ID,Year,M,D,H,1,2,sum,sump
0132-000,2011,1,1,1,231,278,509,0
0132-000,2011,1,1,2,216,265,481,509
0132-000,2011,1,1,3,147,166,313,481
0132-000,2011,1,1,4,97,130,227,313
0132-000,2011,1,1,5,93,123,216,227
0132-000,2011,1,1,6,97,125,222,216
0132-000,2011,1,1,7,158,175,333,222
0132-000,2011,1,1,8,233,259,492,333
0132-000,2011,1,1,9,246,302,548,492
0132-000,2011,1,1,10,377,388,765,548
0132-000,2011,1,1,11,566,558,1124,765
0132-000,2011,1,1,12,624,798,1422,1124
0132-000,2011,1,1,13,691,974,1665,1422
0132-000,2011,1,1,14,704,882,1586,1665
0132-000,2011,1,1,15,745,915,1660,1586
0132-000,2011,1,1,16,835,921,1756,1660
0132-000,2011,1,1,17,932,874,1806,1756
0132-000,2011,1,1,18,936,788,1724,1806
0132-000,2011,1,1,19,768,607,1375,1724
0132-000,2011,1,1,20,515,474,989,1375
0132-000,2011,1,1,21,590,420,1010,989
0132-000,2011,1,1,22,392,388,780,1010
0132-000,2011,1,1,23,308,325,633,780
0132-000,2011,1,1,24,209,259,468,633
0132-000,2011,1,2,1,164,205,369,468
0132-000,2011,1,2,2,82,119,201,369
0132-000,2011,1,2,3,93,84,177,201
0132-000,2011,1,2,4,65,71,136,177
0132-000,2011,1,2,5,71,71,142,136
0132-000,2011,1,2,6,76,82,158,142
0132-000,2011,1,2,7,97,123,220,158
0132-000,2011,1,2,8,198,216,414,220
0132-000,2011,1,2,9,325,325,650,414
0132-000,2011,1,2,10,396,366,762,650
0132-000,2011,1,2,11,555,489,1044,762
0132-000,2011,1,2,12,596,545,1141,1044
0132-000,2011,1,2,13,848,566,1414,1141
0132-000,2011,1,2,14,1233,663,1896,1414
0132-000,2011,1,2,15,1190,792,1982,1896
0132-000,2011,1,2,16,1390,787,2177,1982
0132-000,2011,1,2,17,1405,766,2171,2177
0132-000,2011,1,2,18,1530,730,2260,2171
0132-000,2011,1,2,19,1381,646,2027,2260
0132-000,2011,1,2,20,1216,523,1739,2027
0132-000,2011,1,2,21,826,510,1336,1739
0132-000,2011,1,2,22,495,422,917,1336
0132-000,2011,1,2,23,297,379,676,917
0132-000,2011,1,2,24,233,267,500,676
0132-000,2011,1,3,1,153,158,311,500
0132-000,2011,1,3,2,112,132,244,311
0132-000,2011,1,3,3,78,95,173,244
0132-000,2011,1,3,4,76,102,178,173
0132-000,2011,1,3,5,104,125,229,178
0132-000,2011,1,3,6,155,194,349,229
0132-000,2011,1,3,7,362,476,838,349
0132-000,2011,1,3,8,723,1241,1964,838
0132-000,2011,1,3,9,751,1332,2083,1964
0132-000,2011,1,3,10,706,710,1416,2083
0132-000,2011,1,3,11,856,766,1622,1416
0132-000,2011,1,3,12,850,833,1683,1622
0132-000,2011,1,3,13,777,844,1621,1683
0132-000,2011,1,3,14,947,822,1769,1621
0132-000,2011,1,3,15,1031,867,1898,1769
0132-000,2011,1,3,16,994,899,1893,1898
0132-000,2011,1,3,17,979,818,1797,1893
0132-000,2011,1,3,18,1086,863,1949,1797
0132-000,2011,1,3,19,1082,844,1926,1949
0132-000,2011,1,3,20,859,620,1479,1926
0132-000,2011,1,3,21,665,517,1182,1479
0132-000,2011,1,3,22,570,484,1054,1182
0132-000,2011,1,3,23,403,325,728,1054
0132-000,2011,1,3,24,263,209,472,728
0132-000,2011,1,4,1,160,237,397,472
0132-000,2011,1,4,2,121,99,220,397
0132-000,2011,1,4,3,95,112,207,220
0132-000,2011,1,4,4,59,114,173,207
0132-000,2011,1,4,5,106,140,246,173
0132-000,2011,1,4,6,190,183,373,246
0132-000,2011,1,4,7,327,394,721,373
0132-000,2011,1,4,8,665,1041,1706,721
0132-000,2011,1,4,9,783,1128,1911,1706
0132-000,2011,1,4,10,781,863,1644,1911
0132-000,2011,1,4,11,882,880,1762,1644
0132-000,2011,1,4,12,915,822,1737,1762
0132-000,2011,1,4,13,837,803,1640,1737
0132-000,2011,1,4,14,951,899,1850,1640
0132-000,2011,1,4,15,1143,846,1989,1850
0132-000,2011,1,4,16,1147,979,2126,1989
0132-000,2011,1,4,17,1127,947,2074,2126
0132-000,2011,1,4,18,1089,762,1851,2074
0132-000,2011,1,4,19,1125,835,1960,1851
0132-000,2011,1,4,20,863,635,1498,1960
0132-000,2011,1,4,21,773,585,1358,1498
0132-000,2011,1,4,22,637,502,1139,1358
0132-000,2011,1,4,23,362,338,700,1139
0132-000,2011,1,4,24,244,261,505,700
0132-000,2011,1,5,1,196,211,407,505
0132-000,2011,1,5,2,108,134,242,407
0132-000,2011,1,5,3,95,119,214,242
0132-000,2011,1,5,4,84,132,216,214
0132-000,2011,1,5,5,112,145,257,216
0132-000,2011,1,5,6,201,149,350,257
0132-000,2011,1,5,7,327,342,669,350
0132-000,2011,1,5,8,706,1127,1833,669
0132-000,2011,1,5,9,734,1158,1892,1833
0132-000,2011,1,5,10,811,805,1616,1892
0132-000,2011,1,5,11,876,839,1715,1616
0132-000,2011,1,5,12,930,859,1789,1715
0132-000,2011,1,5,13,899,781,1680,1789
0132-000,2011,1,5,14,1016,889,1905,1680
0132-000,2011,1,5,15,1072,917,1989,1905
0132-000,2011,1,5,16,1115,863,1978,1989
0132-000,2011,1,5,17,1056,861,1917,1978
0132-000,2011,1,5,18,1136,835,1971,1917
0132-000,2011,1,5,19,1117,835,1952,1971
0132-000,2011,1,5,20,818,641,1459,1952
0132-000,2011,1,5,21,691,508,1199,1459
0132-000,2011,1,5,22,534,405,939,1199
0132-000,2011,1,5,23,302,327,629,939
0132-000,2011,1,5,24,252,263,515,629
0132-000,2011,1,6,1,179,188,367,515
0132-000,2011,1,6,2,136,145,281,367
0132-000,2011,1,6,3,127,117,244,281
0132-000,2011,1,6,4,87,119,206,244
0132-000,2011,1,6,5,84,112,196,206
0132-000,2011,1,6,6,168,114,282,196
0132-000,2011,1,6,7,306,304,610,282
0132-000,2011,1,6,8,639,996,1635,610
0132-000,2011,1,6,9,745,1119,1864,1635
0132-000,2011,1,6,10,794,872,1666,1864
0132-000,2011,1,6,11,833,818,1651,1666
0132-000,2011,1,6,12,904,811,1715,1651
0132-000,2011,1,6,13,820,749,1569,1715
0132-000,2011,1,6,14,979,824,1803,1569
0132-000,2011,1,6,15,994,764,1758,1803
0132-000,2011,1,6,16,1160,859,2019,1758
0132-000,2011,1,6,17,1095,861,1956,2019
0132-000,2011,1,6,18,1174,798,1972,1956
0132-000,2011,1,6,19,1175,792,1967,1972
0132-000,2011,1,6,20,813,633,1446,1967
0132-000,2011,1,6,21,719,534,1253,1446
0132-000,2011,1,6,22,592,467,1059,1253
0132-000,2011,1,6,23,366,383,749,1059
0132-000,2011,1,6,24,304,284,588,749
0132-000,2011,1,7,1,205,222,427,588
0132-000,2011,1,7,2,114,153,267,427
0132-000,2011,1,7,3,110,97,207,267
0132-000,2011,1,7,4,80,142,222,207
0132-000,2011,1,7,5,119,125,244,222
0132-000,2011,1,7,6,175,132,307,244
0132-000,2011,1,7,7,319,336,655,307
0132-000,2011,1,7,8,663,1013,1676,655
0132-000,2011,1,7,9,777,1131,1908,1676
0132-000,2011,1,7,10,848,893,1741,1908
0132-000,2011,1,7,11,887,895,1782,1741
0132-000,2011,1,7,12,908,917,1825,1782
0132-000,2011,1,7,13,945,792,1737,1825
0132-000,2011,1,7,14,975,863,1838,1737
0132-000,2011,1,7,15,1181,927,2108,1838
0132-000,2011,1,7,16,1069,368,1437,2108
0132-000,2011,1,7,17,1147,835,1982,1437
0132-000,2011,1,7,18,1196,930,2126,1982
0132-000,2011,1,7,19,1368,895,2263,2126
0132-000,2011,1,7,20,1087,781,1868,2263
0132-000,2011,1,7,21,844,633,1477,1868
0132-000,2011,1,7,22,697,527,1224,1477
0132-000,2011,1,7,23,469,413,882,1224
0132-000,2011,1,7,24,302,355,657,882
0132-000,2011,1,8,1,250,278,528,657
0132-000,2011,1,8,2,162,213,375,528
0132-000,2011,1,8,3,153,179,332,375
0132-000,2011,1,8,4,104,132,236,332
0132-000,2011,1,8,5,149,166,315,236
0132-000,2011,1,8,6,175,173,348,315
0132-000,2011,1,8,7,304,250,554,348
0132-000,2011,1,8,8,534,629,1163,554
0132-000,2011,1,8,9,622,781,1403,1163
0132-000,2011,1,8,10,760,775,1535,1403
0132-000,2011,1,8,11,736,820,1556,1535
0132-000,2011,1,8,12,872,953,1825,1556
0132-000,2011,1,8,13,859,712,1571,1825
0132-000,2011,1,8,14,927,725,1652,1571
0132-000,2011,1,8,15,945,2172,3117,1652
0132-000,2011,1,8,16,1044,1140,2184,3117
0132-000,2011,1,8,17,1183,970,2153,2184
0132-000,2011,1,8,18,1406,1031,2437,2153
0132-000,2011,1,8,19,1269,958,2227,2437
0132-000,2011,1,8,20,760,697,1457,2227
0132-000,2011,1,8,21,618,581,1199,1457
0132-000,2011,1,8,22,506,461,967,1199
0132-000,2011,1,8,23,385,358,743,967
0132-000,2011,1,8,24,250,256,506,743
0132-000,2011,1,9,1,164,238,402,506
0132-000,2011,1,9,2,139,174,313,402
0132-000,2011,1,9,3,97,145,242,313
0132-000,2011,1,9,4,99,97,196,242
0132-000,2011,1,9,5,80,91,171,196
0132-000,2011,1,9,6,88,120,208,171
0132-000,2011,1,9,7,120,162,282,208
0132-000,2011,1,9,8,206,291,497,282
0132-000,2011,1,9,9,329,424,753,497
0132-000,2011,1,9,10,405,469,874,753
0132-000,2011,1,9,11,532,574,1106,874
0132-000,2011,1,9,12,545,592,1137,1106
0132-000,2011,1,9,13,639,663,1302,1137
0132-000,2011,1,9,14,700,703,1403,1302
0132-000,2011,1,9,15,768,718,1486,1403
0132-000,2011,1,9,16,921,696,1617,1486
0132-000,2011,1,9,17,988,635,1623,1617
0132-000,2011,1,9,18,941,605,1546,1623
0132-000,2011,1,9,19,874,546,1420,1546
0132-000,2011,1,9,20,607,517,1124,1420
0132-000,2011,1,9,21,546,451,997,1124
0132-000,2011,1,9,22,332,409,741,997
0132-000,2011,1,9,23,209,295,504,741
0132-000,2011,1,9,24,153,185,338,504
0132-000,2011,1,10,1,144,221,365,338
0132-000,2011,1,10,2,90,119,209,365
0132-000,2011,1,10,3,51,100,151,209
0132-000,2011,1,10,4,58,107,165,151
0132-000,2011,1,10,5,89,102,191,165
0132-000,2011,1,10,6,168,162,330,191
0132-000,2011,1,10,7,347,490,837,330
0132-000,2011,1,10,8,749,1123,1872,837
0132-000,2011,1,10,9,731,1349,2080,1872
0132-000,2011,1,10,10,709,898,1607,2080
0132-000,2011,1,10,11,831,872,1703,1607
0132-000,2011,1,10,12,860,919,1779,1703
0132-000,2011,1,10,13,826,821,1647,1779
0132-000,2011,1,10,14,903,908,1811,1647
0132-000,2011,1,10,15,1039,957,1996,1811
0132-000,2011,1,10,16,1089,972,2061,1996
0132-000,2011,1,10,17,1089,900,1989,2061
0132-000,2011,1,10,18,1095,821,1916,1989
0132-000,2011,1,10,19,1130,792,1922,1916
0132-000,2011,1,10,20,852,709,1561,1922
0132-000,2011,1,10,21,739,584,1323,1561
0132-000,2011,1,10,22,603,541,1144,1323
0132-000,2011,1,10,23,356,374,730,1144
0132-000,2011,1,10,24,278,261,539,730
0132-000,2011,1,11,1,156,191,347,539
0132-000,2011,1,11,2,112,157,269,347
0132-000,2011,1,11,3,94,113,207,269
0132-000,2011,1,11,4,63,111,174,207
0132-000,2011,1,11,5,96,157,253,174
0132-000,2011,1,11,6,145,126,271,253
0132-000,2011,1,11,7,322,348,670,271
0132-000,2011,1,11,8,661,1055,1716,670
0132-000,2011,1,11,9,769,1108,1877,1716
0132-000,2011,1,11,10,776,893,1669,1877
0132-000,2011,1,11,11,884,915,1799,1669
0132-000,2011,1,11,12,862,866,1728,1799
0132-000,2011,1,11,13,793,813,1606,1728
0132-000,2011,1,11,14,929,906,1835,1606
0132-000,2011,1,11,15,1012,904,1916,1835
0132-000,2011,1,11,16,999,870,1869,1916
0132-000,2011,1,11,17,1014,809,1823,1869
0132-000,2011,1,11,18,1034,817,1851,1823
0132-000,2011,1,11,19,1091,762,1853,1851
0132-000,2011,1,11,20,769,622,1391,1853
0132-000,2011,1,11,21,640,478,1118,1391
0132-000,2011,1,11,22,529,488,1017,1118
0132-000,2011,1,11,23,283,297,580,1017
0132-000,2011,1,11,24,185,206,391,580
0132-000,2011,1,12,1,162,170,332,391
0132-000,2011,1,12,2,92,153,245,332
0132-000,2011,1,12,3,67,98,165,245
0132-000,2011,1,12,4,66,113,179,165
0132-000,2011,1,12,5,76,96,172,179
0132-000,2011,1,12,6,123,134,257,172
0132-000,2011,1,12,7,226,312,538,257
0132-000,2011,1,12,8,562,817,1379,538
0132-000,2011,1,12,9,588,961,1549,1379
0132-000,2011,1,12,10,606,641,1247,1549
0132-000,2011,1,12,11,693,730,1423,1247
0132-000,2011,1,12,12,748,874,1622,1423
0132-000,2011,1,12,13,746,705,1451,1622
0132-000,2011,1,12,14,806,877,1683,1451
0132-000,2011,1,12,15,957,921,1878,1683
0132-000,2011,1,12,16,1017,836,1853,1878
0132-000,2011,1,12,17,915,777,1692,1853
0132-000,2011,1,12,18,1023,779,1802,1692
0132-000,2011,1,12,19,1108,794,1902,1802
0132-000,2011,1,12,20,873,686,1559,1902
0132-000,2011,1,12,21,633,550,1183,1559
0132-000,2011,1,12,22,541,488,1029,1183
0132-000,2011,1,12,23,324,367,691,1029
0132-000,2011,1,12,24,255,236,491,691
0132-000,2011,1,13,1,165,247,412,491
0132-000,2011,1,13,2,105,155,260,412
0132-000,2011,1,13,3,78,130,208,260
0132-000,2011,1,13,4,66,117,183,208
0132-000,2011,1,13,5,93,124,217,183
0132-000,2011,1,13,6,146,134,280,217
0132-000,2011,1,13,7,297,334,631,280
0132-000,2011,1,13,8,689,1116,1805,631
0132-000,2011,1,13,9,836,1370,2206,1805
0132-000,2011,1,13,10,956,1050,2006,2206
0132-000,2011,1,13,11,910,857,1767,2006
0132-000,2011,1,13,12,898,868,1766,1767
0132-000,2011,1,13,13,839,853,1692,1766
0132-000,2011,1,13,14,864,855,1719,1692
0132-000,2011,1,13,15,1347,868,2215,1719
0132-000,2011,1,13,16,1177,893,2070,2215
0132-000,2011,1,13,17,943,898,1841,2070
0132-000,2011,1,13,18,1033,838,1871,1841
0132-000,2011,1,13,19,1127,779,1906,1871
0132-000,2011,1,13,20,866,650,1516,1906
0132-000,2011,1,13,21,708,533,1241,1516
0132-000,2011,1,13,22,566,529,1095,1241
0132-000,2011,1,13,23,390,346,736,1095
0132-000,2011,1,13,24,245,272,517,736
0132-000,2011,1,14,1,194,234,428,517
0132-000,2011,1,14,2,116,189,305,428
0132-000,2011,1,14,3,78,134,212,305
0132-000,2011,1,14,4,74,117,191,212
0132-000,2011,1,14,5,84,128,212,191
0132-000,2011,1,14,6,156,121,277,212
0132-000,2011,1,14,7,261,338,599,277
0132-000,2011,1,14,8,677,1006,1683,599
0132-000,2011,1,14,9,774,1026,1800,1683
0132-000,2011,1,14,10,692,753,1445,1800
0132-000,2011,1,14,11,788,821,1609,1445
0132-000,2011,1,14,12,817,843,1660,1609
0132-000,2011,1,14,13,734,790,1524,1660
0132-000,2011,1,14,14,868,840,1708,1524
0132-000,2011,1,14,15,988,932,1920,1708
0132-000,2011,1,14,16,1053,862,1915,1920
0132-000,2011,1,14,17,1105,853,1958,1915
0132-000,2011,1,14,18,1210,815,2025,1958
0132-000,2011,1,14,19,1354,862,2216,2025
0132-000,2011,1,14,20,1048,690,1738,2216
0132-000,2011,1,14,21,1105,611,1716,1738
0132-000,2011,1,14,22,658,552,1210,1716
0132-000,2011,1,14,23,398,401,799,1210
0132-000,2011,1,14,24,294,270,564,799
0132-000,2011,1,15,1,228,236,464,564
0132-000,2011,1,15,2,178,183,361,464
0132-000,2011,1,15,3,120,151,271,361
0132-000,2011,1,15,4,110,145,255,271
0132-000,2011,1,15,5,98,147,245,255
0132-000,2011,1,15,6,139,149,288,245
0132-000,2011,1,15,7,231,257,488,288
0132-000,2011,1,15,8,478,567,1045,488
0132-000,2011,1,15,9,655,792,1447,1045
0132-000,2011,1,15,10,693,734,1427,1447
0132-000,2011,1,15,11,785,715,1500,1427
0132-000,2011,1,15,12,867,877,1744,1500
0132-000,2011,1,15,13,876,1074,1950,1744
0132-000,2011,1,15,14,900,1067,1967,1950
0132-000,2011,1,15,15,991,1093,2084,1967
0132-000,2011,1,15,16,1027,1089,2116,2084
0132-000,2011,1,15,17,1176,1095,2271,2116
0132-000,2011,1,15,18,1462,1019,2481,2271
0132-000,2011,1,15,19,1387,953,2340,2481
0132-000,2011,1,15,20,845,626,1471,2340
0132-000,2011,1,15,21,687,573,1260,1471
0132-000,2011,1,15,22,413,433,846,1260
0132-000,2011,1,15,23,339,334,673,846
0132-000,2011,1,15,24,219,327,546,673
0132-000,2011,1,16,1,183,221,404,546
0132-000,2011,1,16,2,132,177,309,404
0132-000,2011,1,16,3,91,149,240,309
0132-000,2011,1,16,4,100,100,200,240
0132-000,2011,1,16,5,73,81,154,200
0132-000,2011,1,16,6,75,94,169,154
0132-000,2011,1,16,7,113,130,243,169
0132-000,2011,1,16,8,173,225,398,243
0132-000,2011,1,16,9,286,404,690,398
0132-000,2011,1,16,10,404,425,829,690
0132-000,2011,1,16,11,525,560,1085,829
0132-000,2011,1,16,12,485,571,1056,1085
0132-000,2011,1,16,13,622,609,1231,1056
0132-000,2011,1,16,14,660,690,1350,1231
0132-000,2011,1,16,15,742,720,1462,1350
0132-000,2011,1,16,16,880,669,1549,1462
0132-000,2011,1,16,17,937,710,1647,1549
0132-000,2011,1,16,18,1121,688,1809,1647
0132-000,2011,1,16,19,961,630,1591,1809
0132-000,2011,1,16,20,571,550,1121,1591
0132-000,2011,1,16,21,508,482,990,1121
0132-000,2011,1,16,22,394,450,844,990
0132-000,2011,1,16,23,228,336,564,844
0132-000,2011,1,16,24,189,215,404,564
0132-000,2011,1,17,1,120,191,311,404
0132-000,2011,1,17,2,75,136,211,311
0132-000,2011,1,17,3,57,102,159,211
0132-000,2011,1,17,4,54,85,139,159
0132-000,2011,1,17,5,62,94,156,139
0132-000,2011,1,17,6,141,153,294,156
0132-000,2011,1,17,7,318,454,772,294
0132-000,2011,1,17,8,734,1210,1944,772
0132-000,2011,1,17,9,723,1227,1950,1944
0132-000,2011,1,17,10,668,847,1515,1950
0132-000,2011,1,17,11,766,881,1647,1515
0132-000,2011,1,17,12,862,896,1758,1647
0132-000,2011,1,17,13,778,836,1614,1758
0132-000,2011,1,17,14,893,896,1789,1614
0132-000,2011,1,17,15,984,919,1903,1789
0132-000,2011,1,17,16,1004,904,1908,1903
0132-000,2011,1,17,17,994,828,1822,1908
0132-000,2011,1,17,18,1104,828,1932,1822
0132-000,2011,1,17,19,1054,798,1852,1932
0132-000,2011,1,17,20,846,694,1540,1852
0132-000,2011,1,17,21,730,588,1318,1540
0132-000,2011,1,17,22,568,442,1010,1318
0132-000,2011,1,17,23,321,338,659,1010
0132-000,2011,1,17,24,219,238,457,659
0132-000,2011,1,18,1,163,166,329,457
0132-000,2011,1,18,2,108,140,248,329
0132-000,2011,1,18,3,76,115,191,248
0132-000,2011,1,18,4,63,98,161,191
0132-000,2011,1,18,5,93,134,227,161
0132-000,2011,1,18,6,157,155,312,227
0132-000,2011,1,18,7,281,355,636,312
0132-000,2011,1,18,8,720,1044,1764,636
0132-000,2011,1,18,9,803,1091,1894,1764
0132-000,2011,1,18,10,775,838,1613,1894
0132-000,2011,1,18,11,818,930,1748,1613
0132-000,2011,1,18,12,836,851,1687,1748
0132-000,2011,1,18,13,839,779,1618,1687
0132-000,2011,1,18,14,882,923,1805,1618
0132-000,2011,1,18,15,1006,904,1910,1805
0132-000,2011,1,18,16,1020,879,1899,1910
0132-000,2011,1,18,17,1007,817,1824,1899
0132-000,2011,1,18,18,1116,811,1927,1824
0132-000,2011,1,18,19,1158,855,2013,1927
0132-000,2011,1,18,20,890,652,1542,2013
0132-000,2011,1,18,21,725,582,1307,1542
0132-000,2011,1,18,22,604,497,1101,1307
0132-000,2011,1,18,23,328,334,662,1101
0132-000,2011,1,18,24,261,251,512,662
0132-000,2011,1,19,1,169,230,399,512
0132-000,2011,1,19,2,115,157,272,399
0132-000,2011,1,19,3,73,134,207,272
0132-000,2011,1,19,4,80,128,208,207
0132-000,2011,1,19,5,84,130,214,208
0132-000,2011,1,19,6,134,132,266,214
0132-000,2011,1,19,7,272,329,601,266
0132-000,2011,1,19,8,653,1040,1693,601
0132-000,2011,1,19,9,724,1185,1909,1693
0132-000,2011,1,19,10,766,879,1645,1909
0132-000,2011,1,19,11,860,857,1717,1645
0132-000,2011,1,19,12,882,925,1807,1717
0132-000,2011,1,19,13,740,832,1572,1807
0132-000,2011,1,19,14,967,906,1873,1572
0132-000,2011,1,19,15,1009,961,1970,1873
0132-000,2011,1,19,16,993,872,1865,1970
0132-000,2011,1,19,17,990,838,1828,1865
0132-000,2011,1,19,18,1217,857,2074,1828
0132-000,2011,1,19,19,1175,870,2045,2074
0132-000,2011,1,19,20,893,690,1583,2045
0132-000,2011,1,19,21,695,590,1285,1583
0132-000,2011,1,19,22,601,544,1145,1285
0132-000,2011,1,19,23,378,418,796,1145
0132-000,2011,1,19,24,257,289,546,796
0132-000,2011,1,20,1,178,232,410,546
0132-000,2011,1,20,2,127,147,274,410
0132-000,2011,1,20,3,77,149,226,274
0132-000,2011,1,20,4,90,143,233,226
0132-000,2011,1,20,5,114,147,261,233
0132-000,2011,1,20,6,129,174,303,261
0132-000,2011,1,20,7,297,355,652,303
0132-000,2011,1,20,8,701,1097,1798,652
0132-000,2011,1,20,9,787,1236,2023,1798
0132-000,2011,1,20,10,795,913,1708,2023
0132-000,2011,1,20,11,830,836,1666,1708
0132-000,2011,1,20,12,909,908,1817,1666
0132-000,2011,1,20,13,792,826,1618,1817
0132-000,2011,1,20,14,875,847,1722,1618
0132-000,2011,1,20,15,973,966,1939,1722
0132-000,2011,1,20,16,1017,849,1866,1939
0132-000,2011,1,20,17,1038,838,1876,1866
0132-000,2011,1,20,18,1145,819,1964,1876
0132-000,2011,1,20,19,1150,919,2069,1964
0132-000,2011,1,20,20,856,756,1612,2069
0132-000,2011,1,20,21,741,616,1357,1612
0132-000,2011,1,20,22,592,554,1146,1357
0132-000,2011,1,20,23,406,370,776,1146
0132-000,2011,1,20,24,281,314,595,776
0132-000,2011,1,21,1,186,249,435,595
0132-000,2011,1,21,2,132,153,285,435
0132-000,2011,1,21,3,82,130,212,285
0132-000,2011,1,21,4,78,119,197,212
0132-000,2011,1,21,5,80,132,212,197
0132-000,2011,1,21,6,156,157,313,212
0132-000,2011,1,21,7,274,350,624,313
0132-000,2011,1,21,8,708,1093,1801,624
0132-000,2011,1,21,9,771,1188,1959,1801
0132-000,2011,1,21,10,796,879,1675,1959
0132-000,2011,1,21,11,878,845,1723,1675
0132-000,2011,1,21,12,905,885,1790,1723
0132-000,2011,1,21,13,856,857,1713,1790
0132-000,2011,1,21,14,886,938,1824,1713
0132-000,2011,1,21,15,1081,1012,2093,1824
0132-000,2011,1,21,16,1091,1019,2110,2093
0132-000,2011,1,21,17,1102,849,1951,2110
0132-000,2011,1,21,18,1206,902,2108,1951
0132-000,2011,1,21,19,1417,860,2277,2108
0132-000,2011,1,21,20,1082,817,1899,2277
0132-000,2011,1,21,21,786,624,1410,1899
0132-000,2011,1,21,22,660,613,1273,1410
0132-000,2011,1,21,23,430,420,850,1273
0132-000,2011,1,21,24,332,387,719,850
0132-000,2011,1,22,1,229,251,480,719
0132-000,2011,1,22,2,171,215,386,480
0132-000,2011,1,22,3,119,168,287,386
0132-000,2011,1,22,4,100,155,255,287
0132-000,2011,1,22,5,109,138,247,255
0132-000,2011,1,22,6,145,183,328,247
0132-000,2011,1,22,7,253,227,480,328
0132-000,2011,1,22,8,479,645,1124,480
0132-000,2011,1,22,9,630,781,1411,1124
0132-000,2011,1,22,10,655,720,1375,1411
0132-000,2011,1,22,11,818,879,1697,1375
0132-000,2011,1,22,12,873,989,1862,1697
0132-000,2011,1,22,13,843,1019,1862,1862
0132-000,2011,1,22,14,901,955,1856,1862
0132-000,2011,1,22,15,962,1103,2065,1856
0132-000,2011,1,22,16,1106,1190,2296,2065
0132-000,2011,1,22,17,1119,1156,2275,2296
0132-000,2011,1,22,18,1424,1129,2553,2275
0132-000,2011,1,22,19,1413,1040,2453,2553
0132-000,2011,1,22,20,807,739,1546,2453
0132-000,2011,1,22,21,584,558,1142,1546
0132-000,2011,1,22,22,510,457,967,1142
0132-000,2011,1,22,23,382,399,781,967
0132-000,2011,1,22,24,274,329,603,781
0132-000,2011,1,23,1,145,255,400,603
0132-000,2011,1,23,2,146,170,316,400
0132-000,2011,1,23,3,103,140,243,316
0132-000,2011,1,23,4,97,94,191,243
0132-000,2011,1,23,5,87,100,187,191
0132-000,2011,1,23,6,101,145,246,187
0132-000,2011,1,23,7,127,194,321,246
0132-000,2011,1,23,8,239,357,596,321
0132-000,2011,1,23,9,371,444,815,596
0132-000,2011,1,23,10,406,512,918,815
0132-000,2011,1,23,11,538,588,1126,918
0132-000,2011,1,23,12,604,613,1217,1126
0132-000,2011,1,23,13,655,716,1371,1217
0132-000,2011,1,23,14,740,715,1455,1371
0132-000,2011,1,23,15,793,715,1508,1455
0132-000,2011,1,23,16,961,722,1683,1508
0132-000,2011,1,23,17,1038,560,1598,1683
0132-000,2011,1,23,18,761,522,1283,1598
0132-000,2011,1,23,19,787,461,1248,1283
0132-000,2011,1,23,20,642,484,1126,1248
0132-000,2011,1,23,21,583,420,1003,1126
0132-000,2011,1,23,22,270,367,637,1003
0132-000,2011,1,23,23,189,253,442,637
0132-000,2011,1,23,24,117,155,272,442
0132-000,2011,1,24,1,71,134,205,272
0132-000,2011,1,24,2,58,109,167,205
0132-000,2011,1,24,3,48,92,140,167
0132-000,2011,1,24,4,51,90,141,140
0132-000,2011,1,24,5,65,90,155,141
0132-000,2011,1,24,6,99,147,246,155
0132-000,2011,1,24,7,244,346,590,246
0132-000,2011,1,24,8,407,914,1321,590
0132-000,2011,1,24,9,444,868,1312,1321
0132-000,2011,1,24,10,415,590,1005,1312
0132-000,2011,1,24,11,426,741,1167,1005
0132-000,2011,1,24,12,668,667,1335,1167
0132-000,2011,1,24,13,697,732,1429,1335
0132-000,2011,1,24,14,749,813,1562,1429
0132-000,2011,1,24,15,828,877,1705,1562
0132-000,2011,1,24,16,891,823,1714,1705
0132-000,2011,1,24,17,849,787,1636,1714
0132-000,2011,1,24,18,900,760,1660,1636
0132-000,2011,1,24,19,969,760,1729,1660
0132-000,2011,1,24,20,812,658,1470,1729
0132-000,2011,1,24,21,620,482,1102,1470
0132-000,2011,1,24,22,483,465,948,1102
0132-000,2011,1,24,23,322,304,626,948
0132-000,2011,1,24,24,200,215,415,626
0132-000,2011,1,25,1,163,177,340,415
0132-000,2011,1,25,2,95,138,233,340
0132-000,2011,1,25,3,68,102,170,233
0132-000,2011,1,25,4,78,100,178,170
0132-000,2011,1,25,5,102,104,206,178
0132-000,2011,1,25,6,131,124,255,206
0132-000,2011,1,25,7,268,331,599,255
0132-000,2011,1,25,8,614,1036,1650,599
0132-000,2011,1,25,9,759,1044,1803,1650
0132-000,2011,1,25,10,729,889,1618,1803
0132-000,2011,1,25,11,862,832,1694,1618
0132-000,2011,1,25,12,869,851,1720,1694
0132-000,2011,1,25,13,792,815,1607,1720
0132-000,2011,1,25,14,873,921,1794,1607
0132-000,2011,1,25,15,1006,983,1989,1794
0132-000,2011,1,25,16,1093,1008,2101,1989
0132-000,2011,1,25,17,1037,923,1960,2101
0132-000,2011,1,25,18,1047,832,1879,1960
0132-000,2011,1,25,19,1117,857,1974,1879
0132-000,2011,1,25,20,840,711,1551,1974
0132-000,2011,1,25,21,712,577,1289,1551
0132-000,2011,1,25,22,669,571,1240,1289
0132-000,2011,1,25,23,320,404,724,1240
0132-000,2011,1,25,24,209,238,447,724
0132-000,2011,1,26,1,155,170,325,447
0132-000,2011,1,26,2,131,170,301,325
0132-000,2011,1,26,3,97,147,244,301
0132-000,2011,1,26,4,71,138,209,244
0132-000,2011,1,26,5,93,117,210,209
0132-000,2011,1,26,6,152,160,312,210
0132-000,2011,1,26,7,295,342,637,312
0132-000,2011,1,26,8,663,1076,1739,637
0132-000,2011,1,26,9,795,1228,2023,1739
0132-000,2011,1,26,10,788,910,1698,2023
0132-000,2011,1,26,11,891,870,1761,1698
0132-000,2011,1,26,12,873,919,1792,1761
0132-000,2011,1,26,13,828,809,1637,1792
0132-000,2011,1,26,14,916,1114,2030,1637
0132-000,2011,1,26,15,1049,1053,2102,2030
0132-000,2011,1,26,16,1093,1055,2148,2102
0132-000,2011,1,26,17,1161,913,2074,2148
0132-000,2011,1,26,18,1221,893,2114,2074
0132-000,2011,1,26,19,1213,849,2062,2114
0132-000,2011,1,26,20,845,751,1596,2062
0132-000,2011,1,26,21,682,573,1255,1596
0132-000,2011,1,26,22,643,573,1216,1255
0132-000,2011,1,26,23,373,384,757,1216
0132-000,2011,1,26,24,281,300,581,757
0132-000,2011,1,27,1,191,234,425,581
0132-000,2011,1,27,2,132,177,309,425
0132-000,2011,1,27,3,89,119,208,309
0132-000,2011,1,27,4,86,111,197,208
0132-000,2011,1,27,5,96,149,245,197
0132-000,2011,1,27,6,154,149,303,245
0132-000,2011,1,27,7,297,357,654,303
0132-000,2011,1,27,8,669,1040,1709,654
0132-000,2011,1,27,9,764,1099,1863,1709
0132-000,2011,1,27,10,804,853,1657,1863
0132-000,2011,1,27,11,853,932,1785,1657
0132-000,2011,1,27,12,909,836,1745,1785
0132-000,2011,1,27,13,829,855,1684,1745
0132-000,2011,1,27,14,953,877,1830,1684
0132-000,2011,1,27,15,1021,974,1995,1830
0132-000,2011,1,27,16,1043,913,1956,1995
0132-000,2011,1,27,17,1023,836,1859,1956
0132-000,2011,1,27,18,1173,927,2100,1859
0132-000,2011,1,27,19,1164,881,2045,2100
0132-000,2011,1,27,20,898,753,1651,2045
0132-000,2011,1,27,21,766,567,1333,1651
0132-000,2011,1,27,22,610,518,1128,1333
0132-000,2011,1,27,23,437,446,883,1128
0132-000,2011,1,27,24,239,302,541,883
0132-000,2011,1,28,1,191,225,416,541
0132-000,2011,1,28,2,123,189,312,416
0132-000,2011,1,28,3,94,126,220,312
0132-000,2011,1,28,4,83,155,238,220
0132-000,2011,1,28,5,99,134,233,238
0132-000,2011,1,28,6,150,145,295,233
0132-000,2011,1,28,7,307,334,641,295
0132-000,2011,1,28,8,723,1053,1776,641
0132-000,2011,1,28,9,814,1130,1944,1776
0132-000,2011,1,28,10,778,932,1710,1944
0132-000,2011,1,28,11,931,881,1812,1710
0132-000,2011,1,28,12,868,1033,1901,1812
0132-000,2011,1,28,13,864,940,1804,1901
0132-000,2011,1,28,14,1007,963,1970,1804
0132-000,2011,1,28,15,1026,1025,2051,1970
0132-000,2011,1,28,16,1038,1055,2093,2051
0132-000,2011,1,28,17,1111,910,2021,2093
0132-000,2011,1,28,18,1241,902,2143,2021
0132-000,2011,1,28,19,1359,919,2278,2143
0132-000,2011,1,28,20,1151,853,2004,2278
0132-000,2011,1,28,21,823,588,1411,2004
0132-000,2011,1,28,22,720,573,1293,1411
0132-000,2011,1,28,23,453,486,939,1293
0132-000,2011,1,28,24,327,353,680,939
0132-000,2011,1,29,1,204,308,512,680
0132-000,2011,1,29,2,148,202,350,512
0132-000,2011,1,29,3,141,200,341,350
0132-000,2011,1,29,4,114,219,333,341
0132-000,2011,1,29,5,135,202,337,333
0132-000,2011,1,29,6,142,134,276,337
0132-000,2011,1,29,7,232,274,506,276
0132-000,2011,1,29,8,514,647,1161,506
0132-000,2011,1,29,9,680,853,1533,1161
0132-000,2011,1,29,10,785,798,1583,1533
0132-000,2011,1,29,11,813,904,1717,1583
0132-000,2011,1,29,12,907,879,1786,1717
0132-000,2011,1,29,13,840,904,1744,1786
0132-000,2011,1,29,14,996,819,1815,1744
0132-000,2011,1,29,15,954,891,1845,1815
0132-000,2011,1,29,16,941,862,1803,1845
0132-000,2011,1,29,17,923,887,1810,1803
0132-000,2011,1,29,18,1205,900,2105,1810
0132-000,2011,1,29,19,1080,830,1910,2105
0132-000,2011,1,29,20,683,694,1377,1910
0132-000,2011,1,29,21,594,575,1169,1377
0132-000,2011,1,29,22,471,512,983,1169
0132-000,2011,1,29,23,328,361,689,983
0132-000,2011,1,29,24,212,327,539,689
0132-000,2011,1,30,1,162,210,372,539
0132-000,2011,1,30,2,121,147,268,372
0132-000,2011,1,30,3,96,136,232,268
0132-000,2011,1,30,4,99,132,231,232
0132-000,2011,1,30,5,93,113,206,231
0132-000,2011,1,30,6,102,121,223,206
0132-000,2011,1,30,7,129,145,274,223
0132-000,2011,1,30,8,250,346,596,274
0132-000,2011,1,30,9,359,484,843,596
0132-000,2011,1,30,10,428,554,982,843
0132-000,2011,1,30,11,500,656,1156,982
0132-000,2011,1,30,12,549,599,1148,1156
0132-000,2011,1,30,13,622,635,1257,1148
0132-000,2011,1,30,14,689,664,1353,1257
0132-000,2011,1,30,15,753,743,1496,1353
0132-000,2011,1,30,16,779,750,1529,1496
0132-000,2011,1,30,17,747,667,1414,1529
0132-000,2011,1,30,18,802,690,1492,1414
0132-000,2011,1,30,19,839,650,1489,1492
0132-000,2011,1,30,20,554,505,1059,1489
0132-000,2011,1,30,21,458,482,940,1059
0132-000,2011,1,30,22,375,444,819,940
0132-000,2011,1,30,23,258,334,592,819
0132-000,2011,1,30,24,164,259,423,592
0132-000,2011,1,31,1,124,170,294,423
0132-000,2011,1,31,2,62,94,156,294
0132-000,2011,1,31,3,64,102,166,156
0132-000,2011,1,31,4,64,92,156,166
0132-000,2011,1,31,5,80,124,204,156
0132-000,2011,1,31,6,147,164,311,204
0132-000,2011,1,31,7,321,437,758,311
0132-000,2011,1,31,8,693,1171,1864,758
0132-000,2011,1,31,9,802,1202,2004,1864
0132-000,2011,1,31,10,711,919,1630,2004
0132-000,2011,1,31,11,852,910,1762,1630
0132-000,2011,1,31,12,936,921,1857,1762
0132-000,2011,1,31,13,876,906,1782,1857
0132-000,2011,1,31,14,955,966,1921,1782
0132-000,2011,1,31,15,1042,1021,2063,1921
0132-000,2011,1,31,16,1032,947,1979,2063
0132-000,2011,1,31,17,1053,949,2002,1979
0132-000,2011,1,31,18,1110,961,2071,2002
0132-000,2011,1,31,19,1151,932,2083,2071
0132-000,2011,1,31,20,893,722,1615,2083
0132-000,2011,1,31,21,722,630,1352,1615
0132-000,2011,1,31,22,608,571,1179,1352
0132-000,2011,1,31,23,398,410,808,1179
0132-000,2011,1,31,24,289,297,586,808
0132-000,2011,2,1,1,198,254,452,586
0132-000,2011,2,1,2,149,174,323,452
0132-000,2011,2,1,3,103,172,275,323
0132-000,2011,2,1,4,95,128,223,275
0132-000,2011,2,1,5,106,163,269,223
0132-000,2011,2,1,6,130,146,276,269
0132-000,2011,2,1,7,225,311,536,276
0132-000,2011,2,1,8,663,1091,1754,536
0132-000,2011,2,1,9,685,1108,1793,1754
0132-000,2011,2,1,10,720,912,1632,1793
0132-000,2011,2,1,11,808,912,1720,1632
0132-000,2011,2,1,12,822,1168,1990,1720
0132-000,2011,2,1,13,823,1472,2295,1990
0132-000,2011,2,1,14,868,1608,2476,2295
0132-000,2011,2,1,15,964,1657,2621,2476
0132-000,2011,2,1,16,1004,1617,2621,2621
0132-000,2011,2,1,17,974,1641,2615,2621
0132-000,2011,2,1,18,1147,1742,2889,2615
0132-000,2011,2,1,19,1065,1749,2814,2889
0132-000,2011,2,1,20,817,1723,2540,2814
0132-000,2011,2,1,21,551,1564,2115,2540
0132-000,2011,2,1,22,412,1608,2020,2115
0132-000,2011,2,1,23,318,1560,1878,2020
0132-000,2011,2,1,24,240,1480,1720,1878
0132-000,2011,2,2,1,169,1428,1597,1720
0132-000,2011,2,2,2,110,1417,1527,1597
0132-000,2011,2,2,3,102,1300,1402,1527
0132-000,2011,2,2,4,82,1033,1115,1402
0132-000,2011,2,2,5,70,1353,1423,1115
0132-000,2011,2,2,6,100,1531,1631,1423
0132-000,2011,2,2,7,132,1520,1652,1631
0132-000,2011,2,2,8,181,1575,1756,1652
0132-000,2011,2,2,9,313,1661,1974,1756
0132-000,2011,2,2,10,471,1760,2231,1974
0132-000,2011,2,2,11,705,1751,2456,2231
0132-000,2011,2,2,12,771,1756,2527,2456
0132-000,2011,2,2,13,846,1764,2610,2527
0132-000,2011,2,2,14,780,1800,2580,2610
0132-000,2011,2,2,15,812,1806,2618,2580
0132-000,2011,2,2,16,923,1734,2657,2618
0132-000,2011,2,2,17,882,1615,2497,2657
0132-000,2011,2,2,18,595,1513,2108,2497
0132-000,2011,2,2,19,514,1071,1585,2108
0132-000,2011,2,2,20,369,729,1098,1585
0132-000,2011,2,2,21,340,489,829,1098
0132-000,2011,2,2,22,267,353,620,829
0132-000,2011,2,2,23,204,287,491,620
0132-000,2011,2,2,24,136,230,366,491
0132-000,2011,2,3,1,93,113,206,366
0132-000,2011,2,3,2,62,80,142,206
0132-000,2011,2,3,3,63,108,171,142
0132-000,2011,2,3,4,46,60,106,171
0132-000,2011,2,3,5,52,82,134,106
0132-000,2011,2,3,6,88,106,194,134
0132-000,2011,2,3,7,260,313,573,194
0132-000,2011,2,3,8,400,635,1035,573
0132-000,2011,2,3,9,404,637,1041,1035
0132-000,2011,2,3,10,418,619,1037,1041
0132-000,2011,2,3,11,854,967,1821,1037
0132-000,2011,2,3,12,1665,1439,3104,1821
0132-000,2011,2,3,13,1818,1568,3386,3104
0132-000,2011,2,3,14,1879,1604,3483,3386
0132-000,2011,2,3,15,1926,1709,3635,3483
0132-000,2011,2,3,16,1884,1767,3651,3635
0132-000,2011,2,3,17,1728,1795,3523,3651
0132-000,2011,2,3,18,1756,1809,3565,3523
0132-000,2011,2,3,19,1645,1745,3390,3565
0132-000,2011,2,3,20,1642,1727,3369,3390
0132-000,2011,2,3,21,1599,1613,3212,3369
0132-000,2011,2,3,22,1594,1337,2931,3212
0132-000,2011,2,3,23,893,875,1768,2931
0132-000,2011,2,3,24,552,406,958,1768
0132-000,2011,2,4,1,360,214,574,958
0132-000,2011,2,4,2,200,117,317,574
0132-000,2011,2,4,3,113,86,199,317
0132-000,2011,2,4,4,85,60,145,199
0132-000,2011,2,4,5,62,69,131,145
0132-000,2011,2,4,6,88,71,159,131
0132-000,2011,2,4,7,114,78,192,159
0132-000,2011,2,4,8,175,177,352,192
0132-000,2011,2,4,9,277,309,586,352
0132-000,2011,2,4,10,425,399,824,586
0132-000,2011,2,4,11,931,520,1451,824
0132-000,2011,2,4,12,1266,661,1927,1451
0132-000,2011,2,4,13,1546,800,2346,1927
0132-000,2011,2,4,14,1682,851,2533,2346
0132-000,2011,2,4,15,1684,891,2575,2533
0132-000,2011,2,4,16,1940,870,2810,2575
0132-000,2011,2,4,17,1933,888,2821,2810
0132-000,2011,2,4,18,1850,784,2634,2821
0132-000,2011,2,4,19,1750,573,2323,2634
0132-000,2011,2,4,20,1630,520,2150,2323
0132-000,2011,2,4,21,1735,452,2187,2150
0132-000,2011,2,4,22,1607,397,2004,2187
0132-000,2011,2,4,23,1412,355,1767,2004
0132-000,2011,2,4,24,1382,219,1601,1767
0132-000,2011,2,5,1,1614,205,1819,1601
0132-000,2011,2,5,2,958,146,1104,1819
0132-000,2011,2,5,3,640,111,751,1104
0132-000,2011,2,5,4,154,67,221,751
0132-000,2011,2,5,5,98,108,206,221
0132-000,2011,2,5,6,121,124,245,206
0132-000,2011,2,5,7,141,133,274,245
0132-000,2011,2,5,8,259,370,629,274
0132-000,2011,2,5,9,462,397,859,629
0132-000,2011,2,5,10,722,492,1214,859
0132-000,2011,2,5,11,1145,529,1674,1214
0132-000,2011,2,5,12,1440,641,2081,1674
0132-000,2011,2,5,13,1487,644,2131,2081
0132-000,2011,2,5,14,1747,652,2399,2131
0132-000,2011,2,5,15,1903,679,2582,2399
0132-000,2011,2,5,16,1994,686,2680,2582
0132-000,2011,2,5,17,1951,597,2548,2680
0132-000,2011,2,5,18,1824,613,2437,2548
0132-000,2011,2,5,19,1782,644,2426,2437
0132-000,2011,2,5,20,1594,498,2092,2426
0132-000,2011,2,5,21,1632,423,2055,2092
0132-000,2011,2,5,22,1545,415,1960,2055
0132-000,2011,2,5,23,1557,315,1872,1960
0132-000,2011,2,5,24,1305,247,1552,1872
0132-000,2011,2,6,1,485,194,679,1552
0132-000,2011,2,6,2,220,159,379,679
0132-000,2011,2,6,3,107,135,242,379
0132-000,2011,2,6,4,82,75,157,242
0132-000,2011,2,6,5,78,124,202,157
0132-000,2011,2,6,6,86,97,183,202
0132-000,2011,2,6,7,122,157,279,183
0132-000,2011,2,6,8,189,241,430,279
0132-000,2011,2,6,9,284,390,674,430
0132-000,2011,2,6,10,357,417,774,674
0132-000,2011,2,6,11,462,494,956,774
0132-000,2011,2,6,12,443,489,932,956
0132-000,2011,2,6,13,827,635,1462,932
0132-000,2011,2,6,14,952,617,1569,1462
0132-000,2011,2,6,15,1047,604,1651,1569
0132-000,2011,2,6,16,1188,657,1845,1651
0132-000,2011,2,6,17,1127,668,1795,1845
0132-000,2011,2,6,18,1051,595,1646,1795
0132-000,2011,2,6,19,694,573,1267,1646
0132-000,2011,2,6,20,470,450,920,1267
0132-000,2011,2,6,21,424,426,850,920
0132-000,2011,2,6,22,376,423,799,850
0132-000,2011,2,6,23,257,375,632,799
0132-000,2011,2,6,24,167,243,410,632
0132-000,2011,2,7,1,119,179,298,410
0132-000,2011,2,7,2,89,139,228,298
0132-000,2011,2,7,3,60,82,142,228
0132-000,2011,2,7,4,43,89,132,142
0132-000,2011,2,7,5,85,111,196,132
0132-000,2011,2,7,6,143,170,313,196
0132-000,2011,2,7,7,370,465,835,313
0132-000,2011,2,7,8,761,1310,2071,835
0132-000,2011,2,7,9,759,1117,1876,2071
0132-000,2011,2,7,10,636,884,1520,1876
0132-000,2011,2,7,11,729,1080,1809,1520
0132-000,2011,2,7,12,802,1058,1860,1809
0132-000,2011,2,7,13,772,972,1744,1860
0132-000,2011,2,7,14,887,985,1872,1744
0132-000,2011,2,7,15,938,961,1899,1872
0132-000,2011,2,7,16,925,875,1800,1899
0132-000,2011,2,7,17,1012,833,1845,1800
0132-000,2011,2,7,18,962,811,1773,1845
0132-000,2011,2,7,19,1114,835,1949,1773
0132-000,2011,2,7,20,834,661,1495,1949
0132-000,2011,2,7,21,687,560,1247,1495
0132-000,2011,2,7,22,554,558,1112,1247
0132-000,2011,2,7,23,372,412,784,1112
0132-000,2011,2,7,24,235,249,484,784
0132-000,2011,2,8,1,151,203,354,484
0132-000,2011,2,8,2,126,148,274,354
0132-000,2011,2,8,3,79,95,174,274
0132-000,2011,2,8,4,86,106,192,174
0132-000,2011,2,8,5,88,126,214,192
0132-000,2011,2,8,6,133,146,279,214
0132-000,2011,2,8,7,309,377,686,279
0132-000,2011,2,8,8,737,1153,1890,686
0132-000,2011,2,8,9,798,1117,1915,1890
0132-000,2011,2,8,10,836,932,1768,1915
0132-000,2011,2,8,11,778,899,1677,1768
0132-000,2011,2,8,12,856,910,1766,1677
0132-000,2011,2,8,13,789,813,1602,1766
0132-000,2011,2,8,14,886,947,1833,1602
0132-000,2011,2,8,15,972,998,1970,1833
0132-000,2011,2,8,16,976,873,1849,1970
0132-000,2011,2,8,17,1028,925,1953,1849
0132-000,2011,2,8,18,1073,901,1974,1953
0132-000,2011,2,8,19,1168,879,2047,1974
0132-000,2011,2,8,20,850,729,1579,2047
0132-000,2011,2,8,21,686,593,1279,1579
0132-000,2011,2,8,22,640,538,1178,1279
0132-000,2011,2,8,23,388,452,840,1178
0132-000,2011,2,8,24,243,263,506,840
0132-000,2011,2,9,1,176,254,430,506
0132-000,2011,2,9,2,109,152,261,430
0132-000,2011,2,9,3,81,133,214,261
0132-000,2011,2,9,4,92,97,189,214
0132-000,2011,2,9,5,75,130,205,189
0132-000,2011,2,9,6,148,155,303,205
0132-000,2011,2,9,7,313,381,694,303
0132-000,2011,2,9,8,755,1174,1929,694
0132-000,2011,2,9,9,815,1242,2057,1929
0132-000,2011,2,9,10,821,868,1689,2057
0132-000,2011,2,9,11,853,859,1712,1689
0132-000,2011,2,9,12,852,928,1780,1712
0132-000,2011,2,9,13,792,831,1623,1780
0132-000,2011,2,9,14,913,961,1874,1623
0132-000,2011,2,9,15,959,884,1843,1874
0132-000,2011,2,9,16,960,897,1857,1843
0132-000,2011,2,9,17,963,866,1829,1857
0132-000,2011,2,9,18,1030,912,1942,1829
0132-000,2011,2,9,19,1215,820,2035,1942
0132-000,2011,2,9,20,860,727,1587,2035
0132-000,2011,2,9,21,739,599,1338,1587
0132-000,2011,2,9,22,582,540,1122,1338
0132-000,2011,2,9,23,372,373,745,1122
0132-000,2011,2,9,24,254,322,576,745
0132-000,2011,2,10,1,213,251,464,576
0132-000,2011,2,10,2,140,170,310,464
0132-000,2011,2,10,3,105,145,250,310
0132-000,2011,2,10,4,118,131,249,250
0132-000,2011,2,10,5,114,152,266,249
0132-000,2011,2,10,6,179,164,343,266
0132-000,2011,2,10,7,359,411,770,343
0132-000,2011,2,10,8,794,1193,1987,770
0132-000,2011,2,10,9,872,1276,2148,1987
0132-000,2011,2,10,10,832,947,1779,2148
0132-000,2011,2,10,11,877,922,1799,1779
0132-000,2011,2,10,12,905,967,1872,1799
0132-000,2011,2,10,13,836,890,1726,1872
0132-000,2011,2,10,14,914,941,1855,1726
0132-000,2011,2,10,15,1019,939,1958,1855
0132-000,2011,2,10,16,1043,920,1963,1958
0132-000,2011,2,10,17,1020,919,1939,1963
0132-000,2011,2,10,18,1159,955,2114,1939
0132-000,2011,2,10,19,1373,899,2272,2114
0132-000,2011,2,10,20,1001,823,1824,2272
0132-000,2011,2,10,21,819,680,1499,1824
0132-000,2011,2,10,22,669,619,1288,1499
0132-000,2011,2,10,23,444,455,899,1288
0132-000,2011,2,10,24,325,354,679,899
0132-000,2011,2,11,1,250,247,497,679
0132-000,2011,2,11,2,171,188,359,497
0132-000,2011,2,11,3,128,157,285,359
0132-000,2011,2,11,4,144,165,309,285
0132-000,2011,2,11,5,153,174,327,309
0132-000,2011,2,11,6,210,172,382,327
0132-000,2011,2,11,7,404,440,844,382
0132-000,2011,2,11,8,833,1212,2045,844
0132-000,2011,2,11,9,929,1309,2238,2045
0132-000,2011,2,11,10,842,1025,1867,2238
0132-000,2011,2,11,11,901,985,1886,1867
0132-000,2011,2,11,12,957,1005,1962,1886
0132-000,2011,2,11,13,879,948,1827,1962
0132-000,2011,2,11,14,914,920,1834,1827
0132-000,2011,2,11,15,1079,994,2073,1834
0132-000,2011,2,11,16,1125,943,2068,2073
0132-000,2011,2,11,17,1076,971,2047,2068
0132-000,2011,2,11,18,1287,997,2284,2047
0132-000,2011,2,11,19,1531,977,2508,2284
0132-000,2011,2,11,20,1142,919,2061,2508
0132-000,2011,2,11,21,898,760,1658,2061
0132-000,2011,2,11,22,756,698,1454,1658
0132-000,2011,2,11,23,515,536,1051,1454
0132-000,2011,2,11,24,396,386,782,1051
0132-000,2011,2,12,1,296,331,627,782
0132-000,2011,2,12,2,242,263,505,627
0132-000,2011,2,12,3,200,231,431,505
0132-000,2011,2,12,4,191,214,405,431
0132-000,2011,2,12,5,199,218,417,405
0132-000,2011,2,12,6,254,215,469,417
0132-000,2011,2,12,7,363,377,740,469
0132-000,2011,2,12,8,656,827,1483,740
0132-000,2011,2,12,9,792,996,1788,1483
0132-000,2011,2,12,10,815,926,1741,1788
0132-000,2011,2,12,11,862,1009,1871,1741
0132-000,2011,2,12,12,1056,1050,2106,1871
0132-000,2011,2,12,13,1077,1122,2199,2106
0132-000,2011,2,12,14,1075,1095,2170,2199
0132-000,2011,2,12,15,1064,1186,2250,2170
0132-000,2011,2,12,16,1164,1190,2354,2250
0132-000,2011,2,12,17,1347,1180,2527,2354
0132-000,2011,2,12,18,1539,1238,2777,2527
0132-000,2011,2,12,19,1428,1107,2535,2777
0132-000,2011,2,12,20,931,920,1851,2535
0132-000,2011,2,12,21,707,652,1359,1851
0132-000,2011,2,12,22,585,579,1164,1359
0132-000,2011,2,12,23,386,435,821,1164
0132-000,2011,2,12,24,292,335,627,821
0132-000,2011,2,13,1,219,284,503,627
0132-000,2011,2,13,2,179,196,375,503
0132-000,2011,2,13,3,144,157,301,375
0132-000,2011,2,13,4,127,151,278,301
0132-000,2011,2,13,5,142,121,263,278
0132-000,2011,2,13,6,120,155,275,263
0132-000,2011,2,13,7,186,210,396,275
0132-000,2011,2,13,8,288,355,643,396
0132-000,2011,2,13,9,380,531,911,643
0132-000,2011,2,13,10,445,544,989,911
0132-000,2011,2,13,11,566,699,1265,989
0132-000,2011,2,13,12,596,655,1251,1265
0132-000,2011,2,13,13,739,754,1493,1251
0132-000,2011,2,13,14,850,796,1646,1493
0132-000,2011,2,13,15,926,840,1766,1646
0132-000,2011,2,13,16,1041,864,1905,1766
0132-000,2011,2,13,17,1174,915,2089,1905
0132-000,2011,2,13,18,1247,920,2167,2089
0132-000,2011,2,13,19,1129,778,1907,2167
0132-000,2011,2,13,20,1041,690,1731,1907
0132-000,2011,2,13,21,826,582,1408,1731
0132-000,2011,2,13,22,674,517,1191,1408
0132-000,2011,2,13,23,324,415,739,1191
0132-000,2011,2,13,24,198,240,438,739
0132-000,2011,2,14,1,138,186,324,438
0132-000,2011,2,14,2,99,142,241,324
0132-000,2011,2,14,3,88,100,188,241
0132-000,2011,2,14,4,96,95,191,188
0132-000,2011,2,14,5,138,144,282,191
0132-000,2011,2,14,6,204,215,419,282
0132-000,2011,2,14,7,437,562,999,419
0132-000,2011,2,14,8,849,1463,2312,999
0132-000,2011,2,14,9,857,1367,2224,2312
0132-000,2011,2,14,10,846,1018,1864,2224
0132-000,2011,2,14,11,883,965,1848,1864
0132-000,2011,2,14,12,929,1012,1941,1848
0132-000,2011,2,14,13,876,953,1829,1941
0132-000,2011,2,14,14,929,972,1901,1829
0132-000,2011,2,14,15,1025,988,2013,1901
0132-000,2011,2,14,16,1041,1044,2085,2013
0132-000,2011,2,14,17,1047,988,2035,2085
0132-000,2011,2,14,18,1221,927,2148,2035
0132-000,2011,2,14,19,1234,948,2182,2148
0132-000,2011,2,14,20,940,832,1772,2182
0132-000,2011,2,14,21,795,659,1454,1772
0132-000,2011,2,14,22,719,606,1325,1454
0132-000,2011,2,14,23,449,471,920,1325
0132-000,2011,2,14,24,344,327,671,920
0132-000,2011,2,15,1,251,279,530,671
0132-000,2011,2,15,2,171,222,393,530
0132-000,2011,2,15,3,162,171,333,393
0132-000,2011,2,15,4,138,148,286,333
0132-000,2011,2,15,5,153,166,319,286
0132-000,2011,2,15,6,208,180,388,319
0132-000,2011,2,15,7,320,400,720,388
0132-000,2011,2,15,8,646,975,1621,720
0132-000,2011,2,15,9,708,1143,1851,1621
0132-000,2011,2,15,10,761,822,1583,1851
0132-000,2011,2,15,11,826,877,1703,1583
0132-000,2011,2,15,12,814,971,1785,1703
0132-000,2011,2,15,13,763,1010,1773,1785
0132-000,2011,2,15,14,903,998,1901,1773
0132-000,2011,2,15,15,969,1068,2037,1901
0132-000,2011,2,15,16,1022,1037,2059,2037
0132-000,2011,2,15,17,1190,1043,2233,2059
0132-000,2011,2,15,18,1378,1004,2382,2233
0132-000,2011,2,15,19,1326,927,2253,2382
0132-000,2011,2,15,20,1157,709,1866,2253
0132-000,2011,2,15,21,909,616,1525,1866
0132-000,2011,2,15,22,656,563,1219,1525
0132-000,2011,2,15,23,416,415,831,1219
0132-000,2011,2,15,24,291,299,590,831
0132-000,2011,2,16,1,287,313,600,590
0132-000,2011,2,16,2,229,223,452,600
0132-000,2011,2,16,3,194,210,404,452
0132-000,2011,2,16,4,218,192,410,404
0132-000,2011,2,16,5,222,196,418,410
0132-000,2011,2,16,6,276,278,554,418
0132-000,2011,2,16,7,451,489,940,554
0132-000,2011,2,16,8,857,1196,2053,940
0132-000,2011,2,16,9,936,1348,2284,2053
0132-000,2011,2,16,10,889,974,1863,2284
0132-000,2011,2,16,11,954,989,1943,1863
0132-000,2011,2,16,12,908,941,1849,1943
0132-000,2011,2,16,13,795,868,1663,1849
0132-000,2011,2,16,14,975,985,1960,1663
0132-000,2011,2,16,15,1035,1038,2073,1960
0132-000,2011,2,16,16,1056,958,2014,2073
0132-000,2011,2,16,17,1036,917,1953,2014
0132-000,2011,2,16,18,1196,976,2172,1953
0132-000,2011,2,16,19,1219,864,2083,2172
0132-000,2011,2,16,20,966,740,1706,2083
0132-000,2011,2,16,21,810,679,1489,1706
0132-000,2011,2,16,22,604,646,1250,1489
0132-000,2011,2,16,23,438,430,868,1250
0132-000,2011,2,16,24,354,357,711,868
0132-000,2011,2,17,1,217,252,469,711
0132-000,2011,2,17,2,167,146,313,469
0132-000,2011,2,17,3,145,144,289,313
0132-000,2011,2,17,4,131,144,275,289
0132-000,2011,2,17,5,140,183,323,275
0132-000,2011,2,17,6,211,205,416,323
0132-000,2011,2,17,7,382,370,752,416
0132-000,2011,2,17,8,777,1115,1892,752
0132-000,2011,2,17,9,799,1199,1998,1892
0132-000,2011,2,17,10,845,989,1834,1998
0132-000,2011,2,17,11,842,908,1750,1834
0132-000,2011,2,17,12,884,972,1856,1750
0132-000,2011,2,17,13,778,818,1596,1856
0132-000,2011,2,17,14,975,976,1951,1596
0132-000,2011,2,17,15,1052,1060,2112,1951
0132-000,2011,2,17,16,1146,877,2023,2112
0132-000,2011,2,17,17,1050,914,1964,2023
0132-000,2011,2,17,18,1106,888,1994,1964
0132-000,2011,2,17,19,1166,804,1970,1994
0132-000,2011,2,17,20,863,734,1597,1970
0132-000,2011,2,17,21,762,659,1421,1597
0132-000,2011,2,17,22,721,611,1332,1421
0132-000,2011,2,17,23,452,465,917,1332
0132-000,2011,2,17,24,341,311,652,917
0132-000,2011,2,18,1,286,271,557,652
0132-000,2011,2,18,2,200,181,381,557
0132-000,2011,2,18,3,204,177,381,381
0132-000,2011,2,18,4,180,185,365,381
0132-000,2011,2,18,5,212,201,413,365
0132-000,2011,2,18,6,267,177,444,413
0132-000,2011,2,18,7,433,481,914,444
0132-000,2011,2,18,8,825,1146,1971,914
0132-000,2011,2,18,9,912,1227,2139,1971
0132-000,2011,2,18,10,872,978,1850,2139
0132-000,2011,2,18,11,903,1044,1947,1850
0132-000,2011,2,18,12,921,1042,1963,1947
0132-000,2011,2,18,13,888,866,1754,1963
0132-000,2011,2,18,14,959,1000,1959,1754
0132-000,2011,2,18,15,1096,963,2059,1959
0132-000,2011,2,18,16,1068,925,1993,2059
0132-000,2011,2,18,17,1082,945,2027,1993
0132-000,2011,2,18,18,1170,908,2078,2027
0132-000,2011,2,18,19,1407,965,2372,2078
0132-000,2011,2,18,20,1095,813,1908,2372
0132-000,2011,2,18,21,866,657,1523,1908
0132-000,2011,2,18,22,714,628,1342,1523
0132-000,2011,2,18,23,516,463,979,1342
0132-000,2011,2,18,24,365,395,760,979
0132-000,2011,2,19,1,327,335,662,760
0132-000,2011,2,19,2,282,238,520,662
0132-000,2011,2,19,3,215,252,467,520
0132-000,2011,2,19,4,192,210,402,467
0132-000,2011,2,19,5,192,212,404,402
0132-000,2011,2,19,6,272,254,526,404
0132-000,2011,2,19,7,372,362,734,526
0132-000,2011,2,19,8,633,756,1389,734
0132-000,2011,2,19,9,755,936,1691,1389
0132-000,2011,2,19,10,821,952,1773,1691
0132-000,2011,2,19,11,911,950,1861,1773
0132-000,2011,2,19,12,907,1042,1949,1861
0132-000,2011,2,19,13,969,1058,2027,1949
0132-000,2011,2,19,14,1134,1106,2240,2027
0132-000,2011,2,19,15,1200,1110,2310,2240
0132-000,2011,2,19,16,1384,1115,2499,2310
0132-000,2011,2,19,17,1505,1097,2602,2499
0132-000,2011,2,19,18,1653,1157,2810,2602
0132-000,2011,2,19,19,1623,1126,2749,2810
0132-000,2011,2,19,20,1335,807,2142,2749
0132-000,2011,2,19,21,960,635,1595,2142
0132-000,2011,2,19,22,596,599,1195,1595
0132-000,2011,2,19,23,468,478,946,1195
0132-000,2011,2,19,24,314,408,722,946
0132-000,2011,2,20,1,268,351,619,722
0132-000,2011,2,20,2,236,234,470,619
0132-000,2011,2,20,3,190,203,393,470
0132-000,2011,2,20,4,165,166,331,393
0132-000,2011,2,20,5,170,174,344,331
0132-000,2011,2,20,6,210,179,389,344
0132-000,2011,2,20,7,292,252,544,389
0132-000,2011,2,20,8,369,441,810,544
0132-000,2011,2,20,9,476,553,1029,810
0132-000,2011,2,20,10,510,608,1118,1029
0132-000,2011,2,20,11,586,694,1280,1118
0132-000,2011,2,20,12,587,699,1286,1280
0132-000,2011,2,20,13,637,688,1325,1286
0132-000,2011,2,20,14,758,679,1437,1325
0132-000,2011,2,20,15,837,773,1610,1437
0132-000,2011,2,20,16,912,792,1704,1610
0132-000,2011,2,20,17,1245,760,2005,1704
0132-000,2011,2,20,18,1365,778,2143,2005
0132-000,2011,2,20,19,1340,751,2091,2143
0132-000,2011,2,20,20,916,633,1549,2091
0132-000,2011,2,20,21,626,584,1210,1549
0132-000,2011,2,20,22,481,571,1052,1210
0132-000,2011,2,20,23,351,439,790,1052
0132-000,2011,2,20,24,248,302,550,790
0132-000,2011,2,21,1,165,203,368,550
0132-000,2011,2,21,2,102,108,210,368
0132-000,2011,2,21,3,99,102,201,210
0132-000,2011,2,21,4,114,119,233,201
0132-000,2011,2,21,5,149,163,312,233
0132-000,2011,2,21,6,242,208,450,312
0132-000,2011,2,21,7,484,571,1055,450
0132-000,2011,2,21,8,878,1399,2277,1055
0132-000,2011,2,21,9,888,1383,2271,2277
0132-000,2011,2,21,10,828,989,1817,2271
0132-000,2011,2,21,11,841,954,1795,1817
0132-000,2011,2,21,12,864,921,1785,1795
0132-000,2011,2,21,13,838,888,1726,1785
0132-000,2011,2,21,14,952,934,1886,1726
0132-000,2011,2,21,15,1040,1084,2124,1886
0132-000,2011,2,21,16,979,998,1977,2124
0132-000,2011,2,21,17,1047,853,1900,1977
0132-000,2011,2,21,18,1088,932,2020,1900
0132-000,2011,2,21,19,1161,853,2014,2020
0132-000,2011,2,21,20,960,833,1793,2014
0132-000,2011,2,21,21,752,652,1404,1793
0132-000,2011,2,21,22,638,569,1207,1404
0132-000,2011,2,21,23,406,430,836,1207
0132-000,2011,2,21,24,327,304,631,836
0132-000,2011,2,22,1,220,249,469,631
0132-000,2011,2,22,2,203,196,399,469
0132-000,2011,2,22,3,138,172,310,399
0132-000,2011,2,22,4,197,150,347,310
0132-000,2011,2,22,5,187,188,375,347
0132-000,2011,2,22,6,279,210,489,375
0132-000,2011,2,22,7,480,492,972,489
0132-000,2011,2,22,8,853,1203,2056,972
0132-000,2011,2,22,9,898,1290,2188,2056
0132-000,2011,2,22,10,908,1022,1930,2188
0132-000,2011,2,22,11,915,1009,1924,1930
0132-000,2011,2,22,12,869,961,1830,1924
0132-000,2011,2,22,13,827,862,1689,1830
0132-000,2011,2,22,14,972,972,1944,1689
0132-000,2011,2,22,15,1002,945,1947,1944
0132-000,2011,2,22,16,1045,1093,2138,1947
0132-000,2011,2,22,17,1037,877,1914,2138
0132-000,2011,2,22,18,1157,978,2135,1914
0132-000,2011,2,22,19,1205,943,2148,2135
0132-000,2011,2,22,20,900,780,1680,2148
0132-000,2011,2,22,21,789,672,1461,1680
0132-000,2011,2,22,22,679,617,1296,1461
0132-000,2011,2,22,23,440,450,890,1296
0132-000,2011,2,22,24,321,300,621,890
0132-000,2011,2,23,1,241,245,486,621
0132-000,2011,2,23,2,182,199,381,486
0132-000,2011,2,23,3,165,170,335,381
0132-000,2011,2,23,4,181,146,327,335
0132-000,2011,2,23,5,158,159,317,327
0132-000,2011,2,23,6,254,183,437,317
0132-000,2011,2,23,7,427,483,910,437
0132-000,2011,2,23,8,784,1183,1967,910
0132-000,2011,2,23,9,936,1307,2243,1967
0132-000,2011,2,23,10,896,965,1861,2243
0132-000,2011,2,23,11,875,921,1796,1861
0132-000,2011,2,23,12,893,936,1829,1796
0132-000,2011,2,23,13,848,892,1740,1829
0132-000,2011,2,23,14,905,994,1899,1740
0132-000,2011,2,23,15,1013,1036,2049,1899
0132-000,2011,2,23,16,1096,928,2024,2049
0132-000,2011,2,23,17,1098,972,2070,2024
0132-000,2011,2,23,18,1252,936,2188,2070
0132-000,2011,2,23,19,1254,952,2206,2188
0132-000,2011,2,23,20,891,771,1662,2206
0132-000,2011,2,23,21,785,650,1435,1662
0132-000,2011,2,23,22,627,547,1174,1435
0132-000,2011,2,23,23,468,483,951,1174
0132-000,2011,2,23,24,311,315,626,951
0132-000,2011,2,24,1,258,302,560,626
0132-000,2011,2,24,2,186,208,394,560
0132-000,2011,2,24,3,172,172,344,394
0132-000,2011,2,24,4,173,157,330,344
0132-000,2011,2,24,5,191,208,399,330
0132-000,2011,2,24,6,248,232,480,399
0132-000,2011,2,24,7,413,465,878,480
0132-000,2011,2,24,8,848,1216,2064,878
0132-000,2011,2,24,9,926,1270,2196,2064
0132-000,2011,2,24,10,832,1051,1883,2196
0132-000,2011,2,24,11,919,1042,1961,1883
0132-000,2011,2,24,12,916,974,1890,1961
0132-000,2011,2,24,13,847,881,1728,1890
0132-000,2011,2,24,14,1094,1020,2114,1728
0132-000,2011,2,24,15,1032,1038,2070,2114
0132-000,2011,2,24,16,1096,914,2010,2070
0132-000,2011,2,24,17,1145,1005,2150,2010
0132-000,2011,2,24,18,1195,925,2120,2150
0132-000,2011,2,24,19,1218,998,2216,2120
0132-000,2011,2,24,20,918,802,1720,2216
0132-000,2011,2,24,21,833,628,1461,1720
0132-000,2011,2,24,22,691,575,1266,1461
0132-000,2011,2,24,23,414,397,811,1266
0132-000,2011,2,24,24,310,307,617,811
0132-000,2011,2,25,1,245,203,448,617
0132-000,2011,2,25,2,134,155,289,448
0132-000,2011,2,25,3,108,133,241,289
0132-000,2011,2,25,4,117,144,261,241
0132-000,2011,2,25,5,135,155,290,261
0132-000,2011,2,25,6,181,148,329,290
0132-000,2011,2,25,7,400,426,826,329
0132-000,2011,2,25,8,809,1179,1988,826
0132-000,2011,2,25,9,926,1284,2210,1988
0132-000,2011,2,25,10,871,1066,1937,2210
0132-000,2011,2,25,11,924,963,1887,1937
0132-000,2011,2,25,12,965,1033,1998,1887
0132-000,2011,2,25,13,962,934,1896,1998
0132-000,2011,2,25,14,953,958,1911,1896
0132-000,2011,2,25,15,1080,1018,2098,1911
0132-000,2011,2,25,16,1111,965,2076,2098
0132-000,2011,2,25,17,1102,1014,2116,2076
0132-000,2011,2,25,18,1310,1005,2315,2116
0132-000,2011,2,25,19,1558,996,2554,2315
0132-000,2011,2,25,20,1170,1033,2203,2554
0132-000,2011,2,25,21,952,862,1814,2203
0132-000,2011,2,25,22,742,718,1460,1814
0132-000,2011,2,25,23,528,527,1055,1460
0132-000,2011,2,25,24,388,390,778,1055
0132-000,2011,2,26,1,285,331,616,778
0132-000,2011,2,26,2,246,282,528,616
0132-000,2011,2,26,3,213,247,460,528
0132-000,2011,2,26,4,207,234,441,460
0132-000,2011,2,26,5,199,236,435,441
0132-000,2011,2,26,6,255,241,496,435
0132-000,2011,2,26,7,359,355,714,496
0132-000,2011,2,26,8,625,787,1412,714
0132-000,2011,2,26,9,805,1003,1808,1412
0132-000,2011,2,26,10,845,961,1806,1808
0132-000,2011,2,26,11,885,1115,2000,1806
0132-000,2011,2,26,12,1171,1163,2334,2000
0132-000,2011,2,26,13,1214,1267,2481,2334
0132-000,2011,2,26,14,1219,1276,2495,2481
0132-000,2011,2,26,15,1138,1443,2581,2495
0132-000,2011,2,26,16,1279,1392,2671,2581
0132-000,2011,2,26,17,1315,1412,2727,2671
0132-000,2011,2,26,18,1554,1450,3004,2727
0132-000,2011,2,26,19,1494,1262,2756,3004
0132-000,2011,2,26,20,986,1110,2096,2756
0132-000,2011,2,26,21,703,679,1382,2096
0132-000,2011,2,26,22,618,575,1193,1382
0132-000,2011,2,26,23,378,450,828,1193
0132-000,2011,2,26,24,256,300,556,828
0132-000,2011,2,27,1,218,302,520,556
0132-000,2011,2,27,2,151,199,350,520
0132-000,2011,2,27,3,116,166,282,350
0132-000,2011,2,27,4,110,130,240,282
0132-000,2011,2,27,5,112,100,212,240
0132-000,2011,2,27,6,112,150,262,212
0132-000,2011,2,27,7,149,179,328,262
0132-000,2011,2,27,8,248,326,574,328
0132-000,2011,2,27,9,374,443,817,574
0132-000,2011,2,27,10,430,511,941,817
0132-000,2011,2,27,11,556,648,1204,941
0132-000,2011,2,27,12,628,646,1274,1204
0132-000,2011,2,27,13,829,802,1631,1274
0132-000,2011,2,27,14,990,833,1823,1631
0132-000,2011,2,27,15,1055,941,1996,1823
0132-000,2011,2,27,16,1227,945,2172,1996
0132-000,2011,2,27,17,1314,1028,2342,2172
0132-000,2011,2,27,18,1448,1036,2484,2342
0132-000,2011,2,27,19,1283,903,2186,2484
0132-000,2011,2,27,20,1289,754,2043,2186
0132-000,2011,2,27,21,1074,604,1678,2043
0132-000,2011,2,27,22,859,531,1390,1678
0132-000,2011,2,27,23,315,377,692,1390
0132-000,2011,2,27,24,189,236,425,692
0132-000,2011,2,28,1,147,188,335,425
0132-000,2011,2,28,2,85,148,233,335
0132-000,2011,2,28,3,89,91,180,233
0132-000,2011,2,28,4,96,82,178,180
0132-000,2011,2,28,5,122,146,268,178
0132-000,2011,2,28,6,187,194,381,268
0132-000,2011,2,28,7,439,525,964,381
0132-000,2011,2,28,8,790,1435,2225,964
0132-000,2011,2,28,9,851,1232,2083,2225
0132-000,2011,2,28,10,827,989,1816,2083
0132-000,2011,2,28,11,891,1018,1909,1816
0132-000,2011,2,28,12,958,1047,2005,1909
0132-000,2011,2,28,13,922,965,1887,2005
0132-000,2011,2,28,14,919,991,1910,1887
0132-000,2011,2,28,15,1050,1053,2103,1910
0132-000,2011,2,28,16,1088,1110,2198,2103
0132-000,2011,2,28,17,1055,1022,2077,2198
0132-000,2011,2,28,18,1224,923,2147,2077
0132-000,2011,2,28,19,1269,967,2236,2147
0132-000,2011,2,28,20,1005,840,1845,2236
0132-000,2011,2,28,21,804,624,1428,1845
0132-000,2011,2,28,22,694,630,1324,1428
0132-000,2011,2,28,23,448,494,942,1324
0132-000,2011,2,28,24,349,366,715,942
0132-000,2011,3,1,1,246,300,546,715
0132-000,2011,3,1,2,194,265,459,546
0132-000,2011,3,1,3,159,183,342,459
0132-000,2011,3,1,4,109,152,261,342
0132-000,2011,3,1,5,114,139,253,261
0132-000,2011,3,1,6,164,166,330,253
0132-000,2011,3,1,7,242,293,535,330
0132-000,2011,3,1,8,459,637,1096,535
0132-000,2011,3,1,9,527,765,1292,1096
0132-000,2011,3,1,10,632,628,1260,1292
0132-000,2011,3,1,11,723,787,1510,1260
0132-000,2011,3,1,12,749,1011,1760,1510
0132-000,2011,3,1,13,770,1040,1810,1760
0132-000,2011,3,1,14,869,1060,1929,1810
0132-000,2011,3,1,15,921,1113,2034,1929
0132-000,2011,3,1,16,992,1126,2118,2034
0132-000,2011,3,1,17,1287,1136,2423,2118
0132-000,2011,3,1,18,1506,1062,2568,2423
0132-000,2011,3,1,19,1488,897,2385,2568
0132-000,2011,3,1,20,1327,641,1968,2385
0132-000,2011,3,1,21,1035,555,1590,1968
0132-000,2011,3,1,22,567,529,1096,1590
0132-000,2011,3,1,23,361,390,751,1096
0132-000,2011,3,1,24,241,298,539,751
0132-000,2011,3,2,1,227,227,454,539
0132-000,2011,3,2,2,169,144,313,454
0132-000,2011,3,2,3,136,128,264,313
0132-000,2011,3,2,4,131,157,288,264
0132-000,2011,3,2,5,136,148,284,288
0132-000,2011,3,2,6,190,212,402,284
0132-000,2011,3,2,7,456,489,945,402
0132-000,2011,3,2,8,858,1315,2173,945
0132-000,2011,3,2,9,855,1471,2326,2173
0132-000,2011,3,2,10,864,1036,1900,2326
0132-000,2011,3,2,11,877,996,1873,1900
0132-000,2011,3,2,12,900,859,1759,1873
0132-000,2011,3,2,13,816,879,1695,1759
0132-000,2011,3,2,14,912,983,1895,1695
0132-000,2011,3,2,15,1047,1062,2109,1895
0132-000,2011,3,2,16,1095,1051,2146,2109
0132-000,2011,3,2,17,1085,974,2059,2146
0132-000,2011,3,2,18,1173,875,2048,2059
0132-000,2011,3,2,19,1310,912,2222,2048
0132-000,2011,3,2,20,968,804,1772,2222
0132-000,2011,3,2,21,791,648,1439,1772
0132-000,2011,3,2,22,645,562,1207,1439
0132-000,2011,3,2,23,457,434,891,1207
0132-000,2011,3,2,24,318,311,629,891
0132-000,2011,3,3,1,234,225,459,629
0132-000,2011,3,3,2,192,205,397,459
0132-000,2011,3,3,3,166,174,340,397
0132-000,2011,3,3,4,171,183,354,340
0132-000,2011,3,3,5,195,161,356,354
0132-000,2011,3,3,6,241,227,468,356
0132-000,2011,3,3,7,431,472,903,468
0132-000,2011,3,3,8,874,1251,2125,903
0132-000,2011,3,3,9,893,1403,2296,2125
0132-000,2011,3,3,10,886,1027,1913,2296
0132-000,2011,3,3,11,903,1000,1903,1913
0132-000,2011,3,3,12,913,932,1845,1903
0132-000,2011,3,3,13,832,848,1680,1845
0132-000,2011,3,3,14,979,963,1942,1680
0132-000,2011,3,3,15,1072,987,2059,1942
0132-000,2011,3,3,16,1106,989,2095,2059
0132-000,2011,3,3,17,1109,976,2085,2095
0132-000,2011,3,3,18,1167,980,2147,2085
0132-000,2011,3,3,19,1283,835,2118,2147
0132-000,2011,3,3,20,937,875,1812,2118
0132-000,2011,3,3,21,809,677,1486,1812
0132-000,2011,3,3,22,725,577,1302,1486
0132-000,2011,3,3,23,469,437,906,1302
0132-000,2011,3,3,24,324,331,655,906
0132-000,2011,3,4,1,254,291,545,655
0132-000,2011,3,4,2,207,221,428,545
0132-000,2011,3,4,3,148,181,329,428
0132-000,2011,3,4,4,170,185,355,329
0132-000,2011,3,4,5,171,192,363,355
0132-000,2011,3,4,6,238,196,434,363
0132-000,2011,3,4,7,407,454,861,434
0132-000,2011,3,4,8,856,1245,2101,861
0132-000,2011,3,4,9,932,1334,2266,2101
0132-000,2011,3,4,10,812,983,1795,2266
0132-000,2011,3,4,11,877,1007,1884,1795
0132-000,2011,3,4,12,948,976,1924,1884
0132-000,2011,3,4,13,795,961,1756,1924
0132-000,2011,3,4,14,874,881,1755,1756
0132-000,2011,3,4,15,1078,969,2047,1755
0132-000,2011,3,4,16,1139,921,2060,2047
0132-000,2011,3,4,17,1049,928,1977,2060
0132-000,2011,3,4,18,1264,989,2253,1977
0132-000,2011,3,4,19,1504,958,2462,2253
0132-000,2011,3,4,20,1113,804,1917,2462
0132-000,2011,3,4,21,844,657,1501,1917
0132-000,2011,3,4,22,770,677,1447,1501
0132-000,2011,3,4,23,501,544,1045,1447
0132-000,2011,3,4,24,403,381,784,1045
0132-000,2011,3,5,1,307,331,638,784
0132-000,2011,3,5,2,237,243,480,638
0132-000,2011,3,5,3,187,214,401,480
0132-000,2011,3,5,4,175,194,369,401
0132-000,2011,3,5,5,199,199,398,369
0132-000,2011,3,5,6,252,188,440,398
0132-000,2011,3,5,7,366,399,765,440
0132-000,2011,3,5,8,687,866,1553,765
0132-000,2011,3,5,9,778,989,1767,1553
0132-000,2011,3,5,10,785,890,1675,1767
0132-000,2011,3,5,11,839,903,1742,1675
0132-000,2011,3,5,12,941,936,1877,1742
0132-000,2011,3,5,13,940,976,1916,1877
0132-000,2011,3,5,14,930,914,1844,1916
0132-000,2011,3,5,15,989,928,1917,1844
0132-000,2011,3,5,16,1048,987,2035,1917
0132-000,2011,3,5,17,1379,947,2326,2035
0132-000,2011,3,5,18,1523,1025,2548,2326
0132-000,2011,3,5,19,1361,952,2313,2548
0132-000,2011,3,5,20,876,729,1605,2313
0132-000,2011,3,5,21,710,624,1334,1605
0132-000,2011,3,5,22,551,582,1133,1334
0132-000,2011,3,5,23,393,419,812,1133
0132-000,2011,3,5,24,327,370,697,812
0132-000,2011,3,6,1,220,265,485,697
0132-000,2011,3,6,2,207,192,399,485
0132-000,2011,3,6,3,172,148,320,399
0132-000,2011,3,6,4,143,172,315,320
0132-000,2011,3,6,5,172,141,313,315
0132-000,2011,3,6,6,127,159,286,313
0132-000,2011,3,6,7,223,241,464,286
0132-000,2011,3,6,8,328,384,712,464
0132-000,2011,3,6,9,385,619,1004,712
0132-000,2011,3,6,10,460,577,1037,1004
0132-000,2011,3,6,11,575,749,1324,1037
0132-000,2011,3,6,12,563,663,1226,1324
0132-000,2011,3,6,13,649,705,1354,1226
0132-000,2011,3,6,14,709,758,1467,1354
0132-000,2011,3,6,15,796,738,1534,1467
0132-000,2011,3,6,16,854,782,1636,1534
0132-000,2011,3,6,17,1034,801,1835,1636
0132-000,2011,3,6,18,1045,804,1849,1835
0132-000,2011,3,6,19,975,652,1627,1849
0132-000,2011,3,6,20,792,626,1418,1627
0132-000,2011,3,6,21,578,560,1138,1418
0132-000,2011,3,6,22,488,503,991,1138
0132-000,2011,3,6,23,333,452,785,991
0132-000,2011,3,6,24,206,243,449,785
0132-000,2011,3,7,1,128,183,311,449
0132-000,2011,3,7,2,112,135,247,311
0132-000,2011,3,7,3,87,108,195,247
0132-000,2011,3,7,4,95,108,203,195
0132-000,2011,3,7,5,154,141,295,203
0132-000,2011,3,7,6,221,236,457,295
0132-000,2011,3,7,7,434,599,1033,457
0132-000,2011,3,7,8,907,1491,2398,1033
0132-000,2011,3,7,9,862,1501,2363,2398
0132-000,2011,3,7,10,865,1047,1912,2363
0132-000,2011,3,7,11,874,912,1786,1912
0132-000,2011,3,7,12,899,976,1875,1786
0132-000,2011,3,7,13,830,941,1771,1875
0132-000,2011,3,7,14,938,952,1890,1771
0132-000,2011,3,7,15,1000,923,1923,1890
0132-000,2011,3,7,16,993,978,1971,1923
0132-000,2011,3,7,17,1039,954,1993,1971
0132-000,2011,3,7,18,1217,930,2147,1993
0132-000,2011,3,7,19,1198,928,2126,2147
0132-000,2011,3,7,20,875,824,1699,2126
0132-000,2011,3,7,21,786,694,1480,1699
0132-000,2011,3,7,22,744,582,1326,1480
0132-000,2011,3,7,23,450,448,898,1326
0132-000,2011,3,7,24,338,287,625,898
0132-000,2011,3,8,1,256,258,514,625
0132-000,2011,3,8,2,148,179,327,514
0132-000,2011,3,8,3,165,159,324,327
0132-000,2011,3,8,4,166,144,310,324
0132-000,2011,3,8,5,191,192,383,310
0132-000,2011,3,8,6,251,194,445,383
0132-000,2011,3,8,7,398,507,905,445
0132-000,2011,3,8,8,833,1313,2146,905
0132-000,2011,3,8,9,889,1520,2409,2146
0132-000,2011,3,8,10,889,1016,1905,2409
0132-000,2011,3,8,11,929,967,1896,1905
0132-000,2011,3,8,12,878,930,1808,1896
0132-000,2011,3,8,13,755,980,1735,1808
0132-000,2011,3,8,14,936,936,1872,1735
0132-000,2011,3,8,15,1016,1022,2038,1872
0132-000,2011,3,8,16,1052,947,1999,2038
0132-000,2011,3,8,17,1092,950,2042,1999
0132-000,2011,3,8,18,1250,945,2195,2042
0132-000,2011,3,8,19,1164,956,2120,2195
0132-000,2011,3,8,20,986,776,1762,2120
0132-000,2011,3,8,21,782,677,1459,1762
0132-000,2011,3,8,22,744,597,1341,1459
0132-000,2011,3,8,23,471,439,910,1341
0132-000,2011,3,8,24,341,300,641,910
0132-000,2011,3,9,1,244,227,471,641
0132-000,2011,3,9,2,190,196,386,471
0132-000,2011,3,9,3,144,179,323,386
0132-000,2011,3,9,4,165,159,324,323
0132-000,2011,3,9,5,166,177,343,324
0132-000,2011,3,9,6,208,185,393,343
0132-000,2011,3,9,7,420,456,876,393
0132-000,2011,3,9,8,850,1256,2106,876
0132-000,2011,3,9,9,876,1415,2291,2106
0132-000,2011,3,9,10,868,1062,1930,2291
0132-000,2011,3,9,11,873,939,1812,1930
0132-000,2011,3,9,12,927,892,1819,1812
0132-000,2011,3,9,13,821,908,1729,1819
0132-000,2011,3,9,14,952,1025,1977,1729
0132-000,2011,3,9,15,982,954,1936,1977
0132-000,2011,3,9,16,1021,965,1986,1936
0132-000,2011,3,9,17,1021,985,2006,1986
0132-000,2011,3,9,18,1269,930,2199,2006
0132-000,2011,3,9,19,1309,910,2219,2199
0132-000,2011,3,9,20,927,813,1740,2219
0132-000,2011,3,9,21,771,626,1397,1740
0132-000,2011,3,9,22,642,549,1191,1397
0132-000,2011,3,9,23,412,441,853,1191
0132-000,2011,3,9,24,328,285,613,853
0132-000,2011,3,10,1,251,216,467,613
0132-000,2011,3,10,2,183,225,408,467
0132-000,2011,3,10,3,143,159,302,408
0132-000,2011,3,10,4,157,159,316,302
0132-000,2011,3,10,5,171,159,330,316
0132-000,2011,3,10,6,274,214,488,330
0132-000,2011,3,10,7,431,485,916,488
0132-000,2011,3,10,8,900,1344,2244,916
0132-000,2011,3,10,9,890,1392,2282,2244
0132-000,2011,3,10,10,865,1027,1892,2282
0132-000,2011,3,10,11,816,958,1774,1892
0132-000,2011,3,10,12,890,888,1778,1774
0132-000,2011,3,10,13,811,855,1666,1778
0132-000,2011,3,10,14,873,925,1798,1666
0132-000,2011,3,10,15,1042,1011,2053,1798
0132-000,2011,3,10,16,1047,947,1994,2053
0132-000,2011,3,10,17,1156,921,2077,1994
0132-000,2011,3,10,18,1291,908,2199,2077
0132-000,2011,3,10,19,1255,884,2139,2199
0132-000,2011,3,10,20,904,824,1728,2139
0132-000,2011,3,10,21,766,595,1361,1728
0132-000,2011,3,10,22,708,569,1277,1361
0132-000,2011,3,10,23,445,432,877,1277
0132-000,2011,3,10,24,318,340,658,877
0132-000,2011,3,11,1,266,289,555,658
0132-000,2011,3,11,2,218,168,386,555
0132-000,2011,3,11,3,178,196,374,386
0132-000,2011,3,11,4,188,181,369,374
0132-000,2011,3,11,5,168,181,349,369
0132-000,2011,3,11,6,245,214,459,349
0132-000,2011,3,11,7,433,496,929,459
0132-000,2011,3,11,8,865,1293,2158,929
0132-000,2011,3,11,9,932,1351,2283,2158
0132-000,2011,3,11,10,829,1014,1843,2283
0132-000,2011,3,11,11,925,976,1901,1843
0132-000,2011,3,11,12,930,936,1866,1901
0132-000,2011,3,11,13,849,928,1777,1866
0132-000,2011,3,11,14,949,1005,1954,1777
0132-000,2011,3,11,15,1046,1044,2090,1954
0132-000,2011,3,11,16,1149,1016,2165,2090
0132-000,2011,3,11,17,1164,1033,2197,2165
0132-000,2011,3,11,18,1390,1025,2415,2197
0132-000,2011,3,11,19,1512,972,2484,2415
0132-000,2011,3,11,20,1169,888,2057,2484
0132-000,2011,3,11,21,829,716,1545,2057
0132-000,2011,3,11,22,761,648,1409,1545
0132-000,2011,3,11,23,518,492,1010,1409
0132-000,2011,3,11,24,358,351,709,1010
0132-000,2011,3,12,1,270,276,546,709
0132-000,2011,3,12,2,218,234,452,546
0132-000,2011,3,12,3,173,190,363,452
0132-000,2011,3,12,4,165,174,339,363
0132-000,2011,3,12,5,172,188,360,339
0132-000,2011,3,12,6,222,212,434,360
0132-000,2011,3,12,7,344,390,734,434
0132-000,2011,3,12,8,615,831,1446,734
0132-000,2011,3,12,9,730,923,1653,1446
0132-000,2011,3,12,10,766,886,1652,1653
0132-000,2011,3,12,11,827,1007,1834,1652
0132-000,2011,3,12,12,915,1093,2008,1834
0132-000,2011,3,12,13,927,1223,2150,2008
0132-000,2011,3,12,14,943,1340,2283,2150
0132-000,2011,3,12,15,958,1174,2132,2283
0132-000,2011,3,12,16,1053,1093,2146,2132
0132-000,2011,3,12,17,1145,1205,2350,2146
0132-000,2011,3,12,18,1320,1201,2521,2350
0132-000,2011,3,12,19,1293,1064,2357,2521
0132-000,2011,3,12,20,888,906,1794,2357
0132-000,2011,3,12,21,761,710,1471,1794
0132-000,2011,3,12,22,622,613,1235,1471
0132-000,2011,3,12,23,430,492,922,1235
0132-000,2011,3,12,24,278,384,662,922
0132-000,2011,3,13,1,250,293,543,662
0132-000,2011,3,13,2,189,252,441,543
0132-000,2011,3,13,3,148,177,325,441
0132-000,2011,3,13,4,131,126,257,325
0132-000,2011,3,13,5,109,104,213,257
0132-000,2011,3,13,6,126,163,289,213
0132-000,2011,3,13,7,192,236,428,289
0132-000,2011,3,13,8,302,408,710,428
0132-000,2011,3,13,9,444,595,1039,710
0132-000,2011,3,13,10,487,575,1062,1039
0132-000,2011,3,13,11,605,692,1297,1062
0132-000,2011,3,13,12,600,767,1367,1297
0132-000,2011,3,13,13,695,751,1446,1367
0132-000,2011,3,13,14,785,756,1541,1446
0132-000,2011,3,13,15,873,784,1657,1541
0132-000,2011,3,13,16,1154,767,1921,1657
0132-000,2011,3,13,17,1415,758,2173,1921
0132-000,2011,3,13,18,1555,789,2344,2173
0132-000,2011,3,13,19,1444,778,2222,2344
0132-000,2011,3,13,20,1156,619,1775,2222
0132-000,2011,3,13,21,722,635,1357,1775
0132-000,2011,3,13,22,572,595,1167,1357
0132-000,2011,3,13,23,332,476,808,1167
0132-000,2011,3,13,24,214,274,488,808
0132-000,2011,3,14,1,158,185,343,488
0132-000,2011,3,14,2,128,163,291,343
0132-000,2011,3,14,3,97,113,210,291
0132-000,2011,3,14,4,84,137,221,210
0132-000,2011,3,14,5,107,157,264,221
0132-000,2011,3,14,6,186,205,391,264
0132-000,2011,3,14,7,431,617,1048,391
0132-000,2011,3,14,8,851,1414,2265,1048
0132-000,2011,3,14,9,881,1424,2305,2265
0132-000,2011,3,14,10,800,958,1758,2305
0132-000,2011,3,14,11,849,998,1847,1758
0132-000,2011,3,14,12,898,961,1859,1847
0132-000,2011,3,14,13,840,914,1754,1859
0132-000,2011,3,14,14,951,972,1923,1754
0132-000,2011,3,14,15,990,1022,2012,1923
0132-000,2011,3,14,16,1027,868,1895,2012
0132-000,2011,3,14,17,1045,921,1966,1895
0132-000,2011,3,14,18,1123,956,2079,1966
0132-000,2011,3,14,19,1225,917,2142,2079
0132-000,2011,3,14,20,958,848,1806,2142
0132-000,2011,3,14,21,773,628,1401,1806
0132-000,2011,3,14,22,651,593,1244,1401
0132-000,2011,3,14,23,423,465,888,1244
0132-000,2011,3,14,24,236,307,543,888
0132-000,2011,3,15,1,210,225,435,543
0132-000,2011,3,15,2,132,141,273,435
0132-000,2011,3,15,3,112,91,203,273
0132-000,2011,3,15,4,122,139,261,203
0132-000,2011,3,15,5,141,152,293,261
0132-000,2011,3,15,6,203,212,415,293
0132-000,2011,3,15,7,378,454,832,415
0132-000,2011,3,15,8,850,1344,2194,832
0132-000,2011,3,15,9,895,1414,2309,2194
0132-000,2011,3,15,10,907,1069,1976,2309
0132-000,2011,3,15,11,909,947,1856,1976
0132-000,2011,3,15,12,877,1000,1877,1856
0132-000,2011,3,15,13,753,903,1656,1877
0132-000,2011,3,15,14,896,914,1810,1656
0132-000,2011,3,15,15,1074,1020,2094,1810
0132-000,2011,3,15,16,1121,972,2093,2094
0132-000,2011,3,15,17,1058,954,2012,2093
0132-000,2011,3,15,18,1219,921,2140,2012
0132-000,2011,3,15,19,1225,965,2190,2140
0132-000,2011,3,15,20,1006,718,1724,2190
0132-000,2011,3,15,21,784,696,1480,1724
0132-000,2011,3,15,22,741,577,1318,1480
0132-000,2011,3,15,23,467,439,906,1318
0132-000,2011,3,15,24,298,335,633,906
0132-000,2011,3,16,1,249,252,501,633
0132-000,2011,3,16,2,177,208,385,501
0132-000,2011,3,16,3,135,141,276,385
0132-000,2011,3,16,4,158,174,332,276
0132-000,2011,3,16,5,146,148,294,332
0132-000,2011,3,16,6,238,249,487,294
0132-000,2011,3,16,7,491,496,987,487
0132-000,2011,3,16,8,867,1320,2187,987
0132-000,2011,3,16,9,907,1343,2250,2187
0132-000,2011,3,16,10,848,1055,1903,2250
0132-000,2011,3,16,11,885,985,1870,1903
0132-000,2011,3,16,12,890,967,1857,1870
0132-000,2011,3,16,13,854,958,1812,1857
0132-000,2011,3,16,14,951,899,1850,1812
0132-000,2011,3,16,15,986,1042,2028,1850
0132-000,2011,3,16,16,1045,980,2025,2028
0132-000,2011,3,16,17,1069,952,2021,2025
0132-000,2011,3,16,18,1292,921,2213,2021
0132-000,2011,3,16,19,1285,932,2217,2213
0132-000,2011,3,16,20,980,853,1833,2217
0132-000,2011,3,16,21,820,644,1464,1833
0132-000,2011,3,16,22,697,655,1352,1464
0132-000,2011,3,16,23,463,415,878,1352
0132-000,2011,3,16,24,298,342,640,878
0132-000,2011,3,17,1,237,218,455,640
0132-000,2011,3,17,2,167,173,340,455
0132-000,2011,3,17,3,151,121,272,340
0132-000,2011,3,17,4,161,144,305,272
0132-000,2011,3,17,5,191,133,324,305
0132-000,2011,3,17,6,249,193,442,324
0132-000,2011,3,17,7,465,447,912,442
0132-000,2011,3,17,8,877,1356,2233,912
0132-000,2011,3,17,9,926,1352,2278,2233
0132-000,2011,3,17,10,890,1011,1901,2278
0132-000,2011,3,17,11,871,955,1826,1901
0132-000,2011,3,17,12,906,952,1858,1826
0132-000,2011,3,17,13,780,922,1702,1858
0132-000,2011,3,17,14,951,919,1870,1702
0132-000,2011,3,17,15,887,1024,1911,1870
0132-000,2011,3,17,16,1060,968,2028,1911
0132-000,2011,3,17,17,1070,937,2007,2028
0132-000,2011,3,17,18,1258,912,2170,2007
0132-000,2011,3,17,19,1241,949,2190,2170
0132-000,2011,3,17,20,895,816,1711,2190
0132-000,2011,3,17,21,757,633,1390,1711
0132-000,2011,3,17,22,696,599,1295,1390
0132-000,2011,3,17,23,420,405,825,1295
0132-000,2011,3,17,24,287,306,593,825
0132-000,2011,3,18,1,193,184,377,593
0132-000,2011,3,18,2,155,137,292,377
0132-000,2011,3,18,3,102,100,202,292
0132-000,2011,3,18,4,75,113,188,202
0132-000,2011,3,18,5,97,118,215,188
0132-000,2011,3,18,6,197,137,334,215
0132-000,2011,3,18,7,373,397,770,334
0132-000,2011,3,18,8,764,1391,2155,770
0132-000,2011,3,18,9,837,1361,2198,2155
0132-000,2011,3,18,10,875,967,1842,2198
0132-000,2011,3,18,11,840,925,1765,1842
0132-000,2011,3,18,12,930,936,1866,1765
0132-000,2011,3,18,13,815,886,1701,1866
0132-000,2011,3,18,14,972,938,1910,1701
0132-000,2011,3,18,15,990,1005,1995,1910
0132-000,2011,3,18,16,1093,956,2049,1995
0132-000,2011,3,18,17,1143,922,2065,2049
0132-000,2011,3,18,18,1265,903,2168,2065
0132-000,2011,3,18,19,1395,965,2360,2168
0132-000,2011,3,18,20,1027,779,1806,2360
0132-000,2011,3,18,21,853,622,1475,1806
0132-000,2011,3,18,22,682,542,1224,1475
0132-000,2011,3,18,23,428,395,823,1224
0132-000,2011,3,18,24,320,270,590,823
0132-000,2011,3,19,1,221,222,443,590
0132-000,2011,3,19,2,158,164,322,443
0132-000,2011,3,19,3,113,148,261,322
0132-000,2011,3,19,4,114,116,230,261
0132-000,2011,3,19,5,128,150,278,230
0132-000,2011,3,19,6,166,134,300,278
0132-000,2011,3,19,7,290,320,610,300
0132-000,2011,3,19,8,598,828,1426,610
0132-000,2011,3,19,9,720,943,1663,1426
0132-000,2011,3,19,10,791,858,1649,1663
0132-000,2011,3,19,11,845,871,1716,1649
0132-000,2011,3,19,12,827,986,1813,1716
0132-000,2011,3,19,13,892,993,1885,1813
0132-000,2011,3,19,14,996,1024,2020,1885
0132-000,2011,3,19,15,989,1049,2038,2020
0132-000,2011,3,19,16,983,1011,1994,2038
0132-000,2011,3,19,17,1285,1078,2363,1994
0132-000,2011,3,19,18,1570,1072,2642,2363
0132-000,2011,3,19,19,1425,1066,2491,2642
0132-000,2011,3,19,20,901,658,1559,2491
0132-000,2011,3,19,21,683,582,1265,1559
0132-000,2011,3,19,22,552,522,1074,1265
0132-000,2011,3,19,23,379,371,750,1074
0132-000,2011,3,19,24,269,284,553,750
0132-000,2011,3,20,1,204,239,443,553
0132-000,2011,3,20,2,148,164,312,443
0132-000,2011,3,20,3,124,121,245,312
0132-000,2011,3,20,4,84,89,173,245
0132-000,2011,3,20,5,103,101,204,173
0132-000,2011,3,20,6,104,113,217,204
0132-000,2011,3,20,7,140,143,283,217
0132-000,2011,3,20,8,206,321,527,283
0132-000,2011,3,20,9,361,497,858,527
0132-000,2011,3,20,10,433,449,882,858
0132-000,2011,3,20,11,557,600,1157,882
0132-000,2011,3,20,12,649,595,1244,1157
0132-000,2011,3,20,13,645,651,1296,1244
0132-000,2011,3,20,14,724,688,1412,1296
0132-000,2011,3,20,15,787,748,1535,1412
0132-000,2011,3,20,16,844,666,1510,1535
0132-000,2011,3,20,17,887,732,1619,1510
0132-000,2011,3,20,18,1113,679,1792,1619
0132-000,2011,3,20,19,967,614,1581,1792
0132-000,2011,3,20,20,699,492,1191,1581
0132-000,2011,3,20,21,535,502,1037,1191
0132-000,2011,3,20,22,443,482,925,1037
0132-000,2011,3,20,23,329,329,658,925
0132-000,2011,3,20,24,188,249,437,658
0132-000,2011,3,21,1,132,167,299,437
0132-000,2011,3,21,2,84,97,181,299
0132-000,2011,3,21,3,59,79,138,181
0132-000,2011,3,21,4,76,82,158,138
0132-000,2011,3,21,5,93,118,211,158
0132-000,2011,3,21,6,196,172,368,211
0132-000,2011,3,21,7,447,592,1039,368
0132-000,2011,3,21,8,882,1700,2582,1039
0132-000,2011,3,21,9,877,1450,2327,2582
0132-000,2011,3,21,10,823,1019,1842,2327
0132-000,2011,3,21,11,797,932,1729,1842
0132-000,2011,3,21,12,883,952,1835,1729
0132-000,2011,3,21,13,833,925,1758,1835
0132-000,2011,3,21,14,912,1001,1913,1758
0132-000,2011,3,21,15,1054,941,1995,1913
0132-000,2011,3,21,16,969,1014,1983,1995
0132-000,2011,3,21,17,1084,950,2034,1983
0132-000,2011,3,21,18,1193,905,2098,2034
0132-000,2011,3,21,19,1256,920,2176,2098
0132-000,2011,3,21,20,940,752,1692,2176
0132-000,2011,3,21,21,782,566,1348,1692
0132-000,2011,3,21,22,668,515,1183,1348
0132-000,2011,3,21,23,380,363,743,1183
0132-000,2011,3,21,24,276,231,507,743
0132-000,2011,3,22,1,182,167,349,507
0132-000,2011,3,22,2,117,110,227,349
0132-000,2011,3,22,3,106,108,214,227
0132-000,2011,3,22,4,96,95,191,214
0132-000,2011,3,22,5,93,111,204,191
0132-000,2011,3,22,6,170,141,311,204
0132-000,2011,3,22,7,371,442,813,311
0132-000,2011,3,22,8,782,1472,2254,813
0132-000,2011,3,22,9,904,1397,2301,2254
0132-000,2011,3,22,10,881,1035,1916,2301
0132-000,2011,3,22,11,844,968,1812,1916
0132-000,2011,3,22,12,855,873,1728,1812
0132-000,2011,3,22,13,833,788,1621,1728
0132-000,2011,3,22,14,888,951,1839,1621
0132-000,2011,3,22,15,1054,969,2023,1839
0132-000,2011,3,22,16,1058,890,1948,2023
0132-000,2011,3,22,17,1029,933,1962,1948
0132-000,2011,3,22,18,1214,904,2118,1962
0132-000,2011,3,22,19,1276,912,2188,2118
0132-000,2011,3,22,20,930,730,1660,2188
0132-000,2011,3,22,21,775,582,1357,1660
0132-000,2011,3,22,22,654,508,1162,1357
0132-000,2011,3,22,23,417,369,786,1162
0132-000,2011,3,22,24,243,229,472,786
0132-000,2011,3,23,1,179,162,341,472
0132-000,2011,3,23,2,115,124,239,341
0132-000,2011,3,23,3,60,99,159,239
0132-000,2011,3,23,4,77,83,160,159
0132-000,2011,3,23,5,90,97,187,160
0132-000,2011,3,23,6,155,135,290,187
0132-000,2011,3,23,7,370,416,786,290
0132-000,2011,3,23,8,799,1362,2161,786
0132-000,2011,3,23,9,860,1382,2242,2161
0132-000,2011,3,23,10,862,1034,1896,2242
0132-000,2011,3,23,11,881,936,1817,1896
0132-000,2011,3,23,12,838,939,1777,1817
0132-000,2011,3,23,13,779,824,1603,1777
0132-000,2011,3,23,14,880,1010,1890,1603
0132-000,2011,3,23,15,1001,1066,2067,1890
0132-000,2011,3,23,16,1049,955,2004,2067
0132-000,2011,3,23,17,1037,939,1976,2004
0132-000,2011,3,23,18,1253,926,2179,1976
0132-000,2011,3,23,19,1319,938,2257,2179
0132-000,2011,3,23,20,948,764,1712,2257
0132-000,2011,3,23,21,716,570,1286,1712
0132-000,2011,3,23,22,720,514,1234,1286
0132-000,2011,3,23,23,411,347,758,1234
0132-000,2011,3,23,24,252,262,514,758
0132-000,2011,3,24,1,205,175,380,514
0132-000,2011,3,24,2,127,123,250,380
0132-000,2011,3,24,3,92,83,175,250
0132-000,2011,3,24,4,87,100,187,175
0132-000,2011,3,24,5,81,114,195,187
0132-000,2011,3,24,6,183,149,332,195
0132-000,2011,3,24,7,390,393,783,332
0132-000,2011,3,24,8,788,1426,2214,783
0132-000,2011,3,24,9,872,1397,2269,2214
0132-000,2011,3,24,10,806,1099,1905,2269
0132-000,2011,3,24,11,864,898,1762,1905
0132-000,2011,3,24,12,897,912,1809,1762
0132-000,2011,3,24,13,861,808,1669,1809
0132-000,2011,3,24,14,915,927,1842,1669
0132-000,2011,3,24,15,1056,980,2036,1842
0132-000,2011,3,24,16,1111,955,2066,2036
0132-000,2011,3,24,17,1112,937,2049,2066
0132-000,2011,3,24,18,1140,908,2048,2049
0132-000,2011,3,24,19,1119,792,1911,2048
0132-000,2011,3,24,20,883,654,1537,1911
0132-000,2011,3,24,21,662,483,1145,1537
0132-000,2011,3,24,22,590,416,1006,1145
0132-000,2011,3,24,23,350,363,713,1006
0132-000,2011,3,24,24,229,228,457,713
0132-000,2011,3,25,1,180,177,357,457
0132-000,2011,3,25,2,103,107,210,357
0132-000,2011,3,25,3,69,96,165,210
0132-000,2011,3,25,4,88,82,170,165
0132-000,2011,3,25,5,85,102,187,170
0132-000,2011,3,25,6,150,125,275,187
0132-000,2011,3,25,7,368,364,732,275
0132-000,2011,3,25,8,767,1308,2075,732
0132-000,2011,3,25,9,845,1338,2183,2075
0132-000,2011,3,25,10,805,950,1755,2183
0132-000,2011,3,25,11,877,932,1809,1755
0132-000,2011,3,25,12,907,945,1852,1809
0132-000,2011,3,25,13,840,792,1632,1852
0132-000,2011,3,25,14,893,914,1807,1632
0132-000,2011,3,25,15,1033,957,1990,1807
0132-000,2011,3,25,16,1038,981,2019,1990
0132-000,2011,3,25,17,1090,929,2019,2019
0132-000,2011,3,25,18,1308,914,2222,2019
0132-000,2011,3,25,19,1400,1009,2409,2222
0132-000,2011,3,25,20,1130,849,1979,2409
0132-000,2011,3,25,21,858,663,1521,1979
0132-000,2011,3,25,22,685,601,1286,1521
0132-000,2011,3,25,23,458,430,888,1286
0132-000,2011,3,25,24,326,289,615,888
0132-000,2011,3,26,1,224,249,473,615
0132-000,2011,3,26,2,154,155,309,473
0132-000,2011,3,26,3,104,133,237,309
0132-000,2011,3,26,4,93,119,212,237
0132-000,2011,3,26,5,126,150,276,212
0132-000,2011,3,26,6,176,138,314,276
0132-000,2011,3,26,7,324,312,636,314
0132-000,2011,3,26,8,543,809,1352,636
0132-000,2011,3,26,9,728,946,1674,1352
0132-000,2011,3,26,10,807,914,1721,1674
0132-000,2011,3,26,11,865,1147,2012,1721
0132-000,2011,3,26,12,933,1349,2282,2012
0132-000,2011,3,26,13,922,1383,2305,2282
0132-000,2011,3,26,14,1007,1369,2376,2305
0132-000,2011,3,26,15,1032,1305,2337,2376
0132-000,2011,3,26,16,1099,1226,2325,2337
0132-000,2011,3,26,17,1124,1207,2331,2325
0132-000,2011,3,26,18,1399,1151,2550,2331
0132-000,2011,3,26,19,1575,1180,2755,2550
0132-000,2011,3,26,20,1135,836,1971,2755
0132-000,2011,3,26,21,823,620,1443,1971
0132-000,2011,3,26,22,525,530,1055,1443
0132-000,2011,3,26,23,353,386,739,1055
0132-000,2011,3,26,24,241,307,548,739
0132-000,2011,3,27,1,219,218,437,548
0132-000,2011,3,27,2,135,173,308,437
0132-000,2011,3,27,3,127,130,257,308
0132-000,2011,3,27,4,80,91,171,257
0132-000,2011,3,27,5,95,118,213,171
0132-000,2011,3,27,6,117,113,230,213
0132-000,2011,3,27,7,208,188,396,230
0132-000,2011,3,27,8,349,397,746,396
0132-000,2011,3,27,9,423,590,1013,746
0132-000,2011,3,27,10,513,579,1092,1013
0132-000,2011,3,27,11,636,716,1352,1092
0132-000,2011,3,27,12,618,671,1289,1352
0132-000,2011,3,27,13,699,635,1334,1289
0132-000,2011,3,27,14,770,713,1483,1334
0132-000,2011,3,27,15,900,706,1606,1483
0132-000,2011,3,27,16,1182,746,1928,1606
0132-000,2011,3,27,17,1384,743,2127,1928
0132-000,2011,3,27,18,1427,783,2210,2127
0132-000,2011,3,27,19,1389,661,2050,2210
0132-000,2011,3,27,20,995,573,1568,2050
0132-000,2011,3,27,21,697,507,1204,1568
0132-000,2011,3,27,22,527,480,1007,1204
0132-000,2011,3,27,23,364,344,708,1007
0132-000,2011,3,27,24,202,252,454,708
0132-000,2011,3,28,1,135,146,281,454
0132-000,2011,3,28,2,91,107,198,281
0132-000,2011,3,28,3,62,71,133,198
0132-000,2011,3,28,4,51,72,123,133
0132-000,2011,3,28,5,103,114,217,123
0132-000,2011,3,28,6,203,190,393,217
0132-000,2011,3,28,7,460,559,1019,393
0132-000,2011,3,28,8,858,1667,2525,1019
0132-000,2011,3,28,9,871,1448,2319,2525
0132-000,2011,3,28,10,845,1047,1892,2319
0132-000,2011,3,28,11,839,950,1789,1892
0132-000,2011,3,28,12,876,962,1838,1789
0132-000,2011,3,28,13,801,865,1666,1838
0132-000,2011,3,28,14,949,995,1944,1666
0132-000,2011,3,28,15,1011,1006,2017,1944
0132-000,2011,3,28,16,1015,915,1930,2017
0132-000,2011,3,28,17,1082,921,2003,1930
0132-000,2011,3,28,18,1209,916,2125,2003
0132-000,2011,3,28,19,1270,926,2196,2125
0132-000,2011,3,28,20,938,745,1683,2196
0132-000,2011,3,28,21,790,637,1427,1683
0132-000,2011,3,28,22,667,509,1176,1427
0132-000,2011,3,28,23,389,358,747,1176
0132-000,2011,3,28,24,254,226,480,747
0132-000,2011,3,29,1,172,172,344,480
0132-000,2011,3,29,2,105,95,200,344
0132-000,2011,3,29,3,94,121,215,200
0132-000,2011,3,29,4,87,98,185,215
0132-000,2011,3,29,5,99,122,221,185
0132-000,2011,3,29,6,178,143,321,221
0132-000,2011,3,29,7,400,437,837,321
0132-000,2011,3,29,8,787,1446,2233,837
0132-000,2011,3,29,9,856,1411,2267,2233
0132-000,2011,3,29,10,835,1018,1853,2267
0132-000,2011,3,29,11,839,990,1829,1853
0132-000,2011,3,29,12,954,1088,2042,1829
0132-000,2011,3,29,13,790,889,1679,2042
0132-000,2011,3,29,14,908,958,1866,1679
0132-000,2011,3,29,15,1023,996,2019,1866
0132-000,2011,3,29,16,1123,937,2060,2019
0132-000,2011,3,29,17,1209,884,2093,2060
0132-000,2011,3,29,18,1331,918,2249,2093
0132-000,2011,3,29,19,1268,954,2222,2249
0132-000,2011,3,29,20,910,750,1660,2222
0132-000,2011,3,29,21,785,569,1354,1660
0132-000,2011,3,29,22,678,540,1218,1354
0132-000,2011,3,29,23,397,370,767,1218
0132-000,2011,3,29,24,255,224,479,767
0132-000,2011,3,30,1,184,165,349,479
0132-000,2011,3,30,2,120,133,253,349
0132-000,2011,3,30,3,97,100,197,253
0132-000,2011,3,30,4,75,95,170,197
0132-000,2011,3,30,5,99,100,199,170
0132-000,2011,3,30,6,176,155,331,199
0132-000,2011,3,30,7,396,428,824,331
0132-000,2011,3,30,8,792,1384,2176,824
0132-000,2011,3,30,9,885,1407,2292,2176
0132-000,2011,3,30,10,883,1072,1955,2292
0132-000,2011,3,30,11,938,1145,2083,1955
0132-000,2011,3,30,12,879,1003,1882,2083
0132-000,2011,3,30,13,825,899,1724,1882
0132-000,2011,3,30,14,921,1018,1939,1724
0132-000,2011,3,30,15,948,987,1935,1939
0132-000,2011,3,30,16,1026,947,1973,1935
0132-000,2011,3,30,17,1087,891,1978,1973
0132-000,2011,3,30,18,1275,944,2219,1978
0132-000,2011,3,30,19,1275,939,2214,2219
0132-000,2011,3,30,20,974,731,1705,2214
0132-000,2011,3,30,21,756,519,1275,1705
0132-000,2011,3,30,22,677,521,1198,1275
0132-000,2011,3,30,23,402,372,774,1198
0132-000,2011,3,30,24,273,270,543,774
0132-000,2011,3,31,1,164,188,352,543
0132-000,2011,3,31,2,113,130,243,352
0132-000,2011,3,31,3,87,78,165,243
0132-000,2011,3,31,4,78,113,191,165
0132-000,2011,3,31,5,117,104,221,191
0132-000,2011,3,31,6,172,149,321,221
0132-000,2011,3,31,7,378,418,796,321
0132-000,2011,3,31,8,810,1335,2145,796
0132-000,2011,3,31,9,862,1408,2270,2145
0132-000,2011,3,31,10,840,1010,1850,2270
0132-000,2011,3,31,11,871,956,1827,1850
0132-000,2011,3,31,12,871,944,1815,1827
0132-000,2011,3,31,13,809,874,1683,1815
0132-000,2011,3,31,14,874,960,1834,1683
0132-000,2011,3,31,15,1082,1020,2102,1834
0132-000,2011,3,31,16,1023,981,2004,2102
0132-000,2011,3,31,17,1073,905,1978,2004
0132-000,2011,3,31,18,1184,910,2094,1978
0132-000,2011,3,31,19,1309,885,2194,2094
0132-000,2011,3,31,20,927,737,1664,2194
0132-000,2011,3,31,21,752,593,1345,1664
0132-000,2011,3,31,22,691,528,1219,1345
0132-000,2011,3,31,23,469,441,910,1219
0132-000,2011,3,31,24,307,280,587,910
0132-000,2011,4,1,1,206,181,387,587
0132-000,2011,4,1,2,136,144,280,387
0132-000,2011,4,1,3,103,119,222,280
0132-000,2011,4,1,4,72,119,191,222
0132-000,2011,4,1,5,105,117,222,191
0132-000,2011,4,1,6,172,140,312,222
0132-000,2011,4,1,7,390,431,821,312
0132-000,2011,4,1,8,787,1348,2135,821
0132-000,2011,4,1,9,797,1362,2159,2135
0132-000,2011,4,1,10,818,989,1807,2159
0132-000,2011,4,1,11,899,979,1878,1807
0132-000,2011,4,1,12,942,953,1895,1878
0132-000,2011,4,1,13,849,858,1707,1895
0132-000,2011,4,1,14,969,932,1901,1707
0132-000,2011,4,1,15,1019,988,2007,1901
0132-000,2011,4,1,16,1023,951,1974,2007
0132-000,2011,4,1,17,1142,910,2052,1974
0132-000,2011,4,1,18,1186,934,2120,2052
0132-000,2011,4,1,19,1468,974,2442,2120
0132-000,2011,4,1,20,1118,780,1898,2442
0132-000,2011,4,1,21,885,661,1546,1898
0132-000,2011,4,1,22,711,565,1276,1546
0132-000,2011,4,1,23,398,458,856,1276
0132-000,2011,4,1,24,289,306,595,856
0132-000,2011,4,2,1,220,240,460,595
0132-000,2011,4,2,2,172,183,355,460
0132-000,2011,4,2,3,117,157,274,355
0132-000,2011,4,2,4,117,132,249,274
0132-000,2011,4,2,5,115,129,244,249
0132-000,2011,4,2,6,162,153,315,244
0132-000,2011,4,2,7,325,312,637,315
0132-000,2011,4,2,8,653,810,1463,637
0132-000,2011,4,2,9,752,1010,1762,1463
0132-000,2011,4,2,10,830,875,1705,1762
0132-000,2011,4,2,11,834,1053,1887,1705
0132-000,2011,4,2,12,867,1427,2294,1887
0132-000,2011,4,2,13,910,1388,2298,2294
0132-000,2011,4,2,14,1024,1441,2465,2298
0132-000,2011,4,2,15,1036,1382,2418,2465
0132-000,2011,4,2,16,1063,1358,2421,2418
0132-000,2011,4,2,17,1143,1368,2511,2421
0132-000,2011,4,2,18,1519,1454,2973,2511
0132-000,2011,4,2,19,1435,1410,2845,2973
0132-000,2011,4,2,20,875,1067,1942,2845
0132-000,2011,4,2,21,676,762,1438,1942
0132-000,2011,4,2,22,549,547,1096,1438
0132-000,2011,4,2,23,376,376,752,1096
0132-000,2011,4,2,24,261,289,550,752
0132-000,2011,4,3,1,207,207,414,550
0132-000,2011,4,3,2,122,156,278,414
0132-000,2011,4,3,3,118,107,225,278
0132-000,2011,4,3,4,96,90,186,225
0132-000,2011,4,3,5,102,81,183,186
0132-000,2011,4,3,6,116,106,222,183
0132-000,2011,4,3,7,234,227,461,222
0132-000,2011,4,3,8,317,398,715,461
0132-000,2011,4,3,9,434,599,1033,715
0132-000,2011,4,3,10,498,712,1210,1033
0132-000,2011,4,3,11,631,792,1423,1210
0132-000,2011,4,3,12,657,769,1426,1423
0132-000,2011,4,3,13,745,706,1451,1426
0132-000,2011,4,3,14,834,730,1564,1451
0132-000,2011,4,3,15,1114,792,1906,1564
0132-000,2011,4,3,16,1365,762,2127,1906
0132-000,2011,4,3,17,1458,733,2191,2127
0132-000,2011,4,3,18,1636,707,2343,2191
0132-000,2011,4,3,19,1621,694,2315,2343
0132-000,2011,4,3,20,1493,591,2084,2315
0132-000,2011,4,3,21,1320,539,1859,2084
0132-000,2011,4,3,22,1238,496,1734,1859
0132-000,2011,4,3,23,648,379,1027,1734
0132-000,2011,4,3,24,249,242,491,1027
0132-000,2011,4,4,1,149,171,320,491
0132-000,2011,4,4,2,93,121,214,320
0132-000,2011,4,4,3,72,79,151,214
0132-000,2011,4,4,4,66,74,140,151
0132-000,2011,4,4,5,101,104,205,140
0132-000,2011,4,4,6,189,178,367,205
0132-000,2011,4,4,7,483,593,1076,367
0132-000,2011,4,4,8,832,1646,2478,1076
0132-000,2011,4,4,9,894,1485,2379,2478
0132-000,2011,4,4,10,874,1049,1923,2379
0132-000,2011,4,4,11,860,962,1822,1923
0132-000,2011,4,4,12,914,957,1871,1822
0132-000,2011,4,4,13,861,854,1715,1871
0132-000,2011,4,4,14,884,1029,1913,1715
0132-000,2011,4,4,15,1008,1022,2030,1913
0132-000,2011,4,4,16,1020,985,2005,2030
0132-000,2011,4,4,17,1057,916,1973,2005
0132-000,2011,4,4,18,1210,947,2157,1973
0132-000,2011,4,4,19,1221,893,2114,2157
0132-000,2011,4,4,20,976,730,1706,2114
0132-000,2011,4,4,21,773,662,1435,1706
0132-000,2011,4,4,22,659,529,1188,1435
0132-000,2011,4,4,23,458,367,825,1188
0132-000,2011,4,4,24,267,242,509,825
0132-000,2011,4,5,1,204,171,375,509
0132-000,2011,4,5,2,107,125,232,375
0132-000,2011,4,5,3,100,107,207,232
0132-000,2011,4,5,4,90,87,177,207
0132-000,2011,4,5,5,106,129,235,177
0132-000,2011,4,5,6,172,140,312,235
0132-000,2011,4,5,7,431,445,876,312
0132-000,2011,4,5,8,798,1438,2236,876
0132-000,2011,4,5,9,849,1469,2318,2236
0132-000,2011,4,5,10,859,1069,1928,2318
0132-000,2011,4,5,11,898,972,1870,1928
0132-000,2011,4,5,12,881,970,1851,1870
0132-000,2011,4,5,13,907,838,1745,1851
0132-000,2011,4,5,14,943,1001,1944,1745
0132-000,2011,4,5,15,1044,983,2027,1944
0132-000,2011,4,5,16,1067,994,2061,2027
0132-000,2011,4,5,17,1119,948,2067,2061
0132-000,2011,4,5,18,1230,892,2122,2067
0132-000,2011,4,5,19,1255,902,2157,2122
0132-000,2011,4,5,20,1033,719,1752,2157
0132-000,2011,4,5,21,737,584,1321,1752
0132-000,2011,4,5,22,718,556,1274,1321
0132-000,2011,4,5,23,470,390,860,1274
0132-000,2011,4,5,24,258,252,510,860
0132-000,2011,4,6,1,203,182,385,510
0132-000,2011,4,6,2,118,138,256,385
0132-000,2011,4,6,3,104,93,197,256
0132-000,2011,4,6,4,85,102,187,197
0132-000,2011,4,6,5,98,111,209,187
0132-000,2011,4,6,6,195,145,340,209
0132-000,2011,4,6,7,413,457,870,340
0132-000,2011,4,6,8,786,1417,2203,870
0132-000,2011,4,6,9,873,1401,2274,2203
0132-000,2011,4,6,10,844,1046,1890,2274
0132-000,2011,4,6,11,841,975,1816,1890
0132-000,2011,4,6,12,912,972,1884,1816
0132-000,2011,4,6,13,862,872,1734,1884
0132-000,2011,4,6,14,957,1008,1965,1734
0132-000,2011,4,6,15,1031,1058,2089,1965
0132-000,2011,4,6,16,1142,1004,2146,2089
0132-000,2011,4,6,17,1162,917,2079,2146
0132-000,2011,4,6,18,1315,951,2266,2079
0132-000,2011,4,6,19,1292,959,2251,2266
0132-000,2011,4,6,20,977,707,1684,2251
0132-000,2011,4,6,21,768,592,1360,1684
0132-000,2011,4,6,22,662,537,1199,1360
0132-000,2011,4,6,23,424,371,795,1199
0132-000,2011,4,6,24,301,261,562,795
0132-000,2011,4,7,1,189,168,357,562
0132-000,2011,4,7,2,118,150,268,357
0132-000,2011,4,7,3,98,92,190,268
0132-000,2011,4,7,4,93,101,194,190
0132-000,2011,4,7,5,94,121,215,194
0132-000,2011,4,7,6,163,124,287,215
0132-000,2011,4,7,7,335,348,683,287
0132-000,2011,4,7,8,754,1274,2028,683
0132-000,2011,4,7,9,818,1374,2192,2028
0132-000,2011,4,7,10,807,907,1714,2192
0132-000,2011,4,7,11,790,868,1658,1714
0132-000,2011,4,7,12,792,836,1628,1658
0132-000,2011,4,7,13,744,786,1530,1628
0132-000,2011,4,7,14,813,864,1677,1530
0132-000,2011,4,7,15,916,920,1836,1677
0132-000,2011,4,7,16,994,885,1879,1836
0132-000,2011,4,7,17,957,865,1822,1879
0132-000,2011,4,7,18,1136,840,1976,1822
0132-000,2011,4,7,19,1158,840,1998,1976
0132-000,2011,4,7,20,916,631,1547,1998
0132-000,2011,4,7,21,714,551,1265,1547
0132-000,2011,4,7,22,639,521,1160,1265
0132-000,2011,4,7,23,384,370,754,1160
0132-000,2011,4,7,24,282,228,510,754
0132-000,2011,4,8,1,188,190,378,510
0132-000,2011,4,8,2,114,125,239,378
0132-000,2011,4,8,3,103,92,195,239
0132-000,2011,4,8,4,78,97,175,195
0132-000,2011,4,8,5,91,112,203,175
0132-000,2011,4,8,6,177,142,319,203
0132-000,2011,4,8,7,384,376,760,319
0132-000,2011,4,8,8,771,1360,2131,760
0132-000,2011,4,8,9,848,1321,2169,2131
0132-000,2011,4,8,10,836,999,1835,2169
0132-000,2011,4,8,11,874,959,1833,1835
0132-000,2011,4,8,12,888,939,1827,1833
0132-000,2011,4,8,13,875,848,1723,1827
0132-000,2011,4,8,14,997,1004,2001,1723
0132-000,2011,4,8,15,1046,1018,2064,2001
0132-000,2011,4,8,16,1061,999,2060,2064
0132-000,2011,4,8,17,1084,992,2076,2060
0132-000,2011,4,8,18,1414,958,2372,2076
0132-000,2011,4,8,19,1486,995,2481,2372
0132-000,2011,4,8,20,1175,890,2065,2481
0132-000,2011,4,8,21,863,679,1542,2065
0132-000,2011,4,8,22,718,637,1355,1542
0132-000,2011,4,8,23,524,495,1019,1355
0132-000,2011,4,8,24,353,320,673,1019
0132-000,2011,4,9,1,240,255,495,673
0132-000,2011,4,9,2,198,185,383,495
0132-000,2011,4,9,3,142,149,291,383
0132-000,2011,4,9,4,99,144,243,291
0132-000,2011,4,9,5,124,137,261,243
0132-000,2011,4,9,6,187,142,329,261
0132-000,2011,4,9,7,348,359,707,329
0132-000,2011,4,9,8,583,782,1365,707
0132-000,2011,4,9,9,789,925,1714,1365
0132-000,2011,4,9,10,824,1072,1896,1714
0132-000,2011,4,9,11,846,1476,2322,1896
0132-000,2011,4,9,12,906,1762,2668,2322
0132-000,2011,4,9,13,872,1887,2759,2668
0132-000,2011,4,9,14,984,1833,2817,2759
0132-000,2011,4,9,15,1062,1752,2814,2817
0132-000,2011,4,9,16,1207,1741,2948,2814
0132-000,2011,4,9,17,1223,1741,2964,2948
0132-000,2011,4,9,18,1358,1631,2989,2964
0132-000,2011,4,9,19,1258,1567,2825,2989
0132-000,2011,4,9,20,988,1092,2080,2825
0132-000,2011,4,9,21,698,721,1419,2080
0132-000,2011,4,9,22,606,563,1169,1419
0132-000,2011,4,9,23,383,435,818,1169
0132-000,2011,4,9,24,270,331,601,818
0132-000,2011,4,10,1,209,234,443,601
0132-000,2011,4,10,2,133,174,307,443
0132-000,2011,4,10,3,116,130,246,307
0132-000,2011,4,10,4,92,127,219,246
0132-000,2011,4,10,5,108,107,215,219
0132-000,2011,4,10,6,125,143,268,215
0132-000,2011,4,10,7,196,277,473,268
0132-000,2011,4,10,8,323,426,749,473
0132-000,2011,4,10,9,445,530,975,749
0132-000,2011,4,10,10,512,584,1096,975
0132-000,2011,4,10,11,646,683,1329,1096
0132-000,2011,4,10,12,725,618,1343,1329
0132-000,2011,4,10,13,759,654,1413,1343
0132-000,2011,4,10,14,1055,769,1824,1413
0132-000,2011,4,10,15,1444,728,2172,1824
0132-000,2011,4,10,16,1465,718,2183,2172
0132-000,2011,4,10,17,1734,772,2506,2183
0132-000,2011,4,10,18,1601,741,2342,2506
0132-000,2011,4,10,19,1673,681,2354,2342
0132-000,2011,4,10,20,1524,570,2094,2354
0132-000,2011,4,10,21,1442,543,1985,2094
0132-000,2011,4,10,22,1294,460,1754,1985
0132-000,2011,4,10,23,1197,404,1601,1754
0132-000,2011,4,10,24,832,293,1125,1601
0132-000,2011,4,11,1,169,168,337,1125
0132-000,2011,4,11,2,97,110,207,337
0132-000,2011,4,11,3,69,89,158,207
0132-000,2011,4,11,4,76,92,168,158
0132-000,2011,4,11,5,101,113,214,168
0132-000,2011,4,11,6,212,185,397,214
0132-000,2011,4,11,7,476,628,1104,397
0132-000,2011,4,11,8,834,1657,2491,1104
0132-000,2011,4,11,9,841,1451,2292,2491
0132-000,2011,4,11,10,834,1053,1887,2292
0132-000,2011,4,11,11,905,1019,1924,1887
0132-000,2011,4,11,12,906,901,1807,1924
0132-000,2011,4,11,13,839,924,1763,1807
0132-000,2011,4,11,14,926,1033,1959,1763
0132-000,2011,4,11,15,1022,1052,2074,1959
0132-000,2011,4,11,16,1045,1024,2069,2074
0132-000,2011,4,11,17,1032,938,1970,2069
0132-000,2011,4,11,18,1193,907,2100,1970
0132-000,2011,4,11,19,1265,943,2208,2100
0132-000,2011,4,11,20,1028,700,1728,2208
0132-000,2011,4,11,21,793,602,1395,1728
0132-000,2011,4,11,22,690,548,1238,1395
0132-000,2011,4,11,23,416,382,798,1238
0132-000,2011,4,11,24,249,253,502,798
0132-000,2011,4,12,1,182,194,376,502
0132-000,2011,4,12,2,111,128,239,376
0132-000,2011,4,12,3,96,109,205,239
0132-000,2011,4,12,4,85,107,192,205
0132-000,2011,4,12,5,100,121,221,192
0132-000,2011,4,12,6,179,146,325,221
0132-000,2011,4,12,7,428,445,873,325
0132-000,2011,4,12,8,791,1423,2214,873
0132-000,2011,4,12,9,895,1392,2287,2214
0132-000,2011,4,12,10,829,1029,1858,2287
0132-000,2011,4,12,11,867,979,1846,1858
0132-000,2011,4,12,12,895,948,1843,1846
0132-000,2011,4,12,13,815,892,1707,1843
0132-000,2011,4,12,14,863,975,1838,1707
0132-000,2011,4,12,15,1042,1040,2082,1838
0132-000,2011,4,12,16,1112,983,2095,2082
0132-000,2011,4,12,17,1075,891,1966,2095
0132-000,2011,4,12,18,1246,917,2163,1966
0132-000,2011,4,12,19,1301,858,2159,2163
0132-000,2011,4,12,20,960,766,1726,2159
0132-000,2011,4,12,21,845,593,1438,1726
0132-000,2011,4,12,22,656,556,1212,1438
0132-000,2011,4,12,23,461,409,870,1212
0132-000,2011,4,12,24,280,253,533,870
0132-000,2011,4,13,1,202,186,388,533
0132-000,2011,4,13,2,125,115,240,388
0132-000,2011,4,13,3,88,108,196,240
0132-000,2011,4,13,4,78,107,185,196
0132-000,2011,4,13,5,124,103,227,185
0132-000,2011,4,13,6,189,153,342,227
0132-000,2011,4,13,7,410,428,838,342
0132-000,2011,4,13,8,759,1390,2149,838
0132-000,2011,4,13,9,881,1416,2297,2149
0132-000,2011,4,13,10,851,1098,1949,2297
0132-000,2011,4,13,11,877,1038,1915,1949
0132-000,2011,4,13,12,947,866,1813,1915
0132-000,2011,4,13,13,804,866,1670,1813
0132-000,2011,4,13,14,928,982,1910,1670
0132-000,2011,4,13,15,1042,1034,2076,1910
0132-000,2011,4,13,16,1046,934,1980,2076
0132-000,2011,4,13,17,1111,930,2041,1980
0132-000,2011,4,13,18,1265,912,2177,2041
0132-000,2011,4,13,19,1304,963,2267,2177
0132-000,2011,4,13,20,1012,727,1739,2267
0132-000,2011,4,13,21,763,555,1318,1739
0132-000,2011,4,13,22,686,532,1218,1318
0132-000,2011,4,13,23,406,414,820,1218
0132-000,2011,4,13,24,229,257,486,820
0132-000,2011,4,14,1,205,207,412,486
0132-000,2011,4,14,2,119,121,240,412
0132-000,2011,4,14,3,91,119,210,240
0132-000,2011,4,14,4,95,114,209,210
0132-000,2011,4,14,5,114,105,219,209
0132-000,2011,4,14,6,186,142,328,219
0132-000,2011,4,14,7,454,439,893,328
0132-000,2011,4,14,8,810,1456,2266,893
0132-000,2011,4,14,9,884,1302,2186,2266
0132-000,2011,4,14,10,870,972,1842,2186
0132-000,2011,4,14,11,882,925,1807,1842
0132-000,2011,4,14,12,871,939,1810,1807
0132-000,2011,4,14,13,787,877,1664,1810
0132-000,2011,4,14,14,876,954,1830,1664
0132-000,2011,4,14,15,984,997,1981,1830
0132-000,2011,4,14,16,1060,921,1981,1981
0132-000,2011,4,14,17,1135,992,2127,1981
0132-000,2011,4,14,18,1194,883,2077,2127
0132-000,2011,4,14,19,1246,1209,2455,2077
0132-000,2011,4,14,20,953,863,1816,2455
0132-000,2011,4,14,21,806,600,1406,1816
0132-000,2011,4,14,22,751,564,1315,1406
0132-000,2011,4,14,23,459,383,842,1315
0132-000,2011,4,14,24,285,256,541,842
0132-000,2011,4,15,1,191,211,402,541
0132-000,2011,4,15,2,121,139,260,402
0132-000,2011,4,15,3,94,93,187,260
0132-000,2011,4,15,4,94,128,222,187
0132-000,2011,4,15,5,105,120,225,222
0132-000,2011,4,15,6,194,151,345,225
0132-000,2011,4,15,7,410,437,847,345
0132-000,2011,4,15,8,797,1399,2196,847
0132-000,2011,4,15,9,910,1423,2333,2196
0132-000,2011,4,15,10,901,1018,1919,2333
0132-000,2011,4,15,11,903,982,1885,1919
0132-000,2011,4,15,12,940,1008,1948,1885
0132-000,2011,4,15,13,885,904,1789,1948
0132-000,2011,4,15,14,990,1006,1996,1789
0132-000,2011,4,15,15,1058,1000,2058,1996
0132-000,2011,4,15,16,1128,963,2091,2058
0132-000,2011,4,15,17,1059,901,1960,2091
0132-000,2011,4,15,18,1261,948,2209,1960
0132-000,2011,4,15,19,1501,1069,2570,2209
0132-000,2011,4,15,20,1144,794,1938,2570
0132-000,2011,4,15,21,873,647,1520,1938
0132-000,2011,4,15,22,734,571,1305,1520
0132-000,2011,4,15,23,461,453,914,1305
0132-000,2011,4,15,24,317,291,608,914
0132-000,2011,4,16,1,254,274,528,608
0132-000,2011,4,16,2,173,164,337,528
0132-000,2011,4,16,3,154,152,306,337
0132-000,2011,4,16,4,119,137,256,306
0132-000,2011,4,16,5,125,129,254,256
0132-000,2011,4,16,6,172,167,339,254
0132-000,2011,4,16,7,355,384,739,339
0132-000,2011,4,16,8,670,894,1564,739
0132-000,2011,4,16,9,808,1027,1835,1564
0132-000,2011,4,16,10,844,986,1830,1835
0132-000,2011,4,16,11,845,1209,2054,1830
0132-000,2011,4,16,12,890,1442,2332,2054
0132-000,2011,4,16,13,933,1468,2401,2332
0132-000,2011,4,16,14,1018,1425,2443,2401
0132-000,2011,4,16,15,987,1333,2320,2443
0132-000,2011,4,16,16,1127,1322,2449,2320
0132-000,2011,4,16,17,1083,1281,2364,2449
0132-000,2011,4,16,18,1391,1281,2672,2364
0132-000,2011,4,16,19,1374,1216,2590,2672
0132-000,2011,4,16,20,958,804,1762,2590
0132-000,2011,4,16,21,758,627,1385,1762
0132-000,2011,4,16,22,621,541,1162,1385
0132-000,2011,4,16,23,444,424,868,1162
0132-000,2011,4,16,24,310,323,633,868
0132-000,2011,4,17,1,211,263,474,633
0132-000,2011,4,17,2,119,165,284,474
0132-000,2011,4,17,3,108,137,245,284
0132-000,2011,4,17,4,108,105,213,245
0132-000,2011,4,17,5,101,120,221,213
0132-000,2011,4,17,6,137,179,316,221
0132-000,2011,4,17,7,226,289,515,316
0132-000,2011,4,17,8,347,439,786,515
0132-000,2011,4,17,9,425,603,1028,786
0132-000,2011,4,17,10,547,613,1160,1028
0132-000,2011,4,17,11,716,773,1489,1160
0132-000,2011,4,17,12,647,702,1349,1489
0132-000,2011,4,17,13,755,713,1468,1349
0132-000,2011,4,17,14,820,742,1562,1468
0132-000,2011,4,17,15,875,804,1679,1562
0132-000,2011,4,17,16,1243,792,2035,1679
0132-000,2011,4,17,17,1414,710,2124,2035
0132-000,2011,4,17,18,1583,770,2353,2124
0132-000,2011,4,17,19,1510,665,2175,2353
0132-000,2011,4,17,20,1406,542,1948,2175
0132-000,2011,4,17,21,1027,559,1586,1948
0132-000,2011,4,17,22,766,487,1253,1586
0132-000,2011,4,17,23,452,369,821,1253
0132-000,2011,4,17,24,220,276,496,821
0132-000,2011,4,18,1,139,165,304,496
0132-000,2011,4,18,2,85,107,192,304
0132-000,2011,4,18,3,73,85,158,192
0132-000,2011,4,18,4,66,78,144,158
0132-000,2011,4,18,5,94,119,213,144
0132-000,2011,4,18,6,194,195,389,213
0132-000,2011,4,18,7,446,565,1011,389
0132-000,2011,4,18,8,841,1587,2428,1011
0132-000,2011,4,18,9,860,1378,2238,2428
0132-000,2011,4,18,10,839,1014,1853,2238
0132-000,2011,4,18,11,873,995,1868,1853
0132-000,2011,4,18,12,897,964,1861,1868
0132-000,2011,4,18,13,776,862,1638,1861
0132-000,2011,4,18,14,879,963,1842,1638
0132-000,2011,4,18,15,1011,972,1983,1842
0132-000,2011,4,18,16,1042,896,1938,1983
0132-000,2011,4,18,17,981,874,1855,1938
0132-000,2011,4,18,18,1089,834,1923,1855
0132-000,2011,4,18,19,1211,935,2146,1923
0132-000,2011,4,18,20,982,655,1637,2146
0132-000,2011,4,18,21,757,581,1338,1637
0132-000,2011,4,18,22,610,527,1137,1338
0132-000,2011,4,18,23,387,379,766,1137
0132-000,2011,4,18,24,264,246,510,766
0132-000,2011,4,19,1,199,177,376,510
0132-000,2011,4,19,2,126,126,252,376
0132-000,2011,4,19,3,81,100,181,252
0132-000,2011,4,19,4,75,97,172,181
0132-000,2011,4,19,5,112,133,245,172
0132-000,2011,4,19,6,198,157,355,245
0132-000,2011,4,19,7,432,444,876,355
0132-000,2011,4,19,8,823,1436,2259,876
0132-000,2011,4,19,9,873,1510,2383,2259
0132-000,2011,4,19,10,835,1066,1901,2383
0132-000,2011,4,19,11,879,960,1839,1901
0132-000,2011,4,19,12,907,925,1832,1839
0132-000,2011,4,19,13,812,889,1701,1832
0132-000,2011,4,19,14,905,979,1884,1701
0132-000,2011,4,19,15,1004,1069,2073,1884
0132-000,2011,4,19,16,1108,957,2065,2073
0132-000,2011,4,19,17,1093,931,2024,2065
0132-000,2011,4,19,18,1232,908,2140,2024
0132-000,2011,4,19,19,1308,909,2217,2140
0132-000,2011,4,19,20,972,750,1722,2217
0132-000,2011,4,19,21,780,608,1388,1722
0132-000,2011,4,19,22,706,538,1244,1388
0132-000,2011,4,19,23,429,386,815,1244
0132-000,2011,4,19,24,251,238,489,815
0132-000,2011,4,20,1,180,191,371,489
0132-000,2011,4,20,2,120,117,237,371
0132-000,2011,4,20,3,78,108,186,237
0132-000,2011,4,20,4,79,101,180,186
0132-000,2011,4,20,5,116,91,207,180
0132-000,2011,4,20,6,217,188,405,207
0132-000,2011,4,20,7,455,472,927,405
0132-000,2011,4,20,8,830,1445,2275,927
0132-000,2011,4,20,9,863,1361,2224,2275
0132-000,2011,4,20,10,859,1095,1954,2224
0132-000,2011,4,20,11,890,941,1831,1954
0132-000,2011,4,20,12,874,892,1766,1831
0132-000,2011,4,20,13,798,843,1641,1766
0132-000,2011,4,20,14,894,968,1862,1641
0132-000,2011,4,20,15,1005,1093,2098,1862
0132-000,2011,4,20,16,1051,963,2014,2098
0132-000,2011,4,20,17,1059,880,1939,2014
0132-000,2011,4,20,18,1290,951,2241,1939
0132-000,2011,4,20,19,1325,973,2298,2241
0132-000,2011,4,20,20,1065,748,1813,2298
0132-000,2011,4,20,21,739,614,1353,1813
0132-000,2011,4,20,22,667,515,1182,1353
0132-000,2011,4,20,23,445,402,847,1182
0132-000,2011,4,20,24,272,270,542,847
0132-000,2011,4,21,1,196,203,399,542
0132-000,2011,4,21,2,139,141,280,399
0132-000,2011,4,21,3,96,108,204,280
0132-000,2011,4,21,4,86,127,213,204
0132-000,2011,4,21,5,107,105,212,213
0132-000,2011,4,21,6,210,177,387,212
0132-000,2011,4,21,7,450,484,934,387
0132-000,2011,4,21,8,804,1417,2221,934
0132-000,2011,4,21,9,899,1420,2319,2221
0132-000,2011,4,21,10,872,1054,1926,2319
0132-000,2011,4,21,11,851,973,1824,1926
0132-000,2011,4,21,12,893,990,1883,1824
0132-000,2011,4,21,13,856,911,1767,1883
0132-000,2011,4,21,14,924,942,1866,1767
0132-000,2011,4,21,15,1046,1066,2112,1866
0132-000,2011,4,21,16,1145,961,2106,2112
0132-000,2011,4,21,17,1057,911,1968,2106
0132-000,2011,4,21,18,1300,851,2151,1968
0132-000,2011,4,21,19,1301,943,2244,2151
0132-000,2011,4,21,20,991,712,1703,2244
0132-000,2011,4,21,21,850,618,1468,1703
0132-000,2011,4,21,22,752,568,1320,1468
0132-000,2011,4,21,23,455,395,850,1320
0132-000,2011,4,21,24,346,299,645,850
0132-000,2011,4,22,1,229,236,465,645
0132-000,2011,4,22,2,139,149,288,465
0132-000,2011,4,22,3,92,117,209,288
0132-000,2011,4,22,4,87,111,198,209
0132-000,2011,4,22,5,101,116,217,198
0132-000,2011,4,22,6,170,143,313,217
0132-000,2011,4,22,7,334,373,707,313
0132-000,2011,4,22,8,765,1216,1981,707
0132-000,2011,4,22,9,855,1350,2205,1981
0132-000,2011,4,22,10,778,922,1700,2205
0132-000,2011,4,22,11,804,897,1701,1700
0132-000,2011,4,22,12,827,938,1765,1701
0132-000,2011,4,22,13,843,843,1686,1765
0132-000,2011,4,22,14,895,914,1809,1686
0132-000,2011,4,22,15,1007,952,1959,1809
0132-000,2011,4,22,16,1041,941,1982,1959
0132-000,2011,4,22,17,1088,940,2028,1982
0132-000,2011,4,22,18,1260,895,2155,2028
0132-000,2011,4,22,19,1426,981,2407,2155
0132-000,2011,4,22,20,1058,768,1826,2407
0132-000,2011,4,22,21,762,611,1373,1826
0132-000,2011,4,22,22,671,547,1218,1373
0132-000,2011,4,22,23,425,455,880,1218
0132-000,2011,4,22,24,264,299,563,880
0132-000,2011,4,23,1,220,220,440,563
0132-000,2011,4,23,2,152,181,333,440
0132-000,2011,4,23,3,150,140,290,333
0132-000,2011,4,23,4,116,122,238,290
0132-000,2011,4,23,5,114,142,256,238
0132-000,2011,4,23,6,193,167,360,256
0132-000,2011,4,23,7,360,369,729,360
0132-000,2011,4,23,8,616,737,1353,729
0132-000,2011,4,23,9,765,895,1660,1353
0132-000,2011,4,23,10,760,976,1736,1660
0132-000,2011,4,23,11,816,1149,1965,1736
0132-000,2011,4,23,12,942,1529,2471,1965
0132-000,2011,4,23,13,924,1621,2545,2471
0132-000,2011,4,23,14,1004,1438,2442,2545
0132-000,2011,4,23,15,1034,1391,2425,2442
0132-000,2011,4,23,16,1139,1252,2391,2425
0132-000,2011,4,23,17,1168,1083,2251,2391
0132-000,2011,4,23,18,1418,1223,2641,2251
0132-000,2011,4,23,19,1213,1039,2252,2641
0132-000,2011,4,23,20,961,784,1745,2252
0132-000,2011,4,23,21,695,612,1307,1745
0132-000,2011,4,23,22,571,505,1076,1307
0132-000,2011,4,23,23,395,393,788,1076
0132-000,2011,4,23,24,259,306,565,788
0132-000,2011,4,24,1,202,254,456,565
0132-000,2011,4,24,2,139,146,285,456
0132-000,2011,4,24,3,119,126,245,285
0132-000,2011,4,24,4,66,97,163,245
0132-000,2011,4,24,5,94,99,193,163
0132-000,2011,4,24,6,117,144,261,193
0132-000,2011,4,24,7,231,274,505,261
0132-000,2011,4,24,8,339,386,725,505
0132-000,2011,4,24,9,451,582,1033,725
0132-000,2011,4,24,10,552,575,1127,1033
0132-000,2011,4,24,11,603,717,1320,1127
0132-000,2011,4,24,12,670,644,1314,1320
0132-000,2011,4,24,13,784,682,1466,1314
0132-000,2011,4,24,14,839,669,1508,1466
0132-000,2011,4,24,15,1099,755,1854,1508
0132-000,2011,4,24,16,1425,713,2138,1854
0132-000,2011,4,24,17,1558,729,2287,2138
0132-000,2011,4,24,18,1563,737,2300,2287
0132-000,2011,4,24,19,1585,660,2245,2300
0132-000,2011,4,24,20,1563,616,2179,2245
0132-000,2011,4,24,21,1100,553,1653,2179
0132-000,2011,4,24,22,658,502,1160,1653
0132-000,2011,4,24,23,437,375,812,1160
0132-000,2011,4,24,24,255,268,523,812
0132-000,2011,4,25,1,142,165,307,523
0132-000,2011,4,25,2,87,99,186,307
0132-000,2011,4,25,3,68,71,139,186
0132-000,2011,4,25,4,56,71,127,139
0132-000,2011,4,25,5,100,100,200,127
0132-000,2011,4,25,6,226,206,432,200
0132-000,2011,4,25,7,531,603,1134,432
0132-000,2011,4,25,8,870,1656,2526,1134
0132-000,2011,4,25,9,854,1588,2442,2526
0132-000,2011,4,25,10,827,1103,1930,2442
0132-000,2011,4,25,11,837,957,1794,1930
0132-000,2011,4,25,12,893,952,1845,1794
0132-000,2011,4,25,13,827,939,1766,1845
0132-000,2011,4,25,14,895,983,1878,1766
0132-000,2011,4,25,15,1032,1046,2078,1878
0132-000,2011,4,25,16,1059,988,2047,2078
0132-000,2011,4,25,17,1097,957,2054,2047
0132-000,2011,4,25,18,1302,927,2229,2054
0132-000,2011,4,25,19,1318,945,2263,2229
0132-000,2011,4,25,20,1026,734,1760,2263
0132-000,2011,4,25,21,785,605,1390,1760
0132-000,2011,4,25,22,656,587,1243,1390
0132-000,2011,4,25,23,386,349,735,1243
0132-000,2011,4,25,24,244,230,474,735
0132-000,2011,4,26,1,186,180,366,474
0132-000,2011,4,26,2,114,110,224,366
0132-000,2011,4,26,3,94,107,201,224
0132-000,2011,4,26,4,86,107,193,201
0132-000,2011,4,26,5,79,113,192,193
0132-000,2011,4,26,6,178,142,320,192
0132-000,2011,4,26,7,397,418,815,320
0132-000,2011,4,26,8,768,1329,2097,815
0132-000,2011,4,26,9,876,1475,2351,2097
0132-000,2011,4,26,10,799,1012,1811,2351
0132-000,2011,4,26,11,853,917,1770,1811
0132-000,2011,4,26,12,899,886,1785,1770
0132-000,2011,4,26,13,742,801,1543,1785
0132-000,2011,4,26,14,870,922,1792,1543
0132-000,2011,4,26,15,934,942,1876,1792
0132-000,2011,4,26,16,1021,909,1930,1876
0132-000,2011,4,26,17,1025,867,1892,1930
0132-000,2011,4,26,18,1071,852,1923,1892
0132-000,2011,4,26,19,1246,840,2086,1923
0132-000,2011,4,26,20,885,648,1533,2086
0132-000,2011,4,26,21,742,542,1284,1533
0132-000,2011,4,26,22,651,481,1132,1284
0132-000,2011,4,26,23,407,376,783,1132
0132-000,2011,4,26,24,243,255,498,783
0132-000,2011,4,27,1,178,183,361,498
0132-000,2011,4,27,2,106,138,244,361
0132-000,2011,4,27,3,84,92,176,244
0132-000,2011,4,27,4,85,87,172,176
0132-000,2011,4,27,5,106,104,210,172
0132-000,2011,4,27,6,159,154,313,210
0132-000,2011,4,27,7,413,397,810,313
0132-000,2011,4,27,8,746,1322,2068,810
0132-000,2011,4,27,9,836,1436,2272,2068
0132-000,2011,4,27,10,883,993,1876,2272
0132-000,2011,4,27,11,869,1005,1874,1876
0132-000,2011,4,27,12,861,956,1817,1874
0132-000,2011,4,27,13,867,938,1805,1817
0132-000,2011,4,27,14,893,990,1883,1805
0132-000,2011,4,27,15,1050,1018,2068,1883
0132-000,2011,4,27,16,1027,959,1986,2068
0132-000,2011,4,27,17,1123,905,2028,1986
0132-000,2011,4,27,18,1215,908,2123,2028
0132-000,2011,4,27,19,1296,906,2202,2123
0132-000,2011,4,27,20,973,761,1734,2202
0132-000,2011,4,27,21,743,569,1312,1734
0132-000,2011,4,27,22,646,543,1189,1312
0132-000,2011,4,27,23,394,413,807,1189
0132-000,2011,4,27,24,233,284,517,807
0132-000,2011,4,28,1,191,181,372,517
0132-000,2011,4,28,2,118,114,232,372
0132-000,2011,4,28,3,83,100,183,232
0132-000,2011,4,28,4,93,108,201,183
0132-000,2011,4,28,5,122,136,258,201
0132-000,2011,4,28,6,206,181,387,258
0132-000,2011,4,28,7,415,456,871,387
0132-000,2011,4,28,8,862,1400,2262,871
0132-000,2011,4,28,9,860,1459,2319,2262
0132-000,2011,4,28,10,864,1061,1925,2319
0132-000,2011,4,28,11,856,963,1819,1925
0132-000,2011,4,28,12,864,951,1815,1819
0132-000,2011,4,28,13,822,846,1668,1815
0132-000,2011,4,28,14,884,993,1877,1668
0132-000,2011,4,28,15,1024,1008,2032,1877
0132-000,2011,4,28,16,1044,952,1996,2032
0132-000,2011,4,28,17,1091,956,2047,1996
0132-000,2011,4,28,18,1328,908,2236,2047
0132-000,2011,4,28,19,1332,893,2225,2236
0132-000,2011,4,28,20,973,734,1707,2225
0132-000,2011,4,28,21,784,576,1360,1707
0132-000,2011,4,28,22,703,514,1217,1360
0132-000,2011,4,28,23,485,411,896,1217
0132-000,2011,4,28,24,262,291,553,896
0132-000,2011,4,29,1,214,207,421,553
0132-000,2011,4,29,2,130,148,278,421
0132-000,2011,4,29,3,88,104,192,278
0132-000,2011,4,29,4,86,108,194,192
0132-000,2011,4,29,5,106,112,218,194
0132-000,2011,4,29,6,251,187,438,218
0132-000,2011,4,29,7,439,481,920,438
0132-000,2011,4,29,8,843,1403,2246,920
0132-000,2011,4,29,9,921,1427,2348,2246
0132-000,2011,4,29,10,862,1031,1893,2348
0132-000,2011,4,29,11,894,978,1872,1893
0132-000,2011,4,29,12,942,981,1923,1872
0132-000,2011,4,29,13,874,876,1750,1923
0132-000,2011,4,29,14,939,971,1910,1750
0132-000,2011,4,29,15,1073,1034,2107,1910
0132-000,2011,4,29,16,1132,906,2038,2107
0132-000,2011,4,29,17,1041,924,1965,2038
0132-000,2011,4,29,18,1385,939,2324,1965
0132-000,2011,4,29,19,1453,939,2392,2324
0132-000,2011,4,29,20,1176,845,2021,2392
0132-000,2011,4,29,21,855,689,1544,2021
0132-000,2011,4,29,22,729,629,1358,1544
0132-000,2011,4,29,23,489,475,964,1358
0132-000,2011,4,29,24,355,330,685,964
0132-000,2011,4,30,1,215,255,470,685
0132-000,2011,4,30,2,153,163,316,470
0132-000,2011,4,30,3,141,141,282,316
0132-000,2011,4,30,4,96,127,223,282
0132-000,2011,4,30,5,106,96,202,223
0132-000,2011,4,30,6,135,113,248,202
0132-000,2011,4,30,7,236,218,454,248
0132-000,2011,4,30,8,548,673,1221,454
0132-000,2011,4,30,9,727,943,1670,1221
0132-000,2011,4,30,10,698,791,1489,1670
0132-000,2011,4,30,11,733,807,1540,1489
0132-000,2011,4,30,12,810,879,1689,1540
0132-000,2011,4,30,13,900,896,1796,1689
0132-000,2011,4,30,14,937,891,1828,1796
0132-000,2011,4,30,15,1001,933,1934,1828
0132-000,2011,4,30,16,982,985,1967,1934
0132-000,2011,4,30,17,1020,1014,2034,1967
0132-000,2011,4,30,18,1257,1086,2343,2034
0132-000,2011,4,30,19,1199,913,2112,2343
0132-000,2011,4,30,20,740,655,1395,2112
0132-000,2011,4,30,21,554,596,1150,1395
0132-000,2011,4,30,22,442,474,916,1150
0132-000,2011,4,30,23,312,354,666,916
0132-000,2011,4,30,24,229,279,508,666
0132-000,2011,5,1,1,164,176,340,508
0132-000,2011,5,1,2,127,137,264,340
0132-000,2011,5,1,3,91,126,217,264
0132-000,2011,5,1,4,78,71,149,217
0132-000,2011,5,1,5,89,104,193,149
0132-000,2011,5,1,6,111,177,288,193
0132-000,2011,5,1,7,201,276,477,288
0132-000,2011,5,1,8,277,400,677,477
0132-000,2011,5,1,9,401,537,938,677
0132-000,2011,5,1,10,530,614,1144,938
0132-000,2011,5,1,11,628,695,1323,1144
0132-000,2011,5,1,12,675,718,1393,1323
0132-000,2011,5,1,13,675,742,1417,1393
0132-000,2011,5,1,14,809,789,1598,1417
0132-000,2011,5,1,15,929,744,1673,1598
0132-000,2011,5,1,16,1002,764,1766,1673
0132-000,2011,5,1,17,1179,733,1912,1766
0132-000,2011,5,1,18,1420,703,2123,1912
0132-000,2011,5,1,19,1436,635,2071,2123
0132-000,2011,5,1,20,1221,598,1819,2071
0132-000,2011,5,1,21,818,571,1389,1819
0132-000,2011,5,1,22,591,502,1093,1389
0132-000,2011,5,1,23,354,402,756,1093
0132-000,2011,5,1,24,270,260,530,756
0132-000,2011,5,2,1,138,187,325,530
0132-000,2011,5,2,2,98,121,219,325
0132-000,2011,5,2,3,62,92,154,219
0132-000,2011,5,2,4,80,87,167,154
0132-000,2011,5,2,5,103,115,218,167
0132-000,2011,5,2,6,220,231,451,218
0132-000,2011,5,2,7,526,651,1177,451
0132-000,2011,5,2,8,837,1620,2457,1177
0132-000,2011,5,2,9,882,1485,2367,2457
0132-000,2011,5,2,10,744,1050,1794,2367
0132-000,2011,5,2,11,884,929,1813,1794
0132-000,2011,5,2,12,903,917,1820,1813
0132-000,2011,5,2,13,839,902,1741,1820
0132-000,2011,5,2,14,875,953,1828,1741
0132-000,2011,5,2,15,954,1057,2011,1828
0132-000,2011,5,2,16,1090,960,2050,2011
0132-000,2011,5,2,17,1104,923,2027,2050
0132-000,2011,5,2,18,1249,1005,2254,2027
0132-000,2011,5,2,19,1278,938,2216,2254
0132-000,2011,5,2,20,974,743,1717,2216
0132-000,2011,5,2,21,808,603,1411,1717
0132-000,2011,5,2,22,652,534,1186,1411
0132-000,2011,5,2,23,442,419,861,1186
0132-000,2011,5,2,24,284,270,554,861
0132-000,2011,5,3,1,183,195,378,554
0132-000,2011,5,3,2,129,138,267,378
0132-000,2011,5,3,3,100,97,197,267
0132-000,2011,5,3,4,72,109,181,197
0132-000,2011,5,3,5,102,101,203,181
0132-000,2011,5,3,6,204,163,367,203
0132-000,2011,5,3,7,440,482,922,367
0132-000,2011,5,3,8,777,1445,2222,922
0132-000,2011,5,3,9,895,1393,2288,2222
0132-000,2011,5,3,10,858,1045,1903,2288
0132-000,2011,5,3,11,866,987,1853,1903
0132-000,2011,5,3,12,884,1005,1889,1853
0132-000,2011,5,3,13,845,842,1687,1889
0132-000,2011,5,3,14,943,1000,1943,1687
0132-000,2011,5,3,15,993,1011,2004,1943
0132-000,2011,5,3,16,1076,960,2036,2004
0132-000,2011,5,3,17,1103,879,1982,2036
0132-000,2011,5,3,18,1241,939,2180,1982
0132-000,2011,5,3,19,1264,917,2181,2180
0132-000,2011,5,3,20,989,735,1724,2181
0132-000,2011,5,3,21,795,624,1419,1724
0132-000,2011,5,3,22,690,555,1245,1419
0132-000,2011,5,3,23,432,418,850,1245
0132-000,2011,5,3,24,288,270,558,850
0132-000,2011,5,4,1,184,200,384,558
0132-000,2011,5,4,2,124,156,280,384
0132-000,2011,5,4,3,125,137,262,280
0132-000,2011,5,4,4,95,115,210,262
0132-000,2011,5,4,5,96,97,193,210
0132-000,2011,5,4,6,245,157,402,193
0132-000,2011,5,4,7,421,438,859,402
0132-000,2011,5,4,8,806,1440,2246,859
0132-000,2011,5,4,9,884,1425,2309,2246
0132-000,2011,5,4,10,858,1064,1922,2309
0132-000,2011,5,4,11,860,1029,1889,1922
0132-000,2011,5,4,12,862,947,1809,1889
0132-000,2011,5,4,13,893,879,1772,1809
0132-000,2011,5,4,14,995,930,1925,1772
0132-000,2011,5,4,15,975,1093,2068,1925
0132-000,2011,5,4,16,1172,971,2143,2068
0132-000,2011,5,4,17,1157,954,2111,2143
0132-000,2011,5,4,18,1364,998,2362,2111
0132-000,2011,5,4,19,1535,1078,2613,2362
0132-000,2011,5,4,20,1275,957,2232,2613
0132-000,2011,5,4,21,1025,758,1783,2232
0132-000,2011,5,4,22,792,653,1445,1783
0132-000,2011,5,4,23,545,502,1047,1445
0132-000,2011,5,4,24,352,357,709,1047
0132-000,2011,5,5,1,241,252,493,709
0132-000,2011,5,5,2,183,217,400,493
0132-000,2011,5,5,3,159,170,329,400
0132-000,2011,5,5,4,122,138,260,329
0132-000,2011,5,5,5,124,118,242,260
0132-000,2011,5,5,6,201,177,378,242
0132-000,2011,5,5,7,355,364,719,378
0132-000,2011,5,5,8,500,654,1154,719
0132-000,2011,5,5,9,587,784,1371,1154
0132-000,2011,5,5,10,696,961,1657,1371
0132-000,2011,5,5,11,718,1172,1890,1657
0132-000,2011,5,5,12,741,1325,2066,1890
0132-000,2011,5,5,13,671,1341,2012,2066
0132-000,2011,5,5,14,686,1099,1785,2012
0132-000,2011,5,5,15,781,755,1536,1785
0132-000,2011,5,5,16,817,742,1559,1536
0132-000,2011,5,5,17,933,675,1608,1559
0132-000,2011,5,5,18,1058,745,1803,1608
0132-000,2011,5,5,19,922,719,1641,1803
0132-000,2011,5,5,20,785,676,1461,1641
0132-000,2011,5,5,21,695,552,1247,1461
0132-000,2011,5,5,22,560,477,1037,1247
0132-000,2011,5,5,23,392,342,734,1037
0132-000,2011,5,5,24,219,290,509,734
0132-000,2011,5,6,1,165,195,360,509
0132-000,2011,5,6,2,107,125,232,360
0132-000,2011,5,6,3,80,115,195,232
0132-000,2011,5,6,4,85,98,183,195
0132-000,2011,5,6,5,93,107,200,183
0132-000,2011,5,6,6,205,192,397,200
0132-000,2011,5,6,7,430,541,971,397
0132-000,2011,5,6,8,844,1479,2323,971
0132-000,2011,5,6,9,903,1303,2206,2323
0132-000,2011,5,6,10,829,1008,1837,2206
0132-000,2011,5,6,11,896,938,1834,1837
0132-000,2011,5,6,12,916,1133,2049,1834
0132-000,2011,5,6,13,809,935,1744,2049
0132-000,2011,5,6,14,944,982,1926,1744
0132-000,2011,5,6,15,1025,1005,2030,1926
0132-000,2011,5,6,16,1055,978,2033,2030
0132-000,2011,5,6,17,1184,995,2179,2033
0132-000,2011,5,6,18,1333,994,2327,2179
0132-000,2011,5,6,19,1399,1012,2411,2327
0132-000,2011,5,6,20,1061,871,1932,2411
0132-000,2011,5,6,21,829,632,1461,1932
0132-000,2011,5,6,22,694,590,1284,1461
0132-000,2011,5,6,23,487,475,962,1284
0132-000,2011,5,6,24,304,281,585,962
0132-000,2011,5,7,1,200,252,452,585
0132-000,2011,5,7,2,128,161,289,452
0132-000,2011,5,7,3,133,140,273,289
0132-000,2011,5,7,4,98,139,237,273
0132-000,2011,5,7,5,138,124,262,237
0132-000,2011,5,7,6,150,140,290,262
0132-000,2011,5,7,7,316,309,625,290
0132-000,2011,5,7,8,584,772,1356,625
0132-000,2011,5,7,9,697,914,1611,1356
0132-000,2011,5,7,10,781,950,1731,1611
0132-000,2011,5,7,11,844,1300,2144,1731
0132-000,2011,5,7,12,930,1738,2668,2144
0132-000,2011,5,7,13,915,1899,2814,2668
0132-000,2011,5,7,14,943,1871,2814,2814
0132-000,2011,5,7,15,988,2001,2989,2814
0132-000,2011,5,7,16,1150,1967,3117,2989
0132-000,2011,5,7,17,1450,1935,3385,3117
0132-000,2011,5,7,18,1708,2117,3825,3385
0132-000,2011,5,7,19,1746,2182,3928,3825
0132-000,2011,5,7,20,1460,2140,3600,3928
0132-000,2011,5,7,21,1209,1921,3130,3600
0132-000,2011,5,7,22,809,1818,2627,3130
0132-000,2011,5,7,23,572,1645,2217,2627
0132-000,2011,5,7,24,332,1200,1532,2217
0132-000,2011,5,8,1,225,450,675,1532
0132-000,2011,5,8,2,128,178,306,675
0132-000,2011,5,8,3,97,102,199,306
0132-000,2011,5,8,4,78,93,171,199
0132-000,2011,5,8,5,88,116,204,171
0132-000,2011,5,8,6,126,127,253,204
0132-000,2011,5,8,7,251,257,508,253
0132-000,2011,5,8,8,290,351,641,508
0132-000,2011,5,8,9,453,586,1039,641
0132-000,2011,5,8,10,578,730,1308,1039
0132-000,2011,5,8,11,792,981,1773,1308
0132-000,2011,5,8,12,964,1061,2025,1773
0132-000,2011,5,8,13,1389,1081,2470,2025
0132-000,2011,5,8,14,1443,897,2340,2470
0132-000,2011,5,8,15,1626,850,2476,2340
0132-000,2011,5,8,16,1753,966,2719,2476
0132-000,2011,5,8,17,1792,978,2770,2719
0132-000,2011,5,8,18,1965,965,2930,2770
0132-000,2011,5,8,19,1980,812,2792,2930
0132-000,2011,5,8,20,1877,684,2561,2792
0132-000,2011,5,8,21,1806,630,2436,2561
0132-000,2011,5,8,22,1645,545,2190,2436
0132-000,2011,5,8,23,1535,455,1990,2190
0132-000,2011,5,8,24,1478,312,1790,1990
0132-000,2011,5,9,1,1521,203,1724,1790
0132-000,2011,5,9,2,1256,110,1366,1724
0132-000,2011,5,9,3,169,88,257,1366
0132-000,2011,5,9,4,79,95,174,257
0132-000,2011,5,9,5,113,113,226,174
0132-000,2011,5,9,6,206,176,382,226
0132-000,2011,5,9,7,466,544,1010,382
0132-000,2011,5,9,8,812,1440,2252,1010
0132-000,2011,5,9,9,825,1231,2056,2252
0132-000,2011,5,9,10,838,1057,1895,2056
0132-000,2011,5,9,11,911,971,1882,1895
0132-000,2011,5,9,12,932,990,1922,1882
0132-000,2011,5,9,13,919,912,1831,1922
0132-000,2011,5,9,14,885,1060,1945,1831
0132-000,2011,5,9,15,1014,1016,2030,1945
0132-000,2011,5,9,16,1079,988,2067,2030
0132-000,2011,5,9,17,1086,893,1979,2067
0132-000,2011,5,9,18,1289,851,2140,1979
0132-000,2011,5,9,19,1289,928,2217,2140
0132-000,2011,5,9,20,1087,743,1830,2217
0132-000,2011,5,9,21,935,574,1509,1830
0132-000,2011,5,9,22,713,552,1265,1509
0132-000,2011,5,9,23,404,393,797,1265
0132-000,2011,5,9,24,268,248,516,797
0132-000,2011,5,10,1,201,212,413,516
0132-000,2011,5,10,2,129,147,276,413
0132-000,2011,5,10,3,116,124,240,276
0132-000,2011,5,10,4,77,128,205,240
0132-000,2011,5,10,5,93,111,204,205
0132-000,2011,5,10,6,150,119,269,204
0132-000,2011,5,10,7,233,306,539,269
0132-000,2011,5,10,8,431,653,1084,539
0132-000,2011,5,10,9,565,720,1285,1084
0132-000,2011,5,10,10,626,767,1393,1285
0132-000,2011,5,10,11,664,839,1503,1393
0132-000,2011,5,10,12,768,744,1512,1503
0132-000,2011,5,10,13,766,651,1417,1512
0132-000,2011,5,10,14,945,656,1601,1417
0132-000,2011,5,10,15,1063,732,1795,1601
0132-000,2011,5,10,16,1066,722,1788,1795
0132-000,2011,5,10,17,1077,665,1742,1788
0132-000,2011,5,10,18,1425,720,2145,1742
0132-000,2011,5,10,19,1411,659,2070,2145
0132-000,2011,5,10,20,901,546,1447,2070
0132-000,2011,5,10,21,538,448,986,1447
0132-000,2011,5,10,22,443,373,816,986
0132-000,2011,5,10,23,352,332,684,816
0132-000,2011,5,10,24,188,235,423,684
0132-000,2011,5,11,1,150,164,314,423
0132-000,2011,5,11,2,109,85,194,314
0132-000,2011,5,11,3,64,112,176,194
0132-000,2011,5,11,4,65,101,166,176
0132-000,2011,5,11,5,82,98,180,166
0132-000,2011,5,11,6,181,158,339,180
0132-000,2011,5,11,7,394,444,838,339
0132-000,2011,5,11,8,773,1459,2232,838
0132-000,2011,5,11,9,839,1439,2278,2232
0132-000,2011,5,11,10,854,1023,1877,2278
0132-000,2011,5,11,11,852,997,1849,1877
0132-000,2011,5,11,12,885,1007,1892,1849
0132-000,2011,5,11,13,853,905,1758,1892
0132-000,2011,5,11,14,934,1023,1957,1758
0132-000,2011,5,11,15,998,1073,2071,1957
0132-000,2011,5,11,16,1055,986,2041,2071
0132-000,2011,5,11,17,1079,898,1977,2041
0132-000,2011,5,11,18,1140,829,1969,1977
0132-000,2011,5,11,19,1252,986,2238,1969
0132-000,2011,5,11,20,934,725,1659,2238
0132-000,2011,5,11,21,777,573,1350,1659
0132-000,2011,5,11,22,652,507,1159,1350
0132-000,2011,5,11,23,419,375,794,1159
0132-000,2011,5,11,24,272,236,508,794
0132-000,2011,5,12,1,194,194,388,508
0132-000,2011,5,12,2,152,153,305,388
0132-000,2011,5,12,3,75,121,196,305
0132-000,2011,5,12,4,105,111,216,196
0132-000,2011,5,12,5,116,130,246,216
0132-000,2011,5,12,6,217,187,404,246
0132-000,2011,5,12,7,408,420,828,404
0132-000,2011,5,12,8,784,1364,2148,828
0132-000,2011,5,12,9,875,1404,2279,2148
0132-000,2011,5,12,10,895,1029,1924,2279
0132-000,2011,5,12,11,877,953,1830,1924
0132-000,2011,5,12,12,907,913,1820,1830
0132-000,2011,5,12,13,834,853,1687,1820
0132-000,2011,5,12,14,1000,993,1993,1687
0132-000,2011,5,12,15,996,1069,2065,1993
0132-000,2011,5,12,16,1018,983,2001,2065
0132-000,2011,5,12,17,1136,938,2074,2001
0132-000,2011,5,12,18,1283,931,2214,2074
0132-000,2011,5,12,19,1233,891,2124,2214
0132-000,2011,5,12,20,899,740,1639,2124
0132-000,2011,5,12,21,862,613,1475,1639
0132-000,2011,5,12,22,734,563,1297,1475
0132-000,2011,5,12,23,439,400,839,1297
0132-000,2011,5,12,24,283,222,505,839
0132-000,2011,5,13,1,198,207,405,505
0132-000,2011,5,13,2,124,150,274,405
0132-000,2011,5,13,3,127,118,245,274
0132-000,2011,5,13,4,77,100,177,245
0132-000,2011,5,13,5,111,141,252,177
0132-000,2011,5,13,6,216,175,391,252
0132-000,2011,5,13,7,444,501,945,391
0132-000,2011,5,13,8,850,1392,2242,945
0132-000,2011,5,13,9,880,1402,2282,2242
0132-000,2011,5,13,10,902,985,1887,2282
0132-000,2011,5,13,11,906,984,1890,1887
0132-000,2011,5,13,12,929,1034,1963,1890
0132-000,2011,5,13,13,863,860,1723,1963
0132-000,2011,5,13,14,982,1010,1992,1723
0132-000,2011,5,13,15,1052,1065,2117,1992
0132-000,2011,5,13,16,1131,1063,2194,2117
0132-000,2011,5,13,17,1131,922,2053,2194
0132-000,2011,5,13,18,1325,1018,2343,2053
0132-000,2011,5,13,19,1557,1036,2593,2343
0132-000,2011,5,13,20,1160,878,2038,2593
0132-000,2011,5,13,21,891,689,1580,2038
0132-000,2011,5,13,22,735,582,1317,1580
0132-000,2011,5,13,23,517,499,1016,1317
0132-000,2011,5,13,24,342,337,679,1016
0132-000,2011,5,14,1,225,289,514,679
0132-000,2011,5,14,2,167,180,347,514
0132-000,2011,5,14,3,127,156,283,347
0132-000,2011,5,14,4,122,162,284,283
0132-000,2011,5,14,5,125,134,259,284
0132-000,2011,5,14,6,218,204,422,259
0132-000,2011,5,14,7,381,372,753,422
0132-000,2011,5,14,8,659,835,1494,753
0132-000,2011,5,14,9,747,885,1632,1494
0132-000,2011,5,14,10,792,953,1745,1632
0132-000,2011,5,14,11,847,1201,2048,1745
0132-000,2011,5,14,12,941,1538,2479,2048
0132-000,2011,5,14,13,897,1558,2455,2479
0132-000,2011,5,14,14,921,1464,2385,2455
0132-000,2011,5,14,15,1012,1409,2421,2385
0132-000,2011,5,14,16,1091,1266,2357,2421
0132-000,2011,5,14,17,1152,1435,2587,2357
0132-000,2011,5,14,18,1395,1347,2742,2587
0132-000,2011,5,14,19,1560,1291,2851,2742
0132-000,2011,5,14,20,1201,883,2084,2851
0132-000,2011,5,14,21,736,667,1403,2084
0132-000,2011,5,14,22,586,605,1191,1403
0132-000,2011,5,14,23,431,394,825,1191
0132-000,2011,5,14,24,294,318,612,825
0132-000,2011,5,15,1,197,246,443,612
0132-000,2011,5,15,2,154,179,333,443
0132-000,2011,5,15,3,115,119,234,333
0132-000,2011,5,15,4,85,95,180,234
0132-000,2011,5,15,5,112,105,217,180
0132-000,2011,5,15,6,155,146,301,217
0132-000,2011,5,15,7,247,262,509,301
0132-000,2011,5,15,8,358,426,784,509
0132-000,2011,5,15,9,416,537,953,784
0132-000,2011,5,15,10,548,600,1148,953
0132-000,2011,5,15,11,623,719,1342,1148
0132-000,2011,5,15,12,621,710,1331,1342
0132-000,2011,5,15,13,879,708,1587,1331
0132-000,2011,5,15,14,1175,700,1875,1587
0132-000,2011,5,15,15,1120,679,1799,1875
0132-000,2011,5,15,16,1300,716,2016,1799
0132-000,2011,5,15,17,1523,693,2216,2016
0132-000,2011,5,15,18,1652,713,2365,2216
0132-000,2011,5,15,19,1716,693,2409,2365
0132-000,2011,5,15,20,1461,591,2052,2409
0132-000,2011,5,15,21,1172,587,1759,2052
0132-000,2011,5,15,22,801,523,1324,1759
0132-000,2011,5,15,23,504,401,905,1324
0132-000,2011,5,15,24,263,297,560,905
0132-000,2011,5,16,1,160,210,370,560
0132-000,2011,5,16,2,98,109,207,370
0132-000,2011,5,16,3,64,93,157,207
0132-000,2011,5,16,4,65,78,143,157
0132-000,2011,5,16,5,95,101,196,143
0132-000,2011,5,16,6,226,226,452,196
0132-000,2011,5,16,7,524,681,1205,452
0132-000,2011,5,16,8,858,1665,2523,1205
0132-000,2011,5,16,9,895,1510,2405,2523
0132-000,2011,5,16,10,837,1017,1854,2405
0132-000,2011,5,16,11,873,984,1857,1854
0132-000,2011,5,16,12,882,1052,1934,1857
0132-000,2011,5,16,13,884,894,1778,1934
0132-000,2011,5,16,14,957,997,1954,1778
0132-000,2011,5,16,15,1004,1056,2060,1954
0132-000,2011,5,16,16,1004,1016,2020,2060
0132-000,2011,5,16,17,1187,951,2138,2020
0132-000,2011,5,16,18,1172,935,2107,2138
0132-000,2011,5,16,19,1276,939,2215,2107
0132-000,2011,5,16,20,955,787,1742,2215
0132-000,2011,5,16,21,886,633,1519,1742
0132-000,2011,5,16,22,735,596,1331,1519
0132-000,2011,5,16,23,452,397,849,1331
0132-000,2011,5,16,24,264,263,527,849
0132-000,2011,5,17,1,191,189,380,527
0132-000,2011,5,17,2,107,127,234,380
0132-000,2011,5,17,3,96,113,209,234
0132-000,2011,5,17,4,98,107,205,209
0132-000,2011,5,17,5,127,116,243,205
0132-000,2011,5,17,6,251,179,430,243
0132-000,2011,5,17,7,444,491,935,430
0132-000,2011,5,17,8,775,1466,2241,935
0132-000,2011,5,17,9,902,1439,2341,2241
0132-000,2011,5,17,10,844,1060,1904,2341
0132-000,2011,5,17,11,897,1023,1920,1904
0132-000,2011,5,17,12,876,980,1856,1920
0132-000,2011,5,17,13,842,838,1680,1856
0132-000,2011,5,17,14,946,915,1861,1680
0132-000,2011,5,17,15,969,1042,2011,1861
0132-000,2011,5,17,16,1096,979,2075,2011
0132-000,2011,5,17,17,1055,926,1981,2075
0132-000,2011,5,17,18,1291,903,2194,1981
0132-000,2011,5,17,19,1255,912,2167,2194
0132-000,2011,5,17,20,964,730,1694,2167
0132-000,2011,5,17,21,833,639,1472,1694
0132-000,2011,5,17,22,678,577,1255,1472
0132-000,2011,5,17,23,410,394,804,1255
0132-000,2011,5,17,24,324,259,583,804
0132-000,2011,5,18,1,227,186,413,583
0132-000,2011,5,18,2,132,156,288,413
0132-000,2011,5,18,3,96,108,204,288
0132-000,2011,5,18,4,78,100,178,204
0132-000,2011,5,18,5,111,137,248,178
0132-000,2011,5,18,6,217,197,414,248
0132-000,2011,5,18,7,436,485,921,414
0132-000,2011,5,18,8,843,1443,2286,921
0132-000,2011,5,18,9,900,1444,2344,2286
0132-000,2011,5,18,10,909,1116,2025,2344
0132-000,2011,5,18,11,806,1021,1827,2025
0132-000,2011,5,18,12,875,948,1823,1827
0132-000,2011,5,18,13,812,864,1676,1823
0132-000,2011,5,18,14,911,1013,1924,1676
0132-000,2011,5,18,15,967,1004,1971,1924
0132-000,2011,5,18,16,988,998,1986,1971
0132-000,2011,5,18,17,1054,917,1971,1986
0132-000,2011,5,18,18,1268,969,2237,1971
0132-000,2011,5,18,19,1327,956,2283,2237
0132-000,2011,5,18,20,993,817,1810,2283
0132-000,2011,5,18,21,858,611,1469,1810
0132-000,2011,5,18,22,705,523,1228,1469
0132-000,2011,5,18,23,456,403,859,1228
0132-000,2011,5,18,24,312,294,606,859
0132-000,2011,5,19,1,218,212,430,606
0132-000,2011,5,19,2,150,127,277,430
0132-000,2011,5,19,3,115,120,235,277
0132-000,2011,5,19,4,107,101,208,235
0132-000,2011,5,19,5,104,140,244,208
0132-000,2011,5,19,6,257,199,456,244
0132-000,2011,5,19,7,460,505,965,456
0132-000,2011,5,19,8,858,1443,2301,965
0132-000,2011,5,19,9,863,1356,2219,2301
0132-000,2011,5,19,10,860,1060,1920,2219
0132-000,2011,5,19,11,889,968,1857,1920
0132-000,2011,5,19,12,837,912,1749,1857
0132-000,2011,5,19,13,798,856,1654,1749
0132-000,2011,5,19,14,921,947,1868,1654
0132-000,2011,5,19,15,1045,1018,2063,1868
0132-000,2011,5,19,16,994,907,1901,2063
0132-000,2011,5,19,17,1039,907,1946,1901
0132-000,2011,5,19,18,1210,918,2128,1946
0132-000,2011,5,19,19,1325,930,2255,2128
0132-000,2011,5,19,20,981,751,1732,2255
0132-000,2011,5,19,21,810,681,1491,1732
0132-000,2011,5,19,22,697,515,1212,1491
0132-000,2011,5,19,23,443,356,799,1212
0132-000,2011,5,19,24,355,284,639,799
0132-000,2011,5,20,1,212,214,426,639
0132-000,2011,5,20,2,155,138,293,426
0132-000,2011,5,20,3,133,133,266,293
0132-000,2011,5,20,4,116,111,227,266
0132-000,2011,5,20,5,118,146,264,227
0132-000,2011,5,20,6,218,176,394,264
0132-000,2011,5,20,7,413,487,900,394
0132-000,2011,5,20,8,825,1292,2117,900
0132-000,2011,5,20,9,871,1337,2208,2117
0132-000,2011,5,20,10,828,1022,1850,2208
0132-000,2011,5,20,11,837,967,1804,1850
0132-000,2011,5,20,12,916,948,1864,1804
0132-000,2011,5,20,13,855,878,1733,1864
0132-000,2011,5,20,14,984,957,1941,1733
0132-000,2011,5,20,15,1024,988,2012,1941
0132-000,2011,5,20,16,1059,948,2007,2012
0132-000,2011,5,20,17,1052,885,1937,2007
0132-000,2011,5,20,18,1329,915,2244,1937
0132-000,2011,5,20,19,1486,957,2443,2244
0132-000,2011,5,20,20,1136,789,1925,2443
0132-000,2011,5,20,21,880,678,1558,1925
0132-000,2011,5,20,22,667,597,1264,1558
0132-000,2011,5,20,23,437,455,892,1264
0132-000,2011,5,20,24,339,307,646,892
0132-000,2011,5,21,1,245,242,487,646
0132-000,2011,5,21,2,134,178,312,487
0132-000,2011,5,21,3,133,124,257,312
0132-000,2011,5,21,4,103,113,216,257
0132-000,2011,5,21,5,121,160,281,216
0132-000,2011,5,21,6,186,183,369,281
0132-000,2011,5,21,7,354,348,702,369
0132-000,2011,5,21,8,660,780,1440,702
0132-000,2011,5,21,9,739,965,1704,1440
0132-000,2011,5,21,10,790,866,1656,1704
0132-000,2011,5,21,11,816,930,1746,1656
0132-000,2011,5,21,12,906,1062,1968,1746
0132-000,2011,5,21,13,1003,1161,2164,1968
0132-000,2011,5,21,14,1040,1193,2233,2164
0132-000,2011,5,21,15,1020,1232,2252,2233
0132-000,2011,5,21,16,1026,1153,2179,2252
0132-000,2011,5,21,17,1261,1263,2524,2179
0132-000,2011,5,21,18,1426,1275,2701,2524
0132-000,2011,5,21,19,1472,1188,2660,2701
0132-000,2011,5,21,20,940,937,1877,2660
0132-000,2011,5,21,21,736,666,1402,1877
0132-000,2011,5,21,22,551,561,1112,1402
0132-000,2011,5,21,23,341,405,746,1112
0132-000,2011,5,21,24,264,297,561,746
0132-000,2011,5,22,1,218,236,454,561
0132-000,2011,5,22,2,136,147,283,454
0132-000,2011,5,22,3,123,123,246,283
0132-000,2011,5,22,4,75,97,172,246
0132-000,2011,5,22,5,95,100,195,172
0132-000,2011,5,22,6,131,136,267,195
0132-000,2011,5,22,7,275,287,562,267
0132-000,2011,5,22,8,361,431,792,562
0132-000,2011,5,22,9,468,524,992,792
0132-000,2011,5,22,10,537,591,1128,992
0132-000,2011,5,22,11,585,694,1279,1128
0132-000,2011,5,22,12,645,653,1298,1279
0132-000,2011,5,22,13,729,677,1406,1298
0132-000,2011,5,22,14,693,667,1360,1406
0132-000,2011,5,22,15,806,707,1513,1360
0132-000,2011,5,22,16,990,727,1717,1513
0132-000,2011,5,22,17,1304,760,2064,1717
0132-000,2011,5,22,18,1346,757,2103,2064
0132-000,2011,5,22,19,1350,724,2074,2103
0132-000,2011,5,22,20,850,622,1472,2074
0132-000,2011,5,22,21,738,565,1303,1472
0132-000,2011,5,22,22,570,542,1112,1303
0132-000,2011,5,22,23,376,417,793,1112
0132-000,2011,5,22,24,213,263,476,793
0132-000,2011,5,23,1,144,202,346,476
0132-000,2011,5,23,2,92,126,218,346
0132-000,2011,5,23,3,76,72,148,218
0132-000,2011,5,23,4,64,74,138,148
0132-000,2011,5,23,5,90,107,197,138
0132-000,2011,5,23,6,239,229,468,197
0132-000,2011,5,23,7,526,639,1165,468
0132-000,2011,5,23,8,877,1680,2557,1165
0132-000,2011,5,23,9,881,1460,2341,2557
0132-000,2011,5,23,10,809,997,1806,2341
0132-000,2011,5,23,11,864,948,1812,1806
0132-000,2011,5,23,12,887,960,1847,1812
0132-000,2011,5,23,13,818,930,1748,1847
0132-000,2011,5,23,14,899,961,1860,1748
0132-000,2011,5,23,15,1009,1002,2011,1860
0132-000,2011,5,23,16,1089,887,1976,2011
0132-000,2011,5,23,17,1093,940,2033,1976
0132-000,2011,5,23,18,1252,902,2154,2033
0132-000,2011,5,23,19,1304,1010,2314,2154
0132-000,2011,5,23,20,1016,810,1826,2314
0132-000,2011,5,23,21,849,643,1492,1826
0132-000,2011,5,23,22,683,570,1253,1492
0132-000,2011,5,23,23,440,397,837,1253
0132-000,2011,5,23,24,287,248,535,837
0132-000,2011,5,24,1,164,204,368,535
0132-000,2011,5,24,2,130,112,242,368
0132-000,2011,5,24,3,100,106,206,242
0132-000,2011,5,24,4,89,100,189,206
0132-000,2011,5,24,5,110,137,247,189
0132-000,2011,5,24,6,255,216,471,247
0132-000,2011,5,24,7,475,469,944,471
0132-000,2011,5,24,8,845,1518,2363,944
0132-000,2011,5,24,9,880,1402,2282,2363
0132-000,2011,5,24,10,859,1044,1903,2282
0132-000,2011,5,24,11,883,981,1864,1903
0132-000,2011,5,24,12,823,942,1765,1864
0132-000,2011,5,24,13,751,919,1670,1765
0132-000,2011,5,24,14,928,1033,1961,1670
0132-000,2011,5,24,15,1008,947,1955,1961
0132-000,2011,5,24,16,1054,942,1996,1955
0132-000,2011,5,24,17,1032,899,1931,1996
0132-000,2011,5,24,18,1236,1017,2253,1931
0132-000,2011,5,24,19,1298,998,2296,2253
0132-000,2011,5,24,20,949,727,1676,2296
0132-000,2011,5,24,21,809,672,1481,1676
0132-000,2011,5,24,22,643,554,1197,1481
0132-000,2011,5,24,23,447,380,827,1197
0132-000,2011,5,24,24,314,242,556,827
0132-000,2011,5,25,1,198,196,394,556
0132-000,2011,5,25,2,133,145,278,394
0132-000,2011,5,25,3,113,130,243,278
0132-000,2011,5,25,4,74,103,177,243
0132-000,2011,5,25,5,116,116,232,177
0132-000,2011,5,25,6,226,197,423,232
0132-000,2011,5,25,7,473,466,939,423
0132-000,2011,5,25,8,820,1424,2244,939
0132-000,2011,5,25,9,867,1419,2286,2244
0132-000,2011,5,25,10,903,1071,1974,2286
0132-000,2011,5,25,11,862,1008,1870,1974
0132-000,2011,5,25,12,936,931,1867,1870
0132-000,2011,5,25,13,826,923,1749,1867
0132-000,2011,5,25,14,908,923,1831,1749
0132-000,2011,5,25,15,1058,1048,2106,1831
0132-000,2011,5,25,16,1036,993,2029,2106
0132-000,2011,5,25,17,1104,923,2027,2029
0132-000,2011,5,25,18,1242,928,2170,2027
0132-000,2011,5,25,19,1368,983,2351,2170
0132-000,2011,5,25,20,1011,759,1770,2351
0132-000,2011,5,25,21,805,580,1385,1770
0132-000,2011,5,25,22,675,540,1215,1385
0132-000,2011,5,25,23,450,394,844,1215
0132-000,2011,5,25,24,237,261,498,844
0132-000,2011,5,26,1,209,210,419,498
0132-000,2011,5,26,2,150,157,307,419
0132-000,2011,5,26,3,119,135,254,307
0132-000,2011,5,26,4,88,116,204,254
0132-000,2011,5,26,5,122,123,245,204
0132-000,2011,5,26,6,222,191,413,245
0132-000,2011,5,26,7,456,423,879,413
0132-000,2011,5,26,8,779,1340,2119,879
0132-000,2011,5,26,9,871,1393,2264,2119
0132-000,2011,5,26,10,813,1022,1835,2264
0132-000,2011,5,26,11,849,921,1770,1835
0132-000,2011,5,26,12,877,832,1709,1770
0132-000,2011,5,26,13,723,875,1598,1709
0132-000,2011,5,26,14,930,891,1821,1598
0132-000,2011,5,26,15,1004,995,1999,1821
0132-000,2011,5,26,16,1009,912,1921,1999
0132-000,2011,5,26,17,1033,874,1907,1921
0132-000,2011,5,26,18,1142,880,2022,1907
0132-000,2011,5,26,19,1244,892,2136,2022
0132-000,2011,5,26,20,915,719,1634,2136
0132-000,2011,5,26,21,810,649,1459,1634
0132-000,2011,5,26,22,704,561,1265,1459
0132-000,2011,5,26,23,432,406,838,1265
0132-000,2011,5,26,24,348,292,640,838
0132-000,2011,5,27,1,179,220,399,640
0132-000,2011,5,27,2,149,136,285,399
0132-000,2011,5,27,3,102,131,233,285
0132-000,2011,5,27,4,95,102,197,233
0132-000,2011,5,27,5,133,124,257,197
0132-000,2011,5,27,6,230,191,421,257
0132-000,2011,5,27,7,456,464,920,421
0132-000,2011,5,27,8,811,1378,2189,920
0132-000,2011,5,27,9,909,1384,2293,2189
0132-000,2011,5,27,10,855,984,1839,2293
0132-000,2011,5,27,11,861,1014,1875,1839
0132-000,2011,5,27,12,920,952,1872,1875
0132-000,2011,5,27,13,812,903,1715,1872
0132-000,2011,5,27,14,957,977,1934,1715
0132-000,2011,5,27,15,1031,929,1960,1934
0132-000,2011,5,27,16,1000,978,1978,1960
0132-000,2011,5,27,17,1134,969,2103,1978
0132-000,2011,5,27,18,1383,915,2298,2103
0132-000,2011,5,27,19,1501,1090,2591,2298
0132-000,2011,5,27,20,1207,923,2130,2591
0132-000,2011,5,27,21,888,710,1598,2130
0132-000,2011,5,27,22,784,628,1412,1598
0132-000,2011,5,27,23,496,498,994,1412
0132-000,2011,5,27,24,335,345,680,994
0132-000,2011,5,28,1,248,273,521,680
0132-000,2011,5,28,2,176,213,389,521
0132-000,2011,5,28,3,127,145,272,389
0132-000,2011,5,28,4,113,140,253,272
0132-000,2011,5,28,5,131,157,288,253
0132-000,2011,5,28,6,239,226,465,288
0132-000,2011,5,28,7,436,399,835,465
0132-000,2011,5,28,8,676,812,1488,835
0132-000,2011,5,28,9,775,921,1696,1488
0132-000,2011,5,28,10,832,950,1782,1696
0132-000,2011,5,28,11,869,1140,2009,1782
0132-000,2011,5,28,12,969,1372,2341,2009
0132-000,2011,5,28,13,929,1446,2375,2341
0132-000,2011,5,28,14,993,1460,2453,2375
0132-000,2011,5,28,15,997,1346,2343,2453
0132-000,2011,5,28,16,1031,1312,2343,2343
0132-000,2011,5,28,17,1064,1297,2361,2343
0132-000,2011,5,28,18,1274,1429,2703,2361
0132-000,2011,5,28,19,1259,1339,2598,2703
0132-000,2011,5,28,20,875,991,1866,2598
0132-000,2011,5,28,21,716,685,1401,1866
0132-000,2011,5,28,22,588,581,1169,1401
0132-000,2011,5,28,23,431,437,868,1169
0132-000,2011,5,28,24,288,354,642,868
0132-000,2011,5,29,1,209,272,481,642
0132-000,2011,5,29,2,159,176,335,481
0132-000,2011,5,29,3,117,128,245,335
0132-000,2011,5,29,4,112,106,218,245
0132-000,2011,5,29,5,99,98,197,218
0132-000,2011,5,29,6,175,164,339,197
0132-000,2011,5,29,7,233,300,533,339
0132-000,2011,5,29,8,306,412,718,533
0132-000,2011,5,29,9,452,494,946,718
0132-000,2011,5,29,10,533,557,1090,946
0132-000,2011,5,29,11,647,619,1266,1090
0132-000,2011,5,29,12,552,601,1153,1266
0132-000,2011,5,29,13,684,680,1364,1153
0132-000,2011,5,29,14,736,681,1417,1364
0132-000,2011,5,29,15,766,685,1451,1417
0132-000,2011,5,29,16,1082,726,1808,1451
0132-000,2011,5,29,17,1373,704,2077,1808
0132-000,2011,5,29,18,1561,728,2289,2077
0132-000,2011,5,29,19,1524,679,2203,2289
0132-000,2011,5,29,20,1168,613,1781,2203
0132-000,2011,5,29,21,773,605,1378,1781
0132-000,2011,5,29,22,624,518,1142,1378
0132-000,2011,5,29,23,406,419,825,1142
0132-000,2011,5,29,24,255,315,570,825
0132-000,2011,5,30,1,161,192,353,570
0132-000,2011,5,30,2,113,112,225,353
0132-000,2011,5,30,3,48,81,129,225
0132-000,2011,5,30,4,66,97,163,129
0132-000,2011,5,30,5,103,101,204,163
0132-000,2011,5,30,6,247,253,500,204
0132-000,2011,5,30,7,533,714,1247,500
0132-000,2011,5,30,8,845,1686,2531,1247
0132-000,2011,5,30,9,887,1460,2347,2531
0132-000,2011,5,30,10,810,1120,1930,2347
0132-000,2011,5,30,11,871,996,1867,1930
0132-000,2011,5,30,12,900,926,1826,1867
0132-000,2011,5,30,13,843,903,1746,1826
0132-000,2011,5,30,14,923,959,1882,1746
0132-000,2011,5,30,15,1013,1044,2057,1882
0132-000,2011,5,30,16,1012,959,1971,2057
0132-000,2011,5,30,17,1142,944,2086,1971
0132-000,2011,5,30,18,1157,890,2047,2086
0132-000,2011,5,30,19,1311,958,2269,2047
0132-000,2011,5,30,20,962,760,1722,2269
0132-000,2011,5,30,21,796,623,1419,1722
0132-000,2011,5,30,22,655,536,1191,1419
0132-000,2011,5,30,23,433,388,821,1191
0132-000,2011,5,30,24,265,233,498,821
0132-000,2011,5,31,1,176,179,355,498
0132-000,2011,5,31,2,122,118,240,355
0132-000,2011,5,31,3,102,115,217,240
0132-000,2011,5,31,4,83,106,189,217
0132-000,2011,5,31,5,120,134,254,189
0132-000,2011,5,31,6,251,197,448,254
0132-000,2011,5,31,7,456,469,925,448
0132-000,2011,5,31,8,782,1418,2200,925
0132-000,2011,5,31,9,884,1415,2299,2200
0132-000,2011,5,31,10,788,1040,1828,2299
0132-000,2011,5,31,11,865,926,1791,1828
0132-000,2011,5,31,12,867,933,1800,1791
0132-000,2011,5,31,13,893,840,1733,1800
0132-000,2011,5,31,14,921,979,1900,1733
0132-000,2011,5,31,15,1003,1017,2020,1900
0132-000,2011,5,31,16,1055,926,1981,2020
0132-000,2011,5,31,17,1089,864,1953,1981
0132-000,2011,5,31,18,1206,937,2143,1953
0132-000,2011,5,31,19,1293,912,2205,2143
0132-000,2011,5,31,20,928,748,1676,2205
0132-000,2011,5,31,21,829,603,1432,1676
0132-000,2011,5,31,22,695,514,1209,1432
0132-000,2011,5,31,23,424,385,809,1209
0132-000,2011,5,31,24,256,260,516,809
0132-000,2011,6,1,1,183,206,389,516
0132-000,2011,6,1,2,129,135,264,389
0132-000,2011,6,1,3,95,126,221,264
0132-000,2011,6,1,4,105,110,215,221
0132-000,2011,6,1,5,87,104,191,215
0132-000,2011,6,1,6,180,174,354,191
0132-000,2011,6,1,7,352,374,726,354
0132-000,2011,6,1,8,745,1276,2021,726
0132-000,2011,6,1,9,790,1363,2153,2021
0132-000,2011,6,1,10,778,864,1642,2153
0132-000,2011,6,1,11,867,944,1811,1642
0132-000,2011,6,1,12,827,904,1731,1811
0132-000,2011,6,1,13,799,908,1707,1731
0132-000,2011,6,1,14,886,938,1824,1707
0132-000,2011,6,1,15,1024,998,2022,1824
0132-000,2011,6,1,16,1074,928,2002,2022
0132-000,2011,6,1,17,1011,941,1952,2002
0132-000,2011,6,1,18,1141,861,2002,1952
0132-000,2011,6,1,19,1292,956,2248,2002
0132-000,2011,6,1,20,925,721,1646,2248
0132-000,2011,6,1,21,790,555,1345,1646
0132-000,2011,6,1,22,674,512,1186,1345
0132-000,2011,6,1,23,421,410,831,1186
0132-000,2011,6,1,24,252,244,496,831
0132-000,2011,6,2,1,237,215,452,496
0132-000,2011,6,2,2,148,135,283,452
0132-000,2011,6,2,3,101,117,218,283
0132-000,2011,6,2,4,85,107,192,218
0132-000,2011,6,2,5,123,124,247,192
0132-000,2011,6,2,6,189,197,386,247
0132-000,2011,6,2,7,448,469,917,386
0132-000,2011,6,2,8,817,1419,2236,917
0132-000,2011,6,2,9,864,1411,2275,2236
0132-000,2011,6,2,10,865,1079,1944,2275
0132-000,2011,6,2,11,894,956,1850,1944
0132-000,2011,6,2,12,888,943,1831,1850
0132-000,2011,6,2,13,834,845,1679,1831
0132-000,2011,6,2,14,867,967,1834,1679
0132-000,2011,6,2,15,972,983,1955,1834
0132-000,2011,6,2,16,1035,971,2006,1955
0132-000,2011,6,2,17,1097,906,2003,2006
0132-000,2011,6,2,18,1258,870,2128,2003
0132-000,2011,6,2,19,1363,990,2353,2128
0132-000,2011,6,2,20,927,725,1652,2353
0132-000,2011,6,2,21,838,668,1506,1652
0132-000,2011,6,2,22,708,558,1266,1506
0132-000,2011,6,2,23,524,443,967,1266
0132-000,2011,6,2,24,274,297,571,967
0132-000,2011,6,3,1,224,226,450,571
0132-000,2011,6,3,2,156,152,308,450
0132-000,2011,6,3,3,129,104,233,308
0132-000,2011,6,3,4,92,104,196,233
0132-000,2011,6,3,5,127,134,261,196
0132-000,2011,6,3,6,244,212,456,261
0132-000,2011,6,3,7,439,471,910,456
0132-000,2011,6,3,8,771,1379,2150,910
0132-000,2011,6,3,9,816,1365,2181,2150
0132-000,2011,6,3,10,858,959,1817,2181
0132-000,2011,6,3,11,940,920,1860,1817
0132-000,2011,6,3,12,920,949,1869,1860
0132-000,2011,6,3,13,850,887,1737,1869
0132-000,2011,6,3,14,876,916,1792,1737
0132-000,2011,6,3,15,995,1010,2005,1792
0132-000,2011,6,3,16,1073,1009,2082,2005
0132-000,2011,6,3,17,1061,923,1984,2082
0132-000,2011,6,3,18,1460,918,2378,1984
0132-000,2011,6,3,19,1516,971,2487,2378
0132-000,2011,6,3,20,1249,861,2110,2487
0132-000,2011,6,3,21,919,786,1705,2110
0132-000,2011,6,3,22,777,584,1361,1705
0132-000,2011,6,3,23,501,492,993,1361
0132-000,2011,6,3,24,319,335,654,993
0132-000,2011,6,4,1,224,226,450,654
0132-000,2011,6,4,2,154,190,344,450
0132-000,2011,6,4,3,126,120,246,344
0132-000,2011,6,4,4,129,151,280,246
0132-000,2011,6,4,5,138,144,282,280
0132-000,2011,6,4,6,229,216,445,282
0132-000,2011,6,4,7,399,377,776,445
0132-000,2011,6,4,8,691,808,1499,776
0132-000,2011,6,4,9,769,948,1717,1499
0132-000,2011,6,4,10,788,1086,1874,1717
0132-000,2011,6,4,11,797,1468,2265,1874
0132-000,2011,6,4,12,843,1663,2506,2265
0132-000,2011,6,4,13,873,1721,2594,2506
0132-000,2011,6,4,14,980,1759,2739,2594
0132-000,2011,6,4,15,1084,1866,2950,2739
0132-000,2011,6,4,16,974,1918,2892,2950
0132-000,2011,6,4,17,1098,2028,3126,2892
0132-000,2011,6,4,18,1472,2012,3484,3126
0132-000,2011,6,4,19,1495,2017,3512,3484
0132-000,2011,6,4,20,1043,2016,3059,3512
0132-000,2011,6,4,21,734,1883,2617,3059
0132-000,2011,6,4,22,580,1761,2341,2617
0132-000,2011,6,4,23,410,1170,1580,2341
0132-000,2011,6,4,24,301,782,1083,1580
0132-000,2011,6,5,1,206,279,485,1083
0132-000,2011,6,5,2,164,168,332,485
0132-000,2011,6,5,3,133,131,264,332
0132-000,2011,6,5,4,76,82,158,264
0132-000,2011,6,5,5,106,106,212,158
0132-000,2011,6,5,6,147,152,299,212
0132-000,2011,6,5,7,244,282,526,299
0132-000,2011,6,5,8,319,393,712,526
0132-000,2011,6,5,9,442,513,955,712
0132-000,2011,6,5,10,520,679,1199,955
0132-000,2011,6,5,11,569,989,1558,1199
0132-000,2011,6,5,12,541,1063,1604,1558
0132-000,2011,6,5,13,690,1106,1796,1604
0132-000,2011,6,5,14,749,1080,1829,1796
0132-000,2011,6,5,15,730,1082,1812,1829
0132-000,2011,6,5,16,866,1022,1888,1812
0132-000,2011,6,5,17,1270,1101,2371,1888
0132-000,2011,6,5,18,1476,1072,2548,2371
0132-000,2011,6,5,19,1502,968,2470,2548
0132-000,2011,6,5,20,1494,642,2136,2470
0132-000,2011,6,5,21,1367,575,1942,2136
0132-000,2011,6,5,22,1038,516,1554,1942
0132-000,2011,6,5,23,561,454,1015,1554
0132-000,2011,6,5,24,408,317,725,1015
0132-000,2011,6,6,1,255,252,507,725
0132-000,2011,6,6,2,141,148,289,507
0132-000,2011,6,6,3,104,102,206,289
0132-000,2011,6,6,4,71,81,152,206
0132-000,2011,6,6,5,88,121,209,152
0132-000,2011,6,6,6,211,180,391,209
0132-000,2011,6,6,7,317,394,711,391
0132-000,2011,6,6,8,530,709,1239,711
0132-000,2011,6,6,9,580,713,1293,1239
0132-000,2011,6,6,10,628,699,1327,1293
0132-000,2011,6,6,11,862,769,1631,1327
0132-000,2011,6,6,12,1222,789,2011,1631
0132-000,2011,6,6,13,1300,717,2017,2011
0132-000,2011,6,6,14,1391,727,2118,2017
0132-000,2011,6,6,15,1412,690,2102,2118
0132-000,2011,6,6,16,1494,736,2230,2102
0132-000,2011,6,6,17,1553,679,2232,2230
0132-000,2011,6,6,18,1773,780,2553,2232
0132-000,2011,6,6,19,1799,669,2468,2553
0132-000,2011,6,6,20,1668,611,2279,2468
0132-000,2011,6,6,21,1425,607,2032,2279
0132-000,2011,6,6,22,891,531,1422,2032
0132-000,2011,6,6,23,447,367,814,1422
0132-000,2011,6,6,24,256,272,528,814
0132-000,2011,6,7,1,172,180,352,528
0132-000,2011,6,7,2,96,106,202,352
0132-000,2011,6,7,3,61,82,143,202
0132-000,2011,6,7,4,69,86,155,143
0132-000,2011,6,7,5,110,112,222,155
0132-000,2011,6,7,6,248,238,486,222
0132-000,2011,6,7,7,537,654,1191,486
0132-000,2011,6,7,8,863,1668,2531,1191
0132-000,2011,6,7,9,865,1496,2361,2531
0132-000,2011,6,7,10,817,1070,1887,2361
0132-000,2011,6,7,11,918,915,1833,1887
0132-000,2011,6,7,12,865,909,1774,1833
0132-000,2011,6,7,13,834,890,1724,1774
0132-000,2011,6,7,14,858,943,1801,1724
0132-000,2011,6,7,15,1075,1026,2101,1801
0132-000,2011,6,7,16,1073,910,1983,2101
0132-000,2011,6,7,17,1100,940,2040,1983
0132-000,2011,6,7,18,1255,991,2246,2040
0132-000,2011,6,7,19,1259,984,2243,2246
0132-000,2011,6,7,20,961,723,1684,2243
0132-000,2011,6,7,21,830,611,1441,1684
0132-000,2011,6,7,22,676,512,1188,1441
0132-000,2011,6,7,23,426,386,812,1188
0132-000,2011,6,7,24,279,233,512,812
0132-000,2011,6,8,1,173,191,364,512
0132-000,2011,6,8,2,141,130,271,364
0132-000,2011,6,8,3,113,110,223,271
0132-000,2011,6,8,4,86,100,186,223
0132-000,2011,6,8,5,121,109,230,186
0132-000,2011,6,8,6,227,180,407,230
0132-000,2011,6,8,7,475,501,976,407
0132-000,2011,6,8,8,795,1453,2248,976
0132-000,2011,6,8,9,913,1413,2326,2248
0132-000,2011,6,8,10,845,1069,1914,2326
0132-000,2011,6,8,11,840,1009,1849,1914
0132-000,2011,6,8,12,888,928,1816,1849
0132-000,2011,6,8,13,820,842,1662,1816
0132-000,2011,6,8,14,913,918,1831,1662
0132-000,2011,6,8,15,947,989,1936,1831
0132-000,2011,6,8,16,1109,938,2047,1936
0132-000,2011,6,8,17,1053,953,2006,2047
0132-000,2011,6,8,18,1266,909,2175,2006
0132-000,2011,6,8,19,1317,924,2241,2175
0132-000,2011,6,8,20,1002,769,1771,2241
0132-000,2011,6,8,21,796,615,1411,1771
0132-000,2011,6,8,22,728,545,1273,1411
0132-000,2011,6,8,23,470,390,860,1273
0132-000,2011,6,8,24,243,271,514,860
0132-000,2011,6,9,1,229,190,419,514
0132-000,2011,6,9,2,138,165,303,419
0132-000,2011,6,9,3,94,119,213,303
0132-000,2011,6,9,4,91,101,192,213
0132-000,2011,6,9,5,120,114,234,192
0132-000,2011,6,9,6,206,170,376,234
0132-000,2011,6,9,7,433,473,906,376
0132-000,2011,6,9,8,805,1385,2190,906
0132-000,2011,6,9,9,910,1375,2285,2190
0132-000,2011,6,9,10,833,996,1829,2285
0132-000,2011,6,9,11,823,968,1791,1829
0132-000,2011,6,9,12,871,957,1828,1791
0132-000,2011,6,9,13,795,898,1693,1828
0132-000,2011,6,9,14,940,1006,1946,1693
0132-000,2011,6,9,15,1015,1064,2079,1946
0132-000,2011,6,9,16,1083,1023,2106,2079
0132-000,2011,6,9,17,1079,888,1967,2106
0132-000,2011,6,9,18,1262,899,2161,1967
0132-000,2011,6,9,19,1311,994,2305,2161
0132-000,2011,6,9,20,1015,750,1765,2305
0132-000,2011,6,9,21,770,627,1397,1765
0132-000,2011,6,9,22,769,550,1319,1397
0132-000,2011,6,9,23,421,401,822,1319
0132-000,2011,6,9,24,306,288,594,822
0132-000,2011,6,10,1,226,234,460,594
0132-000,2011,6,10,2,129,158,287,460
0132-000,2011,6,10,3,104,111,215,287
0132-000,2011,6,10,4,90,101,191,215
0132-000,2011,6,10,5,122,145,267,191
0132-000,2011,6,10,6,257,207,464,267
0132-000,2011,6,10,7,460,449,909,464
0132-000,2011,6,10,8,836,1400,2236,909
0132-000,2011,6,10,9,871,1346,2217,2236
0132-000,2011,6,10,10,846,937,1783,2217
0132-000,2011,6,10,11,817,974,1791,1783
0132-000,2011,6,10,12,925,969,1894,1791
0132-000,2011,6,10,13,917,887,1804,1894
0132-000,2011,6,10,14,978,1011,1989,1804
0132-000,2011,6,10,15,1066,1016,2082,1989
0132-000,2011,6,10,16,1113,1011,2124,2082
0132-000,2011,6,10,17,1121,957,2078,2124
0132-000,2011,6,10,18,1337,982,2319,2078
0132-000,2011,6,10,19,1523,1026,2549,2319
0132-000,2011,6,10,20,1115,897,2012,2549
0132-000,2011,6,10,21,959,761,1720,2012
0132-000,2011,6,10,22,774,597,1371,1720
0132-000,2011,6,10,23,496,526,1022,1371
0132-000,2011,6,10,24,310,331,641,1022
0132-000,2011,6,11,1,261,275,536,641
0132-000,2011,6,11,2,178,192,370,536
0132-000,2011,6,11,3,149,142,291,370
0132-000,2011,6,11,4,97,143,240,291
0132-000,2011,6,11,5,132,161,293,240
0132-000,2011,6,11,6,213,216,429,293
0132-000,2011,6,11,7,396,401,797,429
0132-000,2011,6,11,8,695,841,1536,797
0132-000,2011,6,11,9,749,928,1677,1536
0132-000,2011,6,11,10,729,984,1713,1677
0132-000,2011,6,11,11,879,1257,2136,1713
0132-000,2011,6,11,12,920,1643,2563,2136
0132-000,2011,6,11,13,900,1483,2383,2563
0132-000,2011,6,11,14,931,1449,2380,2383
0132-000,2011,6,11,15,964,1427,2391,2380
0132-000,2011,6,11,16,1034,1332,2366,2391
0132-000,2011,6,11,17,1314,1214,2528,2366
0132-000,2011,6,11,18,1599,1221,2820,2528
0132-000,2011,6,11,19,1562,1272,2834,2820
0132-000,2011,6,11,20,1000,1064,2064,2834
0132-000,2011,6,11,21,741,769,1510,2064
0132-000,2011,6,11,22,628,567,1195,1510
0132-000,2011,6,11,23,421,456,877,1195
0132-000,2011,6,11,24,317,340,657,877
0132-000,2011,6,12,1,220,249,469,657
0132-000,2011,6,12,2,159,212,371,469
0132-000,2011,6,12,3,120,141,261,371
0132-000,2011,6,12,4,94,99,193,261
0132-000,2011,6,12,5,122,117,239,193
0132-000,2011,6,12,6,158,176,334,239
0132-000,2011,6,12,7,276,257,533,334
0132-000,2011,6,12,8,333,413,746,533
0132-000,2011,6,12,9,447,571,1018,746
0132-000,2011,6,12,10,517,595,1112,1018
0132-000,2011,6,12,11,602,664,1266,1112
0132-000,2011,6,12,12,589,663,1252,1266
0132-000,2011,6,12,13,736,683,1419,1252
0132-000,2011,6,12,14,788,685,1473,1419
0132-000,2011,6,12,15,837,694,1531,1473
0132-000,2011,6,12,16,1020,741,1761,1531
0132-000,2011,6,12,17,1275,756,2031,1761
0132-000,2011,6,12,18,1398,795,2193,2031
0132-000,2011,6,12,19,1301,692,1993,2193
0132-000,2011,6,12,20,808,525,1333,1993
0132-000,2011,6,12,21,769,577,1346,1333
0132-000,2011,6,12,22,580,493,1073,1346
0132-000,2011,6,12,23,389,425,814,1073
0132-000,2011,6,12,24,220,290,510,814
0132-000,2011,6,13,1,186,192,378,510
0132-000,2011,6,13,2,96,125,221,378
0132-000,2011,6,13,3,58,87,145,221
0132-000,2011,6,13,4,60,79,139,145
0132-000,2011,6,13,5,117,148,265,139
0132-000,2011,6,13,6,279,247,526,265
0132-000,2011,6,13,7,519,642,1161,526
0132-000,2011,6,13,8,871,1639,2510,1161
0132-000,2011,6,13,9,848,1565,2413,2510
0132-000,2011,6,13,10,852,1034,1886,2413
0132-000,2011,6,13,11,935,977,1912,1886
0132-000,2011,6,13,12,868,932,1800,1912
0132-000,2011,6,13,13,775,906,1681,1800
0132-000,2011,6,13,14,884,981,1865,1681
0132-000,2011,6,13,15,1003,1062,2065,1865
0132-000,2011,6,13,16,1132,915,2047,2065
0132-000,2011,6,13,17,1058,941,1999,2047
0132-000,2011,6,13,18,1132,929,2061,1999
0132-000,2011,6,13,19,1237,994,2231,2061
0132-000,2011,6,13,20,1045,739,1784,2231
0132-000,2011,6,13,21,878,623,1501,1784
0132-000,2011,6,13,22,683,604,1287,1501
0132-000,2011,6,13,23,420,408,828,1287
0132-000,2011,6,13,24,266,262,528,828
0132-000,2011,6,14,1,190,195,385,528
0132-000,2011,6,14,2,116,124,240,385
0132-000,2011,6,14,3,102,126,228,240
0132-000,2011,6,14,4,89,112,201,228
0132-000,2011,6,14,5,125,159,284,201
0132-000,2011,6,14,6,242,208,450,284
0132-000,2011,6,14,7,479,519,998,450
0132-000,2011,6,14,8,797,1417,2214,998
0132-000,2011,6,14,9,901,1504,2405,2214
0132-000,2011,6,14,10,873,1074,1947,2405
0132-000,2011,6,14,11,952,1025,1977,1947
0132-000,2011,6,14,12,904,932,1836,1977
0132-000,2011,6,14,13,776,840,1616,1836
0132-000,2011,6,14,14,931,926,1857,1616
0132-000,2011,6,14,15,1022,960,1982,1857
0132-000,2011,6,14,16,1057,951,2008,1982
0132-000,2011,6,14,17,1101,973,2074,2008
0132-000,2011,6,14,18,1248,917,2165,2074
0132-000,2011,6,14,19,1377,954,2331,2165
0132-000,2011,6,14,20,1000,718,1718,2331
0132-000,2011,6,14,21,846,658,1504,1718
0132-000,2011,6,14,22,738,577,1315,1504
0132-000,2011,6,14,23,447,405,852,1315
0132-000,2011,6,14,24,313,298,611,852
0132-000,2011,6,15,1,229,218,447,611
0132-000,2011,6,15,2,119,149,268,447
0132-000,2011,6,15,3,91,118,209,268
0132-000,2011,6,15,4,91,107,198,209
0132-000,2011,6,15,5,132,139,271,198
0132-000,2011,6,15,6,246,224,470,271
0132-000,2011,6,15,7,479,502,981,470
0132-000,2011,6,15,8,816,1370,2186,981
0132-000,2011,6,15,9,853,1392,2245,2186
0132-000,2011,6,15,10,858,996,1854,2245
0132-000,2011,6,15,11,923,939,1862,1854
0132-000,2011,6,15,12,888,974,1862,1862
0132-000,2011,6,15,13,778,863,1641,1862
0132-000,2011,6,15,14,919,946,1865,1641
0132-000,2011,6,15,15,1031,1010,2041,1865
0132-000,2011,6,15,16,1027,938,1965,2041
0132-000,2011,6,15,17,1130,948,2078,1965
0132-000,2011,6,15,18,1275,946,2221,2078
0132-000,2011,6,15,19,1258,1013,2271,2221
0132-000,2011,6,15,20,955,805,1760,2271
0132-000,2011,6,15,21,880,679,1559,1760
0132-000,2011,6,15,22,664,536,1200,1559
0132-000,2011,6,15,23,460,373,833,1200
0132-000,2011,6,15,24,278,275,553,833
0132-000,2011,6,16,1,230,224,454,553
0132-000,2011,6,16,2,131,137,268,454
0132-000,2011,6,16,3,111,119,230,268
0132-000,2011,6,16,4,97,122,219,230
0132-000,2011,6,16,5,112,138,250,219
0132-000,2011,6,16,6,234,197,431,250
0132-000,2011,6,16,7,490,483,973,431
0132-000,2011,6,16,8,837,1455,2292,973
0132-000,2011,6,16,9,905,1399,2304,2292
0132-000,2011,6,16,10,847,1011,1858,2304
0132-000,2011,6,16,11,892,943,1835,1858
0132-000,2011,6,16,12,923,952,1875,1835
0132-000,2011,6,16,13,835,912,1747,1875
0132-000,2011,6,16,14,892,1001,1893,1747
0132-000,2011,6,16,15,1073,971,2044,1893
0132-000,2011,6,16,16,1077,942,2019,2044
0132-000,2011,6,16,17,1141,950,2091,2019
0132-000,2011,6,16,18,1184,940,2124,2091
0132-000,2011,6,16,19,1258,905,2163,2124
0132-000,2011,6,16,20,970,767,1737,2163
0132-000,2011,6,16,21,902,624,1526,1737
0132-000,2011,6,16,22,742,596,1338,1526
0132-000,2011,6,16,23,457,413,870,1338
0132-000,2011,6,16,24,280,293,573,870
0132-000,2011,6,17,1,234,235,469,573
0132-000,2011,6,17,2,127,130,257,469
0132-000,2011,6,17,3,106,123,229,257
0132-000,2011,6,17,4,92,97,189,229
0132-000,2011,6,17,5,111,169,280,189
0132-000,2011,6,17,6,237,204,441,280
0132-000,2011,6,17,7,435,517,952,441
0132-000,2011,6,17,8,829,1358,2187,952
0132-000,2011,6,17,9,840,1288,2128,2187
0132-000,2011,6,17,10,864,1022,1886,2128
0132-000,2011,6,17,11,900,944,1844,1886
0132-000,2011,6,17,12,900,943,1843,1844
0132-000,2011,6,17,13,841,856,1697,1843
0132-000,2011,6,17,14,908,961,1869,1697
0132-000,2011,6,17,15,1004,973,1977,1869
0132-000,2011,6,17,16,1042,997,2039,1977
0132-000,2011,6,17,17,1161,955,2116,2039
0132-000,2011,6,17,18,1317,1027,2344,2116
0132-000,2011,6,17,19,1466,1008,2474,2344
0132-000,2011,6,17,20,1128,858,1986,2474
0132-000,2011,6,17,21,924,677,1601,1986
0132-000,2011,6,17,22,726,595,1321,1601
0132-000,2011,6,17,23,500,458,958,1321
0132-000,2011,6,17,24,307,325,632,958
0132-000,2011,6,18,1,229,250,479,632
0132-000,2011,6,18,2,171,204,375,479
0132-000,2011,6,18,3,132,134,266,375
0132-000,2011,6,18,4,99,129,228,266
0132-000,2011,6,18,5,125,151,276,228
0132-000,2011,6,18,6,231,233,464,276
0132-000,2011,6,18,7,410,412,822,464
0132-000,2011,6,18,8,669,871,1540,822
0132-000,2011,6,18,9,859,1039,1898,1540
0132-000,2011,6,18,10,779,947,1726,1898
0132-000,2011,6,18,11,879,990,1869,1726
0132-000,2011,6,18,12,896,1138,2034,1869
0132-000,2011,6,18,13,880,1194,2074,2034
0132-000,2011,6,18,14,945,1159,2104,2074
0132-000,2011,6,18,15,972,1364,2336,2104
0132-000,2011,6,18,16,1024,1253,2277,2336
0132-000,2011,6,18,17,1074,1264,2338,2277
0132-000,2011,6,18,18,1277,1164,2441,2338
0132-000,2011,6,18,19,1203,1112,2315,2441
0132-000,2011,6,18,20,881,833,1714,2315
0132-000,2011,6,18,21,716,670,1386,1714
0132-000,2011,6,18,22,607,592,1199,1386
0132-000,2011,6,18,23,459,468,927,1199
0132-000,2011,6,18,24,307,344,651,927
0132-000,2011,6,19,1,225,255,480,651
0132-000,2011,6,19,2,133,214,347,480
0132-000,2011,6,19,3,115,121,236,347
0132-000,2011,6,19,4,122,104,226,236
0132-000,2011,6,19,5,102,143,245,226
0132-000,2011,6,19,6,183,180,363,245
0132-000,2011,6,19,7,251,278,529,363
0132-000,2011,6,19,8,360,379,739,529
0132-000,2011,6,19,9,460,577,1037,739
0132-000,2011,6,19,10,483,582,1065,1037
0132-000,2011,6,19,11,608,688,1296,1065
0132-000,2011,6,19,12,552,659,1211,1296
0132-000,2011,6,19,13,639,664,1303,1211
0132-000,2011,6,19,14,728,658,1386,1303
0132-000,2011,6,19,15,811,657,1468,1386
0132-000,2011,6,19,16,902,680,1582,1468
0132-000,2011,6,19,17,1241,702,1943,1582
0132-000,2011,6,19,18,1398,727,2125,1943
0132-000,2011,6,19,19,1206,671,1877,2125
0132-000,2011,6,19,20,926,588,1514,1877
0132-000,2011,6,19,21,741,549,1290,1514
0132-000,2011,6,19,22,666,539,1205,1290
0132-000,2011,6,19,23,424,407,831,1205
0132-000,2011,6,19,24,234,294,528,831
0132-000,2011,6,20,1,147,197,344,528
0132-000,2011,6,20,2,105,121,226,344
0132-000,2011,6,20,3,59,79,138,226
0132-000,2011,6,20,4,60,79,139,138
0132-000,2011,6,20,5,107,130,237,139
0132-000,2011,6,20,6,244,269,513,237
0132-000,2011,6,20,7,526,669,1195,513
0132-000,2011,6,20,8,841,1631,2472,1195
0132-000,2011,6,20,9,872,1392,2264,2472
0132-000,2011,6,20,10,853,1020,1873,2264
0132-000,2011,6,20,11,881,1032,1913,1873
0132-000,2011,6,20,12,978,968,1946,1913
0132-000,2011,6,20,13,837,916,1753,1946
0132-000,2011,6,20,14,917,920,1837,1753
0132-000,2011,6,20,15,1019,1071,2090,1837
0132-000,2011,6,20,16,1044,1031,2075,2090
0132-000,2011,6,20,17,1027,892,1919,2075
0132-000,2011,6,20,18,1185,919,2104,1919
0132-000,2011,6,20,19,1248,949,2197,2104
0132-000,2011,6,20,20,964,812,1776,2197
0132-000,2011,6,20,21,842,682,1524,1776
0132-000,2011,6,20,22,666,566,1232,1524
0132-000,2011,6,20,23,473,420,893,1232
0132-000,2011,6,20,24,253,265,518,893
0132-000,2011,6,21,1,194,215,409,518
0132-000,2011,6,21,2,122,120,242,409
0132-000,2011,6,21,3,90,114,204,242
0132-000,2011,6,21,4,102,131,233,204
0132-000,2011,6,21,5,116,128,244,233
0132-000,2011,6,21,6,245,194,439,244
0132-000,2011,6,21,7,470,544,1014,439
0132-000,2011,6,21,8,824,1433,2257,1014
0132-000,2011,6,21,9,874,1360,2234,2257
0132-000,2011,6,21,10,821,987,1808,2234
0132-000,2011,6,21,11,870,960,1830,1808
0132-000,2011,6,21,12,941,932,1873,1830
0132-000,2011,6,21,13,798,851,1649,1873
0132-000,2011,6,21,14,958,898,1856,1649
0132-000,2011,6,21,15,1001,1024,2025,1856
0132-000,2011,6,21,16,988,908,1896,2025
0132-000,2011,6,21,17,1121,915,2036,1896
0132-000,2011,6,21,18,1158,874,2032,2036
0132-000,2011,6,21,19,1241,965,2206,2032
0132-000,2011,6,21,20,976,788,1764,2206
0132-000,2011,6,21,21,885,739,1624,1764
0132-000,2011,6,21,22,742,585,1327,1624
0132-000,2011,6,21,23,455,408,863,1327
0132-000,2011,6,21,24,260,260,520,863
0132-000,2011,6,22,1,226,231,457,520
0132-000,2011,6,22,2,130,142,272,457
0132-000,2011,6,22,3,98,114,212,272
0132-000,2011,6,22,4,87,113,200,212
0132-000,2011,6,22,5,125,123,248,200
0132-000,2011,6,22,6,214,187,401,248
0132-000,2011,6,22,7,450,487,937,401
0132-000,2011,6,22,8,794,1357,2151,937
0132-000,2011,6,22,9,843,1323,2166,2151
0132-000,2011,6,22,10,877,1017,1894,2166
0132-000,2011,6,22,11,868,943,1811,1894
0132-000,2011,6,22,12,870,891,1761,1811
0132-000,2011,6,22,13,861,881,1742,1761
0132-000,2011,6,22,14,914,923,1837,1742
0132-000,2011,6,22,15,997,954,1951,1837
0132-000,2011,6,22,16,1054,926,1980,1951
0132-000,2011,6,22,17,1036,873,1909,1980
0132-000,2011,6,22,18,1187,935,2122,1909
0132-000,2011,6,22,19,1296,952,2248,2122
0132-000,2011,6,22,20,967,776,1743,2248
0132-000,2011,6,22,21,757,654,1411,1743
0132-000,2011,6,22,22,618,483,1101,1411
0132-000,2011,6,22,23,355,399,754,1101
0132-000,2011,6,22,24,249,246,495,754
0132-000,2011,6,23,1,178,184,362,495
0132-000,2011,6,23,2,120,128,248,362
0132-000,2011,6,23,3,93,87,180,248
0132-000,2011,6,23,4,84,104,188,180
0132-000,2011,6,23,5,126,128,254,188
0132-000,2011,6,23,6,216,191,407,254
0132-000,2011,6,23,7,396,365,761,407
0132-000,2011,6,23,8,775,1288,2063,761
0132-000,2011,6,23,9,786,1276,2062,2063
0132-000,2011,6,23,10,799,908,1707,2062
0132-000,2011,6,23,11,805,852,1657,1707
0132-000,2011,6,23,12,806,916,1722,1657
0132-000,2011,6,23,13,754,804,1558,1722
0132-000,2011,6,23,14,847,899,1746,1558
0132-000,2011,6,23,15,957,928,1885,1746
0132-000,2011,6,23,16,938,885,1823,1885
0132-000,2011,6,23,17,987,860,1847,1823
0132-000,2011,6,23,18,1110,838,1948,1847
0132-000,2011,6,23,19,1140,863,2003,1948
0132-000,2011,6,23,20,861,640,1501,2003
0132-000,2011,6,23,21,726,576,1302,1501
0132-000,2011,6,23,22,617,536,1153,1302
0132-000,2011,6,23,23,383,325,708,1153
0132-000,2011,6,23,24,255,245,500,708
0132-000,2011,6,24,1,199,206,405,500
0132-000,2011,6,24,2,114,120,234,405
0132-000,2011,6,24,3,80,94,174,234
0132-000,2011,6,24,4,101,88,189,174
0132-000,2011,6,24,5,82,125,207,189
0132-000,2011,6,24,6,164,163,327,207
0132-000,2011,6,24,7,382,353,735,327
0132-000,2011,6,24,8,727,1284,2011,735
0132-000,2011,6,24,9,858,1267,2125,2011
0132-000,2011,6,24,10,764,884,1648,2125
0132-000,2011,6,24,11,834,889,1723,1648
0132-000,2011,6,24,12,889,900,1789,1723
0132-000,2011,6,24,13,756,820,1576,1789
0132-000,2011,6,24,14,844,880,1724,1576
0132-000,2011,6,24,15,978,971,1949,1724
0132-000,2011,6,24,16,960,833,1793,1949
0132-000,2011,6,24,17,1083,865,1948,1793
0132-000,2011,6,24,18,1308,915,2223,1948
0132-000,2011,6,24,19,1573,1097,2670,2223
0132-000,2011,6,24,20,1254,877,2131,2670
0132-000,2011,6,24,21,888,689,1577,2131
0132-000,2011,6,24,22,686,555,1241,1577
0132-000,2011,6,24,23,407,421,828,1241
0132-000,2011,6,24,24,302,306,608,828
0132-000,2011,6,25,1,224,266,490,608
0132-000,2011,6,25,2,160,191,351,490
0132-000,2011,6,25,3,136,114,250,351
0132-000,2011,6,25,4,118,108,226,250
0132-000,2011,6,25,5,101,162,263,226
0132-000,2011,6,25,6,181,159,340,263
0132-000,2011,6,25,7,298,300,598,340
0132-000,2011,6,25,8,545,706,1251,598
0132-000,2011,6,25,9,654,840,1494,1251
0132-000,2011,6,25,10,769,895,1664,1494
0132-000,2011,6,25,11,894,915,1809,1664
0132-000,2011,6,25,12,890,958,1848,1809
0132-000,2011,6,25,13,889,956,1845,1848
0132-000,2011,6,25,14,876,916,1792,1845
0132-000,2011,6,25,15,909,946,1855,1792
0132-000,2011,6,25,16,1087,951,2038,1855
0132-000,2011,6,25,17,1164,1178,2342,2038
0132-000,2011,6,25,18,1425,1248,2673,2342
0132-000,2011,6,25,19,1299,1059,2358,2673
0132-000,2011,6,25,20,770,766,1536,2358
0132-000,2011,6,25,21,625,562,1187,1536
0132-000,2011,6,25,22,551,473,1024,1187
0132-000,2011,6,25,23,331,393,724,1024
0132-000,2011,6,25,24,256,273,529,724
0132-000,2011,6,26,1,192,224,416,529
0132-000,2011,6,26,2,148,154,302,416
0132-000,2011,6,26,3,116,132,248,302
0132-000,2011,6,26,4,77,99,176,248
0132-000,2011,6,26,5,87,84,171,176
0132-000,2011,6,26,6,97,115,212,171
0132-000,2011,6,26,7,163,178,341,212
0132-000,2011,6,26,8,270,295,565,341
0132-000,2011,6,26,9,366,430,796,565
0132-000,2011,6,26,10,430,413,843,796
0132-000,2011,6,26,11,501,571,1072,843
0132-000,2011,6,26,12,570,584,1154,1072
0132-000,2011,6,26,13,613,610,1223,1154
0132-000,2011,6,26,14,647,611,1258,1223
0132-000,2011,6,26,15,719,659,1378,1258
0132-000,2011,6,26,16,703,717,1420,1378
0132-000,2011,6,26,17,920,655,1575,1420
0132-000,2011,6,26,18,807,665,1472,1575
0132-000,2011,6,26,19,811,581,1392,1472
0132-000,2011,6,26,20,659,508,1167,1392
0132-000,2011,6,26,21,561,472,1033,1167
0132-000,2011,6,26,22,429,439,868,1033
0132-000,2011,6,26,23,304,336,640,868
0132-000,2011,6,26,24,206,239,445,640
0132-000,2011,6,27,1,136,179,315,445
0132-000,2011,6,27,2,95,112,207,315
0132-000,2011,6,27,3,74,76,150,207
0132-000,2011,6,27,4,52,82,134,150
0132-000,2011,6,27,5,91,82,173,134
0132-000,2011,6,27,6,213,213,426,173
0132-000,2011,6,27,7,455,501,956,426
0132-000,2011,6,27,8,777,1494,2271,956
0132-000,2011,6,27,9,800,1378,2178,2271
0132-000,2011,6,27,10,763,925,1688,2178
0132-000,2011,6,27,11,839,944,1783,1688
0132-000,2011,6,27,12,887,926,1813,1783
0132-000,2011,6,27,13,776,836,1612,1813
0132-000,2011,6,27,14,869,995,1864,1612
0132-000,2011,6,27,15,947,1008,1955,1864
0132-000,2011,6,27,16,971,902,1873,1955
0132-000,2011,6,27,17,1029,924,1953,1873
0132-000,2011,6,27,18,1076,826,1902,1953
0132-000,2011,6,27,19,1169,942,2111,1902
0132-000,2011,6,27,20,928,694,1622,2111
0132-000,2011,6,27,21,745,587,1332,1622
0132-000,2011,6,27,22,633,515,1148,1332
0132-000,2011,6,27,23,440,364,804,1148
0132-000,2011,6,27,24,271,258,529,804
0132-000,2011,6,28,1,191,185,376,529
0132-000,2011,6,28,2,135,136,271,376
0132-000,2011,6,28,3,61,108,169,271
0132-000,2011,6,28,4,98,124,222,169
0132-000,2011,6,28,5,127,123,250,222
0132-000,2011,6,28,6,213,225,438,250
0132-000,2011,6,28,7,458,481,939,438
0132-000,2011,6,28,8,821,1414,2235,939
0132-000,2011,6,28,9,876,1269,2145,2235
0132-000,2011,6,28,10,851,927,1778,2145
0132-000,2011,6,28,11,923,957,1880,1778
0132-000,2011,6,28,12,895,897,1792,1880
0132-000,2011,6,28,13,805,861,1666,1792
0132-000,2011,6,28,14,874,906,1780,1666
0132-000,2011,6,28,15,940,1010,1950,1780
0132-000,2011,6,28,16,1055,901,1956,1950
0132-000,2011,6,28,17,1005,1025,2030,1956
0132-000,2011,6,28,18,1163,940,2103,2030
0132-000,2011,6,28,19,1262,967,2229,2103
0132-000,2011,6,28,20,1025,747,1772,2229
0132-000,2011,6,28,21,844,635,1479,1772
0132-000,2011,6,28,22,668,568,1236,1479
0132-000,2011,6,28,23,447,382,829,1236
0132-000,2011,6,28,24,287,291,578,829
0132-000,2011,6,29,1,204,181,385,578
0132-000,2011,6,29,2,115,131,246,385
0132-000,2011,6,29,3,98,106,204,246
0132-000,2011,6,29,4,74,100,174,204
0132-000,2011,6,29,5,112,113,225,174
0132-000,2011,6,29,6,186,171,357,225
0132-000,2011,6,29,7,418,405,823,357
0132-000,2011,6,29,8,756,1305,2061,823
0132-000,2011,6,29,9,816,1268,2084,2061
0132-000,2011,6,29,10,797,916,1713,2084
0132-000,2011,6,29,11,868,836,1704,1713
0132-000,2011,6,29,12,822,829,1651,1704
0132-000,2011,6,29,13,831,750,1581,1651
0132-000,2011,6,29,14,781,913,1694,1581
0132-000,2011,6,29,15,919,940,1859,1694
0132-000,2011,6,29,16,918,865,1783,1859
0132-000,2011,6,29,17,925,816,1741,1783
0132-000,2011,6,29,18,1003,828,1831,1741
0132-000,2011,6,29,19,1192,882,2074,1831
0132-000,2011,6,29,20,809,711,1520,2074
0132-000,2011,6,29,21,700,544,1244,1520
0132-000,2011,6,29,22,608,445,1053,1244
0132-000,2011,6,29,23,417,386,803,1053
0132-000,2011,6,29,24,259,266,525,803
0132-000,2011,6,30,1,154,188,342,525
0132-000,2011,6,30,2,103,130,233,342
0132-000,2011,6,30,3,99,114,213,233
0132-000,2011,6,30,4,72,103,175,213
0132-000,2011,6,30,5,101,124,225,175
0132-000,2011,6,30,6,171,153,324,225
0132-000,2011,6,30,7,380,360,740,324
0132-000,2011,6,30,8,721,1254,1975,740
0132-000,2011,6,30,9,785,1240,2025,1975
0132-000,2011,6,30,10,779,924,1703,2025
0132-000,2011,6,30,11,821,920,1741,1703
0132-000,2011,6,30,12,843,921,1764,1741
0132-000,2011,6,30,13,804,862,1666,1764
0132-000,2011,6,30,14,900,878,1778,1666
0132-000,2011,6,30,15,965,971,1936,1778
0132-000,2011,6,30,16,1008,890,1898,1936
0132-000,2011,6,30,17,990,898,1888,1898
0132-000,2011,6,30,18,1082,817,1899,1888
0132-000,2011,6,30,19,1145,879,2024,1899
0132-000,2011,6,30,20,995,732,1727,2024
0132-000,2011,6,30,21,762,582,1344,1727
0132-000,2011,6,30,22,679,535,1214,1344
0132-000,2011,6,30,23,483,401,884,1214
0132-000,2011,6,30,24,301,288,589,884
0132-000,2011,7,1,1,206,222,428,589
0132-000,2011,7,1,2,134,151,285,428
0132-000,2011,7,1,3,116,124,240,285
0132-000,2011,7,1,4,105,129,234,240
0132-000,2011,7,1,5,131,159,290,234
0132-000,2011,7,1,6,217,241,458,290
0132-000,2011,7,1,7,456,473,929,458
0132-000,2011,7,1,8,798,1366,2164,929
0132-000,2011,7,1,9,849,1222,2071,2164
0132-000,2011,7,1,10,841,952,1793,2071
0132-000,2011,7,1,11,853,973,1826,1793
0132-000,2011,7,1,12,896,945,1841,1826
0132-000,2011,7,1,13,784,852,1636,1841
0132-000,2011,7,1,14,927,937,1864,1636
0132-000,2011,7,1,15,1056,969,2025,1864
0132-000,2011,7,1,16,1019,957,1976,2025
0132-000,2011,7,1,17,1088,868,1956,1976
0132-000,2011,7,1,18,1290,949,2239,1956
0132-000,2011,7,1,19,1444,979,2423,2239
0132-000,2011,7,1,20,1063,844,1907,2423
0132-000,2011,7,1,21,959,689,1648,1907
0132-000,2011,7,1,22,701,564,1265,1648
0132-000,2011,7,1,23,513,447,960,1265
0132-000,2011,7,1,24,322,348,670,960
0132-000,2011,7,2,1,254,293,547,670
0132-000,2011,7,2,2,196,179,375,547
0132-000,2011,7,2,3,130,156,286,375
0132-000,2011,7,2,4,108,138,246,286
0132-000,2011,7,2,5,129,149,278,246
0132-000,2011,7,2,6,217,209,426,278
0132-000,2011,7,2,7,423,374,797,426
0132-000,2011,7,2,8,640,818,1458,797
0132-000,2011,7,2,9,763,939,1702,1458
0132-000,2011,7,2,10,787,870,1657,1702
0132-000,2011,7,2,11,884,934,1818,1657
0132-000,2011,7,2,12,868,941,1809,1818
0132-000,2011,7,2,13,867,996,1863,1809
0132-000,2011,7,2,14,940,974,1914,1863
0132-000,2011,7,2,15,971,1005,1976,1914
0132-000,2011,7,2,16,1022,1109,2131,1976
0132-000,2011,7,2,17,1036,1263,2299,2131
0132-000,2011,7,2,18,1253,1306,2559,2299
0132-000,2011,7,2,19,1220,1238,2458,2559
0132-000,2011,7,2,20,856,862,1718,2458
0132-000,2011,7,2,21,752,623,1375,1718
0132-000,2011,7,2,22,592,555,1147,1375
0132-000,2011,7,2,23,390,434,824,1147
0132-000,2011,7,2,24,326,326,652,824
0132-000,2011,7,3,1,206,244,450,652
0132-000,2011,7,3,2,168,186,354,450
0132-000,2011,7,3,3,142,130,272,354
0132-000,2011,7,3,4,87,114,201,272
0132-000,2011,7,3,5,85,90,175,201
0132-000,2011,7,3,6,119,125,244,175
0132-000,2011,7,3,7,168,145,313,244
0132-000,2011,7,3,8,237,313,550,313
0132-000,2011,7,3,9,350,422,772,550
0132-000,2011,7,3,10,398,525,923,772
0132-000,2011,7,3,11,509,567,1076,923
0132-000,2011,7,3,12,543,498,1041,1076
0132-000,2011,7,3,13,579,511,1090,1041
0132-000,2011,7,3,14,729,589,1318,1090
0132-000,2011,7,3,15,786,623,1409,1318
0132-000,2011,7,3,16,980,601,1581,1409
0132-000,2011,7,3,17,1202,629,1831,1581
0132-000,2011,7,3,18,1364,608,1972,1831
0132-000,2011,7,3,19,1324,581,1905,1972
0132-000,2011,7,3,20,777,484,1261,1905
0132-000,2011,7,3,21,552,476,1028,1261
0132-000,2011,7,3,22,395,411,806,1028
0132-000,2011,7,3,23,296,331,627,806
0132-000,2011,7,3,24,194,259,453,627
0132-000,2011,7,4,1,140,184,324,453
0132-000,2011,7,4,2,94,129,223,324
0132-000,2011,7,4,3,66,79,145,223
0132-000,2011,7,4,4,57,94,151,145
0132-000,2011,7,4,5,107,114,221,151
0132-000,2011,7,4,6,217,213,430,221
0132-000,2011,7,4,7,477,557,1034,430
0132-000,2011,7,4,8,832,1560,2392,1034
0132-000,2011,7,4,9,819,1358,2177,2392
0132-000,2011,7,4,10,718,939,1657,2177
0132-000,2011,7,4,11,761,910,1671,1657
0132-000,2011,7,4,12,856,911,1767,1671
0132-000,2011,7,4,13,778,830,1608,1767
0132-000,2011,7,4,14,858,889,1747,1608
0132-000,2011,7,4,15,979,936,1915,1747
0132-000,2011,7,4,16,987,976,1963,1915
0132-000,2011,7,4,17,986,907,1893,1963
0132-000,2011,7,4,18,1132,896,2028,1893
0132-000,2011,7,4,19,1171,897,2068,2028
0132-000,2011,7,4,20,920,743,1663,2068
0132-000,2011,7,4,21,842,662,1504,1663
0132-000,2011,7,4,22,631,559,1190,1504
0132-000,2011,7,4,23,458,387,845,1190
0132-000,2011,7,4,24,279,276,555,845
0132-000,2011,7,5,1,184,189,373,555
0132-000,2011,7,5,2,118,122,240,373
0132-000,2011,7,5,3,96,116,212,240
0132-000,2011,7,5,4,88,114,202,212
0132-000,2011,7,5,5,122,155,277,202
0132-000,2011,7,5,6,242,225,467,277
0132-000,2011,7,5,7,460,516,976,467
0132-000,2011,7,5,8,775,1408,2183,976
0132-000,2011,7,5,9,869,1275,2144,2183
0132-000,2011,7,5,10,793,897,1690,2144
0132-000,2011,7,5,11,820,885,1705,1690
0132-000,2011,7,5,12,918,871,1789,1705
0132-000,2011,7,5,13,793,849,1642,1789
0132-000,2011,7,5,14,863,897,1760,1642
0132-000,2011,7,5,15,971,970,1941,1760
0132-000,2011,7,5,16,1012,979,1991,1941
0132-000,2011,7,5,17,1036,881,1917,1991
0132-000,2011,7,5,18,1119,926,2045,1917
0132-000,2011,7,5,19,1222,917,2139,2045
0132-000,2011,7,5,20,960,773,1733,2139
0132-000,2011,7,5,21,845,652,1497,1733
0132-000,2011,7,5,22,681,574,1255,1497
0132-000,2011,7,5,23,450,379,829,1255
0132-000,2011,7,5,24,305,316,621,829
0132-000,2011,7,6,1,224,186,410,621
0132-000,2011,7,6,2,141,148,289,410
0132-000,2011,7,6,3,87,113,200,289
0132-000,2011,7,6,4,77,106,183,200
0132-000,2011,7,6,5,115,137,252,183
0132-000,2011,7,6,6,240,220,460,252
0132-000,2011,7,6,7,446,494,940,460
0132-000,2011,7,6,8,822,1382,2204,940
0132-000,2011,7,6,9,860,1251,2111,2204
0132-000,2011,7,6,10,840,897,1737,2111
0132-000,2011,7,6,11,851,910,1761,1737
0132-000,2011,7,6,12,881,944,1825,1761
0132-000,2011,7,6,13,791,857,1648,1825
0132-000,2011,7,6,14,992,959,1951,1648
0132-000,2011,7,6,15,937,958,1895,1951
0132-000,2011,7,6,16,1075,972,2047,1895
0132-000,2011,7,6,17,1153,1054,2207,2047
0132-000,2011,7,6,18,1211,1001,2212,2207
0132-000,2011,7,6,19,1307,1014,2321,2212
0132-000,2011,7,6,20,1086,821,1907,2321
0132-000,2011,7,6,21,853,612,1465,1907
0132-000,2011,7,6,22,692,521,1213,1465
0132-000,2011,7,6,23,448,396,844,1213
0132-000,2011,7,6,24,282,297,579,844
0132-000,2011,7,7,1,222,199,421,579
0132-000,2011,7,7,2,136,163,299,421
0132-000,2011,7,7,3,93,118,211,299
0132-000,2011,7,7,4,81,108,189,211
0132-000,2011,7,7,5,105,119,224,189
0132-000,2011,7,7,6,157,135,292,224
0132-000,2011,7,7,7,374,399,773,292
0132-000,2011,7,7,8,761,1312,2073,773
0132-000,2011,7,7,9,808,1313,2121,2073
0132-000,2011,7,7,10,806,922,1728,2121
0132-000,2011,7,7,11,875,891,1766,1728
0132-000,2011,7,7,12,894,934,1828,1766
0132-000,2011,7,7,13,779,798,1577,1828
0132-000,2011,7,7,14,828,876,1704,1577
0132-000,2011,7,7,15,985,916,1901,1704
0132-000,2011,7,7,16,996,881,1877,1901
0132-000,2011,7,7,17,1006,856,1862,1877
0132-000,2011,7,7,18,1094,854,1948,1862
0132-000,2011,7,7,19,1159,801,1960,1948
0132-000,2011,7,7,20,818,723,1541,1960
0132-000,2011,7,7,21,678,564,1242,1541
0132-000,2011,7,7,22,605,518,1123,1242
0132-000,2011,7,7,23,385,327,712,1123
0132-000,2011,7,7,24,265,263,528,712
0132-000,2011,7,8,1,187,188,375,528
0132-000,2011,7,8,2,110,148,258,375
0132-000,2011,7,8,3,96,102,198,258
0132-000,2011,7,8,4,79,100,179,198
0132-000,2011,7,8,5,98,108,206,179
0132-000,2011,7,8,6,192,177,369,206
0132-000,2011,7,8,7,399,397,796,369
0132-000,2011,7,8,8,741,1313,2054,796
0132-000,2011,7,8,9,898,1242,2140,2054
0132-000,2011,7,8,10,760,920,1680,2140
0132-000,2011,7,8,11,863,881,1744,1680
0132-000,2011,7,8,12,849,946,1795,1744
0132-000,2011,7,8,13,818,834,1652,1795
0132-000,2011,7,8,14,892,819,1711,1652
0132-000,2011,7,8,15,1017,953,1970,1711
0132-000,2011,7,8,16,1035,966,2001,1970
0132-000,2011,7,8,17,1058,902,1960,2001
0132-000,2011,7,8,18,1212,915,2127,1960
0132-000,2011,7,8,19,1446,966,2412,2127
0132-000,2011,7,8,20,1137,861,1998,2412
0132-000,2011,7,8,21,845,712,1557,1998
0132-000,2011,7,8,22,717,564,1281,1557
0132-000,2011,7,8,23,424,444,868,1281
0132-000,2011,7,8,24,338,349,687,868
0132-000,2011,7,9,1,266,237,503,687
0132-000,2011,7,9,2,180,173,353,503
0132-000,2011,7,9,3,117,142,259,353
0132-000,2011,7,9,4,110,128,238,259
0132-000,2011,7,9,5,101,135,236,238
0132-000,2011,7,9,6,163,163,326,236
0132-000,2011,7,9,7,268,276,544,326
0132-000,2011,7,9,8,567,658,1225,544
0132-000,2011,7,9,9,682,785,1467,1225
0132-000,2011,7,9,10,761,806,1567,1467
0132-000,2011,7,9,11,842,954,1796,1567
0132-000,2011,7,9,12,848,1051,1899,1796
0132-000,2011,7,9,13,798,1139,1937,1899
0132-000,2011,7,9,14,898,1095,1993,1937
0132-000,2011,7,9,15,924,1153,2077,1993
0132-000,2011,7,9,16,922,1062,1984,2077
0132-000,2011,7,9,17,1025,1116,2141,1984
0132-000,2011,7,9,18,1197,1070,2267,2141
0132-000,2011,7,9,19,1148,1131,2279,2267
0132-000,2011,7,9,20,792,749,1541,2279
0132-000,2011,7,9,21,617,633,1250,1541
0132-000,2011,7,9,22,647,500,1147,1250
0132-000,2011,7,9,23,398,429,827,1147
0132-000,2011,7,9,24,279,286,565,827
0132-000,2011,7,10,1,209,279,488,565
0132-000,2011,7,10,2,166,178,344,488
0132-000,2011,7,10,3,121,125,246,344
0132-000,2011,7,10,4,91,105,196,246
0132-000,2011,7,10,5,75,87,162,196
0132-000,2011,7,10,6,117,131,248,162
0132-000,2011,7,10,7,203,201,404,248
0132-000,2011,7,10,8,249,306,555,404
0132-000,2011,7,10,9,351,442,793,555
0132-000,2011,7,10,10,447,467,914,793
0132-000,2011,7,10,11,621,606,1227,914
0132-000,2011,7,10,12,588,601,1189,1227
0132-000,2011,7,10,13,641,636,1277,1189
0132-000,2011,7,10,14,751,629,1380,1277
0132-000,2011,7,10,15,817,678,1495,1380
0132-000,2011,7,10,16,1064,717,1781,1495
0132-000,2011,7,10,17,1152,726,1878,1781
0132-000,2011,7,10,18,1276,725,2001,1878
0132-000,2011,7,10,19,1216,578,1794,2001
0132-000,2011,7,10,20,1125,497,1622,1794
0132-000,2011,7,10,21,798,455,1253,1622
0132-000,2011,7,10,22,516,478,994,1253
0132-000,2011,7,10,23,285,333,618,994
0132-000,2011,7,10,24,217,262,479,618
0132-000,2011,7,11,1,149,181,330,479
0132-000,2011,7,11,2,85,133,218,330
0132-000,2011,7,11,3,71,87,158,218
0132-000,2011,7,11,4,64,84,148,158
0132-000,2011,7,11,5,101,103,204,148
0132-000,2011,7,11,6,176,187,363,204
0132-000,2011,7,11,7,440,538,978,363
0132-000,2011,7,11,8,800,1511,2311,978
0132-000,2011,7,11,9,773,1316,2089,2311
0132-000,2011,7,11,10,742,864,1606,2089
0132-000,2011,7,11,11,768,839,1607,1606
0132-000,2011,7,11,12,781,815,1596,1607
0132-000,2011,7,11,13,777,798,1575,1596
0132-000,2011,7,11,14,757,911,1668,1575
0132-000,2011,7,11,15,911,847,1758,1668
0132-000,2011,7,11,16,919,831,1750,1758
0132-000,2011,7,11,17,814,813,1627,1750
0132-000,2011,7,11,18,983,886,1869,1627
0132-000,2011,7,11,19,1121,829,1950,1869
0132-000,2011,7,11,20,863,684,1547,1950
0132-000,2011,7,11,21,689,511,1200,1547
0132-000,2011,7,11,22,577,462,1039,1200
0132-000,2011,7,11,23,405,349,754,1039
0132-000,2011,7,11,24,197,219,416,754
0132-000,2011,7,12,1,180,183,363,416
0132-000,2011,7,12,2,107,126,233,363
0132-000,2011,7,12,3,64,102,166,233
0132-000,2011,7,12,4,97,117,214,166
0132-000,2011,7,12,5,95,103,198,214
0132-000,2011,7,12,6,168,149,317,198
0132-000,2011,7,12,7,348,417,765,317
0132-000,2011,7,12,8,758,1284,2042,765
0132-000,2011,7,12,9,799,1200,1999,2042
0132-000,2011,7,12,10,716,847,1563,1999
0132-000,2011,7,12,11,838,747,1585,1563
0132-000,2011,7,12,12,745,817,1562,1585
0132-000,2011,7,12,13,752,814,1566,1562
0132-000,2011,7,12,14,767,918,1685,1566
0132-000,2011,7,12,15,878,946,1824,1685
0132-000,2011,7,12,16,957,855,1812,1824
0132-000,2011,7,12,17,901,860,1761,1812
0132-000,2011,7,12,18,1017,896,1913,1761
0132-000,2011,7,12,19,1089,857,1946,1913
0132-000,2011,7,12,20,975,719,1694,1946
0132-000,2011,7,12,21,729,583,1312,1694
0132-000,2011,7,12,22,637,495,1132,1312
0132-000,2011,7,12,23,390,381,771,1132
0132-000,2011,7,12,24,259,233,492,771
0132-000,2011,7,13,1,174,179,353,492
0132-000,2011,7,13,2,160,142,302,353
0132-000,2011,7,13,3,71,118,189,302
0132-000,2011,7,13,4,82,113,195,189
0132-000,2011,7,13,5,93,108,201,195
0132-000,2011,7,13,6,165,154,319,201
0132-000,2011,7,13,7,387,366,753,319
0132-000,2011,7,13,8,740,1279,2019,753
0132-000,2011,7,13,9,814,1242,2056,2019
0132-000,2011,7,13,10,820,851,1671,2056
0132-000,2011,7,13,11,848,914,1762,1671
0132-000,2011,7,13,12,851,837,1688,1762
0132-000,2011,7,13,13,777,823,1600,1688
0132-000,2011,7,13,14,791,904,1695,1600
0132-000,2011,7,13,15,937,954,1891,1695
0132-000,2011,7,13,16,1006,940,1946,1891
0132-000,2011,7,13,17,1017,924,1941,1946
0132-000,2011,7,13,18,1173,863,2036,1941
0132-000,2011,7,13,19,1231,886,2117,2036
0132-000,2011,7,13,20,878,678,1556,2117
0132-000,2011,7,13,21,670,559,1229,1556
0132-000,2011,7,13,22,595,465,1060,1229
0132-000,2011,7,13,23,378,404,782,1060
0132-000,2011,7,13,24,265,238,503,782
0132-000,2011,7,14,1,175,184,359,503
0132-000,2011,7,14,2,121,138,259,359
0132-000,2011,7,14,3,90,98,188,259
0132-000,2011,7,14,4,81,95,176,188
0132-000,2011,7,14,5,99,120,219,176
0132-000,2011,7,14,6,182,177,359,219
0132-000,2011,7,14,7,368,386,754,359
0132-000,2011,7,14,8,739,1326,2065,754
0132-000,2011,7,14,9,809,1234,2043,2065
0132-000,2011,7,14,10,854,837,1691,2043
0132-000,2011,7,14,11,784,919,1703,1691
0132-000,2011,7,14,12,853,832,1685,1703
0132-000,2011,7,14,13,727,837,1564,1685
0132-000,2011,7,14,14,832,884,1716,1564
0132-000,2011,7,14,15,983,968,1951,1716
0132-000,2011,7,14,16,916,824,1740,1951
0132-000,2011,7,14,17,1017,885,1902,1740
0132-000,2011,7,14,18,1208,869,2077,1902
0132-000,2011,7,14,19,1240,888,2128,2077
0132-000,2011,7,14,20,875,712,1587,2128
0132-000,2011,7,14,21,783,587,1370,1587
0132-000,2011,7,14,22,647,527,1174,1370
0132-000,2011,7,14,23,367,373,740,1174
0132-000,2011,7,14,24,260,232,492,740
0132-000,2011,7,15,1,205,205,410,492
0132-000,2011,7,15,2,132,138,270,410
0132-000,2011,7,15,3,98,106,204,270
0132-000,2011,7,15,4,73,106,179,204
0132-000,2011,7,15,5,92,122,214,179
0132-000,2011,7,15,6,191,165,356,214
0132-000,2011,7,15,7,394,384,778,356
0132-000,2011,7,15,8,727,1356,2083,778
0132-000,2011,7,15,9,851,1243,2094,2083
0132-000,2011,7,15,10,812,922,1734,2094
0132-000,2011,7,15,11,847,891,1738,1734
0132-000,2011,7,15,12,875,1067,1942,1738
0132-000,2011,7,15,13,799,1036,1835,1942
0132-000,2011,7,15,14,942,877,1819,1835
0132-000,2011,7,15,15,1034,1007,2041,1819
0132-000,2011,7,15,16,1038,949,1987,2041
0132-000,2011,7,15,17,1061,859,1920,1987
0132-000,2011,7,15,18,1276,963,2239,1920
0132-000,2011,7,15,19,1386,1078,2464,2239
0132-000,2011,7,15,20,1091,851,1942,2464
0132-000,2011,7,15,21,890,663,1553,1942
0132-000,2011,7,15,22,766,609,1375,1553
0132-000,2011,7,15,23,485,491,976,1375
0132-000,2011,7,15,24,349,345,694,976
0132-000,2011,7,16,1,210,259,469,694
0132-000,2011,7,16,2,181,187,368,469
0132-000,2011,7,16,3,151,173,324,368
0132-000,2011,7,16,4,118,127,245,324
0132-000,2011,7,16,5,113,157,270,245
0132-000,2011,7,16,6,201,202,403,270
0132-000,2011,7,16,7,315,349,664,403
0132-000,2011,7,16,8,622,837,1459,664
0132-000,2011,7,16,9,696,992,1688,1459
0132-000,2011,7,16,10,766,760,1526,1688
0132-000,2011,7,16,11,759,887,1646,1526
0132-000,2011,7,16,12,885,1154,2039,1646
0132-000,2011,7,16,13,871,1264,2135,2039
0132-000,2011,7,16,14,918,1319,2237,2135
0132-000,2011,7,16,15,892,1367,2259,2237
0132-000,2011,7,16,16,1070,1313,2383,2259
0132-000,2011,7,16,17,1283,1381,2664,2383
0132-000,2011,7,16,18,1356,1398,2754,2664
0132-000,2011,7,16,19,1155,1251,2406,2754
0132-000,2011,7,16,20,851,779,1630,2406
0132-000,2011,7,16,21,796,619,1415,1630
0132-000,2011,7,16,22,677,564,1241,1415
0132-000,2011,7,16,23,344,447,791,1241
0132-000,2011,7,16,24,296,320,616,791
0132-000,2011,7,17,1,219,253,472,616
0132-000,2011,7,17,2,138,179,317,472
0132-000,2011,7,17,3,113,120,233,317
0132-000,2011,7,17,4,81,107,188,233
0132-000,2011,7,17,5,99,106,205,188
0132-000,2011,7,17,6,145,149,294,205
0132-000,2011,7,17,7,252,240,492,294
0132-000,2011,7,17,8,264,404,668,492
0132-000,2011,7,17,9,428,468,896,668
0132-000,2011,7,17,10,436,478,914,896
0132-000,2011,7,17,11,547,555,1102,914
0132-000,2011,7,17,12,573,621,1194,1102
0132-000,2011,7,17,13,651,638,1289,1194
0132-000,2011,7,17,14,689,709,1398,1289
0132-000,2011,7,17,15,765,735,1500,1398
0132-000,2011,7,17,16,1028,701,1729,1500
0132-000,2011,7,17,17,1271,713,1984,1729
0132-000,2011,7,17,18,1437,742,2179,1984
0132-000,2011,7,17,19,1240,662,1902,2179
0132-000,2011,7,17,20,898,551,1449,1902
0132-000,2011,7,17,21,801,603,1404,1449
0132-000,2011,7,17,22,747,541,1288,1404
0132-000,2011,7,17,23,366,410,776,1288
0132-000,2011,7,17,24,225,247,472,776
0132-000,2011,7,18,1,153,190,343,472
0132-000,2011,7,18,2,112,124,236,343
0132-000,2011,7,18,3,74,95,169,236
0132-000,2011,7,18,4,64,75,139,169
0132-000,2011,7,18,5,115,133,248,139
0132-000,2011,7,18,6,235,228,463,248
0132-000,2011,7,18,7,544,666,1210,463
0132-000,2011,7,18,8,821,1640,2461,1210
0132-000,2011,7,18,9,816,1358,2174,2461
0132-000,2011,7,18,10,850,905,1755,2174
0132-000,2011,7,18,11,830,924,1754,1755
0132-000,2011,7,18,12,775,937,1712,1754
0132-000,2011,7,18,13,864,888,1752,1712
0132-000,2011,7,18,14,873,919,1792,1752
0132-000,2011,7,18,15,922,1011,1933,1792
0132-000,2011,7,18,16,1014,893,1907,1933
0132-000,2011,7,18,17,993,950,1943,1907
0132-000,2011,7,18,18,1142,829,1971,1943
0132-000,2011,7,18,19,1203,948,2151,1971
0132-000,2011,7,18,20,1001,804,1805,2151
0132-000,2011,7,18,21,826,680,1506,1805
0132-000,2011,7,18,22,677,556,1233,1506
0132-000,2011,7,18,23,408,361,769,1233
0132-000,2011,7,18,24,256,264,520,769
0132-000,2011,7,19,1,165,225,390,520
0132-000,2011,7,19,2,131,119,250,390
0132-000,2011,7,19,3,79,112,191,250
0132-000,2011,7,19,4,68,95,163,191
0132-000,2011,7,19,5,124,133,257,163
0132-000,2011,7,19,6,233,220,453,257
0132-000,2011,7,19,7,491,493,984,453
0132-000,2011,7,19,8,807,1333,2140,984
0132-000,2011,7,19,9,851,1338,2189,2140
0132-000,2011,7,19,10,847,904,1751,2189
0132-000,2011,7,19,11,869,987,1856,1751
0132-000,2011,7,19,12,864,939,1803,1856
0132-000,2011,7,19,13,850,824,1674,1803
0132-000,2011,7,19,14,849,926,1775,1674
0132-000,2011,7,19,15,988,976,1964,1775
0132-000,2011,7,19,16,1073,1004,2077,1964
0132-000,2011,7,19,17,1071,928,1999,2077
0132-000,2011,7,19,18,1156,882,2038,1999
0132-000,2011,7,19,19,1160,923,2083,2038
0132-000,2011,7,19,20,997,835,1832,2083
0132-000,2011,7,19,21,858,673,1531,1832
0132-000,2011,7,19,22,746,568,1314,1531
0132-000,2011,7,19,23,400,395,795,1314
0132-000,2011,7,19,24,291,250,541,795
0132-000,2011,7,20,1,181,186,367,541
0132-000,2011,7,20,2,119,135,254,367
0132-000,2011,7,20,3,88,112,200,254
0132-000,2011,7,20,4,77,100,177,200
0132-000,2011,7,20,5,127,146,273,177
0132-000,2011,7,20,6,225,215,440,273
0132-000,2011,7,20,7,512,502,1014,440
0132-000,2011,7,20,8,785,1385,2170,1014
0132-000,2011,7,20,9,836,1268,2104,2170
0132-000,2011,7,20,10,900,889,1789,2104
0132-000,2011,7,20,11,897,955,1852,1789
0132-000,2011,7,20,12,916,912,1828,1852
0132-000,2011,7,20,13,765,882,1647,1828
0132-000,2011,7,20,14,845,942,1787,1647
0132-000,2011,7,20,15,1002,1003,2005,1787
0132-000,2011,7,20,16,997,918,1915,2005
0132-000,2011,7,20,17,1024,921,1945,1915
0132-000,2011,7,20,18,1145,938,2083,1945
0132-000,2011,7,20,19,1300,1016,2316,2083
0132-000,2011,7,20,20,1019,787,1806,2316
0132-000,2011,7,20,21,836,664,1500,1806
0132-000,2011,7,20,22,677,548,1225,1500
0132-000,2011,7,20,23,447,407,854,1225
0132-000,2011,7,20,24,305,321,626,854
0132-000,2011,7,21,1,210,228,438,626
0132-000,2011,7,21,2,157,170,327,438
0132-000,2011,7,21,3,115,139,254,327
0132-000,2011,7,21,4,81,105,186,254
0132-000,2011,7,21,5,123,130,253,186
0132-000,2011,7,21,6,257,208,465,253
0132-000,2011,7,21,7,457,486,943,465
0132-000,2011,7,21,8,803,1399,2202,943
0132-000,2011,7,21,9,859,1300,2159,2202
0132-000,2011,7,21,10,923,945,1868,2159
0132-000,2011,7,21,11,842,911,1753,1868
0132-000,2011,7,21,12,847,958,1805,1753
0132-000,2011,7,21,13,848,905,1753,1805
0132-000,2011,7,21,14,852,895,1747,1753
0132-000,2011,7,21,15,966,1101,2067,1747
0132-000,2011,7,21,16,1077,921,1998,2067
0132-000,2011,7,21,17,1048,908,1956,1998
0132-000,2011,7,21,18,1186,858,2044,1956
0132-000,2011,7,21,19,1219,944,2163,2044
0132-000,2011,7,21,20,979,834,1813,2163
0132-000,2011,7,21,21,842,620,1462,1813
0132-000,2011,7,21,22,691,575,1266,1462
0132-000,2011,7,21,23,438,411,849,1266
0132-000,2011,7,21,24,297,267,564,849
0132-000,2011,7,22,1,204,191,395,564
0132-000,2011,7,22,2,131,141,272,395
0132-000,2011,7,22,3,95,139,234,272
0132-000,2011,7,22,4,88,96,184,234
0132-000,2011,7,22,5,113,135,248,184
0132-000,2011,7,22,6,219,185,404,248
0132-000,2011,7,22,7,435,488,923,404
0132-000,2011,7,22,8,758,1350,2108,923
0132-000,2011,7,22,9,900,1348,2248,2108
0132-000,2011,7,22,10,837,922,1759,2248
0132-000,2011,7,22,11,866,976,1842,1759
0132-000,2011,7,22,12,920,931,1851,1842
0132-000,2011,7,22,13,826,862,1688,1851
0132-000,2011,7,22,14,936,954,1890,1688
0132-000,2011,7,22,15,1017,1026,2043,1890
0132-000,2011,7,22,16,1036,978,2014,2043
0132-000,2011,7,22,17,1056,934,1990,2014
0132-000,2011,7,22,18,1244,959,2203,1990
0132-000,2011,7,22,19,1574,1069,2643,2203
0132-000,2011,7,22,20,1195,895,2090,2643
0132-000,2011,7,22,21,935,679,1614,2090
0132-000,2011,7,22,22,800,610,1410,1614
0132-000,2011,7,22,23,469,511,980,1410
0132-000,2011,7,22,24,318,316,634,980
0132-000,2011,7,23,1,236,261,497,634
0132-000,2011,7,23,2,166,195,361,497
0132-000,2011,7,23,3,147,137,284,361
0132-000,2011,7,23,4,91,145,236,284
0132-000,2011,7,23,5,119,163,282,236
0132-000,2011,7,23,6,244,218,462,282
0132-000,2011,7,23,7,385,440,825,462
0132-000,2011,7,23,8,633,925,1558,825
0132-000,2011,7,23,9,743,1000,1743,1558
0132-000,2011,7,23,10,818,1121,1939,1743
0132-000,2011,7,23,11,830,1416,2246,1939
0132-000,2011,7,23,12,857,1666,2523,2246
0132-000,2011,7,23,13,832,1554,2386,2523
0132-000,2011,7,23,14,894,1405,2299,2386
0132-000,2011,7,23,15,922,1401,2323,2299
0132-000,2011,7,23,16,948,1416,2364,2323
0132-000,2011,7,23,17,1064,1178,2242,2364
0132-000,2011,7,23,18,1298,1121,2419,2242
0132-000,2011,7,23,19,1405,1052,2457,2419
0132-000,2011,7,23,20,835,772,1607,2457
0132-000,2011,7,23,21,741,679,1420,1607
0132-000,2011,7,23,22,670,522,1192,1420
0132-000,2011,7,23,23,410,426,836,1192
0132-000,2011,7,23,24,272,327,599,836
0132-000,2011,7,24,1,198,224,422,599
0132-000,2011,7,24,2,138,190,328,422
0132-000,2011,7,24,3,97,120,217,328
0132-000,2011,7,24,4,105,87,192,217
0132-000,2011,7,24,5,112,112,224,192
0132-000,2011,7,24,6,128,105,233,224
0132-000,2011,7,24,7,211,218,429,233
0132-000,2011,7,24,8,282,480,762,429
0132-000,2011,7,24,9,379,513,892,762
0132-000,2011,7,24,10,413,443,856,892
0132-000,2011,7,24,11,507,560,1067,856
0132-000,2011,7,24,12,582,593,1175,1067
0132-000,2011,7,24,13,597,671,1268,1175
0132-000,2011,7,24,14,697,661,1358,1268
0132-000,2011,7,24,15,1033,663,1696,1358
0132-000,2011,7,24,16,1248,682,1930,1696
0132-000,2011,7,24,17,1453,695,2148,1930
0132-000,2011,7,24,18,1564,658,2222,2148
0132-000,2011,7,24,19,1230,597,1827,2222
0132-000,2011,7,24,20,842,540,1382,1827
0132-000,2011,7,24,21,689,551,1240,1382
0132-000,2011,7,24,22,628,433,1061,1240
0132-000,2011,7,24,23,301,374,675,1061
0132-000,2011,7,24,24,195,277,472,675
0132-000,2011,7,25,1,155,184,339,472
0132-000,2011,7,25,2,88,108,196,339
0132-000,2011,7,25,3,48,80,128,196
0132-000,2011,7,25,4,69,82,151,128
0132-000,2011,7,25,5,101,120,221,151
0132-000,2011,7,25,6,242,221,463,221
0132-000,2011,7,25,7,488,623,1111,463
0132-000,2011,7,25,8,806,1530,2336,1111
0132-000,2011,7,25,9,843,1362,2205,2336
0132-000,2011,7,25,10,765,959,1724,2205
0132-000,2011,7,25,11,847,883,1730,1724
0132-000,2011,7,25,12,851,891,1742,1730
0132-000,2011,7,25,13,841,914,1755,1742
0132-000,2011,7,25,14,865,974,1839,1755
0132-000,2011,7,25,15,1021,949,1970,1839
0132-000,2011,7,25,16,957,973,1930,1970
0132-000,2011,7,25,17,1033,974,2007,1930
0132-000,2011,7,25,18,1119,945,2064,2007
0132-000,2011,7,25,19,1219,962,2181,2064
0132-000,2011,7,25,20,1037,779,1816,2181
0132-000,2011,7,25,21,848,629,1477,1816
0132-000,2011,7,25,22,665,527,1192,1477
0132-000,2011,7,25,23,369,340,709,1192
0132-000,2011,7,25,24,274,285,559,709
0132-000,2011,7,26,1,179,209,388,559
0132-000,2011,7,26,2,117,133,250,388
0132-000,2011,7,26,3,87,117,204,250
0132-000,2011,7,26,4,73,106,179,204
0132-000,2011,7,26,5,103,115,218,179
0132-000,2011,7,26,6,201,226,427,218
0132-000,2011,7,26,7,433,503,936,427
0132-000,2011,7,26,8,722,1451,2173,936
0132-000,2011,7,26,9,925,1289,2214,2173
0132-000,2011,7,26,10,897,1018,1915,2214
0132-000,2011,7,26,11,882,1011,1893,1915
0132-000,2011,7,26,12,898,986,1884,1893
0132-000,2011,7,26,13,855,996,1851,1884
0132-000,2011,7,26,14,936,937,1873,1851
0132-000,2011,7,26,15,1091,1060,2151,1873
0132-000,2011,7,26,16,1043,980,2023,2151
0132-000,2011,7,26,17,1139,949,2088,2023
0132-000,2011,7,26,18,1195,951,2146,2088
0132-000,2011,7,26,19,1149,893,2042,2146
0132-000,2011,7,26,20,943,749,1692,2042
0132-000,2011,7,26,21,754,578,1332,1692
0132-000,2011,7,26,22,606,478,1084,1332
0132-000,2011,7,26,23,434,393,827,1084
0132-000,2011,7,26,24,230,276,506,827
0132-000,2011,7,27,1,200,227,427,506
0132-000,2011,7,27,2,127,190,317,427
0132-000,2011,7,27,3,88,104,192,317
0132-000,2011,7,27,4,80,97,177,192
0132-000,2011,7,27,5,104,108,212,177
0132-000,2011,7,27,6,176,140,316,212
0132-000,2011,7,27,7,327,365,692,316
0132-000,2011,7,27,8,711,1252,1963,692
0132-000,2011,7,27,9,838,1220,2058,1963
0132-000,2011,7,27,10,723,821,1544,2058
0132-000,2011,7,27,11,736,845,1581,1544
0132-000,2011,7,27,12,771,792,1563,1581
0132-000,2011,7,27,13,757,729,1486,1563
0132-000,2011,7,27,14,800,822,1622,1486
0132-000,2011,7,27,15,897,915,1812,1622
0132-000,2011,7,27,16,928,932,1860,1812
0132-000,2011,7,27,17,916,956,1872,1860
0132-000,2011,7,27,18,1023,934,1957,1872
0132-000,2011,7,27,19,1140,896,2036,1957
0132-000,2011,7,27,20,914,731,1645,2036
0132-000,2011,7,27,21,693,589,1282,1645
0132-000,2011,7,27,22,629,482,1111,1282
0132-000,2011,7,27,23,382,375,757,1111
0132-000,2011,7,27,24,290,276,566,757
0132-000,2011,7,28,1,164,192,356,566
0132-000,2011,7,28,2,114,136,250,356
0132-000,2011,7,28,3,93,121,214,250
0132-000,2011,7,28,4,101,107,208,214
0132-000,2011,7,28,5,113,118,231,208
0132-000,2011,7,28,6,172,186,358,231
0132-000,2011,7,28,7,378,408,786,358
0132-000,2011,7,28,8,706,1252,1958,786
0132-000,2011,7,28,9,828,1185,2013,1958
0132-000,2011,7,28,10,802,841,1643,2013
0132-000,2011,7,28,11,794,869,1663,1643
0132-000,2011,7,28,12,800,866,1666,1663
0132-000,2011,7,28,13,810,888,1698,1666
0132-000,2011,7,28,14,780,924,1704,1698
0132-000,2011,7,28,15,911,1033,1944,1704
0132-000,2011,7,28,16,943,926,1869,1944
0132-000,2011,7,28,17,984,893,1877,1869
0132-000,2011,7,28,18,1103,863,1966,1877
0132-000,2011,7,28,19,1197,998,2195,1966
0132-000,2011,7,28,20,927,840,1767,2195
0132-000,2011,7,28,21,750,648,1398,1767
0132-000,2011,7,28,22,646,627,1273,1398
0132-000,2011,7,28,23,413,346,759,1273
0132-000,2011,7,28,24,260,276,536,759
0132-000,2011,7,29,1,211,202,413,536
0132-000,2011,7,29,2,116,160,276,413
0132-000,2011,7,29,3,89,122,211,276
0132-000,2011,7,29,4,104,107,211,211
0132-000,2011,7,29,5,105,132,237,211
0132-000,2011,7,29,6,168,181,349,237
0132-000,2011,7,29,7,407,435,842,349
0132-000,2011,7,29,8,722,1275,1997,842
0132-000,2011,7,29,9,792,1196,1988,1997
0132-000,2011,7,29,10,770,902,1672,1988
0132-000,2011,7,29,11,857,861,1718,1672
0132-000,2011,7,29,12,893,875,1768,1718
0132-000,2011,7,29,13,865,911,1776,1768
0132-000,2011,7,29,14,912,941,1853,1776
0132-000,2011,7,29,15,1024,1053,2077,1853
0132-000,2011,7,29,16,1053,979,2032,2077
0132-000,2011,7,29,17,1064,1242,2306,2032
0132-000,2011,7,29,18,1343,1250,2593,2306
0132-000,2011,7,29,19,1560,1373,2933,2593
0132-000,2011,7,29,20,1229,1257,2486,2933
0132-000,2011,7,29,21,974,1041,2015,2486
0132-000,2011,7,29,22,726,922,1648,2015
0132-000,2011,7,29,23,512,714,1226,1648
0132-000,2011,7,29,24,317,563,880,1226
0132-000,2011,7,30,1,247,566,813,880
0132-000,2011,7,30,2,163,253,416,813
0132-000,2011,7,30,3,122,163,285,416
0132-000,2011,7,30,4,118,158,276,285
0132-000,2011,7,30,5,141,166,307,276
0132-000,2011,7,30,6,228,203,431,307
0132-000,2011,7,30,7,358,372,730,431
0132-000,2011,7,30,8,531,773,1304,730
0132-000,2011,7,30,9,715,1309,2024,1304
0132-000,2011,7,30,10,735,1591,2326,2024
0132-000,2011,7,30,11,806,1721,2527,2326
0132-000,2011,7,30,12,794,1778,2572,2527
0132-000,2011,7,30,13,813,1814,2627,2572
0132-000,2011,7,30,14,778,1802,2580,2627
0132-000,2011,7,30,15,777,1856,2633,2580
0132-000,2011,7,30,16,823,1913,2736,2633
0132-000,2011,7,30,17,849,1893,2742,2736
0132-000,2011,7,30,18,982,1945,2927,2742
0132-000,2011,7,30,19,946,1920,2866,2927
0132-000,2011,7,30,20,840,1519,2359,2866
0132-000,2011,7,30,21,648,777,1425,2359
0132-000,2011,7,30,22,541,570,1111,1425
0132-000,2011,7,30,23,400,452,852,1111
0132-000,2011,7,30,24,243,290,533,852
0132-000,2011,7,31,1,184,219,403,533
0132-000,2011,7,31,2,150,146,296,403
0132-000,2011,7,31,3,93,117,210,296
0132-000,2011,7,31,4,111,109,220,210
0132-000,2011,7,31,5,110,116,226,220
0132-000,2011,7,31,6,160,152,312,226
0132-000,2011,7,31,7,231,260,491,312
0132-000,2011,7,31,8,292,400,692,491
0132-000,2011,7,31,9,387,587,974,692
0132-000,2011,7,31,10,471,751,1222,974
0132-000,2011,7,31,11,608,908,1516,1222
0132-000,2011,7,31,12,561,938,1499,1516
0132-000,2011,7,31,13,634,837,1471,1499
0132-000,2011,7,31,14,677,836,1513,1471
0132-000,2011,7,31,15,736,759,1495,1513
0132-000,2011,7,31,16,1084,956,2040,1495
0132-000,2011,7,31,17,1275,1005,2280,2040
0132-000,2011,7,31,18,1474,869,2343,2280
0132-000,2011,7,31,19,1317,729,2046,2343
0132-000,2011,7,31,20,958,578,1536,2046
0132-000,2011,7,31,21,842,517,1359,1536
0132-000,2011,7,31,22,590,380,970,1359
0132-000,2011,7,31,23,376,330,706,970
0132-000,2011,7,31,24,250,250,500,706
0132-000,2011,8,1,1,149,160,309,500
0132-000,2011,8,1,2,85,103,188,309
0132-000,2011,8,1,3,73,83,156,188
0132-000,2011,8,1,4,64,88,152,156
0132-000,2011,8,1,5,98,101,199,152
0132-000,2011,8,1,6,161,160,321,199
0132-000,2011,8,1,7,346,483,829,321
0132-000,2011,8,1,8,641,1036,1677,829
0132-000,2011,8,1,9,638,942,1580,1677
0132-000,2011,8,1,10,644,706,1350,1580
0132-000,2011,8,1,11,710,792,1502,1350
0132-000,2011,8,1,12,791,883,1674,1502
0132-000,2011,8,1,13,769,857,1626,1674
0132-000,2011,8,1,14,736,888,1624,1626
0132-000,2011,8,1,15,829,878,1707,1624
0132-000,2011,8,1,16,909,836,1745,1707
0132-000,2011,8,1,17,970,828,1798,1745
0132-000,2011,8,1,18,1106,761,1867,1798
0132-000,2011,8,1,19,1119,834,1953,1867
0132-000,2011,8,1,20,921,633,1554,1953
0132-000,2011,8,1,21,705,523,1228,1554
0132-000,2011,8,1,22,542,469,1011,1228
0132-000,2011,8,1,23,362,334,696,1011
0132-000,2011,8,1,24,248,235,483,696
0132-000,2011,8,2,1,175,184,359,483
0132-000,2011,8,2,2,119,136,255,359
0132-000,2011,8,2,3,93,92,185,255
0132-000,2011,8,2,4,56,96,152,185
0132-000,2011,8,2,5,103,116,219,152
0132-000,2011,8,2,6,178,172,350,219
0132-000,2011,8,2,7,360,355,715,350
0132-000,2011,8,2,8,589,988,1577,715
0132-000,2011,8,2,9,624,940,1564,1577
0132-000,2011,8,2,10,708,743,1451,1564
0132-000,2011,8,2,11,728,745,1473,1451
0132-000,2011,8,2,12,756,832,1588,1473
0132-000,2011,8,2,13,745,758,1503,1588
0132-000,2011,8,2,14,762,829,1591,1503
0132-000,2011,8,2,15,854,849,1703,1591
0132-000,2011,8,2,16,923,794,1717,1703
0132-000,2011,8,2,17,1013,780,1793,1717
0132-000,2011,8,2,18,1277,807,2084,1793
0132-000,2011,8,2,19,1407,846,2253,2084
0132-000,2011,8,2,20,1200,680,1880,2253
0132-000,2011,8,2,21,901,590,1491,1880
0132-000,2011,8,2,22,635,469,1104,1491
0132-000,2011,8,2,23,413,380,793,1104
0132-000,2011,8,2,24,284,275,559,793
0132-000,2011,8,3,1,208,185,393,559
0132-000,2011,8,3,2,125,159,284,393
0132-000,2011,8,3,3,86,94,180,284
0132-000,2011,8,3,4,97,88,185,180
0132-000,2011,8,3,5,84,111,195,185
0132-000,2011,8,3,6,189,201,390,195
0132-000,2011,8,3,7,405,437,842,390
0132-000,2011,8,3,8,583,977,1560,842
0132-000,2011,8,3,9,658,954,1612,1560
0132-000,2011,8,3,10,716,770,1486,1612
0132-000,2011,8,3,11,712,814,1526,1486
0132-000,2011,8,3,12,767,754,1521,1526
0132-000,2011,8,3,13,717,825,1542,1521
0132-000,2011,8,3,14,753,824,1577,1542
0132-000,2011,8,3,15,885,862,1747,1577
0132-000,2011,8,3,16,966,823,1789,1747
0132-000,2011,8,3,17,1157,827,1984,1789
0132-000,2011,8,3,18,1322,776,2098,1984
0132-000,2011,8,3,19,1637,932,2569,2098
0132-000,2011,8,3,20,1629,652,2281,2569
0132-000,2011,8,3,21,1125,518,1643,2281
0132-000,2011,8,3,22,766,484,1250,1643
0132-000,2011,8,3,23,424,368,792,1250
0132-000,2011,8,3,24,261,229,490,792
0132-000,2011,8,4,1,160,198,358,490
0132-000,2011,8,4,2,107,165,272,358
0132-000,2011,8,4,3,84,93,177,272
0132-000,2011,8,4,4,80,85,165,177
0132-000,2011,8,4,5,98,92,190,165
0132-000,2011,8,4,6,183,198,381,190
0132-000,2011,8,4,7,357,423,780,381
0132-000,2011,8,4,8,663,1118,1781,780
0132-000,2011,8,4,9,720,1109,1829,1781
0132-000,2011,8,4,10,755,792,1547,1829
0132-000,2011,8,4,11,809,798,1607,1547
0132-000,2011,8,4,12,822,799,1621,1607
0132-000,2011,8,4,13,730,834,1564,1621
0132-000,2011,8,4,14,759,887,1646,1564
0132-000,2011,8,4,15,904,890,1794,1646
0132-000,2011,8,4,16,889,921,1810,1794
0132-000,2011,8,4,17,1000,817,1817,1810
0132-000,2011,8,4,18,1191,819,2010,1817
0132-000,2011,8,4,19,1228,828,2056,2010
0132-000,2011,8,4,20,820,670,1490,2056
0132-000,2011,8,4,21,738,602,1340,1490
0132-000,2011,8,4,22,609,532,1141,1340
0132-000,2011,8,4,23,363,393,756,1141
0132-000,2011,8,4,24,270,289,559,756
0132-000,2011,8,5,1,182,205,387,559
0132-000,2011,8,5,2,120,161,281,387
0132-000,2011,8,5,3,81,102,183,281
0132-000,2011,8,5,4,75,103,178,183
0132-000,2011,8,5,5,104,128,232,178
0132-000,2011,8,5,6,178,191,369,232
0132-000,2011,8,5,7,385,450,835,369
0132-000,2011,8,5,8,657,1141,1798,835
0132-000,2011,8,5,9,767,1192,1959,1798
0132-000,2011,8,5,10,764,822,1586,1959
0132-000,2011,8,5,11,754,895,1649,1586
0132-000,2011,8,5,12,823,844,1667,1649
0132-000,2011,8,5,13,808,873,1681,1667
0132-000,2011,8,5,14,814,866,1680,1681
0132-000,2011,8,5,15,864,912,1776,1680
0132-000,2011,8,5,16,1021,980,2001,1776
0132-000,2011,8,5,17,1033,989,2022,2001
0132-000,2011,8,5,18,1285,932,2217,2022
0132-000,2011,8,5,19,1290,979,2269,2217
0132-000,2011,8,5,20,1071,854,1925,2269
0132-000,2011,8,5,21,877,705,1582,1925
0132-000,2011,8,5,22,770,566,1336,1582
0132-000,2011,8,5,23,442,445,887,1336
0132-000,2011,8,5,24,298,314,612,887
0132-000,2011,8,6,1,214,283,497,612
0132-000,2011,8,6,2,156,214,370,497
0132-000,2011,8,6,3,134,147,281,370
0132-000,2011,8,6,4,102,141,243,281
0132-000,2011,8,6,5,141,158,299,243
0132-000,2011,8,6,6,194,226,420,299
0132-000,2011,8,6,7,320,403,723,420
0132-000,2011,8,6,8,547,770,1317,723
0132-000,2011,8,6,9,667,861,1528,1317
0132-000,2011,8,6,10,715,919,1634,1528
0132-000,2011,8,6,11,770,1075,1845,1634
0132-000,2011,8,6,12,827,1153,1980,1845
0132-000,2011,8,6,13,884,1197,2081,1980
0132-000,2011,8,6,14,929,1145,2074,2081
0132-000,2011,8,6,15,994,1009,2003,2074
0132-000,2011,8,6,16,1163,972,2135,2003
0132-000,2011,8,6,17,1356,902,2258,2135
0132-000,2011,8,6,18,1562,941,2503,2258
0132-000,2011,8,6,19,1500,862,2362,2503
0132-000,2011,8,6,20,1339,703,2042,2362
0132-000,2011,8,6,21,797,533,1330,2042
0132-000,2011,8,6,22,694,497,1191,1330
0132-000,2011,8,6,23,399,427,826,1191
0132-000,2011,8,6,24,269,315,584,826
0132-000,2011,8,7,1,189,251,440,584
0132-000,2011,8,7,2,139,152,291,440
0132-000,2011,8,7,3,116,128,244,291
0132-000,2011,8,7,4,78,101,179,244
0132-000,2011,8,7,5,80,113,193,179
0132-000,2011,8,7,6,131,140,271,193
0132-000,2011,8,7,7,198,244,442,271
0132-000,2011,8,7,8,279,359,638,442
0132-000,2011,8,7,9,366,433,799,638
0132-000,2011,8,7,10,412,468,880,799
0132-000,2011,8,7,11,520,535,1055,880
0132-000,2011,8,7,12,652,523,1175,1055
0132-000,2011,8,7,13,1011,611,1622,1175
0132-000,2011,8,7,14,1169,651,1820,1622
0132-000,2011,8,7,15,1217,598,1815,1820
0132-000,2011,8,7,16,1286,673,1959,1815
0132-000,2011,8,7,17,1366,671,2037,1959
0132-000,2011,8,7,18,1438,735,2173,2037
0132-000,2011,8,7,19,1338,607,1945,2173
0132-000,2011,8,7,20,1150,539,1689,1945
0132-000,2011,8,7,21,784,524,1308,1689
0132-000,2011,8,7,22,643,462,1105,1308
0132-000,2011,8,7,23,324,343,667,1105
0132-000,2011,8,7,24,184,233,417,667
0132-000,2011,8,8,1,135,157,292,417
0132-000,2011,8,8,2,80,102,182,292
0132-000,2011,8,8,3,68,80,148,182
0132-000,2011,8,8,4,56,75,131,148
0132-000,2011,8,8,5,85,81,166,131
0132-000,2011,8,8,6,175,180,355,166
0132-000,2011,8,8,7,435,561,996,355
0132-000,2011,8,8,8,754,1552,2306,996
0132-000,2011,8,8,9,774,1186,1960,2306
0132-000,2011,8,8,10,766,832,1598,1960
0132-000,2011,8,8,11,751,860,1611,1598
0132-000,2011,8,8,12,811,873,1684,1611
0132-000,2011,8,8,13,768,806,1574,1684
0132-000,2011,8,8,14,852,836,1688,1574
0132-000,2011,8,8,15,897,867,1764,1688
0132-000,2011,8,8,16,956,950,1906,1764
0132-000,2011,8,8,17,956,855,1811,1906
0132-000,2011,8,8,18,1024,817,1841,1811
0132-000,2011,8,8,19,1123,823,1946,1841
0132-000,2011,8,8,20,890,663,1553,1946
0132-000,2011,8,8,21,711,583,1294,1553
0132-000,2011,8,8,22,584,469,1053,1294
0132-000,2011,8,8,23,331,325,656,1053
0132-000,2011,8,8,24,233,250,483,656
0132-000,2011,8,9,1,175,183,358,483
0132-000,2011,8,9,2,106,119,225,358
0132-000,2011,8,9,3,80,115,195,225
0132-000,2011,8,9,4,95,107,202,195
0132-000,2011,8,9,5,103,106,209,202
0132-000,2011,8,9,6,197,194,391,209
0132-000,2011,8,9,7,419,461,880,391
0132-000,2011,8,9,8,767,1367,2134,880
0132-000,2011,8,9,9,770,1160,1930,2134
0132-000,2011,8,9,10,831,858,1689,1930
0132-000,2011,8,9,11,837,893,1730,1689
0132-000,2011,8,9,12,857,875,1732,1730
0132-000,2011,8,9,13,705,833,1538,1732
0132-000,2011,8,9,14,865,985,1850,1538
0132-000,2011,8,9,15,961,1042,2003,1850
0132-000,2011,8,9,16,1008,961,1969,2003
0132-000,2011,8,9,17,1029,922,1951,1969
0132-000,2011,8,9,18,1032,802,1834,1951
0132-000,2011,8,9,19,1159,912,2071,1834
0132-000,2011,8,9,20,938,713,1651,2071
0132-000,2011,8,9,21,766,655,1421,1651
0132-000,2011,8,9,22,659,493,1152,1421
0132-000,2011,8,9,23,413,341,754,1152
0132-000,2011,8,9,24,259,251,510,754
0132-000,2011,8,10,1,203,185,388,510
0132-000,2011,8,10,2,138,117,255,388
0132-000,2011,8,10,3,82,106,188,255
0132-000,2011,8,10,4,92,97,189,188
0132-000,2011,8,10,5,115,107,222,189
0132-000,2011,8,10,6,173,200,373,222
0132-000,2011,8,10,7,428,419,847,373
0132-000,2011,8,10,8,675,1290,1965,847
0132-000,2011,8,10,9,856,1301,2157,1965
0132-000,2011,8,10,10,884,876,1760,2157
0132-000,2011,8,10,11,805,945,1750,1760
0132-000,2011,8,10,12,908,948,1856,1750
0132-000,2011,8,10,13,816,851,1667,1856
0132-000,2011,8,10,14,932,938,1870,1667
0132-000,2011,8,10,15,994,1007,2001,1870
0132-000,2011,8,10,16,1031,997,2028,2001
0132-000,2011,8,10,17,1009,910,1919,2028
0132-000,2011,8,10,18,1180,912,2092,1919
0132-000,2011,8,10,19,1297,960,2257,2092
0132-000,2011,8,10,20,944,750,1694,2257
0132-000,2011,8,10,21,722,555,1277,1694
0132-000,2011,8,10,22,582,489,1071,1277
0132-000,2011,8,10,23,406,361,767,1071
0132-000,2011,8,10,24,243,247,490,767
0132-000,2011,8,11,1,184,192,376,490
0132-000,2011,8,11,2,136,164,300,376
0132-000,2011,8,11,3,99,86,185,300
0132-000,2011,8,11,4,110,117,227,185
0132-000,2011,8,11,5,118,138,256,227
0132-000,2011,8,11,6,222,229,451,256
0132-000,2011,8,11,7,449,514,963,451
0132-000,2011,8,11,8,721,1321,2042,963
0132-000,2011,8,11,9,870,1221,2091,2042
0132-000,2011,8,11,10,786,872,1658,2091
0132-000,2011,8,11,11,878,977,1855,1658
0132-000,2011,8,11,12,884,913,1797,1855
0132-000,2011,8,11,13,827,887,1714,1797
0132-000,2011,8,11,14,907,953,1860,1714
0132-000,2011,8,11,15,1002,1016,2018,1860
0132-000,2011,8,11,16,1035,970,2005,2018
0132-000,2011,8,11,17,1040,900,1940,2005
0132-000,2011,8,11,18,1139,919,2058,1940
0132-000,2011,8,11,19,1206,889,2095,2058
0132-000,2011,8,11,20,1072,807,1879,2095
0132-000,2011,8,11,21,807,578,1385,1879
0132-000,2011,8,11,22,679,561,1240,1385
0132-000,2011,8,11,23,450,370,820,1240
0132-000,2011,8,11,24,265,305,570,820
0132-000,2011,8,12,1,179,208,387,570
0132-000,2011,8,12,2,125,121,246,387
0132-000,2011,8,12,3,94,120,214,246
0132-000,2011,8,12,4,94,109,203,214
0132-000,2011,8,12,5,118,124,242,203
0132-000,2011,8,12,6,195,175,370,242
0132-000,2011,8,12,7,396,451,847,370
0132-000,2011,8,12,8,702,1219,1921,847
0132-000,2011,8,12,9,881,1311,2192,1921
0132-000,2011,8,12,10,812,948,1760,2192
0132-000,2011,8,12,11,891,996,1887,1760
0132-000,2011,8,12,12,928,938,1866,1887
0132-000,2011,8,12,13,852,841,1693,1866
0132-000,2011,8,12,14,923,983,1906,1693
0132-000,2011,8,12,15,981,951,1932,1906
0132-000,2011,8,12,16,961,1114,2075,1932
0132-000,2011,8,12,17,1064,1140,2204,2075
0132-000,2011,8,12,18,1359,1308,2667,2204
0132-000,2011,8,12,19,1649,1266,2915,2667
0132-000,2011,8,12,20,1550,1082,2632,2915
0132-000,2011,8,12,21,1191,979,2170,2632
0132-000,2011,8,12,22,864,822,1686,2170
0132-000,2011,8,12,23,479,633,1112,1686
0132-000,2011,8,12,24,273,433,706,1112
0132-000,2011,8,13,1,225,244,469,706
0132-000,2011,8,13,2,151,185,336,469
0132-000,2011,8,13,3,110,139,249,336
0132-000,2011,8,13,4,92,109,201,249
0132-000,2011,8,13,5,118,120,238,201
0132-000,2011,8,13,6,157,154,311,238
0132-000,2011,8,13,7,352,350,702,311
0132-000,2011,8,13,8,518,709,1227,702
0132-000,2011,8,13,9,710,938,1648,1227
0132-000,2011,8,13,10,727,1115,1842,1648
0132-000,2011,8,13,11,827,1335,2162,1842
0132-000,2011,8,13,12,827,1502,2329,2162
0132-000,2011,8,13,13,774,1766,2540,2329
0132-000,2011,8,13,14,873,1776,2649,2540
0132-000,2011,8,13,15,902,1887,2789,2649
0132-000,2011,8,13,16,995,1898,2893,2789
0132-000,2011,8,13,17,940,1906,2846,2893
0132-000,2011,8,13,18,1214,1980,3194,2846
0132-000,2011,8,13,19,1053,2018,3071,3194
0132-000,2011,8,13,20,777,1864,2641,3071
0132-000,2011,8,13,21,689,1738,2427,2641
0132-000,2011,8,13,22,572,1036,1608,2427
0132-000,2011,8,13,23,386,531,917,1608
0132-000,2011,8,13,24,235,277,512,917
0132-000,2011,8,14,1,187,222,409,512
0132-000,2011,8,14,2,132,151,283,409
0132-000,2011,8,14,3,103,119,222,283
0132-000,2011,8,14,4,96,71,167,222
0132-000,2011,8,14,5,79,98,177,167
0132-000,2011,8,14,6,129,142,271,177
0132-000,2011,8,14,7,254,247,501,271
0132-000,2011,8,14,8,293,384,677,501
0132-000,2011,8,14,9,416,565,981,677
0132-000,2011,8,14,10,469,607,1076,981
0132-000,2011,8,14,11,540,803,1343,1076
0132-000,2011,8,14,12,592,832,1424,1343
0132-000,2011,8,14,13,609,779,1388,1424
0132-000,2011,8,14,14,666,836,1502,1388
0132-000,2011,8,14,15,761,767,1528,1502
0132-000,2011,8,14,16,1147,845,1992,1528
0132-000,2011,8,14,17,1360,958,2318,1992
0132-000,2011,8,14,18,1456,912,2368,2318
0132-000,2011,8,14,19,1426,901,2327,2368
0132-000,2011,8,14,20,1432,660,2092,2327
0132-000,2011,8,14,21,1296,508,1804,2092
0132-000,2011,8,14,22,1096,400,1496,1804
0132-000,2011,8,14,23,914,372,1286,1496
0132-000,2011,8,14,24,394,288,682,1286
0132-000,2011,8,15,1,228,194,422,682
0132-000,2011,8,15,2,114,139,253,422
0132-000,2011,8,15,3,91,88,179,253
0132-000,2011,8,15,4,75,76,151,179
0132-000,2011,8,15,5,101,113,214,151
0132-000,2011,8,15,6,149,186,335,214
0132-000,2011,8,15,7,330,356,686,335
0132-000,2011,8,15,8,426,613,1039,686
0132-000,2011,8,15,9,510,589,1099,1039
0132-000,2011,8,15,10,576,667,1243,1099
0132-000,2011,8,15,11,691,766,1457,1243
0132-000,2011,8,15,12,1179,682,1861,1457
0132-000,2011,8,15,13,1278,669,1947,1861
0132-000,2011,8,15,14,1273,704,1977,1947
0132-000,2011,8,15,15,1351,706,2057,1977
0132-000,2011,8,15,16,1758,671,2429,2057
0132-000,2011,8,15,17,1888,693,2581,2429
0132-000,2011,8,15,18,1932,716,2648,2581
0132-000,2011,8,15,19,1744,675,2419,2648
0132-000,2011,8,15,20,1555,568,2123,2419
0132-000,2011,8,15,21,1410,529,1939,2123
0132-000,2011,8,15,22,884,470,1354,1939
0132-000,2011,8,15,23,538,332,870,1354
0132-000,2011,8,15,24,303,269,572,870
0132-000,2011,8,16,1,184,197,381,572
0132-000,2011,8,16,2,116,130,246,381
0132-000,2011,8,16,3,77,89,166,246
0132-000,2011,8,16,4,86,100,186,166
0132-000,2011,8,16,5,93,121,214,186
0132-000,2011,8,16,6,188,221,409,214
0132-000,2011,8,16,7,522,631,1153,409
0132-000,2011,8,16,8,791,1553,2344,1153
0132-000,2011,8,16,9,821,1261,2082,2344
0132-000,2011,8,16,10,849,949,1798,2082
0132-000,2011,8,16,11,810,946,1756,1798
0132-000,2011,8,16,12,876,932,1808,1756
0132-000,2011,8,16,13,836,907,1743,1808
0132-000,2011,8,16,14,902,922,1824,1743
0132-000,2011,8,16,15,1003,1014,2017,1824
0132-000,2011,8,16,16,968,854,1822,2017
0132-000,2011,8,16,17,1003,959,1962,1822
0132-000,2011,8,16,18,1220,824,2044,1962
0132-000,2011,8,16,19,1228,912,2140,2044
0132-000,2011,8,16,20,1002,724,1726,2140
0132-000,2011,8,16,21,754,612,1366,1726
0132-000,2011,8,16,22,678,531,1209,1366
0132-000,2011,8,16,23,375,348,723,1209
0132-000,2011,8,16,24,261,235,496,723
0132-000,2011,8,17,1,224,192,416,496
0132-000,2011,8,17,2,117,141,258,416
0132-000,2011,8,17,3,105,110,215,258
0132-000,2011,8,17,4,88,125,213,215
0132-000,2011,8,17,5,150,111,261,213
0132-000,2011,8,17,6,233,193,426,261
0132-000,2011,8,17,7,432,477,909,426
0132-000,2011,8,17,8,812,1242,2054,909
0132-000,2011,8,17,9,944,1092,2036,2054
0132-000,2011,8,17,10,882,951,1833,2036
0132-000,2011,8,17,11,855,917,1772,1833
0132-000,2011,8,17,12,857,916,1773,1772
0132-000,2011,8,17,13,790,856,1646,1773
0132-000,2011,8,17,14,885,940,1825,1646
0132-000,2011,8,17,15,1012,977,1989,1825
0132-000,2011,8,17,16,997,918,1915,1989
0132-000,2011,8,17,17,1040,927,1967,1915
0132-000,2011,8,17,18,1116,960,2076,1967
0132-000,2011,8,17,19,1251,994,2245,2076
0132-000,2011,8,17,20,988,777,1765,2245
0132-000,2011,8,17,21,783,640,1423,1765
0132-000,2011,8,17,22,594,550,1144,1423
0132-000,2011,8,17,23,433,395,828,1144
0132-000,2011,8,17,24,300,246,546,828
0132-000,2011,8,18,1,215,218,433,546
0132-000,2011,8,18,2,167,141,308,433
0132-000,2011,8,18,3,121,149,270,308
0132-000,2011,8,18,4,98,125,223,270
0132-000,2011,8,18,5,123,120,243,223
0132-000,2011,8,18,6,236,188,424,243
0132-000,2011,8,18,7,403,480,883,424
0132-000,2011,8,18,8,797,1231,2028,883
0132-000,2011,8,18,9,935,1140,2075,2028
0132-000,2011,8,18,10,847,980,1827,2075
0132-000,2011,8,18,11,823,904,1727,1827
0132-000,2011,8,18,12,905,874,1779,1727
0132-000,2011,8,18,13,829,823,1652,1779
0132-000,2011,8,18,14,888,919,1807,1652
0132-000,2011,8,18,15,974,978,1952,1807
0132-000,2011,8,18,16,1080,977,2057,1952
0132-000,2011,8,18,17,1045,888,1933,2057
0132-000,2011,8,18,18,1152,908,2060,1933
0132-000,2011,8,18,19,1161,961,2122,2060
0132-000,2011,8,18,20,1011,759,1770,2122
0132-000,2011,8,18,21,841,619,1460,1770
0132-000,2011,8,18,22,604,511,1115,1460
0132-000,2011,8,18,23,453,385,838,1115
0132-000,2011,8,18,24,308,273,581,838
0132-000,2011,8,19,1,204,240,444,581
0132-000,2011,8,19,2,170,148,318,444
0132-000,2011,8,19,3,112,131,243,318
0132-000,2011,8,19,4,104,121,225,243
0132-000,2011,8,19,5,135,113,248,225
0132-000,2011,8,19,6,181,177,358,248
0132-000,2011,8,19,7,337,381,718,358
0132-000,2011,8,19,8,763,1096,1859,718
0132-000,2011,8,19,9,880,1032,1912,1859
0132-000,2011,8,19,10,831,967,1798,1912
0132-000,2011,8,19,11,826,868,1694,1798
0132-000,2011,8,19,12,832,841,1673,1694
0132-000,2011,8,19,13,725,820,1545,1673
0132-000,2011,8,19,14,885,867,1752,1545
0132-000,2011,8,19,15,867,909,1776,1752
0132-000,2011,8,19,16,1028,923,1951,1776
0132-000,2011,8,19,17,959,845,1804,1951
0132-000,2011,8,19,18,1198,888,2086,1804
0132-000,2011,8,19,19,1296,983,2279,2086
0132-000,2011,8,19,20,980,830,1810,2279
0132-000,2011,8,19,21,776,641,1417,1810
0132-000,2011,8,19,22,581,603,1184,1417
0132-000,2011,8,19,23,435,430,865,1184
0132-000,2011,8,19,24,282,275,557,865
0132-000,2011,8,20,1,240,231,471,557
0132-000,2011,8,20,2,160,174,334,471
0132-000,2011,8,20,3,119,129,248,334
0132-000,2011,8,20,4,125,127,252,248
0132-000,2011,8,20,5,144,145,289,252
0132-000,2011,8,20,6,199,185,384,289
0132-000,2011,8,20,7,322,327,649,384
0132-000,2011,8,20,8,522,721,1243,649
0132-000,2011,8,20,9,703,837,1540,1243
0132-000,2011,8,20,10,773,839,1612,1540
0132-000,2011,8,20,11,812,898,1710,1612
0132-000,2011,8,20,12,856,954,1810,1710
0132-000,2011,8,20,13,759,1085,1844,1810
0132-000,2011,8,20,14,891,1137,2028,1844
0132-000,2011,8,20,15,915,1276,2191,2028
0132-000,2011,8,20,16,1043,1277,2320,2191
0132-000,2011,8,20,17,1057,1282,2339,2320
0132-000,2011,8,20,18,1102,1139,2241,2339
0132-000,2011,8,20,19,1085,1109,2194,2241
0132-000,2011,8,20,20,779,817,1596,2194
0132-000,2011,8,20,21,615,540,1155,1596
0132-000,2011,8,20,22,443,484,927,1155
0132-000,2011,8,20,23,367,374,741,927
0132-000,2011,8,20,24,323,323,646,741
0132-000,2011,8,21,1,202,253,455,646
0132-000,2011,8,21,2,174,158,332,455
0132-000,2011,8,21,3,140,123,263,332
0132-000,2011,8,21,4,124,93,217,263
0132-000,2011,8,21,5,110,108,218,217
0132-000,2011,8,21,6,151,149,300,218
0132-000,2011,8,21,7,231,300,531,300
0132-000,2011,8,21,8,338,478,816,531
0132-000,2011,8,21,9,436,590,1026,816
0132-000,2011,8,21,10,503,638,1141,1026
0132-000,2011,8,21,11,526,659,1185,1141
0132-000,2011,8,21,12,630,653,1283,1185
0132-000,2011,8,21,13,606,693,1299,1283
0132-000,2011,8,21,14,748,748,1496,1299
0132-000,2011,8,21,15,874,716,1590,1496
0132-000,2011,8,21,16,1240,763,2003,1590
0132-000,2011,8,21,17,1428,785,2213,2003
0132-000,2011,8,21,18,1440,741,2181,2213
0132-000,2011,8,21,19,1590,735,2325,2181
0132-000,2011,8,21,20,1509,636,2145,2325
0132-000,2011,8,21,21,1468,569,2037,2145
0132-000,2011,8,21,22,1008,549,1557,2037
0132-000,2011,8,21,23,668,375,1043,1557
0132-000,2011,8,21,24,351,284,635,1043
0132-000,2011,8,22,1,226,178,404,635
0132-000,2011,8,22,2,145,117,262,404
0132-000,2011,8,22,3,86,83,169,262
0132-000,2011,8,22,4,74,84,158,169
0132-000,2011,8,22,5,105,113,218,158
0132-000,2011,8,22,6,231,226,457,218
0132-000,2011,8,22,7,464,670,1134,457
0132-000,2011,8,22,8,789,1331,2120,1134
0132-000,2011,8,22,9,862,1081,1943,2120
0132-000,2011,8,22,10,805,862,1667,1943
0132-000,2011,8,22,11,801,924,1725,1667
0132-000,2011,8,22,12,836,879,1715,1725
0132-000,2011,8,22,13,758,871,1629,1715
0132-000,2011,8,22,14,816,906,1722,1629
0132-000,2011,8,22,15,909,945,1854,1722
0132-000,2011,8,22,16,970,925,1895,1854
0132-000,2011,8,22,17,985,873,1858,1895
0132-000,2011,8,22,18,1050,848,1898,1858
0132-000,2011,8,22,19,1076,841,1917,1898
0132-000,2011,8,22,20,954,737,1691,1917
0132-000,2011,8,22,21,813,573,1386,1691
0132-000,2011,8,22,22,558,489,1047,1386
0132-000,2011,8,22,23,412,369,781,1047
0132-000,2011,8,22,24,259,251,510,781
0132-000,2011,8,23,1,0,0,0,510
0132-000,2011,8,23,2,0,0,0,0
0132-000,2011,8,23,3,0,0,0,0
0132-000,2011,8,23,4,0,0,0,0
0132-000,2011,8,23,5,0,0,0,0
0132-000,2011,8,23,6,230,168,398,0
0132-000,2011,8,23,7,419,520,939,398
0132-000,2011,8,23,8,879,1317,2196,939
0132-000,2011,8,23,9,942,1315,2257,2196
0132-000,2011,8,23,10,968,1084,2052,2257
0132-000,2011,8,23,11,904,974,1878,2052
0132-000,2011,8,23,12,913,902,1815,1878
0132-000,2011,8,23,13,826,854,1680,1815
0132-000,2011,8,23,14,950,1015,1965,1680
0132-000,2011,8,23,15,1092,962,2054,1965
0132-000,2011,8,23,16,1090,958,2048,2054
0132-000,2011,8,23,17,1178,960,2138,2048
0132-000,2011,8,23,18,1213,932,2145,2138
0132-000,2011,8,23,19,1269,983,2252,2145
0132-000,2011,8,23,20,1077,752,1829,2252
0132-000,2011,8,23,21,900,645,1545,1829
0132-000,2011,8,23,22,655,566,1221,1545
0132-000,2011,8,23,23,460,400,860,1221
0132-000,2011,8,23,24,296,276,572,860
0132-000,2011,8,24,1,228,194,422,572
0132-000,2011,8,24,2,136,146,282,422
0132-000,2011,8,24,3,102,135,237,282
0132-000,2011,8,24,4,121,134,255,237
0132-000,2011,8,24,5,136,128,264,255
0132-000,2011,8,24,6,242,207,449,264
0132-000,2011,8,24,7,446,486,932,449
0132-000,2011,8,24,8,882,1324,2206,932
0132-000,2011,8,24,9,996,1225,2221,2206
0132-000,2011,8,24,10,923,1006,1929,2221
0132-000,2011,8,24,11,954,987,1941,1929
0132-000,2011,8,24,12,906,904,1810,1941
0132-000,2011,8,24,13,828,886,1714,1810
0132-000,2011,8,24,14,947,1033,1980,1714
0132-000,2011,8,24,15,1038,958,1996,1980
0132-000,2011,8,24,16,1060,994,2054,1996
0132-000,2011,8,24,17,1126,887,2013,2054
0132-000,2011,8,24,18,1231,922,2153,2013
0132-000,2011,8,24,19,1272,954,2226,2153
0132-000,2011,8,24,20,1057,794,1851,2226
0132-000,2011,8,24,21,819,638,1457,1851
0132-000,2011,8,24,22,645,593,1238,1457
0132-000,2011,8,24,23,428,406,834,1238
0132-000,2011,8,24,24,330,302,632,834
0132-000,2011,8,25,1,224,224,448,632
0132-000,2011,8,25,2,136,121,257,448
0132-000,2011,8,25,3,120,129,249,257
0132-000,2011,8,25,4,117,139,256,249
0132-000,2011,8,25,5,155,145,300,256
0132-000,2011,8,25,6,223,215,438,300
0132-000,2011,8,25,7,454,518,972,438
0132-000,2011,8,25,8,898,1293,2191,972
0132-000,2011,8,25,9,987,1290,2277,2191
0132-000,2011,8,25,10,919,943,1862,2277
0132-000,2011,8,25,11,883,1005,1888,1862
0132-000,2011,8,25,12,956,923,1879,1888
0132-000,2011,8,25,13,771,888,1659,1879
0132-000,2011,8,25,14,982,990,1972,1659
0132-000,2011,8,25,15,1028,1025,2053,1972
0132-000,2011,8,25,16,1087,994,2081,2053
0132-000,2011,8,25,17,1177,916,2093,2081
0132-000,2011,8,25,18,1201,981,2182,2093
0132-000,2011,8,25,19,1200,1005,2205,2182
0132-000,2011,8,25,20,1037,869,1906,2205
0132-000,2011,8,25,21,920,656,1576,1906
0132-000,2011,8,25,22,675,527,1202,1576
0132-000,2011,8,25,23,463,402,865,1202
0132-000,2011,8,25,24,347,285,632,865
0132-000,2011,8,26,1,242,232,474,632
0132-000,2011,8,26,2,146,176,322,474
0132-000,2011,8,26,3,132,139,271,322
0132-000,2011,8,26,4,108,132,240,271
0132-000,2011,8,26,5,159,145,304,240
0132-000,2011,8,26,6,222,184,406,304
0132-000,2011,8,26,7,418,528,946,406
0132-000,2011,8,26,8,885,1286,2171,946
0132-000,2011,8,26,9,1007,1215,2222,2171
0132-000,2011,8,26,10,1017,928,1945,2222
0132-000,2011,8,26,11,914,1008,1922,1945
0132-000,2011,8,26,12,976,990,1966,1922
0132-000,2011,8,26,13,869,917,1786,1966
0132-000,2011,8,26,14,1031,941,1972,1786
0132-000,2011,8,26,15,1074,1000,2074,1972
0132-000,2011,8,26,16,1148,1025,2173,2074
0132-000,2011,8,26,17,1155,1022,2177,2173
0132-000,2011,8,26,18,1361,1003,2364,2177
0132-000,2011,8,26,19,1454,1080,2534,2364
0132-000,2011,8,26,20,1194,895,2089,2534
0132-000,2011,8,26,21,1031,681,1712,2089
0132-000,2011,8,26,22,810,633,1443,1712
0132-000,2011,8,26,23,449,438,887,1443
0132-000,2011,8,26,24,364,291,655,887
0132-000,2011,8,27,1,235,266,501,655
0132-000,2011,8,27,2,192,213,405,501
0132-000,2011,8,27,3,130,148,278,405
0132-000,2011,8,27,4,112,158,270,278
0132-000,2011,8,27,5,186,156,342,270
0132-000,2011,8,27,6,210,226,436,342
0132-000,2011,8,27,7,396,437,833,436
0132-000,2011,8,27,8,640,892,1532,833
0132-000,2011,8,27,9,809,1025,1834,1532
0132-000,2011,8,27,10,794,1016,1810,1834
0132-000,2011,8,27,11,849,1000,1849,1810
0132-000,2011,8,27,12,849,1070,1919,1849
0132-000,2011,8,27,13,909,1130,2039,1919
0132-000,2011,8,27,14,955,1238,2193,2039
0132-000,2011,8,27,15,1012,1331,2343,2193
0132-000,2011,8,27,16,1054,1391,2445,2343
0132-000,2011,8,27,17,1195,1402,2597,2445
0132-000,2011,8,27,18,1530,1433,2963,2597
0132-000,2011,8,27,19,1531,1386,2917,2963
0132-000,2011,8,27,20,1250,1224,2474,2917
0132-000,2011,8,27,21,984,934,1918,2474
0132-000,2011,8,27,22,706,758,1464,1918
0132-000,2011,8,27,23,477,563,1040,1464
0132-000,2011,8,27,24,323,334,657,1040
0132-000,2011,8,28,1,245,237,482,657
0132-000,2011,8,28,2,168,168,336,482
0132-000,2011,8,28,3,119,163,282,336
0132-000,2011,8,28,4,122,120,242,282
0132-000,2011,8,28,5,119,110,229,242
0132-000,2011,8,28,6,172,192,364,229
0132-000,2011,8,28,7,274,396,670,364
0132-000,2011,8,28,8,378,699,1077,670
0132-000,2011,8,28,9,464,922,1386,1077
0132-000,2011,8,28,10,554,1009,1563,1386
0132-000,2011,8,28,11,662,1048,1710,1563
0132-000,2011,8,28,12,698,927,1625,1710
0132-000,2011,8,28,13,792,762,1554,1625
0132-000,2011,8,28,14,1002,700,1702,1554
0132-000,2011,8,28,15,1612,739,2351,1702
0132-000,2011,8,28,16,1733,762,2495,2351
0132-000,2011,8,28,17,1857,733,2590,2495
0132-000,2011,8,28,18,1952,697,2649,2590
0132-000,2011,8,28,19,2017,649,2666,2649
0132-000,2011,8,28,20,1922,625,2547,2666
0132-000,2011,8,28,21,1873,528,2401,2547
0132-000,2011,8,28,22,1802,510,2312,2401
0132-000,2011,8,28,23,1615,442,2057,2312
0132-000,2011,8,28,24,1505,289,1794,2057
0132-000,2011,8,29,1,921,192,1113,1794
0132-000,2011,8,29,2,182,143,325,1113
0132-000,2011,8,29,3,89,99,188,325
0132-000,2011,8,29,4,88,98,186,188
0132-000,2011,8,29,5,129,124,253,186
0132-000,2011,8,29,6,220,204,424,253
0132-000,2011,8,29,7,482,599,1081,424
0132-000,2011,8,29,8,905,1499,2404,1081
0132-000,2011,8,29,9,922,1270,2192,2404
0132-000,2011,8,29,10,820,896,1716,2192
0132-000,2011,8,29,11,891,930,1821,1716
0132-000,2011,8,29,12,836,1047,1883,1821
0132-000,2011,8,29,13,763,956,1719,1883
0132-000,2011,8,29,14,950,1076,2026,1719
0132-000,2011,8,29,15,966,1154,2120,2026
0132-000,2011,8,29,16,1050,897,1947,2120
0132-000,2011,8,29,17,1075,964,2039,1947
0132-000,2011,8,29,18,1182,890,2072,2039
0132-000,2011,8,29,19,1178,896,2074,2072
0132-000,2011,8,29,20,900,747,1647,2074
0132-000,2011,8,29,21,754,558,1312,1647
0132-000,2011,8,29,22,615,478,1093,1312
0132-000,2011,8,29,23,401,372,773,1093
0132-000,2011,8,29,24,286,237,523,773
0132-000,2011,8,30,1,187,170,357,523
0132-000,2011,8,30,2,114,116,230,357
0132-000,2011,8,30,3,100,111,211,230
0132-000,2011,8,30,4,88,108,196,211
0132-000,2011,8,30,5,138,120,258,196
0132-000,2011,8,30,6,183,166,349,258
0132-000,2011,8,30,7,358,400,758,349
0132-000,2011,8,30,8,807,1312,2119,758
0132-000,2011,8,30,9,930,1274,2204,2119
0132-000,2011,8,30,10,840,930,1770,2204
0132-000,2011,8,30,11,824,899,1723,1770
0132-000,2011,8,30,12,838,892,1730,1723
0132-000,2011,8,30,13,803,845,1648,1730
0132-000,2011,8,30,14,1002,930,1932,1648
0132-000,2011,8,30,15,1032,1033,2065,1932
0132-000,2011,8,30,16,1058,980,2038,2065
0132-000,2011,8,30,17,1080,909,1989,2038
0132-000,2011,8,30,18,1157,937,2094,1989
0132-000,2011,8,30,19,1200,1034,2234,2094
0132-000,2011,8,30,20,1034,705,1739,2234
0132-000,2011,8,30,21,912,629,1541,1739
0132-000,2011,8,30,22,691,554,1245,1541
0132-000,2011,8,30,23,449,401,850,1245
0132-000,2011,8,30,24,303,300,603,850
0132-000,2011,8,31,1,227,209,436,603
0132-000,2011,8,31,2,135,139,274,436
0132-000,2011,8,31,3,113,117,230,274
0132-000,2011,8,31,4,104,118,222,230
0132-000,2011,8,31,5,129,140,269,222
0132-000,2011,8,31,6,203,191,394,269
0132-000,2011,8,31,7,393,480,873,394
0132-000,2011,8,31,8,802,1349,2151,873
0132-000,2011,8,31,9,948,1220,2168,2151
0132-000,2011,8,31,10,910,1068,1978,2168
0132-000,2011,8,31,11,953,1030,1983,1978
0132-000,2011,8,31,12,963,925,1888,1983
0132-000,2011,8,31,13,839,865,1704,1888
0132-000,2011,8,31,14,973,969,1942,1704
0132-000,2011,8,31,15,1048,987,2035,1942
0132-000,2011,8,31,16,1172,988,2160,2035
0132-000,2011,8,31,17,1092,964,2056,2160
0132-000,2011,8,31,18,1291,938,2229,2056
0132-000,2011,8,31,19,1270,1019,2289,2229
0132-000,2011,8,31,20,1029,783,1812,2289
0132-000,2011,8,31,21,863,598,1461,1812
0132-000,2011,8,31,22,673,545,1218,1461
0132-000,2011,8,31,23,461,400,861,1218
0132-000,2011,8,31,24,325,263,588,861
0132-000,2011,9,1,1,213,230,443,588
0132-000,2011,9,1,2,141,144,285,443
0132-000,2011,9,1,3,122,128,250,285
0132-000,2011,9,1,4,94,125,219,250
0132-000,2011,9,1,5,128,174,302,219
0132-000,2011,9,1,6,244,192,436,302
0132-000,2011,9,1,7,400,513,913,436
0132-000,2011,9,1,8,899,1346,2245,913
0132-000,2011,9,1,9,987,1337,2324,2245
0132-000,2011,9,1,10,871,1017,1888,2324
0132-000,2011,9,1,11,921,977,1898,1888
0132-000,2011,9,1,12,898,1030,1928,1898
0132-000,2011,9,1,13,841,880,1721,1928
0132-000,2011,9,1,14,925,998,1923,1721
0132-000,2011,9,1,15,1064,1060,2124,1923
0132-000,2011,9,1,16,1143,954,2097,2124
0132-000,2011,9,1,17,1139,938,2077,2097
0132-000,2011,9,1,18,1229,914,2143,2077
0132-000,2011,9,1,19,1220,967,2187,2143
0132-000,2011,9,1,20,1046,791,1837,2187
0132-000,2011,9,1,21,877,622,1499,1837
0132-000,2011,9,1,22,719,539,1258,1499
0132-000,2011,9,1,23,458,369,827,1258
0132-000,2011,9,1,24,313,303,616,827
0132-000,2011,9,2,1,245,237,482,616
0132-000,2011,9,2,2,175,147,322,482
0132-000,2011,9,2,3,125,134,259,322
0132-000,2011,9,2,4,102,118,220,259
0132-000,2011,9,2,5,134,149,283,220
0132-000,2011,9,2,6,222,214,436,283
0132-000,2011,9,2,7,398,513,911,436
0132-000,2011,9,2,8,883,1298,2181,911
0132-000,2011,9,2,9,1015,1300,2315,2181
0132-000,2011,9,2,10,964,1033,1997,2315
0132-000,2011,9,2,11,943,1000,1943,1997
0132-000,2011,9,2,12,904,921,1825,1943
0132-000,2011,9,2,13,833,926,1759,1825
0132-000,2011,9,2,14,1010,976,1986,1759
0132-000,2011,9,2,15,1152,1008,2160,1986
0132-000,2011,9,2,16,1114,997,2111,2160
0132-000,2011,9,2,17,1164,904,2068,2111
0132-000,2011,9,2,18,1305,989,2294,2068
0132-000,2011,9,2,19,1436,1082,2518,2294
0132-000,2011,9,2,20,1137,912,2049,2518
0132-000,2011,9,2,21,933,716,1649,2049
0132-000,2011,9,2,22,762,593,1355,1649
0132-000,2011,9,2,23,532,474,1006,1355
0132-000,2011,9,2,24,372,340,712,1006
0132-000,2011,9,3,1,257,289,546,712
0132-000,2011,9,3,2,213,214,427,546
0132-000,2011,9,3,3,149,146,295,427
0132-000,2011,9,3,4,140,163,303,295
0132-000,2011,9,3,5,167,179,346,303
0132-000,2011,9,3,6,224,220,444,346
0132-000,2011,9,3,7,396,469,865,444
0132-000,2011,9,3,8,680,902,1582,865
0132-000,2011,9,3,9,812,1003,1815,1582
0132-000,2011,9,3,10,852,965,1817,1815
0132-000,2011,9,3,11,912,1056,1968,1817
0132-000,2011,9,3,12,928,1022,1950,1968
0132-000,2011,9,3,13,959,1036,1995,1950
0132-000,2011,9,3,14,1126,1051,2177,1995
0132-000,2011,9,3,15,1067,990,2057,2177
0132-000,2011,9,3,16,1151,967,2118,2057
0132-000,2011,9,3,17,1191,1010,2201,2118
0132-000,2011,9,3,18,1775,1001,2776,2201
0132-000,2011,9,3,19,1771,964,2735,2776
0132-000,2011,9,3,20,1454,789,2243,2735
0132-000,2011,9,3,21,884,687,1571,2243
0132-000,2011,9,3,22,604,560,1164,1571
0132-000,2011,9,3,23,447,478,925,1164
0132-000,2011,9,3,24,297,302,599,925
0132-000,2011,9,4,1,211,227,438,599
0132-000,2011,9,4,2,173,188,361,438
0132-000,2011,9,4,3,146,147,293,361
0132-000,2011,9,4,4,108,111,219,293
0132-000,2011,9,4,5,125,116,241,219
0132-000,2011,9,4,6,146,152,298,241
0132-000,2011,9,4,7,276,371,647,298
0132-000,2011,9,4,8,402,565,967,647
0132-000,2011,9,4,9,466,693,1159,967
0132-000,2011,9,4,10,575,634,1209,1159
0132-000,2011,9,4,11,663,750,1413,1209
0132-000,2011,9,4,12,664,702,1366,1413
0132-000,2011,9,4,13,735,681,1416,1366
0132-000,2011,9,4,14,797,668,1465,1416
0132-000,2011,9,4,15,957,711,1668,1465
0132-000,2011,9,4,16,1222,743,1965,1668
0132-000,2011,9,4,17,1205,837,2042,1965
0132-000,2011,9,4,18,1406,753,2159,2042
0132-000,2011,9,4,19,1282,713,1995,2159
0132-000,2011,9,4,20,974,615,1589,1995
0132-000,2011,9,4,21,813,559,1372,1589
0132-000,2011,9,4,22,623,526,1149,1372
0132-000,2011,9,4,23,389,395,784,1149
0132-000,2011,9,4,24,259,287,546,784
0132-000,2011,9,5,1,157,151,308,546
0132-000,2011,9,5,2,97,115,212,308
0132-000,2011,9,5,3,104,90,194,212
0132-000,2011,9,5,4,49,97,146,194
0132-000,2011,9,5,5,97,134,231,146
0132-000,2011,9,5,6,230,246,476,231
0132-000,2011,9,5,7,497,732,1229,476
0132-000,2011,9,5,8,1015,1592,2607,1229
0132-000,2011,9,5,9,959,1394,2353,2607
0132-000,2011,9,5,10,942,1035,1977,2353
0132-000,2011,9,5,11,908,1031,1939,1977
0132-000,2011,9,5,12,948,955,1903,1939
0132-000,2011,9,5,13,883,995,1878,1903
0132-000,2011,9,5,14,1029,1063,2092,1878
0132-000,2011,9,5,15,1214,1088,2302,2092
0132-000,2011,9,5,16,1155,1129,2284,2302
0132-000,2011,9,5,17,1225,955,2180,2284
0132-000,2011,9,5,18,1281,945,2226,2180
0132-000,2011,9,5,19,1292,973,2265,2226
0132-000,2011,9,5,20,1079,812,1891,2265
0132-000,2011,9,5,21,886,651,1537,1891
0132-000,2011,9,5,22,698,567,1265,1537
0132-000,2011,9,5,23,432,386,818,1265
0132-000,2011,9,5,24,327,253,580,818
0132-000,2011,9,6,1,176,202,378,580
0132-000,2011,9,6,2,135,138,273,378
0132-000,2011,9,6,3,127,129,256,273
0132-000,2011,9,6,4,113,127,240,256
0132-000,2011,9,6,5,121,132,253,240
0132-000,2011,9,6,6,246,185,431,253
0132-000,2011,9,6,7,444,526,970,431
0132-000,2011,9,6,8,897,1365,2262,970
0132-000,2011,9,6,9,964,1282,2246,2262
0132-000,2011,9,6,10,996,1107,2103,2246
0132-000,2011,9,6,11,949,1037,1986,2103
0132-000,2011,9,6,12,993,957,1950,1986
0132-000,2011,9,6,13,886,911,1797,1950
0132-000,2011,9,6,14,995,1033,2028,1797
0132-000,2011,9,6,15,1090,1139,2229,2028
0132-000,2011,9,6,16,1189,1057,2246,2229
0132-000,2011,9,6,17,1156,974,2130,2246
0132-000,2011,9,6,18,1326,1010,2336,2130
0132-000,2011,9,6,19,1382,1011,2393,2336
0132-000,2011,9,6,20,1109,833,1942,2393
0132-000,2011,9,6,21,937,629,1566,1942
0132-000,2011,9,6,22,732,571,1303,1566
0132-000,2011,9,6,23,468,405,873,1303
0132-000,2011,9,6,24,326,315,641,873
0132-000,2011,9,7,1,221,232,453,641
0132-000,2011,9,7,2,143,147,290,453
0132-000,2011,9,7,3,121,124,245,290
0132-000,2011,9,7,4,91,133,224,245
0132-000,2011,9,7,5,141,154,295,224
0132-000,2011,9,7,6,242,186,428,295
0132-000,2011,9,7,7,381,472,853,428
0132-000,2011,9,7,8,914,1367,2281,853
0132-000,2011,9,7,9,962,1263,2225,2281
0132-000,2011,9,7,10,985,1153,2138,2225
0132-000,2011,9,7,11,1000,999,1999,2138
0132-000,2011,9,7,12,1019,1028,2047,1999
0132-000,2011,9,7,13,915,967,1882,2047
0132-000,2011,9,7,14,1116,1069,2185,1882
0132-000,2011,9,7,15,1156,1128,2284,2185
0132-000,2011,9,7,16,1227,1012,2239,2284
0132-000,2011,9,7,17,1329,983,2312,2239
0132-000,2011,9,7,18,1349,996,2345,2312
0132-000,2011,9,7,19,1347,1031,2378,2345
0132-000,2011,9,7,20,1151,886,2037,2378
0132-000,2011,9,7,21,853,660,1513,2037
0132-000,2011,9,7,22,732,602,1334,1513
0132-000,2011,9,7,23,523,464,987,1334
0132-000,2011,9,7,24,372,349,721,987
0132-000,2011,9,8,1,263,241,504,721
0132-000,2011,9,8,2,163,172,335,504
0132-000,2011,9,8,3,144,171,315,335
0132-000,2011,9,8,4,106,146,252,315
0132-000,2011,9,8,5,142,152,294,252
0132-000,2011,9,8,6,203,202,405,294
0132-000,2011,9,8,7,436,530,966,405
0132-000,2011,9,8,8,851,1326,2177,966
0132-000,2011,9,8,9,1002,1385,2387,2177
0132-000,2011,9,8,10,985,1181,2166,2387
0132-000,2011,9,8,11,1039,1071,2110,2166
0132-000,2011,9,8,12,1071,1036,2107,2110
0132-000,2011,9,8,13,959,936,1895,2107
0132-000,2011,9,8,14,1106,1111,2217,1895
0132-000,2011,9,8,15,1181,1096,2277,2217
0132-000,2011,9,8,16,1373,1086,2459,2277
0132-000,2011,9,8,17,1406,1209,2615,2459
0132-000,2011,9,8,18,1432,1242,2674,2615
0132-000,2011,9,8,19,1442,1151,2593,2674
0132-000,2011,9,8,20,1264,968,2232,2593
0132-000,2011,9,8,21,919,720,1639,2232
0132-000,2011,9,8,22,778,624,1402,1639
0132-000,2011,9,8,23,490,457,947,1402
0132-000,2011,9,8,24,348,348,696,947
0132-000,2011,9,9,1,263,241,504,696
0132-000,2011,9,9,2,163,172,335,504
0132-000,2011,9,9,3,144,171,315,335
0132-000,2011,9,9,4,106,146,252,315
0132-000,2011,9,9,5,142,152,294,252
0132-000,2011,9,9,6,203,202,405,294
0132-000,2011,9,9,7,436,530,966,405
0132-000,2011,9,9,8,851,1326,2177,966
0132-000,2011,9,9,9,1002,1385,2387,2177
0132-000,2011,9,9,10,985,1181,2166,2387
0132-000,2011,9,9,11,1039,1071,2110,2166
0132-000,2011,9,9,12,1071,1036,2107,2110
0132-000,2011,9,9,13,959,936,1895,2107
0132-000,2011,9,9,14,1106,1111,2217,1895
0132-000,2011,9,9,15,1181,1096,2277,2217
0132-000,2011,9,9,16,1373,1086,2459,2277
0132-000,2011,9,9,17,1406,1209,2615,2459
0132-000,2011,9,9,18,1432,1242,2674,2615
0132-000,2011,9,9,19,1442,1151,2593,2674
0132-000,2011,9,9,20,1264,968,2232,2593
0132-000,2011,9,9,21,919,720,1639,2232
0132-000,2011,9,9,22,778,624,1402,1639
0132-000,2011,9,9,23,490,457,947,1402
0132-000,2011,9,9,24,348,348,696,947
0132-000,2011,9,10,1,264,272,536,696
0132-000,2011,9,10,2,165,203,368,536
0132-000,2011,9,10,3,122,160,282,368
0132-000,2011,9,10,4,120,130,250,282
0132-000,2011,9,10,5,133,158,291,250
0132-000,2011,9,10,6,191,170,361,291
0132-000,2011,9,10,7,382,448,830,361
0132-000,2011,9,10,8,782,1191,1973,830
0132-000,2011,9,10,9,853,1161,2014,1973
0132-000,2011,9,10,10,879,1017,1896,2014
0132-000,2011,9,10,11,913,1102,2015,1896
0132-000,2011,9,10,12,998,1053,2051,2015
0132-000,2011,9,10,13,935,1253,2188,2051
0132-000,2011,9,10,14,1003,1452,2455,2188
0132-000,2011,9,10,15,1093,1743,2836,2455
0132-000,2011,9,10,16,1197,1722,2919,2836
0132-000,2011,9,10,17,1230,1947,3177,2919
0132-000,2011,9,10,18,1224,2091,3315,3177
0132-000,2011,9,10,19,1228,2094,3322,3315
0132-000,2011,9,10,20,924,1868,2792,3322
0132-000,2011,9,10,21,707,1886,2593,2792
0132-000,2011,9,10,22,574,1743,2317,2593
0132-000,2011,9,10,23,375,1671,2046,2317
0132-000,2011,9,10,24,330,1622,1952,2046
0132-000,2011,9,11,1,210,1377,1587,1952
0132-000,2011,9,11,2,143,1445,1588,1587
0132-000,2011,9,11,3,134,1258,1392,1588
0132-000,2011,9,11,4,118,1155,1273,1392
0132-000,2011,9,11,5,119,1510,1629,1273
0132-000,2011,9,11,6,133,1807,1940,1629
0132-000,2011,9,11,7,197,2123,2320,1940
0132-000,2011,9,11,8,299,1913,2212,2320
0132-000,2011,9,11,9,398,1839,2237,2212
0132-000,2011,9,11,10,669,1891,2560,2237
0132-000,2011,9,11,11,766,1857,2623,2560
0132-000,2011,9,11,12,738,1808,2546,2623
0132-000,2011,9,11,13,678,1339,2017,2546
0132-000,2011,9,11,14,654,1012,1666,2017
0132-000,2011,9,11,15,616,710,1326,1666
0132-000,2011,9,11,16,588,670,1258,1326
0132-000,2011,9,11,17,573,607,1180,1258
0132-000,2011,9,11,18,573,533,1106,1180
0132-000,2011,9,11,19,523,515,1038,1106
0132-000,2011,9,11,20,497,462,959,1038
0132-000,2011,9,11,21,417,449,866,959
0132-000,2011,9,11,22,316,333,649,866
0132-000,2011,9,11,23,263,296,559,649
0132-000,2011,9,11,24,164,232,396,559
0132-000,2011,9,12,1,132,148,280,396
0132-000,2011,9,12,2,95,114,209,280
0132-000,2011,9,12,3,66,80,146,209
0132-000,2011,9,12,4,70,75,145,146
0132-000,2011,9,12,5,80,65,145,145
0132-000,2011,9,12,6,129,131,260,145
0132-000,2011,9,12,7,309,421,730,260
0132-000,2011,9,12,8,462,791,1253,730
0132-000,2011,9,12,9,430,695,1125,1253
0132-000,2011,9,12,10,627,786,1413,1125
0132-000,2011,9,12,11,1371,1033,2404,1413
0132-000,2011,9,12,12,1858,1136,2994,2404
0132-000,2011,9,12,13,1926,1193,3119,2994
0132-000,2011,9,12,14,2013,1402,3415,3119
0132-000,2011,9,12,15,2001,1488,3489,3415
0132-000,2011,9,12,16,2011,1562,3573,3489
0132-000,2011,9,12,17,1979,1593,3572,3573
0132-000,2011,9,12,18,1995,1343,3338,3572
0132-000,2011,9,12,19,1894,1264,3158,3338
0132-000,2011,9,12,20,1820,821,2641,3158
0132-000,2011,9,12,21,1711,621,2332,2641
0132-000,2011,9,12,22,1609,411,2020,2332
0132-000,2011,9,12,23,1140,353,1493,2020
0132-000,2011,9,12,24,848,299,1147,1493
0132-000,2011,9,13,1,560,175,735,1147
0132-000,2011,9,13,2,573,119,692,735
0132-000,2011,9,13,3,440,93,533,692
0132-000,2011,9,13,4,249,96,345,533
0132-000,2011,9,13,5,213,60,273,345
0132-000,2011,9,13,6,250,73,323,273
0132-000,2011,9,13,7,312,135,447,323
0132-000,2011,9,13,8,626,206,832,447
0132-000,2011,9,13,9,679,270,949,832
0132-000,2011,9,13,10,620,375,995,949
0132-000,2011,9,13,11,757,497,1254,995
0132-000,2011,9,13,12,1064,605,1669,1254
0132-000,2011,9,13,13,1331,628,1959,1669
0132-000,2011,9,13,14,1549,607,2156,1959
0132-000,2011,9,13,15,1607,649,2256,2156
0132-000,2011,9,13,16,1593,624,2217,2256
0132-000,2011,9,13,17,1608,617,2225,2217
0132-000,2011,9,13,18,1640,648,2288,2225
0132-000,2011,9,13,19,1595,582,2177,2288
0132-000,2011,9,13,20,1265,524,1789,2177
0132-000,2011,9,13,21,1126,536,1662,1789
0132-000,2011,9,13,22,1055,485,1540,1662
0132-000,2011,9,13,23,772,334,1106,1540
0132-000,2011,9,13,24,891,249,1140,1106
0132-000,2011,9,14,1,645,181,826,1140
0132-000,2011,9,14,2,335,138,473,826
0132-000,2011,9,14,3,134,94,228,473
0132-000,2011,9,14,4,92,77,169,228
0132-000,2011,9,14,5,116,80,196,169
0132-000,2011,9,14,6,155,129,284,196
0132-000,2011,9,14,7,289,414,703,284
0132-000,2011,9,14,8,598,1043,1641,703
0132-000,2011,9,14,9,684,1016,1700,1641
0132-000,2011,9,14,10,755,792,1547,1700
0132-000,2011,9,14,11,823,829,1652,1547
0132-000,2011,9,14,12,848,784,1632,1652
0132-000,2011,9,14,13,1049,720,1769,1632
0132-000,2011,9,14,14,1063,810,1873,1769
0132-000,2011,9,14,15,1289,764,2053,1873
0132-000,2011,9,14,16,1573,825,2398,2053
0132-000,2011,9,14,17,1672,818,2490,2398
0132-000,2011,9,14,18,1710,779,2489,2490
0132-000,2011,9,14,19,1721,835,2556,2489
0132-000,2011,9,14,20,1601,719,2320,2556
0132-000,2011,9,14,21,1162,539,1701,2320
0132-000,2011,9,14,22,629,466,1095,1701
0132-000,2011,9,14,23,475,353,828,1095
0132-000,2011,9,14,24,262,218,480,828
0132-000,2011,9,15,1,190,201,391,480
0132-000,2011,9,15,2,142,160,302,391
0132-000,2011,9,15,3,107,120,227,302
0132-000,2011,9,15,4,96,121,217,227
0132-000,2011,9,15,5,148,148,296,217
0132-000,2011,9,15,6,189,214,403,296
0132-000,2011,9,15,7,415,509,924,403
0132-000,2011,9,15,8,865,1316,2181,924
0132-000,2011,9,15,9,963,1290,2253,2181
0132-000,2011,9,15,10,923,1088,2011,2253
0132-000,2011,9,15,11,869,1003,1872,2011
0132-000,2011,9,15,12,918,963,1881,1872
0132-000,2011,9,15,13,827,878,1705,1881
0132-000,2011,9,15,14,973,968,1941,1705
0132-000,2011,9,15,15,1075,1009,2084,1941
0132-000,2011,9,15,16,1122,923,2045,2084
0132-000,2011,9,15,17,1062,897,1959,2045
0132-000,2011,9,15,18,1195,856,2051,1959
0132-000,2011,9,15,19,1270,992,2262,2051
0132-000,2011,9,15,20,977,744,1721,2262
0132-000,2011,9,15,21,837,580,1417,1721
0132-000,2011,9,15,22,685,541,1226,1417
0132-000,2011,9,15,23,449,339,788,1226
0132-000,2011,9,15,24,299,275,574,788
0132-000,2011,9,16,1,204,197,401,574
0132-000,2011,9,16,2,154,146,300,401
0132-000,2011,9,16,3,120,132,252,300
0132-000,2011,9,16,4,99,123,222,252
0132-000,2011,9,16,5,123,133,256,222
0132-000,2011,9,16,6,211,207,418,256
0132-000,2011,9,16,7,409,455,864,418
0132-000,2011,9,16,8,885,1309,2194,864
0132-000,2011,9,16,9,1003,1219,2222,2194
0132-000,2011,9,16,10,887,1026,1913,2222
0132-000,2011,9,16,11,912,965,1877,1913
0132-000,2011,9,16,12,924,970,1894,1877
0132-000,2011,9,16,13,799,928,1727,1894
0132-000,2011,9,16,14,983,917,1900,1727
0132-000,2011,9,16,15,1067,996,2063,1900
0132-000,2011,9,16,16,1046,978,2024,2063
0132-000,2011,9,16,17,1133,894,2027,2024
0132-000,2011,9,16,18,1374,933,2307,2027
0132-000,2011,9,16,19,1479,1065,2544,2307
0132-000,2011,9,16,20,1094,779,1873,2544
0132-000,2011,9,16,21,863,629,1492,1873
0132-000,2011,9,16,22,728,562,1290,1492
0132-000,2011,9,16,23,490,429,919,1290
0132-000,2011,9,16,24,358,311,669,919
0132-000,2011,9,17,1,245,256,501,669
0132-000,2011,9,17,2,202,188,390,501
0132-000,2011,9,17,3,148,163,311,390
0132-000,2011,9,17,4,130,154,284,311
0132-000,2011,9,17,5,143,165,308,284
0132-000,2011,9,17,6,258,193,451,308
0132-000,2011,9,17,7,386,381,767,451
0132-000,2011,9,17,8,647,871,1518,767
0132-000,2011,9,17,9,847,958,1805,1518
0132-000,2011,9,17,10,802,892,1694,1805
0132-000,2011,9,17,11,846,880,1726,1694
0132-000,2011,9,17,12,848,805,1653,1726
0132-000,2011,9,17,13,1035,854,1889,1653
0132-000,2011,9,17,14,926,965,1891,1889
0132-000,2011,9,17,15,1000,856,1856,1891
0132-000,2011,9,17,16,1028,839,1867,1856
0132-000,2011,9,17,17,1142,922,2064,1867
0132-000,2011,9,17,18,1277,959,2236,2064
0132-000,2011,9,17,19,1250,961,2211,2236
0132-000,2011,9,17,20,865,735,1600,2211
0132-000,2011,9,17,21,586,573,1159,1600
0132-000,2011,9,17,22,449,458,907,1159
0132-000,2011,9,17,23,366,354,720,907
0132-000,2011,9,17,24,278,264,542,720
0132-000,2011,9,18,1,197,206,403,542
0132-000,2011,9,18,2,157,164,321,403
0132-000,2011,9,18,3,126,136,262,321
0132-000,2011,9,18,4,98,95,193,262
0132-000,2011,9,18,5,125,99,224,193
0132-000,2011,9,18,6,127,134,261,224
0132-000,2011,9,18,7,219,250,469,261
0132-000,2011,9,18,8,258,383,641,469
0132-000,2011,9,18,9,397,522,919,641
0132-000,2011,9,18,10,482,539,1021,919
0132-000,2011,9,18,11,581,681,1262,1021
0132-000,2011,9,18,12,593,649,1242,1262
0132-000,2011,9,18,13,630,699,1329,1242
0132-000,2011,9,18,14,680,684,1364,1329
0132-000,2011,9,18,15,787,723,1510,1364
0132-000,2011,9,18,16,842,714,1556,1510
0132-000,2011,9,18,17,980,727,1707,1556
0132-000,2011,9,18,18,1096,671,1767,1707
0132-000,2011,9,18,19,1148,684,1832,1767
0132-000,2011,9,18,20,887,540,1427,1832
0132-000,2011,9,18,21,682,489,1171,1427
0132-000,2011,9,18,22,497,466,963,1171
0132-000,2011,9,18,23,327,366,693,963
0132-000,2011,9,18,24,234,234,468,693
0132-000,2011,9,19,1,132,172,304,468
0132-000,2011,9,19,2,98,115,213,304
0132-000,2011,9,19,3,77,82,159,213
0132-000,2011,9,19,4,77,86,163,159
0132-000,2011,9,19,5,101,112,213,163
0132-000,2011,9,19,6,194,230,424,213
0132-000,2011,9,19,7,464,662,1126,424
0132-000,2011,9,19,8,906,1581,2487,1126
0132-000,2011,9,19,9,922,1353,2275,2487
0132-000,2011,9,19,10,845,979,1824,2275
0132-000,2011,9,19,11,861,1033,1894,1824
0132-000,2011,9,19,12,883,1008,1891,1894
0132-000,2011,9,19,13,799,961,1760,1891
0132-000,2011,9,19,14,978,1070,2048,1760
0132-000,2011,9,19,15,1016,1091,2107,2048
0132-000,2011,9,19,16,1068,933,2001,2107
0132-000,2011,9,19,17,1058,926,1984,2001
0132-000,2011,9,19,18,1190,923,2113,1984
0132-000,2011,9,19,19,1247,958,2205,2113
0132-000,2011,9,19,20,968,740,1708,2205
0132-000,2011,9,19,21,744,586,1330,1708
0132-000,2011,9,19,22,635,463,1098,1330
0132-000,2011,9,19,23,415,369,784,1098
0132-000,2011,9,19,24,273,222,495,784
0132-000,2011,9,20,1,180,228,408,495
0132-000,2011,9,20,2,126,105,231,408
0132-000,2011,9,20,3,117,100,217,231
0132-000,2011,9,20,4,88,104,192,217
0132-000,2011,9,20,5,113,135,248,192
0132-000,2011,9,20,6,185,189,374,248
0132-000,2011,9,20,7,415,472,887,374
0132-000,2011,9,20,8,844,1315,2159,887
0132-000,2011,9,20,9,908,1315,2223,2159
0132-000,2011,9,20,10,937,1119,2056,2223
0132-000,2011,9,20,11,953,1036,1989,2056
0132-000,2011,9,20,12,888,875,1763,1989
0132-000,2011,9,20,13,847,941,1788,1763
0132-000,2011,9,20,14,914,957,1871,1788
0132-000,2011,9,20,15,1102,977,2079,1871
0132-000,2011,9,20,16,1118,960,2078,2079
0132-000,2011,9,20,17,1068,881,1949,2078
0132-000,2011,9,20,18,1221,936,2157,1949
0132-000,2011,9,20,19,1218,976,2194,2157
0132-000,2011,9,20,20,959,741,1700,2194
0132-000,2011,9,20,21,791,591,1382,1700
0132-000,2011,9,20,22,637,525,1162,1382
0132-000,2011,9,20,23,441,375,816,1162
0132-000,2011,9,20,24,311,269,580,816
0132-000,2011,9,21,1,222,232,454,580
0132-000,2011,9,21,2,161,148,309,454
0132-000,2011,9,21,3,130,142,272,309
0132-000,2011,9,21,4,108,102,210,272
0132-000,2011,9,21,5,121,123,244,210
0132-000,2011,9,21,6,195,179,374,244
0132-000,2011,9,21,7,423,476,899,374
0132-000,2011,9,21,8,874,1293,2167,899
0132-000,2011,9,21,9,970,1270,2240,2167
0132-000,2011,9,21,10,892,1033,1925,2240
0132-000,2011,9,21,11,898,1020,1918,1925
0132-000,2011,9,21,12,906,975,1881,1918
0132-000,2011,9,21,13,826,948,1774,1881
0132-000,2011,9,21,14,967,974,1941,1774
0132-000,2011,9,21,15,1040,1002,2042,1941
0132-000,2011,9,21,16,1073,910,1983,2042
0132-000,2011,9,21,17,1082,897,1979,1983
0132-000,2011,9,21,18,1262,929,2191,1979
0132-000,2011,9,21,19,1275,955,2230,2191
0132-000,2011,9,21,20,999,764,1763,2230
0132-000,2011,9,21,21,736,603,1339,1763
0132-000,2011,9,21,22,669,533,1202,1339
0132-000,2011,9,21,23,406,392,798,1202
0132-000,2011,9,21,24,283,248,531,798
0132-000,2011,9,22,1,204,284,488,531
0132-000,2011,9,22,2,180,216,396,488
0132-000,2011,9,22,3,127,154,281,396
0132-000,2011,9,22,4,96,206,302,281
0132-000,2011,9,22,5,138,174,312,302
0132-000,2011,9,22,6,218,270,488,312
0132-000,2011,9,22,7,391,657,1048,488
0132-000,2011,9,22,8,833,1598,2431,1048
0132-000,2011,9,22,9,988,1662,2650,2431
0132-000,2011,9,22,10,875,1352,2227,2650
0132-000,2011,9,22,11,927,1513,2440,2227
0132-000,2011,9,22,12,923,1091,2014,2440
0132-000,2011,9,22,13,827,701,1528,2014
0132-000,2011,9,22,14,995,792,1787,1528
0132-000,2011,9,22,15,988,768,1756,1787
0132-000,2011,9,22,16,1082,761,1843,1756
0132-000,2011,9,22,17,1078,786,1864,1843
0132-000,2011,9,22,18,1284,744,2028,1864
0132-000,2011,9,22,19,1224,758,1982,2028
0132-000,2011,9,22,20,950,543,1493,1982
0132-000,2011,9,22,21,802,446,1248,1493
0132-000,2011,9,22,22,628,389,1017,1248
0132-000,2011,9,22,23,456,260,716,1017
0132-000,2011,9,22,24,333,183,516,716
0132-000,2011,9,23,1,239,183,422,516
0132-000,2011,9,23,2,165,111,276,422
0132-000,2011,9,23,3,138,123,261,276
0132-000,2011,9,23,4,110,103,213,261
0132-000,2011,9,23,5,134,117,251,213
0132-000,2011,9,23,6,194,162,356,251
0132-000,2011,9,23,7,408,465,873,356
0132-000,2011,9,23,8,913,1365,2278,873
0132-000,2011,9,23,9,1053,1366,2419,2278
0132-000,2011,9,23,10,959,1122,2081,2419
0132-000,2011,9,23,11,977,1080,2057,2081
0132-000,2011,9,23,12,1027,1050,2077,2057
0132-000,2011,9,23,13,858,906,1764,2077
0132-000,2011,9,23,14,999,1034,2033,1764
0132-000,2011,9,23,15,1128,818,1946,2033
0132-000,2011,9,23,16,1149,978,2127,1946
0132-000,2011,9,23,17,1212,1059,2271,2127
0132-000,2011,9,23,18,1445,1106,2551,2271
0132-000,2011,9,23,19,1480,1196,2676,2551
0132-000,2011,9,23,20,1197,886,2083,2676
0132-000,2011,9,23,21,963,622,1585,2083
0132-000,2011,9,23,22,712,539,1251,1585
0132-000,2011,9,23,23,525,456,981,1251
0132-000,2011,9,23,24,358,313,671,981
0132-000,2011,9,24,1,249,205,454,671
0132-000,2011,9,24,2,163,179,342,454
0132-000,2011,9,24,3,160,139,299,342
0132-000,2011,9,24,4,121,126,247,299
0132-000,2011,9,24,5,148,126,274,247
0132-000,2011,9,24,6,243,136,379,274
0132-000,2011,9,24,7,354,408,762,379
0132-000,2011,9,24,8,624,799,1423,762
0132-000,2011,9,24,9,805,917,1722,1423
0132-000,2011,9,24,10,846,1024,1870,1722
0132-000,2011,9,24,11,895,1057,1952,1870
0132-000,2011,9,24,12,932,1095,2027,1952
0132-000,2011,9,24,13,913,967,1880,2027
0132-000,2011,9,24,14,1028,1198,2226,1880
0132-000,2011,9,24,15,1009,1051,2060,2226
0132-000,2011,9,24,16,1175,1070,2245,2060
0132-000,2011,9,24,17,1277,1061,2338,2245
0132-000,2011,9,24,18,1491,1190,2681,2338
0132-000,2011,9,24,19,1364,1171,2535,2681
0132-000,2011,9,24,20,919,796,1715,2535
0132-000,2011,9,24,21,733,589,1322,1715
0132-000,2011,9,24,22,574,495,1069,1322
0132-000,2011,9,24,23,391,406,797,1069
0132-000,2011,9,24,24,296,294,590,797
0132-000,2011,9,25,1,210,194,404,590
0132-000,2011,9,25,2,163,146,309,404
0132-000,2011,9,25,3,127,129,256,309
0132-000,2011,9,25,4,96,89,185,256
0132-000,2011,9,25,5,130,89,219,185
0132-000,2011,9,25,6,149,103,252,219
0132-000,2011,9,25,7,204,292,496,252
0132-000,2011,9,25,8,310,512,822,496
0132-000,2011,9,25,9,444,609,1053,822
0132-000,2011,9,25,10,556,817,1373,1053
0132-000,2011,9,25,11,649,950,1599,1373
0132-000,2011,9,25,12,695,998,1693,1599
0132-000,2011,9,25,13,654,904,1558,1693
0132-000,2011,9,25,14,776,855,1631,1558
0132-000,2011,9,25,15,838,924,1762,1631
0132-000,2011,9,25,16,949,992,1941,1762
0132-000,2011,9,25,17,1131,924,2055,1941
0132-000,2011,9,25,18,1237,935,2172,2055
0132-000,2011,9,25,19,1339,906,2245,2172
0132-000,2011,9,25,20,1145,685,1830,2245
0132-000,2011,9,25,21,869,649,1518,1830
0132-000,2011,9,25,22,640,694,1334,1518
0132-000,2011,9,25,23,422,479,901,1334
0132-000,2011,9,25,24,235,325,560,901
0132-000,2011,9,26,1,146,144,290,560
0132-000,2011,9,26,2,87,97,184,290
0132-000,2011,9,26,3,74,56,130,184
0132-000,2011,9,26,4,70,79,149,130
0132-000,2011,9,26,5,127,83,210,149
0132-000,2011,9,26,6,209,185,394,210
0132-000,2011,9,26,7,476,702,1178,394
0132-000,2011,9,26,8,940,1665,2605,1178
0132-000,2011,9,26,9,987,1409,2396,2605
0132-000,2011,9,26,10,928,1173,2101,2396
0132-000,2011,9,26,11,964,1139,2103,2101
0132-000,2011,9,26,12,931,1063,1994,2103
0132-000,2011,9,26,13,871,1007,1878,1994
0132-000,2011,9,26,14,956,996,1952,1878
0132-000,2011,9,26,15,1086,1029,2115,1952
0132-000,2011,9,26,16,1094,942,2036,2115
0132-000,2011,9,26,17,1163,932,2095,2036
0132-000,2011,9,26,18,1247,996,2243,2095
0132-000,2011,9,26,19,1352,1077,2429,2243
0132-000,2011,9,26,20,989,792,1781,2429
0132-000,2011,9,26,21,840,629,1469,1781
0132-000,2011,9,26,22,652,496,1148,1469
0132-000,2011,9,26,23,452,280,732,1148
0132-000,2011,9,26,24,281,218,499,732
0132-000,2011,9,27,1,163,178,341,499
0132-000,2011,9,27,2,129,117,246,341
0132-000,2011,9,27,3,86,91,177,246
0132-000,2011,9,27,4,82,90,172,177
0132-000,2011,9,27,5,101,145,246,172
0132-000,2011,9,27,6,185,169,354,246
0132-000,2011,9,27,7,421,491,912,354
0132-000,2011,9,27,8,809,1430,2239,912
0132-000,2011,9,27,9,845,1508,2353,2239
0132-000,2011,9,27,10,861,1074,1935,2353
0132-000,2011,9,27,11,902,1012,1914,1935
0132-000,2011,9,27,12,911,930,1841,1914
0132-000,2011,9,27,13,836,875,1711,1841
0132-000,2011,9,27,14,991,962,1953,1711
0132-000,2011,9,27,15,1035,1001,2036,1953
0132-000,2011,9,27,16,1044,921,1965,2036
0132-000,2011,9,27,17,1068,918,1986,1965
0132-000,2011,9,27,18,1245,962,2207,1986
0132-000,2011,9,27,19,1345,936,2281,2207
0132-000,2011,9,27,20,995,777,1772,2281
0132-000,2011,9,27,21,832,610,1442,1772
0132-000,2011,9,27,22,679,526,1205,1442
0132-000,2011,9,27,23,419,353,772,1205
0132-000,2011,9,27,24,259,253,512,772
0132-000,2011,9,28,1,172,182,354,512
0132-000,2011,9,28,2,128,138,266,354
0132-000,2011,9,28,3,99,95,194,266
0132-000,2011,9,28,4,78,95,173,194
0132-000,2011,9,28,5,110,126,236,173
0132-000,2011,9,28,6,180,184,364,236
0132-000,2011,9,28,7,457,495,952,364
0132-000,2011,9,28,8,831,1470,2301,952
0132-000,2011,9,28,9,858,1422,2280,2301
0132-000,2011,9,28,10,873,1043,1916,2280
0132-000,2011,9,28,11,897,977,1874,1916
0132-000,2011,9,28,12,867,924,1791,1874
0132-000,2011,9,28,13,904,880,1784,1791
0132-000,2011,9,28,14,918,982,1900,1784
0132-000,2011,9,28,15,1058,1046,2104,1900
0132-000,2011,9,28,16,1089,963,2052,2104
0132-000,2011,9,28,17,1093,997,2090,2052
0132-000,2011,9,28,18,1353,936,2289,2090
0132-000,2011,9,28,19,1354,929,2283,2289
0132-000,2011,9,28,20,994,750,1744,2283
0132-000,2011,9,28,21,737,638,1375,1744
0132-000,2011,9,28,22,672,537,1209,1375
0132-000,2011,9,28,23,396,382,778,1209
0132-000,2011,9,28,24,263,249,512,778
0132-000,2011,9,29,1,187,205,392,512
0132-000,2011,9,29,2,133,150,283,392
0132-000,2011,9,29,3,95,106,201,283
0132-000,2011,9,29,4,77,102,179,201
0132-000,2011,9,29,5,119,103,222,179
0132-000,2011,9,29,6,188,180,368,222
0132-000,2011,9,29,7,396,455,851,368
0132-000,2011,9,29,8,840,1356,2196,851
0132-000,2011,9,29,9,857,1384,2241,2196
0132-000,2011,9,29,10,839,986,1825,2241
0132-000,2011,9,29,11,867,945,1812,1825
0132-000,2011,9,29,12,844,900,1744,1812
0132-000,2011,9,29,13,821,857,1678,1744
0132-000,2011,9,29,14,896,883,1779,1678
0132-000,2011,9,29,15,1001,958,1959,1779
0132-000,2011,9,29,16,949,852,1801,1959
0132-000,2011,9,29,17,980,912,1892,1801
0132-000,2011,9,29,18,1171,883,2054,1892
0132-000,2011,9,29,19,1184,947,2131,2054
0132-000,2011,9,29,20,895,716,1611,2131
0132-000,2011,9,29,21,774,589,1363,1611
0132-000,2011,9,29,22,637,506,1143,1363
0132-000,2011,9,29,23,402,356,758,1143
0132-000,2011,9,29,24,269,240,509,758
0132-000,2011,9,30,1,212,215,427,509
0132-000,2011,9,30,2,109,142,251,427
0132-000,2011,9,30,3,104,101,205,251
0132-000,2011,9,30,4,115,125,240,205
0132-000,2011,9,30,5,107,110,217,240
0132-000,2011,9,30,6,208,185,393,217
0132-000,2011,9,30,7,436,509,945,393
0132-000,2011,9,30,8,846,1436,2282,945
0132-000,2011,9,30,9,886,1395,2281,2282
0132-000,2011,9,30,10,888,1057,1945,2281
0132-000,2011,9,30,11,876,982,1858,1945
0132-000,2011,9,30,12,981,1032,2013,1858
0132-000,2011,9,30,13,952,827,1779,2013
0132-000,2011,9,30,14,987,932,1919,1779
0132-000,2011,9,30,15,1071,1038,2109,1919
0132-000,2011,9,30,16,1064,993,2057,2109
0132-000,2011,9,30,17,1103,1048,2151,2057
0132-000,2011,9,30,18,1301,953,2254,2151
0132-000,2011,9,30,19,1475,1026,2501,2254
0132-000,2011,9,30,20,1242,828,2070,2501
0132-000,2011,9,30,21,913,722,1635,2070
0132-000,2011,9,30,22,703,606,1309,1635
0132-000,2011,9,30,23,475,456,931,1309
0132-000,2011,9,30,24,362,343,705,931
0132-000,2011,10,1,1,238,259,497,705
0132-000,2011,10,1,2,194,152,346,497
0132-000,2011,10,1,3,137,150,287,346
0132-000,2011,10,1,4,107,153,260,287
0132-000,2011,10,1,5,123,146,269,260
0132-000,2011,10,1,6,186,180,366,269
0132-000,2011,10,1,7,405,415,820,366
0132-000,2011,10,1,8,659,925,1584,820
0132-000,2011,10,1,9,772,997,1769,1584
0132-000,2011,10,1,10,861,1065,1926,1769
0132-000,2011,10,1,11,893,1426,2319,1926
0132-000,2011,10,1,12,845,1794,2639,2319
0132-000,2011,10,1,13,891,1850,2741,2639
0132-000,2011,10,1,14,1006,1907,2913,2741
0132-000,2011,10,1,15,997,1931,2928,2913
0132-000,2011,10,1,16,1112,1993,3105,2928
0132-000,2011,10,1,17,1427,1334,2761,3105
0132-000,2011,10,1,18,1555,2071,3626,2761
0132-000,2011,10,1,19,1569,1928,3497,3626
0132-000,2011,10,1,20,1292,1784,3076,3497
0132-000,2011,10,1,21,791,1443,2234,3076
0132-000,2011,10,1,22,555,1110,1665,2234
0132-000,2011,10,1,23,366,626,992,1665
0132-000,2011,10,1,24,238,349,587,992
0132-000,2011,10,2,1,188,221,409,587
0132-000,2011,10,2,2,143,157,300,409
0132-000,2011,10,2,3,105,124,229,300
0132-000,2011,10,2,4,90,75,165,229
0132-000,2011,10,2,5,79,90,169,165
0132-000,2011,10,2,6,115,115,230,169
0132-000,2011,10,2,7,240,244,484,230
0132-000,2011,10,2,8,333,540,873,484
0132-000,2011,10,2,9,459,608,1067,873
0132-000,2011,10,2,10,500,863,1363,1067
0132-000,2011,10,2,11,586,1066,1652,1363
0132-000,2011,10,2,12,624,1168,1792,1652
0132-000,2011,10,2,13,643,1121,1764,1792
0132-000,2011,10,2,14,713,966,1679,1764
0132-000,2011,10,2,15,821,803,1624,1679
0132-000,2011,10,2,16,972,783,1755,1624
0132-000,2011,10,2,17,1512,745,2257,1755
0132-000,2011,10,2,18,1526,797,2323,2257
0132-000,2011,10,2,19,1493,717,2210,2323
0132-000,2011,10,2,20,1464,546,2010,2210
0132-000,2011,10,2,21,1173,631,1804,2010
0132-000,2011,10,2,22,1047,430,1477,1804
0132-000,2011,10,2,23,599,372,971,1477
0132-000,2011,10,2,24,305,272,577,971
0132-000,2011,10,3,1,173,188,361,577
0132-000,2011,10,3,2,99,122,221,361
0132-000,2011,10,3,3,93,99,192,221
0132-000,2011,10,3,4,57,93,150,192
0132-000,2011,10,3,5,88,97,185,150
0132-000,2011,10,3,6,142,172,314,185
0132-000,2011,10,3,7,291,345,636,314
0132-000,2011,10,3,8,497,714,1211,636
0132-000,2011,10,3,9,554,658,1212,1211
0132-000,2011,10,3,10,602,651,1253,1212
0132-000,2011,10,3,11,694,752,1446,1253
0132-000,2011,10,3,12,909,786,1695,1446
0132-000,2011,10,3,13,1195,765,1960,1695
0132-000,2011,10,3,14,1260,722,1982,1960
0132-000,2011,10,3,15,1440,778,2218,1982
0132-000,2011,10,3,16,1466,756,2222,2218
0132-000,2011,10,3,17,1640,789,2429,2222
0132-000,2011,10,3,18,1899,801,2700,2429
0132-000,2011,10,3,19,1793,728,2521,2700
0132-000,2011,10,3,20,1377,685,2062,2521
0132-000,2011,10,3,21,885,550,1435,2062
0132-000,2011,10,3,22,648,487,1135,1435
0132-000,2011,10,3,23,373,366,739,1135
0132-000,2011,10,3,24,224,244,468,739
0132-000,2011,10,4,1,152,199,351,468
0132-000,2011,10,4,2,86,108,194,351
0132-000,2011,10,4,3,58,85,143,194
0132-000,2011,10,4,4,57,87,144,143
0132-000,2011,10,4,5,99,101,200,144
0132-000,2011,10,4,6,188,203,391,200
0132-000,2011,10,4,7,493,581,1074,391
0132-000,2011,10,4,8,835,1651,2486,1074
0132-000,2011,10,4,9,843,1504,2347,2486
0132-000,2011,10,4,10,870,1082,1952,2347
0132-000,2011,10,4,11,929,933,1862,1952
0132-000,2011,10,4,12,876,957,1833,1862
0132-000,2011,10,4,13,850,889,1739,1833
0132-000,2011,10,4,14,901,1016,1917,1739
0132-000,2011,10,4,15,991,1017,2008,1917
0132-000,2011,10,4,16,1047,970,2017,2008
0132-000,2011,10,4,17,1109,931,2040,2017
0132-000,2011,10,4,18,1261,980,2241,2040
0132-000,2011,10,4,19,1266,959,2225,2241
0132-000,2011,10,4,20,1032,820,1852,2225
0132-000,2011,10,4,21,811,579,1390,1852
0132-000,2011,10,4,22,593,514,1107,1390
0132-000,2011,10,4,23,403,366,769,1107
0132-000,2011,10,4,24,263,269,532,769
0132-000,2011,10,5,1,165,152,317,532
0132-000,2011,10,5,2,137,126,263,317
0132-000,2011,10,5,3,71,118,189,263
0132-000,2011,10,5,4,84,120,204,189
0132-000,2011,10,5,5,93,115,208,204
0132-000,2011,10,5,6,207,165,372,208
0132-000,2011,10,5,7,439,469,908,372
0132-000,2011,10,5,8,804,1459,2263,908
0132-000,2011,10,5,9,893,1363,2256,2263
0132-000,2011,10,5,10,926,1199,2125,2256
0132-000,2011,10,5,11,933,1035,1968,2125
0132-000,2011,10,5,12,966,922,1888,1968
0132-000,2011,10,5,13,761,926,1687,1888
0132-000,2011,10,5,14,957,964,1921,1687
0132-000,2011,10,5,15,1080,1109,2189,1921
0132-000,2011,10,5,16,1140,987,2127,2189
0132-000,2011,10,5,17,1129,940,2069,2127
0132-000,2011,10,5,18,1261,984,2245,2069
0132-000,2011,10,5,19,1331,977,2308,2245
0132-000,2011,10,5,20,979,752,1731,2308
0132-000,2011,10,5,21,801,587,1388,1731
0132-000,2011,10,5,22,677,535,1212,1388
0132-000,2011,10,5,23,420,358,778,1212
0132-000,2011,10,5,24,267,274,541,778
0132-000,2011,10,6,1,161,180,341,541
0132-000,2011,10,6,2,129,145,274,341
0132-000,2011,10,6,3,92,94,186,274
0132-000,2011,10,6,4,84,115,199,186
0132-000,2011,10,6,5,107,121,228,199
0132-000,2011,10,6,6,181,193,374,228
0132-000,2011,10,6,7,442,483,925,374
0132-000,2011,10,6,8,841,1478,2319,925
0132-000,2011,10,6,9,912,1439,2351,2319
0132-000,2011,10,6,10,912,1067,1979,2351
0132-000,2011,10,6,11,949,1046,1995,1979
0132-000,2011,10,6,12,935,1014,1949,1995
0132-000,2011,10,6,13,885,938,1823,1949
0132-000,2011,10,6,14,970,1035,2005,1823
0132-000,2011,10,6,15,1086,1054,2140,2005
0132-000,2011,10,6,16,1053,1032,2085,2140
0132-000,2011,10,6,17,1163,950,2113,2085
0132-000,2011,10,6,18,1277,962,2239,2113
0132-000,2011,10,6,19,1304,923,2227,2239
0132-000,2011,10,6,20,985,696,1681,2227
0132-000,2011,10,6,21,827,600,1427,1681
0132-000,2011,10,6,22,680,539,1219,1427
0132-000,2011,10,6,23,419,416,835,1219
0132-000,2011,10,6,24,261,249,510,835
0132-000,2011,10,7,1,224,200,424,510
0132-000,2011,10,7,2,135,156,291,424
0132-000,2011,10,7,3,100,126,226,291
0132-000,2011,10,7,4,84,126,210,226
0132-000,2011,10,7,5,102,147,249,210
0132-000,2011,10,7,6,200,183,383,249
0132-000,2011,10,7,7,458,471,929,383
0132-000,2011,10,7,8,820,1486,2306,929
0132-000,2011,10,7,9,894,1343,2237,2306
0132-000,2011,10,7,10,869,1072,1941,2237
0132-000,2011,10,7,11,901,967,1868,1941
0132-000,2011,10,7,12,983,983,1966,1868
0132-000,2011,10,7,13,855,922,1777,1966
0132-000,2011,10,7,14,972,1011,1983,1777
0132-000,2011,10,7,15,1096,1038,2134,1983
0132-000,2011,10,7,16,1172,1030,2202,2134
0132-000,2011,10,7,17,1208,1017,2225,2202
0132-000,2011,10,7,18,1338,1015,2353,2225
0132-000,2011,10,7,19,1593,1031,2624,2353
0132-000,2011,10,7,20,1206,866,2072,2624
0132-000,2011,10,7,21,936,675,1611,2072
0132-000,2011,10,7,22,725,564,1289,1611
0132-000,2011,10,7,23,478,471,949,1289
0132-000,2011,10,7,24,294,336,630,949
0132-000,2011,10,8,1,226,273,499,630
0132-000,2011,10,8,2,167,168,335,499
0132-000,2011,10,8,3,104,164,268,335
0132-000,2011,10,8,4,108,121,229,268
0132-000,2011,10,8,5,108,133,241,229
0132-000,2011,10,8,6,201,165,366,241
0132-000,2011,10,8,7,338,378,716,366
0132-000,2011,10,8,8,581,940,1521,716
0132-000,2011,10,8,9,786,1123,1909,1521
0132-000,2011,10,8,10,888,1114,2002,1909
0132-000,2011,10,8,11,909,1484,2393,2002
0132-000,2011,10,8,12,1000,1780,2780,2393
0132-000,2011,10,8,13,1178,1867,3045,2780
0132-000,2011,10,8,14,1114,1670,2784,3045
0132-000,2011,10,8,15,1291,1536,2827,2784
0132-000,2011,10,8,16,1308,1440,2748,2827
0132-000,2011,10,8,17,1722,1317,3039,2748
0132-000,2011,10,8,18,1868,1321,3189,3039
0132-000,2011,10,8,19,1677,1193,2870,3189
0132-000,2011,10,8,20,1459,775,2234,2870
0132-000,2011,10,8,21,1357,612,1969,2234
0132-000,2011,10,8,22,783,508,1291,1969
0132-000,2011,10,8,23,420,420,840,1291
0132-000,2011,10,8,24,250,318,568,840
0132-000,2011,10,9,1,188,237,425,568
0132-000,2011,10,9,2,132,150,282,425
0132-000,2011,10,9,3,117,122,239,282
0132-000,2011,10,9,4,92,115,207,239
0132-000,2011,10,9,5,95,113,208,207
0132-000,2011,10,9,6,131,147,278,208
0132-000,2011,10,9,7,200,270,470,278
0132-000,2011,10,9,8,329,460,789,470
0132-000,2011,10,9,9,442,609,1051,789
0132-000,2011,10,9,10,508,661,1169,1051
0132-000,2011,10,9,11,632,739,1371,1169
0132-000,2011,10,9,12,661,728,1389,1371
0132-000,2011,10,9,13,750,720,1470,1389
0132-000,2011,10,9,14,753,734,1487,1470
0132-000,2011,10,9,15,1003,741,1744,1487
0132-000,2011,10,9,16,1129,786,1915,1744
0132-000,2011,10,9,17,1410,782,2192,1915
0132-000,2011,10,9,18,1660,760,2420,2192
0132-000,2011,10,9,19,1621,711,2332,2420
0132-000,2011,10,9,20,1243,570,1813,2332
0132-000,2011,10,9,21,791,540,1331,1813
0132-000,2011,10,9,22,554,498,1052,1331
0132-000,2011,10,9,23,345,373,718,1052
0132-000,2011,10,9,24,200,281,481,718
0132-000,2011,10,10,1,145,166,311,481
0132-000,2011,10,10,2,97,126,223,311
0132-000,2011,10,10,3,61,100,161,223
0132-000,2011,10,10,4,65,90,155,161
0132-000,2011,10,10,5,100,99,199,155
0132-000,2011,10,10,6,215,200,415,199
0132-000,2011,10,10,7,499,625,1124,415
0132-000,2011,10,10,8,835,1655,2490,1124
0132-000,2011,10,10,9,879,1538,2417,2490
0132-000,2011,10,10,10,870,1067,1937,2417
0132-000,2011,10,10,11,875,1027,1902,1937
0132-000,2011,10,10,12,937,1000,1937,1902
0132-000,2011,10,10,13,855,925,1780,1937
0132-000,2011,10,10,14,945,1003,1948,1780
0132-000,2011,10,10,15,1062,1054,2116,1948
0132-000,2011,10,10,16,1064,998,2062,2116
0132-000,2011,10,10,17,1126,1022,2148,2062
0132-000,2011,10,10,18,1163,1002,2165,2148
0132-000,2011,10,10,19,1298,939,2237,2165
0132-000,2011,10,10,20,934,732,1666,2237
0132-000,2011,10,10,21,795,616,1411,1666
0132-000,2011,10,10,22,676,538,1214,1411
0132-000,2011,10,10,23,421,366,787,1214
0132-000,2011,10,10,24,243,227,470,787
0132-000,2011,10,11,1,155,192,347,470
0132-000,2011,10,11,2,106,141,247,347
0132-000,2011,10,11,3,92,108,200,247
0132-000,2011,10,11,4,90,86,176,200
0132-000,2011,10,11,5,93,131,224,176
0132-000,2011,10,11,6,191,182,373,224
0132-000,2011,10,11,7,439,446,885,373
0132-000,2011,10,11,8,785,1458,2243,885
0132-000,2011,10,11,9,862,1430,2292,2243
0132-000,2011,10,11,10,914,1070,1984,2292
0132-000,2011,10,11,11,931,1022,1953,1984
0132-000,2011,10,11,12,957,951,1908,1953
0132-000,2011,10,11,13,855,940,1795,1908
0132-000,2011,10,11,14,932,993,1925,1795
0132-000,2011,10,11,15,1028,1079,2107,1925
0132-000,2011,10,11,16,1103,1002,2105,2107
0132-000,2011,10,11,17,1108,999,2107,2105
0132-000,2011,10,11,18,1309,940,2249,2107
0132-000,2011,10,11,19,1300,949,2249,2249
0132-000,2011,10,11,20,978,722,1700,2249
0132-000,2011,10,11,21,783,602,1385,1700
0132-000,2011,10,11,22,644,508,1152,1385
0132-000,2011,10,11,23,388,375,763,1152
0132-000,2011,10,11,24,250,252,502,763
0132-000,2011,10,12,1,179,187,366,502
0132-000,2011,10,12,2,109,161,270,366
0132-000,2011,10,12,3,82,83,165,270
0132-000,2011,10,12,4,84,99,183,165
0132-000,2011,10,12,5,123,115,238,183
0132-000,2011,10,12,6,169,192,361,238
0132-000,2011,10,12,7,437,461,898,361
0132-000,2011,10,12,8,819,1475,2294,898
0132-000,2011,10,12,9,938,1436,2374,2294
0132-000,2011,10,12,10,809,1112,1921,2374
0132-000,2011,10,12,11,900,992,1892,1921
0132-000,2011,10,12,12,877,1000,1877,1892
0132-000,2011,10,12,13,869,899,1768,1877
0132-000,2011,10,12,14,909,964,1873,1768
0132-000,2011,10,12,15,1037,1008,2045,1873
0132-000,2011,10,12,16,1083,982,2065,2045
0132-000,2011,10,12,17,1158,958,2116,2065
0132-000,2011,10,12,18,1311,1049,2360,2116
0132-000,2011,10,12,19,1356,929,2285,2360
0132-000,2011,10,12,20,889,746,1635,2285
0132-000,2011,10,12,21,785,614,1399,1635
0132-000,2011,10,12,22,646,508,1154,1399
0132-000,2011,10,12,23,389,381,770,1154
0132-000,2011,10,12,24,237,270,507,770
0132-000,2011,10,13,1,193,192,385,507
0132-000,2011,10,13,2,123,138,261,385
0132-000,2011,10,13,3,90,97,187,261
0132-000,2011,10,13,4,84,112,196,187
0132-000,2011,10,13,5,108,126,234,196
0132-000,2011,10,13,6,186,173,359,234
0132-000,2011,10,13,7,450,463,913,359
0132-000,2011,10,13,8,813,1479,2292,913
0132-000,2011,10,13,9,852,1422,2274,2292
0132-000,2011,10,13,10,897,1112,2009,2274
0132-000,2011,10,13,11,921,1026,1947,2009
0132-000,2011,10,13,12,944,931,1875,1947
0132-000,2011,10,13,13,850,809,1659,1875
0132-000,2011,10,13,14,916,1039,1955,1659
0132-000,2011,10,13,15,1014,958,1972,1955
0132-000,2011,10,13,16,1056,988,2044,1972
0132-000,2011,10,13,17,1141,933,2074,2044
0132-000,2011,10,13,18,1296,991,2287,2074
0132-000,2011,10,13,19,1330,947,2277,2287
0132-000,2011,10,13,20,984,715,1699,2277
0132-000,2011,10,13,21,756,639,1395,1699
0132-000,2011,10,13,22,652,548,1200,1395
0132-000,2011,10,13,23,416,364,780,1200
0132-000,2011,10,13,24,274,261,535,780
0132-000,2011,10,14,1,181,194,375,535
0132-000,2011,10,14,2,109,132,241,375
0132-000,2011,10,14,3,93,113,206,241
0132-000,2011,10,14,4,99,110,209,206
0132-000,2011,10,14,5,103,129,232,209
0132-000,2011,10,14,6,180,180,360,232
0132-000,2011,10,14,7,434,421,855,360
0132-000,2011,10,14,8,790,1389,2179,855
0132-000,2011,10,14,9,895,1393,2288,2179
0132-000,2011,10,14,10,867,950,1817,2288
0132-000,2011,10,14,11,851,965,1816,1817
0132-000,2011,10,14,12,886,898,1784,1816
0132-000,2011,10,14,13,859,856,1715,1784
0132-000,2011,10,14,14,872,960,1832,1715
0132-000,2011,10,14,15,1008,1025,2033,1832
0132-000,2011,10,14,16,1088,969,2057,2033
0132-000,2011,10,14,17,1094,956,2050,2057
0132-000,2011,10,14,18,1250,894,2144,2050
0132-000,2011,10,14,19,1449,942,2391,2144
0132-000,2011,10,14,20,1043,804,1847,2391
0132-000,2011,10,14,21,788,605,1393,1847
0132-000,2011,10,14,22,675,571,1246,1393
0132-000,2011,10,14,23,411,412,823,1246
0132-000,2011,10,14,24,286,292,578,823
0132-000,2011,10,15,1,224,280,504,578
0132-000,2011,10,15,2,172,157,329,504
0132-000,2011,10,15,3,113,142,255,329
0132-000,2011,10,15,4,109,124,233,255
0132-000,2011,10,15,5,111,145,256,233
0132-000,2011,10,15,6,198,173,371,256
0132-000,2011,10,15,7,348,340,688,371
0132-000,2011,10,15,8,627,862,1489,688
0132-000,2011,10,15,9,790,1011,1801,1489
0132-000,2011,10,15,10,867,945,1812,1801
0132-000,2011,10,15,11,904,1176,2080,1812
0132-000,2011,10,15,12,903,1306,2209,2080
0132-000,2011,10,15,13,949,1388,2337,2209
0132-000,2011,10,15,14,1026,1286,2312,2337
0132-000,2011,10,15,15,1008,1239,2247,2312
0132-000,2011,10,15,16,1107,1210,2317,2247
0132-000,2011,10,15,17,1222,1254,2476,2317
0132-000,2011,10,15,18,1578,1235,2813,2476
0132-000,2011,10,15,19,1510,1039,2549,2813
0132-000,2011,10,15,20,1087,719,1806,2549
0132-000,2011,10,15,21,695,693,1388,1806
0132-000,2011,10,15,22,584,547,1131,1388
0132-000,2011,10,15,23,535,417,952,1131
0132-000,2011,10,15,24,255,245,500,952
0132-000,2011,10,16,1,212,230,442,500
0132-000,2011,10,16,2,118,160,278,442
0132-000,2011,10,16,3,109,92,201,278
0132-000,2011,10,16,4,106,99,205,201
0132-000,2011,10,16,5,93,98,191,205
0132-000,2011,10,16,6,135,139,274,191
0132-000,2011,10,16,7,217,246,463,274
0132-000,2011,10,16,8,269,434,703,463
0132-000,2011,10,16,9,389,565,954,703
0132-000,2011,10,16,10,517,614,1131,954
0132-000,2011,10,16,11,697,706,1403,1131
0132-000,2011,10,16,12,696,739,1435,1403
0132-000,2011,10,16,13,681,749,1430,1435
0132-000,2011,10,16,14,784,745,1529,1430
0132-000,2011,10,16,15,891,810,1701,1529
0132-000,2011,10,16,16,1145,716,1861,1701
0132-000,2011,10,16,17,1373,755,2128,1861
0132-000,2011,10,16,18,1546,828,2374,2128
0132-000,2011,10,16,19,1548,673,2221,2374
0132-000,2011,10,16,20,1196,616,1812,2221
0132-000,2011,10,16,21,833,551,1384,1812
0132-000,2011,10,16,22,579,475,1054,1384
0132-000,2011,10,16,23,369,359,728,1054
0132-000,2011,10,16,24,206,249,455,728
0132-000,2011,10,17,1,133,177,310,455
0132-000,2011,10,17,2,91,107,198,310
0132-000,2011,10,17,3,63,88,151,198
0132-000,2011,10,17,4,70,67,137,151
0132-000,2011,10,17,5,104,111,215,137
0132-000,2011,10,17,6,198,201,399,215
0132-000,2011,10,17,7,496,620,1116,399
0132-000,2011,10,17,8,838,1682,2520,1116
0132-000,2011,10,17,9,849,1473,2322,2520
0132-000,2011,10,17,10,837,1056,1893,2322
0132-000,2011,10,17,11,895,1027,1922,1893
0132-000,2011,10,17,12,923,982,1905,1922
0132-000,2011,10,17,13,836,934,1770,1905
0132-000,2011,10,17,14,885,1009,1894,1770
0132-000,2011,10,17,15,1060,1033,2093,1894
0132-000,2011,10,17,16,1046,974,2020,2093
0132-000,2011,10,17,17,1096,945,2041,2020
0132-000,2011,10,17,18,1236,1002,2238,2041
0132-000,2011,10,17,19,1244,921,2165,2238
0132-000,2011,10,17,20,946,731,1677,2165
0132-000,2011,10,17,21,769,598,1367,1677
0132-000,2011,10,17,22,622,487,1109,1367
0132-000,2011,10,17,23,403,346,749,1109
0132-000,2011,10,17,24,258,240,498,749
0132-000,2011,10,18,1,181,184,365,498
0132-000,2011,10,18,2,113,106,219,365
0132-000,2011,10,18,3,80,94,174,219
0132-000,2011,10,18,4,86,111,197,174
0132-000,2011,10,18,5,107,135,242,197
0132-000,2011,10,18,6,194,185,379,242
0132-000,2011,10,18,7,466,486,952,379
0132-000,2011,10,18,8,811,1465,2276,952
0132-000,2011,10,18,9,878,1490,2368,2276
0132-000,2011,10,18,10,887,1074,1961,2368
0132-000,2011,10,18,11,950,1003,1953,1961
0132-000,2011,10,18,12,942,936,1878,1953
0132-000,2011,10,18,13,858,901,1759,1878
0132-000,2011,10,18,14,993,1047,2040,1759
0132-000,2011,10,18,15,1051,1098,2149,2040
0132-000,2011,10,18,16,1133,1039,2172,2149
0132-000,2011,10,18,17,1113,934,2047,2172
0132-000,2011,10,18,18,1323,1038,2361,2047
0132-000,2011,10,18,19,1296,924,2220,2361
0132-000,2011,10,18,20,897,756,1653,2220
0132-000,2011,10,18,21,791,575,1366,1653
0132-000,2011,10,18,22,683,499,1182,1366
0132-000,2011,10,18,23,403,371,774,1182
0132-000,2011,10,18,24,247,238,485,774
0132-000,2011,10,19,1,192,188,380,485
0132-000,2011,10,19,2,117,132,249,380
0132-000,2011,10,19,3,83,105,188,249
0132-000,2011,10,19,4,96,102,198,188
0132-000,2011,10,19,5,113,110,223,198
0132-000,2011,10,19,6,177,168,345,223
0132-000,2011,10,19,7,456,463,919,345
0132-000,2011,10,19,8,778,1438,2216,919
0132-000,2011,10,19,9,874,1409,2283,2216
0132-000,2011,10,19,10,872,1073,1945,2283
0132-000,2011,10,19,11,912,1016,1928,1945
0132-000,2011,10,19,12,909,1010,1919,1928
0132-000,2011,10,19,13,812,866,1678,1919
0132-000,2011,10,19,14,911,998,1909,1678
0132-000,2011,10,19,15,1019,990,2009,1909
0132-000,2011,10,19,16,1095,976,2071,2009
0132-000,2011,10,19,17,1115,994,2109,2071
0132-000,2011,10,19,18,1306,969,2275,2109
0132-000,2011,10,19,19,1349,894,2243,2275
0132-000,2011,10,19,20,906,765,1671,2243
0132-000,2011,10,19,21,760,574,1334,1671
0132-000,2011,10,19,22,639,536,1175,1334
0132-000,2011,10,19,23,409,374,783,1175
0132-000,2011,10,19,24,240,260,500,783
0132-000,2011,10,20,1,191,167,358,500
0132-000,2011,10,20,2,118,146,264,358
0132-000,2011,10,20,3,108,108,216,264
0132-000,2011,10,20,4,100,122,222,216
0132-000,2011,10,20,5,102,110,212,222
0132-000,2011,10,20,6,188,189,377,212
0132-000,2011,10,20,7,466,454,920,377
0132-000,2011,10,20,8,818,1486,2304,920
0132-000,2011,10,20,9,900,1384,2284,2304
0132-000,2011,10,20,10,836,1144,1980,2284
0132-000,2011,10,20,11,947,988,1935,1980
0132-000,2011,10,20,12,927,964,1891,1935
0132-000,2011,10,20,13,824,907,1731,1891
0132-000,2011,10,20,14,955,959,1914,1731
0132-000,2011,10,20,15,998,1067,2065,1914
0132-000,2011,10,20,16,1179,945,2124,2065
0132-000,2011,10,20,17,1133,994,2127,2124
0132-000,2011,10,20,18,1261,995,2256,2127
0132-000,2011,10,20,19,1235,963,2198,2256
0132-000,2011,10,20,20,899,736,1635,2198
0132-000,2011,10,20,21,774,584,1358,1635
0132-000,2011,10,20,22,645,522,1167,1358
0132-000,2011,10,20,23,432,344,776,1167
0132-000,2011,10,20,24,268,235,503,776
0132-000,2011,10,21,1,215,195,410,503
0132-000,2011,10,21,2,132,133,265,410
0132-000,2011,10,21,3,119,111,230,265
0132-000,2011,10,21,4,64,104,168,230
0132-000,2011,10,21,5,92,120,212,168
0132-000,2011,10,21,6,211,184,395,212
0132-000,2011,10,21,7,435,457,892,395
0132-000,2011,10,21,8,804,1448,2252,892
0132-000,2011,10,21,9,932,1345,2277,2252
0132-000,2011,10,21,10,829,1056,1885,2277
0132-000,2011,10,21,11,914,986,1900,1885
0132-000,2011,10,21,12,963,988,1951,1900
0132-000,2011,10,21,13,902,873,1775,1951
0132-000,2011,10,21,14,972,1051,2023,1775
0132-000,2011,10,21,15,1070,1070,2140,2023
0132-000,2011,10,21,16,1165,1032,2197,2140
0132-000,2011,10,21,17,1118,997,2115,2197
0132-000,2011,10,21,18,1332,967,2299,2115
0132-000,2011,10,21,19,1532,915,2447,2299
0132-000,2011,10,21,20,1063,856,1919,2447
0132-000,2011,10,21,21,831,661,1492,1919
0132-000,2011,10,21,22,689,528,1217,1492
0132-000,2011,10,21,23,462,409,871,1217
0132-000,2011,10,21,24,285,299,584,871
0132-000,2011,10,22,1,218,226,444,584
0132-000,2011,10,22,2,181,173,354,444
0132-000,2011,10,22,3,135,119,254,354
0132-000,2011,10,22,4,87,130,217,254
0132-000,2011,10,22,5,119,127,246,217
0132-000,2011,10,22,6,172,192,364,246
0132-000,2011,10,22,7,341,352,693,364
0132-000,2011,10,22,8,589,835,1424,693
0132-000,2011,10,22,9,770,949,1719,1424
0132-000,2011,10,22,10,794,1088,1882,1719
0132-000,2011,10,22,11,912,1415,2327,1882
0132-000,2011,10,22,12,965,1566,2531,2327
0132-000,2011,10,22,13,902,1658,2560,2531
0132-000,2011,10,22,14,1021,1654,2675,2560
0132-000,2011,10,22,15,1033,1554,2587,2675
0132-000,2011,10,22,16,1062,1531,2593,2587
0132-000,2011,10,22,17,1360,1517,2877,2593
0132-000,2011,10,22,18,1627,1396,3023,2877
0132-000,2011,10,22,19,1546,1087,2633,3023
0132-000,2011,10,22,20,1093,783,1876,2633
0132-000,2011,10,22,21,691,614,1305,1876
0132-000,2011,10,22,22,529,516,1045,1305
0132-000,2011,10,22,23,374,406,780,1045
0132-000,2011,10,22,24,239,311,550,780
0132-000,2011,10,23,1,183,219,402,550
0132-000,2011,10,23,2,142,146,288,402
0132-000,2011,10,23,3,105,120,225,288
0132-000,2011,10,23,4,83,100,183,225
0132-000,2011,10,23,5,92,105,197,183
0132-000,2011,10,23,6,118,174,292,197
0132-000,2011,10,23,7,207,282,489,292
0132-000,2011,10,23,8,344,436,780,489
0132-000,2011,10,23,9,436,547,983,780
0132-000,2011,10,23,10,486,570,1056,983
0132-000,2011,10,23,11,619,726,1345,1056
0132-000,2011,10,23,12,633,707,1340,1345
0132-000,2011,10,23,13,695,740,1435,1340
0132-000,2011,10,23,14,772,773,1545,1435
0132-000,2011,10,23,15,1079,797,1876,1545
0132-000,2011,10,23,16,1367,742,2109,1876
0132-000,2011,10,23,17,1475,782,2257,2109
0132-000,2011,10,23,18,1690,741,2431,2257
0132-000,2011,10,23,19,1589,687,2276,2431
0132-000,2011,10,23,20,1426,549,1975,2276
0132-000,2011,10,23,21,1319,543,1862,1975
0132-000,2011,10,23,22,1166,461,1627,1862
0132-000,2011,10,23,23,632,426,1058,1627
0132-000,2011,10,23,24,280,275,555,1058
0132-000,2011,10,24,1,143,182,325,555
0132-000,2011,10,24,2,105,93,198,325
0132-000,2011,10,24,3,86,85,171,198
0132-000,2011,10,24,4,58,78,136,171
0132-000,2011,10,24,5,111,124,235,136
0132-000,2011,10,24,6,195,196,391,235
0132-000,2011,10,24,7,469,587,1056,391
0132-000,2011,10,24,8,864,1688,2552,1056
0132-000,2011,10,24,9,858,1440,2298,2552
0132-000,2011,10,24,10,844,1011,1855,2298
0132-000,2011,10,24,11,898,993,1891,1855
0132-000,2011,10,24,12,862,950,1812,1891
0132-000,2011,10,24,13,860,887,1747,1812
0132-000,2011,10,24,14,867,1006,1873,1747
0132-000,2011,10,24,15,1090,1029,2119,1873
0132-000,2011,10,24,16,1094,942,2036,2119
0132-000,2011,10,24,17,1028,987,2015,2036
0132-000,2011,10,24,18,1138,912,2050,2015
0132-000,2011,10,24,19,1230,904,2134,2050
0132-000,2011,10,24,20,806,633,1439,2134
0132-000,2011,10,24,21,730,579,1309,1439
0132-000,2011,10,24,22,568,462,1030,1309
0132-000,2011,10,24,23,381,358,739,1030
0132-000,2011,10,24,24,215,235,450,739
0132-000,2011,10,25,1,157,143,300,450
0132-000,2011,10,25,2,123,128,251,300
0132-000,2011,10,25,3,92,93,185,251
0132-000,2011,10,25,4,86,103,189,185
0132-000,2011,10,25,5,102,102,204,189
0132-000,2011,10,25,6,189,192,381,204
0132-000,2011,10,25,7,426,496,922,381
0132-000,2011,10,25,8,793,1439,2232,922
0132-000,2011,10,25,9,873,1431,2304,2232
0132-000,2011,10,25,10,839,1053,1892,2304
0132-000,2011,10,25,11,912,1033,1945,1892
0132-000,2011,10,25,12,885,971,1856,1945
0132-000,2011,10,25,13,889,925,1814,1856
0132-000,2011,10,25,14,925,948,1873,1814
0132-000,2011,10,25,15,1064,996,2060,1873
0132-000,2011,10,25,16,1114,974,2088,2060
0132-000,2011,10,25,17,1102,947,2049,2088
0132-000,2011,10,25,18,1245,940,2185,2049
0132-000,2011,10,25,19,1293,917,2210,2185
0132-000,2011,10,25,20,925,776,1701,2210
0132-000,2011,10,25,21,799,631,1430,1701
0132-000,2011,10,25,22,675,489,1164,1430
0132-000,2011,10,25,23,421,355,776,1164
0132-000,2011,10,25,24,241,227,468,776
0132-000,2011,10,26,1,169,197,366,468
0132-000,2011,10,26,2,116,118,234,366
0132-000,2011,10,26,3,84,101,185,234
0132-000,2011,10,26,4,88,98,186,185
0132-000,2011,10,26,5,102,107,209,186
0132-000,2011,10,26,6,195,167,362,209
0132-000,2011,10,26,7,417,458,875,362
0132-000,2011,10,26,8,805,1468,2273,875
0132-000,2011,10,26,9,860,1444,2304,2273
0132-000,2011,10,26,10,883,1042,1925,2304
0132-000,2011,10,26,11,891,1073,1964,1925
0132-000,2011,10,26,12,900,987,1887,1964
0132-000,2011,10,26,13,863,868,1731,1887
0132-000,2011,10,26,14,950,1041,1991,1731
0132-000,2011,10,26,15,1010,1021,2031,1991
0132-000,2011,10,26,16,1172,937,2109,2031
0132-000,2011,10,26,17,1116,963,2079,2109
0132-000,2011,10,26,18,1311,1003,2314,2079
0132-000,2011,10,26,19,1252,883,2135,2314
0132-000,2011,10,26,20,970,724,1694,2135
0132-000,2011,10,26,21,754,585,1339,1694
0132-000,2011,10,26,22,620,480,1100,1339
0132-000,2011,10,26,23,391,373,764,1100
0132-000,2011,10,26,24,228,255,483,764
0132-000,2011,10,27,1,163,177,340,483
0132-000,2011,10,27,2,116,118,234,340
0132-000,2011,10,27,3,79,101,180,234
0132-000,2011,10,27,4,93,122,215,180
0132-000,2011,10,27,5,90,118,208,215
0132-000,2011,10,27,6,192,171,363,208
0132-000,2011,10,27,7,382,471,853,363
0132-000,2011,10,27,8,844,1409,2253,853
0132-000,2011,10,27,9,858,1378,2236,2253
0132-000,2011,10,27,10,916,1081,1997,2236
0132-000,2011,10,27,11,849,966,1815,1997
0132-000,2011,10,27,12,919,869,1788,1815
0132-000,2011,10,27,13,829,855,1684,1788
0132-000,2011,10,27,14,885,997,1882,1684
0132-000,2011,10,27,15,1014,1000,2014,1882
0132-000,2011,10,27,16,1083,992,2075,2014
0132-000,2011,10,27,17,1094,976,2070,2075
0132-000,2011,10,27,18,1230,980,2210,2070
0132-000,2011,10,27,19,1297,877,2174,2210
0132-000,2011,10,27,20,901,677,1578,2174
0132-000,2011,10,27,21,806,590,1396,1578
0132-000,2011,10,27,22,631,484,1115,1396
0132-000,2011,10,27,23,395,366,761,1115
0132-000,2011,10,27,24,249,278,527,761
0132-000,2011,10,28,1,198,176,374,527
0132-000,2011,10,28,2,141,148,289,374
0132-000,2011,10,28,3,107,112,219,289
0132-000,2011,10,28,4,86,102,188,219
0132-000,2011,10,28,5,100,127,227,188
0132-000,2011,10,28,6,196,165,361,227
0132-000,2011,10,28,7,445,469,914,361
0132-000,2011,10,28,8,795,1448,2243,914
0132-000,2011,10,28,9,903,1393,2296,2243
0132-000,2011,10,28,10,864,985,1849,2296
0132-000,2011,10,28,11,934,1039,1973,1849
0132-000,2011,10,28,12,918,970,1888,1973
0132-000,2011,10,28,13,794,865,1659,1888
0132-000,2011,10,28,14,943,1013,1956,1659
0132-000,2011,10,28,15,1078,1026,2104,1956
0132-000,2011,10,28,16,1092,998,2090,2104
0132-000,2011,10,28,17,1181,997,2178,2090
0132-000,2011,10,28,18,1275,998,2273,2178
0132-000,2011,10,28,19,1520,940,2460,2273
0132-000,2011,10,28,20,1074,799,1873,2460
0132-000,2011,10,28,21,821,633,1454,1873
0132-000,2011,10,28,22,696,581,1277,1454
0132-000,2011,10,28,23,466,464,930,1277
0132-000,2011,10,28,24,304,308,612,930
0132-000,2011,10,29,1,221,280,501,612
0132-000,2011,10,29,2,187,178,365,501
0132-000,2011,10,29,3,110,146,256,365
0132-000,2011,10,29,4,106,116,222,256
0132-000,2011,10,29,5,104,122,226,222
0132-000,2011,10,29,6,170,147,317,226
0132-000,2011,10,29,7,318,311,629,317
0132-000,2011,10,29,8,602,804,1406,629
0132-000,2011,10,29,9,780,902,1682,1406
0132-000,2011,10,29,10,735,889,1624,1682
0132-000,2011,10,29,11,841,1199,2040,1624
0132-000,2011,10,29,12,956,1520,2476,2040
0132-000,2011,10,29,13,1139,1704,2843,2476
0132-000,2011,10,29,14,995,1602,2597,2843
0132-000,2011,10,29,15,950,1566,2516,2597
0132-000,2011,10,29,16,1011,1539,2550,2516
0132-000,2011,10,29,17,1071,1620,2691,2550
0132-000,2011,10,29,18,1405,1520,2925,2691
0132-000,2011,10,29,19,1319,1247,2566,2925
0132-000,2011,10,29,20,1045,814,1859,2566
0132-000,2011,10,29,21,768,648,1416,1859
0132-000,2011,10,29,22,600,501,1101,1416
0132-000,2011,10,29,23,431,399,830,1101
0132-000,2011,10,29,24,236,304,540,830
0132-000,2011,10,30,1,222,216,438,540
0132-000,2011,10,30,2,150,158,308,438
0132-000,2011,10,30,3,96,122,218,308
0132-000,2011,10,30,4,95,84,179,218
0132-000,2011,10,30,5,96,107,203,179
0132-000,2011,10,30,6,128,117,245,203
0132-000,2011,10,30,7,202,226,428,245
0132-000,2011,10,30,8,326,402,728,428
0132-000,2011,10,30,9,497,533,1030,728
0132-000,2011,10,30,10,537,601,1138,1030
0132-000,2011,10,30,11,692,781,1473,1138
0132-000,2011,10,30,12,669,718,1387,1473
0132-000,2011,10,30,13,701,733,1434,1387
0132-000,2011,10,30,14,811,807,1618,1434
0132-000,2011,10,30,15,1012,709,1721,1618
0132-000,2011,10,30,16,1483,853,2336,1721
0132-000,2011,10,30,17,1551,829,2380,2336
0132-000,2011,10,30,18,1673,838,2511,2380
0132-000,2011,10,30,19,1586,683,2269,2511
0132-000,2011,10,30,20,1421,603,2024,2269
0132-000,2011,10,30,21,1193,536,1729,2024
0132-000,2011,10,30,22,1111,455,1566,1729
0132-000,2011,10,30,23,769,395,1164,1566
0132-000,2011,10,30,24,295,277,572,1164
0132-000,2011,10,31,1,134,152,286,572
0132-000,2011,10,31,2,96,97,193,286
0132-000,2011,10,31,3,65,81,146,193
0132-000,2011,10,31,4,53,74,127,146
0132-000,2011,10,31,5,92,105,197,127
0132-000,2011,10,31,6,190,223,413,197
0132-000,2011,10,31,7,508,613,1121,413
0132-000,2011,10,31,8,824,1681,2505,1121
0132-000,2011,10,31,9,882,1469,2351,2505
0132-000,2011,10,31,10,846,1061,1907,2351
0132-000,2011,10,31,11,905,1044,1949,1907
0132-000,2011,10,31,12,885,934,1819,1949
0132-000,2011,10,31,13,832,876,1708,1819
0132-000,2011,10,31,14,869,1019,1888,1708
0132-000,2011,10,31,15,1029,1014,2043,1888
0132-000,2011,10,31,16,1011,937,1948,2043
0132-000,2011,10,31,17,1088,959,2047,1948
0132-000,2011,10,31,18,1203,1023,2226,2047
0132-000,2011,10,31,19,1299,915,2214,2226
0132-000,2011,10,31,20,920,715,1635,2214
0132-000,2011,10,31,21,778,616,1394,1635
0132-000,2011,10,31,22,611,515,1126,1394
0132-000,2011,10,31,23,383,337,720,1126
0132-000,2011,10,31,24,237,242,479,720
0132-000,2011,11,1,1,179,189,368,479
0132-000,2011,11,1,2,142,130,272,368
0132-000,2011,11,1,3,97,105,202,272
0132-000,2011,11,1,4,92,115,207,202
0132-000,2011,11,1,5,94,128,222,207
0132-000,2011,11,1,6,179,179,358,222
0132-000,2011,11,1,7,444,443,887,358
0132-000,2011,11,1,8,823,1466,2289,887
0132-000,2011,11,1,9,854,1336,2190,2289
0132-000,2011,11,1,10,819,1055,1874,2190
0132-000,2011,11,1,11,911,956,1867,1874
0132-000,2011,11,1,12,805,921,1726,1867
0132-000,2011,11,1,13,809,885,1694,1726
0132-000,2011,11,1,14,856,1024,1880,1694
0132-000,2011,11,1,15,1021,1030,2051,1880
0132-000,2011,11,1,16,1025,938,1963,2051
0132-000,2011,11,1,17,1091,924,2015,1963
0132-000,2011,11,1,18,1194,873,2067,2015
0132-000,2011,11,1,19,1257,857,2114,2067
0132-000,2011,11,1,20,855,695,1550,2114
0132-000,2011,11,1,21,721,585,1306,1550
0132-000,2011,11,1,22,639,479,1118,1306
0132-000,2011,11,1,23,366,377,743,1118
0132-000,2011,11,1,24,249,218,467,743
0132-000,2011,11,2,1,167,206,373,467
0132-000,2011,11,2,2,132,111,243,373
0132-000,2011,11,2,3,87,96,183,243
0132-000,2011,11,2,4,66,102,168,183
0132-000,2011,11,2,5,104,105,209,168
0132-000,2011,11,2,6,190,169,359,209
0132-000,2011,11,2,7,440,468,908,359
0132-000,2011,11,2,8,782,1473,2255,908
0132-000,2011,11,2,9,857,1404,2261,2255
0132-000,2011,11,2,10,817,989,1806,2261
0132-000,2011,11,2,11,874,971,1845,1806
0132-000,2011,11,2,12,896,927,1823,1845
0132-000,2011,11,2,13,824,892,1716,1823
0132-000,2011,11,2,14,885,910,1795,1716
0132-000,2011,11,2,15,980,980,1960,1795
0132-000,2011,11,2,16,1074,939,2013,1960
0132-000,2011,11,2,17,1091,925,2016,2013
0132-000,2011,11,2,18,1255,934,2189,2016
0132-000,2011,11,2,19,1227,862,2089,2189
0132-000,2011,11,2,20,847,733,1580,2089
0132-000,2011,11,2,21,716,549,1265,1580
0132-000,2011,11,2,22,613,531,1144,1265
0132-000,2011,11,2,23,398,346,744,1144
0132-000,2011,11,2,24,215,251,466,744
0132-000,2011,11,3,1,211,179,390,466
0132-000,2011,11,3,2,122,143,265,390
0132-000,2011,11,3,3,89,94,183,265
0132-000,2011,11,3,4,82,97,179,183
0132-000,2011,11,3,5,101,109,210,179
0132-000,2011,11,3,6,193,169,362,210
0132-000,2011,11,3,7,422,424,846,362
0132-000,2011,11,3,8,798,1413,2211,846
0132-000,2011,11,3,9,949,1369,2318,2211
0132-000,2011,11,3,10,893,1096,1989,2318
0132-000,2011,11,3,11,893,967,1860,1989
0132-000,2011,11,3,12,916,918,1834,1860
0132-000,2011,11,3,13,825,897,1722,1834
0132-000,2011,11,3,14,960,972,1932,1722
0132-000,2011,11,3,15,1007,980,1987,1932
0132-000,2011,11,3,16,989,945,1934,1987
0132-000,2011,11,3,17,1135,895,2030,1934
0132-000,2011,11,3,18,1153,982,2135,2030
0132-000,2011,11,3,19,1248,848,2096,2135
0132-000,2011,11,3,20,873,720,1593,2096
0132-000,2011,11,3,21,769,553,1322,1593
0132-000,2011,11,3,22,672,482,1154,1322
0132-000,2011,11,3,23,385,385,770,1154
0132-000,2011,11,3,24,226,252,478,770
0132-000,2011,11,4,1,168,211,379,478
0132-000,2011,11,4,2,123,120,243,379
0132-000,2011,11,4,3,78,135,213,243
0132-000,2011,11,4,4,98,98,196,213
0132-000,2011,11,4,5,112,113,225,196
0132-000,2011,11,4,6,193,188,381,225
0132-000,2011,11,4,7,448,459,907,381
0132-000,2011,11,4,8,805,1457,2262,907
0132-000,2011,11,4,9,930,1303,2233,2262
0132-000,2011,11,4,10,848,998,1846,2233
0132-000,2011,11,4,11,936,973,1909,1846
0132-000,2011,11,4,12,887,967,1854,1909
0132-000,2011,11,4,13,823,988,1811,1854
0132-000,2011,11,4,14,1016,980,1996,1811
0132-000,2011,11,4,15,1027,1045,2072,1996
0132-000,2011,11,4,16,1078,1003,2081,2072
0132-000,2011,11,4,17,1217,1001,2218,2081
0132-000,2011,11,4,18,1305,1046,2351,2218
0132-000,2011,11,4,19,1499,1017,2516,2351
0132-000,2011,11,4,20,1164,851,2015,2516
0132-000,2011,11,4,21,854,654,1508,2015
0132-000,2011,11,4,22,714,570,1284,1508
0132-000,2011,11,4,23,472,419,891,1284
0132-000,2011,11,4,24,311,303,614,891
0132-000,2011,11,5,1,226,235,461,614
0132-000,2011,11,5,2,168,178,346,461
0132-000,2011,11,5,3,118,152,270,346
0132-000,2011,11,5,4,92,105,197,270
0132-000,2011,11,5,5,111,123,234,197
0132-000,2011,11,5,6,165,149,314,234
0132-000,2011,11,5,7,324,272,596,314
0132-000,2011,11,5,8,582,815,1397,596
0132-000,2011,11,5,9,799,986,1785,1397
0132-000,2011,11,5,10,815,994,1809,1785
0132-000,2011,11,5,11,824,1329,2153,1809
0132-000,2011,11,5,12,895,1461,2356,2153
0132-000,2011,11,5,13,960,1564,2524,2356
0132-000,2011,11,5,14,963,1520,2483,2524
0132-000,2011,11,5,15,1129,1538,2667,2483
0132-000,2011,11,5,16,1225,1583,2808,2667
0132-000,2011,11,5,17,1377,1468,2845,2808
0132-000,2011,11,5,18,1709,1415,3124,2845
0132-000,2011,11,5,19,1569,1232,2801,3124
0132-000,2011,11,5,20,1268,915,2183,2801
0132-000,2011,11,5,21,761,690,1451,2183
0132-000,2011,11,5,22,571,524,1095,1451
0132-000,2011,11,5,23,349,381,730,1095
0132-000,2011,11,5,24,268,256,524,730
0132-000,2011,11,6,1,199,249,448,524
0132-000,2011,11,6,2,135,132,267,448
0132-000,2011,11,6,3,93,102,195,267
0132-000,2011,11,6,4,108,105,213,195
0132-000,2011,11,6,5,81,111,192,213
0132-000,2011,11,6,6,110,106,216,192
0132-000,2011,11,6,7,194,209,403,216
0132-000,2011,11,6,8,287,390,677,403
0132-000,2011,11,6,9,393,539,932,677
0132-000,2011,11,6,10,501,608,1109,932
0132-000,2011,11,6,11,627,715,1342,1109
0132-000,2011,11,6,12,629,676,1305,1342
0132-000,2011,11,6,13,905,735,1640,1305
0132-000,2011,11,6,14,936,700,1636,1640
0132-000,2011,11,6,15,1186,736,1922,1636
0132-000,2011,11,6,16,1368,769,2137,1922
0132-000,2011,11,6,17,1431,758,2189,2137
0132-000,2011,11,6,18,1520,723,2243,2189
0132-000,2011,11,6,19,1631,653,2284,2243
0132-000,2011,11,6,20,1438,558,1996,2284
0132-000,2011,11,6,21,1322,542,1864,1996
0132-000,2011,11,6,22,1166,448,1614,1864
0132-000,2011,11,6,23,759,330,1089,1614
0132-000,2011,11,6,24,292,287,579,1089
0132-000,2011,11,7,1,169,170,339,579
0132-000,2011,11,7,2,92,108,200,339
0132-000,2011,11,7,3,57,81,138,200
0132-000,2011,11,7,4,54,79,133,138
0132-000,2011,11,7,5,79,98,177,133
0132-000,2011,11,7,6,188,226,414,177
0132-000,2011,11,7,7,471,615,1086,414
0132-000,2011,11,7,8,888,1620,2508,1086
0132-000,2011,11,7,9,844,1436,2280,2508
0132-000,2011,11,7,10,829,992,1821,2280
0132-000,2011,11,7,11,827,1033,1860,1821
0132-000,2011,11,7,12,840,933,1773,1860
0132-000,2011,11,7,13,848,900,1748,1773
0132-000,2011,11,7,14,869,1007,1876,1748
0132-000,2011,11,7,15,1005,1007,2012,1876
0132-000,2011,11,7,16,960,907,1867,2012
0132-000,2011,11,7,17,1097,904,2001,1867
0132-000,2011,11,7,18,1225,977,2202,2001
0132-000,2011,11,7,19,1205,852,2057,2202
0132-000,2011,11,7,20,822,661,1483,2057
0132-000,2011,11,7,21,713,578,1291,1483
0132-000,2011,11,7,22,599,480,1079,1291
0132-000,2011,11,7,23,407,338,745,1079
0132-000,2011,11,7,24,216,213,429,745
0132-000,2011,11,8,1,154,157,311,429
0132-000,2011,11,8,2,121,120,241,311
0132-000,2011,11,8,3,93,90,183,241
0132-000,2011,11,8,4,77,86,163,183
0132-000,2011,11,8,5,101,124,225,163
0132-000,2011,11,8,6,196,177,373,225
0132-000,2011,11,8,7,428,437,865,373
0132-000,2011,11,8,8,799,1429,2228,865
0132-000,2011,11,8,9,879,1487,2366,2228
0132-000,2011,11,8,10,837,1052,1889,2366
0132-000,2011,11,8,11,928,1014,1942,1889
0132-000,2011,11,8,12,899,904,1803,1942
0132-000,2011,11,8,13,806,851,1657,1803
0132-000,2011,11,8,14,917,950,1867,1657
0132-000,2011,11,8,15,990,988,1978,1867
0132-000,2011,11,8,16,1084,961,2045,1978
0132-000,2011,11,8,17,1080,888,1968,2045
0132-000,2011,11,8,18,1240,891,2131,1968
0132-000,2011,11,8,19,1238,899,2137,2131
0132-000,2011,11,8,20,819,646,1465,2137
0132-000,2011,11,8,21,826,594,1420,1465
0132-000,2011,11,8,22,634,482,1116,1420
0132-000,2011,11,8,23,396,308,704,1116
0132-000,2011,11,8,24,258,233,491,704
0132-000,2011,11,9,1,187,173,360,491
0132-000,2011,11,9,2,132,138,270,360
0132-000,2011,11,9,3,94,99,193,270
0132-000,2011,11,9,4,79,96,175,193
0132-000,2011,11,9,5,107,101,208,175
0132-000,2011,11,9,6,167,145,312,208
0132-000,2011,11,9,7,428,431,859,312
0132-000,2011,11,9,8,820,1446,2266,859
0132-000,2011,11,9,9,894,1363,2257,2266
0132-000,2011,11,9,10,843,995,1838,2257
0132-000,2011,11,9,11,866,955,1821,1838
0132-000,2011,11,9,12,762,923,1685,1821
0132-000,2011,11,9,13,756,821,1577,1685
0132-000,2011,11,9,14,893,998,1891,1577
0132-000,2011,11,9,15,1031,975,2006,1891
0132-000,2011,11,9,16,1132,930,2062,2006
0132-000,2011,11,9,17,1113,959,2072,2062
0132-000,2011,11,9,18,1245,920,2165,2072
0132-000,2011,11,9,19,1291,869,2160,2165
0132-000,2011,11,9,20,880,706,1586,2160
0132-000,2011,11,9,21,716,594,1310,1586
0132-000,2011,11,9,22,571,527,1098,1310
0132-000,2011,11,9,23,375,341,716,1098
0132-000,2011,11,9,24,274,265,539,716
0132-000,2011,11,10,1,194,173,367,539
0132-000,2011,11,10,2,119,142,261,367
0132-000,2011,11,10,3,99,113,212,261
0132-000,2011,11,10,4,101,109,210,212
0132-000,2011,11,10,5,97,127,224,210
0132-000,2011,11,10,6,221,165,386,224
0132-000,2011,11,10,7,437,470,907,386
0132-000,2011,11,10,8,788,1381,2169,907
0132-000,2011,11,10,9,853,1377,2230,2169
0132-000,2011,11,10,10,921,1076,1997,2230
0132-000,2011,11,10,11,974,1059,2033,1997
0132-000,2011,11,10,12,911,900,1811,2033
0132-000,2011,11,10,13,794,840,1634,1811
0132-000,2011,11,10,14,867,970,1837,1634
0132-000,2011,11,10,15,1004,978,1982,1837
0132-000,2011,11,10,16,1100,962,2062,1982
0132-000,2011,11,10,17,1131,949,2080,2062
0132-000,2011,11,10,18,1224,927,2151,2080
0132-000,2011,11,10,19,1330,971,2301,2151
0132-000,2011,11,10,20,905,681,1586,2301
0132-000,2011,11,10,21,729,597,1326,1586
0132-000,2011,11,10,22,648,498,1146,1326
0132-000,2011,11,10,23,438,330,768,1146
0132-000,2011,11,10,24,253,283,536,768
0132-000,2011,11,11,1,205,205,410,536
0132-000,2011,11,11,2,121,146,267,410
0132-000,2011,11,11,3,87,99,186,267
0132-000,2011,11,11,4,100,107,207,186
0132-000,2011,11,11,5,96,114,210,207
0132-000,2011,11,11,6,175,168,343,210
0132-000,2011,11,11,7,409,396,805,343
0132-000,2011,11,11,8,778,1380,2158,805
0132-000,2011,11,11,9,861,1311,2172,2158
0132-000,2011,11,11,10,857,1000,1857,2172
0132-000,2011,11,11,11,880,1014,1894,1857
0132-000,2011,11,11,12,874,944,1818,1894
0132-000,2011,11,11,13,891,932,1823,1818
0132-000,2011,11,11,14,972,983,1955,1823
0132-000,2011,11,11,15,1058,1059,2117,1955
0132-000,2011,11,11,16,1088,975,2063,2117
0132-000,2011,11,11,17,1166,969,2135,2063
0132-000,2011,11,11,18,1335,1008,2343,2135
0132-000,2011,11,11,19,1487,921,2408,2343
0132-000,2011,11,11,20,1113,904,2017,2408
0132-000,2011,11,11,21,846,731,1577,2017
0132-000,2011,11,11,22,747,604,1351,1577
0132-000,2011,11,11,23,492,523,1015,1351
0132-000,2011,11,11,24,306,367,673,1015
0132-000,2011,11,12,1,251,302,553,673
0132-000,2011,11,12,2,178,203,381,553
0132-000,2011,11,12,3,131,149,280,381
0132-000,2011,11,12,4,119,124,243,280
0132-000,2011,11,12,5,110,142,252,243
0132-000,2011,11,12,6,208,195,403,252
0132-000,2011,11,12,7,356,383,739,403
0132-000,2011,11,12,8,585,829,1414,739
0132-000,2011,11,12,9,777,1065,1842,1414
0132-000,2011,11,12,10,784,1115,1899,1842
0132-000,2011,11,12,11,890,1541,2431,1899
0132-000,2011,11,12,12,1020,1836,2856,2431
0132-000,2011,11,12,13,1071,1887,2958,2856
0132-000,2011,11,12,14,1034,1851,2885,2958
0132-000,2011,11,12,15,1076,1947,3023,2885
0132-000,2011,11,12,16,1151,1824,2975,3023
0132-000,2011,11,12,17,1408,1742,3150,2975
0132-000,2011,11,12,18,1721,1738,3459,3150
0132-000,2011,11,12,19,1617,1523,3140,3459
0132-000,2011,11,12,20,1349,1214,2563,3140
0132-000,2011,11,12,21,1109,965,2074,2563
0132-000,2011,11,12,22,691,652,1343,2074
0132-000,2011,11,12,23,404,429,833,1343
0132-000,2011,11,12,24,269,316,585,833
0132-000,2011,11,13,1,186,226,412,585
0132-000,2011,11,13,2,142,133,275,412
0132-000,2011,11,13,3,115,121,236,275
0132-000,2011,11,13,4,88,96,184,236
0132-000,2011,11,13,5,90,127,217,184
0132-000,2011,11,13,6,140,153,293,217
0132-000,2011,11,13,7,224,278,502,293
0132-000,2011,11,13,8,302,447,749,502
0132-000,2011,11,13,9,528,650,1178,749
0132-000,2011,11,13,10,542,639,1181,1178
0132-000,2011,11,13,11,652,693,1345,1181
0132-000,2011,11,13,12,746,724,1470,1345
0132-000,2011,11,13,13,1157,722,1879,1470
0132-000,2011,11,13,14,1317,745,2062,1879
0132-000,2011,11,13,15,1510,820,2330,2062
0132-000,2011,11,13,16,1653,880,2533,2330
0132-000,2011,11,13,17,1760,795,2555,2533
0132-000,2011,11,13,18,1874,817,2691,2555
0132-000,2011,11,13,19,1857,668,2525,2691
0132-000,2011,11,13,20,1822,618,2440,2525
0132-000,2011,11,13,21,1755,585,2340,2440
0132-000,2011,11,13,22,1330,500,1830,2340
0132-000,2011,11,13,23,1367,394,1761,1830
0132-000,2011,11,13,24,1365,266,1631,1761
0132-000,2011,11,14,1,325,200,525,1631
0132-000,2011,11,14,2,100,95,195,525
0132-000,2011,11,14,3,77,81,158,195
0132-000,2011,11,14,4,63,92,155,158
0132-000,2011,11,14,5,104,108,212,155
0132-000,2011,11,14,6,199,221,420,212
0132-000,2011,11,14,7,499,610,1109,420
0132-000,2011,11,14,8,835,1637,2472,1109
0132-000,2011,11,14,9,786,1470,2256,2472
0132-000,2011,11,14,10,820,1035,1855,2256
0132-000,2011,11,14,11,875,990,1865,1855
0132-000,2011,11,14,12,918,961,1879,1865
0132-000,2011,11,14,13,806,870,1676,1879
0132-000,2011,11,14,14,910,1000,1910,1676
0132-000,2011,11,14,15,1043,991,2034,1910
0132-000,2011,11,14,16,1062,939,2001,2034
0132-000,2011,11,14,17,1128,976,2104,2001
0132-000,2011,11,14,18,1253,966,2219,2104
0132-000,2011,11,14,19,1224,931,2155,2219
0132-000,2011,11,14,20,878,696,1574,2155
0132-000,2011,11,14,21,793,586,1379,1574
0132-000,2011,11,14,22,594,464,1058,1379
0132-000,2011,11,14,23,393,314,707,1058
0132-000,2011,11,14,24,210,217,427,707
0132-000,2011,11,15,1,155,180,335,427
0132-000,2011,11,15,2,110,118,228,335
0132-000,2011,11,15,3,72,88,160,228
0132-000,2011,11,15,4,76,102,178,160
0132-000,2011,11,15,5,77,105,182,178
0132-000,2011,11,15,6,200,160,360,182
0132-000,2011,11,15,7,429,437,866,360
0132-000,2011,11,15,8,774,1438,2212,866
0132-000,2011,11,15,9,862,1420,2282,2212
0132-000,2011,11,15,10,768,1080,1848,2282
0132-000,2011,11,15,11,839,943,1782,1848
0132-000,2011,11,15,12,856,945,1801,1782
0132-000,2011,11,15,13,850,865,1715,1801
0132-000,2011,11,15,14,928,961,1889,1715
0132-000,2011,11,15,15,899,903,1802,1889
0132-000,2011,11,15,16,1121,988,2109,1802
0132-000,2011,11,15,17,1105,898,2003,2109
0132-000,2011,11,15,18,1284,944,2228,2003
0132-000,2011,11,15,19,1225,884,2109,2228
0132-000,2011,11,15,20,870,692,1562,2109
0132-000,2011,11,15,21,784,596,1380,1562
0132-000,2011,11,15,22,650,517,1167,1380
0132-000,2011,11,15,23,409,343,752,1167
0132-000,2011,11,15,24,239,226,465,752
0132-000,2011,11,16,1,157,193,350,465
0132-000,2011,11,16,2,128,141,269,350
0132-000,2011,11,16,3,82,107,189,269
0132-000,2011,11,16,4,84,114,198,189
0132-000,2011,11,16,5,115,103,218,198
0132-000,2011,11,16,6,178,172,350,218
0132-000,2011,11,16,7,371,443,814,350
0132-000,2011,11,16,8,738,1355,2093,814
0132-000,2011,11,16,9,829,1455,2284,2093
0132-000,2011,11,16,10,834,1093,1927,2284
0132-000,2011,11,16,11,853,960,1813,1927
0132-000,2011,11,16,12,890,898,1788,1813
0132-000,2011,11,16,13,805,829,1634,1788
0132-000,2011,11,16,14,881,973,1854,1634
0132-000,2011,11,16,15,901,981,1882,1854
0132-000,2011,11,16,16,1188,941,2129,1882
0132-000,2011,11,16,17,1182,914,2096,2129
0132-000,2011,11,16,18,1326,939,2265,2096
0132-000,2011,11,16,19,1310,901,2211,2265
0132-000,2011,11,16,20,903,727,1630,2211
0132-000,2011,11,16,21,741,572,1313,1630
0132-000,2011,11,16,22,639,527,1166,1313
0132-000,2011,11,16,23,378,370,748,1166
0132-000,2011,11,16,24,266,251,517,748
0132-000,2011,11,17,1,175,208,383,517
0132-000,2011,11,17,2,118,136,254,383
0132-000,2011,11,17,3,96,92,188,254
0132-000,2011,11,17,4,95,118,213,188
0132-000,2011,11,17,5,102,107,209,213
0132-000,2011,11,17,6,184,161,345,209
0132-000,2011,11,17,7,427,473,900,345
0132-000,2011,11,17,8,772,1376,2148,900
0132-000,2011,11,17,9,846,1430,2276,2148
0132-000,2011,11,17,10,867,1021,1888,2276
0132-000,2011,11,17,11,887,967,1854,1888
0132-000,2011,11,17,12,908,929,1837,1854
0132-000,2011,11,17,13,875,773,1648,1837
0132-000,2011,11,17,14,916,1017,1933,1648
0132-000,2011,11,17,15,1044,977,2021,1933
0132-000,2011,11,17,16,1064,985,2049,2021
0132-000,2011,11,17,17,1111,911,2022,2049
0132-000,2011,11,17,18,1240,939,2179,2022
0132-000,2011,11,17,19,1227,922,2149,2179
0132-000,2011,11,17,20,887,697,1584,2149
0132-000,2011,11,17,21,771,513,1284,1584
0132-000,2011,11,17,22,701,495,1196,1284
0132-000,2011,11,17,23,406,383,789,1196
0132-000,2011,11,17,24,255,279,534,789
0132-000,2011,11,18,1,180,198,378,534
0132-000,2011,11,18,2,148,128,276,378
0132-000,2011,11,18,3,96,118,214,276
0132-000,2011,11,18,4,96,112,208,214
0132-000,2011,11,18,5,88,117,205,208
0132-000,2011,11,18,6,170,139,309,205
0132-000,2011,11,18,7,372,342,714,309
0132-000,2011,11,18,8,757,1267,2024,714
0132-000,2011,11,18,9,825,1318,2143,2024
0132-000,2011,11,18,10,828,983,1811,2143
0132-000,2011,11,18,11,895,978,1873,1811
0132-000,2011,11,18,12,908,959,1867,1873
0132-000,2011,11,18,13,825,841,1666,1867
0132-000,2011,11,18,14,970,978,1948,1666
0132-000,2011,11,18,15,942,1041,1983,1948
0132-000,2011,11,18,16,974,943,1917,1983
0132-000,2011,11,18,17,1059,997,2056,1917
0132-000,2011,11,18,18,1274,1044,2318,2056
0132-000,2011,11,18,19,1513,994,2507,2318
0132-000,2011,11,18,20,1005,833,1838,2507
0132-000,2011,11,18,21,826,643,1469,1838
0132-000,2011,11,18,22,720,570,1290,1469
0132-000,2011,11,18,23,484,446,930,1290
0132-000,2011,11,18,24,292,276,568,930
0132-000,2011,11,19,1,197,237,434,568
0132-000,2011,11,19,2,155,194,349,434
0132-000,2011,11,19,3,120,142,262,349
0132-000,2011,11,19,4,91,113,204,262
0132-000,2011,11,19,5,108,108,216,204
0132-000,2011,11,19,6,173,169,342,216
0132-000,2011,11,19,7,324,319,643,342
0132-000,2011,11,19,8,541,770,1311,643
0132-000,2011,11,19,9,794,973,1767,1311
0132-000,2011,11,19,10,776,1026,1802,1767
0132-000,2011,11,19,11,933,1365,2298,1802
0132-000,2011,11,19,12,962,1462,2424,2298
0132-000,2011,11,19,13,930,1556,2486,2424
0132-000,2011,11,19,14,1056,1492,2548,2486
0132-000,2011,11,19,15,1059,1626,2685,2548
0132-000,2011,11,19,16,1144,1678,2822,2685
0132-000,2011,11,19,17,1369,1648,3017,2822
0132-000,2011,11,19,18,1637,1660,3297,3017
0132-000,2011,11,19,19,1547,1575,3122,3297
0132-000,2011,11,19,20,1288,1168,2456,3122
0132-000,2011,11,19,21,746,896,1642,2456
0132-000,2011,11,19,22,583,619,1202,1642
0132-000,2011,11,19,23,485,372,857,1202
0132-000,2011,11,19,24,294,306,600,857
0132-000,2011,11,20,1,191,250,441,600
0132-000,2011,11,20,2,129,157,286,441
0132-000,2011,11,20,3,122,121,243,286
0132-000,2011,11,20,4,92,111,203,243
0132-000,2011,11,20,5,107,81,188,203
0132-000,2011,11,20,6,132,147,279,188
0132-000,2011,11,20,7,223,248,471,279
0132-000,2011,11,20,8,321,403,724,471
0132-000,2011,11,20,9,445,513,958,724
0132-000,2011,11,20,10,523,567,1090,958
0132-000,2011,11,20,11,634,677,1311,1090
0132-000,2011,11,20,12,801,737,1538,1311
0132-000,2011,11,20,13,1071,757,1828,1538
0132-000,2011,11,20,14,1292,702,1994,1828
0132-000,2011,11,20,15,1396,812,2208,1994
0132-000,2011,11,20,16,1639,829,2468,2208
0132-000,2011,11,20,17,1882,843,2725,2468
0132-000,2011,11,20,18,1985,823,2808,2725
0132-000,2011,11,20,19,1708,755,2463,2808
0132-000,2011,11,20,20,1638,579,2217,2463
0132-000,2011,11,20,21,1558,541,2099,2217
0132-000,2011,11,20,22,1496,489,1985,2099
0132-000,2011,11,20,23,1359,363,1722,1985
0132-000,2011,11,20,24,644,275,919,1722
0132-000,2011,11,21,1,172,186,358,919
0132-000,2011,11,21,2,68,107,175,358
0132-000,2011,11,21,3,62,61,123,175
0132-000,2011,11,21,4,59,85,144,123
0132-000,2011,11,21,5,99,89,188,144
0132-000,2011,11,21,6,183,209,392,188
0132-000,2011,11,21,7,504,616,1120,392
0132-000,2011,11,21,8,856,1623,2479,1120
0132-000,2011,11,21,9,879,1497,2376,2479
0132-000,2011,11,21,10,766,1015,1781,2376
0132-000,2011,11,21,11,843,981,1824,1781
0132-000,2011,11,21,12,852,928,1780,1824
0132-000,2011,11,21,13,766,901,1667,1780
0132-000,2011,11,21,14,887,946,1833,1667
0132-000,2011,11,21,15,1026,1066,2092,1833
0132-000,2011,11,21,16,1095,918,2013,2092
0132-000,2011,11,21,17,1112,962,2074,2013
0132-000,2011,11,21,18,1247,958,2205,2074
0132-000,2011,11,21,19,1246,910,2156,2205
0132-000,2011,11,21,20,875,693,1568,2156
0132-000,2011,11,21,21,717,524,1241,1568
0132-000,2011,11,21,22,607,494,1101,1241
0132-000,2011,11,21,23,349,329,678,1101
0132-000,2011,11,21,24,252,236,488,678
0132-000,2011,11,22,1,149,184,333,488
0132-000,2011,11,22,2,107,109,216,333
0132-000,2011,11,22,3,81,94,175,216
0132-000,2011,11,22,4,89,96,185,175
0132-000,2011,11,22,5,75,99,174,185
0132-000,2011,11,22,6,196,156,352,174
0132-000,2011,11,22,7,395,431,826,352
0132-000,2011,11,22,8,796,1405,2201,826
0132-000,2011,11,22,9,878,1463,2341,2201
0132-000,2011,11,22,10,860,1081,1941,2341
0132-000,2011,11,22,11,847,972,1819,1941
0132-000,2011,11,22,12,868,954,1822,1819
0132-000,2011,11,22,13,775,860,1635,1822
0132-000,2011,11,22,14,931,905,1836,1635
0132-000,2011,11,22,15,1031,1021,2052,1836
0132-000,2011,11,22,16,1045,925,1970,2052
0132-000,2011,11,22,17,1125,892,2017,1970
0132-000,2011,11,22,18,1272,890,2162,2017
0132-000,2011,11,22,19,1184,927,2111,2162
0132-000,2011,11,22,20,919,686,1605,2111
0132-000,2011,11,22,21,774,504,1278,1605
0132-000,2011,11,22,22,613,516,1129,1278
0132-000,2011,11,22,23,375,387,762,1129
0132-000,2011,11,22,24,222,213,435,762
0132-000,2011,11,23,1,181,170,351,435
0132-000,2011,11,23,2,120,115,235,351
0132-000,2011,11,23,3,100,93,193,235
0132-000,2011,11,23,4,76,111,187,193
0132-000,2011,11,23,5,96,91,187,187
0132-000,2011,11,23,6,153,148,301,187
0132-000,2011,11,23,7,385,387,772,301
0132-000,2011,11,23,8,750,1345,2095,772
0132-000,2011,11,23,9,867,1328,2195,2095
0132-000,2011,11,23,10,856,1002,1858,2195
0132-000,2011,11,23,11,877,934,1811,1858
0132-000,2011,11,23,12,785,871,1656,1811
0132-000,2011,11,23,13,757,853,1610,1656
0132-000,2011,11,23,14,902,962,1864,1610
0132-000,2011,11,23,15,933,1038,1971,1864
0132-000,2011,11,23,16,1059,1120,2179,1971
0132-000,2011,11,23,17,1051,1002,2053,2179
0132-000,2011,11,23,18,1284,934,2218,2053
0132-000,2011,11,23,19,1202,878,2080,2218
0132-000,2011,11,23,20,876,689,1565,2080
0132-000,2011,11,23,21,744,520,1264,1565
0132-000,2011,11,23,22,612,475,1087,1264
0132-000,2011,11,23,23,390,338,728,1087
0132-000,2011,11,23,24,238,215,453,728
0132-000,2011,11,24,1,172,201,373,453
0132-000,2011,11,24,2,112,114,226,373
0132-000,2011,11,24,3,65,101,166,226
0132-000,2011,11,24,4,76,101,177,166
0132-000,2011,11,24,5,88,92,180,177
0132-000,2011,11,24,6,180,146,326,180
0132-000,2011,11,24,7,401,409,810,326
0132-000,2011,11,24,8,775,1345,2120,810
0132-000,2011,11,24,9,812,1380,2192,2120
0132-000,2011,11,24,10,824,1003,1827,2192
0132-000,2011,11,24,11,903,943,1846,1827
0132-000,2011,11,24,12,871,885,1756,1846
0132-000,2011,11,24,13,791,786,1577,1756
0132-000,2011,11,24,14,854,910,1764,1577
0132-000,2011,11,24,15,1011,1033,2044,1764
0132-000,2011,11,24,16,1049,917,1966,2044
0132-000,2011,11,24,17,1105,903,2008,1966
0132-000,2011,11,24,18,1271,873,2144,2008
0132-000,2011,11,24,19,1222,896,2118,2144
0132-000,2011,11,24,20,852,715,1567,2118
0132-000,2011,11,24,21,784,571,1355,1567
0132-000,2011,11,24,22,681,495,1176,1355
0132-000,2011,11,24,23,353,334,687,1176
0132-000,2011,11,24,24,285,273,558,687
0132-000,2011,11,25,1,199,193,392,558
0132-000,2011,11,25,2,129,159,288,392
0132-000,2011,11,25,3,100,100,200,288
0132-000,2011,11,25,4,87,105,192,200
0132-000,2011,11,25,5,111,110,221,192
0132-000,2011,11,25,6,185,149,334,221
0132-000,2011,11,25,7,398,405,803,334
0132-000,2011,11,25,8,737,1341,2078,803
0132-000,2011,11,25,9,950,1359,2309,2078
0132-000,2011,11,25,10,824,951,1775,2309
0132-000,2011,11,25,11,892,1021,1913,1775
0132-000,2011,11,25,12,957,958,1915,1913
0132-000,2011,11,25,13,867,914,1781,1915
0132-000,2011,11,25,14,955,994,1949,1781
0132-000,2011,11,25,15,994,999,1993,1949
0132-000,2011,11,25,16,1153,943,2096,1993
0132-000,2011,11,25,17,1131,987,2118,2096
0132-000,2011,11,25,18,1321,992,2313,2118
0132-000,2011,11,25,19,1564,971,2535,2313
0132-000,2011,11,25,20,1080,922,2002,2535
0132-000,2011,11,25,21,843,758,1601,2002
0132-000,2011,11,25,22,702,624,1326,1601
0132-000,2011,11,25,23,438,515,953,1326
0132-000,2011,11,25,24,310,356,666,953
0132-000,2011,11,26,1,227,279,506,666
0132-000,2011,11,26,2,166,174,340,506
0132-000,2011,11,26,3,134,140,274,340
0132-000,2011,11,26,4,110,125,235,274
0132-000,2011,11,26,5,128,147,275,235
0132-000,2011,11,26,6,186,168,354,275
0132-000,2011,11,26,7,360,330,690,354
0132-000,2011,11,26,8,539,751,1290,690
0132-000,2011,11,26,9,646,942,1588,1290
0132-000,2011,11,26,10,773,1136,1909,1588
0132-000,2011,11,26,11,864,1459,2323,1909
0132-000,2011,11,26,12,1181,1719,2900,2323
0132-000,2011,11,26,13,1067,2018,3085,2900
0132-000,2011,11,26,14,971,1881,2852,3085
0132-000,2011,11,26,15,1098,1942,3040,2852
0132-000,2011,11,26,16,1067,1962,3029,3040
0132-000,2011,11,26,17,1573,1902,3475,3029
0132-000,2011,11,26,18,1709,1799,3508,3475
0132-000,2011,11,26,19,1678,1636,3314,3508
0132-000,2011,11,26,20,1303,1382,2685,3314
0132-000,2011,11,26,21,979,998,1977,2685
0132-000,2011,11,26,22,639,621,1260,1977
0132-000,2011,11,26,23,544,384,928,1260
0132-000,2011,11,26,24,270,299,569,928
0132-000,2011,11,27,1,217,203,420,569
0132-000,2011,11,27,2,140,161,301,420
0132-000,2011,11,27,3,93,130,223,301
0132-000,2011,11,27,4,101,83,184,223
0132-000,2011,11,27,5,122,107,229,184
0132-000,2011,11,27,6,132,148,280,229
0132-000,2011,11,27,7,202,218,420,280
0132-000,2011,11,27,8,283,391,674,420
0132-000,2011,11,27,9,442,472,914,674
0132-000,2011,11,27,10,553,549,1102,914
0132-000,2011,11,27,11,624,658,1282,1102
0132-000,2011,11,27,12,899,734,1633,1282
0132-000,2011,11,27,13,1203,723,1926,1633
0132-000,2011,11,27,14,1268,714,1982,1926
0132-000,2011,11,27,15,1566,730,2296,1982
0132-000,2011,11,27,16,1499,748,2247,2296
0132-000,2011,11,27,17,1678,824,2502,2247
0132-000,2011,11,27,18,1944,736,2680,2502
0132-000,2011,11,27,19,1970,639,2609,2680
0132-000,2011,11,27,20,1756,569,2325,2609
0132-000,2011,11,27,21,1625,505,2130,2325
0132-000,2011,11,27,22,1471,454,1925,2130
0132-000,2011,11,27,23,1389,358,1747,1925
0132-000,2011,11,27,24,768,265,1033,1747
0132-000,2011,11,28,1,168,175,343,1033
0132-000,2011,11,28,2,100,116,216,343
0132-000,2011,11,28,3,81,73,154,216
0132-000,2011,11,28,4,72,83,155,154
0132-000,2011,11,28,5,80,99,179,155
0132-000,2011,11,28,6,202,224,426,179
0132-000,2011,11,28,7,523,566,1089,426
0132-000,2011,11,28,8,814,1587,2401,1089
0132-000,2011,11,28,9,826,1478,2304,2401
0132-000,2011,11,28,10,770,1042,1812,2304
0132-000,2011,11,28,11,904,974,1878,1812
0132-000,2011,11,28,12,844,959,1803,1878
0132-000,2011,11,28,13,726,870,1596,1803
0132-000,2011,11,28,14,902,970,1872,1596
0132-000,2011,11,28,15,945,1042,1987,1872
0132-000,2011,11,28,16,1011,997,2008,1987
0132-000,2011,11,28,17,877,919,1796,2008
0132-000,2011,11,28,18,1138,924,2062,1796
0132-000,2011,11,28,19,1147,877,2024,2062
0132-000,2011,11,28,20,804,625,1429,2024
0132-000,2011,11,28,21,815,547,1362,1429
0132-000,2011,11,28,22,572,523,1095,1362
0132-000,2011,11,28,23,365,341,706,1095
0132-000,2011,11,28,24,250,224,474,706
0132-000,2011,11,29,1,165,167,332,474
0132-000,2011,11,29,2,129,125,254,332
0132-000,2011,11,29,3,91,109,200,254
0132-000,2011,11,29,4,85,119,204,200
0132-000,2011,11,29,5,107,122,229,204
0132-000,2011,11,29,6,195,167,362,229
0132-000,2011,11,29,7,421,457,878,362
0132-000,2011,11,29,8,786,1360,2146,878
0132-000,2011,11,29,9,835,1393,2228,2146
0132-000,2011,11,29,10,854,1054,1908,2228
0132-000,2011,11,29,11,905,1017,1922,1908
0132-000,2011,11,29,12,886,849,1735,1922
0132-000,2011,11,29,13,820,860,1680,1735
0132-000,2011,11,29,14,875,894,1769,1680
0132-000,2011,11,29,15,1034,1024,2058,1769
0132-000,2011,11,29,16,1107,908,2015,2058
0132-000,2011,11,29,17,1109,954,2063,2015
0132-000,2011,11,29,18,1267,909,2176,2063
0132-000,2011,11,29,19,1159,844,2003,2176
0132-000,2011,11,29,20,857,725,1582,2003
0132-000,2011,11,29,21,750,557,1307,1582
0132-000,2011,11,29,22,625,507,1132,1307
0132-000,2011,11,29,23,413,373,786,1132
0132-000,2011,11,29,24,252,263,515,786
0132-000,2011,11,30,1,174,187,361,515
0132-000,2011,11,30,2,138,108,246,361
0132-000,2011,11,30,3,89,116,205,246
0132-000,2011,11,30,4,94,105,199,205
0132-000,2011,11,30,5,84,81,165,199
0132-000,2011,11,30,6,160,136,296,165
0132-000,2011,11,30,7,352,358,710,296
0132-000,2011,11,30,8,728,1242,1970,710
0132-000,2011,11,30,9,783,1332,2115,1970
0132-000,2011,11,30,10,695,973,1668,2115
0132-000,2011,11,30,11,807,893,1700,1668
0132-000,2011,11,30,12,797,814,1611,1700
0132-000,2011,11,30,13,714,788,1502,1611
0132-000,2011,11,30,14,797,895,1692,1502
0132-000,2011,11,30,15,959,905,1864,1692
0132-000,2011,11,30,16,1014,844,1858,1864
0132-000,2011,11,30,17,999,839,1838,1858
0132-000,2011,11,30,18,1113,788,1901,1838
0132-000,2011,11,30,19,1162,876,2038,1901
0132-000,2011,11,30,20,864,599,1463,2038
0132-000,2011,11,30,21,672,563,1235,1463
0132-000,2011,11,30,22,577,464,1041,1235
0132-000,2011,11,30,23,412,388,800,1041
0132-000,2011,11,30,24,233,258,491,800
0132-000,2011,12,1,1,193,191,384,491
0132-000,2011,12,1,2,105,110,215,384
0132-000,2011,12,1,3,90,99,189,215
0132-000,2011,12,1,4,74,100,174,189
0132-000,2011,12,1,5,103,97,200,174
0132-000,2011,12,1,6,175,141,316,200
0132-000,2011,12,1,7,410,447,857,316
0132-000,2011,12,1,8,760,1333,2093,857
0132-000,2011,12,1,9,804,1396,2200,2093
0132-000,2011,12,1,10,784,967,1751,2200
0132-000,2011,12,1,11,855,993,1848,1751
0132-000,2011,12,1,12,910,898,1808,1848
0132-000,2011,12,1,13,795,884,1679,1808
0132-000,2011,12,1,14,881,894,1775,1679
0132-000,2011,12,1,15,996,1021,2017,1775
0132-000,2011,12,1,16,1085,881,1966,2017
0132-000,2011,12,1,17,1061,933,1994,1966
0132-000,2011,12,1,18,1193,871,2064,1994
0132-000,2011,12,1,19,1178,848,2026,2064
0132-000,2011,12,1,20,865,638,1503,2026
0132-000,2011,12,1,21,727,535,1262,1503
0132-000,2011,12,1,22,640,492,1132,1262
0132-000,2011,12,1,23,370,383,753,1132
0132-000,2011,12,1,24,234,243,477,753
0132-000,2011,12,2,1,202,190,392,477
0132-000,2011,12,2,2,135,153,288,392
0132-000,2011,12,2,3,80,95,175,288
0132-000,2011,12,2,4,76,100,176,175
0132-000,2011,12,2,5,89,119,208,176
0132-000,2011,12,2,6,162,141,303,208
0132-000,2011,12,2,7,393,411,804,303
0132-000,2011,12,2,8,752,1308,2060,804
0132-000,2011,12,2,9,870,1372,2242,2060
0132-000,2011,12,2,10,815,979,1794,2242
0132-000,2011,12,2,11,911,940,1851,1794
0132-000,2011,12,2,12,894,915,1809,1851
0132-000,2011,12,2,13,801,880,1681,1809
0132-000,2011,12,2,14,913,905,1818,1681
0132-000,2011,12,2,15,1047,983,2030,1818
0132-000,2011,12,2,16,1054,941,1995,2030
0132-000,2011,12,2,17,1154,951,2105,1995
0132-000,2011,12,2,18,1352,889,2241,2105
0132-000,2011,12,2,19,1415,922,2337,2241
0132-000,2011,12,2,20,1029,799,1828,2337
0132-000,2011,12,2,21,777,597,1374,1828
0132-000,2011,12,2,22,587,571,1158,1374
0132-000,2011,12,2,23,463,440,903,1158
0132-000,2011,12,2,24,266,280,546,903
0132-000,2011,12,3,1,213,266,479,546
0132-000,2011,12,3,2,174,183,357,479
0132-000,2011,12,3,3,149,150,299,357
0132-000,2011,12,3,4,78,130,208,299
0132-000,2011,12,3,5,111,114,225,208
0132-000,2011,12,3,6,153,125,278,225
0132-000,2011,12,3,7,279,264,543,278
0132-000,2011,12,3,8,520,704,1224,543
0132-000,2011,12,3,9,698,890,1588,1224
0132-000,2011,12,3,10,728,865,1593,1588
0132-000,2011,12,3,11,870,1081,1951,1593
0132-000,2011,12,3,12,965,1309,2274,1951
0132-000,2011,12,3,13,971,1254,2225,2274
0132-000,2011,12,3,14,1040,1193,2233,2225
0132-000,2011,12,3,15,1065,1308,2373,2233
0132-000,2011,12,3,16,1071,1339,2410,2373
0132-000,2011,12,3,17,1321,1375,2696,2410
0132-000,2011,12,3,18,1447,1338,2785,2696
0132-000,2011,12,3,19,1399,1259,2658,2785
0132-000,2011,12,3,20,785,805,1590,2658
0132-000,2011,12,3,21,639,551,1190,1590
0132-000,2011,12,3,22,523,532,1055,1190
0132-000,2011,12,3,23,336,386,722,1055
0132-000,2011,12,3,24,246,295,541,722
0132-000,2011,12,4,1,225,259,484,541
0132-000,2011,12,4,2,157,177,334,484
0132-000,2011,12,4,3,106,127,233,334
0132-000,2011,12,4,4,107,91,198,233
0132-000,2011,12,4,5,97,106,203,198
0132-000,2011,12,4,6,109,103,212,203
0132-000,2011,12,4,7,143,197,340,212
0132-000,2011,12,4,8,260,337,597,340
0132-000,2011,12,4,9,407,471,878,597
0132-000,2011,12,4,10,474,621,1095,878
0132-000,2011,12,4,11,551,626,1177,1095
0132-000,2011,12,4,12,575,639,1214,1177
0132-000,2011,12,4,13,873,649,1522,1214
0132-000,2011,12,4,14,949,671,1620,1522
0132-000,2011,12,4,15,1041,741,1782,1620
0132-000,2011,12,4,16,1368,765,2133,1782
0132-000,2011,12,4,17,1407,727,2134,2133
0132-000,2011,12,4,18,1605,776,2381,2134
0132-000,2011,12,4,19,1380,620,2000,2381
0132-000,2011,12,4,20,928,572,1500,2000
0132-000,2011,12,4,21,651,513,1164,1500
0132-000,2011,12,4,22,467,451,918,1164
0132-000,2011,12,4,23,315,331,646,918
0132-000,2011,12,4,24,201,236,437,646
0132-000,2011,12,5,1,112,191,303,437
0132-000,2011,12,5,2,76,88,164,303
0132-000,2011,12,5,3,60,68,128,164
0132-000,2011,12,5,4,74,80,154,128
0132-000,2011,12,5,5,88,96,184,154
0132-000,2011,12,5,6,207,206,413,184
0132-000,2011,12,5,7,443,551,994,413
0132-000,2011,12,5,8,812,1569,2381,994
0132-000,2011,12,5,9,834,1452,2286,2381
0132-000,2011,12,5,10,771,1011,1782,2286
0132-000,2011,12,5,11,834,958,1792,1782
0132-000,2011,12,5,12,914,973,1887,1792
0132-000,2011,12,5,13,815,875,1690,1887
0132-000,2011,12,5,14,906,991,1897,1690
0132-000,2011,12,5,15,1027,1024,2051,1897
0132-000,2011,12,5,16,1102,933,2035,2051
0132-000,2011,12,5,17,1183,965,2148,2035
0132-000,2011,12,5,18,1221,918,2139,2148
0132-000,2011,12,5,19,1185,878,2063,2139
0132-000,2011,12,5,20,850,707,1557,2063
0132-000,2011,12,5,21,751,579,1330,1557
0132-000,2011,12,5,22,612,464,1076,1330
0132-000,2011,12,5,23,366,334,700,1076
0132-000,2011,12,5,24,205,224,429,700
0132-000,2011,12,6,1,149,160,309,429
0132-000,2011,12,6,2,101,115,216,309
0132-000,2011,12,6,3,97,103,200,216
0132-000,2011,12,6,4,76,84,160,200
0132-000,2011,12,6,5,88,123,211,160
0132-000,2011,12,6,6,161,168,329,211
0132-000,2011,12,6,7,394,454,848,329
0132-000,2011,12,6,8,737,1362,2099,848
0132-000,2011,12,6,9,827,1407,2234,2099
0132-000,2011,12,6,10,849,1029,1878,2234
0132-000,2011,12,6,11,884,983,1867,1878
0132-000,2011,12,6,12,885,905,1790,1867
0132-000,2011,12,6,13,812,837,1649,1790
0132-000,2011,12,6,14,923,959,1882,1649
0132-000,2011,12,6,15,994,989,1983,1882
0132-000,2011,12,6,16,1058,938,1996,1983
0132-000,2011,12,6,17,1100,921,2021,1996
0132-000,2011,12,6,18,1276,889,2165,2021
0132-000,2011,12,6,19,1156,871,2027,2165
0132-000,2011,12,6,20,855,645,1500,2027
0132-000,2011,12,6,21,771,551,1322,1500
0132-000,2011,12,6,22,627,441,1068,1322
0132-000,2011,12,6,23,351,309,660,1068
0132-000,2011,12,6,24,207,244,451,660
0132-000,2011,12,7,1,174,162,336,451
0132-000,2011,12,7,2,114,125,239,336
0132-000,2011,12,7,3,90,110,200,239
0132-000,2011,12,7,4,96,108,204,200
0132-000,2011,12,7,5,83,96,179,204
0132-000,2011,12,7,6,178,157,335,179
0132-000,2011,12,7,7,402,422,824,335
0132-000,2011,12,7,8,762,1325,2087,824
0132-000,2011,12,7,9,859,1353,2212,2087
0132-000,2011,12,7,10,781,990,1771,2212
0132-000,2011,12,7,11,823,957,1780,1771
0132-000,2011,12,7,12,889,928,1817,1780
0132-000,2011,12,7,13,781,880,1661,1817
0132-000,2011,12,7,14,922,989,1911,1661
0132-000,2011,12,7,15,1010,960,1970,1911
0132-000,2011,12,7,16,1122,913,2035,1970
0132-000,2011,12,7,17,1095,909,2004,2035
0132-000,2011,12,7,18,1236,865,2101,2004
0132-000,2011,12,7,19,1243,872,2115,2101
0132-000,2011,12,7,20,863,624,1487,2115
0132-000,2011,12,7,21,673,548,1221,1487
0132-000,2011,12,7,22,569,485,1054,1221
0132-000,2011,12,7,23,374,367,741,1054
0132-000,2011,12,7,24,227,257,484,741
0132-000,2011,12,8,1,171,181,352,484
0132-000,2011,12,8,2,119,149,268,352
0132-000,2011,12,8,3,110,110,220,268
0132-000,2011,12,8,4,77,100,177,220
0132-000,2011,12,8,5,99,108,207,177
0132-000,2011,12,8,6,174,147,321,207
0132-000,2011,12,8,7,368,401,769,321
0132-000,2011,12,8,8,709,1356,2065,769
0132-000,2011,12,8,9,827,1346,2173,2065
0132-000,2011,12,8,10,770,986,1756,2173
0132-000,2011,12,8,11,828,983,1811,1756
0132-000,2011,12,8,12,888,883,1771,1811
0132-000,2011,12,8,13,780,817,1597,1771
0132-000,2011,12,8,14,898,951,1849,1597
0132-000,2011,12,8,15,1020,908,1928,1849
0132-000,2011,12,8,16,1044,937,1981,1928
0132-000,2011,12,8,17,1044,893,1937,1981
0132-000,2011,12,8,18,1232,863,2095,1937
0132-000,2011,12,8,19,1151,802,1953,2095
0132-000,2011,12,8,20,844,602,1446,1953
0132-000,2011,12,8,21,689,489,1178,1446
0132-000,2011,12,8,22,609,498,1107,1178
0132-000,2011,12,8,23,399,341,740,1107
0132-000,2011,12,8,24,231,232,463,740
0132-000,2011,12,9,1,195,200,395,463
0132-000,2011,12,9,2,122,120,242,395
0132-000,2011,12,9,3,86,114,200,242
0132-000,2011,12,9,4,73,94,167,200
0132-000,2011,12,9,5,91,94,185,167
0132-000,2011,12,9,6,175,164,339,185
0132-000,2011,12,9,7,326,413,739,339
0132-000,2011,12,9,8,646,1254,1900,739
0132-000,2011,12,9,9,774,1290,2064,1900
0132-000,2011,12,9,10,813,940,1753,2064
0132-000,2011,12,9,11,829,1018,1847,1753
0132-000,2011,12,9,12,878,898,1776,1847
0132-000,2011,12,9,13,812,853,1665,1776
0132-000,2011,12,9,14,886,905,1791,1665
0132-000,2011,12,9,15,1052,934,1986,1791
0132-000,2011,12,9,16,1154,975,2129,1986
0132-000,2011,12,9,17,1153,928,2081,2129
0132-000,2011,12,9,18,1362,940,2302,2081
0132-000,2011,12,9,19,1441,905,2346,2302
0132-000,2011,12,9,20,1044,758,1802,2346
0132-000,2011,12,9,21,776,620,1396,1802
0132-000,2011,12,9,22,628,572,1200,1396
0132-000,2011,12,9,23,438,431,869,1200
0132-000,2011,12,9,24,265,322,587,869
0132-000,2011,12,10,1,259,247,506,587
0132-000,2011,12,10,2,160,164,324,506
0132-000,2011,12,10,3,131,148,279,324
0132-000,2011,12,10,4,102,127,229,279
0132-000,2011,12,10,5,109,125,234,229
0132-000,2011,12,10,6,160,146,306,234
0132-000,2011,12,10,7,281,290,571,306
0132-000,2011,12,10,8,428,659,1087,571
0132-000,2011,12,10,9,650,768,1418,1087
0132-000,2011,12,10,10,709,784,1493,1418
0132-000,2011,12,10,11,882,901,1783,1493
0132-000,2011,12,10,12,979,976,1955,1783
0132-000,2011,12,10,13,892,1166,2058,1955
0132-000,2011,12,10,14,904,1140,2044,2058
0132-000,2011,12,10,15,1033,1250,2283,2044
0132-000,2011,12,10,16,1178,1257,2435,2283
0132-000,2011,12,10,17,1395,1287,2682,2435
0132-000,2011,12,10,18,1601,1261,2862,2682
0132-000,2011,12,10,19,1373,1143,2516,2862
0132-000,2011,12,10,20,782,707,1489,2516
0132-000,2011,12,10,21,608,588,1196,1489
0132-000,2011,12,10,22,481,493,974,1196
0132-000,2011,12,10,23,345,384,729,974
0132-000,2011,12,10,24,248,286,534,729
0132-000,2011,12,11,1,207,263,470,534
0132-000,2011,12,11,2,155,187,342,470
0132-000,2011,12,11,3,113,131,244,342
0132-000,2011,12,11,4,103,99,202,244
0132-000,2011,12,11,5,80,109,189,202
0132-000,2011,12,11,6,125,100,225,189
0132-000,2011,12,11,7,148,198,346,225
0132-000,2011,12,11,8,234,299,533,346
0132-000,2011,12,11,9,370,460,830,533
0132-000,2011,12,11,10,407,471,878,830
0132-000,2011,12,11,11,574,662,1236,878
0132-000,2011,12,11,12,612,673,1285,1236
0132-000,2011,12,11,13,861,661,1522,1285
0132-000,2011,12,11,14,1186,707,1893,1522
0132-000,2011,12,11,15,1226,762,1988,1893
0132-000,2011,12,11,16,1404,755,2159,1988
0132-000,2011,12,11,17,1480,757,2237,2159
0132-000,2011,12,11,18,1485,681,2166,2237
0132-000,2011,12,11,19,1324,618,1942,2166
0132-000,2011,12,11,20,1008,562,1570,1942
0132-000,2011,12,11,21,589,467,1056,1570
0132-000,2011,12,11,22,469,477,946,1056
0132-000,2011,12,11,23,315,323,638,946
0132-000,2011,12,11,24,199,261,460,638
0132-000,2011,12,12,1,153,142,295,460
0132-000,2011,12,12,2,102,104,206,295
0132-000,2011,12,12,3,57,79,136,206
0132-000,2011,12,12,4,61,79,140,136
0132-000,2011,12,12,5,88,101,189,140
0132-000,2011,12,12,6,185,193,378,189
0132-000,2011,12,12,7,462,576,1038,378
0132-000,2011,12,12,8,788,1574,2362,1038
0132-000,2011,12,12,9,829,1381,2210,2362
0132-000,2011,12,12,10,809,986,1795,2210
0132-000,2011,12,12,11,861,934,1795,1795
0132-000,2011,12,12,12,900,944,1844,1795
0132-000,2011,12,12,13,782,876,1658,1844
0132-000,2011,12,12,14,918,991,1909,1658
0132-000,2011,12,12,15,999,999,1998,1909
0132-000,2011,12,12,16,1033,928,1961,1998
0132-000,2011,12,12,17,1084,920,2004,1961
0132-000,2011,12,12,18,1178,908,2086,2004
0132-000,2011,12,12,19,1137,811,1948,2086
0132-000,2011,12,12,20,807,599,1406,1948
0132-000,2011,12,12,21,709,556,1265,1406
0132-000,2011,12,12,22,588,476,1064,1265
0132-000,2011,12,12,23,361,351,712,1064
0132-000,2011,12,12,24,231,243,474,712
0132-000,2011,12,13,1,151,157,308,474
0132-000,2011,12,13,2,122,132,254,308
0132-000,2011,12,13,3,93,123,216,254
0132-000,2011,12,13,4,84,105,189,216
0132-000,2011,12,13,5,89,108,197,189
0132-000,2011,12,13,6,183,150,333,197
0132-000,2011,12,13,7,363,450,813,333
0132-000,2011,12,13,8,707,1359,2066,813
0132-000,2011,12,13,9,852,1331,2183,2066
0132-000,2011,12,13,10,824,990,1814,2183
0132-000,2011,12,13,11,867,977,1844,1814
0132-000,2011,12,13,12,887,909,1796,1844
0132-000,2011,12,13,13,826,821,1647,1796
0132-000,2011,12,13,14,926,957,1883,1647
0132-000,2011,12,13,15,983,1025,2008,1883
0132-000,2011,12,13,16,1092,962,2054,2008
0132-000,2011,12,13,17,1080,877,1957,2054
0132-000,2011,12,13,18,1267,897,2164,1957
0132-000,2011,12,13,19,1183,823,2006,2164
0132-000,2011,12,13,20,819,635,1454,2006
0132-000,2011,12,13,21,715,521,1236,1454
0132-000,2011,12,13,22,564,451,1015,1236
0132-000,2011,12,13,23,394,345,739,1015
0132-000,2011,12,13,24,257,261,518,739
0132-000,2011,12,14,1,173,179,352,518
0132-000,2011,12,14,2,122,137,259,352
0132-000,2011,12,14,3,83,109,192,259
0132-000,2011,12,14,4,93,109,202,192
0132-000,2011,12,14,5,91,104,195,202
0132-000,2011,12,14,6,178,139,317,195
0132-000,2011,12,14,7,382,413,795,317
0132-000,2011,12,14,8,729,1309,2038,795
0132-000,2011,12,14,9,866,1289,2155,2038
0132-000,2011,12,14,10,771,959,1730,2155
0132-000,2011,12,14,11,852,924,1776,1730
0132-000,2011,12,14,12,906,960,1866,1776
0132-000,2011,12,14,13,797,824,1621,1866
0132-000,2011,12,14,14,908,950,1858,1621
0132-000,2011,12,14,15,986,968,1954,1858
0132-000,2011,12,14,16,1094,949,2043,1954
0132-000,2011,12,14,17,1025,864,1889,2043
0132-000,2011,12,14,18,1237,901,2138,1889
0132-000,2011,12,14,19,1178,779,1957,2138
0132-000,2011,12,14,20,833,666,1499,1957
0132-000,2011,12,14,21,688,516,1204,1499
0132-000,2011,12,14,22,527,480,1007,1204
0132-000,2011,12,14,23,364,350,714,1007
0132-000,2011,12,14,24,261,232,493,714
0132-000,2011,12,15,1,209,183,392,493
0132-000,2011,12,15,2,117,124,241,392
0132-000,2011,12,15,3,95,116,211,241
0132-000,2011,12,15,4,82,103,185,211
0132-000,2011,12,15,5,83,90,173,185
0132-000,2011,12,15,6,158,127,285,173
0132-000,2011,12,15,7,366,398,764,285
0132-000,2011,12,15,8,712,1312,2024,764
0132-000,2011,12,15,9,863,1305,2168,2024
0132-000,2011,12,15,10,817,928,1745,2168
0132-000,2011,12,15,11,896,896,1792,1745
0132-000,2011,12,15,12,827,953,1780,1792
0132-000,2011,12,15,13,802,884,1686,1780
0132-000,2011,12,15,14,919,872,1791,1686
0132-000,2011,12,15,15,996,982,1978,1791
0132-000,2011,12,15,16,1055,922,1977,1978
0132-000,2011,12,15,17,1047,861,1908,1977
0132-000,2011,12,15,18,1197,908,2105,1908
0132-000,2011,12,15,19,1223,864,2087,2105
0132-000,2011,12,15,20,844,646,1490,2087
0132-000,2011,12,15,21,704,532,1236,1490
0132-000,2011,12,15,22,592,514,1106,1236
0132-000,2011,12,15,23,394,377,771,1106
0132-000,2011,12,15,24,229,261,490,771
0132-000,2011,12,16,1,200,219,419,490
0132-000,2011,12,16,2,142,154,296,419
0132-000,2011,12,16,3,83,104,187,296
0132-000,2011,12,16,4,92,113,205,187
0132-000,2011,12,16,5,93,113,206,205
0132-000,2011,12,16,6,165,139,304,206
0132-000,2011,12,16,7,357,390,747,304
0132-000,2011,12,16,8,747,1270,2017,747
0132-000,2011,12,16,9,833,1238,2071,2017
0132-000,2011,12,16,10,749,910,1659,2071
0132-000,2011,12,16,11,861,950,1811,1659
0132-000,2011,12,16,12,895,926,1821,1811
0132-000,2011,12,16,13,838,861,1699,1821
0132-000,2011,12,16,14,987,981,1968,1699
0132-000,2011,12,16,15,1099,955,2054,1968
0132-000,2011,12,16,16,1112,947,2059,2054
0132-000,2011,12,16,17,1187,935,2122,2059
0132-000,2011,12,16,18,1361,971,2332,2122
0132-000,2011,12,16,19,1483,946,2429,2332
0132-000,2011,12,16,20,989,696,1685,2429
0132-000,2011,12,16,21,729,601,1330,1685
0132-000,2011,12,16,22,645,516,1161,1330
0132-000,2011,12,16,23,424,407,831,1161
0132-000,2011,12,16,24,264,295,559,831
0132-000,2011,12,17,1,200,236,436,559
0132-000,2011,12,17,2,187,181,368,436
0132-000,2011,12,17,3,133,139,272,368
0132-000,2011,12,17,4,99,151,250,272
0132-000,2011,12,17,5,118,125,243,250
0132-000,2011,12,17,6,147,152,299,243
0132-000,2011,12,17,7,283,258,541,299
0132-000,2011,12,17,8,511,662,1173,541
0132-000,2011,12,17,9,668,867,1535,1173
0132-000,2011,12,17,10,732,816,1548,1535
0132-000,2011,12,17,11,829,1078,1907,1548
0132-000,2011,12,17,12,936,1095,2031,1907
0132-000,2011,12,17,13,1041,1143,2184,2031
0132-000,2011,12,17,14,1057,1175,2232,2184
0132-000,2011,12,17,15,1146,1275,2421,2232
0132-000,2011,12,17,16,1435,1261,2696,2421
0132-000,2011,12,17,17,1573,1329,2902,2696
0132-000,2011,12,17,18,1816,1421,3237,2902
0132-000,2011,12,17,19,1583,1144,2727,3237
0132-000,2011,12,17,20,1007,837,1844,2727
0132-000,2011,12,17,21,655,593,1248,1844
0132-000,2011,12,17,22,536,488,1024,1248
0132-000,2011,12,17,23,357,377,734,1024
0132-000,2011,12,17,24,292,285,577,734
0132-000,2011,12,18,1,228,280,508,577
0132-000,2011,12,18,2,167,187,354,508
0132-000,2011,12,18,3,125,151,276,354
0132-000,2011,12,18,4,111,119,230,276
0132-000,2011,12,18,5,93,104,197,230
0132-000,2011,12,18,6,112,129,241,197
0132-000,2011,12,18,7,179,173,352,241
0132-000,2011,12,18,8,232,300,532,352
0132-000,2011,12,18,9,350,470,820,532
0132-000,2011,12,18,10,453,479,932,820
0132-000,2011,12,18,11,628,661,1289,932
0132-000,2011,12,18,12,635,665,1300,1289
0132-000,2011,12,18,13,726,723,1449,1300
0132-000,2011,12,18,14,926,727,1653,1449
0132-000,2011,12,18,15,1051,691,1742,1653
0132-000,2011,12,18,16,1233,735,1968,1742
0132-000,2011,12,18,17,1351,778,2129,1968
0132-000,2011,12,18,18,1404,704,2108,2129
0132-000,2011,12,18,19,1236,607,1843,2108
0132-000,2011,12,18,20,807,538,1345,1843
0132-000,2011,12,18,21,568,507,1075,1345
0132-000,2011,12,18,22,495,413,908,1075
0132-000,2011,12,18,23,276,345,621,908
0132-000,2011,12,18,24,190,243,433,621
0132-000,2011,12,19,1,137,160,297,433
0132-000,2011,12,19,2,79,115,194,297
0132-000,2011,12,19,3,62,75,137,194
0132-000,2011,12,19,4,59,81,140,137
0132-000,2011,12,19,5,100,101,201,140
0132-000,2011,12,19,6,188,197,385,201
0132-000,2011,12,19,7,453,574,1027,385
0132-000,2011,12,19,8,800,1579,2379,1027
0132-000,2011,12,19,9,840,1336,2176,2379
0132-000,2011,12,19,10,750,843,1593,2176
0132-000,2011,12,19,11,892,903,1795,1593
0132-000,2011,12,19,12,846,953,1799,1795
0132-000,2011,12,19,13,772,835,1607,1799
0132-000,2011,12,19,14,858,928,1786,1607
0132-000,2011,12,19,15,963,981,1944,1786
0132-000,2011,12,19,16,1035,908,1943,1944
0132-000,2011,12,19,17,1045,938,1983,1943
0132-000,2011,12,19,18,1188,884,2072,1983
0132-000,2011,12,19,19,1126,801,1927,2072
0132-000,2011,12,19,20,806,595,1401,1927
0132-000,2011,12,19,21,710,603,1313,1401
0132-000,2011,12,19,22,559,497,1056,1313
0132-000,2011,12,19,23,347,317,664,1056
0132-000,2011,12,19,24,205,194,399,664
0132-000,2011,12,20,1,151,169,320,399
0132-000,2011,12,20,2,87,123,210,320
0132-000,2011,12,20,3,81,106,187,210
0132-000,2011,12,20,4,83,104,187,187
0132-000,2011,12,20,5,98,112,210,187
0132-000,2011,12,20,6,175,141,316,210
0132-000,2011,12,20,7,386,429,815,316
0132-000,2011,12,20,8,718,1331,2049,815
0132-000,2011,12,20,9,934,1362,2296,2049
0132-000,2011,12,20,10,878,937,1815,2296
0132-000,2011,12,20,11,866,903,1769,1815
0132-000,2011,12,20,12,869,891,1760,1769
0132-000,2011,12,20,13,794,789,1583,1760
0132-000,2011,12,20,14,900,954,1854,1583
0132-000,2011,12,20,15,976,1056,2032,1854
0132-000,2011,12,20,16,1106,922,2028,2032
0132-000,2011,12,20,17,1128,912,2040,2028
0132-000,2011,12,20,18,1111,871,1982,2040
0132-000,2011,12,20,19,1155,828,1983,1982
0132-000,2011,12,20,20,802,575,1377,1983
0132-000,2011,12,20,21,673,566,1239,1377
0132-000,2011,12,20,22,574,489,1063,1239
0132-000,2011,12,20,23,377,375,752,1063
0132-000,2011,12,20,24,254,251,505,752
0132-000,2011,12,21,1,193,209,402,505
0132-000,2011,12,21,2,127,144,271,402
0132-000,2011,12,21,3,100,107,207,271
0132-000,2011,12,21,4,90,104,194,207
0132-000,2011,12,21,5,87,106,193,194
0132-000,2011,12,21,6,167,141,308,193
0132-000,2011,12,21,7,352,363,715,308
0132-000,2011,12,21,8,732,1319,2051,715
0132-000,2011,12,21,9,860,1296,2156,2051
0132-000,2011,12,21,10,828,882,1710,2156
0132-000,2011,12,21,11,855,981,1836,1710
0132-000,2011,12,21,12,883,934,1817,1836
0132-000,2011,12,21,13,773,855,1628,1817
0132-000,2011,12,21,14,878,897,1775,1628
0132-000,2011,12,21,15,1000,1004,2004,1775
0132-000,2011,12,21,16,1066,946,2012,2004
0132-000,2011,12,21,17,1099,855,1954,2012
0132-000,2011,12,21,18,1241,870,2111,1954
0132-000,2011,12,21,19,1201,854,2055,2111
0132-000,2011,12,21,20,824,616,1440,2055
0132-000,2011,12,21,21,671,515,1186,1440
0132-000,2011,12,21,22,564,502,1066,1186
0132-000,2011,12,21,23,346,346,692,1066
0132-000,2011,12,21,24,245,271,516,692
0132-000,2011,12,22,1,160,191,351,516
0132-000,2011,12,22,2,146,136,282,351
0132-000,2011,12,22,3,101,119,220,282
0132-000,2011,12,22,4,74,136,210,220
0132-000,2011,12,22,5,84,120,204,210
0132-000,2011,12,22,6,150,126,276,204
0132-000,2011,12,22,7,354,363,717,276
0132-000,2011,12,22,8,678,1378,2056,717
0132-000,2011,12,22,9,816,1233,2049,2056
0132-000,2011,12,22,10,794,931,1725,2049
0132-000,2011,12,22,11,882,938,1820,1725
0132-000,2011,12,22,12,890,887,1777,1820
0132-000,2011,12,22,13,818,807,1625,1777
0132-000,2011,12,22,14,911,970,1881,1625
0132-000,2011,12,22,15,958,1006,1964,1881
0132-000,2011,12,22,16,1004,909,1913,1964
0132-000,2011,12,22,17,1035,965,2000,1913
0132-000,2011,12,22,18,1404,912,2316,2000
0132-000,2011,12,22,19,1159,882,2041,2316
0132-000,2011,12,22,20,774,605,1379,2041
0132-000,2011,12,22,21,744,530,1274,1379
0132-000,2011,12,22,22,618,485,1103,1274
0132-000,2011,12,22,23,449,381,830,1103
0132-000,2011,12,22,24,258,230,488,830
0132-000,2011,12,23,1,190,197,387,488
0132-000,2011,12,23,2,140,135,275,387
0132-000,2011,12,23,3,91,119,210,275
0132-000,2011,12,23,4,88,125,213,210
0132-000,2011,12,23,5,83,106,189,213
0132-000,2011,12,23,6,161,137,298,189
0132-000,2011,12,23,7,361,354,715,298
0132-000,2011,12,23,8,692,1302,1994,715
0132-000,2011,12,23,9,733,1137,1870,1994
0132-000,2011,12,23,10,667,942,1609,1870
0132-000,2011,12,23,11,812,913,1725,1609
0132-000,2011,12,23,12,908,893,1801,1725
0132-000,2011,12,23,13,834,809,1643,1801
0132-000,2011,12,23,14,933,918,1851,1643
0132-000,2011,12,23,15,1135,1011,2146,1851
0132-000,2011,12,23,16,1045,939,1984,2146
0132-000,2011,12,23,17,1122,879,2001,1984
0132-000,2011,12,23,18,1392,909,2301,2001
0132-000,2011,12,23,19,1468,1007,2475,2301
0132-000,2011,12,23,20,1025,784,1809,2475
0132-000,2011,12,23,21,818,642,1460,1809
0132-000,2011,12,23,22,697,563,1260,1460
0132-000,2011,12,23,23,525,382,907,1260
0132-000,2011,12,23,24,254,233,487,907
0132-000,2011,12,24,1,185,192,377,487
0132-000,2011,12,24,2,130,172,302,377
0132-000,2011,12,24,3,105,174,279,302
0132-000,2011,12,24,4,99,150,249,279
0132-000,2011,12,24,5,81,116,197,249
0132-000,2011,12,24,6,129,112,241,197
0132-000,2011,12,24,7,196,160,356,241
0132-000,2011,12,24,8,244,315,559,356
0132-000,2011,12,24,9,377,423,800,559
0132-000,2011,12,24,10,423,431,854,800
0132-000,2011,12,24,11,539,515,1054,854
0132-000,2011,12,24,12,641,684,1325,1054
0132-000,2011,12,24,13,610,879,1489,1325
0132-000,2011,12,24,14,741,872,1613,1489
0132-000,2011,12,24,15,789,920,1709,1613
0132-000,2011,12,24,16,830,873,1703,1709
0132-000,2011,12,24,17,1061,812,1873,1703
0132-000,2011,12,24,18,918,732,1650,1873
0132-000,2011,12,24,19,763,577,1340,1650
0132-000,2011,12,24,20,490,450,940,1340
0132-000,2011,12,24,21,395,377,772,940
0132-000,2011,12,24,22,348,326,674,772
0132-000,2011,12,24,23,277,297,574,674
0132-000,2011,12,24,24,173,220,393,574
0132-000,2011,12,25,1,156,180,336,393
0132-000,2011,12,25,2,110,127,237,336
0132-000,2011,12,25,3,87,105,192,237
0132-000,2011,12,25,4,76,85,161,192
0132-000,2011,12,25,5,67,94,161,161
0132-000,2011,12,25,6,78,84,162,161
0132-000,2011,12,25,7,103,93,196,162
0132-000,2011,12,25,8,169,181,350,196
0132-000,2011,12,25,9,220,260,480,350
0132-000,2011,12,25,10,330,343,673,480
0132-000,2011,12,25,11,450,446,896,673
0132-000,2011,12,25,12,474,483,957,896
0132-000,2011,12,25,13,570,562,1132,957
0132-000,2011,12,25,14,649,579,1228,1132
0132-000,2011,12,25,15,665,609,1274,1228
0132-000,2011,12,25,16,843,662,1505,1274
0132-000,2011,12,25,17,986,717,1703,1505
0132-000,2011,12,25,18,762,696,1458,1703
0132-000,2011,12,25,19,628,555,1183,1458
0132-000,2011,12,25,20,507,502,1009,1183
0132-000,2011,12,25,21,465,451,916,1009
0132-000,2011,12,25,22,402,391,793,916
0132-000,2011,12,25,23,250,337,587,793
0132-000,2011,12,25,24,169,208,377,587
0132-000,2011,12,26,1,125,172,297,377
0132-000,2011,12,26,2,90,108,198,297
0132-000,2011,12,26,3,52,79,131,198
0132-000,2011,12,26,4,89,81,170,131
0132-000,2011,12,26,5,71,94,165,170
0132-000,2011,12,26,6,177,162,339,165
0132-000,2011,12,26,7,410,517,927,339
0132-000,2011,12,26,8,736,1463,2199,927
0132-000,2011,12,26,9,772,1283,2055,2199
0132-000,2011,12,26,10,747,922,1669,2055
0132-000,2011,12,26,11,809,870,1679,1669
0132-000,2011,12,26,12,884,960,1844,1679
0132-000,2011,12,26,13,862,873,1735,1844
0132-000,2011,12,26,14,1046,901,1947,1735
0132-000,2011,12,26,15,1104,952,2056,1947
0132-000,2011,12,26,16,1019,935,1954,2056
0132-000,2011,12,26,17,1067,861,1928,1954
0132-000,2011,12,26,18,1188,835,2023,1928
0132-000,2011,12,26,19,1113,788,1901,2023
0132-000,2011,12,26,20,789,641,1430,1901
0132-000,2011,12,26,21,697,544,1241,1430
0132-000,2011,12,26,22,504,464,968,1241
0132-000,2011,12,26,23,385,350,735,968
0132-000,2011,12,26,24,224,218,442,735
0132-000,2011,12,27,1,165,193,358,442
0132-000,2011,12,27,2,121,117,238,358
0132-000,2011,12,27,3,78,87,165,238
0132-000,2011,12,27,4,79,108,187,165
0132-000,2011,12,27,5,100,96,196,187
0132-000,2011,12,27,6,143,124,267,196
0132-000,2011,12,27,7,365,394,759,267
0132-000,2011,12,27,8,691,1322,2013,759
0132-000,2011,12,27,9,800,1150,1950,2013
0132-000,2011,12,27,10,810,924,1734,1950
0132-000,2011,12,27,11,867,944,1811,1734
0132-000,2011,12,27,12,878,903,1781,1811
0132-000,2011,12,27,13,772,788,1560,1781
0132-000,2011,12,27,14,865,877,1742,1560
0132-000,2011,12,27,15,969,1001,1970,1742
0132-000,2011,12,27,16,970,941,1911,1970
0132-000,2011,12,27,17,1044,866,1910,1911
0132-000,2011,12,27,18,1115,823,1938,1910
0132-000,2011,12,27,19,1114,789,1903,1938
0132-000,2011,12,27,20,804,645,1449,1903
0132-000,2011,12,27,21,706,562,1268,1449
0132-000,2011,12,27,22,559,472,1031,1268
0132-000,2011,12,27,23,370,362,732,1031
0132-000,2011,12,27,24,262,223,485,732
0132-000,2011,12,28,1,210,191,401,485
0132-000,2011,12,28,2,127,150,277,401
0132-000,2011,12,28,3,102,111,213,277
0132-000,2011,12,28,4,97,115,212,213
0132-000,2011,12,28,5,96,105,201,212
0132-000,2011,12,28,6,179,133,312,201
0132-000,2011,12,28,7,351,382,733,312
0132-000,2011,12,28,8,711,1321,2032,733
0132-000,2011,12,28,9,797,1205,2002,2032
0132-000,2011,12,28,10,808,891,1699,2002
0132-000,2011,12,28,11,876,898,1774,1699
0132-000,2011,12,28,12,920,915,1835,1774
0132-000,2011,12,28,13,808,790,1598,1835
0132-000,2011,12,28,14,898,904,1802,1598
0132-000,2011,12,28,15,986,947,1933,1802
0132-000,2011,12,28,16,1015,925,1940,1933
0132-000,2011,12,28,17,992,825,1817,1940
0132-000,2011,12,28,18,1154,879,2033,1817
0132-000,2011,12,28,19,1175,824,1999,2033
0132-000,2011,12,28,20,788,598,1386,1999
0132-000,2011,12,28,21,639,507,1146,1386
0132-000,2011,12,28,22,550,495,1045,1146
0132-000,2011,12,28,23,384,338,722,1045
0132-000,2011,12,28,24,258,252,510,722
0132-000,2011,12,29,1,193,206,399,510
0132-000,2011,12,29,2,141,174,315,399
0132-000,2011,12,29,3,91,122,213,315
0132-000,2011,12,29,4,84,111,195,213
0132-000,2011,12,29,5,78,92,170,195
0132-000,2011,12,29,6,172,131,303,170
0132-000,2011,12,29,7,353,352,705,303
0132-000,2011,12,29,8,661,1232,1893,705
0132-000,2011,12,29,9,773,1151,1924,1893
0132-000,2011,12,29,10,763,849,1612,1924
0132-000,2011,12,29,11,822,950,1772,1612
0132-000,2011,12,29,12,885,871,1756,1772
0132-000,2011,12,29,13,721,847,1568,1756
0132-000,2011,12,29,14,900,891,1791,1568
0132-000,2011,12,29,15,991,932,1923,1791
0132-000,2011,12,29,16,1052,918,1970,1923
0132-000,2011,12,29,17,990,886,1876,1970
0132-000,2011,12,29,18,1189,840,2029,1876
0132-000,2011,12,29,19,1197,847,2044,2029
0132-000,2011,12,29,20,763,622,1385,2044
0132-000,2011,12,29,21,679,503,1182,1385
0132-000,2011,12,29,22,551,474,1025,1182
0132-000,2011,12,29,23,352,377,729,1025
0132-000,2011,12,29,24,287,262,549,729
0132-000,2011,12,30,1,198,255,453,549
0132-000,2011,12,30,2,146,178,324,453
0132-000,2011,12,30,3,92,139,231,324
0132-000,2011,12,30,4,98,88,186,231
0132-000,2011,12,30,5,88,123,211,186
0132-000,2011,12,30,6,168,143,311,211
0132-000,2011,12,30,7,332,357,689,311
0132-000,2011,12,30,8,641,1167,1808,689
0132-000,2011,12,30,9,749,1059,1808,1808
0132-000,2011,12,30,10,726,822,1548,1808
0132-000,2011,12,30,11,852,845,1697,1548
0132-000,2011,12,30,12,807,872,1679,1697
0132-000,2011,12,30,13,796,832,1628,1679
0132-000,2011,12,30,14,901,845,1746,1628
0132-000,2011,12,30,15,1066,899,1965,1746
0132-000,2011,12,30,16,1121,919,2040,1965
0132-000,2011,12,30,17,1137,896,2033,2040
0132-000,2011,12,30,18,1354,894,2248,2033
0132-000,2011,12,30,19,1215,908,2123,2248
0132-000,2011,12,30,20,846,717,1563,2123
0132-000,2011,12,30,21,682,607,1289,1563
0132-000,2011,12,30,22,579,514,1093,1289
0132-000,2011,12,30,23,407,407,814,1093
0132-000,2011,12,30,24,255,289,544,814
0132-000,2011,12,31,1,233,254,487,544
0132-000,2011,12,31,2,162,190,352,487
0132-000,2011,12,31,3,121,136,257,352
0132-000,2011,12,31,4,112,122,234,257
0132-000,2011,12,31,5,111,143,254,234
0132-000,2011,12,31,6,150,131,281,254
0132-000,2011,12,31,7,206,218,424,281
0132-000,2011,12,31,8,365,469,834,424
0132-000,2011,12,31,9,481,629,1110,834
0132-000,2011,12,31,10,599,644,1243,1110
0132-000,2011,12,31,11,691,713,1404,1243
0132-000,2011,12,31,12,744,800,1544,1404
0132-000,2011,12,31,13,822,1091,1913,1544
0132-000,2011,12,31,14,860,1065,1925,1913
0132-000,2011,12,31,15,915,991,1906,1925
0132-000,2011,12,31,16,960,1061,2021,1906
0132-000,2011,12,31,17,1084,1057,2141,2021
0132-000,2011,12,31,18,1155,973,2128,2141
0132-000,2011,12,31,19,787,821,1608,2128
0132-000,2011,12,31,20,558,557,1115,1608
0132-000,2011,12,31,21,507,472,979,1115
0132-000,2011,12,31,22,436,415,851,979
0132-000,2011,12,31,23,342,327,669,851
0132-000,2011,12,31,24,222,252,474,669
0132-000,2012,1,1,1,168,199,367,474
0132-000,2012,1,1,2,152,214,366,367
0132-000,2012,1,1,3,107,121,228,366
0132-000,2012,1,1,4,95,107,202,228
0132-000,2012,1,1,5,78,97,175,202
0132-000,2012,1,1,6,94,121,215,175
0132-000,2012,1,1,7,88,108,196,215
0132-000,2012,1,1,8,161,191,352,196
0132-000,2012,1,1,9,209,223,432,352
0132-000,2012,1,1,10,322,334,656,432
0132-000,2012,1,1,11,497,480,977,656
0132-000,2012,1,1,12,522,501,1023,977
0132-000,2012,1,1,13,636,549,1185,1023
0132-000,2012,1,1,14,949,604,1553,1185
0132-000,2012,1,1,15,1188,760,1948,1553
0132-000,2012,1,1,16,1175,819,1994,1948
0132-000,2012,1,1,17,1338,881,2219,1994
0132-000,2012,1,1,18,1493,811,2304,2219
0132-000,2012,1,1,19,1310,688,1998,2304
0132-000,2012,1,1,20,1094,496,1590,1998
0132-000,2012,1,1,21,954,451,1405,1590
0132-000,2012,1,1,22,655,394,1049,1405
0132-000,2012,1,1,23,277,341,618,1049
0132-000,2012,1,1,24,162,209,371,618
0132-000,2012,1,2,1,118,148,266,371
0132-000,2012,1,2,2,78,99,177,266
0132-000,2012,1,2,3,46,73,119,177
0132-000,2012,1,2,4,50,58,108,119
0132-000,2012,1,2,5,64,62,126,108
0132-000,2012,1,2,6,140,164,304,126
0132-000,2012,1,2,7,328,420,748,304
0132-000,2012,1,2,8,668,1307,1975,748
0132-000,2012,1,2,9,648,1207,1855,1975
0132-000,2012,1,2,10,629,763,1392,1855
0132-000,2012,1,2,11,682,769,1451,1392
0132-000,2012,1,2,12,748,819,1567,1451
0132-000,2012,1,2,13,686,781,1467,1567
0132-000,2012,1,2,14,811,839,1650,1467
0132-000,2012,1,2,15,856,816,1672,1650
0132-000,2012,1,2,16,914,822,1736,1672
0132-000,2012,1,2,17,890,777,1667,1736
0132-000,2012,1,2,18,1018,755,1773,1667
0132-000,2012,1,2,19,1024,779,1803,1773
0132-000,2012,1,2,20,753,604,1357,1803
0132-000,2012,1,2,21,652,485,1137,1357
0132-000,2012,1,2,22,517,391,908,1137
0132-000,2012,1,2,23,309,312,621,908
0132-000,2012,1,2,24,207,209,416,621
0132-000,2012,1,3,1,125,153,278,416
0132-000,2012,1,3,2,93,99,192,278
0132-000,2012,1,3,3,62,93,155,192
0132-000,2012,1,3,4,57,78,135,155
0132-000,2012,1,3,5,64,105,169,135
0132-000,2012,1,3,6,158,138,296,169
0132-000,2012,1,3,7,327,352,679,296
0132-000,2012,1,3,8,658,1280,1938,679
0132-000,2012,1,3,9,775,1178,1953,1938
0132-000,2012,1,3,10,732,874,1606,1953
0132-000,2012,1,3,11,795,845,1640,1606
0132-000,2012,1,3,12,828,870,1698,1640
0132-000,2012,1,3,13,751,788,1539,1698
0132-000,2012,1,3,14,821,885,1706,1539
0132-000,2012,1,3,15,972,930,1902,1706
0132-000,2012,1,3,16,1014,840,1854,1902
0132-000,2012,1,3,17,887,783,1670,1854
0132-000,2012,1,3,18,1055,786,1841,1670
0132-000,2012,1,3,19,1035,782,1817,1841
0132-000,2012,1,3,20,734,582,1316,1817
0132-000,2012,1,3,21,661,514,1175,1316
0132-000,2012,1,3,22,525,414,939,1175
0132-000,2012,1,3,23,287,296,583,939
0132-000,2012,1,3,24,216,216,432,583
0132-000,2012,1,4,1,134,155,289,432
0132-000,2012,1,4,2,101,114,215,289
0132-000,2012,1,4,3,73,93,166,215
0132-000,2012,1,4,4,77,84,161,166
0132-000,2012,1,4,5,69,90,159,161
0132-000,2012,1,4,6,147,121,268,159
0132-000,2012,1,4,7,281,321,602,268
0132-000,2012,1,4,8,621,1177,1798,602
0132-000,2012,1,4,9,762,1154,1916,1798
0132-000,2012,1,4,10,688,838,1526,1916
0132-000,2012,1,4,11,791,858,1649,1526
0132-000,2012,1,4,12,835,805,1640,1649
0132-000,2012,1,4,13,709,758,1467,1640
0132-000,2012,1,4,14,814,861,1675,1467
0132-000,2012,1,4,15,915,942,1857,1675
0132-000,2012,1,4,16,1030,851,1881,1857
0132-000,2012,1,4,17,941,799,1740,1881
0132-000,2012,1,4,18,1100,800,1900,1740
0132-000,2012,1,4,19,1107,812,1919,1900
0132-000,2012,1,4,20,781,655,1436,1919
0132-000,2012,1,4,21,655,514,1169,1436
0132-000,2012,1,4,22,589,445,1034,1169
0132-000,2012,1,4,23,344,313,657,1034
0132-000,2012,1,4,24,234,248,482,657
0132-000,2012,1,5,1,132,183,315,482
0132-000,2012,1,5,2,94,97,191,315
0132-000,2012,1,5,3,63,91,154,191
0132-000,2012,1,5,4,80,97,177,154
0132-000,2012,1,5,5,94,86,180,177
0132-000,2012,1,5,6,146,107,253,180
0132-000,2012,1,5,7,313,337,650,253
0132-000,2012,1,5,8,680,1210,1890,650
0132-000,2012,1,5,9,756,1226,1982,1890
0132-000,2012,1,5,10,672,867,1539,1982
0132-000,2012,1,5,11,830,946,1776,1539
0132-000,2012,1,5,12,830,914,1744,1776
0132-000,2012,1,5,13,764,799,1563,1744
0132-000,2012,1,5,14,852,898,1750,1563
0132-000,2012,1,5,15,998,899,1897,1750
0132-000,2012,1,5,16,1041,898,1939,1897
0132-000,2012,1,5,17,955,883,1838,1939
0132-000,2012,1,5,18,1120,789,1909,1838
0132-000,2012,1,5,19,1123,850,1973,1909
0132-000,2012,1,5,20,821,627,1448,1973
0132-000,2012,1,5,21,701,512,1213,1448
0132-000,2012,1,5,22,624,443,1067,1213
0132-000,2012,1,5,23,379,339,718,1067
0132-000,2012,1,5,24,257,242,499,718
0132-000,2012,1,6,1,173,170,343,499
0132-000,2012,1,6,2,124,131,255,343
0132-000,2012,1,6,3,83,113,196,255
0132-000,2012,1,6,4,75,109,184,196
0132-000,2012,1,6,5,73,105,178,184
0132-000,2012,1,6,6,162,131,293,178
0132-000,2012,1,6,7,279,330,609,293
0132-000,2012,1,6,8,655,1249,1904,609
0132-000,2012,1,6,9,833,1264,2097,1904
0132-000,2012,1,6,10,756,947,1703,2097
0132-000,2012,1,6,11,821,942,1763,1703
0132-000,2012,1,6,12,987,952,1939,1763
0132-000,2012,1,6,13,845,797,1642,1939
0132-000,2012,1,6,14,901,944,1845,1642
0132-000,2012,1,6,15,1018,966,1984,1845
0132-000,2012,1,6,16,1069,914,1983,1984
0132-000,2012,1,6,17,1084,882,1966,1983
0132-000,2012,1,6,18,1335,929,2264,1966
0132-000,2012,1,6,19,1471,967,2438,2264
0132-000,2012,1,6,20,1079,739,1818,2438
0132-000,2012,1,6,21,821,577,1398,1818
0132-000,2012,1,6,22,682,543,1225,1398
0132-000,2012,1,6,23,440,406,846,1225
0132-000,2012,1,6,24,303,282,585,846
0132-000,2012,1,7,1,214,228,442,585
0132-000,2012,1,7,2,139,167,306,442
0132-000,2012,1,7,3,117,129,246,306
0132-000,2012,1,7,4,102,140,242,246
0132-000,2012,1,7,5,91,124,215,242
0132-000,2012,1,7,6,159,131,290,215
0132-000,2012,1,7,7,243,237,480,290
0132-000,2012,1,7,8,434,612,1046,480
0132-000,2012,1,7,9,629,813,1442,1046
0132-000,2012,1,7,10,674,768,1442,1442
0132-000,2012,1,7,11,766,885,1651,1442
0132-000,2012,1,7,12,822,1006,1828,1651
0132-000,2012,1,7,13,801,1108,1909,1828
0132-000,2012,1,7,14,950,989,1939,1909
0132-000,2012,1,7,15,1000,1197,2197,1939
0132-000,2012,1,7,16,1036,1139,2175,2197
0132-000,2012,1,7,17,1146,1228,2374,2175
0132-000,2012,1,7,18,1402,1224,2626,2374
0132-000,2012,1,7,19,1169,1096,2265,2626
0132-000,2012,1,7,20,689,783,1472,2265
0132-000,2012,1,7,21,572,501,1073,1472
0132-000,2012,1,7,22,494,466,960,1073
0132-000,2012,1,7,23,355,352,707,960
0132-000,2012,1,7,24,236,260,496,707
0132-000,2012,1,8,1,166,198,364,496
0132-000,2012,1,8,2,134,164,298,364
0132-000,2012,1,8,3,110,111,221,298
0132-000,2012,1,8,4,74,90,164,221
0132-000,2012,1,8,5,86,86,172,164
0132-000,2012,1,8,6,84,104,188,172
0132-000,2012,1,8,7,143,152,295,188
0132-000,2012,1,8,8,226,290,516,295
0132-000,2012,1,8,9,281,418,699,516
0132-000,2012,1,8,10,407,470,877,699
0132-000,2012,1,8,11,519,570,1089,877
0132-000,2012,1,8,12,554,626,1180,1089
0132-000,2012,1,8,13,647,610,1257,1180
0132-000,2012,1,8,14,705,656,1361,1257
0132-000,2012,1,8,15,753,672,1425,1361
0132-000,2012,1,8,16,981,682,1663,1425
0132-000,2012,1,8,17,1184,690,1874,1663
0132-000,2012,1,8,18,1307,756,2063,1874
0132-000,2012,1,8,19,990,569,1559,2063
0132-000,2012,1,8,20,610,496,1106,1559
0132-000,2012,1,8,21,468,450,918,1106
0132-000,2012,1,8,22,397,440,837,918
0132-000,2012,1,8,23,273,310,583,837
0132-000,2012,1,8,24,189,247,436,583
0132-000,2012,1,9,1,131,149,280,436
0132-000,2012,1,9,2,93,118,211,280
0132-000,2012,1,9,3,57,72,129,211
0132-000,2012,1,9,4,46,82,128,129
0132-000,2012,1,9,5,71,86,157,128
0132-000,2012,1,9,6,184,174,358,157
0132-000,2012,1,9,7,390,496,886,358
0132-000,2012,1,9,8,734,1496,2230,886
0132-000,2012,1,9,9,810,1322,2132,2230
0132-000,2012,1,9,10,773,918,1691,2132
0132-000,2012,1,9,11,821,890,1711,1691
0132-000,2012,1,9,12,895,964,1859,1711
0132-000,2012,1,9,13,779,858,1637,1859
0132-000,2012,1,9,14,885,928,1813,1637
0132-000,2012,1,9,15,930,882,1812,1813
0132-000,2012,1,9,16,1017,967,1984,1812
0132-000,2012,1,9,17,1028,885,1913,1984
0132-000,2012,1,9,18,1179,865,2044,1913
0132-000,2012,1,9,19,1195,840,2035,2044
0132-000,2012,1,9,20,856,714,1570,2035
0132-000,2012,1,9,21,709,562,1271,1570
0132-000,2012,1,9,22,580,466,1046,1271
0132-000,2012,1,9,23,359,339,698,1046
0132-000,2012,1,9,24,230,219,449,698
0132-000,2012,1,10,1,157,150,307,449
0132-000,2012,1,10,2,122,145,267,307
0132-000,2012,1,10,3,78,86,164,267
0132-000,2012,1,10,4,69,97,166,164
0132-000,2012,1,10,5,82,96,178,166
0132-000,2012,1,10,6,149,123,272,178
0132-000,2012,1,10,7,295,365,660,272
0132-000,2012,1,10,8,681,1225,1906,660
0132-000,2012,1,10,9,838,1217,2055,1906
0132-000,2012,1,10,10,822,960,1782,2055
0132-000,2012,1,10,11,820,879,1699,1782
0132-000,2012,1,10,12,832,897,1729,1699
0132-000,2012,1,10,13,827,831,1658,1729
0132-000,2012,1,10,14,854,890,1744,1658
0132-000,2012,1,10,15,934,983,1917,1744
0132-000,2012,1,10,16,845,910,1755,1917
0132-000,2012,1,10,17,1002,874,1876,1755
0132-000,2012,1,10,18,1125,840,1965,1876
0132-000,2012,1,10,19,1130,776,1906,1965
0132-000,2012,1,10,20,871,641,1512,1906
0132-000,2012,1,10,21,707,563,1270,1512
0132-000,2012,1,10,22,623,480,1103,1270
0132-000,2012,1,10,23,379,352,731,1103
0132-000,2012,1,10,24,236,248,484,731
0132-000,2012,1,11,1,193,181,374,484
0132-000,2012,1,11,2,106,132,238,374
0132-000,2012,1,11,3,95,116,211,238
0132-000,2012,1,11,4,77,106,183,211
0132-000,2012,1,11,5,77,104,181,183
0132-000,2012,1,11,6,175,124,299,181
0132-000,2012,1,11,7,302,344,646,299
0132-000,2012,1,11,8,668,1234,1902,646
0132-000,2012,1,11,9,753,1220,1973,1902
0132-000,2012,1,11,10,786,906,1692,1973
0132-000,2012,1,11,11,854,980,1834,1692
0132-000,2012,1,11,12,933,1022,1955,1834
0132-000,2012,1,11,13,866,896,1762,1955
0132-000,2012,1,11,14,863,936,1799,1762
0132-000,2012,1,11,15,985,986,1971,1799
0132-000,2012,1,11,16,1029,904,1933,1971
0132-000,2012,1,11,17,1008,870,1878,1933
0132-000,2012,1,11,18,1244,833,2077,1878
0132-000,2012,1,11,19,1191,853,2044,2077
0132-000,2012,1,11,20,944,680,1624,2044
0132-000,2012,1,11,21,669,504,1173,1624
0132-000,2012,1,11,22,551,511,1062,1173
0132-000,2012,1,11,23,346,351,697,1062
0132-000,2012,1,11,24,276,276,552,697
0132-000,2012,1,12,1,192,191,383,552
0132-000,2012,1,12,2,116,130,246,383
0132-000,2012,1,12,3,82,102,184,246
0132-000,2012,1,12,4,70,95,165,184
0132-000,2012,1,12,5,87,103,190,165
0132-000,2012,1,12,6,159,117,276,190
0132-000,2012,1,12,7,297,355,652,276
0132-000,2012,1,12,8,659,1229,1888,652
0132-000,2012,1,12,9,813,1269,2082,1888
0132-000,2012,1,12,10,768,889,1657,2082
0132-000,2012,1,12,11,846,861,1707,1657
0132-000,2012,1,12,12,824,935,1759,1707
0132-000,2012,1,12,13,809,814,1623,1759
0132-000,2012,1,12,14,810,956,1766,1623
0132-000,2012,1,12,15,985,900,1885,1766
0132-000,2012,1,12,16,1030,946,1976,1885
0132-000,2012,1,12,17,1023,851,1874,1976
0132-000,2012,1,12,18,1138,811,1949,1874
0132-000,2012,1,12,19,1116,812,1928,1949
0132-000,2012,1,12,20,844,638,1482,1928
0132-000,2012,1,12,21,708,516,1224,1482
0132-000,2012,1,12,22,574,442,1016,1224
0132-000,2012,1,12,23,404,339,743,1016
0132-000,2012,1,12,24,228,267,495,743
0132-000,2012,1,13,1,180,221,401,495
0132-000,2012,1,13,2,117,131,248,401
0132-000,2012,1,13,3,109,120,229,248
0132-000,2012,1,13,4,67,111,178,229
0132-000,2012,1,13,5,80,99,179,178
0132-000,2012,1,13,6,164,142,306,179
0132-000,2012,1,13,7,338,322,660,306
0132-000,2012,1,13,8,671,1214,1885,660
0132-000,2012,1,13,9,842,1244,2086,1885
0132-000,2012,1,13,10,853,944,1797,2086
0132-000,2012,1,13,11,880,973,1853,1797
0132-000,2012,1,13,12,888,910,1798,1853
0132-000,2012,1,13,13,830,865,1695,1798
0132-000,2012,1,13,14,866,894,1760,1695
0132-000,2012,1,13,15,1045,972,2017,1760
0132-000,2012,1,13,16,1006,949,1955,2017
0132-000,2012,1,13,17,1090,886,1976,1955
0132-000,2012,1,13,18,1289,928,2217,1976
0132-000,2012,1,13,19,1416,885,2301,2217
0132-000,2012,1,13,20,1109,803,1912,2301
0132-000,2012,1,13,21,813,608,1421,1912
0132-000,2012,1,13,22,653,525,1178,1421
0132-000,2012,1,13,23,482,409,891,1178
0132-000,2012,1,13,24,288,275,563,891
0132-000,2012,1,14,1,190,253,443,563
0132-000,2012,1,14,2,160,183,343,443
0132-000,2012,1,14,3,127,134,261,343
0132-000,2012,1,14,4,116,135,251,261
0132-000,2012,1,14,5,95,140,235,251
0132-000,2012,1,14,6,134,152,286,235
0132-000,2012,1,14,7,236,250,486,286
0132-000,2012,1,14,8,462,675,1137,486
0132-000,2012,1,14,9,639,814,1453,1137
0132-000,2012,1,14,10,702,840,1542,1453
0132-000,2012,1,14,11,760,914,1674,1542
0132-000,2012,1,14,12,942,1041,1983,1674
0132-000,2012,1,14,13,906,1099,2005,1983
0132-000,2012,1,14,14,948,1170,2118,2005
0132-000,2012,1,14,15,1037,1051,2088,2118
0132-000,2012,1,14,16,984,1023,2007,2088
0132-000,2012,1,14,17,1219,917,2136,2007
0132-000,2012,1,14,18,1462,1018,2480,2136
0132-000,2012,1,14,19,1403,803,2206,2480
0132-000,2012,1,14,20,822,591,1413,2206
0132-000,2012,1,14,21,608,558,1166,1413
0132-000,2012,1,14,22,480,469,949,1166
0132-000,2012,1,14,23,342,380,722,949
0132-000,2012,1,14,24,274,248,522,722
0132-000,2012,1,15,1,179,224,403,522
0132-000,2012,1,15,2,137,156,293,403
0132-000,2012,1,15,3,107,119,226,293
0132-000,2012,1,15,4,82,96,178,226
0132-000,2012,1,15,5,87,96,183,178
0132-000,2012,1,15,6,104,113,217,183
0132-000,2012,1,15,7,169,203,372,217
0132-000,2012,1,15,8,227,352,579,372
0132-000,2012,1,15,9,364,462,826,579
0132-000,2012,1,15,10,444,495,939,826
0132-000,2012,1,15,11,593,662,1255,939
0132-000,2012,1,15,12,610,655,1265,1255
0132-000,2012,1,15,13,647,682,1329,1265
0132-000,2012,1,15,14,743,691,1434,1329
0132-000,2012,1,15,15,849,727,1576,1434
0132-000,2012,1,15,16,919,689,1608,1576
0132-000,2012,1,15,17,1013,783,1796,1608
0132-000,2012,1,15,18,978,672,1650,1796
0132-000,2012,1,15,19,839,641,1480,1650
0132-000,2012,1,15,20,625,496,1121,1480
0132-000,2012,1,15,21,500,473,973,1121
0132-000,2012,1,15,22,410,457,867,973
0132-000,2012,1,15,23,263,352,615,867
0132-000,2012,1,15,24,194,254,448,615
0132-000,2012,1,16,1,111,158,269,448
0132-000,2012,1,16,2,70,103,173,269
0132-000,2012,1,16,3,55,80,135,173
0132-000,2012,1,16,4,53,75,128,135
0132-000,2012,1,16,5,78,105,183,128
0132-000,2012,1,16,6,161,184,345,183
0132-000,2012,1,16,7,358,517,875,345
0132-000,2012,1,16,8,733,1523,2256,875
0132-000,2012,1,16,9,801,1428,2229,2256
0132-000,2012,1,16,10,806,956,1762,2229
0132-000,2012,1,16,11,847,948,1795,1762
0132-000,2012,1,16,12,947,1037,1984,1795
0132-000,2012,1,16,13,870,872,1742,1984
0132-000,2012,1,16,14,860,974,1834,1742
0132-000,2012,1,16,15,991,1011,2002,1834
0132-000,2012,1,16,16,1077,953,2030,2002
0132-000,2012,1,16,17,1023,895,1918,2030
0132-000,2012,1,16,18,1183,953,2136,1918
0132-000,2012,1,16,19,1198,867,2065,2136
0132-000,2012,1,16,20,907,699,1606,2065
0132-000,2012,1,16,21,732,559,1291,1606
0132-000,2012,1,16,22,626,431,1057,1291
0132-000,2012,1,16,23,348,350,698,1057
0132-000,2012,1,16,24,264,253,517,698
0132-000,2012,1,17,1,166,162,328,517
0132-000,2012,1,17,2,95,134,229,328
0132-000,2012,1,17,3,68,92,160,229
0132-000,2012,1,17,4,78,126,204,160
0132-000,2012,1,17,5,95,116,211,204
0132-000,2012,1,17,6,155,149,304,211
0132-000,2012,1,17,7,315,375,690,304
0132-000,2012,1,17,8,681,1345,2026,690
0132-000,2012,1,17,9,897,1456,2353,2026
0132-000,2012,1,17,10,898,1008,1906,2353
0132-000,2012,1,17,11,943,960,1903,1906
0132-000,2012,1,17,12,893,955,1848,1903
0132-000,2012,1,17,13,837,891,1728,1848
0132-000,2012,1,17,14,936,992,1928,1728
0132-000,2012,1,17,15,1219,1121,2340,1928
0132-000,2012,1,17,16,1185,961,2146,2340
0132-000,2012,1,17,17,1102,955,2057,2146
0132-000,2012,1,17,18,1154,860,2014,2057
0132-000,2012,1,17,19,1212,892,2104,2014
0132-000,2012,1,17,20,850,684,1534,2104
0132-000,2012,1,17,21,773,542,1315,1534
0132-000,2012,1,17,22,603,547,1150,1315
0132-000,2012,1,17,23,382,374,756,1150
0132-000,2012,1,17,24,275,221,496,756
0132-000,2012,1,18,1,160,179,339,496
0132-000,2012,1,18,2,122,136,258,339
0132-000,2012,1,18,3,91,104,195,258
0132-000,2012,1,18,4,88,107,195,195
0132-000,2012,1,18,5,78,96,174,195
0132-000,2012,1,18,6,159,123,282,174
0132-000,2012,1,18,7,324,337,661,282
0132-000,2012,1,18,8,666,1205,1871,661
0132-000,2012,1,18,9,848,1291,2139,1871
0132-000,2012,1,18,10,846,958,1804,2139
0132-000,2012,1,18,11,923,1013,1936,1804
0132-000,2012,1,18,12,974,1026,2000,1936
0132-000,2012,1,18,13,845,902,1747,2000
0132-000,2012,1,18,14,948,1011,1959,1747
0132-000,2012,1,18,15,1058,998,2056,1959
0132-000,2012,1,18,16,1074,996,2070,2056
0132-000,2012,1,18,17,1113,893,2006,2070
0132-000,2012,1,18,18,1189,959,2148,2006
0132-000,2012,1,18,19,1252,902,2154,2148
0132-000,2012,1,18,20,889,740,1629,2154
0132-000,2012,1,18,21,771,580,1351,1629
0132-000,2012,1,18,22,604,526,1130,1351
0132-000,2012,1,18,23,419,375,794,1130
0132-000,2012,1,18,24,302,268,570,794
0132-000,2012,1,19,1,163,193,356,570
0132-000,2012,1,19,2,135,138,273,356
0132-000,2012,1,19,3,86,114,200,273
0132-000,2012,1,19,4,90,96,186,200
0132-000,2012,1,19,5,84,110,194,186
0132-000,2012,1,19,6,176,137,313,194
0132-000,2012,1,19,7,307,364,671,313
0132-000,2012,1,19,8,670,1239,1909,671
0132-000,2012,1,19,9,784,1298,2082,1909
0132-000,2012,1,19,10,831,1000,1831,2082
0132-000,2012,1,19,11,877,992,1869,1831
0132-000,2012,1,19,12,891,908,1799,1869
0132-000,2012,1,19,13,889,836,1725,1799
0132-000,2012,1,19,14,919,1034,1953,1725
0132-000,2012,1,19,15,1059,1029,2088,1953
0132-000,2012,1,19,16,1144,1036,2180,2088
0132-000,2012,1,19,17,1012,871,1883,2180
0132-000,2012,1,19,18,1133,887,2020,1883
0132-000,2012,1,19,19,1197,826,2023,2020
0132-000,2012,1,19,20,896,727,1623,2023
0132-000,2012,1,19,21,838,551,1389,1623
0132-000,2012,1,19,22,588,506,1094,1389
0132-000,2012,1,19,23,421,366,787,1094
0132-000,2012,1,19,24,288,263,551,787
0132-000,2012,1,20,1,192,216,408,551
0132-000,2012,1,20,2,134,126,260,408
0132-000,2012,1,20,3,100,120,220,260
0132-000,2012,1,20,4,94,125,219,220
0132-000,2012,1,20,5,94,131,225,219
0132-000,2012,1,20,6,152,126,278,225
0132-000,2012,1,20,7,292,308,600,278
0132-000,2012,1,20,8,637,1217,1854,600
0132-000,2012,1,20,9,800,1249,2049,1854
0132-000,2012,1,20,10,820,945,1765,2049
0132-000,2012,1,20,11,873,969,1842,1765
0132-000,2012,1,20,12,972,1012,1984,1842
0132-000,2012,1,20,13,899,894,1793,1984
0132-000,2012,1,20,14,1003,1063,2066,1793
0132-000,2012,1,20,15,1021,1172,2193,2066
0132-000,2012,1,20,16,1083,1416,2499,2193
0132-000,2012,1,20,17,1134,1536,2670,2499
0132-000,2012,1,20,18,1303,1533,2836,2670
0132-000,2012,1,20,19,1294,1452,2746,2836
0132-000,2012,1,20,20,955,1405,2360,2746
0132-000,2012,1,20,21,675,1217,1892,2360
0132-000,2012,1,20,22,543,1079,1622,1892
0132-000,2012,1,20,23,409,612,1021,1622
0132-000,2012,1,20,24,243,354,597,1021
0132-000,2012,1,21,1,194,243,437,597
0132-000,2012,1,21,2,153,203,356,437
0132-000,2012,1,21,3,125,147,272,356
0132-000,2012,1,21,4,106,151,257,272
0132-000,2012,1,21,5,117,172,289,257
0132-000,2012,1,21,6,155,285,440,289
0132-000,2012,1,21,7,172,658,830,440
0132-000,2012,1,21,8,283,1294,1577,830
0132-000,2012,1,21,9,421,1731,2152,1577
0132-000,2012,1,21,10,551,1606,2157,2152
0132-000,2012,1,21,11,635,1440,2075,2157
0132-000,2012,1,21,12,713,1598,2311,2075
0132-000,2012,1,21,13,683,1601,2284,2311
0132-000,2012,1,21,14,754,1645,2399,2284
0132-000,2012,1,21,15,722,1617,2339,2399
0132-000,2012,1,21,16,734,1524,2258,2339
0132-000,2012,1,21,17,664,1467,2131,2258
0132-000,2012,1,21,18,748,1324,2072,2131
0132-000,2012,1,21,19,660,1056,1716,2072
0132-000,2012,1,21,20,453,644,1097,1716
0132-000,2012,1,21,21,373,530,903,1097
0132-000,2012,1,21,22,339,398,737,903
0132-000,2012,1,21,23,238,314,552,737
0132-000,2012,1,21,24,163,251,414,552
0132-000,2012,1,22,1,157,235,392,414
0132-000,2012,1,22,2,115,150,265,392
0132-000,2012,1,22,3,89,132,221,265
0132-000,2012,1,22,4,70,101,171,221
0132-000,2012,1,22,5,84,149,233,171
0132-000,2012,1,22,6,89,187,276,233
0132-000,2012,1,22,7,108,324,432,276
0132-000,2012,1,22,8,142,573,715,432
0132-000,2012,1,22,9,284,954,1238,715
0132-000,2012,1,22,10,472,1008,1480,1238
0132-000,2012,1,22,11,604,1000,1604,1480
0132-000,2012,1,22,12,614,1083,1697,1604
0132-000,2012,1,22,13,689,1139,1828,1697
0132-000,2012,1,22,14,632,1007,1639,1828
0132-000,2012,1,22,15,616,864,1480,1639
0132-000,2012,1,22,16,635,883,1518,1480
0132-000,2012,1,22,17,564,773,1337,1518
0132-000,2012,1,22,18,515,722,1237,1337
0132-000,2012,1,22,19,435,519,954,1237
0132-000,2012,1,22,20,326,386,712,954
0132-000,2012,1,22,21,362,365,727,712
0132-000,2012,1,22,22,303,298,601,727
0132-000,2012,1,22,23,191,242,433,601
0132-000,2012,1,22,24,133,193,326,433
0132-000,2012,1,23,1,116,132,248,326
0132-000,2012,1,23,2,66,85,151,248
0132-000,2012,1,23,3,51,64,115,151
0132-000,2012,1,23,4,51,53,104,115
0132-000,2012,1,23,5,35,41,76,104
0132-000,2012,1,23,6,100,80,180,76
0132-000,2012,1,23,7,243,254,497,180
0132-000,2012,1,23,8,405,606,1011,497
0132-000,2012,1,23,9,430,575,1005,1011
0132-000,2012,1,23,10,478,489,967,1005
0132-000,2012,1,23,11,1146,877,2023,967
0132-000,2012,1,23,12,1958,1415,3373,2023
0132-000,2012,1,23,13,1985,1587,3572,3373
0132-000,2012,1,23,14,2131,1844,3975,3572
0132-000,2012,1,23,15,1948,1823,3771,3975
0132-000,2012,1,23,16,1987,1869,3856,3771
0132-000,2012,1,23,17,1950,1759,3709,3856
0132-000,2012,1,23,18,2163,1659,3822,3709
0132-000,2012,1,23,19,2042,1331,3373,3822
0132-000,2012,1,23,20,1954,1089,3043,3373
0132-000,2012,1,23,21,2060,721,2781,3043
0132-000,2012,1,23,22,2136,416,2552,2781
0132-000,2012,1,23,23,1950,266,2216,2552
0132-000,2012,1,23,24,1535,190,1725,2216
0132-000,2012,1,24,1,1402,148,1550,1725
0132-000,2012,1,24,2,1243,98,1341,1550
0132-000,2012,1,24,3,743,79,822,1341
0132-000,2012,1,24,4,378,50,428,822
0132-000,2012,1,24,5,223,58,281,428
0132-000,2012,1,24,6,176,55,231,281
0132-000,2012,1,24,7,164,55,219,231
0132-000,2012,1,24,8,233,138,371,219
0132-000,2012,1,24,9,583,199,782,371
0132-000,2012,1,24,10,888,272,1160,782
0132-000,2012,1,24,11,1406,421,1827,1160
0132-000,2012,1,24,12,1583,551,2134,1827
0132-000,2012,1,24,13,1611,625,2236,2134
0132-000,2012,1,24,14,1997,951,2948,2236
0132-000,2012,1,24,15,2093,1068,3161,2948
0132-000,2012,1,24,16,2044,897,2941,3161
0132-000,2012,1,24,17,1853,797,2650,2941
0132-000,2012,1,24,18,1834,681,2515,2650
0132-000,2012,1,24,19,1874,555,2429,2515
0132-000,2012,1,24,20,1830,434,2264,2429
0132-000,2012,1,24,21,1690,463,2153,2264
0132-000,2012,1,24,22,1236,397,1633,2153
0132-000,2012,1,24,23,1361,301,1662,1633
0132-000,2012,1,24,24,1174,211,1385,1662
0132-000,2012,1,25,1,614,127,741,1385
0132-000,2012,1,25,2,266,100,366,741
0132-000,2012,1,25,3,82,89,171,366
0132-000,2012,1,25,4,53,62,115,171
0132-000,2012,1,25,5,57,73,130,115
0132-000,2012,1,25,6,97,113,210,130
0132-000,2012,1,25,7,199,272,471,210
0132-000,2012,1,25,8,420,972,1392,471
0132-000,2012,1,25,9,556,896,1452,1392
0132-000,2012,1,25,10,560,641,1201,1452
0132-000,2012,1,25,11,616,689,1305,1201
0132-000,2012,1,25,12,690,675,1365,1305
0132-000,2012,1,25,13,1052,654,1706,1365
0132-000,2012,1,25,14,1095,740,1835,1706
0132-000,2012,1,25,15,1199,724,1923,1835
0132-000,2012,1,25,16,1484,747,2231,1923
0132-000,2012,1,25,17,1374,684,2058,2231
0132-000,2012,1,25,18,1705,721,2426,2058
0132-000,2012,1,25,19,1562,754,2316,2426
0132-000,2012,1,25,20,1364,530,1894,2316
0132-000,2012,1,25,21,876,425,1301,1894
0132-000,2012,1,25,22,560,402,962,1301
0132-000,2012,1,25,23,313,294,607,962
0132-000,2012,1,25,24,214,213,427,607
0132-000,2012,1,26,1,136,156,292,427
0132-000,2012,1,26,2,82,104,186,292
0132-000,2012,1,26,3,67,80,147,186
0132-000,2012,1,26,4,59,77,136,147
0132-000,2012,1,26,5,80,76,156,136
0132-000,2012,1,26,6,142,145,287,156
0132-000,2012,1,26,7,306,346,652,287
0132-000,2012,1,26,8,614,1243,1857,652
0132-000,2012,1,26,9,753,1189,1942,1857
0132-000,2012,1,26,10,807,892,1699,1942
0132-000,2012,1,26,11,779,960,1739,1699
0132-000,2012,1,26,12,839,854,1693,1739
0132-000,2012,1,26,13,778,853,1631,1693
0132-000,2012,1,26,14,902,921,1823,1631
0132-000,2012,1,26,15,984,940,1924,1823
0132-000,2012,1,26,16,978,850,1828,1924
0132-000,2012,1,26,17,922,813,1735,1828
0132-000,2012,1,26,18,1043,771,1814,1735
0132-000,2012,1,26,19,1062,804,1866,1814
0132-000,2012,1,26,20,796,618,1414,1866
0132-000,2012,1,26,21,612,518,1130,1414
0132-000,2012,1,26,22,530,440,970,1130
0132-000,2012,1,26,23,325,300,625,970
0132-000,2012,1,26,24,241,215,456,625
0132-000,2012,1,27,1,152,160,312,456
0132-000,2012,1,27,2,97,123,220,312
0132-000,2012,1,27,3,61,80,141,220
0132-000,2012,1,27,4,78,88,166,141
0132-000,2012,1,27,5,89,117,206,166
0132-000,2012,1,27,6,157,131,288,206
0132-000,2012,1,27,7,299,323,622,288
0132-000,2012,1,27,8,617,1211,1828,622
0132-000,2012,1,27,9,788,1225,2013,1828
0132-000,2012,1,27,10,766,857,1623,2013
0132-000,2012,1,27,11,833,916,1749,1623
0132-000,2012,1,27,12,877,912,1789,1749
0132-000,2012,1,27,13,791,816,1607,1789
0132-000,2012,1,27,14,852,921,1773,1607
0132-000,2012,1,27,15,978,988,1966,1773
0132-000,2012,1,27,16,1047,861,1908,1966
0132-000,2012,1,27,17,1025,825,1850,1908
0132-000,2012,1,27,18,1174,824,1998,1850
0132-000,2012,1,27,19,1363,864,2227,1998
0132-000,2012,1,27,20,1014,738,1752,2227
0132-000,2012,1,27,21,803,561,1364,1752
0132-000,2012,1,27,22,623,466,1089,1364
0132-000,2012,1,27,23,382,355,737,1089
0132-000,2012,1,27,24,260,259,519,737
0132-000,2012,1,28,1,202,190,392,519
0132-000,2012,1,28,2,148,130,278,392
0132-000,2012,1,28,3,112,123,235,278
0132-000,2012,1,28,4,105,120,225,235
0132-000,2012,1,28,5,90,125,215,225
0132-000,2012,1,28,6,135,136,271,215
0132-000,2012,1,28,7,276,254,530,271
0132-000,2012,1,28,8,438,675,1113,530
0132-000,2012,1,28,9,615,784,1399,1113
0132-000,2012,1,28,10,724,805,1529,1399
0132-000,2012,1,28,11,813,897,1710,1529
0132-000,2012,1,28,12,764,874,1638,1710
0132-000,2012,1,28,13,796,909,1705,1638
0132-000,2012,1,28,14,838,883,1721,1705
0132-000,2012,1,28,15,931,808,1739,1721
0132-000,2012,1,28,16,948,869,1817,1739
0132-000,2012,1,28,17,1068,825,1893,1817
0132-000,2012,1,28,18,1304,810,2114,1893
0132-000,2012,1,28,19,1109,695,1804,2114
0132-000,2012,1,28,20,677,579,1256,1804
0132-000,2012,1,28,21,531,491,1022,1256
0132-000,2012,1,28,22,419,457,876,1022
0132-000,2012,1,28,23,322,325,647,876
0132-000,2012,1,28,24,239,249,488,647
0132-000,2012,1,29,1,129,191,320,488
0132-000,2012,1,29,2,111,127,238,320
0132-000,2012,1,29,3,91,112,203,238
0132-000,2012,1,29,4,79,70,149,203
0132-000,2012,1,29,5,72,76,148,149
0132-000,2012,1,29,6,77,116,193,148
0132-000,2012,1,29,7,133,147,280,193
0132-000,2012,1,29,8,224,278,502,280
0132-000,2012,1,29,9,330,409,739,502
0132-000,2012,1,29,10,421,505,926,739
0132-000,2012,1,29,11,533,578,1111,926
0132-000,2012,1,29,12,534,532,1066,1111
0132-000,2012,1,29,13,593,589,1182,1066
0132-000,2012,1,29,14,648,633,1281,1182
0132-000,2012,1,29,15,701,632,1333,1281
0132-000,2012,1,29,16,825,669,1494,1333
0132-000,2012,1,29,17,964,669,1633,1494
0132-000,2012,1,29,18,955,647,1602,1633
0132-000,2012,1,29,19,798,565,1363,1602
0132-000,2012,1,29,20,523,481,1004,1363
0132-000,2012,1,29,21,418,412,830,1004
0132-000,2012,1,29,22,390,388,778,830
0132-000,2012,1,29,23,232,327,559,778
0132-000,2012,1,29,24,162,245,407,559
0132-000,2012,1,30,1,108,135,243,407
0132-000,2012,1,30,2,85,101,186,243
0132-000,2012,1,30,3,48,72,120,186
0132-000,2012,1,30,4,73,72,145,120
0132-000,2012,1,30,5,68,115,183,145
0132-000,2012,1,30,6,153,163,316,183
0132-000,2012,1,30,7,392,499,891,316
0132-000,2012,1,30,8,745,1482,2227,891
0132-000,2012,1,30,9,761,1321,2082,2227
0132-000,2012,1,30,10,789,901,1690,2082
0132-000,2012,1,30,11,874,966,1840,1690
0132-000,2012,1,30,12,872,920,1792,1840
0132-000,2012,1,30,13,771,851,1622,1792
0132-000,2012,1,30,14,881,896,1777,1622
0132-000,2012,1,30,15,955,1006,1961,1777
0132-000,2012,1,30,16,1013,934,1947,1961
0132-000,2012,1,30,17,1006,860,1866,1947
0132-000,2012,1,30,18,1148,863,2011,1866
0132-000,2012,1,30,19,1156,810,1966,2011
0132-000,2012,1,30,20,864,697,1561,1966
0132-000,2012,1,30,21,701,529,1230,1561
0132-000,2012,1,30,22,576,464,1040,1230
0132-000,2012,1,30,23,375,389,764,1040
0132-000,2012,1,30,24,233,243,476,764
0132-000,2012,1,31,1,171,140,311,476
0132-000,2012,1,31,2,86,120,206,311
0132-000,2012,1,31,3,72,96,168,206
0132-000,2012,1,31,4,69,90,159,168
0132-000,2012,1,31,5,72,96,168,159
0132-000,2012,1,31,6,173,127,300,168
0132-000,2012,1,31,7,311,309,620,300
0132-000,2012,1,31,8,605,1274,1879,620
0132-000,2012,1,31,9,822,1180,2002,1879
0132-000,2012,1,31,10,820,931,1751,2002
0132-000,2012,1,31,11,824,931,1755,1751
0132-000,2012,1,31,12,915,870,1785,1755
0132-000,2012,1,31,13,809,793,1602,1785
0132-000,2012,1,31,14,886,864,1750,1602
0132-000,2012,1,31,15,1008,949,1957,1750
0132-000,2012,1,31,16,966,871,1837,1957
0132-000,2012,1,31,17,930,771,1701,1837
0132-000,2012,1,31,18,808,651,1459,1701
0132-000,2012,1,31,19,907,631,1538,1459
0132-000,2012,1,31,20,616,426,1042,1538
0132-000,2012,1,31,21,444,294,738,1042
0132-000,2012,1,31,22,341,267,608,738
0132-000,2012,1,31,23,210,199,409,608
0132-000,2012,1,31,24,137,135,272,409
0132-000,2012,2,1,1,115,85,200,272
0132-000,2012,2,1,2,57,76,133,200
0132-000,2012,2,1,3,52,69,121,133
0132-000,2012,2,1,4,51,67,118,121
0132-000,2012,2,1,5,50,60,110,118
0132-000,2012,2,1,6,98,80,178,110
0132-000,2012,2,1,7,179,218,397,178
0132-000,2012,2,1,8,424,887,1311,397
0132-000,2012,2,1,9,537,874,1411,1311
0132-000,2012,2,1,10,554,638,1192,1411
0132-000,2012,2,1,11,599,664,1263,1192
0132-000,2012,2,1,12,615,676,1291,1263
0132-000,2012,2,1,13,607,610,1217,1291
0132-000,2012,2,1,14,770,787,1557,1217
0132-000,2012,2,1,15,748,829,1577,1557
0132-000,2012,2,1,16,826,702,1528,1577
0132-000,2012,2,1,17,768,737,1505,1528
0132-000,2012,2,1,18,1005,663,1668,1505
0132-000,2012,2,1,19,968,746,1714,1668
0132-000,2012,2,1,20,763,542,1305,1714
0132-000,2012,2,1,21,575,420,995,1305
0132-000,2012,2,1,22,438,364,802,995
0132-000,2012,2,1,23,293,266,559,802
0132-000,2012,2,1,24,198,195,393,559
0132-000,2012,2,2,1,129,147,276,393
0132-000,2012,2,2,2,106,103,209,276
0132-000,2012,2,2,3,79,81,160,209
0132-000,2012,2,2,4,55,87,142,160
0132-000,2012,2,2,5,65,82,147,142
0132-000,2012,2,2,6,109,80,189,147
0132-000,2012,2,2,7,239,264,503,189
0132-000,2012,2,2,8,589,1193,1782,503
0132-000,2012,2,2,9,707,1153,1860,1782
0132-000,2012,2,2,10,731,810,1541,1860
0132-000,2012,2,2,11,787,839,1626,1541
0132-000,2012,2,2,12,796,783,1579,1626
0132-000,2012,2,2,13,724,785,1509,1579
0132-000,2012,2,2,14,846,873,1719,1509
0132-000,2012,2,2,15,888,847,1735,1719
0132-000,2012,2,2,16,946,823,1769,1735
0132-000,2012,2,2,17,949,805,1754,1769
0132-000,2012,2,2,18,1009,743,1752,1754
0132-000,2012,2,2,19,1030,774,1804,1752
0132-000,2012,2,2,20,769,617,1386,1804
0132-000,2012,2,2,21,644,487,1131,1386
0132-000,2012,2,2,22,508,396,904,1131
0132-000,2012,2,2,23,371,294,665,904
0132-000,2012,2,2,24,246,221,467,665
0132-000,2012,2,3,1,165,157,322,467
0132-000,2012,2,3,2,107,129,236,322
0132-000,2012,2,3,3,79,100,179,236
0132-000,2012,2,3,4,66,84,150,179
0132-000,2012,2,3,5,84,82,166,150
0132-000,2012,2,3,6,129,114,243,166
0132-000,2012,2,3,7,296,304,600,243
0132-000,2012,2,3,8,636,1182,1818,600
0132-000,2012,2,3,9,771,1155,1926,1818
0132-000,2012,2,3,10,729,819,1548,1926
0132-000,2012,2,3,11,808,955,1763,1548
0132-000,2012,2,3,12,843,913,1756,1763
0132-000,2012,2,3,13,861,848,1709,1756
0132-000,2012,2,3,14,892,913,1805,1709
0132-000,2012,2,3,15,939,995,1934,1805
0132-000,2012,2,3,16,992,1051,2043,1934
0132-000,2012,2,3,17,1021,909,1930,2043
0132-000,2012,2,3,18,1235,866,2101,1930
0132-000,2012,2,3,19,1391,872,2263,2101
0132-000,2012,2,3,20,964,695,1659,2263
0132-000,2012,2,3,21,961,549,1510,1659
0132-000,2012,2,3,22,598,447,1045,1510
0132-000,2012,2,3,23,409,351,760,1045
0132-000,2012,2,3,24,256,260,516,760
0132-000,2012,2,4,1,200,229,429,516
0132-000,2012,2,4,2,148,150,298,429
0132-000,2012,2,4,3,108,108,216,298
0132-000,2012,2,4,4,79,134,213,216
0132-000,2012,2,4,5,92,127,219,213
0132-000,2012,2,4,6,148,124,272,219
0132-000,2012,2,4,7,209,193,402,272
0132-000,2012,2,4,8,428,576,1004,402
0132-000,2012,2,4,9,609,777,1386,1004
0132-000,2012,2,4,10,682,832,1514,1386
0132-000,2012,2,4,11,734,843,1577,1514
0132-000,2012,2,4,12,806,854,1660,1577
0132-000,2012,2,4,13,862,950,1812,1660
0132-000,2012,2,4,14,911,1087,1998,1812
0132-000,2012,2,4,15,953,927,1880,1998
0132-000,2012,2,4,16,1031,852,1883,1880
0132-000,2012,2,4,17,1278,833,2111,1883
0132-000,2012,2,4,18,1550,895,2445,2111
0132-000,2012,2,4,19,1238,825,2063,2445
0132-000,2012,2,4,20,758,649,1407,2063
0132-000,2012,2,4,21,572,506,1078,1407
0132-000,2012,2,4,22,467,441,908,1078
0132-000,2012,2,4,23,347,314,661,908
0132-000,2012,2,4,24,206,261,467,661
0132-000,2012,2,5,1,175,195,370,467
0132-000,2012,2,5,2,123,135,258,370
0132-000,2012,2,5,3,83,113,196,258
0132-000,2012,2,5,4,93,99,192,196
0132-000,2012,2,5,5,86,85,171,192
0132-000,2012,2,5,6,91,85,176,171
0132-000,2012,2,5,7,126,150,276,176
0132-000,2012,2,5,8,216,275,491,276
0132-000,2012,2,5,9,321,422,743,491
0132-000,2012,2,5,10,399,444,843,743
0132-000,2012,2,5,11,509,606,1115,843
0132-000,2012,2,5,12,563,612,1175,1115
0132-000,2012,2,5,13,655,627,1282,1175
0132-000,2012,2,5,14,693,669,1362,1282
0132-000,2012,2,5,15,705,679,1384,1362
0132-000,2012,2,5,16,828,722,1550,1384
0132-000,2012,2,5,17,932,666,1598,1550
0132-000,2012,2,5,18,891,664,1555,1598
0132-000,2012,2,5,19,823,566,1389,1555
0132-000,2012,2,5,20,610,492,1102,1389
0132-000,2012,2,5,21,441,477,918,1102
0132-000,2012,2,5,22,428,386,814,918
0132-000,2012,2,5,23,253,310,563,814
0132-000,2012,2,5,24,166,217,383,563
0132-000,2012,2,6,1,117,140,257,383
0132-000,2012,2,6,2,88,105,193,257
0132-000,2012,2,6,3,57,71,128,193
0132-000,2012,2,6,4,50,66,116,128
0132-000,2012,2,6,5,66,96,162,116
0132-000,2012,2,6,6,170,159,329,162
0132-000,2012,2,6,7,401,480,881,329
0132-000,2012,2,6,8,733,1485,2218,881
0132-000,2012,2,6,9,809,1387,2196,2218
0132-000,2012,2,6,10,729,910,1639,2196
0132-000,2012,2,6,11,798,953,1751,1639
0132-000,2012,2,6,12,821,936,1757,1751
0132-000,2012,2,6,13,868,832,1700,1757
0132-000,2012,2,6,14,842,898,1740,1700
0132-000,2012,2,6,15,957,891,1848,1740
0132-000,2012,2,6,16,981,920,1901,1848
0132-000,2012,2,6,17,1023,874,1897,1901
0132-000,2012,2,6,18,1158,795,1953,1897
0132-000,2012,2,6,19,1104,852,1956,1953
0132-000,2012,2,6,20,824,619,1443,1956
0132-000,2012,2,6,21,652,568,1220,1443
0132-000,2012,2,6,22,524,441,965,1220
0132-000,2012,2,6,23,353,323,676,965
0132-000,2012,2,6,24,217,201,418,676
0132-000,2012,2,7,1,150,168,318,418
0132-000,2012,2,7,2,116,101,217,318
0132-000,2012,2,7,3,61,109,170,217
0132-000,2012,2,7,4,74,87,161,170
0132-000,2012,2,7,5,68,94,162,161
0132-000,2012,2,7,6,160,127,287,162
0132-000,2012,2,7,7,318,312,630,287
0132-000,2012,2,7,8,648,1341,1989,630
0132-000,2012,2,7,9,829,1239,2068,1989
0132-000,2012,2,7,10,808,919,1727,2068
0132-000,2012,2,7,11,812,855,1667,1727
0132-000,2012,2,7,12,868,924,1792,1667
0132-000,2012,2,7,13,786,777,1563,1792
0132-000,2012,2,7,14,848,894,1742,1563
0132-000,2012,2,7,15,882,890,1772,1742
0132-000,2012,2,7,16,1019,861,1880,1772
0132-000,2012,2,7,17,960,811,1771,1880
0132-000,2012,2,7,18,1037,867,1904,1771
0132-000,2012,2,7,19,1185,863,2048,1904
0132-000,2012,2,7,20,794,625,1419,2048
0132-000,2012,2,7,21,719,496,1215,1419
0132-000,2012,2,7,22,607,438,1045,1215
0132-000,2012,2,7,23,382,293,675,1045
0132-000,2012,2,7,24,234,234,468,675
0132-000,2012,2,8,1,144,151,295,468
0132-000,2012,2,8,2,86,110,196,295
0132-000,2012,2,8,3,77,100,177,196
0132-000,2012,2,8,4,64,76,140,177
0132-000,2012,2,8,5,66,86,152,140
0132-000,2012,2,8,6,145,123,268,152
0132-000,2012,2,8,7,279,312,591,268
0132-000,2012,2,8,8,625,1208,1833,591
0132-000,2012,2,8,9,773,1218,1991,1833
0132-000,2012,2,8,10,753,856,1609,1991
0132-000,2012,2,8,11,826,902,1728,1609
0132-000,2012,2,8,12,810,838,1648,1728
0132-000,2012,2,8,13,766,767,1533,1648
0132-000,2012,2,8,14,838,850,1688,1533
0132-000,2012,2,8,15,944,929,1873,1688
0132-000,2012,2,8,16,967,907,1874,1873
0132-000,2012,2,8,17,1011,808,1819,1874
0132-000,2012,2,8,18,1084,834,1918,1819
0132-000,2012,2,8,19,1213,844,2057,1918
0132-000,2012,2,8,20,817,664,1481,2057
0132-000,2012,2,8,21,654,519,1173,1481
0132-000,2012,2,8,22,451,451,902,1173
0132-000,2012,2,8,23,299,325,624,902
0132-000,2012,2,8,24,214,202,416,624
0132-000,2012,2,9,1,121,148,269,416
0132-000,2012,2,9,2,111,101,212,269
0132-000,2012,2,9,3,64,97,161,212
0132-000,2012,2,9,4,56,91,147,161
0132-000,2012,2,9,5,87,94,181,147
0132-000,2012,2,9,6,146,118,264,181
0132-000,2012,2,9,7,255,273,528,264
0132-000,2012,2,9,8,455,1104,1559,528
0132-000,2012,2,9,9,749,1227,1976,1559
0132-000,2012,2,9,10,714,1036,1750,1976
0132-000,2012,2,9,11,795,1496,2291,1750
0132-000,2012,2,9,12,864,1286,2150,2291
0132-000,2012,2,9,13,1125,819,1944,2150
0132-000,2012,2,9,14,1536,952,2488,1944
0132-000,2012,2,9,15,1102,915,2017,2488
0132-000,2012,2,9,16,1046,898,1944,2017
0132-000,2012,2,9,17,1002,812,1814,1944
0132-000,2012,2,9,18,999,815,1814,1814
0132-000,2012,2,9,19,1113,780,1893,1814
0132-000,2012,2,9,20,844,590,1434,1893
0132-000,2012,2,9,21,689,488,1177,1434
0132-000,2012,2,9,22,479,429,908,1177
0132-000,2012,2,9,23,383,307,690,908
0132-000,2012,2,9,24,240,226,466,690
0132-000,2012,2,10,1,168,141,309,466
0132-000,2012,2,10,2,111,135,246,309
0132-000,2012,2,10,3,93,122,215,246
0132-000,2012,2,10,4,81,93,174,215
0132-000,2012,2,10,5,75,107,182,174
0132-000,2012,2,10,6,155,109,264,182
0132-000,2012,2,10,7,322,348,670,264
0132-000,2012,2,10,8,682,1256,1938,670
0132-000,2012,2,10,9,823,1213,2036,1938
0132-000,2012,2,10,10,797,876,1673,2036
0132-000,2012,2,10,11,805,936,1741,1673
0132-000,2012,2,10,12,867,861,1728,1741
0132-000,2012,2,10,13,818,793,1611,1728
0132-000,2012,2,10,14,924,910,1834,1611
0132-000,2012,2,10,15,937,968,1905,1834
0132-000,2012,2,10,16,1002,890,1892,1905
0132-000,2012,2,10,17,1034,845,1879,1892
0132-000,2012,2,10,18,1285,891,2176,1879
0132-000,2012,2,10,19,1457,911,2368,2176
0132-000,2012,2,10,20,1019,747,1766,2368
0132-000,2012,2,10,21,758,599,1357,1766
0132-000,2012,2,10,22,617,498,1115,1357
0132-000,2012,2,10,23,446,359,805,1115
0132-000,2012,2,10,24,301,315,616,805
0132-000,2012,2,11,1,219,228,447,616
0132-000,2012,2,11,2,142,168,310,447
0132-000,2012,2,11,3,99,141,240,310
0132-000,2012,2,11,4,110,148,258,240
0132-000,2012,2,11,5,109,132,241,258
0132-000,2012,2,11,6,140,96,236,241
0132-000,2012,2,11,7,238,226,464,236
0132-000,2012,2,11,8,418,638,1056,464
0132-000,2012,2,11,9,602,838,1440,1056
0132-000,2012,2,11,10,707,789,1496,1440
0132-000,2012,2,11,11,745,984,1729,1496
0132-000,2012,2,11,12,949,1098,2047,1729
0132-000,2012,2,11,13,1108,1244,2352,2047
0132-000,2012,2,11,14,1058,1192,2250,2352
0132-000,2012,2,11,15,1104,1184,2288,2250
0132-000,2012,2,11,16,1202,1079,2281,2288
0132-000,2012,2,11,17,1450,1055,2505,2281
0132-000,2012,2,11,18,1543,1080,2623,2505
0132-000,2012,2,11,19,1417,1052,2469,2623
0132-000,2012,2,11,20,808,698,1506,2469
0132-000,2012,2,11,21,558,581,1139,1506
0132-000,2012,2,11,22,454,503,957,1139
0132-000,2012,2,11,23,339,368,707,957
0132-000,2012,2,11,24,221,299,520,707
0132-000,2012,2,12,1,195,225,420,520
0132-000,2012,2,12,2,107,168,275,420
0132-000,2012,2,12,3,83,101,184,275
0132-000,2012,2,12,4,80,94,174,184
0132-000,2012,2,12,5,89,84,173,174
0132-000,2012,2,12,6,95,88,183,173
0132-000,2012,2,12,7,135,158,293,183
0132-000,2012,2,12,8,226,253,479,293
0132-000,2012,2,12,9,325,435,760,479
0132-000,2012,2,12,10,384,457,841,760
0132-000,2012,2,12,11,508,659,1167,841
0132-000,2012,2,12,12,590,603,1193,1167
0132-000,2012,2,12,13,610,739,1349,1193
0132-000,2012,2,12,14,686,694,1380,1349
0132-000,2012,2,12,15,858,652,1510,1380
0132-000,2012,2,12,16,955,741,1696,1510
0132-000,2012,2,12,17,1205,731,1936,1696
0132-000,2012,2,12,18,1205,664,1869,1936
0132-000,2012,2,12,19,857,612,1469,1869
0132-000,2012,2,12,20,653,463,1116,1469
0132-000,2012,2,12,21,476,439,915,1116
0132-000,2012,2,12,22,415,391,806,915
0132-000,2012,2,12,23,264,327,591,806
0132-000,2012,2,12,24,172,214,386,591
0132-000,2012,2,13,1,128,152,280,386
0132-000,2012,2,13,2,83,102,185,280
0132-000,2012,2,13,3,52,84,136,185
0132-000,2012,2,13,4,48,73,121,136
0132-000,2012,2,13,5,73,97,170,121
0132-000,2012,2,13,6,169,194,363,170
0132-000,2012,2,13,7,382,518,900,363
0132-000,2012,2,13,8,759,1520,2279,900
0132-000,2012,2,13,9,800,1373,2173,2279
0132-000,2012,2,13,10,758,877,1635,2173
0132-000,2012,2,13,11,802,941,1743,1635
0132-000,2012,2,13,12,859,887,1746,1743
0132-000,2012,2,13,13,815,862,1677,1746
0132-000,2012,2,13,14,843,954,1797,1677
0132-000,2012,2,13,15,931,926,1857,1797
0132-000,2012,2,13,16,1006,919,1925,1857
0132-000,2012,2,13,17,1032,837,1869,1925
0132-000,2012,2,13,18,1106,877,1983,1869
0132-000,2012,2,13,19,1151,833,1984,1983
0132-000,2012,2,13,20,829,648,1477,1984
0132-000,2012,2,13,21,716,552,1268,1477
0132-000,2012,2,13,22,560,456,1016,1268
0132-000,2012,2,13,23,374,337,711,1016
0132-000,2012,2,13,24,210,229,439,711
0132-000,2012,2,14,1,142,138,280,439
0132-000,2012,2,14,2,98,113,211,280
0132-000,2012,2,14,3,70,107,177,211
0132-000,2012,2,14,4,65,102,167,177
0132-000,2012,2,14,5,64,106,170,167
0132-000,2012,2,14,6,176,131,307,170
0132-000,2012,2,14,7,343,339,682,307
0132-000,2012,2,14,8,703,1266,1969,682
0132-000,2012,2,14,9,816,1179,1995,1969
0132-000,2012,2,14,10,748,918,1666,1995
0132-000,2012,2,14,11,868,959,1827,1666
0132-000,2012,2,14,12,905,875,1780,1827
0132-000,2012,2,14,13,808,844,1652,1780
0132-000,2012,2,14,14,841,953,1794,1652
0132-000,2012,2,14,15,939,973,1912,1794
0132-000,2012,2,14,16,978,853,1831,1912
0132-000,2012,2,14,17,1046,860,1906,1831
0132-000,2012,2,14,18,1088,882,1970,1906
0132-000,2012,2,14,19,1168,832,2000,1970
0132-000,2012,2,14,20,898,723,1621,2000
0132-000,2012,2,14,21,773,536,1309,1621
0132-000,2012,2,14,22,598,507,1105,1309
0132-000,2012,2,14,23,383,357,740,1105
0132-000,2012,2,14,24,246,254,500,740
0132-000,2012,2,15,1,195,183,378,500
0132-000,2012,2,15,2,120,126,246,378
0132-000,2012,2,15,3,89,93,182,246
0132-000,2012,2,15,4,64,96,160,182
0132-000,2012,2,15,5,96,121,217,160
0132-000,2012,2,15,6,151,101,252,217
0132-000,2012,2,15,7,356,336,692,252
0132-000,2012,2,15,8,690,1267,1957,692
0132-000,2012,2,15,9,884,1266,2150,1957
0132-000,2012,2,15,10,849,903,1752,2150
0132-000,2012,2,15,11,906,906,1812,1752
0132-000,2012,2,15,12,854,869,1723,1812
0132-000,2012,2,15,13,787,869,1656,1723
0132-000,2012,2,15,14,903,955,1858,1656
0132-000,2012,2,15,15,946,984,1930,1858
0132-000,2012,2,15,16,993,932,1925,1930
0132-000,2012,2,15,17,1039,851,1890,1925
0132-000,2012,2,15,18,1150,903,2053,1890
0132-000,2012,2,15,19,1207,870,2077,2053
0132-000,2012,2,15,20,858,657,1515,2077
0132-000,2012,2,15,21,670,547,1217,1515
0132-000,2012,2,15,22,550,491,1041,1217
0132-000,2012,2,15,23,361,349,710,1041
0132-000,2012,2,15,24,238,244,482,710
0132-000,2012,2,16,1,167,188,355,482
0132-000,2012,2,16,2,136,130,266,355
0132-000,2012,2,16,3,81,110,191,266
0132-000,2012,2,16,4,77,109,186,191
0132-000,2012,2,16,5,81,113,194,186
0132-000,2012,2,16,6,180,126,306,194
0132-000,2012,2,16,7,337,330,667,306
0132-000,2012,2,16,8,656,1306,1962,667
0132-000,2012,2,16,9,793,1246,2039,1962
0132-000,2012,2,16,10,791,968,1759,2039
0132-000,2012,2,16,11,858,943,1801,1759
0132-000,2012,2,16,12,891,920,1811,1801
0132-000,2012,2,16,13,792,882,1674,1811
0132-000,2012,2,16,14,893,884,1777,1674
0132-000,2012,2,16,15,1025,949,1974,1777
0132-000,2012,2,16,16,1054,901,1955,1974
0132-000,2012,2,16,17,1100,870,1970,1955
0132-000,2012,2,16,18,1261,903,2164,1970
0132-000,2012,2,16,19,1275,781,2056,2164
0132-000,2012,2,16,20,810,679,1489,2056
0132-000,2012,2,16,21,733,573,1306,1489
0132-000,2012,2,16,22,597,438,1035,1306
0132-000,2012,2,16,23,360,304,664,1035
0132-000,2012,2,16,24,205,219,424,664
0132-000,2012,2,17,1,155,182,337,424
0132-000,2012,2,17,2,115,116,231,337
0132-000,2012,2,17,3,86,102,188,231
0132-000,2012,2,17,4,69,94,163,188
0132-000,2012,2,17,5,90,108,198,163
0132-000,2012,2,17,6,171,117,288,198
0132-000,2012,2,17,7,333,322,655,288
0132-000,2012,2,17,8,660,1258,1918,655
0132-000,2012,2,17,9,805,1207,2012,1918
0132-000,2012,2,17,10,769,889,1658,2012
0132-000,2012,2,17,11,829,996,1825,1658
0132-000,2012,2,17,12,812,918,1730,1825
0132-000,2012,2,17,13,849,797,1646,1730
0132-000,2012,2,17,14,969,912,1881,1646
0132-000,2012,2,17,15,1004,970,1974,1881
0132-000,2012,2,17,16,1011,882,1893,1974
0132-000,2012,2,17,17,1078,812,1890,1893
0132-000,2012,2,17,18,1252,824,2076,1890
0132-000,2012,2,17,19,1426,957,2383,2076
0132-000,2012,2,17,20,1004,760,1764,2383
0132-000,2012,2,17,21,791,632,1423,1764
0132-000,2012,2,17,22,638,528,1166,1423
0132-000,2012,2,17,23,426,373,799,1166
0132-000,2012,2,17,24,264,284,548,799
0132-000,2012,2,18,1,217,239,456,548
0132-000,2012,2,18,2,152,166,318,456
0132-000,2012,2,18,3,97,132,229,318
0132-000,2012,2,18,4,92,111,203,229
0132-000,2012,2,18,5,111,129,240,203
0132-000,2012,2,18,6,134,121,255,240
0132-000,2012,2,18,7,267,241,508,255
0132-000,2012,2,18,8,450,637,1087,508
0132-000,2012,2,18,9,618,783,1401,1087
0132-000,2012,2,18,10,710,820,1530,1401
0132-000,2012,2,18,11,826,969,1795,1530
0132-000,2012,2,18,12,875,1194,2069,1795
0132-000,2012,2,18,13,917,1346,2263,2069
0132-000,2012,2,18,14,1006,1348,2354,2263
0132-000,2012,2,18,15,1132,1328,2460,2354
0132-000,2012,2,18,16,1206,1241,2447,2460
0132-000,2012,2,18,17,1420,1164,2584,2447
0132-000,2012,2,18,18,1620,1252,2872,2584
0132-000,2012,2,18,19,1513,1164,2677,2872
0132-000,2012,2,18,20,1021,694,1715,2677
0132-000,2012,2,18,21,665,524,1189,1715
0132-000,2012,2,18,22,494,455,949,1189
0132-000,2012,2,18,23,350,375,725,949
0132-000,2012,2,18,24,239,273,512,725
0132-000,2012,2,19,1,160,204,364,512
0132-000,2012,2,19,2,123,140,263,364
0132-000,2012,2,19,3,82,105,187,263
0132-000,2012,2,19,4,79,78,157,187
0132-000,2012,2,19,5,71,91,162,157
0132-000,2012,2,19,6,77,85,162,162
0132-000,2012,2,19,7,147,143,290,162
0132-000,2012,2,19,8,188,263,451,290
0132-000,2012,2,19,9,349,396,745,451
0132-000,2012,2,19,10,408,453,861,745
0132-000,2012,2,19,11,566,617,1183,861
0132-000,2012,2,19,12,589,717,1306,1183
0132-000,2012,2,19,13,671,663,1334,1306
0132-000,2012,2,19,14,688,643,1331,1334
0132-000,2012,2,19,15,854,656,1510,1331
0132-000,2012,2,19,16,1165,703,1868,1510
0132-000,2012,2,19,17,1184,732,1916,1868
0132-000,2012,2,19,18,1234,741,1975,1916
0132-000,2012,2,19,19,1177,582,1759,1975
0132-000,2012,2,19,20,761,497,1258,1759
0132-000,2012,2,19,21,518,465,983,1258
0132-000,2012,2,19,22,403,425,828,983
0132-000,2012,2,19,23,285,328,613,828
0132-000,2012,2,19,24,184,213,397,613
0132-000,2012,2,20,1,143,156,299,397
0132-000,2012,2,20,2,75,96,171,299
0132-000,2012,2,20,3,52,77,129,171
0132-000,2012,2,20,4,56,88,144,129
0132-000,2012,2,20,5,85,92,177,144
0132-000,2012,2,20,6,166,162,328,177
0132-000,2012,2,20,7,403,464,867,328
0132-000,2012,2,20,8,733,1599,2332,867
0132-000,2012,2,20,9,764,1292,2056,2332
0132-000,2012,2,20,10,785,900,1685,2056
0132-000,2012,2,20,11,817,875,1692,1685
0132-000,2012,2,20,12,877,890,1767,1692
0132-000,2012,2,20,13,759,855,1614,1767
0132-000,2012,2,20,14,878,912,1790,1614
0132-000,2012,2,20,15,994,972,1966,1790
0132-000,2012,2,20,16,946,941,1887,1966
0132-000,2012,2,20,17,1040,904,1944,1887
0132-000,2012,2,20,18,1075,690,1765,1944
0132-000,2012,2,20,19,1160,845,2005,1765
0132-000,2012,2,20,20,869,666,1535,2005
0132-000,2012,2,20,21,705,506,1211,1535
0132-000,2012,2,20,22,550,495,1045,1211
0132-000,2012,2,20,23,370,298,668,1045
0132-000,2012,2,20,24,185,192,377,668
0132-000,2012,2,21,1,150,167,317,377
0132-000,2012,2,21,2,101,112,213,317
0132-000,2012,2,21,3,72,97,169,213
0132-000,2012,2,21,4,76,102,178,169
0132-000,2012,2,21,5,77,97,174,178
0132-000,2012,2,21,6,155,131,286,174
0132-000,2012,2,21,7,349,379,728,286
0132-000,2012,2,21,8,690,1357,2047,728
0132-000,2012,2,21,9,815,1260,2075,2047
0132-000,2012,2,21,10,833,1009,1842,2075
0132-000,2012,2,21,11,827,999,1826,1842
0132-000,2012,2,21,12,855,879,1734,1826
0132-000,2012,2,21,13,723,888,1611,1734
0132-000,2012,2,21,14,894,892,1786,1611
0132-000,2012,2,21,15,996,974,1970,1786
0132-000,2012,2,21,16,1000,883,1883,1970
0132-000,2012,2,21,17,1031,855,1886,1883
0132-000,2012,2,21,18,1072,813,1885,1886
0132-000,2012,2,21,19,1184,779,1963,1885
0132-000,2012,2,21,20,837,643,1480,1963
0132-000,2012,2,21,21,727,579,1306,1480
0132-000,2012,2,21,22,609,473,1082,1306
0132-000,2012,2,21,23,393,333,726,1082
0132-000,2012,2,21,24,194,198,392,726
0132-000,2012,2,22,1,174,178,352,392
0132-000,2012,2,22,2,103,119,222,352
0132-000,2012,2,22,3,82,109,191,222
0132-000,2012,2,22,4,83,90,173,191
0132-000,2012,2,22,5,97,102,199,173
0132-000,2012,2,22,6,171,128,299,199
0132-000,2012,2,22,7,323,346,669,299
0132-000,2012,2,22,8,684,1291,1975,669
0132-000,2012,2,22,9,820,1202,2022,1975
0132-000,2012,2,22,10,809,962,1771,2022
0132-000,2012,2,22,11,895,923,1818,1771
0132-000,2012,2,22,12,897,922,1819,1818
0132-000,2012,2,22,13,775,823,1598,1819
0132-000,2012,2,22,14,946,912,1858,1598
0132-000,2012,2,22,15,971,974,1945,1858
0132-000,2012,2,22,16,1035,960,1995,1945
0132-000,2012,2,22,17,1020,856,1876,1995
0132-000,2012,2,22,18,1123,878,2001,1876
0132-000,2012,2,22,19,1241,884,2125,2001
0132-000,2012,2,22,20,835,694,1529,2125
0132-000,2012,2,22,21,685,534,1219,1529
0132-000,2012,2,22,22,545,496,1041,1219
0132-000,2012,2,22,23,328,346,674,1041
0132-000,2012,2,22,24,228,226,454,674
0132-000,2012,2,23,1,142,151,293,454
0132-000,2012,2,23,2,117,110,227,293
0132-000,2012,2,23,3,78,101,179,227
0132-000,2012,2,23,4,77,111,188,179
0132-000,2012,2,23,5,90,103,193,188
0132-000,2012,2,23,6,161,117,278,193
0132-000,2012,2,23,7,348,356,704,278
0132-000,2012,2,23,8,663,1289,1952,704
0132-000,2012,2,23,9,776,1187,1963,1952
0132-000,2012,2,23,10,808,967,1775,1963
0132-000,2012,2,23,11,883,953,1836,1775
0132-000,2012,2,23,12,859,885,1744,1836
0132-000,2012,2,23,13,837,797,1634,1744
0132-000,2012,2,23,14,843,902,1745,1634
0132-000,2012,2,23,15,934,976,1910,1745
0132-000,2012,2,23,16,1002,932,1934,1910
0132-000,2012,2,23,17,1017,805,1822,1934
0132-000,2012,2,23,18,1179,815,1994,1822
0132-000,2012,2,23,19,1142,797,1939,1994
0132-000,2012,2,23,20,838,649,1487,1939
0132-000,2012,2,23,21,686,535,1221,1487
0132-000,2012,2,23,22,590,481,1071,1221
0132-000,2012,2,23,23,371,335,706,1071
0132-000,2012,2,23,24,221,230,451,706
0132-000,2012,2,24,1,176,193,369,451
0132-000,2012,2,24,2,135,142,277,369
0132-000,2012,2,24,3,79,115,194,277
0132-000,2012,2,24,4,87,108,195,194
0132-000,2012,2,24,5,71,102,173,195
0132-000,2012,2,24,6,169,129,298,173
0132-000,2012,2,24,7,339,348,687,298
0132-000,2012,2,24,8,709,1289,1998,687
0132-000,2012,2,24,9,814,1181,1995,1998
0132-000,2012,2,24,10,793,959,1752,1995
0132-000,2012,2,24,11,865,954,1819,1752
0132-000,2012,2,24,12,907,896,1803,1819
0132-000,2012,2,24,13,806,837,1643,1803
0132-000,2012,2,24,14,878,879,1757,1643
0132-000,2012,2,24,15,1005,998,2003,1757
0132-000,2012,2,24,16,1034,897,1931,2003
0132-000,2012,2,24,17,1011,866,1877,1931
0132-000,2012,2,24,18,1331,905,2236,1877
0132-000,2012,2,24,19,1436,922,2358,2236
0132-000,2012,2,24,20,1052,819,1871,2358
0132-000,2012,2,24,21,775,636,1411,1871
0132-000,2012,2,24,22,684,533,1217,1411
0132-000,2012,2,24,23,434,379,813,1217
0132-000,2012,2,24,24,269,274,543,813
0132-000,2012,2,25,1,189,215,404,543
0132-000,2012,2,25,2,151,206,357,404
0132-000,2012,2,25,3,117,143,260,357
0132-000,2012,2,25,4,82,144,226,260
0132-000,2012,2,25,5,111,132,243,226
0132-000,2012,2,25,6,180,122,302,243
0132-000,2012,2,25,7,265,240,505,302
0132-000,2012,2,25,8,518,709,1227,505
0132-000,2012,2,25,9,652,826,1478,1227
0132-000,2012,2,25,10,762,863,1625,1478
0132-000,2012,2,25,11,834,962,1796,1625
0132-000,2012,2,25,12,976,1241,2217,1796
0132-000,2012,2,25,13,996,1304,2300,2217
0132-000,2012,2,25,14,967,1337,2304,2300
0132-000,2012,2,25,15,1050,1297,2347,2304
0132-000,2012,2,25,16,1038,1155,2193,2347
0132-000,2012,2,25,17,1266,1252,2518,2193
0132-000,2012,2,25,18,1534,1249,2783,2518
0132-000,2012,2,25,19,1329,1133,2462,2783
0132-000,2012,2,25,20,1057,843,1900,2462
0132-000,2012,2,25,21,642,635,1277,1900
0132-000,2012,2,25,22,546,500,1046,1277
0132-000,2012,2,25,23,351,378,729,1046
0132-000,2012,2,25,24,231,266,497,729
0132-000,2012,2,26,1,168,222,390,497
0132-000,2012,2,26,2,143,154,297,390
0132-000,2012,2,26,3,92,132,224,297
0132-000,2012,2,26,4,96,96,192,224
0132-000,2012,2,26,5,70,77,147,192
0132-000,2012,2,26,6,105,98,203,147
0132-000,2012,2,26,7,156,139,295,203
0132-000,2012,2,26,8,236,339,575,295
0132-000,2012,2,26,9,382,416,798,575
0132-000,2012,2,26,10,471,515,986,798
0132-000,2012,2,26,11,530,652,1182,986
0132-000,2012,2,26,12,583,594,1177,1182
0132-000,2012,2,26,13,675,671,1346,1177
0132-000,2012,2,26,14,739,724,1463,1346
0132-000,2012,2,26,15,865,752,1617,1463
0132-000,2012,2,26,16,1187,768,1955,1617
0132-000,2012,2,26,17,1334,714,2048,1955
0132-000,2012,2,26,18,1504,755,2259,2048
0132-000,2012,2,26,19,1389,669,2058,2259
0132-000,2012,2,26,20,1102,566,1668,2058
0132-000,2012,2,26,21,623,493,1116,1668
0132-000,2012,2,26,22,455,421,876,1116
0132-000,2012,2,26,23,290,332,622,876
0132-000,2012,2,26,24,194,253,447,622
0132-000,2012,2,27,1,122,169,291,447
0132-000,2012,2,27,2,88,114,202,291
0132-000,2012,2,27,3,56,71,127,202
0132-000,2012,2,27,4,61,79,140,127
0132-000,2012,2,27,5,88,106,194,140
0132-000,2012,2,27,6,188,172,360,194
0132-000,2012,2,27,7,413,555,968,360
0132-000,2012,2,27,8,774,1626,2400,968
0132-000,2012,2,27,9,836,1317,2153,2400
0132-000,2012,2,27,10,828,898,1726,2153
0132-000,2012,2,27,11,841,910,1751,1726
0132-000,2012,2,27,12,873,909,1782,1751
0132-000,2012,2,27,13,811,803,1614,1782
0132-000,2012,2,27,14,926,919,1845,1614
0132-000,2012,2,27,15,940,985,1925,1845
0132-000,2012,2,27,16,997,918,1915,1925
0132-000,2012,2,27,17,983,854,1837,1915
0132-000,2012,2,27,18,1131,820,1951,1837
0132-000,2012,2,27,19,1141,775,1916,1951
0132-000,2012,2,27,20,841,702,1543,1916
0132-000,2012,2,27,21,693,590,1283,1543
0132-000,2012,2,27,22,583,455,1038,1283
0132-000,2012,2,27,23,328,326,654,1038
0132-000,2012,2,27,24,234,233,467,654
0132-000,2012,2,28,1,156,152,308,467
0132-000,2012,2,28,2,83,98,181,308
0132-000,2012,2,28,3,82,106,188,181
0132-000,2012,2,28,4,78,98,176,188
0132-000,2012,2,28,5,79,116,195,176
0132-000,2012,2,28,6,180,139,319,195
0132-000,2012,2,28,7,331,371,702,319
0132-000,2012,2,28,8,709,1388,2097,702
0132-000,2012,2,28,9,820,1210,2030,2097
0132-000,2012,2,28,10,793,1014,1807,2030
0132-000,2012,2,28,11,904,1128,2032,1807
0132-000,2012,2,28,12,896,1019,1915,2032
0132-000,2012,2,28,13,803,905,1708,1915
0132-000,2012,2,28,14,1000,941,1941,1708
0132-000,2012,2,28,15,1072,980,2052,1941
0132-000,2012,2,28,16,1007,926,1933,2052
0132-000,2012,2,28,17,1050,844,1894,1933
0132-000,2012,2,28,18,1156,916,2072,1894
0132-000,2012,2,28,19,1153,827,1980,2072
0132-000,2012,2,28,20,920,673,1593,1980
0132-000,2012,2,28,21,772,559,1331,1593
0132-000,2012,2,28,22,580,496,1076,1331
0132-000,2012,2,28,23,393,365,758,1076
0132-000,2012,2,28,24,269,212,481,758
0132-000,2012,2,29,1,203,187,390,481
0132-000,2012,2,29,2,105,139,244,390
0132-000,2012,2,29,3,85,107,192,244
0132-000,2012,2,29,4,74,103,177,192
0132-000,2012,2,29,5,98,106,204,177
0132-000,2012,2,29,6,163,136,299,204
0132-000,2012,2,29,7,343,346,689,299
0132-000,2012,2,29,8,700,1265,1965,689
0132-000,2012,2,29,9,834,1321,2155,1965
0132-000,2012,2,29,10,832,889,1721,2155
0132-000,2012,2,29,11,863,952,1815,1721
0132-000,2012,2,29,12,832,876,1708,1815
0132-000,2012,2,29,13,851,845,1696,1708
0132-000,2012,2,29,14,911,867,1778,1696
0132-000,2012,2,29,15,1009,1001,2010,1778
0132-000,2012,2,29,16,1018,959,1977,2010
0132-000,2012,2,29,17,1033,891,1924,1977
0132-000,2012,2,29,18,1295,966,2261,1924
0132-000,2012,2,29,19,1513,916,2429,2261
0132-000,2012,2,29,20,1031,795,1826,2429
0132-000,2012,2,29,21,831,630,1461,1826
0132-000,2012,2,29,22,653,561,1214,1461
0132-000,2012,2,29,23,408,366,774,1214
0132-000,2012,2,29,24,276,266,542,774
0132-000,2012,3,1,1,223,245,468,542
0132-000,2012,3,1,2,149,161,310,468
0132-000,2012,3,1,3,124,132,256,310
0132-000,2012,3,1,4,121,148,269,256
0132-000,2012,3,1,5,115,118,233,269
0132-000,2012,3,1,6,170,139,309,233
0132-000,2012,3,1,7,251,279,530,309
0132-000,2012,3,1,8,438,672,1110,530
0132-000,2012,3,1,9,564,761,1325,1110
0132-000,2012,3,1,10,648,782,1430,1325
0132-000,2012,3,1,11,733,1038,1771,1430
0132-000,2012,3,1,12,727,1200,1927,1771
0132-000,2012,3,1,13,811,1222,2033,1927
0132-000,2012,3,1,14,838,1274,2112,2033
0132-000,2012,3,1,15,1007,1173,2180,2112
0132-000,2012,3,1,16,1093,1121,2214,2180
0132-000,2012,3,1,17,1324,1063,2387,2214
0132-000,2012,3,1,18,1768,1072,2840,2387
0132-000,2012,3,1,19,1578,744,2322,2840
0132-000,2012,3,1,20,1258,590,1848,2322
0132-000,2012,3,1,21,782,486,1268,1848
0132-000,2012,3,1,22,543,408,951,1268
0132-000,2012,3,1,23,298,310,608,951
0132-000,2012,3,1,24,202,218,420,608
0132-000,2012,3,2,1,134,157,291,420
0132-000,2012,3,2,2,108,97,205,291
0132-000,2012,3,2,3,53,74,127,205
0132-000,2012,3,2,4,68,80,148,127
0132-000,2012,3,2,5,86,100,186,148
0132-000,2012,3,2,6,150,117,267,186
0132-000,2012,3,2,7,374,410,784,267
0132-000,2012,3,2,8,662,1358,2020,784
0132-000,2012,3,2,9,800,1240,2040,2020
0132-000,2012,3,2,10,730,949,1679,2040
0132-000,2012,3,2,11,818,924,1742,1679
0132-000,2012,3,2,12,878,924,1802,1742
0132-000,2012,3,2,13,853,807,1660,1802
0132-000,2012,3,2,14,876,918,1794,1660
0132-000,2012,3,2,15,915,922,1837,1794
0132-000,2012,3,2,16,954,906,1860,1837
0132-000,2012,3,2,17,1006,873,1879,1860
0132-000,2012,3,2,18,1276,863,2139,1879
0132-000,2012,3,2,19,1320,892,2212,2139
0132-000,2012,3,2,20,944,738,1682,2212
0132-000,2012,3,2,21,810,596,1406,1682
0132-000,2012,3,2,22,626,525,1151,1406
0132-000,2012,3,2,23,458,390,848,1151
0132-000,2012,3,2,24,277,268,545,848
0132-000,2012,3,3,1,234,238,472,545
0132-000,2012,3,3,2,147,144,291,472
0132-000,2012,3,3,3,133,143,276,291
0132-000,2012,3,3,4,111,130,241,276
0132-000,2012,3,3,5,93,120,213,241
0132-000,2012,3,3,6,170,121,291,213
0132-000,2012,3,3,7,294,259,553,291
0132-000,2012,3,3,8,461,674,1135,553
0132-000,2012,3,3,9,632,784,1416,1135
0132-000,2012,3,3,10,748,775,1523,1416
0132-000,2012,3,3,11,742,913,1655,1523
0132-000,2012,3,3,12,793,1119,1912,1655
0132-000,2012,3,3,13,734,1111,1845,1912
0132-000,2012,3,3,14,872,1111,1983,1845
0132-000,2012,3,3,15,960,1084,2044,1983
0132-000,2012,3,3,16,974,1014,1988,2044
0132-000,2012,3,3,17,1213,1015,2228,1988
0132-000,2012,3,3,18,1581,1086,2667,2228
0132-000,2012,3,3,19,1293,912,2205,2667
0132-000,2012,3,3,20,808,651,1459,2205
0132-000,2012,3,3,21,647,541,1188,1459
0132-000,2012,3,3,22,468,444,912,1188
0132-000,2012,3,3,23,299,316,615,912
0132-000,2012,3,3,24,240,247,487,615
0132-000,2012,3,4,1,145,221,366,487
0132-000,2012,3,4,2,118,133,251,366
0132-000,2012,3,4,3,102,101,203,251
0132-000,2012,3,4,4,90,113,203,203
0132-000,2012,3,4,5,75,76,151,203
0132-000,2012,3,4,6,96,74,170,151
0132-000,2012,3,4,7,130,177,307,170
0132-000,2012,3,4,8,263,340,603,307
0132-000,2012,3,4,9,341,459,800,603
0132-000,2012,3,4,10,451,489,940,800
0132-000,2012,3,4,11,571,679,1250,940
0132-000,2012,3,4,12,647,673,1320,1250
0132-000,2012,3,4,13,626,648,1274,1320
0132-000,2012,3,4,14,749,633,1382,1274
0132-000,2012,3,4,15,925,715,1640,1382
0132-000,2012,3,4,16,1224,720,1944,1640
0132-000,2012,3,4,17,1391,699,2090,1944
0132-000,2012,3,4,18,1536,721,2257,2090
0132-000,2012,3,4,19,1458,641,2099,2257
0132-000,2012,3,4,20,1238,554,1792,2099
0132-000,2012,3,4,21,677,469,1146,1792
0132-000,2012,3,4,22,474,417,891,1146
0132-000,2012,3,4,23,272,318,590,891
0132-000,2012,3,4,24,204,233,437,590
0132-000,2012,3,5,1,136,143,279,437
0132-000,2012,3,5,2,84,88,172,279
0132-000,2012,3,5,3,57,81,138,172
0132-000,2012,3,5,4,52,67,119,138
0132-000,2012,3,5,5,85,95,180,119
0132-000,2012,3,5,6,192,175,367,180
0132-000,2012,3,5,7,446,574,1020,367
0132-000,2012,3,5,8,744,1687,2431,1020
0132-000,2012,3,5,9,848,1429,2277,2431
0132-000,2012,3,5,10,768,1044,1812,2277
0132-000,2012,3,5,11,834,979,1813,1812
0132-000,2012,3,5,12,888,891,1779,1813
0132-000,2012,3,5,13,807,883,1690,1779
0132-000,2012,3,5,14,884,916,1800,1690
0132-000,2012,3,5,15,960,954,1914,1800
0132-000,2012,3,5,16,1006,838,1844,1914
0132-000,2012,3,5,17,980,836,1816,1844
0132-000,2012,3,5,18,1128,819,1947,1816
0132-000,2012,3,5,19,1146,838,1984,1947
0132-000,2012,3,5,20,927,619,1546,1984
0132-000,2012,3,5,21,734,512,1246,1546
0132-000,2012,3,5,22,542,439,981,1246
0132-000,2012,3,5,23,348,324,672,981
0132-000,2012,3,5,24,205,208,413,672
0132-000,2012,3,6,1,131,130,261,413
0132-000,2012,3,6,2,96,104,200,261
0132-000,2012,3,6,3,71,83,154,200
0132-000,2012,3,6,4,71,104,175,154
0132-000,2012,3,6,5,104,89,193,175
0132-000,2012,3,6,6,130,120,250,193
0132-000,2012,3,6,7,340,337,677,250
0132-000,2012,3,6,8,654,1385,2039,677
0132-000,2012,3,6,9,825,1376,2201,2039
0132-000,2012,3,6,10,744,980,1724,2201
0132-000,2012,3,6,11,823,990,1813,1724
0132-000,2012,3,6,12,847,913,1760,1813
0132-000,2012,3,6,13,788,806,1594,1760
0132-000,2012,3,6,14,946,955,1901,1594
0132-000,2012,3,6,15,976,955,1931,1901
0132-000,2012,3,6,16,1045,878,1923,1931
0132-000,2012,3,6,17,1002,785,1787,1923
0132-000,2012,3,6,18,1119,833,1952,1787
0132-000,2012,3,6,19,1185,824,2009,1952
0132-000,2012,3,6,20,856,646,1502,2009
0132-000,2012,3,6,21,760,512,1272,1502
0132-000,2012,3,6,22,601,478,1079,1272
0132-000,2012,3,6,23,358,324,682,1079
0132-000,2012,3,6,24,206,220,426,682
0132-000,2012,3,7,1,171,182,353,426
0132-000,2012,3,7,2,120,119,239,353
0132-000,2012,3,7,3,88,98,186,239
0132-000,2012,3,7,4,64,106,170,186
0132-000,2012,3,7,5,105,106,211,170
0132-000,2012,3,7,6,165,139,304,211
0132-000,2012,3,7,7,389,395,784,304
0132-000,2012,3,7,8,706,1392,2098,784
0132-000,2012,3,7,9,838,1377,2215,2098
0132-000,2012,3,7,10,845,1070,1915,2215
0132-000,2012,3,7,11,806,991,1797,1915
0132-000,2012,3,7,12,861,866,1727,1797
0132-000,2012,3,7,13,834,946,1780,1727
0132-000,2012,3,7,14,939,929,1868,1780
0132-000,2012,3,7,15,974,962,1936,1868
0132-000,2012,3,7,16,1001,870,1871,1936
0132-000,2012,3,7,17,1093,893,1986,1871
0132-000,2012,3,7,18,1249,843,2092,1986
0132-000,2012,3,7,19,1232,915,2147,2092
0132-000,2012,3,7,20,847,659,1506,2147
0132-000,2012,3,7,21,705,515,1220,1506
0132-000,2012,3,7,22,619,466,1085,1220
0132-000,2012,3,7,23,356,384,740,1085
0132-000,2012,3,7,24,218,210,428,740
0132-000,2012,3,8,1,193,200,393,428
0132-000,2012,3,8,2,121,133,254,393
0132-000,2012,3,8,3,88,104,192,254
0132-000,2012,3,8,4,75,97,172,192
0132-000,2012,3,8,5,102,108,210,172
0132-000,2012,3,8,6,161,128,289,210
0132-000,2012,3,8,7,391,395,786,289
0132-000,2012,3,8,8,687,1449,2136,786
0132-000,2012,3,8,9,768,1434,2202,2136
0132-000,2012,3,8,10,872,1022,1894,2202
0132-000,2012,3,8,11,890,948,1838,1894
0132-000,2012,3,8,12,849,903,1752,1838
0132-000,2012,3,8,13,799,803,1602,1752
0132-000,2012,3,8,14,940,898,1838,1602
0132-000,2012,3,8,15,1015,978,1993,1838
0132-000,2012,3,8,16,1061,893,1954,1993
0132-000,2012,3,8,17,1021,815,1836,1954
0132-000,2012,3,8,18,1177,869,2046,1836
0132-000,2012,3,8,19,1256,865,2121,2046
0132-000,2012,3,8,20,884,675,1559,2121
0132-000,2012,3,8,21,713,582,1295,1559
0132-000,2012,3,8,22,648,449,1097,1295
0132-000,2012,3,8,23,395,364,759,1097
0132-000,2012,3,8,24,250,267,517,759
0132-000,2012,3,9,1,215,189,404,517
0132-000,2012,3,9,2,108,130,238,404
0132-000,2012,3,9,3,83,108,191,238
0132-000,2012,3,9,4,85,98,183,191
0132-000,2012,3,9,5,80,90,170,183
0132-000,2012,3,9,6,176,128,304,170
0132-000,2012,3,9,7,373,416,789,304
0132-000,2012,3,9,8,773,1438,2211,789
0132-000,2012,3,9,9,898,1294,2192,2211
0132-000,2012,3,9,10,791,961,1752,2192
0132-000,2012,3,9,11,848,969,1817,1752
0132-000,2012,3,9,12,861,939,1800,1817
0132-000,2012,3,9,13,803,833,1636,1800
0132-000,2012,3,9,14,945,913,1858,1636
0132-000,2012,3,9,15,990,996,1986,1858
0132-000,2012,3,9,16,1102,888,1990,1986
0132-000,2012,3,9,17,1101,950,2051,1990
0132-000,2012,3,9,18,1311,866,2177,2051
0132-000,2012,3,9,19,1498,973,2471,2177
0132-000,2012,3,9,20,1032,770,1802,2471
0132-000,2012,3,9,21,893,628,1521,1802
0132-000,2012,3,9,22,667,540,1207,1521
0132-000,2012,3,9,23,446,410,856,1207
0132-000,2012,3,9,24,288,276,564,856
0132-000,2012,3,10,1,239,212,451,564
0132-000,2012,3,10,2,161,190,351,451
0132-000,2012,3,10,3,108,137,245,351
0132-000,2012,3,10,4,108,142,250,245
0132-000,2012,3,10,5,92,109,201,250
0132-000,2012,3,10,6,167,150,317,201
0132-000,2012,3,10,7,320,271,591,317
0132-000,2012,3,10,8,497,776,1273,591
0132-000,2012,3,10,9,678,904,1582,1273
0132-000,2012,3,10,10,731,851,1582,1582
0132-000,2012,3,10,11,812,967,1779,1582
0132-000,2012,3,10,12,945,1203,2148,1779
0132-000,2012,3,10,13,1072,1345,2417,2148
0132-000,2012,3,10,14,957,1153,2110,2417
0132-000,2012,3,10,15,1053,1265,2318,2110
0132-000,2012,3,10,16,1094,1104,2198,2318
0132-000,2012,3,10,17,1354,1152,2506,2198
0132-000,2012,3,10,18,1691,1155,2846,2506
0132-000,2012,3,10,19,1476,1120,2596,2846
0132-000,2012,3,10,20,958,668,1626,2596
0132-000,2012,3,10,21,617,553,1170,1626
0132-000,2012,3,10,22,528,482,1010,1170
0132-000,2012,3,10,23,381,393,774,1010
0132-000,2012,3,10,24,242,267,509,774
0132-000,2012,3,11,1,198,226,424,509
0132-000,2012,3,11,2,148,159,307,424
0132-000,2012,3,11,3,109,133,242,307
0132-000,2012,3,11,4,87,94,181,242
0132-000,2012,3,11,5,85,82,167,181
0132-000,2012,3,11,6,115,113,228,167
0132-000,2012,3,11,7,169,178,347,228
0132-000,2012,3,11,8,284,388,672,347
0132-000,2012,3,11,9,364,445,809,672
0132-000,2012,3,11,10,469,498,967,809
0132-000,2012,3,11,11,633,659,1292,967
0132-000,2012,3,11,12,635,665,1300,1292
0132-000,2012,3,11,13,730,639,1369,1300
0132-000,2012,3,11,14,760,723,1483,1369
0132-000,2012,3,11,15,874,736,1610,1483
0132-000,2012,3,11,16,1172,704,1876,1610
0132-000,2012,3,11,17,1351,751,2102,1876
0132-000,2012,3,11,18,1391,761,2152,2102
0132-000,2012,3,11,19,1322,623,1945,2152
0132-000,2012,3,11,20,700,563,1263,1945
0132-000,2012,3,11,21,588,536,1124,1263
0132-000,2012,3,11,22,445,456,901,1124
0132-000,2012,3,11,23,306,322,628,901
0132-000,2012,3,11,24,188,238,426,628
0132-000,2012,3,12,1,140,152,292,426
0132-000,2012,3,12,2,88,99,187,292
0132-000,2012,3,12,3,77,73,150,187
0132-000,2012,3,12,4,53,74,127,150
0132-000,2012,3,12,5,92,104,196,127
0132-000,2012,3,12,6,158,167,325,196
0132-000,2012,3,12,7,468,596,1064,325
0132-000,2012,3,12,8,762,1647,2409,1064
0132-000,2012,3,12,9,885,1480,2365,2409
0132-000,2012,3,12,10,798,1040,1838,2365
0132-000,2012,3,12,11,808,909,1717,1838
0132-000,2012,3,12,12,894,917,1811,1717
0132-000,2012,3,12,13,804,877,1681,1811
0132-000,2012,3,12,14,892,935,1827,1681
0132-000,2012,3,12,15,1008,989,1997,1827
0132-000,2012,3,12,16,991,928,1919,1997
0132-000,2012,3,12,17,1046,896,1942,1919
0132-000,2012,3,12,18,1189,855,2044,1942
0132-000,2012,3,12,19,1259,906,2165,2044
0132-000,2012,3,12,20,874,677,1551,2165
0132-000,2012,3,12,21,768,574,1342,1551
0132-000,2012,3,12,22,611,495,1106,1342
0132-000,2012,3,12,23,397,363,760,1106
0132-000,2012,3,12,24,222,202,424,760
0132-000,2012,3,13,1,168,196,364,424
0132-000,2012,3,13,2,104,123,227,364
0132-000,2012,3,13,3,82,91,173,227
0132-000,2012,3,13,4,74,96,170,173
0132-000,2012,3,13,5,81,97,178,170
0132-000,2012,3,13,6,175,125,300,178
0132-000,2012,3,13,7,392,441,833,300
0132-000,2012,3,13,8,749,1515,2264,833
0132-000,2012,3,13,9,873,1387,2260,2264
0132-000,2012,3,13,10,848,1041,1889,2260
0132-000,2012,3,13,11,862,984,1846,1889
0132-000,2012,3,13,12,850,920,1770,1846
0132-000,2012,3,13,13,835,810,1645,1770
0132-000,2012,3,13,14,900,979,1879,1645
0132-000,2012,3,13,15,1024,996,2020,1879
0132-000,2012,3,13,16,1075,971,2046,2020
0132-000,2012,3,13,17,1032,842,1874,2046
0132-000,2012,3,13,18,1207,806,2013,1874
0132-000,2012,3,13,19,1268,888,2156,2013
0132-000,2012,3,13,20,915,715,1630,2156
0132-000,2012,3,13,21,753,562,1315,1630
0132-000,2012,3,13,22,666,486,1152,1315
0132-000,2012,3,13,23,359,326,685,1152
0132-000,2012,3,13,24,223,209,432,685
0132-000,2012,3,14,1,168,181,349,432
0132-000,2012,3,14,2,109,116,225,349
0132-000,2012,3,14,3,79,114,193,225
0132-000,2012,3,14,4,75,87,162,193
0132-000,2012,3,14,5,109,99,208,162
0132-000,2012,3,14,6,171,154,325,208
0132-000,2012,3,14,7,378,445,823,325
0132-000,2012,3,14,8,744,1488,2232,823
0132-000,2012,3,14,9,862,1383,2245,2232
0132-000,2012,3,14,10,846,1049,1895,2245
0132-000,2012,3,14,11,897,921,1818,1895
0132-000,2012,3,14,12,867,947,1814,1818
0132-000,2012,3,14,13,766,865,1631,1814
0132-000,2012,3,14,14,886,910,1796,1631
0132-000,2012,3,14,15,1059,922,1981,1796
0132-000,2012,3,14,16,1037,884,1921,1981
0132-000,2012,3,14,17,1073,791,1864,1921
0132-000,2012,3,14,18,1237,896,2133,1864
0132-000,2012,3,14,19,1319,908,2227,2133
0132-000,2012,3,14,20,938,653,1591,2227
0132-000,2012,3,14,21,760,565,1325,1591
0132-000,2012,3,14,22,605,446,1051,1325
0132-000,2012,3,14,23,381,356,737,1051
0132-000,2012,3,14,24,258,247,505,737
0132-000,2012,3,15,1,165,205,370,505
0132-000,2012,3,15,2,98,130,228,370
0132-000,2012,3,15,3,75,101,176,228
0132-000,2012,3,15,4,74,90,164,176
0132-000,2012,3,15,5,95,115,210,164
0132-000,2012,3,15,6,167,165,332,210
0132-000,2012,3,15,7,435,419,854,332
0132-000,2012,3,15,8,779,1489,2268,854
0132-000,2012,3,15,9,829,1399,2228,2268
0132-000,2012,3,15,10,827,1004,1831,2228
0132-000,2012,3,15,11,882,947,1829,1831
0132-000,2012,3,15,12,865,888,1753,1829
0132-000,2012,3,15,13,784,836,1620,1753
0132-000,2012,3,15,14,868,945,1813,1620
0132-000,2012,3,15,15,1011,985,1996,1813
0132-000,2012,3,15,16,1041,903,1944,1996
0132-000,2012,3,15,17,1030,877,1907,1944
0132-000,2012,3,15,18,1234,858,2092,1907
0132-000,2012,3,15,19,1242,886,2128,2092
0132-000,2012,3,15,20,927,697,1624,2128
0132-000,2012,3,15,21,772,559,1331,1624
0132-000,2012,3,15,22,675,516,1191,1331
0132-000,2012,3,15,23,419,350,769,1191
0132-000,2012,3,15,24,283,233,516,769
0132-000,2012,3,16,1,197,194,391,516
0132-000,2012,3,16,2,106,138,244,391
0132-000,2012,3,16,3,94,119,213,244
0132-000,2012,3,16,4,90,92,182,213
0132-000,2012,3,16,5,90,101,191,182
0132-000,2012,3,16,6,185,145,330,191
0132-000,2012,3,16,7,366,404,770,330
0132-000,2012,3,16,8,701,1467,2168,770
0132-000,2012,3,16,9,865,1274,2139,2168
0132-000,2012,3,16,10,811,992,1803,2139
0132-000,2012,3,16,11,861,968,1829,1803
0132-000,2012,3,16,12,856,920,1776,1829
0132-000,2012,3,16,13,823,889,1712,1776
0132-000,2012,3,16,14,962,887,1849,1712
0132-000,2012,3,16,15,1056,941,1997,1849
0132-000,2012,3,16,16,1093,915,2008,1997
0132-000,2012,3,16,17,1049,907,1956,2008
0132-000,2012,3,16,18,1313,918,2231,1956
0132-000,2012,3,16,19,1515,925,2440,2231
0132-000,2012,3,16,20,1040,743,1783,2440
0132-000,2012,3,16,21,791,595,1386,1783
0132-000,2012,3,16,22,650,496,1146,1386
0132-000,2012,3,16,23,384,383,767,1146
0132-000,2012,3,16,24,264,267,531,767
0132-000,2012,3,17,1,210,232,442,531
0132-000,2012,3,17,2,161,179,340,442
0132-000,2012,3,17,3,105,137,242,340
0132-000,2012,3,17,4,112,120,232,242
0132-000,2012,3,17,5,90,121,211,232
0132-000,2012,3,17,6,149,135,284,211
0132-000,2012,3,17,7,237,258,495,284
0132-000,2012,3,17,8,508,766,1274,495
0132-000,2012,3,17,9,662,896,1558,1274
0132-000,2012,3,17,10,771,928,1699,1558
0132-000,2012,3,17,11,806,1046,1852,1699
0132-000,2012,3,17,12,889,1389,2278,1852
0132-000,2012,3,17,13,864,1240,2104,2278
0132-000,2012,3,17,14,946,1122,2068,2104
0132-000,2012,3,17,15,974,1074,2048,2068
0132-000,2012,3,17,16,1003,1013,2016,2048
0132-000,2012,3,17,17,1046,996,2042,2016
0132-000,2012,3,17,18,1404,968,2372,2042
0132-000,2012,3,17,19,1095,905,2000,2372
0132-000,2012,3,17,20,749,677,1426,2000
0132-000,2012,3,17,21,559,579,1138,1426
0132-000,2012,3,17,22,479,466,945,1138
0132-000,2012,3,17,23,353,337,690,945
0132-000,2012,3,17,24,258,255,513,690
0132-000,2012,3,18,1,201,200,401,513
0132-000,2012,3,18,2,139,154,293,401
0132-000,2012,3,18,3,99,113,212,293
0132-000,2012,3,18,4,107,118,225,212
0132-000,2012,3,18,5,82,93,175,225
0132-000,2012,3,18,6,113,126,239,175
0132-000,2012,3,18,7,194,220,414,239
0132-000,2012,3,18,8,288,365,653,414
0132-000,2012,3,18,9,395,503,898,653
0132-000,2012,3,18,10,461,519,980,898
0132-000,2012,3,18,11,547,637,1184,980
0132-000,2012,3,18,12,651,636,1287,1184
0132-000,2012,3,18,13,727,596,1323,1287
0132-000,2012,3,18,14,734,667,1401,1323
0132-000,2012,3,18,15,821,722,1543,1401
0132-000,2012,3,18,16,1087,688,1775,1543
0132-000,2012,3,18,17,1264,735,1999,1775
0132-000,2012,3,18,18,1328,688,2016,1999
0132-000,2012,3,18,19,1298,644,1942,2016
0132-000,2012,3,18,20,788,530,1318,1942
0132-000,2012,3,18,21,631,507,1138,1318
0132-000,2012,3,18,22,405,473,878,1138
0132-000,2012,3,18,23,275,332,607,878
0132-000,2012,3,18,24,189,231,420,607
0132-000,2012,3,19,1,100,142,242,420
0132-000,2012,3,19,2,69,88,157,242
0132-000,2012,3,19,3,58,75,133,157
0132-000,2012,3,19,4,54,93,147,133
0132-000,2012,3,19,5,90,106,196,147
0132-000,2012,3,19,6,197,187,384,196
0132-000,2012,3,19,7,476,631,1107,384
0132-000,2012,3,19,8,798,1794,2592,1107
0132-000,2012,3,19,9,817,1425,2242,2592
0132-000,2012,3,19,10,812,962,1774,2242
0132-000,2012,3,19,11,842,963,1805,1774
0132-000,2012,3,19,12,842,963,1805,1805
0132-000,2012,3,19,13,770,844,1614,1805
0132-000,2012,3,19,14,875,925,1800,1614
0132-000,2012,3,19,15,946,919,1865,1800
0132-000,2012,3,19,16,963,915,1878,1865
0132-000,2012,3,19,17,1062,933,1995,1878
0132-000,2012,3,19,18,1161,838,1999,1995
0132-000,2012,3,19,19,1270,941,2211,1999
0132-000,2012,3,19,20,885,702,1587,2211
0132-000,2012,3,19,21,793,585,1378,1587
0132-000,2012,3,19,22,643,450,1093,1378
0132-000,2012,3,19,23,371,360,731,1093
0132-000,2012,3,19,24,226,198,424,731
0132-000,2012,3,20,1,165,170,335,424
0132-000,2012,3,20,2,107,116,223,335
0132-000,2012,3,20,3,72,104,176,223
0132-000,2012,3,20,4,57,79,136,176
0132-000,2012,3,20,5,110,104,214,136
0132-000,2012,3,20,6,172,157,329,214
0132-000,2012,3,20,7,404,443,847,329
0132-000,2012,3,20,8,739,1507,2246,847
0132-000,2012,3,20,9,830,1397,2227,2246
0132-000,2012,3,20,10,830,1003,1833,2227
0132-000,2012,3,20,11,869,963,1832,1833
0132-000,2012,3,20,12,842,842,1684,1832
0132-000,2012,3,20,13,812,847,1659,1684
0132-000,2012,3,20,14,924,962,1886,1659
0132-000,2012,3,20,15,979,960,1939,1886
0132-000,2012,3,20,16,1018,945,1963,1939
0132-000,2012,3,20,17,1042,891,1933,1963
0132-000,2012,3,20,18,1174,816,1990,1933
0132-000,2012,3,20,19,1323,921,2244,1990
0132-000,2012,3,20,20,847,679,1526,2244
0132-000,2012,3,20,21,723,585,1308,1526
0132-000,2012,3,20,22,646,457,1103,1308
0132-000,2012,3,20,23,438,351,789,1103
0132-000,2012,3,20,24,241,211,452,789
0132-000,2012,3,21,1,164,156,320,452
0132-000,2012,3,21,2,117,133,250,320
0132-000,2012,3,21,3,83,115,198,250
0132-000,2012,3,21,4,68,75,143,198
0132-000,2012,3,21,5,108,123,231,143
0132-000,2012,3,21,6,180,124,304,231
0132-000,2012,3,21,7,415,453,868,304
0132-000,2012,3,21,8,771,1495,2266,868
0132-000,2012,3,21,9,865,1378,2243,2266
0132-000,2012,3,21,10,830,1036,1866,2243
0132-000,2012,3,21,11,876,974,1850,1866
0132-000,2012,3,21,12,897,957,1854,1850
0132-000,2012,3,21,13,818,882,1700,1854
0132-000,2012,3,21,14,860,965,1825,1700
0132-000,2012,3,21,15,991,937,1928,1825
0132-000,2012,3,21,16,1026,933,1959,1928
0132-000,2012,3,21,17,1070,824,1894,1959
0132-000,2012,3,21,18,1490,876,2366,1894
0132-000,2012,3,21,19,1378,918,2296,2366
0132-000,2012,3,21,20,972,704,1676,2296
0132-000,2012,3,21,21,783,562,1345,1676
0132-000,2012,3,21,22,635,489,1124,1345
0132-000,2012,3,21,23,404,357,761,1124
0132-000,2012,3,21,24,239,269,508,761
0132-000,2012,3,22,1,201,172,373,508
0132-000,2012,3,22,2,120,144,264,373
0132-000,2012,3,22,3,80,112,192,264
0132-000,2012,3,22,4,91,106,197,192
0132-000,2012,3,22,5,106,113,219,197
0132-000,2012,3,22,6,157,135,292,219
0132-000,2012,3,22,7,380,428,808,292
0132-000,2012,3,22,8,737,1474,2211,808
0132-000,2012,3,22,9,894,1402,2296,2211
0132-000,2012,3,22,10,857,1015,1872,2296
0132-000,2012,3,22,11,842,980,1822,1872
0132-000,2012,3,22,12,845,876,1721,1822
0132-000,2012,3,22,13,800,790,1590,1721
0132-000,2012,3,22,14,925,927,1852,1590
0132-000,2012,3,22,15,1003,905,1908,1852
0132-000,2012,3,22,16,984,866,1850,1908
0132-000,2012,3,22,17,1057,956,2013,1850
0132-000,2012,3,22,18,1169,870,2039,2013
0132-000,2012,3,22,19,1273,869,2142,2039
0132-000,2012,3,22,20,855,634,1489,2142
0132-000,2012,3,22,21,737,582,1319,1489
0132-000,2012,3,22,22,662,494,1156,1319
0132-000,2012,3,22,23,435,320,755,1156
0132-000,2012,3,22,24,230,252,482,755
0132-000,2012,3,23,1,204,172,376,482
0132-000,2012,3,23,2,131,129,260,376
0132-000,2012,3,23,3,88,108,196,260
0132-000,2012,3,23,4,75,100,175,196
0132-000,2012,3,23,5,90,121,211,175
0132-000,2012,3,23,6,164,124,288,211
0132-000,2012,3,23,7,325,353,678,288
0132-000,2012,3,23,8,711,1380,2091,678
0132-000,2012,3,23,9,817,1317,2134,2091
0132-000,2012,3,23,10,723,916,1639,2134
0132-000,2012,3,23,11,868,988,1856,1639
0132-000,2012,3,23,12,849,907,1756,1856
0132-000,2012,3,23,13,785,793,1578,1756
0132-000,2012,3,23,14,921,834,1755,1578
0132-000,2012,3,23,15,968,931,1899,1755
0132-000,2012,3,23,16,1004,833,1837,1899
0132-000,2012,3,23,17,1009,819,1828,1837
0132-000,2012,3,23,18,1286,857,2143,1828
0132-000,2012,3,23,19,1411,922,2333,2143
0132-000,2012,3,23,20,975,728,1703,2333
0132-000,2012,3,23,21,713,624,1337,1703
0132-000,2012,3,23,22,679,541,1220,1337
0132-000,2012,3,23,23,381,378,759,1220
0132-000,2012,3,23,24,279,249,528,759
0132-000,2012,3,24,1,245,211,456,528
0132-000,2012,3,24,2,173,171,344,456
0132-000,2012,3,24,3,108,141,249,344
0132-000,2012,3,24,4,90,105,195,249
0132-000,2012,3,24,5,92,108,200,195
0132-000,2012,3,24,6,158,132,290,200
0132-000,2012,3,24,7,293,306,599,290
0132-000,2012,3,24,8,469,757,1226,599
0132-000,2012,3,24,9,693,888,1581,1226
0132-000,2012,3,24,10,802,953,1755,1581
0132-000,2012,3,24,11,784,1323,2107,1755
0132-000,2012,3,24,12,1053,1543,2596,2107
0132-000,2012,3,24,13,1117,1560,2677,2596
0132-000,2012,3,24,14,1015,1441,2456,2677
0132-000,2012,3,24,15,1049,1300,2349,2456
0132-000,2012,3,24,16,1139,1294,2433,2349
0132-000,2012,3,24,17,1326,1258,2584,2433
0132-000,2012,3,24,18,1582,1236,2818,2584
0132-000,2012,3,24,19,1490,1149,2639,2818
0132-000,2012,3,24,20,921,830,1751,2639
0132-000,2012,3,24,21,629,529,1158,1751
0132-000,2012,3,24,22,508,460,968,1158
0132-000,2012,3,24,23,350,400,750,968
0132-000,2012,3,24,24,229,255,484,750
0132-000,2012,3,25,1,185,174,359,484
0132-000,2012,3,25,2,142,163,305,359
0132-000,2012,3,25,3,103,137,240,305
0132-000,2012,3,25,4,83,82,165,240
0132-000,2012,3,25,5,97,91,188,165
0132-000,2012,3,25,6,123,109,232,188
0132-000,2012,3,25,7,218,218,436,232
0132-000,2012,3,25,8,284,388,672,436
0132-000,2012,3,25,9,392,506,898,672
0132-000,2012,3,25,10,480,561,1041,898
0132-000,2012,3,25,11,612,631,1243,1041
0132-000,2012,3,25,12,630,653,1283,1243
0132-000,2012,3,25,13,678,671,1349,1283
0132-000,2012,3,25,14,783,702,1485,1349
0132-000,2012,3,25,15,881,738,1619,1485
0132-000,2012,3,25,16,1188,720,1908,1619
0132-000,2012,3,25,17,1285,738,2023,1908
0132-000,2012,3,25,18,1605,749,2354,2023
0132-000,2012,3,25,19,1379,678,2057,2354
0132-000,2012,3,25,20,990,555,1545,2057
0132-000,2012,3,25,21,723,496,1219,1545
0132-000,2012,3,25,22,494,422,916,1219
0132-000,2012,3,25,23,336,335,671,916
0132-000,2012,3,25,24,168,221,389,671
0132-000,2012,3,26,1,134,166,300,389
0132-000,2012,3,26,2,88,105,193,300
0132-000,2012,3,26,3,64,79,143,193
0132-000,2012,3,26,4,65,91,156,143
0132-000,2012,3,26,5,96,91,187,156
0132-000,2012,3,26,6,181,185,366,187
0132-000,2012,3,26,7,500,633,1133,366
0132-000,2012,3,26,8,848,1809,2657,1133
0132-000,2012,3,26,9,857,1527,2384,2657
0132-000,2012,3,26,10,821,971,1792,2384
0132-000,2012,3,26,11,868,978,1846,1792
0132-000,2012,3,26,12,896,1042,1938,1846
0132-000,2012,3,26,13,845,923,1768,1938
0132-000,2012,3,26,14,909,994,1903,1768
0132-000,2012,3,26,15,1049,960,2009,1903
0132-000,2012,3,26,16,1036,941,1977,2009
0132-000,2012,3,26,17,1086,898,1984,1977
0132-000,2012,3,26,18,1192,885,2077,1984
0132-000,2012,3,26,19,1263,845,2108,2077
0132-000,2012,3,26,20,942,696,1638,2108
0132-000,2012,3,26,21,706,587,1293,1638
0132-000,2012,3,26,22,658,429,1087,1293
0132-000,2012,3,26,23,333,355,688,1087
0132-000,2012,3,26,24,222,210,432,688
0132-000,2012,3,27,1,189,188,377,432
0132-000,2012,3,27,2,115,112,227,377
0132-000,2012,3,27,3,99,100,199,227
0132-000,2012,3,27,4,81,85,166,199
0132-000,2012,3,27,5,90,111,201,166
0132-000,2012,3,27,6,173,148,321,201
0132-000,2012,3,27,7,434,465,899,321
0132-000,2012,3,27,8,742,1525,2267,899
0132-000,2012,3,27,9,877,1426,2303,2267
0132-000,2012,3,27,10,894,1032,1926,2303
0132-000,2012,3,27,11,852,977,1829,1926
0132-000,2012,3,27,12,887,946,1833,1829
0132-000,2012,3,27,13,830,893,1723,1833
0132-000,2012,3,27,14,894,916,1810,1723
0132-000,2012,3,27,15,1004,1018,2022,1810
0132-000,2012,3,27,16,1067,926,1993,2022
0132-000,2012,3,27,17,1102,928,2030,1993
0132-000,2012,3,27,18,1089,831,1920,2030
0132-000,2012,3,27,19,1260,839,2099,1920
0132-000,2012,3,27,20,877,681,1558,2099
0132-000,2012,3,27,21,790,586,1376,1558
0132-000,2012,3,27,22,678,482,1160,1376
0132-000,2012,3,27,23,414,382,796,1160
0132-000,2012,3,27,24,268,218,486,796
0132-000,2012,3,28,1,179,169,348,486
0132-000,2012,3,28,2,145,128,273,348
0132-000,2012,3,28,3,104,102,206,273
0132-000,2012,3,28,4,78,122,200,206
0132-000,2012,3,28,5,88,104,192,200
0132-000,2012,3,28,6,163,152,315,192
0132-000,2012,3,28,7,385,373,758,315
0132-000,2012,3,28,8,764,1375,2139,758
0132-000,2012,3,28,9,815,1491,2306,2139
0132-000,2012,3,28,10,859,1013,1872,2306
0132-000,2012,3,28,11,881,969,1850,1872
0132-000,2012,3,28,12,888,910,1798,1850
0132-000,2012,3,28,13,801,863,1664,1798
0132-000,2012,3,28,14,870,894,1764,1664
0132-000,2012,3,28,15,960,941,1901,1764
0132-000,2012,3,28,16,1029,933,1962,1901
0132-000,2012,3,28,17,1062,866,1928,1962
0132-000,2012,3,28,18,1193,867,2060,1928
0132-000,2012,3,28,19,1369,895,2264,2060
0132-000,2012,3,28,20,954,663,1617,2264
0132-000,2012,3,28,21,788,613,1401,1617
0132-000,2012,3,28,22,633,512,1145,1401
0132-000,2012,3,28,23,418,388,806,1145
0132-000,2012,3,28,24,274,274,548,806
0132-000,2012,3,29,1,219,180,399,548
0132-000,2012,3,29,2,122,140,262,399
0132-000,2012,3,29,3,99,113,212,262
0132-000,2012,3,29,4,90,85,175,212
0132-000,2012,3,29,5,122,117,239,175
0132-000,2012,3,29,6,169,150,319,239
0132-000,2012,3,29,7,402,403,805,319
0132-000,2012,3,29,8,756,1433,2189,805
0132-000,2012,3,29,9,847,1473,2320,2189
0132-000,2012,3,29,10,838,984,1822,2320
0132-000,2012,3,29,11,828,955,1783,1822
0132-000,2012,3,29,12,864,968,1832,1783
0132-000,2012,3,29,13,824,868,1692,1832
0132-000,2012,3,29,14,936,949,1885,1692
0132-000,2012,3,29,15,988,1019,2007,1885
0132-000,2012,3,29,16,1049,924,1973,2007
0132-000,2012,3,29,17,1061,858,1919,1973
0132-000,2012,3,29,18,1223,877,2100,1919
0132-000,2012,3,29,19,1306,844,2150,2100
0132-000,2012,3,29,20,923,697,1620,2150
0132-000,2012,3,29,21,773,625,1398,1620
0132-000,2012,3,29,22,712,499,1211,1398
0132-000,2012,3,29,23,411,417,828,1211
0132-000,2012,3,29,24,289,278,567,828
0132-000,2012,3,30,1,225,181,406,567
0132-000,2012,3,30,2,147,172,319,406
0132-000,2012,3,30,3,79,91,170,319
0132-000,2012,3,30,4,87,103,190,170
0132-000,2012,3,30,5,86,106,192,190
0132-000,2012,3,30,6,160,99,259,192
0132-000,2012,3,30,7,340,327,667,259
0132-000,2012,3,30,8,697,1311,2008,667
0132-000,2012,3,30,9,837,1433,2270,2008
0132-000,2012,3,30,10,806,939,1745,2270
0132-000,2012,3,30,11,891,960,1851,1745
0132-000,2012,3,30,12,889,959,1848,1851
0132-000,2012,3,30,13,865,896,1761,1848
0132-000,2012,3,30,14,895,897,1792,1761
0132-000,2012,3,30,15,939,921,1860,1792
0132-000,2012,3,30,16,1076,948,2024,1860
0132-000,2012,3,30,17,1094,947,2041,2024
0132-000,2012,3,30,18,1285,873,2158,2041
0132-000,2012,3,30,19,1418,976,2394,2158
0132-000,2012,3,30,20,1023,744,1767,2394
0132-000,2012,3,30,21,766,623,1389,1767
0132-000,2012,3,30,22,727,558,1285,1389
0132-000,2012,3,30,23,445,466,911,1285
0132-000,2012,3,30,24,305,312,617,911
0132-000,2012,3,31,1,226,232,458,617
0132-000,2012,3,31,2,174,165,339,458
0132-000,2012,3,31,3,103,139,242,339
0132-000,2012,3,31,4,115,119,234,242
0132-000,2012,3,31,5,123,123,246,234
0132-000,2012,3,31,6,165,163,328,246
0132-000,2012,3,31,7,323,341,664,328
0132-000,2012,3,31,8,509,784,1293,664
0132-000,2012,3,31,9,734,1019,1753,1293
0132-000,2012,3,31,10,804,1159,1963,1753
0132-000,2012,3,31,11,906,1373,2279,1963
0132-000,2012,3,31,12,889,1609,2498,2279
0132-000,2012,3,31,13,1013,1513,2526,2498
0132-000,2012,3,31,14,983,1472,2455,2526
0132-000,2012,3,31,15,1051,1521,2572,2455
0132-000,2012,3,31,16,1056,1279,2335,2572
0132-000,2012,3,31,17,1344,1263,2607,2335
0132-000,2012,3,31,18,1643,1192,2835,2607
0132-000,2012,3,31,19,1526,1173,2699,2835
0132-000,2012,3,31,20,1185,792,1977,2699
0132-000,2012,3,31,21,627,590,1217,1977
0132-000,2012,3,31,22,551,506,1057,1217
0132-000,2012,3,31,23,398,355,753,1057
0132-000,2012,3,31,24,227,301,528,753
0132-000,2012,4,1,1,186,202,388,528
0132-000,2012,4,1,2,139,131,270,388
0132-000,2012,4,1,3,104,121,225,270
0132-000,2012,4,1,4,78,73,151,225
0132-000,2012,4,1,5,102,77,179,151
0132-000,2012,4,1,6,100,131,231,179
0132-000,2012,4,1,7,196,220,416,231
0132-000,2012,4,1,8,269,414,683,416
0132-000,2012,4,1,9,393,650,1043,683
0132-000,2012,4,1,10,505,659,1164,1043
0132-000,2012,4,1,11,602,748,1350,1164
0132-000,2012,4,1,12,652,760,1412,1350
0132-000,2012,4,1,13,676,664,1340,1412
0132-000,2012,4,1,14,755,714,1469,1340
0132-000,2012,4,1,15,967,712,1679,1469
0132-000,2012,4,1,16,1394,752,2146,1679
0132-000,2012,4,1,17,1518,747,2265,2146
0132-000,2012,4,1,18,1589,805,2394,2265
0132-000,2012,4,1,19,1689,668,2357,2394
0132-000,2012,4,1,20,1517,571,2088,2357
0132-000,2012,4,1,21,1277,559,1836,2088
0132-000,2012,4,1,22,908,466,1374,1836
0132-000,2012,4,1,23,485,348,833,1374
0132-000,2012,4,1,24,277,265,542,833
0132-000,2012,4,2,1,129,163,292,542
0132-000,2012,4,2,2,89,90,179,292
0132-000,2012,4,2,3,58,70,128,179
0132-000,2012,4,2,4,51,78,129,128
0132-000,2012,4,2,5,97,113,210,129
0132-000,2012,4,2,6,177,207,384,210
0132-000,2012,4,2,7,471,592,1063,384
0132-000,2012,4,2,8,829,1646,2475,1063
0132-000,2012,4,2,9,863,1563,2426,2475
0132-000,2012,4,2,10,802,998,1800,2426
0132-000,2012,4,2,11,854,976,1830,1800
0132-000,2012,4,2,12,840,946,1786,1830
0132-000,2012,4,2,13,801,865,1666,1786
0132-000,2012,4,2,14,913,886,1799,1666
0132-000,2012,4,2,15,986,947,1933,1799
0132-000,2012,4,2,16,1014,942,1956,1933
0132-000,2012,4,2,17,1032,837,1869,1956
0132-000,2012,4,2,18,1208,872,2080,1869
0132-000,2012,4,2,19,1149,883,2032,2080
0132-000,2012,4,2,20,863,631,1494,2032
0132-000,2012,4,2,21,708,507,1215,1494
0132-000,2012,4,2,22,649,441,1090,1215
0132-000,2012,4,2,23,350,363,713,1090
0132-000,2012,4,2,24,231,231,462,713
0132-000,2012,4,3,1,148,162,310,462
0132-000,2012,4,3,2,107,105,212,310
0132-000,2012,4,3,3,88,98,186,212
0132-000,2012,4,3,4,76,111,187,186
0132-000,2012,4,3,5,89,132,221,187
0132-000,2012,4,3,6,149,122,271,221
0132-000,2012,4,3,7,312,343,655,271
0132-000,2012,4,3,8,646,1288,1934,655
0132-000,2012,4,3,9,780,1419,2199,1934
0132-000,2012,4,3,10,793,965,1758,2199
0132-000,2012,4,3,11,814,870,1684,1758
0132-000,2012,4,3,12,812,827,1639,1684
0132-000,2012,4,3,13,767,746,1513,1639
0132-000,2012,4,3,14,814,887,1701,1513
0132-000,2012,4,3,15,879,887,1766,1701
0132-000,2012,4,3,16,993,877,1870,1766
0132-000,2012,4,3,17,986,806,1792,1870
0132-000,2012,4,3,18,1088,817,1905,1792
0132-000,2012,4,3,19,1212,859,2071,1905
0132-000,2012,4,3,20,906,670,1576,2071
0132-000,2012,4,3,21,791,571,1362,1576
0132-000,2012,4,3,22,649,417,1066,1362
0132-000,2012,4,3,23,409,339,748,1066
0132-000,2012,4,3,24,228,242,470,748
0132-000,2012,4,4,1,179,146,325,470
0132-000,2012,4,4,2,102,121,223,325
0132-000,2012,4,4,3,76,108,184,223
0132-000,2012,4,4,4,87,101,188,184
0132-000,2012,4,4,5,104,111,215,188
0132-000,2012,4,4,6,169,144,313,215
0132-000,2012,4,4,7,370,410,780,313
0132-000,2012,4,4,8,708,1405,2113,780
0132-000,2012,4,4,9,875,1496,2371,2113
0132-000,2012,4,4,10,799,1092,1891,2371
0132-000,2012,4,4,11,876,966,1842,1891
0132-000,2012,4,4,12,934,893,1827,1842
0132-000,2012,4,4,13,858,895,1753,1827
0132-000,2012,4,4,14,894,943,1837,1753
0132-000,2012,4,4,15,994,1020,2014,1837
0132-000,2012,4,4,16,1021,930,1951,2014
0132-000,2012,4,4,17,1105,883,1988,1951
0132-000,2012,4,4,18,1279,840,2119,1988
0132-000,2012,4,4,19,1333,868,2201,2119
0132-000,2012,4,4,20,922,729,1651,2201
0132-000,2012,4,4,21,741,537,1278,1651
0132-000,2012,4,4,22,666,487,1153,1278
0132-000,2012,4,4,23,428,368,796,1153
0132-000,2012,4,4,24,237,266,503,796
0132-000,2012,4,5,1,175,213,388,503
0132-000,2012,4,5,2,134,136,270,388
0132-000,2012,4,5,3,98,97,195,270
0132-000,2012,4,5,4,69,102,171,195
0132-000,2012,4,5,5,105,131,236,171
0132-000,2012,4,5,6,147,169,316,236
0132-000,2012,4,5,7,396,430,826,316
0132-000,2012,4,5,8,738,1499,2237,826
0132-000,2012,4,5,9,833,1408,2241,2237
0132-000,2012,4,5,10,785,1070,1855,2241
0132-000,2012,4,5,11,857,1021,1878,1855
0132-000,2012,4,5,12,856,998,1854,1878
0132-000,2012,4,5,13,826,867,1693,1854
0132-000,2012,4,5,14,919,976,1895,1693
0132-000,2012,4,5,15,1059,971,2030,1895
0132-000,2012,4,5,16,1056,906,1962,2030
0132-000,2012,4,5,17,1140,905,2045,1962
0132-000,2012,4,5,18,1331,843,2174,2045
0132-000,2012,4,5,19,1342,942,2284,2174
0132-000,2012,4,5,20,1000,675,1675,2284
0132-000,2012,4,5,21,802,559,1361,1675
0132-000,2012,4,5,22,682,509,1191,1361
0132-000,2012,4,5,23,412,330,742,1191
0132-000,2012,4,5,24,271,254,525,742
0132-000,2012,4,6,1,185,188,373,525
0132-000,2012,4,6,2,115,141,256,373
0132-000,2012,4,6,3,131,108,239,256
0132-000,2012,4,6,4,67,96,163,239
0132-000,2012,4,6,5,118,132,250,163
0132-000,2012,4,6,6,190,165,355,250
0132-000,2012,4,6,7,393,442,835,355
0132-000,2012,4,6,8,770,1399,2169,835
0132-000,2012,4,6,9,878,1472,2350,2169
0132-000,2012,4,6,10,800,1014,1814,2350
0132-000,2012,4,6,11,885,1100,1985,1814
0132-000,2012,4,6,12,859,1023,1882,1985
0132-000,2012,4,6,13,812,840,1652,1882
0132-000,2012,4,6,14,920,882,1802,1652
0132-000,2012,4,6,15,973,957,1930,1802
0132-000,2012,4,6,16,1069,903,1972,1930
0132-000,2012,4,6,17,1032,915,1947,1972
0132-000,2012,4,6,18,1363,949,2312,1947
0132-000,2012,4,6,19,1577,976,2553,2312
0132-000,2012,4,6,20,1145,863,2008,2553
0132-000,2012,4,6,21,862,679,1541,2008
0132-000,2012,4,6,22,735,558,1293,1541
0132-000,2012,4,6,23,468,394,862,1293
0132-000,2012,4,6,24,270,259,529,862
0132-000,2012,4,7,1,219,213,432,529
0132-000,2012,4,7,2,149,167,316,432
0132-000,2012,4,7,3,111,126,237,316
0132-000,2012,4,7,4,93,120,213,237
0132-000,2012,4,7,5,109,128,237,213
0132-000,2012,4,7,6,179,155,334,237
0132-000,2012,4,7,7,322,323,645,334
0132-000,2012,4,7,8,535,771,1306,645
0132-000,2012,4,7,9,709,951,1660,1306
0132-000,2012,4,7,10,752,1096,1848,1660
0132-000,2012,4,7,11,813,1395,2208,1848
0132-000,2012,4,7,12,945,1586,2531,2208
0132-000,2012,4,7,13,877,1618,2495,2531
0132-000,2012,4,7,14,904,1469,2373,2495
0132-000,2012,4,7,15,975,1482,2457,2373
0132-000,2012,4,7,16,1060,1277,2337,2457
0132-000,2012,4,7,17,1213,1205,2418,2337
0132-000,2012,4,7,18,1539,1150,2689,2418
0132-000,2012,4,7,19,1510,916,2426,2689
0132-000,2012,4,7,20,1090,676,1766,2426
0132-000,2012,4,7,21,659,613,1272,1766
0132-000,2012,4,7,22,522,498,1020,1272
0132-000,2012,4,7,23,410,375,785,1020
0132-000,2012,4,7,24,274,296,570,785
0132-000,2012,4,8,1,198,198,396,570
0132-000,2012,4,8,2,136,136,272,396
0132-000,2012,4,8,3,94,96,190,272
0132-000,2012,4,8,4,63,70,133,190
0132-000,2012,4,8,5,71,81,152,133
0132-000,2012,4,8,6,100,108,208,152
0132-000,2012,4,8,7,172,223,395,208
0132-000,2012,4,8,8,277,358,635,395
0132-000,2012,4,8,9,413,535,948,635
0132-000,2012,4,8,10,495,619,1114,948
0132-000,2012,4,8,11,623,674,1297,1114
0132-000,2012,4,8,12,645,712,1357,1297
0132-000,2012,4,8,13,682,667,1349,1357
0132-000,2012,4,8,14,786,681,1467,1349
0132-000,2012,4,8,15,1021,724,1745,1467
0132-000,2012,4,8,16,1265,657,1922,1745
0132-000,2012,4,8,17,1409,716,2125,1922
0132-000,2012,4,8,18,1624,745,2369,2125
0132-000,2012,4,8,19,1625,655,2280,2369
0132-000,2012,4,8,20,1401,563,1964,2280
0132-000,2012,4,8,21,1155,554,1709,1964
0132-000,2012,4,8,22,990,468,1458,1709
0132-000,2012,4,8,23,488,392,880,1458
0132-000,2012,4,8,24,263,288,551,880
0132-000,2012,4,9,1,163,171,334,551
0132-000,2012,4,9,2,88,123,211,334
0132-000,2012,4,9,3,76,85,161,211
0132-000,2012,4,9,4,68,69,137,161
0132-000,2012,4,9,5,98,112,210,137
0132-000,2012,4,9,6,192,183,375,210
0132-000,2012,4,9,7,470,565,1035,375
0132-000,2012,4,9,8,765,1677,2442,1035
0132-000,2012,4,9,9,845,1515,2360,2442
0132-000,2012,4,9,10,749,1058,1807,2360
0132-000,2012,4,9,11,864,933,1797,1807
0132-000,2012,4,9,12,825,941,1766,1797
0132-000,2012,4,9,13,807,879,1686,1766
0132-000,2012,4,9,14,903,971,1874,1686
0132-000,2012,4,9,15,963,999,1962,1874
0132-000,2012,4,9,16,1072,936,2008,1962
0132-000,2012,4,9,17,1069,854,1923,2008
0132-000,2012,4,9,18,1186,875,2061,1923
0132-000,2012,4,9,19,1198,894,2092,2061
0132-000,2012,4,9,20,925,697,1622,2092
0132-000,2012,4,9,21,802,555,1357,1622
0132-000,2012,4,9,22,657,466,1123,1357
0132-000,2012,4,9,23,370,345,715,1123
0132-000,2012,4,9,24,256,228,484,715
0132-000,2012,4,10,1,168,171,339,484
0132-000,2012,4,10,2,108,117,225,339
0132-000,2012,4,10,3,78,100,178,225
0132-000,2012,4,10,4,85,95,180,178
0132-000,2012,4,10,5,92,127,219,180
0132-000,2012,4,10,6,176,162,338,219
0132-000,2012,4,10,7,395,426,821,338
0132-000,2012,4,10,8,743,1392,2135,821
0132-000,2012,4,10,9,897,1427,2324,2135
0132-000,2012,4,10,10,902,1038,1940,2324
0132-000,2012,4,10,11,886,940,1826,1940
0132-000,2012,4,10,12,927,948,1875,1826
0132-000,2012,4,10,13,872,847,1719,1875
0132-000,2012,4,10,14,981,951,1932,1719
0132-000,2012,4,10,15,1042,949,1991,1932
0132-000,2012,4,10,16,1021,924,1945,1991
0132-000,2012,4,10,17,1121,841,1962,1945
0132-000,2012,4,10,18,1224,937,2161,1962
0132-000,2012,4,10,19,1327,816,2143,2161
0132-000,2012,4,10,20,1064,747,1811,2143
0132-000,2012,4,10,21,851,646,1497,1811
0132-000,2012,4,10,22,725,497,1222,1497
0132-000,2012,4,10,23,438,397,835,1222
0132-000,2012,4,10,24,311,278,589,835
0132-000,2012,4,11,1,207,230,437,589
0132-000,2012,4,11,2,161,157,318,437
0132-000,2012,4,11,3,155,153,308,318
0132-000,2012,4,11,4,107,125,232,308
0132-000,2012,4,11,5,110,111,221,232
0132-000,2012,4,11,6,158,110,268,221
0132-000,2012,4,11,7,273,272,545,268
0132-000,2012,4,11,8,418,697,1115,545
0132-000,2012,4,11,9,650,856,1506,1115
0132-000,2012,4,11,10,658,832,1490,1506
0132-000,2012,4,11,11,732,849,1581,1490
0132-000,2012,4,11,12,837,876,1713,1581
0132-000,2012,4,11,13,819,808,1627,1713
0132-000,2012,4,11,14,847,850,1697,1627
0132-000,2012,4,11,15,877,871,1748,1697
0132-000,2012,4,11,16,910,857,1767,1748
0132-000,2012,4,11,17,898,801,1699,1767
0132-000,2012,4,11,18,979,818,1797,1699
0132-000,2012,4,11,19,864,691,1555,1797
0132-000,2012,4,11,20,790,603,1393,1555
0132-000,2012,4,11,21,575,524,1099,1393
0132-000,2012,4,11,22,463,402,865,1099
0132-000,2012,4,11,23,315,331,646,865
0132-000,2012,4,11,24,216,239,455,646
0132-000,2012,4,12,1,138,147,285,455
0132-000,2012,4,12,2,100,92,192,285
0132-000,2012,4,12,3,73,94,167,192
0132-000,2012,4,12,4,77,98,175,167
0132-000,2012,4,12,5,69,107,176,175
0132-000,2012,4,12,6,172,172,344,176
0132-000,2012,4,12,7,415,489,904,344
0132-000,2012,4,12,8,774,1561,2335,904
0132-000,2012,4,12,9,861,1469,2330,2335
0132-000,2012,4,12,10,846,1011,1857,2330
0132-000,2012,4,12,11,863,963,1826,1857
0132-000,2012,4,12,12,913,1019,1932,1826
0132-000,2012,4,12,13,837,816,1653,1932
0132-000,2012,4,12,14,843,955,1798,1653
0132-000,2012,4,12,15,1017,962,1979,1798
0132-000,2012,4,12,16,1013,957,1970,1979
0132-000,2012,4,12,17,992,869,1861,1970
0132-000,2012,4,12,18,1184,825,2009,1861
0132-000,2012,4,12,19,1148,861,2009,2009
0132-000,2012,4,12,20,941,666,1607,2009
0132-000,2012,4,12,21,782,595,1377,1607
0132-000,2012,4,12,22,717,454,1171,1377
0132-000,2012,4,12,23,422,327,749,1171
0132-000,2012,4,12,24,228,214,442,749
0132-000,2012,4,13,1,169,179,348,442
0132-000,2012,4,13,2,127,130,257,348
0132-000,2012,4,13,3,103,113,216,257
0132-000,2012,4,13,4,88,104,192,216
0132-000,2012,4,13,5,93,113,206,192
0132-000,2012,4,13,6,172,162,334,206
0132-000,2012,4,13,7,368,414,782,334
0132-000,2012,4,13,8,708,1411,2119,782
0132-000,2012,4,13,9,866,1408,2274,2119
0132-000,2012,4,13,10,834,993,1827,2274
0132-000,2012,4,13,11,862,1023,1885,1827
0132-000,2012,4,13,12,908,947,1855,1885
0132-000,2012,4,13,13,852,831,1683,1855
0132-000,2012,4,13,14,913,946,1859,1683
0132-000,2012,4,13,15,1029,1007,2036,1859
0132-000,2012,4,13,16,1033,930,1963,2036
0132-000,2012,4,13,17,1115,911,2026,1963
0132-000,2012,4,13,18,1550,918,2468,2026
0132-000,2012,4,13,19,1710,944,2654,2468
0132-000,2012,4,13,20,1070,776,1846,2654
0132-000,2012,4,13,21,892,685,1577,1846
0132-000,2012,4,13,22,746,591,1337,1577
0132-000,2012,4,13,23,427,417,844,1337
0132-000,2012,4,13,24,316,282,598,844
0132-000,2012,4,14,1,273,264,537,598
0132-000,2012,4,14,2,152,156,308,537
0132-000,2012,4,14,3,118,134,252,308
0132-000,2012,4,14,4,105,135,240,252
0132-000,2012,4,14,5,104,130,234,240
0132-000,2012,4,14,6,205,162,367,234
0132-000,2012,4,14,7,337,353,690,367
0132-000,2012,4,14,8,553,748,1301,690
0132-000,2012,4,14,9,703,981,1684,1301
0132-000,2012,4,14,10,764,1110,1874,1684
0132-000,2012,4,14,11,792,1482,2274,1874
0132-000,2012,4,14,12,895,1767,2662,2274
0132-000,2012,4,14,13,899,1818,2717,2662
0132-000,2012,4,14,14,970,1586,2556,2717
0132-000,2012,4,14,15,1045,1566,2611,2556
0132-000,2012,4,14,16,1037,1502,2539,2611
0132-000,2012,4,14,17,1242,1293,2535,2539
0132-000,2012,4,14,18,1620,1398,3018,2535
0132-000,2012,4,14,19,1513,1204,2717,3018
0132-000,2012,4,14,20,1017,791,1808,2717
0132-000,2012,4,14,21,680,600,1280,1808
0132-000,2012,4,14,22,647,515,1162,1280
0132-000,2012,4,14,23,403,386,789,1162
0132-000,2012,4,14,24,270,305,575,789
0132-000,2012,4,15,1,192,188,380,575
0132-000,2012,4,15,2,148,151,299,380
0132-000,2012,4,15,3,111,114,225,299
0132-000,2012,4,15,4,94,99,193,225
0132-000,2012,4,15,5,83,69,152,193
0132-000,2012,4,15,6,115,123,238,152
0132-000,2012,4,15,7,216,246,462,238
0132-000,2012,4,15,8,298,387,685,462
0132-000,2012,4,15,9,395,564,959,685
0132-000,2012,4,15,10,485,596,1081,959
0132-000,2012,4,15,11,610,693,1303,1081
0132-000,2012,4,15,12,633,714,1347,1303
0132-000,2012,4,15,13,725,686,1411,1347
0132-000,2012,4,15,14,817,713,1530,1411
0132-000,2012,4,15,15,962,751,1713,1530
0132-000,2012,4,15,16,1319,718,2037,1713
0132-000,2012,4,15,17,1590,731,2321,2037
0132-000,2012,4,15,18,1736,749,2485,2321
0132-000,2012,4,15,19,1721,654,2375,2485
0132-000,2012,4,15,20,1460,609,2069,2375
0132-000,2012,4,15,21,1247,521,1768,2069
0132-000,2012,4,15,22,1025,461,1486,1768
0132-000,2012,4,15,23,692,393,1085,1486
0132-000,2012,4,15,24,310,263,573,1085
0132-000,2012,4,16,1,172,155,327,573
0132-000,2012,4,16,2,91,112,203,327
0132-000,2012,4,16,3,77,88,165,203
0132-000,2012,4,16,4,62,81,143,165
0132-000,2012,4,16,5,79,111,190,143
0132-000,2012,4,16,6,189,199,388,190
0132-000,2012,4,16,7,462,562,1024,388
0132-000,2012,4,16,8,796,1752,2548,1024
0132-000,2012,4,16,9,844,1552,2396,2548
0132-000,2012,4,16,10,810,998,1808,2396
0132-000,2012,4,16,11,864,947,1811,1808
0132-000,2012,4,16,12,860,920,1780,1811
0132-000,2012,4,16,13,823,883,1706,1780
0132-000,2012,4,16,14,899,958,1857,1706
0132-000,2012,4,16,15,970,936,1906,1857
0132-000,2012,4,16,16,982,972,1954,1906
0132-000,2012,4,16,17,1041,944,1985,1954
0132-000,2012,4,16,18,1171,877,2048,1985
0132-000,2012,4,16,19,1287,873,2160,2048
0132-000,2012,4,16,20,943,753,1696,2160
0132-000,2012,4,16,21,809,549,1358,1696
0132-000,2012,4,16,22,683,521,1204,1358
0132-000,2012,4,16,23,376,340,716,1204
0132-000,2012,4,16,24,272,220,492,716
0132-000,2012,4,17,1,164,166,330,492
0132-000,2012,4,17,2,133,110,243,330
0132-000,2012,4,17,3,88,92,180,243
0132-000,2012,4,17,4,80,92,172,180
0132-000,2012,4,17,5,80,118,198,172
0132-000,2012,4,17,6,174,171,345,198
0132-000,2012,4,17,7,425,454,879,345
0132-000,2012,4,17,8,754,1440,2194,879
0132-000,2012,4,17,9,879,1402,2281,2194
0132-000,2012,4,17,10,796,1127,1923,2281
0132-000,2012,4,17,11,871,943,1814,1923
0132-000,2012,4,17,12,768,915,1683,1814
0132-000,2012,4,17,13,733,803,1536,1683
0132-000,2012,4,17,14,882,914,1796,1536
0132-000,2012,4,17,15,979,958,1937,1796
0132-000,2012,4,17,16,1029,940,1969,1937
0132-000,2012,4,17,17,1122,892,2014,1969
0132-000,2012,4,17,18,1203,901,2104,2014
0132-000,2012,4,17,19,1259,910,2169,2104
0132-000,2012,4,17,20,973,744,1717,2169
0132-000,2012,4,17,21,823,568,1391,1717
0132-000,2012,4,17,22,768,477,1245,1391
0132-000,2012,4,17,23,476,396,872,1245
0132-000,2012,4,17,24,295,282,577,872
0132-000,2012,4,18,1,181,154,335,577
0132-000,2012,4,18,2,108,136,244,335
0132-000,2012,4,18,3,89,88,177,244
0132-000,2012,4,18,4,83,79,162,177
0132-000,2012,4,18,5,88,102,190,162
0132-000,2012,4,18,6,196,164,360,190
0132-000,2012,4,18,7,411,429,840,360
0132-000,2012,4,18,8,763,1428,2191,840
0132-000,2012,4,18,9,910,1471,2381,2191
0132-000,2012,4,18,10,877,1080,1957,2381
0132-000,2012,4,18,11,819,963,1782,1957
0132-000,2012,4,18,12,659,894,1553,1782
0132-000,2012,4,18,13,478,797,1275,1553
0132-000,2012,4,18,14,578,912,1490,1275
0132-000,2012,4,18,15,690,921,1611,1490
0132-000,2012,4,18,16,955,891,1846,1611
0132-000,2012,4,18,17,1014,795,1809,1846
0132-000,2012,4,18,18,1195,924,2119,1809
0132-000,2012,4,18,19,1328,931,2259,2119
0132-000,2012,4,18,20,977,742,1719,2259
0132-000,2012,4,18,21,763,571,1334,1719
0132-000,2012,4,18,22,683,509,1192,1334
0132-000,2012,4,18,23,428,384,812,1192
0132-000,2012,4,18,24,267,286,553,812
0132-000,2012,4,19,1,227,192,419,553
0132-000,2012,4,19,2,108,115,223,419
0132-000,2012,4,19,3,87,95,182,223
0132-000,2012,4,19,4,90,93,183,182
0132-000,2012,4,19,5,96,111,207,183
0132-000,2012,4,19,6,187,158,345,207
0132-000,2012,4,19,7,391,453,844,345
0132-000,2012,4,19,8,748,1411,2159,844
0132-000,2012,4,19,9,867,1484,2351,2159
0132-000,2012,4,19,10,871,1041,1912,2351
0132-000,2012,4,19,11,754,915,1669,1912
0132-000,2012,4,19,12,749,909,1658,1669
0132-000,2012,4,19,13,626,781,1407,1658
0132-000,2012,4,19,14,837,976,1813,1407
0132-000,2012,4,19,15,908,980,1888,1813
0132-000,2012,4,19,16,987,913,1900,1888
0132-000,2012,4,19,17,1065,884,1949,1900
0132-000,2012,4,19,18,1193,890,2083,1949
0132-000,2012,4,19,19,1287,904,2191,2083
0132-000,2012,4,19,20,950,676,1626,2191
0132-000,2012,4,19,21,826,608,1434,1626
0132-000,2012,4,19,22,654,478,1132,1434
0132-000,2012,4,19,23,434,401,835,1132
0132-000,2012,4,19,24,282,258,540,835
0132-000,2012,4,20,1,187,201,388,540
0132-000,2012,4,20,2,134,110,244,388
0132-000,2012,4,20,3,95,125,220,244
0132-000,2012,4,20,4,86,130,216,220
0132-000,2012,4,20,5,108,110,218,216
0132-000,2012,4,20,6,192,190,382,218
0132-000,2012,4,20,7,391,398,789,382
0132-000,2012,4,20,8,760,1330,2090,789
0132-000,2012,4,20,9,886,1387,2273,2090
0132-000,2012,4,20,10,816,1004,1820,2273
0132-000,2012,4,20,11,856,953,1809,1820
0132-000,2012,4,20,12,865,908,1773,1809
0132-000,2012,4,20,13,833,903,1736,1773
0132-000,2012,4,20,14,920,923,1843,1736
0132-000,2012,4,20,15,994,992,1986,1843
0132-000,2012,4,20,16,1102,957,2059,1986
0132-000,2012,4,20,17,1111,948,2059,2059
0132-000,2012,4,20,18,1348,933,2281,2059
0132-000,2012,4,20,19,1553,1053,2606,2281
0132-000,2012,4,20,20,1100,996,2096,2606
0132-000,2012,4,20,21,968,783,1751,2096
0132-000,2012,4,20,22,797,640,1437,1751
0132-000,2012,4,20,23,455,545,1000,1437
0132-000,2012,4,20,24,325,329,654,1000
0132-000,2012,4,21,1,246,275,521,654
0132-000,2012,4,21,2,159,166,325,521
0132-000,2012,4,21,3,120,147,267,325
0132-000,2012,4,21,4,114,110,224,267
0132-000,2012,4,21,5,112,135,247,224
0132-000,2012,4,21,6,146,178,324,247
0132-000,2012,4,21,7,336,324,660,324
0132-000,2012,4,21,8,511,739,1250,660
0132-000,2012,4,21,9,691,912,1603,1250
0132-000,2012,4,21,10,790,873,1663,1603
0132-000,2012,4,21,11,788,990,1778,1663
0132-000,2012,4,21,12,856,990,1846,1778
0132-000,2012,4,21,13,824,971,1795,1846
0132-000,2012,4,21,14,837,936,1773,1795
0132-000,2012,4,21,15,1065,922,1987,1773
0132-000,2012,4,21,16,1102,824,1926,1987
0132-000,2012,4,21,17,1219,937,2156,1926
0132-000,2012,4,21,18,1469,936,2405,2156
0132-000,2012,4,21,19,1123,910,2033,2405
0132-000,2012,4,21,20,731,595,1326,2033
0132-000,2012,4,21,21,574,496,1070,1326
0132-000,2012,4,21,22,447,455,902,1070
0132-000,2012,4,21,23,321,345,666,902
0132-000,2012,4,21,24,226,233,459,666
0132-000,2012,4,22,1,167,198,365,459
0132-000,2012,4,22,2,121,140,261,365
0132-000,2012,4,22,3,109,102,211,261
0132-000,2012,4,22,4,89,93,182,211
0132-000,2012,4,22,5,77,83,160,182
0132-000,2012,4,22,6,80,93,173,160
0132-000,2012,4,22,7,162,156,318,173
0132-000,2012,4,22,8,234,350,584,318
0132-000,2012,4,22,9,399,475,874,584
0132-000,2012,4,22,10,437,489,926,874
0132-000,2012,4,22,11,503,558,1061,926
0132-000,2012,4,22,12,567,598,1165,1061
0132-000,2012,4,22,13,689,642,1331,1165
0132-000,2012,4,22,14,742,640,1382,1331
0132-000,2012,4,22,15,735,671,1406,1382
0132-000,2012,4,22,16,911,663,1574,1406
0132-000,2012,4,22,17,1204,693,1897,1574
0132-000,2012,4,22,18,1106,651,1757,1897
0132-000,2012,4,22,19,918,582,1500,1757
0132-000,2012,4,22,20,661,552,1213,1500
0132-000,2012,4,22,21,545,490,1035,1213
0132-000,2012,4,22,22,396,438,834,1035
0132-000,2012,4,22,23,317,317,634,834
0132-000,2012,4,22,24,207,229,436,634
0132-000,2012,4,23,1,123,153,276,436
0132-000,2012,4,23,2,101,124,225,276
0132-000,2012,4,23,3,69,73,142,225
0132-000,2012,4,23,4,76,84,160,142
0132-000,2012,4,23,5,79,115,194,160
0132-000,2012,4,23,6,200,233,433,194
0132-000,2012,4,23,7,470,595,1065,433
0132-000,2012,4,23,8,795,1662,2457,1065
0132-000,2012,4,23,9,845,1490,2335,2457
0132-000,2012,4,23,10,793,992,1785,2335
0132-000,2012,4,23,11,812,960,1772,1785
0132-000,2012,4,23,12,821,1003,1824,1772
0132-000,2012,4,23,13,759,977,1736,1824
0132-000,2012,4,23,14,686,1069,1755,1736
0132-000,2012,4,23,15,801,1011,1812,1755
0132-000,2012,4,23,16,884,934,1818,1812
0132-000,2012,4,23,17,827,848,1675,1818
0132-000,2012,4,23,18,1010,893,1903,1675
0132-000,2012,4,23,19,1276,882,2158,1903
0132-000,2012,4,23,20,942,711,1653,2158
0132-000,2012,4,23,21,831,593,1424,1653
0132-000,2012,4,23,22,533,490,1023,1424
0132-000,2012,4,23,23,365,376,741,1023
0132-000,2012,4,23,24,269,253,522,741
0132-000,2012,4,24,1,185,163,348,522
0132-000,2012,4,24,2,123,122,245,348
0132-000,2012,4,24,3,92,125,217,245
0132-000,2012,4,24,4,72,88,160,217
0132-000,2012,4,24,5,96,127,223,160
0132-000,2012,4,24,6,189,171,360,223
0132-000,2012,4,24,7,434,472,906,360
0132-000,2012,4,24,8,752,1490,2242,906
0132-000,2012,4,24,9,882,1473,2355,2242
0132-000,2012,4,24,10,747,1023,1770,2355
0132-000,2012,4,24,11,705,931,1636,1770
0132-000,2012,4,24,12,749,923,1672,1636
0132-000,2012,4,24,13,715,804,1519,1672
0132-000,2012,4,24,14,744,980,1724,1519
0132-000,2012,4,24,15,944,1008,1952,1724
0132-000,2012,4,24,16,1088,919,2007,1952
0132-000,2012,4,24,17,1120,874,1994,2007
0132-000,2012,4,24,18,1125,928,2053,1994
0132-000,2012,4,24,19,1283,891,2174,2053
0132-000,2012,4,24,20,997,691,1688,2174
0132-000,2012,4,24,21,845,591,1436,1688
0132-000,2012,4,24,22,660,530,1190,1436
0132-000,2012,4,24,23,413,319,732,1190
0132-000,2012,4,24,24,262,250,512,732
0132-000,2012,4,25,1,196,172,368,512
0132-000,2012,4,25,2,123,136,259,368
0132-000,2012,4,25,3,79,107,186,259
0132-000,2012,4,25,4,91,107,198,186
0132-000,2012,4,25,5,84,111,195,198
0132-000,2012,4,25,6,175,145,320,195
0132-000,2012,4,25,7,378,355,733,320
0132-000,2012,4,25,8,717,1322,2039,733
0132-000,2012,4,25,9,831,1418,2249,2039
0132-000,2012,4,25,10,777,996,1773,2249
0132-000,2012,4,25,11,828,884,1712,1773
0132-000,2012,4,25,12,844,838,1682,1712
0132-000,2012,4,25,13,768,847,1615,1682
0132-000,2012,4,25,14,875,881,1756,1615
0132-000,2012,4,25,15,903,927,1830,1756
0132-000,2012,4,25,16,977,899,1876,1830
0132-000,2012,4,25,17,962,797,1759,1876
0132-000,2012,4,25,18,1151,795,1946,1759
0132-000,2012,4,25,19,1122,829,1951,1946
0132-000,2012,4,25,20,899,699,1598,1951
0132-000,2012,4,25,21,736,547,1283,1598
0132-000,2012,4,25,22,597,453,1050,1283
0132-000,2012,4,25,23,421,377,798,1050
0132-000,2012,4,25,24,254,247,501,798
0132-000,2012,4,26,1,171,160,331,501
0132-000,2012,4,26,2,118,162,280,331
0132-000,2012,4,26,3,91,103,194,280
0132-000,2012,4,26,4,80,98,178,194
0132-000,2012,4,26,5,91,124,215,178
0132-000,2012,4,26,6,197,194,391,215
0132-000,2012,4,26,7,423,446,869,391
0132-000,2012,4,26,8,750,1522,2272,869
0132-000,2012,4,26,9,866,1473,2339,2272
0132-000,2012,4,26,10,856,1073,1929,2339
0132-000,2012,4,26,11,875,1008,1883,1929
0132-000,2012,4,26,12,937,933,1870,1883
0132-000,2012,4,26,13,842,900,1742,1870
0132-000,2012,4,26,14,924,965,1889,1742
0132-000,2012,4,26,15,739,914,1653,1889
0132-000,2012,4,26,16,1034,906,1940,1653
0132-000,2012,4,26,17,1141,946,2087,1940
0132-000,2012,4,26,18,1322,848,2170,2087
0132-000,2012,4,26,19,1290,935,2225,2170
0132-000,2012,4,26,20,972,678,1650,2225
0132-000,2012,4,26,21,883,551,1434,1650
0132-000,2012,4,26,22,670,531,1201,1434
0132-000,2012,4,26,23,458,389,847,1201
0132-000,2012,4,26,24,277,251,528,847
0132-000,2012,4,27,1,195,212,407,528
0132-000,2012,4,27,2,142,134,276,407
0132-000,2012,4,27,3,101,117,218,276
0132-000,2012,4,27,4,95,119,214,218
0132-000,2012,4,27,5,95,131,226,214
0132-000,2012,4,27,6,186,167,353,226
0132-000,2012,4,27,7,436,466,902,353
0132-000,2012,4,27,8,784,1425,2209,902
0132-000,2012,4,27,9,852,1416,2268,2209
0132-000,2012,4,27,10,857,980,1837,2268
0132-000,2012,4,27,11,778,966,1744,1837
0132-000,2012,4,27,12,815,903,1718,1744
0132-000,2012,4,27,13,598,892,1490,1718
0132-000,2012,4,27,14,632,868,1500,1490
0132-000,2012,4,27,15,831,966,1797,1500
0132-000,2012,4,27,16,1016,913,1929,1797
0132-000,2012,4,27,17,1114,927,2041,1929
0132-000,2012,4,27,18,1290,956,2246,2041
0132-000,2012,4,27,19,1222,961,2183,2246
0132-000,2012,4,27,20,946,793,1739,2183
0132-000,2012,4,27,21,777,675,1452,1739
0132-000,2012,4,27,22,594,551,1145,1452
0132-000,2012,4,27,23,469,441,910,1145
0132-000,2012,4,27,24,301,335,636,910
0132-000,2012,4,28,1,224,239,463,636
0132-000,2012,4,28,2,163,186,349,463
0132-000,2012,4,28,3,119,147,266,349
0132-000,2012,4,28,4,101,131,232,266
0132-000,2012,4,28,5,120,141,261,232
0132-000,2012,4,28,6,190,175,365,261
0132-000,2012,4,28,7,373,430,803,365
0132-000,2012,4,28,8,610,876,1486,803
0132-000,2012,4,28,9,760,1064,1824,1486
0132-000,2012,4,28,10,740,1183,1923,1824
0132-000,2012,4,28,11,680,1365,2045,1923
0132-000,2012,4,28,12,824,1406,2230,2045
0132-000,2012,4,28,13,742,1341,2083,2230
0132-000,2012,4,28,14,800,1306,2106,2083
0132-000,2012,4,28,15,965,1212,2177,2106
0132-000,2012,4,28,16,957,1074,2031,2177
0132-000,2012,4,28,17,1015,1149,2164,2031
0132-000,2012,4,28,18,1253,1341,2594,2164
0132-000,2012,4,28,19,1070,1049,2119,2594
0132-000,2012,4,28,20,772,745,1517,2119
0132-000,2012,4,28,21,628,589,1217,1517
0132-000,2012,4,28,22,478,512,990,1217
0132-000,2012,4,28,23,316,399,715,990
0132-000,2012,4,28,24,266,301,567,715
0132-000,2012,4,29,1,185,227,412,567
0132-000,2012,4,29,2,170,167,337,412
0132-000,2012,4,29,3,112,120,232,337
0132-000,2012,4,29,4,99,100,199,232
0132-000,2012,4,29,5,84,110,194,199
0132-000,2012,4,29,6,130,182,312,194
0132-000,2012,4,29,7,253,291,544,312
0132-000,2012,4,29,8,351,461,812,544
0132-000,2012,4,29,9,446,578,1024,812
0132-000,2012,4,29,10,461,651,1112,1024
0132-000,2012,4,29,11,478,688,1166,1112
0132-000,2012,4,29,12,498,608,1106,1166
0132-000,2012,4,29,13,540,686,1226,1106
0132-000,2012,4,29,14,611,632,1243,1226
0132-000,2012,4,29,15,762,665,1427,1243
0132-000,2012,4,29,16,1045,706,1751,1427
0132-000,2012,4,29,17,1233,697,1930,1751
0132-000,2012,4,29,18,1460,742,2202,1930
0132-000,2012,4,29,19,1323,639,1962,2202
0132-000,2012,4,29,20,1060,533,1593,1962
0132-000,2012,4,29,21,802,536,1338,1593
0132-000,2012,4,29,22,661,477,1138,1338
0132-000,2012,4,29,23,373,365,738,1138
0132-000,2012,4,29,24,228,249,477,738
0132-000,2012,4,30,1,136,207,343,477
0132-000,2012,4,30,2,97,114,211,343
0132-000,2012,4,30,3,70,85,155,211
0132-000,2012,4,30,4,50,100,150,155
0132-000,2012,4,30,5,83,113,196,150
0132-000,2012,4,30,6,198,212,410,196
0132-000,2012,4,30,7,477,620,1097,410
0132-000,2012,4,30,8,778,1670,2448,1097
0132-000,2012,4,30,9,874,1475,2349,2448
0132-000,2012,4,30,10,711,1048,1759,2349
0132-000,2012,4,30,11,796,996,1792,1759
0132-000,2012,4,30,12,793,899,1692,1792
0132-000,2012,4,30,13,620,991,1611,1692
0132-000,2012,4,30,14,678,1006,1684,1611
0132-000,2012,4,30,15,868,954,1822,1684
0132-000,2012,4,30,16,931,989,1920,1822
0132-000,2012,4,30,17,1023,963,1986,1920
0132-000,2012,4,30,18,1152,947,2099,1986
0132-000,2012,4,30,19,1269,966,2235,2099
0132-000,2012,4,30,20,980,773,1753,2235
0132-000,2012,4,30,21,775,685,1460,1753
0132-000,2012,4,30,22,628,555,1183,1460
0132-000,2012,4,30,23,448,413,861,1183
0132-000,2012,4,30,24,306,314,620,861
0132-000,2012,5,1,1,242,225,467,620
0132-000,2012,5,1,2,150,152,302,467
0132-000,2012,5,1,3,109,124,233,302
0132-000,2012,5,1,4,81,123,204,233
0132-000,2012,5,1,5,109,121,230,204
0132-000,2012,5,1,6,153,171,324,230
0132-000,2012,5,1,7,309,412,721,324
0132-000,2012,5,1,8,604,978,1582,721
0132-000,2012,5,1,9,728,1162,1890,1582
0132-000,2012,5,1,10,659,950,1609,1890
0132-000,2012,5,1,11,718,913,1631,1609
0132-000,2012,5,1,12,794,825,1619,1631
0132-000,2012,5,1,13,745,777,1522,1619
0132-000,2012,5,1,14,677,844,1521,1522
0132-000,2012,5,1,15,765,788,1553,1521
0132-000,2012,5,1,16,871,684,1555,1553
0132-000,2012,5,1,17,923,788,1711,1555
0132-000,2012,5,1,18,1064,899,1963,1711
0132-000,2012,5,1,19,1008,688,1696,1963
0132-000,2012,5,1,20,734,584,1318,1696
0132-000,2012,5,1,21,630,480,1110,1318
0132-000,2012,5,1,22,471,431,902,1110
0132-000,2012,5,1,23,328,354,682,902
0132-000,2012,5,1,24,250,235,485,682
0132-000,2012,5,2,1,144,166,310,485
0132-000,2012,5,2,2,100,124,224,310
0132-000,2012,5,2,3,84,104,188,224
0132-000,2012,5,2,4,87,107,194,188
0132-000,2012,5,2,5,104,124,228,194
0132-000,2012,5,2,6,219,212,431,228
0132-000,2012,5,2,7,441,543,984,431
0132-000,2012,5,2,8,746,1550,2296,984
0132-000,2012,5,2,9,876,1477,2353,2296
0132-000,2012,5,2,10,746,1016,1762,2353
0132-000,2012,5,2,11,711,915,1626,1762
0132-000,2012,5,2,12,755,960,1715,1626
0132-000,2012,5,2,13,799,895,1694,1715
0132-000,2012,5,2,14,722,905,1627,1694
0132-000,2012,5,2,15,815,1038,1853,1627
0132-000,2012,5,2,16,1044,984,2028,1853
0132-000,2012,5,2,17,1072,856,1928,2028
0132-000,2012,5,2,18,1188,897,2085,1928
0132-000,2012,5,2,19,1233,932,2165,2085
0132-000,2012,5,2,20,913,720,1633,2165
0132-000,2012,5,2,21,752,557,1309,1633
0132-000,2012,5,2,22,506,524,1030,1309
0132-000,2012,5,2,23,315,375,690,1030
0132-000,2012,5,2,24,230,240,470,690
0132-000,2012,5,3,1,166,188,354,470
0132-000,2012,5,3,2,111,134,245,354
0132-000,2012,5,3,3,107,106,213,245
0132-000,2012,5,3,4,80,122,202,213
0132-000,2012,5,3,5,109,128,237,202
0132-000,2012,5,3,6,215,198,413,237
0132-000,2012,5,3,7,418,471,889,413
0132-000,2012,5,3,8,734,1485,2219,889
0132-000,2012,5,3,9,790,1411,2201,2219
0132-000,2012,5,3,10,687,1031,1718,2201
0132-000,2012,5,3,11,802,997,1799,1718
0132-000,2012,5,3,12,787,913,1700,1799
0132-000,2012,5,3,13,820,850,1670,1700
0132-000,2012,5,3,14,791,967,1758,1670
0132-000,2012,5,3,15,825,993,1818,1758
0132-000,2012,5,3,16,827,944,1771,1818
0132-000,2012,5,3,17,976,856,1832,1771
0132-000,2012,5,3,18,1237,926,2163,1832
0132-000,2012,5,3,19,1243,821,2064,2163
0132-000,2012,5,3,20,845,765,1610,2064
0132-000,2012,5,3,21,613,580,1193,1610
0132-000,2012,5,3,22,535,526,1061,1193
0132-000,2012,5,3,23,396,372,768,1061
0132-000,2012,5,3,24,259,246,505,768
0132-000,2012,5,4,1,192,158,350,505
0132-000,2012,5,4,2,134,134,268,350
0132-000,2012,5,4,3,100,132,232,268
0132-000,2012,5,4,4,83,136,219,232
0132-000,2012,5,4,5,111,114,225,219
0132-000,2012,5,4,6,194,199,393,225
0132-000,2012,5,4,7,448,469,917,393
0132-000,2012,5,4,8,755,1409,2164,917
0132-000,2012,5,4,9,841,1362,2203,2164
0132-000,2012,5,4,10,694,1051,1745,2203
0132-000,2012,5,4,11,817,1059,1876,1745
0132-000,2012,5,4,12,801,928,1729,1876
0132-000,2012,5,4,13,758,820,1578,1729
0132-000,2012,5,4,14,721,914,1635,1578
0132-000,2012,5,4,15,884,911,1795,1635
0132-000,2012,5,4,16,850,984,1834,1795
0132-000,2012,5,4,17,896,876,1772,1834
0132-000,2012,5,4,18,1050,989,2039,1772
0132-000,2012,5,4,19,1180,1168,2348,2039
0132-000,2012,5,4,20,875,1169,2044,2348
0132-000,2012,5,4,21,888,1137,2025,2044
0132-000,2012,5,4,22,523,1128,1651,2025
0132-000,2012,5,4,23,457,1172,1629,1651
0132-000,2012,5,4,24,307,991,1298,1629
0132-000,2012,5,5,1,257,801,1058,1298
0132-000,2012,5,5,2,182,386,568,1058
0132-000,2012,5,5,3,137,157,294,568
0132-000,2012,5,5,4,116,107,223,294
0132-000,2012,5,5,5,118,150,268,223
0132-000,2012,5,5,6,208,205,413,268
0132-000,2012,5,5,7,350,347,697,413
0132-000,2012,5,5,8,443,744,1187,697
0132-000,2012,5,5,9,570,1137,1707,1187
0132-000,2012,5,5,10,636,1513,2149,1707
0132-000,2012,5,5,11,686,1624,2310,2149
0132-000,2012,5,5,12,643,1796,2439,2310
0132-000,2012,5,5,13,638,1640,2278,2439
0132-000,2012,5,5,14,627,1515,2142,2278
0132-000,2012,5,5,15,722,1581,2303,2142
0132-000,2012,5,5,16,798,1398,2196,2303
0132-000,2012,5,5,17,860,1314,2174,2196
0132-000,2012,5,5,18,1024,1235,2259,2174
0132-000,2012,5,5,19,935,1063,1998,2259
0132-000,2012,5,5,20,609,695,1304,1998
0132-000,2012,5,5,21,670,578,1248,1304
0132-000,2012,5,5,22,533,525,1058,1248
0132-000,2012,5,5,23,349,426,775,1058
0132-000,2012,5,5,24,226,274,500,775
0132-000,2012,5,6,1,167,202,369,500
0132-000,2012,5,6,2,115,120,235,369
0132-000,2012,5,6,3,77,98,175,235
0132-000,2012,5,6,4,90,65,155,175
0132-000,2012,5,6,5,79,80,159,155
0132-000,2012,5,6,6,121,135,256,159
0132-000,2012,5,6,7,241,285,526,256
0132-000,2012,5,6,8,322,404,726,526
0132-000,2012,5,6,9,404,566,970,726
0132-000,2012,5,6,10,522,651,1173,970
0132-000,2012,5,6,11,832,710,1542,1173
0132-000,2012,5,6,12,1118,723,1841,1542
0132-000,2012,5,6,13,1183,677,1860,1841
0132-000,2012,5,6,14,1251,678,1929,1860
0132-000,2012,5,6,15,1263,701,1964,1929
0132-000,2012,5,6,16,1258,747,2005,1964
0132-000,2012,5,6,17,1598,772,2370,2005
0132-000,2012,5,6,18,1629,826,2455,2370
0132-000,2012,5,6,19,1386,688,2074,2455
0132-000,2012,5,6,20,1656,581,2237,2074
0132-000,2012,5,6,21,1473,637,2110,2237
0132-000,2012,5,6,22,1292,587,1879,2110
0132-000,2012,5,6,23,1027,394,1421,1879
0132-000,2012,5,6,24,807,335,1142,1421
0132-000,2012,5,7,1,296,171,467,1142
0132-000,2012,5,7,2,117,121,238,467
0132-000,2012,5,7,3,73,98,171,238
0132-000,2012,5,7,4,52,90,142,171
0132-000,2012,5,7,5,80,123,203,142
0132-000,2012,5,7,6,204,219,423,203
0132-000,2012,5,7,7,423,637,1060,423
0132-000,2012,5,7,8,644,1697,2341,1060
0132-000,2012,5,7,9,696,1455,2151,2341
0132-000,2012,5,7,10,673,1093,1766,2151
0132-000,2012,5,7,11,748,921,1669,1766
0132-000,2012,5,7,12,755,960,1715,1669
0132-000,2012,5,7,13,558,933,1491,1715
0132-000,2012,5,7,14,826,964,1790,1491
0132-000,2012,5,7,15,751,996,1747,1790
0132-000,2012,5,7,16,896,913,1809,1747
0132-000,2012,5,7,17,965,891,1856,1809
0132-000,2012,5,7,18,1196,941,2137,1856
0132-000,2012,5,7,19,1189,937,2126,2137
0132-000,2012,5,7,20,865,783,1648,2126
0132-000,2012,5,7,21,783,649,1432,1648
0132-000,2012,5,7,22,743,513,1256,1432
0132-000,2012,5,7,23,427,387,814,1256
0132-000,2012,5,7,24,245,280,525,814
0132-000,2012,5,8,1,162,181,343,525
0132-000,2012,5,8,2,145,126,271,343
0132-000,2012,5,8,3,53,94,147,271
0132-000,2012,5,8,4,97,114,211,147
0132-000,2012,5,8,5,102,141,243,211
0132-000,2012,5,8,6,244,193,437,243
0132-000,2012,5,8,7,521,511,1032,437
0132-000,2012,5,8,8,721,1492,2213,1032
0132-000,2012,5,8,9,990,1479,2469,2213
0132-000,2012,5,8,10,918,1043,1961,2469
0132-000,2012,5,8,11,989,1041,2030,1961
0132-000,2012,5,8,12,928,987,1915,2030
0132-000,2012,5,8,13,911,900,1811,1915
0132-000,2012,5,8,14,901,949,1850,1811
0132-000,2012,5,8,15,946,954,1900,1850
0132-000,2012,5,8,16,1134,958,2092,1900
0132-000,2012,5,8,17,1079,911,1990,2092
0132-000,2012,5,8,18,1088,909,1997,1990
0132-000,2012,5,8,19,1327,966,2293,1997
0132-000,2012,5,8,20,1008,793,1801,2293
0132-000,2012,5,8,21,915,631,1546,1801
0132-000,2012,5,8,22,789,569,1358,1546
0132-000,2012,5,8,23,518,397,915,1358
0132-000,2012,5,8,24,258,258,516,915
0132-000,2012,5,9,1,159,166,325,516
0132-000,2012,5,9,2,94,120,214,325
0132-000,2012,5,9,3,88,114,202,214
0132-000,2012,5,9,4,80,95,175,202
0132-000,2012,5,9,5,92,119,211,175
0132-000,2012,5,9,6,229,194,423,211
0132-000,2012,5,9,7,415,463,878,423
0132-000,2012,5,9,8,739,1428,2167,878
0132-000,2012,5,9,9,912,1437,2349,2167
0132-000,2012,5,9,10,908,1032,1940,2349
0132-000,2012,5,9,11,903,986,1889,1940
0132-000,2012,5,9,12,899,930,1829,1889
0132-000,2012,5,9,13,773,774,1547,1829
0132-000,2012,5,9,14,902,914,1816,1547
0132-000,2012,5,9,15,980,964,1944,1816
0132-000,2012,5,9,16,962,902,1864,1944
0132-000,2012,5,9,17,1095,875,1970,1864
0132-000,2012,5,9,18,1156,889,2045,1970
0132-000,2012,5,9,19,1301,905,2206,2045
0132-000,2012,5,9,20,917,745,1662,2206
0132-000,2012,5,9,21,714,566,1280,1662
0132-000,2012,5,9,22,520,520,1040,1280
0132-000,2012,5,9,23,379,411,790,1040
0132-000,2012,5,9,24,294,277,571,790
0132-000,2012,5,10,1,147,179,326,571
0132-000,2012,5,10,2,141,128,269,326
0132-000,2012,5,10,3,78,118,196,269
0132-000,2012,5,10,4,63,102,165,196
0132-000,2012,5,10,5,130,140,270,165
0132-000,2012,5,10,6,237,191,428,270
0132-000,2012,5,10,7,437,467,904,428
0132-000,2012,5,10,8,608,1474,2082,904
0132-000,2012,5,10,9,905,1482,2387,2082
0132-000,2012,5,10,10,712,1032,1744,2387
0132-000,2012,5,10,11,528,992,1520,1744
0132-000,2012,5,10,12,611,908,1519,1520
0132-000,2012,5,10,13,1160,844,2004,1519
0132-000,2012,5,10,14,1469,910,2379,2004
0132-000,2012,5,10,15,1117,927,2044,2379
0132-000,2012,5,10,16,1065,914,1979,2044
0132-000,2012,5,10,17,1149,931,2080,1979
0132-000,2012,5,10,18,1207,984,2191,2080
0132-000,2012,5,10,19,1363,955,2318,2191
0132-000,2012,5,10,20,1038,725,1763,2318
0132-000,2012,5,10,21,873,618,1491,1763
0132-000,2012,5,10,22,615,550,1165,1491
0132-000,2012,5,10,23,495,396,891,1165
0132-000,2012,5,10,24,290,273,563,891
0132-000,2012,5,11,1,229,192,421,563
0132-000,2012,5,11,2,149,181,330,421
0132-000,2012,5,11,3,111,145,256,330
0132-000,2012,5,11,4,123,141,264,256
0132-000,2012,5,11,5,83,117,200,264
0132-000,2012,5,11,6,338,237,575,200
0132-000,2012,5,11,7,458,494,952,575
0132-000,2012,5,11,8,764,1407,2171,952
0132-000,2012,5,11,9,944,1390,2334,2171
0132-000,2012,5,11,10,882,969,1851,2334
0132-000,2012,5,11,11,869,1010,1879,1851
0132-000,2012,5,11,12,950,943,1893,1879
0132-000,2012,5,11,13,967,937,1904,1893
0132-000,2012,5,11,14,1097,1080,2177,1904
0132-000,2012,5,11,15,1016,1049,2065,2177
0132-000,2012,5,11,16,1102,978,2080,2065
0132-000,2012,5,11,17,1159,947,2106,2080
0132-000,2012,5,11,18,1332,923,2255,2106
0132-000,2012,5,11,19,1536,960,2496,2255
0132-000,2012,5,11,20,1135,832,1967,2496
0132-000,2012,5,11,21,913,721,1634,1967
0132-000,2012,5,11,22,746,602,1348,1634
0132-000,2012,5,11,23,542,436,978,1348
0132-000,2012,5,11,24,314,328,642,978
0132-000,2012,5,12,1,237,246,483,642
0132-000,2012,5,12,2,168,198,366,483
0132-000,2012,5,12,3,110,156,266,366
0132-000,2012,5,12,4,111,149,260,266
0132-000,2012,5,12,5,115,139,254,260
0132-000,2012,5,12,6,361,247,608,254
0132-000,2012,5,12,7,455,432,887,608
0132-000,2012,5,12,8,569,868,1437,887
0132-000,2012,5,12,9,771,1072,1843,1437
0132-000,2012,5,12,10,919,1025,1944,1843
0132-000,2012,5,12,11,848,1119,1967,1944
0132-000,2012,5,12,12,1145,1324,2469,1967
0132-000,2012,5,12,13,1240,1392,2632,2469
0132-000,2012,5,12,14,1115,1256,2371,2632
0132-000,2012,5,12,15,944,1012,1956,2371
0132-000,2012,5,12,16,1120,1005,2125,1956
0132-000,2012,5,12,17,1613,1173,2786,2125
0132-000,2012,5,12,18,2201,1540,3741,2786
0132-000,2012,5,12,19,1564,1161,2725,3741
0132-000,2012,5,12,20,840,725,1565,2725
0132-000,2012,5,12,21,571,594,1165,1565
0132-000,2012,5,12,22,450,498,948,1165
0132-000,2012,5,12,23,369,400,769,948
0132-000,2012,5,12,24,192,259,451,769
0132-000,2012,5,13,1,199,229,428,451
0132-000,2012,5,13,2,98,153,251,428
0132-000,2012,5,13,3,84,101,185,251
0132-000,2012,5,13,4,80,93,173,185
0132-000,2012,5,13,5,106,100,206,173
0132-000,2012,5,13,6,171,158,329,206
0132-000,2012,5,13,7,238,278,516,329
0132-000,2012,5,13,8,394,441,835,516
0132-000,2012,5,13,9,390,521,911,835
0132-000,2012,5,13,10,538,640,1178,911
0132-000,2012,5,13,11,561,727,1288,1178
0132-000,2012,5,13,12,649,663,1312,1288
0132-000,2012,5,13,13,591,715,1306,1312
0132-000,2012,5,13,14,688,696,1384,1306
0132-000,2012,5,13,15,930,706,1636,1384
0132-000,2012,5,13,16,1013,786,1799,1636
0132-000,2012,5,13,17,1713,1039,2752,1799
0132-000,2012,5,13,18,1481,816,2297,2752
0132-000,2012,5,13,19,915,653,1568,2297
0132-000,2012,5,13,20,964,683,1647,1568
0132-000,2012,5,13,21,645,594,1239,1647
0132-000,2012,5,13,22,574,540,1114,1239
0132-000,2012,5,13,23,290,359,649,1114
0132-000,2012,5,13,24,209,259,468,649
0132-000,2012,5,14,1,142,168,310,468
0132-000,2012,5,14,2,96,117,213,310
0132-000,2012,5,14,3,57,92,149,213
0132-000,2012,5,14,4,48,73,121,149
0132-000,2012,5,14,5,74,97,171,121
0132-000,2012,5,14,6,179,205,384,171
0132-000,2012,5,14,7,460,623,1083,384
0132-000,2012,5,14,8,862,1726,2588,1083
0132-000,2012,5,14,9,829,1422,2251,2588
0132-000,2012,5,14,10,890,1029,1919,2251
0132-000,2012,5,14,11,792,929,1721,1919
0132-000,2012,5,14,12,857,884,1741,1721
0132-000,2012,5,14,13,854,903,1757,1741
0132-000,2012,5,14,14,791,895,1686,1757
0132-000,2012,5,14,15,899,894,1793,1686
0132-000,2012,5,14,16,932,851,1783,1793
0132-000,2012,5,14,17,1099,891,1990,1783
0132-000,2012,5,14,18,1103,874,1977,1990
0132-000,2012,5,14,19,1223,885,2108,1977
0132-000,2012,5,14,20,879,687,1566,2108
0132-000,2012,5,14,21,762,587,1349,1566
0132-000,2012,5,14,22,600,488,1088,1349
0132-000,2012,5,14,23,377,339,716,1088
0132-000,2012,5,14,24,199,216,415,716
0132-000,2012,5,15,1,163,158,321,415
0132-000,2012,5,15,2,91,104,195,321
0132-000,2012,5,15,3,61,92,153,195
0132-000,2012,5,15,4,60,93,153,153
0132-000,2012,5,15,5,74,121,195,153
0132-000,2012,5,15,6,271,201,472,195
0132-000,2012,5,15,7,479,473,952,472
0132-000,2012,5,15,8,816,1469,2285,952
0132-000,2012,5,15,9,1006,1453,2459,2285
0132-000,2012,5,15,10,837,1027,1864,2459
0132-000,2012,5,15,11,872,963,1835,1864
0132-000,2012,5,15,12,1006,972,1978,1835
0132-000,2012,5,15,13,837,874,1711,1978
0132-000,2012,5,15,14,847,959,1806,1711
0132-000,2012,5,15,15,1023,1060,2083,1806
0132-000,2012,5,15,16,1105,963,2068,2083
0132-000,2012,5,15,17,1124,924,2048,2068
0132-000,2012,5,15,18,1160,940,2100,2048
0132-000,2012,5,15,19,1298,924,2222,2100
0132-000,2012,5,15,20,941,757,1698,2222
0132-000,2012,5,15,21,857,594,1451,1698
0132-000,2012,5,15,22,583,494,1077,1451
0132-000,2012,5,15,23,410,382,792,1077
0132-000,2012,5,15,24,253,261,514,792
0132-000,2012,5,16,1,217,203,420,514
0132-000,2012,5,16,2,125,131,256,420
0132-000,2012,5,16,3,114,119,233,256
0132-000,2012,5,16,4,72,107,179,233
0132-000,2012,5,16,5,92,115,207,179
0132-000,2012,5,16,6,267,178,445,207
0132-000,2012,5,16,7,562,530,1092,445
0132-000,2012,5,16,8,803,1474,2277,1092
0132-000,2012,5,16,9,989,1415,2404,2277
0132-000,2012,5,16,10,955,1015,1970,2404
0132-000,2012,5,16,11,971,970,1941,1970
0132-000,2012,5,16,12,882,897,1779,1941
0132-000,2012,5,16,13,727,802,1529,1779
0132-000,2012,5,16,14,877,927,1804,1529
0132-000,2012,5,16,15,908,944,1852,1804
0132-000,2012,5,16,16,1192,1118,2310,1852
0132-000,2012,5,16,17,1024,838,1862,2310
0132-000,2012,5,16,18,1120,879,1999,1862
0132-000,2012,5,16,19,1232,888,2120,1999
0132-000,2012,5,16,20,954,730,1684,2120
0132-000,2012,5,16,21,683,557,1240,1684
0132-000,2012,5,16,22,585,522,1107,1240
0132-000,2012,5,16,23,389,376,765,1107
0132-000,2012,5,16,24,241,247,488,765
0132-000,2012,5,17,1,178,200,378,488
0132-000,2012,5,17,2,177,169,346,378
0132-000,2012,5,17,3,84,113,197,346
0132-000,2012,5,17,4,75,105,180,197
0132-000,2012,5,17,5,87,121,208,180
0132-000,2012,5,17,6,286,200,486,208
0132-000,2012,5,17,7,549,537,1086,486
0132-000,2012,5,17,8,752,1497,2249,1086
0132-000,2012,5,17,9,893,1402,2295,2249
0132-000,2012,5,17,10,862,1054,1916,2295
0132-000,2012,5,17,11,830,912,1742,1916
0132-000,2012,5,17,12,919,948,1867,1742
0132-000,2012,5,17,13,649,722,1371,1867
0132-000,2012,5,17,14,884,875,1759,1371
0132-000,2012,5,17,15,1031,954,1985,1759
0132-000,2012,5,17,16,991,847,1838,1985
0132-000,2012,5,17,17,1073,848,1921,1838
0132-000,2012,5,17,18,1236,885,2121,1921
0132-000,2012,5,17,19,1527,935,2462,2121
0132-000,2012,5,17,20,883,740,1623,2462
0132-000,2012,5,17,21,794,620,1414,1623
0132-000,2012,5,17,22,742,544,1286,1414
0132-000,2012,5,17,23,448,378,826,1286
0132-000,2012,5,17,24,249,265,514,826
0132-000,2012,5,18,1,175,205,380,514
0132-000,2012,5,18,2,152,153,305,380
0132-000,2012,5,18,3,89,105,194,305
0132-000,2012,5,18,4,92,125,217,194
0132-000,2012,5,18,5,94,112,206,217
0132-000,2012,5,18,6,321,219,540,206
0132-000,2012,5,18,7,531,513,1044,540
0132-000,2012,5,18,8,742,1413,2155,1044
0132-000,2012,5,18,9,944,1414,2358,2155
0132-000,2012,5,18,10,812,938,1750,2358
0132-000,2012,5,18,11,762,915,1677,1750
0132-000,2012,5,18,12,812,917,1729,1677
0132-000,2012,5,18,13,923,866,1789,1729
0132-000,2012,5,18,14,967,910,1877,1789
0132-000,2012,5,18,15,923,891,1814,1877
0132-000,2012,5,18,16,987,861,1848,1814
0132-000,2012,5,18,17,1125,847,1972,1848
0132-000,2012,5,18,18,1371,902,2273,1972
0132-000,2012,5,18,19,1473,988,2461,2273
0132-000,2012,5,18,20,1152,872,2024,2461
0132-000,2012,5,18,21,859,686,1545,2024
0132-000,2012,5,18,22,726,600,1326,1545
0132-000,2012,5,18,23,536,469,1005,1326
0132-000,2012,5,18,24,298,320,618,1005
0132-000,2012,5,19,1,246,258,504,618
0132-000,2012,5,19,2,157,160,317,504
0132-000,2012,5,19,3,107,145,252,317
0132-000,2012,5,19,4,96,106,202,252
0132-000,2012,5,19,5,100,135,235,202
0132-000,2012,5,19,6,206,196,402,235
0132-000,2012,5,19,7,388,391,779,402
0132-000,2012,5,19,8,482,867,1349,779
0132-000,2012,5,19,9,697,927,1624,1349
0132-000,2012,5,19,10,697,982,1679,1624
0132-000,2012,5,19,11,743,1303,2046,1679
0132-000,2012,5,19,12,815,1338,2153,2046
0132-000,2012,5,19,13,769,1212,1981,2153
0132-000,2012,5,19,14,841,1173,2014,1981
0132-000,2012,5,19,15,827,1036,1863,2014
0132-000,2012,5,19,16,943,885,1828,1863
0132-000,2012,5,19,17,1079,928,2007,1828
0132-000,2012,5,19,18,1282,1065,2347,2007
0132-000,2012,5,19,19,1045,924,1969,2347
0132-000,2012,5,19,20,733,692,1425,1969
0132-000,2012,5,19,21,620,618,1238,1425
0132-000,2012,5,19,22,512,498,1010,1238
0132-000,2012,5,19,23,322,413,735,1010
0132-000,2012,5,19,24,244,302,546,735
0132-000,2012,5,20,1,181,241,422,546
0132-000,2012,5,20,2,143,145,288,422
0132-000,2012,5,20,3,99,111,210,288
0132-000,2012,5,20,4,87,114,201,210
0132-000,2012,5,20,5,103,97,200,201
0132-000,2012,5,20,6,146,157,303,200
0132-000,2012,5,20,7,249,247,496,303
0132-000,2012,5,20,8,318,466,784,496
0132-000,2012,5,20,9,426,575,1001,784
0132-000,2012,5,20,10,454,581,1035,1001
0132-000,2012,5,20,11,542,679,1221,1035
0132-000,2012,5,20,12,532,672,1204,1221
0132-000,2012,5,20,13,633,603,1236,1204
0132-000,2012,5,20,14,709,586,1295,1236
0132-000,2012,5,20,15,733,676,1409,1295
0132-000,2012,5,20,16,866,685,1551,1409
0132-000,2012,5,20,17,921,675,1596,1551
0132-000,2012,5,20,18,972,719,1691,1596
0132-000,2012,5,20,19,813,701,1514,1691
0132-000,2012,5,20,20,753,594,1347,1514
0132-000,2012,5,20,21,618,547,1165,1347
0132-000,2012,5,20,22,545,543,1088,1165
0132-000,2012,5,20,23,336,381,717,1088
0132-000,2012,5,20,24,242,291,533,717
0132-000,2012,5,21,1,175,207,382,533
0132-000,2012,5,21,2,101,123,224,382
0132-000,2012,5,21,3,53,85,138,224
0132-000,2012,5,21,4,54,81,135,138
0132-000,2012,5,21,5,85,112,197,135
0132-000,2012,5,21,6,232,266,498,197
0132-000,2012,5,21,7,526,712,1238,498
0132-000,2012,5,21,8,859,1720,2579,1238
0132-000,2012,5,21,9,843,1446,2289,2579
0132-000,2012,5,21,10,909,1051,1960,2289
0132-000,2012,5,21,11,842,987,1829,1960
0132-000,2012,5,21,12,998,1030,2028,1829
0132-000,2012,5,21,13,901,952,1853,2028
0132-000,2012,5,21,14,784,887,1671,1853
0132-000,2012,5,21,15,962,956,1918,1671
0132-000,2012,5,21,16,999,912,1911,1918
0132-000,2012,5,21,17,1118,906,2024,1911
0132-000,2012,5,21,18,1127,893,2020,2024
0132-000,2012,5,21,19,1247,902,2149,2020
0132-000,2012,5,21,20,932,728,1660,2149
0132-000,2012,5,21,21,863,665,1528,1660
0132-000,2012,5,21,22,696,566,1262,1528
0132-000,2012,5,21,23,433,390,823,1262
0132-000,2012,5,21,24,220,239,459,823
0132-000,2012,5,22,1,182,176,358,459
0132-000,2012,5,22,2,113,130,243,358
0132-000,2012,5,22,3,69,105,174,243
0132-000,2012,5,22,4,71,110,181,174
0132-000,2012,5,22,5,89,146,235,181
0132-000,2012,5,22,6,308,229,537,235
0132-000,2012,5,22,7,585,578,1163,537
0132-000,2012,5,22,8,838,1508,2346,1163
0132-000,2012,5,22,9,965,1393,2358,2346
0132-000,2012,5,22,10,825,1012,1837,2358
0132-000,2012,5,22,11,836,923,1759,1837
0132-000,2012,5,22,12,980,947,1927,1759
0132-000,2012,5,22,13,810,846,1656,1927
0132-000,2012,5,22,14,747,846,1593,1656
0132-000,2012,5,22,15,938,971,1909,1593
0132-000,2012,5,22,16,1027,895,1922,1909
0132-000,2012,5,22,17,1083,890,1973,1922
0132-000,2012,5,22,18,1101,892,1993,1973
0132-000,2012,5,22,19,1256,894,2150,1993
0132-000,2012,5,22,20,977,786,1763,2150
0132-000,2012,5,22,21,861,597,1458,1763
0132-000,2012,5,22,22,584,495,1079,1458
0132-000,2012,5,22,23,389,362,751,1079
0132-000,2012,5,22,24,271,279,550,751
0132-000,2012,5,23,1,210,197,407,550
0132-000,2012,5,23,2,136,142,278,407
0132-000,2012,5,23,3,112,116,228,278
0132-000,2012,5,23,4,68,101,169,228
0132-000,2012,5,23,5,101,127,228,169
0132-000,2012,5,23,6,317,212,529,228
0132-000,2012,5,23,7,524,494,1018,529
0132-000,2012,5,23,8,809,1484,2293,1018
0132-000,2012,5,23,9,1014,1451,2465,2293
0132-000,2012,5,23,10,944,1003,1947,2465
0132-000,2012,5,23,11,1050,1049,2099,1947
0132-000,2012,5,23,12,1026,1044,2070,2099
0132-000,2012,5,23,13,800,883,1683,2070
0132-000,2012,5,23,14,851,900,1751,1683
0132-000,2012,5,23,15,926,963,1889,1751
0132-000,2012,5,23,16,919,862,1781,1889
0132-000,2012,5,23,17,1044,855,1899,1781
0132-000,2012,5,23,18,1142,896,2038,1899
0132-000,2012,5,23,19,1203,867,2070,2038
0132-000,2012,5,23,20,988,756,1744,2070
0132-000,2012,5,23,21,793,647,1440,1744
0132-000,2012,5,23,22,638,569,1207,1440
0132-000,2012,5,23,23,394,380,774,1207
0132-000,2012,5,23,24,270,276,546,774
0132-000,2012,5,24,1,191,215,406,546
0132-000,2012,5,24,2,168,160,328,406
0132-000,2012,5,24,3,96,130,226,328
0132-000,2012,5,24,4,92,130,222,226
0132-000,2012,5,24,5,92,128,220,222
0132-000,2012,5,24,6,289,202,491,220
0132-000,2012,5,24,7,543,531,1074,491
0132-000,2012,5,24,8,728,1448,2176,1074
0132-000,2012,5,24,9,902,1417,2319,2176
0132-000,2012,5,24,10,828,1013,1841,2319
0132-000,2012,5,24,11,886,973,1859,1841
0132-000,2012,5,24,12,866,894,1760,1859
0132-000,2012,5,24,13,827,920,1747,1760
0132-000,2012,5,24,14,919,909,1828,1747
0132-000,2012,5,24,15,995,921,1916,1828
0132-000,2012,5,24,16,1091,932,2023,1916
0132-000,2012,5,24,17,1049,829,1878,2023
0132-000,2012,5,24,18,1338,958,2296,1878
0132-000,2012,5,24,19,1467,898,2365,2296
0132-000,2012,5,24,20,831,696,1527,2365
0132-000,2012,5,24,21,777,607,1384,1527
0132-000,2012,5,24,22,773,567,1340,1384
0132-000,2012,5,24,23,423,357,780,1340
0132-000,2012,5,24,24,267,285,552,780
0132-000,2012,5,25,1,194,190,384,552
0132-000,2012,5,25,2,137,134,271,384
0132-000,2012,5,25,3,84,104,188,271
0132-000,2012,5,25,4,95,97,192,188
0132-000,2012,5,25,5,101,139,240,192
0132-000,2012,5,25,6,221,216,437,240
0132-000,2012,5,25,7,417,497,914,437
0132-000,2012,5,25,8,613,1433,2046,914
0132-000,2012,5,25,9,832,1331,2163,2046
0132-000,2012,5,25,10,780,1000,1780,2163
0132-000,2012,5,25,11,865,962,1827,1780
0132-000,2012,5,25,12,867,958,1825,1827
0132-000,2012,5,25,13,782,1051,1833,1825
0132-000,2012,5,25,14,731,954,1685,1833
0132-000,2012,5,25,15,813,986,1799,1685
0132-000,2012,5,25,16,856,963,1819,1799
0132-000,2012,5,25,17,962,993,1955,1819
0132-000,2012,5,25,18,1235,1142,2377,1955
0132-000,2012,5,25,19,1269,1348,2617,2377
0132-000,2012,5,25,20,1102,1307,2409,2617
0132-000,2012,5,25,21,953,1159,2112,2409
0132-000,2012,5,25,22,762,1030,1792,2112
0132-000,2012,5,25,23,514,839,1353,1792
0132-000,2012,5,25,24,343,619,962,1353
0132-000,2012,5,26,1,362,443,805,962
0132-000,2012,5,26,2,239,182,421,805
0132-000,2012,5,26,3,176,143,319,421
0132-000,2012,5,26,4,178,138,316,319
0132-000,2012,5,26,5,163,147,310,316
0132-000,2012,5,26,6,327,236,563,310
0132-000,2012,5,26,7,489,432,921,563
0132-000,2012,5,26,8,780,1021,1801,921
0132-000,2012,5,26,9,969,1516,2485,1801
0132-000,2012,5,26,10,925,1784,2709,2485
0132-000,2012,5,26,11,1192,1889,3081,2709
0132-000,2012,5,26,12,946,1784,2730,3081
0132-000,2012,5,26,13,691,1838,2529,2730
0132-000,2012,5,26,14,638,1808,2446,2529
0132-000,2012,5,26,15,619,1765,2384,2446
0132-000,2012,5,26,16,664,1814,2478,2384
0132-000,2012,5,26,17,691,1779,2470,2478
0132-000,2012,5,26,18,840,1906,2746,2470
0132-000,2012,5,26,19,763,1884,2647,2746
0132-000,2012,5,26,20,615,1827,2442,2647
0132-000,2012,5,26,21,489,1687,2176,2442
0132-000,2012,5,26,22,415,1141,1556,2176
0132-000,2012,5,26,23,314,664,978,1556
0132-000,2012,5,26,24,188,361,549,978
0132-000,2012,5,27,1,241,193,434,549
0132-000,2012,5,27,2,142,127,269,434
0132-000,2012,5,27,3,116,125,241,269
0132-000,2012,5,27,4,123,91,214,241
0132-000,2012,5,27,5,97,95,192,214
0132-000,2012,5,27,6,166,158,324,192
0132-000,2012,5,27,7,306,274,580,324
0132-000,2012,5,27,8,420,437,857,580
0132-000,2012,5,27,9,450,521,971,857
0132-000,2012,5,27,10,566,730,1296,971
0132-000,2012,5,27,11,686,885,1571,1296
0132-000,2012,5,27,12,664,889,1553,1571
0132-000,2012,5,27,13,782,952,1734,1553
0132-000,2012,5,27,14,780,981,1761,1734
0132-000,2012,5,27,15,837,947,1784,1761
0132-000,2012,5,27,16,907,956,1863,1784
0132-000,2012,5,27,17,1234,939,2173,1863
0132-000,2012,5,27,18,1378,889,2267,2173
0132-000,2012,5,27,19,1393,715,2108,2267
0132-000,2012,5,27,20,1354,581,1935,2108
0132-000,2012,5,27,21,1120,512,1632,1935
0132-000,2012,5,27,22,959,453,1412,1632
0132-000,2012,5,27,23,618,388,1006,1412
0132-000,2012,5,27,24,448,280,728,1006
0132-000,2012,5,28,1,330,199,529,728
0132-000,2012,5,28,2,169,146,315,529
0132-000,2012,5,28,3,107,110,217,315
0132-000,2012,5,28,4,81,101,182,217
0132-000,2012,5,28,5,86,93,179,182
0132-000,2012,5,28,6,186,191,377,179
0132-000,2012,5,28,7,356,356,712,377
0132-000,2012,5,28,8,481,695,1176,712
0132-000,2012,5,28,9,579,765,1344,1176
0132-000,2012,5,28,10,721,813,1534,1344
0132-000,2012,5,28,11,883,801,1684,1534
0132-000,2012,5,28,12,1232,810,2042,1684
0132-000,2012,5,28,13,1411,732,2143,2042
0132-000,2012,5,28,14,1651,781,2432,2143
0132-000,2012,5,28,15,1828,766,2594,2432
0132-000,2012,5,28,16,1865,678,2543,2594
0132-000,2012,5,28,17,2037,875,2912,2543
0132-000,2012,5,28,18,2178,908,3086,2912
0132-000,2012,5,28,19,1933,885,2818,3086
0132-000,2012,5,28,20,1415,781,2196,2818
0132-000,2012,5,28,21,867,642,1509,2196
0132-000,2012,5,28,22,736,555,1291,1509
0132-000,2012,5,28,23,431,411,842,1291
0132-000,2012,5,28,24,238,245,483,842
0132-000,2012,5,29,1,175,186,361,483
0132-000,2012,5,29,2,105,110,215,361
0132-000,2012,5,29,3,70,92,162,215
0132-000,2012,5,29,4,90,129,219,162
0132-000,2012,5,29,5,118,114,232,219
0132-000,2012,5,29,6,278,295,573,232
0132-000,2012,5,29,7,572,687,1259,573
0132-000,2012,5,29,8,760,1774,2534,1259
0132-000,2012,5,29,9,904,1544,2448,2534
0132-000,2012,5,29,10,874,1069,1943,2448
0132-000,2012,5,29,11,924,1004,1928,1943
0132-000,2012,5,29,12,963,1011,1974,1928
0132-000,2012,5,29,13,935,895,1830,1974
0132-000,2012,5,29,14,937,945,1882,1830
0132-000,2012,5,29,15,1029,1011,2040,1882
0132-000,2012,5,29,16,1083,926,2009,2040
0132-000,2012,5,29,17,1033,975,2008,2009
0132-000,2012,5,29,18,1256,865,2121,2008
0132-000,2012,5,29,19,1190,904,2094,2121
0132-000,2012,5,29,20,985,740,1725,2094
0132-000,2012,5,29,21,913,621,1534,1725
0132-000,2012,5,29,22,673,539,1212,1534
0132-000,2012,5,29,23,511,396,907,1212
0132-000,2012,5,29,24,306,255,561,907
0132-000,2012,5,30,1,171,194,365,561
0132-000,2012,5,30,2,142,132,274,365
0132-000,2012,5,30,3,90,135,225,274
0132-000,2012,5,30,4,92,116,208,225
0132-000,2012,5,30,5,123,137,260,208
0132-000,2012,5,30,6,228,212,440,260
0132-000,2012,5,30,7,481,494,975,440
0132-000,2012,5,30,8,717,1477,2194,975
0132-000,2012,5,30,9,896,1455,2351,2194
0132-000,2012,5,30,10,815,1009,1824,2351
0132-000,2012,5,30,11,902,913,1815,1824
0132-000,2012,5,30,12,1018,910,1928,1815
0132-000,2012,5,30,13,931,827,1758,1928
0132-000,2012,5,30,14,955,1015,1970,1758
0132-000,2012,5,30,15,1018,1123,2141,1970
0132-000,2012,5,30,16,1031,952,1983,2141
0132-000,2012,5,30,17,1103,923,2026,1983
0132-000,2012,5,30,18,1197,956,2153,2026
0132-000,2012,5,30,19,1236,945,2181,2153
0132-000,2012,5,30,20,946,710,1656,2181
0132-000,2012,5,30,21,784,531,1315,1656
0132-000,2012,5,30,22,693,508,1201,1315
0132-000,2012,5,30,23,424,358,782,1201
0132-000,2012,5,30,24,265,263,528,782
0132-000,2012,5,31,1,210,215,425,528
0132-000,2012,5,31,2,134,119,253,425
0132-000,2012,5,31,3,125,123,248,253
0132-000,2012,5,31,4,75,117,192,248
0132-000,2012,5,31,5,103,124,227,192
0132-000,2012,5,31,6,199,196,395,227
0132-000,2012,5,31,7,457,508,965,395
0132-000,2012,5,31,8,736,1560,2296,965
0132-000,2012,5,31,9,861,1458,2319,2296
0132-000,2012,5,31,10,843,887,1730,2319
0132-000,2012,5,31,11,922,969,1891,1730
0132-000,2012,5,31,12,904,968,1872,1891
0132-000,2012,5,31,13,845,901,1746,1872
0132-000,2012,5,31,14,920,991,1911,1746
0132-000,2012,5,31,15,1003,1045,2048,1911
0132-000,2012,5,31,16,1057,987,2044,2048
0132-000,2012,5,31,17,1094,976,2070,2044
0132-000,2012,5,31,18,1182,1036,2218,2070
0132-000,2012,5,31,19,1184,1011,2195,2218
0132-000,2012,5,31,20,983,772,1755,2195
0132-000,2012,5,31,21,893,604,1497,1755
0132-000,2012,5,31,22,708,538,1246,1497
0132-000,2012,5,31,23,551,359,910,1246
0132-000,2012,5,31,24,339,262,601,910
0132-000,2012,6,1,1,204,189,393,601
0132-000,2012,6,1,2,106,132,238,393
0132-000,2012,6,1,3,89,114,203,238
0132-000,2012,6,1,4,94,102,196,203
0132-000,2012,6,1,5,131,146,277,196
0132-000,2012,6,1,6,288,218,506,277
0132-000,2012,6,1,7,432,479,911,506
0132-000,2012,6,1,8,762,1501,2263,911
0132-000,2012,6,1,9,930,1354,2284,2263
0132-000,2012,6,1,10,815,993,1808,2284
0132-000,2012,6,1,11,853,967,1820,1808
0132-000,2012,6,1,12,858,928,1786,1820
0132-000,2012,6,1,13,811,857,1668,1786
0132-000,2012,6,1,14,1007,950,1957,1668
0132-000,2012,6,1,15,1048,991,2039,1957
0132-000,2012,6,1,16,1131,929,2060,2039
0132-000,2012,6,1,17,1050,906,1956,2060
0132-000,2012,6,1,18,1358,922,2280,1956
0132-000,2012,6,1,19,1495,941,2436,2280
0132-000,2012,6,1,20,1229,896,2125,2436
0132-000,2012,6,1,21,914,664,1578,2125
0132-000,2012,6,1,22,762,598,1360,1578
0132-000,2012,6,1,23,494,473,967,1360
0132-000,2012,6,1,24,297,292,589,967
0132-000,2012,6,2,1,244,241,485,589
0132-000,2012,6,2,2,165,189,354,485
0132-000,2012,6,2,3,104,133,237,354
0132-000,2012,6,2,4,111,130,241,237
0132-000,2012,6,2,5,126,158,284,241
0132-000,2012,6,2,6,250,226,476,284
0132-000,2012,6,2,7,429,410,839,476
0132-000,2012,6,2,8,548,839,1387,839
0132-000,2012,6,2,9,710,954,1664,1387
0132-000,2012,6,2,10,893,1056,1949,1664
0132-000,2012,6,2,11,1033,1283,2316,1949
0132-000,2012,6,2,12,1015,1425,2440,2316
0132-000,2012,6,2,13,1015,1362,2377,2440
0132-000,2012,6,2,14,1045,1247,2292,2377
0132-000,2012,6,2,15,1083,1244,2327,2292
0132-000,2012,6,2,16,1130,1141,2271,2327
0132-000,2012,6,2,17,1378,1238,2616,2271
0132-000,2012,6,2,18,1925,1321,3246,2616
0132-000,2012,6,2,19,1501,1188,2689,3246
0132-000,2012,6,2,20,1001,791,1792,2689
0132-000,2012,6,2,21,585,561,1146,1792
0132-000,2012,6,2,22,552,519,1071,1146
0132-000,2012,6,2,23,430,426,856,1071
0132-000,2012,6,2,24,296,309,605,856
0132-000,2012,6,3,1,215,229,444,605
0132-000,2012,6,3,2,159,173,332,444
0132-000,2012,6,3,3,112,132,244,332
0132-000,2012,6,3,4,89,97,186,244
0132-000,2012,6,3,5,108,113,221,186
0132-000,2012,6,3,6,151,157,308,221
0132-000,2012,6,3,7,250,274,524,308
0132-000,2012,6,3,8,293,385,678,524
0132-000,2012,6,3,9,418,521,939,678
0132-000,2012,6,3,10,552,603,1155,939
0132-000,2012,6,3,11,614,674,1288,1155
0132-000,2012,6,3,12,674,682,1356,1288
0132-000,2012,6,3,13,755,640,1395,1356
0132-000,2012,6,3,14,767,714,1481,1395
0132-000,2012,6,3,15,830,713,1543,1481
0132-000,2012,6,3,16,1177,725,1902,1543
0132-000,2012,6,3,17,1275,725,2000,1902
0132-000,2012,6,3,18,1298,690,1988,2000
0132-000,2012,6,3,19,1449,700,2149,1988
0132-000,2012,6,3,20,812,592,1404,2149
0132-000,2012,6,3,21,671,573,1244,1404
0132-000,2012,6,3,22,458,499,957,1244
0132-000,2012,6,3,23,354,397,751,957
0132-000,2012,6,3,24,202,250,452,751
0132-000,2012,6,4,1,210,217,427,452
0132-000,2012,6,4,2,79,103,182,427
0132-000,2012,6,4,3,83,125,208,182
0132-000,2012,6,4,4,73,99,172,208
0132-000,2012,6,4,5,129,147,276,172
0132-000,2012,6,4,6,258,286,544,276
0132-000,2012,6,4,7,592,708,1300,544
0132-000,2012,6,4,8,743,1749,2492,1300
0132-000,2012,6,4,9,848,1509,2357,2492
0132-000,2012,6,4,10,830,1022,1852,2357
0132-000,2012,6,4,11,948,1046,1994,1852
0132-000,2012,6,4,12,950,948,1898,1994
0132-000,2012,6,4,13,848,939,1787,1898
0132-000,2012,6,4,14,955,848,1803,1787
0132-000,2012,6,4,15,920,1024,1944,1803
0132-000,2012,6,4,16,1046,922,1968,1944
0132-000,2012,6,4,17,1081,904,1985,1968
0132-000,2012,6,4,18,1174,928,2102,1985
0132-000,2012,6,4,19,1175,937,2112,2102
0132-000,2012,6,4,20,974,752,1726,2112
0132-000,2012,6,4,21,902,677,1579,1726
0132-000,2012,6,4,22,717,562,1279,1579
0132-000,2012,6,4,23,472,389,861,1279
0132-000,2012,6,4,24,293,284,577,861
0132-000,2012,6,5,1,197,186,383,577
0132-000,2012,6,5,2,127,166,293,383
0132-000,2012,6,5,3,94,116,210,293
0132-000,2012,6,5,4,121,118,239,210
0132-000,2012,6,5,5,101,160,261,239
0132-000,2012,6,5,6,282,228,510,261
0132-000,2012,6,5,7,461,588,1049,510
0132-000,2012,6,5,8,771,1388,2159,1049
0132-000,2012,6,5,9,974,1352,2326,2159
0132-000,2012,6,5,10,904,970,1874,2326
0132-000,2012,6,5,11,909,1018,1927,1874
0132-000,2012,6,5,12,937,968,1905,1927
0132-000,2012,6,5,13,852,861,1713,1905
0132-000,2012,6,5,14,981,1031,2012,1713
0132-000,2012,6,5,15,1057,1033,2090,2012
0132-000,2012,6,5,16,1171,963,2134,2090
0132-000,2012,6,5,17,1123,963,2086,2134
0132-000,2012,6,5,18,1393,1007,2400,2086
0132-000,2012,6,5,19,1496,1048,2544,2400
0132-000,2012,6,5,20,1177,806,1983,2544
0132-000,2012,6,5,21,965,752,1717,1983
0132-000,2012,6,5,22,837,616,1453,1717
0132-000,2012,6,5,23,568,470,1038,1453
0132-000,2012,6,5,24,365,365,730,1038
0132-000,2012,6,6,1,265,313,578,730
0132-000,2012,6,6,2,190,230,420,578
0132-000,2012,6,6,3,136,177,313,420
0132-000,2012,6,6,4,149,171,320,313
0132-000,2012,6,6,5,121,160,281,320
0132-000,2012,6,6,6,223,247,470,281
0132-000,2012,6,6,7,372,496,868,470
0132-000,2012,6,6,8,575,829,1404,868
0132-000,2012,6,6,9,721,804,1525,1404
0132-000,2012,6,6,10,669,802,1471,1525
0132-000,2012,6,6,11,760,841,1601,1471
0132-000,2012,6,6,12,808,839,1647,1601
0132-000,2012,6,6,13,786,736,1522,1647
0132-000,2012,6,6,14,762,736,1498,1522
0132-000,2012,6,6,15,861,789,1650,1498
0132-000,2012,6,6,16,889,708,1597,1650
0132-000,2012,6,6,17,889,749,1638,1597
0132-000,2012,6,6,18,1036,767,1803,1638
0132-000,2012,6,6,19,970,758,1728,1803
0132-000,2012,6,6,20,782,614,1396,1728
0132-000,2012,6,6,21,662,588,1250,1396
0132-000,2012,6,6,22,531,520,1051,1250
0132-000,2012,6,6,23,398,391,789,1051
0132-000,2012,6,6,24,186,210,396,789
0132-000,2012,6,7,1,166,182,348,396
0132-000,2012,6,7,2,103,142,245,348
0132-000,2012,6,7,3,66,86,152,245
0132-000,2012,6,7,4,83,105,188,152
0132-000,2012,6,7,5,90,129,219,188
0132-000,2012,6,7,6,225,214,439,219
0132-000,2012,6,7,7,472,625,1097,439
0132-000,2012,6,7,8,789,1524,2313,1097
0132-000,2012,6,7,9,852,1426,2278,2313
0132-000,2012,6,7,10,876,983,1859,2278
0132-000,2012,6,7,11,834,974,1808,1859
0132-000,2012,6,7,12,889,926,1815,1808
0132-000,2012,6,7,13,830,900,1730,1815
0132-000,2012,6,7,14,965,1000,1965,1730
0132-000,2012,6,7,15,1048,957,2005,1965
0132-000,2012,6,7,16,1024,933,1957,2005
0132-000,2012,6,7,17,1201,883,2084,1957
0132-000,2012,6,7,18,1289,926,2215,2084
0132-000,2012,6,7,19,1282,900,2182,2215
0132-000,2012,6,7,20,1044,789,1833,2182
0132-000,2012,6,7,21,904,1210,2114,1833
0132-000,2012,6,7,22,743,1116,1859,2114
0132-000,2012,6,7,23,500,810,1310,1859
0132-000,2012,6,7,24,302,575,877,1310
0132-000,2012,6,8,1,221,194,415,877
0132-000,2012,6,8,2,112,134,246,415
0132-000,2012,6,8,3,75,97,172,246
0132-000,2012,6,8,4,92,105,197,172
0132-000,2012,6,8,5,138,155,293,197
0132-000,2012,6,8,6,276,200,476,293
0132-000,2012,6,8,7,419,467,886,476
0132-000,2012,6,8,8,799,1486,2285,886
0132-000,2012,6,8,9,957,1379,2336,2285
0132-000,2012,6,8,10,840,1020,1860,2336
0132-000,2012,6,8,11,896,1023,1919,1860
0132-000,2012,6,8,12,836,911,1747,1919
0132-000,2012,6,8,13,861,893,1754,1747
0132-000,2012,6,8,14,972,939,1911,1754
0132-000,2012,6,8,15,997,1003,2000,1911
0132-000,2012,6,8,16,1140,918,2058,2000
0132-000,2012,6,8,17,1044,900,1944,2058
0132-000,2012,6,8,18,1404,927,2331,1944
0132-000,2012,6,8,19,1458,947,2405,2331
0132-000,2012,6,8,20,1167,870,2037,2405
0132-000,2012,6,8,21,946,665,1611,2037
0132-000,2012,6,8,22,717,580,1297,1611
0132-000,2012,6,8,23,507,466,973,1297
0132-000,2012,6,8,24,295,282,577,973
0132-000,2012,6,9,1,259,229,488,577
0132-000,2012,6,9,2,159,187,346,488
0132-000,2012,6,9,3,101,127,228,346
0132-000,2012,6,9,4,95,124,219,228
0132-000,2012,6,9,5,138,163,301,219
0132-000,2012,6,9,6,224,201,425,301
0132-000,2012,6,9,7,468,396,864,425
0132-000,2012,6,9,8,515,803,1318,864
0132-000,2012,6,9,9,690,919,1609,1318
0132-000,2012,6,9,10,914,1063,1977,1609
0132-000,2012,6,9,11,1081,1287,2368,1977
0132-000,2012,6,9,12,1103,1404,2507,2368
0132-000,2012,6,9,13,1031,1293,2324,2507
0132-000,2012,6,9,14,987,1188,2175,2324
0132-000,2012,6,9,15,1016,1220,2236,2175
0132-000,2012,6,9,16,1094,1104,2198,2236
0132-000,2012,6,9,17,1450,1233,2683,2198
0132-000,2012,6,9,18,1916,1308,3224,2683
0132-000,2012,6,9,19,1540,1168,2708,3224
0132-000,2012,6,9,20,1098,765,1863,2708
0132-000,2012,6,9,21,641,574,1215,1863
0132-000,2012,6,9,22,564,514,1078,1215
0132-000,2012,6,9,23,422,435,857,1078
0132-000,2012,6,9,24,284,313,597,857
0132-000,2012,6,10,1,215,245,460,597
0132-000,2012,6,10,2,159,170,329,460
0132-000,2012,6,10,3,115,140,255,329
0132-000,2012,6,10,4,90,97,187,255
0132-000,2012,6,10,5,106,102,208,187
0132-000,2012,6,10,6,163,160,323,208
0132-000,2012,6,10,7,238,250,488,323
0132-000,2012,6,10,8,289,394,683,488
0132-000,2012,6,10,9,409,499,908,683
0132-000,2012,6,10,10,570,605,1175,908
0132-000,2012,6,10,11,659,686,1345,1175
0132-000,2012,6,10,12,681,713,1394,1345
0132-000,2012,6,10,13,753,659,1412,1394
0132-000,2012,6,10,14,812,772,1584,1412
0132-000,2012,6,10,15,882,742,1624,1584
0132-000,2012,6,10,16,1209,726,1935,1624
0132-000,2012,6,10,17,1280,711,1991,1935
0132-000,2012,6,10,18,1232,674,1906,1991
0132-000,2012,6,10,19,1490,702,2192,1906
0132-000,2012,6,10,20,697,560,1257,2192
0132-000,2012,6,10,21,638,581,1219,1257
0132-000,2012,6,10,22,488,500,988,1219
0132-000,2012,6,10,23,386,406,792,988
0132-000,2012,6,10,24,194,245,439,792
0132-000,2012,6,11,1,164,178,342,439
0132-000,2012,6,11,2,104,117,221,342
0132-000,2012,6,11,3,94,89,183,221
0132-000,2012,6,11,4,76,106,182,183
0132-000,2012,6,11,5,122,137,259,182
0132-000,2012,6,11,6,255,269,524,259
0132-000,2012,6,11,7,532,677,1209,524
0132-000,2012,6,11,8,800,1729,2529,1209
0132-000,2012,6,11,9,924,1545,2469,2529
0132-000,2012,6,11,10,789,1027,1816,2469
0132-000,2012,6,11,11,910,1023,1933,1816
0132-000,2012,6,11,12,895,918,1813,1933
0132-000,2012,6,11,13,799,871,1670,1813
0132-000,2012,6,11,14,897,940,1837,1670
0132-000,2012,6,11,15,996,977,1973,1837
0132-000,2012,6,11,16,937,877,1814,1973
0132-000,2012,6,11,17,1079,924,2003,1814
0132-000,2012,6,11,18,1274,916,2190,2003
0132-000,2012,6,11,19,1211,871,2082,2190
0132-000,2012,6,11,20,1000,774,1774,2082
0132-000,2012,6,11,21,794,593,1387,1774
0132-000,2012,6,11,22,603,488,1091,1387
0132-000,2012,6,11,23,344,314,658,1091
0132-000,2012,6,11,24,239,217,456,658
0132-000,2012,6,12,1,139,162,301,456
0132-000,2012,6,12,2,100,118,218,301
0132-000,2012,6,12,3,107,118,225,218
0132-000,2012,6,12,4,73,94,167,225
0132-000,2012,6,12,5,124,148,272,167
0132-000,2012,6,12,6,264,188,452,272
0132-000,2012,6,12,7,438,492,930,452
0132-000,2012,6,12,8,781,1579,2360,930
0132-000,2012,6,12,9,869,1380,2249,2360
0132-000,2012,6,12,10,836,1026,1862,2249
0132-000,2012,6,12,11,859,980,1839,1862
0132-000,2012,6,12,12,897,970,1867,1839
0132-000,2012,6,12,13,863,837,1700,1867
0132-000,2012,6,12,14,888,965,1853,1700
0132-000,2012,6,12,15,987,960,1947,1853
0132-000,2012,6,12,16,1097,990,2087,1947
0132-000,2012,6,12,17,1086,886,1972,2087
0132-000,2012,6,12,18,1312,876,2188,1972
0132-000,2012,6,12,19,1348,944,2292,2188
0132-000,2012,6,12,20,955,746,1701,2292
0132-000,2012,6,12,21,767,572,1339,1701
0132-000,2012,6,12,22,661,482,1143,1339
0132-000,2012,6,12,23,377,342,719,1143
0132-000,2012,6,12,24,275,257,532,719
0132-000,2012,6,13,1,163,175,338,532
0132-000,2012,6,13,2,129,137,266,338
0132-000,2012,6,13,3,83,119,202,266
0132-000,2012,6,13,4,77,89,166,202
0132-000,2012,6,13,5,147,133,280,166
0132-000,2012,6,13,6,254,228,482,280
0132-000,2012,6,13,7,418,492,910,482
0132-000,2012,6,13,8,728,1455,2183,910
0132-000,2012,6,13,9,907,1455,2362,2183
0132-000,2012,6,13,10,844,1046,1890,2362
0132-000,2012,6,13,11,994,1020,2014,1890
0132-000,2012,6,13,12,935,1021,1956,2014
0132-000,2012,6,13,13,757,854,1611,1956
0132-000,2012,6,13,14,877,900,1777,1611
0132-000,2012,6,13,15,1117,972,2089,1777
0132-000,2012,6,13,16,1054,898,1952,2089
0132-000,2012,6,13,17,1167,860,2027,1952
0132-000,2012,6,13,18,1371,993,2364,2027
0132-000,2012,6,13,19,1363,938,2301,2364
0132-000,2012,6,13,20,1117,777,1894,2301
0132-000,2012,6,13,21,773,574,1347,1894
0132-000,2012,6,13,22,686,505,1191,1347
0132-000,2012,6,13,23,437,408,845,1191
0132-000,2012,6,13,24,246,235,481,845
0132-000,2012,6,14,1,139,172,311,481
0132-000,2012,6,14,2,86,114,200,311
0132-000,2012,6,14,3,81,108,189,200
0132-000,2012,6,14,4,81,98,179,189
0132-000,2012,6,14,5,129,155,284,179
0132-000,2012,6,14,6,202,199,401,284
0132-000,2012,6,14,7,486,468,954,401
0132-000,2012,6,14,8,795,1519,2314,954
0132-000,2012,6,14,9,866,1461,2327,2314
0132-000,2012,6,14,10,797,967,1764,2327
0132-000,2012,6,14,11,926,994,1920,1764
0132-000,2012,6,14,12,870,893,1763,1920
0132-000,2012,6,14,13,851,907,1758,1763
0132-000,2012,6,14,14,852,927,1779,1758
0132-000,2012,6,14,15,1005,979,1984,1779
0132-000,2012,6,14,16,1039,901,1940,1984
0132-000,2012,6,14,17,985,838,1823,1940
0132-000,2012,6,14,18,1304,906,2210,1823
0132-000,2012,6,14,19,1210,863,2073,2210
0132-000,2012,6,14,20,1075,808,1883,2073
0132-000,2012,6,14,21,883,639,1522,1883
0132-000,2012,6,14,22,640,489,1129,1522
0132-000,2012,6,14,23,488,407,895,1129
0132-000,2012,6,14,24,331,272,603,895
0132-000,2012,6,15,1,187,184,371,603
0132-000,2012,6,15,2,100,129,229,371
0132-000,2012,6,15,3,103,130,233,229
0132-000,2012,6,15,4,96,98,194,233
0132-000,2012,6,15,5,123,137,260,194
0132-000,2012,6,15,6,300,235,535,260
0132-000,2012,6,15,7,444,490,934,535
0132-000,2012,6,15,8,725,1516,2241,934
0132-000,2012,6,15,9,902,1328,2230,2241
0132-000,2012,6,15,10,790,966,1756,2230
0132-000,2012,6,15,11,810,910,1720,1756
0132-000,2012,6,15,12,879,944,1823,1720
0132-000,2012,6,15,13,761,821,1582,1823
0132-000,2012,6,15,14,1042,960,2002,1582
0132-000,2012,6,15,15,1099,979,2078,2002
0132-000,2012,6,15,16,1122,939,2061,2078
0132-000,2012,6,15,17,1055,912,1967,2061
0132-000,2012,6,15,18,1311,916,2227,1967
0132-000,2012,6,15,19,1532,935,2467,2227
0132-000,2012,6,15,20,1291,922,2213,2467
0132-000,2012,6,15,21,882,663,1545,2213
0132-000,2012,6,15,22,806,615,1421,1545
0132-000,2012,6,15,23,481,479,960,1421
0132-000,2012,6,15,24,299,302,601,960
0132-000,2012,6,16,1,229,252,481,601
0132-000,2012,6,16,2,171,190,361,481
0132-000,2012,6,16,3,107,139,246,361
0132-000,2012,6,16,4,127,136,263,246
0132-000,2012,6,16,5,114,152,266,263
0132-000,2012,6,16,6,276,250,526,266
0132-000,2012,6,16,7,390,424,814,526
0132-000,2012,6,16,8,581,875,1456,814
0132-000,2012,6,16,9,730,988,1718,1456
0132-000,2012,6,16,10,872,1049,1921,1718
0132-000,2012,6,16,11,985,1278,2263,1921
0132-000,2012,6,16,12,926,1446,2372,2263
0132-000,2012,6,16,13,998,1431,2429,2372
0132-000,2012,6,16,14,1102,1306,2408,2429
0132-000,2012,6,16,15,1150,1268,2418,2408
0132-000,2012,6,16,16,1166,1177,2343,2418
0132-000,2012,6,16,17,1305,1242,2547,2343
0132-000,2012,6,16,18,1934,1333,3267,2547
0132-000,2012,6,16,19,1461,1207,2668,3267
0132-000,2012,6,16,20,903,816,1719,2668
0132-000,2012,6,16,21,529,547,1076,1719
0132-000,2012,6,16,22,539,524,1063,1076
0132-000,2012,6,16,23,437,417,854,1063
0132-000,2012,6,16,24,308,304,612,854
0132-000,2012,6,17,1,214,212,426,612
0132-000,2012,6,17,2,158,175,333,426
0132-000,2012,6,17,3,109,124,233,333
0132-000,2012,6,17,4,88,97,185,233
0132-000,2012,6,17,5,109,123,232,185
0132-000,2012,6,17,6,138,153,291,232
0132-000,2012,6,17,7,262,297,559,291
0132-000,2012,6,17,8,296,375,671,559
0132-000,2012,6,17,9,427,543,970,671
0132-000,2012,6,17,10,534,601,1135,970
0132-000,2012,6,17,11,569,662,1231,1135
0132-000,2012,6,17,12,666,650,1316,1231
0132-000,2012,6,17,13,757,620,1377,1316
0132-000,2012,6,17,14,721,655,1376,1377
0132-000,2012,6,17,15,778,684,1462,1376
0132-000,2012,6,17,16,1144,724,1868,1462
0132-000,2012,6,17,17,1270,738,2008,1868
0132-000,2012,6,17,18,1363,706,2069,2008
0132-000,2012,6,17,19,1407,698,2105,2069
0132-000,2012,6,17,20,927,623,1550,2105
0132-000,2012,6,17,21,704,565,1269,1550
0132-000,2012,6,17,22,427,498,925,1269
0132-000,2012,6,17,23,322,388,710,925
0132-000,2012,6,17,24,209,255,464,710
0132-000,2012,6,18,1,114,161,275,464
0132-000,2012,6,18,2,80,101,181,275
0132-000,2012,6,18,3,71,91,162,181
0132-000,2012,6,18,4,50,86,136,162
0132-000,2012,6,18,5,120,141,261,136
0132-000,2012,6,18,6,297,281,578,261
0132-000,2012,6,18,7,556,737,1293,578
0132-000,2012,6,18,8,776,1743,2519,1293
0132-000,2012,6,18,9,851,1484,2335,2519
0132-000,2012,6,18,10,812,962,1774,2335
0132-000,2012,6,18,11,821,938,1759,1774
0132-000,2012,6,18,12,890,1017,1907,1759
0132-000,2012,6,18,13,1041,1140,2181,1907
0132-000,2012,6,18,14,1126,1190,2316,2181
0132-000,2012,6,18,15,1137,1104,2241,2316
0132-000,2012,6,18,16,1059,1006,2065,2241
0132-000,2012,6,18,17,1015,891,1906,2065
0132-000,2012,6,18,18,1267,914,2181,1906
0132-000,2012,6,18,19,1192,883,2075,2181
0132-000,2012,6,18,20,884,701,1585,2075
0132-000,2012,6,18,21,792,584,1376,1585
0132-000,2012,6,18,22,769,538,1307,1376
0132-000,2012,6,18,23,391,379,770,1307
0132-000,2012,6,18,24,254,222,476,770
0132-000,2012,6,19,1,166,171,337,476
0132-000,2012,6,19,2,95,102,197,337
0132-000,2012,6,19,3,68,98,166,197
0132-000,2012,6,19,4,77,106,183,166
0132-000,2012,6,19,5,138,130,268,183
0132-000,2012,6,19,6,233,212,445,268
0132-000,2012,6,19,7,491,538,1029,445
0132-000,2012,6,19,8,769,1567,2336,1029
0132-000,2012,6,19,9,802,1349,2151,2336
0132-000,2012,6,19,10,852,1029,1881,2151
0132-000,2012,6,19,11,916,1015,1931,1881
0132-000,2012,6,19,12,961,961,1922,1931
0132-000,2012,6,19,13,853,889,1742,1922
0132-000,2012,6,19,14,898,934,1832,1742
0132-000,2012,6,19,15,986,966,1952,1832
0132-000,2012,6,19,16,1012,939,1951,1952
0132-000,2012,6,19,17,1041,890,1931,1951
0132-000,2012,6,19,18,1320,917,2237,1931
0132-000,2012,6,19,19,1239,862,2101,2237
0132-000,2012,6,19,20,876,702,1578,2101
0132-000,2012,6,19,21,759,614,1373,1578
0132-000,2012,6,19,22,714,505,1219,1373
0132-000,2012,6,19,23,520,416,936,1219
0132-000,2012,6,19,24,300,262,562,936
0132-000,2012,6,20,1,174,165,339,562
0132-000,2012,6,20,2,136,154,290,339
0132-000,2012,6,20,3,68,93,161,290
0132-000,2012,6,20,4,100,110,210,161
0132-000,2012,6,20,5,123,140,263,210
0132-000,2012,6,20,6,318,219,537,263
0132-000,2012,6,20,7,466,508,974,537
0132-000,2012,6,20,8,799,1549,2348,974
0132-000,2012,6,20,9,840,1338,2178,2348
0132-000,2012,6,20,10,762,951,1713,2178
0132-000,2012,6,20,11,888,987,1875,1713
0132-000,2012,6,20,12,877,935,1812,1875
0132-000,2012,6,20,13,836,901,1737,1812
0132-000,2012,6,20,14,836,938,1774,1737
0132-000,2012,6,20,15,1074,1015,2089,1774
0132-000,2012,6,20,16,1043,948,1991,2089
0132-000,2012,6,20,17,1273,980,2253,1991
0132-000,2012,6,20,18,1487,874,2361,2253
0132-000,2012,6,20,19,1359,905,2264,2361
0132-000,2012,6,20,20,995,720,1715,2264
0132-000,2012,6,20,21,804,577,1381,1715
0132-000,2012,6,20,22,700,539,1239,1381
0132-000,2012,6,20,23,446,394,840,1239
0132-000,2012,6,20,24,219,246,465,840
0132-000,2012,6,21,1,206,176,382,465
0132-000,2012,6,21,2,128,153,281,382
0132-000,2012,6,21,3,65,90,155,281
0132-000,2012,6,21,4,82,95,177,155
0132-000,2012,6,21,5,141,150,291,177
0132-000,2012,6,21,6,259,222,481,291
0132-000,2012,6,21,7,469,528,997,481
0132-000,2012,6,21,8,771,1541,2312,997
0132-000,2012,6,21,9,905,1418,2323,2312
0132-000,2012,6,21,10,828,980,1808,2323
0132-000,2012,6,21,11,851,990,1841,1808
0132-000,2012,6,21,12,863,894,1757,1841
0132-000,2012,6,21,13,898,886,1784,1757
0132-000,2012,6,21,14,957,959,1916,1784
0132-000,2012,6,21,15,1061,957,2018,1916
0132-000,2012,6,21,16,1127,991,2118,2018
0132-000,2012,6,21,17,1013,916,1929,2118
0132-000,2012,6,21,18,1161,864,2025,1929
0132-000,2012,6,21,19,1272,868,2140,2025
0132-000,2012,6,21,20,981,727,1708,2140
0132-000,2012,6,21,21,711,561,1272,1708
0132-000,2012,6,21,22,746,556,1302,1272
0132-000,2012,6,21,23,555,408,963,1302
0132-000,2012,6,21,24,229,250,479,963
0132-000,2012,6,22,1,234,197,431,479
0132-000,2012,6,22,2,135,132,267,431
0132-000,2012,6,22,3,98,120,218,267
0132-000,2012,6,22,4,76,100,176,218
0132-000,2012,6,22,5,115,154,269,176
0132-000,2012,6,22,6,286,216,502,269
0132-000,2012,6,22,7,481,522,1003,502
0132-000,2012,6,22,8,797,1546,2343,1003
0132-000,2012,6,22,9,796,1282,2078,2343
0132-000,2012,6,22,10,793,1004,1797,2078
0132-000,2012,6,22,11,837,952,1789,1797
0132-000,2012,6,22,12,867,926,1793,1789
0132-000,2012,6,22,13,817,825,1642,1793
0132-000,2012,6,22,14,1034,936,1970,1642
0132-000,2012,6,22,15,967,930,1897,1970
0132-000,2012,6,22,16,1091,905,1996,1897
0132-000,2012,6,22,17,1207,979,2186,1996
0132-000,2012,6,22,18,1515,1009,2524,2186
0132-000,2012,6,22,19,1946,1271,3217,2524
0132-000,2012,6,22,20,1475,1101,2576,3217
0132-000,2012,6,22,21,908,794,1702,2576
0132-000,2012,6,22,22,725,577,1302,1702
0132-000,2012,6,22,23,459,455,914,1302
0132-000,2012,6,22,24,351,313,664,914
0132-000,2012,6,23,1,241,278,519,664
0132-000,2012,6,23,2,190,206,396,519
0132-000,2012,6,23,3,124,130,254,396
0132-000,2012,6,23,4,103,125,228,254
0132-000,2012,6,23,5,123,139,262,228
0132-000,2012,6,23,6,242,213,455,262
0132-000,2012,6,23,7,342,371,713,455
0132-000,2012,6,23,8,533,761,1294,713
0132-000,2012,6,23,9,709,882,1591,1294
0132-000,2012,6,23,10,793,955,1748,1591
0132-000,2012,6,23,11,911,1095,2006,1748
0132-000,2012,6,23,12,983,1257,2240,2006
0132-000,2012,6,23,13,968,1235,2203,2240
0132-000,2012,6,23,14,1050,1168,2218,2203
0132-000,2012,6,23,15,1045,1214,2259,2218
0132-000,2012,6,23,16,1083,1171,2254,2259
0132-000,2012,6,23,17,1246,1227,2473,2254
0132-000,2012,6,23,18,1656,1206,2862,2473
0132-000,2012,6,23,19,1338,1094,2432,2862
0132-000,2012,6,23,20,821,759,1580,2432
0132-000,2012,6,23,21,574,558,1132,1580
0132-000,2012,6,23,22,536,518,1054,1132
0132-000,2012,6,23,23,417,427,844,1054
0132-000,2012,6,23,24,292,314,606,844
0132-000,2012,6,24,1,265,265,530,606
0132-000,2012,6,24,2,208,173,381,530
0132-000,2012,6,24,3,131,153,284,381
0132-000,2012,6,24,4,94,110,204,284
0132-000,2012,6,24,5,114,127,241,204
0132-000,2012,6,24,6,153,173,326,241
0132-000,2012,6,24,7,295,280,575,326
0132-000,2012,6,24,8,391,457,848,575
0132-000,2012,6,24,9,496,572,1068,848
0132-000,2012,6,24,10,566,645,1211,1068
0132-000,2012,6,24,11,706,752,1458,1211
0132-000,2012,6,24,12,747,728,1475,1458
0132-000,2012,6,24,13,813,697,1510,1475
0132-000,2012,6,24,14,810,756,1566,1510
0132-000,2012,6,24,15,826,800,1626,1566
0132-000,2012,6,24,16,1110,690,1800,1626
0132-000,2012,6,24,17,1337,795,2132,1800
0132-000,2012,6,24,18,1404,803,2207,2132
0132-000,2012,6,24,19,1403,682,2085,2207
0132-000,2012,6,24,20,1072,623,1695,2085
0132-000,2012,6,24,21,1000,568,1568,1695
0132-000,2012,6,24,22,695,540,1235,1568
0132-000,2012,6,24,23,428,524,952,1235
0132-000,2012,6,24,24,269,311,580,952
0132-000,2012,6,25,1,175,177,352,580
0132-000,2012,6,25,2,88,145,233,352
0132-000,2012,6,25,3,103,88,191,233
0132-000,2012,6,25,4,79,107,186,191
0132-000,2012,6,25,5,121,182,303,186
0132-000,2012,6,25,6,284,308,592,303
0132-000,2012,6,25,7,529,769,1298,592
0132-000,2012,6,25,8,741,1660,2401,1298
0132-000,2012,6,25,9,874,1409,2283,2401
0132-000,2012,6,25,10,872,872,1744,2283
0132-000,2012,6,25,11,837,965,1802,1744
0132-000,2012,6,25,12,904,1066,1970,1802
0132-000,2012,6,25,13,861,983,1844,1970
0132-000,2012,6,25,14,972,1038,2010,1844
0132-000,2012,6,25,15,961,1024,1985,2010
0132-000,2012,6,25,16,1077,1033,2110,1985
0132-000,2012,6,25,17,1035,917,1952,2110
0132-000,2012,6,25,18,1127,898,2025,1952
0132-000,2012,6,25,19,1276,939,2215,2025
0132-000,2012,6,25,20,963,795,1758,2215
0132-000,2012,6,25,21,863,655,1518,1758
0132-000,2012,6,25,22,640,531,1171,1518
0132-000,2012,6,25,23,446,428,874,1171
0132-000,2012,6,25,24,243,236,479,874
0132-000,2012,6,26,1,177,177,354,479
0132-000,2012,6,26,2,101,97,198,354
0132-000,2012,6,26,3,94,136,230,198
0132-000,2012,6,26,4,97,110,207,230
0132-000,2012,6,26,5,110,190,300,207
0132-000,2012,6,26,6,289,247,536,300
0132-000,2012,6,26,7,472,599,1071,536
0132-000,2012,6,26,8,712,1424,2136,1071
0132-000,2012,6,26,9,935,1232,2167,2136
0132-000,2012,6,26,10,869,907,1776,2167
0132-000,2012,6,26,11,854,937,1791,1776
0132-000,2012,6,26,12,944,944,1888,1791
0132-000,2012,6,26,13,876,883,1759,1888
0132-000,2012,6,26,14,970,965,1935,1759
0132-000,2012,6,26,15,1020,948,1968,1935
0132-000,2012,6,26,16,1009,961,1970,1968
0132-000,2012,6,26,17,1094,935,2029,1970
0132-000,2012,6,26,18,1193,955,2148,2029
0132-000,2012,6,26,19,1226,902,2128,2148
0132-000,2012,6,26,20,1009,773,1782,2128
0132-000,2012,6,26,21,885,629,1514,1782
0132-000,2012,6,26,22,736,538,1274,1514
0132-000,2012,6,26,23,448,466,914,1274
0132-000,2012,6,26,24,328,319,647,914
0132-000,2012,6,27,1,247,208,455,647
0132-000,2012,6,27,2,112,182,294,455
0132-000,2012,6,27,3,112,114,226,294
0132-000,2012,6,27,4,92,116,208,226
0132-000,2012,6,27,5,125,177,302,208
0132-000,2012,6,27,6,254,265,519,302
0132-000,2012,6,27,7,446,572,1018,519
0132-000,2012,6,27,8,708,1407,2115,1018
0132-000,2012,6,27,9,889,1297,2186,2115
0132-000,2012,6,27,10,876,972,1848,2186
0132-000,2012,6,27,11,948,998,1946,1848
0132-000,2012,6,27,12,878,1127,2005,1946
0132-000,2012,6,27,13,830,1070,1900,2005
0132-000,2012,6,27,14,907,983,1890,1900
0132-000,2012,6,27,15,1022,981,2003,1890
0132-000,2012,6,27,16,1046,911,1957,2003
0132-000,2012,6,27,17,1038,817,1855,1957
0132-000,2012,6,27,18,1267,924,2191,1855
0132-000,2012,6,27,19,1273,869,2142,2191
0132-000,2012,6,27,20,955,725,1680,2142
0132-000,2012,6,27,21,863,640,1503,1680
0132-000,2012,6,27,22,618,544,1162,1503
0132-000,2012,6,27,23,448,415,863,1162
0132-000,2012,6,27,24,289,276,565,863
0132-000,2012,6,28,1,190,221,411,565
0132-000,2012,6,28,2,127,164,291,411
0132-000,2012,6,28,3,101,134,235,291
0132-000,2012,6,28,4,118,131,249,235
0132-000,2012,6,28,5,151,199,350,249
0132-000,2012,6,28,6,265,273,538,350
0132-000,2012,6,28,7,444,590,1034,538
0132-000,2012,6,28,8,773,1412,2185,1034
0132-000,2012,6,28,9,941,1275,2216,2185
0132-000,2012,6,28,10,1068,917,1985,2216
0132-000,2012,6,28,11,1260,902,2162,1985
0132-000,2012,6,28,12,1256,878,2134,2162
0132-000,2012,6,28,13,830,830,1660,2134
0132-000,2012,6,28,14,885,911,1796,1660
0132-000,2012,6,28,15,952,922,1874,1796
0132-000,2012,6,28,16,1024,880,1904,1874
0132-000,2012,6,28,17,1048,904,1952,1904
0132-000,2012,6,28,18,1493,828,2321,1952
0132-000,2012,6,28,19,1127,861,1988,2321
0132-000,2012,6,28,20,948,762,1710,1988
0132-000,2012,6,28,21,939,586,1525,1710
0132-000,2012,6,28,22,640,583,1223,1525
0132-000,2012,6,28,23,446,435,881,1223
0132-000,2012,6,28,24,293,324,617,881
0132-000,2012,6,29,1,238,267,505,617
0132-000,2012,6,29,2,140,127,267,505
0132-000,2012,6,29,3,134,138,272,267
0132-000,2012,6,29,4,77,138,215,272
0132-000,2012,6,29,5,147,180,327,215
0132-000,2012,6,29,6,262,267,529,327
0132-000,2012,6,29,7,466,540,1006,529
0132-000,2012,6,29,8,765,1335,2100,1006
0132-000,2012,6,29,9,861,1251,2112,2100
0132-000,2012,6,29,10,824,911,1735,2112
0132-000,2012,6,29,11,893,987,1880,1735
0132-000,2012,6,29,12,909,891,1800,1880
0132-000,2012,6,29,13,926,876,1802,1800
0132-000,2012,6,29,14,922,924,1846,1802
0132-000,2012,6,29,15,1029,920,1949,1846
0132-000,2012,6,29,16,1033,917,1950,1949
0132-000,2012,6,29,17,1018,915,1933,1950
0132-000,2012,6,29,18,1258,961,2219,1933
0132-000,2012,6,29,19,1510,1024,2534,2219
0132-000,2012,6,29,20,1144,900,2044,2534
0132-000,2012,6,29,21,937,754,1691,2044
0132-000,2012,6,29,22,714,607,1321,1691
0132-000,2012,6,29,23,568,485,1053,1321
0132-000,2012,6,29,24,378,345,723,1053
0132-000,2012,6,30,1,252,304,556,723
0132-000,2012,6,30,2,208,221,429,556
0132-000,2012,6,30,3,140,121,261,429
0132-000,2012,6,30,4,79,114,193,261
0132-000,2012,6,30,5,131,125,256,193
0132-000,2012,6,30,6,208,175,383,256
0132-000,2012,6,30,7,293,317,610,383
0132-000,2012,6,30,8,485,647,1132,610
0132-000,2012,6,30,9,688,776,1464,1132
0132-000,2012,6,30,10,714,861,1575,1464
0132-000,2012,6,30,11,837,911,1748,1575
0132-000,2012,6,30,12,1040,1068,2108,1748
0132-000,2012,6,30,13,937,1038,1975,2108
0132-000,2012,6,30,14,998,1029,2027,1975
0132-000,2012,6,30,15,939,1160,2099,2027
0132-000,2012,6,30,16,1000,1164,2164,2099
0132-000,2012,6,30,17,1186,1211,2397,2164
0132-000,2012,6,30,18,1377,1079,2456,2397
0132-000,2012,6,30,19,1214,981,2195,2456
0132-000,2012,6,30,20,738,701,1439,2195
0132-000,2012,6,30,21,618,568,1186,1439
0132-000,2012,6,30,22,533,511,1044,1186
0132-000,2012,6,30,23,396,437,833,1044
0132-000,2012,6,30,24,276,324,600,833
0132-000,2012,7,1,1,192,256,448,600
0132-000,2012,7,1,2,201,178,379,448
0132-000,2012,7,1,3,135,151,286,379
0132-000,2012,7,1,4,142,108,250,286
0132-000,2012,7,1,5,131,117,248,250
0132-000,2012,7,1,6,169,201,370,248
0132-000,2012,7,1,7,247,331,578,370
0132-000,2012,7,1,8,315,450,765,578
0132-000,2012,7,1,9,487,578,1065,765
0132-000,2012,7,1,10,550,731,1281,1065
0132-000,2012,7,1,11,658,767,1425,1281
0132-000,2012,7,1,12,838,753,1591,1425
0132-000,2012,7,1,13,799,703,1502,1591
0132-000,2012,7,1,14,856,845,1701,1502
0132-000,2012,7,1,15,977,783,1760,1701
0132-000,2012,7,1,16,1000,833,1833,1760
0132-000,2012,7,1,17,1212,749,1961,1833
0132-000,2012,7,1,18,1289,765,2054,1961
0132-000,2012,7,1,19,1178,708,1886,2054
0132-000,2012,7,1,20,895,623,1518,1886
0132-000,2012,7,1,21,715,610,1325,1518
0132-000,2012,7,1,22,603,601,1204,1325
0132-000,2012,7,1,23,393,475,868,1204
0132-000,2012,7,1,24,281,311,592,868
0132-000,2012,7,2,1,208,210,418,592
0132-000,2012,7,2,2,128,153,281,418
0132-000,2012,7,2,3,71,87,158,281
0132-000,2012,7,2,4,99,108,207,158
0132-000,2012,7,2,5,131,169,300,207
0132-000,2012,7,2,6,277,338,615,300
0132-000,2012,7,2,7,532,769,1301,615
0132-000,2012,7,2,8,779,1772,2551,1301
0132-000,2012,7,2,9,906,1370,2276,2551
0132-000,2012,7,2,10,909,986,1895,2276
0132-000,2012,7,2,11,831,922,1753,1895
0132-000,2012,7,2,12,915,943,1858,1753
0132-000,2012,7,2,13,877,950,1827,1858
0132-000,2012,7,2,14,945,1027,1972,1827
0132-000,2012,7,2,15,998,1032,2030,1972
0132-000,2012,7,2,16,998,995,1993,2030
0132-000,2012,7,2,17,1023,959,1982,1993
0132-000,2012,7,2,18,1103,979,2082,1982
0132-000,2012,7,2,19,1280,945,2225,2082
0132-000,2012,7,2,20,959,840,1799,2225
0132-000,2012,7,2,21,906,635,1541,1799
0132-000,2012,7,2,22,710,498,1208,1541
0132-000,2012,7,2,23,455,423,878,1208
0132-000,2012,7,2,24,265,249,514,878
0132-000,2012,7,3,1,185,213,398,514
0132-000,2012,7,3,2,133,112,245,398
0132-000,2012,7,3,3,101,115,216,245
0132-000,2012,7,3,4,108,112,220,216
0132-000,2012,7,3,5,149,201,350,220
0132-000,2012,7,3,6,224,270,494,350
0132-000,2012,7,3,7,475,612,1087,494
0132-000,2012,7,3,8,699,1530,2229,1087
0132-000,2012,7,3,9,934,1228,2162,2229
0132-000,2012,7,3,10,890,991,1881,2162
0132-000,2012,7,3,11,888,1009,1897,1881
0132-000,2012,7,3,12,920,925,1845,1897
0132-000,2012,7,3,13,879,920,1799,1845
0132-000,2012,7,3,14,1011,1061,2072,1799
0132-000,2012,7,3,15,1055,1046,2101,2072
0132-000,2012,7,3,16,1132,922,2054,2101
0132-000,2012,7,3,17,973,920,1893,2054
0132-000,2012,7,3,18,1208,929,2137,1893
0132-000,2012,7,3,19,1199,952,2151,2137
0132-000,2012,7,3,20,977,792,1769,2151
0132-000,2012,7,3,21,902,603,1505,1769
0132-000,2012,7,3,22,728,512,1240,1505
0132-000,2012,7,3,23,448,393,841,1240
0132-000,2012,7,3,24,281,247,528,841
0132-000,2012,7,4,1,229,204,433,528
0132-000,2012,7,4,2,165,149,314,433
0132-000,2012,7,4,3,103,153,256,314
0132-000,2012,7,4,4,99,99,198,256
0132-000,2012,7,4,5,147,181,328,198
0132-000,2012,7,4,6,274,295,569,328
0132-000,2012,7,4,7,484,628,1112,569
0132-000,2012,7,4,8,776,1402,2178,1112
0132-000,2012,7,4,9,895,1303,2198,2178
0132-000,2012,7,4,10,897,988,1885,2198
0132-000,2012,7,4,11,945,1020,1965,1885
0132-000,2012,7,4,12,899,927,1826,1965
0132-000,2012,7,4,13,854,904,1758,1826
0132-000,2012,7,4,14,961,982,1943,1758
0132-000,2012,7,4,15,1027,1075,2102,1943
0132-000,2012,7,4,16,984,968,1952,2102
0132-000,2012,7,4,17,1114,918,2032,1952
0132-000,2012,7,4,18,1235,1046,2281,2032
0132-000,2012,7,4,19,1316,1239,2555,2281
0132-000,2012,7,4,20,1030,836,1866,2555
0132-000,2012,7,4,21,854,642,1496,1866
0132-000,2012,7,4,22,628,521,1149,1496
0132-000,2012,7,4,23,432,464,896,1149
0132-000,2012,7,4,24,279,331,610,896
0132-000,2012,7,5,1,192,261,453,610
0132-000,2012,7,5,2,151,135,286,453
0132-000,2012,7,5,3,89,128,217,286
0132-000,2012,7,5,4,117,112,229,217
0132-000,2012,7,5,5,128,119,247,229
0132-000,2012,7,5,6,229,242,471,247
0132-000,2012,7,5,7,448,512,960,471
0132-000,2012,7,5,8,769,1422,2191,960
0132-000,2012,7,5,9,888,1303,2191,2191
0132-000,2012,7,5,10,840,982,1822,2191
0132-000,2012,7,5,11,906,936,1842,1822
0132-000,2012,7,5,12,909,945,1854,1842
0132-000,2012,7,5,13,881,776,1657,1854
0132-000,2012,7,5,14,884,954,1838,1657
0132-000,2012,7,5,15,952,973,1925,1838
0132-000,2012,7,5,16,1000,874,1874,1925
0132-000,2012,7,5,17,1039,849,1888,1874
0132-000,2012,7,5,18,1205,886,2091,1888
0132-000,2012,7,5,19,1214,852,2066,2091
0132-000,2012,7,5,20,1011,769,1780,2066
0132-000,2012,7,5,21,829,623,1452,1780
0132-000,2012,7,5,22,653,509,1162,1452
0132-000,2012,7,5,23,432,388,820,1162
0132-000,2012,7,5,24,286,299,585,820
0132-000,2012,7,6,1,199,206,405,585
0132-000,2012,7,6,2,151,165,316,405
0132-000,2012,7,6,3,115,103,218,316
0132-000,2012,7,6,4,74,101,175,218
0132-000,2012,7,6,5,103,115,218,175
0132-000,2012,7,6,6,151,149,300,218
0132-000,2012,7,6,7,407,459,866,300
0132-000,2012,7,6,8,658,1187,1845,866
0132-000,2012,7,6,9,849,1296,2145,1845
0132-000,2012,7,6,10,774,922,1696,2145
0132-000,2012,7,6,11,854,886,1740,1696
0132-000,2012,7,6,12,820,995,1815,1740
0132-000,2012,7,6,13,911,897,1808,1815
0132-000,2012,7,6,14,941,842,1783,1808
0132-000,2012,7,6,15,1046,986,2032,1783
0132-000,2012,7,6,16,1009,906,1915,2032
0132-000,2012,7,6,17,977,929,1906,1915
0132-000,2012,7,6,18,1267,904,2171,1906
0132-000,2012,7,6,19,1510,934,2444,2171
0132-000,2012,7,6,20,1046,927,1973,2444
0132-000,2012,7,6,21,927,751,1678,1973
0132-000,2012,7,6,22,662,580,1242,1678
0132-000,2012,7,6,23,459,487,946,1242
0132-000,2012,7,6,24,315,322,637,946
0132-000,2012,7,7,1,267,265,532,637
0132-000,2012,7,7,2,201,178,379,532
0132-000,2012,7,7,3,140,194,334,379
0132-000,2012,7,7,4,119,142,261,334
0132-000,2012,7,7,5,142,167,309,261
0132-000,2012,7,7,6,224,258,482,309
0132-000,2012,7,7,7,366,432,798,482
0132-000,2012,7,7,8,591,858,1449,798
0132-000,2012,7,7,9,792,963,1755,1449
0132-000,2012,7,7,10,893,1007,1900,1755
0132-000,2012,7,7,11,941,1071,2012,1900
0132-000,2012,7,7,12,1009,1169,2178,2012
0132-000,2012,7,7,13,938,1164,2102,2178
0132-000,2012,7,7,14,988,1221,2209,2102
0132-000,2012,7,7,15,1025,1180,2205,2209
0132-000,2012,7,7,16,1046,1096,2142,2205
0132-000,2012,7,7,17,1185,1052,2237,2142
0132-000,2012,7,7,18,1497,1084,2581,2237
0132-000,2012,7,7,19,1303,1011,2314,2581
0132-000,2012,7,7,20,936,824,1760,2314
0132-000,2012,7,7,21,799,637,1436,1760
0132-000,2012,7,7,22,678,603,1281,1436
0132-000,2012,7,7,23,475,525,1000,1281
0132-000,2012,7,7,24,286,347,633,1000
0132-000,2012,7,8,1,201,272,473,633
0132-000,2012,7,8,2,178,174,352,473
0132-000,2012,7,8,3,133,144,277,352
0132-000,2012,7,8,4,126,103,229,277
0132-000,2012,7,8,5,115,115,230,229
0132-000,2012,7,8,6,158,181,339,230
0132-000,2012,7,8,7,242,283,525,339
0132-000,2012,7,8,8,302,516,818,525
0132-000,2012,7,8,9,455,603,1058,818
0132-000,2012,7,8,10,521,653,1174,1058
0132-000,2012,7,8,11,637,737,1374,1174
0132-000,2012,7,8,12,731,728,1459,1374
0132-000,2012,7,8,13,808,683,1491,1459
0132-000,2012,7,8,14,801,804,1605,1491
0132-000,2012,7,8,15,902,774,1676,1605
0132-000,2012,7,8,16,1073,806,1879,1676
0132-000,2012,7,8,17,1292,790,2082,1879
0132-000,2012,7,8,18,1457,774,2231,2082
0132-000,2012,7,8,19,1351,722,2073,2231
0132-000,2012,7,8,20,913,630,1543,2073
0132-000,2012,7,8,21,767,591,1358,1543
0132-000,2012,7,8,22,589,596,1185,1358
0132-000,2012,7,8,23,400,443,843,1185
0132-000,2012,7,8,24,277,320,597,843
0132-000,2012,7,9,1,206,222,428,597
0132-000,2012,7,9,2,121,149,270,428
0132-000,2012,7,9,3,83,87,170,270
0132-000,2012,7,9,4,87,99,186,170
0132-000,2012,7,9,5,128,169,297,186
0132-000,2012,7,9,6,263,293,556,297
0132-000,2012,7,9,7,509,710,1219,556
0132-000,2012,7,9,8,751,1741,2492,1219
0132-000,2012,7,9,9,893,1420,2313,2492
0132-000,2012,7,9,10,895,988,1883,2313
0132-000,2012,7,9,11,874,959,1833,1883
0132-000,2012,7,9,12,936,950,1886,1833
0132-000,2012,7,9,13,886,959,1845,1886
0132-000,2012,7,9,14,950,1041,1991,1845
0132-000,2012,7,9,15,995,1007,2002,1991
0132-000,2012,7,9,16,1055,993,2048,2002
0132-000,2012,7,9,17,1066,909,1975,2048
0132-000,2012,7,9,18,1160,977,2137,1975
0132-000,2012,7,9,19,1301,945,2246,2137
0132-000,2012,7,9,20,991,833,1824,2246
0132-000,2012,7,9,21,902,651,1553,1824
0132-000,2012,7,9,22,712,539,1251,1553
0132-000,2012,7,9,23,468,439,907,1251
0132-000,2012,7,9,24,306,263,569,907
0132-000,2012,7,10,1,197,224,421,569
0132-000,2012,7,10,2,135,144,279,421
0132-000,2012,7,10,3,101,137,238,279
0132-000,2012,7,10,4,117,115,232,238
0132-000,2012,7,10,5,144,199,343,232
0132-000,2012,7,10,6,254,245,499,343
0132-000,2012,7,10,7,448,546,994,499
0132-000,2012,7,10,8,747,1444,2191,994
0132-000,2012,7,10,9,922,1269,2191,2191
0132-000,2012,7,10,10,884,1000,1884,2191
0132-000,2012,7,10,11,849,988,1837,1884
0132-000,2012,7,10,12,973,915,1888,1837
0132-000,2012,7,10,13,902,902,1804,1888
0132-000,2012,7,10,14,995,966,1961,1804
0132-000,2012,7,10,15,1057,1048,2105,1961
0132-000,2012,7,10,16,1107,909,2016,2105
0132-000,2012,7,10,17,1036,915,1951,2016
0132-000,2012,7,10,18,1216,957,2173,1951
0132-000,2012,7,10,19,1226,945,2171,2173
0132-000,2012,7,10,20,975,808,1783,2171
0132-000,2012,7,10,21,925,642,1567,1783
0132-000,2012,7,10,22,696,525,1221,1567
0132-000,2012,7,10,23,464,441,905,1221
0132-000,2012,7,10,24,286,270,556,905
0132-000,2012,7,11,1,213,201,414,556
0132-000,2012,7,11,2,131,151,282,414
0132-000,2012,7,11,3,105,149,254,282
0132-000,2012,7,11,4,105,108,213,254
0132-000,2012,7,11,5,142,178,320,213
0132-000,2012,7,11,6,247,267,514,320
0132-000,2012,7,11,7,459,539,998,514
0132-000,2012,7,11,8,744,1395,2139,998
0132-000,2012,7,11,9,918,1317,2235,2139
0132-000,2012,7,11,10,897,998,1895,2235
0132-000,2012,7,11,11,929,1020,1949,1895
0132-000,2012,7,11,12,902,936,1838,1949
0132-000,2012,7,11,13,842,886,1728,1838
0132-000,2012,7,11,14,945,954,1899,1728
0132-000,2012,7,11,15,1014,1030,2044,1899
0132-000,2012,7,11,16,1016,959,1975,2044
0132-000,2012,7,11,17,1091,909,2000,1975
0132-000,2012,7,11,18,1214,973,2187,2000
0132-000,2012,7,11,19,1314,1055,2369,2187
0132-000,2012,7,11,20,982,829,1811,2369
0132-000,2012,7,11,21,845,644,1489,1811
0132-000,2012,7,11,22,658,564,1222,1489
0132-000,2012,7,11,23,416,448,864,1222
0132-000,2012,7,11,24,283,315,598,864
0132-000,2012,7,12,1,210,256,466,598
0132-000,2012,7,12,2,140,149,289,466
0132-000,2012,7,12,3,103,121,224,289
0132-000,2012,7,12,4,121,121,242,224
0132-000,2012,7,12,5,117,133,250,242
0132-000,2012,7,12,6,208,208,416,250
0132-000,2012,7,12,7,409,477,886,416
0132-000,2012,7,12,8,712,1382,2094,886
0132-000,2012,7,12,9,854,1312,2166,2094
0132-000,2012,7,12,10,820,938,1758,2166
0132-000,2012,7,12,11,870,899,1769,1758
0132-000,2012,7,12,12,874,911,1785,1769
0132-000,2012,7,12,13,838,806,1644,1785
0132-000,2012,7,12,14,872,909,1781,1644
0132-000,2012,7,12,15,954,966,1920,1781
0132-000,2012,7,12,16,966,863,1829,1920
0132-000,2012,7,12,17,1020,879,1899,1829
0132-000,2012,7,12,18,1148,858,2006,1899
0132-000,2012,7,12,19,1257,872,2129,2006
0132-000,2012,7,12,20,1027,779,1806,2129
0132-000,2012,7,12,21,842,619,1461,1806
0132-000,2012,7,12,22,676,530,1206,1461
0132-000,2012,7,12,23,445,418,863,1206
0132-000,2012,7,12,24,286,322,608,863
0132-000,2012,7,13,1,210,201,411,608
0132-000,2012,7,13,2,140,158,298,411
0132-000,2012,7,13,3,112,140,252,298
0132-000,2012,7,13,4,108,115,223,252
0132-000,2012,7,13,5,131,140,271,223
0132-000,2012,7,13,6,220,236,456,271
0132-000,2012,7,13,7,393,550,943,456
0132-000,2012,7,13,8,607,1556,2163,943
0132-000,2012,7,13,9,913,1349,2262,2163
0132-000,2012,7,13,10,786,909,1695,2262
0132-000,2012,7,13,11,1028,1073,2101,1695
0132-000,2012,7,13,12,902,988,1890,2101
0132-000,2012,7,13,13,888,920,1808,1890
0132-000,2012,7,13,14,1016,947,1963,1808
0132-000,2012,7,13,15,1071,1052,2123,1963
0132-000,2012,7,13,16,1125,1002,2127,2123
0132-000,2012,7,13,17,1139,895,2034,2127
0132-000,2012,7,13,18,1370,637,2007,2034
0132-000,2012,7,13,19,1703,1039,2742,2007
0132-000,2012,7,13,20,1150,881,2031,2742
0132-000,2012,7,13,21,995,763,1758,2031
0132-000,2012,7,13,22,724,637,1361,1758
0132-000,2012,7,13,23,482,569,1051,1361
0132-000,2012,7,13,24,320,356,676,1051
0132-000,2012,7,14,1,254,270,524,676
0132-000,2012,7,14,2,185,240,425,524
0132-000,2012,7,14,3,156,165,321,425
0132-000,2012,7,14,4,117,151,268,321
0132-000,2012,7,14,5,126,144,270,268
0132-000,2012,7,14,6,247,277,524,270
0132-000,2012,7,14,7,338,436,774,524
0132-000,2012,7,14,8,436,927,1363,774
0132-000,2012,7,14,9,649,1036,1685,1363
0132-000,2012,7,14,10,806,1009,1815,1685
0132-000,2012,7,14,11,895,1109,2004,1815
0132-000,2012,7,14,12,925,1248,2173,2004
0132-000,2012,7,14,13,934,1251,2185,2173
0132-000,2012,7,14,14,1011,1128,2139,2185
0132-000,2012,7,14,15,1057,1155,2212,2139
0132-000,2012,7,14,16,1071,1150,2221,2212
0132-000,2012,7,14,17,1221,1198,2419,2221
0132-000,2012,7,14,18,1614,1210,2824,2419
0132-000,2012,7,14,19,1679,1068,2747,2824
0132-000,2012,7,14,20,1061,854,1915,2747
0132-000,2012,7,14,21,797,660,1457,1915
0132-000,2012,7,14,22,601,591,1192,1457
0132-000,2012,7,14,23,409,429,838,1192
0132-000,2012,7,14,24,277,290,567,838
0132-000,2012,7,15,1,208,288,496,567
0132-000,2012,7,15,2,153,169,322,496
0132-000,2012,7,15,3,128,137,265,322
0132-000,2012,7,15,4,110,96,206,265
0132-000,2012,7,15,5,96,110,206,206
0132-000,2012,7,15,6,147,160,307,206
0132-000,2012,7,15,7,236,236,472,307
0132-000,2012,7,15,8,288,582,870,472
0132-000,2012,7,15,9,423,626,1049,870
0132-000,2012,7,15,10,491,573,1064,1049
0132-000,2012,7,15,11,614,706,1320,1064
0132-000,2012,7,15,12,621,703,1324,1320
0132-000,2012,7,15,13,815,660,1475,1324
0132-000,2012,7,15,14,744,774,1518,1475
0132-000,2012,7,15,15,824,763,1587,1518
0132-000,2012,7,15,16,1144,779,1923,1587
0132-000,2012,7,15,17,1370,820,2190,1923
0132-000,2012,7,15,18,1625,781,2406,2190
0132-000,2012,7,15,19,1522,735,2257,2406
0132-000,2012,7,15,20,929,637,1566,2257
0132-000,2012,7,15,21,820,573,1393,1566
0132-000,2012,7,15,22,573,591,1164,1393
0132-000,2012,7,15,23,404,409,813,1164
0132-000,2012,7,15,24,270,329,599,813
0132-000,2012,7,16,1,204,233,437,599
0132-000,2012,7,16,2,115,142,257,437
0132-000,2012,7,16,3,94,85,179,257
0132-000,2012,7,16,4,74,89,163,179
0132-000,2012,7,16,5,124,167,291,163
0132-000,2012,7,16,6,247,247,494,291
0132-000,2012,7,16,7,484,651,1135,494
0132-000,2012,7,16,8,724,1716,2440,1135
0132-000,2012,7,16,9,879,1470,2349,2440
0132-000,2012,7,16,10,881,988,1869,2349
0132-000,2012,7,16,11,918,993,1911,1869
0132-000,2012,7,16,12,954,957,1911,1911
0132-000,2012,7,16,13,893,968,1861,1911
0132-000,2012,7,16,14,952,1052,2004,1861
0132-000,2012,7,16,15,993,982,1975,2004
0132-000,2012,7,16,16,1112,991,2103,1975
0132-000,2012,7,16,17,1109,856,1965,2103
0132-000,2012,7,16,18,1217,975,2192,1965
0132-000,2012,7,16,19,1317,945,2262,2192
0132-000,2012,7,16,20,1020,826,1846,2262
0132-000,2012,7,16,21,895,664,1559,1846
0132-000,2012,7,16,22,715,578,1293,1559
0132-000,2012,7,16,23,480,455,935,1293
0132-000,2012,7,16,24,347,277,624,935
0132-000,2012,7,17,1,208,236,444,624
0132-000,2012,7,17,2,137,174,311,444
0132-000,2012,7,17,3,101,158,259,311
0132-000,2012,7,17,4,126,117,243,259
0132-000,2012,7,17,5,137,194,331,243
0132-000,2012,7,17,6,281,217,498,331
0132-000,2012,7,17,7,420,480,900,498
0132-000,2012,7,17,8,792,1356,2148,900
0132-000,2012,7,17,9,909,1310,2219,2148
0132-000,2012,7,17,10,874,1009,1883,2219
0132-000,2012,7,17,11,808,966,1774,1883
0132-000,2012,7,17,12,1023,906,1929,1774
0132-000,2012,7,17,13,922,884,1806,1929
0132-000,2012,7,17,14,977,870,1847,1806
0132-000,2012,7,17,15,1059,1048,2107,1847
0132-000,2012,7,17,16,1082,893,1975,2107
0132-000,2012,7,17,17,1100,909,2009,1975
0132-000,2012,7,17,18,1244,984,2228,2009
0132-000,2012,7,17,19,1239,936,2175,2228
0132-000,2012,7,17,20,970,824,1794,2175
0132-000,2012,7,17,21,947,680,1627,1794
0132-000,2012,7,17,22,662,537,1199,1627
0132-000,2012,7,17,23,480,487,967,1199
0132-000,2012,7,17,24,288,290,578,967
0132-000,2012,7,18,1,194,199,393,578
0132-000,2012,7,18,2,96,153,249,393
0132-000,2012,7,18,3,105,142,247,249
0132-000,2012,7,18,4,112,115,227,247
0132-000,2012,7,18,5,137,176,313,227
0132-000,2012,7,18,6,217,240,457,313
0132-000,2012,7,18,7,432,450,882,457
0132-000,2012,7,18,8,712,1390,2102,882
0132-000,2012,7,18,9,938,1331,2269,2102
0132-000,2012,7,18,10,895,1004,1899,2269
0132-000,2012,7,18,11,911,1020,1931,1899
0132-000,2012,7,18,12,904,943,1847,1931
0132-000,2012,7,18,13,829,868,1697,1847
0132-000,2012,7,18,14,929,925,1854,1697
0132-000,2012,7,18,15,998,982,1980,1854
0132-000,2012,7,18,16,1048,950,1998,1980
0132-000,2012,7,18,17,1066,897,1963,1998
0132-000,2012,7,18,18,1194,897,2091,1963
0132-000,2012,7,18,19,1312,868,2180,2091
0132-000,2012,7,18,20,931,822,1753,2180
0132-000,2012,7,18,21,833,646,1479,1753
0132-000,2012,7,18,22,687,607,1294,1479
0132-000,2012,7,18,23,400,429,829,1294
0132-000,2012,7,18,24,288,299,587,829
0132-000,2012,7,19,1,229,251,480,587
0132-000,2012,7,19,2,128,163,291,480
0132-000,2012,7,19,3,115,115,230,291
0132-000,2012,7,19,4,124,131,255,230
0132-000,2012,7,19,5,103,144,247,255
0132-000,2012,7,19,6,185,174,359,247
0132-000,2012,7,19,7,368,443,811,359
0132-000,2012,7,19,8,655,1340,1995,811
0132-000,2012,7,19,9,820,1319,2139,1995
0132-000,2012,7,19,10,799,893,1692,2139
0132-000,2012,7,19,11,831,863,1694,1692
0132-000,2012,7,19,12,838,874,1712,1694
0132-000,2012,7,19,13,795,836,1631,1712
0132-000,2012,7,19,14,858,863,1721,1631
0132-000,2012,7,19,15,957,959,1916,1721
0132-000,2012,7,19,16,929,852,1781,1916
0132-000,2012,7,19,17,1002,909,1911,1781
0132-000,2012,7,19,18,1091,831,1922,1911
0132-000,2012,7,19,19,1296,893,2189,1922
0132-000,2012,7,19,20,1041,785,1826,2189
0132-000,2012,7,19,21,856,612,1468,1826
0132-000,2012,7,19,22,696,548,1244,1468
0132-000,2012,7,19,23,459,445,904,1244
0132-000,2012,7,19,24,286,343,629,904
0132-000,2012,7,20,1,247,267,514,629
0132-000,2012,7,20,2,140,197,337,514
0132-000,2012,7,20,3,158,140,298,337
0132-000,2012,7,20,4,144,142,286,298
0132-000,2012,7,20,5,128,197,325,286
0132-000,2012,7,20,6,277,238,515,325
0132-000,2012,7,20,7,473,525,998,515
0132-000,2012,7,20,8,728,1356,2084,998
0132-000,2012,7,20,9,979,1405,2384,2084
0132-000,2012,7,20,10,890,1004,1894,2384
0132-000,2012,7,20,11,906,952,1858,1894
0132-000,2012,7,20,12,945,1027,1972,1858
0132-000,2012,7,20,13,920,1135,2055,1972
0132-000,2012,7,20,14,988,1171,2159,2055
0132-000,2012,7,20,15,1027,1103,2130,2159
0132-000,2012,7,20,16,1107,1073,2180,2130
0132-000,2012,7,20,17,1192,1301,2493,2180
0132-000,2012,7,20,18,1589,1084,2673,2493
0132-000,2012,7,20,19,1689,1071,2760,2673
0132-000,2012,7,20,20,1219,947,2166,2760
0132-000,2012,7,20,21,1089,783,1872,2166
0132-000,2012,7,20,22,945,715,1660,1872
0132-000,2012,7,20,23,596,528,1124,1660
0132-000,2012,7,20,24,391,404,795,1124
0132-000,2012,7,21,1,272,322,594,795
0132-000,2012,7,21,2,220,240,460,594
0132-000,2012,7,21,3,165,213,378,460
0132-000,2012,7,21,4,144,153,297,378
0132-000,2012,7,21,5,137,236,373,297
0132-000,2012,7,21,6,245,242,487,373
0132-000,2012,7,21,7,391,439,830,487
0132-000,2012,7,21,8,610,893,1503,830
0132-000,2012,7,21,9,840,966,1806,1503
0132-000,2012,7,21,10,813,1048,1861,1806
0132-000,2012,7,21,11,945,1244,2189,1861
0132-000,2012,7,21,12,936,1399,2335,2189
0132-000,2012,7,21,13,918,1447,2365,2335
0132-000,2012,7,21,14,1002,1283,2285,2365
0132-000,2012,7,21,15,1032,1255,2287,2285
0132-000,2012,7,21,16,957,1107,2064,2287
0132-000,2012,7,21,17,1030,1100,2130,2064
0132-000,2012,7,21,18,1280,1214,2494,2130
0132-000,2012,7,21,19,1182,991,2173,2494
0132-000,2012,7,21,20,966,833,1799,2173
0132-000,2012,7,21,21,852,619,1471,1799
0132-000,2012,7,21,22,824,653,1477,1471
0132-000,2012,7,21,23,423,491,914,1477
0132-000,2012,7,21,24,404,400,804,914
0132-000,2012,7,22,1,297,304,601,804
0132-000,2012,7,22,2,197,242,439,601
0132-000,2012,7,22,3,137,160,297,439
0132-000,2012,7,22,4,133,133,266,297
0132-000,2012,7,22,5,135,135,270,266
0132-000,2012,7,22,6,165,167,332,270
0132-000,2012,7,22,7,277,263,540,332
0132-000,2012,7,22,8,343,464,807,540
0132-000,2012,7,22,9,516,580,1096,807
0132-000,2012,7,22,10,523,569,1092,1096
0132-000,2012,7,22,11,605,630,1235,1092
0132-000,2012,7,22,12,655,701,1356,1235
0132-000,2012,7,22,13,806,751,1557,1356
0132-000,2012,7,22,14,881,774,1655,1557
0132-000,2012,7,22,15,904,767,1671,1655
0132-000,2012,7,22,16,1161,806,1967,1671
0132-000,2012,7,22,17,1135,817,1952,1967
0132-000,2012,7,22,18,1125,774,1899,1952
0132-000,2012,7,22,19,1032,744,1776,1899
0132-000,2012,7,22,20,920,637,1557,1776
0132-000,2012,7,22,21,788,671,1459,1557
0132-000,2012,7,22,22,724,553,1277,1459
0132-000,2012,7,22,23,459,471,930,1277
0132-000,2012,7,22,24,254,288,542,930
0132-000,2012,7,23,1,163,254,417,542
0132-000,2012,7,23,2,92,135,227,417
0132-000,2012,7,23,3,92,101,193,227
0132-000,2012,7,23,4,78,101,179,193
0132-000,2012,7,23,5,112,151,263,179
0132-000,2012,7,23,6,258,279,537,263
0132-000,2012,7,23,7,502,701,1203,537
0132-000,2012,7,23,8,815,1602,2417,1203
0132-000,2012,7,23,9,902,1424,2326,2417
0132-000,2012,7,23,10,861,984,1845,2326
0132-000,2012,7,23,11,879,1080,1959,1845
0132-000,2012,7,23,12,1002,1308,2310,1959
0132-000,2012,7,23,13,977,1349,2326,2310
0132-000,2012,7,23,14,943,1093,2036,2326
0132-000,2012,7,23,15,988,1082,2070,2036
0132-000,2012,7,23,16,1082,1034,2116,2070
0132-000,2012,7,23,17,1036,984,2020,2116
0132-000,2012,7,23,18,1212,954,2166,2020
0132-000,2012,7,23,19,1268,952,2220,2166
0132-000,2012,7,23,20,966,783,1749,2220
0132-000,2012,7,23,21,931,724,1655,1749
0132-000,2012,7,23,22,737,546,1283,1655
0132-000,2012,7,23,23,445,377,822,1283
0132-000,2012,7,23,24,258,315,573,822
0132-000,2012,7,24,1,204,231,435,573
0132-000,2012,7,24,2,137,160,297,435
0132-000,2012,7,24,3,101,149,250,297
0132-000,2012,7,24,4,121,117,238,250
0132-000,2012,7,24,5,142,197,339,238
0132-000,2012,7,24,6,267,231,498,339
0132-000,2012,7,24,7,434,514,948,498
0132-000,2012,7,24,8,769,1400,2169,948
0132-000,2012,7,24,9,915,1290,2205,2169
0132-000,2012,7,24,10,879,1004,1883,2205
0132-000,2012,7,24,11,829,977,1806,1883
0132-000,2012,7,24,12,998,911,1909,1806
0132-000,2012,7,24,13,913,893,1806,1909
0132-000,2012,7,24,14,986,918,1904,1806
0132-000,2012,7,24,15,1059,1048,2107,1904
0132-000,2012,7,24,16,1096,902,1998,2107
0132-000,2012,7,24,17,1068,913,1981,1998
0132-000,2012,7,24,18,1231,970,2201,1981
0132-000,2012,7,24,19,1233,941,2174,2201
0132-000,2012,7,24,20,973,817,1790,2174
0132-000,2012,7,24,21,936,662,1598,1790
0132-000,2012,7,24,22,680,532,1212,1598
0132-000,2012,7,24,23,473,464,937,1212
0132-000,2012,7,24,24,288,281,569,937
0132-000,2012,7,25,1,204,201,405,569
0132-000,2012,7,25,2,115,153,268,405
0132-000,2012,7,25,3,105,147,252,268
0132-000,2012,7,25,4,110,112,222,252
0132-000,2012,7,25,5,140,178,318,222
0132-000,2012,7,25,6,233,254,487,318
0132-000,2012,7,25,7,445,496,941,487
0132-000,2012,7,25,8,728,1393,2121,941
0132-000,2012,7,25,9,929,1324,2253,2121
0132-000,2012,7,25,10,897,1002,1899,2253
0132-000,2012,7,25,11,920,1020,1940,1899
0132-000,2012,7,25,12,904,941,1845,1940
0132-000,2012,7,25,13,836,877,1713,1845
0132-000,2012,7,25,14,938,941,1879,1713
0132-000,2012,7,25,15,1007,1007,2014,1879
0132-000,2012,7,25,16,1032,954,1986,2014
0132-000,2012,7,25,17,1080,904,1984,1986
0132-000,2012,7,25,18,1205,936,2141,1984
0132-000,2012,7,25,19,1311,961,2272,2141
0132-000,2012,7,25,20,957,826,1783,2272
0132-000,2012,7,25,21,840,646,1486,1783
0132-000,2012,7,25,22,674,587,1261,1486
0132-000,2012,7,25,23,409,439,848,1261
0132-000,2012,7,25,24,286,309,595,848
0132-000,2012,7,26,1,220,254,474,595
0132-000,2012,7,26,2,135,156,291,474
0132-000,2012,7,26,3,110,119,229,291
0132-000,2012,7,26,4,124,126,250,229
0132-000,2012,7,26,5,110,140,250,250
0132-000,2012,7,26,6,197,192,389,250
0132-000,2012,7,26,7,388,461,849,389
0132-000,2012,7,26,8,685,1361,2046,849
0132-000,2012,7,26,9,838,1317,2155,2046
0132-000,2012,7,26,10,811,915,1726,2155
0132-000,2012,7,26,11,852,881,1733,1726
0132-000,2012,7,26,12,856,893,1749,1733
0132-000,2012,7,26,13,817,822,1639,1749
0132-000,2012,7,26,14,865,886,1751,1639
0132-000,2012,7,26,15,957,963,1920,1751
0132-000,2012,7,26,16,947,858,1805,1920
0132-000,2012,7,26,17,1011,895,1906,1805
0132-000,2012,7,26,18,1121,845,1966,1906
0132-000,2012,7,26,19,1275,884,2159,1966
0132-000,2012,7,26,20,1034,783,1817,2159
0132-000,2012,7,26,21,849,617,1466,1817
0132-000,2012,7,26,22,687,539,1226,1466
0132-000,2012,7,26,23,452,432,884,1226
0132-000,2012,7,26,24,286,334,620,884
0132-000,2012,7,27,1,229,236,465,620
0132-000,2012,7,27,2,140,178,318,465
0132-000,2012,7,27,3,135,140,275,318
0132-000,2012,7,27,4,126,128,254,275
0132-000,2012,7,27,5,131,169,300,254
0132-000,2012,7,27,6,249,238,487,300
0132-000,2012,7,27,7,434,539,973,487
0132-000,2012,7,27,8,669,1450,2119,973
0132-000,2012,7,27,9,589,1383,1972,2119
0132-000,2012,7,27,10,548,957,1505,1972
0132-000,2012,7,27,11,722,1014,1736,1505
0132-000,2012,7,27,12,925,1009,1934,1736
0132-000,2012,7,27,13,904,1027,1931,1934
0132-000,2012,7,27,14,1002,1059,2061,1931
0132-000,2012,7,27,15,1050,1077,2127,2061
0132-000,2012,7,27,16,1116,1039,2155,2127
0132-000,2012,7,27,17,1166,1098,2264,2155
0132-000,2012,7,27,18,1479,861,2340,2264
0132-000,2012,7,27,19,1697,1055,2752,2340
0132-000,2012,7,27,20,1185,915,2100,2752
0132-000,2012,7,27,21,1043,774,1817,2100
0132-000,2012,7,27,22,836,676,1512,1817
0132-000,2012,7,27,23,539,548,1087,1512
0132-000,2012,7,27,24,356,382,738,1087
0132-000,2012,7,28,1,263,297,560,738
0132-000,2012,7,28,2,204,240,444,560
0132-000,2012,7,28,3,160,190,350,444
0132-000,2012,7,28,4,131,153,284,350
0132-000,2012,7,28,5,133,190,323,284
0132-000,2012,7,28,6,247,261,508,323
0132-000,2012,7,28,7,366,439,805,508
0132-000,2012,7,28,8,523,911,1434,805
0132-000,2012,7,28,9,744,1002,1746,1434
0132-000,2012,7,28,10,811,1030,1841,1746
0132-000,2012,7,28,11,920,1178,2098,1841
0132-000,2012,7,28,12,931,1328,2259,2098
0132-000,2012,7,28,13,927,1345,2272,2259
0132-000,2012,7,28,14,1007,1205,2212,2272
0132-000,2012,7,28,15,1046,1205,2251,2212
0132-000,2012,7,28,16,1014,1130,2144,2251
0132-000,2012,7,28,17,1125,1150,2275,2144
0132-000,2012,7,28,18,1440,1212,2652,2275
0132-000,2012,7,28,19,1438,1030,2468,2652
0132-000,2012,7,28,20,1014,845,1859,2468
0132-000,2012,7,28,21,824,639,1463,1859
0132-000,2012,7,28,22,712,623,1335,1463
0132-000,2012,7,28,23,416,461,877,1335
0132-000,2012,7,28,24,340,345,685,877
0132-000,2012,7,29,1,210,176,386,685
0132-000,2012,7,29,2,178,163,341,386
0132-000,2012,7,29,3,126,117,243,341
0132-000,2012,7,29,4,101,99,200,243
0132-000,2012,7,29,5,121,83,204,200
0132-000,2012,7,29,6,165,176,341,204
0132-000,2012,7,29,7,295,247,542,341
0132-000,2012,7,29,8,377,429,806,542
0132-000,2012,7,29,9,468,539,1007,806
0132-000,2012,7,29,10,553,646,1199,1007
0132-000,2012,7,29,11,699,619,1318,1199
0132-000,2012,7,29,12,601,685,1286,1318
0132-000,2012,7,29,13,662,589,1251,1286
0132-000,2012,7,29,14,728,607,1335,1251
0132-000,2012,7,29,15,847,772,1619,1335
0132-000,2012,7,29,16,913,687,1600,1619
0132-000,2012,7,29,17,1046,731,1777,1600
0132-000,2012,7,29,18,1339,790,2129,1777
0132-000,2012,7,29,19,1032,610,1642,2129
0132-000,2012,7,29,20,847,617,1464,1642
0132-000,2012,7,29,21,804,537,1341,1464
0132-000,2012,7,29,22,795,498,1293,1341
0132-000,2012,7,29,23,455,434,889,1293
0132-000,2012,7,29,24,267,272,539,889
0132-000,2012,7,30,1,188,185,373,539
0132-000,2012,7,30,2,112,110,222,373
0132-000,2012,7,30,3,74,87,161,222
0132-000,2012,7,30,4,85,78,163,161
0132-000,2012,7,30,5,158,131,289,163
0132-000,2012,7,30,6,222,226,448,289
0132-000,2012,7,30,7,500,578,1078,448
0132-000,2012,7,30,8,715,1410,2125,1078
0132-000,2012,7,30,9,836,1397,2233,2125
0132-000,2012,7,30,10,877,1009,1886,2233
0132-000,2012,7,30,11,870,988,1858,1886
0132-000,2012,7,30,12,904,984,1888,1858
0132-000,2012,7,30,13,870,959,1829,1888
0132-000,2012,7,30,14,938,1034,1972,1829
0132-000,2012,7,30,15,1057,1089,2146,1972
0132-000,2012,7,30,16,1084,1011,2095,2146
0132-000,2012,7,30,17,1050,890,1940,2095
0132-000,2012,7,30,18,1182,877,2059,1940
0132-000,2012,7,30,19,1190,945,2135,2059
0132-000,2012,7,30,20,927,804,1731,2135
0132-000,2012,7,30,21,799,626,1425,1731
0132-000,2012,7,30,22,639,571,1210,1425
0132-000,2012,7,30,23,398,386,784,1210
0132-000,2012,7,30,24,267,256,523,784
0132-000,2012,7,31,1,222,178,400,523
0132-000,2012,7,31,2,126,115,241,400
0132-000,2012,7,31,3,108,101,209,241
0132-000,2012,7,31,4,112,105,217,209
0132-000,2012,7,31,5,126,119,245,217
0132-000,2012,7,31,6,242,181,423,245
0132-000,2012,7,31,7,411,441,852,423
0132-000,2012,7,31,8,610,1265,1875,852
0132-000,2012,7,31,9,836,1274,2110,1875
0132-000,2012,7,31,10,772,888,1660,2110
0132-000,2012,7,31,11,881,929,1810,1660
0132-000,2012,7,31,12,902,1002,1904,1810
0132-000,2012,7,31,13,874,922,1796,1904
0132-000,2012,7,31,14,929,845,1774,1796
0132-000,2012,7,31,15,988,950,1938,1774
0132-000,2012,7,31,16,975,947,1922,1938
0132-000,2012,7,31,17,1018,769,1787,1922
0132-000,2012,7,31,18,1137,979,2116,1787
0132-000,2012,7,31,19,1191,998,2189,2116
0132-000,2012,7,31,20,970,776,1746,2189
0132-000,2012,7,31,21,774,712,1486,1746
0132-000,2012,7,31,22,651,528,1179,1486
0132-000,2012,7,31,23,482,407,889,1179
0132-000,2012,7,31,24,313,263,576,889
0132-000,2012,8,1,1,213,199,412,576
0132-000,2012,8,1,2,142,167,309,412
0132-000,2012,8,1,3,174,112,286,309
0132-000,2012,8,1,4,101,128,229,286
0132-000,2012,8,1,5,133,142,275,229
0132-000,2012,8,1,6,254,178,432,275
0132-000,2012,8,1,7,443,432,875,432
0132-000,2012,8,1,8,626,1217,1843,875
0132-000,2012,8,1,9,758,1198,1956,1843
0132-000,2012,8,1,10,797,920,1717,1956
0132-000,2012,8,1,11,817,1041,1858,1717
0132-000,2012,8,1,12,868,1157,2025,1858
0132-000,2012,8,1,13,890,1294,2184,2025
0132-000,2012,8,1,14,833,1399,2232,2184
0132-000,2012,8,1,15,911,1421,2332,2232
0132-000,2012,8,1,16,979,1344,2323,2332
0132-000,2012,8,1,17,1020,1260,2280,2323
0132-000,2012,8,1,18,1160,1249,2409,2280
0132-000,2012,8,1,19,1228,1347,2575,2409
0132-000,2012,8,1,20,943,909,1852,2575
0132-000,2012,8,1,21,767,594,1361,1852
0132-000,2012,8,1,22,617,514,1131,1361
0132-000,2012,8,1,23,398,366,764,1131
0132-000,2012,8,1,24,288,254,542,764
0132-000,2012,8,2,1,240,206,446,542
0132-000,2012,8,2,2,142,128,270,446
0132-000,2012,8,2,3,112,62,174,270
0132-000,2012,8,2,4,99,101,200,174
0132-000,2012,8,2,5,115,96,211,200
0132-000,2012,8,2,6,204,181,385,211
0132-000,2012,8,2,7,368,370,738,385
0132-000,2012,8,2,8,591,1144,1735,738
0132-000,2012,8,2,9,783,1100,1883,1735
0132-000,2012,8,2,10,758,872,1630,1883
0132-000,2012,8,2,11,776,1066,1842,1630
0132-000,2012,8,2,12,790,1290,2080,1842
0132-000,2012,8,2,13,852,1415,2267,2080
0132-000,2012,8,2,14,884,1570,2454,2267
0132-000,2012,8,2,15,909,1592,2501,2454
0132-000,2012,8,2,16,947,1347,2294,2501
0132-000,2012,8,2,17,941,1192,2133,2294
0132-000,2012,8,2,18,1091,1048,2139,2133
0132-000,2012,8,2,19,1166,911,2077,2139
0132-000,2012,8,2,20,993,799,1792,2077
0132-000,2012,8,2,21,790,598,1388,1792
0132-000,2012,8,2,22,585,409,994,1388
0132-000,2012,8,2,23,450,455,905,994
0132-000,2012,8,2,24,318,265,583,905
0132-000,2012,8,3,1,204,167,371,583
0132-000,2012,8,3,2,124,115,239,371
0132-000,2012,8,3,3,117,76,193,239
0132-000,2012,8,3,4,92,92,184,193
0132-000,2012,8,3,5,153,124,277,184
0132-000,2012,8,3,6,254,185,439,277
0132-000,2012,8,3,7,423,372,795,439
0132-000,2012,8,3,8,575,1032,1607,795
0132-000,2012,8,3,9,717,1098,1815,1607
0132-000,2012,8,3,10,735,838,1573,1815
0132-000,2012,8,3,11,781,897,1678,1573
0132-000,2012,8,3,12,854,954,1808,1678
0132-000,2012,8,3,13,801,1007,1808,1808
0132-000,2012,8,3,14,870,1089,1959,1808
0132-000,2012,8,3,15,966,934,1900,1959
0132-000,2012,8,3,16,1016,963,1979,1900
0132-000,2012,8,3,17,1032,831,1863,1979
0132-000,2012,8,3,18,1313,877,2190,1863
0132-000,2012,8,3,19,1278,954,2232,2190
0132-000,2012,8,3,20,1178,879,2057,2232
0132-000,2012,8,3,21,904,607,1511,2057
0132-000,2012,8,3,22,909,553,1462,1511
0132-000,2012,8,3,23,505,445,950,1462
0132-000,2012,8,3,24,331,297,628,950
0132-000,2012,8,4,1,233,213,446,628
0132-000,2012,8,4,2,208,169,377,446
0132-000,2012,8,4,3,140,101,241,377
0132-000,2012,8,4,4,131,119,250,241
0132-000,2012,8,4,5,156,108,264,250
0132-000,2012,8,4,6,183,204,387,264
0132-000,2012,8,4,7,311,313,624,387
0132-000,2012,8,4,8,496,701,1197,624
0132-000,2012,8,4,9,669,854,1523,1197
0132-000,2012,8,4,10,680,1135,1815,1523
0132-000,2012,8,4,11,763,1566,2329,1815
0132-000,2012,8,4,12,785,1590,2375,2329
0132-000,2012,8,4,13,838,1456,2294,2375
0132-000,2012,8,4,14,920,1166,2086,2294
0132-000,2012,8,4,15,963,918,1881,2086
0132-000,2012,8,4,16,1059,804,1863,1881
0132-000,2012,8,4,17,1196,749,1945,1863
0132-000,2012,8,4,18,1311,813,2124,1945
0132-000,2012,8,4,19,1308,861,2169,2124
0132-000,2012,8,4,20,1084,685,1769,2169
0132-000,2012,8,4,21,968,509,1477,1769
0132-000,2012,8,4,22,957,448,1405,1477
0132-000,2012,8,4,23,569,325,894,1405
0132-000,2012,8,4,24,398,290,688,894
0132-000,2012,8,5,1,185,220,405,688
0132-000,2012,8,5,2,178,169,347,405
0132-000,2012,8,5,3,117,96,213,347
0132-000,2012,8,5,4,119,78,197,213
0132-000,2012,8,5,5,96,76,172,197
0132-000,2012,8,5,6,140,153,293,172
0132-000,2012,8,5,7,238,197,435,293
0132-000,2012,8,5,8,345,391,736,435
0132-000,2012,8,5,9,407,429,836,736
0132-000,2012,8,5,10,502,509,1011,836
0132-000,2012,8,5,11,630,589,1219,1011
0132-000,2012,8,5,12,628,546,1174,1219
0132-000,2012,8,5,13,756,658,1414,1174
0132-000,2012,8,5,14,856,664,1520,1414
0132-000,2012,8,5,15,1055,669,1724,1520
0132-000,2012,8,5,16,1203,621,1824,1724
0132-000,2012,8,5,17,1219,575,1794,1824
0132-000,2012,8,5,18,1354,767,2121,1794
0132-000,2012,8,5,19,1445,989,2434,2121
0132-000,2012,8,5,20,1397,621,2018,2434
0132-000,2012,8,5,21,915,594,1509,2018
0132-000,2012,8,5,22,947,587,1534,1509
0132-000,2012,8,5,23,450,411,861,1534
0132-000,2012,8,5,24,272,236,508,861
0132-000,2012,8,6,1,176,153,329,508
0132-000,2012,8,6,2,110,108,218,329
0132-000,2012,8,6,3,101,53,154,218
0132-000,2012,8,6,4,71,121,192,154
0132-000,2012,8,6,5,144,124,268,192
0132-000,2012,8,6,6,263,220,483,268
0132-000,2012,8,6,7,489,728,1217,483
0132-000,2012,8,6,8,744,1711,2455,1217
0132-000,2012,8,6,9,897,1429,2326,2455
0132-000,2012,8,6,10,863,1059,1922,2326
0132-000,2012,8,6,11,833,1020,1853,1922
0132-000,2012,8,6,12,957,1016,1973,1853
0132-000,2012,8,6,13,845,929,1774,1973
0132-000,2012,8,6,14,966,1030,1996,1774
0132-000,2012,8,6,15,993,1018,2011,1996
0132-000,2012,8,6,16,961,966,1927,2011
0132-000,2012,8,6,17,1046,899,1945,1927
0132-000,2012,8,6,18,1153,973,2126,1945
0132-000,2012,8,6,19,1269,767,2036,2126
0132-000,2012,8,6,20,993,795,1788,2036
0132-000,2012,8,6,21,831,607,1438,1788
0132-000,2012,8,6,22,639,471,1110,1438
0132-000,2012,8,6,23,411,368,779,1110
0132-000,2012,8,6,24,267,183,450,779
0132-000,2012,8,7,1,190,156,346,450
0132-000,2012,8,7,2,105,103,208,346
0132-000,2012,8,7,3,112,85,197,208
0132-000,2012,8,7,4,83,103,186,197
0132-000,2012,8,7,5,128,101,229,186
0132-000,2012,8,7,6,265,199,464,229
0132-000,2012,8,7,7,441,461,902,464
0132-000,2012,8,7,8,696,1503,2199,902
0132-000,2012,8,7,9,858,1308,2166,2199
0132-000,2012,8,7,10,920,1059,1979,2166
0132-000,2012,8,7,11,877,954,1831,1979
0132-000,2012,8,7,12,957,1000,1957,1831
0132-000,2012,8,7,13,852,1030,1882,1957
0132-000,2012,8,7,14,961,1155,2116,1882
0132-000,2012,8,7,15,945,1226,2171,2116
0132-000,2012,8,7,16,1087,936,2023,2171
0132-000,2012,8,7,17,1166,991,2157,2023
0132-000,2012,8,7,18,1273,961,2234,2157
0132-000,2012,8,7,19,1267,1046,2313,2234
0132-000,2012,8,7,20,1080,897,1977,2313
0132-000,2012,8,7,21,904,587,1491,1977
0132-000,2012,8,7,22,722,516,1238,1491
0132-000,2012,8,7,23,493,361,854,1238
0132-000,2012,8,7,24,315,274,589,854
0132-000,2012,8,8,1,229,217,446,589
0132-000,2012,8,8,2,149,135,284,446
0132-000,2012,8,8,3,126,103,229,284
0132-000,2012,8,8,4,101,96,197,229
0132-000,2012,8,8,5,103,99,202,197
0132-000,2012,8,8,6,204,174,378,202
0132-000,2012,8,8,7,434,544,978,378
0132-000,2012,8,8,8,649,1703,2352,978
0132-000,2012,8,8,9,947,1595,2542,2352
0132-000,2012,8,8,10,833,1032,1865,2542
0132-000,2012,8,8,11,852,982,1834,1865
0132-000,2012,8,8,12,918,938,1856,1834
0132-000,2012,8,8,13,838,863,1701,1856
0132-000,2012,8,8,14,947,947,1894,1701
0132-000,2012,8,8,15,904,950,1854,1894
0132-000,2012,8,8,16,1025,995,2020,1854
0132-000,2012,8,8,17,986,913,1899,2020
0132-000,2012,8,8,18,1210,982,2192,1899
0132-000,2012,8,8,19,1393,1030,2423,2192
0132-000,2012,8,8,20,1034,795,1829,2423
0132-000,2012,8,8,21,861,633,1494,1829
0132-000,2012,8,8,22,619,569,1188,1494
0132-000,2012,8,8,23,418,393,811,1188
0132-000,2012,8,8,24,306,192,498,811
0132-000,2012,8,9,1,217,188,405,498
0132-000,2012,8,9,2,158,137,295,405
0132-000,2012,8,9,3,119,119,238,295
0132-000,2012,8,9,4,76,105,181,238
0132-000,2012,8,9,5,135,133,268,181
0132-000,2012,8,9,6,210,169,379,268
0132-000,2012,8,9,7,423,530,953,379
0132-000,2012,8,9,8,685,1520,2205,953
0132-000,2012,8,9,9,906,1516,2422,2205
0132-000,2012,8,9,10,808,1075,1883,2422
0132-000,2012,8,9,11,863,1048,1911,1883
0132-000,2012,8,9,12,975,979,1954,1911
0132-000,2012,8,9,13,913,874,1787,1954
0132-000,2012,8,9,14,911,925,1836,1787
0132-000,2012,8,9,15,959,959,1918,1836
0132-000,2012,8,9,16,991,963,1954,1918
0132-000,2012,8,9,17,1068,936,2004,1954
0132-000,2012,8,9,18,1048,890,1938,2004
0132-000,2012,8,9,19,1249,998,2247,1938
0132-000,2012,8,9,20,938,717,1655,2247
0132-000,2012,8,9,21,904,669,1573,1655
0132-000,2012,8,9,22,692,512,1204,1573
0132-000,2012,8,9,23,418,315,733,1204
0132-000,2012,8,9,24,272,249,521,733
0132-000,2012,8,10,1,222,165,387,521
0132-000,2012,8,10,2,160,119,279,387
0132-000,2012,8,10,3,128,110,238,279
0132-000,2012,8,10,4,96,87,183,238
0132-000,2012,8,10,5,140,121,261,183
0132-000,2012,8,10,6,226,213,439,261
0132-000,2012,8,10,7,429,544,973,439
0132-000,2012,8,10,8,687,1682,2369,973
0132-000,2012,8,10,9,884,1538,2422,2369
0132-000,2012,8,10,10,840,1109,1949,2422
0132-000,2012,8,10,11,868,961,1829,1949
0132-000,2012,8,10,12,959,957,1916,1829
0132-000,2012,8,10,13,913,936,1849,1916
0132-000,2012,8,10,14,966,1059,2025,1849
0132-000,2012,8,10,15,1002,1105,2107,2025
0132-000,2012,8,10,16,1160,1112,2272,2107
0132-000,2012,8,10,17,1150,1048,2198,2272
0132-000,2012,8,10,18,1297,1084,2381,2198
0132-000,2012,8,10,19,1566,1068,2634,2381
0132-000,2012,8,10,20,1189,945,2134,2634
0132-000,2012,8,10,21,1036,749,1785,2134
0132-000,2012,8,10,22,863,605,1468,1785
0132-000,2012,8,10,23,507,468,975,1468
0132-000,2012,8,10,24,402,334,736,975
0132-000,2012,8,11,1,240,249,489,736
0132-000,2012,8,11,2,178,174,352,489
0132-000,2012,8,11,3,153,137,290,352
0132-000,2012,8,11,4,110,133,243,290
0132-000,2012,8,11,5,151,151,302,243
0132-000,2012,8,11,6,242,144,386,302
0132-000,2012,8,11,7,386,368,754,386
0132-000,2012,8,11,8,580,909,1489,754
0132-000,2012,8,11,9,774,1066,1840,1489
0132-000,2012,8,11,10,831,982,1813,1840
0132-000,2012,8,11,11,840,1404,2244,1813
0132-000,2012,8,11,12,877,1554,2431,2244
0132-000,2012,8,11,13,913,1614,2527,2431
0132-000,2012,8,11,14,941,1557,2498,2527
0132-000,2012,8,11,15,970,1244,2214,2498
0132-000,2012,8,11,16,968,1217,2185,2214
0132-000,2012,8,11,17,1025,1071,2096,2185
0132-000,2012,8,11,18,1224,1182,2406,2096
0132-000,2012,8,11,19,1066,920,1986,2406
0132-000,2012,8,11,20,927,804,1731,1986
0132-000,2012,8,11,21,742,571,1313,1731
0132-000,2012,8,11,22,781,487,1268,1313
0132-000,2012,8,11,23,400,372,772,1268
0132-000,2012,8,11,24,313,270,583,772
0132-000,2012,8,12,1,213,220,433,583
0132-000,2012,8,12,2,199,149,348,433
0132-000,2012,8,12,3,140,121,261,348
0132-000,2012,8,12,4,137,105,242,261
0132-000,2012,8,12,5,110,92,202,242
0132-000,2012,8,12,6,165,144,309,202
0132-000,2012,8,12,7,263,217,480,309
0132-000,2012,8,12,8,361,370,731,480
0132-000,2012,8,12,9,493,500,993,731
0132-000,2012,8,12,10,550,585,1135,993
0132-000,2012,8,12,11,646,614,1260,1135
0132-000,2012,8,12,12,646,591,1237,1260
0132-000,2012,8,12,13,788,610,1398,1237
0132-000,2012,8,12,14,753,674,1427,1398
0132-000,2012,8,12,15,973,623,1596,1427
0132-000,2012,8,12,16,954,671,1625,1596
0132-000,2012,8,12,17,1059,691,1750,1625
0132-000,2012,8,12,18,1123,651,1774,1750
0132-000,2012,8,12,19,1093,546,1639,1774
0132-000,2012,8,12,20,970,557,1527,1639
0132-000,2012,8,12,21,781,450,1231,1527
0132-000,2012,8,12,22,715,388,1103,1231
0132-000,2012,8,12,23,393,304,697,1103
0132-000,2012,8,12,24,229,249,478,697
0132-000,2012,8,13,1,167,140,307,478
0132-000,2012,8,13,2,89,99,188,307
0132-000,2012,8,13,3,64,74,138,188
0132-000,2012,8,13,4,58,94,152,138
0132-000,2012,8,13,5,99,101,200,152
0132-000,2012,8,13,6,163,158,321,200
0132-000,2012,8,13,7,448,598,1046,321
0132-000,2012,8,13,8,692,1864,2556,1046
0132-000,2012,8,13,9,872,1611,2483,2556
0132-000,2012,8,13,10,863,1055,1918,2483
0132-000,2012,8,13,11,936,1064,2000,1918
0132-000,2012,8,13,12,909,1032,1941,2000
0132-000,2012,8,13,13,868,1002,1870,1941
0132-000,2012,8,13,14,943,1000,1943,1870
0132-000,2012,8,13,15,1041,1091,2132,1943
0132-000,2012,8,13,16,1087,1109,2196,2132
0132-000,2012,8,13,17,1166,1011,2177,2196
0132-000,2012,8,13,18,1203,993,2196,2177
0132-000,2012,8,13,19,1329,961,2290,2196
0132-000,2012,8,13,20,984,847,1831,2290
0132-000,2012,8,13,21,906,683,1589,1831
0132-000,2012,8,13,22,735,514,1249,1589
0132-000,2012,8,13,23,457,388,845,1249
0132-000,2012,8,13,24,283,251,534,845
0132-000,2012,8,14,1,226,160,386,534
0132-000,2012,8,14,2,142,126,268,386
0132-000,2012,8,14,3,124,137,261,268
0132-000,2012,8,14,4,124,110,234,261
0132-000,2012,8,14,5,115,115,230,234
0132-000,2012,8,14,6,240,185,425,230
0132-000,2012,8,14,7,409,564,973,425
0132-000,2012,8,14,8,701,1721,2422,973
0132-000,2012,8,14,9,954,1376,2330,2422
0132-000,2012,8,14,10,938,1039,1977,2330
0132-000,2012,8,14,11,936,1064,2000,1977
0132-000,2012,8,14,12,984,1050,2034,2000
0132-000,2012,8,14,13,922,929,1851,2034
0132-000,2012,8,14,14,982,970,1952,1851
0132-000,2012,8,14,15,1016,1114,2130,1952
0132-000,2012,8,14,16,1194,1052,2246,2130
0132-000,2012,8,14,17,1123,1148,2271,2246
0132-000,2012,8,14,18,1411,1237,2648,2271
0132-000,2012,8,14,19,1451,1235,2686,2648
0132-000,2012,8,14,20,1139,979,2118,2686
0132-000,2012,8,14,21,941,683,1624,2118
0132-000,2012,8,14,22,737,585,1322,1624
0132-000,2012,8,14,23,450,407,857,1322
0132-000,2012,8,14,24,379,320,699,857
0132-000,2012,8,15,1,261,231,492,699
0132-000,2012,8,15,2,222,197,419,492
0132-000,2012,8,15,3,153,115,268,419
0132-000,2012,8,15,4,133,119,252,268
0132-000,2012,8,15,5,147,115,262,252
0132-000,2012,8,15,6,167,128,295,262
0132-000,2012,8,15,7,283,272,555,295
0132-000,2012,8,15,8,450,724,1174,555
0132-000,2012,8,15,9,687,728,1415,1174
0132-000,2012,8,15,10,667,735,1402,1415
0132-000,2012,8,15,11,715,840,1555,1402
0132-000,2012,8,15,12,774,925,1699,1555
0132-000,2012,8,15,13,751,744,1495,1699
0132-000,2012,8,15,14,801,662,1463,1495
0132-000,2012,8,15,15,806,687,1493,1463
0132-000,2012,8,15,16,865,737,1602,1493
0132-000,2012,8,15,17,1071,699,1770,1602
0132-000,2012,8,15,18,1149,699,1848,1770
0132-000,2012,8,15,19,1034,662,1696,1848
0132-000,2012,8,15,20,674,530,1204,1696
0132-000,2012,8,15,21,596,441,1037,1204
0132-000,2012,8,15,22,448,354,802,1037
0132-000,2012,8,15,23,299,251,550,802
0132-000,2012,8,15,24,215,215,430,550
0132-000,2012,8,16,1,183,142,325,430
0132-000,2012,8,16,2,99,140,239,325
0132-000,2012,8,16,3,89,78,167,239
0132-000,2012,8,16,4,71,87,158,167
0132-000,2012,8,16,5,89,96,185,158
0132-000,2012,8,16,6,165,197,362,185
0132-000,2012,8,16,7,425,594,1019,362
0132-000,2012,8,16,8,685,1729,2414,1019
0132-000,2012,8,16,9,918,1424,2342,2414
0132-000,2012,8,16,10,863,1034,1897,2342
0132-000,2012,8,16,11,957,931,1888,1897
0132-000,2012,8,16,12,963,959,1922,1888
0132-000,2012,8,16,13,893,927,1820,1922
0132-000,2012,8,16,14,988,1011,1999,1820
0132-000,2012,8,16,15,1027,1146,2173,1999
0132-000,2012,8,16,16,1080,1039,2119,2173
0132-000,2012,8,16,17,1050,1027,2077,2119
0132-000,2012,8,16,18,1160,941,2101,2077
0132-000,2012,8,16,19,1266,986,2252,2101
0132-000,2012,8,16,20,1014,836,1850,2252
0132-000,2012,8,16,21,858,617,1475,1850
0132-000,2012,8,16,22,683,539,1222,1475
0132-000,2012,8,16,23,420,354,774,1222
0132-000,2012,8,16,24,304,233,537,774
0132-000,2012,8,17,1,238,172,410,537
0132-000,2012,8,17,2,142,121,263,410
0132-000,2012,8,17,3,76,71,147,263
0132-000,2012,8,17,4,124,110,234,147
0132-000,2012,8,17,5,124,96,220,234
0132-000,2012,8,17,6,210,169,379,220
0132-000,2012,8,17,7,388,507,895,379
0132-000,2012,8,17,8,744,1640,2384,895
0132-000,2012,8,17,9,870,1424,2294,2384
0132-000,2012,8,17,10,957,1109,2066,2294
0132-000,2012,8,17,11,963,1068,2031,2066
0132-000,2012,8,17,12,993,1109,2102,2031
0132-000,2012,8,17,13,973,988,1961,2102
0132-000,2012,8,17,14,991,1000,1991,1961
0132-000,2012,8,17,15,1041,1091,2132,1991
0132-000,2012,8,17,16,1096,1073,2169,2132
0132-000,2012,8,17,17,1119,1082,2201,2169
0132-000,2012,8,17,18,1322,1048,2370,2201
0132-000,2012,8,17,19,1490,1201,2691,2370
0132-000,2012,8,17,20,1135,1025,2160,2691
0132-000,2012,8,17,21,1114,690,1804,2160
0132-000,2012,8,17,22,854,569,1423,1804
0132-000,2012,8,17,23,555,473,1028,1423
0132-000,2012,8,17,24,347,306,653,1028
0132-000,2012,8,18,1,315,233,548,653
0132-000,2012,8,18,2,201,215,416,548
0132-000,2012,8,18,3,128,142,270,416
0132-000,2012,8,18,4,101,112,213,270
0132-000,2012,8,18,5,147,131,278,213
0132-000,2012,8,18,6,208,153,361,278
0132-000,2012,8,18,7,384,338,722,361
0132-000,2012,8,18,8,557,872,1429,722
0132-000,2012,8,18,9,806,909,1715,1429
0132-000,2012,8,18,10,822,959,1781,1715
0132-000,2012,8,18,11,881,1212,2093,1781
0132-000,2012,8,18,12,977,1376,2353,2093
0132-000,2012,8,18,13,927,1342,2269,2353
0132-000,2012,8,18,14,740,1294,2034,2269
0132-000,2012,8,18,15,852,1338,2190,2034
0132-000,2012,8,18,16,945,1096,2041,2190
0132-000,2012,8,18,17,1000,1055,2055,2041
0132-000,2012,8,18,18,1215,1027,2242,2055
0132-000,2012,8,18,19,1148,943,2091,2242
0132-000,2012,8,18,20,833,769,1602,2091
0132-000,2012,8,18,21,785,587,1372,1602
0132-000,2012,8,18,22,710,530,1240,1372
0132-000,2012,8,18,23,393,411,804,1240
0132-000,2012,8,18,24,288,281,569,804
0132-000,2012,8,19,1,220,231,451,569
0132-000,2012,8,19,2,188,135,323,451
0132-000,2012,8,19,3,133,115,248,323
0132-000,2012,8,19,4,126,96,222,248
0132-000,2012,8,19,5,105,71,176,222
0132-000,2012,8,19,6,133,160,293,176
0132-000,2012,8,19,7,261,236,497,293
0132-000,2012,8,19,8,343,345,688,497
0132-000,2012,8,19,9,489,482,971,688
0132-000,2012,8,19,10,514,489,1003,971
0132-000,2012,8,19,11,630,639,1269,1003
0132-000,2012,8,19,12,653,708,1361,1269
0132-000,2012,8,19,13,744,694,1438,1361
0132-000,2012,8,19,14,852,774,1626,1438
0132-000,2012,8,19,15,813,793,1606,1626
0132-000,2012,8,19,16,1030,740,1770,1606
0132-000,2012,8,19,17,1055,772,1827,1770
0132-000,2012,8,19,18,1151,804,1955,1827
0132-000,2012,8,19,19,993,692,1685,1955
0132-000,2012,8,19,20,811,594,1405,1685
0132-000,2012,8,19,21,772,534,1306,1405
0132-000,2012,8,19,22,683,516,1199,1306
0132-000,2012,8,19,23,370,329,699,1199
0132-000,2012,8,19,24,279,245,524,699
0132-000,2012,8,20,1,135,174,309,524
0132-000,2012,8,20,2,105,135,240,309
0132-000,2012,8,20,3,101,76,177,240
0132-000,2012,8,20,4,69,96,165,177
0132-000,2012,8,20,5,110,117,227,165
0132-000,2012,8,20,6,215,206,421,227
0132-000,2012,8,20,7,489,699,1188,421
0132-000,2012,8,20,8,710,1790,2500,1188
0132-000,2012,8,20,9,861,1568,2429,2500
0132-000,2012,8,20,10,915,1050,1965,2429
0132-000,2012,8,20,11,893,1009,1902,1965
0132-000,2012,8,20,12,975,847,1822,1902
0132-000,2012,8,20,13,788,863,1651,1822
0132-000,2012,8,20,14,918,899,1817,1651
0132-000,2012,8,20,15,1018,1093,2111,1817
0132-000,2012,8,20,16,1068,982,2050,2111
0132-000,2012,8,20,17,1036,936,1972,2050
0132-000,2012,8,20,18,1198,904,2102,1972
0132-000,2012,8,20,19,1246,993,2239,2102
0132-000,2012,8,20,20,1011,776,1787,2239
0132-000,2012,8,20,21,799,607,1406,1787
0132-000,2012,8,20,22,633,432,1065,1406
0132-000,2012,8,20,23,398,336,734,1065
0132-000,2012,8,20,24,274,226,500,734
0132-000,2012,8,21,1,210,144,354,500
0132-000,2012,8,21,2,144,124,268,354
0132-000,2012,8,21,3,92,101,193,268
0132-000,2012,8,21,4,76,96,172,193
0132-000,2012,8,21,5,121,89,210,172
0132-000,2012,8,21,6,197,163,360,210
0132-000,2012,8,21,7,363,473,836,360
0132-000,2012,8,21,8,710,1670,2380,836
0132-000,2012,8,21,9,884,1433,2317,2380
0132-000,2012,8,21,10,842,1123,1965,2317
0132-000,2012,8,21,11,927,1023,1950,1965
0132-000,2012,8,21,12,941,1064,2005,1950
0132-000,2012,8,21,13,831,925,1756,2005
0132-000,2012,8,21,14,915,984,1899,1756
0132-000,2012,8,21,15,1050,1020,2070,1899
0132-000,2012,8,21,16,1057,970,2027,2070
0132-000,2012,8,21,17,1046,991,2037,2027
0132-000,2012,8,21,18,1203,888,2091,2037
0132-000,2012,8,21,19,1275,906,2181,2091
0132-000,2012,8,21,20,950,854,1804,2181
0132-000,2012,8,21,21,854,594,1448,1804
0132-000,2012,8,21,22,614,457,1071,1448
0132-000,2012,8,21,23,432,320,752,1071
0132-000,2012,8,21,24,304,208,512,752
0132-000,2012,8,22,1,197,181,378,512
0132-000,2012,8,22,2,140,128,268,378
0132-000,2012,8,22,3,99,96,195,268
0132-000,2012,8,22,4,99,99,198,195
0132-000,2012,8,22,5,87,87,174,198
0132-000,2012,8,22,6,194,128,322,174
0132-000,2012,8,22,7,354,434,788,322
0132-000,2012,8,22,8,699,1746,2445,788
0132-000,2012,8,22,9,858,1465,2323,2445
0132-000,2012,8,22,10,829,998,1827,2323
0132-000,2012,8,22,11,813,904,1717,1827
0132-000,2012,8,22,12,904,915,1819,1717
0132-000,2012,8,22,13,863,897,1760,1819
0132-000,2012,8,22,14,986,966,1952,1760
0132-000,2012,8,22,15,1016,1025,2041,1952
0132-000,2012,8,22,16,1089,957,2046,2041
0132-000,2012,8,22,17,1020,913,1933,2046
0132-000,2012,8,22,18,1194,938,2132,1933
0132-000,2012,8,22,19,1362,1020,2382,2132
0132-000,2012,8,22,20,909,804,1713,2382
0132-000,2012,8,22,21,724,639,1363,1713
0132-000,2012,8,22,22,603,480,1083,1363
0132-000,2012,8,22,23,464,345,809,1083
0132-000,2012,8,22,24,318,245,563,809
0132-000,2012,8,23,1,220,172,392,563
0132-000,2012,8,23,2,185,135,320,392
0132-000,2012,8,23,3,99,117,216,320
0132-000,2012,8,23,4,99,110,209,216
0132-000,2012,8,23,5,103,110,213,209
0132-000,2012,8,23,6,217,217,434,213
0132-000,2012,8,23,7,409,487,896,434
0132-000,2012,8,23,8,703,1768,2471,896
0132-000,2012,8,23,9,911,1477,2388,2471
0132-000,2012,8,23,10,906,1071,1977,2388
0132-000,2012,8,23,11,877,1002,1879,1977
0132-000,2012,8,23,12,881,998,1879,1879
0132-000,2012,8,23,13,913,831,1744,1879
0132-000,2012,8,23,14,861,998,1859,1744
0132-000,2012,8,23,15,1043,925,1968,1859
0132-000,2012,8,23,16,1046,909,1955,1968
0132-000,2012,8,23,17,1109,1030,2139,1955
0132-000,2012,8,23,18,1212,959,2171,2139
0132-000,2012,8,23,19,1247,920,2167,2171
0132-000,2012,8,23,20,1103,854,1957,2167
0132-000,2012,8,23,21,888,575,1463,1957
0132-000,2012,8,23,22,724,518,1242,1463
0132-000,2012,8,23,23,416,361,777,1242
0132-000,2012,8,23,24,309,245,554,777
0132-000,2012,8,24,1,233,160,393,554
0132-000,2012,8,24,2,188,147,335,393
0132-000,2012,8,24,3,115,108,223,335
0132-000,2012,8,24,4,78,108,186,223
0132-000,2012,8,24,5,133,126,259,186
0132-000,2012,8,24,6,199,131,330,259
0132-000,2012,8,24,7,413,445,858,330
0132-000,2012,8,24,8,699,1717,2416,858
0132-000,2012,8,24,9,906,1379,2285,2416
0132-000,2012,8,24,10,893,1055,1948,2285
0132-000,2012,8,24,11,1004,1032,2036,1948
0132-000,2012,8,24,12,991,1125,2116,2036
0132-000,2012,8,24,13,915,909,1824,2116
0132-000,2012,8,24,14,1046,938,1984,1824
0132-000,2012,8,24,15,1061,1135,2196,1984
0132-000,2012,8,24,16,1100,1048,2148,2196
0132-000,2012,8,24,17,1105,947,2052,2148
0132-000,2012,8,24,18,1411,936,2347,2052
0132-000,2012,8,24,19,1641,1077,2718,2347
0132-000,2012,8,24,20,1148,973,2121,2718
0132-000,2012,8,24,21,899,660,1559,2121
0132-000,2012,8,24,22,683,591,1274,1559
0132-000,2012,8,24,23,480,436,916,1274
0132-000,2012,8,24,24,354,306,660,916
0132-000,2012,8,25,1,226,236,462,660
0132-000,2012,8,25,2,192,188,380,462
0132-000,2012,8,25,3,128,124,252,380
0132-000,2012,8,25,4,110,142,252,252
0132-000,2012,8,25,5,140,140,280,252
0132-000,2012,8,25,6,199,160,359,280
0132-000,2012,8,25,7,340,304,644,359
0132-000,2012,8,25,8,546,895,1441,644
0132-000,2012,8,25,9,785,925,1710,1441
0132-000,2012,8,25,10,874,1103,1977,1710
0132-000,2012,8,25,11,888,1176,2064,1977
0132-000,2012,8,25,12,1039,1374,2413,2064
0132-000,2012,8,25,13,1039,1486,2525,2413
0132-000,2012,8,25,14,1018,1303,2321,2525
0132-000,2012,8,25,15,1023,1194,2217,2321
0132-000,2012,8,25,16,1148,1338,2486,2217
0132-000,2012,8,25,17,1246,1595,2841,2486
0132-000,2012,8,25,18,1456,1583,3039,2841
0132-000,2012,8,25,19,1210,1436,2646,3039
0132-000,2012,8,25,20,884,872,1756,2646
0132-000,2012,8,25,21,774,655,1429,1756
0132-000,2012,8,25,22,651,582,1233,1429
0132-000,2012,8,25,23,480,459,939,1233
0132-000,2012,8,25,24,359,245,604,939
0132-000,2012,8,26,1,263,208,471,604
0132-000,2012,8,26,2,183,121,304,471
0132-000,2012,8,26,3,147,103,250,304
0132-000,2012,8,26,4,115,89,204,250
0132-000,2012,8,26,5,140,94,234,204
0132-000,2012,8,26,6,160,153,313,234
0132-000,2012,8,26,7,242,254,496,313
0132-000,2012,8,26,8,423,459,882,496
0132-000,2012,8,26,9,557,653,1210,882
0132-000,2012,8,26,10,603,655,1258,1210
0132-000,2012,8,26,11,717,836,1553,1258
0132-000,2012,8,26,12,783,845,1628,1553
0132-000,2012,8,26,13,943,776,1719,1628
0132-000,2012,8,26,14,1084,737,1821,1719
0132-000,2012,8,26,15,1073,779,1852,1821
0132-000,2012,8,26,16,1139,740,1879,1852
0132-000,2012,8,26,17,1328,824,2152,1879
0132-000,2012,8,26,18,1331,977,2308,2152
0132-000,2012,8,26,19,1333,785,2118,2308
0132-000,2012,8,26,20,1103,582,1685,2118
0132-000,2012,8,26,21,975,617,1592,1685
0132-000,2012,8,26,22,706,605,1311,1592
0132-000,2012,8,26,23,459,436,895,1311
0132-000,2012,8,26,24,286,272,558,895
0132-000,2012,8,27,1,188,188,376,558
0132-000,2012,8,27,2,101,119,220,376
0132-000,2012,8,27,3,76,76,152,220
0132-000,2012,8,27,4,96,80,176,152
0132-000,2012,8,27,5,128,135,263,176
0132-000,2012,8,27,6,242,245,487,263
0132-000,2012,8,27,7,548,724,1272,487
0132-000,2012,8,27,8,822,1975,2797,1272
0132-000,2012,8,27,9,911,1566,2477,2797
0132-000,2012,8,27,10,847,1130,1977,2477
0132-000,2012,8,27,11,899,1011,1910,1977
0132-000,2012,8,27,12,1002,1039,2041,1910
0132-000,2012,8,27,13,936,1007,1943,2041
0132-000,2012,8,27,14,979,1128,2107,1943
0132-000,2012,8,27,15,1039,1096,2135,2107
0132-000,2012,8,27,16,1089,1077,2166,2135
0132-000,2012,8,27,17,1148,1016,2164,2166
0132-000,2012,8,27,18,1395,1034,2429,2164
0132-000,2012,8,27,19,1326,1016,2342,2429
0132-000,2012,8,27,20,1148,938,2086,2342
0132-000,2012,8,27,21,879,708,1587,2086
0132-000,2012,8,27,22,701,566,1267,1587
0132-000,2012,8,27,23,450,384,834,1267
0132-000,2012,8,27,24,277,231,508,834
0132-000,2012,8,28,1,167,185,352,508
0132-000,2012,8,28,2,115,94,209,352
0132-000,2012,8,28,3,92,76,168,209
0132-000,2012,8,28,4,112,76,188,168
0132-000,2012,8,28,5,89,83,172,188
0132-000,2012,8,28,6,151,153,304,172
0132-000,2012,8,28,7,343,398,741,304
0132-000,2012,8,28,8,642,1495,2137,741
0132-000,2012,8,28,9,806,1237,2043,2137
0132-000,2012,8,28,10,669,722,1391,2043
0132-000,2012,8,28,11,651,646,1297,1391
0132-000,2012,8,28,12,628,566,1194,1297
0132-000,2012,8,28,13,571,452,1023,1194
0132-000,2012,8,28,14,557,541,1098,1023
0132-000,2012,8,28,15,685,534,1219,1098
0132-000,2012,8,28,16,664,566,1230,1219
0132-000,2012,8,28,17,655,544,1199,1230
0132-000,2012,8,28,18,852,635,1487,1199
0132-000,2012,8,28,19,1006,667,1673,1487
0132-000,2012,8,28,20,751,525,1276,1673
0132-000,2012,8,28,21,605,366,971,1276
0132-000,2012,8,28,22,455,336,791,971
0132-000,2012,8,28,23,320,233,553,791
0132-000,2012,8,28,24,226,144,370,553
0132-000,2012,8,29,1,119,105,224,370
0132-000,2012,8,29,2,94,94,188,224
0132-000,2012,8,29,3,85,62,147,188
0132-000,2012,8,29,4,74,83,157,147
0132-000,2012,8,29,5,101,99,200,157
0132-000,2012,8,29,6,238,156,394,200
0132-000,2012,8,29,7,400,489,889,394
0132-000,2012,8,29,8,751,1707,2458,889
0132-000,2012,8,29,9,918,1666,2584,2458
0132-000,2012,8,29,10,881,1125,2006,2584
0132-000,2012,8,29,11,954,1082,2036,2006
0132-000,2012,8,29,12,968,1153,2121,2036
0132-000,2012,8,29,13,1014,1032,2046,2121
0132-000,2012,8,29,14,1052,1080,2132,2046
0132-000,2012,8,29,15,1121,1173,2294,2132
0132-000,2012,8,29,16,1196,1064,2260,2294
0132-000,2012,8,29,17,1139,1023,2162,2260
0132-000,2012,8,29,18,1340,941,2281,2162
0132-000,2012,8,29,19,1407,1002,2409,2281
0132-000,2012,8,29,20,1027,865,1892,2409
0132-000,2012,8,29,21,865,653,1518,1892
0132-000,2012,8,29,22,667,541,1208,1518
0132-000,2012,8,29,23,398,398,796,1208
0132-000,2012,8,29,24,306,254,560,796
0132-000,2012,8,30,1,217,160,377,560
0132-000,2012,8,30,2,163,147,310,377
0132-000,2012,8,30,3,144,121,265,310
0132-000,2012,8,30,4,96,105,201,265
0132-000,2012,8,30,5,128,105,233,201
0132-000,2012,8,30,6,151,153,304,233
0132-000,2012,8,30,7,388,423,811,304
0132-000,2012,8,30,8,664,1706,2370,811
0132-000,2012,8,30,9,838,1621,2459,2370
0132-000,2012,8,30,10,826,1041,1867,2459
0132-000,2012,8,30,11,858,929,1787,1867
0132-000,2012,8,30,12,815,895,1710,1787
0132-000,2012,8,30,13,911,899,1810,1710
0132-000,2012,8,30,14,863,993,1856,1810
0132-000,2012,8,30,15,975,884,1859,1856
0132-000,2012,8,30,16,1016,863,1879,1859
0132-000,2012,8,30,17,959,833,1792,1879
0132-000,2012,8,30,18,1153,836,1989,1792
0132-000,2012,8,30,19,1258,824,2082,1989
0132-000,2012,8,30,20,849,712,1561,2082
0132-000,2012,8,30,21,801,541,1342,1561
0132-000,2012,8,30,22,601,432,1033,1342
0132-000,2012,8,30,23,382,295,677,1033
0132-000,2012,8,30,24,256,201,457,677
0132-000,2012,8,31,1,204,167,371,457
0132-000,2012,8,31,2,135,144,279,371
0132-000,2012,8,31,3,108,103,211,279
0132-000,2012,8,31,4,83,87,170,211
0132-000,2012,8,31,5,96,124,220,170
0132-000,2012,8,31,6,188,115,303,220
0132-000,2012,8,31,7,386,457,843,303
0132-000,2012,8,31,8,744,1559,2303,843
0132-000,2012,8,31,9,925,1452,2377,2303
0132-000,2012,8,31,10,877,1146,2023,2377
0132-000,2012,8,31,11,938,1043,1981,2023
0132-000,2012,8,31,12,998,1030,2028,1981
0132-000,2012,8,31,13,970,1030,2000,2028
0132-000,2012,8,31,14,1030,1043,2073,2000
0132-000,2012,8,31,15,1107,1059,2166,2073
0132-000,2012,8,31,16,1176,1116,2292,2166
0132-000,2012,8,31,17,1201,1155,2356,2292
0132-000,2012,8,31,18,1500,1128,2628,2356
0132-000,2012,8,31,19,1507,991,2498,2628
0132-000,2012,8,31,20,1306,1023,2329,2498
0132-000,2012,8,31,21,986,744,1730,2329
0132-000,2012,8,31,22,788,703,1491,1730
0132-000,2012,8,31,23,553,489,1042,1491
0132-000,2012,8,31,24,368,359,727,1042
0132-000,2012,9,1,1,257,238,495,727
0132-000,2012,9,1,2,178,172,350,495
0132-000,2012,9,1,3,141,160,301,350
0132-000,2012,9,1,4,121,142,263,301
0132-000,2012,9,1,5,153,166,319,263
0132-000,2012,9,1,6,175,163,338,319
0132-000,2012,9,1,7,310,337,647,338
0132-000,2012,9,1,8,537,803,1340,647
0132-000,2012,9,1,9,716,990,1706,1340
0132-000,2012,9,1,10,753,1145,1898,1706
0132-000,2012,9,1,11,818,1432,2250,1898
0132-000,2012,9,1,12,922,1481,2403,2250
0132-000,2012,9,1,13,922,1485,2407,2403
0132-000,2012,9,1,14,943,1312,2255,2407
0132-000,2012,9,1,15,972,1158,2130,2255
0132-000,2012,9,1,16,1027,1067,2094,2130
0132-000,2012,9,1,17,1056,949,2005,2094
0132-000,2012,9,1,18,1230,930,2160,2005
0132-000,2012,9,1,19,1189,778,1967,2160
0132-000,2012,9,1,20,905,636,1541,1967
0132-000,2012,9,1,21,692,595,1287,1541
0132-000,2012,9,1,22,597,541,1138,1287
0132-000,2012,9,1,23,352,371,723,1138
0132-000,2012,9,1,24,285,308,593,723
0132-000,2012,9,2,1,227,204,431,593
0132-000,2012,9,2,2,156,159,315,431
0132-000,2012,9,2,3,117,112,229,315
0132-000,2012,9,2,4,110,115,225,229
0132-000,2012,9,2,5,116,100,216,225
0132-000,2012,9,2,6,124,141,265,216
0132-000,2012,9,2,7,260,292,552,265
0132-000,2012,9,2,8,340,459,799,552
0132-000,2012,9,2,9,492,591,1083,799
0132-000,2012,9,2,10,537,675,1212,1083
0132-000,2012,9,2,11,654,695,1349,1212
0132-000,2012,9,2,12,668,674,1342,1349
0132-000,2012,9,2,13,790,756,1546,1342
0132-000,2012,9,2,14,829,695,1524,1546
0132-000,2012,9,2,15,984,759,1743,1524
0132-000,2012,9,2,16,1076,669,1745,1743
0132-000,2012,9,2,17,1095,672,1767,1745
0132-000,2012,9,2,18,1186,696,1882,1767
0132-000,2012,9,2,19,1192,607,1799,1882
0132-000,2012,9,2,20,1009,525,1534,1799
0132-000,2012,9,2,21,778,507,1285,1534
0132-000,2012,9,2,22,630,418,1048,1285
0132-000,2012,9,2,23,396,340,736,1048
0132-000,2012,9,2,24,232,258,490,736
0132-000,2012,9,3,1,182,192,374,490
0132-000,2012,9,3,2,107,138,245,374
0132-000,2012,9,3,3,84,87,171,245
0132-000,2012,9,3,4,77,86,163,171
0132-000,2012,9,3,5,105,111,216,163
0132-000,2012,9,3,6,222,196,418,216
0132-000,2012,9,3,7,493,612,1105,418
0132-000,2012,9,3,8,719,1583,2302,1105
0132-000,2012,9,3,9,820,1409,2229,2302
0132-000,2012,9,3,10,826,1101,1927,2229
0132-000,2012,9,3,11,832,908,1740,1927
0132-000,2012,9,3,12,875,999,1874,1740
0132-000,2012,9,3,13,887,985,1872,1874
0132-000,2012,9,3,14,997,1061,2058,1872
0132-000,2012,9,3,15,1030,1056,2086,2058
0132-000,2012,9,3,16,1061,987,2048,2086
0132-000,2012,9,3,17,1075,887,1962,2048
0132-000,2012,9,3,18,1210,898,2108,1962
0132-000,2012,9,3,19,1215,873,2088,2108
0132-000,2012,9,3,20,925,718,1643,2088
0132-000,2012,9,3,21,801,571,1372,1643
0132-000,2012,9,3,22,666,440,1106,1372
0132-000,2012,9,3,23,410,351,761,1106
0132-000,2012,9,3,24,264,239,503,761
0132-000,2012,9,4,1,208,199,407,503
0132-000,2012,9,4,2,137,128,265,407
0132-000,2012,9,4,3,98,121,219,265
0132-000,2012,9,4,4,95,110,205,219
0132-000,2012,9,4,5,129,140,269,205
0132-000,2012,9,4,6,220,205,425,269
0132-000,2012,9,4,7,444,494,938,425
0132-000,2012,9,4,8,702,1324,2026,938
0132-000,2012,9,4,9,850,1353,2203,2026
0132-000,2012,9,4,10,865,986,1851,2203
0132-000,2012,9,4,11,850,946,1796,1851
0132-000,2012,9,4,12,898,927,1825,1796
0132-000,2012,9,4,13,855,885,1740,1825
0132-000,2012,9,4,14,905,903,1808,1740
0132-000,2012,9,4,15,1048,992,2040,1808
0132-000,2012,9,4,16,1087,966,2053,2040
0132-000,2012,9,4,17,1055,822,1877,2053
0132-000,2012,9,4,18,1110,897,2007,1877
0132-000,2012,9,4,19,1158,754,1912,2007
0132-000,2012,9,4,20,965,710,1675,1912
0132-000,2012,9,4,21,807,628,1435,1675
0132-000,2012,9,4,22,650,471,1121,1435
0132-000,2012,9,4,23,421,377,798,1121
0132-000,2012,9,4,24,290,245,535,798
0132-000,2012,9,5,1,199,163,362,535
0132-000,2012,9,5,2,95,113,208,362
0132-000,2012,9,5,3,99,141,240,208
0132-000,2012,9,5,4,68,79,147,240
0132-000,2012,9,5,5,109,117,226,147
0132-000,2012,9,5,6,189,162,351,226
0132-000,2012,9,5,7,379,420,799,351
0132-000,2012,9,5,8,647,1284,1931,799
0132-000,2012,9,5,9,844,1443,2287,1931
0132-000,2012,9,5,10,776,1061,1837,2287
0132-000,2012,9,5,11,897,990,1887,1837
0132-000,2012,9,5,12,897,858,1755,1887
0132-000,2012,9,5,13,829,865,1694,1755
0132-000,2012,9,5,14,823,869,1692,1694
0132-000,2012,9,5,15,934,959,1893,1692
0132-000,2012,9,5,16,1012,922,1934,1893
0132-000,2012,9,5,17,1108,886,1994,1934
0132-000,2012,9,5,18,1206,793,1999,1994
0132-000,2012,9,5,19,1167,760,1927,1999
0132-000,2012,9,5,20,966,764,1730,1927
0132-000,2012,9,5,21,764,554,1318,1730
0132-000,2012,9,5,22,604,442,1046,1318
0132-000,2012,9,5,23,432,372,804,1046
0132-000,2012,9,5,24,291,327,618,804
0132-000,2012,9,6,1,205,250,455,618
0132-000,2012,9,6,2,125,127,252,455
0132-000,2012,9,6,3,101,100,201,252
0132-000,2012,9,6,4,76,113,189,201
0132-000,2012,9,6,5,119,149,268,189
0132-000,2012,9,6,6,205,236,441,268
0132-000,2012,9,6,7,426,463,889,441
0132-000,2012,9,6,8,707,1437,2144,889
0132-000,2012,9,6,9,819,1385,2204,2144
0132-000,2012,9,6,10,819,1117,1936,2204
0132-000,2012,9,6,11,885,1055,1940,1936
0132-000,2012,9,6,12,936,1092,2028,1940
0132-000,2012,9,6,13,829,871,1700,2028
0132-000,2012,9,6,14,819,870,1689,1700
0132-000,2012,9,6,15,1007,924,1931,1689
0132-000,2012,9,6,16,1087,933,2020,1931
0132-000,2012,9,6,17,1091,867,1958,2020
0132-000,2012,9,6,18,1220,773,1993,1958
0132-000,2012,9,6,19,1215,853,2068,1993
0132-000,2012,9,6,20,1001,676,1677,2068
0132-000,2012,9,6,21,823,574,1397,1677
0132-000,2012,9,6,22,692,517,1209,1397
0132-000,2012,9,6,23,432,347,779,1209
0132-000,2012,9,6,24,277,260,537,779
0132-000,2012,9,7,1,215,219,434,537
0132-000,2012,9,7,2,129,159,288,434
0132-000,2012,9,7,3,95,79,174,288
0132-000,2012,9,7,4,78,112,190,174
0132-000,2012,9,7,5,119,134,253,190
0132-000,2012,9,7,6,219,191,410,253
0132-000,2012,9,7,7,400,450,850,410
0132-000,2012,9,7,8,672,1221,1893,850
0132-000,2012,9,7,9,829,1390,2219,1893
0132-000,2012,9,7,10,750,951,1701,2219
0132-000,2012,9,7,11,807,1004,1811,1701
0132-000,2012,9,7,12,901,1074,1975,1811
0132-000,2012,9,7,13,876,907,1783,1975
0132-000,2012,9,7,14,893,857,1750,1783
0132-000,2012,9,7,15,979,963,1942,1750
0132-000,2012,9,7,16,1130,955,2085,1942
0132-000,2012,9,7,17,1267,1124,2391,2085
0132-000,2012,9,7,18,1490,1038,2528,2391
0132-000,2012,9,7,19,1460,904,2364,2528
0132-000,2012,9,7,20,1140,860,2000,2364
0132-000,2012,9,7,21,897,707,1604,2000
0132-000,2012,9,7,22,725,551,1276,1604
0132-000,2012,9,7,23,455,384,839,1276
0132-000,2012,9,7,24,342,329,671,839
0132-000,2012,9,8,1,246,240,486,671
0132-000,2012,9,8,2,148,166,314,486
0132-000,2012,9,8,3,138,157,295,314
0132-000,2012,9,8,4,101,131,232,295
0132-000,2012,9,8,5,134,158,292,232
0132-000,2012,9,8,6,160,139,299,292
0132-000,2012,9,8,7,279,280,559,299
0132-000,2012,9,8,8,500,721,1221,559
0132-000,2012,9,8,9,705,946,1651,1221
0132-000,2012,9,8,10,711,1037,1748,1651
0132-000,2012,9,8,11,784,1346,2130,1748
0132-000,2012,9,8,12,936,1571,2507,2130
0132-000,2012,9,8,13,917,1692,2609,2507
0132-000,2012,9,8,14,999,1624,2623,2609
0132-000,2012,9,8,15,901,1370,2271,2623
0132-000,2012,9,8,16,1020,1229,2249,2271
0132-000,2012,9,8,17,1042,1036,2078,2249
0132-000,2012,9,8,18,1150,860,2010,2078
0132-000,2012,9,8,19,1108,673,1781,2010
0132-000,2012,9,8,20,881,547,1428,1781
0132-000,2012,9,8,21,682,635,1317,1428
0132-000,2012,9,8,22,588,561,1149,1317
0132-000,2012,9,8,23,353,323,676,1149
0132-000,2012,9,8,24,293,317,610,676
0132-000,2012,9,9,1,199,200,399,610
0132-000,2012,9,9,2,140,140,280,399
0132-000,2012,9,9,3,115,118,233,280
0132-000,2012,9,9,4,113,126,239,233
0132-000,2012,9,9,5,105,120,225,239
0132-000,2012,9,9,6,121,131,252,225
0132-000,2012,9,9,7,215,279,494,252
0132-000,2012,9,9,8,336,435,771,494
0132-000,2012,9,9,9,451,585,1036,771
0132-000,2012,9,9,10,500,626,1126,1036
0132-000,2012,9,9,11,619,670,1289,1126
0132-000,2012,9,9,12,623,688,1311,1289
0132-000,2012,9,9,13,784,767,1551,1311
0132-000,2012,9,9,14,850,737,1587,1551
0132-000,2012,9,9,15,1059,751,1810,1587
0132-000,2012,9,9,16,1136,591,1727,1810
0132-000,2012,9,9,17,1210,615,1825,1727
0132-000,2012,9,9,18,1339,615,1954,1825
0132-000,2012,9,9,19,1335,539,1874,1954
0132-000,2012,9,9,20,1208,486,1694,1874
0132-000,2012,9,9,21,911,437,1348,1694
0132-000,2012,9,9,22,702,332,1034,1348
0132-000,2012,9,9,23,408,328,736,1034
0132-000,2012,9,9,24,236,259,495,736
0132-000,2012,9,10,1,168,177,345,495
0132-000,2012,9,10,2,105,147,252,345
0132-000,2012,9,10,3,64,72,136,252
0132-000,2012,9,10,4,62,63,125,136
0132-000,2012,9,10,5,86,99,185,125
0132-000,2012,9,10,6,185,177,362,185
0132-000,2012,9,10,7,467,562,1029,362
0132-000,2012,9,10,8,711,1559,2270,1029
0132-000,2012,9,10,9,793,1422,2215,2270
0132-000,2012,9,10,10,813,1149,1962,2215
0132-000,2012,9,10,11,795,859,1654,1962
0132-000,2012,9,10,12,862,984,1846,1654
0132-000,2012,9,10,13,911,993,1904,1846
0132-000,2012,9,10,14,1036,1115,2151,1904
0132-000,2012,9,10,15,1054,1094,2148,2151
0132-000,2012,9,10,16,1136,992,2128,2148
0132-000,2012,9,10,17,1048,838,1886,2128
0132-000,2012,9,10,18,1177,869,2046,1886
0132-000,2012,9,10,19,1163,868,2031,2046
0132-000,2012,9,10,20,901,679,1580,2031
0132-000,2012,9,10,21,774,536,1310,1580
0132-000,2012,9,10,22,633,449,1082,1310
0132-000,2012,9,10,23,391,365,756,1082
0132-000,2012,9,10,24,248,221,469,756
0132-000,2012,9,11,1,215,219,434,469
0132-000,2012,9,11,2,109,119,228,434
0132-000,2012,9,11,3,101,130,231,228
0132-000,2012,9,11,4,89,100,189,231
0132-000,2012,9,11,5,107,148,255,189
0132-000,2012,9,11,6,215,198,413,255
0132-000,2012,9,11,7,432,466,898,413
0132-000,2012,9,11,8,680,1274,1954,898
0132-000,2012,9,11,9,842,1340,2182,1954
0132-000,2012,9,11,10,827,952,1779,2182
0132-000,2012,9,11,11,846,898,1744,1779
0132-000,2012,9,11,12,854,874,1728,1744
0132-000,2012,9,11,13,813,790,1603,1728
0132-000,2012,9,11,14,878,852,1730,1603
0132-000,2012,9,11,15,1005,916,1921,1730
0132-000,2012,9,11,16,1040,942,1982,1921
0132-000,2012,9,11,17,1038,779,1817,1982
0132-000,2012,9,11,18,1132,867,1999,1817
0132-000,2012,9,11,19,1091,671,1762,1999
0132-000,2012,9,11,20,1005,706,1711,1762
0132-000,2012,9,11,21,815,619,1434,1711
0132-000,2012,9,11,22,649,445,1094,1434
0132-000,2012,9,11,23,416,378,794,1094
0132-000,2012,9,11,24,281,252,533,794
0132-000,2012,9,12,1,191,213,404,533
0132-000,2012,9,12,2,125,122,247,404
0132-000,2012,9,12,3,111,110,221,247
0132-000,2012,9,12,4,91,107,198,221
0132-000,2012,9,12,5,95,96,191,198
0132-000,2012,9,12,6,183,128,311,191
0132-000,2012,9,12,7,432,431,863,311
0132-000,2012,9,12,8,692,1154,1846,863
0132-000,2012,9,12,9,813,1071,1884,1846
0132-000,2012,9,12,10,821,1039,1860,1884
0132-000,2012,9,12,11,831,964,1795,1860
0132-000,2012,9,12,12,842,882,1724,1795
0132-000,2012,9,12,13,811,801,1612,1724
0132-000,2012,9,12,14,889,893,1782,1612
0132-000,2012,9,12,15,940,934,1874,1782
0132-000,2012,9,12,16,966,910,1876,1874
0132-000,2012,9,12,17,1061,947,2008,1876
0132-000,2012,9,12,18,1192,996,2188,2008
0132-000,2012,9,12,19,1189,951,2140,2188
0132-000,2012,9,12,20,928,709,1637,2140
0132-000,2012,9,12,21,729,665,1394,1637
0132-000,2012,9,12,22,633,550,1183,1394
0132-000,2012,9,12,23,383,403,786,1183
0132-000,2012,9,12,24,289,320,609,786
0132-000,2012,9,13,1,187,200,387,609
0132-000,2012,9,13,2,129,119,248,387
0132-000,2012,9,13,3,84,109,193,248
0132-000,2012,9,13,4,99,126,225,193
0132-000,2012,9,13,5,113,176,289,225
0132-000,2012,9,13,6,193,194,387,289
0132-000,2012,9,13,7,430,507,937,387
0132-000,2012,9,13,8,623,1257,1880,937
0132-000,2012,9,13,9,801,1367,2168,1880
0132-000,2012,9,13,10,799,955,1754,2168
0132-000,2012,9,13,11,827,923,1750,1754
0132-000,2012,9,13,12,844,942,1786,1750
0132-000,2012,9,13,13,813,793,1606,1786
0132-000,2012,9,13,14,872,988,1860,1606
0132-000,2012,9,13,15,827,783,1610,1860
0132-000,2012,9,13,16,909,859,1768,1610
0132-000,2012,9,13,17,983,862,1845,1768
0132-000,2012,9,13,18,1122,782,1904,1845
0132-000,2012,9,13,19,1117,838,1955,1904
0132-000,2012,9,13,20,833,590,1423,1955
0132-000,2012,9,13,21,774,589,1363,1423
0132-000,2012,9,13,22,631,400,1031,1363
0132-000,2012,9,13,23,420,326,746,1031
0132-000,2012,9,13,24,267,251,518,746
0132-000,2012,9,14,1,244,259,503,518
0132-000,2012,9,14,2,125,128,253,503
0132-000,2012,9,14,3,113,124,237,253
0132-000,2012,9,14,4,93,110,203,237
0132-000,2012,9,14,5,113,138,251,203
0132-000,2012,9,14,6,203,192,395,251
0132-000,2012,9,14,7,387,436,823,395
0132-000,2012,9,14,8,639,1274,1913,823
0132-000,2012,9,14,9,827,1345,2172,1913
0132-000,2012,9,14,10,803,957,1760,2172
0132-000,2012,9,14,11,809,961,1770,1760
0132-000,2012,9,14,12,901,940,1841,1770
0132-000,2012,9,14,13,858,837,1695,1841
0132-000,2012,9,14,14,956,991,1947,1695
0132-000,2012,9,14,15,1028,1007,2035,1947
0132-000,2012,9,14,16,1030,928,1958,2035
0132-000,2012,9,14,17,1012,827,1839,1958
0132-000,2012,9,14,18,1288,763,2051,1839
0132-000,2012,9,14,19,1338,739,2077,2051
0132-000,2012,9,14,20,1081,784,1865,2077
0132-000,2012,9,14,21,915,703,1618,1865
0132-000,2012,9,14,22,748,593,1341,1618
0132-000,2012,9,14,23,479,468,947,1341
0132-000,2012,9,14,24,330,295,625,947
0132-000,2012,9,15,1,269,261,530,625
0132-000,2012,9,15,2,179,184,363,530
0132-000,2012,9,15,3,140,159,299,363
0132-000,2012,9,15,4,117,151,268,299
0132-000,2012,9,15,5,154,193,347,268
0132-000,2012,9,15,6,213,169,382,347
0132-000,2012,9,15,7,371,389,760,382
0132-000,2012,9,15,8,563,762,1325,760
0132-000,2012,9,15,9,680,949,1629,1325
0132-000,2012,9,15,10,711,1033,1744,1629
0132-000,2012,9,15,11,772,1445,2217,1744
0132-000,2012,9,15,12,688,1359,2047,2217
0132-000,2012,9,15,13,969,1960,2929,2047
0132-000,2012,9,15,14,954,1560,2514,2929
0132-000,2012,9,15,15,956,1433,2389,2514
0132-000,2012,9,15,16,1106,1602,2708,2389
0132-000,2012,9,15,17,1198,1248,2446,2708
0132-000,2012,9,15,18,1449,1251,2700,2446
0132-000,2012,9,15,19,1487,1184,2671,2700
0132-000,2012,9,15,20,1251,973,2224,2671
0132-000,2012,9,15,21,1042,920,1962,2224
0132-000,2012,9,15,22,776,618,1394,1962
0132-000,2012,9,15,23,608,583,1191,1394
0132-000,2012,9,15,24,338,382,720,1191
0132-000,2012,9,16,1,189,186,375,720
0132-000,2012,9,16,2,146,149,295,375
0132-000,2012,9,16,3,136,140,276,295
0132-000,2012,9,16,4,80,85,165,276
0132-000,2012,9,16,5,129,108,237,165
0132-000,2012,9,16,6,146,157,303,237
0132-000,2012,9,16,7,265,302,567,303
0132-000,2012,9,16,8,357,464,821,567
0132-000,2012,9,16,9,467,667,1134,821
0132-000,2012,9,16,10,512,630,1142,1134
0132-000,2012,9,16,11,678,771,1449,1142
0132-000,2012,9,16,12,795,897,1692,1449
0132-000,2012,9,16,13,1173,1110,2283,1692
0132-000,2012,9,16,14,1136,992,2128,2283
0132-000,2012,9,16,15,1396,1090,2486,2128
0132-000,2012,9,16,16,1583,862,2445,2486
0132-000,2012,9,16,17,1654,761,2415,2445
0132-000,2012,9,16,18,1847,797,2644,2415
0132-000,2012,9,16,19,1859,707,2566,2644
0132-000,2012,9,16,20,1742,727,2469,2566
0132-000,2012,9,16,21,1470,615,2085,2469
0132-000,2012,9,16,22,764,344,1108,2085
0132-000,2012,9,16,23,580,330,910,1108
0132-000,2012,9,16,24,275,234,509,910
0132-000,2012,9,17,1,146,132,278,509
0132-000,2012,9,17,2,99,122,221,278
0132-000,2012,9,17,3,84,96,180,221
0132-000,2012,9,17,4,68,89,157,180
0132-000,2012,9,17,5,89,126,215,157
0132-000,2012,9,17,6,174,184,358,215
0132-000,2012,9,17,7,400,487,887,358
0132-000,2012,9,17,8,676,1488,2164,887
0132-000,2012,9,17,9,739,1359,2098,2164
0132-000,2012,9,17,10,731,901,1632,2098
0132-000,2012,9,17,11,768,842,1610,1632
0132-000,2012,9,17,12,692,741,1433,1610
0132-000,2012,9,17,13,766,822,1588,1433
0132-000,2012,9,17,14,741,790,1531,1588
0132-000,2012,9,17,15,774,747,1521,1531
0132-000,2012,9,17,16,840,832,1672,1521
0132-000,2012,9,17,17,819,743,1562,1672
0132-000,2012,9,17,18,1018,763,1781,1562
0132-000,2012,9,17,19,1064,722,1786,1781
0132-000,2012,9,17,20,778,622,1400,1786
0132-000,2012,9,17,21,694,471,1165,1400
0132-000,2012,9,17,22,504,385,889,1165
0132-000,2012,9,17,23,340,308,648,889
0132-000,2012,9,17,24,262,212,474,648
0132-000,2012,9,18,1,187,190,377,474
0132-000,2012,9,18,2,107,89,196,377
0132-000,2012,9,18,3,78,82,160,196
0132-000,2012,9,18,4,72,83,155,160
0132-000,2012,9,18,5,105,155,260,155
0132-000,2012,9,18,6,185,182,367,260
0132-000,2012,9,18,7,371,397,768,367
0132-000,2012,9,18,8,660,1261,1921,768
0132-000,2012,9,18,9,840,1340,2180,1921
0132-000,2012,9,18,10,801,1135,1936,2180
0132-000,2012,9,18,11,881,954,1835,1936
0132-000,2012,9,18,12,907,1081,1988,1835
0132-000,2012,9,18,13,813,891,1704,1988
0132-000,2012,9,18,14,932,966,1898,1704
0132-000,2012,9,18,15,979,958,1937,1898
0132-000,2012,9,18,16,1044,954,1998,1937
0132-000,2012,9,18,17,1030,819,1849,1998
0132-000,2012,9,18,18,1159,869,2028,1849
0132-000,2012,9,18,19,1192,862,2054,2028
0132-000,2012,9,18,20,936,716,1652,2054
0132-000,2012,9,18,21,719,497,1216,1652
0132-000,2012,9,18,22,641,399,1040,1216
0132-000,2012,9,18,23,455,379,834,1040
0132-000,2012,9,18,24,303,290,593,834
0132-000,2012,9,19,1,219,199,418,593
0132-000,2012,9,19,2,138,135,273,418
0132-000,2012,9,19,3,107,130,237,273
0132-000,2012,9,19,4,111,118,229,237
0132-000,2012,9,19,5,129,136,265,229
0132-000,2012,9,19,6,234,187,421,265
0132-000,2012,9,19,7,481,474,955,421
0132-000,2012,9,19,8,684,1506,2190,955
0132-000,2012,9,19,9,807,1285,2092,2190
0132-000,2012,9,19,10,848,954,1802,2092
0132-000,2012,9,19,11,842,969,1811,1802
0132-000,2012,9,19,12,924,889,1813,1811
0132-000,2012,9,19,13,844,863,1707,1813
0132-000,2012,9,19,14,905,936,1841,1707
0132-000,2012,9,19,15,1001,918,1919,1841
0132-000,2012,9,19,16,1054,911,1965,1919
0132-000,2012,9,19,17,1052,840,1892,1965
0132-000,2012,9,19,18,1206,832,2038,1892
0132-000,2012,9,19,19,1259,844,2103,2038
0132-000,2012,9,19,20,977,719,1696,2103
0132-000,2012,9,19,21,700,563,1263,1696
0132-000,2012,9,19,22,635,455,1090,1263
0132-000,2012,9,19,23,395,387,782,1090
0132-000,2012,9,19,24,301,264,565,782
0132-000,2012,9,20,1,193,193,386,565
0132-000,2012,9,20,2,140,139,279,386
0132-000,2012,9,20,3,144,112,256,279
0132-000,2012,9,20,4,117,127,244,256
0132-000,2012,9,20,5,138,146,284,244
0132-000,2012,9,20,6,224,170,394,284
0132-000,2012,9,20,7,443,500,943,394
0132-000,2012,9,20,8,660,1479,2139,943
0132-000,2012,9,20,9,878,1319,2197,2139
0132-000,2012,9,20,10,864,1009,1873,2197
0132-000,2012,9,20,11,805,960,1765,1873
0132-000,2012,9,20,12,901,941,1842,1765
0132-000,2012,9,20,13,823,826,1649,1842
0132-000,2012,9,20,14,944,937,1881,1649
0132-000,2012,9,20,15,983,947,1930,1881
0132-000,2012,9,20,16,1118,898,2016,1930
0132-000,2012,9,20,17,1079,895,1974,2016
0132-000,2012,9,20,18,1202,873,2075,1974
0132-000,2012,9,20,19,1196,899,2095,2075
0132-000,2012,9,20,20,1012,791,1803,2095
0132-000,2012,9,20,21,821,545,1366,1803
0132-000,2012,9,20,22,721,504,1225,1366
0132-000,2012,9,20,23,449,408,857,1225
0132-000,2012,9,20,24,299,277,576,857
0132-000,2012,9,21,1,209,198,407,576
0132-000,2012,9,21,2,158,126,284,407
0132-000,2012,9,21,3,117,114,231,284
0132-000,2012,9,21,4,93,123,216,231
0132-000,2012,9,21,5,109,148,257,216
0132-000,2012,9,21,6,213,193,406,257
0132-000,2012,9,21,7,445,480,925,406
0132-000,2012,9,21,8,709,1533,2242,925
0132-000,2012,9,21,9,883,1241,2124,2242
0132-000,2012,9,21,10,844,1008,1852,2124
0132-000,2012,9,21,11,833,962,1795,1852
0132-000,2012,9,21,12,917,949,1866,1795
0132-000,2012,9,21,13,803,894,1697,1866
0132-000,2012,9,21,14,827,943,1770,1697
0132-000,2012,9,21,15,1020,994,2014,1770
0132-000,2012,9,21,16,1085,962,2047,2014
0132-000,2012,9,21,17,1134,864,1998,2047
0132-000,2012,9,21,18,1255,946,2201,1998
0132-000,2012,9,21,19,1410,952,2362,2201
0132-000,2012,9,21,20,1108,807,1915,2362
0132-000,2012,9,21,21,924,593,1517,1915
0132-000,2012,9,21,22,762,571,1333,1517
0132-000,2012,9,21,23,506,436,942,1333
0132-000,2012,9,21,24,410,343,753,942
0132-000,2012,9,22,1,267,236,503,753
0132-000,2012,9,22,2,207,177,384,503
0132-000,2012,9,22,3,144,163,307,384
0132-000,2012,9,22,4,140,152,292,307
0132-000,2012,9,22,5,172,173,345,292
0132-000,2012,9,22,6,189,187,376,345
0132-000,2012,9,22,7,340,394,734,376
0132-000,2012,9,22,8,574,884,1458,734
0132-000,2012,9,22,9,727,1034,1761,1458
0132-000,2012,9,22,10,795,1253,2048,1761
0132-000,2012,9,22,11,852,1517,2369,2048
0132-000,2012,9,22,12,907,1391,2298,2369
0132-000,2012,9,22,13,926,1277,2203,2298
0132-000,2012,9,22,14,887,1000,1887,2203
0132-000,2012,9,22,15,1042,945,1987,1887
0132-000,2012,9,22,16,1034,904,1938,1987
0132-000,2012,9,22,17,1069,861,1930,1938
0132-000,2012,9,22,18,1310,999,2309,1930
0132-000,2012,9,22,19,1269,883,2152,2309
0132-000,2012,9,22,20,928,725,1653,2152
0132-000,2012,9,22,21,702,555,1257,1653
0132-000,2012,9,22,22,606,520,1126,1257
0132-000,2012,9,22,23,350,418,768,1126
0132-000,2012,9,22,24,277,299,576,768
0132-000,2012,9,23,1,254,208,462,576
0132-000,2012,9,23,2,172,177,349,462
0132-000,2012,9,23,3,119,105,224,349
0132-000,2012,9,23,4,107,103,210,224
0132-000,2012,9,23,5,127,80,207,210
0132-000,2012,9,23,6,127,150,277,207
0132-000,2012,9,23,7,305,305,610,277
0132-000,2012,9,23,8,344,483,827,610
0132-000,2012,9,23,9,533,596,1129,827
0132-000,2012,9,23,10,574,723,1297,1129
0132-000,2012,9,23,11,688,720,1408,1297
0132-000,2012,9,23,12,713,660,1373,1408
0132-000,2012,9,23,13,795,744,1539,1373
0132-000,2012,9,23,14,807,653,1460,1539
0132-000,2012,9,23,15,909,767,1676,1460
0132-000,2012,9,23,16,1016,746,1762,1676
0132-000,2012,9,23,17,979,728,1707,1762
0132-000,2012,9,23,18,1032,776,1808,1707
0132-000,2012,9,23,19,1049,675,1724,1808
0132-000,2012,9,23,20,809,563,1372,1724
0132-000,2012,9,23,21,645,577,1222,1372
0132-000,2012,9,23,22,557,503,1060,1222
0132-000,2012,9,23,23,383,351,734,1060
0132-000,2012,9,23,24,228,256,484,734
0132-000,2012,9,24,1,195,206,401,484
0132-000,2012,9,24,2,109,128,237,401
0132-000,2012,9,24,3,103,101,204,237
0132-000,2012,9,24,4,91,108,199,204
0132-000,2012,9,24,5,123,122,245,199
0132-000,2012,9,24,6,258,215,473,245
0132-000,2012,9,24,7,518,662,1180,473
0132-000,2012,9,24,8,727,1607,2334,1180
0132-000,2012,9,24,9,846,1396,2242,2334
0132-000,2012,9,24,10,838,1053,1891,2242
0132-000,2012,9,24,11,868,957,1825,1891
0132-000,2012,9,24,12,887,1014,1901,1825
0132-000,2012,9,24,13,862,977,1839,1901
0132-000,2012,9,24,14,958,1007,1965,1839
0132-000,2012,9,24,15,1005,1017,2022,1965
0132-000,2012,9,24,16,985,982,1967,2022
0132-000,2012,9,24,17,1102,935,2037,1967
0132-000,2012,9,24,18,1243,927,2170,2037
0132-000,2012,9,24,19,1266,877,2143,2170
0132-000,2012,9,24,20,948,756,1704,2143
0132-000,2012,9,24,21,827,605,1432,1704
0132-000,2012,9,24,22,698,430,1128,1432
0132-000,2012,9,24,23,428,336,764,1128
0132-000,2012,9,24,24,279,256,535,764
0132-000,2012,9,25,1,201,178,379,535
0132-000,2012,9,25,2,164,136,300,379
0132-000,2012,9,25,3,95,111,206,300
0132-000,2012,9,25,4,101,119,220,206
0132-000,2012,9,25,5,150,131,281,220
0132-000,2012,9,25,6,224,211,435,281
0132-000,2012,9,25,7,455,521,976,435
0132-000,2012,9,25,8,723,1373,2096,976
0132-000,2012,9,25,9,858,1365,2223,2096
0132-000,2012,9,25,10,903,1019,1922,2223
0132-000,2012,9,25,11,854,994,1848,1922
0132-000,2012,9,25,12,942,980,1922,1848
0132-000,2012,9,25,13,897,980,1877,1922
0132-000,2012,9,25,14,932,953,1885,1877
0132-000,2012,9,25,15,1091,1068,2159,1885
0132-000,2012,9,25,16,1134,989,2123,2159
0132-000,2012,9,25,17,1071,864,1935,2123
0132-000,2012,9,25,18,1087,926,2013,1935
0132-000,2012,9,25,19,1224,836,2060,2013
0132-000,2012,9,25,20,924,713,1637,2060
0132-000,2012,9,25,21,799,636,1435,1637
0132-000,2012,9,25,22,651,497,1148,1435
0132-000,2012,9,25,23,426,376,802,1148
0132-000,2012,9,25,24,299,237,536,802
0132-000,2012,9,26,1,213,191,404,536
0132-000,2012,9,26,2,142,150,292,404
0132-000,2012,9,26,3,109,111,220,292
0132-000,2012,9,26,4,93,123,216,220
0132-000,2012,9,26,5,99,122,221,216
0132-000,2012,9,26,6,189,187,376,221
0132-000,2012,9,26,7,408,531,939,376
0132-000,2012,9,26,8,705,1453,2158,939
0132-000,2012,9,26,9,780,1366,2146,2158
0132-000,2012,9,26,10,784,1022,1806,2146
0132-000,2012,9,26,11,876,941,1817,1806
0132-000,2012,9,26,12,889,935,1824,1817
0132-000,2012,9,26,13,833,906,1739,1824
0132-000,2012,9,26,14,909,908,1817,1739
0132-000,2012,9,26,15,952,936,1888,1817
0132-000,2012,9,26,16,1079,972,2051,1888
0132-000,2012,9,26,17,1026,899,1925,2051
0132-000,2012,9,26,18,1212,844,2056,1925
0132-000,2012,9,26,19,1262,854,2116,2056
0132-000,2012,9,26,20,952,717,1669,2116
0132-000,2012,9,26,21,715,566,1281,1669
0132-000,2012,9,26,22,633,505,1138,1281
0132-000,2012,9,26,23,457,346,803,1138
0132-000,2012,9,26,24,305,264,569,803
0132-000,2012,9,27,1,199,198,397,569
0132-000,2012,9,27,2,138,134,272,397
0132-000,2012,9,27,3,115,120,235,272
0132-000,2012,9,27,4,86,113,199,235
0132-000,2012,9,27,5,111,129,240,199
0132-000,2012,9,27,6,191,191,382,240
0132-000,2012,9,27,7,400,485,885,382
0132-000,2012,9,27,8,705,1514,2219,885
0132-000,2012,9,27,9,840,1340,2180,2219
0132-000,2012,9,27,10,858,970,1828,2180
0132-000,2012,9,27,11,921,924,1845,1828
0132-000,2012,9,27,12,969,923,1892,1845
0132-000,2012,9,27,13,854,855,1709,1892
0132-000,2012,9,27,14,883,905,1788,1709
0132-000,2012,9,27,15,1073,930,2003,1788
0132-000,2012,9,27,16,977,939,1916,2003
0132-000,2012,9,27,17,1120,922,2042,1916
0132-000,2012,9,27,18,1171,930,2101,2042
0132-000,2012,9,27,19,1261,868,2129,2101
0132-000,2012,9,27,20,973,807,1780,2129
0132-000,2012,9,27,21,856,576,1432,1780
0132-000,2012,9,27,22,729,561,1290,1432
0132-000,2012,9,27,23,459,406,865,1290
0132-000,2012,9,27,24,293,296,589,865
0132-000,2012,9,28,1,222,195,417,589
0132-000,2012,9,28,2,172,140,312,417
0132-000,2012,9,28,3,129,122,251,312
0132-000,2012,9,28,4,89,115,204,251
0132-000,2012,9,28,5,125,134,259,204
0132-000,2012,9,28,6,197,171,368,259
0132-000,2012,9,28,7,404,464,868,368
0132-000,2012,9,28,8,631,1426,2057,868
0132-000,2012,9,28,9,881,1247,2128,2057
0132-000,2012,9,28,10,803,930,1733,2128
0132-000,2012,9,28,11,878,945,1823,1733
0132-000,2012,9,28,12,940,989,1929,1823
0132-000,2012,9,28,13,881,1083,1964,1929
0132-000,2012,9,28,14,928,1327,2255,1964
0132-000,2012,9,28,15,962,1427,2389,2255
0132-000,2012,9,28,16,1118,1661,2779,2389
0132-000,2012,9,28,17,1196,1815,3011,2779
0132-000,2012,9,28,18,1430,1828,3258,3011
0132-000,2012,9,28,19,1251,1714,2965,3258
0132-000,2012,9,28,20,926,1707,2633,2965
0132-000,2012,9,28,21,674,1682,2356,2633
0132-000,2012,9,28,22,569,1658,2227,2356
0132-000,2012,9,28,23,402,1634,2036,2227
0132-000,2012,9,28,24,299,1546,1845,2036
0132-000,2012,9,29,1,207,1654,1861,1845
0132-000,2012,9,29,2,158,1286,1444,1861
0132-000,2012,9,29,3,142,1335,1477,1444
0132-000,2012,9,29,4,158,1740,1898,1477
0132-000,2012,9,29,5,117,1941,2058,1898
0132-000,2012,9,29,6,125,1923,2048,2058
0132-000,2012,9,29,7,191,1765,1956,2048
0132-000,2012,9,29,8,346,1853,2199,1956
0132-000,2012,9,29,9,441,1874,2315,2199
0132-000,2012,9,29,10,582,1846,2428,2315
0132-000,2012,9,29,11,702,1872,2574,2428
0132-000,2012,9,29,12,718,1801,2519,2574
0132-000,2012,9,29,13,680,1844,2524,2519
0132-000,2012,9,29,14,635,1826,2461,2524
0132-000,2012,9,29,15,680,1847,2527,2461
0132-000,2012,9,29,16,614,1681,2295,2527
0132-000,2012,9,29,17,596,2156,2752,2295
0132-000,2012,9,29,18,545,1779,2324,2752
0132-000,2012,9,29,19,584,1364,1948,2324
0132-000,2012,9,29,20,451,962,1413,1948
0132-000,2012,9,29,21,350,835,1185,1413
0132-000,2012,9,29,22,338,500,838,1185
0132-000,2012,9,29,23,254,307,561,838
0132-000,2012,9,29,24,142,191,333,561
0132-000,2012,9,30,1,152,132,284,333
0132-000,2012,9,30,2,95,82,177,284
0132-000,2012,9,30,3,78,101,179,177
0132-000,2012,9,30,4,74,53,127,179
0132-000,2012,9,30,5,56,62,118,127
0132-000,2012,9,30,6,121,112,233,118
0132-000,2012,9,30,7,305,484,789,233
0132-000,2012,9,30,8,428,1054,1482,789
0132-000,2012,9,30,9,475,966,1441,1482
0132-000,2012,9,30,10,635,1060,1695,1441
0132-000,2012,9,30,11,1292,1593,2885,1695
0132-000,2012,9,30,12,1619,1744,3363,2885
0132-000,2012,9,30,13,1822,1750,3572,3363
0132-000,2012,9,30,14,2129,1835,3964,3572
0132-000,2012,9,30,15,1980,2061,4041,3964
0132-000,2012,9,30,16,2225,2087,4312,4041
0132-000,2012,9,30,17,2441,2223,4664,4312
0132-000,2012,9,30,18,2254,2156,4410,4664
0132-000,2012,9,30,19,1808,1796,3604,4410
0132-000,2012,9,30,20,1660,1837,3497,3604
0132-000,2012,9,30,21,1067,1199,2266,3497
0132-000,2012,9,30,22,887,919,1806,2266
0132-000,2012,9,30,23,637,429,1066,1806
0132-000,2012,9,30,24,438,244,682,1066
0132-000,2012,10,1,1,199,152,351,682
0132-000,2012,10,1,2,140,118,258,351
0132-000,2012,10,1,3,84,81,165,258
0132-000,2012,10,1,4,66,78,144,165
0132-000,2012,10,1,5,57,63,120,144
0132-000,2012,10,1,6,77,74,151,120
0132-000,2012,10,1,7,102,121,223,151
0132-000,2012,10,1,8,157,244,401,223
0132-000,2012,10,1,9,189,334,523,401
0132-000,2012,10,1,10,284,456,740,523
0132-000,2012,10,1,11,415,593,1008,740
0132-000,2012,10,1,12,499,756,1255,1008
0132-000,2012,10,1,13,495,791,1286,1255
0132-000,2012,10,1,14,542,869,1411,1286
0132-000,2012,10,1,15,624,802,1426,1411
0132-000,2012,10,1,16,606,718,1324,1426
0132-000,2012,10,1,17,698,603,1301,1324
0132-000,2012,10,1,18,728,554,1282,1301
0132-000,2012,10,1,19,694,479,1173,1282
0132-000,2012,10,1,20,721,458,1179,1173
0132-000,2012,10,1,21,686,384,1070,1179
0132-000,2012,10,1,22,645,333,978,1070
0132-000,2012,10,1,23,704,299,1003,978
0132-000,2012,10,1,24,630,207,837,1003
0132-000,2012,10,2,1,520,151,671,837
0132-000,2012,10,2,2,270,104,374,671
0132-000,2012,10,2,3,95,79,174,374
0132-000,2012,10,2,4,48,66,114,174
0132-000,2012,10,2,5,40,72,112,114
0132-000,2012,10,2,6,59,111,170,112
0132-000,2012,10,2,7,113,271,384,170
0132-000,2012,10,2,8,217,650,867,384
0132-000,2012,10,2,9,256,629,885,867
0132-000,2012,10,2,10,300,588,888,885
0132-000,2012,10,2,11,364,657,1021,888
0132-000,2012,10,2,12,411,742,1153,1021
0132-000,2012,10,2,13,430,688,1118,1153
0132-000,2012,10,2,14,460,715,1175,1118
0132-000,2012,10,2,15,575,696,1271,1175
0132-000,2012,10,2,16,620,626,1246,1271
0132-000,2012,10,2,17,706,617,1323,1246
0132-000,2012,10,2,18,701,665,1366,1323
0132-000,2012,10,2,19,783,611,1394,1366
0132-000,2012,10,2,20,670,508,1178,1394
0132-000,2012,10,2,21,509,415,924,1178
0132-000,2012,10,2,22,447,378,825,924
0132-000,2012,10,2,23,316,313,629,825
0132-000,2012,10,2,24,185,221,406,629
0132-000,2012,10,3,1,224,182,406,406
0132-000,2012,10,3,2,104,123,227,406
0132-000,2012,10,3,3,88,124,212,227
0132-000,2012,10,3,4,87,100,187,212
0132-000,2012,10,3,5,75,79,154,187
0132-000,2012,10,3,6,146,124,270,154
0132-000,2012,10,3,7,231,255,486,270
0132-000,2012,10,3,8,285,565,850,486
0132-000,2012,10,3,9,312,532,844,850
0132-000,2012,10,3,10,456,622,1078,844
0132-000,2012,10,3,11,575,634,1209,1078
0132-000,2012,10,3,12,739,706,1445,1209
0132-000,2012,10,3,13,597,622,1219,1445
0132-000,2012,10,3,14,638,672,1310,1219
0132-000,2012,10,3,15,652,669,1321,1310
0132-000,2012,10,3,16,766,697,1463,1321
0132-000,2012,10,3,17,845,675,1520,1463
0132-000,2012,10,3,18,1053,691,1744,1520
0132-000,2012,10,3,19,905,589,1494,1744
0132-000,2012,10,3,20,750,593,1343,1494
0132-000,2012,10,3,21,632,458,1090,1343
0132-000,2012,10,3,22,512,374,886,1090
0132-000,2012,10,3,23,318,273,591,886
0132-000,2012,10,3,24,160,179,339,591
0132-000,2012,10,4,1,120,145,265,339
0132-000,2012,10,4,2,85,86,171,265
0132-000,2012,10,4,3,64,63,127,171
0132-000,2012,10,4,4,59,86,145,127
0132-000,2012,10,4,5,97,121,218,145
0132-000,2012,10,4,6,147,168,315,218
0132-000,2012,10,4,7,505,548,1053,315
0132-000,2012,10,4,8,819,1663,2482,1053
0132-000,2012,10,4,9,751,1268,2019,2482
0132-000,2012,10,4,10,686,934,1620,2019
0132-000,2012,10,4,11,715,851,1566,1620
0132-000,2012,10,4,12,739,861,1600,1566
0132-000,2012,10,4,13,740,776,1516,1600
0132-000,2012,10,4,14,736,781,1517,1516
0132-000,2012,10,4,15,985,903,1888,1517
0132-000,2012,10,4,16,998,856,1854,1888
0132-000,2012,10,4,17,1047,831,1878,1854
0132-000,2012,10,4,18,1376,871,2247,1878
0132-000,2012,10,4,19,1090,765,1855,2247
0132-000,2012,10,4,20,913,616,1529,1855
0132-000,2012,10,4,21,686,478,1164,1529
0132-000,2012,10,4,22,578,431,1009,1164
0132-000,2012,10,4,23,341,273,614,1009
0132-000,2012,10,4,24,194,181,375,614
0132-000,2012,10,5,1,164,166,330,375
0132-000,2012,10,5,2,97,118,215,330
0132-000,2012,10,5,3,106,87,193,215
0132-000,2012,10,5,4,65,92,157,193
0132-000,2012,10,5,5,103,115,218,157
0132-000,2012,10,5,6,187,162,349,218
0132-000,2012,10,5,7,456,512,968,349
0132-000,2012,10,5,8,822,1493,2315,968
0132-000,2012,10,5,9,707,1185,1892,2315
0132-000,2012,10,5,10,737,933,1670,1892
0132-000,2012,10,5,11,746,926,1672,1670
0132-000,2012,10,5,12,776,924,1700,1672
0132-000,2012,10,5,13,754,780,1534,1700
0132-000,2012,10,5,14,915,877,1792,1534
0132-000,2012,10,5,15,904,889,1793,1792
0132-000,2012,10,5,16,1035,874,1909,1793
0132-000,2012,10,5,17,952,844,1796,1909
0132-000,2012,10,5,18,1262,878,2140,1796
0132-000,2012,10,5,19,1319,816,2135,2140
0132-000,2012,10,5,20,964,726,1690,2135
0132-000,2012,10,5,21,779,613,1392,1690
0132-000,2012,10,5,22,697,529,1226,1392
0132-000,2012,10,5,23,452,380,832,1226
0132-000,2012,10,5,24,265,254,519,832
0132-000,2012,10,6,1,227,220,447,519
0132-000,2012,10,6,2,143,160,303,447
0132-000,2012,10,6,3,110,124,234,303
0132-000,2012,10,6,4,97,125,222,234
0132-000,2012,10,6,5,108,126,234,222
0132-000,2012,10,6,6,192,166,358,234
0132-000,2012,10,6,7,362,363,725,358
0132-000,2012,10,6,8,640,921,1561,725
0132-000,2012,10,6,9,692,927,1619,1561
0132-000,2012,10,6,10,713,1038,1751,1619
0132-000,2012,10,6,11,699,1199,1898,1751
0132-000,2012,10,6,12,836,1403,2239,1898
0132-000,2012,10,6,13,667,1230,1897,2239
0132-000,2012,10,6,14,639,1037,1676,1897
0132-000,2012,10,6,15,586,890,1476,1676
0132-000,2012,10,6,16,723,870,1593,1476
0132-000,2012,10,6,17,872,866,1738,1593
0132-000,2012,10,6,18,1209,903,2112,1738
0132-000,2012,10,6,19,1319,800,2119,2112
0132-000,2012,10,6,20,1020,632,1652,2119
0132-000,2012,10,6,21,518,481,999,1652
0132-000,2012,10,6,22,469,447,916,999
0132-000,2012,10,6,23,361,330,691,916
0132-000,2012,10,6,24,255,275,530,691
0132-000,2012,10,7,1,215,214,429,530
0132-000,2012,10,7,2,150,149,299,429
0132-000,2012,10,7,3,97,99,196,299
0132-000,2012,10,7,4,89,98,187,196
0132-000,2012,10,7,5,71,80,151,187
0132-000,2012,10,7,6,133,143,276,151
0132-000,2012,10,7,7,200,259,459,276
0132-000,2012,10,7,8,342,442,784,459
0132-000,2012,10,7,9,387,501,888,784
0132-000,2012,10,7,10,451,563,1014,888
0132-000,2012,10,7,11,592,640,1232,1014
0132-000,2012,10,7,12,559,616,1175,1232
0132-000,2012,10,7,13,620,606,1226,1175
0132-000,2012,10,7,14,792,686,1478,1226
0132-000,2012,10,7,15,912,646,1558,1478
0132-000,2012,10,7,16,1396,725,2121,1558
0132-000,2012,10,7,17,1455,739,2194,2121
0132-000,2012,10,7,18,1404,644,2048,2194
0132-000,2012,10,7,19,1467,591,2058,2048
0132-000,2012,10,7,20,1387,557,1944,2058
0132-000,2012,10,7,21,843,404,1247,1944
0132-000,2012,10,7,22,849,401,1250,1247
0132-000,2012,10,7,23,385,309,694,1250
0132-000,2012,10,7,24,166,181,347,694
0132-000,2012,10,8,1,141,147,288,347
0132-000,2012,10,8,2,57,79,136,288
0132-000,2012,10,8,3,74,82,156,136
0132-000,2012,10,8,4,83,84,167,156
0132-000,2012,10,8,5,82,93,175,167
0132-000,2012,10,8,6,227,216,443,175
0132-000,2012,10,8,7,492,591,1083,443
0132-000,2012,10,8,8,764,1673,2437,1083
0132-000,2012,10,8,9,745,1334,2079,2437
0132-000,2012,10,8,10,687,970,1657,2079
0132-000,2012,10,8,11,778,840,1618,1657
0132-000,2012,10,8,12,747,851,1598,1618
0132-000,2012,10,8,13,806,877,1683,1598
0132-000,2012,10,8,14,848,911,1759,1683
0132-000,2012,10,8,15,848,879,1727,1759
0132-000,2012,10,8,16,1026,895,1921,1727
0132-000,2012,10,8,17,1107,884,1991,1921
0132-000,2012,10,8,18,1189,877,2066,1991
0132-000,2012,10,8,19,1126,840,1966,2066
0132-000,2012,10,8,20,883,665,1548,1966
0132-000,2012,10,8,21,732,506,1238,1548
0132-000,2012,10,8,22,662,469,1131,1238
0132-000,2012,10,8,23,345,321,666,1131
0132-000,2012,10,8,24,236,210,446,666
0132-000,2012,10,9,1,168,170,338,446
0132-000,2012,10,9,2,106,114,220,338
0132-000,2012,10,9,3,64,81,145,220
0132-000,2012,10,9,4,82,91,173,145
0132-000,2012,10,9,5,91,125,216,173
0132-000,2012,10,9,6,213,196,409,216
0132-000,2012,10,9,7,449,484,933,409
0132-000,2012,10,9,8,781,1462,2243,933
0132-000,2012,10,9,9,784,1247,2031,2243
0132-000,2012,10,9,10,817,940,1757,2031
0132-000,2012,10,9,11,928,984,1912,1757
0132-000,2012,10,9,12,866,885,1751,1912
0132-000,2012,10,9,13,835,811,1646,1751
0132-000,2012,10,9,14,938,909,1847,1646
0132-000,2012,10,9,15,1011,920,1931,1847
0132-000,2012,10,9,16,957,866,1823,1931
0132-000,2012,10,9,17,994,745,1739,1823
0132-000,2012,10,9,18,1108,848,1956,1739
0132-000,2012,10,9,19,1362,837,2199,1956
0132-000,2012,10,9,20,936,657,1593,2199
0132-000,2012,10,9,21,655,497,1152,1593
0132-000,2012,10,9,22,693,475,1168,1152
0132-000,2012,10,9,23,356,322,678,1168
0132-000,2012,10,9,24,214,191,405,678
0132-000,2012,10,10,1,163,181,344,405
0132-000,2012,10,10,2,122,118,240,344
0132-000,2012,10,10,3,112,110,222,240
0132-000,2012,10,10,4,93,108,201,222
0132-000,2012,10,10,5,100,100,200,201
0132-000,2012,10,10,6,260,181,441,200
0132-000,2012,10,10,7,446,444,890,441
0132-000,2012,10,10,8,881,1468,2349,890
0132-000,2012,10,10,9,980,1290,2270,2349
0132-000,2012,10,10,10,766,968,1734,2270
0132-000,2012,10,10,11,795,921,1716,1734
0132-000,2012,10,10,12,880,920,1800,1716
0132-000,2012,10,10,13,774,763,1537,1800
0132-000,2012,10,10,14,798,800,1598,1537
0132-000,2012,10,10,15,860,854,1714,1598
0132-000,2012,10,10,16,939,884,1823,1714
0132-000,2012,10,10,17,907,809,1716,1823
0132-000,2012,10,10,18,968,808,1776,1716
0132-000,2012,10,10,19,1016,812,1828,1776
0132-000,2012,10,10,20,849,648,1497,1828
0132-000,2012,10,10,21,535,487,1022,1497
0132-000,2012,10,10,22,498,432,930,1022
0132-000,2012,10,10,23,318,334,652,930
0132-000,2012,10,10,24,201,222,423,652
0132-000,2012,10,11,1,170,181,351,423
0132-000,2012,10,11,2,157,144,301,351
0132-000,2012,10,11,3,72,92,164,301
0132-000,2012,10,11,4,79,100,179,164
0132-000,2012,10,11,5,67,103,170,179
0132-000,2012,10,11,6,156,156,312,170
0132-000,2012,10,11,7,409,481,890,312
0132-000,2012,10,11,8,733,1478,2211,890
0132-000,2012,10,11,9,739,1260,1999,2211
0132-000,2012,10,11,10,822,982,1804,1999
0132-000,2012,10,11,11,816,910,1726,1804
0132-000,2012,10,11,12,873,974,1847,1726
0132-000,2012,10,11,13,847,825,1672,1847
0132-000,2012,10,11,14,797,902,1699,1672
0132-000,2012,10,11,15,993,939,1932,1699
0132-000,2012,10,11,16,970,916,1886,1932
0132-000,2012,10,11,17,975,854,1829,1886
0132-000,2012,10,11,18,1197,834,2031,1829
0132-000,2012,10,11,19,1210,907,2117,2031
0132-000,2012,10,11,20,954,675,1629,2117
0132-000,2012,10,11,21,693,527,1220,1629
0132-000,2012,10,11,22,770,487,1257,1220
0132-000,2012,10,11,23,439,340,779,1257
0132-000,2012,10,11,24,228,214,442,779
0132-000,2012,10,12,1,137,145,282,442
0132-000,2012,10,12,2,127,129,256,282
0132-000,2012,10,12,3,98,107,205,256
0132-000,2012,10,12,4,83,98,181,205
0132-000,2012,10,12,5,89,107,196,181
0132-000,2012,10,12,6,197,185,382,196
0132-000,2012,10,12,7,428,481,909,382
0132-000,2012,10,12,8,741,1475,2216,909
0132-000,2012,10,12,9,752,1222,1974,2216
0132-000,2012,10,12,10,787,936,1723,1974
0132-000,2012,10,12,11,750,890,1640,1723
0132-000,2012,10,12,12,826,861,1687,1640
0132-000,2012,10,12,13,827,806,1633,1687
0132-000,2012,10,12,14,941,975,1916,1633
0132-000,2012,10,12,15,919,899,1818,1916
0132-000,2012,10,12,16,999,899,1898,1818
0132-000,2012,10,12,17,1098,897,1995,1898
0132-000,2012,10,12,18,1630,965,2595,1995
0132-000,2012,10,12,19,1613,890,2503,2595
0132-000,2012,10,12,20,1055,765,1820,2503
0132-000,2012,10,12,21,771,592,1363,1820
0132-000,2012,10,12,22,710,562,1272,1363
0132-000,2012,10,12,23,403,393,796,1272
0132-000,2012,10,12,24,281,250,531,796
0132-000,2012,10,13,1,230,222,452,531
0132-000,2012,10,13,2,161,165,326,452
0132-000,2012,10,13,3,127,144,271,326
0132-000,2012,10,13,4,78,100,178,271
0132-000,2012,10,13,5,120,150,270,178
0132-000,2012,10,13,6,208,164,372,270
0132-000,2012,10,13,7,331,346,677,372
0132-000,2012,10,13,8,694,938,1632,677
0132-000,2012,10,13,9,811,1131,1942,1632
0132-000,2012,10,13,10,836,1214,2050,1942
0132-000,2012,10,13,11,718,1342,2060,2050
0132-000,2012,10,13,12,823,1624,2447,2060
0132-000,2012,10,13,13,810,1637,2447,2447
0132-000,2012,10,13,14,951,1554,2505,2447
0132-000,2012,10,13,15,951,1425,2376,2505
0132-000,2012,10,13,16,887,1284,2171,2376
0132-000,2012,10,13,17,1188,1236,2424,2171
0132-000,2012,10,13,18,1430,1234,2664,2424
0132-000,2012,10,13,19,1345,1070,2415,2664
0132-000,2012,10,13,20,886,689,1575,2415
0132-000,2012,10,13,21,606,534,1140,1575
0132-000,2012,10,13,22,592,471,1063,1140
0132-000,2012,10,13,23,410,392,802,1063
0132-000,2012,10,13,24,224,253,477,802
0132-000,2012,10,14,1,187,183,370,477
0132-000,2012,10,14,2,167,170,337,370
0132-000,2012,10,14,3,97,99,196,337
0132-000,2012,10,14,4,72,75,147,196
0132-000,2012,10,14,5,109,90,199,147
0132-000,2012,10,14,6,121,129,250,199
0132-000,2012,10,14,7,224,255,479,250
0132-000,2012,10,14,8,352,456,808,479
0132-000,2012,10,14,9,389,555,944,808
0132-000,2012,10,14,10,538,660,1198,944
0132-000,2012,10,14,11,608,690,1298,1198
0132-000,2012,10,14,12,608,685,1293,1298
0132-000,2012,10,14,13,690,652,1342,1293
0132-000,2012,10,14,14,792,691,1483,1342
0132-000,2012,10,14,15,1005,784,1789,1483
0132-000,2012,10,14,16,1380,751,2131,1789
0132-000,2012,10,14,17,1608,739,2347,2131
0132-000,2012,10,14,18,1880,811,2691,2347
0132-000,2012,10,14,19,1711,650,2361,2691
0132-000,2012,10,14,20,1194,498,1692,2361
0132-000,2012,10,14,21,1166,487,1653,1692
0132-000,2012,10,14,22,1010,454,1464,1653
0132-000,2012,10,14,23,566,321,887,1464
0132-000,2012,10,14,24,263,223,486,887
0132-000,2012,10,15,1,166,149,315,486
0132-000,2012,10,15,2,101,124,225,315
0132-000,2012,10,15,3,71,81,152,225
0132-000,2012,10,15,4,59,76,135,152
0132-000,2012,10,15,5,75,105,180,135
0132-000,2012,10,15,6,199,209,408,180
0132-000,2012,10,15,7,478,581,1059,408
0132-000,2012,10,15,8,698,1536,2234,1059
0132-000,2012,10,15,9,699,1285,1984,2234
0132-000,2012,10,15,10,823,1014,1837,1984
0132-000,2012,10,15,11,858,940,1798,1837
0132-000,2012,10,15,12,815,871,1686,1798
0132-000,2012,10,15,13,846,907,1753,1686
0132-000,2012,10,15,14,862,918,1780,1753
0132-000,2012,10,15,15,939,906,1845,1780
0132-000,2012,10,15,16,938,928,1866,1845
0132-000,2012,10,15,17,969,878,1847,1866
0132-000,2012,10,15,18,1240,928,2168,1847
0132-000,2012,10,15,19,1218,826,2044,2168
0132-000,2012,10,15,20,841,671,1512,2044
0132-000,2012,10,15,21,840,570,1410,1512
0132-000,2012,10,15,22,691,527,1218,1410
0132-000,2012,10,15,23,360,325,685,1218
0132-000,2012,10,15,24,233,188,421,685
0132-000,2012,10,16,1,174,176,350,421
0132-000,2012,10,16,2,121,100,221,350
0132-000,2012,10,16,3,92,96,188,221
0132-000,2012,10,16,4,85,97,182,188
0132-000,2012,10,16,5,86,126,212,182
0132-000,2012,10,16,6,197,193,390,212
0132-000,2012,10,16,7,442,472,914,390
0132-000,2012,10,16,8,752,1436,2188,914
0132-000,2012,10,16,9,805,1283,2088,2188
0132-000,2012,10,16,10,628,888,1516,2088
0132-000,2012,10,16,11,822,889,1711,1516
0132-000,2012,10,16,12,787,937,1724,1711
0132-000,2012,10,16,13,730,799,1529,1724
0132-000,2012,10,16,14,887,919,1806,1529
0132-000,2012,10,16,15,938,917,1855,1806
0132-000,2012,10,16,16,990,904,1894,1855
0132-000,2012,10,16,17,1096,871,1967,1894
0132-000,2012,10,16,18,1119,838,1957,1967
0132-000,2012,10,16,19,1188,858,2046,1957
0132-000,2012,10,16,20,805,615,1420,2046
0132-000,2012,10,16,21,738,509,1247,1420
0132-000,2012,10,16,22,743,461,1204,1247
0132-000,2012,10,16,23,374,311,685,1204
0132-000,2012,10,16,24,213,203,416,685
0132-000,2012,10,17,1,164,139,303,416
0132-000,2012,10,17,2,91,114,205,303
0132-000,2012,10,17,3,93,91,184,205
0132-000,2012,10,17,4,89,84,173,184
0132-000,2012,10,17,5,99,114,213,173
0132-000,2012,10,17,6,182,152,334,213
0132-000,2012,10,17,7,358,373,731,334
0132-000,2012,10,17,8,680,1272,1952,731
0132-000,2012,10,17,9,713,1152,1865,1952
0132-000,2012,10,17,10,654,805,1459,1865
0132-000,2012,10,17,11,663,779,1442,1459
0132-000,2012,10,17,12,565,766,1331,1442
0132-000,2012,10,17,13,450,750,1200,1331
0132-000,2012,10,17,14,544,858,1402,1200
0132-000,2012,10,17,15,664,885,1549,1402
0132-000,2012,10,17,16,861,803,1664,1549
0132-000,2012,10,17,17,1006,788,1794,1664
0132-000,2012,10,17,18,1049,811,1860,1794
0132-000,2012,10,17,19,1152,807,1959,1860
0132-000,2012,10,17,20,864,656,1520,1959
0132-000,2012,10,17,21,638,477,1115,1520
0132-000,2012,10,17,22,612,456,1068,1115
0132-000,2012,10,17,23,385,345,730,1068
0132-000,2012,10,17,24,194,207,401,730
0132-000,2012,10,18,1,164,138,302,401
0132-000,2012,10,18,2,134,142,276,302
0132-000,2012,10,18,3,104,113,217,276
0132-000,2012,10,18,4,97,100,197,217
0132-000,2012,10,18,5,146,168,314,197
0132-000,2012,10,18,6,247,208,455,314
0132-000,2012,10,18,7,402,465,867,455
0132-000,2012,10,18,8,831,1567,2398,867
0132-000,2012,10,18,9,768,1313,2081,2398
0132-000,2012,10,18,10,780,932,1712,2081
0132-000,2012,10,18,11,715,867,1582,1712
0132-000,2012,10,18,12,741,899,1640,1582
0132-000,2012,10,18,13,622,776,1398,1640
0132-000,2012,10,18,14,802,935,1737,1398
0132-000,2012,10,18,15,914,986,1900,1737
0132-000,2012,10,18,16,917,848,1765,1900
0132-000,2012,10,18,17,993,824,1817,1765
0132-000,2012,10,18,18,1155,861,2016,1817
0132-000,2012,10,18,19,1112,781,1893,2016
0132-000,2012,10,18,20,845,601,1446,1893
0132-000,2012,10,18,21,718,528,1246,1446
0132-000,2012,10,18,22,634,463,1097,1246
0132-000,2012,10,18,23,312,288,600,1097
0132-000,2012,10,18,24,239,218,457,600
0132-000,2012,10,19,1,150,161,311,457
0132-000,2012,10,19,2,122,100,222,311
0132-000,2012,10,19,3,83,108,191,222
0132-000,2012,10,19,4,63,94,157,191
0132-000,2012,10,19,5,131,133,264,157
0132-000,2012,10,19,6,186,184,370,264
0132-000,2012,10,19,7,455,463,918,370
0132-000,2012,10,19,8,823,1439,2262,918
0132-000,2012,10,19,9,767,1200,1967,2262
0132-000,2012,10,19,10,729,896,1625,1967
0132-000,2012,10,19,11,784,872,1656,1625
0132-000,2012,10,19,12,828,869,1697,1656
0132-000,2012,10,19,13,750,813,1563,1697
0132-000,2012,10,19,14,855,857,1712,1563
0132-000,2012,10,19,15,893,891,1784,1712
0132-000,2012,10,19,16,1063,923,1986,1784
0132-000,2012,10,19,17,1092,931,2023,1986
0132-000,2012,10,19,18,1302,901,2203,2023
0132-000,2012,10,19,19,1315,891,2206,2203
0132-000,2012,10,19,20,809,732,1541,2206
0132-000,2012,10,19,21,698,564,1262,1541
0132-000,2012,10,19,22,700,562,1262,1262
0132-000,2012,10,19,23,298,356,654,1262
0132-000,2012,10,19,24,249,252,501,654
0132-000,2012,10,20,1,197,220,417,501
0132-000,2012,10,20,2,145,151,296,417
0132-000,2012,10,20,3,94,114,208,296
0132-000,2012,10,20,4,145,139,284,208
0132-000,2012,10,20,5,143,172,315,284
0132-000,2012,10,20,6,151,184,335,315
0132-000,2012,10,20,7,364,351,715,335
0132-000,2012,10,20,8,581,839,1420,715
0132-000,2012,10,20,9,748,987,1735,1420
0132-000,2012,10,20,10,985,1088,2073,1735
0132-000,2012,10,20,11,956,1200,2156,2073
0132-000,2012,10,20,12,1507,1742,3249,2156
0132-000,2012,10,20,13,1521,1792,3313,3249
0132-000,2012,10,20,14,1481,1656,3137,3313
0132-000,2012,10,20,15,1882,1629,3511,3137
0132-000,2012,10,20,16,2075,1551,3626,3511
0132-000,2012,10,20,17,1916,1472,3388,3626
0132-000,2012,10,20,18,2320,1478,3798,3388
0132-000,2012,10,20,19,1453,1177,2630,3798
0132-000,2012,10,20,20,822,669,1491,2630
0132-000,2012,10,20,21,649,560,1209,1491
0132-000,2012,10,20,22,467,475,942,1209
0132-000,2012,10,20,23,308,330,638,942
0132-000,2012,10,20,24,253,260,513,638
0132-000,2012,10,21,1,144,170,314,513
0132-000,2012,10,21,2,132,152,284,314
0132-000,2012,10,21,3,100,93,193,284
0132-000,2012,10,21,4,112,117,229,193
0132-000,2012,10,21,5,98,105,203,229
0132-000,2012,10,21,6,106,123,229,203
0132-000,2012,10,21,7,267,257,524,229
0132-000,2012,10,21,8,301,449,750,524
0132-000,2012,10,21,9,459,546,1005,750
0132-000,2012,10,21,10,562,628,1190,1005
0132-000,2012,10,21,11,669,742,1411,1190
0132-000,2012,10,21,12,669,705,1374,1411
0132-000,2012,10,21,13,761,709,1470,1374
0132-000,2012,10,21,14,825,711,1536,1470
0132-000,2012,10,21,15,779,711,1490,1536
0132-000,2012,10,21,16,1107,805,1912,1490
0132-000,2012,10,21,17,1423,819,2242,1912
0132-000,2012,10,21,18,1283,755,2038,2242
0132-000,2012,10,21,19,1072,679,1751,2038
0132-000,2012,10,21,20,664,554,1218,1751
0132-000,2012,10,21,21,564,507,1071,1218
0132-000,2012,10,21,22,408,451,859,1071
0132-000,2012,10,21,23,336,336,672,859
0132-000,2012,10,21,24,190,210,400,672
0132-000,2012,10,22,1,109,135,244,400
0132-000,2012,10,22,2,67,82,149,244
0132-000,2012,10,22,3,76,80,156,149
0132-000,2012,10,22,4,73,80,153,156
0132-000,2012,10,22,5,66,96,162,153
0132-000,2012,10,22,6,163,189,352,162
0132-000,2012,10,22,7,417,527,944,352
0132-000,2012,10,22,8,740,1546,2286,944
0132-000,2012,10,22,9,758,1336,2094,2286
0132-000,2012,10,22,10,713,891,1604,2094
0132-000,2012,10,22,11,680,803,1483,1604
0132-000,2012,10,22,12,628,767,1395,1483
0132-000,2012,10,22,13,525,675,1200,1395
0132-000,2012,10,22,14,488,760,1248,1200
0132-000,2012,10,22,15,619,781,1400,1248
0132-000,2012,10,22,16,801,846,1647,1400
0132-000,2012,10,22,17,779,798,1577,1647
0132-000,2012,10,22,18,880,778,1658,1577
0132-000,2012,10,22,19,1142,789,1931,1658
0132-000,2012,10,22,20,830,626,1456,1931
0132-000,2012,10,22,21,742,529,1271,1456
0132-000,2012,10,22,22,500,459,959,1271
0132-000,2012,10,22,23,273,281,554,959
0132-000,2012,10,22,24,204,191,395,554
0132-000,2012,10,23,1,130,114,244,395
0132-000,2012,10,23,2,95,94,189,244
0132-000,2012,10,23,3,57,77,134,189
0132-000,2012,10,23,4,79,96,175,134
0132-000,2012,10,23,5,93,123,216,175
0132-000,2012,10,23,6,188,170,358,216
0132-000,2012,10,23,7,446,484,930,358
0132-000,2012,10,23,8,717,1420,2137,930
0132-000,2012,10,23,9,725,1210,1935,2137
0132-000,2012,10,23,10,642,879,1521,1935
0132-000,2012,10,23,11,687,907,1594,1521
0132-000,2012,10,23,12,714,879,1593,1594
0132-000,2012,10,23,13,753,846,1599,1593
0132-000,2012,10,23,14,663,873,1536,1599
0132-000,2012,10,23,15,867,925,1792,1536
0132-000,2012,10,23,16,989,835,1824,1792
0132-000,2012,10,23,17,1046,816,1862,1824
0132-000,2012,10,23,18,981,809,1790,1862
0132-000,2012,10,23,19,1121,778,1899,1790
0132-000,2012,10,23,20,920,637,1557,1899
0132-000,2012,10,23,21,688,481,1169,1557
0132-000,2012,10,23,22,580,465,1045,1169
0132-000,2012,10,23,23,377,291,668,1045
0132-000,2012,10,23,24,218,208,426,668
0132-000,2012,10,24,1,181,158,339,426
0132-000,2012,10,24,2,105,116,221,339
0132-000,2012,10,24,3,97,131,228,221
0132-000,2012,10,24,4,80,93,173,228
0132-000,2012,10,24,5,94,123,217,173
0132-000,2012,10,24,6,224,185,409,217
0132-000,2012,10,24,7,462,433,895,409
0132-000,2012,10,24,8,718,1323,2041,895
0132-000,2012,10,24,9,733,1250,1983,2041
0132-000,2012,10,24,10,717,918,1635,1983
0132-000,2012,10,24,11,777,829,1606,1635
0132-000,2012,10,24,12,850,843,1693,1606
0132-000,2012,10,24,13,718,791,1509,1693
0132-000,2012,10,24,14,890,896,1786,1509
0132-000,2012,10,24,15,818,839,1657,1786
0132-000,2012,10,24,16,933,858,1791,1657
0132-000,2012,10,24,17,952,788,1740,1791
0132-000,2012,10,24,18,1266,874,2140,1740
0132-000,2012,10,24,19,1024,756,1780,2140
0132-000,2012,10,24,20,806,626,1432,1780
0132-000,2012,10,24,21,673,500,1173,1432
0132-000,2012,10,24,22,571,433,1004,1173
0132-000,2012,10,24,23,340,304,644,1004
0132-000,2012,10,24,24,211,205,416,644
0132-000,2012,10,25,1,165,154,319,416
0132-000,2012,10,25,2,79,108,187,319
0132-000,2012,10,25,3,103,116,219,187
0132-000,2012,10,25,4,76,93,169,219
0132-000,2012,10,25,5,98,133,231,169
0132-000,2012,10,25,6,184,181,365,231
0132-000,2012,10,25,7,416,438,854,365
0132-000,2012,10,25,8,693,1406,2099,854
0132-000,2012,10,25,9,744,1264,2008,2099
0132-000,2012,10,25,10,762,955,1717,2008
0132-000,2012,10,25,11,764,880,1644,1717
0132-000,2012,10,25,12,932,928,1860,1644
0132-000,2012,10,25,13,730,780,1510,1860
0132-000,2012,10,25,14,906,946,1852,1510
0132-000,2012,10,25,15,755,933,1688,1852
0132-000,2012,10,25,16,924,809,1733,1688
0132-000,2012,10,25,17,970,804,1774,1733
0132-000,2012,10,25,18,1157,742,1899,1774
0132-000,2012,10,25,19,1122,813,1935,1899
0132-000,2012,10,25,20,912,636,1548,1935
0132-000,2012,10,25,21,783,488,1271,1548
0132-000,2012,10,25,22,626,496,1122,1271
0132-000,2012,10,25,23,344,292,636,1122
0132-000,2012,10,25,24,236,213,449,636
0132-000,2012,10,26,1,165,179,344,449
0132-000,2012,10,26,2,118,111,229,344
0132-000,2012,10,26,3,83,96,179,229
0132-000,2012,10,26,4,83,103,186,179
0132-000,2012,10,26,5,81,111,192,186
0132-000,2012,10,26,6,199,178,377,192
0132-000,2012,10,26,7,424,453,877,377
0132-000,2012,10,26,8,772,1402,2174,877
0132-000,2012,10,26,9,749,1244,1993,2174
0132-000,2012,10,26,10,816,933,1749,1993
0132-000,2012,10,26,11,755,937,1692,1749
0132-000,2012,10,26,12,807,894,1701,1692
0132-000,2012,10,26,13,529,789,1318,1701
0132-000,2012,10,26,14,616,846,1462,1318
0132-000,2012,10,26,15,829,963,1792,1462
0132-000,2012,10,26,16,962,864,1826,1792
0132-000,2012,10,26,17,1078,897,1975,1826
0132-000,2012,10,26,18,1177,872,2049,1975
0132-000,2012,10,26,19,1136,893,2029,2049
0132-000,2012,10,26,20,1009,845,1854,2029
0132-000,2012,10,26,21,740,642,1382,1854
0132-000,2012,10,26,22,618,573,1191,1382
0132-000,2012,10,26,23,398,374,772,1191
0132-000,2012,10,26,24,235,261,496,772
0132-000,2012,10,27,1,242,258,500,496
0132-000,2012,10,27,2,137,156,293,500
0132-000,2012,10,27,3,93,114,207,293
0132-000,2012,10,27,4,93,120,213,207
0132-000,2012,10,27,5,119,139,258,213
0132-000,2012,10,27,6,149,137,286,258
0132-000,2012,10,27,7,246,283,529,286
0132-000,2012,10,27,8,467,670,1137,529
0132-000,2012,10,27,9,563,787,1350,1137
0132-000,2012,10,27,10,597,953,1550,1350
0132-000,2012,10,27,11,600,1203,1803,1550
0132-000,2012,10,27,12,850,1450,2300,1803
0132-000,2012,10,27,13,786,1420,2206,2300
0132-000,2012,10,27,14,910,1485,2395,2206
0132-000,2012,10,27,15,1050,1318,2368,2395
0132-000,2012,10,27,16,1150,1290,2440,2368
0132-000,2012,10,27,17,1009,1142,2151,2440
0132-000,2012,10,27,18,1084,1160,2244,2151
0132-000,2012,10,27,19,932,913,1845,2244
0132-000,2012,10,27,20,662,638,1300,1845
0132-000,2012,10,27,21,603,565,1168,1300
0132-000,2012,10,27,22,422,451,873,1168
0132-000,2012,10,27,23,230,290,520,873
0132-000,2012,10,27,24,207,234,441,520
0132-000,2012,10,28,1,150,184,334,441
0132-000,2012,10,28,2,146,143,289,334
0132-000,2012,10,28,3,87,93,180,289
0132-000,2012,10,28,4,87,87,174,180
0132-000,2012,10,28,5,72,94,166,174
0132-000,2012,10,28,6,76,106,182,166
0132-000,2012,10,28,7,184,211,395,182
0132-000,2012,10,28,8,297,389,686,395
0132-000,2012,10,28,9,385,498,883,686
0132-000,2012,10,28,10,417,588,1005,883
0132-000,2012,10,28,11,481,692,1173,1005
0132-000,2012,10,28,12,579,706,1285,1173
0132-000,2012,10,28,13,496,630,1126,1285
0132-000,2012,10,28,14,764,790,1554,1126
0132-000,2012,10,28,15,863,753,1616,1554
0132-000,2012,10,28,16,1233,833,2066,1616
0132-000,2012,10,28,17,1324,748,2072,2066
0132-000,2012,10,28,18,1453,738,2191,2072
0132-000,2012,10,28,19,1245,601,1846,2191
0132-000,2012,10,28,20,1136,571,1707,1846
0132-000,2012,10,28,21,770,514,1284,1707
0132-000,2012,10,28,22,570,411,981,1284
0132-000,2012,10,28,23,323,316,639,981
0132-000,2012,10,28,24,179,195,374,639
0132-000,2012,10,29,1,113,171,284,374
0132-000,2012,10,29,2,84,98,182,284
0132-000,2012,10,29,3,54,65,119,182
0132-000,2012,10,29,4,40,78,118,119
0132-000,2012,10,29,5,76,103,179,118
0132-000,2012,10,29,6,185,198,383,179
0132-000,2012,10,29,7,441,573,1014,383
0132-000,2012,10,29,8,776,1664,2440,1014
0132-000,2012,10,29,9,760,1281,2041,2440
0132-000,2012,10,29,10,647,953,1600,2041
0132-000,2012,10,29,11,777,972,1749,1600
0132-000,2012,10,29,12,807,914,1721,1749
0132-000,2012,10,29,13,547,873,1420,1721
0132-000,2012,10,29,14,600,890,1490,1420
0132-000,2012,10,29,15,838,920,1758,1490
0132-000,2012,10,29,16,927,984,1911,1758
0132-000,2012,10,29,17,912,858,1770,1911
0132-000,2012,10,29,18,1030,846,1876,1770
0132-000,2012,10,29,19,1066,811,1877,1876
0132-000,2012,10,29,20,783,617,1400,1877
0132-000,2012,10,29,21,617,545,1162,1400
0132-000,2012,10,29,22,472,417,889,1162
0132-000,2012,10,29,23,305,281,586,889
0132-000,2012,10,29,24,191,195,386,586
0132-000,2012,10,30,1,162,150,312,386
0132-000,2012,10,30,2,109,110,219,312
0132-000,2012,10,30,3,74,84,158,219
0132-000,2012,10,30,4,70,105,175,158
0132-000,2012,10,30,5,105,116,221,175
0132-000,2012,10,30,6,167,186,353,221
0132-000,2012,10,30,7,311,414,725,353
0132-000,2012,10,30,8,923,1493,2416,725
0132-000,2012,10,30,9,824,1314,2138,2416
0132-000,2012,10,30,10,639,921,1560,2138
0132-000,2012,10,30,11,696,885,1581,1560
0132-000,2012,10,30,12,859,892,1751,1581
0132-000,2012,10,30,13,782,815,1597,1751
0132-000,2012,10,30,14,734,914,1648,1597
0132-000,2012,10,30,15,835,860,1695,1648
0132-000,2012,10,30,16,1099,863,1962,1695
0132-000,2012,10,30,17,1013,864,1877,1962
0132-000,2012,10,30,18,1030,870,1900,1877
0132-000,2012,10,30,19,1145,781,1926,1900
0132-000,2012,10,30,20,809,643,1452,1926
0132-000,2012,10,30,21,673,512,1185,1452
0132-000,2012,10,30,22,490,448,938,1185
0132-000,2012,10,30,23,280,302,582,938
0132-000,2012,10,30,24,214,201,415,582
0132-000,2012,10,31,1,125,143,268,415
0132-000,2012,10,31,2,78,96,174,268
0132-000,2012,10,31,3,76,93,169,174
0132-000,2012,10,31,4,68,83,151,169
0132-000,2012,10,31,5,74,88,162,151
0132-000,2012,10,31,6,182,176,358,162
0132-000,2012,10,31,7,345,424,769,358
0132-000,2012,10,31,8,714,1482,2196,769
0132-000,2012,10,31,9,763,1285,2048,2196
0132-000,2012,10,31,10,668,909,1577,2048
0132-000,2012,10,31,11,677,871,1548,1577
0132-000,2012,10,31,12,673,855,1528,1548
0132-000,2012,10,31,13,734,822,1556,1528
0132-000,2012,10,31,14,675,846,1521,1556
0132-000,2012,10,31,15,688,875,1563,1521
0132-000,2012,10,31,16,893,841,1734,1563
0132-000,2012,10,31,17,1030,822,1852,1734
0132-000,2012,10,31,18,985,743,1728,1852
0132-000,2012,10,31,19,1051,794,1845,1728
0132-000,2012,10,31,20,749,590,1339,1845
0132-000,2012,10,31,21,676,500,1176,1339
0132-000,2012,10,31,22,452,468,920,1176
0132-000,2012,10,31,23,271,322,593,920
0132-000,2012,10,31,24,224,233,457,593
0132-000,2012,11,1,1,139,168,307,457
0132-000,2012,11,1,2,123,124,247,307
0132-000,2012,11,1,3,94,93,187,247
0132-000,2012,11,1,4,60,88,148,187
0132-000,2012,11,1,5,101,126,227,148
0132-000,2012,11,1,6,144,165,309,227
0132-000,2012,11,1,7,365,396,761,309
0132-000,2012,11,1,8,692,1405,2097,761
0132-000,2012,11,1,9,793,1340,2133,2097
0132-000,2012,11,1,10,689,939,1628,2133
0132-000,2012,11,1,11,714,850,1564,1628
0132-000,2012,11,1,12,744,867,1611,1564
0132-000,2012,11,1,13,746,782,1528,1611
0132-000,2012,11,1,14,813,863,1676,1528
0132-000,2012,11,1,15,966,885,1851,1676
0132-000,2012,11,1,16,1024,878,1902,1851
0132-000,2012,11,1,17,1025,813,1838,1902
0132-000,2012,11,1,18,1302,824,2126,1838
0132-000,2012,11,1,19,1129,792,1921,2126
0132-000,2012,11,1,20,1032,696,1728,1921
0132-000,2012,11,1,21,681,474,1155,1728
0132-000,2012,11,1,22,622,464,1086,1155
0132-000,2012,11,1,23,391,313,704,1086
0132-000,2012,11,1,24,215,201,416,704
0132-000,2012,11,2,1,176,178,354,416
0132-000,2012,11,2,2,94,115,209,354
0132-000,2012,11,2,3,113,93,206,209
0132-000,2012,11,2,4,70,99,169,206
0132-000,2012,11,2,5,103,115,218,169
0132-000,2012,11,2,6,147,127,274,218
0132-000,2012,11,2,7,325,365,690,274
0132-000,2012,11,2,8,774,1405,2179,690
0132-000,2012,11,2,9,821,1376,2197,2179
0132-000,2012,11,2,10,774,980,1754,2197
0132-000,2012,11,2,11,725,900,1625,1754
0132-000,2012,11,2,12,771,918,1689,1625
0132-000,2012,11,2,13,739,764,1503,1689
0132-000,2012,11,2,14,952,912,1864,1503
0132-000,2012,11,2,15,933,917,1850,1864
0132-000,2012,11,2,16,1092,922,2014,1850
0132-000,2012,11,2,17,995,882,1877,2014
0132-000,2012,11,2,18,1309,911,2220,1877
0132-000,2012,11,2,19,1453,899,2352,2220
0132-000,2012,11,2,20,958,722,1680,2352
0132-000,2012,11,2,21,755,594,1349,1680
0132-000,2012,11,2,22,718,545,1263,1349
0132-000,2012,11,2,23,499,420,919,1263
0132-000,2012,11,2,24,279,267,546,919
0132-000,2012,11,3,1,191,185,376,546
0132-000,2012,11,3,2,151,169,320,376
0132-000,2012,11,3,3,104,118,222,320
0132-000,2012,11,3,4,77,99,176,222
0132-000,2012,11,3,5,105,123,228,176
0132-000,2012,11,3,6,192,166,358,228
0132-000,2012,11,3,7,360,361,721,358
0132-000,2012,11,3,8,523,753,1276,721
0132-000,2012,11,3,9,701,940,1641,1276
0132-000,2012,11,3,10,855,1245,2100,1641
0132-000,2012,11,3,11,952,1633,2585,2100
0132-000,2012,11,3,12,1062,1782,2844,2585
0132-000,2012,11,3,13,1024,1889,2913,2844
0132-000,2012,11,3,14,1054,1712,2766,2913
0132-000,2012,11,3,15,1024,1555,2579,2766
0132-000,2012,11,3,16,1220,1469,2689,2579
0132-000,2012,11,3,17,1309,1300,2609,2689
0132-000,2012,11,3,18,1807,1350,3157,2609
0132-000,2012,11,3,19,1570,952,2522,3157
0132-000,2012,11,3,20,1000,620,1620,2522
0132-000,2012,11,3,21,591,549,1140,1620
0132-000,2012,11,3,22,518,494,1012,1140
0132-000,2012,11,3,23,395,361,756,1012
0132-000,2012,11,3,24,261,281,542,756
0132-000,2012,11,4,1,196,196,392,542
0132-000,2012,11,4,2,124,123,247,392
0132-000,2012,11,4,3,103,105,208,247
0132-000,2012,11,4,4,69,76,145,208
0132-000,2012,11,4,5,79,89,168,145
0132-000,2012,11,4,6,115,124,239,168
0132-000,2012,11,4,7,142,184,326,239
0132-000,2012,11,4,8,271,350,621,326
0132-000,2012,11,4,9,388,502,890,621
0132-000,2012,11,4,10,460,574,1034,890
0132-000,2012,11,4,11,590,638,1228,1034
0132-000,2012,11,4,12,565,623,1188,1228
0132-000,2012,11,4,13,660,645,1305,1188
0132-000,2012,11,4,14,748,648,1396,1305
0132-000,2012,11,4,15,996,706,1702,1396
0132-000,2012,11,4,16,1418,736,2154,1702
0132-000,2012,11,4,17,1390,706,2096,2154
0132-000,2012,11,4,18,1409,646,2055,2096
0132-000,2012,11,4,19,1449,584,2033,2055
0132-000,2012,11,4,20,1397,561,1958,2033
0132-000,2012,11,4,21,943,452,1395,1958
0132-000,2012,11,4,22,845,399,1244,1395
0132-000,2012,11,4,23,380,305,685,1244
0132-000,2012,11,4,24,177,193,370,685
0132-000,2012,11,5,1,138,144,282,370
0132-000,2012,11,5,2,51,70,121,282
0132-000,2012,11,5,3,59,65,124,121
0132-000,2012,11,5,4,56,56,112,124
0132-000,2012,11,5,5,72,82,154,112
0132-000,2012,11,5,6,179,170,349,154
0132-000,2012,11,5,7,402,483,885,349
0132-000,2012,11,5,8,708,1552,2260,885
0132-000,2012,11,5,9,788,1412,2200,2260
0132-000,2012,11,5,10,621,876,1497,2200
0132-000,2012,11,5,11,862,930,1792,1497
0132-000,2012,11,5,12,781,890,1671,1792
0132-000,2012,11,5,13,713,776,1489,1671
0132-000,2012,11,5,14,806,866,1672,1489
0132-000,2012,11,5,15,828,858,1686,1672
0132-000,2012,11,5,16,995,868,1863,1686
0132-000,2012,11,5,17,1036,827,1863,1863
0132-000,2012,11,5,18,1108,817,1925,1863
0132-000,2012,11,5,19,1060,791,1851,1925
0132-000,2012,11,5,20,826,622,1448,1851
0132-000,2012,11,5,21,775,536,1311,1448
0132-000,2012,11,5,22,573,406,979,1311
0132-000,2012,11,5,23,312,290,602,979
0132-000,2012,11,5,24,222,197,419,602
0132-000,2012,11,6,1,157,159,316,419
0132-000,2012,11,6,2,83,89,172,316
0132-000,2012,11,6,3,71,91,162,172
0132-000,2012,11,6,4,92,102,194,162
0132-000,2012,11,6,5,69,94,163,194
0132-000,2012,11,6,6,148,136,284,163
0132-000,2012,11,6,7,346,373,719,284
0132-000,2012,11,6,8,748,1400,2148,719
0132-000,2012,11,6,9,877,1394,2271,2148
0132-000,2012,11,6,10,814,936,1750,2271
0132-000,2012,11,6,11,843,894,1737,1750
0132-000,2012,11,6,12,812,830,1642,1737
0132-000,2012,11,6,13,799,776,1575,1642
0132-000,2012,11,6,14,838,812,1650,1575
0132-000,2012,11,6,15,949,864,1813,1650
0132-000,2012,11,6,16,857,775,1632,1813
0132-000,2012,11,6,17,1115,836,1951,1632
0132-000,2012,11,6,18,985,754,1739,1951
0132-000,2012,11,6,19,1194,734,1928,1739
0132-000,2012,11,6,20,915,642,1557,1928
0132-000,2012,11,6,21,639,485,1124,1557
0132-000,2012,11,6,22,661,453,1114,1124
0132-000,2012,11,6,23,296,268,564,1114
0132-000,2012,11,6,24,220,196,416,564
0132-000,2012,11,7,1,120,133,253,416
0132-000,2012,11,7,2,89,86,175,253
0132-000,2012,11,7,3,94,92,186,175
0132-000,2012,11,7,4,70,81,151,186
0132-000,2012,11,7,5,88,88,176,151
0132-000,2012,11,7,6,210,146,356,176
0132-000,2012,11,7,7,399,397,796,356
0132-000,2012,11,7,8,810,1349,2159,796
0132-000,2012,11,7,9,1023,1347,2370,2159
0132-000,2012,11,7,10,758,958,1716,2370
0132-000,2012,11,7,11,781,905,1686,1716
0132-000,2012,11,7,12,795,831,1626,1686
0132-000,2012,11,7,13,768,757,1525,1626
0132-000,2012,11,7,14,793,795,1588,1525
0132-000,2012,11,7,15,860,854,1714,1588
0132-000,2012,11,7,16,917,863,1780,1714
0132-000,2012,11,7,17,968,863,1831,1780
0132-000,2012,11,7,18,1029,859,1888,1831
0132-000,2012,11,7,19,1057,845,1902,1888
0132-000,2012,11,7,20,866,661,1527,1902
0132-000,2012,11,7,21,573,522,1095,1527
0132-000,2012,11,7,22,531,461,992,1095
0132-000,2012,11,7,23,308,323,631,992
0132-000,2012,11,7,24,200,221,421,631
0132-000,2012,11,8,1,154,163,317,421
0132-000,2012,11,8,2,142,130,272,317
0132-000,2012,11,8,3,74,94,168,272
0132-000,2012,11,8,4,75,95,170,168
0132-000,2012,11,8,5,79,121,200,170
0132-000,2012,11,8,6,142,141,283,200
0132-000,2012,11,8,7,335,394,729,283
0132-000,2012,11,8,8,668,1347,2015,729
0132-000,2012,11,8,9,803,1370,2173,2015
0132-000,2012,11,8,10,841,1005,1846,2173
0132-000,2012,11,8,11,781,871,1652,1846
0132-000,2012,11,8,12,765,853,1618,1652
0132-000,2012,11,8,13,817,796,1613,1618
0132-000,2012,11,8,14,765,866,1631,1613
0132-000,2012,11,8,15,919,869,1788,1631
0132-000,2012,11,8,16,896,846,1742,1788
0132-000,2012,11,8,17,862,755,1617,1742
0132-000,2012,11,8,18,1150,801,1951,1617
0132-000,2012,11,8,19,1010,757,1767,1951
0132-000,2012,11,8,20,877,620,1497,1767
0132-000,2012,11,8,21,656,499,1155,1497
0132-000,2012,11,8,22,751,475,1226,1155
0132-000,2012,11,8,23,424,328,752,1226
0132-000,2012,11,8,24,249,233,482,752
0132-000,2012,11,9,1,156,165,321,482
0132-000,2012,11,9,2,101,103,204,321
0132-000,2012,11,9,3,90,98,188,204
0132-000,2012,11,9,4,76,89,165,188
0132-000,2012,11,9,5,77,93,170,165
0132-000,2012,11,9,6,143,134,277,170
0132-000,2012,11,9,7,328,368,696,277
0132-000,2012,11,9,8,689,1373,2062,696
0132-000,2012,11,9,9,794,1290,2084,2062
0132-000,2012,11,9,10,744,885,1629,2084
0132-000,2012,11,9,11,762,904,1666,1629
0132-000,2012,11,9,12,849,885,1734,1666
0132-000,2012,11,9,13,831,810,1641,1734
0132-000,2012,11,9,14,878,909,1787,1641
0132-000,2012,11,9,15,885,866,1751,1787
0132-000,2012,11,9,16,1019,917,1936,1751
0132-000,2012,11,9,17,1086,887,1973,1936
0132-000,2012,11,9,18,1500,888,2388,1973
0132-000,2012,11,9,19,1566,864,2430,2388
0132-000,2012,11,9,20,1138,825,1963,2430
0132-000,2012,11,9,21,791,607,1398,1963
0132-000,2012,11,9,22,690,546,1236,1398
0132-000,2012,11,9,23,402,392,794,1236
0132-000,2012,11,9,24,300,267,567,794
0132-000,2012,11,10,1,230,222,452,567
0132-000,2012,11,10,2,154,158,312,452
0132-000,2012,11,10,3,107,121,228,312
0132-000,2012,11,10,4,100,128,228,228
0132-000,2012,11,10,5,98,122,220,228
0132-000,2012,11,10,6,195,154,349,220
0132-000,2012,11,10,7,294,307,601,349
0132-000,2012,11,10,8,585,791,1376,601
0132-000,2012,11,10,9,770,1074,1844,1376
0132-000,2012,11,10,10,770,1118,1888,1844
0132-000,2012,11,10,11,758,1417,2175,1888
0132-000,2012,11,10,12,815,1608,2423,2175
0132-000,2012,11,10,13,819,1655,2474,2423
0132-000,2012,11,10,14,955,1560,2515,2474
0132-000,2012,11,10,15,1017,1524,2541,2515
0132-000,2012,11,10,16,931,1348,2279,2541
0132-000,2012,11,10,17,1276,1328,2604,2279
0132-000,2012,11,10,18,1575,1359,2934,2604
0132-000,2012,11,10,19,1514,1204,2718,2934
0132-000,2012,11,10,20,1042,810,1852,2718
0132-000,2012,11,10,21,656,578,1234,1852
0132-000,2012,11,10,22,626,498,1124,1234
0132-000,2012,11,10,23,396,379,775,1124
0132-000,2012,11,10,24,224,252,476,775
0132-000,2012,11,11,1,219,214,433,476
0132-000,2012,11,11,2,130,132,262,433
0132-000,2012,11,11,3,109,111,220,262
0132-000,2012,11,11,4,87,91,178,220
0132-000,2012,11,11,5,88,73,161,178
0132-000,2012,11,11,6,78,83,161,161
0132-000,2012,11,11,7,131,149,280,161
0132-000,2012,11,11,8,253,328,581,280
0132-000,2012,11,11,9,393,560,953,581
0132-000,2012,11,11,10,405,497,902,953
0132-000,2012,11,11,11,561,637,1198,902
0132-000,2012,11,11,12,568,640,1208,1198
0132-000,2012,11,11,13,801,757,1558,1208
0132-000,2012,11,11,14,937,817,1754,1558
0132-000,2012,11,11,15,982,766,1748,1754
0132-000,2012,11,11,16,1395,759,2154,1748
0132-000,2012,11,11,17,1521,699,2220,2154
0132-000,2012,11,11,18,1746,753,2499,2220
0132-000,2012,11,11,19,1595,606,2201,2499
0132-000,2012,11,11,20,1362,568,1930,2201
0132-000,2012,11,11,21,1145,478,1623,1930
0132-000,2012,11,11,22,1005,452,1457,1623
0132-000,2012,11,11,23,488,277,765,1457
0132-000,2012,11,11,24,269,228,497,765
0132-000,2012,11,12,1,150,135,285,497
0132-000,2012,11,12,2,75,92,167,285
0132-000,2012,11,12,3,51,58,109,167
0132-000,2012,11,12,4,49,64,113,109
0132-000,2012,11,12,5,78,109,187,113
0132-000,2012,11,12,6,146,153,299,187
0132-000,2012,11,12,7,378,459,837,299
0132-000,2012,11,12,8,695,1529,2224,837
0132-000,2012,11,12,9,767,1410,2177,2224
0132-000,2012,11,12,10,708,872,1580,2177
0132-000,2012,11,12,11,782,857,1639,1580
0132-000,2012,11,12,12,817,873,1690,1639
0132-000,2012,11,12,13,782,839,1621,1690
0132-000,2012,11,12,14,858,914,1772,1621
0132-000,2012,11,12,15,899,867,1766,1772
0132-000,2012,11,12,16,900,890,1790,1766
0132-000,2012,11,12,17,914,828,1742,1790
0132-000,2012,11,12,18,1167,874,2041,1742
0132-000,2012,11,12,19,1142,774,1916,2041
0132-000,2012,11,12,20,762,608,1370,1916
0132-000,2012,11,12,21,683,463,1146,1370
0132-000,2012,11,12,22,560,427,987,1146
0132-000,2012,11,12,23,328,296,624,987
0132-000,2012,11,12,24,242,195,437,624
0132-000,2012,11,13,1,129,130,259,437
0132-000,2012,11,13,2,129,106,235,259
0132-000,2012,11,13,3,80,83,163,235
0132-000,2012,11,13,4,75,86,161,163
0132-000,2012,11,13,5,81,119,200,161
0132-000,2012,11,13,6,130,127,257,200
0132-000,2012,11,13,7,314,335,649,257
0132-000,2012,11,13,8,706,1347,2053,649
0132-000,2012,11,13,9,851,1357,2208,2053
0132-000,2012,11,13,10,635,899,1534,2208
0132-000,2012,11,13,11,837,906,1743,1534
0132-000,2012,11,13,12,664,790,1454,1743
0132-000,2012,11,13,13,699,765,1464,1454
0132-000,2012,11,13,14,802,831,1633,1464
0132-000,2012,11,13,15,866,847,1713,1633
0132-000,2012,11,13,16,896,818,1714,1713
0132-000,2012,11,13,17,951,756,1707,1714
0132-000,2012,11,13,18,1051,787,1838,1707
0132-000,2012,11,13,19,1038,750,1788,1838
0132-000,2012,11,13,20,819,626,1445,1788
0132-000,2012,11,13,21,745,514,1259,1445
0132-000,2012,11,13,22,688,427,1115,1259
0132-000,2012,11,13,23,347,288,635,1115
0132-000,2012,11,13,24,206,196,402,635
0132-000,2012,11,14,1,157,133,290,402
0132-000,2012,11,14,2,96,120,216,290
0132-000,2012,11,14,3,96,94,190,216
0132-000,2012,11,14,4,111,105,216,190
0132-000,2012,11,14,5,72,83,155,216
0132-000,2012,11,14,6,150,125,275,155
0132-000,2012,11,14,7,347,362,709,275
0132-000,2012,11,14,8,712,1331,2043,709
0132-000,2012,11,14,9,828,1337,2165,2043
0132-000,2012,11,14,10,727,895,1622,2165
0132-000,2012,11,14,11,739,868,1607,1622
0132-000,2012,11,14,12,642,870,1512,1607
0132-000,2012,11,14,13,449,748,1197,1512
0132-000,2012,11,14,14,545,859,1404,1197
0132-000,2012,11,14,15,673,897,1570,1404
0132-000,2012,11,14,16,980,914,1894,1570
0132-000,2012,11,14,17,1058,829,1887,1894
0132-000,2012,11,14,18,1075,831,1906,1887
0132-000,2012,11,14,19,1142,800,1942,1906
0132-000,2012,11,14,20,877,666,1543,1942
0132-000,2012,11,14,21,666,498,1164,1543
0132-000,2012,11,14,22,583,434,1017,1164
0132-000,2012,11,14,23,383,343,726,1017
0132-000,2012,11,14,24,236,252,488,726
0132-000,2012,11,15,1,171,144,315,488
0132-000,2012,11,15,2,97,103,200,315
0132-000,2012,11,15,3,91,99,190,200
0132-000,2012,11,15,4,78,80,158,190
0132-000,2012,11,15,5,116,133,249,158
0132-000,2012,11,15,6,169,142,311,249
0132-000,2012,11,15,7,339,392,731,311
0132-000,2012,11,15,8,752,1418,2170,731
0132-000,2012,11,15,9,781,1336,2117,2170
0132-000,2012,11,15,10,779,931,1710,2117
0132-000,2012,11,15,11,694,841,1535,1710
0132-000,2012,11,15,12,690,837,1527,1535
0132-000,2012,11,15,13,624,778,1402,1527
0132-000,2012,11,15,14,742,865,1607,1402
0132-000,2012,11,15,15,798,861,1659,1607
0132-000,2012,11,15,16,916,847,1763,1659
0132-000,2012,11,15,17,996,826,1822,1763
0132-000,2012,11,15,18,1143,852,1995,1822
0132-000,2012,11,15,19,1185,832,2017,1995
0132-000,2012,11,15,20,854,607,1461,2017
0132-000,2012,11,15,21,657,483,1140,1461
0132-000,2012,11,15,22,641,468,1109,1140
0132-000,2012,11,15,23,339,313,652,1109
0132-000,2012,11,15,24,277,253,530,652
0132-000,2012,11,16,1,144,154,298,530
0132-000,2012,11,16,2,158,129,287,298
0132-000,2012,11,16,3,77,101,178,287
0132-000,2012,11,16,4,77,116,193,178
0132-000,2012,11,16,5,120,122,242,193
0132-000,2012,11,16,6,161,159,320,242
0132-000,2012,11,16,7,366,372,738,320
0132-000,2012,11,16,8,755,1321,2076,738
0132-000,2012,11,16,9,806,1261,2067,2076
0132-000,2012,11,16,10,784,964,1748,2067
0132-000,2012,11,16,11,844,939,1783,1748
0132-000,2012,11,16,12,865,907,1772,1783
0132-000,2012,11,16,13,756,819,1575,1772
0132-000,2012,11,16,14,850,852,1702,1575
0132-000,2012,11,16,15,896,894,1790,1702
0132-000,2012,11,16,16,970,842,1812,1790
0132-000,2012,11,16,17,985,840,1825,1812
0132-000,2012,11,16,18,1309,906,2215,1825
0132-000,2012,11,16,19,1287,872,2159,2215
0132-000,2012,11,16,20,883,799,1682,2159
0132-000,2012,11,16,21,850,687,1537,1682
0132-000,2012,11,16,22,724,581,1305,1537
0132-000,2012,11,16,23,335,401,736,1305
0132-000,2012,11,16,24,264,267,531,736
0132-000,2012,11,17,1,183,204,387,531
0132-000,2012,11,17,2,168,175,343,387
0132-000,2012,11,17,3,102,124,226,343
0132-000,2012,11,17,4,130,125,255,226
0132-000,2012,11,17,5,85,102,187,255
0132-000,2012,11,17,6,119,144,263,187
0132-000,2012,11,17,7,283,272,555,263
0132-000,2012,11,17,8,496,716,1212,555
0132-000,2012,11,17,9,683,901,1584,1212
0132-000,2012,11,17,10,971,1073,2044,1584
0132-000,2012,11,17,11,1215,1526,2741,2044
0132-000,2012,11,17,12,1456,1683,3139,2741
0132-000,2012,11,17,13,1495,1761,3256,3139
0132-000,2012,11,17,14,1355,1515,2870,3256
0132-000,2012,11,17,15,1817,1573,3390,2870
0132-000,2012,11,17,16,2210,1652,3862,3390
0132-000,2012,11,17,17,2186,1680,3866,3862
0132-000,2012,11,17,18,2447,1559,4006,3866
0132-000,2012,11,17,19,1790,1450,3240,4006
0132-000,2012,11,17,20,1480,1204,2684,3240
0132-000,2012,11,17,21,892,770,1662,2684
0132-000,2012,11,17,22,543,552,1095,1662
0132-000,2012,11,17,23,319,342,661,1095
0132-000,2012,11,17,24,213,219,432,661
0132-000,2012,11,18,1,173,205,378,432
0132-000,2012,11,18,2,122,140,262,378
0132-000,2012,11,18,3,124,116,240,262
0132-000,2012,11,18,4,106,110,216,240
0132-000,2012,11,18,5,80,86,166,216
0132-000,2012,11,18,6,122,141,263,166
0132-000,2012,11,18,7,197,189,386,263
0132-000,2012,11,18,8,228,340,568,386
0132-000,2012,11,18,9,454,540,994,568
0132-000,2012,11,18,10,571,638,1209,994
0132-000,2012,11,18,11,645,715,1360,1209
0132-000,2012,11,18,12,574,605,1179,1360
0132-000,2012,11,18,13,677,630,1307,1179
0132-000,2012,11,18,14,846,729,1575,1307
0132-000,2012,11,18,15,843,769,1612,1575
0132-000,2012,11,18,16,1111,808,1919,1612
0132-000,2012,11,18,17,1333,767,2100,1919
0132-000,2012,11,18,18,1356,798,2154,2100
0132-000,2012,11,18,19,1026,650,1676,2154
0132-000,2012,11,18,20,656,547,1203,1676
0132-000,2012,11,18,21,518,465,983,1203
0132-000,2012,11,18,22,405,447,852,983
0132-000,2012,11,18,23,326,326,652,852
0132-000,2012,11,18,24,198,219,417,652
0132-000,2012,11,19,1,135,167,302,417
0132-000,2012,11,19,2,75,92,167,302
0132-000,2012,11,19,3,75,79,154,167
0132-000,2012,11,19,4,70,77,147,154
0132-000,2012,11,19,5,60,86,146,147
0132-000,2012,11,19,6,168,195,363,146
0132-000,2012,11,19,7,354,448,802,363
0132-000,2012,11,19,8,571,1193,1764,802
0132-000,2012,11,19,9,947,1669,2616,1764
0132-000,2012,11,19,10,729,911,1640,2616
0132-000,2012,11,19,11,719,850,1569,1640
0132-000,2012,11,19,12,642,784,1426,1569
0132-000,2012,11,19,13,627,807,1434,1426
0132-000,2012,11,19,14,556,865,1421,1434
0132-000,2012,11,19,15,705,889,1594,1421
0132-000,2012,11,19,16,805,850,1655,1594
0132-000,2012,11,19,17,779,798,1577,1655
0132-000,2012,11,19,18,956,845,1801,1577
0132-000,2012,11,19,19,1138,786,1924,1801
0132-000,2012,11,19,20,843,636,1479,1924
0132-000,2012,11,19,21,722,515,1237,1479
0132-000,2012,11,19,22,486,446,932,1237
0132-000,2012,11,19,23,256,263,519,932
0132-000,2012,11,19,24,200,188,388,519
0132-000,2012,11,20,1,146,128,274,388
0132-000,2012,11,20,2,113,112,225,274
0132-000,2012,11,20,3,77,104,181,225
0132-000,2012,11,20,4,75,91,166,181
0132-000,2012,11,20,5,75,99,174,166
0132-000,2012,11,20,6,176,159,335,174
0132-000,2012,11,20,7,331,359,690,335
0132-000,2012,11,20,8,570,1129,1699,690
0132-000,2012,11,20,9,717,1196,1913,1699
0132-000,2012,11,20,10,659,902,1561,1913
0132-000,2012,11,20,11,663,875,1538,1561
0132-000,2012,11,20,12,691,851,1542,1538
0132-000,2012,11,20,13,693,779,1472,1542
0132-000,2012,11,20,14,660,869,1529,1472
0132-000,2012,11,20,15,832,888,1720,1529
0132-000,2012,11,20,16,994,839,1833,1720
0132-000,2012,11,20,17,1072,836,1908,1833
0132-000,2012,11,20,18,1064,877,1941,1908
0132-000,2012,11,20,19,1135,788,1923,1941
0132-000,2012,11,20,20,925,641,1566,1923
0132-000,2012,11,20,21,771,539,1310,1566
0132-000,2012,11,20,22,550,441,991,1310
0132-000,2012,11,20,23,439,339,778,991
0132-000,2012,11,20,24,234,223,457,778
0132-000,2012,11,21,1,173,151,324,457
0132-000,2012,11,21,2,83,91,174,324
0132-000,2012,11,21,3,75,101,176,174
0132-000,2012,11,21,4,80,94,174,176
0132-000,2012,11,21,5,81,106,187,174
0132-000,2012,11,21,6,185,153,338,187
0132-000,2012,11,21,7,390,366,756,338
0132-000,2012,11,21,8,702,1293,1995,756
0132-000,2012,11,21,9,793,1352,2145,1995
0132-000,2012,11,21,10,704,902,1606,2145
0132-000,2012,11,21,11,850,907,1757,1606
0132-000,2012,11,21,12,1103,1095,2198,1757
0132-000,2012,11,21,13,735,810,1545,2198
0132-000,2012,11,21,14,854,859,1713,1545
0132-000,2012,11,21,15,853,875,1728,1713
0132-000,2012,11,21,16,903,830,1733,1728
0132-000,2012,11,21,17,1006,833,1839,1733
0132-000,2012,11,21,18,1277,882,2159,1839
0132-000,2012,11,21,19,1104,815,1919,2159
0132-000,2012,11,21,20,829,644,1473,1919
0132-000,2012,11,21,21,680,505,1185,1473
0132-000,2012,11,21,22,612,464,1076,1185
0132-000,2012,11,21,23,363,325,688,1076
0132-000,2012,11,21,24,208,202,410,688
0132-000,2012,11,22,1,169,158,327,410
0132-000,2012,11,22,2,89,121,210,327
0132-000,2012,11,22,3,99,111,210,210
0132-000,2012,11,22,4,78,95,173,210
0132-000,2012,11,22,5,72,97,169,173
0132-000,2012,11,22,6,150,147,297,169
0132-000,2012,11,22,7,331,348,679,297
0132-000,2012,11,22,8,652,1323,1975,679
0132-000,2012,11,22,9,740,1257,1997,1975
0132-000,2012,11,22,10,778,975,1753,1997
0132-000,2012,11,22,11,764,879,1643,1753
0132-000,2012,11,22,12,798,794,1592,1643
0132-000,2012,11,22,13,766,818,1584,1592
0132-000,2012,11,22,14,784,818,1602,1584
0132-000,2012,11,22,15,697,861,1558,1602
0132-000,2012,11,22,16,966,846,1812,1558
0132-000,2012,11,22,17,996,825,1821,1812
0132-000,2012,11,22,18,1273,816,2089,1821
0132-000,2012,11,22,19,1108,803,1911,2089
0132-000,2012,11,22,20,865,603,1468,1911
0132-000,2012,11,22,21,892,556,1448,1468
0132-000,2012,11,22,22,571,452,1023,1448
0132-000,2012,11,22,23,406,344,750,1023
0132-000,2012,11,22,24,242,219,461,750
0132-000,2012,11,23,1,143,155,298,461
0132-000,2012,11,23,2,145,136,281,298
0132-000,2012,11,23,3,83,95,178,281
0132-000,2012,11,23,4,68,84,152,178
0132-000,2012,11,23,5,72,99,171,152
0132-000,2012,11,23,6,154,138,292,171
0132-000,2012,11,23,7,323,345,668,292
0132-000,2012,11,23,8,721,1310,2031,668
0132-000,2012,11,23,9,742,1233,1975,2031
0132-000,2012,11,23,10,787,899,1686,1975
0132-000,2012,11,23,11,727,902,1629,1686
0132-000,2012,11,23,12,806,893,1699,1629
0132-000,2012,11,23,13,558,831,1389,1699
0132-000,2012,11,23,14,620,851,1471,1389
0132-000,2012,11,23,15,830,964,1794,1471
0132-000,2012,11,23,16,998,896,1894,1794
0132-000,2012,11,23,17,1041,866,1907,1894
0132-000,2012,11,23,18,1230,911,2141,1907
0132-000,2012,11,23,19,1178,926,2104,2141
0132-000,2012,11,23,20,1071,897,1968,2104
0132-000,2012,11,23,21,881,765,1646,1968
0132-000,2012,11,23,22,730,677,1407,1646
0132-000,2012,11,23,23,545,512,1057,1407
0132-000,2012,11,23,24,266,296,562,1057
0132-000,2012,11,24,1,219,233,452,562
0132-000,2012,11,24,2,124,141,265,452
0132-000,2012,11,24,3,115,141,256,265
0132-000,2012,11,24,4,92,119,211,256
0132-000,2012,11,24,5,112,131,243,211
0132-000,2012,11,24,6,175,161,336,243
0132-000,2012,11,24,7,265,305,570,336
0132-000,2012,11,24,8,494,709,1203,570
0132-000,2012,11,24,9,710,993,1703,1203
0132-000,2012,11,24,10,771,1231,2002,1703
0132-000,2012,11,24,11,781,1567,2348,2002
0132-000,2012,11,24,12,1023,1744,2767,2348
0132-000,2012,11,24,13,1077,1945,3022,2767
0132-000,2012,11,24,14,1200,1958,3158,3022
0132-000,2012,11,24,15,1515,1902,3417,3158
0132-000,2012,11,24,16,1667,1870,3537,3417
0132-000,2012,11,24,17,1722,1949,3671,3537
0132-000,2012,11,24,18,1680,1797,3477,3671
0132-000,2012,11,24,19,1716,1682,3398,3477
0132-000,2012,11,24,20,1360,1312,2672,3398
0132-000,2012,11,24,21,1085,1017,2102,2672
0132-000,2012,11,24,22,677,725,1402,2102
0132-000,2012,11,24,23,307,387,694,1402
0132-000,2012,11,24,24,218,246,464,694
0132-000,2012,11,25,1,159,195,354,464
0132-000,2012,11,25,2,132,129,261,354
0132-000,2012,11,25,3,112,119,231,261
0132-000,2012,11,25,4,93,93,186,231
0132-000,2012,11,25,5,65,85,150,186
0132-000,2012,11,25,6,114,159,273,150
0132-000,2012,11,25,7,209,240,449,273
0132-000,2012,11,25,8,304,399,703,449
0132-000,2012,11,25,9,416,539,955,703
0132-000,2012,11,25,10,437,616,1053,955
0132-000,2012,11,25,11,477,686,1163,1053
0132-000,2012,11,25,12,566,691,1257,1163
0132-000,2012,11,25,13,575,730,1305,1257
0132-000,2012,11,25,14,682,705,1387,1305
0132-000,2012,11,25,15,831,725,1556,1387
0132-000,2012,11,25,16,1171,791,1962,1556
0132-000,2012,11,25,17,1322,747,2069,1962
0132-000,2012,11,25,18,1382,702,2084,2069
0132-000,2012,11,25,19,1214,586,1800,2084
0132-000,2012,11,25,20,1013,509,1522,1800
0132-000,2012,11,25,21,714,477,1191,1522
0132-000,2012,11,25,22,631,455,1086,1191
0132-000,2012,11,25,23,299,292,591,1086
0132-000,2012,11,25,24,185,202,387,591
0132-000,2012,11,26,1,100,152,252,387
0132-000,2012,11,26,2,84,98,182,252
0132-000,2012,11,26,3,56,68,124,182
0132-000,2012,11,26,4,31,61,92,124
0132-000,2012,11,26,5,71,96,167,92
0132-000,2012,11,26,6,161,172,333,167
0132-000,2012,11,26,7,363,471,834,333
0132-000,2012,11,26,8,702,1505,2207,834
0132-000,2012,11,26,9,854,1441,2295,2207
0132-000,2012,11,26,10,627,924,1551,2295
0132-000,2012,11,26,11,693,866,1559,1551
0132-000,2012,11,26,12,761,862,1623,1559
0132-000,2012,11,26,13,526,840,1366,1623
0132-000,2012,11,26,14,619,918,1537,1366
0132-000,2012,11,26,15,790,868,1658,1537
0132-000,2012,11,26,16,772,820,1592,1658
0132-000,2012,11,26,17,864,813,1677,1592
0132-000,2012,11,26,18,958,787,1745,1677
0132-000,2012,11,26,19,952,724,1676,1745
0132-000,2012,11,26,20,699,551,1250,1676
0132-000,2012,11,26,21,523,462,985,1250
0132-000,2012,11,26,22,507,448,955,985
0132-000,2012,11,26,23,316,291,607,955
0132-000,2012,11,26,24,177,181,358,607
0132-000,2012,11,27,1,164,152,316,358
0132-000,2012,11,27,2,91,92,183,316
0132-000,2012,11,27,3,95,108,203,183
0132-000,2012,11,27,4,61,92,153,203
0132-000,2012,11,27,5,110,122,232,153
0132-000,2012,11,27,6,106,118,224,232
0132-000,2012,11,27,7,306,408,714,224
0132-000,2012,11,27,8,822,1330,2152,714
0132-000,2012,11,27,9,801,1277,2078,2152
0132-000,2012,11,27,10,661,952,1613,2078
0132-000,2012,11,27,11,679,863,1542,1613
0132-000,2012,11,27,12,884,918,1802,1542
0132-000,2012,11,27,13,778,811,1589,1802
0132-000,2012,11,27,14,748,932,1680,1589
0132-000,2012,11,27,15,833,858,1691,1680
0132-000,2012,11,27,16,1037,814,1851,1691
0132-000,2012,11,27,17,931,794,1725,1851
0132-000,2012,11,27,18,1004,848,1852,1725
0132-000,2012,11,27,19,1142,779,1921,1852
0132-000,2012,11,27,20,703,559,1262,1921
0132-000,2012,11,27,21,671,511,1182,1262
0132-000,2012,11,27,22,447,409,856,1182
0132-000,2012,11,27,23,241,260,501,856
0132-000,2012,11,27,24,204,191,395,501
0132-000,2012,11,28,1,127,146,273,395
0132-000,2012,11,28,2,82,101,183,273
0132-000,2012,11,28,3,86,106,192,183
0132-000,2012,11,28,4,85,104,189,192
0132-000,2012,11,28,5,74,88,162,189
0132-000,2012,11,28,6,153,148,301,162
0132-000,2012,11,28,7,303,373,676,301
0132-000,2012,11,28,8,648,1345,1993,676
0132-000,2012,11,28,9,833,1403,2236,1993
0132-000,2012,11,28,10,721,981,1702,2236
0132-000,2012,11,28,11,645,829,1474,1702
0132-000,2012,11,28,12,617,784,1401,1474
0132-000,2012,11,28,13,650,728,1378,1401
0132-000,2012,11,28,14,650,814,1464,1378
0132-000,2012,11,28,15,729,928,1657,1464
0132-000,2012,11,28,16,921,868,1789,1657
0132-000,2012,11,28,17,997,796,1793,1789
0132-000,2012,11,28,18,1060,800,1860,1793
0132-000,2012,11,28,19,1022,772,1794,1860
0132-000,2012,11,28,20,756,596,1352,1794
0132-000,2012,11,28,21,685,507,1192,1352
0132-000,2012,11,28,22,453,469,922,1192
0132-000,2012,11,28,23,284,337,621,922
0132-000,2012,11,28,24,203,211,414,621
0132-000,2012,11,29,1,140,158,298,414
0132-000,2012,11,29,2,90,108,198,298
0132-000,2012,11,29,3,108,106,214,198
0132-000,2012,11,29,4,74,112,186,214
0132-000,2012,11,29,5,110,128,238,186
0132-000,2012,11,29,6,161,148,309,238
0132-000,2012,11,29,7,335,377,712,309
0132-000,2012,11,29,8,368,744,1112,712
0132-000,2012,11,29,9,519,926,1445,1112
0132-000,2012,11,29,10,612,917,1529,1445
0132-000,2012,11,29,11,704,875,1579,1529
0132-000,2012,11,29,12,754,874,1628,1579
0132-000,2012,11,29,13,772,800,1572,1628
0132-000,2012,11,29,14,737,900,1637,1572
0132-000,2012,11,29,15,624,751,1375,1637
0132-000,2012,11,29,16,803,916,1719,1375
0132-000,2012,11,29,17,929,814,1743,1719
0132-000,2012,11,29,18,1145,857,2002,1743
0132-000,2012,11,29,19,1147,757,1904,2002
0132-000,2012,11,29,20,668,604,1272,1904
0132-000,2012,11,29,21,532,503,1035,1272
0132-000,2012,11,29,22,464,456,920,1035
0132-000,2012,11,29,23,315,295,610,920
0132-000,2012,11,29,24,237,225,462,610
0132-000,2012,11,30,1,234,192,426,462
0132-000,2012,11,30,2,143,142,285,426
0132-000,2012,11,30,3,84,110,194,285
0132-000,2012,11,30,4,75,122,197,194
0132-000,2012,11,30,5,112,115,227,197
0132-000,2012,11,30,6,138,141,279,227
0132-000,2012,11,30,7,354,370,724,279
0132-000,2012,11,30,8,673,1255,1928,724
0132-000,2012,11,30,9,740,1197,1937,1928
0132-000,2012,11,30,10,593,898,1491,1937
0132-000,2012,11,30,11,661,856,1517,1491
0132-000,2012,11,30,12,738,854,1592,1517
0132-000,2012,11,30,13,704,761,1465,1592
0132-000,2012,11,30,14,669,848,1517,1465
0132-000,2012,11,30,15,781,804,1585,1517
0132-000,2012,11,30,16,749,867,1616,1585
0132-000,2012,11,30,17,907,886,1793,1616
0132-000,2012,11,30,18,870,819,1689,1793
0132-000,2012,11,30,19,829,820,1649,1689
0132-000,2012,11,30,20,544,726,1270,1649
0132-000,2012,11,30,21,446,570,1016,1270
0132-000,2012,11,30,22,236,509,745,1016
0132-000,2012,11,30,23,156,398,554,745
0132-000,2012,11,30,24,95,306,401,554
0132-000,2012,12,1,1,277,208,485,401
0132-000,2012,12,1,2,168,169,337,485
0132-000,2012,12,1,3,144,134,278,337
0132-000,2012,12,1,4,76,136,212,278
0132-000,2012,12,1,5,125,134,259,212
0132-000,2012,12,1,6,174,187,361,259
0132-000,2012,12,1,7,287,302,589,361
0132-000,2012,12,1,8,414,619,1033,589
0132-000,2012,12,1,9,612,812,1424,1033
0132-000,2012,12,1,10,666,967,1633,1424
0132-000,2012,12,1,11,737,1160,1897,1633
0132-000,2012,12,1,12,846,1447,2293,1897
0132-000,2012,12,1,13,793,1676,2469,2293
0132-000,2012,12,1,14,903,1485,2388,2469
0132-000,2012,12,1,15,989,1392,2381,2388
0132-000,2012,12,1,16,1046,1367,2413,2381
0132-000,2012,12,1,17,1095,1324,2419,2413
0132-000,2012,12,1,18,1196,1302,2498,2419
0132-000,2012,12,1,19,1190,1200,2390,2498
0132-000,2012,12,1,20,713,877,1590,2390
0132-000,2012,12,1,21,660,554,1214,1590
0132-000,2012,12,1,22,537,503,1040,1214
0132-000,2012,12,1,23,379,339,718,1040
0132-000,2012,12,1,24,316,299,615,718
0132-000,2012,12,2,1,232,212,444,615
0132-000,2012,12,2,2,131,182,313,444
0132-000,2012,12,2,3,125,114,239,313
0132-000,2012,12,2,4,66,71,137,239
0132-000,2012,12,2,5,93,159,252,137
0132-000,2012,12,2,6,119,134,253,252
0132-000,2012,12,2,7,205,192,397,253
0132-000,2012,12,2,8,234,324,558,397
0132-000,2012,12,2,9,355,484,839,558
0132-000,2012,12,2,10,502,608,1110,839
0132-000,2012,12,2,11,569,651,1220,1110
0132-000,2012,12,2,12,760,714,1474,1220
0132-000,2012,12,2,13,825,698,1523,1474
0132-000,2012,12,2,14,1022,658,1680,1523
0132-000,2012,12,2,15,1009,695,1704,1680
0132-000,2012,12,2,16,1319,716,2035,1704
0132-000,2012,12,2,17,1476,751,2227,2035
0132-000,2012,12,2,18,1598,794,2392,2227
0132-000,2012,12,2,19,1527,576,2103,2392
0132-000,2012,12,2,20,1314,504,1818,2103
0132-000,2012,12,2,21,1159,447,1606,1818
0132-000,2012,12,2,22,741,395,1136,1606
0132-000,2012,12,2,23,424,291,715,1136
0132-000,2012,12,2,24,226,170,396,715
0132-000,2012,12,3,1,127,145,272,396
0132-000,2012,12,3,2,89,109,198,272
0132-000,2012,12,3,3,33,103,136,198
0132-000,2012,12,3,4,43,67,110,136
0132-000,2012,12,3,5,72,86,158,110
0132-000,2012,12,3,6,158,185,343,158
0132-000,2012,12,3,7,443,498,941,343
0132-000,2012,12,3,8,629,1483,2112,941
0132-000,2012,12,3,9,743,1340,2083,2112
0132-000,2012,12,3,10,715,904,1619,2083
0132-000,2012,12,3,11,731,826,1557,1619
0132-000,2012,12,3,12,809,817,1626,1557
0132-000,2012,12,3,13,770,754,1524,1626
0132-000,2012,12,3,14,797,863,1660,1524
0132-000,2012,12,3,15,995,845,1840,1660
0132-000,2012,12,3,16,891,788,1679,1840
0132-000,2012,12,3,17,823,774,1597,1679
0132-000,2012,12,3,18,1065,732,1797,1597
0132-000,2012,12,3,19,1099,732,1831,1797
0132-000,2012,12,3,20,762,607,1369,1831
0132-000,2012,12,3,21,717,475,1192,1369
0132-000,2012,12,3,22,580,402,982,1192
0132-000,2012,12,3,23,379,281,660,982
0132-000,2012,12,3,24,240,191,431,660
0132-000,2012,12,4,1,146,133,279,431
0132-000,2012,12,4,2,80,94,174,279
0132-000,2012,12,4,3,76,92,168,174
0132-000,2012,12,4,4,76,117,193,168
0132-000,2012,12,4,5,82,94,176,193
0132-000,2012,12,4,6,129,129,258,176
0132-000,2012,12,4,7,322,331,653,258
0132-000,2012,12,4,8,545,1265,1810,653
0132-000,2012,12,4,9,711,1299,2010,1810
0132-000,2012,12,4,10,672,845,1517,2010
0132-000,2012,12,4,11,760,848,1608,1517
0132-000,2012,12,4,12,827,856,1683,1608
0132-000,2012,12,4,13,799,743,1542,1683
0132-000,2012,12,4,14,854,815,1669,1542
0132-000,2012,12,4,15,936,827,1763,1669
0132-000,2012,12,4,16,954,899,1853,1763
0132-000,2012,12,4,17,964,948,1912,1853
0132-000,2012,12,4,18,1043,754,1797,1912
0132-000,2012,12,4,19,1052,790,1842,1797
0132-000,2012,12,4,20,739,624,1363,1842
0132-000,2012,12,4,21,707,496,1203,1363
0132-000,2012,12,4,22,604,432,1036,1203
0132-000,2012,12,4,23,371,298,669,1036
0132-000,2012,12,4,24,226,215,441,669
0132-000,2012,12,5,1,158,169,327,441
0132-000,2012,12,5,2,105,180,285,327
0132-000,2012,12,5,3,84,122,206,285
0132-000,2012,12,5,4,76,84,160,206
0132-000,2012,12,5,5,86,139,225,160
0132-000,2012,12,5,6,136,171,307,225
0132-000,2012,12,5,7,346,360,706,307
0132-000,2012,12,5,8,586,1272,1858,706
0132-000,2012,12,5,9,772,1166,1938,1858
0132-000,2012,12,5,10,707,880,1587,1938
0132-000,2012,12,5,11,793,863,1656,1587
0132-000,2012,12,5,12,805,820,1625,1656
0132-000,2012,12,5,13,827,700,1527,1625
0132-000,2012,12,5,14,838,709,1547,1527
0132-000,2012,12,5,15,725,545,1270,1547
0132-000,2012,12,5,16,596,510,1106,1270
0132-000,2012,12,5,17,645,469,1114,1106
0132-000,2012,12,5,18,770,491,1261,1114
0132-000,2012,12,5,19,780,423,1203,1261
0132-000,2012,12,5,20,455,324,779,1203
0132-000,2012,12,5,21,420,233,653,779
0132-000,2012,12,5,22,297,220,517,653
0132-000,2012,12,5,23,203,164,367,517
0132-000,2012,12,5,24,134,117,251,367
0132-000,2012,12,6,1,111,99,210,251
0132-000,2012,12,6,2,64,81,145,210
0132-000,2012,12,6,3,70,49,119,145
0132-000,2012,12,6,4,33,78,111,119
0132-000,2012,12,6,5,62,71,133,111
0132-000,2012,12,6,6,103,75,178,133
0132-000,2012,12,6,7,207,203,410,178
0132-000,2012,12,6,8,381,876,1257,410
0132-000,2012,12,6,9,606,866,1472,1257
0132-000,2012,12,6,10,569,636,1205,1472
0132-000,2012,12,6,11,600,543,1143,1205
0132-000,2012,12,6,12,635,563,1198,1143
0132-000,2012,12,6,13,643,602,1245,1198
0132-000,2012,12,6,14,721,648,1369,1245
0132-000,2012,12,6,15,764,745,1509,1369
0132-000,2012,12,6,16,851,701,1552,1509
0132-000,2012,12,6,17,790,650,1440,1552
0132-000,2012,12,6,18,711,549,1260,1440
0132-000,2012,12,6,19,823,490,1313,1260
0132-000,2012,12,6,20,643,437,1080,1313
0132-000,2012,12,6,21,502,331,833,1080
0132-000,2012,12,6,22,355,288,643,833
0132-000,2012,12,6,23,234,188,422,643
0132-000,2012,12,6,24,168,124,292,422
0132-000,2012,12,7,1,107,108,215,292
0132-000,2012,12,7,2,72,87,159,215
0132-000,2012,12,7,3,50,84,134,159
0132-000,2012,12,7,4,64,65,129,134
0132-000,2012,12,7,5,35,98,133,129
0132-000,2012,12,7,6,101,114,215,133
0132-000,2012,12,7,7,201,227,428,215
0132-000,2012,12,7,8,408,1040,1448,428
0132-000,2012,12,7,9,578,977,1555,1448
0132-000,2012,12,7,10,592,641,1233,1555
0132-000,2012,12,7,11,535,577,1112,1233
0132-000,2012,12,7,12,463,583,1046,1112
0132-000,2012,12,7,13,533,556,1089,1046
0132-000,2012,12,7,14,576,583,1159,1089
0132-000,2012,12,7,15,743,612,1355,1159
0132-000,2012,12,7,16,752,649,1401,1355
0132-000,2012,12,7,17,739,570,1309,1401
0132-000,2012,12,7,18,901,580,1481,1309
0132-000,2012,12,7,19,907,570,1477,1481
0132-000,2012,12,7,20,686,469,1155,1477
0132-000,2012,12,7,21,545,329,874,1155
0132-000,2012,12,7,22,361,296,657,874
0132-000,2012,12,7,23,228,197,425,657
0132-000,2012,12,7,24,154,206,360,425
0132-000,2012,12,8,1,119,179,298,360
0132-000,2012,12,8,2,115,105,220,298
0132-000,2012,12,8,3,82,115,197,220
0132-000,2012,12,8,4,66,97,163,197
0132-000,2012,12,8,5,62,96,158,163
0132-000,2012,12,8,6,105,102,207,158
0132-000,2012,12,8,7,142,162,304,207
0132-000,2012,12,8,8,305,408,713,304
0132-000,2012,12,8,9,443,625,1068,713
0132-000,2012,12,8,10,434,574,1008,1068
0132-000,2012,12,8,11,524,662,1186,1008
0132-000,2012,12,8,12,619,765,1384,1186
0132-000,2012,12,8,13,680,737,1417,1384
0132-000,2012,12,8,14,711,746,1457,1417
0132-000,2012,12,8,15,797,746,1543,1457
0132-000,2012,12,8,16,823,723,1546,1543
0132-000,2012,12,8,17,907,716,1623,1546
0132-000,2012,12,8,18,918,724,1642,1623
0132-000,2012,12,8,19,854,625,1479,1642
0132-000,2012,12,8,20,518,458,976,1479
0132-000,2012,12,8,21,445,381,826,976
0132-000,2012,12,8,22,389,342,731,826
0132-000,2012,12,8,23,289,306,595,731
0132-000,2012,12,8,24,193,200,393,595
0132-000,2012,12,9,1,117,159,276,393
0132-000,2012,12,9,2,125,158,283,276
0132-000,2012,12,9,3,121,96,217,283
0132-000,2012,12,9,4,54,69,123,217
0132-000,2012,12,9,5,84,75,159,123
0132-000,2012,12,9,6,97,117,214,159
0132-000,2012,12,9,7,258,147,405,214
0132-000,2012,12,9,8,328,333,661,405
0132-000,2012,12,9,9,404,376,780,661
0132-000,2012,12,9,10,477,532,1009,780
0132-000,2012,12,9,11,594,576,1170,1009
0132-000,2012,12,9,12,653,600,1253,1170
0132-000,2012,12,9,13,598,622,1220,1253
0132-000,2012,12,9,14,829,685,1514,1220
0132-000,2012,12,9,15,846,646,1492,1514
0132-000,2012,12,9,16,864,727,1591,1492
0132-000,2012,12,9,17,813,629,1442,1591
0132-000,2012,12,9,18,737,614,1351,1442
0132-000,2012,12,9,19,702,470,1172,1351
0132-000,2012,12,9,20,461,461,922,1172
0132-000,2012,12,9,21,465,356,821,922
0132-000,2012,12,9,22,363,309,672,821
0132-000,2012,12,9,23,179,219,398,672
0132-000,2012,12,9,24,179,178,357,398
0132-000,2012,12,10,1,95,100,195,357
0132-000,2012,12,10,2,54,93,147,195
0132-000,2012,12,10,3,68,52,120,147
0132-000,2012,12,10,4,50,60,110,120
0132-000,2012,12,10,5,64,104,168,110
0132-000,2012,12,10,6,177,168,345,168
0132-000,2012,12,10,7,420,409,829,345
0132-000,2012,12,10,8,614,1438,2052,829
0132-000,2012,12,10,9,735,1370,2105,2052
0132-000,2012,12,10,10,721,932,1653,2105
0132-000,2012,12,10,11,852,893,1745,1653
0132-000,2012,12,10,12,913,881,1794,1745
0132-000,2012,12,10,13,836,788,1624,1794
0132-000,2012,12,10,14,897,899,1796,1624
0132-000,2012,12,10,15,936,924,1860,1796
0132-000,2012,12,10,16,1042,889,1931,1860
0132-000,2012,12,10,17,876,776,1652,1931
0132-000,2012,12,10,18,1038,836,1874,1652
0132-000,2012,12,10,19,1031,736,1767,1874
0132-000,2012,12,10,20,752,627,1379,1767
0132-000,2012,12,10,21,690,501,1191,1379
0132-000,2012,12,10,22,539,399,938,1191
0132-000,2012,12,10,23,336,278,614,938
0132-000,2012,12,10,24,199,173,372,614
0132-000,2012,12,11,1,131,124,255,372
0132-000,2012,12,11,2,105,100,205,255
0132-000,2012,12,11,3,91,106,197,205
0132-000,2012,12,11,4,72,92,164,197
0132-000,2012,12,11,5,60,127,187,164
0132-000,2012,12,11,6,160,175,335,187
0132-000,2012,12,11,7,324,337,661,335
0132-000,2012,12,11,8,588,1359,1947,661
0132-000,2012,12,11,9,719,1355,2074,1947
0132-000,2012,12,11,10,725,899,1624,2074
0132-000,2012,12,11,11,788,855,1643,1624
0132-000,2012,12,11,12,821,866,1687,1643
0132-000,2012,12,11,13,844,831,1675,1687
0132-000,2012,12,11,14,883,939,1822,1675
0132-000,2012,12,11,15,989,904,1893,1822
0132-000,2012,12,11,16,993,844,1837,1893
0132-000,2012,12,11,17,983,804,1787,1837
0132-000,2012,12,11,18,1016,839,1855,1787
0132-000,2012,12,11,19,1005,687,1692,1855
0132-000,2012,12,11,20,741,592,1333,1692
0132-000,2012,12,11,21,688,479,1167,1333
0132-000,2012,12,11,22,543,372,915,1167
0132-000,2012,12,11,23,328,305,633,915
0132-000,2012,12,11,24,267,241,508,633
0132-000,2012,12,12,1,177,150,327,508
0132-000,2012,12,12,2,121,125,246,327
0132-000,2012,12,12,3,97,86,183,246
0132-000,2012,12,12,4,72,84,156,183
0132-000,2012,12,12,5,80,114,194,156
0132-000,2012,12,12,6,170,148,318,194
0132-000,2012,12,12,7,330,350,680,318
0132-000,2012,12,12,8,559,1272,1831,680
0132-000,2012,12,12,9,772,1356,2128,1831
0132-000,2012,12,12,10,725,852,1577,2128
0132-000,2012,12,12,11,741,837,1578,1577
0132-000,2012,12,12,12,846,811,1657,1578
0132-000,2012,12,12,13,786,826,1612,1657
0132-000,2012,12,12,14,852,881,1733,1612
0132-000,2012,12,12,15,940,858,1798,1733
0132-000,2012,12,12,16,1005,850,1855,1798
0132-000,2012,12,12,17,954,827,1781,1855
0132-000,2012,12,12,18,1108,787,1895,1781
0132-000,2012,12,12,19,1093,766,1859,1895
0132-000,2012,12,12,20,827,612,1439,1859
0132-000,2012,12,12,21,668,464,1132,1439
0132-000,2012,12,12,22,504,489,993,1132
0132-000,2012,12,12,23,383,353,736,993
0132-000,2012,12,12,24,254,249,503,736
0132-000,2012,12,13,1,174,176,350,503
0132-000,2012,12,13,2,125,121,246,350
0132-000,2012,12,13,3,117,120,237,246
0132-000,2012,12,13,4,76,97,173,237
0132-000,2012,12,13,5,72,116,188,173
0132-000,2012,12,13,6,160,162,322,188
0132-000,2012,12,13,7,310,350,660,322
0132-000,2012,12,13,8,612,1314,1926,660
0132-000,2012,12,13,9,774,1293,2067,1926
0132-000,2012,12,13,10,723,873,1596,2067
0132-000,2012,12,13,11,821,841,1662,1596
0132-000,2012,12,13,12,864,859,1723,1662
0132-000,2012,12,13,13,786,750,1536,1723
0132-000,2012,12,13,14,924,893,1817,1536
0132-000,2012,12,13,15,1020,902,1922,1817
0132-000,2012,12,13,16,1046,854,1900,1922
0132-000,2012,12,13,17,1050,844,1894,1900
0132-000,2012,12,13,18,1054,792,1846,1894
0132-000,2012,12,13,19,1069,762,1831,1846
0132-000,2012,12,13,20,786,636,1422,1831
0132-000,2012,12,13,21,709,481,1190,1422
0132-000,2012,12,13,22,584,427,1011,1190
0132-000,2012,12,13,23,363,272,635,1011
0132-000,2012,12,13,24,277,227,504,635
0132-000,2012,12,14,1,166,179,345,504
0132-000,2012,12,14,2,127,146,273,345
0132-000,2012,12,14,3,101,91,192,273
0132-000,2012,12,14,4,103,127,230,192
0132-000,2012,12,14,5,82,123,205,230
0132-000,2012,12,14,6,197,151,348,205
0132-000,2012,12,14,7,297,323,620,348
0132-000,2012,12,14,8,447,853,1300,620
0132-000,2012,12,14,9,672,909,1581,1300
0132-000,2012,12,14,10,711,1083,1794,1581
0132-000,2012,12,14,11,668,719,1387,1794
0132-000,2012,12,14,12,733,795,1528,1387
0132-000,2012,12,14,13,678,729,1407,1528
0132-000,2012,12,14,14,797,769,1566,1407
0132-000,2012,12,14,15,815,810,1625,1566
0132-000,2012,12,14,16,940,768,1708,1625
0132-000,2012,12,14,17,1007,733,1740,1708
0132-000,2012,12,14,18,1114,733,1847,1740
0132-000,2012,12,14,19,1170,774,1944,1847
0132-000,2012,12,14,20,854,588,1442,1944
0132-000,2012,12,14,21,666,511,1177,1442
0132-000,2012,12,14,22,498,391,889,1177
0132-000,2012,12,14,23,441,301,742,889
0132-000,2012,12,14,24,269,212,481,742
0132-000,2012,12,15,1,193,194,387,481
0132-000,2012,12,15,2,144,135,279,387
0132-000,2012,12,15,3,129,110,239,279
0132-000,2012,12,15,4,123,118,241,239
0132-000,2012,12,15,5,93,82,175,241
0132-000,2012,12,15,6,127,122,249,175
0132-000,2012,12,15,7,211,208,419,249
0132-000,2012,12,15,8,416,584,1000,419
0132-000,2012,12,15,9,543,706,1249,1000
0132-000,2012,12,15,10,655,769,1424,1249
0132-000,2012,12,15,11,778,1054,1832,1424
0132-000,2012,12,15,12,881,1391,2272,1832
0132-000,2012,12,15,13,809,1349,2158,2272
0132-000,2012,12,15,14,799,1252,2051,2158
0132-000,2012,12,15,15,909,1130,2039,2051
0132-000,2012,12,15,16,1028,1236,2264,2039
0132-000,2012,12,15,17,1163,1269,2432,2264
0132-000,2012,12,15,18,1313,1236,2549,2432
0132-000,2012,12,15,19,1132,1057,2189,2549
0132-000,2012,12,15,20,721,627,1348,2189
0132-000,2012,12,15,21,574,527,1101,1348
0132-000,2012,12,15,22,475,428,903,1101
0132-000,2012,12,15,23,359,308,667,903
0132-000,2012,12,15,24,262,230,492,667
0132-000,2012,12,16,1,232,238,470,492
0132-000,2012,12,16,2,172,186,358,470
0132-000,2012,12,16,3,113,123,236,358
0132-000,2012,12,16,4,105,114,219,236
0132-000,2012,12,16,5,89,85,174,219
0132-000,2012,12,16,6,109,138,247,174
0132-000,2012,12,16,7,187,187,374,247
0132-000,2012,12,16,8,230,337,567,374
0132-000,2012,12,16,9,381,456,837,567
0132-000,2012,12,16,10,477,494,971,837
0132-000,2012,12,16,11,551,614,1165,971
0132-000,2012,12,16,12,572,701,1273,1165
0132-000,2012,12,16,13,713,631,1344,1273
0132-000,2012,12,16,14,743,682,1425,1344
0132-000,2012,12,16,15,829,661,1490,1425
0132-000,2012,12,16,16,858,706,1564,1490
0132-000,2012,12,16,17,975,644,1619,1564
0132-000,2012,12,16,18,983,660,1643,1619
0132-000,2012,12,16,19,901,528,1429,1643
0132-000,2012,12,16,20,670,475,1145,1429
0132-000,2012,12,16,21,524,452,976,1145
0132-000,2012,12,16,22,391,354,745,976
0132-000,2012,12,16,23,252,264,516,745
0132-000,2012,12,16,24,185,183,368,516
0132-000,2012,12,17,1,129,135,264,368
0132-000,2012,12,17,2,82,85,167,264
0132-000,2012,12,17,3,72,94,166,167
0132-000,2012,12,17,4,60,63,123,166
0132-000,2012,12,17,5,70,104,174,123
0132-000,2012,12,17,6,181,176,357,174
0132-000,2012,12,17,7,371,405,776,357
0132-000,2012,12,17,8,623,1400,2023,776
0132-000,2012,12,17,9,793,1291,2084,2023
0132-000,2012,12,17,10,678,854,1532,2084
0132-000,2012,12,17,11,739,787,1526,1532
0132-000,2012,12,17,12,731,814,1545,1526
0132-000,2012,12,17,13,725,752,1477,1545
0132-000,2012,12,17,14,833,912,1745,1477
0132-000,2012,12,17,15,829,921,1750,1745
0132-000,2012,12,17,16,993,816,1809,1750
0132-000,2012,12,17,17,868,851,1719,1809
0132-000,2012,12,17,18,989,815,1804,1719
0132-000,2012,12,17,19,1070,686,1756,1804
0132-000,2012,12,17,20,723,583,1306,1756
0132-000,2012,12,17,21,684,464,1148,1306
0132-000,2012,12,17,22,578,408,986,1148
0132-000,2012,12,17,23,318,254,572,986
0132-000,2012,12,17,24,242,190,432,572
0132-000,2012,12,18,1,162,164,326,432
0132-000,2012,12,18,2,111,109,220,326
0132-000,2012,12,18,3,103,107,210,220
0132-000,2012,12,18,4,72,86,158,210
0132-000,2012,12,18,5,76,102,178,158
0132-000,2012,12,18,6,156,136,292,178
0132-000,2012,12,18,7,293,347,640,292
0132-000,2012,12,18,8,592,1284,1876,640
0132-000,2012,12,18,9,760,1258,2018,1876
0132-000,2012,12,18,10,721,859,1580,2018
0132-000,2012,12,18,11,762,861,1623,1580
0132-000,2012,12,18,12,764,829,1593,1623
0132-000,2012,12,18,13,860,748,1608,1593
0132-000,2012,12,18,14,887,865,1752,1608
0132-000,2012,12,18,15,940,910,1850,1752
0132-000,2012,12,18,16,969,831,1800,1850
0132-000,2012,12,18,17,1020,806,1826,1800
0132-000,2012,12,18,18,1112,845,1957,1826
0132-000,2012,12,18,19,1145,748,1893,1957
0132-000,2012,12,18,20,924,674,1598,1893
0132-000,2012,12,18,21,780,534,1314,1598
0132-000,2012,12,18,22,637,516,1153,1314
0132-000,2012,12,18,23,469,336,805,1153
0132-000,2012,12,18,24,287,238,525,805
0132-000,2012,12,19,1,226,211,437,525
0132-000,2012,12,19,2,154,164,318,437
0132-000,2012,12,19,3,121,107,228,318
0132-000,2012,12,19,4,115,116,231,228
0132-000,2012,12,19,5,70,104,174,231
0132-000,2012,12,19,6,123,139,262,174
0132-000,2012,12,19,7,281,272,553,262
0132-000,2012,12,19,8,418,661,1079,553
0132-000,2012,12,19,9,590,777,1367,1079
0132-000,2012,12,19,10,756,849,1605,1367
0132-000,2012,12,19,11,797,774,1571,1605
0132-000,2012,12,19,12,756,819,1575,1571
0132-000,2012,12,19,13,780,810,1590,1575
0132-000,2012,12,19,14,848,814,1662,1590
0132-000,2012,12,19,15,926,806,1732,1662
0132-000,2012,12,19,16,991,832,1823,1732
0132-000,2012,12,19,17,930,740,1670,1823
0132-000,2012,12,19,18,903,763,1666,1670
0132-000,2012,12,19,19,786,664,1450,1666
0132-000,2012,12,19,20,510,506,1016,1450
0132-000,2012,12,19,21,483,431,914,1016
0132-000,2012,12,19,22,410,345,755,914
0132-000,2012,12,19,23,297,245,542,755
0132-000,2012,12,19,24,185,190,375,542
0132-000,2012,12,20,1,131,149,280,375
0132-000,2012,12,20,2,97,99,196,280
0132-000,2012,12,20,3,68,115,183,196
0132-000,2012,12,20,4,62,99,161,183
0132-000,2012,12,20,5,76,115,191,161
0132-000,2012,12,20,6,164,149,313,191
0132-000,2012,12,20,7,353,394,747,313
0132-000,2012,12,20,8,578,1438,2016,747
0132-000,2012,12,20,9,727,1265,1992,2016
0132-000,2012,12,20,10,647,882,1529,1992
0132-000,2012,12,20,11,731,830,1561,1529
0132-000,2012,12,20,12,801,878,1679,1561
0132-000,2012,12,20,13,731,732,1463,1679
0132-000,2012,12,20,14,803,849,1652,1463
0132-000,2012,12,20,15,930,886,1816,1652
0132-000,2012,12,20,16,950,873,1823,1816
0132-000,2012,12,20,17,899,819,1718,1823
0132-000,2012,12,20,18,1055,844,1899,1718
0132-000,2012,12,20,19,1024,680,1704,1899
0132-000,2012,12,20,20,799,569,1368,1704
0132-000,2012,12,20,21,684,499,1183,1368
0132-000,2012,12,20,22,596,434,1030,1183
0132-000,2012,12,20,23,432,373,805,1030
0132-000,2012,12,20,24,258,231,489,805
0132-000,2012,12,21,1,191,175,366,489
0132-000,2012,12,21,2,154,112,266,366
0132-000,2012,12,21,3,101,123,224,266
0132-000,2012,12,21,4,82,133,215,224
0132-000,2012,12,21,5,101,121,222,215
0132-000,2012,12,21,6,193,136,329,222
0132-000,2012,12,21,7,283,350,633,329
0132-000,2012,12,21,8,516,1267,1783,633
0132-000,2012,12,21,9,784,1266,2050,1783
0132-000,2012,12,21,10,680,916,1596,2050
0132-000,2012,12,21,11,752,795,1547,1596
0132-000,2012,12,21,12,735,710,1445,1547
0132-000,2012,12,21,13,743,677,1420,1445
0132-000,2012,12,21,14,762,741,1503,1420
0132-000,2012,12,21,15,768,748,1516,1503
0132-000,2012,12,21,16,836,705,1541,1516
0132-000,2012,12,21,17,776,736,1512,1541
0132-000,2012,12,21,18,1067,756,1823,1512
0132-000,2012,12,21,19,1140,745,1885,1823
0132-000,2012,12,21,20,821,597,1418,1885
0132-000,2012,12,21,21,686,517,1203,1418
0132-000,2012,12,21,22,580,465,1045,1203
0132-000,2012,12,21,23,418,306,724,1045
0132-000,2012,12,21,24,312,225,537,724
0132-000,2012,12,22,1,209,236,445,537
0132-000,2012,12,22,2,160,170,330,445
0132-000,2012,12,22,3,152,110,262,330
0132-000,2012,12,22,4,80,131,211,262
0132-000,2012,12,22,5,134,125,259,211
0132-000,2012,12,22,6,127,131,258,259
0132-000,2012,12,22,7,293,223,516,258
0132-000,2012,12,22,8,385,646,1031,516
0132-000,2012,12,22,9,547,750,1297,1031
0132-000,2012,12,22,10,635,795,1430,1297
0132-000,2012,12,22,11,739,809,1548,1430
0132-000,2012,12,22,12,793,982,1775,1548
0132-000,2012,12,22,13,750,1081,1831,1775
0132-000,2012,12,22,14,872,1021,1893,1831
0132-000,2012,12,22,15,971,1185,2156,1893
0132-000,2012,12,22,16,928,1081,2009,2156
0132-000,2012,12,22,17,942,1116,2058,2009
0132-000,2012,12,22,18,1112,1072,2184,2058
0132-000,2012,12,22,19,940,933,1873,2184
0132-000,2012,12,22,20,565,613,1178,1873
0132-000,2012,12,22,21,459,475,934,1178
0132-000,2012,12,22,22,457,422,879,934
0132-000,2012,12,22,23,363,330,693,879
0132-000,2012,12,22,24,254,231,485,693
0132-000,2012,12,23,1,179,258,437,485
0132-000,2012,12,23,2,162,206,368,437
0132-000,2012,12,23,3,93,117,210,368
0132-000,2012,12,23,4,101,101,202,210
0132-000,2012,12,23,5,89,107,196,202
0132-000,2012,12,23,6,91,132,223,196
0132-000,2012,12,23,7,138,136,274,223
0132-000,2012,12,23,8,174,296,470,274
0132-000,2012,12,23,9,316,371,687,470
0132-000,2012,12,23,10,391,450,841,687
0132-000,2012,12,23,11,467,563,1030,841
0132-000,2012,12,23,12,572,522,1094,1030
0132-000,2012,12,23,13,635,571,1206,1094
0132-000,2012,12,23,14,668,583,1251,1206
0132-000,2012,12,23,15,825,612,1437,1251
0132-000,2012,12,23,16,829,637,1466,1437
0132-000,2012,12,23,17,899,598,1497,1466
0132-000,2012,12,23,18,931,625,1556,1497
0132-000,2012,12,23,19,780,519,1299,1556
0132-000,2012,12,23,20,580,403,983,1299
0132-000,2012,12,23,21,391,418,809,983
0132-000,2012,12,23,22,357,328,685,809
0132-000,2012,12,23,23,250,250,500,685
0132-000,2012,12,23,24,131,202,333,500
0132-000,2012,12,24,1,127,141,268,333
0132-000,2012,12,24,2,76,99,175,268
0132-000,2012,12,24,3,58,82,140,175
0132-000,2012,12,24,4,52,98,150,140
0132-000,2012,12,24,5,54,92,146,150
0132-000,2012,12,24,6,129,163,292,146
0132-000,2012,12,24,7,322,371,693,292
0132-000,2012,12,24,8,522,1272,1794,693
0132-000,2012,12,24,9,696,1108,1804,1794
0132-000,2012,12,24,10,668,768,1436,1804
0132-000,2012,12,24,11,743,784,1527,1436
0132-000,2012,12,24,12,811,825,1636,1527
0132-000,2012,12,24,13,786,739,1525,1636
0132-000,2012,12,24,14,854,838,1692,1525
0132-000,2012,12,24,15,930,874,1804,1692
0132-000,2012,12,24,16,952,875,1827,1804
0132-000,2012,12,24,17,905,791,1696,1827
0132-000,2012,12,24,18,1108,892,2000,1696
0132-000,2012,12,24,19,1256,800,2056,2000
0132-000,2012,12,24,20,868,744,1612,2056
0132-000,2012,12,24,21,637,501,1138,1612
0132-000,2012,12,24,22,574,446,1020,1138
0132-000,2012,12,24,23,361,359,720,1020
0132-000,2012,12,24,24,283,250,533,720
0132-000,2012,12,25,1,170,214,384,533
0132-000,2012,12,25,2,142,136,278,384
0132-000,2012,12,25,3,111,129,240,278
0132-000,2012,12,25,4,113,106,219,240
0132-000,2012,12,25,5,105,108,213,219
0132-000,2012,12,25,6,125,103,228,213
0132-000,2012,12,25,7,148,140,288,228
0132-000,2012,12,25,8,215,347,562,288
0132-000,2012,12,25,9,310,351,661,562
0132-000,2012,12,25,10,285,379,664,661
0132-000,2012,12,25,11,426,478,904,664
0132-000,2012,12,25,12,510,486,996,904
0132-000,2012,12,25,13,606,550,1156,996
0132-000,2012,12,25,14,709,584,1293,1156
0132-000,2012,12,25,15,737,627,1364,1293
0132-000,2012,12,25,16,698,674,1372,1364
0132-000,2012,12,25,17,758,677,1435,1372
0132-000,2012,12,25,18,773,634,1407,1435
0132-000,2012,12,25,19,580,519,1099,1407
0132-000,2012,12,25,20,547,453,1000,1099
0132-000,2012,12,25,21,453,377,830,1000
0132-000,2012,12,25,22,379,349,728,830
0132-000,2012,12,25,23,252,247,499,728
0132-000,2012,12,25,24,197,190,387,499
0132-000,2012,12,26,1,121,160,281,387
0132-000,2012,12,26,2,101,104,205,281
0132-000,2012,12,26,3,62,100,162,205
0132-000,2012,12,26,4,58,92,150,162
0132-000,2012,12,26,5,72,72,144,150
0132-000,2012,12,26,6,148,123,271,144
0132-000,2012,12,26,7,330,363,693,271
0132-000,2012,12,26,8,574,1387,1961,693
0132-000,2012,12,26,9,768,1319,2087,1961
0132-000,2012,12,26,10,598,778,1376,2087
0132-000,2012,12,26,11,729,803,1532,1376
0132-000,2012,12,26,12,768,816,1584,1532
0132-000,2012,12,26,13,813,792,1605,1584
0132-000,2012,12,26,14,846,801,1647,1605
0132-000,2012,12,26,15,930,914,1844,1647
0132-000,2012,12,26,16,909,891,1800,1844
0132-000,2012,12,26,17,958,816,1774,1800
0132-000,2012,12,26,18,1075,794,1869,1774
0132-000,2012,12,26,19,1073,756,1829,1869
0132-000,2012,12,26,20,780,593,1373,1829
0132-000,2012,12,26,21,631,509,1140,1373
0132-000,2012,12,26,22,541,456,997,1140
0132-000,2012,12,26,23,348,306,654,997
0132-000,2012,12,26,24,244,202,446,654
0132-000,2012,12,27,1,177,171,348,446
0132-000,2012,12,27,2,103,116,219,348
0132-000,2012,12,27,3,89,82,171,219
0132-000,2012,12,27,4,76,120,196,171
0132-000,2012,12,27,5,70,114,184,196
0132-000,2012,12,27,6,146,138,284,184
0132-000,2012,12,27,7,303,306,609,284
0132-000,2012,12,27,8,565,1290,1855,609
0132-000,2012,12,27,9,698,1184,1882,1855
0132-000,2012,12,27,10,709,780,1489,1882
0132-000,2012,12,27,11,741,838,1579,1489
0132-000,2012,12,27,12,754,788,1542,1579
0132-000,2012,12,27,13,846,760,1606,1542
0132-000,2012,12,27,14,887,818,1705,1606
0132-000,2012,12,27,15,901,821,1722,1705
0132-000,2012,12,27,16,907,854,1761,1722
0132-000,2012,12,27,17,909,799,1708,1761
0132-000,2012,12,27,18,1063,782,1845,1708
0132-000,2012,12,27,19,1054,731,1785,1845
0132-000,2012,12,27,20,780,606,1386,1785
0132-000,2012,12,27,21,688,475,1163,1386
0132-000,2012,12,27,22,551,417,968,1163
0132-000,2012,12,27,23,408,304,712,968
0132-000,2012,12,27,24,285,205,490,712
0132-000,2012,12,28,1,187,197,384,490
0132-000,2012,12,28,2,152,120,272,384
0132-000,2012,12,28,3,105,127,232,272
0132-000,2012,12,28,4,82,88,170,232
0132-000,2012,12,28,5,97,119,216,170
0132-000,2012,12,28,6,166,126,292,216
0132-000,2012,12,28,7,305,314,619,292
0132-000,2012,12,28,8,535,1235,1770,619
0132-000,2012,12,28,9,610,1138,1748,1770
0132-000,2012,12,28,10,578,755,1333,1748
0132-000,2012,12,28,11,666,695,1361,1333
0132-000,2012,12,28,12,709,749,1458,1361
0132-000,2012,12,28,13,801,717,1518,1458
0132-000,2012,12,28,14,823,789,1612,1518
0132-000,2012,12,28,15,819,760,1579,1612
0132-000,2012,12,28,16,813,768,1581,1579
0132-000,2012,12,28,17,899,726,1625,1581
0132-000,2012,12,28,18,1116,707,1823,1625
0132-000,2012,12,28,19,1097,741,1838,1823
0132-000,2012,12,28,20,801,608,1409,1838
0132-000,2012,12,28,21,655,510,1165,1409
0132-000,2012,12,28,22,520,445,965,1165
0132-000,2012,12,28,23,426,363,789,965
0132-000,2012,12,28,24,277,264,541,789
0132-000,2012,12,29,1,226,239,465,541
0132-000,2012,12,29,2,205,146,351,465
0132-000,2012,12,29,3,127,131,258,351
0132-000,2012,12,29,4,117,139,256,258
0132-000,2012,12,29,5,115,143,258,256
0132-000,2012,12,29,6,140,155,295,258
0132-000,2012,12,29,7,252,234,486,295
0132-000,2012,12,29,8,426,602,1028,486
0132-000,2012,12,29,9,524,714,1238,1028
0132-000,2012,12,29,10,612,703,1315,1238
0132-000,2012,12,29,11,795,801,1596,1315
0132-000,2012,12,29,12,748,932,1680,1596
0132-000,2012,12,29,13,737,1010,1747,1680
0132-000,2012,12,29,14,829,1078,1907,1747
0132-000,2012,12,29,15,870,1114,1984,1907
0132-000,2012,12,29,16,983,1129,2112,1984
0132-000,2012,12,29,17,940,1149,2089,2112
0132-000,2012,12,29,18,1044,1015,2059,2089
0132-000,2012,12,29,19,928,928,1856,2059
0132-000,2012,12,29,20,590,540,1130,1856
0132-000,2012,12,29,21,377,370,747,1130
0132-000,2012,12,29,22,428,353,781,747
0132-000,2012,12,29,23,277,237,514,781
0132-000,2012,12,29,24,219,174,393,514
0132-000,2012,12,30,1,138,165,303,393
0132-000,2012,12,30,2,121,123,244,303
0132-000,2012,12,30,3,103,90,193,244
0132-000,2012,12,30,4,93,152,245,193
0132-000,2012,12,30,5,84,74,158,245
0132-000,2012,12,30,6,66,94,160,158
0132-000,2012,12,30,7,76,116,192,160
0132-000,2012,12,30,8,129,213,342,192
0132-000,2012,12,30,9,215,248,463,342
0132-000,2012,12,30,10,256,321,577,463
0132-000,2012,12,30,11,260,416,676,577
0132-000,2012,12,30,12,383,411,794,676
0132-000,2012,12,30,13,524,465,989,794
0132-000,2012,12,30,14,543,448,991,989
0132-000,2012,12,30,15,621,502,1123,991
0132-000,2012,12,30,16,836,518,1354,1123
0132-000,2012,12,30,17,733,867,1600,1354
0132-000,2012,12,30,18,672,826,1498,1600
0132-000,2012,12,30,19,629,441,1070,1498
0132-000,2012,12,30,20,524,389,913,1070
0132-000,2012,12,30,21,348,336,684,913
0132-000,2012,12,30,22,316,290,606,684
0132-000,2012,12,30,23,203,227,430,606
0132-000,2012,12,30,24,131,144,275,430
0132-000,2012,12,31,1,117,120,237,275
0132-000,2012,12,31,2,86,84,170,237
0132-000,2012,12,31,3,86,84,170,170
0132-000,2012,12,31,4,41,82,123,170
0132-000,2012,12,31,5,60,84,144,123
0132-000,2012,12,31,6,95,120,215,144
0132-000,2012,12,31,7,234,251,485,215
0132-000,2012,12,31,8,400,869,1269,485
0132-000,2012,12,31,9,498,862,1360,1269
0132-000,2012,12,31,10,549,651,1200,1360
0132-000,2012,12,31,11,639,650,1289,1200
0132-000,2012,12,31,12,664,697,1361,1289
0132-000,2012,12,31,13,696,690,1386,1361
0132-000,2012,12,31,14,801,750,1551,1386
0132-000,2012,12,31,15,854,740,1594,1551
0132-000,2012,12,31,16,907,760,1667,1594
0132-000,2012,12,31,17,883,789,1672,1667
0132-000,2012,12,31,18,995,759,1754,1672
0132-000,2012,12,31,19,889,740,1629,1754
0132-000,2012,12,31,20,717,662,1379,1629
0132-000,2012,12,31,21,451,427,878,1379
0132-000,2012,12,31,22,443,384,827,878
0132-000,2012,12,31,23,350,312,662,827
0132-000,2012,12,31,24,207,236,443,662
0132-000,2013,1,1,1,156,174,330,443
0132-000,2013,1,1,2,214,186,400,330
0132-000,2013,1,1,3,79,141,220,400
0132-000,2013,1,1,4,105,123,228,220
0132-000,2013,1,1,5,73,100,173,228
0132-000,2013,1,1,6,130,103,233,173
0132-000,2013,1,1,7,133,130,263,233
0132-000,2013,1,1,8,97,200,297,263
0132-000,2013,1,1,9,142,211,353,297
0132-000,2013,1,1,10,246,279,525,353
0132-000,2013,1,1,11,335,352,687,525
0132-000,2013,1,1,12,448,476,924,687
0132-000,2013,1,1,13,484,478,962,924
0132-000,2013,1,1,14,463,488,951,962
0132-000,2013,1,1,15,477,481,958,951
0132-000,2013,1,1,16,646,545,1191,958
0132-000,2013,1,1,17,633,534,1167,1191
0132-000,2013,1,1,18,548,458,1006,1167
0132-000,2013,1,1,19,563,410,973,1006
0132-000,2013,1,1,20,416,327,743,973
0132-000,2013,1,1,21,493,340,833,743
0132-000,2013,1,1,22,333,240,573,833
0132-000,2013,1,1,23,276,211,487,573
0132-000,2013,1,1,24,132,131,263,487
0132-000,2013,1,2,1,125,131,256,263
0132-000,2013,1,2,2,96,122,218,256
0132-000,2013,1,2,3,57,74,131,218
0132-000,2013,1,2,4,51,60,111,131
0132-000,2013,1,2,5,49,63,112,111
0132-000,2013,1,2,6,138,117,255,112
0132-000,2013,1,2,7,226,252,478,255
0132-000,2013,1,2,8,526,1015,1541,478
0132-000,2013,1,2,9,590,929,1519,1541
0132-000,2013,1,2,10,505,574,1079,1519
0132-000,2013,1,2,11,492,537,1029,1079
0132-000,2013,1,2,12,514,531,1045,1029
0132-000,2013,1,2,13,597,597,1194,1045
0132-000,2013,1,2,14,669,678,1347,1194
0132-000,2013,1,2,15,643,632,1275,1347
0132-000,2013,1,2,16,675,633,1308,1275
0132-000,2013,1,2,17,796,636,1432,1308
0132-000,2013,1,2,18,810,623,1433,1432
0132-000,2013,1,2,19,823,572,1395,1433
0132-000,2013,1,2,20,603,490,1093,1395
0132-000,2013,1,2,21,452,358,810,1093
0132-000,2013,1,2,22,328,327,655,810
0132-000,2013,1,2,23,210,228,438,655
0132-000,2013,1,2,24,151,142,293,438
0132-000,2013,1,3,1,98,119,217,293
0132-000,2013,1,3,2,110,100,210,217
0132-000,2013,1,3,3,72,108,180,210
0132-000,2013,1,3,4,55,89,144,180
0132-000,2013,1,3,5,76,82,158,144
0132-000,2013,1,3,6,95,76,171,158
0132-000,2013,1,3,7,267,285,552,171
0132-000,2013,1,3,8,495,1200,1695,552
0132-000,2013,1,3,9,594,973,1567,1695
0132-000,2013,1,3,10,479,694,1173,1567
0132-000,2013,1,3,11,401,754,1155,1173
0132-000,2013,1,3,12,486,723,1209,1155
0132-000,2013,1,3,13,996,725,1721,1209
0132-000,2013,1,3,14,1170,725,1895,1721
0132-000,2013,1,3,15,913,758,1671,1895
0132-000,2013,1,3,16,821,704,1525,1671
0132-000,2013,1,3,17,836,677,1513,1525
0132-000,2013,1,3,18,800,652,1452,1513
0132-000,2013,1,3,19,999,700,1699,1452
0132-000,2013,1,3,20,774,541,1315,1699
0132-000,2013,1,3,21,554,392,946,1315
0132-000,2013,1,3,22,383,343,726,946
0132-000,2013,1,3,23,356,285,641,726
0132-000,2013,1,3,24,201,189,390,641
0132-000,2013,1,4,1,160,134,294,390
0132-000,2013,1,4,2,93,113,206,294
0132-000,2013,1,4,3,58,76,134,206
0132-000,2013,1,4,4,82,93,175,134
0132-000,2013,1,4,5,63,89,152,175
0132-000,2013,1,4,6,171,120,291,152
0132-000,2013,1,4,7,257,277,534,291
0132-000,2013,1,4,8,665,1224,1889,534
0132-000,2013,1,4,9,716,1055,1771,1889
0132-000,2013,1,4,10,721,792,1513,1771
0132-000,2013,1,4,11,693,805,1498,1513
0132-000,2013,1,4,12,780,774,1554,1498
0132-000,2013,1,4,13,759,735,1494,1554
0132-000,2013,1,4,14,819,806,1625,1494
0132-000,2013,1,4,15,790,816,1606,1625
0132-000,2013,1,4,16,894,794,1688,1606
0132-000,2013,1,4,17,917,749,1666,1688
0132-000,2013,1,4,18,1037,719,1756,1666
0132-000,2013,1,4,19,1282,801,2083,1756
0132-000,2013,1,4,20,879,644,1523,2083
0132-000,2013,1,4,21,675,533,1208,1523
0132-000,2013,1,4,22,516,416,932,1208
0132-000,2013,1,4,23,397,319,716,932
0132-000,2013,1,4,24,219,229,448,716
0132-000,2013,1,5,1,200,208,408,448
0132-000,2013,1,5,2,105,124,229,408
0132-000,2013,1,5,3,71,100,171,229
0132-000,2013,1,5,4,65,87,152,171
0132-000,2013,1,5,5,95,115,210,152
0132-000,2013,1,5,6,158,108,266,210
0132-000,2013,1,5,7,205,194,399,266
0132-000,2013,1,5,8,386,588,974,399
0132-000,2013,1,5,9,486,676,1162,974
0132-000,2013,1,5,10,647,722,1369,1162
0132-000,2013,1,5,11,573,756,1329,1369
0132-000,2013,1,5,12,734,849,1583,1329
0132-000,2013,1,5,13,845,948,1793,1583
0132-000,2013,1,5,14,799,900,1699,1793
0132-000,2013,1,5,15,884,947,1831,1699
0132-000,2013,1,5,16,1058,949,2007,1831
0132-000,2013,1,5,17,1320,960,2280,2007
0132-000,2013,1,5,18,1342,939,2281,2280
0132-000,2013,1,5,19,1074,797,1871,2281
0132-000,2013,1,5,20,730,630,1360,1871
0132-000,2013,1,5,21,456,474,930,1360
0132-000,2013,1,5,22,330,365,695,930
0132-000,2013,1,5,23,232,251,483,695
0132-000,2013,1,5,24,151,203,354,483
0132-000,2013,1,6,1,149,171,320,354
0132-000,2013,1,6,2,98,153,251,320
0132-000,2013,1,6,3,86,104,190,251
0132-000,2013,1,6,4,84,98,182,190
0132-000,2013,1,6,5,94,88,182,182
0132-000,2013,1,6,6,121,112,233,182
0132-000,2013,1,6,7,141,165,306,233
0132-000,2013,1,6,8,252,282,534,306
0132-000,2013,1,6,9,309,413,722,534
0132-000,2013,1,6,10,369,439,808,722
0132-000,2013,1,6,11,408,529,937,808
0132-000,2013,1,6,12,544,555,1099,937
0132-000,2013,1,6,13,516,624,1140,1099
0132-000,2013,1,6,14,639,646,1285,1140
0132-000,2013,1,6,15,855,649,1504,1285
0132-000,2013,1,6,16,788,611,1399,1504
0132-000,2013,1,6,17,1037,629,1666,1399
0132-000,2013,1,6,18,1075,592,1667,1666
0132-000,2013,1,6,19,782,558,1340,1667
0132-000,2013,1,6,20,648,459,1107,1340
0132-000,2013,1,6,21,415,382,797,1107
0132-000,2013,1,6,22,407,383,790,797
0132-000,2013,1,6,23,212,262,474,790
0132-000,2013,1,6,24,144,178,322,474
0132-000,2013,1,7,1,135,160,295,322
0132-000,2013,1,7,2,99,121,220,295
0132-000,2013,1,7,3,36,57,93,220
0132-000,2013,1,7,4,48,72,120,93
0132-000,2013,1,7,5,83,110,193,120
0132-000,2013,1,7,6,125,143,268,193
0132-000,2013,1,7,7,307,415,722,268
0132-000,2013,1,7,8,726,1452,2178,722
0132-000,2013,1,7,9,676,1160,1836,2178
0132-000,2013,1,7,10,736,851,1587,1836
0132-000,2013,1,7,11,711,834,1545,1587
0132-000,2013,1,7,12,761,785,1546,1545
0132-000,2013,1,7,13,766,810,1576,1546
0132-000,2013,1,7,14,681,770,1451,1576
0132-000,2013,1,7,15,864,859,1723,1451
0132-000,2013,1,7,16,921,841,1762,1723
0132-000,2013,1,7,17,939,761,1700,1762
0132-000,2013,1,7,18,939,744,1683,1700
0132-000,2013,1,7,19,1017,736,1753,1683
0132-000,2013,1,7,20,716,559,1275,1753
0132-000,2013,1,7,21,602,464,1066,1275
0132-000,2013,1,7,22,460,374,834,1066
0132-000,2013,1,7,23,296,266,562,834
0132-000,2013,1,7,24,169,184,353,562
0132-000,2013,1,8,1,122,118,240,353
0132-000,2013,1,8,2,85,98,183,240
0132-000,2013,1,8,3,78,119,197,183
0132-000,2013,1,8,4,62,97,159,197
0132-000,2013,1,8,5,50,82,132,159
0132-000,2013,1,8,6,178,132,310,132
0132-000,2013,1,8,7,341,337,678,310
0132-000,2013,1,8,8,727,1308,2035,678
0132-000,2013,1,8,9,790,1140,1930,2035
0132-000,2013,1,8,10,657,806,1463,1930
0132-000,2013,1,8,11,742,819,1561,1463
0132-000,2013,1,8,12,820,792,1612,1561
0132-000,2013,1,8,13,761,794,1555,1612
0132-000,2013,1,8,14,711,805,1516,1555
0132-000,2013,1,8,15,838,868,1706,1516
0132-000,2013,1,8,16,915,798,1713,1706
0132-000,2013,1,8,17,964,792,1756,1713
0132-000,2013,1,8,18,975,790,1765,1756
0132-000,2013,1,8,19,989,704,1693,1765
0132-000,2013,1,8,20,672,541,1213,1693
0132-000,2013,1,8,21,694,481,1175,1213
0132-000,2013,1,8,22,485,411,896,1175
0132-000,2013,1,8,23,269,250,519,896
0132-000,2013,1,8,24,214,220,434,519
0132-000,2013,1,9,1,133,124,257,434
0132-000,2013,1,9,2,129,135,264,257
0132-000,2013,1,9,3,111,115,226,264
0132-000,2013,1,9,4,59,88,147,226
0132-000,2013,1,9,5,103,129,232,147
0132-000,2013,1,9,6,207,138,345,232
0132-000,2013,1,9,7,350,330,680,345
0132-000,2013,1,9,8,717,1315,2032,680
0132-000,2013,1,9,9,773,1106,1879,2032
0132-000,2013,1,9,10,752,799,1551,1879
0132-000,2013,1,9,11,746,745,1491,1551
0132-000,2013,1,9,12,754,767,1521,1491
0132-000,2013,1,9,13,615,678,1293,1521
0132-000,2013,1,9,14,723,764,1487,1293
0132-000,2013,1,9,15,788,819,1607,1487
0132-000,2013,1,9,16,849,796,1645,1607
0132-000,2013,1,9,17,941,770,1711,1645
0132-000,2013,1,9,18,989,776,1765,1711
0132-000,2013,1,9,19,1041,750,1791,1765
0132-000,2013,1,9,20,758,580,1338,1791
0132-000,2013,1,9,21,614,501,1115,1338
0132-000,2013,1,9,22,431,384,815,1115
0132-000,2013,1,9,23,295,285,580,815
0132-000,2013,1,9,24,172,176,348,580
0132-000,2013,1,10,1,129,145,274,348
0132-000,2013,1,10,2,103,98,201,274
0132-000,2013,1,10,3,61,82,143,201
0132-000,2013,1,10,4,53,75,128,143
0132-000,2013,1,10,5,66,92,158,128
0132-000,2013,1,10,6,183,128,311,158
0132-000,2013,1,10,7,329,322,651,311
0132-000,2013,1,10,8,642,1278,1920,651
0132-000,2013,1,10,9,715,1123,1838,1920
0132-000,2013,1,10,10,648,792,1440,1838
0132-000,2013,1,10,11,739,812,1551,1440
0132-000,2013,1,10,12,733,756,1489,1551
0132-000,2013,1,10,13,639,711,1350,1489
0132-000,2013,1,10,14,795,786,1581,1350
0132-000,2013,1,10,15,867,802,1669,1581
0132-000,2013,1,10,16,960,820,1780,1669
0132-000,2013,1,10,17,982,776,1758,1780
0132-000,2013,1,10,18,1065,762,1827,1758
0132-000,2013,1,10,19,1223,749,1972,1827
0132-000,2013,1,10,20,660,553,1213,1972
0132-000,2013,1,10,21,604,472,1076,1213
0132-000,2013,1,10,22,547,401,948,1076
0132-000,2013,1,10,23,344,290,634,948
0132-000,2013,1,10,24,202,215,417,634
0132-000,2013,1,11,1,112,131,243,417
0132-000,2013,1,11,2,101,101,202,243
0132-000,2013,1,11,3,73,86,159,202
0132-000,2013,1,11,4,73,99,172,159
0132-000,2013,1,11,5,95,114,209,172
0132-000,2013,1,11,6,173,118,291,209
0132-000,2013,1,11,7,337,325,662,291
0132-000,2013,1,11,8,688,1311,1999,662
0132-000,2013,1,11,9,780,1169,1949,1999
0132-000,2013,1,11,10,753,870,1623,1949
0132-000,2013,1,11,11,694,833,1527,1623
0132-000,2013,1,11,12,733,828,1561,1527
0132-000,2013,1,11,13,803,753,1556,1561
0132-000,2013,1,11,14,827,778,1605,1556
0132-000,2013,1,11,15,843,814,1657,1605
0132-000,2013,1,11,16,982,856,1838,1657
0132-000,2013,1,11,17,1118,842,1960,1838
0132-000,2013,1,11,18,1190,783,1973,1960
0132-000,2013,1,11,19,1170,785,1955,1973
0132-000,2013,1,11,20,872,660,1532,1955
0132-000,2013,1,11,21,699,558,1257,1532
0132-000,2013,1,11,22,533,441,974,1257
0132-000,2013,1,11,23,379,331,710,974
0132-000,2013,1,11,24,213,229,442,710
0132-000,2013,1,12,1,198,217,415,442
0132-000,2013,1,12,2,131,142,273,415
0132-000,2013,1,12,3,108,146,254,273
0132-000,2013,1,12,4,94,113,207,254
0132-000,2013,1,12,5,91,105,196,207
0132-000,2013,1,12,6,115,103,218,196
0132-000,2013,1,12,7,233,210,443,218
0132-000,2013,1,12,8,439,621,1060,443
0132-000,2013,1,12,9,574,727,1301,1060
0132-000,2013,1,12,10,629,726,1355,1301
0132-000,2013,1,12,11,736,863,1599,1355
0132-000,2013,1,12,12,690,941,1631,1599
0132-000,2013,1,12,13,710,1042,1752,1631
0132-000,2013,1,12,14,775,1038,1813,1752
0132-000,2013,1,12,15,840,985,1825,1813
0132-000,2013,1,12,16,947,974,1921,1825
0132-000,2013,1,12,17,1167,956,2123,1921
0132-000,2013,1,12,18,1331,1028,2359,2123
0132-000,2013,1,12,19,1173,902,2075,2359
0132-000,2013,1,12,20,935,635,1570,2075
0132-000,2013,1,12,21,542,427,969,1570
0132-000,2013,1,12,22,410,377,787,969
0132-000,2013,1,12,23,311,333,644,787
0132-000,2013,1,12,24,156,178,334,644
0132-000,2013,1,13,1,144,183,327,334
0132-000,2013,1,13,2,101,114,215,327
0132-000,2013,1,13,3,77,98,175,215
0132-000,2013,1,13,4,100,98,198,175
0132-000,2013,1,13,5,65,83,148,198
0132-000,2013,1,13,6,107,118,225,148
0132-000,2013,1,13,7,154,149,303,225
0132-000,2013,1,13,8,184,257,441,303
0132-000,2013,1,13,9,312,353,665,441
0132-000,2013,1,13,10,454,504,958,665
0132-000,2013,1,13,11,574,625,1199,958
0132-000,2013,1,13,12,447,544,991,1199
0132-000,2013,1,13,13,620,612,1232,991
0132-000,2013,1,13,14,663,619,1282,1232
0132-000,2013,1,13,15,809,621,1430,1282
0132-000,2013,1,13,16,1054,636,1690,1430
0132-000,2013,1,13,17,974,602,1576,1690
0132-000,2013,1,13,18,1033,620,1653,1576
0132-000,2013,1,13,19,1036,512,1548,1653
0132-000,2013,1,13,20,688,449,1137,1548
0132-000,2013,1,13,21,457,410,867,1137
0132-000,2013,1,13,22,366,385,751,867
0132-000,2013,1,13,23,239,274,513,751
0132-000,2013,1,13,24,143,165,308,513
0132-000,2013,1,14,1,114,124,238,308
0132-000,2013,1,14,2,72,91,163,238
0132-000,2013,1,14,3,86,126,212,163
0132-000,2013,1,14,4,53,82,135,212
0132-000,2013,1,14,5,93,100,193,135
0132-000,2013,1,14,6,163,159,322,193
0132-000,2013,1,14,7,389,447,836,322
0132-000,2013,1,14,8,678,1478,2156,836
0132-000,2013,1,14,9,720,1217,1937,2156
0132-000,2013,1,14,10,710,813,1523,1937
0132-000,2013,1,14,11,709,759,1468,1523
0132-000,2013,1,14,12,793,804,1597,1468
0132-000,2013,1,14,13,732,824,1556,1597
0132-000,2013,1,14,14,762,791,1553,1556
0132-000,2013,1,14,15,847,828,1675,1553
0132-000,2013,1,14,16,797,792,1589,1675
0132-000,2013,1,14,17,928,806,1734,1589
0132-000,2013,1,14,18,1252,803,2055,1734
0132-000,2013,1,14,19,1016,740,1756,2055
0132-000,2013,1,14,20,765,586,1351,1756
0132-000,2013,1,14,21,648,465,1113,1351
0132-000,2013,1,14,22,418,376,794,1113
0132-000,2013,1,14,23,334,269,603,794
0132-000,2013,1,14,24,158,163,321,603
0132-000,2013,1,15,1,119,132,251,321
0132-000,2013,1,15,2,112,124,236,251
0132-000,2013,1,15,3,107,144,251,236
0132-000,2013,1,15,4,62,82,144,251
0132-000,2013,1,15,5,97,122,219,144
0132-000,2013,1,15,6,134,113,247,219
0132-000,2013,1,15,7,338,366,704,247
0132-000,2013,1,15,8,662,1301,1963,704
0132-000,2013,1,15,9,760,1174,1934,1963
0132-000,2013,1,15,10,637,771,1408,1934
0132-000,2013,1,15,11,682,823,1505,1408
0132-000,2013,1,15,12,730,750,1480,1505
0132-000,2013,1,15,13,603,740,1343,1480
0132-000,2013,1,15,14,833,831,1664,1343
0132-000,2013,1,15,15,875,855,1730,1664
0132-000,2013,1,15,16,959,846,1805,1730
0132-000,2013,1,15,17,954,791,1745,1805
0132-000,2013,1,15,18,1096,831,1927,1745
0132-000,2013,1,15,19,1107,728,1835,1927
0132-000,2013,1,15,20,724,556,1280,1835
0132-000,2013,1,15,21,586,466,1052,1280
0132-000,2013,1,15,22,501,389,890,1052
0132-000,2013,1,15,23,305,258,563,890
0132-000,2013,1,15,24,175,178,353,563
0132-000,2013,1,16,1,145,148,293,353
0132-000,2013,1,16,2,82,94,176,293
0132-000,2013,1,16,3,56,74,130,176
0132-000,2013,1,16,4,72,78,150,130
0132-000,2013,1,16,5,127,133,260,150
0132-000,2013,1,16,6,238,178,416,260
0132-000,2013,1,16,7,316,338,654,416
0132-000,2013,1,16,8,735,1387,2122,654
0132-000,2013,1,16,9,874,1280,2154,2122
0132-000,2013,1,16,10,708,841,1549,2154
0132-000,2013,1,16,11,776,800,1576,1549
0132-000,2013,1,16,12,740,760,1500,1576
0132-000,2013,1,16,13,707,750,1457,1500
0132-000,2013,1,16,14,846,815,1661,1457
0132-000,2013,1,16,15,833,835,1668,1661
0132-000,2013,1,16,16,766,710,1476,1668
0132-000,2013,1,16,17,860,721,1581,1476
0132-000,2013,1,16,18,914,714,1628,1581
0132-000,2013,1,16,19,1022,728,1750,1628
0132-000,2013,1,16,20,641,532,1173,1750
0132-000,2013,1,16,21,591,460,1051,1173
0132-000,2013,1,16,22,384,349,733,1051
0132-000,2013,1,16,23,256,270,526,733
0132-000,2013,1,16,24,206,204,410,526
0132-000,2013,1,17,1,129,137,266,410
0132-000,2013,1,17,2,116,109,225,266
0132-000,2013,1,17,3,55,71,126,225
0132-000,2013,1,17,4,65,93,158,126
0132-000,2013,1,17,5,80,91,171,158
0132-000,2013,1,17,6,149,108,257,171
0132-000,2013,1,17,7,336,343,679,257
0132-000,2013,1,17,8,665,1291,1956,679
0132-000,2013,1,17,9,729,1115,1844,1956
0132-000,2013,1,17,10,681,814,1495,1844
0132-000,2013,1,17,11,740,798,1538,1495
0132-000,2013,1,17,12,749,771,1520,1538
0132-000,2013,1,17,13,782,744,1526,1520
0132-000,2013,1,17,14,743,795,1538,1526
0132-000,2013,1,17,15,786,821,1607,1538
0132-000,2013,1,17,16,804,747,1551,1607
0132-000,2013,1,17,17,887,702,1589,1551
0132-000,2013,1,17,18,1112,768,1880,1589
0132-000,2013,1,17,19,1094,763,1857,1880
0132-000,2013,1,17,20,744,576,1320,1857
0132-000,2013,1,17,21,575,448,1023,1320
0132-000,2013,1,17,22,518,422,940,1023
0132-000,2013,1,17,23,329,297,626,940
0132-000,2013,1,17,24,177,184,361,626
0132-000,2013,1,18,1,135,148,283,361
0132-000,2013,1,18,2,107,112,219,283
0132-000,2013,1,18,3,74,107,181,219
0132-000,2013,1,18,4,88,108,196,181
0132-000,2013,1,18,5,60,86,146,196
0132-000,2013,1,18,6,168,128,296,146
0132-000,2013,1,18,7,345,354,699,296
0132-000,2013,1,18,8,697,1266,1963,699
0132-000,2013,1,18,9,803,1165,1968,1963
0132-000,2013,1,18,10,708,855,1563,1968
0132-000,2013,1,18,11,722,796,1518,1563
0132-000,2013,1,18,12,745,735,1480,1518
0132-000,2013,1,18,13,726,753,1479,1480
0132-000,2013,1,18,14,837,837,1674,1479
0132-000,2013,1,18,15,854,848,1702,1674
0132-000,2013,1,18,16,940,815,1755,1702
0132-000,2013,1,18,17,890,762,1652,1755
0132-000,2013,1,18,18,1206,820,2026,1652
0132-000,2013,1,18,19,1261,809,2070,2026
0132-000,2013,1,18,20,852,663,1515,2070
0132-000,2013,1,18,21,630,517,1147,1515
0132-000,2013,1,18,22,505,393,898,1147
0132-000,2013,1,18,23,336,293,629,898
0132-000,2013,1,18,24,233,237,470,629
0132-000,2013,1,19,1,175,198,373,470
0132-000,2013,1,19,2,108,146,254,373
0132-000,2013,1,19,3,84,102,186,254
0132-000,2013,1,19,4,82,143,225,186
0132-000,2013,1,19,5,97,115,212,225
0132-000,2013,1,19,6,259,175,434,212
0132-000,2013,1,19,7,266,240,506,434
0132-000,2013,1,19,8,500,683,1183,506
0132-000,2013,1,19,9,560,709,1269,1183
0132-000,2013,1,19,10,769,870,1639,1269
0132-000,2013,1,19,11,806,929,1735,1639
0132-000,2013,1,19,12,864,1098,1962,1735
0132-000,2013,1,19,13,835,1092,1927,1962
0132-000,2013,1,19,14,751,1037,1788,1927
0132-000,2013,1,19,15,817,1009,1826,1788
0132-000,2013,1,19,16,871,969,1840,1826
0132-000,2013,1,19,17,1022,1010,2032,1840
0132-000,2013,1,19,18,1256,1022,2278,2032
0132-000,2013,1,19,19,985,839,1824,2278
0132-000,2013,1,19,20,700,558,1258,1824
0132-000,2013,1,19,21,524,518,1042,1258
0132-000,2013,1,19,22,470,430,900,1042
0132-000,2013,1,19,23,285,306,591,900
0132-000,2013,1,19,24,159,183,342,591
0132-000,2013,1,20,1,153,202,355,342
0132-000,2013,1,20,2,131,141,272,355
0132-000,2013,1,20,3,75,107,182,272
0132-000,2013,1,20,4,86,86,172,182
0132-000,2013,1,20,5,72,79,151,172
0132-000,2013,1,20,6,118,110,228,151
0132-000,2013,1,20,7,179,159,338,228
0132-000,2013,1,20,8,201,288,489,338
0132-000,2013,1,20,9,376,409,785,489
0132-000,2013,1,20,10,449,490,939,785
0132-000,2013,1,20,11,457,562,1019,939
0132-000,2013,1,20,12,614,625,1239,1019
0132-000,2013,1,20,13,686,681,1367,1239
0132-000,2013,1,20,14,623,610,1233,1367
0132-000,2013,1,20,15,773,672,1445,1233
0132-000,2013,1,20,16,1082,700,1782,1445
0132-000,2013,1,20,17,1178,630,1808,1782
0132-000,2013,1,20,18,1281,643,1924,1808
0132-000,2013,1,20,19,1203,579,1782,1924
0132-000,2013,1,20,20,955,490,1445,1782
0132-000,2013,1,20,21,544,430,974,1445
0132-000,2013,1,20,22,368,340,708,974
0132-000,2013,1,20,23,239,273,512,708
0132-000,2013,1,20,24,163,212,375,512
0132-000,2013,1,21,1,115,159,274,375
0132-000,2013,1,21,2,73,94,167,274
0132-000,2013,1,21,3,64,81,145,167
0132-000,2013,1,21,4,51,66,117,145
0132-000,2013,1,21,5,62,74,136,117
0132-000,2013,1,21,6,146,133,279,136
0132-000,2013,1,21,7,303,406,709,279
0132-000,2013,1,21,8,695,1459,2154,709
0132-000,2013,1,21,9,699,1100,1799,2154
0132-000,2013,1,21,10,679,736,1415,1799
0132-000,2013,1,21,11,675,730,1405,1415
0132-000,2013,1,21,12,713,742,1455,1405
0132-000,2013,1,21,13,702,695,1397,1455
0132-000,2013,1,21,14,734,728,1462,1397
0132-000,2013,1,21,15,737,772,1509,1462
0132-000,2013,1,21,16,735,676,1411,1509
0132-000,2013,1,21,17,789,685,1474,1411
0132-000,2013,1,21,18,972,704,1676,1474
0132-000,2013,1,21,19,1058,718,1776,1676
0132-000,2013,1,21,20,631,526,1157,1776
0132-000,2013,1,21,21,511,435,946,1157
0132-000,2013,1,21,22,477,372,849,946
0132-000,2013,1,21,23,239,237,476,849
0132-000,2013,1,21,24,165,164,329,476
0132-000,2013,1,22,1,146,142,288,329
0132-000,2013,1,22,2,76,89,165,288
0132-000,2013,1,22,3,56,72,128,165
0132-000,2013,1,22,4,65,81,146,128
0132-000,2013,1,22,5,50,72,122,146
0132-000,2013,1,22,6,121,93,214,122
0132-000,2013,1,22,7,305,341,646,214
0132-000,2013,1,22,8,651,1273,1924,646
0132-000,2013,1,22,9,731,1078,1809,1924
0132-000,2013,1,22,10,605,773,1378,1809
0132-000,2013,1,22,11,626,781,1407,1378
0132-000,2013,1,22,12,644,732,1376,1407
0132-000,2013,1,22,13,655,738,1393,1376
0132-000,2013,1,22,14,896,843,1739,1393
0132-000,2013,1,22,15,951,869,1820,1739
0132-000,2013,1,22,16,793,729,1522,1820
0132-000,2013,1,22,17,947,761,1708,1522
0132-000,2013,1,22,18,891,706,1597,1708
0132-000,2013,1,22,19,1102,790,1892,1597
0132-000,2013,1,22,20,778,569,1347,1892
0132-000,2013,1,22,21,662,479,1141,1347
0132-000,2013,1,22,22,486,415,901,1141
0132-000,2013,1,22,23,304,282,586,901
0132-000,2013,1,22,24,187,147,334,586
0132-000,2013,1,23,1,151,139,290,334
0132-000,2013,1,23,2,75,98,173,290
0132-000,2013,1,23,3,74,92,166,173
0132-000,2013,1,23,4,62,86,148,166
0132-000,2013,1,23,5,93,100,193,148
0132-000,2013,1,23,6,126,105,231,193
0132-000,2013,1,23,7,344,347,691,231
0132-000,2013,1,23,8,689,1245,1934,691
0132-000,2013,1,23,9,714,1130,1844,1934
0132-000,2013,1,23,10,735,785,1520,1844
0132-000,2013,1,23,11,651,718,1369,1520
0132-000,2013,1,23,12,743,782,1525,1369
0132-000,2013,1,23,13,704,699,1403,1525
0132-000,2013,1,23,14,840,799,1639,1403
0132-000,2013,1,23,15,835,828,1663,1639
0132-000,2013,1,23,16,771,726,1497,1663
0132-000,2013,1,23,17,835,720,1555,1497
0132-000,2013,1,23,18,999,745,1744,1555
0132-000,2013,1,23,19,1183,716,1899,1744
0132-000,2013,1,23,20,740,570,1310,1899
0132-000,2013,1,23,21,599,454,1053,1310
0132-000,2013,1,23,22,452,388,840,1053
0132-000,2013,1,23,23,314,281,595,840
0132-000,2013,1,23,24,195,187,382,595
0132-000,2013,1,24,1,147,161,308,382
0132-000,2013,1,24,2,93,100,193,308
0132-000,2013,1,24,3,76,80,156,193
0132-000,2013,1,24,4,63,76,139,156
0132-000,2013,1,24,5,101,103,204,139
0132-000,2013,1,24,6,117,95,212,204
0132-000,2013,1,24,7,296,328,624,212
0132-000,2013,1,24,8,796,1220,2016,624
0132-000,2013,1,24,9,871,1174,2045,2016
0132-000,2013,1,24,10,620,748,1368,2045
0132-000,2013,1,24,11,537,760,1297,1368
0132-000,2013,1,24,12,459,757,1216,1297
0132-000,2013,1,24,13,497,748,1245,1216
0132-000,2013,1,24,14,533,810,1343,1245
0132-000,2013,1,24,15,707,823,1530,1343
0132-000,2013,1,24,16,762,781,1543,1530
0132-000,2013,1,24,17,864,693,1557,1543
0132-000,2013,1,24,18,1124,681,1805,1557
0132-000,2013,1,24,19,1419,669,2088,1805
0132-000,2013,1,24,20,1278,599,1877,2088
0132-000,2013,1,24,21,834,518,1352,1877
0132-000,2013,1,24,22,536,402,938,1352
0132-000,2013,1,24,23,295,306,601,938
0132-000,2013,1,24,24,176,189,365,601
0132-000,2013,1,25,1,147,172,319,365
0132-000,2013,1,25,2,117,105,222,319
0132-000,2013,1,25,3,62,86,148,222
0132-000,2013,1,25,4,82,96,178,148
0132-000,2013,1,25,5,71,82,153,178
0132-000,2013,1,25,6,163,127,290,153
0132-000,2013,1,25,7,263,288,551,290
0132-000,2013,1,25,8,595,1220,1815,551
0132-000,2013,1,25,9,757,1172,1929,1815
0132-000,2013,1,25,10,611,794,1405,1929
0132-000,2013,1,25,11,695,785,1480,1405
0132-000,2013,1,25,12,792,833,1625,1480
0132-000,2013,1,25,13,758,717,1475,1625
0132-000,2013,1,25,14,806,844,1650,1475
0132-000,2013,1,25,15,856,862,1718,1650
0132-000,2013,1,25,16,882,837,1719,1718
0132-000,2013,1,25,17,792,687,1479,1719
0132-000,2013,1,25,18,1115,754,1869,1479
0132-000,2013,1,25,19,1131,764,1895,1869
0132-000,2013,1,25,20,866,677,1543,1895
0132-000,2013,1,25,21,738,543,1281,1543
0132-000,2013,1,25,22,595,499,1094,1281
0132-000,2013,1,25,23,413,351,764,1094
0132-000,2013,1,25,24,260,251,511,764
0132-000,2013,1,26,1,234,238,472,511
0132-000,2013,1,26,2,171,167,338,472
0132-000,2013,1,26,3,117,125,242,338
0132-000,2013,1,26,4,82,96,178,242
0132-000,2013,1,26,5,78,100,178,178
0132-000,2013,1,26,6,221,157,378,178
0132-000,2013,1,26,7,254,223,477,378
0132-000,2013,1,26,8,388,567,955,477
0132-000,2013,1,26,9,616,763,1379,955
0132-000,2013,1,26,10,713,738,1451,1379
0132-000,2013,1,26,11,705,867,1572,1451
0132-000,2013,1,26,12,688,970,1658,1572
0132-000,2013,1,26,13,723,1094,1817,1658
0132-000,2013,1,26,14,821,1045,1866,1817
0132-000,2013,1,26,15,869,981,1850,1866
0132-000,2013,1,26,16,941,979,1920,1850
0132-000,2013,1,26,17,1019,852,1871,1920
0132-000,2013,1,26,18,1344,923,2267,1871
0132-000,2013,1,26,19,1184,835,2019,2267
0132-000,2013,1,26,20,686,552,1238,2019
0132-000,2013,1,26,21,527,440,967,1238
0132-000,2013,1,26,22,453,429,882,967
0132-000,2013,1,26,23,304,321,625,882
0132-000,2013,1,26,24,244,251,495,625
0132-000,2013,1,27,1,134,203,337,495
0132-000,2013,1,27,2,110,123,233,337
0132-000,2013,1,27,3,113,111,224,233
0132-000,2013,1,27,4,82,102,184,224
0132-000,2013,1,27,5,91,92,183,184
0132-000,2013,1,27,6,137,105,242,183
0132-000,2013,1,27,7,95,129,224,242
0132-000,2013,1,27,8,202,260,462,224
0132-000,2013,1,27,9,249,335,584,462
0132-000,2013,1,27,10,408,442,850,584
0132-000,2013,1,27,11,472,561,1033,850
0132-000,2013,1,27,12,522,542,1064,1033
0132-000,2013,1,27,13,563,582,1145,1064
0132-000,2013,1,27,14,697,589,1286,1145
0132-000,2013,1,27,15,756,584,1340,1286
0132-000,2013,1,27,16,1077,633,1710,1340
0132-000,2013,1,27,17,1268,637,1905,1710
0132-000,2013,1,27,18,1360,638,1998,1905
0132-000,2013,1,27,19,1179,518,1697,1998
0132-000,2013,1,27,20,999,447,1446,1697
0132-000,2013,1,27,21,630,436,1066,1446
0132-000,2013,1,27,22,423,372,795,1066
0132-000,2013,1,27,23,241,281,522,795
0132-000,2013,1,27,24,167,190,357,522
0132-000,2013,1,28,1,195,205,400,357
0132-000,2013,1,28,2,111,116,227,400
0132-000,2013,1,28,3,79,111,190,227
0132-000,2013,1,28,4,44,56,100,190
0132-000,2013,1,28,5,81,90,171,100
0132-000,2013,1,28,6,169,154,323,171
0132-000,2013,1,28,7,314,403,717,323
0132-000,2013,1,28,8,629,1426,2055,717
0132-000,2013,1,28,9,757,1275,2032,2055
0132-000,2013,1,28,10,601,816,1417,2032
0132-000,2013,1,28,11,662,776,1438,1417
0132-000,2013,1,28,12,835,837,1672,1438
0132-000,2013,1,28,13,690,754,1444,1672
0132-000,2013,1,28,14,825,854,1679,1444
0132-000,2013,1,28,15,875,869,1744,1679
0132-000,2013,1,28,16,1033,860,1893,1744
0132-000,2013,1,28,17,980,836,1816,1893
0132-000,2013,1,28,18,1051,763,1814,1816
0132-000,2013,1,28,19,1028,751,1779,1814
0132-000,2013,1,28,20,899,600,1499,1779
0132-000,2013,1,28,21,669,466,1135,1499
0132-000,2013,1,28,22,504,408,912,1135
0132-000,2013,1,28,23,298,277,575,912
0132-000,2013,1,28,24,156,158,314,575
0132-000,2013,1,29,1,140,138,278,314
0132-000,2013,1,29,2,94,101,195,278
0132-000,2013,1,29,3,70,81,151,195
0132-000,2013,1,29,4,60,87,147,151
0132-000,2013,1,29,5,122,104,226,147
0132-000,2013,1,29,6,124,114,238,226
0132-000,2013,1,29,7,325,322,647,238
0132-000,2013,1,29,8,606,1282,1888,647
0132-000,2013,1,29,9,710,1184,1894,1888
0132-000,2013,1,29,10,713,938,1651,1894
0132-000,2013,1,29,11,660,793,1453,1651
0132-000,2013,1,29,12,744,801,1545,1453
0132-000,2013,1,29,13,735,751,1486,1545
0132-000,2013,1,29,14,803,810,1613,1486
0132-000,2013,1,29,15,888,868,1756,1613
0132-000,2013,1,29,16,965,810,1775,1756
0132-000,2013,1,29,17,969,759,1728,1775
0132-000,2013,1,29,18,1072,798,1870,1728
0132-000,2013,1,29,19,957,665,1622,1870
0132-000,2013,1,29,20,781,589,1370,1622
0132-000,2013,1,29,21,709,477,1186,1370
0132-000,2013,1,29,22,605,481,1086,1186
0132-000,2013,1,29,23,324,293,617,1086
0132-000,2013,1,29,24,218,232,450,617
0132-000,2013,1,30,1,119,126,245,450
0132-000,2013,1,30,2,139,137,276,245
0132-000,2013,1,30,3,94,104,198,276
0132-000,2013,1,30,4,48,78,126,198
0132-000,2013,1,30,5,101,101,202,126
0132-000,2013,1,30,6,166,139,305,202
0132-000,2013,1,30,7,303,307,610,305
0132-000,2013,1,30,8,668,1316,1984,610
0132-000,2013,1,30,9,750,1231,1981,1984
0132-000,2013,1,30,10,660,835,1495,1981
0132-000,2013,1,30,11,699,859,1558,1495
0132-000,2013,1,30,12,853,857,1710,1558
0132-000,2013,1,30,13,666,755,1421,1710
0132-000,2013,1,30,14,801,792,1593,1421
0132-000,2013,1,30,15,854,843,1697,1593
0132-000,2013,1,30,16,950,825,1775,1697
0132-000,2013,1,30,17,981,801,1782,1775
0132-000,2013,1,30,18,1272,858,2130,1782
0132-000,2013,1,30,19,994,738,1732,2130
0132-000,2013,1,30,20,795,618,1413,1732
0132-000,2013,1,30,21,675,493,1168,1413
0132-000,2013,1,30,22,529,398,927,1168
0132-000,2013,1,30,23,290,312,602,927
0132-000,2013,1,30,24,227,218,445,602
0132-000,2013,1,31,1,166,171,337,445
0132-000,2013,1,31,2,108,118,226,337
0132-000,2013,1,31,3,76,89,165,226
0132-000,2013,1,31,4,64,82,146,165
0132-000,2013,1,31,5,80,84,164,146
0132-000,2013,1,31,6,153,121,274,164
0132-000,2013,1,31,7,318,321,639,274
0132-000,2013,1,31,8,614,1293,1907,639
0132-000,2013,1,31,9,675,1259,1934,1907
0132-000,2013,1,31,10,687,805,1492,1934
0132-000,2013,1,31,11,754,803,1557,1492
0132-000,2013,1,31,12,732,778,1510,1557
0132-000,2013,1,31,13,751,754,1505,1510
0132-000,2013,1,31,14,827,790,1617,1505
0132-000,2013,1,31,15,833,802,1635,1617
0132-000,2013,1,31,16,968,814,1782,1635
0132-000,2013,1,31,17,944,753,1697,1782
0132-000,2013,1,31,18,1100,812,1912,1697
0132-000,2013,1,31,19,1085,747,1832,1912
0132-000,2013,1,31,20,826,630,1456,1832
0132-000,2013,1,31,21,576,470,1046,1456
0132-000,2013,1,31,22,641,444,1085,1046
0132-000,2013,1,31,23,315,290,605,1085
0132-000,2013,1,31,24,204,217,421,605
0132-000,2013,2,1,1,149,154,303,421
0132-000,2013,2,1,2,134,107,241,303
0132-000,2013,2,1,3,97,101,198,241
0132-000,2013,2,1,4,69,85,154,198
0132-000,2013,2,1,5,80,103,183,154
0132-000,2013,2,1,6,125,108,233,183
0132-000,2013,2,1,7,267,259,526,233
0132-000,2013,2,1,8,544,1269,1813,526
0132-000,2013,2,1,9,731,1173,1904,1813
0132-000,2013,2,1,10,647,821,1468,1904
0132-000,2013,2,1,11,755,716,1471,1468
0132-000,2013,2,1,12,779,748,1527,1471
0132-000,2013,2,1,13,725,680,1405,1527
0132-000,2013,2,1,14,826,713,1539,1405
0132-000,2013,2,1,15,860,726,1586,1539
0132-000,2013,2,1,16,895,758,1653,1586
0132-000,2013,2,1,17,916,730,1646,1653
0132-000,2013,2,1,18,1172,780,1952,1646
0132-000,2013,2,1,19,1261,783,2044,1952
0132-000,2013,2,1,20,903,678,1581,2044
0132-000,2013,2,1,21,789,490,1279,1581
0132-000,2013,2,1,22,622,430,1052,1279
0132-000,2013,2,1,23,351,347,698,1052
0132-000,2013,2,1,24,267,232,499,698
0132-000,2013,2,2,1,235,205,440,499
0132-000,2013,2,2,2,151,151,302,440
0132-000,2013,2,2,3,104,114,218,302
0132-000,2013,2,2,4,95,100,195,218
0132-000,2013,2,2,5,119,110,229,195
0132-000,2013,2,2,6,147,129,276,229
0132-000,2013,2,2,7,235,249,484,276
0132-000,2013,2,2,8,420,656,1076,484
0132-000,2013,2,2,9,600,856,1456,1076
0132-000,2013,2,2,10,714,822,1536,1456
0132-000,2013,2,2,11,794,878,1672,1536
0132-000,2013,2,2,12,869,919,1788,1672
0132-000,2013,2,2,13,905,1060,1965,1788
0132-000,2013,2,2,14,903,1034,1937,1965
0132-000,2013,2,2,15,968,1056,2024,1937
0132-000,2013,2,2,16,1004,927,1931,2024
0132-000,2013,2,2,17,1067,899,1966,1931
0132-000,2013,2,2,18,1363,895,2258,1966
0132-000,2013,2,2,19,1262,818,2080,2258
0132-000,2013,2,2,20,716,643,1359,2080
0132-000,2013,2,2,21,602,466,1068,1359
0132-000,2013,2,2,22,497,454,951,1068
0132-000,2013,2,2,23,357,315,672,951
0132-000,2013,2,2,24,222,246,468,672
0132-000,2013,2,3,1,170,236,406,468
0132-000,2013,2,3,2,175,148,323,406
0132-000,2013,2,3,3,99,154,253,323
0132-000,2013,2,3,4,99,113,212,253
0132-000,2013,2,3,5,80,115,195,212
0132-000,2013,2,3,6,129,149,278,195
0132-000,2013,2,3,7,157,165,322,278
0132-000,2013,2,3,8,263,328,591,322
0132-000,2013,2,3,9,340,469,809,591
0132-000,2013,2,3,10,471,554,1025,809
0132-000,2013,2,3,11,600,658,1258,1025
0132-000,2013,2,3,12,557,577,1134,1258
0132-000,2013,2,3,13,673,717,1390,1134
0132-000,2013,2,3,14,733,670,1403,1390
0132-000,2013,2,3,15,837,695,1532,1403
0132-000,2013,2,3,16,930,722,1652,1532
0132-000,2013,2,3,17,834,647,1481,1652
0132-000,2013,2,3,18,822,633,1455,1481
0132-000,2013,2,3,19,779,532,1311,1455
0132-000,2013,2,3,20,561,454,1015,1311
0132-000,2013,2,3,21,514,375,889,1015
0132-000,2013,2,3,22,402,348,750,889
0132-000,2013,2,3,23,239,276,515,750
0132-000,2013,2,3,24,104,169,273,515
0132-000,2013,2,4,1,106,132,238,273
0132-000,2013,2,4,2,89,64,153,238
0132-000,2013,2,4,3,39,67,106,153
0132-000,2013,2,4,4,56,77,133,106
0132-000,2013,2,4,5,69,84,153,133
0132-000,2013,2,4,6,142,113,255,153
0132-000,2013,2,4,7,284,285,569,255
0132-000,2013,2,4,8,411,1102,1513,569
0132-000,2013,2,4,9,592,1078,1670,1513
0132-000,2013,2,4,10,585,640,1225,1670
0132-000,2013,2,4,11,699,643,1342,1225
0132-000,2013,2,4,12,723,713,1436,1342
0132-000,2013,2,4,13,714,664,1378,1436
0132-000,2013,2,4,14,871,824,1695,1378
0132-000,2013,2,4,15,892,761,1653,1695
0132-000,2013,2,4,16,965,664,1629,1653
0132-000,2013,2,4,17,873,697,1570,1629
0132-000,2013,2,4,18,927,685,1612,1570
0132-000,2013,2,4,19,976,662,1638,1612
0132-000,2013,2,4,20,770,599,1369,1638
0132-000,2013,2,4,21,727,458,1185,1369
0132-000,2013,2,4,22,512,355,867,1185
0132-000,2013,2,4,23,362,262,624,867
0132-000,2013,2,4,24,198,182,380,624
0132-000,2013,2,5,1,132,127,259,380
0132-000,2013,2,5,2,89,106,195,259
0132-000,2013,2,5,3,80,80,160,195
0132-000,2013,2,5,4,82,79,161,160
0132-000,2013,2,5,5,86,128,214,161
0132-000,2013,2,5,6,136,125,261,214
0132-000,2013,2,5,7,248,308,556,261
0132-000,2013,2,5,8,570,1318,1888,556
0132-000,2013,2,5,9,759,1203,1962,1888
0132-000,2013,2,5,10,764,853,1617,1962
0132-000,2013,2,5,11,757,806,1563,1617
0132-000,2013,2,5,12,882,884,1766,1563
0132-000,2013,2,5,13,875,836,1711,1766
0132-000,2013,2,5,14,832,837,1669,1711
0132-000,2013,2,5,15,1002,924,1926,1669
0132-000,2013,2,5,16,938,862,1800,1926
0132-000,2013,2,5,17,963,750,1713,1800
0132-000,2013,2,5,18,1036,813,1849,1713
0132-000,2013,2,5,19,1043,734,1777,1849
0132-000,2013,2,5,20,822,544,1366,1777
0132-000,2013,2,5,21,673,459,1132,1366
0132-000,2013,2,5,22,553,423,976,1132
0132-000,2013,2,5,23,379,279,658,976
0132-000,2013,2,5,24,252,168,420,658
0132-000,2013,2,6,1,198,152,350,420
0132-000,2013,2,6,2,136,115,251,350
0132-000,2013,2,6,3,114,72,186,251
0132-000,2013,2,6,4,89,77,166,186
0132-000,2013,2,6,5,86,121,207,166
0132-000,2013,2,6,6,138,101,239,207
0132-000,2013,2,6,7,243,243,486,239
0132-000,2013,2,6,8,465,1103,1568,486
0132-000,2013,2,6,9,626,1144,1770,1568
0132-000,2013,2,6,10,645,705,1350,1770
0132-000,2013,2,6,11,650,751,1401,1350
0132-000,2013,2,6,12,729,781,1510,1401
0132-000,2013,2,6,13,813,755,1568,1510
0132-000,2013,2,6,14,811,849,1660,1568
0132-000,2013,2,6,15,884,828,1712,1660
0132-000,2013,2,6,16,948,894,1842,1712
0132-000,2013,2,6,17,925,785,1710,1842
0132-000,2013,2,6,18,1062,749,1811,1710
0132-000,2013,2,6,19,1120,735,1855,1811
0132-000,2013,2,6,20,776,601,1377,1855
0132-000,2013,2,6,21,637,476,1113,1377
0132-000,2013,2,6,22,632,432,1064,1113
0132-000,2013,2,6,23,334,292,626,1064
0132-000,2013,2,6,24,273,228,501,626
0132-000,2013,2,7,1,181,177,358,501
0132-000,2013,2,7,2,110,83,193,358
0132-000,2013,2,7,3,82,101,183,193
0132-000,2013,2,7,4,84,63,147,183
0132-000,2013,2,7,5,93,131,224,147
0132-000,2013,2,7,6,149,102,251,224
0132-000,2013,2,7,7,284,240,524,251
0132-000,2013,2,7,8,510,994,1504,524
0132-000,2013,2,7,9,678,1164,1842,1504
0132-000,2013,2,7,10,665,856,1521,1842
0132-000,2013,2,7,11,609,1171,1780,1521
0132-000,2013,2,7,12,751,1252,2003,1780
0132-000,2013,2,7,13,1006,797,1803,2003
0132-000,2013,2,7,14,1306,870,2176,1803
0132-000,2013,2,7,15,1030,955,1985,2176
0132-000,2013,2,7,16,993,888,1881,1985
0132-000,2013,2,7,17,1105,869,1974,1881
0132-000,2013,2,7,18,1215,904,2119,1974
0132-000,2013,2,7,19,1211,771,1982,2119
0132-000,2013,2,7,20,914,717,1631,1982
0132-000,2013,2,7,21,742,549,1291,1631
0132-000,2013,2,7,22,615,483,1098,1291
0132-000,2013,2,7,23,400,331,731,1098
0132-000,2013,2,7,24,263,222,485,731
0132-000,2013,2,8,1,192,164,356,485
0132-000,2013,2,8,2,117,113,230,356
0132-000,2013,2,8,3,86,105,191,230
0132-000,2013,2,8,4,61,93,154,191
0132-000,2013,2,8,5,80,102,182,154
0132-000,2013,2,8,6,110,105,215,182
0132-000,2013,2,8,7,220,252,472,215
0132-000,2013,2,8,8,512,1183,1695,472
0132-000,2013,2,8,9,684,1099,1783,1695
0132-000,2013,2,8,10,665,827,1492,1783
0132-000,2013,2,8,11,776,856,1632,1492
0132-000,2013,2,8,12,854,1016,1870,1632
0132-000,2013,2,8,13,826,1195,2021,1870
0132-000,2013,2,8,14,901,1443,2344,2021
0132-000,2013,2,8,15,966,1563,2529,2344
0132-000,2013,2,8,16,1043,1757,2800,2529
0132-000,2013,2,8,17,1144,1927,3071,2800
0132-000,2013,2,8,18,1177,1881,3058,3071
0132-000,2013,2,8,19,1099,1615,2714,3058
0132-000,2013,2,8,20,742,1574,2316,2714
0132-000,2013,2,8,21,549,1677,2226,2316
0132-000,2013,2,8,22,480,1676,2156,2226
0132-000,2013,2,8,23,314,1262,1576,2156
0132-000,2013,2,8,24,222,682,904,1576
0132-000,2013,2,9,1,166,561,727,904
0132-000,2013,2,9,2,106,393,499,727
0132-000,2013,2,9,3,106,292,398,499
0132-000,2013,2,9,4,102,273,375,398
0132-000,2013,2,9,5,86,560,646,375
0132-000,2013,2,9,6,104,842,946,646
0132-000,2013,2,9,7,104,1041,1145,946
0132-000,2013,2,9,8,209,1362,1571,1145
0132-000,2013,2,9,9,364,1625,1989,1571
0132-000,2013,2,9,10,551,1401,1952,1989
0132-000,2013,2,9,11,712,1315,2027,1952
0132-000,2013,2,9,12,770,1164,1934,2027
0132-000,2013,2,9,13,701,996,1697,1934
0132-000,2013,2,9,14,768,926,1694,1697
0132-000,2013,2,9,15,654,891,1545,1694
0132-000,2013,2,9,16,645,749,1394,1545
0132-000,2013,2,9,17,617,634,1251,1394
0132-000,2013,2,9,18,585,537,1122,1251
0132-000,2013,2,9,19,491,422,913,1122
0132-000,2013,2,9,20,400,386,786,913
0132-000,2013,2,9,21,366,324,690,786
0132-000,2013,2,9,22,368,273,641,690
0132-000,2013,2,9,23,213,221,434,641
0132-000,2013,2,9,24,153,152,305,434
0132-000,2013,2,10,1,127,124,251,305
0132-000,2013,2,10,2,91,101,192,251
0132-000,2013,2,10,3,63,51,114,192
0132-000,2013,2,10,4,48,59,107,114
0132-000,2013,2,10,5,56,68,124,107
0132-000,2013,2,10,6,82,74,156,124
0132-000,2013,2,10,7,196,195,391,156
0132-000,2013,2,10,8,366,506,872,391
0132-000,2013,2,10,9,417,608,1025,872
0132-000,2013,2,10,10,480,422,902,1025
0132-000,2013,2,10,11,946,769,1715,902
0132-000,2013,2,10,12,1535,976,2511,1715
0132-000,2013,2,10,13,1907,1152,3059,2511
0132-000,2013,2,10,14,2156,1324,3480,3059
0132-000,2013,2,10,15,2415,1419,3834,3480
0132-000,2013,2,10,16,2330,1370,3700,3834
0132-000,2013,2,10,17,2410,1355,3765,3700
0132-000,2013,2,10,18,2109,899,3008,3765
0132-000,2013,2,10,19,1991,634,2625,3008
0132-000,2013,2,10,20,1129,423,1552,2625
0132-000,2013,2,10,21,766,424,1190,1552
0132-000,2013,2,10,22,678,337,1015,1190
0132-000,2013,2,10,23,486,267,753,1015
0132-000,2013,2,10,24,413,196,609,753
0132-000,2013,2,11,1,366,148,514,609
0132-000,2013,2,11,2,306,89,395,514
0132-000,2013,2,11,3,153,75,228,395
0132-000,2013,2,11,4,80,47,127,228
0132-000,2013,2,11,5,69,46,115,127
0132-000,2013,2,11,6,91,76,167,115
0132-000,2013,2,11,7,140,68,208,167
0132-000,2013,2,11,8,194,154,348,208
0132-000,2013,2,11,9,301,219,520,348
0132-000,2013,2,11,10,465,280,745,520
0132-000,2013,2,11,11,753,429,1182,745
0132-000,2013,2,11,12,1144,484,1628,1182
0132-000,2013,2,11,13,1361,605,1966,1628
0132-000,2013,2,11,14,1474,634,2108,1966
0132-000,2013,2,11,15,1385,879,2264,2108
0132-000,2013,2,11,16,1402,903,2305,2264
0132-000,2013,2,11,17,1294,743,2037,2305
0132-000,2013,2,11,18,1142,686,1828,2037
0132-000,2013,2,11,19,1165,632,1797,1828
0132-000,2013,2,11,20,1290,595,1885,1797
0132-000,2013,2,11,21,1292,404,1696,1885
0132-000,2013,2,11,22,1103,345,1448,1696
0132-000,2013,2,11,23,862,283,1145,1448
0132-000,2013,2,11,24,579,196,775,1145
0132-000,2013,2,12,1,377,134,511,775
0132-000,2013,2,12,2,183,109,292,511
0132-000,2013,2,12,3,97,59,156,292
0132-000,2013,2,12,4,65,54,119,156
0132-000,2013,2,12,5,48,50,98,119
0132-000,2013,2,12,6,121,84,205,98
0132-000,2013,2,12,7,224,240,464,205
0132-000,2013,2,12,8,428,892,1320,464
0132-000,2013,2,12,9,650,872,1522,1320
0132-000,2013,2,12,10,615,659,1274,1522
0132-000,2013,2,12,11,665,684,1349,1274
0132-000,2013,2,12,12,785,666,1451,1349
0132-000,2013,2,12,13,834,770,1604,1451
0132-000,2013,2,12,14,923,694,1617,1604
0132-000,2013,2,12,15,916,732,1648,1617
0132-000,2013,2,12,16,970,747,1717,1648
0132-000,2013,2,12,17,944,716,1660,1717
0132-000,2013,2,12,18,1075,688,1763,1660
0132-000,2013,2,12,19,981,659,1640,1763
0132-000,2013,2,12,20,705,517,1222,1640
0132-000,2013,2,12,21,568,421,989,1222
0132-000,2013,2,12,22,450,364,814,989
0132-000,2013,2,12,23,306,245,551,814
0132-000,2013,2,12,24,185,156,341,551
0132-000,2013,2,13,1,145,157,302,341
0132-000,2013,2,13,2,125,101,226,302
0132-000,2013,2,13,3,78,79,157,226
0132-000,2013,2,13,4,71,79,150,157
0132-000,2013,2,13,5,97,88,185,150
0132-000,2013,2,13,6,117,97,214,185
0132-000,2013,2,13,7,267,339,606,214
0132-000,2013,2,13,8,549,1332,1881,606
0132-000,2013,2,13,9,693,1173,1866,1881
0132-000,2013,2,13,10,770,818,1588,1866
0132-000,2013,2,13,11,714,790,1504,1588
0132-000,2013,2,13,12,791,762,1553,1504
0132-000,2013,2,13,13,779,742,1521,1553
0132-000,2013,2,13,14,809,828,1637,1521
0132-000,2013,2,13,15,931,868,1799,1637
0132-000,2013,2,13,16,931,753,1684,1799
0132-000,2013,2,13,17,882,713,1595,1684
0132-000,2013,2,13,18,1000,795,1795,1595
0132-000,2013,2,13,19,1035,731,1766,1795
0132-000,2013,2,13,20,766,602,1368,1766
0132-000,2013,2,13,21,643,458,1101,1368
0132-000,2013,2,13,22,583,441,1024,1101
0132-000,2013,2,13,23,334,284,618,1024
0132-000,2013,2,13,24,211,212,423,618
0132-000,2013,2,14,1,222,140,362,423
0132-000,2013,2,14,2,175,135,310,362
0132-000,2013,2,14,3,102,86,188,310
0132-000,2013,2,14,4,71,87,158,188
0132-000,2013,2,14,5,86,101,187,158
0132-000,2013,2,14,6,147,119,266,187
0132-000,2013,2,14,7,306,313,619,266
0132-000,2013,2,14,8,564,1304,1868,619
0132-000,2013,2,14,9,761,1217,1978,1868
0132-000,2013,2,14,10,751,906,1657,1978
0132-000,2013,2,14,11,783,968,1751,1657
0132-000,2013,2,14,12,923,867,1790,1751
0132-000,2013,2,14,13,944,809,1753,1790
0132-000,2013,2,14,14,914,874,1788,1753
0132-000,2013,2,14,15,920,842,1762,1788
0132-000,2013,2,14,16,981,804,1785,1762
0132-000,2013,2,14,17,940,751,1691,1785
0132-000,2013,2,14,18,1060,817,1877,1691
0132-000,2013,2,14,19,1123,705,1828,1877
0132-000,2013,2,14,20,804,628,1432,1828
0132-000,2013,2,14,21,680,477,1157,1432
0132-000,2013,2,14,22,538,419,957,1157
0132-000,2013,2,14,23,390,294,684,957
0132-000,2013,2,14,24,263,213,476,684
0132-000,2013,2,15,1,155,146,301,476
0132-000,2013,2,15,2,147,120,267,301
0132-000,2013,2,15,3,78,86,164,267
0132-000,2013,2,15,4,69,74,143,164
0132-000,2013,2,15,5,67,88,155,143
0132-000,2013,2,15,6,142,119,261,155
0132-000,2013,2,15,7,269,301,570,261
0132-000,2013,2,15,8,555,1264,1819,570
0132-000,2013,2,15,9,759,1149,1908,1819
0132-000,2013,2,15,10,721,871,1592,1908
0132-000,2013,2,15,11,725,830,1555,1592
0132-000,2013,2,15,12,796,794,1590,1555
0132-000,2013,2,15,13,830,805,1635,1590
0132-000,2013,2,15,14,918,814,1732,1635
0132-000,2013,2,15,15,938,812,1750,1732
0132-000,2013,2,15,16,1019,799,1818,1750
0132-000,2013,2,15,17,1000,902,1902,1818
0132-000,2013,2,15,18,1161,985,2146,1902
0132-000,2013,2,15,19,1317,923,2240,2146
0132-000,2013,2,15,20,918,690,1608,2240
0132-000,2013,2,15,21,746,522,1268,1608
0132-000,2013,2,15,22,656,448,1104,1268
0132-000,2013,2,15,23,394,350,744,1104
0132-000,2013,2,15,24,280,229,509,744
0132-000,2013,2,16,1,198,203,401,509
0132-000,2013,2,16,2,175,147,322,401
0132-000,2013,2,16,3,121,104,225,322
0132-000,2013,2,16,4,93,107,200,225
0132-000,2013,2,16,5,99,108,207,200
0132-000,2013,2,16,6,121,116,237,207
0132-000,2013,2,16,7,243,224,467,237
0132-000,2013,2,16,8,450,697,1147,467
0132-000,2013,2,16,9,570,781,1351,1147
0132-000,2013,2,16,10,688,817,1505,1351
0132-000,2013,2,16,11,748,878,1626,1505
0132-000,2013,2,16,12,785,1062,1847,1626
0132-000,2013,2,16,13,809,1117,1926,1847
0132-000,2013,2,16,14,933,1093,2026,1926
0132-000,2013,2,16,15,976,1097,2073,2026
0132-000,2013,2,16,16,1019,999,2018,2073
0132-000,2013,2,16,17,981,962,1943,2018
0132-000,2013,2,16,18,1118,985,2103,1943
0132-000,2013,2,16,19,1105,840,1945,2103
0132-000,2013,2,16,20,617,543,1160,1945
0132-000,2013,2,16,21,551,456,1007,1160
0132-000,2013,2,16,22,469,397,866,1007
0132-000,2013,2,16,23,312,307,619,866
0132-000,2013,2,16,24,246,234,480,619
0132-000,2013,2,17,1,190,207,397,480
0132-000,2013,2,17,2,134,116,250,397
0132-000,2013,2,17,3,84,106,190,250
0132-000,2013,2,17,4,71,80,151,190
0132-000,2013,2,17,5,74,83,157,151
0132-000,2013,2,17,6,59,92,151,157
0132-000,2013,2,17,7,149,135,284,151
0132-000,2013,2,17,8,218,322,540,284
0132-000,2013,2,17,9,364,408,772,540
0132-000,2013,2,17,10,439,492,931,772
0132-000,2013,2,17,11,501,563,1064,931
0132-000,2013,2,17,12,566,597,1163,1064
0132-000,2013,2,17,13,660,531,1191,1163
0132-000,2013,2,17,14,742,635,1377,1191
0132-000,2013,2,17,15,779,640,1419,1377
0132-000,2013,2,17,16,852,634,1486,1419
0132-000,2013,2,17,17,867,712,1579,1486
0132-000,2013,2,17,18,877,653,1530,1579
0132-000,2013,2,17,19,798,540,1338,1530
0132-000,2013,2,17,20,516,443,959,1338
0132-000,2013,2,17,21,448,419,867,959
0132-000,2013,2,17,22,439,356,795,867
0132-000,2013,2,17,23,263,232,495,795
0132-000,2013,2,17,24,190,194,384,495
0132-000,2013,2,18,1,114,118,232,384
0132-000,2013,2,18,2,99,75,174,232
0132-000,2013,2,18,3,54,83,137,174
0132-000,2013,2,18,4,50,69,119,137
0132-000,2013,2,18,5,76,93,169,119
0132-000,2013,2,18,6,179,141,320,169
0132-000,2013,2,18,7,316,438,754,320
0132-000,2013,2,18,8,574,1454,2028,754
0132-000,2013,2,18,9,740,1191,1931,2028
0132-000,2013,2,18,10,671,816,1487,1931
0132-000,2013,2,18,11,776,824,1600,1487
0132-000,2013,2,18,12,834,809,1643,1600
0132-000,2013,2,18,13,834,798,1632,1643
0132-000,2013,2,18,14,830,837,1667,1632
0132-000,2013,2,18,15,912,883,1795,1667
0132-000,2013,2,18,16,944,752,1696,1795
0132-000,2013,2,18,17,978,749,1727,1696
0132-000,2013,2,18,18,1039,743,1782,1727
0132-000,2013,2,18,19,1034,755,1789,1782
0132-000,2013,2,18,20,757,601,1358,1789
0132-000,2013,2,18,21,744,481,1225,1358
0132-000,2013,2,18,22,527,401,928,1225
0132-000,2013,2,18,23,340,252,592,928
0132-000,2013,2,18,24,239,183,422,592
0132-000,2013,2,19,1,170,153,323,422
0132-000,2013,2,19,2,86,106,192,323
0132-000,2013,2,19,3,91,77,168,192
0132-000,2013,2,19,4,61,87,148,168
0132-000,2013,2,19,5,97,100,197,148
0132-000,2013,2,19,6,136,127,263,197
0132-000,2013,2,19,7,280,305,585,263
0132-000,2013,2,19,8,553,1312,1865,585
0132-000,2013,2,19,9,776,1206,1982,1865
0132-000,2013,2,19,10,701,846,1547,1982
0132-000,2013,2,19,11,761,832,1593,1547
0132-000,2013,2,19,12,828,780,1608,1593
0132-000,2013,2,19,13,783,757,1540,1608
0132-000,2013,2,19,14,839,789,1628,1540
0132-000,2013,2,19,15,903,866,1769,1628
0132-000,2013,2,19,16,1011,792,1803,1769
0132-000,2013,2,19,17,1013,795,1808,1803
0132-000,2013,2,19,18,1067,761,1828,1808
0132-000,2013,2,19,19,1120,774,1894,1828
0132-000,2013,2,19,20,811,582,1393,1894
0132-000,2013,2,19,21,695,462,1157,1393
0132-000,2013,2,19,22,506,447,953,1157
0132-000,2013,2,19,23,377,260,637,953
0132-000,2013,2,19,24,230,196,426,637
0132-000,2013,2,20,1,147,145,292,426
0132-000,2013,2,20,2,129,99,228,292
0132-000,2013,2,20,3,71,96,167,228
0132-000,2013,2,20,4,69,69,138,167
0132-000,2013,2,20,5,95,86,181,138
0132-000,2013,2,20,6,121,109,230,181
0132-000,2013,2,20,7,301,304,605,230
0132-000,2013,2,20,8,579,1313,1892,605
0132-000,2013,2,20,9,714,1155,1869,1892
0132-000,2013,2,20,10,736,814,1550,1869
0132-000,2013,2,20,11,742,813,1555,1550
0132-000,2013,2,20,12,774,766,1540,1555
0132-000,2013,2,20,13,811,741,1552,1540
0132-000,2013,2,20,14,847,802,1649,1552
0132-000,2013,2,20,15,974,843,1817,1649
0132-000,2013,2,20,16,929,824,1753,1817
0132-000,2013,2,20,17,914,746,1660,1753
0132-000,2013,2,20,18,1099,840,1939,1660
0132-000,2013,2,20,19,1193,767,1960,1939
0132-000,2013,2,20,20,843,592,1435,1960
0132-000,2013,2,20,21,682,488,1170,1435
0132-000,2013,2,20,22,577,448,1025,1170
0132-000,2013,2,20,23,372,290,662,1025
0132-000,2013,2,20,24,271,192,463,662
0132-000,2013,2,21,1,183,176,359,463
0132-000,2013,2,21,2,117,99,216,359
0132-000,2013,2,21,3,99,91,190,216
0132-000,2013,2,21,4,78,93,171,190
0132-000,2013,2,21,5,104,89,193,171
0132-000,2013,2,21,6,172,115,287,193
0132-000,2013,2,21,7,334,304,638,287
0132-000,2013,2,21,8,632,1353,1985,638
0132-000,2013,2,21,9,697,1194,1891,1985
0132-000,2013,2,21,10,705,794,1499,1891
0132-000,2013,2,21,11,772,825,1597,1499
0132-000,2013,2,21,12,830,821,1651,1597
0132-000,2013,2,21,13,817,840,1657,1651
0132-000,2013,2,21,14,830,823,1653,1657
0132-000,2013,2,21,15,974,829,1803,1653
0132-000,2013,2,21,16,1056,768,1824,1803
0132-000,2013,2,21,17,989,762,1751,1824
0132-000,2013,2,21,18,1099,736,1835,1751
0132-000,2013,2,21,19,1142,754,1896,1835
0132-000,2013,2,21,20,843,639,1482,1896
0132-000,2013,2,21,21,746,505,1251,1482
0132-000,2013,2,21,22,587,448,1035,1251
0132-000,2013,2,21,23,394,331,725,1035
0132-000,2013,2,21,24,226,239,465,725
0132-000,2013,2,22,1,164,155,319,465
0132-000,2013,2,22,2,140,123,263,319
0132-000,2013,2,22,3,97,116,213,263
0132-000,2013,2,22,4,86,82,168,213
0132-000,2013,2,22,5,89,110,199,168
0132-000,2013,2,22,6,166,121,287,199
0132-000,2013,2,22,7,267,260,527,287
0132-000,2013,2,22,8,542,1219,1761,527
0132-000,2013,2,22,9,723,1186,1909,1761
0132-000,2013,2,22,10,708,798,1506,1909
0132-000,2013,2,22,11,714,857,1571,1506
0132-000,2013,2,22,12,770,768,1538,1571
0132-000,2013,2,22,13,751,837,1588,1538
0132-000,2013,2,22,14,873,1032,1905,1588
0132-000,2013,2,22,15,961,959,1920,1905
0132-000,2013,2,22,16,1002,805,1807,1920
0132-000,2013,2,22,17,991,783,1774,1807
0132-000,2013,2,22,18,1086,807,1893,1774
0132-000,2013,2,22,19,1375,808,2183,1893
0132-000,2013,2,22,20,974,664,1638,2183
0132-000,2013,2,22,21,815,540,1355,1638
0132-000,2013,2,22,22,600,517,1117,1355
0132-000,2013,2,22,23,402,390,792,1117
0132-000,2013,2,22,24,321,252,573,792
0132-000,2013,2,23,1,254,187,441,573
0132-000,2013,2,23,2,194,163,357,441
0132-000,2013,2,23,3,106,119,225,357
0132-000,2013,2,23,4,95,119,214,225
0132-000,2013,2,23,5,63,110,173,214
0132-000,2013,2,23,6,145,123,268,173
0132-000,2013,2,23,7,295,239,534,268
0132-000,2013,2,23,8,441,648,1089,534
0132-000,2013,2,23,9,641,793,1434,1089
0132-000,2013,2,23,10,701,779,1480,1434
0132-000,2013,2,23,11,740,989,1729,1480
0132-000,2013,2,23,12,852,1170,2022,1729
0132-000,2013,2,23,13,830,1113,1943,2022
0132-000,2013,2,23,14,880,1197,2077,1943
0132-000,2013,2,23,15,946,1050,1996,2077
0132-000,2013,2,23,16,976,1065,2041,1996
0132-000,2013,2,23,17,1129,872,2001,2041
0132-000,2013,2,23,18,1157,939,2096,2001
0132-000,2013,2,23,19,1172,1029,2201,2096
0132-000,2013,2,23,20,761,671,1432,2201
0132-000,2013,2,23,21,660,445,1105,1432
0132-000,2013,2,23,22,493,452,945,1105
0132-000,2013,2,23,23,379,306,685,945
0132-000,2013,2,23,24,226,233,459,685
0132-000,2013,2,24,1,198,173,371,459
0132-000,2013,2,24,2,134,156,290,371
0132-000,2013,2,24,3,104,120,224,290
0132-000,2013,2,24,4,123,90,213,224
0132-000,2013,2,24,5,89,88,177,213
0132-000,2013,2,24,6,114,99,213,177
0132-000,2013,2,24,7,190,176,366,213
0132-000,2013,2,24,8,265,257,522,366
0132-000,2013,2,24,9,368,426,794,522
0132-000,2013,2,24,10,475,503,978,794
0132-000,2013,2,24,11,613,630,1243,978
0132-000,2013,2,24,12,602,625,1227,1243
0132-000,2013,2,24,13,622,655,1277,1227
0132-000,2013,2,24,14,738,659,1397,1277
0132-000,2013,2,24,15,837,716,1553,1397
0132-000,2013,2,24,16,839,696,1535,1553
0132-000,2013,2,24,17,990,771,1761,1535
0132-000,2013,2,24,18,899,776,1675,1761
0132-000,2013,2,24,19,985,650,1635,1675
0132-000,2013,2,24,20,701,512,1213,1635
0132-000,2013,2,24,21,534,457,991,1213
0132-000,2013,2,24,22,465,428,893,991
0132-000,2013,2,24,23,299,286,585,893
0132-000,2013,2,24,24,164,206,370,585
0132-000,2013,2,25,1,136,170,306,370
0132-000,2013,2,25,2,99,115,214,306
0132-000,2013,2,25,3,65,67,132,214
0132-000,2013,2,25,4,56,74,130,132
0132-000,2013,2,25,5,104,89,193,130
0132-000,2013,2,25,6,175,169,344,193
0132-000,2013,2,25,7,342,430,772,344
0132-000,2013,2,25,8,639,1496,2135,772
0132-000,2013,2,25,9,755,1214,1969,2135
0132-000,2013,2,25,10,742,809,1551,1969
0132-000,2013,2,25,11,716,781,1497,1551
0132-000,2013,2,25,12,854,802,1656,1497
0132-000,2013,2,25,13,862,789,1651,1656
0132-000,2013,2,25,14,860,859,1719,1651
0132-000,2013,2,25,15,920,859,1779,1719
0132-000,2013,2,25,16,923,830,1753,1779
0132-000,2013,2,25,17,903,785,1688,1753
0132-000,2013,2,25,18,961,772,1733,1688
0132-000,2013,2,25,19,1091,781,1872,1733
0132-000,2013,2,25,20,791,630,1421,1872
0132-000,2013,2,25,21,710,463,1173,1421
0132-000,2013,2,25,22,598,430,1028,1173
0132-000,2013,2,25,23,344,292,636,1028
0132-000,2013,2,25,24,258,195,453,636
0132-000,2013,2,26,1,164,140,304,453
0132-000,2013,2,26,2,112,75,187,304
0132-000,2013,2,26,3,80,103,183,187
0132-000,2013,2,26,4,54,70,124,183
0132-000,2013,2,26,5,74,116,190,124
0132-000,2013,2,26,6,129,107,236,190
0132-000,2013,2,26,7,308,361,669,236
0132-000,2013,2,26,8,525,1336,1861,669
0132-000,2013,2,26,9,768,1218,1986,1861
0132-000,2013,2,26,10,783,926,1709,1986
0132-000,2013,2,26,11,761,856,1617,1709
0132-000,2013,2,26,12,802,829,1631,1617
0132-000,2013,2,26,13,783,764,1547,1631
0132-000,2013,2,26,14,912,837,1749,1547
0132-000,2013,2,26,15,944,842,1786,1749
0132-000,2013,2,26,16,1028,830,1858,1786
0132-000,2013,2,26,17,931,772,1703,1858
0132-000,2013,2,26,18,1062,744,1806,1703
0132-000,2013,2,26,19,1078,774,1852,1806
0132-000,2013,2,26,20,854,612,1466,1852
0132-000,2013,2,26,21,748,483,1231,1466
0132-000,2013,2,26,22,611,432,1043,1231
0132-000,2013,2,26,23,407,305,712,1043
0132-000,2013,2,26,24,254,235,489,712
0132-000,2013,2,27,1,209,148,357,489
0132-000,2013,2,27,2,138,121,259,357
0132-000,2013,2,27,3,112,83,195,259
0132-000,2013,2,27,4,76,90,166,195
0132-000,2013,2,27,5,74,90,164,166
0132-000,2013,2,27,6,136,121,257,164
0132-000,2013,2,27,7,336,294,630,257
0132-000,2013,2,27,8,564,1359,1923,630
0132-000,2013,2,27,9,748,1156,1904,1923
0132-000,2013,2,27,10,731,876,1607,1904
0132-000,2013,2,27,11,832,812,1644,1607
0132-000,2013,2,27,12,854,840,1694,1644
0132-000,2013,2,27,13,798,847,1645,1694
0132-000,2013,2,27,14,882,878,1760,1645
0132-000,2013,2,27,15,927,971,1898,1760
0132-000,2013,2,27,16,944,835,1779,1898
0132-000,2013,2,27,17,978,795,1773,1779
0132-000,2013,2,27,18,1052,809,1861,1773
0132-000,2013,2,27,19,1148,858,2006,1861
0132-000,2013,2,27,20,822,695,1517,2006
0132-000,2013,2,27,21,742,505,1247,1517
0132-000,2013,2,27,22,641,472,1113,1247
0132-000,2013,2,27,23,428,324,752,1113
0132-000,2013,2,27,24,254,221,475,752
0132-000,2013,2,28,1,183,187,370,475
0132-000,2013,2,28,2,153,117,270,370
0132-000,2013,2,28,3,106,105,211,270
0132-000,2013,2,28,4,74,94,168,211
0132-000,2013,2,28,5,99,78,177,168
0132-000,2013,2,28,6,149,127,276,177
0132-000,2013,2,28,7,321,303,624,276
0132-000,2013,2,28,8,559,990,1549,624
0132-000,2013,2,28,9,708,1003,1711,1549
0132-000,2013,2,28,10,813,773,1586,1711
0132-000,2013,2,28,11,787,782,1569,1586
0132-000,2013,2,28,12,871,762,1633,1569
0132-000,2013,2,28,13,811,746,1557,1633
0132-000,2013,2,28,14,914,788,1702,1557
0132-000,2013,2,28,15,950,816,1766,1702
0132-000,2013,2,28,16,991,890,1881,1766
0132-000,2013,2,28,17,970,944,1914,1881
0132-000,2013,2,28,18,1112,919,2031,1914
0132-000,2013,2,28,19,1235,908,2143,2031
0132-000,2013,2,28,20,972,786,1758,2143
0132-000,2013,2,28,21,789,608,1397,1758
0132-000,2013,2,28,22,686,554,1240,1397
0132-000,2013,2,28,23,475,410,885,1240
0132-000,2013,2,28,24,379,264,643,885
0132-000,2013,3,1,1,182,213,395,643
0132-000,2013,3,1,2,161,144,305,395
0132-000,2013,3,1,3,89,124,213,305
0132-000,2013,3,1,4,95,111,206,213
0132-000,2013,3,1,5,98,113,211,206
0132-000,2013,3,1,6,159,124,283,211
0132-000,2013,3,1,7,221,242,463,283
0132-000,2013,3,1,8,306,626,932,463
0132-000,2013,3,1,9,524,811,1335,932
0132-000,2013,3,1,10,923,1199,2122,1335
0132-000,2013,3,1,11,1502,1696,3198,2122
0132-000,2013,3,1,12,1880,1978,3858,3198
0132-000,2013,3,1,13,2001,1893,3894,3858
0132-000,2013,3,1,14,1834,1921,3755,3894
0132-000,2013,3,1,15,1872,1886,3758,3755
0132-000,2013,3,1,16,2005,1904,3909,3758
0132-000,2013,3,1,17,2242,1945,4187,3909
0132-000,2013,3,1,18,2720,1839,4559,4187
0132-000,2013,3,1,19,2347,1586,3933,4559
0132-000,2013,3,1,20,1254,980,2234,3933
0132-000,2013,3,1,21,885,651,1536,2234
0132-000,2013,3,1,22,584,489,1073,1536
0132-000,2013,3,1,23,376,320,696,1073
0132-000,2013,3,1,24,226,218,444,696
0132-000,2013,3,2,1,171,173,344,444
0132-000,2013,3,2,2,97,95,192,344
0132-000,2013,3,2,3,69,74,143,192
0132-000,2013,3,2,4,81,94,175,143
0132-000,2013,3,2,5,68,87,155,175
0132-000,2013,3,2,6,159,113,272,155
0132-000,2013,3,2,7,241,212,453,272
0132-000,2013,3,2,8,334,488,822,453
0132-000,2013,3,2,9,481,596,1077,822
0132-000,2013,3,2,10,602,623,1225,1077
0132-000,2013,3,2,11,536,659,1195,1225
0132-000,2013,3,2,12,665,937,1602,1195
0132-000,2013,3,2,13,661,1000,1661,1602
0132-000,2013,3,2,14,965,1229,2194,1661
0132-000,2013,3,2,15,1128,1273,2401,2194
0132-000,2013,3,2,16,1113,1158,2271,2401
0132-000,2013,3,2,17,1380,1154,2534,2271
0132-000,2013,3,2,18,1711,1175,2886,2534
0132-000,2013,3,2,19,1440,1015,2455,2886
0132-000,2013,3,2,20,812,654,1466,2455
0132-000,2013,3,2,21,595,497,1092,1466
0132-000,2013,3,2,22,441,418,859,1092
0132-000,2013,3,2,23,357,377,734,859
0132-000,2013,3,2,24,273,280,553,734
0132-000,2013,3,3,1,144,219,363,553
0132-000,2013,3,3,2,113,127,240,363
0132-000,2013,3,3,3,102,101,203,240
0132-000,2013,3,3,4,75,93,168,203
0132-000,2013,3,3,5,79,80,159,168
0132-000,2013,3,3,6,112,86,198,159
0132-000,2013,3,3,7,96,130,226,198
0132-000,2013,3,3,8,202,261,463,226
0132-000,2013,3,3,9,263,354,617,463
0132-000,2013,3,3,10,463,501,964,617
0132-000,2013,3,3,11,537,638,1175,964
0132-000,2013,3,3,12,658,684,1342,1175
0132-000,2013,3,3,13,785,812,1597,1342
0132-000,2013,3,3,14,939,793,1732,1597
0132-000,2013,3,3,15,1154,892,2046,1732
0132-000,2013,3,3,16,1524,896,2420,2046
0132-000,2013,3,3,17,2056,1033,3089,2420
0132-000,2013,3,3,18,2014,945,2959,3089
0132-000,2013,3,3,19,2020,888,2908,2959
0132-000,2013,3,3,20,1238,554,1792,2908
0132-000,2013,3,3,21,745,516,1261,1792
0132-000,2013,3,3,22,414,364,778,1261
0132-000,2013,3,3,23,223,260,483,778
0132-000,2013,3,3,24,163,186,349,483
0132-000,2013,3,4,1,124,130,254,349
0132-000,2013,3,4,2,72,75,147,254
0132-000,2013,3,4,3,50,70,120,147
0132-000,2013,3,4,4,59,76,135,120
0132-000,2013,3,4,5,86,95,181,135
0132-000,2013,3,4,6,165,150,315,181
0132-000,2013,3,4,7,303,389,692,315
0132-000,2013,3,4,8,550,1247,1797,692
0132-000,2013,3,4,9,652,1098,1750,1797
0132-000,2013,3,4,10,578,785,1363,1750
0132-000,2013,3,4,11,648,760,1408,1363
0132-000,2013,3,4,12,839,841,1680,1408
0132-000,2013,3,4,13,724,792,1516,1680
0132-000,2013,3,4,14,810,839,1649,1516
0132-000,2013,3,4,15,882,876,1758,1649
0132-000,2013,3,4,16,1049,873,1922,1758
0132-000,2013,3,4,17,890,759,1649,1922
0132-000,2013,3,4,18,1124,816,1940,1649
0132-000,2013,3,4,19,1084,792,1876,1940
0132-000,2013,3,4,20,947,632,1579,1876
0132-000,2013,3,4,21,667,465,1132,1579
0132-000,2013,3,4,22,529,428,957,1132
0132-000,2013,3,4,23,280,260,540,957
0132-000,2013,3,4,24,201,203,404,540
0132-000,2013,3,5,1,140,138,278,404
0132-000,2013,3,5,2,96,103,199,278
0132-000,2013,3,5,3,72,84,156,199
0132-000,2013,3,5,4,48,70,118,156
0132-000,2013,3,5,5,122,104,226,118
0132-000,2013,3,5,6,164,151,315,226
0132-000,2013,3,5,7,327,324,651,315
0132-000,2013,3,5,8,566,1197,1763,651
0132-000,2013,3,5,9,665,1109,1774,1763
0132-000,2013,3,5,10,571,751,1322,1774
0132-000,2013,3,5,11,710,854,1564,1322
0132-000,2013,3,5,12,768,827,1595,1564
0132-000,2013,3,5,13,744,760,1504,1595
0132-000,2013,3,5,14,802,809,1611,1504
0132-000,2013,3,5,15,872,853,1725,1611
0132-000,2013,3,5,16,975,819,1794,1725
0132-000,2013,3,5,17,971,760,1731,1794
0132-000,2013,3,5,18,1027,764,1791,1731
0132-000,2013,3,5,19,1147,797,1944,1791
0132-000,2013,3,5,20,774,584,1358,1944
0132-000,2013,3,5,21,716,482,1198,1358
0132-000,2013,3,5,22,483,384,867,1198
0132-000,2013,3,5,23,333,301,634,867
0132-000,2013,3,5,24,188,200,388,634
0132-000,2013,3,6,1,136,144,280,388
0132-000,2013,3,6,2,99,98,197,280
0132-000,2013,3,6,3,102,113,215,197
0132-000,2013,3,6,4,73,120,193,215
0132-000,2013,3,6,5,98,98,196,193
0132-000,2013,3,6,6,171,144,315,196
0132-000,2013,3,6,7,339,344,683,315
0132-000,2013,3,6,8,672,1324,1996,683
0132-000,2013,3,6,9,686,1126,1812,1996
0132-000,2013,3,6,10,682,863,1545,1812
0132-000,2013,3,6,11,663,814,1477,1545
0132-000,2013,3,6,12,821,825,1646,1477
0132-000,2013,3,6,13,665,754,1419,1646
0132-000,2013,3,6,14,828,819,1647,1419
0132-000,2013,3,6,15,865,854,1719,1647
0132-000,2013,3,6,16,883,767,1650,1719
0132-000,2013,3,6,17,939,767,1706,1650
0132-000,2013,3,6,18,1236,834,2070,1706
0132-000,2013,3,6,19,1074,797,1871,2070
0132-000,2013,3,6,20,845,657,1502,1871
0132-000,2013,3,6,21,679,496,1175,1502
0132-000,2013,3,6,22,566,426,992,1175
0132-000,2013,3,6,23,293,316,609,992
0132-000,2013,3,6,24,223,214,437,609
0132-000,2013,3,7,1,142,147,289,437
0132-000,2013,3,7,2,104,114,218,289
0132-000,2013,3,7,3,75,88,163,218
0132-000,2013,3,7,4,72,93,165,163
0132-000,2013,3,7,5,88,93,181,165
0132-000,2013,3,7,6,148,117,265,181
0132-000,2013,3,7,7,354,357,711,265
0132-000,2013,3,7,8,595,1254,1849,711
0132-000,2013,3,7,9,678,1265,1943,1849
0132-000,2013,3,7,10,717,840,1557,1943
0132-000,2013,3,7,11,764,813,1577,1557
0132-000,2013,3,7,12,739,786,1525,1577
0132-000,2013,3,7,13,731,734,1465,1525
0132-000,2013,3,7,14,772,737,1509,1465
0132-000,2013,3,7,15,836,805,1641,1509
0132-000,2013,3,7,16,972,818,1790,1641
0132-000,2013,3,7,17,946,755,1701,1790
0132-000,2013,3,7,18,1050,775,1825,1701
0132-000,2013,3,7,19,978,673,1651,1825
0132-000,2013,3,7,20,739,564,1303,1651
0132-000,2013,3,7,21,535,436,971,1303
0132-000,2013,3,7,22,599,415,1014,971
0132-000,2013,3,7,23,310,285,595,1014
0132-000,2013,3,7,24,193,206,399,595
0132-000,2013,3,8,1,179,157,336,399
0132-000,2013,3,8,2,96,115,211,336
0132-000,2013,3,8,3,64,83,147,211
0132-000,2013,3,8,4,82,94,176,147
0132-000,2013,3,8,5,78,87,165,176
0132-000,2013,3,8,6,167,121,288,165
0132-000,2013,3,8,7,271,302,573,288
0132-000,2013,3,8,8,501,931,1432,573
0132-000,2013,3,8,9,606,873,1479,1432
0132-000,2013,3,8,10,598,726,1324,1479
0132-000,2013,3,8,11,649,741,1390,1324
0132-000,2013,3,8,12,727,792,1519,1390
0132-000,2013,3,8,13,707,733,1440,1519
0132-000,2013,3,8,14,823,795,1618,1440
0132-000,2013,3,8,15,815,819,1634,1618
0132-000,2013,3,8,16,1019,821,1840,1634
0132-000,2013,3,8,17,973,839,1812,1840
0132-000,2013,3,8,18,1430,944,2374,1812
0132-000,2013,3,8,19,1449,941,2390,2374
0132-000,2013,3,8,20,951,709,1660,2390
0132-000,2013,3,8,21,787,553,1340,1660
0132-000,2013,3,8,22,518,419,937,1340
0132-000,2013,3,8,23,378,347,725,937
0132-000,2013,3,8,24,226,216,442,725
0132-000,2013,3,9,1,236,209,445,442
0132-000,2013,3,9,2,134,158,292,445
0132-000,2013,3,9,3,85,107,192,292
0132-000,2013,3,9,4,77,100,177,192
0132-000,2013,3,9,5,99,117,216,177
0132-000,2013,3,9,6,186,167,353,216
0132-000,2013,3,9,7,318,269,587,353
0132-000,2013,3,9,8,462,720,1182,587
0132-000,2013,3,9,9,592,788,1380,1182
0132-000,2013,3,9,10,631,734,1365,1380
0132-000,2013,3,9,11,656,781,1437,1365
0132-000,2013,3,9,12,720,916,1636,1437
0132-000,2013,3,9,13,796,998,1794,1636
0132-000,2013,3,9,14,928,1118,2046,1794
0132-000,2013,3,9,15,817,981,1798,2046
0132-000,2013,3,9,16,946,954,1900,1798
0132-000,2013,3,9,17,996,847,1843,1900
0132-000,2013,3,9,18,1466,1001,2467,1843
0132-000,2013,3,9,19,1189,902,2091,2467
0132-000,2013,3,9,20,918,640,1558,2091
0132-000,2013,3,9,21,635,569,1204,1558
0132-000,2013,3,9,22,528,482,1010,1204
0132-000,2013,3,9,23,302,311,613,1010
0132-000,2013,3,9,24,203,223,426,613
0132-000,2013,3,10,1,180,205,385,426
0132-000,2013,3,10,2,148,158,306,385
0132-000,2013,3,10,3,87,106,193,306
0132-000,2013,3,10,4,101,109,210,193
0132-000,2013,3,10,5,123,118,241,210
0132-000,2013,3,10,6,106,104,210,241
0132-000,2013,3,10,7,207,217,424,210
0132-000,2013,3,10,8,240,327,567,424
0132-000,2013,3,10,9,380,464,844,567
0132-000,2013,3,10,10,511,542,1053,844
0132-000,2013,3,10,11,613,638,1251,1053
0132-000,2013,3,10,12,746,781,1527,1251
0132-000,2013,3,10,13,637,557,1194,1527
0132-000,2013,3,10,14,636,605,1241,1194
0132-000,2013,3,10,15,743,625,1368,1241
0132-000,2013,3,10,16,1106,664,1770,1368
0132-000,2013,3,10,17,1292,718,2010,1770
0132-000,2013,3,10,18,1322,723,2045,2010
0132-000,2013,3,10,19,1327,625,1952,2045
0132-000,2013,3,10,20,697,560,1257,1952
0132-000,2013,3,10,21,486,443,929,1257
0132-000,2013,3,10,22,401,410,811,929
0132-000,2013,3,10,23,271,285,556,811
0132-000,2013,3,10,24,156,197,353,556
0132-000,2013,3,11,1,108,117,225,353
0132-000,2013,3,11,2,73,82,155,225
0132-000,2013,3,11,3,67,63,130,155
0132-000,2013,3,11,4,51,71,122,130
0132-000,2013,3,11,5,82,92,174,122
0132-000,2013,3,11,6,140,147,287,174
0132-000,2013,3,11,7,361,459,820,287
0132-000,2013,3,11,8,744,1608,2352,820
0132-000,2013,3,11,9,767,1281,2048,2352
0132-000,2013,3,11,10,700,911,1611,2048
0132-000,2013,3,11,11,725,815,1540,1611
0132-000,2013,3,11,12,786,806,1592,1540
0132-000,2013,3,11,13,696,759,1455,1592
0132-000,2013,3,11,14,699,732,1431,1455
0132-000,2013,3,11,15,726,712,1438,1431
0132-000,2013,3,11,16,735,688,1423,1438
0132-000,2013,3,11,17,708,606,1314,1423
0132-000,2013,3,11,18,1014,729,1743,1314
0132-000,2013,3,11,19,1054,758,1812,1743
0132-000,2013,3,11,20,841,651,1492,1812
0132-000,2013,3,11,21,637,476,1113,1492
0132-000,2013,3,11,22,553,448,1001,1113
0132-000,2013,3,11,23,324,296,620,1001
0132-000,2013,3,11,24,196,178,374,620
0132-000,2013,3,12,1,116,135,251,374
0132-000,2013,3,12,2,78,92,170,251
0132-000,2013,3,12,3,64,70,134,170
0132-000,2013,3,12,4,68,87,155,134
0132-000,2013,3,12,5,77,92,169,155
0132-000,2013,3,12,6,202,144,346,169
0132-000,2013,3,12,7,330,371,701,346
0132-000,2013,3,12,8,659,1332,1991,701
0132-000,2013,3,12,9,746,1185,1931,1991
0132-000,2013,3,12,10,722,886,1608,1931
0132-000,2013,3,12,11,708,808,1516,1608
0132-000,2013,3,12,12,746,807,1553,1516
0132-000,2013,3,12,13,612,593,1205,1553
0132-000,2013,3,12,14,664,722,1386,1205
0132-000,2013,3,12,15,636,618,1254,1386
0132-000,2013,3,12,16,816,737,1553,1254
0132-000,2013,3,12,17,966,788,1754,1553
0132-000,2013,3,12,18,1083,723,1806,1754
0132-000,2013,3,12,19,1127,789,1916,1806
0132-000,2013,3,12,20,720,562,1282,1916
0132-000,2013,3,12,21,595,444,1039,1282
0132-000,2013,3,12,22,595,434,1029,1039
0132-000,2013,3,12,23,323,293,616,1029
0132-000,2013,3,12,24,280,262,542,616
0132-000,2013,3,13,1,298,321,619,542
0132-000,2013,3,13,2,106,112,218,619
0132-000,2013,3,13,3,140,202,342,218
0132-000,2013,3,13,4,142,164,306,342
0132-000,2013,3,13,5,134,121,255,306
0132-000,2013,3,13,6,264,237,501,255
0132-000,2013,3,13,7,334,393,727,501
0132-000,2013,3,13,8,468,934,1402,727
0132-000,2013,3,13,9,544,872,1416,1402
0132-000,2013,3,13,10,651,806,1457,1416
0132-000,2013,3,13,11,534,548,1082,1457
0132-000,2013,3,13,12,714,779,1493,1082
0132-000,2013,3,13,13,646,729,1375,1493
0132-000,2013,3,13,14,783,804,1587,1375
0132-000,2013,3,13,15,968,842,1810,1587
0132-000,2013,3,13,16,860,733,1593,1810
0132-000,2013,3,13,17,1063,783,1846,1593
0132-000,2013,3,13,18,1175,851,2026,1846
0132-000,2013,3,13,19,1229,846,2075,2026
0132-000,2013,3,13,20,900,626,1526,2075
0132-000,2013,3,13,21,673,500,1173,1526
0132-000,2013,3,13,22,599,441,1040,1173
0132-000,2013,3,13,23,354,330,684,1040
0132-000,2013,3,13,24,236,225,461,684
0132-000,2013,3,14,1,147,182,329,461
0132-000,2013,3,14,2,107,141,248,329
0132-000,2013,3,14,3,75,100,175,248
0132-000,2013,3,14,4,70,85,155,175
0132-000,2013,3,14,5,71,85,156,155
0132-000,2013,3,14,6,138,136,274,156
0132-000,2013,3,14,7,329,316,645,274
0132-000,2013,3,14,8,589,1124,1713,645
0132-000,2013,3,14,9,681,1148,1829,1713
0132-000,2013,3,14,10,723,877,1600,1829
0132-000,2013,3,14,11,749,804,1553,1600
0132-000,2013,3,14,12,709,727,1436,1553
0132-000,2013,3,14,13,707,753,1460,1436
0132-000,2013,3,14,14,602,655,1257,1460
0132-000,2013,3,14,15,820,798,1618,1257
0132-000,2013,3,14,16,907,786,1693,1618
0132-000,2013,3,14,17,913,777,1690,1693
0132-000,2013,3,14,18,1082,752,1834,1690
0132-000,2013,3,14,19,1206,860,2066,1834
0132-000,2013,3,14,20,939,706,1645,2066
0132-000,2013,3,14,21,822,595,1417,1645
0132-000,2013,3,14,22,592,452,1044,1417
0132-000,2013,3,14,23,391,326,717,1044
0132-000,2013,3,14,24,273,224,497,717
0132-000,2013,3,15,1,172,169,341,497
0132-000,2013,3,15,2,94,122,216,341
0132-000,2013,3,15,3,83,105,188,216
0132-000,2013,3,15,4,103,105,208,188
0132-000,2013,3,15,5,97,108,205,208
0132-000,2013,3,15,6,182,142,324,205
0132-000,2013,3,15,7,354,390,744,324
0132-000,2013,3,15,8,650,1360,2010,744
0132-000,2013,3,15,9,776,1142,1918,2010
0132-000,2013,3,15,10,731,894,1625,1918
0132-000,2013,3,15,11,750,843,1593,1625
0132-000,2013,3,15,12,735,789,1524,1593
0132-000,2013,3,15,13,599,647,1246,1524
0132-000,2013,3,15,14,674,621,1295,1246
0132-000,2013,3,15,15,819,729,1548,1295
0132-000,2013,3,15,16,692,579,1271,1548
0132-000,2013,3,15,17,672,581,1253,1271
0132-000,2013,3,15,18,944,660,1604,1253
0132-000,2013,3,15,19,1226,748,1974,1604
0132-000,2013,3,15,20,1045,746,1791,1974
0132-000,2013,3,15,21,725,545,1270,1791
0132-000,2013,3,15,22,664,506,1170,1270
0132-000,2013,3,15,23,358,357,715,1170
0132-000,2013,3,15,24,242,244,486,715
0132-000,2013,3,16,1,223,246,469,486
0132-000,2013,3,16,2,134,148,282,469
0132-000,2013,3,16,3,99,128,227,282
0132-000,2013,3,16,4,98,104,202,227
0132-000,2013,3,16,5,100,134,234,202
0132-000,2013,3,16,6,137,124,261,234
0132-000,2013,3,16,7,286,311,597,261
0132-000,2013,3,16,8,530,798,1328,597
0132-000,2013,3,16,9,725,981,1706,1328
0132-000,2013,3,16,10,779,937,1716,1706
0132-000,2013,3,16,11,837,1086,1923,1716
0132-000,2013,3,16,12,732,1143,1875,1923
0132-000,2013,3,16,13,714,1024,1738,1875
0132-000,2013,3,16,14,820,972,1792,1738
0132-000,2013,3,16,15,925,1019,1944,1792
0132-000,2013,3,16,16,957,966,1923,1944
0132-000,2013,3,16,17,960,914,1874,1923
0132-000,2013,3,16,18,1467,1011,2478,1874
0132-000,2013,3,16,19,1046,864,1910,2478
0132-000,2013,3,16,20,716,647,1363,1910
0132-000,2013,3,16,21,462,478,940,1363
0132-000,2013,3,16,22,450,437,887,940
0132-000,2013,3,16,23,337,321,658,887
0132-000,2013,3,16,24,226,223,449,658
0132-000,2013,3,17,1,218,216,434,449
0132-000,2013,3,17,2,129,142,271,434
0132-000,2013,3,17,3,96,109,205,271
0132-000,2013,3,17,4,77,84,161,205
0132-000,2013,3,17,5,70,79,149,161
0132-000,2013,3,17,6,90,100,190,149
0132-000,2013,3,17,7,146,165,311,190
0132-000,2013,3,17,8,290,367,657,311
0132-000,2013,3,17,9,384,488,872,657
0132-000,2013,3,17,10,483,543,1026,872
0132-000,2013,3,17,11,551,641,1192,1026
0132-000,2013,3,17,12,590,576,1166,1192
0132-000,2013,3,17,13,719,589,1308,1166
0132-000,2013,3,17,14,660,599,1259,1308
0132-000,2013,3,17,15,758,666,1424,1259
0132-000,2013,3,17,16,884,559,1443,1424
0132-000,2013,3,17,17,1142,664,1806,1443
0132-000,2013,3,17,18,1307,677,1984,1806
0132-000,2013,3,17,19,1172,581,1753,1984
0132-000,2013,3,17,20,711,478,1189,1753
0132-000,2013,3,17,21,577,463,1040,1189
0132-000,2013,3,17,22,315,367,682,1040
0132-000,2013,3,17,23,213,257,470,682
0132-000,2013,3,17,24,163,199,362,470
0132-000,2013,3,18,1,95,134,229,362
0132-000,2013,3,18,2,62,79,141,229
0132-000,2013,3,18,3,58,74,132,141
0132-000,2013,3,18,4,42,72,114,132
0132-000,2013,3,18,5,93,109,202,114
0132-000,2013,3,18,6,183,173,356,202
0132-000,2013,3,18,7,351,464,815,356
0132-000,2013,3,18,8,641,1439,2080,815
0132-000,2013,3,18,9,589,1027,1616,2080
0132-000,2013,3,18,10,668,791,1459,1616
0132-000,2013,3,18,11,668,763,1431,1459
0132-000,2013,3,18,12,626,715,1341,1431
0132-000,2013,3,18,13,616,675,1291,1341
0132-000,2013,3,18,14,742,784,1526,1291
0132-000,2013,3,18,15,766,744,1510,1526
0132-000,2013,3,18,16,717,681,1398,1510
0132-000,2013,3,18,17,879,772,1651,1398
0132-000,2013,3,18,18,1101,794,1895,1651
0132-000,2013,3,18,19,1030,763,1793,1895
0132-000,2013,3,18,20,815,646,1461,1793
0132-000,2013,3,18,21,639,471,1110,1461
0132-000,2013,3,18,22,611,427,1038,1110
0132-000,2013,3,18,23,325,315,640,1038
0132-000,2013,3,18,24,217,190,407,640
0132-000,2013,3,19,1,145,149,294,407
0132-000,2013,3,19,2,100,108,208,294
0132-000,2013,3,19,3,61,87,148,208
0132-000,2013,3,19,4,67,92,159,148
0132-000,2013,3,19,5,108,102,210,159
0132-000,2013,3,19,6,160,146,306,210
0132-000,2013,3,19,7,339,371,710,306
0132-000,2013,3,19,8,612,1248,1860,710
0132-000,2013,3,19,9,646,1087,1733,1860
0132-000,2013,3,19,10,749,904,1653,1733
0132-000,2013,3,19,11,730,808,1538,1653
0132-000,2013,3,19,12,722,721,1443,1538
0132-000,2013,3,19,13,679,708,1387,1443
0132-000,2013,3,19,14,730,760,1490,1387
0132-000,2013,3,19,15,833,816,1649,1490
0132-000,2013,3,19,16,816,757,1573,1649
0132-000,2013,3,19,17,905,773,1678,1573
0132-000,2013,3,19,18,1095,761,1856,1678
0132-000,2013,3,19,19,1097,763,1860,1856
0132-000,2013,3,19,20,739,592,1331,1860
0132-000,2013,3,19,21,585,473,1058,1331
0132-000,2013,3,19,22,655,463,1118,1058
0132-000,2013,3,19,23,356,285,641,1118
0132-000,2013,3,19,24,229,200,429,641
0132-000,2013,3,20,1,146,138,284,429
0132-000,2013,3,20,2,100,113,213,284
0132-000,2013,3,20,3,65,89,154,213
0132-000,2013,3,20,4,84,92,176,154
0132-000,2013,3,20,5,90,102,192,176
0132-000,2013,3,20,6,180,124,304,192
0132-000,2013,3,20,7,291,317,608,304
0132-000,2013,3,20,8,686,1329,2015,608
0132-000,2013,3,20,9,790,1257,2047,2015
0132-000,2013,3,20,10,694,866,1560,2047
0132-000,2013,3,20,11,730,811,1541,1560
0132-000,2013,3,20,12,778,830,1608,1541
0132-000,2013,3,20,13,658,709,1367,1608
0132-000,2013,3,20,14,777,871,1648,1367
0132-000,2013,3,20,15,847,800,1647,1648
0132-000,2013,3,20,16,854,776,1630,1647
0132-000,2013,3,20,17,961,740,1701,1630
0132-000,2013,3,20,18,1397,821,2218,1701
0132-000,2013,3,20,19,1155,769,1924,2218
0132-000,2013,3,20,20,774,560,1334,1924
0132-000,2013,3,20,21,672,482,1154,1334
0132-000,2013,3,20,22,490,377,867,1154
0132-000,2013,3,20,23,332,293,625,867
0132-000,2013,3,20,24,173,194,367,625
0132-000,2013,3,21,1,169,144,313,367
0132-000,2013,3,21,2,88,105,193,313
0132-000,2013,3,21,3,73,102,175,193
0132-000,2013,3,21,4,71,82,153,175
0132-000,2013,3,21,5,91,96,187,153
0132-000,2013,3,21,6,147,126,273,187
0132-000,2013,3,21,7,343,386,729,273
0132-000,2013,3,21,8,706,1411,2117,729
0132-000,2013,3,21,9,731,1145,1876,2117
0132-000,2013,3,21,10,759,898,1657,1876
0132-000,2013,3,21,11,710,826,1536,1657
0132-000,2013,3,21,12,755,782,1537,1536
0132-000,2013,3,21,13,778,768,1546,1537
0132-000,2013,3,21,14,802,803,1605,1546
0132-000,2013,3,21,15,854,770,1624,1605
0132-000,2013,3,21,16,878,772,1650,1624
0132-000,2013,3,21,17,823,744,1567,1650
0132-000,2013,3,21,18,995,740,1735,1567
0132-000,2013,3,21,19,1010,689,1699,1735
0132-000,2013,3,21,20,922,683,1605,1699
0132-000,2013,3,21,21,592,467,1059,1605
0132-000,2013,3,21,22,585,436,1021,1059
0132-000,2013,3,21,23,389,286,675,1021
0132-000,2013,3,21,24,183,200,383,675
0132-000,2013,3,22,1,208,175,383,383
0132-000,2013,3,22,2,100,98,198,383
0132-000,2013,3,22,3,85,104,189,198
0132-000,2013,3,22,4,58,77,135,189
0132-000,2013,3,22,5,67,90,157,135
0132-000,2013,3,22,6,154,116,270,157
0132-000,2013,3,22,7,360,390,750,270
0132-000,2013,3,22,8,686,1330,2016,750
0132-000,2013,3,22,9,737,1188,1925,2016
0132-000,2013,3,22,10,645,816,1461,1925
0132-000,2013,3,22,11,688,782,1470,1461
0132-000,2013,3,22,12,773,825,1598,1470
0132-000,2013,3,22,13,709,716,1425,1598
0132-000,2013,3,22,14,891,806,1697,1425
0132-000,2013,3,22,15,720,692,1412,1697
0132-000,2013,3,22,16,936,776,1712,1412
0132-000,2013,3,22,17,971,788,1759,1712
0132-000,2013,3,22,18,1323,881,2204,1759
0132-000,2013,3,22,19,1353,884,2237,2204
0132-000,2013,3,22,20,1012,755,1767,2237
0132-000,2013,3,22,21,661,578,1239,1767
0132-000,2013,3,22,22,666,530,1196,1239
0132-000,2013,3,22,23,358,355,713,1196
0132-000,2013,3,22,24,312,278,590,713
0132-000,2013,3,23,1,252,217,469,590
0132-000,2013,3,23,2,143,141,284,469
0132-000,2013,3,23,3,102,132,234,284
0132-000,2013,3,23,4,113,131,244,234
0132-000,2013,3,23,5,106,124,230,244
0132-000,2013,3,23,6,191,159,350,230
0132-000,2013,3,23,7,330,344,674,350
0132-000,2013,3,23,8,459,740,1199,674
0132-000,2013,3,23,9,555,710,1265,1199
0132-000,2013,3,23,10,850,1010,1860,1265
0132-000,2013,3,23,11,700,1180,1880,1860
0132-000,2013,3,23,12,819,1199,2018,1880
0132-000,2013,3,23,13,835,1165,2000,2018
0132-000,2013,3,23,14,769,1091,1860,2000
0132-000,2013,3,23,15,739,915,1654,1860
0132-000,2013,3,23,16,678,770,1448,1654
0132-000,2013,3,23,17,860,815,1675,1448
0132-000,2013,3,23,18,1341,1047,2388,1675
0132-000,2013,3,23,19,1197,923,2120,2388
0132-000,2013,3,23,20,784,706,1490,2120
0132-000,2013,3,23,21,601,505,1106,1490
0132-000,2013,3,23,22,485,439,924,1106
0132-000,2013,3,23,23,293,334,627,924
0132-000,2013,3,23,24,205,228,433,627
0132-000,2013,3,24,1,184,173,357,433
0132-000,2013,3,24,2,114,130,244,357
0132-000,2013,3,24,3,80,106,186,244
0132-000,2013,3,24,4,88,86,174,186
0132-000,2013,3,24,5,78,73,151,174
0132-000,2013,3,24,6,112,99,211,151
0132-000,2013,3,24,7,174,173,347,211
0132-000,2013,3,24,8,274,374,648,347
0132-000,2013,3,24,9,409,527,936,648
0132-000,2013,3,24,10,480,561,1041,936
0132-000,2013,3,24,11,611,629,1240,1041
0132-000,2013,3,24,12,642,665,1307,1240
0132-000,2013,3,24,13,669,662,1331,1307
0132-000,2013,3,24,14,712,638,1350,1331
0132-000,2013,3,24,15,768,643,1411,1350
0132-000,2013,3,24,16,1047,634,1681,1411
0132-000,2013,3,24,17,1185,680,1865,1681
0132-000,2013,3,24,18,1505,702,2207,1865
0132-000,2013,3,24,19,1194,587,1781,2207
0132-000,2013,3,24,20,942,528,1470,1781
0132-000,2013,3,24,21,683,468,1151,1470
0132-000,2013,3,24,22,477,407,884,1151
0132-000,2013,3,24,23,279,278,557,884
0132-000,2013,3,24,24,142,186,328,557
0132-000,2013,3,25,1,105,129,234,328
0132-000,2013,3,25,2,62,73,135,234
0132-000,2013,3,25,3,68,83,151,135
0132-000,2013,3,25,4,39,54,93,151
0132-000,2013,3,25,5,102,96,198,93
0132-000,2013,3,25,6,168,171,339,198
0132-000,2013,3,25,7,376,475,851,339
0132-000,2013,3,25,8,758,1617,2375,851
0132-000,2013,3,25,9,664,1182,1846,2375
0132-000,2013,3,25,10,767,906,1673,1846
0132-000,2013,3,25,11,716,806,1522,1673
0132-000,2013,3,25,12,785,912,1697,1522
0132-000,2013,3,25,13,678,740,1418,1697
0132-000,2013,3,25,14,771,843,1614,1418
0132-000,2013,3,25,15,945,864,1809,1614
0132-000,2013,3,25,16,946,859,1805,1809
0132-000,2013,3,25,17,997,824,1821,1805
0132-000,2013,3,25,18,1114,827,1941,1821
0132-000,2013,3,25,19,1193,798,1991,1941
0132-000,2013,3,25,20,857,633,1490,1991
0132-000,2013,3,25,21,557,463,1020,1490
0132-000,2013,3,25,22,683,445,1128,1020
0132-000,2013,3,25,23,287,305,592,1128
0132-000,2013,3,25,24,201,190,391,592
0132-000,2013,3,26,1,142,141,283,391
0132-000,2013,3,26,2,129,125,254,283
0132-000,2013,3,26,3,85,85,170,254
0132-000,2013,3,26,4,79,82,161,170
0132-000,2013,3,26,5,85,104,189,161
0132-000,2013,3,26,6,157,134,291,189
0132-000,2013,3,26,7,408,437,845,291
0132-000,2013,3,26,8,705,1448,2153,845
0132-000,2013,3,26,9,687,1116,1803,2153
0132-000,2013,3,26,10,828,955,1783,1803
0132-000,2013,3,26,11,687,787,1474,1783
0132-000,2013,3,26,12,791,843,1634,1474
0132-000,2013,3,26,13,663,713,1376,1634
0132-000,2013,3,26,14,799,818,1617,1376
0132-000,2013,3,26,15,796,807,1603,1617
0132-000,2013,3,26,16,880,763,1643,1603
0132-000,2013,3,26,17,927,780,1707,1643
0132-000,2013,3,26,18,1058,807,1865,1707
0132-000,2013,3,26,19,1172,780,1952,1865
0132-000,2013,3,26,20,780,605,1385,1952
0132-000,2013,3,26,21,625,463,1088,1385
0132-000,2013,3,26,22,591,420,1011,1088
0132-000,2013,3,26,23,326,300,626,1011
0132-000,2013,3,26,24,250,203,453,626
0132-000,2013,3,27,1,163,153,316,453
0132-000,2013,3,27,2,118,104,222,316
0132-000,2013,3,27,3,111,108,219,222
0132-000,2013,3,27,4,52,81,133,219
0132-000,2013,3,27,5,84,99,183,133
0132-000,2013,3,27,6,133,124,257,183
0132-000,2013,3,27,7,413,400,813,257
0132-000,2013,3,27,8,701,1261,1962,813
0132-000,2013,3,27,9,659,1204,1863,1962
0132-000,2013,3,27,10,748,882,1630,1863
0132-000,2013,3,27,11,718,789,1507,1630
0132-000,2013,3,27,12,735,753,1488,1507
0132-000,2013,3,27,13,679,731,1410,1488
0132-000,2013,3,27,14,687,705,1392,1410
0132-000,2013,3,27,15,814,797,1611,1392
0132-000,2013,3,27,16,782,709,1491,1611
0132-000,2013,3,27,17,707,576,1283,1491
0132-000,2013,3,27,18,1086,789,1875,1283
0132-000,2013,3,27,19,1148,750,1898,1875
0132-000,2013,3,27,20,913,634,1547,1898
0132-000,2013,3,27,21,630,490,1120,1547
0132-000,2013,3,27,22,525,424,949,1120
0132-000,2013,3,27,23,326,302,628,949
0132-000,2013,3,27,24,232,231,463,628
0132-000,2013,3,28,1,183,150,333,463
0132-000,2013,3,28,2,94,107,201,333
0132-000,2013,3,28,3,80,91,171,201
0132-000,2013,3,28,4,112,105,217,171
0132-000,2013,3,28,5,99,94,193,217
0132-000,2013,3,28,6,163,144,307,193
0132-000,2013,3,28,7,413,414,827,307
0132-000,2013,3,28,8,725,1374,2099,827
0132-000,2013,3,28,9,699,1214,1913,2099
0132-000,2013,3,28,10,772,906,1678,1913
0132-000,2013,3,28,11,691,796,1487,1678
0132-000,2013,3,28,12,732,819,1551,1487
0132-000,2013,3,28,13,727,765,1492,1551
0132-000,2013,3,28,14,807,818,1625,1492
0132-000,2013,3,28,15,774,798,1572,1625
0132-000,2013,3,28,16,818,720,1538,1572
0132-000,2013,3,28,17,942,761,1703,1538
0132-000,2013,3,28,18,1065,763,1828,1703
0132-000,2013,3,28,19,1248,806,2054,1828
0132-000,2013,3,28,20,853,644,1497,2054
0132-000,2013,3,28,21,505,408,913,1497
0132-000,2013,3,28,22,614,430,1044,913
0132-000,2013,3,28,23,302,306,608,1044
0132-000,2013,3,28,24,212,203,415,608
0132-000,2013,3,29,1,193,155,348,415
0132-000,2013,3,29,2,110,128,238,348
0132-000,2013,3,29,3,75,86,161,238
0132-000,2013,3,29,4,77,90,167,161
0132-000,2013,3,29,5,94,115,209,167
0132-000,2013,3,29,6,233,144,377,209
0132-000,2013,3,29,7,381,366,747,377
0132-000,2013,3,29,8,744,1398,2142,747
0132-000,2013,3,29,9,691,1182,1873,2142
0132-000,2013,3,29,10,728,847,1575,1873
0132-000,2013,3,29,11,745,802,1547,1575
0132-000,2013,3,29,12,734,791,1525,1547
0132-000,2013,3,29,13,660,683,1343,1525
0132-000,2013,3,29,14,732,733,1465,1343
0132-000,2013,3,29,15,735,720,1455,1465
0132-000,2013,3,29,16,909,800,1709,1455
0132-000,2013,3,29,17,873,755,1628,1709
0132-000,2013,3,29,18,1294,879,2173,1628
0132-000,2013,3,29,19,1201,826,2027,2173
0132-000,2013,3,29,20,1055,767,1822,2027
0132-000,2013,3,29,21,728,592,1320,1822
0132-000,2013,3,29,22,690,529,1219,1320
0132-000,2013,3,29,23,315,329,644,1219
0132-000,2013,3,29,24,275,281,556,644
0132-000,2013,3,30,1,210,215,425,556
0132-000,2013,3,30,2,158,149,307,425
0132-000,2013,3,30,3,86,115,201,307
0132-000,2013,3,30,4,126,130,256,201
0132-000,2013,3,30,5,112,112,224,256
0132-000,2013,3,30,6,146,144,290,224
0132-000,2013,3,30,7,288,303,591,290
0132-000,2013,3,30,8,510,785,1295,591
0132-000,2013,3,30,9,637,883,1520,1295
0132-000,2013,3,30,10,757,1090,1847,1520
0132-000,2013,3,30,11,914,1384,2298,1847
0132-000,2013,3,30,12,922,1668,2590,2298
0132-000,2013,3,30,13,1030,1537,2567,2590
0132-000,2013,3,30,14,831,1243,2074,2567
0132-000,2013,3,30,15,752,1087,1839,2074
0132-000,2013,3,30,16,877,1062,1939,1839
0132-000,2013,3,30,17,1280,1202,2482,1939
0132-000,2013,3,30,18,1827,1325,3152,2482
0132-000,2013,3,30,19,1398,1074,2472,3152
0132-000,2013,3,30,20,1025,685,1710,2472
0132-000,2013,3,30,21,482,453,935,1710
0132-000,2013,3,30,22,501,460,961,935
0132-000,2013,3,30,23,360,321,681,961
0132-000,2013,3,30,24,151,199,350,681
0132-000,2013,3,31,1,187,203,390,350
0132-000,2013,3,31,2,146,137,283,390
0132-000,2013,3,31,3,86,100,186,283
0132-000,2013,3,31,4,70,65,135,186
0132-000,2013,3,31,5,120,90,210,135
0132-000,2013,3,31,6,76,99,175,210
0132-000,2013,3,31,7,198,222,420,175
0132-000,2013,3,31,8,216,332,548,420
0132-000,2013,3,31,9,286,472,758,548
0132-000,2013,3,31,10,457,596,1053,758
0132-000,2013,3,31,11,512,635,1147,1053
0132-000,2013,3,31,12,540,629,1169,1147
0132-000,2013,3,31,13,654,642,1296,1169
0132-000,2013,3,31,14,686,648,1334,1296
0132-000,2013,3,31,15,951,700,1651,1334
0132-000,2013,3,31,16,1241,669,1910,1651
0132-000,2013,3,31,17,1250,615,1865,1910
0132-000,2013,3,31,18,1299,658,1957,1865
0132-000,2013,3,31,19,1576,623,2199,1957
0132-000,2013,3,31,20,1435,540,1975,2199
0132-000,2013,3,31,21,1145,501,1646,1975
0132-000,2013,3,31,22,821,421,1242,1646
0132-000,2013,3,31,23,434,311,745,1242
0132-000,2013,3,31,24,237,226,463,745
0132-000,2013,4,1,1,107,134,241,463
0132-000,2013,4,1,2,65,65,130,241
0132-000,2013,4,1,3,73,87,160,130
0132-000,2013,4,1,4,44,67,111,160
0132-000,2013,4,1,5,77,89,166,111
0132-000,2013,4,1,6,157,183,340,166
0132-000,2013,4,1,7,409,513,922,340
0132-000,2013,4,1,8,800,1588,2388,922
0132-000,2013,4,1,9,673,1218,1891,2388
0132-000,2013,4,1,10,719,894,1613,1891
0132-000,2013,4,1,11,708,809,1517,1613
0132-000,2013,4,1,12,698,786,1484,1517
0132-000,2013,4,1,13,682,736,1418,1484
0132-000,2013,4,1,14,741,719,1460,1418
0132-000,2013,4,1,15,778,747,1525,1460
0132-000,2013,4,1,16,832,772,1604,1525
0132-000,2013,4,1,17,873,708,1581,1604
0132-000,2013,4,1,18,1027,741,1768,1581
0132-000,2013,4,1,19,1079,829,1908,1768
0132-000,2013,4,1,20,831,607,1438,1908
0132-000,2013,4,1,21,675,483,1158,1438
0132-000,2013,4,1,22,632,429,1061,1158
0132-000,2013,4,1,23,249,258,507,1061
0132-000,2013,4,1,24,192,191,383,507
0132-000,2013,4,2,1,145,158,303,383
0132-000,2013,4,2,2,103,101,204,303
0132-000,2013,4,2,3,75,83,158,204
0132-000,2013,4,2,4,47,68,115,158
0132-000,2013,4,2,5,69,102,171,115
0132-000,2013,4,2,6,162,132,294,171
0132-000,2013,4,2,7,378,415,793,294
0132-000,2013,4,2,8,739,1473,2212,793
0132-000,2013,4,2,9,671,1220,1891,2212
0132-000,2013,4,2,10,692,841,1533,1891
0132-000,2013,4,2,11,752,803,1555,1533
0132-000,2013,4,2,12,772,786,1558,1555
0132-000,2013,4,2,13,784,762,1546,1558
0132-000,2013,4,2,14,722,786,1508,1546
0132-000,2013,4,2,15,802,809,1611,1508
0132-000,2013,4,2,16,819,723,1542,1611
0132-000,2013,4,2,17,928,758,1686,1542
0132-000,2013,4,2,18,981,736,1717,1686
0132-000,2013,4,2,19,1036,734,1770,1717
0132-000,2013,4,2,20,777,574,1351,1770
0132-000,2013,4,2,21,693,500,1193,1351
0132-000,2013,4,2,22,648,416,1064,1193
0132-000,2013,4,2,23,359,297,656,1064
0132-000,2013,4,2,24,192,203,395,656
0132-000,2013,4,3,1,170,138,308,395
0132-000,2013,4,3,2,91,107,198,308
0132-000,2013,4,3,3,62,88,150,198
0132-000,2013,4,3,4,81,93,174,150
0132-000,2013,4,3,5,94,100,194,174
0132-000,2013,4,3,6,184,156,340,194
0132-000,2013,4,3,7,374,414,788,340
0132-000,2013,4,3,8,762,1512,2274,788
0132-000,2013,4,3,9,686,1172,1858,2274
0132-000,2013,4,3,10,660,902,1562,1858
0132-000,2013,4,3,11,724,798,1522,1562
0132-000,2013,4,3,12,801,765,1566,1522
0132-000,2013,4,3,13,706,736,1442,1566
0132-000,2013,4,3,14,750,791,1541,1442
0132-000,2013,4,3,15,784,804,1588,1541
0132-000,2013,4,3,16,772,703,1475,1588
0132-000,2013,4,3,17,863,689,1552,1475
0132-000,2013,4,3,18,1097,720,1817,1552
0132-000,2013,4,3,19,1209,787,1996,1817
0132-000,2013,4,3,20,830,656,1486,1996
0132-000,2013,4,3,21,628,455,1083,1486
0132-000,2013,4,3,22,609,445,1054,1083
0132-000,2013,4,3,23,356,306,662,1054
0132-000,2013,4,3,24,171,191,362,662
0132-000,2013,4,4,1,129,157,286,362
0132-000,2013,4,4,2,102,103,205,286
0132-000,2013,4,4,3,127,125,252,205
0132-000,2013,4,4,4,71,104,175,252
0132-000,2013,4,4,5,78,97,175,175
0132-000,2013,4,4,6,151,173,324,175
0132-000,2013,4,4,7,390,423,813,324
0132-000,2013,4,4,8,741,1504,2245,813
0132-000,2013,4,4,9,745,1258,2003,2245
0132-000,2013,4,4,10,652,888,1540,2003
0132-000,2013,4,4,11,683,813,1496,1540
0132-000,2013,4,4,12,730,851,1581,1496
0132-000,2013,4,4,13,625,656,1281,1581
0132-000,2013,4,4,14,782,830,1612,1281
0132-000,2013,4,4,15,856,784,1640,1612
0132-000,2013,4,4,16,854,732,1586,1640
0132-000,2013,4,4,17,953,756,1709,1586
0132-000,2013,4,4,18,951,602,1553,1709
0132-000,2013,4,4,19,798,560,1358,1553
0132-000,2013,4,4,20,864,583,1447,1358
0132-000,2013,4,4,21,762,531,1293,1447
0132-000,2013,4,4,22,597,445,1042,1293
0132-000,2013,4,4,23,344,275,619,1042
0132-000,2013,4,4,24,235,220,455,619
0132-000,2013,4,5,1,142,144,286,455
0132-000,2013,4,5,2,80,98,178,286
0132-000,2013,4,5,3,125,103,228,178
0132-000,2013,4,5,4,75,107,182,228
0132-000,2013,4,5,5,92,102,194,182
0132-000,2013,4,5,6,185,160,345,194
0132-000,2013,4,5,7,400,449,849,345
0132-000,2013,4,5,8,802,1457,2259,849
0132-000,2013,4,5,9,705,1181,1886,2259
0132-000,2013,4,5,10,736,932,1668,1886
0132-000,2013,4,5,11,663,823,1486,1668
0132-000,2013,4,5,12,526,626,1152,1486
0132-000,2013,4,5,13,663,685,1348,1152
0132-000,2013,4,5,14,768,736,1504,1348
0132-000,2013,4,5,15,846,832,1678,1504
0132-000,2013,4,5,16,997,842,1839,1678
0132-000,2013,4,5,17,880,780,1660,1839
0132-000,2013,4,5,18,1289,897,2186,1660
0132-000,2013,4,5,19,1663,1029,2692,2186
0132-000,2013,4,5,20,986,743,1729,2692
0132-000,2013,4,5,21,711,560,1271,1729
0132-000,2013,4,5,22,689,523,1212,1271
0132-000,2013,4,5,23,441,371,812,1212
0132-000,2013,4,5,24,289,277,566,812
0132-000,2013,4,6,1,210,204,414,566
0132-000,2013,4,6,2,129,144,273,414
0132-000,2013,4,6,3,114,129,243,273
0132-000,2013,4,6,4,88,113,201,243
0132-000,2013,4,6,5,107,125,232,201
0132-000,2013,4,6,6,148,128,276,232
0132-000,2013,4,6,7,226,226,452,276
0132-000,2013,4,6,8,451,649,1100,452
0132-000,2013,4,6,9,569,763,1332,1100
0132-000,2013,4,6,10,629,916,1545,1332
0132-000,2013,4,6,11,679,1165,1844,1545
0132-000,2013,4,6,12,774,1298,2072,1844
0132-000,2013,4,6,13,745,1374,2119,2072
0132-000,2013,4,6,14,741,1204,1945,2119
0132-000,2013,4,6,15,760,1155,1915,1945
0132-000,2013,4,6,16,750,903,1653,1915
0132-000,2013,4,6,17,1024,1017,2041,1653
0132-000,2013,4,6,18,1273,951,2224,2041
0132-000,2013,4,6,19,1369,830,2199,2224
0132-000,2013,4,6,20,924,573,1497,2199
0132-000,2013,4,6,21,497,462,959,1497
0132-000,2013,4,6,22,387,369,756,959
0132-000,2013,4,6,23,288,263,551,756
0132-000,2013,4,6,24,195,210,405,551
0132-000,2013,4,7,1,162,161,323,405
0132-000,2013,4,7,2,114,113,227,323
0132-000,2013,4,7,3,94,95,189,227
0132-000,2013,4,7,4,64,71,135,189
0132-000,2013,4,7,5,59,67,126,135
0132-000,2013,4,7,6,189,204,393,126
0132-000,2013,4,7,7,169,218,387,393
0132-000,2013,4,7,8,239,308,547,387
0132-000,2013,4,7,9,355,459,814,547
0132-000,2013,4,7,10,461,576,1037,814
0132-000,2013,4,7,11,608,657,1265,1037
0132-000,2013,4,7,12,539,594,1133,1265
0132-000,2013,4,7,13,589,576,1165,1133
0132-000,2013,4,7,14,730,632,1362,1165
0132-000,2013,4,7,15,876,621,1497,1362
0132-000,2013,4,7,16,1219,633,1852,1497
0132-000,2013,4,7,17,1368,695,2063,1852
0132-000,2013,4,7,18,1415,649,2064,2063
0132-000,2013,4,7,19,1554,626,2180,2064
0132-000,2013,4,7,20,1337,537,1874,2180
0132-000,2013,4,7,21,1012,485,1497,1874
0132-000,2013,4,7,22,802,379,1181,1497
0132-000,2013,4,7,23,308,247,555,1181
0132-000,2013,4,7,24,191,209,400,555
0132-000,2013,4,8,1,139,145,284,400
0132-000,2013,4,8,2,63,87,150,284
0132-000,2013,4,8,3,61,68,129,150
0132-000,2013,4,8,4,58,58,116,129
0132-000,2013,4,8,5,76,86,162,116
0132-000,2013,4,8,6,190,181,371,162
0132-000,2013,4,8,7,485,583,1068,371
0132-000,2013,4,8,8,747,1637,2384,1068
0132-000,2013,4,8,9,649,1163,1812,2384
0132-000,2013,4,8,10,640,904,1544,1812
0132-000,2013,4,8,11,780,842,1622,1544
0132-000,2013,4,8,12,716,816,1532,1622
0132-000,2013,4,8,13,692,753,1445,1532
0132-000,2013,4,8,14,714,767,1481,1445
0132-000,2013,4,8,15,776,804,1580,1481
0132-000,2013,4,8,16,862,752,1614,1580
0132-000,2013,4,8,17,931,743,1674,1614
0132-000,2013,4,8,18,1119,825,1944,1674
0132-000,2013,4,8,19,1024,764,1788,1944
0132-000,2013,4,8,20,773,582,1355,1788
0132-000,2013,4,8,21,697,482,1179,1355
0132-000,2013,4,8,22,594,421,1015,1179
0132-000,2013,4,8,23,286,266,552,1015
0132-000,2013,4,8,24,182,162,344,552
0132-000,2013,4,9,1,138,140,278,344
0132-000,2013,4,9,2,77,83,160,278
0132-000,2013,4,9,3,61,78,139,160
0132-000,2013,4,9,4,78,87,165,139
0132-000,2013,4,9,5,68,93,161,165
0132-000,2013,4,9,6,160,147,307,161
0132-000,2013,4,9,7,442,476,918,307
0132-000,2013,4,9,8,788,1476,2264,918
0132-000,2013,4,9,9,775,1232,2007,2264
0132-000,2013,4,9,10,784,902,1686,2007
0132-000,2013,4,9,11,771,817,1588,1686
0132-000,2013,4,9,12,713,729,1442,1588
0132-000,2013,4,9,13,713,692,1405,1442
0132-000,2013,4,9,14,768,744,1512,1405
0132-000,2013,4,9,15,781,711,1492,1512
0132-000,2013,4,9,16,795,719,1514,1492
0132-000,2013,4,9,17,1012,759,1771,1514
0132-000,2013,4,9,18,1081,827,1908,1771
0132-000,2013,4,9,19,1308,804,2112,1908
0132-000,2013,4,9,20,926,650,1576,2112
0132-000,2013,4,9,21,707,536,1243,1576
0132-000,2013,4,9,22,690,473,1163,1243
0132-000,2013,4,9,23,366,331,697,1163
0132-000,2013,4,9,24,214,191,405,697
0132-000,2013,4,10,1,145,161,306,405
0132-000,2013,4,10,2,115,112,227,306
0132-000,2013,4,10,3,86,84,170,227
0132-000,2013,4,10,4,65,75,140,170
0132-000,2013,4,10,5,89,89,178,140
0132-000,2013,4,10,6,181,126,307,178
0132-000,2013,4,10,7,465,463,928,307
0132-000,2013,4,10,8,861,1435,2296,928
0132-000,2013,4,10,9,930,1224,2154,2296
0132-000,2013,4,10,10,700,885,1585,2154
0132-000,2013,4,10,11,732,849,1581,1585
0132-000,2013,4,10,12,765,800,1565,1581
0132-000,2013,4,10,13,714,704,1418,1565
0132-000,2013,4,10,14,759,761,1520,1418
0132-000,2013,4,10,15,754,748,1502,1520
0132-000,2013,4,10,16,814,766,1580,1502
0132-000,2013,4,10,17,839,748,1587,1580
0132-000,2013,4,10,18,990,827,1817,1587
0132-000,2013,4,10,19,1016,812,1828,1817
0132-000,2013,4,10,20,835,637,1472,1828
0132-000,2013,4,10,21,537,489,1026,1472
0132-000,2013,4,10,22,531,461,992,1026
0132-000,2013,4,10,23,270,283,553,992
0132-000,2013,4,10,24,176,194,370,553
0132-000,2013,4,11,1,140,149,289,370
0132-000,2013,4,11,2,139,127,266,289
0132-000,2013,4,11,3,77,99,176,266
0132-000,2013,4,11,4,73,92,165,176
0132-000,2013,4,11,5,65,100,165,165
0132-000,2013,4,11,6,136,135,271,165
0132-000,2013,4,11,7,379,446,825,271
0132-000,2013,4,11,8,749,1509,2258,825
0132-000,2013,4,11,9,744,1268,2012,2258
0132-000,2013,4,11,10,742,886,1628,2012
0132-000,2013,4,11,11,728,812,1540,1628
0132-000,2013,4,11,12,644,718,1362,1540
0132-000,2013,4,11,13,740,721,1461,1362
0132-000,2013,4,11,14,672,761,1433,1461
0132-000,2013,4,11,15,914,864,1778,1433
0132-000,2013,4,11,16,780,736,1516,1778
0132-000,2013,4,11,17,822,720,1542,1516
0132-000,2013,4,11,18,1085,756,1841,1542
0132-000,2013,4,11,19,1072,804,1876,1841
0132-000,2013,4,11,20,848,600,1448,1876
0132-000,2013,4,11,21,715,544,1259,1448
0132-000,2013,4,11,22,697,441,1138,1259
0132-000,2013,4,11,23,433,335,768,1138
0132-000,2013,4,11,24,221,207,428,768
0132-000,2013,4,12,1,169,178,347,428
0132-000,2013,4,12,2,121,123,244,347
0132-000,2013,4,12,3,94,103,197,244
0132-000,2013,4,12,4,89,105,194,197
0132-000,2013,4,12,5,102,123,225,194
0132-000,2013,4,12,6,181,170,351,225
0132-000,2013,4,12,7,370,416,786,351
0132-000,2013,4,12,8,683,1361,2044,786
0132-000,2013,4,12,9,720,1170,1890,2044
0132-000,2013,4,12,10,665,791,1456,1890
0132-000,2013,4,12,11,655,777,1432,1456
0132-000,2013,4,12,12,785,818,1603,1432
0132-000,2013,4,12,13,808,788,1596,1603
0132-000,2013,4,12,14,776,804,1580,1596
0132-000,2013,4,12,15,754,737,1491,1580
0132-000,2013,4,12,16,865,778,1643,1491
0132-000,2013,4,12,17,1021,834,1855,1643
0132-000,2013,4,12,18,1442,854,2296,1855
0132-000,2013,4,12,19,1631,900,2531,2296
0132-000,2013,4,12,20,1088,789,1877,2531
0132-000,2013,4,12,21,754,579,1333,1877
0132-000,2013,4,12,22,630,499,1129,1333
0132-000,2013,4,12,23,369,360,729,1129
0132-000,2013,4,12,24,290,258,548,729
0132-000,2013,4,13,1,216,208,424,548
0132-000,2013,4,13,2,184,188,372,424
0132-000,2013,4,13,3,104,118,222,372
0132-000,2013,4,13,4,109,139,248,222
0132-000,2013,4,13,5,116,144,260,248
0132-000,2013,4,13,6,195,154,349,260
0132-000,2013,4,13,7,331,346,677,349
0132-000,2013,4,13,8,555,750,1305,677
0132-000,2013,4,13,9,697,972,1669,1305
0132-000,2013,4,13,10,923,1340,2263,1669
0132-000,2013,4,13,11,825,1542,2367,2263
0132-000,2013,4,13,12,882,1740,2622,2367
0132-000,2013,4,13,13,931,1881,2812,2622
0132-000,2013,4,13,14,1052,1719,2771,2812
0132-000,2013,4,13,15,931,1394,2325,2771
0132-000,2013,4,13,16,860,1245,2105,2325
0132-000,2013,4,13,17,1377,1433,2810,2105
0132-000,2013,4,13,18,1681,1450,3131,2810
0132-000,2013,4,13,19,1407,1119,2526,3131
0132-000,2013,4,13,20,871,677,1548,2526
0132-000,2013,4,13,21,627,553,1180,1548
0132-000,2013,4,13,22,538,428,966,1180
0132-000,2013,4,13,23,292,279,571,966
0132-000,2013,4,13,24,195,220,415,571
0132-000,2013,4,14,1,194,189,383,415
0132-000,2013,4,14,2,146,148,294,383
0132-000,2013,4,14,3,102,104,206,294
0132-000,2013,4,14,4,99,104,203,206
0132-000,2013,4,14,5,106,88,194,203
0132-000,2013,4,14,6,101,107,208,194
0132-000,2013,4,14,7,148,168,316,208
0132-000,2013,4,14,8,252,327,579,316
0132-000,2013,4,14,9,295,420,715,579
0132-000,2013,4,14,10,452,555,1007,715
0132-000,2013,4,14,11,552,627,1179,1007
0132-000,2013,4,14,12,521,587,1108,1179
0132-000,2013,4,14,13,606,573,1179,1108
0132-000,2013,4,14,14,792,691,1483,1179
0132-000,2013,4,14,15,882,688,1570,1483
0132-000,2013,4,14,16,1209,658,1867,1570
0132-000,2013,4,14,17,1395,641,2036,1867
0132-000,2013,4,14,18,1493,644,2137,2036
0132-000,2013,4,14,19,1511,574,2085,2137
0132-000,2013,4,14,20,1230,513,1743,2085
0132-000,2013,4,14,21,1226,512,1738,1743
0132-000,2013,4,14,22,852,383,1235,1738
0132-000,2013,4,14,23,509,289,798,1235
0132-000,2013,4,14,24,195,165,360,798
0132-000,2013,4,15,1,155,139,294,360
0132-000,2013,4,15,2,92,112,204,294
0132-000,2013,4,15,3,70,80,150,204
0132-000,2013,4,15,4,54,70,124,150
0132-000,2013,4,15,5,67,93,160,124
0132-000,2013,4,15,6,178,187,365,160
0132-000,2013,4,15,7,452,549,1001,365
0132-000,2013,4,15,8,703,1546,2249,1001
0132-000,2013,4,15,9,683,1255,1938,2249
0132-000,2013,4,15,10,722,889,1611,1938
0132-000,2013,4,15,11,758,830,1588,1611
0132-000,2013,4,15,12,742,793,1535,1588
0132-000,2013,4,15,13,730,783,1513,1535
0132-000,2013,4,15,14,743,791,1534,1513
0132-000,2013,4,15,15,842,812,1654,1534
0132-000,2013,4,15,16,781,773,1554,1654
0132-000,2013,4,15,17,785,711,1496,1554
0132-000,2013,4,15,18,1030,771,1801,1496
0132-000,2013,4,15,19,1181,801,1982,1801
0132-000,2013,4,15,20,712,568,1280,1982
0132-000,2013,4,15,21,739,501,1240,1280
0132-000,2013,4,15,22,585,446,1031,1240
0132-000,2013,4,15,23,338,305,643,1031
0132-000,2013,4,15,24,276,223,499,643
0132-000,2013,4,16,1,164,165,329,499
0132-000,2013,4,16,2,94,97,191,329
0132-000,2013,4,16,3,96,100,196,191
0132-000,2013,4,16,4,80,91,171,196
0132-000,2013,4,16,5,67,98,165,171
0132-000,2013,4,16,6,160,157,317,165
0132-000,2013,4,16,7,458,489,947,317
0132-000,2013,4,16,8,763,1456,2219,947
0132-000,2013,4,16,9,776,1237,2013,2219
0132-000,2013,4,16,10,601,850,1451,2013
0132-000,2013,4,16,11,685,741,1426,1451
0132-000,2013,4,16,12,662,788,1450,1426
0132-000,2013,4,16,13,754,825,1579,1450
0132-000,2013,4,16,14,756,783,1539,1579
0132-000,2013,4,16,15,870,851,1721,1539
0132-000,2013,4,16,16,919,839,1758,1721
0132-000,2013,4,16,17,924,734,1658,1758
0132-000,2013,4,16,18,1093,818,1911,1658
0132-000,2013,4,16,19,1134,819,1953,1911
0132-000,2013,4,16,20,796,608,1404,1953
0132-000,2013,4,16,21,712,491,1203,1404
0132-000,2013,4,16,22,714,443,1157,1203
0132-000,2013,4,16,23,404,336,740,1157
0132-000,2013,4,16,24,212,202,414,740
0132-000,2013,4,17,1,186,158,344,414
0132-000,2013,4,17,2,92,115,207,344
0132-000,2013,4,17,3,99,97,196,207
0132-000,2013,4,17,4,91,86,177,196
0132-000,2013,4,17,5,87,100,187,177
0132-000,2013,4,17,6,179,149,328,187
0132-000,2013,4,17,7,404,421,825,328
0132-000,2013,4,17,8,697,1304,2001,825
0132-000,2013,4,17,9,693,1119,1812,2001
0132-000,2013,4,17,10,694,854,1548,1812
0132-000,2013,4,17,11,768,903,1671,1548
0132-000,2013,4,17,12,696,944,1640,1671
0132-000,2013,4,17,13,449,747,1196,1640
0132-000,2013,4,17,14,504,795,1299,1196
0132-000,2013,4,17,15,637,849,1486,1299
0132-000,2013,4,17,16,810,755,1565,1486
0132-000,2013,4,17,17,969,759,1728,1565
0132-000,2013,4,17,18,1039,803,1842,1728
0132-000,2013,4,17,19,1129,791,1920,1842
0132-000,2013,4,17,20,789,599,1388,1920
0132-000,2013,4,17,21,643,481,1124,1388
0132-000,2013,4,17,22,606,451,1057,1124
0132-000,2013,4,17,23,363,325,688,1057
0132-000,2013,4,17,24,180,192,372,688
0132-000,2013,4,18,1,168,142,310,372
0132-000,2013,4,18,2,108,114,222,310
0132-000,2013,4,18,3,89,97,186,222
0132-000,2013,4,18,4,85,87,172,186
0132-000,2013,4,18,5,88,101,189,172
0132-000,2013,4,18,6,183,154,337,189
0132-000,2013,4,18,7,357,413,770,337
0132-000,2013,4,18,8,701,1321,2022,770
0132-000,2013,4,18,9,654,1119,1773,2022
0132-000,2013,4,18,10,697,833,1530,1773
0132-000,2013,4,18,11,654,793,1447,1530
0132-000,2013,4,18,12,650,788,1438,1447
0132-000,2013,4,18,13,590,735,1325,1438
0132-000,2013,4,18,14,648,755,1403,1325
0132-000,2013,4,18,15,687,741,1428,1403
0132-000,2013,4,18,16,824,762,1586,1428
0132-000,2013,4,18,17,908,753,1661,1586
0132-000,2013,4,18,18,1043,778,1821,1661
0132-000,2013,4,18,19,1175,825,2000,1821
0132-000,2013,4,18,20,852,606,1458,2000
0132-000,2013,4,18,21,659,485,1144,1458
0132-000,2013,4,18,22,623,455,1078,1144
0132-000,2013,4,18,23,368,340,708,1078
0132-000,2013,4,18,24,272,248,520,708
0132-000,2013,4,19,1,151,162,313,520
0132-000,2013,4,19,2,152,124,276,313
0132-000,2013,4,19,3,72,94,166,276
0132-000,2013,4,19,4,65,97,162,166
0132-000,2013,4,19,5,108,109,217,162
0132-000,2013,4,19,6,177,175,352,217
0132-000,2013,4,19,7,448,456,904,352
0132-000,2013,4,19,8,778,1360,2138,904
0132-000,2013,4,19,9,730,1142,1872,2138
0132-000,2013,4,19,10,651,800,1451,1872
0132-000,2013,4,19,11,726,808,1534,1451
0132-000,2013,4,19,12,808,848,1656,1534
0132-000,2013,4,19,13,688,745,1433,1656
0132-000,2013,4,19,14,836,838,1674,1433
0132-000,2013,4,19,15,797,795,1592,1674
0132-000,2013,4,19,16,887,770,1657,1592
0132-000,2013,4,19,17,947,808,1755,1657
0132-000,2013,4,19,18,1230,851,2081,1755
0132-000,2013,4,19,19,1254,850,2104,2081
0132-000,2013,4,19,20,821,743,1564,2104
0132-000,2013,4,19,21,708,572,1280,1564
0132-000,2013,4,19,22,668,536,1204,1280
0132-000,2013,4,19,23,304,363,667,1204
0132-000,2013,4,19,24,232,234,466,667
0132-000,2013,4,20,1,203,226,429,466
0132-000,2013,4,20,2,137,142,279,429
0132-000,2013,4,20,3,103,125,228,279
0132-000,2013,4,20,4,132,127,259,228
0132-000,2013,4,20,5,100,120,220,259
0132-000,2013,4,20,6,123,149,272,220
0132-000,2013,4,20,7,299,288,587,272
0132-000,2013,4,20,8,550,795,1345,587
0132-000,2013,4,20,9,620,818,1438,1345
0132-000,2013,4,20,10,1022,1129,2151,1438
0132-000,2013,4,20,11,1087,1365,2452,2151
0132-000,2013,4,20,12,1383,1599,2982,2452
0132-000,2013,4,20,13,1484,1748,3232,2982
0132-000,2013,4,20,14,1515,1694,3209,3232
0132-000,2013,4,20,15,1354,1172,2526,3209
0132-000,2013,4,20,16,1849,1382,3231,2526
0132-000,2013,4,20,17,2063,1585,3648,3231
0132-000,2013,4,20,18,2169,1382,3551,3648
0132-000,2013,4,20,19,1588,1286,2874,3551
0132-000,2013,4,20,20,851,692,1543,2874
0132-000,2013,4,20,21,606,523,1129,1543
0132-000,2013,4,20,22,413,420,833,1129
0132-000,2013,4,20,23,257,276,533,833
0132-000,2013,4,20,24,226,233,459,533
0132-000,2013,4,21,1,233,276,509,459
0132-000,2013,4,21,2,240,277,517,509
0132-000,2013,4,21,3,206,192,398,517
0132-000,2013,4,21,4,194,202,396,398
0132-000,2013,4,21,5,259,279,538,396
0132-000,2013,4,21,6,175,203,378,538
0132-000,2013,4,21,7,348,335,683,378
0132-000,2013,4,21,8,285,426,711,683
0132-000,2013,4,21,9,486,578,1064,711
0132-000,2013,4,21,10,570,637,1207,1064
0132-000,2013,4,21,11,646,716,1362,1207
0132-000,2013,4,21,12,893,941,1834,1362
0132-000,2013,4,21,13,1011,942,1953,1834
0132-000,2013,4,21,14,1109,956,2065,1953
0132-000,2013,4,21,15,1087,992,2079,2065
0132-000,2013,4,21,16,1310,953,2263,2079
0132-000,2013,4,21,17,1394,802,2196,2263
0132-000,2013,4,21,18,1524,897,2421,2196
0132-000,2013,4,21,19,1092,692,1784,2421
0132-000,2013,4,21,20,626,522,1148,1784
0132-000,2013,4,21,21,581,522,1103,1148
0132-000,2013,4,21,22,508,561,1069,1103
0132-000,2013,4,21,23,284,284,568,1069
0132-000,2013,4,21,24,201,222,423,568
0132-000,2013,4,22,1,114,141,255,423
0132-000,2013,4,22,2,70,85,155,255
0132-000,2013,4,22,3,65,68,133,155
0132-000,2013,4,22,4,74,81,155,133
0132-000,2013,4,22,5,58,84,142,155
0132-000,2013,4,22,6,168,195,363,142
0132-000,2013,4,22,7,474,599,1073,363
0132-000,2013,4,22,8,782,1633,2415,1073
0132-000,2013,4,22,9,721,1270,1991,2415
0132-000,2013,4,22,10,666,832,1498,1991
0132-000,2013,4,22,11,719,850,1569,1498
0132-000,2013,4,22,12,642,784,1426,1569
0132-000,2013,4,22,13,604,777,1381,1426
0132-000,2013,4,22,14,515,801,1316,1381
0132-000,2013,4,22,15,636,802,1438,1316
0132-000,2013,4,22,16,699,738,1437,1438
0132-000,2013,4,22,17,736,754,1490,1437
0132-000,2013,4,22,18,928,820,1748,1490
0132-000,2013,4,22,19,1090,753,1843,1748
0132-000,2013,4,22,20,855,645,1500,1843
0132-000,2013,4,22,21,756,539,1295,1500
0132-000,2013,4,22,22,499,458,957,1295
0132-000,2013,4,22,23,323,332,655,957
0132-000,2013,4,22,24,223,209,432,655
0132-000,2013,4,23,1,154,135,289,432
0132-000,2013,4,23,2,112,111,223,289
0132-000,2013,4,23,3,70,94,164,223
0132-000,2013,4,23,4,76,92,168,164
0132-000,2013,4,23,5,79,104,183,168
0132-000,2013,4,23,6,191,172,363,183
0132-000,2013,4,23,7,389,423,812,363
0132-000,2013,4,23,8,712,1410,2122,812
0132-000,2013,4,23,9,768,1282,2050,2122
0132-000,2013,4,23,10,580,793,1373,2050
0132-000,2013,4,23,11,540,712,1252,1373
0132-000,2013,4,23,12,547,673,1220,1252
0132-000,2013,4,23,13,611,687,1298,1220
0132-000,2013,4,23,14,541,712,1253,1298
0132-000,2013,4,23,15,711,759,1470,1253
0132-000,2013,4,23,16,891,752,1643,1470
0132-000,2013,4,23,17,914,713,1627,1643
0132-000,2013,4,23,18,899,741,1640,1627
0132-000,2013,4,23,19,1193,828,2021,1640
0132-000,2013,4,23,20,842,583,1425,2021
0132-000,2013,4,23,21,694,485,1179,1425
0132-000,2013,4,23,22,558,448,1006,1179
0132-000,2013,4,23,23,505,390,895,1006
0132-000,2013,4,23,24,337,321,658,895
0132-000,2013,4,24,1,391,343,734,658
0132-000,2013,4,24,2,357,394,751,734
0132-000,2013,4,24,3,218,294,512,751
0132-000,2013,4,24,4,266,312,578,512
0132-000,2013,4,24,5,207,273,480,578
0132-000,2013,4,24,6,195,161,356,480
0132-000,2013,4,24,7,427,401,828,356
0132-000,2013,4,24,8,815,1501,2316,828
0132-000,2013,4,24,9,661,1127,1788,2316
0132-000,2013,4,24,10,711,911,1622,1788
0132-000,2013,4,24,11,861,919,1780,1622
0132-000,2013,4,24,12,959,952,1911,1780
0132-000,2013,4,24,13,641,706,1347,1911
0132-000,2013,4,24,14,774,779,1553,1347
0132-000,2013,4,24,15,825,846,1671,1553
0132-000,2013,4,24,16,860,791,1651,1671
0132-000,2013,4,24,17,844,699,1543,1651
0132-000,2013,4,24,18,1101,760,1861,1543
0132-000,2013,4,24,19,1101,813,1914,1861
0132-000,2013,4,24,20,871,677,1548,1914
0132-000,2013,4,24,21,742,551,1293,1548
0132-000,2013,4,24,22,507,384,891,1293
0132-000,2013,4,24,23,361,323,684,891
0132-000,2013,4,24,24,212,206,418,684
0132-000,2013,4,25,1,178,166,344,418
0132-000,2013,4,25,2,78,107,185,344
0132-000,2013,4,25,3,81,91,172,185
0132-000,2013,4,25,4,87,106,193,172
0132-000,2013,4,25,5,83,113,196,193
0132-000,2013,4,25,6,163,160,323,196
0132-000,2013,4,25,7,425,448,873,323
0132-000,2013,4,25,8,642,1302,1944,873
0132-000,2013,4,25,9,655,1114,1769,1944
0132-000,2013,4,25,10,558,699,1257,1769
0132-000,2013,4,25,11,618,711,1329,1257
0132-000,2013,4,25,12,666,663,1329,1329
0132-000,2013,4,25,13,598,639,1237,1329
0132-000,2013,4,25,14,677,706,1383,1237
0132-000,2013,4,25,15,644,796,1440,1383
0132-000,2013,4,25,16,901,789,1690,1440
0132-000,2013,4,25,17,916,759,1675,1690
0132-000,2013,4,25,18,1202,771,1973,1675
0132-000,2013,4,25,19,1071,776,1847,1973
0132-000,2013,4,25,20,881,614,1495,1847
0132-000,2013,4,25,21,770,480,1250,1495
0132-000,2013,4,25,22,475,376,851,1250
0132-000,2013,4,25,23,325,276,601,851
0132-000,2013,4,25,24,180,163,343,601
0132-000,2013,4,26,1,173,187,360,343
0132-000,2013,4,26,2,126,118,244,360
0132-000,2013,4,26,3,101,116,217,244
0132-000,2013,4,26,4,71,88,159,217
0132-000,2013,4,26,5,79,108,187,159
0132-000,2013,4,26,6,189,169,358,187
0132-000,2013,4,26,7,455,486,941,358
0132-000,2013,4,26,8,820,1490,2310,941
0132-000,2013,4,26,9,683,1135,1818,2310
0132-000,2013,4,26,10,711,813,1524,1818
0132-000,2013,4,26,11,651,808,1459,1524
0132-000,2013,4,26,12,681,754,1435,1459
0132-000,2013,4,26,13,482,718,1200,1435
0132-000,2013,4,26,14,555,761,1316,1200
0132-000,2013,4,26,15,692,804,1496,1316
0132-000,2013,4,26,16,885,795,1680,1496
0132-000,2013,4,26,17,946,787,1733,1680
0132-000,2013,4,26,18,1169,866,2035,1733
0132-000,2013,4,26,19,1193,938,2131,2035
0132-000,2013,4,26,20,936,784,1720,2131
0132-000,2013,4,26,21,666,578,1244,1720
0132-000,2013,4,26,22,513,475,988,1244
0132-000,2013,4,26,23,382,359,741,988
0132-000,2013,4,26,24,225,250,475,741
0132-000,2013,4,27,1,191,203,394,475
0132-000,2013,4,27,2,146,166,312,394
0132-000,2013,4,27,3,90,110,200,312
0132-000,2013,4,27,4,101,130,231,200
0132-000,2013,4,27,5,106,124,230,231
0132-000,2013,4,27,6,174,160,334,230
0132-000,2013,4,27,7,328,378,706,334
0132-000,2013,4,27,8,617,885,1502,706
0132-000,2013,4,27,9,560,783,1343,1502
0132-000,2013,4,27,10,659,1053,1712,1343
0132-000,2013,4,27,11,615,1233,1848,1712
0132-000,2013,4,27,12,900,1535,2435,1848
0132-000,2013,4,27,13,729,1317,2046,2435
0132-000,2013,4,27,14,780,1273,2053,2046
0132-000,2013,4,27,15,868,1090,1958,2053
0132-000,2013,4,27,16,917,1029,1946,1958
0132-000,2013,4,27,17,944,1068,2012,1946
0132-000,2013,4,27,18,1067,1141,2208,2012
0132-000,2013,4,27,19,953,934,1887,2208
0132-000,2013,4,27,20,699,674,1373,1887
0132-000,2013,4,27,21,539,505,1044,1373
0132-000,2013,4,27,22,422,451,873,1044
0132-000,2013,4,27,23,248,312,560,873
0132-000,2013,4,27,24,214,242,456,560
0132-000,2013,4,28,1,163,200,363,456
0132-000,2013,4,28,2,142,139,281,363
0132-000,2013,4,28,3,103,110,213,281
0132-000,2013,4,28,4,87,87,174,213
0132-000,2013,4,28,5,53,69,122,174
0132-000,2013,4,28,6,100,140,240,122
0132-000,2013,4,28,7,187,215,402,240
0132-000,2013,4,28,8,339,445,784,402
0132-000,2013,4,28,9,396,513,909,784
0132-000,2013,4,28,10,410,578,988,909
0132-000,2013,4,28,11,441,634,1075,988
0132-000,2013,4,28,12,557,679,1236,1075
0132-000,2013,4,28,13,433,550,983,1236
0132-000,2013,4,28,14,639,660,1299,983
0132-000,2013,4,28,15,749,653,1402,1299
0132-000,2013,4,28,16,980,662,1642,1402
0132-000,2013,4,28,17,1127,637,1764,1642
0132-000,2013,4,28,18,1110,564,1674,1764
0132-000,2013,4,28,19,1305,630,1935,1674
0132-000,2013,4,28,20,1062,534,1596,1935
0132-000,2013,4,28,21,678,453,1131,1596
0132-000,2013,4,28,22,625,451,1076,1131
0132-000,2013,4,28,23,300,293,593,1076
0132-000,2013,4,28,24,181,197,378,593
0132-000,2013,4,29,1,115,174,289,378
0132-000,2013,4,29,2,78,91,169,289
0132-000,2013,4,29,3,56,67,123,169
0132-000,2013,4,29,4,28,56,84,123
0132-000,2013,4,29,5,83,112,195,84
0132-000,2013,4,29,6,152,162,314,195
0132-000,2013,4,29,7,377,490,867,314
0132-000,2013,4,29,8,757,1624,2381,867
0132-000,2013,4,29,9,780,1315,2095,2381
0132-000,2013,4,29,10,604,889,1493,2095
0132-000,2013,4,29,11,629,786,1415,1493
0132-000,2013,4,29,12,730,827,1557,1415
0132-000,2013,4,29,13,444,709,1153,1557
0132-000,2013,4,29,14,557,825,1382,1153
0132-000,2013,4,29,15,767,842,1609,1382
0132-000,2013,4,29,16,765,812,1577,1609
0132-000,2013,4,29,17,820,771,1591,1577
0132-000,2013,4,29,18,935,768,1703,1591
0132-000,2013,4,29,19,1075,818,1893,1703
0132-000,2013,4,29,20,764,602,1366,1893
0132-000,2013,4,29,21,613,541,1154,1366
0132-000,2013,4,29,22,510,450,960,1154
0132-000,2013,4,29,23,332,306,638,960
0132-000,2013,4,29,24,207,212,419,638
0132-000,2013,4,30,1,167,155,322,419
0132-000,2013,4,30,2,128,129,257,322
0132-000,2013,4,30,3,78,88,166,257
0132-000,2013,4,30,4,60,90,150,166
0132-000,2013,4,30,5,100,110,210,150
0132-000,2013,4,30,6,134,149,283,210
0132-000,2013,4,30,7,370,493,863,283
0132-000,2013,4,30,8,957,1549,2506,863
0132-000,2013,4,30,9,792,1263,2055,2506
0132-000,2013,4,30,10,601,866,1467,2055
0132-000,2013,4,30,11,658,836,1494,1467
0132-000,2013,4,30,12,743,771,1514,1494
0132-000,2013,4,30,13,743,774,1517,1514
0132-000,2013,4,30,14,653,814,1467,1517
0132-000,2013,4,30,15,801,825,1626,1467
0132-000,2013,4,30,16,996,782,1778,1626
0132-000,2013,4,30,17,970,828,1798,1778
0132-000,2013,4,30,18,1062,897,1959,1798
0132-000,2013,4,30,19,1260,860,2120,1959
0132-000,2013,4,30,20,1015,807,1822,2120
0132-000,2013,4,30,21,760,579,1339,1822
0132-000,2013,4,30,22,583,533,1116,1339
0132-000,2013,4,30,23,350,377,727,1116
0132-000,2013,4,30,24,310,291,601,727
0132-000,2013,5,1,1,180,207,387,601
0132-000,2013,5,1,2,125,154,279,387
0132-000,2013,5,1,3,79,97,176,279
0132-000,2013,5,1,4,81,99,180,176
0132-000,2013,5,1,5,89,105,194,180
0132-000,2013,5,1,6,136,131,267,194
0132-000,2013,5,1,7,305,375,680,267
0132-000,2013,5,1,8,441,916,1357,680
0132-000,2013,5,1,9,591,996,1587,1357
0132-000,2013,5,1,10,629,856,1485,1587
0132-000,2013,5,1,11,579,744,1323,1485
0132-000,2013,5,1,12,564,716,1280,1323
0132-000,2013,5,1,13,681,762,1443,1280
0132-000,2013,5,1,14,578,724,1302,1443
0132-000,2013,5,1,15,535,681,1216,1302
0132-000,2013,5,1,16,800,754,1554,1216
0132-000,2013,5,1,17,891,711,1602,1554
0132-000,2013,5,1,18,1055,796,1851,1602
0132-000,2013,5,1,19,920,695,1615,1851
0132-000,2013,5,1,20,740,583,1323,1615
0132-000,2013,5,1,21,605,448,1053,1323
0132-000,2013,5,1,22,363,375,738,1053
0132-000,2013,5,1,23,243,289,532,738
0132-000,2013,5,1,24,215,224,439,532
0132-000,2013,5,2,1,122,138,260,439
0132-000,2013,5,2,2,77,92,169,260
0132-000,2013,5,2,3,84,83,167,169
0132-000,2013,5,2,4,56,85,141,167
0132-000,2013,5,2,5,103,120,223,141
0132-000,2013,5,2,6,171,157,328,223
0132-000,2013,5,2,7,473,532,1005,328
0132-000,2013,5,2,8,688,1391,2079,1005
0132-000,2013,5,2,9,754,1345,2099,2079
0132-000,2013,5,2,10,573,859,1432,2099
0132-000,2013,5,2,11,622,772,1394,1432
0132-000,2013,5,2,12,744,862,1606,1394
0132-000,2013,5,2,13,732,758,1490,1606
0132-000,2013,5,2,14,702,858,1560,1490
0132-000,2013,5,2,15,678,816,1494,1560
0132-000,2013,5,2,16,748,853,1601,1494
0132-000,2013,5,2,17,842,738,1580,1601
0132-000,2013,5,2,18,1079,807,1886,1580
0132-000,2013,5,2,19,1178,778,1956,1886
0132-000,2013,5,2,20,685,620,1305,1956
0132-000,2013,5,2,21,524,495,1019,1305
0132-000,2013,5,2,22,464,456,920,1019
0132-000,2013,5,2,23,374,351,725,920
0132-000,2013,5,2,24,247,234,481,725
0132-000,2013,5,3,1,207,170,377,481
0132-000,2013,5,3,2,116,115,231,377
0132-000,2013,5,3,3,90,118,208,231
0132-000,2013,5,3,4,52,85,137,208
0132-000,2013,5,3,5,129,132,261,137
0132-000,2013,5,3,6,147,150,297,261
0132-000,2013,5,3,7,429,449,878,297
0132-000,2013,5,3,8,728,1357,2085,878
0132-000,2013,5,3,9,738,1194,1932,2085
0132-000,2013,5,3,10,601,910,1511,1932
0132-000,2013,5,3,11,587,760,1347,1511
0132-000,2013,5,3,12,735,851,1586,1347
0132-000,2013,5,3,13,681,736,1417,1586
0132-000,2013,5,3,14,653,827,1480,1417
0132-000,2013,5,3,15,862,888,1750,1480
0132-000,2013,5,3,16,727,841,1568,1750
0132-000,2013,5,3,17,873,853,1726,1568
0132-000,2013,5,3,18,1003,944,1947,1726
0132-000,2013,5,3,19,950,940,1890,1947
0132-000,2013,5,3,20,701,936,1637,1890
0132-000,2013,5,3,21,632,809,1441,1637
0132-000,2013,5,3,22,388,836,1224,1441
0132-000,2013,5,3,23,258,660,918,1224
0132-000,2013,5,3,24,89,287,376,918
0132-000,2013,5,4,1,74,228,302,376
0132-000,2013,5,4,2,70,147,217,302
0132-000,2013,5,4,3,92,105,197,217
0132-000,2013,5,4,4,110,101,211,197
0132-000,2013,5,4,5,104,132,236,211
0132-000,2013,5,4,6,185,182,367,236
0132-000,2013,5,4,7,359,355,714,367
0132-000,2013,5,4,8,469,787,1256,714
0132-000,2013,5,4,9,519,1035,1554,1256
0132-000,2013,5,4,10,522,1240,1762,1554
0132-000,2013,5,4,11,682,1614,2296,1762
0132-000,2013,5,4,12,665,1857,2522,2296
0132-000,2013,5,4,13,716,1839,2555,2522
0132-000,2013,5,4,14,716,1730,2446,2555
0132-000,2013,5,4,15,772,1690,2462,2446
0132-000,2013,5,4,16,977,1710,2687,2462
0132-000,2013,5,4,17,978,1493,2471,2687
0132-000,2013,5,4,18,1201,1448,2649,2471
0132-000,2013,5,4,19,1104,1254,2358,2649
0132-000,2013,5,4,20,706,805,1511,2358
0132-000,2013,5,4,21,653,563,1216,1511
0132-000,2013,5,4,22,518,510,1028,1216
0132-000,2013,5,4,23,291,355,646,1028
0132-000,2013,5,4,24,217,262,479,646
0132-000,2013,5,5,1,158,191,349,479
0132-000,2013,5,5,2,124,129,253,349
0132-000,2013,5,5,3,74,93,167,253
0132-000,2013,5,5,4,95,68,163,167
0132-000,2013,5,5,5,90,91,181,163
0132-000,2013,5,5,6,104,116,220,181
0132-000,2013,5,5,7,198,233,431,220
0132-000,2013,5,5,8,272,341,613,431
0132-000,2013,5,5,9,330,462,792,613
0132-000,2013,5,5,10,458,570,1028,792
0132-000,2013,5,5,11,810,691,1501,1028
0132-000,2013,5,5,12,1106,715,1821,1501
0132-000,2013,5,5,13,1152,659,1811,1821
0132-000,2013,5,5,14,1296,702,1998,1811
0132-000,2013,5,5,15,1294,718,2012,1998
0132-000,2013,5,5,16,1156,686,1842,2012
0132-000,2013,5,5,17,1570,758,2328,1842
0132-000,2013,5,5,18,1304,661,1965,2328
0132-000,2013,5,5,19,1338,664,2002,1965
0132-000,2013,5,5,20,1645,577,2222,2002
0132-000,2013,5,5,21,1166,504,1670,2222
0132-000,2013,5,5,22,1046,475,1521,1670
0132-000,2013,5,5,23,928,356,1284,1521
0132-000,2013,5,5,24,538,223,761,1284
0132-000,2013,5,6,1,314,181,495,761
0132-000,2013,5,6,2,77,79,156,495
0132-000,2013,5,6,3,49,65,114,156
0132-000,2013,5,6,4,36,62,98,114
0132-000,2013,5,6,5,58,89,147,98
0132-000,2013,5,6,6,167,179,346,147
0132-000,2013,5,6,7,393,591,984,346
0132-000,2013,5,6,8,646,1701,2347,984
0132-000,2013,5,6,9,653,1364,2017,2347
0132-000,2013,5,6,10,561,911,1472,2017
0132-000,2013,5,6,11,672,827,1499,1472
0132-000,2013,5,6,12,649,824,1473,1499
0132-000,2013,5,6,13,475,793,1268,1473
0132-000,2013,5,6,14,749,873,1622,1268
0132-000,2013,5,6,15,630,835,1465,1622
0132-000,2013,5,6,16,823,838,1661,1465
0132-000,2013,5,6,17,837,772,1609,1661
0132-000,2013,5,6,18,1088,856,1944,1609
0132-000,2013,5,6,19,1283,1011,2294,1944
0132-000,2013,5,6,20,769,696,1465,2294
0132-000,2013,5,6,21,671,556,1227,1465
0132-000,2013,5,6,22,674,465,1139,1227
0132-000,2013,5,6,23,332,300,632,1139
0132-000,2013,5,6,24,182,207,389,632
0132-000,2013,5,7,1,128,143,271,389
0132-000,2013,5,7,2,119,103,222,271
0132-000,2013,5,7,3,46,81,127,222
0132-000,2013,5,7,4,78,91,169,127
0132-000,2013,5,7,5,87,119,206,169
0132-000,2013,5,7,6,289,228,517,206
0132-000,2013,5,7,7,504,494,998,517
0132-000,2013,5,7,8,755,1562,2317,998
0132-000,2013,5,7,9,883,1319,2202,2317
0132-000,2013,5,7,10,779,885,1664,2202
0132-000,2013,5,7,11,821,864,1685,1664
0132-000,2013,5,7,12,781,830,1611,1685
0132-000,2013,5,7,13,732,723,1455,1611
0132-000,2013,5,7,14,790,832,1622,1455
0132-000,2013,5,7,15,815,821,1636,1622
0132-000,2013,5,7,16,1001,845,1846,1636
0132-000,2013,5,7,17,1017,858,1875,1846
0132-000,2013,5,7,18,995,831,1826,1875
0132-000,2013,5,7,19,1185,862,2047,1826
0132-000,2013,5,7,20,969,762,1731,2047
0132-000,2013,5,7,21,855,589,1444,1731
0132-000,2013,5,7,22,728,525,1253,1444
0132-000,2013,5,7,23,453,347,800,1253
0132-000,2013,5,7,24,226,226,452,800
0132-000,2013,5,8,1,161,168,329,452
0132-000,2013,5,8,2,86,109,195,329
0132-000,2013,5,8,3,69,89,158,195
0132-000,2013,5,8,4,106,125,231,158
0132-000,2013,5,8,5,85,109,194,231
0132-000,2013,5,8,6,233,197,430,194
0132-000,2013,5,8,7,439,489,928,430
0132-000,2013,5,8,8,769,1485,2254,928
0132-000,2013,5,8,9,879,1385,2264,2254
0132-000,2013,5,8,10,833,946,1779,2264
0132-000,2013,5,8,11,777,848,1625,1779
0132-000,2013,5,8,12,857,886,1743,1625
0132-000,2013,5,8,13,783,784,1567,1743
0132-000,2013,5,8,14,836,847,1683,1567
0132-000,2013,5,8,15,861,846,1707,1683
0132-000,2013,5,8,16,941,882,1823,1707
0132-000,2013,5,8,17,965,771,1736,1823
0132-000,2013,5,8,18,1181,908,2089,1736
0132-000,2013,5,8,19,1450,1008,2458,2089
0132-000,2013,5,8,20,969,787,1756,2458
0132-000,2013,5,8,21,745,590,1335,1756
0132-000,2013,5,8,22,574,573,1147,1335
0132-000,2013,5,8,23,364,394,758,1147
0132-000,2013,5,8,24,236,222,458,758
0132-000,2013,5,9,1,123,149,272,458
0132-000,2013,5,9,2,130,118,248,272
0132-000,2013,5,9,3,70,105,175,248
0132-000,2013,5,9,4,52,83,135,175
0132-000,2013,5,9,5,102,109,211,135
0132-000,2013,5,9,6,220,177,397,211
0132-000,2013,5,9,7,443,473,916,397
0132-000,2013,5,9,8,624,1511,2135,916
0132-000,2013,5,9,9,815,1333,2148,2135
0132-000,2013,5,9,10,648,875,1523,2148
0132-000,2013,5,9,11,710,857,1567,1523
0132-000,2013,5,9,12,785,761,1546,1567
0132-000,2013,5,9,13,1078,784,1862,1546
0132-000,2013,5,9,14,1355,839,2194,1862
0132-000,2013,5,9,15,984,816,1800,2194
0132-000,2013,5,9,16,954,818,1772,1800
0132-000,2013,5,9,17,935,757,1692,1772
0132-000,2013,5,9,18,971,791,1762,1692
0132-000,2013,5,9,19,1155,809,1964,1762
0132-000,2013,5,9,20,917,640,1557,1964
0132-000,2013,5,9,21,712,504,1216,1557
0132-000,2013,5,9,22,510,456,966,1216
0132-000,2013,5,9,23,389,311,700,966
0132-000,2013,5,9,24,238,224,462,700
0132-000,2013,5,10,1,184,154,338,462
0132-000,2013,5,10,2,109,132,241,338
0132-000,2013,5,10,3,67,87,154,241
0132-000,2013,5,10,4,59,67,126,154
0132-000,2013,5,10,5,73,102,175,126
0132-000,2013,5,10,6,152,106,258,175
0132-000,2013,5,10,7,329,354,683,258
0132-000,2013,5,10,8,738,1358,2096,683
0132-000,2013,5,10,9,866,1274,2140,2096
0132-000,2013,5,10,10,754,828,1582,2140
0132-000,2013,5,10,11,735,854,1589,1582
0132-000,2013,5,10,12,816,809,1625,1589
0132-000,2013,5,10,13,758,734,1492,1625
0132-000,2013,5,10,14,937,922,1859,1492
0132-000,2013,5,10,15,900,929,1829,1859
0132-000,2013,5,10,16,938,832,1770,1829
0132-000,2013,5,10,17,986,805,1791,1770
0132-000,2013,5,10,18,1236,856,2092,1791
0132-000,2013,5,10,19,1325,828,2153,2092
0132-000,2013,5,10,20,1033,757,1790,2153
0132-000,2013,5,10,21,731,577,1308,1790
0132-000,2013,5,10,22,665,536,1201,1308
0132-000,2013,5,10,23,492,395,887,1201
0132-000,2013,5,10,24,264,275,539,887
0132-000,2013,5,11,1,199,206,405,539
0132-000,2013,5,11,2,144,169,313,405
0132-000,2013,5,11,3,97,137,234,313
0132-000,2013,5,11,4,91,121,212,234
0132-000,2013,5,11,5,103,124,227,212
0132-000,2013,5,11,6,256,175,431,227
0132-000,2013,5,11,7,405,384,789,431
0132-000,2013,5,11,8,495,755,1250,789
0132-000,2013,5,11,9,795,1104,1899,1250
0132-000,2013,5,11,10,1246,1389,2635,1899
0132-000,2013,5,11,11,1277,1684,2961,2635
0132-000,2013,5,11,12,1517,1753,3270,2961
0132-000,2013,5,11,13,1617,1815,3432,3270
0132-000,2013,5,11,14,1379,1553,2932,3432
0132-000,2013,5,11,15,1374,1472,2846,2932
0132-000,2013,5,11,16,1501,1346,2847,2846
0132-000,2013,5,11,17,1827,1328,3155,2847
0132-000,2013,5,11,18,2063,1443,3506,3155
0132-000,2013,5,11,19,1745,1295,3040,3506
0132-000,2013,5,11,20,1017,877,1894,3040
0132-000,2013,5,11,21,578,601,1179,1894
0132-000,2013,5,11,22,478,528,1006,1179
0132-000,2013,5,11,23,350,379,729,1006
0132-000,2013,5,11,24,189,254,443,729
0132-000,2013,5,12,1,189,217,406,443
0132-000,2013,5,12,2,80,124,204,406
0132-000,2013,5,12,3,99,119,218,204
0132-000,2013,5,12,4,69,80,149,218
0132-000,2013,5,12,5,108,101,209,149
0132-000,2013,5,12,6,155,143,298,209
0132-000,2013,5,12,7,189,220,409,298
0132-000,2013,5,12,8,325,363,688,409
0132-000,2013,5,12,9,393,525,918,688
0132-000,2013,5,12,10,512,608,1120,918
0132-000,2013,5,12,11,562,727,1289,1120
0132-000,2013,5,12,12,659,673,1332,1289
0132-000,2013,5,12,13,571,690,1261,1332
0132-000,2013,5,12,14,678,685,1363,1261
0132-000,2013,5,12,15,880,668,1548,1363
0132-000,2013,5,12,16,834,647,1481,1548
0132-000,2013,5,12,17,1108,672,1780,1481
0132-000,2013,5,12,18,1463,806,2269,1780
0132-000,2013,5,12,19,866,618,1484,2269
0132-000,2013,5,12,20,795,563,1358,1484
0132-000,2013,5,12,21,588,541,1129,1358
0132-000,2013,5,12,22,496,466,962,1129
0132-000,2013,5,12,23,296,366,662,962
0132-000,2013,5,12,24,178,220,398,662
0132-000,2013,5,13,1,132,156,288,398
0132-000,2013,5,13,2,72,87,159,288
0132-000,2013,5,13,3,46,73,119,159
0132-000,2013,5,13,4,45,68,113,119
0132-000,2013,5,13,5,81,105,186,113
0132-000,2013,5,13,6,168,192,360,186
0132-000,2013,5,13,7,446,604,1050,360
0132-000,2013,5,13,8,721,1442,2163,1050
0132-000,2013,5,13,9,600,1029,1629,2163
0132-000,2013,5,13,10,775,896,1671,1629
0132-000,2013,5,13,11,709,831,1540,1671
0132-000,2013,5,13,12,807,832,1639,1540
0132-000,2013,5,13,13,750,792,1542,1639
0132-000,2013,5,13,14,749,847,1596,1542
0132-000,2013,5,13,15,858,853,1711,1596
0132-000,2013,5,13,16,869,793,1662,1711
0132-000,2013,5,13,17,980,794,1774,1662
0132-000,2013,5,13,18,1058,838,1896,1774
0132-000,2013,5,13,19,1113,805,1918,1896
0132-000,2013,5,13,20,914,714,1628,1918
0132-000,2013,5,13,21,750,577,1327,1628
0132-000,2013,5,13,22,593,482,1075,1327
0132-000,2013,5,13,23,399,358,757,1075
0132-000,2013,5,13,24,202,219,421,757
0132-000,2013,5,14,1,171,165,336,421
0132-000,2013,5,14,2,123,140,263,336
0132-000,2013,5,14,3,50,74,124,263
0132-000,2013,5,14,4,62,96,158,124
0132-000,2013,5,14,5,65,106,171,158
0132-000,2013,5,14,6,240,178,418,171
0132-000,2013,5,14,7,468,462,930,418
0132-000,2013,5,14,8,870,1565,2435,930
0132-000,2013,5,14,9,913,1318,2231,2435
0132-000,2013,5,14,10,711,872,1583,2231
0132-000,2013,5,14,11,830,916,1746,1583
0132-000,2013,5,14,12,806,778,1584,1746
0132-000,2013,5,14,13,700,730,1430,1584
0132-000,2013,5,14,14,731,827,1558,1430
0132-000,2013,5,14,15,860,891,1751,1558
0132-000,2013,5,14,16,969,844,1813,1751
0132-000,2013,5,14,17,1030,846,1876,1813
0132-000,2013,5,14,18,1009,817,1826,1876
0132-000,2013,5,14,19,1242,884,2126,1826
0132-000,2013,5,14,20,818,658,1476,2126
0132-000,2013,5,14,21,842,583,1425,1476
0132-000,2013,5,14,22,550,466,1016,1425
0132-000,2013,5,14,23,387,360,747,1016
0132-000,2013,5,14,24,233,240,473,747
0132-000,2013,5,15,1,186,174,360,473
0132-000,2013,5,15,2,113,118,231,360
0132-000,2013,5,15,3,105,109,214,231
0132-000,2013,5,15,4,62,92,154,214
0132-000,2013,5,15,5,96,119,215,154
0132-000,2013,5,15,6,263,175,438,215
0132-000,2013,5,15,7,486,458,944,438
0132-000,2013,5,15,8,659,1209,1868,944
0132-000,2013,5,15,9,514,735,1249,1868
0132-000,2013,5,15,10,613,651,1264,1249
0132-000,2013,5,15,11,873,872,1745,1264
0132-000,2013,5,15,12,865,879,1744,1745
0132-000,2013,5,15,13,715,788,1503,1744
0132-000,2013,5,15,14,847,895,1742,1503
0132-000,2013,5,15,15,782,812,1594,1742
0132-000,2013,5,15,16,857,803,1660,1594
0132-000,2013,5,15,17,827,676,1503,1660
0132-000,2013,5,15,18,1103,865,1968,1503
0132-000,2013,5,15,19,1199,864,2063,1968
0132-000,2013,5,15,20,975,746,1721,2063
0132-000,2013,5,15,21,728,593,1321,1721
0132-000,2013,5,15,22,637,568,1205,1321
0132-000,2013,5,15,23,376,363,739,1205
0132-000,2013,5,15,24,264,270,534,739
0132-000,2013,5,16,1,174,195,369,534
0132-000,2013,5,16,2,148,141,289,369
0132-000,2013,5,16,3,82,109,191,289
0132-000,2013,5,16,4,86,119,205,191
0132-000,2013,5,16,5,85,117,202,205
0132-000,2013,5,16,6,301,210,511,202
0132-000,2013,5,16,7,466,455,921,511
0132-000,2013,5,16,8,696,1384,2080,921
0132-000,2013,5,16,9,837,1313,2150,2080
0132-000,2013,5,16,10,723,883,1606,2150
0132-000,2013,5,16,11,797,875,1672,1606
0132-000,2013,5,16,12,826,852,1678,1672
0132-000,2013,5,16,13,719,799,1518,1678
0132-000,2013,5,16,14,840,831,1671,1518
0132-000,2013,5,16,15,976,903,1879,1671
0132-000,2013,5,16,16,1029,879,1908,1879
0132-000,2013,5,16,17,1152,910,2062,1908
0132-000,2013,5,16,18,1443,1033,2476,2062
0132-000,2013,5,16,19,2053,1257,3310,2476
0132-000,2013,5,16,20,1646,1379,3025,3310
0132-000,2013,5,16,21,1472,1149,2621,3025
0132-000,2013,5,16,22,1479,1084,2563,2621
0132-000,2013,5,16,23,1523,1285,2808,2563
0132-000,2013,5,16,24,1269,1350,2619,2808
0132-000,2013,5,17,1,684,836,1520,2619
0132-000,2013,5,17,2,358,272,630,1520
0132-000,2013,5,17,3,183,148,331,630
0132-000,2013,5,17,4,197,152,349,331
0132-000,2013,5,17,5,168,151,319,349
0132-000,2013,5,17,6,297,214,511,319
0132-000,2013,5,17,7,546,482,1028,511
0132-000,2013,5,17,8,885,1158,2043,1028
0132-000,2013,5,17,9,1132,1771,2903,2043
0132-000,2013,5,17,10,895,1726,2621,2903
0132-000,2013,5,17,11,983,1557,2540,2621
0132-000,2013,5,17,12,985,1857,2842,2540
0132-000,2013,5,17,13,677,1799,2476,2842
0132-000,2013,5,17,14,621,1758,2379,2476
0132-000,2013,5,17,15,618,1761,2379,2379
0132-000,2013,5,17,16,603,1646,2249,2379
0132-000,2013,5,17,17,655,1684,2339,2249
0132-000,2013,5,17,18,551,1250,1801,2339
0132-000,2013,5,17,19,295,727,1022,1801
0132-000,2013,5,17,20,241,713,954,1022
0132-000,2013,5,17,21,152,523,675,954
0132-000,2013,5,17,22,180,493,673,675
0132-000,2013,5,17,23,164,346,510,673
0132-000,2013,5,17,24,124,237,361,510
0132-000,2013,5,18,1,244,195,439,361
0132-000,2013,5,18,2,138,123,261,439
0132-000,2013,5,18,3,95,102,197,261
0132-000,2013,5,18,4,134,99,233,197
0132-000,2013,5,18,5,101,98,199,233
0132-000,2013,5,18,6,173,164,337,199
0132-000,2013,5,18,7,363,325,688,337
0132-000,2013,5,18,8,675,702,1377,688
0132-000,2013,5,18,9,664,768,1432,1377
0132-000,2013,5,18,10,631,813,1444,1432
0132-000,2013,5,18,11,663,855,1518,1444
0132-000,2013,5,18,12,615,823,1438,1518
0132-000,2013,5,18,13,641,780,1421,1438
0132-000,2013,5,18,14,592,744,1336,1421
0132-000,2013,5,18,15,646,730,1376,1336
0132-000,2013,5,18,16,700,737,1437,1376
0132-000,2013,5,18,17,985,749,1734,1437
0132-000,2013,5,18,18,1343,866,2209,1734
0132-000,2013,5,18,19,1413,725,2138,2209
0132-000,2013,5,18,20,1289,553,1842,2138
0132-000,2013,5,18,21,1031,471,1502,1842
0132-000,2013,5,18,22,879,415,1294,1502
0132-000,2013,5,18,23,478,300,778,1294
0132-000,2013,5,18,24,346,216,562,778
0132-000,2013,5,19,1,286,172,458,562
0132-000,2013,5,19,2,153,132,285,458
0132-000,2013,5,19,3,84,86,170,285
0132-000,2013,5,19,4,56,69,125,170
0132-000,2013,5,19,5,61,65,126,125
0132-000,2013,5,19,6,95,97,192,126
0132-000,2013,5,19,7,156,156,312,192
0132-000,2013,5,19,8,167,241,408,312
0132-000,2013,5,19,9,287,378,665,408
0132-000,2013,5,19,10,385,434,819,665
0132-000,2013,5,19,11,619,561,1180,819
0132-000,2013,5,19,12,931,612,1543,1180
0132-000,2013,5,19,13,1157,600,1757,1543
0132-000,2013,5,19,14,1364,645,2009,1757
0132-000,2013,5,19,15,1561,654,2215,2009
0132-000,2013,5,19,16,1915,696,2611,2215
0132-000,2013,5,19,17,1551,666,2217,2611
0132-000,2013,5,19,18,1468,612,2080,2217
0132-000,2013,5,19,19,1245,570,1815,2080
0132-000,2013,5,19,20,950,524,1474,1815
0132-000,2013,5,19,21,658,487,1145,1474
0132-000,2013,5,19,22,548,413,961,1145
0132-000,2013,5,19,23,294,280,574,961
0132-000,2013,5,19,24,199,204,403,574
0132-000,2013,5,20,1,119,140,259,403
0132-000,2013,5,20,2,61,74,135,259
0132-000,2013,5,20,3,35,55,90,135
0132-000,2013,5,20,4,56,84,140,90
0132-000,2013,5,20,5,73,95,168,140
0132-000,2013,5,20,6,186,213,399,168
0132-000,2013,5,20,7,421,569,990,399
0132-000,2013,5,20,8,873,1747,2620,990
0132-000,2013,5,20,9,755,1294,2049,2620
0132-000,2013,5,20,10,711,821,1532,2049
0132-000,2013,5,20,11,744,872,1616,1532
0132-000,2013,5,20,12,784,809,1593,1616
0132-000,2013,5,20,13,698,738,1436,1593
0132-000,2013,5,20,14,730,825,1555,1436
0132-000,2013,5,20,15,867,861,1728,1555
0132-000,2013,5,20,16,889,811,1700,1728
0132-000,2013,5,20,17,1049,850,1899,1700
0132-000,2013,5,20,18,1014,803,1817,1899
0132-000,2013,5,20,19,1180,853,2033,1817
0132-000,2013,5,20,20,876,684,1560,2033
0132-000,2013,5,20,21,693,534,1227,1560
0132-000,2013,5,20,22,621,505,1126,1227
0132-000,2013,5,20,23,364,327,691,1126
0132-000,2013,5,20,24,218,236,454,691
0132-000,2013,5,21,1,154,148,302,454
0132-000,2013,5,21,2,99,113,212,302
0132-000,2013,5,21,3,54,82,136,212
0132-000,2013,5,21,4,65,100,165,136
0132-000,2013,5,21,5,60,98,158,165
0132-000,2013,5,21,6,240,178,418,158
0132-000,2013,5,21,7,510,503,1013,418
0132-000,2013,5,21,8,805,1448,2253,1013
0132-000,2013,5,21,9,919,1326,2245,2253
0132-000,2013,5,21,10,737,904,1641,2245
0132-000,2013,5,21,11,730,805,1535,1641
0132-000,2013,5,21,12,911,880,1791,1535
0132-000,2013,5,21,13,743,775,1518,1791
0132-000,2013,5,21,14,761,861,1622,1518
0132-000,2013,5,21,15,803,831,1634,1622
0132-000,2013,5,21,16,900,784,1684,1634
0132-000,2013,5,21,17,945,776,1721,1684
0132-000,2013,5,21,18,1015,822,1837,1721
0132-000,2013,5,21,19,919,654,1573,1837
0132-000,2013,5,21,20,841,676,1517,1573
0132-000,2013,5,21,21,603,418,1021,1517
0132-000,2013,5,21,22,436,369,805,1021
0132-000,2013,5,21,23,237,220,457,805
0132-000,2013,5,21,24,158,162,320,457
0132-000,2013,5,22,1,93,87,180,320
0132-000,2013,5,22,2,41,42,83,180
0132-000,2013,5,22,3,70,72,142,83
0132-000,2013,5,22,4,62,91,153,142
0132-000,2013,5,22,5,88,110,198,153
0132-000,2013,5,22,6,264,176,440,198
0132-000,2013,5,22,7,442,416,858,440
0132-000,2013,5,22,8,740,1356,2096,858
0132-000,2013,5,22,9,820,1173,1993,2096
0132-000,2013,5,22,10,776,824,1600,1993
0132-000,2013,5,22,11,850,849,1699,1600
0132-000,2013,5,22,12,617,627,1244,1699
0132-000,2013,5,22,13,646,712,1358,1244
0132-000,2013,5,22,14,782,826,1608,1358
0132-000,2013,5,22,15,770,800,1570,1608
0132-000,2013,5,22,16,893,837,1730,1570
0132-000,2013,5,22,17,1002,820,1822,1730
0132-000,2013,5,22,18,1112,872,1984,1822
0132-000,2013,5,22,19,1117,805,1922,1984
0132-000,2013,5,22,20,921,704,1625,1922
0132-000,2013,5,22,21,697,568,1265,1625
0132-000,2013,5,22,22,556,495,1051,1265
0132-000,2013,5,22,23,348,335,683,1051
0132-000,2013,5,22,24,211,215,426,683
0132-000,2013,5,23,1,168,188,356,426
0132-000,2013,5,23,2,131,124,255,356
0132-000,2013,5,23,3,87,117,204,255
0132-000,2013,5,23,4,61,86,147,204
0132-000,2013,5,23,5,82,113,195,147
0132-000,2013,5,23,6,264,184,448,195
0132-000,2013,5,23,7,496,485,981,448
0132-000,2013,5,23,8,778,1547,2325,981
0132-000,2013,5,23,9,842,1322,2164,2325
0132-000,2013,5,23,10,702,858,1560,2164
0132-000,2013,5,23,11,773,848,1621,1560
0132-000,2013,5,23,12,771,795,1566,1621
0132-000,2013,5,23,13,706,785,1491,1566
0132-000,2013,5,23,14,813,804,1617,1491
0132-000,2013,5,23,15,865,800,1665,1617
0132-000,2013,5,23,16,907,774,1681,1665
0132-000,2013,5,23,17,980,774,1754,1681
0132-000,2013,5,23,18,1165,834,1999,1754
0132-000,2013,5,23,19,1322,809,2131,1999
0132-000,2013,5,23,20,845,707,1552,2131
0132-000,2013,5,23,21,745,582,1327,1552
0132-000,2013,5,23,22,688,504,1192,1327
0132-000,2013,5,23,23,420,354,774,1192
0132-000,2013,5,23,24,248,264,512,774
0132-000,2013,5,24,1,194,190,384,512
0132-000,2013,5,24,2,144,140,284,384
0132-000,2013,5,24,3,77,95,172,284
0132-000,2013,5,24,4,99,101,200,172
0132-000,2013,5,24,5,91,125,216,200
0132-000,2013,5,24,6,192,187,379,216
0132-000,2013,5,24,7,381,454,835,379
0132-000,2013,5,24,8,634,1481,2115,835
0132-000,2013,5,24,9,821,1313,2134,2115
0132-000,2013,5,24,10,690,884,1574,2134
0132-000,2013,5,24,11,810,900,1710,1574
0132-000,2013,5,24,12,749,827,1576,1710
0132-000,2013,5,24,13,568,763,1331,1576
0132-000,2013,5,24,14,626,816,1442,1331
0132-000,2013,5,24,15,724,877,1601,1442
0132-000,2013,5,24,16,728,819,1547,1601
0132-000,2013,5,24,17,814,840,1654,1547
0132-000,2013,5,24,18,1003,927,1930,1654
0132-000,2013,5,24,19,873,927,1800,1930
0132-000,2013,5,24,20,671,795,1466,1800
0132-000,2013,5,24,21,542,659,1201,1466
0132-000,2013,5,24,22,426,575,1001,1201
0132-000,2013,5,24,23,254,414,668,1001
0132-000,2013,5,24,24,185,333,518,668
0132-000,2013,5,25,1,189,198,387,518
0132-000,2013,5,25,2,161,164,325,387
0132-000,2013,5,25,3,99,133,232,325
0132-000,2013,5,25,4,105,115,220,232
0132-000,2013,5,25,5,102,137,239,220
0132-000,2013,5,25,6,183,174,357,239
0132-000,2013,5,25,7,412,415,827,357
0132-000,2013,5,25,8,451,811,1262,827
0132-000,2013,5,25,9,750,997,1747,1262
0132-000,2013,5,25,10,841,1184,2025,1747
0132-000,2013,5,25,11,790,1384,2174,2025
0132-000,2013,5,25,12,922,1513,2435,2174
0132-000,2013,5,25,13,940,1481,2421,2435
0132-000,2013,5,25,14,965,1345,2310,2421
0132-000,2013,5,25,15,803,1005,1808,2310
0132-000,2013,5,25,16,962,902,1864,1808
0132-000,2013,5,25,17,1043,897,1940,1864
0132-000,2013,5,25,18,1172,973,2145,1940
0132-000,2013,5,25,19,1084,958,2042,2145
0132-000,2013,5,25,20,813,767,1580,2042
0132-000,2013,5,25,21,574,572,1146,1580
0132-000,2013,5,25,22,465,452,917,1146
0132-000,2013,5,25,23,320,410,730,917
0132-000,2013,5,25,24,214,264,478,730
0132-000,2013,5,26,1,147,195,342,478
0132-000,2013,5,26,2,141,142,283,342
0132-000,2013,5,26,3,123,137,260,283
0132-000,2013,5,26,4,71,92,163,260
0132-000,2013,5,26,5,99,93,192,163
0132-000,2013,5,26,6,137,147,284,192
0132-000,2013,5,26,7,281,278,559,284
0132-000,2013,5,26,8,305,446,751,559
0132-000,2013,5,26,9,405,546,951,751
0132-000,2013,5,26,10,467,597,1064,951
0132-000,2013,5,26,11,523,655,1178,1064
0132-000,2013,5,26,12,464,586,1050,1178
0132-000,2013,5,26,13,656,624,1280,1050
0132-000,2013,5,26,14,691,571,1262,1280
0132-000,2013,5,26,15,668,616,1284,1262
0132-000,2013,5,26,16,768,607,1375,1284
0132-000,2013,5,26,17,868,636,1504,1375
0132-000,2013,5,26,18,959,709,1668,1504
0132-000,2013,5,26,19,685,590,1275,1668
0132-000,2013,5,26,20,652,514,1166,1275
0132-000,2013,5,26,21,568,502,1070,1166
0132-000,2013,5,26,22,466,464,930,1070
0132-000,2013,5,26,23,272,308,580,930
0132-000,2013,5,26,24,180,216,396,580
0132-000,2013,5,27,1,154,182,336,396
0132-000,2013,5,27,2,69,83,152,336
0132-000,2013,5,27,3,50,80,130,152
0132-000,2013,5,27,4,55,82,137,130
0132-000,2013,5,27,5,84,110,194,137
0132-000,2013,5,27,6,183,209,392,194
0132-000,2013,5,27,7,423,572,995,392
0132-000,2013,5,27,8,855,1711,2566,995
0132-000,2013,5,27,9,760,1303,2063,2566
0132-000,2013,5,27,10,703,812,1515,2063
0132-000,2013,5,27,11,686,803,1489,1515
0132-000,2013,5,27,12,719,742,1461,1489
0132-000,2013,5,27,13,647,683,1330,1461
0132-000,2013,5,27,14,678,767,1445,1330
0132-000,2013,5,27,15,793,788,1581,1445
0132-000,2013,5,27,16,794,724,1518,1581
0132-000,2013,5,27,17,932,755,1687,1518
0132-000,2013,5,27,18,963,763,1726,1687
0132-000,2013,5,27,19,1058,765,1823,1726
0132-000,2013,5,27,20,733,572,1305,1823
0132-000,2013,5,27,21,592,456,1048,1305
0132-000,2013,5,27,22,497,404,901,1048
0132-000,2013,5,27,23,352,317,669,901
0132-000,2013,5,27,24,184,199,383,669
0132-000,2013,5,28,1,151,160,311,383
0132-000,2013,5,28,2,87,91,178,311
0132-000,2013,5,28,3,51,67,118,178
0132-000,2013,5,28,4,58,82,140,118
0132-000,2013,5,28,5,92,88,180,140
0132-000,2013,5,28,6,132,140,272,180
0132-000,2013,5,28,7,337,404,741,272
0132-000,2013,5,28,8,601,1402,2003,741
0132-000,2013,5,28,9,730,1246,1976,2003
0132-000,2013,5,28,10,700,855,1555,1976
0132-000,2013,5,28,11,772,838,1610,1555
0132-000,2013,5,28,12,694,728,1422,1610
0132-000,2013,5,28,13,797,762,1559,1422
0132-000,2013,5,28,14,775,781,1556,1559
0132-000,2013,5,28,15,790,776,1566,1556
0132-000,2013,5,28,16,895,765,1660,1566
0132-000,2013,5,28,17,824,777,1601,1660
0132-000,2013,5,28,18,1087,748,1835,1601
0132-000,2013,5,28,19,1065,809,1874,1835
0132-000,2013,5,28,20,852,640,1492,1874
0132-000,2013,5,28,21,705,479,1184,1492
0132-000,2013,5,28,22,530,424,954,1184
0132-000,2013,5,28,23,376,291,667,954
0132-000,2013,5,28,24,261,217,478,667
0132-000,2013,5,29,1,142,160,302,478
0132-000,2013,5,29,2,136,126,262,302
0132-000,2013,5,29,3,62,93,155,262
0132-000,2013,5,29,4,73,92,165,155
0132-000,2013,5,29,5,97,108,205,165
0132-000,2013,5,29,6,196,182,378,205
0132-000,2013,5,29,7,421,432,853,378
0132-000,2013,5,29,8,706,1453,2159,853
0132-000,2013,5,29,9,760,1234,1994,2159
0132-000,2013,5,29,10,698,864,1562,1994
0132-000,2013,5,29,11,877,887,1764,1562
0132-000,2013,5,29,12,836,747,1583,1764
0132-000,2013,5,29,13,840,746,1586,1583
0132-000,2013,5,29,14,715,759,1474,1586
0132-000,2013,5,29,15,758,836,1594,1474
0132-000,2013,5,29,16,838,773,1611,1594
0132-000,2013,5,29,17,894,748,1642,1611
0132-000,2013,5,29,18,1021,815,1836,1642
0132-000,2013,5,29,19,1086,830,1916,1836
0132-000,2013,5,29,20,861,646,1507,1916
0132-000,2013,5,29,21,748,506,1254,1507
0132-000,2013,5,29,22,590,432,1022,1254
0132-000,2013,5,29,23,388,327,715,1022
0132-000,2013,5,29,24,226,224,450,715
0132-000,2013,5,30,1,195,199,394,450
0132-000,2013,5,30,2,138,122,260,394
0132-000,2013,5,30,3,101,99,200,260
0132-000,2013,5,30,4,61,94,155,200
0132-000,2013,5,30,5,99,119,218,155
0132-000,2013,5,30,6,197,194,391,218
0132-000,2013,5,30,7,391,434,825,391
0132-000,2013,5,30,8,631,1337,1968,825
0132-000,2013,5,30,9,729,1233,1962,1968
0132-000,2013,5,30,10,854,898,1752,1962
0132-000,2013,5,30,11,816,857,1673,1752
0132-000,2013,5,30,12,754,807,1561,1673
0132-000,2013,5,30,13,768,818,1586,1561
0132-000,2013,5,30,14,787,847,1634,1586
0132-000,2013,5,30,15,790,823,1613,1634
0132-000,2013,5,30,16,804,750,1554,1613
0132-000,2013,5,30,17,854,761,1615,1554
0132-000,2013,5,30,18,801,702,1503,1615
0132-000,2013,5,30,19,916,782,1698,1503
0132-000,2013,5,30,20,828,650,1478,1698
0132-000,2013,5,30,21,759,513,1272,1478
0132-000,2013,5,30,22,632,480,1112,1272
0132-000,2013,5,30,23,567,369,936,1112
0132-000,2013,5,30,24,324,250,574,936
0132-000,2013,5,31,1,197,182,379,574
0132-000,2013,5,31,2,86,106,192,379
0132-000,2013,5,31,3,85,108,193,192
0132-000,2013,5,31,4,97,105,202,193
0132-000,2013,5,31,5,94,104,198,202
0132-000,2013,5,31,6,269,203,472,198
0132-000,2013,5,31,7,406,450,856,472
0132-000,2013,5,31,8,728,1434,2162,856
0132-000,2013,5,31,9,854,1242,2096,2162
0132-000,2013,5,31,10,665,810,1475,2096
0132-000,2013,5,31,11,794,899,1693,1475
0132-000,2013,5,31,12,808,873,1681,1693
0132-000,2013,5,31,13,795,840,1635,1681
0132-000,2013,5,31,14,883,833,1716,1635
0132-000,2013,5,31,15,869,821,1690,1716
0132-000,2013,5,31,16,897,736,1633,1690
0132-000,2013,5,31,17,962,830,1792,1633
0132-000,2013,5,31,18,1397,948,2345,1792
0132-000,2013,5,31,19,1332,838,2170,2345
0132-000,2013,5,31,20,1013,738,1751,2170
0132-000,2013,5,31,21,906,658,1564,1751
0132-000,2013,5,31,22,719,564,1283,1564
0132-000,2013,5,31,23,390,373,763,1283
0132-000,2013,5,31,24,294,289,583,763
0132-000,2013,6,1,1,220,217,437,583
0132-000,2013,6,1,2,132,151,283,437
0132-000,2013,6,1,3,106,135,241,283
0132-000,2013,6,1,4,69,80,149,241
0132-000,2013,6,1,5,92,115,207,149
0132-000,2013,6,1,6,212,191,403,207
0132-000,2013,6,1,7,412,393,805,403
0132-000,2013,6,1,8,498,761,1259,805
0132-000,2013,6,1,9,662,889,1551,1259
0132-000,2013,6,1,10,884,1045,1929,1551
0132-000,2013,6,1,11,1044,1296,2340,1929
0132-000,2013,6,1,12,961,1348,2309,2340
0132-000,2013,6,1,13,1009,1353,2362,2309
0132-000,2013,6,1,14,880,1050,1930,2362
0132-000,2013,6,1,15,739,848,1587,1930
0132-000,2013,6,1,16,790,797,1587,1587
0132-000,2013,6,1,17,989,888,1877,1587
0132-000,2013,6,1,18,1394,956,2350,1877
0132-000,2013,6,1,19,1279,1012,2291,2350
0132-000,2013,6,1,20,890,703,1593,2291
0132-000,2013,6,1,21,551,528,1079,1593
0132-000,2013,6,1,22,518,487,1005,1079
0132-000,2013,6,1,23,355,351,706,1005
0132-000,2013,6,1,24,231,241,472,706
0132-000,2013,6,2,1,214,227,441,472
0132-000,2013,6,2,2,134,145,279,441
0132-000,2013,6,2,3,91,107,198,279
0132-000,2013,6,2,4,89,96,185,198
0132-000,2013,6,2,5,105,109,214,185
0132-000,2013,6,2,6,138,143,281,214
0132-000,2013,6,2,7,247,270,517,281
0132-000,2013,6,2,8,308,404,712,517
0132-000,2013,6,2,9,414,516,930,712
0132-000,2013,6,2,10,544,594,1138,930
0132-000,2013,6,2,11,543,595,1138,1138
0132-000,2013,6,2,12,638,645,1283,1138
0132-000,2013,6,2,13,796,674,1470,1283
0132-000,2013,6,2,14,690,642,1332,1470
0132-000,2013,6,2,15,702,603,1305,1332
0132-000,2013,6,2,16,1057,651,1708,1305
0132-000,2013,6,2,17,1128,641,1769,1708
0132-000,2013,6,2,18,1229,653,1882,1769
0132-000,2013,6,2,19,1323,639,1962,1882
0132-000,2013,6,2,20,716,522,1238,1962
0132-000,2013,6,2,21,597,509,1106,1238
0132-000,2013,6,2,22,406,442,848,1106
0132-000,2013,6,2,23,258,289,547,848
0132-000,2013,6,2,24,159,196,355,547
0132-000,2013,6,3,1,143,147,290,355
0132-000,2013,6,3,2,66,85,151,290
0132-000,2013,6,3,3,46,68,114,151
0132-000,2013,6,3,4,57,77,134,114
0132-000,2013,6,3,5,92,104,196,134
0132-000,2013,6,3,6,197,218,415,196
0132-000,2013,6,3,7,472,564,1036,415
0132-000,2013,6,3,8,681,1601,2282,1036
0132-000,2013,6,3,9,706,1256,1962,2282
0132-000,2013,6,3,10,679,836,1515,1962
0132-000,2013,6,3,11,801,883,1684,1515
0132-000,2013,6,3,12,768,766,1534,1684
0132-000,2013,6,3,13,726,803,1529,1534
0132-000,2013,6,3,14,977,867,1844,1529
0132-000,2013,6,3,15,769,855,1624,1844
0132-000,2013,6,3,16,864,761,1625,1624
0132-000,2013,6,3,17,967,808,1775,1625
0132-000,2013,6,3,18,972,768,1740,1775
0132-000,2013,6,3,19,1055,841,1896,1740
0132-000,2013,6,3,20,893,689,1582,1896
0132-000,2013,6,3,21,717,538,1255,1582
0132-000,2013,6,3,22,603,472,1075,1255
0132-000,2013,6,3,23,367,302,669,1075
0132-000,2013,6,3,24,221,214,435,669
0132-000,2013,6,4,1,167,157,324,435
0132-000,2013,6,4,2,76,99,175,324
0132-000,2013,6,4,3,75,92,167,175
0132-000,2013,6,4,4,92,89,181,167
0132-000,2013,6,4,5,64,100,164,181
0132-000,2013,6,4,6,263,212,475,164
0132-000,2013,6,4,7,342,436,778,475
0132-000,2013,6,4,8,741,1333,2074,778
0132-000,2013,6,4,9,883,1225,2108,2074
0132-000,2013,6,4,10,833,893,1726,2108
0132-000,2013,6,4,11,812,909,1721,1726
0132-000,2013,6,4,12,939,970,1909,1721
0132-000,2013,6,4,13,872,881,1753,1909
0132-000,2013,6,4,14,785,824,1609,1753
0132-000,2013,6,4,15,855,835,1690,1609
0132-000,2013,6,4,16,871,716,1587,1690
0132-000,2013,6,4,17,851,729,1580,1587
0132-000,2013,6,4,18,1136,821,1957,1580
0132-000,2013,6,4,19,1170,819,1989,1957
0132-000,2013,6,4,20,899,615,1514,1989
0132-000,2013,6,4,21,670,522,1192,1514
0132-000,2013,6,4,22,636,468,1104,1192
0132-000,2013,6,4,23,434,359,793,1104
0132-000,2013,6,4,24,200,200,400,793
0132-000,2013,6,5,1,148,174,322,400
0132-000,2013,6,5,2,89,107,196,322
0132-000,2013,6,5,3,77,99,176,196
0132-000,2013,6,5,4,69,79,148,176
0132-000,2013,6,5,5,85,112,197,148
0132-000,2013,6,5,6,175,193,368,197
0132-000,2013,6,5,7,348,464,812,368
0132-000,2013,6,5,8,953,1373,2326,812
0132-000,2013,6,5,9,1130,1260,2390,2326
0132-000,2013,6,5,10,767,919,1686,2390
0132-000,2013,6,5,11,753,833,1586,1686
0132-000,2013,6,5,12,823,854,1677,1586
0132-000,2013,6,5,13,829,776,1605,1677
0132-000,2013,6,5,14,851,821,1672,1605
0132-000,2013,6,5,15,899,823,1722,1672
0132-000,2013,6,5,16,992,790,1782,1722
0132-000,2013,6,5,17,1032,869,1901,1782
0132-000,2013,6,5,18,1278,946,2224,1901
0132-000,2013,6,5,19,1200,937,2137,2224
0132-000,2013,6,5,20,932,731,1663,2137
0132-000,2013,6,5,21,771,684,1455,1663
0132-000,2013,6,5,22,566,554,1120,1455
0132-000,2013,6,5,23,430,422,852,1120
0132-000,2013,6,5,24,251,283,534,852
0132-000,2013,6,6,1,208,228,436,534
0132-000,2013,6,6,2,118,162,280,436
0132-000,2013,6,6,3,80,103,183,280
0132-000,2013,6,6,4,113,142,255,183
0132-000,2013,6,6,5,84,120,204,255
0132-000,2013,6,6,6,234,222,456,204
0132-000,2013,6,6,7,297,393,690,456
0132-000,2013,6,6,8,447,863,1310,690
0132-000,2013,6,6,9,587,981,1568,1310
0132-000,2013,6,6,10,982,1101,2083,1568
0132-000,2013,6,6,11,1132,1321,2453,2083
0132-000,2013,6,6,12,1470,1531,3001,2453
0132-000,2013,6,6,13,1153,1250,2403,3001
0132-000,2013,6,6,14,795,823,1618,2403
0132-000,2013,6,6,15,736,672,1408,1618
0132-000,2013,6,6,16,663,604,1267,1408
0132-000,2013,6,6,17,818,601,1419,1267
0132-000,2013,6,6,18,919,660,1579,1419
0132-000,2013,6,6,19,982,689,1671,1579
0132-000,2013,6,6,20,718,542,1260,1671
0132-000,2013,6,6,21,357,477,834,1260
0132-000,2013,6,6,22,289,434,723,834
0132-000,2013,6,6,23,200,324,524,723
0132-000,2013,6,6,24,125,237,362,524
0132-000,2013,6,7,1,162,142,304,362
0132-000,2013,6,7,2,89,106,195,304
0132-000,2013,6,7,3,72,92,164,195
0132-000,2013,6,7,4,76,86,162,164
0132-000,2013,6,7,5,106,118,224,162
0132-000,2013,6,7,6,234,169,403,224
0132-000,2013,6,7,7,460,512,972,403
0132-000,2013,6,7,8,749,1393,2142,972
0132-000,2013,6,7,9,781,1124,1905,2142
0132-000,2013,6,7,10,755,916,1671,1905
0132-000,2013,6,7,11,782,892,1674,1671
0132-000,2013,6,7,12,702,764,1466,1674
0132-000,2013,6,7,13,677,702,1379,1466
0132-000,2013,6,7,14,799,771,1570,1379
0132-000,2013,6,7,15,816,820,1636,1570
0132-000,2013,6,7,16,974,784,1758,1636
0132-000,2013,6,7,17,1002,863,1865,1758
0132-000,2013,6,7,18,1297,856,2153,1865
0132-000,2013,6,7,19,1368,888,2256,2153
0132-000,2013,6,7,20,970,723,1693,2256
0132-000,2013,6,7,21,918,645,1563,1693
0132-000,2013,6,7,22,714,577,1291,1563
0132-000,2013,6,7,23,423,388,811,1291
0132-000,2013,6,7,24,299,285,584,811
0132-000,2013,6,8,1,252,222,474,584
0132-000,2013,6,8,2,158,185,343,474
0132-000,2013,6,8,3,103,129,232,343
0132-000,2013,6,8,4,87,113,200,232
0132-000,2013,6,8,5,106,125,231,200
0132-000,2013,6,8,6,216,193,409,231
0132-000,2013,6,8,7,478,404,882,409
0132-000,2013,6,8,8,502,782,1284,882
0132-000,2013,6,8,9,718,955,1673,1284
0132-000,2013,6,8,10,912,1060,1972,1673
0132-000,2013,6,8,11,947,1127,2074,1972
0132-000,2013,6,8,12,1012,1288,2300,2074
0132-000,2013,6,8,13,1084,1359,2443,2300
0132-000,2013,6,8,14,1028,1237,2265,2443
0132-000,2013,6,8,15,792,951,1743,2265
0132-000,2013,6,8,16,865,872,1737,1743
0132-000,2013,6,8,17,1062,903,1965,1737
0132-000,2013,6,8,18,1350,921,2271,1965
0132-000,2013,6,8,19,1216,922,2138,2271
0132-000,2013,6,8,20,890,620,1510,2138
0132-000,2013,6,8,21,557,498,1055,1510
0132-000,2013,6,8,22,507,462,969,1055
0132-000,2013,6,8,23,337,347,684,969
0132-000,2013,6,8,24,292,321,613,684
0132-000,2013,6,9,1,178,202,380,613
0132-000,2013,6,9,2,125,133,258,380
0132-000,2013,6,9,3,89,108,197,258
0132-000,2013,6,9,4,96,103,199,197
0132-000,2013,6,9,5,96,92,188,199
0132-000,2013,6,9,6,161,158,319,188
0132-000,2013,6,9,7,255,267,522,319
0132-000,2013,6,9,8,292,397,689,522
0132-000,2013,6,9,9,414,505,919,689
0132-000,2013,6,9,10,588,624,1212,919
0132-000,2013,6,9,11,682,709,1391,1212
0132-000,2013,6,9,12,603,631,1234,1391
0132-000,2013,6,9,13,669,585,1254,1234
0132-000,2013,6,9,14,678,644,1322,1254
0132-000,2013,6,9,15,741,623,1364,1322
0132-000,2013,6,9,16,1210,726,1936,1364
0132-000,2013,6,9,17,1176,653,1829,1936
0132-000,2013,6,9,18,1200,656,1856,1829
0132-000,2013,6,9,19,1386,653,2039,1856
0132-000,2013,6,9,20,683,548,1231,2039
0132-000,2013,6,9,21,551,501,1052,1231
0132-000,2013,6,9,22,419,429,848,1052
0132-000,2013,6,9,23,316,332,648,848
0132-000,2013,6,9,24,189,238,427,648
0132-000,2013,6,10,1,138,149,287,427
0132-000,2013,6,10,2,74,83,157,287
0132-000,2013,6,10,3,88,83,171,157
0132-000,2013,6,10,4,44,60,104,171
0132-000,2013,6,10,5,83,93,176,104
0132-000,2013,6,10,6,219,231,450,176
0132-000,2013,6,10,7,475,604,1079,450
0132-000,2013,6,10,8,770,1664,2434,1079
0132-000,2013,6,10,9,773,1292,2065,2434
0132-000,2013,6,10,10,679,883,1562,2065
0132-000,2013,6,10,11,842,946,1788,1562
0132-000,2013,6,10,12,946,970,1916,1788
0132-000,2013,6,10,13,843,918,1761,1916
0132-000,2013,6,10,14,898,940,1838,1761
0132-000,2013,6,10,15,924,906,1830,1838
0132-000,2013,6,10,16,893,835,1728,1830
0132-000,2013,6,10,17,973,833,1806,1728
0132-000,2013,6,10,18,1134,815,1949,1806
0132-000,2013,6,10,19,1199,862,2061,1949
0132-000,2013,6,10,20,878,679,1557,2061
0132-000,2013,6,10,21,728,543,1271,1557
0132-000,2013,6,10,22,621,502,1123,1271
0132-000,2013,6,10,23,410,374,784,1123
0132-000,2013,6,10,24,254,230,484,784
0132-000,2013,6,11,1,138,160,298,484
0132-000,2013,6,11,2,101,119,220,298
0132-000,2013,6,11,3,83,91,174,220
0132-000,2013,6,11,4,79,101,180,174
0132-000,2013,6,11,5,99,118,217,180
0132-000,2013,6,11,6,274,195,469,217
0132-000,2013,6,11,7,427,479,906,469
0132-000,2013,6,11,8,751,1517,2268,906
0132-000,2013,6,11,9,888,1410,2298,2268
0132-000,2013,6,11,10,855,1049,1904,2298
0132-000,2013,6,11,11,820,935,1755,1904
0132-000,2013,6,11,12,861,930,1791,1755
0132-000,2013,6,11,13,883,856,1739,1791
0132-000,2013,6,11,14,912,990,1902,1739
0132-000,2013,6,11,15,926,900,1826,1902
0132-000,2013,6,11,16,869,784,1653,1826
0132-000,2013,6,11,17,1041,849,1890,1653
0132-000,2013,6,11,18,1250,834,2084,1890
0132-000,2013,6,11,19,1194,836,2030,2084
0132-000,2013,6,11,20,907,708,1615,2030
0132-000,2013,6,11,21,692,516,1208,1615
0132-000,2013,6,11,22,572,417,989,1208
0132-000,2013,6,11,23,348,315,663,989
0132-000,2013,6,11,24,210,196,406,663
0132-000,2013,6,12,1,159,170,329,406
0132-000,2013,6,12,2,111,117,228,329
0132-000,2013,6,12,3,69,98,167,228
0132-000,2013,6,12,4,88,101,189,167
0132-000,2013,6,12,5,115,104,219,189
0132-000,2013,6,12,6,166,149,315,219
0132-000,2013,6,12,7,317,372,689,315
0132-000,2013,6,12,8,706,1411,2117,689
0132-000,2013,6,12,9,821,1316,2137,2117
0132-000,2013,6,12,10,665,823,1488,2137
0132-000,2013,6,12,11,828,849,1677,1488
0132-000,2013,6,12,12,740,807,1547,1677
0132-000,2013,6,12,13,653,736,1389,1547
0132-000,2013,6,12,14,808,829,1637,1389
0132-000,2013,6,12,15,973,846,1819,1637
0132-000,2013,6,12,16,956,814,1770,1819
0132-000,2013,6,12,17,988,728,1716,1770
0132-000,2013,6,12,18,1080,782,1862,1716
0132-000,2013,6,12,19,1103,759,1862,1862
0132-000,2013,6,12,20,955,664,1619,1862
0132-000,2013,6,12,21,713,529,1242,1619
0132-000,2013,6,12,22,615,452,1067,1242
0132-000,2013,6,12,23,350,326,676,1067
0132-000,2013,6,12,24,238,227,465,676
0132-000,2013,6,13,1,141,174,315,465
0132-000,2013,6,13,2,74,98,172,315
0132-000,2013,6,13,3,85,113,198,172
0132-000,2013,6,13,4,100,120,220,198
0132-000,2013,6,13,5,100,119,219,220
0132-000,2013,6,13,6,204,200,404,219
0132-000,2013,6,13,7,499,480,979,404
0132-000,2013,6,13,8,814,1554,2368,979
0132-000,2013,6,13,9,785,1323,2108,2368
0132-000,2013,6,13,10,740,897,1637,2108
0132-000,2013,6,13,11,886,950,1836,1637
0132-000,2013,6,13,12,909,933,1842,1836
0132-000,2013,6,13,13,821,874,1695,1842
0132-000,2013,6,13,14,731,795,1526,1695
0132-000,2013,6,13,15,874,851,1725,1526
0132-000,2013,6,13,16,940,815,1755,1725
0132-000,2013,6,13,17,944,803,1747,1755
0132-000,2013,6,13,18,1142,793,1935,1747
0132-000,2013,6,13,19,1243,886,2129,1935
0132-000,2013,6,13,20,970,729,1699,2129
0132-000,2013,6,13,21,756,547,1303,1699
0132-000,2013,6,13,22,625,477,1102,1303
0132-000,2013,6,13,23,447,372,819,1102
0132-000,2013,6,13,24,272,223,495,819
0132-000,2013,6,14,1,193,189,382,495
0132-000,2013,6,14,2,91,117,208,382
0132-000,2013,6,14,3,74,93,167,208
0132-000,2013,6,14,4,97,99,196,167
0132-000,2013,6,14,5,114,126,240,196
0132-000,2013,6,14,6,246,192,438,240
0132-000,2013,6,14,7,437,482,919,438
0132-000,2013,6,14,8,689,1439,2128,919
0132-000,2013,6,14,9,925,1361,2286,2128
0132-000,2013,6,14,10,745,910,1655,2286
0132-000,2013,6,14,11,808,907,1715,1655
0132-000,2013,6,14,12,940,1009,1949,1715
0132-000,2013,6,14,13,833,898,1731,1949
0132-000,2013,6,14,14,916,843,1759,1731
0132-000,2013,6,14,15,996,887,1883,1759
0132-000,2013,6,14,16,1039,869,1908,1883
0132-000,2013,6,14,17,1127,974,2101,1908
0132-000,2013,6,14,18,1364,953,2317,2101
0132-000,2013,6,14,19,1824,1113,2937,2317
0132-000,2013,6,14,20,1240,885,2125,2937
0132-000,2013,6,14,21,981,737,1718,2125
0132-000,2013,6,14,22,712,543,1255,1718
0132-000,2013,6,14,23,407,405,812,1255
0132-000,2013,6,14,24,265,267,532,812
0132-000,2013,6,15,1,198,217,415,532
0132-000,2013,6,15,2,151,167,318,415
0132-000,2013,6,15,3,108,139,247,318
0132-000,2013,6,15,4,140,149,289,247
0132-000,2013,6,15,5,100,133,233,289
0132-000,2013,6,15,6,248,224,472,233
0132-000,2013,6,15,7,397,431,828,472
0132-000,2013,6,15,8,567,853,1420,828
0132-000,2013,6,15,9,785,1062,1847,1420
0132-000,2013,6,15,10,1079,1297,2376,1847
0132-000,2013,6,15,11,1011,1311,2322,2376
0132-000,2013,6,15,12,918,1433,2351,2322
0132-000,2013,6,15,13,973,1394,2367,2351
0132-000,2013,6,15,14,1118,1324,2442,2367
0132-000,2013,6,15,15,1093,1205,2298,2442
0132-000,2013,6,15,16,1145,1155,2300,2298
0132-000,2013,6,15,17,1162,1105,2267,2300
0132-000,2013,6,15,18,1750,1206,2956,2267
0132-000,2013,6,15,19,1195,987,2182,2956
0132-000,2013,6,15,20,853,770,1623,2182
0132-000,2013,6,15,21,555,573,1128,1623
0132-000,2013,6,15,22,530,515,1045,1128
0132-000,2013,6,15,23,358,341,699,1045
0132-000,2013,6,15,24,307,303,610,699
0132-000,2013,6,16,1,205,203,408,610
0132-000,2013,6,16,2,127,140,267,408
0132-000,2013,6,16,3,108,122,230,267
0132-000,2013,6,16,4,81,89,170,230
0132-000,2013,6,16,5,99,111,210,170
0132-000,2013,6,16,6,170,188,358,210
0132-000,2013,6,16,7,258,292,550,358
0132-000,2013,6,16,8,332,420,752,550
0132-000,2013,6,16,9,380,482,862,752
0132-000,2013,6,16,10,530,596,1126,862
0132-000,2013,6,16,11,555,645,1200,1126
0132-000,2013,6,16,12,611,596,1207,1200
0132-000,2013,6,16,13,789,646,1435,1207
0132-000,2013,6,16,14,749,680,1429,1435
0132-000,2013,6,16,15,709,623,1332,1429
0132-000,2013,6,16,16,1026,649,1675,1332
0132-000,2013,6,16,17,1074,624,1698,1675
0132-000,2013,6,16,18,1358,703,2061,1698
0132-000,2013,6,16,19,1313,651,1964,2061
0132-000,2013,6,16,20,866,582,1448,1964
0132-000,2013,6,16,21,615,493,1108,1448
0132-000,2013,6,16,22,365,425,790,1108
0132-000,2013,6,16,23,255,307,562,790
0132-000,2013,6,16,24,170,207,377,562
0132-000,2013,6,17,1,111,156,267,377
0132-000,2013,6,17,2,86,108,194,267
0132-000,2013,6,17,3,57,73,130,194
0132-000,2013,6,17,4,56,95,151,130
0132-000,2013,6,17,5,86,101,187,151
0132-000,2013,6,17,6,259,245,504,187
0132-000,2013,6,17,7,457,605,1062,504
0132-000,2013,6,17,8,759,1704,2463,1062
0132-000,2013,6,17,9,768,1339,2107,2463
0132-000,2013,6,17,10,694,822,1516,2107
0132-000,2013,6,17,11,745,851,1596,1516
0132-000,2013,6,17,12,723,826,1549,1596
0132-000,2013,6,17,13,867,949,1816,1549
0132-000,2013,6,17,14,924,976,1900,1816
0132-000,2013,6,17,15,928,901,1829,1900
0132-000,2013,6,17,16,826,784,1610,1829
0132-000,2013,6,17,17,946,830,1776,1610
0132-000,2013,6,17,18,1230,887,2117,1776
0132-000,2013,6,17,19,1186,878,2064,2117
0132-000,2013,6,17,20,925,733,1658,2064
0132-000,2013,6,17,21,719,530,1249,1658
0132-000,2013,6,17,22,645,451,1096,1249
0132-000,2013,6,17,23,339,328,667,1096
0132-000,2013,6,17,24,248,216,464,667
0132-000,2013,6,18,1,140,144,284,464
0132-000,2013,6,18,2,82,87,169,284
0132-000,2013,6,18,3,60,86,146,169
0132-000,2013,6,18,4,67,92,159,146
0132-000,2013,6,18,5,107,100,207,159
0132-000,2013,6,18,6,143,130,273,207
0132-000,2013,6,18,7,375,410,785,273
0132-000,2013,6,18,8,702,1429,2131,785
0132-000,2013,6,18,9,721,1212,1933,2131
0132-000,2013,6,18,10,675,815,1490,1933
0132-000,2013,6,18,11,684,757,1441,1490
0132-000,2013,6,18,12,704,703,1407,1441
0132-000,2013,6,18,13,762,794,1556,1407
0132-000,2013,6,18,14,798,829,1627,1556
0132-000,2013,6,18,15,822,805,1627,1627
0132-000,2013,6,18,16,790,733,1523,1627
0132-000,2013,6,18,17,866,740,1606,1523
0132-000,2013,6,18,18,1086,754,1840,1606
0132-000,2013,6,18,19,1037,721,1758,1840
0132-000,2013,6,18,20,782,626,1408,1758
0132-000,2013,6,18,21,586,474,1060,1408
0132-000,2013,6,18,22,603,426,1029,1060
0132-000,2013,6,18,23,360,288,648,1029
0132-000,2013,6,18,24,226,197,423,648
0132-000,2013,6,19,1,152,144,296,423
0132-000,2013,6,19,2,79,89,168,296
0132-000,2013,6,19,3,55,75,130,168
0132-000,2013,6,19,4,80,87,167,130
0132-000,2013,6,19,5,91,103,194,167
0132-000,2013,6,19,6,263,181,444,194
0132-000,2013,6,19,7,410,446,856,444
0132-000,2013,6,19,8,806,1562,2368,856
0132-000,2013,6,19,9,815,1298,2113,2368
0132-000,2013,6,19,10,690,861,1551,2113
0132-000,2013,6,19,11,765,850,1615,1551
0132-000,2013,6,19,12,812,865,1677,1615
0132-000,2013,6,19,13,796,857,1653,1677
0132-000,2013,6,19,14,743,833,1576,1653
0132-000,2013,6,19,15,847,800,1647,1576
0132-000,2013,6,19,16,896,814,1710,1647
0132-000,2013,6,19,17,968,745,1713,1710
0132-000,2013,6,19,18,1345,790,2135,1713
0132-000,2013,6,19,19,1211,806,2017,2135
0132-000,2013,6,19,20,968,700,1668,2017
0132-000,2013,6,19,21,721,517,1238,1668
0132-000,2013,6,19,22,629,484,1113,1238
0132-000,2013,6,19,23,402,355,757,1113
0132-000,2013,6,19,24,218,244,462,757
0132-000,2013,6,20,1,194,165,359,462
0132-000,2013,6,20,2,102,121,223,359
0132-000,2013,6,20,3,81,112,193,223
0132-000,2013,6,20,4,83,96,179,193
0132-000,2013,6,20,5,115,122,237,179
0132-000,2013,6,20,6,227,194,421,237
0132-000,2013,6,20,7,427,480,907,421
0132-000,2013,6,20,8,768,1534,2302,907
0132-000,2013,6,20,9,876,1372,2248,2302
0132-000,2013,6,20,10,744,880,1624,2248
0132-000,2013,6,20,11,771,896,1667,1624
0132-000,2013,6,20,12,911,943,1854,1667
0132-000,2013,6,20,13,698,688,1386,1854
0132-000,2013,6,20,14,804,805,1609,1386
0132-000,2013,6,20,15,839,756,1595,1609
0132-000,2013,6,20,16,867,762,1629,1595
0132-000,2013,6,20,17,786,710,1496,1629
0132-000,2013,6,20,18,1070,796,1866,1496
0132-000,2013,6,20,19,1255,856,2111,1866
0132-000,2013,6,20,20,905,670,1575,2111
0132-000,2013,6,20,21,729,575,1304,1575
0132-000,2013,6,20,22,697,519,1216,1304
0132-000,2013,6,20,23,475,349,824,1216
0132-000,2013,6,20,24,228,248,476,824
0132-000,2013,6,21,1,211,177,388,476
0132-000,2013,6,21,2,115,112,227,388
0132-000,2013,6,21,3,93,113,206,227
0132-000,2013,6,21,4,89,116,205,206
0132-000,2013,6,21,5,91,121,212,205
0132-000,2013,6,21,6,279,210,489,212
0132-000,2013,6,21,7,432,468,900,489
0132-000,2013,6,21,8,793,1537,2330,900
0132-000,2013,6,21,9,783,1260,2043,2330
0132-000,2013,6,21,10,693,877,1570,2043
0132-000,2013,6,21,11,728,827,1555,1570
0132-000,2013,6,21,12,844,901,1745,1555
0132-000,2013,6,21,13,1004,1013,2017,1745
0132-000,2013,6,21,14,877,793,1670,2017
0132-000,2013,6,21,15,919,883,1802,1670
0132-000,2013,6,21,16,1020,846,1866,1802
0132-000,2013,6,21,17,1055,855,1910,1866
0132-000,2013,6,21,18,1335,889,2224,1910
0132-000,2013,6,21,19,1492,974,2466,2224
0132-000,2013,6,21,20,1198,894,2092,2466
0132-000,2013,6,21,21,732,640,1372,2092
0132-000,2013,6,21,22,717,570,1287,1372
0132-000,2013,6,21,23,464,459,923,1287
0132-000,2013,6,21,24,345,307,652,923
0132-000,2013,6,22,1,209,241,450,652
0132-000,2013,6,22,2,141,152,293,450
0132-000,2013,6,22,3,126,132,258,293
0132-000,2013,6,22,4,105,127,232,258
0132-000,2013,6,22,5,126,142,268,232
0132-000,2013,6,22,6,252,221,473,268
0132-000,2013,6,22,7,364,394,758,473
0132-000,2013,6,22,8,553,789,1342,758
0132-000,2013,6,22,9,724,900,1624,1342
0132-000,2013,6,22,10,860,1035,1895,1624
0132-000,2013,6,22,11,1098,1319,2417,1895
0132-000,2013,6,22,12,1159,1481,2640,2417
0132-000,2013,6,22,13,972,1240,2212,2640
0132-000,2013,6,22,14,971,1080,2051,2212
0132-000,2013,6,22,15,923,1072,1995,2051
0132-000,2013,6,22,16,992,1072,2064,1995
0132-000,2013,6,22,17,1108,1091,2199,2064
0132-000,2013,6,22,18,1481,1078,2559,2199
0132-000,2013,6,22,19,1252,1023,2275,2559
0132-000,2013,6,22,20,840,776,1616,2275
0132-000,2013,6,22,21,530,515,1045,1616
0132-000,2013,6,22,22,474,458,932,1045
0132-000,2013,6,22,23,347,355,702,932
0132-000,2013,6,22,24,228,245,473,702
0132-000,2013,6,23,1,184,184,368,473
0132-000,2013,6,23,2,184,153,337,368
0132-000,2013,6,23,3,89,103,192,337
0132-000,2013,6,23,4,80,93,173,192
0132-000,2013,6,23,5,103,114,217,173
0132-000,2013,6,23,6,163,184,347,217
0132-000,2013,6,23,7,254,241,495,347
0132-000,2013,6,23,8,331,386,717,495
0132-000,2013,6,23,9,443,510,953,717
0132-000,2013,6,23,10,456,519,975,953
0132-000,2013,6,23,11,550,585,1135,975
0132-000,2013,6,23,12,639,622,1261,1135
0132-000,2013,6,23,13,695,595,1290,1261
0132-000,2013,6,23,14,716,668,1384,1290
0132-000,2013,6,23,15,717,694,1411,1384
0132-000,2013,6,23,16,1148,713,1861,1411
0132-000,2013,6,23,17,1067,634,1701,1861
0132-000,2013,6,23,18,1156,661,1817,1701
0132-000,2013,6,23,19,1105,537,1642,1817
0132-000,2013,6,23,20,882,512,1394,1642
0132-000,2013,6,23,21,891,506,1397,1394
0132-000,2013,6,23,22,595,462,1057,1397
0132-000,2013,6,23,23,259,316,575,1057
0132-000,2013,6,23,24,182,210,392,575
0132-000,2013,6,24,1,140,141,281,392
0132-000,2013,6,24,2,58,94,152,281
0132-000,2013,6,24,3,81,69,150,152
0132-000,2013,6,24,4,65,88,153,150
0132-000,2013,6,24,5,74,111,185,153
0132-000,2013,6,24,6,198,214,412,185
0132-000,2013,6,24,7,419,609,1028,412
0132-000,2013,6,24,8,791,1772,2563,1028
0132-000,2013,6,24,9,781,1259,2040,2563
0132-000,2013,6,24,10,826,825,1651,2040
0132-000,2013,6,24,11,692,797,1489,1651
0132-000,2013,6,24,12,722,851,1573,1489
0132-000,2013,6,24,13,821,937,1758,1573
0132-000,2013,6,24,14,850,907,1757,1758
0132-000,2013,6,24,15,808,860,1668,1757
0132-000,2013,6,24,16,913,875,1788,1668
0132-000,2013,6,24,17,877,777,1654,1788
0132-000,2013,6,24,18,994,792,1786,1654
0132-000,2013,6,24,19,1047,770,1817,1786
0132-000,2013,6,24,20,842,695,1537,1817
0132-000,2013,6,24,21,755,573,1328,1537
0132-000,2013,6,24,22,602,499,1101,1328
0132-000,2013,6,24,23,315,302,617,1101
0132-000,2013,6,24,24,217,210,427,617
0132-000,2013,6,25,1,162,161,323,427
0132-000,2013,6,25,2,106,101,207,323
0132-000,2013,6,25,3,63,91,154,207
0132-000,2013,6,25,4,86,97,183,154
0132-000,2013,6,25,5,72,123,195,183
0132-000,2013,6,25,6,225,192,417,195
0132-000,2013,6,25,7,409,519,928,417
0132-000,2013,6,25,8,772,1542,2314,928
0132-000,2013,6,25,9,932,1228,2160,2314
0132-000,2013,6,25,10,783,817,1600,2160
0132-000,2013,6,25,11,804,882,1686,1600
0132-000,2013,6,25,12,963,962,1925,1686
0132-000,2013,6,25,13,717,722,1439,1925
0132-000,2013,6,25,14,825,820,1645,1439
0132-000,2013,6,25,15,872,810,1682,1645
0132-000,2013,6,25,16,837,797,1634,1682
0132-000,2013,6,25,17,879,751,1630,1634
0132-000,2013,6,25,18,977,782,1759,1630
0132-000,2013,6,25,19,1114,819,1933,1759
0132-000,2013,6,25,20,869,665,1534,1933
0132-000,2013,6,25,21,659,468,1127,1534
0132-000,2013,6,25,22,679,496,1175,1127
0132-000,2013,6,25,23,338,351,689,1175
0132-000,2013,6,25,24,195,189,384,689
0132-000,2013,6,26,1,213,179,392,384
0132-000,2013,6,26,2,66,107,173,392
0132-000,2013,6,26,3,102,103,205,173
0132-000,2013,6,26,4,80,100,180,205
0132-000,2013,6,26,5,70,99,169,180
0132-000,2013,6,26,6,192,200,392,169
0132-000,2013,6,26,7,371,475,846,392
0132-000,2013,6,26,8,771,1532,2303,846
0132-000,2013,6,26,9,861,1256,2117,2303
0132-000,2013,6,26,10,731,811,1542,2117
0132-000,2013,6,26,11,786,827,1613,1542
0132-000,2013,6,26,12,617,791,1408,1613
0132-000,2013,6,26,13,601,774,1375,1408
0132-000,2013,6,26,14,679,735,1414,1375
0132-000,2013,6,26,15,852,817,1669,1414
0132-000,2013,6,26,16,903,786,1689,1669
0132-000,2013,6,26,17,988,777,1765,1689
0132-000,2013,6,26,18,1063,775,1838,1765
0132-000,2013,6,26,19,1221,833,2054,1838
0132-000,2013,6,26,20,928,704,1632,2054
0132-000,2013,6,26,21,696,516,1212,1632
0132-000,2013,6,26,22,569,500,1069,1212
0132-000,2013,6,26,23,371,343,714,1069
0132-000,2013,6,26,24,202,192,394,714
0132-000,2013,6,27,1,161,187,348,394
0132-000,2013,6,27,2,92,118,210,348
0132-000,2013,6,27,3,67,88,155,210
0132-000,2013,6,27,4,102,113,215,155
0132-000,2013,6,27,5,95,124,219,215
0132-000,2013,6,27,6,213,219,432,219
0132-000,2013,6,27,7,370,491,861,432
0132-000,2013,6,27,8,790,1443,2233,861
0132-000,2013,6,27,9,857,1161,2018,2233
0132-000,2013,6,27,10,1021,876,1897,2018
0132-000,2013,6,27,11,1121,802,1923,1897
0132-000,2013,6,27,12,1261,881,2142,1923
0132-000,2013,6,27,13,798,798,1596,2142
0132-000,2013,6,27,14,768,790,1558,1596
0132-000,2013,6,27,15,788,763,1551,1558
0132-000,2013,6,27,16,937,805,1742,1551
0132-000,2013,6,27,17,847,730,1577,1742
0132-000,2013,6,27,18,1355,751,2106,1577
0132-000,2013,6,27,19,1015,775,1790,2106
0132-000,2013,6,27,20,834,670,1504,1790
0132-000,2013,6,27,21,843,526,1369,1504
0132-000,2013,6,27,22,509,463,972,1369
0132-000,2013,6,27,23,339,330,669,972
0132-000,2013,6,27,24,199,220,419,669
0132-000,2013,6,28,1,132,148,280,419
0132-000,2013,6,28,2,106,96,202,280
0132-000,2013,6,28,3,94,96,190,202
0132-000,2013,6,28,4,55,97,152,190
0132-000,2013,6,28,5,104,127,231,152
0132-000,2013,6,28,6,226,230,456,231
0132-000,2013,6,28,7,385,445,830,456
0132-000,2013,6,28,8,583,1016,1599,830
0132-000,2013,6,28,9,674,978,1652,1599
0132-000,2013,6,28,10,629,695,1324,1652
0132-000,2013,6,28,11,651,719,1370,1324
0132-000,2013,6,28,12,778,762,1540,1370
0132-000,2013,6,28,13,702,664,1366,1540
0132-000,2013,6,28,14,665,666,1331,1366
0132-000,2013,6,28,15,819,732,1551,1331
0132-000,2013,6,28,16,865,767,1632,1551
0132-000,2013,6,28,17,842,756,1598,1632
0132-000,2013,6,28,18,957,731,1688,1598
0132-000,2013,6,28,19,1124,762,1886,1688
0132-000,2013,6,28,20,997,784,1781,1886
0132-000,2013,6,28,21,771,620,1391,1781
0132-000,2013,6,28,22,670,569,1239,1391
0132-000,2013,6,28,23,439,374,813,1239
0132-000,2013,6,28,24,299,272,571,813
0132-000,2013,6,29,1,221,266,487,571
0132-000,2013,6,29,2,149,158,307,487
0132-000,2013,6,29,3,164,141,305,307
0132-000,2013,6,29,4,89,127,216,305
0132-000,2013,6,29,5,161,153,314,216
0132-000,2013,6,29,6,242,203,445,314
0132-000,2013,6,29,7,345,373,718,445
0132-000,2013,6,29,8,571,761,1332,718
0132-000,2013,6,29,9,818,922,1740,1332
0132-000,2013,6,29,10,889,1072,1961,1740
0132-000,2013,6,29,11,895,974,1869,1961
0132-000,2013,6,29,12,1003,1029,2032,1869
0132-000,2013,6,29,13,1139,1261,2400,2032
0132-000,2013,6,29,14,1165,1201,2366,2400
0132-000,2013,6,29,15,855,1055,1910,2366
0132-000,2013,6,29,16,799,929,1728,1910
0132-000,2013,6,29,17,884,902,1786,1728
0132-000,2013,6,29,18,1311,1027,2338,1786
0132-000,2013,6,29,19,1109,896,2005,2338
0132-000,2013,6,29,20,766,727,1493,2005
0132-000,2013,6,29,21,645,592,1237,1493
0132-000,2013,6,29,22,494,473,967,1237
0132-000,2013,6,29,23,317,349,666,967
0132-000,2013,6,29,24,230,270,500,666
0132-000,2013,6,30,1,195,194,389,500
0132-000,2013,6,30,2,156,147,303,389
0132-000,2013,6,30,3,99,113,212,303
0132-000,2013,6,30,4,81,91,172,212
0132-000,2013,6,30,5,101,113,214,172
0132-000,2013,6,30,6,167,186,353,214
0132-000,2013,6,30,7,256,267,523,353
0132-000,2013,6,30,8,332,403,735,523
0132-000,2013,6,30,9,412,496,908,735
0132-000,2013,6,30,10,493,558,1051,908
0132-000,2013,6,30,11,553,615,1168,1051
0132-000,2013,6,30,12,625,609,1234,1168
0132-000,2013,6,30,13,742,621,1363,1234
0132-000,2013,6,30,14,733,674,1407,1363
0132-000,2013,6,30,15,713,659,1372,1407
0132-000,2013,6,30,16,1087,681,1768,1372
0132-000,2013,6,30,17,1071,629,1700,1768
0132-000,2013,6,30,18,1257,682,1939,1700
0132-000,2013,6,30,19,1209,594,1803,1939
0132-000,2013,6,30,20,874,547,1421,1803
0132-000,2013,6,30,21,753,500,1253,1421
0132-000,2013,6,30,22,480,444,924,1253
0132-000,2013,6,30,23,257,312,569,924
0132-000,2013,6,30,24,176,209,385,569
0132-000,2013,7,1,1,126,139,265,385
0132-000,2013,7,1,2,74,87,161,265
0132-000,2013,7,1,3,70,68,138,161
0132-000,2013,7,1,4,66,70,136,138
0132-000,2013,7,1,5,114,117,231,136
0132-000,2013,7,1,6,213,228,441,231
0132-000,2013,7,1,7,448,607,1055,441
0132-000,2013,7,1,8,568,1466,2034,1055
0132-000,2013,7,1,9,674,1133,1807,2034
0132-000,2013,7,1,10,676,748,1424,1807
0132-000,2013,7,1,11,682,796,1478,1424
0132-000,2013,7,1,12,736,815,1551,1478
0132-000,2013,7,1,13,685,776,1461,1551
0132-000,2013,7,1,14,759,478,1237,1461
0132-000,2013,7,1,15,755,423,1178,1237
0132-000,2013,7,1,16,790,414,1204,1178
0132-000,2013,7,1,17,770,373,1143,1204
0132-000,2013,7,1,18,942,385,1327,1143
0132-000,2013,7,1,19,963,389,1352,1327
0132-000,2013,7,1,20,822,365,1187,1352
0132-000,2013,7,1,21,778,296,1074,1187
0132-000,2013,7,1,22,581,213,794,1074
0132-000,2013,7,1,23,392,181,573,794
0132-000,2013,7,1,24,255,133,388,573
0132-000,2013,7,2,1,149,78,227,388
0132-000,2013,7,2,2,110,58,168,227
0132-000,2013,7,2,3,80,56,136,168
0132-000,2013,7,2,4,76,54,130,136
0132-000,2013,7,2,5,80,69,149,130
0132-000,2013,7,2,6,147,83,230,149
0132-000,2013,7,2,7,325,209,534,230
0132-000,2013,7,2,8,546,1373,1919,534
0132-000,2013,7,2,9,693,1119,1812,1919
0132-000,2013,7,2,10,620,748,1368,1812
0132-000,2013,7,2,11,606,600,1206,1368
0132-000,2013,7,2,12,745,750,1495,1206
0132-000,2013,7,2,13,627,638,1265,1495
0132-000,2013,7,2,14,680,762,1442,1265
0132-000,2013,7,2,15,768,754,1522,1442
0132-000,2013,7,2,16,776,664,1440,1522
0132-000,2013,7,2,17,736,692,1428,1440
0132-000,2013,7,2,18,942,753,1695,1428
0132-000,2013,7,2,19,1017,774,1791,1695
0132-000,2013,7,2,20,766,668,1434,1791
0132-000,2013,7,2,21,658,491,1149,1434
0132-000,2013,7,2,22,579,436,1015,1149
0132-000,2013,7,2,23,327,286,613,1015
0132-000,2013,7,2,24,197,202,399,613
0132-000,2013,7,3,1,149,149,298,399
0132-000,2013,7,3,2,87,98,185,298
0132-000,2013,7,3,3,91,76,167,185
0132-000,2013,7,3,4,76,85,161,167
0132-000,2013,7,3,5,91,110,201,161
0132-000,2013,7,3,6,172,171,343,201
0132-000,2013,7,3,7,352,425,777,343
0132-000,2013,7,3,8,585,1408,1993,777
0132-000,2013,7,3,9,649,987,1636,1993
0132-000,2013,7,3,10,712,799,1511,1636
0132-000,2013,7,3,11,693,743,1436,1511
0132-000,2013,7,3,12,757,711,1468,1436
0132-000,2013,7,3,13,724,668,1392,1468
0132-000,2013,7,3,14,714,738,1452,1392
0132-000,2013,7,3,15,755,805,1560,1452
0132-000,2013,7,3,16,853,745,1598,1560
0132-000,2013,7,3,17,830,736,1566,1598
0132-000,2013,7,3,18,955,826,1781,1566
0132-000,2013,7,3,19,1084,816,1900,1781
0132-000,2013,7,3,20,764,691,1455,1900
0132-000,2013,7,3,21,629,533,1162,1455
0132-000,2013,7,3,22,516,439,955,1162
0132-000,2013,7,3,23,402,330,732,955
0132-000,2013,7,3,24,195,216,411,732
0132-000,2013,7,4,1,145,171,316,411
0132-000,2013,7,4,2,78,108,186,316
0132-000,2013,7,4,3,89,94,183,186
0132-000,2013,7,4,4,56,122,178,183
0132-000,2013,7,4,5,105,133,238,178
0132-000,2013,7,4,6,170,185,355,238
0132-000,2013,7,4,7,354,436,790,355
0132-000,2013,7,4,8,608,1475,2083,790
0132-000,2013,7,4,9,712,1123,1835,2083
0132-000,2013,7,4,10,653,777,1430,1835
0132-000,2013,7,4,11,714,755,1469,1430
0132-000,2013,7,4,12,689,713,1402,1469
0132-000,2013,7,4,13,602,660,1262,1402
0132-000,2013,7,4,14,751,724,1475,1262
0132-000,2013,7,4,15,786,695,1481,1475
0132-000,2013,7,4,16,766,737,1503,1481
0132-000,2013,7,4,17,799,668,1467,1503
0132-000,2013,7,4,18,967,756,1723,1467
0132-000,2013,7,4,19,960,746,1706,1723
0132-000,2013,7,4,20,724,573,1297,1706
0132-000,2013,7,4,21,705,456,1161,1297
0132-000,2013,7,4,22,521,386,907,1161
0132-000,2013,7,4,23,402,294,696,907
0132-000,2013,7,4,24,228,237,465,696
0132-000,2013,7,5,1,170,180,350,465
0132-000,2013,7,5,2,120,116,236,350
0132-000,2013,7,5,3,89,98,187,236
0132-000,2013,7,5,4,83,93,176,187
0132-000,2013,7,5,5,72,86,158,176
0132-000,2013,7,5,6,161,151,312,158
0132-000,2013,7,5,7,282,362,644,312
0132-000,2013,7,5,8,560,1438,1998,644
0132-000,2013,7,5,9,689,1116,1805,1998
0132-000,2013,7,5,10,654,835,1489,1805
0132-000,2013,7,5,11,693,811,1504,1489
0132-000,2013,7,5,12,772,780,1552,1504
0132-000,2013,7,5,13,668,714,1382,1552
0132-000,2013,7,5,14,768,719,1487,1382
0132-000,2013,7,5,15,768,768,1536,1487
0132-000,2013,7,5,16,828,727,1555,1536
0132-000,2013,7,5,17,830,800,1630,1555
0132-000,2013,7,5,18,1106,832,1938,1630
0132-000,2013,7,5,19,1178,859,2037,1938
0132-000,2013,7,5,20,954,723,1677,2037
0132-000,2013,7,5,21,793,644,1437,1677
0132-000,2013,7,5,22,606,551,1157,1437
0132-000,2013,7,5,23,390,418,808,1157
0132-000,2013,7,5,24,267,274,541,808
0132-000,2013,7,6,1,195,240,435,541
0132-000,2013,7,6,2,163,152,315,435
0132-000,2013,7,6,3,136,144,280,315
0132-000,2013,7,6,4,95,127,222,280
0132-000,2013,7,6,5,126,159,285,222
0132-000,2013,7,6,6,174,204,378,285
0132-000,2013,7,6,7,300,362,662,378
0132-000,2013,7,6,8,454,762,1216,662
0132-000,2013,7,6,9,568,917,1485,1216
0132-000,2013,7,6,10,595,855,1450,1485
0132-000,2013,7,6,11,647,902,1549,1450
0132-000,2013,7,6,12,778,1177,1955,1549
0132-000,2013,7,6,13,768,1099,1867,1955
0132-000,2013,7,6,14,674,872,1546,1867
0132-000,2013,7,6,15,778,913,1691,1546
0132-000,2013,7,6,16,811,862,1673,1691
0132-000,2013,7,6,17,803,873,1676,1673
0132-000,2013,7,6,18,1022,898,1920,1676
0132-000,2013,7,6,19,1029,813,1842,1920
0132-000,2013,7,6,20,739,625,1364,1842
0132-000,2013,7,6,21,697,552,1249,1364
0132-000,2013,7,6,22,556,482,1038,1249
0132-000,2013,7,6,23,381,357,738,1038
0132-000,2013,7,6,24,271,255,526,738
0132-000,2013,7,7,1,172,191,363,526
0132-000,2013,7,7,2,153,142,295,363
0132-000,2013,7,7,3,66,120,186,295
0132-000,2013,7,7,4,93,87,180,186
0132-000,2013,7,7,5,93,101,194,180
0132-000,2013,7,7,6,134,145,279,194
0132-000,2013,7,7,7,191,203,394,279
0132-000,2013,7,7,8,271,346,617,394
0132-000,2013,7,7,9,384,432,816,617
0132-000,2013,7,7,10,460,500,960,816
0132-000,2013,7,7,11,523,599,1122,960
0132-000,2013,7,7,12,543,606,1149,1122
0132-000,2013,7,7,13,593,607,1200,1149
0132-000,2013,7,7,14,670,600,1270,1200
0132-000,2013,7,7,15,705,627,1332,1270
0132-000,2013,7,7,16,788,624,1412,1332
0132-000,2013,7,7,17,849,590,1439,1412
0132-000,2013,7,7,18,965,677,1642,1439
0132-000,2013,7,7,19,813,533,1346,1642
0132-000,2013,7,7,20,656,475,1131,1346
0132-000,2013,7,7,21,577,429,1006,1131
0132-000,2013,7,7,22,438,409,847,1006
0132-000,2013,7,7,23,300,276,576,847
0132-000,2013,7,7,24,139,191,330,576
0132-000,2013,7,8,1,107,124,231,330
0132-000,2013,7,8,2,68,61,129,231
0132-000,2013,7,8,3,64,59,123,129
0132-000,2013,7,8,4,58,76,134,123
0132-000,2013,7,8,5,93,114,207,134
0132-000,2013,7,8,6,153,191,344,207
0132-000,2013,7,8,7,348,513,861,344
0132-000,2013,7,8,8,518,1560,2078,861
0132-000,2013,7,8,9,726,1162,1888,2078
0132-000,2013,7,8,10,651,704,1355,1888
0132-000,2013,7,8,11,716,632,1348,1355
0132-000,2013,7,8,12,647,649,1296,1348
0132-000,2013,7,8,13,639,668,1307,1296
0132-000,2013,7,8,14,716,645,1361,1307
0132-000,2013,7,8,15,768,483,1251,1361
0132-000,2013,7,8,16,788,523,1311,1251
0132-000,2013,7,8,17,753,673,1426,1311
0132-000,2013,7,8,18,884,681,1565,1426
0132-000,2013,7,8,19,958,657,1615,1565
0132-000,2013,7,8,20,728,537,1265,1615
0132-000,2013,7,8,21,670,428,1098,1265
0132-000,2013,7,8,22,496,362,858,1098
0132-000,2013,7,8,23,325,258,583,858
0132-000,2013,7,8,24,199,161,360,583
0132-000,2013,7,9,1,174,130,304,360
0132-000,2013,7,9,2,85,90,175,304
0132-000,2013,7,9,3,89,82,171,175
0132-000,2013,7,9,4,60,91,151,171
0132-000,2013,7,9,5,76,112,188,151
0132-000,2013,7,9,6,161,162,323,188
0132-000,2013,7,9,7,328,428,756,323
0132-000,2013,7,9,8,552,1204,1756,756
0132-000,2013,7,9,9,668,1010,1678,1756
0132-000,2013,7,9,10,680,680,1360,1678
0132-000,2013,7,9,11,685,657,1342,1360
0132-000,2013,7,9,12,710,754,1464,1342
0132-000,2013,7,9,13,678,755,1433,1464
0132-000,2013,7,9,14,674,670,1344,1433
0132-000,2013,7,9,15,772,745,1517,1344
0132-000,2013,7,9,16,791,720,1511,1517
0132-000,2013,7,9,17,770,688,1458,1511
0132-000,2013,7,9,18,957,653,1610,1458
0132-000,2013,7,9,19,1021,752,1773,1610
0132-000,2013,7,9,20,780,592,1372,1773
0132-000,2013,7,9,21,730,468,1198,1372
0132-000,2013,7,9,22,537,398,935,1198
0132-000,2013,7,9,23,365,300,665,935
0132-000,2013,7,9,24,218,177,395,665
0132-000,2013,7,10,1,145,160,305,395
0132-000,2013,7,10,2,120,112,232,305
0132-000,2013,7,10,3,70,97,167,232
0132-000,2013,7,10,4,43,101,144,167
0132-000,2013,7,10,5,99,130,229,144
0132-000,2013,7,10,6,184,180,364,229
0132-000,2013,7,10,7,382,418,800,364
0132-000,2013,7,10,8,604,1226,1830,800
0132-000,2013,7,10,9,693,947,1640,1830
0132-000,2013,7,10,10,666,736,1402,1640
0132-000,2013,7,10,11,722,700,1422,1402
0132-000,2013,7,10,12,707,738,1445,1422
0132-000,2013,7,10,13,656,651,1307,1445
0132-000,2013,7,10,14,799,706,1505,1307
0132-000,2013,7,10,15,791,737,1528,1505
0132-000,2013,7,10,16,790,709,1499,1528
0132-000,2013,7,10,17,828,686,1514,1499
0132-000,2013,7,10,18,940,757,1697,1514
0132-000,2013,7,10,19,1024,745,1769,1697
0132-000,2013,7,10,20,813,600,1413,1769
0132-000,2013,7,10,21,699,464,1163,1413
0132-000,2013,7,10,22,577,434,1011,1163
0132-000,2013,7,10,23,388,306,694,1011
0132-000,2013,7,10,24,226,206,432,694
0132-000,2013,7,11,1,149,179,328,432
0132-000,2013,7,11,2,130,129,259,328
0132-000,2013,7,11,3,78,102,180,259
0132-000,2013,7,11,4,78,97,175,180
0132-000,2013,7,11,5,116,122,238,175
0132-000,2013,7,11,6,153,198,351,238
0132-000,2013,7,11,7,319,456,775,351
0132-000,2013,7,11,8,566,1189,1755,775
0132-000,2013,7,11,9,670,943,1613,1755
0132-000,2013,7,11,10,687,707,1394,1613
0132-000,2013,7,11,11,741,703,1444,1394
0132-000,2013,7,11,12,653,760,1413,1444
0132-000,2013,7,11,13,658,656,1314,1413
0132-000,2013,7,11,14,737,720,1457,1314
0132-000,2013,7,11,15,780,715,1495,1457
0132-000,2013,7,11,16,828,729,1557,1495
0132-000,2013,7,11,17,824,673,1497,1557
0132-000,2013,7,11,18,965,721,1686,1497
0132-000,2013,7,11,19,968,697,1665,1686
0132-000,2013,7,11,20,786,573,1359,1665
0132-000,2013,7,11,21,739,487,1226,1359
0132-000,2013,7,11,22,564,424,988,1226
0132-000,2013,7,11,23,404,327,731,988
0132-000,2013,7,11,24,246,230,476,731
0132-000,2013,7,12,1,157,167,324,476
0132-000,2013,7,12,2,136,125,261,324
0132-000,2013,7,12,3,68,96,164,261
0132-000,2013,7,12,4,80,98,178,164
0132-000,2013,7,12,5,110,117,227,178
0132-000,2013,7,12,6,151,186,337,227
0132-000,2013,7,12,7,355,436,791,337
0132-000,2013,7,12,8,566,1308,1874,791
0132-000,2013,7,12,9,647,1072,1719,1874
0132-000,2013,7,12,10,643,690,1333,1719
0132-000,2013,7,12,11,687,800,1487,1333
0132-000,2013,7,12,12,739,705,1444,1487
0132-000,2013,7,12,13,691,696,1387,1444
0132-000,2013,7,12,14,683,747,1430,1387
0132-000,2013,7,12,15,859,797,1656,1430
0132-000,2013,7,12,16,886,786,1672,1656
0132-000,2013,7,12,17,882,721,1603,1672
0132-000,2013,7,12,18,973,824,1797,1603
0132-000,2013,7,12,19,1278,917,2195,1797
0132-000,2013,7,12,20,919,783,1702,2195
0132-000,2013,7,12,21,726,578,1304,1702
0132-000,2013,7,12,22,575,526,1101,1304
0132-000,2013,7,12,23,402,358,760,1101
0132-000,2013,7,12,24,284,252,536,760
0132-000,2013,7,13,1,207,204,411,536
0132-000,2013,7,13,2,161,149,310,411
0132-000,2013,7,13,3,85,121,206,310
0132-000,2013,7,13,4,80,128,208,206
0132-000,2013,7,13,5,105,125,230,208
0132-000,2013,7,13,6,161,157,318,230
0132-000,2013,7,13,7,323,287,610,318
0132-000,2013,7,13,8,440,770,1210,610
0132-000,2013,7,13,9,575,832,1407,1210
0132-000,2013,7,13,10,618,774,1392,1407
0132-000,2013,7,13,11,643,862,1505,1392
0132-000,2013,7,13,12,753,1051,1804,1505
0132-000,2013,7,13,13,741,1190,1931,1804
0132-000,2013,7,13,14,757,1070,1827,1931
0132-000,2013,7,13,15,801,929,1730,1827
0132-000,2013,7,13,16,845,1037,1882,1730
0132-000,2013,7,13,17,888,902,1790,1882
0132-000,2013,7,13,18,986,1008,1994,1790
0132-000,2013,7,13,19,934,847,1781,1994
0132-000,2013,7,13,20,685,550,1235,1781
0132-000,2013,7,13,21,591,537,1128,1235
0132-000,2013,7,13,22,500,450,950,1128
0132-000,2013,7,13,23,342,321,663,950
0132-000,2013,7,13,24,222,207,429,663
0132-000,2013,7,14,1,184,171,355,429
0132-000,2013,7,14,2,141,148,289,355
0132-000,2013,7,14,3,83,96,179,289
0132-000,2013,7,14,4,74,79,153,179
0132-000,2013,7,14,5,80,97,177,153
0132-000,2013,7,14,6,116,106,222,177
0132-000,2013,7,14,7,184,206,390,222
0132-000,2013,7,14,8,230,346,576,390
0132-000,2013,7,14,9,381,419,800,576
0132-000,2013,7,14,10,417,455,872,800
0132-000,2013,7,14,11,469,543,1012,872
0132-000,2013,7,14,12,562,547,1109,1012
0132-000,2013,7,14,13,616,568,1184,1109
0132-000,2013,7,14,14,604,524,1128,1184
0132-000,2013,7,14,15,739,576,1315,1128
0132-000,2013,7,14,16,871,583,1454,1315
0132-000,2013,7,14,17,965,590,1555,1454
0132-000,2013,7,14,18,957,554,1511,1555
0132-000,2013,7,14,19,1019,543,1562,1511
0132-000,2013,7,14,20,840,479,1319,1562
0132-000,2013,7,14,21,643,431,1074,1319
0132-000,2013,7,14,22,483,381,864,1074
0132-000,2013,7,14,23,267,264,531,864
0132-000,2013,7,14,24,170,203,373,531
0132-000,2013,7,15,1,128,135,263,373
0132-000,2013,7,15,2,66,84,150,263
0132-000,2013,7,15,3,78,72,150,150
0132-000,2013,7,15,4,56,81,137,150
0132-000,2013,7,15,5,101,94,195,137
0132-000,2013,7,15,6,191,187,378,195
0132-000,2013,7,15,7,371,493,864,378
0132-000,2013,7,15,8,529,1429,1958,864
0132-000,2013,7,15,9,689,1052,1741,1958
0132-000,2013,7,15,10,656,739,1395,1741
0132-000,2013,7,15,11,695,664,1359,1395
0132-000,2013,7,15,12,693,792,1485,1359
0132-000,2013,7,15,13,709,721,1430,1485
0132-000,2013,7,15,14,747,713,1460,1430
0132-000,2013,7,15,15,737,803,1540,1460
0132-000,2013,7,15,16,817,766,1583,1540
0132-000,2013,7,15,17,788,741,1529,1583
0132-000,2013,7,15,18,882,798,1680,1529
0132-000,2013,7,15,19,955,725,1680,1680
0132-000,2013,7,15,20,786,596,1382,1680
0132-000,2013,7,15,21,716,500,1216,1382
0132-000,2013,7,15,22,543,422,965,1216
0132-000,2013,7,15,23,321,304,625,965
0132-000,2013,7,15,24,255,208,463,625
0132-000,2013,7,16,1,155,162,317,463
0132-000,2013,7,16,2,105,108,213,317
0132-000,2013,7,16,3,72,88,160,213
0132-000,2013,7,16,4,49,94,143,160
0132-000,2013,7,16,5,110,114,224,143
0132-000,2013,7,16,6,186,191,377,224
0132-000,2013,7,16,7,363,482,845,377
0132-000,2013,7,16,8,610,1453,2063,845
0132-000,2013,7,16,9,647,1034,1681,2063
0132-000,2013,7,16,10,693,794,1487,1681
0132-000,2013,7,16,11,734,780,1514,1487
0132-000,2013,7,16,12,826,844,1670,1514
0132-000,2013,7,16,13,672,739,1411,1670
0132-000,2013,7,16,14,799,806,1605,1411
0132-000,2013,7,16,15,790,766,1556,1605
0132-000,2013,7,16,16,849,771,1620,1556
0132-000,2013,7,16,17,805,784,1589,1620
0132-000,2013,7,16,18,942,827,1769,1589
0132-000,2013,7,16,19,1011,783,1794,1769
0132-000,2013,7,16,20,813,597,1410,1794
0132-000,2013,7,16,21,695,479,1174,1410
0132-000,2013,7,16,22,595,484,1079,1174
0132-000,2013,7,16,23,367,309,676,1079
0132-000,2013,7,16,24,232,198,430,676
0132-000,2013,7,17,1,197,164,361,430
0132-000,2013,7,17,2,114,113,227,361
0132-000,2013,7,17,3,82,90,172,227
0132-000,2013,7,17,4,78,97,175,172
0132-000,2013,7,17,5,74,62,136,175
0132-000,2013,7,17,6,151,126,277,136
0132-000,2013,7,17,7,296,368,664,277
0132-000,2013,7,17,8,560,1347,1907,664
0132-000,2013,7,17,9,641,1120,1761,1907
0132-000,2013,7,17,10,643,724,1367,1761
0132-000,2013,7,17,11,680,745,1425,1367
0132-000,2013,7,17,12,718,786,1504,1425
0132-000,2013,7,17,13,666,743,1409,1504
0132-000,2013,7,17,14,714,752,1466,1409
0132-000,2013,7,17,15,749,735,1484,1466
0132-000,2013,7,17,16,763,753,1516,1484
0132-000,2013,7,17,17,790,752,1542,1516
0132-000,2013,7,17,18,871,760,1631,1542
0132-000,2013,7,17,19,991,736,1727,1631
0132-000,2013,7,17,20,759,595,1354,1727
0132-000,2013,7,17,21,641,499,1140,1354
0132-000,2013,7,17,22,508,380,888,1140
0132-000,2013,7,17,23,327,309,636,888
0132-000,2013,7,17,24,199,201,400,636
0132-000,2013,7,18,1,164,161,325,400
0132-000,2013,7,18,2,110,110,220,325
0132-000,2013,7,18,3,80,90,170,220
0132-000,2013,7,18,4,66,97,163,170
0132-000,2013,7,18,5,91,103,194,163
0132-000,2013,7,18,6,161,165,326,194
0132-000,2013,7,18,7,332,397,729,326
0132-000,2013,7,18,8,535,1195,1730,729
0132-000,2013,7,18,9,649,1018,1667,1730
0132-000,2013,7,18,10,664,796,1460,1667
0132-000,2013,7,18,11,699,796,1495,1460
0132-000,2013,7,18,12,724,860,1584,1495
0132-000,2013,7,18,13,722,850,1572,1584
0132-000,2013,7,18,14,701,861,1562,1572
0132-000,2013,7,18,15,763,804,1567,1562
0132-000,2013,7,18,16,776,791,1567,1567
0132-000,2013,7,18,17,801,803,1604,1567
0132-000,2013,7,18,18,1008,795,1803,1604
0132-000,2013,7,18,19,1041,746,1787,1803
0132-000,2013,7,18,20,764,607,1371,1787
0132-000,2013,7,18,21,695,503,1198,1371
0132-000,2013,7,18,22,595,420,1015,1198
0132-000,2013,7,18,23,367,295,662,1015
0132-000,2013,7,18,24,234,216,450,662
0132-000,2013,7,19,1,205,182,387,450
0132-000,2013,7,19,2,126,104,230,387
0132-000,2013,7,19,3,101,104,205,230
0132-000,2013,7,19,4,76,117,193,205
0132-000,2013,7,19,5,80,122,202,193
0132-000,2013,7,19,6,191,163,354,202
0132-000,2013,7,19,7,375,483,858,354
0132-000,2013,7,19,8,579,1574,2153,858
0132-000,2013,7,19,9,693,1010,1703,2153
0132-000,2013,7,19,10,612,737,1349,1703
0132-000,2013,7,19,11,678,671,1349,1349
0132-000,2013,7,19,12,730,707,1437,1349
0132-000,2013,7,19,13,703,669,1372,1437
0132-000,2013,7,19,14,788,781,1569,1372
0132-000,2013,7,19,15,820,787,1607,1569
0132-000,2013,7,19,16,844,849,1693,1607
0132-000,2013,7,19,17,909,793,1702,1693
0132-000,2013,7,19,18,1127,822,1949,1702
0132-000,2013,7,19,19,1274,879,2153,1949
0132-000,2013,7,19,20,940,735,1675,2153
0132-000,2013,7,19,21,836,611,1447,1675
0132-000,2013,7,19,22,629,574,1203,1447
0132-000,2013,7,19,23,404,374,778,1203
0132-000,2013,7,19,24,330,261,591,778
0132-000,2013,7,20,1,218,223,441,591
0132-000,2013,7,20,2,143,150,293,441
0132-000,2013,7,20,3,110,131,241,293
0132-000,2013,7,20,4,107,119,226,241
0132-000,2013,7,20,5,99,133,232,226
0132-000,2013,7,20,6,178,198,376,232
0132-000,2013,7,20,7,327,380,707,376
0132-000,2013,7,20,8,489,786,1275,707
0132-000,2013,7,20,9,587,773,1360,1275
0132-000,2013,7,20,10,614,924,1538,1360
0132-000,2013,7,20,11,645,1112,1757,1538
0132-000,2013,7,20,12,763,1265,2028,1757
0132-000,2013,7,20,13,668,1244,1912,2028
0132-000,2013,7,20,14,720,1241,1961,1912
0132-000,2013,7,20,15,736,958,1694,1961
0132-000,2013,7,20,16,813,924,1737,1694
0132-000,2013,7,20,17,865,957,1822,1737
0132-000,2013,7,20,18,1059,856,1915,1822
0132-000,2013,7,20,19,979,791,1770,1915
0132-000,2013,7,20,20,739,631,1370,1770
0132-000,2013,7,20,21,658,490,1148,1370
0132-000,2013,7,20,22,498,463,961,1148
0132-000,2013,7,20,23,392,366,758,961
0132-000,2013,7,20,24,218,231,449,758
0132-000,2013,7,21,1,163,190,353,449
0132-000,2013,7,21,2,120,134,254,353
0132-000,2013,7,21,3,87,94,181,254
0132-000,2013,7,21,4,89,77,166,181
0132-000,2013,7,21,5,70,107,177,166
0132-000,2013,7,21,6,143,144,287,177
0132-000,2013,7,21,7,238,256,494,287
0132-000,2013,7,21,8,247,480,727,494
0132-000,2013,7,21,9,338,506,844,727
0132-000,2013,7,21,10,458,512,970,844
0132-000,2013,7,21,11,481,538,1019,970
0132-000,2013,7,21,12,514,537,1051,1019
0132-000,2013,7,21,13,612,637,1249,1051
0132-000,2013,7,21,14,658,639,1297,1249
0132-000,2013,7,21,15,714,640,1354,1297
0132-000,2013,7,21,16,720,574,1294,1354
0132-000,2013,7,21,17,981,659,1640,1294
0132-000,2013,7,21,18,989,550,1539,1640
0132-000,2013,7,21,19,853,493,1346,1539
0132-000,2013,7,21,20,801,451,1252,1346
0132-000,2013,7,21,21,799,480,1279,1252
0132-000,2013,7,21,22,489,349,838,1279
0132-000,2013,7,21,23,292,288,580,838
0132-000,2013,7,21,24,191,184,375,580
0132-000,2013,7,22,1,145,131,276,375
0132-000,2013,7,22,2,85,83,168,276
0132-000,2013,7,22,3,68,61,129,168
0132-000,2013,7,22,4,49,79,128,129
0132-000,2013,7,22,5,78,81,159,128
0132-000,2013,7,22,6,120,156,276,159
0132-000,2013,7,22,7,396,432,828,276
0132-000,2013,7,22,8,529,1228,1757,828
0132-000,2013,7,22,9,712,956,1668,1757
0132-000,2013,7,22,10,680,708,1388,1668
0132-000,2013,7,22,11,627,646,1273,1388
0132-000,2013,7,22,12,761,681,1442,1273
0132-000,2013,7,22,13,635,681,1316,1442
0132-000,2013,7,22,14,728,773,1501,1316
0132-000,2013,7,22,15,782,754,1536,1501
0132-000,2013,7,22,16,807,774,1581,1536
0132-000,2013,7,22,17,836,662,1498,1581
0132-000,2013,7,22,18,900,719,1619,1498
0132-000,2013,7,22,19,1006,692,1698,1619
0132-000,2013,7,22,20,803,572,1375,1698
0132-000,2013,7,22,21,722,495,1217,1375
0132-000,2013,7,22,22,591,417,1008,1217
0132-000,2013,7,22,23,350,308,658,1008
0132-000,2013,7,22,24,242,172,414,658
0132-000,2013,7,23,1,164,159,323,414
0132-000,2013,7,23,2,103,105,208,323
0132-000,2013,7,23,3,82,83,165,208
0132-000,2013,7,23,4,80,100,180,165
0132-000,2013,7,23,5,82,104,186,180
0132-000,2013,7,23,6,149,143,292,186
0132-000,2013,7,23,7,354,444,798,292
0132-000,2013,7,23,8,529,1168,1697,798
0132-000,2013,7,23,9,707,924,1631,1697
0132-000,2013,7,23,10,693,702,1395,1631
0132-000,2013,7,23,11,656,607,1263,1395
0132-000,2013,7,23,12,676,636,1312,1263
0132-000,2013,7,23,13,643,601,1244,1312
0132-000,2013,7,23,14,676,657,1333,1244
0132-000,2013,7,23,15,795,673,1468,1333
0132-000,2013,7,23,16,776,697,1473,1468
0132-000,2013,7,23,17,776,630,1406,1473
0132-000,2013,7,23,18,917,629,1546,1406
0132-000,2013,7,23,19,966,597,1563,1546
0132-000,2013,7,23,20,739,527,1266,1563
0132-000,2013,7,23,21,710,437,1147,1266
0132-000,2013,7,23,22,471,395,866,1147
0132-000,2013,7,23,23,338,285,623,866
0132-000,2013,7,23,24,207,181,388,623
0132-000,2013,7,24,1,153,171,324,388
0132-000,2013,7,24,2,116,95,211,324
0132-000,2013,7,24,3,89,111,200,211
0132-000,2013,7,24,4,83,108,191,200
0132-000,2013,7,24,5,99,85,184,191
0132-000,2013,7,24,6,166,135,301,184
0132-000,2013,7,24,7,327,340,667,301
0132-000,2013,7,24,8,575,1122,1697,667
0132-000,2013,7,24,9,678,993,1671,1697
0132-000,2013,7,24,10,664,694,1358,1671
0132-000,2013,7,24,11,720,712,1432,1358
0132-000,2013,7,24,12,703,676,1379,1432
0132-000,2013,7,24,13,722,666,1388,1379
0132-000,2013,7,24,14,764,617,1381,1388
0132-000,2013,7,24,15,813,677,1490,1381
0132-000,2013,7,24,16,845,726,1571,1490
0132-000,2013,7,24,17,832,642,1474,1571
0132-000,2013,7,24,18,959,677,1636,1474
0132-000,2013,7,24,19,1086,755,1841,1636
0132-000,2013,7,24,20,784,560,1344,1841
0132-000,2013,7,24,21,714,515,1229,1344
0132-000,2013,7,24,22,564,449,1013,1229
0132-000,2013,7,24,23,367,329,696,1013
0132-000,2013,7,24,24,234,206,440,696
0132-000,2013,7,25,1,141,171,312,440
0132-000,2013,7,25,2,112,127,239,312
0132-000,2013,7,25,3,78,94,172,239
0132-000,2013,7,25,4,83,114,197,172
0132-000,2013,7,25,5,95,101,196,197
0132-000,2013,7,25,6,157,154,311,196
0132-000,2013,7,25,7,398,459,857,311
0132-000,2013,7,25,8,572,1301,1873,857
0132-000,2013,7,25,9,707,970,1677,1873
0132-000,2013,7,25,10,720,722,1442,1677
0132-000,2013,7,25,11,658,669,1327,1442
0132-000,2013,7,25,12,753,723,1476,1327
0132-000,2013,7,25,13,720,704,1424,1476
0132-000,2013,7,25,14,720,813,1533,1424
0132-000,2013,7,25,15,778,791,1569,1533
0132-000,2013,7,25,16,830,803,1633,1569
0132-000,2013,7,25,17,859,768,1627,1633
0132-000,2013,7,25,18,981,745,1726,1627
0132-000,2013,7,25,19,1020,721,1741,1726
0132-000,2013,7,25,20,797,572,1369,1741
0132-000,2013,7,25,21,757,491,1248,1369
0132-000,2013,7,25,22,635,451,1086,1248
0132-000,2013,7,25,23,365,327,692,1086
0132-000,2013,7,25,24,242,225,467,692
0132-000,2013,7,26,1,151,172,323,467
0132-000,2013,7,26,2,112,132,244,323
0132-000,2013,7,26,3,99,105,204,244
0132-000,2013,7,26,4,74,123,197,204
0132-000,2013,7,26,5,95,112,207,197
0132-000,2013,7,26,6,176,161,337,207
0132-000,2013,7,26,7,371,495,866,337
0132-000,2013,7,26,8,525,1286,1811,866
0132-000,2013,7,26,9,693,898,1591,1811
0132-000,2013,7,26,10,641,686,1327,1591
0132-000,2013,7,26,11,716,769,1485,1327
0132-000,2013,7,26,12,726,715,1441,1485
0132-000,2013,7,26,13,770,756,1526,1441
0132-000,2013,7,26,14,770,771,1541,1526
0132-000,2013,7,26,15,842,861,1703,1541
0132-000,2013,7,26,16,882,860,1742,1703
0132-000,2013,7,26,17,903,881,1784,1742
0132-000,2013,7,26,18,1083,881,1964,1784
0132-000,2013,7,26,19,1221,1000,2221,1964
0132-000,2013,7,26,20,921,881,1802,2221
0132-000,2013,7,26,21,869,696,1565,1802
0132-000,2013,7,26,22,622,589,1211,1565
0132-000,2013,7,26,23,408,416,824,1211
0132-000,2013,7,26,24,263,244,507,824
0132-000,2013,7,27,1,203,212,415,507
0132-000,2013,7,27,2,161,147,308,415
0132-000,2013,7,27,3,130,126,256,308
0132-000,2013,7,27,4,109,133,242,256
0132-000,2013,7,27,5,110,123,233,242
0132-000,2013,7,27,6,191,195,386,233
0132-000,2013,7,27,7,307,330,637,386
0132-000,2013,7,27,8,479,693,1172,637
0132-000,2013,7,27,9,577,1009,1586,1172
0132-000,2013,7,27,10,643,1365,2008,1586
0132-000,2013,7,27,11,680,1303,1983,2008
0132-000,2013,7,27,12,747,1587,2334,1983
0132-000,2013,7,27,13,732,1648,2380,2334
0132-000,2013,7,27,14,674,1653,2327,2380
0132-000,2013,7,27,15,728,1333,2061,2327
0132-000,2013,7,27,16,701,1154,1855,2061
0132-000,2013,7,27,17,845,1129,1974,1855
0132-000,2013,7,27,18,976,896,1872,1974
0132-000,2013,7,27,19,928,955,1883,1872
0132-000,2013,7,27,20,666,560,1226,1883
0132-000,2013,7,27,21,620,517,1137,1226
0132-000,2013,7,27,22,448,448,896,1137
0132-000,2013,7,27,23,352,365,717,896
0132-000,2013,7,27,24,199,196,395,717
0132-000,2013,7,28,1,163,139,302,395
0132-000,2013,7,28,2,105,113,218,302
0132-000,2013,7,28,3,109,107,216,218
0132-000,2013,7,28,4,68,76,144,216
0132-000,2013,7,28,5,85,75,160,144
0132-000,2013,7,28,6,105,112,217,160
0132-000,2013,7,28,7,186,200,386,217
0132-000,2013,7,28,8,249,310,559,386
0132-000,2013,7,28,9,340,365,705,559
0132-000,2013,7,28,10,423,421,844,705
0132-000,2013,7,28,11,438,487,925,844
0132-000,2013,7,28,12,479,525,1004,925
0132-000,2013,7,28,13,519,566,1085,1004
0132-000,2013,7,28,14,604,556,1160,1085
0132-000,2013,7,28,15,691,573,1264,1160
0132-000,2013,7,28,16,734,560,1294,1264
0132-000,2013,7,28,17,788,574,1362,1294
0132-000,2013,7,28,18,788,540,1328,1362
0132-000,2013,7,28,19,792,501,1293,1328
0132-000,2013,7,28,20,678,416,1094,1293
0132-000,2013,7,28,21,718,384,1102,1094
0132-000,2013,7,28,22,382,340,722,1102
0132-000,2013,7,28,23,311,283,594,722
0132-000,2013,7,28,24,134,149,283,594
0132-000,2013,7,29,1,114,138,252,283
0132-000,2013,7,29,2,82,82,164,252
0132-000,2013,7,29,3,56,69,125,164
0132-000,2013,7,29,4,47,68,115,125
0132-000,2013,7,29,5,85,84,169,115
0132-000,2013,7,29,6,168,153,321,169
0132-000,2013,7,29,7,390,386,776,321
0132-000,2013,7,29,8,539,1080,1619,776
0132-000,2013,7,29,9,600,900,1500,1619
0132-000,2013,7,29,10,664,749,1413,1500
0132-000,2013,7,29,11,674,741,1415,1413
0132-000,2013,7,29,12,724,723,1447,1415
0132-000,2013,7,29,13,683,714,1397,1447
0132-000,2013,7,29,14,747,713,1460,1397
0132-000,2013,7,29,15,728,705,1433,1460
0132-000,2013,7,29,16,795,784,1579,1433
0132-000,2013,7,29,17,780,745,1525,1579
0132-000,2013,7,29,18,946,731,1677,1525
0132-000,2013,7,29,19,1024,756,1780,1677
0132-000,2013,7,29,20,651,522,1173,1780
0132-000,2013,7,29,21,693,497,1190,1173
0132-000,2013,7,29,22,518,435,953,1190
0132-000,2013,7,29,23,301,328,629,953
0132-000,2013,7,29,24,232,198,430,629
0132-000,2013,7,30,1,149,141,290,430
0132-000,2013,7,30,2,105,103,208,290
0132-000,2013,7,30,3,93,94,187,208
0132-000,2013,7,30,4,70,98,168,187
0132-000,2013,7,30,5,80,108,188,168
0132-000,2013,7,30,6,199,170,369,188
0132-000,2013,7,30,7,309,430,739,369
0132-000,2013,7,30,8,545,1071,1616,739
0132-000,2013,7,30,9,654,1010,1664,1616
0132-000,2013,7,30,10,658,673,1331,1664
0132-000,2013,7,30,11,685,716,1401,1331
0132-000,2013,7,30,12,705,750,1455,1401
0132-000,2013,7,30,13,707,723,1430,1455
0132-000,2013,7,30,14,782,999,1781,1430
0132-000,2013,7,30,15,845,905,1750,1781
0132-000,2013,7,30,16,809,767,1576,1750
0132-000,2013,7,30,17,849,798,1647,1576
0132-000,2013,7,30,18,940,743,1683,1647
0132-000,2013,7,30,19,1110,810,1920,1683
0132-000,2013,7,30,20,701,564,1265,1920
0132-000,2013,7,30,21,639,552,1191,1265
0132-000,2013,7,30,22,533,397,930,1191
0132-000,2013,7,30,23,357,359,716,930
0132-000,2013,7,30,24,228,215,443,716
0132-000,2013,7,31,1,166,164,330,443
0132-000,2013,7,31,2,107,106,213,330
0132-000,2013,7,31,3,78,87,165,213
0132-000,2013,7,31,4,87,94,181,165
0132-000,2013,7,31,5,82,89,171,181
0132-000,2013,7,31,6,145,112,257,171
0132-000,2013,7,31,7,294,309,603,257
0132-000,2013,7,31,8,477,928,1405,603
0132-000,2013,7,31,9,612,831,1443,1405
0132-000,2013,7,31,10,610,704,1314,1443
0132-000,2013,7,31,11,643,747,1390,1314
0132-000,2013,7,31,12,643,735,1378,1390
0132-000,2013,7,31,13,697,730,1427,1378
0132-000,2013,7,31,14,776,846,1622,1427
0132-000,2013,7,31,15,710,860,1570,1622
0132-000,2013,7,31,16,745,866,1611,1570
0132-000,2013,7,31,17,815,823,1638,1611
0132-000,2013,7,31,18,932,754,1686,1638
0132-000,2013,7,31,19,1042,711,1753,1686
0132-000,2013,7,31,20,772,615,1387,1753
0132-000,2013,7,31,21,610,553,1163,1387
0132-000,2013,7,31,22,473,435,908,1163
0132-000,2013,7,31,23,371,313,684,908
0132-000,2013,7,31,24,240,230,470,684
0132-000,2013,8,1,1,202,199,401,470
0132-000,2013,8,1,2,128,132,260,401
0132-000,2013,8,1,3,103,92,195,260
0132-000,2013,8,1,4,100,104,204,195
0132-000,2013,8,1,5,114,107,221,204
0132-000,2013,8,1,6,188,184,372,221
0132-000,2013,8,1,7,373,389,762,372
0132-000,2013,8,1,8,649,1198,1847,762
0132-000,2013,8,1,9,806,1143,1949,1847
0132-000,2013,8,1,10,780,857,1637,1949
0132-000,2013,8,1,11,785,968,1753,1637
0132-000,2013,8,1,12,795,1078,1873,1753
0132-000,2013,8,1,13,831,1152,1983,1873
0132-000,2013,8,1,14,832,1247,2079,1983
0132-000,2013,8,1,15,910,1313,2223,2079
0132-000,2013,8,1,16,945,1137,2082,2223
0132-000,2013,8,1,17,963,1043,2006,2082
0132-000,2013,8,1,18,1097,956,2053,2006
0132-000,2013,8,1,19,1182,955,2137,2053
0132-000,2013,8,1,20,960,820,1780,2137
0132-000,2013,8,1,21,770,623,1393,1780
0132-000,2013,8,1,22,616,518,1134,1393
0132-000,2013,8,1,23,432,401,833,1134
0132-000,2013,8,1,24,289,271,560,833
0132-000,2013,8,2,1,208,185,393,560
0132-000,2013,8,2,2,120,138,258,393
0132-000,2013,8,2,3,103,99,202,258
0132-000,2013,8,2,4,98,100,198,202
0132-000,2013,8,2,5,129,128,257,198
0132-000,2013,8,2,6,211,183,394,257
0132-000,2013,8,2,7,415,404,819,394
0132-000,2013,8,2,8,649,1154,1803,819
0132-000,2013,8,2,9,755,1147,1902,1803
0132-000,2013,8,2,10,753,870,1623,1902
0132-000,2013,8,2,11,819,879,1698,1623
0132-000,2013,8,2,12,874,915,1789,1698
0132-000,2013,8,2,13,833,959,1792,1789
0132-000,2013,8,2,14,891,1015,1906,1792
0132-000,2013,8,2,15,995,994,1989,1906
0132-000,2013,8,2,16,1035,971,2006,1989
0132-000,2013,8,2,17,1048,1037,2085,2006
0132-000,2013,8,2,18,1328,1064,2392,2085
0132-000,2013,8,2,19,1419,1164,2583,2392
0132-000,2013,8,2,20,1204,1068,2272,2583
0132-000,2013,8,2,21,939,824,1763,2272
0132-000,2013,8,2,22,818,738,1556,1763
0132-000,2013,8,2,23,509,580,1089,1556
0132-000,2013,8,2,24,324,430,754,1089
0132-000,2013,8,3,1,240,390,630,754
0132-000,2013,8,3,2,186,211,397,630
0132-000,2013,8,3,3,131,132,263,397
0132-000,2013,8,3,4,125,139,264,263
0132-000,2013,8,3,5,149,137,286,264
0132-000,2013,8,3,6,206,204,410,286
0132-000,2013,8,3,7,335,343,678,410
0132-000,2013,8,3,8,514,737,1251,678
0132-000,2013,8,3,9,692,1082,1774,1251
0132-000,2013,8,3,10,708,1363,2071,1774
0132-000,2013,8,3,11,785,1644,2429,2071
0132-000,2013,8,3,12,790,1684,2474,2429
0132-000,2013,8,3,13,826,1635,2461,2474
0132-000,2013,8,3,14,849,1484,2333,2461
0132-000,2013,8,3,15,870,1387,2257,2333
0132-000,2013,8,3,16,941,1359,2300,2257
0132-000,2013,8,3,17,1023,1321,2344,2300
0132-000,2013,8,3,18,1147,1379,2526,2344
0132-000,2013,8,3,19,1127,1391,2518,2526
0132-000,2013,8,3,20,962,1102,2064,2518
0132-000,2013,8,3,21,808,643,1451,2064
0132-000,2013,8,3,22,749,509,1258,1451
0132-000,2013,8,3,23,485,389,874,1258
0132-000,2013,8,3,24,321,290,611,874
0132-000,2013,8,4,1,185,220,405,611
0132-000,2013,8,4,2,164,158,322,405
0132-000,2013,8,4,3,105,107,212,322
0132-000,2013,8,4,4,115,94,209,212
0132-000,2013,8,4,5,103,96,199,209
0132-000,2013,8,4,6,150,153,303,199
0132-000,2013,8,4,7,235,229,464,303
0132-000,2013,8,4,8,319,396,715,464
0132-000,2013,8,4,9,397,508,905,715
0132-000,2013,8,4,10,487,630,1117,905
0132-000,2013,8,4,11,619,749,1368,1117
0132-000,2013,8,4,12,595,742,1337,1368
0132-000,2013,8,4,13,695,748,1443,1337
0132-000,2013,8,4,14,767,750,1517,1443
0132-000,2013,8,4,15,896,714,1610,1517
0132-000,2013,8,4,16,1144,789,1933,1610
0132-000,2013,8,4,17,1247,790,2037,1933
0132-000,2013,8,4,18,1414,818,2232,2037
0132-000,2013,8,4,19,1381,859,2240,2232
0132-000,2013,8,4,20,1178,600,1778,2240
0132-000,2013,8,4,21,879,556,1435,1778
0132-000,2013,8,4,22,769,484,1253,1435
0132-000,2013,8,4,23,413,371,784,1253
0132-000,2013,8,4,24,261,243,504,784
0132-000,2013,8,5,1,163,157,320,504
0132-000,2013,8,5,2,98,106,204,320
0132-000,2013,8,5,3,87,68,155,204
0132-000,2013,8,5,4,68,105,173,155
0132-000,2013,8,5,5,121,113,234,173
0132-000,2013,8,5,6,212,190,402,234
0132-000,2013,8,5,7,418,606,1024,402
0132-000,2013,8,5,8,693,1374,2067,1024
0132-000,2013,8,5,9,768,1186,1954,2067
0132-000,2013,8,5,10,754,883,1637,1954
0132-000,2013,8,5,11,772,906,1678,1637
0132-000,2013,8,5,12,874,950,1824,1678
0132-000,2013,8,5,13,807,893,1700,1824
0132-000,2013,8,5,14,851,959,1810,1700
0132-000,2013,8,5,15,911,948,1859,1810
0132-000,2013,8,5,16,935,901,1836,1859
0132-000,2013,8,5,17,1008,864,1872,1836
0132-000,2013,8,5,18,1130,867,1997,1872
0132-000,2013,8,5,19,1194,801,1995,1997
0132-000,2013,8,5,20,957,714,1671,1995
0132-000,2013,8,5,21,768,565,1333,1671
0132-000,2013,8,5,22,591,470,1061,1333
0132-000,2013,8,5,23,387,351,738,1061
0132-000,2013,8,5,24,258,209,467,738
0132-000,2013,8,6,1,183,170,353,467
0132-000,2013,8,6,2,112,120,232,353
0132-000,2013,8,6,3,103,89,192,232
0132-000,2013,8,6,4,70,100,170,192
0132-000,2013,8,6,5,116,109,225,170
0132-000,2013,8,6,6,222,186,408,225
0132-000,2013,8,6,7,401,408,809,408
0132-000,2013,8,6,8,643,1246,1889,809
0132-000,2013,8,6,9,741,1124,1865,1889
0132-000,2013,8,6,10,814,901,1715,1865
0132-000,2013,8,6,11,803,850,1653,1715
0132-000,2013,8,6,12,857,916,1773,1653
0132-000,2013,8,6,13,799,894,1693,1773
0132-000,2013,8,6,14,862,992,1854,1693
0132-000,2013,8,6,15,900,1038,1938,1854
0132-000,2013,8,6,16,1005,865,1870,1938
0132-000,2013,8,6,17,1090,886,1976,1870
0132-000,2013,8,6,18,1275,884,2159,1976
0132-000,2013,8,6,19,1337,946,2283,2159
0132-000,2013,8,6,20,1140,789,1929,2283
0132-000,2013,8,6,21,903,589,1492,1929
0132-000,2013,8,6,22,679,493,1172,1492
0132-000,2013,8,6,23,453,371,824,1172
0132-000,2013,8,6,24,300,275,575,824
0132-000,2013,8,7,1,219,201,420,575
0132-000,2013,8,7,2,137,147,284,420
0132-000,2013,8,7,3,106,99,205,284
0132-000,2013,8,7,4,99,92,191,205
0132-000,2013,8,7,5,94,105,199,191
0132-000,2013,8,7,6,197,188,385,199
0132-000,2013,8,7,7,420,491,911,385
0132-000,2013,8,7,8,616,1340,1956,911
0132-000,2013,8,7,9,803,1275,2078,1956
0132-000,2013,8,7,10,775,901,1676,2078
0132-000,2013,8,7,11,782,898,1680,1676
0132-000,2013,8,7,12,843,846,1689,1680
0132-000,2013,8,7,13,778,844,1622,1689
0132-000,2013,8,7,14,850,886,1736,1622
0132-000,2013,8,7,15,895,906,1801,1736
0132-000,2013,8,7,16,996,909,1905,1801
0132-000,2013,8,7,17,1072,870,1942,1905
0132-000,2013,8,7,18,1266,879,2145,1942
0132-000,2013,8,7,19,1515,981,2496,2145
0132-000,2013,8,7,20,1332,724,2056,2496
0132-000,2013,8,7,21,993,576,1569,2056
0132-000,2013,8,7,22,693,527,1220,1569
0132-000,2013,8,7,23,421,381,802,1220
0132-000,2013,8,7,24,284,211,495,802
0132-000,2013,8,8,1,189,193,382,495
0132-000,2013,8,8,2,133,151,284,382
0132-000,2013,8,8,3,102,106,208,284
0132-000,2013,8,8,4,78,95,173,208
0132-000,2013,8,8,5,117,113,230,173
0132-000,2013,8,8,6,197,184,381,230
0132-000,2013,8,8,7,390,477,867,381
0132-000,2013,8,8,8,674,1319,1993,867
0132-000,2013,8,8,9,813,1313,2126,1993
0132-000,2013,8,8,10,782,934,1716,2126
0132-000,2013,8,8,11,836,923,1759,1716
0132-000,2013,8,8,12,899,889,1788,1759
0132-000,2013,8,8,13,822,854,1676,1788
0132-000,2013,8,8,14,835,906,1741,1676
0132-000,2013,8,8,15,932,925,1857,1741
0132-000,2013,8,8,16,940,942,1882,1857
0132-000,2013,8,8,17,1034,877,1911,1882
0132-000,2013,8,8,18,1120,855,1975,1911
0132-000,2013,8,8,19,1239,913,2152,1975
0132-000,2013,8,8,20,879,694,1573,2152
0132-000,2013,8,8,21,821,636,1457,1573
0132-000,2013,8,8,22,651,522,1173,1457
0132-000,2013,8,8,23,391,354,745,1173
0132-000,2013,8,8,24,271,269,540,745
0132-000,2013,8,9,1,202,185,387,540
0132-000,2013,8,9,2,140,140,280,387
0132-000,2013,8,9,3,105,106,211,280
0132-000,2013,8,9,4,86,95,181,211
0132-000,2013,8,9,5,122,125,247,181
0132-000,2013,8,9,6,202,202,404,247
0132-000,2013,8,9,7,407,497,904,404
0132-000,2013,8,9,8,672,1412,2084,904
0132-000,2013,8,9,9,826,1365,2191,2084
0132-000,2013,8,9,10,802,966,1768,2191
0132-000,2013,8,9,11,811,928,1739,1768
0132-000,2013,8,9,12,891,901,1792,1739
0132-000,2013,8,9,13,861,905,1766,1792
0132-000,2013,8,9,14,890,963,1853,1766
0132-000,2013,8,9,15,933,1009,1942,1853
0132-000,2013,8,9,16,1091,1046,2137,1942
0132-000,2013,8,9,17,1092,1019,2111,2137
0132-000,2013,8,9,18,1291,1008,2299,2111
0132-000,2013,8,9,19,1428,1024,2452,2299
0132-000,2013,8,9,20,1130,900,2030,2452
0132-000,2013,8,9,21,957,727,1684,2030
0132-000,2013,8,9,22,817,586,1403,1684
0132-000,2013,8,9,23,475,457,932,1403
0132-000,2013,8,9,24,350,324,674,932
0132-000,2013,8,10,1,227,266,493,674
0132-000,2013,8,10,2,167,194,361,493
0132-000,2013,8,10,3,144,142,286,361
0132-000,2013,8,10,4,106,137,243,286
0132-000,2013,8,10,5,146,155,301,243
0132-000,2013,8,10,6,218,185,403,301
0132-000,2013,8,10,7,353,386,739,403
0132-000,2013,8,10,8,564,840,1404,739
0132-000,2013,8,10,9,721,964,1685,1404
0132-000,2013,8,10,10,773,951,1724,1685
0132-000,2013,8,10,11,805,1240,2045,1724
0132-000,2013,8,10,12,852,1354,2206,2045
0132-000,2013,8,10,13,899,1406,2305,2206
0132-000,2013,8,10,14,935,1351,2286,2305
0132-000,2013,8,10,15,982,1127,2109,2286
0132-000,2013,8,10,16,1066,1095,2161,2109
0132-000,2013,8,10,17,1191,987,2178,2161
0132-000,2013,8,10,18,1393,1062,2455,2178
0132-000,2013,8,10,19,1283,891,2174,2455
0132-000,2013,8,10,20,1133,754,1887,2174
0132-000,2013,8,10,21,770,552,1322,1887
0132-000,2013,8,10,22,738,492,1230,1322
0132-000,2013,8,10,23,400,400,800,1230
0132-000,2013,8,10,24,291,293,584,800
0132-000,2013,8,11,1,201,236,437,584
0132-000,2013,8,11,2,169,151,320,437
0132-000,2013,8,11,3,128,125,253,320
0132-000,2013,8,11,4,108,103,211,253
0132-000,2013,8,11,5,95,103,198,211
0132-000,2013,8,11,6,148,142,290,198
0132-000,2013,8,11,7,231,231,462,290
0132-000,2013,8,11,8,320,365,685,462
0132-000,2013,8,11,9,430,467,897,685
0132-000,2013,8,11,10,481,527,1008,897
0132-000,2013,8,11,11,583,575,1158,1008
0132-000,2013,8,11,12,649,557,1206,1158
0132-000,2013,8,11,13,900,611,1511,1206
0132-000,2013,8,11,14,961,663,1624,1511
0132-000,2013,8,11,15,1095,611,1706,1624
0132-000,2013,8,11,16,1120,672,1792,1706
0132-000,2013,8,11,17,1213,681,1894,1792
0132-000,2013,8,11,18,1281,693,1974,1894
0132-000,2013,8,11,19,1216,577,1793,1974
0132-000,2013,8,11,20,1060,548,1608,1793
0132-000,2013,8,11,21,783,487,1270,1608
0132-000,2013,8,11,22,679,425,1104,1270
0132-000,2013,8,11,23,359,324,683,1104
0132-000,2013,8,11,24,207,241,448,683
0132-000,2013,8,12,1,151,149,300,448
0132-000,2013,8,12,2,85,101,186,300
0132-000,2013,8,12,3,66,77,143,186
0132-000,2013,8,12,4,57,85,142,143
0132-000,2013,8,12,5,92,91,183,142
0132-000,2013,8,12,6,169,169,338,183
0132-000,2013,8,12,7,442,580,1022,338
0132-000,2013,8,12,8,723,1708,2431,1022
0132-000,2013,8,12,9,823,1399,2222,2431
0132-000,2013,8,12,10,815,944,1759,2222
0132-000,2013,8,12,11,844,962,1806,1759
0132-000,2013,8,12,12,860,953,1813,1806
0132-000,2013,8,12,13,818,904,1722,1813
0132-000,2013,8,12,14,898,918,1816,1722
0132-000,2013,8,12,15,969,979,1948,1816
0132-000,2013,8,12,16,1022,1030,2052,1948
0132-000,2013,8,12,17,1061,933,1994,2052
0132-000,2013,8,12,18,1114,905,2019,1994
0132-000,2013,8,12,19,1226,892,2118,2019
0132-000,2013,8,12,20,937,755,1692,2118
0132-000,2013,8,12,21,809,633,1442,1692
0132-000,2013,8,12,22,660,492,1152,1442
0132-000,2013,8,12,23,394,357,751,1152
0132-000,2013,8,12,24,258,251,509,751
0132-000,2013,8,13,1,201,172,373,509
0132-000,2013,8,13,2,124,123,247,373
0132-000,2013,8,13,3,102,126,228,247
0132-000,2013,8,13,4,110,109,219,228
0132-000,2013,8,13,5,109,111,220,219
0132-000,2013,8,13,6,219,190,409,220
0132-000,2013,8,13,7,414,513,927,409
0132-000,2013,8,13,8,734,1544,2278,927
0132-000,2013,8,13,9,862,1268,2130,2278
0132-000,2013,8,13,10,885,949,1834,2130
0132-000,2013,8,13,11,887,979,1866,1834
0132-000,2013,8,13,12,921,963,1884,1866
0132-000,2013,8,13,13,814,881,1695,1884
0132-000,2013,8,13,14,924,978,1902,1695
0132-000,2013,8,13,15,989,1078,2067,1902
0132-000,2013,8,13,16,1101,1007,2108,2067
0132-000,2013,8,13,17,1076,1035,2111,2108
0132-000,2013,8,13,18,1222,1020,2242,2111
0132-000,2013,8,13,19,1305,1074,2379,2242
0132-000,2013,8,13,20,1039,846,1885,2379
0132-000,2013,8,13,21,854,669,1523,1885
0132-000,2013,8,13,22,698,539,1237,1523
0132-000,2013,8,13,23,432,374,806,1237
0132-000,2013,8,13,24,319,286,605,806
0132-000,2013,8,14,1,232,208,440,605
0132-000,2013,8,14,2,180,157,337,440
0132-000,2013,8,14,3,118,111,229,337
0132-000,2013,8,14,4,113,108,221,229
0132-000,2013,8,14,5,131,111,242,221
0132-000,2013,8,14,6,170,164,334,242
0132-000,2013,8,14,7,356,346,702,334
0132-000,2013,8,14,8,563,1007,1570,702
0132-000,2013,8,14,9,772,1015,1787,1570
0132-000,2013,8,14,10,776,806,1582,1787
0132-000,2013,8,14,11,760,893,1653,1582
0132-000,2013,8,14,12,841,937,1778,1653
0132-000,2013,8,14,13,784,798,1582,1778
0132-000,2013,8,14,14,867,800,1667,1582
0132-000,2013,8,14,15,900,847,1747,1667
0132-000,2013,8,14,16,948,867,1815,1747
0132-000,2013,8,14,17,1040,805,1845,1815
0132-000,2013,8,14,18,1165,806,1971,1845
0132-000,2013,8,14,19,1166,811,1977,1971
0132-000,2013,8,14,20,809,640,1449,1977
0132-000,2013,8,14,21,659,498,1157,1449
0132-000,2013,8,14,22,515,422,937,1157
0132-000,2013,8,14,23,353,306,659,937
0132-000,2013,8,14,24,229,231,460,659
0132-000,2013,8,15,1,184,167,351,460
0132-000,2013,8,15,2,118,152,270,351
0132-000,2013,8,15,3,94,82,176,270
0132-000,2013,8,15,4,91,102,193,176
0132-000,2013,8,15,5,104,117,221,193
0132-000,2013,8,15,6,194,213,407,221
0132-000,2013,8,15,7,437,554,991,407
0132-000,2013,8,15,8,703,1525,2228,991
0132-000,2013,8,15,9,894,1323,2217,2228
0132-000,2013,8,15,10,825,953,1778,2217
0132-000,2013,8,15,11,918,954,1872,1778
0132-000,2013,8,15,12,924,936,1860,1872
0132-000,2013,8,15,13,860,907,1767,1860
0132-000,2013,8,15,14,948,982,1930,1767
0132-000,2013,8,15,15,1015,1081,2096,1930
0132-000,2013,8,15,16,1058,1005,2063,2096
0132-000,2013,8,15,17,1045,964,2009,2063
0132-000,2013,8,15,18,1150,930,2080,2009
0132-000,2013,8,15,19,1236,938,2174,2080
0132-000,2013,8,15,20,1043,822,1865,2174
0132-000,2013,8,15,21,833,598,1431,1865
0132-000,2013,8,15,22,681,550,1231,1431
0132-000,2013,8,15,23,435,362,797,1231
0132-000,2013,8,15,24,285,269,554,797
0132-000,2013,8,16,1,209,190,399,554
0132-000,2013,8,16,2,134,121,255,399
0132-000,2013,8,16,3,85,96,181,255
0132-000,2013,8,16,4,109,110,219,181
0132-000,2013,8,16,5,121,110,231,219
0132-000,2013,8,16,6,203,172,375,231
0132-000,2013,8,16,7,392,479,871,375
0132-000,2013,8,16,8,723,1430,2153,871
0132-000,2013,8,16,9,876,1368,2244,2153
0132-000,2013,8,16,10,885,1029,1914,2244
0132-000,2013,8,16,11,927,1032,1959,1914
0132-000,2013,8,16,12,961,1024,1985,1959
0132-000,2013,8,16,13,913,915,1828,1985
0132-000,2013,8,16,14,957,992,1949,1828
0132-000,2013,8,16,15,1011,1021,2032,1949
0132-000,2013,8,16,16,1029,1094,2123,2032
0132-000,2013,8,16,17,1092,1111,2203,2123
0132-000,2013,8,16,18,1341,1178,2519,2203
0132-000,2013,8,16,19,1570,1234,2804,2519
0132-000,2013,8,16,20,1343,1054,2397,2804
0132-000,2013,8,16,21,1153,835,1988,2397
0132-000,2013,8,16,22,859,696,1555,1988
0132-000,2013,8,16,23,517,553,1070,1555
0132-000,2013,8,16,24,310,370,680,1070
0132-000,2013,8,17,1,270,239,509,680
0132-000,2013,8,17,2,176,200,376,509
0132-000,2013,8,17,3,119,141,260,376
0132-000,2013,8,17,4,97,111,208,260
0132-000,2013,8,17,5,133,126,259,208
0132-000,2013,8,17,6,183,154,337,259
0132-000,2013,8,17,7,368,344,712,337
0132-000,2013,8,17,8,538,791,1329,712
0132-000,2013,8,17,9,758,924,1682,1329
0132-000,2013,8,17,10,775,1037,1812,1682
0132-000,2013,8,17,11,854,1274,2128,1812
0132-000,2013,8,17,12,902,1439,2341,2128
0132-000,2013,8,17,13,851,1554,2405,2341
0132-000,2013,8,17,14,807,1535,2342,2405
0132-000,2013,8,17,15,877,1613,2490,2342
0132-000,2013,8,17,16,970,1497,2467,2490
0132-000,2013,8,17,17,970,1481,2451,2467
0132-000,2013,8,17,18,1215,1504,2719,2451
0132-000,2013,8,17,19,1101,1481,2582,2719
0132-000,2013,8,17,20,805,1317,2122,2582
0132-000,2013,8,17,21,737,1163,1900,2122
0132-000,2013,8,17,22,641,783,1424,1900
0132-000,2013,8,17,23,390,471,861,1424
0132-000,2013,8,17,24,262,279,541,861
0132-000,2013,8,18,1,204,227,431,541
0132-000,2013,8,18,2,160,143,303,431
0132-000,2013,8,18,3,118,117,235,303
0132-000,2013,8,18,4,111,84,195,235
0132-000,2013,8,18,5,92,85,177,195
0132-000,2013,8,18,6,131,151,282,177
0132-000,2013,8,18,7,258,242,500,282
0132-000,2013,8,18,8,318,365,683,500
0132-000,2013,8,18,9,453,524,977,683
0132-000,2013,8,18,10,492,548,1040,977
0132-000,2013,8,18,11,585,721,1306,1040
0132-000,2013,8,18,12,623,770,1393,1306
0132-000,2013,8,18,13,677,737,1414,1393
0132-000,2013,8,18,14,759,805,1564,1414
0132-000,2013,8,18,15,787,780,1567,1564
0132-000,2013,8,18,16,1089,793,1882,1567
0132-000,2013,8,18,17,1208,865,2073,1882
0132-000,2013,8,18,18,1304,858,2162,2073
0132-000,2013,8,18,19,1210,797,2007,2162
0132-000,2013,8,18,20,1122,627,1749,2007
0132-000,2013,8,18,21,1034,521,1555,1749
0132-000,2013,8,18,22,890,458,1348,1555
0132-000,2013,8,18,23,642,351,993,1348
0132-000,2013,8,18,24,337,267,604,993
0132-000,2013,8,19,1,182,184,366,604
0132-000,2013,8,19,2,110,137,247,366
0132-000,2013,8,19,3,96,82,178,247
0132-000,2013,8,19,4,72,86,158,178
0132-000,2013,8,19,5,106,115,221,158
0132-000,2013,8,19,6,182,196,378,221
0132-000,2013,8,19,7,410,528,938,378
0132-000,2013,8,19,8,568,1202,1770,938
0132-000,2013,8,19,9,686,1079,1765,1770
0132-000,2013,8,19,10,746,859,1605,1765
0132-000,2013,8,19,11,792,888,1680,1605
0132-000,2013,8,19,12,1077,765,1842,1680
0132-000,2013,8,19,13,1033,766,1799,1842
0132-000,2013,8,19,14,1096,802,1898,1799
0132-000,2013,8,19,15,1185,900,2085,1898
0132-000,2013,8,19,16,1413,827,2240,2085
0132-000,2013,8,19,17,1462,815,2277,2240
0132-000,2013,8,19,18,1565,810,2375,2277
0132-000,2013,8,19,19,1495,834,2329,2375
0132-000,2013,8,19,20,1283,672,1955,2329
0132-000,2013,8,19,21,1105,568,1673,1955
0132-000,2013,8,19,22,759,451,1210,1673
0132-000,2013,8,19,23,468,334,802,1210
0132-000,2013,8,19,24,289,248,537,802
0132-000,2013,8,20,1,197,171,368,537
0132-000,2013,8,20,2,130,127,257,368
0132-000,2013,8,20,3,85,95,180,257
0132-000,2013,8,20,4,81,98,179,180
0132-000,2013,8,20,5,107,105,212,179
0132-000,2013,8,20,6,193,192,385,212
0132-000,2013,8,20,7,443,552,995,385
0132-000,2013,8,20,8,751,1612,2363,995
0132-000,2013,8,20,9,853,1347,2200,2363
0132-000,2013,8,20,10,846,1036,1882,2200
0132-000,2013,8,20,11,869,985,1854,1882
0132-000,2013,8,20,12,909,998,1907,1854
0132-000,2013,8,20,13,834,916,1750,1907
0132-000,2013,8,20,14,909,953,1862,1750
0132-000,2013,8,20,15,1027,1017,2044,1862
0132-000,2013,8,20,16,1013,912,1925,2044
0132-000,2013,8,20,17,1025,975,2000,1925
0132-000,2013,8,20,18,1212,856,2068,2000
0132-000,2013,8,20,19,1252,909,2161,2068
0132-000,2013,8,20,20,976,789,1765,2161
0132-000,2013,8,20,21,804,603,1407,1765
0132-000,2013,8,20,22,646,494,1140,1407
0132-000,2013,8,20,23,404,334,738,1140
0132-000,2013,8,20,24,283,222,505,738
0132-000,2013,8,21,1,211,187,398,505
0132-000,2013,8,21,2,129,135,264,398
0132-000,2013,8,21,3,102,103,205,264
0132-000,2013,8,21,4,94,112,206,205
0132-000,2013,8,21,5,119,99,218,206
0132-000,2013,8,21,6,214,161,375,218
0132-000,2013,8,21,7,393,456,849,375
0132-000,2013,8,21,8,756,1494,2250,849
0132-000,2013,8,21,9,901,1279,2180,2250
0132-000,2013,8,21,10,856,975,1831,2180
0132-000,2013,8,21,11,834,911,1745,1831
0132-000,2013,8,21,12,881,916,1797,1745
0132-000,2013,8,21,13,827,877,1704,1797
0132-000,2013,8,21,14,936,953,1889,1704
0132-000,2013,8,21,15,1014,1001,2015,1889
0132-000,2013,8,21,16,1043,938,1981,2015
0132-000,2013,8,21,17,1030,920,1950,1981
0132-000,2013,8,21,18,1155,949,2104,1950
0132-000,2013,8,21,19,1307,1007,2314,2104
0132-000,2013,8,21,20,949,791,1740,2314
0132-000,2013,8,21,21,754,640,1394,1740
0132-000,2013,8,21,22,599,515,1114,1394
0132-000,2013,8,21,23,449,370,819,1114
0132-000,2013,8,21,24,309,246,555,819
0132-000,2013,8,22,1,218,195,413,555
0132-000,2013,8,22,2,176,138,314,413
0132-000,2013,8,22,3,110,133,243,314
0132-000,2013,8,22,4,99,118,217,243
0132-000,2013,8,22,5,113,115,228,217
0132-000,2013,8,22,6,227,203,430,228
0132-000,2013,8,22,7,406,484,890,430
0132-000,2013,8,22,8,750,1500,2250,890
0132-000,2013,8,22,9,923,1309,2232,2250
0132-000,2013,8,22,10,877,1026,1903,2232
0132-000,2013,8,22,11,850,953,1803,1903
0132-000,2013,8,22,12,893,936,1829,1803
0132-000,2013,8,22,13,871,827,1698,1829
0132-000,2013,8,22,14,875,959,1834,1698
0132-000,2013,8,22,15,1009,952,1961,1834
0132-000,2013,8,22,16,1063,943,2006,1961
0132-000,2013,8,22,17,1077,959,2036,2006
0132-000,2013,8,22,18,1182,934,2116,2036
0132-000,2013,8,22,19,1204,941,2145,2116
0132-000,2013,8,22,20,1057,807,1864,2145
0132-000,2013,8,22,21,865,597,1462,1864
0132-000,2013,8,22,22,664,515,1179,1462
0132-000,2013,8,22,23,435,373,808,1179
0132-000,2013,8,22,24,309,259,568,808
0132-000,2013,8,23,1,219,200,419,568
0132-000,2013,8,23,2,179,148,327,419
0132-000,2013,8,23,3,114,120,234,327
0132-000,2013,8,23,4,91,115,206,234
0132-000,2013,8,23,5,134,120,254,206
0132-000,2013,8,23,6,190,154,344,254
0132-000,2013,8,23,7,375,413,788,344
0132-000,2013,8,23,8,731,1407,2138,788
0132-000,2013,8,23,9,893,1206,2099,2138
0132-000,2013,8,23,10,862,1011,1873,2099
0132-000,2013,8,23,11,915,950,1865,1873
0132-000,2013,8,23,12,912,983,1895,1865
0132-000,2013,8,23,13,820,865,1685,1895
0132-000,2013,8,23,14,966,903,1869,1685
0132-000,2013,8,23,15,964,1022,1986,1869
0132-000,2013,8,23,16,1064,986,2050,1986
0132-000,2013,8,23,17,1032,896,1928,2050
0132-000,2013,8,23,18,1305,912,2217,1928
0132-000,2013,8,23,19,1469,1030,2499,2217
0132-000,2013,8,23,20,1064,902,1966,2499
0132-000,2013,8,23,21,838,651,1489,1966
0132-000,2013,8,23,22,632,597,1229,1489
0132-000,2013,8,23,23,458,433,891,1229
0132-000,2013,8,23,24,318,291,609,891
0132-000,2013,8,24,1,233,234,467,609
0132-000,2013,8,24,2,176,181,357,467
0132-000,2013,8,24,3,124,127,251,357
0132-000,2013,8,24,4,118,135,253,251
0132-000,2013,8,24,5,142,143,285,253
0132-000,2013,8,24,6,199,173,372,285
0132-000,2013,8,24,7,331,316,647,372
0132-000,2013,8,24,8,534,808,1342,647
0132-000,2013,8,24,9,744,881,1625,1342
0132-000,2013,8,24,10,824,971,1795,1625
0132-000,2013,8,24,11,850,1037,1887,1795
0132-000,2013,8,24,12,948,1164,2112,1887
0132-000,2013,8,24,13,899,1286,2185,2112
0132-000,2013,8,24,14,955,1220,2175,2185
0132-000,2013,8,24,15,969,1235,2204,2175
0132-000,2013,8,24,16,1096,1308,2404,2204
0132-000,2013,8,24,17,1152,1439,2591,2404
0132-000,2013,8,24,18,1279,1361,2640,2591
0132-000,2013,8,24,19,1148,1273,2421,2640
0132-000,2013,8,24,20,832,845,1677,2421
0132-000,2013,8,24,21,695,598,1293,1677
0132-000,2013,8,24,22,547,533,1080,1293
0132-000,2013,8,24,23,424,417,841,1080
0132-000,2013,8,24,24,341,284,625,841
0132-000,2013,8,25,1,233,231,464,625
0132-000,2013,8,25,2,179,140,319,464
0132-000,2013,8,25,3,144,113,257,319
0132-000,2013,8,25,4,120,91,211,257
0132-000,2013,8,25,5,125,101,226,211
0132-000,2013,8,25,6,156,151,307,226
0132-000,2013,8,25,7,237,277,514,307
0132-000,2013,8,25,8,381,469,850,514
0132-000,2013,8,25,9,497,622,1119,850
0132-000,2013,8,25,10,553,647,1200,1119
0132-000,2013,8,25,11,622,748,1370,1200
0132-000,2013,8,25,12,707,749,1456,1370
0132-000,2013,8,25,13,775,735,1510,1456
0132-000,2013,8,25,14,916,743,1659,1510
0132-000,2013,8,25,15,974,748,1722,1659
0132-000,2013,8,25,16,1190,752,1942,1722
0132-000,2013,8,25,17,1378,805,2183,1942
0132-000,2013,8,25,18,1386,859,2245,2183
0132-000,2013,8,25,19,1462,760,2222,2245
0132-000,2013,8,25,20,1306,609,1915,2222
0132-000,2013,8,25,21,1222,593,1815,1915
0132-000,2013,8,25,22,857,577,1434,1815
0132-000,2013,8,25,23,564,406,970,1434
0132-000,2013,8,25,24,319,278,597,970
0132-000,2013,8,26,1,207,183,390,597
0132-000,2013,8,26,2,123,118,241,390
0132-000,2013,8,26,3,81,80,161,241
0132-000,2013,8,26,4,85,82,167,161
0132-000,2013,8,26,5,117,124,241,167
0132-000,2013,8,26,6,237,236,473,241
0132-000,2013,8,26,7,506,697,1203,473
0132-000,2013,8,26,8,806,1653,2459,1203
0132-000,2013,8,26,9,887,1324,2211,2459
0132-000,2013,8,26,10,826,996,1822,2211
0132-000,2013,8,26,11,850,968,1818,1822
0132-000,2013,8,26,12,919,959,1878,1818
0132-000,2013,8,26,13,847,939,1786,1878
0132-000,2013,8,26,14,898,1017,1915,1786
0132-000,2013,8,26,15,974,1021,1995,1915
0132-000,2013,8,26,16,1030,1001,2031,1995
0132-000,2013,8,26,17,1067,945,2012,2031
0132-000,2013,8,26,18,1223,941,2164,2012
0132-000,2013,8,26,19,1201,929,2130,2164
0132-000,2013,8,26,20,1051,838,1889,2130
0132-000,2013,8,26,21,846,641,1487,1889
0132-000,2013,8,26,22,630,528,1158,1487
0132-000,2013,8,26,23,431,377,808,1158
0132-000,2013,8,26,24,268,241,509,808
0132-000,2013,8,27,1,84,93,177,509
0132-000,2013,8,27,2,58,47,105,177
0132-000,2013,8,27,3,46,38,84,105
0132-000,2013,8,27,4,56,38,94,84
0132-000,2013,8,27,5,45,42,87,94
0132-000,2013,8,27,6,191,161,352,87
0132-000,2013,8,27,7,381,459,840,352
0132-000,2013,8,27,8,761,1406,2167,840
0132-000,2013,8,27,9,874,1276,2150,2167
0132-000,2013,8,27,10,819,903,1722,2150
0132-000,2013,8,27,11,778,810,1588,1722
0132-000,2013,8,27,12,771,734,1505,1588
0132-000,2013,8,27,13,699,653,1352,1505
0132-000,2013,8,27,14,754,778,1532,1352
0132-000,2013,8,27,15,889,748,1637,1532
0132-000,2013,8,27,16,877,762,1639,1637
0132-000,2013,8,27,17,917,752,1669,1639
0132-000,2013,8,27,18,1033,784,1817,1669
0132-000,2013,8,27,19,1138,825,1963,1817
0132-000,2013,8,27,20,914,639,1553,1963
0132-000,2013,8,27,21,753,506,1259,1553
0132-000,2013,8,27,22,555,451,1006,1259
0132-000,2013,8,27,23,390,317,707,1006
0132-000,2013,8,27,24,261,210,471,707
0132-000,2013,8,28,1,174,150,324,471
0132-000,2013,8,28,2,115,120,235,324
0132-000,2013,8,28,3,94,99,193,235
0132-000,2013,8,28,4,98,109,207,193
0132-000,2013,8,28,5,119,114,233,207
0132-000,2013,8,28,6,240,182,422,233
0132-000,2013,8,28,7,423,488,911,422
0132-000,2013,8,28,8,817,1516,2333,911
0132-000,2013,8,28,9,957,1446,2403,2333
0132-000,2013,8,28,10,902,1066,1968,2403
0132-000,2013,8,28,11,954,1035,1989,1968
0132-000,2013,8,28,12,937,1029,1966,1989
0132-000,2013,8,28,13,921,959,1880,1966
0132-000,2013,8,28,14,1000,1057,2057,1880
0132-000,2013,8,28,15,1080,1066,2146,2057
0132-000,2013,8,28,16,1128,1029,2157,2146
0132-000,2013,8,28,17,1133,955,2088,2157
0132-000,2013,8,28,18,1286,932,2218,2088
0132-000,2013,8,28,19,1340,978,2318,2218
0132-000,2013,8,28,20,1042,830,1872,2318
0132-000,2013,8,28,21,842,646,1488,1872
0132-000,2013,8,28,22,656,567,1223,1488
0132-000,2013,8,28,23,413,402,815,1223
0132-000,2013,8,28,24,318,278,596,815
0132-000,2013,8,29,1,221,192,413,596
0132-000,2013,8,29,2,150,134,284,413
0132-000,2013,8,29,3,132,125,257,284
0132-000,2013,8,29,4,107,122,229,257
0132-000,2013,8,29,5,142,125,267,229
0132-000,2013,8,29,6,187,184,371,267
0132-000,2013,8,29,7,421,471,892,371
0132-000,2013,8,29,8,781,1500,2281,892
0132-000,2013,8,29,9,913,1456,2369,2281
0132-000,2013,8,29,10,873,992,1865,2369
0132-000,2013,8,29,11,871,967,1838,1865
0132-000,2013,8,29,12,886,909,1795,1838
0132-000,2013,8,29,13,841,894,1735,1795
0132-000,2013,8,29,14,923,992,1915,1735
0132-000,2013,8,29,15,1002,955,1957,1915
0132-000,2013,8,29,16,1052,929,1981,1957
0132-000,2013,8,29,17,1068,875,1943,1981
0132-000,2013,8,29,18,1177,909,2086,1943
0132-000,2013,8,29,19,1229,915,2144,2086
0132-000,2013,8,29,20,943,791,1734,2144
0132-000,2013,8,29,21,861,599,1460,1734
0132-000,2013,8,29,22,638,480,1118,1460
0132-000,2013,8,29,23,423,349,772,1118
0132-000,2013,8,29,24,302,243,545,772
0132-000,2013,8,30,1,223,200,423,545
0132-000,2013,8,30,2,141,160,301,423
0132-000,2013,8,30,3,120,121,241,301
0132-000,2013,8,30,4,96,110,206,241
0132-000,2013,8,30,5,128,135,263,206
0132-000,2013,8,30,6,205,150,355,263
0132-000,2013,8,30,7,402,493,895,355
0132-000,2013,8,30,8,815,1423,2238,895
0132-000,2013,8,30,9,966,1334,2300,2238
0132-000,2013,8,30,10,947,1037,1984,2300
0132-000,2013,8,30,11,926,1026,1952,1984
0132-000,2013,8,30,12,987,1010,1997,1952
0132-000,2013,8,30,13,920,974,1894,1997
0132-000,2013,8,30,14,1031,992,2023,1894
0132-000,2013,8,30,15,1091,1030,2121,2023
0132-000,2013,8,30,16,1162,1071,2233,2121
0132-000,2013,8,30,17,1178,1089,2267,2233
0132-000,2013,8,30,18,1431,1066,2497,2267
0132-000,2013,8,30,19,1481,1036,2517,2497
0132-000,2013,8,30,20,1250,959,2209,2517
0132-000,2013,8,30,21,1009,713,1722,2209
0132-000,2013,8,30,22,799,668,1467,1722
0132-000,2013,8,30,23,501,464,965,1467
0132-000,2013,8,30,24,366,325,691,965
0132-000,2013,8,31,1,246,252,498,691
0132-000,2013,8,31,2,185,193,378,498
0132-000,2013,8,31,3,136,154,290,378
0132-000,2013,8,31,4,117,150,267,290
0132-000,2013,8,31,5,170,161,331,267
0132-000,2013,8,31,6,193,195,388,331
0132-000,2013,8,31,7,353,387,740,388
0132-000,2013,8,31,8,589,848,1437,740
0132-000,2013,8,31,9,763,1008,1771,1437
0132-000,2013,8,31,10,774,1081,1855,1771
0132-000,2013,8,31,11,834,1216,2050,1855
0132-000,2013,8,31,12,886,1276,2162,2050
0132-000,2013,8,31,13,916,1308,2224,2162
0132-000,2013,8,31,14,949,1275,2224,2224
0132-000,2013,8,31,15,992,1245,2237,2224
0132-000,2013,8,31,16,1041,1229,2270,2237
0132-000,2013,8,31,17,1126,1176,2302,2270
0132-000,2013,8,31,18,1380,1182,2562,2302
0132-000,2013,8,31,19,1360,1082,2442,2562
0132-000,2013,8,31,20,1078,930,2008,2442
0132-000,2013,8,31,21,838,765,1603,2008
0132-000,2013,8,31,22,652,650,1302,1603
0132-000,2013,8,31,23,415,467,882,1302
0132-000,2013,8,31,24,304,321,625,882
0132-000,2013,9,1,1,236,221,457,625
0132-000,2013,9,1,2,162,164,326,457
0132-000,2013,9,1,3,118,138,256,326
0132-000,2013,9,1,4,116,118,234,256
0132-000,2013,9,1,5,118,105,223,234
0132-000,2013,9,1,6,148,167,315,223
0132-000,2013,9,1,7,267,344,611,315
0132-000,2013,9,1,8,359,579,938,611
0132-000,2013,9,1,9,478,757,1235,938
0132-000,2013,9,1,10,546,842,1388,1235
0132-000,2013,9,1,11,658,872,1530,1388
0132-000,2013,9,1,12,683,801,1484,1530
0132-000,2013,9,1,13,791,759,1550,1484
0132-000,2013,9,1,14,916,698,1614,1550
0132-000,2013,9,1,15,1298,749,2047,1614
0132-000,2013,9,1,16,1405,716,2121,2047
0132-000,2013,9,1,17,1476,703,2179,2121
0132-000,2013,9,1,18,1569,697,2266,2179
0132-000,2013,9,1,19,1605,628,2233,2266
0132-000,2013,9,1,20,1466,575,2041,2233
0132-000,2013,9,1,21,1326,518,1844,2041
0132-000,2013,9,1,22,1216,464,1680,1844
0132-000,2013,9,1,23,1006,391,1397,1680
0132-000,2013,9,1,24,869,274,1143,1397
0132-000,2013,9,2,1,552,192,744,1143
0132-000,2013,9,2,2,145,141,286,744
0132-000,2013,9,2,3,87,93,180,286
0132-000,2013,9,2,4,83,92,175,180
0132-000,2013,9,2,5,117,118,235,175
0132-000,2013,9,2,6,221,200,421,235
0132-000,2013,9,2,7,488,606,1094,421
0132-000,2013,9,2,8,812,1541,2353,1094
0132-000,2013,9,2,9,871,1340,2211,2353
0132-000,2013,9,2,10,823,999,1822,2211
0132-000,2013,9,2,11,862,919,1781,1822
0132-000,2013,9,2,12,856,1023,1879,1781
0132-000,2013,9,2,13,825,971,1796,1879
0132-000,2013,9,2,14,974,1069,2043,1796
0132-000,2013,9,2,15,998,1105,2103,2043
0132-000,2013,9,2,16,1056,942,1998,2103
0132-000,2013,9,2,17,1075,926,2001,1998
0132-000,2013,9,2,18,1196,894,2090,2001
0132-000,2013,9,2,19,1197,885,2082,2090
0132-000,2013,9,2,20,913,733,1646,2082
0132-000,2013,9,2,21,778,565,1343,1646
0132-000,2013,9,2,22,641,459,1100,1343
0132-000,2013,9,2,23,406,362,768,1100
0132-000,2013,9,2,24,275,238,513,768
0132-000,2013,9,3,1,198,185,383,513
0132-000,2013,9,3,2,126,122,248,383
0132-000,2013,9,3,3,99,116,215,248
0132-000,2013,9,3,4,92,109,201,215
0132-000,2013,9,3,5,134,130,264,201
0132-000,2013,9,3,6,202,186,388,264
0132-000,2013,9,3,7,401,447,848,388
0132-000,2013,9,3,8,755,1318,2073,848
0132-000,2013,9,3,9,890,1314,2204,2073
0132-000,2013,9,3,10,853,958,1811,2204
0132-000,2013,9,3,11,837,923,1760,1811
0132-000,2013,9,3,12,868,910,1778,1760
0132-000,2013,9,3,13,829,865,1694,1778
0132-000,2013,9,3,14,954,917,1871,1694
0132-000,2013,9,3,15,1040,1013,2053,1871
0132-000,2013,9,3,16,1073,973,2046,2053
0132-000,2013,9,3,17,1068,866,1934,2046
0132-000,2013,9,3,18,1134,917,2051,1934
0132-000,2013,9,3,19,1179,894,2073,2051
0132-000,2013,9,3,20,1000,708,1708,2073
0132-000,2013,9,3,21,860,629,1489,1708
0132-000,2013,9,3,22,671,513,1184,1489
0132-000,2013,9,3,23,435,389,824,1184
0132-000,2013,9,3,24,297,273,570,824
0132-000,2013,9,4,1,213,186,399,570
0132-000,2013,9,4,2,115,126,241,399
0132-000,2013,9,4,3,106,129,235,241
0132-000,2013,9,4,4,86,99,185,235
0132-000,2013,9,4,5,119,129,248,185
0132-000,2013,9,4,6,196,177,373,248
0132-000,2013,9,4,7,386,450,836,373
0132-000,2013,9,4,8,725,1317,2042,836
0132-000,2013,9,4,9,896,1332,2228,2042
0132-000,2013,9,4,10,843,1065,1908,2228
0132-000,2013,9,4,11,925,1010,1935,1908
0132-000,2013,9,4,12,930,892,1822,1935
0132-000,2013,9,4,13,834,865,1699,1822
0132-000,2013,9,4,14,898,919,1817,1699
0132-000,2013,9,4,15,991,973,1964,1817
0132-000,2013,9,4,16,1092,955,2047,1964
0132-000,2013,9,4,17,1100,925,2025,2047
0132-000,2013,9,4,18,1249,866,2115,2025
0132-000,2013,9,4,19,1219,890,2109,2115
0132-000,2013,9,4,20,998,774,1772,2109
0132-000,2013,9,4,21,814,576,1390,1772
0132-000,2013,9,4,22,639,494,1133,1390
0132-000,2013,9,4,23,447,386,833,1133
0132-000,2013,9,4,24,308,295,603,833
0132-000,2013,9,5,1,209,240,449,603
0132-000,2013,9,5,2,133,136,269,449
0132-000,2013,9,5,3,112,114,226,269
0132-000,2013,9,5,4,85,119,204,226
0132-000,2013,9,5,5,124,162,286,204
0132-000,2013,9,5,6,225,214,439,286
0132-000,2013,9,5,7,413,488,901,439
0132-000,2013,9,5,8,803,1392,2195,901
0132-000,2013,9,5,9,903,1361,2264,2195
0132-000,2013,9,5,10,845,1067,1912,2264
0132-000,2013,9,5,11,903,1016,1919,1912
0132-000,2013,9,5,12,917,1061,1978,1919
0132-000,2013,9,5,13,835,876,1711,1978
0132-000,2013,9,5,14,872,934,1806,1711
0132-000,2013,9,5,15,1036,992,2028,1806
0132-000,2013,9,5,16,1115,944,2059,2028
0132-000,2013,9,5,17,1115,903,2018,2059
0132-000,2013,9,5,18,1225,844,2069,2018
0132-000,2013,9,5,19,1218,910,2128,2069
0132-000,2013,9,5,20,1024,734,1758,2128
0132-000,2013,9,5,21,850,598,1448,1758
0132-000,2013,9,5,22,706,528,1234,1448
0132-000,2013,9,5,23,445,358,803,1234
0132-000,2013,9,5,24,295,282,577,803
0132-000,2013,9,6,1,230,228,458,577
0132-000,2013,9,6,2,152,153,305,458
0132-000,2013,9,6,3,110,107,217,305
0132-000,2013,9,6,4,90,115,205,217
0132-000,2013,9,6,5,127,142,269,205
0132-000,2013,9,6,6,221,203,424,269
0132-000,2013,9,6,7,399,482,881,424
0132-000,2013,9,6,8,778,1260,2038,881
0132-000,2013,9,6,9,922,1345,2267,2038
0132-000,2013,9,6,10,857,992,1849,2267
0132-000,2013,9,6,11,875,1002,1877,1849
0132-000,2013,9,6,12,903,998,1901,1877
0132-000,2013,9,6,13,855,917,1772,1901
0132-000,2013,9,6,14,952,917,1869,1772
0132-000,2013,9,6,15,1066,986,2052,1869
0132-000,2013,9,6,16,1122,976,2098,2052
0132-000,2013,9,6,17,1216,1014,2230,2098
0132-000,2013,9,6,18,1398,1014,2412,2230
0132-000,2013,9,6,19,1448,993,2441,2412
0132-000,2013,9,6,20,1139,886,2025,2441
0132-000,2013,9,6,21,915,712,1627,2025
0132-000,2013,9,6,22,744,572,1316,1627
0132-000,2013,9,6,23,494,429,923,1316
0132-000,2013,9,6,24,357,335,692,923
0132-000,2013,9,7,1,252,265,517,692
0132-000,2013,9,7,2,181,190,371,517
0132-000,2013,9,7,3,144,152,296,371
0132-000,2013,9,7,4,121,147,268,296
0132-000,2013,9,7,5,151,169,320,268
0132-000,2013,9,7,6,192,180,372,320
0132-000,2013,9,7,7,338,375,713,372
0132-000,2013,9,7,8,590,812,1402,713
0132-000,2013,9,7,9,759,975,1734,1402
0132-000,2013,9,7,10,782,1001,1783,1734
0132-000,2013,9,7,11,848,1201,2049,1783
0132-000,2013,9,7,12,932,1297,2229,2049
0132-000,2013,9,7,13,938,1364,2302,2229
0132-000,2013,9,7,14,1063,1338,2401,2302
0132-000,2013,9,7,15,984,1180,2164,2401
0132-000,2013,9,7,16,1086,1098,2184,2164
0132-000,2013,9,7,17,1117,1023,2140,2184
0132-000,2013,9,7,18,1463,931,2394,2140
0132-000,2013,9,7,19,1440,819,2259,2394
0132-000,2013,9,7,20,1168,668,1836,2259
0132-000,2013,9,7,21,783,661,1444,1836
0132-000,2013,9,7,22,596,561,1157,1444
0132-000,2013,9,7,23,400,401,801,1157
0132-000,2013,9,7,24,295,310,605,801
0132-000,2013,9,8,1,205,214,419,605
0132-000,2013,9,8,2,157,164,321,419
0132-000,2013,9,8,3,131,133,264,321
0132-000,2013,9,8,4,111,119,230,264
0132-000,2013,9,8,5,115,118,233,230
0132-000,2013,9,8,6,134,142,276,233
0132-000,2013,9,8,7,246,325,571,276
0132-000,2013,9,8,8,369,500,869,571
0132-000,2013,9,8,9,459,639,1098,869
0132-000,2013,9,8,10,538,630,1168,1098
0132-000,2013,9,8,11,641,710,1351,1168
0132-000,2013,9,8,12,644,695,1339,1351
0132-000,2013,9,8,13,760,724,1484,1339
0132-000,2013,9,8,14,824,703,1527,1484
0132-000,2013,9,8,15,1008,731,1739,1527
0132-000,2013,9,8,16,1179,667,1846,1739
0132-000,2013,9,8,17,1208,726,1934,1846
0132-000,2013,9,8,18,1373,684,2057,1934
0132-000,2013,9,8,19,1309,626,1935,2057
0132-000,2013,9,8,20,1091,551,1642,1935
0132-000,2013,9,8,21,862,498,1360,1642
0132-000,2013,9,8,22,663,429,1092,1360
0132-000,2013,9,8,23,399,362,761,1092
0132-000,2013,9,8,24,248,273,521,761
0132-000,2013,9,9,1,163,164,327,521
0132-000,2013,9,9,2,101,131,232,327
0132-000,2013,9,9,3,84,81,165,232
0132-000,2013,9,9,4,56,80,136,165
0132-000,2013,9,9,5,92,117,209,136
0132-000,2013,9,9,6,208,212,420,209
0132-000,2013,9,9,7,482,647,1129,420
0132-000,2013,9,9,8,863,1576,2439,1129
0132-000,2013,9,9,9,876,1408,2284,2439
0132-000,2013,9,9,10,878,1092,1970,2284
0132-000,2013,9,9,11,852,945,1797,1970
0132-000,2013,9,9,12,905,970,1875,1797
0132-000,2013,9,9,13,897,994,1891,1875
0132-000,2013,9,9,14,1033,1089,2122,1891
0132-000,2013,9,9,15,1134,1091,2225,2122
0132-000,2013,9,9,16,1146,1061,2207,2225
0132-000,2013,9,9,17,1137,897,2034,2207
0132-000,2013,9,9,18,1229,907,2136,2034
0132-000,2013,9,9,19,1228,921,2149,2136
0132-000,2013,9,9,20,990,746,1736,2149
0132-000,2013,9,9,21,830,594,1424,1736
0132-000,2013,9,9,22,666,508,1174,1424
0132-000,2013,9,9,23,412,376,788,1174
0132-000,2013,9,9,24,288,237,525,788
0132-000,2013,9,10,1,196,211,407,525
0132-000,2013,9,10,2,122,129,251,407
0132-000,2013,9,10,3,114,130,244,251
0132-000,2013,9,10,4,101,114,215,244
0132-000,2013,9,10,5,114,140,254,215
0132-000,2013,9,10,6,231,192,423,254
0132-000,2013,9,10,7,438,496,934,423
0132-000,2013,9,10,8,789,1320,2109,934
0132-000,2013,9,10,9,903,1311,2214,2109
0132-000,2013,9,10,10,912,1030,1942,2214
0132-000,2013,9,10,11,898,968,1866,1942
0132-000,2013,9,10,12,924,916,1840,1866
0132-000,2013,9,10,13,850,851,1701,1840
0132-000,2013,9,10,14,937,943,1880,1701
0132-000,2013,9,10,15,1048,1028,2076,1880
0132-000,2013,9,10,16,1115,1000,2115,2076
0132-000,2013,9,10,17,1097,877,1974,2115
0132-000,2013,9,10,18,1229,939,2168,1974
0132-000,2013,9,10,19,1237,841,2078,2168
0132-000,2013,9,10,20,1057,770,1827,2078
0132-000,2013,9,10,21,876,624,1500,1827
0132-000,2013,9,10,22,691,508,1199,1500
0132-000,2013,9,10,23,442,392,834,1199
0132-000,2013,9,10,24,304,284,588,834
0132-000,2013,9,11,1,206,223,429,588
0132-000,2013,9,11,2,134,135,269,429
0132-000,2013,9,11,3,116,117,233,269
0132-000,2013,9,11,4,91,120,211,233
0132-000,2013,9,11,5,118,125,243,211
0132-000,2013,9,11,6,213,157,370,243
0132-000,2013,9,11,7,407,452,859,370
0132-000,2013,9,11,8,803,1261,2064,859
0132-000,2013,9,11,9,888,1167,2055,2064
0132-000,2013,9,11,10,903,1096,1999,2055
0132-000,2013,9,11,11,916,982,1898,1999
0132-000,2013,9,11,12,931,955,1886,1898
0132-000,2013,9,11,13,863,884,1747,1886
0132-000,2013,9,11,14,1003,981,1984,1747
0132-000,2013,9,11,15,1048,1031,2079,1984
0132-000,2013,9,11,16,1097,961,2058,2079
0132-000,2013,9,11,17,1195,965,2160,2058
0132-000,2013,9,11,18,1271,996,2267,2160
0132-000,2013,9,11,19,1268,991,2259,2267
0132-000,2013,9,11,20,1040,798,1838,2259
0132-000,2013,9,11,21,791,663,1454,1838
0132-000,2013,9,11,22,683,576,1259,1454
0132-000,2013,9,11,23,453,434,887,1259
0132-000,2013,9,11,24,331,335,666,887
0132-000,2013,9,12,1,225,221,446,666
0132-000,2013,9,12,2,146,146,292,446
0132-000,2013,9,12,3,114,140,254,292
0132-000,2013,9,12,4,103,136,239,254
0132-000,2013,9,12,5,128,164,292,239
0132-000,2013,9,12,6,198,198,396,292
0132-000,2013,9,12,7,433,519,952,396
0132-000,2013,9,12,8,737,1292,2029,952
0132-000,2013,9,12,9,902,1376,2278,2029
0132-000,2013,9,12,10,892,1068,1960,2278
0132-000,2013,9,12,11,933,997,1930,1960
0132-000,2013,9,12,12,958,989,1947,1930
0132-000,2013,9,12,13,886,865,1751,1947
0132-000,2013,9,12,14,989,1050,2039,1751
0132-000,2013,9,12,15,1004,940,1944,2039
0132-000,2013,9,12,16,1141,973,2114,1944
0132-000,2013,9,12,17,1195,1036,2231,2114
0132-000,2013,9,12,18,1277,1012,2289,2231
0132-000,2013,9,12,19,1280,995,2275,2289
0132-000,2013,9,12,20,1049,779,1828,2275
0132-000,2013,9,12,21,847,655,1502,1828
0132-000,2013,9,12,22,705,512,1217,1502
0132-000,2013,9,12,23,455,392,847,1217
0132-000,2013,9,12,24,308,300,608,847
0132-000,2013,9,13,1,254,250,504,608
0132-000,2013,9,13,2,144,150,294,504
0132-000,2013,9,13,3,129,148,277,294
0132-000,2013,9,13,4,100,128,228,277
0132-000,2013,9,13,5,128,145,273,228
0132-000,2013,9,13,6,203,197,400,273
0132-000,2013,9,13,7,412,483,895,400
0132-000,2013,9,13,8,745,1300,2045,895
0132-000,2013,9,13,9,915,1365,2280,2045
0132-000,2013,9,13,10,894,1069,1963,2280
0132-000,2013,9,13,11,924,1016,1940,1963
0132-000,2013,9,13,12,986,988,1974,1940
0132-000,2013,9,13,13,909,887,1796,1974
0132-000,2013,9,13,14,1031,1051,2082,1796
0132-000,2013,9,13,15,1105,1052,2157,2082
0132-000,2013,9,13,16,1202,1007,2209,2157
0132-000,2013,9,13,17,1209,1018,2227,2209
0132-000,2013,9,13,18,1360,1003,2363,2227
0132-000,2013,9,13,19,1390,945,2335,2363
0132-000,2013,9,13,20,1173,876,2049,2335
0132-000,2013,9,13,21,917,712,1629,2049
0132-000,2013,9,13,22,763,609,1372,1629
0132-000,2013,9,13,23,485,463,948,1372
0132-000,2013,9,13,24,339,322,661,948
0132-000,2013,9,14,1,254,256,510,661
0132-000,2013,9,14,2,193,187,380,510
0132-000,2013,9,14,3,145,158,303,380
0132-000,2013,9,14,4,128,150,278,303
0132-000,2013,9,14,5,155,169,324,278
0132-000,2013,9,14,6,208,185,393,324
0132-000,2013,9,14,7,351,382,733,393
0132-000,2013,9,14,8,601,845,1446,733
0132-000,2013,9,14,9,773,986,1759,1446
0132-000,2013,9,14,10,791,1037,1828,1759
0132-000,2013,9,14,11,849,1200,2049,1828
0132-000,2013,9,14,12,905,1198,2103,2049
0132-000,2013,9,14,13,960,1215,2175,2103
0132-000,2013,9,14,14,985,1161,2146,2175
0132-000,2013,9,14,15,1003,1041,2044,2146
0132-000,2013,9,14,16,1059,985,2044,2044
0132-000,2013,9,14,17,1112,958,2070,2044
0132-000,2013,9,14,18,1379,955,2334,2070
0132-000,2013,9,14,19,1350,871,2221,2334
0132-000,2013,9,14,20,1033,699,1732,2221
0132-000,2013,9,14,21,714,613,1327,1732
0132-000,2013,9,14,22,562,525,1087,1327
0132-000,2013,9,14,23,379,394,773,1087
0132-000,2013,9,14,24,287,296,583,773
0132-000,2013,9,15,1,216,211,427,583
0132-000,2013,9,15,2,161,168,329,427
0132-000,2013,9,15,3,127,127,254,329
0132-000,2013,9,15,4,107,109,216,254
0132-000,2013,9,15,5,121,104,225,216
0132-000,2013,9,15,6,131,142,273,225
0132-000,2013,9,15,7,254,302,556,273
0132-000,2013,9,15,8,335,467,802,556
0132-000,2013,9,15,9,462,599,1061,802
0132-000,2013,9,15,10,533,631,1164,1061
0132-000,2013,9,15,11,638,706,1344,1164
0132-000,2013,9,15,12,649,675,1324,1344
0132-000,2013,9,15,13,737,723,1460,1324
0132-000,2013,9,15,14,784,686,1470,1460
0132-000,2013,9,15,15,928,738,1666,1470
0132-000,2013,9,15,16,1054,699,1753,1666
0132-000,2013,9,15,17,1094,727,1821,1753
0132-000,2013,9,15,18,1219,704,1923,1821
0132-000,2013,9,15,19,1204,653,1857,1923
0132-000,2013,9,15,20,970,552,1522,1857
0132-000,2013,9,15,21,763,516,1279,1522
0132-000,2013,9,15,22,595,457,1052,1279
0132-000,2013,9,15,23,377,361,738,1052
0132-000,2013,9,15,24,240,259,499,738
0132-000,2013,9,16,1,164,177,341,499
0132-000,2013,9,16,2,103,127,230,341
0132-000,2013,9,16,3,87,87,174,230
0132-000,2013,9,16,4,70,89,159,174
0132-000,2013,9,16,5,102,117,219,159
0132-000,2013,9,16,6,217,218,435,219
0132-000,2013,9,16,7,487,655,1142,435
0132-000,2013,9,16,8,840,1585,2425,1142
0132-000,2013,9,16,9,880,1392,2272,2425
0132-000,2013,9,16,10,860,1054,1914,2272
0132-000,2013,9,16,11,859,970,1829,1914
0132-000,2013,9,16,12,895,991,1886,1829
0132-000,2013,9,16,13,864,982,1846,1886
0132-000,2013,9,16,14,1001,1064,2065,1846
0132-000,2013,9,16,15,1073,1073,2146,2065
0132-000,2013,9,16,16,1087,1010,2097,2146
0132-000,2013,9,16,17,1109,914,2023,2097
0132-000,2013,9,16,18,1223,916,2139,2023
0132-000,2013,9,16,19,1243,920,2163,2139
0132-000,2013,9,16,20,974,747,1721,2163
0132-000,2013,9,16,21,808,595,1403,1721
0132-000,2013,9,16,22,667,478,1145,1403
0132-000,2013,9,16,23,417,365,782,1145
0132-000,2013,9,16,24,282,238,520,782
0132-000,2013,9,17,1,228,218,446,520
0132-000,2013,9,17,2,149,156,305,446
0132-000,2013,9,17,3,122,147,269,305
0132-000,2013,9,17,4,100,131,231,269
0132-000,2013,9,17,5,118,143,261,231
0132-000,2013,9,17,6,178,187,365,261
0132-000,2013,9,17,7,364,497,861,365
0132-000,2013,9,17,8,744,1376,2120,861
0132-000,2013,9,17,9,901,1316,2217,2120
0132-000,2013,9,17,10,903,1056,1959,2217
0132-000,2013,9,17,11,956,1008,1964,1959
0132-000,2013,9,17,12,1022,1013,2035,1964
0132-000,2013,9,17,13,929,1010,1939,2035
0132-000,2013,9,17,14,1055,1219,2274,1939
0132-000,2013,9,17,15,1101,1262,2363,2274
0132-000,2013,9,17,16,1228,1374,2602,2363
0132-000,2013,9,17,17,1270,1512,2782,2602
0132-000,2013,9,17,18,1368,1535,2903,2782
0132-000,2013,9,17,19,1368,1433,2801,2903
0132-000,2013,9,17,20,1110,1338,2448,2801
0132-000,2013,9,17,21,797,1201,1998,2448
0132-000,2013,9,17,22,661,1141,1802,1998
0132-000,2013,9,17,23,450,1046,1496,1802
0132-000,2013,9,17,24,296,947,1243,1496
0132-000,2013,9,18,1,229,963,1192,1243
0132-000,2013,9,18,2,159,745,904,1192
0132-000,2013,9,18,3,124,748,872,904
0132-000,2013,9,18,4,113,935,1048,872
0132-000,2013,9,18,5,125,1050,1175,1048
0132-000,2013,9,18,6,173,1047,1220,1175
0132-000,2013,9,18,7,277,1107,1384,1220
0132-000,2013,9,18,8,533,1522,2055,1384
0132-000,2013,9,18,9,637,1518,2155,2055
0132-000,2013,9,18,10,715,1432,2147,2155
0132-000,2013,9,18,11,774,1487,2261,2147
0132-000,2013,9,18,12,856,1427,2283,2261
0132-000,2013,9,18,13,809,1549,2358,2283
0132-000,2013,9,18,14,879,1639,2518,2358
0132-000,2013,9,18,15,908,1795,2703,2518
0132-000,2013,9,18,16,966,1702,2668,2703
0132-000,2013,9,18,17,947,2052,2999,2668
0132-000,2013,9,18,18,986,1935,2921,2999
0132-000,2013,9,18,19,944,1729,2673,2921
0132-000,2013,9,18,20,689,1415,2104,2673
0132-000,2013,9,18,21,540,1361,1901,2104
0132-000,2013,9,18,22,457,1122,1579,1901
0132-000,2013,9,18,23,307,989,1296,1579
0132-000,2013,9,18,24,247,907,1154,1296
0132-000,2013,9,19,1,184,755,939,1154
0132-000,2013,9,19,2,129,764,893,939
0132-000,2013,9,19,3,112,680,792,893
0132-000,2013,9,19,4,94,604,698,792
0132-000,2013,9,19,5,102,786,888,698
0132-000,2013,9,19,6,111,960,1071,888
0132-000,2013,9,19,7,153,1304,1457,1071
0132-000,2013,9,19,8,221,1484,1705,1457
0132-000,2013,9,19,9,341,1403,1744,1705
0132-000,2013,9,19,10,571,1476,2047,1744
0132-000,2013,9,19,11,685,1725,2410,2047
0132-000,2013,9,19,12,676,1776,2452,2410
0132-000,2013,9,19,13,684,1545,2229,2452
0132-000,2013,9,19,14,643,1424,2067,2229
0132-000,2013,9,19,15,616,1386,2002,2067
0132-000,2013,9,19,16,612,1379,1991,2002
0132-000,2013,9,19,17,569,1415,1984,1991
0132-000,2013,9,19,18,544,1345,1889,1984
0132-000,2013,9,19,19,479,1156,1635,1889
0132-000,2013,9,19,20,412,1150,1562,1635
0132-000,2013,9,19,21,390,824,1214,1562
0132-000,2013,9,19,22,310,626,936,1214
0132-000,2013,9,19,23,227,363,590,936
0132-000,2013,9,19,24,149,238,387,590
0132-000,2013,9,20,1,124,150,274,387
0132-000,2013,9,20,2,81,116,197,274
0132-000,2013,9,20,3,59,81,140,197
0132-000,2013,9,20,4,61,77,138,140
0132-000,2013,9,20,5,58,64,122,138
0132-000,2013,9,20,6,115,103,218,122
0132-000,2013,9,20,7,276,271,547,218
0132-000,2013,9,20,8,434,518,952,547
0132-000,2013,9,20,9,430,515,945,952
0132-000,2013,9,20,10,553,621,1174,945
0132-000,2013,9,20,11,1259,813,2072,1174
0132-000,2013,9,20,12,1908,946,2854,2072
0132-000,2013,9,20,13,1956,992,2948,2854
0132-000,2013,9,20,14,2072,1136,3208,2948
0132-000,2013,9,20,15,1975,1145,3120,3208
0132-000,2013,9,20,16,1999,1140,3139,3120
0132-000,2013,9,20,17,1965,1098,3063,3139
0132-000,2013,9,20,18,2079,949,3028,3063
0132-000,2013,9,20,19,1968,872,2840,3028
0132-000,2013,9,20,20,1887,640,2527,2840
0132-000,2013,9,20,21,1886,503,2389,2527
0132-000,2013,9,20,22,1873,372,2245,2389
0132-000,2013,9,20,23,1545,326,1871,2245
0132-000,2013,9,20,24,1192,253,1445,1871
0132-000,2013,9,21,1,981,163,1144,1445
0132-000,2013,9,21,2,908,112,1020,1144
0132-000,2013,9,21,3,592,86,678,1020
0132-000,2013,9,21,4,314,81,395,678
0132-000,2013,9,21,5,218,66,284,395
0132-000,2013,9,21,6,213,92,305,284
0132-000,2013,9,21,7,238,203,441,305
0132-000,2013,9,21,8,430,428,858,441
0132-000,2013,9,21,9,631,450,1081,858
0132-000,2013,9,21,10,754,482,1236,1081
0132-000,2013,9,21,11,1082,577,1659,1236
0132-000,2013,9,21,12,1324,674,1998,1659
0132-000,2013,9,21,13,1471,658,2129,1998
0132-000,2013,9,21,14,1773,661,2434,2129
0132-000,2013,9,21,15,1850,673,2523,2434
0132-000,2013,9,21,16,1819,625,2444,2523
0132-000,2013,9,21,17,1731,617,2348,2444
0132-000,2013,9,21,18,1737,657,2394,2348
0132-000,2013,9,21,19,1735,597,2332,2394
0132-000,2013,9,21,20,1548,516,2064,2332
0132-000,2013,9,21,21,1408,476,1884,2064
0132-000,2013,9,21,22,1146,432,1578,1884
0132-000,2013,9,21,23,1067,324,1391,1578
0132-000,2013,9,21,24,1033,235,1268,1391
0132-000,2013,9,22,1,630,182,812,1268
0132-000,2013,9,22,2,301,131,432,812
0132-000,2013,9,22,3,108,109,217,432
0132-000,2013,9,22,4,73,89,162,217
0132-000,2013,9,22,5,87,80,167,162
0132-000,2013,9,22,6,126,127,253,167
0132-000,2013,9,22,7,244,335,579,253
0132-000,2013,9,22,8,509,804,1313,579
0132-000,2013,9,22,9,620,774,1394,1313
0132-000,2013,9,22,10,658,707,1365,1394
0132-000,2013,9,22,11,720,732,1452,1365
0132-000,2013,9,22,12,769,745,1514,1452
0132-000,2013,9,22,13,1051,671,1722,1514
0132-000,2013,9,22,14,1079,741,1820,1722
0132-000,2013,9,22,15,1244,717,1961,1820
0132-000,2013,9,22,16,1529,761,2290,1961
0132-000,2013,9,22,17,1523,747,2270,2290
0132-000,2013,9,22,18,1708,735,2443,2270
0132-000,2013,9,22,19,1642,712,2354,2443
0132-000,2013,9,22,20,1483,656,2139,2354
0132-000,2013,9,22,21,1019,499,1518,2139
0132-000,2013,9,22,22,595,420,1015,1518
0132-000,2013,9,22,23,394,313,707,1015
0132-000,2013,9,22,24,238,199,437,707
0132-000,2013,9,23,1,164,189,353,437
0132-000,2013,9,23,2,104,122,226,353
0132-000,2013,9,23,3,90,92,182,226
0132-000,2013,9,23,4,84,97,181,182
0132-000,2013,9,23,5,112,117,229,181
0132-000,2013,9,23,6,226,223,449,229
0132-000,2013,9,23,7,491,662,1153,449
0132-000,2013,9,23,8,817,1594,2411,1153
0132-000,2013,9,23,9,884,1375,2259,2411
0132-000,2013,9,23,10,842,1016,1858,2259
0132-000,2013,9,23,11,865,995,1860,1858
0132-000,2013,9,23,12,885,1011,1896,1860
0132-000,2013,9,23,13,831,969,1800,1896
0132-000,2013,9,23,14,968,1039,2007,1800
0132-000,2013,9,23,15,1011,1054,2065,2007
0132-000,2013,9,23,16,1027,958,1985,2065
0132-000,2013,9,23,17,1080,931,2011,1985
0132-000,2013,9,23,18,1217,925,2142,2011
0132-000,2013,9,23,19,1257,918,2175,2142
0132-000,2013,9,23,20,958,748,1706,2175
0132-000,2013,9,23,21,786,596,1382,1706
0132-000,2013,9,23,22,667,447,1114,1382
0132-000,2013,9,23,23,422,353,775,1114
0132-000,2013,9,23,24,276,239,515,775
0132-000,2013,9,24,1,191,203,394,515
0132-000,2013,9,24,2,145,121,266,394
0132-000,2013,9,24,3,106,106,212,266
0132-000,2013,9,24,4,95,112,207,212
0132-000,2013,9,24,5,132,133,265,207
0132-000,2013,9,24,6,205,200,405,265
0132-000,2013,9,24,7,435,497,932,405
0132-000,2013,9,24,8,784,1344,2128,932
0132-000,2013,9,24,9,883,1340,2223,2128
0132-000,2013,9,24,10,920,1069,1989,2223
0132-000,2013,9,24,11,904,1015,1919,1989
0132-000,2013,9,24,12,915,928,1843,1919
0132-000,2013,9,24,13,872,961,1833,1843
0132-000,2013,9,24,14,923,955,1878,1833
0132-000,2013,9,24,15,1097,1023,2120,1878
0132-000,2013,9,24,16,1126,975,2101,2120
0132-000,2013,9,24,17,1070,873,1943,2101
0132-000,2013,9,24,18,1154,931,2085,1943
0132-000,2013,9,24,19,1221,906,2127,2085
0132-000,2013,9,24,20,942,727,1669,2127
0132-000,2013,9,24,21,795,614,1409,1669
0132-000,2013,9,24,22,644,511,1155,1409
0132-000,2013,9,24,23,434,376,810,1155
0132-000,2013,9,24,24,305,253,558,810
0132-000,2013,9,25,1,218,212,430,558
0132-000,2013,9,25,2,152,149,301,430
0132-000,2013,9,25,3,120,127,247,301
0132-000,2013,9,25,4,101,113,214,247
0132-000,2013,9,25,5,110,123,233,214
0132-000,2013,9,25,6,192,183,375,233
0132-000,2013,9,25,7,416,504,920,375
0132-000,2013,9,25,8,790,1373,2163,920
0132-000,2013,9,25,9,875,1318,2193,2163
0132-000,2013,9,25,10,838,1028,1866,2193
0132-000,2013,9,25,11,887,981,1868,1866
0132-000,2013,9,25,12,898,955,1853,1868
0132-000,2013,9,25,13,830,927,1757,1853
0132-000,2013,9,25,14,938,941,1879,1757
0132-000,2013,9,25,15,996,969,1965,1879
0132-000,2013,9,25,16,1076,941,2017,1965
0132-000,2013,9,25,17,1054,898,1952,2017
0132-000,2013,9,25,18,1237,887,2124,1952
0132-000,2013,9,25,19,1269,905,2174,2124
0132-000,2013,9,25,20,976,741,1717,2174
0132-000,2013,9,25,21,726,585,1311,1717
0132-000,2013,9,25,22,651,519,1170,1311
0132-000,2013,9,25,23,432,369,801,1170
0132-000,2013,9,25,24,294,256,550,801
0132-000,2013,9,26,1,202,241,443,550
0132-000,2013,9,26,2,159,175,334,443
0132-000,2013,9,26,3,121,137,258,334
0132-000,2013,9,26,4,91,160,251,258
0132-000,2013,9,26,5,125,152,277,251
0132-000,2013,9,26,6,205,231,436,277
0132-000,2013,9,26,7,396,571,967,436
0132-000,2013,9,26,8,769,1556,2325,967
0132-000,2013,9,26,9,914,1501,2415,2325
0132-000,2013,9,26,10,867,1161,2028,2415
0132-000,2013,9,26,11,924,1219,2143,2028
0132-000,2013,9,26,12,946,1007,1953,2143
0132-000,2013,9,26,13,841,778,1619,1953
0132-000,2013,9,26,14,939,849,1788,1619
0132-000,2013,9,26,15,1031,849,1880,1788
0132-000,2013,9,26,16,1030,850,1880,1880
0132-000,2013,9,26,17,1099,854,1953,1880
0132-000,2013,9,26,18,1228,837,2065,1953
0132-000,2013,9,26,19,1243,813,2056,2065
0132-000,2013,9,26,20,962,675,1637,2056
0132-000,2013,9,26,21,829,511,1340,1637
0132-000,2013,9,26,22,679,475,1154,1340
0132-000,2013,9,26,23,458,333,791,1154
0132-000,2013,9,26,24,313,240,553,791
0132-000,2013,9,27,1,175,167,342,553
0132-000,2013,9,27,2,119,115,234,342
0132-000,2013,9,27,3,85,104,189,234
0132-000,2013,9,27,4,82,103,185,189
0132-000,2013,9,27,5,98,116,214,185
0132-000,2013,9,27,6,172,167,339,214
0132-000,2013,9,27,7,410,451,861,339
0132-000,2013,9,27,8,756,1466,2222,861
0132-000,2013,9,27,9,893,1284,2177,2222
0132-000,2013,9,27,10,802,933,1735,2177
0132-000,2013,9,27,11,818,907,1725,1735
0132-000,2013,9,27,12,860,884,1744,1725
0132-000,2013,9,27,13,770,854,1624,1744
0132-000,2013,9,27,14,844,889,1733,1624
0132-000,2013,9,27,15,1001,954,1955,1733
0132-000,2013,9,27,16,1025,881,1906,1955
0132-000,2013,9,27,17,1065,888,1953,1906
0132-000,2013,9,27,18,1235,904,2139,1953
0132-000,2013,9,27,19,1429,954,2383,2139
0132-000,2013,9,27,20,1072,746,1818,2383
0132-000,2013,9,27,21,859,597,1456,1818
0132-000,2013,9,27,22,674,569,1243,1456
0132-000,2013,9,27,23,438,392,830,1243
0132-000,2013,9,27,24,319,299,618,830
0132-000,2013,9,28,1,233,225,458,618
0132-000,2013,9,28,2,177,165,342,458
0132-000,2013,9,28,3,128,143,271,342
0132-000,2013,9,28,4,112,135,247,271
0132-000,2013,9,28,5,133,140,273,247
0132-000,2013,9,28,6,195,170,365,273
0132-000,2013,9,28,7,338,368,706,365
0132-000,2013,9,28,8,579,899,1478,706
0132-000,2013,9,28,9,736,1039,1775,1478
0132-000,2013,9,28,10,774,1075,1849,1775
0132-000,2013,9,28,11,849,1158,2007,1849
0132-000,2013,9,28,12,908,1209,2117,2007
0132-000,2013,9,28,13,1002,1133,2135,2117
0132-000,2013,9,28,14,993,1003,1996,2135
0132-000,2013,9,28,15,1056,912,1968,1996
0132-000,2013,9,28,16,1142,876,2018,1968
0132-000,2013,9,28,17,1284,914,2198,2018
0132-000,2013,9,28,18,1409,963,2372,2198
0132-000,2013,9,28,19,1303,857,2160,2372
0132-000,2013,9,28,20,958,669,1627,2160
0132-000,2013,9,28,21,713,534,1247,1627
0132-000,2013,9,28,22,541,462,1003,1247
0132-000,2013,9,28,23,346,348,694,1003
0132-000,2013,9,28,24,245,265,510,694
0132-000,2013,9,29,1,209,190,399,510
0132-000,2013,9,29,2,156,157,313,399
0132-000,2013,9,29,3,119,112,231,313
0132-000,2013,9,29,4,93,92,185,231
0132-000,2013,9,29,5,110,82,192,185
0132-000,2013,9,29,6,117,132,249,192
0132-000,2013,9,29,7,250,262,512,249
0132-000,2013,9,29,8,302,451,753,512
0132-000,2013,9,29,9,422,552,974,753
0132-000,2013,9,29,10,482,631,1113,974
0132-000,2013,9,29,11,581,704,1285,1113
0132-000,2013,9,29,12,661,687,1348,1285
0132-000,2013,9,29,13,731,673,1404,1348
0132-000,2013,9,29,14,763,687,1450,1404
0132-000,2013,9,29,15,845,707,1552,1450
0132-000,2013,9,29,16,1004,708,1712,1552
0132-000,2013,9,29,17,1108,731,1839,1712
0132-000,2013,9,29,18,1214,784,1998,1839
0132-000,2013,9,29,19,1202,639,1841,1998
0132-000,2013,9,29,20,1018,544,1562,1841
0132-000,2013,9,29,21,762,491,1253,1562
0132-000,2013,9,29,22,593,421,1014,1253
0132-000,2013,9,29,23,364,318,682,1014
0132-000,2013,9,29,24,212,198,410,682
0132-000,2013,9,30,1,133,156,289,410
0132-000,2013,9,30,2,99,106,205,289
0132-000,2013,9,30,3,82,86,168,205
0132-000,2013,9,30,4,67,83,150,168
0132-000,2013,9,30,5,98,107,205,150
0132-000,2013,9,30,6,203,210,413,205
0132-000,2013,9,30,7,492,606,1098,413
0132-000,2013,9,30,8,771,1623,2394,1098
0132-000,2013,9,30,9,862,1404,2266,2394
0132-000,2013,9,30,10,790,940,1730,2266
0132-000,2013,9,30,11,819,936,1755,1730
0132-000,2013,9,30,12,866,924,1790,1755
0132-000,2013,9,30,13,779,898,1677,1790
0132-000,2013,9,30,14,895,954,1849,1677
0132-000,2013,9,30,15,967,983,1950,1849
0132-000,2013,9,30,16,988,920,1908,1950
0132-000,2013,9,30,17,1025,880,1905,1908
0132-000,2013,9,30,18,1161,889,2050,1905
0132-000,2013,9,30,19,1281,864,2145,2050
0132-000,2013,9,30,20,894,713,1607,2145
0132-000,2013,9,30,21,806,575,1381,1607
0132-000,2013,9,30,22,643,455,1098,1381
0132-000,2013,9,30,23,390,316,706,1098
0132-000,2013,9,30,24,239,220,459,706
0132-000,2013,10,1,1,91,92,183,459
0132-000,2013,10,1,2,63,65,128,183
0132-000,2013,10,1,3,29,58,87,128
0132-000,2013,10,1,4,47,63,110,87
0132-000,2013,10,1,5,49,71,120,110
0132-000,2013,10,1,6,84,81,165,120
0132-000,2013,10,1,7,182,247,429,165
0132-000,2013,10,1,8,304,687,991,429
0132-000,2013,10,1,9,378,613,991,991
0132-000,2013,10,1,10,342,429,771,991
0132-000,2013,10,1,11,361,399,760,771
0132-000,2013,10,1,12,578,532,1110,760
0132-000,2013,10,1,13,550,525,1075,1110
0132-000,2013,10,1,14,762,799,1561,1075
0132-000,2013,10,1,15,868,848,1716,1561
0132-000,2013,10,1,16,976,742,1718,1716
0132-000,2013,10,1,17,941,822,1763,1718
0132-000,2013,10,1,18,1082,807,1889,1763
0132-000,2013,10,1,19,1310,857,2167,1889
0132-000,2013,10,1,20,888,649,1537,2167
0132-000,2013,10,1,21,768,536,1304,1537
0132-000,2013,10,1,22,620,476,1096,1304
0132-000,2013,10,1,23,388,313,701,1096
0132-000,2013,10,1,24,245,180,425,701
0132-000,2013,10,2,1,163,180,343,425
0132-000,2013,10,2,2,104,128,232,343
0132-000,2013,10,2,3,85,107,192,232
0132-000,2013,10,2,4,94,92,186,192
0132-000,2013,10,2,5,82,94,176,186
0132-000,2013,10,2,6,158,157,315,176
0132-000,2013,10,2,7,352,426,778,315
0132-000,2013,10,2,8,692,1498,2190,778
0132-000,2013,10,2,9,835,1400,2235,2190
0132-000,2013,10,2,10,705,845,1550,2235
0132-000,2013,10,2,11,761,825,1586,1550
0132-000,2013,10,2,12,753,807,1560,1586
0132-000,2013,10,2,13,734,794,1528,1560
0132-000,2013,10,2,14,788,766,1554,1528
0132-000,2013,10,2,15,895,921,1816,1554
0132-000,2013,10,2,16,1055,790,1845,1816
0132-000,2013,10,2,17,1094,850,1944,1845
0132-000,2013,10,2,18,1278,831,2109,1944
0132-000,2013,10,2,19,1538,964,2502,2109
0132-000,2013,10,2,20,1232,739,1971,2502
0132-000,2013,10,2,21,901,592,1493,1971
0132-000,2013,10,2,22,617,502,1119,1493
0132-000,2013,10,2,23,388,358,746,1119
0132-000,2013,10,2,24,260,259,519,746
0132-000,2013,10,3,1,218,200,418,519
0132-000,2013,10,3,2,158,155,313,418
0132-000,2013,10,3,3,104,102,206,313
0132-000,2013,10,3,4,108,107,215,206
0132-000,2013,10,3,5,102,129,231,215
0132-000,2013,10,3,6,169,161,330,231
0132-000,2013,10,3,7,319,336,655,330
0132-000,2013,10,3,8,536,827,1363,655
0132-000,2013,10,3,9,601,834,1435,1363
0132-000,2013,10,3,10,654,869,1523,1435
0132-000,2013,10,3,11,711,1127,1838,1523
0132-000,2013,10,3,12,722,1102,1824,1838
0132-000,2013,10,3,13,644,886,1530,1824
0132-000,2013,10,3,14,759,774,1533,1530
0132-000,2013,10,3,15,810,783,1593,1533
0132-000,2013,10,3,16,890,688,1578,1593
0132-000,2013,10,3,17,976,672,1648,1578
0132-000,2013,10,3,18,1156,772,1928,1648
0132-000,2013,10,3,19,1158,733,1891,1928
0132-000,2013,10,3,20,761,540,1301,1891
0132-000,2013,10,3,21,597,433,1030,1301
0132-000,2013,10,3,22,499,408,907,1030
0132-000,2013,10,3,23,257,268,525,907
0132-000,2013,10,3,24,186,190,376,525
0132-000,2013,10,4,1,143,136,279,376
0132-000,2013,10,4,2,81,93,174,279
0132-000,2013,10,4,3,51,85,136,174
0132-000,2013,10,4,4,68,83,151,136
0132-000,2013,10,4,5,80,91,171,151
0132-000,2013,10,4,6,132,133,265,171
0132-000,2013,10,4,7,393,433,826,265
0132-000,2013,10,4,8,715,1510,2225,826
0132-000,2013,10,4,9,843,1337,2180,2225
0132-000,2013,10,4,10,737,849,1586,2180
0132-000,2013,10,4,11,762,849,1611,1586
0132-000,2013,10,4,12,798,807,1605,1611
0132-000,2013,10,4,13,738,797,1535,1605
0132-000,2013,10,4,14,783,848,1631,1535
0132-000,2013,10,4,15,958,912,1870,1631
0132-000,2013,10,4,16,984,792,1776,1870
0132-000,2013,10,4,17,996,897,1893,1776
0132-000,2013,10,4,18,1154,867,2021,1893
0132-000,2013,10,4,19,1413,899,2312,2021
0132-000,2013,10,4,20,1043,699,1742,2312
0132-000,2013,10,4,21,824,583,1407,1742
0132-000,2013,10,4,22,603,571,1174,1407
0132-000,2013,10,4,23,377,350,727,1174
0132-000,2013,10,4,24,254,271,525,727
0132-000,2013,10,5,1,210,204,414,525
0132-000,2013,10,5,2,149,147,296,414
0132-000,2013,10,5,3,109,123,232,296
0132-000,2013,10,5,4,88,116,204,232
0132-000,2013,10,5,5,107,111,218,204
0132-000,2013,10,5,6,165,149,314,218
0132-000,2013,10,5,7,312,348,660,314
0132-000,2013,10,5,8,546,919,1465,660
0132-000,2013,10,5,9,684,1082,1766,1465
0132-000,2013,10,5,10,749,1076,1825,1766
0132-000,2013,10,5,11,849,1116,1965,1825
0132-000,2013,10,5,12,937,1320,2257,1965
0132-000,2013,10,5,13,1022,1199,2221,2257
0132-000,2013,10,5,14,1079,1022,2101,2221
0132-000,2013,10,5,15,1090,922,2012,2101
0132-000,2013,10,5,16,1252,880,2132,2012
0132-000,2013,10,5,17,1462,936,2398,2132
0132-000,2013,10,5,18,1524,947,2471,2398
0132-000,2013,10,5,19,1345,792,2137,2471
0132-000,2013,10,5,20,1019,608,1627,2137
0132-000,2013,10,5,21,782,504,1286,1627
0132-000,2013,10,5,22,554,435,989,1286
0132-000,2013,10,5,23,333,310,643,989
0132-000,2013,10,5,24,211,248,459,643
0132-000,2013,10,6,1,191,173,364,459
0132-000,2013,10,6,2,147,143,290,364
0132-000,2013,10,6,3,115,102,217,290
0132-000,2013,10,6,4,82,85,167,217
0132-000,2013,10,6,5,93,74,167,167
0132-000,2013,10,6,6,107,122,229,167
0132-000,2013,10,6,7,237,246,483,229
0132-000,2013,10,6,8,302,468,770,483
0132-000,2013,10,6,9,379,545,924,770
0132-000,2013,10,6,10,435,631,1066,924
0132-000,2013,10,6,11,526,707,1233,1066
0132-000,2013,10,6,12,669,719,1388,1233
0132-000,2013,10,6,13,749,624,1373,1388
0132-000,2013,10,6,14,782,704,1486,1373
0132-000,2013,10,6,15,842,668,1510,1486
0132-000,2013,10,6,16,1078,685,1763,1510
0132-000,2013,10,6,17,1236,733,1969,1763
0132-000,2013,10,6,18,1363,843,2206,1969
0132-000,2013,10,6,19,1304,598,1902,2206
0132-000,2013,10,6,20,1187,535,1722,1902
0132-000,2013,10,6,21,859,448,1307,1722
0132-000,2013,10,6,22,658,356,1014,1307
0132-000,2013,10,6,23,372,277,649,1014
0132-000,2013,10,6,24,192,151,343,649
0132-000,2013,10,7,1,102,122,224,343
0132-000,2013,10,7,2,94,89,183,224
0132-000,2013,10,7,3,74,79,153,183
0132-000,2013,10,7,4,49,69,118,153
0132-000,2013,10,7,5,83,96,179,118
0132-000,2013,10,7,6,179,197,376,179
0132-000,2013,10,7,7,493,549,1042,376
0132-000,2013,10,7,8,725,1652,2377,1042
0132-000,2013,10,7,9,840,1432,2272,2377
0132-000,2013,10,7,10,737,864,1601,2272
0132-000,2013,10,7,11,772,877,1649,1601
0132-000,2013,10,7,12,846,836,1682,1649
0132-000,2013,10,7,13,726,826,1552,1682
0132-000,2013,10,7,14,822,868,1690,1552
0132-000,2013,10,7,15,923,911,1834,1690
0132-000,2013,10,7,16,949,881,1830,1834
0132-000,2013,10,7,17,969,829,1798,1830
0132-000,2013,10,7,18,1105,853,1958,1798
0132-000,2013,10,7,19,1305,809,2114,1958
0132-000,2013,10,7,20,830,678,1508,2114
0132-000,2013,10,7,21,825,554,1379,1508
0132-000,2013,10,7,22,618,463,1081,1379
0132-000,2013,10,7,23,358,279,637,1081
0132-000,2013,10,7,24,202,200,402,637
0132-000,2013,10,8,1,162,144,306,402
0132-000,2013,10,8,2,84,107,191,306
0132-000,2013,10,8,3,79,81,160,191
0132-000,2013,10,8,4,79,93,172,160
0132-000,2013,10,8,5,110,106,216,172
0132-000,2013,10,8,6,172,132,304,216
0132-000,2013,10,8,7,313,389,702,304
0132-000,2013,10,8,8,668,1400,2068,702
0132-000,2013,10,8,9,796,1398,2194,2068
0132-000,2013,10,8,10,744,847,1591,2194
0132-000,2013,10,8,11,769,839,1608,1591
0132-000,2013,10,8,12,783,776,1559,1608
0132-000,2013,10,8,13,770,752,1522,1559
0132-000,2013,10,8,14,769,792,1561,1522
0132-000,2013,10,8,15,871,829,1700,1561
0132-000,2013,10,8,16,935,764,1699,1700
0132-000,2013,10,8,17,958,765,1723,1699
0132-000,2013,10,8,18,1119,798,1917,1723
0132-000,2013,10,8,19,1268,903,2171,1917
0132-000,2013,10,8,20,887,634,1521,2171
0132-000,2013,10,8,21,775,552,1327,1521
0132-000,2013,10,8,22,612,448,1060,1327
0132-000,2013,10,8,23,376,323,699,1060
0132-000,2013,10,8,24,256,219,475,699
0132-000,2013,10,9,1,195,220,415,475
0132-000,2013,10,9,2,136,139,275,415
0132-000,2013,10,9,3,116,122,238,275
0132-000,2013,10,9,4,76,93,169,238
0132-000,2013,10,9,5,104,100,204,169
0132-000,2013,10,9,6,149,138,287,204
0132-000,2013,10,9,7,289,311,600,287
0132-000,2013,10,9,8,488,799,1287,600
0132-000,2013,10,9,9,612,873,1485,1287
0132-000,2013,10,9,10,611,739,1350,1485
0132-000,2013,10,9,11,683,765,1448,1350
0132-000,2013,10,9,12,685,819,1504,1448
0132-000,2013,10,9,13,689,790,1479,1504
0132-000,2013,10,9,14,795,759,1554,1479
0132-000,2013,10,9,15,820,718,1538,1554
0132-000,2013,10,9,16,809,702,1511,1538
0132-000,2013,10,9,17,851,739,1590,1511
0132-000,2013,10,9,18,1067,784,1851,1590
0132-000,2013,10,9,19,1077,748,1825,1851
0132-000,2013,10,9,20,684,518,1202,1825
0132-000,2013,10,9,21,532,423,955,1202
0132-000,2013,10,9,22,412,371,783,955
0132-000,2013,10,9,23,290,254,544,783
0132-000,2013,10,9,24,197,191,388,544
0132-000,2013,10,10,1,117,147,264,388
0132-000,2013,10,10,2,99,86,185,264
0132-000,2013,10,10,3,88,102,190,185
0132-000,2013,10,10,4,75,79,154,190
0132-000,2013,10,10,5,97,86,183,154
0132-000,2013,10,10,6,152,154,306,183
0132-000,2013,10,10,7,407,443,850,306
0132-000,2013,10,10,8,754,1630,2384,850
0132-000,2013,10,10,9,887,1436,2323,2384
0132-000,2013,10,10,10,758,863,1621,2323
0132-000,2013,10,10,11,723,837,1560,1621
0132-000,2013,10,10,12,795,792,1587,1560
0132-000,2013,10,10,13,761,773,1534,1587
0132-000,2013,10,10,14,816,867,1683,1534
0132-000,2013,10,10,15,890,892,1782,1683
0132-000,2013,10,10,16,925,871,1796,1782
0132-000,2013,10,10,17,1032,851,1883,1796
0132-000,2013,10,10,18,1112,873,1985,1883
0132-000,2013,10,10,19,1278,902,2180,1985
0132-000,2013,10,10,20,855,657,1512,2180
0132-000,2013,10,10,21,784,517,1301,1512
0132-000,2013,10,10,22,651,472,1123,1301
0132-000,2013,10,10,23,413,338,751,1123
0132-000,2013,10,10,24,244,223,467,751
0132-000,2013,10,11,1,202,185,387,467
0132-000,2013,10,11,2,134,101,235,387
0132-000,2013,10,11,3,114,121,235,235
0132-000,2013,10,11,4,124,111,235,235
0132-000,2013,10,11,5,99,105,204,235
0132-000,2013,10,11,6,155,146,301,204
0132-000,2013,10,11,7,383,415,798,301
0132-000,2013,10,11,8,711,1514,2225,798
0132-000,2013,10,11,9,838,1351,2189,2225
0132-000,2013,10,11,10,731,913,1644,2189
0132-000,2013,10,11,11,750,882,1632,1644
0132-000,2013,10,11,12,810,890,1700,1632
0132-000,2013,10,11,13,755,771,1526,1700
0132-000,2013,10,11,14,861,812,1673,1526
0132-000,2013,10,11,15,920,876,1796,1673
0132-000,2013,10,11,16,1003,859,1862,1796
0132-000,2013,10,11,17,1006,902,1908,1862
0132-000,2013,10,11,18,1229,939,2168,1908
0132-000,2013,10,11,19,1494,889,2383,2168
0132-000,2013,10,11,20,1025,688,1713,2383
0132-000,2013,10,11,21,838,659,1497,1713
0132-000,2013,10,11,22,616,491,1107,1497
0132-000,2013,10,11,23,448,372,820,1107
0132-000,2013,10,11,24,258,268,526,820
0132-000,2013,10,12,1,169,187,356,526
0132-000,2013,10,12,2,149,151,300,356
0132-000,2013,10,12,3,99,123,222,300
0132-000,2013,10,12,4,77,114,191,222
0132-000,2013,10,12,5,125,123,248,191
0132-000,2013,10,12,6,159,170,329,248
0132-000,2013,10,12,7,350,361,711,329
0132-000,2013,10,12,8,583,961,1544,711
0132-000,2013,10,12,9,721,1118,1839,1544
0132-000,2013,10,12,10,792,1165,1957,1839
0132-000,2013,10,12,11,822,1321,2143,1957
0132-000,2013,10,12,12,916,1315,2231,2143
0132-000,2013,10,12,13,895,1321,2216,2231
0132-000,2013,10,12,14,919,1119,2038,2216
0132-000,2013,10,12,15,1113,948,2061,2038
0132-000,2013,10,12,16,1091,980,2071,2061
0132-000,2013,10,12,17,1279,982,2261,2071
0132-000,2013,10,12,18,1566,973,2539,2261
0132-000,2013,10,12,19,1409,805,2214,2539
0132-000,2013,10,12,20,1052,590,1642,2214
0132-000,2013,10,12,21,747,482,1229,1642
0132-000,2013,10,12,22,571,496,1067,1229
0132-000,2013,10,12,23,341,353,694,1067
0132-000,2013,10,12,24,253,276,529,694
0132-000,2013,10,13,1,163,196,359,529
0132-000,2013,10,13,2,155,154,309,359
0132-000,2013,10,13,3,122,115,237,309
0132-000,2013,10,13,4,86,99,185,237
0132-000,2013,10,13,5,102,100,202,185
0132-000,2013,10,13,6,135,133,268,202
0132-000,2013,10,13,7,218,225,443,268
0132-000,2013,10,13,8,312,432,744,443
0132-000,2013,10,13,9,379,559,938,744
0132-000,2013,10,13,10,521,673,1194,938
0132-000,2013,10,13,11,562,716,1278,1194
0132-000,2013,10,13,12,628,741,1369,1278
0132-000,2013,10,13,13,675,676,1351,1369
0132-000,2013,10,13,14,804,757,1561,1351
0132-000,2013,10,13,15,894,752,1646,1561
0132-000,2013,10,13,16,1069,717,1786,1646
0132-000,2013,10,13,17,1191,765,1956,1786
0132-000,2013,10,13,18,1329,746,2075,1956
0132-000,2013,10,13,19,1327,669,1996,2075
0132-000,2013,10,13,20,1106,517,1623,1996
0132-000,2013,10,13,21,928,521,1449,1623
0132-000,2013,10,13,22,732,452,1184,1449
0132-000,2013,10,13,23,432,307,739,1184
0132-000,2013,10,13,24,190,183,373,739
0132-000,2013,10,14,1,130,140,270,373
0132-000,2013,10,14,2,81,100,181,270
0132-000,2013,10,14,3,59,69,128,181
0132-000,2013,10,14,4,58,64,122,128
0132-000,2013,10,14,5,110,97,207,122
0132-000,2013,10,14,6,152,202,354,207
0132-000,2013,10,14,7,479,516,995,354
0132-000,2013,10,14,8,723,1642,2365,995
0132-000,2013,10,14,9,836,1353,2189,2365
0132-000,2013,10,14,10,776,968,1744,2189
0132-000,2013,10,14,11,782,950,1732,1744
0132-000,2013,10,14,12,827,903,1730,1732
0132-000,2013,10,14,13,742,804,1546,1730
0132-000,2013,10,14,14,845,863,1708,1546
0132-000,2013,10,14,15,948,949,1897,1708
0132-000,2013,10,14,16,952,846,1798,1897
0132-000,2013,10,14,17,914,840,1754,1798
0132-000,2013,10,14,18,1107,922,2029,1754
0132-000,2013,10,14,19,1232,897,2129,2029
0132-000,2013,10,14,20,856,642,1498,2129
0132-000,2013,10,14,21,765,548,1313,1498
0132-000,2013,10,14,22,601,392,993,1313
0132-000,2013,10,14,23,360,281,641,993
0132-000,2013,10,14,24,234,189,423,641
0132-000,2013,10,15,1,154,186,340,423
0132-000,2013,10,15,2,97,75,172,340
0132-000,2013,10,15,3,79,80,159,172
0132-000,2013,10,15,4,69,73,142,159
0132-000,2013,10,15,5,83,109,192,142
0132-000,2013,10,15,6,142,148,290,192
0132-000,2013,10,15,7,370,413,783,290
0132-000,2013,10,15,8,693,1506,2199,783
0132-000,2013,10,15,9,840,1370,2210,2199
0132-000,2013,10,15,10,791,874,1665,2210
0132-000,2013,10,15,11,749,870,1619,1665
0132-000,2013,10,15,12,725,793,1518,1619
0132-000,2013,10,15,13,709,766,1475,1518
0132-000,2013,10,15,14,840,838,1678,1475
0132-000,2013,10,15,15,854,810,1664,1678
0132-000,2013,10,15,16,892,805,1697,1664
0132-000,2013,10,15,17,908,816,1724,1697
0132-000,2013,10,15,18,1050,854,1904,1724
0132-000,2013,10,15,19,1219,843,2062,1904
0132-000,2013,10,15,20,825,562,1387,2062
0132-000,2013,10,15,21,702,517,1219,1387
0132-000,2013,10,15,22,540,426,966,1219
0132-000,2013,10,15,23,475,269,744,966
0132-000,2013,10,15,24,236,178,414,744
0132-000,2013,10,16,1,137,138,275,414
0132-000,2013,10,16,2,87,85,172,275
0132-000,2013,10,16,3,85,82,167,172
0132-000,2013,10,16,4,66,86,152,167
0132-000,2013,10,16,5,100,101,201,152
0132-000,2013,10,16,6,109,164,273,201
0132-000,2013,10,16,7,383,424,807,273
0132-000,2013,10,16,8,684,1538,2222,807
0132-000,2013,10,16,9,813,1373,2186,2222
0132-000,2013,10,16,10,748,931,1679,2186
0132-000,2013,10,16,11,788,859,1647,1679
0132-000,2013,10,16,12,846,845,1691,1647
0132-000,2013,10,16,13,730,778,1508,1691
0132-000,2013,10,16,14,828,831,1659,1508
0132-000,2013,10,16,15,882,893,1775,1659
0132-000,2013,10,16,16,969,859,1828,1775
0132-000,2013,10,16,17,990,867,1857,1828
0132-000,2013,10,16,18,1226,933,2159,1857
0132-000,2013,10,16,19,1317,875,2192,2159
0132-000,2013,10,16,20,896,660,1556,2192
0132-000,2013,10,16,21,746,479,1225,1556
0132-000,2013,10,16,22,571,433,1004,1225
0132-000,2013,10,16,23,385,318,703,1004
0132-000,2013,10,16,24,223,211,434,703
0132-000,2013,10,17,1,149,148,297,434
0132-000,2013,10,17,2,119,129,248,297
0132-000,2013,10,17,3,93,110,203,248
0132-000,2013,10,17,4,80,91,171,203
0132-000,2013,10,17,5,91,84,175,171
0132-000,2013,10,17,6,149,166,315,175
0132-000,2013,10,17,7,396,405,801,315
0132-000,2013,10,17,8,709,1485,2194,801
0132-000,2013,10,17,9,812,1423,2235,2194
0132-000,2013,10,17,10,792,909,1701,2235
0132-000,2013,10,17,11,760,830,1590,1701
0132-000,2013,10,17,12,779,839,1618,1590
0132-000,2013,10,17,13,676,760,1436,1618
0132-000,2013,10,17,14,771,842,1613,1436
0132-000,2013,10,17,15,914,870,1784,1613
0132-000,2013,10,17,16,951,838,1789,1784
0132-000,2013,10,17,17,893,778,1671,1789
0132-000,2013,10,17,18,1126,835,1961,1671
0132-000,2013,10,17,19,1197,865,2062,1961
0132-000,2013,10,17,20,830,614,1444,2062
0132-000,2013,10,17,21,715,504,1219,1444
0132-000,2013,10,17,22,593,472,1065,1219
0132-000,2013,10,17,23,357,312,669,1065
0132-000,2013,10,17,24,262,232,494,669
0132-000,2013,10,18,1,185,174,359,494
0132-000,2013,10,18,2,104,126,230,359
0132-000,2013,10,18,3,80,84,164,230
0132-000,2013,10,18,4,71,78,149,164
0132-000,2013,10,18,5,99,110,209,149
0132-000,2013,10,18,6,145,156,301,209
0132-000,2013,10,18,7,380,411,791,301
0132-000,2013,10,18,8,693,1471,2164,791
0132-000,2013,10,18,9,834,1381,2215,2164
0132-000,2013,10,18,10,788,894,1682,2215
0132-000,2013,10,18,11,834,837,1671,1682
0132-000,2013,10,18,12,841,871,1712,1671
0132-000,2013,10,18,13,768,806,1574,1712
0132-000,2013,10,18,14,807,853,1660,1574
0132-000,2013,10,18,15,939,854,1793,1660
0132-000,2013,10,18,16,913,844,1757,1793
0132-000,2013,10,18,17,1068,855,1923,1757
0132-000,2013,10,18,18,1277,981,2258,1923
0132-000,2013,10,18,19,1479,987,2466,2258
0132-000,2013,10,18,20,988,702,1690,2466
0132-000,2013,10,18,21,765,596,1361,1690
0132-000,2013,10,18,22,635,486,1121,1361
0132-000,2013,10,18,23,381,373,754,1121
0132-000,2013,10,18,24,251,263,514,754
0132-000,2013,10,19,1,233,224,457,514
0132-000,2013,10,19,2,149,157,306,457
0132-000,2013,10,19,3,112,113,225,306
0132-000,2013,10,19,4,96,121,217,225
0132-000,2013,10,19,5,123,122,245,217
0132-000,2013,10,19,6,161,152,313,245
0132-000,2013,10,19,7,328,325,653,313
0132-000,2013,10,19,8,531,776,1307,653
0132-000,2013,10,19,9,727,985,1712,1307
0132-000,2013,10,19,10,733,1074,1807,1712
0132-000,2013,10,19,11,802,1275,2077,1807
0132-000,2013,10,19,12,889,1382,2271,2077
0132-000,2013,10,19,13,775,1334,2109,2271
0132-000,2013,10,19,14,937,1098,2035,2109
0132-000,2013,10,19,15,915,1015,1930,2035
0132-000,2013,10,19,16,1033,933,1966,1930
0132-000,2013,10,19,17,1261,940,2201,1966
0132-000,2013,10,19,18,1516,1021,2537,2201
0132-000,2013,10,19,19,1423,923,2346,2537
0132-000,2013,10,19,20,1053,583,1636,2346
0132-000,2013,10,19,21,779,502,1281,1636
0132-000,2013,10,19,22,558,435,993,1281
0132-000,2013,10,19,23,333,299,632,993
0132-000,2013,10,19,24,233,247,480,632
0132-000,2013,10,20,1,195,166,361,480
0132-000,2013,10,20,2,130,144,274,361
0132-000,2013,10,20,3,107,114,221,274
0132-000,2013,10,20,4,91,98,189,221
0132-000,2013,10,20,5,104,92,196,189
0132-000,2013,10,20,6,127,134,261,196
0132-000,2013,10,20,7,224,185,409,261
0132-000,2013,10,20,8,270,400,670,409
0132-000,2013,10,20,9,441,476,917,670
0132-000,2013,10,20,10,460,608,1068,917
0132-000,2013,10,20,11,567,696,1263,1068
0132-000,2013,10,20,12,583,722,1305,1263
0132-000,2013,10,20,13,643,650,1293,1305
0132-000,2013,10,20,14,760,694,1454,1293
0132-000,2013,10,20,15,819,694,1513,1454
0132-000,2013,10,20,16,1098,750,1848,1513
0132-000,2013,10,20,17,1268,747,2015,1848
0132-000,2013,10,20,18,1466,771,2237,2015
0132-000,2013,10,20,19,1428,636,2064,2237
0132-000,2013,10,20,20,1320,500,1820,2064
0132-000,2013,10,20,21,1242,468,1710,1820
0132-000,2013,10,20,22,935,415,1350,1710
0132-000,2013,10,20,23,499,274,773,1350
0132-000,2013,10,20,24,250,193,443,773
0132-000,2013,10,21,1,130,142,272,443
0132-000,2013,10,21,2,88,92,180,272
0132-000,2013,10,21,3,52,78,130,180
0132-000,2013,10,21,4,62,66,128,130
0132-000,2013,10,21,5,86,85,171,128
0132-000,2013,10,21,6,156,166,322,171
0132-000,2013,10,21,7,421,503,924,322
0132-000,2013,10,21,8,701,1641,2342,924
0132-000,2013,10,21,9,820,1473,2293,2342
0132-000,2013,10,21,10,733,937,1670,2293
0132-000,2013,10,21,11,774,828,1602,1670
0132-000,2013,10,21,12,783,841,1624,1602
0132-000,2013,10,21,13,738,802,1540,1624
0132-000,2013,10,21,14,841,901,1742,1540
0132-000,2013,10,21,15,843,859,1702,1742
0132-000,2013,10,21,16,938,845,1783,1702
0132-000,2013,10,21,17,917,816,1733,1783
0132-000,2013,10,21,18,1133,854,1987,1733
0132-000,2013,10,21,19,1271,851,2122,1987
0132-000,2013,10,21,20,848,634,1482,2122
0132-000,2013,10,21,21,756,545,1301,1482
0132-000,2013,10,21,22,590,401,991,1301
0132-000,2013,10,21,23,319,284,603,991
0132-000,2013,10,21,24,215,196,411,603
0132-000,2013,10,22,1,165,142,307,411
0132-000,2013,10,22,2,118,100,218,307
0132-000,2013,10,22,3,90,74,164,218
0132-000,2013,10,22,4,65,87,152,164
0132-000,2013,10,22,5,95,107,202,152
0132-000,2013,10,22,6,159,155,314,202
0132-000,2013,10,22,7,368,426,794,314
0132-000,2013,10,22,8,722,1472,2194,794
0132-000,2013,10,22,9,836,1361,2197,2194
0132-000,2013,10,22,10,798,897,1695,2197
0132-000,2013,10,22,11,803,884,1687,1695
0132-000,2013,10,22,12,815,863,1678,1687
0132-000,2013,10,22,13,701,812,1513,1678
0132-000,2013,10,22,14,852,855,1707,1513
0132-000,2013,10,22,15,901,904,1805,1707
0132-000,2013,10,22,16,886,722,1608,1805
0132-000,2013,10,22,17,942,824,1766,1608
0132-000,2013,10,22,18,1110,839,1949,1766
0132-000,2013,10,22,19,1297,837,2134,1949
0132-000,2013,10,22,20,784,627,1411,2134
0132-000,2013,10,22,21,739,504,1243,1411
0132-000,2013,10,22,22,591,456,1047,1243
0132-000,2013,10,22,23,373,324,697,1047
0132-000,2013,10,22,24,236,218,454,697
0132-000,2013,10,23,1,153,170,323,454
0132-000,2013,10,23,2,119,108,227,323
0132-000,2013,10,23,3,80,94,174,227
0132-000,2013,10,23,4,65,93,158,174
0132-000,2013,10,23,5,92,112,204,158
0132-000,2013,10,23,6,137,134,271,204
0132-000,2013,10,23,7,380,417,797,271
0132-000,2013,10,23,8,722,1436,2158,797
0132-000,2013,10,23,9,820,1380,2200,2158
0132-000,2013,10,23,10,742,863,1605,2200
0132-000,2013,10,23,11,763,878,1641,1605
0132-000,2013,10,23,12,775,858,1633,1641
0132-000,2013,10,23,13,682,759,1441,1633
0132-000,2013,10,23,14,795,778,1573,1441
0132-000,2013,10,23,15,859,852,1711,1573
0132-000,2013,10,23,16,938,837,1775,1711
0132-000,2013,10,23,17,945,785,1730,1775
0132-000,2013,10,23,18,1177,848,2025,1730
0132-000,2013,10,23,19,1298,860,2158,2025
0132-000,2013,10,23,20,810,655,1465,2158
0132-000,2013,10,23,21,689,547,1236,1465
0132-000,2013,10,23,22,570,406,976,1236
0132-000,2013,10,23,23,368,315,683,976
0132-000,2013,10,23,24,225,238,463,683
0132-000,2013,10,24,1,164,160,324,463
0132-000,2013,10,24,2,114,108,222,324
0132-000,2013,10,24,3,77,93,170,222
0132-000,2013,10,24,4,94,113,207,170
0132-000,2013,10,24,5,109,102,211,207
0132-000,2013,10,24,6,146,157,303,211
0132-000,2013,10,24,7,374,424,798,303
0132-000,2013,10,24,8,679,1465,2144,798
0132-000,2013,10,24,9,888,1335,2223,2144
0132-000,2013,10,24,10,739,906,1645,2223
0132-000,2013,10,24,11,766,980,1746,1645
0132-000,2013,10,24,12,784,851,1635,1746
0132-000,2013,10,24,13,722,727,1449,1635
0132-000,2013,10,24,14,876,833,1709,1449
0132-000,2013,10,24,15,868,869,1737,1709
0132-000,2013,10,24,16,980,792,1772,1737
0132-000,2013,10,24,17,921,842,1763,1772
0132-000,2013,10,24,18,1143,813,1956,1763
0132-000,2013,10,24,19,1309,803,2112,1956
0132-000,2013,10,24,20,823,608,1431,2112
0132-000,2013,10,24,21,774,518,1292,1431
0132-000,2013,10,24,22,556,468,1024,1292
0132-000,2013,10,24,23,371,317,688,1024
0132-000,2013,10,24,24,222,220,442,688
0132-000,2013,10,25,1,169,164,333,442
0132-000,2013,10,25,2,106,101,207,333
0132-000,2013,10,25,3,85,96,181,207
0132-000,2013,10,25,4,72,90,162,181
0132-000,2013,10,25,5,93,115,208,162
0132-000,2013,10,25,6,156,153,309,208
0132-000,2013,10,25,7,319,412,731,309
0132-000,2013,10,25,8,708,1418,2126,731
0132-000,2013,10,25,9,863,1338,2201,2126
0132-000,2013,10,25,10,708,959,1667,2201
0132-000,2013,10,25,11,766,918,1684,1667
0132-000,2013,10,25,12,832,891,1723,1684
0132-000,2013,10,25,13,849,819,1668,1723
0132-000,2013,10,25,14,874,839,1713,1668
0132-000,2013,10,25,15,974,926,1900,1713
0132-000,2013,10,25,16,1017,816,1833,1900
0132-000,2013,10,25,17,1078,824,1902,1833
0132-000,2013,10,25,18,1237,901,2138,1902
0132-000,2013,10,25,19,1475,957,2432,2138
0132-000,2013,10,25,20,974,772,1746,2432
0132-000,2013,10,25,21,802,569,1371,1746
0132-000,2013,10,25,22,635,516,1151,1371
0132-000,2013,10,25,23,389,369,758,1151
0132-000,2013,10,25,24,266,260,526,758
0132-000,2013,10,26,1,188,208,396,526
0132-000,2013,10,26,2,135,146,281,396
0132-000,2013,10,26,3,117,110,227,281
0132-000,2013,10,26,4,102,112,214,227
0132-000,2013,10,26,5,117,134,251,214
0132-000,2013,10,26,6,175,162,337,251
0132-000,2013,10,26,7,329,344,673,337
0132-000,2013,10,26,8,511,845,1356,673
0132-000,2013,10,26,9,710,945,1655,1356
0132-000,2013,10,26,10,728,1127,1855,1655
0132-000,2013,10,26,11,780,1763,2543,1855
0132-000,2013,10,26,12,852,1617,2469,2543
0132-000,2013,10,26,13,1039,1330,2369,2469
0132-000,2013,10,26,14,1021,1108,2129,2369
0132-000,2013,10,26,15,981,1002,1983,2129
0132-000,2013,10,26,16,1036,990,2026,1983
0132-000,2013,10,26,17,1097,955,2052,2026
0132-000,2013,10,26,18,1301,1021,2322,2052
0132-000,2013,10,26,19,1267,909,2176,2322
0132-000,2013,10,26,20,810,628,1438,2176
0132-000,2013,10,26,21,665,495,1160,1438
0132-000,2013,10,26,22,548,445,993,1160
0132-000,2013,10,26,23,353,321,674,993
0132-000,2013,10,26,24,223,249,472,674
0132-000,2013,10,27,1,165,195,360,472
0132-000,2013,10,27,2,136,130,266,360
0132-000,2013,10,27,3,97,116,213,266
0132-000,2013,10,27,4,72,102,174,213
0132-000,2013,10,27,5,89,65,154,174
0132-000,2013,10,27,6,111,124,235,154
0132-000,2013,10,27,7,233,214,447,235
0132-000,2013,10,27,8,284,398,682,447
0132-000,2013,10,27,9,379,465,844,682
0132-000,2013,10,27,10,481,583,1064,844
0132-000,2013,10,27,11,589,654,1243,1064
0132-000,2013,10,27,12,627,696,1323,1243
0132-000,2013,10,27,13,680,658,1338,1323
0132-000,2013,10,27,14,772,742,1514,1338
0132-000,2013,10,27,15,950,789,1739,1514
0132-000,2013,10,27,16,1036,715,1751,1739
0132-000,2013,10,27,17,1305,811,2116,1751
0132-000,2013,10,27,18,1331,936,2267,2116
0132-000,2013,10,27,19,1343,716,2059,2267
0132-000,2013,10,27,20,1255,535,1790,2059
0132-000,2013,10,27,21,1339,516,1855,1790
0132-000,2013,10,27,22,1071,396,1467,1855
0132-000,2013,10,27,23,669,309,978,1467
0132-000,2013,10,27,24,277,191,468,978
0132-000,2013,10,28,1,140,142,282,468
0132-000,2013,10,28,2,74,89,163,282
0132-000,2013,10,28,3,56,59,115,163
0132-000,2013,10,28,4,46,53,99,115
0132-000,2013,10,28,5,84,83,167,99
0132-000,2013,10,28,6,149,159,308,167
0132-000,2013,10,28,7,412,487,899,308
0132-000,2013,10,28,8,720,1584,2304,899
0132-000,2013,10,28,9,804,1422,2226,2304
0132-000,2013,10,28,10,717,907,1624,2226
0132-000,2013,10,28,11,785,883,1668,1624
0132-000,2013,10,28,12,759,796,1555,1668
0132-000,2013,10,28,13,703,788,1491,1555
0132-000,2013,10,28,14,773,871,1644,1491
0132-000,2013,10,28,15,924,829,1753,1644
0132-000,2013,10,28,16,976,888,1864,1753
0132-000,2013,10,28,17,929,815,1744,1864
0132-000,2013,10,28,18,1050,890,1940,1744
0132-000,2013,10,28,19,1223,770,1993,1940
0132-000,2013,10,28,20,922,691,1613,1993
0132-000,2013,10,28,21,711,499,1210,1613
0132-000,2013,10,28,22,551,432,983,1210
0132-000,2013,10,28,23,335,296,631,983
0132-000,2013,10,28,24,207,172,379,631
0132-000,2013,10,29,1,135,145,280,379
0132-000,2013,10,29,2,90,95,185,280
0132-000,2013,10,29,3,94,88,182,185
0132-000,2013,10,29,4,77,90,167,182
0132-000,2013,10,29,5,100,102,202,167
0132-000,2013,10,29,6,130,146,276,202
0132-000,2013,10,29,7,337,367,704,276
0132-000,2013,10,29,8,700,1446,2146,704
0132-000,2013,10,29,9,822,1367,2189,2146
0132-000,2013,10,29,10,760,873,1633,2189
0132-000,2013,10,29,11,765,881,1646,1633
0132-000,2013,10,29,12,819,800,1619,1646
0132-000,2013,10,29,13,685,732,1417,1619
0132-000,2013,10,29,14,803,847,1650,1417
0132-000,2013,10,29,15,844,848,1692,1650
0132-000,2013,10,29,16,947,767,1714,1692
0132-000,2013,10,29,17,978,826,1804,1714
0132-000,2013,10,29,18,1120,798,1918,1804
0132-000,2013,10,29,19,1270,779,2049,1918
0132-000,2013,10,29,20,845,694,1539,2049
0132-000,2013,10,29,21,750,540,1290,1539
0132-000,2013,10,29,22,581,446,1027,1290
0132-000,2013,10,29,23,405,295,700,1027
0132-000,2013,10,29,24,230,222,452,700
0132-000,2013,10,30,1,147,149,296,452
0132-000,2013,10,30,2,115,88,203,296
0132-000,2013,10,30,3,101,106,207,203
0132-000,2013,10,30,4,77,95,172,207
0132-000,2013,10,30,5,90,90,180,172
0132-000,2013,10,30,6,164,134,298,180
0132-000,2013,10,30,7,319,393,712,298
0132-000,2013,10,30,8,691,1360,2051,712
0132-000,2013,10,30,9,800,1381,2181,2051
0132-000,2013,10,30,10,795,879,1674,2181
0132-000,2013,10,30,11,792,868,1660,1674
0132-000,2013,10,30,12,801,789,1590,1660
0132-000,2013,10,30,13,741,710,1451,1590
0132-000,2013,10,30,14,786,831,1617,1451
0132-000,2013,10,30,15,893,898,1791,1617
0132-000,2013,10,30,16,895,823,1718,1791
0132-000,2013,10,30,17,966,861,1827,1718
0132-000,2013,10,30,18,1140,826,1966,1827
0132-000,2013,10,30,19,1270,847,2117,1966
0132-000,2013,10,30,20,812,626,1438,2117
0132-000,2013,10,30,21,678,523,1201,1438
0132-000,2013,10,30,22,598,433,1031,1201
0132-000,2013,10,30,23,349,333,682,1031
0132-000,2013,10,30,24,228,211,439,682
0132-000,2013,10,31,1,172,167,339,439
0132-000,2013,10,31,2,103,98,201,339
0132-000,2013,10,31,3,65,100,165,201
0132-000,2013,10,31,4,70,90,160,165
0132-000,2013,10,31,5,115,92,207,160
0132-000,2013,10,31,6,130,122,252,207
0132-000,2013,10,31,7,345,362,707,252
0132-000,2013,10,31,8,664,1286,1950,707
0132-000,2013,10,31,9,841,1367,2208,1950
0132-000,2013,10,31,10,743,909,1652,2208
0132-000,2013,10,31,11,759,865,1624,1652
0132-000,2013,10,31,12,823,888,1711,1624
0132-000,2013,10,31,13,712,739,1451,1711
0132-000,2013,10,31,14,802,806,1608,1451
0132-000,2013,10,31,15,838,840,1678,1608
0132-000,2013,10,31,16,886,778,1664,1678
0132-000,2013,10,31,17,951,837,1788,1664
0132-000,2013,10,31,18,1090,837,1927,1788
0132-000,2013,10,31,19,1224,784,2008,1927
0132-000,2013,10,31,20,853,661,1514,2008
0132-000,2013,10,31,21,763,479,1242,1514
0132-000,2013,10,31,22,610,459,1069,1242
0132-000,2013,10,31,23,339,344,683,1069
0132-000,2013,10,31,24,275,230,505,683
0132-000,2013,11,1,1,162,172,334,505
0132-000,2013,11,1,2,122,131,253,334
0132-000,2013,11,1,3,88,109,197,253
0132-000,2013,11,1,4,87,84,171,197
0132-000,2013,11,1,5,100,103,203,171
0132-000,2013,11,1,6,142,142,284,203
0132-000,2013,11,1,7,366,369,735,284
0132-000,2013,11,1,8,664,1393,2057,735
0132-000,2013,11,1,9,831,1399,2230,2057
0132-000,2013,11,1,10,748,872,1620,2230
0132-000,2013,11,1,11,736,876,1612,1620
0132-000,2013,11,1,12,830,843,1673,1612
0132-000,2013,11,1,13,675,827,1502,1673
0132-000,2013,11,1,14,880,812,1692,1502
0132-000,2013,11,1,15,893,861,1754,1692
0132-000,2013,11,1,16,985,837,1822,1754
0132-000,2013,11,1,17,957,848,1805,1822
0132-000,2013,11,1,18,1174,889,2063,1805
0132-000,2013,11,1,19,1481,880,2361,2063
0132-000,2013,11,1,20,1037,718,1755,2361
0132-000,2013,11,1,21,781,568,1349,1755
0132-000,2013,11,1,22,606,506,1112,1349
0132-000,2013,11,1,23,394,367,761,1112
0132-000,2013,11,1,24,249,251,500,761
0132-000,2013,11,2,1,195,192,387,500
0132-000,2013,11,2,2,124,139,263,387
0132-000,2013,11,2,3,100,121,221,263
0132-000,2013,11,2,4,97,97,194,221
0132-000,2013,11,2,5,98,117,215,194
0132-000,2013,11,2,6,142,141,283,215
0132-000,2013,11,2,7,295,310,605,283
0132-000,2013,11,2,8,479,735,1214,605
0132-000,2013,11,2,9,713,901,1614,1214
0132-000,2013,11,2,10,701,1011,1712,1614
0132-000,2013,11,2,11,781,1031,1812,1712
0132-000,2013,11,2,12,884,1199,2083,1812
0132-000,2013,11,2,13,896,1113,2009,2083
0132-000,2013,11,2,14,859,1096,1955,2009
0132-000,2013,11,2,15,870,1091,1961,1955
0132-000,2013,11,2,16,1009,1102,2111,1961
0132-000,2013,11,2,17,1095,1068,2163,2111
0132-000,2013,11,2,18,1388,1069,2457,2163
0132-000,2013,11,2,19,1254,930,2184,2457
0132-000,2013,11,2,20,1036,654,1690,2184
0132-000,2013,11,2,21,760,514,1274,1690
0132-000,2013,11,2,22,624,425,1049,1274
0132-000,2013,11,2,23,353,313,666,1049
0132-000,2013,11,2,24,211,219,430,666
0132-000,2013,11,3,1,163,168,331,430
0132-000,2013,11,3,2,126,129,255,331
0132-000,2013,11,3,3,132,119,251,255
0132-000,2013,11,3,4,77,66,143,251
0132-000,2013,11,3,5,106,86,192,143
0132-000,2013,11,3,6,110,109,219,192
0132-000,2013,11,3,7,196,186,382,219
0132-000,2013,11,3,8,283,347,630,382
0132-000,2013,11,3,9,361,488,849,630
0132-000,2013,11,3,10,459,576,1035,849
0132-000,2013,11,3,11,541,658,1199,1035
0132-000,2013,11,3,12,586,627,1213,1199
0132-000,2013,11,3,13,691,671,1362,1213
0132-000,2013,11,3,14,841,736,1577,1362
0132-000,2013,11,3,15,1160,762,1922,1577
0132-000,2013,11,3,16,1340,708,2048,1922
0132-000,2013,11,3,17,1463,679,2142,2048
0132-000,2013,11,3,18,1615,695,2310,2142
0132-000,2013,11,3,19,1514,603,2117,2310
0132-000,2013,11,3,20,1459,519,1978,2117
0132-000,2013,11,3,21,1558,430,1988,1978
0132-000,2013,11,3,22,1228,404,1632,1988
0132-000,2013,11,3,23,796,327,1123,1632
0132-000,2013,11,3,24,346,211,557,1123
0132-000,2013,11,4,1,128,151,279,557
0132-000,2013,11,4,2,82,94,176,279
0132-000,2013,11,4,3,65,72,137,176
0132-000,2013,11,4,4,57,69,126,137
0132-000,2013,11,4,5,95,78,173,126
0132-000,2013,11,4,6,165,141,306,173
0132-000,2013,11,4,7,380,434,814,306
0132-000,2013,11,4,8,703,1576,2279,814
0132-000,2013,11,4,9,741,1359,2100,2279
0132-000,2013,11,4,10,719,856,1575,2100
0132-000,2013,11,4,11,758,859,1617,1575
0132-000,2013,11,4,12,749,882,1631,1617
0132-000,2013,11,4,13,714,812,1526,1631
0132-000,2013,11,4,14,796,794,1590,1526
0132-000,2013,11,4,15,865,864,1729,1590
0132-000,2013,11,4,16,919,878,1797,1729
0132-000,2013,11,4,17,1003,846,1849,1797
0132-000,2013,11,4,18,1067,851,1918,1849
0132-000,2013,11,4,19,1206,711,1917,1918
0132-000,2013,11,4,20,834,632,1466,1917
0132-000,2013,11,4,21,739,504,1243,1466
0132-000,2013,11,4,22,569,430,999,1243
0132-000,2013,11,4,23,315,308,623,999
0132-000,2013,11,4,24,190,165,355,623
0132-000,2013,11,5,1,173,171,344,355
0132-000,2013,11,5,2,104,103,207,344
0132-000,2013,11,5,3,81,96,177,207
0132-000,2013,11,5,4,62,75,137,177
0132-000,2013,11,5,5,102,97,199,137
0132-000,2013,11,5,6,153,115,268,199
0132-000,2013,11,5,7,316,365,681,268
0132-000,2013,11,5,8,663,1439,2102,681
0132-000,2013,11,5,9,798,1405,2203,2102
0132-000,2013,11,5,10,846,868,1714,2203
0132-000,2013,11,5,11,774,872,1646,1714
0132-000,2013,11,5,12,783,870,1653,1646
0132-000,2013,11,5,13,735,815,1550,1653
0132-000,2013,11,5,14,811,847,1658,1550
0132-000,2013,11,5,15,861,849,1710,1658
0132-000,2013,11,5,16,1009,848,1857,1710
0132-000,2013,11,5,17,940,821,1761,1857
0132-000,2013,11,5,18,1091,842,1933,1761
0132-000,2013,11,5,19,1165,775,1940,1933
0132-000,2013,11,5,20,866,607,1473,1940
0132-000,2013,11,5,21,748,494,1242,1473
0132-000,2013,11,5,22,577,456,1033,1242
0132-000,2013,11,5,23,338,290,628,1033
0132-000,2013,11,5,24,240,198,438,628
0132-000,2013,11,6,1,141,161,302,438
0132-000,2013,11,6,2,122,132,254,302
0132-000,2013,11,6,3,85,96,181,254
0132-000,2013,11,6,4,86,77,163,181
0132-000,2013,11,6,5,90,79,169,163
0132-000,2013,11,6,6,175,153,328,169
0132-000,2013,11,6,7,358,409,767,328
0132-000,2013,11,6,8,676,1366,2042,767
0132-000,2013,11,6,9,796,1412,2208,2042
0132-000,2013,11,6,10,700,889,1589,2208
0132-000,2013,11,6,11,747,913,1660,1589
0132-000,2013,11,6,12,789,791,1580,1660
0132-000,2013,11,6,13,705,757,1462,1580
0132-000,2013,11,6,14,780,770,1550,1462
0132-000,2013,11,6,15,862,801,1663,1550
0132-000,2013,11,6,16,937,767,1704,1663
0132-000,2013,11,6,17,992,818,1810,1704
0132-000,2013,11,6,18,1190,865,2055,1810
0132-000,2013,11,6,19,1283,745,2028,2055
0132-000,2013,11,6,20,818,561,1379,2028
0132-000,2013,11,6,21,694,498,1192,1379
0132-000,2013,11,6,22,554,434,988,1192
0132-000,2013,11,6,23,354,309,663,988
0132-000,2013,11,6,24,232,245,477,663
0132-000,2013,11,7,1,144,134,278,477
0132-000,2013,11,7,2,92,106,198,278
0132-000,2013,11,7,3,88,105,193,198
0132-000,2013,11,7,4,74,95,169,193
0132-000,2013,11,7,5,91,100,191,169
0132-000,2013,11,7,6,142,118,260,191
0132-000,2013,11,7,7,299,366,665,260
0132-000,2013,11,7,8,683,1464,2147,665
0132-000,2013,11,7,9,791,1348,2139,2147
0132-000,2013,11,7,10,759,926,1685,2139
0132-000,2013,11,7,11,805,854,1659,1685
0132-000,2013,11,7,12,735,808,1543,1659
0132-000,2013,11,7,13,687,723,1410,1543
0132-000,2013,11,7,14,760,818,1578,1410
0132-000,2013,11,7,15,831,841,1672,1578
0132-000,2013,11,7,16,961,847,1808,1672
0132-000,2013,11,7,17,982,852,1834,1808
0132-000,2013,11,7,18,1158,852,2010,1834
0132-000,2013,11,7,19,1220,752,1972,2010
0132-000,2013,11,7,20,836,619,1455,1972
0132-000,2013,11,7,21,742,499,1241,1455
0132-000,2013,11,7,22,589,444,1033,1241
0132-000,2013,11,7,23,343,304,647,1033
0132-000,2013,11,7,24,254,214,468,647
0132-000,2013,11,8,1,163,163,326,468
0132-000,2013,11,8,2,116,94,210,326
0132-000,2013,11,8,3,95,105,200,210
0132-000,2013,11,8,4,92,113,205,200
0132-000,2013,11,8,5,76,96,172,205
0132-000,2013,11,8,6,156,139,295,172
0132-000,2013,11,8,7,343,406,749,295
0132-000,2013,11,8,8,663,1393,2056,749
0132-000,2013,11,8,9,802,1366,2168,2056
0132-000,2013,11,8,10,802,827,1629,2168
0132-000,2013,11,8,11,748,922,1670,1629
0132-000,2013,11,8,12,790,840,1630,1670
0132-000,2013,11,8,13,738,797,1535,1630
0132-000,2013,11,8,14,871,822,1693,1535
0132-000,2013,11,8,15,903,852,1755,1693
0132-000,2013,11,8,16,1021,815,1836,1755
0132-000,2013,11,8,17,984,869,1853,1836
0132-000,2013,11,8,18,1283,989,2272,1853
0132-000,2013,11,8,19,1399,873,2272,2272
0132-000,2013,11,8,20,1005,799,1804,2272
0132-000,2013,11,8,21,781,628,1409,1804
0132-000,2013,11,8,22,652,574,1226,1409
0132-000,2013,11,8,23,405,372,777,1226
0132-000,2013,11,8,24,254,245,499,777
0132-000,2013,11,9,1,206,219,425,499
0132-000,2013,11,9,2,173,170,343,425
0132-000,2013,11,9,3,108,121,229,343
0132-000,2013,11,9,4,102,124,226,229
0132-000,2013,11,9,5,104,125,229,226
0132-000,2013,11,9,6,152,148,300,229
0132-000,2013,11,9,7,299,324,623,300
0132-000,2013,11,9,8,525,778,1303,623
0132-000,2013,11,9,9,744,929,1673,1303
0132-000,2013,11,9,10,739,1026,1765,1673
0132-000,2013,11,9,11,845,1193,2038,1765
0132-000,2013,11,9,12,887,1291,2178,2038
0132-000,2013,11,9,13,907,1302,2209,2178
0132-000,2013,11,9,14,947,1135,2082,2209
0132-000,2013,11,9,15,939,1046,1985,2082
0132-000,2013,11,9,16,1096,1035,2131,1985
0132-000,2013,11,9,17,1156,1020,2176,2131
0132-000,2013,11,9,18,1303,1036,2339,2176
0132-000,2013,11,9,19,1248,811,2059,2339
0132-000,2013,11,9,20,946,679,1625,2059
0132-000,2013,11,9,21,817,521,1338,1625
0132-000,2013,11,9,22,623,410,1033,1338
0132-000,2013,11,9,23,364,323,687,1033
0132-000,2013,11,9,24,220,221,441,687
0132-000,2013,11,10,1,181,189,370,441
0132-000,2013,11,10,2,110,144,254,370
0132-000,2013,11,10,3,91,102,193,254
0132-000,2013,11,10,4,94,98,192,193
0132-000,2013,11,10,5,105,97,202,192
0132-000,2013,11,10,6,100,112,212,202
0132-000,2013,11,10,7,167,169,336,212
0132-000,2013,11,10,8,267,356,623,336
0132-000,2013,11,10,9,420,484,904,623
0132-000,2013,11,10,10,484,601,1085,904
0132-000,2013,11,10,11,605,676,1281,1085
0132-000,2013,11,10,12,666,636,1302,1281
0132-000,2013,11,10,13,715,674,1389,1302
0132-000,2013,11,10,14,957,725,1682,1389
0132-000,2013,11,10,15,1318,789,2107,1682
0132-000,2013,11,10,16,1443,772,2215,2107
0132-000,2013,11,10,17,1573,765,2338,2215
0132-000,2013,11,10,18,1669,743,2412,2338
0132-000,2013,11,10,19,1813,629,2442,2412
0132-000,2013,11,10,20,1645,563,2208,2442
0132-000,2013,11,10,21,1491,545,2036,2208
0132-000,2013,11,10,22,1423,415,1838,2036
0132-000,2013,11,10,23,1049,319,1368,1838
0132-000,2013,11,10,24,422,193,615,1368
0132-000,2013,11,11,1,137,141,278,615
0132-000,2013,11,11,2,91,88,179,278
0132-000,2013,11,11,3,62,85,147,179
0132-000,2013,11,11,4,61,77,138,147
0132-000,2013,11,11,5,90,77,167,138
0132-000,2013,11,11,6,141,154,295,167
0132-000,2013,11,11,7,358,493,851,295
0132-000,2013,11,11,8,728,1614,2342,851
0132-000,2013,11,11,9,843,1443,2286,2342
0132-000,2013,11,11,10,705,808,1513,2286
0132-000,2013,11,11,11,769,879,1648,1513
0132-000,2013,11,11,12,706,824,1530,1648
0132-000,2013,11,11,13,770,764,1534,1530
0132-000,2013,11,11,14,832,833,1665,1534
0132-000,2013,11,11,15,908,875,1783,1665
0132-000,2013,11,11,16,922,815,1737,1783
0132-000,2013,11,11,17,936,866,1802,1737
0132-000,2013,11,11,18,1114,808,1922,1802
0132-000,2013,11,11,19,1165,801,1966,1922
0132-000,2013,11,11,20,924,641,1565,1966
0132-000,2013,11,11,21,772,491,1263,1565
0132-000,2013,11,11,22,582,452,1034,1263
0132-000,2013,11,11,23,313,341,654,1034
0132-000,2013,11,11,24,211,208,419,654
0132-000,2013,11,12,1,145,141,286,419
0132-000,2013,11,12,2,103,102,205,286
0132-000,2013,11,12,3,82,74,156,205
0132-000,2013,11,12,4,57,89,146,156
0132-000,2013,11,12,5,101,98,199,146
0132-000,2013,11,12,6,132,136,268,199
0132-000,2013,11,12,7,336,405,741,268
0132-000,2013,11,12,8,669,1451,2120,741
0132-000,2013,11,12,9,822,1348,2170,2120
0132-000,2013,11,12,10,755,912,1667,2170
0132-000,2013,11,12,11,768,843,1611,1667
0132-000,2013,11,12,12,756,788,1544,1611
0132-000,2013,11,12,13,728,784,1512,1544
0132-000,2013,11,12,14,812,852,1664,1512
0132-000,2013,11,12,15,847,815,1662,1664
0132-000,2013,11,12,16,910,807,1717,1662
0132-000,2013,11,12,17,1009,814,1823,1717
0132-000,2013,11,12,18,1122,867,1989,1823
0132-000,2013,11,12,19,1209,761,1970,1989
0132-000,2013,11,12,20,847,618,1465,1970
0132-000,2013,11,12,21,750,501,1251,1465
0132-000,2013,11,12,22,563,449,1012,1251
0132-000,2013,11,12,23,359,297,656,1012
0132-000,2013,11,12,24,192,207,399,656
0132-000,2013,11,13,1,159,135,294,399
0132-000,2013,11,13,2,135,125,260,294
0132-000,2013,11,13,3,95,89,184,260
0132-000,2013,11,13,4,76,81,157,184
0132-000,2013,11,13,5,80,94,174,157
0132-000,2013,11,13,6,161,161,322,174
0132-000,2013,11,13,7,347,449,796,322
0132-000,2013,11,13,8,695,1414,2109,796
0132-000,2013,11,13,9,825,1427,2252,2109
0132-000,2013,11,13,10,722,814,1536,2252
0132-000,2013,11,13,11,753,911,1664,1536
0132-000,2013,11,13,12,802,820,1622,1664
0132-000,2013,11,13,13,723,789,1512,1622
0132-000,2013,11,13,14,866,781,1647,1512
0132-000,2013,11,13,15,871,859,1730,1647
0132-000,2013,11,13,16,899,838,1737,1730
0132-000,2013,11,13,17,1002,819,1821,1737
0132-000,2013,11,13,18,1193,906,2099,1821
0132-000,2013,11,13,19,1288,812,2100,2099
0132-000,2013,11,13,20,804,614,1418,2100
0132-000,2013,11,13,21,717,515,1232,1418
0132-000,2013,11,13,22,561,418,979,1232
0132-000,2013,11,13,23,374,300,674,979
0132-000,2013,11,13,24,220,227,447,674
0132-000,2013,11,14,1,163,147,310,447
0132-000,2013,11,14,2,111,131,242,310
0132-000,2013,11,14,3,98,106,204,242
0132-000,2013,11,14,4,70,84,154,204
0132-000,2013,11,14,5,90,95,185,154
0132-000,2013,11,14,6,149,139,288,185
0132-000,2013,11,14,7,368,392,760,288
0132-000,2013,11,14,8,708,1434,2142,760
0132-000,2013,11,14,9,788,1377,2165,2142
0132-000,2013,11,14,10,779,879,1658,2165
0132-000,2013,11,14,11,746,855,1601,1658
0132-000,2013,11,14,12,774,774,1548,1601
0132-000,2013,11,14,13,724,759,1483,1548
0132-000,2013,11,14,14,788,907,1695,1483
0132-000,2013,11,14,15,883,858,1741,1695
0132-000,2013,11,14,16,906,833,1739,1741
0132-000,2013,11,14,17,950,831,1781,1739
0132-000,2013,11,14,18,1178,829,2007,1781
0132-000,2013,11,14,19,1180,747,1927,2007
0132-000,2013,11,14,20,844,625,1469,1927
0132-000,2013,11,14,21,691,514,1205,1469
0132-000,2013,11,14,22,575,460,1035,1205
0132-000,2013,11,14,23,373,299,672,1035
0132-000,2013,11,14,24,250,217,467,672
0132-000,2013,11,15,1,177,196,373,467
0132-000,2013,11,15,2,101,123,224,373
0132-000,2013,11,15,3,118,109,227,224
0132-000,2013,11,15,4,71,101,172,227
0132-000,2013,11,15,5,75,107,182,172
0132-000,2013,11,15,6,171,137,308,182
0132-000,2013,11,15,7,346,373,719,308
0132-000,2013,11,15,8,639,1378,2017,719
0132-000,2013,11,15,9,765,1412,2177,2017
0132-000,2013,11,15,10,754,853,1607,2177
0132-000,2013,11,15,11,777,847,1624,1607
0132-000,2013,11,15,12,798,837,1635,1624
0132-000,2013,11,15,13,768,824,1592,1635
0132-000,2013,11,15,14,829,820,1649,1592
0132-000,2013,11,15,15,934,876,1810,1649
0132-000,2013,11,15,16,997,830,1827,1810
0132-000,2013,11,15,17,1065,968,2033,1827
0132-000,2013,11,15,18,1382,1003,2385,2033
0132-000,2013,11,15,19,1448,940,2388,2385
0132-000,2013,11,15,20,1070,768,1838,2388
0132-000,2013,11,15,21,813,640,1453,1838
0132-000,2013,11,15,22,604,508,1112,1453
0132-000,2013,11,15,23,443,382,825,1112
0132-000,2013,11,15,24,255,285,540,825
0132-000,2013,11,16,1,198,208,406,540
0132-000,2013,11,16,2,164,150,314,406
0132-000,2013,11,16,3,108,142,250,314
0132-000,2013,11,16,4,88,113,201,250
0132-000,2013,11,16,5,101,139,240,201
0132-000,2013,11,16,6,151,133,284,240
0132-000,2013,11,16,7,290,300,590,284
0132-000,2013,11,16,8,459,774,1233,590
0132-000,2013,11,16,9,687,1142,1829,1233
0132-000,2013,11,16,10,733,1203,1936,1829
0132-000,2013,11,16,11,785,1344,2129,1936
0132-000,2013,11,16,12,819,1396,2215,2129
0132-000,2013,11,16,13,871,1430,2301,2215
0132-000,2013,11,16,14,956,1333,2289,2301
0132-000,2013,11,16,15,1007,1316,2323,2289
0132-000,2013,11,16,16,1016,1158,2174,2323
0132-000,2013,11,16,17,1293,1208,2501,2174
0132-000,2013,11,16,18,1515,1135,2650,2501
0132-000,2013,11,16,19,1355,936,2291,2650
0132-000,2013,11,16,20,1210,648,1858,2291
0132-000,2013,11,16,21,1021,533,1554,1858
0132-000,2013,11,16,22,757,462,1219,1554
0132-000,2013,11,16,23,468,328,796,1219
0132-000,2013,11,16,24,239,246,485,796
0132-000,2013,11,17,1,165,178,343,485
0132-000,2013,11,17,2,150,148,298,343
0132-000,2013,11,17,3,92,114,206,298
0132-000,2013,11,17,4,78,84,162,206
0132-000,2013,11,17,5,87,95,182,162
0132-000,2013,11,17,6,113,101,214,182
0132-000,2013,11,17,7,199,172,371,214
0132-000,2013,11,17,8,266,359,625,371
0132-000,2013,11,17,9,398,524,922,625
0132-000,2013,11,17,10,478,602,1080,922
0132-000,2013,11,17,11,605,684,1289,1080
0132-000,2013,11,17,12,719,725,1444,1289
0132-000,2013,11,17,13,884,723,1607,1444
0132-000,2013,11,17,14,1104,698,1802,1607
0132-000,2013,11,17,15,1341,781,2122,1802
0132-000,2013,11,17,16,1524,747,2271,2122
0132-000,2013,11,17,17,1634,777,2411,2271
0132-000,2013,11,17,18,1763,758,2521,2411
0132-000,2013,11,17,19,1779,631,2410,2521
0132-000,2013,11,17,20,1753,517,2270,2410
0132-000,2013,11,17,21,1659,454,2113,2270
0132-000,2013,11,17,22,1423,401,1824,2113
0132-000,2013,11,17,23,1067,302,1369,1824
0132-000,2013,11,17,24,523,214,737,1369
0132-000,2013,11,18,1,145,121,266,737
0132-000,2013,11,18,2,88,92,180,266
0132-000,2013,11,18,3,67,73,140,180
0132-000,2013,11,18,4,64,63,127,140
0132-000,2013,11,18,5,68,91,159,127
0132-000,2013,11,18,6,136,138,274,159
0132-000,2013,11,18,7,376,469,845,274
0132-000,2013,11,18,8,684,1628,2312,845
0132-000,2013,11,18,9,768,1438,2206,2312
0132-000,2013,11,18,10,695,857,1552,2206
0132-000,2013,11,18,11,801,869,1670,1552
0132-000,2013,11,18,12,775,848,1623,1670
0132-000,2013,11,18,13,780,843,1623,1623
0132-000,2013,11,18,14,766,789,1555,1623
0132-000,2013,11,18,15,874,819,1693,1555
0132-000,2013,11,18,16,945,821,1766,1693
0132-000,2013,11,18,17,960,815,1775,1766
0132-000,2013,11,18,18,1055,839,1894,1775
0132-000,2013,11,18,19,1239,781,2020,1894
0132-000,2013,11,18,20,830,583,1413,2020
0132-000,2013,11,18,21,696,536,1232,1413
0132-000,2013,11,18,22,542,423,965,1232
0132-000,2013,11,18,23,321,292,613,965
0132-000,2013,11,18,24,186,182,368,613
0132-000,2013,11,19,1,122,137,259,368
0132-000,2013,11,19,2,93,93,186,259
0132-000,2013,11,19,3,77,93,170,186
0132-000,2013,11,19,4,46,84,130,170
0132-000,2013,11,19,5,84,86,170,130
0132-000,2013,11,19,6,128,139,267,170
0132-000,2013,11,19,7,350,386,736,267
0132-000,2013,11,19,8,667,1393,2060,736
0132-000,2013,11,19,9,794,1368,2162,2060
0132-000,2013,11,19,10,748,833,1581,2162
0132-000,2013,11,19,11,784,863,1647,1581
0132-000,2013,11,19,12,752,767,1519,1647
0132-000,2013,11,19,13,683,787,1470,1519
0132-000,2013,11,19,14,765,826,1591,1470
0132-000,2013,11,19,15,877,800,1677,1591
0132-000,2013,11,19,16,953,800,1753,1677
0132-000,2013,11,19,17,932,760,1692,1753
0132-000,2013,11,19,18,1179,851,2030,1692
0132-000,2013,11,19,19,1107,716,1823,2030
0132-000,2013,11,19,20,775,573,1348,1823
0132-000,2013,11,19,21,724,518,1242,1348
0132-000,2013,11,19,22,588,425,1013,1242
0132-000,2013,11,19,23,369,316,685,1013
0132-000,2013,11,19,24,228,223,451,685
0132-000,2013,11,20,1,179,142,321,451
0132-000,2013,11,20,2,117,120,237,321
0132-000,2013,11,20,3,98,79,177,237
0132-000,2013,11,20,4,64,89,153,177
0132-000,2013,11,20,5,89,89,178,153
0132-000,2013,11,20,6,130,116,246,178
0132-000,2013,11,20,7,317,353,670,246
0132-000,2013,11,20,8,675,1429,2104,670
0132-000,2013,11,20,9,794,1333,2127,2104
0132-000,2013,11,20,10,735,869,1604,2127
0132-000,2013,11,20,11,744,820,1564,1604
0132-000,2013,11,20,12,785,809,1594,1564
0132-000,2013,11,20,13,735,737,1472,1594
0132-000,2013,11,20,14,817,804,1621,1472
0132-000,2013,11,20,15,942,813,1755,1621
0132-000,2013,11,20,16,894,863,1757,1755
0132-000,2013,11,20,17,972,874,1846,1757
0132-000,2013,11,20,18,1187,840,2027,1846
0132-000,2013,11,20,19,1238,824,2062,2027
0132-000,2013,11,20,20,844,594,1438,2062
0132-000,2013,11,20,21,688,489,1177,1438
0132-000,2013,11,20,22,576,433,1009,1177
0132-000,2013,11,20,23,345,312,657,1009
0132-000,2013,11,20,24,214,213,427,657
0132-000,2013,11,21,1,149,152,301,427
0132-000,2013,11,21,2,103,111,214,301
0132-000,2013,11,21,3,119,94,213,214
0132-000,2013,11,21,4,90,105,195,213
0132-000,2013,11,21,5,86,87,173,195
0132-000,2013,11,21,6,135,145,280,173
0132-000,2013,11,21,7,366,400,766,280
0132-000,2013,11,21,8,667,1412,2079,766
0132-000,2013,11,21,9,787,1428,2215,2079
0132-000,2013,11,21,10,753,845,1598,2215
0132-000,2013,11,21,11,765,882,1647,1598
0132-000,2013,11,21,12,815,807,1622,1647
0132-000,2013,11,21,13,714,762,1476,1622
0132-000,2013,11,21,14,830,789,1619,1476
0132-000,2013,11,21,15,900,771,1671,1619
0132-000,2013,11,21,16,922,818,1740,1671
0132-000,2013,11,21,17,915,921,1836,1740
0132-000,2013,11,21,18,1201,834,2035,1836
0132-000,2013,11,21,19,1196,791,1987,2035
0132-000,2013,11,21,20,802,542,1344,1987
0132-000,2013,11,21,21,747,534,1281,1344
0132-000,2013,11,21,22,609,454,1063,1281
0132-000,2013,11,21,23,356,299,655,1063
0132-000,2013,11,21,24,272,230,502,655
0132-000,2013,11,22,1,169,165,334,502
0132-000,2013,11,22,2,101,126,227,334
0132-000,2013,11,22,3,87,106,193,227
0132-000,2013,11,22,4,74,84,158,193
0132-000,2013,11,22,5,87,111,198,158
0132-000,2013,11,22,6,142,132,274,198
0132-000,2013,11,22,7,334,379,713,274
0132-000,2013,11,22,8,633,1364,1997,713
0132-000,2013,11,22,9,801,1399,2200,1997
0132-000,2013,11,22,10,768,809,1577,2200
0132-000,2013,11,22,11,721,852,1573,1577
0132-000,2013,11,22,12,798,820,1618,1573
0132-000,2013,11,22,13,716,736,1452,1618
0132-000,2013,11,22,14,821,840,1661,1452
0132-000,2013,11,22,15,897,871,1768,1661
0132-000,2013,11,22,16,956,818,1774,1768
0132-000,2013,11,22,17,1030,869,1899,1774
0132-000,2013,11,22,18,1218,931,2149,1899
0132-000,2013,11,22,19,1457,1029,2486,2149
0132-000,2013,11,22,20,955,821,1776,2486
0132-000,2013,11,22,21,823,577,1400,1776
0132-000,2013,11,22,22,590,569,1159,1400
0132-000,2013,11,22,23,401,363,764,1159
0132-000,2013,11,22,24,253,284,537,764
0132-000,2013,11,23,1,194,215,409,537
0132-000,2013,11,23,2,138,148,286,409
0132-000,2013,11,23,3,106,124,230,286
0132-000,2013,11,23,4,119,122,241,230
0132-000,2013,11,23,5,97,100,197,241
0132-000,2013,11,23,6,172,154,326,197
0132-000,2013,11,23,7,306,312,618,326
0132-000,2013,11,23,8,533,707,1240,618
0132-000,2013,11,23,9,631,953,1584,1240
0132-000,2013,11,23,10,745,992,1737,1584
0132-000,2013,11,23,11,823,1143,1966,1737
0132-000,2013,11,23,12,907,1381,2288,1966
0132-000,2013,11,23,13,815,1365,2180,2288
0132-000,2013,11,23,14,924,1327,2251,2180
0132-000,2013,11,23,15,888,1192,2080,2251
0132-000,2013,11,23,16,985,1023,2008,2080
0132-000,2013,11,23,17,1183,1140,2323,2008
0132-000,2013,11,23,18,1463,1061,2524,2323
0132-000,2013,11,23,19,1294,869,2163,2524
0132-000,2013,11,23,20,1032,663,1695,2163
0132-000,2013,11,23,21,657,515,1172,1695
0132-000,2013,11,23,22,573,434,1007,1172
0132-000,2013,11,23,23,355,312,667,1007
0132-000,2013,11,23,24,207,202,409,667
0132-000,2013,11,24,1,167,159,326,409
0132-000,2013,11,24,2,130,118,248,326
0132-000,2013,11,24,3,113,117,230,248
0132-000,2013,11,24,4,82,90,172,230
0132-000,2013,11,24,5,105,92,197,172
0132-000,2013,11,24,6,87,100,187,197
0132-000,2013,11,24,7,166,201,367,187
0132-000,2013,11,24,8,267,334,601,367
0132-000,2013,11,24,9,355,441,796,601
0132-000,2013,11,24,10,496,561,1057,796
0132-000,2013,11,24,11,568,631,1199,1057
0132-000,2013,11,24,12,688,665,1353,1199
0132-000,2013,11,24,13,829,709,1538,1353
0132-000,2013,11,24,14,1005,715,1720,1538
0132-000,2013,11,24,15,1312,672,1984,1720
0132-000,2013,11,24,16,1469,775,2244,1984
0132-000,2013,11,24,17,1578,778,2356,2244
0132-000,2013,11,24,18,1708,745,2453,2356
0132-000,2013,11,24,19,1583,683,2266,2453
0132-000,2013,11,24,20,1563,481,2044,2266
0132-000,2013,11,24,21,1730,432,2162,2044
0132-000,2013,11,24,22,1599,399,1998,2162
0132-000,2013,11,24,23,1118,281,1399,1998
0132-000,2013,11,24,24,606,202,808,1399
0132-000,2013,11,25,1,182,128,310,808
0132-000,2013,11,25,2,92,78,170,310
0132-000,2013,11,25,3,56,77,133,170
0132-000,2013,11,25,4,58,71,129,133
0132-000,2013,11,25,5,93,77,170,129
0132-000,2013,11,25,6,145,158,303,170
0132-000,2013,11,25,7,358,417,775,303
0132-000,2013,11,25,8,636,1495,2131,775
0132-000,2013,11,25,9,767,1399,2166,2131
0132-000,2013,11,25,10,694,814,1508,2166
0132-000,2013,11,25,11,748,780,1528,1508
0132-000,2013,11,25,12,704,813,1517,1528
0132-000,2013,11,25,13,653,750,1403,1517
0132-000,2013,11,25,14,784,842,1626,1403
0132-000,2013,11,25,15,875,773,1648,1626
0132-000,2013,11,25,16,904,846,1750,1648
0132-000,2013,11,25,17,865,731,1596,1750
0132-000,2013,11,25,18,1036,782,1818,1596
0132-000,2013,11,25,19,1169,740,1909,1818
0132-000,2013,11,25,20,804,617,1421,1909
0132-000,2013,11,25,21,692,468,1160,1421
0132-000,2013,11,25,22,572,413,985,1160
0132-000,2013,11,25,23,349,290,639,985
0132-000,2013,11,25,24,217,186,403,639
0132-000,2013,11,26,1,142,138,280,403
0132-000,2013,11,26,2,96,107,203,280
0132-000,2013,11,26,3,93,87,180,203
0132-000,2013,11,26,4,69,91,160,180
0132-000,2013,11,26,5,87,92,179,160
0132-000,2013,11,26,6,144,145,289,179
0132-000,2013,11,26,7,309,357,666,289
0132-000,2013,11,26,8,645,1417,2062,666
0132-000,2013,11,26,9,770,1390,2160,2062
0132-000,2013,11,26,10,722,853,1575,2160
0132-000,2013,11,26,11,797,885,1682,1575
0132-000,2013,11,26,12,822,953,1775,1682
0132-000,2013,11,26,13,707,831,1538,1775
0132-000,2013,11,26,14,799,864,1663,1538
0132-000,2013,11,26,15,886,862,1748,1663
0132-000,2013,11,26,16,903,754,1657,1748
0132-000,2013,11,26,17,897,785,1682,1657
0132-000,2013,11,26,18,1128,823,1951,1682
0132-000,2013,11,26,19,1172,793,1965,1951
0132-000,2013,11,26,20,791,572,1363,1965
0132-000,2013,11,26,21,691,476,1167,1363
0132-000,2013,11,26,22,570,446,1016,1167
0132-000,2013,11,26,23,360,266,626,1016
0132-000,2013,11,26,24,190,188,378,626
0132-000,2013,11,27,1,143,143,286,378
0132-000,2013,11,27,2,98,104,202,286
0132-000,2013,11,27,3,100,81,181,202
0132-000,2013,11,27,4,61,89,150,181
0132-000,2013,11,27,5,85,85,170,150
0132-000,2013,11,27,6,125,123,248,170
0132-000,2013,11,27,7,278,291,569,248
0132-000,2013,11,27,8,601,1324,1925,569
0132-000,2013,11,27,9,756,1363,2119,1925
0132-000,2013,11,27,10,696,780,1476,2119
0132-000,2013,11,27,11,674,753,1427,1476
0132-000,2013,11,27,12,768,748,1516,1427
0132-000,2013,11,27,13,648,749,1397,1516
0132-000,2013,11,27,14,718,690,1408,1397
0132-000,2013,11,27,15,808,811,1619,1408
0132-000,2013,11,27,16,866,727,1593,1619
0132-000,2013,11,27,17,827,755,1582,1593
0132-000,2013,11,27,18,1034,736,1770,1582
0132-000,2013,11,27,19,1115,748,1863,1770
0132-000,2013,11,27,20,724,518,1242,1863
0132-000,2013,11,27,21,628,424,1052,1242
0132-000,2013,11,27,22,549,369,918,1052
0132-000,2013,11,27,23,333,223,556,918
0132-000,2013,11,27,24,178,153,331,556
0132-000,2013,11,28,1,149,127,276,331
0132-000,2013,11,28,2,117,93,210,276
0132-000,2013,11,28,3,133,68,201,210
0132-000,2013,11,28,4,95,81,176,201
0132-000,2013,11,28,5,89,89,178,176
0132-000,2013,11,28,6,130,73,203,178
0132-000,2013,11,28,7,212,264,476,203
0132-000,2013,11,28,8,497,1061,1558,476
0132-000,2013,11,28,9,602,1217,1819,1558
0132-000,2013,11,28,10,570,764,1334,1819
0132-000,2013,11,28,11,633,749,1382,1334
0132-000,2013,11,28,12,686,725,1411,1382
0132-000,2013,11,28,13,663,666,1329,1411
0132-000,2013,11,28,14,742,710,1452,1329
0132-000,2013,11,28,15,884,734,1618,1452
0132-000,2013,11,28,16,872,813,1685,1618
0132-000,2013,11,28,17,896,784,1680,1685
0132-000,2013,11,28,18,1074,761,1835,1680
0132-000,2013,11,28,19,1043,703,1746,1835
0132-000,2013,11,28,20,803,519,1322,1746
0132-000,2013,11,28,21,656,419,1075,1322
0132-000,2013,11,28,22,515,387,902,1075
0132-000,2013,11,28,23,292,274,566,902
0132-000,2013,11,28,24,176,191,367,566
0132-000,2013,11,29,1,147,139,286,367
0132-000,2013,11,29,2,96,111,207,286
0132-000,2013,11,29,3,82,95,177,207
0132-000,2013,11,29,4,67,80,147,177
0132-000,2013,11,29,5,93,99,192,147
0132-000,2013,11,29,6,144,119,263,192
0132-000,2013,11,29,7,279,317,596,263
0132-000,2013,11,29,8,543,1239,1782,596
0132-000,2013,11,29,9,720,1222,1942,1782
0132-000,2013,11,29,10,695,786,1481,1942
0132-000,2013,11,29,11,815,830,1645,1481
0132-000,2013,11,29,12,837,771,1608,1645
0132-000,2013,11,29,13,755,806,1561,1608
0132-000,2013,11,29,14,822,753,1575,1561
0132-000,2013,11,29,15,940,903,1843,1575
0132-000,2013,11,29,16,963,782,1745,1843
0132-000,2013,11,29,17,956,851,1807,1745
0132-000,2013,11,29,18,1194,869,2063,1807
0132-000,2013,11,29,19,1324,890,2214,2063
0132-000,2013,11,29,20,916,702,1618,2214
0132-000,2013,11,29,21,740,565,1305,1618
0132-000,2013,11,29,22,580,463,1043,1305
0132-000,2013,11,29,23,371,369,740,1043
0132-000,2013,11,29,24,255,241,496,740
0132-000,2013,11,30,1,211,222,433,496
0132-000,2013,11,30,2,147,154,301,433
0132-000,2013,11,30,3,115,124,239,301
0132-000,2013,11,30,4,107,116,223,239
0132-000,2013,11,30,5,99,100,199,223
0132-000,2013,11,30,6,148,140,288,199
0132-000,2013,11,30,7,286,303,589,288
0132-000,2013,11,30,8,501,688,1189,589
0132-000,2013,11,30,9,662,911,1573,1189
0132-000,2013,11,30,10,727,935,1662,1573
0132-000,2013,11,30,11,799,1029,1828,1662
0132-000,2013,11,30,12,888,1181,2069,1828
0132-000,2013,11,30,13,813,1127,1940,2069
0132-000,2013,11,30,14,921,1104,2025,1940
0132-000,2013,11,30,15,893,1025,1918,2025
0132-000,2013,11,30,16,991,945,1936,1918
0132-000,2013,11,30,17,1090,1048,2138,1936
0132-000,2013,11,30,18,1376,1002,2378,2138
0132-000,2013,11,30,19,1228,842,2070,2378
0132-000,2013,11,30,20,846,596,1442,2070
0132-000,2013,11,30,21,580,478,1058,1442
0132-000,2013,11,30,22,527,422,949,1058
0132-000,2013,11,30,23,340,310,650,949
0132-000,2013,11,30,24,225,235,460,650
0132-000,2013,12,1,1,204,205,409,460
0132-000,2013,12,1,2,154,157,311,409
0132-000,2013,12,1,3,104,101,205,311
0132-000,2013,12,1,4,76,89,165,205
0132-000,2013,12,1,5,84,83,167,165
0132-000,2013,12,1,6,116,85,201,167
0132-000,2013,12,1,7,179,176,355,201
0132-000,2013,12,1,8,265,312,577,355
0132-000,2013,12,1,9,347,521,868,577
0132-000,2013,12,1,10,451,547,998,868
0132-000,2013,12,1,11,537,635,1172,998
0132-000,2013,12,1,12,682,728,1410,1172
0132-000,2013,12,1,13,771,788,1559,1410
0132-000,2013,12,1,14,921,721,1642,1559
0132-000,2013,12,1,15,1048,651,1699,1642
0132-000,2013,12,1,16,1165,750,1915,1699
0132-000,2013,12,1,17,1332,768,2100,1915
0132-000,2013,12,1,18,1478,671,2149,2100
0132-000,2013,12,1,19,1386,584,1970,2149
0132-000,2013,12,1,20,1241,460,1701,1970
0132-000,2013,12,1,21,816,460,1276,1701
0132-000,2013,12,1,22,647,365,1012,1276
0132-000,2013,12,1,23,314,284,598,1012
0132-000,2013,12,1,24,150,190,340,598
0132-000,2013,12,2,1,124,126,250,340
0132-000,2013,12,2,2,64,85,149,250
0132-000,2013,12,2,3,57,59,116,149
0132-000,2013,12,2,4,49,64,113,116
0132-000,2013,12,2,5,63,75,138,113
0132-000,2013,12,2,6,145,127,272,138
0132-000,2013,12,2,7,397,457,854,272
0132-000,2013,12,2,8,666,1536,2202,854
0132-000,2013,12,2,9,745,1398,2143,2202
0132-000,2013,12,2,10,673,793,1466,2143
0132-000,2013,12,2,11,795,876,1671,1466
0132-000,2013,12,2,12,748,807,1555,1671
0132-000,2013,12,2,13,744,731,1475,1555
0132-000,2013,12,2,14,743,737,1480,1475
0132-000,2013,12,2,15,870,853,1723,1480
0132-000,2013,12,2,16,932,792,1724,1723
0132-000,2013,12,2,17,893,781,1674,1724
0132-000,2013,12,2,18,1045,864,1909,1674
0132-000,2013,12,2,19,1153,695,1848,1909
0132-000,2013,12,2,20,784,579,1363,1848
0132-000,2013,12,2,21,702,485,1187,1363
0132-000,2013,12,2,22,523,442,965,1187
0132-000,2013,12,2,23,340,284,624,965
0132-000,2013,12,2,24,202,206,408,624
0132-000,2013,12,3,1,139,136,275,408
0132-000,2013,12,3,2,88,92,180,275
0132-000,2013,12,3,3,76,91,167,180
0132-000,2013,12,3,4,82,74,156,167
0132-000,2013,12,3,5,92,83,175,156
0132-000,2013,12,3,6,124,136,260,175
0132-000,2013,12,3,7,350,355,705,260
0132-000,2013,12,3,8,633,1449,2082,705
0132-000,2013,12,3,9,810,1377,2187,2082
0132-000,2013,12,3,10,734,886,1620,2187
0132-000,2013,12,3,11,820,880,1700,1620
0132-000,2013,12,3,12,826,766,1592,1700
0132-000,2013,12,3,13,722,800,1522,1592
0132-000,2013,12,3,14,850,807,1657,1522
0132-000,2013,12,3,15,858,790,1648,1657
0132-000,2013,12,3,16,934,762,1696,1648
0132-000,2013,12,3,17,940,785,1725,1696
0132-000,2013,12,3,18,1082,861,1943,1725
0132-000,2013,12,3,19,1253,783,2036,1943
0132-000,2013,12,3,20,822,577,1399,2036
0132-000,2013,12,3,21,698,470,1168,1399
0132-000,2013,12,3,22,557,448,1005,1168
0132-000,2013,12,3,23,336,308,644,1005
0132-000,2013,12,3,24,239,213,452,644
0132-000,2013,12,4,1,169,170,339,452
0132-000,2013,12,4,2,112,121,233,339
0132-000,2013,12,4,3,75,88,163,233
0132-000,2013,12,4,4,70,81,151,163
0132-000,2013,12,4,5,91,100,191,151
0132-000,2013,12,4,6,138,136,274,191
0132-000,2013,12,4,7,311,368,679,274
0132-000,2013,12,4,8,658,1378,2036,679
0132-000,2013,12,4,9,763,1340,2103,2036
0132-000,2013,12,4,10,725,785,1510,2103
0132-000,2013,12,4,11,739,819,1558,1510
0132-000,2013,12,4,12,804,848,1652,1558
0132-000,2013,12,4,13,695,810,1505,1652
0132-000,2013,12,4,14,813,738,1551,1505
0132-000,2013,12,4,15,890,795,1685,1551
0132-000,2013,12,4,16,918,793,1711,1685
0132-000,2013,12,4,17,915,803,1718,1711
0132-000,2013,12,4,18,1181,872,2053,1718
0132-000,2013,12,4,19,1245,786,2031,2053
0132-000,2013,12,4,20,747,579,1326,2031
0132-000,2013,12,4,21,664,441,1105,1326
0132-000,2013,12,4,22,516,441,957,1105
0132-000,2013,12,4,23,311,299,610,957
0132-000,2013,12,4,24,235,204,439,610
0132-000,2013,12,5,1,143,165,308,439
0132-000,2013,12,5,2,122,101,223,308
0132-000,2013,12,5,3,87,102,189,223
0132-000,2013,12,5,4,71,87,158,189
0132-000,2013,12,5,5,90,97,187,158
0132-000,2013,12,5,6,125,119,244,187
0132-000,2013,12,5,7,353,341,694,244
0132-000,2013,12,5,8,680,1387,2067,694
0132-000,2013,12,5,9,787,1380,2167,2067
0132-000,2013,12,5,10,722,849,1571,2167
0132-000,2013,12,5,11,823,856,1679,1571
0132-000,2013,12,5,12,791,835,1626,1679
0132-000,2013,12,5,13,729,790,1519,1626
0132-000,2013,12,5,14,795,798,1593,1519
0132-000,2013,12,5,15,910,774,1684,1593
0132-000,2013,12,5,16,988,824,1812,1684
0132-000,2013,12,5,17,1118,829,1947,1812
0132-000,2013,12,5,18,1436,900,2336,1947
0132-000,2013,12,5,19,1489,960,2449,2336
0132-000,2013,12,5,20,1151,886,2037,2449
0132-000,2013,12,5,21,798,708,1506,2037
0132-000,2013,12,5,22,582,486,1068,1506
0132-000,2013,12,5,23,357,337,694,1068
0132-000,2013,12,5,24,262,205,467,694
0132-000,2013,12,6,1,158,161,319,467
0132-000,2013,12,6,2,129,138,267,319
0132-000,2013,12,6,3,91,85,176,267
0132-000,2013,12,6,4,79,70,149,176
0132-000,2013,12,6,5,82,84,166,149
0132-000,2013,12,6,6,128,126,254,166
0132-000,2013,12,6,7,291,356,647,254
0132-000,2013,12,6,8,645,1401,2046,647
0132-000,2013,12,6,9,793,1321,2114,2046
0132-000,2013,12,6,10,763,828,1591,2114
0132-000,2013,12,6,11,757,815,1572,1591
0132-000,2013,12,6,12,821,815,1636,1572
0132-000,2013,12,6,13,716,713,1429,1636
0132-000,2013,12,6,14,725,812,1537,1429
0132-000,2013,12,6,15,876,860,1736,1537
0132-000,2013,12,6,16,955,850,1805,1736
0132-000,2013,12,6,17,1011,824,1835,1805
0132-000,2013,12,6,18,1209,855,2064,1835
0132-000,2013,12,6,19,1469,914,2383,2064
0132-000,2013,12,6,20,934,665,1599,2383
0132-000,2013,12,6,21,737,527,1264,1599
0132-000,2013,12,6,22,566,520,1086,1264
0132-000,2013,12,6,23,380,363,743,1086
0132-000,2013,12,6,24,254,241,495,743
0132-000,2013,12,7,1,228,229,457,495
0132-000,2013,12,7,2,156,160,316,457
0132-000,2013,12,7,3,123,123,246,316
0132-000,2013,12,7,4,94,110,204,246
0132-000,2013,12,7,5,100,99,199,204
0132-000,2013,12,7,6,124,125,249,199
0132-000,2013,12,7,7,266,293,559,249
0132-000,2013,12,7,8,469,668,1137,559
0132-000,2013,12,7,9,693,869,1562,1137
0132-000,2013,12,7,10,708,877,1585,1562
0132-000,2013,12,7,11,775,914,1689,1585
0132-000,2013,12,7,12,868,980,1848,1689
0132-000,2013,12,7,13,811,889,1700,1848
0132-000,2013,12,7,14,918,881,1799,1700
0132-000,2013,12,7,15,897,858,1755,1799
0132-000,2013,12,7,16,997,867,1864,1755
0132-000,2013,12,7,17,996,955,1951,1864
0132-000,2013,12,7,18,1288,943,2231,1951
0132-000,2013,12,7,19,1161,814,1975,2231
0132-000,2013,12,7,20,660,529,1189,1975
0132-000,2013,12,7,21,503,440,943,1189
0132-000,2013,12,7,22,481,409,890,943
0132-000,2013,12,7,23,324,308,632,890
0132-000,2013,12,7,24,242,268,510,632
0132-000,2013,12,8,1,194,233,427,510
0132-000,2013,12,8,2,128,161,289,427
0132-000,2013,12,8,3,118,114,232,289
0132-000,2013,12,8,4,85,97,182,232
0132-000,2013,12,8,5,76,73,149,182
0132-000,2013,12,8,6,121,101,222,149
0132-000,2013,12,8,7,155,188,343,222
0132-000,2013,12,8,8,258,275,533,343
0132-000,2013,12,8,9,315,416,731,533
0132-000,2013,12,8,10,417,460,877,731
0132-000,2013,12,8,11,500,553,1053,877
0132-000,2013,12,8,12,646,671,1317,1053
0132-000,2013,12,8,13,725,670,1395,1317
0132-000,2013,12,8,14,761,702,1463,1395
0132-000,2013,12,8,15,833,679,1512,1463
0132-000,2013,12,8,16,990,715,1705,1512
0132-000,2013,12,8,17,1147,762,1909,1705
0132-000,2013,12,8,18,1101,726,1827,1909
0132-000,2013,12,8,19,1081,565,1646,1827
0132-000,2013,12,8,20,779,464,1243,1646
0132-000,2013,12,8,21,609,422,1031,1243
0132-000,2013,12,8,22,451,364,815,1031
0132-000,2013,12,8,23,260,261,521,815
0132-000,2013,12,8,24,148,162,310,521
0132-000,2013,12,9,1,117,132,249,310
0132-000,2013,12,9,2,76,67,143,249
0132-000,2013,12,9,3,49,67,116,143
0132-000,2013,12,9,4,49,66,115,116
0132-000,2013,12,9,5,75,60,135,115
0132-000,2013,12,9,6,123,153,276,135
0132-000,2013,12,9,7,341,416,757,276
0132-000,2013,12,9,8,621,1471,2092,757
0132-000,2013,12,9,9,743,1455,2198,2092
0132-000,2013,12,9,10,630,729,1359,2198
0132-000,2013,12,9,11,701,761,1462,1359
0132-000,2013,12,9,12,722,735,1457,1462
0132-000,2013,12,9,13,692,656,1348,1457
0132-000,2013,12,9,14,700,816,1516,1348
0132-000,2013,12,9,15,783,751,1534,1516
0132-000,2013,12,9,16,832,779,1611,1534
0132-000,2013,12,9,17,781,754,1535,1611
0132-000,2013,12,9,18,951,752,1703,1535
0132-000,2013,12,9,19,1080,697,1777,1703
0132-000,2013,12,9,20,750,548,1298,1777
0132-000,2013,12,9,21,665,463,1128,1298
0132-000,2013,12,9,22,520,378,898,1128
0132-000,2013,12,9,23,348,250,598,898
0132-000,2013,12,9,24,211,199,410,598
0132-000,2013,12,10,1,126,150,276,410
0132-000,2013,12,10,2,95,85,180,276
0132-000,2013,12,10,3,75,84,159,180
0132-000,2013,12,10,4,80,91,171,159
0132-000,2013,12,10,5,75,77,152,171
0132-000,2013,12,10,6,112,104,216,152
0132-000,2013,12,10,7,308,340,648,216
0132-000,2013,12,10,8,616,1400,2016,648
0132-000,2013,12,10,9,786,1326,2112,2016
0132-000,2013,12,10,10,709,779,1488,2112
0132-000,2013,12,10,11,781,927,1708,1488
0132-000,2013,12,10,12,877,803,1680,1708
0132-000,2013,12,10,13,719,788,1507,1680
0132-000,2013,12,10,14,830,828,1658,1507
0132-000,2013,12,10,15,916,857,1773,1658
0132-000,2013,12,10,16,933,814,1747,1773
0132-000,2013,12,10,17,887,810,1697,1747
0132-000,2013,12,10,18,1090,846,1936,1697
0132-000,2013,12,10,19,1124,795,1919,1936
0132-000,2013,12,10,20,798,614,1412,1919
0132-000,2013,12,10,21,729,524,1253,1412
0132-000,2013,12,10,22,598,479,1077,1253
0132-000,2013,12,10,23,313,277,590,1077
0132-000,2013,12,10,24,241,223,464,590
0132-000,2013,12,11,1,151,176,327,464
0132-000,2013,12,11,2,140,112,252,327
0132-000,2013,12,11,3,95,110,205,252
0132-000,2013,12,11,4,68,96,164,205
0132-000,2013,12,11,5,65,81,146,164
0132-000,2013,12,11,6,106,118,224,146
0132-000,2013,12,11,7,226,288,514,224
0132-000,2013,12,11,8,542,1276,1818,514
0132-000,2013,12,11,9,673,1158,1831,1818
0132-000,2013,12,11,10,635,728,1363,1831
0132-000,2013,12,11,11,676,752,1428,1363
0132-000,2013,12,11,12,707,760,1467,1428
0132-000,2013,12,11,13,693,752,1445,1467
0132-000,2013,12,11,14,731,774,1505,1445
0132-000,2013,12,11,15,812,763,1575,1505
0132-000,2013,12,11,16,846,715,1561,1575
0132-000,2013,12,11,17,821,734,1555,1561
0132-000,2013,12,11,18,903,721,1624,1555
0132-000,2013,12,11,19,936,710,1646,1624
0132-000,2013,12,11,20,721,407,1128,1646
0132-000,2013,12,11,21,557,329,886,1128
0132-000,2013,12,11,22,390,293,683,886
0132-000,2013,12,11,23,248,206,454,683
0132-000,2013,12,11,24,185,155,340,454
0132-000,2013,12,12,1,106,122,228,340
0132-000,2013,12,12,2,97,96,193,228
0132-000,2013,12,12,3,78,70,148,193
0132-000,2013,12,12,4,70,78,148,148
0132-000,2013,12,12,5,73,63,136,148
0132-000,2013,12,12,6,119,107,226,136
0132-000,2013,12,12,7,194,283,477,226
0132-000,2013,12,12,8,489,1185,1674,477
0132-000,2013,12,12,9,609,1121,1730,1674
0132-000,2013,12,12,10,654,746,1400,1730
0132-000,2013,12,12,11,712,739,1451,1400
0132-000,2013,12,12,12,766,782,1548,1451
0132-000,2013,12,12,13,671,650,1321,1548
0132-000,2013,12,12,14,771,762,1533,1321
0132-000,2013,12,12,15,816,661,1477,1533
0132-000,2013,12,12,16,815,558,1373,1477
0132-000,2013,12,12,17,1016,603,1619,1373
0132-000,2013,12,12,18,968,580,1548,1619
0132-000,2013,12,12,19,1027,613,1640,1548
0132-000,2013,12,12,20,600,407,1007,1640
0132-000,2013,12,12,21,543,329,872,1007
0132-000,2013,12,12,22,421,289,710,872
0132-000,2013,12,12,23,239,234,473,710
0132-000,2013,12,12,24,166,152,318,473
0132-000,2013,12,13,1,155,148,303,318
0132-000,2013,12,13,2,104,89,193,303
0132-000,2013,12,13,3,68,80,148,193
0132-000,2013,12,13,4,74,72,146,148
0132-000,2013,12,13,5,61,61,122,146
0132-000,2013,12,13,6,108,90,198,122
0132-000,2013,12,13,7,228,282,510,198
0132-000,2013,12,13,8,538,1139,1677,510
0132-000,2013,12,13,9,672,1142,1814,1677
0132-000,2013,12,13,10,640,752,1392,1814
0132-000,2013,12,13,11,641,749,1390,1392
0132-000,2013,12,13,12,746,761,1507,1390
0132-000,2013,12,13,13,671,691,1362,1507
0132-000,2013,12,13,14,805,785,1590,1362
0132-000,2013,12,13,15,897,794,1691,1590
0132-000,2013,12,13,16,890,797,1687,1691
0132-000,2013,12,13,17,977,805,1782,1687
0132-000,2013,12,13,18,1207,824,2031,1782
0132-000,2013,12,13,19,1324,791,2115,2031
0132-000,2013,12,13,20,849,610,1459,2115
0132-000,2013,12,13,21,734,510,1244,1459
0132-000,2013,12,13,22,498,430,928,1244
0132-000,2013,12,13,23,326,272,598,928
0132-000,2013,12,13,24,252,246,498,598
0132-000,2013,12,14,1,187,221,408,498
0132-000,2013,12,14,2,135,140,275,408
0132-000,2013,12,14,3,108,132,240,275
0132-000,2013,12,14,4,81,95,176,240
0132-000,2013,12,14,5,74,87,161,176
0132-000,2013,12,14,6,122,106,228,161
0132-000,2013,12,14,7,195,173,368,228
0132-000,2013,12,14,8,375,535,910,368
0132-000,2013,12,14,9,506,666,1172,910
0132-000,2013,12,14,10,571,800,1371,1172
0132-000,2013,12,14,11,767,932,1699,1371
0132-000,2013,12,14,12,914,987,1901,1699
0132-000,2013,12,14,13,857,903,1760,1901
0132-000,2013,12,14,14,817,898,1715,1760
0132-000,2013,12,14,15,844,814,1658,1715
0132-000,2013,12,14,16,954,817,1771,1658
0132-000,2013,12,14,17,1026,835,1861,1771
0132-000,2013,12,14,18,1226,872,2098,1861
0132-000,2013,12,14,19,1024,742,1766,2098
0132-000,2013,12,14,20,586,502,1088,1766
0132-000,2013,12,14,21,480,435,915,1088
0132-000,2013,12,14,22,390,417,807,915
0132-000,2013,12,14,23,309,307,616,807
0132-000,2013,12,14,24,233,253,486,616
0132-000,2013,12,15,1,207,222,429,486
0132-000,2013,12,15,2,178,165,343,429
0132-000,2013,12,15,3,119,135,254,343
0132-000,2013,12,15,4,96,98,194,254
0132-000,2013,12,15,5,63,69,132,194
0132-000,2013,12,15,6,91,89,180,132
0132-000,2013,12,15,7,172,133,305,180
0132-000,2013,12,15,8,189,246,435,305
0132-000,2013,12,15,9,282,339,621,435
0132-000,2013,12,15,10,396,460,856,621
0132-000,2013,12,15,11,436,555,991,856
0132-000,2013,12,15,12,576,541,1117,991
0132-000,2013,12,15,13,577,613,1190,1117
0132-000,2013,12,15,14,724,715,1439,1190
0132-000,2013,12,15,15,788,659,1447,1439
0132-000,2013,12,15,16,873,697,1570,1447
0132-000,2013,12,15,17,952,718,1670,1570
0132-000,2013,12,15,18,948,683,1631,1670
0132-000,2013,12,15,19,876,537,1413,1631
0132-000,2013,12,15,20,561,496,1057,1413
0132-000,2013,12,15,21,484,373,857,1057
0132-000,2013,12,15,22,373,376,749,857
0132-000,2013,12,15,23,274,247,521,749
0132-000,2013,12,15,24,173,172,345,521
0132-000,2013,12,16,1,105,149,254,345
0132-000,2013,12,16,2,66,67,133,254
0132-000,2013,12,16,3,58,52,110,133
0132-000,2013,12,16,4,53,76,129,110
0132-000,2013,12,16,5,75,61,136,129
0132-000,2013,12,16,6,155,138,293,136
0132-000,2013,12,16,7,309,430,739,293
0132-000,2013,12,16,8,649,1522,2171,739
0132-000,2013,12,16,9,744,1326,2070,2171
0132-000,2013,12,16,10,693,777,1470,2070
0132-000,2013,12,16,11,723,844,1567,1470
0132-000,2013,12,16,12,791,815,1606,1567
0132-000,2013,12,16,13,697,726,1423,1606
0132-000,2013,12,16,14,807,832,1639,1423
0132-000,2013,12,16,15,866,829,1695,1639
0132-000,2013,12,16,16,918,847,1765,1695
0132-000,2013,12,16,17,948,774,1722,1765
0132-000,2013,12,16,18,1079,782,1861,1722
0132-000,2013,12,16,19,1205,715,1920,1861
0132-000,2013,12,16,20,682,557,1239,1920
0132-000,2013,12,16,21,667,461,1128,1239
0132-000,2013,12,16,22,510,401,911,1128
0132-000,2013,12,16,23,298,282,580,911
0132-000,2013,12,16,24,215,187,402,580
0132-000,2013,12,17,1,149,151,300,402
0132-000,2013,12,17,2,112,93,205,300
0132-000,2013,12,17,3,78,73,151,205
0132-000,2013,12,17,4,75,92,167,151
0132-000,2013,12,17,5,82,98,180,167
0132-000,2013,12,17,6,142,112,254,180
0132-000,2013,12,17,7,317,348,665,254
0132-000,2013,12,17,8,590,1395,1985,665
0132-000,2013,12,17,9,772,1265,2037,1985
0132-000,2013,12,17,10,702,805,1507,2037
0132-000,2013,12,17,11,732,778,1510,1507
0132-000,2013,12,17,12,802,784,1586,1510
0132-000,2013,12,17,13,740,753,1493,1586
0132-000,2013,12,17,14,779,824,1603,1493
0132-000,2013,12,17,15,913,820,1733,1603
0132-000,2013,12,17,16,934,783,1717,1733
0132-000,2013,12,17,17,883,781,1664,1717
0132-000,2013,12,17,18,1091,792,1883,1664
0132-000,2013,12,17,19,1144,786,1930,1883
0132-000,2013,12,17,20,737,565,1302,1930
0132-000,2013,12,17,21,669,473,1142,1302
0132-000,2013,12,17,22,530,430,960,1142
0132-000,2013,12,17,23,338,279,617,960
0132-000,2013,12,17,24,233,227,460,617
0132-000,2013,12,18,1,173,159,332,460
0132-000,2013,12,18,2,99,107,206,332
0132-000,2013,12,18,3,91,114,205,206
0132-000,2013,12,18,4,89,94,183,205
0132-000,2013,12,18,5,84,95,179,183
0132-000,2013,12,18,6,151,137,288,179
0132-000,2013,12,18,7,282,395,677,288
0132-000,2013,12,18,8,643,1340,1983,677
0132-000,2013,12,18,9,821,1252,2073,1983
0132-000,2013,12,18,10,734,848,1582,2073
0132-000,2013,12,18,11,785,807,1592,1582
0132-000,2013,12,18,12,770,825,1595,1592
0132-000,2013,12,18,13,750,761,1511,1595
0132-000,2013,12,18,14,844,785,1629,1511
0132-000,2013,12,18,15,872,908,1780,1629
0132-000,2013,12,18,16,893,869,1762,1780
0132-000,2013,12,18,17,867,765,1632,1762
0132-000,2013,12,18,18,1156,774,1930,1632
0132-000,2013,12,18,19,1196,745,1941,1930
0132-000,2013,12,18,20,767,587,1354,1941
0132-000,2013,12,18,21,713,507,1220,1354
0132-000,2013,12,18,22,543,440,983,1220
0132-000,2013,12,18,23,354,300,654,983
0132-000,2013,12,18,24,227,208,435,654
0132-000,2013,12,19,1,161,137,298,435
0132-000,2013,12,19,2,107,108,215,298
0132-000,2013,12,19,3,85,70,155,215
0132-000,2013,12,19,4,85,80,165,155
0132-000,2013,12,19,5,84,76,160,165
0132-000,2013,12,19,6,122,120,242,160
0132-000,2013,12,19,7,279,350,629,242
0132-000,2013,12,19,8,507,1288,1795,629
0132-000,2013,12,19,9,671,1172,1843,1795
0132-000,2013,12,19,10,420,762,1182,1843
0132-000,2013,12,19,11,432,783,1215,1182
0132-000,2013,12,19,12,596,818,1414,1215
0132-000,2013,12,19,13,567,728,1295,1414
0132-000,2013,12,19,14,673,766,1439,1295
0132-000,2013,12,19,15,689,708,1397,1439
0132-000,2013,12,19,16,764,657,1421,1397
0132-000,2013,12,19,17,780,681,1461,1421
0132-000,2013,12,19,18,795,658,1453,1461
0132-000,2013,12,19,19,860,658,1518,1453
0132-000,2013,12,19,20,883,472,1355,1518
0132-000,2013,12,19,21,649,371,1020,1355
0132-000,2013,12,19,22,422,341,763,1020
0132-000,2013,12,19,23,254,269,523,763
0132-000,2013,12,19,24,142,194,336,523
0132-000,2013,12,20,1,99,91,190,336
0132-000,2013,12,20,2,82,79,161,190
0132-000,2013,12,20,3,61,59,120,161
0132-000,2013,12,20,4,46,73,119,120
0132-000,2013,12,20,5,78,73,151,119
0132-000,2013,12,20,6,78,75,153,151
0132-000,2013,12,20,7,149,222,371,153
0132-000,2013,12,20,8,341,843,1184,371
0132-000,2013,12,20,9,493,840,1333,1184
0132-000,2013,12,20,10,469,595,1064,1333
0132-000,2013,12,20,11,585,652,1237,1064
0132-000,2013,12,20,12,591,674,1265,1237
0132-000,2013,12,20,13,607,621,1228,1265
0132-000,2013,12,20,14,714,664,1378,1228
0132-000,2013,12,20,15,778,708,1486,1378
0132-000,2013,12,20,16,803,723,1526,1486
0132-000,2013,12,20,17,906,733,1639,1526
0132-000,2013,12,20,18,1067,727,1794,1639
0132-000,2013,12,20,19,1269,685,1954,1794
0132-000,2013,12,20,20,797,521,1318,1954
0132-000,2013,12,20,21,642,401,1043,1318
0132-000,2013,12,20,22,499,373,872,1043
0132-000,2013,12,20,23,347,288,635,872
0132-000,2013,12,20,24,256,239,495,635
0132-000,2013,12,21,1,178,227,405,495
0132-000,2013,12,21,2,157,173,330,405
0132-000,2013,12,21,3,121,116,237,330
0132-000,2013,12,21,4,84,102,186,237
0132-000,2013,12,21,5,89,109,198,186
0132-000,2013,12,21,6,119,119,238,198
0132-000,2013,12,21,7,205,227,432,238
0132-000,2013,12,21,8,369,569,938,432
0132-000,2013,12,21,9,536,732,1268,938
0132-000,2013,12,21,10,622,898,1520,1268
0132-000,2013,12,21,11,711,987,1698,1520
0132-000,2013,12,21,12,793,1111,1904,1698
0132-000,2013,12,21,13,759,1015,1774,1904
0132-000,2013,12,21,14,894,997,1891,1774
0132-000,2013,12,21,15,931,861,1792,1891
0132-000,2013,12,21,16,942,866,1808,1792
0132-000,2013,12,21,17,1043,855,1898,1808
0132-000,2013,12,21,18,1443,868,2311,1898
0132-000,2013,12,21,19,1114,690,1804,2311
0132-000,2013,12,21,20,697,500,1197,1804
0132-000,2013,12,21,21,485,421,906,1197
0132-000,2013,12,21,22,386,417,803,906
0132-000,2013,12,21,23,314,302,616,803
0132-000,2013,12,21,24,237,248,485,616
0132-000,2013,12,22,1,212,243,455,485
0132-000,2013,12,22,2,141,157,298,455
0132-000,2013,12,22,3,110,116,226,298
0132-000,2013,12,22,4,105,98,203,226
0132-000,2013,12,22,5,75,93,168,203
0132-000,2013,12,22,6,112,120,232,168
0132-000,2013,12,22,7,135,148,283,232
0132-000,2013,12,22,8,230,275,505,283
0132-000,2013,12,22,9,310,350,660,505
0132-000,2013,12,22,10,377,513,890,660
0132-000,2013,12,22,11,559,601,1160,890
0132-000,2013,12,22,12,594,611,1205,1160
0132-000,2013,12,22,13,682,614,1296,1205
0132-000,2013,12,22,14,837,687,1524,1296
0132-000,2013,12,22,15,862,646,1508,1524
0132-000,2013,12,22,16,959,706,1665,1508
0132-000,2013,12,22,17,1068,723,1791,1665
0132-000,2013,12,22,18,920,620,1540,1791
0132-000,2013,12,22,19,916,541,1457,1540
0132-000,2013,12,22,20,564,457,1021,1457
0132-000,2013,12,22,21,478,397,875,1021
0132-000,2013,12,22,22,365,372,737,875
0132-000,2013,12,22,23,232,234,466,737
0132-000,2013,12,22,24,154,189,343,466
0132-000,2013,12,23,1,121,132,253,343
0132-000,2013,12,23,2,76,69,145,253
0132-000,2013,12,23,3,52,62,114,145
0132-000,2013,12,23,4,43,58,101,114
0132-000,2013,12,23,5,73,96,169,101
0132-000,2013,12,23,6,137,137,274,169
0132-000,2013,12,23,7,356,463,819,274
0132-000,2013,12,23,8,643,1482,2125,819
0132-000,2013,12,23,9,782,1304,2086,2125
0132-000,2013,12,23,10,701,815,1516,2086
0132-000,2013,12,23,11,801,844,1645,1516
0132-000,2013,12,23,12,789,803,1592,1645
0132-000,2013,12,23,13,776,809,1585,1592
0132-000,2013,12,23,14,823,870,1693,1585
0132-000,2013,12,23,15,815,871,1686,1693
0132-000,2013,12,23,16,935,847,1782,1686
0132-000,2013,12,23,17,862,771,1633,1782
0132-000,2013,12,23,18,1069,844,1913,1633
0132-000,2013,12,23,19,1169,777,1946,1913
0132-000,2013,12,23,20,756,566,1322,1946
0132-000,2013,12,23,21,667,457,1124,1322
0132-000,2013,12,23,22,540,420,960,1124
0132-000,2013,12,23,23,322,288,610,960
0132-000,2013,12,23,24,228,222,450,610
0132-000,2013,12,24,1,158,156,314,450
0132-000,2013,12,24,2,109,104,213,314
0132-000,2013,12,24,3,85,113,198,213
0132-000,2013,12,24,4,71,80,151,198
0132-000,2013,12,24,5,88,114,202,151
0132-000,2013,12,24,6,132,156,288,202
0132-000,2013,12,24,7,286,298,584,288
0132-000,2013,12,24,8,597,1316,1913,584
0132-000,2013,12,24,9,785,1191,1976,1913
0132-000,2013,12,24,10,728,747,1475,1976
0132-000,2013,12,24,11,833,900,1733,1475
0132-000,2013,12,24,12,826,828,1654,1733
0132-000,2013,12,24,13,814,791,1605,1654
0132-000,2013,12,24,14,882,793,1675,1605
0132-000,2013,12,24,15,911,887,1798,1675
0132-000,2013,12,24,16,920,785,1705,1798
0132-000,2013,12,24,17,1032,888,1920,1705
0132-000,2013,12,24,18,1329,926,2255,1920
0132-000,2013,12,24,19,1580,872,2452,2255
0132-000,2013,12,24,20,1071,772,1843,2452
0132-000,2013,12,24,21,728,571,1299,1843
0132-000,2013,12,24,22,533,504,1037,1299
0132-000,2013,12,24,23,363,334,697,1037
0132-000,2013,12,24,24,243,285,528,697
0132-000,2013,12,25,1,188,222,410,528
0132-000,2013,12,25,2,124,149,273,410
0132-000,2013,12,25,3,99,110,209,273
0132-000,2013,12,25,4,125,134,259,209
0132-000,2013,12,25,5,105,119,224,259
0132-000,2013,12,25,6,114,118,232,224
0132-000,2013,12,25,7,195,197,392,232
0132-000,2013,12,25,8,278,426,704,392
0132-000,2013,12,25,9,411,446,857,704
0132-000,2013,12,25,10,440,438,878,857
0132-000,2013,12,25,11,564,532,1096,878
0132-000,2013,12,25,12,574,575,1149,1096
0132-000,2013,12,25,13,558,694,1252,1149
0132-000,2013,12,25,14,762,716,1478,1252
0132-000,2013,12,25,15,706,666,1372,1478
0132-000,2013,12,25,16,748,650,1398,1372
0132-000,2013,12,25,17,770,731,1501,1398
0132-000,2013,12,25,18,772,631,1403,1501
0132-000,2013,12,25,19,722,564,1286,1403
0132-000,2013,12,25,20,496,441,937,1286
0132-000,2013,12,25,21,434,391,825,937
0132-000,2013,12,25,22,424,341,765,825
0132-000,2013,12,25,23,221,267,488,765
0132-000,2013,12,25,24,165,175,340,488
0132-000,2013,12,26,1,110,152,262,340
0132-000,2013,12,26,2,102,119,221,262
0132-000,2013,12,26,3,53,71,124,221
0132-000,2013,12,26,4,71,83,154,124
0132-000,2013,12,26,5,85,89,174,154
0132-000,2013,12,26,6,110,133,243,174
0132-000,2013,12,26,7,341,417,758,243
0132-000,2013,12,26,8,632,1391,2023,758
0132-000,2013,12,26,9,726,1222,1948,2023
0132-000,2013,12,26,10,679,777,1456,1948
0132-000,2013,12,26,11,786,827,1613,1456
0132-000,2013,12,26,12,755,855,1610,1613
0132-000,2013,12,26,13,731,807,1538,1610
0132-000,2013,12,26,14,806,770,1576,1538
0132-000,2013,12,26,15,841,756,1597,1576
0132-000,2013,12,26,16,864,756,1620,1597
0132-000,2013,12,26,17,866,759,1625,1620
0132-000,2013,12,26,18,995,736,1731,1625
0132-000,2013,12,26,19,1168,702,1870,1731
0132-000,2013,12,26,20,689,536,1225,1870
0132-000,2013,12,26,21,613,413,1026,1225
0132-000,2013,12,26,22,517,393,910,1026
0132-000,2013,12,26,23,313,304,617,910
0132-000,2013,12,26,24,234,235,469,617
0132-000,2013,12,27,1,191,168,359,469
0132-000,2013,12,27,2,112,119,231,359
0132-000,2013,12,27,3,122,114,236,231
0132-000,2013,12,27,4,87,109,196,236
0132-000,2013,12,27,5,140,98,238,196
0132-000,2013,12,27,6,148,105,253,238
0132-000,2013,12,27,7,267,326,593,253
0132-000,2013,12,27,8,600,1196,1796,593
0132-000,2013,12,27,9,772,1232,2004,1796
0132-000,2013,12,27,10,642,723,1365,2004
0132-000,2013,12,27,11,738,738,1476,1365
0132-000,2013,12,27,12,743,809,1552,1476
0132-000,2013,12,27,13,704,762,1466,1552
0132-000,2013,12,27,14,840,744,1584,1466
0132-000,2013,12,27,15,894,829,1723,1584
0132-000,2013,12,27,16,922,841,1763,1723
0132-000,2013,12,27,17,907,814,1721,1763
0132-000,2013,12,27,18,1140,842,1982,1721
0132-000,2013,12,27,19,1298,797,2095,1982
0132-000,2013,12,27,20,829,629,1458,2095
0132-000,2013,12,27,21,715,485,1200,1458
0132-000,2013,12,27,22,543,512,1055,1200
0132-000,2013,12,27,23,380,331,711,1055
0132-000,2013,12,27,24,274,278,552,711
0132-000,2013,12,28,1,235,215,450,552
0132-000,2013,12,28,2,150,144,294,450
0132-000,2013,12,28,3,107,133,240,294
0132-000,2013,12,28,4,101,125,226,240
0132-000,2013,12,28,5,97,106,203,226
0132-000,2013,12,28,6,98,125,223,203
0132-000,2013,12,28,7,187,237,424,223
0132-000,2013,12,28,8,391,556,947,424
0132-000,2013,12,28,9,547,659,1206,947
0132-000,2013,12,28,10,611,753,1364,1206
0132-000,2013,12,28,11,746,750,1496,1364
0132-000,2013,12,28,12,757,890,1647,1496
0132-000,2013,12,28,13,803,816,1619,1647
0132-000,2013,12,28,14,854,818,1672,1619
0132-000,2013,12,28,15,833,856,1689,1672
0132-000,2013,12,28,16,845,831,1676,1689
0132-000,2013,12,28,17,956,820,1776,1676
0132-000,2013,12,28,18,1119,831,1950,1776
0132-000,2013,12,28,19,948,698,1646,1950
0132-000,2013,12,28,20,563,544,1107,1646
0132-000,2013,12,28,21,449,398,847,1107
0132-000,2013,12,28,22,407,387,794,847
0132-000,2013,12,28,23,293,299,592,794
0132-000,2013,12,28,24,205,204,409,592
0132-000,2013,12,29,1,182,203,385,409
0132-000,2013,12,29,2,142,141,283,385
0132-000,2013,12,29,3,108,130,238,283
0132-000,2013,12,29,4,86,80,166,238
0132-000,2013,12,29,5,77,88,165,166
0132-000,2013,12,29,6,97,105,202,165
0132-000,2013,12,29,7,128,123,251,202
0132-000,2013,12,29,8,198,220,418,251
0132-000,2013,12,29,9,313,323,636,418
0132-000,2013,12,29,10,367,439,806,636
0132-000,2013,12,29,11,470,604,1074,806
0132-000,2013,12,29,12,492,561,1053,1074
0132-000,2013,12,29,13,591,623,1214,1053
0132-000,2013,12,29,14,718,635,1353,1214
0132-000,2013,12,29,15,758,588,1346,1353
0132-000,2013,12,29,16,865,663,1528,1346
0132-000,2013,12,29,17,994,687,1681,1528
0132-000,2013,12,29,18,951,596,1547,1681
0132-000,2013,12,29,19,869,519,1388,1547
0132-000,2013,12,29,20,615,474,1089,1388
0132-000,2013,12,29,21,447,389,836,1089
0132-000,2013,12,29,22,361,337,698,836
0132-000,2013,12,29,23,257,227,484,698
0132-000,2013,12,29,24,157,173,330,484
0132-000,2013,12,30,1,116,95,211,330
0132-000,2013,12,30,2,82,87,169,211
0132-000,2013,12,30,3,81,67,148,169
0132-000,2013,12,30,4,46,59,105,148
0132-000,2013,12,30,5,63,68,131,105
0132-000,2013,12,30,6,152,125,277,131
0132-000,2013,12,30,7,332,385,717,277
0132-000,2013,12,30,8,650,1383,2033,717
0132-000,2013,12,30,9,766,1263,2029,2033
0132-000,2013,12,30,10,699,744,1443,2029
0132-000,2013,12,30,11,787,856,1643,1443
0132-000,2013,12,30,12,803,793,1596,1643
0132-000,2013,12,30,13,748,822,1570,1596
0132-000,2013,12,30,14,841,830,1671,1570
0132-000,2013,12,30,15,909,923,1832,1671
0132-000,2013,12,30,16,922,827,1749,1832
0132-000,2013,12,30,17,906,820,1726,1749
0132-000,2013,12,30,18,1061,793,1854,1726
0132-000,2013,12,30,19,1172,800,1972,1854
0132-000,2013,12,30,20,732,538,1270,1972
0132-000,2013,12,30,21,657,465,1122,1270
0132-000,2013,12,30,22,555,443,998,1122
0132-000,2013,12,30,23,330,327,657,998
0132-000,2013,12,30,24,262,256,518,657
0132-000,2013,12,31,1,207,189,396,518
0132-000,2013,12,31,2,142,164,306,396
0132-000,2013,12,31,3,94,106,200,306
0132-000,2013,12,31,4,67,110,177,200
0132-000,2013,12,31,5,103,112,215,177
0132-000,2013,12,31,6,110,107,217,215
0132-000,2013,12,31,7,272,285,557,217
0132-000,2013,12,31,8,557,1115,1672,557
0132-000,2013,12,31,9,711,1142,1853,1672
0132-000,2013,12,31,10,625,670,1295,1853
0132-000,2013,12,31,11,729,746,1475,1295
0132-000,2013,12,31,12,787,783,1570,1475
0132-000,2013,12,31,13,800,724,1524,1570
0132-000,2013,12,31,14,831,775,1606,1524
0132-000,2013,12,31,15,949,853,1802,1606
0132-000,2013,12,31,16,902,810,1712,1802
0132-000,2013,12,31,17,1054,814,1868,1712
0132-000,2013,12,31,18,1191,867,2058,1868
0132-000,2013,12,31,19,1159,808,1967,2058
0132-000,2013,12,31,20,783,609,1392,1967
0132-000,2013,12,31,21,536,513,1049,1392
0132-000,2013,12,31,22,443,442,885,1049
0132-000,2013,12,31,23,362,330,692,885
0132-000,2013,12,31,24,226,243,469,692
0132-000,2014,1,1,1,213,217,430,469
0132-000,2014,1,1,2,188,222,410,430
0132-000,2014,1,1,3,154,185,339,410
0132-000,2014,1,1,4,94,135,229,339
0132-000,2014,1,1,5,91,85,176,229
0132-000,2014,1,1,6,81,115,196,176
0132-000,2014,1,1,7,129,171,300,196
0132-000,2014,1,1,8,199,249,448,300
0132-000,2014,1,1,9,248,298,546,448
0132-000,2014,1,1,10,296,351,647,546
0132-000,2014,1,1,11,380,486,866,647
0132-000,2014,1,1,12,471,541,1012,866
0132-000,2014,1,1,13,542,575,1117,1012
0132-000,2014,1,1,14,592,515,1107,1117
0132-000,2014,1,1,15,729,572,1301,1107
0132-000,2014,1,1,16,810,609,1419,1301
0132-000,2014,1,1,17,774,584,1358,1419
0132-000,2014,1,1,18,819,545,1364,1358
0132-000,2014,1,1,19,705,486,1191,1364
0132-000,2014,1,1,20,551,453,1004,1191
0132-000,2014,1,1,21,442,381,823,1004
0132-000,2014,1,1,22,367,322,689,823
0132-000,2014,1,1,23,268,241,509,689
0132-000,2014,1,1,24,144,152,296,509
0132-000,2014,1,2,1,113,126,239,296
0132-000,2014,1,2,2,72,72,144,239
0132-000,2014,1,2,3,46,54,100,144
0132-000,2014,1,2,4,56,44,100,100
0132-000,2014,1,2,5,72,64,136,100
0132-000,2014,1,2,6,122,126,248,136
0132-000,2014,1,2,7,302,384,686,248
0132-000,2014,1,2,8,549,1351,1900,686
0132-000,2014,1,2,9,626,1143,1769,1900
0132-000,2014,1,2,10,560,642,1202,1769
0132-000,2014,1,2,11,668,771,1439,1202
0132-000,2014,1,2,12,675,709,1384,1439
0132-000,2014,1,2,13,651,693,1344,1384
0132-000,2014,1,2,14,769,690,1459,1344
0132-000,2014,1,2,15,825,764,1589,1459
0132-000,2014,1,2,16,799,753,1552,1589
0132-000,2014,1,2,17,828,714,1542,1552
0132-000,2014,1,2,18,1090,802,1892,1542
0132-000,2014,1,2,19,1297,818,2115,1892
0132-000,2014,1,2,20,928,614,1542,2115
0132-000,2014,1,2,21,871,514,1385,1542
0132-000,2014,1,2,22,484,362,846,1385
0132-000,2014,1,2,23,318,286,604,846
0132-000,2014,1,2,24,182,184,366,604
0132-000,2014,1,3,1,151,137,288,366
0132-000,2014,1,3,2,93,101,194,288
0132-000,2014,1,3,3,67,73,140,194
0132-000,2014,1,3,4,63,89,152,140
0132-000,2014,1,3,5,72,98,170,152
0132-000,2014,1,3,6,156,161,317,170
0132-000,2014,1,3,7,295,351,646,317
0132-000,2014,1,3,8,636,1299,1935,646
0132-000,2014,1,3,9,734,1183,1917,1935
0132-000,2014,1,3,10,736,806,1542,1917
0132-000,2014,1,3,11,716,850,1566,1542
0132-000,2014,1,3,12,771,817,1588,1566
0132-000,2014,1,3,13,667,737,1404,1588
0132-000,2014,1,3,14,847,790,1637,1404
0132-000,2014,1,3,15,887,825,1712,1637
0132-000,2014,1,3,16,906,740,1646,1712
0132-000,2014,1,3,17,909,804,1713,1646
0132-000,2014,1,3,18,1069,858,1927,1713
0132-000,2014,1,3,19,1341,757,2098,1927
0132-000,2014,1,3,20,862,650,1512,2098
0132-000,2014,1,3,21,697,452,1149,1512
0132-000,2014,1,3,22,527,431,958,1149
0132-000,2014,1,3,23,383,314,697,958
0132-000,2014,1,3,24,205,208,413,697
0132-000,2014,1,4,1,167,183,350,413
0132-000,2014,1,4,2,130,127,257,350
0132-000,2014,1,4,3,95,122,217,257
0132-000,2014,1,4,4,75,111,186,217
0132-000,2014,1,4,5,97,117,214,186
0132-000,2014,1,4,6,134,134,268,214
0132-000,2014,1,4,7,227,255,482,268
0132-000,2014,1,4,8,402,612,1014,482
0132-000,2014,1,4,9,601,717,1318,1014
0132-000,2014,1,4,10,579,732,1311,1318
0132-000,2014,1,4,11,713,779,1492,1311
0132-000,2014,1,4,12,755,803,1558,1492
0132-000,2014,1,4,13,698,793,1491,1558
0132-000,2014,1,4,14,790,776,1566,1491
0132-000,2014,1,4,15,809,801,1610,1566
0132-000,2014,1,4,16,911,780,1691,1610
0132-000,2014,1,4,17,874,784,1658,1691
0132-000,2014,1,4,18,1142,786,1928,1658
0132-000,2014,1,4,19,966,638,1604,1928
0132-000,2014,1,4,20,554,507,1061,1604
0132-000,2014,1,4,21,466,409,875,1061
0132-000,2014,1,4,22,431,336,767,875
0132-000,2014,1,4,23,278,288,566,767
0132-000,2014,1,4,24,196,211,407,566
0132-000,2014,1,5,1,148,155,303,407
0132-000,2014,1,5,2,107,145,252,303
0132-000,2014,1,5,3,91,119,210,252
0132-000,2014,1,5,4,88,97,185,210
0132-000,2014,1,5,5,80,85,165,185
0132-000,2014,1,5,6,90,81,171,165
0132-000,2014,1,5,7,141,179,320,171
0132-000,2014,1,5,8,199,255,454,320
0132-000,2014,1,5,9,306,337,643,454
0132-000,2014,1,5,10,591,620,1211,643
0132-000,2014,1,5,11,714,749,1463,1211
0132-000,2014,1,5,12,737,543,1280,1463
0132-000,2014,1,5,13,831,664,1495,1280
0132-000,2014,1,5,14,902,801,1703,1495
0132-000,2014,1,5,15,996,818,1814,1703
0132-000,2014,1,5,16,1106,718,1824,1814
0132-000,2014,1,5,17,1108,801,1909,1824
0132-000,2014,1,5,18,1204,721,1925,1909
0132-000,2014,1,5,19,1088,634,1722,1925
0132-000,2014,1,5,20,785,588,1373,1722
0132-000,2014,1,5,21,701,486,1187,1373
0132-000,2014,1,5,22,613,510,1123,1187
0132-000,2014,1,5,23,499,417,916,1123
0132-000,2014,1,5,24,346,365,711,916
0132-000,2014,1,6,1,257,347,604,711
0132-000,2014,1,6,2,292,317,609,604
0132-000,2014,1,6,3,221,252,473,609
0132-000,2014,1,6,4,229,276,505,473
0132-000,2014,1,6,5,228,235,463,505
0132-000,2014,1,6,6,355,345,700,463
0132-000,2014,1,6,7,486,613,1099,700
0132-000,2014,1,6,8,708,1504,2212,1099
0132-000,2014,1,6,9,831,1435,2266,2212
0132-000,2014,1,6,10,773,814,1587,2266
0132-000,2014,1,6,11,870,880,1750,1587
0132-000,2014,1,6,12,896,970,1866,1750
0132-000,2014,1,6,13,909,849,1758,1866
0132-000,2014,1,6,14,792,761,1553,1758
0132-000,2014,1,6,15,901,787,1688,1553
0132-000,2014,1,6,16,887,753,1640,1688
0132-000,2014,1,6,17,893,774,1667,1640
0132-000,2014,1,6,18,1003,788,1791,1667
0132-000,2014,1,6,19,1198,698,1896,1791
0132-000,2014,1,6,20,731,559,1290,1896
0132-000,2014,1,6,21,657,443,1100,1290
0132-000,2014,1,6,22,503,408,911,1100
0132-000,2014,1,6,23,332,291,623,911
0132-000,2014,1,6,24,201,157,358,623
0132-000,2014,1,7,1,131,148,279,358
0132-000,2014,1,7,2,83,94,177,279
0132-000,2014,1,7,3,74,87,161,177
0132-000,2014,1,7,4,60,95,155,161
0132-000,2014,1,7,5,72,73,145,155
0132-000,2014,1,7,6,101,107,208,145
0132-000,2014,1,7,7,281,370,651,208
0132-000,2014,1,7,8,599,1348,1947,651
0132-000,2014,1,7,9,753,1229,1982,1947
0132-000,2014,1,7,10,733,836,1569,1982
0132-000,2014,1,7,11,762,809,1571,1569
0132-000,2014,1,7,12,737,801,1538,1571
0132-000,2014,1,7,13,686,766,1452,1538
0132-000,2014,1,7,14,828,795,1623,1452
0132-000,2014,1,7,15,861,853,1714,1623
0132-000,2014,1,7,16,908,791,1699,1714
0132-000,2014,1,7,17,970,760,1730,1699
0132-000,2014,1,7,18,1124,782,1906,1730
0132-000,2014,1,7,19,1219,764,1983,1906
0132-000,2014,1,7,20,987,588,1575,1983
0132-000,2014,1,7,21,914,467,1381,1575
0132-000,2014,1,7,22,838,442,1280,1381
0132-000,2014,1,7,23,564,250,814,1280
0132-000,2014,1,7,24,472,204,676,814
0132-000,2014,1,8,1,461,161,622,676
0132-000,2014,1,8,2,335,110,445,622
0132-000,2014,1,8,3,263,84,347,445
0132-000,2014,1,8,4,246,107,353,347
0132-000,2014,1,8,5,302,142,444,353
0132-000,2014,1,8,6,376,151,527,444
0132-000,2014,1,8,7,479,330,809,527
0132-000,2014,1,8,8,785,1389,2174,809
0132-000,2014,1,8,9,940,1291,2231,2174
0132-000,2014,1,8,10,811,847,1658,2231
0132-000,2014,1,8,11,753,747,1500,1658
0132-000,2014,1,8,12,791,709,1500,1500
0132-000,2014,1,8,13,673,682,1355,1500
0132-000,2014,1,8,14,750,812,1562,1355
0132-000,2014,1,8,15,844,814,1658,1562
0132-000,2014,1,8,16,831,769,1600,1658
0132-000,2014,1,8,17,793,706,1499,1600
0132-000,2014,1,8,18,1063,744,1807,1499
0132-000,2014,1,8,19,1158,718,1876,1807
0132-000,2014,1,8,20,721,541,1262,1876
0132-000,2014,1,8,21,624,446,1070,1262
0132-000,2014,1,8,22,520,387,907,1070
0132-000,2014,1,8,23,297,256,553,907
0132-000,2014,1,8,24,213,207,420,553
0132-000,2014,1,9,1,128,153,281,420
0132-000,2014,1,9,2,123,105,228,281
0132-000,2014,1,9,3,55,81,136,228
0132-000,2014,1,9,4,53,88,141,136
0132-000,2014,1,9,5,69,70,139,141
0132-000,2014,1,9,6,104,107,211,139
0132-000,2014,1,9,7,279,329,608,211
0132-000,2014,1,9,8,590,1381,1971,608
0132-000,2014,1,9,9,721,1202,1923,1971
0132-000,2014,1,9,10,655,736,1391,1923
0132-000,2014,1,9,11,720,733,1453,1391
0132-000,2014,1,9,12,721,782,1503,1453
0132-000,2014,1,9,13,638,662,1300,1503
0132-000,2014,1,9,14,812,750,1562,1300
0132-000,2014,1,9,15,794,827,1621,1562
0132-000,2014,1,9,16,856,742,1598,1621
0132-000,2014,1,9,17,791,748,1539,1598
0132-000,2014,1,9,18,954,738,1692,1539
0132-000,2014,1,9,19,1120,732,1852,1692
0132-000,2014,1,9,20,723,543,1266,1852
0132-000,2014,1,9,21,683,433,1116,1266
0132-000,2014,1,9,22,535,432,967,1116
0132-000,2014,1,9,23,338,271,609,967
0132-000,2014,1,9,24,174,198,372,609
0132-000,2014,1,10,1,140,151,291,372
0132-000,2014,1,10,2,98,84,182,291
0132-000,2014,1,10,3,64,84,148,182
0132-000,2014,1,10,4,73,101,174,148
0132-000,2014,1,10,5,66,72,138,174
0132-000,2014,1,10,6,130,111,241,138
0132-000,2014,1,10,7,261,313,574,241
0132-000,2014,1,10,8,567,1308,1875,574
0132-000,2014,1,10,9,747,1188,1935,1875
0132-000,2014,1,10,10,655,743,1398,1935
0132-000,2014,1,10,11,736,784,1520,1398
0132-000,2014,1,10,12,778,842,1620,1520
0132-000,2014,1,10,13,742,744,1486,1620
0132-000,2014,1,10,14,824,762,1586,1486
0132-000,2014,1,10,15,840,860,1700,1586
0132-000,2014,1,10,16,901,797,1698,1700
0132-000,2014,1,10,17,918,795,1713,1698
0132-000,2014,1,10,18,1070,851,1921,1713
0132-000,2014,1,10,19,1359,783,2142,1921
0132-000,2014,1,10,20,903,601,1504,2142
0132-000,2014,1,10,21,709,505,1214,1504
0132-000,2014,1,10,22,569,454,1023,1214
0132-000,2014,1,10,23,356,325,681,1023
0132-000,2014,1,10,24,238,219,457,681
0132-000,2014,1,11,1,217,221,438,457
0132-000,2014,1,11,2,138,154,292,438
0132-000,2014,1,11,3,110,149,259,292
0132-000,2014,1,11,4,78,116,194,259
0132-000,2014,1,11,5,90,130,220,194
0132-000,2014,1,11,6,108,127,235,220
0132-000,2014,1,11,7,221,272,493,235
0132-000,2014,1,11,8,410,643,1053,493
0132-000,2014,1,11,9,622,791,1413,1053
0132-000,2014,1,11,10,614,772,1386,1413
0132-000,2014,1,11,11,799,894,1693,1386
0132-000,2014,1,11,12,821,1003,1824,1693
0132-000,2014,1,11,13,897,997,1894,1824
0132-000,2014,1,11,14,811,872,1683,1894
0132-000,2014,1,11,15,848,886,1734,1683
0132-000,2014,1,11,16,925,812,1737,1734
0132-000,2014,1,11,17,964,843,1807,1737
0132-000,2014,1,11,18,1160,914,2074,1807
0132-000,2014,1,11,19,1064,760,1824,2074
0132-000,2014,1,11,20,639,533,1172,1824
0132-000,2014,1,11,21,469,495,964,1172
0132-000,2014,1,11,22,433,406,839,964
0132-000,2014,1,11,23,301,294,595,839
0132-000,2014,1,11,24,187,231,418,595
0132-000,2014,1,12,1,181,190,371,418
0132-000,2014,1,12,2,143,133,276,371
0132-000,2014,1,12,3,82,133,215,276
0132-000,2014,1,12,4,99,89,188,215
0132-000,2014,1,12,5,80,71,151,188
0132-000,2014,1,12,6,99,88,187,151
0132-000,2014,1,12,7,151,149,300,187
0132-000,2014,1,12,8,180,283,463,300
0132-000,2014,1,12,9,303,392,695,463
0132-000,2014,1,12,10,359,474,833,695
0132-000,2014,1,12,11,481,588,1069,833
0132-000,2014,1,12,12,525,560,1085,1069
0132-000,2014,1,12,13,623,600,1223,1085
0132-000,2014,1,12,14,659,631,1290,1223
0132-000,2014,1,12,15,756,649,1405,1290
0132-000,2014,1,12,16,858,656,1514,1405
0132-000,2014,1,12,17,855,708,1563,1514
0132-000,2014,1,12,18,1032,611,1643,1563
0132-000,2014,1,12,19,913,558,1471,1643
0132-000,2014,1,12,20,629,492,1121,1471
0132-000,2014,1,12,21,433,369,802,1121
0132-000,2014,1,12,22,445,361,806,802
0132-000,2014,1,12,23,234,282,516,806
0132-000,2014,1,12,24,163,194,357,516
0132-000,2014,1,13,1,96,138,234,357
0132-000,2014,1,13,2,73,59,132,234
0132-000,2014,1,13,3,47,63,110,132
0132-000,2014,1,13,4,43,60,103,110
0132-000,2014,1,13,5,65,76,141,103
0132-000,2014,1,13,6,151,145,296,141
0132-000,2014,1,13,7,310,401,711,296
0132-000,2014,1,13,8,628,1506,2134,711
0132-000,2014,1,13,9,729,1246,1975,2134
0132-000,2014,1,13,10,643,766,1409,1975
0132-000,2014,1,13,11,773,761,1534,1409
0132-000,2014,1,13,12,758,737,1495,1534
0132-000,2014,1,13,13,668,732,1400,1495
0132-000,2014,1,13,14,749,821,1570,1400
0132-000,2014,1,13,15,800,800,1600,1570
0132-000,2014,1,13,16,875,803,1678,1600
0132-000,2014,1,13,17,890,796,1686,1678
0132-000,2014,1,13,18,1032,770,1802,1686
0132-000,2014,1,13,19,1156,763,1919,1802
0132-000,2014,1,13,20,732,539,1271,1919
0132-000,2014,1,13,21,634,461,1095,1271
0132-000,2014,1,13,22,500,395,895,1095
0132-000,2014,1,13,23,315,274,589,895
0132-000,2014,1,13,24,200,176,376,589
0132-000,2014,1,14,1,124,132,256,376
0132-000,2014,1,14,2,104,90,194,256
0132-000,2014,1,14,3,69,88,157,194
0132-000,2014,1,14,4,58,81,139,157
0132-000,2014,1,14,5,72,94,166,139
0132-000,2014,1,14,6,114,110,224,166
0132-000,2014,1,14,7,296,330,626,224
0132-000,2014,1,14,8,585,1335,1920,626
0132-000,2014,1,14,9,737,1229,1966,1920
0132-000,2014,1,14,10,690,778,1468,1966
0132-000,2014,1,14,11,733,820,1553,1468
0132-000,2014,1,14,12,747,744,1491,1553
0132-000,2014,1,14,13,689,744,1433,1491
0132-000,2014,1,14,14,808,769,1577,1433
0132-000,2014,1,14,15,840,819,1659,1577
0132-000,2014,1,14,16,867,763,1630,1659
0132-000,2014,1,14,17,811,707,1518,1630
0132-000,2014,1,14,18,968,829,1797,1518
0132-000,2014,1,14,19,1125,693,1818,1797
0132-000,2014,1,14,20,753,607,1360,1818
0132-000,2014,1,14,21,684,422,1106,1360
0132-000,2014,1,14,22,541,384,925,1106
0132-000,2014,1,14,23,289,267,556,925
0132-000,2014,1,14,24,203,196,399,556
0132-000,2014,1,15,1,142,140,282,399
0132-000,2014,1,15,2,90,83,173,282
0132-000,2014,1,15,3,79,86,165,173
0132-000,2014,1,15,4,73,88,161,165
0132-000,2014,1,15,5,85,97,182,161
0132-000,2014,1,15,6,124,103,227,182
0132-000,2014,1,15,7,269,338,607,227
0132-000,2014,1,15,8,582,1402,1984,607
0132-000,2014,1,15,9,796,1331,2127,1984
0132-000,2014,1,15,10,741,789,1530,2127
0132-000,2014,1,15,11,741,809,1550,1530
0132-000,2014,1,15,12,766,834,1600,1550
0132-000,2014,1,15,13,673,728,1401,1600
0132-000,2014,1,15,14,806,803,1609,1401
0132-000,2014,1,15,15,983,828,1811,1609
0132-000,2014,1,15,16,859,830,1689,1811
0132-000,2014,1,15,17,864,775,1639,1689
0132-000,2014,1,15,18,1063,802,1865,1639
0132-000,2014,1,15,19,1179,792,1971,1865
0132-000,2014,1,15,20,788,566,1354,1971
0132-000,2014,1,15,21,656,454,1110,1354
0132-000,2014,1,15,22,518,414,932,1110
0132-000,2014,1,15,23,299,328,627,932
0132-000,2014,1,15,24,187,198,385,627
0132-000,2014,1,16,1,170,135,305,385
0132-000,2014,1,16,2,98,108,206,305
0132-000,2014,1,16,3,62,90,152,206
0132-000,2014,1,16,4,75,100,175,152
0132-000,2014,1,16,5,101,92,193,175
0132-000,2014,1,16,6,156,133,289,193
0132-000,2014,1,16,7,262,334,596,289
0132-000,2014,1,16,8,560,1363,1923,596
0132-000,2014,1,16,9,767,1162,1929,1923
0132-000,2014,1,16,10,695,828,1523,1929
0132-000,2014,1,16,11,794,873,1667,1523
0132-000,2014,1,16,12,795,798,1593,1667
0132-000,2014,1,16,13,733,751,1484,1593
0132-000,2014,1,16,14,816,766,1582,1484
0132-000,2014,1,16,15,816,841,1657,1582
0132-000,2014,1,16,16,859,757,1616,1657
0132-000,2014,1,16,17,876,779,1655,1616
0132-000,2014,1,16,18,1075,781,1856,1655
0132-000,2014,1,16,19,1140,710,1850,1856
0132-000,2014,1,16,20,780,618,1398,1850
0132-000,2014,1,16,21,649,460,1109,1398
0132-000,2014,1,16,22,539,420,959,1109
0132-000,2014,1,16,23,326,276,602,959
0132-000,2014,1,16,24,225,224,449,602
0132-000,2014,1,17,1,179,178,357,449
0132-000,2014,1,17,2,86,78,164,357
0132-000,2014,1,17,3,79,94,173,164
0132-000,2014,1,17,4,71,97,168,173
0132-000,2014,1,17,5,99,110,209,168
0132-000,2014,1,17,6,121,110,231,209
0132-000,2014,1,17,7,266,343,609,231
0132-000,2014,1,17,8,625,1319,1944,609
0132-000,2014,1,17,9,784,1158,1942,1944
0132-000,2014,1,17,10,712,788,1500,1942
0132-000,2014,1,17,11,709,850,1559,1500
0132-000,2014,1,17,12,771,840,1611,1559
0132-000,2014,1,17,13,803,789,1592,1611
0132-000,2014,1,17,14,890,769,1659,1592
0132-000,2014,1,17,15,826,814,1640,1659
0132-000,2014,1,17,16,909,826,1735,1640
0132-000,2014,1,17,17,931,826,1757,1735
0132-000,2014,1,17,18,1169,829,1998,1757
0132-000,2014,1,17,19,1416,764,2180,1998
0132-000,2014,1,17,20,916,623,1539,2180
0132-000,2014,1,17,21,708,481,1189,1539
0132-000,2014,1,17,22,571,466,1037,1189
0132-000,2014,1,17,23,320,309,629,1037
0132-000,2014,1,17,24,211,214,425,629
0132-000,2014,1,18,1,183,182,365,425
0132-000,2014,1,18,2,120,158,278,365
0132-000,2014,1,18,3,99,105,204,278
0132-000,2014,1,18,4,96,114,210,204
0132-000,2014,1,18,5,95,115,210,210
0132-000,2014,1,18,6,141,138,279,210
0132-000,2014,1,18,7,221,258,479,279
0132-000,2014,1,18,8,425,680,1105,479
0132-000,2014,1,18,9,646,818,1464,1105
0132-000,2014,1,18,10,628,756,1384,1464
0132-000,2014,1,18,11,836,886,1722,1384
0132-000,2014,1,18,12,831,844,1675,1722
0132-000,2014,1,18,13,842,879,1721,1675
0132-000,2014,1,18,14,835,824,1659,1721
0132-000,2014,1,18,15,884,815,1699,1659
0132-000,2014,1,18,16,836,807,1643,1699
0132-000,2014,1,18,17,916,847,1763,1643
0132-000,2014,1,18,18,1163,818,1981,1763
0132-000,2014,1,18,19,1075,735,1810,1981
0132-000,2014,1,18,20,642,552,1194,1810
0132-000,2014,1,18,21,472,433,905,1194
0132-000,2014,1,18,22,437,373,810,905
0132-000,2014,1,18,23,291,336,627,810
0132-000,2014,1,18,24,215,246,461,627
0132-000,2014,1,19,1,181,176,357,461
0132-000,2014,1,19,2,118,123,241,357
0132-000,2014,1,19,3,87,104,191,241
0132-000,2014,1,19,4,54,79,133,191
0132-000,2014,1,19,5,84,69,153,133
0132-000,2014,1,19,6,89,110,199,153
0132-000,2014,1,19,7,151,140,291,199
0132-000,2014,1,19,8,240,330,570,291
0132-000,2014,1,19,9,315,374,689,570
0132-000,2014,1,19,10,422,481,903,689
0132-000,2014,1,19,11,494,611,1105,903
0132-000,2014,1,19,12,515,615,1130,1105
0132-000,2014,1,19,13,664,601,1265,1130
0132-000,2014,1,19,14,678,649,1327,1265
0132-000,2014,1,19,15,769,676,1445,1327
0132-000,2014,1,19,16,819,683,1502,1445
0132-000,2014,1,19,17,812,687,1499,1502
0132-000,2014,1,19,18,928,678,1606,1499
0132-000,2014,1,19,19,887,570,1457,1606
0132-000,2014,1,19,20,623,468,1091,1457
0132-000,2014,1,19,21,437,421,858,1091
0132-000,2014,1,19,22,365,328,693,858
0132-000,2014,1,19,23,256,263,519,693
0132-000,2014,1,19,24,160,189,349,519
0132-000,2014,1,20,1,118,131,249,349
0132-000,2014,1,20,2,60,89,149,249
0132-000,2014,1,20,3,56,96,152,149
0132-000,2014,1,20,4,50,55,105,152
0132-000,2014,1,20,5,57,83,140,105
0132-000,2014,1,20,6,104,113,217,140
0132-000,2014,1,20,7,291,371,662,217
0132-000,2014,1,20,8,518,1175,1693,662
0132-000,2014,1,20,9,630,1119,1749,1693
0132-000,2014,1,20,10,592,643,1235,1749
0132-000,2014,1,20,11,655,686,1341,1235
0132-000,2014,1,20,12,666,756,1422,1341
0132-000,2014,1,20,13,621,670,1291,1422
0132-000,2014,1,20,14,774,715,1489,1291
0132-000,2014,1,20,15,764,762,1526,1489
0132-000,2014,1,20,16,789,716,1505,1526
0132-000,2014,1,20,17,777,704,1481,1505
0132-000,2014,1,20,18,902,726,1628,1481
0132-000,2014,1,20,19,967,681,1648,1628
0132-000,2014,1,20,20,671,506,1177,1648
0132-000,2014,1,20,21,571,354,925,1177
0132-000,2014,1,20,22,408,312,720,925
0132-000,2014,1,20,23,235,201,436,720
0132-000,2014,1,20,24,150,146,296,436
0132-000,2014,1,21,1,126,113,239,296
0132-000,2014,1,21,2,70,68,138,239
0132-000,2014,1,21,3,52,58,110,138
0132-000,2014,1,21,4,48,68,116,110
0132-000,2014,1,21,5,69,82,151,116
0132-000,2014,1,21,6,73,101,174,151
0132-000,2014,1,21,7,196,280,476,174
0132-000,2014,1,21,8,478,1286,1764,476
0132-000,2014,1,21,9,638,1058,1696,1764
0132-000,2014,1,21,10,621,761,1382,1696
0132-000,2014,1,21,11,700,772,1472,1382
0132-000,2014,1,21,12,736,679,1415,1472
0132-000,2014,1,21,13,696,684,1380,1415
0132-000,2014,1,21,14,750,741,1491,1380
0132-000,2014,1,21,15,840,825,1665,1491
0132-000,2014,1,21,16,895,715,1610,1665
0132-000,2014,1,21,17,837,690,1527,1610
0132-000,2014,1,21,18,897,776,1673,1527
0132-000,2014,1,21,19,1025,690,1715,1673
0132-000,2014,1,21,20,720,530,1250,1715
0132-000,2014,1,21,21,689,404,1093,1250
0132-000,2014,1,21,22,509,385,894,1093
0132-000,2014,1,21,23,299,289,588,894
0132-000,2014,1,21,24,200,209,409,588
0132-000,2014,1,22,1,160,124,284,409
0132-000,2014,1,22,2,105,87,192,284
0132-000,2014,1,22,3,83,90,173,192
0132-000,2014,1,22,4,99,97,196,173
0132-000,2014,1,22,5,88,77,165,196
0132-000,2014,1,22,6,106,105,211,165
0132-000,2014,1,22,7,285,321,606,211
0132-000,2014,1,22,8,597,1364,1961,606
0132-000,2014,1,22,9,809,1206,2015,1961
0132-000,2014,1,22,10,689,778,1467,2015
0132-000,2014,1,22,11,822,778,1600,1467
0132-000,2014,1,22,12,742,807,1549,1600
0132-000,2014,1,22,13,742,760,1502,1549
0132-000,2014,1,22,14,829,805,1634,1502
0132-000,2014,1,22,15,908,806,1714,1634
0132-000,2014,1,22,16,903,805,1708,1714
0132-000,2014,1,22,17,831,842,1673,1708
0132-000,2014,1,22,18,1111,847,1958,1673
0132-000,2014,1,22,19,1182,757,1939,1958
0132-000,2014,1,22,20,845,581,1426,1939
0132-000,2014,1,22,21,639,436,1075,1426
0132-000,2014,1,22,22,527,425,952,1075
0132-000,2014,1,22,23,327,289,616,952
0132-000,2014,1,22,24,231,238,469,616
0132-000,2014,1,23,1,161,162,323,469
0132-000,2014,1,23,2,111,113,224,323
0132-000,2014,1,23,3,86,98,184,224
0132-000,2014,1,23,4,73,112,185,184
0132-000,2014,1,23,5,89,86,175,185
0132-000,2014,1,23,6,128,125,253,175
0132-000,2014,1,23,7,286,348,634,253
0132-000,2014,1,23,8,605,1371,1976,634
0132-000,2014,1,23,9,751,1160,1911,1976
0132-000,2014,1,23,10,710,826,1536,1911
0132-000,2014,1,23,11,765,826,1591,1536
0132-000,2014,1,23,12,799,793,1592,1591
0132-000,2014,1,23,13,676,731,1407,1592
0132-000,2014,1,23,14,854,797,1651,1407
0132-000,2014,1,23,15,899,849,1748,1651
0132-000,2014,1,23,16,864,814,1678,1748
0132-000,2014,1,23,17,889,787,1676,1678
0132-000,2014,1,23,18,1084,829,1913,1676
0132-000,2014,1,23,19,1075,788,1863,1913
0132-000,2014,1,23,20,809,537,1346,1863
0132-000,2014,1,23,21,690,487,1177,1346
0132-000,2014,1,23,22,549,423,972,1177
0132-000,2014,1,23,23,321,304,625,972
0132-000,2014,1,23,24,237,213,450,625
0132-000,2014,1,24,1,163,167,330,450
0132-000,2014,1,24,2,115,88,203,330
0132-000,2014,1,24,3,74,109,183,203
0132-000,2014,1,24,4,68,83,151,183
0132-000,2014,1,24,5,80,110,190,151
0132-000,2014,1,24,6,128,141,269,190
0132-000,2014,1,24,7,275,352,627,269
0132-000,2014,1,24,8,579,1383,1962,627
0132-000,2014,1,24,9,787,1197,1984,1962
0132-000,2014,1,24,10,761,898,1659,1984
0132-000,2014,1,24,11,772,900,1672,1659
0132-000,2014,1,24,12,804,813,1617,1672
0132-000,2014,1,24,13,772,735,1507,1617
0132-000,2014,1,24,14,880,871,1751,1507
0132-000,2014,1,24,15,922,923,1845,1751
0132-000,2014,1,24,16,957,831,1788,1845
0132-000,2014,1,24,17,996,840,1836,1788
0132-000,2014,1,24,18,1225,881,2106,1836
0132-000,2014,1,24,19,1290,833,2123,2106
0132-000,2014,1,24,20,993,634,1627,2123
0132-000,2014,1,24,21,748,500,1248,1627
0132-000,2014,1,24,22,566,465,1031,1248
0132-000,2014,1,24,23,359,322,681,1031
0132-000,2014,1,24,24,245,268,513,681
0132-000,2014,1,25,1,197,218,415,513
0132-000,2014,1,25,2,135,130,265,415
0132-000,2014,1,25,3,124,109,233,265
0132-000,2014,1,25,4,90,115,205,233
0132-000,2014,1,25,5,100,124,224,205
0132-000,2014,1,25,6,115,151,266,224
0132-000,2014,1,25,7,198,233,431,266
0132-000,2014,1,25,8,412,620,1032,431
0132-000,2014,1,25,9,674,787,1461,1032
0132-000,2014,1,25,10,704,817,1521,1461
0132-000,2014,1,25,11,726,801,1527,1521
0132-000,2014,1,25,12,838,810,1648,1527
0132-000,2014,1,25,13,817,784,1601,1648
0132-000,2014,1,25,14,863,811,1674,1601
0132-000,2014,1,25,15,844,848,1692,1674
0132-000,2014,1,25,16,852,760,1612,1692
0132-000,2014,1,25,17,844,768,1612,1612
0132-000,2014,1,25,18,1130,758,1888,1612
0132-000,2014,1,25,19,844,678,1522,1888
0132-000,2014,1,25,20,582,532,1114,1522
0132-000,2014,1,25,21,469,433,902,1114
0132-000,2014,1,25,22,403,375,778,902
0132-000,2014,1,25,23,276,288,564,778
0132-000,2014,1,25,24,207,232,439,564
0132-000,2014,1,26,1,161,161,322,439
0132-000,2014,1,26,2,142,124,266,322
0132-000,2014,1,26,3,152,127,279,266
0132-000,2014,1,26,4,87,104,191,279
0132-000,2014,1,26,5,88,76,164,191
0132-000,2014,1,26,6,94,102,196,164
0132-000,2014,1,26,7,142,172,314,196
0132-000,2014,1,26,8,222,281,503,314
0132-000,2014,1,26,9,350,403,753,503
0132-000,2014,1,26,10,412,496,908,753
0132-000,2014,1,26,11,511,617,1128,908
0132-000,2014,1,26,12,501,583,1084,1128
0132-000,2014,1,26,13,683,698,1381,1084
0132-000,2014,1,26,14,703,692,1395,1381
0132-000,2014,1,26,15,793,705,1498,1395
0132-000,2014,1,26,16,754,683,1437,1498
0132-000,2014,1,26,17,799,663,1462,1437
0132-000,2014,1,26,18,926,613,1539,1462
0132-000,2014,1,26,19,799,573,1372,1539
0132-000,2014,1,26,20,558,456,1014,1372
0132-000,2014,1,26,21,424,334,758,1014
0132-000,2014,1,26,22,408,337,745,758
0132-000,2014,1,26,23,253,254,507,745
0132-000,2014,1,26,24,147,168,315,507
0132-000,2014,1,27,1,110,139,249,315
0132-000,2014,1,27,2,72,84,156,249
0132-000,2014,1,27,3,44,59,103,156
0132-000,2014,1,27,4,52,57,109,103
0132-000,2014,1,27,5,58,81,139,109
0132-000,2014,1,27,6,121,130,251,139
0132-000,2014,1,27,7,334,425,759,251
0132-000,2014,1,27,8,571,1491,2062,759
0132-000,2014,1,27,9,769,1221,1990,2062
0132-000,2014,1,27,10,758,824,1582,1990
0132-000,2014,1,27,11,835,877,1712,1582
0132-000,2014,1,27,12,760,914,1674,1712
0132-000,2014,1,27,13,762,857,1619,1674
0132-000,2014,1,27,14,905,809,1714,1619
0132-000,2014,1,27,15,892,907,1799,1714
0132-000,2014,1,27,16,1011,883,1894,1799
0132-000,2014,1,27,17,912,868,1780,1894
0132-000,2014,1,27,18,1075,847,1922,1780
0132-000,2014,1,27,19,1214,843,2057,1922
0132-000,2014,1,27,20,854,589,1443,2057
0132-000,2014,1,27,21,718,493,1211,1443
0132-000,2014,1,27,22,552,401,953,1211
0132-000,2014,1,27,23,316,292,608,953
0132-000,2014,1,27,24,191,212,403,608
0132-000,2014,1,28,1,160,170,330,403
0132-000,2014,1,28,2,117,113,230,330
0132-000,2014,1,28,3,88,110,198,230
0132-000,2014,1,28,4,78,90,168,198
0132-000,2014,1,28,5,82,90,172,168
0132-000,2014,1,28,6,128,137,265,172
0132-000,2014,1,28,7,273,334,607,265
0132-000,2014,1,28,8,564,901,1465,607
0132-000,2014,1,28,9,751,1487,2238,1465
0132-000,2014,1,28,10,717,822,1539,2238
0132-000,2014,1,28,11,855,873,1728,1539
0132-000,2014,1,28,12,870,874,1744,1728
0132-000,2014,1,28,13,804,831,1635,1744
0132-000,2014,1,28,14,875,893,1768,1635
0132-000,2014,1,28,15,961,943,1904,1768
0132-000,2014,1,28,16,966,928,1894,1904
0132-000,2014,1,28,17,990,860,1850,1894
0132-000,2014,1,28,18,1120,919,2039,1850
0132-000,2014,1,28,19,1187,831,2018,2039
0132-000,2014,1,28,20,875,636,1511,2018
0132-000,2014,1,28,21,782,490,1272,1511
0132-000,2014,1,28,22,548,468,1016,1272
0132-000,2014,1,28,23,341,355,696,1016
0132-000,2014,1,28,24,245,219,464,696
0132-000,2014,1,29,1,160,168,328,464
0132-000,2014,1,29,2,121,128,249,328
0132-000,2014,1,29,3,71,84,155,249
0132-000,2014,1,29,4,86,107,193,155
0132-000,2014,1,29,5,76,110,186,193
0132-000,2014,1,29,6,105,109,214,186
0132-000,2014,1,29,7,243,303,546,214
0132-000,2014,1,29,8,544,1261,1805,546
0132-000,2014,1,29,9,716,1059,1775,1805
0132-000,2014,1,29,10,693,848,1541,1775
0132-000,2014,1,29,11,746,862,1608,1541
0132-000,2014,1,29,12,787,964,1751,1608
0132-000,2014,1,29,13,833,1144,1977,1751
0132-000,2014,1,29,14,824,1467,2291,1977
0132-000,2014,1,29,15,870,1558,2428,2291
0132-000,2014,1,29,16,980,1794,2774,2428
0132-000,2014,1,29,17,1050,1821,2871,2774
0132-000,2014,1,29,18,1162,1791,2953,2871
0132-000,2014,1,29,19,952,1626,2578,2953
0132-000,2014,1,29,20,667,1654,2321,2578
0132-000,2014,1,29,21,507,1628,2135,2321
0132-000,2014,1,29,22,409,1569,1978,2135
0132-000,2014,1,29,23,279,1194,1473,1978
0132-000,2014,1,29,24,207,702,909,1473
0132-000,2014,1,30,1,182,528,710,909
0132-000,2014,1,30,2,134,537,671,710
0132-000,2014,1,30,3,77,527,604,671
0132-000,2014,1,30,4,71,513,584,604
0132-000,2014,1,30,5,61,895,956,584
0132-000,2014,1,30,6,90,1699,1789,956
0132-000,2014,1,30,7,110,1638,1748,1789
0132-000,2014,1,30,8,186,1551,1737,1748
0132-000,2014,1,30,9,299,1696,1995,1737
0132-000,2014,1,30,10,403,1623,2026,1995
0132-000,2014,1,30,11,653,1500,2153,2026
0132-000,2014,1,30,12,790,1235,2025,2153
0132-000,2014,1,30,13,698,1118,1816,2025
0132-000,2014,1,30,14,706,1040,1746,1816
0132-000,2014,1,30,15,637,971,1608,1746
0132-000,2014,1,30,16,588,835,1423,1608
0132-000,2014,1,30,17,542,714,1256,1423
0132-000,2014,1,30,18,523,575,1098,1256
0132-000,2014,1,30,19,403,441,844,1098
0132-000,2014,1,30,20,365,370,735,844
0132-000,2014,1,30,21,319,337,656,735
0132-000,2014,1,30,22,264,257,521,656
0132-000,2014,1,30,23,180,199,379,521
0132-000,2014,1,30,24,131,119,250,379
0132-000,2014,1,31,1,96,104,200,250
0132-000,2014,1,31,2,85,90,175,200
0132-000,2014,1,31,3,63,58,121,175
0132-000,2014,1,31,4,55,51,106,121
0132-000,2014,1,31,5,41,41,82,106
0132-000,2014,1,31,6,65,107,172,82
0132-000,2014,1,31,7,178,314,492,172
0132-000,2014,1,31,8,366,595,961,492
0132-000,2014,1,31,9,367,579,946,961
0132-000,2014,1,31,10,417,540,957,946
0132-000,2014,1,31,11,1020,849,1869,957
0132-000,2014,1,31,12,1434,1206,2640,1869
0132-000,2014,1,31,13,1571,1405,2976,2640
0132-000,2014,1,31,14,1924,1519,3443,2976
0132-000,2014,1,31,15,1958,1668,3626,3443
0132-000,2014,1,31,16,1834,1586,3420,3626
0132-000,2014,1,31,17,1796,1786,3582,3420
0132-000,2014,1,31,18,1755,1811,3566,3582
0132-000,2014,1,31,19,1653,1305,2958,3566
0132-000,2014,1,31,20,1373,702,2075,2958
0132-000,2014,1,31,21,1083,386,1469,2075
0132-000,2014,1,31,22,773,299,1072,1469
0132-000,2014,1,31,23,573,257,830,1072
0132-000,2014,1,31,24,426,176,602,830
0132-000,2014,2,1,1,380,134,514,602
0132-000,2014,2,1,2,243,71,314,514
0132-000,2014,2,1,3,104,56,160,314
0132-000,2014,2,1,4,61,38,99,160
0132-000,2014,2,1,5,90,49,139,99
0132-000,2014,2,1,6,68,57,125,139
0132-000,2014,2,1,7,104,71,175,125
0132-000,2014,2,1,8,143,121,264,175
0132-000,2014,2,1,9,233,186,419,264
0132-000,2014,2,1,10,378,296,674,419
0132-000,2014,2,1,11,765,415,1180,674
0132-000,2014,2,1,12,1162,584,1746,1180
0132-000,2014,2,1,13,1302,631,1933,1746
0132-000,2014,2,1,14,1449,584,2033,1933
0132-000,2014,2,1,15,1462,598,2060,2033
0132-000,2014,2,1,16,1692,606,2298,2060
0132-000,2014,2,1,17,1562,546,2108,2298
0132-000,2014,2,1,18,1671,479,2150,2108
0132-000,2014,2,1,19,1629,448,2077,2150
0132-000,2014,2,1,20,1622,326,1948,2077
0132-000,2014,2,1,21,1321,249,1570,1948
0132-000,2014,2,1,22,1299,266,1565,1570
0132-000,2014,2,1,23,1084,211,1295,1565
0132-000,2014,2,1,24,684,151,835,1295
0132-000,2014,2,2,1,645,130,775,835
0132-000,2014,2,2,2,520,95,615,775
0132-000,2014,2,2,3,283,73,356,615
0132-000,2014,2,2,4,100,59,159,356
0132-000,2014,2,2,5,63,60,123,159
0132-000,2014,2,2,6,63,58,121,123
0132-000,2014,2,2,7,97,86,183,121
0132-000,2014,2,2,8,142,179,321,183
0132-000,2014,2,2,9,252,220,472,321
0132-000,2014,2,2,10,401,307,708,472
0132-000,2014,2,2,11,602,393,995,708
0132-000,2014,2,2,12,746,412,1158,995
0132-000,2014,2,2,13,997,477,1474,1158
0132-000,2014,2,2,14,1120,574,1694,1474
0132-000,2014,2,2,15,1171,541,1712,1694
0132-000,2014,2,2,16,1158,689,1847,1712
0132-000,2014,2,2,17,1180,676,1856,1847
0132-000,2014,2,2,18,1049,513,1562,1856
0132-000,2014,2,2,19,768,417,1185,1562
0132-000,2014,2,2,20,536,390,926,1185
0132-000,2014,2,2,21,422,329,751,926
0132-000,2014,2,2,22,334,317,651,751
0132-000,2014,2,2,23,252,240,492,651
0132-000,2014,2,2,24,172,150,322,492
0132-000,2014,2,3,1,100,124,224,322
0132-000,2014,2,3,2,68,82,150,224
0132-000,2014,2,3,3,84,84,168,150
0132-000,2014,2,3,4,71,70,141,168
0132-000,2014,2,3,5,75,74,149,141
0132-000,2014,2,3,6,106,105,211,149
0132-000,2014,2,3,7,277,387,664,211
0132-000,2014,2,3,8,563,1344,1907,664
0132-000,2014,2,3,9,686,967,1653,1907
0132-000,2014,2,3,10,645,638,1283,1653
0132-000,2014,2,3,11,683,711,1394,1283
0132-000,2014,2,3,12,705,735,1440,1394
0132-000,2014,2,3,13,670,649,1319,1440
0132-000,2014,2,3,14,717,782,1499,1319
0132-000,2014,2,3,15,845,713,1558,1499
0132-000,2014,2,3,16,828,729,1557,1558
0132-000,2014,2,3,17,764,732,1496,1557
0132-000,2014,2,3,18,975,763,1738,1496
0132-000,2014,2,3,19,1051,696,1747,1738
0132-000,2014,2,3,20,686,529,1215,1747
0132-000,2014,2,3,21,581,427,1008,1215
0132-000,2014,2,3,22,467,347,814,1008
0132-000,2014,2,3,23,259,240,499,814
0132-000,2014,2,3,24,207,153,360,499
0132-000,2014,2,4,1,109,133,242,360
0132-000,2014,2,4,2,91,90,181,242
0132-000,2014,2,4,3,51,67,118,181
0132-000,2014,2,4,4,59,65,124,118
0132-000,2014,2,4,5,80,85,165,124
0132-000,2014,2,4,6,121,107,228,165
0132-000,2014,2,4,7,276,353,629,228
0132-000,2014,2,4,8,558,1411,1969,629
0132-000,2014,2,4,9,759,1127,1886,1969
0132-000,2014,2,4,10,653,832,1485,1886
0132-000,2014,2,4,11,684,697,1381,1485
0132-000,2014,2,4,12,698,753,1451,1381
0132-000,2014,2,4,13,678,735,1413,1451
0132-000,2014,2,4,14,814,719,1533,1413
0132-000,2014,2,4,15,780,808,1588,1533
0132-000,2014,2,4,16,799,728,1527,1588
0132-000,2014,2,4,17,807,750,1557,1527
0132-000,2014,2,4,18,943,714,1657,1557
0132-000,2014,2,4,19,1085,764,1849,1657
0132-000,2014,2,4,20,780,547,1327,1849
0132-000,2014,2,4,21,653,459,1112,1327
0132-000,2014,2,4,22,509,366,875,1112
0132-000,2014,2,4,23,296,273,569,875
0132-000,2014,2,4,24,195,173,368,569
0132-000,2014,2,5,1,174,128,302,368
0132-000,2014,2,5,2,85,98,183,302
0132-000,2014,2,5,3,72,87,159,183
0132-000,2014,2,5,4,55,68,123,159
0132-000,2014,2,5,5,65,80,145,123
0132-000,2014,2,5,6,124,110,234,145
0132-000,2014,2,5,7,285,323,608,234
0132-000,2014,2,5,8,603,1379,1982,608
0132-000,2014,2,5,9,713,1108,1821,1982
0132-000,2014,2,5,10,636,726,1362,1821
0132-000,2014,2,5,11,670,771,1441,1362
0132-000,2014,2,5,12,710,719,1429,1441
0132-000,2014,2,5,13,650,684,1334,1429
0132-000,2014,2,5,14,737,709,1446,1334
0132-000,2014,2,5,15,841,802,1643,1446
0132-000,2014,2,5,16,868,724,1592,1643
0132-000,2014,2,5,17,833,773,1606,1592
0132-000,2014,2,5,18,967,799,1766,1606
0132-000,2014,2,5,19,1131,774,1905,1766
0132-000,2014,2,5,20,723,567,1290,1905
0132-000,2014,2,5,21,621,436,1057,1290
0132-000,2014,2,5,22,543,412,955,1057
0132-000,2014,2,5,23,306,264,570,955
0132-000,2014,2,5,24,202,188,390,570
0132-000,2014,2,6,1,134,160,294,390
0132-000,2014,2,6,2,109,86,195,294
0132-000,2014,2,6,3,82,90,172,195
0132-000,2014,2,6,4,64,77,141,172
0132-000,2014,2,6,5,70,78,148,141
0132-000,2014,2,6,6,110,106,216,148
0132-000,2014,2,6,7,310,336,646,216
0132-000,2014,2,6,8,572,1385,1957,646
0132-000,2014,2,6,9,752,1102,1854,1957
0132-000,2014,2,6,10,667,805,1472,1854
0132-000,2014,2,6,11,702,742,1444,1472
0132-000,2014,2,6,12,720,717,1437,1444
0132-000,2014,2,6,13,651,671,1322,1437
0132-000,2014,2,6,14,791,792,1583,1322
0132-000,2014,2,6,15,805,803,1608,1583
0132-000,2014,2,6,16,900,798,1698,1608
0132-000,2014,2,6,17,792,763,1555,1698
0132-000,2014,2,6,18,1028,802,1830,1555
0132-000,2014,2,6,19,1128,758,1886,1830
0132-000,2014,2,6,20,761,523,1284,1886
0132-000,2014,2,6,21,629,479,1108,1284
0132-000,2014,2,6,22,525,373,898,1108
0132-000,2014,2,6,23,328,293,621,898
0132-000,2014,2,6,24,227,182,409,621
0132-000,2014,2,7,1,171,176,347,409
0132-000,2014,2,7,2,98,92,190,347
0132-000,2014,2,7,3,82,77,159,190
0132-000,2014,2,7,4,56,79,135,159
0132-000,2014,2,7,5,75,92,167,135
0132-000,2014,2,7,6,114,104,218,167
0132-000,2014,2,7,7,305,337,642,218
0132-000,2014,2,7,8,609,1412,2021,642
0132-000,2014,2,7,9,771,1135,1906,2021
0132-000,2014,2,7,10,757,808,1565,1906
0132-000,2014,2,7,11,745,805,1550,1565
0132-000,2014,2,7,12,736,838,1574,1550
0132-000,2014,2,7,13,790,684,1474,1574
0132-000,2014,2,7,14,777,866,1643,1474
0132-000,2014,2,7,15,836,837,1673,1643
0132-000,2014,2,7,16,936,803,1739,1673
0132-000,2014,2,7,17,884,865,1749,1739
0132-000,2014,2,7,18,1146,826,1972,1749
0132-000,2014,2,7,19,1299,841,2140,1972
0132-000,2014,2,7,20,910,633,1543,2140
0132-000,2014,2,7,21,682,476,1158,1543
0132-000,2014,2,7,22,534,445,979,1158
0132-000,2014,2,7,23,327,304,631,979
0132-000,2014,2,7,24,207,221,428,631
0132-000,2014,2,8,1,190,192,382,428
0132-000,2014,2,8,2,130,117,247,382
0132-000,2014,2,8,3,97,106,203,247
0132-000,2014,2,8,4,71,103,174,203
0132-000,2014,2,8,5,95,109,204,174
0132-000,2014,2,8,6,141,113,254,204
0132-000,2014,2,8,7,224,227,451,254
0132-000,2014,2,8,8,427,594,1021,451
0132-000,2014,2,8,9,548,808,1356,1021
0132-000,2014,2,8,10,637,715,1352,1356
0132-000,2014,2,8,11,621,764,1385,1352
0132-000,2014,2,8,12,753,774,1527,1385
0132-000,2014,2,8,13,735,717,1452,1527
0132-000,2014,2,8,14,843,762,1605,1452
0132-000,2014,2,8,15,799,753,1552,1605
0132-000,2014,2,8,16,808,712,1520,1552
0132-000,2014,2,8,17,844,735,1579,1520
0132-000,2014,2,8,18,1107,726,1833,1579
0132-000,2014,2,8,19,841,737,1578,1833
0132-000,2014,2,8,20,545,499,1044,1578
0132-000,2014,2,8,21,460,422,882,1044
0132-000,2014,2,8,22,406,368,774,882
0132-000,2014,2,8,23,234,279,513,774
0132-000,2014,2,8,24,189,207,396,513
0132-000,2014,2,9,1,147,150,297,396
0132-000,2014,2,9,2,116,134,250,297
0132-000,2014,2,9,3,86,86,172,250
0132-000,2014,2,9,4,40,66,106,172
0132-000,2014,2,9,5,71,71,142,106
0132-000,2014,2,9,6,97,61,158,142
0132-000,2014,2,9,7,144,134,278,158
0132-000,2014,2,9,8,191,236,427,278
0132-000,2014,2,9,9,273,333,606,427
0132-000,2014,2,9,10,311,427,738,606
0132-000,2014,2,9,11,420,472,892,738
0132-000,2014,2,9,12,495,511,1006,892
0132-000,2014,2,9,13,592,572,1164,1006
0132-000,2014,2,9,14,637,585,1222,1164
0132-000,2014,2,9,15,658,646,1304,1222
0132-000,2014,2,9,16,671,659,1330,1304
0132-000,2014,2,9,17,689,643,1332,1330
0132-000,2014,2,9,18,723,586,1309,1332
0132-000,2014,2,9,19,708,511,1219,1309
0132-000,2014,2,9,20,481,389,870,1219
0132-000,2014,2,9,21,386,385,771,870
0132-000,2014,2,9,22,335,275,610,771
0132-000,2014,2,9,23,192,213,405,610
0132-000,2014,2,9,24,120,136,256,405
0132-000,2014,2,10,1,85,123,208,256
0132-000,2014,2,10,2,64,59,123,208
0132-000,2014,2,10,3,50,54,104,123
0132-000,2014,2,10,4,43,47,90,104
0132-000,2014,2,10,5,57,71,128,90
0132-000,2014,2,10,6,97,110,207,128
0132-000,2014,2,10,7,295,344,639,207
0132-000,2014,2,10,8,528,1152,1680,639
0132-000,2014,2,10,9,712,1452,2164,1680
0132-000,2014,2,10,10,675,695,1370,2164
0132-000,2014,2,10,11,715,709,1424,1370
0132-000,2014,2,10,12,761,729,1490,1424
0132-000,2014,2,10,13,682,707,1389,1490
0132-000,2014,2,10,14,742,839,1581,1389
0132-000,2014,2,10,15,813,779,1592,1581
0132-000,2014,2,10,16,863,758,1621,1592
0132-000,2014,2,10,17,782,744,1526,1621
0132-000,2014,2,10,18,993,757,1750,1526
0132-000,2014,2,10,19,1036,735,1771,1750
0132-000,2014,2,10,20,749,582,1331,1771
0132-000,2014,2,10,21,665,458,1123,1331
0132-000,2014,2,10,22,507,396,903,1123
0132-000,2014,2,10,23,283,256,539,903
0132-000,2014,2,10,24,188,167,355,539
0132-000,2014,2,11,1,122,121,243,355
0132-000,2014,2,11,2,90,86,176,243
0132-000,2014,2,11,3,74,71,145,176
0132-000,2014,2,11,4,56,76,132,145
0132-000,2014,2,11,5,79,80,159,132
0132-000,2014,2,11,6,113,112,225,159
0132-000,2014,2,11,7,318,371,689,225
0132-000,2014,2,11,8,558,1413,1971,689
0132-000,2014,2,11,9,791,1134,1925,1971
0132-000,2014,2,11,10,688,840,1528,1925
0132-000,2014,2,11,11,709,790,1499,1528
0132-000,2014,2,11,12,754,753,1507,1499
0132-000,2014,2,11,13,675,734,1409,1507
0132-000,2014,2,11,14,752,799,1551,1409
0132-000,2014,2,11,15,843,849,1692,1551
0132-000,2014,2,11,16,918,769,1687,1692
0132-000,2014,2,11,17,834,756,1590,1687
0132-000,2014,2,11,18,990,725,1715,1590
0132-000,2014,2,11,19,1130,786,1916,1715
0132-000,2014,2,11,20,804,591,1395,1916
0132-000,2014,2,11,21,713,458,1171,1395
0132-000,2014,2,11,22,524,409,933,1171
0132-000,2014,2,11,23,300,280,580,933
0132-000,2014,2,11,24,173,163,336,580
0132-000,2014,2,12,1,129,148,277,336
0132-000,2014,2,12,2,95,95,190,277
0132-000,2014,2,12,3,74,97,171,190
0132-000,2014,2,12,4,55,74,129,171
0132-000,2014,2,12,5,71,77,148,129
0132-000,2014,2,12,6,103,125,228,148
0132-000,2014,2,12,7,329,366,695,228
0132-000,2014,2,12,8,552,1413,1965,695
0132-000,2014,2,12,9,770,1078,1848,1965
0132-000,2014,2,12,10,726,786,1512,1848
0132-000,2014,2,12,11,701,761,1462,1512
0132-000,2014,2,12,12,782,740,1522,1462
0132-000,2014,2,12,13,676,762,1438,1522
0132-000,2014,2,12,14,734,773,1507,1438
0132-000,2014,2,12,15,800,815,1615,1507
0132-000,2014,2,12,16,894,729,1623,1615
0132-000,2014,2,12,17,843,756,1599,1623
0132-000,2014,2,12,18,1031,772,1803,1599
0132-000,2014,2,12,19,1162,755,1917,1803
0132-000,2014,2,12,20,718,571,1289,1917
0132-000,2014,2,12,21,648,457,1105,1289
0132-000,2014,2,12,22,500,387,887,1105
0132-000,2014,2,12,23,312,296,608,887
0132-000,2014,2,12,24,203,187,390,608
0132-000,2014,2,13,1,138,159,297,390
0132-000,2014,2,13,2,107,117,224,297
0132-000,2014,2,13,3,72,88,160,224
0132-000,2014,2,13,4,62,83,145,160
0132-000,2014,2,13,5,87,97,184,145
0132-000,2014,2,13,6,113,111,224,184
0132-000,2014,2,13,7,315,335,650,224
0132-000,2014,2,13,8,560,1413,1973,650
0132-000,2014,2,13,9,782,1111,1893,1973
0132-000,2014,2,13,10,682,1053,1735,1893
0132-000,2014,2,13,11,726,754,1480,1735
0132-000,2014,2,13,12,852,758,1610,1480
0132-000,2014,2,13,13,1152,771,1923,1610
0132-000,2014,2,13,14,1099,822,1921,1923
0132-000,2014,2,13,15,899,753,1652,1921
0132-000,2014,2,13,16,879,787,1666,1652
0132-000,2014,2,13,17,900,755,1655,1666
0132-000,2014,2,13,18,1053,774,1827,1655
0132-000,2014,2,13,19,1167,775,1942,1827
0132-000,2014,2,13,20,769,612,1381,1942
0132-000,2014,2,13,21,705,483,1188,1381
0132-000,2014,2,13,22,551,458,1009,1188
0132-000,2014,2,13,23,331,287,618,1009
0132-000,2014,2,13,24,198,189,387,618
0132-000,2014,2,14,1,142,144,286,387
0132-000,2014,2,14,2,99,102,201,286
0132-000,2014,2,14,3,105,112,217,201
0132-000,2014,2,14,4,61,84,145,217
0132-000,2014,2,14,5,84,99,183,145
0132-000,2014,2,14,6,100,100,200,183
0132-000,2014,2,14,7,325,333,658,200
0132-000,2014,2,14,8,557,1374,1931,658
0132-000,2014,2,14,9,801,1112,1913,1931
0132-000,2014,2,14,10,744,850,1594,1913
0132-000,2014,2,14,11,789,871,1660,1594
0132-000,2014,2,14,12,703,838,1541,1660
0132-000,2014,2,14,13,796,748,1544,1541
0132-000,2014,2,14,14,841,816,1657,1544
0132-000,2014,2,14,15,917,850,1767,1657
0132-000,2014,2,14,16,925,792,1717,1767
0132-000,2014,2,14,17,958,838,1796,1717
0132-000,2014,2,14,18,1177,855,2032,1796
0132-000,2014,2,14,19,1338,865,2203,2032
0132-000,2014,2,14,20,836,668,1504,2203
0132-000,2014,2,14,21,742,555,1297,1504
0132-000,2014,2,14,22,569,508,1077,1297
0132-000,2014,2,14,23,378,460,838,1077
0132-000,2014,2,14,24,268,236,504,838
0132-000,2014,2,15,1,184,203,387,504
0132-000,2014,2,15,2,128,144,272,387
0132-000,2014,2,15,3,101,123,224,272
0132-000,2014,2,15,4,87,100,187,224
0132-000,2014,2,15,5,92,88,180,187
0132-000,2014,2,15,6,143,109,252,180
0132-000,2014,2,15,7,252,259,511,252
0132-000,2014,2,15,8,390,686,1076,511
0132-000,2014,2,15,9,605,776,1381,1076
0132-000,2014,2,15,10,672,778,1450,1381
0132-000,2014,2,15,11,726,860,1586,1450
0132-000,2014,2,15,12,738,1006,1744,1586
0132-000,2014,2,15,13,780,1031,1811,1744
0132-000,2014,2,15,14,830,874,1704,1811
0132-000,2014,2,15,15,730,809,1539,1704
0132-000,2014,2,15,16,919,793,1712,1539
0132-000,2014,2,15,17,930,785,1715,1712
0132-000,2014,2,15,18,1230,875,2105,1715
0132-000,2014,2,15,19,1098,737,1835,2105
0132-000,2014,2,15,20,658,565,1223,1835
0132-000,2014,2,15,21,508,468,976,1223
0132-000,2014,2,15,22,442,390,832,976
0132-000,2014,2,15,23,269,324,593,832
0132-000,2014,2,15,24,182,206,388,593
0132-000,2014,2,16,1,151,158,309,388
0132-000,2014,2,16,2,131,159,290,309
0132-000,2014,2,16,3,98,121,219,290
0132-000,2014,2,16,4,58,65,123,219
0132-000,2014,2,16,5,79,79,158,123
0132-000,2014,2,16,6,89,90,179,158
0132-000,2014,2,16,7,169,148,317,179
0132-000,2014,2,16,8,231,311,542,317
0132-000,2014,2,16,9,261,393,654,542
0132-000,2014,2,16,10,394,480,874,654
0132-000,2014,2,16,11,500,583,1083,874
0132-000,2014,2,16,12,593,583,1176,1083
0132-000,2014,2,16,13,572,653,1225,1176
0132-000,2014,2,16,14,764,648,1412,1225
0132-000,2014,2,16,15,715,657,1372,1412
0132-000,2014,2,16,16,799,649,1448,1372
0132-000,2014,2,16,17,879,664,1543,1448
0132-000,2014,2,16,18,877,583,1460,1543
0132-000,2014,2,16,19,879,522,1401,1460
0132-000,2014,2,16,20,564,475,1039,1401
0132-000,2014,2,16,21,454,348,802,1039
0132-000,2014,2,16,22,404,379,783,802
0132-000,2014,2,16,23,256,258,514,783
0132-000,2014,2,16,24,162,169,331,514
0132-000,2014,2,17,1,116,141,257,331
0132-000,2014,2,17,2,70,68,138,257
0132-000,2014,2,17,3,38,58,96,138
0132-000,2014,2,17,4,47,63,110,96
0132-000,2014,2,17,5,64,78,142,110
0132-000,2014,2,17,6,143,140,283,142
0132-000,2014,2,17,7,385,407,792,283
0132-000,2014,2,17,8,608,1713,2321,792
0132-000,2014,2,17,9,775,1131,1906,2321
0132-000,2014,2,17,10,667,821,1488,1906
0132-000,2014,2,17,11,736,792,1528,1488
0132-000,2014,2,17,12,709,779,1488,1528
0132-000,2014,2,17,13,708,784,1492,1488
0132-000,2014,2,17,14,786,782,1568,1492
0132-000,2014,2,17,15,856,820,1676,1568
0132-000,2014,2,17,16,793,800,1593,1676
0132-000,2014,2,17,17,873,764,1637,1593
0132-000,2014,2,17,18,1016,783,1799,1637
0132-000,2014,2,17,19,1081,786,1867,1799
0132-000,2014,2,17,20,817,545,1362,1867
0132-000,2014,2,17,21,669,450,1119,1362
0132-000,2014,2,17,22,532,383,915,1119
0132-000,2014,2,17,23,274,275,549,915
0132-000,2014,2,17,24,179,166,345,549
0132-000,2014,2,18,1,132,149,281,345
0132-000,2014,2,18,2,78,91,169,281
0132-000,2014,2,18,3,75,79,154,169
0132-000,2014,2,18,4,66,76,142,154
0132-000,2014,2,18,5,72,75,147,142
0132-000,2014,2,18,6,122,122,244,147
0132-000,2014,2,18,7,314,356,670,244
0132-000,2014,2,18,8,597,1440,2037,670
0132-000,2014,2,18,9,783,1141,1924,2037
0132-000,2014,2,18,10,735,822,1557,1924
0132-000,2014,2,18,11,741,780,1521,1557
0132-000,2014,2,18,12,787,797,1584,1521
0132-000,2014,2,18,13,682,687,1369,1584
0132-000,2014,2,18,14,820,788,1608,1369
0132-000,2014,2,18,15,878,823,1701,1608
0132-000,2014,2,18,16,869,749,1618,1701
0132-000,2014,2,18,17,782,719,1501,1618
0132-000,2014,2,18,18,986,808,1794,1501
0132-000,2014,2,18,19,1101,760,1861,1794
0132-000,2014,2,18,20,798,593,1391,1861
0132-000,2014,2,18,21,657,469,1126,1391
0132-000,2014,2,18,22,543,401,944,1126
0132-000,2014,2,18,23,274,251,525,944
0132-000,2014,2,18,24,195,158,353,525
0132-000,2014,2,19,1,134,124,258,353
0132-000,2014,2,19,2,104,97,201,258
0132-000,2014,2,19,3,64,94,158,201
0132-000,2014,2,19,4,63,88,151,158
0132-000,2014,2,19,5,103,88,191,151
0132-000,2014,2,19,6,128,122,250,191
0132-000,2014,2,19,7,296,349,645,250
0132-000,2014,2,19,8,612,1469,2081,645
0132-000,2014,2,19,9,772,1063,1835,2081
0132-000,2014,2,19,10,676,811,1487,1835
0132-000,2014,2,19,11,721,772,1493,1487
0132-000,2014,2,19,12,743,760,1503,1493
0132-000,2014,2,19,13,690,695,1385,1503
0132-000,2014,2,19,14,775,734,1509,1385
0132-000,2014,2,19,15,798,880,1678,1509
0132-000,2014,2,19,16,798,752,1550,1678
0132-000,2014,2,19,17,806,726,1532,1550
0132-000,2014,2,19,18,1042,747,1789,1532
0132-000,2014,2,19,19,1191,831,2022,1789
0132-000,2014,2,19,20,758,581,1339,2022
0132-000,2014,2,19,21,629,400,1029,1339
0132-000,2014,2,19,22,505,369,874,1029
0132-000,2014,2,19,23,316,260,576,874
0132-000,2014,2,19,24,203,185,388,576
0132-000,2014,2,20,1,124,151,275,388
0132-000,2014,2,20,2,99,109,208,275
0132-000,2014,2,20,3,71,80,151,208
0132-000,2014,2,20,4,57,77,134,151
0132-000,2014,2,20,5,70,72,142,134
0132-000,2014,2,20,6,95,102,197,142
0132-000,2014,2,20,7,310,357,667,197
0132-000,2014,2,20,8,598,1406,2004,667
0132-000,2014,2,20,9,807,1095,1902,2004
0132-000,2014,2,20,10,700,814,1514,1902
0132-000,2014,2,20,11,750,765,1515,1514
0132-000,2014,2,20,12,700,800,1500,1515
0132-000,2014,2,20,13,712,717,1429,1500
0132-000,2014,2,20,14,764,767,1531,1429
0132-000,2014,2,20,15,812,823,1635,1531
0132-000,2014,2,20,16,953,746,1699,1635
0132-000,2014,2,20,17,846,739,1585,1699
0132-000,2014,2,20,18,985,792,1777,1585
0132-000,2014,2,20,19,1177,834,2011,1777
0132-000,2014,2,20,20,807,567,1374,2011
0132-000,2014,2,20,21,710,474,1184,1374
0132-000,2014,2,20,22,521,409,930,1184
0132-000,2014,2,20,23,305,253,558,930
0132-000,2014,2,20,24,199,200,399,558
0132-000,2014,2,21,1,143,175,318,399
0132-000,2014,2,21,2,95,88,183,318
0132-000,2014,2,21,3,72,99,171,183
0132-000,2014,2,21,4,54,78,132,171
0132-000,2014,2,21,5,80,94,174,132
0132-000,2014,2,21,6,102,124,226,174
0132-000,2014,2,21,7,326,362,688,226
0132-000,2014,2,21,8,570,1399,1969,688
0132-000,2014,2,21,9,760,1135,1895,1969
0132-000,2014,2,21,10,695,819,1514,1895
0132-000,2014,2,21,11,785,856,1641,1514
0132-000,2014,2,21,12,782,814,1596,1641
0132-000,2014,2,21,13,770,748,1518,1596
0132-000,2014,2,21,14,836,791,1627,1518
0132-000,2014,2,21,15,919,830,1749,1627
0132-000,2014,2,21,16,912,844,1756,1749
0132-000,2014,2,21,17,945,863,1808,1756
0132-000,2014,2,21,18,1147,809,1956,1808
0132-000,2014,2,21,19,1377,855,2232,1956
0132-000,2014,2,21,20,902,683,1585,2232
0132-000,2014,2,21,21,762,486,1248,1585
0132-000,2014,2,21,22,558,483,1041,1248
0132-000,2014,2,21,23,386,321,707,1041
0132-000,2014,2,21,24,239,248,487,707
0132-000,2014,2,22,1,167,195,362,487
0132-000,2014,2,22,2,140,120,260,362
0132-000,2014,2,22,3,98,107,205,260
0132-000,2014,2,22,4,79,125,204,205
0132-000,2014,2,22,5,105,99,204,204
0132-000,2014,2,22,6,125,118,243,204
0132-000,2014,2,22,7,231,252,483,243
0132-000,2014,2,22,8,456,720,1176,483
0132-000,2014,2,22,9,619,719,1338,1176
0132-000,2014,2,22,10,706,897,1603,1338
0132-000,2014,2,22,11,736,1042,1778,1603
0132-000,2014,2,22,12,815,1132,1947,1778
0132-000,2014,2,22,13,800,1070,1870,1947
0132-000,2014,2,22,14,890,1061,1951,1870
0132-000,2014,2,22,15,870,939,1809,1951
0132-000,2014,2,22,16,884,823,1707,1809
0132-000,2014,2,22,17,1017,852,1869,1707
0132-000,2014,2,22,18,1232,840,2072,1869
0132-000,2014,2,22,19,1145,810,1955,2072
0132-000,2014,2,22,20,766,584,1350,1955
0132-000,2014,2,22,21,518,461,979,1350
0132-000,2014,2,22,22,458,385,843,979
0132-000,2014,2,22,23,310,280,590,843
0132-000,2014,2,22,24,195,204,399,590
0132-000,2014,2,23,1,160,163,323,399
0132-000,2014,2,23,2,107,133,240,323
0132-000,2014,2,23,3,95,108,203,240
0132-000,2014,2,23,4,86,86,172,203
0132-000,2014,2,23,5,77,69,146,172
0132-000,2014,2,23,6,95,101,196,146
0132-000,2014,2,23,7,169,128,297,196
0132-000,2014,2,23,8,219,280,499,297
0132-000,2014,2,23,9,311,370,681,499
0132-000,2014,2,23,10,416,519,935,681
0132-000,2014,2,23,11,492,655,1147,935
0132-000,2014,2,23,12,513,667,1180,1147
0132-000,2014,2,23,13,597,610,1207,1180
0132-000,2014,2,23,14,676,613,1289,1207
0132-000,2014,2,23,15,811,561,1372,1289
0132-000,2014,2,23,16,884,659,1543,1372
0132-000,2014,2,23,17,947,735,1682,1543
0132-000,2014,2,23,18,1064,702,1766,1682
0132-000,2014,2,23,19,983,595,1578,1766
0132-000,2014,2,23,20,695,487,1182,1578
0132-000,2014,2,23,21,523,399,922,1182
0132-000,2014,2,23,22,419,343,762,922
0132-000,2014,2,23,23,240,237,477,762
0132-000,2014,2,23,24,151,179,330,477
0132-000,2014,2,24,1,102,123,225,330
0132-000,2014,2,24,2,82,58,140,225
0132-000,2014,2,24,3,43,68,111,140
0132-000,2014,2,24,4,48,63,111,111
0132-000,2014,2,24,5,71,78,149,111
0132-000,2014,2,24,6,129,132,261,149
0132-000,2014,2,24,7,367,476,843,261
0132-000,2014,2,24,8,636,1626,2262,843
0132-000,2014,2,24,9,768,1145,1913,2262
0132-000,2014,2,24,10,653,851,1504,1913
0132-000,2014,2,24,11,837,782,1619,1504
0132-000,2014,2,24,12,721,819,1540,1619
0132-000,2014,2,24,13,734,739,1473,1540
0132-000,2014,2,24,14,786,811,1597,1473
0132-000,2014,2,24,15,845,834,1679,1597
0132-000,2014,2,24,16,888,780,1668,1679
0132-000,2014,2,24,17,860,823,1683,1668
0132-000,2014,2,24,18,1001,845,1846,1683
0132-000,2014,2,24,19,1153,811,1964,1846
0132-000,2014,2,24,20,766,560,1326,1964
0132-000,2014,2,24,21,692,473,1165,1326
0132-000,2014,2,24,22,538,375,913,1165
0132-000,2014,2,24,23,308,278,586,913
0132-000,2014,2,24,24,194,183,377,586
0132-000,2014,2,25,1,118,128,246,377
0132-000,2014,2,25,2,100,83,183,246
0132-000,2014,2,25,3,63,87,150,183
0132-000,2014,2,25,4,51,75,126,150
0132-000,2014,2,25,5,74,82,156,126
0132-000,2014,2,25,6,116,112,228,156
0132-000,2014,2,25,7,321,387,708,228
0132-000,2014,2,25,8,637,1499,2136,708
0132-000,2014,2,25,9,760,1139,1899,2136
0132-000,2014,2,25,10,766,814,1580,1899
0132-000,2014,2,25,11,720,862,1582,1580
0132-000,2014,2,25,12,841,770,1611,1582
0132-000,2014,2,25,13,726,786,1512,1611
0132-000,2014,2,25,14,832,835,1667,1512
0132-000,2014,2,25,15,859,827,1686,1667
0132-000,2014,2,25,16,918,795,1713,1686
0132-000,2014,2,25,17,895,824,1719,1713
0132-000,2014,2,25,18,1039,825,1864,1719
0132-000,2014,2,25,19,1135,740,1875,1864
0132-000,2014,2,25,20,844,595,1439,1875
0132-000,2014,2,25,21,723,523,1246,1439
0132-000,2014,2,25,22,527,391,918,1246
0132-000,2014,2,25,23,339,285,624,918
0132-000,2014,2,25,24,220,201,421,624
0132-000,2014,2,26,1,152,154,306,421
0132-000,2014,2,26,2,98,107,205,306
0132-000,2014,2,26,3,87,107,194,205
0132-000,2014,2,26,4,63,76,139,194
0132-000,2014,2,26,5,82,87,169,139
0132-000,2014,2,26,6,133,125,258,169
0132-000,2014,2,26,7,325,374,699,258
0132-000,2014,2,26,8,625,1510,2135,699
0132-000,2014,2,26,9,792,1148,1940,2135
0132-000,2014,2,26,10,726,823,1549,1940
0132-000,2014,2,26,11,774,790,1564,1549
0132-000,2014,2,26,12,773,800,1573,1564
0132-000,2014,2,26,13,709,745,1454,1573
0132-000,2014,2,26,14,818,808,1626,1454
0132-000,2014,2,26,15,922,886,1808,1626
0132-000,2014,2,26,16,852,762,1614,1808
0132-000,2014,2,26,17,871,830,1701,1614
0132-000,2014,2,26,18,1068,786,1854,1701
0132-000,2014,2,26,19,1251,809,2060,1854
0132-000,2014,2,26,20,821,628,1449,2060
0132-000,2014,2,26,21,663,479,1142,1449
0132-000,2014,2,26,22,578,439,1017,1142
0132-000,2014,2,26,23,314,290,604,1017
0132-000,2014,2,26,24,231,207,438,604
0132-000,2014,2,27,1,164,177,341,438
0132-000,2014,2,27,2,98,101,199,341
0132-000,2014,2,27,3,81,89,170,199
0132-000,2014,2,27,4,56,84,140,170
0132-000,2014,2,27,5,82,82,164,140
0132-000,2014,2,27,6,124,143,267,164
0132-000,2014,2,27,7,319,356,675,267
0132-000,2014,2,27,8,632,1450,2082,675
0132-000,2014,2,27,9,838,1143,1981,2082
0132-000,2014,2,27,10,760,835,1595,1981
0132-000,2014,2,27,11,751,776,1527,1595
0132-000,2014,2,27,12,799,886,1685,1527
0132-000,2014,2,27,13,732,711,1443,1685
0132-000,2014,2,27,14,843,804,1647,1443
0132-000,2014,2,27,15,881,803,1684,1647
0132-000,2014,2,27,16,880,859,1739,1684
0132-000,2014,2,27,17,908,797,1705,1739
0132-000,2014,2,27,18,1048,849,1897,1705
0132-000,2014,2,27,19,1132,811,1943,1897
0132-000,2014,2,27,20,810,605,1415,1943
0132-000,2014,2,27,21,691,499,1190,1415
0132-000,2014,2,27,22,643,488,1131,1190
0132-000,2014,2,27,23,445,364,809,1131
0132-000,2014,2,27,24,337,275,612,809
0132-000,2014,2,28,1,201,189,390,612
0132-000,2014,2,28,2,115,115,230,390
0132-000,2014,2,28,3,82,100,182,230
0132-000,2014,2,28,4,68,85,153,182
0132-000,2014,2,28,5,100,90,190,153
0132-000,2014,2,28,6,130,106,236,190
0132-000,2014,2,28,7,374,361,735,236
0132-000,2014,2,28,8,627,1428,2055,735
0132-000,2014,2,28,9,785,1177,1962,2055
0132-000,2014,2,28,10,725,847,1572,1962
0132-000,2014,2,28,11,765,937,1702,1572
0132-000,2014,2,28,12,809,862,1671,1702
0132-000,2014,2,28,13,748,762,1510,1671
0132-000,2014,2,28,14,876,802,1678,1510
0132-000,2014,2,28,15,888,907,1795,1678
0132-000,2014,2,28,16,949,853,1802,1795
0132-000,2014,2,28,17,981,846,1827,1802
0132-000,2014,2,28,18,1207,824,2031,1827
0132-000,2014,2,28,19,1476,909,2385,2031
0132-000,2014,2,28,20,964,714,1678,2385
0132-000,2014,2,28,21,839,602,1441,1678
0132-000,2014,2,28,22,584,529,1113,1441
0132-000,2014,2,28,23,383,382,765,1113
0132-000,2014,2,28,24,267,260,527,765
0132-000,2014,3,1,1,243,204,447,527
0132-000,2014,3,1,2,139,133,272,447
0132-000,2014,3,1,3,107,118,225,272
0132-000,2014,3,1,4,100,99,199,225
0132-000,2014,3,1,5,99,112,211,199
0132-000,2014,3,1,6,137,146,283,211
0132-000,2014,3,1,7,279,273,552,283
0132-000,2014,3,1,8,411,652,1063,552
0132-000,2014,3,1,9,606,734,1340,1063
0132-000,2014,3,1,10,636,828,1464,1340
0132-000,2014,3,1,11,695,1079,1774,1464
0132-000,2014,3,1,12,847,1230,2077,1774
0132-000,2014,3,1,13,770,1220,1990,2077
0132-000,2014,3,1,14,871,1168,2039,1990
0132-000,2014,3,1,15,954,1086,2040,2039
0132-000,2014,3,1,16,942,1052,1994,2040
0132-000,2014,3,1,17,1141,930,2071,1994
0132-000,2014,3,1,18,1388,934,2322,2071
0132-000,2014,3,1,19,1356,798,2154,2322
0132-000,2014,3,1,20,1035,583,1618,2154
0132-000,2014,3,1,21,795,478,1273,1618
0132-000,2014,3,1,22,543,394,937,1273
0132-000,2014,3,1,23,304,297,601,937
0132-000,2014,3,1,24,220,227,447,601
0132-000,2014,3,2,1,166,177,343,447
0132-000,2014,3,2,2,104,121,225,343
0132-000,2014,3,2,3,93,114,207,225
0132-000,2014,3,2,4,75,76,151,207
0132-000,2014,3,2,5,84,73,157,151
0132-000,2014,3,2,6,103,82,185,157
0132-000,2014,3,2,7,199,160,359,185
0132-000,2014,3,2,8,244,297,541,359
0132-000,2014,3,2,9,335,428,763,541
0132-000,2014,3,2,10,435,546,981,763
0132-000,2014,3,2,11,552,629,1181,981
0132-000,2014,3,2,12,591,713,1304,1181
0132-000,2014,3,2,13,646,867,1513,1304
0132-000,2014,3,2,14,839,826,1665,1513
0132-000,2014,3,2,15,1047,780,1827,1665
0132-000,2014,3,2,16,1219,822,2041,1827
0132-000,2014,3,2,17,1380,806,2186,2041
0132-000,2014,3,2,18,1451,808,2259,2186
0132-000,2014,3,2,19,1438,680,2118,2259
0132-000,2014,3,2,20,1266,581,1847,2118
0132-000,2014,3,2,21,1177,482,1659,1847
0132-000,2014,3,2,22,987,379,1366,1659
0132-000,2014,3,2,23,476,266,742,1366
0132-000,2014,3,2,24,179,151,330,742
0132-000,2014,3,3,1,113,114,227,330
0132-000,2014,3,3,2,74,69,143,227
0132-000,2014,3,3,3,45,60,105,143
0132-000,2014,3,3,4,53,55,108,105
0132-000,2014,3,3,5,78,89,167,108
0132-000,2014,3,3,6,140,126,266,167
0132-000,2014,3,3,7,433,456,889,266
0132-000,2014,3,3,8,649,1678,2327,889
0132-000,2014,3,3,9,764,1219,1983,2327
0132-000,2014,3,3,10,715,835,1550,1983
0132-000,2014,3,3,11,730,805,1535,1550
0132-000,2014,3,3,12,790,818,1608,1535
0132-000,2014,3,3,13,700,758,1458,1608
0132-000,2014,3,3,14,810,781,1591,1458
0132-000,2014,3,3,15,870,807,1677,1591
0132-000,2014,3,3,16,888,843,1731,1677
0132-000,2014,3,3,17,894,762,1656,1731
0132-000,2014,3,3,18,996,829,1825,1656
0132-000,2014,3,3,19,1191,891,2082,1825
0132-000,2014,3,3,20,845,630,1475,2082
0132-000,2014,3,3,21,717,481,1198,1475
0132-000,2014,3,3,22,554,395,949,1198
0132-000,2014,3,3,23,312,299,611,949
0132-000,2014,3,3,24,217,200,417,611
0132-000,2014,3,4,1,136,138,274,417
0132-000,2014,3,4,2,81,93,174,274
0132-000,2014,3,4,3,66,79,145,174
0132-000,2014,3,4,4,71,76,147,145
0132-000,2014,3,4,5,83,89,172,147
0132-000,2014,3,4,6,142,115,257,172
0132-000,2014,3,4,7,334,388,722,257
0132-000,2014,3,4,8,658,1542,2200,722
0132-000,2014,3,4,9,784,1252,2036,2200
0132-000,2014,3,4,10,723,837,1560,2036
0132-000,2014,3,4,11,732,835,1567,1560
0132-000,2014,3,4,12,732,773,1505,1567
0132-000,2014,3,4,13,704,673,1377,1505
0132-000,2014,3,4,14,777,750,1527,1377
0132-000,2014,3,4,15,858,867,1725,1527
0132-000,2014,3,4,16,949,817,1766,1725
0132-000,2014,3,4,17,880,777,1657,1766
0132-000,2014,3,4,18,1065,841,1906,1657
0132-000,2014,3,4,19,1113,818,1931,1906
0132-000,2014,3,4,20,823,604,1427,1931
0132-000,2014,3,4,21,739,505,1244,1427
0132-000,2014,3,4,22,561,380,941,1244
0132-000,2014,3,4,23,339,311,650,941
0132-000,2014,3,4,24,217,159,376,650
0132-000,2014,3,5,1,130,143,273,376
0132-000,2014,3,5,2,105,86,191,273
0132-000,2014,3,5,3,62,78,140,191
0132-000,2014,3,5,4,57,71,128,140
0132-000,2014,3,5,5,80,92,172,128
0132-000,2014,3,5,6,141,105,246,172
0132-000,2014,3,5,7,341,381,722,246
0132-000,2014,3,5,8,633,1605,2238,722
0132-000,2014,3,5,9,849,1245,2094,2238
0132-000,2014,3,5,10,726,826,1552,2094
0132-000,2014,3,5,11,724,786,1510,1552
0132-000,2014,3,5,12,798,785,1583,1510
0132-000,2014,3,5,13,684,749,1433,1583
0132-000,2014,3,5,14,779,769,1548,1433
0132-000,2014,3,5,15,842,826,1668,1548
0132-000,2014,3,5,16,902,772,1674,1668
0132-000,2014,3,5,17,890,775,1665,1674
0132-000,2014,3,5,18,1159,831,1990,1665
0132-000,2014,3,5,19,1239,844,2083,1990
0132-000,2014,3,5,20,844,649,1493,2083
0132-000,2014,3,5,21,654,452,1106,1493
0132-000,2014,3,5,22,487,441,928,1106
0132-000,2014,3,5,23,347,312,659,928
0132-000,2014,3,5,24,217,195,412,659
0132-000,2014,3,6,1,137,151,288,412
0132-000,2014,3,6,2,112,96,208,288
0132-000,2014,3,6,3,79,94,173,208
0132-000,2014,3,6,4,52,87,139,173
0132-000,2014,3,6,5,82,82,164,139
0132-000,2014,3,6,6,112,104,216,164
0132-000,2014,3,6,7,342,395,737,216
0132-000,2014,3,6,8,662,1538,2200,737
0132-000,2014,3,6,9,813,1286,2099,2200
0132-000,2014,3,6,10,717,868,1585,2099
0132-000,2014,3,6,11,750,771,1521,1585
0132-000,2014,3,6,12,794,772,1566,1521
0132-000,2014,3,6,13,677,692,1369,1566
0132-000,2014,3,6,14,827,826,1653,1369
0132-000,2014,3,6,15,877,843,1720,1653
0132-000,2014,3,6,16,927,763,1690,1720
0132-000,2014,3,6,17,874,756,1630,1690
0132-000,2014,3,6,18,1106,803,1909,1630
0132-000,2014,3,6,19,1100,813,1913,1909
0132-000,2014,3,6,20,821,622,1443,1913
0132-000,2014,3,6,21,713,466,1179,1443
0132-000,2014,3,6,22,588,390,978,1179
0132-000,2014,3,6,23,389,331,720,978
0132-000,2014,3,6,24,219,183,402,720
0132-000,2014,3,7,1,133,164,297,402
0132-000,2014,3,7,2,108,114,222,297
0132-000,2014,3,7,3,81,91,172,222
0132-000,2014,3,7,4,101,105,206,172
0132-000,2014,3,7,5,84,114,198,206
0132-000,2014,3,7,6,138,103,241,198
0132-000,2014,3,7,7,368,381,749,241
0132-000,2014,3,7,8,659,1455,2114,749
0132-000,2014,3,7,9,804,1218,2022,2114
0132-000,2014,3,7,10,724,814,1538,2022
0132-000,2014,3,7,11,755,835,1590,1538
0132-000,2014,3,7,12,743,827,1570,1590
0132-000,2014,3,7,13,729,716,1445,1570
0132-000,2014,3,7,14,766,789,1555,1445
0132-000,2014,3,7,15,870,807,1677,1555
0132-000,2014,3,7,16,882,786,1668,1677
0132-000,2014,3,7,17,950,828,1778,1668
0132-000,2014,3,7,18,1113,887,2000,1778
0132-000,2014,3,7,19,1423,864,2287,2000
0132-000,2014,3,7,20,942,696,1638,2287
0132-000,2014,3,7,21,817,508,1325,1638
0132-000,2014,3,7,22,556,438,994,1325
0132-000,2014,3,7,23,389,340,729,994
0132-000,2014,3,7,24,206,245,451,729
0132-000,2014,3,8,1,204,189,393,451
0132-000,2014,3,8,2,152,145,297,393
0132-000,2014,3,8,3,107,122,229,297
0132-000,2014,3,8,4,106,119,225,229
0132-000,2014,3,8,5,101,100,201,225
0132-000,2014,3,8,6,121,127,248,201
0132-000,2014,3,8,7,291,282,573,248
0132-000,2014,3,8,8,451,769,1220,573
0132-000,2014,3,8,9,611,837,1448,1220
0132-000,2014,3,8,10,754,847,1601,1448
0132-000,2014,3,8,11,807,874,1681,1601
0132-000,2014,3,8,12,880,995,1875,1681
0132-000,2014,3,8,13,868,933,1801,1875
0132-000,2014,3,8,14,887,835,1722,1801
0132-000,2014,3,8,15,857,895,1752,1722
0132-000,2014,3,8,16,940,848,1788,1752
0132-000,2014,3,8,17,978,848,1826,1788
0132-000,2014,3,8,18,1131,822,1953,1826
0132-000,2014,3,8,19,996,780,1776,1953
0132-000,2014,3,8,20,678,586,1264,1776
0132-000,2014,3,8,21,501,456,957,1264
0132-000,2014,3,8,22,419,415,834,957
0132-000,2014,3,8,23,279,288,567,834
0132-000,2014,3,8,24,208,221,429,567
0132-000,2014,3,9,1,173,170,343,429
0132-000,2014,3,9,2,129,148,277,343
0132-000,2014,3,9,3,103,101,204,277
0132-000,2014,3,9,4,96,76,172,204
0132-000,2014,3,9,5,86,84,170,172
0132-000,2014,3,9,6,123,97,220,170
0132-000,2014,3,9,7,164,139,303,220
0132-000,2014,3,9,8,213,260,473,303
0132-000,2014,3,9,9,308,361,669,473
0132-000,2014,3,9,10,403,484,887,669
0132-000,2014,3,9,11,534,570,1104,887
0132-000,2014,3,9,12,541,607,1148,1104
0132-000,2014,3,9,13,653,617,1270,1148
0132-000,2014,3,9,14,700,652,1352,1270
0132-000,2014,3,9,15,787,666,1453,1352
0132-000,2014,3,9,16,834,681,1515,1453
0132-000,2014,3,9,17,938,685,1623,1515
0132-000,2014,3,9,18,918,670,1588,1623
0132-000,2014,3,9,19,864,609,1473,1588
0132-000,2014,3,9,20,620,534,1154,1473
0132-000,2014,3,9,21,498,473,971,1154
0132-000,2014,3,9,22,428,368,796,971
0132-000,2014,3,9,23,258,240,498,796
0132-000,2014,3,9,24,157,137,294,498
0132-000,2014,3,10,1,98,118,216,294
0132-000,2014,3,10,2,57,86,143,216
0132-000,2014,3,10,3,43,43,86,143
0132-000,2014,3,10,4,47,59,106,86
0132-000,2014,3,10,5,61,77,138,106
0132-000,2014,3,10,6,162,153,315,138
0132-000,2014,3,10,7,414,489,903,315
0132-000,2014,3,10,8,699,1728,2427,903
0132-000,2014,3,10,9,814,1233,2047,2427
0132-000,2014,3,10,10,699,824,1523,2047
0132-000,2014,3,10,11,798,794,1592,1523
0132-000,2014,3,10,12,779,820,1599,1592
0132-000,2014,3,10,13,765,759,1524,1599
0132-000,2014,3,10,14,822,834,1656,1524
0132-000,2014,3,10,15,850,875,1725,1656
0132-000,2014,3,10,16,899,802,1701,1725
0132-000,2014,3,10,17,869,767,1636,1701
0132-000,2014,3,10,18,1071,822,1893,1636
0132-000,2014,3,10,19,1172,872,2044,1893
0132-000,2014,3,10,20,855,667,1522,2044
0132-000,2014,3,10,21,699,534,1233,1522
0132-000,2014,3,10,22,577,421,998,1233
0132-000,2014,3,10,23,337,284,621,998
0132-000,2014,3,10,24,191,188,379,621
0132-000,2014,3,11,1,152,152,304,379
0132-000,2014,3,11,2,81,79,160,304
0132-000,2014,3,11,3,79,86,165,160
0132-000,2014,3,11,4,57,70,127,165
0132-000,2014,3,11,5,91,113,204,127
0132-000,2014,3,11,6,153,119,272,204
0132-000,2014,3,11,7,384,434,818,272
0132-000,2014,3,11,8,682,1579,2261,818
0132-000,2014,3,11,9,792,1257,2049,2261
0132-000,2014,3,11,10,762,888,1650,2049
0132-000,2014,3,11,11,765,821,1586,1650
0132-000,2014,3,11,12,735,835,1570,1586
0132-000,2014,3,11,13,741,700,1441,1570
0132-000,2014,3,11,14,849,764,1613,1441
0132-000,2014,3,11,15,847,912,1759,1613
0132-000,2014,3,11,16,856,828,1684,1759
0132-000,2014,3,11,17,877,767,1644,1684
0132-000,2014,3,11,18,1078,872,1950,1644
0132-000,2014,3,11,19,1184,790,1974,1950
0132-000,2014,3,11,20,885,644,1529,1974
0132-000,2014,3,11,21,707,489,1196,1529
0132-000,2014,3,11,22,625,447,1072,1196
0132-000,2014,3,11,23,321,298,619,1072
0132-000,2014,3,11,24,207,179,386,619
0132-000,2014,3,12,1,187,186,373,386
0132-000,2014,3,12,2,118,113,231,373
0132-000,2014,3,12,3,81,93,174,231
0132-000,2014,3,12,4,55,68,123,174
0132-000,2014,3,12,5,96,97,193,123
0132-000,2014,3,12,6,150,133,283,193
0132-000,2014,3,12,7,385,409,794,283
0132-000,2014,3,12,8,671,1512,2183,794
0132-000,2014,3,12,9,828,1246,2074,2183
0132-000,2014,3,12,10,795,848,1643,2074
0132-000,2014,3,12,11,697,847,1544,1643
0132-000,2014,3,12,12,785,757,1542,1544
0132-000,2014,3,12,13,677,800,1477,1542
0132-000,2014,3,12,14,772,750,1522,1477
0132-000,2014,3,12,15,823,794,1617,1522
0132-000,2014,3,12,16,830,747,1577,1617
0132-000,2014,3,12,17,862,719,1581,1577
0132-000,2014,3,12,18,1102,763,1865,1581
0132-000,2014,3,12,19,1120,746,1866,1865
0132-000,2014,3,12,20,856,625,1481,1866
0132-000,2014,3,12,21,650,428,1078,1481
0132-000,2014,3,12,22,530,411,941,1078
0132-000,2014,3,12,23,348,281,629,941
0132-000,2014,3,12,24,213,165,378,629
0132-000,2014,3,13,1,152,154,306,378
0132-000,2014,3,13,2,99,89,188,306
0132-000,2014,3,13,3,83,105,188,188
0132-000,2014,3,13,4,69,93,162,188
0132-000,2014,3,13,5,92,89,181,162
0132-000,2014,3,13,6,133,134,267,181
0132-000,2014,3,13,7,344,379,723,267
0132-000,2014,3,13,8,634,1506,2140,723
0132-000,2014,3,13,9,772,1209,1981,2140
0132-000,2014,3,13,10,721,851,1572,1981
0132-000,2014,3,13,11,745,795,1540,1572
0132-000,2014,3,13,12,733,849,1582,1540
0132-000,2014,3,13,13,680,705,1385,1582
0132-000,2014,3,13,14,820,808,1628,1385
0132-000,2014,3,13,15,838,826,1664,1628
0132-000,2014,3,13,16,865,786,1651,1664
0132-000,2014,3,13,17,881,744,1625,1651
0132-000,2014,3,13,18,1049,788,1837,1625
0132-000,2014,3,13,19,1194,776,1970,1837
0132-000,2014,3,13,20,776,584,1360,1970
0132-000,2014,3,13,21,741,488,1229,1360
0132-000,2014,3,13,22,579,430,1009,1229
0132-000,2014,3,13,23,317,335,652,1009
0132-000,2014,3,13,24,203,199,402,652
0132-000,2014,3,14,1,146,158,304,402
0132-000,2014,3,14,2,108,114,222,304
0132-000,2014,3,14,3,81,102,183,222
0132-000,2014,3,14,4,64,83,147,183
0132-000,2014,3,14,5,93,68,161,147
0132-000,2014,3,14,6,146,158,304,161
0132-000,2014,3,14,7,365,428,793,304
0132-000,2014,3,14,8,625,1553,2178,793
0132-000,2014,3,14,9,817,1172,1989,2178
0132-000,2014,3,14,10,777,859,1636,1989
0132-000,2014,3,14,11,747,826,1573,1636
0132-000,2014,3,14,12,766,798,1564,1573
0132-000,2014,3,14,13,714,751,1465,1564
0132-000,2014,3,14,14,832,858,1690,1465
0132-000,2014,3,14,15,875,794,1669,1690
0132-000,2014,3,14,16,932,785,1717,1669
0132-000,2014,3,14,17,983,857,1840,1717
0132-000,2014,3,14,18,1222,868,2090,1840
0132-000,2014,3,14,19,1477,953,2430,2090
0132-000,2014,3,14,20,987,785,1772,2430
0132-000,2014,3,14,21,802,609,1411,1772
0132-000,2014,3,14,22,562,499,1061,1411
0132-000,2014,3,14,23,397,391,788,1061
0132-000,2014,3,14,24,259,251,510,788
0132-000,2014,3,15,1,195,185,380,510
0132-000,2014,3,15,2,152,145,297,380
0132-000,2014,3,15,3,106,111,217,297
0132-000,2014,3,15,4,69,105,174,217
0132-000,2014,3,15,5,102,116,218,174
0132-000,2014,3,15,6,137,118,255,218
0132-000,2014,3,15,7,335,300,635,255
0132-000,2014,3,15,8,485,815,1300,635
0132-000,2014,3,15,9,694,800,1494,1300
0132-000,2014,3,15,10,705,891,1596,1494
0132-000,2014,3,15,11,729,872,1601,1596
0132-000,2014,3,15,12,829,926,1755,1601
0132-000,2014,3,15,13,879,882,1761,1755
0132-000,2014,3,15,14,856,830,1686,1761
0132-000,2014,3,15,15,850,847,1697,1686
0132-000,2014,3,15,16,931,833,1764,1697
0132-000,2014,3,15,17,942,906,1848,1764
0132-000,2014,3,15,18,1135,963,2098,1848
0132-000,2014,3,15,19,1034,759,1793,2098
0132-000,2014,3,15,20,699,624,1323,1793
0132-000,2014,3,15,21,548,474,1022,1323
0132-000,2014,3,15,22,451,417,868,1022
0132-000,2014,3,15,23,298,309,607,868
0132-000,2014,3,15,24,232,252,484,607
0132-000,2014,3,16,1,192,201,393,484
0132-000,2014,3,16,2,136,145,281,393
0132-000,2014,3,16,3,99,114,213,281
0132-000,2014,3,16,4,68,77,145,213
0132-000,2014,3,16,5,93,76,169,145
0132-000,2014,3,16,6,108,110,218,169
0132-000,2014,3,16,7,189,188,377,218
0132-000,2014,3,16,8,253,316,569,377
0132-000,2014,3,16,9,334,425,759,569
0132-000,2014,3,16,10,496,523,1019,759
0132-000,2014,3,16,11,530,654,1184,1019
0132-000,2014,3,16,12,583,651,1234,1184
0132-000,2014,3,16,13,632,631,1263,1234
0132-000,2014,3,16,14,751,712,1463,1263
0132-000,2014,3,16,15,855,704,1559,1463
0132-000,2014,3,16,16,884,758,1642,1559
0132-000,2014,3,16,17,895,731,1626,1642
0132-000,2014,3,16,18,1079,747,1826,1626
0132-000,2014,3,16,19,1048,619,1667,1826
0132-000,2014,3,16,20,840,567,1407,1667
0132-000,2014,3,16,21,570,501,1071,1407
0132-000,2014,3,16,22,412,372,784,1071
0132-000,2014,3,16,23,290,290,580,784
0132-000,2014,3,16,24,209,180,389,580
0132-000,2014,3,17,1,149,156,305,389
0132-000,2014,3,17,2,78,79,157,305
0132-000,2014,3,17,3,58,61,119,157
0132-000,2014,3,17,4,47,46,93,119
0132-000,2014,3,17,5,87,81,168,93
0132-000,2014,3,17,6,156,134,290,168
0132-000,2014,3,17,7,406,451,857,290
0132-000,2014,3,17,8,650,1677,2327,857
0132-000,2014,3,17,9,782,1406,2188,2327
0132-000,2014,3,17,10,726,851,1577,2188
0132-000,2014,3,17,11,756,801,1557,1577
0132-000,2014,3,17,12,736,739,1475,1557
0132-000,2014,3,17,13,676,773,1449,1475
0132-000,2014,3,17,14,768,771,1539,1449
0132-000,2014,3,17,15,830,826,1656,1539
0132-000,2014,3,17,16,865,859,1724,1656
0132-000,2014,3,17,17,886,780,1666,1724
0132-000,2014,3,17,18,1079,867,1946,1666
0132-000,2014,3,17,19,1203,817,2020,1946
0132-000,2014,3,17,20,796,613,1409,2020
0132-000,2014,3,17,21,779,507,1286,1409
0132-000,2014,3,17,22,607,419,1026,1286
0132-000,2014,3,17,23,323,285,608,1026
0132-000,2014,3,17,24,202,207,409,608
0132-000,2014,3,18,1,171,157,328,409
0132-000,2014,3,18,2,96,99,195,328
0132-000,2014,3,18,3,66,82,148,195
0132-000,2014,3,18,4,79,73,152,148
0132-000,2014,3,18,5,82,115,197,152
0132-000,2014,3,18,6,117,117,234,197
0132-000,2014,3,18,7,337,356,693,234
0132-000,2014,3,18,8,626,1433,2059,693
0132-000,2014,3,18,9,792,1350,2142,2059
0132-000,2014,3,18,10,735,879,1614,2142
0132-000,2014,3,18,11,743,807,1550,1614
0132-000,2014,3,18,12,811,770,1581,1550
0132-000,2014,3,18,13,715,773,1488,1581
0132-000,2014,3,18,14,823,747,1570,1488
0132-000,2014,3,18,15,818,804,1622,1570
0132-000,2014,3,18,16,876,782,1658,1622
0132-000,2014,3,18,17,849,776,1625,1658
0132-000,2014,3,18,18,1071,797,1868,1625
0132-000,2014,3,18,19,1205,776,1981,1868
0132-000,2014,3,18,20,833,645,1478,1981
0132-000,2014,3,18,21,722,503,1225,1478
0132-000,2014,3,18,22,602,464,1066,1225
0132-000,2014,3,18,23,342,268,610,1066
0132-000,2014,3,18,24,229,192,421,610
0132-000,2014,3,19,1,174,176,350,421
0132-000,2014,3,19,2,87,82,169,350
0132-000,2014,3,19,3,91,97,188,169
0132-000,2014,3,19,4,64,90,154,188
0132-000,2014,3,19,5,93,102,195,154
0132-000,2014,3,19,6,133,136,269,195
0132-000,2014,3,19,7,383,356,739,269
0132-000,2014,3,19,8,679,1476,2155,739
0132-000,2014,3,19,9,788,1323,2111,2155
0132-000,2014,3,19,10,700,891,1591,2111
0132-000,2014,3,19,11,784,788,1572,1591
0132-000,2014,3,19,12,796,796,1592,1572
0132-000,2014,3,19,13,678,744,1422,1592
0132-000,2014,3,19,14,835,803,1638,1422
0132-000,2014,3,19,15,874,807,1681,1638
0132-000,2014,3,19,16,880,774,1654,1681
0132-000,2014,3,19,17,870,783,1653,1654
0132-000,2014,3,19,18,1095,834,1929,1653
0132-000,2014,3,19,19,1211,799,2010,1929
0132-000,2014,3,19,20,804,580,1384,2010
0132-000,2014,3,19,21,698,461,1159,1384
0132-000,2014,3,19,22,579,449,1028,1159
0132-000,2014,3,19,23,347,311,658,1028
0132-000,2014,3,19,24,212,211,423,658
0132-000,2014,3,20,1,150,169,319,423
0132-000,2014,3,20,2,114,127,241,319
0132-000,2014,3,20,3,73,102,175,241
0132-000,2014,3,20,4,67,97,164,175
0132-000,2014,3,20,5,93,89,182,164
0132-000,2014,3,20,6,126,141,267,182
0132-000,2014,3,20,7,352,333,685,267
0132-000,2014,3,20,8,636,1468,2104,685
0132-000,2014,3,20,9,814,1335,2149,2104
0132-000,2014,3,20,10,704,795,1499,2149
0132-000,2014,3,20,11,747,864,1611,1499
0132-000,2014,3,20,12,755,805,1560,1611
0132-000,2014,3,20,13,726,776,1502,1560
0132-000,2014,3,20,14,753,778,1531,1502
0132-000,2014,3,20,15,827,836,1663,1531
0132-000,2014,3,20,16,857,768,1625,1663
0132-000,2014,3,20,17,850,763,1613,1625
0132-000,2014,3,20,18,1029,841,1870,1613
0132-000,2014,3,20,19,1191,779,1970,1870
0132-000,2014,3,20,20,872,644,1516,1970
0132-000,2014,3,20,21,758,470,1228,1516
0132-000,2014,3,20,22,602,444,1046,1228
0132-000,2014,3,20,23,351,295,646,1046
0132-000,2014,3,20,24,218,206,424,646
0132-000,2014,3,21,1,149,153,302,424
0132-000,2014,3,21,2,114,123,237,302
0132-000,2014,3,21,3,116,93,209,237
0132-000,2014,3,21,4,51,101,152,209
0132-000,2014,3,21,5,94,105,199,152
0132-000,2014,3,21,6,143,128,271,199
0132-000,2014,3,21,7,369,365,734,271
0132-000,2014,3,21,8,612,1504,2116,734
0132-000,2014,3,21,9,809,1311,2120,2116
0132-000,2014,3,21,10,727,853,1580,2120
0132-000,2014,3,21,11,757,849,1606,1580
0132-000,2014,3,21,12,802,817,1619,1606
0132-000,2014,3,21,13,714,755,1469,1619
0132-000,2014,3,21,14,852,789,1641,1469
0132-000,2014,3,21,15,894,862,1756,1641
0132-000,2014,3,21,16,947,797,1744,1756
0132-000,2014,3,21,17,905,801,1706,1744
0132-000,2014,3,21,18,1116,900,2016,1706
0132-000,2014,3,21,19,1428,877,2305,2016
0132-000,2014,3,21,20,1061,727,1788,2305
0132-000,2014,3,21,21,799,564,1363,1788
0132-000,2014,3,21,22,617,534,1151,1363
0132-000,2014,3,21,23,379,369,748,1151
0132-000,2014,3,21,24,247,251,498,748
0132-000,2014,3,22,1,196,198,394,498
0132-000,2014,3,22,2,144,137,281,394
0132-000,2014,3,22,3,100,100,200,281
0132-000,2014,3,22,4,104,109,213,200
0132-000,2014,3,22,5,117,130,247,213
0132-000,2014,3,22,6,148,144,292,247
0132-000,2014,3,22,7,318,312,630,292
0132-000,2014,3,22,8,487,769,1256,630
0132-000,2014,3,22,9,648,905,1553,1256
0132-000,2014,3,22,10,676,927,1603,1553
0132-000,2014,3,22,11,813,988,1801,1603
0132-000,2014,3,22,12,757,1040,1797,1801
0132-000,2014,3,22,13,831,926,1757,1797
0132-000,2014,3,22,14,863,868,1731,1757
0132-000,2014,3,22,15,866,869,1735,1731
0132-000,2014,3,22,16,938,882,1820,1735
0132-000,2014,3,22,17,946,878,1824,1820
0132-000,2014,3,22,18,1172,936,2108,1824
0132-000,2014,3,22,19,1168,832,2000,2108
0132-000,2014,3,22,20,819,625,1444,2000
0132-000,2014,3,22,21,597,473,1070,1444
0132-000,2014,3,22,22,478,424,902,1070
0132-000,2014,3,22,23,322,304,626,902
0132-000,2014,3,22,24,249,225,474,626
0132-000,2014,3,23,1,171,199,370,474
0132-000,2014,3,23,2,135,154,289,370
0132-000,2014,3,23,3,99,90,189,289
0132-000,2014,3,23,4,71,91,162,189
0132-000,2014,3,23,5,79,85,164,162
0132-000,2014,3,23,6,118,107,225,164
0132-000,2014,3,23,7,185,162,347,225
0132-000,2014,3,23,8,245,314,559,347
0132-000,2014,3,23,9,343,433,776,559
0132-000,2014,3,23,10,409,533,942,776
0132-000,2014,3,23,11,584,710,1294,942
0132-000,2014,3,23,12,584,553,1137,1294
0132-000,2014,3,23,13,615,621,1236,1137
0132-000,2014,3,23,14,653,662,1315,1236
0132-000,2014,3,23,15,784,693,1477,1315
0132-000,2014,3,23,16,857,652,1509,1477
0132-000,2014,3,23,17,1003,659,1662,1509
0132-000,2014,3,23,18,1138,740,1878,1662
0132-000,2014,3,23,19,1059,594,1653,1878
0132-000,2014,3,23,20,819,534,1353,1653
0132-000,2014,3,23,21,656,473,1129,1353
0132-000,2014,3,23,22,483,361,844,1129
0132-000,2014,3,23,23,264,286,550,844
0132-000,2014,3,23,24,173,188,361,550
0132-000,2014,3,24,1,114,141,255,361
0132-000,2014,3,24,2,92,77,169,255
0132-000,2014,3,24,3,81,71,152,169
0132-000,2014,3,24,4,55,64,119,152
0132-000,2014,3,24,5,74,83,157,119
0132-000,2014,3,24,6,139,141,280,157
0132-000,2014,3,24,7,443,476,919,280
0132-000,2014,3,24,8,675,1697,2372,919
0132-000,2014,3,24,9,820,1378,2198,2372
0132-000,2014,3,24,10,730,892,1622,2198
0132-000,2014,3,24,11,727,775,1502,1622
0132-000,2014,3,24,12,733,789,1522,1502
0132-000,2014,3,24,13,661,686,1347,1522
0132-000,2014,3,24,14,770,812,1582,1347
0132-000,2014,3,24,15,855,795,1650,1582
0132-000,2014,3,24,16,845,773,1618,1650
0132-000,2014,3,24,17,814,779,1593,1618
0132-000,2014,3,24,18,1119,885,2004,1593
0132-000,2014,3,24,19,1200,811,2011,2004
0132-000,2014,3,24,20,865,684,1549,2011
0132-000,2014,3,24,21,727,513,1240,1549
0132-000,2014,3,24,22,574,433,1007,1240
0132-000,2014,3,24,23,324,301,625,1007
0132-000,2014,3,24,24,224,201,425,625
0132-000,2014,3,25,1,139,143,282,425
0132-000,2014,3,25,2,118,99,217,282
0132-000,2014,3,25,3,72,91,163,217
0132-000,2014,3,25,4,70,85,155,163
0132-000,2014,3,25,5,94,107,201,155
0132-000,2014,3,25,6,143,138,281,201
0132-000,2014,3,25,7,350,392,742,281
0132-000,2014,3,25,8,628,1462,2090,742
0132-000,2014,3,25,9,802,1304,2106,2090
0132-000,2014,3,25,10,720,850,1570,2106
0132-000,2014,3,25,11,744,815,1559,1570
0132-000,2014,3,25,12,726,784,1510,1559
0132-000,2014,3,25,13,685,765,1450,1510
0132-000,2014,3,25,14,772,792,1564,1450
0132-000,2014,3,25,15,847,840,1687,1564
0132-000,2014,3,25,16,835,729,1564,1687
0132-000,2014,3,25,17,884,764,1648,1564
0132-000,2014,3,25,18,1059,813,1872,1648
0132-000,2014,3,25,19,1218,836,2054,1872
0132-000,2014,3,25,20,905,679,1584,2054
0132-000,2014,3,25,21,703,489,1192,1584
0132-000,2014,3,25,22,640,464,1104,1192
0132-000,2014,3,25,23,367,279,646,1104
0132-000,2014,3,25,24,206,173,379,646
0132-000,2014,3,26,1,142,167,309,379
0132-000,2014,3,26,2,99,89,188,309
0132-000,2014,3,26,3,90,81,171,188
0132-000,2014,3,26,4,64,82,146,171
0132-000,2014,3,26,5,70,112,182,146
0132-000,2014,3,26,6,122,118,240,182
0132-000,2014,3,26,7,357,389,746,240
0132-000,2014,3,26,8,640,1485,2125,746
0132-000,2014,3,26,9,820,1386,2206,2125
0132-000,2014,3,26,10,762,857,1619,2206
0132-000,2014,3,26,11,722,823,1545,1619
0132-000,2014,3,26,12,724,786,1510,1545
0132-000,2014,3,26,13,680,730,1410,1510
0132-000,2014,3,26,14,823,788,1611,1410
0132-000,2014,3,26,15,828,854,1682,1611
0132-000,2014,3,26,16,887,835,1722,1682
0132-000,2014,3,26,17,926,765,1691,1722
0132-000,2014,3,26,18,1098,844,1942,1691
0132-000,2014,3,26,19,1318,848,2166,1942
0132-000,2014,3,26,20,973,671,1644,2166
0132-000,2014,3,26,21,706,529,1235,1644
0132-000,2014,3,26,22,598,435,1033,1235
0132-000,2014,3,26,23,391,294,685,1033
0132-000,2014,3,26,24,236,234,470,685
0132-000,2014,3,27,1,170,173,343,470
0132-000,2014,3,27,2,105,101,206,343
0132-000,2014,3,27,3,82,92,174,206
0132-000,2014,3,27,4,59,84,143,174
0132-000,2014,3,27,5,93,108,201,143
0132-000,2014,3,27,6,185,153,338,201
0132-000,2014,3,27,7,385,413,798,338
0132-000,2014,3,27,8,637,1503,2140,798
0132-000,2014,3,27,9,800,1345,2145,2140
0132-000,2014,3,27,10,708,892,1600,2145
0132-000,2014,3,27,11,775,839,1614,1600
0132-000,2014,3,27,12,778,803,1581,1614
0132-000,2014,3,27,13,704,732,1436,1581
0132-000,2014,3,27,14,792,829,1621,1436
0132-000,2014,3,27,15,851,827,1678,1621
0132-000,2014,3,27,16,859,823,1682,1678
0132-000,2014,3,27,17,959,774,1733,1682
0132-000,2014,3,27,18,1120,858,1978,1733
0132-000,2014,3,27,19,1238,777,2015,1978
0132-000,2014,3,27,20,878,663,1541,2015
0132-000,2014,3,27,21,733,514,1247,1541
0132-000,2014,3,27,22,596,477,1073,1247
0132-000,2014,3,27,23,354,327,681,1073
0132-000,2014,3,27,24,232,230,462,681
0132-000,2014,3,28,1,174,157,331,462
0132-000,2014,3,28,2,132,136,268,331
0132-000,2014,3,28,3,93,113,206,268
0132-000,2014,3,28,4,72,91,163,206
0132-000,2014,3,28,5,87,106,193,163
0132-000,2014,3,28,6,151,125,276,193
0132-000,2014,3,28,7,366,402,768,276
0132-000,2014,3,28,8,627,1485,2112,768
0132-000,2014,3,28,9,804,1311,2115,2112
0132-000,2014,3,28,10,757,855,1612,2115
0132-000,2014,3,28,11,777,826,1603,1612
0132-000,2014,3,28,12,795,787,1582,1603
0132-000,2014,3,28,13,740,742,1482,1582
0132-000,2014,3,28,14,835,782,1617,1482
0132-000,2014,3,28,15,821,738,1559,1617
0132-000,2014,3,28,16,860,819,1679,1559
0132-000,2014,3,28,17,939,833,1772,1679
0132-000,2014,3,28,18,1184,888,2072,1772
0132-000,2014,3,28,19,1439,850,2289,2072
0132-000,2014,3,28,20,1079,784,1863,2289
0132-000,2014,3,28,21,789,564,1353,1863
0132-000,2014,3,28,22,584,575,1159,1353
0132-000,2014,3,28,23,420,359,779,1159
0132-000,2014,3,28,24,285,259,544,779
0132-000,2014,3,29,1,204,234,438,544
0132-000,2014,3,29,2,166,162,328,438
0132-000,2014,3,29,3,105,120,225,328
0132-000,2014,3,29,4,93,112,205,225
0132-000,2014,3,29,5,97,127,224,205
0132-000,2014,3,29,6,128,133,261,224
0132-000,2014,3,29,7,297,278,575,261
0132-000,2014,3,29,8,478,747,1225,575
0132-000,2014,3,29,9,621,821,1442,1225
0132-000,2014,3,29,10,711,926,1637,1442
0132-000,2014,3,29,11,765,943,1708,1637
0132-000,2014,3,29,12,808,1101,1909,1708
0132-000,2014,3,29,13,826,1072,1898,1909
0132-000,2014,3,29,14,748,847,1595,1898
0132-000,2014,3,29,15,905,955,1860,1595
0132-000,2014,3,29,16,956,835,1791,1860
0132-000,2014,3,29,17,978,830,1808,1791
0132-000,2014,3,29,18,1194,894,2088,1808
0132-000,2014,3,29,19,1114,768,1882,2088
0132-000,2014,3,29,20,732,644,1376,1882
0132-000,2014,3,29,21,566,479,1045,1376
0132-000,2014,3,29,22,430,452,882,1045
0132-000,2014,3,29,23,337,321,658,882
0132-000,2014,3,29,24,193,226,419,658
0132-000,2014,3,30,1,184,182,366,419
0132-000,2014,3,30,2,121,119,240,366
0132-000,2014,3,30,3,74,72,146,240
0132-000,2014,3,30,4,75,86,161,146
0132-000,2014,3,30,5,70,94,164,161
0132-000,2014,3,30,6,92,83,175,164
0132-000,2014,3,30,7,216,199,415,175
0132-000,2014,3,30,8,279,319,598,415
0132-000,2014,3,30,9,390,500,890,598
0132-000,2014,3,30,10,496,597,1093,890
0132-000,2014,3,30,11,511,649,1160,1093
0132-000,2014,3,30,12,626,634,1260,1160
0132-000,2014,3,30,13,642,692,1334,1260
0132-000,2014,3,30,14,707,722,1429,1334
0132-000,2014,3,30,15,831,732,1563,1429
0132-000,2014,3,30,16,885,668,1553,1563
0132-000,2014,3,30,17,1051,651,1702,1553
0132-000,2014,3,30,18,1138,746,1884,1702
0132-000,2014,3,30,19,1086,640,1726,1884
0132-000,2014,3,30,20,976,569,1545,1726
0132-000,2014,3,30,21,810,492,1302,1545
0132-000,2014,3,30,22,555,416,971,1302
0132-000,2014,3,30,23,330,279,609,971
0132-000,2014,3,30,24,176,199,375,609
0132-000,2014,3,31,1,105,134,239,375
0132-000,2014,3,31,2,71,77,148,239
0132-000,2014,3,31,3,47,61,108,148
0132-000,2014,3,31,4,54,49,103,108
0132-000,2014,3,31,5,82,89,171,103
0132-000,2014,3,31,6,137,143,280,171
0132-000,2014,3,31,7,418,473,891,280
0132-000,2014,3,31,8,676,1687,2363,891
0132-000,2014,3,31,9,833,1383,2216,2363
0132-000,2014,3,31,10,735,863,1598,2216
0132-000,2014,3,31,11,787,823,1610,1598
0132-000,2014,3,31,12,783,805,1588,1610
0132-000,2014,3,31,13,723,727,1450,1588
0132-000,2014,3,31,14,831,777,1608,1450
0132-000,2014,3,31,15,894,865,1759,1608
0132-000,2014,3,31,16,871,875,1746,1759
0132-000,2014,3,31,17,869,905,1774,1746
0132-000,2014,3,31,18,1120,850,1970,1774
0132-000,2014,3,31,19,1130,806,1936,1970
0132-000,2014,3,31,20,846,605,1451,1936
0132-000,2014,3,31,21,726,529,1255,1451
0132-000,2014,3,31,22,610,454,1064,1255
0132-000,2014,3,31,23,335,293,628,1064
0132-000,2014,3,31,24,223,211,434,628
0132-000,2014,4,1,1,156,164,320,434
0132-000,2014,4,1,2,113,105,218,320
0132-000,2014,4,1,3,89,102,191,218
0132-000,2014,4,1,4,65,76,141,191
0132-000,2014,4,1,5,85,107,192,141
0132-000,2014,4,1,6,134,130,264,192
0132-000,2014,4,1,7,356,448,804,264
0132-000,2014,4,1,8,659,1526,2185,804
0132-000,2014,4,1,9,730,1300,2030,2185
0132-000,2014,4,1,10,768,864,1632,2030
0132-000,2014,4,1,11,702,842,1544,1632
0132-000,2014,4,1,12,805,796,1601,1544
0132-000,2014,4,1,13,703,771,1474,1601
0132-000,2014,4,1,14,811,812,1623,1474
0132-000,2014,4,1,15,802,805,1607,1623
0132-000,2014,4,1,16,905,801,1706,1607
0132-000,2014,4,1,17,927,802,1729,1706
0132-000,2014,4,1,18,1046,829,1875,1729
0132-000,2014,4,1,19,1256,843,2099,1875
0132-000,2014,4,1,20,941,687,1628,2099
0132-000,2014,4,1,21,737,501,1238,1628
0132-000,2014,4,1,22,621,439,1060,1238
0132-000,2014,4,1,23,323,307,630,1060
0132-000,2014,4,1,24,242,238,480,630
0132-000,2014,4,2,1,146,160,306,480
0132-000,2014,4,2,2,95,109,204,306
0132-000,2014,4,2,3,74,86,160,204
0132-000,2014,4,2,4,64,97,161,160
0132-000,2014,4,2,5,88,90,178,161
0132-000,2014,4,2,6,132,121,253,178
0132-000,2014,4,2,7,352,436,788,253
0132-000,2014,4,2,8,676,1554,2230,788
0132-000,2014,4,2,9,796,1360,2156,2230
0132-000,2014,4,2,10,704,825,1529,2156
0132-000,2014,4,2,11,760,771,1531,1529
0132-000,2014,4,2,12,730,843,1573,1531
0132-000,2014,4,2,13,677,740,1417,1573
0132-000,2014,4,2,14,807,774,1581,1417
0132-000,2014,4,2,15,905,850,1755,1581
0132-000,2014,4,2,16,939,808,1747,1755
0132-000,2014,4,2,17,893,819,1712,1747
0132-000,2014,4,2,18,1169,836,2005,1712
0132-000,2014,4,2,19,1259,886,2145,2005
0132-000,2014,4,2,20,968,663,1631,2145
0132-000,2014,4,2,21,709,518,1227,1631
0132-000,2014,4,2,22,592,469,1061,1227
0132-000,2014,4,2,23,404,318,722,1061
0132-000,2014,4,2,24,218,196,414,722
0132-000,2014,4,3,1,156,168,324,414
0132-000,2014,4,3,2,99,102,201,324
0132-000,2014,4,3,3,80,77,157,201
0132-000,2014,4,3,4,65,99,164,157
0132-000,2014,4,3,5,83,101,184,164
0132-000,2014,4,3,6,129,140,269,184
0132-000,2014,4,3,7,371,387,758,269
0132-000,2014,4,3,8,619,1515,2134,758
0132-000,2014,4,3,9,784,1291,2075,2134
0132-000,2014,4,3,10,733,852,1585,2075
0132-000,2014,4,3,11,753,881,1634,1585
0132-000,2014,4,3,12,751,815,1566,1634
0132-000,2014,4,3,13,650,719,1369,1566
0132-000,2014,4,3,14,796,727,1523,1369
0132-000,2014,4,3,15,839,782,1621,1523
0132-000,2014,4,3,16,809,841,1650,1621
0132-000,2014,4,3,17,908,776,1684,1650
0132-000,2014,4,3,18,1053,794,1847,1684
0132-000,2014,4,3,19,1167,749,1916,1847
0132-000,2014,4,3,20,809,590,1399,1916
0132-000,2014,4,3,21,699,463,1162,1399
0132-000,2014,4,3,22,605,400,1005,1162
0132-000,2014,4,3,23,339,292,631,1005
0132-000,2014,4,3,24,238,204,442,631
0132-000,2014,4,4,1,154,185,339,442
0132-000,2014,4,4,2,117,119,236,339
0132-000,2014,4,4,3,94,88,182,236
0132-000,2014,4,4,4,69,85,154,182
0132-000,2014,4,4,5,101,104,205,154
0132-000,2014,4,4,6,148,133,281,205
0132-000,2014,4,4,7,379,385,764,281
0132-000,2014,4,4,8,666,1458,2124,764
0132-000,2014,4,4,9,773,1308,2081,2124
0132-000,2014,4,4,10,748,825,1573,2081
0132-000,2014,4,4,11,758,847,1605,1573
0132-000,2014,4,4,12,779,810,1589,1605
0132-000,2014,4,4,13,739,766,1505,1589
0132-000,2014,4,4,14,838,821,1659,1505
0132-000,2014,4,4,15,852,854,1706,1659
0132-000,2014,4,4,16,902,838,1740,1706
0132-000,2014,4,4,17,951,874,1825,1740
0132-000,2014,4,4,18,1206,953,2159,1825
0132-000,2014,4,4,19,1517,917,2434,2159
0132-000,2014,4,4,20,1135,755,1890,2434
0132-000,2014,4,4,21,774,558,1332,1890
0132-000,2014,4,4,22,619,550,1169,1332
0132-000,2014,4,4,23,378,347,725,1169
0132-000,2014,4,4,24,264,257,521,725
0132-000,2014,4,5,1,218,212,430,521
0132-000,2014,4,5,2,155,171,326,430
0132-000,2014,4,5,3,114,122,236,326
0132-000,2014,4,5,4,106,101,207,236
0132-000,2014,4,5,5,84,109,193,207
0132-000,2014,4,5,6,143,146,289,193
0132-000,2014,4,5,7,352,323,675,289
0132-000,2014,4,5,8,433,791,1224,675
0132-000,2014,4,5,9,666,1043,1709,1224
0132-000,2014,4,5,10,710,1316,2026,1709
0132-000,2014,4,5,11,806,1434,2240,2026
0132-000,2014,4,5,12,733,1578,2311,2240
0132-000,2014,4,5,13,827,1552,2379,2311
0132-000,2014,4,5,14,847,1377,2224,2379
0132-000,2014,4,5,15,995,1150,2145,2224
0132-000,2014,4,5,16,993,1069,2062,2145
0132-000,2014,4,5,17,1043,888,1931,2062
0132-000,2014,4,5,18,1312,947,2259,1931
0132-000,2014,4,5,19,1335,820,2155,2259
0132-000,2014,4,5,20,991,648,1639,2155
0132-000,2014,4,5,21,666,520,1186,1639
0132-000,2014,4,5,22,540,442,982,1186
0132-000,2014,4,5,23,337,333,670,982
0132-000,2014,4,5,24,222,188,410,670
0132-000,2014,4,6,1,171,156,327,410
0132-000,2014,4,6,2,115,124,239,327
0132-000,2014,4,6,3,102,103,205,239
0132-000,2014,4,6,4,83,78,161,205
0132-000,2014,4,6,5,54,71,125,161
0132-000,2014,4,6,6,110,111,221,125
0132-000,2014,4,6,7,209,235,444,221
0132-000,2014,4,6,8,238,442,680,444
0132-000,2014,4,6,9,375,513,888,680
0132-000,2014,4,6,10,443,752,1195,888
0132-000,2014,4,6,11,576,728,1304,1195
0132-000,2014,4,6,12,599,616,1215,1304
0132-000,2014,4,6,13,745,754,1499,1215
0132-000,2014,4,6,14,848,791,1639,1499
0132-000,2014,4,6,15,1051,699,1750,1639
0132-000,2014,4,6,16,1185,734,1919,1750
0132-000,2014,4,6,17,1340,651,1991,1919
0132-000,2014,4,6,18,1533,676,2209,1991
0132-000,2014,4,6,19,1614,538,2152,2209
0132-000,2014,4,6,20,1525,500,2025,2152
0132-000,2014,4,6,21,1226,471,1697,2025
0132-000,2014,4,6,22,1024,415,1439,1697
0132-000,2014,4,6,23,627,283,910,1439
0132-000,2014,4,6,24,349,178,527,910
0132-000,2014,4,7,1,129,125,254,527
0132-000,2014,4,7,2,63,81,144,254
0132-000,2014,4,7,3,49,41,90,144
0132-000,2014,4,7,4,49,54,103,90
0132-000,2014,4,7,5,77,79,156,103
0132-000,2014,4,7,6,154,151,305,156
0132-000,2014,4,7,7,425,504,929,305
0132-000,2014,4,7,8,685,1666,2351,929
0132-000,2014,4,7,9,814,1357,2171,2351
0132-000,2014,4,7,10,759,881,1640,2171
0132-000,2014,4,7,11,770,768,1538,1640
0132-000,2014,4,7,12,762,811,1573,1538
0132-000,2014,4,7,13,680,808,1488,1573
0132-000,2014,4,7,14,788,858,1646,1488
0132-000,2014,4,7,15,819,826,1645,1646
0132-000,2014,4,7,16,844,769,1613,1645
0132-000,2014,4,7,17,894,866,1760,1613
0132-000,2014,4,7,18,1041,826,1867,1760
0132-000,2014,4,7,19,1213,839,2052,1867
0132-000,2014,4,7,20,864,681,1545,2052
0132-000,2014,4,7,21,809,446,1255,1545
0132-000,2014,4,7,22,580,437,1017,1255
0132-000,2014,4,7,23,331,275,606,1017
0132-000,2014,4,7,24,200,225,425,606
0132-000,2014,4,8,1,149,151,300,425
0132-000,2014,4,8,2,106,95,201,300
0132-000,2014,4,8,3,99,114,213,201
0132-000,2014,4,8,4,96,113,209,213
0132-000,2014,4,8,5,93,99,192,209
0132-000,2014,4,8,6,124,134,258,192
0132-000,2014,4,8,7,394,426,820,258
0132-000,2014,4,8,8,688,1559,2247,820
0132-000,2014,4,8,9,786,1341,2127,2247
0132-000,2014,4,8,10,757,862,1619,2127
0132-000,2014,4,8,11,746,833,1579,1619
0132-000,2014,4,8,12,787,747,1534,1579
0132-000,2014,4,8,13,682,738,1420,1534
0132-000,2014,4,8,14,828,848,1676,1420
0132-000,2014,4,8,15,836,750,1586,1676
0132-000,2014,4,8,16,854,753,1607,1586
0132-000,2014,4,8,17,887,732,1619,1607
0132-000,2014,4,8,18,1054,834,1888,1619
0132-000,2014,4,8,19,1253,764,2017,1888
0132-000,2014,4,8,20,885,718,1603,2017
0132-000,2014,4,8,21,778,506,1284,1603
0132-000,2014,4,8,22,541,463,1004,1284
0132-000,2014,4,8,23,336,331,667,1004
0132-000,2014,4,8,24,243,190,433,667
0132-000,2014,4,9,1,154,157,311,433
0132-000,2014,4,9,2,94,84,178,311
0132-000,2014,4,9,3,73,83,156,178
0132-000,2014,4,9,4,75,77,152,156
0132-000,2014,4,9,5,83,106,189,152
0132-000,2014,4,9,6,152,138,290,189
0132-000,2014,4,9,7,408,401,809,290
0132-000,2014,4,9,8,657,1486,2143,809
0132-000,2014,4,9,9,789,1364,2153,2143
0132-000,2014,4,9,10,739,835,1574,2153
0132-000,2014,4,9,11,736,803,1539,1574
0132-000,2014,4,9,12,770,785,1555,1539
0132-000,2014,4,9,13,694,757,1451,1555
0132-000,2014,4,9,14,781,779,1560,1451
0132-000,2014,4,9,15,783,793,1576,1560
0132-000,2014,4,9,16,897,852,1749,1576
0132-000,2014,4,9,17,825,758,1583,1749
0132-000,2014,4,9,18,1170,861,2031,1583
0132-000,2014,4,9,19,1259,848,2107,2031
0132-000,2014,4,9,20,905,657,1562,2107
0132-000,2014,4,9,21,725,513,1238,1562
0132-000,2014,4,9,22,591,433,1024,1238
0132-000,2014,4,9,23,373,316,689,1024
0132-000,2014,4,9,24,219,209,428,689
0132-000,2014,4,10,1,145,172,317,428
0132-000,2014,4,10,2,118,89,207,317
0132-000,2014,4,10,3,92,104,196,207
0132-000,2014,4,10,4,77,95,172,196
0132-000,2014,4,10,5,90,107,197,172
0132-000,2014,4,10,6,148,132,280,197
0132-000,2014,4,10,7,381,409,790,280
0132-000,2014,4,10,8,661,1585,2246,790
0132-000,2014,4,10,9,819,1328,2147,2246
0132-000,2014,4,10,10,762,854,1616,2147
0132-000,2014,4,10,11,746,800,1546,1616
0132-000,2014,4,10,12,734,792,1526,1546
0132-000,2014,4,10,13,694,770,1464,1526
0132-000,2014,4,10,14,782,786,1568,1464
0132-000,2014,4,10,15,835,802,1637,1568
0132-000,2014,4,10,16,855,804,1659,1637
0132-000,2014,4,10,17,925,764,1689,1659
0132-000,2014,4,10,18,1173,847,2020,1689
0132-000,2014,4,10,19,1187,823,2010,2020
0132-000,2014,4,10,20,908,659,1567,2010
0132-000,2014,4,10,21,701,511,1212,1567
0132-000,2014,4,10,22,605,476,1081,1212
0132-000,2014,4,10,23,382,320,702,1081
0132-000,2014,4,10,24,260,221,481,702
0132-000,2014,4,11,1,191,189,380,481
0132-000,2014,4,11,2,121,126,247,380
0132-000,2014,4,11,3,101,96,197,247
0132-000,2014,4,11,4,86,86,172,197
0132-000,2014,4,11,5,97,125,222,172
0132-000,2014,4,11,6,134,153,287,222
0132-000,2014,4,11,7,455,453,908,287
0132-000,2014,4,11,8,684,1560,2244,908
0132-000,2014,4,11,9,763,1337,2100,2244
0132-000,2014,4,11,10,733,866,1599,2100
0132-000,2014,4,11,11,784,810,1594,1599
0132-000,2014,4,11,12,787,863,1650,1594
0132-000,2014,4,11,13,730,827,1557,1650
0132-000,2014,4,11,14,818,846,1664,1557
0132-000,2014,4,11,15,914,919,1833,1664
0132-000,2014,4,11,16,962,865,1827,1833
0132-000,2014,4,11,17,1021,812,1833,1827
0132-000,2014,4,11,18,1350,891,2241,1833
0132-000,2014,4,11,19,1495,961,2456,2241
0132-000,2014,4,11,20,1161,827,1988,2456
0132-000,2014,4,11,21,844,558,1402,1988
0132-000,2014,4,11,22,585,487,1072,1402
0132-000,2014,4,11,23,405,397,802,1072
0132-000,2014,4,11,24,255,272,527,802
0132-000,2014,4,12,1,202,226,428,527
0132-000,2014,4,12,2,151,169,320,428
0132-000,2014,4,12,3,111,115,226,320
0132-000,2014,4,12,4,96,107,203,226
0132-000,2014,4,12,5,126,118,244,203
0132-000,2014,4,12,6,136,148,284,244
0132-000,2014,4,12,7,334,308,642,284
0132-000,2014,4,12,8,460,774,1234,642
0132-000,2014,4,12,9,677,976,1653,1234
0132-000,2014,4,12,10,702,1002,1704,1653
0132-000,2014,4,12,11,788,1166,1954,1704
0132-000,2014,4,12,12,733,1463,2196,1954
0132-000,2014,4,12,13,806,1301,2107,2196
0132-000,2014,4,12,14,797,1069,1866,2107
0132-000,2014,4,12,15,908,919,1827,1866
0132-000,2014,4,12,16,799,859,1658,1827
0132-000,2014,4,12,17,1063,863,1926,1658
0132-000,2014,4,12,18,1372,948,2320,1926
0132-000,2014,4,12,19,1217,860,2077,2320
0132-000,2014,4,12,20,910,676,1586,2077
0132-000,2014,4,12,21,651,517,1168,1586
0132-000,2014,4,12,22,514,422,936,1168
0132-000,2014,4,12,23,368,347,715,936
0132-000,2014,4,12,24,235,263,498,715
0132-000,2014,4,13,1,200,201,401,498
0132-000,2014,4,13,2,143,150,293,401
0132-000,2014,4,13,3,109,109,218,293
0132-000,2014,4,13,4,78,82,160,218
0132-000,2014,4,13,5,96,76,172,160
0132-000,2014,4,13,6,84,99,183,172
0132-000,2014,4,13,7,227,197,424,183
0132-000,2014,4,13,8,295,378,673,424
0132-000,2014,4,13,9,359,542,901,673
0132-000,2014,4,13,10,435,542,977,901
0132-000,2014,4,13,11,540,604,1144,977
0132-000,2014,4,13,12,597,679,1276,1144
0132-000,2014,4,13,13,669,666,1335,1276
0132-000,2014,4,13,14,721,750,1471,1335
0132-000,2014,4,13,15,883,691,1574,1471
0132-000,2014,4,13,16,1035,653,1688,1574
0132-000,2014,4,13,17,1247,698,1945,1688
0132-000,2014,4,13,18,1302,727,2029,1945
0132-000,2014,4,13,19,1377,609,1986,2029
0132-000,2014,4,13,20,1511,515,2026,1986
0132-000,2014,4,13,21,943,484,1427,2026
0132-000,2014,4,13,22,728,411,1139,1427
0132-000,2014,4,13,23,369,285,654,1139
0132-000,2014,4,13,24,200,193,393,654
0132-000,2014,4,14,1,137,179,316,393
0132-000,2014,4,14,2,99,83,182,316
0132-000,2014,4,14,3,64,61,125,182
0132-000,2014,4,14,4,47,61,108,125
0132-000,2014,4,14,5,82,106,188,108
0132-000,2014,4,14,6,172,150,322,188
0132-000,2014,4,14,7,473,517,990,322
0132-000,2014,4,14,8,729,1761,2490,990
0132-000,2014,4,14,9,805,1415,2220,2490
0132-000,2014,4,14,10,741,822,1563,2220
0132-000,2014,4,14,11,781,837,1618,1563
0132-000,2014,4,14,12,772,835,1607,1618
0132-000,2014,4,14,13,692,750,1442,1607
0132-000,2014,4,14,14,822,787,1609,1442
0132-000,2014,4,14,15,811,834,1645,1609
0132-000,2014,4,14,16,908,782,1690,1645
0132-000,2014,4,14,17,854,803,1657,1690
0132-000,2014,4,14,18,1094,881,1975,1657
0132-000,2014,4,14,19,1273,895,2168,1975
0132-000,2014,4,14,20,892,659,1551,2168
0132-000,2014,4,14,21,765,493,1258,1551
0132-000,2014,4,14,22,588,460,1048,1258
0132-000,2014,4,14,23,335,287,622,1048
0132-000,2014,4,14,24,219,222,441,622
0132-000,2014,4,15,1,170,148,318,441
0132-000,2014,4,15,2,94,97,191,318
0132-000,2014,4,15,3,69,79,148,191
0132-000,2014,4,15,4,76,81,157,148
0132-000,2014,4,15,5,81,112,193,157
0132-000,2014,4,15,6,133,131,264,193
0132-000,2014,4,15,7,400,444,844,264
0132-000,2014,4,15,8,709,1625,2334,844
0132-000,2014,4,15,9,769,1385,2154,2334
0132-000,2014,4,15,10,790,830,1620,2154
0132-000,2014,4,15,11,760,803,1563,1620
0132-000,2014,4,15,12,762,825,1587,1563
0132-000,2014,4,15,13,709,776,1485,1587
0132-000,2014,4,15,14,781,783,1564,1485
0132-000,2014,4,15,15,849,816,1665,1564
0132-000,2014,4,15,16,881,778,1659,1665
0132-000,2014,4,15,17,924,764,1688,1659
0132-000,2014,4,15,18,1136,882,2018,1688
0132-000,2014,4,15,19,1255,882,2137,2018
0132-000,2014,4,15,20,935,652,1587,2137
0132-000,2014,4,15,21,775,508,1283,1587
0132-000,2014,4,15,22,587,450,1037,1283
0132-000,2014,4,15,23,336,292,628,1037
0132-000,2014,4,15,24,227,212,439,628
0132-000,2014,4,16,1,144,146,290,439
0132-000,2014,4,16,2,133,113,246,290
0132-000,2014,4,16,3,84,115,199,246
0132-000,2014,4,16,4,71,73,144,199
0132-000,2014,4,16,5,89,108,197,144
0132-000,2014,4,16,6,133,139,272,197
0132-000,2014,4,16,7,423,437,860,272
0132-000,2014,4,16,8,698,1565,2263,860
0132-000,2014,4,16,9,787,1347,2134,2263
0132-000,2014,4,16,10,774,884,1658,2134
0132-000,2014,4,16,11,775,816,1591,1658
0132-000,2014,4,16,12,781,794,1575,1591
0132-000,2014,4,16,13,670,809,1479,1575
0132-000,2014,4,16,14,825,823,1648,1479
0132-000,2014,4,16,15,890,776,1666,1648
0132-000,2014,4,16,16,912,797,1709,1666
0132-000,2014,4,16,17,929,807,1736,1709
0132-000,2014,4,16,18,1201,873,2074,1736
0132-000,2014,4,16,19,1285,843,2128,2074
0132-000,2014,4,16,20,930,624,1554,2128
0132-000,2014,4,16,21,744,502,1246,1554
0132-000,2014,4,16,22,551,409,960,1246
0132-000,2014,4,16,23,365,312,677,960
0132-000,2014,4,16,24,211,222,433,677
0132-000,2014,4,17,1,167,159,326,433
0132-000,2014,4,17,2,119,104,223,326
0132-000,2014,4,17,3,73,98,171,223
0132-000,2014,4,17,4,64,70,134,171
0132-000,2014,4,17,5,91,109,200,134
0132-000,2014,4,17,6,124,133,257,200
0132-000,2014,4,17,7,403,425,828,257
0132-000,2014,4,17,8,666,1563,2229,828
0132-000,2014,4,17,9,812,1330,2142,2229
0132-000,2014,4,17,10,725,856,1581,2142
0132-000,2014,4,17,11,772,831,1603,1581
0132-000,2014,4,17,12,778,850,1628,1603
0132-000,2014,4,17,13,699,692,1391,1628
0132-000,2014,4,17,14,811,820,1631,1391
0132-000,2014,4,17,15,900,749,1649,1631
0132-000,2014,4,17,16,898,767,1665,1649
0132-000,2014,4,17,17,920,746,1666,1665
0132-000,2014,4,17,18,1133,810,1943,1666
0132-000,2014,4,17,19,1203,815,2018,1943
0132-000,2014,4,17,20,845,610,1455,2018
0132-000,2014,4,17,21,711,451,1162,1455
0132-000,2014,4,17,22,555,419,974,1162
0132-000,2014,4,17,23,343,281,624,974
0132-000,2014,4,17,24,198,197,395,624
0132-000,2014,4,18,1,155,159,314,395
0132-000,2014,4,18,2,86,102,188,314
0132-000,2014,4,18,3,65,77,142,188
0132-000,2014,4,18,4,74,71,145,142
0132-000,2014,4,18,5,92,119,211,145
0132-000,2014,4,18,6,139,123,262,211
0132-000,2014,4,18,7,392,402,794,262
0132-000,2014,4,18,8,634,1473,2107,794
0132-000,2014,4,18,9,825,1382,2207,2107
0132-000,2014,4,18,10,758,846,1604,2207
0132-000,2014,4,18,11,774,838,1612,1604
0132-000,2014,4,18,12,820,798,1618,1612
0132-000,2014,4,18,13,679,716,1395,1618
0132-000,2014,4,18,14,800,840,1640,1395
0132-000,2014,4,18,15,894,855,1749,1640
0132-000,2014,4,18,16,922,814,1736,1749
0132-000,2014,4,18,17,879,804,1683,1736
0132-000,2014,4,18,18,1199,877,2076,1683
0132-000,2014,4,18,19,1356,896,2252,2076
0132-000,2014,4,18,20,1095,749,1844,2252
0132-000,2014,4,18,21,848,543,1391,1844
0132-000,2014,4,18,22,582,532,1114,1391
0132-000,2014,4,18,23,375,364,739,1114
0132-000,2014,4,18,24,255,276,531,739
0132-000,2014,4,19,1,158,218,376,531
0132-000,2014,4,19,2,152,133,285,376
0132-000,2014,4,19,3,99,109,208,285
0132-000,2014,4,19,4,81,109,190,208
0132-000,2014,4,19,5,116,115,231,190
0132-000,2014,4,19,6,152,141,293,231
0132-000,2014,4,19,7,362,330,692,293
0132-000,2014,4,19,8,479,798,1277,692
0132-000,2014,4,19,9,660,1012,1672,1277
0132-000,2014,4,19,10,648,962,1610,1672
0132-000,2014,4,19,11,726,1078,1804,1610
0132-000,2014,4,19,12,779,1072,1851,1804
0132-000,2014,4,19,13,782,918,1700,1851
0132-000,2014,4,19,14,863,886,1749,1700
0132-000,2014,4,19,15,845,799,1644,1749
0132-000,2014,4,19,16,892,856,1748,1644
0132-000,2014,4,19,17,904,814,1718,1748
0132-000,2014,4,19,18,1196,877,2073,1718
0132-000,2014,4,19,19,1095,853,1948,2073
0132-000,2014,4,19,20,766,604,1370,1948
0132-000,2014,4,19,21,556,485,1041,1370
0132-000,2014,4,19,22,471,417,888,1041
0132-000,2014,4,19,23,320,338,658,888
0132-000,2014,4,19,24,237,235,472,658
0132-000,2014,4,20,1,178,194,372,472
0132-000,2014,4,20,2,159,129,288,372
0132-000,2014,4,20,3,86,95,181,288
0132-000,2014,4,20,4,77,95,172,181
0132-000,2014,4,20,5,97,77,174,172
0132-000,2014,4,20,6,110,108,218,174
0132-000,2014,4,20,7,251,220,471,218
0132-000,2014,4,20,8,299,408,707,471
0132-000,2014,4,20,9,394,501,895,707
0132-000,2014,4,20,10,472,544,1016,895
0132-000,2014,4,20,11,589,608,1197,1016
0132-000,2014,4,20,12,569,597,1166,1197
0132-000,2014,4,20,13,636,600,1236,1166
0132-000,2014,4,20,14,610,699,1309,1236
0132-000,2014,4,20,15,740,715,1455,1309
0132-000,2014,4,20,16,878,701,1579,1455
0132-000,2014,4,20,17,1133,690,1823,1579
0132-000,2014,4,20,18,1286,674,1960,1823
0132-000,2014,4,20,19,1057,620,1677,1960
0132-000,2014,4,20,20,920,550,1470,1677
0132-000,2014,4,20,21,716,426,1142,1470
0132-000,2014,4,20,22,474,386,860,1142
0132-000,2014,4,20,23,318,297,615,860
0132-000,2014,4,20,24,195,189,384,615
0132-000,2014,4,21,1,140,133,273,384
0132-000,2014,4,21,2,73,92,165,273
0132-000,2014,4,21,3,62,72,134,165
0132-000,2014,4,21,4,55,53,108,134
0132-000,2014,4,21,5,83,96,179,108
0132-000,2014,4,21,6,159,160,319,179
0132-000,2014,4,21,7,444,512,956,319
0132-000,2014,4,21,8,694,1733,2427,956
0132-000,2014,4,21,9,783,1376,2159,2427
0132-000,2014,4,21,10,721,872,1593,2159
0132-000,2014,4,21,11,738,817,1555,1593
0132-000,2014,4,21,12,766,810,1576,1555
0132-000,2014,4,21,13,744,854,1598,1576
0132-000,2014,4,21,14,769,838,1607,1598
0132-000,2014,4,21,15,873,804,1677,1607
0132-000,2014,4,21,16,921,800,1721,1677
0132-000,2014,4,21,17,913,831,1744,1721
0132-000,2014,4,21,18,1095,860,1955,1744
0132-000,2014,4,21,19,1233,829,2062,1955
0132-000,2014,4,21,20,950,626,1576,2062
0132-000,2014,4,21,21,763,506,1269,1576
0132-000,2014,4,21,22,552,411,963,1269
0132-000,2014,4,21,23,332,324,656,963
0132-000,2014,4,21,24,187,182,369,656
0132-000,2014,4,22,1,163,149,312,369
0132-000,2014,4,22,2,102,108,210,312
0132-000,2014,4,22,3,77,77,154,210
0132-000,2014,4,22,4,61,61,122,154
0132-000,2014,4,22,5,76,103,179,122
0132-000,2014,4,22,6,159,135,294,179
0132-000,2014,4,22,7,388,434,822,294
0132-000,2014,4,22,8,635,1606,2241,822
0132-000,2014,4,22,9,760,1301,2061,2241
0132-000,2014,4,22,10,748,868,1616,2061
0132-000,2014,4,22,11,786,839,1625,1616
0132-000,2014,4,22,12,740,803,1543,1625
0132-000,2014,4,22,13,726,689,1415,1543
0132-000,2014,4,22,14,794,787,1581,1415
0132-000,2014,4,22,15,853,817,1670,1581
0132-000,2014,4,22,16,883,734,1617,1670
0132-000,2014,4,22,17,885,735,1620,1617
0132-000,2014,4,22,18,1107,818,1925,1620
0132-000,2014,4,22,19,1208,823,2031,1925
0132-000,2014,4,22,20,885,639,1524,2031
0132-000,2014,4,22,21,742,480,1222,1524
0132-000,2014,4,22,22,564,452,1016,1222
0132-000,2014,4,22,23,364,301,665,1016
0132-000,2014,4,22,24,234,196,430,665
0132-000,2014,4,23,1,178,159,337,430
0132-000,2014,4,23,2,106,100,206,337
0132-000,2014,4,23,3,77,82,159,206
0132-000,2014,4,23,4,62,83,145,159
0132-000,2014,4,23,5,70,88,158,145
0132-000,2014,4,23,6,146,137,283,158
0132-000,2014,4,23,7,433,424,857,283
0132-000,2014,4,23,8,649,1520,2169,857
0132-000,2014,4,23,9,785,1290,2075,2169
0132-000,2014,4,23,10,766,848,1614,2075
0132-000,2014,4,23,11,730,825,1555,1614
0132-000,2014,4,23,12,744,793,1537,1555
0132-000,2014,4,23,13,689,716,1405,1537
0132-000,2014,4,23,14,774,781,1555,1405
0132-000,2014,4,23,15,853,794,1647,1555
0132-000,2014,4,23,16,852,794,1646,1647
0132-000,2014,4,23,17,905,755,1660,1646
0132-000,2014,4,23,18,1063,867,1930,1660
0132-000,2014,4,23,19,1330,829,2159,1930
0132-000,2014,4,23,20,905,661,1566,2159
0132-000,2014,4,23,21,734,474,1208,1566
0132-000,2014,4,23,22,578,445,1023,1208
0132-000,2014,4,23,23,330,315,645,1023
0132-000,2014,4,23,24,265,216,481,645
0132-000,2014,4,24,1,143,154,297,481
0132-000,2014,4,24,2,112,111,223,297
0132-000,2014,4,24,3,86,89,175,223
0132-000,2014,4,24,4,68,90,158,175
0132-000,2014,4,24,5,99,99,198,158
0132-000,2014,4,24,6,147,122,269,198
0132-000,2014,4,24,7,399,417,816,269
0132-000,2014,4,24,8,685,1518,2203,816
0132-000,2014,4,24,9,756,1308,2064,2203
0132-000,2014,4,24,10,770,847,1617,2064
0132-000,2014,4,24,11,726,826,1552,1617
0132-000,2014,4,24,12,716,815,1531,1552
0132-000,2014,4,24,13,671,716,1387,1531
0132-000,2014,4,24,14,753,814,1567,1387
0132-000,2014,4,24,15,888,811,1699,1567
0132-000,2014,4,24,16,850,743,1593,1699
0132-000,2014,4,24,17,938,772,1710,1593
0132-000,2014,4,24,18,1075,763,1838,1710
0132-000,2014,4,24,19,1150,815,1965,1838
0132-000,2014,4,24,20,918,652,1570,1965
0132-000,2014,4,24,21,759,510,1269,1570
0132-000,2014,4,24,22,584,476,1060,1269
0132-000,2014,4,24,23,343,300,643,1060
0132-000,2014,4,24,24,249,229,478,643
0132-000,2014,4,25,1,178,171,349,478
0132-000,2014,4,25,2,112,102,214,349
0132-000,2014,4,25,3,83,90,173,214
0132-000,2014,4,25,4,70,83,153,173
0132-000,2014,4,25,5,92,107,199,153
0132-000,2014,4,25,6,161,150,311,199
0132-000,2014,4,25,7,437,464,901,311
0132-000,2014,4,25,8,641,1507,2148,901
0132-000,2014,4,25,9,773,1287,2060,2148
0132-000,2014,4,25,10,778,843,1621,2060
0132-000,2014,4,25,11,768,847,1615,1621
0132-000,2014,4,25,12,815,779,1594,1615
0132-000,2014,4,25,13,788,779,1567,1594
0132-000,2014,4,25,14,757,754,1511,1567
0132-000,2014,4,25,15,875,760,1635,1511
0132-000,2014,4,25,16,917,851,1768,1635
0132-000,2014,4,25,17,926,845,1771,1768
0132-000,2014,4,25,18,1238,877,2115,1771
0132-000,2014,4,25,19,1459,946,2405,2115
0132-000,2014,4,25,20,1056,733,1789,2405
0132-000,2014,4,25,21,811,575,1386,1789
0132-000,2014,4,25,22,618,542,1160,1386
0132-000,2014,4,25,23,400,354,754,1160
0132-000,2014,4,25,24,247,292,539,754
0132-000,2014,4,26,1,220,200,420,539
0132-000,2014,4,26,2,178,162,340,420
0132-000,2014,4,26,3,129,127,256,340
0132-000,2014,4,26,4,136,142,278,256
0132-000,2014,4,26,5,122,145,267,278
0132-000,2014,4,26,6,170,159,329,267
0132-000,2014,4,26,7,352,370,722,329
0132-000,2014,4,26,8,507,843,1350,722
0132-000,2014,4,26,9,711,932,1643,1350
0132-000,2014,4,26,10,733,913,1646,1643
0132-000,2014,4,26,11,752,1001,1753,1646
0132-000,2014,4,26,12,859,1050,1909,1753
0132-000,2014,4,26,13,843,980,1823,1909
0132-000,2014,4,26,14,855,883,1738,1823
0132-000,2014,4,26,15,879,945,1824,1738
0132-000,2014,4,26,16,938,825,1763,1824
0132-000,2014,4,26,17,1037,896,1933,1763
0132-000,2014,4,26,18,1366,931,2297,1933
0132-000,2014,4,26,19,1174,820,1994,2297
0132-000,2014,4,26,20,810,597,1407,1994
0132-000,2014,4,26,21,646,499,1145,1407
0132-000,2014,4,26,22,483,449,932,1145
0132-000,2014,4,26,23,336,351,687,932
0132-000,2014,4,26,24,251,251,502,687
0132-000,2014,4,27,1,190,205,395,502
0132-000,2014,4,27,2,162,159,321,395
0132-000,2014,4,27,3,98,94,192,321
0132-000,2014,4,27,4,93,107,200,192
0132-000,2014,4,27,5,89,92,181,200
0132-000,2014,4,27,6,102,97,199,181
0132-000,2014,4,27,7,148,170,318,199
0132-000,2014,4,27,8,251,275,526,318
0132-000,2014,4,27,9,338,348,686,526
0132-000,2014,4,27,10,420,450,870,686
0132-000,2014,4,27,11,570,546,1116,870
0132-000,2014,4,27,12,558,530,1088,1116
0132-000,2014,4,27,13,630,646,1276,1088
0132-000,2014,4,27,14,639,648,1287,1276
0132-000,2014,4,27,15,759,614,1373,1287
0132-000,2014,4,27,16,802,708,1510,1373
0132-000,2014,4,27,17,942,733,1675,1510
0132-000,2014,4,27,18,1045,663,1708,1675
0132-000,2014,4,27,19,936,629,1565,1708
0132-000,2014,4,27,20,768,543,1311,1565
0132-000,2014,4,27,21,584,446,1030,1311
0132-000,2014,4,27,22,424,398,822,1030
0132-000,2014,4,27,23,266,286,552,822
0132-000,2014,4,27,24,169,181,350,552
0132-000,2014,4,28,1,106,133,239,350
0132-000,2014,4,28,2,79,72,151,239
0132-000,2014,4,28,3,49,70,119,151
0132-000,2014,4,28,4,35,49,84,119
0132-000,2014,4,28,5,80,78,158,84
0132-000,2014,4,28,6,129,123,252,158
0132-000,2014,4,28,7,370,442,812,252
0132-000,2014,4,28,8,617,1635,2252,812
0132-000,2014,4,28,9,751,1378,2129,2252
0132-000,2014,4,28,10,686,837,1523,2129
0132-000,2014,4,28,11,770,729,1499,1523
0132-000,2014,4,28,12,691,805,1496,1499
0132-000,2014,4,28,13,655,709,1364,1496
0132-000,2014,4,28,14,742,756,1498,1364
0132-000,2014,4,28,15,773,780,1553,1498
0132-000,2014,4,28,16,781,784,1565,1553
0132-000,2014,4,28,17,877,797,1674,1565
0132-000,2014,4,28,18,1018,740,1758,1674
0132-000,2014,4,28,19,1160,751,1911,1758
0132-000,2014,4,28,20,854,595,1449,1911
0132-000,2014,4,28,21,711,446,1157,1449
0132-000,2014,4,28,22,490,429,919,1157
0132-000,2014,4,28,23,330,263,593,919
0132-000,2014,4,28,24,197,186,383,593
0132-000,2014,4,29,1,149,148,297,383
0132-000,2014,4,29,2,101,95,196,297
0132-000,2014,4,29,3,57,72,129,196
0132-000,2014,4,29,4,62,71,133,129
0132-000,2014,4,29,5,91,100,191,133
0132-000,2014,4,29,6,124,111,235,191
0132-000,2014,4,29,7,310,393,703,235
0132-000,2014,4,29,8,637,1517,2154,703
0132-000,2014,4,29,9,763,1339,2102,2154
0132-000,2014,4,29,10,729,839,1568,2102
0132-000,2014,4,29,11,795,875,1670,1568
0132-000,2014,4,29,12,802,786,1588,1670
0132-000,2014,4,29,13,725,759,1484,1588
0132-000,2014,4,29,14,788,843,1631,1484
0132-000,2014,4,29,15,831,814,1645,1631
0132-000,2014,4,29,16,951,809,1760,1645
0132-000,2014,4,29,17,855,773,1628,1760
0132-000,2014,4,29,18,1103,797,1900,1628
0132-000,2014,4,29,19,1154,824,1978,1900
0132-000,2014,4,29,20,914,630,1544,1978
0132-000,2014,4,29,21,747,528,1275,1544
0132-000,2014,4,29,22,587,418,1005,1275
0132-000,2014,4,29,23,326,272,598,1005
0132-000,2014,4,29,24,265,240,505,598
0132-000,2014,4,30,1,159,166,325,505
0132-000,2014,4,30,2,126,120,246,325
0132-000,2014,4,30,3,89,92,181,246
0132-000,2014,4,30,4,99,92,191,181
0132-000,2014,4,30,5,93,109,202,191
0132-000,2014,4,30,6,179,172,351,202
0132-000,2014,4,30,7,420,411,831,351
0132-000,2014,4,30,8,664,1565,2229,831
0132-000,2014,4,30,9,797,1304,2101,2229
0132-000,2014,4,30,10,755,857,1612,2101
0132-000,2014,4,30,11,769,801,1570,1612
0132-000,2014,4,30,12,744,793,1537,1570
0132-000,2014,4,30,13,737,634,1371,1537
0132-000,2014,4,30,14,797,829,1626,1371
0132-000,2014,4,30,15,826,864,1690,1626
0132-000,2014,4,30,16,931,831,1762,1690
0132-000,2014,4,30,17,911,806,1717,1762
0132-000,2014,4,30,18,1180,843,2023,1717
0132-000,2014,4,30,19,1385,905,2290,2023
0132-000,2014,4,30,20,973,713,1686,2290
0132-000,2014,4,30,21,812,519,1331,1686
0132-000,2014,4,30,22,613,465,1078,1331
0132-000,2014,4,30,23,397,347,744,1078
0132-000,2014,4,30,24,264,256,520,744
0132-000,2014,5,1,1,205,222,427,520
0132-000,2014,5,1,2,134,119,253,427
0132-000,2014,5,1,3,103,118,221,253
0132-000,2014,5,1,4,109,116,225,221
0132-000,2014,5,1,5,92,105,197,225
0132-000,2014,5,1,6,150,159,309,197
0132-000,2014,5,1,7,363,372,735,309
0132-000,2014,5,1,8,583,1024,1607,735
0132-000,2014,5,1,9,683,1060,1743,1607
0132-000,2014,5,1,10,693,924,1617,1743
0132-000,2014,5,1,11,741,844,1585,1617
0132-000,2014,5,1,12,761,914,1675,1585
0132-000,2014,5,1,13,718,736,1454,1675
0132-000,2014,5,1,14,792,742,1534,1454
0132-000,2014,5,1,15,815,757,1572,1534
0132-000,2014,5,1,16,896,696,1592,1572
0132-000,2014,5,1,17,857,757,1614,1592
0132-000,2014,5,1,18,1071,836,1907,1614
0132-000,2014,5,1,19,955,741,1696,1907
0132-000,2014,5,1,20,775,578,1353,1696
0132-000,2014,5,1,21,560,433,993,1353
0132-000,2014,5,1,22,509,407,916,993
0132-000,2014,5,1,23,316,290,606,916
0132-000,2014,5,1,24,217,213,430,606
0132-000,2014,5,2,1,152,144,296,430
0132-000,2014,5,2,2,118,97,215,296
0132-000,2014,5,2,3,71,88,159,215
0132-000,2014,5,2,4,82,90,172,159
0132-000,2014,5,2,5,76,82,158,172
0132-000,2014,5,2,6,191,154,345,158
0132-000,2014,5,2,7,449,449,898,345
0132-000,2014,5,2,8,682,1423,2105,898
0132-000,2014,5,2,9,772,1149,1921,2105
0132-000,2014,5,2,10,737,789,1526,1921
0132-000,2014,5,2,11,796,833,1629,1526
0132-000,2014,5,2,12,802,836,1638,1629
0132-000,2014,5,2,13,723,762,1485,1638
0132-000,2014,5,2,14,848,846,1694,1485
0132-000,2014,5,2,15,881,881,1762,1694
0132-000,2014,5,2,16,931,875,1806,1762
0132-000,2014,5,2,17,1055,959,2014,1806
0132-000,2014,5,2,18,1177,1103,2280,2014
0132-000,2014,5,2,19,1260,1111,2371,2280
0132-000,2014,5,2,20,1050,925,1975,2371
0132-000,2014,5,2,21,762,722,1484,1975
0132-000,2014,5,2,22,541,573,1114,1484
0132-000,2014,5,2,23,392,548,940,1114
0132-000,2014,5,2,24,233,289,522,940
0132-000,2014,5,3,1,192,204,396,522
0132-000,2014,5,3,2,126,126,252,396
0132-000,2014,5,3,3,109,113,222,252
0132-000,2014,5,3,4,72,105,177,222
0132-000,2014,5,3,5,96,108,204,177
0132-000,2014,5,3,6,162,151,313,204
0132-000,2014,5,3,7,366,368,734,313
0132-000,2014,5,3,8,524,993,1517,734
0132-000,2014,5,3,9,643,1536,2179,1517
0132-000,2014,5,3,10,721,1704,2425,2179
0132-000,2014,5,3,11,767,1903,2670,2425
0132-000,2014,5,3,12,840,1862,2702,2670
0132-000,2014,5,3,13,786,1871,2657,2702
0132-000,2014,5,3,14,813,1814,2627,2657
0132-000,2014,5,3,15,782,1854,2636,2627
0132-000,2014,5,3,16,882,1694,2576,2636
0132-000,2014,5,3,17,850,1751,2601,2576
0132-000,2014,5,3,18,1086,1780,2866,2601
0132-000,2014,5,3,19,1058,1806,2864,2866
0132-000,2014,5,3,20,868,1813,2681,2864
0132-000,2014,5,3,21,724,1582,2306,2681
0132-000,2014,5,3,22,637,1402,2039,2306
0132-000,2014,5,3,23,381,747,1128,2039
0132-000,2014,5,3,24,231,375,606,1128
0132-000,2014,5,4,1,164,174,338,606
0132-000,2014,5,4,2,114,138,252,338
0132-000,2014,5,4,3,101,93,194,252
0132-000,2014,5,4,4,67,58,125,194
0132-000,2014,5,4,5,58,68,126,125
0132-000,2014,5,4,6,145,138,283,126
0132-000,2014,5,4,7,229,237,466,283
0132-000,2014,5,4,8,274,420,694,466
0132-000,2014,5,4,9,358,668,1026,694
0132-000,2014,5,4,10,483,1040,1523,1026
0132-000,2014,5,4,11,549,1299,1848,1523
0132-000,2014,5,4,12,575,1328,1903,1848
0132-000,2014,5,4,13,530,1476,2006,1903
0132-000,2014,5,4,14,642,1326,1968,2006
0132-000,2014,5,4,15,739,989,1728,1968
0132-000,2014,5,4,16,910,1129,2039,1728
0132-000,2014,5,4,17,1016,1255,2271,2039
0132-000,2014,5,4,18,1335,1046,2381,2271
0132-000,2014,5,4,19,1353,793,2146,2381
0132-000,2014,5,4,20,1397,498,1895,2146
0132-000,2014,5,4,21,1299,268,1567,1895
0132-000,2014,5,4,22,1006,217,1223,1567
0132-000,2014,5,4,23,840,182,1022,1223
0132-000,2014,5,4,24,603,195,798,1022
0132-000,2014,5,5,1,271,143,414,798
0132-000,2014,5,5,2,125,94,219,414
0132-000,2014,5,5,3,77,72,149,219
0132-000,2014,5,5,4,74,65,139,149
0132-000,2014,5,5,5,69,62,131,139
0132-000,2014,5,5,6,128,38,166,131
0132-000,2014,5,5,7,262,145,407,166
0132-000,2014,5,5,8,352,452,804,407
0132-000,2014,5,5,9,422,519,941,804
0132-000,2014,5,5,10,479,404,883,941
0132-000,2014,5,5,11,637,466,1103,883
0132-000,2014,5,5,12,784,819,1603,1103
0132-000,2014,5,5,13,875,475,1350,1603
0132-000,2014,5,5,14,1001,526,1527,1350
0132-000,2014,5,5,15,1077,524,1601,1527
0132-000,2014,5,5,16,1268,521,1789,1601
0132-000,2014,5,5,17,1578,339,1917,1789
0132-000,2014,5,5,18,1756,469,2225,1917
0132-000,2014,5,5,19,1895,320,2215,2225
0132-000,2014,5,5,20,1834,369,2203,2215
0132-000,2014,5,5,21,1836,427,2263,2203
0132-000,2014,5,5,22,2091,188,2279,2263
0132-000,2014,5,5,23,1432,136,1568,2279
0132-000,2014,5,5,24,1596,111,1707,1568
0132-000,2014,5,6,1,1674,118,1792,1707
0132-000,2014,5,6,2,1458,100,1558,1792
0132-000,2014,5,6,3,1080,72,1152,1558
0132-000,2014,5,6,4,195,81,276,1152
0132-000,2014,5,6,5,106,47,153,276
0132-000,2014,5,6,6,139,65,204,153
0132-000,2014,5,6,7,309,193,502,204
0132-000,2014,5,6,8,377,347,724,502
0132-000,2014,5,6,9,524,408,932,724
0132-000,2014,5,6,10,659,571,1230,932
0132-000,2014,5,6,11,980,702,1682,1230
0132-000,2014,5,6,12,1098,561,1659,1682
0132-000,2014,5,6,13,1230,539,1769,1659
0132-000,2014,5,6,14,1235,513,1748,1769
0132-000,2014,5,6,15,1301,702,2003,1748
0132-000,2014,5,6,16,1456,731,2187,2003
0132-000,2014,5,6,17,1489,663,2152,2187
0132-000,2014,5,6,18,1399,726,2125,2152
0132-000,2014,5,6,19,1235,701,1936,2125
0132-000,2014,5,6,20,847,626,1473,1936
0132-000,2014,5,6,21,631,454,1085,1473
0132-000,2014,5,6,22,442,412,854,1085
0132-000,2014,5,6,23,298,157,455,854
0132-000,2014,5,6,24,208,108,316,455
0132-000,2014,5,7,1,128,125,253,316
0132-000,2014,5,7,2,64,73,137,253
0132-000,2014,5,7,3,75,85,160,137
0132-000,2014,5,7,4,51,55,106,160
0132-000,2014,5,7,5,72,95,167,106
0132-000,2014,5,7,6,176,173,349,167
0132-000,2014,5,7,7,443,349,792,349
0132-000,2014,5,7,8,685,1051,1736,792
0132-000,2014,5,7,9,793,805,1598,1736
0132-000,2014,5,7,10,706,634,1340,1598
0132-000,2014,5,7,11,751,504,1255,1340
0132-000,2014,5,7,12,773,661,1434,1255
0132-000,2014,5,7,13,703,718,1421,1434
0132-000,2014,5,7,14,814,651,1465,1421
0132-000,2014,5,7,15,913,694,1607,1465
0132-000,2014,5,7,16,887,672,1559,1607
0132-000,2014,5,7,17,873,536,1409,1559
0132-000,2014,5,7,18,1116,526,1642,1409
0132-000,2014,5,7,19,1315,513,1828,1642
0132-000,2014,5,7,20,915,537,1452,1828
0132-000,2014,5,7,21,793,378,1171,1452
0132-000,2014,5,7,22,618,259,877,1171
0132-000,2014,5,7,23,381,312,693,877
0132-000,2014,5,7,24,211,168,379,693
0132-000,2014,5,8,1,169,135,304,379
0132-000,2014,5,8,2,87,106,193,304
0132-000,2014,5,8,3,88,95,183,193
0132-000,2014,5,8,4,62,83,145,183
0132-000,2014,5,8,5,86,93,179,145
0132-000,2014,5,8,6,141,143,284,179
0132-000,2014,5,8,7,383,424,807,284
0132-000,2014,5,8,8,615,1547,2162,807
0132-000,2014,5,8,9,785,1389,2174,2162
0132-000,2014,5,8,10,787,877,1664,2174
0132-000,2014,5,8,11,837,862,1699,1664
0132-000,2014,5,8,12,850,868,1718,1699
0132-000,2014,5,8,13,768,746,1514,1718
0132-000,2014,5,8,14,769,837,1606,1514
0132-000,2014,5,8,15,846,788,1634,1606
0132-000,2014,5,8,16,898,817,1715,1634
0132-000,2014,5,8,17,964,850,1814,1715
0132-000,2014,5,8,18,1172,821,1993,1814
0132-000,2014,5,8,19,1340,656,1996,1993
0132-000,2014,5,8,20,1011,792,1803,1996
0132-000,2014,5,8,21,839,567,1406,1803
0132-000,2014,5,8,22,607,491,1098,1406
0132-000,2014,5,8,23,394,337,731,1098
0132-000,2014,5,8,24,251,212,463,731
0132-000,2014,5,9,1,157,155,312,463
0132-000,2014,5,9,2,84,84,168,312
0132-000,2014,5,9,3,68,43,111,168
0132-000,2014,5,9,4,71,44,115,111
0132-000,2014,5,9,5,100,117,217,115
0132-000,2014,5,9,6,169,132,301,217
0132-000,2014,5,9,7,408,502,910,301
0132-000,2014,5,9,8,692,1650,2342,910
0132-000,2014,5,9,9,814,1302,2116,2342
0132-000,2014,5,9,10,745,809,1554,2116
0132-000,2014,5,9,11,736,753,1489,1554
0132-000,2014,5,9,12,822,821,1643,1489
0132-000,2014,5,9,13,719,770,1489,1643
0132-000,2014,5,9,14,818,672,1490,1489
0132-000,2014,5,9,15,838,844,1682,1490
0132-000,2014,5,9,16,927,805,1732,1682
0132-000,2014,5,9,17,964,546,1510,1732
0132-000,2014,5,9,18,1173,587,1760,1510
0132-000,2014,5,9,19,1449,572,2021,1760
0132-000,2014,5,9,20,1118,446,1564,2021
0132-000,2014,5,9,21,856,578,1434,1564
0132-000,2014,5,9,22,654,386,1040,1434
0132-000,2014,5,9,23,425,181,606,1040
0132-000,2014,5,9,24,261,132,393,606
0132-000,2014,5,10,1,211,208,419,393
0132-000,2014,5,10,2,139,137,276,419
0132-000,2014,5,10,3,120,67,187,276
0132-000,2014,5,10,4,93,54,147,187
0132-000,2014,5,10,5,90,70,160,147
0132-000,2014,5,10,6,188,66,254,160
0132-000,2014,5,10,7,374,232,606,254
0132-000,2014,5,10,8,543,822,1365,606
0132-000,2014,5,10,9,681,936,1617,1365
0132-000,2014,5,10,10,752,904,1656,1617
0132-000,2014,5,10,11,783,1018,1801,1656
0132-000,2014,5,10,12,850,745,1595,1801
0132-000,2014,5,10,13,782,720,1502,1595
0132-000,2014,5,10,14,848,570,1418,1502
0132-000,2014,5,10,15,895,869,1764,1418
0132-000,2014,5,10,16,938,856,1794,1764
0132-000,2014,5,10,17,957,844,1801,1794
0132-000,2014,5,10,18,1213,886,2099,1801
0132-000,2014,5,10,19,1126,831,1957,2099
0132-000,2014,5,10,20,784,611,1395,1957
0132-000,2014,5,10,21,634,505,1139,1395
0132-000,2014,5,10,22,527,436,963,1139
0132-000,2014,5,10,23,321,349,670,963
0132-000,2014,5,10,24,228,259,487,670
0132-000,2014,5,11,1,193,188,381,487
0132-000,2014,5,11,2,144,132,276,381
0132-000,2014,5,11,3,118,91,209,276
0132-000,2014,5,11,4,99,96,195,209
0132-000,2014,5,11,5,69,86,155,195
0132-000,2014,5,11,6,140,116,256,155
0132-000,2014,5,11,7,231,236,467,256
0132-000,2014,5,11,8,304,386,690,467
0132-000,2014,5,11,9,366,448,814,690
0132-000,2014,5,11,10,447,598,1045,814
0132-000,2014,5,11,11,585,608,1193,1045
0132-000,2014,5,11,12,549,650,1199,1193
0132-000,2014,5,11,13,580,595,1175,1199
0132-000,2014,5,11,14,750,655,1405,1175
0132-000,2014,5,11,15,772,661,1433,1405
0132-000,2014,5,11,16,965,639,1604,1433
0132-000,2014,5,11,17,993,603,1596,1604
0132-000,2014,5,11,18,1057,700,1757,1596
0132-000,2014,5,11,19,1001,561,1562,1757
0132-000,2014,5,11,20,688,519,1207,1562
0132-000,2014,5,11,21,536,433,969,1207
0132-000,2014,5,11,22,413,366,779,969
0132-000,2014,5,11,23,273,258,531,779
0132-000,2014,5,11,24,149,155,304,531
0132-000,2014,5,12,1,105,127,232,304
0132-000,2014,5,12,2,71,78,149,232
0132-000,2014,5,12,3,55,55,110,149
0132-000,2014,5,12,4,43,53,96,110
0132-000,2014,5,12,5,69,69,138,96
0132-000,2014,5,12,6,156,151,307,138
0132-000,2014,5,12,7,377,514,891,307
0132-000,2014,5,12,8,655,1709,2364,891
0132-000,2014,5,12,9,806,1400,2206,2364
0132-000,2014,5,12,10,746,875,1621,2206
0132-000,2014,5,12,11,776,801,1577,1621
0132-000,2014,5,12,12,748,837,1585,1577
0132-000,2014,5,12,13,703,748,1451,1585
0132-000,2014,5,12,14,820,798,1618,1451
0132-000,2014,5,12,15,878,805,1683,1618
0132-000,2014,5,12,16,846,785,1631,1683
0132-000,2014,5,12,17,870,800,1670,1631
0132-000,2014,5,12,18,983,799,1782,1670
0132-000,2014,5,12,19,1223,795,2018,1782
0132-000,2014,5,12,20,894,687,1581,2018
0132-000,2014,5,12,21,832,492,1324,1581
0132-000,2014,5,12,22,613,469,1082,1324
0132-000,2014,5,12,23,362,300,662,1082
0132-000,2014,5,12,24,258,210,468,662
0132-000,2014,5,13,1,172,157,329,468
0132-000,2014,5,13,2,90,98,188,329
0132-000,2014,5,13,3,104,77,181,188
0132-000,2014,5,13,4,71,98,169,181
0132-000,2014,5,13,5,102,113,215,169
0132-000,2014,5,13,6,165,163,328,215
0132-000,2014,5,13,7,426,477,903,328
0132-000,2014,5,13,8,651,1590,2241,903
0132-000,2014,5,13,9,795,1323,2118,2241
0132-000,2014,5,13,10,751,872,1623,2118
0132-000,2014,5,13,11,805,780,1585,1623
0132-000,2014,5,13,12,762,755,1517,1585
0132-000,2014,5,13,13,718,767,1485,1517
0132-000,2014,5,13,14,792,811,1603,1485
0132-000,2014,5,13,15,821,763,1584,1603
0132-000,2014,5,13,16,864,807,1671,1584
0132-000,2014,5,13,17,911,833,1744,1671
0132-000,2014,5,13,18,1170,813,1983,1744
0132-000,2014,5,13,19,1186,835,2021,1983
0132-000,2014,5,13,20,927,705,1632,2021
0132-000,2014,5,13,21,812,504,1316,1632
0132-000,2014,5,13,22,605,427,1032,1316
0132-000,2014,5,13,23,371,325,696,1032
0132-000,2014,5,13,24,207,223,430,696
0132-000,2014,5,14,1,181,157,338,430
0132-000,2014,5,14,2,97,103,200,338
0132-000,2014,5,14,3,77,92,169,200
0132-000,2014,5,14,4,64,87,151,169
0132-000,2014,5,14,5,87,89,176,151
0132-000,2014,5,14,6,160,169,329,176
0132-000,2014,5,14,7,431,454,885,329
0132-000,2014,5,14,8,662,1609,2271,885
0132-000,2014,5,14,9,781,1293,2074,2271
0132-000,2014,5,14,10,736,834,1570,2074
0132-000,2014,5,14,11,788,811,1599,1570
0132-000,2014,5,14,12,818,797,1615,1599
0132-000,2014,5,14,13,694,729,1423,1615
0132-000,2014,5,14,14,777,772,1549,1423
0132-000,2014,5,14,15,813,820,1633,1549
0132-000,2014,5,14,16,865,768,1633,1633
0132-000,2014,5,14,17,876,792,1668,1633
0132-000,2014,5,14,18,1140,888,2028,1668
0132-000,2014,5,14,19,1302,898,2200,2028
0132-000,2014,5,14,20,957,690,1647,2200
0132-000,2014,5,14,21,784,483,1267,1647
0132-000,2014,5,14,22,615,487,1102,1267
0132-000,2014,5,14,23,363,350,713,1102
0132-000,2014,5,14,24,250,221,471,713
0132-000,2014,5,15,1,169,172,341,471
0132-000,2014,5,15,2,98,110,208,341
0132-000,2014,5,15,3,70,78,148,208
0132-000,2014,5,15,4,89,102,191,148
0132-000,2014,5,15,5,75,86,161,191
0132-000,2014,5,15,6,183,152,335,161
0132-000,2014,5,15,7,432,455,887,335
0132-000,2014,5,15,8,670,1580,2250,887
0132-000,2014,5,15,9,803,1359,2162,2250
0132-000,2014,5,15,10,799,906,1705,2162
0132-000,2014,5,15,11,788,878,1666,1705
0132-000,2014,5,15,12,786,841,1627,1666
0132-000,2014,5,15,13,697,735,1432,1627
0132-000,2014,5,15,14,788,780,1568,1432
0132-000,2014,5,15,15,877,816,1693,1568
0132-000,2014,5,15,16,875,809,1684,1693
0132-000,2014,5,15,17,910,820,1730,1684
0132-000,2014,5,15,18,1122,834,1956,1730
0132-000,2014,5,15,19,1310,894,2204,1956
0132-000,2014,5,15,20,908,680,1588,2204
0132-000,2014,5,15,21,823,503,1326,1588
0132-000,2014,5,15,22,581,504,1085,1326
0132-000,2014,5,15,23,365,321,686,1085
0132-000,2014,5,15,24,290,273,563,686
0132-000,2014,5,16,1,186,162,348,563
0132-000,2014,5,16,2,124,117,241,348
0132-000,2014,5,16,3,80,101,181,241
0132-000,2014,5,16,4,76,77,153,181
0132-000,2014,5,16,5,81,123,204,153
0132-000,2014,5,16,6,185,153,338,204
0132-000,2014,5,16,7,447,469,916,338
0132-000,2014,5,16,8,670,1622,2292,916
0132-000,2014,5,16,9,788,1347,2135,2292
0132-000,2014,5,16,10,783,888,1671,2135
0132-000,2014,5,16,11,821,838,1659,1671
0132-000,2014,5,16,12,842,834,1676,1659
0132-000,2014,5,16,13,750,777,1527,1676
0132-000,2014,5,16,14,827,855,1682,1527
0132-000,2014,5,16,15,890,803,1693,1682
0132-000,2014,5,16,16,936,872,1808,1693
0132-000,2014,5,16,17,897,817,1714,1808
0132-000,2014,5,16,18,1213,922,2135,1714
0132-000,2014,5,16,19,1488,919,2407,2135
0132-000,2014,5,16,20,1141,786,1927,2407
0132-000,2014,5,16,21,877,614,1491,1927
0132-000,2014,5,16,22,610,534,1144,1491
0132-000,2014,5,16,23,409,375,784,1144
0132-000,2014,5,16,24,267,269,536,784
0132-000,2014,5,17,1,200,220,420,536
0132-000,2014,5,17,2,149,136,285,420
0132-000,2014,5,17,3,107,115,222,285
0132-000,2014,5,17,4,114,128,242,222
0132-000,2014,5,17,5,117,116,233,242
0132-000,2014,5,17,6,160,192,352,233
0132-000,2014,5,17,7,377,368,745,352
0132-000,2014,5,17,8,560,786,1346,745
0132-000,2014,5,17,9,755,948,1703,1346
0132-000,2014,5,17,10,747,926,1673,1703
0132-000,2014,5,17,11,773,1053,1826,1673
0132-000,2014,5,17,12,881,993,1874,1826
0132-000,2014,5,17,13,840,909,1749,1874
0132-000,2014,5,17,14,863,928,1791,1749
0132-000,2014,5,17,15,956,912,1868,1791
0132-000,2014,5,17,16,970,846,1816,1868
0132-000,2014,5,17,17,1032,879,1911,1816
0132-000,2014,5,17,18,1221,871,2092,1911
0132-000,2014,5,17,19,1145,883,2028,2092
0132-000,2014,5,17,20,808,701,1509,2028
0132-000,2014,5,17,21,654,576,1230,1509
0132-000,2014,5,17,22,525,502,1027,1230
0132-000,2014,5,17,23,348,379,727,1027
0132-000,2014,5,17,24,251,267,518,727
0132-000,2014,5,18,1,173,173,346,518
0132-000,2014,5,18,2,131,145,276,346
0132-000,2014,5,18,3,124,102,226,276
0132-000,2014,5,18,4,96,85,181,226
0132-000,2014,5,18,5,89,82,171,181
0132-000,2014,5,18,6,140,148,288,171
0132-000,2014,5,18,7,216,252,468,288
0132-000,2014,5,18,8,310,390,700,468
0132-000,2014,5,18,9,381,456,837,700
0132-000,2014,5,18,10,471,571,1042,837
0132-000,2014,5,18,11,533,663,1196,1042
0132-000,2014,5,18,12,590,643,1233,1196
0132-000,2014,5,18,13,591,673,1264,1233
0132-000,2014,5,18,14,694,613,1307,1264
0132-000,2014,5,18,15,742,691,1433,1307
0132-000,2014,5,18,16,862,657,1519,1433
0132-000,2014,5,18,17,954,693,1647,1519
0132-000,2014,5,18,18,1090,717,1807,1647
0132-000,2014,5,18,19,1050,686,1736,1807
0132-000,2014,5,18,20,845,570,1415,1736
0132-000,2014,5,18,21,637,484,1121,1415
0132-000,2014,5,18,22,496,482,978,1121
0132-000,2014,5,18,23,325,328,653,978
0132-000,2014,5,18,24,208,192,400,653
0132-000,2014,5,19,1,133,153,286,400
0132-000,2014,5,19,2,79,67,146,286
0132-000,2014,5,19,3,53,74,127,146
0132-000,2014,5,19,4,53,64,117,127
0132-000,2014,5,19,5,78,79,157,117
0132-000,2014,5,19,6,204,186,390,157
0132-000,2014,5,19,7,467,575,1042,390
0132-000,2014,5,19,8,719,1813,2532,1042
0132-000,2014,5,19,9,779,1342,2121,2532
0132-000,2014,5,19,10,681,904,1585,2121
0132-000,2014,5,19,11,829,790,1619,1585
0132-000,2014,5,19,12,783,833,1616,1619
0132-000,2014,5,19,13,726,749,1475,1616
0132-000,2014,5,19,14,836,826,1662,1475
0132-000,2014,5,19,15,880,842,1722,1662
0132-000,2014,5,19,16,907,837,1744,1722
0132-000,2014,5,19,17,877,781,1658,1744
0132-000,2014,5,19,18,1121,900,2021,1658
0132-000,2014,5,19,19,1288,881,2169,2021
0132-000,2014,5,19,20,955,695,1650,2169
0132-000,2014,5,19,21,762,534,1296,1650
0132-000,2014,5,19,22,588,418,1006,1296
0132-000,2014,5,19,23,347,305,652,1006
0132-000,2014,5,19,24,234,210,444,652
0132-000,2014,5,20,1,170,141,311,444
0132-000,2014,5,20,2,106,93,199,311
0132-000,2014,5,20,3,85,98,183,199
0132-000,2014,5,20,4,63,72,135,183
0132-000,2014,5,20,5,98,104,202,135
0132-000,2014,5,20,6,183,144,327,202
0132-000,2014,5,20,7,422,479,901,327
0132-000,2014,5,20,8,691,1611,2302,901
0132-000,2014,5,20,9,762,1297,2059,2302
0132-000,2014,5,20,10,744,833,1577,2059
0132-000,2014,5,20,11,776,814,1590,1577
0132-000,2014,5,20,12,757,813,1570,1590
0132-000,2014,5,20,13,702,758,1460,1570
0132-000,2014,5,20,14,762,751,1513,1460
0132-000,2014,5,20,15,837,772,1609,1513
0132-000,2014,5,20,16,876,792,1668,1609
0132-000,2014,5,20,17,920,766,1686,1668
0132-000,2014,5,20,18,1148,847,1995,1686
0132-000,2014,5,20,19,1204,907,2111,1995
0132-000,2014,5,20,20,931,680,1611,2111
0132-000,2014,5,20,21,848,536,1384,1611
0132-000,2014,5,20,22,589,465,1054,1384
0132-000,2014,5,20,23,356,326,682,1054
0132-000,2014,5,20,24,240,189,429,682
0132-000,2014,5,21,1,150,160,310,429
0132-000,2014,5,21,2,119,108,227,310
0132-000,2014,5,21,3,76,74,150,227
0132-000,2014,5,21,4,85,86,171,150
0132-000,2014,5,21,5,87,100,187,171
0132-000,2014,5,21,6,193,174,367,187
0132-000,2014,5,21,7,418,492,910,367
0132-000,2014,5,21,8,693,1594,2287,910
0132-000,2014,5,21,9,767,1336,2103,2287
0132-000,2014,5,21,10,733,867,1600,2103
0132-000,2014,5,21,11,730,799,1529,1600
0132-000,2014,5,21,12,754,773,1527,1529
0132-000,2014,5,21,13,701,707,1408,1527
0132-000,2014,5,21,14,801,810,1611,1408
0132-000,2014,5,21,15,860,840,1700,1611
0132-000,2014,5,21,16,859,791,1650,1700
0132-000,2014,5,21,17,958,815,1773,1650
0132-000,2014,5,21,18,1218,828,2046,1773
0132-000,2014,5,21,19,1336,873,2209,2046
0132-000,2014,5,21,20,943,674,1617,2209
0132-000,2014,5,21,21,737,490,1227,1617
0132-000,2014,5,21,22,615,512,1127,1227
0132-000,2014,5,21,23,384,314,698,1127
0132-000,2014,5,21,24,218,235,453,698
0132-000,2014,5,22,1,198,177,375,453
0132-000,2014,5,22,2,111,105,216,375
0132-000,2014,5,22,3,80,80,160,216
0132-000,2014,5,22,4,74,88,162,160
0132-000,2014,5,22,5,86,104,190,162
0132-000,2014,5,22,6,182,155,337,190
0132-000,2014,5,22,7,456,502,958,337
0132-000,2014,5,22,8,689,1587,2276,958
0132-000,2014,5,22,9,812,1322,2134,2276
0132-000,2014,5,22,10,766,851,1617,2134
0132-000,2014,5,22,11,710,744,1454,1617
0132-000,2014,5,22,12,796,758,1554,1454
0132-000,2014,5,22,13,715,735,1450,1554
0132-000,2014,5,22,14,762,743,1505,1450
0132-000,2014,5,22,15,856,785,1641,1505
0132-000,2014,5,22,16,824,842,1666,1641
0132-000,2014,5,22,17,875,828,1703,1666
0132-000,2014,5,22,18,1162,809,1971,1703
0132-000,2014,5,22,19,1221,814,2035,1971
0132-000,2014,5,22,20,953,685,1638,2035
0132-000,2014,5,22,21,771,503,1274,1638
0132-000,2014,5,22,22,628,487,1115,1274
0132-000,2014,5,22,23,377,361,738,1115
0132-000,2014,5,22,24,256,246,502,738
0132-000,2014,5,23,1,163,163,326,502
0132-000,2014,5,23,2,129,104,233,326
0132-000,2014,5,23,3,95,95,190,233
0132-000,2014,5,23,4,62,78,140,190
0132-000,2014,5,23,5,87,113,200,140
0132-000,2014,5,23,6,165,155,320,200
0132-000,2014,5,23,7,439,489,928,320
0132-000,2014,5,23,8,692,1554,2246,928
0132-000,2014,5,23,9,824,1316,2140,2246
0132-000,2014,5,23,10,731,843,1574,2140
0132-000,2014,5,23,11,799,890,1689,1574
0132-000,2014,5,23,12,789,824,1613,1689
0132-000,2014,5,23,13,722,759,1481,1613
0132-000,2014,5,23,14,839,798,1637,1481
0132-000,2014,5,23,15,865,832,1697,1637
0132-000,2014,5,23,16,913,825,1738,1697
0132-000,2014,5,23,17,985,872,1857,1738
0132-000,2014,5,23,18,1242,889,2131,1857
0132-000,2014,5,23,19,1482,976,2458,2131
0132-000,2014,5,23,20,1094,773,1867,2458
0132-000,2014,5,23,21,790,549,1339,1867
0132-000,2014,5,23,22,572,523,1095,1339
0132-000,2014,5,23,23,393,385,778,1095
0132-000,2014,5,23,24,301,263,564,778
0132-000,2014,5,24,1,201,181,382,564
0132-000,2014,5,24,2,154,138,292,382
0132-000,2014,5,24,3,93,125,218,292
0132-000,2014,5,24,4,113,108,221,218
0132-000,2014,5,24,5,114,112,226,221
0132-000,2014,5,24,6,207,180,387,226
0132-000,2014,5,24,7,380,392,772,387
0132-000,2014,5,24,8,554,839,1393,772
0132-000,2014,5,24,9,698,898,1596,1393
0132-000,2014,5,24,10,770,926,1696,1596
0132-000,2014,5,24,11,782,961,1743,1696
0132-000,2014,5,24,12,838,945,1783,1743
0132-000,2014,5,24,13,843,848,1691,1783
0132-000,2014,5,24,14,863,822,1685,1691
0132-000,2014,5,24,15,838,827,1665,1685
0132-000,2014,5,24,16,848,830,1678,1665
0132-000,2014,5,24,17,902,812,1714,1678
0132-000,2014,5,24,18,1210,915,2125,1714
0132-000,2014,5,24,19,1178,865,2043,2125
0132-000,2014,5,24,20,799,655,1454,2043
0132-000,2014,5,24,21,571,459,1030,1454
0132-000,2014,5,24,22,439,478,917,1030
0132-000,2014,5,24,23,335,314,649,917
0132-000,2014,5,24,24,219,255,474,649
0132-000,2014,5,25,1,171,206,377,474
0132-000,2014,5,25,2,135,128,263,377
0132-000,2014,5,25,3,106,113,219,263
0132-000,2014,5,25,4,97,105,202,219
0132-000,2014,5,25,5,84,74,158,202
0132-000,2014,5,25,6,148,133,281,158
0132-000,2014,5,25,7,250,244,494,281
0132-000,2014,5,25,8,304,423,727,494
0132-000,2014,5,25,9,417,471,888,727
0132-000,2014,5,25,10,456,525,981,888
0132-000,2014,5,25,11,529,604,1133,981
0132-000,2014,5,25,12,572,570,1142,1133
0132-000,2014,5,25,13,648,658,1306,1142
0132-000,2014,5,25,14,701,673,1374,1306
0132-000,2014,5,25,15,805,643,1448,1374
0132-000,2014,5,25,16,859,680,1539,1448
0132-000,2014,5,25,17,1074,706,1780,1539
0132-000,2014,5,25,18,1120,679,1799,1780
0132-000,2014,5,25,19,1033,591,1624,1799
0132-000,2014,5,25,20,807,506,1313,1624
0132-000,2014,5,25,21,633,480,1113,1313
0132-000,2014,5,25,22,443,373,816,1113
0132-000,2014,5,25,23,273,244,517,816
0132-000,2014,5,25,24,181,190,371,517
0132-000,2014,5,26,1,102,125,227,371
0132-000,2014,5,26,2,71,80,151,227
0132-000,2014,5,26,3,54,51,105,151
0132-000,2014,5,26,4,37,58,95,105
0132-000,2014,5,26,5,62,73,135,95
0132-000,2014,5,26,6,170,173,343,135
0132-000,2014,5,26,7,483,524,1007,343
0132-000,2014,5,26,8,673,1790,2463,1007
0132-000,2014,5,26,9,803,1392,2195,2463
0132-000,2014,5,26,10,744,857,1601,2195
0132-000,2014,5,26,11,718,797,1515,1601
0132-000,2014,5,26,12,788,822,1610,1515
0132-000,2014,5,26,13,694,777,1471,1610
0132-000,2014,5,26,14,779,801,1580,1471
0132-000,2014,5,26,15,848,794,1642,1580
0132-000,2014,5,26,16,912,807,1719,1642
0132-000,2014,5,26,17,904,801,1705,1719
0132-000,2014,5,26,18,1078,849,1927,1705
0132-000,2014,5,26,19,1241,821,2062,1927
0132-000,2014,5,26,20,918,643,1561,2062
0132-000,2014,5,26,21,895,567,1462,1561
0132-000,2014,5,26,22,588,480,1068,1462
0132-000,2014,5,26,23,359,329,688,1068
0132-000,2014,5,26,24,251,189,440,688
0132-000,2014,5,27,1,158,165,323,440
0132-000,2014,5,27,2,112,85,197,323
0132-000,2014,5,27,3,75,81,156,197
0132-000,2014,5,27,4,67,76,143,156
0132-000,2014,5,27,5,85,95,180,143
0132-000,2014,5,27,6,173,169,342,180
0132-000,2014,5,27,7,440,525,965,342
0132-000,2014,5,27,8,730,1639,2369,965
0132-000,2014,5,27,9,794,1263,2057,2369
0132-000,2014,5,27,10,777,872,1649,2057
0132-000,2014,5,27,11,728,786,1514,1649
0132-000,2014,5,27,12,746,814,1560,1514
0132-000,2014,5,27,13,725,723,1448,1560
0132-000,2014,5,27,14,751,727,1478,1448
0132-000,2014,5,27,15,858,876,1734,1478
0132-000,2014,5,27,16,878,814,1692,1734
0132-000,2014,5,27,17,939,759,1698,1692
0132-000,2014,5,27,18,1111,843,1954,1698
0132-000,2014,5,27,19,1202,902,2104,1954
0132-000,2014,5,27,20,897,657,1554,2104
0132-000,2014,5,27,21,809,518,1327,1554
0132-000,2014,5,27,22,650,460,1110,1327
0132-000,2014,5,27,23,363,321,684,1110
0132-000,2014,5,27,24,215,215,430,684
0132-000,2014,5,28,1,166,174,340,430
0132-000,2014,5,28,2,102,109,211,340
0132-000,2014,5,28,3,98,88,186,211
0132-000,2014,5,28,4,72,90,162,186
0132-000,2014,5,28,5,104,89,193,162
0132-000,2014,5,28,6,182,169,351,193
0132-000,2014,5,28,7,425,465,890,351
0132-000,2014,5,28,8,689,1587,2276,890
0132-000,2014,5,28,9,816,1322,2138,2276
0132-000,2014,5,28,10,767,852,1619,2138
0132-000,2014,5,28,11,736,843,1579,1619
0132-000,2014,5,28,12,766,772,1538,1579
0132-000,2014,5,28,13,741,755,1496,1538
0132-000,2014,5,28,14,816,782,1598,1496
0132-000,2014,5,28,15,822,875,1697,1598
0132-000,2014,5,28,16,918,762,1680,1697
0132-000,2014,5,28,17,876,779,1655,1680
0132-000,2014,5,28,18,1248,831,2079,1655
0132-000,2014,5,28,19,1273,878,2151,2079
0132-000,2014,5,28,20,982,663,1645,2151
0132-000,2014,5,28,21,809,515,1324,1645
0132-000,2014,5,28,22,583,466,1049,1324
0132-000,2014,5,28,23,383,335,718,1049
0132-000,2014,5,28,24,215,254,469,718
0132-000,2014,5,29,1,190,181,371,469
0132-000,2014,5,29,2,122,103,225,371
0132-000,2014,5,29,3,68,78,146,225
0132-000,2014,5,29,4,85,96,181,146
0132-000,2014,5,29,5,80,93,173,181
0132-000,2014,5,29,6,191,178,369,173
0132-000,2014,5,29,7,464,470,934,369
0132-000,2014,5,29,8,689,1636,2325,934
0132-000,2014,5,29,9,804,1299,2103,2325
0132-000,2014,5,29,10,767,900,1667,2103
0132-000,2014,5,29,11,772,816,1588,1667
0132-000,2014,5,29,12,785,810,1595,1588
0132-000,2014,5,29,13,687,678,1365,1595
0132-000,2014,5,29,14,787,768,1555,1365
0132-000,2014,5,29,15,824,780,1604,1555
0132-000,2014,5,29,16,865,779,1644,1604
0132-000,2014,5,29,17,878,798,1676,1644
0132-000,2014,5,29,18,1109,867,1976,1676
0132-000,2014,5,29,19,1232,853,2085,1976
0132-000,2014,5,29,20,926,716,1642,2085
0132-000,2014,5,29,21,847,538,1385,1642
0132-000,2014,5,29,22,647,469,1116,1385
0132-000,2014,5,29,23,410,338,748,1116
0132-000,2014,5,29,24,261,228,489,748
0132-000,2014,5,30,1,171,158,329,489
0132-000,2014,5,30,2,124,104,228,329
0132-000,2014,5,30,3,84,94,178,228
0132-000,2014,5,30,4,112,105,217,178
0132-000,2014,5,30,5,99,102,201,217
0132-000,2014,5,30,6,311,211,522,201
0132-000,2014,5,30,7,455,488,943,522
0132-000,2014,5,30,8,687,1643,2330,943
0132-000,2014,5,30,9,789,1253,2042,2330
0132-000,2014,5,30,10,762,896,1658,2042
0132-000,2014,5,30,11,794,794,1588,1658
0132-000,2014,5,30,12,797,859,1656,1588
0132-000,2014,5,30,13,723,755,1478,1656
0132-000,2014,5,30,14,813,796,1609,1478
0132-000,2014,5,30,15,904,787,1691,1609
0132-000,2014,5,30,16,861,842,1703,1691
0132-000,2014,5,30,17,969,888,1857,1703
0132-000,2014,5,30,18,1176,900,2076,1857
0132-000,2014,5,30,19,1437,922,2359,2076
0132-000,2014,5,30,20,1179,776,1955,2359
0132-000,2014,5,30,21,889,624,1513,1955
0132-000,2014,5,30,22,643,558,1201,1513
0132-000,2014,5,30,23,397,379,776,1201
0132-000,2014,5,30,24,278,284,562,776
0132-000,2014,5,31,1,229,208,437,562
0132-000,2014,5,31,2,150,167,317,437
0132-000,2014,5,31,3,120,158,278,317
0132-000,2014,5,31,4,110,112,222,278
0132-000,2014,5,31,5,102,139,241,222
0132-000,2014,5,31,6,206,191,397,241
0132-000,2014,5,31,7,392,388,780,397
0132-000,2014,5,31,8,545,839,1384,780
0132-000,2014,5,31,9,675,906,1581,1384
0132-000,2014,5,31,10,731,1025,1756,1581
0132-000,2014,5,31,11,736,984,1720,1756
0132-000,2014,5,31,12,857,1095,1952,1720
0132-000,2014,5,31,13,856,948,1804,1952
0132-000,2014,5,31,14,944,879,1823,1804
0132-000,2014,5,31,15,948,908,1856,1823
0132-000,2014,5,31,16,923,837,1760,1856
0132-000,2014,5,31,17,1021,855,1876,1760
0132-000,2014,5,31,18,1198,955,2153,1876
0132-000,2014,5,31,19,1182,901,2083,2153
0132-000,2014,5,31,20,785,625,1410,2083
0132-000,2014,5,31,21,646,601,1247,1410
0132-000,2014,5,31,22,516,437,953,1247
0132-000,2014,5,31,23,413,378,791,953
0132-000,2014,5,31,24,248,276,524,791
0132-000,2014,6,1,1,190,191,381,524
0132-000,2014,6,1,2,148,140,288,381
0132-000,2014,6,1,3,86,99,185,288
0132-000,2014,6,1,4,105,71,176,185
0132-000,2014,6,1,5,85,94,179,176
0132-000,2014,6,1,6,155,180,335,179
0132-000,2014,6,1,7,247,258,505,335
0132-000,2014,6,1,8,300,434,734,505
0132-000,2014,6,1,9,402,458,860,734
0132-000,2014,6,1,10,465,652,1117,860
0132-000,2014,6,1,11,522,695,1217,1117
0132-000,2014,6,1,12,591,699,1290,1217
0132-000,2014,6,1,13,620,714,1334,1290
0132-000,2014,6,1,14,706,709,1415,1334
0132-000,2014,6,1,15,821,705,1526,1415
0132-000,2014,6,1,16,912,719,1631,1526
0132-000,2014,6,1,17,1041,703,1744,1631
0132-000,2014,6,1,18,1040,728,1768,1744
0132-000,2014,6,1,19,1068,628,1696,1768
0132-000,2014,6,1,20,760,531,1291,1696
0132-000,2014,6,1,21,688,475,1163,1291
0132-000,2014,6,1,22,538,419,957,1163
0132-000,2014,6,1,23,335,245,580,957
0132-000,2014,6,1,24,190,178,368,580
0132-000,2014,6,2,1,122,145,267,368
0132-000,2014,6,2,2,79,84,163,267
0132-000,2014,6,2,3,38,53,91,163
0132-000,2014,6,2,4,61,73,134,91
0132-000,2014,6,2,5,84,81,165,134
0132-000,2014,6,2,6,197,183,380,165
0132-000,2014,6,2,7,495,555,1050,380
0132-000,2014,6,2,8,701,1797,2498,1050
0132-000,2014,6,2,9,807,1424,2231,2498
0132-000,2014,6,2,10,794,878,1672,2231
0132-000,2014,6,2,11,788,890,1678,1672
0132-000,2014,6,2,12,795,776,1571,1678
0132-000,2014,6,2,13,715,770,1485,1571
0132-000,2014,6,2,14,814,823,1637,1485
0132-000,2014,6,2,15,858,825,1683,1637
0132-000,2014,6,2,16,858,815,1673,1683
0132-000,2014,6,2,17,831,796,1627,1673
0132-000,2014,6,2,18,1078,841,1919,1627
0132-000,2014,6,2,19,1237,783,2020,1919
0132-000,2014,6,2,20,847,631,1478,2020
0132-000,2014,6,2,21,811,449,1260,1478
0132-000,2014,6,2,22,596,425,1021,1260
0132-000,2014,6,2,23,321,272,593,1021
0132-000,2014,6,2,24,201,168,369,593
0132-000,2014,6,3,1,143,173,316,369
0132-000,2014,6,3,2,101,80,181,316
0132-000,2014,6,3,3,85,72,157,181
0132-000,2014,6,3,4,64,84,148,157
0132-000,2014,6,3,5,82,94,176,148
0132-000,2014,6,3,6,123,146,269,176
0132-000,2014,6,3,7,360,394,754,269
0132-000,2014,6,3,8,604,1528,2132,754
0132-000,2014,6,3,9,798,1291,2089,2132
0132-000,2014,6,3,10,658,875,1533,2089
0132-000,2014,6,3,11,730,788,1518,1533
0132-000,2014,6,3,12,718,782,1500,1518
0132-000,2014,6,3,13,682,707,1389,1500
0132-000,2014,6,3,14,784,815,1599,1389
0132-000,2014,6,3,15,866,768,1634,1599
0132-000,2014,6,3,16,860,845,1705,1634
0132-000,2014,6,3,17,947,868,1815,1705
0132-000,2014,6,3,18,1170,852,2022,1815
0132-000,2014,6,3,19,1293,889,2182,2022
0132-000,2014,6,3,20,960,752,1712,2182
0132-000,2014,6,3,21,828,521,1349,1712
0132-000,2014,6,3,22,626,488,1114,1349
0132-000,2014,6,3,23,422,325,747,1114
0132-000,2014,6,3,24,243,221,464,747
0132-000,2014,6,4,1,204,215,419,464
0132-000,2014,6,4,2,136,139,275,419
0132-000,2014,6,4,3,102,109,211,275
0132-000,2014,6,4,4,100,111,211,211
0132-000,2014,6,4,5,119,109,228,211
0132-000,2014,6,4,6,161,173,334,228
0132-000,2014,6,4,7,363,329,692,334
0132-000,2014,6,4,8,537,845,1382,692
0132-000,2014,6,4,9,651,925,1576,1382
0132-000,2014,6,4,10,734,974,1708,1576
0132-000,2014,6,4,11,776,891,1667,1708
0132-000,2014,6,4,12,735,931,1666,1667
0132-000,2014,6,4,13,714,838,1552,1666
0132-000,2014,6,4,14,819,824,1643,1552
0132-000,2014,6,4,15,874,813,1687,1643
0132-000,2014,6,4,16,877,785,1662,1687
0132-000,2014,6,4,17,888,816,1704,1662
0132-000,2014,6,4,18,1043,824,1867,1704
0132-000,2014,6,4,19,1047,762,1809,1867
0132-000,2014,6,4,20,711,629,1340,1809
0132-000,2014,6,4,21,635,494,1129,1340
0132-000,2014,6,4,22,492,439,931,1129
0132-000,2014,6,4,23,314,299,613,931
0132-000,2014,6,4,24,197,202,399,613
0132-000,2014,6,5,1,162,149,311,399
0132-000,2014,6,5,2,92,102,194,311
0132-000,2014,6,5,3,86,71,157,194
0132-000,2014,6,5,4,71,102,173,157
0132-000,2014,6,5,5,109,105,214,173
0132-000,2014,6,5,6,211,183,394,214
0132-000,2014,6,5,7,440,505,945,394
0132-000,2014,6,5,8,682,1503,2185,945
0132-000,2014,6,5,9,816,1289,2105,2185
0132-000,2014,6,5,10,764,927,1691,2105
0132-000,2014,6,5,11,769,908,1677,1691
0132-000,2014,6,5,12,799,840,1639,1677
0132-000,2014,6,5,13,799,828,1627,1639
0132-000,2014,6,5,14,901,891,1792,1627
0132-000,2014,6,5,15,922,896,1818,1792
0132-000,2014,6,5,16,938,858,1796,1818
0132-000,2014,6,5,17,1059,904,1963,1796
0132-000,2014,6,5,18,1214,913,2127,1963
0132-000,2014,6,5,19,1336,987,2323,2127
0132-000,2014,6,5,20,1066,832,1898,2323
0132-000,2014,6,5,21,849,616,1465,1898
0132-000,2014,6,5,22,657,507,1164,1465
0132-000,2014,6,5,23,401,389,790,1164
0132-000,2014,6,5,24,277,275,552,790
0132-000,2014,6,6,1,226,211,437,552
0132-000,2014,6,6,2,139,143,282,437
0132-000,2014,6,6,3,101,133,234,282
0132-000,2014,6,6,4,106,121,227,234
0132-000,2014,6,6,5,125,128,253,227
0132-000,2014,6,6,6,183,219,402,253
0132-000,2014,6,6,7,380,443,823,402
0132-000,2014,6,6,8,541,862,1403,823
0132-000,2014,6,6,9,599,1104,1703,1403
0132-000,2014,6,6,10,637,1450,2087,1703
0132-000,2014,6,6,11,694,1541,2235,2087
0132-000,2014,6,6,12,674,1757,2431,2235
0132-000,2014,6,6,13,674,1746,2420,2431
0132-000,2014,6,6,14,734,1748,2482,2420
0132-000,2014,6,6,15,800,1670,2470,2482
0132-000,2014,6,6,16,909,1462,2371,2470
0132-000,2014,6,6,17,870,1105,1975,2371
0132-000,2014,6,6,18,1228,960,2188,1975
0132-000,2014,6,6,19,1056,835,1891,2188
0132-000,2014,6,6,20,912,623,1535,1891
0132-000,2014,6,6,21,740,554,1294,1535
0132-000,2014,6,6,22,588,432,1020,1294
0132-000,2014,6,6,23,386,318,704,1020
0132-000,2014,6,6,24,214,243,457,704
0132-000,2014,6,7,1,166,177,343,457
0132-000,2014,6,7,2,123,113,236,343
0132-000,2014,6,7,3,100,85,185,236
0132-000,2014,6,7,4,86,92,178,185
0132-000,2014,6,7,5,98,107,205,178
0132-000,2014,6,7,6,155,179,334,205
0132-000,2014,6,7,7,377,315,692,334
0132-000,2014,6,7,8,473,687,1160,692
0132-000,2014,6,7,9,536,721,1257,1160
0132-000,2014,6,7,10,657,775,1432,1257
0132-000,2014,6,7,11,734,812,1546,1432
0132-000,2014,6,7,12,742,778,1520,1546
0132-000,2014,6,7,13,772,817,1589,1520
0132-000,2014,6,7,14,773,826,1599,1589
0132-000,2014,6,7,15,862,763,1625,1599
0132-000,2014,6,7,16,995,856,1851,1625
0132-000,2014,6,7,17,1251,858,2109,1851
0132-000,2014,6,7,18,1394,788,2182,2109
0132-000,2014,6,7,19,1459,761,2220,2182
0132-000,2014,6,7,20,1387,563,1950,2220
0132-000,2014,6,7,21,1167,548,1715,1950
0132-000,2014,6,7,22,975,399,1374,1715
0132-000,2014,6,7,23,593,303,896,1374
0132-000,2014,6,7,24,351,278,629,896
0132-000,2014,6,8,1,177,169,346,629
0132-000,2014,6,8,2,139,137,276,346
0132-000,2014,6,8,3,83,95,178,276
0132-000,2014,6,8,4,73,80,153,178
0132-000,2014,6,8,5,88,116,204,153
0132-000,2014,6,8,6,139,136,275,204
0132-000,2014,6,8,7,271,217,488,275
0132-000,2014,6,8,8,290,325,615,488
0132-000,2014,6,8,9,355,430,785,615
0132-000,2014,6,8,10,439,528,967,785
0132-000,2014,6,8,11,541,603,1144,967
0132-000,2014,6,8,12,809,608,1417,1144
0132-000,2014,6,8,13,1053,604,1657,1417
0132-000,2014,6,8,14,1041,675,1716,1657
0132-000,2014,6,8,15,1145,676,1821,1716
0132-000,2014,6,8,16,1328,721,2049,1821
0132-000,2014,6,8,17,1268,707,1975,2049
0132-000,2014,6,8,18,1298,642,1940,1975
0132-000,2014,6,8,19,1363,673,2036,1940
0132-000,2014,6,8,20,1030,531,1561,2036
0132-000,2014,6,8,21,810,464,1274,1561
0132-000,2014,6,8,22,514,429,943,1274
0132-000,2014,6,8,23,347,279,626,943
0132-000,2014,6,8,24,207,221,428,626
0132-000,2014,6,9,1,153,126,279,428
0132-000,2014,6,9,2,92,97,189,279
0132-000,2014,6,9,3,72,72,144,189
0132-000,2014,6,9,4,54,70,124,144
0132-000,2014,6,9,5,109,103,212,124
0132-000,2014,6,9,6,192,211,403,212
0132-000,2014,6,9,7,489,570,1059,403
0132-000,2014,6,9,8,703,1852,2555,1059
0132-000,2014,6,9,9,810,1343,2153,2555
0132-000,2014,6,9,10,811,897,1708,2153
0132-000,2014,6,9,11,820,875,1695,1708
0132-000,2014,6,9,12,728,964,1692,1695
0132-000,2014,6,9,13,747,993,1740,1692
0132-000,2014,6,9,14,823,875,1698,1740
0132-000,2014,6,9,15,881,873,1754,1698
0132-000,2014,6,9,16,916,800,1716,1754
0132-000,2014,6,9,17,937,830,1767,1716
0132-000,2014,6,9,18,1119,839,1958,1767
0132-000,2014,6,9,19,1207,905,2112,1958
0132-000,2014,6,9,20,917,677,1594,2112
0132-000,2014,6,9,21,852,516,1368,1594
0132-000,2014,6,9,22,627,441,1068,1368
0132-000,2014,6,9,23,401,345,746,1068
0132-000,2014,6,9,24,226,213,439,746
0132-000,2014,6,10,1,164,149,313,439
0132-000,2014,6,10,2,106,82,188,313
0132-000,2014,6,10,3,97,84,181,188
0132-000,2014,6,10,4,65,85,150,181
0132-000,2014,6,10,5,91,105,196,150
0132-000,2014,6,10,6,189,180,369,196
0132-000,2014,6,10,7,434,509,943,369
0132-000,2014,6,10,8,675,1641,2316,943
0132-000,2014,6,10,9,763,1265,2028,2316
0132-000,2014,6,10,10,733,881,1614,2028
0132-000,2014,6,10,11,747,839,1586,1614
0132-000,2014,6,10,12,795,789,1584,1586
0132-000,2014,6,10,13,730,760,1490,1584
0132-000,2014,6,10,14,941,817,1758,1490
0132-000,2014,6,10,15,865,783,1648,1758
0132-000,2014,6,10,16,848,729,1577,1648
0132-000,2014,6,10,17,912,789,1701,1577
0132-000,2014,6,10,18,1064,855,1919,1701
0132-000,2014,6,10,19,1218,838,2056,1919
0132-000,2014,6,10,20,867,734,1601,2056
0132-000,2014,6,10,21,870,559,1429,1601
0132-000,2014,6,10,22,671,448,1119,1429
0132-000,2014,6,10,23,402,301,703,1119
0132-000,2014,6,10,24,250,195,445,703
0132-000,2014,6,11,1,177,183,360,445
0132-000,2014,6,11,2,88,100,188,360
0132-000,2014,6,11,3,104,88,192,188
0132-000,2014,6,11,4,67,96,163,192
0132-000,2014,6,11,5,93,108,201,163
0132-000,2014,6,11,6,160,156,316,201
0132-000,2014,6,11,7,382,460,842,316
0132-000,2014,6,11,8,684,1568,2252,842
0132-000,2014,6,11,9,798,1331,2129,2252
0132-000,2014,6,11,10,723,889,1612,2129
0132-000,2014,6,11,11,727,879,1606,1612
0132-000,2014,6,11,12,792,809,1601,1606
0132-000,2014,6,11,13,719,694,1413,1601
0132-000,2014,6,11,14,756,843,1599,1413
0132-000,2014,6,11,15,858,818,1676,1599
0132-000,2014,6,11,16,933,822,1755,1676
0132-000,2014,6,11,17,948,757,1705,1755
0132-000,2014,6,11,18,1227,830,2057,1705
0132-000,2014,6,11,19,1323,887,2210,2057
0132-000,2014,6,11,20,927,653,1580,2210
0132-000,2014,6,11,21,769,554,1323,1580
0132-000,2014,6,11,22,605,469,1074,1323
0132-000,2014,6,11,23,358,293,651,1074
0132-000,2014,6,11,24,229,222,451,651
0132-000,2014,6,12,1,191,165,356,451
0132-000,2014,6,12,2,128,102,230,356
0132-000,2014,6,12,3,96,101,197,230
0132-000,2014,6,12,4,96,100,196,197
0132-000,2014,6,12,5,96,115,211,196
0132-000,2014,6,12,6,186,190,376,211
0132-000,2014,6,12,7,446,484,930,376
0132-000,2014,6,12,8,652,1676,2328,930
0132-000,2014,6,12,9,811,1287,2098,2328
0132-000,2014,6,12,10,733,844,1577,2098
0132-000,2014,6,12,11,739,842,1581,1577
0132-000,2014,6,12,12,774,844,1618,1581
0132-000,2014,6,12,13,675,756,1431,1618
0132-000,2014,6,12,14,734,726,1460,1431
0132-000,2014,6,12,15,748,873,1621,1460
0132-000,2014,6,12,16,910,852,1762,1621
0132-000,2014,6,12,17,1047,840,1887,1762
0132-000,2014,6,12,18,1236,817,2053,1887
0132-000,2014,6,12,19,1281,850,2131,2053
0132-000,2014,6,12,20,955,684,1639,2131
0132-000,2014,6,12,21,831,550,1381,1639
0132-000,2014,6,12,22,618,427,1045,1381
0132-000,2014,6,12,23,416,351,767,1045
0132-000,2014,6,12,24,262,214,476,767
0132-000,2014,6,13,1,185,169,354,476
0132-000,2014,6,13,2,116,129,245,354
0132-000,2014,6,13,3,84,104,188,245
0132-000,2014,6,13,4,87,86,173,188
0132-000,2014,6,13,5,97,120,217,173
0132-000,2014,6,13,6,175,202,377,217
0132-000,2014,6,13,7,403,460,863,377
0132-000,2014,6,13,8,668,1589,2257,863
0132-000,2014,6,13,9,792,1304,2096,2257
0132-000,2014,6,13,10,785,883,1668,2096
0132-000,2014,6,13,11,809,882,1691,1668
0132-000,2014,6,13,12,821,804,1625,1691
0132-000,2014,6,13,13,730,789,1519,1625
0132-000,2014,6,13,14,846,807,1653,1519
0132-000,2014,6,13,15,917,834,1751,1653
0132-000,2014,6,13,16,941,816,1757,1751
0132-000,2014,6,13,17,975,873,1848,1757
0132-000,2014,6,13,18,1260,841,2101,1848
0132-000,2014,6,13,19,1426,937,2363,2101
0132-000,2014,6,13,20,1111,751,1862,2363
0132-000,2014,6,13,21,927,639,1566,1862
0132-000,2014,6,13,22,633,521,1154,1566
0132-000,2014,6,13,23,418,350,768,1154
0132-000,2014,6,13,24,265,273,538,768
0132-000,2014,6,14,1,207,210,417,538
0132-000,2014,6,14,2,169,160,329,417
0132-000,2014,6,14,3,104,105,209,329
0132-000,2014,6,14,4,97,130,227,209
0132-000,2014,6,14,5,135,137,272,227
0132-000,2014,6,14,6,161,207,368,272
0132-000,2014,6,14,7,384,374,758,368
0132-000,2014,6,14,8,575,827,1402,758
0132-000,2014,6,14,9,691,886,1577,1402
0132-000,2014,6,14,10,812,989,1801,1577
0132-000,2014,6,14,11,788,990,1778,1801
0132-000,2014,6,14,12,830,1131,1961,1778
0132-000,2014,6,14,13,850,1017,1867,1961
0132-000,2014,6,14,14,869,890,1759,1867
0132-000,2014,6,14,15,891,862,1753,1759
0132-000,2014,6,14,16,904,844,1748,1753
0132-000,2014,6,14,17,970,897,1867,1748
0132-000,2014,6,14,18,1210,973,2183,1867
0132-000,2014,6,14,19,1206,916,2122,2183
0132-000,2014,6,14,20,806,764,1570,2122
0132-000,2014,6,14,21,667,550,1217,1570
0132-000,2014,6,14,22,566,517,1083,1217
0132-000,2014,6,14,23,401,382,783,1083
0132-000,2014,6,14,24,278,275,553,783
0132-000,2014,6,15,1,209,195,404,553
0132-000,2014,6,15,2,189,159,348,404
0132-000,2014,6,15,3,106,102,208,348
0132-000,2014,6,15,4,105,90,195,208
0132-000,2014,6,15,5,101,114,215,195
0132-000,2014,6,15,6,166,145,311,215
0132-000,2014,6,15,7,208,240,448,311
0132-000,2014,6,15,8,317,316,633,448
0132-000,2014,6,15,9,373,412,785,633
0132-000,2014,6,15,10,514,551,1065,785
0132-000,2014,6,15,11,521,630,1151,1065
0132-000,2014,6,15,12,553,668,1221,1151
0132-000,2014,6,15,13,611,655,1266,1221
0132-000,2014,6,15,14,710,714,1424,1266
0132-000,2014,6,15,15,727,733,1460,1424
0132-000,2014,6,15,16,820,670,1490,1460
0132-000,2014,6,15,17,1004,718,1722,1490
0132-000,2014,6,15,18,1119,726,1845,1722
0132-000,2014,6,15,19,1072,655,1727,1845
0132-000,2014,6,15,20,877,551,1428,1727
0132-000,2014,6,15,21,698,518,1216,1428
0132-000,2014,6,15,22,532,413,945,1216
0132-000,2014,6,15,23,369,326,695,945
0132-000,2014,6,15,24,201,203,404,695
0132-000,2014,6,16,1,116,154,270,404
0132-000,2014,6,16,2,88,75,163,270
0132-000,2014,6,16,3,54,70,124,163
0132-000,2014,6,16,4,56,69,125,124
0132-000,2014,6,16,5,95,111,206,125
0132-000,2014,6,16,6,205,224,429,206
0132-000,2014,6,16,7,505,601,1106,429
0132-000,2014,6,16,8,708,1807,2515,1106
0132-000,2014,6,16,9,861,1276,2137,2515
0132-000,2014,6,16,10,728,880,1608,2137
0132-000,2014,6,16,11,766,916,1682,1608
0132-000,2014,6,16,12,832,828,1660,1682
0132-000,2014,6,16,13,745,831,1576,1660
0132-000,2014,6,16,14,780,793,1573,1576
0132-000,2014,6,16,15,915,864,1779,1573
0132-000,2014,6,16,16,902,826,1728,1779
0132-000,2014,6,16,17,923,855,1778,1728
0132-000,2014,6,16,18,1059,827,1886,1778
0132-000,2014,6,16,19,1334,858,2192,1886
0132-000,2014,6,16,20,898,680,1578,2192
0132-000,2014,6,16,21,832,522,1354,1578
0132-000,2014,6,16,22,631,447,1078,1354
0132-000,2014,6,16,23,353,303,656,1078
0132-000,2014,6,16,24,202,217,419,656
0132-000,2014,6,17,1,158,163,321,419
0132-000,2014,6,17,2,101,102,203,321
0132-000,2014,6,17,3,83,82,165,203
0132-000,2014,6,17,4,70,105,175,165
0132-000,2014,6,17,5,108,96,204,175
0132-000,2014,6,17,6,187,171,358,204
0132-000,2014,6,17,7,439,486,925,358
0132-000,2014,6,17,8,690,1652,2342,925
0132-000,2014,6,17,9,819,1236,2055,2342
0132-000,2014,6,17,10,780,891,1671,2055
0132-000,2014,6,17,11,783,910,1693,1671
0132-000,2014,6,17,12,824,832,1656,1693
0132-000,2014,6,17,13,736,756,1492,1656
0132-000,2014,6,17,14,797,824,1621,1492
0132-000,2014,6,17,15,875,834,1709,1621
0132-000,2014,6,17,16,932,766,1698,1709
0132-000,2014,6,17,17,937,837,1774,1698
0132-000,2014,6,17,18,1096,871,1967,1774
0132-000,2014,6,17,19,1289,899,2188,1967
0132-000,2014,6,17,20,935,655,1590,2188
0132-000,2014,6,17,21,769,541,1310,1590
0132-000,2014,6,17,22,667,469,1136,1310
0132-000,2014,6,17,23,394,317,711,1136
0132-000,2014,6,17,24,243,206,449,711
0132-000,2014,6,18,1,160,146,306,449
0132-000,2014,6,18,2,100,88,188,306
0132-000,2014,6,18,3,83,87,170,188
0132-000,2014,6,18,4,62,99,161,170
0132-000,2014,6,18,5,98,110,208,161
0132-000,2014,6,18,6,173,177,350,208
0132-000,2014,6,18,7,482,654,1136,350
0132-000,2014,6,18,8,655,1438,2093,1136
0132-000,2014,6,18,9,699,1058,1757,2093
0132-000,2014,6,18,10,791,1018,1809,1757
0132-000,2014,6,18,11,772,834,1606,1809
0132-000,2014,6,18,12,852,777,1629,1606
0132-000,2014,6,18,13,708,781,1489,1629
0132-000,2014,6,18,14,829,777,1606,1489
0132-000,2014,6,18,15,898,782,1680,1606
0132-000,2014,6,18,16,878,865,1743,1680
0132-000,2014,6,18,17,951,851,1802,1743
0132-000,2014,6,18,18,1154,873,2027,1802
0132-000,2014,6,18,19,1321,898,2219,2027
0132-000,2014,6,18,20,918,666,1584,2219
0132-000,2014,6,18,21,813,571,1384,1584
0132-000,2014,6,18,22,588,460,1048,1384
0132-000,2014,6,18,23,375,317,692,1048
0132-000,2014,6,18,24,265,242,507,692
0132-000,2014,6,19,1,190,167,357,507
0132-000,2014,6,19,2,104,114,218,357
0132-000,2014,6,19,3,95,95,190,218
0132-000,2014,6,19,4,86,91,177,190
0132-000,2014,6,19,5,109,121,230,177
0132-000,2014,6,19,6,203,183,386,230
0132-000,2014,6,19,7,436,479,915,386
0132-000,2014,6,19,8,689,1641,2330,915
0132-000,2014,6,19,9,857,1305,2162,2330
0132-000,2014,6,19,10,746,870,1616,2162
0132-000,2014,6,19,11,759,824,1583,1616
0132-000,2014,6,19,12,750,758,1508,1583
0132-000,2014,6,19,13,730,789,1519,1508
0132-000,2014,6,19,14,868,767,1635,1519
0132-000,2014,6,19,15,831,819,1650,1635
0132-000,2014,6,19,16,970,827,1797,1650
0132-000,2014,6,19,17,945,778,1723,1797
0132-000,2014,6,19,18,1099,822,1921,1723
0132-000,2014,6,19,19,1252,876,2128,1921
0132-000,2014,6,19,20,829,675,1504,2128
0132-000,2014,6,19,21,794,568,1362,1504
0132-000,2014,6,19,22,670,427,1097,1362
0132-000,2014,6,19,23,372,322,694,1097
0132-000,2014,6,19,24,240,212,452,694
0132-000,2014,6,20,1,156,170,326,452
0132-000,2014,6,20,2,108,95,203,326
0132-000,2014,6,20,3,95,94,189,203
0132-000,2014,6,20,4,56,82,138,189
0132-000,2014,6,20,5,99,131,230,138
0132-000,2014,6,20,6,199,183,382,230
0132-000,2014,6,20,7,411,470,881,382
0132-000,2014,6,20,8,669,1604,2273,881
0132-000,2014,6,20,9,840,1229,2069,2273
0132-000,2014,6,20,10,781,904,1685,2069
0132-000,2014,6,20,11,773,852,1625,1685
0132-000,2014,6,20,12,826,837,1663,1625
0132-000,2014,6,20,13,801,788,1589,1663
0132-000,2014,6,20,14,893,857,1750,1589
0132-000,2014,6,20,15,890,880,1770,1750
0132-000,2014,6,20,16,899,879,1778,1770
0132-000,2014,6,20,17,960,887,1847,1778
0132-000,2014,6,20,18,1288,941,2229,1847
0132-000,2014,6,20,19,1525,974,2499,2229
0132-000,2014,6,20,20,1082,819,1901,2499
0132-000,2014,6,20,21,928,636,1564,1901
0132-000,2014,6,20,22,626,495,1121,1564
0132-000,2014,6,20,23,434,374,808,1121
0132-000,2014,6,20,24,259,229,488,808
0132-000,2014,6,21,1,209,194,403,488
0132-000,2014,6,21,2,156,154,310,403
0132-000,2014,6,21,3,124,117,241,310
0132-000,2014,6,21,4,105,100,205,241
0132-000,2014,6,21,5,107,121,228,205
0132-000,2014,6,21,6,186,196,382,228
0132-000,2014,6,21,7,355,392,747,382
0132-000,2014,6,21,8,516,834,1350,747
0132-000,2014,6,21,9,673,867,1540,1350
0132-000,2014,6,21,10,723,915,1638,1540
0132-000,2014,6,21,11,739,1027,1766,1638
0132-000,2014,6,21,12,866,1118,1984,1766
0132-000,2014,6,21,13,809,1035,1844,1984
0132-000,2014,6,21,14,895,951,1846,1844
0132-000,2014,6,21,15,953,871,1824,1846
0132-000,2014,6,21,16,937,914,1851,1824
0132-000,2014,6,21,17,981,943,1924,1851
0132-000,2014,6,21,18,1252,955,2207,1924
0132-000,2014,6,21,19,1181,952,2133,2207
0132-000,2014,6,21,20,761,616,1377,2133
0132-000,2014,6,21,21,639,522,1161,1377
0132-000,2014,6,21,22,543,477,1020,1161
0132-000,2014,6,21,23,399,365,764,1020
0132-000,2014,6,21,24,304,251,555,764
0132-000,2014,6,22,1,183,176,359,555
0132-000,2014,6,22,2,139,147,286,359
0132-000,2014,6,22,3,120,124,244,286
0132-000,2014,6,22,4,101,92,193,244
0132-000,2014,6,22,5,96,105,201,193
0132-000,2014,6,22,6,145,143,288,201
0132-000,2014,6,22,7,223,246,469,288
0132-000,2014,6,22,8,346,371,717,469
0132-000,2014,6,22,9,384,470,854,717
0132-000,2014,6,22,10,454,587,1041,854
0132-000,2014,6,22,11,517,675,1192,1041
0132-000,2014,6,22,12,598,678,1276,1192
0132-000,2014,6,22,13,642,656,1298,1276
0132-000,2014,6,22,14,760,684,1444,1298
0132-000,2014,6,22,15,742,630,1372,1444
0132-000,2014,6,22,16,926,716,1642,1372
0132-000,2014,6,22,17,1210,714,1924,1642
0132-000,2014,6,22,18,1303,720,2023,1924
0132-000,2014,6,22,19,1163,636,1799,2023
0132-000,2014,6,22,20,1001,573,1574,1799
0132-000,2014,6,22,21,789,495,1284,1574
0132-000,2014,6,22,22,569,442,1011,1284
0132-000,2014,6,22,23,331,271,602,1011
0132-000,2014,6,22,24,181,221,402,602
0132-000,2014,6,23,1,111,132,243,402
0132-000,2014,6,23,2,65,81,146,243
0132-000,2014,6,23,3,45,65,110,146
0132-000,2014,6,23,4,51,80,131,110
0132-000,2014,6,23,5,100,82,182,131
0132-000,2014,6,23,6,183,187,370,182
0132-000,2014,6,23,7,484,611,1095,370
0132-000,2014,6,23,8,699,1782,2481,1095
0132-000,2014,6,23,9,817,1294,2111,2481
0132-000,2014,6,23,10,700,853,1553,2111
0132-000,2014,6,23,11,736,821,1557,1553
0132-000,2014,6,23,12,758,881,1639,1557
0132-000,2014,6,23,13,675,729,1404,1639
0132-000,2014,6,23,14,731,735,1466,1404
0132-000,2014,6,23,15,846,795,1641,1466
0132-000,2014,6,23,16,860,809,1669,1641
0132-000,2014,6,23,17,946,822,1768,1669
0132-000,2014,6,23,18,1114,836,1950,1768
0132-000,2014,6,23,19,1271,902,2173,1950
0132-000,2014,6,23,20,941,663,1604,2173
0132-000,2014,6,23,21,831,599,1430,1604
0132-000,2014,6,23,22,606,421,1027,1430
0132-000,2014,6,23,23,380,325,705,1027
0132-000,2014,6,23,24,210,179,389,705
0132-000,2014,6,24,1,177,139,316,389
0132-000,2014,6,24,2,114,99,213,316
0132-000,2014,6,24,3,79,95,174,213
0132-000,2014,6,24,4,70,85,155,174
0132-000,2014,6,24,5,81,104,185,155
0132-000,2014,6,24,6,187,165,352,185
0132-000,2014,6,24,7,456,513,969,352
0132-000,2014,6,24,8,710,1686,2396,969
0132-000,2014,6,24,9,840,1252,2092,2396
0132-000,2014,6,24,10,759,839,1598,2092
0132-000,2014,6,24,11,758,853,1611,1598
0132-000,2014,6,24,12,768,819,1587,1611
0132-000,2014,6,24,13,720,723,1443,1587
0132-000,2014,6,24,14,804,789,1593,1443
0132-000,2014,6,24,15,830,827,1657,1593
0132-000,2014,6,24,16,898,809,1707,1657
0132-000,2014,6,24,17,920,818,1738,1707
0132-000,2014,6,24,18,1143,816,1959,1738
0132-000,2014,6,24,19,1217,846,2063,1959
0132-000,2014,6,24,20,926,692,1618,2063
0132-000,2014,6,24,21,856,541,1397,1618
0132-000,2014,6,24,22,639,461,1100,1397
0132-000,2014,6,24,23,375,328,703,1100
0132-000,2014,6,24,24,247,212,459,703
0132-000,2014,6,25,1,151,139,290,459
0132-000,2014,6,25,2,99,105,204,290
0132-000,2014,6,25,3,75,80,155,204
0132-000,2014,6,25,4,80,97,177,155
0132-000,2014,6,25,5,98,114,212,177
0132-000,2014,6,25,6,176,190,366,212
0132-000,2014,6,25,7,406,451,857,366
0132-000,2014,6,25,8,684,1628,2312,857
0132-000,2014,6,25,9,787,1263,2050,2312
0132-000,2014,6,25,10,775,818,1593,2050
0132-000,2014,6,25,11,728,848,1576,1593
0132-000,2014,6,25,12,784,783,1567,1576
0132-000,2014,6,25,13,665,707,1372,1567
0132-000,2014,6,25,14,777,741,1518,1372
0132-000,2014,6,25,15,866,896,1762,1518
0132-000,2014,6,25,16,885,793,1678,1762
0132-000,2014,6,25,17,911,833,1744,1678
0132-000,2014,6,25,18,1140,846,1986,1744
0132-000,2014,6,25,19,1366,819,2185,1986
0132-000,2014,6,25,20,914,685,1599,2185
0132-000,2014,6,25,21,772,536,1308,1599
0132-000,2014,6,25,22,591,410,1001,1308
0132-000,2014,6,25,23,380,305,685,1001
0132-000,2014,6,25,24,204,249,453,685
0132-000,2014,6,26,1,188,166,354,453
0132-000,2014,6,26,2,119,115,234,354
0132-000,2014,6,26,3,91,100,191,234
0132-000,2014,6,26,4,69,110,179,191
0132-000,2014,6,26,5,93,103,196,179
0132-000,2014,6,26,6,209,178,387,196
0132-000,2014,6,26,7,413,499,912,387
0132-000,2014,6,26,8,652,1671,2323,912
0132-000,2014,6,26,9,813,1269,2082,2323
0132-000,2014,6,26,10,739,848,1587,2082
0132-000,2014,6,26,11,719,844,1563,1587
0132-000,2014,6,26,12,822,782,1604,1563
0132-000,2014,6,26,13,707,721,1428,1604
0132-000,2014,6,26,14,788,773,1561,1428
0132-000,2014,6,26,15,775,819,1594,1561
0132-000,2014,6,26,16,889,788,1677,1594
0132-000,2014,6,26,17,866,875,1741,1677
0132-000,2014,6,26,18,1089,839,1928,1741
0132-000,2014,6,26,19,1261,824,2085,1928
0132-000,2014,6,26,20,892,672,1564,2085
0132-000,2014,6,26,21,867,516,1383,1564
0132-000,2014,6,26,22,592,427,1019,1383
0132-000,2014,6,26,23,372,282,654,1019
0132-000,2014,6,26,24,273,218,491,654
0132-000,2014,6,27,1,196,165,361,491
0132-000,2014,6,27,2,86,102,188,361
0132-000,2014,6,27,3,86,73,159,188
0132-000,2014,6,27,4,68,102,170,159
0132-000,2014,6,27,5,118,101,219,170
0132-000,2014,6,27,6,166,173,339,219
0132-000,2014,6,27,7,425,465,890,339
0132-000,2014,6,27,8,689,1638,2327,890
0132-000,2014,6,27,9,817,1206,2023,2327
0132-000,2014,6,27,10,769,834,1603,2023
0132-000,2014,6,27,11,741,917,1658,1603
0132-000,2014,6,27,12,810,818,1628,1658
0132-000,2014,6,27,13,789,724,1513,1628
0132-000,2014,6,27,14,834,790,1624,1513
0132-000,2014,6,27,15,920,821,1741,1624
0132-000,2014,6,27,16,901,807,1708,1741
0132-000,2014,6,27,17,901,867,1768,1708
0132-000,2014,6,27,18,1221,873,2094,1768
0132-000,2014,6,27,19,1534,988,2522,2094
0132-000,2014,6,27,20,1174,828,2002,2522
0132-000,2014,6,27,21,895,608,1503,2002
0132-000,2014,6,27,22,651,536,1187,1503
0132-000,2014,6,27,23,476,358,834,1187
0132-000,2014,6,27,24,269,264,533,834
0132-000,2014,6,28,1,195,183,378,533
0132-000,2014,6,28,2,146,155,301,378
0132-000,2014,6,28,3,98,130,228,301
0132-000,2014,6,28,4,102,108,210,228
0132-000,2014,6,28,5,96,126,222,210
0132-000,2014,6,28,6,199,193,392,222
0132-000,2014,6,28,7,353,407,760,392
0132-000,2014,6,28,8,514,836,1350,760
0132-000,2014,6,28,9,683,823,1506,1350
0132-000,2014,6,28,10,726,927,1653,1506
0132-000,2014,6,28,11,768,923,1691,1653
0132-000,2014,6,28,12,801,914,1715,1691
0132-000,2014,6,28,13,837,969,1806,1715
0132-000,2014,6,28,14,869,1004,1873,1806
0132-000,2014,6,28,15,837,935,1772,1873
0132-000,2014,6,28,16,874,890,1764,1772
0132-000,2014,6,28,17,964,877,1841,1764
0132-000,2014,6,28,18,1234,911,2145,1841
0132-000,2014,6,28,19,1165,922,2087,2145
0132-000,2014,6,28,20,826,680,1506,2087
0132-000,2014,6,28,21,629,544,1173,1506
0132-000,2014,6,28,22,555,483,1038,1173
0132-000,2014,6,28,23,403,346,749,1038
0132-000,2014,6,28,24,257,287,544,749
0132-000,2014,6,29,1,185,206,391,544
0132-000,2014,6,29,2,151,151,302,391
0132-000,2014,6,29,3,103,101,204,302
0132-000,2014,6,29,4,84,83,167,204
0132-000,2014,6,29,5,101,101,202,167
0132-000,2014,6,29,6,133,163,296,202
0132-000,2014,6,29,7,226,213,439,296
0132-000,2014,6,29,8,293,367,660,439
0132-000,2014,6,29,9,361,489,850,660
0132-000,2014,6,29,10,451,581,1032,850
0132-000,2014,6,29,11,530,623,1153,1032
0132-000,2014,6,29,12,572,663,1235,1153
0132-000,2014,6,29,13,654,657,1311,1235
0132-000,2014,6,29,14,713,675,1388,1311
0132-000,2014,6,29,15,726,714,1440,1388
0132-000,2014,6,29,16,849,695,1544,1440
0132-000,2014,6,29,17,1103,702,1805,1544
0132-000,2014,6,29,18,1182,657,1839,1805
0132-000,2014,6,29,19,1180,590,1770,1839
0132-000,2014,6,29,20,884,573,1457,1770
0132-000,2014,6,29,21,641,517,1158,1457
0132-000,2014,6,29,22,482,387,869,1158
0132-000,2014,6,29,23,312,278,590,869
0132-000,2014,6,29,24,169,204,373,590
0132-000,2014,6,30,1,143,142,285,373
0132-000,2014,6,30,2,74,96,170,285
0132-000,2014,6,30,3,43,67,110,170
0132-000,2014,6,30,4,61,77,138,110
0132-000,2014,6,30,5,89,83,172,138
0132-000,2014,6,30,6,215,229,444,172
0132-000,2014,6,30,7,484,568,1052,444
0132-000,2014,6,30,8,753,1795,2548,1052
0132-000,2014,6,30,9,821,1327,2148,2548
0132-000,2014,6,30,10,724,796,1520,2148
0132-000,2014,6,30,11,816,821,1637,1520
0132-000,2014,6,30,12,814,825,1639,1637
0132-000,2014,6,30,13,774,771,1545,1639
0132-000,2014,6,30,14,768,778,1546,1545
0132-000,2014,6,30,15,857,855,1712,1546
0132-000,2014,6,30,16,897,812,1709,1712
0132-000,2014,6,30,17,864,825,1689,1709
0132-000,2014,6,30,18,1075,885,1960,1689
0132-000,2014,6,30,19,1226,849,2075,1960
0132-000,2014,6,30,20,915,672,1587,2075
0132-000,2014,6,30,21,831,562,1393,1587
0132-000,2014,6,30,22,683,473,1156,1393
0132-000,2014,6,30,23,367,313,680,1156
0132-000,2014,6,30,24,243,212,455,680
0132-000,2014,7,1,1,177,141,318,455
0132-000,2014,7,1,2,106,124,230,318
0132-000,2014,7,1,3,79,78,157,230
0132-000,2014,7,1,4,75,106,181,157
0132-000,2014,7,1,5,102,116,218,181
0132-000,2014,7,1,6,175,199,374,218
0132-000,2014,7,1,7,428,495,923,374
0132-000,2014,7,1,8,704,1657,2361,923
0132-000,2014,7,1,9,825,1232,2057,2361
0132-000,2014,7,1,10,780,841,1621,2057
0132-000,2014,7,1,11,771,861,1632,1621
0132-000,2014,7,1,12,814,818,1632,1632
0132-000,2014,7,1,13,722,699,1421,1632
0132-000,2014,7,1,14,747,774,1521,1421
0132-000,2014,7,1,15,844,794,1638,1521
0132-000,2014,7,1,16,916,769,1685,1638
0132-000,2014,7,1,17,914,879,1793,1685
0132-000,2014,7,1,18,1037,827,1864,1793
0132-000,2014,7,1,19,1238,854,2092,1864
0132-000,2014,7,1,20,922,652,1574,2092
0132-000,2014,7,1,21,838,493,1331,1574
0132-000,2014,7,1,22,586,449,1035,1331
0132-000,2014,7,1,23,348,312,660,1035
0132-000,2014,7,1,24,221,203,424,660
0132-000,2014,7,2,1,180,176,356,424
0132-000,2014,7,2,2,106,90,196,356
0132-000,2014,7,2,3,73,99,172,196
0132-000,2014,7,2,4,72,90,162,172
0132-000,2014,7,2,5,82,94,176,162
0132-000,2014,7,2,6,187,198,385,176
0132-000,2014,7,2,7,436,453,889,385
0132-000,2014,7,2,8,667,1570,2237,889
0132-000,2014,7,2,9,819,1227,2046,2237
0132-000,2014,7,2,10,738,845,1583,2046
0132-000,2014,7,2,11,753,798,1551,1583
0132-000,2014,7,2,12,754,806,1560,1551
0132-000,2014,7,2,13,716,810,1526,1560
0132-000,2014,7,2,14,778,766,1544,1526
0132-000,2014,7,2,15,934,844,1778,1544
0132-000,2014,7,2,16,883,790,1673,1778
0132-000,2014,7,2,17,936,862,1798,1673
0132-000,2014,7,2,18,1135,873,2008,1798
0132-000,2014,7,2,19,1356,885,2241,2008
0132-000,2014,7,2,20,862,658,1520,2241
0132-000,2014,7,2,21,728,535,1263,1520
0132-000,2014,7,2,22,564,415,979,1263
0132-000,2014,7,2,23,323,313,636,979
0132-000,2014,7,2,24,204,197,401,636
0132-000,2014,7,3,1,165,180,345,401
0132-000,2014,7,3,2,100,111,211,345
0132-000,2014,7,3,3,74,77,151,211
0132-000,2014,7,3,4,62,74,136,151
0132-000,2014,7,3,5,65,94,159,136
0132-000,2014,7,3,6,167,121,288,159
0132-000,2014,7,3,7,388,442,830,288
0132-000,2014,7,3,8,666,1571,2237,830
0132-000,2014,7,3,9,803,1224,2027,2237
0132-000,2014,7,3,10,727,817,1544,2027
0132-000,2014,7,3,11,728,829,1557,1544
0132-000,2014,7,3,12,756,855,1611,1557
0132-000,2014,7,3,13,708,697,1405,1611
0132-000,2014,7,3,14,804,780,1584,1405
0132-000,2014,7,3,15,864,803,1667,1584
0132-000,2014,7,3,16,849,742,1591,1667
0132-000,2014,7,3,17,891,830,1721,1591
0132-000,2014,7,3,18,1070,781,1851,1721
0132-000,2014,7,3,19,1221,796,2017,1851
0132-000,2014,7,3,20,796,613,1409,2017
0132-000,2014,7,3,21,796,528,1324,1409
0132-000,2014,7,3,22,572,433,1005,1324
0132-000,2014,7,3,23,346,332,678,1005
0132-000,2014,7,3,24,219,203,422,678
0132-000,2014,7,4,1,172,143,315,422
0132-000,2014,7,4,2,105,91,196,315
0132-000,2014,7,4,3,79,88,167,196
0132-000,2014,7,4,4,61,92,153,167
0132-000,2014,7,4,5,73,96,169,153
0132-000,2014,7,4,6,199,158,357,169
0132-000,2014,7,4,7,421,497,918,357
0132-000,2014,7,4,8,709,1633,2342,918
0132-000,2014,7,4,9,847,1195,2042,2342
0132-000,2014,7,4,10,736,842,1578,2042
0132-000,2014,7,4,11,789,906,1695,1578
0132-000,2014,7,4,12,825,804,1629,1695
0132-000,2014,7,4,13,768,845,1613,1629
0132-000,2014,7,4,14,879,819,1698,1613
0132-000,2014,7,4,15,892,880,1772,1698
0132-000,2014,7,4,16,937,882,1819,1772
0132-000,2014,7,4,17,964,941,1905,1819
0132-000,2014,7,4,18,1189,924,2113,1905
0132-000,2014,7,4,19,1459,980,2439,2113
0132-000,2014,7,4,20,1154,831,1985,2439
0132-000,2014,7,4,21,904,632,1536,1985
0132-000,2014,7,4,22,661,504,1165,1536
0132-000,2014,7,4,23,456,422,878,1165
0132-000,2014,7,4,24,276,271,547,878
0132-000,2014,7,5,1,218,207,425,547
0132-000,2014,7,5,2,138,160,298,425
0132-000,2014,7,5,3,104,116,220,298
0132-000,2014,7,5,4,84,105,189,220
0132-000,2014,7,5,5,99,125,224,189
0132-000,2014,7,5,6,226,218,444,224
0132-000,2014,7,5,7,367,388,755,444
0132-000,2014,7,5,8,485,796,1281,755
0132-000,2014,7,5,9,651,876,1527,1281
0132-000,2014,7,5,10,752,1002,1754,1527
0132-000,2014,7,5,11,729,914,1643,1754
0132-000,2014,7,5,12,848,1007,1855,1643
0132-000,2014,7,5,13,839,955,1794,1855
0132-000,2014,7,5,14,898,954,1852,1794
0132-000,2014,7,5,15,938,887,1825,1852
0132-000,2014,7,5,16,942,890,1832,1825
0132-000,2014,7,5,17,1008,935,1943,1832
0132-000,2014,7,5,18,1245,947,2192,1943
0132-000,2014,7,5,19,1142,830,1972,2192
0132-000,2014,7,5,20,771,601,1372,1972
0132-000,2014,7,5,21,660,514,1174,1372
0132-000,2014,7,5,22,533,442,975,1174
0132-000,2014,7,5,23,376,342,718,975
0132-000,2014,7,5,24,228,261,489,718
0132-000,2014,7,6,1,181,166,347,489
0132-000,2014,7,6,2,137,149,286,347
0132-000,2014,7,6,3,107,107,214,286
0132-000,2014,7,6,4,95,88,183,214
0132-000,2014,7,6,5,81,85,166,183
0132-000,2014,7,6,6,128,134,262,166
0132-000,2014,7,6,7,193,266,459,262
0132-000,2014,7,6,8,265,323,588,459
0132-000,2014,7,6,9,369,455,824,588
0132-000,2014,7,6,10,460,596,1056,824
0132-000,2014,7,6,11,556,668,1224,1056
0132-000,2014,7,6,12,592,653,1245,1224
0132-000,2014,7,6,13,650,702,1352,1245
0132-000,2014,7,6,14,678,738,1416,1352
0132-000,2014,7,6,15,772,690,1462,1416
0132-000,2014,7,6,16,919,714,1633,1462
0132-000,2014,7,6,17,1039,680,1719,1633
0132-000,2014,7,6,18,1073,623,1696,1719
0132-000,2014,7,6,19,1158,609,1767,1696
0132-000,2014,7,6,20,879,554,1433,1767
0132-000,2014,7,6,21,615,497,1112,1433
0132-000,2014,7,6,22,451,442,893,1112
0132-000,2014,7,6,23,313,289,602,893
0132-000,2014,7,6,24,204,195,399,602
0132-000,2014,7,7,1,135,159,294,399
0132-000,2014,7,7,2,89,87,176,294
0132-000,2014,7,7,3,59,60,119,176
0132-000,2014,7,7,4,58,68,126,119
0132-000,2014,7,7,5,85,99,184,126
0132-000,2014,7,7,6,199,226,425,184
0132-000,2014,7,7,7,487,611,1098,425
0132-000,2014,7,7,8,687,1840,2527,1098
0132-000,2014,7,7,9,792,1275,2067,2527
0132-000,2014,7,7,10,715,807,1522,2067
0132-000,2014,7,7,11,755,799,1554,1522
0132-000,2014,7,7,12,755,812,1567,1554
0132-000,2014,7,7,13,744,681,1425,1567
0132-000,2014,7,7,14,801,799,1600,1425
0132-000,2014,7,7,15,813,783,1596,1600
0132-000,2014,7,7,16,963,763,1726,1596
0132-000,2014,7,7,17,863,873,1736,1726
0132-000,2014,7,7,18,1056,866,1922,1736
0132-000,2014,7,7,19,1303,834,2137,1922
0132-000,2014,7,7,20,931,680,1611,2137
0132-000,2014,7,7,21,763,550,1313,1611
0132-000,2014,7,7,22,565,401,966,1313
0132-000,2014,7,7,23,333,314,647,966
0132-000,2014,7,7,24,235,174,409,647
0132-000,2014,7,8,1,145,145,290,409
0132-000,2014,7,8,2,92,103,195,290
0132-000,2014,7,8,3,67,92,159,195
0132-000,2014,7,8,4,76,93,169,159
0132-000,2014,7,8,5,96,101,197,169
0132-000,2014,7,8,6,157,160,317,197
0132-000,2014,7,8,7,410,470,880,317
0132-000,2014,7,8,8,698,1653,2351,880
0132-000,2014,7,8,9,803,1255,2058,2351
0132-000,2014,7,8,10,771,849,1620,2058
0132-000,2014,7,8,11,764,868,1632,1620
0132-000,2014,7,8,12,742,800,1542,1632
0132-000,2014,7,8,13,718,744,1462,1542
0132-000,2014,7,8,14,808,809,1617,1462
0132-000,2014,7,8,15,929,798,1727,1617
0132-000,2014,7,8,16,873,811,1684,1727
0132-000,2014,7,8,17,879,849,1728,1684
0132-000,2014,7,8,18,1082,842,1924,1728
0132-000,2014,7,8,19,1220,865,2085,1924
0132-000,2014,7,8,20,924,625,1549,2085
0132-000,2014,7,8,21,794,561,1355,1549
0132-000,2014,7,8,22,562,447,1009,1355
0132-000,2014,7,8,23,368,159,527,1009
0132-000,2014,7,8,24,229,113,342,527
0132-000,2014,7,9,1,126,106,232,342
0132-000,2014,7,9,2,81,77,158,232
0132-000,2014,7,9,3,91,65,156,158
0132-000,2014,7,9,4,70,65,135,156
0132-000,2014,7,9,5,74,85,159,135
0132-000,2014,7,9,6,185,139,324,159
0132-000,2014,7,9,7,431,429,860,324
0132-000,2014,7,9,8,660,1785,2445,860
0132-000,2014,7,9,9,858,1328,2186,2445
0132-000,2014,7,9,10,771,868,1639,2186
0132-000,2014,7,9,11,778,889,1667,1639
0132-000,2014,7,9,12,794,850,1644,1667
0132-000,2014,7,9,13,672,676,1348,1644
0132-000,2014,7,9,14,820,748,1568,1348
0132-000,2014,7,9,15,848,852,1700,1568
0132-000,2014,7,9,16,847,778,1625,1700
0132-000,2014,7,9,17,828,846,1674,1625
0132-000,2014,7,9,18,1160,840,2000,1674
0132-000,2014,7,9,19,1244,770,2014,2000
0132-000,2014,7,9,20,849,756,1605,2014
0132-000,2014,7,9,21,664,462,1126,1605
0132-000,2014,7,9,22,576,413,989,1126
0132-000,2014,7,9,23,343,296,639,989
0132-000,2014,7,9,24,237,218,455,639
0132-000,2014,7,10,1,159,159,318,455
0132-000,2014,7,10,2,99,81,180,318
0132-000,2014,7,10,3,86,55,141,180
0132-000,2014,7,10,4,80,65,145,141
0132-000,2014,7,10,5,71,61,132,145
0132-000,2014,7,10,6,168,147,315,132
0132-000,2014,7,10,7,427,488,915,315
0132-000,2014,7,10,8,685,1691,2376,915
0132-000,2014,7,10,9,852,1331,2183,2376
0132-000,2014,7,10,10,745,975,1720,2183
0132-000,2014,7,10,11,751,854,1605,1720
0132-000,2014,7,10,12,739,809,1548,1605
0132-000,2014,7,10,13,733,733,1466,1548
0132-000,2014,7,10,14,824,817,1641,1466
0132-000,2014,7,10,15,842,854,1696,1641
0132-000,2014,7,10,16,840,803,1643,1696
0132-000,2014,7,10,17,898,866,1764,1643
0132-000,2014,7,10,18,1053,834,1887,1764
0132-000,2014,7,10,19,1258,875,2133,1887
0132-000,2014,7,10,20,863,715,1578,2133
0132-000,2014,7,10,21,839,547,1386,1578
0132-000,2014,7,10,22,651,502,1153,1386
0132-000,2014,7,10,23,396,286,682,1153
0132-000,2014,7,10,24,264,214,478,682
0132-000,2014,7,11,1,176,143,319,478
0132-000,2014,7,11,2,128,116,244,319
0132-000,2014,7,11,3,106,63,169,244
0132-000,2014,7,11,4,69,106,175,169
0132-000,2014,7,11,5,92,79,171,175
0132-000,2014,7,11,6,186,157,343,171
0132-000,2014,7,11,7,441,511,952,343
0132-000,2014,7,11,8,646,1823,2469,952
0132-000,2014,7,11,9,854,1267,2121,2469
0132-000,2014,7,11,10,746,871,1617,2121
0132-000,2014,7,11,11,738,913,1651,1617
0132-000,2014,7,11,12,772,860,1632,1651
0132-000,2014,7,11,13,711,791,1502,1632
0132-000,2014,7,11,14,794,844,1638,1502
0132-000,2014,7,11,15,937,866,1803,1638
0132-000,2014,7,11,16,926,905,1831,1803
0132-000,2014,7,11,17,965,866,1831,1831
0132-000,2014,7,11,18,1225,918,2143,1831
0132-000,2014,7,11,19,1455,1036,2491,2143
0132-000,2014,7,11,20,1123,860,1983,2491
0132-000,2014,7,11,21,977,654,1631,1983
0132-000,2014,7,11,22,655,529,1184,1631
0132-000,2014,7,11,23,490,394,884,1184
0132-000,2014,7,11,24,321,280,601,884
0132-000,2014,7,12,1,243,192,435,601
0132-000,2014,7,12,2,159,149,308,435
0132-000,2014,7,12,3,110,116,226,308
0132-000,2014,7,12,4,99,91,190,226
0132-000,2014,7,12,5,114,81,195,190
0132-000,2014,7,12,6,201,173,374,195
0132-000,2014,7,12,7,403,372,775,374
0132-000,2014,7,12,8,497,805,1302,775
0132-000,2014,7,12,9,696,860,1556,1302
0132-000,2014,7,12,10,749,913,1662,1556
0132-000,2014,7,12,11,761,987,1748,1662
0132-000,2014,7,12,12,830,1027,1857,1748
0132-000,2014,7,12,13,834,969,1803,1857
0132-000,2014,7,12,14,830,909,1739,1803
0132-000,2014,7,12,15,846,799,1645,1739
0132-000,2014,7,12,16,896,907,1803,1645
0132-000,2014,7,12,17,946,940,1886,1803
0132-000,2014,7,12,18,1192,889,2081,1886
0132-000,2014,7,12,19,1026,844,1870,2081
0132-000,2014,7,12,20,766,566,1332,1870
0132-000,2014,7,12,21,668,558,1226,1332
0132-000,2014,7,12,22,518,445,963,1226
0132-000,2014,7,12,23,390,306,696,963
0132-000,2014,7,12,24,221,251,472,696
0132-000,2014,7,13,1,172,163,335,472
0132-000,2014,7,13,2,146,94,240,335
0132-000,2014,7,13,3,116,89,205,240
0132-000,2014,7,13,4,82,71,153,205
0132-000,2014,7,13,5,91,81,172,153
0132-000,2014,7,13,6,110,89,199,172
0132-000,2014,7,13,7,239,177,416,199
0132-000,2014,7,13,8,263,318,581,416
0132-000,2014,7,13,9,368,384,752,581
0132-000,2014,7,13,10,456,464,920,752
0132-000,2014,7,13,11,518,615,1133,920
0132-000,2014,7,13,12,558,615,1173,1133
0132-000,2014,7,13,13,631,596,1227,1173
0132-000,2014,7,13,14,667,648,1315,1227
0132-000,2014,7,13,15,703,662,1365,1315
0132-000,2014,7,13,16,865,672,1537,1365
0132-000,2014,7,13,17,1039,680,1719,1537
0132-000,2014,7,13,18,1118,670,1788,1719
0132-000,2014,7,13,19,1081,642,1723,1788
0132-000,2014,7,13,20,913,507,1420,1723
0132-000,2014,7,13,21,862,556,1418,1420
0132-000,2014,7,13,22,547,417,964,1418
0132-000,2014,7,13,23,351,251,602,964
0132-000,2014,7,13,24,184,188,372,602
0132-000,2014,7,14,1,132,132,264,372
0132-000,2014,7,14,2,68,47,115,264
0132-000,2014,7,14,3,45,55,100,115
0132-000,2014,7,14,4,66,69,135,100
0132-000,2014,7,14,5,69,71,140,135
0132-000,2014,7,14,6,207,200,407,140
0132-000,2014,7,14,7,491,588,1079,407
0132-000,2014,7,14,8,713,1993,2706,1079
0132-000,2014,7,14,9,851,1425,2276,2706
0132-000,2014,7,14,10,778,819,1597,2276
0132-000,2014,7,14,11,787,817,1604,1597
0132-000,2014,7,14,12,767,895,1662,1604
0132-000,2014,7,14,13,646,756,1402,1662
0132-000,2014,7,14,14,769,817,1586,1402
0132-000,2014,7,14,15,875,787,1662,1586
0132-000,2014,7,14,16,859,801,1660,1662
0132-000,2014,7,14,17,863,832,1695,1660
0132-000,2014,7,14,18,1040,875,1915,1695
0132-000,2014,7,14,19,1264,828,2092,1915
0132-000,2014,7,14,20,840,705,1545,2092
0132-000,2014,7,14,21,818,500,1318,1545
0132-000,2014,7,14,22,596,455,1051,1318
0132-000,2014,7,14,23,354,261,615,1051
0132-000,2014,7,14,24,214,157,371,615
0132-000,2014,7,15,1,147,151,298,371
0132-000,2014,7,15,2,93,85,178,298
0132-000,2014,7,15,3,65,75,140,178
0132-000,2014,7,15,4,84,55,139,140
0132-000,2014,7,15,5,77,83,160,139
0132-000,2014,7,15,6,179,143,322,160
0132-000,2014,7,15,7,428,476,904,322
0132-000,2014,7,15,8,654,1785,2439,904
0132-000,2014,7,15,9,840,1367,2207,2439
0132-000,2014,7,15,10,814,924,1738,2207
0132-000,2014,7,15,11,806,862,1668,1738
0132-000,2014,7,15,12,739,897,1636,1668
0132-000,2014,7,15,13,755,754,1509,1636
0132-000,2014,7,15,14,857,877,1734,1509
0132-000,2014,7,15,15,826,875,1701,1734
0132-000,2014,7,15,16,924,891,1815,1701
0132-000,2014,7,15,17,888,881,1769,1815
0132-000,2014,7,15,18,1118,891,2009,1769
0132-000,2014,7,15,19,1251,877,2128,2009
0132-000,2014,7,15,20,897,668,1565,2128
0132-000,2014,7,15,21,760,547,1307,1565
0132-000,2014,7,15,22,539,433,972,1307
0132-000,2014,7,15,23,338,280,618,972
0132-000,2014,7,15,24,220,163,383,618
0132-000,2014,7,16,1,160,128,288,383
0132-000,2014,7,16,2,123,73,196,288
0132-000,2014,7,16,3,97,71,168,196
0132-000,2014,7,16,4,61,63,124,168
0132-000,2014,7,16,5,90,85,175,124
0132-000,2014,7,16,6,186,143,329,175
0132-000,2014,7,16,7,420,535,955,329
0132-000,2014,7,16,8,708,1680,2388,955
0132-000,2014,7,16,9,812,1361,2173,2388
0132-000,2014,7,16,10,758,856,1614,2173
0132-000,2014,7,16,11,750,856,1606,1614
0132-000,2014,7,16,12,769,770,1539,1606
0132-000,2014,7,16,13,672,676,1348,1539
0132-000,2014,7,16,14,814,748,1562,1348
0132-000,2014,7,16,15,865,774,1639,1562
0132-000,2014,7,16,16,845,801,1646,1639
0132-000,2014,7,16,17,933,907,1840,1646
0132-000,2014,7,16,18,1166,901,2067,1840
0132-000,2014,7,16,19,1354,922,2276,2067
0132-000,2014,7,16,20,925,689,1614,2276
0132-000,2014,7,16,21,750,568,1318,1614
0132-000,2014,7,16,22,592,427,1019,1318
0132-000,2014,7,16,23,386,304,690,1019
0132-000,2014,7,16,24,232,179,411,690
0132-000,2014,7,17,1,166,163,329,411
0132-000,2014,7,17,2,120,96,216,329
0132-000,2014,7,17,3,83,75,158,216
0132-000,2014,7,17,4,96,67,163,158
0132-000,2014,7,17,5,91,83,174,163
0132-000,2014,7,17,6,189,141,330,174
0132-000,2014,7,17,7,387,472,859,330
0132-000,2014,7,17,8,669,1655,2324,859
0132-000,2014,7,17,9,792,1314,2106,2324
0132-000,2014,7,17,10,752,830,1582,2106
0132-000,2014,7,17,11,761,909,1670,1582
0132-000,2014,7,17,12,826,828,1654,1670
0132-000,2014,7,17,13,700,746,1446,1654
0132-000,2014,7,17,14,773,830,1603,1446
0132-000,2014,7,17,15,835,774,1609,1603
0132-000,2014,7,17,16,913,815,1728,1609
0132-000,2014,7,17,17,892,909,1801,1728
0132-000,2014,7,17,18,1052,893,1945,1801
0132-000,2014,7,17,19,1286,803,2089,1945
0132-000,2014,7,17,20,865,670,1535,2089
0132-000,2014,7,17,21,729,529,1258,1535
0132-000,2014,7,17,22,588,425,1013,1258
0132-000,2014,7,17,23,372,261,633,1013
0132-000,2014,7,17,24,227,243,470,633
0132-000,2014,7,18,1,174,94,268,470
0132-000,2014,7,18,2,118,108,226,268
0132-000,2014,7,18,3,79,55,134,226
0132-000,2014,7,18,4,76,63,139,134
0132-000,2014,7,18,5,77,63,140,139
0132-000,2014,7,18,6,123,141,264,140
0132-000,2014,7,18,7,322,370,692,264
0132-000,2014,7,18,8,632,1546,2178,692
0132-000,2014,7,18,9,764,1349,2113,2178
0132-000,2014,7,18,10,698,844,1542,2113
0132-000,2014,7,18,11,746,838,1584,1542
0132-000,2014,7,18,12,713,805,1518,1584
0132-000,2014,7,18,13,742,799,1541,1518
0132-000,2014,7,18,14,788,760,1548,1541
0132-000,2014,7,18,15,870,825,1695,1548
0132-000,2014,7,18,16,878,846,1724,1695
0132-000,2014,7,18,17,978,854,1832,1724
0132-000,2014,7,18,18,1218,862,2080,1832
0132-000,2014,7,18,19,1507,938,2445,2080
0132-000,2014,7,18,20,1063,785,1848,2445
0132-000,2014,7,18,21,900,633,1533,1848
0132-000,2014,7,18,22,596,459,1055,1533
0132-000,2014,7,18,23,405,359,764,1055
0132-000,2014,7,18,24,273,202,475,764
0132-000,2014,7,19,1,207,204,411,475
0132-000,2014,7,19,2,137,120,257,411
0132-000,2014,7,19,3,119,112,231,257
0132-000,2014,7,19,4,104,73,177,231
0132-000,2014,7,19,5,88,81,169,177
0132-000,2014,7,19,6,200,151,351,169
0132-000,2014,7,19,7,341,304,645,351
0132-000,2014,7,19,8,494,856,1350,645
0132-000,2014,7,19,9,625,870,1495,1350
0132-000,2014,7,19,10,687,844,1531,1495
0132-000,2014,7,19,11,768,967,1735,1531
0132-000,2014,7,19,12,755,1068,1823,1735
0132-000,2014,7,19,13,845,887,1732,1823
0132-000,2014,7,19,14,785,909,1694,1732
0132-000,2014,7,19,15,824,862,1686,1694
0132-000,2014,7,19,16,849,830,1679,1686
0132-000,2014,7,19,17,969,918,1887,1679
0132-000,2014,7,19,18,1124,918,2042,1887
0132-000,2014,7,19,19,1002,781,1783,2042
0132-000,2014,7,19,20,752,562,1314,1783
0132-000,2014,7,19,21,719,480,1199,1314
0132-000,2014,7,19,22,491,453,944,1199
0132-000,2014,7,19,23,396,312,708,944
0132-000,2014,7,19,24,238,212,450,708
0132-000,2014,7,20,1,170,151,321,450
0132-000,2014,7,20,2,138,118,256,321
0132-000,2014,7,20,3,107,69,176,256
0132-000,2014,7,20,4,80,61,141,176
0132-000,2014,7,20,5,91,67,158,141
0132-000,2014,7,20,6,142,132,274,158
0132-000,2014,7,20,7,227,194,421,274
0132-000,2014,7,20,8,252,337,589,421
0132-000,2014,7,20,9,391,425,816,589
0132-000,2014,7,20,10,431,578,1009,816
0132-000,2014,7,20,11,599,617,1216,1009
0132-000,2014,7,20,12,536,656,1192,1216
0132-000,2014,7,20,13,697,723,1420,1192
0132-000,2014,7,20,14,636,693,1329,1420
0132-000,2014,7,20,15,780,689,1469,1329
0132-000,2014,7,20,16,847,672,1519,1469
0132-000,2014,7,20,17,1011,718,1729,1519
0132-000,2014,7,20,18,1182,623,1805,1729
0132-000,2014,7,20,19,1020,586,1606,1805
0132-000,2014,7,20,20,857,597,1454,1606
0132-000,2014,7,20,21,841,468,1309,1454
0132-000,2014,7,20,22,487,404,891,1309
0132-000,2014,7,20,23,322,253,575,891
0132-000,2014,7,20,24,197,204,401,575
0132-000,2014,7,21,1,122,114,236,401
0132-000,2014,7,21,2,85,77,162,236
0132-000,2014,7,21,3,59,49,108,162
0132-000,2014,7,21,4,53,53,106,108
0132-000,2014,7,21,5,81,57,138,106
0132-000,2014,7,21,6,211,167,378,138
0132-000,2014,7,21,7,473,646,1119,378
0132-000,2014,7,21,8,722,1879,2601,1119
0132-000,2014,7,21,9,812,1414,2226,2601
0132-000,2014,7,21,10,689,811,1500,2226
0132-000,2014,7,21,11,667,832,1499,1500
0132-000,2014,7,21,12,761,809,1570,1499
0132-000,2014,7,21,13,705,752,1457,1570
0132-000,2014,7,21,14,731,1020,1751,1457
0132-000,2014,7,21,15,832,893,1725,1751
0132-000,2014,7,21,16,940,830,1770,1725
0132-000,2014,7,21,17,915,840,1755,1770
0132-000,2014,7,21,18,1082,915,1997,1755
0132-000,2014,7,21,19,1253,870,2123,1997
0132-000,2014,7,21,20,950,727,1677,2123
0132-000,2014,7,21,21,808,513,1321,1677
0132-000,2014,7,21,22,575,384,959,1321
0132-000,2014,7,21,23,354,280,634,959
0132-000,2014,7,21,24,240,161,401,634
0132-000,2014,7,22,1,144,126,270,401
0132-000,2014,7,22,2,88,81,169,270
0132-000,2014,7,22,3,79,87,166,169
0132-000,2014,7,22,4,61,59,120,166
0132-000,2014,7,22,5,87,65,152,120
0132-000,2014,7,22,6,173,132,305,152
0132-000,2014,7,22,7,404,482,886,305
0132-000,2014,7,22,8,675,1749,2424,886
0132-000,2014,7,22,9,809,1355,2164,2424
0132-000,2014,7,22,10,698,832,1530,2164
0132-000,2014,7,22,11,734,893,1627,1530
0132-000,2014,7,22,12,830,852,1682,1627
0132-000,2014,7,22,13,712,709,1421,1682
0132-000,2014,7,22,14,807,797,1604,1421
0132-000,2014,7,22,15,906,854,1760,1604
0132-000,2014,7,22,16,929,903,1832,1760
0132-000,2014,7,22,17,858,852,1710,1832
0132-000,2014,7,22,18,1140,895,2035,1710
0132-000,2014,7,22,19,1271,860,2131,2035
0132-000,2014,7,22,20,899,697,1596,2131
0132-000,2014,7,22,21,723,525,1248,1596
0132-000,2014,7,22,22,651,421,1072,1248
0132-000,2014,7,22,23,343,271,614,1072
0132-000,2014,7,22,24,218,149,367,614
0132-000,2014,7,23,1,145,157,302,367
0132-000,2014,7,23,2,115,89,204,302
0132-000,2014,7,23,3,70,71,141,204
0132-000,2014,7,23,4,72,63,135,141
0132-000,2014,7,23,5,84,96,180,135
0132-000,2014,7,23,6,143,130,273,180
0132-000,2014,7,23,7,338,367,705,273
0132-000,2014,7,23,8,602,1620,2222,705
0132-000,2014,7,23,9,734,1324,2058,2222
0132-000,2014,7,23,10,658,721,1379,2058
0132-000,2014,7,23,11,696,795,1491,1379
0132-000,2014,7,23,12,641,774,1415,1491
0132-000,2014,7,23,13,630,817,1447,1415
0132-000,2014,7,23,14,779,793,1572,1447
0132-000,2014,7,23,15,776,791,1567,1572
0132-000,2014,7,23,16,839,715,1554,1567
0132-000,2014,7,23,17,822,870,1692,1554
0132-000,2014,7,23,18,1103,725,1828,1692
0132-000,2014,7,23,19,1236,699,1935,1828
0132-000,2014,7,23,20,824,621,1445,1935
0132-000,2014,7,23,21,655,505,1160,1445
0132-000,2014,7,23,22,523,439,962,1160
0132-000,2014,7,23,23,326,239,565,962
0132-000,2014,7,23,24,221,184,405,565
0132-000,2014,7,24,1,159,128,287,405
0132-000,2014,7,24,2,109,106,215,287
0132-000,2014,7,24,3,81,77,158,215
0132-000,2014,7,24,4,72,77,149,158
0132-000,2014,7,24,5,81,53,134,149
0132-000,2014,7,24,6,129,108,237,134
0132-000,2014,7,24,7,305,390,695,237
0132-000,2014,7,24,8,582,1619,2201,695
0132-000,2014,7,24,9,782,1324,2106,2201
0132-000,2014,7,24,10,682,885,1567,2106
0132-000,2014,7,24,11,692,778,1470,1567
0132-000,2014,7,24,12,749,776,1525,1470
0132-000,2014,7,24,13,731,736,1467,1525
0132-000,2014,7,24,14,762,828,1590,1467
0132-000,2014,7,24,15,833,856,1689,1590
0132-000,2014,7,24,16,884,809,1693,1689
0132-000,2014,7,24,17,882,832,1714,1693
0132-000,2014,7,24,18,1073,807,1880,1714
0132-000,2014,7,24,19,1255,760,2015,1880
0132-000,2014,7,24,20,927,666,1593,2015
0132-000,2014,7,24,21,785,535,1320,1593
0132-000,2014,7,24,22,625,457,1082,1320
0132-000,2014,7,24,23,357,273,630,1082
0132-000,2014,7,24,24,252,222,474,630
0132-000,2014,7,25,1,175,119,294,474
0132-000,2014,7,25,2,123,112,235,294
0132-000,2014,7,25,3,93,59,152,235
0132-000,2014,7,25,4,73,85,158,152
0132-000,2014,7,25,5,85,71,156,158
0132-000,2014,7,25,6,155,149,304,156
0132-000,2014,7,25,7,382,441,823,304
0132-000,2014,7,25,8,639,1685,2324,823
0132-000,2014,7,25,9,809,1308,2117,2324
0132-000,2014,7,25,10,722,858,1580,2117
0132-000,2014,7,25,11,742,876,1618,1580
0132-000,2014,7,25,12,743,833,1576,1618
0132-000,2014,7,25,13,727,795,1522,1576
0132-000,2014,7,25,14,791,802,1593,1522
0132-000,2014,7,25,15,904,846,1750,1593
0132-000,2014,7,25,16,902,876,1778,1750
0132-000,2014,7,25,17,972,860,1832,1778
0132-000,2014,7,25,18,1222,890,2112,1832
0132-000,2014,7,25,19,1481,987,2468,2112
0132-000,2014,7,25,20,1093,823,1916,2468
0132-000,2014,7,25,21,939,644,1583,1916
0132-000,2014,7,25,22,626,494,1120,1583
0132-000,2014,7,25,23,448,377,825,1120
0132-000,2014,7,25,24,297,241,538,825
0132-000,2014,7,26,1,225,198,423,538
0132-000,2014,7,26,2,148,135,283,423
0132-000,2014,7,26,3,115,114,229,283
0132-000,2014,7,26,4,102,82,184,229
0132-000,2014,7,26,5,101,81,182,184
0132-000,2014,7,26,6,201,162,363,182
0132-000,2014,7,26,7,372,338,710,363
0132-000,2014,7,26,8,496,831,1327,710
0132-000,2014,7,26,9,661,865,1526,1327
0132-000,2014,7,26,10,718,879,1597,1526
0132-000,2014,7,26,11,765,977,1742,1597
0132-000,2014,7,26,12,793,1048,1841,1742
0132-000,2014,7,26,13,840,928,1768,1841
0132-000,2014,7,26,14,808,909,1717,1768
0132-000,2014,7,26,15,835,831,1666,1717
0132-000,2014,7,26,16,873,869,1742,1666
0132-000,2014,7,26,17,958,929,1887,1742
0132-000,2014,7,26,18,1158,904,2062,1887
0132-000,2014,7,26,19,1014,813,1827,2062
0132-000,2014,7,26,20,759,564,1323,1827
0132-000,2014,7,26,21,694,519,1213,1323
0132-000,2014,7,26,22,505,449,954,1213
0132-000,2014,7,26,23,393,309,702,954
0132-000,2014,7,26,24,230,232,462,702
0132-000,2014,7,27,1,171,157,328,462
0132-000,2014,7,27,2,142,106,248,328
0132-000,2014,7,27,3,112,79,191,248
0132-000,2014,7,27,4,81,66,147,191
0132-000,2014,7,27,5,91,74,165,147
0132-000,2014,7,27,6,126,111,237,165
0132-000,2014,7,27,7,233,186,419,237
0132-000,2014,7,27,8,258,328,586,419
0132-000,2014,7,27,9,380,405,785,586
0132-000,2014,7,27,10,444,521,965,785
0132-000,2014,7,27,11,559,616,1175,965
0132-000,2014,7,27,12,547,636,1183,1175
0132-000,2014,7,27,13,664,660,1324,1183
0132-000,2014,7,27,14,652,671,1323,1324
0132-000,2014,7,27,15,742,676,1418,1323
0132-000,2014,7,27,16,856,672,1528,1418
0132-000,2014,7,27,17,1025,699,1724,1528
0132-000,2014,7,27,18,1150,647,1797,1724
0132-000,2014,7,27,19,1051,614,1665,1797
0132-000,2014,7,27,20,885,552,1437,1665
0132-000,2014,7,27,21,852,512,1364,1437
0132-000,2014,7,27,22,517,411,928,1364
0132-000,2014,7,27,23,337,252,589,928
0132-000,2014,7,27,24,191,196,387,589
0132-000,2014,7,28,1,127,123,250,387
0132-000,2014,7,28,2,77,62,139,250
0132-000,2014,7,28,3,52,52,104,139
0132-000,2014,7,28,4,60,61,121,104
0132-000,2014,7,28,5,75,64,139,121
0132-000,2014,7,28,6,209,184,393,139
0132-000,2014,7,28,7,482,617,1099,393
0132-000,2014,7,28,8,718,1936,2654,1099
0132-000,2014,7,28,9,832,1420,2252,2654
0132-000,2014,7,28,10,734,815,1549,2252
0132-000,2014,7,28,11,727,825,1552,1549
0132-000,2014,7,28,12,764,852,1616,1552
0132-000,2014,7,28,13,676,754,1430,1616
0132-000,2014,7,28,14,750,919,1669,1430
0132-000,2014,7,28,15,854,840,1694,1669
0132-000,2014,7,28,16,900,816,1716,1694
0132-000,2014,7,28,17,889,836,1725,1716
0132-000,2014,7,28,18,1061,895,1956,1725
0132-000,2014,7,28,19,1259,849,2108,1956
0132-000,2014,7,28,20,895,716,1611,2108
0132-000,2014,7,28,21,813,507,1320,1611
0132-000,2014,7,28,22,586,420,1006,1320
0132-000,2014,7,28,23,354,271,625,1006
0132-000,2014,7,28,24,227,159,386,625
0132-000,2014,7,29,1,146,139,285,386
0132-000,2014,7,29,2,91,83,174,285
0132-000,2014,7,29,3,72,81,153,174
0132-000,2014,7,29,4,73,57,130,153
0132-000,2014,7,29,5,82,74,156,130
0132-000,2014,7,29,6,176,138,314,156
0132-000,2014,7,29,7,416,479,895,314
0132-000,2014,7,29,8,665,1767,2432,895
0132-000,2014,7,29,9,825,1361,2186,2432
0132-000,2014,7,29,10,756,878,1634,2186
0132-000,2014,7,29,11,770,878,1648,1634
0132-000,2014,7,29,12,785,875,1660,1648
0132-000,2014,7,29,13,734,732,1466,1660
0132-000,2014,7,29,14,832,837,1669,1466
0132-000,2014,7,29,15,866,865,1731,1669
0132-000,2014,7,29,16,927,897,1824,1731
0132-000,2014,7,29,17,873,867,1740,1824
0132-000,2014,7,29,18,1129,893,2022,1740
0132-000,2014,7,29,19,1261,869,2130,2022
0132-000,2014,7,29,20,898,683,1581,2130
0132-000,2014,7,29,21,742,536,1278,1581
0132-000,2014,7,29,22,595,427,1022,1278
0132-000,2014,7,29,23,341,276,617,1022
0132-000,2014,7,29,24,219,156,375,617
0132-000,2014,7,30,1,153,143,296,375
0132-000,2014,7,30,2,119,81,200,296
0132-000,2014,7,30,3,84,71,155,200
0132-000,2014,7,30,4,67,63,130,155
0132-000,2014,7,30,5,87,91,178,130
0132-000,2014,7,30,6,165,137,302,178
0132-000,2014,7,30,7,379,451,830,302
0132-000,2014,7,30,8,655,1650,2305,830
0132-000,2014,7,30,9,773,1343,2116,2305
0132-000,2014,7,30,10,708,789,1497,2116
0132-000,2014,7,30,11,723,826,1549,1497
0132-000,2014,7,30,12,705,772,1477,1549
0132-000,2014,7,30,13,651,747,1398,1477
0132-000,2014,7,30,14,797,771,1568,1398
0132-000,2014,7,30,15,821,783,1604,1568
0132-000,2014,7,30,16,842,758,1600,1604
0132-000,2014,7,30,17,878,889,1767,1600
0132-000,2014,7,30,18,1135,813,1948,1767
0132-000,2014,7,30,19,1295,811,2106,1948
0132-000,2014,7,30,20,875,655,1530,2106
0132-000,2014,7,30,21,703,537,1240,1530
0132-000,2014,7,30,22,558,433,991,1240
0132-000,2014,7,30,23,356,272,628,991
0132-000,2014,7,30,24,227,182,409,628
0132-000,2014,7,31,1,163,146,309,409
0132-000,2014,7,31,2,115,101,216,309
0132-000,2014,7,31,3,82,76,158,216
0132-000,2014,7,31,4,84,72,156,158
0132-000,2014,7,31,5,86,68,154,156
0132-000,2014,7,31,6,159,125,284,154
0132-000,2014,7,31,7,346,431,777,284
0132-000,2014,7,31,8,626,1637,2263,777
0132-000,2014,7,31,9,787,1319,2106,2263
0132-000,2014,7,31,10,717,858,1575,2106
0132-000,2014,7,31,11,727,844,1571,1575
0132-000,2014,7,31,12,788,802,1590,1571
0132-000,2014,7,31,13,716,741,1457,1590
0132-000,2014,7,31,14,768,829,1597,1457
0132-000,2014,7,31,15,834,815,1649,1597
0132-000,2014,7,31,16,899,812,1711,1649
0132-000,2014,7,31,17,887,871,1758,1711
0132-000,2014,7,31,18,1063,850,1913,1758
0132-000,2014,7,31,19,1271,782,2053,1913
0132-000,2014,7,31,20,896,668,1564,2053
0132-000,2014,7,31,21,757,532,1289,1564
0132-000,2014,7,31,22,607,441,1048,1289
0132-000,2014,7,31,23,365,267,632,1048
0132-000,2014,7,31,24,240,233,473,632
0132-000,2014,8,1,1,206,176,382,473
0132-000,2014,8,1,2,122,127,249,382
0132-000,2014,8,1,3,110,88,198,249
0132-000,2014,8,1,4,95,96,191,198
0132-000,2014,8,1,5,141,126,267,191
0132-000,2014,8,1,6,233,184,417,267
0132-000,2014,8,1,7,419,388,807,417
0132-000,2014,8,1,8,612,1093,1705,807
0132-000,2014,8,1,9,736,1123,1859,1705
0132-000,2014,8,1,10,744,854,1598,1859
0132-000,2014,8,1,11,800,888,1688,1598
0132-000,2014,8,1,12,864,935,1799,1688
0132-000,2014,8,1,13,817,983,1800,1799
0132-000,2014,8,1,14,881,1052,1933,1800
0132-000,2014,8,1,15,981,964,1945,1933
0132-000,2014,8,1,16,1026,967,1993,1945
0132-000,2014,8,1,17,1040,934,1974,1993
0132-000,2014,8,1,18,1321,971,2292,1974
0132-000,2014,8,1,19,1349,1059,2408,2292
0132-000,2014,8,1,20,1191,974,2165,2408
0132-000,2014,8,1,21,922,716,1638,2165
0132-000,2014,8,1,22,864,646,1510,1638
0132-000,2014,8,1,23,507,513,1020,1510
0132-000,2014,8,1,24,328,364,692,1020
0132-000,2014,8,2,1,237,302,539,692
0132-000,2014,8,2,2,197,190,387,539
0132-000,2014,8,2,3,136,117,253,387
0132-000,2014,8,2,4,128,129,257,253
0132-000,2014,8,2,5,153,123,276,257
0132-000,2014,8,2,6,195,204,399,276
0132-000,2014,8,2,7,323,328,651,399
0132-000,2014,8,2,8,505,719,1224,651
0132-000,2014,8,2,9,681,968,1649,1224
0132-000,2014,8,2,10,694,1249,1943,1649
0132-000,2014,8,2,11,774,1605,2379,1943
0132-000,2014,8,2,12,788,1637,2425,2379
0132-000,2014,8,2,13,832,1546,2378,2425
0132-000,2014,8,2,14,885,1325,2210,2378
0132-000,2014,8,2,15,917,1153,2070,2210
0132-000,2014,8,2,16,1000,1082,2082,2070
0132-000,2014,8,2,17,1110,1035,2145,2082
0132-000,2014,8,2,18,1229,1096,2325,2145
0132-000,2014,8,2,19,1218,1126,2344,2325
0132-000,2014,8,2,20,1023,894,1917,2344
0132-000,2014,8,2,21,888,576,1464,1917
0132-000,2014,8,2,22,853,479,1332,1464
0132-000,2014,8,2,23,527,357,884,1332
0132-000,2014,8,2,24,360,290,650,884
0132-000,2014,8,3,1,185,220,405,650
0132-000,2014,8,3,2,171,164,335,405
0132-000,2014,8,3,3,111,102,213,335
0132-000,2014,8,3,4,117,86,203,213
0132-000,2014,8,3,5,100,86,186,203
0132-000,2014,8,3,6,145,153,298,186
0132-000,2014,8,3,7,237,213,450,298
0132-000,2014,8,3,8,332,394,726,450
0132-000,2014,8,3,9,402,469,871,726
0132-000,2014,8,3,10,495,570,1065,871
0132-000,2014,8,3,11,625,669,1294,1065
0132-000,2014,8,3,12,612,644,1256,1294
0132-000,2014,8,3,13,726,703,1429,1256
0132-000,2014,8,3,14,812,707,1519,1429
0132-000,2014,8,3,15,976,692,1668,1519
0132-000,2014,8,3,16,1174,705,1879,1668
0132-000,2014,8,3,17,1233,683,1916,1879
0132-000,2014,8,3,18,1384,793,2177,1916
0132-000,2014,8,3,19,1413,924,2337,2177
0132-000,2014,8,3,20,1288,611,1899,2337
0132-000,2014,8,3,21,897,575,1472,1899
0132-000,2014,8,3,22,858,536,1394,1472
0132-000,2014,8,3,23,432,391,823,1394
0132-000,2014,8,3,24,267,240,507,823
0132-000,2014,8,4,1,170,155,325,507
0132-000,2014,8,4,2,104,107,211,325
0132-000,2014,8,4,3,94,61,155,211
0132-000,2014,8,4,4,70,113,183,155
0132-000,2014,8,4,5,133,119,252,183
0132-000,2014,8,4,6,238,205,443,252
0132-000,2014,8,4,7,454,667,1121,443
0132-000,2014,8,4,8,719,1543,2262,1121
0132-000,2014,8,4,9,833,1308,2141,2262
0132-000,2014,8,4,10,809,971,1780,2141
0132-000,2014,8,4,11,803,963,1766,1780
0132-000,2014,8,4,12,916,983,1899,1766
0132-000,2014,8,4,13,826,911,1737,1899
0132-000,2014,8,4,14,909,995,1904,1737
0132-000,2014,8,4,15,952,983,1935,1904
0132-000,2014,8,4,16,948,934,1882,1935
0132-000,2014,8,4,17,1027,882,1909,1882
0132-000,2014,8,4,18,1142,920,2062,1909
0132-000,2014,8,4,19,1232,784,2016,2062
0132-000,2014,8,4,20,975,755,1730,2016
0132-000,2014,8,4,21,800,586,1386,1730
0132-000,2014,8,4,22,615,471,1086,1386
0132-000,2014,8,4,23,399,360,759,1086
0132-000,2014,8,4,24,263,196,459,759
0132-000,2014,8,5,1,187,163,350,459
0132-000,2014,8,5,2,109,112,221,350
0132-000,2014,8,5,3,108,87,195,221
0132-000,2014,8,5,4,77,102,179,195
0132-000,2014,8,5,5,122,105,227,179
0132-000,2014,8,5,6,244,193,437,227
0132-000,2014,8,5,7,421,435,856,437
0132-000,2014,8,5,8,670,1375,2045,856
0132-000,2014,8,5,9,800,1216,2016,2045
0132-000,2014,8,5,10,867,980,1847,2016
0132-000,2014,8,5,11,840,902,1742,1847
0132-000,2014,8,5,12,907,958,1865,1742
0132-000,2014,8,5,13,826,962,1788,1865
0132-000,2014,8,5,14,912,1074,1986,1788
0132-000,2014,8,5,15,923,1132,2055,1986
0132-000,2014,8,5,16,1046,901,1947,2055
0132-000,2014,8,5,17,1128,939,2067,1947
0132-000,2014,8,5,18,1274,923,2197,2067
0132-000,2014,8,5,19,1302,996,2298,2197
0132-000,2014,8,5,20,1110,843,1953,2298
0132-000,2014,8,5,21,904,588,1492,1953
0132-000,2014,8,5,22,701,505,1206,1492
0132-000,2014,8,5,23,473,366,839,1206
0132-000,2014,8,5,24,308,275,583,839
0132-000,2014,8,6,1,224,209,433,583
0132-000,2014,8,6,2,143,141,284,433
0132-000,2014,8,6,3,116,101,217,284
0132-000,2014,8,6,4,100,94,194,217
0132-000,2014,8,6,5,99,102,201,194
0132-000,2014,8,6,6,201,181,382,201
0132-000,2014,8,6,7,427,518,945,382
0132-000,2014,8,6,8,633,1522,2155,945
0132-000,2014,8,6,9,875,1435,2310,2155
0132-000,2014,8,6,10,804,967,1771,2310
0132-000,2014,8,6,11,817,940,1757,1771
0132-000,2014,8,6,12,881,892,1773,1757
0132-000,2014,8,6,13,808,854,1662,1773
0132-000,2014,8,6,14,899,917,1816,1662
0132-000,2014,8,6,15,900,928,1828,1816
0132-000,2014,8,6,16,1011,952,1963,1828
0132-000,2014,8,6,17,1029,892,1921,1963
0132-000,2014,8,6,18,1238,931,2169,1921
0132-000,2014,8,6,19,1454,1006,2460,2169
0132-000,2014,8,6,20,1183,760,1943,2460
0132-000,2014,8,6,21,927,605,1532,1943
0132-000,2014,8,6,22,656,548,1204,1532
0132-000,2014,8,6,23,420,387,807,1204
0132-000,2014,8,6,24,295,202,497,807
0132-000,2014,8,7,1,203,191,394,497
0132-000,2014,8,7,2,146,144,290,394
0132-000,2014,8,7,3,111,113,224,290
0132-000,2014,8,7,4,77,100,177,224
0132-000,2014,8,7,5,126,123,249,177
0132-000,2014,8,7,6,204,177,381,249
0132-000,2014,8,7,7,407,504,911,381
0132-000,2014,8,7,8,680,1420,2100,911
0132-000,2014,8,7,9,860,1415,2275,2100
0132-000,2014,8,7,10,795,1005,1800,2275
0132-000,2014,8,7,11,850,986,1836,1800
0132-000,2014,8,7,12,937,934,1871,1836
0132-000,2014,8,7,13,868,864,1732,1871
0132-000,2014,8,7,14,873,916,1789,1732
0132-000,2014,8,7,15,946,942,1888,1789
0132-000,2014,8,7,16,966,953,1919,1888
0132-000,2014,8,7,17,1051,907,1958,1919
0132-000,2014,8,7,18,1084,873,1957,1958
0132-000,2014,8,7,19,1244,956,2200,1957
0132-000,2014,8,7,20,909,706,1615,2200
0132-000,2014,8,7,21,863,653,1516,1615
0132-000,2014,8,7,22,672,517,1189,1516
0132-000,2014,8,7,23,405,335,740,1189
0132-000,2014,8,7,24,272,259,531,740
0132-000,2014,8,8,1,212,175,387,531
0132-000,2014,8,8,2,150,130,280,387
0132-000,2014,8,8,3,117,108,225,280
0132-000,2014,8,8,4,91,91,182,225
0132-000,2014,8,8,5,131,123,254,182
0132-000,2014,8,8,6,214,208,422,254
0132-000,2014,8,8,7,418,521,939,422
0132-000,2014,8,8,8,680,1547,2227,939
0132-000,2014,8,8,9,855,1452,2307,2227
0132-000,2014,8,8,10,821,1038,1859,2307
0132-000,2014,8,8,11,840,945,1785,1859
0132-000,2014,8,8,12,925,929,1854,1785
0132-000,2014,8,8,13,887,921,1808,1854
0132-000,2014,8,8,14,928,1011,1939,1808
0132-000,2014,8,8,15,968,1057,2025,1939
0132-000,2014,8,8,16,1126,1079,2205,2025
0132-000,2014,8,8,17,1121,1034,2155,2205
0132-000,2014,8,8,18,1294,1046,2340,2155
0132-000,2014,8,8,19,1497,1046,2543,2340
0132-000,2014,8,8,20,1160,923,2083,2543
0132-000,2014,8,8,21,997,738,1735,2083
0132-000,2014,8,8,22,840,596,1436,1735
0132-000,2014,8,8,23,491,463,954,1436
0132-000,2014,8,8,24,376,329,705,954
0132-000,2014,8,9,1,234,258,492,705
0132-000,2014,8,9,2,173,184,357,492
0132-000,2014,8,9,3,149,140,289,357
0132-000,2014,8,9,4,108,135,243,289
0132-000,2014,8,9,5,149,153,302,243
0132-000,2014,8,9,6,230,165,395,302
0132-000,2014,8,9,7,370,377,747,395
0132-000,2014,8,9,8,572,875,1447,747
0132-000,2014,8,9,9,748,1015,1763,1447
0132-000,2014,8,9,10,802,967,1769,1763
0132-000,2014,8,9,11,823,1322,2145,1769
0132-000,2014,8,9,12,865,1454,2319,2145
0132-000,2014,8,9,13,906,1510,2416,2319
0132-000,2014,8,9,14,938,1454,2392,2416
0132-000,2014,8,9,15,976,1186,2162,2392
0132-000,2014,8,9,16,1017,1156,2173,2162
0132-000,2014,8,9,17,1108,1029,2137,2173
0132-000,2014,8,9,18,1309,1122,2431,2137
0132-000,2014,8,9,19,1175,906,2081,2431
0132-000,2014,8,9,20,1030,779,1809,2081
0132-000,2014,8,9,21,756,562,1318,1809
0132-000,2014,8,9,22,760,490,1250,1318
0132-000,2014,8,9,23,400,386,786,1250
0132-000,2014,8,9,24,302,282,584,786
0132-000,2014,8,10,1,207,228,435,584
0132-000,2014,8,10,2,184,150,334,435
0132-000,2014,8,10,3,134,123,257,334
0132-000,2014,8,10,4,123,104,227,257
0132-000,2014,8,10,5,103,98,201,227
0132-000,2014,8,10,6,157,143,300,201
0132-000,2014,8,10,7,247,224,471,300
0132-000,2014,8,10,8,341,368,709,471
0132-000,2014,8,10,9,462,484,946,709
0132-000,2014,8,10,10,516,556,1072,946
0132-000,2014,8,10,11,615,595,1210,1072
0132-000,2014,8,10,12,648,574,1222,1210
0132-000,2014,8,10,13,844,611,1455,1222
0132-000,2014,8,10,14,857,669,1526,1455
0132-000,2014,8,10,15,1034,617,1651,1526
0132-000,2014,8,10,16,1037,672,1709,1651
0132-000,2014,8,10,17,1136,686,1822,1709
0132-000,2014,8,10,18,1202,672,1874,1822
0132-000,2014,8,10,19,1155,562,1717,1874
0132-000,2014,8,10,20,1015,553,1568,1717
0132-000,2014,8,10,21,782,469,1251,1568
0132-000,2014,8,10,22,697,407,1104,1251
0132-000,2014,8,10,23,376,314,690,1104
0132-000,2014,8,10,24,218,245,463,690
0132-000,2014,8,11,1,159,145,304,463
0132-000,2014,8,11,2,87,100,187,304
0132-000,2014,8,11,3,65,76,141,187
0132-000,2014,8,11,4,58,90,148,141
0132-000,2014,8,11,5,96,96,192,148
0132-000,2014,8,11,6,166,164,330,192
0132-000,2014,8,11,7,445,589,1034,330
0132-000,2014,8,11,8,708,1786,2494,1034
0132-000,2014,8,11,9,848,1505,2353,2494
0132-000,2014,8,11,10,839,1000,1839,2353
0132-000,2014,8,11,11,890,1013,1903,1839
0132-000,2014,8,11,12,885,993,1878,1903
0132-000,2014,8,11,13,843,953,1796,1878
0132-000,2014,8,11,14,921,959,1880,1796
0132-000,2014,8,11,15,1005,1035,2040,1880
0132-000,2014,8,11,16,1055,1070,2125,2040
0132-000,2014,8,11,17,1114,972,2086,2125
0132-000,2014,8,11,18,1159,949,2108,2086
0132-000,2014,8,11,19,1278,927,2205,2108
0132-000,2014,8,11,20,961,801,1762,2205
0132-000,2014,8,11,21,858,658,1516,1762
0132-000,2014,8,11,22,698,503,1201,1516
0132-000,2014,8,11,23,426,373,799,1201
0132-000,2014,8,11,24,271,251,522,799
0132-000,2014,8,12,1,166,136,302,522
0132-000,2014,8,12,2,100,89,189,302
0132-000,2014,8,12,3,96,74,170,189
0132-000,2014,8,12,4,77,76,153,170
0132-000,2014,8,12,5,94,78,172,153
0132-000,2014,8,12,6,194,155,349,172
0132-000,2014,8,12,7,386,401,787,349
0132-000,2014,8,12,8,629,1500,2129,787
0132-000,2014,8,12,9,780,1226,2006,2129
0132-000,2014,8,12,10,780,902,1682,2006
0132-000,2014,8,12,11,806,845,1651,1682
0132-000,2014,8,12,12,839,880,1719,1651
0132-000,2014,8,12,13,755,792,1547,1719
0132-000,2014,8,12,14,798,773,1571,1547
0132-000,2014,8,12,15,838,894,1732,1571
0132-000,2014,8,12,16,943,820,1763,1732
0132-000,2014,8,12,17,901,800,1701,1763
0132-000,2014,8,12,18,1059,825,1884,1701
0132-000,2014,8,12,19,1210,821,2031,1884
0132-000,2014,8,12,20,950,684,1634,2031
0132-000,2014,8,12,21,822,493,1315,1634
0132-000,2014,8,12,22,585,457,1042,1315
0132-000,2014,8,12,23,343,278,621,1042
0132-000,2014,8,12,24,217,206,423,621
0132-000,2014,8,13,1,178,296,474,423
0132-000,2014,8,13,2,100,189,289,474
0132-000,2014,8,13,3,71,132,203,289
0132-000,2014,8,13,4,74,157,231,203
0132-000,2014,8,13,5,83,189,272,231
0132-000,2014,8,13,6,165,365,530,272
0132-000,2014,8,13,7,397,899,1296,530
0132-000,2014,8,13,8,613,2885,3498,1296
0132-000,2014,8,13,9,796,2163,2959,3498
0132-000,2014,8,13,10,714,1597,2311,2959
0132-000,2014,8,13,11,801,758,1559,2311
0132-000,2014,8,13,12,738,762,1500,1559
0132-000,2014,8,13,13,699,852,1551,1500
0132-000,2014,8,13,14,837,839,1676,1551
0132-000,2014,8,13,15,864,918,1782,1676
0132-000,2014,8,13,16,949,751,1700,1782
0132-000,2014,8,13,17,993,775,1768,1700
0132-000,2014,8,13,18,1242,781,2023,1768
0132-000,2014,8,13,19,1392,809,2201,2023
0132-000,2014,8,13,20,1000,629,1629,2201
0132-000,2014,8,13,21,742,441,1183,1629
0132-000,2014,8,13,22,508,392,900,1183
0132-000,2014,8,13,23,346,254,600,900
0132-000,2014,8,13,24,216,168,384,600
0132-000,2014,8,14,1,156,104,260,384
0132-000,2014,8,14,2,112,78,190,260
0132-000,2014,8,14,3,91,66,157,190
0132-000,2014,8,14,4,92,66,158,157
0132-000,2014,8,14,5,92,83,175,158
0132-000,2014,8,14,6,146,130,276,175
0132-000,2014,8,14,7,403,380,783,276
0132-000,2014,8,14,8,620,1518,2138,783
0132-000,2014,8,14,9,785,1213,1998,2138
0132-000,2014,8,14,10,749,875,1624,1998
0132-000,2014,8,14,11,784,818,1602,1624
0132-000,2014,8,14,12,791,854,1645,1602
0132-000,2014,8,14,13,720,788,1508,1645
0132-000,2014,8,14,14,840,753,1593,1508
0132-000,2014,8,14,15,933,860,1793,1593
0132-000,2014,8,14,16,970,871,1841,1793
0132-000,2014,8,14,17,947,971,1918,1841
0132-000,2014,8,14,18,1149,875,2024,1918
0132-000,2014,8,14,19,1519,958,2477,2024
0132-000,2014,8,14,20,1141,775,1916,2477
0132-000,2014,8,14,21,992,572,1564,1916
0132-000,2014,8,14,22,675,450,1125,1564
0132-000,2014,8,14,23,428,309,737,1125
0132-000,2014,8,14,24,255,202,457,737
0132-000,2014,8,15,1,196,158,354,457
0132-000,2014,8,15,2,134,140,274,354
0132-000,2014,8,15,3,110,100,210,274
0132-000,2014,8,15,4,84,74,158,210
0132-000,2014,8,15,5,90,93,183,158
0132-000,2014,8,15,6,165,138,303,183
0132-000,2014,8,15,7,359,286,645,303
0132-000,2014,8,15,8,461,854,1315,645
0132-000,2014,8,15,9,573,975,1548,1315
0132-000,2014,8,15,10,588,1240,1828,1548
0132-000,2014,8,15,11,619,1657,2276,1828
0132-000,2014,8,15,12,745,1804,2549,2276
0132-000,2014,8,15,13,633,1738,2371,2549
0132-000,2014,8,15,14,722,1796,2518,2371
0132-000,2014,8,15,15,767,1802,2569,2518
0132-000,2014,8,15,16,843,1510,2353,2569
0132-000,2014,8,15,17,911,986,1897,2353
0132-000,2014,8,15,18,1120,888,2008,1897
0132-000,2014,8,15,19,1074,787,1861,2008
0132-000,2014,8,15,20,864,623,1487,1861
0132-000,2014,8,15,21,708,409,1117,1487
0132-000,2014,8,15,22,489,384,873,1117
0132-000,2014,8,15,23,343,262,605,873
0132-000,2014,8,15,24,220,226,446,605
0132-000,2014,8,16,1,168,121,289,446
0132-000,2014,8,16,2,103,100,203,289
0132-000,2014,8,16,3,89,66,155,203
0132-000,2014,8,16,4,60,74,134,155
0132-000,2014,8,16,5,82,81,163,134
0132-000,2014,8,16,6,167,126,293,163
0132-000,2014,8,16,7,355,271,626,293
0132-000,2014,8,16,8,378,708,1086,626
0132-000,2014,8,16,9,585,674,1259,1086
0132-000,2014,8,16,10,612,683,1295,1259
0132-000,2014,8,16,11,635,706,1341,1295
0132-000,2014,8,16,12,740,854,1594,1341
0132-000,2014,8,16,13,775,800,1575,1594
0132-000,2014,8,16,14,793,766,1559,1575
0132-000,2014,8,16,15,797,824,1621,1559
0132-000,2014,8,16,16,908,1196,2104,1621
0132-000,2014,8,16,17,1304,1521,2825,2104
0132-000,2014,8,16,18,1545,1411,2956,2825
0132-000,2014,8,16,19,1690,762,2452,2956
0132-000,2014,8,16,20,1555,555,2110,2452
0132-000,2014,8,16,21,1351,454,1805,2110
0132-000,2014,8,16,22,1066,324,1390,1805
0132-000,2014,8,16,23,593,237,830,1390
0132-000,2014,8,16,24,290,204,494,830
0132-000,2014,8,17,1,216,175,391,494
0132-000,2014,8,17,2,111,95,206,391
0132-000,2014,8,17,3,79,95,174,206
0132-000,2014,8,17,4,104,53,157,174
0132-000,2014,8,17,5,80,76,156,157
0132-000,2014,8,17,6,138,91,229,156
0132-000,2014,8,17,7,202,179,381,229
0132-000,2014,8,17,8,242,268,510,381
0132-000,2014,8,17,9,340,346,686,510
0132-000,2014,8,17,10,430,424,854,686
0132-000,2014,8,17,11,505,495,1000,854
0132-000,2014,8,17,12,691,587,1278,1000
0132-000,2014,8,17,13,855,610,1465,1278
0132-000,2014,8,17,14,897,619,1516,1465
0132-000,2014,8,17,15,1089,620,1709,1516
0132-000,2014,8,17,16,1127,610,1737,1709
0132-000,2014,8,17,17,1227,557,1784,1737
0132-000,2014,8,17,18,1248,535,1783,1784
0132-000,2014,8,17,19,1323,519,1842,1783
0132-000,2014,8,17,20,966,450,1416,1842
0132-000,2014,8,17,21,891,424,1315,1416
0132-000,2014,8,17,22,486,281,767,1315
0132-000,2014,8,17,23,273,251,524,767
0132-000,2014,8,17,24,167,143,310,524
0132-000,2014,8,18,1,106,76,182,310
0132-000,2014,8,18,2,73,72,145,182
0132-000,2014,8,18,3,58,44,102,145
0132-000,2014,8,18,4,54,51,105,102
0132-000,2014,8,18,5,80,53,133,105
0132-000,2014,8,18,6,141,143,284,133
0132-000,2014,8,18,7,417,506,923,284
0132-000,2014,8,18,8,625,1724,2349,923
0132-000,2014,8,18,9,770,1196,1966,2349
0132-000,2014,8,18,10,749,820,1569,1966
0132-000,2014,8,18,11,697,813,1510,1569
0132-000,2014,8,18,12,724,785,1509,1510
0132-000,2014,8,18,13,761,719,1480,1509
0132-000,2014,8,18,14,776,790,1566,1480
0132-000,2014,8,18,15,842,766,1608,1566
0132-000,2014,8,18,16,873,770,1643,1608
0132-000,2014,8,18,17,941,779,1720,1643
0132-000,2014,8,18,18,1051,726,1777,1720
0132-000,2014,8,18,19,1224,766,1990,1777
0132-000,2014,8,18,20,811,572,1383,1990
0132-000,2014,8,18,21,746,437,1183,1383
0132-000,2014,8,18,22,498,384,882,1183
0132-000,2014,8,18,23,310,215,525,882
0132-000,2014,8,18,24,197,151,348,525
0132-000,2014,8,19,1,145,110,255,348
0132-000,2014,8,19,2,92,66,158,255
0132-000,2014,8,19,3,84,61,145,158
0132-000,2014,8,19,4,77,51,128,145
0132-000,2014,8,19,5,66,51,117,128
0132-000,2014,8,19,6,144,117,261,117
0132-000,2014,8,19,7,352,367,719,261
0132-000,2014,8,19,8,588,1626,2214,719
0132-000,2014,8,19,9,761,1236,1997,2214
0132-000,2014,8,19,10,694,824,1518,1997
0132-000,2014,8,19,11,773,788,1561,1518
0132-000,2014,8,19,12,771,802,1573,1561
0132-000,2014,8,19,13,749,764,1513,1573
0132-000,2014,8,19,14,819,715,1534,1513
0132-000,2014,8,19,15,860,815,1675,1534
0132-000,2014,8,19,16,895,852,1747,1675
0132-000,2014,8,19,17,843,766,1609,1747
0132-000,2014,8,19,18,1047,745,1792,1609
0132-000,2014,8,19,19,1199,787,1986,1792
0132-000,2014,8,19,20,830,598,1428,1986
0132-000,2014,8,19,21,734,405,1139,1428
0132-000,2014,8,19,22,582,373,955,1139
0132-000,2014,8,19,23,328,234,562,955
0132-000,2014,8,19,24,217,164,381,562
0132-000,2014,8,20,1,187,136,323,381
0132-000,2014,8,20,2,106,89,195,323
0132-000,2014,8,20,3,84,83,167,195
0132-000,2014,8,20,4,76,55,131,167
0132-000,2014,8,20,5,66,64,130,131
0132-000,2014,8,20,6,169,126,295,130
0132-000,2014,8,20,7,419,435,854,295
0132-000,2014,8,20,8,659,1658,2317,854
0132-000,2014,8,20,9,784,1206,1990,2317
0132-000,2014,8,20,10,716,899,1615,1990
0132-000,2014,8,20,11,759,790,1549,1615
0132-000,2014,8,20,12,785,753,1538,1549
0132-000,2014,8,20,13,724,728,1452,1538
0132-000,2014,8,20,14,764,762,1526,1452
0132-000,2014,8,20,15,786,790,1576,1526
0132-000,2014,8,20,16,832,775,1607,1576
0132-000,2014,8,20,17,910,815,1725,1607
0132-000,2014,8,20,18,1166,858,2024,1725
0132-000,2014,8,20,19,1304,854,2158,2024
0132-000,2014,8,20,20,956,655,1611,2158
0132-000,2014,8,20,21,710,442,1152,1611
0132-000,2014,8,20,22,549,377,926,1152
0132-000,2014,8,20,23,320,275,595,926
0132-000,2014,8,20,24,247,177,424,595
0132-000,2014,8,21,1,169,106,275,424
0132-000,2014,8,21,2,108,85,193,275
0132-000,2014,8,21,3,75,79,154,193
0132-000,2014,8,21,4,73,68,141,154
0132-000,2014,8,21,5,82,64,146,141
0132-000,2014,8,21,6,110,121,231,146
0132-000,2014,8,21,7,327,326,653,231
0132-000,2014,8,21,8,595,1641,2236,653
0132-000,2014,8,21,9,751,1238,1989,2236
0132-000,2014,8,21,10,716,696,1412,1989
0132-000,2014,8,21,11,672,704,1376,1412
0132-000,2014,8,21,12,746,760,1506,1376
0132-000,2014,8,21,13,670,787,1457,1506
0132-000,2014,8,21,14,684,811,1495,1457
0132-000,2014,8,21,15,723,762,1485,1495
0132-000,2014,8,21,16,838,743,1581,1485
0132-000,2014,8,21,17,911,692,1603,1581
0132-000,2014,8,21,18,1032,732,1764,1603
0132-000,2014,8,21,19,1226,756,1982,1764
0132-000,2014,8,21,20,819,585,1404,1982
0132-000,2014,8,21,21,684,442,1126,1404
0132-000,2014,8,21,22,543,394,937,1126
0132-000,2014,8,21,23,352,215,567,937
0132-000,2014,8,21,24,208,160,368,567
0132-000,2014,8,22,1,151,123,274,368
0132-000,2014,8,22,2,105,87,192,274
0132-000,2014,8,22,3,88,61,149,192
0132-000,2014,8,22,4,56,74,130,149
0132-000,2014,8,22,5,81,64,145,130
0132-000,2014,8,22,6,171,121,292,145
0132-000,2014,8,22,7,382,435,817,292
0132-000,2014,8,22,8,691,1713,2404,817
0132-000,2014,8,22,9,754,1277,2031,2404
0132-000,2014,8,22,10,757,824,1581,2031
0132-000,2014,8,22,11,768,952,1720,1581
0132-000,2014,8,22,12,804,1089,1893,1720
0132-000,2014,8,22,13,729,916,1645,1893
0132-000,2014,8,22,14,851,847,1698,1645
0132-000,2014,8,22,15,885,830,1715,1698
0132-000,2014,8,22,16,954,946,1900,1715
0132-000,2014,8,22,17,978,1106,2084,1900
0132-000,2014,8,22,18,1220,1012,2232,2084
0132-000,2014,8,22,19,1448,1016,2464,2232
0132-000,2014,8,22,20,1112,790,1902,2464
0132-000,2014,8,22,21,902,521,1423,1902
0132-000,2014,8,22,22,602,484,1086,1423
0132-000,2014,8,22,23,407,324,731,1086
0132-000,2014,8,22,24,282,266,548,731
0132-000,2014,8,23,1,201,213,414,548
0132-000,2014,8,23,2,167,115,282,414
0132-000,2014,8,23,3,114,79,193,282
0132-000,2014,8,23,4,82,108,190,193
0132-000,2014,8,23,5,106,111,217,190
0132-000,2014,8,23,6,188,147,335,217
0132-000,2014,8,23,7,379,463,842,335
0132-000,2014,8,23,8,530,1243,1773,842
0132-000,2014,8,23,9,710,1401,2111,1773
0132-000,2014,8,23,10,716,1430,2146,2111
0132-000,2014,8,23,11,766,1516,2282,2146
0132-000,2014,8,23,12,860,1510,2370,2282
0132-000,2014,8,23,13,800,1274,2074,2370
0132-000,2014,8,23,14,908,1106,2014,2074
0132-000,2014,8,23,15,997,1016,2013,2014
0132-000,2014,8,23,16,1017,944,1961,2013
0132-000,2014,8,23,17,1276,969,2245,1961
0132-000,2014,8,23,18,1547,1029,2576,2245
0132-000,2014,8,23,19,1588,841,2429,2576
0132-000,2014,8,23,20,1322,709,2031,2429
0132-000,2014,8,23,21,1044,516,1560,2031
0132-000,2014,8,23,22,697,418,1115,1560
0132-000,2014,8,23,23,422,322,744,1115
0132-000,2014,8,23,24,244,228,472,744
0132-000,2014,8,24,1,202,164,366,472
0132-000,2014,8,24,2,160,119,279,366
0132-000,2014,8,24,3,99,85,184,279
0132-000,2014,8,24,4,84,64,148,184
0132-000,2014,8,24,5,91,78,169,148
0132-000,2014,8,24,6,137,128,265,169
0132-000,2014,8,24,7,266,283,549,265
0132-000,2014,8,24,8,311,585,896,549
0132-000,2014,8,24,9,419,730,1149,896
0132-000,2014,8,24,10,454,608,1062,1149
0132-000,2014,8,24,11,576,625,1201,1062
0132-000,2014,8,24,12,726,602,1328,1201
0132-000,2014,8,24,13,1057,685,1742,1328
0132-000,2014,8,24,14,1299,674,1973,1742
0132-000,2014,8,24,15,691,719,1410,1973
0132-000,2014,8,24,16,789,753,1542,1410
0132-000,2014,8,24,17,959,651,1610,1542
0132-000,2014,8,24,18,935,700,1635,1610
0132-000,2014,8,24,19,954,583,1537,1635
0132-000,2014,8,24,20,789,469,1258,1537
0132-000,2014,8,24,21,807,403,1210,1258
0132-000,2014,8,24,22,665,360,1025,1210
0132-000,2014,8,24,23,328,247,575,1025
0132-000,2014,8,24,24,177,166,343,575
0132-000,2014,8,25,1,169,125,294,343
0132-000,2014,8,25,2,61,70,131,294
0132-000,2014,8,25,3,65,40,105,131
0132-000,2014,8,25,4,37,51,88,105
0132-000,2014,8,25,5,104,70,174,88
0132-000,2014,8,25,6,174,188,362,174
0132-000,2014,8,25,7,429,627,1056,362
0132-000,2014,8,25,8,689,2049,2738,1056
0132-000,2014,8,25,9,747,1643,2390,2738
0132-000,2014,8,25,10,766,1040,1806,2390
0132-000,2014,8,25,11,866,1021,1887,1806
0132-000,2014,8,25,12,810,1008,1818,1887
0132-000,2014,8,25,13,754,925,1679,1818
0132-000,2014,8,25,14,827,942,1769,1679
0132-000,2014,8,25,15,970,951,1921,1769
0132-000,2014,8,25,16,985,953,1938,1921
0132-000,2014,8,25,17,972,929,1901,1938
0132-000,2014,8,25,18,1121,907,2028,1901
0132-000,2014,8,25,19,1238,927,2165,2028
0132-000,2014,8,25,20,944,789,1733,2165
0132-000,2014,8,25,21,797,551,1348,1733
0132-000,2014,8,25,22,548,422,970,1348
0132-000,2014,8,25,23,366,300,666,970
0132-000,2014,8,25,24,247,177,424,666
0132-000,2014,8,26,1,178,127,305,424
0132-000,2014,8,26,2,100,68,168,305
0132-000,2014,8,26,3,72,75,147,168
0132-000,2014,8,26,4,70,75,145,147
0132-000,2014,8,26,5,104,73,177,145
0132-000,2014,8,26,6,202,153,355,177
0132-000,2014,8,26,7,405,509,914,355
0132-000,2014,8,26,8,673,2132,2805,914
0132-000,2014,8,26,9,773,1652,2425,2805
0132-000,2014,8,26,10,773,957,1730,2425
0132-000,2014,8,26,11,773,968,1741,1730
0132-000,2014,8,26,12,799,1018,1817,1741
0132-000,2014,8,26,13,853,868,1721,1817
0132-000,2014,8,26,14,927,986,1913,1721
0132-000,2014,8,26,15,918,1032,1950,1913
0132-000,2014,8,26,16,957,1023,1980,1950
0132-000,2014,8,26,17,937,935,1872,1980
0132-000,2014,8,26,18,1193,977,2170,1872
0132-000,2014,8,26,19,1324,990,2314,2170
0132-000,2014,8,26,20,1030,730,1760,2314
0132-000,2014,8,26,21,834,595,1429,1760
0132-000,2014,8,26,22,572,509,1081,1429
0132-000,2014,8,26,23,353,287,640,1081
0132-000,2014,8,26,24,262,206,468,640
0132-000,2014,8,27,1,178,149,327,468
0132-000,2014,8,27,2,152,88,240,327
0132-000,2014,8,27,3,91,86,177,240
0132-000,2014,8,27,4,70,64,134,177
0132-000,2014,8,27,5,89,79,168,134
0132-000,2014,8,27,6,184,121,305,168
0132-000,2014,8,27,7,416,496,912,305
0132-000,2014,8,27,8,639,2044,2683,912
0132-000,2014,8,27,9,773,1600,2373,2683
0132-000,2014,8,27,10,799,957,1756,2373
0132-000,2014,8,27,11,838,935,1773,1756
0132-000,2014,8,27,12,810,955,1765,1773
0132-000,2014,8,27,13,853,894,1747,1765
0132-000,2014,8,27,14,864,970,1834,1747
0132-000,2014,8,27,15,989,1139,2128,1834
0132-000,2014,8,27,16,944,968,1912,2128
0132-000,2014,8,27,17,955,949,1904,1912
0132-000,2014,8,27,18,1223,1104,2327,1904
0132-000,2014,8,27,19,1325,986,2311,2327
0132-000,2014,8,27,20,1015,780,1795,2311
0132-000,2014,8,27,21,771,590,1361,1795
0132-000,2014,8,27,22,613,527,1140,1361
0132-000,2014,8,27,23,388,337,725,1140
0132-000,2014,8,27,24,347,223,570,725
0132-000,2014,8,28,1,191,167,358,570
0132-000,2014,8,28,2,113,121,234,358
0132-000,2014,8,28,3,107,79,186,234
0132-000,2014,8,28,4,78,81,159,186
0132-000,2014,8,28,5,96,92,188,159
0132-000,2014,8,28,6,241,145,386,188
0132-000,2014,8,28,7,464,586,1050,386
0132-000,2014,8,28,8,693,2141,2834,1050
0132-000,2014,8,28,9,786,1648,2434,2834
0132-000,2014,8,28,10,766,1082,1848,2434
0132-000,2014,8,28,11,857,1005,1862,1848
0132-000,2014,8,28,12,901,994,1895,1862
0132-000,2014,8,28,13,816,933,1749,1895
0132-000,2014,8,28,14,894,979,1873,1749
0132-000,2014,8,28,15,959,927,1886,1873
0132-000,2014,8,28,16,1024,944,1968,1886
0132-000,2014,8,28,17,1080,970,2050,1968
0132-000,2014,8,28,18,1212,1049,2261,2050
0132-000,2014,8,28,19,1345,984,2329,2261
0132-000,2014,8,28,20,933,835,1768,2329
0132-000,2014,8,28,21,808,645,1453,1768
0132-000,2014,8,28,22,645,555,1200,1453
0132-000,2014,8,28,23,425,330,755,1200
0132-000,2014,8,28,24,264,210,474,755
0132-000,2014,8,29,1,161,164,325,474
0132-000,2014,8,29,2,158,123,281,325
0132-000,2014,8,29,3,98,79,177,281
0132-000,2014,8,29,4,83,79,162,177
0132-000,2014,8,29,5,76,79,155,162
0132-000,2014,8,29,6,221,151,372,155
0132-000,2014,8,29,7,440,542,982,372
0132-000,2014,8,29,8,600,2165,2765,982
0132-000,2014,8,29,9,721,1510,2231,2765
0132-000,2014,8,29,10,851,1029,1880,2231
0132-000,2014,8,29,11,864,933,1797,1880
0132-000,2014,8,29,12,868,953,1821,1797
0132-000,2014,8,29,13,834,951,1785,1821
0132-000,2014,8,29,14,942,1071,2013,1785
0132-000,2014,8,29,15,1007,1027,2034,2013
0132-000,2014,8,29,16,992,1126,2118,2034
0132-000,2014,8,29,17,981,1095,2076,2118
0132-000,2014,8,29,18,1234,1077,2311,2076
0132-000,2014,8,29,19,1544,1150,2694,2311
0132-000,2014,8,29,20,1147,955,2102,2694
0132-000,2014,8,29,21,953,743,1696,2102
0132-000,2014,8,29,22,678,571,1249,1696
0132-000,2014,8,29,23,418,361,779,1249
0132-000,2014,8,29,24,299,265,564,779
0132-000,2014,8,30,1,277,206,483,564
0132-000,2014,8,30,2,143,134,277,483
0132-000,2014,8,30,3,135,112,247,277
0132-000,2014,8,30,4,91,99,190,247
0132-000,2014,8,30,5,83,110,193,190
0132-000,2014,8,30,6,223,212,435,193
0132-000,2014,8,30,7,392,523,915,435
0132-000,2014,8,30,8,513,1195,1708,915
0132-000,2014,8,30,9,728,1416,2144,1708
0132-000,2014,8,30,10,721,1449,2170,2144
0132-000,2014,8,30,11,823,1485,2308,2170
0132-000,2014,8,30,12,862,1410,2272,2308
0132-000,2014,8,30,13,1017,1390,2407,2272
0132-000,2014,8,30,14,1292,1346,2638,2407
0132-000,2014,8,30,15,1498,1316,2814,2638
0132-000,2014,8,30,16,1336,1160,2496,2814
0132-000,2014,8,30,17,1422,1049,2471,2496
0132-000,2014,8,30,18,1753,1093,2846,2471
0132-000,2014,8,30,19,1759,1003,2762,2846
0132-000,2014,8,30,20,1528,756,2284,2762
0132-000,2014,8,30,21,1080,592,1672,2284
0132-000,2014,8,30,22,779,483,1262,1672
0132-000,2014,8,30,23,487,418,905,1262
0132-000,2014,8,30,24,264,234,498,905
0132-000,2014,8,31,1,204,164,368,498
0132-000,2014,8,31,2,158,129,287,368
0132-000,2014,8,31,3,126,97,223,287
0132-000,2014,8,31,4,91,75,166,223
0132-000,2014,8,31,5,115,105,220,166
0132-000,2014,8,31,6,158,162,320,220
0132-000,2014,8,31,7,301,313,614,320
0132-000,2014,8,31,8,386,691,1077,614
0132-000,2014,8,31,9,537,724,1261,1077
0132-000,2014,8,31,10,496,726,1222,1261
0132-000,2014,8,31,11,643,835,1478,1222
0132-000,2014,8,31,12,680,820,1500,1478
0132-000,2014,8,31,13,892,839,1731,1500
0132-000,2014,8,31,14,955,831,1786,1731
0132-000,2014,8,31,15,1290,809,2099,1786
0132-000,2014,8,31,16,1394,901,2295,2099
0132-000,2014,8,31,17,1600,800,2400,2295
0132-000,2014,8,31,18,1632,776,2408,2400
0132-000,2014,8,31,19,1780,734,2514,2408
0132-000,2014,8,31,20,1251,608,1859,2514
0132-000,2014,8,31,21,1115,575,1690,1859
0132-000,2014,8,31,22,634,378,1012,1690
0132-000,2014,8,31,23,429,291,720,1012
0132-000,2014,8,31,24,221,215,436,720
0132-000,2014,9,1,1,116,130,246,436
0132-000,2014,9,1,2,116,76,192,246
0132-000,2014,9,1,3,67,74,141,192
0132-000,2014,9,1,4,61,80,141,141
0132-000,2014,9,1,5,78,57,135,141
0132-000,2014,9,1,6,245,168,413,135
0132-000,2014,9,1,7,552,679,1231,413
0132-000,2014,9,1,8,696,2143,2839,1231
0132-000,2014,9,1,9,810,1575,2385,2839
0132-000,2014,9,1,10,807,1004,1811,2385
0132-000,2014,9,1,11,892,1072,1964,1811
0132-000,2014,9,1,12,934,970,1904,1964
0132-000,2014,9,1,13,830,963,1793,1904
0132-000,2014,9,1,14,963,996,1959,1793
0132-000,2014,9,1,15,988,1010,1998,1959
0132-000,2014,9,1,16,1052,929,1981,1998
0132-000,2014,9,1,17,1028,1008,2036,1981
0132-000,2014,9,1,18,1201,960,2161,2036
0132-000,2014,9,1,19,1338,960,2298,2161
0132-000,2014,9,1,20,1063,887,1950,2298
0132-000,2014,9,1,21,892,564,1456,1950
0132-000,2014,9,1,22,694,466,1160,1456
0132-000,2014,9,1,23,403,313,716,1160
0132-000,2014,9,1,24,263,192,455,716
0132-000,2014,9,2,1,189,137,326,455
0132-000,2014,9,2,2,116,80,196,326
0132-000,2014,9,2,3,105,61,166,196
0132-000,2014,9,2,4,89,68,157,166
0132-000,2014,9,2,5,83,76,159,157
0132-000,2014,9,2,6,218,135,353,159
0132-000,2014,9,2,7,485,550,1035,353
0132-000,2014,9,2,8,730,2132,2862,1035
0132-000,2014,9,2,9,830,1586,2416,2862
0132-000,2014,9,2,10,850,1091,1941,2416
0132-000,2014,9,2,11,823,1087,1910,1941
0132-000,2014,9,2,12,916,1046,1962,1910
0132-000,2014,9,2,13,852,863,1715,1962
0132-000,2014,9,2,14,1021,1065,2086,1715
0132-000,2014,9,2,15,1019,1179,2198,2086
0132-000,2014,9,2,16,1001,1062,2063,2198
0132-000,2014,9,2,17,1130,920,2050,2063
0132-000,2014,9,2,18,1239,970,2209,2050
0132-000,2014,9,2,19,1367,998,2365,2209
0132-000,2014,9,2,20,1036,778,1814,2365
0132-000,2014,9,2,21,854,541,1395,1814
0132-000,2014,9,2,22,681,514,1195,1395
0132-000,2014,9,2,23,410,293,703,1195
0132-000,2014,9,2,24,236,180,416,703
0132-000,2014,9,3,1,209,156,365,416
0132-000,2014,9,3,2,163,88,251,365
0132-000,2014,9,3,3,89,83,172,251
0132-000,2014,9,3,4,54,85,139,172
0132-000,2014,9,3,5,78,76,154,139
0132-000,2014,9,3,6,149,114,263,154
0132-000,2014,9,3,7,334,420,754,263
0132-000,2014,9,3,8,610,1810,2420,754
0132-000,2014,9,3,9,767,1433,2200,2420
0132-000,2014,9,3,10,785,906,1691,2200
0132-000,2014,9,3,11,810,925,1735,1691
0132-000,2014,9,3,12,868,868,1736,1735
0132-000,2014,9,3,13,859,812,1671,1736
0132-000,2014,9,3,14,928,887,1815,1671
0132-000,2014,9,3,15,919,970,1889,1815
0132-000,2014,9,3,16,992,979,1971,1889
0132-000,2014,9,3,17,1043,939,1982,1971
0132-000,2014,9,3,18,1192,937,2129,1982
0132-000,2014,9,3,19,1326,908,2234,2129
0132-000,2014,9,3,20,1021,781,1802,2234
0132-000,2014,9,3,21,836,558,1394,1802
0132-000,2014,9,3,22,639,474,1113,1394
0132-000,2014,9,3,23,418,322,740,1113
0132-000,2014,9,3,24,310,225,535,740
0132-000,2014,9,4,1,212,218,430,535
0132-000,2014,9,4,2,121,88,209,430
0132-000,2014,9,4,3,98,69,167,209
0132-000,2014,9,4,4,61,80,141,167
0132-000,2014,9,4,5,114,99,213,141
0132-000,2014,9,4,6,198,154,352,213
0132-000,2014,9,4,7,421,514,935,352
0132-000,2014,9,4,8,656,1991,2647,935
0132-000,2014,9,4,9,776,1492,2268,2647
0132-000,2014,9,4,10,786,1077,1863,2268
0132-000,2014,9,4,11,802,1004,1806,1863
0132-000,2014,9,4,12,963,1072,2035,1806
0132-000,2014,9,4,13,899,908,1807,2035
0132-000,2014,9,4,14,994,1008,2002,1807
0132-000,2014,9,4,15,1012,1089,2101,2002
0132-000,2014,9,4,16,1137,981,2118,2101
0132-000,2014,9,4,17,1141,937,2078,2118
0132-000,2014,9,4,18,1330,1017,2347,2078
0132-000,2014,9,4,19,1462,1115,2577,2347
0132-000,2014,9,4,20,1072,863,1935,2577
0132-000,2014,9,4,21,916,576,1492,1935
0132-000,2014,9,4,22,772,541,1313,1492
0132-000,2014,9,4,23,463,368,831,1313
0132-000,2014,9,4,24,265,220,485,831
0132-000,2014,9,5,1,216,189,405,485
0132-000,2014,9,5,2,138,118,256,405
0132-000,2014,9,5,3,105,105,210,256
0132-000,2014,9,5,4,94,74,168,210
0132-000,2014,9,5,5,105,90,195,168
0132-000,2014,9,5,6,192,126,318,195
0132-000,2014,9,5,7,467,516,983,318
0132-000,2014,9,5,8,663,1995,2658,983
0132-000,2014,9,5,9,825,1469,2294,2658
0132-000,2014,9,5,10,861,1054,1915,2294
0132-000,2014,9,5,11,879,973,1852,1915
0132-000,2014,9,5,12,912,1010,1922,1852
0132-000,2014,9,5,13,948,1084,2032,1922
0132-000,2014,9,5,14,943,954,1897,2032
0132-000,2014,9,5,15,1101,1013,2114,1897
0132-000,2014,9,5,16,1130,1148,2278,2114
0132-000,2014,9,5,17,1172,1231,2403,2278
0132-000,2014,9,5,18,1461,1375,2836,2403
0132-000,2014,9,5,19,1491,1656,3147,2836
0132-000,2014,9,5,20,1172,1329,2501,3147
0132-000,2014,9,5,21,787,868,1655,2501
0132-000,2014,9,5,22,603,552,1155,1655
0132-000,2014,9,5,23,425,460,885,1155
0132-000,2014,9,5,24,294,351,645,885
0132-000,2014,9,6,1,238,1309,1547,645
0132-000,2014,9,6,2,187,1016,1203,1547
0132-000,2014,9,6,3,132,1042,1174,1203
0132-000,2014,9,6,4,114,1338,1452,1174
0132-000,2014,9,6,5,147,1496,1643,1452
0132-000,2014,9,6,6,149,1485,1634,1643
0132-000,2014,9,6,7,301,1436,1737,1634
0132-000,2014,9,6,8,427,1688,2115,1737
0132-000,2014,9,6,9,592,1696,2288,2115
0132-000,2014,9,6,10,634,1639,2273,2288
0132-000,2014,9,6,11,741,1680,2421,2273
0132-000,2014,9,6,12,763,1614,2377,2421
0132-000,2014,9,6,13,745,1697,2442,2377
0132-000,2014,9,6,14,805,1733,2538,2442
0132-000,2014,9,6,15,803,1821,2624,2538
0132-000,2014,9,6,16,869,1692,2561,2624
0132-000,2014,9,6,17,812,2104,2916,2561
0132-000,2014,9,6,18,841,1857,2698,2916
0132-000,2014,9,6,19,834,1547,2381,2698
0132-000,2014,9,6,20,725,1189,1914,2381
0132-000,2014,9,6,21,579,1098,1677,1914
0132-000,2014,9,6,22,432,811,1243,1677
0132-000,2014,9,6,23,334,648,982,1243
0132-000,2014,9,6,24,225,549,774,982
0132-000,2014,9,7,1,167,444,611,774
0132-000,2014,9,7,2,143,423,566,611
0132-000,2014,9,7,3,121,391,512,566
0132-000,2014,9,7,4,76,329,405,512
0132-000,2014,9,7,5,81,424,505,405
0132-000,2014,9,7,6,105,536,641,505
0132-000,2014,9,7,7,143,894,1037,641
0132-000,2014,9,7,8,283,1269,1552,1037
0132-000,2014,9,7,9,401,1185,1586,1552
0132-000,2014,9,7,10,556,1268,1824,1586
0132-000,2014,9,7,11,645,1659,2304,1824
0132-000,2014,9,7,12,683,1760,2443,2304
0132-000,2014,9,7,13,687,1648,2335,2443
0132-000,2014,9,7,14,665,1630,2295,2335
0132-000,2014,9,7,15,667,1724,2391,2295
0132-000,2014,9,7,16,641,1733,2374,2391
0132-000,2014,9,7,17,694,1819,2513,2374
0132-000,2014,9,7,18,619,1751,2370,2513
0132-000,2014,9,7,19,552,1476,2028,2370
0132-000,2014,9,7,20,532,1494,2026,2028
0132-000,2014,9,7,21,430,1012,1442,2026
0132-000,2014,9,7,22,318,773,1091,1442
0132-000,2014,9,7,23,292,396,688,1091
0132-000,2014,9,7,24,181,241,422,688
0132-000,2014,9,8,1,89,151,240,422
0132-000,2014,9,8,2,134,117,251,240
0132-000,2014,9,8,3,67,81,148,251
0132-000,2014,9,8,4,49,78,127,148
0132-000,2014,9,8,5,76,64,140,127
0132-000,2014,9,8,6,114,89,203,140
0132-000,2014,9,8,7,292,196,488,203
0132-000,2014,9,8,8,432,381,813,488
0132-000,2014,9,8,9,432,425,857,813
0132-000,2014,9,8,10,645,539,1184,857
0132-000,2014,9,8,11,1205,703,1908,1184
0132-000,2014,9,8,12,1835,851,2686,1908
0132-000,2014,9,8,13,1986,892,2878,2686
0132-000,2014,9,8,14,2333,1003,3336,2878
0132-000,2014,9,8,15,2524,974,3498,3336
0132-000,2014,9,8,16,2506,929,3435,3498
0132-000,2014,9,8,17,2519,851,3370,3435
0132-000,2014,9,8,18,2529,752,3281,3370
0132-000,2014,9,8,19,2393,676,3069,3281
0132-000,2014,9,8,20,2346,549,2895,3069
0132-000,2014,9,8,21,2410,444,2854,2895
0132-000,2014,9,8,22,1955,353,2308,2854
0132-000,2014,9,8,23,2261,313,2574,2308
0132-000,2014,9,8,24,1479,230,1709,2574
0132-000,2014,9,9,1,1210,132,1342,1709
0132-000,2014,9,9,2,936,90,1026,1342
0132-000,2014,9,9,3,652,64,716,1026
0132-000,2014,9,9,4,269,43,312,716
0132-000,2014,9,9,5,125,47,172,312
0132-000,2014,9,9,6,116,53,169,172
0132-000,2014,9,9,7,192,95,287,169
0132-000,2014,9,9,8,330,174,504,287
0132-000,2014,9,9,9,503,239,742,504
0132-000,2014,9,9,10,825,427,1252,742
0132-000,2014,9,9,11,1119,550,1669,1252
0132-000,2014,9,9,12,1530,706,2236,1669
0132-000,2014,9,9,13,1497,705,2202,2236
0132-000,2014,9,9,14,1735,608,2343,2202
0132-000,2014,9,9,15,1772,622,2394,2343
0132-000,2014,9,9,16,2106,673,2779,2394
0132-000,2014,9,9,17,2229,597,2826,2779
0132-000,2014,9,9,18,2199,543,2742,2826
0132-000,2014,9,9,19,2010,520,2530,2742
0132-000,2014,9,9,20,2086,416,2502,2530
0132-000,2014,9,9,21,1674,382,2056,2502
0132-000,2014,9,9,22,1843,306,2149,2056
0132-000,2014,9,9,23,1706,259,1965,2149
0132-000,2014,9,9,24,1583,172,1755,1965
0132-000,2014,9,10,1,1568,137,1705,1755
0132-000,2014,9,10,2,810,93,903,1705
0132-000,2014,9,10,3,601,93,694,903
0132-000,2014,9,10,4,181,66,247,694
0132-000,2014,9,10,5,85,57,142,247
0132-000,2014,9,10,6,98,74,172,142
0132-000,2014,9,10,7,263,228,491,172
0132-000,2014,9,10,8,416,647,1063,491
0132-000,2014,9,10,9,518,505,1023,1063
0132-000,2014,9,10,10,585,536,1121,1023
0132-000,2014,9,10,11,743,668,1411,1121
0132-000,2014,9,10,12,812,700,1512,1411
0132-000,2014,9,10,13,896,643,1539,1512
0132-000,2014,9,10,14,972,741,1713,1539
0132-000,2014,9,10,15,996,728,1724,1713
0132-000,2014,9,10,16,1108,683,1791,1724
0132-000,2014,9,10,17,1134,695,1829,1791
0132-000,2014,9,10,18,1043,671,1714,1829
0132-000,2014,9,10,19,1094,614,1708,1714
0132-000,2014,9,10,20,839,522,1361,1708
0132-000,2014,9,10,21,676,445,1121,1361
0132-000,2014,9,10,22,525,351,876,1121
0132-000,2014,9,10,23,352,276,628,876
0132-000,2014,9,10,24,218,216,434,628
0132-000,2014,9,11,1,185,120,305,434
0132-000,2014,9,11,2,112,59,171,305
0132-000,2014,9,11,3,56,69,125,171
0132-000,2014,9,11,4,72,59,131,125
0132-000,2014,9,11,5,74,59,133,131
0132-000,2014,9,11,6,174,190,364,133
0132-000,2014,9,11,7,441,531,972,364
0132-000,2014,9,11,8,694,1914,2608,972
0132-000,2014,9,11,9,767,1546,2313,2608
0132-000,2014,9,11,10,807,937,1744,2313
0132-000,2014,9,11,11,747,944,1691,1744
0132-000,2014,9,11,12,872,854,1726,1691
0132-000,2014,9,11,13,839,854,1693,1726
0132-000,2014,9,11,14,836,860,1696,1693
0132-000,2014,9,11,15,948,825,1773,1696
0132-000,2014,9,11,16,916,831,1747,1773
0132-000,2014,9,11,17,919,892,1811,1747
0132-000,2014,9,11,18,1252,977,2229,1811
0132-000,2014,9,11,19,1244,873,2117,2229
0132-000,2014,9,11,20,932,702,1634,2117
0132-000,2014,9,11,21,801,448,1249,1634
0132-000,2014,9,11,22,541,379,920,1249
0132-000,2014,9,11,23,370,282,652,920
0132-000,2014,9,11,24,227,138,365,652
0132-000,2014,9,12,1,161,124,285,365
0132-000,2014,9,12,2,121,95,216,285
0132-000,2014,9,12,3,98,76,174,216
0132-000,2014,9,12,4,105,43,148,174
0132-000,2014,9,12,5,63,74,137,148
0132-000,2014,9,12,6,189,135,324,137
0132-000,2014,9,12,7,494,520,1014,324
0132-000,2014,9,12,8,670,1963,2633,1014
0132-000,2014,9,12,9,783,1501,2284,2633
0132-000,2014,9,12,10,785,913,1698,2284
0132-000,2014,9,12,11,843,877,1720,1698
0132-000,2014,9,12,12,836,1025,1861,1720
0132-000,2014,9,12,13,821,858,1679,1861
0132-000,2014,9,12,14,894,965,1859,1679
0132-000,2014,9,12,15,954,925,1879,1859
0132-000,2014,9,12,16,983,868,1851,1879
0132-000,2014,9,12,17,968,899,1867,1851
0132-000,2014,9,12,18,1265,1065,2330,1867
0132-000,2014,9,12,19,1458,923,2381,2330
0132-000,2014,9,12,20,1083,812,1895,2381
0132-000,2014,9,12,21,848,576,1424,1895
0132-000,2014,9,12,22,603,479,1082,1424
0132-000,2014,9,12,23,390,308,698,1082
0132-000,2014,9,12,24,287,235,522,698
0132-000,2014,9,13,1,201,182,383,522
0132-000,2014,9,13,2,183,130,313,383
0132-000,2014,9,13,3,121,105,226,313
0132-000,2014,9,13,4,107,90,197,226
0132-000,2014,9,13,5,136,107,243,197
0132-000,2014,9,13,6,192,156,348,243
0132-000,2014,9,13,7,425,372,797,348
0132-000,2014,9,13,8,532,1044,1576,797
0132-000,2014,9,13,9,703,968,1671,1576
0132-000,2014,9,13,10,725,937,1662,1671
0132-000,2014,9,13,11,894,948,1842,1662
0132-000,2014,9,13,12,883,1215,2098,1842
0132-000,2014,9,13,13,819,1000,1819,2098
0132-000,2014,9,13,14,845,902,1747,1819
0132-000,2014,9,13,15,1003,977,1980,1747
0132-000,2014,9,13,16,1019,889,1908,1980
0132-000,2014,9,13,17,1014,899,1913,1908
0132-000,2014,9,13,18,1265,933,2198,1913
0132-000,2014,9,13,19,1262,875,2137,2198
0132-000,2014,9,13,20,905,662,1567,2137
0132-000,2014,9,13,21,661,445,1106,1567
0132-000,2014,9,13,22,483,368,851,1106
0132-000,2014,9,13,23,394,334,728,851
0132-000,2014,9,13,24,225,214,439,728
0132-000,2014,9,14,1,198,197,395,439
0132-000,2014,9,14,2,158,121,279,395
0132-000,2014,9,14,3,92,78,170,279
0132-000,2014,9,14,4,96,55,151,170
0132-000,2014,9,14,5,89,74,163,151
0132-000,2014,9,14,6,143,105,248,163
0132-000,2014,9,14,7,274,237,511,248
0132-000,2014,9,14,8,332,439,771,511
0132-000,2014,9,14,9,401,512,913,771
0132-000,2014,9,14,10,463,516,979,913
0132-000,2014,9,14,11,610,656,1266,979
0132-000,2014,9,14,12,641,574,1215,1266
0132-000,2014,9,14,13,685,695,1380,1215
0132-000,2014,9,14,14,712,656,1368,1380
0132-000,2014,9,14,15,816,708,1524,1368
0132-000,2014,9,14,16,899,756,1655,1524
0132-000,2014,9,14,17,1025,650,1675,1655
0132-000,2014,9,14,18,1083,706,1789,1675
0132-000,2014,9,14,19,854,595,1449,1789
0132-000,2014,9,14,20,723,558,1281,1449
0132-000,2014,9,14,21,574,458,1032,1281
0132-000,2014,9,14,22,401,351,752,1032
0132-000,2014,9,14,23,261,278,539,752
0132-000,2014,9,14,24,221,180,401,539
0132-000,2014,9,15,1,123,116,239,401
0132-000,2014,9,15,2,123,87,210,239
0132-000,2014,9,15,3,72,57,129,210
0132-000,2014,9,15,4,49,38,87,129
0132-000,2014,9,15,5,94,51,145,87
0132-000,2014,9,15,6,209,166,375,145
0132-000,2014,9,15,7,545,619,1164,375
0132-000,2014,9,15,8,690,2169,2859,1164
0132-000,2014,9,15,9,734,1561,2295,2859
0132-000,2014,9,15,10,814,960,1774,2295
0132-000,2014,9,15,11,827,970,1797,1774
0132-000,2014,9,15,12,910,894,1804,1797
0132-000,2014,9,15,13,852,849,1701,1804
0132-000,2014,9,15,14,890,908,1798,1701
0132-000,2014,9,15,15,930,941,1871,1798
0132-000,2014,9,15,16,943,935,1878,1871
0132-000,2014,9,15,17,1001,902,1903,1878
0132-000,2014,9,15,18,1252,1023,2275,1903
0132-000,2014,9,15,19,1289,896,2185,2275
0132-000,2014,9,15,20,974,750,1724,2185
0132-000,2014,9,15,21,825,501,1326,1724
0132-000,2014,9,15,22,581,432,1013,1326
0132-000,2014,9,15,23,325,266,591,1013
0132-000,2014,9,15,24,232,170,402,591
0132-000,2014,9,16,1,161,116,277,402
0132-000,2014,9,16,2,127,114,241,277
0132-000,2014,9,16,3,92,59,151,241
0132-000,2014,9,16,4,89,76,165,151
0132-000,2014,9,16,5,92,85,177,165
0132-000,2014,9,16,6,176,156,332,177
0132-000,2014,9,16,7,478,536,1014,332
0132-000,2014,9,16,8,665,2061,2726,1014
0132-000,2014,9,16,9,852,1549,2401,2726
0132-000,2014,9,16,10,825,1052,1877,2401
0132-000,2014,9,16,11,836,1058,1894,1877
0132-000,2014,9,16,12,874,915,1789,1894
0132-000,2014,9,16,13,839,904,1743,1789
0132-000,2014,9,16,14,939,854,1793,1743
0132-000,2014,9,16,15,954,935,1889,1793
0132-000,2014,9,16,16,930,939,1869,1889
0132-000,2014,9,16,17,932,868,1800,1869
0132-000,2014,9,16,18,1194,996,2190,1800
0132-000,2014,9,16,19,1324,913,2237,2190
0132-000,2014,9,16,20,1039,777,1816,2237
0132-000,2014,9,16,21,801,483,1284,1816
0132-000,2014,9,16,22,619,464,1083,1284
0132-000,2014,9,16,23,392,306,698,1083
0132-000,2014,9,16,24,285,204,489,698
0132-000,2014,9,17,1,167,114,281,489
0132-000,2014,9,17,2,98,99,197,281
0132-000,2014,9,17,3,72,101,173,197
0132-000,2014,9,17,4,76,76,152,173
0132-000,2014,9,17,5,85,88,173,152
0132-000,2014,9,17,6,181,140,321,173
0132-000,2014,9,17,7,490,495,985,321
0132-000,2014,9,17,8,654,2005,2659,985
0132-000,2014,9,17,9,796,1519,2315,2659
0132-000,2014,9,17,10,823,1106,1929,2315
0132-000,2014,9,17,11,843,963,1806,1929
0132-000,2014,9,17,12,872,908,1780,1806
0132-000,2014,9,17,13,761,837,1598,1780
0132-000,2014,9,17,14,894,906,1800,1598
0132-000,2014,9,17,15,923,958,1881,1800
0132-000,2014,9,17,16,961,941,1902,1881
0132-000,2014,9,17,17,988,827,1815,1902
0132-000,2014,9,17,18,1305,968,2273,1815
0132-000,2014,9,17,19,1446,925,2371,2273
0132-000,2014,9,17,20,939,777,1716,2371
0132-000,2014,9,17,21,767,439,1206,1716
0132-000,2014,9,17,22,541,441,982,1206
0132-000,2014,9,17,23,394,282,676,982
0132-000,2014,9,17,24,252,187,439,676
0132-000,2014,9,18,1,209,151,360,439
0132-000,2014,9,18,2,132,88,220,360
0132-000,2014,9,18,3,76,74,150,220
0132-000,2014,9,18,4,81,93,174,150
0132-000,2014,9,18,5,65,95,160,174
0132-000,2014,9,18,6,212,149,361,160
0132-000,2014,9,18,7,456,531,987,361
0132-000,2014,9,18,8,639,1957,2596,987
0132-000,2014,9,18,9,743,1559,2302,2596
0132-000,2014,9,18,10,774,1077,1851,2302
0132-000,2014,9,18,11,767,949,1716,1851
0132-000,2014,9,18,12,827,956,1783,1716
0132-000,2014,9,18,13,770,899,1669,1783
0132-000,2014,9,18,14,821,814,1635,1669
0132-000,2014,9,18,15,963,977,1940,1635
0132-000,2014,9,18,16,923,897,1820,1940
0132-000,2014,9,18,17,928,939,1867,1820
0132-000,2014,9,18,18,1241,939,2180,1867
0132-000,2014,9,18,19,1347,873,2220,2180
0132-000,2014,9,18,20,988,666,1654,2220
0132-000,2014,9,18,21,801,572,1373,1654
0132-000,2014,9,18,22,674,501,1175,1373
0132-000,2014,9,18,23,438,291,729,1175
0132-000,2014,9,18,24,269,228,497,729
0132-000,2014,9,19,1,205,176,381,497
0132-000,2014,9,19,2,152,121,273,381
0132-000,2014,9,19,3,89,80,169,273
0132-000,2014,9,19,4,65,68,133,169
0132-000,2014,9,19,5,81,83,164,133
0132-000,2014,9,19,6,236,166,402,164
0132-000,2014,9,19,7,454,472,926,402
0132-000,2014,9,19,8,707,1959,2666,926
0132-000,2014,9,19,9,812,1482,2294,2666
0132-000,2014,9,19,10,834,963,1797,2294
0132-000,2014,9,19,11,843,1001,1844,1797
0132-000,2014,9,19,12,799,949,1748,1844
0132-000,2014,9,19,13,876,894,1770,1748
0132-000,2014,9,19,14,874,899,1773,1770
0132-000,2014,9,19,15,956,991,1947,1773
0132-000,2014,9,19,16,1041,852,1893,1947
0132-000,2014,9,19,17,939,1015,1954,1893
0132-000,2014,9,19,18,1234,1001,2235,1954
0132-000,2014,9,19,19,1472,1067,2539,2235
0132-000,2014,9,19,20,1163,847,2010,2539
0132-000,2014,9,19,21,910,589,1499,2010
0132-000,2014,9,19,22,665,555,1220,1499
0132-000,2014,9,19,23,487,334,821,1220
0132-000,2014,9,19,24,310,287,597,821
0132-000,2014,9,20,1,265,195,460,597
0132-000,2014,9,20,2,181,149,330,460
0132-000,2014,9,20,3,141,128,269,330
0132-000,2014,9,20,4,107,101,208,269
0132-000,2014,9,20,5,105,95,200,208
0132-000,2014,9,20,6,176,156,332,200
0132-000,2014,9,20,7,387,410,797,332
0132-000,2014,9,20,8,541,1000,1541,797
0132-000,2014,9,20,9,752,1060,1812,1541
0132-000,2014,9,20,10,719,948,1667,1812
0132-000,2014,9,20,11,803,1175,1978,1667
0132-000,2014,9,20,12,885,1171,2056,1978
0132-000,2014,9,20,13,883,1172,2055,2056
0132-000,2014,9,20,14,956,1013,1969,2055
0132-000,2014,9,20,15,1005,916,1921,1969
0132-000,2014,9,20,16,1043,963,2006,1921
0132-000,2014,9,20,17,1141,1006,2147,2006
0132-000,2014,9,20,18,1511,1094,2605,2147
0132-000,2014,9,20,19,1288,923,2211,2605
0132-000,2014,9,20,20,1137,708,1845,2211
0132-000,2014,9,20,21,772,487,1259,1845
0132-000,2014,9,20,22,545,510,1055,1259
0132-000,2014,9,20,23,405,324,729,1055
0132-000,2014,9,20,24,249,232,481,729
0132-000,2014,9,21,1,194,187,381,481
0132-000,2014,9,21,2,169,121,290,381
0132-000,2014,9,21,3,92,72,164,290
0132-000,2014,9,21,4,112,93,205,164
0132-000,2014,9,21,5,121,80,201,205
0132-000,2014,9,21,6,165,93,258,201
0132-000,2014,9,21,7,265,258,523,258
0132-000,2014,9,21,8,336,382,718,523
0132-000,2014,9,21,9,425,484,909,718
0132-000,2014,9,21,10,521,660,1181,909
0132-000,2014,9,21,11,590,739,1329,1181
0132-000,2014,9,21,12,627,708,1335,1329
0132-000,2014,9,21,13,705,770,1475,1335
0132-000,2014,9,21,14,783,704,1487,1475
0132-000,2014,9,21,15,832,760,1592,1487
0132-000,2014,9,21,16,959,773,1732,1592
0132-000,2014,9,21,17,1061,735,1796,1732
0132-000,2014,9,21,18,1285,758,2043,1796
0132-000,2014,9,21,19,1334,629,1963,2043
0132-000,2014,9,21,20,963,548,1511,1963
0132-000,2014,9,21,21,807,514,1321,1511
0132-000,2014,9,21,22,612,403,1015,1321
0132-000,2014,9,21,23,294,289,583,1015
0132-000,2014,9,21,24,187,201,388,583
0132-000,2014,9,22,1,132,120,252,388
0132-000,2014,9,22,2,74,87,161,252
0132-000,2014,9,22,3,85,49,134,161
0132-000,2014,9,22,4,54,55,109,134
0132-000,2014,9,22,5,81,69,150,109
0132-000,2014,9,22,6,174,145,319,150
0132-000,2014,9,22,7,476,666,1142,319
0132-000,2014,9,22,8,690,2305,2995,1142
0132-000,2014,9,22,9,765,2304,3069,2995
0132-000,2014,9,22,10,841,1155,1996,3069
0132-000,2014,9,22,11,856,1027,1883,1996
0132-000,2014,9,22,12,841,904,1745,1883
0132-000,2014,9,22,13,787,818,1605,1745
0132-000,2014,9,22,14,852,839,1691,1605
0132-000,2014,9,22,15,959,956,1915,1691
0132-000,2014,9,22,16,954,985,1939,1915
0132-000,2014,9,22,17,988,929,1917,1939
0132-000,2014,9,22,18,1168,933,2101,1917
0132-000,2014,9,22,19,1338,913,2251,2101
0132-000,2014,9,22,20,965,743,1708,2251
0132-000,2014,9,22,21,852,535,1387,1708
0132-000,2014,9,22,22,614,470,1084,1387
0132-000,2014,9,22,23,358,297,655,1084
0132-000,2014,9,22,24,258,145,403,655
0132-000,2014,9,23,1,225,124,349,403
0132-000,2014,9,23,2,109,93,202,349
0132-000,2014,9,23,3,94,69,163,202
0132-000,2014,9,23,4,78,74,152,163
0132-000,2014,9,23,5,96,88,184,152
0132-000,2014,9,23,6,203,140,343,184
0132-000,2014,9,23,7,438,555,993,343
0132-000,2014,9,23,8,654,2118,2772,993
0132-000,2014,9,23,9,799,1494,2293,2772
0132-000,2014,9,23,10,821,933,1754,2293
0132-000,2014,9,23,11,790,954,1744,1754
0132-000,2014,9,23,12,890,894,1784,1744
0132-000,2014,9,23,13,832,873,1705,1784
0132-000,2014,9,23,14,888,902,1790,1705
0132-000,2014,9,23,15,970,870,1840,1790
0132-000,2014,9,23,16,1008,844,1852,1840
0132-000,2014,9,23,17,1050,846,1896,1852
0132-000,2014,9,23,18,1177,966,2143,1896
0132-000,2014,9,23,19,1359,948,2307,2143
0132-000,2014,9,23,20,992,668,1660,2307
0132-000,2014,9,23,21,794,553,1347,1660
0132-000,2014,9,23,22,630,474,1104,1347
0132-000,2014,9,23,23,390,316,706,1104
0132-000,2014,9,23,24,252,199,451,706
0132-000,2014,9,24,1,196,132,328,451
0132-000,2014,9,24,2,118,68,186,328
0132-000,2014,9,24,3,76,90,166,186
0132-000,2014,9,24,4,83,69,152,166
0132-000,2014,9,24,5,105,68,173,152
0132-000,2014,9,24,6,136,104,240,173
0132-000,2014,9,24,7,363,395,758,240
0132-000,2014,9,24,8,594,1777,2371,758
0132-000,2014,9,24,9,799,1494,2293,2371
0132-000,2014,9,24,10,770,904,1674,2293
0132-000,2014,9,24,11,759,866,1625,1674
0132-000,2014,9,24,12,812,881,1693,1625
0132-000,2014,9,24,13,803,657,1460,1693
0132-000,2014,9,24,14,843,802,1645,1460
0132-000,2014,9,24,15,854,802,1656,1645
0132-000,2014,9,24,16,948,828,1776,1656
0132-000,2014,9,24,17,945,818,1763,1776
0132-000,2014,9,24,18,1212,887,2099,1763
0132-000,2014,9,24,19,1337,913,2250,2099
0132-000,2014,9,24,20,932,721,1653,2250
0132-000,2014,9,24,21,796,500,1296,1653
0132-000,2014,9,24,22,572,466,1038,1296
0132-000,2014,9,24,23,394,275,669,1038
0132-000,2014,9,24,24,263,190,453,669
0132-000,2014,9,25,1,209,137,346,453
0132-000,2014,9,25,2,145,118,263,346
0132-000,2014,9,25,3,101,83,184,263
0132-000,2014,9,25,4,72,95,167,184
0132-000,2014,9,25,5,114,66,180,167
0132-000,2014,9,25,6,225,168,393,180
0132-000,2014,9,25,7,463,524,987,393
0132-000,2014,9,25,8,683,1988,2671,987
0132-000,2014,9,25,9,839,1485,2324,2671
0132-000,2014,9,25,10,832,1052,1884,2324
0132-000,2014,9,25,11,810,998,1808,1884
0132-000,2014,9,25,12,883,929,1812,1808
0132-000,2014,9,25,13,812,860,1672,1812
0132-000,2014,9,25,14,919,915,1834,1672
0132-000,2014,9,25,15,970,1008,1978,1834
0132-000,2014,9,25,16,979,933,1912,1978
0132-000,2014,9,25,17,1105,933,2038,1912
0132-000,2014,9,25,18,1252,929,2181,2038
0132-000,2014,9,25,19,1428,1013,2441,2181
0132-000,2014,9,25,20,992,783,1775,2441
0132-000,2014,9,25,21,794,508,1302,1775
0132-000,2014,9,25,22,650,427,1077,1302
0132-000,2014,9,25,23,427,285,712,1077
0132-000,2014,9,25,24,269,226,495,712
0132-000,2014,9,26,1,192,156,348,495
0132-000,2014,9,26,2,127,97,224,348
0132-000,2014,9,26,3,107,78,185,224
0132-000,2014,9,26,4,83,88,171,185
0132-000,2014,9,26,5,105,78,183,171
0132-000,2014,9,26,6,196,159,355,183
0132-000,2014,9,26,7,501,535,1036,355
0132-000,2014,9,26,8,616,2083,2699,1036
0132-000,2014,9,26,9,754,1625,2379,2699
0132-000,2014,9,26,10,823,1219,2042,2379
0132-000,2014,9,26,11,874,1281,2155,2042
0132-000,2014,9,26,12,865,1292,2157,2155
0132-000,2014,9,26,13,863,1010,1873,2157
0132-000,2014,9,26,14,912,933,1845,1873
0132-000,2014,9,26,15,959,956,1915,1845
0132-000,2014,9,26,16,1016,937,1953,1915
0132-000,2014,9,26,17,1074,920,1994,1953
0132-000,2014,9,26,18,1299,1017,2316,1994
0132-000,2014,9,26,19,1539,991,2530,2316
0132-000,2014,9,26,20,1096,821,1917,2530
0132-000,2014,9,26,21,843,539,1382,1917
0132-000,2014,9,26,22,663,516,1179,1382
0132-000,2014,9,26,23,481,372,853,1179
0132-000,2014,9,26,24,265,218,483,853
0132-000,2014,9,27,1,214,192,406,483
0132-000,2014,9,27,2,201,120,321,406
0132-000,2014,9,27,3,123,111,234,321
0132-000,2014,9,27,4,92,80,172,234
0132-000,2014,9,27,5,114,93,207,172
0132-000,2014,9,27,6,187,157,344,207
0132-000,2014,9,27,7,425,399,824,344
0132-000,2014,9,27,8,523,975,1498,824
0132-000,2014,9,27,9,772,1035,1807,1498
0132-000,2014,9,27,10,801,1001,1802,1807
0132-000,2014,9,27,11,945,1288,2233,1802
0132-000,2014,9,27,12,934,1360,2294,2233
0132-000,2014,9,27,13,896,1219,2115,2294
0132-000,2014,9,27,14,899,1046,1945,2115
0132-000,2014,9,27,15,928,1238,2166,1945
0132-000,2014,9,27,16,961,1108,2069,2166
0132-000,2014,9,27,17,1003,892,1895,2069
0132-000,2014,9,27,18,1418,1054,2472,1895
0132-000,2014,9,27,19,1265,856,2121,2472
0132-000,2014,9,27,20,976,656,1632,2121
0132-000,2014,9,27,21,685,455,1140,1632
0132-000,2014,9,27,22,514,441,955,1140
0132-000,2014,9,27,23,356,320,676,955
0132-000,2014,9,27,24,265,228,493,676
0132-000,2014,9,28,1,198,180,378,493
0132-000,2014,9,28,2,163,111,274,378
0132-000,2014,9,28,3,134,76,210,274
0132-000,2014,9,28,4,103,57,160,210
0132-000,2014,9,28,5,127,76,203,160
0132-000,2014,9,28,6,152,118,270,203
0132-000,2014,9,28,7,272,222,494,270
0132-000,2014,9,28,8,345,399,744,494
0132-000,2014,9,28,9,467,466,933,744
0132-000,2014,9,28,10,550,587,1137,933
0132-000,2014,9,28,11,632,745,1377,1137
0132-000,2014,9,28,12,596,581,1177,1377
0132-000,2014,9,28,13,719,721,1440,1177
0132-000,2014,9,28,14,714,735,1449,1440
0132-000,2014,9,28,15,774,716,1490,1449
0132-000,2014,9,28,16,1014,728,1742,1490
0132-000,2014,9,28,17,1076,728,1804,1742
0132-000,2014,9,28,18,1332,754,2086,1804
0132-000,2014,9,28,19,1323,639,1962,2086
0132-000,2014,9,28,20,1056,501,1557,1962
0132-000,2014,9,28,21,787,431,1218,1557
0132-000,2014,9,28,22,521,387,908,1218
0132-000,2014,9,28,23,290,268,558,908
0132-000,2014,9,28,24,189,138,327,558
0132-000,2014,9,29,1,128,118,246,327
0132-000,2014,9,29,2,99,87,186,246
0132-000,2014,9,29,3,79,53,132,186
0132-000,2014,9,29,4,52,47,99,132
0132-000,2014,9,29,5,88,60,148,99
0132-000,2014,9,29,6,192,156,348,148
0132-000,2014,9,29,7,511,642,1153,348
0132-000,2014,9,29,8,690,2232,2922,1153
0132-000,2014,9,29,9,750,1939,2689,2922
0132-000,2014,9,29,10,828,1057,1885,2689
0132-000,2014,9,29,11,842,999,1841,1885
0132-000,2014,9,29,12,876,899,1775,1841
0132-000,2014,9,29,13,820,834,1654,1775
0132-000,2014,9,29,14,871,874,1745,1654
0132-000,2014,9,29,15,945,949,1894,1745
0132-000,2014,9,29,16,949,961,1910,1894
0132-000,2014,9,29,17,995,915,1910,1910
0132-000,2014,9,29,18,1210,979,2189,1910
0132-000,2014,9,29,19,1314,904,2218,2189
0132-000,2014,9,29,20,970,747,1717,2218
0132-000,2014,9,29,21,839,518,1357,1717
0132-000,2014,9,29,22,598,451,1049,1357
0132-000,2014,9,29,23,342,282,624,1049
0132-000,2014,9,29,24,245,157,402,624
0132-000,2014,9,30,1,193,121,314,402
0132-000,2014,9,30,2,118,104,222,314
0132-000,2014,9,30,3,93,65,158,222
0132-000,2014,9,30,4,84,75,159,158
0132-000,2014,9,30,5,94,87,181,159
0132-000,2014,9,30,6,190,148,338,181
0132-000,2014,9,30,7,458,546,1004,338
0132-000,2014,9,30,8,660,2088,2748,1004
0132-000,2014,9,30,9,826,1521,2347,2748
0132-000,2014,9,30,10,823,993,1816,2347
0132-000,2014,9,30,11,813,1006,1819,1816
0132-000,2014,9,30,12,882,904,1786,1819
0132-000,2014,9,30,13,836,889,1725,1786
0132-000,2014,9,30,14,914,879,1793,1725
0132-000,2014,9,30,15,962,903,1865,1793
0132-000,2014,9,30,16,969,892,1861,1865
0132-000,2014,9,30,17,991,857,1848,1861
0132-000,2014,9,30,18,1186,982,2168,1848
0132-000,2014,9,30,19,1342,931,2273,2168
0132-000,2014,9,30,20,1016,723,1739,2273
0132-000,2014,9,30,21,798,518,1316,1739
0132-000,2014,9,30,22,625,469,1094,1316
0132-000,2014,9,30,23,391,311,702,1094
0132-000,2014,9,30,24,269,202,471,702
0132-000,2014,10,1,1,194,181,375,471
0132-000,2014,10,1,2,104,126,230,375
0132-000,2014,10,1,3,87,116,203,230
0132-000,2014,10,1,4,91,96,187,203
0132-000,2014,10,1,5,79,87,166,187
0132-000,2014,10,1,6,152,141,293,166
0132-000,2014,10,1,7,292,341,633,293
0132-000,2014,10,1,8,489,1032,1521,633
0132-000,2014,10,1,9,574,966,1540,1521
0132-000,2014,10,1,10,581,734,1315,1540
0132-000,2014,10,1,11,668,730,1398,1315
0132-000,2014,10,1,12,746,757,1503,1398
0132-000,2014,10,1,13,666,708,1374,1503
0132-000,2014,10,1,14,713,719,1432,1374
0132-000,2014,10,1,15,774,795,1569,1432
0132-000,2014,10,1,16,911,744,1655,1569
0132-000,2014,10,1,17,970,763,1733,1655
0132-000,2014,10,1,18,1166,761,1927,1733
0132-000,2014,10,1,19,1222,777,1999,1927
0132-000,2014,10,1,20,991,666,1657,1999
0132-000,2014,10,1,21,767,525,1292,1657
0132-000,2014,10,1,22,565,438,1003,1292
0132-000,2014,10,1,23,353,316,669,1003
0132-000,2014,10,1,24,210,219,429,669
0132-000,2014,10,2,1,169,173,342,429
0132-000,2014,10,2,2,122,121,243,342
0132-000,2014,10,2,3,84,83,167,243
0132-000,2014,10,2,4,84,97,181,167
0132-000,2014,10,2,5,100,125,225,181
0132-000,2014,10,2,6,158,165,323,225
0132-000,2014,10,2,7,412,442,854,323
0132-000,2014,10,2,8,678,1245,1923,854
0132-000,2014,10,2,9,676,1051,1727,1923
0132-000,2014,10,2,10,670,902,1572,1727
0132-000,2014,10,2,11,713,989,1702,1572
0132-000,2014,10,2,12,731,982,1713,1702
0132-000,2014,10,2,13,692,831,1523,1713
0132-000,2014,10,2,14,748,778,1526,1523
0132-000,2014,10,2,15,898,843,1741,1526
0132-000,2014,10,2,16,944,772,1716,1741
0132-000,2014,10,2,17,1012,752,1764,1716
0132-000,2014,10,2,18,1266,822,2088,1764
0132-000,2014,10,2,19,1124,749,1873,2088
0132-000,2014,10,2,20,837,578,1415,1873
0132-000,2014,10,2,21,642,456,1098,1415
0132-000,2014,10,2,22,539,420,959,1098
0132-000,2014,10,2,23,299,271,570,959
0132-000,2014,10,2,24,190,186,376,570
0132-000,2014,10,3,1,154,151,305,376
0132-000,2014,10,3,2,89,106,195,305
0132-000,2014,10,3,3,79,86,165,195
0132-000,2014,10,3,4,67,88,155,165
0132-000,2014,10,3,5,92,103,195,155
0132-000,2014,10,3,6,160,148,308,195
0132-000,2014,10,3,7,425,473,898,308
0132-000,2014,10,3,8,769,1502,2271,898
0132-000,2014,10,3,9,775,1261,2036,2271
0132-000,2014,10,3,10,737,891,1628,2036
0132-000,2014,10,3,11,754,888,1642,1628
0132-000,2014,10,3,12,787,866,1653,1642
0132-000,2014,10,3,13,746,789,1535,1653
0132-000,2014,10,3,14,849,863,1712,1535
0132-000,2014,10,3,15,931,901,1832,1712
0132-000,2014,10,3,16,1010,833,1843,1832
0132-000,2014,10,3,17,974,871,1845,1843
0132-000,2014,10,3,18,1208,873,2081,1845
0132-000,2014,10,3,19,1366,858,2224,2081
0132-000,2014,10,3,20,1004,713,1717,2224
0132-000,2014,10,3,21,802,598,1400,1717
0132-000,2014,10,3,22,650,550,1200,1400
0132-000,2014,10,3,23,415,365,780,1200
0132-000,2014,10,3,24,260,263,523,780
0132-000,2014,10,4,1,219,212,431,523
0132-000,2014,10,4,2,146,154,300,431
0132-000,2014,10,4,3,110,124,234,300
0132-000,2014,10,4,4,93,121,214,234
0132-000,2014,10,4,5,108,119,227,214
0132-000,2014,10,4,6,179,158,337,227
0132-000,2014,10,4,7,337,356,693,337
0132-000,2014,10,4,8,593,920,1513,693
0132-000,2014,10,4,9,688,1005,1693,1513
0132-000,2014,10,4,10,731,1057,1788,1693
0132-000,2014,10,4,11,774,1158,1932,1788
0132-000,2014,10,4,12,887,1362,2249,1932
0132-000,2014,10,4,13,845,1215,2060,2249
0132-000,2014,10,4,14,859,1030,1889,2060
0132-000,2014,10,4,15,838,906,1744,1889
0132-000,2014,10,4,16,988,875,1863,1744
0132-000,2014,10,4,17,1167,901,2068,1863
0132-000,2014,10,4,18,1367,925,2292,2068
0132-000,2014,10,4,19,1332,796,2128,2292
0132-000,2014,10,4,20,1020,620,1640,2128
0132-000,2014,10,4,21,650,493,1143,1640
0132-000,2014,10,4,22,512,441,953,1143
0132-000,2014,10,4,23,347,320,667,953
0132-000,2014,10,4,24,233,262,495,667
0132-000,2014,10,5,1,203,194,397,495
0132-000,2014,10,5,2,149,146,295,397
0132-000,2014,10,5,3,106,101,207,295
0132-000,2014,10,5,4,86,92,178,207
0132-000,2014,10,5,5,82,77,159,178
0132-000,2014,10,5,6,120,133,253,159
0132-000,2014,10,5,7,219,253,472,253
0132-000,2014,10,5,8,322,455,777,472
0132-000,2014,10,5,9,383,523,906,777
0132-000,2014,10,5,10,443,597,1040,906
0132-000,2014,10,5,11,559,674,1233,1040
0132-000,2014,10,5,12,614,668,1282,1233
0132-000,2014,10,5,13,685,615,1300,1282
0132-000,2014,10,5,14,787,695,1482,1300
0132-000,2014,10,5,15,877,657,1534,1482
0132-000,2014,10,5,16,1237,705,1942,1534
0132-000,2014,10,5,17,1346,736,2082,1942
0132-000,2014,10,5,18,1384,744,2128,2082
0132-000,2014,10,5,19,1386,595,1981,2128
0132-000,2014,10,5,20,1287,546,1833,1981
0132-000,2014,10,5,21,851,426,1277,1833
0132-000,2014,10,5,22,754,379,1133,1277
0132-000,2014,10,5,23,379,293,672,1133
0132-000,2014,10,5,24,179,166,345,672
0132-000,2014,10,6,1,122,135,257,345
0132-000,2014,10,6,2,76,84,160,257
0132-000,2014,10,6,3,74,81,155,160
0132-000,2014,10,6,4,66,77,143,155
0132-000,2014,10,6,5,83,95,178,143
0132-000,2014,10,6,6,203,207,410,178
0132-000,2014,10,6,7,493,570,1063,410
0132-000,2014,10,6,8,745,1663,2408,1063
0132-000,2014,10,6,9,793,1383,2176,2408
0132-000,2014,10,6,10,712,917,1629,2176
0132-000,2014,10,6,11,775,859,1634,1629
0132-000,2014,10,6,12,797,844,1641,1634
0132-000,2014,10,6,13,766,852,1618,1641
0132-000,2014,10,6,14,835,890,1725,1618
0132-000,2014,10,6,15,886,895,1781,1725
0132-000,2014,10,6,16,988,888,1876,1781
0132-000,2014,10,6,17,1038,857,1895,1876
0132-000,2014,10,6,18,1147,865,2012,1895
0132-000,2014,10,6,19,1216,825,2041,2012
0132-000,2014,10,6,20,857,672,1529,2041
0132-000,2014,10,6,21,779,530,1309,1529
0132-000,2014,10,6,22,640,466,1106,1309
0132-000,2014,10,6,23,352,300,652,1106
0132-000,2014,10,6,24,219,205,424,652
0132-000,2014,10,7,1,165,157,322,424
0132-000,2014,10,7,2,95,111,206,322
0132-000,2014,10,7,3,72,81,153,206
0132-000,2014,10,7,4,81,92,173,153
0132-000,2014,10,7,5,101,116,217,173
0132-000,2014,10,7,6,193,164,357,217
0132-000,2014,10,7,7,381,437,818,357
0132-000,2014,10,7,8,725,1431,2156,818
0132-000,2014,10,7,9,790,1323,2113,2156
0132-000,2014,10,7,10,781,894,1675,2113
0132-000,2014,10,7,11,849,912,1761,1675
0132-000,2014,10,7,12,825,831,1656,1761
0132-000,2014,10,7,13,803,782,1585,1656
0132-000,2014,10,7,14,854,851,1705,1585
0132-000,2014,10,7,15,941,875,1816,1705
0132-000,2014,10,7,16,946,815,1761,1816
0132-000,2014,10,7,17,976,755,1731,1761
0132-000,2014,10,7,18,1114,823,1937,1731
0132-000,2014,10,7,19,1315,870,2185,1937
0132-000,2014,10,7,20,912,646,1558,2185
0132-000,2014,10,7,21,715,525,1240,1558
0132-000,2014,10,7,22,653,462,1115,1240
0132-000,2014,10,7,23,366,323,689,1115
0132-000,2014,10,7,24,235,205,440,689
0132-000,2014,10,8,1,179,201,380,440
0132-000,2014,10,8,2,129,129,258,380
0132-000,2014,10,8,3,114,116,230,258
0132-000,2014,10,8,4,85,101,186,230
0132-000,2014,10,8,5,102,100,202,186
0132-000,2014,10,8,6,205,160,365,202
0132-000,2014,10,8,7,368,378,746,365
0132-000,2014,10,8,8,685,1134,1819,746
0132-000,2014,10,8,9,796,1082,1878,1819
0132-000,2014,10,8,10,689,854,1543,1878
0132-000,2014,10,8,11,739,843,1582,1543
0132-000,2014,10,8,12,783,870,1653,1582
0132-000,2014,10,8,13,732,777,1509,1653
0132-000,2014,10,8,14,797,780,1577,1509
0132-000,2014,10,8,15,840,786,1626,1577
0132-000,2014,10,8,16,874,793,1667,1626
0132-000,2014,10,8,17,879,774,1653,1667
0132-000,2014,10,8,18,1018,796,1814,1653
0132-000,2014,10,8,19,1047,780,1827,1814
0132-000,2014,10,8,20,767,583,1350,1827
0132-000,2014,10,8,21,534,455,989,1350
0132-000,2014,10,8,22,455,402,857,989
0132-000,2014,10,8,23,304,294,598,857
0132-000,2014,10,8,24,199,207,406,598
0132-000,2014,10,9,1,144,164,308,406
0132-000,2014,10,9,2,128,115,243,308
0132-000,2014,10,9,3,80,97,177,243
0132-000,2014,10,9,4,77,90,167,177
0132-000,2014,10,9,5,82,95,177,167
0132-000,2014,10,9,6,154,155,309,177
0132-000,2014,10,9,7,408,462,870,309
0132-000,2014,10,9,8,744,1554,2298,870
0132-000,2014,10,9,9,813,1348,2161,2298
0132-000,2014,10,9,10,790,923,1713,2161
0132-000,2014,10,9,11,770,874,1644,1713
0132-000,2014,10,9,12,834,883,1717,1644
0132-000,2014,10,9,13,804,799,1603,1717
0132-000,2014,10,9,14,807,885,1692,1603
0132-000,2014,10,9,15,942,916,1858,1692
0132-000,2014,10,9,16,948,894,1842,1858
0132-000,2014,10,9,17,1004,853,1857,1842
0132-000,2014,10,9,18,1155,854,2009,1857
0132-000,2014,10,9,19,1244,905,2149,2009
0132-000,2014,10,9,20,905,666,1571,2149
0132-000,2014,10,9,21,739,522,1261,1571
0132-000,2014,10,9,22,711,480,1191,1261
0132-000,2014,10,9,23,426,339,765,1191
0132-000,2014,10,9,24,236,219,455,765
0132-000,2014,10,10,1,170,165,335,455
0132-000,2014,10,10,2,131,115,246,335
0132-000,2014,10,10,3,106,114,220,246
0132-000,2014,10,10,4,104,105,209,220
0132-000,2014,10,10,5,94,106,200,209
0132-000,2014,10,10,6,176,166,342,200
0132-000,2014,10,10,7,406,448,854,342
0132-000,2014,10,10,8,726,1495,2221,854
0132-000,2014,10,10,9,795,1287,2082,2221
0132-000,2014,10,10,10,759,925,1684,2082
0132-000,2014,10,10,11,750,886,1636,1684
0132-000,2014,10,10,12,818,876,1694,1636
0132-000,2014,10,10,13,791,789,1580,1694
0132-000,2014,10,10,14,901,894,1795,1580
0132-000,2014,10,10,15,920,888,1808,1795
0132-000,2014,10,10,16,1001,879,1880,1808
0132-000,2014,10,10,17,1052,900,1952,1880
0132-000,2014,10,10,18,1430,952,2382,1952
0132-000,2014,10,10,19,1554,890,2444,2382
0132-000,2014,10,10,20,1040,727,1767,2444
0132-000,2014,10,10,21,805,626,1431,1767
0132-000,2014,10,10,22,663,527,1190,1431
0132-000,2014,10,10,23,426,383,809,1190
0132-000,2014,10,10,24,270,259,529,809
0132-000,2014,10,11,1,200,205,405,529
0132-000,2014,10,11,2,155,158,313,405
0132-000,2014,10,11,3,113,134,247,313
0132-000,2014,10,11,4,78,107,185,247
0132-000,2014,10,11,5,123,137,260,185
0132-000,2014,10,11,6,184,167,351,260
0132-000,2014,10,11,7,341,354,695,351
0132-000,2014,10,11,8,639,950,1589,695
0132-000,2014,10,11,9,766,1125,1891,1589
0132-000,2014,10,11,10,814,1190,2004,1891
0132-000,2014,10,11,11,770,1332,2102,2004
0132-000,2014,10,11,12,870,1470,2340,2102
0132-000,2014,10,11,13,853,1479,2332,2340
0132-000,2014,10,11,14,935,1337,2272,2332
0132-000,2014,10,11,15,1032,1187,2219,2272
0132-000,2014,10,11,16,989,1132,2121,2219
0132-000,2014,10,11,17,1234,1109,2343,2121
0132-000,2014,10,11,18,1498,1104,2602,2343
0132-000,2014,10,11,19,1377,938,2315,2602
0132-000,2014,10,11,20,969,640,1609,2315
0132-000,2014,10,11,21,677,508,1185,1609
0132-000,2014,10,11,22,582,484,1066,1185
0132-000,2014,10,11,23,376,373,749,1066
0132-000,2014,10,11,24,239,265,504,749
0132-000,2014,10,12,1,175,190,365,504
0132-000,2014,10,12,2,161,162,323,365
0132-000,2014,10,12,3,110,107,217,323
0132-000,2014,10,12,4,79,87,166,217
0132-000,2014,10,12,5,106,95,201,166
0132-000,2014,10,12,6,128,131,259,201
0132-000,2014,10,12,7,221,240,461,259
0132-000,2014,10,12,8,332,444,776,461
0132-000,2014,10,12,9,384,557,941,776
0132-000,2014,10,12,10,530,667,1197,941
0132-000,2014,10,12,11,585,703,1288,1197
0132-000,2014,10,12,12,618,713,1331,1288
0132-000,2014,10,12,13,683,664,1347,1331
0132-000,2014,10,12,14,798,724,1522,1347
0132-000,2014,10,12,15,950,768,1718,1522
0132-000,2014,10,12,16,1225,734,1959,1718
0132-000,2014,10,12,17,1400,752,2152,1959
0132-000,2014,10,12,18,1605,779,2384,2152
0132-000,2014,10,12,19,1519,660,2179,2384
0132-000,2014,10,12,20,1150,508,1658,2179
0132-000,2014,10,12,21,1047,504,1551,1658
0132-000,2014,10,12,22,871,453,1324,1551
0132-000,2014,10,12,23,499,314,813,1324
0132-000,2014,10,12,24,227,203,430,813
0132-000,2014,10,13,1,148,145,293,430
0132-000,2014,10,13,2,91,112,203,293
0132-000,2014,10,13,3,65,75,140,203
0132-000,2014,10,13,4,59,70,129,140
0132-000,2014,10,13,5,93,101,194,129
0132-000,2014,10,13,6,176,206,382,194
0132-000,2014,10,13,7,479,549,1028,382
0132-000,2014,10,13,8,711,1589,2300,1028
0132-000,2014,10,13,9,768,1319,2087,2300
0132-000,2014,10,13,10,800,991,1791,2087
0132-000,2014,10,13,11,820,945,1765,1791
0132-000,2014,10,13,12,821,887,1708,1765
0132-000,2014,10,13,13,794,856,1650,1708
0132-000,2014,10,13,14,854,891,1745,1650
0132-000,2014,10,13,15,944,928,1872,1745
0132-000,2014,10,13,16,945,887,1832,1872
0132-000,2014,10,13,17,942,859,1801,1832
0132-000,2014,10,13,18,1174,925,2099,1801
0132-000,2014,10,13,19,1225,862,2087,2099
0132-000,2014,10,13,20,849,657,1506,2087
0132-000,2014,10,13,21,803,559,1362,1506
0132-000,2014,10,13,22,646,460,1106,1362
0132-000,2014,10,13,23,360,303,663,1106
0132-000,2014,10,13,24,234,189,423,663
0132-000,2014,10,14,1,148,133,281,423
0132-000,2014,10,14,2,104,102,206,281
0132-000,2014,10,14,3,69,73,142,206
0132-000,2014,10,14,4,80,86,166,142
0132-000,2014,10,14,5,75,99,174,166
0132-000,2014,10,14,6,205,185,390,174
0132-000,2014,10,14,7,445,461,906,390
0132-000,2014,10,14,8,722,1781,2503,906
0132-000,2014,10,14,9,883,1299,2182,2503
0132-000,2014,10,14,10,783,885,1668,2182
0132-000,2014,10,14,11,825,966,1791,1668
0132-000,2014,10,14,12,807,925,1732,1791
0132-000,2014,10,14,13,750,805,1555,1732
0132-000,2014,10,14,14,907,873,1780,1555
0132-000,2014,10,14,15,921,872,1793,1780
0132-000,2014,10,14,16,879,893,1772,1793
0132-000,2014,10,14,17,992,855,1847,1772
0132-000,2014,10,14,18,1236,952,2188,1847
0132-000,2014,10,14,19,1258,853,2111,2188
0132-000,2014,10,14,20,888,656,1544,2111
0132-000,2014,10,14,21,717,475,1192,1544
0132-000,2014,10,14,22,554,411,965,1192
0132-000,2014,10,14,23,347,273,620,965
0132-000,2014,10,14,24,211,183,394,620
0132-000,2014,10,15,1,148,164,312,394
0132-000,2014,10,15,2,109,115,224,312
0132-000,2014,10,15,3,62,84,146,224
0132-000,2014,10,15,4,77,70,147,146
0132-000,2014,10,15,5,87,102,189,147
0132-000,2014,10,15,6,190,166,356,189
0132-000,2014,10,15,7,430,464,894,356
0132-000,2014,10,15,8,682,1694,2376,894
0132-000,2014,10,15,9,838,1346,2184,2376
0132-000,2014,10,15,10,800,872,1672,2184
0132-000,2014,10,15,11,761,879,1640,1672
0132-000,2014,10,15,12,815,903,1718,1640
0132-000,2014,10,15,13,723,772,1495,1718
0132-000,2014,10,15,14,834,893,1727,1495
0132-000,2014,10,15,15,896,876,1772,1727
0132-000,2014,10,15,16,996,835,1831,1772
0132-000,2014,10,15,17,959,873,1832,1831
0132-000,2014,10,15,18,1369,962,2331,1832
0132-000,2014,10,15,19,1316,831,2147,2331
0132-000,2014,10,15,20,880,664,1544,2147
0132-000,2014,10,15,21,703,488,1191,1544
0132-000,2014,10,15,22,577,418,995,1191
0132-000,2014,10,15,23,359,306,665,995
0132-000,2014,10,15,24,237,192,429,665
0132-000,2014,10,16,1,177,158,335,429
0132-000,2014,10,16,2,102,109,211,335
0132-000,2014,10,16,3,96,84,180,211
0132-000,2014,10,16,4,62,77,139,180
0132-000,2014,10,16,5,92,92,184,139
0132-000,2014,10,16,6,193,170,363,184
0132-000,2014,10,16,7,402,458,860,363
0132-000,2014,10,16,8,679,1675,2354,860
0132-000,2014,10,16,9,813,1341,2154,2354
0132-000,2014,10,16,10,820,949,1769,2154
0132-000,2014,10,16,11,804,948,1752,1769
0132-000,2014,10,16,12,841,922,1763,1752
0132-000,2014,10,16,13,708,808,1516,1763
0132-000,2014,10,16,14,824,853,1677,1516
0132-000,2014,10,16,15,913,850,1763,1677
0132-000,2014,10,16,16,967,809,1776,1763
0132-000,2014,10,16,17,960,834,1794,1776
0132-000,2014,10,16,18,1243,885,2128,1794
0132-000,2014,10,16,19,1360,801,2161,2128
0132-000,2014,10,16,20,874,670,1544,2161
0132-000,2014,10,16,21,764,502,1266,1544
0132-000,2014,10,16,22,629,436,1065,1266
0132-000,2014,10,16,23,328,290,618,1065
0132-000,2014,10,16,24,224,199,423,618
0132-000,2014,10,17,1,167,168,335,423
0132-000,2014,10,17,2,93,129,222,335
0132-000,2014,10,17,3,96,80,176,222
0132-000,2014,10,17,4,65,91,156,176
0132-000,2014,10,17,5,80,104,184,156
0132-000,2014,10,17,6,171,145,316,184
0132-000,2014,10,17,7,400,506,906,316
0132-000,2014,10,17,8,697,1660,2357,906
0132-000,2014,10,17,9,828,1291,2119,2357
0132-000,2014,10,17,10,778,909,1687,2119
0132-000,2014,10,17,11,783,898,1681,1687
0132-000,2014,10,17,12,843,879,1722,1681
0132-000,2014,10,17,13,759,785,1544,1722
0132-000,2014,10,17,14,879,804,1683,1544
0132-000,2014,10,17,15,942,960,1902,1683
0132-000,2014,10,17,16,1007,929,1936,1902
0132-000,2014,10,17,17,1033,909,1942,1936
0132-000,2014,10,17,18,1376,1009,2385,1942
0132-000,2014,10,17,19,1580,901,2481,2385
0132-000,2014,10,17,20,1055,774,1829,2481
0132-000,2014,10,17,21,837,576,1413,1829
0132-000,2014,10,17,22,624,501,1125,1413
0132-000,2014,10,17,23,394,364,758,1125
0132-000,2014,10,17,24,265,220,485,758
0132-000,2014,10,18,1,194,188,382,485
0132-000,2014,10,18,2,141,134,275,382
0132-000,2014,10,18,3,98,111,209,275
0132-000,2014,10,18,4,93,101,194,209
0132-000,2014,10,18,5,98,125,223,194
0132-000,2014,10,18,6,180,217,397,223
0132-000,2014,10,18,7,394,343,737,397
0132-000,2014,10,18,8,554,884,1438,737
0132-000,2014,10,18,9,722,1094,1816,1438
0132-000,2014,10,18,10,784,1254,2038,1816
0132-000,2014,10,18,11,805,1401,2206,2038
0132-000,2014,10,18,12,873,1552,2425,2206
0132-000,2014,10,18,13,868,1481,2349,2425
0132-000,2014,10,18,14,942,1100,2042,2349
0132-000,2014,10,18,15,960,1049,2009,2042
0132-000,2014,10,18,16,1015,1034,2049,2009
0132-000,2014,10,18,17,1355,954,2309,2049
0132-000,2014,10,18,18,1711,1050,2761,2309
0132-000,2014,10,18,19,1695,842,2537,2761
0132-000,2014,10,18,20,1455,632,2087,2537
0132-000,2014,10,18,21,904,527,1431,2087
0132-000,2014,10,18,22,720,425,1145,1431
0132-000,2014,10,18,23,372,315,687,1145
0132-000,2014,10,18,24,211,206,417,687
0132-000,2014,10,19,1,155,160,315,417
0132-000,2014,10,19,2,125,116,241,315
0132-000,2014,10,19,3,89,88,177,241
0132-000,2014,10,19,4,61,76,137,177
0132-000,2014,10,19,5,88,92,180,137
0132-000,2014,10,19,6,134,128,262,180
0132-000,2014,10,19,7,213,216,429,262
0132-000,2014,10,19,8,306,411,717,429
0132-000,2014,10,19,9,409,553,962,717
0132-000,2014,10,19,10,532,647,1179,962
0132-000,2014,10,19,11,603,746,1349,1179
0132-000,2014,10,19,12,634,736,1370,1349
0132-000,2014,10,19,13,713,767,1480,1370
0132-000,2014,10,19,14,802,809,1611,1480
0132-000,2014,10,19,15,917,818,1735,1611
0132-000,2014,10,19,16,1165,811,1976,1735
0132-000,2014,10,19,17,1209,820,2029,1976
0132-000,2014,10,19,18,1498,749,2247,2029
0132-000,2014,10,19,19,1528,658,2186,2247
0132-000,2014,10,19,20,1464,542,2006,2186
0132-000,2014,10,19,21,1132,484,1616,2006
0132-000,2014,10,19,22,808,366,1174,1616
0132-000,2014,10,19,23,471,264,735,1174
0132-000,2014,10,19,24,198,195,393,735
0132-000,2014,10,20,1,92,134,226,393
0132-000,2014,10,20,2,98,96,194,226
0132-000,2014,10,20,3,70,59,129,194
0132-000,2014,10,20,4,47,72,119,129
0132-000,2014,10,20,5,64,57,121,119
0132-000,2014,10,20,6,160,161,321,121
0132-000,2014,10,20,7,370,424,794,321
0132-000,2014,10,20,8,621,1693,2314,794
0132-000,2014,10,20,9,770,1392,2162,2314
0132-000,2014,10,20,10,662,844,1506,2162
0132-000,2014,10,20,11,709,797,1506,1506
0132-000,2014,10,20,12,718,818,1536,1506
0132-000,2014,10,20,13,723,703,1426,1536
0132-000,2014,10,20,14,726,833,1559,1426
0132-000,2014,10,20,15,841,801,1642,1559
0132-000,2014,10,20,16,865,815,1680,1642
0132-000,2014,10,20,17,858,810,1668,1680
0132-000,2014,10,20,18,1157,818,1975,1668
0132-000,2014,10,20,19,1262,760,2022,1975
0132-000,2014,10,20,20,791,545,1336,2022
0132-000,2014,10,20,21,713,446,1159,1336
0132-000,2014,10,20,22,526,393,919,1159
0132-000,2014,10,20,23,280,271,551,919
0132-000,2014,10,20,24,191,155,346,551
0132-000,2014,10,21,1,129,105,234,346
0132-000,2014,10,21,2,84,88,172,234
0132-000,2014,10,21,3,66,76,142,172
0132-000,2014,10,21,4,51,74,125,142
0132-000,2014,10,21,5,70,69,139,125
0132-000,2014,10,21,6,137,149,286,139
0132-000,2014,10,21,7,323,379,702,286
0132-000,2014,10,21,8,585,1575,2160,702
0132-000,2014,10,21,9,759,1306,2065,2160
0132-000,2014,10,21,10,686,829,1515,2065
0132-000,2014,10,21,11,715,837,1552,1515
0132-000,2014,10,21,12,720,851,1571,1552
0132-000,2014,10,21,13,716,747,1463,1571
0132-000,2014,10,21,14,820,723,1543,1463
0132-000,2014,10,21,15,784,771,1555,1543
0132-000,2014,10,21,16,837,719,1556,1555
0132-000,2014,10,21,17,791,758,1549,1556
0132-000,2014,10,21,18,1127,739,1866,1549
0132-000,2014,10,21,19,1171,722,1893,1866
0132-000,2014,10,21,20,795,572,1367,1893
0132-000,2014,10,21,21,670,425,1095,1367
0132-000,2014,10,21,22,525,438,963,1095
0132-000,2014,10,21,23,297,250,547,963
0132-000,2014,10,21,24,181,175,356,547
0132-000,2014,10,22,1,143,133,276,356
0132-000,2014,10,22,2,103,97,200,276
0132-000,2014,10,22,3,74,56,130,200
0132-000,2014,10,22,4,53,73,126,130
0132-000,2014,10,22,5,77,96,173,126
0132-000,2014,10,22,6,187,168,355,173
0132-000,2014,10,22,7,368,442,810,355
0132-000,2014,10,22,8,653,1489,2142,810
0132-000,2014,10,22,9,846,1383,2229,2142
0132-000,2014,10,22,10,765,763,1528,2229
0132-000,2014,10,22,11,877,888,1765,1528
0132-000,2014,10,22,12,821,918,1739,1765
0132-000,2014,10,22,13,769,854,1623,1739
0132-000,2014,10,22,14,834,803,1637,1623
0132-000,2014,10,22,15,879,887,1766,1637
0132-000,2014,10,22,16,924,838,1762,1766
0132-000,2014,10,22,17,986,873,1859,1762
0132-000,2014,10,22,18,1208,901,2109,1859
0132-000,2014,10,22,19,1334,810,2144,2109
0132-000,2014,10,22,20,883,708,1591,2144
0132-000,2014,10,22,21,658,492,1150,1591
0132-000,2014,10,22,22,582,402,984,1150
0132-000,2014,10,22,23,341,278,619,984
0132-000,2014,10,22,24,239,216,455,619
0132-000,2014,10,23,1,177,137,314,455
0132-000,2014,10,23,2,111,120,231,314
0132-000,2014,10,23,3,75,101,176,231
0132-000,2014,10,23,4,85,85,170,176
0132-000,2014,10,23,5,79,108,187,170
0132-000,2014,10,23,6,189,164,353,187
0132-000,2014,10,23,7,446,449,895,353
0132-000,2014,10,23,8,725,1726,2451,895
0132-000,2014,10,23,9,805,1303,2108,2451
0132-000,2014,10,23,10,791,928,1719,2108
0132-000,2014,10,23,11,741,909,1650,1719
0132-000,2014,10,23,12,814,980,1794,1650
0132-000,2014,10,23,13,748,1006,1754,1794
0132-000,2014,10,23,14,817,879,1696,1754
0132-000,2014,10,23,15,921,851,1772,1696
0132-000,2014,10,23,16,943,889,1832,1772
0132-000,2014,10,23,17,1039,841,1880,1832
0132-000,2014,10,23,18,1362,928,2290,1880
0132-000,2014,10,23,19,1280,856,2136,2290
0132-000,2014,10,23,20,839,636,1475,2136
0132-000,2014,10,23,21,706,521,1227,1475
0132-000,2014,10,23,22,557,445,1002,1227
0132-000,2014,10,23,23,358,338,696,1002
0132-000,2014,10,23,24,237,173,410,696
0132-000,2014,10,24,1,150,139,289,410
0132-000,2014,10,24,2,121,111,232,289
0132-000,2014,10,24,3,74,83,157,232
0132-000,2014,10,24,4,72,107,179,157
0132-000,2014,10,24,5,79,104,183,179
0132-000,2014,10,24,6,200,191,391,183
0132-000,2014,10,24,7,428,457,885,391
0132-000,2014,10,24,8,720,1662,2382,885
0132-000,2014,10,24,9,861,1290,2151,2382
0132-000,2014,10,24,10,826,966,1792,2151
0132-000,2014,10,24,11,825,982,1807,1792
0132-000,2014,10,24,12,866,920,1786,1807
0132-000,2014,10,24,13,803,870,1673,1786
0132-000,2014,10,24,14,871,894,1765,1673
0132-000,2014,10,24,15,1010,919,1929,1765
0132-000,2014,10,24,16,957,885,1842,1929
0132-000,2014,10,24,17,1083,931,2014,1842
0132-000,2014,10,24,18,1372,1061,2433,2014
0132-000,2014,10,24,19,1544,900,2444,2433
0132-000,2014,10,24,20,1115,760,1875,2444
0132-000,2014,10,24,21,816,575,1391,1875
0132-000,2014,10,24,22,572,480,1052,1391
0132-000,2014,10,24,23,409,338,747,1052
0132-000,2014,10,24,24,246,241,487,747
0132-000,2014,10,25,1,189,180,369,487
0132-000,2014,10,25,2,147,139,286,369
0132-000,2014,10,25,3,99,104,203,286
0132-000,2014,10,25,4,92,111,203,203
0132-000,2014,10,25,5,105,125,230,203
0132-000,2014,10,25,6,158,186,344,230
0132-000,2014,10,25,7,347,325,672,344
0132-000,2014,10,25,8,542,796,1338,672
0132-000,2014,10,25,9,739,1050,1789,1338
0132-000,2014,10,25,10,767,1099,1866,1789
0132-000,2014,10,25,11,770,1226,1996,1866
0132-000,2014,10,25,12,846,1185,2031,1996
0132-000,2014,10,25,13,930,1167,2097,2031
0132-000,2014,10,25,14,860,1457,2317,2097
0132-000,2014,10,25,15,901,1158,2059,2317
0132-000,2014,10,25,16,924,943,1867,2059
0132-000,2014,10,25,17,1053,904,1957,1867
0132-000,2014,10,25,18,1477,978,2455,1957
0132-000,2014,10,25,19,1374,818,2192,2455
0132-000,2014,10,25,20,1035,631,1666,2192
0132-000,2014,10,25,21,759,500,1259,1666
0132-000,2014,10,25,22,591,438,1029,1259
0132-000,2014,10,25,23,334,315,649,1029
0132-000,2014,10,25,24,228,214,442,649
0132-000,2014,10,26,1,164,206,370,442
0132-000,2014,10,26,2,136,141,277,370
0132-000,2014,10,26,3,93,91,184,277
0132-000,2014,10,26,4,81,86,167,184
0132-000,2014,10,26,5,64,79,143,167
0132-000,2014,10,26,6,118,138,256,143
0132-000,2014,10,26,7,230,215,445,256
0132-000,2014,10,26,8,335,425,760,445
0132-000,2014,10,26,9,410,507,917,760
0132-000,2014,10,26,10,462,625,1087,917
0132-000,2014,10,26,11,517,641,1158,1087
0132-000,2014,10,26,12,590,748,1338,1158
0132-000,2014,10,26,13,656,750,1406,1338
0132-000,2014,10,26,14,689,708,1397,1406
0132-000,2014,10,26,15,876,724,1600,1397
0132-000,2014,10,26,16,1077,752,1829,1600
0132-000,2014,10,26,17,1206,720,1926,1829
0132-000,2014,10,26,18,1362,723,2085,1926
0132-000,2014,10,26,19,1383,603,1986,2085
0132-000,2014,10,26,20,1199,521,1720,1986
0132-000,2014,10,26,21,970,450,1420,1720
0132-000,2014,10,26,22,706,384,1090,1420
0132-000,2014,10,26,23,422,288,710,1090
0132-000,2014,10,26,24,192,212,404,710
0132-000,2014,10,27,1,113,151,264,404
0132-000,2014,10,27,2,86,95,181,264
0132-000,2014,10,27,3,56,69,125,181
0132-000,2014,10,27,4,46,76,122,125
0132-000,2014,10,27,5,69,72,141,122
0132-000,2014,10,27,6,178,181,359,141
0132-000,2014,10,27,7,422,497,919,359
0132-000,2014,10,27,8,714,1714,2428,919
0132-000,2014,10,27,9,833,1564,2397,2428
0132-000,2014,10,27,10,790,898,1688,2397
0132-000,2014,10,27,11,784,991,1775,1688
0132-000,2014,10,27,12,814,939,1753,1775
0132-000,2014,10,27,13,708,842,1550,1753
0132-000,2014,10,27,14,750,905,1655,1550
0132-000,2014,10,27,15,913,880,1793,1655
0132-000,2014,10,27,16,934,880,1814,1793
0132-000,2014,10,27,17,987,935,1922,1814
0132-000,2014,10,27,18,1272,988,2260,1922
0132-000,2014,10,27,19,1357,902,2259,2260
0132-000,2014,10,27,20,933,652,1585,2259
0132-000,2014,10,27,21,760,519,1279,1585
0132-000,2014,10,27,22,621,478,1099,1279
0132-000,2014,10,27,23,343,323,666,1099
0132-000,2014,10,27,24,224,173,397,666
0132-000,2014,10,28,1,140,138,278,397
0132-000,2014,10,28,2,113,96,209,278
0132-000,2014,10,28,3,72,75,147,209
0132-000,2014,10,28,4,82,66,148,147
0132-000,2014,10,28,5,78,112,190,148
0132-000,2014,10,28,6,158,149,307,190
0132-000,2014,10,28,7,418,458,876,307
0132-000,2014,10,28,8,692,1614,2306,876
0132-000,2014,10,28,9,829,1482,2311,2306
0132-000,2014,10,28,10,809,898,1707,2311
0132-000,2014,10,28,11,799,909,1708,1707
0132-000,2014,10,28,12,780,864,1644,1708
0132-000,2014,10,28,13,738,820,1558,1644
0132-000,2014,10,28,14,833,827,1660,1558
0132-000,2014,10,28,15,909,913,1822,1660
0132-000,2014,10,28,16,936,846,1782,1822
0132-000,2014,10,28,17,968,863,1831,1782
0132-000,2014,10,28,18,1205,903,2108,1831
0132-000,2014,10,28,19,1313,825,2138,2108
0132-000,2014,10,28,20,922,646,1568,2138
0132-000,2014,10,28,21,757,524,1281,1568
0132-000,2014,10,28,22,601,455,1056,1281
0132-000,2014,10,28,23,346,272,618,1056
0132-000,2014,10,28,24,222,220,442,618
0132-000,2014,10,29,1,162,139,301,442
0132-000,2014,10,29,2,111,99,210,301
0132-000,2014,10,29,3,65,83,148,210
0132-000,2014,10,29,4,69,80,149,148
0132-000,2014,10,29,5,70,103,173,149
0132-000,2014,10,29,6,182,158,340,173
0132-000,2014,10,29,7,411,418,829,340
0132-000,2014,10,29,8,688,1599,2287,829
0132-000,2014,10,29,9,885,1491,2376,2287
0132-000,2014,10,29,10,805,906,1711,2376
0132-000,2014,10,29,11,783,889,1672,1711
0132-000,2014,10,29,12,765,876,1641,1672
0132-000,2014,10,29,13,796,773,1569,1641
0132-000,2014,10,29,14,792,835,1627,1569
0132-000,2014,10,29,15,849,811,1660,1627
0132-000,2014,10,29,16,917,850,1767,1660
0132-000,2014,10,29,17,988,928,1916,1767
0132-000,2014,10,29,18,1262,944,2206,1916
0132-000,2014,10,29,19,1381,828,2209,2206
0132-000,2014,10,29,20,942,668,1610,2209
0132-000,2014,10,29,21,694,466,1160,1610
0132-000,2014,10,29,22,584,399,983,1160
0132-000,2014,10,29,23,345,256,601,983
0132-000,2014,10,29,24,218,193,411,601
0132-000,2014,10,30,1,171,125,296,411
0132-000,2014,10,30,2,115,85,200,296
0132-000,2014,10,30,3,72,69,141,200
0132-000,2014,10,30,4,81,65,146,141
0132-000,2014,10,30,5,69,55,124,146
0132-000,2014,10,30,6,186,123,309,124
0132-000,2014,10,30,7,407,350,757,309
0132-000,2014,10,30,8,699,1622,2321,757
0132-000,2014,10,30,9,851,1455,2306,2321
0132-000,2014,10,30,10,779,946,1725,2306
0132-000,2014,10,30,11,793,960,1753,1725
0132-000,2014,10,30,12,827,1018,1845,1753
0132-000,2014,10,30,13,760,811,1571,1845
0132-000,2014,10,30,14,851,768,1619,1571
0132-000,2014,10,30,15,894,809,1703,1619
0132-000,2014,10,30,16,950,751,1701,1703
0132-000,2014,10,30,17,988,849,1837,1701
0132-000,2014,10,30,18,1297,894,2191,1837
0132-000,2014,10,30,19,1319,845,2164,2191
0132-000,2014,10,30,20,913,618,1531,2164
0132-000,2014,10,30,21,841,440,1281,1531
0132-000,2014,10,30,22,670,404,1074,1281
0132-000,2014,10,30,23,392,276,668,1074
0132-000,2014,10,30,24,259,190,449,668
0132-000,2014,10,31,1,199,139,338,449
0132-000,2014,10,31,2,108,89,197,338
0132-000,2014,10,31,3,102,80,182,197
0132-000,2014,10,31,4,65,53,118,182
0132-000,2014,10,31,5,90,67,157,118
0132-000,2014,10,31,6,145,112,257,157
0132-000,2014,10,31,7,333,344,677,257
0132-000,2014,10,31,8,634,1497,2131,677
0132-000,2014,10,31,9,795,1374,2169,2131
0132-000,2014,10,31,10,782,852,1634,2169
0132-000,2014,10,31,11,779,847,1626,1634
0132-000,2014,10,31,12,806,827,1633,1626
0132-000,2014,10,31,13,707,822,1529,1633
0132-000,2014,10,31,14,788,800,1588,1529
0132-000,2014,10,31,15,909,766,1675,1588
0132-000,2014,10,31,16,901,760,1661,1675
0132-000,2014,10,31,17,1104,841,1945,1661
0132-000,2014,10,31,18,1523,886,2409,1945
0132-000,2014,10,31,19,1681,789,2470,2409
0132-000,2014,10,31,20,1269,614,1883,2470
0132-000,2014,10,31,21,1027,465,1492,1883
0132-000,2014,10,31,22,582,384,966,1492
0132-000,2014,10,31,23,359,299,658,966
0132-000,2014,10,31,24,259,209,468,658
0132-000,2014,11,1,1,207,164,371,468
0132-000,2014,11,1,2,145,112,257,371
0132-000,2014,11,1,3,112,95,207,257
0132-000,2014,11,1,4,95,68,163,207
0132-000,2014,11,1,5,96,87,183,163
0132-000,2014,11,1,6,152,127,279,183
0132-000,2014,11,1,7,291,206,497,279
0132-000,2014,11,1,8,431,733,1164,497
0132-000,2014,11,1,9,625,981,1606,1164
0132-000,2014,11,1,10,673,1071,1744,1606
0132-000,2014,11,1,11,751,1168,1919,1744
0132-000,2014,11,1,12,849,1109,1958,1919
0132-000,2014,11,1,13,837,1052,1889,1958
0132-000,2014,11,1,14,843,1002,1845,1889
0132-000,2014,11,1,15,990,950,1940,1845
0132-000,2014,11,1,16,984,934,1918,1940
0132-000,2014,11,1,17,1039,881,1920,1918
0132-000,2014,11,1,18,1263,925,2188,1920
0132-000,2014,11,1,19,1309,756,2065,2188
0132-000,2014,11,1,20,933,577,1510,2065
0132-000,2014,11,1,21,992,412,1404,1510
0132-000,2014,11,1,22,924,337,1261,1404
0132-000,2014,11,1,23,411,287,698,1261
0132-000,2014,11,1,24,263,197,460,698
0132-000,2014,11,2,1,189,150,339,460
0132-000,2014,11,2,2,142,118,260,339
0132-000,2014,11,2,3,119,89,208,260
0132-000,2014,11,2,4,69,60,129,208
0132-000,2014,11,2,5,83,75,158,129
0132-000,2014,11,2,6,100,62,162,158
0132-000,2014,11,2,7,156,102,258,162
0132-000,2014,11,2,8,230,246,476,258
0132-000,2014,11,2,9,344,329,673,476
0132-000,2014,11,2,10,394,492,886,673
0132-000,2014,11,2,11,537,700,1237,886
0132-000,2014,11,2,12,551,621,1172,1237
0132-000,2014,11,2,13,664,660,1324,1172
0132-000,2014,11,2,14,774,694,1468,1324
0132-000,2014,11,2,15,1077,735,1812,1468
0132-000,2014,11,2,16,1153,713,1866,1812
0132-000,2014,11,2,17,1283,692,1975,1866
0132-000,2014,11,2,18,1390,637,2027,1975
0132-000,2014,11,2,19,1314,552,1866,2027
0132-000,2014,11,2,20,1135,521,1656,1866
0132-000,2014,11,2,21,770,387,1157,1656
0132-000,2014,11,2,22,563,296,859,1157
0132-000,2014,11,2,23,260,210,470,859
0132-000,2014,11,2,24,125,137,262,470
0132-000,2014,11,3,1,118,75,193,262
0132-000,2014,11,3,2,61,56,117,193
0132-000,2014,11,3,3,57,45,102,117
0132-000,2014,11,3,4,37,52,89,102
0132-000,2014,11,3,5,66,52,118,89
0132-000,2014,11,3,6,170,177,347,118
0132-000,2014,11,3,7,443,521,964,347
0132-000,2014,11,3,8,655,1767,2422,964
0132-000,2014,11,3,9,810,1561,2371,2422
0132-000,2014,11,3,10,769,896,1665,2371
0132-000,2014,11,3,11,766,846,1612,1665
0132-000,2014,11,3,12,762,861,1623,1612
0132-000,2014,11,3,13,752,792,1544,1623
0132-000,2014,11,3,14,807,910,1717,1544
0132-000,2014,11,3,15,940,971,1911,1717
0132-000,2014,11,3,16,939,861,1800,1911
0132-000,2014,11,3,17,962,885,1847,1800
0132-000,2014,11,3,18,1194,967,2161,1847
0132-000,2014,11,3,19,1296,840,2136,2161
0132-000,2014,11,3,20,894,623,1517,2136
0132-000,2014,11,3,21,784,446,1230,1517
0132-000,2014,11,3,22,607,373,980,1230
0132-000,2014,11,3,23,330,233,563,980
0132-000,2014,11,3,24,194,172,366,563
0132-000,2014,11,4,1,151,100,251,366
0132-000,2014,11,4,2,97,77,174,251
0132-000,2014,11,4,3,70,62,132,174
0132-000,2014,11,4,4,65,47,112,132
0132-000,2014,11,4,5,86,56,142,112
0132-000,2014,11,4,6,158,110,268,142
0132-000,2014,11,4,7,397,352,749,268
0132-000,2014,11,4,8,653,1672,2325,749
0132-000,2014,11,4,9,829,1532,2361,2325
0132-000,2014,11,4,10,784,900,1684,2361
0132-000,2014,11,4,11,755,898,1653,1684
0132-000,2014,11,4,12,815,879,1694,1653
0132-000,2014,11,4,13,742,873,1615,1694
0132-000,2014,11,4,14,846,848,1694,1615
0132-000,2014,11,4,15,897,787,1684,1694
0132-000,2014,11,4,16,929,802,1731,1684
0132-000,2014,11,4,17,946,908,1854,1731
0132-000,2014,11,4,18,1246,875,2121,1854
0132-000,2014,11,4,19,1259,794,2053,2121
0132-000,2014,11,4,20,879,648,1527,2053
0132-000,2014,11,4,21,762,441,1203,1527
0132-000,2014,11,4,22,548,325,873,1203
0132-000,2014,11,4,23,346,262,608,873
0132-000,2014,11,4,24,242,160,402,608
0132-000,2014,11,5,1,147,102,249,402
0132-000,2014,11,5,2,90,64,154,249
0132-000,2014,11,5,3,64,54,118,154
0132-000,2014,11,5,4,61,56,117,118
0132-000,2014,11,5,5,74,85,159,117
0132-000,2014,11,5,6,194,116,310,159
0132-000,2014,11,5,7,357,364,721,310
0132-000,2014,11,5,8,682,1747,2429,721
0132-000,2014,11,5,9,825,1503,2328,2429
0132-000,2014,11,5,10,762,911,1673,2328
0132-000,2014,11,5,11,786,908,1694,1673
0132-000,2014,11,5,12,763,877,1640,1694
0132-000,2014,11,5,13,771,762,1533,1640
0132-000,2014,11,5,14,761,860,1621,1533
0132-000,2014,11,5,15,917,844,1761,1621
0132-000,2014,11,5,16,962,863,1825,1761
0132-000,2014,11,5,17,976,983,1959,1825
0132-000,2014,11,5,18,1331,988,2319,1959
0132-000,2014,11,5,19,1358,846,2204,2319
0132-000,2014,11,5,20,867,627,1494,2204
0132-000,2014,11,5,21,732,439,1171,1494
0132-000,2014,11,5,22,560,396,956,1171
0132-000,2014,11,5,23,360,233,593,956
0132-000,2014,11,5,24,220,170,390,593
0132-000,2014,11,6,1,172,129,301,390
0132-000,2014,11,6,2,135,99,234,301
0132-000,2014,11,6,3,75,66,141,234
0132-000,2014,11,6,4,90,54,144,141
0132-000,2014,11,6,5,85,97,182,144
0132-000,2014,11,6,6,171,133,304,182
0132-000,2014,11,6,7,375,448,823,304
0132-000,2014,11,6,8,695,1694,2389,823
0132-000,2014,11,6,9,877,1640,2517,2389
0132-000,2014,11,6,10,794,927,1721,2517
0132-000,2014,11,6,11,812,933,1745,1721
0132-000,2014,11,6,12,817,858,1675,1745
0132-000,2014,11,6,13,697,777,1474,1675
0132-000,2014,11,6,14,822,844,1666,1474
0132-000,2014,11,6,15,864,925,1789,1666
0132-000,2014,11,6,16,956,802,1758,1789
0132-000,2014,11,6,17,1006,896,1902,1758
0132-000,2014,11,6,18,1235,915,2150,1902
0132-000,2014,11,6,19,1333,769,2102,2150
0132-000,2014,11,6,20,892,600,1492,2102
0132-000,2014,11,6,21,751,479,1230,1492
0132-000,2014,11,6,22,630,416,1046,1230
0132-000,2014,11,6,23,352,285,637,1046
0132-000,2014,11,6,24,228,189,417,637
0132-000,2014,11,7,1,166,108,274,417
0132-000,2014,11,7,2,126,74,200,274
0132-000,2014,11,7,3,72,60,132,200
0132-000,2014,11,7,4,79,60,139,132
0132-000,2014,11,7,5,83,81,164,139
0132-000,2014,11,7,6,178,152,330,164
0132-000,2014,11,7,7,356,362,718,330
0132-000,2014,11,7,8,657,1714,2371,718
0132-000,2014,11,7,9,822,1421,2243,2371
0132-000,2014,11,7,10,765,892,1657,2243
0132-000,2014,11,7,11,759,856,1615,1657
0132-000,2014,11,7,12,796,892,1688,1615
0132-000,2014,11,7,13,724,769,1493,1688
0132-000,2014,11,7,14,858,806,1664,1493
0132-000,2014,11,7,15,916,931,1847,1664
0132-000,2014,11,7,16,988,787,1775,1847
0132-000,2014,11,7,17,1004,944,1948,1775
0132-000,2014,11,7,18,1347,961,2308,1948
0132-000,2014,11,7,19,1519,848,2367,2308
0132-000,2014,11,7,20,1032,748,1780,2367
0132-000,2014,11,7,21,892,517,1409,1780
0132-000,2014,11,7,22,627,481,1108,1409
0132-000,2014,11,7,23,357,310,667,1108
0132-000,2014,11,7,24,255,210,465,667
0132-000,2014,11,8,1,180,148,328,465
0132-000,2014,11,8,2,130,131,261,328
0132-000,2014,11,8,3,96,83,179,261
0132-000,2014,11,8,4,104,85,189,179
0132-000,2014,11,8,5,106,85,191,189
0132-000,2014,11,8,6,196,166,362,191
0132-000,2014,11,8,7,365,318,683,362
0132-000,2014,11,8,8,517,844,1361,683
0132-000,2014,11,8,9,716,1174,1890,1361
0132-000,2014,11,8,10,711,1094,1805,1890
0132-000,2014,11,8,11,775,1180,1955,1805
0132-000,2014,11,8,12,911,1109,2020,1955
0132-000,2014,11,8,13,873,1132,2005,2020
0132-000,2014,11,8,14,866,1017,1883,2005
0132-000,2014,11,8,15,950,1004,1954,1883
0132-000,2014,11,8,16,950,885,1835,1954
0132-000,2014,11,8,17,1129,911,2040,1835
0132-000,2014,11,8,18,1424,961,2385,2040
0132-000,2014,11,8,19,1112,765,1877,2385
0132-000,2014,11,8,20,868,514,1382,1877
0132-000,2014,11,8,21,658,479,1137,1382
0132-000,2014,11,8,22,470,346,816,1137
0132-000,2014,11,8,23,300,266,566,816
0132-000,2014,11,8,24,206,191,397,566
0132-000,2014,11,9,1,153,141,294,397
0132-000,2014,11,9,2,118,114,232,294
0132-000,2014,11,9,3,94,62,156,232
0132-000,2014,11,9,4,79,64,143,156
0132-000,2014,11,9,5,74,70,144,143
0132-000,2014,11,9,6,120,93,213,144
0132-000,2014,11,9,7,222,170,392,213
0132-000,2014,11,9,8,261,348,609,392
0132-000,2014,11,9,9,381,494,875,609
0132-000,2014,11,9,10,471,521,992,875
0132-000,2014,11,9,11,480,581,1061,992
0132-000,2014,11,9,12,537,608,1145,1061
0132-000,2014,11,9,13,656,652,1308,1145
0132-000,2014,11,9,14,743,677,1420,1308
0132-000,2014,11,9,15,935,730,1665,1420
0132-000,2014,11,9,16,1102,696,1798,1665
0132-000,2014,11,9,17,1397,729,2126,1798
0132-000,2014,11,9,18,1755,737,2492,2126
0132-000,2014,11,9,19,1811,514,2325,2492
0132-000,2014,11,9,20,1345,371,1716,2325
0132-000,2014,11,9,21,1231,421,1652,1716
0132-000,2014,11,9,22,1129,352,1481,1652
0132-000,2014,11,9,23,634,252,886,1481
0132-000,2014,11,9,24,257,143,400,886
0132-000,2014,11,10,1,94,102,196,400
0132-000,2014,11,10,2,73,66,139,196
0132-000,2014,11,10,3,47,50,97,139
0132-000,2014,11,10,4,40,45,85,97
0132-000,2014,11,10,5,85,68,153,85
0132-000,2014,11,10,6,174,145,319,153
0132-000,2014,11,10,7,420,491,911,319
0132-000,2014,11,10,8,688,1871,2559,911
0132-000,2014,11,10,9,759,1513,2272,2559
0132-000,2014,11,10,10,794,896,1690,2272
0132-000,2014,11,10,11,737,961,1698,1690
0132-000,2014,11,10,12,801,819,1620,1698
0132-000,2014,11,10,13,796,827,1623,1620
0132-000,2014,11,10,14,831,885,1716,1623
0132-000,2014,11,10,15,889,906,1795,1716
0132-000,2014,11,10,16,944,860,1804,1795
0132-000,2014,11,10,17,951,908,1859,1804
0132-000,2014,11,10,18,1228,906,2134,1859
0132-000,2014,11,10,19,1329,827,2156,2134
0132-000,2014,11,10,20,855,625,1480,2156
0132-000,2014,11,10,21,826,467,1293,1480
0132-000,2014,11,10,22,614,371,985,1293
0132-000,2014,11,10,23,350,246,596,985
0132-000,2014,11,10,24,195,172,367,596
0132-000,2014,11,11,1,137,125,262,367
0132-000,2014,11,11,2,117,68,185,262
0132-000,2014,11,11,3,69,58,127,185
0132-000,2014,11,11,4,69,43,112,127
0132-000,2014,11,11,5,81,74,155,112
0132-000,2014,11,11,6,152,145,297,155
0132-000,2014,11,11,7,401,398,799,297
0132-000,2014,11,11,8,686,1782,2468,799
0132-000,2014,11,11,9,811,1563,2374,2468
0132-000,2014,11,11,10,817,958,1775,2374
0132-000,2014,11,11,11,808,835,1643,1775
0132-000,2014,11,11,12,848,871,1719,1643
0132-000,2014,11,11,13,704,844,1548,1719
0132-000,2014,11,11,14,842,894,1736,1548
0132-000,2014,11,11,15,917,911,1828,1736
0132-000,2014,11,11,16,960,838,1798,1828
0132-000,2014,11,11,17,1017,840,1857,1798
0132-000,2014,11,11,18,1178,869,2047,1857
0132-000,2014,11,11,19,1370,825,2195,2047
0132-000,2014,11,11,20,930,650,1580,2195
0132-000,2014,11,11,21,826,481,1307,1580
0132-000,2014,11,11,22,580,487,1067,1307
0132-000,2014,11,11,23,371,285,656,1067
0132-000,2014,11,11,24,216,179,395,656
0132-000,2014,11,12,1,163,147,310,395
0132-000,2014,11,12,2,98,74,172,310
0132-000,2014,11,12,3,63,72,135,172
0132-000,2014,11,12,4,59,62,121,135
0132-000,2014,11,12,5,76,75,151,121
0132-000,2014,11,12,6,148,108,256,151
0132-000,2014,11,12,7,376,387,763,256
0132-000,2014,11,12,8,668,1724,2392,763
0132-000,2014,11,12,9,836,1475,2311,2392
0132-000,2014,11,12,10,788,915,1703,2311
0132-000,2014,11,12,11,800,811,1611,1703
0132-000,2014,11,12,12,732,817,1549,1611
0132-000,2014,11,12,13,701,750,1451,1549
0132-000,2014,11,12,14,814,811,1625,1451
0132-000,2014,11,12,15,857,877,1734,1625
0132-000,2014,11,12,16,900,831,1731,1734
0132-000,2014,11,12,17,965,835,1800,1731
0132-000,2014,11,12,18,1266,865,2131,1800
0132-000,2014,11,12,19,1288,710,1998,2131
0132-000,2014,11,12,20,870,652,1522,1998
0132-000,2014,11,12,21,701,394,1095,1522
0132-000,2014,11,12,22,546,318,864,1095
0132-000,2014,11,12,23,308,225,533,864
0132-000,2014,11,12,24,221,133,354,533
0132-000,2014,11,13,1,139,133,272,354
0132-000,2014,11,13,2,89,89,178,272
0132-000,2014,11,13,3,82,68,150,178
0132-000,2014,11,13,4,74,50,124,150
0132-000,2014,11,13,5,84,54,138,124
0132-000,2014,11,13,6,155,120,275,138
0132-000,2014,11,13,7,390,427,817,275
0132-000,2014,11,13,8,644,1719,2363,817
0132-000,2014,11,13,9,824,1453,2277,2363
0132-000,2014,11,13,10,805,988,1793,2277
0132-000,2014,11,13,11,803,925,1728,1793
0132-000,2014,11,13,12,833,860,1693,1728
0132-000,2014,11,13,13,689,735,1424,1693
0132-000,2014,11,13,14,819,815,1634,1424
0132-000,2014,11,13,15,917,788,1705,1634
0132-000,2014,11,13,16,953,811,1764,1705
0132-000,2014,11,13,17,1024,819,1843,1764
0132-000,2014,11,13,18,1245,936,2181,1843
0132-000,2014,11,13,19,1349,767,2116,2181
0132-000,2014,11,13,20,895,627,1522,2116
0132-000,2014,11,13,21,756,400,1156,1522
0132-000,2014,11,13,22,542,364,906,1156
0132-000,2014,11,13,23,346,246,592,906
0132-000,2014,11,13,24,220,189,409,592
0132-000,2014,11,14,1,163,104,267,409
0132-000,2014,11,14,2,108,83,191,267
0132-000,2014,11,14,3,84,56,140,191
0132-000,2014,11,14,4,63,52,115,140
0132-000,2014,11,14,5,81,89,170,115
0132-000,2014,11,14,6,187,133,320,170
0132-000,2014,11,14,7,370,393,763,320
0132-000,2014,11,14,8,658,1684,2342,763
0132-000,2014,11,14,9,814,1451,2265,2342
0132-000,2014,11,14,10,839,921,1760,2265
0132-000,2014,11,14,11,824,931,1755,1760
0132-000,2014,11,14,12,840,996,1836,1755
0132-000,2014,11,14,13,808,840,1648,1836
0132-000,2014,11,14,14,868,835,1703,1648
0132-000,2014,11,14,15,944,915,1859,1703
0132-000,2014,11,14,16,1006,948,1954,1859
0132-000,2014,11,14,17,1098,1033,2131,1954
0132-000,2014,11,14,18,1415,948,2363,2131
0132-000,2014,11,14,19,1624,871,2495,2363
0132-000,2014,11,14,20,1162,777,1939,2495
0132-000,2014,11,14,21,837,529,1366,1939
0132-000,2014,11,14,22,636,431,1067,1366
0132-000,2014,11,14,23,433,352,785,1067
0132-000,2014,11,14,24,263,223,486,785
0132-000,2014,11,15,1,185,160,345,486
0132-000,2014,11,15,2,144,141,285,345
0132-000,2014,11,15,3,95,106,201,285
0132-000,2014,11,15,4,75,68,143,201
0132-000,2014,11,15,5,103,74,177,143
0132-000,2014,11,15,6,172,139,311,177
0132-000,2014,11,15,7,330,293,623,311
0132-000,2014,11,15,8,555,911,1466,623
0132-000,2014,11,15,9,706,1396,2102,1466
0132-000,2014,11,15,10,880,1073,1953,2102
0132-000,2014,11,15,11,763,1148,1911,1953
0132-000,2014,11,15,12,916,1396,2312,1911
0132-000,2014,11,15,13,915,1282,2197,2312
0132-000,2014,11,15,14,899,1182,2081,2197
0132-000,2014,11,15,15,1332,1075,2407,2081
0132-000,2014,11,15,16,1206,946,2152,2407
0132-000,2014,11,15,17,1332,967,2299,2152
0132-000,2014,11,15,18,1598,1046,2644,2299
0132-000,2014,11,15,19,1528,802,2330,2644
0132-000,2014,11,15,20,1382,625,2007,2330
0132-000,2014,11,15,21,907,462,1369,2007
0132-000,2014,11,15,22,720,444,1164,1369
0132-000,2014,11,15,23,334,270,604,1164
0132-000,2014,11,15,24,235,212,447,604
0132-000,2014,11,16,1,162,166,328,447
0132-000,2014,11,16,2,113,99,212,328
0132-000,2014,11,16,3,98,56,154,212
0132-000,2014,11,16,4,73,64,137,154
0132-000,2014,11,16,5,67,72,139,137
0132-000,2014,11,16,6,119,89,208,139
0132-000,2014,11,16,7,227,181,408,208
0132-000,2014,11,16,8,290,341,631,408
0132-000,2014,11,16,9,395,444,839,631
0132-000,2014,11,16,10,512,516,1028,839
0132-000,2014,11,16,11,550,664,1214,1028
0132-000,2014,11,16,12,561,642,1203,1214
0132-000,2014,11,16,13,740,706,1446,1203
0132-000,2014,11,16,14,823,744,1567,1446
0132-000,2014,11,16,15,1106,762,1868,1567
0132-000,2014,11,16,16,1344,791,2135,1868
0132-000,2014,11,16,17,1815,744,2559,2135
0132-000,2014,11,16,18,1759,788,2547,2559
0132-000,2014,11,16,19,1787,535,2322,2547
0132-000,2014,11,16,20,1715,521,2236,2322
0132-000,2014,11,16,21,1516,431,1947,2236
0132-000,2014,11,16,22,1504,375,1879,1947
0132-000,2014,11,16,23,573,248,821,1879
0132-000,2014,11,16,24,204,166,370,821
0132-000,2014,11,17,1,115,99,214,370
0132-000,2014,11,17,2,56,74,130,214
0132-000,2014,11,17,3,54,31,85,130
0132-000,2014,11,17,4,46,24,70,85
0132-000,2014,11,17,5,75,49,124,70
0132-000,2014,11,17,6,171,150,321,124
0132-000,2014,11,17,7,424,469,893,321
0132-000,2014,11,17,8,638,1780,2418,893
0132-000,2014,11,17,9,812,1582,2394,2418
0132-000,2014,11,17,10,763,888,1651,2394
0132-000,2014,11,17,11,754,840,1594,1651
0132-000,2014,11,17,12,782,865,1647,1594
0132-000,2014,11,17,13,736,790,1526,1647
0132-000,2014,11,17,14,864,879,1743,1526
0132-000,2014,11,17,15,921,933,1854,1743
0132-000,2014,11,17,16,949,875,1824,1854
0132-000,2014,11,17,17,945,898,1843,1824
0132-000,2014,11,17,18,1205,911,2116,1843
0132-000,2014,11,17,19,1299,835,2134,2116
0132-000,2014,11,17,20,886,639,1525,2134
0132-000,2014,11,17,21,760,471,1231,1525
0132-000,2014,11,17,22,573,381,954,1231
0132-000,2014,11,17,23,368,248,616,954
0132-000,2014,11,17,24,199,133,332,616
0132-000,2014,11,18,1,132,127,259,332
0132-000,2014,11,18,2,79,66,145,259
0132-000,2014,11,18,3,66,39,105,145
0132-000,2014,11,18,4,59,52,111,105
0132-000,2014,11,18,5,70,50,120,111
0132-000,2014,11,18,6,175,116,291,120
0132-000,2014,11,18,7,422,444,866,291
0132-000,2014,11,18,8,679,1834,2513,866
0132-000,2014,11,18,9,804,1703,2507,2513
0132-000,2014,11,18,10,814,946,1760,2507
0132-000,2014,11,18,11,805,873,1678,1760
0132-000,2014,11,18,12,858,861,1719,1678
0132-000,2014,11,18,13,781,779,1560,1719
0132-000,2014,11,18,14,825,815,1640,1560
0132-000,2014,11,18,15,884,929,1813,1640
0132-000,2014,11,18,16,937,883,1820,1813
0132-000,2014,11,18,17,965,846,1811,1820
0132-000,2014,11,18,18,1243,921,2164,1811
0132-000,2014,11,18,19,1377,815,2192,2164
0132-000,2014,11,18,20,900,567,1467,2192
0132-000,2014,11,18,21,746,419,1165,1467
0132-000,2014,11,18,22,549,406,955,1165
0132-000,2014,11,18,23,328,262,590,955
0132-000,2014,11,18,24,204,187,391,590
0132-000,2014,11,19,1,151,116,267,391
0132-000,2014,11,19,2,114,72,186,267
0132-000,2014,11,19,3,71,77,148,186
0132-000,2014,11,19,4,65,66,131,148
0132-000,2014,11,19,5,76,50,126,131
0132-000,2014,11,19,6,162,106,268,126
0132-000,2014,11,19,7,376,387,763,268
0132-000,2014,11,19,8,656,1767,2423,763
0132-000,2014,11,19,9,809,1476,2285,2423
0132-000,2014,11,19,10,778,931,1709,2285
0132-000,2014,11,19,11,784,923,1707,1709
0132-000,2014,11,19,12,831,829,1660,1707
0132-000,2014,11,19,13,765,698,1463,1660
0132-000,2014,11,19,14,842,908,1750,1463
0132-000,2014,11,19,15,936,971,1907,1750
0132-000,2014,11,19,16,950,869,1819,1907
0132-000,2014,11,19,17,976,798,1774,1819
0132-000,2014,11,19,18,1310,967,2277,1774
0132-000,2014,11,19,19,1370,796,2166,2277
0132-000,2014,11,19,20,830,615,1445,2166
0132-000,2014,11,19,21,741,444,1185,1445
0132-000,2014,11,19,22,585,404,989,1185
0132-000,2014,11,19,23,375,252,627,989
0132-000,2014,11,19,24,209,195,404,627
0132-000,2014,11,20,1,170,148,318,404
0132-000,2014,11,20,2,101,68,169,318
0132-000,2014,11,20,3,70,54,124,169
0132-000,2014,11,20,4,66,64,130,124
0132-000,2014,11,20,5,76,87,163,130
0132-000,2014,11,20,6,169,114,283,163
0132-000,2014,11,20,7,382,381,763,283
0132-000,2014,11,20,8,641,1763,2404,763
0132-000,2014,11,20,9,823,1459,2282,2404
0132-000,2014,11,20,10,792,902,1694,2282
0132-000,2014,11,20,11,771,890,1661,1694
0132-000,2014,11,20,12,762,867,1629,1661
0132-000,2014,11,20,13,748,775,1523,1629
0132-000,2014,11,20,14,815,842,1657,1523
0132-000,2014,11,20,15,889,881,1770,1657
0132-000,2014,11,20,16,926,825,1751,1770
0132-000,2014,11,20,17,1000,877,1877,1751
0132-000,2014,11,20,18,1282,894,2176,1877
0132-000,2014,11,20,19,1293,802,2095,2176
0132-000,2014,11,20,20,1003,662,1665,2095
0132-000,2014,11,20,21,727,500,1227,1665
0132-000,2014,11,20,22,572,385,957,1227
0132-000,2014,11,20,23,379,245,624,957
0132-000,2014,11,20,24,218,198,416,624
0132-000,2014,11,21,1,174,112,286,416
0132-000,2014,11,21,2,107,81,188,286
0132-000,2014,11,21,3,96,62,158,188
0132-000,2014,11,21,4,84,68,152,158
0132-000,2014,11,21,5,88,79,167,152
0132-000,2014,11,21,6,154,122,276,167
0132-000,2014,11,21,7,401,377,778,276
0132-000,2014,11,21,8,660,1768,2428,778
0132-000,2014,11,21,9,826,1475,2301,2428
0132-000,2014,11,21,10,823,863,1686,2301
0132-000,2014,11,21,11,804,867,1671,1686
0132-000,2014,11,21,12,822,890,1712,1671
0132-000,2014,11,21,13,780,900,1680,1712
0132-000,2014,11,21,14,890,819,1709,1680
0132-000,2014,11,21,15,903,838,1741,1709
0132-000,2014,11,21,16,999,869,1868,1741
0132-000,2014,11,21,17,987,952,1939,1868
0132-000,2014,11,21,18,1417,983,2400,1939
0132-000,2014,11,21,19,1549,888,2437,2400
0132-000,2014,11,21,20,1068,844,1912,2437
0132-000,2014,11,21,21,831,552,1383,1912
0132-000,2014,11,21,22,659,492,1151,1383
0132-000,2014,11,21,23,407,335,742,1151
0132-000,2014,11,21,24,257,227,484,742
0132-000,2014,11,22,1,189,197,386,484
0132-000,2014,11,22,2,127,122,249,386
0132-000,2014,11,22,3,121,81,202,249
0132-000,2014,11,22,4,82,66,148,202
0132-000,2014,11,22,5,101,81,182,148
0132-000,2014,11,22,6,171,114,285,182
0132-000,2014,11,22,7,343,306,649,285
0132-000,2014,11,22,8,471,810,1281,649
0132-000,2014,11,22,9,707,927,1634,1281
0132-000,2014,11,22,10,698,1059,1757,1634
0132-000,2014,11,22,11,807,1265,2072,1757
0132-000,2014,11,22,12,868,1352,2220,2072
0132-000,2014,11,22,13,950,1438,2388,2220
0132-000,2014,11,22,14,988,1538,2526,2388
0132-000,2014,11,22,15,1017,1576,2593,2526
0132-000,2014,11,22,16,946,1593,2539,2593
0132-000,2014,11,22,17,1279,1475,2754,2539
0132-000,2014,11,22,18,1572,1196,2768,2754
0132-000,2014,11,22,19,1689,1154,2843,2768
0132-000,2014,11,22,20,1470,721,2191,2843
0132-000,2014,11,22,21,950,441,1391,2191
0132-000,2014,11,22,22,720,362,1082,1391
0132-000,2014,11,22,23,382,281,663,1082
0132-000,2014,11,22,24,198,175,373,663
0132-000,2014,11,23,1,185,123,308,373
0132-000,2014,11,23,2,108,68,176,308
0132-000,2014,11,23,3,86,81,167,176
0132-000,2014,11,23,4,70,89,159,167
0132-000,2014,11,23,5,65,81,146,159
0132-000,2014,11,23,6,114,100,214,146
0132-000,2014,11,23,7,184,147,331,214
0132-000,2014,11,23,8,267,252,519,331
0132-000,2014,11,23,9,387,456,843,519
0132-000,2014,11,23,10,469,492,961,843
0132-000,2014,11,23,11,574,637,1211,961
0132-000,2014,11,23,12,671,642,1313,1211
0132-000,2014,11,23,13,950,652,1602,1313
0132-000,2014,11,23,14,1087,723,1810,1602
0132-000,2014,11,23,15,1389,721,2110,1810
0132-000,2014,11,23,16,1808,554,2362,2110
0132-000,2014,11,23,17,1927,621,2548,2362
0132-000,2014,11,23,18,1775,665,2440,2548
0132-000,2014,11,23,19,1793,560,2353,2440
0132-000,2014,11,23,20,1738,444,2182,2353
0132-000,2014,11,23,21,1777,396,2173,2182
0132-000,2014,11,23,22,1441,343,1784,2173
0132-000,2014,11,23,23,1167,223,1390,1784
0132-000,2014,11,23,24,497,187,684,1390
0132-000,2014,11,24,1,151,160,311,684
0132-000,2014,11,24,2,74,60,134,311
0132-000,2014,11,24,3,48,37,85,134
0132-000,2014,11,24,4,53,47,100,85
0132-000,2014,11,24,5,71,68,139,100
0132-000,2014,11,24,6,153,129,282,139
0132-000,2014,11,24,7,387,483,870,282
0132-000,2014,11,24,8,652,1830,2482,870
0132-000,2014,11,24,9,804,1496,2300,2482
0132-000,2014,11,24,10,784,996,1780,2300
0132-000,2014,11,24,11,842,885,1727,1780
0132-000,2014,11,24,12,758,923,1681,1727
0132-000,2014,11,24,13,782,804,1586,1681
0132-000,2014,11,24,14,792,885,1677,1586
0132-000,2014,11,24,15,871,888,1759,1677
0132-000,2014,11,24,16,938,783,1721,1759
0132-000,2014,11,24,17,929,879,1808,1721
0132-000,2014,11,24,18,1182,852,2034,1808
0132-000,2014,11,24,19,1193,719,1912,2034
0132-000,2014,11,24,20,814,581,1395,1912
0132-000,2014,11,24,21,706,435,1141,1395
0132-000,2014,11,24,22,525,354,879,1141
0132-000,2014,11,24,23,323,254,577,879
0132-000,2014,11,24,24,202,152,354,577
0132-000,2014,11,25,1,146,114,260,354
0132-000,2014,11,25,2,97,47,144,260
0132-000,2014,11,25,3,59,54,113,144
0132-000,2014,11,25,4,68,56,124,113
0132-000,2014,11,25,5,72,64,136,124
0132-000,2014,11,25,6,181,108,289,136
0132-000,2014,11,25,7,369,452,821,289
0132-000,2014,11,25,8,634,1739,2373,821
0132-000,2014,11,25,9,812,1492,2304,2373
0132-000,2014,11,25,10,760,936,1696,2304
0132-000,2014,11,25,11,830,910,1740,1696
0132-000,2014,11,25,12,815,823,1638,1740
0132-000,2014,11,25,13,732,735,1467,1638
0132-000,2014,11,25,14,867,879,1746,1467
0132-000,2014,11,25,15,903,959,1862,1746
0132-000,2014,11,25,16,968,806,1774,1862
0132-000,2014,11,25,17,945,867,1812,1774
0132-000,2014,11,25,18,1207,927,2134,1812
0132-000,2014,11,25,19,1197,810,2007,2134
0132-000,2014,11,25,20,904,592,1496,2007
0132-000,2014,11,25,21,737,421,1158,1496
0132-000,2014,11,25,22,549,341,890,1158
0132-000,2014,11,25,23,334,254,588,890
0132-000,2014,11,25,24,223,166,389,588
0132-000,2014,11,26,1,155,106,261,389
0132-000,2014,11,26,2,110,81,191,261
0132-000,2014,11,26,3,75,74,149,191
0132-000,2014,11,26,4,76,79,155,149
0132-000,2014,11,26,5,78,74,152,155
0132-000,2014,11,26,6,174,106,280,152
0132-000,2014,11,26,7,349,406,755,280
0132-000,2014,11,26,8,678,1755,2433,755
0132-000,2014,11,26,9,836,1526,2362,2433
0132-000,2014,11,26,10,756,952,1708,2362
0132-000,2014,11,26,11,785,917,1702,1708
0132-000,2014,11,26,12,791,865,1656,1702
0132-000,2014,11,26,13,768,829,1597,1656
0132-000,2014,11,26,14,873,881,1754,1597
0132-000,2014,11,26,15,884,892,1776,1754
0132-000,2014,11,26,16,939,798,1737,1776
0132-000,2014,11,26,17,949,825,1774,1737
0132-000,2014,11,26,18,1348,888,2236,1774
0132-000,2014,11,26,19,1382,815,2197,2236
0132-000,2014,11,26,20,834,592,1426,2197
0132-000,2014,11,26,21,700,429,1129,1426
0132-000,2014,11,26,22,571,371,942,1129
0132-000,2014,11,26,23,326,273,599,942
0132-000,2014,11,26,24,222,193,415,599
0132-000,2014,11,27,1,154,118,272,415
0132-000,2014,11,27,2,116,91,207,272
0132-000,2014,11,27,3,68,77,145,207
0132-000,2014,11,27,4,81,60,141,145
0132-000,2014,11,27,5,76,74,150,141
0132-000,2014,11,27,6,152,97,249,150
0132-000,2014,11,27,7,356,435,791,249
0132-000,2014,11,27,8,697,1725,2422,791
0132-000,2014,11,27,9,790,1557,2347,2422
0132-000,2014,11,27,10,781,950,1731,2347
0132-000,2014,11,27,11,830,885,1715,1731
0132-000,2014,11,27,12,758,833,1591,1715
0132-000,2014,11,27,13,695,821,1516,1591
0132-000,2014,11,27,14,826,831,1657,1516
0132-000,2014,11,27,15,895,867,1762,1657
0132-000,2014,11,27,16,905,842,1747,1762
0132-000,2014,11,27,17,919,925,1844,1747
0132-000,2014,11,27,18,1306,848,2154,1844
0132-000,2014,11,27,19,1279,781,2060,2154
0132-000,2014,11,27,20,916,656,1572,2060
0132-000,2014,11,27,21,732,467,1199,1572
0132-000,2014,11,27,22,629,379,1008,1199
0132-000,2014,11,27,23,385,298,683,1008
0132-000,2014,11,27,24,235,204,439,683
0132-000,2014,11,28,1,168,147,315,439
0132-000,2014,11,28,2,103,74,177,315
0132-000,2014,11,28,3,76,79,155,177
0132-000,2014,11,28,4,75,49,124,155
0132-000,2014,11,28,5,87,93,180,124
0132-000,2014,11,28,6,165,97,262,180
0132-000,2014,11,28,7,355,364,719,262
0132-000,2014,11,28,8,604,1633,2237,719
0132-000,2014,11,28,9,766,1430,2196,2237
0132-000,2014,11,28,10,784,908,1692,2196
0132-000,2014,11,28,11,739,894,1633,1692
0132-000,2014,11,28,12,764,790,1554,1633
0132-000,2014,11,28,13,771,792,1563,1554
0132-000,2014,11,28,14,896,765,1661,1563
0132-000,2014,11,28,15,899,860,1759,1661
0132-000,2014,11,28,16,931,860,1791,1759
0132-000,2014,11,28,17,810,863,1673,1791
0132-000,2014,11,28,18,1239,836,2075,1673
0132-000,2014,11,28,19,1555,792,2347,2075
0132-000,2014,11,28,20,1009,631,1640,2347
0132-000,2014,11,28,21,751,469,1220,1640
0132-000,2014,11,28,22,559,418,977,1220
0132-000,2014,11,28,23,409,341,750,977
0132-000,2014,11,28,24,259,223,482,750
0132-000,2014,11,29,1,196,156,352,482
0132-000,2014,11,29,2,151,139,290,352
0132-000,2014,11,29,3,106,83,189,290
0132-000,2014,11,29,4,90,70,160,189
0132-000,2014,11,29,5,95,58,153,160
0132-000,2014,11,29,6,173,131,304,153
0132-000,2014,11,29,7,281,252,533,304
0132-000,2014,11,29,8,452,785,1237,533
0132-000,2014,11,29,9,649,961,1610,1237
0132-000,2014,11,29,10,738,1065,1803,1610
0132-000,2014,11,29,11,869,1403,2272,1803
0132-000,2014,11,29,12,993,1553,2546,2272
0132-000,2014,11,29,13,911,1551,2462,2546
0132-000,2014,11,29,14,972,1560,2532,2462
0132-000,2014,11,29,15,957,1448,2405,2532
0132-000,2014,11,29,16,1148,1371,2519,2405
0132-000,2014,11,29,17,1235,1211,2446,2519
0132-000,2014,11,29,18,1470,1134,2604,2446
0132-000,2014,11,29,19,1332,869,2201,2604
0132-000,2014,11,29,20,1035,627,1662,2201
0132-000,2014,11,29,21,815,443,1258,1662
0132-000,2014,11,29,22,578,368,946,1258
0132-000,2014,11,29,23,373,252,625,946
0132-000,2014,11,29,24,226,183,409,625
0132-000,2014,11,30,1,174,145,319,409
0132-000,2014,11,30,2,111,84,195,319
0132-000,2014,11,30,3,92,69,161,195
0132-000,2014,11,30,4,72,77,149,161
0132-000,2014,11,30,5,66,77,143,149
0132-000,2014,11,30,6,117,95,212,143
0132-000,2014,11,30,7,206,164,370,212
0132-000,2014,11,30,8,279,297,576,370
0132-000,2014,11,30,9,391,450,841,576
0132-000,2014,11,30,10,491,504,995,841
0132-000,2014,11,30,11,562,651,1213,995
0132-000,2014,11,30,12,616,642,1258,1213
0132-000,2014,11,30,13,845,679,1524,1258
0132-000,2014,11,30,14,955,734,1689,1524
0132-000,2014,11,30,15,1248,742,1990,1689
0132-000,2014,11,30,16,1576,673,2249,1990
0132-000,2014,11,30,17,1871,683,2554,2249
0132-000,2014,11,30,18,1767,727,2494,2554
0132-000,2014,11,30,19,1790,548,2338,2494
0132-000,2014,11,30,20,1727,483,2210,2338
0132-000,2014,11,30,21,1647,414,2061,2210
0132-000,2014,11,30,22,1473,359,1832,2061
0132-000,2014,11,30,23,870,236,1106,1832
0132-000,2014,11,30,24,351,177,528,1106
0132-000,2014,12,1,1,124,99,223,528
0132-000,2014,12,1,2,62,77,139,223
0132-000,2014,12,1,3,49,40,89,139
0132-000,2014,12,1,4,52,52,104,89
0132-000,2014,12,1,5,81,67,148,104
0132-000,2014,12,1,6,180,140,320,148
0132-000,2014,12,1,7,394,487,881,320
0132-000,2014,12,1,8,655,1808,2463,881
0132-000,2014,12,1,9,743,1582,2325,2463
0132-000,2014,12,1,10,689,991,1680,2325
0132-000,2014,12,1,11,721,749,1470,1680
0132-000,2014,12,1,12,671,798,1469,1470
0132-000,2014,12,1,13,619,694,1313,1469
0132-000,2014,12,1,14,713,692,1405,1313
0132-000,2014,12,1,15,734,658,1392,1405
0132-000,2014,12,1,16,867,796,1663,1392
0132-000,2014,12,1,17,844,816,1660,1663
0132-000,2014,12,1,18,1016,741,1757,1660
0132-000,2014,12,1,19,1122,692,1814,1757
0132-000,2014,12,1,20,804,512,1316,1814
0132-000,2014,12,1,21,657,392,1049,1316
0132-000,2014,12,1,22,469,319,788,1049
0132-000,2014,12,1,23,275,201,476,788
0132-000,2014,12,1,24,185,146,331,476
0132-000,2014,12,2,1,124,107,231,331
0132-000,2014,12,2,2,77,71,148,231
0132-000,2014,12,2,3,66,54,120,148
0132-000,2014,12,2,4,54,71,125,120
0132-000,2014,12,2,5,66,56,122,125
0132-000,2014,12,2,6,143,79,222,122
0132-000,2014,12,2,7,289,341,630,222
0132-000,2014,12,2,8,573,1636,2209,630
0132-000,2014,12,2,9,743,1363,2106,2209
0132-000,2014,12,2,10,696,920,1616,2106
0132-000,2014,12,2,11,732,826,1558,1616
0132-000,2014,12,2,12,763,861,1624,1558
0132-000,2014,12,2,13,674,755,1429,1624
0132-000,2014,12,2,14,821,794,1615,1429
0132-000,2014,12,2,15,894,845,1739,1615
0132-000,2014,12,2,16,890,784,1674,1739
0132-000,2014,12,2,17,921,831,1752,1674
0132-000,2014,12,2,18,1184,867,2051,1752
0132-000,2014,12,2,19,1202,741,1943,2051
0132-000,2014,12,2,20,806,544,1350,1943
0132-000,2014,12,2,21,747,440,1187,1350
0132-000,2014,12,2,22,432,343,775,1187
0132-000,2014,12,2,23,271,184,455,775
0132-000,2014,12,2,24,234,115,349,455
0132-000,2014,12,3,1,128,71,199,349
0132-000,2014,12,3,2,82,54,136,199
0132-000,2014,12,3,3,55,46,101,136
0132-000,2014,12,3,4,55,62,117,101
0132-000,2014,12,3,5,55,48,103,117
0132-000,2014,12,3,6,86,54,140,103
0132-000,2014,12,3,7,187,207,394,140
0132-000,2014,12,3,8,386,1026,1412,394
0132-000,2014,12,3,9,560,1112,1672,1412
0132-000,2014,12,3,10,581,898,1479,1672
0132-000,2014,12,3,11,578,757,1335,1479
0132-000,2014,12,3,12,642,729,1371,1335
0132-000,2014,12,3,13,620,666,1286,1371
0132-000,2014,12,3,14,702,729,1431,1286
0132-000,2014,12,3,15,778,780,1558,1431
0132-000,2014,12,3,16,781,648,1429,1558
0132-000,2014,12,3,17,782,640,1422,1429
0132-000,2014,12,3,18,1066,682,1748,1422
0132-000,2014,12,3,19,1091,674,1765,1748
0132-000,2014,12,3,20,663,459,1122,1765
0132-000,2014,12,3,21,531,327,858,1122
0132-000,2014,12,3,22,393,255,648,858
0132-000,2014,12,3,23,249,148,397,648
0132-000,2014,12,3,24,159,99,258,397
0132-000,2014,12,4,1,127,85,212,258
0132-000,2014,12,4,2,81,28,109,212
0132-000,2014,12,4,3,55,34,89,109
0132-000,2014,12,4,4,58,12,70,89
0132-000,2014,12,4,5,62,32,94,70
0132-000,2014,12,4,6,105,50,155,94
0132-000,2014,12,4,7,256,255,511,155
0132-000,2014,12,4,8,473,1266,1739,511
0132-000,2014,12,4,9,642,1265,1907,1739
0132-000,2014,12,4,10,562,745,1307,1907
0132-000,2014,12,4,11,680,757,1437,1307
0132-000,2014,12,4,12,732,701,1433,1437
0132-000,2014,12,4,13,649,678,1327,1433
0132-000,2014,12,4,14,751,698,1449,1327
0132-000,2014,12,4,15,785,723,1508,1449
0132-000,2014,12,4,16,862,772,1634,1508
0132-000,2014,12,4,17,924,733,1657,1634
0132-000,2014,12,4,18,1093,800,1893,1657
0132-000,2014,12,4,19,1190,692,1882,1893
0132-000,2014,12,4,20,778,495,1273,1882
0132-000,2014,12,4,21,638,400,1038,1273
0132-000,2014,12,4,22,473,308,781,1038
0132-000,2014,12,4,23,276,184,460,781
0132-000,2014,12,4,24,174,121,295,460
0132-000,2014,12,5,1,125,117,242,295
0132-000,2014,12,5,2,92,58,150,242
0132-000,2014,12,5,3,61,54,115,150
0132-000,2014,12,5,4,56,62,118,115
0132-000,2014,12,5,5,69,69,138,118
0132-000,2014,12,5,6,120,79,199,138
0132-000,2014,12,5,7,291,308,599,199
0132-000,2014,12,5,8,558,1699,2257,599
0132-000,2014,12,5,9,729,1267,1996,2257
0132-000,2014,12,5,10,662,806,1468,1996
0132-000,2014,12,5,11,762,926,1688,1468
0132-000,2014,12,5,12,818,865,1683,1688
0132-000,2014,12,5,13,785,768,1553,1683
0132-000,2014,12,5,14,818,786,1604,1553
0132-000,2014,12,5,15,929,889,1818,1604
0132-000,2014,12,5,16,945,881,1826,1818
0132-000,2014,12,5,17,953,938,1891,1826
0132-000,2014,12,5,18,1314,940,2254,1891
0132-000,2014,12,5,19,1521,808,2329,2254
0132-000,2014,12,5,20,892,690,1582,2329
0132-000,2014,12,5,21,718,416,1134,1582
0132-000,2014,12,5,22,524,422,946,1134
0132-000,2014,12,5,23,345,280,625,946
0132-000,2014,12,5,24,241,207,448,625
0132-000,2014,12,6,1,178,164,342,448
0132-000,2014,12,6,2,135,121,256,342
0132-000,2014,12,6,3,92,62,154,256
0132-000,2014,12,6,4,87,79,166,154
0132-000,2014,12,6,5,83,58,141,166
0132-000,2014,12,6,6,120,105,225,141
0132-000,2014,12,6,7,238,239,477,225
0132-000,2014,12,6,8,409,705,1114,477
0132-000,2014,12,6,9,589,806,1395,1114
0132-000,2014,12,6,10,671,812,1483,1395
0132-000,2014,12,6,11,731,944,1675,1483
0132-000,2014,12,6,12,846,1080,1926,1675
0132-000,2014,12,6,13,806,1171,1977,1926
0132-000,2014,12,6,14,957,1032,1989,1977
0132-000,2014,12,6,15,964,983,1947,1989
0132-000,2014,12,6,16,1038,1046,2084,1947
0132-000,2014,12,6,17,1106,1058,2164,2084
0132-000,2014,12,6,18,1348,920,2268,2164
0132-000,2014,12,6,19,1180,774,1954,2268
0132-000,2014,12,6,20,916,473,1389,1954
0132-000,2014,12,6,21,507,384,891,1389
0132-000,2014,12,6,22,427,353,780,891
0132-000,2014,12,6,23,296,237,533,780
0132-000,2014,12,6,24,173,166,339,533
0132-000,2014,12,7,1,186,154,340,339
0132-000,2014,12,7,2,113,113,226,340
0132-000,2014,12,7,3,93,83,176,226
0132-000,2014,12,7,4,71,75,146,176
0132-000,2014,12,7,5,79,71,150,146
0132-000,2014,12,7,6,85,64,149,150
0132-000,2014,12,7,7,179,105,284,149
0132-000,2014,12,7,8,194,237,431,284
0132-000,2014,12,7,9,286,369,655,431
0132-000,2014,12,7,10,403,528,931,655
0132-000,2014,12,7,11,487,577,1064,931
0132-000,2014,12,7,12,619,605,1224,1064
0132-000,2014,12,7,13,685,696,1381,1224
0132-000,2014,12,7,14,728,676,1404,1381
0132-000,2014,12,7,15,807,723,1530,1404
0132-000,2014,12,7,16,925,714,1639,1530
0132-000,2014,12,7,17,1169,709,1878,1639
0132-000,2014,12,7,18,1193,648,1841,1878
0132-000,2014,12,7,19,1110,501,1611,1841
0132-000,2014,12,7,20,848,447,1295,1611
0132-000,2014,12,7,21,654,388,1042,1295
0132-000,2014,12,7,22,532,306,838,1042
0132-000,2014,12,7,23,267,223,490,838
0132-000,2014,12,7,24,142,170,312,490
0132-000,2014,12,8,1,92,105,197,312
0132-000,2014,12,8,2,78,67,145,197
0132-000,2014,12,8,3,53,34,87,145
0132-000,2014,12,8,4,45,32,77,87
0132-000,2014,12,8,5,49,62,111,77
0132-000,2014,12,8,6,136,105,241,111
0132-000,2014,12,8,7,313,381,694,241
0132-000,2014,12,8,8,540,1720,2260,694
0132-000,2014,12,8,9,716,1373,2089,2260
0132-000,2014,12,8,10,652,831,1483,2089
0132-000,2014,12,8,11,715,847,1562,1483
0132-000,2014,12,8,12,754,837,1591,1562
0132-000,2014,12,8,13,726,780,1506,1591
0132-000,2014,12,8,14,796,851,1647,1506
0132-000,2014,12,8,15,897,786,1683,1647
0132-000,2014,12,8,16,884,891,1775,1683
0132-000,2014,12,8,17,816,828,1644,1775
0132-000,2014,12,8,18,1132,902,2034,1644
0132-000,2014,12,8,19,1175,705,1880,2034
0132-000,2014,12,8,20,795,577,1372,1880
0132-000,2014,12,8,21,684,367,1051,1372
0132-000,2014,12,8,22,544,365,909,1051
0132-000,2014,12,8,23,314,209,523,909
0132-000,2014,12,8,24,191,156,347,523
0132-000,2014,12,9,1,117,89,206,347
0132-000,2014,12,9,2,89,54,143,206
0132-000,2014,12,9,3,65,46,111,143
0132-000,2014,12,9,4,66,40,106,111
0132-000,2014,12,9,5,73,38,111,106
0132-000,2014,12,9,6,141,109,250,111
0132-000,2014,12,9,7,321,351,672,250
0132-000,2014,12,9,8,607,1750,2357,672
0132-000,2014,12,9,9,764,1379,2143,2357
0132-000,2014,12,9,10,699,885,1584,2143
0132-000,2014,12,9,11,754,853,1607,1584
0132-000,2014,12,9,12,772,894,1666,1607
0132-000,2014,12,9,13,718,755,1473,1666
0132-000,2014,12,9,14,813,889,1702,1473
0132-000,2014,12,9,15,861,857,1718,1702
0132-000,2014,12,9,16,879,784,1663,1718
0132-000,2014,12,9,17,934,812,1746,1663
0132-000,2014,12,9,18,1168,857,2025,1746
0132-000,2014,12,9,19,1279,770,2049,2025
0132-000,2014,12,9,20,814,589,1403,2049
0132-000,2014,12,9,21,728,402,1130,1403
0132-000,2014,12,9,22,542,369,911,1130
0132-000,2014,12,9,23,333,219,552,911
0132-000,2014,12,9,24,223,178,401,552
0132-000,2014,12,10,1,144,125,269,401
0132-000,2014,12,10,2,96,69,165,269
0132-000,2014,12,10,3,66,62,128,165
0132-000,2014,12,10,4,64,58,122,128
0132-000,2014,12,10,5,72,65,137,122
0132-000,2014,12,10,6,144,101,245,137
0132-000,2014,12,10,7,359,375,734,245
0132-000,2014,12,10,8,635,1747,2382,734
0132-000,2014,12,10,9,773,1517,2290,2382
0132-000,2014,12,10,10,741,924,1665,2290
0132-000,2014,12,10,11,776,867,1643,1665
0132-000,2014,12,10,12,788,863,1651,1643
0132-000,2014,12,10,13,763,910,1673,1651
0132-000,2014,12,10,14,813,867,1680,1673
0132-000,2014,12,10,15,947,851,1798,1680
0132-000,2014,12,10,16,962,828,1790,1798
0132-000,2014,12,10,17,987,967,1954,1790
0132-000,2014,12,10,18,1252,889,2141,1954
0132-000,2014,12,10,19,1344,763,2107,2141
0132-000,2014,12,10,20,804,599,1403,2107
0132-000,2014,12,10,21,688,481,1169,1403
0132-000,2014,12,10,22,516,371,887,1169
0132-000,2014,12,10,23,344,268,612,887
0132-000,2014,12,10,24,207,178,385,612
0132-000,2014,12,11,1,185,113,298,385
0132-000,2014,12,11,2,104,83,187,298
0132-000,2014,12,11,3,78,67,145,187
0132-000,2014,12,11,4,80,62,142,145
0132-000,2014,12,11,5,71,69,140,142
0132-000,2014,12,11,6,150,113,263,140
0132-000,2014,12,11,7,318,353,671,263
0132-000,2014,12,11,8,604,1610,2214,671
0132-000,2014,12,11,9,782,1483,2265,2214
0132-000,2014,12,11,10,700,977,1677,2265
0132-000,2014,12,11,11,764,959,1723,1677
0132-000,2014,12,11,12,748,894,1642,1723
0132-000,2014,12,11,13,691,826,1517,1642
0132-000,2014,12,11,14,876,656,1532,1517
0132-000,2014,12,11,15,826,812,1638,1532
0132-000,2014,12,11,16,924,841,1765,1638
0132-000,2014,12,11,17,921,810,1731,1765
0132-000,2014,12,11,18,1233,891,2124,1731
0132-000,2014,12,11,19,1273,778,2051,2124
0132-000,2014,12,11,20,852,570,1422,2051
0132-000,2014,12,11,21,757,444,1201,1422
0132-000,2014,12,11,22,596,396,992,1201
0132-000,2014,12,11,23,351,247,598,992
0132-000,2014,12,11,24,267,190,457,598
0132-000,2014,12,12,1,173,127,300,457
0132-000,2014,12,12,2,117,123,240,300
0132-000,2014,12,12,3,94,83,177,240
0132-000,2014,12,12,4,68,62,130,177
0132-000,2014,12,12,5,78,64,142,130
0132-000,2014,12,12,6,130,99,229,142
0132-000,2014,12,12,7,342,343,685,229
0132-000,2014,12,12,8,605,1688,2293,685
0132-000,2014,12,12,9,801,1412,2213,2293
0132-000,2014,12,12,10,717,859,1576,2213
0132-000,2014,12,12,11,825,946,1771,1576
0132-000,2014,12,12,12,826,956,1782,1771
0132-000,2014,12,12,13,792,824,1616,1782
0132-000,2014,12,12,14,864,849,1713,1616
0132-000,2014,12,12,15,877,987,1864,1713
0132-000,2014,12,12,16,989,940,1929,1864
0132-000,2014,12,12,17,970,908,1878,1929
0132-000,2014,12,12,18,1100,715,1815,1878
0132-000,2014,12,12,19,1246,648,1894,1815
0132-000,2014,12,12,20,1115,577,1692,1894
0132-000,2014,12,12,21,639,373,1012,1692
0132-000,2014,12,12,22,447,260,707,1012
0132-000,2014,12,12,23,315,186,501,707
0132-000,2014,12,12,24,184,121,305,501
0132-000,2014,12,13,1,130,95,225,305
0132-000,2014,12,13,2,103,77,180,225
0132-000,2014,12,13,3,70,50,120,180
0132-000,2014,12,13,4,59,40,99,120
0132-000,2014,12,13,5,57,42,99,99
0132-000,2014,12,13,6,67,36,103,99
0132-000,2014,12,13,7,151,99,250,103
0132-000,2014,12,13,8,303,386,689,250
0132-000,2014,12,13,9,428,574,1002,689
0132-000,2014,12,13,10,538,631,1169,1002
0132-000,2014,12,13,11,598,786,1384,1169
0132-000,2014,12,13,12,738,863,1601,1384
0132-000,2014,12,13,13,787,882,1669,1601
0132-000,2014,12,13,14,826,857,1683,1669
0132-000,2014,12,13,15,824,824,1648,1683
0132-000,2014,12,13,16,1056,847,1903,1648
0132-000,2014,12,13,17,1157,875,2032,1903
0132-000,2014,12,13,18,1285,865,2150,2032
0132-000,2014,12,13,19,1048,635,1683,2150
0132-000,2014,12,13,20,683,465,1148,1683
0132-000,2014,12,13,21,466,353,819,1148
0132-000,2014,12,13,22,377,365,742,819
0132-000,2014,12,13,23,273,253,526,742
0132-000,2014,12,13,24,205,162,367,526
0132-000,2014,12,14,1,151,158,309,367
0132-000,2014,12,14,2,112,130,242,309
0132-000,2014,12,14,3,109,81,190,242
0132-000,2014,12,14,4,88,54,142,190
0132-000,2014,12,14,5,90,56,146,142
0132-000,2014,12,14,6,82,75,157,146
0132-000,2014,12,14,7,151,105,256,157
0132-000,2014,12,14,8,190,213,403,256
0132-000,2014,12,14,9,271,323,594,403
0132-000,2014,12,14,10,396,390,786,594
0132-000,2014,12,14,11,538,530,1068,786
0132-000,2014,12,14,12,541,633,1174,1068
0132-000,2014,12,14,13,658,520,1178,1174
0132-000,2014,12,14,14,732,471,1203,1178
0132-000,2014,12,14,15,817,495,1312,1203
0132-000,2014,12,14,16,958,681,1639,1312
0132-000,2014,12,14,17,1013,526,1539,1639
0132-000,2014,12,14,18,1042,625,1667,1539
0132-000,2014,12,14,19,1092,483,1575,1667
0132-000,2014,12,14,20,753,422,1175,1575
0132-000,2014,12,14,21,484,284,768,1175
0132-000,2014,12,14,22,343,272,615,768
0132-000,2014,12,14,23,230,197,427,615
0132-000,2014,12,14,24,145,148,293,427
0132-000,2014,12,15,1,90,89,179,293
0132-000,2014,12,15,2,64,52,116,179
0132-000,2014,12,15,3,48,26,74,116
0132-000,2014,12,15,4,37,30,67,74
0132-000,2014,12,15,5,49,42,91,67
0132-000,2014,12,15,6,145,142,287,91
0132-000,2014,12,15,7,308,436,744,287
0132-000,2014,12,15,8,586,1766,2352,744
0132-000,2014,12,15,9,740,1473,2213,2352
0132-000,2014,12,15,10,680,818,1498,2213
0132-000,2014,12,15,11,789,887,1676,1498
0132-000,2014,12,15,12,777,835,1612,1676
0132-000,2014,12,15,13,696,867,1563,1612
0132-000,2014,12,15,14,597,796,1393,1563
0132-000,2014,12,15,15,840,893,1733,1393
0132-000,2014,12,15,16,850,914,1764,1733
0132-000,2014,12,15,17,906,826,1732,1764
0132-000,2014,12,15,18,1087,849,1936,1732
0132-000,2014,12,15,19,1117,741,1858,1936
0132-000,2014,12,15,20,765,467,1232,1858
0132-000,2014,12,15,21,657,390,1047,1232
0132-000,2014,12,15,22,479,329,808,1047
0132-000,2014,12,15,23,293,168,461,808
0132-000,2014,12,15,24,180,164,344,461
0132-000,2014,12,16,1,147,97,244,344
0132-000,2014,12,16,2,84,71,155,244
0132-000,2014,12,16,3,92,56,148,155
0132-000,2014,12,16,4,57,46,103,148
0132-000,2014,12,16,5,88,60,148,103
0132-000,2014,12,16,6,136,107,243,148
0132-000,2014,12,16,7,288,359,647,243
0132-000,2014,12,16,8,543,1646,2189,647
0132-000,2014,12,16,9,753,1341,2094,2189
0132-000,2014,12,16,10,624,796,1420,2094
0132-000,2014,12,16,11,726,849,1575,1420
0132-000,2014,12,16,12,729,893,1622,1575
0132-000,2014,12,16,13,723,963,1686,1622
0132-000,2014,12,16,14,817,950,1767,1686
0132-000,2014,12,16,15,799,865,1664,1767
0132-000,2014,12,16,16,818,766,1584,1664
0132-000,2014,12,16,17,853,755,1608,1584
0132-000,2014,12,16,18,1088,743,1831,1608
0132-000,2014,12,16,19,1197,741,1938,1831
0132-000,2014,12,16,20,763,520,1283,1938
0132-000,2014,12,16,21,616,351,967,1283
0132-000,2014,12,16,22,468,333,801,967
0132-000,2014,12,16,23,290,235,525,801
0132-000,2014,12,16,24,205,152,357,525
0132-000,2014,12,17,1,137,101,238,357
0132-000,2014,12,17,2,86,64,150,238
0132-000,2014,12,17,3,65,69,134,150
0132-000,2014,12,17,4,61,50,111,134
0132-000,2014,12,17,5,43,46,89,111
0132-000,2014,12,17,6,109,79,188,89
0132-000,2014,12,17,7,280,314,594,188
0132-000,2014,12,17,8,545,1647,2192,594
0132-000,2014,12,17,9,768,1347,2115,2192
0132-000,2014,12,17,10,709,806,1515,2115
0132-000,2014,12,17,11,728,818,1546,1515
0132-000,2014,12,17,12,742,818,1560,1546
0132-000,2014,12,17,13,737,743,1480,1560
0132-000,2014,12,17,14,742,776,1518,1480
0132-000,2014,12,17,15,862,828,1690,1518
0132-000,2014,12,17,16,858,792,1650,1690
0132-000,2014,12,17,17,845,871,1716,1650
0132-000,2014,12,17,18,1198,869,2067,1716
0132-000,2014,12,17,19,1218,757,1975,2067
0132-000,2014,12,17,20,734,548,1282,1975
0132-000,2014,12,17,21,648,381,1029,1282
0132-000,2014,12,17,22,485,323,808,1029
0132-000,2014,12,17,23,312,256,568,808
0132-000,2014,12,17,24,212,158,370,568
0132-000,2014,12,18,1,157,121,278,370
0132-000,2014,12,18,2,102,75,177,278
0132-000,2014,12,18,3,78,56,134,177
0132-000,2014,12,18,4,57,71,128,134
0132-000,2014,12,18,5,73,69,142,128
0132-000,2014,12,18,6,124,81,205,142
0132-000,2014,12,18,7,290,371,661,205
0132-000,2014,12,18,8,566,1560,2126,661
0132-000,2014,12,18,9,748,1355,2103,2126
0132-000,2014,12,18,10,694,808,1502,2103
0132-000,2014,12,18,11,702,847,1549,1502
0132-000,2014,12,18,12,716,786,1502,1549
0132-000,2014,12,18,13,643,723,1366,1502
0132-000,2014,12,18,14,777,745,1522,1366
0132-000,2014,12,18,15,879,792,1671,1522
0132-000,2014,12,18,16,893,696,1589,1671
0132-000,2014,12,18,17,896,843,1739,1589
0132-000,2014,12,18,18,1167,816,1983,1739
0132-000,2014,12,18,19,1226,725,1951,1983
0132-000,2014,12,18,20,754,629,1383,1951
0132-000,2014,12,18,21,705,392,1097,1383
0132-000,2014,12,18,22,539,379,918,1097
0132-000,2014,12,18,23,318,260,578,918
0132-000,2014,12,18,24,216,164,380,578
0132-000,2014,12,19,1,169,168,337,380
0132-000,2014,12,19,2,111,87,198,337
0132-000,2014,12,19,3,79,69,148,198
0132-000,2014,12,19,4,53,77,130,148
0132-000,2014,12,19,5,58,64,122,130
0132-000,2014,12,19,6,99,91,190,122
0132-000,2014,12,19,7,314,371,685,190
0132-000,2014,12,19,8,591,1571,2162,685
0132-000,2014,12,19,9,828,1353,2181,2162
0132-000,2014,12,19,10,763,891,1654,2181
0132-000,2014,12,19,11,749,885,1634,1654
0132-000,2014,12,19,12,851,956,1807,1634
0132-000,2014,12,19,13,726,808,1534,1807
0132-000,2014,12,19,14,865,875,1740,1534
0132-000,2014,12,19,15,859,936,1795,1740
0132-000,2014,12,19,16,933,891,1824,1795
0132-000,2014,12,19,17,1017,873,1890,1824
0132-000,2014,12,19,18,1379,930,2309,1890
0132-000,2014,12,19,19,1536,942,2478,2309
0132-000,2014,12,19,20,963,640,1603,2478
0132-000,2014,12,19,21,743,528,1271,1603
0132-000,2014,12,19,22,585,381,966,1271
0132-000,2014,12,19,23,385,290,675,966
0132-000,2014,12,19,24,299,217,516,675
0132-000,2014,12,20,1,201,192,393,516
0132-000,2014,12,20,2,150,140,290,393
0132-000,2014,12,20,3,128,107,235,290
0132-000,2014,12,20,4,85,73,158,235
0132-000,2014,12,20,5,106,69,175,158
0132-000,2014,12,20,6,126,107,233,175
0132-000,2014,12,20,7,234,186,420,233
0132-000,2014,12,20,8,372,564,936,420
0132-000,2014,12,20,9,565,737,1302,936
0132-000,2014,12,20,10,640,766,1406,1302
0132-000,2014,12,20,11,757,804,1561,1406
0132-000,2014,12,20,12,832,1034,1866,1561
0132-000,2014,12,20,13,933,1045,1978,1866
0132-000,2014,12,20,14,885,1058,1943,1978
0132-000,2014,12,20,15,956,952,1908,1943
0132-000,2014,12,20,16,1058,871,1929,1908
0132-000,2014,12,20,17,1237,952,2189,1929
0132-000,2014,12,20,18,1363,932,2295,2189
0132-000,2014,12,20,19,1343,763,2106,2295
0132-000,2014,12,20,20,763,534,1297,2106
0132-000,2014,12,20,21,534,485,1019,1297
0132-000,2014,12,20,22,425,331,756,1019
0132-000,2014,12,20,23,296,258,554,756
0132-000,2014,12,20,24,232,227,459,554
0132-000,2014,12,21,1,174,140,314,459
0132-000,2014,12,21,2,111,113,224,314
0132-000,2014,12,21,3,113,89,202,224
0132-000,2014,12,21,4,73,75,148,202
0132-000,2014,12,21,5,84,62,146,148
0132-000,2014,12,21,6,88,93,181,146
0132-000,2014,12,21,7,153,121,274,181
0132-000,2014,12,21,8,217,221,438,274
0132-000,2014,12,21,9,276,379,655,438
0132-000,2014,12,21,10,379,414,793,655
0132-000,2014,12,21,11,469,574,1043,793
0132-000,2014,12,21,12,541,640,1181,1043
0132-000,2014,12,21,13,654,668,1322,1181
0132-000,2014,12,21,14,723,723,1446,1322
0132-000,2014,12,21,15,833,737,1570,1446
0132-000,2014,12,21,16,1054,727,1781,1570
0132-000,2014,12,21,17,1333,719,2052,1781
0132-000,2014,12,21,18,1026,625,1651,2052
0132-000,2014,12,21,19,971,495,1466,1651
0132-000,2014,12,21,20,635,377,1012,1466
0132-000,2014,12,21,21,475,357,832,1012
0132-000,2014,12,21,22,362,249,611,832
0132-000,2014,12,21,23,220,195,415,611
0132-000,2014,12,21,24,148,119,267,415
0132-000,2014,12,22,1,81,71,152,267
0132-000,2014,12,22,2,69,56,125,152
0132-000,2014,12,22,3,48,32,80,125
0132-000,2014,12,22,4,40,52,92,80
0132-000,2014,12,22,5,53,60,113,92
0132-000,2014,12,22,6,117,81,198,113
0132-000,2014,12,22,7,329,434,763,198
0132-000,2014,12,22,8,499,1395,1894,763
0132-000,2014,12,22,9,650,1286,1936,1894
0132-000,2014,12,22,10,501,556,1057,1936
0132-000,2014,12,22,11,521,581,1102,1057
0132-000,2014,12,22,12,440,577,1017,1102
0132-000,2014,12,22,13,471,631,1102,1017
0132-000,2014,12,22,14,597,763,1360,1102
0132-000,2014,12,22,15,679,851,1530,1360
0132-000,2014,12,22,16,786,662,1448,1530
0132-000,2014,12,22,17,794,701,1495,1448
0132-000,2014,12,22,18,1055,611,1666,1495
0132-000,2014,12,22,19,1140,579,1719,1666
0132-000,2014,12,22,20,695,444,1139,1719
0132-000,2014,12,22,21,600,343,943,1139
0132-000,2014,12,22,22,442,284,726,943
0132-000,2014,12,22,23,274,197,471,726
0132-000,2014,12,22,24,176,123,299,471
0132-000,2014,12,23,1,118,113,231,299
0132-000,2014,12,23,2,100,67,167,231
0132-000,2014,12,23,3,73,44,117,167
0132-000,2014,12,23,4,61,50,111,117
0132-000,2014,12,23,5,70,52,122,111
0132-000,2014,12,23,6,110,65,175,122
0132-000,2014,12,23,7,269,373,642,175
0132-000,2014,12,23,8,532,1494,2026,642
0132-000,2014,12,23,9,729,1357,2086,2026
0132-000,2014,12,23,10,734,950,1684,2086
0132-000,2014,12,23,11,758,930,1688,1684
0132-000,2014,12,23,12,837,887,1724,1688
0132-000,2014,12,23,13,756,780,1536,1724
0132-000,2014,12,23,14,769,835,1604,1536
0132-000,2014,12,23,15,820,831,1651,1604
0132-000,2014,12,23,16,859,792,1651,1651
0132-000,2014,12,23,17,913,800,1713,1651
0132-000,2014,12,23,18,1185,765,1950,1713
0132-000,2014,12,23,19,1231,727,1958,1950
0132-000,2014,12,23,20,730,585,1315,1958
0132-000,2014,12,23,21,670,471,1141,1315
0132-000,2014,12,23,22,542,381,923,1141
0132-000,2014,12,23,23,401,312,713,923
0132-000,2014,12,23,24,237,217,454,713
0132-000,2014,12,24,1,183,170,353,454
0132-000,2014,12,24,2,130,81,211,353
0132-000,2014,12,24,3,78,73,151,211
0132-000,2014,12,24,4,72,79,151,151
0132-000,2014,12,24,5,97,71,168,151
0132-000,2014,12,24,6,130,75,205,168
0132-000,2014,12,24,7,326,365,691,205
0132-000,2014,12,24,8,562,1548,2110,691
0132-000,2014,12,24,9,785,1414,2199,2110
0132-000,2014,12,24,10,714,983,1697,2199
0132-000,2014,12,24,11,700,829,1529,1697
0132-000,2014,12,24,12,743,826,1569,1529
0132-000,2014,12,24,13,749,810,1559,1569
0132-000,2014,12,24,14,847,774,1621,1559
0132-000,2014,12,24,15,917,936,1853,1621
0132-000,2014,12,24,16,918,845,1763,1853
0132-000,2014,12,24,17,1003,871,1874,1763
0132-000,2014,12,24,18,1468,847,2315,1874
0132-000,2014,12,24,19,1646,956,2602,2315
0132-000,2014,12,24,20,996,680,1676,2602
0132-000,2014,12,24,21,699,514,1213,1676
0132-000,2014,12,24,22,498,436,934,1213
0132-000,2014,12,24,23,359,323,682,934
0132-000,2014,12,24,24,240,221,461,682
0132-000,2014,12,25,1,154,197,351,461
0132-000,2014,12,25,2,136,128,264,351
0132-000,2014,12,25,3,105,95,200,264
0132-000,2014,12,25,4,89,107,196,200
0132-000,2014,12,25,5,87,81,168,196
0132-000,2014,12,25,6,123,119,242,168
0132-000,2014,12,25,7,207,195,402,242
0132-000,2014,12,25,8,320,442,762,402
0132-000,2014,12,25,9,389,471,860,762
0132-000,2014,12,25,10,479,518,997,860
0132-000,2014,12,25,11,559,638,1197,997
0132-000,2014,12,25,12,529,615,1144,1197
0132-000,2014,12,25,13,610,666,1276,1144
0132-000,2014,12,25,14,652,765,1417,1276
0132-000,2014,12,25,15,744,749,1493,1417
0132-000,2014,12,25,16,697,717,1414,1493
0132-000,2014,12,25,17,839,694,1533,1414
0132-000,2014,12,25,18,885,692,1577,1533
0132-000,2014,12,25,19,777,564,1341,1577
0132-000,2014,12,25,20,573,444,1017,1341
0132-000,2014,12,25,21,464,363,827,1017
0132-000,2014,12,25,22,393,282,675,827
0132-000,2014,12,25,23,234,245,479,675
0132-000,2014,12,25,24,170,186,356,479
0132-000,2014,12,26,1,110,107,217,356
0132-000,2014,12,26,2,96,65,161,217
0132-000,2014,12,26,3,49,62,111,161
0132-000,2014,12,26,4,57,58,115,111
0132-000,2014,12,26,5,60,67,127,115
0132-000,2014,12,26,6,137,103,240,127
0132-000,2014,12,26,7,323,418,741,240
0132-000,2014,12,26,8,581,1571,2152,741
0132-000,2014,12,26,9,777,1328,2105,2152
0132-000,2014,12,26,10,659,835,1494,2105
0132-000,2014,12,26,11,763,873,1636,1494
0132-000,2014,12,26,12,794,885,1679,1636
0132-000,2014,12,26,13,764,883,1647,1679
0132-000,2014,12,26,14,850,837,1687,1647
0132-000,2014,12,26,15,872,851,1723,1687
0132-000,2014,12,26,16,934,818,1752,1723
0132-000,2014,12,26,17,963,979,1942,1752
0132-000,2014,12,26,18,1349,910,2259,1942
0132-000,2014,12,26,19,1382,839,2221,2259
0132-000,2014,12,26,20,800,568,1368,2221
0132-000,2014,12,26,21,654,534,1188,1368
0132-000,2014,12,26,22,555,428,983,1188
0132-000,2014,12,26,23,333,278,611,983
0132-000,2014,12,26,24,263,203,466,611
0132-000,2014,12,27,1,206,193,399,466
0132-000,2014,12,27,2,123,130,253,399
0132-000,2014,12,27,3,106,73,179,253
0132-000,2014,12,27,4,91,73,164,179
0132-000,2014,12,27,5,110,65,175,164
0132-000,2014,12,27,6,145,101,246,175
0132-000,2014,12,27,7,275,233,508,246
0132-000,2014,12,27,8,402,656,1058,508
0132-000,2014,12,27,9,551,739,1290,1058
0132-000,2014,12,27,10,637,788,1425,1290
0132-000,2014,12,27,11,723,700,1423,1425
0132-000,2014,12,27,12,768,916,1684,1423
0132-000,2014,12,27,13,812,855,1667,1684
0132-000,2014,12,27,14,893,940,1833,1667
0132-000,2014,12,27,15,842,829,1671,1833
0132-000,2014,12,27,16,913,865,1778,1671
0132-000,2014,12,27,17,1088,1002,2090,1778
0132-000,2014,12,27,18,1376,961,2337,2090
0132-000,2014,12,27,19,1161,723,1884,2337
0132-000,2014,12,27,20,746,475,1221,1884
0132-000,2014,12,27,21,523,426,949,1221
0132-000,2014,12,27,22,403,357,760,949
0132-000,2014,12,27,23,283,274,557,760
0132-000,2014,12,27,24,178,203,381,557
0132-000,2014,12,28,1,175,164,339,381
0132-000,2014,12,28,2,120,93,213,339
0132-000,2014,12,28,3,94,87,181,213
0132-000,2014,12,28,4,77,71,148,181
0132-000,2014,12,28,5,70,69,139,148
0132-000,2014,12,28,6,108,85,193,139
0132-000,2014,12,28,7,175,154,329,193
0132-000,2014,12,28,8,231,219,450,329
0132-000,2014,12,28,9,305,337,642,450
0132-000,2014,12,28,10,376,436,812,642
0132-000,2014,12,28,11,479,585,1064,812
0132-000,2014,12,28,12,540,514,1054,1064
0132-000,2014,12,28,13,636,522,1158,1054
0132-000,2014,12,28,14,674,609,1283,1158
0132-000,2014,12,28,15,750,597,1347,1283
0132-000,2014,12,28,16,853,694,1547,1347
0132-000,2014,12,28,17,1186,703,1889,1547
0132-000,2014,12,28,18,1215,629,1844,1889
0132-000,2014,12,28,19,1039,465,1504,1844
0132-000,2014,12,28,20,745,392,1137,1504
0132-000,2014,12,28,21,649,359,1008,1137
0132-000,2014,12,28,22,348,306,654,1008
0132-000,2014,12,28,23,224,201,425,654
0132-000,2014,12,28,24,162,154,316,425
0132-000,2014,12,29,1,106,119,225,316
0132-000,2014,12,29,2,72,67,139,225
0132-000,2014,12,29,3,64,52,116,139
0132-000,2014,12,29,4,45,56,101,116
0132-000,2014,12,29,5,64,52,116,101
0132-000,2014,12,29,6,163,105,268,116
0132-000,2014,12,29,7,350,485,835,268
0132-000,2014,12,29,8,624,1779,2403,835
0132-000,2014,12,29,9,767,1446,2213,2403
0132-000,2014,12,29,10,683,893,1576,2213
0132-000,2014,12,29,11,769,849,1618,1576
0132-000,2014,12,29,12,773,961,1734,1618
0132-000,2014,12,29,13,745,851,1596,1734
0132-000,2014,12,29,14,790,940,1730,1596
0132-000,2014,12,29,15,953,891,1844,1730
0132-000,2014,12,29,16,895,902,1797,1844
0132-000,2014,12,29,17,938,924,1862,1797
0132-000,2014,12,29,18,1199,883,2082,1862
0132-000,2014,12,29,19,1218,753,1971,2082
0132-000,2014,12,29,20,747,609,1356,1971
0132-000,2014,12,29,21,684,420,1104,1356
0132-000,2014,12,29,22,514,384,898,1104
0132-000,2014,12,29,23,338,270,608,898
0132-000,2014,12,29,24,265,174,439,608
0132-000,2014,12,30,1,183,138,321,439
0132-000,2014,12,30,2,117,99,216,321
0132-000,2014,12,30,3,86,85,171,216
0132-000,2014,12,30,4,71,71,142,171
0132-000,2014,12,30,5,84,69,153,142
0132-000,2014,12,30,6,136,95,231,153
0132-000,2014,12,30,7,316,375,691,231
0132-000,2014,12,30,8,581,1589,2170,691
0132-000,2014,12,30,9,782,1373,2155,2170
0132-000,2014,12,30,10,779,831,1610,2155
0132-000,2014,12,30,11,820,971,1791,1610
0132-000,2014,12,30,12,800,1184,1984,1791
0132-000,2014,12,30,13,837,1115,1952,1984
0132-000,2014,12,30,14,852,1022,1874,1952
0132-000,2014,12,30,15,912,908,1820,1874
0132-000,2014,12,30,16,940,918,1858,1820
0132-000,2014,12,30,17,882,772,1654,1858
0132-000,2014,12,30,18,1234,833,2067,1654
0132-000,2014,12,30,19,1227,826,2053,2067
0132-000,2014,12,30,20,785,579,1364,2053
0132-000,2014,12,30,21,669,451,1120,1364
0132-000,2014,12,30,22,546,408,954,1120
0132-000,2014,12,30,23,385,339,724,954
0132-000,2014,12,30,24,277,229,506,724
0132-000,2014,12,31,1,201,172,373,506
0132-000,2014,12,31,2,148,117,265,373
0132-000,2014,12,31,3,81,81,162,265
0132-000,2014,12,31,4,86,67,153,162
0132-000,2014,12,31,5,87,93,180,153
0132-000,2014,12,31,6,136,89,225,180
0132-000,2014,12,31,7,222,284,506,225
0132-000,2014,12,31,8,465,1278,1743,506
0132-000,2014,12,31,9,628,1263,1891,1743
0132-000,2014,12,31,10,611,701,1312,1891
0132-000,2014,12,31,11,647,778,1425,1312
0132-000,2014,12,31,12,699,731,1430,1425
0132-000,2014,12,31,13,732,658,1390,1430
0132-000,2014,12,31,14,806,845,1651,1390
0132-000,2014,12,31,15,875,770,1645,1651
0132-000,2014,12,31,16,1095,867,1962,1645
0132-000,2014,12,31,17,1107,806,1913,1962
0132-000,2014,12,31,18,1408,804,2212,1913
0132-000,2014,12,31,19,1365,810,2175,2212
0132-000,2014,12,31,20,821,642,1463,2175
0132-000,2014,12,31,21,628,522,1150,1463
0132-000,2014,12,31,22,512,371,883,1150
0132-000,2014,12,31,23,293,312,605,883
0132-000,2014,12,31,24,196,223,419,605
0132-000,2015,1,1,1,210,163,373,419
0132-000,2015,1,1,2,155,157,312,373
0132-000,2015,1,1,3,97,130,227,312
0132-000,2015,1,1,4,79,60,139,227
0132-000,2015,1,1,5,68,64,132,139
0132-000,2015,1,1,6,89,64,153,132
0132-000,2015,1,1,7,88,108,196,153
0132-000,2015,1,1,8,154,205,359,196
0132-000,2015,1,1,9,224,229,453,359
0132-000,2015,1,1,10,319,271,590,453
0132-000,2015,1,1,11,379,410,789,590
0132-000,2015,1,1,12,471,543,1014,789
0132-000,2015,1,1,13,527,600,1127,1014
0132-000,2015,1,1,14,569,583,1152,1127
0132-000,2015,1,1,15,633,535,1168,1152
0132-000,2015,1,1,16,688,545,1233,1168
0132-000,2015,1,1,17,756,523,1279,1233
0132-000,2015,1,1,18,701,517,1218,1279
0132-000,2015,1,1,19,608,436,1044,1218
0132-000,2015,1,1,20,455,378,833,1044
0132-000,2015,1,1,21,365,342,707,833
0132-000,2015,1,1,22,307,207,514,707
0132-000,2015,1,1,23,182,189,371,514
0132-000,2015,1,1,24,112,126,238,371
0132-000,2015,1,2,1,87,74,161,238
0132-000,2015,1,2,2,63,66,129,161
0132-000,2015,1,2,3,52,34,86,129
0132-000,2015,1,2,4,27,32,59,86
0132-000,2015,1,2,5,57,36,93,59
0132-000,2015,1,2,6,98,78,176,93
0132-000,2015,1,2,7,212,293,505,176
0132-000,2015,1,2,8,453,1195,1648,505
0132-000,2015,1,2,9,510,1004,1514,1648
0132-000,2015,1,2,10,560,658,1218,1514
0132-000,2015,1,2,11,668,783,1451,1218
0132-000,2015,1,2,12,711,793,1504,1451
0132-000,2015,1,2,13,649,787,1436,1504
0132-000,2015,1,2,14,763,785,1548,1436
0132-000,2015,1,2,15,811,791,1602,1548
0132-000,2015,1,2,16,887,829,1716,1602
0132-000,2015,1,2,17,906,805,1711,1716
0132-000,2015,1,2,18,1143,789,1932,1711
0132-000,2015,1,2,19,1210,771,1981,1932
0132-000,2015,1,2,20,685,527,1212,1981
0132-000,2015,1,2,21,562,392,954,1212
0132-000,2015,1,2,22,437,344,781,954
0132-000,2015,1,2,23,269,251,520,781
0132-000,2015,1,2,24,192,138,330,520
0132-000,2015,1,3,1,167,112,279,330
0132-000,2015,1,3,2,85,90,175,279
0132-000,2015,1,3,3,87,78,165,175
0132-000,2015,1,3,4,69,50,119,165
0132-000,2015,1,3,5,77,68,145,119
0132-000,2015,1,3,6,97,100,197,145
0132-000,2015,1,3,7,218,169,387,197
0132-000,2015,1,3,8,303,497,800,387
0132-000,2015,1,3,9,441,648,1089,800
0132-000,2015,1,3,10,533,672,1205,1089
0132-000,2015,1,3,11,609,726,1335,1205
0132-000,2015,1,3,12,687,799,1486,1335
0132-000,2015,1,3,13,843,803,1646,1486
0132-000,2015,1,3,14,775,785,1560,1646
0132-000,2015,1,3,15,834,866,1700,1560
0132-000,2015,1,3,16,941,829,1770,1700
0132-000,2015,1,3,17,1130,827,1957,1770
0132-000,2015,1,3,18,1244,799,2043,1957
0132-000,2015,1,3,19,1142,583,1725,2043
0132-000,2015,1,3,20,680,422,1102,1725
0132-000,2015,1,3,21,532,360,892,1102
0132-000,2015,1,3,22,422,348,770,892
0132-000,2015,1,3,23,253,237,490,770
0132-000,2015,1,3,24,192,173,365,490
0132-000,2015,1,4,1,137,116,253,365
0132-000,2015,1,4,2,91,66,157,253
0132-000,2015,1,4,3,83,84,167,157
0132-000,2015,1,4,4,56,52,108,167
0132-000,2015,1,4,5,79,60,139,108
0132-000,2015,1,4,6,94,50,144,139
0132-000,2015,1,4,7,155,88,243,144
0132-000,2015,1,4,8,202,217,419,243
0132-000,2015,1,4,9,259,316,575,419
0132-000,2015,1,4,10,342,390,732,575
0132-000,2015,1,4,11,452,465,917,732
0132-000,2015,1,4,12,476,547,1023,917
0132-000,2015,1,4,13,582,644,1226,1023
0132-000,2015,1,4,14,669,622,1291,1226
0132-000,2015,1,4,15,805,664,1469,1291
0132-000,2015,1,4,16,1032,666,1698,1469
0132-000,2015,1,4,17,1272,674,1946,1698
0132-000,2015,1,4,18,1274,607,1881,1946
0132-000,2015,1,4,19,1151,489,1640,1881
0132-000,2015,1,4,20,734,410,1144,1640
0132-000,2015,1,4,21,613,364,977,1144
0132-000,2015,1,4,22,353,328,681,977
0132-000,2015,1,4,23,230,205,435,681
0132-000,2015,1,4,24,140,130,270,435
0132-000,2015,1,5,1,82,80,162,270
0132-000,2015,1,5,2,60,76,136,162
0132-000,2015,1,5,3,43,38,81,136
0132-000,2015,1,5,4,41,36,77,81
0132-000,2015,1,5,5,77,54,131,77
0132-000,2015,1,5,6,152,118,270,131
0132-000,2015,1,5,7,340,481,821,270
0132-000,2015,1,5,8,583,1837,2420,821
0132-000,2015,1,5,9,716,1485,2201,2420
0132-000,2015,1,5,10,672,823,1495,2201
0132-000,2015,1,5,11,752,815,1567,1495
0132-000,2015,1,5,12,747,831,1578,1567
0132-000,2015,1,5,13,697,849,1546,1578
0132-000,2015,1,5,14,798,807,1605,1546
0132-000,2015,1,5,15,830,909,1739,1605
0132-000,2015,1,5,16,865,763,1628,1739
0132-000,2015,1,5,17,892,777,1669,1628
0132-000,2015,1,5,18,1138,883,2021,1669
0132-000,2015,1,5,19,1168,748,1916,2021
0132-000,2015,1,5,20,827,555,1382,1916
0132-000,2015,1,5,21,731,400,1131,1382
0132-000,2015,1,5,22,518,334,852,1131
0132-000,2015,1,5,23,316,213,529,852
0132-000,2015,1,5,24,204,157,361,529
0132-000,2015,1,6,1,152,130,282,361
0132-000,2015,1,6,2,94,102,196,282
0132-000,2015,1,6,3,67,68,135,196
0132-000,2015,1,6,4,64,54,118,135
0132-000,2015,1,6,5,78,54,132,118
0132-000,2015,1,6,6,129,98,227,132
0132-000,2015,1,6,7,328,404,732,227
0132-000,2015,1,6,8,569,1703,2272,732
0132-000,2015,1,6,9,706,1415,2121,2272
0132-000,2015,1,6,10,685,883,1568,2121
0132-000,2015,1,6,11,765,841,1606,1568
0132-000,2015,1,6,12,715,825,1540,1606
0132-000,2015,1,6,13,702,807,1509,1540
0132-000,2015,1,6,14,823,905,1728,1509
0132-000,2015,1,6,15,830,895,1725,1728
0132-000,2015,1,6,16,870,841,1711,1725
0132-000,2015,1,6,17,939,761,1700,1711
0132-000,2015,1,6,18,1143,847,1990,1700
0132-000,2015,1,6,19,1257,793,2050,1990
0132-000,2015,1,6,20,861,581,1442,2050
0132-000,2015,1,6,21,703,434,1137,1442
0132-000,2015,1,6,22,528,354,882,1137
0132-000,2015,1,6,23,307,197,504,882
0132-000,2015,1,6,24,223,171,394,504
0132-000,2015,1,7,1,143,140,283,394
0132-000,2015,1,7,2,105,62,167,283
0132-000,2015,1,7,3,67,64,131,167
0132-000,2015,1,7,4,59,58,117,131
0132-000,2015,1,7,5,74,70,144,117
0132-000,2015,1,7,6,123,74,197,144
0132-000,2015,1,7,7,296,426,722,197
0132-000,2015,1,7,8,567,1679,2246,722
0132-000,2015,1,7,9,741,1501,2242,2246
0132-000,2015,1,7,10,688,789,1477,2242
0132-000,2015,1,7,11,737,861,1598,1477
0132-000,2015,1,7,12,702,769,1471,1598
0132-000,2015,1,7,13,691,720,1411,1471
0132-000,2015,1,7,14,799,879,1678,1411
0132-000,2015,1,7,15,814,847,1661,1678
0132-000,2015,1,7,16,848,873,1721,1661
0132-000,2015,1,7,17,871,781,1652,1721
0132-000,2015,1,7,18,1197,821,2018,1652
0132-000,2015,1,7,19,1310,740,2050,2018
0132-000,2015,1,7,20,782,563,1345,2050
0132-000,2015,1,7,21,663,414,1077,1345
0132-000,2015,1,7,22,503,410,913,1077
0132-000,2015,1,7,23,343,249,592,913
0132-000,2015,1,7,24,194,148,342,592
0132-000,2015,1,8,1,151,108,259,342
0132-000,2015,1,8,2,120,58,178,259
0132-000,2015,1,8,3,73,78,151,178
0132-000,2015,1,8,4,66,78,144,151
0132-000,2015,1,8,5,68,58,126,144
0132-000,2015,1,8,6,118,100,218,126
0132-000,2015,1,8,7,314,412,726,218
0132-000,2015,1,8,8,563,1703,2266,726
0132-000,2015,1,8,9,742,1522,2264,2266
0132-000,2015,1,8,10,725,847,1572,2264
0132-000,2015,1,8,11,781,839,1620,1572
0132-000,2015,1,8,12,747,851,1598,1620
0132-000,2015,1,8,13,704,799,1503,1598
0132-000,2015,1,8,14,824,889,1713,1503
0132-000,2015,1,8,15,828,861,1689,1713
0132-000,2015,1,8,16,984,761,1745,1689
0132-000,2015,1,8,17,929,829,1758,1745
0132-000,2015,1,8,18,1151,847,1998,1758
0132-000,2015,1,8,19,1247,686,1933,1998
0132-000,2015,1,8,20,817,567,1384,1933
0132-000,2015,1,8,21,685,452,1137,1384
0132-000,2015,1,8,22,526,342,868,1137
0132-000,2015,1,8,23,324,301,625,868
0132-000,2015,1,8,24,208,183,391,625
0132-000,2015,1,9,1,168,132,300,391
0132-000,2015,1,9,2,98,88,186,300
0132-000,2015,1,9,3,68,64,132,186
0132-000,2015,1,9,4,62,72,134,132
0132-000,2015,1,9,5,75,68,143,134
0132-000,2015,1,9,6,117,122,239,143
0132-000,2015,1,9,7,331,410,741,239
0132-000,2015,1,9,8,597,1779,2376,741
0132-000,2015,1,9,9,715,1495,2210,2376
0132-000,2015,1,9,10,748,986,1734,2210
0132-000,2015,1,9,11,761,974,1735,1734
0132-000,2015,1,9,12,786,865,1651,1735
0132-000,2015,1,9,13,780,865,1645,1651
0132-000,2015,1,9,14,830,905,1735,1645
0132-000,2015,1,9,15,972,946,1918,1735
0132-000,2015,1,9,16,911,936,1847,1918
0132-000,2015,1,9,17,959,833,1792,1847
0132-000,2015,1,9,18,1310,905,2215,1792
0132-000,2015,1,9,19,1475,889,2364,2215
0132-000,2015,1,9,20,972,696,1668,2364
0132-000,2015,1,9,21,721,517,1238,1668
0132-000,2015,1,9,22,563,412,975,1238
0132-000,2015,1,9,23,382,312,694,975
0132-000,2015,1,9,24,230,209,439,694
0132-000,2015,1,10,1,173,148,321,439
0132-000,2015,1,10,2,129,82,211,321
0132-000,2015,1,10,3,113,128,241,211
0132-000,2015,1,10,4,109,74,183,241
0132-000,2015,1,10,5,104,84,188,183
0132-000,2015,1,10,6,145,130,275,188
0132-000,2015,1,10,7,275,273,548,275
0132-000,2015,1,10,8,388,710,1098,548
0132-000,2015,1,10,9,606,914,1520,1098
0132-000,2015,1,10,10,702,869,1571,1520
0132-000,2015,1,10,11,786,932,1718,1571
0132-000,2015,1,10,12,859,1284,2143,1718
0132-000,2015,1,10,13,955,1181,2136,2143
0132-000,2015,1,10,14,915,1000,1915,2136
0132-000,2015,1,10,15,871,911,1782,1915
0132-000,2015,1,10,16,882,954,1836,1782
0132-000,2015,1,10,17,1098,899,1997,1836
0132-000,2015,1,10,18,1352,976,2328,1997
0132-000,2015,1,10,19,1171,775,1946,2328
0132-000,2015,1,10,20,754,545,1299,1946
0132-000,2015,1,10,21,531,448,979,1299
0132-000,2015,1,10,22,432,372,804,979
0132-000,2015,1,10,23,326,283,609,804
0132-000,2015,1,10,24,196,185,381,609
0132-000,2015,1,11,1,162,161,323,381
0132-000,2015,1,11,2,124,112,236,323
0132-000,2015,1,11,3,74,90,164,236
0132-000,2015,1,11,4,68,48,116,164
0132-000,2015,1,11,5,82,52,134,116
0132-000,2015,1,11,6,73,78,151,134
0132-000,2015,1,11,7,161,126,287,151
0132-000,2015,1,11,8,189,227,416,287
0132-000,2015,1,11,9,322,350,672,416
0132-000,2015,1,11,10,399,521,920,672
0132-000,2015,1,11,11,492,599,1091,920
0132-000,2015,1,11,12,560,595,1155,1091
0132-000,2015,1,11,13,609,601,1210,1155
0132-000,2015,1,11,14,712,640,1352,1210
0132-000,2015,1,11,15,693,730,1423,1352
0132-000,2015,1,11,16,918,672,1590,1423
0132-000,2015,1,11,17,926,680,1606,1590
0132-000,2015,1,11,18,988,589,1577,1606
0132-000,2015,1,11,19,985,481,1466,1577
0132-000,2015,1,11,20,623,430,1053,1466
0132-000,2015,1,11,21,512,360,872,1053
0132-000,2015,1,11,22,370,342,712,872
0132-000,2015,1,11,23,245,225,470,712
0132-000,2015,1,11,24,163,161,324,470
0132-000,2015,1,12,1,94,104,198,324
0132-000,2015,1,12,2,75,58,133,198
0132-000,2015,1,12,3,53,50,103,133
0132-000,2015,1,12,4,61,54,115,103
0132-000,2015,1,12,5,68,36,104,115
0132-000,2015,1,12,6,150,118,268,104
0132-000,2015,1,12,7,363,497,860,268
0132-000,2015,1,12,8,650,1811,2461,860
0132-000,2015,1,12,9,783,1405,2188,2461
0132-000,2015,1,12,10,748,857,1605,2188
0132-000,2015,1,12,11,842,783,1625,1605
0132-000,2015,1,12,12,769,907,1676,1625
0132-000,2015,1,12,13,740,783,1523,1676
0132-000,2015,1,12,14,823,942,1765,1523
0132-000,2015,1,12,15,884,891,1775,1765
0132-000,2015,1,12,16,958,867,1825,1775
0132-000,2015,1,12,17,883,867,1750,1825
0132-000,2015,1,12,18,1075,859,1934,1750
0132-000,2015,1,12,19,1245,756,2001,1934
0132-000,2015,1,12,20,809,597,1406,2001
0132-000,2015,1,12,21,708,452,1160,1406
0132-000,2015,1,12,22,534,352,886,1160
0132-000,2015,1,12,23,278,193,471,886
0132-000,2015,1,12,24,173,130,303,471
0132-000,2015,1,13,1,151,110,261,303
0132-000,2015,1,13,2,97,64,161,261
0132-000,2015,1,13,3,67,64,131,161
0132-000,2015,1,13,4,79,66,145,131
0132-000,2015,1,13,5,69,58,127,145
0132-000,2015,1,13,6,155,100,255,127
0132-000,2015,1,13,7,369,398,767,255
0132-000,2015,1,13,8,581,1722,2303,767
0132-000,2015,1,13,9,733,1358,2091,2303
0132-000,2015,1,13,10,755,926,1681,2091
0132-000,2015,1,13,11,823,930,1753,1681
0132-000,2015,1,13,12,812,821,1633,1753
0132-000,2015,1,13,13,699,833,1532,1633
0132-000,2015,1,13,14,804,879,1683,1532
0132-000,2015,1,13,15,878,911,1789,1683
0132-000,2015,1,13,16,891,839,1730,1789
0132-000,2015,1,13,17,913,863,1776,1730
0132-000,2015,1,13,18,1154,889,2043,1776
0132-000,2015,1,13,19,1150,787,1937,2043
0132-000,2015,1,13,20,804,591,1395,1937
0132-000,2015,1,13,21,746,428,1174,1395
0132-000,2015,1,13,22,505,362,867,1174
0132-000,2015,1,13,23,336,227,563,867
0132-000,2015,1,13,24,204,171,375,563
0132-000,2015,1,14,1,139,102,241,375
0132-000,2015,1,14,2,94,78,172,241
0132-000,2015,1,14,3,65,60,125,172
0132-000,2015,1,14,4,68,66,134,125
0132-000,2015,1,14,5,85,72,157,134
0132-000,2015,1,14,6,144,126,270,157
0132-000,2015,1,14,7,331,432,763,270
0132-000,2015,1,14,8,596,1717,2313,763
0132-000,2015,1,14,9,771,1443,2214,2313
0132-000,2015,1,14,10,770,845,1615,2214
0132-000,2015,1,14,11,732,851,1583,1615
0132-000,2015,1,14,12,776,839,1615,1583
0132-000,2015,1,14,13,697,777,1474,1615
0132-000,2015,1,14,14,805,895,1700,1474
0132-000,2015,1,14,15,884,905,1789,1700
0132-000,2015,1,14,16,850,869,1719,1789
0132-000,2015,1,14,17,898,795,1693,1719
0132-000,2015,1,14,18,1172,853,2025,1693
0132-000,2015,1,14,19,1288,722,2010,2025
0132-000,2015,1,14,20,785,595,1380,2010
0132-000,2015,1,14,21,627,390,1017,1380
0132-000,2015,1,14,22,502,374,876,1017
0132-000,2015,1,14,23,329,251,580,876
0132-000,2015,1,14,24,192,179,371,580
0132-000,2015,1,15,1,149,106,255,371
0132-000,2015,1,15,2,98,80,178,255
0132-000,2015,1,15,3,84,66,150,178
0132-000,2015,1,15,4,87,78,165,150
0132-000,2015,1,15,5,93,58,151,165
0132-000,2015,1,15,6,156,134,290,151
0132-000,2015,1,15,7,327,372,699,290
0132-000,2015,1,15,8,584,1694,2278,699
0132-000,2015,1,15,9,767,1435,2202,2278
0132-000,2015,1,15,10,691,877,1568,2202
0132-000,2015,1,15,11,742,887,1629,1568
0132-000,2015,1,15,12,774,847,1621,1629
0132-000,2015,1,15,13,812,807,1619,1621
0132-000,2015,1,15,14,853,789,1642,1619
0132-000,2015,1,15,15,867,857,1724,1642
0132-000,2015,1,15,16,905,789,1694,1724
0132-000,2015,1,15,17,898,835,1733,1694
0132-000,2015,1,15,18,1201,899,2100,1733
0132-000,2015,1,15,19,1209,793,2002,2100
0132-000,2015,1,15,20,840,577,1417,2002
0132-000,2015,1,15,21,694,448,1142,1417
0132-000,2015,1,15,22,555,394,949,1142
0132-000,2015,1,15,23,361,265,626,949
0132-000,2015,1,15,24,207,161,368,626
0132-000,2015,1,16,1,129,130,259,368
0132-000,2015,1,16,2,104,86,190,259
0132-000,2015,1,16,3,69,64,133,190
0132-000,2015,1,16,4,77,56,133,133
0132-000,2015,1,16,5,80,80,160,133
0132-000,2015,1,16,6,144,138,282,160
0132-000,2015,1,16,7,337,384,721,282
0132-000,2015,1,16,8,578,1609,2187,721
0132-000,2015,1,16,9,721,1497,2218,2187
0132-000,2015,1,16,10,726,847,1573,2218
0132-000,2015,1,16,11,708,835,1543,1573
0132-000,2015,1,16,12,744,911,1655,1543
0132-000,2015,1,16,13,752,831,1583,1655
0132-000,2015,1,16,14,818,839,1657,1583
0132-000,2015,1,16,15,889,897,1786,1657
0132-000,2015,1,16,16,860,851,1711,1786
0132-000,2015,1,16,17,956,839,1795,1711
0132-000,2015,1,16,18,1291,831,2122,1795
0132-000,2015,1,16,19,1514,889,2403,2122
0132-000,2015,1,16,20,977,666,1643,2403
0132-000,2015,1,16,21,737,487,1224,1643
0132-000,2015,1,16,22,569,412,981,1224
0132-000,2015,1,16,23,327,281,608,981
0132-000,2015,1,16,24,221,199,420,608
0132-000,2015,1,17,1,198,181,379,420
0132-000,2015,1,17,2,132,126,258,379
0132-000,2015,1,17,3,101,90,191,258
0132-000,2015,1,17,4,83,68,151,191
0132-000,2015,1,17,5,90,64,154,151
0132-000,2015,1,17,6,143,132,275,154
0132-000,2015,1,17,7,264,225,489,275
0132-000,2015,1,17,8,378,720,1098,489
0132-000,2015,1,17,9,579,883,1462,1098
0132-000,2015,1,17,10,662,809,1471,1462
0132-000,2015,1,17,11,760,968,1728,1471
0132-000,2015,1,17,12,802,926,1728,1728
0132-000,2015,1,17,13,905,947,1852,1728
0132-000,2015,1,17,14,827,942,1769,1852
0132-000,2015,1,17,15,900,889,1789,1769
0132-000,2015,1,17,16,946,922,1868,1789
0132-000,2015,1,17,17,1082,895,1977,1868
0132-000,2015,1,17,18,1515,899,2414,1977
0132-000,2015,1,17,19,1179,692,1871,2414
0132-000,2015,1,17,20,741,545,1286,1871
0132-000,2015,1,17,21,529,406,935,1286
0132-000,2015,1,17,22,453,378,831,935
0132-000,2015,1,17,23,317,297,614,831
0132-000,2015,1,17,24,193,181,374,614
0132-000,2015,1,18,1,172,144,316,374
0132-000,2015,1,18,2,104,108,212,316
0132-000,2015,1,18,3,92,56,148,212
0132-000,2015,1,18,4,83,20,103,148
0132-000,2015,1,18,5,80,58,138,103
0132-000,2015,1,18,6,94,84,178,138
0132-000,2015,1,18,7,173,114,287,178
0132-000,2015,1,18,8,181,245,426,287
0132-000,2015,1,18,9,288,328,616,426
0132-000,2015,1,18,10,370,444,814,616
0132-000,2015,1,18,11,506,597,1103,814
0132-000,2015,1,18,12,536,618,1154,1103
0132-000,2015,1,18,13,661,616,1277,1154
0132-000,2015,1,18,14,660,722,1382,1277
0132-000,2015,1,18,15,819,722,1541,1382
0132-000,2015,1,18,16,919,767,1686,1541
0132-000,2015,1,18,17,994,686,1680,1686
0132-000,2015,1,18,18,1186,605,1791,1680
0132-000,2015,1,18,19,1023,513,1536,1791
0132-000,2015,1,18,20,670,456,1126,1536
0132-000,2015,1,18,21,528,356,884,1126
0132-000,2015,1,18,22,382,263,645,884
0132-000,2015,1,18,23,247,215,462,645
0132-000,2015,1,18,24,129,148,277,462
0132-000,2015,1,19,1,100,98,198,277
0132-000,2015,1,19,2,61,66,127,198
0132-000,2015,1,19,3,48,50,98,127
0132-000,2015,1,19,4,40,46,86,98
0132-000,2015,1,19,5,64,42,106,86
0132-000,2015,1,19,6,144,90,234,106
0132-000,2015,1,19,7,331,414,745,234
0132-000,2015,1,19,8,544,1747,2291,745
0132-000,2015,1,19,9,695,1302,1997,2291
0132-000,2015,1,19,10,651,720,1371,1997
0132-000,2015,1,19,11,670,676,1346,1371
0132-000,2015,1,19,12,729,891,1620,1346
0132-000,2015,1,19,13,698,759,1457,1620
0132-000,2015,1,19,14,817,821,1638,1457
0132-000,2015,1,19,15,798,984,1782,1638
0132-000,2015,1,19,16,877,825,1702,1782
0132-000,2015,1,19,17,814,785,1599,1702
0132-000,2015,1,19,18,1077,811,1888,1599
0132-000,2015,1,19,19,1226,765,1991,1888
0132-000,2015,1,19,20,806,561,1367,1991
0132-000,2015,1,19,21,740,412,1152,1367
0132-000,2015,1,19,22,506,322,828,1152
0132-000,2015,1,19,23,298,267,565,828
0132-000,2015,1,19,24,182,124,306,565
0132-000,2015,1,20,1,127,120,247,306
0132-000,2015,1,20,2,94,68,162,247
0132-000,2015,1,20,3,68,72,140,162
0132-000,2015,1,20,4,79,76,155,140
0132-000,2015,1,20,5,85,58,143,155
0132-000,2015,1,20,6,145,102,247,143
0132-000,2015,1,20,7,328,400,728,247
0132-000,2015,1,20,8,566,1754,2320,728
0132-000,2015,1,20,9,752,1358,2110,2320
0132-000,2015,1,20,10,775,861,1636,2110
0132-000,2015,1,20,11,749,837,1586,1636
0132-000,2015,1,20,12,786,907,1693,1586
0132-000,2015,1,20,13,750,825,1575,1693
0132-000,2015,1,20,14,817,918,1735,1575
0132-000,2015,1,20,15,864,825,1689,1735
0132-000,2015,1,20,16,887,881,1768,1689
0132-000,2015,1,20,17,904,817,1721,1768
0132-000,2015,1,20,18,1194,857,2051,1721
0132-000,2015,1,20,19,1199,825,2024,2051
0132-000,2015,1,20,20,905,571,1476,2024
0132-000,2015,1,20,21,719,465,1184,1476
0132-000,2015,1,20,22,559,408,967,1184
0132-000,2015,1,20,23,335,237,572,967
0132-000,2015,1,20,24,205,171,376,572
0132-000,2015,1,21,1,147,96,243,376
0132-000,2015,1,21,2,114,86,200,243
0132-000,2015,1,21,3,65,70,135,200
0132-000,2015,1,21,4,77,80,157,135
0132-000,2015,1,21,5,82,82,164,157
0132-000,2015,1,21,6,161,132,293,164
0132-000,2015,1,21,7,316,416,732,293
0132-000,2015,1,21,8,616,1790,2406,732
0132-000,2015,1,21,9,755,1598,2353,2406
0132-000,2015,1,21,10,808,936,1744,2353
0132-000,2015,1,21,11,789,813,1602,1744
0132-000,2015,1,21,12,795,879,1674,1602
0132-000,2015,1,21,13,691,797,1488,1674
0132-000,2015,1,21,14,797,831,1628,1488
0132-000,2015,1,21,15,1046,956,2002,1628
0132-000,2015,1,21,16,881,1181,2062,2002
0132-000,2015,1,21,17,861,998,1859,2062
0132-000,2015,1,21,18,1219,839,2058,1859
0132-000,2015,1,21,19,1225,720,1945,2058
0132-000,2015,1,21,20,790,555,1345,1945
0132-000,2015,1,21,21,669,416,1085,1345
0132-000,2015,1,21,22,504,360,864,1085
0132-000,2015,1,21,23,312,267,579,864
0132-000,2015,1,21,24,210,155,365,579
0132-000,2015,1,22,1,161,126,287,365
0132-000,2015,1,22,2,89,64,153,287
0132-000,2015,1,22,3,68,60,128,153
0132-000,2015,1,22,4,74,68,142,128
0132-000,2015,1,22,5,79,74,153,142
0132-000,2015,1,22,6,143,98,241,153
0132-000,2015,1,22,7,322,358,680,241
0132-000,2015,1,22,8,547,1662,2209,680
0132-000,2015,1,22,9,752,1364,2116,2209
0132-000,2015,1,22,10,667,863,1530,2116
0132-000,2015,1,22,11,741,773,1514,1530
0132-000,2015,1,22,12,764,817,1581,1514
0132-000,2015,1,22,13,725,843,1568,1581
0132-000,2015,1,22,14,806,763,1569,1568
0132-000,2015,1,22,15,787,807,1594,1569
0132-000,2015,1,22,16,841,797,1638,1594
0132-000,2015,1,22,17,821,799,1620,1638
0132-000,2015,1,22,18,1140,851,1991,1620
0132-000,2015,1,22,19,1155,718,1873,1991
0132-000,2015,1,22,20,831,579,1410,1873
0132-000,2015,1,22,21,737,440,1177,1410
0132-000,2015,1,22,22,514,330,844,1177
0132-000,2015,1,22,23,317,239,556,844
0132-000,2015,1,22,24,213,159,372,556
0132-000,2015,1,23,1,163,134,297,372
0132-000,2015,1,23,2,112,88,200,297
0132-000,2015,1,23,3,80,78,158,200
0132-000,2015,1,23,4,59,54,113,158
0132-000,2015,1,23,5,84,78,162,113
0132-000,2015,1,23,6,158,120,278,162
0132-000,2015,1,23,7,325,422,747,278
0132-000,2015,1,23,8,598,1707,2305,747
0132-000,2015,1,23,9,797,1348,2145,2305
0132-000,2015,1,23,10,745,924,1669,2145
0132-000,2015,1,23,11,716,946,1662,1669
0132-000,2015,1,23,12,785,883,1668,1662
0132-000,2015,1,23,13,784,815,1599,1668
0132-000,2015,1,23,14,782,857,1639,1599
0132-000,2015,1,23,15,867,976,1843,1639
0132-000,2015,1,23,16,959,879,1838,1843
0132-000,2015,1,23,17,870,813,1683,1838
0132-000,2015,1,23,18,1353,899,2252,1683
0132-000,2015,1,23,19,1470,803,2273,2252
0132-000,2015,1,23,20,954,781,1735,2273
0132-000,2015,1,23,21,734,503,1237,1735
0132-000,2015,1,23,22,618,390,1008,1237
0132-000,2015,1,23,23,372,322,694,1008
0132-000,2015,1,23,24,237,201,438,694
0132-000,2015,1,24,1,163,173,336,438
0132-000,2015,1,24,2,138,108,246,336
0132-000,2015,1,24,3,101,96,197,246
0132-000,2015,1,24,4,100,78,178,197
0132-000,2015,1,24,5,98,72,170,178
0132-000,2015,1,24,6,146,114,260,170
0132-000,2015,1,24,7,292,275,567,260
0132-000,2015,1,24,8,435,740,1175,567
0132-000,2015,1,24,9,575,881,1456,1175
0132-000,2015,1,24,10,622,821,1443,1456
0132-000,2015,1,24,11,713,1004,1717,1443
0132-000,2015,1,24,12,806,1112,1918,1717
0132-000,2015,1,24,13,829,928,1757,1918
0132-000,2015,1,24,14,832,891,1723,1757
0132-000,2015,1,24,15,875,926,1801,1723
0132-000,2015,1,24,16,900,815,1715,1801
0132-000,2015,1,24,17,1013,889,1902,1715
0132-000,2015,1,24,18,1378,909,2287,1902
0132-000,2015,1,24,19,1137,654,1791,2287
0132-000,2015,1,24,20,698,559,1257,1791
0132-000,2015,1,24,21,553,350,903,1257
0132-000,2015,1,24,22,443,338,781,903
0132-000,2015,1,24,23,286,285,571,781
0132-000,2015,1,24,24,199,199,398,571
0132-000,2015,1,25,1,160,169,329,398
0132-000,2015,1,25,2,120,98,218,329
0132-000,2015,1,25,3,95,94,189,218
0132-000,2015,1,25,4,68,66,134,189
0132-000,2015,1,25,5,81,70,151,134
0132-000,2015,1,25,6,92,104,196,151
0132-000,2015,1,25,7,153,92,245,196
0132-000,2015,1,25,8,201,259,460,245
0132-000,2015,1,25,9,332,360,692,460
0132-000,2015,1,25,10,398,465,863,692
0132-000,2015,1,25,11,455,559,1014,863
0132-000,2015,1,25,12,531,614,1145,1014
0132-000,2015,1,25,13,643,706,1349,1145
0132-000,2015,1,25,14,640,622,1262,1349
0132-000,2015,1,25,15,823,676,1499,1262
0132-000,2015,1,25,16,1084,605,1689,1499
0132-000,2015,1,25,17,1280,585,1865,1689
0132-000,2015,1,25,18,1305,666,1971,1865
0132-000,2015,1,25,19,1265,444,1709,1971
0132-000,2015,1,25,20,900,392,1292,1709
0132-000,2015,1,25,21,623,338,961,1292
0132-000,2015,1,25,22,381,318,699,961
0132-000,2015,1,25,23,227,217,444,699
0132-000,2015,1,25,24,149,140,289,444
0132-000,2015,1,26,1,108,102,210,289
0132-000,2015,1,26,2,74,78,152,210
0132-000,2015,1,26,3,61,56,117,152
0132-000,2015,1,26,4,51,48,99,117
0132-000,2015,1,26,5,64,44,108,99
0132-000,2015,1,26,6,144,130,274,108
0132-000,2015,1,26,7,337,469,806,274
0132-000,2015,1,26,8,590,1819,2409,806
0132-000,2015,1,26,9,695,1288,1983,2409
0132-000,2015,1,26,10,652,867,1519,1983
0132-000,2015,1,26,11,730,857,1587,1519
0132-000,2015,1,26,12,723,922,1645,1587
0132-000,2015,1,26,13,751,865,1616,1645
0132-000,2015,1,26,14,789,698,1487,1616
0132-000,2015,1,26,15,875,875,1750,1487
0132-000,2015,1,26,16,892,833,1725,1750
0132-000,2015,1,26,17,839,781,1620,1725
0132-000,2015,1,26,18,1172,837,2009,1620
0132-000,2015,1,26,19,1220,716,1936,2009
0132-000,2015,1,26,20,749,668,1417,1936
0132-000,2015,1,26,21,731,473,1204,1417
0132-000,2015,1,26,22,511,352,863,1204
0132-000,2015,1,26,23,310,245,555,863
0132-000,2015,1,26,24,174,144,318,555
0132-000,2015,1,27,1,150,108,258,318
0132-000,2015,1,27,2,110,86,196,258
0132-000,2015,1,27,3,75,66,141,196
0132-000,2015,1,27,4,85,62,147,141
0132-000,2015,1,27,5,72,52,124,147
0132-000,2015,1,27,6,123,126,249,124
0132-000,2015,1,27,7,365,362,727,249
0132-000,2015,1,27,8,570,1694,2264,727
0132-000,2015,1,27,9,745,1415,2160,2264
0132-000,2015,1,27,10,756,952,1708,2160
0132-000,2015,1,27,11,784,847,1631,1708
0132-000,2015,1,27,12,781,920,1701,1631
0132-000,2015,1,27,13,777,752,1529,1701
0132-000,2015,1,27,14,627,879,1506,1529
0132-000,2015,1,27,15,868,855,1723,1506
0132-000,2015,1,27,16,888,865,1753,1723
0132-000,2015,1,27,17,905,773,1678,1753
0132-000,2015,1,27,18,1142,873,2015,1678
0132-000,2015,1,27,19,1157,803,1960,2015
0132-000,2015,1,27,20,862,585,1447,1960
0132-000,2015,1,27,21,742,489,1231,1447
0132-000,2015,1,27,22,540,356,896,1231
0132-000,2015,1,27,23,342,217,559,896
0132-000,2015,1,27,24,206,191,397,559
0132-000,2015,1,28,1,150,152,302,397
0132-000,2015,1,28,2,102,52,154,302
0132-000,2015,1,28,3,67,56,123,154
0132-000,2015,1,28,4,61,52,113,123
0132-000,2015,1,28,5,81,72,153,113
0132-000,2015,1,28,6,136,108,244,153
0132-000,2015,1,28,7,331,406,737,244
0132-000,2015,1,28,8,591,1727,2318,737
0132-000,2015,1,28,9,764,1328,2092,2318
0132-000,2015,1,28,10,707,946,1653,2092
0132-000,2015,1,28,11,761,843,1604,1653
0132-000,2015,1,28,12,775,839,1614,1604
0132-000,2015,1,28,13,690,758,1448,1614
0132-000,2015,1,28,14,773,837,1610,1448
0132-000,2015,1,28,15,861,791,1652,1610
0132-000,2015,1,28,16,872,879,1751,1652
0132-000,2015,1,28,17,859,799,1658,1751
0132-000,2015,1,28,18,1214,962,2176,1658
0132-000,2015,1,28,19,1298,779,2077,2176
0132-000,2015,1,28,20,841,648,1489,2077
0132-000,2015,1,28,21,710,402,1112,1489
0132-000,2015,1,28,22,528,398,926,1112
0132-000,2015,1,28,23,331,289,620,926
0132-000,2015,1,28,24,198,169,367,620
0132-000,2015,1,29,1,180,132,312,367
0132-000,2015,1,29,2,82,102,184,312
0132-000,2015,1,29,3,72,80,152,184
0132-000,2015,1,29,4,85,72,157,152
0132-000,2015,1,29,5,90,82,172,157
0132-000,2015,1,29,6,146,134,280,172
0132-000,2015,1,29,7,349,378,727,280
0132-000,2015,1,29,8,592,1775,2367,727
0132-000,2015,1,29,9,804,1379,2183,2367
0132-000,2015,1,29,10,705,891,1596,2183
0132-000,2015,1,29,11,738,879,1617,1596
0132-000,2015,1,29,12,791,909,1700,1617
0132-000,2015,1,29,13,751,773,1524,1700
0132-000,2015,1,29,14,812,992,1804,1524
0132-000,2015,1,29,15,909,926,1835,1804
0132-000,2015,1,29,16,927,831,1758,1835
0132-000,2015,1,29,17,950,781,1731,1758
0132-000,2015,1,29,18,1103,865,1968,1731
0132-000,2015,1,29,19,1199,805,2004,1968
0132-000,2015,1,29,20,841,622,1463,2004
0132-000,2015,1,29,21,723,465,1188,1463
0132-000,2015,1,29,22,514,370,884,1188
0132-000,2015,1,29,23,378,253,631,884
0132-000,2015,1,29,24,219,157,376,631
0132-000,2015,1,30,1,149,116,265,376
0132-000,2015,1,30,2,137,74,211,265
0132-000,2015,1,30,3,80,82,162,211
0132-000,2015,1,30,4,77,66,143,162
0132-000,2015,1,30,5,81,84,165,143
0132-000,2015,1,30,6,169,144,313,165
0132-000,2015,1,30,7,330,356,686,313
0132-000,2015,1,30,8,588,1713,2301,686
0132-000,2015,1,30,9,753,1306,2059,2301
0132-000,2015,1,30,10,747,861,1608,2059
0132-000,2015,1,30,11,745,926,1671,1608
0132-000,2015,1,30,12,771,903,1674,1671
0132-000,2015,1,30,13,765,698,1463,1674
0132-000,2015,1,30,14,862,789,1651,1463
0132-000,2015,1,30,15,899,891,1790,1651
0132-000,2015,1,30,16,963,863,1826,1790
0132-000,2015,1,30,17,949,875,1824,1826
0132-000,2015,1,30,18,1353,938,2291,1824
0132-000,2015,1,30,19,1482,907,2389,2291
0132-000,2015,1,30,20,950,716,1666,2389
0132-000,2015,1,30,21,754,491,1245,1666
0132-000,2015,1,30,22,586,430,1016,1245
0132-000,2015,1,30,23,355,289,644,1016
0132-000,2015,1,30,24,233,215,448,644
0132-000,2015,1,31,1,193,189,382,448
0132-000,2015,1,31,2,124,100,224,382
0132-000,2015,1,31,3,81,88,169,224
0132-000,2015,1,31,4,102,54,156,169
0132-000,2015,1,31,5,104,86,190,156
0132-000,2015,1,31,6,138,106,244,190
0132-000,2015,1,31,7,254,267,521,244
0132-000,2015,1,31,8,398,765,1163,521
0132-000,2015,1,31,9,565,829,1394,1163
0132-000,2015,1,31,10,732,803,1535,1394
0132-000,2015,1,31,11,749,936,1685,1535
0132-000,2015,1,31,12,821,918,1739,1685
0132-000,2015,1,31,13,830,934,1764,1739
0132-000,2015,1,31,14,890,879,1769,1764
0132-000,2015,1,31,15,853,893,1746,1769
0132-000,2015,1,31,16,923,926,1849,1746
0132-000,2015,1,31,17,1044,853,1897,1849
0132-000,2015,1,31,18,1390,914,2304,1897
0132-000,2015,1,31,19,1022,628,1650,2304
0132-000,2015,1,31,20,630,475,1105,1650
0132-000,2015,1,31,21,513,410,923,1105
0132-000,2015,1,31,22,421,352,773,923
0132-000,2015,1,31,23,272,231,503,773
0132-000,2015,1,31,24,188,187,375,503
0132-000,2015,2,1,1,160,131,291,375
0132-000,2015,2,1,2,109,100,209,291
0132-000,2015,2,1,3,86,71,157,209
0132-000,2015,2,1,4,95,68,163,157
0132-000,2015,2,1,5,76,69,145,163
0132-000,2015,2,1,6,96,102,198,145
0132-000,2015,2,1,7,128,123,251,198
0132-000,2015,2,1,8,183,247,430,251
0132-000,2015,2,1,9,285,399,684,430
0132-000,2015,2,1,10,394,458,852,684
0132-000,2015,2,1,11,482,619,1101,852
0132-000,2015,2,1,12,516,581,1097,1101
0132-000,2015,2,1,13,638,625,1263,1097
0132-000,2015,2,1,14,686,715,1401,1263
0132-000,2015,2,1,15,805,712,1517,1401
0132-000,2015,2,1,16,876,669,1545,1517
0132-000,2015,2,1,17,979,644,1623,1545
0132-000,2015,2,1,18,1065,613,1678,1623
0132-000,2015,2,1,19,1010,471,1481,1678
0132-000,2015,2,1,20,724,506,1230,1481
0132-000,2015,2,1,21,531,314,845,1230
0132-000,2015,2,1,22,443,341,784,845
0132-000,2015,2,1,23,238,232,470,784
0132-000,2015,2,1,24,146,112,258,470
0132-000,2015,2,2,1,110,89,199,258
0132-000,2015,2,2,2,66,50,116,199
0132-000,2015,2,2,3,38,45,83,116
0132-000,2015,2,2,4,50,50,100,83
0132-000,2015,2,2,5,65,52,117,100
0132-000,2015,2,2,6,161,133,294,117
0132-000,2015,2,2,7,396,506,902,294
0132-000,2015,2,2,8,595,1824,2419,902
0132-000,2015,2,2,9,741,1419,2160,2419
0132-000,2015,2,2,10,709,824,1533,2160
0132-000,2015,2,2,11,763,751,1514,1533
0132-000,2015,2,2,12,691,826,1517,1514
0132-000,2015,2,2,13,711,757,1468,1517
0132-000,2015,2,2,14,822,810,1632,1468
0132-000,2015,2,2,15,862,847,1709,1632
0132-000,2015,2,2,16,926,839,1765,1709
0132-000,2015,2,2,17,906,784,1690,1765
0132-000,2015,2,2,18,1078,895,1973,1690
0132-000,2015,2,2,19,1175,759,1934,1973
0132-000,2015,2,2,20,880,602,1482,1934
0132-000,2015,2,2,21,768,429,1197,1482
0132-000,2015,2,2,22,524,372,896,1197
0132-000,2015,2,2,23,306,259,565,896
0132-000,2015,2,2,24,173,144,317,565
0132-000,2015,2,3,1,140,85,225,317
0132-000,2015,2,3,2,99,60,159,225
0132-000,2015,2,3,3,63,62,125,159
0132-000,2015,2,3,4,61,62,123,125
0132-000,2015,2,3,5,76,73,149,123
0132-000,2015,2,3,6,143,110,253,149
0132-000,2015,2,3,7,371,387,758,253
0132-000,2015,2,3,8,587,1773,2360,758
0132-000,2015,2,3,9,794,1312,2106,2360
0132-000,2015,2,3,10,689,831,1520,2106
0132-000,2015,2,3,11,761,807,1568,1520
0132-000,2015,2,3,12,781,887,1668,1568
0132-000,2015,2,3,13,713,755,1468,1668
0132-000,2015,2,3,14,818,807,1625,1468
0132-000,2015,2,3,15,860,816,1676,1625
0132-000,2015,2,3,16,857,791,1648,1676
0132-000,2015,2,3,17,882,872,1754,1648
0132-000,2015,2,3,18,1187,768,1955,1754
0132-000,2015,2,3,19,1236,759,1995,1955
0132-000,2015,2,3,20,818,567,1385,1995
0132-000,2015,2,3,21,810,504,1314,1385
0132-000,2015,2,3,22,549,381,930,1314
0132-000,2015,2,3,23,333,249,582,930
0132-000,2015,2,3,24,202,154,356,582
0132-000,2015,2,4,1,165,89,254,356
0132-000,2015,2,4,2,72,71,143,254
0132-000,2015,2,4,3,73,62,135,143
0132-000,2015,2,4,4,71,54,125,135
0132-000,2015,2,4,5,85,75,160,125
0132-000,2015,2,4,6,181,115,296,160
0132-000,2015,2,4,7,349,376,725,296
0132-000,2015,2,4,8,581,1775,2356,725
0132-000,2015,2,4,9,798,1360,2158,2356
0132-000,2015,2,4,10,687,870,1557,2158
0132-000,2015,2,4,11,769,826,1595,1557
0132-000,2015,2,4,12,757,908,1665,1595
0132-000,2015,2,4,13,780,766,1546,1665
0132-000,2015,2,4,14,809,814,1623,1546
0132-000,2015,2,4,15,866,843,1709,1623
0132-000,2015,2,4,16,870,774,1644,1709
0132-000,2015,2,4,17,938,797,1735,1644
0132-000,2015,2,4,18,1213,874,2087,1735
0132-000,2015,2,4,19,1183,764,1947,2087
0132-000,2015,2,4,20,820,632,1452,1947
0132-000,2015,2,4,21,682,427,1109,1452
0132-000,2015,2,4,22,566,332,898,1109
0132-000,2015,2,4,23,292,226,518,898
0132-000,2015,2,4,24,183,146,329,518
0132-000,2015,2,5,1,170,108,278,329
0132-000,2015,2,5,2,101,79,180,278
0132-000,2015,2,5,3,84,69,153,180
0132-000,2015,2,5,4,69,54,123,153
0132-000,2015,2,5,5,79,85,164,123
0132-000,2015,2,5,6,147,96,243,164
0132-000,2015,2,5,7,320,372,692,243
0132-000,2015,2,5,8,634,1759,2393,692
0132-000,2015,2,5,9,810,1312,2122,2393
0132-000,2015,2,5,10,734,879,1613,2122
0132-000,2015,2,5,11,711,918,1629,1613
0132-000,2015,2,5,12,760,808,1568,1629
0132-000,2015,2,5,13,777,738,1515,1568
0132-000,2015,2,5,14,855,852,1707,1515
0132-000,2015,2,5,15,879,851,1730,1707
0132-000,2015,2,5,16,887,887,1774,1730
0132-000,2015,2,5,17,927,759,1686,1774
0132-000,2015,2,5,18,1226,874,2100,1686
0132-000,2015,2,5,19,1251,726,1977,2100
0132-000,2015,2,5,20,846,640,1486,1977
0132-000,2015,2,5,21,750,487,1237,1486
0132-000,2015,2,5,22,548,450,998,1237
0132-000,2015,2,5,23,348,272,620,998
0132-000,2015,2,5,24,213,167,380,620
0132-000,2015,2,6,1,139,115,254,380
0132-000,2015,2,6,2,99,83,182,254
0132-000,2015,2,6,3,72,69,141,182
0132-000,2015,2,6,4,74,79,153,141
0132-000,2015,2,6,5,89,83,172,153
0132-000,2015,2,6,6,161,119,280,172
0132-000,2015,2,6,7,337,391,728,280
0132-000,2015,2,6,8,603,1693,2296,728
0132-000,2015,2,6,9,782,1354,2136,2296
0132-000,2015,2,6,10,758,837,1595,2136
0132-000,2015,2,6,11,727,816,1543,1595
0132-000,2015,2,6,12,771,929,1700,1543
0132-000,2015,2,6,13,723,747,1470,1700
0132-000,2015,2,6,14,884,841,1725,1470
0132-000,2015,2,6,15,895,944,1839,1725
0132-000,2015,2,6,16,992,843,1835,1839
0132-000,2015,2,6,17,1028,875,1903,1835
0132-000,2015,2,6,18,1370,889,2259,1903
0132-000,2015,2,6,19,1537,843,2380,2259
0132-000,2015,2,6,20,996,741,1737,2380
0132-000,2015,2,6,21,739,500,1239,1737
0132-000,2015,2,6,22,615,416,1031,1239
0132-000,2015,2,6,23,405,255,660,1031
0132-000,2015,2,6,24,226,184,410,660
0132-000,2015,2,7,1,222,186,408,410
0132-000,2015,2,7,2,152,129,281,408
0132-000,2015,2,7,3,73,73,146,281
0132-000,2015,2,7,4,83,104,187,146
0132-000,2015,2,7,5,100,81,181,187
0132-000,2015,2,7,6,132,112,244,181
0132-000,2015,2,7,7,279,247,526,244
0132-000,2015,2,7,8,506,749,1255,526
0132-000,2015,2,7,9,626,849,1475,1255
0132-000,2015,2,7,10,719,877,1596,1475
0132-000,2015,2,7,11,757,927,1684,1596
0132-000,2015,2,7,12,890,991,1881,1684
0132-000,2015,2,7,13,822,883,1705,1881
0132-000,2015,2,7,14,904,875,1779,1705
0132-000,2015,2,7,15,942,875,1817,1779
0132-000,2015,2,7,16,995,948,1943,1817
0132-000,2015,2,7,17,1103,839,1942,1943
0132-000,2015,2,7,18,1510,904,2414,1942
0132-000,2015,2,7,19,1172,718,1890,2414
0132-000,2015,2,7,20,782,506,1288,1890
0132-000,2015,2,7,21,560,445,1005,1288
0132-000,2015,2,7,22,444,301,745,1005
0132-000,2015,2,7,23,293,242,535,745
0132-000,2015,2,7,24,199,196,395,535
0132-000,2015,2,8,1,141,125,266,395
0132-000,2015,2,8,2,108,100,208,266
0132-000,2015,2,8,3,80,58,138,208
0132-000,2015,2,8,4,63,60,123,138
0132-000,2015,2,8,5,58,48,106,123
0132-000,2015,2,8,6,85,68,153,106
0132-000,2015,2,8,7,170,104,274,153
0132-000,2015,2,8,8,227,257,484,274
0132-000,2015,2,8,9,345,360,705,484
0132-000,2015,2,8,10,413,510,923,705
0132-000,2015,2,8,11,461,561,1022,923
0132-000,2015,2,8,12,561,548,1109,1022
0132-000,2015,2,8,13,623,567,1190,1109
0132-000,2015,2,8,14,713,669,1382,1190
0132-000,2015,2,8,15,817,660,1477,1382
0132-000,2015,2,8,16,826,651,1477,1477
0132-000,2015,2,8,17,985,621,1606,1477
0132-000,2015,2,8,18,994,613,1607,1606
0132-000,2015,2,8,19,851,514,1365,1607
0132-000,2015,2,8,20,547,385,932,1365
0132-000,2015,2,8,21,479,324,803,932
0132-000,2015,2,8,22,364,311,675,803
0132-000,2015,2,8,23,202,182,384,675
0132-000,2015,2,8,24,148,135,283,384
0132-000,2015,2,9,1,82,69,151,283
0132-000,2015,2,9,2,70,45,115,151
0132-000,2015,2,9,3,40,45,85,115
0132-000,2015,2,9,4,43,39,82,85
0132-000,2015,2,9,5,67,64,131,82
0132-000,2015,2,9,6,134,112,246,131
0132-000,2015,2,9,7,367,462,829,246
0132-000,2015,2,9,8,648,1881,2529,829
0132-000,2015,2,9,9,771,1320,2091,2529
0132-000,2015,2,9,10,700,816,1516,2091
0132-000,2015,2,9,11,773,789,1562,1516
0132-000,2015,2,9,12,718,891,1609,1562
0132-000,2015,2,9,13,730,812,1542,1609
0132-000,2015,2,9,14,814,787,1601,1542
0132-000,2015,2,9,15,859,872,1731,1601
0132-000,2015,2,9,16,887,864,1751,1731
0132-000,2015,2,9,17,866,778,1644,1751
0132-000,2015,2,9,18,1109,847,1956,1644
0132-000,2015,2,9,19,1149,707,1856,1956
0132-000,2015,2,9,20,782,538,1320,1856
0132-000,2015,2,9,21,716,389,1105,1320
0132-000,2015,2,9,22,524,364,888,1105
0132-000,2015,2,9,23,294,209,503,888
0132-000,2015,2,9,24,186,142,328,503
0132-000,2015,2,10,1,128,83,211,328
0132-000,2015,2,10,2,85,56,141,211
0132-000,2015,2,10,3,59,66,125,141
0132-000,2015,2,10,4,60,50,110,125
0132-000,2015,2,10,5,76,79,155,110
0132-000,2015,2,10,6,117,110,227,155
0132-000,2015,2,10,7,344,383,727,227
0132-000,2015,2,10,8,617,1737,2354,727
0132-000,2015,2,10,9,800,1343,2143,2354
0132-000,2015,2,10,10,732,1149,1881,2143
0132-000,2015,2,10,11,694,870,1564,1881
0132-000,2015,2,10,12,879,948,1827,1564
0132-000,2015,2,10,13,1011,818,1829,1827
0132-000,2015,2,10,14,1241,862,2103,1829
0132-000,2015,2,10,15,991,952,1943,2103
0132-000,2015,2,10,16,953,835,1788,1943
0132-000,2015,2,10,17,936,784,1720,1788
0132-000,2015,2,10,18,1145,868,2013,1720
0132-000,2015,2,10,19,1278,795,2073,2013
0132-000,2015,2,10,20,852,615,1467,2073
0132-000,2015,2,10,21,815,445,1260,1467
0132-000,2015,2,10,22,570,431,1001,1260
0132-000,2015,2,10,23,351,255,606,1001
0132-000,2015,2,10,24,219,163,382,606
0132-000,2015,2,11,1,163,127,290,382
0132-000,2015,2,11,2,99,96,195,290
0132-000,2015,2,11,3,81,68,149,195
0132-000,2015,2,11,4,68,77,145,149
0132-000,2015,2,11,5,97,62,159,145
0132-000,2015,2,11,6,158,123,281,159
0132-000,2015,2,11,7,364,408,772,281
0132-000,2015,2,11,8,670,1740,2410,772
0132-000,2015,2,11,9,857,1322,2179,2410
0132-000,2015,2,11,10,807,697,1504,2179
0132-000,2015,2,11,11,817,1015,1832,1504
0132-000,2015,2,11,12,768,910,1678,1832
0132-000,2015,2,11,13,747,925,1672,1678
0132-000,2015,2,11,14,836,992,1828,1672
0132-000,2015,2,11,15,952,925,1877,1828
0132-000,2015,2,11,16,1007,883,1890,1877
0132-000,2015,2,11,17,1025,816,1841,1890
0132-000,2015,2,11,18,1300,870,2170,1841
0132-000,2015,2,11,19,1343,799,2142,2170
0132-000,2015,2,11,20,824,594,1418,2142
0132-000,2015,2,11,21,729,466,1195,1418
0132-000,2015,2,11,22,556,391,947,1195
0132-000,2015,2,11,23,337,280,617,947
0132-000,2015,2,11,24,236,165,401,617
0132-000,2015,2,12,1,155,125,280,401
0132-000,2015,2,12,2,99,100,199,280
0132-000,2015,2,12,3,77,73,150,199
0132-000,2015,2,12,4,63,50,113,150
0132-000,2015,2,12,5,74,79,153,113
0132-000,2015,2,12,6,157,100,257,153
0132-000,2015,2,12,7,371,420,791,257
0132-000,2015,2,12,8,622,1739,2361,791
0132-000,2015,2,12,9,831,1356,2187,2361
0132-000,2015,2,12,10,739,971,1710,2187
0132-000,2015,2,12,11,786,1061,1847,1710
0132-000,2015,2,12,12,800,948,1748,1847
0132-000,2015,2,12,13,900,807,1707,1748
0132-000,2015,2,12,14,925,816,1741,1707
0132-000,2015,2,12,15,961,1015,1976,1741
0132-000,2015,2,12,16,1016,1000,2016,1976
0132-000,2015,2,12,17,1043,893,1936,2016
0132-000,2015,2,12,18,1234,849,2083,1936
0132-000,2015,2,12,19,1316,849,2165,2083
0132-000,2015,2,12,20,871,638,1509,2165
0132-000,2015,2,12,21,762,477,1239,1509
0132-000,2015,2,12,22,587,437,1024,1239
0132-000,2015,2,12,23,373,290,663,1024
0132-000,2015,2,12,24,217,154,371,663
0132-000,2015,2,13,1,138,115,253,371
0132-000,2015,2,13,2,98,77,175,253
0132-000,2015,2,13,3,60,60,120,175
0132-000,2015,2,13,4,77,64,141,120
0132-000,2015,2,13,5,77,81,158,141
0132-000,2015,2,13,6,155,98,253,158
0132-000,2015,2,13,7,384,435,819,253
0132-000,2015,2,13,8,586,1723,2309,819
0132-000,2015,2,13,9,798,1253,2051,2309
0132-000,2015,2,13,10,811,952,1763,2051
0132-000,2015,2,13,11,849,952,1801,1763
0132-000,2015,2,13,12,810,883,1693,1801
0132-000,2015,2,13,13,775,1000,1775,1693
0132-000,2015,2,13,14,926,918,1844,1775
0132-000,2015,2,13,15,953,1008,1961,1844
0132-000,2015,2,13,16,1058,916,1974,1961
0132-000,2015,2,13,17,1086,994,2080,1974
0132-000,2015,2,13,18,1481,954,2435,2080
0132-000,2015,2,13,19,1531,914,2445,2435
0132-000,2015,2,13,20,1030,743,1773,2445
0132-000,2015,2,13,21,811,577,1388,1773
0132-000,2015,2,13,22,635,462,1097,1388
0132-000,2015,2,13,23,407,293,700,1097
0132-000,2015,2,13,24,246,200,446,700
0132-000,2015,2,14,1,213,184,397,446
0132-000,2015,2,14,2,149,104,253,397
0132-000,2015,2,14,3,105,117,222,253
0132-000,2015,2,14,4,105,81,186,222
0132-000,2015,2,14,5,87,89,176,186
0132-000,2015,2,14,6,139,125,264,176
0132-000,2015,2,14,7,323,272,595,264
0132-000,2015,2,14,8,508,810,1318,595
0132-000,2015,2,14,9,647,921,1568,1318
0132-000,2015,2,14,10,751,887,1638,1568
0132-000,2015,2,14,11,790,977,1767,1638
0132-000,2015,2,14,12,862,946,1808,1767
0132-000,2015,2,14,13,867,883,1750,1808
0132-000,2015,2,14,14,974,807,1781,1750
0132-000,2015,2,14,15,907,896,1803,1781
0132-000,2015,2,14,16,906,841,1747,1803
0132-000,2015,2,14,17,991,870,1861,1747
0132-000,2015,2,14,18,1283,968,2251,1861
0132-000,2015,2,14,19,1070,753,1823,2251
0132-000,2015,2,14,20,690,584,1274,1823
0132-000,2015,2,14,21,578,443,1021,1274
0132-000,2015,2,14,22,458,387,845,1021
0132-000,2015,2,14,23,301,249,550,845
0132-000,2015,2,14,24,225,194,419,550
0132-000,2015,2,15,1,157,117,274,419
0132-000,2015,2,15,2,112,96,208,274
0132-000,2015,2,15,3,101,85,186,208
0132-000,2015,2,15,4,86,73,159,186
0132-000,2015,2,15,5,93,64,157,159
0132-000,2015,2,15,6,117,87,204,157
0132-000,2015,2,15,7,214,154,368,204
0132-000,2015,2,15,8,270,313,583,368
0132-000,2015,2,15,9,341,452,793,583
0132-000,2015,2,15,10,425,577,1002,793
0132-000,2015,2,15,11,502,646,1148,1002
0132-000,2015,2,15,12,590,638,1228,1148
0132-000,2015,2,15,13,675,720,1395,1228
0132-000,2015,2,15,14,722,738,1460,1395
0132-000,2015,2,15,15,813,732,1545,1460
0132-000,2015,2,15,16,882,768,1650,1545
0132-000,2015,2,15,17,910,761,1671,1650
0132-000,2015,2,15,18,968,730,1698,1671
0132-000,2015,2,15,19,905,556,1461,1698
0132-000,2015,2,15,20,569,422,991,1461
0132-000,2015,2,15,21,462,311,773,991
0132-000,2015,2,15,22,420,336,756,773
0132-000,2015,2,15,23,229,207,436,756
0132-000,2015,2,15,24,139,125,264,436
0132-000,2015,2,16,1,113,110,223,264
0132-000,2015,2,16,2,75,62,137,223
0132-000,2015,2,16,3,51,41,92,137
0132-000,2015,2,16,4,41,45,86,92
0132-000,2015,2,16,5,73,48,121,86
0132-000,2015,2,16,6,128,100,228,121
0132-000,2015,2,16,7,321,431,752,228
0132-000,2015,2,16,8,580,1770,2350,752
0132-000,2015,2,16,9,792,1356,2148,2350
0132-000,2015,2,16,10,766,923,1689,2148
0132-000,2015,2,16,11,796,963,1759,1689
0132-000,2015,2,16,12,862,983,1845,1759
0132-000,2015,2,16,13,826,797,1623,1845
0132-000,2015,2,16,14,892,939,1831,1623
0132-000,2015,2,16,15,927,1059,1986,1831
0132-000,2015,2,16,16,995,948,1943,1986
0132-000,2015,2,16,17,966,845,1811,1943
0132-000,2015,2,16,18,1233,879,2112,1811
0132-000,2015,2,16,19,1284,762,2046,2112
0132-000,2015,2,16,20,916,651,1567,2046
0132-000,2015,2,16,21,795,481,1276,1567
0132-000,2015,2,16,22,587,414,1001,1276
0132-000,2015,2,16,23,336,251,587,1001
0132-000,2015,2,16,24,211,177,388,587
0132-000,2015,2,17,1,153,125,278,388
0132-000,2015,2,17,2,110,102,212,278
0132-000,2015,2,17,3,74,75,149,212
0132-000,2015,2,17,4,72,66,138,149
0132-000,2015,2,17,5,94,69,163,138
0132-000,2015,2,17,6,132,90,222,163
0132-000,2015,2,17,7,297,366,663,222
0132-000,2015,2,17,8,541,1607,2148,663
0132-000,2015,2,17,9,753,1237,1990,2148
0132-000,2015,2,17,10,749,856,1605,1990
0132-000,2015,2,17,11,776,933,1709,1605
0132-000,2015,2,17,12,804,1009,1813,1709
0132-000,2015,2,17,13,824,1197,2021,1813
0132-000,2015,2,17,14,888,1547,2435,2021
0132-000,2015,2,17,15,910,1752,2662,2435
0132-000,2015,2,17,16,1094,1873,2967,2662
0132-000,2015,2,17,17,1105,1789,2894,2967
0132-000,2015,2,17,18,1330,2275,3605,2894
0132-000,2015,2,17,19,1242,2003,3245,3605
0132-000,2015,2,17,20,764,1953,2717,3245
0132-000,2015,2,17,21,594,2016,2610,2717
0132-000,2015,2,17,22,445,1796,2241,2610
0132-000,2015,2,17,23,307,1220,1527,2241
0132-000,2015,2,17,24,187,983,1170,1527
0132-000,2015,2,18,1,158,745,903,1170
0132-000,2015,2,18,2,100,598,698,903
0132-000,2015,2,18,3,86,517,603,698
0132-000,2015,2,18,4,71,496,567,603
0132-000,2015,2,18,5,101,1172,1273,567
0132-000,2015,2,18,6,83,1838,1921,1273
0132-000,2015,2,18,7,127,1651,1778,1921
0132-000,2015,2,18,8,200,1957,2157,1778
0132-000,2015,2,18,9,327,2034,2361,2157
0132-000,2015,2,18,10,432,2015,2447,2361
0132-000,2015,2,18,11,662,2101,2763,2447
0132-000,2015,2,18,12,804,2108,2912,2763
0132-000,2015,2,18,13,733,2099,2832,2912
0132-000,2015,2,18,14,669,1869,2538,2832
0132-000,2015,2,18,15,498,1366,1864,2538
0132-000,2015,2,18,16,624,1163,1787,1864
0132-000,2015,2,18,17,608,948,1556,1787
0132-000,2015,2,18,18,582,780,1362,1556
0132-000,2015,2,18,19,428,542,970,1362
0132-000,2015,2,18,20,398,383,781,970
0132-000,2015,2,18,21,301,318,619,781
0132-000,2015,2,18,22,244,253,497,619
0132-000,2015,2,18,23,168,173,341,497
0132-000,2015,2,18,24,138,144,282,341
0132-000,2015,2,19,1,88,77,165,282
0132-000,2015,2,19,2,63,71,134,165
0132-000,2015,2,19,3,44,48,92,134
0132-000,2015,2,19,4,48,54,102,92
0132-000,2015,2,19,5,52,31,83,102
0132-000,2015,2,19,6,62,79,141,83
0132-000,2015,2,19,7,201,272,473,141
0132-000,2015,2,19,8,357,688,1045,473
0132-000,2015,2,19,9,352,684,1036,1045
0132-000,2015,2,19,10,415,686,1101,1036
0132-000,2015,2,19,11,848,1145,1993,1101
0132-000,2015,2,19,12,1415,1714,3129,1993
0132-000,2015,2,19,13,1649,1898,3547,3129
0132-000,2015,2,19,14,1966,1926,3892,3547
0132-000,2015,2,19,15,2142,2135,4277,3892
0132-000,2015,2,19,16,2033,2110,4143,4277
0132-000,2015,2,19,17,2220,2124,4344,4143
0132-000,2015,2,19,18,2058,2176,4234,4344
0132-000,2015,2,19,19,1969,1706,3675,4234
0132-000,2015,2,19,20,1781,971,2752,3675
0132-000,2015,2,19,21,1435,560,1995,2752
0132-000,2015,2,19,22,1282,292,1574,1995
0132-000,2015,2,19,23,710,203,913,1574
0132-000,2015,2,19,24,484,154,638,913
0132-000,2015,2,20,1,348,113,461,638
0132-000,2015,2,20,2,224,64,288,461
0132-000,2015,2,20,3,87,43,130,288
0132-000,2015,2,20,4,55,52,107,130
0132-000,2015,2,20,5,64,25,89,107
0132-000,2015,2,20,6,76,35,111,89
0132-000,2015,2,20,7,105,41,146,111
0132-000,2015,2,20,8,167,146,313,146
0132-000,2015,2,20,9,264,200,464,313
0132-000,2015,2,20,10,411,336,747,464
0132-000,2015,2,20,11,749,504,1253,747
0132-000,2015,2,20,12,1271,611,1882,1253
0132-000,2015,2,20,13,1245,637,1882,1882
0132-000,2015,2,20,14,1464,605,2069,1882
0132-000,2015,2,20,15,1413,558,1971,2069
0132-000,2015,2,20,16,1649,569,2218,1971
0132-000,2015,2,20,17,2033,510,2543,2218
0132-000,2015,2,20,18,1673,504,2177,2543
0132-000,2015,2,20,19,1970,401,2371,2177
0132-000,2015,2,20,20,2019,292,2311,2371
0132-000,2015,2,20,21,1753,297,2050,2311
0132-000,2015,2,20,22,1450,213,1663,2050
0132-000,2015,2,20,23,1512,215,1727,1663
0132-000,2015,2,20,24,890,136,1026,1727
0132-000,2015,2,21,1,743,96,839,1026
0132-000,2015,2,21,2,417,64,481,839
0132-000,2015,2,21,3,163,43,206,481
0132-000,2015,2,21,4,93,37,130,206
0132-000,2015,2,21,5,73,45,118,130
0132-000,2015,2,21,6,87,54,141,118
0132-000,2015,2,21,7,151,98,249,141
0132-000,2015,2,21,8,216,284,500,249
0132-000,2015,2,21,9,357,313,670,500
0132-000,2015,2,21,10,509,372,881,670
0132-000,2015,2,21,11,678,494,1172,881
0132-000,2015,2,21,12,886,608,1494,1172
0132-000,2015,2,21,13,1034,487,1521,1494
0132-000,2015,2,21,14,1227,546,1773,1521
0132-000,2015,2,21,15,1401,573,1974,1773
0132-000,2015,2,21,16,1652,604,2256,1974
0132-000,2015,2,21,17,1866,525,2391,2256
0132-000,2015,2,21,18,1629,565,2194,2391
0132-000,2015,2,21,19,1593,295,1888,2194
0132-000,2015,2,21,20,1587,276,1863,1888
0132-000,2015,2,21,21,1171,232,1403,1863
0132-000,2015,2,21,22,886,276,1162,1403
0132-000,2015,2,21,23,541,190,731,1162
0132-000,2015,2,21,24,247,148,395,731
0132-000,2015,2,22,1,171,113,284,395
0132-000,2015,2,22,2,116,96,212,284
0132-000,2015,2,22,3,93,71,164,212
0132-000,2015,2,22,4,84,43,127,164
0132-000,2015,2,22,5,74,66,140,127
0132-000,2015,2,22,6,73,39,112,140
0132-000,2015,2,22,7,139,77,216,112
0132-000,2015,2,22,8,186,213,399,216
0132-000,2015,2,22,9,268,270,538,399
0132-000,2015,2,22,10,352,303,655,538
0132-000,2015,2,22,11,416,450,866,655
0132-000,2015,2,22,12,506,426,932,866
0132-000,2015,2,22,13,557,489,1046,932
0132-000,2015,2,22,14,724,563,1287,1046
0132-000,2015,2,22,15,785,558,1343,1287
0132-000,2015,2,22,16,899,561,1460,1343
0132-000,2015,2,22,17,772,537,1309,1460
0132-000,2015,2,22,18,791,558,1349,1309
0132-000,2015,2,22,19,611,433,1044,1349
0132-000,2015,2,22,20,498,385,883,1044
0132-000,2015,2,22,21,367,324,691,883
0132-000,2015,2,22,22,337,278,615,691
0132-000,2015,2,22,23,228,194,422,615
0132-000,2015,2,22,24,161,142,303,422
0132-000,2015,2,23,1,110,92,202,303
0132-000,2015,2,23,2,86,35,121,202
0132-000,2015,2,23,3,58,35,93,121
0132-000,2015,2,23,4,71,33,104,93
0132-000,2015,2,23,5,64,66,130,104
0132-000,2015,2,23,6,152,113,265,130
0132-000,2015,2,23,7,387,464,851,265
0132-000,2015,2,23,8,655,1858,2513,851
0132-000,2015,2,23,9,820,1354,2174,2513
0132-000,2015,2,23,10,714,874,1588,2174
0132-000,2015,2,23,11,777,856,1633,1588
0132-000,2015,2,23,12,695,805,1500,1633
0132-000,2015,2,23,13,726,808,1534,1500
0132-000,2015,2,23,14,800,784,1584,1534
0132-000,2015,2,23,15,840,818,1658,1584
0132-000,2015,2,23,16,897,818,1715,1658
0132-000,2015,2,23,17,893,807,1700,1715
0132-000,2015,2,23,18,1121,807,1928,1700
0132-000,2015,2,23,19,1218,879,2097,1928
0132-000,2015,2,23,20,831,583,1414,2097
0132-000,2015,2,23,21,734,464,1198,1414
0132-000,2015,2,23,22,539,370,909,1198
0132-000,2015,2,23,23,333,219,552,909
0132-000,2015,2,23,24,209,131,340,552
0132-000,2015,2,24,1,121,106,227,340
0132-000,2015,2,24,2,96,56,152,227
0132-000,2015,2,24,3,51,68,119,152
0132-000,2015,2,24,4,70,50,120,119
0132-000,2015,2,24,5,75,71,146,120
0132-000,2015,2,24,6,143,87,230,146
0132-000,2015,2,24,7,390,401,791,230
0132-000,2015,2,24,8,638,1738,2376,791
0132-000,2015,2,24,9,820,1356,2176,2376
0132-000,2015,2,24,10,732,889,1621,2176
0132-000,2015,2,24,11,751,954,1705,1621
0132-000,2015,2,24,12,827,810,1637,1705
0132-000,2015,2,24,13,785,824,1609,1637
0132-000,2015,2,24,14,824,864,1688,1609
0132-000,2015,2,24,15,859,883,1742,1688
0132-000,2015,2,24,16,966,877,1843,1742
0132-000,2015,2,24,17,1029,826,1855,1843
0132-000,2015,2,24,18,1256,851,2107,1855
0132-000,2015,2,24,19,1216,757,1973,2107
0132-000,2015,2,24,20,886,648,1534,1973
0132-000,2015,2,24,21,759,514,1273,1534
0132-000,2015,2,24,22,586,431,1017,1273
0132-000,2015,2,24,23,349,270,619,1017
0132-000,2015,2,24,24,220,156,376,619
0132-000,2015,2,25,1,142,110,252,376
0132-000,2015,2,25,2,105,71,176,252
0132-000,2015,2,25,3,70,69,139,176
0132-000,2015,2,25,4,67,69,136,139
0132-000,2015,2,25,5,85,83,168,136
0132-000,2015,2,25,6,158,119,277,168
0132-000,2015,2,25,7,387,403,790,277
0132-000,2015,2,25,8,629,1754,2383,790
0132-000,2015,2,25,9,847,1348,2195,2383
0132-000,2015,2,25,10,762,906,1668,2195
0132-000,2015,2,25,11,777,841,1618,1668
0132-000,2015,2,25,12,761,856,1617,1618
0132-000,2015,2,25,13,728,782,1510,1617
0132-000,2015,2,25,14,814,852,1666,1510
0132-000,2015,2,25,15,906,925,1831,1666
0132-000,2015,2,25,16,985,812,1797,1831
0132-000,2015,2,25,17,987,849,1836,1797
0132-000,2015,2,25,18,1290,902,2192,1836
0132-000,2015,2,25,19,1324,822,2146,2192
0132-000,2015,2,25,20,843,605,1448,2146
0132-000,2015,2,25,21,723,506,1229,1448
0132-000,2015,2,25,22,546,418,964,1229
0132-000,2015,2,25,23,328,280,608,964
0132-000,2015,2,25,24,216,180,396,608
0132-000,2015,2,26,1,173,138,311,396
0132-000,2015,2,26,2,89,87,176,311
0132-000,2015,2,26,3,76,87,163,176
0132-000,2015,2,26,4,82,71,153,163
0132-000,2015,2,26,5,68,85,153,153
0132-000,2015,2,26,6,165,108,273,153
0132-000,2015,2,26,7,391,433,824,273
0132-000,2015,2,26,8,609,1692,2301,824
0132-000,2015,2,26,9,793,1346,2139,2301
0132-000,2015,2,26,10,734,904,1638,2139
0132-000,2015,2,26,11,840,856,1696,1638
0132-000,2015,2,26,12,800,879,1679,1696
0132-000,2015,2,26,13,689,852,1541,1679
0132-000,2015,2,26,14,850,833,1683,1541
0132-000,2015,2,26,15,918,937,1855,1683
0132-000,2015,2,26,16,958,925,1883,1855
0132-000,2015,2,26,17,942,833,1775,1883
0132-000,2015,2,26,18,1120,887,2007,1775
0132-000,2015,2,26,19,1274,837,2111,2007
0132-000,2015,2,26,20,913,703,1616,2111
0132-000,2015,2,26,21,842,508,1350,1616
0132-000,2015,2,26,22,551,420,971,1350
0132-000,2015,2,26,23,401,263,664,971
0132-000,2015,2,26,24,219,173,392,664
0132-000,2015,2,27,1,180,138,318,392
0132-000,2015,2,27,2,99,68,167,318
0132-000,2015,2,27,3,86,102,188,167
0132-000,2015,2,27,4,61,58,119,188
0132-000,2015,2,27,5,82,73,155,119
0132-000,2015,2,27,6,154,117,271,155
0132-000,2015,2,27,7,402,464,866,271
0132-000,2015,2,27,8,657,1749,2406,866
0132-000,2015,2,27,9,880,1344,2224,2406
0132-000,2015,2,27,10,733,931,1664,2224
0132-000,2015,2,27,11,809,950,1759,1664
0132-000,2015,2,27,12,757,885,1642,1759
0132-000,2015,2,27,13,784,730,1514,1642
0132-000,2015,2,27,14,903,822,1725,1514
0132-000,2015,2,27,15,907,900,1807,1725
0132-000,2015,2,27,16,997,883,1880,1807
0132-000,2015,2,27,17,1029,937,1966,1880
0132-000,2015,2,27,18,1337,931,2268,1966
0132-000,2015,2,27,19,1596,914,2510,2268
0132-000,2015,2,27,20,1095,711,1806,2510
0132-000,2015,2,27,21,959,602,1561,1806
0132-000,2015,2,27,22,643,414,1057,1561
0132-000,2015,2,27,23,417,313,730,1057
0132-000,2015,2,27,24,256,198,454,730
0132-000,2015,2,28,1,202,184,386,454
0132-000,2015,2,28,2,142,106,248,386
0132-000,2015,2,28,3,108,89,197,248
0132-000,2015,2,28,4,78,85,163,197
0132-000,2015,2,28,5,121,85,206,163
0132-000,2015,2,28,6,172,140,312,206
0132-000,2015,2,28,7,342,274,616,312
0132-000,2015,2,28,8,505,789,1294,616
0132-000,2015,2,28,9,652,860,1512,1294
0132-000,2015,2,28,10,721,944,1665,1512
0132-000,2015,2,28,11,802,883,1685,1665
0132-000,2015,2,28,12,1024,1055,2079,1685
0132-000,2015,2,28,13,935,1082,2017,2079
0132-000,2015,2,28,14,1049,702,1751,2017
0132-000,2015,2,28,15,1061,1027,2088,1751
0132-000,2015,2,28,16,1177,956,2133,2088
0132-000,2015,2,28,17,1394,944,2338,2133
0132-000,2015,2,28,18,1646,1031,2677,2338
0132-000,2015,2,28,19,1607,875,2482,2677
0132-000,2015,2,28,20,1114,594,1708,2482
0132-000,2015,2,28,21,784,468,1252,1708
0132-000,2015,2,28,22,612,387,999,1252
0132-000,2015,2,28,23,372,263,635,999
0132-000,2015,2,28,24,223,188,411,635
0132-000,2015,3,1,1,187,137,324,411
0132-000,2015,3,1,2,115,129,244,324
0132-000,2015,3,1,3,95,75,170,244
0132-000,2015,3,1,4,73,64,137,170
0132-000,2015,3,1,5,70,52,122,137
0132-000,2015,3,1,6,104,66,170,122
0132-000,2015,3,1,7,192,127,319,170
0132-000,2015,3,1,8,238,296,534,319
0132-000,2015,3,1,9,323,442,765,534
0132-000,2015,3,1,10,438,577,1015,765
0132-000,2015,3,1,11,524,717,1241,1015
0132-000,2015,3,1,12,544,749,1293,1241
0132-000,2015,3,1,13,704,707,1411,1293
0132-000,2015,3,1,14,840,864,1704,1411
0132-000,2015,3,1,15,951,849,1800,1704
0132-000,2015,3,1,16,1204,774,1978,1800
0132-000,2015,3,1,17,1392,847,2239,1978
0132-000,2015,3,1,18,1473,721,2194,2239
0132-000,2015,3,1,19,1580,665,2245,2194
0132-000,2015,3,1,20,1188,490,1678,2245
0132-000,2015,3,1,21,813,436,1249,1678
0132-000,2015,3,1,22,591,335,926,1249
0132-000,2015,3,1,23,294,290,584,926
0132-000,2015,3,1,24,176,118,294,584
0132-000,2015,3,2,1,98,100,198,294
0132-000,2015,3,2,2,70,70,140,198
0132-000,2015,3,2,3,50,45,95,140
0132-000,2015,3,2,4,39,37,76,95
0132-000,2015,3,2,5,61,60,121,76
0132-000,2015,3,2,6,152,145,297,121
0132-000,2015,3,2,7,426,565,991,297
0132-000,2015,3,2,8,691,1827,2518,991
0132-000,2015,3,2,9,763,1425,2188,2518
0132-000,2015,3,2,10,790,801,1591,2188
0132-000,2015,3,2,11,767,844,1611,1591
0132-000,2015,3,2,12,753,794,1547,1611
0132-000,2015,3,2,13,749,886,1635,1547
0132-000,2015,3,2,14,785,861,1646,1635
0132-000,2015,3,2,15,872,832,1704,1646
0132-000,2015,3,2,16,934,892,1826,1704
0132-000,2015,3,2,17,931,909,1840,1826
0132-000,2015,3,2,18,1220,832,2052,1840
0132-000,2015,3,2,19,1337,755,2092,2052
0132-000,2015,3,2,20,873,567,1440,2092
0132-000,2015,3,2,21,762,469,1231,1440
0132-000,2015,3,2,22,470,346,816,1231
0132-000,2015,3,2,23,346,217,563,816
0132-000,2015,3,2,24,219,146,365,563
0132-000,2015,3,3,1,110,75,185,365
0132-000,2015,3,3,2,105,75,180,185
0132-000,2015,3,3,3,60,50,110,180
0132-000,2015,3,3,4,63,79,142,110
0132-000,2015,3,3,5,75,60,135,142
0132-000,2015,3,3,6,144,121,265,135
0132-000,2015,3,3,7,382,410,792,265
0132-000,2015,3,3,8,669,1813,2482,792
0132-000,2015,3,3,9,778,1418,2196,2482
0132-000,2015,3,3,10,798,953,1751,2196
0132-000,2015,3,3,11,726,893,1619,1751
0132-000,2015,3,3,12,746,851,1597,1619
0132-000,2015,3,3,13,779,740,1519,1597
0132-000,2015,3,3,14,852,838,1690,1519
0132-000,2015,3,3,15,873,853,1726,1690
0132-000,2015,3,3,16,957,759,1716,1726
0132-000,2015,3,3,17,919,849,1768,1716
0132-000,2015,3,3,18,1103,853,1956,1768
0132-000,2015,3,3,19,1239,749,1988,1956
0132-000,2015,3,3,20,851,552,1403,1988
0132-000,2015,3,3,21,775,436,1211,1403
0132-000,2015,3,3,22,534,350,884,1211
0132-000,2015,3,3,23,349,260,609,884
0132-000,2015,3,3,24,185,127,312,609
0132-000,2015,3,4,1,143,120,263,312
0132-000,2015,3,4,2,90,66,156,263
0132-000,2015,3,4,3,73,72,145,156
0132-000,2015,3,4,4,70,70,140,145
0132-000,2015,3,4,5,81,73,154,140
0132-000,2015,3,4,6,168,95,263,154
0132-000,2015,3,4,7,374,410,784,263
0132-000,2015,3,4,8,686,1762,2448,784
0132-000,2015,3,4,9,819,1475,2294,2448
0132-000,2015,3,4,10,823,926,1749,2294
0132-000,2015,3,4,11,773,868,1641,1749
0132-000,2015,3,4,12,794,797,1591,1641
0132-000,2015,3,4,13,674,815,1489,1591
0132-000,2015,3,4,14,804,842,1646,1489
0132-000,2015,3,4,15,817,840,1657,1646
0132-000,2015,3,4,16,903,784,1687,1657
0132-000,2015,3,4,17,889,794,1683,1687
0132-000,2015,3,4,18,1217,855,2072,1683
0132-000,2015,3,4,19,1348,807,2155,2072
0132-000,2015,3,4,20,865,673,1538,2155
0132-000,2015,3,4,21,753,498,1251,1538
0132-000,2015,3,4,22,544,398,942,1251
0132-000,2015,3,4,23,351,273,624,942
0132-000,2015,3,4,24,217,164,381,624
0132-000,2015,3,5,1,153,127,280,381
0132-000,2015,3,5,2,103,54,157,280
0132-000,2015,3,5,3,74,52,126,157
0132-000,2015,3,5,4,80,77,157,126
0132-000,2015,3,5,5,65,52,117,157
0132-000,2015,3,5,6,162,129,291,117
0132-000,2015,3,5,7,389,440,829,291
0132-000,2015,3,5,8,681,1777,2458,829
0132-000,2015,3,5,9,819,1452,2271,2458
0132-000,2015,3,5,10,793,886,1679,2271
0132-000,2015,3,5,11,763,809,1572,1679
0132-000,2015,3,5,12,789,849,1638,1572
0132-000,2015,3,5,13,716,788,1504,1638
0132-000,2015,3,5,14,823,832,1655,1504
0132-000,2015,3,5,15,845,755,1600,1655
0132-000,2015,3,5,16,895,753,1648,1600
0132-000,2015,3,5,17,896,820,1716,1648
0132-000,2015,3,5,18,1220,807,2027,1716
0132-000,2015,3,5,19,1283,834,2117,2027
0132-000,2015,3,5,20,891,619,1510,2117
0132-000,2015,3,5,21,790,490,1280,1510
0132-000,2015,3,5,22,569,379,948,1280
0132-000,2015,3,5,23,361,273,634,948
0132-000,2015,3,5,24,211,150,361,634
0132-000,2015,3,6,1,159,68,227,361
0132-000,2015,3,6,2,102,44,146,227
0132-000,2015,3,6,3,88,33,121,146
0132-000,2015,3,6,4,56,32,88,121
0132-000,2015,3,6,5,74,31,105,88
0132-000,2015,3,6,6,168,64,232,105
0132-000,2015,3,6,7,396,234,630,232
0132-000,2015,3,6,8,706,1736,2442,630
0132-000,2015,3,6,9,813,1298,2111,2442
0132-000,2015,3,6,10,769,942,1711,2111
0132-000,2015,3,6,11,724,951,1675,1711
0132-000,2015,3,6,12,779,884,1663,1675
0132-000,2015,3,6,13,727,865,1592,1663
0132-000,2015,3,6,14,903,870,1773,1592
0132-000,2015,3,6,15,882,966,1848,1773
0132-000,2015,3,6,16,1011,857,1868,1848
0132-000,2015,3,6,17,1012,865,1877,1868
0132-000,2015,3,6,18,1336,898,2234,1877
0132-000,2015,3,6,19,1661,911,2572,2234
0132-000,2015,3,6,20,1121,735,1856,2572
0132-000,2015,3,6,21,847,536,1383,1856
0132-000,2015,3,6,22,603,458,1061,1383
0132-000,2015,3,6,23,378,369,747,1061
0132-000,2015,3,6,24,251,261,512,747
0132-000,2015,3,7,1,191,221,412,512
0132-000,2015,3,7,2,152,135,287,412
0132-000,2015,3,7,3,102,101,203,287
0132-000,2015,3,7,4,91,109,200,203
0132-000,2015,3,7,5,108,115,223,200
0132-000,2015,3,7,6,142,170,312,223
0132-000,2015,3,7,7,341,342,683,312
0132-000,2015,3,7,8,487,761,1248,683
0132-000,2015,3,7,9,660,851,1511,1248
0132-000,2015,3,7,10,710,968,1678,1511
0132-000,2015,3,7,11,795,953,1748,1678
0132-000,2015,3,7,12,867,1013,1880,1748
0132-000,2015,3,7,13,787,951,1738,1880
0132-000,2015,3,7,14,869,857,1726,1738
0132-000,2015,3,7,15,904,880,1784,1726
0132-000,2015,3,7,16,1000,864,1864,1784
0132-000,2015,3,7,17,1107,982,2089,1864
0132-000,2015,3,7,18,1435,967,2402,2089
0132-000,2015,3,7,19,1265,777,2042,2402
0132-000,2015,3,7,20,806,587,1393,2042
0132-000,2015,3,7,21,603,511,1114,1393
0132-000,2015,3,7,22,463,374,837,1114
0132-000,2015,3,7,23,298,328,626,837
0132-000,2015,3,7,24,195,210,405,626
0132-000,2015,3,8,1,160,186,346,405
0132-000,2015,3,8,2,105,134,239,346
0132-000,2015,3,8,3,114,91,205,239
0132-000,2015,3,8,4,64,70,134,205
0132-000,2015,3,8,5,79,74,153,134
0132-000,2015,3,8,6,109,94,203,153
0132-000,2015,3,8,7,220,183,403,203
0132-000,2015,3,8,8,249,332,581,403
0132-000,2015,3,8,9,345,492,837,581
0132-000,2015,3,8,10,420,605,1025,837
0132-000,2015,3,8,11,507,625,1132,1025
0132-000,2015,3,8,12,576,689,1265,1132
0132-000,2015,3,8,13,634,618,1252,1265
0132-000,2015,3,8,14,702,657,1359,1252
0132-000,2015,3,8,15,809,695,1504,1359
0132-000,2015,3,8,16,877,704,1581,1504
0132-000,2015,3,8,17,1017,725,1742,1581
0132-000,2015,3,8,18,1044,717,1761,1742
0132-000,2015,3,8,19,1032,591,1623,1761
0132-000,2015,3,8,20,696,480,1176,1623
0132-000,2015,3,8,21,547,510,1057,1176
0132-000,2015,3,8,22,428,371,799,1057
0132-000,2015,3,8,23,249,254,503,799
0132-000,2015,3,8,24,173,171,344,503
0132-000,2015,3,9,1,111,127,238,344
0132-000,2015,3,9,2,77,80,157,238
0132-000,2015,3,9,3,37,56,93,157
0132-000,2015,3,9,4,58,69,127,93
0132-000,2015,3,9,5,69,84,153,127
0132-000,2015,3,9,6,195,176,371,153
0132-000,2015,3,9,7,468,569,1037,371
0132-000,2015,3,9,8,710,1833,2543,1037
0132-000,2015,3,9,9,809,1471,2280,2543
0132-000,2015,3,9,10,819,912,1731,2280
0132-000,2015,3,9,11,806,879,1685,1731
0132-000,2015,3,9,12,762,821,1583,1685
0132-000,2015,3,9,13,736,804,1540,1583
0132-000,2015,3,9,14,863,831,1694,1540
0132-000,2015,3,9,15,892,869,1761,1694
0132-000,2015,3,9,16,862,830,1692,1761
0132-000,2015,3,9,17,904,812,1716,1692
0132-000,2015,3,9,18,1083,921,2004,1716
0132-000,2015,3,9,19,1309,869,2178,2004
0132-000,2015,3,9,20,854,636,1490,2178
0132-000,2015,3,9,21,746,492,1238,1490
0132-000,2015,3,9,22,570,408,978,1238
0132-000,2015,3,9,23,322,265,587,978
0132-000,2015,3,9,24,168,168,336,587
0132-000,2015,3,10,1,120,124,244,336
0132-000,2015,3,10,2,95,80,175,244
0132-000,2015,3,10,3,58,68,126,175
0132-000,2015,3,10,4,68,66,134,126
0132-000,2015,3,10,5,77,87,164,134
0132-000,2015,3,10,6,163,143,306,164
0132-000,2015,3,10,7,391,438,829,306
0132-000,2015,3,10,8,679,1670,2349,829
0132-000,2015,3,10,9,841,1437,2278,2349
0132-000,2015,3,10,10,774,891,1665,2278
0132-000,2015,3,10,11,800,829,1629,1665
0132-000,2015,3,10,12,752,900,1652,1629
0132-000,2015,3,10,13,705,771,1476,1652
0132-000,2015,3,10,14,903,851,1754,1476
0132-000,2015,3,10,15,907,872,1779,1754
0132-000,2015,3,10,16,902,818,1720,1779
0132-000,2015,3,10,17,929,761,1690,1720
0132-000,2015,3,10,18,1116,873,1989,1690
0132-000,2015,3,10,19,1292,871,2163,1989
0132-000,2015,3,10,20,864,631,1495,2163
0132-000,2015,3,10,21,780,504,1284,1495
0132-000,2015,3,10,22,683,439,1122,1284
0132-000,2015,3,10,23,338,307,645,1122
0132-000,2015,3,10,24,232,173,405,645
0132-000,2015,3,11,1,151,128,279,405
0132-000,2015,3,11,2,98,115,213,279
0132-000,2015,3,11,3,84,92,176,213
0132-000,2015,3,11,4,68,86,154,176
0132-000,2015,3,11,5,84,100,184,154
0132-000,2015,3,11,6,177,157,334,184
0132-000,2015,3,11,7,392,491,883,334
0132-000,2015,3,11,8,676,1695,2371,883
0132-000,2015,3,11,9,869,1361,2230,2371
0132-000,2015,3,11,10,798,960,1758,2230
0132-000,2015,3,11,11,808,840,1648,1758
0132-000,2015,3,11,12,793,868,1661,1648
0132-000,2015,3,11,13,762,784,1546,1661
0132-000,2015,3,11,14,843,839,1682,1546
0132-000,2015,3,11,15,868,814,1682,1682
0132-000,2015,3,11,16,866,796,1662,1682
0132-000,2015,3,11,17,887,794,1681,1662
0132-000,2015,3,11,18,1245,701,1946,1681
0132-000,2015,3,11,19,1324,916,2240,1946
0132-000,2015,3,11,20,922,653,1575,2240
0132-000,2015,3,11,21,794,526,1320,1575
0132-000,2015,3,11,22,581,394,975,1320
0132-000,2015,3,11,23,355,324,679,975
0132-000,2015,3,11,24,235,200,435,679
0132-000,2015,3,12,1,164,164,328,435
0132-000,2015,3,12,2,98,82,180,328
0132-000,2015,3,12,3,73,101,174,180
0132-000,2015,3,12,4,66,85,151,174
0132-000,2015,3,12,5,71,104,175,151
0132-000,2015,3,12,6,183,166,349,175
0132-000,2015,3,12,7,396,460,856,349
0132-000,2015,3,12,8,718,1653,2371,856
0132-000,2015,3,12,9,867,1449,2316,2371
0132-000,2015,3,12,10,863,957,1820,2316
0132-000,2015,3,12,11,783,961,1744,1820
0132-000,2015,3,12,12,567,647,1214,1744
0132-000,2015,3,12,13,736,762,1498,1214
0132-000,2015,3,12,14,827,834,1661,1498
0132-000,2015,3,12,15,851,875,1726,1661
0132-000,2015,3,12,16,890,801,1691,1726
0132-000,2015,3,12,17,932,857,1789,1691
0132-000,2015,3,12,18,1173,885,2058,1789
0132-000,2015,3,12,19,1269,875,2144,2058
0132-000,2015,3,12,20,874,612,1486,2144
0132-000,2015,3,12,21,771,511,1282,1486
0132-000,2015,3,12,22,617,425,1042,1282
0132-000,2015,3,12,23,362,271,633,1042
0132-000,2015,3,12,24,187,216,403,633
0132-000,2015,3,13,1,185,152,337,403
0132-000,2015,3,13,2,127,117,244,337
0132-000,2015,3,13,3,85,95,180,244
0132-000,2015,3,13,4,68,85,153,180
0132-000,2015,3,13,5,84,102,186,153
0132-000,2015,3,13,6,164,138,302,186
0132-000,2015,3,13,7,388,453,841,302
0132-000,2015,3,13,8,702,1668,2370,841
0132-000,2015,3,13,9,857,1321,2178,2370
0132-000,2015,3,13,10,761,899,1660,2178
0132-000,2015,3,13,11,728,894,1622,1660
0132-000,2015,3,13,12,796,857,1653,1622
0132-000,2015,3,13,13,714,815,1529,1653
0132-000,2015,3,13,14,834,828,1662,1529
0132-000,2015,3,13,15,878,890,1768,1662
0132-000,2015,3,13,16,941,879,1820,1768
0132-000,2015,3,13,17,985,832,1817,1820
0132-000,2015,3,13,18,1323,920,2243,1817
0132-000,2015,3,13,19,1613,953,2566,2243
0132-000,2015,3,13,20,1006,734,1740,2566
0132-000,2015,3,13,21,790,551,1341,1740
0132-000,2015,3,13,22,602,468,1070,1341
0132-000,2015,3,13,23,381,336,717,1070
0132-000,2015,3,13,24,227,219,446,717
0132-000,2015,3,14,1,180,186,366,446
0132-000,2015,3,14,2,131,163,294,366
0132-000,2015,3,14,3,104,98,202,294
0132-000,2015,3,14,4,95,103,198,202
0132-000,2015,3,14,5,85,109,194,198
0132-000,2015,3,14,6,183,155,338,194
0132-000,2015,3,14,7,370,334,704,338
0132-000,2015,3,14,8,538,831,1369,704
0132-000,2015,3,14,9,682,909,1591,1369
0132-000,2015,3,14,10,746,1006,1752,1591
0132-000,2015,3,14,11,809,1025,1834,1752
0132-000,2015,3,14,12,870,1130,2000,1834
0132-000,2015,3,14,13,934,1079,2013,2000
0132-000,2015,3,14,14,949,964,1913,2013
0132-000,2015,3,14,15,935,950,1885,1913
0132-000,2015,3,14,16,1008,925,1933,1885
0132-000,2015,3,14,17,1211,985,2196,1933
0132-000,2015,3,14,18,1471,1000,2471,2196
0132-000,2015,3,14,19,1341,858,2199,2471
0132-000,2015,3,14,20,922,605,1527,2199
0132-000,2015,3,14,21,663,520,1183,1527
0132-000,2015,3,14,22,509,421,930,1183
0132-000,2015,3,14,23,357,315,672,930
0132-000,2015,3,14,24,211,215,426,672
0132-000,2015,3,15,1,181,164,345,426
0132-000,2015,3,15,2,109,127,236,345
0132-000,2015,3,15,3,71,90,161,236
0132-000,2015,3,15,4,73,73,146,161
0132-000,2015,3,15,5,77,72,149,146
0132-000,2015,3,15,6,113,111,224,149
0132-000,2015,3,15,7,218,175,393,224
0132-000,2015,3,15,8,275,348,623,393
0132-000,2015,3,15,9,373,442,815,623
0132-000,2015,3,15,10,470,582,1052,815
0132-000,2015,3,15,11,546,793,1339,1052
0132-000,2015,3,15,12,587,788,1375,1339
0132-000,2015,3,15,13,674,675,1349,1375
0132-000,2015,3,15,14,778,728,1506,1349
0132-000,2015,3,15,15,868,790,1658,1506
0132-000,2015,3,15,16,964,765,1729,1658
0132-000,2015,3,15,17,1097,785,1882,1729
0132-000,2015,3,15,18,1198,747,1945,1882
0132-000,2015,3,15,19,1145,670,1815,1945
0132-000,2015,3,15,20,902,470,1372,1815
0132-000,2015,3,15,21,686,404,1090,1372
0132-000,2015,3,15,22,460,376,836,1090
0132-000,2015,3,15,23,286,269,555,836
0132-000,2015,3,15,24,170,155,325,555
0132-000,2015,3,16,1,104,132,236,325
0132-000,2015,3,16,2,77,89,166,236
0132-000,2015,3,16,3,50,72,122,166
0132-000,2015,3,16,4,61,65,126,122
0132-000,2015,3,16,5,64,87,151,126
0132-000,2015,3,16,6,208,179,387,151
0132-000,2015,3,16,7,490,596,1086,387
0132-000,2015,3,16,8,724,1882,2606,1086
0132-000,2015,3,16,9,872,1420,2292,2606
0132-000,2015,3,16,10,762,947,1709,2292
0132-000,2015,3,16,11,754,869,1623,1709
0132-000,2015,3,16,12,782,877,1659,1623
0132-000,2015,3,16,13,724,782,1506,1659
0132-000,2015,3,16,14,907,862,1769,1506
0132-000,2015,3,16,15,926,871,1797,1769
0132-000,2015,3,16,16,929,868,1797,1797
0132-000,2015,3,16,17,946,857,1803,1797
0132-000,2015,3,16,18,1161,890,2051,1803
0132-000,2015,3,16,19,1380,900,2280,2051
0132-000,2015,3,16,20,1000,628,1628,2280
0132-000,2015,3,16,21,810,532,1342,1628
0132-000,2015,3,16,22,585,436,1021,1342
0132-000,2015,3,16,23,344,276,620,1021
0132-000,2015,3,16,24,195,177,372,620
0132-000,2015,3,17,1,156,125,281,372
0132-000,2015,3,17,2,111,104,215,281
0132-000,2015,3,17,3,81,96,177,215
0132-000,2015,3,17,4,86,85,171,177
0132-000,2015,3,17,5,60,87,147,171
0132-000,2015,3,17,6,174,164,338,147
0132-000,2015,3,17,7,415,518,933,338
0132-000,2015,3,17,8,712,1721,2433,933
0132-000,2015,3,17,9,842,1391,2233,2433
0132-000,2015,3,17,10,773,899,1672,2233
0132-000,2015,3,17,11,829,855,1684,1672
0132-000,2015,3,17,12,799,871,1670,1684
0132-000,2015,3,17,13,720,768,1488,1670
0132-000,2015,3,17,14,840,804,1644,1488
0132-000,2015,3,17,15,824,857,1681,1644
0132-000,2015,3,17,16,1004,865,1869,1681
0132-000,2015,3,17,17,946,819,1765,1869
0132-000,2015,3,17,18,1168,864,2032,1765
0132-000,2015,3,17,19,1305,847,2152,2032
0132-000,2015,3,17,20,909,609,1518,2152
0132-000,2015,3,17,21,729,514,1243,1518
0132-000,2015,3,17,22,576,422,998,1243
0132-000,2015,3,17,23,326,283,609,998
0132-000,2015,3,17,24,199,152,351,609
0132-000,2015,3,18,1,142,128,270,351
0132-000,2015,3,18,2,100,104,204,270
0132-000,2015,3,18,3,64,82,146,204
0132-000,2015,3,18,4,71,72,143,146
0132-000,2015,3,18,5,74,84,158,143
0132-000,2015,3,18,6,185,156,341,158
0132-000,2015,3,18,7,357,430,787,341
0132-000,2015,3,18,8,647,1622,2269,787
0132-000,2015,3,18,9,863,1383,2246,2269
0132-000,2015,3,18,10,738,921,1659,2246
0132-000,2015,3,18,11,827,821,1648,1659
0132-000,2015,3,18,12,768,828,1596,1648
0132-000,2015,3,18,13,701,747,1448,1596
0132-000,2015,3,18,14,824,813,1637,1448
0132-000,2015,3,18,15,797,755,1552,1637
0132-000,2015,3,18,16,904,765,1669,1552
0132-000,2015,3,18,17,854,773,1627,1669
0132-000,2015,3,18,18,1166,812,1978,1627
0132-000,2015,3,18,19,1309,841,2150,1978
0132-000,2015,3,18,20,822,572,1394,2150
0132-000,2015,3,18,21,713,515,1228,1394
0132-000,2015,3,18,22,521,387,908,1228
0132-000,2015,3,18,23,322,304,626,908
0132-000,2015,3,18,24,196,170,366,626
0132-000,2015,3,19,1,167,144,311,366
0132-000,2015,3,19,2,104,132,236,311
0132-000,2015,3,19,3,73,84,157,236
0132-000,2015,3,19,4,68,88,156,157
0132-000,2015,3,19,5,86,83,169,156
0132-000,2015,3,19,6,179,162,341,169
0132-000,2015,3,19,7,441,497,938,341
0132-000,2015,3,19,8,710,1703,2413,938
0132-000,2015,3,19,9,880,1424,2304,2413
0132-000,2015,3,19,10,801,890,1691,2304
0132-000,2015,3,19,11,790,837,1627,1691
0132-000,2015,3,19,12,855,868,1723,1627
0132-000,2015,3,19,13,729,770,1499,1723
0132-000,2015,3,19,14,820,852,1672,1499
0132-000,2015,3,19,15,885,862,1747,1672
0132-000,2015,3,19,16,906,852,1758,1747
0132-000,2015,3,19,17,950,834,1784,1758
0132-000,2015,3,19,18,1209,908,2117,1784
0132-000,2015,3,19,19,1319,919,2238,2117
0132-000,2015,3,19,20,952,665,1617,2238
0132-000,2015,3,19,21,769,529,1298,1617
0132-000,2015,3,19,22,661,482,1143,1298
0132-000,2015,3,19,23,334,331,665,1143
0132-000,2015,3,19,24,230,186,416,665
0132-000,2015,3,20,1,168,167,335,416
0132-000,2015,3,20,2,115,98,213,335
0132-000,2015,3,20,3,84,102,186,213
0132-000,2015,3,20,4,76,99,175,186
0132-000,2015,3,20,5,79,79,158,175
0132-000,2015,3,20,6,192,178,370,158
0132-000,2015,3,20,7,417,487,904,370
0132-000,2015,3,20,8,709,1687,2396,904
0132-000,2015,3,20,9,882,1410,2292,2396
0132-000,2015,3,20,10,759,949,1708,2292
0132-000,2015,3,20,11,801,889,1690,1708
0132-000,2015,3,20,12,828,918,1746,1690
0132-000,2015,3,20,13,800,840,1640,1746
0132-000,2015,3,20,14,919,867,1786,1640
0132-000,2015,3,20,15,882,841,1723,1786
0132-000,2015,3,20,16,853,928,1781,1723
0132-000,2015,3,20,17,1049,851,1900,1781
0132-000,2015,3,20,18,1427,996,2423,1900
0132-000,2015,3,20,19,1544,961,2505,2423
0132-000,2015,3,20,20,1062,732,1794,2505
0132-000,2015,3,20,21,829,654,1483,1794
0132-000,2015,3,20,22,669,519,1188,1483
0132-000,2015,3,20,23,404,350,754,1188
0132-000,2015,3,20,24,250,235,485,754
0132-000,2015,3,21,1,191,210,401,485
0132-000,2015,3,21,2,135,135,270,401
0132-000,2015,3,21,3,116,137,253,270
0132-000,2015,3,21,4,85,109,194,253
0132-000,2015,3,21,5,111,101,212,194
0132-000,2015,3,21,6,191,177,368,212
0132-000,2015,3,21,7,371,402,773,368
0132-000,2015,3,21,8,476,917,1393,773
0132-000,2015,3,21,9,727,962,1689,1393
0132-000,2015,3,21,10,763,1006,1769,1689
0132-000,2015,3,21,11,878,1041,1919,1769
0132-000,2015,3,21,12,856,1108,1964,1919
0132-000,2015,3,21,13,897,993,1890,1964
0132-000,2015,3,21,14,916,946,1862,1890
0132-000,2015,3,21,15,893,896,1789,1862
0132-000,2015,3,21,16,984,953,1937,1789
0132-000,2015,3,21,17,1219,912,2131,1937
0132-000,2015,3,21,18,1486,944,2430,2131
0132-000,2015,3,21,19,1321,968,2289,2430
0132-000,2015,3,21,20,895,641,1536,2289
0132-000,2015,3,21,21,602,464,1066,1536
0132-000,2015,3,21,22,503,403,906,1066
0132-000,2015,3,21,23,345,334,679,906
0132-000,2015,3,21,24,239,211,450,679
0132-000,2015,3,22,1,189,192,381,450
0132-000,2015,3,22,2,124,119,243,381
0132-000,2015,3,22,3,94,104,198,243
0132-000,2015,3,22,4,72,103,175,198
0132-000,2015,3,22,5,80,90,170,175
0132-000,2015,3,22,6,132,105,237,170
0132-000,2015,3,22,7,231,180,411,237
0132-000,2015,3,22,8,261,399,660,411
0132-000,2015,3,22,9,385,526,911,660
0132-000,2015,3,22,10,423,579,1002,911
0132-000,2015,3,22,11,592,639,1231,1002
0132-000,2015,3,22,12,546,690,1236,1231
0132-000,2015,3,22,13,678,628,1306,1236
0132-000,2015,3,22,14,688,713,1401,1306
0132-000,2015,3,22,15,812,724,1536,1401
0132-000,2015,3,22,16,961,717,1678,1536
0132-000,2015,3,22,17,1251,759,2010,1678
0132-000,2015,3,22,18,1310,687,1997,2010
0132-000,2015,3,22,19,1288,613,1901,1997
0132-000,2015,3,22,20,897,507,1404,1901
0132-000,2015,3,22,21,757,470,1227,1404
0132-000,2015,3,22,22,514,425,939,1227
0132-000,2015,3,22,23,291,263,554,939
0132-000,2015,3,22,24,154,147,301,554
0132-000,2015,3,23,1,114,115,229,301
0132-000,2015,3,23,2,52,66,118,229
0132-000,2015,3,23,3,47,58,105,118
0132-000,2015,3,23,4,42,60,102,105
0132-000,2015,3,23,5,57,88,145,102
0132-000,2015,3,23,6,178,170,348,145
0132-000,2015,3,23,7,468,608,1076,348
0132-000,2015,3,23,8,708,1859,2567,1076
0132-000,2015,3,23,9,830,1352,2182,2567
0132-000,2015,3,23,10,765,969,1734,2182
0132-000,2015,3,23,11,870,901,1771,1734
0132-000,2015,3,23,12,777,893,1670,1771
0132-000,2015,3,23,13,748,803,1551,1670
0132-000,2015,3,23,14,917,866,1783,1551
0132-000,2015,3,23,15,890,920,1810,1783
0132-000,2015,3,23,16,894,814,1708,1810
0132-000,2015,3,23,17,927,810,1737,1708
0132-000,2015,3,23,18,1112,886,1998,1737
0132-000,2015,3,23,19,1303,879,2182,1998
0132-000,2015,3,23,20,893,641,1534,2182
0132-000,2015,3,23,21,748,539,1287,1534
0132-000,2015,3,23,22,587,391,978,1287
0132-000,2015,3,23,23,357,275,632,978
0132-000,2015,3,23,24,186,180,366,632
0132-000,2015,3,24,1,159,135,294,366
0132-000,2015,3,24,2,81,92,173,294
0132-000,2015,3,24,3,68,85,153,173
0132-000,2015,3,24,4,74,85,159,153
0132-000,2015,3,24,5,75,89,164,159
0132-000,2015,3,24,6,191,174,365,164
0132-000,2015,3,24,7,447,523,970,365
0132-000,2015,3,24,8,689,1752,2441,970
0132-000,2015,3,24,9,874,1379,2253,2441
0132-000,2015,3,24,10,825,923,1748,2253
0132-000,2015,3,24,11,755,840,1595,1748
0132-000,2015,3,24,12,754,864,1618,1595
0132-000,2015,3,24,13,713,819,1532,1618
0132-000,2015,3,24,14,837,915,1752,1532
0132-000,2015,3,24,15,874,825,1699,1752
0132-000,2015,3,24,16,871,804,1675,1699
0132-000,2015,3,24,17,984,822,1806,1675
0132-000,2015,3,24,18,1159,854,2013,1806
0132-000,2015,3,24,19,1326,886,2212,2013
0132-000,2015,3,24,20,921,679,1600,2212
0132-000,2015,3,24,21,763,513,1276,1600
0132-000,2015,3,24,22,594,466,1060,1276
0132-000,2015,3,24,23,364,298,662,1060
0132-000,2015,3,24,24,201,196,397,662
0132-000,2015,3,25,1,128,158,286,397
0132-000,2015,3,25,2,109,94,203,286
0132-000,2015,3,25,3,63,75,138,203
0132-000,2015,3,25,4,66,87,153,138
0132-000,2015,3,25,5,63,74,137,153
0132-000,2015,3,25,6,188,165,353,137
0132-000,2015,3,25,7,435,542,977,353
0132-000,2015,3,25,8,715,1680,2395,977
0132-000,2015,3,25,9,855,1290,2145,2395
0132-000,2015,3,25,10,779,927,1706,2145
0132-000,2015,3,25,11,761,906,1667,1706
0132-000,2015,3,25,12,828,846,1674,1667
0132-000,2015,3,25,13,734,825,1559,1674
0132-000,2015,3,25,14,861,790,1651,1559
0132-000,2015,3,25,15,918,875,1793,1651
0132-000,2015,3,25,16,948,834,1782,1793
0132-000,2015,3,25,17,931,830,1761,1782
0132-000,2015,3,25,18,1213,888,2101,1761
0132-000,2015,3,25,19,1371,874,2245,2101
0132-000,2015,3,25,20,900,682,1582,2245
0132-000,2015,3,25,21,741,526,1267,1582
0132-000,2015,3,25,22,608,441,1049,1267
0132-000,2015,3,25,23,345,297,642,1049
0132-000,2015,3,25,24,217,210,427,642
0132-000,2015,3,26,1,189,172,361,427
0132-000,2015,3,26,2,97,120,217,361
0132-000,2015,3,26,3,85,91,176,217
0132-000,2015,3,26,4,72,88,160,176
0132-000,2015,3,26,5,77,89,166,160
0132-000,2015,3,26,6,194,181,375,166
0132-000,2015,3,26,7,422,519,941,375
0132-000,2015,3,26,8,718,1732,2450,941
0132-000,2015,3,26,9,869,1364,2233,2450
0132-000,2015,3,26,10,806,925,1731,2233
0132-000,2015,3,26,11,761,883,1644,1731
0132-000,2015,3,26,12,727,844,1571,1644
0132-000,2015,3,26,13,767,770,1537,1571
0132-000,2015,3,26,14,850,836,1686,1537
0132-000,2015,3,26,15,906,927,1833,1686
0132-000,2015,3,26,16,985,827,1812,1833
0132-000,2015,3,26,17,964,874,1838,1812
0132-000,2015,3,26,18,1241,899,2140,1838
0132-000,2015,3,26,19,1359,905,2264,2140
0132-000,2015,3,26,20,997,687,1684,2264
0132-000,2015,3,26,21,743,516,1259,1684
0132-000,2015,3,26,22,610,437,1047,1259
0132-000,2015,3,26,23,384,334,718,1047
0132-000,2015,3,26,24,234,186,420,718
0132-000,2015,3,27,1,176,167,343,420
0132-000,2015,3,27,2,112,104,216,343
0132-000,2015,3,27,3,71,105,176,216
0132-000,2015,3,27,4,78,81,159,176
0132-000,2015,3,27,5,84,91,175,159
0132-000,2015,3,27,6,179,177,356,175
0132-000,2015,3,27,7,442,525,967,356
0132-000,2015,3,27,8,706,1692,2398,967
0132-000,2015,3,27,9,912,1343,2255,2398
0132-000,2015,3,27,10,798,944,1742,2255
0132-000,2015,3,27,11,829,851,1680,1742
0132-000,2015,3,27,12,776,845,1621,1680
0132-000,2015,3,27,13,758,733,1491,1621
0132-000,2015,3,27,14,852,840,1692,1491
0132-000,2015,3,27,15,902,882,1784,1692
0132-000,2015,3,27,16,985,887,1872,1784
0132-000,2015,3,27,17,947,921,1868,1872
0132-000,2015,3,27,18,1354,1005,2359,1868
0132-000,2015,3,27,19,1538,915,2453,2359
0132-000,2015,3,27,20,1084,832,1916,2453
0132-000,2015,3,27,21,825,568,1393,1916
0132-000,2015,3,27,22,623,469,1092,1393
0132-000,2015,3,27,23,410,332,742,1092
0132-000,2015,3,27,24,257,236,493,742
0132-000,2015,3,28,1,206,196,402,493
0132-000,2015,3,28,2,133,140,273,402
0132-000,2015,3,28,3,117,104,221,273
0132-000,2015,3,28,4,94,111,205,221
0132-000,2015,3,28,5,88,106,194,205
0132-000,2015,3,28,6,172,175,347,194
0132-000,2015,3,28,7,356,377,733,347
0132-000,2015,3,28,8,546,819,1365,733
0132-000,2015,3,28,9,705,934,1639,1365
0132-000,2015,3,28,10,781,1011,1792,1639
0132-000,2015,3,28,11,801,1220,2021,1792
0132-000,2015,3,28,12,889,1522,2411,2021
0132-000,2015,3,28,13,878,1329,2207,2411
0132-000,2015,3,28,14,922,1158,2080,2207
0132-000,2015,3,28,15,936,1020,1956,2080
0132-000,2015,3,28,16,1058,972,2030,1956
0132-000,2015,3,28,17,1218,945,2163,2030
0132-000,2015,3,28,18,1428,942,2370,2163
0132-000,2015,3,28,19,1366,843,2209,2370
0132-000,2015,3,28,20,1026,634,1660,2209
0132-000,2015,3,28,21,679,504,1183,1660
0132-000,2015,3,28,22,619,424,1043,1183
0132-000,2015,3,28,23,349,333,682,1043
0132-000,2015,3,28,24,205,238,443,682
0132-000,2015,3,29,1,188,192,380,443
0132-000,2015,3,29,2,124,130,254,380
0132-000,2015,3,29,3,96,90,186,254
0132-000,2015,3,29,4,82,70,152,186
0132-000,2015,3,29,5,93,92,185,152
0132-000,2015,3,29,6,116,110,226,185
0132-000,2015,3,29,7,218,172,390,226
0132-000,2015,3,29,8,266,328,594,390
0132-000,2015,3,29,9,389,475,864,594
0132-000,2015,3,29,10,463,611,1074,864
0132-000,2015,3,29,11,576,683,1259,1074
0132-000,2015,3,29,12,607,702,1309,1259
0132-000,2015,3,29,13,708,629,1337,1309
0132-000,2015,3,29,14,726,757,1483,1337
0132-000,2015,3,29,15,907,706,1613,1483
0132-000,2015,3,29,16,1021,759,1780,1613
0132-000,2015,3,29,17,1211,748,1959,1780
0132-000,2015,3,29,18,1249,784,2033,1959
0132-000,2015,3,29,19,1281,612,1893,2033
0132-000,2015,3,29,20,1025,608,1633,1893
0132-000,2015,3,29,21,825,420,1245,1633
0132-000,2015,3,29,22,557,439,996,1245
0132-000,2015,3,29,23,333,291,624,996
0132-000,2015,3,29,24,200,179,379,624
0132-000,2015,3,30,1,85,125,210,379
0132-000,2015,3,30,2,53,77,130,210
0132-000,2015,3,30,3,40,47,87,130
0132-000,2015,3,30,4,54,63,117,87
0132-000,2015,3,30,5,76,83,159,117
0132-000,2015,3,30,6,211,183,394,159
0132-000,2015,3,30,7,453,621,1074,394
0132-000,2015,3,30,8,709,1836,2545,1074
0132-000,2015,3,30,9,890,1453,2343,2545
0132-000,2015,3,30,10,742,900,1642,2343
0132-000,2015,3,30,11,829,874,1703,1642
0132-000,2015,3,30,12,749,853,1602,1703
0132-000,2015,3,30,13,742,752,1494,1602
0132-000,2015,3,30,14,844,807,1651,1494
0132-000,2015,3,30,15,893,868,1761,1651
0132-000,2015,3,30,16,919,872,1791,1761
0132-000,2015,3,30,17,916,866,1782,1791
0132-000,2015,3,30,18,1197,884,2081,1782
0132-000,2015,3,30,19,1355,856,2211,2081
0132-000,2015,3,30,20,1000,694,1694,2211
0132-000,2015,3,30,21,832,542,1374,1694
0132-000,2015,3,30,22,541,449,990,1374
0132-000,2015,3,30,23,339,289,628,990
0132-000,2015,3,30,24,214,181,395,628
0132-000,2015,3,31,1,158,155,313,395
0132-000,2015,3,31,2,111,96,207,313
0132-000,2015,3,31,3,65,89,154,207
0132-000,2015,3,31,4,73,76,149,154
0132-000,2015,3,31,5,76,103,179,149
0132-000,2015,3,31,6,181,170,351,179
0132-000,2015,3,31,7,408,504,912,351
0132-000,2015,3,31,8,681,1704,2385,912
0132-000,2015,3,31,9,880,1372,2252,2385
0132-000,2015,3,31,10,786,922,1708,2252
0132-000,2015,3,31,11,797,843,1640,1708
0132-000,2015,3,31,12,822,847,1669,1640
0132-000,2015,3,31,13,723,772,1495,1669
0132-000,2015,3,31,14,872,819,1691,1495
0132-000,2015,3,31,15,869,862,1731,1691
0132-000,2015,3,31,16,946,813,1759,1731
0132-000,2015,3,31,17,955,807,1762,1759
0132-000,2015,3,31,18,1160,874,2034,1762
0132-000,2015,3,31,19,1322,765,2087,2034
0132-000,2015,3,31,20,857,603,1460,2087
0132-000,2015,3,31,21,729,499,1228,1460
0132-000,2015,3,31,22,525,422,947,1228
0132-000,2015,3,31,23,324,301,625,947
0132-000,2015,3,31,24,206,181,387,625
0132-000,2015,4,1,1,156,132,288,387
0132-000,2015,4,1,2,110,95,205,288
0132-000,2015,4,1,3,54,81,135,205
0132-000,2015,4,1,4,77,86,163,135
0132-000,2015,4,1,5,80,94,174,163
0132-000,2015,4,1,6,178,174,352,174
0132-000,2015,4,1,7,405,505,910,352
0132-000,2015,4,1,8,652,1666,2318,910
0132-000,2015,4,1,9,848,1327,2175,2318
0132-000,2015,4,1,10,783,1003,1786,2175
0132-000,2015,4,1,11,826,846,1672,1786
0132-000,2015,4,1,12,801,872,1673,1672
0132-000,2015,4,1,13,769,832,1601,1673
0132-000,2015,4,1,14,855,823,1678,1601
0132-000,2015,4,1,15,859,858,1717,1678
0132-000,2015,4,1,16,976,807,1783,1717
0132-000,2015,4,1,17,919,818,1737,1783
0132-000,2015,4,1,18,1232,914,2146,1737
0132-000,2015,4,1,19,1372,838,2210,2146
0132-000,2015,4,1,20,949,673,1622,2210
0132-000,2015,4,1,21,761,540,1301,1622
0132-000,2015,4,1,22,559,411,970,1301
0132-000,2015,4,1,23,317,322,639,970
0132-000,2015,4,1,24,210,206,416,639
0132-000,2015,4,2,1,165,114,279,416
0132-000,2015,4,2,2,92,119,211,279
0132-000,2015,4,2,3,72,88,160,211
0132-000,2015,4,2,4,75,83,158,160
0132-000,2015,4,2,5,90,97,187,158
0132-000,2015,4,2,6,199,189,388,187
0132-000,2015,4,2,7,425,524,949,388
0132-000,2015,4,2,8,693,1741,2434,949
0132-000,2015,4,2,9,836,1366,2202,2434
0132-000,2015,4,2,10,735,906,1641,2202
0132-000,2015,4,2,11,801,942,1743,1641
0132-000,2015,4,2,12,814,890,1704,1743
0132-000,2015,4,2,13,725,752,1477,1704
0132-000,2015,4,2,14,813,808,1621,1477
0132-000,2015,4,2,15,896,824,1720,1621
0132-000,2015,4,2,16,932,862,1794,1720
0132-000,2015,4,2,17,960,828,1788,1794
0132-000,2015,4,2,18,1217,905,2122,1788
0132-000,2015,4,2,19,1317,773,2090,2122
0132-000,2015,4,2,20,880,587,1467,2090
0132-000,2015,4,2,21,767,490,1257,1467
0132-000,2015,4,2,22,563,398,961,1257
0132-000,2015,4,2,23,263,224,487,961
0132-000,2015,4,2,24,0,0,0,487
0132-000,2015,4,3,1,170,162,332,0
0132-000,2015,4,3,2,112,103,215,332
0132-000,2015,4,3,3,70,90,160,215
0132-000,2015,4,3,4,71,76,147,160
0132-000,2015,4,3,5,80,90,170,147
0132-000,2015,4,3,6,181,170,351,170
0132-000,2015,4,3,7,452,498,950,351
0132-000,2015,4,3,8,702,1668,2370,950
0132-000,2015,4,3,9,692,958,1650,2370
0132-000,2015,4,3,10,769,861,1630,1650
0132-000,2015,4,3,11,764,893,1657,1630
0132-000,2015,4,3,12,772,865,1637,1657
0132-000,2015,4,3,13,754,797,1551,1637
0132-000,2015,4,3,14,885,837,1722,1551
0132-000,2015,4,3,15,852,845,1697,1722
0132-000,2015,4,3,16,978,872,1850,1697
0132-000,2015,4,3,17,953,841,1794,1850
0132-000,2015,4,3,18,1323,896,2219,1794
0132-000,2015,4,3,19,1555,890,2445,2219
0132-000,2015,4,3,20,1093,740,1833,2445
0132-000,2015,4,3,21,787,655,1442,1833
0132-000,2015,4,3,22,659,494,1153,1442
0132-000,2015,4,3,23,405,339,744,1153
0132-000,2015,4,3,24,236,206,442,744
0132-000,2015,4,4,1,182,206,388,442
0132-000,2015,4,4,2,150,140,290,388
0132-000,2015,4,4,3,88,91,179,290
0132-000,2015,4,4,4,87,104,191,179
0132-000,2015,4,4,5,108,113,221,191
0132-000,2015,4,4,6,167,182,349,221
0132-000,2015,4,4,7,353,345,698,349
0132-000,2015,4,4,8,491,804,1295,698
0132-000,2015,4,4,9,659,1091,1750,1295
0132-000,2015,4,4,10,702,1203,1905,1750
0132-000,2015,4,4,11,869,1351,2220,1905
0132-000,2015,4,4,12,929,1336,2265,2220
0132-000,2015,4,4,13,899,1235,2134,2265
0132-000,2015,4,4,14,912,1145,2057,2134
0132-000,2015,4,4,15,953,1083,2036,2057
0132-000,2015,4,4,16,985,942,1927,2036
0132-000,2015,4,4,17,1000,919,1919,1927
0132-000,2015,4,4,18,1495,918,2413,1919
0132-000,2015,4,4,19,1412,787,2199,2413
0132-000,2015,4,4,20,1091,578,1669,2199
0132-000,2015,4,4,21,781,479,1260,1669
0132-000,2015,4,4,22,494,407,901,1260
0132-000,2015,4,4,23,321,283,604,901
0132-000,2015,4,4,24,226,232,458,604
0132-000,2015,4,5,1,149,185,334,458
0132-000,2015,4,5,2,122,111,233,334
0132-000,2015,4,5,3,85,87,172,233
0132-000,2015,4,5,4,64,74,138,172
0132-000,2015,4,5,5,70,64,134,138
0132-000,2015,4,5,6,112,102,214,134
0132-000,2015,4,5,7,198,208,406,214
0132-000,2015,4,5,8,225,353,578,406
0132-000,2015,4,5,9,342,499,841,578
0132-000,2015,4,5,10,459,637,1096,841
0132-000,2015,4,5,11,516,663,1179,1096
0132-000,2015,4,5,12,591,660,1251,1179
0132-000,2015,4,5,13,811,664,1475,1251
0132-000,2015,4,5,14,907,737,1644,1475
0132-000,2015,4,5,15,1067,770,1837,1644
0132-000,2015,4,5,16,1363,708,2071,1837
0132-000,2015,4,5,17,1773,702,2475,2071
0132-000,2015,4,5,18,1686,653,2339,2475
0132-000,2015,4,5,19,1801,558,2359,2339
0132-000,2015,4,5,20,1823,527,2350,2359
0132-000,2015,4,5,21,1174,463,1637,2350
0132-000,2015,4,5,22,1109,371,1480,1637
0132-000,2015,4,5,23,649,313,962,1480
0132-000,2015,4,5,24,290,197,487,962
0132-000,2015,4,6,1,136,139,275,487
0132-000,2015,4,6,2,74,75,149,275
0132-000,2015,4,6,3,44,66,110,149
0132-000,2015,4,6,4,52,59,111,110
0132-000,2015,4,6,5,78,78,156,111
0132-000,2015,4,6,6,191,167,358,156
0132-000,2015,4,6,7,454,586,1040,358
0132-000,2015,4,6,8,679,1752,2431,1040
0132-000,2015,4,6,9,821,1498,2319,2431
0132-000,2015,4,6,10,757,935,1692,2319
0132-000,2015,4,6,11,760,931,1691,1692
0132-000,2015,4,6,12,849,816,1665,1691
0132-000,2015,4,6,13,766,810,1576,1665
0132-000,2015,4,6,14,835,832,1667,1576
0132-000,2015,4,6,15,849,902,1751,1667
0132-000,2015,4,6,16,929,811,1740,1751
0132-000,2015,4,6,17,915,830,1745,1740
0132-000,2015,4,6,18,1167,897,2064,1745
0132-000,2015,4,6,19,1349,856,2205,2064
0132-000,2015,4,6,20,961,704,1665,2205
0132-000,2015,4,6,21,784,501,1285,1665
0132-000,2015,4,6,22,549,403,952,1285
0132-000,2015,4,6,23,346,285,631,952
0132-000,2015,4,6,24,211,176,387,631
0132-000,2015,4,7,1,157,134,291,387
0132-000,2015,4,7,2,110,110,220,291
0132-000,2015,4,7,3,82,72,154,220
0132-000,2015,4,7,4,56,74,130,154
0132-000,2015,4,7,5,61,97,158,130
0132-000,2015,4,7,6,179,149,328,158
0132-000,2015,4,7,7,477,472,949,328
0132-000,2015,4,7,8,632,1692,2324,949
0132-000,2015,4,7,9,837,1415,2252,2324
0132-000,2015,4,7,10,803,886,1689,2252
0132-000,2015,4,7,11,774,909,1683,1689
0132-000,2015,4,7,12,794,813,1607,1683
0132-000,2015,4,7,13,732,769,1501,1607
0132-000,2015,4,7,14,813,858,1671,1501
0132-000,2015,4,7,15,833,837,1670,1671
0132-000,2015,4,7,16,874,796,1670,1670
0132-000,2015,4,7,17,959,791,1750,1670
0132-000,2015,4,7,18,1112,902,2014,1750
0132-000,2015,4,7,19,1294,860,2154,2014
0132-000,2015,4,7,20,963,628,1591,2154
0132-000,2015,4,7,21,762,539,1301,1591
0132-000,2015,4,7,22,579,407,986,1301
0132-000,2015,4,7,23,389,327,716,986
0132-000,2015,4,7,24,201,201,402,716
0132-000,2015,4,8,1,153,159,312,402
0132-000,2015,4,8,2,85,106,191,312
0132-000,2015,4,8,3,80,75,155,191
0132-000,2015,4,8,4,74,72,146,155
0132-000,2015,4,8,5,64,84,148,146
0132-000,2015,4,8,6,191,152,343,148
0132-000,2015,4,8,7,451,467,918,343
0132-000,2015,4,8,8,692,1647,2339,918
0132-000,2015,4,8,9,828,1440,2268,2339
0132-000,2015,4,8,10,748,861,1609,2268
0132-000,2015,4,8,11,760,833,1593,1609
0132-000,2015,4,8,12,722,829,1551,1593
0132-000,2015,4,8,13,741,808,1549,1551
0132-000,2015,4,8,14,855,802,1657,1549
0132-000,2015,4,8,15,835,823,1658,1657
0132-000,2015,4,8,16,853,792,1645,1658
0132-000,2015,4,8,17,857,822,1679,1645
0132-000,2015,4,8,18,1296,928,2224,1679
0132-000,2015,4,8,19,1357,833,2190,2224
0132-000,2015,4,8,20,896,701,1597,2190
0132-000,2015,4,8,21,800,522,1322,1597
0132-000,2015,4,8,22,526,444,970,1322
0132-000,2015,4,8,23,371,319,690,970
0132-000,2015,4,8,24,210,176,386,690
0132-000,2015,4,9,1,172,153,325,386
0132-000,2015,4,9,2,100,123,223,325
0132-000,2015,4,9,3,63,69,132,223
0132-000,2015,4,9,4,63,83,146,132
0132-000,2015,4,9,5,90,89,179,146
0132-000,2015,4,9,6,162,147,309,179
0132-000,2015,4,9,7,471,461,932,309
0132-000,2015,4,9,8,662,1682,2344,932
0132-000,2015,4,9,9,870,1416,2286,2344
0132-000,2015,4,9,10,744,902,1646,2286
0132-000,2015,4,9,11,755,835,1590,1646
0132-000,2015,4,9,12,797,824,1621,1590
0132-000,2015,4,9,13,738,747,1485,1621
0132-000,2015,4,9,14,740,829,1569,1485
0132-000,2015,4,9,15,868,768,1636,1569
0132-000,2015,4,9,16,874,777,1651,1636
0132-000,2015,4,9,17,960,838,1798,1651
0132-000,2015,4,9,18,1207,953,2160,1798
0132-000,2015,4,9,19,1367,827,2194,2160
0132-000,2015,4,9,20,928,668,1596,2194
0132-000,2015,4,9,21,812,558,1370,1596
0132-000,2015,4,9,22,644,453,1097,1370
0132-000,2015,4,9,23,381,325,706,1097
0132-000,2015,4,9,24,224,210,434,706
0132-000,2015,4,10,1,165,156,321,434
0132-000,2015,4,10,2,112,102,214,321
0132-000,2015,4,10,3,68,74,142,214
0132-000,2015,4,10,4,64,72,136,142
0132-000,2015,4,10,5,75,88,163,136
0132-000,2015,4,10,6,183,164,347,163
0132-000,2015,4,10,7,461,472,933,347
0132-000,2015,4,10,8,699,1643,2342,933
0132-000,2015,4,10,9,845,1386,2231,2342
0132-000,2015,4,10,10,763,862,1625,2231
0132-000,2015,4,10,11,802,906,1708,1625
0132-000,2015,4,10,12,830,933,1763,1708
0132-000,2015,4,10,13,796,868,1664,1763
0132-000,2015,4,10,14,853,832,1685,1664
0132-000,2015,4,10,15,922,882,1804,1685
0132-000,2015,4,10,16,970,866,1836,1804
0132-000,2015,4,10,17,1016,865,1881,1836
0132-000,2015,4,10,18,1327,1005,2332,1881
0132-000,2015,4,10,19,1593,954,2547,2332
0132-000,2015,4,10,20,1224,798,2022,2547
0132-000,2015,4,10,21,843,630,1473,2022
0132-000,2015,4,10,22,683,520,1203,1473
0132-000,2015,4,10,23,452,370,822,1203
0132-000,2015,4,10,24,272,264,536,822
0132-000,2015,4,11,1,209,211,420,536
0132-000,2015,4,11,2,148,150,298,420
0132-000,2015,4,11,3,120,104,224,298
0132-000,2015,4,11,4,99,128,227,224
0132-000,2015,4,11,5,89,127,216,227
0132-000,2015,4,11,6,175,160,335,216
0132-000,2015,4,11,7,378,373,751,335
0132-000,2015,4,11,8,505,762,1267,751
0132-000,2015,4,11,9,639,994,1633,1267
0132-000,2015,4,11,10,688,1121,1809,1633
0132-000,2015,4,11,11,779,1185,1964,1809
0132-000,2015,4,11,12,841,1341,2182,1964
0132-000,2015,4,11,13,906,1381,2287,2182
0132-000,2015,4,11,14,864,1236,2100,2287
0132-000,2015,4,11,15,929,1216,2145,2100
0132-000,2015,4,11,16,1016,1060,2076,2145
0132-000,2015,4,11,17,1187,922,2109,2076
0132-000,2015,4,11,18,1457,1039,2496,2109
0132-000,2015,4,11,19,1432,857,2289,2496
0132-000,2015,4,11,20,1152,639,1791,2289
0132-000,2015,4,11,21,827,516,1343,1791
0132-000,2015,4,11,22,709,427,1136,1343
0132-000,2015,4,11,23,409,364,773,1136
0132-000,2015,4,11,24,287,263,550,773
0132-000,2015,4,12,1,225,209,434,550
0132-000,2015,4,12,2,139,108,247,434
0132-000,2015,4,12,3,96,112,208,247
0132-000,2015,4,12,4,96,91,187,208
0132-000,2015,4,12,5,78,84,162,187
0132-000,2015,4,12,6,108,119,227,162
0132-000,2015,4,12,7,222,213,435,227
0132-000,2015,4,12,8,265,358,623,435
0132-000,2015,4,12,9,362,514,876,623
0132-000,2015,4,12,10,485,611,1096,876
0132-000,2015,4,12,11,542,680,1222,1096
0132-000,2015,4,12,12,590,703,1293,1222
0132-000,2015,4,12,13,645,668,1313,1293
0132-000,2015,4,12,14,658,675,1333,1313
0132-000,2015,4,12,15,860,711,1571,1333
0132-000,2015,4,12,16,1088,712,1800,1571
0132-000,2015,4,12,17,1197,642,1839,1800
0132-000,2015,4,12,18,1435,611,2046,1839
0132-000,2015,4,12,19,1448,589,2037,2046
0132-000,2015,4,12,20,1298,512,1810,2037
0132-000,2015,4,12,21,1054,473,1527,1810
0132-000,2015,4,12,22,720,373,1093,1527
0132-000,2015,4,12,23,509,274,783,1093
0132-000,2015,4,12,24,194,164,358,783
0132-000,2015,4,13,1,116,140,256,358
0132-000,2015,4,13,2,67,74,141,256
0132-000,2015,4,13,3,62,67,129,141
0132-000,2015,4,13,4,43,74,117,129
0132-000,2015,4,13,5,69,72,141,117
0132-000,2015,4,13,6,206,162,368,141
0132-000,2015,4,13,7,496,615,1111,368
0132-000,2015,4,13,8,680,1828,2508,1111
0132-000,2015,4,13,9,840,1447,2287,2508
0132-000,2015,4,13,10,782,920,1702,2287
0132-000,2015,4,13,11,790,905,1695,1702
0132-000,2015,4,13,12,786,833,1619,1695
0132-000,2015,4,13,13,780,839,1619,1619
0132-000,2015,4,13,14,860,823,1683,1619
0132-000,2015,4,13,15,868,864,1732,1683
0132-000,2015,4,13,16,941,825,1766,1732
0132-000,2015,4,13,17,890,821,1711,1766
0132-000,2015,4,13,18,1171,908,2079,1711
0132-000,2015,4,13,19,1331,826,2157,2079
0132-000,2015,4,13,20,926,620,1546,2157
0132-000,2015,4,13,21,771,502,1273,1546
0132-000,2015,4,13,22,581,437,1018,1273
0132-000,2015,4,13,23,347,284,631,1018
0132-000,2015,4,13,24,209,186,395,631
0132-000,2015,4,14,1,145,131,276,395
0132-000,2015,4,14,2,81,92,173,276
0132-000,2015,4,14,3,69,70,139,173
0132-000,2015,4,14,4,59,76,135,139
0132-000,2015,4,14,5,65,64,129,135
0132-000,2015,4,14,6,120,125,245,129
0132-000,2015,4,14,7,376,444,820,245
0132-000,2015,4,14,8,581,1607,2188,820
0132-000,2015,4,14,9,782,1376,2158,2188
0132-000,2015,4,14,10,778,807,1585,2158
0132-000,2015,4,14,11,755,917,1672,1585
0132-000,2015,4,14,12,816,776,1592,1672
0132-000,2015,4,14,13,700,749,1449,1592
0132-000,2015,4,14,14,817,793,1610,1449
0132-000,2015,4,14,15,799,849,1648,1610
0132-000,2015,4,14,16,876,809,1685,1648
0132-000,2015,4,14,17,865,762,1627,1685
0132-000,2015,4,14,18,1125,835,1960,1627
0132-000,2015,4,14,19,1236,799,2035,1960
0132-000,2015,4,14,20,893,612,1505,2035
0132-000,2015,4,14,21,706,494,1200,1505
0132-000,2015,4,14,22,598,413,1011,1200
0132-000,2015,4,14,23,369,323,692,1011
0132-000,2015,4,14,24,215,215,430,692
0132-000,2015,4,15,1,158,172,330,430
0132-000,2015,4,15,2,90,96,186,330
0132-000,2015,4,15,3,74,63,137,186
0132-000,2015,4,15,4,70,76,146,137
0132-000,2015,4,15,5,74,72,146,146
0132-000,2015,4,15,6,198,162,360,146
0132-000,2015,4,15,7,440,510,950,360
0132-000,2015,4,15,8,681,1680,2361,950
0132-000,2015,4,15,9,873,1440,2313,2361
0132-000,2015,4,15,10,806,893,1699,2313
0132-000,2015,4,15,11,735,861,1596,1699
0132-000,2015,4,15,12,868,851,1719,1596
0132-000,2015,4,15,13,813,800,1613,1719
0132-000,2015,4,15,14,819,856,1675,1613
0132-000,2015,4,15,15,897,842,1739,1675
0132-000,2015,4,15,16,725,767,1492,1739
0132-000,2015,4,15,17,995,891,1886,1492
0132-000,2015,4,15,18,1236,928,2164,1886
0132-000,2015,4,15,19,1416,849,2265,2164
0132-000,2015,4,15,20,938,652,1590,2265
0132-000,2015,4,15,21,786,544,1330,1590
0132-000,2015,4,15,22,562,431,993,1330
0132-000,2015,4,15,23,393,342,735,993
0132-000,2015,4,15,24,230,237,467,735
0132-000,2015,4,16,1,193,182,375,467
0132-000,2015,4,16,2,116,95,211,375
0132-000,2015,4,16,3,64,90,154,211
0132-000,2015,4,16,4,76,83,159,154
0132-000,2015,4,16,5,94,88,182,159
0132-000,2015,4,16,6,185,156,341,182
0132-000,2015,4,16,7,471,518,989,341
0132-000,2015,4,16,8,646,1724,2370,989
0132-000,2015,4,16,9,860,1414,2274,2370
0132-000,2015,4,16,10,771,937,1708,2274
0132-000,2015,4,16,11,796,884,1680,1708
0132-000,2015,4,16,12,809,825,1634,1680
0132-000,2015,4,16,13,763,782,1545,1634
0132-000,2015,4,16,14,897,837,1734,1545
0132-000,2015,4,16,15,838,800,1638,1734
0132-000,2015,4,16,16,912,800,1712,1638
0132-000,2015,4,16,17,917,766,1683,1712
0132-000,2015,4,16,18,1072,866,1938,1683
0132-000,2015,4,16,19,1270,804,2074,1938
0132-000,2015,4,16,20,955,650,1605,2074
0132-000,2015,4,16,21,787,488,1275,1605
0132-000,2015,4,16,22,586,408,994,1275
0132-000,2015,4,16,23,357,314,671,994
0132-000,2015,4,16,24,239,205,444,671
0132-000,2015,4,17,1,156,136,292,444
0132-000,2015,4,17,2,105,109,214,292
0132-000,2015,4,17,3,68,93,161,214
0132-000,2015,4,17,4,80,81,161,161
0132-000,2015,4,17,5,69,101,170,161
0132-000,2015,4,17,6,208,156,364,170
0132-000,2015,4,17,7,511,537,1048,364
0132-000,2015,4,17,8,678,1696,2374,1048
0132-000,2015,4,17,9,838,1380,2218,2374
0132-000,2015,4,17,10,827,940,1767,2218
0132-000,2015,4,17,11,808,853,1661,1767
0132-000,2015,4,17,12,782,879,1661,1661
0132-000,2015,4,17,13,729,821,1550,1661
0132-000,2015,4,17,14,858,794,1652,1550
0132-000,2015,4,17,15,915,864,1779,1652
0132-000,2015,4,17,16,967,886,1853,1779
0132-000,2015,4,17,17,969,898,1867,1853
0132-000,2015,4,17,18,1387,1036,2423,1867
0132-000,2015,4,17,19,1602,983,2585,2423
0132-000,2015,4,17,20,1105,816,1921,2585
0132-000,2015,4,17,21,848,640,1488,1921
0132-000,2015,4,17,22,664,496,1160,1488
0132-000,2015,4,17,23,430,361,791,1160
0132-000,2015,4,17,24,248,265,513,791
0132-000,2015,4,18,1,185,203,388,513
0132-000,2015,4,18,2,149,136,285,388
0132-000,2015,4,18,3,108,108,216,285
0132-000,2015,4,18,4,94,114,208,216
0132-000,2015,4,18,5,120,103,223,208
0132-000,2015,4,18,6,196,179,375,223
0132-000,2015,4,18,7,424,383,807,375
0132-000,2015,4,18,8,525,877,1402,807
0132-000,2015,4,18,9,715,1053,1768,1402
0132-000,2015,4,18,10,782,960,1742,1768
0132-000,2015,4,18,11,838,1240,2078,1742
0132-000,2015,4,18,12,892,1172,2064,2078
0132-000,2015,4,18,13,855,1125,1980,2064
0132-000,2015,4,18,14,859,959,1818,1980
0132-000,2015,4,18,15,932,946,1878,1818
0132-000,2015,4,18,16,977,968,1945,1878
0132-000,2015,4,18,17,1158,875,2033,1945
0132-000,2015,4,18,18,1486,997,2483,2033
0132-000,2015,4,18,19,1414,776,2190,2483
0132-000,2015,4,18,20,1093,617,1710,2190
0132-000,2015,4,18,21,839,503,1342,1710
0132-000,2015,4,18,22,647,474,1121,1342
0132-000,2015,4,18,23,372,317,689,1121
0132-000,2015,4,18,24,236,252,488,689
0132-000,2015,4,19,1,167,173,340,488
0132-000,2015,4,19,2,112,110,222,340
0132-000,2015,4,19,3,103,113,216,222
0132-000,2015,4,19,4,81,90,171,216
0132-000,2015,4,19,5,89,90,179,171
0132-000,2015,4,19,6,105,104,209,179
0132-000,2015,4,19,7,177,172,349,209
0132-000,2015,4,19,8,228,296,524,349
0132-000,2015,4,19,9,320,460,780,524
0132-000,2015,4,19,10,420,540,960,780
0132-000,2015,4,19,11,486,638,1124,960
0132-000,2015,4,19,12,600,723,1323,1124
0132-000,2015,4,19,13,675,720,1395,1323
0132-000,2015,4,19,14,687,699,1386,1395
0132-000,2015,4,19,15,866,731,1597,1386
0132-000,2015,4,19,16,951,677,1628,1597
0132-000,2015,4,19,17,1199,727,1926,1628
0132-000,2015,4,19,18,1338,657,1995,1926
0132-000,2015,4,19,19,1582,528,2110,1995
0132-000,2015,4,19,20,1110,472,1582,2110
0132-000,2015,4,19,21,810,414,1224,1582
0132-000,2015,4,19,22,529,392,921,1224
0132-000,2015,4,19,23,324,261,585,921
0132-000,2015,4,19,24,165,175,340,585
0132-000,2015,4,20,1,119,138,257,340
0132-000,2015,4,20,2,64,88,152,257
0132-000,2015,4,20,3,48,63,111,152
0132-000,2015,4,20,4,47,58,105,111
0132-000,2015,4,20,5,80,74,154,105
0132-000,2015,4,20,6,140,141,281,154
0132-000,2015,4,20,7,376,546,922,281
0132-000,2015,4,20,8,652,1727,2379,922
0132-000,2015,4,20,9,774,1443,2217,2379
0132-000,2015,4,20,10,749,985,1734,2217
0132-000,2015,4,20,11,715,804,1519,1734
0132-000,2015,4,20,12,717,894,1611,1519
0132-000,2015,4,20,13,767,809,1576,1611
0132-000,2015,4,20,14,803,813,1616,1576
0132-000,2015,4,20,15,857,809,1666,1616
0132-000,2015,4,20,16,907,843,1750,1666
0132-000,2015,4,20,17,920,866,1786,1750
0132-000,2015,4,20,18,1101,836,1937,1786
0132-000,2015,4,20,19,1255,855,2110,1937
0132-000,2015,4,20,20,970,636,1606,2110
0132-000,2015,4,20,21,841,556,1397,1606
0132-000,2015,4,20,22,606,453,1059,1397
0132-000,2015,4,20,23,415,333,748,1059
0132-000,2015,4,20,24,218,213,431,748
0132-000,2015,4,21,1,171,165,336,431
0132-000,2015,4,21,2,93,108,201,336
0132-000,2015,4,21,3,81,86,167,201
0132-000,2015,4,21,4,78,88,166,167
0132-000,2015,4,21,5,64,102,166,166
0132-000,2015,4,21,6,193,191,384,166
0132-000,2015,4,21,7,463,570,1033,384
0132-000,2015,4,21,8,704,1757,2461,1033
0132-000,2015,4,21,9,857,1505,2362,2461
0132-000,2015,4,21,10,835,947,1782,2362
0132-000,2015,4,21,11,788,953,1741,1782
0132-000,2015,4,21,12,805,860,1665,1741
0132-000,2015,4,21,13,718,770,1488,1665
0132-000,2015,4,21,14,807,847,1654,1488
0132-000,2015,4,21,15,890,836,1726,1654
0132-000,2015,4,21,16,885,814,1699,1726
0132-000,2015,4,21,17,930,837,1767,1699
0132-000,2015,4,21,18,1219,912,2131,1767
0132-000,2015,4,21,19,1416,883,2299,2131
0132-000,2015,4,21,20,1062,697,1759,2299
0132-000,2015,4,21,21,791,536,1327,1759
0132-000,2015,4,21,22,605,475,1080,1327
0132-000,2015,4,21,23,381,330,711,1080
0132-000,2015,4,21,24,233,220,453,711
0132-000,2015,4,22,1,162,152,314,453
0132-000,2015,4,22,2,86,99,185,314
0132-000,2015,4,22,3,79,89,168,185
0132-000,2015,4,22,4,74,97,171,168
0132-000,2015,4,22,5,72,95,167,171
0132-000,2015,4,22,6,193,183,376,167
0132-000,2015,4,22,7,437,532,969,376
0132-000,2015,4,22,8,727,1705,2432,969
0132-000,2015,4,22,9,896,1392,2288,2432
0132-000,2015,4,22,10,753,926,1679,2288
0132-000,2015,4,22,11,808,896,1704,1679
0132-000,2015,4,22,12,775,835,1610,1704
0132-000,2015,4,22,13,726,763,1489,1610
0132-000,2015,4,22,14,836,771,1607,1489
0132-000,2015,4,22,15,893,854,1747,1607
0132-000,2015,4,22,16,942,794,1736,1747
0132-000,2015,4,22,17,892,813,1705,1736
0132-000,2015,4,22,18,1255,946,2201,1705
0132-000,2015,4,22,19,1449,869,2318,2201
0132-000,2015,4,22,20,941,706,1647,2318
0132-000,2015,4,22,21,793,539,1332,1647
0132-000,2015,4,22,22,573,447,1020,1332
0132-000,2015,4,22,23,357,314,671,1020
0132-000,2015,4,22,24,244,222,466,671
0132-000,2015,4,23,1,160,145,305,466
0132-000,2015,4,23,2,111,119,230,305
0132-000,2015,4,23,3,74,91,165,230
0132-000,2015,4,23,4,69,74,143,165
0132-000,2015,4,23,5,84,105,189,143
0132-000,2015,4,23,6,187,152,339,189
0132-000,2015,4,23,7,446,498,944,339
0132-000,2015,4,23,8,697,1696,2393,944
0132-000,2015,4,23,9,909,1407,2316,2393
0132-000,2015,4,23,10,816,962,1778,2316
0132-000,2015,4,23,11,770,898,1668,1778
0132-000,2015,4,23,12,799,812,1611,1668
0132-000,2015,4,23,13,739,711,1450,1611
0132-000,2015,4,23,14,808,765,1573,1450
0132-000,2015,4,23,15,889,886,1775,1573
0132-000,2015,4,23,16,991,840,1831,1775
0132-000,2015,4,23,17,969,842,1811,1831
0132-000,2015,4,23,18,1185,895,2080,1811
0132-000,2015,4,23,19,1390,866,2256,2080
0132-000,2015,4,23,20,1015,690,1705,2256
0132-000,2015,4,23,21,806,559,1365,1705
0132-000,2015,4,23,22,598,466,1064,1365
0132-000,2015,4,23,23,359,351,710,1064
0132-000,2015,4,23,24,264,231,495,710
0132-000,2015,4,24,1,192,170,362,495
0132-000,2015,4,24,2,122,110,232,362
0132-000,2015,4,24,3,84,95,179,232
0132-000,2015,4,24,4,73,88,161,179
0132-000,2015,4,24,5,75,101,176,161
0132-000,2015,4,24,6,197,165,362,176
0132-000,2015,4,24,7,421,541,962,362
0132-000,2015,4,24,8,722,1665,2387,962
0132-000,2015,4,24,9,903,1392,2295,2387
0132-000,2015,4,24,10,778,937,1715,2295
0132-000,2015,4,24,11,825,941,1766,1715
0132-000,2015,4,24,12,814,871,1685,1766
0132-000,2015,4,24,13,832,847,1679,1685
0132-000,2015,4,24,14,928,870,1798,1679
0132-000,2015,4,24,15,963,923,1886,1798
0132-000,2015,4,24,16,1001,883,1884,1886
0132-000,2015,4,24,17,1047,888,1935,1884
0132-000,2015,4,24,18,1345,1000,2345,1935
0132-000,2015,4,24,19,1509,1135,2644,2345
0132-000,2015,4,24,20,1268,1205,2473,2644
0132-000,2015,4,24,21,923,633,1556,2473
0132-000,2015,4,24,22,645,536,1181,1556
0132-000,2015,4,24,23,452,425,877,1181
0132-000,2015,4,24,24,306,281,587,877
0132-000,2015,4,25,1,211,201,412,587
0132-000,2015,4,25,2,133,164,297,412
0132-000,2015,4,25,3,113,135,248,297
0132-000,2015,4,25,4,97,123,220,248
0132-000,2015,4,25,5,113,122,235,220
0132-000,2015,4,25,6,205,174,379,235
0132-000,2015,4,25,7,402,445,847,379
0132-000,2015,4,25,8,513,827,1340,847
0132-000,2015,4,25,9,747,985,1732,1340
0132-000,2015,4,25,10,745,998,1743,1732
0132-000,2015,4,25,11,781,1270,2051,1743
0132-000,2015,4,25,12,863,1156,2019,2051
0132-000,2015,4,25,13,883,1210,2093,2019
0132-000,2015,4,25,14,927,1072,1999,2093
0132-000,2015,4,25,15,902,978,1880,1999
0132-000,2015,4,25,16,981,854,1835,1880
0132-000,2015,4,25,17,1083,934,2017,1835
0132-000,2015,4,25,18,1450,954,2404,2017
0132-000,2015,4,25,19,1348,888,2236,2404
0132-000,2015,4,25,20,972,720,1692,2236
0132-000,2015,4,25,21,746,547,1293,1692
0132-000,2015,4,25,22,535,464,999,1293
0132-000,2015,4,25,23,398,368,766,999
0132-000,2015,4,25,24,264,265,529,766
0132-000,2015,4,26,1,208,196,404,529
0132-000,2015,4,26,2,106,155,261,404
0132-000,2015,4,26,3,111,99,210,261
0132-000,2015,4,26,4,98,100,198,210
0132-000,2015,4,26,5,93,82,175,198
0132-000,2015,4,26,6,148,123,271,175
0132-000,2015,4,26,7,273,278,551,271
0132-000,2015,4,26,8,293,422,715,551
0132-000,2015,4,26,9,427,591,1018,715
0132-000,2015,4,26,10,478,604,1082,1018
0132-000,2015,4,26,11,576,695,1271,1082
0132-000,2015,4,26,12,601,684,1285,1271
0132-000,2015,4,26,13,659,601,1260,1285
0132-000,2015,4,26,14,730,674,1404,1260
0132-000,2015,4,26,15,854,730,1584,1404
0132-000,2015,4,26,16,1011,697,1708,1584
0132-000,2015,4,26,17,1263,636,1899,1708
0132-000,2015,4,26,18,1499,673,2172,1899
0132-000,2015,4,26,19,1501,628,2129,2172
0132-000,2015,4,26,20,1327,595,1922,2129
0132-000,2015,4,26,21,1146,501,1647,1922
0132-000,2015,4,26,22,724,434,1158,1647
0132-000,2015,4,26,23,415,315,730,1158
0132-000,2015,4,26,24,192,200,392,730
0132-000,2015,4,27,1,133,144,277,392
0132-000,2015,4,27,2,78,95,173,277
0132-000,2015,4,27,3,46,69,115,173
0132-000,2015,4,27,4,70,83,153,115
0132-000,2015,4,27,5,93,99,192,153
0132-000,2015,4,27,6,195,208,403,192
0132-000,2015,4,27,7,444,626,1070,403
0132-000,2015,4,27,8,726,1864,2590,1070
0132-000,2015,4,27,9,840,1408,2248,2590
0132-000,2015,4,27,10,754,990,1744,2248
0132-000,2015,4,27,11,772,871,1643,1744
0132-000,2015,4,27,12,801,792,1593,1643
0132-000,2015,4,27,13,803,738,1541,1593
0132-000,2015,4,27,14,831,816,1647,1541
0132-000,2015,4,27,15,837,846,1683,1647
0132-000,2015,4,27,16,927,807,1734,1683
0132-000,2015,4,27,17,876,842,1718,1734
0132-000,2015,4,27,18,1194,893,2087,1718
0132-000,2015,4,27,19,1323,922,2245,2087
0132-000,2015,4,27,20,1089,721,1810,2245
0132-000,2015,4,27,21,876,547,1423,1810
0132-000,2015,4,27,22,609,409,1018,1423
0132-000,2015,4,27,23,368,329,697,1018
0132-000,2015,4,27,24,249,192,441,697
0132-000,2015,4,28,1,151,152,303,441
0132-000,2015,4,28,2,90,84,174,303
0132-000,2015,4,28,3,75,90,165,174
0132-000,2015,4,28,4,74,81,155,165
0132-000,2015,4,28,5,86,84,170,155
0132-000,2015,4,28,6,196,160,356,170
0132-000,2015,4,28,7,448,570,1018,356
0132-000,2015,4,28,8,681,1744,2425,1018
0132-000,2015,4,28,9,864,1463,2327,2425
0132-000,2015,4,28,10,817,970,1787,2327
0132-000,2015,4,28,11,824,904,1728,1787
0132-000,2015,4,28,12,848,870,1718,1728
0132-000,2015,4,28,13,774,756,1530,1718
0132-000,2015,4,28,14,845,833,1678,1530
0132-000,2015,4,28,15,917,892,1809,1678
0132-000,2015,4,28,16,925,847,1772,1809
0132-000,2015,4,28,17,907,879,1786,1772
0132-000,2015,4,28,18,1253,934,2187,1786
0132-000,2015,4,28,19,1403,851,2254,2187
0132-000,2015,4,28,20,996,691,1687,2254
0132-000,2015,4,28,21,747,521,1268,1687
0132-000,2015,4,28,22,669,499,1168,1268
0132-000,2015,4,28,23,377,330,707,1168
0132-000,2015,4,28,24,202,211,413,707
0132-000,2015,4,29,1,143,157,300,413
0132-000,2015,4,29,2,108,106,214,300
0132-000,2015,4,29,3,78,101,179,214
0132-000,2015,4,29,4,81,88,169,179
0132-000,2015,4,29,5,68,78,146,169
0132-000,2015,4,29,6,187,151,338,146
0132-000,2015,4,29,7,387,490,877,338
0132-000,2015,4,29,8,625,1496,2121,877
0132-000,2015,4,29,9,867,1478,2345,2121
0132-000,2015,4,29,10,768,889,1657,2345
0132-000,2015,4,29,11,757,805,1562,1657
0132-000,2015,4,29,12,762,830,1592,1562
0132-000,2015,4,29,13,714,729,1443,1592
0132-000,2015,4,29,14,747,779,1526,1443
0132-000,2015,4,29,15,796,791,1587,1526
0132-000,2015,4,29,16,843,740,1583,1587
0132-000,2015,4,29,17,880,774,1654,1583
0132-000,2015,4,29,18,1233,868,2101,1654
0132-000,2015,4,29,19,1304,816,2120,2101
0132-000,2015,4,29,20,896,681,1577,2120
0132-000,2015,4,29,21,710,559,1269,1577
0132-000,2015,4,29,22,563,397,960,1269
0132-000,2015,4,29,23,430,332,762,960
0132-000,2015,4,29,24,224,222,446,762
0132-000,2015,4,30,1,172,165,337,446
0132-000,2015,4,30,2,99,92,191,337
0132-000,2015,4,30,3,73,104,177,191
0132-000,2015,4,30,4,86,93,179,177
0132-000,2015,4,30,5,75,103,178,179
0132-000,2015,4,30,6,221,169,390,178
0132-000,2015,4,30,7,421,572,993,390
0132-000,2015,4,30,8,684,1697,2381,993
0132-000,2015,4,30,9,883,1370,2253,2381
0132-000,2015,4,30,10,813,963,1776,2253
0132-000,2015,4,30,11,798,912,1710,1776
0132-000,2015,4,30,12,787,857,1644,1710
0132-000,2015,4,30,13,811,761,1572,1644
0132-000,2015,4,30,14,846,806,1652,1572
0132-000,2015,4,30,15,934,843,1777,1652
0132-000,2015,4,30,16,960,820,1780,1777
0132-000,2015,4,30,17,1063,804,1867,1780
0132-000,2015,4,30,18,1383,880,2263,1867
0132-000,2015,4,30,19,1612,835,2447,2263
0132-000,2015,4,30,20,1242,670,1912,2447
0132-000,2015,4,30,21,954,524,1478,1912
0132-000,2015,4,30,22,705,437,1142,1478
0132-000,2015,4,30,23,474,332,806,1142
0132-000,2015,4,30,24,297,218,515,806
0132-000,2015,5,1,1,221,186,407,515
0132-000,2015,5,1,2,148,125,273,407
0132-000,2015,5,1,3,125,94,219,273
0132-000,2015,5,1,4,110,98,208,219
0132-000,2015,5,1,5,107,103,210,208
0132-000,2015,5,1,6,179,162,341,210
0132-000,2015,5,1,7,330,372,702,341
0132-000,2015,5,1,8,572,981,1553,702
0132-000,2015,5,1,9,746,1312,2058,1553
0132-000,2015,5,1,10,747,1435,2182,2058
0132-000,2015,5,1,11,800,1488,2288,2182
0132-000,2015,5,1,12,776,1705,2481,2288
0132-000,2015,5,1,13,736,1796,2532,2481
0132-000,2015,5,1,14,814,1466,2280,2532
0132-000,2015,5,1,15,847,1382,2229,2280
0132-000,2015,5,1,16,934,1459,2393,2229
0132-000,2015,5,1,17,968,1319,2287,2393
0132-000,2015,5,1,18,1232,1204,2436,2287
0132-000,2015,5,1,19,1175,1150,2325,2436
0132-000,2015,5,1,20,914,732,1646,2325
0132-000,2015,5,1,21,664,531,1195,1646
0132-000,2015,5,1,22,505,348,853,1195
0132-000,2015,5,1,23,380,278,658,853
0132-000,2015,5,1,24,225,158,383,658
0132-000,2015,5,2,1,159,140,299,383
0132-000,2015,5,2,2,116,102,218,299
0132-000,2015,5,2,3,103,89,192,218
0132-000,2015,5,2,4,71,63,134,192
0132-000,2015,5,2,5,85,61,146,134
0132-000,2015,5,2,6,185,131,316,146
0132-000,2015,5,2,7,399,326,725,316
0132-000,2015,5,2,8,454,730,1184,725
0132-000,2015,5,2,9,629,1156,1785,1184
0132-000,2015,5,2,10,687,1428,2115,1785
0132-000,2015,5,2,11,736,1523,2259,2115
0132-000,2015,5,2,12,764,1650,2414,2259
0132-000,2015,5,2,13,774,1655,2429,2414
0132-000,2015,5,2,14,771,1253,2024,2429
0132-000,2015,5,2,15,868,1134,2002,2024
0132-000,2015,5,2,16,923,1018,1941,2002
0132-000,2015,5,2,17,1131,877,2008,1941
0132-000,2015,5,2,18,1447,919,2366,2008
0132-000,2015,5,2,19,1456,741,2197,2366
0132-000,2015,5,2,20,1299,566,1865,2197
0132-000,2015,5,2,21,1022,414,1436,1865
0132-000,2015,5,2,22,763,364,1127,1436
0132-000,2015,5,2,23,656,276,932,1127
0132-000,2015,5,2,24,310,151,461,932
0132-000,2015,5,3,1,152,131,283,461
0132-000,2015,5,3,2,102,92,194,283
0132-000,2015,5,3,3,87,65,152,194
0132-000,2015,5,3,4,75,63,138,152
0132-000,2015,5,3,5,92,50,142,138
0132-000,2015,5,3,6,134,79,213,142
0132-000,2015,5,3,7,210,144,354,213
0132-000,2015,5,3,8,246,282,528,354
0132-000,2015,5,3,9,359,340,699,528
0132-000,2015,5,3,10,442,498,940,699
0132-000,2015,5,3,11,568,627,1195,940
0132-000,2015,5,3,12,690,581,1271,1195
0132-000,2015,5,3,13,787,561,1348,1271
0132-000,2015,5,3,14,826,561,1387,1348
0132-000,2015,5,3,15,1211,732,1943,1387
0132-000,2015,5,3,16,1492,733,2225,1943
0132-000,2015,5,3,17,1673,634,2307,2225
0132-000,2015,5,3,18,1798,601,2399,2307
0132-000,2015,5,3,19,1919,495,2414,2399
0132-000,2015,5,3,20,1791,430,2221,2414
0132-000,2015,5,3,21,1779,370,2149,2221
0132-000,2015,5,3,22,1794,311,2105,2149
0132-000,2015,5,3,23,1103,254,1357,2105
0132-000,2015,5,3,24,699,160,859,1357
0132-000,2015,5,4,1,263,90,353,859
0132-000,2015,5,4,2,108,83,191,353
0132-000,2015,5,4,3,58,41,99,191
0132-000,2015,5,4,4,53,52,105,99
0132-000,2015,5,4,5,69,50,119,105
0132-000,2015,5,4,6,208,147,355,119
0132-000,2015,5,4,7,387,557,944,355
0132-000,2015,5,4,8,671,1433,2104,944
0132-000,2015,5,4,9,728,1108,1836,2104
0132-000,2015,5,4,10,779,853,1632,1836
0132-000,2015,5,4,11,793,877,1670,1632
0132-000,2015,5,4,12,841,932,1773,1670
0132-000,2015,5,4,13,729,814,1543,1773
0132-000,2015,5,4,14,887,849,1736,1543
0132-000,2015,5,4,15,947,871,1818,1736
0132-000,2015,5,4,16,942,807,1749,1818
0132-000,2015,5,4,17,970,822,1792,1749
0132-000,2015,5,4,18,1358,912,2270,1792
0132-000,2015,5,4,19,1465,877,2342,2270
0132-000,2015,5,4,20,1276,748,2024,2342
0132-000,2015,5,4,21,996,533,1529,2024
0132-000,2015,5,4,22,717,430,1147,1529
0132-000,2015,5,4,23,466,337,803,1147
0132-000,2015,5,4,24,259,241,500,803
0132-000,2015,5,5,1,174,151,325,500
0132-000,2015,5,5,2,127,92,219,325
0132-000,2015,5,5,3,86,74,160,219
0132-000,2015,5,5,4,78,56,134,160
0132-000,2015,5,5,5,80,72,152,134
0132-000,2015,5,5,6,200,118,318,152
0132-000,2015,5,5,7,326,294,620,318
0132-000,2015,5,5,8,383,592,975,620
0132-000,2015,5,5,9,532,698,1230,975
0132-000,2015,5,5,10,602,752,1354,1230
0132-000,2015,5,5,11,673,781,1454,1354
0132-000,2015,5,5,12,677,791,1468,1454
0132-000,2015,5,5,13,721,658,1379,1468
0132-000,2015,5,5,14,769,711,1480,1379
0132-000,2015,5,5,15,821,717,1538,1480
0132-000,2015,5,5,16,787,625,1412,1538
0132-000,2015,5,5,17,1067,686,1753,1412
0132-000,2015,5,5,18,1208,752,1960,1753
0132-000,2015,5,5,19,1192,715,1907,1960
0132-000,2015,5,5,20,951,524,1475,1907
0132-000,2015,5,5,21,727,412,1139,1475
0132-000,2015,5,5,22,496,190,686,1139
0132-000,2015,5,5,23,327,228,555,686
0132-000,2015,5,5,24,179,164,343,555
0132-000,2015,5,6,1,136,98,234,343
0132-000,2015,5,6,2,95,68,163,234
0132-000,2015,5,6,3,62,50,112,163
0132-000,2015,5,6,4,69,57,126,112
0132-000,2015,5,6,5,60,72,132,126
0132-000,2015,5,6,6,213,153,366,132
0132-000,2015,5,6,7,464,640,1104,366
0132-000,2015,5,6,8,717,1886,2603,1104
0132-000,2015,5,6,9,812,1446,2258,2603
0132-000,2015,5,6,10,763,932,1695,2258
0132-000,2015,5,6,11,813,902,1715,1695
0132-000,2015,5,6,12,816,831,1647,1715
0132-000,2015,5,6,13,732,790,1522,1647
0132-000,2015,5,6,14,834,752,1586,1522
0132-000,2015,5,6,15,897,788,1685,1586
0132-000,2015,5,6,16,1008,774,1782,1685
0132-000,2015,5,6,17,940,860,1800,1782
0132-000,2015,5,6,18,1187,965,2152,1800
0132-000,2015,5,6,19,1422,827,2249,2152
0132-000,2015,5,6,20,1005,654,1659,2249
0132-000,2015,5,6,21,788,511,1299,1659
0132-000,2015,5,6,22,618,395,1013,1299
0132-000,2015,5,6,23,363,265,628,1013
0132-000,2015,5,6,24,257,158,415,628
0132-000,2015,5,7,1,177,116,293,415
0132-000,2015,5,7,2,109,76,185,293
0132-000,2015,5,7,3,75,59,134,185
0132-000,2015,5,7,4,77,48,125,134
0132-000,2015,5,7,5,88,57,145,125
0132-000,2015,5,7,6,199,149,348,145
0132-000,2015,5,7,7,438,522,960,348
0132-000,2015,5,7,8,709,1808,2517,960
0132-000,2015,5,7,9,848,1373,2221,2517
0132-000,2015,5,7,10,791,934,1725,2221
0132-000,2015,5,7,11,821,926,1747,1725
0132-000,2015,5,7,12,792,809,1601,1747
0132-000,2015,5,7,13,703,781,1484,1601
0132-000,2015,5,7,14,837,886,1723,1484
0132-000,2015,5,7,15,897,810,1707,1723
0132-000,2015,5,7,16,843,752,1595,1707
0132-000,2015,5,7,17,938,822,1760,1595
0132-000,2015,5,7,18,1200,908,2108,1760
0132-000,2015,5,7,19,1385,919,2304,2108
0132-000,2015,5,7,20,1028,658,1686,2304
0132-000,2015,5,7,21,874,487,1361,1686
0132-000,2015,5,7,22,655,485,1140,1361
0132-000,2015,5,7,23,447,263,710,1140
0132-000,2015,5,7,24,247,193,440,710
0132-000,2015,5,8,1,203,144,347,440
0132-000,2015,5,8,2,120,96,216,347
0132-000,2015,5,8,3,84,74,158,216
0132-000,2015,5,8,4,75,68,143,158
0132-000,2015,5,8,5,95,65,160,143
0132-000,2015,5,8,6,183,140,323,160
0132-000,2015,5,8,7,474,531,1005,323
0132-000,2015,5,8,8,703,1777,2480,1005
0132-000,2015,5,8,9,826,1451,2277,2480
0132-000,2015,5,8,10,802,915,1717,2277
0132-000,2015,5,8,11,803,886,1689,1717
0132-000,2015,5,8,12,876,899,1775,1689
0132-000,2015,5,8,13,804,858,1662,1775
0132-000,2015,5,8,14,869,772,1641,1662
0132-000,2015,5,8,15,900,932,1832,1641
0132-000,2015,5,8,16,968,888,1856,1832
0132-000,2015,5,8,17,1091,917,2008,1856
0132-000,2015,5,8,18,1523,1077,2600,2008
0132-000,2015,5,8,19,1792,1013,2805,2600
0132-000,2015,5,8,20,1304,827,2131,2805
0132-000,2015,5,8,21,1077,621,1698,2131
0132-000,2015,5,8,22,808,548,1356,1698
0132-000,2015,5,8,23,456,379,835,1356
0132-000,2015,5,8,24,271,206,477,835
0132-000,2015,5,9,1,204,157,361,477
0132-000,2015,5,9,2,120,98,218,361
0132-000,2015,5,9,3,99,85,184,218
0132-000,2015,5,9,4,87,63,150,184
0132-000,2015,5,9,5,89,70,159,150
0132-000,2015,5,9,6,215,136,351,159
0132-000,2015,5,9,7,418,316,734,351
0132-000,2015,5,9,8,570,864,1434,734
0132-000,2015,5,9,9,727,937,1664,1434
0132-000,2015,5,9,10,720,1007,1727,1664
0132-000,2015,5,9,11,784,1417,2201,1727
0132-000,2015,5,9,12,888,1453,2341,2201
0132-000,2015,5,9,13,792,1345,2137,2341
0132-000,2015,5,9,14,855,1136,1991,2137
0132-000,2015,5,9,15,963,950,1913,1991
0132-000,2015,5,9,16,1056,915,1971,1913
0132-000,2015,5,9,17,1217,941,2158,1971
0132-000,2015,5,9,18,1544,967,2511,2158
0132-000,2015,5,9,19,1537,849,2386,2511
0132-000,2015,5,9,20,1099,691,1790,2386
0132-000,2015,5,9,21,835,513,1348,1790
0132-000,2015,5,9,22,641,364,1005,1348
0132-000,2015,5,9,23,419,311,730,1005
0132-000,2015,5,9,24,232,190,422,730
0132-000,2015,5,10,1,154,149,303,422
0132-000,2015,5,10,2,136,107,243,303
0132-000,2015,5,10,3,104,85,189,243
0132-000,2015,5,10,4,76,65,141,189
0132-000,2015,5,10,5,77,67,144,141
0132-000,2015,5,10,6,155,122,277,144
0132-000,2015,5,10,7,284,221,505,277
0132-000,2015,5,10,8,330,331,661,505
0132-000,2015,5,10,9,416,456,872,661
0132-000,2015,5,10,10,453,553,1006,872
0132-000,2015,5,10,11,549,658,1207,1006
0132-000,2015,5,10,12,634,634,1268,1207
0132-000,2015,5,10,13,689,594,1283,1268
0132-000,2015,5,10,14,792,629,1421,1283
0132-000,2015,5,10,15,869,680,1549,1421
0132-000,2015,5,10,16,1123,662,1785,1549
0132-000,2015,5,10,17,1354,614,1968,1785
0132-000,2015,5,10,18,1684,686,2370,1968
0132-000,2015,5,10,19,1800,592,2392,2370
0132-000,2015,5,10,20,1491,529,2020,2392
0132-000,2015,5,10,21,1340,438,1778,2020
0132-000,2015,5,10,22,1110,430,1540,1778
0132-000,2015,5,10,23,554,270,824,1540
0132-000,2015,5,10,24,239,166,405,824
0132-000,2015,5,11,1,151,131,282,405
0132-000,2015,5,11,2,80,72,152,282
0132-000,2015,5,11,3,49,43,92,152
0132-000,2015,5,11,4,49,45,94,92
0132-000,2015,5,11,5,81,56,137,94
0132-000,2015,5,11,6,219,164,383,137
0132-000,2015,5,11,7,480,610,1090,383
0132-000,2015,5,11,8,707,1940,2647,1090
0132-000,2015,5,11,9,836,1428,2264,2647
0132-000,2015,5,11,10,779,878,1657,2264
0132-000,2015,5,11,11,854,893,1747,1657
0132-000,2015,5,11,12,767,845,1612,1747
0132-000,2015,5,11,13,765,792,1557,1612
0132-000,2015,5,11,14,831,796,1627,1557
0132-000,2015,5,11,15,837,897,1734,1627
0132-000,2015,5,11,16,989,755,1744,1734
0132-000,2015,5,11,17,951,761,1712,1744
0132-000,2015,5,11,18,1207,838,2045,1712
0132-000,2015,5,11,19,1348,772,2120,2045
0132-000,2015,5,11,20,966,636,1602,2120
0132-000,2015,5,11,21,830,454,1284,1602
0132-000,2015,5,11,22,606,357,963,1284
0132-000,2015,5,11,23,345,270,615,963
0132-000,2015,5,11,24,232,138,370,615
0132-000,2015,5,12,1,133,136,269,370
0132-000,2015,5,12,2,94,50,144,269
0132-000,2015,5,12,3,64,65,129,144
0132-000,2015,5,12,4,64,68,132,129
0132-000,2015,5,12,5,79,57,136,132
0132-000,2015,5,12,6,140,100,240,136
0132-000,2015,5,12,7,374,416,790,240
0132-000,2015,5,12,8,661,1781,2442,790
0132-000,2015,5,12,9,868,1374,2242,2442
0132-000,2015,5,12,10,803,840,1643,2242
0132-000,2015,5,12,11,797,895,1692,1643
0132-000,2015,5,12,12,773,829,1602,1692
0132-000,2015,5,12,13,700,781,1481,1602
0132-000,2015,5,12,14,868,754,1622,1481
0132-000,2015,5,12,15,896,893,1789,1622
0132-000,2015,5,12,16,923,785,1708,1789
0132-000,2015,5,12,17,914,893,1807,1708
0132-000,2015,5,12,18,1178,875,2053,1807
0132-000,2015,5,12,19,1408,869,2277,2053
0132-000,2015,5,12,20,950,608,1558,2277
0132-000,2015,5,12,21,800,428,1228,1558
0132-000,2015,5,12,22,660,425,1085,1228
0132-000,2015,5,12,23,355,269,624,1085
0132-000,2015,5,12,24,243,179,422,624
0132-000,2015,5,13,1,155,129,284,422
0132-000,2015,5,13,2,113,100,213,284
0132-000,2015,5,13,3,83,74,157,213
0132-000,2015,5,13,4,70,67,137,157
0132-000,2015,5,13,5,74,79,153,137
0132-000,2015,5,13,6,229,175,404,153
0132-000,2015,5,13,7,436,553,989,404
0132-000,2015,5,13,8,709,1761,2470,989
0132-000,2015,5,13,9,871,1369,2240,2470
0132-000,2015,5,13,10,803,950,1753,2240
0132-000,2015,5,13,11,797,875,1672,1753
0132-000,2015,5,13,12,766,774,1540,1672
0132-000,2015,5,13,13,747,825,1572,1540
0132-000,2015,5,13,14,859,860,1719,1572
0132-000,2015,5,13,15,899,822,1721,1719
0132-000,2015,5,13,16,884,803,1687,1721
0132-000,2015,5,13,17,933,809,1742,1687
0132-000,2015,5,13,18,1279,950,2229,1742
0132-000,2015,5,13,19,1388,891,2279,2229
0132-000,2015,5,13,20,947,702,1649,2279
0132-000,2015,5,13,21,782,509,1291,1649
0132-000,2015,5,13,22,639,423,1062,1291
0132-000,2015,5,13,23,432,298,730,1062
0132-000,2015,5,13,24,274,208,482,730
0132-000,2015,5,14,1,201,166,367,482
0132-000,2015,5,14,2,146,81,227,367
0132-000,2015,5,14,3,93,85,178,227
0132-000,2015,5,14,4,107,81,188,178
0132-000,2015,5,14,5,81,63,144,188
0132-000,2015,5,14,6,212,153,365,144
0132-000,2015,5,14,7,499,517,1016,365
0132-000,2015,5,14,8,709,1829,2538,1016
0132-000,2015,5,14,9,886,1369,2255,2538
0132-000,2015,5,14,10,774,912,1686,2255
0132-000,2015,5,14,11,838,840,1678,1686
0132-000,2015,5,14,12,771,845,1616,1678
0132-000,2015,5,14,13,692,805,1497,1616
0132-000,2015,5,14,14,855,810,1665,1497
0132-000,2015,5,14,15,894,844,1738,1665
0132-000,2015,5,14,16,979,792,1771,1738
0132-000,2015,5,14,17,931,822,1753,1771
0132-000,2015,5,14,18,1257,878,2135,1753
0132-000,2015,5,14,19,1353,886,2239,2135
0132-000,2015,5,14,20,1000,766,1766,2239
0132-000,2015,5,14,21,811,485,1296,1766
0132-000,2015,5,14,22,697,438,1135,1296
0132-000,2015,5,14,23,427,287,714,1135
0132-000,2015,5,14,24,287,226,513,714
0132-000,2015,5,15,1,212,165,377,513
0132-000,2015,5,15,2,134,110,244,377
0132-000,2015,5,15,3,104,84,188,244
0132-000,2015,5,15,4,92,83,175,188
0132-000,2015,5,15,5,101,84,185,175
0132-000,2015,5,15,6,181,151,332,185
0132-000,2015,5,15,7,402,452,854,332
0132-000,2015,5,15,8,638,1379,2017,854
0132-000,2015,5,15,9,786,1382,2168,2017
0132-000,2015,5,15,10,774,1175,1949,2168
0132-000,2015,5,15,11,802,1187,1989,1949
0132-000,2015,5,15,12,826,1302,2128,1989
0132-000,2015,5,15,13,770,1327,2097,2128
0132-000,2015,5,15,14,842,1119,1961,2097
0132-000,2015,5,15,15,874,1157,2031,1961
0132-000,2015,5,15,16,995,878,1873,2031
0132-000,2015,5,15,17,1070,897,1967,1873
0132-000,2015,5,15,18,1456,999,2455,1967
0132-000,2015,5,15,19,1739,948,2687,2455
0132-000,2015,5,15,20,1249,823,2072,2687
0132-000,2015,5,15,21,942,608,1550,2072
0132-000,2015,5,15,22,641,547,1188,1550
0132-000,2015,5,15,23,469,377,846,1188
0132-000,2015,5,15,24,317,279,596,846
0132-000,2015,5,16,1,235,234,469,596
0132-000,2015,5,16,2,156,159,315,469
0132-000,2015,5,16,3,117,125,242,315
0132-000,2015,5,16,4,103,117,220,242
0132-000,2015,5,16,5,115,130,245,220
0132-000,2015,5,16,6,224,156,380,245
0132-000,2015,5,16,7,382,440,822,380
0132-000,2015,5,16,8,537,856,1393,822
0132-000,2015,5,16,9,742,982,1724,1393
0132-000,2015,5,16,10,756,1035,1791,1724
0132-000,2015,5,16,11,862,1101,1963,1791
0132-000,2015,5,16,12,842,1098,1940,1963
0132-000,2015,5,16,13,943,986,1929,1940
0132-000,2015,5,16,14,906,966,1872,1929
0132-000,2015,5,16,15,944,888,1832,1872
0132-000,2015,5,16,16,1004,889,1893,1832
0132-000,2015,5,16,17,1121,948,2069,1893
0132-000,2015,5,16,18,1422,927,2349,2069
0132-000,2015,5,16,19,1393,888,2281,2349
0132-000,2015,5,16,20,990,657,1647,2281
0132-000,2015,5,16,21,682,583,1265,1647
0132-000,2015,5,16,22,548,420,968,1265
0132-000,2015,5,16,23,375,350,725,968
0132-000,2015,5,16,24,239,272,511,725
0132-000,2015,5,17,1,180,213,393,511
0132-000,2015,5,17,2,131,136,267,393
0132-000,2015,5,17,3,103,110,213,267
0132-000,2015,5,17,4,82,91,173,213
0132-000,2015,5,17,5,86,98,184,173
0132-000,2015,5,17,6,149,130,279,184
0132-000,2015,5,17,7,264,261,525,279
0132-000,2015,5,17,8,323,415,738,525
0132-000,2015,5,17,9,435,521,956,738
0132-000,2015,5,17,10,470,579,1049,956
0132-000,2015,5,17,11,583,682,1265,1049
0132-000,2015,5,17,12,646,696,1342,1265
0132-000,2015,5,17,13,699,725,1424,1342
0132-000,2015,5,17,14,758,738,1496,1424
0132-000,2015,5,17,15,809,755,1564,1496
0132-000,2015,5,17,16,966,703,1669,1564
0132-000,2015,5,17,17,1091,751,1842,1669
0132-000,2015,5,17,18,1219,665,1884,1842
0132-000,2015,5,17,19,1382,676,2058,1884
0132-000,2015,5,17,20,1098,543,1641,2058
0132-000,2015,5,17,21,720,540,1260,1641
0132-000,2015,5,17,22,563,447,1010,1260
0132-000,2015,5,17,23,354,316,670,1010
0132-000,2015,5,17,24,225,203,428,670
0132-000,2015,5,18,1,128,133,261,428
0132-000,2015,5,18,2,66,93,159,261
0132-000,2015,5,18,3,51,60,111,159
0132-000,2015,5,18,4,57,68,125,111
0132-000,2015,5,18,5,78,72,150,125
0132-000,2015,5,18,6,220,219,439,150
0132-000,2015,5,18,7,483,644,1127,439
0132-000,2015,5,18,8,767,1820,2587,1127
0132-000,2015,5,18,9,882,1459,2341,2587
0132-000,2015,5,18,10,772,912,1684,2341
0132-000,2015,5,18,11,819,901,1720,1684
0132-000,2015,5,18,12,821,849,1670,1720
0132-000,2015,5,18,13,815,751,1566,1670
0132-000,2015,5,18,14,807,805,1612,1566
0132-000,2015,5,18,15,921,865,1786,1612
0132-000,2015,5,18,16,887,809,1696,1786
0132-000,2015,5,18,17,975,823,1798,1696
0132-000,2015,5,18,18,1178,895,2073,1798
0132-000,2015,5,18,19,1417,898,2315,2073
0132-000,2015,5,18,20,955,665,1620,2315
0132-000,2015,5,18,21,830,557,1387,1620
0132-000,2015,5,18,22,627,451,1078,1387
0132-000,2015,5,18,23,420,314,734,1078
0132-000,2015,5,18,24,231,195,426,734
0132-000,2015,5,19,1,149,157,306,426
0132-000,2015,5,19,2,100,99,199,306
0132-000,2015,5,19,3,79,83,162,199
0132-000,2015,5,19,4,77,99,176,162
0132-000,2015,5,19,5,79,100,179,176
0132-000,2015,5,19,6,190,156,346,179
0132-000,2015,5,19,7,468,554,1022,346
0132-000,2015,5,19,8,721,1618,2339,1022
0132-000,2015,5,19,9,885,1460,2345,2339
0132-000,2015,5,19,10,704,747,1451,2345
0132-000,2015,5,19,11,800,822,1622,1451
0132-000,2015,5,19,12,836,859,1695,1622
0132-000,2015,5,19,13,771,837,1608,1695
0132-000,2015,5,19,14,879,808,1687,1608
0132-000,2015,5,19,15,896,839,1735,1687
0132-000,2015,5,19,16,899,767,1666,1735
0132-000,2015,5,19,17,923,787,1710,1666
0132-000,2015,5,19,18,1221,929,2150,1710
0132-000,2015,5,19,19,1401,789,2190,2150
0132-000,2015,5,19,20,950,725,1675,2190
0132-000,2015,5,19,21,841,490,1331,1675
0132-000,2015,5,19,22,576,420,996,1331
0132-000,2015,5,19,23,325,300,625,996
0132-000,2015,5,19,24,217,220,437,625
0132-000,2015,5,20,1,138,131,269,437
0132-000,2015,5,20,2,100,80,180,269
0132-000,2015,5,20,3,74,86,160,180
0132-000,2015,5,20,4,68,67,135,160
0132-000,2015,5,20,5,78,79,157,135
0132-000,2015,5,20,6,197,174,371,157
0132-000,2015,5,20,7,485,546,1031,371
0132-000,2015,5,20,8,715,1621,2336,1031
0132-000,2015,5,20,9,844,1384,2228,2336
0132-000,2015,5,20,10,817,882,1699,2228
0132-000,2015,5,20,11,864,871,1735,1699
0132-000,2015,5,20,12,770,856,1626,1735
0132-000,2015,5,20,13,753,766,1519,1626
0132-000,2015,5,20,14,792,773,1565,1519
0132-000,2015,5,20,15,905,858,1763,1565
0132-000,2015,5,20,16,959,780,1739,1763
0132-000,2015,5,20,17,973,828,1801,1739
0132-000,2015,5,20,18,1228,889,2117,1801
0132-000,2015,5,20,19,1510,896,2406,2117
0132-000,2015,5,20,20,1005,763,1768,2406
0132-000,2015,5,20,21,827,575,1402,1768
0132-000,2015,5,20,22,642,479,1121,1402
0132-000,2015,5,20,23,375,320,695,1121
0132-000,2015,5,20,24,268,241,509,695
0132-000,2015,5,21,1,164,153,317,509
0132-000,2015,5,21,2,109,115,224,317
0132-000,2015,5,21,3,85,86,171,224
0132-000,2015,5,21,4,93,78,171,171
0132-000,2015,5,21,5,108,94,202,171
0132-000,2015,5,21,6,212,205,417,202
0132-000,2015,5,21,7,483,588,1071,417
0132-000,2015,5,21,8,722,1629,2351,1071
0132-000,2015,5,21,9,874,1521,2395,2351
0132-000,2015,5,21,10,749,890,1639,2395
0132-000,2015,5,21,11,787,860,1647,1639
0132-000,2015,5,21,12,802,856,1658,1647
0132-000,2015,5,21,13,756,738,1494,1658
0132-000,2015,5,21,14,864,840,1704,1494
0132-000,2015,5,21,15,884,833,1717,1704
0132-000,2015,5,21,16,918,795,1713,1717
0132-000,2015,5,21,17,993,801,1794,1713
0132-000,2015,5,21,18,1207,847,2054,1794
0132-000,2015,5,21,19,1471,983,2454,2054
0132-000,2015,5,21,20,1072,721,1793,2454
0132-000,2015,5,21,21,974,591,1565,1793
0132-000,2015,5,21,22,687,500,1187,1565
0132-000,2015,5,21,23,349,338,687,1187
0132-000,2015,5,21,24,271,238,509,687
0132-000,2015,5,22,1,199,151,350,509
0132-000,2015,5,22,2,112,109,221,350
0132-000,2015,5,22,3,79,104,183,221
0132-000,2015,5,22,4,71,82,153,183
0132-000,2015,5,22,5,79,87,166,153
0132-000,2015,5,22,6,213,191,404,166
0132-000,2015,5,22,7,471,561,1032,404
0132-000,2015,5,22,8,702,1589,2291,1032
0132-000,2015,5,22,9,891,1439,2330,2291
0132-000,2015,5,22,10,769,796,1565,2330
0132-000,2015,5,22,11,861,864,1725,1565
0132-000,2015,5,22,12,778,773,1551,1725
0132-000,2015,5,22,13,791,773,1564,1551
0132-000,2015,5,22,14,807,796,1603,1564
0132-000,2015,5,22,15,940,867,1807,1603
0132-000,2015,5,22,16,1052,828,1880,1807
0132-000,2015,5,22,17,1014,925,1939,1880
0132-000,2015,5,22,18,1349,1006,2355,1939
0132-000,2015,5,22,19,1739,973,2712,2355
0132-000,2015,5,22,20,1204,857,2061,2712
0132-000,2015,5,22,21,1024,684,1708,2061
0132-000,2015,5,22,22,706,541,1247,1708
0132-000,2015,5,22,23,450,429,879,1247
0132-000,2015,5,22,24,285,272,557,879
0132-000,2015,5,23,1,245,223,468,557
0132-000,2015,5,23,2,136,148,284,468
0132-000,2015,5,23,3,108,127,235,284
0132-000,2015,5,23,4,94,93,187,235
0132-000,2015,5,23,5,118,122,240,187
0132-000,2015,5,23,6,228,220,448,240
0132-000,2015,5,23,7,388,432,820,448
0132-000,2015,5,23,8,548,908,1456,820
0132-000,2015,5,23,9,728,1249,1977,1456
0132-000,2015,5,23,10,794,1374,2168,1977
0132-000,2015,5,23,11,807,1561,2368,2168
0132-000,2015,5,23,12,1072,1948,3020,2368
0132-000,2015,5,23,13,912,1879,2791,3020
0132-000,2015,5,23,14,930,1858,2788,2791
0132-000,2015,5,23,15,905,1534,2439,2788
0132-000,2015,5,23,16,923,1572,2495,2439
0132-000,2015,5,23,17,1085,1534,2619,2495
0132-000,2015,5,23,18,1397,1265,2662,2619
0132-000,2015,5,23,19,1372,1312,2684,2662
0132-000,2015,5,23,20,1022,850,1872,2684
0132-000,2015,5,23,21,724,595,1319,1872
0132-000,2015,5,23,22,519,452,971,1319
0132-000,2015,5,23,23,393,370,763,971
0132-000,2015,5,23,24,212,262,474,763
0132-000,2015,5,24,1,153,172,325,474
0132-000,2015,5,24,2,110,133,243,325
0132-000,2015,5,24,3,105,108,213,243
0132-000,2015,5,24,4,85,82,167,213
0132-000,2015,5,24,5,72,81,153,167
0132-000,2015,5,24,6,160,144,304,153
0132-000,2015,5,24,7,278,278,556,304
0132-000,2015,5,24,8,325,394,719,556
0132-000,2015,5,24,9,458,569,1027,719
0132-000,2015,5,24,10,446,667,1113,1027
0132-000,2015,5,24,11,577,766,1343,1113
0132-000,2015,5,24,12,648,824,1472,1343
0132-000,2015,5,24,13,614,749,1363,1472
0132-000,2015,5,24,14,637,703,1340,1363
0132-000,2015,5,24,15,754,634,1388,1340
0132-000,2015,5,24,16,981,657,1638,1388
0132-000,2015,5,24,17,1111,634,1745,1638
0132-000,2015,5,24,18,1280,642,1922,1745
0132-000,2015,5,24,19,1342,683,2025,1922
0132-000,2015,5,24,20,1418,558,1976,2025
0132-000,2015,5,24,21,1287,459,1746,1976
0132-000,2015,5,24,22,967,426,1393,1746
0132-000,2015,5,24,23,757,307,1064,1393
0132-000,2015,5,24,24,371,229,600,1064
0132-000,2015,5,25,1,188,181,369,600
0132-000,2015,5,25,2,110,126,236,369
0132-000,2015,5,25,3,78,71,149,236
0132-000,2015,5,25,4,64,67,131,149
0132-000,2015,5,25,5,84,89,173,131
0132-000,2015,5,25,6,179,178,357,173
0132-000,2015,5,25,7,315,361,676,357
0132-000,2015,5,25,8,439,661,1100,676
0132-000,2015,5,25,9,565,719,1284,1100
0132-000,2015,5,25,10,569,806,1375,1284
0132-000,2015,5,25,11,703,806,1509,1375
0132-000,2015,5,25,12,807,751,1558,1509
0132-000,2015,5,25,13,1032,775,1807,1558
0132-000,2015,5,25,14,1221,788,2009,1807
0132-000,2015,5,25,15,1404,781,2185,2009
0132-000,2015,5,25,16,1529,751,2280,2185
0132-000,2015,5,25,17,2013,735,2748,2280
0132-000,2015,5,25,18,2149,743,2892,2748
0132-000,2015,5,25,19,1790,688,2478,2892
0132-000,2015,5,25,20,1452,571,2023,2478
0132-000,2015,5,25,21,1012,507,1519,2023
0132-000,2015,5,25,22,731,463,1194,1519
0132-000,2015,5,25,23,381,314,695,1194
0132-000,2015,5,25,24,234,229,463,695
0132-000,2015,5,26,1,141,138,279,463
0132-000,2015,5,26,2,99,93,192,279
0132-000,2015,5,26,3,66,71,137,192
0132-000,2015,5,26,4,57,69,126,137
0132-000,2015,5,26,5,85,84,169,126
0132-000,2015,5,26,6,208,220,428,169
0132-000,2015,5,26,7,503,645,1148,428
0132-000,2015,5,26,8,724,1796,2520,1148
0132-000,2015,5,26,9,910,1547,2457,2520
0132-000,2015,5,26,10,868,913,1781,2457
0132-000,2015,5,26,11,830,873,1703,1781
0132-000,2015,5,26,12,851,928,1779,1703
0132-000,2015,5,26,13,767,904,1671,1779
0132-000,2015,5,26,14,892,814,1706,1671
0132-000,2015,5,26,15,909,875,1784,1706
0132-000,2015,5,26,16,911,822,1733,1784
0132-000,2015,5,26,17,947,816,1763,1733
0132-000,2015,5,26,18,1186,983,2169,1763
0132-000,2015,5,26,19,1427,1095,2522,2169
0132-000,2015,5,26,20,1083,697,1780,2522
0132-000,2015,5,26,21,935,579,1514,1780
0132-000,2015,5,26,22,696,494,1190,1514
0132-000,2015,5,26,23,392,347,739,1190
0132-000,2015,5,26,24,227,203,430,739
0132-000,2015,5,27,1,174,160,334,430
0132-000,2015,5,27,2,86,89,175,334
0132-000,2015,5,27,3,71,80,151,175
0132-000,2015,5,27,4,70,73,143,151
0132-000,2015,5,27,5,88,84,172,143
0132-000,2015,5,27,6,218,165,383,172
0132-000,2015,5,27,7,457,532,989,383
0132-000,2015,5,27,8,685,1672,2357,989
0132-000,2015,5,27,9,907,1414,2321,2357
0132-000,2015,5,27,10,759,943,1702,2321
0132-000,2015,5,27,11,788,862,1650,1702
0132-000,2015,5,27,12,794,778,1572,1650
0132-000,2015,5,27,13,762,773,1535,1572
0132-000,2015,5,27,14,819,831,1650,1535
0132-000,2015,5,27,15,899,855,1754,1650
0132-000,2015,5,27,16,937,794,1731,1754
0132-000,2015,5,27,17,963,852,1815,1731
0132-000,2015,5,27,18,1223,892,2115,1815
0132-000,2015,5,27,19,1470,933,2403,2115
0132-000,2015,5,27,20,988,704,1692,2403
0132-000,2015,5,27,21,848,567,1415,1692
0132-000,2015,5,27,22,621,439,1060,1415
0132-000,2015,5,27,23,402,364,766,1060
0132-000,2015,5,27,24,271,244,515,766
0132-000,2015,5,28,1,205,180,385,515
0132-000,2015,5,28,2,118,114,232,385
0132-000,2015,5,28,3,83,104,187,232
0132-000,2015,5,28,4,92,85,177,187
0132-000,2015,5,28,5,88,94,182,177
0132-000,2015,5,28,6,219,182,401,182
0132-000,2015,5,28,7,494,540,1034,401
0132-000,2015,5,28,8,688,1629,2317,1034
0132-000,2015,5,28,9,903,1447,2350,2317
0132-000,2015,5,28,10,807,954,1761,2350
0132-000,2015,5,28,11,853,855,1708,1761
0132-000,2015,5,28,12,821,860,1681,1708
0132-000,2015,5,28,13,753,804,1557,1681
0132-000,2015,5,28,14,851,792,1643,1557
0132-000,2015,5,28,15,878,840,1718,1643
0132-000,2015,5,28,16,924,816,1740,1718
0132-000,2015,5,28,17,916,807,1723,1740
0132-000,2015,5,28,18,1206,902,2108,1723
0132-000,2015,5,28,19,1408,844,2252,2108
0132-000,2015,5,28,20,985,684,1669,2252
0132-000,2015,5,28,21,869,562,1431,1669
0132-000,2015,5,28,22,665,463,1128,1431
0132-000,2015,5,28,23,416,338,754,1128
0132-000,2015,5,28,24,251,221,472,754
0132-000,2015,5,29,1,162,163,325,472
0132-000,2015,5,29,2,144,113,257,325
0132-000,2015,5,29,3,80,94,174,257
0132-000,2015,5,29,4,73,94,167,174
0132-000,2015,5,29,5,93,79,172,167
0132-000,2015,5,29,6,222,173,395,172
0132-000,2015,5,29,7,471,541,1012,395
0132-000,2015,5,29,8,734,1655,2389,1012
0132-000,2015,5,29,9,876,1387,2263,2389
0132-000,2015,5,29,10,825,854,1679,2263
0132-000,2015,5,29,11,836,842,1678,1679
0132-000,2015,5,29,12,833,840,1673,1678
0132-000,2015,5,29,13,774,783,1557,1673
0132-000,2015,5,29,14,863,765,1628,1557
0132-000,2015,5,29,15,839,866,1705,1628
0132-000,2015,5,29,16,971,880,1851,1705
0132-000,2015,5,29,17,1020,873,1893,1851
0132-000,2015,5,29,18,1314,963,2277,1893
0132-000,2015,5,29,19,1566,932,2498,2277
0132-000,2015,5,29,20,1185,768,1953,2498
0132-000,2015,5,29,21,914,591,1505,1953
0132-000,2015,5,29,22,644,522,1166,1505
0132-000,2015,5,29,23,440,378,818,1166
0132-000,2015,5,29,24,305,264,569,818
0132-000,2015,5,30,1,218,199,417,569
0132-000,2015,5,30,2,155,152,307,417
0132-000,2015,5,30,3,101,128,229,307
0132-000,2015,5,30,4,94,102,196,229
0132-000,2015,5,30,5,118,116,234,196
0132-000,2015,5,30,6,199,175,374,234
0132-000,2015,5,30,7,340,384,724,374
0132-000,2015,5,30,8,549,732,1281,724
0132-000,2015,5,30,9,709,899,1608,1281
0132-000,2015,5,30,10,753,965,1718,1608
0132-000,2015,5,30,11,759,997,1756,1718
0132-000,2015,5,30,12,876,949,1825,1756
0132-000,2015,5,30,13,782,894,1676,1825
0132-000,2015,5,30,14,795,835,1630,1676
0132-000,2015,5,30,15,818,855,1673,1630
0132-000,2015,5,30,16,953,874,1827,1673
0132-000,2015,5,30,17,1169,839,2008,1827
0132-000,2015,5,30,18,1311,791,2102,2008
0132-000,2015,5,30,19,1210,765,1975,2102
0132-000,2015,5,30,20,813,639,1452,1975
0132-000,2015,5,30,21,606,525,1131,1452
0132-000,2015,5,30,22,500,404,904,1131
0132-000,2015,5,30,23,371,335,706,904
0132-000,2015,5,30,24,253,228,481,706
0132-000,2015,5,31,1,185,188,373,481
0132-000,2015,5,31,2,142,131,273,373
0132-000,2015,5,31,3,108,112,220,273
0132-000,2015,5,31,4,70,80,150,220
0132-000,2015,5,31,5,85,94,179,150
0132-000,2015,5,31,6,158,129,287,179
0132-000,2015,5,31,7,261,279,540,287
0132-000,2015,5,31,8,317,388,705,540
0132-000,2015,5,31,9,403,495,898,705
0132-000,2015,5,31,10,452,625,1077,898
0132-000,2015,5,31,11,536,658,1194,1077
0132-000,2015,5,31,12,637,680,1317,1194
0132-000,2015,5,31,13,628,706,1334,1317
0132-000,2015,5,31,14,704,662,1366,1334
0132-000,2015,5,31,15,737,681,1418,1366
0132-000,2015,5,31,16,889,684,1573,1418
0132-000,2015,5,31,17,991,686,1677,1573
0132-000,2015,5,31,18,1122,756,1878,1677
0132-000,2015,5,31,19,1055,651,1706,1878
0132-000,2015,5,31,20,843,524,1367,1706
0132-000,2015,5,31,21,664,488,1152,1367
0132-000,2015,5,31,22,531,436,967,1152
0132-000,2015,5,31,23,352,311,663,967
0132-000,2015,5,31,24,205,201,406,663
0132-000,2015,6,1,1,123,114,237,406
0132-000,2015,6,1,2,78,103,181,237
0132-000,2015,6,1,3,56,60,116,181
0132-000,2015,6,1,4,47,65,112,116
0132-000,2015,6,1,5,86,85,171,112
0132-000,2015,6,1,6,206,225,431,171
0132-000,2015,6,1,7,506,618,1124,431
0132-000,2015,6,1,8,679,1834,2513,1124
0132-000,2015,6,1,9,901,1411,2312,2513
0132-000,2015,6,1,10,745,919,1664,2312
0132-000,2015,6,1,11,761,822,1583,1664
0132-000,2015,6,1,12,734,840,1574,1583
0132-000,2015,6,1,13,730,773,1503,1574
0132-000,2015,6,1,14,777,766,1543,1503
0132-000,2015,6,1,15,861,814,1675,1543
0132-000,2015,6,1,16,888,832,1720,1675
0132-000,2015,6,1,17,890,752,1642,1720
0132-000,2015,6,1,18,1164,905,2069,1642
0132-000,2015,6,1,19,1343,844,2187,2069
0132-000,2015,6,1,20,1026,671,1697,2187
0132-000,2015,6,1,21,876,528,1404,1697
0132-000,2015,6,1,22,683,443,1126,1404
0132-000,2015,6,1,23,380,309,689,1126
0132-000,2015,6,1,24,225,204,429,689
0132-000,2015,6,2,1,159,138,297,429
0132-000,2015,6,2,2,112,79,191,297
0132-000,2015,6,2,3,68,78,146,191
0132-000,2015,6,2,4,67,85,152,146
0132-000,2015,6,2,5,74,86,160,152
0132-000,2015,6,2,6,215,162,377,160
0132-000,2015,6,2,7,442,494,936,377
0132-000,2015,6,2,8,709,1152,1861,936
0132-000,2015,6,2,9,888,1734,2622,1861
0132-000,2015,6,2,10,783,901,1684,2622
0132-000,2015,6,2,11,831,887,1718,1684
0132-000,2015,6,2,12,799,789,1588,1718
0132-000,2015,6,2,13,627,705,1332,1588
0132-000,2015,6,2,14,774,776,1550,1332
0132-000,2015,6,2,15,807,780,1587,1550
0132-000,2015,6,2,16,857,690,1547,1587
0132-000,2015,6,2,17,908,812,1720,1547
0132-000,2015,6,2,18,1132,855,1987,1720
0132-000,2015,6,2,19,1318,859,2177,1987
0132-000,2015,6,2,20,1000,688,1688,2177
0132-000,2015,6,2,21,878,508,1386,1688
0132-000,2015,6,2,22,605,440,1045,1386
0132-000,2015,6,2,23,381,290,671,1045
0132-000,2015,6,2,24,245,190,435,671
0132-000,2015,6,3,1,151,138,289,435
0132-000,2015,6,3,2,110,97,207,289
0132-000,2015,6,3,3,84,83,167,207
0132-000,2015,6,3,4,78,76,154,167
0132-000,2015,6,3,5,75,79,154,154
0132-000,2015,6,3,6,214,177,391,154
0132-000,2015,6,3,7,468,542,1010,391
0132-000,2015,6,3,8,712,1671,2383,1010
0132-000,2015,6,3,9,822,1374,2196,2383
0132-000,2015,6,3,10,732,858,1590,2196
0132-000,2015,6,3,11,767,803,1570,1590
0132-000,2015,6,3,12,753,810,1563,1570
0132-000,2015,6,3,13,664,678,1342,1563
0132-000,2015,6,3,14,692,745,1437,1342
0132-000,2015,6,3,15,839,773,1612,1437
0132-000,2015,6,3,16,843,731,1574,1612
0132-000,2015,6,3,17,882,795,1677,1574
0132-000,2015,6,3,18,1152,898,2050,1677
0132-000,2015,6,3,19,1333,797,2130,2050
0132-000,2015,6,3,20,993,662,1655,2130
0132-000,2015,6,3,21,788,506,1294,1655
0132-000,2015,6,3,22,623,396,1019,1294
0132-000,2015,6,3,23,378,257,635,1019
0132-000,2015,6,3,24,235,155,390,635
0132-000,2015,6,4,1,177,148,325,390
0132-000,2015,6,4,2,110,73,183,325
0132-000,2015,6,4,3,71,103,174,183
0132-000,2015,6,4,4,91,79,170,174
0132-000,2015,6,4,5,65,86,151,170
0132-000,2015,6,4,6,235,183,418,151
0132-000,2015,6,4,7,465,525,990,418
0132-000,2015,6,4,8,701,1677,2378,990
0132-000,2015,6,4,9,880,1347,2227,2378
0132-000,2015,6,4,10,719,858,1577,2227
0132-000,2015,6,4,11,697,766,1463,1577
0132-000,2015,6,4,12,678,755,1433,1463
0132-000,2015,6,4,13,616,651,1267,1433
0132-000,2015,6,4,14,743,709,1452,1267
0132-000,2015,6,4,15,746,709,1455,1452
0132-000,2015,6,4,16,803,729,1532,1455
0132-000,2015,6,4,17,851,749,1600,1532
0132-000,2015,6,4,18,1078,813,1891,1600
0132-000,2015,6,4,19,1319,794,2113,1891
0132-000,2015,6,4,20,973,656,1629,2113
0132-000,2015,6,4,21,816,430,1246,1629
0132-000,2015,6,4,22,596,404,1000,1246
0132-000,2015,6,4,23,396,252,648,1000
0132-000,2015,6,4,24,230,169,399,648
0132-000,2015,6,5,1,159,137,296,399
0132-000,2015,6,5,2,120,88,208,296
0132-000,2015,6,5,3,69,83,152,208
0132-000,2015,6,5,4,72,65,137,152
0132-000,2015,6,5,5,78,81,159,137
0132-000,2015,6,5,6,202,155,357,159
0132-000,2015,6,5,7,463,488,951,357
0132-000,2015,6,5,8,619,1553,2172,951
0132-000,2015,6,5,9,818,1385,2203,2172
0132-000,2015,6,5,10,728,802,1530,2203
0132-000,2015,6,5,11,733,765,1498,1530
0132-000,2015,6,5,12,761,849,1610,1498
0132-000,2015,6,5,13,657,726,1383,1610
0132-000,2015,6,5,14,742,732,1474,1383
0132-000,2015,6,5,15,830,800,1630,1474
0132-000,2015,6,5,16,820,777,1597,1630
0132-000,2015,6,5,17,966,775,1741,1597
0132-000,2015,6,5,18,1207,845,2052,1741
0132-000,2015,6,5,19,1476,892,2368,2052
0132-000,2015,6,5,20,1086,765,1851,2368
0132-000,2015,6,5,21,840,511,1351,1851
0132-000,2015,6,5,22,627,449,1076,1351
0132-000,2015,6,5,23,391,295,686,1076
0132-000,2015,6,5,24,232,201,433,686
0132-000,2015,6,6,1,186,169,355,433
0132-000,2015,6,6,2,137,128,265,355
0132-000,2015,6,6,3,99,100,199,265
0132-000,2015,6,6,4,89,87,176,199
0132-000,2015,6,6,5,86,109,195,176
0132-000,2015,6,6,6,211,186,397,195
0132-000,2015,6,6,7,322,383,705,397
0132-000,2015,6,6,8,453,659,1112,705
0132-000,2015,6,6,9,618,799,1417,1112
0132-000,2015,6,6,10,575,799,1374,1417
0132-000,2015,6,6,11,621,935,1556,1374
0132-000,2015,6,6,12,619,890,1509,1556
0132-000,2015,6,6,13,641,717,1358,1509
0132-000,2015,6,6,14,732,714,1446,1358
0132-000,2015,6,6,15,660,709,1369,1446
0132-000,2015,6,6,16,773,646,1419,1369
0132-000,2015,6,6,17,751,707,1458,1419
0132-000,2015,6,6,18,1071,758,1829,1458
0132-000,2015,6,6,19,923,672,1595,1829
0132-000,2015,6,6,20,632,477,1109,1595
0132-000,2015,6,6,21,524,332,856,1109
0132-000,2015,6,6,22,433,323,756,856
0132-000,2015,6,6,23,317,224,541,756
0132-000,2015,6,6,24,197,188,385,541
0132-000,2015,6,7,1,144,131,275,385
0132-000,2015,6,7,2,90,90,180,275
0132-000,2015,6,7,3,69,63,132,180
0132-000,2015,6,7,4,72,49,121,132
0132-000,2015,6,7,5,82,79,161,121
0132-000,2015,6,7,6,127,114,241,161
0132-000,2015,6,7,7,236,225,461,241
0132-000,2015,6,7,8,228,336,564,461
0132-000,2015,6,7,9,321,396,717,564
0132-000,2015,6,7,10,328,485,813,717
0132-000,2015,6,7,11,414,527,941,813
0132-000,2015,6,7,12,387,447,834,941
0132-000,2015,6,7,13,453,531,984,834
0132-000,2015,6,7,14,516,509,1025,984
0132-000,2015,6,7,15,602,493,1095,1025
0132-000,2015,6,7,16,716,510,1226,1095
0132-000,2015,6,7,17,1021,510,1531,1226
0132-000,2015,6,7,18,980,536,1516,1531
0132-000,2015,6,7,19,1043,510,1553,1516
0132-000,2015,6,7,20,789,417,1206,1553
0132-000,2015,6,7,21,629,364,993,1206
0132-000,2015,6,7,22,461,313,774,993
0132-000,2015,6,7,23,301,239,540,774
0132-000,2015,6,7,24,166,158,324,540
0132-000,2015,6,8,1,97,102,199,324
0132-000,2015,6,8,2,76,67,143,199
0132-000,2015,6,8,3,56,48,104,143
0132-000,2015,6,8,4,37,53,90,104
0132-000,2015,6,8,5,75,78,153,90
0132-000,2015,6,8,6,229,191,420,153
0132-000,2015,6,8,7,508,613,1121,420
0132-000,2015,6,8,8,675,1751,2426,1121
0132-000,2015,6,8,9,843,1399,2242,2426
0132-000,2015,6,8,10,710,859,1569,2242
0132-000,2015,6,8,11,734,777,1511,1569
0132-000,2015,6,8,12,751,773,1524,1511
0132-000,2015,6,8,13,655,712,1367,1524
0132-000,2015,6,8,14,754,754,1508,1367
0132-000,2015,6,8,15,834,757,1591,1508
0132-000,2015,6,8,16,814,697,1511,1591
0132-000,2015,6,8,17,853,776,1629,1511
0132-000,2015,6,8,18,1080,843,1923,1629
0132-000,2015,6,8,19,1306,892,2198,1923
0132-000,2015,6,8,20,950,621,1571,2198
0132-000,2015,6,8,21,846,439,1285,1571
0132-000,2015,6,8,22,612,403,1015,1285
0132-000,2015,6,8,23,372,275,647,1015
0132-000,2015,6,8,24,214,155,369,647
0132-000,2015,6,9,1,175,127,302,369
0132-000,2015,6,9,2,98,84,182,302
0132-000,2015,6,9,3,89,73,162,182
0132-000,2015,6,9,4,62,82,144,162
0132-000,2015,6,9,5,91,97,188,144
0132-000,2015,6,9,6,209,167,376,188
0132-000,2015,6,9,7,436,506,942,376
0132-000,2015,6,9,8,667,1668,2335,942
0132-000,2015,6,9,9,799,1377,2176,2335
0132-000,2015,6,9,10,767,862,1629,2176
0132-000,2015,6,9,11,746,782,1528,1629
0132-000,2015,6,9,12,700,786,1486,1528
0132-000,2015,6,9,13,646,680,1326,1486
0132-000,2015,6,9,14,733,724,1457,1326
0132-000,2015,6,9,15,813,711,1524,1457
0132-000,2015,6,9,16,840,730,1570,1524
0132-000,2015,6,9,17,897,741,1638,1570
0132-000,2015,6,9,18,1080,802,1882,1638
0132-000,2015,6,9,19,1296,817,2113,1882
0132-000,2015,6,9,20,953,627,1580,2113
0132-000,2015,6,9,21,865,477,1342,1580
0132-000,2015,6,9,22,615,406,1021,1342
0132-000,2015,6,9,23,367,263,630,1021
0132-000,2015,6,9,24,205,167,372,630
0132-000,2015,6,10,1,168,129,297,372
0132-000,2015,6,10,2,101,80,181,297
0132-000,2015,6,10,3,78,76,154,181
0132-000,2015,6,10,4,68,67,135,154
0132-000,2015,6,10,5,103,95,198,135
0132-000,2015,6,10,6,212,186,398,198
0132-000,2015,6,10,7,447,537,984,398
0132-000,2015,6,10,8,667,1630,2297,984
0132-000,2015,6,10,9,809,1419,2228,2297
0132-000,2015,6,10,10,788,830,1618,2228
0132-000,2015,6,10,11,745,807,1552,1618
0132-000,2015,6,10,12,673,755,1428,1552
0132-000,2015,6,10,13,649,676,1325,1428
0132-000,2015,6,10,14,730,716,1446,1325
0132-000,2015,6,10,15,871,837,1708,1446
0132-000,2015,6,10,16,864,720,1584,1708
0132-000,2015,6,10,17,831,792,1623,1584
0132-000,2015,6,10,18,1115,777,1892,1623
0132-000,2015,6,10,19,1410,895,2305,1892
0132-000,2015,6,10,20,999,657,1656,2305
0132-000,2015,6,10,21,784,456,1240,1656
0132-000,2015,6,10,22,628,389,1017,1240
0132-000,2015,6,10,23,377,279,656,1017
0132-000,2015,6,10,24,218,143,361,656
0132-000,2015,6,11,1,175,144,319,361
0132-000,2015,6,11,2,115,98,213,319
0132-000,2015,6,11,3,82,81,163,213
0132-000,2015,6,11,4,69,94,163,163
0132-000,2015,6,11,5,107,90,197,163
0132-000,2015,6,11,6,214,222,436,197
0132-000,2015,6,11,7,458,532,990,436
0132-000,2015,6,11,8,661,1625,2286,990
0132-000,2015,6,11,9,759,1397,2156,2286
0132-000,2015,6,11,10,753,816,1569,2156
0132-000,2015,6,11,11,738,843,1581,1569
0132-000,2015,6,11,12,742,783,1525,1581
0132-000,2015,6,11,13,645,681,1326,1525
0132-000,2015,6,11,14,758,769,1527,1326
0132-000,2015,6,11,15,793,775,1568,1527
0132-000,2015,6,11,16,857,769,1626,1568
0132-000,2015,6,11,17,893,737,1630,1626
0132-000,2015,6,11,18,1078,846,1924,1630
0132-000,2015,6,11,19,1344,866,2210,1924
0132-000,2015,6,11,20,1029,633,1662,2210
0132-000,2015,6,11,21,852,452,1304,1662
0132-000,2015,6,11,22,562,392,954,1304
0132-000,2015,6,11,23,379,311,690,954
0132-000,2015,6,11,24,234,189,423,690
0132-000,2015,6,12,1,190,140,330,423
0132-000,2015,6,12,2,120,95,215,330
0132-000,2015,6,12,3,105,90,195,215
0132-000,2015,6,12,4,59,74,133,195
0132-000,2015,6,12,5,84,93,177,133
0132-000,2015,6,12,6,213,185,398,177
0132-000,2015,6,12,7,451,492,943,398
0132-000,2015,6,12,8,664,1612,2276,943
0132-000,2015,6,12,9,826,1341,2167,2276
0132-000,2015,6,12,10,794,830,1624,2167
0132-000,2015,6,12,11,748,851,1599,1624
0132-000,2015,6,12,12,755,824,1579,1599
0132-000,2015,6,12,13,713,713,1426,1579
0132-000,2015,6,12,14,784,753,1537,1426
0132-000,2015,6,12,15,817,771,1588,1537
0132-000,2015,6,12,16,888,753,1641,1588
0132-000,2015,6,12,17,920,802,1722,1641
0132-000,2015,6,12,18,1163,888,2051,1722
0132-000,2015,6,12,19,1554,991,2545,2051
0132-000,2015,6,12,20,1124,753,1877,2545
0132-000,2015,6,12,21,865,576,1441,1877
0132-000,2015,6,12,22,728,480,1208,1441
0132-000,2015,6,12,23,455,341,796,1208
0132-000,2015,6,12,24,231,226,457,796
0132-000,2015,6,13,1,234,178,412,457
0132-000,2015,6,13,2,148,133,281,412
0132-000,2015,6,13,3,115,96,211,281
0132-000,2015,6,13,4,94,111,205,211
0132-000,2015,6,13,5,126,124,250,205
0132-000,2015,6,13,6,225,188,413,250
0132-000,2015,6,13,7,379,395,774,413
0132-000,2015,6,13,8,496,829,1325,774
0132-000,2015,6,13,9,589,896,1485,1325
0132-000,2015,6,13,10,659,857,1516,1485
0132-000,2015,6,13,11,716,790,1506,1516
0132-000,2015,6,13,12,649,755,1404,1506
0132-000,2015,6,13,13,690,780,1470,1404
0132-000,2015,6,13,14,778,792,1570,1470
0132-000,2015,6,13,15,815,781,1596,1570
0132-000,2015,6,13,16,824,752,1576,1596
0132-000,2015,6,13,17,892,706,1598,1576
0132-000,2015,6,13,18,1153,823,1976,1598
0132-000,2015,6,13,19,1134,791,1925,1976
0132-000,2015,6,13,20,789,528,1317,1925
0132-000,2015,6,13,21,584,371,955,1317
0132-000,2015,6,13,22,492,374,866,955
0132-000,2015,6,13,23,339,263,602,866
0132-000,2015,6,13,24,252,214,466,602
0132-000,2015,6,14,1,159,147,306,466
0132-000,2015,6,14,2,134,105,239,306
0132-000,2015,6,14,3,106,90,196,239
0132-000,2015,6,14,4,73,65,138,196
0132-000,2015,6,14,5,75,91,166,138
0132-000,2015,6,14,6,163,126,289,166
0132-000,2015,6,14,7,202,210,412,289
0132-000,2015,6,14,8,261,271,532,412
0132-000,2015,6,14,9,291,406,697,532
0132-000,2015,6,14,10,363,550,913,697
0132-000,2015,6,14,11,408,599,1007,913
0132-000,2015,6,14,12,473,536,1009,1007
0132-000,2015,6,14,13,506,527,1033,1009
0132-000,2015,6,14,14,561,567,1128,1033
0132-000,2015,6,14,15,660,604,1264,1128
0132-000,2015,6,14,16,769,598,1367,1264
0132-000,2015,6,14,17,898,541,1439,1367
0132-000,2015,6,14,18,1073,555,1628,1439
0132-000,2015,6,14,19,978,457,1435,1628
0132-000,2015,6,14,20,740,469,1209,1435
0132-000,2015,6,14,21,575,420,995,1209
0132-000,2015,6,14,22,456,337,793,995
0132-000,2015,6,14,23,297,266,563,793
0132-000,2015,6,14,24,188,196,384,563
0132-000,2015,6,15,1,125,137,262,384
0132-000,2015,6,15,2,65,75,140,262
0132-000,2015,6,15,3,44,56,100,140
0132-000,2015,6,15,4,40,51,91,100
0132-000,2015,6,15,5,87,98,185,91
0132-000,2015,6,15,6,249,202,451,185
0132-000,2015,6,15,7,477,630,1107,451
0132-000,2015,6,15,8,694,1684,2378,1107
0132-000,2015,6,15,9,815,1514,2329,2378
0132-000,2015,6,15,10,746,871,1617,2329
0132-000,2015,6,15,11,729,799,1528,1617
0132-000,2015,6,15,12,717,796,1513,1528
0132-000,2015,6,15,13,722,749,1471,1513
0132-000,2015,6,15,14,791,773,1564,1471
0132-000,2015,6,15,15,840,819,1659,1564
0132-000,2015,6,15,16,827,728,1555,1659
0132-000,2015,6,15,17,913,754,1667,1555
0132-000,2015,6,15,18,1095,868,1963,1667
0132-000,2015,6,15,19,1350,861,2211,1963
0132-000,2015,6,15,20,939,671,1610,2211
0132-000,2015,6,15,21,930,517,1447,1610
0132-000,2015,6,15,22,603,373,976,1447
0132-000,2015,6,15,23,385,277,662,976
0132-000,2015,6,15,24,202,206,408,662
0132-000,2015,6,16,1,149,141,290,408
0132-000,2015,6,16,2,119,106,225,290
0132-000,2015,6,16,3,72,76,148,225
0132-000,2015,6,16,4,80,71,151,148
0132-000,2015,6,16,5,93,109,202,151
0132-000,2015,6,16,6,201,192,393,202
0132-000,2015,6,16,7,454,560,1014,393
0132-000,2015,6,16,8,680,1647,2327,1014
0132-000,2015,6,16,9,869,1398,2267,2327
0132-000,2015,6,16,10,727,855,1582,2267
0132-000,2015,6,16,11,779,786,1565,1582
0132-000,2015,6,16,12,711,811,1522,1565
0132-000,2015,6,16,13,716,764,1480,1522
0132-000,2015,6,16,14,799,785,1584,1480
0132-000,2015,6,16,15,816,840,1656,1584
0132-000,2015,6,16,16,919,743,1662,1656
0132-000,2015,6,16,17,894,761,1655,1662
0132-000,2015,6,16,18,1131,883,2014,1655
0132-000,2015,6,16,19,1377,853,2230,2014
0132-000,2015,6,16,20,978,706,1684,2230
0132-000,2015,6,16,21,841,482,1323,1684
0132-000,2015,6,16,22,593,436,1029,1323
0132-000,2015,6,16,23,410,294,704,1029
0132-000,2015,6,16,24,256,203,459,704
0132-000,2015,6,17,1,150,148,298,459
0132-000,2015,6,17,2,120,96,216,298
0132-000,2015,6,17,3,70,87,157,216
0132-000,2015,6,17,4,68,70,138,157
0132-000,2015,6,17,5,76,93,169,138
0132-000,2015,6,17,6,188,174,362,169
0132-000,2015,6,17,7,450,551,1001,362
0132-000,2015,6,17,8,729,1592,2321,1001
0132-000,2015,6,17,9,838,1426,2264,2321
0132-000,2015,6,17,10,704,864,1568,2264
0132-000,2015,6,17,11,738,749,1487,1568
0132-000,2015,6,17,12,758,786,1544,1487
0132-000,2015,6,17,13,666,736,1402,1544
0132-000,2015,6,17,14,768,705,1473,1402
0132-000,2015,6,17,15,855,782,1637,1473
0132-000,2015,6,17,16,805,761,1566,1637
0132-000,2015,6,17,17,956,761,1717,1566
0132-000,2015,6,17,18,1173,909,2082,1717
0132-000,2015,6,17,19,1579,906,2485,2082
0132-000,2015,6,17,20,995,646,1641,2485
0132-000,2015,6,17,21,748,521,1269,1641
0132-000,2015,6,17,22,565,386,951,1269
0132-000,2015,6,17,23,345,276,621,951
0132-000,2015,6,17,24,226,194,420,621
0132-000,2015,6,18,1,171,138,309,420
0132-000,2015,6,18,2,94,85,179,309
0132-000,2015,6,18,3,94,94,188,179
0132-000,2015,6,18,4,62,76,138,188
0132-000,2015,6,18,5,95,99,194,138
0132-000,2015,6,18,6,188,168,356,194
0132-000,2015,6,18,7,465,554,1019,356
0132-000,2015,6,18,8,687,1596,2283,1019
0132-000,2015,6,18,9,854,1482,2336,2283
0132-000,2015,6,18,10,718,864,1582,2336
0132-000,2015,6,18,11,740,786,1526,1582
0132-000,2015,6,18,12,765,803,1568,1526
0132-000,2015,6,18,13,677,711,1388,1568
0132-000,2015,6,18,14,729,735,1464,1388
0132-000,2015,6,18,15,807,797,1604,1464
0132-000,2015,6,18,16,931,749,1680,1604
0132-000,2015,6,18,17,875,757,1632,1680
0132-000,2015,6,18,18,1180,827,2007,1632
0132-000,2015,6,18,19,1384,816,2200,2007
0132-000,2015,6,18,20,974,665,1639,2200
0132-000,2015,6,18,21,833,545,1378,1639
0132-000,2015,6,18,22,616,456,1072,1378
0132-000,2015,6,18,23,391,326,717,1072
0132-000,2015,6,18,24,274,216,490,717
0132-000,2015,6,19,1,167,161,328,490
0132-000,2015,6,19,2,114,86,200,328
0132-000,2015,6,19,3,101,87,188,200
0132-000,2015,6,19,4,75,98,173,188
0132-000,2015,6,19,5,84,99,183,173
0132-000,2015,6,19,6,207,197,404,183
0132-000,2015,6,19,7,450,574,1024,404
0132-000,2015,6,19,8,695,1574,2269,1024
0132-000,2015,6,19,9,862,1389,2251,2269
0132-000,2015,6,19,10,754,874,1628,2251
0132-000,2015,6,19,11,782,830,1612,1628
0132-000,2015,6,19,12,785,838,1623,1612
0132-000,2015,6,19,13,671,719,1390,1623
0132-000,2015,6,19,14,815,796,1611,1390
0132-000,2015,6,19,15,868,801,1669,1611
0132-000,2015,6,19,16,909,794,1703,1669
0132-000,2015,6,19,17,1012,805,1817,1703
0132-000,2015,6,19,18,1278,952,2230,1817
0132-000,2015,6,19,19,1639,983,2622,2230
0132-000,2015,6,19,20,1226,841,2067,2622
0132-000,2015,6,19,21,1022,644,1666,2067
0132-000,2015,6,19,22,741,526,1267,1666
0132-000,2015,6,19,23,447,347,794,1267
0132-000,2015,6,19,24,294,253,547,794
0132-000,2015,6,20,1,212,178,390,547
0132-000,2015,6,20,2,147,142,289,390
0132-000,2015,6,20,3,108,115,223,289
0132-000,2015,6,20,4,88,108,196,223
0132-000,2015,6,20,5,94,124,218,196
0132-000,2015,6,20,6,208,190,398,218
0132-000,2015,6,20,7,325,385,710,398
0132-000,2015,6,20,8,461,713,1174,710
0132-000,2015,6,20,9,664,838,1502,1174
0132-000,2015,6,20,10,659,860,1519,1502
0132-000,2015,6,20,11,775,888,1663,1519
0132-000,2015,6,20,12,772,925,1697,1663
0132-000,2015,6,20,13,832,926,1758,1697
0132-000,2015,6,20,14,902,852,1754,1758
0132-000,2015,6,20,15,904,801,1705,1754
0132-000,2015,6,20,16,924,832,1756,1705
0132-000,2015,6,20,17,1059,797,1856,1756
0132-000,2015,6,20,18,1234,811,2045,1856
0132-000,2015,6,20,19,1112,772,1884,2045
0132-000,2015,6,20,20,719,510,1229,1884
0132-000,2015,6,20,21,558,398,956,1229
0132-000,2015,6,20,22,481,352,833,956
0132-000,2015,6,20,23,322,260,582,833
0132-000,2015,6,20,24,227,188,415,582
0132-000,2015,6,21,1,174,176,350,415
0132-000,2015,6,21,2,110,130,240,350
0132-000,2015,6,21,3,84,90,174,240
0132-000,2015,6,21,4,86,67,153,174
0132-000,2015,6,21,5,92,83,175,153
0132-000,2015,6,21,6,172,142,314,175
0132-000,2015,6,21,7,224,263,487,314
0132-000,2015,6,21,8,271,393,664,487
0132-000,2015,6,21,9,374,505,879,664
0132-000,2015,6,21,10,401,653,1054,879
0132-000,2015,6,21,11,480,642,1122,1054
0132-000,2015,6,21,12,523,642,1165,1122
0132-000,2015,6,21,13,556,622,1178,1165
0132-000,2015,6,21,14,644,693,1337,1178
0132-000,2015,6,21,15,726,643,1369,1337
0132-000,2015,6,21,16,852,657,1509,1369
0132-000,2015,6,21,17,943,648,1591,1509
0132-000,2015,6,21,18,1070,673,1743,1591
0132-000,2015,6,21,19,1156,525,1681,1743
0132-000,2015,6,21,20,856,515,1371,1681
0132-000,2015,6,21,21,749,470,1219,1371
0132-000,2015,6,21,22,552,388,940,1219
0132-000,2015,6,21,23,364,286,650,940
0132-000,2015,6,21,24,193,211,404,650
0132-000,2015,6,22,1,123,145,268,404
0132-000,2015,6,22,2,76,70,146,268
0132-000,2015,6,22,3,48,58,106,146
0132-000,2015,6,22,4,62,72,134,106
0132-000,2015,6,22,5,71,100,171,134
0132-000,2015,6,22,6,198,243,441,171
0132-000,2015,6,22,7,495,625,1120,441
0132-000,2015,6,22,8,733,1782,2515,1120
0132-000,2015,6,22,9,844,1424,2268,2515
0132-000,2015,6,22,10,719,867,1586,2268
0132-000,2015,6,22,11,734,811,1545,1586
0132-000,2015,6,22,12,745,762,1507,1545
0132-000,2015,6,22,13,713,729,1442,1507
0132-000,2015,6,22,14,785,765,1550,1442
0132-000,2015,6,22,15,824,805,1629,1550
0132-000,2015,6,22,16,896,827,1723,1629
0132-000,2015,6,22,17,878,793,1671,1723
0132-000,2015,6,22,18,1170,853,2023,1671
0132-000,2015,6,22,19,1380,932,2312,2023
0132-000,2015,6,22,20,972,667,1639,2312
0132-000,2015,6,22,21,796,528,1324,1639
0132-000,2015,6,22,22,581,415,996,1324
0132-000,2015,6,22,23,420,281,701,996
0132-000,2015,6,22,24,231,201,432,701
0132-000,2015,6,23,1,172,163,335,432
0132-000,2015,6,23,2,85,80,165,335
0132-000,2015,6,23,3,66,83,149,165
0132-000,2015,6,23,4,67,84,151,149
0132-000,2015,6,23,5,97,93,190,151
0132-000,2015,6,23,6,196,184,380,190
0132-000,2015,6,23,7,449,523,972,380
0132-000,2015,6,23,8,736,1669,2405,972
0132-000,2015,6,23,9,862,1452,2314,2405
0132-000,2015,6,23,10,818,814,1632,2314
0132-000,2015,6,23,11,756,853,1609,1632
0132-000,2015,6,23,12,770,748,1518,1609
0132-000,2015,6,23,13,687,725,1412,1518
0132-000,2015,6,23,14,777,724,1501,1412
0132-000,2015,6,23,15,830,795,1625,1501
0132-000,2015,6,23,16,859,694,1553,1625
0132-000,2015,6,23,17,939,785,1724,1553
0132-000,2015,6,23,18,1151,883,2034,1724
0132-000,2015,6,23,19,1327,890,2217,2034
0132-000,2015,6,23,20,946,672,1618,2217
0132-000,2015,6,23,21,828,536,1364,1618
0132-000,2015,6,23,22,701,493,1194,1364
0132-000,2015,6,23,23,423,326,749,1194
0132-000,2015,6,23,24,237,205,442,749
0132-000,2015,6,24,1,180,137,317,442
0132-000,2015,6,24,2,125,84,209,317
0132-000,2015,6,24,3,71,78,149,209
0132-000,2015,6,24,4,66,75,141,149
0132-000,2015,6,24,5,83,98,181,141
0132-000,2015,6,24,6,196,211,407,181
0132-000,2015,6,24,7,459,525,984,407
0132-000,2015,6,24,8,706,1613,2319,984
0132-000,2015,6,24,9,826,1425,2251,2319
0132-000,2015,6,24,10,783,810,1593,2251
0132-000,2015,6,24,11,790,870,1660,1593
0132-000,2015,6,24,12,776,858,1634,1660
0132-000,2015,6,24,13,739,687,1426,1634
0132-000,2015,6,24,14,775,736,1511,1426
0132-000,2015,6,24,15,870,797,1667,1511
0132-000,2015,6,24,16,884,791,1675,1667
0132-000,2015,6,24,17,887,776,1663,1675
0132-000,2015,6,24,18,1223,896,2119,1663
0132-000,2015,6,24,19,1436,872,2308,2119
0132-000,2015,6,24,20,958,666,1624,2308
0132-000,2015,6,24,21,808,536,1344,1624
0132-000,2015,6,24,22,556,415,971,1344
0132-000,2015,6,24,23,424,307,731,971
0132-000,2015,6,24,24,244,184,428,731
0132-000,2015,6,25,1,157,144,301,428
0132-000,2015,6,25,2,106,96,202,301
0132-000,2015,6,25,3,82,84,166,202
0132-000,2015,6,25,4,84,83,167,166
0132-000,2015,6,25,5,91,103,194,167
0132-000,2015,6,25,6,231,168,399,194
0132-000,2015,6,25,7,457,574,1031,399
0132-000,2015,6,25,8,698,1622,2320,1031
0132-000,2015,6,25,9,856,1435,2291,2320
0132-000,2015,6,25,10,796,821,1617,2291
0132-000,2015,6,25,11,800,820,1620,1617
0132-000,2015,6,25,12,762,833,1595,1620
0132-000,2015,6,25,13,686,693,1379,1595
0132-000,2015,6,25,14,822,719,1541,1379
0132-000,2015,6,25,15,884,843,1727,1541
0132-000,2015,6,25,16,896,730,1626,1727
0132-000,2015,6,25,17,914,823,1737,1626
0132-000,2015,6,25,18,1185,865,2050,1737
0132-000,2015,6,25,19,1457,895,2352,2050
0132-000,2015,6,25,20,985,685,1670,2352
0132-000,2015,6,25,21,763,512,1275,1670
0132-000,2015,6,25,22,586,406,992,1275
0132-000,2015,6,25,23,391,291,682,992
0132-000,2015,6,25,24,272,216,488,682
0132-000,2015,6,26,1,160,136,296,488
0132-000,2015,6,26,2,126,102,228,296
0132-000,2015,6,26,3,96,107,203,228
0132-000,2015,6,26,4,75,90,165,203
0132-000,2015,6,26,5,74,82,156,165
0132-000,2015,6,26,6,142,118,260,156
0132-000,2015,6,26,7,345,395,740,260
0132-000,2015,6,26,8,607,1504,2111,740
0132-000,2015,6,26,9,867,1381,2248,2111
0132-000,2015,6,26,10,690,800,1490,2248
0132-000,2015,6,26,11,770,801,1571,1490
0132-000,2015,6,26,12,730,788,1518,1571
0132-000,2015,6,26,13,723,723,1446,1518
0132-000,2015,6,26,14,774,756,1530,1446
0132-000,2015,6,26,15,845,807,1652,1530
0132-000,2015,6,26,16,922,857,1779,1652
0132-000,2015,6,26,17,955,862,1817,1779
0132-000,2015,6,26,18,1250,893,2143,1817
0132-000,2015,6,26,19,1588,957,2545,2143
0132-000,2015,6,26,20,1191,913,2104,2545
0132-000,2015,6,26,21,882,670,1552,2104
0132-000,2015,6,26,22,606,473,1079,1552
0132-000,2015,6,26,23,481,352,833,1079
0132-000,2015,6,26,24,312,285,597,833
0132-000,2015,6,27,1,212,240,452,597
0132-000,2015,6,27,2,145,177,322,452
0132-000,2015,6,27,3,111,114,225,322
0132-000,2015,6,27,4,87,92,179,225
0132-000,2015,6,27,5,129,147,276,179
0132-000,2015,6,27,6,214,207,421,276
0132-000,2015,6,27,7,384,412,796,421
0132-000,2015,6,27,8,520,774,1294,796
0132-000,2015,6,27,9,640,865,1505,1294
0132-000,2015,6,27,10,675,874,1549,1505
0132-000,2015,6,27,11,736,919,1655,1549
0132-000,2015,6,27,12,786,1010,1796,1655
0132-000,2015,6,27,13,802,942,1744,1796
0132-000,2015,6,27,14,815,822,1637,1744
0132-000,2015,6,27,15,817,826,1643,1637
0132-000,2015,6,27,16,893,836,1729,1643
0132-000,2015,6,27,17,946,855,1801,1729
0132-000,2015,6,27,18,1235,1024,2259,1801
0132-000,2015,6,27,19,1208,836,2044,2259
0132-000,2015,6,27,20,789,589,1378,2044
0132-000,2015,6,27,21,726,485,1211,1378
0132-000,2015,6,27,22,572,394,966,1211
0132-000,2015,6,27,23,378,359,737,966
0132-000,2015,6,27,24,241,250,491,737
0132-000,2015,6,28,1,165,193,358,491
0132-000,2015,6,28,2,124,133,257,358
0132-000,2015,6,28,3,82,97,179,257
0132-000,2015,6,28,4,87,92,179,179
0132-000,2015,6,28,5,90,92,182,179
0132-000,2015,6,28,6,136,141,277,182
0132-000,2015,6,28,7,233,271,504,277
0132-000,2015,6,28,8,294,382,676,504
0132-000,2015,6,28,9,353,485,838,676
0132-000,2015,6,28,10,457,556,1013,838
0132-000,2015,6,28,11,494,620,1114,1013
0132-000,2015,6,28,12,514,623,1137,1114
0132-000,2015,6,28,13,632,599,1231,1137
0132-000,2015,6,28,14,651,672,1323,1231
0132-000,2015,6,28,15,697,624,1321,1323
0132-000,2015,6,28,16,818,592,1410,1321
0132-000,2015,6,28,17,1002,637,1639,1410
0132-000,2015,6,28,18,1283,637,1920,1639
0132-000,2015,6,28,19,1343,557,1900,1920
0132-000,2015,6,28,20,868,536,1404,1900
0132-000,2015,6,28,21,708,440,1148,1404
0132-000,2015,6,28,22,528,423,951,1148
0132-000,2015,6,28,23,325,308,633,951
0132-000,2015,6,28,24,188,200,388,633
0132-000,2015,6,29,1,125,140,265,388
0132-000,2015,6,29,2,79,85,164,265
0132-000,2015,6,29,3,51,71,122,164
0132-000,2015,6,29,4,46,63,109,122
0132-000,2015,6,29,5,84,94,178,109
0132-000,2015,6,29,6,223,234,457,178
0132-000,2015,6,29,7,498,666,1164,457
0132-000,2015,6,29,8,690,1765,2455,1164
0132-000,2015,6,29,9,932,1553,2485,2455
0132-000,2015,6,29,10,759,840,1599,2485
0132-000,2015,6,29,11,792,845,1637,1599
0132-000,2015,6,29,12,761,851,1612,1637
0132-000,2015,6,29,13,754,734,1488,1612
0132-000,2015,6,29,14,803,764,1567,1488
0132-000,2015,6,29,15,876,843,1719,1567
0132-000,2015,6,29,16,918,814,1732,1719
0132-000,2015,6,29,17,933,715,1648,1732
0132-000,2015,6,29,18,1165,933,2098,1648
0132-000,2015,6,29,19,1387,906,2293,2098
0132-000,2015,6,29,20,992,714,1706,2293
0132-000,2015,6,29,21,859,480,1339,1706
0132-000,2015,6,29,22,606,456,1062,1339
0132-000,2015,6,29,23,411,338,749,1062
0132-000,2015,6,29,24,257,213,470,749
0132-000,2015,6,30,1,164,132,296,470
0132-000,2015,6,30,2,128,81,209,296
0132-000,2015,6,30,3,111,88,199,209
0132-000,2015,6,30,4,84,73,157,199
0132-000,2015,6,30,5,115,84,199,157
0132-000,2015,6,30,6,242,167,409,199
0132-000,2015,6,30,7,437,492,929,409
0132-000,2015,6,30,8,662,1561,2223,929
0132-000,2015,6,30,9,880,1483,2363,2223
0132-000,2015,6,30,10,787,825,1612,2363
0132-000,2015,6,30,11,795,847,1642,1612
0132-000,2015,6,30,12,749,800,1549,1642
0132-000,2015,6,30,13,698,716,1414,1549
0132-000,2015,6,30,14,789,692,1481,1414
0132-000,2015,6,30,15,834,813,1647,1481
0132-000,2015,6,30,16,914,802,1716,1647
0132-000,2015,6,30,17,944,773,1717,1716
0132-000,2015,6,30,18,1137,830,1967,1717
0132-000,2015,6,30,19,1330,890,2220,1967
0132-000,2015,6,30,20,920,666,1586,2220
0132-000,2015,6,30,21,791,510,1301,1586
0132-000,2015,6,30,22,628,419,1047,1301
0132-000,2015,6,30,23,373,319,692,1047
0132-000,2015,6,30,24,261,182,443,692
0132-000,2015,7,1,1,169,149,318,443
0132-000,2015,7,1,2,119,104,223,318
0132-000,2015,7,1,3,83,85,168,223
0132-000,2015,7,1,4,76,97,173,168
0132-000,2015,7,1,5,100,91,191,173
0132-000,2015,7,1,6,174,199,373,191
0132-000,2015,7,1,7,463,562,1025,373
0132-000,2015,7,1,8,697,1625,2322,1025
0132-000,2015,7,1,9,808,1409,2217,2322
0132-000,2015,7,1,10,768,823,1591,2217
0132-000,2015,7,1,11,744,795,1539,1591
0132-000,2015,7,1,12,758,748,1506,1539
0132-000,2015,7,1,13,701,683,1384,1506
0132-000,2015,7,1,14,749,756,1505,1384
0132-000,2015,7,1,15,823,807,1630,1505
0132-000,2015,7,1,16,921,790,1711,1630
0132-000,2015,7,1,17,915,745,1660,1711
0132-000,2015,7,1,18,1126,890,2016,1660
0132-000,2015,7,1,19,1422,867,2289,2016
0132-000,2015,7,1,20,1016,725,1741,2289
0132-000,2015,7,1,21,828,532,1360,1741
0132-000,2015,7,1,22,627,442,1069,1360
0132-000,2015,7,1,23,406,316,722,1069
0132-000,2015,7,1,24,251,213,464,722
0132-000,2015,7,2,1,174,156,330,464
0132-000,2015,7,2,2,113,98,211,330
0132-000,2015,7,2,3,86,86,172,211
0132-000,2015,7,2,4,80,87,167,172
0132-000,2015,7,2,5,84,97,181,167
0132-000,2015,7,2,6,219,187,406,181
0132-000,2015,7,2,7,455,493,948,406
0132-000,2015,7,2,8,669,1600,2269,948
0132-000,2015,7,2,9,852,1432,2284,2269
0132-000,2015,7,2,10,754,851,1605,2284
0132-000,2015,7,2,11,789,819,1608,1605
0132-000,2015,7,2,12,767,821,1588,1608
0132-000,2015,7,2,13,667,686,1353,1588
0132-000,2015,7,2,14,784,712,1496,1353
0132-000,2015,7,2,15,856,829,1685,1496
0132-000,2015,7,2,16,879,797,1676,1685
0132-000,2015,7,2,17,910,813,1723,1676
0132-000,2015,7,2,18,1129,872,2001,1723
0132-000,2015,7,2,19,1362,888,2250,2001
0132-000,2015,7,2,20,999,716,1715,2250
0132-000,2015,7,2,21,824,564,1388,1715
0132-000,2015,7,2,22,661,434,1095,1388
0132-000,2015,7,2,23,415,333,748,1095
0132-000,2015,7,2,24,279,194,473,748
0132-000,2015,7,3,1,191,162,353,473
0132-000,2015,7,3,2,114,106,220,353
0132-000,2015,7,3,3,92,86,178,220
0132-000,2015,7,3,4,69,90,159,178
0132-000,2015,7,3,5,95,112,207,159
0132-000,2015,7,3,6,199,191,390,207
0132-000,2015,7,3,7,496,492,988,390
0132-000,2015,7,3,8,690,1593,2283,988
0132-000,2015,7,3,9,860,1414,2274,2283
0132-000,2015,7,3,10,833,886,1719,2274
0132-000,2015,7,3,11,793,848,1641,1719
0132-000,2015,7,3,12,799,831,1630,1641
0132-000,2015,7,3,13,741,787,1528,1630
0132-000,2015,7,3,14,766,781,1547,1528
0132-000,2015,7,3,15,879,810,1689,1547
0132-000,2015,7,3,16,1008,823,1831,1689
0132-000,2015,7,3,17,971,856,1827,1831
0132-000,2015,7,3,18,1281,927,2208,1827
0132-000,2015,7,3,19,1603,954,2557,2208
0132-000,2015,7,3,20,1224,832,2056,2557
0132-000,2015,7,3,21,934,649,1583,2056
0132-000,2015,7,3,22,694,503,1197,1583
0132-000,2015,7,3,23,493,414,907,1197
0132-000,2015,7,3,24,307,287,594,907
0132-000,2015,7,4,1,195,190,385,594
0132-000,2015,7,4,2,139,121,260,385
0132-000,2015,7,4,3,136,122,258,260
0132-000,2015,7,4,4,92,116,208,258
0132-000,2015,7,4,5,117,105,222,208
0132-000,2015,7,4,6,226,194,420,222
0132-000,2015,7,4,7,452,425,877,420
0132-000,2015,7,4,8,537,812,1349,877
0132-000,2015,7,4,9,733,1287,2020,1349
0132-000,2015,7,4,10,699,1138,1837,2020
0132-000,2015,7,4,11,778,1117,1895,1837
0132-000,2015,7,4,12,812,1062,1874,1895
0132-000,2015,7,4,13,798,1059,1857,1874
0132-000,2015,7,4,14,841,954,1795,1857
0132-000,2015,7,4,15,1015,969,1984,1795
0132-000,2015,7,4,16,999,848,1847,1984
0132-000,2015,7,4,17,1036,808,1844,1847
0132-000,2015,7,4,18,1295,996,2291,1844
0132-000,2015,7,4,19,1184,831,2015,2291
0132-000,2015,7,4,20,884,693,1577,2015
0132-000,2015,7,4,21,659,572,1231,1577
0132-000,2015,7,4,22,567,446,1013,1231
0132-000,2015,7,4,23,390,341,731,1013
0132-000,2015,7,4,24,251,272,523,731
0132-000,2015,7,5,1,175,182,357,523
0132-000,2015,7,5,2,133,126,259,357
0132-000,2015,7,5,3,92,88,180,259
0132-000,2015,7,5,4,87,76,163,180
0132-000,2015,7,5,5,96,100,196,163
0132-000,2015,7,5,6,149,149,298,196
0132-000,2015,7,5,7,270,237,507,298
0132-000,2015,7,5,8,266,323,589,507
0132-000,2015,7,5,9,365,465,830,589
0132-000,2015,7,5,10,457,576,1033,830
0132-000,2015,7,5,11,506,684,1190,1033
0132-000,2015,7,5,12,525,683,1208,1190
0132-000,2015,7,5,13,646,700,1346,1208
0132-000,2015,7,5,14,673,646,1319,1346
0132-000,2015,7,5,15,768,675,1443,1319
0132-000,2015,7,5,16,870,731,1601,1443
0132-000,2015,7,5,17,967,652,1619,1601
0132-000,2015,7,5,18,1142,690,1832,1619
0132-000,2015,7,5,19,1042,650,1692,1832
0132-000,2015,7,5,20,872,566,1438,1692
0132-000,2015,7,5,21,636,461,1097,1438
0132-000,2015,7,5,22,508,381,889,1097
0132-000,2015,7,5,23,339,306,645,889
0132-000,2015,7,5,24,204,215,419,645
0132-000,2015,7,6,1,123,113,236,419
0132-000,2015,7,6,2,80,92,172,236
0132-000,2015,7,6,3,59,55,114,172
0132-000,2015,7,6,4,41,72,113,114
0132-000,2015,7,6,5,75,75,150,113
0132-000,2015,7,6,6,201,225,426,150
0132-000,2015,7,6,7,492,627,1119,426
0132-000,2015,7,6,8,685,1769,2454,1119
0132-000,2015,7,6,9,794,1502,2296,2454
0132-000,2015,7,6,10,787,839,1626,2296
0132-000,2015,7,6,11,804,875,1679,1626
0132-000,2015,7,6,12,809,811,1620,1679
0132-000,2015,7,6,13,823,719,1542,1620
0132-000,2015,7,6,14,815,818,1633,1542
0132-000,2015,7,6,15,881,822,1703,1633
0132-000,2015,7,6,16,932,849,1781,1703
0132-000,2015,7,6,17,900,742,1642,1781
0132-000,2015,7,6,18,1168,918,2086,1642
0132-000,2015,7,6,19,1338,844,2182,2086
0132-000,2015,7,6,20,1054,705,1759,2182
0132-000,2015,7,6,21,877,502,1379,1759
0132-000,2015,7,6,22,642,436,1078,1379
0132-000,2015,7,6,23,398,302,700,1078
0132-000,2015,7,6,24,233,196,429,700
0132-000,2015,7,7,1,139,153,292,429
0132-000,2015,7,7,2,95,76,171,292
0132-000,2015,7,7,3,75,87,162,171
0132-000,2015,7,7,4,66,81,147,162
0132-000,2015,7,7,5,80,93,173,147
0132-000,2015,7,7,6,185,180,365,173
0132-000,2015,7,7,7,475,528,1003,365
0132-000,2015,7,7,8,675,1556,2231,1003
0132-000,2015,7,7,9,829,1437,2266,2231
0132-000,2015,7,7,10,788,873,1661,2266
0132-000,2015,7,7,11,804,830,1634,1661
0132-000,2015,7,7,12,817,829,1646,1634
0132-000,2015,7,7,13,721,735,1456,1646
0132-000,2015,7,7,14,793,802,1595,1456
0132-000,2015,7,7,15,901,817,1718,1595
0132-000,2015,7,7,16,926,811,1737,1718
0132-000,2015,7,7,17,902,745,1647,1737
0132-000,2015,7,7,18,1174,892,2066,1647
0132-000,2015,7,7,19,1360,853,2213,2066
0132-000,2015,7,7,20,980,696,1676,2213
0132-000,2015,7,7,21,823,520,1343,1676
0132-000,2015,7,7,22,574,426,1000,1343
0132-000,2015,7,7,23,356,270,626,1000
0132-000,2015,7,7,24,231,211,442,626
0132-000,2015,7,8,1,151,143,294,442
0132-000,2015,7,8,2,103,92,195,294
0132-000,2015,7,8,3,78,84,162,195
0132-000,2015,7,8,4,74,83,157,162
0132-000,2015,7,8,5,77,92,169,157
0132-000,2015,7,8,6,184,158,342,169
0132-000,2015,7,8,7,431,463,894,342
0132-000,2015,7,8,8,666,1535,2201,894
0132-000,2015,7,8,9,859,1444,2303,2201
0132-000,2015,7,8,10,796,839,1635,2303
0132-000,2015,7,8,11,749,862,1611,1635
0132-000,2015,7,8,12,743,804,1547,1611
0132-000,2015,7,8,13,728,707,1435,1547
0132-000,2015,7,8,14,802,718,1520,1435
0132-000,2015,7,8,15,891,775,1666,1520
0132-000,2015,7,8,16,872,761,1633,1666
0132-000,2015,7,8,17,876,807,1683,1633
0132-000,2015,7,8,18,1185,869,2054,1683
0132-000,2015,7,8,19,1427,775,2202,2054
0132-000,2015,7,8,20,969,666,1635,2202
0132-000,2015,7,8,21,708,512,1220,1635
0132-000,2015,7,8,22,516,381,897,1220
0132-000,2015,7,8,23,365,337,702,897
0132-000,2015,7,8,24,250,212,462,702
0132-000,2015,7,9,1,162,156,318,462
0132-000,2015,7,9,2,124,107,231,318
0132-000,2015,7,9,3,77,88,165,231
0132-000,2015,7,9,4,84,101,185,165
0132-000,2015,7,9,5,85,72,157,185
0132-000,2015,7,9,6,178,150,328,157
0132-000,2015,7,9,7,465,476,941,328
0132-000,2015,7,9,8,657,1557,2214,941
0132-000,2015,7,9,9,863,1354,2217,2214
0132-000,2015,7,9,10,772,888,1660,2217
0132-000,2015,7,9,11,739,808,1547,1660
0132-000,2015,7,9,12,752,755,1507,1547
0132-000,2015,7,9,13,687,750,1437,1507
0132-000,2015,7,9,14,792,778,1570,1437
0132-000,2015,7,9,15,870,848,1718,1570
0132-000,2015,7,9,16,887,797,1684,1718
0132-000,2015,7,9,17,898,771,1669,1684
0132-000,2015,7,9,18,1168,872,2040,1669
0132-000,2015,7,9,19,1328,902,2230,2040
0132-000,2015,7,9,20,971,657,1628,2230
0132-000,2015,7,9,21,837,525,1362,1628
0132-000,2015,7,9,22,625,432,1057,1362
0132-000,2015,7,9,23,388,308,696,1057
0132-000,2015,7,9,24,287,224,511,696
0132-000,2015,7,10,1,152,181,333,511
0132-000,2015,7,10,2,125,119,244,333
0132-000,2015,7,10,3,88,109,197,244
0132-000,2015,7,10,4,77,85,162,197
0132-000,2015,7,10,5,84,93,177,162
0132-000,2015,7,10,6,181,183,364,177
0132-000,2015,7,10,7,469,518,987,364
0132-000,2015,7,10,8,685,1570,2255,987
0132-000,2015,7,10,9,840,1436,2276,2255
0132-000,2015,7,10,10,784,826,1610,2276
0132-000,2015,7,10,11,801,808,1609,1610
0132-000,2015,7,10,12,837,788,1625,1609
0132-000,2015,7,10,13,769,851,1620,1625
0132-000,2015,7,10,14,771,807,1578,1620
0132-000,2015,7,10,15,933,783,1716,1578
0132-000,2015,7,10,16,909,844,1753,1716
0132-000,2015,7,10,17,1013,890,1903,1753
0132-000,2015,7,10,18,1258,1040,2298,1903
0132-000,2015,7,10,19,1681,980,2661,2298
0132-000,2015,7,10,20,1282,879,2161,2661
0132-000,2015,7,10,21,989,645,1634,2161
0132-000,2015,7,10,22,715,518,1233,1634
0132-000,2015,7,10,23,519,412,931,1233
0132-000,2015,7,10,24,290,277,567,931
0132-000,2015,7,11,1,204,236,440,567
0132-000,2015,7,11,2,173,190,363,440
0132-000,2015,7,11,3,135,132,267,363
0132-000,2015,7,11,4,104,125,229,267
0132-000,2015,7,11,5,108,101,209,229
0132-000,2015,7,11,6,230,219,449,209
0132-000,2015,7,11,7,431,469,900,449
0132-000,2015,7,11,8,528,843,1371,900
0132-000,2015,7,11,9,761,970,1731,1371
0132-000,2015,7,11,10,791,940,1731,1731
0132-000,2015,7,11,11,811,954,1765,1731
0132-000,2015,7,11,12,802,1040,1842,1765
0132-000,2015,7,11,13,854,974,1828,1842
0132-000,2015,7,11,14,861,899,1760,1828
0132-000,2015,7,11,15,892,868,1760,1760
0132-000,2015,7,11,16,1085,810,1895,1760
0132-000,2015,7,11,17,1182,873,2055,1895
0132-000,2015,7,11,18,1353,971,2324,2055
0132-000,2015,7,11,19,1220,899,2119,2324
0132-000,2015,7,11,20,877,682,1559,2119
0132-000,2015,7,11,21,732,533,1265,1559
0132-000,2015,7,11,22,547,464,1011,1265
0132-000,2015,7,11,23,387,372,759,1011
0132-000,2015,7,11,24,244,270,514,759
0132-000,2015,7,12,1,176,200,376,514
0132-000,2015,7,12,2,140,132,272,376
0132-000,2015,7,12,3,105,106,211,272
0132-000,2015,7,12,4,80,86,166,211
0132-000,2015,7,12,5,70,71,141,166
0132-000,2015,7,12,6,130,116,246,141
0132-000,2015,7,12,7,185,176,361,246
0132-000,2015,7,12,8,216,345,561,361
0132-000,2015,7,12,9,344,402,746,561
0132-000,2015,7,12,10,389,452,841,746
0132-000,2015,7,12,11,478,500,978,841
0132-000,2015,7,12,12,541,590,1131,978
0132-000,2015,7,12,13,606,590,1196,1131
0132-000,2015,7,12,14,686,600,1286,1196
0132-000,2015,7,12,15,787,677,1464,1286
0132-000,2015,7,12,16,729,645,1374,1464
0132-000,2015,7,12,17,1034,637,1671,1374
0132-000,2015,7,12,18,1026,564,1590,1671
0132-000,2015,7,12,19,911,508,1419,1590
0132-000,2015,7,12,20,804,482,1286,1419
0132-000,2015,7,12,21,661,397,1058,1286
0132-000,2015,7,12,22,400,365,765,1058
0132-000,2015,7,12,23,232,261,493,765
0132-000,2015,7,12,24,143,176,319,493
0132-000,2015,7,13,1,118,114,232,319
0132-000,2015,7,13,2,80,92,172,232
0132-000,2015,7,13,3,44,60,104,172
0132-000,2015,7,13,4,41,52,93,104
0132-000,2015,7,13,5,55,58,113,93
0132-000,2015,7,13,6,193,173,366,113
0132-000,2015,7,13,7,397,634,1031,366
0132-000,2015,7,13,8,676,1737,2413,1031
0132-000,2015,7,13,9,816,1396,2212,2413
0132-000,2015,7,13,10,748,821,1569,2212
0132-000,2015,7,13,11,807,818,1625,1569
0132-000,2015,7,13,12,745,752,1497,1625
0132-000,2015,7,13,13,718,728,1446,1497
0132-000,2015,7,13,14,763,783,1546,1446
0132-000,2015,7,13,15,859,771,1630,1546
0132-000,2015,7,13,16,906,767,1673,1630
0132-000,2015,7,13,17,853,763,1616,1673
0132-000,2015,7,13,18,1081,826,1907,1616
0132-000,2015,7,13,19,1251,826,2077,1907
0132-000,2015,7,13,20,960,642,1602,2077
0132-000,2015,7,13,21,790,489,1279,1602
0132-000,2015,7,13,22,592,430,1022,1279
0132-000,2015,7,13,23,341,291,632,1022
0132-000,2015,7,13,24,233,189,422,632
0132-000,2015,7,14,1,149,151,300,422
0132-000,2015,7,14,2,102,96,198,300
0132-000,2015,7,14,3,70,83,153,198
0132-000,2015,7,14,4,82,99,181,153
0132-000,2015,7,14,5,90,89,179,181
0132-000,2015,7,14,6,202,172,374,179
0132-000,2015,7,14,7,466,565,1031,374
0132-000,2015,7,14,8,681,1641,2322,1031
0132-000,2015,7,14,9,869,1382,2251,2322
0132-000,2015,7,14,10,842,835,1677,2251
0132-000,2015,7,14,11,802,850,1652,1677
0132-000,2015,7,14,12,725,903,1628,1652
0132-000,2015,7,14,13,770,731,1501,1628
0132-000,2015,7,14,14,782,798,1580,1501
0132-000,2015,7,14,15,938,817,1755,1580
0132-000,2015,7,14,16,916,772,1688,1755
0132-000,2015,7,14,17,874,762,1636,1688
0132-000,2015,7,14,18,1216,870,2086,1636
0132-000,2015,7,14,19,1372,896,2268,2086
0132-000,2015,7,14,20,1002,683,1685,2268
0132-000,2015,7,14,21,831,543,1374,1685
0132-000,2015,7,14,22,630,466,1096,1374
0132-000,2015,7,14,23,375,328,703,1096
0132-000,2015,7,14,24,240,214,454,703
0132-000,2015,7,15,1,172,155,327,454
0132-000,2015,7,15,2,115,110,225,327
0132-000,2015,7,15,3,78,111,189,225
0132-000,2015,7,15,4,75,93,168,189
0132-000,2015,7,15,5,100,82,182,168
0132-000,2015,7,15,6,212,190,402,182
0132-000,2015,7,15,7,453,540,993,402
0132-000,2015,7,15,8,732,1593,2325,993
0132-000,2015,7,15,9,831,1380,2211,2325
0132-000,2015,7,15,10,799,868,1667,2211
0132-000,2015,7,15,11,781,841,1622,1667
0132-000,2015,7,15,12,779,812,1591,1622
0132-000,2015,7,15,13,750,713,1463,1591
0132-000,2015,7,15,14,789,776,1565,1463
0132-000,2015,7,15,15,827,761,1588,1565
0132-000,2015,7,15,16,878,777,1655,1588
0132-000,2015,7,15,17,927,827,1754,1655
0132-000,2015,7,15,18,1159,841,2000,1754
0132-000,2015,7,15,19,1513,925,2438,2000
0132-000,2015,7,15,20,1002,725,1727,2438
0132-000,2015,7,15,21,831,576,1407,1727
0132-000,2015,7,15,22,572,455,1027,1407
0132-000,2015,7,15,23,401,332,733,1027
0132-000,2015,7,15,24,273,229,502,733
0132-000,2015,7,16,1,205,163,368,502
0132-000,2015,7,16,2,116,98,214,368
0132-000,2015,7,16,3,79,106,185,214
0132-000,2015,7,16,4,83,93,176,185
0132-000,2015,7,16,5,76,101,177,176
0132-000,2015,7,16,6,227,204,431,177
0132-000,2015,7,16,7,455,596,1051,431
0132-000,2015,7,16,8,745,1645,2390,1051
0132-000,2015,7,16,9,836,1421,2257,2390
0132-000,2015,7,16,10,769,830,1599,2257
0132-000,2015,7,16,11,805,829,1634,1599
0132-000,2015,7,16,12,827,772,1599,1634
0132-000,2015,7,16,13,739,745,1484,1599
0132-000,2015,7,16,14,829,770,1599,1484
0132-000,2015,7,16,15,885,808,1693,1599
0132-000,2015,7,16,16,925,808,1733,1693
0132-000,2015,7,16,17,905,848,1753,1733
0132-000,2015,7,16,18,1161,873,2034,1753
0132-000,2015,7,16,19,1399,882,2281,2034
0132-000,2015,7,16,20,976,700,1676,2281
0132-000,2015,7,16,21,863,618,1481,1676
0132-000,2015,7,16,22,686,428,1114,1481
0132-000,2015,7,16,23,456,321,777,1114
0132-000,2015,7,16,24,333,219,552,777
0132-000,2015,7,17,1,180,155,335,552
0132-000,2015,7,17,2,124,112,236,335
0132-000,2015,7,17,3,86,92,178,236
0132-000,2015,7,17,4,91,89,180,178
0132-000,2015,7,17,5,82,110,192,180
0132-000,2015,7,17,6,230,199,429,192
0132-000,2015,7,17,7,473,595,1068,429
0132-000,2015,7,17,8,691,1604,2295,1068
0132-000,2015,7,17,9,865,1406,2271,2295
0132-000,2015,7,17,10,776,827,1603,2271
0132-000,2015,7,17,11,795,825,1620,1603
0132-000,2015,7,17,12,768,844,1612,1620
0132-000,2015,7,17,13,822,832,1654,1612
0132-000,2015,7,17,14,874,793,1667,1654
0132-000,2015,7,17,15,881,904,1785,1667
0132-000,2015,7,17,16,918,893,1811,1785
0132-000,2015,7,17,17,1025,899,1924,1811
0132-000,2015,7,17,18,1117,958,2075,1924
0132-000,2015,7,17,19,1594,960,2554,2075
0132-000,2015,7,17,20,1368,784,2152,2554
0132-000,2015,7,17,21,874,603,1477,2152
0132-000,2015,7,17,22,692,504,1196,1477
0132-000,2015,7,17,23,430,356,786,1196
0132-000,2015,7,17,24,295,261,556,786
0132-000,2015,7,18,1,208,224,432,556
0132-000,2015,7,18,2,134,136,270,432
0132-000,2015,7,18,3,103,120,223,270
0132-000,2015,7,18,4,88,106,194,223
0132-000,2015,7,18,5,102,115,217,194
0132-000,2015,7,18,6,239,190,429,217
0132-000,2015,7,18,7,428,473,901,429
0132-000,2015,7,18,8,521,899,1420,901
0132-000,2015,7,18,9,688,949,1637,1420
0132-000,2015,7,18,10,731,877,1608,1637
0132-000,2015,7,18,11,784,964,1748,1608
0132-000,2015,7,18,12,831,1014,1845,1748
0132-000,2015,7,18,13,878,979,1857,1845
0132-000,2015,7,18,14,899,944,1843,1857
0132-000,2015,7,18,15,974,821,1795,1843
0132-000,2015,7,18,16,951,805,1756,1795
0132-000,2015,7,18,17,991,921,1912,1756
0132-000,2015,7,18,18,1342,950,2292,1912
0132-000,2015,7,18,19,1405,970,2375,2292
0132-000,2015,7,18,20,928,576,1504,2375
0132-000,2015,7,18,21,771,546,1317,1504
0132-000,2015,7,18,22,505,415,920,1317
0132-000,2015,7,18,23,366,318,684,920
0132-000,2015,7,18,24,248,253,501,684
0132-000,2015,7,19,1,180,168,348,501
0132-000,2015,7,19,2,114,113,227,348
0132-000,2015,7,19,3,84,90,174,227
0132-000,2015,7,19,4,70,80,150,174
0132-000,2015,7,19,5,71,59,130,150
0132-000,2015,7,19,6,108,103,211,130
0132-000,2015,7,19,7,224,222,446,211
0132-000,2015,7,19,8,244,462,706,446
0132-000,2015,7,19,9,409,547,956,706
0132-000,2015,7,19,10,437,542,979,956
0132-000,2015,7,19,11,546,602,1148,979
0132-000,2015,7,19,12,539,668,1207,1148
0132-000,2015,7,19,13,674,708,1382,1207
0132-000,2015,7,19,14,769,762,1531,1382
0132-000,2015,7,19,15,737,768,1505,1531
0132-000,2015,7,19,16,891,675,1566,1505
0132-000,2015,7,19,17,1138,681,1819,1566
0132-000,2015,7,19,18,1255,604,1859,1819
0132-000,2015,7,19,19,1108,590,1698,1859
0132-000,2015,7,19,20,887,556,1443,1698
0132-000,2015,7,19,21,818,479,1297,1443
0132-000,2015,7,19,22,545,403,948,1297
0132-000,2015,7,19,23,349,298,647,948
0132-000,2015,7,19,24,178,209,387,647
0132-000,2015,7,20,1,133,145,278,387
0132-000,2015,7,20,2,66,83,149,278
0132-000,2015,7,20,3,58,67,125,149
0132-000,2015,7,20,4,53,70,123,125
0132-000,2015,7,20,5,75,80,155,123
0132-000,2015,7,20,6,218,205,423,155
0132-000,2015,7,20,7,517,692,1209,423
0132-000,2015,7,20,8,719,1805,2524,1209
0132-000,2015,7,20,9,859,1451,2310,2524
0132-000,2015,7,20,10,761,820,1581,2310
0132-000,2015,7,20,11,782,801,1583,1581
0132-000,2015,7,20,12,830,848,1678,1583
0132-000,2015,7,20,13,768,797,1565,1678
0132-000,2015,7,20,14,822,800,1622,1565
0132-000,2015,7,20,15,851,839,1690,1622
0132-000,2015,7,20,16,855,729,1584,1690
0132-000,2015,7,20,17,916,761,1677,1584
0132-000,2015,7,20,18,1119,864,1983,1677
0132-000,2015,7,20,19,1377,887,2264,1983
0132-000,2015,7,20,20,952,732,1684,2264
0132-000,2015,7,20,21,870,541,1411,1684
0132-000,2015,7,20,22,618,478,1096,1411
0132-000,2015,7,20,23,382,299,681,1096
0132-000,2015,7,20,24,246,207,453,681
0132-000,2015,7,21,1,144,132,276,453
0132-000,2015,7,21,2,111,96,207,276
0132-000,2015,7,21,3,82,81,163,207
0132-000,2015,7,21,4,92,95,187,163
0132-000,2015,7,21,5,79,94,173,187
0132-000,2015,7,21,6,205,159,364,173
0132-000,2015,7,21,7,424,513,937,364
0132-000,2015,7,21,8,648,1627,2275,937
0132-000,2015,7,21,9,859,1382,2241,2275
0132-000,2015,7,21,10,787,868,1655,2241
0132-000,2015,7,21,11,800,836,1636,1655
0132-000,2015,7,21,12,762,833,1595,1636
0132-000,2015,7,21,13,717,771,1488,1595
0132-000,2015,7,21,14,866,775,1641,1488
0132-000,2015,7,21,15,876,819,1695,1641
0132-000,2015,7,21,16,963,821,1784,1695
0132-000,2015,7,21,17,917,778,1695,1784
0132-000,2015,7,21,18,1197,822,2019,1695
0132-000,2015,7,21,19,1308,896,2204,2019
0132-000,2015,7,21,20,923,662,1585,2204
0132-000,2015,7,21,21,811,541,1352,1585
0132-000,2015,7,21,22,600,430,1030,1352
0132-000,2015,7,21,23,383,307,690,1030
0132-000,2015,7,21,24,251,182,433,690
0132-000,2015,7,22,1,179,166,345,433
0132-000,2015,7,22,2,107,95,202,345
0132-000,2015,7,22,3,81,97,178,202
0132-000,2015,7,22,4,64,98,162,178
0132-000,2015,7,22,5,75,99,174,162
0132-000,2015,7,22,6,197,163,360,174
0132-000,2015,7,22,7,465,539,1004,360
0132-000,2015,7,22,8,690,1664,2354,1004
0132-000,2015,7,22,9,883,1378,2261,2354
0132-000,2015,7,22,10,782,850,1632,2261
0132-000,2015,7,22,11,772,794,1566,1632
0132-000,2015,7,22,12,782,808,1590,1566
0132-000,2015,7,22,13,759,774,1533,1590
0132-000,2015,7,22,14,799,759,1558,1533
0132-000,2015,7,22,15,884,852,1736,1558
0132-000,2015,7,22,16,884,758,1642,1736
0132-000,2015,7,22,17,873,843,1716,1642
0132-000,2015,7,22,18,1209,920,2129,1716
0132-000,2015,7,22,19,1471,883,2354,2129
0132-000,2015,7,22,20,973,719,1692,2354
0132-000,2015,7,22,21,799,541,1340,1692
0132-000,2015,7,22,22,576,443,1019,1340
0132-000,2015,7,22,23,380,351,731,1019
0132-000,2015,7,22,24,275,239,514,731
0132-000,2015,7,23,1,190,187,377,514
0132-000,2015,7,23,2,123,95,218,377
0132-000,2015,7,23,3,74,105,179,218
0132-000,2015,7,23,4,69,87,156,179
0132-000,2015,7,23,5,100,104,204,156
0132-000,2015,7,23,6,182,164,346,204
0132-000,2015,7,23,7,444,606,1050,346
0132-000,2015,7,23,8,693,1550,2243,1050
0132-000,2015,7,23,9,863,1353,2216,2243
0132-000,2015,7,23,10,787,893,1680,2216
0132-000,2015,7,23,11,796,805,1601,1680
0132-000,2015,7,23,12,800,797,1597,1601
0132-000,2015,7,23,13,716,722,1438,1597
0132-000,2015,7,23,14,828,814,1642,1438
0132-000,2015,7,23,15,910,888,1798,1642
0132-000,2015,7,23,16,849,813,1662,1798
0132-000,2015,7,23,17,891,794,1685,1662
0132-000,2015,7,23,18,1297,851,2148,1685
0132-000,2015,7,23,19,1494,852,2346,2148
0132-000,2015,7,23,20,1024,614,1638,2346
0132-000,2015,7,23,21,775,519,1294,1638
0132-000,2015,7,23,22,608,464,1072,1294
0132-000,2015,7,23,23,346,334,680,1072
0132-000,2015,7,23,24,252,198,450,680
0132-000,2015,7,24,1,170,161,331,450
0132-000,2015,7,24,2,118,107,225,331
0132-000,2015,7,24,3,77,96,173,225
0132-000,2015,7,24,4,66,77,143,173
0132-000,2015,7,24,5,79,87,166,143
0132-000,2015,7,24,6,142,146,288,166
0132-000,2015,7,24,7,345,453,798,288
0132-000,2015,7,24,8,597,1416,2013,798
0132-000,2015,7,24,9,809,1384,2193,2013
0132-000,2015,7,24,10,664,748,1412,2193
0132-000,2015,7,24,11,754,703,1457,1412
0132-000,2015,7,24,12,702,799,1501,1457
0132-000,2015,7,24,13,754,836,1590,1501
0132-000,2015,7,24,14,808,801,1609,1590
0132-000,2015,7,24,15,866,844,1710,1609
0132-000,2015,7,24,16,937,794,1731,1710
0132-000,2015,7,24,17,922,810,1732,1731
0132-000,2015,7,24,18,1272,831,2103,1732
0132-000,2015,7,24,19,1478,877,2355,2103
0132-000,2015,7,24,20,980,752,1732,2355
0132-000,2015,7,24,21,898,566,1464,1732
0132-000,2015,7,24,22,591,476,1067,1464
0132-000,2015,7,24,23,446,335,781,1067
0132-000,2015,7,24,24,275,241,516,781
0132-000,2015,7,25,1,212,204,416,516
0132-000,2015,7,25,2,176,140,316,416
0132-000,2015,7,25,3,122,126,248,316
0132-000,2015,7,25,4,80,119,199,248
0132-000,2015,7,25,5,102,115,217,199
0132-000,2015,7,25,6,183,145,328,217
0132-000,2015,7,25,7,360,357,717,328
0132-000,2015,7,25,8,465,758,1223,717
0132-000,2015,7,25,9,611,873,1484,1223
0132-000,2015,7,25,10,691,819,1510,1484
0132-000,2015,7,25,11,727,924,1651,1510
0132-000,2015,7,25,12,832,1128,1960,1651
0132-000,2015,7,25,13,914,1167,2081,1960
0132-000,2015,7,25,14,874,1217,2091,2081
0132-000,2015,7,25,15,926,1041,1967,2091
0132-000,2015,7,25,16,985,912,1897,1967
0132-000,2015,7,25,17,1129,899,2028,1897
0132-000,2015,7,25,18,1298,894,2192,2028
0132-000,2015,7,25,19,1199,800,1999,2192
0132-000,2015,7,25,20,907,596,1503,1999
0132-000,2015,7,25,21,711,506,1217,1503
0132-000,2015,7,25,22,512,426,938,1217
0132-000,2015,7,25,23,343,324,667,938
0132-000,2015,7,25,24,249,228,477,667
0132-000,2015,7,26,1,178,190,368,477
0132-000,2015,7,26,2,143,142,285,368
0132-000,2015,7,26,3,93,93,186,285
0132-000,2015,7,26,4,79,87,166,186
0132-000,2015,7,26,5,80,85,165,166
0132-000,2015,7,26,6,151,111,262,165
0132-000,2015,7,26,7,258,227,485,262
0132-000,2015,7,26,8,293,356,649,485
0132-000,2015,7,26,9,377,450,827,649
0132-000,2015,7,26,10,432,556,988,827
0132-000,2015,7,26,11,523,646,1169,988
0132-000,2015,7,26,12,570,653,1223,1169
0132-000,2015,7,26,13,619,659,1278,1223
0132-000,2015,7,26,14,746,726,1472,1278
0132-000,2015,7,26,15,763,719,1482,1472
0132-000,2015,7,26,16,858,696,1554,1482
0132-000,2015,7,26,17,981,653,1634,1554
0132-000,2015,7,26,18,1048,681,1729,1634
0132-000,2015,7,26,19,936,598,1534,1729
0132-000,2015,7,26,20,753,513,1266,1534
0132-000,2015,7,26,21,803,493,1296,1266
0132-000,2015,7,26,22,541,461,1002,1296
0132-000,2015,7,26,23,338,325,663,1002
0132-000,2015,7,26,24,202,217,419,663
0132-000,2015,7,27,1,126,138,264,419
0132-000,2015,7,27,2,88,102,190,264
0132-000,2015,7,27,3,56,66,122,190
0132-000,2015,7,27,4,49,62,111,122
0132-000,2015,7,27,5,67,92,159,111
0132-000,2015,7,27,6,221,194,415,159
0132-000,2015,7,27,7,477,662,1139,415
0132-000,2015,7,27,8,732,1758,2490,1139
0132-000,2015,7,27,9,810,1300,2110,2490
0132-000,2015,7,27,10,729,880,1609,2110
0132-000,2015,7,27,11,808,845,1653,1609
0132-000,2015,7,27,12,807,884,1691,1653
0132-000,2015,7,27,13,836,849,1685,1691
0132-000,2015,7,27,14,809,875,1684,1685
0132-000,2015,7,27,15,886,865,1751,1684
0132-000,2015,7,27,16,932,863,1795,1751
0132-000,2015,7,27,17,880,787,1667,1795
0132-000,2015,7,27,18,1207,856,2063,1667
0132-000,2015,7,27,19,1356,894,2250,2063
0132-000,2015,7,27,20,977,730,1707,2250
0132-000,2015,7,27,21,871,534,1405,1707
0132-000,2015,7,27,22,592,440,1032,1405
0132-000,2015,7,27,23,377,342,719,1032
0132-000,2015,7,27,24,226,190,416,719
0132-000,2015,7,28,1,179,143,322,416
0132-000,2015,7,28,2,104,97,201,322
0132-000,2015,7,28,3,65,79,144,201
0132-000,2015,7,28,4,61,94,155,144
0132-000,2015,7,28,5,93,84,177,155
0132-000,2015,7,28,6,191,166,357,177
0132-000,2015,7,28,7,440,574,1014,357
0132-000,2015,7,28,8,678,1602,2280,1014
0132-000,2015,7,28,9,816,1292,2108,2280
0132-000,2015,7,28,10,777,810,1587,2108
0132-000,2015,7,28,11,788,875,1663,1587
0132-000,2015,7,28,12,821,835,1656,1663
0132-000,2015,7,28,13,784,796,1580,1656
0132-000,2015,7,28,14,782,842,1624,1580
0132-000,2015,7,28,15,1013,836,1849,1624
0132-000,2015,7,28,16,1181,796,1977,1849
0132-000,2015,7,28,17,1152,920,2072,1977
0132-000,2015,7,28,18,1278,987,2265,2072
0132-000,2015,7,28,19,1377,903,2280,2265
0132-000,2015,7,28,20,1009,712,1721,2280
0132-000,2015,7,28,21,829,567,1396,1721
0132-000,2015,7,28,22,583,465,1048,1396
0132-000,2015,7,28,23,371,381,752,1048
0132-000,2015,7,28,24,263,220,483,752
0132-000,2015,7,29,1,171,176,347,483
0132-000,2015,7,29,2,122,118,240,347
0132-000,2015,7,29,3,82,100,182,240
0132-000,2015,7,29,4,91,84,175,182
0132-000,2015,7,29,5,83,86,169,175
0132-000,2015,7,29,6,177,160,337,169
0132-000,2015,7,29,7,394,506,900,337
0132-000,2015,7,29,8,677,1516,2193,900
0132-000,2015,7,29,9,790,1254,2044,2193
0132-000,2015,7,29,10,719,764,1483,2044
0132-000,2015,7,29,11,686,820,1506,1483
0132-000,2015,7,29,12,722,871,1593,1506
0132-000,2015,7,29,13,716,981,1697,1593
0132-000,2015,7,29,14,801,1125,1926,1697
0132-000,2015,7,29,15,923,1160,2083,1926
0132-000,2015,7,29,16,905,961,1866,2083
0132-000,2015,7,29,17,883,799,1682,1866
0132-000,2015,7,29,18,1143,809,1952,1682
0132-000,2015,7,29,19,1523,846,2369,1952
0132-000,2015,7,29,20,934,695,1629,2369
0132-000,2015,7,29,21,834,624,1458,1629
0132-000,2015,7,29,22,588,460,1048,1458
0132-000,2015,7,29,23,387,350,737,1048
0132-000,2015,7,29,24,266,237,503,737
0132-000,2015,7,30,1,189,174,363,503
0132-000,2015,7,30,2,130,103,233,363
0132-000,2015,7,30,3,83,98,181,233
0132-000,2015,7,30,4,94,82,176,181
0132-000,2015,7,30,5,78,107,185,176
0132-000,2015,7,30,6,219,169,388,185
0132-000,2015,7,30,7,467,539,1006,388
0132-000,2015,7,30,8,658,1539,2197,1006
0132-000,2015,7,30,9,833,1234,2067,2197
0132-000,2015,7,30,10,738,827,1565,2067
0132-000,2015,7,30,11,834,856,1690,1565
0132-000,2015,7,30,12,862,900,1762,1690
0132-000,2015,7,30,13,807,903,1710,1762
0132-000,2015,7,30,14,772,885,1657,1710
0132-000,2015,7,30,15,850,939,1789,1657
0132-000,2015,7,30,16,906,817,1723,1789
0132-000,2015,7,30,17,988,850,1838,1723
0132-000,2015,7,30,18,1282,917,2199,1838
0132-000,2015,7,30,19,1420,945,2365,2199
0132-000,2015,7,30,20,1004,826,1830,2365
0132-000,2015,7,30,21,867,640,1507,1830
0132-000,2015,7,30,22,669,486,1155,1507
0132-000,2015,7,30,23,477,392,869,1155
0132-000,2015,7,30,24,264,270,534,869
0132-000,2015,7,31,1,207,183,390,534
0132-000,2015,7,31,2,141,133,274,390
0132-000,2015,7,31,3,99,101,200,274
0132-000,2015,7,31,4,90,89,179,200
0132-000,2015,7,31,5,100,96,196,179
0132-000,2015,7,31,6,207,183,390,196
0132-000,2015,7,31,7,481,549,1030,390
0132-000,2015,7,31,8,668,1459,2127,1030
0132-000,2015,7,31,9,763,1257,2020,2127
0132-000,2015,7,31,10,746,804,1550,2020
0132-000,2015,7,31,11,768,804,1572,1550
0132-000,2015,7,31,12,808,803,1611,1572
0132-000,2015,7,31,13,767,887,1654,1611
0132-000,2015,7,31,14,798,836,1634,1654
0132-000,2015,7,31,15,864,883,1747,1634
0132-000,2015,7,31,16,964,897,1861,1747
0132-000,2015,7,31,17,989,879,1868,1861
0132-000,2015,7,31,18,1327,979,2306,1868
0132-000,2015,7,31,19,1584,1161,2745,2306
0132-000,2015,7,31,20,1192,1075,2267,2745
0132-000,2015,7,31,21,942,782,1724,2267
0132-000,2015,7,31,22,596,568,1164,1724
0132-000,2015,7,31,23,422,452,874,1164
0132-000,2015,7,31,24,294,292,586,874
0132-000,2015,8,1,1,209,196,405,586
0132-000,2015,8,1,2,154,159,313,405
0132-000,2015,8,1,3,120,109,229,313
0132-000,2015,8,1,4,97,116,213,229
0132-000,2015,8,1,5,125,123,248,213
0132-000,2015,8,1,6,221,208,429,248
0132-000,2015,8,1,7,385,423,808,429
0132-000,2015,8,1,8,450,827,1277,808
0132-000,2015,8,1,9,578,1470,2048,1277
0132-000,2015,8,1,10,623,1542,2165,2048
0132-000,2015,8,1,11,646,1876,2522,2165
0132-000,2015,8,1,12,757,1694,2451,2522
0132-000,2015,8,1,13,763,1804,2567,2451
0132-000,2015,8,1,14,721,1696,2417,2567
0132-000,2015,8,1,15,775,1490,2265,2417
0132-000,2015,8,1,16,818,1155,1973,2265
0132-000,2015,8,1,17,949,943,1892,1973
0132-000,2015,8,1,18,1170,929,2099,1892
0132-000,2015,8,1,19,1160,849,2009,2099
0132-000,2015,8,1,20,897,605,1502,2009
0132-000,2015,8,1,21,751,490,1241,1502
0132-000,2015,8,1,22,498,453,951,1241
0132-000,2015,8,1,23,386,284,670,951
0132-000,2015,8,1,24,210,252,462,670
0132-000,2015,8,2,1,185,186,371,462
0132-000,2015,8,2,2,100,129,229,371
0132-000,2015,8,2,3,86,65,151,229
0132-000,2015,8,2,4,84,93,177,151
0132-000,2015,8,2,5,83,90,173,177
0132-000,2015,8,2,6,133,98,231,173
0132-000,2015,8,2,7,176,204,380,231
0132-000,2015,8,2,8,228,287,515,380
0132-000,2015,8,2,9,323,431,754,515
0132-000,2015,8,2,10,372,499,871,754
0132-000,2015,8,2,11,545,528,1073,871
0132-000,2015,8,2,12,668,624,1292,1073
0132-000,2015,8,2,13,758,711,1469,1292
0132-000,2015,8,2,14,816,649,1465,1469
0132-000,2015,8,2,15,1129,700,1829,1465
0132-000,2015,8,2,16,1405,714,2119,1829
0132-000,2015,8,2,17,1307,760,2067,2119
0132-000,2015,8,2,18,1430,744,2174,2067
0132-000,2015,8,2,19,1253,571,1824,2174
0132-000,2015,8,2,20,1109,537,1646,1824
0132-000,2015,8,2,21,967,414,1381,1646
0132-000,2015,8,2,22,681,368,1049,1381
0132-000,2015,8,2,23,400,281,681,1049
0132-000,2015,8,2,24,179,202,381,681
0132-000,2015,8,3,1,153,153,306,381
0132-000,2015,8,3,2,90,97,187,306
0132-000,2015,8,3,3,45,67,112,187
0132-000,2015,8,3,4,67,73,140,112
0132-000,2015,8,3,5,69,63,132,140
0132-000,2015,8,3,6,209,172,381,132
0132-000,2015,8,3,7,416,530,946,381
0132-000,2015,8,3,8,599,1116,1715,946
0132-000,2015,8,3,9,673,1062,1735,1715
0132-000,2015,8,3,10,670,772,1442,1735
0132-000,2015,8,3,11,713,810,1523,1442
0132-000,2015,8,3,12,764,882,1646,1523
0132-000,2015,8,3,13,728,823,1551,1646
0132-000,2015,8,3,14,772,810,1582,1551
0132-000,2015,8,3,15,768,708,1476,1582
0132-000,2015,8,3,16,920,784,1704,1476
0132-000,2015,8,3,17,935,770,1705,1704
0132-000,2015,8,3,18,1158,852,2010,1705
0132-000,2015,8,3,19,1237,781,2018,2010
0132-000,2015,8,3,20,928,675,1603,2018
0132-000,2015,8,3,21,705,497,1202,1603
0132-000,2015,8,3,22,546,395,941,1202
0132-000,2015,8,3,23,379,288,667,941
0132-000,2015,8,3,24,241,214,455,667
0132-000,2015,8,4,1,153,155,308,455
0132-000,2015,8,4,2,119,121,240,308
0132-000,2015,8,4,3,72,84,156,240
0132-000,2015,8,4,4,47,74,121,156
0132-000,2015,8,4,5,90,86,176,121
0132-000,2015,8,4,6,198,167,365,176
0132-000,2015,8,4,7,372,460,832,365
0132-000,2015,8,4,8,576,1015,1591,832
0132-000,2015,8,4,9,675,1055,1730,1591
0132-000,2015,8,4,10,671,787,1458,1730
0132-000,2015,8,4,11,700,728,1428,1458
0132-000,2015,8,4,12,768,751,1519,1428
0132-000,2015,8,4,13,699,772,1471,1519
0132-000,2015,8,4,14,763,775,1538,1471
0132-000,2015,8,4,15,830,763,1593,1538
0132-000,2015,8,4,16,858,744,1602,1593
0132-000,2015,8,4,17,927,743,1670,1602
0132-000,2015,8,4,18,1125,886,2011,1670
0132-000,2015,8,4,19,1459,805,2264,2011
0132-000,2015,8,4,20,1098,659,1757,2264
0132-000,2015,8,4,21,760,525,1285,1757
0132-000,2015,8,4,22,571,393,964,1285
0132-000,2015,8,4,23,387,351,738,964
0132-000,2015,8,4,24,240,224,464,738
0132-000,2015,8,5,1,160,151,311,464
0132-000,2015,8,5,2,88,115,203,311
0132-000,2015,8,5,3,80,96,176,203
0132-000,2015,8,5,4,69,84,153,176
0132-000,2015,8,5,5,84,77,161,153
0132-000,2015,8,5,6,207,156,363,161
0132-000,2015,8,5,7,402,447,849,363
0132-000,2015,8,5,8,569,1059,1628,849
0132-000,2015,8,5,9,657,1036,1693,1628
0132-000,2015,8,5,10,711,787,1498,1693
0132-000,2015,8,5,11,679,744,1423,1498
0132-000,2015,8,5,12,758,777,1535,1423
0132-000,2015,8,5,13,740,788,1528,1535
0132-000,2015,8,5,14,791,799,1590,1528
0132-000,2015,8,5,15,865,796,1661,1590
0132-000,2015,8,5,16,914,814,1728,1661
0132-000,2015,8,5,17,925,812,1737,1728
0132-000,2015,8,5,18,1078,898,1976,1737
0132-000,2015,8,5,19,1297,830,2127,1976
0132-000,2015,8,5,20,945,658,1603,2127
0132-000,2015,8,5,21,651,507,1158,1603
0132-000,2015,8,5,22,496,420,916,1158
0132-000,2015,8,5,23,350,336,686,916
0132-000,2015,8,5,24,275,211,486,686
0132-000,2015,8,6,1,151,178,329,486
0132-000,2015,8,6,2,99,111,210,329
0132-000,2015,8,6,3,73,88,161,210
0132-000,2015,8,6,4,70,80,150,161
0132-000,2015,8,6,5,73,91,164,150
0132-000,2015,8,6,6,202,175,377,164
0132-000,2015,8,6,7,401,515,916,377
0132-000,2015,8,6,8,654,1255,1909,916
0132-000,2015,8,6,9,729,1258,1987,1909
0132-000,2015,8,6,10,718,818,1536,1987
0132-000,2015,8,6,11,795,782,1577,1536
0132-000,2015,8,6,12,802,858,1660,1577
0132-000,2015,8,6,13,714,800,1514,1660
0132-000,2015,8,6,14,850,871,1721,1514
0132-000,2015,8,6,15,824,734,1558,1721
0132-000,2015,8,6,16,893,785,1678,1558
0132-000,2015,8,6,17,976,787,1763,1678
0132-000,2015,8,6,18,1138,871,2009,1763
0132-000,2015,8,6,19,1319,903,2222,2009
0132-000,2015,8,6,20,940,637,1577,2222
0132-000,2015,8,6,21,732,499,1231,1577
0132-000,2015,8,6,22,542,433,975,1231
0132-000,2015,8,6,23,381,317,698,975
0132-000,2015,8,6,24,233,212,445,698
0132-000,2015,8,7,1,164,173,337,445
0132-000,2015,8,7,2,121,115,236,337
0132-000,2015,8,7,3,93,87,180,236
0132-000,2015,8,7,4,78,76,154,180
0132-000,2015,8,7,5,86,88,174,154
0132-000,2015,8,7,6,199,180,379,174
0132-000,2015,8,7,7,416,483,899,379
0132-000,2015,8,7,8,665,1291,1956,899
0132-000,2015,8,7,9,741,1273,2014,1956
0132-000,2015,8,7,10,765,958,1723,2014
0132-000,2015,8,7,11,817,878,1695,1723
0132-000,2015,8,7,12,792,792,1584,1695
0132-000,2015,8,7,13,809,818,1627,1584
0132-000,2015,8,7,14,837,810,1647,1627
0132-000,2015,8,7,15,839,817,1656,1647
0132-000,2015,8,7,16,931,828,1759,1656
0132-000,2015,8,7,17,932,840,1772,1759
0132-000,2015,8,7,18,1295,942,2237,1772
0132-000,2015,8,7,19,1530,859,2389,2237
0132-000,2015,8,7,20,1125,781,1906,2389
0132-000,2015,8,7,21,850,583,1433,1906
0132-000,2015,8,7,22,603,491,1094,1433
0132-000,2015,8,7,23,374,376,750,1094
0132-000,2015,8,7,24,249,272,521,750
0132-000,2015,8,8,1,202,237,439,521
0132-000,2015,8,8,2,134,156,290,439
0132-000,2015,8,8,3,126,133,259,290
0132-000,2015,8,8,4,91,117,208,259
0132-000,2015,8,8,5,130,94,224,208
0132-000,2015,8,8,6,205,205,410,224
0132-000,2015,8,8,7,390,381,771,410
0132-000,2015,8,8,8,499,765,1264,771
0132-000,2015,8,8,9,640,892,1532,1264
0132-000,2015,8,8,10,656,901,1557,1532
0132-000,2015,8,8,11,730,1005,1735,1557
0132-000,2015,8,8,12,768,1133,1901,1735
0132-000,2015,8,8,13,878,994,1872,1901
0132-000,2015,8,8,14,803,815,1618,1872
0132-000,2015,8,8,15,986,841,1827,1618
0132-000,2015,8,8,16,932,829,1761,1827
0132-000,2015,8,8,17,970,850,1820,1761
0132-000,2015,8,8,18,1174,839,2013,1820
0132-000,2015,8,8,19,1056,773,1829,2013
0132-000,2015,8,8,20,843,597,1440,1829
0132-000,2015,8,8,21,695,465,1160,1440
0132-000,2015,8,8,22,510,419,929,1160
0132-000,2015,8,8,23,344,327,671,929
0132-000,2015,8,8,24,211,246,457,671
0132-000,2015,8,9,1,156,178,334,457
0132-000,2015,8,9,2,117,114,231,334
0132-000,2015,8,9,3,89,96,185,231
0132-000,2015,8,9,4,82,85,167,185
0132-000,2015,8,9,5,90,82,172,167
0132-000,2015,8,9,6,130,141,271,172
0132-000,2015,8,9,7,255,235,490,271
0132-000,2015,8,9,8,275,359,634,490
0132-000,2015,8,9,9,342,410,752,634
0132-000,2015,8,9,10,404,530,934,752
0132-000,2015,8,9,11,498,559,1057,934
0132-000,2015,8,9,12,584,642,1226,1057
0132-000,2015,8,9,13,597,659,1256,1226
0132-000,2015,8,9,14,652,612,1264,1256
0132-000,2015,8,9,15,711,615,1326,1264
0132-000,2015,8,9,16,845,600,1445,1326
0132-000,2015,8,9,17,860,633,1493,1445
0132-000,2015,8,9,18,990,670,1660,1493
0132-000,2015,8,9,19,887,585,1472,1660
0132-000,2015,8,9,20,735,509,1244,1472
0132-000,2015,8,9,21,703,492,1195,1244
0132-000,2015,8,9,22,487,417,904,1195
0132-000,2015,8,9,23,351,322,673,904
0132-000,2015,8,9,24,219,210,429,673
0132-000,2015,8,10,1,130,141,271,429
0132-000,2015,8,10,2,72,73,145,271
0132-000,2015,8,10,3,44,71,115,145
0132-000,2015,8,10,4,49,75,124,115
0132-000,2015,8,10,5,85,60,145,124
0132-000,2015,8,10,6,203,195,398,145
0132-000,2015,8,10,7,487,644,1131,398
0132-000,2015,8,10,8,690,1681,2371,1131
0132-000,2015,8,10,9,838,1451,2289,2371
0132-000,2015,8,10,10,737,912,1649,2289
0132-000,2015,8,10,11,791,799,1590,1649
0132-000,2015,8,10,12,829,832,1661,1590
0132-000,2015,8,10,13,778,780,1558,1661
0132-000,2015,8,10,14,854,821,1675,1558
0132-000,2015,8,10,15,918,857,1775,1675
0132-000,2015,8,10,16,872,808,1680,1775
0132-000,2015,8,10,17,926,823,1749,1680
0132-000,2015,8,10,18,1206,889,2095,1749
0132-000,2015,8,10,19,1398,911,2309,2095
0132-000,2015,8,10,20,988,727,1715,2309
0132-000,2015,8,10,21,852,544,1396,1715
0132-000,2015,8,10,22,609,482,1091,1396
0132-000,2015,8,10,23,418,317,735,1091
0132-000,2015,8,10,24,246,223,469,735
0132-000,2015,8,11,1,177,158,335,469
0132-000,2015,8,11,2,103,118,221,335
0132-000,2015,8,11,3,86,96,182,221
0132-000,2015,8,11,4,70,83,153,182
0132-000,2015,8,11,5,90,91,181,153
0132-000,2015,8,11,6,205,168,373,181
0132-000,2015,8,11,7,489,565,1054,373
0132-000,2015,8,11,8,705,1579,2284,1054
0132-000,2015,8,11,9,823,1426,2249,2284
0132-000,2015,8,11,10,810,822,1632,2249
0132-000,2015,8,11,11,825,878,1703,1632
0132-000,2015,8,11,12,838,840,1678,1703
0132-000,2015,8,11,13,750,745,1495,1678
0132-000,2015,8,11,14,877,843,1720,1495
0132-000,2015,8,11,15,954,862,1816,1720
0132-000,2015,8,11,16,968,838,1806,1816
0132-000,2015,8,11,17,977,847,1824,1806
0132-000,2015,8,11,18,1197,854,2051,1824
0132-000,2015,8,11,19,1459,909,2368,2051
0132-000,2015,8,11,20,967,701,1668,2368
0132-000,2015,8,11,21,844,600,1444,1668
0132-000,2015,8,11,22,608,448,1056,1444
0132-000,2015,8,11,23,397,315,712,1056
0132-000,2015,8,11,24,214,198,412,712
0132-000,2015,8,12,1,146,174,320,412
0132-000,2015,8,12,2,109,113,222,320
0132-000,2015,8,12,3,68,86,154,222
0132-000,2015,8,12,4,71,90,161,154
0132-000,2015,8,12,5,112,68,180,161
0132-000,2015,8,12,6,189,157,346,180
0132-000,2015,8,12,7,461,531,992,346
0132-000,2015,8,12,8,705,1531,2236,992
0132-000,2015,8,12,9,867,1380,2247,2236
0132-000,2015,8,12,10,797,907,1704,2247
0132-000,2015,8,12,11,828,864,1692,1704
0132-000,2015,8,12,12,766,844,1610,1692
0132-000,2015,8,12,13,797,802,1599,1610
0132-000,2015,8,12,14,781,783,1564,1599
0132-000,2015,8,12,15,841,795,1636,1564
0132-000,2015,8,12,16,856,815,1671,1636
0132-000,2015,8,12,17,925,782,1707,1671
0132-000,2015,8,12,18,1240,884,2124,1707
0132-000,2015,8,12,19,1506,970,2476,2124
0132-000,2015,8,12,20,1054,700,1754,2476
0132-000,2015,8,12,21,779,584,1363,1754
0132-000,2015,8,12,22,581,461,1042,1363
0132-000,2015,8,12,23,419,336,755,1042
0132-000,2015,8,12,24,261,227,488,755
0132-000,2015,8,13,1,177,171,348,488
0132-000,2015,8,13,2,101,107,208,348
0132-000,2015,8,13,3,83,95,178,208
0132-000,2015,8,13,4,76,111,187,178
0132-000,2015,8,13,5,94,92,186,187
0132-000,2015,8,13,6,225,175,400,186
0132-000,2015,8,13,7,467,535,1002,400
0132-000,2015,8,13,8,710,1522,2232,1002
0132-000,2015,8,13,9,844,1431,2275,2232
0132-000,2015,8,13,10,828,840,1668,2275
0132-000,2015,8,13,11,829,915,1744,1668
0132-000,2015,8,13,12,840,858,1698,1744
0132-000,2015,8,13,13,780,791,1571,1698
0132-000,2015,8,13,14,795,807,1602,1571
0132-000,2015,8,13,15,925,831,1756,1602
0132-000,2015,8,13,16,933,865,1798,1756
0132-000,2015,8,13,17,997,921,1918,1798
0132-000,2015,8,13,18,1306,956,2262,1918
0132-000,2015,8,13,19,1569,940,2509,2262
0132-000,2015,8,13,20,1183,844,2027,2509
0132-000,2015,8,13,21,932,591,1523,2027
0132-000,2015,8,13,22,796,544,1340,1523
0132-000,2015,8,13,23,495,347,842,1340
0132-000,2015,8,13,24,254,289,543,842
0132-000,2015,8,14,1,180,183,363,543
0132-000,2015,8,14,2,137,107,244,363
0132-000,2015,8,14,3,88,100,188,244
0132-000,2015,8,14,4,75,112,187,188
0132-000,2015,8,14,5,104,115,219,187
0132-000,2015,8,14,6,223,166,389,219
0132-000,2015,8,14,7,417,438,855,389
0132-000,2015,8,14,8,606,1133,1739,855
0132-000,2015,8,14,9,753,1266,2019,1739
0132-000,2015,8,14,10,663,1093,1756,2019
0132-000,2015,8,14,11,740,1368,2108,1756
0132-000,2015,8,14,12,794,1286,2080,2108
0132-000,2015,8,14,13,754,1101,1855,2080
0132-000,2015,8,14,14,795,1007,1802,1855
0132-000,2015,8,14,15,846,925,1771,1802
0132-000,2015,8,14,16,867,839,1706,1771
0132-000,2015,8,14,17,927,834,1761,1706
0132-000,2015,8,14,18,1186,853,2039,1761
0132-000,2015,8,14,19,1273,896,2169,2039
0132-000,2015,8,14,20,957,700,1657,2169
0132-000,2015,8,14,21,815,573,1388,1657
0132-000,2015,8,14,22,551,477,1028,1388
0132-000,2015,8,14,23,406,346,752,1028
0132-000,2015,8,14,24,237,244,481,752
0132-000,2015,8,15,1,192,186,378,481
0132-000,2015,8,15,2,139,147,286,378
0132-000,2015,8,15,3,89,97,186,286
0132-000,2015,8,15,4,74,93,167,186
0132-000,2015,8,15,5,119,131,250,167
0132-000,2015,8,15,6,203,166,369,250
0132-000,2015,8,15,7,349,354,703,369
0132-000,2015,8,15,8,468,658,1126,703
0132-000,2015,8,15,9,584,760,1344,1126
0132-000,2015,8,15,10,573,833,1406,1344
0132-000,2015,8,15,11,662,992,1654,1406
0132-000,2015,8,15,12,728,1184,1912,1654
0132-000,2015,8,15,13,718,1058,1776,1912
0132-000,2015,8,15,14,774,889,1663,1776
0132-000,2015,8,15,15,793,712,1505,1663
0132-000,2015,8,15,16,823,759,1582,1505
0132-000,2015,8,15,17,966,787,1753,1582
0132-000,2015,8,15,18,1174,829,2003,1753
0132-000,2015,8,15,19,1218,740,1958,2003
0132-000,2015,8,15,20,880,607,1487,1958
0132-000,2015,8,15,21,815,510,1325,1487
0132-000,2015,8,15,22,524,371,895,1325
0132-000,2015,8,15,23,362,317,679,895
0132-000,2015,8,15,24,254,228,482,679
0132-000,2015,8,16,1,190,187,377,482
0132-000,2015,8,16,2,127,130,257,377
0132-000,2015,8,16,3,105,111,216,257
0132-000,2015,8,16,4,78,74,152,216
0132-000,2015,8,16,5,95,70,165,152
0132-000,2015,8,16,6,146,117,263,165
0132-000,2015,8,16,7,261,238,499,263
0132-000,2015,8,16,8,282,333,615,499
0132-000,2015,8,16,9,364,425,789,615
0132-000,2015,8,16,10,412,517,929,789
0132-000,2015,8,16,11,559,587,1146,929
0132-000,2015,8,16,12,653,625,1278,1146
0132-000,2015,8,16,13,809,678,1487,1278
0132-000,2015,8,16,14,860,636,1496,1487
0132-000,2015,8,16,15,934,738,1672,1496
0132-000,2015,8,16,16,951,682,1633,1672
0132-000,2015,8,16,17,1168,777,1945,1633
0132-000,2015,8,16,18,1120,748,1868,1945
0132-000,2015,8,16,19,1135,751,1886,1868
0132-000,2015,8,16,20,880,554,1434,1886
0132-000,2015,8,16,21,812,469,1281,1434
0132-000,2015,8,16,22,630,380,1010,1281
0132-000,2015,8,16,23,363,297,660,1010
0132-000,2015,8,16,24,220,194,414,660
0132-000,2015,8,17,1,137,119,256,414
0132-000,2015,8,17,2,95,87,182,256
0132-000,2015,8,17,3,49,66,115,182
0132-000,2015,8,17,4,50,60,110,115
0132-000,2015,8,17,5,73,73,146,110
0132-000,2015,8,17,6,214,209,423,146
0132-000,2015,8,17,7,503,632,1135,423
0132-000,2015,8,17,8,702,1701,2403,1135
0132-000,2015,8,17,9,836,1426,2262,2403
0132-000,2015,8,17,10,798,872,1670,2262
0132-000,2015,8,17,11,784,908,1692,1670
0132-000,2015,8,17,12,844,795,1639,1692
0132-000,2015,8,17,13,757,786,1543,1639
0132-000,2015,8,17,14,837,792,1629,1543
0132-000,2015,8,17,15,845,840,1685,1629
0132-000,2015,8,17,16,878,796,1674,1685
0132-000,2015,8,17,17,916,869,1785,1674
0132-000,2015,8,17,18,1153,887,2040,1785
0132-000,2015,8,17,19,1434,918,2352,2040
0132-000,2015,8,17,20,987,698,1685,2352
0132-000,2015,8,17,21,829,551,1380,1685
0132-000,2015,8,17,22,608,471,1079,1380
0132-000,2015,8,17,23,385,313,698,1079
0132-000,2015,8,17,24,258,223,481,698
0132-000,2015,8,18,1,154,137,291,481
0132-000,2015,8,18,2,107,99,206,291
0132-000,2015,8,18,3,85,75,160,206
0132-000,2015,8,18,4,77,84,161,160
0132-000,2015,8,18,5,96,88,184,161
0132-000,2015,8,18,6,247,166,413,184
0132-000,2015,8,18,7,427,540,967,413
0132-000,2015,8,18,8,725,1624,2349,967
0132-000,2015,8,18,9,862,1470,2332,2349
0132-000,2015,8,18,10,767,872,1639,2332
0132-000,2015,8,18,11,800,843,1643,1639
0132-000,2015,8,18,12,863,829,1692,1643
0132-000,2015,8,18,13,827,777,1604,1692
0132-000,2015,8,18,14,854,821,1675,1604
0132-000,2015,8,18,15,864,845,1709,1675
0132-000,2015,8,18,16,904,792,1696,1709
0132-000,2015,8,18,17,949,836,1785,1696
0132-000,2015,8,18,18,1151,924,2075,1785
0132-000,2015,8,18,19,1425,861,2286,2075
0132-000,2015,8,18,20,1036,683,1719,2286
0132-000,2015,8,18,21,851,588,1439,1719
0132-000,2015,8,18,22,618,471,1089,1439
0132-000,2015,8,18,23,409,333,742,1089
0132-000,2015,8,18,24,287,227,514,742
0132-000,2015,8,19,1,176,169,345,514
0132-000,2015,8,19,2,103,80,183,345
0132-000,2015,8,19,3,91,89,180,183
0132-000,2015,8,19,4,78,97,175,180
0132-000,2015,8,19,5,83,96,179,175
0132-000,2015,8,19,6,243,185,428,179
0132-000,2015,8,19,7,463,560,1023,428
0132-000,2015,8,19,8,684,1550,2234,1023
0132-000,2015,8,19,9,873,1465,2338,2234
0132-000,2015,8,19,10,784,861,1645,2338
0132-000,2015,8,19,11,841,815,1656,1645
0132-000,2015,8,19,12,814,812,1626,1656
0132-000,2015,8,19,13,771,762,1533,1626
0132-000,2015,8,19,14,808,757,1565,1533
0132-000,2015,8,19,15,839,796,1635,1565
0132-000,2015,8,19,16,941,820,1761,1635
0132-000,2015,8,19,17,952,810,1762,1761
0132-000,2015,8,19,18,1297,867,2164,1762
0132-000,2015,8,19,19,1457,926,2383,2164
0132-000,2015,8,19,20,988,743,1731,2383
0132-000,2015,8,19,21,759,560,1319,1731
0132-000,2015,8,19,22,620,439,1059,1319
0132-000,2015,8,19,23,375,356,731,1059
0132-000,2015,8,19,24,264,235,499,731
0132-000,2015,8,20,1,164,167,331,499
0132-000,2015,8,20,2,107,94,201,331
0132-000,2015,8,20,3,83,106,189,201
0132-000,2015,8,20,4,94,105,199,189
0132-000,2015,8,20,5,87,84,171,199
0132-000,2015,8,20,6,209,171,380,171
0132-000,2015,8,20,7,472,525,997,380
0132-000,2015,8,20,8,726,1320,2046,997
0132-000,2015,8,20,9,825,1678,2503,2046
0132-000,2015,8,20,10,801,856,1657,2503
0132-000,2015,8,20,11,749,798,1547,1657
0132-000,2015,8,20,12,789,854,1643,1547
0132-000,2015,8,20,13,744,711,1455,1643
0132-000,2015,8,20,14,794,841,1635,1455
0132-000,2015,8,20,15,827,805,1632,1635
0132-000,2015,8,20,16,961,774,1735,1632
0132-000,2015,8,20,17,933,856,1789,1735
0132-000,2015,8,20,18,1199,848,2047,1789
0132-000,2015,8,20,19,1429,865,2294,2047
0132-000,2015,8,20,20,976,641,1617,2294
0132-000,2015,8,20,21,809,535,1344,1617
0132-000,2015,8,20,22,609,436,1045,1344
0132-000,2015,8,20,23,425,346,771,1045
0132-000,2015,8,20,24,285,230,515,771
0132-000,2015,8,21,1,168,164,332,515
0132-000,2015,8,21,2,121,118,239,332
0132-000,2015,8,21,3,74,97,171,239
0132-000,2015,8,21,4,97,94,191,171
0132-000,2015,8,21,5,85,85,170,191
0132-000,2015,8,21,6,171,120,291,170
0132-000,2015,8,21,7,354,468,822,291
0132-000,2015,8,21,8,635,1522,2157,822
0132-000,2015,8,21,9,847,1420,2267,2157
0132-000,2015,8,21,10,826,834,1660,2267
0132-000,2015,8,21,11,808,882,1690,1660
0132-000,2015,8,21,12,837,847,1684,1690
0132-000,2015,8,21,13,770,822,1592,1684
0132-000,2015,8,21,14,871,858,1729,1592
0132-000,2015,8,21,15,920,843,1763,1729
0132-000,2015,8,21,16,949,894,1843,1763
0132-000,2015,8,21,17,1031,893,1924,1843
0132-000,2015,8,21,18,1245,940,2185,1924
0132-000,2015,8,21,19,1617,961,2578,2185
0132-000,2015,8,21,20,1098,795,1893,2578
0132-000,2015,8,21,21,952,639,1591,1893
0132-000,2015,8,21,22,656,528,1184,1591
0132-000,2015,8,21,23,443,359,802,1184
0132-000,2015,8,21,24,271,281,552,802
0132-000,2015,8,22,1,215,204,419,552
0132-000,2015,8,22,2,134,162,296,419
0132-000,2015,8,22,3,124,119,243,296
0132-000,2015,8,22,4,109,121,230,243
0132-000,2015,8,22,5,92,98,190,230
0132-000,2015,8,22,6,217,172,389,190
0132-000,2015,8,22,7,394,398,792,389
0132-000,2015,8,22,8,619,825,1444,792
0132-000,2015,8,22,9,663,911,1574,1444
0132-000,2015,8,22,10,789,852,1641,1574
0132-000,2015,8,22,11,772,998,1770,1641
0132-000,2015,8,22,12,838,966,1804,1770
0132-000,2015,8,22,13,869,946,1815,1804
0132-000,2015,8,22,14,891,885,1776,1815
0132-000,2015,8,22,15,837,891,1728,1776
0132-000,2015,8,22,16,1012,935,1947,1728
0132-000,2015,8,22,17,1124,1025,2149,1947
0132-000,2015,8,22,18,1289,1010,2299,2149
0132-000,2015,8,22,19,1105,914,2019,2299
0132-000,2015,8,22,20,778,575,1353,2019
0132-000,2015,8,22,21,739,532,1271,1353
0132-000,2015,8,22,22,462,439,901,1271
0132-000,2015,8,22,23,370,342,712,901
0132-000,2015,8,22,24,235,237,472,712
0132-000,2015,8,23,1,153,171,324,472
0132-000,2015,8,23,2,124,150,274,324
0132-000,2015,8,23,3,91,102,193,274
0132-000,2015,8,23,4,82,78,160,193
0132-000,2015,8,23,5,79,102,181,160
0132-000,2015,8,23,6,142,122,264,181
0132-000,2015,8,23,7,302,238,540,264
0132-000,2015,8,23,8,279,333,612,540
0132-000,2015,8,23,9,373,458,831,612
0132-000,2015,8,23,10,442,542,984,831
0132-000,2015,8,23,11,540,626,1166,984
0132-000,2015,8,23,12,607,724,1331,1166
0132-000,2015,8,23,13,670,708,1378,1331
0132-000,2015,8,23,14,690,689,1379,1378
0132-000,2015,8,23,15,737,688,1425,1379
0132-000,2015,8,23,16,830,696,1526,1425
0132-000,2015,8,23,17,944,794,1738,1526
0132-000,2015,8,23,18,980,762,1742,1738
0132-000,2015,8,23,19,948,674,1622,1742
0132-000,2015,8,23,20,830,610,1440,1622
0132-000,2015,8,23,21,740,512,1252,1440
0132-000,2015,8,23,22,503,389,892,1252
0132-000,2015,8,23,23,363,340,703,892
0132-000,2015,8,23,24,193,193,386,703
0132-000,2015,8,24,1,145,137,282,386
0132-000,2015,8,24,2,103,110,213,282
0132-000,2015,8,24,3,46,63,109,213
0132-000,2015,8,24,4,62,85,147,109
0132-000,2015,8,24,5,77,79,156,147
0132-000,2015,8,24,6,190,175,365,156
0132-000,2015,8,24,7,547,635,1182,365
0132-000,2015,8,24,8,731,1757,2488,1182
0132-000,2015,8,24,9,858,1591,2449,2488
0132-000,2015,8,24,10,805,881,1686,2449
0132-000,2015,8,24,11,803,890,1693,1686
0132-000,2015,8,24,12,856,798,1654,1693
0132-000,2015,8,24,13,778,789,1567,1654
0132-000,2015,8,24,14,849,835,1684,1567
0132-000,2015,8,24,15,950,876,1826,1684
0132-000,2015,8,24,16,1066,838,1904,1826
0132-000,2015,8,24,17,1055,922,1977,1904
0132-000,2015,8,24,18,1310,904,2214,1977
0132-000,2015,8,24,19,1440,906,2346,2214
0132-000,2015,8,24,20,1069,762,1831,2346
0132-000,2015,8,24,21,884,572,1456,1831
0132-000,2015,8,24,22,620,457,1077,1456
0132-000,2015,8,24,23,390,328,718,1077
0132-000,2015,8,24,24,233,210,443,718
0132-000,2015,8,25,1,168,137,305,443
0132-000,2015,8,25,2,107,90,197,305
0132-000,2015,8,25,3,87,77,164,197
0132-000,2015,8,25,4,75,93,168,164
0132-000,2015,8,25,5,77,89,166,168
0132-000,2015,8,25,6,144,113,257,166
0132-000,2015,8,25,7,346,391,737,257
0132-000,2015,8,25,8,650,1548,2198,737
0132-000,2015,8,25,9,810,1490,2300,2198
0132-000,2015,8,25,10,761,861,1622,2300
0132-000,2015,8,25,11,786,745,1531,1622
0132-000,2015,8,25,12,765,804,1569,1531
0132-000,2015,8,25,13,745,783,1528,1569
0132-000,2015,8,25,14,831,802,1633,1528
0132-000,2015,8,25,15,822,814,1636,1633
0132-000,2015,8,25,16,948,754,1702,1636
0132-000,2015,8,25,17,869,759,1628,1702
0132-000,2015,8,25,18,1121,775,1896,1628
0132-000,2015,8,25,19,1362,837,2199,1896
0132-000,2015,8,25,20,968,646,1614,2199
0132-000,2015,8,25,21,840,540,1380,1614
0132-000,2015,8,25,22,606,432,1038,1380
0132-000,2015,8,25,23,378,340,718,1038
0132-000,2015,8,25,24,236,205,441,718
0132-000,2015,8,26,1,174,184,358,441
0132-000,2015,8,26,2,131,107,238,358
0132-000,2015,8,26,3,73,86,159,238
0132-000,2015,8,26,4,59,75,134,159
0132-000,2015,8,26,5,86,82,168,134
0132-000,2015,8,26,6,186,142,328,168
0132-000,2015,8,26,7,470,496,966,328
0132-000,2015,8,26,8,714,1632,2346,966
0132-000,2015,8,26,9,856,1658,2514,2346
0132-000,2015,8,26,10,835,911,1746,2514
0132-000,2015,8,26,11,849,849,1698,1746
0132-000,2015,8,26,12,825,868,1693,1698
0132-000,2015,8,26,13,825,799,1624,1693
0132-000,2015,8,26,14,805,797,1602,1624
0132-000,2015,8,26,15,927,873,1800,1602
0132-000,2015,8,26,16,901,806,1707,1800
0132-000,2015,8,26,17,903,854,1757,1707
0132-000,2015,8,26,18,1211,883,2094,1757
0132-000,2015,8,26,19,1523,917,2440,2094
0132-000,2015,8,26,20,1070,775,1845,2440
0132-000,2015,8,26,21,835,580,1415,1845
0132-000,2015,8,26,22,607,488,1095,1415
0132-000,2015,8,26,23,368,340,708,1095
0132-000,2015,8,26,24,286,222,508,708
0132-000,2015,8,27,1,180,176,356,508
0132-000,2015,8,27,2,133,108,241,356
0132-000,2015,8,27,3,75,75,150,241
0132-000,2015,8,27,4,69,93,162,150
0132-000,2015,8,27,5,98,90,188,162
0132-000,2015,8,27,6,209,142,351,188
0132-000,2015,8,27,7,486,510,996,351
0132-000,2015,8,27,8,704,1561,2265,996
0132-000,2015,8,27,9,913,1590,2503,2265
0132-000,2015,8,27,10,789,955,1744,2503
0132-000,2015,8,27,11,872,846,1718,1744
0132-000,2015,8,27,12,811,919,1730,1718
0132-000,2015,8,27,13,816,775,1591,1730
0132-000,2015,8,27,14,822,867,1689,1591
0132-000,2015,8,27,15,889,890,1779,1689
0132-000,2015,8,27,16,953,825,1778,1779
0132-000,2015,8,27,17,917,889,1806,1778
0132-000,2015,8,27,18,1256,952,2208,1806
0132-000,2015,8,27,19,1503,883,2386,2208
0132-000,2015,8,27,20,1043,718,1761,2386
0132-000,2015,8,27,21,855,542,1397,1761
0132-000,2015,8,27,22,664,497,1161,1397
0132-000,2015,8,27,23,433,354,787,1161
0132-000,2015,8,27,24,274,258,532,787
0132-000,2015,8,28,1,177,172,349,532
0132-000,2015,8,28,2,120,100,220,349
0132-000,2015,8,28,3,75,103,178,220
0132-000,2015,8,28,4,80,108,188,178
0132-000,2015,8,28,5,106,84,190,188
0132-000,2015,8,28,6,190,149,339,190
0132-000,2015,8,28,7,454,536,990,339
0132-000,2015,8,28,8,729,1498,2227,990
0132-000,2015,8,28,9,868,1555,2423,2227
0132-000,2015,8,28,10,801,915,1716,2423
0132-000,2015,8,28,11,819,859,1678,1716
0132-000,2015,8,28,12,808,855,1663,1678
0132-000,2015,8,28,13,807,726,1533,1663
0132-000,2015,8,28,14,836,823,1659,1533
0132-000,2015,8,28,15,939,831,1770,1659
0132-000,2015,8,28,16,1006,817,1823,1770
0132-000,2015,8,28,17,1027,921,1948,1823
0132-000,2015,8,28,18,1421,1009,2430,1948
0132-000,2015,8,28,19,1689,962,2651,2430
0132-000,2015,8,28,20,1205,833,2038,2651
0132-000,2015,8,28,21,993,616,1609,2038
0132-000,2015,8,28,22,700,540,1240,1609
0132-000,2015,8,28,23,482,389,871,1240
0132-000,2015,8,28,24,292,296,588,871
0132-000,2015,8,29,1,200,227,427,588
0132-000,2015,8,29,2,157,161,318,427
0132-000,2015,8,29,3,145,124,269,318
0132-000,2015,8,29,4,88,111,199,269
0132-000,2015,8,29,5,107,117,224,199
0132-000,2015,8,29,6,228,184,412,224
0132-000,2015,8,29,7,438,399,837,412
0132-000,2015,8,29,8,592,832,1424,837
0132-000,2015,8,29,9,724,1002,1726,1424
0132-000,2015,8,29,10,775,923,1698,1726
0132-000,2015,8,29,11,786,1119,1905,1698
0132-000,2015,8,29,12,861,1148,2009,1905
0132-000,2015,8,29,13,950,1130,2080,2009
0132-000,2015,8,29,14,911,981,1892,2080
0132-000,2015,8,29,15,984,1021,2005,1892
0132-000,2015,8,29,16,975,919,1894,2005
0132-000,2015,8,29,17,1096,921,2017,1894
0132-000,2015,8,29,18,1353,989,2342,2017
0132-000,2015,8,29,19,1301,934,2235,2342
0132-000,2015,8,29,20,996,744,1740,2235
0132-000,2015,8,29,21,768,581,1349,1740
0132-000,2015,8,29,22,542,442,984,1349
0132-000,2015,8,29,23,394,353,747,984
0132-000,2015,8,29,24,230,291,521,747
0132-000,2015,8,30,1,201,185,386,521
0132-000,2015,8,30,2,154,134,288,386
0132-000,2015,8,30,3,99,109,208,288
0132-000,2015,8,30,4,85,84,169,208
0132-000,2015,8,30,5,59,88,147,169
0132-000,2015,8,30,6,145,114,259,147
0132-000,2015,8,30,7,277,258,535,259
0132-000,2015,8,30,8,332,394,726,535
0132-000,2015,8,30,9,370,518,888,726
0132-000,2015,8,30,10,467,555,1022,888
0132-000,2015,8,30,11,602,639,1241,1022
0132-000,2015,8,30,12,624,689,1313,1241
0132-000,2015,8,30,13,680,726,1406,1313
0132-000,2015,8,30,14,691,753,1444,1406
0132-000,2015,8,30,15,824,786,1610,1444
0132-000,2015,8,30,16,1022,771,1793,1610
0132-000,2015,8,30,17,1155,806,1961,1793
0132-000,2015,8,30,18,1384,796,2180,1961
0132-000,2015,8,30,19,1306,642,1948,2180
0132-000,2015,8,30,20,1086,602,1688,1948
0132-000,2015,8,30,21,929,493,1422,1688
0132-000,2015,8,30,22,633,442,1075,1422
0132-000,2015,8,30,23,386,317,703,1075
0132-000,2015,8,30,24,238,209,447,703
0132-000,2015,8,31,1,137,138,275,447
0132-000,2015,8,31,2,97,87,184,275
0132-000,2015,8,31,3,55,66,121,184
0132-000,2015,8,31,4,53,73,126,121
0132-000,2015,8,31,5,81,73,154,126
0132-000,2015,8,31,6,203,172,375,154
0132-000,2015,8,31,7,513,604,1117,375
0132-000,2015,8,31,8,726,1763,2489,1117
0132-000,2015,8,31,9,861,1639,2500,2489
0132-000,2015,8,31,10,780,876,1656,2500
0132-000,2015,8,31,11,814,898,1712,1656
0132-000,2015,8,31,12,788,812,1600,1712
0132-000,2015,8,31,13,767,745,1512,1600
0132-000,2015,8,31,14,816,844,1660,1512
0132-000,2015,8,31,15,893,820,1713,1660
0132-000,2015,8,31,16,952,827,1779,1713
0132-000,2015,8,31,17,926,867,1793,1779
0132-000,2015,8,31,18,1308,920,2228,1793
0132-000,2015,8,31,19,1462,893,2355,2228
0132-000,2015,8,31,20,1049,770,1819,2355
0132-000,2015,8,31,21,845,566,1411,1819
0132-000,2015,8,31,22,615,435,1050,1411
0132-000,2015,8,31,23,383,372,755,1050
0132-000,2015,8,31,24,258,230,488,755
0132-000,2015,9,1,1,169,148,317,488
0132-000,2015,9,1,2,99,108,207,317
0132-000,2015,9,1,3,89,97,186,207
0132-000,2015,9,1,4,66,89,155,186
0132-000,2015,9,1,5,87,85,172,155
0132-000,2015,9,1,6,214,159,373,172
0132-000,2015,9,1,7,473,548,1021,373
0132-000,2015,9,1,8,696,1665,2361,1021
0132-000,2015,9,1,9,879,1598,2477,2361
0132-000,2015,9,1,10,800,888,1688,2477
0132-000,2015,9,1,11,826,843,1669,1688
0132-000,2015,9,1,12,900,847,1747,1669
0132-000,2015,9,1,13,767,799,1566,1747
0132-000,2015,9,1,14,877,794,1671,1566
0132-000,2015,9,1,15,855,855,1710,1671
0132-000,2015,9,1,16,986,845,1831,1710
0132-000,2015,9,1,17,1014,864,1878,1831
0132-000,2015,9,1,18,1248,970,2218,1878
0132-000,2015,9,1,19,1445,930,2375,2218
0132-000,2015,9,1,20,1070,776,1846,2375
0132-000,2015,9,1,21,925,562,1487,1846
0132-000,2015,9,1,22,675,453,1128,1487
0132-000,2015,9,1,23,385,300,685,1128
0132-000,2015,9,1,24,255,197,452,685
0132-000,2015,9,2,1,185,154,339,452
0132-000,2015,9,2,2,121,126,247,339
0132-000,2015,9,2,3,81,103,184,247
0132-000,2015,9,2,4,56,82,138,184
0132-000,2015,9,2,5,80,92,172,138
0132-000,2015,9,2,6,219,137,356,172
0132-000,2015,9,2,7,450,526,976,356
0132-000,2015,9,2,8,731,1653,2384,976
0132-000,2015,9,2,9,884,1624,2508,2384
0132-000,2015,9,2,10,840,935,1775,2508
0132-000,2015,9,2,11,891,878,1769,1775
0132-000,2015,9,2,12,830,759,1589,1769
0132-000,2015,9,2,13,797,774,1571,1589
0132-000,2015,9,2,14,775,804,1579,1571
0132-000,2015,9,2,15,944,827,1771,1579
0132-000,2015,9,2,16,909,808,1717,1771
0132-000,2015,9,2,17,956,805,1761,1717
0132-000,2015,9,2,18,1241,907,2148,1761
0132-000,2015,9,2,19,1522,867,2389,2148
0132-000,2015,9,2,20,991,720,1711,2389
0132-000,2015,9,2,21,804,539,1343,1711
0132-000,2015,9,2,22,593,478,1071,1343
0132-000,2015,9,2,23,356,346,702,1071
0132-000,2015,9,2,24,230,193,423,702
0132-000,2015,9,3,1,196,189,385,423
0132-000,2015,9,3,2,132,109,241,385
0132-000,2015,9,3,3,86,100,186,241
0132-000,2015,9,3,4,71,75,146,186
0132-000,2015,9,3,5,79,79,158,146
0132-000,2015,9,3,6,214,155,369,158
0132-000,2015,9,3,7,442,517,959,369
0132-000,2015,9,3,8,734,1633,2367,959
0132-000,2015,9,3,9,862,1580,2442,2367
0132-000,2015,9,3,10,807,864,1671,2442
0132-000,2015,9,3,11,766,833,1599,1671
0132-000,2015,9,3,12,759,838,1597,1599
0132-000,2015,9,3,13,746,709,1455,1597
0132-000,2015,9,3,14,828,805,1633,1455
0132-000,2015,9,3,15,877,822,1699,1633
0132-000,2015,9,3,16,912,763,1675,1699
0132-000,2015,9,3,17,924,817,1741,1675
0132-000,2015,9,3,18,1277,877,2154,1741
0132-000,2015,9,3,19,1448,870,2318,2154
0132-000,2015,9,3,20,1006,722,1728,2318
0132-000,2015,9,3,21,801,552,1353,1728
0132-000,2015,9,3,22,676,447,1123,1353
0132-000,2015,9,3,23,403,361,764,1123
0132-000,2015,9,3,24,235,232,467,764
0132-000,2015,9,4,1,193,172,365,467
0132-000,2015,9,4,2,112,123,235,365
0132-000,2015,9,4,3,75,95,170,235
0132-000,2015,9,4,4,86,96,182,170
0132-000,2015,9,4,5,90,91,181,182
0132-000,2015,9,4,6,214,151,365,181
0132-000,2015,9,4,7,470,507,977,365
0132-000,2015,9,4,8,727,1655,2382,977
0132-000,2015,9,4,9,804,1519,2323,2382
0132-000,2015,9,4,10,828,864,1692,2323
0132-000,2015,9,4,11,797,817,1614,1692
0132-000,2015,9,4,12,808,792,1600,1614
0132-000,2015,9,4,13,774,727,1501,1600
0132-000,2015,9,4,14,806,850,1656,1501
0132-000,2015,9,4,15,941,887,1828,1656
0132-000,2015,9,4,16,935,831,1766,1828
0132-000,2015,9,4,17,985,876,1861,1766
0132-000,2015,9,4,18,1380,1000,2380,1861
0132-000,2015,9,4,19,1894,965,2859,2380
0132-000,2015,9,4,20,1298,938,2236,2859
0132-000,2015,9,4,21,959,669,1628,2236
0132-000,2015,9,4,22,682,568,1250,1628
0132-000,2015,9,4,23,499,371,870,1250
0132-000,2015,9,4,24,289,261,550,870
0132-000,2015,9,5,1,200,209,409,550
0132-000,2015,9,5,2,149,149,298,409
0132-000,2015,9,5,3,115,130,245,298
0132-000,2015,9,5,4,105,136,241,245
0132-000,2015,9,5,5,111,120,231,241
0132-000,2015,9,5,6,192,179,371,231
0132-000,2015,9,5,7,422,380,802,371
0132-000,2015,9,5,8,514,810,1324,802
0132-000,2015,9,5,9,710,1021,1731,1324
0132-000,2015,9,5,10,793,1031,1824,1731
0132-000,2015,9,5,11,788,1089,1877,1824
0132-000,2015,9,5,12,902,1122,2024,1877
0132-000,2015,9,5,13,820,1145,1965,2024
0132-000,2015,9,5,14,957,1013,1970,1965
0132-000,2015,9,5,15,1028,964,1992,1970
0132-000,2015,9,5,16,1099,993,2092,1992
0132-000,2015,9,5,17,1290,958,2248,2092
0132-000,2015,9,5,18,1751,944,2695,2248
0132-000,2015,9,5,19,1674,909,2583,2695
0132-000,2015,9,5,20,1241,654,1895,2583
0132-000,2015,9,5,21,770,517,1287,1895
0132-000,2015,9,5,22,561,454,1015,1287
0132-000,2015,9,5,23,368,357,725,1015
0132-000,2015,9,5,24,254,274,528,725
0132-000,2015,9,6,1,170,195,365,528
0132-000,2015,9,6,2,121,137,258,365
0132-000,2015,9,6,3,107,100,207,258
0132-000,2015,9,6,4,74,92,166,207
0132-000,2015,9,6,5,96,89,185,166
0132-000,2015,9,6,6,156,121,277,185
0132-000,2015,9,6,7,280,285,565,277
0132-000,2015,9,6,8,294,466,760,565
0132-000,2015,9,6,9,401,494,895,760
0132-000,2015,9,6,10,448,643,1091,895
0132-000,2015,9,6,11,589,699,1288,1091
0132-000,2015,9,6,12,598,715,1313,1288
0132-000,2015,9,6,13,707,741,1448,1313
0132-000,2015,9,6,14,781,762,1543,1448
0132-000,2015,9,6,15,1006,766,1772,1543
0132-000,2015,9,6,16,1240,811,2051,1772
0132-000,2015,9,6,17,1469,810,2279,2051
0132-000,2015,9,6,18,1725,795,2520,2279
0132-000,2015,9,6,19,1592,658,2250,2520
0132-000,2015,9,6,20,1227,552,1779,2250
0132-000,2015,9,6,21,928,504,1432,1779
0132-000,2015,9,6,22,703,407,1110,1432
0132-000,2015,9,6,23,354,285,639,1110
0132-000,2015,9,6,24,201,202,403,639
0132-000,2015,9,7,1,127,136,263,403
0132-000,2015,9,7,2,82,74,156,263
0132-000,2015,9,7,3,46,64,110,156
0132-000,2015,9,7,4,51,69,120,110
0132-000,2015,9,7,5,78,69,147,120
0132-000,2015,9,7,6,220,175,395,147
0132-000,2015,9,7,7,502,613,1115,395
0132-000,2015,9,7,8,766,1752,2518,1115
0132-000,2015,9,7,9,865,1657,2522,2518
0132-000,2015,9,7,10,845,930,1775,2522
0132-000,2015,9,7,11,847,827,1674,1775
0132-000,2015,9,7,12,766,837,1603,1674
0132-000,2015,9,7,13,739,755,1494,1603
0132-000,2015,9,7,14,835,855,1690,1494
0132-000,2015,9,7,15,909,843,1752,1690
0132-000,2015,9,7,16,925,849,1774,1752
0132-000,2015,9,7,17,979,879,1858,1774
0132-000,2015,9,7,18,1203,952,2155,1858
0132-000,2015,9,7,19,1440,860,2300,2155
0132-000,2015,9,7,20,1067,731,1798,2300
0132-000,2015,9,7,21,848,562,1410,1798
0132-000,2015,9,7,22,660,482,1142,1410
0132-000,2015,9,7,23,409,350,759,1142
0132-000,2015,9,7,24,211,242,453,759
0132-000,2015,9,8,1,162,145,307,453
0132-000,2015,9,8,2,92,92,184,307
0132-000,2015,9,8,3,78,76,154,184
0132-000,2015,9,8,4,72,91,163,154
0132-000,2015,9,8,5,89,86,175,163
0132-000,2015,9,8,6,230,162,392,175
0132-000,2015,9,8,7,490,551,1041,392
0132-000,2015,9,8,8,752,1629,2381,1041
0132-000,2015,9,8,9,851,1587,2438,2381
0132-000,2015,9,8,10,842,950,1792,2438
0132-000,2015,9,8,11,805,834,1639,1792
0132-000,2015,9,8,12,801,839,1640,1639
0132-000,2015,9,8,13,808,753,1561,1640
0132-000,2015,9,8,14,842,856,1698,1561
0132-000,2015,9,8,15,932,808,1740,1698
0132-000,2015,9,8,16,893,795,1688,1740
0132-000,2015,9,8,17,981,799,1780,1688
0132-000,2015,9,8,18,1227,883,2110,1780
0132-000,2015,9,8,19,1455,874,2329,2110
0132-000,2015,9,8,20,1024,733,1757,2329
0132-000,2015,9,8,21,903,623,1526,1757
0132-000,2015,9,8,22,632,492,1124,1526
0132-000,2015,9,8,23,408,316,724,1124
0132-000,2015,9,8,24,237,225,462,724
0132-000,2015,9,9,1,180,149,329,462
0132-000,2015,9,9,2,107,109,216,329
0132-000,2015,9,9,3,82,84,166,216
0132-000,2015,9,9,4,85,73,158,166
0132-000,2015,9,9,5,81,88,169,158
0132-000,2015,9,9,6,230,156,386,169
0132-000,2015,9,9,7,503,501,1004,386
0132-000,2015,9,9,8,756,1648,2404,1004
0132-000,2015,9,9,9,930,1629,2559,2404
0132-000,2015,9,9,10,882,908,1790,2559
0132-000,2015,9,9,11,827,866,1693,1790
0132-000,2015,9,9,12,813,825,1638,1693
0132-000,2015,9,9,13,748,758,1506,1638
0132-000,2015,9,9,14,857,858,1715,1506
0132-000,2015,9,9,15,904,821,1725,1715
0132-000,2015,9,9,16,946,799,1745,1725
0132-000,2015,9,9,17,904,844,1748,1745
0132-000,2015,9,9,18,1292,927,2219,1748
0132-000,2015,9,9,19,1533,903,2436,2219
0132-000,2015,9,9,20,1065,734,1799,2436
0132-000,2015,9,9,21,848,619,1467,1799
0132-000,2015,9,9,22,571,492,1063,1467
0132-000,2015,9,9,23,434,330,764,1063
0132-000,2015,9,9,24,247,227,474,764
0132-000,2015,9,10,1,176,158,334,474
0132-000,2015,9,10,2,113,116,229,334
0132-000,2015,9,10,3,85,103,188,229
0132-000,2015,9,10,4,75,79,154,188
0132-000,2015,9,10,5,83,91,174,154
0132-000,2015,9,10,6,210,152,362,174
0132-000,2015,9,10,7,492,502,994,362
0132-000,2015,9,10,8,741,1595,2336,994
0132-000,2015,9,10,9,888,1658,2546,2336
0132-000,2015,9,10,10,851,959,1810,2546
0132-000,2015,9,10,11,827,881,1708,1810
0132-000,2015,9,10,12,800,842,1642,1708
0132-000,2015,9,10,13,742,790,1532,1642
0132-000,2015,9,10,14,816,801,1617,1532
0132-000,2015,9,10,15,937,861,1798,1617
0132-000,2015,9,10,16,971,795,1766,1798
0132-000,2015,9,10,17,935,854,1789,1766
0132-000,2015,9,10,18,1224,945,2169,1789
0132-000,2015,9,10,19,1526,915,2441,2169
0132-000,2015,9,10,20,1048,722,1770,2441
0132-000,2015,9,10,21,871,563,1434,1770
0132-000,2015,9,10,22,699,516,1215,1434
0132-000,2015,9,10,23,376,354,730,1215
0132-000,2015,9,10,24,262,220,482,730
0132-000,2015,9,11,1,211,167,378,482
0132-000,2015,9,11,2,115,111,226,378
0132-000,2015,9,11,3,88,95,183,226
0132-000,2015,9,11,4,82,96,178,183
0132-000,2015,9,11,5,96,106,202,178
0132-000,2015,9,11,6,213,157,370,202
0132-000,2015,9,11,7,446,494,940,370
0132-000,2015,9,11,8,729,1635,2364,940
0132-000,2015,9,11,9,907,1630,2537,2364
0132-000,2015,9,11,10,840,933,1773,2537
0132-000,2015,9,11,11,877,863,1740,1773
0132-000,2015,9,11,12,837,859,1696,1740
0132-000,2015,9,11,13,844,851,1695,1696
0132-000,2015,9,11,14,867,886,1753,1695
0132-000,2015,9,11,15,900,863,1763,1753
0132-000,2015,9,11,16,1013,891,1904,1763
0132-000,2015,9,11,17,1059,926,1985,1904
0132-000,2015,9,11,18,1481,1032,2513,1985
0132-000,2015,9,11,19,1767,962,2729,2513
0132-000,2015,9,11,20,1100,814,1914,2729
0132-000,2015,9,11,21,856,598,1454,1914
0132-000,2015,9,11,22,714,468,1182,1454
0132-000,2015,9,11,23,459,380,839,1182
0132-000,2015,9,11,24,277,265,542,839
0132-000,2015,9,12,1,212,217,429,542
0132-000,2015,9,12,2,128,170,298,429
0132-000,2015,9,12,3,108,123,231,298
0132-000,2015,9,12,4,95,104,199,231
0132-000,2015,9,12,5,126,111,237,199
0132-000,2015,9,12,6,233,188,421,237
0132-000,2015,9,12,7,424,430,854,421
0132-000,2015,9,12,8,606,976,1582,854
0132-000,2015,9,12,9,707,1164,1871,1582
0132-000,2015,9,12,10,735,1349,2084,1871
0132-000,2015,9,12,11,832,1367,2199,2084
0132-000,2015,9,12,12,971,1787,2758,2199
0132-000,2015,9,12,13,910,1430,2340,2758
0132-000,2015,9,12,14,925,1214,2139,2340
0132-000,2015,9,12,15,1082,985,2067,2139
0132-000,2015,9,12,16,1174,907,2081,2067
0132-000,2015,9,12,17,1367,940,2307,2081
0132-000,2015,9,12,18,1758,999,2757,2307
0132-000,2015,9,12,19,1792,894,2686,2757
0132-000,2015,9,12,20,1507,690,2197,2686
0132-000,2015,9,12,21,1054,550,1604,2197
0132-000,2015,9,12,22,636,504,1140,1604
0132-000,2015,9,12,23,402,371,773,1140
0132-000,2015,9,12,24,216,248,464,773
0132-000,2015,9,13,1,161,171,332,464
0132-000,2015,9,13,2,134,130,264,332
0132-000,2015,9,13,3,96,95,191,264
0132-000,2015,9,13,4,72,84,156,191
0132-000,2015,9,13,5,90,86,176,156
0132-000,2015,9,13,6,159,176,335,176
0132-000,2015,9,13,7,267,347,614,335
0132-000,2015,9,13,8,375,613,988,614
0132-000,2015,9,13,9,481,809,1290,988
0132-000,2015,9,13,10,541,984,1525,1290
0132-000,2015,9,13,11,646,814,1460,1525
0132-000,2015,9,13,12,761,661,1422,1460
0132-000,2015,9,13,13,930,688,1618,1422
0132-000,2015,9,13,14,1108,778,1886,1618
0132-000,2015,9,13,15,1245,704,1949,1886
0132-000,2015,9,13,16,1733,783,2516,1949
0132-000,2015,9,13,17,1962,769,2731,2516
0132-000,2015,9,13,18,1959,765,2724,2731
0132-000,2015,9,13,19,1926,737,2663,2724
0132-000,2015,9,13,20,1919,560,2479,2663
0132-000,2015,9,13,21,1652,523,2175,2479
0132-000,2015,9,13,22,1074,453,1527,2175
0132-000,2015,9,13,23,576,292,868,1527
0132-000,2015,9,13,24,245,194,439,868
0132-000,2015,9,14,1,115,122,237,439
0132-000,2015,9,14,2,79,88,167,237
0132-000,2015,9,14,3,58,55,113,167
0132-000,2015,9,14,4,46,66,112,113
0132-000,2015,9,14,5,83,70,153,112
0132-000,2015,9,14,6,224,194,418,153
0132-000,2015,9,14,7,505,651,1156,418
0132-000,2015,9,14,8,811,1812,2623,1156
0132-000,2015,9,14,9,909,1620,2529,2623
0132-000,2015,9,14,10,813,983,1796,2529
0132-000,2015,9,14,11,863,830,1693,1796
0132-000,2015,9,14,12,816,883,1699,1693
0132-000,2015,9,14,13,810,846,1656,1699
0132-000,2015,9,14,14,909,908,1817,1656
0132-000,2015,9,14,15,945,928,1873,1817
0132-000,2015,9,14,16,991,868,1859,1873
0132-000,2015,9,14,17,1016,851,1867,1859
0132-000,2015,9,14,18,1377,989,2366,1867
0132-000,2015,9,14,19,1469,895,2364,2366
0132-000,2015,9,14,20,1026,769,1795,2364
0132-000,2015,9,14,21,804,547,1351,1795
0132-000,2015,9,14,22,615,458,1073,1351
0132-000,2015,9,14,23,383,321,704,1073
0132-000,2015,9,14,24,235,206,441,704
0132-000,2015,9,15,1,192,160,352,441
0132-000,2015,9,15,2,97,120,217,352
0132-000,2015,9,15,3,75,76,151,217
0132-000,2015,9,15,4,73,96,169,151
0132-000,2015,9,15,5,91,90,181,169
0132-000,2015,9,15,6,196,160,356,181
0132-000,2015,9,15,7,457,540,997,356
0132-000,2015,9,15,8,753,1744,2497,997
0132-000,2015,9,15,9,858,1448,2306,2497
0132-000,2015,9,15,10,892,920,1812,2306
0132-000,2015,9,15,11,855,897,1752,1812
0132-000,2015,9,15,12,872,828,1700,1752
0132-000,2015,9,15,13,823,866,1689,1700
0132-000,2015,9,15,14,852,857,1709,1689
0132-000,2015,9,15,15,944,883,1827,1709
0132-000,2015,9,15,16,952,792,1744,1827
0132-000,2015,9,15,17,998,867,1865,1744
0132-000,2015,9,15,18,1287,987,2274,1865
0132-000,2015,9,15,19,1512,915,2427,2274
0132-000,2015,9,15,20,946,709,1655,2427
0132-000,2015,9,15,21,885,549,1434,1655
0132-000,2015,9,15,22,667,463,1130,1434
0132-000,2015,9,15,23,359,314,673,1130
0132-000,2015,9,15,24,236,219,455,673
0132-000,2015,9,16,1,190,155,345,455
0132-000,2015,9,16,2,110,100,210,345
0132-000,2015,9,16,3,81,110,191,210
0132-000,2015,9,16,4,81,102,183,191
0132-000,2015,9,16,5,83,98,181,183
0132-000,2015,9,16,6,227,165,392,181
0132-000,2015,9,16,7,478,567,1045,392
0132-000,2015,9,16,8,733,1789,2522,1045
0132-000,2015,9,16,9,906,1534,2440,2522
0132-000,2015,9,16,10,884,956,1840,2440
0132-000,2015,9,16,11,844,890,1734,1840
0132-000,2015,9,16,12,861,937,1798,1734
0132-000,2015,9,16,13,765,814,1579,1798
0132-000,2015,9,16,14,908,847,1755,1579
0132-000,2015,9,16,15,899,949,1848,1755
0132-000,2015,9,16,16,994,812,1806,1848
0132-000,2015,9,16,17,1004,838,1842,1806
0132-000,2015,9,16,18,1405,992,2397,1842
0132-000,2015,9,16,19,1554,874,2428,2397
0132-000,2015,9,16,20,1049,685,1734,2428
0132-000,2015,9,16,21,787,539,1326,1734
0132-000,2015,9,16,22,643,473,1116,1326
0132-000,2015,9,16,23,390,352,742,1116
0132-000,2015,9,16,24,258,222,480,742
0132-000,2015,9,17,1,162,165,327,480
0132-000,2015,9,17,2,112,107,219,327
0132-000,2015,9,17,3,85,110,195,219
0132-000,2015,9,17,4,69,93,162,195
0132-000,2015,9,17,5,94,94,188,162
0132-000,2015,9,17,6,241,165,406,188
0132-000,2015,9,17,7,526,569,1095,406
0132-000,2015,9,17,8,785,1782,2567,1095
0132-000,2015,9,17,9,868,1485,2353,2567
0132-000,2015,9,17,10,871,910,1781,2353
0132-000,2015,9,17,11,834,956,1790,1781
0132-000,2015,9,17,12,875,874,1749,1790
0132-000,2015,9,17,13,820,827,1647,1749
0132-000,2015,9,17,14,858,865,1723,1647
0132-000,2015,9,17,15,940,883,1823,1723
0132-000,2015,9,17,16,958,844,1802,1823
0132-000,2015,9,17,17,1052,877,1929,1802
0132-000,2015,9,17,18,1312,956,2268,1929
0132-000,2015,9,17,19,1478,860,2338,2268
0132-000,2015,9,17,20,1015,754,1769,2338
0132-000,2015,9,17,21,830,573,1403,1769
0132-000,2015,9,17,22,662,490,1152,1403
0132-000,2015,9,17,23,402,346,748,1152
0132-000,2015,9,17,24,260,253,513,748
0132-000,2015,9,18,1,166,157,323,513
0132-000,2015,9,18,2,108,105,213,323
0132-000,2015,9,18,3,87,97,184,213
0132-000,2015,9,18,4,71,91,162,184
0132-000,2015,9,18,5,88,90,178,162
0132-000,2015,9,18,6,237,190,427,178
0132-000,2015,9,18,7,510,557,1067,427
0132-000,2015,9,18,8,768,1729,2497,1067
0132-000,2015,9,18,9,879,1446,2325,2497
0132-000,2015,9,18,10,831,874,1705,2325
0132-000,2015,9,18,11,829,932,1761,1705
0132-000,2015,9,18,12,869,906,1775,1761
0132-000,2015,9,18,13,813,815,1628,1775
0132-000,2015,9,18,14,837,863,1700,1628
0132-000,2015,9,18,15,939,899,1838,1700
0132-000,2015,9,18,16,1018,893,1911,1838
0132-000,2015,9,18,17,1149,938,2087,1911
0132-000,2015,9,18,18,1557,1044,2601,2087
0132-000,2015,9,18,19,2027,967,2994,2601
0132-000,2015,9,18,20,1295,868,2163,2994
0132-000,2015,9,18,21,912,644,1556,2163
0132-000,2015,9,18,22,708,556,1264,1556
0132-000,2015,9,18,23,459,379,838,1264
0132-000,2015,9,18,24,272,261,533,838
0132-000,2015,9,19,1,216,237,453,533
0132-000,2015,9,19,2,142,146,288,453
0132-000,2015,9,19,3,108,131,239,288
0132-000,2015,9,19,4,106,116,222,239
0132-000,2015,9,19,5,105,120,225,222
0132-000,2015,9,19,6,245,182,427,225
0132-000,2015,9,19,7,435,449,884,427
0132-000,2015,9,19,8,584,959,1543,884
0132-000,2015,9,19,9,733,1176,1909,1543
0132-000,2015,9,19,10,849,1058,1907,1909
0132-000,2015,9,19,11,809,1054,1863,1907
0132-000,2015,9,19,12,952,1028,1980,1863
0132-000,2015,9,19,13,965,916,1881,1980
0132-000,2015,9,19,14,910,844,1754,1881
0132-000,2015,9,19,15,1017,927,1944,1754
0132-000,2015,9,19,16,1013,834,1847,1944
0132-000,2015,9,19,17,1130,986,2116,1847
0132-000,2015,9,19,18,1369,1030,2399,2116
0132-000,2015,9,19,19,1328,978,2306,2399
0132-000,2015,9,19,20,886,681,1567,2306
0132-000,2015,9,19,21,665,572,1237,1567
0132-000,2015,9,19,22,559,480,1039,1237
0132-000,2015,9,19,23,327,336,663,1039
0132-000,2015,9,19,24,231,272,503,663
0132-000,2015,9,20,1,178,199,377,503
0132-000,2015,9,20,2,107,154,261,377
0132-000,2015,9,20,3,100,119,219,261
0132-000,2015,9,20,4,90,83,173,219
0132-000,2015,9,20,5,93,108,201,173
0132-000,2015,9,20,6,188,135,323,201
0132-000,2015,9,20,7,300,322,622,323
0132-000,2015,9,20,8,347,513,860,622
0132-000,2015,9,20,9,470,609,1079,860
0132-000,2015,9,20,10,495,718,1213,1079
0132-000,2015,9,20,11,657,725,1382,1213
0132-000,2015,9,20,12,671,664,1335,1382
0132-000,2015,9,20,13,769,746,1515,1335
0132-000,2015,9,20,14,811,728,1539,1515
0132-000,2015,9,20,15,873,811,1684,1539
0132-000,2015,9,20,16,1001,766,1767,1684
0132-000,2015,9,20,17,1048,840,1888,1767
0132-000,2015,9,20,18,1152,813,1965,1888
0132-000,2015,9,20,19,1097,712,1809,1965
0132-000,2015,9,20,20,792,592,1384,1809
0132-000,2015,9,20,21,602,544,1146,1384
0132-000,2015,9,20,22,481,411,892,1146
0132-000,2015,9,20,23,337,303,640,892
0132-000,2015,9,20,24,167,171,338,640
0132-000,2015,9,21,1,128,111,239,338
0132-000,2015,9,21,2,78,73,151,239
0132-000,2015,9,21,3,58,67,125,151
0132-000,2015,9,21,4,58,87,145,125
0132-000,2015,9,21,5,61,80,141,145
0132-000,2015,9,21,6,225,188,413,141
0132-000,2015,9,21,7,539,658,1197,413
0132-000,2015,9,21,8,788,1825,2613,1197
0132-000,2015,9,21,9,887,1666,2553,2613
0132-000,2015,9,21,10,857,1023,1880,2553
0132-000,2015,9,21,11,908,912,1820,1880
0132-000,2015,9,21,12,908,929,1837,1820
0132-000,2015,9,21,13,837,899,1736,1837
0132-000,2015,9,21,14,882,938,1820,1736
0132-000,2015,9,21,15,934,904,1838,1820
0132-000,2015,9,21,16,1011,901,1912,1838
0132-000,2015,9,21,17,1103,951,2054,1912
0132-000,2015,9,21,18,1297,1018,2315,2054
0132-000,2015,9,21,19,1599,909,2508,2315
0132-000,2015,9,21,20,1043,725,1768,2508
0132-000,2015,9,21,21,866,604,1470,1768
0132-000,2015,9,21,22,722,469,1191,1470
0132-000,2015,9,21,23,391,337,728,1191
0132-000,2015,9,21,24,235,190,425,728
0132-000,2015,9,22,1,159,173,332,425
0132-000,2015,9,22,2,113,111,224,332
0132-000,2015,9,22,3,83,83,166,224
0132-000,2015,9,22,4,68,97,165,166
0132-000,2015,9,22,5,101,91,192,165
0132-000,2015,9,22,6,275,195,470,192
0132-000,2015,9,22,7,481,559,1040,470
0132-000,2015,9,22,8,805,1779,2584,1040
0132-000,2015,9,22,9,920,1544,2464,2584
0132-000,2015,9,22,10,891,1006,1897,2464
0132-000,2015,9,22,11,910,960,1870,1897
0132-000,2015,9,22,12,921,1006,1927,1870
0132-000,2015,9,22,13,800,983,1783,1927
0132-000,2015,9,22,14,943,1034,1977,1783
0132-000,2015,9,22,15,903,967,1870,1977
0132-000,2015,9,22,16,1101,893,1994,1870
0132-000,2015,9,22,17,1110,893,2003,1994
0132-000,2015,9,22,18,1231,974,2205,2003
0132-000,2015,9,22,19,1692,961,2653,2205
0132-000,2015,9,22,20,1045,744,1789,2653
0132-000,2015,9,22,21,852,632,1484,1789
0132-000,2015,9,22,22,715,481,1196,1484
0132-000,2015,9,22,23,425,360,785,1196
0132-000,2015,9,22,24,273,245,518,785
0132-000,2015,9,23,1,184,165,349,518
0132-000,2015,9,23,2,94,125,219,349
0132-000,2015,9,23,3,91,94,185,219
0132-000,2015,9,23,4,79,90,169,185
0132-000,2015,9,23,5,101,99,200,169
0132-000,2015,9,23,6,220,182,402,200
0132-000,2015,9,23,7,499,543,1042,402
0132-000,2015,9,23,8,779,1695,2474,1042
0132-000,2015,9,23,9,923,1529,2452,2474
0132-000,2015,9,23,10,955,963,1918,2452
0132-000,2015,9,23,11,891,947,1838,1918
0132-000,2015,9,23,12,927,980,1907,1838
0132-000,2015,9,23,13,949,891,1840,1907
0132-000,2015,9,23,14,921,982,1903,1840
0132-000,2015,9,23,15,995,938,1933,1903
0132-000,2015,9,23,16,1065,901,1966,1933
0132-000,2015,9,23,17,1091,938,2029,1966
0132-000,2015,9,23,18,1441,970,2411,2029
0132-000,2015,9,23,19,1606,985,2591,2411
0132-000,2015,9,23,20,1012,791,1803,2591
0132-000,2015,9,23,21,826,656,1482,1803
0132-000,2015,9,23,22,627,484,1111,1482
0132-000,2015,9,23,23,448,345,793,1111
0132-000,2015,9,23,24,272,229,501,793
0132-000,2015,9,24,1,198,179,377,501
0132-000,2015,9,24,2,150,120,270,377
0132-000,2015,9,24,3,102,109,211,270
0132-000,2015,9,24,4,83,92,175,211
0132-000,2015,9,24,5,104,110,214,175
0132-000,2015,9,24,6,232,179,411,214
0132-000,2015,9,24,7,474,557,1031,411
0132-000,2015,9,24,8,772,1685,2457,1031
0132-000,2015,9,24,9,922,1541,2463,2457
0132-000,2015,9,24,10,927,1020,1947,2463
0132-000,2015,9,24,11,918,945,1863,1947
0132-000,2015,9,24,12,950,928,1878,1863
0132-000,2015,9,24,13,902,890,1792,1878
0132-000,2015,9,24,14,964,908,1872,1792
0132-000,2015,9,24,15,947,966,1913,1872
0132-000,2015,9,24,16,1066,917,1983,1913
0132-000,2015,9,24,17,1178,969,2147,1983
0132-000,2015,9,24,18,1455,1091,2546,2147
0132-000,2015,9,24,19,1600,996,2596,2546
0132-000,2015,9,24,20,1124,833,1957,2596
0132-000,2015,9,24,21,927,672,1599,1957
0132-000,2015,9,24,22,714,571,1285,1599
0132-000,2015,9,24,23,480,421,901,1285
0132-000,2015,9,24,24,322,270,592,901
0132-000,2015,9,25,1,255,198,453,592
0132-000,2015,9,25,2,134,135,269,453
0132-000,2015,9,25,3,101,109,210,269
0132-000,2015,9,25,4,97,98,195,210
0132-000,2015,9,25,5,98,97,195,195
0132-000,2015,9,25,6,193,169,362,195
0132-000,2015,9,25,7,383,531,914,362
0132-000,2015,9,25,8,753,1574,2327,914
0132-000,2015,9,25,9,886,1500,2386,2327
0132-000,2015,9,25,10,879,991,1870,2386
0132-000,2015,9,25,11,893,1008,1901,1870
0132-000,2015,9,25,12,910,1029,1939,1901
0132-000,2015,9,25,13,938,1208,2146,1939
0132-000,2015,9,25,14,975,1401,2376,2146
0132-000,2015,9,25,15,993,1412,2405,2376
0132-000,2015,9,25,16,1167,1688,2855,2405
0132-000,2015,9,25,17,1312,1788,3100,2855
0132-000,2015,9,25,18,1531,1820,3351,3100
0132-000,2015,9,25,19,1383,1825,3208,3351
0132-000,2015,9,25,20,825,1658,2483,3208
0132-000,2015,9,25,21,606,1626,2232,2483
0132-000,2015,9,25,22,462,1479,1941,2232
0132-000,2015,9,25,23,366,1174,1540,1941
0132-000,2015,9,25,24,267,632,899,1540
0132-000,2015,9,26,1,207,545,752,899
0132-000,2015,9,26,2,125,587,712,752
0132-000,2015,9,26,3,130,640,770,712
0132-000,2015,9,26,4,95,1173,1268,770
0132-000,2015,9,26,5,82,1666,1748,1268
0132-000,2015,9,26,6,136,1597,1733,1748
0132-000,2015,9,26,7,169,1617,1786,1733
0132-000,2015,9,26,8,250,1782,2032,1786
0132-000,2015,9,26,9,403,2075,2478,2032
0132-000,2015,9,26,10,525,2152,2677,2478
0132-000,2015,9,26,11,697,2205,2902,2677
0132-000,2015,9,26,12,772,2182,2954,2902
0132-000,2015,9,26,13,714,2129,2843,2954
0132-000,2015,9,26,14,636,2032,2668,2843
0132-000,2015,9,26,15,573,1391,1964,2668
0132-000,2015,9,26,16,602,943,1545,1964
0132-000,2015,9,26,17,568,847,1415,1545
0132-000,2015,9,26,18,647,736,1383,1415
0132-000,2015,9,26,19,543,676,1219,1383
0132-000,2015,9,26,20,455,427,882,1219
0132-000,2015,9,26,21,363,370,733,882
0132-000,2015,9,26,22,290,310,600,733
0132-000,2015,9,26,23,232,259,491,600
0132-000,2015,9,26,24,138,184,322,491
0132-000,2015,9,27,1,100,139,239,322
0132-000,2015,9,27,2,65,84,149,239
0132-000,2015,9,27,3,57,65,122,149
0132-000,2015,9,27,4,41,63,104,122
0132-000,2015,9,27,5,67,48,115,104
0132-000,2015,9,27,6,103,124,227,115
0132-000,2015,9,27,7,213,364,577,227
0132-000,2015,9,27,8,393,960,1353,577
0132-000,2015,9,27,9,413,1098,1511,1353
0132-000,2015,9,27,10,521,1158,1679,1511
0132-000,2015,9,27,11,1019,1681,2700,1679
0132-000,2015,9,27,12,1713,1924,3637,2700
0132-000,2015,9,27,13,1970,1915,3885,3637
0132-000,2015,9,27,14,2259,2029,4288,3885
0132-000,2015,9,27,15,2217,2134,4351,4288
0132-000,2015,9,27,16,2329,2088,4417,4351
0132-000,2015,9,27,17,2148,2129,4277,4417
0132-000,2015,9,27,18,1897,2155,4052,4277
0132-000,2015,9,27,19,2112,1701,3813,4052
0132-000,2015,9,27,20,1888,941,2829,3813
0132-000,2015,9,27,21,1630,566,2196,2829
0132-000,2015,9,27,22,1608,403,2011,2196
0132-000,2015,9,27,23,976,264,1240,2011
0132-000,2015,9,27,24,890,210,1100,1240
0132-000,2015,9,28,1,513,135,648,1100
0132-000,2015,9,28,2,258,91,349,648
0132-000,2015,9,28,3,138,67,205,349
0132-000,2015,9,28,4,68,60,128,205
0132-000,2015,9,28,5,81,42,123,128
0132-000,2015,9,28,6,69,75,144,123
0132-000,2015,9,28,7,166,144,310,144
0132-000,2015,9,28,8,258,223,481,310
0132-000,2015,9,28,9,367,315,682,481
0132-000,2015,9,28,10,639,433,1072,682
0132-000,2015,9,28,11,1326,561,1887,1072
0132-000,2015,9,28,12,1542,683,2225,1887
0132-000,2015,9,28,13,1464,676,2140,2225
0132-000,2015,9,28,14,1650,623,2273,2140
0132-000,2015,9,28,15,1701,646,2347,2273
0132-000,2015,9,28,16,1732,651,2383,2347
0132-000,2015,9,28,17,2205,602,2807,2383
0132-000,2015,9,28,18,2036,525,2561,2807
0132-000,2015,9,28,19,2015,474,2489,2561
0132-000,2015,9,28,20,2111,414,2525,2489
0132-000,2015,9,28,21,1543,339,1882,2525
0132-000,2015,9,28,22,1303,318,1621,1882
0132-000,2015,9,28,23,1445,222,1667,1621
0132-000,2015,9,28,24,1288,182,1470,1667
0132-000,2015,9,29,1,1052,135,1187,1470
0132-000,2015,9,29,2,653,119,772,1187
0132-000,2015,9,29,3,241,99,340,772
0132-000,2015,9,29,4,120,58,178,340
0132-000,2015,9,29,5,82,78,160,178
0132-000,2015,9,29,6,88,62,150,160
0132-000,2015,9,29,7,168,182,350,150
0132-000,2015,9,29,8,338,392,730,350
0132-000,2015,9,29,9,424,490,914,730
0132-000,2015,9,29,10,516,504,1020,914
0132-000,2015,9,29,11,700,588,1288,1020
0132-000,2015,9,29,12,1012,649,1661,1288
0132-000,2015,9,29,13,1244,658,1902,1661
0132-000,2015,9,29,14,1004,643,1647,1902
0132-000,2015,9,29,15,1052,653,1705,1647
0132-000,2015,9,29,16,971,609,1580,1705
0132-000,2015,9,29,17,1046,658,1704,1580
0132-000,2015,9,29,18,1167,641,1808,1704
0132-000,2015,9,29,19,1130,613,1743,1808
0132-000,2015,9,29,20,833,505,1338,1743
0132-000,2015,9,29,21,608,443,1051,1338
0132-000,2015,9,29,22,552,399,951,1051
0132-000,2015,9,29,23,378,252,630,951
0132-000,2015,9,29,24,228,187,415,630
0132-000,2015,9,30,1,137,144,281,415
0132-000,2015,9,30,2,83,91,174,281
0132-000,2015,9,30,3,72,61,133,174
0132-000,2015,9,30,4,53,54,107,133
0132-000,2015,9,30,5,61,71,132,107
0132-000,2015,9,30,6,189,149,338,132
0132-000,2015,9,30,7,403,494,897,338
0132-000,2015,9,30,8,732,1646,2378,897
0132-000,2015,9,30,9,857,1357,2214,2378
0132-000,2015,9,30,10,697,806,1503,2214
0132-000,2015,9,30,11,750,784,1534,1503
0132-000,2015,9,30,12,724,838,1562,1534
0132-000,2015,9,30,13,758,767,1525,1562
0132-000,2015,9,30,14,839,769,1608,1525
0132-000,2015,9,30,15,936,824,1760,1608
0132-000,2015,9,30,16,945,744,1689,1760
0132-000,2015,9,30,17,884,828,1712,1689
0132-000,2015,9,30,18,1283,929,2212,1712
0132-000,2015,9,30,19,1385,860,2245,2212
0132-000,2015,9,30,20,852,637,1489,2245
0132-000,2015,9,30,21,755,504,1259,1489
0132-000,2015,9,30,22,496,369,865,1259
0132-000,2015,9,30,23,316,326,642,865
0132-000,2015,9,30,24,266,182,448,642
0132-000,2015,10,1,1,147,164,311,448
0132-000,2015,10,1,2,100,99,199,311
0132-000,2015,10,1,3,77,88,165,199
0132-000,2015,10,1,4,64,84,148,165
0132-000,2015,10,1,5,91,95,186,148
0132-000,2015,10,1,6,168,147,315,186
0132-000,2015,10,1,7,383,435,818,315
0132-000,2015,10,1,8,726,1602,2328,818
0132-000,2015,10,1,9,795,1440,2235,2328
0132-000,2015,10,1,10,767,875,1642,2235
0132-000,2015,10,1,11,770,773,1543,1642
0132-000,2015,10,1,12,770,747,1517,1543
0132-000,2015,10,1,13,684,739,1423,1517
0132-000,2015,10,1,14,790,757,1547,1423
0132-000,2015,10,1,15,820,749,1569,1547
0132-000,2015,10,1,16,852,754,1606,1569
0132-000,2015,10,1,17,912,764,1676,1606
0132-000,2015,10,1,18,1159,833,1992,1676
0132-000,2015,10,1,19,1342,804,2146,1992
0132-000,2015,10,1,20,860,578,1438,2146
0132-000,2015,10,1,21,707,532,1239,1438
0132-000,2015,10,1,22,579,394,973,1239
0132-000,2015,10,1,23,365,296,661,973
0132-000,2015,10,1,24,186,187,373,661
0132-000,2015,10,2,1,156,165,321,373
0132-000,2015,10,2,2,107,88,195,321
0132-000,2015,10,2,3,83,88,171,195
0132-000,2015,10,2,4,71,69,140,171
0132-000,2015,10,2,5,83,81,164,140
0132-000,2015,10,2,6,208,148,356,164
0132-000,2015,10,2,7,468,463,931,356
0132-000,2015,10,2,8,744,1686,2430,931
0132-000,2015,10,2,9,920,1483,2403,2430
0132-000,2015,10,2,10,812,914,1726,2403
0132-000,2015,10,2,11,827,899,1726,1726
0132-000,2015,10,2,12,833,878,1711,1726
0132-000,2015,10,2,13,753,742,1495,1711
0132-000,2015,10,2,14,880,843,1723,1495
0132-000,2015,10,2,15,938,873,1811,1723
0132-000,2015,10,2,16,1028,839,1867,1811
0132-000,2015,10,2,17,1056,920,1976,1867
0132-000,2015,10,2,18,1449,1023,2472,1976
0132-000,2015,10,2,19,1826,1033,2859,2472
0132-000,2015,10,2,20,1208,796,2004,2859
0132-000,2015,10,2,21,828,558,1386,2004
0132-000,2015,10,2,22,605,492,1097,1386
0132-000,2015,10,2,23,367,322,689,1097
0132-000,2015,10,2,24,252,257,509,689
0132-000,2015,10,3,1,209,186,395,509
0132-000,2015,10,3,2,147,127,274,395
0132-000,2015,10,3,3,110,125,235,274
0132-000,2015,10,3,4,100,95,195,235
0132-000,2015,10,3,5,100,107,207,195
0132-000,2015,10,3,6,230,186,416,207
0132-000,2015,10,3,7,415,389,804,416
0132-000,2015,10,3,8,527,831,1358,804
0132-000,2015,10,3,9,704,864,1568,1358
0132-000,2015,10,3,10,715,972,1687,1568
0132-000,2015,10,3,11,810,1232,2042,1687
0132-000,2015,10,3,12,1070,1312,2382,2042
0132-000,2015,10,3,13,785,1319,2104,2382
0132-000,2015,10,3,14,821,1059,1880,2104
0132-000,2015,10,3,15,877,869,1746,1880
0132-000,2015,10,3,16,971,809,1780,1746
0132-000,2015,10,3,17,1038,802,1840,1780
0132-000,2015,10,3,18,1358,934,2292,1840
0132-000,2015,10,3,19,1236,864,2100,2292
0132-000,2015,10,3,20,818,588,1406,2100
0132-000,2015,10,3,21,580,498,1078,1406
0132-000,2015,10,3,22,429,398,827,1078
0132-000,2015,10,3,23,329,343,672,827
0132-000,2015,10,3,24,203,226,429,672
0132-000,2015,10,4,1,175,171,346,429
0132-000,2015,10,4,2,110,105,215,346
0132-000,2015,10,4,3,98,88,186,215
0132-000,2015,10,4,4,68,86,154,186
0132-000,2015,10,4,5,86,72,158,154
0132-000,2015,10,4,6,162,112,274,158
0132-000,2015,10,4,7,257,202,459,274
0132-000,2015,10,4,8,314,418,732,459
0132-000,2015,10,4,9,405,490,895,732
0132-000,2015,10,4,10,492,566,1058,895
0132-000,2015,10,4,11,546,680,1226,1058
0132-000,2015,10,4,12,552,660,1212,1226
0132-000,2015,10,4,13,631,649,1280,1212
0132-000,2015,10,4,14,713,738,1451,1280
0132-000,2015,10,4,15,797,716,1513,1451
0132-000,2015,10,4,16,1035,699,1734,1513
0132-000,2015,10,4,17,1040,695,1735,1734
0132-000,2015,10,4,18,1218,785,2003,1735
0132-000,2015,10,4,19,1057,654,1711,2003
0132-000,2015,10,4,20,684,559,1243,1711
0132-000,2015,10,4,21,553,454,1007,1243
0132-000,2015,10,4,22,437,370,807,1007
0132-000,2015,10,4,23,284,292,576,807
0132-000,2015,10,4,24,187,184,371,576
0132-000,2015,10,5,1,126,135,261,371
0132-000,2015,10,5,2,73,72,145,261
0132-000,2015,10,5,3,45,74,119,145
0132-000,2015,10,5,4,62,54,116,119
0132-000,2015,10,5,5,68,76,144,116
0132-000,2015,10,5,6,236,168,404,144
0132-000,2015,10,5,7,496,595,1091,404
0132-000,2015,10,5,8,754,1855,2609,1091
0132-000,2015,10,5,9,869,1547,2416,2609
0132-000,2015,10,5,10,905,941,1846,2416
0132-000,2015,10,5,11,816,853,1669,1846
0132-000,2015,10,5,12,780,843,1623,1669
0132-000,2015,10,5,13,779,830,1609,1623
0132-000,2015,10,5,14,848,887,1735,1609
0132-000,2015,10,5,15,908,879,1787,1735
0132-000,2015,10,5,16,989,789,1778,1787
0132-000,2015,10,5,17,965,892,1857,1778
0132-000,2015,10,5,18,1267,945,2212,1857
0132-000,2015,10,5,19,1457,899,2356,2212
0132-000,2015,10,5,20,1012,732,1744,2356
0132-000,2015,10,5,21,827,551,1378,1744
0132-000,2015,10,5,22,634,452,1086,1378
0132-000,2015,10,5,23,334,307,641,1086
0132-000,2015,10,5,24,194,208,402,641
0132-000,2015,10,6,1,147,152,299,402
0132-000,2015,10,6,2,102,76,178,299
0132-000,2015,10,6,3,80,101,181,178
0132-000,2015,10,6,4,80,78,158,181
0132-000,2015,10,6,5,79,90,169,158
0132-000,2015,10,6,6,229,152,381,169
0132-000,2015,10,6,7,493,529,1022,381
0132-000,2015,10,6,8,736,1722,2458,1022
0132-000,2015,10,6,9,905,1569,2474,2458
0132-000,2015,10,6,10,883,968,1851,2474
0132-000,2015,10,6,11,818,819,1637,1851
0132-000,2015,10,6,12,814,906,1720,1637
0132-000,2015,10,6,13,806,856,1662,1720
0132-000,2015,10,6,14,848,879,1727,1662
0132-000,2015,10,6,15,938,880,1818,1727
0132-000,2015,10,6,16,952,805,1757,1818
0132-000,2015,10,6,17,1056,841,1897,1757
0132-000,2015,10,6,18,1290,907,2197,1897
0132-000,2015,10,6,19,1446,942,2388,2197
0132-000,2015,10,6,20,974,691,1665,2388
0132-000,2015,10,6,21,840,531,1371,1665
0132-000,2015,10,6,22,585,433,1018,1371
0132-000,2015,10,6,23,400,294,694,1018
0132-000,2015,10,6,24,245,235,480,694
0132-000,2015,10,7,1,157,148,305,480
0132-000,2015,10,7,2,122,100,222,305
0132-000,2015,10,7,3,73,94,167,222
0132-000,2015,10,7,4,71,86,157,167
0132-000,2015,10,7,5,83,94,177,157
0132-000,2015,10,7,6,214,164,378,177
0132-000,2015,10,7,7,464,515,979,378
0132-000,2015,10,7,8,734,1719,2453,979
0132-000,2015,10,7,9,927,1549,2476,2453
0132-000,2015,10,7,10,886,944,1830,2476
0132-000,2015,10,7,11,820,875,1695,1830
0132-000,2015,10,7,12,819,868,1687,1695
0132-000,2015,10,7,13,821,773,1594,1687
0132-000,2015,10,7,14,799,850,1649,1594
0132-000,2015,10,7,15,900,952,1852,1649
0132-000,2015,10,7,16,1013,846,1859,1852
0132-000,2015,10,7,17,1049,796,1845,1859
0132-000,2015,10,7,18,1090,978,2068,1845
0132-000,2015,10,7,19,1512,862,2374,2068
0132-000,2015,10,7,20,1097,722,1819,2374
0132-000,2015,10,7,21,824,498,1322,1819
0132-000,2015,10,7,22,582,451,1033,1322
0132-000,2015,10,7,23,383,329,712,1033
0132-000,2015,10,7,24,268,210,478,712
0132-000,2015,10,8,1,190,174,364,478
0132-000,2015,10,8,2,109,118,227,364
0132-000,2015,10,8,3,95,91,186,227
0132-000,2015,10,8,4,61,87,148,186
0132-000,2015,10,8,5,83,96,179,148
0132-000,2015,10,8,6,238,153,391,179
0132-000,2015,10,8,7,507,516,1023,391
0132-000,2015,10,8,8,731,1697,2428,1023
0132-000,2015,10,8,9,914,1542,2456,2428
0132-000,2015,10,8,10,895,895,1790,2456
0132-000,2015,10,8,11,847,905,1752,1790
0132-000,2015,10,8,12,826,878,1704,1752
0132-000,2015,10,8,13,804,830,1634,1704
0132-000,2015,10,8,14,889,866,1755,1634
0132-000,2015,10,8,15,952,890,1842,1755
0132-000,2015,10,8,16,1059,941,2000,1842
0132-000,2015,10,8,17,1118,921,2039,2000
0132-000,2015,10,8,18,1474,1111,2585,2039
0132-000,2015,10,8,19,1694,983,2677,2585
0132-000,2015,10,8,20,1186,834,2020,2677
0132-000,2015,10,8,21,928,616,1544,2020
0132-000,2015,10,8,22,683,517,1200,1544
0132-000,2015,10,8,23,406,376,782,1200
0132-000,2015,10,8,24,274,270,544,782
0132-000,2015,10,9,1,201,193,394,544
0132-000,2015,10,9,2,150,147,297,394
0132-000,2015,10,9,3,124,112,236,297
0132-000,2015,10,9,4,95,110,205,236
0132-000,2015,10,9,5,111,118,229,205
0132-000,2015,10,9,6,239,165,404,229
0132-000,2015,10,9,7,430,426,856,404
0132-000,2015,10,9,8,621,919,1540,856
0132-000,2015,10,9,9,686,1060,1746,1540
0132-000,2015,10,9,10,670,1293,1963,1746
0132-000,2015,10,9,11,738,1567,2305,1963
0132-000,2015,10,9,12,752,1738,2490,2305
0132-000,2015,10,9,13,696,1777,2473,2490
0132-000,2015,10,9,14,792,1764,2556,2473
0132-000,2015,10,9,15,842,1767,2609,2556
0132-000,2015,10,9,16,863,1702,2565,2609
0132-000,2015,10,9,17,972,1308,2280,2565
0132-000,2015,10,9,18,1250,1397,2647,2280
0132-000,2015,10,9,19,1235,1015,2250,2647
0132-000,2015,10,9,20,869,648,1517,2250
0132-000,2015,10,9,21,661,522,1183,1517
0132-000,2015,10,9,22,525,404,929,1183
0132-000,2015,10,9,23,365,327,692,929
0132-000,2015,10,9,24,226,250,476,692
0132-000,2015,10,10,1,171,179,350,476
0132-000,2015,10,10,2,122,122,244,350
0132-000,2015,10,10,3,98,108,206,244
0132-000,2015,10,10,4,99,93,192,206
0132-000,2015,10,10,5,88,102,190,192
0132-000,2015,10,10,6,177,146,323,190
0132-000,2015,10,10,7,358,325,683,323
0132-000,2015,10,10,8,472,860,1332,683
0132-000,2015,10,10,9,707,1121,1828,1332
0132-000,2015,10,10,10,812,1067,1879,1828
0132-000,2015,10,10,11,747,912,1659,1879
0132-000,2015,10,10,12,825,944,1769,1659
0132-000,2015,10,10,13,816,843,1659,1769
0132-000,2015,10,10,14,824,866,1690,1659
0132-000,2015,10,10,15,1226,868,2094,1690
0132-000,2015,10,10,16,1068,809,1877,2094
0132-000,2015,10,10,17,1140,807,1947,1877
0132-000,2015,10,10,18,1473,844,2317,1947
0132-000,2015,10,10,19,1281,741,2022,2317
0132-000,2015,10,10,20,1117,538,1655,2022
0132-000,2015,10,10,21,856,483,1339,1655
0132-000,2015,10,10,22,586,353,939,1339
0132-000,2015,10,10,23,310,293,603,939
0132-000,2015,10,10,24,224,192,416,603
0132-000,2015,10,11,1,157,173,330,416
0132-000,2015,10,11,2,100,116,216,330
0132-000,2015,10,11,3,66,84,150,216
0132-000,2015,10,11,4,79,69,148,150
0132-000,2015,10,11,5,76,59,135,148
0132-000,2015,10,11,6,147,106,253,135
0132-000,2015,10,11,7,223,197,420,253
0132-000,2015,10,11,8,287,330,617,420
0132-000,2015,10,11,9,384,435,819,617
0132-000,2015,10,11,10,476,550,1026,819
0132-000,2015,10,11,11,634,645,1279,1026
0132-000,2015,10,11,12,780,698,1478,1279
0132-000,2015,10,11,13,700,847,1547,1478
0132-000,2015,10,11,14,753,700,1453,1547
0132-000,2015,10,11,15,848,744,1592,1453
0132-000,2015,10,11,16,1044,834,1878,1592
0132-000,2015,10,11,17,1110,1196,2306,1878
0132-000,2015,10,11,18,1336,798,2134,2306
0132-000,2015,10,11,19,1270,573,1843,2134
0132-000,2015,10,11,20,899,514,1413,1843
0132-000,2015,10,11,21,666,438,1104,1413
0132-000,2015,10,11,22,427,378,805,1104
0132-000,2015,10,11,23,269,312,581,805
0132-000,2015,10,11,24,176,163,339,581
0132-000,2015,10,12,1,103,126,229,339
0132-000,2015,10,12,2,81,81,162,229
0132-000,2015,10,12,3,56,59,115,162
0132-000,2015,10,12,4,43,59,102,115
0132-000,2015,10,12,5,74,71,145,102
0132-000,2015,10,12,6,214,178,392,145
0132-000,2015,10,12,7,474,586,1060,392
0132-000,2015,10,12,8,762,1782,2544,1060
0132-000,2015,10,12,9,896,1604,2500,2544
0132-000,2015,10,12,10,812,882,1694,2500
0132-000,2015,10,12,11,832,899,1731,1694
0132-000,2015,10,12,12,792,891,1683,1731
0132-000,2015,10,12,13,758,859,1617,1683
0132-000,2015,10,12,14,849,908,1757,1617
0132-000,2015,10,12,15,969,951,1920,1757
0132-000,2015,10,12,16,1029,909,1938,1920
0132-000,2015,10,12,17,985,883,1868,1938
0132-000,2015,10,12,18,1329,1036,2365,1868
0132-000,2015,10,12,19,1441,949,2390,2365
0132-000,2015,10,12,20,979,663,1642,2390
0132-000,2015,10,12,21,779,547,1326,1642
0132-000,2015,10,12,22,623,446,1069,1326
0132-000,2015,10,12,23,407,311,718,1069
0132-000,2015,10,12,24,206,216,422,718
0132-000,2015,10,13,1,141,125,266,422
0132-000,2015,10,13,2,101,90,191,266
0132-000,2015,10,13,3,94,76,170,191
0132-000,2015,10,13,4,76,86,162,170
0132-000,2015,10,13,5,84,77,161,162
0132-000,2015,10,13,6,227,148,375,161
0132-000,2015,10,13,7,511,524,1035,375
0132-000,2015,10,13,8,804,1650,2454,1035
0132-000,2015,10,13,9,871,1616,2487,2454
0132-000,2015,10,13,10,875,988,1863,2487
0132-000,2015,10,13,11,871,885,1756,1863
0132-000,2015,10,13,12,873,880,1753,1756
0132-000,2015,10,13,13,785,825,1610,1753
0132-000,2015,10,13,14,939,898,1837,1610
0132-000,2015,10,13,15,948,930,1878,1837
0132-000,2015,10,13,16,1018,864,1882,1878
0132-000,2015,10,13,17,1021,892,1913,1882
0132-000,2015,10,13,18,1258,960,2218,1913
0132-000,2015,10,13,19,1457,884,2341,2218
0132-000,2015,10,13,20,971,678,1649,2341
0132-000,2015,10,13,21,801,535,1336,1649
0132-000,2015,10,13,22,596,475,1071,1336
0132-000,2015,10,13,23,375,332,707,1071
0132-000,2015,10,13,24,238,191,429,707
0132-000,2015,10,14,1,174,158,332,429
0132-000,2015,10,14,2,117,105,222,332
0132-000,2015,10,14,3,81,88,169,222
0132-000,2015,10,14,4,86,88,174,169
0132-000,2015,10,14,5,74,85,159,174
0132-000,2015,10,14,6,224,139,363,159
0132-000,2015,10,14,7,498,512,1010,363
0132-000,2015,10,14,8,787,1389,2176,1010
0132-000,2015,10,14,9,883,798,1681,2176
0132-000,2015,10,14,10,838,789,1627,1681
0132-000,2015,10,14,11,858,846,1704,1627
0132-000,2015,10,14,12,854,956,1810,1704
0132-000,2015,10,14,13,805,838,1643,1810
0132-000,2015,10,14,14,860,913,1773,1643
0132-000,2015,10,14,15,971,883,1854,1773
0132-000,2015,10,14,16,974,909,1883,1854
0132-000,2015,10,14,17,1017,934,1951,1883
0132-000,2015,10,14,18,1452,949,2401,1951
0132-000,2015,10,14,19,1582,880,2462,2401
0132-000,2015,10,14,20,972,713,1685,2462
0132-000,2015,10,14,21,777,561,1338,1685
0132-000,2015,10,14,22,586,445,1031,1338
0132-000,2015,10,14,23,374,320,694,1031
0132-000,2015,10,14,24,227,216,443,694
0132-000,2015,10,15,1,198,163,361,443
0132-000,2015,10,15,2,125,101,226,361
0132-000,2015,10,15,3,92,93,185,226
0132-000,2015,10,15,4,92,102,194,185
0132-000,2015,10,15,5,90,94,184,194
0132-000,2015,10,15,6,221,158,379,184
0132-000,2015,10,15,7,479,500,979,379
0132-000,2015,10,15,8,755,1658,2413,979
0132-000,2015,10,15,9,911,1510,2421,2413
0132-000,2015,10,15,10,867,956,1823,2421
0132-000,2015,10,15,11,872,910,1782,1823
0132-000,2015,10,15,12,883,956,1839,1782
0132-000,2015,10,15,13,822,869,1691,1839
0132-000,2015,10,15,14,917,877,1794,1691
0132-000,2015,10,15,15,997,859,1856,1794
0132-000,2015,10,15,16,1044,884,1928,1856
0132-000,2015,10,15,17,1008,946,1954,1928
0132-000,2015,10,15,18,1361,1015,2376,1954
0132-000,2015,10,15,19,1498,879,2377,2376
0132-000,2015,10,15,20,958,680,1638,2377
0132-000,2015,10,15,21,817,535,1352,1638
0132-000,2015,10,15,22,650,503,1153,1352
0132-000,2015,10,15,23,407,330,737,1153
0132-000,2015,10,15,24,258,227,485,737
0132-000,2015,10,16,1,190,160,350,485
0132-000,2015,10,16,2,122,158,280,350
0132-000,2015,10,16,3,90,93,183,280
0132-000,2015,10,16,4,69,88,157,183
0132-000,2015,10,16,5,82,105,187,157
0132-000,2015,10,16,6,218,151,369,187
0132-000,2015,10,16,7,472,541,1013,369
0132-000,2015,10,16,8,773,1664,2437,1013
0132-000,2015,10,16,9,897,1503,2400,2437
0132-000,2015,10,16,10,852,950,1802,2400
0132-000,2015,10,16,11,848,948,1796,1802
0132-000,2015,10,16,12,871,936,1807,1796
0132-000,2015,10,16,13,877,845,1722,1807
0132-000,2015,10,16,14,904,900,1804,1722
0132-000,2015,10,16,15,988,981,1969,1804
0132-000,2015,10,16,16,1112,907,2019,1969
0132-000,2015,10,16,17,1195,982,2177,2019
0132-000,2015,10,16,18,1456,1075,2531,2177
0132-000,2015,10,16,19,1831,981,2812,2531
0132-000,2015,10,16,20,1109,733,1842,2812
0132-000,2015,10,16,21,907,649,1556,1842
0132-000,2015,10,16,22,620,496,1116,1556
0132-000,2015,10,16,23,475,387,862,1116
0132-000,2015,10,16,24,315,257,572,862
0132-000,2015,10,17,1,237,219,456,572
0132-000,2015,10,17,2,149,136,285,456
0132-000,2015,10,17,3,107,121,228,285
0132-000,2015,10,17,4,105,107,212,228
0132-000,2015,10,17,5,113,105,218,212
0132-000,2015,10,17,6,203,149,352,218
0132-000,2015,10,17,7,428,399,827,352
0132-000,2015,10,17,8,588,888,1476,827
0132-000,2015,10,17,9,772,1130,1902,1476
0132-000,2015,10,17,10,743,1119,1862,1902
0132-000,2015,10,17,11,938,1230,2168,1862
0132-000,2015,10,17,12,932,1146,2078,2168
0132-000,2015,10,17,13,1109,1259,2368,2078
0132-000,2015,10,17,14,999,1258,2257,2368
0132-000,2015,10,17,15,922,1138,2060,2257
0132-000,2015,10,17,16,1092,1001,2093,2060
0132-000,2015,10,17,17,1218,1086,2304,2093
0132-000,2015,10,17,18,1622,1093,2715,2304
0132-000,2015,10,17,19,1656,901,2557,2715
0132-000,2015,10,17,20,1270,641,1911,2557
0132-000,2015,10,17,21,812,585,1397,1911
0132-000,2015,10,17,22,587,477,1064,1397
0132-000,2015,10,17,23,363,334,697,1064
0132-000,2015,10,17,24,244,247,491,697
0132-000,2015,10,18,1,148,198,346,491
0132-000,2015,10,18,2,139,140,279,346
0132-000,2015,10,18,3,94,105,199,279
0132-000,2015,10,18,4,64,80,144,199
0132-000,2015,10,18,5,84,75,159,144
0132-000,2015,10,18,6,142,106,248,159
0132-000,2015,10,18,7,286,229,515,248
0132-000,2015,10,18,8,342,382,724,515
0132-000,2015,10,18,9,447,522,969,724
0132-000,2015,10,18,10,517,637,1154,969
0132-000,2015,10,18,11,605,733,1338,1154
0132-000,2015,10,18,12,634,684,1318,1338
0132-000,2015,10,18,13,678,728,1406,1318
0132-000,2015,10,18,14,759,759,1518,1406
0132-000,2015,10,18,15,850,803,1653,1518
0132-000,2015,10,18,16,1049,775,1824,1653
0132-000,2015,10,18,17,1168,768,1936,1824
0132-000,2015,10,18,18,1327,776,2103,1936
0132-000,2015,10,18,19,1373,737,2110,2103
0132-000,2015,10,18,20,1062,555,1617,2110
0132-000,2015,10,18,21,810,512,1322,1617
0132-000,2015,10,18,22,567,383,950,1322
0132-000,2015,10,18,23,354,344,698,950
0132-000,2015,10,18,24,188,183,371,698
0132-000,2015,10,19,1,120,125,245,371
0132-000,2015,10,19,2,83,110,193,245
0132-000,2015,10,19,3,54,63,117,193
0132-000,2015,10,19,4,53,60,113,117
0132-000,2015,10,19,5,72,75,147,113
0132-000,2015,10,19,6,210,168,378,147
0132-000,2015,10,19,7,487,556,1043,378
0132-000,2015,10,19,8,808,1757,2565,1043
0132-000,2015,10,19,9,880,1639,2519,2565
0132-000,2015,10,19,10,812,937,1749,2519
0132-000,2015,10,19,11,854,879,1733,1749
0132-000,2015,10,19,12,816,842,1658,1733
0132-000,2015,10,19,13,819,782,1601,1658
0132-000,2015,10,19,14,835,814,1649,1601
0132-000,2015,10,19,15,872,885,1757,1649
0132-000,2015,10,19,16,999,890,1889,1757
0132-000,2015,10,19,17,1015,867,1882,1889
0132-000,2015,10,19,18,1268,960,2228,1882
0132-000,2015,10,19,19,1550,896,2446,2228
0132-000,2015,10,19,20,902,640,1542,2446
0132-000,2015,10,19,21,806,510,1316,1542
0132-000,2015,10,19,22,591,450,1041,1316
0132-000,2015,10,19,23,339,310,649,1041
0132-000,2015,10,19,24,213,189,402,649
0132-000,2015,10,20,1,136,147,283,402
0132-000,2015,10,20,2,88,87,175,283
0132-000,2015,10,20,3,89,79,168,175
0132-000,2015,10,20,4,70,92,162,168
0132-000,2015,10,20,5,76,86,162,162
0132-000,2015,10,20,6,226,133,359,162
0132-000,2015,10,20,7,450,468,918,359
0132-000,2015,10,20,8,786,1545,2331,918
0132-000,2015,10,20,9,880,1649,2529,2331
0132-000,2015,10,20,10,840,992,1832,2529
0132-000,2015,10,20,11,892,916,1808,1832
0132-000,2015,10,20,12,822,917,1739,1808
0132-000,2015,10,20,13,843,855,1698,1739
0132-000,2015,10,20,14,898,900,1798,1698
0132-000,2015,10,20,15,908,899,1807,1798
0132-000,2015,10,20,16,997,817,1814,1807
0132-000,2015,10,20,17,994,950,1944,1814
0132-000,2015,10,20,18,1305,939,2244,1944
0132-000,2015,10,20,19,1481,937,2418,2244
0132-000,2015,10,20,20,955,638,1593,2418
0132-000,2015,10,20,21,796,569,1365,1593
0132-000,2015,10,20,22,619,439,1058,1365
0132-000,2015,10,20,23,416,320,736,1058
0132-000,2015,10,20,24,220,211,431,736
0132-000,2015,10,21,1,171,140,311,431
0132-000,2015,10,21,2,119,102,221,311
0132-000,2015,10,21,3,88,99,187,221
0132-000,2015,10,21,4,80,71,151,187
0132-000,2015,10,21,5,71,86,157,151
0132-000,2015,10,21,6,213,139,352,157
0132-000,2015,10,21,7,446,479,925,352
0132-000,2015,10,21,8,807,1578,2385,925
0132-000,2015,10,21,9,940,1628,2568,2385
0132-000,2015,10,21,10,855,967,1822,2568
0132-000,2015,10,21,11,882,858,1740,1822
0132-000,2015,10,21,12,862,896,1758,1740
0132-000,2015,10,21,13,790,872,1662,1758
0132-000,2015,10,21,14,905,879,1784,1662
0132-000,2015,10,21,15,992,942,1934,1784
0132-000,2015,10,21,16,963,871,1834,1934
0132-000,2015,10,21,17,984,955,1939,1834
0132-000,2015,10,21,18,1382,980,2362,1939
0132-000,2015,10,21,19,1620,950,2570,2362
0132-000,2015,10,21,20,916,694,1610,2570
0132-000,2015,10,21,21,777,575,1352,1610
0132-000,2015,10,21,22,605,438,1043,1352
0132-000,2015,10,21,23,378,341,719,1043
0132-000,2015,10,21,24,223,220,443,719
0132-000,2015,10,22,1,180,163,343,443
0132-000,2015,10,22,2,112,106,218,343
0132-000,2015,10,22,3,74,78,152,218
0132-000,2015,10,22,4,69,93,162,152
0132-000,2015,10,22,5,79,86,165,162
0132-000,2015,10,22,6,191,128,319,165
0132-000,2015,10,22,7,475,442,917,319
0132-000,2015,10,22,8,750,1539,2289,917
0132-000,2015,10,22,9,893,1646,2539,2289
0132-000,2015,10,22,10,830,871,1701,2539
0132-000,2015,10,22,11,810,893,1703,1701
0132-000,2015,10,22,12,915,897,1812,1703
0132-000,2015,10,22,13,742,853,1595,1812
0132-000,2015,10,22,14,864,875,1739,1595
0132-000,2015,10,22,15,883,894,1777,1739
0132-000,2015,10,22,16,1007,836,1843,1777
0132-000,2015,10,22,17,991,870,1861,1843
0132-000,2015,10,22,18,1314,967,2281,1861
0132-000,2015,10,22,19,1527,926,2453,2281
0132-000,2015,10,22,20,952,652,1604,2453
0132-000,2015,10,22,21,807,570,1377,1604
0132-000,2015,10,22,22,665,435,1100,1377
0132-000,2015,10,22,23,415,355,770,1100
0132-000,2015,10,22,24,252,213,465,770
0132-000,2015,10,23,1,195,156,351,465
0132-000,2015,10,23,2,127,125,252,351
0132-000,2015,10,23,3,89,85,174,252
0132-000,2015,10,23,4,76,92,168,174
0132-000,2015,10,23,5,75,86,161,168
0132-000,2015,10,23,6,192,134,326,161
0132-000,2015,10,23,7,436,504,940,326
0132-000,2015,10,23,8,795,1570,2365,940
0132-000,2015,10,23,9,928,1568,2496,2365
0132-000,2015,10,23,10,830,905,1735,2496
0132-000,2015,10,23,11,897,894,1791,1735
0132-000,2015,10,23,12,860,951,1811,1791
0132-000,2015,10,23,13,844,845,1689,1811
0132-000,2015,10,23,14,885,863,1748,1689
0132-000,2015,10,23,15,993,964,1957,1748
0132-000,2015,10,23,16,1064,893,1957,1957
0132-000,2015,10,23,17,1080,890,1970,1957
0132-000,2015,10,23,18,1467,974,2441,1970
0132-000,2015,10,23,19,1838,982,2820,2441
0132-000,2015,10,23,20,1136,750,1886,2820
0132-000,2015,10,23,21,873,622,1495,1886
0132-000,2015,10,23,22,619,524,1143,1495
0132-000,2015,10,23,23,438,419,857,1143
0132-000,2015,10,23,24,247,235,482,857
0132-000,2015,10,24,1,205,223,428,482
0132-000,2015,10,24,2,159,159,318,428
0132-000,2015,10,24,3,123,97,220,318
0132-000,2015,10,24,4,98,122,220,220
0132-000,2015,10,24,5,110,108,218,220
0132-000,2015,10,24,6,210,140,350,218
0132-000,2015,10,24,7,413,385,798,350
0132-000,2015,10,24,8,608,776,1384,798
0132-000,2015,10,24,9,735,1056,1791,1384
0132-000,2015,10,24,10,808,1131,1939,1791
0132-000,2015,10,24,11,787,1377,2164,1939
0132-000,2015,10,24,12,899,1650,2549,2164
0132-000,2015,10,24,13,896,1560,2456,2549
0132-000,2015,10,24,14,918,1316,2234,2456
0132-000,2015,10,24,15,889,1191,2080,2234
0132-000,2015,10,24,16,994,1055,2049,2080
0132-000,2015,10,24,17,1108,1018,2126,2049
0132-000,2015,10,24,18,1377,1057,2434,2126
0132-000,2015,10,24,19,1323,955,2278,2434
0132-000,2015,10,24,20,865,604,1469,2278
0132-000,2015,10,24,21,673,518,1191,1469
0132-000,2015,10,24,22,509,449,958,1191
0132-000,2015,10,24,23,355,346,701,958
0132-000,2015,10,24,24,250,237,487,701
0132-000,2015,10,25,1,168,156,324,487
0132-000,2015,10,25,2,118,155,273,324
0132-000,2015,10,25,3,86,72,158,273
0132-000,2015,10,25,4,84,98,182,158
0132-000,2015,10,25,5,73,72,145,182
0132-000,2015,10,25,6,142,108,250,145
0132-000,2015,10,25,7,256,210,466,250
0132-000,2015,10,25,8,342,386,728,466
0132-000,2015,10,25,9,422,501,923,728
0132-000,2015,10,25,10,468,622,1090,923
0132-000,2015,10,25,11,580,725,1305,1090
0132-000,2015,10,25,12,711,765,1476,1305
0132-000,2015,10,25,13,724,783,1507,1476
0132-000,2015,10,25,14,796,760,1556,1507
0132-000,2015,10,25,15,858,785,1643,1556
0132-000,2015,10,25,16,941,764,1705,1643
0132-000,2015,10,25,17,1211,814,2025,1705
0132-000,2015,10,25,18,1499,789,2288,2025
0132-000,2015,10,25,19,1330,716,2046,2288
0132-000,2015,10,25,20,1109,516,1625,2046
0132-000,2015,10,25,21,876,553,1429,1625
0132-000,2015,10,25,22,590,420,1010,1429
0132-000,2015,10,25,23,370,297,667,1010
0132-000,2015,10,25,24,228,214,442,667
0132-000,2015,10,26,1,97,138,235,442
0132-000,2015,10,26,2,73,67,140,235
0132-000,2015,10,26,3,46,51,97,140
0132-000,2015,10,26,4,46,66,112,97
0132-000,2015,10,26,5,86,66,152,112
0132-000,2015,10,26,6,208,166,374,152
0132-000,2015,10,26,7,472,546,1018,374
0132-000,2015,10,26,8,758,1764,2522,1018
0132-000,2015,10,26,9,926,1603,2529,2522
0132-000,2015,10,26,10,803,1041,1844,2529
0132-000,2015,10,26,11,796,1009,1805,1844
0132-000,2015,10,26,12,830,1056,1886,1805
0132-000,2015,10,26,13,787,1051,1838,1886
0132-000,2015,10,26,14,845,995,1840,1838
0132-000,2015,10,26,15,904,1011,1915,1840
0132-000,2015,10,26,16,973,919,1892,1915
0132-000,2015,10,26,17,1054,936,1990,1892
0132-000,2015,10,26,18,1324,948,2272,1990
0132-000,2015,10,26,19,1575,854,2429,2272
0132-000,2015,10,26,20,981,693,1674,2429
0132-000,2015,10,26,21,734,497,1231,1674
0132-000,2015,10,26,22,599,437,1036,1231
0132-000,2015,10,26,23,355,296,651,1036
0132-000,2015,10,26,24,223,200,423,651
0132-000,2015,10,27,1,146,139,285,423
0132-000,2015,10,27,2,105,99,204,285
0132-000,2015,10,27,3,69,68,137,204
0132-000,2015,10,27,4,80,69,149,137
0132-000,2015,10,27,5,69,84,153,149
0132-000,2015,10,27,6,143,121,264,153
0132-000,2015,10,27,7,360,372,732,264
0132-000,2015,10,27,8,654,1529,2183,732
0132-000,2015,10,27,9,806,1537,2343,2183
0132-000,2015,10,27,10,774,874,1648,2343
0132-000,2015,10,27,11,802,845,1647,1648
0132-000,2015,10,27,12,800,818,1618,1647
0132-000,2015,10,27,13,736,758,1494,1618
0132-000,2015,10,27,14,821,821,1642,1494
0132-000,2015,10,27,15,946,880,1826,1642
0132-000,2015,10,27,16,911,850,1761,1826
0132-000,2015,10,27,17,1015,854,1869,1761
0132-000,2015,10,27,18,1239,849,2088,1869
0132-000,2015,10,27,19,1425,855,2280,2088
0132-000,2015,10,27,20,867,645,1512,2280
0132-000,2015,10,27,21,752,532,1284,1512
0132-000,2015,10,27,22,607,474,1081,1284
0132-000,2015,10,27,23,367,309,676,1081
0132-000,2015,10,27,24,233,205,438,676
0132-000,2015,10,28,1,166,154,320,438
0132-000,2015,10,28,2,121,119,240,320
0132-000,2015,10,28,3,73,78,151,240
0132-000,2015,10,28,4,61,68,129,151
0132-000,2015,10,28,5,86,84,170,129
0132-000,2015,10,28,6,214,139,353,170
0132-000,2015,10,28,7,417,473,890,353
0132-000,2015,10,28,8,725,1606,2331,890
0132-000,2015,10,28,9,933,1613,2546,2331
0132-000,2015,10,28,10,898,1002,1900,2546
0132-000,2015,10,28,11,834,916,1750,1900
0132-000,2015,10,28,12,880,918,1798,1750
0132-000,2015,10,28,13,804,825,1629,1798
0132-000,2015,10,28,14,940,862,1802,1629
0132-000,2015,10,28,15,920,912,1832,1802
0132-000,2015,10,28,16,972,907,1879,1832
0132-000,2015,10,28,17,1038,871,1909,1879
0132-000,2015,10,28,18,1404,897,2301,1909
0132-000,2015,10,28,19,1531,902,2433,2301
0132-000,2015,10,28,20,954,603,1557,2433
0132-000,2015,10,28,21,786,629,1415,1557
0132-000,2015,10,28,22,574,422,996,1415
0132-000,2015,10,28,23,346,323,669,996
0132-000,2015,10,28,24,235,232,467,669
0132-000,2015,10,29,1,167,169,336,467
0132-000,2015,10,29,2,109,80,189,336
0132-000,2015,10,29,3,71,89,160,189
0132-000,2015,10,29,4,74,88,162,160
0132-000,2015,10,29,5,87,78,165,162
0132-000,2015,10,29,6,236,156,392,165
0132-000,2015,10,29,7,461,484,945,392
0132-000,2015,10,29,8,728,1662,2390,945
0132-000,2015,10,29,9,920,1487,2407,2390
0132-000,2015,10,29,10,823,882,1705,2407
0132-000,2015,10,29,11,808,942,1750,1705
0132-000,2015,10,29,12,802,876,1678,1750
0132-000,2015,10,29,13,760,808,1568,1678
0132-000,2015,10,29,14,847,819,1666,1568
0132-000,2015,10,29,15,939,862,1801,1666
0132-000,2015,10,29,16,945,797,1742,1801
0132-000,2015,10,29,17,1083,955,2038,1742
0132-000,2015,10,29,18,1388,920,2308,2038
0132-000,2015,10,29,19,1434,900,2334,2308
0132-000,2015,10,29,20,927,662,1589,2334
0132-000,2015,10,29,21,793,539,1332,1589
0132-000,2015,10,29,22,573,450,1023,1332
0132-000,2015,10,29,23,360,286,646,1023
0132-000,2015,10,29,24,251,212,463,646
0132-000,2015,10,30,1,165,166,331,463
0132-000,2015,10,30,2,112,91,203,331
0132-000,2015,10,30,3,72,93,165,203
0132-000,2015,10,30,4,80,71,151,165
0132-000,2015,10,30,5,96,95,191,151
0132-000,2015,10,30,6,224,154,378,191
0132-000,2015,10,30,7,447,486,933,378
0132-000,2015,10,30,8,713,1631,2344,933
0132-000,2015,10,30,9,886,1473,2359,2344
0132-000,2015,10,30,10,803,918,1721,2359
0132-000,2015,10,30,11,805,883,1688,1721
0132-000,2015,10,30,12,814,841,1655,1688
0132-000,2015,10,30,13,871,810,1681,1655
0132-000,2015,10,30,14,919,870,1789,1681
0132-000,2015,10,30,15,922,912,1834,1789
0132-000,2015,10,30,16,987,875,1862,1834
0132-000,2015,10,30,17,1076,956,2032,1862
0132-000,2015,10,30,18,1452,990,2442,2032
0132-000,2015,10,30,19,1755,919,2674,2442
0132-000,2015,10,30,20,1084,731,1815,2674
0132-000,2015,10,30,21,819,571,1390,1815
0132-000,2015,10,30,22,628,467,1095,1390
0132-000,2015,10,30,23,421,383,804,1095
0132-000,2015,10,30,24,217,261,478,804
0132-000,2015,10,31,1,219,187,406,478
0132-000,2015,10,31,2,119,160,279,406
0132-000,2015,10,31,3,117,121,238,279
0132-000,2015,10,31,4,88,109,197,238
0132-000,2015,10,31,5,95,99,194,197
0132-000,2015,10,31,6,215,132,347,194
0132-000,2015,10,31,7,383,369,752,347
0132-000,2015,10,31,8,562,873,1435,752
0132-000,2015,10,31,9,735,1200,1935,1435
0132-000,2015,10,31,10,741,1229,1970,1935
0132-000,2015,10,31,11,873,1198,2071,1970
0132-000,2015,10,31,12,1035,896,1931,2071
0132-000,2015,10,31,13,936,1005,1941,1931
0132-000,2015,10,31,14,907,1114,2021,1941
0132-000,2015,10,31,15,1002,1060,2062,2021
0132-000,2015,10,31,16,1086,995,2081,2062
0132-000,2015,10,31,17,1113,999,2112,2081
0132-000,2015,10,31,18,1435,1091,2526,2112
0132-000,2015,10,31,19,1400,929,2329,2526
0132-000,2015,10,31,20,937,650,1587,2329
0132-000,2015,10,31,21,648,538,1186,1587
0132-000,2015,10,31,22,521,422,943,1186
0132-000,2015,10,31,23,341,317,658,943
0132-000,2015,10,31,24,222,233,455,658
0132-000,2015,11,1,1,162,188,350,455
0132-000,2015,11,1,2,135,140,275,350
0132-000,2015,11,1,3,84,100,184,275
0132-000,2015,11,1,4,78,75,153,184
0132-000,2015,11,1,5,70,63,133,153
0132-000,2015,11,1,6,144,111,255,133
0132-000,2015,11,1,7,211,217,428,255
0132-000,2015,11,1,8,312,377,689,428
0132-000,2015,11,1,9,393,433,826,689
0132-000,2015,11,1,10,483,585,1068,826
0132-000,2015,11,1,11,588,745,1333,1068
0132-000,2015,11,1,12,682,712,1394,1333
0132-000,2015,11,1,13,684,742,1426,1394
0132-000,2015,11,1,14,809,837,1646,1426
0132-000,2015,11,1,15,909,828,1737,1646
0132-000,2015,11,1,16,1049,831,1880,1737
0132-000,2015,11,1,17,1301,788,2089,1880
0132-000,2015,11,1,18,1418,756,2174,2089
0132-000,2015,11,1,19,1375,633,2008,2174
0132-000,2015,11,1,20,928,510,1438,2008
0132-000,2015,11,1,21,762,513,1275,1438
0132-000,2015,11,1,22,534,422,956,1275
0132-000,2015,11,1,23,305,264,569,956
0132-000,2015,11,1,24,186,198,384,569
0132-000,2015,11,2,1,117,111,228,384
0132-000,2015,11,2,2,51,66,117,228
0132-000,2015,11,2,3,50,57,107,117
0132-000,2015,11,2,4,51,58,109,107
0132-000,2015,11,2,5,79,64,143,109
0132-000,2015,11,2,6,223,174,397,143
0132-000,2015,11,2,7,452,533,985,397
0132-000,2015,11,2,8,760,1798,2558,985
0132-000,2015,11,2,9,902,1611,2513,2558
0132-000,2015,11,2,10,831,966,1797,2513
0132-000,2015,11,2,11,849,906,1755,1797
0132-000,2015,11,2,12,845,784,1629,1755
0132-000,2015,11,2,13,785,877,1662,1629
0132-000,2015,11,2,14,874,838,1712,1662
0132-000,2015,11,2,15,924,902,1826,1712
0132-000,2015,11,2,16,1009,847,1856,1826
0132-000,2015,11,2,17,1003,920,1923,1856
0132-000,2015,11,2,18,1298,945,2243,1923
0132-000,2015,11,2,19,1476,839,2315,2243
0132-000,2015,11,2,20,918,618,1536,2315
0132-000,2015,11,2,21,772,532,1304,1536
0132-000,2015,11,2,22,604,411,1015,1304
0132-000,2015,11,2,23,380,319,699,1015
0132-000,2015,11,2,24,222,200,422,699
0132-000,2015,11,3,1,138,145,283,422
0132-000,2015,11,3,2,88,86,174,283
0132-000,2015,11,3,3,77,90,167,174
0132-000,2015,11,3,4,55,72,127,167
0132-000,2015,11,3,5,78,77,155,127
0132-000,2015,11,3,6,209,144,353,155
0132-000,2015,11,3,7,483,446,929,353
0132-000,2015,11,3,8,769,1709,2478,929
0132-000,2015,11,3,9,876,1586,2462,2478
0132-000,2015,11,3,10,873,963,1836,2462
0132-000,2015,11,3,11,837,894,1731,1836
0132-000,2015,11,3,12,867,870,1737,1731
0132-000,2015,11,3,13,816,782,1598,1737
0132-000,2015,11,3,14,856,864,1720,1598
0132-000,2015,11,3,15,912,868,1780,1720
0132-000,2015,11,3,16,999,851,1850,1780
0132-000,2015,11,3,17,1015,850,1865,1850
0132-000,2015,11,3,18,1336,923,2259,1865
0132-000,2015,11,3,19,1491,783,2274,2259
0132-000,2015,11,3,20,884,661,1545,2274
0132-000,2015,11,3,21,839,560,1399,1545
0132-000,2015,11,3,22,605,468,1073,1399
0132-000,2015,11,3,23,374,299,673,1073
0132-000,2015,11,3,24,247,197,444,673
0132-000,2015,11,4,1,160,138,298,444
0132-000,2015,11,4,2,91,94,185,298
0132-000,2015,11,4,3,73,66,139,185
0132-000,2015,11,4,4,62,74,136,139
0132-000,2015,11,4,5,100,95,195,136
0132-000,2015,11,4,6,230,151,381,195
0132-000,2015,11,4,7,499,487,986,381
0132-000,2015,11,4,8,781,1696,2477,986
0132-000,2015,11,4,9,907,1556,2463,2477
0132-000,2015,11,4,10,832,1005,1837,2463
0132-000,2015,11,4,11,874,866,1740,1837
0132-000,2015,11,4,12,836,876,1712,1740
0132-000,2015,11,4,13,796,751,1547,1712
0132-000,2015,11,4,14,856,811,1667,1547
0132-000,2015,11,4,15,919,944,1863,1667
0132-000,2015,11,4,16,967,832,1799,1863
0132-000,2015,11,4,17,1003,952,1955,1799
0132-000,2015,11,4,18,1438,950,2388,1955
0132-000,2015,11,4,19,1524,900,2424,2388
0132-000,2015,11,4,20,891,678,1569,2424
0132-000,2015,11,4,21,777,498,1275,1569
0132-000,2015,11,4,22,604,409,1013,1275
0132-000,2015,11,4,23,357,314,671,1013
0132-000,2015,11,4,24,231,191,422,671
0132-000,2015,11,5,1,165,137,302,422
0132-000,2015,11,5,2,103,120,223,302
0132-000,2015,11,5,3,84,91,175,223
0132-000,2015,11,5,4,81,89,170,175
0132-000,2015,11,5,5,70,90,160,170
0132-000,2015,11,5,6,235,152,387,160
0132-000,2015,11,5,7,469,474,943,387
0132-000,2015,11,5,8,763,1645,2408,943
0132-000,2015,11,5,9,913,1575,2488,2408
0132-000,2015,11,5,10,864,924,1788,2488
0132-000,2015,11,5,11,850,851,1701,1788
0132-000,2015,11,5,12,781,841,1622,1701
0132-000,2015,11,5,13,775,805,1580,1622
0132-000,2015,11,5,14,880,872,1752,1580
0132-000,2015,11,5,15,908,874,1782,1752
0132-000,2015,11,5,16,992,839,1831,1782
0132-000,2015,11,5,17,1073,875,1948,1831
0132-000,2015,11,5,18,1398,929,2327,1948
0132-000,2015,11,5,19,1600,870,2470,2327
0132-000,2015,11,5,20,1020,684,1704,2470
0132-000,2015,11,5,21,851,533,1384,1704
0132-000,2015,11,5,22,604,475,1079,1384
0132-000,2015,11,5,23,365,330,695,1079
0132-000,2015,11,5,24,275,229,504,695
0132-000,2015,11,6,1,170,173,343,504
0132-000,2015,11,6,2,98,108,206,343
0132-000,2015,11,6,3,81,78,159,206
0132-000,2015,11,6,4,87,89,176,159
0132-000,2015,11,6,5,86,98,184,176
0132-000,2015,11,6,6,223,141,364,184
0132-000,2015,11,6,7,452,525,977,364
0132-000,2015,11,6,8,766,1671,2437,977
0132-000,2015,11,6,9,918,1559,2477,2437
0132-000,2015,11,6,10,882,981,1863,2477
0132-000,2015,11,6,11,832,920,1752,1863
0132-000,2015,11,6,12,866,875,1741,1752
0132-000,2015,11,6,13,814,835,1649,1741
0132-000,2015,11,6,14,987,905,1892,1649
0132-000,2015,11,6,15,974,949,1923,1892
0132-000,2015,11,6,16,1111,935,2046,1923
0132-000,2015,11,6,17,1069,898,1967,2046
0132-000,2015,11,6,18,1569,1038,2607,1967
0132-000,2015,11,6,19,1807,867,2674,2607
0132-000,2015,11,6,20,1239,787,2026,2674
0132-000,2015,11,6,21,947,580,1527,2026
0132-000,2015,11,6,22,669,524,1193,1527
0132-000,2015,11,6,23,410,358,768,1193
0132-000,2015,11,6,24,258,285,543,768
0132-000,2015,11,7,1,178,214,392,543
0132-000,2015,11,7,2,128,149,277,392
0132-000,2015,11,7,3,109,110,219,277
0132-000,2015,11,7,4,82,100,182,219
0132-000,2015,11,7,5,94,84,178,182
0132-000,2015,11,7,6,166,112,278,178
0132-000,2015,11,7,7,262,279,541,278
0132-000,2015,11,7,8,454,695,1149,541
0132-000,2015,11,7,9,609,887,1496,1149
0132-000,2015,11,7,10,714,856,1570,1496
0132-000,2015,11,7,11,811,1083,1894,1570
0132-000,2015,11,7,12,938,1139,2077,1894
0132-000,2015,11,7,13,838,1152,1990,2077
0132-000,2015,11,7,14,840,1028,1868,1990
0132-000,2015,11,7,15,912,1092,2004,1868
0132-000,2015,11,7,16,1086,895,1981,2004
0132-000,2015,11,7,17,1345,916,2261,1981
0132-000,2015,11,7,18,1630,933,2563,2261
0132-000,2015,11,7,19,1323,798,2121,2563
0132-000,2015,11,7,20,837,564,1401,2121
0132-000,2015,11,7,21,578,497,1075,1401
0132-000,2015,11,7,22,445,373,818,1075
0132-000,2015,11,7,23,297,289,586,818
0132-000,2015,11,7,24,200,242,442,586
0132-000,2015,11,8,1,134,150,284,442
0132-000,2015,11,8,2,123,109,232,284
0132-000,2015,11,8,3,79,98,177,232
0132-000,2015,11,8,4,62,70,132,177
0132-000,2015,11,8,5,68,74,142,132
0132-000,2015,11,8,6,85,87,172,142
0132-000,2015,11,8,7,145,144,289,172
0132-000,2015,11,8,8,242,258,500,289
0132-000,2015,11,8,9,323,376,699,500
0132-000,2015,11,8,10,421,489,910,699
0132-000,2015,11,8,11,513,556,1069,910
0132-000,2015,11,8,12,639,603,1242,1069
0132-000,2015,11,8,13,695,676,1371,1242
0132-000,2015,11,8,14,733,709,1442,1371
0132-000,2015,11,8,15,822,748,1570,1442
0132-000,2015,11,8,16,859,781,1640,1570
0132-000,2015,11,8,17,985,724,1709,1640
0132-000,2015,11,8,18,1241,606,1847,1709
0132-000,2015,11,8,19,1129,559,1688,1847
0132-000,2015,11,8,20,809,463,1272,1688
0132-000,2015,11,8,21,614,435,1049,1272
0132-000,2015,11,8,22,407,355,762,1049
0132-000,2015,11,8,23,270,254,524,762
0132-000,2015,11,8,24,161,188,349,524
0132-000,2015,11,9,1,111,112,223,349
0132-000,2015,11,9,2,65,73,138,223
0132-000,2015,11,9,3,58,59,117,138
0132-000,2015,11,9,4,43,65,108,117
0132-000,2015,11,9,5,66,59,125,108
0132-000,2015,11,9,6,211,173,384,125
0132-000,2015,11,9,7,427,549,976,384
0132-000,2015,11,9,8,726,1767,2493,976
0132-000,2015,11,9,9,833,1551,2384,2493
0132-000,2015,11,9,10,789,907,1696,2384
0132-000,2015,11,9,11,815,861,1676,1696
0132-000,2015,11,9,12,808,812,1620,1676
0132-000,2015,11,9,13,775,838,1613,1620
0132-000,2015,11,9,14,904,854,1758,1613
0132-000,2015,11,9,15,878,878,1756,1758
0132-000,2015,11,9,16,948,861,1809,1756
0132-000,2015,11,9,17,962,855,1817,1809
0132-000,2015,11,9,18,1260,882,2142,1817
0132-000,2015,11,9,19,1433,838,2271,2142
0132-000,2015,11,9,20,956,648,1604,2271
0132-000,2015,11,9,21,793,473,1266,1604
0132-000,2015,11,9,22,562,424,986,1266
0132-000,2015,11,9,23,328,286,614,986
0132-000,2015,11,9,24,204,212,416,614
0132-000,2015,11,10,1,146,121,267,416
0132-000,2015,11,10,2,94,91,185,267
0132-000,2015,11,10,3,89,82,171,185
0132-000,2015,11,10,4,69,92,161,171
0132-000,2015,11,10,5,65,92,157,161
0132-000,2015,11,10,6,213,157,370,157
0132-000,2015,11,10,7,443,491,934,370
0132-000,2015,11,10,8,720,1655,2375,934
0132-000,2015,11,10,9,875,1565,2440,2375
0132-000,2015,11,10,10,835,923,1758,2440
0132-000,2015,11,10,11,794,903,1697,1758
0132-000,2015,11,10,12,807,852,1659,1697
0132-000,2015,11,10,13,761,826,1587,1659
0132-000,2015,11,10,14,780,802,1582,1587
0132-000,2015,11,10,15,957,863,1820,1582
0132-000,2015,11,10,16,1021,834,1855,1820
0132-000,2015,11,10,17,949,841,1790,1855
0132-000,2015,11,10,18,1339,887,2226,1790
0132-000,2015,11,10,19,1408,803,2211,2226
0132-000,2015,11,10,20,903,660,1563,2211
0132-000,2015,11,10,21,797,505,1302,1563
0132-000,2015,11,10,22,636,462,1098,1302
0132-000,2015,11,10,23,400,321,721,1098
0132-000,2015,11,10,24,220,209,429,721
0132-000,2015,11,11,1,185,176,361,429
0132-000,2015,11,11,2,137,94,231,361
0132-000,2015,11,11,3,79,98,177,231
0132-000,2015,11,11,4,78,91,169,177
0132-000,2015,11,11,5,78,83,161,169
0132-000,2015,11,11,6,221,141,362,161
0132-000,2015,11,11,7,418,503,921,362
0132-000,2015,11,11,8,753,1674,2427,921
0132-000,2015,11,11,9,846,1535,2381,2427
0132-000,2015,11,11,10,849,962,1811,2381
0132-000,2015,11,11,11,764,888,1652,1811
0132-000,2015,11,11,12,842,846,1688,1652
0132-000,2015,11,11,13,855,804,1659,1688
0132-000,2015,11,11,14,928,812,1740,1659
0132-000,2015,11,11,15,929,895,1824,1740
0132-000,2015,11,11,16,991,789,1780,1824
0132-000,2015,11,11,17,1079,905,1984,1780
0132-000,2015,11,11,18,1440,964,2404,1984
0132-000,2015,11,11,19,1550,812,2362,2404
0132-000,2015,11,11,20,992,675,1667,2362
0132-000,2015,11,11,21,814,558,1372,1667
0132-000,2015,11,11,22,561,425,986,1372
0132-000,2015,11,11,23,404,330,734,986
0132-000,2015,11,11,24,250,214,464,734
0132-000,2015,11,12,1,182,156,338,464
0132-000,2015,11,12,2,101,112,213,338
0132-000,2015,11,12,3,82,83,165,213
0132-000,2015,11,12,4,76,105,181,165
0132-000,2015,11,12,5,83,91,174,181
0132-000,2015,11,12,6,204,154,358,174
0132-000,2015,11,12,7,439,481,920,358
0132-000,2015,11,12,8,711,1629,2340,920
0132-000,2015,11,12,9,876,1562,2438,2340
0132-000,2015,11,12,10,916,1011,1927,2438
0132-000,2015,11,12,11,818,822,1640,1927
0132-000,2015,11,12,12,791,896,1687,1640
0132-000,2015,11,12,13,767,768,1535,1687
0132-000,2015,11,12,14,865,834,1699,1535
0132-000,2015,11,12,15,878,890,1768,1699
0132-000,2015,11,12,16,980,821,1801,1768
0132-000,2015,11,12,17,1058,860,1918,1801
0132-000,2015,11,12,18,1318,974,2292,1918
0132-000,2015,11,12,19,1608,765,2373,2292
0132-000,2015,11,12,20,952,691,1643,2373
0132-000,2015,11,12,21,772,522,1294,1643
0132-000,2015,11,12,22,594,465,1059,1294
0132-000,2015,11,12,23,378,337,715,1059
0132-000,2015,11,12,24,265,222,487,715
0132-000,2015,11,13,1,174,165,339,487
0132-000,2015,11,13,2,112,107,219,339
0132-000,2015,11,13,3,87,80,167,219
0132-000,2015,11,13,4,89,97,186,167
0132-000,2015,11,13,5,84,87,171,186
0132-000,2015,11,13,6,216,138,354,171
0132-000,2015,11,13,7,476,487,963,354
0132-000,2015,11,13,8,735,1528,2263,963
0132-000,2015,11,13,9,847,1581,2428,2263
0132-000,2015,11,13,10,856,910,1766,2428
0132-000,2015,11,13,11,796,897,1693,1766
0132-000,2015,11,13,12,843,912,1755,1693
0132-000,2015,11,13,13,811,823,1634,1755
0132-000,2015,11,13,14,863,848,1711,1634
0132-000,2015,11,13,15,926,875,1801,1711
0132-000,2015,11,13,16,975,844,1819,1801
0132-000,2015,11,13,17,1065,844,1909,1819
0132-000,2015,11,13,18,1427,872,2299,1909
0132-000,2015,11,13,19,1801,869,2670,2299
0132-000,2015,11,13,20,1232,787,2019,2670
0132-000,2015,11,13,21,865,585,1450,2019
0132-000,2015,11,13,22,587,495,1082,1450
0132-000,2015,11,13,23,404,329,733,1082
0132-000,2015,11,13,24,236,240,476,733
0132-000,2015,11,14,1,204,211,415,476
0132-000,2015,11,14,2,126,146,272,415
0132-000,2015,11,14,3,80,106,186,272
0132-000,2015,11,14,4,97,91,188,186
0132-000,2015,11,14,5,88,92,180,188
0132-000,2015,11,14,6,178,123,301,180
0132-000,2015,11,14,7,331,289,620,301
0132-000,2015,11,14,8,458,691,1149,620
0132-000,2015,11,14,9,688,935,1623,1149
0132-000,2015,11,14,10,735,999,1734,1623
0132-000,2015,11,14,11,821,1227,2048,1734
0132-000,2015,11,14,12,1001,1550,2551,2048
0132-000,2015,11,14,13,910,1571,2481,2551
0132-000,2015,11,14,14,949,1323,2272,2481
0132-000,2015,11,14,15,969,1341,2310,2272
0132-000,2015,11,14,16,1106,1204,2310,2310
0132-000,2015,11,14,17,1237,1187,2424,2310
0132-000,2015,11,14,18,1541,1217,2758,2424
0132-000,2015,11,14,19,1455,952,2407,2758
0132-000,2015,11,14,20,1029,597,1626,2407
0132-000,2015,11,14,21,694,536,1230,1626
0132-000,2015,11,14,22,534,443,977,1230
0132-000,2015,11,14,23,330,346,676,977
0132-000,2015,11,14,24,225,226,451,676
0132-000,2015,11,15,1,189,191,380,451
0132-000,2015,11,15,2,136,159,295,380
0132-000,2015,11,15,3,103,122,225,295
0132-000,2015,11,15,4,101,93,194,225
0132-000,2015,11,15,5,87,100,187,194
0132-000,2015,11,15,6,173,105,278,187
0132-000,2015,11,15,7,242,206,448,278
0132-000,2015,11,15,8,333,373,706,448
0132-000,2015,11,15,9,408,535,943,706
0132-000,2015,11,15,10,484,682,1166,943
0132-000,2015,11,15,11,625,711,1336,1166
0132-000,2015,11,15,12,639,742,1381,1336
0132-000,2015,11,15,13,887,766,1653,1381
0132-000,2015,11,15,14,1163,809,1972,1653
0132-000,2015,11,15,15,1183,852,2035,1972
0132-000,2015,11,15,16,1360,839,2199,2035
0132-000,2015,11,15,17,1738,823,2561,2199
0132-000,2015,11,15,18,1874,825,2699,2561
0132-000,2015,11,15,19,1741,674,2415,2699
0132-000,2015,11,15,20,1790,513,2303,2415
0132-000,2015,11,15,21,1797,527,2324,2303
0132-000,2015,11,15,22,1276,420,1696,2324
0132-000,2015,11,15,23,1106,275,1381,1696
0132-000,2015,11,15,24,432,219,651,1381
0132-000,2015,11,16,1,126,136,262,651
0132-000,2015,11,16,2,72,88,160,262
0132-000,2015,11,16,3,62,66,128,160
0132-000,2015,11,16,4,41,66,107,128
0132-000,2015,11,16,5,70,69,139,107
0132-000,2015,11,16,6,247,156,403,139
0132-000,2015,11,16,7,411,569,980,403
0132-000,2015,11,16,8,767,1724,2491,980
0132-000,2015,11,16,9,855,1624,2479,2491
0132-000,2015,11,16,10,812,925,1737,2479
0132-000,2015,11,16,11,814,900,1714,1737
0132-000,2015,11,16,12,836,879,1715,1714
0132-000,2015,11,16,13,778,848,1626,1715
0132-000,2015,11,16,14,868,872,1740,1626
0132-000,2015,11,16,15,908,919,1827,1740
0132-000,2015,11,16,16,991,897,1888,1827
0132-000,2015,11,16,17,1066,897,1963,1888
0132-000,2015,11,16,18,1346,827,2173,1963
0132-000,2015,11,16,19,1419,819,2238,2173
0132-000,2015,11,16,20,971,587,1558,2238
0132-000,2015,11,16,21,775,534,1309,1558
0132-000,2015,11,16,22,567,407,974,1309
0132-000,2015,11,16,23,343,290,633,974
0132-000,2015,11,16,24,207,177,384,633
0132-000,2015,11,17,1,160,142,302,384
0132-000,2015,11,17,2,83,102,185,302
0132-000,2015,11,17,3,77,85,162,185
0132-000,2015,11,17,4,82,70,152,162
0132-000,2015,11,17,5,70,75,145,152
0132-000,2015,11,17,6,198,109,307,145
0132-000,2015,11,17,7,423,432,855,307
0132-000,2015,11,17,8,710,1602,2312,855
0132-000,2015,11,17,9,875,1577,2452,2312
0132-000,2015,11,17,10,795,904,1699,2452
0132-000,2015,11,17,11,868,914,1782,1699
0132-000,2015,11,17,12,824,885,1709,1782
0132-000,2015,11,17,13,846,879,1725,1709
0132-000,2015,11,17,14,826,874,1700,1725
0132-000,2015,11,17,15,920,859,1779,1700
0132-000,2015,11,17,16,948,825,1773,1779
0132-000,2015,11,17,17,1104,879,1983,1773
0132-000,2015,11,17,18,1288,934,2222,1983
0132-000,2015,11,17,19,1428,826,2254,2222
0132-000,2015,11,17,20,953,692,1645,2254
0132-000,2015,11,17,21,843,528,1371,1645
0132-000,2015,11,17,22,628,438,1066,1371
0132-000,2015,11,17,23,388,327,715,1066
0132-000,2015,11,17,24,245,229,474,715
0132-000,2015,11,18,1,162,163,325,474
0132-000,2015,11,18,2,100,120,220,325
0132-000,2015,11,18,3,91,95,186,220
0132-000,2015,11,18,4,66,79,145,186
0132-000,2015,11,18,5,85,91,176,145
0132-000,2015,11,18,6,214,137,351,176
0132-000,2015,11,18,7,421,429,850,351
0132-000,2015,11,18,8,698,1534,2232,850
0132-000,2015,11,18,9,860,1559,2419,2232
0132-000,2015,11,18,10,826,903,1729,2419
0132-000,2015,11,18,11,798,821,1619,1729
0132-000,2015,11,18,12,809,878,1687,1619
0132-000,2015,11,18,13,744,772,1516,1687
0132-000,2015,11,18,14,819,785,1604,1516
0132-000,2015,11,18,15,854,872,1726,1604
0132-000,2015,11,18,16,973,830,1803,1726
0132-000,2015,11,18,17,1002,846,1848,1803
0132-000,2015,11,18,18,1311,830,2141,1848
0132-000,2015,11,18,19,1502,806,2308,2141
0132-000,2015,11,18,20,906,703,1609,2308
0132-000,2015,11,18,21,685,533,1218,1609
0132-000,2015,11,18,22,565,401,966,1218
0132-000,2015,11,18,23,366,314,680,966
0132-000,2015,11,18,24,231,198,429,680
0132-000,2015,11,19,1,171,165,336,429
0132-000,2015,11,19,2,119,100,219,336
0132-000,2015,11,19,3,79,83,162,219
0132-000,2015,11,19,4,69,95,164,162
0132-000,2015,11,19,5,93,92,185,164
0132-000,2015,11,19,6,254,133,387,185
0132-000,2015,11,19,7,450,459,909,387
0132-000,2015,11,19,8,714,1528,2242,909
0132-000,2015,11,19,9,911,1596,2507,2242
0132-000,2015,11,19,10,804,979,1783,2507
0132-000,2015,11,19,11,862,878,1740,1783
0132-000,2015,11,19,12,820,880,1700,1740
0132-000,2015,11,19,13,798,826,1624,1700
0132-000,2015,11,19,14,861,835,1696,1624
0132-000,2015,11,19,15,911,907,1818,1696
0132-000,2015,11,19,16,965,848,1813,1818
0132-000,2015,11,19,17,954,854,1808,1813
0132-000,2015,11,19,18,1352,931,2283,1808
0132-000,2015,11,19,19,1473,812,2285,2283
0132-000,2015,11,19,20,945,619,1564,2285
0132-000,2015,11,19,21,783,538,1321,1564
0132-000,2015,11,19,22,587,413,1000,1321
0132-000,2015,11,19,23,387,322,709,1000
0132-000,2015,11,19,24,243,224,467,709
0132-000,2015,11,20,1,183,160,343,467
0132-000,2015,11,20,2,97,87,184,343
0132-000,2015,11,20,3,80,77,157,184
0132-000,2015,11,20,4,82,82,164,157
0132-000,2015,11,20,5,70,92,162,164
0132-000,2015,11,20,6,208,122,330,162
0132-000,2015,11,20,7,435,458,893,330
0132-000,2015,11,20,8,740,1565,2305,893
0132-000,2015,11,20,9,912,1555,2467,2305
0132-000,2015,11,20,10,876,931,1807,2467
0132-000,2015,11,20,11,807,956,1763,1807
0132-000,2015,11,20,12,842,917,1759,1763
0132-000,2015,11,20,13,804,826,1630,1759
0132-000,2015,11,20,14,928,811,1739,1630
0132-000,2015,11,20,15,923,890,1813,1739
0132-000,2015,11,20,16,1044,817,1861,1813
0132-000,2015,11,20,17,1097,1006,2103,1861
0132-000,2015,11,20,18,1532,990,2522,2103
0132-000,2015,11,20,19,1820,1021,2841,2522
0132-000,2015,11,20,20,1124,851,1975,2841
0132-000,2015,11,20,21,873,683,1556,1975
0132-000,2015,11,20,22,662,547,1209,1556
0132-000,2015,11,20,23,449,385,834,1209
0132-000,2015,11,20,24,262,300,562,834
0132-000,2015,11,21,1,226,209,435,562
0132-000,2015,11,21,2,156,171,327,435
0132-000,2015,11,21,3,106,113,219,327
0132-000,2015,11,21,4,86,115,201,219
0132-000,2015,11,21,5,116,111,227,201
0132-000,2015,11,21,6,218,157,375,227
0132-000,2015,11,21,7,391,380,771,375
0132-000,2015,11,21,8,568,839,1407,771
0132-000,2015,11,21,9,740,1099,1839,1407
0132-000,2015,11,21,10,783,1259,2042,1839
0132-000,2015,11,21,11,927,1406,2333,2042
0132-000,2015,11,21,12,936,1752,2688,2333
0132-000,2015,11,21,13,1255,1744,2999,2688
0132-000,2015,11,21,14,1031,1556,2587,2999
0132-000,2015,11,21,15,1078,1398,2476,2587
0132-000,2015,11,21,16,1127,1319,2446,2476
0132-000,2015,11,21,17,1375,1281,2656,2446
0132-000,2015,11,21,18,1762,1191,2953,2656
0132-000,2015,11,21,19,1832,1057,2889,2953
0132-000,2015,11,21,20,1411,700,2111,2889
0132-000,2015,11,21,21,891,539,1430,2111
0132-000,2015,11,21,22,608,442,1050,1430
0132-000,2015,11,21,23,376,322,698,1050
0132-000,2015,11,21,24,247,296,543,698
0132-000,2015,11,22,1,183,174,357,543
0132-000,2015,11,22,2,116,148,264,357
0132-000,2015,11,22,3,100,106,206,264
0132-000,2015,11,22,4,97,74,171,206
0132-000,2015,11,22,5,78,77,155,171
0132-000,2015,11,22,6,152,101,253,155
0132-000,2015,11,22,7,226,206,432,253
0132-000,2015,11,22,8,320,370,690,432
0132-000,2015,11,22,9,427,522,949,690
0132-000,2015,11,22,10,532,629,1161,949
0132-000,2015,11,22,11,612,665,1277,1161
0132-000,2015,11,22,12,684,679,1363,1277
0132-000,2015,11,22,13,805,709,1514,1363
0132-000,2015,11,22,14,992,715,1707,1514
0132-000,2015,11,22,15,1351,813,2164,1707
0132-000,2015,11,22,16,1929,784,2713,2164
0132-000,2015,11,22,17,2217,816,3033,2713
0132-000,2015,11,22,18,2118,837,2955,3033
0132-000,2015,11,22,19,2117,713,2830,2955
0132-000,2015,11,22,20,2171,533,2704,2830
0132-000,2015,11,22,21,1674,452,2126,2704
0132-000,2015,11,22,22,1623,401,2024,2126
0132-000,2015,11,22,23,1188,272,1460,2024
0132-000,2015,11,22,24,591,184,775,1460
0132-000,2015,11,23,1,173,123,296,775
0132-000,2015,11,23,2,65,89,154,296
0132-000,2015,11,23,3,61,68,129,154
0132-000,2015,11,23,4,41,58,99,129
0132-000,2015,11,23,5,73,70,143,99
0132-000,2015,11,23,6,198,147,345,143
0132-000,2015,11,23,7,379,463,842,345
0132-000,2015,11,23,8,692,1590,2282,842
0132-000,2015,11,23,9,833,1668,2501,2282
0132-000,2015,11,23,10,803,952,1755,2501
0132-000,2015,11,23,11,820,924,1744,1755
0132-000,2015,11,23,12,841,870,1711,1744
0132-000,2015,11,23,13,802,819,1621,1711
0132-000,2015,11,23,14,859,872,1731,1621
0132-000,2015,11,23,15,950,889,1839,1731
0132-000,2015,11,23,16,942,858,1800,1839
0132-000,2015,11,23,17,999,894,1893,1800
0132-000,2015,11,23,18,1325,873,2198,1893
0132-000,2015,11,23,19,1445,835,2280,2198
0132-000,2015,11,23,20,907,631,1538,2280
0132-000,2015,11,23,21,745,511,1256,1538
0132-000,2015,11,23,22,591,438,1029,1256
0132-000,2015,11,23,23,388,300,688,1029
0132-000,2015,11,23,24,232,190,422,688
0132-000,2015,11,24,1,139,134,273,422
0132-000,2015,11,24,2,98,105,203,273
0132-000,2015,11,24,3,77,80,157,203
0132-000,2015,11,24,4,79,70,149,157
0132-000,2015,11,24,5,71,73,144,149
0132-000,2015,11,24,6,230,134,364,144
0132-000,2015,11,24,7,437,420,857,364
0132-000,2015,11,24,8,729,1586,2315,857
0132-000,2015,11,24,9,896,1625,2521,2315
0132-000,2015,11,24,10,825,934,1759,2521
0132-000,2015,11,24,11,875,934,1809,1759
0132-000,2015,11,24,12,859,902,1761,1809
0132-000,2015,11,24,13,740,819,1559,1761
0132-000,2015,11,24,14,915,873,1788,1559
0132-000,2015,11,24,15,932,898,1830,1788
0132-000,2015,11,24,16,1025,805,1830,1830
0132-000,2015,11,24,17,1092,834,1926,1830
0132-000,2015,11,24,18,1307,913,2220,1926
0132-000,2015,11,24,19,1536,889,2425,2220
0132-000,2015,11,24,20,885,605,1490,2425
0132-000,2015,11,24,21,811,539,1350,1490
0132-000,2015,11,24,22,600,484,1084,1350
0132-000,2015,11,24,23,389,324,713,1084
0132-000,2015,11,24,24,219,197,416,713
0132-000,2015,11,25,1,160,141,301,416
0132-000,2015,11,25,2,133,94,227,301
0132-000,2015,11,25,3,81,79,160,227
0132-000,2015,11,25,4,71,74,145,160
0132-000,2015,11,25,5,60,85,145,145
0132-000,2015,11,25,6,154,119,273,145
0132-000,2015,11,25,7,320,352,672,273
0132-000,2015,11,25,8,656,1491,2147,672
0132-000,2015,11,25,9,858,1596,2454,2147
0132-000,2015,11,25,10,801,910,1711,2454
0132-000,2015,11,25,11,786,833,1619,1711
0132-000,2015,11,25,12,844,810,1654,1619
0132-000,2015,11,25,13,699,847,1546,1654
0132-000,2015,11,25,14,864,793,1657,1546
0132-000,2015,11,25,15,927,845,1772,1657
0132-000,2015,11,25,16,951,842,1793,1772
0132-000,2015,11,25,17,962,812,1774,1793
0132-000,2015,11,25,18,1377,835,2212,1774
0132-000,2015,11,25,19,1518,803,2321,2212
0132-000,2015,11,25,20,948,591,1539,2321
0132-000,2015,11,25,21,704,507,1211,1539
0132-000,2015,11,25,22,588,429,1017,1211
0132-000,2015,11,25,23,335,311,646,1017
0132-000,2015,11,25,24,225,195,420,646
0132-000,2015,11,26,1,170,133,303,420
0132-000,2015,11,26,2,120,120,240,303
0132-000,2015,11,26,3,61,86,147,240
0132-000,2015,11,26,4,75,88,163,147
0132-000,2015,11,26,5,79,78,157,163
0132-000,2015,11,26,6,146,102,248,157
0132-000,2015,11,26,7,240,299,539,248
0132-000,2015,11,26,8,410,1185,1595,539
0132-000,2015,11,26,9,571,1431,2002,1595
0132-000,2015,11,26,10,553,1116,1669,2002
0132-000,2015,11,26,11,641,831,1472,1669
0132-000,2015,11,26,12,729,910,1639,1472
0132-000,2015,11,26,13,712,958,1670,1639
0132-000,2015,11,26,14,790,1100,1890,1670
0132-000,2015,11,26,15,816,983,1799,1890
0132-000,2015,11,26,16,880,937,1817,1799
0132-000,2015,11,26,17,964,820,1784,1817
0132-000,2015,11,26,18,1259,680,1939,1784
0132-000,2015,11,26,19,1338,635,1973,1939
0132-000,2015,11,26,20,750,493,1243,1973
0132-000,2015,11,26,21,549,368,917,1243
0132-000,2015,11,26,22,454,300,754,917
0132-000,2015,11,26,23,256,305,561,754
0132-000,2015,11,26,24,157,149,306,561
0132-000,2015,11,27,1,109,93,202,306
0132-000,2015,11,27,2,91,85,176,202
0132-000,2015,11,27,3,55,72,127,176
0132-000,2015,11,27,4,62,74,136,127
0132-000,2015,11,27,5,81,77,158,136
0132-000,2015,11,27,6,141,97,238,158
0132-000,2015,11,27,7,320,346,666,238
0132-000,2015,11,27,8,552,1402,1954,666
0132-000,2015,11,27,9,720,1343,2063,1954
0132-000,2015,11,27,10,703,803,1506,2063
0132-000,2015,11,27,11,737,798,1535,1506
0132-000,2015,11,27,12,816,798,1614,1535
0132-000,2015,11,27,13,757,777,1534,1614
0132-000,2015,11,27,14,847,861,1708,1534
0132-000,2015,11,27,15,888,845,1733,1708
0132-000,2015,11,27,16,928,804,1732,1733
0132-000,2015,11,27,17,1075,832,1907,1732
0132-000,2015,11,27,18,1399,838,2237,1907
0132-000,2015,11,27,19,1662,864,2526,2237
0132-000,2015,11,27,20,1126,717,1843,2526
0132-000,2015,11,27,21,762,558,1320,1843
0132-000,2015,11,27,22,632,454,1086,1320
0132-000,2015,11,27,23,372,332,704,1086
0132-000,2015,11,27,24,229,248,477,704
0132-000,2015,11,28,1,215,223,438,477
0132-000,2015,11,28,2,126,121,247,438
0132-000,2015,11,28,3,104,113,217,247
0132-000,2015,11,28,4,77,104,181,217
0132-000,2015,11,28,5,98,116,214,181
0132-000,2015,11,28,6,179,126,305,214
0132-000,2015,11,28,7,322,262,584,305
0132-000,2015,11,28,8,467,645,1112,584
0132-000,2015,11,28,9,647,880,1527,1112
0132-000,2015,11,28,10,731,934,1665,1527
0132-000,2015,11,28,11,784,1064,1848,1665
0132-000,2015,11,28,12,928,1249,2177,1848
0132-000,2015,11,28,13,862,1180,2042,2177
0132-000,2015,11,28,14,855,1301,2156,2042
0132-000,2015,11,28,15,883,1151,2034,2156
0132-000,2015,11,28,16,1054,920,1974,2034
0132-000,2015,11,28,17,1078,886,1964,1974
0132-000,2015,11,28,18,1310,1018,2328,1964
0132-000,2015,11,28,19,1231,905,2136,2328
0132-000,2015,11,28,20,779,612,1391,2136
0132-000,2015,11,28,21,564,491,1055,1391
0132-000,2015,11,28,22,463,417,880,1055
0132-000,2015,11,28,23,323,370,693,880
0132-000,2015,11,28,24,236,233,469,693
0132-000,2015,11,29,1,180,194,374,469
0132-000,2015,11,29,2,140,141,281,374
0132-000,2015,11,29,3,85,99,184,281
0132-000,2015,11,29,4,91,107,198,184
0132-000,2015,11,29,5,78,73,151,198
0132-000,2015,11,29,6,132,79,211,151
0132-000,2015,11,29,7,205,142,347,211
0132-000,2015,11,29,8,261,323,584,347
0132-000,2015,11,29,9,378,449,827,584
0132-000,2015,11,29,10,449,524,973,827
0132-000,2015,11,29,11,530,630,1160,973
0132-000,2015,11,29,12,701,663,1364,1160
0132-000,2015,11,29,13,907,721,1628,1364
0132-000,2015,11,29,14,1020,803,1823,1628
0132-000,2015,11,29,15,1189,783,1972,1823
0132-000,2015,11,29,16,1489,790,2279,1972
0132-000,2015,11,29,17,1776,769,2545,2279
0132-000,2015,11,29,18,1865,723,2588,2545
0132-000,2015,11,29,19,1781,609,2390,2588
0132-000,2015,11,29,20,1507,509,2016,2390
0132-000,2015,11,29,21,1401,424,1825,2016
0132-000,2015,11,29,22,936,357,1293,1825
0132-000,2015,11,29,23,518,284,802,1293
0132-000,2015,11,29,24,191,171,362,802
0132-000,2015,11,30,1,116,115,231,362
0132-000,2015,11,30,2,58,91,149,231
0132-000,2015,11,30,3,40,72,112,149
0132-000,2015,11,30,4,46,58,104,112
0132-000,2015,11,30,5,70,64,134,104
0132-000,2015,11,30,6,213,145,358,134
0132-000,2015,11,30,7,444,437,881,358
0132-000,2015,11,30,8,692,1664,2356,881
0132-000,2015,11,30,9,844,1654,2498,2356
0132-000,2015,11,30,10,729,927,1656,2498
0132-000,2015,11,30,11,805,794,1599,1656
0132-000,2015,11,30,12,889,863,1752,1599
0132-000,2015,11,30,13,784,824,1608,1752
0132-000,2015,11,30,14,857,902,1759,1608
0132-000,2015,11,30,15,829,898,1727,1759
0132-000,2015,11,30,16,904,840,1744,1727
0132-000,2015,11,30,17,987,834,1821,1744
0132-000,2015,11,30,18,1076,870,1946,1821
0132-000,2015,11,30,19,1126,835,1961,1946
0132-000,2015,11,30,20,1095,678,1773,1961
0132-000,2015,11,30,21,914,559,1473,1773
0132-000,2015,11,30,22,621,436,1057,1473
0132-000,2015,11,30,23,377,320,697,1057
0132-000,2015,11,30,24,251,238,489,697
0132-000,2015,12,1,1,145,129,274,489
0132-000,2015,12,1,2,109,88,197,274
0132-000,2015,12,1,3,76,81,157,197
0132-000,2015,12,1,4,69,86,155,157
0132-000,2015,12,1,5,80,82,162,155
0132-000,2015,12,1,6,200,112,312,162
0132-000,2015,12,1,7,406,419,825,312
0132-000,2015,12,1,8,694,1524,2218,825
0132-000,2015,12,1,9,844,1641,2485,2218
0132-000,2015,12,1,10,802,891,1693,2485
0132-000,2015,12,1,11,876,894,1770,1693
0132-000,2015,12,1,12,811,900,1711,1770
0132-000,2015,12,1,13,819,771,1590,1711
0132-000,2015,12,1,14,833,874,1707,1590
0132-000,2015,12,1,15,930,933,1863,1707
0132-000,2015,12,1,16,916,847,1763,1863
0132-000,2015,12,1,17,904,882,1786,1763
0132-000,2015,12,1,18,991,901,1892,1786
0132-000,2015,12,1,19,1068,865,1933,1892
0132-000,2015,12,1,20,1080,664,1744,1933
0132-000,2015,12,1,21,995,547,1542,1744
0132-000,2015,12,1,22,618,463,1081,1542
0132-000,2015,12,1,23,375,320,695,1081
0132-000,2015,12,1,24,215,193,408,695
0132-000,2015,12,2,1,184,132,316,408
0132-000,2015,12,2,2,100,91,191,316
0132-000,2015,12,2,3,76,92,168,191
0132-000,2015,12,2,4,60,87,147,168
0132-000,2015,12,2,5,96,62,158,147
0132-000,2015,12,2,6,185,134,319,158
0132-000,2015,12,2,7,372,368,740,319
0132-000,2015,12,2,8,663,1487,2150,740
0132-000,2015,12,2,9,862,1514,2376,2150
0132-000,2015,12,2,10,773,871,1644,2376
0132-000,2015,12,2,11,778,839,1617,1644
0132-000,2015,12,2,12,805,804,1609,1617
0132-000,2015,12,2,13,714,771,1485,1609
0132-000,2015,12,2,14,789,745,1534,1485
0132-000,2015,12,2,15,857,848,1705,1534
0132-000,2015,12,2,16,937,800,1737,1705
0132-000,2015,12,2,17,926,810,1736,1737
0132-000,2015,12,2,18,1195,765,1960,1736
0132-000,2015,12,2,19,1413,783,2196,1960
0132-000,2015,12,2,20,869,637,1506,2196
0132-000,2015,12,2,21,747,553,1300,1506
0132-000,2015,12,2,22,577,402,979,1300
0132-000,2015,12,2,23,341,319,660,979
0132-000,2015,12,2,24,244,204,448,660
0132-000,2015,12,3,1,178,159,337,448
0132-000,2015,12,3,2,134,120,254,337
0132-000,2015,12,3,3,73,83,156,254
0132-000,2015,12,3,4,70,89,159,156
0132-000,2015,12,3,5,76,75,151,159
0132-000,2015,12,3,6,153,180,333,151
0132-000,2015,12,3,7,283,392,675,333
0132-000,2015,12,3,8,557,1414,1971,675
0132-000,2015,12,3,9,748,1278,2026,1971
0132-000,2015,12,3,10,710,773,1483,2026
0132-000,2015,12,3,11,697,798,1495,1483
0132-000,2015,12,3,12,698,793,1491,1495
0132-000,2015,12,3,13,630,655,1285,1491
0132-000,2015,12,3,14,682,690,1372,1285
0132-000,2015,12,3,15,684,655,1339,1372
0132-000,2015,12,3,16,796,671,1467,1339
0132-000,2015,12,3,17,720,729,1449,1467
0132-000,2015,12,3,18,865,791,1656,1449
0132-000,2015,12,3,19,1117,671,1788,1656
0132-000,2015,12,3,20,739,410,1149,1788
0132-000,2015,12,3,21,558,284,842,1149
0132-000,2015,12,3,22,397,206,603,842
0132-000,2015,12,3,23,198,164,362,603
0132-000,2015,12,3,24,112,106,218,362
0132-000,2015,12,4,1,104,109,213,218
0132-000,2015,12,4,2,76,69,145,213
0132-000,2015,12,4,3,65,55,120,145
0132-000,2015,12,4,4,50,58,108,120
0132-000,2015,12,4,5,75,66,141,108
0132-000,2015,12,4,6,137,88,225,141
0132-000,2015,12,4,7,237,307,544,225
0132-000,2015,12,4,8,490,1258,1748,544
0132-000,2015,12,4,9,681,1255,1936,1748
0132-000,2015,12,4,10,668,741,1409,1936
0132-000,2015,12,4,11,687,698,1385,1409
0132-000,2015,12,4,12,746,858,1604,1385
0132-000,2015,12,4,13,721,830,1551,1604
0132-000,2015,12,4,14,844,856,1700,1551
0132-000,2015,12,4,15,943,875,1818,1700
0132-000,2015,12,4,16,1053,881,1934,1818
0132-000,2015,12,4,17,1376,930,2306,1934
0132-000,2015,12,4,18,1758,942,2700,2306
0132-000,2015,12,4,19,1865,881,2746,2700
0132-000,2015,12,4,20,1397,877,2274,2746
0132-000,2015,12,4,21,778,572,1350,2274
0132-000,2015,12,4,22,596,489,1085,1350
0132-000,2015,12,4,23,407,343,750,1085
0132-000,2015,12,4,24,249,249,498,750
0132-000,2015,12,5,1,188,214,402,498
0132-000,2015,12,5,2,150,121,271,402
0132-000,2015,12,5,3,109,112,221,271
0132-000,2015,12,5,4,83,106,189,221
0132-000,2015,12,5,5,103,88,191,189
0132-000,2015,12,5,6,180,107,287,191
0132-000,2015,12,5,7,313,286,599,287
0132-000,2015,12,5,8,477,713,1190,599
0132-000,2015,12,5,9,633,1006,1639,1190
0132-000,2015,12,5,10,726,986,1712,1639
0132-000,2015,12,5,11,872,1065,1937,1712
0132-000,2015,12,5,12,900,1326,2226,1937
0132-000,2015,12,5,13,1028,1569,2597,2226
0132-000,2015,12,5,14,1063,1404,2467,2597
0132-000,2015,12,5,15,1062,1227,2289,2467
0132-000,2015,12,5,16,1089,1170,2259,2289
0132-000,2015,12,5,17,1201,1252,2453,2259
0132-000,2015,12,5,18,1704,1292,2996,2453
0132-000,2015,12,5,19,1497,1010,2507,2996
0132-000,2015,12,5,20,1000,626,1626,2507
0132-000,2015,12,5,21,634,504,1138,1626
0132-000,2015,12,5,22,468,412,880,1138
0132-000,2015,12,5,23,352,353,705,880
0132-000,2015,12,5,24,272,282,554,705
0132-000,2015,12,6,1,199,199,398,554
0132-000,2015,12,6,2,150,151,301,398
0132-000,2015,12,6,3,110,134,244,301
0132-000,2015,12,6,4,95,105,200,244
0132-000,2015,12,6,5,95,87,182,200
0132-000,2015,12,6,6,143,96,239,182
0132-000,2015,12,6,7,247,162,409,239
0132-000,2015,12,6,8,262,309,571,409
0132-000,2015,12,6,9,339,511,850,571
0132-000,2015,12,6,10,433,574,1007,850
0132-000,2015,12,6,11,553,639,1192,1007
0132-000,2015,12,6,12,633,701,1334,1192
0132-000,2015,12,6,13,696,804,1500,1334
0132-000,2015,12,6,14,861,769,1630,1500
0132-000,2015,12,6,15,1046,834,1880,1630
0132-000,2015,12,6,16,1317,821,2138,1880
0132-000,2015,12,6,17,1431,797,2228,2138
0132-000,2015,12,6,18,1769,872,2641,2228
0132-000,2015,12,6,19,1585,578,2163,2641
0132-000,2015,12,6,20,1091,529,1620,2163
0132-000,2015,12,6,21,692,451,1143,1620
0132-000,2015,12,6,22,449,391,840,1143
0132-000,2015,12,6,23,303,284,587,840
0132-000,2015,12,6,24,196,194,390,587
0132-000,2015,12,7,1,99,121,220,390
0132-000,2015,12,7,2,56,86,142,220
0132-000,2015,12,7,3,62,57,119,142
0132-000,2015,12,7,4,47,66,113,119
0132-000,2015,12,7,5,60,71,131,113
0132-000,2015,12,7,6,223,133,356,131
0132-000,2015,12,7,7,428,501,929,356
0132-000,2015,12,7,8,705,1661,2366,929
0132-000,2015,12,7,9,870,1676,2546,2366
0132-000,2015,12,7,10,811,927,1738,2546
0132-000,2015,12,7,11,845,894,1739,1738
0132-000,2015,12,7,12,818,854,1672,1739
0132-000,2015,12,7,13,801,854,1655,1672
0132-000,2015,12,7,14,879,931,1810,1655
0132-000,2015,12,7,15,967,945,1912,1810
0132-000,2015,12,7,16,995,909,1904,1912
0132-000,2015,12,7,17,1060,925,1985,1904
0132-000,2015,12,7,18,1421,958,2379,1985
0132-000,2015,12,7,19,1449,856,2305,2379
0132-000,2015,12,7,20,967,713,1680,2305
0132-000,2015,12,7,21,781,481,1262,1680
0132-000,2015,12,7,22,590,417,1007,1262
0132-000,2015,12,7,23,311,285,596,1007
0132-000,2015,12,7,24,221,185,406,596
0132-000,2015,12,8,1,158,151,309,406
0132-000,2015,12,8,2,80,104,184,309
0132-000,2015,12,8,3,82,73,155,184
0132-000,2015,12,8,4,72,95,167,155
0132-000,2015,12,8,5,81,86,167,167
0132-000,2015,12,8,6,199,116,315,167
0132-000,2015,12,8,7,401,382,783,315
0132-000,2015,12,8,8,639,1544,2183,783
0132-000,2015,12,8,9,827,1666,2493,2183
0132-000,2015,12,8,10,861,997,1858,2493
0132-000,2015,12,8,11,834,861,1695,1858
0132-000,2015,12,8,12,824,850,1674,1695
0132-000,2015,12,8,13,813,844,1657,1674
0132-000,2015,12,8,14,868,823,1691,1657
0132-000,2015,12,8,15,958,944,1902,1691
0132-000,2015,12,8,16,982,845,1827,1902
0132-000,2015,12,8,17,1030,828,1858,1827
0132-000,2015,12,8,18,1340,894,2234,1858
0132-000,2015,12,8,19,1480,788,2268,2234
0132-000,2015,12,8,20,986,667,1653,2268
0132-000,2015,12,8,21,798,484,1282,1653
0132-000,2015,12,8,22,645,424,1069,1282
0132-000,2015,12,8,23,346,301,647,1069
0132-000,2015,12,8,24,232,224,456,647
0132-000,2015,12,9,1,174,154,328,456
0132-000,2015,12,9,2,89,86,175,328
0132-000,2015,12,9,3,68,78,146,175
0132-000,2015,12,9,4,57,80,137,146
0132-000,2015,12,9,5,84,100,184,137
0132-000,2015,12,9,6,206,112,318,184
0132-000,2015,12,9,7,389,384,773,318
0132-000,2015,12,9,8,688,1507,2195,773
0132-000,2015,12,9,9,830,1577,2407,2195
0132-000,2015,12,9,10,824,1009,1833,2407
0132-000,2015,12,9,11,851,905,1756,1833
0132-000,2015,12,9,12,863,874,1737,1756
0132-000,2015,12,9,13,781,836,1617,1737
0132-000,2015,12,9,14,911,906,1817,1617
0132-000,2015,12,9,15,933,924,1857,1817
0132-000,2015,12,9,16,976,824,1800,1857
0132-000,2015,12,9,17,1163,917,2080,1800
0132-000,2015,12,9,18,1070,950,2020,2080
0132-000,2015,12,9,19,1502,815,2317,2020
0132-000,2015,12,9,20,1199,623,1822,2317
0132-000,2015,12,9,21,751,509,1260,1822
0132-000,2015,12,9,22,562,435,997,1260
0132-000,2015,12,9,23,380,341,721,997
0132-000,2015,12,9,24,255,227,482,721
0132-000,2015,12,10,1,145,148,293,482
0132-000,2015,12,10,2,116,103,219,293
0132-000,2015,12,10,3,81,82,163,219
0132-000,2015,12,10,4,86,88,174,163
0132-000,2015,12,10,5,82,93,175,174
0132-000,2015,12,10,6,233,132,365,175
0132-000,2015,12,10,7,359,410,769,365
0132-000,2015,12,10,8,654,1533,2187,769
0132-000,2015,12,10,9,894,1563,2457,2187
0132-000,2015,12,10,10,783,940,1723,2457
0132-000,2015,12,10,11,793,881,1674,1723
0132-000,2015,12,10,12,860,864,1724,1674
0132-000,2015,12,10,13,775,883,1658,1724
0132-000,2015,12,10,14,900,862,1762,1658
0132-000,2015,12,10,15,994,887,1881,1762
0132-000,2015,12,10,16,1102,897,1999,1881
0132-000,2015,12,10,17,1091,896,1987,1999
0132-000,2015,12,10,18,1344,881,2225,1987
0132-000,2015,12,10,19,1457,805,2262,2225
0132-000,2015,12,10,20,881,629,1510,2262
0132-000,2015,12,10,21,727,500,1227,1510
0132-000,2015,12,10,22,586,428,1014,1227
0132-000,2015,12,10,23,355,295,650,1014
0132-000,2015,12,10,24,279,231,510,650
0132-000,2015,12,11,1,191,173,364,510
0132-000,2015,12,11,2,131,143,274,364
0132-000,2015,12,11,3,111,110,221,274
0132-000,2015,12,11,4,85,80,165,221
0132-000,2015,12,11,5,87,92,179,165
0132-000,2015,12,11,6,208,153,361,179
0132-000,2015,12,11,7,368,412,780,361
0132-000,2015,12,11,8,654,1513,2167,780
0132-000,2015,12,11,9,861,1579,2440,2167
0132-000,2015,12,11,10,799,937,1736,2440
0132-000,2015,12,11,11,837,866,1703,1736
0132-000,2015,12,11,12,901,942,1843,1703
0132-000,2015,12,11,13,877,884,1761,1843
0132-000,2015,12,11,14,944,850,1794,1761
0132-000,2015,12,11,15,983,988,1971,1794
0132-000,2015,12,11,16,1129,895,2024,1971
0132-000,2015,12,11,17,1179,994,2173,2024
0132-000,2015,12,11,18,1614,1086,2700,2173
0132-000,2015,12,11,19,1921,972,2893,2700
0132-000,2015,12,11,20,1273,808,2081,2893
0132-000,2015,12,11,21,840,627,1467,2081
0132-000,2015,12,11,22,655,507,1162,1467
0132-000,2015,12,11,23,440,404,844,1162
0132-000,2015,12,11,24,296,293,589,844
0132-000,2015,12,12,1,235,208,443,589
0132-000,2015,12,12,2,159,165,324,443
0132-000,2015,12,12,3,119,127,246,324
0132-000,2015,12,12,4,102,100,202,246
0132-000,2015,12,12,5,91,106,197,202
0132-000,2015,12,12,6,202,127,329,197
0132-000,2015,12,12,7,347,317,664,329
0132-000,2015,12,12,8,535,703,1238,664
0132-000,2015,12,12,9,646,901,1547,1238
0132-000,2015,12,12,10,711,872,1583,1547
0132-000,2015,12,12,11,937,1081,2018,1583
0132-000,2015,12,12,12,1037,1123,2160,2018
0132-000,2015,12,12,13,1104,1146,2250,2160
0132-000,2015,12,12,14,1022,1159,2181,2250
0132-000,2015,12,12,15,1172,1190,2362,2181
0132-000,2015,12,12,16,1157,1065,2222,2362
0132-000,2015,12,12,17,1255,1271,2526,2222
0132-000,2015,12,12,18,1604,1291,2895,2526
0132-000,2015,12,12,19,1384,1052,2436,2895
0132-000,2015,12,12,20,1009,666,1675,2436
0132-000,2015,12,12,21,758,508,1266,1675
0132-000,2015,12,12,22,479,380,859,1266
0132-000,2015,12,12,23,376,351,727,859
0132-000,2015,12,12,24,255,301,556,727
0132-000,2015,12,13,1,194,205,399,556
0132-000,2015,12,13,2,163,176,339,399
0132-000,2015,12,13,3,128,128,256,339
0132-000,2015,12,13,4,126,104,230,256
0132-000,2015,12,13,5,84,95,179,230
0132-000,2015,12,13,6,154,98,252,179
0132-000,2015,12,13,7,199,160,359,252
0132-000,2015,12,13,8,273,338,611,359
0132-000,2015,12,13,9,369,452,821,611
0132-000,2015,12,13,10,447,505,952,821
0132-000,2015,12,13,11,573,615,1188,952
0132-000,2015,12,13,12,671,650,1321,1188
0132-000,2015,12,13,13,994,724,1718,1321
0132-000,2015,12,13,14,990,739,1729,1718
0132-000,2015,12,13,15,1121,738,1859,1729
0132-000,2015,12,13,16,1171,766,1937,1859
0132-000,2015,12,13,17,1348,731,2079,1937
0132-000,2015,12,13,18,1342,739,2081,2079
0132-000,2015,12,13,19,1186,644,1830,2081
0132-000,2015,12,13,20,786,548,1334,1830
0132-000,2015,12,13,21,535,467,1002,1334
0132-000,2015,12,13,22,422,350,772,1002
0132-000,2015,12,13,23,255,261,516,772
0132-000,2015,12,13,24,161,199,360,516
0132-000,2015,12,14,1,128,113,241,360
0132-000,2015,12,14,2,62,100,162,241
0132-000,2015,12,14,3,45,64,109,162
0132-000,2015,12,14,4,59,58,117,109
0132-000,2015,12,14,5,73,83,156,117
0132-000,2015,12,14,6,218,145,363,156
0132-000,2015,12,14,7,411,504,915,363
0132-000,2015,12,14,8,699,1643,2342,915
0132-000,2015,12,14,9,826,1711,2537,2342
0132-000,2015,12,14,10,768,916,1684,2537
0132-000,2015,12,14,11,812,861,1673,1684
0132-000,2015,12,14,12,812,895,1707,1673
0132-000,2015,12,14,13,815,876,1691,1707
0132-000,2015,12,14,14,842,862,1704,1691
0132-000,2015,12,14,15,908,866,1774,1704
0132-000,2015,12,14,16,944,818,1762,1774
0132-000,2015,12,14,17,1041,812,1853,1762
0132-000,2015,12,14,18,1192,857,2049,1853
0132-000,2015,12,14,19,1445,752,2197,2049
0132-000,2015,12,14,20,888,652,1540,2197
0132-000,2015,12,14,21,768,508,1276,1540
0132-000,2015,12,14,22,548,388,936,1276
0132-000,2015,12,14,23,325,296,621,936
0132-000,2015,12,14,24,212,187,399,621
0132-000,2015,12,15,1,171,146,317,399
0132-000,2015,12,15,2,95,81,176,317
0132-000,2015,12,15,3,75,77,152,176
0132-000,2015,12,15,4,72,75,147,152
0132-000,2015,12,15,5,91,88,179,147
0132-000,2015,12,15,6,188,115,303,179
0132-000,2015,12,15,7,377,412,789,303
0132-000,2015,12,15,8,691,1496,2187,789
0132-000,2015,12,15,9,827,1612,2439,2187
0132-000,2015,12,15,10,775,921,1696,2439
0132-000,2015,12,15,11,837,916,1753,1696
0132-000,2015,12,15,12,814,837,1651,1753
0132-000,2015,12,15,13,823,776,1599,1651
0132-000,2015,12,15,14,914,859,1773,1599
0132-000,2015,12,15,15,944,878,1822,1773
0132-000,2015,12,15,16,967,885,1852,1822
0132-000,2015,12,15,17,1022,925,1947,1852
0132-000,2015,12,15,18,1338,909,2247,1947
0132-000,2015,12,15,19,1446,822,2268,2247
0132-000,2015,12,15,20,949,623,1572,2268
0132-000,2015,12,15,21,770,531,1301,1572
0132-000,2015,12,15,22,601,418,1019,1301
0132-000,2015,12,15,23,347,285,632,1019
0132-000,2015,12,15,24,217,237,454,632
0132-000,2015,12,16,1,187,180,367,454
0132-000,2015,12,16,2,121,119,240,367
0132-000,2015,12,16,3,90,110,200,240
0132-000,2015,12,16,4,69,88,157,200
0132-000,2015,12,16,5,91,83,174,157
0132-000,2015,12,16,6,182,96,278,174
0132-000,2015,12,16,7,377,364,741,278
0132-000,2015,12,16,8,638,1471,2109,741
0132-000,2015,12,16,9,843,2753,3596,2109
0132-000,2015,12,16,10,756,1753,2509,3596
0132-000,2015,12,16,11,833,1275,2108,2509
0132-000,2015,12,16,12,784,841,1625,2108
0132-000,2015,12,16,13,811,818,1629,1625
0132-000,2015,12,16,14,899,873,1772,1629
0132-000,2015,12,16,15,924,850,1774,1772
0132-000,2015,12,16,16,916,788,1704,1774
0132-000,2015,12,16,17,1017,807,1824,1704
0132-000,2015,12,16,18,1296,888,2184,1824
0132-000,2015,12,16,19,1504,820,2324,2184
0132-000,2015,12,16,20,877,617,1494,2324
0132-000,2015,12,16,21,631,502,1133,1494
0132-000,2015,12,16,22,567,358,925,1133
0132-000,2015,12,16,23,351,284,635,925
0132-000,2015,12,16,24,229,209,438,635
0132-000,2015,12,17,1,189,167,356,438
0132-000,2015,12,17,2,112,110,222,356
0132-000,2015,12,17,3,93,93,186,222
0132-000,2015,12,17,4,83,98,181,186
0132-000,2015,12,17,5,85,83,168,181
0132-000,2015,12,17,6,193,123,316,168
0132-000,2015,12,17,7,393,356,749,316
0132-000,2015,12,17,8,613,1433,2046,749
0132-000,2015,12,17,9,785,1571,2356,2046
0132-000,2015,12,17,10,739,860,1599,2356
0132-000,2015,12,17,11,801,820,1621,1599
0132-000,2015,12,17,12,923,943,1866,1621
0132-000,2015,12,17,13,751,782,1533,1866
0132-000,2015,12,17,14,819,805,1624,1533
0132-000,2015,12,17,15,903,866,1769,1624
0132-000,2015,12,17,16,957,839,1796,1769
0132-000,2015,12,17,17,1055,829,1884,1796
0132-000,2015,12,17,18,1342,862,2204,1884
0132-000,2015,12,17,19,1360,791,2151,2204
0132-000,2015,12,17,20,865,599,1464,2151
0132-000,2015,12,17,21,727,481,1208,1464
0132-000,2015,12,17,22,598,432,1030,1208
0132-000,2015,12,17,23,366,321,687,1030
0132-000,2015,12,17,24,230,231,461,687
0132-000,2015,12,18,1,190,174,364,461
0132-000,2015,12,18,2,118,118,236,364
0132-000,2015,12,18,3,71,91,162,236
0132-000,2015,12,18,4,75,91,166,162
0132-000,2015,12,18,5,84,101,185,166
0132-000,2015,12,18,6,225,133,358,185
0132-000,2015,12,18,7,390,375,765,358
0132-000,2015,12,18,8,684,1557,2241,765
0132-000,2015,12,18,9,840,1398,2238,2241
0132-000,2015,12,18,10,776,891,1667,2238
0132-000,2015,12,18,11,856,862,1718,1667
0132-000,2015,12,18,12,856,899,1755,1718
0132-000,2015,12,18,13,805,755,1560,1755
0132-000,2015,12,18,14,937,851,1788,1560
0132-000,2015,12,18,15,878,874,1752,1788
0132-000,2015,12,18,16,1029,861,1890,1752
0132-000,2015,12,18,17,1230,898,2128,1890
0132-000,2015,12,18,18,1612,985,2597,2128
0132-000,2015,12,18,19,1962,886,2848,2597
0132-000,2015,12,18,20,1007,749,1756,2848
0132-000,2015,12,18,21,825,530,1355,1756
0132-000,2015,12,18,22,586,478,1064,1355
0132-000,2015,12,18,23,449,407,856,1064
0132-000,2015,12,18,24,267,260,527,856
0132-000,2015,12,19,1,246,250,496,527
0132-000,2015,12,19,2,154,168,322,496
0132-000,2015,12,19,3,113,124,237,322
0132-000,2015,12,19,4,100,104,204,237
0132-000,2015,12,19,5,99,116,215,204
0132-000,2015,12,19,6,226,123,349,215
0132-000,2015,12,19,7,312,298,610,349
0132-000,2015,12,19,8,482,652,1134,610
0132-000,2015,12,19,9,637,872,1509,1134
0132-000,2015,12,19,10,692,849,1541,1509
0132-000,2015,12,19,11,909,954,1863,1541
0132-000,2015,12,19,12,922,1088,2010,1863
0132-000,2015,12,19,13,968,1008,1976,2010
0132-000,2015,12,19,14,1009,1018,2027,1976
0132-000,2015,12,19,15,1056,967,2023,2027
0132-000,2015,12,19,16,1015,958,1973,2023
0132-000,2015,12,19,17,1230,938,2168,1973
0132-000,2015,12,19,18,1550,1040,2590,2168
0132-000,2015,12,19,19,1256,839,2095,2590
0132-000,2015,12,19,20,873,557,1430,2095
0132-000,2015,12,19,21,607,508,1115,1430
0132-000,2015,12,19,22,491,431,922,1115
0132-000,2015,12,19,23,339,330,669,922
0132-000,2015,12,19,24,241,264,505,669
0132-000,2015,12,20,1,186,229,415,505
0132-000,2015,12,20,2,146,150,296,415
0132-000,2015,12,20,3,130,122,252,296
0132-000,2015,12,20,4,83,125,208,252
0132-000,2015,12,20,5,94,86,180,208
0132-000,2015,12,20,6,135,112,247,180
0132-000,2015,12,20,7,220,162,382,247
0132-000,2015,12,20,8,257,315,572,382
0132-000,2015,12,20,9,351,389,740,572
0132-000,2015,12,20,10,441,575,1016,740
0132-000,2015,12,20,11,553,620,1173,1016
0132-000,2015,12,20,12,617,703,1320,1173
0132-000,2015,12,20,13,702,777,1479,1320
0132-000,2015,12,20,14,769,763,1532,1479
0132-000,2015,12,20,15,878,743,1621,1532
0132-000,2015,12,20,16,930,844,1774,1621
0132-000,2015,12,20,17,1066,813,1879,1774
0132-000,2015,12,20,18,1107,794,1901,1879
0132-000,2015,12,20,19,906,597,1503,1901
0132-000,2015,12,20,20,637,514,1151,1503
0132-000,2015,12,20,21,521,476,997,1151
0132-000,2015,12,20,22,412,349,761,997
0132-000,2015,12,20,23,302,295,597,761
0132-000,2015,12,20,24,173,181,354,597
0132-000,2015,12,21,1,124,115,239,354
0132-000,2015,12,21,2,64,88,152,239
0132-000,2015,12,21,3,72,68,140,152
0132-000,2015,12,21,4,48,77,125,140
0132-000,2015,12,21,5,67,73,140,125
0132-000,2015,12,21,6,212,157,369,140
0132-000,2015,12,21,7,411,498,909,369
0132-000,2015,12,21,8,643,1579,2222,909
0132-000,2015,12,21,9,781,1577,2358,2222
0132-000,2015,12,21,10,779,833,1612,2358
0132-000,2015,12,21,11,770,769,1539,1612
0132-000,2015,12,21,12,764,833,1597,1539
0132-000,2015,12,21,13,722,789,1511,1597
0132-000,2015,12,21,14,856,866,1722,1511
0132-000,2015,12,21,15,921,877,1798,1722
0132-000,2015,12,21,16,953,785,1738,1798
0132-000,2015,12,21,17,941,816,1757,1738
0132-000,2015,12,21,18,1226,847,2073,1757
0132-000,2015,12,21,19,1362,756,2118,2073
0132-000,2015,12,21,20,878,571,1449,2118
0132-000,2015,12,21,21,714,521,1235,1449
0132-000,2015,12,21,22,545,409,954,1235
0132-000,2015,12,21,23,317,291,608,954
0132-000,2015,12,21,24,238,190,428,608
0132-000,2015,12,22,1,153,149,302,428
0132-000,2015,12,22,2,113,110,223,302
0132-000,2015,12,22,3,98,70,168,223
0132-000,2015,12,22,4,68,78,146,168
0132-000,2015,12,22,5,95,89,184,146
0132-000,2015,12,22,6,196,134,330,184
0132-000,2015,12,22,7,405,435,840,330
0132-000,2015,12,22,8,629,1513,2142,840
0132-000,2015,12,22,9,884,1480,2364,2142
0132-000,2015,12,22,10,818,880,1698,2364
0132-000,2015,12,22,11,817,984,1801,1698
0132-000,2015,12,22,12,839,985,1824,1801
0132-000,2015,12,22,13,799,845,1644,1824
0132-000,2015,12,22,14,910,873,1783,1644
0132-000,2015,12,22,15,916,838,1754,1783
0132-000,2015,12,22,16,961,854,1815,1754
0132-000,2015,12,22,17,994,846,1840,1815
0132-000,2015,12,22,18,1246,905,2151,1840
0132-000,2015,12,22,19,1335,808,2143,2151
0132-000,2015,12,22,20,866,598,1464,2143
0132-000,2015,12,22,21,737,516,1253,1464
0132-000,2015,12,22,22,592,450,1042,1253
0132-000,2015,12,22,23,330,282,612,1042
0132-000,2015,12,22,24,243,226,469,612
0132-000,2015,12,23,1,179,167,346,469
0132-000,2015,12,23,2,116,118,234,346
0132-000,2015,12,23,3,96,83,179,234
0132-000,2015,12,23,4,74,85,159,179
0132-000,2015,12,23,5,78,90,168,159
0132-000,2015,12,23,6,198,132,330,168
0132-000,2015,12,23,7,398,401,799,330
0132-000,2015,12,23,8,674,1552,2226,799
0132-000,2015,12,23,9,810,1345,2155,2226
0132-000,2015,12,23,10,760,832,1592,2155
0132-000,2015,12,23,11,820,824,1644,1592
0132-000,2015,12,23,12,798,843,1641,1644
0132-000,2015,12,23,13,794,824,1618,1641
0132-000,2015,12,23,14,884,799,1683,1618
0132-000,2015,12,23,15,918,860,1778,1683
0132-000,2015,12,23,16,922,779,1701,1778
0132-000,2015,12,23,17,995,856,1851,1701
0132-000,2015,12,23,18,1316,900,2216,1851
0132-000,2015,12,23,19,1455,839,2294,2216
0132-000,2015,12,23,20,802,614,1416,2294
0132-000,2015,12,23,21,699,555,1254,1416
0132-000,2015,12,23,22,532,379,911,1254
0132-000,2015,12,23,23,377,366,743,911
0132-000,2015,12,23,24,232,222,454,743
0132-000,2015,12,24,1,204,197,401,454
0132-000,2015,12,24,2,113,118,231,401
0132-000,2015,12,24,3,88,112,200,231
0132-000,2015,12,24,4,94,84,178,200
0132-000,2015,12,24,5,85,96,181,178
0132-000,2015,12,24,6,222,124,346,181
0132-000,2015,12,24,7,397,360,757,346
0132-000,2015,12,24,8,633,1445,2078,757
0132-000,2015,12,24,9,857,1454,2311,2078
0132-000,2015,12,24,10,738,865,1603,2311
0132-000,2015,12,24,11,841,837,1678,1603
0132-000,2015,12,24,12,831,856,1687,1678
0132-000,2015,12,24,13,816,753,1569,1687
0132-000,2015,12,24,14,871,831,1702,1569
0132-000,2015,12,24,15,959,884,1843,1702
0132-000,2015,12,24,16,979,870,1849,1843
0132-000,2015,12,24,17,1057,866,1923,1849
0132-000,2015,12,24,18,1551,976,2527,1923
0132-000,2015,12,24,19,1845,1007,2852,2527
0132-000,2015,12,24,20,1065,819,1884,2852
0132-000,2015,12,24,21,800,601,1401,1884
0132-000,2015,12,24,22,535,484,1019,1401
0132-000,2015,12,24,23,388,345,733,1019
0132-000,2015,12,24,24,245,272,517,733
0132-000,2015,12,25,1,216,210,426,517
0132-000,2015,12,25,2,154,136,290,426
0132-000,2015,12,25,3,95,111,206,290
0132-000,2015,12,25,4,81,110,191,206
0132-000,2015,12,25,5,116,95,211,191
0132-000,2015,12,25,6,198,119,317,211
0132-000,2015,12,25,7,271,227,498,317
0132-000,2015,12,25,8,367,467,834,498
0132-000,2015,12,25,9,441,513,954,834
0132-000,2015,12,25,10,509,532,1041,954
0132-000,2015,12,25,11,644,715,1359,1041
0132-000,2015,12,25,12,641,772,1413,1359
0132-000,2015,12,25,13,682,798,1480,1413
0132-000,2015,12,25,14,740,822,1562,1480
0132-000,2015,12,25,15,796,833,1629,1562
0132-000,2015,12,25,16,764,739,1503,1629
0132-000,2015,12,25,17,871,804,1675,1503
0132-000,2015,12,25,18,960,771,1731,1675
0132-000,2015,12,25,19,872,650,1522,1731
0132-000,2015,12,25,20,550,441,991,1522
0132-000,2015,12,25,21,448,365,813,991
0132-000,2015,12,25,22,372,350,722,813
0132-000,2015,12,25,23,281,296,577,722
0132-000,2015,12,25,24,188,201,389,577
0132-000,2015,12,26,1,141,165,306,389
0132-000,2015,12,26,2,106,111,217,306
0132-000,2015,12,26,3,79,93,172,217
0132-000,2015,12,26,4,70,55,125,172
0132-000,2015,12,26,5,84,72,156,125
0132-000,2015,12,26,6,162,100,262,156
0132-000,2015,12,26,7,228,223,451,262
0132-000,2015,12,26,8,380,528,908,451
0132-000,2015,12,26,9,442,643,1085,908
0132-000,2015,12,26,10,618,688,1306,1085
0132-000,2015,12,26,11,667,744,1411,1306
0132-000,2015,12,26,12,726,754,1480,1411
0132-000,2015,12,26,13,775,803,1578,1480
0132-000,2015,12,26,14,785,799,1584,1578
0132-000,2015,12,26,15,861,836,1697,1584
0132-000,2015,12,26,16,926,834,1760,1697
0132-000,2015,12,26,17,1059,770,1829,1760
0132-000,2015,12,26,18,1181,875,2056,1829
0132-000,2015,12,26,19,1002,977,1979,2056
0132-000,2015,12,26,20,641,1109,1750,1979
0132-000,2015,12,26,21,515,512,1027,1750
0132-000,2015,12,26,22,390,315,705,1027
0132-000,2015,12,26,23,241,301,542,705
0132-000,2015,12,26,24,213,216,429,542
0132-000,2015,12,27,1,172,181,353,429
0132-000,2015,12,27,2,114,124,238,353
0132-000,2015,12,27,3,113,114,227,238
0132-000,2015,12,27,4,64,80,144,227
0132-000,2015,12,27,5,77,86,163,144
0132-000,2015,12,27,6,123,75,198,163
0132-000,2015,12,27,7,174,135,309,198
0132-000,2015,12,27,8,207,243,450,309
0132-000,2015,12,27,9,301,364,665,450
0132-000,2015,12,27,10,374,483,857,665
0132-000,2015,12,27,11,508,558,1066,857
0132-000,2015,12,27,12,550,612,1162,1066
0132-000,2015,12,27,13,667,563,1230,1162
0132-000,2015,12,27,14,726,659,1385,1230
0132-000,2015,12,27,15,678,675,1353,1385
0132-000,2015,12,27,16,898,731,1629,1353
0132-000,2015,12,27,17,1032,718,1750,1629
0132-000,2015,12,27,18,954,647,1601,1750
0132-000,2015,12,27,19,795,592,1387,1601
0132-000,2015,12,27,20,538,481,1019,1387
0132-000,2015,12,27,21,425,440,865,1019
0132-000,2015,12,27,22,375,349,724,865
0132-000,2015,12,27,23,244,264,508,724
0132-000,2015,12,27,24,180,168,348,508
0132-000,2015,12,28,1,98,116,214,348
0132-000,2015,12,28,2,60,77,137,214
0132-000,2015,12,28,3,50,66,116,137
0132-000,2015,12,28,4,47,54,101,116
0132-000,2015,12,28,5,73,62,135,101
0132-000,2015,12,28,6,206,143,349,135
0132-000,2015,12,28,7,398,470,868,349
0132-000,2015,12,28,8,674,1638,2312,868
0132-000,2015,12,28,9,816,1493,2309,2312
0132-000,2015,12,28,10,759,810,1569,2309
0132-000,2015,12,28,11,799,866,1665,1569
0132-000,2015,12,28,12,785,811,1596,1665
0132-000,2015,12,28,13,782,822,1604,1596
0132-000,2015,12,28,14,846,783,1629,1604
0132-000,2015,12,28,15,852,875,1727,1629
0132-000,2015,12,28,16,895,834,1729,1727
0132-000,2015,12,28,17,971,841,1812,1729
0132-000,2015,12,28,18,1319,889,2208,1812
0132-000,2015,12,28,19,1399,873,2272,2208
0132-000,2015,12,28,20,823,592,1415,2272
0132-000,2015,12,28,21,713,479,1192,1415
0132-000,2015,12,28,22,506,405,911,1192
0132-000,2015,12,28,23,360,300,660,911
0132-000,2015,12,28,24,217,234,451,660
0132-000,2015,12,29,1,180,173,353,451
0132-000,2015,12,29,2,95,87,182,353
0132-000,2015,12,29,3,68,88,156,182
0132-000,2015,12,29,4,76,96,172,156
0132-000,2015,12,29,5,73,85,158,172
0132-000,2015,12,29,6,196,108,304,158
0132-000,2015,12,29,7,369,392,761,304
0132-000,2015,12,29,8,632,1471,2103,761
0132-000,2015,12,29,9,863,1455,2318,2103
0132-000,2015,12,29,10,779,826,1605,2318
0132-000,2015,12,29,11,895,850,1745,1605
0132-000,2015,12,29,12,856,1103,1959,1745
0132-000,2015,12,29,13,779,865,1644,1959
0132-000,2015,12,29,14,870,840,1710,1644
0132-000,2015,12,29,15,947,900,1847,1710
0132-000,2015,12,29,16,1040,866,1906,1847
0132-000,2015,12,29,17,1017,850,1867,1906
0132-000,2015,12,29,18,1339,919,2258,1867
0132-000,2015,12,29,19,1440,823,2263,2258
0132-000,2015,12,29,20,816,626,1442,2263
0132-000,2015,12,29,21,691,487,1178,1442
0132-000,2015,12,29,22,532,484,1016,1178
0132-000,2015,12,29,23,354,321,675,1016
0132-000,2015,12,29,24,239,231,470,675
0132-000,2015,12,30,1,203,197,400,470
0132-000,2015,12,30,2,149,124,273,400
0132-000,2015,12,30,3,85,94,179,273
0132-000,2015,12,30,4,86,79,165,179
0132-000,2015,12,30,5,86,96,182,165
0132-000,2015,12,30,6,200,121,321,182
0132-000,2015,12,30,7,391,389,780,321
0132-000,2015,12,30,8,664,1501,2165,780
0132-000,2015,12,30,9,843,1390,2233,2165
0132-000,2015,12,30,10,757,832,1589,2233
0132-000,2015,12,30,11,786,829,1615,1589
0132-000,2015,12,30,12,781,831,1612,1615
0132-000,2015,12,30,13,755,760,1515,1612
0132-000,2015,12,30,14,888,817,1705,1515
0132-000,2015,12,30,15,929,840,1769,1705
0132-000,2015,12,30,16,969,888,1857,1769
0132-000,2015,12,30,17,980,876,1856,1857
0132-000,2015,12,30,18,1334,846,2180,1856
0132-000,2015,12,30,19,1319,775,2094,2180
0132-000,2015,12,30,20,804,660,1464,2094
0132-000,2015,12,30,21,639,490,1129,1464
0132-000,2015,12,30,22,519,409,928,1129
0132-000,2015,12,30,23,327,327,654,928
0132-000,2015,12,30,24,279,249,528,654
0132-000,2015,12,31,1,203,196,399,528
0132-000,2015,12,31,2,138,165,303,399
0132-000,2015,12,31,3,129,116,245,303
0132-000,2015,12,31,4,94,94,188,245
0132-000,2015,12,31,5,85,98,183,188
0132-000,2015,12,31,6,170,117,287,183
0132-000,2015,12,31,7,297,335,632,287
0132-000,2015,12,31,8,593,1338,1931,632
0132-000,2015,12,31,9,760,1228,1988,1931
0132-000,2015,12,31,10,681,776,1457,1988
0132-000,2015,12,31,11,766,791,1557,1457
0132-000,2015,12,31,12,785,857,1642,1557
0132-000,2015,12,31,13,870,813,1683,1642
0132-000,2015,12,31,14,987,855,1842,1683
0132-000,2015,12,31,15,964,921,1885,1842
0132-000,2015,12,31,16,1083,966,2049,1885
0132-000,2015,12,31,17,1184,1029,2213,2049
0132-000,2015,12,31,18,1525,1023,2548,2213
0132-000,2015,12,31,19,1407,991,2398,2548
0132-000,2015,12,31,20,852,796,1648,2398
0132-000,2015,12,31,21,643,590,1233,1648
0132-000,2015,12,31,22,494,438,932,1233
0132-000,2015,12,31,23,365,397,762,932
0132-000,2015,12,31,24,242,271,513,762
0132-000,2016,1,1,1,211,202,413,513
0132-000,2016,1,1,2,185,192,377,413
0132-000,2016,1,1,3,107,125,232,377
0132-000,2016,1,1,4,80,89,169,232
0132-000,2016,1,1,5,67,88,155,169
0132-000,2016,1,1,6,85,97,182,155
0132-000,2016,1,1,7,124,170,294,182
0132-000,2016,1,1,8,176,271,447,294
0132-000,2016,1,1,9,263,328,591,447
0132-000,2016,1,1,10,338,400,738,591
0132-000,2016,1,1,11,504,550,1054,738
0132-000,2016,1,1,12,544,802,1346,1054
0132-000,2016,1,1,13,539,1076,1615,1346
0132-000,2016,1,1,14,615,992,1607,1615
0132-000,2016,1,1,15,651,946,1597,1607
0132-000,2016,1,1,16,711,872,1583,1597
0132-000,2016,1,1,17,724,883,1607,1583
0132-000,2016,1,1,18,784,701,1485,1607
0132-000,2016,1,1,19,665,515,1180,1485
0132-000,2016,1,1,20,505,404,909,1180
0132-000,2016,1,1,21,401,368,769,909
0132-000,2016,1,1,22,345,288,633,769
0132-000,2016,1,1,23,229,243,472,633
0132-000,2016,1,1,24,185,177,362,472
0132-000,2016,1,2,1,109,131,240,362
0132-000,2016,1,2,2,93,109,202,240
0132-000,2016,1,2,3,57,68,125,202
0132-000,2016,1,2,4,48,51,99,125
0132-000,2016,1,2,5,65,68,133,99
0132-000,2016,1,2,6,70,82,152,133
0132-000,2016,1,2,7,171,193,364,152
0132-000,2016,1,2,8,253,328,581,364
0132-000,2016,1,2,9,344,527,871,581
0132-000,2016,1,2,10,445,525,970,871
0132-000,2016,1,2,11,523,698,1221,970
0132-000,2016,1,2,12,716,754,1470,1221
0132-000,2016,1,2,13,725,757,1482,1470
0132-000,2016,1,2,14,745,792,1537,1482
0132-000,2016,1,2,15,827,762,1589,1537
0132-000,2016,1,2,16,922,779,1701,1589
0132-000,2016,1,2,17,1128,741,1869,1701
0132-000,2016,1,2,18,1359,731,2090,1869
0132-000,2016,1,2,19,1299,599,1898,2090
0132-000,2016,1,2,20,861,464,1325,1898
0132-000,2016,1,2,21,666,359,1025,1325
0132-000,2016,1,2,22,462,331,793,1025
0132-000,2016,1,2,23,312,257,569,793
0132-000,2016,1,2,24,172,194,366,569
0132-000,2016,1,3,1,142,138,280,366
0132-000,2016,1,3,2,102,126,228,280
0132-000,2016,1,3,3,97,97,194,228
0132-000,2016,1,3,4,80,91,171,194
0132-000,2016,1,3,5,76,73,149,171
0132-000,2016,1,3,6,73,80,153,149
0132-000,2016,1,3,7,137,122,259,153
0132-000,2016,1,3,8,187,221,408,259
0132-000,2016,1,3,9,240,340,580,408
0132-000,2016,1,3,10,359,414,773,580
0132-000,2016,1,3,11,422,507,929,773
0132-000,2016,1,3,12,562,537,1099,929
0132-000,2016,1,3,13,622,618,1240,1099
0132-000,2016,1,3,14,724,686,1410,1240
0132-000,2016,1,3,15,840,705,1545,1410
0132-000,2016,1,3,16,921,737,1658,1545
0132-000,2016,1,3,17,979,702,1681,1658
0132-000,2016,1,3,18,1123,682,1805,1681
0132-000,2016,1,3,19,952,520,1472,1805
0132-000,2016,1,3,20,620,448,1068,1472
0132-000,2016,1,3,21,489,423,912,1068
0132-000,2016,1,3,22,405,361,766,912
0132-000,2016,1,3,23,249,256,505,766
0132-000,2016,1,3,24,172,189,361,505
0132-000,2016,1,4,1,121,118,239,361
0132-000,2016,1,4,2,61,75,136,239
0132-000,2016,1,4,3,36,57,93,136
0132-000,2016,1,4,4,49,65,114,93
0132-000,2016,1,4,5,78,57,135,114
0132-000,2016,1,4,6,208,160,368,135
0132-000,2016,1,4,7,404,496,900,368
0132-000,2016,1,4,8,646,1719,2365,900
0132-000,2016,1,4,9,829,1495,2324,2365
0132-000,2016,1,4,10,732,787,1519,2324
0132-000,2016,1,4,11,766,837,1603,1519
0132-000,2016,1,4,12,824,830,1654,1603
0132-000,2016,1,4,13,731,758,1489,1654
0132-000,2016,1,4,14,867,901,1768,1489
0132-000,2016,1,4,15,969,924,1893,1768
0132-000,2016,1,4,16,927,825,1752,1893
0132-000,2016,1,4,17,950,824,1774,1752
0132-000,2016,1,4,18,1178,883,2061,1774
0132-000,2016,1,4,19,1393,859,2252,2061
0132-000,2016,1,4,20,929,629,1558,2252
0132-000,2016,1,4,21,725,452,1177,1558
0132-000,2016,1,4,22,511,364,875,1177
0132-000,2016,1,4,23,328,264,592,875
0132-000,2016,1,4,24,191,182,373,592
0132-000,2016,1,5,1,143,151,294,373
0132-000,2016,1,5,2,92,82,174,294
0132-000,2016,1,5,3,81,69,150,174
0132-000,2016,1,5,4,69,75,144,150
0132-000,2016,1,5,5,65,73,138,144
0132-000,2016,1,5,6,223,131,354,138
0132-000,2016,1,5,7,356,407,763,354
0132-000,2016,1,5,8,626,1640,2266,763
0132-000,2016,1,5,9,759,1431,2190,2266
0132-000,2016,1,5,10,786,855,1641,2190
0132-000,2016,1,5,11,818,842,1660,1641
0132-000,2016,1,5,12,733,833,1566,1660
0132-000,2016,1,5,13,766,767,1533,1566
0132-000,2016,1,5,14,856,770,1626,1533
0132-000,2016,1,5,15,922,834,1756,1626
0132-000,2016,1,5,16,862,867,1729,1756
0132-000,2016,1,5,17,943,791,1734,1729
0132-000,2016,1,5,18,1233,893,2126,1734
0132-000,2016,1,5,19,1337,782,2119,2126
0132-000,2016,1,5,20,910,629,1539,2119
0132-000,2016,1,5,21,771,442,1213,1539
0132-000,2016,1,5,22,584,401,985,1213
0132-000,2016,1,5,23,334,302,636,985
0132-000,2016,1,5,24,242,208,450,636
0132-000,2016,1,6,1,164,158,322,450
0132-000,2016,1,6,2,112,105,217,322
0132-000,2016,1,6,3,69,87,156,217
0132-000,2016,1,6,4,82,76,158,156
0132-000,2016,1,6,5,77,80,157,158
0132-000,2016,1,6,6,226,113,339,157
0132-000,2016,1,6,7,360,426,786,339
0132-000,2016,1,6,8,610,1618,2228,786
0132-000,2016,1,6,9,757,1438,2195,2228
0132-000,2016,1,6,10,744,833,1577,2195
0132-000,2016,1,6,11,768,821,1589,1577
0132-000,2016,1,6,12,787,814,1601,1589
0132-000,2016,1,6,13,770,730,1500,1601
0132-000,2016,1,6,14,861,770,1631,1500
0132-000,2016,1,6,15,865,886,1751,1631
0132-000,2016,1,6,16,890,772,1662,1751
0132-000,2016,1,6,17,902,792,1694,1662
0132-000,2016,1,6,18,1339,892,2231,1694
0132-000,2016,1,6,19,1446,817,2263,2231
0132-000,2016,1,6,20,887,640,1527,2263
0132-000,2016,1,6,21,705,468,1173,1527
0132-000,2016,1,6,22,503,371,874,1173
0132-000,2016,1,6,23,323,271,594,874
0132-000,2016,1,6,24,233,211,444,594
0132-000,2016,1,7,1,186,149,335,444
0132-000,2016,1,7,2,103,105,208,335
0132-000,2016,1,7,3,72,82,154,208
0132-000,2016,1,7,4,60,78,138,154
0132-000,2016,1,7,5,88,70,158,138
0132-000,2016,1,7,6,215,126,341,158
0132-000,2016,1,7,7,341,390,731,341
0132-000,2016,1,7,8,598,1579,2177,731
0132-000,2016,1,7,9,816,1404,2220,2177
0132-000,2016,1,7,10,729,816,1545,2220
0132-000,2016,1,7,11,779,875,1654,1545
0132-000,2016,1,7,12,801,883,1684,1654
0132-000,2016,1,7,13,753,785,1538,1684
0132-000,2016,1,7,14,767,773,1540,1538
0132-000,2016,1,7,15,902,788,1690,1540
0132-000,2016,1,7,16,868,807,1675,1690
0132-000,2016,1,7,17,915,793,1708,1675
0132-000,2016,1,7,18,1242,877,2119,1708
0132-000,2016,1,7,19,1368,812,2180,2119
0132-000,2016,1,7,20,866,666,1532,2180
0132-000,2016,1,7,21,838,441,1279,1532
0132-000,2016,1,7,22,554,496,1050,1279
0132-000,2016,1,7,23,338,303,641,1050
0132-000,2016,1,7,24,240,203,443,641
0132-000,2016,1,8,1,175,165,340,443
0132-000,2016,1,8,2,105,83,188,340
0132-000,2016,1,8,3,85,104,189,188
0132-000,2016,1,8,4,78,67,145,189
0132-000,2016,1,8,5,83,95,178,145
0132-000,2016,1,8,6,217,114,331,178
0132-000,2016,1,8,7,290,343,633,331
0132-000,2016,1,8,8,609,1504,2113,633
0132-000,2016,1,8,9,793,1455,2248,2113
0132-000,2016,1,8,10,763,840,1603,2248
0132-000,2016,1,8,11,803,801,1604,1603
0132-000,2016,1,8,12,823,841,1664,1604
0132-000,2016,1,8,13,790,789,1579,1664
0132-000,2016,1,8,14,892,771,1663,1579
0132-000,2016,1,8,15,911,878,1789,1663
0132-000,2016,1,8,16,863,804,1667,1789
0132-000,2016,1,8,17,921,829,1750,1667
0132-000,2016,1,8,18,1349,916,2265,1750
0132-000,2016,1,8,19,1613,867,2480,2265
0132-000,2016,1,8,20,1056,723,1779,2480
0132-000,2016,1,8,21,775,486,1261,1779
0132-000,2016,1,8,22,582,411,993,1261
0132-000,2016,1,8,23,356,354,710,993
0132-000,2016,1,8,24,240,256,496,710
0132-000,2016,1,9,1,182,180,362,496
0132-000,2016,1,9,2,142,150,292,362
0132-000,2016,1,9,3,107,115,222,292
0132-000,2016,1,9,4,92,98,190,222
0132-000,2016,1,9,5,96,100,196,190
0132-000,2016,1,9,6,207,125,332,196
0132-000,2016,1,9,7,285,263,548,332
0132-000,2016,1,9,8,425,658,1083,548
0132-000,2016,1,9,9,618,809,1427,1083
0132-000,2016,1,9,10,675,802,1477,1427
0132-000,2016,1,9,11,841,826,1667,1477
0132-000,2016,1,9,12,875,878,1753,1667
0132-000,2016,1,9,13,827,874,1701,1753
0132-000,2016,1,9,14,815,840,1655,1701
0132-000,2016,1,9,15,889,918,1807,1655
0132-000,2016,1,9,16,934,896,1830,1807
0132-000,2016,1,9,17,1061,872,1933,1830
0132-000,2016,1,9,18,1273,909,2182,1933
0132-000,2016,1,9,19,998,791,1789,2182
0132-000,2016,1,9,20,627,572,1199,1789
0132-000,2016,1,9,21,483,451,934,1199
0132-000,2016,1,9,22,425,369,794,934
0132-000,2016,1,9,23,330,304,634,794
0132-000,2016,1,9,24,231,257,488,634
0132-000,2016,1,10,1,150,152,302,488
0132-000,2016,1,10,2,105,131,236,302
0132-000,2016,1,10,3,97,113,210,236
0132-000,2016,1,10,4,81,74,155,210
0132-000,2016,1,10,5,71,87,158,155
0132-000,2016,1,10,6,120,78,198,158
0132-000,2016,1,10,7,173,128,301,198
0132-000,2016,1,10,8,202,241,443,301
0132-000,2016,1,10,9,302,374,676,443
0132-000,2016,1,10,10,374,460,834,676
0132-000,2016,1,10,11,490,579,1069,834
0132-000,2016,1,10,12,531,598,1129,1069
0132-000,2016,1,10,13,639,614,1253,1129
0132-000,2016,1,10,14,713,631,1344,1253
0132-000,2016,1,10,15,772,727,1499,1344
0132-000,2016,1,10,16,811,693,1504,1499
0132-000,2016,1,10,17,833,717,1550,1504
0132-000,2016,1,10,18,887,722,1609,1550
0132-000,2016,1,10,19,757,596,1353,1609
0132-000,2016,1,10,20,526,489,1015,1353
0132-000,2016,1,10,21,461,374,835,1015
0132-000,2016,1,10,22,344,320,664,835
0132-000,2016,1,10,23,217,232,449,664
0132-000,2016,1,10,24,172,167,339,449
0132-000,2016,1,11,1,120,131,251,339
0132-000,2016,1,11,2,94,80,174,251
0132-000,2016,1,11,3,60,52,112,174
0132-000,2016,1,11,4,40,59,99,112
0132-000,2016,1,11,5,77,63,140,99
0132-000,2016,1,11,6,205,133,338,140
0132-000,2016,1,11,7,412,488,900,338
0132-000,2016,1,11,8,627,1650,2277,900
0132-000,2016,1,11,9,771,1512,2283,2277
0132-000,2016,1,11,10,721,799,1520,2283
0132-000,2016,1,11,11,799,793,1592,1520
0132-000,2016,1,11,12,789,842,1631,1592
0132-000,2016,1,11,13,745,743,1488,1631
0132-000,2016,1,11,14,822,827,1649,1488
0132-000,2016,1,11,15,861,839,1700,1649
0132-000,2016,1,11,16,991,839,1830,1700
0132-000,2016,1,11,17,926,856,1782,1830
0132-000,2016,1,11,18,1187,921,2108,1782
0132-000,2016,1,11,19,1382,838,2220,2108
0132-000,2016,1,11,20,955,621,1576,2220
0132-000,2016,1,11,21,799,454,1253,1576
0132-000,2016,1,11,22,546,412,958,1253
0132-000,2016,1,11,23,323,285,608,958
0132-000,2016,1,11,24,216,214,430,608
0132-000,2016,1,12,1,159,148,307,430
0132-000,2016,1,12,2,102,111,213,307
0132-000,2016,1,12,3,75,77,152,213
0132-000,2016,1,12,4,60,61,121,152
0132-000,2016,1,12,5,65,81,146,121
0132-000,2016,1,12,6,190,109,299,146
0132-000,2016,1,12,7,350,397,747,299
0132-000,2016,1,12,8,580,1487,2067,747
0132-000,2016,1,12,9,833,1472,2305,2067
0132-000,2016,1,12,10,701,786,1487,2305
0132-000,2016,1,12,11,816,836,1652,1487
0132-000,2016,1,12,12,813,803,1616,1652
0132-000,2016,1,12,13,737,739,1476,1616
0132-000,2016,1,12,14,789,810,1599,1476
0132-000,2016,1,12,15,897,854,1751,1599
0132-000,2016,1,12,16,923,776,1699,1751
0132-000,2016,1,12,17,890,813,1703,1699
0132-000,2016,1,12,18,1169,877,2046,1703
0132-000,2016,1,12,19,1296,806,2102,2046
0132-000,2016,1,12,20,908,628,1536,2102
0132-000,2016,1,12,21,739,496,1235,1536
0132-000,2016,1,12,22,553,415,968,1235
0132-000,2016,1,12,23,363,317,680,968
0132-000,2016,1,12,24,215,191,406,680
0132-000,2016,1,13,1,148,121,269,406
0132-000,2016,1,13,2,112,98,210,269
0132-000,2016,1,13,3,63,82,145,210
0132-000,2016,1,13,4,59,73,132,145
0132-000,2016,1,13,5,78,80,158,132
0132-000,2016,1,13,6,187,123,310,158
0132-000,2016,1,13,7,342,292,634,310
0132-000,2016,1,13,8,567,1337,1904,634
0132-000,2016,1,13,9,657,1521,2178,1904
0132-000,2016,1,13,10,674,771,1445,2178
0132-000,2016,1,13,11,741,731,1472,1445
0132-000,2016,1,13,12,777,728,1505,1472
0132-000,2016,1,13,13,723,700,1423,1505
0132-000,2016,1,13,14,819,829,1648,1423
0132-000,2016,1,13,15,900,778,1678,1648
0132-000,2016,1,13,16,889,811,1700,1678
0132-000,2016,1,13,17,887,803,1690,1700
0132-000,2016,1,13,18,1232,860,2092,1690
0132-000,2016,1,13,19,1429,641,2070,2092
0132-000,2016,1,13,20,813,526,1339,2070
0132-000,2016,1,13,21,611,433,1044,1339
0132-000,2016,1,13,22,427,310,737,1044
0132-000,2016,1,13,23,234,251,485,737
0132-000,2016,1,13,24,182,163,345,485
0132-000,2016,1,14,1,132,127,259,345
0132-000,2016,1,14,2,101,104,205,259
0132-000,2016,1,14,3,54,57,111,205
0132-000,2016,1,14,4,61,57,118,111
0132-000,2016,1,14,5,53,80,133,118
0132-000,2016,1,14,6,182,93,275,133
0132-000,2016,1,14,7,297,323,620,275
0132-000,2016,1,14,8,556,1152,1708,620
0132-000,2016,1,14,9,667,1297,1964,1708
0132-000,2016,1,14,10,719,884,1603,1964
0132-000,2016,1,14,11,713,753,1466,1603
0132-000,2016,1,14,12,764,671,1435,1466
0132-000,2016,1,14,13,669,779,1448,1435
0132-000,2016,1,14,14,754,765,1519,1448
0132-000,2016,1,14,15,869,820,1689,1519
0132-000,2016,1,14,16,895,777,1672,1689
0132-000,2016,1,14,17,1005,833,1838,1672
0132-000,2016,1,14,18,1124,835,1959,1838
0132-000,2016,1,14,19,1280,767,2047,1959
0132-000,2016,1,14,20,801,591,1392,2047
0132-000,2016,1,14,21,730,443,1173,1392
0132-000,2016,1,14,22,573,369,942,1173
0132-000,2016,1,14,23,333,290,623,942
0132-000,2016,1,14,24,216,203,419,623
0132-000,2016,1,15,1,194,148,342,419
0132-000,2016,1,15,2,104,92,196,342
0132-000,2016,1,15,3,68,84,152,196
0132-000,2016,1,15,4,65,97,162,152
0132-000,2016,1,15,5,80,92,172,162
0132-000,2016,1,15,6,207,124,331,172
0132-000,2016,1,15,7,337,389,726,331
0132-000,2016,1,15,8,600,1383,1983,726
0132-000,2016,1,15,9,770,1362,2132,1983
0132-000,2016,1,15,10,694,793,1487,2132
0132-000,2016,1,15,11,805,843,1648,1487
0132-000,2016,1,15,12,814,871,1685,1648
0132-000,2016,1,15,13,808,802,1610,1685
0132-000,2016,1,15,14,944,842,1786,1610
0132-000,2016,1,15,15,941,885,1826,1786
0132-000,2016,1,15,16,1012,821,1833,1826
0132-000,2016,1,15,17,989,850,1839,1833
0132-000,2016,1,15,18,1321,896,2217,1839
0132-000,2016,1,15,19,1563,860,2423,2217
0132-000,2016,1,15,20,1085,734,1819,2423
0132-000,2016,1,15,21,743,526,1269,1819
0132-000,2016,1,15,22,562,471,1033,1269
0132-000,2016,1,15,23,334,311,645,1033
0132-000,2016,1,15,24,250,252,502,645
0132-000,2016,1,16,1,201,195,396,502
0132-000,2016,1,16,2,145,142,287,396
0132-000,2016,1,16,3,106,111,217,287
0132-000,2016,1,16,4,80,101,181,217
0132-000,2016,1,16,5,95,95,190,181
0132-000,2016,1,16,6,169,122,291,190
0132-000,2016,1,16,7,259,306,565,291
0132-000,2016,1,16,8,404,647,1051,565
0132-000,2016,1,16,9,639,840,1479,1051
0132-000,2016,1,16,10,690,810,1500,1479
0132-000,2016,1,16,11,764,949,1713,1500
0132-000,2016,1,16,12,946,1082,2028,1713
0132-000,2016,1,16,13,1007,945,1952,2028
0132-000,2016,1,16,14,863,938,1801,1952
0132-000,2016,1,16,15,885,906,1791,1801
0132-000,2016,1,16,16,947,925,1872,1791
0132-000,2016,1,16,17,1065,861,1926,1872
0132-000,2016,1,16,18,1305,920,2225,1926
0132-000,2016,1,16,19,1169,813,1982,2225
0132-000,2016,1,16,20,683,580,1263,1982
0132-000,2016,1,16,21,542,441,983,1263
0132-000,2016,1,16,22,434,358,792,983
0132-000,2016,1,16,23,330,299,629,792
0132-000,2016,1,16,24,195,224,419,629
0132-000,2016,1,17,1,161,173,334,419
0132-000,2016,1,17,2,101,149,250,334
0132-000,2016,1,17,3,96,93,189,250
0132-000,2016,1,17,4,73,89,162,189
0132-000,2016,1,17,5,71,72,143,162
0132-000,2016,1,17,6,139,89,228,143
0132-000,2016,1,17,7,202,157,359,228
0132-000,2016,1,17,8,194,252,446,359
0132-000,2016,1,17,9,313,372,685,446
0132-000,2016,1,17,10,386,484,870,685
0132-000,2016,1,17,11,458,593,1051,870
0132-000,2016,1,17,12,522,550,1072,1051
0132-000,2016,1,17,13,621,713,1334,1072
0132-000,2016,1,17,14,651,688,1339,1334
0132-000,2016,1,17,15,799,710,1509,1339
0132-000,2016,1,17,16,800,693,1493,1509
0132-000,2016,1,17,17,923,732,1655,1493
0132-000,2016,1,17,18,1016,672,1688,1655
0132-000,2016,1,17,19,839,607,1446,1688
0132-000,2016,1,17,20,575,490,1065,1446
0132-000,2016,1,17,21,449,392,841,1065
0132-000,2016,1,17,22,372,360,732,841
0132-000,2016,1,17,23,246,291,537,732
0132-000,2016,1,17,24,150,206,356,537
0132-000,2016,1,18,1,121,109,230,356
0132-000,2016,1,18,2,76,88,164,230
0132-000,2016,1,18,3,53,69,122,164
0132-000,2016,1,18,4,59,52,111,122
0132-000,2016,1,18,5,55,68,123,111
0132-000,2016,1,18,6,211,140,351,123
0132-000,2016,1,18,7,366,477,843,351
0132-000,2016,1,18,8,618,1538,2156,843
0132-000,2016,1,18,9,753,1471,2224,2156
0132-000,2016,1,18,10,668,773,1441,2224
0132-000,2016,1,18,11,720,774,1494,1441
0132-000,2016,1,18,12,778,808,1586,1494
0132-000,2016,1,18,13,792,692,1484,1586
0132-000,2016,1,18,14,793,794,1587,1484
0132-000,2016,1,18,15,871,892,1763,1587
0132-000,2016,1,18,16,905,777,1682,1763
0132-000,2016,1,18,17,817,761,1578,1682
0132-000,2016,1,18,18,1018,825,1843,1578
0132-000,2016,1,18,19,1255,798,2053,1843
0132-000,2016,1,18,20,822,586,1408,2053
0132-000,2016,1,18,21,683,419,1102,1408
0132-000,2016,1,18,22,489,321,810,1102
0132-000,2016,1,18,23,254,200,454,810
0132-000,2016,1,18,24,168,159,327,454
0132-000,2016,1,19,1,120,101,221,327
0132-000,2016,1,19,2,76,65,141,221
0132-000,2016,1,19,3,57,61,118,141
0132-000,2016,1,19,4,53,68,121,118
0132-000,2016,1,19,5,45,58,103,121
0132-000,2016,1,19,6,137,82,219,103
0132-000,2016,1,19,7,252,336,588,219
0132-000,2016,1,19,8,456,1211,1667,588
0132-000,2016,1,19,9,703,1322,2025,1667
0132-000,2016,1,19,10,629,686,1315,2025
0132-000,2016,1,19,11,650,695,1345,1315
0132-000,2016,1,19,12,691,717,1408,1345
0132-000,2016,1,19,13,720,666,1386,1408
0132-000,2016,1,19,14,764,702,1466,1386
0132-000,2016,1,19,15,840,749,1589,1466
0132-000,2016,1,19,16,891,697,1588,1589
0132-000,2016,1,19,17,767,768,1535,1588
0132-000,2016,1,19,18,1017,681,1698,1535
0132-000,2016,1,19,19,1259,711,1970,1698
0132-000,2016,1,19,20,804,552,1356,1970
0132-000,2016,1,19,21,689,414,1103,1356
0132-000,2016,1,19,22,514,335,849,1103
0132-000,2016,1,19,23,284,259,543,849
0132-000,2016,1,19,24,174,167,341,543
0132-000,2016,1,20,1,133,124,257,341
0132-000,2016,1,20,2,89,73,162,257
0132-000,2016,1,20,3,53,65,118,162
0132-000,2016,1,20,4,60,62,122,118
0132-000,2016,1,20,5,58,77,135,122
0132-000,2016,1,20,6,152,101,253,135
0132-000,2016,1,20,7,300,345,645,253
0132-000,2016,1,20,8,549,1428,1977,645
0132-000,2016,1,20,9,764,1516,2280,1977
0132-000,2016,1,20,10,692,772,1464,2280
0132-000,2016,1,20,11,815,772,1587,1464
0132-000,2016,1,20,12,759,810,1569,1587
0132-000,2016,1,20,13,729,762,1491,1569
0132-000,2016,1,20,14,836,779,1615,1491
0132-000,2016,1,20,15,994,855,1849,1615
0132-000,2016,1,20,16,929,789,1718,1849
0132-000,2016,1,20,17,885,801,1686,1718
0132-000,2016,1,20,18,1116,814,1930,1686
0132-000,2016,1,20,19,1425,762,2187,1930
0132-000,2016,1,20,20,858,638,1496,2187
0132-000,2016,1,20,21,691,466,1157,1496
0132-000,2016,1,20,22,540,378,918,1157
0132-000,2016,1,20,23,344,273,617,918
0132-000,2016,1,20,24,206,173,379,617
0132-000,2016,1,21,1,162,155,317,379
0132-000,2016,1,21,2,119,89,208,317
0132-000,2016,1,21,3,71,92,163,208
0132-000,2016,1,21,4,78,78,156,163
0132-000,2016,1,21,5,76,85,161,156
0132-000,2016,1,21,6,175,105,280,161
0132-000,2016,1,21,7,310,351,661,280
0132-000,2016,1,21,8,587,1464,2051,661
0132-000,2016,1,21,9,737,1473,2210,2051
0132-000,2016,1,21,10,658,793,1451,2210
0132-000,2016,1,21,11,782,774,1556,1451
0132-000,2016,1,21,12,772,792,1564,1556
0132-000,2016,1,21,13,723,759,1482,1564
0132-000,2016,1,21,14,828,751,1579,1482
0132-000,2016,1,21,15,919,836,1755,1579
0132-000,2016,1,21,16,905,721,1626,1755
0132-000,2016,1,21,17,905,814,1719,1626
0132-000,2016,1,21,18,1170,800,1970,1719
0132-000,2016,1,21,19,1301,829,2130,1970
0132-000,2016,1,21,20,906,613,1519,2130
0132-000,2016,1,21,21,764,461,1225,1519
0132-000,2016,1,21,22,550,376,926,1225
0132-000,2016,1,21,23,371,303,674,926
0132-000,2016,1,21,24,224,191,415,674
0132-000,2016,1,22,1,165,158,323,415
0132-000,2016,1,22,2,104,103,207,323
0132-000,2016,1,22,3,68,84,152,207
0132-000,2016,1,22,4,62,81,143,152
0132-000,2016,1,22,5,58,81,139,143
0132-000,2016,1,22,6,180,100,280,139
0132-000,2016,1,22,7,320,365,685,280
0132-000,2016,1,22,8,562,1377,1939,685
0132-000,2016,1,22,9,757,1527,2284,1939
0132-000,2016,1,22,10,716,803,1519,2284
0132-000,2016,1,22,11,800,859,1659,1519
0132-000,2016,1,22,12,804,827,1631,1659
0132-000,2016,1,22,13,757,750,1507,1631
0132-000,2016,1,22,14,885,780,1665,1507
0132-000,2016,1,22,15,979,839,1818,1665
0132-000,2016,1,22,16,924,858,1782,1818
0132-000,2016,1,22,17,1010,915,1925,1782
0132-000,2016,1,22,18,1320,864,2184,1925
0132-000,2016,1,22,19,1571,840,2411,2184
0132-000,2016,1,22,20,1036,717,1753,2411
0132-000,2016,1,22,21,780,565,1345,1753
0132-000,2016,1,22,22,563,459,1022,1345
0132-000,2016,1,22,23,393,330,723,1022
0132-000,2016,1,22,24,229,220,449,723
0132-000,2016,1,23,1,209,210,419,449
0132-000,2016,1,23,2,123,125,248,419
0132-000,2016,1,23,3,91,94,185,248
0132-000,2016,1,23,4,94,101,195,185
0132-000,2016,1,23,5,87,88,175,195
0132-000,2016,1,23,6,190,129,319,175
0132-000,2016,1,23,7,238,245,483,319
0132-000,2016,1,23,8,400,613,1013,483
0132-000,2016,1,23,9,599,770,1369,1013
0132-000,2016,1,23,10,651,725,1376,1369
0132-000,2016,1,23,11,724,831,1555,1376
0132-000,2016,1,23,12,858,847,1705,1555
0132-000,2016,1,23,13,888,905,1793,1705
0132-000,2016,1,23,14,968,891,1859,1793
0132-000,2016,1,23,15,1026,889,1915,1859
0132-000,2016,1,23,16,1003,894,1897,1915
0132-000,2016,1,23,17,1063,858,1921,1897
0132-000,2016,1,23,18,1212,860,2072,1921
0132-000,2016,1,23,19,883,737,1620,2072
0132-000,2016,1,23,20,588,530,1118,1620
0132-000,2016,1,23,21,494,413,907,1118
0132-000,2016,1,23,22,356,287,643,907
0132-000,2016,1,23,23,243,206,449,643
0132-000,2016,1,23,24,179,171,350,449
0132-000,2016,1,24,1,129,114,243,350
0132-000,2016,1,24,2,98,108,206,243
0132-000,2016,1,24,3,64,71,135,206
0132-000,2016,1,24,4,48,52,100,135
0132-000,2016,1,24,5,46,52,98,100
0132-000,2016,1,24,6,85,56,141,98
0132-000,2016,1,24,7,73,88,161,141
0132-000,2016,1,24,8,137,215,352,161
0132-000,2016,1,24,9,225,340,565,352
0132-000,2016,1,24,10,248,337,585,565
0132-000,2016,1,24,11,379,421,800,585
0132-000,2016,1,24,12,434,481,915,800
0132-000,2016,1,24,13,519,530,1049,915
0132-000,2016,1,24,14,556,575,1131,1049
0132-000,2016,1,24,15,652,554,1206,1131
0132-000,2016,1,24,16,762,586,1348,1206
0132-000,2016,1,24,17,724,565,1289,1348
0132-000,2016,1,24,18,700,528,1228,1289
0132-000,2016,1,24,19,636,458,1094,1228
0132-000,2016,1,24,20,444,387,831,1094
0132-000,2016,1,24,21,374,317,691,831
0132-000,2016,1,24,22,279,287,566,691
0132-000,2016,1,24,23,169,200,369,566
0132-000,2016,1,24,24,132,123,255,369
0132-000,2016,1,25,1,75,100,175,255
0132-000,2016,1,25,2,58,61,119,175
0132-000,2016,1,25,3,44,45,89,119
0132-000,2016,1,25,4,28,27,55,89
0132-000,2016,1,25,5,54,62,116,55
0132-000,2016,1,25,6,163,97,260,116
0132-000,2016,1,25,7,255,371,626,260
0132-000,2016,1,25,8,490,1398,1888,626
0132-000,2016,1,25,9,673,1422,2095,1888
0132-000,2016,1,25,10,596,737,1333,2095
0132-000,2016,1,25,11,702,710,1412,1333
0132-000,2016,1,25,12,741,770,1511,1412
0132-000,2016,1,25,13,722,769,1491,1511
0132-000,2016,1,25,14,784,770,1554,1491
0132-000,2016,1,25,15,846,841,1687,1554
0132-000,2016,1,25,16,862,756,1618,1687
0132-000,2016,1,25,17,881,747,1628,1618
0132-000,2016,1,25,18,1099,806,1905,1628
0132-000,2016,1,25,19,1351,801,2152,1905
0132-000,2016,1,25,20,903,565,1468,2152
0132-000,2016,1,25,21,768,449,1217,1468
0132-000,2016,1,25,22,495,392,887,1217
0132-000,2016,1,25,23,319,283,602,887
0132-000,2016,1,25,24,178,165,343,602
0132-000,2016,1,26,1,127,134,261,343
0132-000,2016,1,26,2,101,87,188,261
0132-000,2016,1,26,3,62,85,147,188
0132-000,2016,1,26,4,63,92,155,147
0132-000,2016,1,26,5,54,85,139,155
0132-000,2016,1,26,6,183,96,279,139
0132-000,2016,1,26,7,298,321,619,279
0132-000,2016,1,26,8,571,1412,1983,619
0132-000,2016,1,26,9,726,1456,2182,1983
0132-000,2016,1,26,10,650,829,1479,2182
0132-000,2016,1,26,11,857,770,1627,1479
0132-000,2016,1,26,12,821,794,1615,1627
0132-000,2016,1,26,13,800,839,1639,1615
0132-000,2016,1,26,14,810,882,1692,1639
0132-000,2016,1,26,15,873,832,1705,1692
0132-000,2016,1,26,16,883,782,1665,1705
0132-000,2016,1,26,17,886,842,1728,1665
0132-000,2016,1,26,18,1148,869,2017,1728
0132-000,2016,1,26,19,1375,744,2119,2017
0132-000,2016,1,26,20,900,627,1527,2119
0132-000,2016,1,26,21,800,472,1272,1527
0132-000,2016,1,26,22,558,391,949,1272
0132-000,2016,1,26,23,318,278,596,949
0132-000,2016,1,26,24,190,193,383,596
0132-000,2016,1,27,1,159,146,305,383
0132-000,2016,1,27,2,103,110,213,305
0132-000,2016,1,27,3,79,93,172,213
0132-000,2016,1,27,4,60,70,130,172
0132-000,2016,1,27,5,77,106,183,130
0132-000,2016,1,27,6,190,119,309,183
0132-000,2016,1,27,7,309,370,679,309
0132-000,2016,1,27,8,605,1454,2059,679
0132-000,2016,1,27,9,790,1480,2270,2059
0132-000,2016,1,27,10,814,855,1669,2270
0132-000,2016,1,27,11,821,833,1654,1669
0132-000,2016,1,27,12,862,797,1659,1654
0132-000,2016,1,27,13,807,831,1638,1659
0132-000,2016,1,27,14,794,845,1639,1638
0132-000,2016,1,27,15,910,884,1794,1639
0132-000,2016,1,27,16,966,820,1786,1794
0132-000,2016,1,27,17,922,830,1752,1786
0132-000,2016,1,27,18,1276,856,2132,1752
0132-000,2016,1,27,19,1457,800,2257,2132
0132-000,2016,1,27,20,927,651,1578,2257
0132-000,2016,1,27,21,712,503,1215,1578
0132-000,2016,1,27,22,553,401,954,1215
0132-000,2016,1,27,23,339,311,650,954
0132-000,2016,1,27,24,244,241,485,650
0132-000,2016,1,28,1,171,175,346,485
0132-000,2016,1,28,2,118,117,235,346
0132-000,2016,1,28,3,75,117,192,235
0132-000,2016,1,28,4,77,98,175,192
0132-000,2016,1,28,5,93,99,192,175
0132-000,2016,1,28,6,210,112,322,192
0132-000,2016,1,28,7,346,359,705,322
0132-000,2016,1,28,8,633,1479,2112,705
0132-000,2016,1,28,9,783,1477,2260,2112
0132-000,2016,1,28,10,731,817,1548,2260
0132-000,2016,1,28,11,902,841,1743,1548
0132-000,2016,1,28,12,795,925,1720,1743
0132-000,2016,1,28,13,751,767,1518,1720
0132-000,2016,1,28,14,819,831,1650,1518
0132-000,2016,1,28,15,943,892,1835,1650
0132-000,2016,1,28,16,946,851,1797,1835
0132-000,2016,1,28,17,960,808,1768,1797
0132-000,2016,1,28,18,1258,906,2164,1768
0132-000,2016,1,28,19,1340,832,2172,2164
0132-000,2016,1,28,20,897,647,1544,2172
0132-000,2016,1,28,21,764,463,1227,1544
0132-000,2016,1,28,22,538,413,951,1227
0132-000,2016,1,28,23,381,284,665,951
0132-000,2016,1,28,24,238,241,479,665
0132-000,2016,1,29,1,177,171,348,479
0132-000,2016,1,29,2,107,104,211,348
0132-000,2016,1,29,3,87,88,175,211
0132-000,2016,1,29,4,78,75,153,175
0132-000,2016,1,29,5,69,101,170,153
0132-000,2016,1,29,6,204,108,312,170
0132-000,2016,1,29,7,378,359,737,312
0132-000,2016,1,29,8,579,1471,2050,737
0132-000,2016,1,29,9,811,1512,2323,2050
0132-000,2016,1,29,10,800,828,1628,2323
0132-000,2016,1,29,11,849,872,1721,1628
0132-000,2016,1,29,12,779,877,1656,1721
0132-000,2016,1,29,13,728,760,1488,1656
0132-000,2016,1,29,14,902,813,1715,1488
0132-000,2016,1,29,15,927,880,1807,1715
0132-000,2016,1,29,16,984,831,1815,1807
0132-000,2016,1,29,17,1045,868,1913,1815
0132-000,2016,1,29,18,1369,930,2299,1913
0132-000,2016,1,29,19,1663,947,2610,2299
0132-000,2016,1,29,20,1093,726,1819,2610
0132-000,2016,1,29,21,802,575,1377,1819
0132-000,2016,1,29,22,596,435,1031,1377
0132-000,2016,1,29,23,400,380,780,1031
0132-000,2016,1,29,24,255,262,517,780
0132-000,2016,1,30,1,196,187,383,517
0132-000,2016,1,30,2,165,149,314,383
0132-000,2016,1,30,3,100,122,222,314
0132-000,2016,1,30,4,86,106,192,222
0132-000,2016,1,30,5,111,114,225,192
0132-000,2016,1,30,6,217,124,341,225
0132-000,2016,1,30,7,265,240,505,341
0132-000,2016,1,30,8,450,696,1146,505
0132-000,2016,1,30,9,689,843,1532,1146
0132-000,2016,1,30,10,726,831,1557,1532
0132-000,2016,1,30,11,810,930,1740,1557
0132-000,2016,1,30,12,912,1008,1920,1740
0132-000,2016,1,30,13,1046,973,2019,1920
0132-000,2016,1,30,14,1135,953,2088,2019
0132-000,2016,1,30,15,1011,1017,2028,2088
0132-000,2016,1,30,16,1013,979,1992,2028
0132-000,2016,1,30,17,1023,936,1959,1992
0132-000,2016,1,30,18,1407,1029,2436,1959
0132-000,2016,1,30,19,1244,850,2094,2436
0132-000,2016,1,30,20,695,616,1311,2094
0132-000,2016,1,30,21,604,498,1102,1311
0132-000,2016,1,30,22,473,440,913,1102
0132-000,2016,1,30,23,334,335,669,913
0132-000,2016,1,30,24,226,234,460,669
0132-000,2016,1,31,1,137,156,293,460
0132-000,2016,1,31,2,114,116,230,293
0132-000,2016,1,31,3,90,105,195,230
0132-000,2016,1,31,4,69,94,163,195
0132-000,2016,1,31,5,61,70,131,163
0132-000,2016,1,31,6,134,84,218,131
0132-000,2016,1,31,7,195,151,346,218
0132-000,2016,1,31,8,213,284,497,346
0132-000,2016,1,31,9,309,431,740,497
0132-000,2016,1,31,10,472,525,997,740
0132-000,2016,1,31,11,549,657,1206,997
0132-000,2016,1,31,12,591,697,1288,1206
0132-000,2016,1,31,13,663,732,1395,1288
0132-000,2016,1,31,14,784,748,1532,1395
0132-000,2016,1,31,15,867,812,1679,1532
0132-000,2016,1,31,16,934,766,1700,1679
0132-000,2016,1,31,17,939,788,1727,1700
0132-000,2016,1,31,18,1065,819,1884,1727
0132-000,2016,1,31,19,892,612,1504,1884
0132-000,2016,1,31,20,667,488,1155,1504
0132-000,2016,1,31,21,498,439,937,1155
0132-000,2016,1,31,22,412,356,768,937
0132-000,2016,1,31,23,242,252,494,768
0132-000,2016,1,31,24,174,191,365,494
0132-000,2016,2,1,1,102,108,210,365
0132-000,2016,2,1,2,59,80,139,210
0132-000,2016,2,1,3,50,61,111,139
0132-000,2016,2,1,4,48,42,90,111
0132-000,2016,2,1,5,63,68,131,90
0132-000,2016,2,1,6,223,126,349,131
0132-000,2016,2,1,7,404,439,843,349
0132-000,2016,2,1,8,599,1676,2275,843
0132-000,2016,2,1,9,800,1614,2414,2275
0132-000,2016,2,1,10,752,846,1598,2414
0132-000,2016,2,1,11,792,813,1605,1598
0132-000,2016,2,1,12,839,919,1758,1605
0132-000,2016,2,1,13,844,800,1644,1758
0132-000,2016,2,1,14,909,852,1761,1644
0132-000,2016,2,1,15,893,917,1810,1761
0132-000,2016,2,1,16,939,858,1797,1810
0132-000,2016,2,1,17,903,812,1715,1797
0132-000,2016,2,1,18,1235,899,2134,1715
0132-000,2016,2,1,19,1331,826,2157,2134
0132-000,2016,2,1,20,953,634,1587,2157
0132-000,2016,2,1,21,797,483,1280,1587
0132-000,2016,2,1,22,591,427,1018,1280
0132-000,2016,2,1,23,337,297,634,1018
0132-000,2016,2,1,24,204,205,409,634
0132-000,2016,2,2,1,157,130,287,409
0132-000,2016,2,2,2,113,104,217,287
0132-000,2016,2,2,3,76,80,156,217
0132-000,2016,2,2,4,64,86,150,156
0132-000,2016,2,2,5,76,92,168,150
0132-000,2016,2,2,6,191,123,314,168
0132-000,2016,2,2,7,341,344,685,314
0132-000,2016,2,2,8,626,1572,2198,685
0132-000,2016,2,2,9,863,1539,2402,2198
0132-000,2016,2,2,10,810,904,1714,2402
0132-000,2016,2,2,11,847,881,1728,1714
0132-000,2016,2,2,12,841,871,1712,1728
0132-000,2016,2,2,13,874,836,1710,1712
0132-000,2016,2,2,14,863,884,1747,1710
0132-000,2016,2,2,15,915,913,1828,1747
0132-000,2016,2,2,16,1039,841,1880,1828
0132-000,2016,2,2,17,964,872,1836,1880
0132-000,2016,2,2,18,1216,919,2135,1836
0132-000,2016,2,2,19,1387,808,2195,2135
0132-000,2016,2,2,20,910,666,1576,2195
0132-000,2016,2,2,21,801,502,1303,1576
0132-000,2016,2,2,22,678,475,1153,1303
0132-000,2016,2,2,23,417,328,745,1153
0132-000,2016,2,2,24,216,193,409,745
0132-000,2016,2,3,1,179,166,345,409
0132-000,2016,2,3,2,116,103,219,345
0132-000,2016,2,3,3,70,86,156,219
0132-000,2016,2,3,4,64,88,152,156
0132-000,2016,2,3,5,71,81,152,152
0132-000,2016,2,3,6,224,95,319,152
0132-000,2016,2,3,7,355,366,721,319
0132-000,2016,2,3,8,631,1554,2185,721
0132-000,2016,2,3,9,813,1475,2288,2185
0132-000,2016,2,3,10,823,889,1712,2288
0132-000,2016,2,3,11,849,861,1710,1712
0132-000,2016,2,3,12,839,903,1742,1710
0132-000,2016,2,3,13,759,815,1574,1742
0132-000,2016,2,3,14,882,913,1795,1574
0132-000,2016,2,3,15,1013,971,1984,1795
0132-000,2016,2,3,16,1038,909,1947,1984
0132-000,2016,2,3,17,976,881,1857,1947
0132-000,2016,2,3,18,1271,922,2193,1857
0132-000,2016,2,3,19,1511,875,2386,2193
0132-000,2016,2,3,20,983,714,1697,2386
0132-000,2016,2,3,21,790,566,1356,1697
0132-000,2016,2,3,22,616,452,1068,1356
0132-000,2016,2,3,23,379,350,729,1068
0132-000,2016,2,3,24,241,233,474,729
0132-000,2016,2,4,1,174,158,332,474
0132-000,2016,2,4,2,113,111,224,332
0132-000,2016,2,4,3,93,100,193,224
0132-000,2016,2,4,4,80,87,167,193
0132-000,2016,2,4,5,89,110,199,167
0132-000,2016,2,4,6,194,107,301,199
0132-000,2016,2,4,7,339,375,714,301
0132-000,2016,2,4,8,596,1511,2107,714
0132-000,2016,2,4,9,801,1548,2349,2107
0132-000,2016,2,4,10,784,998,1782,2349
0132-000,2016,2,4,11,899,1266,2165,1782
0132-000,2016,2,4,12,973,1145,2118,2165
0132-000,2016,2,4,13,1026,861,1887,2118
0132-000,2016,2,4,14,1251,960,2211,1887
0132-000,2016,2,4,15,1138,958,2096,2211
0132-000,2016,2,4,16,1062,933,1995,2096
0132-000,2016,2,4,17,1086,884,1970,1995
0132-000,2016,2,4,18,1365,984,2349,1970
0132-000,2016,2,4,19,1456,868,2324,2349
0132-000,2016,2,4,20,990,777,1767,2324
0132-000,2016,2,4,21,857,564,1421,1767
0132-000,2016,2,4,22,668,488,1156,1421
0132-000,2016,2,4,23,393,364,757,1156
0132-000,2016,2,4,24,267,259,526,757
0132-000,2016,2,5,1,191,203,394,526
0132-000,2016,2,5,2,132,120,252,394
0132-000,2016,2,5,3,87,101,188,252
0132-000,2016,2,5,4,68,85,153,188
0132-000,2016,2,5,5,82,90,172,153
0132-000,2016,2,5,6,200,115,315,172
0132-000,2016,2,5,7,335,352,687,315
0132-000,2016,2,5,8,614,1510,2124,687
0132-000,2016,2,5,9,844,1506,2350,2124
0132-000,2016,2,5,10,837,890,1727,2350
0132-000,2016,2,5,11,793,793,1586,1727
0132-000,2016,2,5,12,916,950,1866,1586
0132-000,2016,2,5,13,884,875,1759,1866
0132-000,2016,2,5,14,925,979,1904,1759
0132-000,2016,2,5,15,1048,1080,2128,1904
0132-000,2016,2,5,16,1098,1026,2124,2128
0132-000,2016,2,5,17,1233,1130,2363,2124
0132-000,2016,2,5,18,1488,1235,2723,2363
0132-000,2016,2,5,19,1493,1121,2614,2723
0132-000,2016,2,5,20,959,908,1867,2614
0132-000,2016,2,5,21,678,683,1361,1867
0132-000,2016,2,5,22,523,590,1113,1361
0132-000,2016,2,5,23,367,421,788,1113
0132-000,2016,2,5,24,216,227,443,788
0132-000,2016,2,6,1,183,204,387,443
0132-000,2016,2,6,2,128,134,262,387
0132-000,2016,2,6,3,101,151,252,262
0132-000,2016,2,6,4,91,101,192,252
0132-000,2016,2,6,5,81,135,216,192
0132-000,2016,2,6,6,130,226,356,216
0132-000,2016,2,6,7,188,463,651,356
0132-000,2016,2,6,8,316,802,1118,651
0132-000,2016,2,6,9,466,1040,1506,1118
0132-000,2016,2,6,10,581,1058,1639,1506
0132-000,2016,2,6,11,610,1175,1785,1639
0132-000,2016,2,6,12,742,1131,1873,1785
0132-000,2016,2,6,13,804,1134,1938,1873
0132-000,2016,2,6,14,749,1100,1849,1938
0132-000,2016,2,6,15,775,1165,1940,1849
0132-000,2016,2,6,16,726,1191,1917,1940
0132-000,2016,2,6,17,767,1139,1906,1917
0132-000,2016,2,6,18,811,1039,1850,1906
0132-000,2016,2,6,19,729,846,1575,1850
0132-000,2016,2,6,20,533,658,1191,1575
0132-000,2016,2,6,21,425,470,895,1191
0132-000,2016,2,6,22,347,398,745,895
0132-000,2016,2,6,23,246,312,558,745
0132-000,2016,2,6,24,177,228,405,558
0132-000,2016,2,7,1,124,196,320,405
0132-000,2016,2,7,2,114,134,248,320
0132-000,2016,2,7,3,76,107,183,248
0132-000,2016,2,7,4,65,99,164,183
0132-000,2016,2,7,5,74,103,177,164
0132-000,2016,2,7,6,86,178,264,177
0132-000,2016,2,7,7,110,333,443,264
0132-000,2016,2,7,8,160,439,599,443
0132-000,2016,2,7,9,290,706,996,599
0132-000,2016,2,7,10,416,692,1108,996
0132-000,2016,2,7,11,593,892,1485,1108
0132-000,2016,2,7,12,624,940,1564,1485
0132-000,2016,2,7,13,630,961,1591,1564
0132-000,2016,2,7,14,607,917,1524,1591
0132-000,2016,2,7,15,605,1010,1615,1524
0132-000,2016,2,7,16,602,957,1559,1615
0132-000,2016,2,7,17,543,862,1405,1559
0132-000,2016,2,7,18,544,788,1332,1405
0132-000,2016,2,7,19,461,574,1035,1332
0132-000,2016,2,7,20,380,380,760,1035
0132-000,2016,2,7,21,318,329,647,760
0132-000,2016,2,7,22,272,234,506,647
0132-000,2016,2,7,23,192,193,385,506
0132-000,2016,2,7,24,108,133,241,385
0132-000,2016,2,8,1,75,98,173,241
0132-000,2016,2,8,2,55,84,139,173
0132-000,2016,2,8,3,47,62,109,139
0132-000,2016,2,8,4,34,33,67,109
0132-000,2016,2,8,5,37,33,70,67
0132-000,2016,2,8,6,63,81,144,70
0132-000,2016,2,8,7,173,233,406,144
0132-000,2016,2,8,8,323,657,980,406
0132-000,2016,2,8,9,389,688,1077,980
0132-000,2016,2,8,10,421,503,924,1077
0132-000,2016,2,8,11,807,912,1719,924
0132-000,2016,2,8,12,1411,1373,2784,1719
0132-000,2016,2,8,13,1975,1622,3597,2784
0132-000,2016,2,8,14,2266,1730,3996,3597
0132-000,2016,2,8,15,2252,1938,4190,3996
0132-000,2016,2,8,16,2196,1915,4111,4190
0132-000,2016,2,8,17,2208,1993,4201,4111
0132-000,2016,2,8,18,2171,2000,4171,4201
0132-000,2016,2,8,19,2183,1731,3914,4171
0132-000,2016,2,8,20,2171,919,3090,3914
0132-000,2016,2,8,21,1806,588,2394,3090
0132-000,2016,2,8,22,2192,343,2535,2394
0132-000,2016,2,8,23,1522,251,1773,2535
0132-000,2016,2,8,24,983,214,1197,1773
0132-000,2016,2,9,1,554,121,675,1197
0132-000,2016,2,9,2,450,86,536,675
0132-000,2016,2,9,3,137,54,191,536
0132-000,2016,2,9,4,78,43,121,191
0132-000,2016,2,9,5,49,51,100,121
0132-000,2016,2,9,6,67,48,115,100
0132-000,2016,2,9,7,106,69,175,115
0132-000,2016,2,9,8,222,146,368,175
0132-000,2016,2,9,9,571,220,791,368
0132-000,2016,2,9,10,649,300,949,791
0132-000,2016,2,9,11,926,473,1399,949
0132-000,2016,2,9,12,1177,682,1859,1399
0132-000,2016,2,9,13,1670,669,2339,1859
0132-000,2016,2,9,14,1615,640,2255,2339
0132-000,2016,2,9,15,1913,637,2550,2255
0132-000,2016,2,9,16,1834,592,2426,2550
0132-000,2016,2,9,17,2279,585,2864,2426
0132-000,2016,2,9,18,2153,513,2666,2864
0132-000,2016,2,9,19,2105,474,2579,2666
0132-000,2016,2,9,20,1755,398,2153,2579
0132-000,2016,2,9,21,1851,391,2242,2153
0132-000,2016,2,9,22,1624,291,1915,2242
0132-000,2016,2,9,23,1625,268,1893,1915
0132-000,2016,2,9,24,1173,200,1373,1893
0132-000,2016,2,10,1,720,145,865,1373
0132-000,2016,2,10,2,361,109,470,865
0132-000,2016,2,10,3,155,77,232,470
0132-000,2016,2,10,4,84,73,157,232
0132-000,2016,2,10,5,80,73,153,157
0132-000,2016,2,10,6,70,58,128,153
0132-000,2016,2,10,7,122,147,269,128
0132-000,2016,2,10,8,225,328,553,269
0132-000,2016,2,10,9,305,437,742,553
0132-000,2016,2,10,10,388,428,816,742
0132-000,2016,2,10,11,553,554,1107,816
0132-000,2016,2,10,12,668,648,1316,1107
0132-000,2016,2,10,13,787,626,1413,1316
0132-000,2016,2,10,14,891,648,1539,1413
0132-000,2016,2,10,15,1049,707,1756,1539
0132-000,2016,2,10,16,1106,665,1771,1756
0132-000,2016,2,10,17,1090,626,1716,1771
0132-000,2016,2,10,18,1102,588,1690,1716
0132-000,2016,2,10,19,993,564,1557,1690
0132-000,2016,2,10,20,726,483,1209,1557
0132-000,2016,2,10,21,574,396,970,1209
0132-000,2016,2,10,22,407,328,735,970
0132-000,2016,2,10,23,264,259,523,735
0132-000,2016,2,10,24,182,171,353,523
0132-000,2016,2,11,1,126,135,261,353
0132-000,2016,2,11,2,95,93,188,261
0132-000,2016,2,11,3,58,62,120,188
0132-000,2016,2,11,4,47,75,122,120
0132-000,2016,2,11,5,66,62,128,122
0132-000,2016,2,11,6,182,117,299,128
0132-000,2016,2,11,7,335,379,714,299
0132-000,2016,2,11,8,561,1393,1954,714
0132-000,2016,2,11,9,701,1480,2181,1954
0132-000,2016,2,11,10,664,739,1403,2181
0132-000,2016,2,11,11,735,789,1524,1403
0132-000,2016,2,11,12,769,736,1505,1524
0132-000,2016,2,11,13,722,750,1472,1505
0132-000,2016,2,11,14,922,897,1819,1472
0132-000,2016,2,11,15,890,841,1731,1819
0132-000,2016,2,11,16,894,791,1685,1731
0132-000,2016,2,11,17,916,743,1659,1685
0132-000,2016,2,11,18,1175,801,1976,1659
0132-000,2016,2,11,19,1314,794,2108,1976
0132-000,2016,2,11,20,877,605,1482,2108
0132-000,2016,2,11,21,696,477,1173,1482
0132-000,2016,2,11,22,475,363,838,1173
0132-000,2016,2,11,23,317,292,609,838
0132-000,2016,2,11,24,222,181,403,609
0132-000,2016,2,12,1,134,148,282,403
0132-000,2016,2,12,2,91,87,178,282
0132-000,2016,2,12,3,66,76,142,178
0132-000,2016,2,12,4,75,85,160,142
0132-000,2016,2,12,5,72,67,139,160
0132-000,2016,2,12,6,157,108,265,139
0132-000,2016,2,12,7,262,359,621,265
0132-000,2016,2,12,8,522,1396,1918,621
0132-000,2016,2,12,9,761,1385,2146,1918
0132-000,2016,2,12,10,706,732,1438,2146
0132-000,2016,2,12,11,689,808,1497,1438
0132-000,2016,2,12,12,787,819,1606,1497
0132-000,2016,2,12,13,712,803,1515,1606
0132-000,2016,2,12,14,800,785,1585,1515
0132-000,2016,2,12,15,844,807,1651,1585
0132-000,2016,2,12,16,841,745,1586,1651
0132-000,2016,2,12,17,902,684,1586,1586
0132-000,2016,2,12,18,1209,777,1986,1586
0132-000,2016,2,12,19,1491,773,2264,1986
0132-000,2016,2,12,20,926,646,1572,2264
0132-000,2016,2,12,21,707,509,1216,1572
0132-000,2016,2,12,22,571,431,1002,1216
0132-000,2016,2,12,23,332,313,645,1002
0132-000,2016,2,12,24,219,222,441,645
0132-000,2016,2,13,1,179,179,358,441
0132-000,2016,2,13,2,112,115,227,358
0132-000,2016,2,13,3,86,102,188,227
0132-000,2016,2,13,4,84,94,178,188
0132-000,2016,2,13,5,105,89,194,178
0132-000,2016,2,13,6,143,95,238,194
0132-000,2016,2,13,7,229,205,434,238
0132-000,2016,2,13,8,365,591,956,434
0132-000,2016,2,13,9,543,828,1371,956
0132-000,2016,2,13,10,635,787,1422,1371
0132-000,2016,2,13,11,740,768,1508,1422
0132-000,2016,2,13,12,774,842,1616,1508
0132-000,2016,2,13,13,811,759,1570,1616
0132-000,2016,2,13,14,790,765,1555,1570
0132-000,2016,2,13,15,846,830,1676,1555
0132-000,2016,2,13,16,914,778,1692,1676
0132-000,2016,2,13,17,927,824,1751,1692
0132-000,2016,2,13,18,1114,762,1876,1751
0132-000,2016,2,13,19,971,695,1666,1876
0132-000,2016,2,13,20,661,528,1189,1666
0132-000,2016,2,13,21,478,421,899,1189
0132-000,2016,2,13,22,373,349,722,899
0132-000,2016,2,13,23,280,279,559,722
0132-000,2016,2,13,24,167,201,368,559
0132-000,2016,2,14,1,143,173,316,368
0132-000,2016,2,14,2,118,111,229,316
0132-000,2016,2,14,3,102,94,196,229
0132-000,2016,2,14,4,67,72,139,196
0132-000,2016,2,14,5,70,66,136,139
0132-000,2016,2,14,6,137,90,227,136
0132-000,2016,2,14,7,174,148,322,227
0132-000,2016,2,14,8,209,262,471,322
0132-000,2016,2,14,9,332,409,741,471
0132-000,2016,2,14,10,341,456,797,741
0132-000,2016,2,14,11,500,551,1051,797
0132-000,2016,2,14,12,539,549,1088,1051
0132-000,2016,2,14,13,597,582,1179,1088
0132-000,2016,2,14,14,641,684,1325,1179
0132-000,2016,2,14,15,704,640,1344,1325
0132-000,2016,2,14,16,772,656,1428,1344
0132-000,2016,2,14,17,857,651,1508,1428
0132-000,2016,2,14,18,799,660,1459,1508
0132-000,2016,2,14,19,726,548,1274,1459
0132-000,2016,2,14,20,497,432,929,1274
0132-000,2016,2,14,21,417,377,794,929
0132-000,2016,2,14,22,339,334,673,794
0132-000,2016,2,14,23,211,252,463,673
0132-000,2016,2,14,24,145,141,286,463
0132-000,2016,2,15,1,114,121,235,286
0132-000,2016,2,15,2,51,70,121,235
0132-000,2016,2,15,3,54,64,118,121
0132-000,2016,2,15,4,50,58,108,118
0132-000,2016,2,15,5,59,61,120,108
0132-000,2016,2,15,6,223,128,351,120
0132-000,2016,2,15,7,330,463,793,351
0132-000,2016,2,15,8,611,1658,2269,793
0132-000,2016,2,15,9,792,1496,2288,2269
0132-000,2016,2,15,10,689,854,1543,2288
0132-000,2016,2,15,11,754,866,1620,1543
0132-000,2016,2,15,12,810,818,1628,1620
0132-000,2016,2,15,13,818,809,1627,1628
0132-000,2016,2,15,14,809,773,1582,1627
0132-000,2016,2,15,15,879,820,1699,1582
0132-000,2016,2,15,16,948,826,1774,1699
0132-000,2016,2,15,17,879,802,1681,1774
0132-000,2016,2,15,18,1137,894,2031,1681
0132-000,2016,2,15,19,1366,828,2194,2031
0132-000,2016,2,15,20,880,576,1456,2194
0132-000,2016,2,15,21,827,437,1264,1456
0132-000,2016,2,15,22,551,410,961,1264
0132-000,2016,2,15,23,312,282,594,961
0132-000,2016,2,15,24,232,190,422,594
0132-000,2016,2,16,1,136,120,256,422
0132-000,2016,2,16,2,100,87,187,256
0132-000,2016,2,16,3,78,75,153,187
0132-000,2016,2,16,4,66,78,144,153
0132-000,2016,2,16,5,76,74,150,144
0132-000,2016,2,16,6,198,108,306,150
0132-000,2016,2,16,7,327,355,682,306
0132-000,2016,2,16,8,549,1481,2030,682
0132-000,2016,2,16,9,780,1443,2223,2030
0132-000,2016,2,16,10,698,845,1543,2223
0132-000,2016,2,16,11,779,828,1607,1543
0132-000,2016,2,16,12,803,823,1626,1607
0132-000,2016,2,16,13,789,699,1488,1626
0132-000,2016,2,16,14,882,761,1643,1488
0132-000,2016,2,16,15,832,784,1616,1643
0132-000,2016,2,16,16,902,757,1659,1616
0132-000,2016,2,16,17,899,817,1716,1659
0132-000,2016,2,16,18,1173,785,1958,1716
0132-000,2016,2,16,19,1356,769,2125,1958
0132-000,2016,2,16,20,834,571,1405,2125
0132-000,2016,2,16,21,750,494,1244,1405
0132-000,2016,2,16,22,528,360,888,1244
0132-000,2016,2,16,23,340,298,638,888
0132-000,2016,2,16,24,226,184,410,638
0132-000,2016,2,17,1,158,132,290,410
0132-000,2016,2,17,2,108,92,200,290
0132-000,2016,2,17,3,76,94,170,200
0132-000,2016,2,17,4,65,76,141,170
0132-000,2016,2,17,5,85,87,172,141
0132-000,2016,2,17,6,216,118,334,172
0132-000,2016,2,17,7,326,384,710,334
0132-000,2016,2,17,8,614,1578,2192,710
0132-000,2016,2,17,9,808,1448,2256,2192
0132-000,2016,2,17,10,758,851,1609,2256
0132-000,2016,2,17,11,779,867,1646,1609
0132-000,2016,2,17,12,846,783,1629,1646
0132-000,2016,2,17,13,790,767,1557,1629
0132-000,2016,2,17,14,829,853,1682,1557
0132-000,2016,2,17,15,888,840,1728,1682
0132-000,2016,2,17,16,993,783,1776,1728
0132-000,2016,2,17,17,945,851,1796,1776
0132-000,2016,2,17,18,1257,859,2116,1796
0132-000,2016,2,17,19,1477,837,2314,2116
0132-000,2016,2,17,20,920,651,1571,2314
0132-000,2016,2,17,21,713,535,1248,1571
0132-000,2016,2,17,22,543,410,953,1248
0132-000,2016,2,17,23,377,321,698,953
0132-000,2016,2,17,24,226,215,441,698
0132-000,2016,2,18,1,164,164,328,441
0132-000,2016,2,18,2,93,104,197,328
0132-000,2016,2,18,3,92,105,197,197
0132-000,2016,2,18,4,85,91,176,197
0132-000,2016,2,18,5,72,78,150,176
0132-000,2016,2,18,6,233,111,344,150
0132-000,2016,2,18,7,347,400,747,344
0132-000,2016,2,18,8,624,1581,2205,747
0132-000,2016,2,18,9,831,1547,2378,2205
0132-000,2016,2,18,10,785,853,1638,2378
0132-000,2016,2,18,11,762,901,1663,1638
0132-000,2016,2,18,12,848,855,1703,1663
0132-000,2016,2,18,13,805,825,1630,1703
0132-000,2016,2,18,14,887,756,1643,1630
0132-000,2016,2,18,15,913,863,1776,1643
0132-000,2016,2,18,16,986,800,1786,1776
0132-000,2016,2,18,17,958,811,1769,1786
0132-000,2016,2,18,18,1183,841,2024,1769
0132-000,2016,2,18,19,1427,792,2219,2024
0132-000,2016,2,18,20,895,664,1559,2219
0132-000,2016,2,18,21,789,490,1279,1559
0132-000,2016,2,18,22,562,389,951,1279
0132-000,2016,2,18,23,345,310,655,951
0132-000,2016,2,18,24,208,202,410,655
0132-000,2016,2,19,1,179,180,359,410
0132-000,2016,2,19,2,114,93,207,359
0132-000,2016,2,19,3,92,102,194,207
0132-000,2016,2,19,4,63,79,142,194
0132-000,2016,2,19,5,71,103,174,142
0132-000,2016,2,19,6,242,105,347,174
0132-000,2016,2,19,7,360,401,761,347
0132-000,2016,2,19,8,600,1539,2139,761
0132-000,2016,2,19,9,781,1412,2193,2139
0132-000,2016,2,19,10,804,887,1691,2193
0132-000,2016,2,19,11,769,904,1673,1691
0132-000,2016,2,19,12,858,820,1678,1673
0132-000,2016,2,19,13,814,775,1589,1678
0132-000,2016,2,19,14,911,798,1709,1589
0132-000,2016,2,19,15,894,850,1744,1709
0132-000,2016,2,19,16,1019,835,1854,1744
0132-000,2016,2,19,17,1014,834,1848,1854
0132-000,2016,2,19,18,1367,886,2253,1848
0132-000,2016,2,19,19,1634,878,2512,2253
0132-000,2016,2,19,20,968,701,1669,2512
0132-000,2016,2,19,21,849,565,1414,1669
0132-000,2016,2,19,22,586,434,1020,1414
0132-000,2016,2,19,23,361,338,699,1020
0132-000,2016,2,19,24,273,242,515,699
0132-000,2016,2,20,1,228,182,410,515
0132-000,2016,2,20,2,148,146,294,410
0132-000,2016,2,20,3,104,115,219,294
0132-000,2016,2,20,4,85,101,186,219
0132-000,2016,2,20,5,88,98,186,186
0132-000,2016,2,20,6,199,113,312,186
0132-000,2016,2,20,7,319,271,590,312
0132-000,2016,2,20,8,477,690,1167,590
0132-000,2016,2,20,9,623,884,1507,1167
0132-000,2016,2,20,10,787,901,1688,1507
0132-000,2016,2,20,11,768,891,1659,1688
0132-000,2016,2,20,12,854,961,1815,1659
0132-000,2016,2,20,13,901,986,1887,1815
0132-000,2016,2,20,14,983,928,1911,1887
0132-000,2016,2,20,15,988,891,1879,1911
0132-000,2016,2,20,16,1029,937,1966,1879
0132-000,2016,2,20,17,1211,1015,2226,1966
0132-000,2016,2,20,18,1405,1034,2439,2226
0132-000,2016,2,20,19,1316,854,2170,2439
0132-000,2016,2,20,20,835,636,1471,2170
0132-000,2016,2,20,21,610,542,1152,1471
0132-000,2016,2,20,22,440,412,852,1152
0132-000,2016,2,20,23,336,315,651,852
0132-000,2016,2,20,24,244,247,491,651
0132-000,2016,2,21,1,179,158,337,491
0132-000,2016,2,21,2,133,117,250,337
0132-000,2016,2,21,3,94,86,180,250
0132-000,2016,2,21,4,90,88,178,180
0132-000,2016,2,21,5,64,65,129,178
0132-000,2016,2,21,6,159,89,248,129
0132-000,2016,2,21,7,207,171,378,248
0132-000,2016,2,21,8,187,312,499,378
0132-000,2016,2,21,9,354,484,838,499
0132-000,2016,2,21,10,420,560,980,838
0132-000,2016,2,21,11,575,667,1242,980
0132-000,2016,2,21,12,610,757,1367,1242
0132-000,2016,2,21,13,652,768,1420,1367
0132-000,2016,2,21,14,784,743,1527,1420
0132-000,2016,2,21,15,869,761,1630,1527
0132-000,2016,2,21,16,936,763,1699,1630
0132-000,2016,2,21,17,1059,773,1832,1699
0132-000,2016,2,21,18,1040,707,1747,1832
0132-000,2016,2,21,19,890,616,1506,1747
0132-000,2016,2,21,20,588,511,1099,1506
0132-000,2016,2,21,21,562,470,1032,1099
0132-000,2016,2,21,22,401,365,766,1032
0132-000,2016,2,21,23,237,245,482,766
0132-000,2016,2,21,24,161,166,327,482
0132-000,2016,2,22,1,114,116,230,327
0132-000,2016,2,22,2,58,76,134,230
0132-000,2016,2,22,3,52,60,112,134
0132-000,2016,2,22,4,59,65,124,112
0132-000,2016,2,22,5,74,68,142,124
0132-000,2016,2,22,6,210,142,352,142
0132-000,2016,2,22,7,400,477,877,352
0132-000,2016,2,22,8,650,1679,2329,877
0132-000,2016,2,22,9,820,1535,2355,2329
0132-000,2016,2,22,10,738,850,1588,2355
0132-000,2016,2,22,11,878,856,1734,1588
0132-000,2016,2,22,12,782,873,1655,1734
0132-000,2016,2,22,13,788,788,1576,1655
0132-000,2016,2,22,14,813,832,1645,1576
0132-000,2016,2,22,15,893,837,1730,1645
0132-000,2016,2,22,16,952,848,1800,1730
0132-000,2016,2,22,17,1029,802,1831,1800
0132-000,2016,2,22,18,1208,883,2091,1831
0132-000,2016,2,22,19,1352,824,2176,2091
0132-000,2016,2,22,20,890,619,1509,2176
0132-000,2016,2,22,21,795,482,1277,1509
0132-000,2016,2,22,22,562,415,977,1277
0132-000,2016,2,22,23,317,288,605,977
0132-000,2016,2,22,24,227,193,420,605
0132-000,2016,2,23,1,149,161,310,420
0132-000,2016,2,23,2,98,86,184,310
0132-000,2016,2,23,3,61,98,159,184
0132-000,2016,2,23,4,65,71,136,159
0132-000,2016,2,23,5,82,90,172,136
0132-000,2016,2,23,6,192,107,299,172
0132-000,2016,2,23,7,349,409,758,299
0132-000,2016,2,23,8,559,1571,2130,758
0132-000,2016,2,23,9,839,1422,2261,2130
0132-000,2016,2,23,10,796,856,1652,2261
0132-000,2016,2,23,11,838,847,1685,1652
0132-000,2016,2,23,12,791,929,1720,1685
0132-000,2016,2,23,13,774,796,1570,1720
0132-000,2016,2,23,14,864,807,1671,1570
0132-000,2016,2,23,15,936,863,1799,1671
0132-000,2016,2,23,16,991,837,1828,1799
0132-000,2016,2,23,17,950,781,1731,1828
0132-000,2016,2,23,18,1286,910,2196,1731
0132-000,2016,2,23,19,1289,823,2112,2196
0132-000,2016,2,23,20,974,620,1594,2112
0132-000,2016,2,23,21,795,490,1285,1594
0132-000,2016,2,23,22,558,421,979,1285
0132-000,2016,2,23,23,377,309,686,979
0132-000,2016,2,23,24,232,218,450,686
0132-000,2016,2,24,1,149,132,281,450
0132-000,2016,2,24,2,91,97,188,281
0132-000,2016,2,24,3,61,76,137,188
0132-000,2016,2,24,4,67,64,131,137
0132-000,2016,2,24,5,72,93,165,131
0132-000,2016,2,24,6,232,115,347,165
0132-000,2016,2,24,7,380,423,803,347
0132-000,2016,2,24,8,672,1602,2274,803
0132-000,2016,2,24,9,803,1585,2388,2274
0132-000,2016,2,24,10,819,876,1695,2388
0132-000,2016,2,24,11,826,859,1685,1695
0132-000,2016,2,24,12,825,826,1651,1685
0132-000,2016,2,24,13,810,757,1567,1651
0132-000,2016,2,24,14,830,829,1659,1567
0132-000,2016,2,24,15,907,809,1716,1659
0132-000,2016,2,24,16,961,833,1794,1716
0132-000,2016,2,24,17,941,817,1758,1794
0132-000,2016,2,24,18,1351,919,2270,1758
0132-000,2016,2,24,19,1423,863,2286,2270
0132-000,2016,2,24,20,944,665,1609,2286
0132-000,2016,2,24,21,738,526,1264,1609
0132-000,2016,2,24,22,544,418,962,1264
0132-000,2016,2,24,23,376,351,727,962
0132-000,2016,2,24,24,232,209,441,727
0132-000,2016,2,25,1,163,173,336,441
0132-000,2016,2,25,2,108,107,215,336
0132-000,2016,2,25,3,69,87,156,215
0132-000,2016,2,25,4,78,87,165,156
0132-000,2016,2,25,5,68,86,154,165
0132-000,2016,2,25,6,229,120,349,154
0132-000,2016,2,25,7,382,393,775,349
0132-000,2016,2,25,8,598,1616,2214,775
0132-000,2016,2,25,9,827,1444,2271,2214
0132-000,2016,2,25,10,774,909,1683,2271
0132-000,2016,2,25,11,845,1005,1850,1683
0132-000,2016,2,25,12,834,818,1652,1850
0132-000,2016,2,25,13,833,792,1625,1652
0132-000,2016,2,25,14,882,793,1675,1625
0132-000,2016,2,25,15,1000,856,1856,1675
0132-000,2016,2,25,16,926,817,1743,1856
0132-000,2016,2,25,17,917,766,1683,1743
0132-000,2016,2,25,18,1286,907,2193,1683
0132-000,2016,2,25,19,1412,865,2277,2193
0132-000,2016,2,25,20,945,719,1664,2277
0132-000,2016,2,25,21,783,509,1292,1664
0132-000,2016,2,25,22,593,408,1001,1292
0132-000,2016,2,25,23,407,328,735,1001
0132-000,2016,2,25,24,279,228,507,735
0132-000,2016,2,26,1,169,186,355,507
0132-000,2016,2,26,2,120,100,220,355
0132-000,2016,2,26,3,74,76,150,220
0132-000,2016,2,26,4,83,94,177,150
0132-000,2016,2,26,5,81,83,164,177
0132-000,2016,2,26,6,209,114,323,164
0132-000,2016,2,26,7,396,431,827,323
0132-000,2016,2,26,8,623,1585,2208,827
0132-000,2016,2,26,9,851,1435,2286,2208
0132-000,2016,2,26,10,799,901,1700,2286
0132-000,2016,2,26,11,743,876,1619,1700
0132-000,2016,2,26,12,865,886,1751,1619
0132-000,2016,2,26,13,818,782,1600,1751
0132-000,2016,2,26,14,896,831,1727,1600
0132-000,2016,2,26,15,996,892,1888,1727
0132-000,2016,2,26,16,989,875,1864,1888
0132-000,2016,2,26,17,978,848,1826,1864
0132-000,2016,2,26,18,1466,922,2388,1826
0132-000,2016,2,26,19,1759,892,2651,2388
0132-000,2016,2,26,20,1080,830,1910,2651
0132-000,2016,2,26,21,870,558,1428,1910
0132-000,2016,2,26,22,607,456,1063,1428
0132-000,2016,2,26,23,415,374,789,1063
0132-000,2016,2,26,24,230,212,442,789
0132-000,2016,2,27,1,203,221,424,442
0132-000,2016,2,27,2,142,128,270,424
0132-000,2016,2,27,3,105,113,218,270
0132-000,2016,2,27,4,82,86,168,218
0132-000,2016,2,27,5,100,100,200,168
0132-000,2016,2,27,6,195,122,317,200
0132-000,2016,2,27,7,321,261,582,317
0132-000,2016,2,27,8,418,657,1075,582
0132-000,2016,2,27,9,666,864,1530,1075
0132-000,2016,2,27,10,762,891,1653,1530
0132-000,2016,2,27,11,765,975,1740,1653
0132-000,2016,2,27,12,926,1178,2104,1740
0132-000,2016,2,27,13,934,1079,2013,2104
0132-000,2016,2,27,14,913,1030,1943,2013
0132-000,2016,2,27,15,964,1005,1969,1943
0132-000,2016,2,27,16,1045,1002,2047,1969
0132-000,2016,2,27,17,1191,895,2086,2047
0132-000,2016,2,27,18,1443,1025,2468,2086
0132-000,2016,2,27,19,1299,850,2149,2468
0132-000,2016,2,27,20,859,653,1512,2149
0132-000,2016,2,27,21,681,509,1190,1512
0132-000,2016,2,27,22,485,390,875,1190
0132-000,2016,2,27,23,361,322,683,875
0132-000,2016,2,27,24,200,211,411,683
0132-000,2016,2,28,1,180,210,390,411
0132-000,2016,2,28,2,127,150,277,390
0132-000,2016,2,28,3,105,82,187,277
0132-000,2016,2,28,4,62,93,155,187
0132-000,2016,2,28,5,74,69,143,155
0132-000,2016,2,28,6,132,81,213,143
0132-000,2016,2,28,7,188,168,356,213
0132-000,2016,2,28,8,241,303,544,356
0132-000,2016,2,28,9,367,435,802,544
0132-000,2016,2,28,10,426,512,938,802
0132-000,2016,2,28,11,512,627,1139,938
0132-000,2016,2,28,12,609,662,1271,1139
0132-000,2016,2,28,13,798,733,1531,1271
0132-000,2016,2,28,14,766,774,1540,1531
0132-000,2016,2,28,15,859,818,1677,1540
0132-000,2016,2,28,16,959,901,1860,1677
0132-000,2016,2,28,17,839,796,1635,1860
0132-000,2016,2,28,18,869,1006,1875,1635
0132-000,2016,2,28,19,869,993,1862,1875
0132-000,2016,2,28,20,746,918,1664,1862
0132-000,2016,2,28,21,642,863,1505,1664
0132-000,2016,2,28,22,603,324,927,1505
0132-000,2016,2,28,23,456,184,640,927
0132-000,2016,2,28,24,233,145,378,640
0132-000,2016,2,29,1,106,123,229,378
0132-000,2016,2,29,2,52,67,119,229
0132-000,2016,2,29,3,36,46,82,119
0132-000,2016,2,29,4,26,39,65,82
0132-000,2016,2,29,5,46,53,99,65
0132-000,2016,2,29,6,147,91,238,99
0132-000,2016,2,29,7,254,356,610,238
0132-000,2016,2,29,8,482,1482,1964,610
0132-000,2016,2,29,9,661,1290,1951,1964
0132-000,2016,2,29,10,632,718,1350,1951
0132-000,2016,2,29,11,743,800,1543,1350
0132-000,2016,2,29,12,775,825,1600,1543
0132-000,2016,2,29,13,800,807,1607,1600
0132-000,2016,2,29,14,814,809,1623,1607
0132-000,2016,2,29,15,917,803,1720,1623
0132-000,2016,2,29,16,978,782,1760,1720
0132-000,2016,2,29,17,926,794,1720,1760
0132-000,2016,2,29,18,1245,852,2097,1720
0132-000,2016,2,29,19,1390,792,2182,2097
0132-000,2016,2,29,20,908,697,1605,2182
0132-000,2016,2,29,21,771,512,1283,1605
0132-000,2016,2,29,22,615,437,1052,1283
0132-000,2016,2,29,23,357,321,678,1052
0132-000,2016,2,29,24,249,235,484,678
0132-000,2016,3,1,1,170,164,334,484
0132-000,2016,3,1,2,131,121,252,334
0132-000,2016,3,1,3,97,103,200,252
0132-000,2016,3,1,4,70,102,172,200
0132-000,2016,3,1,5,83,85,168,172
0132-000,2016,3,1,6,200,108,308,168
0132-000,2016,3,1,7,270,227,497,308
0132-000,2016,3,1,8,393,630,1023,497
0132-000,2016,3,1,9,494,697,1191,1023
0132-000,2016,3,1,10,535,661,1196,1191
0132-000,2016,3,1,11,593,837,1430,1196
0132-000,2016,3,1,12,723,931,1654,1430
0132-000,2016,3,1,13,764,928,1692,1654
0132-000,2016,3,1,14,843,863,1706,1692
0132-000,2016,3,1,15,920,886,1806,1706
0132-000,2016,3,1,16,1018,913,1931,1806
0132-000,2016,3,1,17,1128,847,1975,1931
0132-000,2016,3,1,18,1444,801,2245,1975
0132-000,2016,3,1,19,1217,690,1907,2245
0132-000,2016,3,1,20,880,588,1468,1907
0132-000,2016,3,1,21,602,426,1028,1468
0132-000,2016,3,1,22,453,350,803,1028
0132-000,2016,3,1,23,263,263,526,803
0132-000,2016,3,1,24,170,163,333,526
0132-000,2016,3,2,1,122,126,248,333
0132-000,2016,3,2,2,62,66,128,248
0132-000,2016,3,2,3,42,52,94,128
0132-000,2016,3,2,4,51,47,98,94
0132-000,2016,3,2,5,64,74,138,98
0132-000,2016,3,2,6,226,127,353,138
0132-000,2016,3,2,7,393,457,850,353
0132-000,2016,3,2,8,694,1730,2424,850
0132-000,2016,3,2,9,819,1583,2402,2424
0132-000,2016,3,2,10,823,891,1714,2402
0132-000,2016,3,2,11,816,902,1718,1714
0132-000,2016,3,2,12,827,855,1682,1718
0132-000,2016,3,2,13,779,798,1577,1682
0132-000,2016,3,2,14,819,884,1703,1577
0132-000,2016,3,2,15,850,849,1699,1703
0132-000,2016,3,2,16,915,802,1717,1699
0132-000,2016,3,2,17,978,851,1829,1717
0132-000,2016,3,2,18,1256,858,2114,1829
0132-000,2016,3,2,19,1406,794,2200,2114
0132-000,2016,3,2,20,963,728,1691,2200
0132-000,2016,3,2,21,817,519,1336,1691
0132-000,2016,3,2,22,604,402,1006,1336
0132-000,2016,3,2,23,437,303,740,1006
0132-000,2016,3,2,24,225,212,437,740
0132-000,2016,3,3,1,165,139,304,437
0132-000,2016,3,3,2,117,104,221,304
0132-000,2016,3,3,3,75,85,160,221
0132-000,2016,3,3,4,61,82,143,160
0132-000,2016,3,3,5,75,85,160,143
0132-000,2016,3,3,6,258,127,385,160
0132-000,2016,3,3,7,385,442,827,385
0132-000,2016,3,3,8,613,1647,2260,827
0132-000,2016,3,3,9,910,1588,2498,2260
0132-000,2016,3,3,10,829,909,1738,2498
0132-000,2016,3,3,11,834,931,1765,1738
0132-000,2016,3,3,12,838,835,1673,1765
0132-000,2016,3,3,13,784,792,1576,1673
0132-000,2016,3,3,14,817,785,1602,1576
0132-000,2016,3,3,15,868,889,1757,1602
0132-000,2016,3,3,16,953,849,1802,1757
0132-000,2016,3,3,17,997,788,1785,1802
0132-000,2016,3,3,18,1209,924,2133,1785
0132-000,2016,3,3,19,1489,809,2298,2133
0132-000,2016,3,3,20,939,707,1646,2298
0132-000,2016,3,3,21,870,504,1374,1646
0132-000,2016,3,3,22,586,449,1035,1374
0132-000,2016,3,3,23,367,349,716,1035
0132-000,2016,3,3,24,237,212,449,716
0132-000,2016,3,4,1,196,181,377,449
0132-000,2016,3,4,2,125,103,228,377
0132-000,2016,3,4,3,81,94,175,228
0132-000,2016,3,4,4,87,76,163,175
0132-000,2016,3,4,5,76,89,165,163
0132-000,2016,3,4,6,222,130,352,165
0132-000,2016,3,4,7,402,413,815,352
0132-000,2016,3,4,8,623,1658,2281,815
0132-000,2016,3,4,9,806,1515,2321,2281
0132-000,2016,3,4,10,761,870,1631,2321
0132-000,2016,3,4,11,797,858,1655,1631
0132-000,2016,3,4,12,823,838,1661,1655
0132-000,2016,3,4,13,769,753,1522,1661
0132-000,2016,3,4,14,885,865,1750,1522
0132-000,2016,3,4,15,926,878,1804,1750
0132-000,2016,3,4,16,944,809,1753,1804
0132-000,2016,3,4,17,1032,813,1845,1753
0132-000,2016,3,4,18,1358,981,2339,1845
0132-000,2016,3,4,19,1705,880,2585,2339
0132-000,2016,3,4,20,1224,787,2011,2585
0132-000,2016,3,4,21,803,630,1433,2011
0132-000,2016,3,4,22,666,477,1143,1433
0132-000,2016,3,4,23,410,421,831,1143
0132-000,2016,3,4,24,251,272,523,831
0132-000,2016,3,5,1,197,222,419,523
0132-000,2016,3,5,2,163,133,296,419
0132-000,2016,3,5,3,121,121,242,296
0132-000,2016,3,5,4,83,95,178,242
0132-000,2016,3,5,5,77,97,174,178
0132-000,2016,3,5,6,158,102,260,174
0132-000,2016,3,5,7,261,211,472,260
0132-000,2016,3,5,8,401,646,1047,472
0132-000,2016,3,5,9,644,874,1518,1047
0132-000,2016,3,5,10,701,838,1539,1518
0132-000,2016,3,5,11,832,937,1769,1539
0132-000,2016,3,5,12,826,1128,1954,1769
0132-000,2016,3,5,13,929,1040,1969,1954
0132-000,2016,3,5,14,875,860,1735,1969
0132-000,2016,3,5,15,905,895,1800,1735
0132-000,2016,3,5,16,936,855,1791,1800
0132-000,2016,3,5,17,1034,845,1879,1791
0132-000,2016,3,5,18,1277,857,2134,1879
0132-000,2016,3,5,19,1195,828,2023,2134
0132-000,2016,3,5,20,781,606,1387,2023
0132-000,2016,3,5,21,532,469,1001,1387
0132-000,2016,3,5,22,416,357,773,1001
0132-000,2016,3,5,23,322,312,634,773
0132-000,2016,3,5,24,213,193,406,634
0132-000,2016,3,6,1,136,185,321,406
0132-000,2016,3,6,2,114,124,238,321
0132-000,2016,3,6,3,94,96,190,238
0132-000,2016,3,6,4,84,80,164,190
0132-000,2016,3,6,5,82,61,143,164
0132-000,2016,3,6,6,126,94,220,143
0132-000,2016,3,6,7,186,180,366,220
0132-000,2016,3,6,8,238,342,580,366
0132-000,2016,3,6,9,356,562,918,580
0132-000,2016,3,6,10,431,548,979,918
0132-000,2016,3,6,11,550,620,1170,979
0132-000,2016,3,6,12,680,757,1437,1170
0132-000,2016,3,6,13,776,787,1563,1437
0132-000,2016,3,6,14,768,787,1555,1563
0132-000,2016,3,6,15,871,793,1664,1555
0132-000,2016,3,6,16,1018,865,1883,1664
0132-000,2016,3,6,17,976,794,1770,1883
0132-000,2016,3,6,18,1034,736,1770,1770
0132-000,2016,3,6,19,984,657,1641,1770
0132-000,2016,3,6,20,742,559,1301,1641
0132-000,2016,3,6,21,535,465,1000,1301
0132-000,2016,3,6,22,441,410,851,1000
0132-000,2016,3,6,23,307,292,599,851
0132-000,2016,3,6,24,196,191,387,599
0132-000,2016,3,7,1,112,135,247,387
0132-000,2016,3,7,2,79,91,170,247
0132-000,2016,3,7,3,61,66,127,170
0132-000,2016,3,7,4,45,63,108,127
0132-000,2016,3,7,5,72,72,144,108
0132-000,2016,3,7,6,257,129,386,144
0132-000,2016,3,7,7,431,539,970,386
0132-000,2016,3,7,8,666,1728,2394,970
0132-000,2016,3,7,9,860,1639,2499,2394
0132-000,2016,3,7,10,792,920,1712,2499
0132-000,2016,3,7,11,807,886,1693,1712
0132-000,2016,3,7,12,869,895,1764,1693
0132-000,2016,3,7,13,767,800,1567,1764
0132-000,2016,3,7,14,857,862,1719,1567
0132-000,2016,3,7,15,934,834,1768,1719
0132-000,2016,3,7,16,1045,811,1856,1768
0132-000,2016,3,7,17,985,807,1792,1856
0132-000,2016,3,7,18,1168,870,2038,1792
0132-000,2016,3,7,19,1381,823,2204,2038
0132-000,2016,3,7,20,922,668,1590,2204
0132-000,2016,3,7,21,820,546,1366,1590
0132-000,2016,3,7,22,616,408,1024,1366
0132-000,2016,3,7,23,367,326,693,1024
0132-000,2016,3,7,24,238,182,420,693
0132-000,2016,3,8,1,165,138,303,420
0132-000,2016,3,8,2,96,89,185,303
0132-000,2016,3,8,3,71,80,151,185
0132-000,2016,3,8,4,68,87,155,151
0132-000,2016,3,8,5,78,80,158,155
0132-000,2016,3,8,6,220,148,368,158
0132-000,2016,3,8,7,417,450,867,368
0132-000,2016,3,8,8,687,1652,2339,867
0132-000,2016,3,8,9,848,1588,2436,2339
0132-000,2016,3,8,10,832,941,1773,2436
0132-000,2016,3,8,11,817,835,1652,1773
0132-000,2016,3,8,12,785,787,1572,1652
0132-000,2016,3,8,13,724,807,1531,1572
0132-000,2016,3,8,14,801,763,1564,1531
0132-000,2016,3,8,15,865,853,1718,1564
0132-000,2016,3,8,16,984,755,1739,1718
0132-000,2016,3,8,17,961,808,1769,1739
0132-000,2016,3,8,18,1244,848,2092,1769
0132-000,2016,3,8,19,1369,849,2218,2092
0132-000,2016,3,8,20,871,642,1513,2218
0132-000,2016,3,8,21,822,514,1336,1513
0132-000,2016,3,8,22,631,409,1040,1336
0132-000,2016,3,8,23,431,308,739,1040
0132-000,2016,3,8,24,237,185,422,739
0132-000,2016,3,9,1,160,156,316,422
0132-000,2016,3,9,2,97,91,188,316
0132-000,2016,3,9,3,59,82,141,188
0132-000,2016,3,9,4,81,86,167,141
0132-000,2016,3,9,5,90,87,177,167
0132-000,2016,3,9,6,209,114,323,177
0132-000,2016,3,9,7,394,455,849,323
0132-000,2016,3,9,8,678,1616,2294,849
0132-000,2016,3,9,9,834,1543,2377,2294
0132-000,2016,3,9,10,841,929,1770,2377
0132-000,2016,3,9,11,781,859,1640,1770
0132-000,2016,3,9,12,799,805,1604,1640
0132-000,2016,3,9,13,755,709,1464,1604
0132-000,2016,3,9,14,800,793,1593,1464
0132-000,2016,3,9,15,899,794,1693,1593
0132-000,2016,3,9,16,913,766,1679,1693
0132-000,2016,3,9,17,935,835,1770,1679
0132-000,2016,3,9,18,1299,892,2191,1770
0132-000,2016,3,9,19,1557,864,2421,2191
0132-000,2016,3,9,20,913,694,1607,2421
0132-000,2016,3,9,21,747,542,1289,1607
0132-000,2016,3,9,22,581,412,993,1289
0132-000,2016,3,9,23,391,308,699,993
0132-000,2016,3,9,24,226,195,421,699
0132-000,2016,3,10,1,171,161,332,421
0132-000,2016,3,10,2,92,101,193,332
0132-000,2016,3,10,3,83,82,165,193
0132-000,2016,3,10,4,74,79,153,165
0132-000,2016,3,10,5,74,88,162,153
0132-000,2016,3,10,6,226,123,349,162
0132-000,2016,3,10,7,404,428,832,349
0132-000,2016,3,10,8,636,1634,2270,832
0132-000,2016,3,10,9,835,1568,2403,2270
0132-000,2016,3,10,10,796,894,1690,2403
0132-000,2016,3,10,11,823,869,1692,1690
0132-000,2016,3,10,12,781,812,1593,1692
0132-000,2016,3,10,13,791,736,1527,1593
0132-000,2016,3,10,14,866,781,1647,1527
0132-000,2016,3,10,15,877,851,1728,1647
0132-000,2016,3,10,16,959,823,1782,1728
0132-000,2016,3,10,17,962,825,1787,1782
0132-000,2016,3,10,18,1126,856,1982,1787
0132-000,2016,3,10,19,1453,914,2367,1982
0132-000,2016,3,10,20,943,673,1616,2367
0132-000,2016,3,10,21,896,545,1441,1616
0132-000,2016,3,10,22,655,454,1109,1441
0132-000,2016,3,10,23,383,339,722,1109
0132-000,2016,3,10,24,250,247,497,722
0132-000,2016,3,11,1,160,139,299,497
0132-000,2016,3,11,2,127,105,232,299
0132-000,2016,3,11,3,90,89,179,232
0132-000,2016,3,11,4,80,94,174,179
0132-000,2016,3,11,5,85,83,168,174
0132-000,2016,3,11,6,205,115,320,168
0132-000,2016,3,11,7,378,425,803,320
0132-000,2016,3,11,8,667,1579,2246,803
0132-000,2016,3,11,9,835,1520,2355,2246
0132-000,2016,3,11,10,819,930,1749,2355
0132-000,2016,3,11,11,844,894,1738,1749
0132-000,2016,3,11,12,786,872,1658,1738
0132-000,2016,3,11,13,757,784,1541,1658
0132-000,2016,3,11,14,887,795,1682,1541
0132-000,2016,3,11,15,944,915,1859,1682
0132-000,2016,3,11,16,986,774,1760,1859
0132-000,2016,3,11,17,964,863,1827,1760
0132-000,2016,3,11,18,1337,896,2233,1827
0132-000,2016,3,11,19,1730,959,2689,2233
0132-000,2016,3,11,20,1118,788,1906,2689
0132-000,2016,3,11,21,901,633,1534,1906
0132-000,2016,3,11,22,674,451,1125,1534
0132-000,2016,3,11,23,487,407,894,1125
0132-000,2016,3,11,24,282,270,552,894
0132-000,2016,3,12,1,222,199,421,552
0132-000,2016,3,12,2,149,122,271,421
0132-000,2016,3,12,3,107,114,221,271
0132-000,2016,3,12,4,111,107,218,221
0132-000,2016,3,12,5,91,117,208,218
0132-000,2016,3,12,6,215,143,358,208
0132-000,2016,3,12,7,330,296,626,358
0132-000,2016,3,12,8,495,746,1241,626
0132-000,2016,3,12,9,689,957,1646,1241
0132-000,2016,3,12,10,746,876,1622,1646
0132-000,2016,3,12,11,833,970,1803,1622
0132-000,2016,3,12,12,877,1057,1934,1803
0132-000,2016,3,12,13,959,968,1927,1934
0132-000,2016,3,12,14,907,938,1845,1927
0132-000,2016,3,12,15,926,902,1828,1845
0132-000,2016,3,12,16,938,838,1776,1828
0132-000,2016,3,12,17,1072,927,1999,1776
0132-000,2016,3,12,18,1282,1052,2334,1999
0132-000,2016,3,12,19,1161,819,1980,2334
0132-000,2016,3,12,20,734,655,1389,1980
0132-000,2016,3,12,21,621,530,1151,1389
0132-000,2016,3,12,22,463,366,829,1151
0132-000,2016,3,12,23,318,350,668,829
0132-000,2016,3,12,24,235,225,460,668
0132-000,2016,3,13,1,176,195,371,460
0132-000,2016,3,13,2,114,134,248,371
0132-000,2016,3,13,3,79,105,184,248
0132-000,2016,3,13,4,72,67,139,184
0132-000,2016,3,13,5,73,81,154,139
0132-000,2016,3,13,6,129,101,230,154
0132-000,2016,3,13,7,204,162,366,230
0132-000,2016,3,13,8,276,328,604,366
0132-000,2016,3,13,9,348,438,786,604
0132-000,2016,3,13,10,398,500,898,786
0132-000,2016,3,13,11,539,556,1095,898
0132-000,2016,3,13,12,621,661,1282,1095
0132-000,2016,3,13,13,719,634,1353,1282
0132-000,2016,3,13,14,693,671,1364,1353
0132-000,2016,3,13,15,814,732,1546,1364
0132-000,2016,3,13,16,861,671,1532,1546
0132-000,2016,3,13,17,1026,700,1726,1532
0132-000,2016,3,13,18,1162,731,1893,1726
0132-000,2016,3,13,19,1091,637,1728,1893
0132-000,2016,3,13,20,768,551,1319,1728
0132-000,2016,3,13,21,577,511,1088,1319
0132-000,2016,3,13,22,437,391,828,1088
0132-000,2016,3,13,23,253,280,533,828
0132-000,2016,3,13,24,142,170,312,533
0132-000,2016,3,14,1,119,111,230,312
0132-000,2016,3,14,2,64,81,145,230
0132-000,2016,3,14,3,46,51,97,145
0132-000,2016,3,14,4,51,65,116,97
0132-000,2016,3,14,5,65,75,140,116
0132-000,2016,3,14,6,253,146,399,140
0132-000,2016,3,14,7,435,555,990,399
0132-000,2016,3,14,8,697,1753,2450,990
0132-000,2016,3,14,9,837,1676,2513,2450
0132-000,2016,3,14,10,861,934,1795,2513
0132-000,2016,3,14,11,767,915,1682,1795
0132-000,2016,3,14,12,849,778,1627,1682
0132-000,2016,3,14,13,792,823,1615,1627
0132-000,2016,3,14,14,903,845,1748,1615
0132-000,2016,3,14,15,929,801,1730,1748
0132-000,2016,3,14,16,923,856,1779,1730
0132-000,2016,3,14,17,946,843,1789,1779
0132-000,2016,3,14,18,1262,901,2163,1789
0132-000,2016,3,14,19,1533,902,2435,2163
0132-000,2016,3,14,20,998,726,1724,2435
0132-000,2016,3,14,21,875,569,1444,1724
0132-000,2016,3,14,22,635,472,1107,1444
0132-000,2016,3,14,23,361,328,689,1107
0132-000,2016,3,14,24,230,200,430,689
0132-000,2016,3,15,1,157,145,302,430
0132-000,2016,3,15,2,117,98,215,302
0132-000,2016,3,15,3,67,76,143,215
0132-000,2016,3,15,4,74,88,162,143
0132-000,2016,3,15,5,84,89,173,162
0132-000,2016,3,15,6,222,130,352,173
0132-000,2016,3,15,7,399,444,843,352
0132-000,2016,3,15,8,689,1646,2335,843
0132-000,2016,3,15,9,833,1644,2477,2335
0132-000,2016,3,15,10,825,967,1792,2477
0132-000,2016,3,15,11,819,915,1734,1792
0132-000,2016,3,15,12,856,843,1699,1734
0132-000,2016,3,15,13,782,790,1572,1699
0132-000,2016,3,15,14,835,808,1643,1572
0132-000,2016,3,15,15,878,854,1732,1643
0132-000,2016,3,15,16,970,804,1774,1732
0132-000,2016,3,15,17,956,796,1752,1774
0132-000,2016,3,15,18,1301,909,2210,1752
0132-000,2016,3,15,19,1580,966,2546,2210
0132-000,2016,3,15,20,989,703,1692,2546
0132-000,2016,3,15,21,832,613,1445,1692
0132-000,2016,3,15,22,649,445,1094,1445
0132-000,2016,3,15,23,433,343,776,1094
0132-000,2016,3,15,24,267,220,487,776
0132-000,2016,3,16,1,177,152,329,487
0132-000,2016,3,16,2,115,97,212,329
0132-000,2016,3,16,3,74,102,176,212
0132-000,2016,3,16,4,68,79,147,176
0132-000,2016,3,16,5,97,93,190,147
0132-000,2016,3,16,6,226,148,374,190
0132-000,2016,3,16,7,430,467,897,374
0132-000,2016,3,16,8,686,1666,2352,897
0132-000,2016,3,16,9,853,1702,2555,2352
0132-000,2016,3,16,10,835,896,1731,2555
0132-000,2016,3,16,11,799,934,1733,1731
0132-000,2016,3,16,12,827,798,1625,1733
0132-000,2016,3,16,13,755,766,1521,1625
0132-000,2016,3,16,14,855,854,1709,1521
0132-000,2016,3,16,15,940,852,1792,1709
0132-000,2016,3,16,16,942,816,1758,1792
0132-000,2016,3,16,17,949,791,1740,1758
0132-000,2016,3,16,18,1392,925,2317,1740
0132-000,2016,3,16,19,1610,875,2485,2317
0132-000,2016,3,16,20,936,710,1646,2485
0132-000,2016,3,16,21,816,576,1392,1646
0132-000,2016,3,16,22,626,415,1041,1392
0132-000,2016,3,16,23,386,333,719,1041
0132-000,2016,3,16,24,237,218,455,719
0132-000,2016,3,17,1,193,168,361,455
0132-000,2016,3,17,2,111,87,198,361
0132-000,2016,3,17,3,77,87,164,198
0132-000,2016,3,17,4,77,89,166,164
0132-000,2016,3,17,5,89,92,181,166
0132-000,2016,3,17,6,238,139,377,181
0132-000,2016,3,17,7,403,458,861,377
0132-000,2016,3,17,8,645,1643,2288,861
0132-000,2016,3,17,9,894,1641,2535,2288
0132-000,2016,3,17,10,785,861,1646,2535
0132-000,2016,3,17,11,732,896,1628,1646
0132-000,2016,3,17,12,798,800,1598,1628
0132-000,2016,3,17,13,765,704,1469,1598
0132-000,2016,3,17,14,829,782,1611,1469
0132-000,2016,3,17,15,877,823,1700,1611
0132-000,2016,3,17,16,944,783,1727,1700
0132-000,2016,3,17,17,976,779,1755,1727
0132-000,2016,3,17,18,1253,833,2086,1755
0132-000,2016,3,17,19,1546,827,2373,2086
0132-000,2016,3,17,20,1202,671,1873,2373
0132-000,2016,3,17,21,784,561,1345,1873
0132-000,2016,3,17,22,642,450,1092,1345
0132-000,2016,3,17,23,416,316,732,1092
0132-000,2016,3,17,24,241,218,459,732
0132-000,2016,3,18,1,202,171,373,459
0132-000,2016,3,18,2,111,111,222,373
0132-000,2016,3,18,3,80,90,170,222
0132-000,2016,3,18,4,75,79,154,170
0132-000,2016,3,18,5,79,105,184,154
0132-000,2016,3,18,6,207,135,342,184
0132-000,2016,3,18,7,386,399,785,342
0132-000,2016,3,18,8,621,1564,2185,785
0132-000,2016,3,18,9,889,1582,2471,2185
0132-000,2016,3,18,10,781,908,1689,2471
0132-000,2016,3,18,11,818,852,1670,1689
0132-000,2016,3,18,12,806,843,1649,1670
0132-000,2016,3,18,13,790,755,1545,1649
0132-000,2016,3,18,14,856,853,1709,1545
0132-000,2016,3,18,15,903,850,1753,1709
0132-000,2016,3,18,16,960,850,1810,1753
0132-000,2016,3,18,17,992,868,1860,1810
0132-000,2016,3,18,18,1269,963,2232,1860
0132-000,2016,3,18,19,1781,882,2663,2232
0132-000,2016,3,18,20,1108,761,1869,2663
0132-000,2016,3,18,21,908,639,1547,1869
0132-000,2016,3,18,22,663,487,1150,1547
0132-000,2016,3,18,23,451,404,855,1150
0132-000,2016,3,18,24,283,296,579,855
0132-000,2016,3,19,1,211,206,417,579
0132-000,2016,3,19,2,138,133,271,417
0132-000,2016,3,19,3,118,100,218,271
0132-000,2016,3,19,4,83,118,201,218
0132-000,2016,3,19,5,118,112,230,201
0132-000,2016,3,19,6,219,148,367,230
0132-000,2016,3,19,7,369,335,704,367
0132-000,2016,3,19,8,512,795,1307,704
0132-000,2016,3,19,9,677,980,1657,1307
0132-000,2016,3,19,10,791,988,1779,1657
0132-000,2016,3,19,11,826,1097,1923,1779
0132-000,2016,3,19,12,897,1098,1995,1923
0132-000,2016,3,19,13,900,1004,1904,1995
0132-000,2016,3,19,14,937,1047,1984,1904
0132-000,2016,3,19,15,921,983,1904,1984
0132-000,2016,3,19,16,1040,997,2037,1904
0132-000,2016,3,19,17,1164,986,2150,2037
0132-000,2016,3,19,18,1405,1002,2407,2150
0132-000,2016,3,19,19,1386,947,2333,2407
0132-000,2016,3,19,20,909,725,1634,2333
0132-000,2016,3,19,21,708,580,1288,1634
0132-000,2016,3,19,22,531,404,935,1288
0132-000,2016,3,19,23,377,365,742,935
0132-000,2016,3,19,24,233,267,500,742
0132-000,2016,3,20,1,180,190,370,500
0132-000,2016,3,20,2,137,149,286,370
0132-000,2016,3,20,3,89,98,187,286
0132-000,2016,3,20,4,87,88,175,187
0132-000,2016,3,20,5,82,74,156,175
0132-000,2016,3,20,6,151,92,243,156
0132-000,2016,3,20,7,222,198,420,243
0132-000,2016,3,20,8,297,358,655,420
0132-000,2016,3,20,9,388,496,884,655
0132-000,2016,3,20,10,489,603,1092,884
0132-000,2016,3,20,11,595,722,1317,1092
0132-000,2016,3,20,12,680,744,1424,1317
0132-000,2016,3,20,13,689,725,1414,1424
0132-000,2016,3,20,14,752,758,1510,1414
0132-000,2016,3,20,15,820,758,1578,1510
0132-000,2016,3,20,16,944,800,1744,1578
0132-000,2016,3,20,17,1099,782,1881,1744
0132-000,2016,3,20,18,1257,768,2025,1881
0132-000,2016,3,20,19,1210,711,1921,2025
0132-000,2016,3,20,20,898,575,1473,1921
0132-000,2016,3,20,21,671,498,1169,1473
0132-000,2016,3,20,22,473,397,870,1169
0132-000,2016,3,20,23,348,309,657,870
0132-000,2016,3,20,24,210,229,439,657
0132-000,2016,3,21,1,117,125,242,439
0132-000,2016,3,21,2,68,82,150,242
0132-000,2016,3,21,3,48,57,105,150
0132-000,2016,3,21,4,46,72,118,105
0132-000,2016,3,21,5,82,88,170,118
0132-000,2016,3,21,6,253,153,406,170
0132-000,2016,3,21,7,438,537,975,406
0132-000,2016,3,21,8,704,1767,2471,975
0132-000,2016,3,21,9,882,1699,2581,2471
0132-000,2016,3,21,10,808,1000,1808,2581
0132-000,2016,3,21,11,861,855,1716,1808
0132-000,2016,3,21,12,843,907,1750,1716
0132-000,2016,3,21,13,813,823,1636,1750
0132-000,2016,3,21,14,903,929,1832,1636
0132-000,2016,3,21,15,901,858,1759,1832
0132-000,2016,3,21,16,940,821,1761,1759
0132-000,2016,3,21,17,1016,820,1836,1761
0132-000,2016,3,21,18,1315,927,2242,1836
0132-000,2016,3,21,19,1567,903,2470,2242
0132-000,2016,3,21,20,979,708,1687,2470
0132-000,2016,3,21,21,809,579,1388,1687
0132-000,2016,3,21,22,617,414,1031,1388
0132-000,2016,3,21,23,375,304,679,1031
0132-000,2016,3,21,24,236,197,433,679
0132-000,2016,3,22,1,163,131,294,433
0132-000,2016,3,22,2,101,97,198,294
0132-000,2016,3,22,3,72,78,150,198
0132-000,2016,3,22,4,61,90,151,150
0132-000,2016,3,22,5,104,101,205,151
0132-000,2016,3,22,6,245,143,388,205
0132-000,2016,3,22,7,433,539,972,388
0132-000,2016,3,22,8,682,1792,2474,972
0132-000,2016,3,22,9,890,1529,2419,2474
0132-000,2016,3,22,10,865,939,1804,2419
0132-000,2016,3,22,11,889,939,1828,1804
0132-000,2016,3,22,12,757,841,1598,1828
0132-000,2016,3,22,13,838,773,1611,1598
0132-000,2016,3,22,14,894,820,1714,1611
0132-000,2016,3,22,15,927,854,1781,1714
0132-000,2016,3,22,16,973,800,1773,1781
0132-000,2016,3,22,17,1038,840,1878,1773
0132-000,2016,3,22,18,1277,969,2246,1878
0132-000,2016,3,22,19,1456,880,2336,2246
0132-000,2016,3,22,20,898,677,1575,2336
0132-000,2016,3,22,21,868,560,1428,1575
0132-000,2016,3,22,22,634,422,1056,1428
0132-000,2016,3,22,23,401,371,772,1056
0132-000,2016,3,22,24,247,205,452,772
0132-000,2016,3,23,1,158,135,293,452
0132-000,2016,3,23,2,96,99,195,293
0132-000,2016,3,23,3,82,83,165,195
0132-000,2016,3,23,4,72,88,160,165
0132-000,2016,3,23,5,90,88,178,160
0132-000,2016,3,23,6,261,154,415,178
0132-000,2016,3,23,7,474,525,999,415
0132-000,2016,3,23,8,688,1747,2435,999
0132-000,2016,3,23,9,881,1523,2404,2435
0132-000,2016,3,23,10,851,952,1803,2404
0132-000,2016,3,23,11,848,882,1730,1803
0132-000,2016,3,23,12,860,842,1702,1730
0132-000,2016,3,23,13,762,777,1539,1702
0132-000,2016,3,23,14,903,823,1726,1539
0132-000,2016,3,23,15,902,877,1779,1726
0132-000,2016,3,23,16,1001,824,1825,1779
0132-000,2016,3,23,17,987,849,1836,1825
0132-000,2016,3,23,18,1428,927,2355,1836
0132-000,2016,3,23,19,1531,851,2382,2355
0132-000,2016,3,23,20,902,710,1612,2382
0132-000,2016,3,23,21,791,544,1335,1612
0132-000,2016,3,23,22,603,430,1033,1335
0132-000,2016,3,23,23,370,350,720,1033
0132-000,2016,3,23,24,211,205,416,720
0132-000,2016,3,24,1,185,165,350,416
0132-000,2016,3,24,2,120,116,236,350
0132-000,2016,3,24,3,70,73,143,236
0132-000,2016,3,24,4,77,91,168,143
0132-000,2016,3,24,5,98,90,188,168
0132-000,2016,3,24,6,249,143,392,188
0132-000,2016,3,24,7,489,529,1018,392
0132-000,2016,3,24,8,716,1779,2495,1018
0132-000,2016,3,24,9,871,1502,2373,2495
0132-000,2016,3,24,10,826,913,1739,2373
0132-000,2016,3,24,11,838,879,1717,1739
0132-000,2016,3,24,12,765,852,1617,1717
0132-000,2016,3,24,13,742,730,1472,1617
0132-000,2016,3,24,14,878,846,1724,1472
0132-000,2016,3,24,15,939,902,1841,1724
0132-000,2016,3,24,16,994,884,1878,1841
0132-000,2016,3,24,17,962,886,1848,1878
0132-000,2016,3,24,18,1348,946,2294,1848
0132-000,2016,3,24,19,1466,884,2350,2294
0132-000,2016,3,24,20,955,672,1627,2350
0132-000,2016,3,24,21,836,547,1383,1627
0132-000,2016,3,24,22,559,433,992,1383
0132-000,2016,3,24,23,376,359,735,992
0132-000,2016,3,24,24,276,215,491,735
0132-000,2016,3,25,1,171,152,323,491
0132-000,2016,3,25,2,104,129,233,323
0132-000,2016,3,25,3,102,99,201,233
0132-000,2016,3,25,4,79,86,165,201
0132-000,2016,3,25,5,119,94,213,165
0132-000,2016,3,25,6,261,186,447,213
0132-000,2016,3,25,7,476,531,1007,447
0132-000,2016,3,25,8,717,1763,2480,1007
0132-000,2016,3,25,9,910,1486,2396,2480
0132-000,2016,3,25,10,814,862,1676,2396
0132-000,2016,3,25,11,841,913,1754,1676
0132-000,2016,3,25,12,853,871,1724,1754
0132-000,2016,3,25,13,832,787,1619,1724
0132-000,2016,3,25,14,869,858,1727,1619
0132-000,2016,3,25,15,952,926,1878,1727
0132-000,2016,3,25,16,1039,891,1930,1878
0132-000,2016,3,25,17,1154,883,2037,1930
0132-000,2016,3,25,18,1507,1085,2592,2037
0132-000,2016,3,25,19,1754,939,2693,2592
0132-000,2016,3,25,20,1102,861,1963,2693
0132-000,2016,3,25,21,891,628,1519,1963
0132-000,2016,3,25,22,629,541,1170,1519
0132-000,2016,3,25,23,459,365,824,1170
0132-000,2016,3,25,24,268,261,529,824
0132-000,2016,3,26,1,223,206,429,529
0132-000,2016,3,26,2,148,164,312,429
0132-000,2016,3,26,3,131,120,251,312
0132-000,2016,3,26,4,115,98,213,251
0132-000,2016,3,26,5,106,110,216,213
0132-000,2016,3,26,6,247,170,417,216
0132-000,2016,3,26,7,396,392,788,417
0132-000,2016,3,26,8,501,896,1397,788
0132-000,2016,3,26,9,759,974,1733,1397
0132-000,2016,3,26,10,775,940,1715,1733
0132-000,2016,3,26,11,803,1059,1862,1715
0132-000,2016,3,26,12,881,1102,1983,1862
0132-000,2016,3,26,13,965,1021,1986,1983
0132-000,2016,3,26,14,951,1053,2004,1986
0132-000,2016,3,26,15,1000,1062,2062,2004
0132-000,2016,3,26,16,1063,1040,2103,2062
0132-000,2016,3,26,17,1063,971,2034,2103
0132-000,2016,3,26,18,1379,1075,2454,2034
0132-000,2016,3,26,19,1259,935,2194,2454
0132-000,2016,3,26,20,886,657,1543,2194
0132-000,2016,3,26,21,626,534,1160,1543
0132-000,2016,3,26,22,486,384,870,1160
0132-000,2016,3,26,23,353,357,710,870
0132-000,2016,3,26,24,235,253,488,710
0132-000,2016,3,27,1,177,191,368,488
0132-000,2016,3,27,2,126,121,247,368
0132-000,2016,3,27,3,83,105,188,247
0132-000,2016,3,27,4,93,65,158,188
0132-000,2016,3,27,5,78,69,147,158
0132-000,2016,3,27,6,164,126,290,147
0132-000,2016,3,27,7,208,216,424,290
0132-000,2016,3,27,8,295,415,710,424
0132-000,2016,3,27,9,426,509,935,710
0132-000,2016,3,27,10,490,635,1125,935
0132-000,2016,3,27,11,631,640,1271,1125
0132-000,2016,3,27,12,687,652,1339,1271
0132-000,2016,3,27,13,743,686,1429,1339
0132-000,2016,3,27,14,795,735,1530,1429
0132-000,2016,3,27,15,931,803,1734,1530
0132-000,2016,3,27,16,1013,773,1786,1734
0132-000,2016,3,27,17,1100,770,1870,1786
0132-000,2016,3,27,18,1149,825,1974,1870
0132-000,2016,3,27,19,1163,646,1809,1974
0132-000,2016,3,27,20,862,547,1409,1809
0132-000,2016,3,27,21,681,494,1175,1409
0132-000,2016,3,27,22,483,396,879,1175
0132-000,2016,3,27,23,295,303,598,879
0132-000,2016,3,27,24,168,167,335,598
0132-000,2016,3,28,1,116,119,235,335
0132-000,2016,3,28,2,64,66,130,235
0132-000,2016,3,28,3,57,51,108,130
0132-000,2016,3,28,4,41,49,90,108
0132-000,2016,3,28,5,75,76,151,90
0132-000,2016,3,28,6,290,181,471,151
0132-000,2016,3,28,7,496,592,1088,471
0132-000,2016,3,28,8,716,1899,2615,1088
0132-000,2016,3,28,9,852,1529,2381,2615
0132-000,2016,3,28,10,816,918,1734,2381
0132-000,2016,3,28,11,828,854,1682,1734
0132-000,2016,3,28,12,828,909,1737,1682
0132-000,2016,3,28,13,813,809,1622,1737
0132-000,2016,3,28,14,856,866,1722,1622
0132-000,2016,3,28,15,940,911,1851,1722
0132-000,2016,3,28,16,994,1271,2265,1851
0132-000,2016,3,28,17,980,1484,2464,2265
0132-000,2016,3,28,18,1351,1179,2530,2464
0132-000,2016,3,28,19,1521,904,2425,2530
0132-000,2016,3,28,20,1042,716,1758,2425
0132-000,2016,3,28,21,862,553,1415,1758
0132-000,2016,3,28,22,620,425,1045,1415
0132-000,2016,3,28,23,373,329,702,1045
0132-000,2016,3,28,24,211,217,428,702
0132-000,2016,3,29,1,135,154,289,428
0132-000,2016,3,29,2,94,77,171,289
0132-000,2016,3,29,3,67,80,147,171
0132-000,2016,3,29,4,59,72,131,147
0132-000,2016,3,29,5,81,101,182,131
0132-000,2016,3,29,6,272,138,410,182
0132-000,2016,3,29,7,446,552,998,410
0132-000,2016,3,29,8,687,1807,2494,998
0132-000,2016,3,29,9,896,1554,2450,2494
0132-000,2016,3,29,10,841,955,1796,2450
0132-000,2016,3,29,11,862,892,1754,1796
0132-000,2016,3,29,12,844,776,1620,1754
0132-000,2016,3,29,13,710,783,1493,1620
0132-000,2016,3,29,14,823,874,1697,1493
0132-000,2016,3,29,15,922,828,1750,1697
0132-000,2016,3,29,16,928,862,1790,1750
0132-000,2016,3,29,17,1053,826,1879,1790
0132-000,2016,3,29,18,1250,900,2150,1879
0132-000,2016,3,29,19,1472,867,2339,2150
0132-000,2016,3,29,20,960,691,1651,2339
0132-000,2016,3,29,21,795,504,1299,1651
0132-000,2016,3,29,22,617,433,1050,1299
0132-000,2016,3,29,23,363,309,672,1050
0132-000,2016,3,29,24,220,218,438,672
0132-000,2016,3,30,1,185,134,319,438
0132-000,2016,3,30,2,93,88,181,319
0132-000,2016,3,30,3,77,88,165,181
0132-000,2016,3,30,4,60,96,156,165
0132-000,2016,3,30,5,93,75,168,156
0132-000,2016,3,30,6,257,148,405,168
0132-000,2016,3,30,7,450,553,1003,405
0132-000,2016,3,30,8,710,1749,2459,1003
0132-000,2016,3,30,9,880,1557,2437,2459
0132-000,2016,3,30,10,821,957,1778,2437
0132-000,2016,3,30,11,857,839,1696,1778
0132-000,2016,3,30,12,882,895,1777,1696
0132-000,2016,3,30,13,723,729,1452,1777
0132-000,2016,3,30,14,943,888,1831,1452
0132-000,2016,3,30,15,921,814,1735,1831
0132-000,2016,3,30,16,957,817,1774,1735
0132-000,2016,3,30,17,977,900,1877,1774
0132-000,2016,3,30,18,1389,932,2321,1877
0132-000,2016,3,30,19,1654,889,2543,2321
0132-000,2016,3,30,20,994,751,1745,2543
0132-000,2016,3,30,21,798,599,1397,1745
0132-000,2016,3,30,22,638,442,1080,1397
0132-000,2016,3,30,23,388,351,739,1080
0132-000,2016,3,30,24,225,212,437,739
0132-000,2016,3,31,1,189,167,356,437
0132-000,2016,3,31,2,116,102,218,356
0132-000,2016,3,31,3,74,80,154,218
0132-000,2016,3,31,4,77,90,167,154
0132-000,2016,3,31,5,94,91,185,167
0132-000,2016,3,31,6,244,141,385,185
0132-000,2016,3,31,7,446,494,940,385
0132-000,2016,3,31,8,681,1711,2392,940
0132-000,2016,3,31,9,883,1572,2455,2392
0132-000,2016,3,31,10,806,887,1693,2455
0132-000,2016,3,31,11,785,888,1673,1693
0132-000,2016,3,31,12,782,826,1608,1673
0132-000,2016,3,31,13,754,717,1471,1608
0132-000,2016,3,31,14,854,814,1668,1471
0132-000,2016,3,31,15,908,863,1771,1668
0132-000,2016,3,31,16,969,834,1803,1771
0132-000,2016,3,31,17,969,833,1802,1803
0132-000,2016,3,31,18,1301,890,2191,1802
0132-000,2016,3,31,19,1506,856,2362,2191
0132-000,2016,3,31,20,1079,672,1751,2362
0132-000,2016,3,31,21,810,554,1364,1751
0132-000,2016,3,31,22,601,442,1043,1364
0132-000,2016,3,31,23,396,338,734,1043
0132-000,2016,3,31,24,259,217,476,734
0132-000,2016,4,1,1,193,176,369,476
0132-000,2016,4,1,2,120,115,235,369
0132-000,2016,4,1,3,89,88,177,235
0132-000,2016,4,1,4,74,90,164,177
0132-000,2016,4,1,5,95,85,180,164
0132-000,2016,4,1,6,263,177,440,180
0132-000,2016,4,1,7,479,561,1040,440
0132-000,2016,4,1,8,695,1743,2438,1040
0132-000,2016,4,1,9,863,1520,2383,2438
0132-000,2016,4,1,10,844,898,1742,2383
0132-000,2016,4,1,11,841,888,1729,1742
0132-000,2016,4,1,12,879,827,1706,1729
0132-000,2016,4,1,13,808,823,1631,1706
0132-000,2016,4,1,14,917,858,1775,1631
0132-000,2016,4,1,15,972,958,1930,1775
0132-000,2016,4,1,16,1008,861,1869,1930
0132-000,2016,4,1,17,1092,903,1995,1869
0132-000,2016,4,1,18,1469,985,2454,1995
0132-000,2016,4,1,19,1760,1000,2760,2454
0132-000,2016,4,1,20,1182,854,2036,2760
0132-000,2016,4,1,21,860,625,1485,2036
0132-000,2016,4,1,22,606,515,1121,1485
0132-000,2016,4,1,23,414,416,830,1121
0132-000,2016,4,1,24,262,252,514,830
0132-000,2016,4,2,1,199,201,400,514
0132-000,2016,4,2,2,128,116,244,400
0132-000,2016,4,2,3,127,126,253,244
0132-000,2016,4,2,4,101,112,213,253
0132-000,2016,4,2,5,102,102,204,213
0132-000,2016,4,2,6,253,177,430,204
0132-000,2016,4,2,7,414,402,816,430
0132-000,2016,4,2,8,527,810,1337,816
0132-000,2016,4,2,9,749,1091,1840,1337
0132-000,2016,4,2,10,776,1182,1958,1840
0132-000,2016,4,2,11,836,1297,2133,1958
0132-000,2016,4,2,12,873,1555,2428,2133
0132-000,2016,4,2,13,914,1516,2430,2428
0132-000,2016,4,2,14,920,1297,2217,2430
0132-000,2016,4,2,15,1016,1192,2208,2217
0132-000,2016,4,2,16,1014,962,1976,2208
0132-000,2016,4,2,17,1092,908,2000,1976
0132-000,2016,4,2,18,1472,1018,2490,2000
0132-000,2016,4,2,19,1356,961,2317,2490
0132-000,2016,4,2,20,939,699,1638,2317
0132-000,2016,4,2,21,746,561,1307,1638
0132-000,2016,4,2,22,542,476,1018,1307
0132-000,2016,4,2,23,384,330,714,1018
0132-000,2016,4,2,24,218,256,474,714
0132-000,2016,4,3,1,183,180,363,474
0132-000,2016,4,3,2,110,130,240,363
0132-000,2016,4,3,3,99,97,196,240
0132-000,2016,4,3,4,67,84,151,196
0132-000,2016,4,3,5,74,79,153,151
0132-000,2016,4,3,6,153,109,262,153
0132-000,2016,4,3,7,212,232,444,262
0132-000,2016,4,3,8,283,382,665,444
0132-000,2016,4,3,9,405,536,941,665
0132-000,2016,4,3,10,451,665,1116,941
0132-000,2016,4,3,11,607,703,1310,1116
0132-000,2016,4,3,12,629,629,1258,1310
0132-000,2016,4,3,13,741,696,1437,1258
0132-000,2016,4,3,14,835,738,1573,1437
0132-000,2016,4,3,15,1054,743,1797,1573
0132-000,2016,4,3,16,1210,741,1951,1797
0132-000,2016,4,3,17,1550,737,2287,1951
0132-000,2016,4,3,18,1568,734,2302,2287
0132-000,2016,4,3,19,1583,596,2179,2302
0132-000,2016,4,3,20,1306,503,1809,2179
0132-000,2016,4,3,21,1137,471,1608,1809
0132-000,2016,4,3,22,829,387,1216,1608
0132-000,2016,4,3,23,477,296,773,1216
0132-000,2016,4,3,24,215,165,380,773
0132-000,2016,4,4,1,138,129,267,380
0132-000,2016,4,4,2,75,67,142,267
0132-000,2016,4,4,3,53,67,120,142
0132-000,2016,4,4,4,51,61,112,120
0132-000,2016,4,4,5,71,73,144,112
0132-000,2016,4,4,6,293,173,466,144
0132-000,2016,4,4,7,525,650,1175,466
0132-000,2016,4,4,8,706,1840,2546,1175
0132-000,2016,4,4,9,810,1546,2356,2546
0132-000,2016,4,4,10,848,942,1790,2356
0132-000,2016,4,4,11,830,905,1735,1790
0132-000,2016,4,4,12,832,856,1688,1735
0132-000,2016,4,4,13,797,794,1591,1688
0132-000,2016,4,4,14,855,866,1721,1591
0132-000,2016,4,4,15,878,834,1712,1721
0132-000,2016,4,4,16,992,822,1814,1712
0132-000,2016,4,4,17,988,801,1789,1814
0132-000,2016,4,4,18,1224,903,2127,1789
0132-000,2016,4,4,19,1540,877,2417,2127
0132-000,2016,4,4,20,962,710,1672,2417
0132-000,2016,4,4,21,844,553,1397,1672
0132-000,2016,4,4,22,640,463,1103,1397
0132-000,2016,4,4,23,352,329,681,1103
0132-000,2016,4,4,24,256,227,483,681
0132-000,2016,4,5,1,175,156,331,483
0132-000,2016,4,5,2,109,112,221,331
0132-000,2016,4,5,3,64,86,150,221
0132-000,2016,4,5,4,68,80,148,150
0132-000,2016,4,5,5,74,89,163,148
0132-000,2016,4,5,6,250,166,416,163
0132-000,2016,4,5,7,489,543,1032,416
0132-000,2016,4,5,8,709,1757,2466,1032
0132-000,2016,4,5,9,864,1570,2434,2466
0132-000,2016,4,5,10,893,987,1880,2434
0132-000,2016,4,5,11,845,955,1800,1880
0132-000,2016,4,5,12,836,979,1815,1800
0132-000,2016,4,5,13,887,899,1786,1815
0132-000,2016,4,5,14,903,899,1802,1786
0132-000,2016,4,5,15,1064,940,2004,1802
0132-000,2016,4,5,16,1034,871,1905,2004
0132-000,2016,4,5,17,1014,844,1858,1905
0132-000,2016,4,5,18,1276,988,2264,1858
0132-000,2016,4,5,19,1497,941,2438,2264
0132-000,2016,4,5,20,1062,693,1755,2438
0132-000,2016,4,5,21,850,556,1406,1755
0132-000,2016,4,5,22,702,463,1165,1406
0132-000,2016,4,5,23,460,352,812,1165
0132-000,2016,4,5,24,282,233,515,812
0132-000,2016,4,6,1,187,154,341,515
0132-000,2016,4,6,2,117,130,247,341
0132-000,2016,4,6,3,74,94,168,247
0132-000,2016,4,6,4,86,81,167,168
0132-000,2016,4,6,5,94,84,178,167
0132-000,2016,4,6,6,260,153,413,178
0132-000,2016,4,6,7,452,580,1032,413
0132-000,2016,4,6,8,705,1773,2478,1032
0132-000,2016,4,6,9,869,1602,2471,2478
0132-000,2016,4,6,10,835,945,1780,2471
0132-000,2016,4,6,11,889,936,1825,1780
0132-000,2016,4,6,12,839,991,1830,1825
0132-000,2016,4,6,13,753,816,1569,1830
0132-000,2016,4,6,14,846,840,1686,1569
0132-000,2016,4,6,15,1010,867,1877,1686
0132-000,2016,4,6,16,1029,865,1894,1877
0132-000,2016,4,6,17,1000,791,1791,1894
0132-000,2016,4,6,18,1369,913,2282,1791
0132-000,2016,4,6,19,1658,906,2564,2282
0132-000,2016,4,6,20,1032,682,1714,2564
0132-000,2016,4,6,21,780,560,1340,1714
0132-000,2016,4,6,22,618,437,1055,1340
0132-000,2016,4,6,23,369,330,699,1055
0132-000,2016,4,6,24,235,213,448,699
0132-000,2016,4,7,1,152,141,293,448
0132-000,2016,4,7,2,98,94,192,293
0132-000,2016,4,7,3,79,85,164,192
0132-000,2016,4,7,4,70,87,157,164
0132-000,2016,4,7,5,82,73,155,157
0132-000,2016,4,7,6,199,130,329,155
0132-000,2016,4,7,7,361,473,834,329
0132-000,2016,4,7,8,628,1671,2299,834
0132-000,2016,4,7,9,835,1518,2353,2299
0132-000,2016,4,7,10,789,929,1718,2353
0132-000,2016,4,7,11,837,821,1658,1718
0132-000,2016,4,7,12,827,814,1641,1658
0132-000,2016,4,7,13,808,749,1557,1641
0132-000,2016,4,7,14,873,826,1699,1557
0132-000,2016,4,7,15,943,831,1774,1699
0132-000,2016,4,7,16,911,814,1725,1774
0132-000,2016,4,7,17,996,811,1807,1725
0132-000,2016,4,7,18,1220,840,2060,1807
0132-000,2016,4,7,19,1506,846,2352,2060
0132-000,2016,4,7,20,966,679,1645,2352
0132-000,2016,4,7,21,837,586,1423,1645
0132-000,2016,4,7,22,625,413,1038,1423
0132-000,2016,4,7,23,369,362,731,1038
0132-000,2016,4,7,24,256,221,477,731
0132-000,2016,4,8,1,164,173,337,477
0132-000,2016,4,8,2,135,107,242,337
0132-000,2016,4,8,3,84,99,183,242
0132-000,2016,4,8,4,81,86,167,183
0132-000,2016,4,8,5,93,83,176,167
0132-000,2016,4,8,6,257,174,431,176
0132-000,2016,4,8,7,454,548,1002,431
0132-000,2016,4,8,8,700,1706,2406,1002
0132-000,2016,4,8,9,872,1555,2427,2406
0132-000,2016,4,8,10,830,936,1766,2427
0132-000,2016,4,8,11,854,876,1730,1766
0132-000,2016,4,8,12,850,882,1732,1730
0132-000,2016,4,8,13,835,830,1665,1732
0132-000,2016,4,8,14,896,909,1805,1665
0132-000,2016,4,8,15,969,906,1875,1805
0132-000,2016,4,8,16,1048,839,1887,1875
0132-000,2016,4,8,17,1023,899,1922,1887
0132-000,2016,4,8,18,1370,902,2272,1922
0132-000,2016,4,8,19,1772,976,2748,2272
0132-000,2016,4,8,20,1135,880,2015,2748
0132-000,2016,4,8,21,933,589,1522,2015
0132-000,2016,4,8,22,680,541,1221,1522
0132-000,2016,4,8,23,435,422,857,1221
0132-000,2016,4,8,24,316,280,596,857
0132-000,2016,4,9,1,210,203,413,596
0132-000,2016,4,9,2,145,149,294,413
0132-000,2016,4,9,3,110,112,222,294
0132-000,2016,4,9,4,86,129,215,222
0132-000,2016,4,9,5,118,106,224,215
0132-000,2016,4,9,6,255,178,433,224
0132-000,2016,4,9,7,410,442,852,433
0132-000,2016,4,9,8,541,827,1368,852
0132-000,2016,4,9,9,734,1020,1754,1368
0132-000,2016,4,9,10,753,1175,1928,1754
0132-000,2016,4,9,11,851,1268,2119,1928
0132-000,2016,4,9,12,945,1787,2732,2119
0132-000,2016,4,9,13,865,1541,2406,2732
0132-000,2016,4,9,14,844,1234,2078,2406
0132-000,2016,4,9,15,928,1122,2050,2078
0132-000,2016,4,9,16,959,962,1921,2050
0132-000,2016,4,9,17,1067,1015,2082,1921
0132-000,2016,4,9,18,1388,964,2352,2082
0132-000,2016,4,9,19,1388,875,2263,2352
0132-000,2016,4,9,20,854,614,1468,2263
0132-000,2016,4,9,21,721,536,1257,1468
0132-000,2016,4,9,22,519,439,958,1257
0132-000,2016,4,9,23,355,309,664,958
0132-000,2016,4,9,24,238,274,512,664
0132-000,2016,4,10,1,152,161,313,512
0132-000,2016,4,10,2,127,129,256,313
0132-000,2016,4,10,3,85,94,179,256
0132-000,2016,4,10,4,95,80,175,179
0132-000,2016,4,10,5,77,70,147,175
0132-000,2016,4,10,6,144,120,264,147
0132-000,2016,4,10,7,241,245,486,264
0132-000,2016,4,10,8,255,377,632,486
0132-000,2016,4,10,9,371,527,898,632
0132-000,2016,4,10,10,468,588,1056,898
0132-000,2016,4,10,11,555,677,1232,1056
0132-000,2016,4,10,12,579,686,1265,1232
0132-000,2016,4,10,13,704,688,1392,1265
0132-000,2016,4,10,14,783,690,1473,1392
0132-000,2016,4,10,15,885,728,1613,1473
0132-000,2016,4,10,16,965,697,1662,1613
0132-000,2016,4,10,17,1276,763,2039,1662
0132-000,2016,4,10,18,1549,768,2317,2039
0132-000,2016,4,10,19,1451,619,2070,2317
0132-000,2016,4,10,20,1008,511,1519,2070
0132-000,2016,4,10,21,871,515,1386,1519
0132-000,2016,4,10,22,631,396,1027,1386
0132-000,2016,4,10,23,387,312,699,1027
0132-000,2016,4,10,24,173,185,358,699
0132-000,2016,4,11,1,133,141,274,358
0132-000,2016,4,11,2,79,84,163,274
0132-000,2016,4,11,3,58,61,119,163
0132-000,2016,4,11,4,42,56,98,119
0132-000,2016,4,11,5,93,71,164,98
0132-000,2016,4,11,6,253,179,432,164
0132-000,2016,4,11,7,529,641,1170,432
0132-000,2016,4,11,8,711,1849,2560,1170
0132-000,2016,4,11,9,897,1668,2565,2560
0132-000,2016,4,11,10,874,1004,1878,2565
0132-000,2016,4,11,11,913,948,1861,1878
0132-000,2016,4,11,12,787,901,1688,1861
0132-000,2016,4,11,13,836,832,1668,1688
0132-000,2016,4,11,14,911,899,1810,1668
0132-000,2016,4,11,15,951,901,1852,1810
0132-000,2016,4,11,16,979,840,1819,1852
0132-000,2016,4,11,17,1038,843,1881,1819
0132-000,2016,4,11,18,1219,959,2178,1881
0132-000,2016,4,11,19,1502,879,2381,2178
0132-000,2016,4,11,20,1039,704,1743,2381
0132-000,2016,4,11,21,879,603,1482,1743
0132-000,2016,4,11,22,694,473,1167,1482
0132-000,2016,4,11,23,389,337,726,1167
0132-000,2016,4,11,24,244,190,434,726
0132-000,2016,4,12,1,161,156,317,434
0132-000,2016,4,12,2,109,110,219,317
0132-000,2016,4,12,3,81,108,189,219
0132-000,2016,4,12,4,65,81,146,189
0132-000,2016,4,12,5,100,95,195,146
0132-000,2016,4,12,6,271,166,437,195
0132-000,2016,4,12,7,523,561,1084,437
0132-000,2016,4,12,8,722,1779,2501,1084
0132-000,2016,4,12,9,924,1682,2606,2501
0132-000,2016,4,12,10,868,936,1804,2606
0132-000,2016,4,12,11,906,880,1786,1804
0132-000,2016,4,12,12,866,905,1771,1786
0132-000,2016,4,12,13,803,842,1645,1771
0132-000,2016,4,12,14,850,796,1646,1645
0132-000,2016,4,12,15,973,875,1848,1646
0132-000,2016,4,12,16,953,846,1799,1848
0132-000,2016,4,12,17,1039,873,1912,1799
0132-000,2016,4,12,18,1761,954,2715,1912
0132-000,2016,4,12,19,2030,958,2988,2715
0132-000,2016,4,12,20,1436,771,2207,2988
0132-000,2016,4,12,21,965,662,1627,2207
0132-000,2016,4,12,22,701,504,1205,1627
0132-000,2016,4,12,23,477,382,859,1205
0132-000,2016,4,12,24,297,267,564,859
0132-000,2016,4,13,1,198,180,378,564
0132-000,2016,4,13,2,174,151,325,378
0132-000,2016,4,13,3,97,114,211,325
0132-000,2016,4,13,4,94,106,200,211
0132-000,2016,4,13,5,98,91,189,200
0132-000,2016,4,13,6,149,131,280,189
0132-000,2016,4,13,7,321,293,614,280
0132-000,2016,4,13,8,514,827,1341,614
0132-000,2016,4,13,9,692,885,1577,1341
0132-000,2016,4,13,10,756,852,1608,1577
0132-000,2016,4,13,11,747,868,1615,1608
0132-000,2016,4,13,12,822,876,1698,1615
0132-000,2016,4,13,13,786,955,1741,1698
0132-000,2016,4,13,14,865,872,1737,1741
0132-000,2016,4,13,15,921,909,1830,1737
0132-000,2016,4,13,16,929,845,1774,1830
0132-000,2016,4,13,17,1022,802,1824,1774
0132-000,2016,4,13,18,1178,791,1969,1824
0132-000,2016,4,13,19,1047,781,1828,1969
0132-000,2016,4,13,20,763,603,1366,1828
0132-000,2016,4,13,21,586,518,1104,1366
0132-000,2016,4,13,22,520,424,944,1104
0132-000,2016,4,13,23,306,269,575,944
0132-000,2016,4,13,24,223,198,421,575
0132-000,2016,4,14,1,156,136,292,421
0132-000,2016,4,14,2,104,94,198,292
0132-000,2016,4,14,3,65,66,131,198
0132-000,2016,4,14,4,74,67,141,131
0132-000,2016,4,14,5,81,94,175,141
0132-000,2016,4,14,6,284,181,465,175
0132-000,2016,4,14,7,520,550,1070,465
0132-000,2016,4,14,8,736,1795,2531,1070
0132-000,2016,4,14,9,898,1649,2547,2531
0132-000,2016,4,14,10,764,895,1659,2547
0132-000,2016,4,14,11,791,844,1635,1659
0132-000,2016,4,14,12,819,838,1657,1635
0132-000,2016,4,14,13,755,748,1503,1657
0132-000,2016,4,14,14,802,826,1628,1503
0132-000,2016,4,14,15,895,885,1780,1628
0132-000,2016,4,14,16,917,770,1687,1780
0132-000,2016,4,14,17,922,840,1762,1687
0132-000,2016,4,14,18,1221,917,2138,1762
0132-000,2016,4,14,19,1527,904,2431,2138
0132-000,2016,4,14,20,1057,700,1757,2431
0132-000,2016,4,14,21,860,526,1386,1757
0132-000,2016,4,14,22,631,491,1122,1386
0132-000,2016,4,14,23,402,332,734,1122
0132-000,2016,4,14,24,234,210,444,734
0132-000,2016,4,15,1,186,157,343,444
0132-000,2016,4,15,2,89,117,206,343
0132-000,2016,4,15,3,70,92,162,206
0132-000,2016,4,15,4,70,80,150,162
0132-000,2016,4,15,5,95,90,185,150
0132-000,2016,4,15,6,257,144,401,185
0132-000,2016,4,15,7,461,539,1000,401
0132-000,2016,4,15,8,721,1749,2470,1000
0132-000,2016,4,15,9,949,1566,2515,2470
0132-000,2016,4,15,10,826,942,1768,2515
0132-000,2016,4,15,11,835,841,1676,1768
0132-000,2016,4,15,12,838,844,1682,1676
0132-000,2016,4,15,13,797,850,1647,1682
0132-000,2016,4,15,14,954,833,1787,1647
0132-000,2016,4,15,15,966,912,1878,1787
0132-000,2016,4,15,16,982,813,1795,1878
0132-000,2016,4,15,17,1002,870,1872,1795
0132-000,2016,4,15,18,1452,1006,2458,1872
0132-000,2016,4,15,19,1724,998,2722,2458
0132-000,2016,4,15,20,1284,823,2107,2722
0132-000,2016,4,15,21,942,666,1608,2107
0132-000,2016,4,15,22,681,533,1214,1608
0132-000,2016,4,15,23,420,448,868,1214
0132-000,2016,4,15,24,267,261,528,868
0132-000,2016,4,16,1,244,183,427,528
0132-000,2016,4,16,2,143,149,292,427
0132-000,2016,4,16,3,109,110,219,292
0132-000,2016,4,16,4,92,110,202,219
0132-000,2016,4,16,5,125,115,240,202
0132-000,2016,4,16,6,213,171,384,240
0132-000,2016,4,16,7,440,436,876,384
0132-000,2016,4,16,8,548,928,1476,876
0132-000,2016,4,16,9,722,1025,1747,1476
0132-000,2016,4,16,10,746,1034,1780,1747
0132-000,2016,4,16,11,852,1133,1985,1780
0132-000,2016,4,16,12,902,1198,2100,1985
0132-000,2016,4,16,13,936,1157,2093,2100
0132-000,2016,4,16,14,989,1047,2036,2093
0132-000,2016,4,16,15,1012,1031,2043,2036
0132-000,2016,4,16,16,1059,938,1997,2043
0132-000,2016,4,16,17,1236,982,2218,1997
0132-000,2016,4,16,18,1435,926,2361,2218
0132-000,2016,4,16,19,1328,777,2105,2361
0132-000,2016,4,16,20,986,549,1535,2105
0132-000,2016,4,16,21,665,456,1121,1535
0132-000,2016,4,16,22,445,361,806,1121
0132-000,2016,4,16,23,315,328,643,806
0132-000,2016,4,16,24,207,230,437,643
0132-000,2016,4,17,1,158,164,322,437
0132-000,2016,4,17,2,102,130,232,322
0132-000,2016,4,17,3,89,104,193,232
0132-000,2016,4,17,4,80,69,149,193
0132-000,2016,4,17,5,74,69,143,149
0132-000,2016,4,17,6,130,117,247,143
0132-000,2016,4,17,7,176,165,341,247
0132-000,2016,4,17,8,270,315,585,341
0132-000,2016,4,17,9,400,466,866,585
0132-000,2016,4,17,10,447,535,982,866
0132-000,2016,4,17,11,539,668,1207,982
0132-000,2016,4,17,12,604,739,1343,1207
0132-000,2016,4,17,13,664,716,1380,1343
0132-000,2016,4,17,14,749,773,1522,1380
0132-000,2016,4,17,15,826,812,1638,1522
0132-000,2016,4,17,16,953,778,1731,1638
0132-000,2016,4,17,17,1112,733,1845,1731
0132-000,2016,4,17,18,1298,763,2061,1845
0132-000,2016,4,17,19,1175,644,1819,2061
0132-000,2016,4,17,20,972,561,1533,1819
0132-000,2016,4,17,21,652,486,1138,1533
0132-000,2016,4,17,22,486,413,899,1138
0132-000,2016,4,17,23,322,296,618,899
0132-000,2016,4,17,24,188,169,357,618
0132-000,2016,4,18,1,99,130,229,357
0132-000,2016,4,18,2,83,100,183,229
0132-000,2016,4,18,3,55,53,108,183
0132-000,2016,4,18,4,53,73,126,108
0132-000,2016,4,18,5,75,87,162,126
0132-000,2016,4,18,6,248,171,419,162
0132-000,2016,4,18,7,517,618,1135,419
0132-000,2016,4,18,8,699,1918,2617,1135
0132-000,2016,4,18,9,918,1569,2487,2617
0132-000,2016,4,18,10,810,960,1770,2487
0132-000,2016,4,18,11,825,901,1726,1770
0132-000,2016,4,18,12,831,854,1685,1726
0132-000,2016,4,18,13,818,812,1630,1685
0132-000,2016,4,18,14,869,863,1732,1630
0132-000,2016,4,18,15,911,936,1847,1732
0132-000,2016,4,18,16,989,854,1843,1847
0132-000,2016,4,18,17,1048,856,1904,1843
0132-000,2016,4,18,18,1384,924,2308,1904
0132-000,2016,4,18,19,1553,876,2429,2308
0132-000,2016,4,18,20,992,708,1700,2429
0132-000,2016,4,18,21,807,473,1280,1700
0132-000,2016,4,18,22,563,426,989,1280
0132-000,2016,4,18,23,322,313,635,989
0132-000,2016,4,18,24,212,182,394,635
0132-000,2016,4,19,1,146,132,278,394
0132-000,2016,4,19,2,104,110,214,278
0132-000,2016,4,19,3,71,75,146,214
0132-000,2016,4,19,4,55,79,134,146
0132-000,2016,4,19,5,83,86,169,134
0132-000,2016,4,19,6,239,155,394,169
0132-000,2016,4,19,7,470,558,1028,394
0132-000,2016,4,19,8,719,1747,2466,1028
0132-000,2016,4,19,9,888,1590,2478,2466
0132-000,2016,4,19,10,833,941,1774,2478
0132-000,2016,4,19,11,787,860,1647,1774
0132-000,2016,4,19,12,833,873,1706,1647
0132-000,2016,4,19,13,748,785,1533,1706
0132-000,2016,4,19,14,897,796,1693,1533
0132-000,2016,4,19,15,944,885,1829,1693
0132-000,2016,4,19,16,923,821,1744,1829
0132-000,2016,4,19,17,992,803,1795,1744
0132-000,2016,4,19,18,1312,927,2239,1795
0132-000,2016,4,19,19,1516,903,2419,2239
0132-000,2016,4,19,20,1014,685,1699,2419
0132-000,2016,4,19,21,840,599,1439,1699
0132-000,2016,4,19,22,604,448,1052,1439
0132-000,2016,4,19,23,413,349,762,1052
0132-000,2016,4,19,24,290,215,505,762
0132-000,2016,4,20,1,180,160,340,505
0132-000,2016,4,20,2,127,113,240,340
0132-000,2016,4,20,3,86,83,169,240
0132-000,2016,4,20,4,64,84,148,169
0132-000,2016,4,20,5,75,78,153,148
0132-000,2016,4,20,6,258,159,417,153
0132-000,2016,4,20,7,490,520,1010,417
0132-000,2016,4,20,8,744,1791,2535,1010
0132-000,2016,4,20,9,919,1599,2518,2535
0132-000,2016,4,20,10,802,961,1763,2518
0132-000,2016,4,20,11,876,870,1746,1763
0132-000,2016,4,20,12,837,906,1743,1746
0132-000,2016,4,20,13,809,803,1612,1743
0132-000,2016,4,20,14,937,840,1777,1612
0132-000,2016,4,20,15,938,894,1832,1777
0132-000,2016,4,20,16,1026,811,1837,1832
0132-000,2016,4,20,17,1006,858,1864,1837
0132-000,2016,4,20,18,1326,907,2233,1864
0132-000,2016,4,20,19,1543,869,2412,2233
0132-000,2016,4,20,20,1001,734,1735,2412
0132-000,2016,4,20,21,781,569,1350,1735
0132-000,2016,4,20,22,661,437,1098,1350
0132-000,2016,4,20,23,359,322,681,1098
0132-000,2016,4,20,24,251,218,469,681
0132-000,2016,4,21,1,193,159,352,469
0132-000,2016,4,21,2,96,120,216,352
0132-000,2016,4,21,3,72,89,161,216
0132-000,2016,4,21,4,73,92,165,161
0132-000,2016,4,21,5,80,72,152,165
0132-000,2016,4,21,6,193,140,333,152
0132-000,2016,4,21,7,362,431,793,333
0132-000,2016,4,21,8,643,1628,2271,793
0132-000,2016,4,21,9,864,1582,2446,2271
0132-000,2016,4,21,10,778,941,1719,2446
0132-000,2016,4,21,11,773,813,1586,1719
0132-000,2016,4,21,12,763,844,1607,1586
0132-000,2016,4,21,13,792,809,1601,1607
0132-000,2016,4,21,14,870,817,1687,1601
0132-000,2016,4,21,15,958,895,1853,1687
0132-000,2016,4,21,16,1026,843,1869,1853
0132-000,2016,4,21,17,973,843,1816,1869
0132-000,2016,4,21,18,1209,877,2086,1816
0132-000,2016,4,21,19,1532,837,2369,2086
0132-000,2016,4,21,20,955,692,1647,2369
0132-000,2016,4,21,21,876,540,1416,1647
0132-000,2016,4,21,22,639,465,1104,1416
0132-000,2016,4,21,23,385,379,764,1104
0132-000,2016,4,21,24,273,245,518,764
0132-000,2016,4,22,1,197,161,358,518
0132-000,2016,4,22,2,125,124,249,358
0132-000,2016,4,22,3,93,85,178,249
0132-000,2016,4,22,4,65,75,140,178
0132-000,2016,4,22,5,97,90,187,140
0132-000,2016,4,22,6,266,163,429,187
0132-000,2016,4,22,7,452,528,980,429
0132-000,2016,4,22,8,684,1734,2418,980
0132-000,2016,4,22,9,922,1527,2449,2418
0132-000,2016,4,22,10,901,937,1838,2449
0132-000,2016,4,22,11,844,901,1745,1838
0132-000,2016,4,22,12,892,945,1837,1745
0132-000,2016,4,22,13,797,825,1622,1837
0132-000,2016,4,22,14,944,890,1834,1622
0132-000,2016,4,22,15,1003,911,1914,1834
0132-000,2016,4,22,16,1030,893,1923,1914
0132-000,2016,4,22,17,1133,909,2042,1923
0132-000,2016,4,22,18,1458,1008,2466,2042
0132-000,2016,4,22,19,1914,1078,2992,2466
0132-000,2016,4,22,20,1208,906,2114,2992
0132-000,2016,4,22,21,921,625,1546,2114
0132-000,2016,4,22,22,617,530,1147,1546
0132-000,2016,4,22,23,445,405,850,1147
0132-000,2016,4,22,24,273,294,567,850
0132-000,2016,4,23,1,211,224,435,567
0132-000,2016,4,23,2,166,165,331,435
0132-000,2016,4,23,3,106,98,204,331
0132-000,2016,4,23,4,99,120,219,204
0132-000,2016,4,23,5,107,110,217,219
0132-000,2016,4,23,6,262,174,436,217
0132-000,2016,4,23,7,465,430,895,436
0132-000,2016,4,23,8,570,824,1394,895
0132-000,2016,4,23,9,679,964,1643,1394
0132-000,2016,4,23,10,753,1007,1760,1643
0132-000,2016,4,23,11,856,1034,1890,1760
0132-000,2016,4,23,12,946,1237,2183,1890
0132-000,2016,4,23,13,964,1256,2220,2183
0132-000,2016,4,23,14,870,1118,1988,2220
0132-000,2016,4,23,15,963,1056,2019,1988
0132-000,2016,4,23,16,958,966,1924,2019
0132-000,2016,4,23,17,1039,1071,2110,1924
0132-000,2016,4,23,18,1431,1259,2690,2110
0132-000,2016,4,23,19,1377,1120,2497,2690
0132-000,2016,4,23,20,1124,710,1834,2497
0132-000,2016,4,23,21,676,584,1260,1834
0132-000,2016,4,23,22,565,432,997,1260
0132-000,2016,4,23,23,365,335,700,997
0132-000,2016,4,23,24,240,235,475,700
0132-000,2016,4,24,1,172,161,333,475
0132-000,2016,4,24,2,115,143,258,333
0132-000,2016,4,24,3,123,100,223,258
0132-000,2016,4,24,4,84,92,176,223
0132-000,2016,4,24,5,83,67,150,176
0132-000,2016,4,24,6,164,139,303,150
0132-000,2016,4,24,7,264,243,507,303
0132-000,2016,4,24,8,358,426,784,507
0132-000,2016,4,24,9,421,571,992,784
0132-000,2016,4,24,10,506,577,1083,992
0132-000,2016,4,24,11,618,681,1299,1083
0132-000,2016,4,24,12,711,650,1361,1299
0132-000,2016,4,24,13,758,643,1401,1361
0132-000,2016,4,24,14,794,660,1454,1401
0132-000,2016,4,24,15,817,707,1524,1454
0132-000,2016,4,24,16,1146,755,1901,1524
0132-000,2016,4,24,17,1448,736,2184,1901
0132-000,2016,4,24,18,1476,732,2208,2184
0132-000,2016,4,24,19,1552,662,2214,2208
0132-000,2016,4,24,20,1288,564,1852,2214
0132-000,2016,4,24,21,934,479,1413,1852
0132-000,2016,4,24,22,601,431,1032,1413
0132-000,2016,4,24,23,335,301,636,1032
0132-000,2016,4,24,24,185,197,382,636
0132-000,2016,4,25,1,121,148,269,382
0132-000,2016,4,25,2,86,88,174,269
0132-000,2016,4,25,3,58,66,124,174
0132-000,2016,4,25,4,65,63,128,124
0132-000,2016,4,25,5,74,76,150,128
0132-000,2016,4,25,6,288,189,477,150
0132-000,2016,4,25,7,564,660,1224,477
0132-000,2016,4,25,8,723,1875,2598,1224
0132-000,2016,4,25,9,805,1448,2253,2598
0132-000,2016,4,25,10,815,972,1787,2253
0132-000,2016,4,25,11,864,890,1754,1787
0132-000,2016,4,25,12,822,850,1672,1754
0132-000,2016,4,25,13,796,829,1625,1672
0132-000,2016,4,25,14,909,858,1767,1625
0132-000,2016,4,25,15,933,849,1782,1767
0132-000,2016,4,25,16,1024,884,1908,1782
0132-000,2016,4,25,17,988,819,1807,1908
0132-000,2016,4,25,18,1246,1028,2274,1807
0132-000,2016,4,25,19,1496,867,2363,2274
0132-000,2016,4,25,20,1084,725,1809,2363
0132-000,2016,4,25,21,883,605,1488,1809
0132-000,2016,4,25,22,700,481,1181,1488
0132-000,2016,4,25,23,397,348,745,1181
0132-000,2016,4,25,24,244,220,464,745
0132-000,2016,4,26,1,172,158,330,464
0132-000,2016,4,26,2,99,81,180,330
0132-000,2016,4,26,3,86,83,169,180
0132-000,2016,4,26,4,57,95,152,169
0132-000,2016,4,26,5,74,93,167,152
0132-000,2016,4,26,6,259,189,448,167
0132-000,2016,4,26,7,533,555,1088,448
0132-000,2016,4,26,8,713,1777,2490,1088
0132-000,2016,4,26,9,871,1627,2498,2490
0132-000,2016,4,26,10,898,975,1873,2498
0132-000,2016,4,26,11,865,893,1758,1873
0132-000,2016,4,26,12,860,906,1766,1758
0132-000,2016,4,26,13,795,802,1597,1766
0132-000,2016,4,26,14,903,841,1744,1597
0132-000,2016,4,26,15,983,903,1886,1744
0132-000,2016,4,26,16,1060,913,1973,1886
0132-000,2016,4,26,17,1040,891,1931,1973
0132-000,2016,4,26,18,1337,979,2316,1931
0132-000,2016,4,26,19,1542,871,2413,2316
0132-000,2016,4,26,20,1095,711,1806,2413
0132-000,2016,4,26,21,900,599,1499,1806
0132-000,2016,4,26,22,641,467,1108,1499
0132-000,2016,4,26,23,424,357,781,1108
0132-000,2016,4,26,24,275,210,485,781
0132-000,2016,4,27,1,177,159,336,485
0132-000,2016,4,27,2,129,120,249,336
0132-000,2016,4,27,3,95,113,208,249
0132-000,2016,4,27,4,72,83,155,208
0132-000,2016,4,27,5,81,96,177,155
0132-000,2016,4,27,6,246,149,395,177
0132-000,2016,4,27,7,508,541,1049,395
0132-000,2016,4,27,8,727,1764,2491,1049
0132-000,2016,4,27,9,915,1503,2418,2491
0132-000,2016,4,27,10,818,958,1776,2418
0132-000,2016,4,27,11,811,879,1690,1776
0132-000,2016,4,27,12,819,840,1659,1690
0132-000,2016,4,27,13,848,800,1648,1659
0132-000,2016,4,27,14,902,875,1777,1648
0132-000,2016,4,27,15,922,868,1790,1777
0132-000,2016,4,27,16,993,806,1799,1790
0132-000,2016,4,27,17,998,827,1825,1799
0132-000,2016,4,27,18,1348,904,2252,1825
0132-000,2016,4,27,19,1557,832,2389,2252
0132-000,2016,4,27,20,944,672,1616,2389
0132-000,2016,4,27,21,791,517,1308,1616
0132-000,2016,4,27,22,555,472,1027,1308
0132-000,2016,4,27,23,376,372,748,1027
0132-000,2016,4,27,24,217,200,417,748
0132-000,2016,4,28,1,174,176,350,417
0132-000,2016,4,28,2,110,115,225,350
0132-000,2016,4,28,3,89,79,168,225
0132-000,2016,4,28,4,82,85,167,168
0132-000,2016,4,28,5,113,114,227,167
0132-000,2016,4,28,6,251,164,415,227
0132-000,2016,4,28,7,509,568,1077,415
0132-000,2016,4,28,8,712,1769,2481,1077
0132-000,2016,4,28,9,912,1574,2486,2481
0132-000,2016,4,28,10,879,959,1838,2486
0132-000,2016,4,28,11,867,905,1772,1838
0132-000,2016,4,28,12,815,851,1666,1772
0132-000,2016,4,28,13,833,816,1649,1666
0132-000,2016,4,28,14,863,817,1680,1649
0132-000,2016,4,28,15,902,809,1711,1680
0132-000,2016,4,28,16,1011,843,1854,1711
0132-000,2016,4,28,17,1041,892,1933,1854
0132-000,2016,4,28,18,1281,936,2217,1933
0132-000,2016,4,28,19,1431,890,2321,2217
0132-000,2016,4,28,20,999,691,1690,2321
0132-000,2016,4,28,21,867,574,1441,1690
0132-000,2016,4,28,22,640,501,1141,1441
0132-000,2016,4,28,23,431,393,824,1141
0132-000,2016,4,28,24,242,253,495,824
0132-000,2016,4,29,1,189,190,379,495
0132-000,2016,4,29,2,105,135,240,379
0132-000,2016,4,29,3,88,99,187,240
0132-000,2016,4,29,4,73,92,165,187
0132-000,2016,4,29,5,91,121,212,165
0132-000,2016,4,29,6,276,166,442,212
0132-000,2016,4,29,7,500,573,1073,442
0132-000,2016,4,29,8,740,1771,2511,1073
0132-000,2016,4,29,9,927,1497,2424,2511
0132-000,2016,4,29,10,863,943,1806,2424
0132-000,2016,4,29,11,835,884,1719,1806
0132-000,2016,4,29,12,829,863,1692,1719
0132-000,2016,4,29,13,812,781,1593,1692
0132-000,2016,4,29,14,883,873,1756,1593
0132-000,2016,4,29,15,929,881,1810,1756
0132-000,2016,4,29,16,986,936,1922,1810
0132-000,2016,4,29,17,1056,1038,2094,1922
0132-000,2016,4,29,18,1425,1536,2961,2094
0132-000,2016,4,29,19,1730,1494,3224,2961
0132-000,2016,4,29,20,1199,1125,2324,3224
0132-000,2016,4,29,21,966,705,1671,2324
0132-000,2016,4,29,22,691,561,1252,1671
0132-000,2016,4,29,23,495,412,907,1252
0132-000,2016,4,29,24,262,290,552,907
0132-000,2016,4,30,1,197,206,403,552
0132-000,2016,4,30,2,138,155,293,403
0132-000,2016,4,30,3,125,125,250,293
0132-000,2016,4,30,4,92,114,206,250
0132-000,2016,4,30,5,133,128,261,206
0132-000,2016,4,30,6,247,191,438,261
0132-000,2016,4,30,7,433,448,881,438
0132-000,2016,4,30,8,569,923,1492,881
0132-000,2016,4,30,9,723,1033,1756,1492
0132-000,2016,4,30,10,780,1060,1840,1756
0132-000,2016,4,30,11,824,1158,1982,1840
0132-000,2016,4,30,12,854,1123,1977,1982
0132-000,2016,4,30,13,913,1179,2092,1977
0132-000,2016,4,30,14,866,1186,2052,2092
0132-000,2016,4,30,15,936,1125,2061,2052
0132-000,2016,4,30,16,950,1035,1985,2061
0132-000,2016,4,30,17,1139,1051,2190,1985
0132-000,2016,4,30,18,1346,1088,2434,2190
0132-000,2016,4,30,19,1377,1068,2445,2434
0132-000,2016,4,30,20,1081,698,1779,2445
0132-000,2016,4,30,21,739,567,1306,1779
0132-000,2016,4,30,22,550,459,1009,1306
0132-000,2016,4,30,23,405,364,769,1009
0132-000,2016,4,30,24,228,272,500,769
0132-000,2016,5,1,1,187,200,387,500
0132-000,2016,5,1,2,134,138,272,387
0132-000,2016,5,1,3,104,118,222,272
0132-000,2016,5,1,4,83,85,168,222
0132-000,2016,5,1,5,102,97,199,168
0132-000,2016,5,1,6,106,133,239,199
0132-000,2016,5,1,7,204,233,437,239
0132-000,2016,5,1,8,319,474,793,437
0132-000,2016,5,1,9,404,528,932,793
0132-000,2016,5,1,10,463,589,1052,932
0132-000,2016,5,1,11,625,666,1291,1052
0132-000,2016,5,1,12,571,667,1238,1291
0132-000,2016,5,1,13,711,729,1440,1238
0132-000,2016,5,1,14,716,775,1491,1440
0132-000,2016,5,1,15,829,737,1566,1491
0132-000,2016,5,1,16,917,779,1696,1566
0132-000,2016,5,1,17,1099,727,1826,1696
0132-000,2016,5,1,18,1318,694,2012,1826
0132-000,2016,5,1,19,1375,642,2017,2012
0132-000,2016,5,1,20,1034,559,1593,2017
0132-000,2016,5,1,21,884,522,1406,1593
0132-000,2016,5,1,22,620,448,1068,1406
0132-000,2016,5,1,23,327,318,645,1068
0132-000,2016,5,1,24,223,198,421,645
0132-000,2016,5,2,1,129,131,260,421
0132-000,2016,5,2,2,77,90,167,260
0132-000,2016,5,2,3,52,56,108,167
0132-000,2016,5,2,4,60,76,136,108
0132-000,2016,5,2,5,79,75,154,136
0132-000,2016,5,2,6,289,197,486,154
0132-000,2016,5,2,7,506,665,1171,486
0132-000,2016,5,2,8,730,1847,2577,1171
0132-000,2016,5,2,9,897,1555,2452,2577
0132-000,2016,5,2,10,822,990,1812,2452
0132-000,2016,5,2,11,903,870,1773,1812
0132-000,2016,5,2,12,848,896,1744,1773
0132-000,2016,5,2,13,856,864,1720,1744
0132-000,2016,5,2,14,889,846,1735,1720
0132-000,2016,5,2,15,874,894,1768,1735
0132-000,2016,5,2,16,1052,864,1916,1768
0132-000,2016,5,2,17,1045,894,1939,1916
0132-000,2016,5,2,18,1350,891,2241,1939
0132-000,2016,5,2,19,1534,863,2397,2241
0132-000,2016,5,2,20,907,677,1584,2397
0132-000,2016,5,2,21,824,557,1381,1584
0132-000,2016,5,2,22,594,445,1039,1381
0132-000,2016,5,2,23,367,301,668,1039
0132-000,2016,5,2,24,202,172,374,668
0132-000,2016,5,3,1,147,163,310,374
0132-000,2016,5,3,2,105,100,205,310
0132-000,2016,5,3,3,70,82,152,205
0132-000,2016,5,3,4,64,70,134,152
0132-000,2016,5,3,5,79,86,165,134
0132-000,2016,5,3,6,179,116,295,165
0132-000,2016,5,3,7,355,469,824,295
0132-000,2016,5,3,8,596,1658,2254,824
0132-000,2016,5,3,9,814,1545,2359,2254
0132-000,2016,5,3,10,769,856,1625,2359
0132-000,2016,5,3,11,708,794,1502,1625
0132-000,2016,5,3,12,792,751,1543,1502
0132-000,2016,5,3,13,742,804,1546,1543
0132-000,2016,5,3,14,812,832,1644,1546
0132-000,2016,5,3,15,824,761,1585,1644
0132-000,2016,5,3,16,849,785,1634,1585
0132-000,2016,5,3,17,945,799,1744,1634
0132-000,2016,5,3,18,1144,787,1931,1744
0132-000,2016,5,3,19,1412,834,2246,1931
0132-000,2016,5,3,20,882,633,1515,2246
0132-000,2016,5,3,21,834,512,1346,1515
0132-000,2016,5,3,22,662,425,1087,1346
0132-000,2016,5,3,23,415,328,743,1087
0132-000,2016,5,3,24,255,199,454,743
0132-000,2016,5,4,1,167,149,316,454
0132-000,2016,5,4,2,110,111,221,316
0132-000,2016,5,4,3,84,93,177,221
0132-000,2016,5,4,4,78,80,158,177
0132-000,2016,5,4,5,95,87,182,158
0132-000,2016,5,4,6,269,183,452,182
0132-000,2016,5,4,7,521,571,1092,452
0132-000,2016,5,4,8,698,1826,2524,1092
0132-000,2016,5,4,9,900,1562,2462,2524
0132-000,2016,5,4,10,850,960,1810,2462
0132-000,2016,5,4,11,849,944,1793,1810
0132-000,2016,5,4,12,856,922,1778,1793
0132-000,2016,5,4,13,899,899,1798,1778
0132-000,2016,5,4,14,885,1012,1897,1798
0132-000,2016,5,4,15,1021,1092,2113,1897
0132-000,2016,5,4,16,1080,1069,2149,2113
0132-000,2016,5,4,17,1102,1129,2231,2149
0132-000,2016,5,4,18,1484,1126,2610,2231
0132-000,2016,5,4,19,1948,1150,3098,2610
0132-000,2016,5,4,20,1318,1055,2373,3098
0132-000,2016,5,4,21,1026,802,1828,2373
0132-000,2016,5,4,22,781,591,1372,1828
0132-000,2016,5,4,23,535,601,1136,1372
0132-000,2016,5,4,24,321,606,927,1136
0132-000,2016,5,5,1,228,269,497,927
0132-000,2016,5,5,2,159,156,315,497
0132-000,2016,5,5,3,100,119,219,315
0132-000,2016,5,5,4,101,108,209,219
0132-000,2016,5,5,5,103,120,223,209
0132-000,2016,5,5,6,267,182,449,223
0132-000,2016,5,5,7,458,453,911,449
0132-000,2016,5,5,8,511,1016,1527,911
0132-000,2016,5,5,9,603,1326,1929,1527
0132-000,2016,5,5,10,645,1660,2305,1929
0132-000,2016,5,5,11,676,1705,2381,2305
0132-000,2016,5,5,12,646,1661,2307,2381
0132-000,2016,5,5,13,691,1624,2315,2307
0132-000,2016,5,5,14,706,1629,2335,2315
0132-000,2016,5,5,15,761,1423,2184,2335
0132-000,2016,5,5,16,776,1115,1891,2184
0132-000,2016,5,5,17,808,900,1708,1891
0132-000,2016,5,5,18,1224,850,2074,1708
0132-000,2016,5,5,19,1016,781,1797,2074
0132-000,2016,5,5,20,738,624,1362,1797
0132-000,2016,5,5,21,641,479,1120,1362
0132-000,2016,5,5,22,532,388,920,1120
0132-000,2016,5,5,23,350,321,671,920
0132-000,2016,5,5,24,214,234,448,671
0132-000,2016,5,6,1,115,146,261,448
0132-000,2016,5,6,2,93,98,191,261
0132-000,2016,5,6,3,74,87,161,191
0132-000,2016,5,6,4,68,75,143,161
0132-000,2016,5,6,5,96,74,170,143
0132-000,2016,5,6,6,216,168,384,170
0132-000,2016,5,6,7,357,402,759,384
0132-000,2016,5,6,8,513,953,1466,759
0132-000,2016,5,6,9,635,919,1554,1466
0132-000,2016,5,6,10,666,891,1557,1554
0132-000,2016,5,6,11,703,948,1651,1557
0132-000,2016,5,6,12,716,1012,1728,1651
0132-000,2016,5,6,13,745,930,1675,1728
0132-000,2016,5,6,14,811,984,1795,1675
0132-000,2016,5,6,15,861,983,1844,1795
0132-000,2016,5,6,16,881,970,1851,1844
0132-000,2016,5,6,17,960,997,1957,1851
0132-000,2016,5,6,18,1320,929,2249,1957
0132-000,2016,5,6,19,1517,857,2374,2249
0132-000,2016,5,6,20,1351,572,1923,2374
0132-000,2016,5,6,21,992,466,1458,1923
0132-000,2016,5,6,22,662,404,1066,1458
0132-000,2016,5,6,23,467,320,787,1066
0132-000,2016,5,6,24,231,218,449,787
0132-000,2016,5,7,1,160,169,329,449
0132-000,2016,5,7,2,128,116,244,329
0132-000,2016,5,7,3,83,84,167,244
0132-000,2016,5,7,4,72,101,173,167
0132-000,2016,5,7,5,88,88,176,173
0132-000,2016,5,7,6,239,196,435,176
0132-000,2016,5,7,7,369,426,795,435
0132-000,2016,5,7,8,509,697,1206,795
0132-000,2016,5,7,9,639,817,1456,1206
0132-000,2016,5,7,10,710,889,1599,1456
0132-000,2016,5,7,11,737,963,1700,1599
0132-000,2016,5,7,12,869,1173,2042,1700
0132-000,2016,5,7,13,950,1202,2152,2042
0132-000,2016,5,7,14,916,1000,1916,2152
0132-000,2016,5,7,15,960,965,1925,1916
0132-000,2016,5,7,16,1081,912,1993,1925
0132-000,2016,5,7,17,1297,903,2200,1993
0132-000,2016,5,7,18,1641,1032,2673,2200
0132-000,2016,5,7,19,1865,879,2744,2673
0132-000,2016,5,7,20,1568,581,2149,2744
0132-000,2016,5,7,21,1454,519,1973,2149
0132-000,2016,5,7,22,1245,456,1701,1973
0132-000,2016,5,7,23,886,364,1250,1701
0132-000,2016,5,7,24,378,268,646,1250
0132-000,2016,5,8,1,241,186,427,646
0132-000,2016,5,8,2,158,142,300,427
0132-000,2016,5,8,3,92,86,178,300
0132-000,2016,5,8,4,73,64,137,178
0132-000,2016,5,8,5,89,98,187,137
0132-000,2016,5,8,6,164,135,299,187
0132-000,2016,5,8,7,238,241,479,299
0132-000,2016,5,8,8,320,403,723,479
0132-000,2016,5,8,9,423,511,934,723
0132-000,2016,5,8,10,535,626,1161,934
0132-000,2016,5,8,11,807,704,1511,1161
0132-000,2016,5,8,12,941,701,1642,1511
0132-000,2016,5,8,13,1100,680,1780,1642
0132-000,2016,5,8,14,1322,686,2008,1780
0132-000,2016,5,8,15,1381,766,2147,2008
0132-000,2016,5,8,16,1577,777,2354,2147
0132-000,2016,5,8,17,1772,811,2583,2354
0132-000,2016,5,8,18,1908,744,2652,2583
0132-000,2016,5,8,19,1876,677,2553,2652
0132-000,2016,5,8,20,1448,531,1979,2553
0132-000,2016,5,8,21,1186,576,1762,1979
0132-000,2016,5,8,22,950,454,1404,1762
0132-000,2016,5,8,23,590,323,913,1404
0132-000,2016,5,8,24,299,206,505,913
0132-000,2016,5,9,1,143,139,282,505
0132-000,2016,5,9,2,90,79,169,282
0132-000,2016,5,9,3,59,68,127,169
0132-000,2016,5,9,4,61,83,144,127
0132-000,2016,5,9,5,81,71,152,144
0132-000,2016,5,9,6,307,219,526,152
0132-000,2016,5,9,7,485,726,1211,526
0132-000,2016,5,9,8,761,1936,2697,1211
0132-000,2016,5,9,9,868,1643,2511,2697
0132-000,2016,5,9,10,830,920,1750,2511
0132-000,2016,5,9,11,822,869,1691,1750
0132-000,2016,5,9,12,875,923,1798,1691
0132-000,2016,5,9,13,858,846,1704,1798
0132-000,2016,5,9,14,885,850,1735,1704
0132-000,2016,5,9,15,895,916,1811,1735
0132-000,2016,5,9,16,942,876,1818,1811
0132-000,2016,5,9,17,1008,862,1870,1818
0132-000,2016,5,9,18,1291,900,2191,1870
0132-000,2016,5,9,19,1559,921,2480,2191
0132-000,2016,5,9,20,1030,719,1749,2480
0132-000,2016,5,9,21,857,579,1436,1749
0132-000,2016,5,9,22,651,472,1123,1436
0132-000,2016,5,9,23,407,332,739,1123
0132-000,2016,5,9,24,235,238,473,739
0132-000,2016,5,10,1,160,146,306,473
0132-000,2016,5,10,2,113,109,222,306
0132-000,2016,5,10,3,74,84,158,222
0132-000,2016,5,10,4,74,77,151,158
0132-000,2016,5,10,5,96,85,181,151
0132-000,2016,5,10,6,248,178,426,181
0132-000,2016,5,10,7,429,504,933,426
0132-000,2016,5,10,8,615,1695,2310,933
0132-000,2016,5,10,9,817,1601,2418,2310
0132-000,2016,5,10,10,780,903,1683,2418
0132-000,2016,5,10,11,855,842,1697,1683
0132-000,2016,5,10,12,802,846,1648,1697
0132-000,2016,5,10,13,744,776,1520,1648
0132-000,2016,5,10,14,821,765,1586,1520
0132-000,2016,5,10,15,847,839,1686,1586
0132-000,2016,5,10,16,862,819,1681,1686
0132-000,2016,5,10,17,995,796,1791,1681
0132-000,2016,5,10,18,1206,791,1997,1791
0132-000,2016,5,10,19,1424,816,2240,1997
0132-000,2016,5,10,20,959,626,1585,2240
0132-000,2016,5,10,21,780,540,1320,1585
0132-000,2016,5,10,22,675,428,1103,1320
0132-000,2016,5,10,23,404,337,741,1103
0132-000,2016,5,10,24,253,203,456,741
0132-000,2016,5,11,1,170,162,332,456
0132-000,2016,5,11,2,113,113,226,332
0132-000,2016,5,11,3,94,96,190,226
0132-000,2016,5,11,4,75,83,158,190
0132-000,2016,5,11,5,93,100,193,158
0132-000,2016,5,11,6,279,190,469,193
0132-000,2016,5,11,7,472,609,1081,469
0132-000,2016,5,11,8,733,1819,2552,1081
0132-000,2016,5,11,9,876,1533,2409,2552
0132-000,2016,5,11,10,841,968,1809,2409
0132-000,2016,5,11,11,833,874,1707,1809
0132-000,2016,5,11,12,844,862,1706,1707
0132-000,2016,5,11,13,814,819,1633,1706
0132-000,2016,5,11,14,906,860,1766,1633
0132-000,2016,5,11,15,900,891,1791,1766
0132-000,2016,5,11,16,944,844,1788,1791
0132-000,2016,5,11,17,966,876,1842,1788
0132-000,2016,5,11,18,1341,1004,2345,1842
0132-000,2016,5,11,19,1580,968,2548,2345
0132-000,2016,5,11,20,1119,779,1898,2548
0132-000,2016,5,11,21,796,599,1395,1898
0132-000,2016,5,11,22,669,471,1140,1395
0132-000,2016,5,11,23,420,382,802,1140
0132-000,2016,5,11,24,282,258,540,802
0132-000,2016,5,12,1,196,202,398,540
0132-000,2016,5,12,2,120,123,243,398
0132-000,2016,5,12,3,90,100,190,243
0132-000,2016,5,12,4,80,114,194,190
0132-000,2016,5,12,5,100,103,203,194
0132-000,2016,5,12,6,279,180,459,203
0132-000,2016,5,12,7,508,560,1068,459
0132-000,2016,5,12,8,719,1773,2492,1068
0132-000,2016,5,12,9,880,1576,2456,2492
0132-000,2016,5,12,10,789,920,1709,2456
0132-000,2016,5,12,11,829,916,1745,1709
0132-000,2016,5,12,12,791,848,1639,1745
0132-000,2016,5,12,13,795,749,1544,1639
0132-000,2016,5,12,14,831,893,1724,1544
0132-000,2016,5,12,15,926,816,1742,1724
0132-000,2016,5,12,16,944,775,1719,1742
0132-000,2016,5,12,17,991,852,1843,1719
0132-000,2016,5,12,18,1307,954,2261,1843
0132-000,2016,5,12,19,1525,909,2434,2261
0132-000,2016,5,12,20,1134,715,1849,2434
0132-000,2016,5,12,21,855,629,1484,1849
0132-000,2016,5,12,22,693,480,1173,1484
0132-000,2016,5,12,23,423,376,799,1173
0132-000,2016,5,12,24,228,255,483,799
0132-000,2016,5,13,1,196,173,369,483
0132-000,2016,5,13,2,109,117,226,369
0132-000,2016,5,13,3,77,101,178,226
0132-000,2016,5,13,4,77,96,173,178
0132-000,2016,5,13,5,99,97,196,173
0132-000,2016,5,13,6,271,173,444,196
0132-000,2016,5,13,7,523,578,1101,444
0132-000,2016,5,13,8,650,1785,2435,1101
0132-000,2016,5,13,9,890,1464,2354,2435
0132-000,2016,5,13,10,857,937,1794,2354
0132-000,2016,5,13,11,843,836,1679,1794
0132-000,2016,5,13,12,836,869,1705,1679
0132-000,2016,5,13,13,819,836,1655,1705
0132-000,2016,5,13,14,847,823,1670,1655
0132-000,2016,5,13,15,896,867,1763,1670
0132-000,2016,5,13,16,1083,867,1950,1763
0132-000,2016,5,13,17,1035,896,1931,1950
0132-000,2016,5,13,18,1517,1028,2545,1931
0132-000,2016,5,13,19,1899,1073,2972,2545
0132-000,2016,5,13,20,1306,922,2228,2972
0132-000,2016,5,13,21,1024,723,1747,2228
0132-000,2016,5,13,22,728,538,1266,1747
0132-000,2016,5,13,23,470,435,905,1266
0132-000,2016,5,13,24,286,308,594,905
0132-000,2016,5,14,1,218,240,458,594
0132-000,2016,5,14,2,165,149,314,458
0132-000,2016,5,14,3,138,146,284,314
0132-000,2016,5,14,4,109,111,220,284
0132-000,2016,5,14,5,113,108,221,220
0132-000,2016,5,14,6,296,198,494,221
0132-000,2016,5,14,7,422,450,872,494
0132-000,2016,5,14,8,535,821,1356,872
0132-000,2016,5,14,9,753,1003,1756,1356
0132-000,2016,5,14,10,759,1204,1963,1756
0132-000,2016,5,14,11,770,1268,2038,1963
0132-000,2016,5,14,12,758,1489,2247,2038
0132-000,2016,5,14,13,888,1394,2282,2247
0132-000,2016,5,14,14,855,1173,2028,2282
0132-000,2016,5,14,15,919,978,1897,2028
0132-000,2016,5,14,16,1002,1423,2425,1897
0132-000,2016,5,14,17,1104,964,2068,2425
0132-000,2016,5,14,18,1308,1001,2309,2068
0132-000,2016,5,14,19,1352,892,2244,2309
0132-000,2016,5,14,20,925,656,1581,2244
0132-000,2016,5,14,21,677,546,1223,1581
0132-000,2016,5,14,22,509,441,950,1223
0132-000,2016,5,14,23,413,359,772,950
0132-000,2016,5,14,24,241,252,493,772
0132-000,2016,5,15,1,184,192,376,493
0132-000,2016,5,15,2,153,147,300,376
0132-000,2016,5,15,3,111,103,214,300
0132-000,2016,5,15,4,97,83,180,214
0132-000,2016,5,15,5,94,99,193,180
0132-000,2016,5,15,6,182,156,338,193
0132-000,2016,5,15,7,254,293,547,338
0132-000,2016,5,15,8,341,438,779,547
0132-000,2016,5,15,9,405,462,867,779
0132-000,2016,5,15,10,494,573,1067,867
0132-000,2016,5,15,11,603,622,1225,1067
0132-000,2016,5,15,12,625,647,1272,1225
0132-000,2016,5,15,13,745,702,1447,1272
0132-000,2016,5,15,14,729,722,1451,1447
0132-000,2016,5,15,15,989,765,1754,1451
0132-000,2016,5,15,16,1072,706,1778,1754
0132-000,2016,5,15,17,1288,758,2046,1778
0132-000,2016,5,15,18,1411,685,2096,2046
0132-000,2016,5,15,19,1375,635,2010,2096
0132-000,2016,5,15,20,1222,472,1694,2010
0132-000,2016,5,15,21,912,494,1406,1694
0132-000,2016,5,15,22,577,360,937,1406
0132-000,2016,5,15,23,310,279,589,937
0132-000,2016,5,15,24,160,179,339,589
0132-000,2016,5,16,1,106,116,222,339
0132-000,2016,5,16,2,91,95,186,222
0132-000,2016,5,16,3,44,55,99,186
0132-000,2016,5,16,4,55,59,114,99
0132-000,2016,5,16,5,81,58,139,114
0132-000,2016,5,16,6,290,218,508,139
0132-000,2016,5,16,7,486,694,1180,508
0132-000,2016,5,16,8,741,1839,2580,1180
0132-000,2016,5,16,9,897,1562,2459,2580
0132-000,2016,5,16,10,846,956,1802,2459
0132-000,2016,5,16,11,844,850,1694,1802
0132-000,2016,5,16,12,865,859,1724,1694
0132-000,2016,5,16,13,817,806,1623,1724
0132-000,2016,5,16,14,841,847,1688,1623
0132-000,2016,5,16,15,883,873,1756,1688
0132-000,2016,5,16,16,904,800,1704,1756
0132-000,2016,5,16,17,1015,863,1878,1704
0132-000,2016,5,16,18,1266,921,2187,1878
0132-000,2016,5,16,19,1476,951,2427,2187
0132-000,2016,5,16,20,1048,723,1771,2427
0132-000,2016,5,16,21,896,570,1466,1771
0132-000,2016,5,16,22,656,471,1127,1466
0132-000,2016,5,16,23,380,366,746,1127
0132-000,2016,5,16,24,239,237,476,746
0132-000,2016,5,17,1,162,163,325,476
0132-000,2016,5,17,2,114,100,214,325
0132-000,2016,5,17,3,71,86,157,214
0132-000,2016,5,17,4,82,96,178,157
0132-000,2016,5,17,5,85,101,186,178
0132-000,2016,5,17,6,314,180,494,186
0132-000,2016,5,17,7,498,615,1113,494
0132-000,2016,5,17,8,678,1895,2573,1113
0132-000,2016,5,17,9,863,1548,2411,2573
0132-000,2016,5,17,10,868,916,1784,2411
0132-000,2016,5,17,11,861,946,1807,1784
0132-000,2016,5,17,12,858,858,1716,1807
0132-000,2016,5,17,13,767,743,1510,1716
0132-000,2016,5,17,14,815,815,1630,1510
0132-000,2016,5,17,15,881,804,1685,1630
0132-000,2016,5,17,16,952,830,1782,1685
0132-000,2016,5,17,17,1039,852,1891,1782
0132-000,2016,5,17,18,1255,896,2151,1891
0132-000,2016,5,17,19,1450,886,2336,2151
0132-000,2016,5,17,20,998,686,1684,2336
0132-000,2016,5,17,21,928,642,1570,1684
0132-000,2016,5,17,22,721,452,1173,1570
0132-000,2016,5,17,23,468,360,828,1173
0132-000,2016,5,17,24,247,242,489,828
0132-000,2016,5,18,1,169,171,340,489
0132-000,2016,5,18,2,115,90,205,340
0132-000,2016,5,18,3,67,89,156,205
0132-000,2016,5,18,4,75,77,152,156
0132-000,2016,5,18,5,85,95,180,152
0132-000,2016,5,18,6,292,202,494,180
0132-000,2016,5,18,7,512,595,1107,494
0132-000,2016,5,18,8,668,1813,2481,1107
0132-000,2016,5,18,9,967,1535,2502,2481
0132-000,2016,5,18,10,863,947,1810,2502
0132-000,2016,5,18,11,784,855,1639,1810
0132-000,2016,5,18,12,815,861,1676,1639
0132-000,2016,5,18,13,850,725,1575,1676
0132-000,2016,5,18,14,889,790,1679,1575
0132-000,2016,5,18,15,811,873,1684,1679
0132-000,2016,5,18,16,916,810,1726,1684
0132-000,2016,5,18,17,888,854,1742,1726
0132-000,2016,5,18,18,1321,911,2232,1742
0132-000,2016,5,18,19,1585,886,2471,2232
0132-000,2016,5,18,20,1018,741,1759,2471
0132-000,2016,5,18,21,850,610,1460,1759
0132-000,2016,5,18,22,638,449,1087,1460
0132-000,2016,5,18,23,462,379,841,1087
0132-000,2016,5,18,24,257,238,495,841
0132-000,2016,5,19,1,200,198,398,495
0132-000,2016,5,19,2,129,115,244,398
0132-000,2016,5,19,3,96,86,182,244
0132-000,2016,5,19,4,80,101,181,182
0132-000,2016,5,19,5,97,89,186,181
0132-000,2016,5,19,6,312,197,509,186
0132-000,2016,5,19,7,488,579,1067,509
0132-000,2016,5,19,8,697,1820,2517,1067
0132-000,2016,5,19,9,895,1546,2441,2517
0132-000,2016,5,19,10,815,903,1718,2441
0132-000,2016,5,19,11,819,883,1702,1718
0132-000,2016,5,19,12,736,834,1570,1702
0132-000,2016,5,19,13,778,702,1480,1570
0132-000,2016,5,19,14,840,784,1624,1480
0132-000,2016,5,19,15,908,807,1715,1624
0132-000,2016,5,19,16,950,850,1800,1715
0132-000,2016,5,19,17,963,813,1776,1800
0132-000,2016,5,19,18,1281,962,2243,1776
0132-000,2016,5,19,19,1468,899,2367,2243
0132-000,2016,5,19,20,1005,740,1745,2367
0132-000,2016,5,19,21,907,606,1513,1745
0132-000,2016,5,19,22,675,472,1147,1513
0132-000,2016,5,19,23,421,370,791,1147
0132-000,2016,5,19,24,275,221,496,791
0132-000,2016,5,20,1,171,176,347,496
0132-000,2016,5,20,2,118,128,246,347
0132-000,2016,5,20,3,78,86,164,246
0132-000,2016,5,20,4,83,82,165,164
0132-000,2016,5,20,5,99,97,196,165
0132-000,2016,5,20,6,314,220,534,196
0132-000,2016,5,20,7,508,605,1113,534
0132-000,2016,5,20,8,683,1796,2479,1113
0132-000,2016,5,20,9,907,1394,2301,2479
0132-000,2016,5,20,10,834,937,1771,2301
0132-000,2016,5,20,11,793,833,1626,1771
0132-000,2016,5,20,12,825,833,1658,1626
0132-000,2016,5,20,13,840,903,1743,1658
0132-000,2016,5,20,14,913,755,1668,1743
0132-000,2016,5,20,15,936,924,1860,1668
0132-000,2016,5,20,16,972,851,1823,1860
0132-000,2016,5,20,17,1051,884,1935,1823
0132-000,2016,5,20,18,1415,1091,2506,1935
0132-000,2016,5,20,19,1680,949,2629,2506
0132-000,2016,5,20,20,1179,834,2013,2629
0132-000,2016,5,20,21,943,602,1545,2013
0132-000,2016,5,20,22,688,557,1245,1545
0132-000,2016,5,20,23,449,421,870,1245
0132-000,2016,5,20,24,301,272,573,870
0132-000,2016,5,21,1,231,218,449,573
0132-000,2016,5,21,2,149,142,291,449
0132-000,2016,5,21,3,115,135,250,291
0132-000,2016,5,21,4,95,113,208,250
0132-000,2016,5,21,5,132,133,265,208
0132-000,2016,5,21,6,308,222,530,265
0132-000,2016,5,21,7,397,500,897,530
0132-000,2016,5,21,8,569,956,1525,897
0132-000,2016,5,21,9,721,962,1683,1525
0132-000,2016,5,21,10,767,977,1744,1683
0132-000,2016,5,21,11,819,1141,1960,1744
0132-000,2016,5,21,12,852,1199,2051,1960
0132-000,2016,5,21,13,1018,1044,2062,2051
0132-000,2016,5,21,14,855,909,1764,2062
0132-000,2016,5,21,15,848,886,1734,1764
0132-000,2016,5,21,16,948,861,1809,1734
0132-000,2016,5,21,17,1098,947,2045,1809
0132-000,2016,5,21,18,1299,1009,2308,2045
0132-000,2016,5,21,19,1348,919,2267,2308
0132-000,2016,5,21,20,892,688,1580,2267
0132-000,2016,5,21,21,663,545,1208,1580
0132-000,2016,5,21,22,509,471,980,1208
0132-000,2016,5,21,23,399,344,743,980
0132-000,2016,5,21,24,234,314,548,743
0132-000,2016,5,22,1,192,220,412,548
0132-000,2016,5,22,2,107,130,237,412
0132-000,2016,5,22,3,111,111,222,237
0132-000,2016,5,22,4,113,97,210,222
0132-000,2016,5,22,5,76,135,211,210
0132-000,2016,5,22,6,218,171,389,211
0132-000,2016,5,22,7,262,255,517,389
0132-000,2016,5,22,8,355,408,763,517
0132-000,2016,5,22,9,410,508,918,763
0132-000,2016,5,22,10,516,615,1131,918
0132-000,2016,5,22,11,584,625,1209,1131
0132-000,2016,5,22,12,665,610,1275,1209
0132-000,2016,5,22,13,616,628,1244,1275
0132-000,2016,5,22,14,704,651,1355,1244
0132-000,2016,5,22,15,736,637,1373,1355
0132-000,2016,5,22,16,878,708,1586,1373
0132-000,2016,5,22,17,1066,718,1784,1586
0132-000,2016,5,22,18,1138,711,1849,1784
0132-000,2016,5,22,19,1089,620,1709,1849
0132-000,2016,5,22,20,726,583,1309,1709
0132-000,2016,5,22,21,643,573,1216,1309
0132-000,2016,5,22,22,507,440,947,1216
0132-000,2016,5,22,23,346,375,721,947
0132-000,2016,5,22,24,228,213,441,721
0132-000,2016,5,23,1,130,122,252,441
0132-000,2016,5,23,2,74,103,177,252
0132-000,2016,5,23,3,64,67,131,177
0132-000,2016,5,23,4,57,82,139,131
0132-000,2016,5,23,5,79,78,157,139
0132-000,2016,5,23,6,330,223,553,157
0132-000,2016,5,23,7,521,792,1313,553
0132-000,2016,5,23,8,745,1920,2665,1313
0132-000,2016,5,23,9,876,1561,2437,2665
0132-000,2016,5,23,10,827,927,1754,2437
0132-000,2016,5,23,11,830,839,1669,1754
0132-000,2016,5,23,12,896,816,1712,1669
0132-000,2016,5,23,13,792,787,1579,1712
0132-000,2016,5,23,14,901,812,1713,1579
0132-000,2016,5,23,15,880,862,1742,1713
0132-000,2016,5,23,16,902,862,1764,1742
0132-000,2016,5,23,17,1104,831,1935,1764
0132-000,2016,5,23,18,1272,1022,2294,1935
0132-000,2016,5,23,19,1546,961,2507,2294
0132-000,2016,5,23,20,1012,743,1755,2507
0132-000,2016,5,23,21,902,565,1467,1755
0132-000,2016,5,23,22,635,467,1102,1467
0132-000,2016,5,23,23,389,363,752,1102
0132-000,2016,5,23,24,234,211,445,752
0132-000,2016,5,24,1,158,160,318,445
0132-000,2016,5,24,2,94,95,189,318
0132-000,2016,5,24,3,86,80,166,189
0132-000,2016,5,24,4,68,72,140,166
0132-000,2016,5,24,5,67,90,157,140
0132-000,2016,5,24,6,197,140,337,157
0132-000,2016,5,24,7,381,487,868,337
0132-000,2016,5,24,8,601,1693,2294,868
0132-000,2016,5,24,9,846,1547,2393,2294
0132-000,2016,5,24,10,776,877,1653,2393
0132-000,2016,5,24,11,770,863,1633,1653
0132-000,2016,5,24,12,778,840,1618,1633
0132-000,2016,5,24,13,768,784,1552,1618
0132-000,2016,5,24,14,830,766,1596,1552
0132-000,2016,5,24,15,843,829,1672,1596
0132-000,2016,5,24,16,898,818,1716,1672
0132-000,2016,5,24,17,911,811,1722,1716
0132-000,2016,5,24,18,1205,863,2068,1722
0132-000,2016,5,24,19,1503,893,2396,2068
0132-000,2016,5,24,20,1015,657,1672,2396
0132-000,2016,5,24,21,875,547,1422,1672
0132-000,2016,5,24,22,642,464,1106,1422
0132-000,2016,5,24,23,420,350,770,1106
0132-000,2016,5,24,24,266,225,491,770
0132-000,2016,5,25,1,186,149,335,491
0132-000,2016,5,25,2,118,133,251,335
0132-000,2016,5,25,3,93,89,182,251
0132-000,2016,5,25,4,79,78,157,182
0132-000,2016,5,25,5,87,111,198,157
0132-000,2016,5,25,6,316,199,515,198
0132-000,2016,5,25,7,511,597,1108,515
0132-000,2016,5,25,8,664,1840,2504,1108
0132-000,2016,5,25,9,872,1558,2430,2504
0132-000,2016,5,25,10,814,967,1781,2430
0132-000,2016,5,25,11,857,849,1706,1781
0132-000,2016,5,25,12,838,791,1629,1706
0132-000,2016,5,25,13,731,769,1500,1629
0132-000,2016,5,25,14,834,826,1660,1500
0132-000,2016,5,25,15,876,905,1781,1660
0132-000,2016,5,25,16,916,904,1820,1781
0132-000,2016,5,25,17,997,837,1834,1820
0132-000,2016,5,25,18,1376,974,2350,1834
0132-000,2016,5,25,19,1628,933,2561,2350
0132-000,2016,5,25,20,1070,711,1781,2561
0132-000,2016,5,25,21,833,607,1440,1781
0132-000,2016,5,25,22,614,445,1059,1440
0132-000,2016,5,25,23,432,387,819,1059
0132-000,2016,5,25,24,268,246,514,819
0132-000,2016,5,26,1,200,178,378,514
0132-000,2016,5,26,2,119,130,249,378
0132-000,2016,5,26,3,98,106,204,249
0132-000,2016,5,26,4,67,105,172,204
0132-000,2016,5,26,5,92,104,196,172
0132-000,2016,5,26,6,288,205,493,196
0132-000,2016,5,26,7,522,598,1120,493
0132-000,2016,5,26,8,671,1849,2520,1120
0132-000,2016,5,26,9,884,1521,2405,2520
0132-000,2016,5,26,10,864,935,1799,2405
0132-000,2016,5,26,11,843,874,1717,1799
0132-000,2016,5,26,12,810,862,1672,1717
0132-000,2016,5,26,13,748,782,1530,1672
0132-000,2016,5,26,14,820,822,1642,1530
0132-000,2016,5,26,15,903,833,1736,1642
0132-000,2016,5,26,16,922,786,1708,1736
0132-000,2016,5,26,17,989,849,1838,1708
0132-000,2016,5,26,18,1303,896,2199,1838
0132-000,2016,5,26,19,1505,881,2386,2199
0132-000,2016,5,26,20,1075,701,1776,2386
0132-000,2016,5,26,21,900,616,1516,1776
0132-000,2016,5,26,22,675,451,1126,1516
0132-000,2016,5,26,23,445,352,797,1126
0132-000,2016,5,26,24,250,225,475,797
0132-000,2016,5,27,1,188,197,385,475
0132-000,2016,5,27,2,120,106,226,385
0132-000,2016,5,27,3,91,103,194,226
0132-000,2016,5,27,4,82,96,178,194
0132-000,2016,5,27,5,109,126,235,178
0132-000,2016,5,27,6,316,191,507,235
0132-000,2016,5,27,7,545,567,1112,507
0132-000,2016,5,27,8,708,1828,2536,1112
0132-000,2016,5,27,9,884,1472,2356,2536
0132-000,2016,5,27,10,824,883,1707,2356
0132-000,2016,5,27,11,857,922,1779,1707
0132-000,2016,5,27,12,861,797,1658,1779
0132-000,2016,5,27,13,777,827,1604,1658
0132-000,2016,5,27,14,829,783,1612,1604
0132-000,2016,5,27,15,860,851,1711,1612
0132-000,2016,5,27,16,950,806,1756,1711
0132-000,2016,5,27,17,1080,859,1939,1756
0132-000,2016,5,27,18,1379,1102,2481,1939
0132-000,2016,5,27,19,1892,965,2857,2481
0132-000,2016,5,27,20,1200,829,2029,2857
0132-000,2016,5,27,21,954,669,1623,2029
0132-000,2016,5,27,22,671,499,1170,1623
0132-000,2016,5,27,23,420,390,810,1170
0132-000,2016,5,27,24,284,304,588,810
0132-000,2016,5,28,1,208,233,441,588
0132-000,2016,5,28,2,153,149,302,441
0132-000,2016,5,28,3,131,128,259,302
0132-000,2016,5,28,4,98,144,242,259
0132-000,2016,5,28,5,115,107,222,242
0132-000,2016,5,28,6,314,226,540,222
0132-000,2016,5,28,7,434,477,911,540
0132-000,2016,5,28,8,528,864,1392,911
0132-000,2016,5,28,9,739,962,1701,1392
0132-000,2016,5,28,10,777,1003,1780,1701
0132-000,2016,5,28,11,794,1130,1924,1780
0132-000,2016,5,28,12,870,1179,2049,1924
0132-000,2016,5,28,13,915,1199,2114,2049
0132-000,2016,5,28,14,848,979,1827,2114
0132-000,2016,5,28,15,895,996,1891,1827
0132-000,2016,5,28,16,939,919,1858,1891
0132-000,2016,5,28,17,1039,979,2018,1858
0132-000,2016,5,28,18,1240,1000,2240,2018
0132-000,2016,5,28,19,1182,988,2170,2240
0132-000,2016,5,28,20,843,694,1537,2170
0132-000,2016,5,28,21,736,570,1306,1537
0132-000,2016,5,28,22,517,433,950,1306
0132-000,2016,5,28,23,373,340,713,950
0132-000,2016,5,28,24,226,267,493,713
0132-000,2016,5,29,1,186,184,370,493
0132-000,2016,5,29,2,133,144,277,370
0132-000,2016,5,29,3,122,124,246,277
0132-000,2016,5,29,4,82,95,177,246
0132-000,2016,5,29,5,93,84,177,177
0132-000,2016,5,29,6,215,141,356,177
0132-000,2016,5,29,7,257,262,519,356
0132-000,2016,5,29,8,325,393,718,519
0132-000,2016,5,29,9,408,494,902,718
0132-000,2016,5,29,10,481,578,1059,902
0132-000,2016,5,29,11,581,653,1234,1059
0132-000,2016,5,29,12,617,640,1257,1234
0132-000,2016,5,29,13,679,695,1374,1257
0132-000,2016,5,29,14,725,693,1418,1374
0132-000,2016,5,29,15,768,753,1521,1418
0132-000,2016,5,29,16,898,716,1614,1521
0132-000,2016,5,29,17,984,777,1761,1614
0132-000,2016,5,29,18,1011,775,1786,1761
0132-000,2016,5,29,19,1085,660,1745,1786
0132-000,2016,5,29,20,841,572,1413,1745
0132-000,2016,5,29,21,687,582,1269,1413
0132-000,2016,5,29,22,486,485,971,1269
0132-000,2016,5,29,23,377,356,733,971
0132-000,2016,5,29,24,206,201,407,733
0132-000,2016,5,30,1,131,138,269,407
0132-000,2016,5,30,2,98,85,183,269
0132-000,2016,5,30,3,53,62,115,183
0132-000,2016,5,30,4,58,64,122,115
0132-000,2016,5,30,5,83,87,170,122
0132-000,2016,5,30,6,329,221,550,170
0132-000,2016,5,30,7,539,758,1297,550
0132-000,2016,5,30,8,702,1894,2596,1297
0132-000,2016,5,30,9,941,1565,2506,2596
0132-000,2016,5,30,10,811,914,1725,2506
0132-000,2016,5,30,11,855,895,1750,1725
0132-000,2016,5,30,12,854,866,1720,1750
0132-000,2016,5,30,13,795,835,1630,1720
0132-000,2016,5,30,14,825,789,1614,1630
0132-000,2016,5,30,15,897,887,1784,1614
0132-000,2016,5,30,16,951,822,1773,1784
0132-000,2016,5,30,17,952,857,1809,1773
0132-000,2016,5,30,18,1284,951,2235,1809
0132-000,2016,5,30,19,1476,980,2456,2235
0132-000,2016,5,30,20,1098,730,1828,2456
0132-000,2016,5,30,21,934,602,1536,1828
0132-000,2016,5,30,22,674,460,1134,1536
0132-000,2016,5,30,23,395,346,741,1134
0132-000,2016,5,30,24,240,213,453,741
0132-000,2016,5,31,1,139,176,315,453
0132-000,2016,5,31,2,109,114,223,315
0132-000,2016,5,31,3,82,89,171,223
0132-000,2016,5,31,4,81,77,158,171
0132-000,2016,5,31,5,81,115,196,158
0132-000,2016,5,31,6,301,177,478,196
0132-000,2016,5,31,7,497,609,1106,478
0132-000,2016,5,31,8,694,1827,2521,1106
0132-000,2016,5,31,9,925,1566,2491,2521
0132-000,2016,5,31,10,827,894,1721,2491
0132-000,2016,5,31,11,807,849,1656,1721
0132-000,2016,5,31,12,894,800,1694,1656
0132-000,2016,5,31,13,805,831,1636,1694
0132-000,2016,5,31,14,824,786,1610,1636
0132-000,2016,5,31,15,910,839,1749,1610
0132-000,2016,5,31,16,901,858,1759,1749
0132-000,2016,5,31,17,996,839,1835,1759
0132-000,2016,5,31,18,1349,969,2318,1835
0132-000,2016,5,31,19,1469,931,2400,2318
0132-000,2016,5,31,20,984,738,1722,2400
0132-000,2016,5,31,21,915,556,1471,1722
0132-000,2016,5,31,22,699,477,1176,1471
0132-000,2016,5,31,23,400,369,769,1176
0132-000,2016,5,31,24,261,222,483,769
0132-000,2016,6,1,1,163,162,325,483
0132-000,2016,6,1,2,114,128,242,325
0132-000,2016,6,1,3,92,80,172,242
0132-000,2016,6,1,4,73,89,162,172
0132-000,2016,6,1,5,95,84,179,162
0132-000,2016,6,1,6,305,205,510,179
0132-000,2016,6,1,7,551,618,1169,510
0132-000,2016,6,1,8,750,1773,2523,1169
0132-000,2016,6,1,9,894,1574,2468,2523
0132-000,2016,6,1,10,765,954,1719,2468
0132-000,2016,6,1,11,826,865,1691,1719
0132-000,2016,6,1,12,824,850,1674,1691
0132-000,2016,6,1,13,743,820,1563,1674
0132-000,2016,6,1,14,839,788,1627,1563
0132-000,2016,6,1,15,889,794,1683,1627
0132-000,2016,6,1,16,976,793,1769,1683
0132-000,2016,6,1,17,987,859,1846,1769
0132-000,2016,6,1,18,1292,978,2270,1846
0132-000,2016,6,1,19,1601,887,2488,2270
0132-000,2016,6,1,20,1081,761,1842,2488
0132-000,2016,6,1,21,908,564,1472,1842
0132-000,2016,6,1,22,610,481,1091,1472
0132-000,2016,6,1,23,433,345,778,1091
0132-000,2016,6,1,24,269,211,480,778
0132-000,2016,6,2,1,167,175,342,480
0132-000,2016,6,2,2,110,123,233,342
0132-000,2016,6,2,3,94,103,197,233
0132-000,2016,6,2,4,79,87,166,197
0132-000,2016,6,2,5,79,101,180,166
0132-000,2016,6,2,6,328,199,527,180
0132-000,2016,6,2,7,483,625,1108,527
0132-000,2016,6,2,8,699,1782,2481,1108
0132-000,2016,6,2,9,884,1554,2438,2481
0132-000,2016,6,2,10,830,932,1762,2438
0132-000,2016,6,2,11,790,871,1661,1762
0132-000,2016,6,2,12,852,876,1728,1661
0132-000,2016,6,2,13,804,727,1531,1728
0132-000,2016,6,2,14,848,804,1652,1531
0132-000,2016,6,2,15,955,829,1784,1652
0132-000,2016,6,2,16,853,810,1663,1784
0132-000,2016,6,2,17,1013,854,1867,1663
0132-000,2016,6,2,18,1362,956,2318,1867
0132-000,2016,6,2,19,1524,874,2398,2318
0132-000,2016,6,2,20,1012,757,1769,2398
0132-000,2016,6,2,21,917,594,1511,1769
0132-000,2016,6,2,22,671,483,1154,1511
0132-000,2016,6,2,23,405,391,796,1154
0132-000,2016,6,2,24,276,227,503,796
0132-000,2016,6,3,1,198,181,379,503
0132-000,2016,6,3,2,131,115,246,379
0132-000,2016,6,3,3,86,98,184,246
0132-000,2016,6,3,4,82,94,176,184
0132-000,2016,6,3,5,105,124,229,176
0132-000,2016,6,3,6,310,213,523,229
0132-000,2016,6,3,7,517,602,1119,523
0132-000,2016,6,3,8,770,1759,2529,1119
0132-000,2016,6,3,9,876,1515,2391,2529
0132-000,2016,6,3,10,836,892,1728,2391
0132-000,2016,6,3,11,822,840,1662,1728
0132-000,2016,6,3,12,803,872,1675,1662
0132-000,2016,6,3,13,800,804,1604,1675
0132-000,2016,6,3,14,835,819,1654,1604
0132-000,2016,6,3,15,951,902,1853,1654
0132-000,2016,6,3,16,1052,876,1928,1853
0132-000,2016,6,3,17,1067,900,1967,1928
0132-000,2016,6,3,18,1486,1051,2537,1967
0132-000,2016,6,3,19,1895,1029,2924,2537
0132-000,2016,6,3,20,1268,904,2172,2924
0132-000,2016,6,3,21,991,641,1632,2172
0132-000,2016,6,3,22,715,550,1265,1632
0132-000,2016,6,3,23,533,450,983,1265
0132-000,2016,6,3,24,289,286,575,983
0132-000,2016,6,4,1,223,252,475,575
0132-000,2016,6,4,2,155,168,323,475
0132-000,2016,6,4,3,115,117,232,323
0132-000,2016,6,4,4,94,111,205,232
0132-000,2016,6,4,5,111,123,234,205
0132-000,2016,6,4,6,290,272,562,234
0132-000,2016,6,4,7,476,441,917,562
0132-000,2016,6,4,8,500,888,1388,917
0132-000,2016,6,4,9,707,1132,1839,1388
0132-000,2016,6,4,10,776,1373,2149,1839
0132-000,2016,6,4,11,776,1759,2535,2149
0132-000,2016,6,4,12,796,1908,2704,2535
0132-000,2016,6,4,13,759,1781,2540,2704
0132-000,2016,6,4,14,786,1841,2627,2540
0132-000,2016,6,4,15,864,1749,2613,2627
0132-000,2016,6,4,16,880,1671,2551,2613
0132-000,2016,6,4,17,1040,1775,2815,2551
0132-000,2016,6,4,18,1280,1725,3005,2815
0132-000,2016,6,4,19,1121,1741,2862,3005
0132-000,2016,6,4,20,887,1070,1957,2862
0132-000,2016,6,4,21,799,671,1470,1957
0132-000,2016,6,4,22,558,458,1016,1470
0132-000,2016,6,4,23,339,342,681,1016
0132-000,2016,6,4,24,217,248,465,681
0132-000,2016,6,5,1,165,171,336,465
0132-000,2016,6,5,2,122,133,255,336
0132-000,2016,6,5,3,98,112,210,255
0132-000,2016,6,5,4,90,92,182,210
0132-000,2016,6,5,5,94,101,195,182
0132-000,2016,6,5,6,206,167,373,195
0132-000,2016,6,5,7,254,294,548,373
0132-000,2016,6,5,8,299,414,713,548
0132-000,2016,6,5,9,445,582,1027,713
0132-000,2016,6,5,10,533,690,1223,1027
0132-000,2016,6,5,11,589,794,1383,1223
0132-000,2016,6,5,12,619,796,1415,1383
0132-000,2016,6,5,13,631,762,1393,1415
0132-000,2016,6,5,14,699,764,1463,1393
0132-000,2016,6,5,15,804,709,1513,1463
0132-000,2016,6,5,16,958,745,1703,1513
0132-000,2016,6,5,17,1130,751,1881,1703
0132-000,2016,6,5,18,1354,735,2089,1881
0132-000,2016,6,5,19,1259,654,1913,2089
0132-000,2016,6,5,20,1157,519,1676,1913
0132-000,2016,6,5,21,871,511,1382,1676
0132-000,2016,6,5,22,751,388,1139,1382
0132-000,2016,6,5,23,497,293,790,1139
0132-000,2016,6,5,24,382,225,607,790
0132-000,2016,6,6,1,212,175,387,607
0132-000,2016,6,6,2,102,112,214,387
0132-000,2016,6,6,3,87,87,174,214
0132-000,2016,6,6,4,75,82,157,174
0132-000,2016,6,6,5,83,100,183,157
0132-000,2016,6,6,6,302,216,518,183
0132-000,2016,6,6,7,377,434,811,518
0132-000,2016,6,6,8,454,759,1213,811
0132-000,2016,6,6,9,514,704,1218,1213
0132-000,2016,6,6,10,645,736,1381,1218
0132-000,2016,6,6,11,659,761,1420,1381
0132-000,2016,6,6,12,751,759,1510,1420
0132-000,2016,6,6,13,826,687,1513,1510
0132-000,2016,6,6,14,936,724,1660,1513
0132-000,2016,6,6,15,1145,760,1905,1660
0132-000,2016,6,6,16,1330,692,2022,1905
0132-000,2016,6,6,17,1477,726,2203,2022
0132-000,2016,6,6,18,1902,772,2674,2203
0132-000,2016,6,6,19,1863,676,2539,2674
0132-000,2016,6,6,20,1351,567,1918,2539
0132-000,2016,6,6,21,1145,491,1636,1918
0132-000,2016,6,6,22,671,365,1036,1636
0132-000,2016,6,6,23,342,280,622,1036
0132-000,2016,6,6,24,211,229,440,622
0132-000,2016,6,7,1,148,138,286,440
0132-000,2016,6,7,2,79,90,169,286
0132-000,2016,6,7,3,57,67,124,169
0132-000,2016,6,7,4,57,67,124,124
0132-000,2016,6,7,5,78,95,173,124
0132-000,2016,6,7,6,287,206,493,173
0132-000,2016,6,7,7,539,691,1230,493
0132-000,2016,6,7,8,686,1875,2561,1230
0132-000,2016,6,7,9,923,1642,2565,2561
0132-000,2016,6,7,10,791,899,1690,2565
0132-000,2016,6,7,11,820,895,1715,1690
0132-000,2016,6,7,12,841,862,1703,1715
0132-000,2016,6,7,13,813,799,1612,1703
0132-000,2016,6,7,14,851,821,1672,1612
0132-000,2016,6,7,15,886,878,1764,1672
0132-000,2016,6,7,16,949,808,1757,1764
0132-000,2016,6,7,17,978,822,1800,1757
0132-000,2016,6,7,18,1337,969,2306,1800
0132-000,2016,6,7,19,1511,911,2422,2306
0132-000,2016,6,7,20,1090,734,1824,2422
0132-000,2016,6,7,21,915,599,1514,1824
0132-000,2016,6,7,22,699,482,1181,1514
0132-000,2016,6,7,23,462,354,816,1181
0132-000,2016,6,7,24,247,235,482,816
0132-000,2016,6,8,1,179,151,330,482
0132-000,2016,6,8,2,118,109,227,330
0132-000,2016,6,8,3,78,108,186,227
0132-000,2016,6,8,4,67,86,153,186
0132-000,2016,6,8,5,115,118,233,153
0132-000,2016,6,8,6,303,220,523,233
0132-000,2016,6,8,7,485,614,1099,523
0132-000,2016,6,8,8,704,1828,2532,1099
0132-000,2016,6,8,9,905,1559,2464,2532
0132-000,2016,6,8,10,804,928,1732,2464
0132-000,2016,6,8,11,841,837,1678,1732
0132-000,2016,6,8,12,799,811,1610,1678
0132-000,2016,6,8,13,807,759,1566,1610
0132-000,2016,6,8,14,870,799,1669,1566
0132-000,2016,6,8,15,894,839,1733,1669
0132-000,2016,6,8,16,941,794,1735,1733
0132-000,2016,6,8,17,952,824,1776,1735
0132-000,2016,6,8,18,1329,925,2254,1776
0132-000,2016,6,8,19,1638,931,2569,2254
0132-000,2016,6,8,20,1070,730,1800,2569
0132-000,2016,6,8,21,866,618,1484,1800
0132-000,2016,6,8,22,637,469,1106,1484
0132-000,2016,6,8,23,457,379,836,1106
0132-000,2016,6,8,24,258,231,489,836
0132-000,2016,6,9,1,186,173,359,489
0132-000,2016,6,9,2,121,119,240,359
0132-000,2016,6,9,3,79,92,171,240
0132-000,2016,6,9,4,76,90,166,171
0132-000,2016,6,9,5,99,100,199,166
0132-000,2016,6,9,6,292,220,512,199
0132-000,2016,6,9,7,517,588,1105,512
0132-000,2016,6,9,8,650,1830,2480,1105
0132-000,2016,6,9,9,934,1587,2521,2480
0132-000,2016,6,9,10,835,937,1772,2521
0132-000,2016,6,9,11,843,828,1671,1772
0132-000,2016,6,9,12,744,812,1556,1671
0132-000,2016,6,9,13,791,741,1532,1556
0132-000,2016,6,9,14,876,824,1700,1532
0132-000,2016,6,9,15,919,844,1763,1700
0132-000,2016,6,9,16,984,788,1772,1763
0132-000,2016,6,9,17,988,849,1837,1772
0132-000,2016,6,9,18,1299,953,2252,1837
0132-000,2016,6,9,19,1454,905,2359,2252
0132-000,2016,6,9,20,1013,695,1708,2359
0132-000,2016,6,9,21,953,600,1553,1708
0132-000,2016,6,9,22,666,439,1105,1553
0132-000,2016,6,9,23,425,376,801,1105
0132-000,2016,6,9,24,251,203,454,801
0132-000,2016,6,10,1,196,184,380,454
0132-000,2016,6,10,2,105,143,248,380
0132-000,2016,6,10,3,77,105,182,248
0132-000,2016,6,10,4,88,109,197,182
0132-000,2016,6,10,5,113,125,238,197
0132-000,2016,6,10,6,302,217,519,238
0132-000,2016,6,10,7,559,642,1201,519
0132-000,2016,6,10,8,734,1799,2533,1201
0132-000,2016,6,10,9,927,1521,2448,2533
0132-000,2016,6,10,10,816,961,1777,2448
0132-000,2016,6,10,11,888,804,1692,1777
0132-000,2016,6,10,12,887,857,1744,1692
0132-000,2016,6,10,13,858,758,1616,1744
0132-000,2016,6,10,14,862,862,1724,1616
0132-000,2016,6,10,15,925,870,1795,1724
0132-000,2016,6,10,16,1006,847,1853,1795
0132-000,2016,6,10,17,1012,897,1909,1853
0132-000,2016,6,10,18,1455,1079,2534,1909
0132-000,2016,6,10,19,1721,1002,2723,2534
0132-000,2016,6,10,20,1224,873,2097,2723
0132-000,2016,6,10,21,986,644,1630,2097
0132-000,2016,6,10,22,736,525,1261,1630
0132-000,2016,6,10,23,480,463,943,1261
0132-000,2016,6,10,24,327,315,642,943
0132-000,2016,6,11,1,235,203,438,642
0132-000,2016,6,11,2,185,167,352,438
0132-000,2016,6,11,3,122,116,238,352
0132-000,2016,6,11,4,96,126,222,238
0132-000,2016,6,11,5,130,160,290,222
0132-000,2016,6,11,6,300,232,532,290
0132-000,2016,6,11,7,450,444,894,532
0132-000,2016,6,11,8,563,894,1457,894
0132-000,2016,6,11,9,700,1010,1710,1457
0132-000,2016,6,11,10,815,1069,1884,1710
0132-000,2016,6,11,11,785,1133,1918,1884
0132-000,2016,6,11,12,896,1049,1945,1918
0132-000,2016,6,11,13,925,972,1897,1945
0132-000,2016,6,11,14,918,915,1833,1897
0132-000,2016,6,11,15,882,944,1826,1833
0132-000,2016,6,11,16,1012,873,1885,1826
0132-000,2016,6,11,17,1055,936,1991,1885
0132-000,2016,6,11,18,1380,1046,2426,1991
0132-000,2016,6,11,19,1326,938,2264,2426
0132-000,2016,6,11,20,897,713,1610,2264
0132-000,2016,6,11,21,745,613,1358,1610
0132-000,2016,6,11,22,561,477,1038,1358
0132-000,2016,6,11,23,392,380,772,1038
0132-000,2016,6,11,24,284,311,595,772
0132-000,2016,6,12,1,183,198,381,595
0132-000,2016,6,12,2,144,166,310,381
0132-000,2016,6,12,3,109,100,209,310
0132-000,2016,6,12,4,79,83,162,209
0132-000,2016,6,12,5,92,93,185,162
0132-000,2016,6,12,6,205,150,355,185
0132-000,2016,6,12,7,270,258,528,355
0132-000,2016,6,12,8,263,353,616,528
0132-000,2016,6,12,9,405,478,883,616
0132-000,2016,6,12,10,465,584,1049,883
0132-000,2016,6,12,11,577,594,1171,1049
0132-000,2016,6,12,12,619,565,1184,1171
0132-000,2016,6,12,13,641,628,1269,1184
0132-000,2016,6,12,14,703,701,1404,1269
0132-000,2016,6,12,15,811,675,1486,1404
0132-000,2016,6,12,16,840,708,1548,1486
0132-000,2016,6,12,17,924,692,1616,1548
0132-000,2016,6,12,18,962,720,1682,1616
0132-000,2016,6,12,19,935,651,1586,1682
0132-000,2016,6,12,20,731,528,1259,1586
0132-000,2016,6,12,21,606,483,1089,1259
0132-000,2016,6,12,22,437,428,865,1089
0132-000,2016,6,12,23,323,339,662,865
0132-000,2016,6,12,24,195,190,385,662
0132-000,2016,6,13,1,124,125,249,385
0132-000,2016,6,13,2,81,96,177,249
0132-000,2016,6,13,3,70,62,132,177
0132-000,2016,6,13,4,47,76,123,132
0132-000,2016,6,13,5,104,111,215,123
0132-000,2016,6,13,6,319,253,572,215
0132-000,2016,6,13,7,538,752,1290,572
0132-000,2016,6,13,8,713,1831,2544,1290
0132-000,2016,6,13,9,909,1579,2488,2544
0132-000,2016,6,13,10,842,969,1811,2488
0132-000,2016,6,13,11,829,831,1660,1811
0132-000,2016,6,13,12,745,809,1554,1660
0132-000,2016,6,13,13,817,784,1601,1554
0132-000,2016,6,13,14,853,855,1708,1601
0132-000,2016,6,13,15,929,853,1782,1708
0132-000,2016,6,13,16,954,814,1768,1782
0132-000,2016,6,13,17,980,890,1870,1768
0132-000,2016,6,13,18,1247,950,2197,1870
0132-000,2016,6,13,19,1553,916,2469,2197
0132-000,2016,6,13,20,996,779,1775,2469
0132-000,2016,6,13,21,929,586,1515,1775
0132-000,2016,6,13,22,671,430,1101,1515
0132-000,2016,6,13,23,377,346,723,1101
0132-000,2016,6,13,24,216,209,425,723
0132-000,2016,6,14,1,149,153,302,425
0132-000,2016,6,14,2,113,91,204,302
0132-000,2016,6,14,3,71,85,156,204
0132-000,2016,6,14,4,83,86,169,156
0132-000,2016,6,14,5,119,127,246,169
0132-000,2016,6,14,6,318,218,536,246
0132-000,2016,6,14,7,550,603,1153,536
0132-000,2016,6,14,8,702,1821,2523,1153
0132-000,2016,6,14,9,857,1562,2419,2523
0132-000,2016,6,14,10,887,913,1800,2419
0132-000,2016,6,14,11,832,860,1692,1800
0132-000,2016,6,14,12,852,864,1716,1692
0132-000,2016,6,14,13,779,779,1558,1716
0132-000,2016,6,14,14,863,715,1578,1558
0132-000,2016,6,14,15,889,661,1550,1578
0132-000,2016,6,14,16,914,707,1621,1550
0132-000,2016,6,14,17,978,713,1691,1621
0132-000,2016,6,14,18,1311,631,1942,1691
0132-000,2016,6,14,19,1513,489,2002,1942
0132-000,2016,6,14,20,1094,667,1761,2002
0132-000,2016,6,14,21,896,588,1484,1761
0132-000,2016,6,14,22,673,506,1179,1484
0132-000,2016,6,14,23,420,365,785,1179
0132-000,2016,6,14,24,268,232,500,785
0132-000,2016,6,15,1,159,168,327,500
0132-000,2016,6,15,2,92,92,184,327
0132-000,2016,6,15,3,65,92,157,184
0132-000,2016,6,15,4,72,89,161,157
0132-000,2016,6,15,5,113,115,228,161
0132-000,2016,6,15,6,266,191,457,228
0132-000,2016,6,15,7,505,540,1045,457
0132-000,2016,6,15,8,662,1693,2355,1045
0132-000,2016,6,15,9,919,1610,2529,2355
0132-000,2016,6,15,10,863,1002,1865,2529
0132-000,2016,6,15,11,871,891,1762,1865
0132-000,2016,6,15,12,836,858,1694,1762
0132-000,2016,6,15,13,746,802,1548,1694
0132-000,2016,6,15,14,889,817,1706,1548
0132-000,2016,6,15,15,915,831,1746,1706
0132-000,2016,6,15,16,962,810,1772,1746
0132-000,2016,6,15,17,1005,801,1806,1772
0132-000,2016,6,15,18,1314,862,2176,1806
0132-000,2016,6,15,19,1589,910,2499,2176
0132-000,2016,6,15,20,948,719,1667,2499
0132-000,2016,6,15,21,793,558,1351,1667
0132-000,2016,6,15,22,609,425,1034,1351
0132-000,2016,6,15,23,430,325,755,1034
0132-000,2016,6,15,24,257,263,520,755
0132-000,2016,6,16,1,201,191,392,520
0132-000,2016,6,16,2,108,113,221,392
0132-000,2016,6,16,3,96,97,193,221
0132-000,2016,6,16,4,77,106,183,193
0132-000,2016,6,16,5,115,120,235,183
0132-000,2016,6,16,6,292,222,514,235
0132-000,2016,6,16,7,498,591,1089,514
0132-000,2016,6,16,8,655,1066,1721,1089
0132-000,2016,6,16,9,850,934,1784,1721
0132-000,2016,6,16,10,776,786,1562,1784
0132-000,2016,6,16,11,848,756,1604,1562
0132-000,2016,6,16,12,934,878,1812,1604
0132-000,2016,6,16,13,822,796,1618,1812
0132-000,2016,6,16,14,896,811,1707,1618
0132-000,2016,6,16,15,919,878,1797,1707
0132-000,2016,6,16,16,966,778,1744,1797
0132-000,2016,6,16,17,1014,791,1805,1744
0132-000,2016,6,16,18,1307,917,2224,1805
0132-000,2016,6,16,19,1517,931,2448,2224
0132-000,2016,6,16,20,1143,781,1924,2448
0132-000,2016,6,16,21,987,571,1558,1924
0132-000,2016,6,16,22,732,542,1274,1558
0132-000,2016,6,16,23,465,409,874,1274
0132-000,2016,6,16,24,265,258,523,874
0132-000,2016,6,17,1,196,193,389,523
0132-000,2016,6,17,2,129,105,234,389
0132-000,2016,6,17,3,85,120,205,234
0132-000,2016,6,17,4,87,94,181,205
0132-000,2016,6,17,5,120,115,235,181
0132-000,2016,6,17,6,336,227,563,235
0132-000,2016,6,17,7,550,631,1181,563
0132-000,2016,6,17,8,694,1813,2507,1181
0132-000,2016,6,17,9,886,1361,2247,2507
0132-000,2016,6,17,10,861,811,1672,2247
0132-000,2016,6,17,11,810,888,1698,1672
0132-000,2016,6,17,12,823,930,1753,1698
0132-000,2016,6,17,13,814,865,1679,1753
0132-000,2016,6,17,14,894,865,1759,1679
0132-000,2016,6,17,15,949,842,1791,1759
0132-000,2016,6,17,16,1006,798,1804,1791
0132-000,2016,6,17,17,1048,957,2005,1804
0132-000,2016,6,17,18,1474,1071,2545,2005
0132-000,2016,6,17,19,1754,945,2699,2545
0132-000,2016,6,17,20,1343,933,2276,2699
0132-000,2016,6,17,21,980,663,1643,2276
0132-000,2016,6,17,22,702,563,1265,1643
0132-000,2016,6,17,23,464,444,908,1265
0132-000,2016,6,17,24,294,300,594,908
0132-000,2016,6,18,1,202,215,417,594
0132-000,2016,6,18,2,158,161,319,417
0132-000,2016,6,18,3,106,121,227,319
0132-000,2016,6,18,4,101,132,233,227
0132-000,2016,6,18,5,137,135,272,233
0132-000,2016,6,18,6,317,219,536,272
0132-000,2016,6,18,7,479,471,950,536
0132-000,2016,6,18,8,595,903,1498,950
0132-000,2016,6,18,9,655,1027,1682,1498
0132-000,2016,6,18,10,845,1025,1870,1682
0132-000,2016,6,18,11,853,1075,1928,1870
0132-000,2016,6,18,12,812,1183,1995,1928
0132-000,2016,6,18,13,880,1032,1912,1995
0132-000,2016,6,18,14,898,910,1808,1912
0132-000,2016,6,18,15,928,968,1896,1808
0132-000,2016,6,18,16,989,941,1930,1896
0132-000,2016,6,18,17,1113,986,2099,1930
0132-000,2016,6,18,18,1384,1083,2467,2099
0132-000,2016,6,18,19,1264,958,2222,2467
0132-000,2016,6,18,20,880,765,1645,2222
0132-000,2016,6,18,21,712,537,1249,1645
0132-000,2016,6,18,22,571,476,1047,1249
0132-000,2016,6,18,23,418,412,830,1047
0132-000,2016,6,18,24,248,273,521,830
0132-000,2016,6,19,1,188,200,388,521
0132-000,2016,6,19,2,155,168,323,388
0132-000,2016,6,19,3,89,90,179,323
0132-000,2016,6,19,4,100,102,202,179
0132-000,2016,6,19,5,111,122,233,202
0132-000,2016,6,19,6,235,189,424,233
0132-000,2016,6,19,7,282,288,570,424
0132-000,2016,6,19,8,303,424,727,570
0132-000,2016,6,19,9,446,511,957,727
0132-000,2016,6,19,10,535,609,1144,957
0132-000,2016,6,19,11,542,627,1169,1144
0132-000,2016,6,19,12,616,651,1267,1169
0132-000,2016,6,19,13,700,680,1380,1267
0132-000,2016,6,19,14,824,692,1516,1380
0132-000,2016,6,19,15,755,742,1497,1516
0132-000,2016,6,19,16,1102,766,1868,1497
0132-000,2016,6,19,17,1134,764,1898,1868
0132-000,2016,6,19,18,1202,793,1995,1898
0132-000,2016,6,19,19,1191,673,1864,1995
0132-000,2016,6,19,20,925,589,1514,1864
0132-000,2016,6,19,21,705,519,1224,1514
0132-000,2016,6,19,22,547,436,983,1224
0132-000,2016,6,19,23,383,310,693,983
0132-000,2016,6,19,24,207,212,419,693
0132-000,2016,6,20,1,136,158,294,419
0132-000,2016,6,20,2,75,85,160,294
0132-000,2016,6,20,3,56,71,127,160
0132-000,2016,6,20,4,70,88,158,127
0132-000,2016,6,20,5,115,122,237,158
0132-000,2016,6,20,6,343,227,570,237
0132-000,2016,6,20,7,565,707,1272,570
0132-000,2016,6,20,8,685,1843,2528,1272
0132-000,2016,6,20,9,893,1524,2417,2528
0132-000,2016,6,20,10,809,868,1677,2417
0132-000,2016,6,20,11,829,875,1704,1677
0132-000,2016,6,20,12,768,836,1604,1704
0132-000,2016,6,20,13,784,807,1591,1604
0132-000,2016,6,20,14,902,923,1825,1591
0132-000,2016,6,20,15,856,882,1738,1825
0132-000,2016,6,20,16,983,819,1802,1738
0132-000,2016,6,20,17,995,820,1815,1802
0132-000,2016,6,20,18,1306,988,2294,1815
0132-000,2016,6,20,19,1522,956,2478,2294
0132-000,2016,6,20,20,1086,725,1811,2478
0132-000,2016,6,20,21,963,593,1556,1811
0132-000,2016,6,20,22,717,439,1156,1556
0132-000,2016,6,20,23,389,401,790,1156
0132-000,2016,6,20,24,240,229,469,790
0132-000,2016,6,21,1,167,127,294,469
0132-000,2016,6,21,2,99,102,201,294
0132-000,2016,6,21,3,89,92,181,201
0132-000,2016,6,21,4,68,93,161,181
0132-000,2016,6,21,5,109,134,243,161
0132-000,2016,6,21,6,315,202,517,243
0132-000,2016,6,21,7,530,623,1153,517
0132-000,2016,6,21,8,678,1841,2519,1153
0132-000,2016,6,21,9,819,1511,2330,2519
0132-000,2016,6,21,10,835,892,1727,2330
0132-000,2016,6,21,11,827,822,1649,1727
0132-000,2016,6,21,12,899,815,1714,1649
0132-000,2016,6,21,13,773,800,1573,1714
0132-000,2016,6,21,14,866,866,1732,1573
0132-000,2016,6,21,15,935,840,1775,1732
0132-000,2016,6,21,16,926,857,1783,1775
0132-000,2016,6,21,17,1025,871,1896,1783
0132-000,2016,6,21,18,1274,1013,2287,1896
0132-000,2016,6,21,19,1483,927,2410,2287
0132-000,2016,6,21,20,1092,778,1870,2410
0132-000,2016,6,21,21,905,602,1507,1870
0132-000,2016,6,21,22,660,458,1118,1507
0132-000,2016,6,21,23,413,370,783,1118
0132-000,2016,6,21,24,236,240,476,783
0132-000,2016,6,22,1,189,167,356,476
0132-000,2016,6,22,2,104,113,217,356
0132-000,2016,6,22,3,96,104,200,217
0132-000,2016,6,22,4,92,100,192,200
0132-000,2016,6,22,5,95,128,223,192
0132-000,2016,6,22,6,291,188,479,223
0132-000,2016,6,22,7,475,576,1051,479
0132-000,2016,6,22,8,653,1774,2427,1051
0132-000,2016,6,22,9,885,1502,2387,2427
0132-000,2016,6,22,10,831,884,1715,2387
0132-000,2016,6,22,11,810,853,1663,1715
0132-000,2016,6,22,12,839,852,1691,1663
0132-000,2016,6,22,13,759,778,1537,1691
0132-000,2016,6,22,14,822,833,1655,1537
0132-000,2016,6,22,15,939,897,1836,1655
0132-000,2016,6,22,16,909,884,1793,1836
0132-000,2016,6,22,17,959,837,1796,1793
0132-000,2016,6,22,18,1356,933,2289,1796
0132-000,2016,6,22,19,1532,877,2409,2289
0132-000,2016,6,22,20,1007,755,1762,2409
0132-000,2016,6,22,21,800,556,1356,1762
0132-000,2016,6,22,22,643,445,1088,1356
0132-000,2016,6,22,23,374,340,714,1088
0132-000,2016,6,22,24,241,251,492,714
0132-000,2016,6,23,1,172,168,340,492
0132-000,2016,6,23,2,125,123,248,340
0132-000,2016,6,23,3,90,116,206,248
0132-000,2016,6,23,4,75,100,175,206
0132-000,2016,6,23,5,110,124,234,175
0132-000,2016,6,23,6,331,222,553,234
0132-000,2016,6,23,7,495,639,1134,553
0132-000,2016,6,23,8,706,1816,2522,1134
0132-000,2016,6,23,9,874,1481,2355,2522
0132-000,2016,6,23,10,880,891,1771,2355
0132-000,2016,6,23,11,820,875,1695,1771
0132-000,2016,6,23,12,847,932,1779,1695
0132-000,2016,6,23,13,785,748,1533,1779
0132-000,2016,6,23,14,894,822,1716,1533
0132-000,2016,6,23,15,871,916,1787,1716
0132-000,2016,6,23,16,983,837,1820,1787
0132-000,2016,6,23,17,998,906,1904,1820
0132-000,2016,6,23,18,1276,1025,2301,1904
0132-000,2016,6,23,19,1588,884,2472,2301
0132-000,2016,6,23,20,1074,741,1815,2472
0132-000,2016,6,23,21,898,585,1483,1815
0132-000,2016,6,23,22,679,486,1165,1483
0132-000,2016,6,23,23,440,379,819,1165
0132-000,2016,6,23,24,271,226,497,819
0132-000,2016,6,24,1,159,159,318,497
0132-000,2016,6,24,2,113,108,221,318
0132-000,2016,6,24,3,72,114,186,221
0132-000,2016,6,24,4,76,94,170,186
0132-000,2016,6,24,5,87,93,180,170
0132-000,2016,6,24,6,226,179,405,180
0132-000,2016,6,24,7,430,549,979,405
0132-000,2016,6,24,8,559,1618,2177,979
0132-000,2016,6,24,9,805,1474,2279,2177
0132-000,2016,6,24,10,772,867,1639,2279
0132-000,2016,6,24,11,761,822,1583,1639
0132-000,2016,6,24,12,806,878,1684,1583
0132-000,2016,6,24,13,793,863,1656,1684
0132-000,2016,6,24,14,910,864,1774,1656
0132-000,2016,6,24,15,963,938,1901,1774
0132-000,2016,6,24,16,1008,901,1909,1901
0132-000,2016,6,24,17,975,858,1833,1909
0132-000,2016,6,24,18,1353,977,2330,1833
0132-000,2016,6,24,19,1731,987,2718,2330
0132-000,2016,6,24,20,1150,801,1951,2718
0132-000,2016,6,24,21,958,595,1553,1951
0132-000,2016,6,24,22,666,516,1182,1553
0132-000,2016,6,24,23,433,409,842,1182
0132-000,2016,6,24,24,276,303,579,842
0132-000,2016,6,25,1,218,229,447,579
0132-000,2016,6,25,2,146,155,301,447
0132-000,2016,6,25,3,118,112,230,301
0132-000,2016,6,25,4,84,141,225,230
0132-000,2016,6,25,5,149,156,305,225
0132-000,2016,6,25,6,316,227,543,305
0132-000,2016,6,25,7,428,469,897,543
0132-000,2016,6,25,8,544,873,1417,897
0132-000,2016,6,25,9,755,934,1689,1417
0132-000,2016,6,25,10,776,975,1751,1689
0132-000,2016,6,25,11,859,1029,1888,1751
0132-000,2016,6,25,12,923,1111,2034,1888
0132-000,2016,6,25,13,890,1060,1950,2034
0132-000,2016,6,25,14,906,1090,1996,1950
0132-000,2016,6,25,15,903,956,1859,1996
0132-000,2016,6,25,16,929,930,1859,1859
0132-000,2016,6,25,17,1025,987,2012,1859
0132-000,2016,6,25,18,1289,1050,2339,2012
0132-000,2016,6,25,19,1277,1096,2373,2339
0132-000,2016,6,25,20,875,745,1620,2373
0132-000,2016,6,25,21,745,579,1324,1620
0132-000,2016,6,25,22,527,478,1005,1324
0132-000,2016,6,25,23,405,391,796,1005
0132-000,2016,6,25,24,265,231,496,796
0132-000,2016,6,26,1,198,202,400,496
0132-000,2016,6,26,2,138,135,273,400
0132-000,2016,6,26,3,95,120,215,273
0132-000,2016,6,26,4,88,108,196,215
0132-000,2016,6,26,5,115,133,248,196
0132-000,2016,6,26,6,246,173,419,248
0132-000,2016,6,26,7,269,304,573,419
0132-000,2016,6,26,8,294,456,750,573
0132-000,2016,6,26,9,420,544,964,750
0132-000,2016,6,26,10,526,572,1098,964
0132-000,2016,6,26,11,598,634,1232,1098
0132-000,2016,6,26,12,618,718,1336,1232
0132-000,2016,6,26,13,677,629,1306,1336
0132-000,2016,6,26,14,711,735,1446,1306
0132-000,2016,6,26,15,785,655,1440,1446
0132-000,2016,6,26,16,897,708,1605,1440
0132-000,2016,6,26,17,935,752,1687,1605
0132-000,2016,6,26,18,1079,689,1768,1687
0132-000,2016,6,26,19,1020,655,1675,1768
0132-000,2016,6,26,20,809,595,1404,1675
0132-000,2016,6,26,21,688,484,1172,1404
0132-000,2016,6,26,22,553,438,991,1172
0132-000,2016,6,26,23,329,322,651,991
0132-000,2016,6,26,24,192,215,407,651
0132-000,2016,6,27,1,119,136,255,407
0132-000,2016,6,27,2,88,84,172,255
0132-000,2016,6,27,3,53,80,133,172
0132-000,2016,6,27,4,55,70,125,133
0132-000,2016,6,27,5,101,108,209,125
0132-000,2016,6,27,6,373,227,600,209
0132-000,2016,6,27,7,570,757,1327,600
0132-000,2016,6,27,8,719,1901,2620,1327
0132-000,2016,6,27,9,822,1485,2307,2620
0132-000,2016,6,27,10,798,840,1638,2307
0132-000,2016,6,27,11,815,877,1692,1638
0132-000,2016,6,27,12,816,835,1651,1692
0132-000,2016,6,27,13,797,799,1596,1651
0132-000,2016,6,27,14,799,828,1627,1596
0132-000,2016,6,27,15,914,928,1842,1627
0132-000,2016,6,27,16,973,846,1819,1842
0132-000,2016,6,27,17,975,866,1841,1819
0132-000,2016,6,27,18,1243,944,2187,1841
0132-000,2016,6,27,19,1449,979,2428,2187
0132-000,2016,6,27,20,1037,804,1841,2428
0132-000,2016,6,27,21,937,588,1525,1841
0132-000,2016,6,27,22,649,457,1106,1525
0132-000,2016,6,27,23,398,326,724,1106
0132-000,2016,6,27,24,226,189,415,724
0132-000,2016,6,28,1,142,136,278,415
0132-000,2016,6,28,2,87,87,174,278
0132-000,2016,6,28,3,76,83,159,174
0132-000,2016,6,28,4,74,87,161,159
0132-000,2016,6,28,5,110,117,227,161
0132-000,2016,6,28,6,338,208,546,227
0132-000,2016,6,28,7,471,626,1097,546
0132-000,2016,6,28,8,654,1826,2480,1097
0132-000,2016,6,28,9,879,1476,2355,2480
0132-000,2016,6,28,10,828,870,1698,2355
0132-000,2016,6,28,11,819,831,1650,1698
0132-000,2016,6,28,12,785,868,1653,1650
0132-000,2016,6,28,13,757,745,1502,1653
0132-000,2016,6,28,14,800,815,1615,1502
0132-000,2016,6,28,15,869,832,1701,1615
0132-000,2016,6,28,16,966,796,1762,1701
0132-000,2016,6,28,17,918,843,1761,1762
0132-000,2016,6,28,18,1203,945,2148,1761
0132-000,2016,6,28,19,1470,935,2405,2148
0132-000,2016,6,28,20,1012,761,1773,2405
0132-000,2016,6,28,21,905,595,1500,1773
0132-000,2016,6,28,22,684,468,1152,1500
0132-000,2016,6,28,23,414,370,784,1152
0132-000,2016,6,28,24,229,234,463,784
0132-000,2016,6,29,1,176,142,318,463
0132-000,2016,6,29,2,101,108,209,318
0132-000,2016,6,29,3,82,106,188,209
0132-000,2016,6,29,4,79,100,179,188
0132-000,2016,6,29,5,125,129,254,179
0132-000,2016,6,29,6,310,221,531,254
0132-000,2016,6,29,7,522,599,1121,531
0132-000,2016,6,29,8,684,1774,2458,1121
0132-000,2016,6,29,9,884,1479,2363,2458
0132-000,2016,6,29,10,855,887,1742,2363
0132-000,2016,6,29,11,788,846,1634,1742
0132-000,2016,6,29,12,807,914,1721,1634
0132-000,2016,6,29,13,796,782,1578,1721
0132-000,2016,6,29,14,798,810,1608,1578
0132-000,2016,6,29,15,889,873,1762,1608
0132-000,2016,6,29,16,969,803,1772,1762
0132-000,2016,6,29,17,955,850,1805,1772
0132-000,2016,6,29,18,1303,948,2251,1805
0132-000,2016,6,29,19,1538,864,2402,2251
0132-000,2016,6,29,20,1047,769,1816,2402
0132-000,2016,6,29,21,841,615,1456,1816
0132-000,2016,6,29,22,612,503,1115,1456
0132-000,2016,6,29,23,378,375,753,1115
0132-000,2016,6,29,24,267,246,513,753
0132-000,2016,6,30,1,170,183,353,513
0132-000,2016,6,30,2,111,120,231,353
0132-000,2016,6,30,3,95,102,197,231
0132-000,2016,6,30,4,82,72,154,197
0132-000,2016,6,30,5,128,115,243,154
0132-000,2016,6,30,6,317,218,535,243
0132-000,2016,6,30,7,513,584,1097,535
0132-000,2016,6,30,8,714,1779,2493,1097
0132-000,2016,6,30,9,897,1546,2443,2493
0132-000,2016,6,30,10,823,872,1695,2443
0132-000,2016,6,30,11,837,903,1740,1695
0132-000,2016,6,30,12,756,831,1587,1740
0132-000,2016,6,30,13,800,761,1561,1587
0132-000,2016,6,30,14,852,823,1675,1561
0132-000,2016,6,30,15,917,846,1763,1675
0132-000,2016,6,30,16,904,864,1768,1763
0132-000,2016,6,30,17,1005,903,1908,1768
0132-000,2016,6,30,18,1311,1017,2328,1908
0132-000,2016,6,30,19,1499,930,2429,2328
0132-000,2016,6,30,20,1060,772,1832,2429
0132-000,2016,6,30,21,886,611,1497,1832
0132-000,2016,6,30,22,696,474,1170,1497
0132-000,2016,6,30,23,415,410,825,1170
0132-000,2016,6,30,24,280,247,527,825
0132-000,2016,7,1,1,206,173,379,527
0132-000,2016,7,1,2,118,113,231,379
0132-000,2016,7,1,3,94,106,200,231
0132-000,2016,7,1,4,82,110,192,200
0132-000,2016,7,1,5,126,130,256,192
0132-000,2016,7,1,6,314,207,521,256
0132-000,2016,7,1,7,482,570,1052,521
0132-000,2016,7,1,8,669,1768,2437,1052
0132-000,2016,7,1,9,920,1464,2384,2437
0132-000,2016,7,1,10,834,894,1728,2384
0132-000,2016,7,1,11,776,875,1651,1728
0132-000,2016,7,1,12,831,858,1689,1651
0132-000,2016,7,1,13,816,778,1594,1689
0132-000,2016,7,1,14,875,908,1783,1594
0132-000,2016,7,1,15,875,867,1742,1783
0132-000,2016,7,1,16,1017,876,1893,1742
0132-000,2016,7,1,17,1122,938,2060,1893
0132-000,2016,7,1,18,1501,1088,2589,2060
0132-000,2016,7,1,19,1830,1025,2855,2589
0132-000,2016,7,1,20,1605,810,2415,2855
0132-000,2016,7,1,21,1010,599,1609,2415
0132-000,2016,7,1,22,756,502,1258,1609
0132-000,2016,7,1,23,409,340,749,1258
0132-000,2016,7,1,24,251,267,518,749
0132-000,2016,7,2,1,164,220,384,518
0132-000,2016,7,2,2,133,133,266,384
0132-000,2016,7,2,3,98,104,202,266
0132-000,2016,7,2,4,81,99,180,202
0132-000,2016,7,2,5,98,104,202,180
0132-000,2016,7,2,6,227,182,409,202
0132-000,2016,7,2,7,356,391,747,409
0132-000,2016,7,2,8,476,781,1257,747
0132-000,2016,7,2,9,692,852,1544,1257
0132-000,2016,7,2,10,727,844,1571,1544
0132-000,2016,7,2,11,774,882,1656,1571
0132-000,2016,7,2,12,822,1026,1848,1656
0132-000,2016,7,2,13,910,971,1881,1848
0132-000,2016,7,2,14,898,962,1860,1881
0132-000,2016,7,2,15,979,979,1958,1860
0132-000,2016,7,2,16,965,962,1927,1958
0132-000,2016,7,2,17,1019,954,1973,1927
0132-000,2016,7,2,18,1350,1008,2358,1973
0132-000,2016,7,2,19,1143,946,2089,2358
0132-000,2016,7,2,20,756,676,1432,2089
0132-000,2016,7,2,21,677,551,1228,1432
0132-000,2016,7,2,22,619,440,1059,1228
0132-000,2016,7,2,23,402,376,778,1059
0132-000,2016,7,2,24,233,241,474,778
0132-000,2016,7,3,1,158,185,343,474
0132-000,2016,7,3,2,125,127,252,343
0132-000,2016,7,3,3,108,122,230,252
0132-000,2016,7,3,4,83,95,178,230
0132-000,2016,7,3,5,76,95,171,178
0132-000,2016,7,3,6,209,128,337,171
0132-000,2016,7,3,7,241,250,491,337
0132-000,2016,7,3,8,257,349,606,491
0132-000,2016,7,3,9,351,434,785,606
0132-000,2016,7,3,10,454,518,972,785
0132-000,2016,7,3,11,599,613,1212,972
0132-000,2016,7,3,12,614,698,1312,1212
0132-000,2016,7,3,13,635,723,1358,1312
0132-000,2016,7,3,14,728,776,1504,1358
0132-000,2016,7,3,15,892,732,1624,1504
0132-000,2016,7,3,16,1028,789,1817,1624
0132-000,2016,7,3,17,1385,754,2139,1817
0132-000,2016,7,3,18,1349,733,2082,2139
0132-000,2016,7,3,19,1196,616,1812,2082
0132-000,2016,7,3,20,828,537,1365,1812
0132-000,2016,7,3,21,627,505,1132,1365
0132-000,2016,7,3,22,543,412,955,1132
0132-000,2016,7,3,23,305,319,624,955
0132-000,2016,7,3,24,184,221,405,624
0132-000,2016,7,4,1,104,129,233,405
0132-000,2016,7,4,2,77,88,165,233
0132-000,2016,7,4,3,57,61,118,165
0132-000,2016,7,4,4,52,77,129,118
0132-000,2016,7,4,5,72,80,152,129
0132-000,2016,7,4,6,239,217,456,152
0132-000,2016,7,4,7,436,636,1072,456
0132-000,2016,7,4,8,642,1826,2468,1072
0132-000,2016,7,4,9,840,1557,2397,2468
0132-000,2016,7,4,10,820,879,1699,2397
0132-000,2016,7,4,11,750,795,1545,1699
0132-000,2016,7,4,12,742,811,1553,1545
0132-000,2016,7,4,13,766,854,1620,1553
0132-000,2016,7,4,14,821,797,1618,1620
0132-000,2016,7,4,15,857,802,1659,1618
0132-000,2016,7,4,16,845,784,1629,1659
0132-000,2016,7,4,17,877,811,1688,1629
0132-000,2016,7,4,18,1153,791,1944,1688
0132-000,2016,7,4,19,1414,865,2279,1944
0132-000,2016,7,4,20,961,628,1589,2279
0132-000,2016,7,4,21,790,512,1302,1589
0132-000,2016,7,4,22,563,378,941,1302
0132-000,2016,7,4,23,326,310,636,941
0132-000,2016,7,4,24,186,162,348,636
0132-000,2016,7,5,1,126,129,255,348
0132-000,2016,7,5,2,102,91,193,255
0132-000,2016,7,5,3,61,84,145,193
0132-000,2016,7,5,4,58,78,136,145
0132-000,2016,7,5,5,79,77,156,136
0132-000,2016,7,5,6,194,155,349,156
0132-000,2016,7,5,7,388,479,867,349
0132-000,2016,7,5,8,664,1761,2425,867
0132-000,2016,7,5,9,835,1515,2350,2425
0132-000,2016,7,5,10,756,812,1568,2350
0132-000,2016,7,5,11,785,846,1631,1568
0132-000,2016,7,5,12,741,768,1509,1631
0132-000,2016,7,5,13,755,778,1533,1509
0132-000,2016,7,5,14,811,767,1578,1533
0132-000,2016,7,5,15,832,888,1720,1578
0132-000,2016,7,5,16,890,788,1678,1720
0132-000,2016,7,5,17,922,789,1711,1678
0132-000,2016,7,5,18,1085,802,1887,1711
0132-000,2016,7,5,19,1426,877,2303,1887
0132-000,2016,7,5,20,972,718,1690,2303
0132-000,2016,7,5,21,851,514,1365,1690
0132-000,2016,7,5,22,580,446,1026,1365
0132-000,2016,7,5,23,396,313,709,1026
0132-000,2016,7,5,24,188,197,385,709
0132-000,2016,7,6,1,187,148,335,385
0132-000,2016,7,6,2,100,100,200,335
0132-000,2016,7,6,3,69,100,169,200
0132-000,2016,7,6,4,62,87,149,169
0132-000,2016,7,6,5,85,96,181,149
0132-000,2016,7,6,6,219,175,394,181
0132-000,2016,7,6,7,398,512,910,394
0132-000,2016,7,6,8,608,1708,2316,910
0132-000,2016,7,6,9,826,1546,2372,2316
0132-000,2016,7,6,10,856,861,1717,2372
0132-000,2016,7,6,11,781,895,1676,1717
0132-000,2016,7,6,12,800,869,1669,1676
0132-000,2016,7,6,13,777,787,1564,1669
0132-000,2016,7,6,14,845,777,1622,1564
0132-000,2016,7,6,15,846,875,1721,1622
0132-000,2016,7,6,16,935,882,1817,1721
0132-000,2016,7,6,17,987,860,1847,1817
0132-000,2016,7,6,18,1298,871,2169,1847
0132-000,2016,7,6,19,1531,838,2369,2169
0132-000,2016,7,6,20,951,707,1658,2369
0132-000,2016,7,6,21,811,537,1348,1658
0132-000,2016,7,6,22,613,428,1041,1348
0132-000,2016,7,6,23,382,337,719,1041
0132-000,2016,7,6,24,258,231,489,719
0132-000,2016,7,7,1,151,168,319,489
0132-000,2016,7,7,2,96,105,201,319
0132-000,2016,7,7,3,81,107,188,201
0132-000,2016,7,7,4,79,83,162,188
0132-000,2016,7,7,5,84,99,183,162
0132-000,2016,7,7,6,263,171,434,183
0132-000,2016,7,7,7,431,539,970,434
0132-000,2016,7,7,8,646,1774,2420,970
0132-000,2016,7,7,9,850,1441,2291,2420
0132-000,2016,7,7,10,788,858,1646,2291
0132-000,2016,7,7,11,775,868,1643,1646
0132-000,2016,7,7,12,838,816,1654,1643
0132-000,2016,7,7,13,764,795,1559,1654
0132-000,2016,7,7,14,853,757,1610,1559
0132-000,2016,7,7,15,897,868,1765,1610
0132-000,2016,7,7,16,990,882,1872,1765
0132-000,2016,7,7,17,985,870,1855,1872
0132-000,2016,7,7,18,1198,916,2114,1855
0132-000,2016,7,7,19,1511,928,2439,2114
0132-000,2016,7,7,20,983,711,1694,2439
0132-000,2016,7,7,21,854,565,1419,1694
0132-000,2016,7,7,22,631,449,1080,1419
0132-000,2016,7,7,23,384,367,751,1080
0132-000,2016,7,7,24,249,247,496,751
0132-000,2016,7,8,1,172,159,331,496
0132-000,2016,7,8,2,124,112,236,331
0132-000,2016,7,8,3,91,107,198,236
0132-000,2016,7,8,4,78,94,172,198
0132-000,2016,7,8,5,134,121,255,172
0132-000,2016,7,8,6,292,236,528,255
0132-000,2016,7,8,7,516,639,1155,528
0132-000,2016,7,8,8,695,1813,2508,1155
0132-000,2016,7,8,9,852,1511,2363,2508
0132-000,2016,7,8,10,880,886,1766,2363
0132-000,2016,7,8,11,835,822,1657,1766
0132-000,2016,7,8,12,870,837,1707,1657
0132-000,2016,7,8,13,745,801,1546,1707
0132-000,2016,7,8,14,870,817,1687,1546
0132-000,2016,7,8,15,918,902,1820,1687
0132-000,2016,7,8,16,912,864,1776,1820
0132-000,2016,7,8,17,1052,902,1954,1776
0132-000,2016,7,8,18,1386,1056,2442,1954
0132-000,2016,7,8,19,1777,1111,2888,2442
0132-000,2016,7,8,20,1166,883,2049,2888
0132-000,2016,7,8,21,915,720,1635,2049
0132-000,2016,7,8,22,715,566,1281,1635
0132-000,2016,7,8,23,447,405,852,1281
0132-000,2016,7,8,24,311,283,594,852
0132-000,2016,7,9,1,213,202,415,594
0132-000,2016,7,9,2,147,160,307,415
0132-000,2016,7,9,3,102,143,245,307
0132-000,2016,7,9,4,107,144,251,245
0132-000,2016,7,9,5,122,148,270,251
0132-000,2016,7,9,6,320,201,521,270
0132-000,2016,7,9,7,433,505,938,521
0132-000,2016,7,9,8,523,959,1482,938
0132-000,2016,7,9,9,742,976,1718,1482
0132-000,2016,7,9,10,785,1035,1820,1718
0132-000,2016,7,9,11,813,1218,2031,1820
0132-000,2016,7,9,12,843,1270,2113,2031
0132-000,2016,7,9,13,890,1225,2115,2113
0132-000,2016,7,9,14,844,970,1814,2115
0132-000,2016,7,9,15,916,881,1797,1814
0132-000,2016,7,9,16,957,974,1931,1797
0132-000,2016,7,9,17,982,961,1943,1931
0132-000,2016,7,9,18,1272,1062,2334,1943
0132-000,2016,7,9,19,1237,967,2204,2334
0132-000,2016,7,9,20,832,699,1531,2204
0132-000,2016,7,9,21,647,540,1187,1531
0132-000,2016,7,9,22,605,479,1084,1187
0132-000,2016,7,9,23,384,377,761,1084
0132-000,2016,7,9,24,253,250,503,761
0132-000,2016,7,10,1,183,202,385,503
0132-000,2016,7,10,2,135,141,276,385
0132-000,2016,7,10,3,102,110,212,276
0132-000,2016,7,10,4,76,95,171,212
0132-000,2016,7,10,5,96,93,189,171
0132-000,2016,7,10,6,218,161,379,189
0132-000,2016,7,10,7,279,304,583,379
0132-000,2016,7,10,8,298,500,798,583
0132-000,2016,7,10,9,395,528,923,798
0132-000,2016,7,10,10,504,622,1126,923
0132-000,2016,7,10,11,605,630,1235,1126
0132-000,2016,7,10,12,584,639,1223,1235
0132-000,2016,7,10,13,689,622,1311,1223
0132-000,2016,7,10,14,741,653,1394,1311
0132-000,2016,7,10,15,780,679,1459,1394
0132-000,2016,7,10,16,1118,662,1780,1459
0132-000,2016,7,10,17,1179,701,1880,1780
0132-000,2016,7,10,18,1302,732,2034,1880
0132-000,2016,7,10,19,1115,619,1734,2034
0132-000,2016,7,10,20,870,565,1435,1734
0132-000,2016,7,10,21,650,542,1192,1435
0132-000,2016,7,10,22,480,439,919,1192
0132-000,2016,7,10,23,333,312,645,919
0132-000,2016,7,10,24,176,208,384,645
0132-000,2016,7,11,1,120,132,252,384
0132-000,2016,7,11,2,71,99,170,252
0132-000,2016,7,11,3,52,64,116,170
0132-000,2016,7,11,4,46,71,117,116
0132-000,2016,7,11,5,96,94,190,117
0132-000,2016,7,11,6,336,250,586,190
0132-000,2016,7,11,7,573,729,1302,586
0132-000,2016,7,11,8,721,1935,2656,1302
0132-000,2016,7,11,9,903,1507,2410,2656
0132-000,2016,7,11,10,828,927,1755,2410
0132-000,2016,7,11,11,879,869,1748,1755
0132-000,2016,7,11,12,848,845,1693,1748
0132-000,2016,7,11,13,790,897,1687,1693
0132-000,2016,7,11,14,872,816,1688,1687
0132-000,2016,7,11,15,869,879,1748,1688
0132-000,2016,7,11,16,968,837,1805,1748
0132-000,2016,7,11,17,957,882,1839,1805
0132-000,2016,7,11,18,1312,936,2248,1839
0132-000,2016,7,11,19,1511,926,2437,2248
0132-000,2016,7,11,20,1028,768,1796,2437
0132-000,2016,7,11,21,901,601,1502,1796
0132-000,2016,7,11,22,683,502,1185,1502
0132-000,2016,7,11,23,358,377,735,1185
0132-000,2016,7,11,24,228,193,421,735
0132-000,2016,7,12,1,149,153,302,421
0132-000,2016,7,12,2,96,122,218,302
0132-000,2016,7,12,3,78,65,143,218
0132-000,2016,7,12,4,60,94,154,143
0132-000,2016,7,12,5,83,92,175,154
0132-000,2016,7,12,6,218,160,378,175
0132-000,2016,7,12,7,442,519,961,378
0132-000,2016,7,12,8,658,1723,2381,961
0132-000,2016,7,12,9,867,1508,2375,2381
0132-000,2016,7,12,10,863,909,1772,2375
0132-000,2016,7,12,11,806,859,1665,1772
0132-000,2016,7,12,12,792,815,1607,1665
0132-000,2016,7,12,13,743,751,1494,1607
0132-000,2016,7,12,14,805,834,1639,1494
0132-000,2016,7,12,15,936,898,1834,1639
0132-000,2016,7,12,16,902,758,1660,1834
0132-000,2016,7,12,17,948,885,1833,1660
0132-000,2016,7,12,18,1162,974,2136,1833
0132-000,2016,7,12,19,1408,857,2265,2136
0132-000,2016,7,12,20,986,728,1714,2265
0132-000,2016,7,12,21,883,578,1461,1714
0132-000,2016,7,12,22,619,505,1124,1461
0132-000,2016,7,12,23,384,355,739,1124
0132-000,2016,7,12,24,262,265,527,739
0132-000,2016,7,13,1,186,169,355,527
0132-000,2016,7,13,2,130,117,247,355
0132-000,2016,7,13,3,84,101,185,247
0132-000,2016,7,13,4,70,81,151,185
0132-000,2016,7,13,5,104,110,214,151
0132-000,2016,7,13,6,296,224,520,214
0132-000,2016,7,13,7,543,595,1138,520
0132-000,2016,7,13,8,682,1767,2449,1138
0132-000,2016,7,13,9,912,1459,2371,2449
0132-000,2016,7,13,10,860,898,1758,2371
0132-000,2016,7,13,11,821,874,1695,1758
0132-000,2016,7,13,12,781,852,1633,1695
0132-000,2016,7,13,13,783,827,1610,1633
0132-000,2016,7,13,14,841,818,1659,1610
0132-000,2016,7,13,15,857,907,1764,1659
0132-000,2016,7,13,16,1004,841,1845,1764
0132-000,2016,7,13,17,977,853,1830,1845
0132-000,2016,7,13,18,1342,922,2264,1830
0132-000,2016,7,13,19,1542,931,2473,2264
0132-000,2016,7,13,20,1020,803,1823,2473
0132-000,2016,7,13,21,881,630,1511,1823
0132-000,2016,7,13,22,649,499,1148,1511
0132-000,2016,7,13,23,429,378,807,1148
0132-000,2016,7,13,24,323,246,569,807
0132-000,2016,7,14,1,194,181,375,569
0132-000,2016,7,14,2,146,108,254,375
0132-000,2016,7,14,3,94,78,172,254
0132-000,2016,7,14,4,72,123,195,172
0132-000,2016,7,14,5,101,111,212,195
0132-000,2016,7,14,6,308,226,534,212
0132-000,2016,7,14,7,550,563,1113,534
0132-000,2016,7,14,8,689,1781,2470,1113
0132-000,2016,7,14,9,831,1470,2301,2470
0132-000,2016,7,14,10,810,944,1754,2301
0132-000,2016,7,14,11,836,860,1696,1754
0132-000,2016,7,14,12,900,930,1830,1696
0132-000,2016,7,14,13,770,812,1582,1830
0132-000,2016,7,14,14,879,833,1712,1582
0132-000,2016,7,14,15,861,871,1732,1712
0132-000,2016,7,14,16,959,878,1837,1732
0132-000,2016,7,14,17,935,948,1883,1837
0132-000,2016,7,14,18,1228,935,2163,1883
0132-000,2016,7,14,19,1476,925,2401,2163
0132-000,2016,7,14,20,1007,802,1809,2401
0132-000,2016,7,14,21,899,605,1504,1809
0132-000,2016,7,14,22,663,495,1158,1504
0132-000,2016,7,14,23,403,371,774,1158
0132-000,2016,7,14,24,285,235,520,774
0132-000,2016,7,15,1,190,172,362,520
0132-000,2016,7,15,2,92,98,190,362
0132-000,2016,7,15,3,79,96,175,190
0132-000,2016,7,15,4,83,89,172,175
0132-000,2016,7,15,5,79,101,180,172
0132-000,2016,7,15,6,304,227,531,180
0132-000,2016,7,15,7,508,593,1101,531
0132-000,2016,7,15,8,719,1778,2497,1101
0132-000,2016,7,15,9,868,1483,2351,2497
0132-000,2016,7,15,10,885,927,1812,2351
0132-000,2016,7,15,11,791,840,1631,1812
0132-000,2016,7,15,12,855,899,1754,1631
0132-000,2016,7,15,13,851,860,1711,1754
0132-000,2016,7,15,14,864,853,1717,1711
0132-000,2016,7,15,15,925,952,1877,1717
0132-000,2016,7,15,16,971,928,1899,1877
0132-000,2016,7,15,17,974,1162,2136,1899
0132-000,2016,7,15,18,1373,1307,2680,2136
0132-000,2016,7,15,19,1790,1064,2854,2680
0132-000,2016,7,15,20,1206,861,2067,2854
0132-000,2016,7,15,21,921,704,1625,2067
0132-000,2016,7,15,22,715,559,1274,1625
0132-000,2016,7,15,23,428,400,828,1274
0132-000,2016,7,15,24,252,286,538,828
0132-000,2016,7,16,1,206,214,420,538
0132-000,2016,7,16,2,140,154,294,420
0132-000,2016,7,16,3,110,117,227,294
0132-000,2016,7,16,4,81,111,192,227
0132-000,2016,7,16,5,103,99,202,192
0132-000,2016,7,16,6,190,162,352,202
0132-000,2016,7,16,7,309,342,651,352
0132-000,2016,7,16,8,485,848,1333,651
0132-000,2016,7,16,9,583,838,1421,1333
0132-000,2016,7,16,10,762,956,1718,1421
0132-000,2016,7,16,11,786,1198,1984,1718
0132-000,2016,7,16,12,869,1242,2111,1984
0132-000,2016,7,16,13,879,1133,2012,2111
0132-000,2016,7,16,14,888,1039,1927,2012
0132-000,2016,7,16,15,885,940,1825,1927
0132-000,2016,7,16,16,1011,915,1926,1825
0132-000,2016,7,16,17,1039,913,1952,1926
0132-000,2016,7,16,18,1219,876,2095,1952
0132-000,2016,7,16,19,1229,836,2065,2095
0132-000,2016,7,16,20,754,623,1377,2065
0132-000,2016,7,16,21,578,527,1105,1377
0132-000,2016,7,16,22,569,407,976,1105
0132-000,2016,7,16,23,343,350,693,976
0132-000,2016,7,16,24,211,227,438,693
0132-000,2016,7,17,1,156,203,359,438
0132-000,2016,7,17,2,109,120,229,359
0132-000,2016,7,17,3,112,108,220,229
0132-000,2016,7,17,4,76,86,162,220
0132-000,2016,7,17,5,77,85,162,162
0132-000,2016,7,17,6,172,120,292,162
0132-000,2016,7,17,7,203,229,432,292
0132-000,2016,7,17,8,284,372,656,432
0132-000,2016,7,17,9,405,466,871,656
0132-000,2016,7,17,10,474,576,1050,871
0132-000,2016,7,17,11,578,684,1262,1050
0132-000,2016,7,17,12,551,704,1255,1262
0132-000,2016,7,17,13,722,724,1446,1255
0132-000,2016,7,17,14,732,719,1451,1446
0132-000,2016,7,17,15,820,769,1589,1451
0132-000,2016,7,17,16,801,771,1572,1589
0132-000,2016,7,17,17,1075,768,1843,1572
0132-000,2016,7,17,18,1142,734,1876,1843
0132-000,2016,7,17,19,1019,599,1618,1876
0132-000,2016,7,17,20,760,533,1293,1618
0132-000,2016,7,17,21,852,498,1350,1293
0132-000,2016,7,17,22,509,408,917,1350
0132-000,2016,7,17,23,299,289,588,917
0132-000,2016,7,17,24,198,183,381,588
0132-000,2016,7,18,1,132,136,268,381
0132-000,2016,7,18,2,91,98,189,268
0132-000,2016,7,18,3,58,67,125,189
0132-000,2016,7,18,4,54,71,125,125
0132-000,2016,7,18,5,76,78,154,125
0132-000,2016,7,18,6,333,236,569,154
0132-000,2016,7,18,7,517,716,1233,569
0132-000,2016,7,18,8,682,1890,2572,1233
0132-000,2016,7,18,9,865,1464,2329,2572
0132-000,2016,7,18,10,755,908,1663,2329
0132-000,2016,7,18,11,822,824,1646,1663
0132-000,2016,7,18,12,923,949,1872,1646
0132-000,2016,7,18,13,721,762,1483,1872
0132-000,2016,7,18,14,853,817,1670,1483
0132-000,2016,7,18,15,903,897,1800,1670
0132-000,2016,7,18,16,866,873,1739,1800
0132-000,2016,7,18,17,912,826,1738,1739
0132-000,2016,7,18,18,1257,948,2205,1738
0132-000,2016,7,18,19,1427,912,2339,2205
0132-000,2016,7,18,20,1005,782,1787,2339
0132-000,2016,7,18,21,893,586,1479,1787
0132-000,2016,7,18,22,593,443,1036,1479
0132-000,2016,7,18,23,362,334,696,1036
0132-000,2016,7,18,24,211,208,419,696
0132-000,2016,7,19,1,136,162,298,419
0132-000,2016,7,19,2,121,102,223,298
0132-000,2016,7,19,3,81,82,163,223
0132-000,2016,7,19,4,77,86,163,163
0132-000,2016,7,19,5,100,103,203,163
0132-000,2016,7,19,6,287,221,508,203
0132-000,2016,7,19,7,514,629,1143,508
0132-000,2016,7,19,8,684,1813,2497,1143
0132-000,2016,7,19,9,900,1513,2413,2497
0132-000,2016,7,19,10,820,847,1667,2413
0132-000,2016,7,19,11,852,910,1762,1667
0132-000,2016,7,19,12,808,907,1715,1762
0132-000,2016,7,19,13,812,801,1613,1715
0132-000,2016,7,19,14,814,745,1559,1613
0132-000,2016,7,19,15,921,888,1809,1559
0132-000,2016,7,19,16,912,885,1797,1809
0132-000,2016,7,19,17,983,907,1890,1797
0132-000,2016,7,19,18,1279,922,2201,1890
0132-000,2016,7,19,19,1541,896,2437,2201
0132-000,2016,7,19,20,985,749,1734,2437
0132-000,2016,7,19,21,905,631,1536,1734
0132-000,2016,7,19,22,656,510,1166,1536
0132-000,2016,7,19,23,389,329,718,1166
0132-000,2016,7,19,24,214,251,465,718
0132-000,2016,7,20,1,155,147,302,465
0132-000,2016,7,20,2,110,90,200,302
0132-000,2016,7,20,3,70,101,171,200
0132-000,2016,7,20,4,73,94,167,171
0132-000,2016,7,20,5,108,102,210,167
0132-000,2016,7,20,6,331,215,546,210
0132-000,2016,7,20,7,493,577,1070,546
0132-000,2016,7,20,8,672,1810,2482,1070
0132-000,2016,7,20,9,914,1553,2467,2482
0132-000,2016,7,20,10,839,906,1745,2467
0132-000,2016,7,20,11,873,939,1812,1745
0132-000,2016,7,20,12,823,935,1758,1812
0132-000,2016,7,20,13,832,856,1688,1758
0132-000,2016,7,20,14,857,874,1731,1688
0132-000,2016,7,20,15,969,835,1804,1731
0132-000,2016,7,20,16,939,894,1833,1804
0132-000,2016,7,20,17,964,883,1847,1833
0132-000,2016,7,20,18,1312,999,2311,1847
0132-000,2016,7,20,19,1592,921,2513,2311
0132-000,2016,7,20,20,992,760,1752,2513
0132-000,2016,7,20,21,847,632,1479,1752
0132-000,2016,7,20,22,630,472,1102,1479
0132-000,2016,7,20,23,418,387,805,1102
0132-000,2016,7,20,24,240,246,486,805
0132-000,2016,7,21,1,160,184,344,486
0132-000,2016,7,21,2,115,127,242,344
0132-000,2016,7,21,3,93,108,201,242
0132-000,2016,7,21,4,92,81,173,201
0132-000,2016,7,21,5,90,123,213,173
0132-000,2016,7,21,6,316,198,514,213
0132-000,2016,7,21,7,500,600,1100,514
0132-000,2016,7,21,8,696,1787,2483,1100
0132-000,2016,7,21,9,868,1518,2386,2483
0132-000,2016,7,21,10,791,891,1682,2386
0132-000,2016,7,21,11,905,910,1815,1682
0132-000,2016,7,21,12,793,948,1741,1815
0132-000,2016,7,21,13,811,764,1575,1741
0132-000,2016,7,21,14,867,800,1667,1575
0132-000,2016,7,21,15,864,859,1723,1667
0132-000,2016,7,21,16,928,798,1726,1723
0132-000,2016,7,21,17,1000,901,1901,1726
0132-000,2016,7,21,18,1254,947,2201,1901
0132-000,2016,7,21,19,1461,917,2378,2201
0132-000,2016,7,21,20,1028,781,1809,2378
0132-000,2016,7,21,21,921,562,1483,1809
0132-000,2016,7,21,22,692,486,1178,1483
0132-000,2016,7,21,23,346,348,694,1178
0132-000,2016,7,21,24,246,251,497,694
0132-000,2016,7,22,1,151,181,332,497
0132-000,2016,7,22,2,130,108,238,332
0132-000,2016,7,22,3,85,92,177,238
0132-000,2016,7,22,4,82,100,182,177
0132-000,2016,7,22,5,115,109,224,182
0132-000,2016,7,22,6,301,192,493,224
0132-000,2016,7,22,7,539,584,1123,493
0132-000,2016,7,22,8,634,1720,2354,1123
0132-000,2016,7,22,9,942,1516,2458,2354
0132-000,2016,7,22,10,819,868,1687,2458
0132-000,2016,7,22,11,869,888,1757,1687
0132-000,2016,7,22,12,850,855,1705,1757
0132-000,2016,7,22,13,797,795,1592,1705
0132-000,2016,7,22,14,838,893,1731,1592
0132-000,2016,7,22,15,878,885,1763,1731
0132-000,2016,7,22,16,1134,860,1994,1763
0132-000,2016,7,22,17,1360,939,2299,1994
0132-000,2016,7,22,18,1856,1030,2886,2299
0132-000,2016,7,22,19,1970,1036,3006,2886
0132-000,2016,7,22,20,1502,838,2340,3006
0132-000,2016,7,22,21,1023,714,1737,2340
0132-000,2016,7,22,22,760,492,1252,1737
0132-000,2016,7,22,23,450,429,879,1252
0132-000,2016,7,22,24,285,282,567,879
0132-000,2016,7,23,1,239,220,459,567
0132-000,2016,7,23,2,156,144,300,459
0132-000,2016,7,23,3,138,132,270,300
0132-000,2016,7,23,4,102,139,241,270
0132-000,2016,7,23,5,132,126,258,241
0132-000,2016,7,23,6,282,207,489,258
0132-000,2016,7,23,7,435,429,864,489
0132-000,2016,7,23,8,575,841,1416,864
0132-000,2016,7,23,9,838,957,1795,1416
0132-000,2016,7,23,10,1053,1217,2270,1795
0132-000,2016,7,23,11,1166,1227,2393,2270
0132-000,2016,7,23,12,1483,1281,2764,2393
0132-000,2016,7,23,13,1447,1197,2644,2764
0132-000,2016,7,23,14,1413,1238,2651,2644
0132-000,2016,7,23,15,1227,1017,2244,2651
0132-000,2016,7,23,16,1480,914,2394,2244
0132-000,2016,7,23,17,1305,927,2232,2394
0132-000,2016,7,23,18,1469,1071,2540,2232
0132-000,2016,7,23,19,1384,922,2306,2540
0132-000,2016,7,23,20,931,737,1668,2306
0132-000,2016,7,23,21,661,580,1241,1668
0132-000,2016,7,23,22,586,435,1021,1241
0132-000,2016,7,23,23,367,371,738,1021
0132-000,2016,7,23,24,236,263,499,738
0132-000,2016,7,24,1,177,147,324,499
0132-000,2016,7,24,2,129,143,272,324
0132-000,2016,7,24,3,100,85,185,272
0132-000,2016,7,24,4,82,84,166,185
0132-000,2016,7,24,5,79,86,165,166
0132-000,2016,7,24,6,175,167,342,165
0132-000,2016,7,24,7,260,254,514,342
0132-000,2016,7,24,8,260,397,657,514
0132-000,2016,7,24,9,450,465,915,657
0132-000,2016,7,24,10,502,598,1100,915
0132-000,2016,7,24,11,586,626,1212,1100
0132-000,2016,7,24,12,678,611,1289,1212
0132-000,2016,7,24,13,789,635,1424,1289
0132-000,2016,7,24,14,847,661,1508,1424
0132-000,2016,7,24,15,1005,647,1652,1508
0132-000,2016,7,24,16,1153,702,1855,1652
0132-000,2016,7,24,17,1304,692,1996,1855
0132-000,2016,7,24,18,1321,702,2023,1996
0132-000,2016,7,24,19,1290,630,1920,2023
0132-000,2016,7,24,20,1039,580,1619,1920
0132-000,2016,7,24,21,803,519,1322,1619
0132-000,2016,7,24,22,565,412,977,1322
0132-000,2016,7,24,23,328,292,620,977
0132-000,2016,7,24,24,191,219,410,620
0132-000,2016,7,25,1,128,147,275,410
0132-000,2016,7,25,2,73,108,181,275
0132-000,2016,7,25,3,51,72,123,181
0132-000,2016,7,25,4,57,75,132,123
0132-000,2016,7,25,5,111,91,202,132
0132-000,2016,7,25,6,349,220,569,202
0132-000,2016,7,25,7,527,707,1234,569
0132-000,2016,7,25,8,693,1894,2587,1234
0132-000,2016,7,25,9,872,1455,2327,2587
0132-000,2016,7,25,10,812,842,1654,2327
0132-000,2016,7,25,11,851,904,1755,1654
0132-000,2016,7,25,12,856,891,1747,1755
0132-000,2016,7,25,13,859,795,1654,1747
0132-000,2016,7,25,14,889,899,1788,1654
0132-000,2016,7,25,15,903,1311,2214,1788
0132-000,2016,7,25,16,926,1002,1928,2214
0132-000,2016,7,25,17,985,947,1932,1928
0132-000,2016,7,25,18,1245,882,2127,1932
0132-000,2016,7,25,19,1674,950,2624,2127
0132-000,2016,7,25,20,1121,791,1912,2624
0132-000,2016,7,25,21,917,627,1544,1912
0132-000,2016,7,25,22,660,506,1166,1544
0132-000,2016,7,25,23,393,360,753,1166
0132-000,2016,7,25,24,246,194,440,753
0132-000,2016,7,26,1,162,120,282,440
0132-000,2016,7,26,2,96,96,192,282
0132-000,2016,7,26,3,68,73,141,192
0132-000,2016,7,26,4,66,92,158,141
0132-000,2016,7,26,5,105,117,222,158
0132-000,2016,7,26,6,288,203,491,222
0132-000,2016,7,26,7,513,613,1126,491
0132-000,2016,7,26,8,686,1757,2443,1126
0132-000,2016,7,26,9,838,1497,2335,2443
0132-000,2016,7,26,10,846,942,1788,2335
0132-000,2016,7,26,11,852,891,1743,1788
0132-000,2016,7,26,12,836,894,1730,1743
0132-000,2016,7,26,13,824,811,1635,1730
0132-000,2016,7,26,14,822,843,1665,1635
0132-000,2016,7,26,15,851,864,1715,1665
0132-000,2016,7,26,16,1008,891,1899,1715
0132-000,2016,7,26,17,1050,886,1936,1899
0132-000,2016,7,26,18,1351,937,2288,1936
0132-000,2016,7,26,19,1588,938,2526,2288
0132-000,2016,7,26,20,1013,818,1831,2526
0132-000,2016,7,26,21,922,602,1524,1831
0132-000,2016,7,26,22,715,484,1199,1524
0132-000,2016,7,26,23,435,360,795,1199
0132-000,2016,7,26,24,219,229,448,795
0132-000,2016,7,27,1,150,146,296,448
0132-000,2016,7,27,2,98,125,223,296
0132-000,2016,7,27,3,94,86,180,223
0132-000,2016,7,27,4,81,111,192,180
0132-000,2016,7,27,5,95,106,201,192
0132-000,2016,7,27,6,303,228,531,201
0132-000,2016,7,27,7,503,600,1103,531
0132-000,2016,7,27,8,631,1723,2354,1103
0132-000,2016,7,27,9,793,1398,2191,2354
0132-000,2016,7,27,10,821,902,1723,2191
0132-000,2016,7,27,11,818,882,1700,1723
0132-000,2016,7,27,12,829,892,1721,1700
0132-000,2016,7,27,13,772,810,1582,1721
0132-000,2016,7,27,14,841,841,1682,1582
0132-000,2016,7,27,15,853,869,1722,1682
0132-000,2016,7,27,16,918,842,1760,1722
0132-000,2016,7,27,17,920,802,1722,1760
0132-000,2016,7,27,18,1324,898,2222,1722
0132-000,2016,7,27,19,1485,887,2372,2222
0132-000,2016,7,27,20,1003,761,1764,2372
0132-000,2016,7,27,21,808,553,1361,1764
0132-000,2016,7,27,22,623,489,1112,1361
0132-000,2016,7,27,23,384,342,726,1112
0132-000,2016,7,27,24,207,248,455,726
0132-000,2016,7,28,1,186,152,338,455
0132-000,2016,7,28,2,108,90,198,338
0132-000,2016,7,28,3,73,106,179,198
0132-000,2016,7,28,4,77,99,176,179
0132-000,2016,7,28,5,102,103,205,176
0132-000,2016,7,28,6,292,202,494,205
0132-000,2016,7,28,7,498,576,1074,494
0132-000,2016,7,28,8,634,1721,2355,1074
0132-000,2016,7,28,9,805,1387,2192,2355
0132-000,2016,7,28,10,808,831,1639,2192
0132-000,2016,7,28,11,863,900,1763,1639
0132-000,2016,7,28,12,844,917,1761,1763
0132-000,2016,7,28,13,807,876,1683,1761
0132-000,2016,7,28,14,882,848,1730,1683
0132-000,2016,7,28,15,861,883,1744,1730
0132-000,2016,7,28,16,938,820,1758,1744
0132-000,2016,7,28,17,884,927,1811,1758
0132-000,2016,7,28,18,1291,853,2144,1811
0132-000,2016,7,28,19,1471,925,2396,2144
0132-000,2016,7,28,20,1013,810,1823,2396
0132-000,2016,7,28,21,938,592,1530,1823
0132-000,2016,7,28,22,649,507,1156,1530
0132-000,2016,7,28,23,416,398,814,1156
0132-000,2016,7,28,24,241,269,510,814
0132-000,2016,7,29,1,177,185,362,510
0132-000,2016,7,29,2,105,116,221,362
0132-000,2016,7,29,3,96,107,203,221
0132-000,2016,7,29,4,69,89,158,203
0132-000,2016,7,29,5,101,89,190,158
0132-000,2016,7,29,6,292,204,496,190
0132-000,2016,7,29,7,505,578,1083,496
0132-000,2016,7,29,8,639,1687,2326,1083
0132-000,2016,7,29,9,821,1311,2132,2326
0132-000,2016,7,29,10,748,842,1590,2132
0132-000,2016,7,29,11,751,885,1636,1590
0132-000,2016,7,29,12,777,906,1683,1636
0132-000,2016,7,29,13,747,991,1738,1683
0132-000,2016,7,29,14,834,1022,1856,1738
0132-000,2016,7,29,15,829,1064,1893,1856
0132-000,2016,7,29,16,952,1113,2065,1893
0132-000,2016,7,29,17,1165,1087,2252,2065
0132-000,2016,7,29,18,1527,1180,2707,2252
0132-000,2016,7,29,19,1706,1034,2740,2707
0132-000,2016,7,29,20,1303,1010,2313,2740
0132-000,2016,7,29,21,911,914,1825,2313
0132-000,2016,7,29,22,729,594,1323,1825
0132-000,2016,7,29,23,446,394,840,1323
0132-000,2016,7,29,24,248,283,531,840
0132-000,2016,7,30,1,207,213,420,531
0132-000,2016,7,30,2,145,155,300,420
0132-000,2016,7,30,3,97,123,220,300
0132-000,2016,7,30,4,111,96,207,220
0132-000,2016,7,30,5,127,109,236,207
0132-000,2016,7,30,6,281,230,511,236
0132-000,2016,7,30,7,394,458,852,511
0132-000,2016,7,30,8,448,833,1281,852
0132-000,2016,7,30,9,646,1266,1912,1281
0132-000,2016,7,30,10,719,1669,2388,1912
0132-000,2016,7,30,11,722,1810,2532,2388
0132-000,2016,7,30,12,774,1798,2572,2532
0132-000,2016,7,30,13,830,1827,2657,2572
0132-000,2016,7,30,14,786,1775,2561,2657
0132-000,2016,7,30,15,849,1274,2123,2561
0132-000,2016,7,30,16,940,1091,2031,2123
0132-000,2016,7,30,17,967,946,1913,2031
0132-000,2016,7,30,18,1051,1032,2083,1913
0132-000,2016,7,30,19,1055,862,1917,2083
0132-000,2016,7,30,20,791,673,1464,1917
0132-000,2016,7,30,21,692,551,1243,1464
0132-000,2016,7,30,22,554,422,976,1243
0132-000,2016,7,30,23,383,331,714,976
0132-000,2016,7,30,24,229,217,446,714
0132-000,2016,7,31,1,161,207,368,446
0132-000,2016,7,31,2,126,124,250,368
0132-000,2016,7,31,3,89,114,203,250
0132-000,2016,7,31,4,83,89,172,203
0132-000,2016,7,31,5,84,105,189,172
0132-000,2016,7,31,6,190,146,336,189
0132-000,2016,7,31,7,242,267,509,336
0132-000,2016,7,31,8,281,358,639,509
0132-000,2016,7,31,9,362,498,860,639
0132-000,2016,7,31,10,460,554,1014,860
0132-000,2016,7,31,11,507,658,1165,1014
0132-000,2016,7,31,12,566,673,1239,1165
0132-000,2016,7,31,13,582,711,1293,1239
0132-000,2016,7,31,14,667,728,1395,1293
0132-000,2016,7,31,15,749,682,1431,1395
0132-000,2016,7,31,16,913,683,1596,1431
0132-000,2016,7,31,17,981,723,1704,1596
0132-000,2016,7,31,18,1116,717,1833,1704
0132-000,2016,7,31,19,1010,718,1728,1833
0132-000,2016,7,31,20,809,545,1354,1728
0132-000,2016,7,31,21,674,492,1166,1354
0132-000,2016,7,31,22,524,406,930,1166
0132-000,2016,7,31,23,371,286,657,930
0132-000,2016,7,31,24,211,215,426,657
0132-000,2016,8,1,1,146,134,280,426
0132-000,2016,8,1,2,106,99,205,280
0132-000,2016,8,1,3,62,74,136,205
0132-000,2016,8,1,4,58,73,131,136
0132-000,2016,8,1,5,94,73,167,131
0132-000,2016,8,1,6,286,204,490,167
0132-000,2016,8,1,7,472,583,1055,490
0132-000,2016,8,1,8,574,1256,1830,1055
0132-000,2016,8,1,9,681,1144,1825,1830
0132-000,2016,8,1,10,690,787,1477,1825
0132-000,2016,8,1,11,721,890,1611,1477
0132-000,2016,8,1,12,792,923,1715,1611
0132-000,2016,8,1,13,757,881,1638,1715
0132-000,2016,8,1,14,803,856,1659,1638
0132-000,2016,8,1,15,859,799,1658,1659
0132-000,2016,8,1,16,869,775,1644,1658
0132-000,2016,8,1,17,914,834,1748,1644
0132-000,2016,8,1,18,1081,884,1965,1748
0132-000,2016,8,1,19,1403,856,2259,1965
0132-000,2016,8,1,20,983,675,1658,2259
0132-000,2016,8,1,21,715,502,1217,1658
0132-000,2016,8,1,22,516,400,916,1217
0132-000,2016,8,1,23,355,343,698,916
0132-000,2016,8,1,24,189,211,400,698
0132-000,2016,8,2,1,147,175,322,400
0132-000,2016,8,2,2,94,95,189,322
0132-000,2016,8,2,3,81,83,164,189
0132-000,2016,8,2,4,62,84,146,164
0132-000,2016,8,2,5,111,89,200,146
0132-000,2016,8,2,6,266,188,454,200
0132-000,2016,8,2,7,402,465,867,454
0132-000,2016,8,2,8,554,1195,1749,867
0132-000,2016,8,2,9,667,1089,1756,1749
0132-000,2016,8,2,10,694,800,1494,1756
0132-000,2016,8,2,11,739,825,1564,1494
0132-000,2016,8,2,12,792,813,1605,1564
0132-000,2016,8,2,13,768,827,1595,1605
0132-000,2016,8,2,14,781,775,1556,1595
0132-000,2016,8,2,15,888,795,1683,1556
0132-000,2016,8,2,16,862,751,1613,1683
0132-000,2016,8,2,17,988,780,1768,1613
0132-000,2016,8,2,18,1318,868,2186,1768
0132-000,2016,8,2,19,1565,850,2415,2186
0132-000,2016,8,2,20,1101,637,1738,2415
0132-000,2016,8,2,21,750,520,1270,1738
0132-000,2016,8,2,22,527,405,932,1270
0132-000,2016,8,2,23,329,357,686,932
0132-000,2016,8,2,24,254,238,492,686
0132-000,2016,8,3,1,152,177,329,492
0132-000,2016,8,3,2,91,103,194,329
0132-000,2016,8,3,3,81,83,164,194
0132-000,2016,8,3,4,88,93,181,164
0132-000,2016,8,3,5,106,95,201,181
0132-000,2016,8,3,6,255,161,416,201
0132-000,2016,8,3,7,433,487,920,416
0132-000,2016,8,3,8,562,1170,1732,920
0132-000,2016,8,3,9,669,1116,1785,1732
0132-000,2016,8,3,10,724,760,1484,1785
0132-000,2016,8,3,11,756,866,1622,1484
0132-000,2016,8,3,12,762,796,1558,1622
0132-000,2016,8,3,13,768,829,1597,1558
0132-000,2016,8,3,14,800,862,1662,1597
0132-000,2016,8,3,15,807,802,1609,1662
0132-000,2016,8,3,16,891,792,1683,1609
0132-000,2016,8,3,17,899,777,1676,1683
0132-000,2016,8,3,18,1234,864,2098,1676
0132-000,2016,8,3,19,1474,868,2342,2098
0132-000,2016,8,3,20,948,748,1696,2342
0132-000,2016,8,3,21,671,555,1226,1696
0132-000,2016,8,3,22,569,414,983,1226
0132-000,2016,8,3,23,354,370,724,983
0132-000,2016,8,3,24,264,227,491,724
0132-000,2016,8,4,1,160,152,312,491
0132-000,2016,8,4,2,109,112,221,312
0132-000,2016,8,4,3,64,96,160,221
0132-000,2016,8,4,4,71,90,161,160
0132-000,2016,8,4,5,117,83,200,161
0132-000,2016,8,4,6,270,191,461,200
0132-000,2016,8,4,7,433,500,933,461
0132-000,2016,8,4,8,596,1393,1989,933
0132-000,2016,8,4,9,736,1250,1986,1989
0132-000,2016,8,4,10,760,830,1590,1986
0132-000,2016,8,4,11,734,815,1549,1590
0132-000,2016,8,4,12,818,887,1705,1549
0132-000,2016,8,4,13,708,870,1578,1705
0132-000,2016,8,4,14,771,847,1618,1578
0132-000,2016,8,4,15,843,835,1678,1618
0132-000,2016,8,4,16,854,759,1613,1678
0132-000,2016,8,4,17,880,776,1656,1613
0132-000,2016,8,4,18,1223,858,2081,1656
0132-000,2016,8,4,19,1380,907,2287,2081
0132-000,2016,8,4,20,893,734,1627,2287
0132-000,2016,8,4,21,758,495,1253,1627
0132-000,2016,8,4,22,527,381,908,1253
0132-000,2016,8,4,23,361,338,699,908
0132-000,2016,8,4,24,230,235,465,699
0132-000,2016,8,5,1,130,166,296,465
0132-000,2016,8,5,2,112,121,233,296
0132-000,2016,8,5,3,68,83,151,233
0132-000,2016,8,5,4,83,86,169,151
0132-000,2016,8,5,5,101,120,221,169
0132-000,2016,8,5,6,282,181,463,221
0132-000,2016,8,5,7,452,476,928,463
0132-000,2016,8,5,8,636,1404,2040,928
0132-000,2016,8,5,9,784,1250,2034,2040
0132-000,2016,8,5,10,777,793,1570,2034
0132-000,2016,8,5,11,731,883,1614,1570
0132-000,2016,8,5,12,817,895,1712,1614
0132-000,2016,8,5,13,774,898,1672,1712
0132-000,2016,8,5,14,798,851,1649,1672
0132-000,2016,8,5,15,940,892,1832,1649
0132-000,2016,8,5,16,887,873,1760,1832
0132-000,2016,8,5,17,931,824,1755,1760
0132-000,2016,8,5,18,1267,915,2182,1755
0132-000,2016,8,5,19,1518,948,2466,2182
0132-000,2016,8,5,20,1055,788,1843,2466
0132-000,2016,8,5,21,796,593,1389,1843
0132-000,2016,8,5,22,626,455,1081,1389
0132-000,2016,8,5,23,428,375,803,1081
0132-000,2016,8,5,24,257,274,531,803
0132-000,2016,8,6,1,194,218,412,531
0132-000,2016,8,6,2,148,154,302,412
0132-000,2016,8,6,3,97,106,203,302
0132-000,2016,8,6,4,80,84,164,203
0132-000,2016,8,6,5,126,125,251,164
0132-000,2016,8,6,6,256,205,461,251
0132-000,2016,8,6,7,374,412,786,461
0132-000,2016,8,6,8,472,807,1279,786
0132-000,2016,8,6,9,544,848,1392,1279
0132-000,2016,8,6,10,787,834,1621,1392
0132-000,2016,8,6,11,740,947,1687,1621
0132-000,2016,8,6,12,888,1093,1981,1687
0132-000,2016,8,6,13,913,938,1851,1981
0132-000,2016,8,6,14,835,848,1683,1851
0132-000,2016,8,6,15,820,782,1602,1683
0132-000,2016,8,6,16,831,879,1710,1602
0132-000,2016,8,6,17,951,874,1825,1710
0132-000,2016,8,6,18,1172,978,2150,1825
0132-000,2016,8,6,19,1082,1031,2113,2150
0132-000,2016,8,6,20,820,737,1557,2113
0132-000,2016,8,6,21,681,606,1287,1557
0132-000,2016,8,6,22,586,456,1042,1287
0132-000,2016,8,6,23,361,351,712,1042
0132-000,2016,8,6,24,218,236,454,712
0132-000,2016,8,7,1,143,185,328,454
0132-000,2016,8,7,2,126,169,295,328
0132-000,2016,8,7,3,97,166,263,295
0132-000,2016,8,7,4,73,71,144,263
0132-000,2016,8,7,5,82,100,182,144
0132-000,2016,8,7,6,182,114,296,182
0132-000,2016,8,7,7,204,265,469,296
0132-000,2016,8,7,8,273,377,650,469
0132-000,2016,8,7,9,387,417,804,650
0132-000,2016,8,7,10,504,559,1063,804
0132-000,2016,8,7,11,553,611,1164,1063
0132-000,2016,8,7,12,558,658,1216,1164
0132-000,2016,8,7,13,616,732,1348,1216
0132-000,2016,8,7,14,690,779,1469,1348
0132-000,2016,8,7,15,772,991,1763,1469
0132-000,2016,8,7,16,761,751,1512,1763
0132-000,2016,8,7,17,911,830,1741,1512
0132-000,2016,8,7,18,957,697,1654,1741
0132-000,2016,8,7,19,974,688,1662,1654
0132-000,2016,8,7,20,696,570,1266,1662
0132-000,2016,8,7,21,614,490,1104,1266
0132-000,2016,8,7,22,498,431,929,1104
0132-000,2016,8,7,23,361,350,711,929
0132-000,2016,8,7,24,212,212,424,711
0132-000,2016,8,8,1,127,145,272,424
0132-000,2016,8,8,2,78,111,189,272
0132-000,2016,8,8,3,61,73,134,189
0132-000,2016,8,8,4,75,66,141,134
0132-000,2016,8,8,5,112,114,226,141
0132-000,2016,8,8,6,282,203,485,226
0132-000,2016,8,8,7,497,693,1190,485
0132-000,2016,8,8,8,633,1918,2551,1190
0132-000,2016,8,8,9,827,1402,2229,2551
0132-000,2016,8,8,10,798,923,1721,2229
0132-000,2016,8,8,11,793,1006,1799,1721
0132-000,2016,8,8,12,789,1036,1825,1799
0132-000,2016,8,8,13,817,831,1648,1825
0132-000,2016,8,8,14,838,929,1767,1648
0132-000,2016,8,8,15,853,884,1737,1767
0132-000,2016,8,8,16,918,890,1808,1737
0132-000,2016,8,8,17,931,887,1818,1808
0132-000,2016,8,8,18,1207,1045,2252,1818
0132-000,2016,8,8,19,1446,1008,2454,2252
0132-000,2016,8,8,20,978,769,1747,2454
0132-000,2016,8,8,21,886,551,1437,1747
0132-000,2016,8,8,22,615,448,1063,1437
0132-000,2016,8,8,23,343,609,952,1063
0132-000,2016,8,8,24,210,305,515,952
0132-000,2016,8,9,1,152,167,319,515
0132-000,2016,8,9,2,91,114,205,319
0132-000,2016,8,9,3,59,111,170,205
0132-000,2016,8,9,4,73,129,202,170
0132-000,2016,8,9,5,115,109,224,202
0132-000,2016,8,9,6,282,195,477,224
0132-000,2016,8,9,7,459,562,1021,477
0132-000,2016,8,9,8,642,1795,2437,1021
0132-000,2016,8,9,9,833,1487,2320,2437
0132-000,2016,8,9,10,856,910,1766,2320
0132-000,2016,8,9,11,823,1035,1858,1766
0132-000,2016,8,9,12,805,1038,1843,1858
0132-000,2016,8,9,13,754,783,1537,1843
0132-000,2016,8,9,14,822,841,1663,1537
0132-000,2016,8,9,15,874,899,1773,1663
0132-000,2016,8,9,16,977,823,1800,1773
0132-000,2016,8,9,17,1011,808,1819,1800
0132-000,2016,8,9,18,1319,963,2282,1819
0132-000,2016,8,9,19,1517,921,2438,2282
0132-000,2016,8,9,20,993,928,1921,2438
0132-000,2016,8,9,21,931,783,1714,1921
0132-000,2016,8,9,22,598,509,1107,1714
0132-000,2016,8,9,23,396,350,746,1107
0132-000,2016,8,9,24,256,260,516,746
0132-000,2016,8,10,1,165,181,346,516
0132-000,2016,8,10,2,118,117,235,346
0132-000,2016,8,10,3,85,93,178,235
0132-000,2016,8,10,4,81,79,160,178
0132-000,2016,8,10,5,121,201,322,160
0132-000,2016,8,10,6,254,305,559,322
0132-000,2016,8,10,7,478,584,1062,559
0132-000,2016,8,10,8,648,1716,2364,1062
0132-000,2016,8,10,9,871,1485,2356,2364
0132-000,2016,8,10,10,874,897,1771,2356
0132-000,2016,8,10,11,933,892,1825,1771
0132-000,2016,8,10,12,829,902,1731,1825
0132-000,2016,8,10,13,804,874,1678,1731
0132-000,2016,8,10,14,848,1012,1860,1678
0132-000,2016,8,10,15,888,1204,2092,1860
0132-000,2016,8,10,16,922,884,1806,2092
0132-000,2016,8,10,17,962,881,1843,1806
0132-000,2016,8,10,18,1295,893,2188,1843
0132-000,2016,8,10,19,1660,991,2651,2188
0132-000,2016,8,10,20,1073,821,1894,2651
0132-000,2016,8,10,21,841,579,1420,1894
0132-000,2016,8,10,22,640,485,1125,1420
0132-000,2016,8,10,23,376,369,745,1125
0132-000,2016,8,10,24,224,250,474,745
0132-000,2016,8,11,1,183,184,367,474
0132-000,2016,8,11,2,119,107,226,367
0132-000,2016,8,11,3,86,80,166,226
0132-000,2016,8,11,4,92,117,209,166
0132-000,2016,8,11,5,105,140,245,209
0132-000,2016,8,11,6,264,239,503,245
0132-000,2016,8,11,7,480,574,1054,503
0132-000,2016,8,11,8,635,1786,2421,1054
0132-000,2016,8,11,9,855,1416,2271,2421
0132-000,2016,8,11,10,786,877,1663,2271
0132-000,2016,8,11,11,800,852,1652,1663
0132-000,2016,8,11,12,803,979,1782,1652
0132-000,2016,8,11,13,823,1086,1909,1782
0132-000,2016,8,11,14,795,893,1688,1909
0132-000,2016,8,11,15,871,877,1748,1688
0132-000,2016,8,11,16,885,883,1768,1748
0132-000,2016,8,11,17,926,927,1853,1768
0132-000,2016,8,11,18,1235,911,2146,1853
0132-000,2016,8,11,19,1528,897,2425,2146
0132-000,2016,8,11,20,1040,757,1797,2425
0132-000,2016,8,11,21,825,619,1444,1797
0132-000,2016,8,11,22,637,475,1112,1444
0132-000,2016,8,11,23,395,354,749,1112
0132-000,2016,8,11,24,252,268,520,749
0132-000,2016,8,12,1,136,186,322,520
0132-000,2016,8,12,2,112,131,243,322
0132-000,2016,8,12,3,94,88,182,243
0132-000,2016,8,12,4,90,108,198,182
0132-000,2016,8,12,5,106,144,250,198
0132-000,2016,8,12,6,300,200,500,250
0132-000,2016,8,12,7,489,578,1067,500
0132-000,2016,8,12,8,718,1724,2442,1067
0132-000,2016,8,12,9,837,1423,2260,2442
0132-000,2016,8,12,10,840,878,1718,2260
0132-000,2016,8,12,11,812,851,1663,1718
0132-000,2016,8,12,12,829,888,1717,1663
0132-000,2016,8,12,13,832,914,1746,1717
0132-000,2016,8,12,14,857,882,1739,1746
0132-000,2016,8,12,15,921,907,1828,1739
0132-000,2016,8,12,16,959,897,1856,1828
0132-000,2016,8,12,17,975,922,1897,1856
0132-000,2016,8,12,18,1321,1033,2354,1897
0132-000,2016,8,12,19,1703,1119,2822,2354
0132-000,2016,8,12,20,1176,1041,2217,2822
0132-000,2016,8,12,21,937,711,1648,2217
0132-000,2016,8,12,22,734,599,1333,1648
0132-000,2016,8,12,23,490,408,898,1333
0132-000,2016,8,12,24,274,291,565,898
0132-000,2016,8,13,1,215,216,431,565
0132-000,2016,8,13,2,169,151,320,431
0132-000,2016,8,13,3,123,141,264,320
0132-000,2016,8,13,4,112,139,251,264
0132-000,2016,8,13,5,120,130,250,251
0132-000,2016,8,13,6,299,218,517,250
0132-000,2016,8,13,7,404,401,805,517
0132-000,2016,8,13,8,572,893,1465,805
0132-000,2016,8,13,9,673,1079,1752,1465
0132-000,2016,8,13,10,757,1261,2018,1752
0132-000,2016,8,13,11,754,1530,2284,2018
0132-000,2016,8,13,12,831,1757,2588,2284
0132-000,2016,8,13,13,802,1842,2644,2588
0132-000,2016,8,13,14,765,1784,2549,2644
0132-000,2016,8,13,15,823,1482,2305,2549
0132-000,2016,8,13,16,913,1176,2089,2305
0132-000,2016,8,13,17,1032,1071,2103,2089
0132-000,2016,8,13,18,1421,1179,2600,2103
0132-000,2016,8,13,19,1137,1143,2280,2600
0132-000,2016,8,13,20,818,795,1613,2280
0132-000,2016,8,13,21,703,567,1270,1613
0132-000,2016,8,13,22,563,419,982,1270
0132-000,2016,8,13,23,330,366,696,982
0132-000,2016,8,13,24,226,233,459,696
0132-000,2016,8,14,1,163,156,319,459
0132-000,2016,8,14,2,113,116,229,319
0132-000,2016,8,14,3,84,98,182,229
0132-000,2016,8,14,4,80,95,175,182
0132-000,2016,8,14,5,92,99,191,175
0132-000,2016,8,14,6,182,151,333,191
0132-000,2016,8,14,7,206,235,441,333
0132-000,2016,8,14,8,257,350,607,441
0132-000,2016,8,14,9,380,436,816,607
0132-000,2016,8,14,10,497,608,1105,816
0132-000,2016,8,14,11,521,648,1169,1105
0132-000,2016,8,14,12,548,622,1170,1169
0132-000,2016,8,14,13,613,651,1264,1170
0132-000,2016,8,14,14,638,642,1280,1264
0132-000,2016,8,14,15,639,668,1307,1280
0132-000,2016,8,14,16,728,613,1341,1307
0132-000,2016,8,14,17,864,692,1556,1341
0132-000,2016,8,14,18,1096,669,1765,1556
0132-000,2016,8,14,19,1029,586,1615,1765
0132-000,2016,8,14,20,893,518,1411,1615
0132-000,2016,8,14,21,735,468,1203,1411
0132-000,2016,8,14,22,674,364,1038,1203
0132-000,2016,8,14,23,371,300,671,1038
0132-000,2016,8,14,24,248,227,475,671
0132-000,2016,8,15,1,138,172,310,475
0132-000,2016,8,15,2,94,129,223,310
0132-000,2016,8,15,3,75,80,155,223
0132-000,2016,8,15,4,75,80,155,155
0132-000,2016,8,15,5,95,89,184,155
0132-000,2016,8,15,6,230,160,390,184
0132-000,2016,8,15,7,305,360,665,390
0132-000,2016,8,15,8,408,622,1030,665
0132-000,2016,8,15,9,507,612,1119,1030
0132-000,2016,8,15,10,571,665,1236,1119
0132-000,2016,8,15,11,592,668,1260,1236
0132-000,2016,8,15,12,832,812,1644,1260
0132-000,2016,8,15,13,909,774,1683,1644
0132-000,2016,8,15,14,969,714,1683,1683
0132-000,2016,8,15,15,1021,817,1838,1683
0132-000,2016,8,15,16,1124,746,1870,1838
0132-000,2016,8,15,17,1193,769,1962,1870
0132-000,2016,8,15,18,1485,842,2327,1962
0132-000,2016,8,15,19,1367,751,2118,2327
0132-000,2016,8,15,20,1015,588,1603,2118
0132-000,2016,8,15,21,802,508,1310,1603
0132-000,2016,8,15,22,525,420,945,1310
0132-000,2016,8,15,23,314,317,631,945
0132-000,2016,8,15,24,200,179,379,631
0132-000,2016,8,16,1,140,142,282,379
0132-000,2016,8,16,2,90,113,203,282
0132-000,2016,8,16,3,71,86,157,203
0132-000,2016,8,16,4,81,83,164,157
0132-000,2016,8,16,5,101,92,193,164
0132-000,2016,8,16,6,310,244,554,193
0132-000,2016,8,16,7,466,658,1124,554
0132-000,2016,8,16,8,701,1874,2575,1124
0132-000,2016,8,16,9,891,1510,2401,2575
0132-000,2016,8,16,10,806,867,1673,2401
0132-000,2016,8,16,11,830,943,1773,1673
0132-000,2016,8,16,12,861,894,1755,1773
0132-000,2016,8,16,13,824,847,1671,1755
0132-000,2016,8,16,14,882,829,1711,1671
0132-000,2016,8,16,15,856,877,1733,1711
0132-000,2016,8,16,16,933,831,1764,1733
0132-000,2016,8,16,17,957,835,1792,1764
0132-000,2016,8,16,18,1208,918,2126,1792
0132-000,2016,8,16,19,1561,912,2473,2126
0132-000,2016,8,16,20,1031,790,1821,2473
0132-000,2016,8,16,21,869,605,1474,1821
0132-000,2016,8,16,22,649,492,1141,1474
0132-000,2016,8,16,23,385,344,729,1141
0132-000,2016,8,16,24,248,230,478,729
0132-000,2016,8,17,1,158,158,316,478
0132-000,2016,8,17,2,115,123,238,316
0132-000,2016,8,17,3,56,84,140,238
0132-000,2016,8,17,4,90,116,206,140
0132-000,2016,8,17,5,100,109,209,206
0132-000,2016,8,17,6,322,223,545,209
0132-000,2016,8,17,7,453,576,1029,545
0132-000,2016,8,17,8,699,1826,2525,1029
0132-000,2016,8,17,9,851,1488,2339,2525
0132-000,2016,8,17,10,866,957,1823,2339
0132-000,2016,8,17,11,809,867,1676,1823
0132-000,2016,8,17,12,866,857,1723,1676
0132-000,2016,8,17,13,791,799,1590,1723
0132-000,2016,8,17,14,890,821,1711,1590
0132-000,2016,8,17,15,888,871,1759,1711
0132-000,2016,8,17,16,926,815,1741,1759
0132-000,2016,8,17,17,961,874,1835,1741
0132-000,2016,8,17,18,1276,961,2237,1835
0132-000,2016,8,17,19,1708,895,2603,2237
0132-000,2016,8,17,20,1033,771,1804,2603
0132-000,2016,8,17,21,836,589,1425,1804
0132-000,2016,8,17,22,600,464,1064,1425
0132-000,2016,8,17,23,355,374,729,1064
0132-000,2016,8,17,24,228,214,442,729
0132-000,2016,8,18,1,175,160,335,442
0132-000,2016,8,18,2,137,100,237,335
0132-000,2016,8,18,3,72,90,162,237
0132-000,2016,8,18,4,95,103,198,162
0132-000,2016,8,18,5,99,103,202,198
0132-000,2016,8,18,6,309,217,526,202
0132-000,2016,8,18,7,495,545,1040,526
0132-000,2016,8,18,8,692,1804,2496,1040
0132-000,2016,8,18,9,842,1454,2296,2496
0132-000,2016,8,18,10,828,896,1724,2296
0132-000,2016,8,18,11,771,879,1650,1724
0132-000,2016,8,18,12,838,838,1676,1650
0132-000,2016,8,18,13,771,857,1628,1676
0132-000,2016,8,18,14,846,823,1669,1628
0132-000,2016,8,18,15,892,918,1810,1669
0132-000,2016,8,18,16,913,841,1754,1810
0132-000,2016,8,18,17,1017,860,1877,1754
0132-000,2016,8,18,18,1252,987,2239,1877
0132-000,2016,8,18,19,1452,939,2391,2239
0132-000,2016,8,18,20,966,716,1682,2391
0132-000,2016,8,18,21,814,597,1411,1682
0132-000,2016,8,18,22,684,458,1142,1411
0132-000,2016,8,18,23,390,333,723,1142
0132-000,2016,8,18,24,247,233,480,723
0132-000,2016,8,19,1,177,167,344,480
0132-000,2016,8,19,2,81,102,183,344
0132-000,2016,8,19,3,90,97,187,183
0132-000,2016,8,19,4,85,106,191,187
0132-000,2016,8,19,5,122,122,244,191
0132-000,2016,8,19,6,299,208,507,244
0132-000,2016,8,19,7,510,575,1085,507
0132-000,2016,8,19,8,663,1812,2475,1085
0132-000,2016,8,19,9,875,1467,2342,2475
0132-000,2016,8,19,10,839,872,1711,2342
0132-000,2016,8,19,11,835,908,1743,1711
0132-000,2016,8,19,12,835,892,1727,1743
0132-000,2016,8,19,13,807,844,1651,1727
0132-000,2016,8,19,14,851,856,1707,1651
0132-000,2016,8,19,15,936,876,1812,1707
0132-000,2016,8,19,16,993,1035,2028,1812
0132-000,2016,8,19,17,1027,910,1937,2028
0132-000,2016,8,19,18,1329,1019,2348,1937
0132-000,2016,8,19,19,1679,981,2660,2348
0132-000,2016,8,19,20,1096,869,1965,2660
0132-000,2016,8,19,21,901,655,1556,1965
0132-000,2016,8,19,22,726,514,1240,1556
0132-000,2016,8,19,23,415,374,789,1240
0132-000,2016,8,19,24,276,317,593,789
0132-000,2016,8,20,1,239,221,460,593
0132-000,2016,8,20,2,171,149,320,460
0132-000,2016,8,20,3,106,105,211,320
0132-000,2016,8,20,4,85,105,190,211
0132-000,2016,8,20,5,114,119,233,190
0132-000,2016,8,20,6,310,221,531,233
0132-000,2016,8,20,7,439,477,916,531
0132-000,2016,8,20,8,510,888,1398,916
0132-000,2016,8,20,9,776,946,1722,1398
0132-000,2016,8,20,10,762,820,1582,1722
0132-000,2016,8,20,11,841,969,1810,1582
0132-000,2016,8,20,12,1064,1035,2099,1810
0132-000,2016,8,20,13,1402,985,2387,2099
0132-000,2016,8,20,14,1074,884,1958,2387
0132-000,2016,8,20,15,933,855,1788,1958
0132-000,2016,8,20,16,914,855,1769,1788
0132-000,2016,8,20,17,1041,939,1980,1769
0132-000,2016,8,20,18,1267,1074,2341,1980
0132-000,2016,8,20,19,1175,986,2161,2341
0132-000,2016,8,20,20,796,680,1476,2161
0132-000,2016,8,20,21,659,540,1199,1476
0132-000,2016,8,20,22,609,463,1072,1199
0132-000,2016,8,20,23,380,366,746,1072
0132-000,2016,8,20,24,206,265,471,746
0132-000,2016,8,21,1,180,187,367,471
0132-000,2016,8,21,2,121,140,261,367
0132-000,2016,8,21,3,115,109,224,261
0132-000,2016,8,21,4,93,88,181,224
0132-000,2016,8,21,5,103,100,203,181
0132-000,2016,8,21,6,214,134,348,203
0132-000,2016,8,21,7,273,303,576,348
0132-000,2016,8,21,8,291,418,709,576
0132-000,2016,8,21,9,390,512,902,709
0132-000,2016,8,21,10,451,571,1022,902
0132-000,2016,8,21,11,577,675,1252,1022
0132-000,2016,8,21,12,644,705,1349,1252
0132-000,2016,8,21,13,711,752,1463,1349
0132-000,2016,8,21,14,758,769,1527,1463
0132-000,2016,8,21,15,815,801,1616,1527
0132-000,2016,8,21,16,917,725,1642,1616
0132-000,2016,8,21,17,958,759,1717,1642
0132-000,2016,8,21,18,1039,763,1802,1717
0132-000,2016,8,21,19,1041,681,1722,1802
0132-000,2016,8,21,20,756,537,1293,1722
0132-000,2016,8,21,21,643,563,1206,1293
0132-000,2016,8,21,22,440,416,856,1206
0132-000,2016,8,21,23,317,281,598,856
0132-000,2016,8,21,24,193,238,431,598
0132-000,2016,8,22,1,115,141,256,431
0132-000,2016,8,22,2,68,94,162,256
0132-000,2016,8,22,3,72,75,147,162
0132-000,2016,8,22,4,48,91,139,147
0132-000,2016,8,22,5,97,101,198,139
0132-000,2016,8,22,6,330,241,571,198
0132-000,2016,8,22,7,562,738,1300,571
0132-000,2016,8,22,8,729,1919,2648,1300
0132-000,2016,8,22,9,839,1543,2382,2648
0132-000,2016,8,22,10,833,795,1628,2382
0132-000,2016,8,22,11,826,847,1673,1628
0132-000,2016,8,22,12,786,851,1637,1673
0132-000,2016,8,22,13,841,880,1721,1637
0132-000,2016,8,22,14,845,781,1626,1721
0132-000,2016,8,22,15,871,923,1794,1626
0132-000,2016,8,22,16,925,857,1782,1794
0132-000,2016,8,22,17,938,840,1778,1782
0132-000,2016,8,22,18,1259,960,2219,1778
0132-000,2016,8,22,19,1449,868,2317,2219
0132-000,2016,8,22,20,1022,752,1774,2317
0132-000,2016,8,22,21,894,632,1526,1774
0132-000,2016,8,22,22,638,447,1085,1526
0132-000,2016,8,22,23,369,349,718,1085
0132-000,2016,8,22,24,221,213,434,718
0132-000,2016,8,23,1,149,161,310,434
0132-000,2016,8,23,2,117,96,213,310
0132-000,2016,8,23,3,64,87,151,213
0132-000,2016,8,23,4,71,89,160,151
0132-000,2016,8,23,5,107,108,215,160
0132-000,2016,8,23,6,288,217,505,215
0132-000,2016,8,23,7,531,608,1139,505
0132-000,2016,8,23,8,706,1833,2539,1139
0132-000,2016,8,23,9,846,1562,2408,2539
0132-000,2016,8,23,10,883,899,1782,2408
0132-000,2016,8,23,11,826,806,1632,1782
0132-000,2016,8,23,12,786,916,1702,1632
0132-000,2016,8,23,13,799,821,1620,1702
0132-000,2016,8,23,14,847,875,1722,1620
0132-000,2016,8,23,15,951,952,1903,1722
0132-000,2016,8,23,16,1005,870,1875,1903
0132-000,2016,8,23,17,1017,882,1899,1875
0132-000,2016,8,23,18,1335,956,2291,1899
0132-000,2016,8,23,19,1606,890,2496,2291
0132-000,2016,8,23,20,1010,748,1758,2496
0132-000,2016,8,23,21,922,551,1473,1758
0132-000,2016,8,23,22,609,451,1060,1473
0132-000,2016,8,23,23,347,383,730,1060
0132-000,2016,8,23,24,212,207,419,730
0132-000,2016,8,24,1,166,162,328,419
0132-000,2016,8,24,2,99,94,193,328
0132-000,2016,8,24,3,87,105,192,193
0132-000,2016,8,24,4,83,97,180,192
0132-000,2016,8,24,5,111,108,219,180
0132-000,2016,8,24,6,315,212,527,219
0132-000,2016,8,24,7,526,602,1128,527
0132-000,2016,8,24,8,687,1813,2500,1128
0132-000,2016,8,24,9,921,1603,2524,2500
0132-000,2016,8,24,10,903,927,1830,2524
0132-000,2016,8,24,11,828,958,1786,1830
0132-000,2016,8,24,12,885,886,1771,1786
0132-000,2016,8,24,13,745,838,1583,1771
0132-000,2016,8,24,14,850,905,1755,1583
0132-000,2016,8,24,15,996,971,1967,1755
0132-000,2016,8,24,16,948,863,1811,1967
0132-000,2016,8,24,17,1043,880,1923,1811
0132-000,2016,8,24,18,1413,889,2302,1923
0132-000,2016,8,24,19,1675,918,2593,2302
0132-000,2016,8,24,20,1037,828,1865,2593
0132-000,2016,8,24,21,840,610,1450,1865
0132-000,2016,8,24,22,628,476,1104,1450
0132-000,2016,8,24,23,383,388,771,1104
0132-000,2016,8,24,24,245,254,499,771
0132-000,2016,8,25,1,185,194,379,499
0132-000,2016,8,25,2,115,93,208,379
0132-000,2016,8,25,3,100,106,206,208
0132-000,2016,8,25,4,72,90,162,206
0132-000,2016,8,25,5,115,114,229,162
0132-000,2016,8,25,6,320,223,543,229
0132-000,2016,8,25,7,497,600,1097,543
0132-000,2016,8,25,8,697,1856,2553,1097
0132-000,2016,8,25,9,898,1473,2371,2553
0132-000,2016,8,25,10,878,936,1814,2371
0132-000,2016,8,25,11,787,921,1708,1814
0132-000,2016,8,25,12,853,861,1714,1708
0132-000,2016,8,25,13,799,814,1613,1714
0132-000,2016,8,25,14,862,864,1726,1613
0132-000,2016,8,25,15,948,930,1878,1726
0132-000,2016,8,25,16,944,832,1776,1878
0132-000,2016,8,25,17,934,888,1822,1776
0132-000,2016,8,25,18,1254,955,2209,1822
0132-000,2016,8,25,19,1560,870,2430,2209
0132-000,2016,8,25,20,1027,845,1872,2430
0132-000,2016,8,25,21,857,586,1443,1872
0132-000,2016,8,25,22,674,455,1129,1443
0132-000,2016,8,25,23,361,341,702,1129
0132-000,2016,8,25,24,253,249,502,702
0132-000,2016,8,26,1,149,162,311,502
0132-000,2016,8,26,2,112,92,204,311
0132-000,2016,8,26,3,88,85,173,204
0132-000,2016,8,26,4,75,104,179,173
0132-000,2016,8,26,5,106,105,211,179
0132-000,2016,8,26,6,296,184,480,211
0132-000,2016,8,26,7,508,527,1035,480
0132-000,2016,8,26,8,649,1630,2279,1035
0132-000,2016,8,26,9,823,1657,2480,2279
0132-000,2016,8,26,10,841,884,1725,2480
0132-000,2016,8,26,11,857,942,1799,1725
0132-000,2016,8,26,12,841,907,1748,1799
0132-000,2016,8,26,13,833,841,1674,1748
0132-000,2016,8,26,14,837,888,1725,1674
0132-000,2016,8,26,15,897,979,1876,1725
0132-000,2016,8,26,16,1023,900,1923,1876
0132-000,2016,8,26,17,1121,992,2113,1923
0132-000,2016,8,26,18,1469,1027,2496,2113
0132-000,2016,8,26,19,1689,954,2643,2496
0132-000,2016,8,26,20,1138,862,2000,2643
0132-000,2016,8,26,21,958,613,1571,2000
0132-000,2016,8,26,22,763,516,1279,1571
0132-000,2016,8,26,23,433,427,860,1279
0132-000,2016,8,26,24,291,284,575,860
0132-000,2016,8,27,1,205,223,428,575
0132-000,2016,8,27,2,138,131,269,428
0132-000,2016,8,27,3,108,126,234,269
0132-000,2016,8,27,4,87,128,215,234
0132-000,2016,8,27,5,103,128,231,215
0132-000,2016,8,27,6,298,219,517,231
0132-000,2016,8,27,7,428,515,943,517
0132-000,2016,8,27,8,563,1062,1625,943
0132-000,2016,8,27,9,748,1223,1971,1625
0132-000,2016,8,27,10,796,1292,2088,1971
0132-000,2016,8,27,11,859,1451,2310,2088
0132-000,2016,8,27,12,902,1431,2333,2310
0132-000,2016,8,27,13,902,1514,2416,2333
0132-000,2016,8,27,14,1105,1270,2375,2416
0132-000,2016,8,27,15,1431,1168,2599,2375
0132-000,2016,8,27,16,1338,1270,2608,2599
0132-000,2016,8,27,17,1504,1336,2840,2608
0132-000,2016,8,27,18,1737,1334,3071,2840
0132-000,2016,8,27,19,1689,1118,2807,3071
0132-000,2016,8,27,20,1220,750,1970,2807
0132-000,2016,8,27,21,1009,607,1616,1970
0132-000,2016,8,27,22,716,461,1177,1616
0132-000,2016,8,27,23,399,373,772,1177
0132-000,2016,8,27,24,243,249,492,772
0132-000,2016,8,28,1,169,194,363,492
0132-000,2016,8,28,2,108,113,221,363
0132-000,2016,8,28,3,94,97,191,221
0132-000,2016,8,28,4,88,91,179,191
0132-000,2016,8,28,5,85,110,195,179
0132-000,2016,8,28,6,174,158,332,195
0132-000,2016,8,28,7,285,370,655,332
0132-000,2016,8,28,8,332,567,899,655
0132-000,2016,8,28,9,416,578,994,899
0132-000,2016,8,28,10,479,586,1065,994
0132-000,2016,8,28,11,601,670,1271,1065
0132-000,2016,8,28,12,712,676,1388,1271
0132-000,2016,8,28,13,922,704,1626,1388
0132-000,2016,8,28,14,982,755,1737,1626
0132-000,2016,8,28,15,1315,786,2101,1737
0132-000,2016,8,28,16,1701,722,2423,2101
0132-000,2016,8,28,17,1722,744,2466,2423
0132-000,2016,8,28,18,1793,797,2590,2466
0132-000,2016,8,28,19,1726,672,2398,2590
0132-000,2016,8,28,20,1748,525,2273,2398
0132-000,2016,8,28,21,1658,488,2146,2273
0132-000,2016,8,28,22,1637,405,2042,2146
0132-000,2016,8,28,23,926,316,1242,2042
0132-000,2016,8,28,24,494,225,719,1242
0132-000,2016,8,29,1,111,128,239,719
0132-000,2016,8,29,2,63,82,145,239
0132-000,2016,8,29,3,59,60,119,145
0132-000,2016,8,29,4,50,71,121,119
0132-000,2016,8,29,5,106,101,207,121
0132-000,2016,8,29,6,311,199,510,207
0132-000,2016,8,29,7,559,699,1258,510
0132-000,2016,8,29,8,673,1923,2596,1258
0132-000,2016,8,29,9,912,1716,2628,2596
0132-000,2016,8,29,10,844,966,1810,2628
0132-000,2016,8,29,11,820,945,1765,1810
0132-000,2016,8,29,12,898,943,1841,1765
0132-000,2016,8,29,13,791,894,1685,1841
0132-000,2016,8,29,14,896,891,1787,1685
0132-000,2016,8,29,15,895,924,1819,1787
0132-000,2016,8,29,16,963,913,1876,1819
0132-000,2016,8,29,17,1081,905,1986,1876
0132-000,2016,8,29,18,1282,1007,2289,1986
0132-000,2016,8,29,19,1659,968,2627,2289
0132-000,2016,8,29,20,1024,780,1804,2627
0132-000,2016,8,29,21,857,574,1431,1804
0132-000,2016,8,29,22,633,423,1056,1431
0132-000,2016,8,29,23,382,314,696,1056
0132-000,2016,8,29,24,219,193,412,696
0132-000,2016,8,30,1,150,150,300,412
0132-000,2016,8,30,2,101,102,203,300
0132-000,2016,8,30,3,78,69,147,203
0132-000,2016,8,30,4,79,99,178,147
0132-000,2016,8,30,5,100,118,218,178
0132-000,2016,8,30,6,329,204,533,218
0132-000,2016,8,30,7,492,599,1091,533
0132-000,2016,8,30,8,731,1634,2365,1091
0132-000,2016,8,30,9,876,1706,2582,2365
0132-000,2016,8,30,10,852,951,1803,2582
0132-000,2016,8,30,11,827,887,1714,1803
0132-000,2016,8,30,12,836,913,1749,1714
0132-000,2016,8,30,13,811,829,1640,1749
0132-000,2016,8,30,14,849,883,1732,1640
0132-000,2016,8,30,15,989,951,1940,1732
0132-000,2016,8,30,16,1069,866,1935,1940
0132-000,2016,8,30,17,1051,871,1922,1935
0132-000,2016,8,30,18,1317,945,2262,1922
0132-000,2016,8,30,19,1512,935,2447,2262
0132-000,2016,8,30,20,961,714,1675,2447
0132-000,2016,8,30,21,890,585,1475,1675
0132-000,2016,8,30,22,663,442,1105,1475
0132-000,2016,8,30,23,349,331,680,1105
0132-000,2016,8,30,24,221,209,430,680
0132-000,2016,8,31,1,125,140,265,430
0132-000,2016,8,31,2,91,103,194,265
0132-000,2016,8,31,3,72,70,142,194
0132-000,2016,8,31,4,69,79,148,142
0132-000,2016,8,31,5,91,99,190,148
0132-000,2016,8,31,6,224,160,384,190
0132-000,2016,8,31,7,418,527,945,384
0132-000,2016,8,31,8,633,1537,2170,945
0132-000,2016,8,31,9,868,1601,2469,2170
0132-000,2016,8,31,10,761,879,1640,2469
0132-000,2016,8,31,11,804,864,1668,1640
0132-000,2016,8,31,12,769,833,1602,1668
0132-000,2016,8,31,13,707,827,1534,1602
0132-000,2016,8,31,14,822,768,1590,1534
0132-000,2016,8,31,15,856,851,1707,1590
0132-000,2016,8,31,16,941,834,1775,1707
0132-000,2016,8,31,17,964,826,1790,1775
0132-000,2016,8,31,18,1333,939,2272,1790
0132-000,2016,8,31,19,1574,917,2491,2272
0132-000,2016,8,31,20,1033,701,1734,2491
0132-000,2016,8,31,21,822,579,1401,1734
0132-000,2016,8,31,22,566,436,1002,1401
0132-000,2016,8,31,23,426,407,833,1002
0132-000,2016,8,31,24,287,228,515,833
0132-000,2016,9,1,1,192,168,360,515
0132-000,2016,9,1,2,128,99,227,360
0132-000,2016,9,1,3,67,93,160,227
0132-000,2016,9,1,4,75,100,175,160
0132-000,2016,9,1,5,137,94,231,175
0132-000,2016,9,1,6,280,188,468,231
0132-000,2016,9,1,7,472,594,1066,468
0132-000,2016,9,1,8,725,1705,2430,1066
0132-000,2016,9,1,9,911,1604,2515,2430
0132-000,2016,9,1,10,858,906,1764,2515
0132-000,2016,9,1,11,847,964,1811,1764
0132-000,2016,9,1,12,887,995,1882,1811
0132-000,2016,9,1,13,897,850,1747,1882
0132-000,2016,9,1,14,914,898,1812,1747
0132-000,2016,9,1,15,957,911,1868,1812
0132-000,2016,9,1,16,1018,937,1955,1868
0132-000,2016,9,1,17,1012,857,1869,1955
0132-000,2016,9,1,18,1264,1019,2283,1869
0132-000,2016,9,1,19,1579,929,2508,2283
0132-000,2016,9,1,20,1081,814,1895,2508
0132-000,2016,9,1,21,914,636,1550,1895
0132-000,2016,9,1,22,710,486,1196,1550
0132-000,2016,9,1,23,422,396,818,1196
0132-000,2016,9,1,24,268,263,531,818
0132-000,2016,9,2,1,194,190,384,531
0132-000,2016,9,2,2,113,117,230,384
0132-000,2016,9,2,3,90,86,176,230
0132-000,2016,9,2,4,97,93,190,176
0132-000,2016,9,2,5,101,116,217,190
0132-000,2016,9,2,6,285,209,494,217
0132-000,2016,9,2,7,501,533,1034,494
0132-000,2016,9,2,8,698,1723,2421,1034
0132-000,2016,9,2,9,908,1525,2433,2421
0132-000,2016,9,2,10,836,904,1740,2433
0132-000,2016,9,2,11,891,887,1778,1740
0132-000,2016,9,2,12,883,928,1811,1778
0132-000,2016,9,2,13,823,863,1686,1811
0132-000,2016,9,2,14,929,882,1811,1686
0132-000,2016,9,2,15,1023,927,1950,1811
0132-000,2016,9,2,16,1033,931,1964,1950
0132-000,2016,9,2,17,1188,960,2148,1964
0132-000,2016,9,2,18,1676,1133,2809,2148
0132-000,2016,9,2,19,1810,962,2772,2809
0132-000,2016,9,2,20,1170,915,2085,2772
0132-000,2016,9,2,21,943,672,1615,2085
0132-000,2016,9,2,22,775,565,1340,1615
0132-000,2016,9,2,23,434,426,860,1340
0132-000,2016,9,2,24,268,257,525,860
0132-000,2016,9,3,1,218,188,406,525
0132-000,2016,9,3,2,159,147,306,406
0132-000,2016,9,3,3,92,114,206,306
0132-000,2016,9,3,4,97,133,230,206
0132-000,2016,9,3,5,118,131,249,230
0132-000,2016,9,3,6,254,222,476,249
0132-000,2016,9,3,7,442,486,928,476
0132-000,2016,9,3,8,584,1074,1658,928
0132-000,2016,9,3,9,714,1315,2029,1658
0132-000,2016,9,3,10,870,1403,2273,2029
0132-000,2016,9,3,11,842,1449,2291,2273
0132-000,2016,9,3,12,971,1565,2536,2291
0132-000,2016,9,3,13,1031,1647,2678,2536
0132-000,2016,9,3,14,1044,1370,2414,2678
0132-000,2016,9,3,15,1040,1098,2138,2414
0132-000,2016,9,3,16,1134,975,2109,2138
0132-000,2016,9,3,17,1238,1015,2253,2109
0132-000,2016,9,3,18,1801,1077,2878,2253
0132-000,2016,9,3,19,1773,983,2756,2878
0132-000,2016,9,3,20,1089,705,1794,2756
0132-000,2016,9,3,21,1088,604,1692,1794
0132-000,2016,9,3,22,742,480,1222,1692
0132-000,2016,9,3,23,403,358,761,1222
0132-000,2016,9,3,24,283,298,581,761
0132-000,2016,9,4,1,169,203,372,581
0132-000,2016,9,4,2,134,146,280,372
0132-000,2016,9,4,3,93,113,206,280
0132-000,2016,9,4,4,75,78,153,206
0132-000,2016,9,4,5,96,102,198,153
0132-000,2016,9,4,6,193,193,386,198
0132-000,2016,9,4,7,276,376,652,386
0132-000,2016,9,4,8,358,956,1314,652
0132-000,2016,9,4,9,410,985,1395,1314
0132-000,2016,9,4,10,535,796,1331,1395
0132-000,2016,9,4,11,666,763,1429,1331
0132-000,2016,9,4,12,761,759,1520,1429
0132-000,2016,9,4,13,850,750,1600,1520
0132-000,2016,9,4,14,1042,822,1864,1600
0132-000,2016,9,4,15,1275,782,2057,1864
0132-000,2016,9,4,16,1655,785,2440,2057
0132-000,2016,9,4,17,1888,790,2678,2440
0132-000,2016,9,4,18,1933,776,2709,2678
0132-000,2016,9,4,19,1842,666,2508,2709
0132-000,2016,9,4,20,1396,572,1968,2508
0132-000,2016,9,4,21,1121,496,1617,1968
0132-000,2016,9,4,22,658,379,1037,1617
0132-000,2016,9,4,23,360,327,687,1037
0132-000,2016,9,4,24,229,210,439,687
0132-000,2016,9,5,1,132,148,280,439
0132-000,2016,9,5,2,78,92,170,280
0132-000,2016,9,5,3,54,97,151,170
0132-000,2016,9,5,4,57,70,127,151
0132-000,2016,9,5,5,105,90,195,127
0132-000,2016,9,5,6,330,226,556,195
0132-000,2016,9,5,7,530,701,1231,556
0132-000,2016,9,5,8,775,1966,2741,1231
0132-000,2016,9,5,9,935,1634,2569,2741
0132-000,2016,9,5,10,783,933,1716,2569
0132-000,2016,9,5,11,877,930,1807,1716
0132-000,2016,9,5,12,865,935,1800,1807
0132-000,2016,9,5,13,847,913,1760,1800
0132-000,2016,9,5,14,898,1006,1904,1760
0132-000,2016,9,5,15,941,985,1926,1904
0132-000,2016,9,5,16,996,941,1937,1926
0132-000,2016,9,5,17,1050,928,1978,1937
0132-000,2016,9,5,18,1245,1003,2248,1978
0132-000,2016,9,5,19,1604,919,2523,2248
0132-000,2016,9,5,20,1097,830,1927,2523
0132-000,2016,9,5,21,931,568,1499,1927
0132-000,2016,9,5,22,684,472,1156,1499
0132-000,2016,9,5,23,393,357,750,1156
0132-000,2016,9,5,24,223,236,459,750
0132-000,2016,9,6,1,167,158,325,459
0132-000,2016,9,6,2,124,118,242,325
0132-000,2016,9,6,3,76,90,166,242
0132-000,2016,9,6,4,72,109,181,166
0132-000,2016,9,6,5,102,111,213,181
0132-000,2016,9,6,6,310,207,517,213
0132-000,2016,9,6,7,518,595,1113,517
0132-000,2016,9,6,8,767,1662,2429,1113
0132-000,2016,9,6,9,939,1659,2598,2429
0132-000,2016,9,6,10,875,995,1870,2598
0132-000,2016,9,6,11,840,943,1783,1870
0132-000,2016,9,6,12,866,986,1852,1783
0132-000,2016,9,6,13,809,878,1687,1852
0132-000,2016,9,6,14,892,892,1784,1687
0132-000,2016,9,6,15,953,963,1916,1784
0132-000,2016,9,6,16,1000,886,1886,1916
0132-000,2016,9,6,17,1066,869,1935,1886
0132-000,2016,9,6,18,1370,1015,2385,1935
0132-000,2016,9,6,19,1579,958,2537,2385
0132-000,2016,9,6,20,1057,801,1858,2537
0132-000,2016,9,6,21,941,612,1553,1858
0132-000,2016,9,6,22,707,470,1177,1553
0132-000,2016,9,6,23,421,378,799,1177
0132-000,2016,9,6,24,269,248,517,799
0132-000,2016,9,7,1,180,185,365,517
0132-000,2016,9,7,2,123,104,227,365
0132-000,2016,9,7,3,74,83,157,227
0132-000,2016,9,7,4,87,101,188,157
0132-000,2016,9,7,5,107,118,225,188
0132-000,2016,9,7,6,296,190,486,225
0132-000,2016,9,7,7,536,545,1081,486
0132-000,2016,9,7,8,769,1496,2265,1081
0132-000,2016,9,7,9,892,1574,2466,2265
0132-000,2016,9,7,10,899,1023,1922,2466
0132-000,2016,9,7,11,856,947,1803,1922
0132-000,2016,9,7,12,876,934,1810,1803
0132-000,2016,9,7,13,848,909,1757,1810
0132-000,2016,9,7,14,887,894,1781,1757
0132-000,2016,9,7,15,1002,935,1937,1781
0132-000,2016,9,7,16,978,880,1858,1937
0132-000,2016,9,7,17,1067,882,1949,1858
0132-000,2016,9,7,18,1402,1053,2455,1949
0132-000,2016,9,7,19,1670,902,2572,2455
0132-000,2016,9,7,20,984,826,1810,2572
0132-000,2016,9,7,21,894,607,1501,1810
0132-000,2016,9,7,22,660,505,1165,1501
0132-000,2016,9,7,23,405,383,788,1165
0132-000,2016,9,7,24,265,264,529,788
0132-000,2016,9,8,1,189,202,391,529
0132-000,2016,9,8,2,117,143,260,391
0132-000,2016,9,8,3,90,103,193,260
0132-000,2016,9,8,4,84,102,186,193
0132-000,2016,9,8,5,116,118,234,186
0132-000,2016,9,8,6,266,185,451,234
0132-000,2016,9,8,7,546,563,1109,451
0132-000,2016,9,8,8,750,1600,2350,1109
0132-000,2016,9,8,9,935,1574,2509,2350
0132-000,2016,9,8,10,856,982,1838,2509
0132-000,2016,9,8,11,837,924,1761,1838
0132-000,2016,9,8,12,792,1021,1813,1761
0132-000,2016,9,8,13,889,850,1739,1813
0132-000,2016,9,8,14,924,893,1817,1739
0132-000,2016,9,8,15,945,988,1933,1817
0132-000,2016,9,8,16,1075,966,2041,1933
0132-000,2016,9,8,17,1124,971,2095,2041
0132-000,2016,9,8,18,1324,1001,2325,2095
0132-000,2016,9,8,19,1575,952,2527,2325
0132-000,2016,9,8,20,1050,842,1892,2527
0132-000,2016,9,8,21,916,602,1518,1892
0132-000,2016,9,8,22,719,515,1234,1518
0132-000,2016,9,8,23,445,396,841,1234
0132-000,2016,9,8,24,313,268,581,841
0132-000,2016,9,9,1,169,198,367,581
0132-000,2016,9,9,2,119,129,248,367
0132-000,2016,9,9,3,99,85,184,248
0132-000,2016,9,9,4,94,123,217,184
0132-000,2016,9,9,5,104,121,225,217
0132-000,2016,9,9,6,300,226,526,225
0132-000,2016,9,9,7,537,623,1160,526
0132-000,2016,9,9,8,760,1893,2653,1160
0132-000,2016,9,9,9,947,1286,2233,2653
0132-000,2016,9,9,10,891,954,1845,2233
0132-000,2016,9,9,11,869,990,1859,1845
0132-000,2016,9,9,12,912,955,1867,1859
0132-000,2016,9,9,13,868,793,1661,1867
0132-000,2016,9,9,14,936,875,1811,1661
0132-000,2016,9,9,15,968,933,1901,1811
0132-000,2016,9,9,16,1099,920,2019,1901
0132-000,2016,9,9,17,1166,950,2116,2019
0132-000,2016,9,9,18,1532,1105,2637,2116
0132-000,2016,9,9,19,1866,954,2820,2637
0132-000,2016,9,9,20,1202,891,2093,2820
0132-000,2016,9,9,21,976,705,1681,2093
0132-000,2016,9,9,22,792,578,1370,1681
0132-000,2016,9,9,23,512,428,940,1370
0132-000,2016,9,9,24,268,314,582,940
0132-000,2016,9,10,1,227,216,443,582
0132-000,2016,9,10,2,130,165,295,443
0132-000,2016,9,10,3,110,131,241,295
0132-000,2016,9,10,4,140,118,258,241
0132-000,2016,9,10,5,123,125,248,258
0132-000,2016,9,10,6,297,232,529,248
0132-000,2016,9,10,7,473,533,1006,529
0132-000,2016,9,10,8,615,991,1606,1006
0132-000,2016,9,10,9,778,1160,1938,1606
0132-000,2016,9,10,10,885,1091,1976,1938
0132-000,2016,9,10,11,915,1052,1967,1976
0132-000,2016,9,10,12,990,1079,2069,1967
0132-000,2016,9,10,13,1061,940,2001,2069
0132-000,2016,9,10,14,950,951,1901,2001
0132-000,2016,9,10,15,1072,1079,2151,1901
0132-000,2016,9,10,16,1042,929,1971,2151
0132-000,2016,9,10,17,1109,1050,2159,1971
0132-000,2016,9,10,18,1459,1090,2549,2159
0132-000,2016,9,10,19,1194,944,2138,2549
0132-000,2016,9,10,20,860,699,1559,2138
0132-000,2016,9,10,21,698,569,1267,1559
0132-000,2016,9,10,22,573,452,1025,1267
0132-000,2016,9,10,23,384,384,768,1025
0132-000,2016,9,10,24,231,277,508,768
0132-000,2016,9,11,1,166,186,352,508
0132-000,2016,9,11,2,157,145,302,352
0132-000,2016,9,11,3,117,132,249,302
0132-000,2016,9,11,4,111,106,217,249
0132-000,2016,9,11,5,90,108,198,217
0132-000,2016,9,11,6,229,183,412,198
0132-000,2016,9,11,7,284,345,629,412
0132-000,2016,9,11,8,367,525,892,629
0132-000,2016,9,11,9,493,625,1118,892
0132-000,2016,9,11,10,567,686,1253,1118
0132-000,2016,9,11,11,683,730,1413,1253
0132-000,2016,9,11,12,695,773,1468,1413
0132-000,2016,9,11,13,709,762,1471,1468
0132-000,2016,9,11,14,876,712,1588,1471
0132-000,2016,9,11,15,874,780,1654,1588
0132-000,2016,9,11,16,962,810,1772,1654
0132-000,2016,9,11,17,936,837,1773,1772
0132-000,2016,9,11,18,1014,816,1830,1773
0132-000,2016,9,11,19,942,661,1603,1830
0132-000,2016,9,11,20,728,604,1332,1603
0132-000,2016,9,11,21,555,476,1031,1332
0132-000,2016,9,11,22,437,397,834,1031
0132-000,2016,9,11,23,264,313,577,834
0132-000,2016,9,11,24,199,202,401,577
0132-000,2016,9,12,1,115,143,258,401
0132-000,2016,9,12,2,76,97,173,258
0132-000,2016,9,12,3,72,82,154,173
0132-000,2016,9,12,4,70,78,148,154
0132-000,2016,9,12,5,99,107,206,148
0132-000,2016,9,12,6,268,233,501,206
0132-000,2016,9,12,7,553,687,1240,501
0132-000,2016,9,12,8,733,1997,2730,1240
0132-000,2016,9,12,9,929,1475,2404,2730
0132-000,2016,9,12,10,905,1035,1940,2404
0132-000,2016,9,12,11,975,1034,2009,1940
0132-000,2016,9,12,12,960,1033,1993,2009
0132-000,2016,9,12,13,954,941,1895,1993
0132-000,2016,9,12,14,964,999,1963,1895
0132-000,2016,9,12,15,977,1047,2024,1963
0132-000,2016,9,12,16,1117,1003,2120,2024
0132-000,2016,9,12,17,1143,1120,2263,2120
0132-000,2016,9,12,18,1398,1038,2436,2263
0132-000,2016,9,12,19,1666,969,2635,2436
0132-000,2016,9,12,20,1080,893,1973,2635
0132-000,2016,9,12,21,982,657,1639,1973
0132-000,2016,9,12,22,676,537,1213,1639
0132-000,2016,9,12,23,490,397,887,1213
0132-000,2016,9,12,24,214,238,452,887
0132-000,2016,9,13,1,177,179,356,452
0132-000,2016,9,13,2,149,142,291,356
0132-000,2016,9,13,3,75,113,188,291
0132-000,2016,9,13,4,86,107,193,188
0132-000,2016,9,13,5,81,110,191,193
0132-000,2016,9,13,6,244,208,452,191
0132-000,2016,9,13,7,417,526,943,452
0132-000,2016,9,13,8,702,1847,2549,943
0132-000,2016,9,13,9,894,1461,2355,2549
0132-000,2016,9,13,10,899,987,1886,2355
0132-000,2016,9,13,11,874,1007,1881,1886
0132-000,2016,9,13,12,929,1006,1935,1881
0132-000,2016,9,13,13,909,1020,1929,1935
0132-000,2016,9,13,14,965,1240,2205,1929
0132-000,2016,9,13,15,1064,1398,2462,2205
0132-000,2016,9,13,16,1201,1647,2848,2462
0132-000,2016,9,13,17,1309,1805,3114,2848
0132-000,2016,9,13,18,1738,1781,3519,3114
0132-000,2016,9,13,19,1609,1638,3247,3519
0132-000,2016,9,13,20,843,1678,2521,3247
0132-000,2016,9,13,21,683,1561,2244,2521
0132-000,2016,9,13,22,499,1082,1581,2244
0132-000,2016,9,13,23,399,836,1235,1581
0132-000,2016,9,13,24,243,637,880,1235
0132-000,2016,9,14,1,190,718,908,880
0132-000,2016,9,14,2,123,1046,1169,908
0132-000,2016,9,14,3,104,778,882,1169
0132-000,2016,9,14,4,94,1527,1621,882
0132-000,2016,9,14,5,79,1211,1290,1621
0132-000,2016,9,14,6,110,1604,1714,1290
0132-000,2016,9,14,7,151,1568,1719,1714
0132-000,2016,9,14,8,281,1830,2111,1719
0132-000,2016,9,14,9,351,1880,2231,2111
0132-000,2016,9,14,10,527,1803,2330,2231
0132-000,2016,9,14,11,640,2192,2832,2330
0132-000,2016,9,14,12,744,2187,2931,2832
0132-000,2016,9,14,13,702,2310,3012,2931
0132-000,2016,9,14,14,769,2332,3101,3012
0132-000,2016,9,14,15,714,1985,2699,3101
0132-000,2016,9,14,16,697,1535,2232,2699
0132-000,2016,9,14,17,547,1278,1825,2232
0132-000,2016,9,14,18,644,929,1573,1825
0132-000,2016,9,14,19,522,652,1174,1573
0132-000,2016,9,14,20,477,464,941,1174
0132-000,2016,9,14,21,381,387,768,941
0132-000,2016,9,14,22,306,324,630,768
0132-000,2016,9,14,23,211,258,469,630
0132-000,2016,9,14,24,150,176,326,469
0132-000,2016,9,15,1,111,140,251,326
0132-000,2016,9,15,2,88,112,200,251
0132-000,2016,9,15,3,68,63,131,200
0132-000,2016,9,15,4,53,55,108,131
0132-000,2016,9,15,5,43,58,101,108
0132-000,2016,9,15,6,79,112,191,101
0132-000,2016,9,15,7,244,404,648,191
0132-000,2016,9,15,8,432,924,1356,648
0132-000,2016,9,15,9,422,1000,1422,1356
0132-000,2016,9,15,10,504,1417,1921,1422
0132-000,2016,9,15,11,864,1800,2664,1921
0132-000,2016,9,15,12,1370,1739,3109,2664
0132-000,2016,9,15,13,1777,1914,3691,3109
0132-000,2016,9,15,14,2134,2138,4272,3691
0132-000,2016,9,15,15,2240,2131,4371,4272
0132-000,2016,9,15,16,2143,2176,4319,4371
0132-000,2016,9,15,17,2192,2111,4303,4319
0132-000,2016,9,15,18,2305,2209,4514,4303
0132-000,2016,9,15,19,2278,1592,3870,4514
0132-000,2016,9,15,20,1980,666,2646,3870
0132-000,2016,9,15,21,1772,431,2203,2646
0132-000,2016,9,15,22,1363,340,1703,2203
0132-000,2016,9,15,23,1080,280,1360,1703
0132-000,2016,9,15,24,536,192,728,1360
0132-000,2016,9,16,1,364,149,513,728
0132-000,2016,9,16,2,202,93,295,513
0132-000,2016,9,16,3,108,65,173,295
0132-000,2016,9,16,4,66,67,133,173
0132-000,2016,9,16,5,90,53,143,133
0132-000,2016,9,16,6,88,76,164,143
0132-000,2016,9,16,7,169,140,309,164
0132-000,2016,9,16,8,233,214,447,309
0132-000,2016,9,16,9,340,320,660,447
0132-000,2016,9,16,10,597,428,1025,660
0132-000,2016,9,16,11,908,615,1523,1025
0132-000,2016,9,16,12,1292,668,1960,1523
0132-000,2016,9,16,13,1394,685,2079,1960
0132-000,2016,9,16,14,1470,608,2078,2079
0132-000,2016,9,16,15,1768,638,2406,2078
0132-000,2016,9,16,16,1807,606,2413,2406
0132-000,2016,9,16,17,2093,549,2642,2413
0132-000,2016,9,16,18,2089,543,2632,2642
0132-000,2016,9,16,19,1455,496,1951,2632
0132-000,2016,9,16,20,1982,380,2362,1951
0132-000,2016,9,16,21,1535,330,1865,2362
0132-000,2016,9,16,22,1821,287,2108,1865
0132-000,2016,9,16,23,1436,234,1670,2108
0132-000,2016,9,16,24,1568,182,1750,1670
0132-000,2016,9,17,1,885,150,1035,1750
0132-000,2016,9,17,2,511,85,596,1035
0132-000,2016,9,17,3,158,82,240,596
0132-000,2016,9,17,4,82,73,155,240
0132-000,2016,9,17,5,85,75,160,155
0132-000,2016,9,17,6,82,78,160,160
0132-000,2016,9,17,7,176,169,345,160
0132-000,2016,9,17,8,249,337,586,345
0132-000,2016,9,17,9,364,377,741,586
0132-000,2016,9,17,10,498,413,911,741
0132-000,2016,9,17,11,708,519,1227,911
0132-000,2016,9,17,12,867,616,1483,1227
0132-000,2016,9,17,13,1223,634,1857,1483
0132-000,2016,9,17,14,1274,700,1974,1857
0132-000,2016,9,17,15,1615,650,2265,1974
0132-000,2016,9,17,16,1478,624,2102,2265
0132-000,2016,9,17,17,1651,620,2271,2102
0132-000,2016,9,17,18,1656,613,2269,2271
0132-000,2016,9,17,19,1295,502,1797,2269
0132-000,2016,9,17,20,1017,428,1445,1797
0132-000,2016,9,17,21,903,388,1291,1445
0132-000,2016,9,17,22,607,356,963,1291
0132-000,2016,9,17,23,334,293,627,963
0132-000,2016,9,17,24,209,192,401,627
0132-000,2016,9,18,1,151,161,312,401
0132-000,2016,9,18,2,117,142,259,312
0132-000,2016,9,18,3,89,112,201,259
0132-000,2016,9,18,4,70,72,142,201
0132-000,2016,9,18,5,80,73,153,142
0132-000,2016,9,18,6,113,85,198,153
0132-000,2016,9,18,7,140,199,339,198
0132-000,2016,9,18,8,237,323,560,339
0132-000,2016,9,18,9,334,394,728,560
0132-000,2016,9,18,10,427,450,877,728
0132-000,2016,9,18,11,519,588,1107,877
0132-000,2016,9,18,12,556,539,1095,1107
0132-000,2016,9,18,13,691,656,1347,1095
0132-000,2016,9,18,14,699,688,1387,1347
0132-000,2016,9,18,15,733,763,1496,1387
0132-000,2016,9,18,16,793,678,1471,1496
0132-000,2016,9,18,17,863,647,1510,1471
0132-000,2016,9,18,18,831,672,1503,1510
0132-000,2016,9,18,19,774,603,1377,1503
0132-000,2016,9,18,20,570,524,1094,1377
0132-000,2016,9,18,21,505,426,931,1094
0132-000,2016,9,18,22,415,334,749,931
0132-000,2016,9,18,23,274,270,544,749
0132-000,2016,9,18,24,182,176,358,544
0132-000,2016,9,19,1,118,141,259,358
0132-000,2016,9,19,2,74,90,164,259
0132-000,2016,9,19,3,67,73,140,164
0132-000,2016,9,19,4,49,71,120,140
0132-000,2016,9,19,5,94,95,189,120
0132-000,2016,9,19,6,312,206,518,189
0132-000,2016,9,19,7,488,669,1157,518
0132-000,2016,9,19,8,685,1926,2611,1157
0132-000,2016,9,19,9,861,1635,2496,2611
0132-000,2016,9,19,10,835,944,1779,2496
0132-000,2016,9,19,11,834,808,1642,1779
0132-000,2016,9,19,12,802,938,1740,1642
0132-000,2016,9,19,13,777,802,1579,1740
0132-000,2016,9,19,14,888,825,1713,1579
0132-000,2016,9,19,15,898,838,1736,1713
0132-000,2016,9,19,16,925,819,1744,1736
0132-000,2016,9,19,17,1011,867,1878,1744
0132-000,2016,9,19,18,1232,970,2202,1878
0132-000,2016,9,19,19,1507,840,2347,2202
0132-000,2016,9,19,20,973,815,1788,2347
0132-000,2016,9,19,21,815,526,1341,1788
0132-000,2016,9,19,22,597,430,1027,1341
0132-000,2016,9,19,23,376,315,691,1027
0132-000,2016,9,19,24,204,215,419,691
0132-000,2016,9,20,1,166,150,316,419
0132-000,2016,9,20,2,96,92,188,316
0132-000,2016,9,20,3,77,101,178,188
0132-000,2016,9,20,4,68,85,153,178
0132-000,2016,9,20,5,105,120,225,153
0132-000,2016,9,20,6,293,208,501,225
0132-000,2016,9,20,7,472,576,1048,501
0132-000,2016,9,20,8,712,1885,2597,1048
0132-000,2016,9,20,9,886,1515,2401,2597
0132-000,2016,9,20,10,852,963,1815,2401
0132-000,2016,9,20,11,853,845,1698,1815
0132-000,2016,9,20,12,809,892,1701,1698
0132-000,2016,9,20,13,820,838,1658,1701
0132-000,2016,9,20,14,870,844,1714,1658
0132-000,2016,9,20,15,886,946,1832,1714
0132-000,2016,9,20,16,980,870,1850,1832
0132-000,2016,9,20,17,991,817,1808,1850
0132-000,2016,9,20,18,1282,945,2227,1808
0132-000,2016,9,20,19,1535,957,2492,2227
0132-000,2016,9,20,20,1039,753,1792,2492
0132-000,2016,9,20,21,893,592,1485,1792
0132-000,2016,9,20,22,701,499,1200,1485
0132-000,2016,9,20,23,411,336,747,1200
0132-000,2016,9,20,24,250,251,501,747
0132-000,2016,9,21,1,160,153,313,501
0132-000,2016,9,21,2,108,86,194,313
0132-000,2016,9,21,3,70,72,142,194
0132-000,2016,9,21,4,72,88,160,142
0132-000,2016,9,21,5,105,130,235,160
0132-000,2016,9,21,6,270,215,485,235
0132-000,2016,9,21,7,501,599,1100,485
0132-000,2016,9,21,8,738,1904,2642,1100
0132-000,2016,9,21,9,897,1579,2476,2642
0132-000,2016,9,21,10,826,997,1823,2476
0132-000,2016,9,21,11,825,887,1712,1823
0132-000,2016,9,21,12,865,823,1688,1712
0132-000,2016,9,21,13,785,875,1660,1688
0132-000,2016,9,21,14,917,852,1769,1660
0132-000,2016,9,21,15,957,858,1815,1769
0132-000,2016,9,21,16,997,868,1865,1815
0132-000,2016,9,21,17,1037,900,1937,1865
0132-000,2016,9,21,18,1420,972,2392,1937
0132-000,2016,9,21,19,1686,891,2577,2392
0132-000,2016,9,21,20,1040,728,1768,2577
0132-000,2016,9,21,21,835,581,1416,1768
0132-000,2016,9,21,22,630,474,1104,1416
0132-000,2016,9,21,23,416,351,767,1104
0132-000,2016,9,21,24,221,233,454,767
0132-000,2016,9,22,1,157,176,333,454
0132-000,2016,9,22,2,119,109,228,333
0132-000,2016,9,22,3,89,106,195,228
0132-000,2016,9,22,4,73,90,163,195
0132-000,2016,9,22,5,131,133,264,163
0132-000,2016,9,22,6,291,194,485,264
0132-000,2016,9,22,7,498,580,1078,485
0132-000,2016,9,22,8,703,1898,2601,1078
0132-000,2016,9,22,9,879,1518,2397,2601
0132-000,2016,9,22,10,852,939,1791,2397
0132-000,2016,9,22,11,824,907,1731,1791
0132-000,2016,9,22,12,830,1007,1837,1731
0132-000,2016,9,22,13,766,915,1681,1837
0132-000,2016,9,22,14,840,859,1699,1681
0132-000,2016,9,22,15,936,861,1797,1699
0132-000,2016,9,22,16,971,826,1797,1797
0132-000,2016,9,22,17,1034,899,1933,1797
0132-000,2016,9,22,18,1278,935,2213,1933
0132-000,2016,9,22,19,1587,892,2479,2213
0132-000,2016,9,22,20,1003,713,1716,2479
0132-000,2016,9,22,21,950,584,1534,1716
0132-000,2016,9,22,22,724,445,1169,1534
0132-000,2016,9,22,23,422,394,816,1169
0132-000,2016,9,22,24,219,234,453,816
0132-000,2016,9,23,1,178,168,346,453
0132-000,2016,9,23,2,106,99,205,346
0132-000,2016,9,23,3,83,109,192,205
0132-000,2016,9,23,4,81,91,172,192
0132-000,2016,9,23,5,116,130,246,172
0132-000,2016,9,23,6,266,166,432,246
0132-000,2016,9,23,7,499,583,1082,432
0132-000,2016,9,23,8,690,1883,2573,1082
0132-000,2016,9,23,9,926,1553,2479,2573
0132-000,2016,9,23,10,816,915,1731,2479
0132-000,2016,9,23,11,816,869,1685,1731
0132-000,2016,9,23,12,839,892,1731,1685
0132-000,2016,9,23,13,820,785,1605,1731
0132-000,2016,9,23,14,837,781,1618,1605
0132-000,2016,9,23,15,944,886,1830,1618
0132-000,2016,9,23,16,998,825,1823,1830
0132-000,2016,9,23,17,1013,913,1926,1823
0132-000,2016,9,23,18,1499,1007,2506,1926
0132-000,2016,9,23,19,1745,935,2680,2506
0132-000,2016,9,23,20,1226,835,2061,2680
0132-000,2016,9,23,21,904,603,1507,2061
0132-000,2016,9,23,22,723,533,1256,1507
0132-000,2016,9,23,23,408,370,778,1256
0132-000,2016,9,23,24,266,288,554,778
0132-000,2016,9,24,1,212,205,417,554
0132-000,2016,9,24,2,150,182,332,417
0132-000,2016,9,24,3,110,126,236,332
0132-000,2016,9,24,4,86,116,202,236
0132-000,2016,9,24,5,115,122,237,202
0132-000,2016,9,24,6,281,216,497,237
0132-000,2016,9,24,7,411,412,823,497
0132-000,2016,9,24,8,593,1004,1597,823
0132-000,2016,9,24,9,814,1099,1913,1597
0132-000,2016,9,24,10,847,1253,2100,1913
0132-000,2016,9,24,11,866,1189,2055,2100
0132-000,2016,9,24,12,944,1392,2336,2055
0132-000,2016,9,24,13,930,1071,2001,2336
0132-000,2016,9,24,14,884,1001,1885,2001
0132-000,2016,9,24,15,981,1045,2026,1885
0132-000,2016,9,24,16,1030,945,1975,2026
0132-000,2016,9,24,17,1170,980,2150,1975
0132-000,2016,9,24,18,1534,1106,2640,2150
0132-000,2016,9,24,19,1375,983,2358,2640
0132-000,2016,9,24,20,1017,727,1744,2358
0132-000,2016,9,24,21,696,531,1227,1744
0132-000,2016,9,24,22,550,434,984,1227
0132-000,2016,9,24,23,368,342,710,984
0132-000,2016,9,24,24,227,273,500,710
0132-000,2016,9,25,1,191,208,399,500
0132-000,2016,9,25,2,147,136,283,399
0132-000,2016,9,25,3,123,136,259,283
0132-000,2016,9,25,4,104,98,202,259
0132-000,2016,9,25,5,126,115,241,202
0132-000,2016,9,25,6,174,153,327,241
0132-000,2016,9,25,7,253,252,505,327
0132-000,2016,9,25,8,345,487,832,505
0132-000,2016,9,25,9,429,542,971,832
0132-000,2016,9,25,10,528,608,1136,971
0132-000,2016,9,25,11,610,657,1267,1136
0132-000,2016,9,25,12,649,680,1329,1267
0132-000,2016,9,25,13,752,682,1434,1329
0132-000,2016,9,25,14,712,711,1423,1434
0132-000,2016,9,25,15,802,728,1530,1423
0132-000,2016,9,25,16,928,790,1718,1530
0132-000,2016,9,25,17,1075,776,1851,1718
0132-000,2016,9,25,18,1183,850,2033,1851
0132-000,2016,9,25,19,1001,728,1729,2033
0132-000,2016,9,25,20,774,525,1299,1729
0132-000,2016,9,25,21,625,510,1135,1299
0132-000,2016,9,25,22,451,411,862,1135
0132-000,2016,9,25,23,325,284,609,862
0132-000,2016,9,25,24,199,197,396,609
0132-000,2016,9,26,1,123,140,263,396
0132-000,2016,9,26,2,79,88,167,263
0132-000,2016,9,26,3,82,66,148,167
0132-000,2016,9,26,4,73,95,168,148
0132-000,2016,9,26,5,117,117,234,168
0132-000,2016,9,26,6,334,250,584,234
0132-000,2016,9,26,7,547,679,1226,584
0132-000,2016,9,26,8,735,2015,2750,1226
0132-000,2016,9,26,9,886,1645,2531,2750
0132-000,2016,9,26,10,835,964,1799,2531
0132-000,2016,9,26,11,873,919,1792,1799
0132-000,2016,9,26,12,834,963,1797,1792
0132-000,2016,9,26,13,783,825,1608,1797
0132-000,2016,9,26,14,845,826,1671,1608
0132-000,2016,9,26,15,887,987,1874,1671
0132-000,2016,9,26,16,1011,906,1917,1874
0132-000,2016,9,26,17,1022,875,1897,1917
0132-000,2016,9,26,18,1352,991,2343,1897
0132-000,2016,9,26,19,1547,921,2468,2343
0132-000,2016,9,26,20,1079,740,1819,2468
0132-000,2016,9,26,21,903,555,1458,1819
0132-000,2016,9,26,22,643,450,1093,1458
0132-000,2016,9,26,23,380,354,734,1093
0132-000,2016,9,26,24,196,188,384,734
0132-000,2016,9,27,1,144,170,314,384
0132-000,2016,9,27,2,108,91,199,314
0132-000,2016,9,27,3,69,88,157,199
0132-000,2016,9,27,4,61,72,133,157
0132-000,2016,9,27,5,113,107,220,133
0132-000,2016,9,27,6,243,181,424,220
0132-000,2016,9,27,7,440,539,979,424
0132-000,2016,9,27,8,698,1865,2563,979
0132-000,2016,9,27,9,874,1523,2397,2563
0132-000,2016,9,27,10,830,915,1745,2397
0132-000,2016,9,27,11,824,931,1755,1745
0132-000,2016,9,27,12,829,840,1669,1755
0132-000,2016,9,27,13,779,783,1562,1669
0132-000,2016,9,27,14,868,969,1837,1562
0132-000,2016,9,27,15,896,947,1843,1837
0132-000,2016,9,27,16,897,839,1736,1843
0132-000,2016,9,27,17,987,778,1765,1736
0132-000,2016,9,27,18,1278,867,2145,1765
0132-000,2016,9,27,19,1437,853,2290,2145
0132-000,2016,9,27,20,961,712,1673,2290
0132-000,2016,9,27,21,842,541,1383,1673
0132-000,2016,9,27,22,687,449,1136,1383
0132-000,2016,9,27,23,427,339,766,1136
0132-000,2016,9,27,24,206,216,422,766
0132-000,2016,9,28,1,174,193,367,422
0132-000,2016,9,28,2,99,109,208,367
0132-000,2016,9,28,3,71,86,157,208
0132-000,2016,9,28,4,74,94,168,157
0132-000,2016,9,28,5,103,103,206,168
0132-000,2016,9,28,6,287,200,487,206
0132-000,2016,9,28,7,468,590,1058,487
0132-000,2016,9,28,8,740,1850,2590,1058
0132-000,2016,9,28,9,877,1512,2389,2590
0132-000,2016,9,28,10,868,963,1831,2389
0132-000,2016,9,28,11,828,886,1714,1831
0132-000,2016,9,28,12,811,819,1630,1714
0132-000,2016,9,28,13,789,861,1650,1630
0132-000,2016,9,28,14,850,862,1712,1650
0132-000,2016,9,28,15,865,908,1773,1712
0132-000,2016,9,28,16,938,853,1791,1773
0132-000,2016,9,28,17,1041,873,1914,1791
0132-000,2016,9,28,18,1385,965,2350,1914
0132-000,2016,9,28,19,1631,895,2526,2350
0132-000,2016,9,28,20,1032,734,1766,2526
0132-000,2016,9,28,21,870,583,1453,1766
0132-000,2016,9,28,22,613,452,1065,1453
0132-000,2016,9,28,23,424,379,803,1065
0132-000,2016,9,28,24,257,227,484,803
0132-000,2016,9,29,1,184,178,362,484
0132-000,2016,9,29,2,121,112,233,362
0132-000,2016,9,29,3,94,91,185,233
0132-000,2016,9,29,4,86,111,197,185
0132-000,2016,9,29,5,120,92,212,197
0132-000,2016,9,29,6,303,204,507,212
0132-000,2016,9,29,7,526,570,1096,507
0132-000,2016,9,29,8,723,1882,2605,1096
0132-000,2016,9,29,9,918,1532,2450,2605
0132-000,2016,9,29,10,887,1041,1928,2450
0132-000,2016,9,29,11,817,943,1760,1928
0132-000,2016,9,29,12,845,911,1756,1760
0132-000,2016,9,29,13,822,831,1653,1756
0132-000,2016,9,29,14,854,861,1715,1653
0132-000,2016,9,29,15,935,881,1816,1715
0132-000,2016,9,29,16,1002,857,1859,1816
0132-000,2016,9,29,17,1154,937,2091,1859
0132-000,2016,9,29,18,1361,955,2316,2091
0132-000,2016,9,29,19,1596,904,2500,2316
0132-000,2016,9,29,20,1014,751,1765,2500
0132-000,2016,9,29,21,860,563,1423,1765
0132-000,2016,9,29,22,699,489,1188,1423
0132-000,2016,9,29,23,420,382,802,1188
0132-000,2016,9,29,24,226,244,470,802
0132-000,2016,9,30,1,185,176,361,470
0132-000,2016,9,30,2,117,105,222,361
0132-000,2016,9,30,3,83,98,181,222
0132-000,2016,9,30,4,83,102,185,181
0132-000,2016,9,30,5,109,114,223,185
0132-000,2016,9,30,6,289,219,508,223
0132-000,2016,9,30,7,528,584,1112,508
0132-000,2016,9,30,8,683,1846,2529,1112
0132-000,2016,9,30,9,928,1538,2466,2529
0132-000,2016,9,30,10,875,946,1821,2466
0132-000,2016,9,30,11,827,880,1707,1821
0132-000,2016,9,30,12,889,903,1792,1707
0132-000,2016,9,30,13,856,865,1721,1792
0132-000,2016,9,30,14,866,903,1769,1721
0132-000,2016,9,30,15,1002,897,1899,1769
0132-000,2016,9,30,16,1136,865,2001,1899
0132-000,2016,9,30,17,1167,1019,2186,2001
0132-000,2016,9,30,18,1562,1071,2633,2186
0132-000,2016,9,30,19,1764,951,2715,2633
0132-000,2016,9,30,20,1089,891,1980,2715
0132-000,2016,9,30,21,908,643,1551,1980
0132-000,2016,9,30,22,729,568,1297,1551
0132-000,2016,9,30,23,494,416,910,1297
0132-000,2016,9,30,24,278,266,544,910
0132-000,2016,10,1,1,225,212,437,544
0132-000,2016,10,1,2,156,163,319,437
0132-000,2016,10,1,3,122,129,251,319
0132-000,2016,10,1,4,94,136,230,251
0132-000,2016,10,1,5,114,136,250,230
0132-000,2016,10,1,6,292,211,503,250
0132-000,2016,10,1,7,416,432,848,503
0132-000,2016,10,1,8,599,967,1566,848
0132-000,2016,10,1,9,787,1193,1980,1566
0132-000,2016,10,1,10,877,1171,2048,1980
0132-000,2016,10,1,11,829,1367,2196,2048
0132-000,2016,10,1,12,881,1508,2389,2196
0132-000,2016,10,1,13,896,1724,2620,2389
0132-000,2016,10,1,14,973,1646,2619,2620
0132-000,2016,10,1,15,947,1523,2470,2619
0132-000,2016,10,1,16,1023,1570,2593,2470
0132-000,2016,10,1,17,1160,1672,2832,2593
0132-000,2016,10,1,18,1392,1293,2685,2832
0132-000,2016,10,1,19,1350,1224,2574,2685
0132-000,2016,10,1,20,1075,805,1880,2574
0132-000,2016,10,1,21,820,605,1425,1880
0132-000,2016,10,1,22,634,451,1085,1425
0132-000,2016,10,1,23,394,319,713,1085
0132-000,2016,10,1,24,243,250,493,713
0132-000,2016,10,2,1,165,154,319,493
0132-000,2016,10,2,2,107,150,257,319
0132-000,2016,10,2,3,106,110,216,257
0132-000,2016,10,2,4,97,107,204,216
0132-000,2016,10,2,5,104,89,193,204
0132-000,2016,10,2,6,136,115,251,193
0132-000,2016,10,2,7,185,205,390,251
0132-000,2016,10,2,8,265,345,610,390
0132-000,2016,10,2,9,394,473,867,610
0132-000,2016,10,2,10,494,559,1053,867
0132-000,2016,10,2,11,504,664,1168,1053
0132-000,2016,10,2,12,643,637,1280,1168
0132-000,2016,10,2,13,646,730,1376,1280
0132-000,2016,10,2,14,674,738,1412,1376
0132-000,2016,10,2,15,710,715,1425,1412
0132-000,2016,10,2,16,811,726,1537,1425
0132-000,2016,10,2,17,911,702,1613,1537
0132-000,2016,10,2,18,1039,665,1704,1613
0132-000,2016,10,2,19,1068,634,1702,1704
0132-000,2016,10,2,20,881,478,1359,1702
0132-000,2016,10,2,21,606,389,995,1359
0132-000,2016,10,2,22,453,332,785,995
0132-000,2016,10,2,23,278,269,547,785
0132-000,2016,10,2,24,195,174,369,547
0132-000,2016,10,3,1,140,145,285,369
0132-000,2016,10,3,2,96,120,216,285
0132-000,2016,10,3,3,81,92,173,216
0132-000,2016,10,3,4,59,69,128,173
0132-000,2016,10,3,5,83,82,165,128
0132-000,2016,10,3,6,213,129,342,165
0132-000,2016,10,3,7,312,335,647,342
0132-000,2016,10,3,8,410,650,1060,647
0132-000,2016,10,3,9,491,638,1129,1060
0132-000,2016,10,3,10,575,625,1200,1129
0132-000,2016,10,3,11,659,651,1310,1200
0132-000,2016,10,3,12,657,853,1510,1310
0132-000,2016,10,3,13,737,805,1542,1510
0132-000,2016,10,3,14,807,807,1614,1542
0132-000,2016,10,3,15,937,812,1749,1614
0132-000,2016,10,3,16,1090,802,1892,1749
0132-000,2016,10,3,17,1178,921,2099,1892
0132-000,2016,10,3,18,1496,937,2433,2099
0132-000,2016,10,3,19,1216,824,2040,2433
0132-000,2016,10,3,20,819,588,1407,2040
0132-000,2016,10,3,21,653,513,1166,1407
0132-000,2016,10,3,22,461,418,879,1166
0132-000,2016,10,3,23,326,301,627,879
0132-000,2016,10,3,24,192,197,389,627
0132-000,2016,10,4,1,126,162,288,389
0132-000,2016,10,4,2,53,97,150,288
0132-000,2016,10,4,3,55,75,130,150
0132-000,2016,10,4,4,55,76,131,130
0132-000,2016,10,4,5,91,104,195,131
0132-000,2016,10,4,6,302,220,522,195
0132-000,2016,10,4,7,530,603,1133,522
0132-000,2016,10,4,8,691,1895,2586,1133
0132-000,2016,10,4,9,926,1696,2622,2586
0132-000,2016,10,4,10,808,967,1775,2622
0132-000,2016,10,4,11,873,858,1731,1775
0132-000,2016,10,4,12,877,932,1809,1731
0132-000,2016,10,4,13,759,873,1632,1809
0132-000,2016,10,4,14,832,859,1691,1632
0132-000,2016,10,4,15,979,949,1928,1691
0132-000,2016,10,4,16,1011,829,1840,1928
0132-000,2016,10,4,17,1014,893,1907,1840
0132-000,2016,10,4,18,1339,985,2324,1907
0132-000,2016,10,4,19,1563,888,2451,2324
0132-000,2016,10,4,20,1032,767,1799,2451
0132-000,2016,10,4,21,956,581,1537,1799
0132-000,2016,10,4,22,669,465,1134,1537
0132-000,2016,10,4,23,379,385,764,1134
0132-000,2016,10,4,24,234,225,459,764
0132-000,2016,10,5,1,168,148,316,459
0132-000,2016,10,5,2,95,90,185,316
0132-000,2016,10,5,3,72,99,171,185
0132-000,2016,10,5,4,85,79,164,171
0132-000,2016,10,5,5,112,125,237,164
0132-000,2016,10,5,6,271,191,462,237
0132-000,2016,10,5,7,441,523,964,462
0132-000,2016,10,5,8,640,1732,2372,964
0132-000,2016,10,5,9,864,1587,2451,2372
0132-000,2016,10,5,10,796,956,1752,2451
0132-000,2016,10,5,11,854,848,1702,1752
0132-000,2016,10,5,12,800,903,1703,1702
0132-000,2016,10,5,13,784,870,1654,1703
0132-000,2016,10,5,14,861,914,1775,1654
0132-000,2016,10,5,15,932,928,1860,1775
0132-000,2016,10,5,16,1018,869,1887,1860
0132-000,2016,10,5,17,967,888,1855,1887
0132-000,2016,10,5,18,1351,918,2269,1855
0132-000,2016,10,5,19,1574,859,2433,2269
0132-000,2016,10,5,20,1010,712,1722,2433
0132-000,2016,10,5,21,808,601,1409,1722
0132-000,2016,10,5,22,649,453,1102,1409
0132-000,2016,10,5,23,441,408,849,1102
0132-000,2016,10,5,24,253,280,533,849
0132-000,2016,10,6,1,158,167,325,533
0132-000,2016,10,6,2,114,98,212,325
0132-000,2016,10,6,3,63,103,166,212
0132-000,2016,10,6,4,72,91,163,166
0132-000,2016,10,6,5,103,109,212,163
0132-000,2016,10,6,6,295,213,508,212
0132-000,2016,10,6,7,425,620,1045,508
0132-000,2016,10,6,8,638,1895,2533,1045
0132-000,2016,10,6,9,900,1589,2489,2533
0132-000,2016,10,6,10,814,1050,1864,2489
0132-000,2016,10,6,11,848,966,1814,1864
0132-000,2016,10,6,12,885,910,1795,1814
0132-000,2016,10,6,13,856,824,1680,1795
0132-000,2016,10,6,14,942,879,1821,1680
0132-000,2016,10,6,15,972,960,1932,1821
0132-000,2016,10,6,16,980,882,1862,1932
0132-000,2016,10,6,17,1088,946,2034,1862
0132-000,2016,10,6,18,1400,1039,2439,2034
0132-000,2016,10,6,19,1727,876,2603,2439
0132-000,2016,10,6,20,1011,753,1764,2603
0132-000,2016,10,6,21,864,597,1461,1764
0132-000,2016,10,6,22,705,464,1169,1461
0132-000,2016,10,6,23,418,400,818,1169
0132-000,2016,10,6,24,268,259,527,818
0132-000,2016,10,7,1,169,173,342,527
0132-000,2016,10,7,2,117,133,250,342
0132-000,2016,10,7,3,92,99,191,250
0132-000,2016,10,7,4,81,91,172,191
0132-000,2016,10,7,5,121,105,226,172
0132-000,2016,10,7,6,323,198,521,226
0132-000,2016,10,7,7,489,590,1079,521
0132-000,2016,10,7,8,808,1861,2669,1079
0132-000,2016,10,7,9,923,1547,2470,2669
0132-000,2016,10,7,10,846,916,1762,2470
0132-000,2016,10,7,11,844,1075,1919,1762
0132-000,2016,10,7,12,888,1241,2129,1919
0132-000,2016,10,7,13,916,977,1893,2129
0132-000,2016,10,7,14,966,902,1868,1893
0132-000,2016,10,7,15,973,965,1938,1868
0132-000,2016,10,7,16,1067,982,2049,1938
0132-000,2016,10,7,17,1090,1003,2093,2049
0132-000,2016,10,7,18,1530,1104,2634,2093
0132-000,2016,10,7,19,1051,951,2002,2634
0132-000,2016,10,7,20,860,879,1739,2002
0132-000,2016,10,7,21,619,692,1311,1739
0132-000,2016,10,7,22,439,536,975,1311
0132-000,2016,10,7,23,226,417,643,975
0132-000,2016,10,7,24,150,280,430,643
0132-000,2016,10,8,1,159,192,351,430
0132-000,2016,10,8,2,135,155,290,351
0132-000,2016,10,8,3,105,115,220,290
0132-000,2016,10,8,4,96,123,219,220
0132-000,2016,10,8,5,117,119,236,219
0132-000,2016,10,8,6,207,155,362,236
0132-000,2016,10,8,7,274,375,649,362
0132-000,2016,10,8,8,488,1039,1527,649
0132-000,2016,10,8,9,779,1291,2070,1527
0132-000,2016,10,8,10,1030,1077,2107,2070
0132-000,2016,10,8,11,1388,1329,2717,2107
0132-000,2016,10,8,12,1007,1305,2312,2717
0132-000,2016,10,8,13,1005,1379,2384,2312
0132-000,2016,10,8,14,924,1223,2147,2384
0132-000,2016,10,8,15,1106,1103,2209,2147
0132-000,2016,10,8,16,1086,978,2064,2209
0132-000,2016,10,8,17,1397,1250,2647,2064
0132-000,2016,10,8,18,1615,1249,2864,2647
0132-000,2016,10,8,19,1571,1057,2628,2864
0132-000,2016,10,8,20,1233,762,1995,2628
0132-000,2016,10,8,21,725,570,1295,1995
0132-000,2016,10,8,22,493,465,958,1295
0132-000,2016,10,8,23,364,332,696,958
0132-000,2016,10,8,24,205,282,487,696
0132-000,2016,10,9,1,157,197,354,487
0132-000,2016,10,9,2,128,162,290,354
0132-000,2016,10,9,3,110,112,222,290
0132-000,2016,10,9,4,53,89,142,222
0132-000,2016,10,9,5,80,86,166,142
0132-000,2016,10,9,6,169,128,297,166
0132-000,2016,10,9,7,191,270,461,297
0132-000,2016,10,9,8,322,475,797,461
0132-000,2016,10,9,9,448,635,1083,797
0132-000,2016,10,9,10,531,688,1219,1083
0132-000,2016,10,9,11,563,758,1321,1219
0132-000,2016,10,9,12,615,802,1417,1321
0132-000,2016,10,9,13,725,745,1470,1417
0132-000,2016,10,9,14,662,853,1515,1470
0132-000,2016,10,9,15,802,825,1627,1515
0132-000,2016,10,9,16,877,804,1681,1627
0132-000,2016,10,9,17,1039,813,1852,1681
0132-000,2016,10,9,18,1289,909,2198,1852
0132-000,2016,10,9,19,1280,698,1978,2198
0132-000,2016,10,9,20,992,568,1560,1978
0132-000,2016,10,9,21,780,496,1276,1560
0132-000,2016,10,9,22,583,432,1015,1276
0132-000,2016,10,9,23,295,328,623,1015
0132-000,2016,10,9,24,155,201,356,623
0132-000,2016,10,10,1,94,147,241,356
0132-000,2016,10,10,2,62,88,150,241
0132-000,2016,10,10,3,47,64,111,150
0132-000,2016,10,10,4,42,72,114,111
0132-000,2016,10,10,5,81,97,178,114
0132-000,2016,10,10,6,283,206,489,178
0132-000,2016,10,10,7,522,712,1234,489
0132-000,2016,10,10,8,813,1961,2774,1234
0132-000,2016,10,10,9,872,1629,2501,2774
0132-000,2016,10,10,10,836,1043,1879,2501
0132-000,2016,10,10,11,860,1268,2128,1879
0132-000,2016,10,10,12,870,1155,2025,2128
0132-000,2016,10,10,13,743,1023,1766,2025
0132-000,2016,10,10,14,919,944,1863,1766
0132-000,2016,10,10,15,933,961,1894,1863
0132-000,2016,10,10,16,1073,947,2020,1894
0132-000,2016,10,10,17,1143,1042,2185,2020
0132-000,2016,10,10,18,1471,1108,2579,2185
0132-000,2016,10,10,19,1468,916,2384,2579
0132-000,2016,10,10,20,975,723,1698,2384
0132-000,2016,10,10,21,834,593,1427,1698
0132-000,2016,10,10,22,570,474,1044,1427
0132-000,2016,10,10,23,398,325,723,1044
0132-000,2016,10,10,24,229,214,443,723
0132-000,2016,10,11,1,132,152,284,443
0132-000,2016,10,11,2,71,96,167,284
0132-000,2016,10,11,3,63,82,145,167
0132-000,2016,10,11,4,67,80,147,145
0132-000,2016,10,11,5,99,123,222,147
0132-000,2016,10,11,6,261,206,467,222
0132-000,2016,10,11,7,453,582,1035,467
0132-000,2016,10,11,8,764,1858,2622,1035
0132-000,2016,10,11,9,996,1651,2647,2622
0132-000,2016,10,11,10,913,1020,1933,2647
0132-000,2016,10,11,11,840,1010,1850,1933
0132-000,2016,10,11,12,798,963,1761,1850
0132-000,2016,10,11,13,701,902,1603,1761
0132-000,2016,10,11,14,890,873,1763,1603
0132-000,2016,10,11,15,942,936,1878,1763
0132-000,2016,10,11,16,966,893,1859,1878
0132-000,2016,10,11,17,1095,1023,2118,1859
0132-000,2016,10,11,18,1422,1009,2431,2118
0132-000,2016,10,11,19,1634,884,2518,2431
0132-000,2016,10,11,20,975,698,1673,2518
0132-000,2016,10,11,21,836,622,1458,1673
0132-000,2016,10,11,22,588,454,1042,1458
0132-000,2016,10,11,23,389,366,755,1042
0132-000,2016,10,11,24,232,236,468,755
0132-000,2016,10,12,1,148,147,295,468
0132-000,2016,10,12,2,81,114,195,295
0132-000,2016,10,12,3,76,96,172,195
0132-000,2016,10,12,4,53,109,162,172
0132-000,2016,10,12,5,108,124,232,162
0132-000,2016,10,12,6,324,209,533,232
0132-000,2016,10,12,7,470,545,1015,533
0132-000,2016,10,12,8,750,1855,2605,1015
0132-000,2016,10,12,9,1023,1666,2689,2605
0132-000,2016,10,12,10,845,1006,1851,2689
0132-000,2016,10,12,11,885,964,1849,1851
0132-000,2016,10,12,12,768,966,1734,1849
0132-000,2016,10,12,13,732,861,1593,1734
0132-000,2016,10,12,14,886,885,1771,1593
0132-000,2016,10,12,15,971,918,1889,1771
0132-000,2016,10,12,16,1001,919,1920,1889
0132-000,2016,10,12,17,1050,1000,2050,1920
0132-000,2016,10,12,18,1478,1043,2521,2050
0132-000,2016,10,12,19,1646,902,2548,2521
0132-000,2016,10,12,20,940,747,1687,2548
0132-000,2016,10,12,21,741,607,1348,1687
0132-000,2016,10,12,22,550,454,1004,1348
0132-000,2016,10,12,23,356,366,722,1004
0132-000,2016,10,12,24,207,202,409,722
0132-000,2016,10,13,1,175,160,335,409
0132-000,2016,10,13,2,99,112,211,335
0132-000,2016,10,13,3,72,86,158,211
0132-000,2016,10,13,4,53,92,145,158
0132-000,2016,10,13,5,101,102,203,145
0132-000,2016,10,13,6,279,201,480,203
0132-000,2016,10,13,7,493,565,1058,480
0132-000,2016,10,13,8,761,1843,2604,1058
0132-000,2016,10,13,9,958,1624,2582,2604
0132-000,2016,10,13,10,854,1012,1866,2582
0132-000,2016,10,13,11,811,876,1687,1866
0132-000,2016,10,13,12,836,1003,1839,1687
0132-000,2016,10,13,13,723,846,1569,1839
0132-000,2016,10,13,14,922,826,1748,1569
0132-000,2016,10,13,15,944,882,1826,1748
0132-000,2016,10,13,16,991,890,1881,1826
0132-000,2016,10,13,17,1048,899,1947,1881
0132-000,2016,10,13,18,1334,1013,2347,1947
0132-000,2016,10,13,19,1546,841,2387,2347
0132-000,2016,10,13,20,958,752,1710,2387
0132-000,2016,10,13,21,852,599,1451,1710
0132-000,2016,10,13,22,631,449,1080,1451
0132-000,2016,10,13,23,355,349,704,1080
0132-000,2016,10,13,24,236,266,502,704
0132-000,2016,10,14,1,166,164,330,502
0132-000,2016,10,14,2,105,120,225,330
0132-000,2016,10,14,3,62,88,150,225
0132-000,2016,10,14,4,67,92,159,150
0132-000,2016,10,14,5,124,220,344,159
0132-000,2016,10,14,6,263,776,1039,344
0132-000,2016,10,14,7,477,642,1119,1039
0132-000,2016,10,14,8,723,1856,2579,1119
0132-000,2016,10,14,9,868,1476,2344,2579
0132-000,2016,10,14,10,895,972,1867,2344
0132-000,2016,10,14,11,798,886,1684,1867
0132-000,2016,10,14,12,824,925,1749,1684
0132-000,2016,10,14,13,786,861,1647,1749
0132-000,2016,10,14,14,838,928,1766,1647
0132-000,2016,10,14,15,930,913,1843,1766
0132-000,2016,10,14,16,1077,900,1977,1843
0132-000,2016,10,14,17,1140,985,2125,1977
0132-000,2016,10,14,18,1499,992,2491,2125
0132-000,2016,10,14,19,1765,970,2735,2491
0132-000,2016,10,14,20,1124,896,2020,2735
0132-000,2016,10,14,21,883,705,1588,2020
0132-000,2016,10,14,22,669,519,1188,1588
0132-000,2016,10,14,23,408,407,815,1188
0132-000,2016,10,14,24,240,251,491,815
0132-000,2016,10,15,1,198,226,424,491
0132-000,2016,10,15,2,110,138,248,424
0132-000,2016,10,15,3,76,125,201,248
0132-000,2016,10,15,4,90,105,195,201
0132-000,2016,10,15,5,107,121,228,195
0132-000,2016,10,15,6,272,194,466,228
0132-000,2016,10,15,7,369,445,814,466
0132-000,2016,10,15,8,601,956,1557,814
0132-000,2016,10,15,9,813,1132,1945,1557
0132-000,2016,10,15,10,845,1172,2017,1945
0132-000,2016,10,15,11,996,1459,2455,2017
0132-000,2016,10,15,12,1037,1680,2717,2455
0132-000,2016,10,15,13,1224,1641,2865,2717
0132-000,2016,10,15,14,931,1623,2554,2865
0132-000,2016,10,15,15,1043,1346,2389,2554
0132-000,2016,10,15,16,1070,1136,2206,2389
0132-000,2016,10,15,17,1465,1189,2654,2206
0132-000,2016,10,15,18,1654,1304,2958,2654
0132-000,2016,10,15,19,1648,970,2618,2958
0132-000,2016,10,15,20,1361,685,2046,2618
0132-000,2016,10,15,21,1104,558,1662,2046
0132-000,2016,10,15,22,658,457,1115,1662
0132-000,2016,10,15,23,351,365,716,1115
0132-000,2016,10,15,24,200,274,474,716
0132-000,2016,10,16,1,168,191,359,474
0132-000,2016,10,16,2,105,128,233,359
0132-000,2016,10,16,3,103,118,221,233
0132-000,2016,10,16,4,83,96,179,221
0132-000,2016,10,16,5,92,97,189,179
0132-000,2016,10,16,6,159,149,308,189
0132-000,2016,10,16,7,196,216,412,308
0132-000,2016,10,16,8,225,419,644,412
0132-000,2016,10,16,9,383,553,936,644
0132-000,2016,10,16,10,486,635,1121,936
0132-000,2016,10,16,11,586,744,1330,1121
0132-000,2016,10,16,12,608,755,1363,1330
0132-000,2016,10,16,13,691,741,1432,1363
0132-000,2016,10,16,14,827,773,1600,1432
0132-000,2016,10,16,15,978,787,1765,1600
0132-000,2016,10,16,16,1185,835,2020,1765
0132-000,2016,10,16,17,1621,784,2405,2020
0132-000,2016,10,16,18,1725,821,2546,2405
0132-000,2016,10,16,19,1724,725,2449,2546
0132-000,2016,10,16,20,1440,557,1997,2449
0132-000,2016,10,16,21,984,460,1444,1997
0132-000,2016,10,16,22,612,396,1008,1444
0132-000,2016,10,16,23,299,304,603,1008
0132-000,2016,10,16,24,184,183,367,603
0132-000,2016,10,17,1,96,149,245,367
0132-000,2016,10,17,2,85,91,176,245
0132-000,2016,10,17,3,71,79,150,176
0132-000,2016,10,17,4,38,81,119,150
0132-000,2016,10,17,5,107,84,191,119
0132-000,2016,10,17,6,281,238,519,191
0132-000,2016,10,17,7,511,686,1197,519
0132-000,2016,10,17,8,728,1948,2676,1197
0132-000,2016,10,17,9,931,1548,2479,2676
0132-000,2016,10,17,10,706,997,1703,2479
0132-000,2016,10,17,11,760,912,1672,1703
0132-000,2016,10,17,12,764,868,1632,1672
0132-000,2016,10,17,13,740,848,1588,1632
0132-000,2016,10,17,14,863,892,1755,1588
0132-000,2016,10,17,15,935,914,1849,1755
0132-000,2016,10,17,16,1082,951,2033,1849
0132-000,2016,10,17,17,1160,911,2071,2033
0132-000,2016,10,17,18,1484,969,2453,2071
0132-000,2016,10,17,19,1342,887,2229,2453
0132-000,2016,10,17,20,897,736,1633,2229
0132-000,2016,10,17,21,744,531,1275,1633
0132-000,2016,10,17,22,516,461,977,1275
0132-000,2016,10,17,23,362,360,722,977
0132-000,2016,10,17,24,210,198,408,722
0132-000,2016,10,18,1,245,145,390,408
0132-000,2016,10,18,2,175,101,276,390
0132-000,2016,10,18,3,117,72,189,276
0132-000,2016,10,18,4,128,95,223,189
0132-000,2016,10,18,5,95,106,201,223
0132-000,2016,10,18,6,282,197,479,201
0132-000,2016,10,18,7,492,570,1062,479
0132-000,2016,10,18,8,728,1815,2543,1062
0132-000,2016,10,18,9,961,1635,2596,2543
0132-000,2016,10,18,10,860,997,1857,2596
0132-000,2016,10,18,11,856,975,1831,1857
0132-000,2016,10,18,12,838,883,1721,1831
0132-000,2016,10,18,13,730,822,1552,1721
0132-000,2016,10,18,14,861,923,1784,1552
0132-000,2016,10,18,15,888,949,1837,1784
0132-000,2016,10,18,16,976,857,1833,1837
0132-000,2016,10,18,17,1149,961,2110,1833
0132-000,2016,10,18,18,1424,1052,2476,2110
0132-000,2016,10,18,19,1541,921,2462,2476
0132-000,2016,10,18,20,994,716,1710,2462
0132-000,2016,10,18,21,879,580,1459,1710
0132-000,2016,10,18,22,608,470,1078,1459
0132-000,2016,10,18,23,371,363,734,1078
0132-000,2016,10,18,24,222,228,450,734
0132-000,2016,10,19,1,142,174,316,450
0132-000,2016,10,19,2,76,109,185,316
0132-000,2016,10,19,3,69,97,166,185
0132-000,2016,10,19,4,71,106,177,166
0132-000,2016,10,19,5,116,107,223,177
0132-000,2016,10,19,6,248,205,453,223
0132-000,2016,10,19,7,455,558,1013,453
0132-000,2016,10,19,8,703,1849,2552,1013
0132-000,2016,10,19,9,1016,1620,2636,2552
0132-000,2016,10,19,10,838,980,1818,2636
0132-000,2016,10,19,11,885,979,1864,1818
0132-000,2016,10,19,12,744,974,1718,1864
0132-000,2016,10,19,13,746,864,1610,1718
0132-000,2016,10,19,14,868,920,1788,1610
0132-000,2016,10,19,15,921,924,1845,1788
0132-000,2016,10,19,16,966,857,1823,1845
0132-000,2016,10,19,17,1068,1005,2073,1823
0132-000,2016,10,19,18,1541,942,2483,2073
0132-000,2016,10,19,19,1686,904,2590,2483
0132-000,2016,10,19,20,955,791,1746,2590
0132-000,2016,10,19,21,771,609,1380,1746
0132-000,2016,10,19,22,581,460,1041,1380
0132-000,2016,10,19,23,378,369,747,1041
0132-000,2016,10,19,24,227,243,470,747
0132-000,2016,10,20,1,169,168,337,470
0132-000,2016,10,20,2,110,119,229,337
0132-000,2016,10,20,3,63,100,163,229
0132-000,2016,10,20,4,65,100,165,163
0132-000,2016,10,20,5,90,115,205,165
0132-000,2016,10,20,6,277,213,490,205
0132-000,2016,10,20,7,486,527,1013,490
0132-000,2016,10,20,8,734,1737,2471,1013
0132-000,2016,10,20,9,895,1645,2540,2471
0132-000,2016,10,20,10,836,984,1820,2540
0132-000,2016,10,20,11,822,933,1755,1820
0132-000,2016,10,20,12,806,989,1795,1755
0132-000,2016,10,20,13,764,958,1722,1795
0132-000,2016,10,20,14,816,922,1738,1722
0132-000,2016,10,20,15,883,897,1780,1738
0132-000,2016,10,20,16,948,835,1783,1780
0132-000,2016,10,20,17,1073,904,1977,1783
0132-000,2016,10,20,18,1542,996,2538,1977
0132-000,2016,10,20,19,1601,880,2481,2538
0132-000,2016,10,20,20,1113,684,1797,2481
0132-000,2016,10,20,21,876,601,1477,1797
0132-000,2016,10,20,22,613,480,1093,1477
0132-000,2016,10,20,23,410,412,822,1093
0132-000,2016,10,20,24,252,238,490,822
0132-000,2016,10,21,1,97,176,273,490
0132-000,2016,10,21,2,67,140,207,273
0132-000,2016,10,21,3,44,106,150,207
0132-000,2016,10,21,4,55,105,160,150
0132-000,2016,10,21,5,70,120,190,160
0132-000,2016,10,21,6,165,199,364,190
0132-000,2016,10,21,7,483,569,1052,364
0132-000,2016,10,21,8,766,1794,2560,1052
0132-000,2016,10,21,9,896,1654,2550,2560
0132-000,2016,10,21,10,870,1013,1883,2550
0132-000,2016,10,21,11,821,1067,1888,1883
0132-000,2016,10,21,12,856,917,1773,1888
0132-000,2016,10,21,13,851,891,1742,1773
0132-000,2016,10,21,14,902,961,1863,1742
0132-000,2016,10,21,15,952,873,1825,1863
0132-000,2016,10,21,16,1072,903,1975,1825
0132-000,2016,10,21,17,1115,957,2072,1975
0132-000,2016,10,21,18,1514,1057,2571,2072
0132-000,2016,10,21,19,1408,1158,2566,2571
0132-000,2016,10,21,20,992,882,1874,2566
0132-000,2016,10,21,21,751,703,1454,1874
0132-000,2016,10,21,22,554,508,1062,1454
0132-000,2016,10,21,23,317,416,733,1062
0132-000,2016,10,21,24,195,284,479,733
0132-000,2016,10,22,1,100,217,317,479
0132-000,2016,10,22,2,73,145,218,317
0132-000,2016,10,22,3,54,93,147,218
0132-000,2016,10,22,4,45,119,164,147
0132-000,2016,10,22,5,58,143,201,164
0132-000,2016,10,22,6,240,172,412,201
0132-000,2016,10,22,7,322,459,781,412
0132-000,2016,10,22,8,544,903,1447,781
0132-000,2016,10,22,9,796,1078,1874,1447
0132-000,2016,10,22,10,938,1128,2066,1874
0132-000,2016,10,22,11,1192,1245,2437,2066
0132-000,2016,10,22,12,1022,1429,2451,2437
0132-000,2016,10,22,13,1114,1373,2487,2451
0132-000,2016,10,22,14,928,1245,2173,2487
0132-000,2016,10,22,15,1074,1169,2243,2173
0132-000,2016,10,22,16,1078,1049,2127,2243
0132-000,2016,10,22,17,1431,1131,2562,2127
0132-000,2016,10,22,18,1634,1125,2759,2562
0132-000,2016,10,22,19,1276,994,2270,2759
0132-000,2016,10,22,20,918,715,1633,2270
0132-000,2016,10,22,21,493,538,1031,1633
0132-000,2016,10,22,22,384,482,866,1031
0132-000,2016,10,22,23,266,358,624,866
0132-000,2016,10,22,24,177,253,430,624
0132-000,2016,10,23,1,142,198,340,430
0132-000,2016,10,23,2,130,132,262,340
0132-000,2016,10,23,3,121,129,250,262
0132-000,2016,10,23,4,79,74,153,250
0132-000,2016,10,23,5,97,99,196,153
0132-000,2016,10,23,6,168,131,299,196
0132-000,2016,10,23,7,226,237,463,299
0132-000,2016,10,23,8,300,431,731,463
0132-000,2016,10,23,9,422,572,994,731
0132-000,2016,10,23,10,476,647,1123,994
0132-000,2016,10,23,11,633,744,1377,1123
0132-000,2016,10,23,12,626,685,1311,1377
0132-000,2016,10,23,13,726,683,1409,1311
0132-000,2016,10,23,14,731,771,1502,1409
0132-000,2016,10,23,15,714,800,1514,1502
0132-000,2016,10,23,16,592,788,1380,1514
0132-000,2016,10,23,17,744,768,1512,1380
0132-000,2016,10,23,18,854,775,1629,1512
0132-000,2016,10,23,19,771,651,1422,1629
0132-000,2016,10,23,20,769,515,1284,1422
0132-000,2016,10,23,21,863,480,1343,1284
0132-000,2016,10,23,22,603,419,1022,1343
0132-000,2016,10,23,23,340,318,658,1022
0132-000,2016,10,23,24,96,177,273,658
0132-000,2016,10,24,1,48,124,172,273
0132-000,2016,10,24,2,40,94,134,172
0132-000,2016,10,24,3,28,71,99,134
0132-000,2016,10,24,4,22,71,93,99
0132-000,2016,10,24,5,53,92,145,93
0132-000,2016,10,24,6,157,214,371,145
0132-000,2016,10,24,7,292,691,983,371
0132-000,2016,10,24,8,770,1897,2667,983
0132-000,2016,10,24,9,902,1613,2515,2667
0132-000,2016,10,24,10,771,940,1711,2515
0132-000,2016,10,24,11,810,936,1746,1711
0132-000,2016,10,24,12,817,1114,1931,1746
0132-000,2016,10,24,13,742,966,1708,1931
0132-000,2016,10,24,14,891,935,1826,1708
0132-000,2016,10,24,15,934,900,1834,1826
0132-000,2016,10,24,16,1078,889,1967,1834
0132-000,2016,10,24,17,1152,921,2073,1967
0132-000,2016,10,24,18,1478,949,2427,2073
0132-000,2016,10,24,19,1405,901,2306,2427
0132-000,2016,10,24,20,959,734,1693,2306
0132-000,2016,10,24,21,876,532,1408,1693
0132-000,2016,10,24,22,629,451,1080,1408
0132-000,2016,10,24,23,385,357,742,1080
0132-000,2016,10,24,24,240,214,454,742
0132-000,2016,10,25,1,132,137,269,454
0132-000,2016,10,25,2,44,115,159,269
0132-000,2016,10,25,3,38,92,130,159
0132-000,2016,10,25,4,41,93,134,130
0132-000,2016,10,25,5,42,97,139,134
0132-000,2016,10,25,6,272,176,448,139
0132-000,2016,10,25,7,472,457,929,448
0132-000,2016,10,25,8,746,1744,2490,929
0132-000,2016,10,25,9,978,1545,2523,2490
0132-000,2016,10,25,10,886,952,1838,2523
0132-000,2016,10,25,11,848,882,1730,1838
0132-000,2016,10,25,12,818,960,1778,1730
0132-000,2016,10,25,13,716,834,1550,1778
0132-000,2016,10,25,14,914,860,1774,1550
0132-000,2016,10,25,15,905,865,1770,1774
0132-000,2016,10,25,16,957,818,1775,1770
0132-000,2016,10,25,17,1006,866,1872,1775
0132-000,2016,10,25,18,1300,907,2207,1872
0132-000,2016,10,25,19,1534,862,2396,2207
0132-000,2016,10,25,20,952,673,1625,2396
0132-000,2016,10,25,21,866,575,1441,1625
0132-000,2016,10,25,22,655,472,1127,1441
0132-000,2016,10,25,23,420,351,771,1127
0132-000,2016,10,25,24,277,226,503,771
0132-000,2016,10,26,1,178,185,363,503
0132-000,2016,10,26,2,106,110,216,363
0132-000,2016,10,26,3,87,97,184,216
0132-000,2016,10,26,4,70,91,161,184
0132-000,2016,10,26,5,114,117,231,161
0132-000,2016,10,26,6,266,217,483,231
0132-000,2016,10,26,7,447,533,980,483
0132-000,2016,10,26,8,681,1787,2468,980
0132-000,2016,10,26,9,904,1617,2521,2468
0132-000,2016,10,26,10,837,1009,1846,2521
0132-000,2016,10,26,11,854,900,1754,1846
0132-000,2016,10,26,12,835,896,1731,1754
0132-000,2016,10,26,13,852,866,1718,1731
0132-000,2016,10,26,14,907,815,1722,1718
0132-000,2016,10,26,15,942,930,1872,1722
0132-000,2016,10,26,16,1011,896,1907,1872
0132-000,2016,10,26,17,997,881,1878,1907
0132-000,2016,10,26,18,1425,918,2343,1878
0132-000,2016,10,26,19,1747,817,2564,2343
0132-000,2016,10,26,20,927,734,1661,2564
0132-000,2016,10,26,21,848,586,1434,1661
0132-000,2016,10,26,22,612,463,1075,1434
0132-000,2016,10,26,23,374,352,726,1075
0132-000,2016,10,26,24,228,240,468,726
0132-000,2016,10,27,1,165,165,330,468
0132-000,2016,10,27,2,107,94,201,330
0132-000,2016,10,27,3,85,91,176,201
0132-000,2016,10,27,4,70,92,162,176
0132-000,2016,10,27,5,103,110,213,162
0132-000,2016,10,27,6,315,212,527,213
0132-000,2016,10,27,7,468,559,1027,527
0132-000,2016,10,27,8,721,1846,2567,1027
0132-000,2016,10,27,9,929,1571,2500,2567
0132-000,2016,10,27,10,843,1038,1881,2500
0132-000,2016,10,27,11,843,936,1779,1881
0132-000,2016,10,27,12,890,900,1790,1779
0132-000,2016,10,27,13,821,845,1666,1790
0132-000,2016,10,27,14,889,841,1730,1666
0132-000,2016,10,27,15,954,922,1876,1730
0132-000,2016,10,27,16,1007,912,1919,1876
0132-000,2016,10,27,17,1073,960,2033,1919
0132-000,2016,10,27,18,1452,1002,2454,2033
0132-000,2016,10,27,19,1580,859,2439,2454
0132-000,2016,10,27,20,977,752,1729,2439
0132-000,2016,10,27,21,854,554,1408,1729
0132-000,2016,10,27,22,696,489,1185,1408
0132-000,2016,10,27,23,402,390,792,1185
0132-000,2016,10,27,24,326,226,552,792
0132-000,2016,10,28,1,218,161,379,552
0132-000,2016,10,28,2,140,107,247,379
0132-000,2016,10,28,3,83,106,189,247
0132-000,2016,10,28,4,91,116,207,189
0132-000,2016,10,28,5,123,109,232,207
0132-000,2016,10,28,6,255,175,430,232
0132-000,2016,10,28,7,425,526,951,430
0132-000,2016,10,28,8,650,1750,2400,951
0132-000,2016,10,28,9,910,1486,2396,2400
0132-000,2016,10,28,10,840,952,1792,2396
0132-000,2016,10,28,11,859,908,1767,1792
0132-000,2016,10,28,12,889,892,1781,1767
0132-000,2016,10,28,13,902,834,1736,1781
0132-000,2016,10,28,14,907,875,1782,1736
0132-000,2016,10,28,15,977,923,1900,1782
0132-000,2016,10,28,16,1007,913,1920,1900
0132-000,2016,10,28,17,1110,905,2015,1920
0132-000,2016,10,28,18,1516,1220,2736,2015
0132-000,2016,10,28,19,1745,1209,2954,2736
0132-000,2016,10,28,20,1076,940,2016,2954
0132-000,2016,10,28,21,874,920,1794,2016
0132-000,2016,10,28,22,722,605,1327,1794
0132-000,2016,10,28,23,452,409,861,1327
0132-000,2016,10,28,24,285,280,565,861
0132-000,2016,10,29,1,215,195,410,565
0132-000,2016,10,29,2,137,144,281,410
0132-000,2016,10,29,3,105,121,226,281
0132-000,2016,10,29,4,94,108,202,226
0132-000,2016,10,29,5,110,140,250,202
0132-000,2016,10,29,6,270,178,448,250
0132-000,2016,10,29,7,406,437,843,448
0132-000,2016,10,29,8,601,1042,1643,843
0132-000,2016,10,29,9,802,1478,2280,1643
0132-000,2016,10,29,10,858,1263,2121,2280
0132-000,2016,10,29,11,908,1339,2247,2121
0132-000,2016,10,29,12,947,1615,2562,2247
0132-000,2016,10,29,13,929,1597,2526,2562
0132-000,2016,10,29,14,990,1423,2413,2526
0132-000,2016,10,29,15,1081,1248,2329,2413
0132-000,2016,10,29,16,1129,1085,2214,2329
0132-000,2016,10,29,17,1262,1082,2344,2214
0132-000,2016,10,29,18,1674,1088,2762,2344
0132-000,2016,10,29,19,1654,910,2564,2762
0132-000,2016,10,29,20,1259,692,1951,2564
0132-000,2016,10,29,21,910,609,1519,1951
0132-000,2016,10,29,22,647,597,1244,1519
0132-000,2016,10,29,23,408,381,789,1244
0132-000,2016,10,29,24,225,272,497,789
0132-000,2016,10,30,1,183,187,370,497
0132-000,2016,10,30,2,148,148,296,370
0132-000,2016,10,30,3,101,101,202,296
0132-000,2016,10,30,4,85,94,179,202
0132-000,2016,10,30,5,92,92,184,179
0132-000,2016,10,30,6,184,129,313,184
0132-000,2016,10,30,7,253,214,467,313
0132-000,2016,10,30,8,323,410,733,467
0132-000,2016,10,30,9,441,534,975,733
0132-000,2016,10,30,10,537,699,1236,975
0132-000,2016,10,30,11,616,733,1349,1236
0132-000,2016,10,30,12,631,744,1375,1349
0132-000,2016,10,30,13,764,710,1474,1375
0132-000,2016,10,30,14,778,779,1557,1474
0132-000,2016,10,30,15,750,707,1457,1557
0132-000,2016,10,30,16,888,812,1700,1457
0132-000,2016,10,30,17,1661,922,2583,1700
0132-000,2016,10,30,18,1791,881,2672,2583
0132-000,2016,10,30,19,1739,715,2454,2672
0132-000,2016,10,30,20,1932,543,2475,2454
0132-000,2016,10,30,21,1439,575,2014,2475
0132-000,2016,10,30,22,988,419,1407,2014
0132-000,2016,10,30,23,395,327,722,1407
0132-000,2016,10,30,24,220,201,421,722
0132-000,2016,10,31,1,108,142,250,421
0132-000,2016,10,31,2,75,85,160,250
0132-000,2016,10,31,3,52,66,118,160
0132-000,2016,10,31,4,43,66,109,118
0132-000,2016,10,31,5,120,102,222,109
0132-000,2016,10,31,6,305,230,535,222
0132-000,2016,10,31,7,517,679,1196,535
0132-000,2016,10,31,8,765,1911,2676,1196
0132-000,2016,10,31,9,871,1622,2493,2676
0132-000,2016,10,31,10,847,1020,1867,2493
0132-000,2016,10,31,11,821,910,1731,1867
0132-000,2016,10,31,12,883,914,1797,1731
0132-000,2016,10,31,13,847,854,1701,1797
0132-000,2016,10,31,14,877,919,1796,1701
0132-000,2016,10,31,15,951,951,1902,1796
0132-000,2016,10,31,16,1033,1012,2045,1902
0132-000,2016,10,31,17,1075,934,2009,2045
0132-000,2016,10,31,18,1372,943,2315,2009
0132-000,2016,10,31,19,1494,858,2352,2315
0132-000,2016,10,31,20,1030,690,1720,2352
0132-000,2016,10,31,21,814,558,1372,1720
0132-000,2016,10,31,22,631,483,1114,1372
0132-000,2016,10,31,23,389,378,767,1114
0132-000,2016,10,31,24,255,225,480,767
0132-000,2016,11,1,1,141,147,288,480
0132-000,2016,11,1,2,90,81,171,288
0132-000,2016,11,1,3,68,94,162,171
0132-000,2016,11,1,4,69,80,149,162
0132-000,2016,11,1,5,102,115,217,149
0132-000,2016,11,1,6,296,206,502,217
0132-000,2016,11,1,7,479,587,1066,502
0132-000,2016,11,1,8,732,1811,2543,1066
0132-000,2016,11,1,9,864,1670,2534,2543
0132-000,2016,11,1,10,836,898,1734,2534
0132-000,2016,11,1,11,821,923,1744,1734
0132-000,2016,11,1,12,866,972,1838,1744
0132-000,2016,11,1,13,802,883,1685,1838
0132-000,2016,11,1,14,903,845,1748,1685
0132-000,2016,11,1,15,947,877,1824,1748
0132-000,2016,11,1,16,1006,903,1909,1824
0132-000,2016,11,1,17,1062,917,1979,1909
0132-000,2016,11,1,18,1441,1000,2441,1979
0132-000,2016,11,1,19,1575,905,2480,2441
0132-000,2016,11,1,20,997,687,1684,2480
0132-000,2016,11,1,21,849,637,1486,1684
0132-000,2016,11,1,22,621,502,1123,1486
0132-000,2016,11,1,23,417,358,775,1123
0132-000,2016,11,1,24,241,222,463,775
0132-000,2016,11,2,1,146,142,288,463
0132-000,2016,11,2,2,92,98,190,288
0132-000,2016,11,2,3,61,92,153,190
0132-000,2016,11,2,4,52,72,124,153
0132-000,2016,11,2,5,101,94,195,124
0132-000,2016,11,2,6,275,169,444,195
0132-000,2016,11,2,7,490,536,1026,444
0132-000,2016,11,2,8,715,1764,2479,1026
0132-000,2016,11,2,9,919,1657,2576,2479
0132-000,2016,11,2,10,858,998,1856,2576
0132-000,2016,11,2,11,840,975,1815,1856
0132-000,2016,11,2,12,793,944,1737,1815
0132-000,2016,11,2,13,794,772,1566,1737
0132-000,2016,11,2,14,888,884,1772,1566
0132-000,2016,11,2,15,993,923,1916,1772
0132-000,2016,11,2,16,1020,869,1889,1916
0132-000,2016,11,2,17,1051,856,1907,1889
0132-000,2016,11,2,18,1468,946,2414,1907
0132-000,2016,11,2,19,1660,859,2519,2414
0132-000,2016,11,2,20,968,838,1806,2519
0132-000,2016,11,2,21,796,574,1370,1806
0132-000,2016,11,2,22,648,471,1119,1370
0132-000,2016,11,2,23,359,379,738,1119
0132-000,2016,11,2,24,232,209,441,738
0132-000,2016,11,3,1,153,158,311,441
0132-000,2016,11,3,2,109,97,206,311
0132-000,2016,11,3,3,61,108,169,206
0132-000,2016,11,3,4,68,86,154,169
0132-000,2016,11,3,5,105,109,214,154
0132-000,2016,11,3,6,269,209,478,214
0132-000,2016,11,3,7,472,536,1008,478
0132-000,2016,11,3,8,693,1744,2437,1008
0132-000,2016,11,3,9,939,1588,2527,2437
0132-000,2016,11,3,10,831,957,1788,2527
0132-000,2016,11,3,11,824,941,1765,1788
0132-000,2016,11,3,12,841,891,1732,1765
0132-000,2016,11,3,13,848,824,1672,1732
0132-000,2016,11,3,14,864,878,1742,1672
0132-000,2016,11,3,15,930,938,1868,1742
0132-000,2016,11,3,16,996,832,1828,1868
0132-000,2016,11,3,17,1008,920,1928,1828
0132-000,2016,11,3,18,1415,874,2289,1928
0132-000,2016,11,3,19,1602,848,2450,2289
0132-000,2016,11,3,20,1035,756,1791,2450
0132-000,2016,11,3,21,886,680,1566,1791
0132-000,2016,11,3,22,631,507,1138,1566
0132-000,2016,11,3,23,392,338,730,1138
0132-000,2016,11,3,24,229,200,429,730
0132-000,2016,11,4,1,154,148,302,429
0132-000,2016,11,4,2,114,109,223,302
0132-000,2016,11,4,3,89,89,178,223
0132-000,2016,11,4,4,66,99,165,178
0132-000,2016,11,4,5,134,118,252,165
0132-000,2016,11,4,6,295,202,497,252
0132-000,2016,11,4,7,444,512,956,497
0132-000,2016,11,4,8,714,1784,2498,956
0132-000,2016,11,4,9,890,1584,2474,2498
0132-000,2016,11,4,10,799,927,1726,2474
0132-000,2016,11,4,11,802,940,1742,1726
0132-000,2016,11,4,12,858,892,1750,1742
0132-000,2016,11,4,13,841,868,1709,1750
0132-000,2016,11,4,14,903,820,1723,1709
0132-000,2016,11,4,15,970,903,1873,1723
0132-000,2016,11,4,16,1036,888,1924,1873
0132-000,2016,11,4,17,1116,935,2051,1924
0132-000,2016,11,4,18,1562,1050,2612,2051
0132-000,2016,11,4,19,1875,963,2838,2612
0132-000,2016,11,4,20,1286,798,2084,2838
0132-000,2016,11,4,21,1075,657,1732,2084
0132-000,2016,11,4,22,669,556,1225,1732
0132-000,2016,11,4,23,415,401,816,1225
0132-000,2016,11,4,24,277,287,564,816
0132-000,2016,11,5,1,194,198,392,564
0132-000,2016,11,5,2,146,161,307,392
0132-000,2016,11,5,3,115,110,225,307
0132-000,2016,11,5,4,92,109,201,225
0132-000,2016,11,5,5,116,115,231,201
0132-000,2016,11,5,6,285,201,486,231
0132-000,2016,11,5,7,424,449,873,486
0132-000,2016,11,5,8,571,915,1486,873
0132-000,2016,11,5,9,728,1114,1842,1486
0132-000,2016,11,5,10,818,1265,2083,1842
0132-000,2016,11,5,11,833,1454,2287,2083
0132-000,2016,11,5,12,964,1655,2619,2287
0132-000,2016,11,5,13,938,1669,2607,2619
0132-000,2016,11,5,14,936,1557,2493,2607
0132-000,2016,11,5,15,936,1323,2259,2493
0132-000,2016,11,5,16,1059,1045,2104,2259
0132-000,2016,11,5,17,1154,1104,2258,2104
0132-000,2016,11,5,18,1601,1145,2746,2258
0132-000,2016,11,5,19,1535,957,2492,2746
0132-000,2016,11,5,20,1261,728,1989,2492
0132-000,2016,11,5,21,988,541,1529,1989
0132-000,2016,11,5,22,582,459,1041,1529
0132-000,2016,11,5,23,378,343,721,1041
0132-000,2016,11,5,24,251,229,480,721
0132-000,2016,11,6,1,150,188,338,480
0132-000,2016,11,6,2,124,146,270,338
0132-000,2016,11,6,3,92,108,200,270
0132-000,2016,11,6,4,94,90,184,200
0132-000,2016,11,6,5,89,93,182,184
0132-000,2016,11,6,6,178,145,323,182
0132-000,2016,11,6,7,222,247,469,323
0132-000,2016,11,6,8,333,426,759,469
0132-000,2016,11,6,9,428,556,984,759
0132-000,2016,11,6,10,524,714,1238,984
0132-000,2016,11,6,11,584,769,1353,1238
0132-000,2016,11,6,12,680,785,1465,1353
0132-000,2016,11,6,13,739,731,1470,1465
0132-000,2016,11,6,14,908,827,1735,1470
0132-000,2016,11,6,15,992,797,1789,1735
0132-000,2016,11,6,16,1191,822,2013,1789
0132-000,2016,11,6,17,1604,805,2409,2013
0132-000,2016,11,6,18,1835,841,2676,2409
0132-000,2016,11,6,19,1846,701,2547,2676
0132-000,2016,11,6,20,1804,556,2360,2547
0132-000,2016,11,6,21,1517,461,1978,2360
0132-000,2016,11,6,22,1269,432,1701,1978
0132-000,2016,11,6,23,712,304,1016,1701
0132-000,2016,11,6,24,272,212,484,1016
0132-000,2016,11,7,1,129,139,268,484
0132-000,2016,11,7,2,67,108,175,268
0132-000,2016,11,7,3,64,68,132,175
0132-000,2016,11,7,4,54,67,121,132
0132-000,2016,11,7,5,121,102,223,121
0132-000,2016,11,7,6,312,227,539,223
0132-000,2016,11,7,7,502,616,1118,539
0132-000,2016,11,7,8,683,1915,2598,1118
0132-000,2016,11,7,9,835,1579,2414,2598
0132-000,2016,11,7,10,766,974,1740,2414
0132-000,2016,11,7,11,828,894,1722,1740
0132-000,2016,11,7,12,754,906,1660,1722
0132-000,2016,11,7,13,798,936,1734,1660
0132-000,2016,11,7,14,901,914,1815,1734
0132-000,2016,11,7,15,883,901,1784,1815
0132-000,2016,11,7,16,973,820,1793,1784
0132-000,2016,11,7,17,1079,880,1959,1793
0132-000,2016,11,7,18,1329,960,2289,1959
0132-000,2016,11,7,19,1512,858,2370,2289
0132-000,2016,11,7,20,1065,665,1730,2370
0132-000,2016,11,7,21,786,558,1344,1730
0132-000,2016,11,7,22,641,431,1072,1344
0132-000,2016,11,7,23,339,317,656,1072
0132-000,2016,11,7,24,220,233,453,656
0132-000,2016,11,8,1,133,148,281,453
0132-000,2016,11,8,2,78,95,173,281
0132-000,2016,11,8,3,75,84,159,173
0132-000,2016,11,8,4,81,78,159,159
0132-000,2016,11,8,5,101,120,221,159
0132-000,2016,11,8,6,289,202,491,221
0132-000,2016,11,8,7,440,553,993,491
0132-000,2016,11,8,8,688,1817,2505,993
0132-000,2016,11,8,9,872,1598,2470,2505
0132-000,2016,11,8,10,797,979,1776,2470
0132-000,2016,11,8,11,876,944,1820,1776
0132-000,2016,11,8,12,844,927,1771,1820
0132-000,2016,11,8,13,772,808,1580,1771
0132-000,2016,11,8,14,855,808,1663,1580
0132-000,2016,11,8,15,926,871,1797,1663
0132-000,2016,11,8,16,997,860,1857,1797
0132-000,2016,11,8,17,1118,907,2025,1857
0132-000,2016,11,8,18,1380,884,2264,2025
0132-000,2016,11,8,19,1570,871,2441,2264
0132-000,2016,11,8,20,1037,711,1748,2441
0132-000,2016,11,8,21,905,592,1497,1748
0132-000,2016,11,8,22,631,491,1122,1497
0132-000,2016,11,8,23,381,333,714,1122
0132-000,2016,11,8,24,236,252,488,714
0132-000,2016,11,9,1,162,164,326,488
0132-000,2016,11,9,2,99,104,203,326
0132-000,2016,11,9,3,74,94,168,203
0132-000,2016,11,9,4,61,82,143,168
0132-000,2016,11,9,5,108,106,214,143
0132-000,2016,11,9,6,270,193,463,214
0132-000,2016,11,9,7,468,534,1002,463
0132-000,2016,11,9,8,698,1776,2474,1002
0132-000,2016,11,9,9,912,1637,2549,2474
0132-000,2016,11,9,10,848,1004,1852,2549
0132-000,2016,11,9,11,847,938,1785,1852
0132-000,2016,11,9,12,814,920,1734,1785
0132-000,2016,11,9,13,823,819,1642,1734
0132-000,2016,11,9,14,898,850,1748,1642
0132-000,2016,11,9,15,968,926,1894,1748
0132-000,2016,11,9,16,989,841,1830,1894
0132-000,2016,11,9,17,1055,894,1949,1830
0132-000,2016,11,9,18,1507,987,2494,1949
0132-000,2016,11,9,19,1524,996,2520,2494
0132-000,2016,11,9,20,1054,684,1738,2520
0132-000,2016,11,9,21,851,543,1394,1738
0132-000,2016,11,9,22,605,428,1033,1394
0132-000,2016,11,9,23,383,365,748,1033
0132-000,2016,11,9,24,228,197,425,748
0132-000,2016,11,10,1,174,144,318,425
0132-000,2016,11,10,2,121,93,214,318
0132-000,2016,11,10,3,74,92,166,214
0132-000,2016,11,10,4,85,85,170,166
0132-000,2016,11,10,5,102,123,225,170
0132-000,2016,11,10,6,298,206,504,225
0132-000,2016,11,10,7,465,554,1019,504
0132-000,2016,11,10,8,714,1791,2505,1019
0132-000,2016,11,10,9,869,1586,2455,2505
0132-000,2016,11,10,10,884,946,1830,2455
0132-000,2016,11,10,11,835,885,1720,1830
0132-000,2016,11,10,12,780,940,1720,1720
0132-000,2016,11,10,13,840,832,1672,1720
0132-000,2016,11,10,14,860,806,1666,1672
0132-000,2016,11,10,15,878,868,1746,1666
0132-000,2016,11,10,16,1006,837,1843,1746
0132-000,2016,11,10,17,1064,919,1983,1843
0132-000,2016,11,10,18,1337,876,2213,1983
0132-000,2016,11,10,19,1594,846,2440,2213
0132-000,2016,11,10,20,995,738,1733,2440
0132-000,2016,11,10,21,850,679,1529,1733
0132-000,2016,11,10,22,632,501,1133,1529
0132-000,2016,11,10,23,397,464,861,1133
0132-000,2016,11,10,24,221,233,454,861
0132-000,2016,11,11,1,167,156,323,454
0132-000,2016,11,11,2,117,119,236,323
0132-000,2016,11,11,3,77,95,172,236
0132-000,2016,11,11,4,76,106,182,172
0132-000,2016,11,11,5,137,142,279,182
0132-000,2016,11,11,6,244,235,479,279
0132-000,2016,11,11,7,462,549,1011,479
0132-000,2016,11,11,8,676,1760,2436,1011
0132-000,2016,11,11,9,939,1572,2511,2436
0132-000,2016,11,11,10,820,952,1772,2511
0132-000,2016,11,11,11,803,908,1711,1772
0132-000,2016,11,11,12,856,969,1825,1711
0132-000,2016,11,11,13,856,845,1701,1825
0132-000,2016,11,11,14,909,877,1786,1701
0132-000,2016,11,11,15,969,920,1889,1786
0132-000,2016,11,11,16,1085,951,2036,1889
0132-000,2016,11,11,17,1144,911,2055,2036
0132-000,2016,11,11,18,1518,1058,2576,2055
0132-000,2016,11,11,19,1840,999,2839,2576
0132-000,2016,11,11,20,1177,924,2101,2839
0132-000,2016,11,11,21,909,694,1603,2101
0132-000,2016,11,11,22,686,617,1303,1603
0132-000,2016,11,11,23,477,435,912,1303
0132-000,2016,11,11,24,342,287,629,912
0132-000,2016,11,12,1,237,212,449,629
0132-000,2016,11,12,2,142,159,301,449
0132-000,2016,11,12,3,97,101,198,301
0132-000,2016,11,12,4,99,115,214,198
0132-000,2016,11,12,5,121,118,239,214
0132-000,2016,11,12,6,274,196,470,239
0132-000,2016,11,12,7,392,408,800,470
0132-000,2016,11,12,8,526,867,1393,800
0132-000,2016,11,12,9,708,1178,1886,1393
0132-000,2016,11,12,10,787,1190,1977,1886
0132-000,2016,11,12,11,939,1274,2213,1977
0132-000,2016,11,12,12,1222,1313,2535,2213
0132-000,2016,11,12,13,1156,1302,2458,2535
0132-000,2016,11,12,14,915,1384,2299,2458
0132-000,2016,11,12,15,994,1278,2272,2299
0132-000,2016,11,12,16,1063,1203,2266,2272
0132-000,2016,11,12,17,1320,1247,2567,2266
0132-000,2016,11,12,18,1721,1205,2926,2567
0132-000,2016,11,12,19,1812,973,2785,2926
0132-000,2016,11,12,20,1209,704,1913,2785
0132-000,2016,11,12,21,787,538,1325,1913
0132-000,2016,11,12,22,528,478,1006,1325
0132-000,2016,11,12,23,356,347,703,1006
0132-000,2016,11,12,24,219,271,490,703
0132-000,2016,11,13,1,169,161,330,490
0132-000,2016,11,13,2,136,143,279,330
0132-000,2016,11,13,3,100,106,206,279
0132-000,2016,11,13,4,91,93,184,206
0132-000,2016,11,13,5,94,94,188,184
0132-000,2016,11,13,6,171,183,354,188
0132-000,2016,11,13,7,221,288,509,354
0132-000,2016,11,13,8,287,412,699,509
0132-000,2016,11,13,9,419,569,988,699
0132-000,2016,11,13,10,543,607,1150,988
0132-000,2016,11,13,11,590,689,1279,1150
0132-000,2016,11,13,12,634,679,1313,1279
0132-000,2016,11,13,13,788,679,1467,1313
0132-000,2016,11,13,14,818,723,1541,1467
0132-000,2016,11,13,15,1080,794,1874,1541
0132-000,2016,11,13,16,1492,823,2315,1874
0132-000,2016,11,13,17,1894,883,2777,2315
0132-000,2016,11,13,18,1852,863,2715,2777
0132-000,2016,11,13,19,1845,670,2515,2715
0132-000,2016,11,13,20,1792,546,2338,2515
0132-000,2016,11,13,21,1544,471,2015,2338
0132-000,2016,11,13,22,1380,397,1777,2015
0132-000,2016,11,13,23,688,320,1008,1777
0132-000,2016,11,13,24,237,199,436,1008
0132-000,2016,11,14,1,118,155,273,436
0132-000,2016,11,14,2,97,83,180,273
0132-000,2016,11,14,3,53,73,126,180
0132-000,2016,11,14,4,63,93,156,126
0132-000,2016,11,14,5,119,97,216,156
0132-000,2016,11,14,6,351,217,568,216
0132-000,2016,11,14,7,483,664,1147,568
0132-000,2016,11,14,8,700,1809,2509,1147
0132-000,2016,11,14,9,916,1680,2596,2509
0132-000,2016,11,14,10,826,955,1781,2596
0132-000,2016,11,14,11,744,889,1633,1781
0132-000,2016,11,14,12,833,974,1807,1633
0132-000,2016,11,14,13,843,907,1750,1807
0132-000,2016,11,14,14,872,917,1789,1750
0132-000,2016,11,14,15,918,913,1831,1789
0132-000,2016,11,14,16,977,886,1863,1831
0132-000,2016,11,14,17,1127,893,2020,1863
0132-000,2016,11,14,18,1403,960,2363,2020
0132-000,2016,11,14,19,1531,904,2435,2363
0132-000,2016,11,14,20,1011,766,1777,2435
0132-000,2016,11,14,21,811,555,1366,1777
0132-000,2016,11,14,22,670,451,1121,1366
0132-000,2016,11,14,23,384,329,713,1121
0132-000,2016,11,14,24,240,238,478,713
0132-000,2016,11,15,1,143,127,270,478
0132-000,2016,11,15,2,105,118,223,270
0132-000,2016,11,15,3,75,93,168,223
0132-000,2016,11,15,4,68,78,146,168
0132-000,2016,11,15,5,123,156,279,146
0132-000,2016,11,15,6,291,273,564,279
0132-000,2016,11,15,7,476,563,1039,564
0132-000,2016,11,15,8,711,1819,2530,1039
0132-000,2016,11,15,9,850,1655,2505,2530
0132-000,2016,11,15,10,820,953,1773,2505
0132-000,2016,11,15,11,887,916,1803,1773
0132-000,2016,11,15,12,862,861,1723,1803
0132-000,2016,11,15,13,799,844,1643,1723
0132-000,2016,11,15,14,912,931,1843,1643
0132-000,2016,11,15,15,978,923,1901,1843
0132-000,2016,11,15,16,1004,883,1887,1901
0132-000,2016,11,15,17,1127,924,2051,1887
0132-000,2016,11,15,18,1515,940,2455,2051
0132-000,2016,11,15,19,1542,865,2407,2455
0132-000,2016,11,15,20,994,816,1810,2407
0132-000,2016,11,15,21,927,559,1486,1810
0132-000,2016,11,15,22,639,450,1089,1486
0132-000,2016,11,15,23,441,348,789,1089
0132-000,2016,11,15,24,217,207,424,789
0132-000,2016,11,16,1,160,156,316,424
0132-000,2016,11,16,2,108,114,222,316
0132-000,2016,11,16,3,77,99,176,222
0132-000,2016,11,16,4,73,96,169,176
0132-000,2016,11,16,5,114,110,224,169
0132-000,2016,11,16,6,282,199,481,224
0132-000,2016,11,16,7,456,554,1010,481
0132-000,2016,11,16,8,730,1809,2539,1010
0132-000,2016,11,16,9,885,1592,2477,2539
0132-000,2016,11,16,10,808,986,1794,2477
0132-000,2016,11,16,11,864,924,1788,1794
0132-000,2016,11,16,12,860,978,1838,1788
0132-000,2016,11,16,13,804,808,1612,1838
0132-000,2016,11,16,14,850,897,1747,1612
0132-000,2016,11,16,15,949,865,1814,1747
0132-000,2016,11,16,16,1015,856,1871,1814
0132-000,2016,11,16,17,1071,879,1950,1871
0132-000,2016,11,16,18,1511,963,2474,1950
0132-000,2016,11,16,19,1622,792,2414,2474
0132-000,2016,11,16,20,976,842,1818,2414
0132-000,2016,11,16,21,813,565,1378,1818
0132-000,2016,11,16,22,591,425,1016,1378
0132-000,2016,11,16,23,373,366,739,1016
0132-000,2016,11,16,24,251,239,490,739
0132-000,2016,11,17,1,155,186,341,490
0132-000,2016,11,17,2,118,107,225,341
0132-000,2016,11,17,3,90,98,188,225
0132-000,2016,11,17,4,74,104,178,188
0132-000,2016,11,17,5,135,112,247,178
0132-000,2016,11,17,6,295,195,490,247
0132-000,2016,11,17,7,488,593,1081,490
0132-000,2016,11,17,8,656,1799,2455,1081
0132-000,2016,11,17,9,896,1561,2457,2455
0132-000,2016,11,17,10,878,1055,1933,2457
0132-000,2016,11,17,11,822,943,1765,1933
0132-000,2016,11,17,12,872,936,1808,1765
0132-000,2016,11,17,13,800,866,1666,1808
0132-000,2016,11,17,14,934,879,1813,1666
0132-000,2016,11,17,15,920,891,1811,1813
0132-000,2016,11,17,16,1056,870,1926,1811
0132-000,2016,11,17,17,1133,903,2036,1926
0132-000,2016,11,17,18,1393,966,2359,2036
0132-000,2016,11,17,19,1533,843,2376,2359
0132-000,2016,11,17,20,1005,719,1724,2376
0132-000,2016,11,17,21,905,678,1583,1724
0132-000,2016,11,17,22,628,495,1123,1583
0132-000,2016,11,17,23,394,341,735,1123
0132-000,2016,11,17,24,264,227,491,735
0132-000,2016,11,18,1,159,163,322,491
0132-000,2016,11,18,2,106,120,226,322
0132-000,2016,11,18,3,98,103,201,226
0132-000,2016,11,18,4,77,103,180,201
0132-000,2016,11,18,5,123,125,248,180
0132-000,2016,11,18,6,277,192,469,248
0132-000,2016,11,18,7,474,608,1082,469
0132-000,2016,11,18,8,686,1771,2457,1082
0132-000,2016,11,18,9,969,1549,2518,2457
0132-000,2016,11,18,10,866,1004,1870,2518
0132-000,2016,11,18,11,844,1009,1853,1870
0132-000,2016,11,18,12,896,966,1862,1853
0132-000,2016,11,18,13,875,908,1783,1862
0132-000,2016,11,18,14,936,916,1852,1783
0132-000,2016,11,18,15,1023,1036,2059,1852
0132-000,2016,11,18,16,1162,978,2140,2059
0132-000,2016,11,18,17,1209,935,2144,2140
0132-000,2016,11,18,18,1524,1008,2532,2144
0132-000,2016,11,18,19,1815,935,2750,2532
0132-000,2016,11,18,20,1584,950,2534,2750
0132-000,2016,11,18,21,992,676,1668,2534
0132-000,2016,11,18,22,678,586,1264,1668
0132-000,2016,11,18,23,446,418,864,1264
0132-000,2016,11,18,24,310,287,597,864
0132-000,2016,11,19,1,217,211,428,597
0132-000,2016,11,19,2,142,150,292,428
0132-000,2016,11,19,3,102,114,216,292
0132-000,2016,11,19,4,98,118,216,216
0132-000,2016,11,19,5,119,115,234,216
0132-000,2016,11,19,6,264,189,453,234
0132-000,2016,11,19,7,388,386,774,453
0132-000,2016,11,19,8,514,833,1347,774
0132-000,2016,11,19,9,694,1066,1760,1347
0132-000,2016,11,19,10,784,1063,1847,1760
0132-000,2016,11,19,11,891,1092,1983,1847
0132-000,2016,11,19,12,1074,1134,2208,1983
0132-000,2016,11,19,13,1026,1150,2176,2208
0132-000,2016,11,19,14,886,1175,2061,2176
0132-000,2016,11,19,15,981,1119,2100,2061
0132-000,2016,11,19,16,1009,1076,2085,2100
0132-000,2016,11,19,17,1245,1111,2356,2085
0132-000,2016,11,19,18,1548,1078,2626,2356
0132-000,2016,11,19,19,1506,871,2377,2626
0132-000,2016,11,19,20,999,647,1646,2377
0132-000,2016,11,19,21,683,504,1187,1646
0132-000,2016,11,19,22,493,444,937,1187
0132-000,2016,11,19,23,359,330,689,937
0132-000,2016,11,19,24,208,251,459,689
0132-000,2016,11,20,1,193,181,374,459
0132-000,2016,11,20,2,134,140,274,374
0132-000,2016,11,20,3,104,105,209,274
0132-000,2016,11,20,4,109,96,205,209
0132-000,2016,11,20,5,98,94,192,205
0132-000,2016,11,20,6,176,147,323,192
0132-000,2016,11,20,7,225,252,477,323
0132-000,2016,11,20,8,310,419,729,477
0132-000,2016,11,20,9,424,562,986,729
0132-000,2016,11,20,10,534,660,1194,986
0132-000,2016,11,20,11,587,729,1316,1194
0132-000,2016,11,20,12,657,732,1389,1316
0132-000,2016,11,20,13,764,705,1469,1389
0132-000,2016,11,20,14,863,775,1638,1469
0132-000,2016,11,20,15,1036,796,1832,1638
0132-000,2016,11,20,16,1342,822,2164,1832
0132-000,2016,11,20,17,1749,844,2593,2164
0132-000,2016,11,20,18,1844,852,2696,2593
0132-000,2016,11,20,19,1846,686,2532,2696
0132-000,2016,11,20,20,1798,551,2349,2532
0132-000,2016,11,20,21,1530,466,1996,2349
0132-000,2016,11,20,22,1324,414,1738,1996
0132-000,2016,11,20,23,323,285,608,1738
0132-000,2016,11,20,24,0,0,0,608
0132-000,2016,11,21,1,153,146,299,0
0132-000,2016,11,21,2,67,85,152,299
0132-000,2016,11,21,3,57,63,120,152
0132-000,2016,11,21,4,58,76,134,120
0132-000,2016,11,21,5,129,102,231,134
0132-000,2016,11,21,6,309,222,531,231
0132-000,2016,11,21,7,480,683,1163,531
0132-000,2016,11,21,8,682,1819,2501,1163
0132-000,2016,11,21,9,864,1625,2489,2501
0132-000,2016,11,21,10,802,962,1764,2489
0132-000,2016,11,21,11,865,869,1734,1764
0132-000,2016,11,21,12,857,921,1778,1734
0132-000,2016,11,21,13,781,772,1553,1778
0132-000,2016,11,21,14,809,817,1626,1553
0132-000,2016,11,21,15,855,838,1693,1626
0132-000,2016,11,21,16,958,771,1729,1693
0132-000,2016,11,21,17,989,868,1857,1729
0132-000,2016,11,21,18,1299,961,2260,1857
0132-000,2016,11,21,19,1511,810,2321,2260
0132-000,2016,11,21,20,977,649,1626,2321
0132-000,2016,11,21,21,830,523,1353,1626
0132-000,2016,11,21,22,600,489,1089,1353
0132-000,2016,11,21,23,357,329,686,1089
0132-000,2016,11,21,24,248,218,466,686
0132-000,2016,11,22,1,172,135,307,466
0132-000,2016,11,22,2,109,111,220,307
0132-000,2016,11,22,3,65,77,142,220
0132-000,2016,11,22,4,69,104,173,142
0132-000,2016,11,22,5,110,167,277,173
0132-000,2016,11,22,6,286,259,545,277
0132-000,2016,11,22,7,424,553,977,545
0132-000,2016,11,22,8,684,1730,2414,977
0132-000,2016,11,22,9,885,1606,2491,2414
0132-000,2016,11,22,10,856,995,1851,2491
0132-000,2016,11,22,11,819,870,1689,1851
0132-000,2016,11,22,12,803,821,1624,1689
0132-000,2016,11,22,13,825,780,1605,1624
0132-000,2016,11,22,14,849,844,1693,1605
0132-000,2016,11,22,15,908,824,1732,1693
0132-000,2016,11,22,16,919,1101,2020,1732
0132-000,2016,11,22,17,1013,925,1938,2020
0132-000,2016,11,22,18,1314,916,2230,1938
0132-000,2016,11,22,19,1472,852,2324,2230
0132-000,2016,11,22,20,967,639,1606,2324
0132-000,2016,11,22,21,911,593,1504,1606
0132-000,2016,11,22,22,668,459,1127,1504
0132-000,2016,11,22,23,385,366,751,1127
0132-000,2016,11,22,24,213,217,430,751
0132-000,2016,11,23,1,167,149,316,430
0132-000,2016,11,23,2,92,97,189,316
0132-000,2016,11,23,3,82,84,166,189
0132-000,2016,11,23,4,61,86,147,166
0132-000,2016,11,23,5,103,108,211,147
0132-000,2016,11,23,6,265,162,427,211
0132-000,2016,11,23,7,420,547,967,427
0132-000,2016,11,23,8,651,1727,2378,967
0132-000,2016,11,23,9,868,1536,2404,2378
0132-000,2016,11,23,10,801,915,1716,2404
0132-000,2016,11,23,11,751,855,1606,1716
0132-000,2016,11,23,12,775,792,1567,1606
0132-000,2016,11,23,13,761,763,1524,1567
0132-000,2016,11,23,14,879,830,1709,1524
0132-000,2016,11,23,15,900,879,1779,1709
0132-000,2016,11,23,16,906,793,1699,1779
0132-000,2016,11,23,17,1058,799,1857,1699
0132-000,2016,11,23,18,1377,956,2333,1857
0132-000,2016,11,23,19,1495,795,2290,2333
0132-000,2016,11,23,20,915,675,1590,2290
0132-000,2016,11,23,21,801,523,1324,1590
0132-000,2016,11,23,22,580,444,1024,1324
0132-000,2016,11,23,23,360,333,693,1024
0132-000,2016,11,23,24,219,210,429,693
0132-000,2016,11,24,1,173,178,351,429
0132-000,2016,11,24,2,112,116,228,351
0132-000,2016,11,24,3,72,84,156,228
0132-000,2016,11,24,4,76,100,176,156
0132-000,2016,11,24,5,105,112,217,176
0132-000,2016,11,24,6,289,199,488,217
0132-000,2016,11,24,7,419,468,887,488
0132-000,2016,11,24,8,632,1644,2276,887
0132-000,2016,11,24,9,859,1575,2434,2276
0132-000,2016,11,24,10,813,975,1788,2434
0132-000,2016,11,24,11,792,796,1588,1788
0132-000,2016,11,24,12,765,819,1584,1588
0132-000,2016,11,24,13,699,681,1380,1584
0132-000,2016,11,24,14,833,857,1690,1380
0132-000,2016,11,24,15,843,1119,1962,1690
0132-000,2016,11,24,16,923,851,1774,1962
0132-000,2016,11,24,17,1003,852,1855,1774
0132-000,2016,11,24,18,1351,840,2191,1855
0132-000,2016,11,24,19,1376,861,2237,2191
0132-000,2016,11,24,20,946,676,1622,2237
0132-000,2016,11,24,21,854,538,1392,1622
0132-000,2016,11,24,22,630,674,1304,1392
0132-000,2016,11,24,23,398,320,718,1304
0132-000,2016,11,24,24,243,224,467,718
0132-000,2016,11,25,1,161,145,306,467
0132-000,2016,11,25,2,113,103,216,306
0132-000,2016,11,25,3,63,84,147,216
0132-000,2016,11,25,4,81,95,176,147
0132-000,2016,11,25,5,98,108,206,176
0132-000,2016,11,25,6,291,190,481,206
0132-000,2016,11,25,7,409,535,944,481
0132-000,2016,11,25,8,660,1692,2352,944
0132-000,2016,11,25,9,824,1433,2257,2352
0132-000,2016,11,25,10,845,923,1768,2257
0132-000,2016,11,25,11,776,865,1641,1768
0132-000,2016,11,25,12,792,847,1639,1641
0132-000,2016,11,25,13,813,763,1576,1639
0132-000,2016,11,25,14,833,746,1579,1576
0132-000,2016,11,25,15,963,798,1761,1579
0132-000,2016,11,25,16,1027,763,1790,1761
0132-000,2016,11,25,17,1133,978,2111,1790
0132-000,2016,11,25,18,1415,1143,2558,2111
0132-000,2016,11,25,19,1727,948,2675,2558
0132-000,2016,11,25,20,1238,968,2206,2675
0132-000,2016,11,25,21,1052,828,1880,2206
0132-000,2016,11,25,22,739,697,1436,1880
0132-000,2016,11,25,23,417,421,838,1436
0132-000,2016,11,25,24,257,264,521,838
0132-000,2016,11,26,1,197,210,407,521
0132-000,2016,11,26,2,141,141,282,407
0132-000,2016,11,26,3,107,126,233,282
0132-000,2016,11,26,4,96,121,217,233
0132-000,2016,11,26,5,117,111,228,217
0132-000,2016,11,26,6,253,181,434,228
0132-000,2016,11,26,7,384,364,748,434
0132-000,2016,11,26,8,501,798,1299,748
0132-000,2016,11,26,9,680,953,1633,1299
0132-000,2016,11,26,10,780,935,1715,1633
0132-000,2016,11,26,11,842,910,1752,1715
0132-000,2016,11,26,12,925,954,1879,1752
0132-000,2016,11,26,13,895,997,1892,1879
0132-000,2016,11,26,14,857,966,1823,1892
0132-000,2016,11,26,15,968,959,1927,1823
0132-000,2016,11,26,16,955,948,1903,1927
0132-000,2016,11,26,17,1170,975,2145,1903
0132-000,2016,11,26,18,1375,950,2325,2145
0132-000,2016,11,26,19,1199,768,1967,2325
0132-000,2016,11,26,20,789,589,1378,1967
0132-000,2016,11,26,21,579,470,1049,1378
0132-000,2016,11,26,22,458,409,867,1049
0132-000,2016,11,26,23,362,312,674,867
0132-000,2016,11,26,24,197,231,428,674
0132-000,2016,11,27,1,178,166,344,428
0132-000,2016,11,27,2,109,139,248,344
0132-000,2016,11,27,3,100,126,226,248
0132-000,2016,11,27,4,80,84,164,226
0132-000,2016,11,27,5,85,77,162,164
0132-000,2016,11,27,6,146,126,272,162
0132-000,2016,11,27,7,203,177,380,272
0132-000,2016,11,27,8,245,355,600,380
0132-000,2016,11,27,9,392,424,816,600
0132-000,2016,11,27,10,477,534,1011,816
0132-000,2016,11,27,11,588,709,1297,1011
0132-000,2016,11,27,12,646,706,1352,1297
0132-000,2016,11,27,13,776,692,1468,1352
0132-000,2016,11,27,14,755,689,1444,1468
0132-000,2016,11,27,15,941,720,1661,1444
0132-000,2016,11,27,16,1015,759,1774,1661
0132-000,2016,11,27,17,1087,742,1829,1774
0132-000,2016,11,27,18,1157,784,1941,1829
0132-000,2016,11,27,19,1089,646,1735,1941
0132-000,2016,11,27,20,753,523,1276,1735
0132-000,2016,11,27,21,599,404,1003,1276
0132-000,2016,11,27,22,593,342,935,1003
0132-000,2016,11,27,23,290,282,572,935
0132-000,2016,11,27,24,194,177,371,572
0132-000,2016,11,28,1,118,117,235,371
0132-000,2016,11,28,2,67,65,132,235
0132-000,2016,11,28,3,50,72,122,132
0132-000,2016,11,28,4,61,68,129,122
0132-000,2016,11,28,5,94,88,182,129
0132-000,2016,11,28,6,290,182,472,182
0132-000,2016,11,28,7,443,635,1078,472
0132-000,2016,11,28,8,677,1796,2473,1078
0132-000,2016,11,28,9,789,1576,2365,2473
0132-000,2016,11,28,10,817,934,1751,2365
0132-000,2016,11,28,11,873,827,1700,1751
0132-000,2016,11,28,12,765,838,1603,1700
0132-000,2016,11,28,13,791,791,1582,1603
0132-000,2016,11,28,14,767,857,1624,1582
0132-000,2016,11,28,15,875,874,1749,1624
0132-000,2016,11,28,16,952,804,1756,1749
0132-000,2016,11,28,17,1009,941,1950,1756
0132-000,2016,11,28,18,1321,918,2239,1950
0132-000,2016,11,28,19,1469,794,2263,2239
0132-000,2016,11,28,20,909,670,1579,2263
0132-000,2016,11,28,21,785,535,1320,1579
0132-000,2016,11,28,22,572,431,1003,1320
0132-000,2016,11,28,23,378,325,703,1003
0132-000,2016,11,28,24,220,177,397,703
0132-000,2016,11,29,1,141,131,272,397
0132-000,2016,11,29,2,89,85,174,272
0132-000,2016,11,29,3,65,76,141,174
0132-000,2016,11,29,4,54,92,146,141
0132-000,2016,11,29,5,99,96,195,146
0132-000,2016,11,29,6,283,189,472,195
0132-000,2016,11,29,7,457,535,992,472
0132-000,2016,11,29,8,628,1702,2330,992
0132-000,2016,11,29,9,840,1609,2449,2330
0132-000,2016,11,29,10,846,924,1770,2449
0132-000,2016,11,29,11,787,870,1657,1770
0132-000,2016,11,29,12,790,851,1641,1657
0132-000,2016,11,29,13,745,729,1474,1641
0132-000,2016,11,29,14,838,770,1608,1474
0132-000,2016,11,29,15,869,853,1722,1608
0132-000,2016,11,29,16,871,729,1600,1722
0132-000,2016,11,29,17,978,821,1799,1600
0132-000,2016,11,29,18,1318,931,2249,1799
0132-000,2016,11,29,19,1417,791,2208,2249
0132-000,2016,11,29,20,922,663,1585,2208
0132-000,2016,11,29,21,801,531,1332,1585
0132-000,2016,11,29,22,648,430,1078,1332
0132-000,2016,11,29,23,399,343,742,1078
0132-000,2016,11,29,24,235,225,460,742
0132-000,2016,11,30,1,158,157,315,460
0132-000,2016,11,30,2,102,95,197,315
0132-000,2016,11,30,3,75,95,170,197
0132-000,2016,11,30,4,66,100,166,170
0132-000,2016,11,30,5,102,98,200,166
0132-000,2016,11,30,6,246,181,427,200
0132-000,2016,11,30,7,439,485,924,427
0132-000,2016,11,30,8,632,1722,2354,924
0132-000,2016,11,30,9,833,1515,2348,2354
0132-000,2016,11,30,10,809,934,1743,2348
0132-000,2016,11,30,11,870,852,1722,1743
0132-000,2016,11,30,12,778,854,1632,1722
0132-000,2016,11,30,13,726,740,1466,1632
0132-000,2016,11,30,14,844,751,1595,1466
0132-000,2016,11,30,15,865,845,1710,1595
0132-000,2016,11,30,16,897,815,1712,1710
0132-000,2016,11,30,17,970,843,1813,1712
0132-000,2016,11,30,18,1375,916,2291,1813
0132-000,2016,11,30,19,1418,800,2218,2291
0132-000,2016,11,30,20,946,687,1633,2218
0132-000,2016,11,30,21,762,536,1298,1633
0132-000,2016,11,30,22,599,411,1010,1298
0132-000,2016,11,30,23,401,342,743,1010
0132-000,2016,11,30,24,221,213,434,743
0132-000,2016,12,1,1,179,175,354,434
0132-000,2016,12,1,2,137,101,238,354
0132-000,2016,12,1,3,94,125,219,238
0132-000,2016,12,1,4,77,101,178,219
0132-000,2016,12,1,5,103,103,206,178
0132-000,2016,12,1,6,268,178,446,206
0132-000,2016,12,1,7,425,518,943,446
0132-000,2016,12,1,8,681,1733,2414,943
0132-000,2016,12,1,9,850,1507,2357,2414
0132-000,2016,12,1,10,774,902,1676,2357
0132-000,2016,12,1,11,748,830,1578,1676
0132-000,2016,12,1,12,747,827,1574,1578
0132-000,2016,12,1,13,731,669,1400,1574
0132-000,2016,12,1,14,808,757,1565,1400
0132-000,2016,12,1,15,862,811,1673,1565
0132-000,2016,12,1,16,888,784,1672,1673
0132-000,2016,12,1,17,934,844,1778,1672
0132-000,2016,12,1,18,1292,940,2232,1778
0132-000,2016,12,1,19,1367,762,2129,2232
0132-000,2016,12,1,20,894,629,1523,2129
0132-000,2016,12,1,21,854,483,1337,1523
0132-000,2016,12,1,22,626,417,1043,1337
0132-000,2016,12,1,23,403,341,744,1043
0132-000,2016,12,1,24,207,201,408,744
0132-000,2016,12,2,1,180,157,337,408
0132-000,2016,12,2,2,115,100,215,337
0132-000,2016,12,2,3,65,89,154,215
0132-000,2016,12,2,4,80,109,189,154
0132-000,2016,12,2,5,127,96,223,189
0132-000,2016,12,2,6,225,192,417,223
0132-000,2016,12,2,7,431,478,909,417
0132-000,2016,12,2,8,645,1710,2355,909
0132-000,2016,12,2,9,893,1533,2426,2355
0132-000,2016,12,2,10,788,888,1676,2426
0132-000,2016,12,2,11,757,856,1613,1676
0132-000,2016,12,2,12,849,824,1673,1613
0132-000,2016,12,2,13,762,795,1557,1673
0132-000,2016,12,2,14,836,843,1679,1557
0132-000,2016,12,2,15,856,870,1726,1679
0132-000,2016,12,2,16,985,849,1834,1726
0132-000,2016,12,2,17,1055,861,1916,1834
0132-000,2016,12,2,18,1390,988,2378,1916
0132-000,2016,12,2,19,1719,896,2615,2378
0132-000,2016,12,2,20,1086,762,1848,2615
0132-000,2016,12,2,21,869,586,1455,1848
0132-000,2016,12,2,22,673,498,1171,1455
0132-000,2016,12,2,23,432,420,852,1171
0132-000,2016,12,2,24,284,276,560,852
0132-000,2016,12,3,1,209,206,415,560
0132-000,2016,12,3,2,146,155,301,415
0132-000,2016,12,3,3,104,124,228,301
0132-000,2016,12,3,4,84,104,188,228
0132-000,2016,12,3,5,117,119,236,188
0132-000,2016,12,3,6,247,198,445,236
0132-000,2016,12,3,7,366,374,740,445
0132-000,2016,12,3,8,462,769,1231,740
0132-000,2016,12,3,9,682,937,1619,1231
0132-000,2016,12,3,10,741,953,1694,1619
0132-000,2016,12,3,11,806,943,1749,1694
0132-000,2016,12,3,12,884,952,1836,1749
0132-000,2016,12,3,13,964,945,1909,1836
0132-000,2016,12,3,14,871,917,1788,1909
0132-000,2016,12,3,15,931,1022,1953,1788
0132-000,2016,12,3,16,996,948,1944,1953
0132-000,2016,12,3,17,1059,981,2040,1944
0132-000,2016,12,3,18,1488,1038,2526,2040
0132-000,2016,12,3,19,1160,885,2045,2526
0132-000,2016,12,3,20,736,630,1366,2045
0132-000,2016,12,3,21,553,531,1084,1366
0132-000,2016,12,3,22,449,426,875,1084
0132-000,2016,12,3,23,337,329,666,875
0132-000,2016,12,3,24,223,246,469,666
0132-000,2016,12,4,1,170,176,346,469
0132-000,2016,12,4,2,103,149,252,346
0132-000,2016,12,4,3,109,110,219,252
0132-000,2016,12,4,4,86,77,163,219
0132-000,2016,12,4,5,92,86,178,163
0132-000,2016,12,4,6,161,136,297,178
0132-000,2016,12,4,7,214,214,428,297
0132-000,2016,12,4,8,278,387,665,428
0132-000,2016,12,4,9,368,461,829,665
0132-000,2016,12,4,10,435,552,987,829
0132-000,2016,12,4,11,581,688,1269,987
0132-000,2016,12,4,12,597,667,1264,1269
0132-000,2016,12,4,13,715,734,1449,1264
0132-000,2016,12,4,14,744,768,1512,1449
0132-000,2016,12,4,15,889,825,1714,1512
0132-000,2016,12,4,16,884,777,1661,1714
0132-000,2016,12,4,17,997,778,1775,1661
0132-000,2016,12,4,18,1161,779,1940,1775
0132-000,2016,12,4,19,1048,631,1679,1940
0132-000,2016,12,4,20,709,555,1264,1679
0132-000,2016,12,4,21,560,458,1018,1264
0132-000,2016,12,4,22,403,354,757,1018
0132-000,2016,12,4,23,289,281,570,757
0132-000,2016,12,4,24,149,184,333,570
0132-000,2016,12,5,1,123,128,251,333
0132-000,2016,12,5,2,64,77,141,251
0132-000,2016,12,5,3,44,67,111,141
0132-000,2016,12,5,4,53,69,122,111
0132-000,2016,12,5,5,108,89,197,122
0132-000,2016,12,5,6,270,190,460,197
0132-000,2016,12,5,7,496,633,1129,460
0132-000,2016,12,5,8,611,1792,2403,1129
0132-000,2016,12,5,9,860,1522,2382,2403
0132-000,2016,12,5,10,770,896,1666,2382
0132-000,2016,12,5,11,794,836,1630,1666
0132-000,2016,12,5,12,778,826,1604,1630
0132-000,2016,12,5,13,796,831,1627,1604
0132-000,2016,12,5,14,780,744,1524,1627
0132-000,2016,12,5,15,787,816,1603,1524
0132-000,2016,12,5,16,882,816,1698,1603
0132-000,2016,12,5,17,908,822,1730,1698
0132-000,2016,12,5,18,1115,883,1998,1730
0132-000,2016,12,5,19,1386,913,2299,1998
0132-000,2016,12,5,20,921,626,1547,2299
0132-000,2016,12,5,21,842,506,1348,1547
0132-000,2016,12,5,22,580,418,998,1348
0132-000,2016,12,5,23,356,304,660,998
0132-000,2016,12,5,24,224,182,406,660
0132-000,2016,12,6,1,145,152,297,406
0132-000,2016,12,6,2,106,89,195,297
0132-000,2016,12,6,3,57,93,150,195
0132-000,2016,12,6,4,72,103,175,150
0132-000,2016,12,6,5,107,121,228,175
0132-000,2016,12,6,6,235,163,398,228
0132-000,2016,12,6,7,466,537,1003,398
0132-000,2016,12,6,8,635,1747,2382,1003
0132-000,2016,12,6,9,858,1590,2448,2382
0132-000,2016,12,6,10,754,927,1681,2448
0132-000,2016,12,6,11,763,841,1604,1681
0132-000,2016,12,6,12,771,795,1566,1604
0132-000,2016,12,6,13,727,770,1497,1566
0132-000,2016,12,6,14,862,813,1675,1497
0132-000,2016,12,6,15,849,818,1667,1675
0132-000,2016,12,6,16,913,728,1641,1667
0132-000,2016,12,6,17,958,859,1817,1641
0132-000,2016,12,6,18,1317,846,2163,1817
0132-000,2016,12,6,19,1387,861,2248,2163
0132-000,2016,12,6,20,944,651,1595,2248
0132-000,2016,12,6,21,856,562,1418,1595
0132-000,2016,12,6,22,658,444,1102,1418
0132-000,2016,12,6,23,392,354,746,1102
0132-000,2016,12,6,24,224,221,445,746
0132-000,2016,12,7,1,153,128,281,445
0132-000,2016,12,7,2,112,97,209,281
0132-000,2016,12,7,3,67,89,156,209
0132-000,2016,12,7,4,59,91,150,156
0132-000,2016,12,7,5,110,100,210,150
0132-000,2016,12,7,6,247,171,418,210
0132-000,2016,12,7,7,414,508,922,418
0132-000,2016,12,7,8,641,1621,2262,922
0132-000,2016,12,7,9,821,1505,2326,2262
0132-000,2016,12,7,10,742,917,1659,2326
0132-000,2016,12,7,11,774,794,1568,1659
0132-000,2016,12,7,12,792,757,1549,1568
0132-000,2016,12,7,13,672,705,1377,1549
0132-000,2016,12,7,14,801,794,1595,1377
0132-000,2016,12,7,15,882,862,1744,1595
0132-000,2016,12,7,16,902,804,1706,1744
0132-000,2016,12,7,17,1014,821,1835,1706
0132-000,2016,12,7,18,1376,936,2312,1835
0132-000,2016,12,7,19,1456,798,2254,2312
0132-000,2016,12,7,20,930,681,1611,2254
0132-000,2016,12,7,21,782,530,1312,1611
0132-000,2016,12,7,22,590,428,1018,1312
0132-000,2016,12,7,23,380,338,718,1018
0132-000,2016,12,7,24,220,212,432,718
0132-000,2016,12,8,1,159,156,315,432
0132-000,2016,12,8,2,111,97,208,315
0132-000,2016,12,8,3,69,113,182,208
0132-000,2016,12,8,4,68,84,152,182
0132-000,2016,12,8,5,102,102,204,152
0132-000,2016,12,8,6,225,167,392,204
0132-000,2016,12,8,7,417,497,914,392
0132-000,2016,12,8,8,587,1651,2238,914
0132-000,2016,12,8,9,843,1550,2393,2238
0132-000,2016,12,8,10,807,930,1737,2393
0132-000,2016,12,8,11,776,842,1618,1737
0132-000,2016,12,8,12,645,954,1599,1618
0132-000,2016,12,8,13,665,664,1329,1599
0132-000,2016,12,8,14,915,812,1727,1329
0132-000,2016,12,8,15,879,832,1711,1727
0132-000,2016,12,8,16,898,762,1660,1711
0132-000,2016,12,8,17,1001,925,1926,1660
0132-000,2016,12,8,18,1341,922,2263,1926
0132-000,2016,12,8,19,1390,777,2167,2263
0132-000,2016,12,8,20,860,640,1500,2167
0132-000,2016,12,8,21,793,470,1263,1500
0132-000,2016,12,8,22,576,384,960,1263
0132-000,2016,12,8,23,404,330,734,960
0132-000,2016,12,8,24,218,232,450,734
0132-000,2016,12,9,1,169,162,331,450
0132-000,2016,12,9,2,124,121,245,331
0132-000,2016,12,9,3,79,105,184,245
0132-000,2016,12,9,4,65,88,153,184
0132-000,2016,12,9,5,96,119,215,153
0132-000,2016,12,9,6,236,150,386,215
0132-000,2016,12,9,7,379,498,877,386
0132-000,2016,12,9,8,635,1617,2252,877
0132-000,2016,12,9,9,802,1454,2256,2252
0132-000,2016,12,9,10,775,893,1668,2256
0132-000,2016,12,9,11,745,848,1593,1668
0132-000,2016,12,9,12,789,807,1596,1593
0132-000,2016,12,9,13,719,735,1454,1596
0132-000,2016,12,9,14,823,798,1621,1454
0132-000,2016,12,9,15,888,844,1732,1621
0132-000,2016,12,9,16,918,870,1788,1732
0132-000,2016,12,9,17,1051,818,1869,1788
0132-000,2016,12,9,18,1404,951,2355,1869
0132-000,2016,12,9,19,1723,922,2645,2355
0132-000,2016,12,9,20,1162,865,2027,2645
0132-000,2016,12,9,21,960,707,1667,2027
0132-000,2016,12,9,22,706,598,1304,1667
0132-000,2016,12,9,23,424,420,844,1304
0132-000,2016,12,9,24,270,270,540,844
0132-000,2016,12,10,1,194,202,396,540
0132-000,2016,12,10,2,161,159,320,396
0132-000,2016,12,10,3,119,118,237,320
0132-000,2016,12,10,4,86,120,206,237
0132-000,2016,12,10,5,102,132,234,206
0132-000,2016,12,10,6,197,149,346,234
0132-000,2016,12,10,7,299,379,678,346
0132-000,2016,12,10,8,461,720,1181,678
0132-000,2016,12,10,9,611,898,1509,1181
0132-000,2016,12,10,10,711,819,1530,1509
0132-000,2016,12,10,11,783,881,1664,1530
0132-000,2016,12,10,12,819,911,1730,1664
0132-000,2016,12,10,13,777,811,1588,1730
0132-000,2016,12,10,14,895,860,1755,1588
0132-000,2016,12,10,15,904,903,1807,1755
0132-000,2016,12,10,16,928,987,1915,1807
0132-000,2016,12,10,17,1052,1057,2109,1915
0132-000,2016,12,10,18,1369,1000,2369,2109
0132-000,2016,12,10,19,1181,810,1991,2369
0132-000,2016,12,10,20,692,585,1277,1991
0132-000,2016,12,10,21,533,491,1024,1277
0132-000,2016,12,10,22,423,421,844,1024
0132-000,2016,12,10,23,366,325,691,844
0132-000,2016,12,10,24,237,259,496,691
0132-000,2016,12,11,1,174,171,345,496
0132-000,2016,12,11,2,106,144,250,345
0132-000,2016,12,11,3,109,124,233,250
0132-000,2016,12,11,4,107,101,208,233
0132-000,2016,12,11,5,97,118,215,208
0132-000,2016,12,11,6,145,130,275,215
0132-000,2016,12,11,7,179,202,381,275
0132-000,2016,12,11,8,210,330,540,381
0132-000,2016,12,11,9,381,474,855,540
0132-000,2016,12,11,10,441,573,1014,855
0132-000,2016,12,11,11,565,589,1154,1014
0132-000,2016,12,11,12,577,634,1211,1154
0132-000,2016,12,11,13,729,733,1462,1211
0132-000,2016,12,11,14,703,725,1428,1462
0132-000,2016,12,11,15,855,723,1578,1428
0132-000,2016,12,11,16,859,702,1561,1578
0132-000,2016,12,11,17,948,718,1666,1561
0132-000,2016,12,11,18,1003,721,1724,1666
0132-000,2016,12,11,19,969,560,1529,1724
0132-000,2016,12,11,20,641,485,1126,1529
0132-000,2016,12,11,21,493,450,943,1126
0132-000,2016,12,11,22,385,367,752,943
0132-000,2016,12,11,23,231,278,509,752
0132-000,2016,12,11,24,190,188,378,509
0132-000,2016,12,12,1,106,132,238,378
0132-000,2016,12,12,2,81,86,167,238
0132-000,2016,12,12,3,46,54,100,167
0132-000,2016,12,12,4,49,69,118,100
0132-000,2016,12,12,5,91,84,175,118
0132-000,2016,12,12,6,270,183,453,175
0132-000,2016,12,12,7,453,606,1059,453
0132-000,2016,12,12,8,669,1761,2430,1059
0132-000,2016,12,12,9,818,1506,2324,2430
0132-000,2016,12,12,10,718,862,1580,2324
0132-000,2016,12,12,11,786,799,1585,1580
0132-000,2016,12,12,12,792,793,1585,1585
0132-000,2016,12,12,13,711,754,1465,1585
0132-000,2016,12,12,14,805,762,1567,1465
0132-000,2016,12,12,15,814,828,1642,1567
0132-000,2016,12,12,16,897,798,1695,1642
0132-000,2016,12,12,17,920,865,1785,1695
0132-000,2016,12,12,18,1304,916,2220,1785
0132-000,2016,12,12,19,1321,779,2100,2220
0132-000,2016,12,12,20,880,662,1542,2100
0132-000,2016,12,12,21,766,484,1250,1542
0132-000,2016,12,12,22,641,417,1058,1250
0132-000,2016,12,12,23,338,319,657,1058
0132-000,2016,12,12,24,207,208,415,657
0132-000,2016,12,13,1,142,129,271,415
0132-000,2016,12,13,2,71,83,154,271
0132-000,2016,12,13,3,62,78,140,154
0132-000,2016,12,13,4,57,72,129,140
0132-000,2016,12,13,5,87,101,188,129
0132-000,2016,12,13,6,233,178,411,188
0132-000,2016,12,13,7,409,498,907,411
0132-000,2016,12,13,8,610,1698,2308,907
0132-000,2016,12,13,9,816,1513,2329,2308
0132-000,2016,12,13,10,762,847,1609,2329
0132-000,2016,12,13,11,734,787,1521,1609
0132-000,2016,12,13,12,745,790,1535,1521
0132-000,2016,12,13,13,779,748,1527,1535
0132-000,2016,12,13,14,798,730,1528,1527
0132-000,2016,12,13,15,824,806,1630,1528
0132-000,2016,12,13,16,900,801,1701,1630
0132-000,2016,12,13,17,967,885,1852,1701
0132-000,2016,12,13,18,1258,850,2108,1852
0132-000,2016,12,13,19,1351,785,2136,2108
0132-000,2016,12,13,20,872,567,1439,2136
0132-000,2016,12,13,21,793,491,1284,1439
0132-000,2016,12,13,22,617,431,1048,1284
0132-000,2016,12,13,23,391,334,725,1048
0132-000,2016,12,13,24,218,225,443,725
0132-000,2016,12,14,1,158,143,301,443
0132-000,2016,12,14,2,111,100,211,301
0132-000,2016,12,14,3,60,85,145,211
0132-000,2016,12,14,4,67,86,153,145
0132-000,2016,12,14,5,98,126,224,153
0132-000,2016,12,14,6,247,156,403,224
0132-000,2016,12,14,7,427,509,936,403
0132-000,2016,12,14,8,636,1672,2308,936
0132-000,2016,12,14,9,827,1510,2337,2308
0132-000,2016,12,14,10,770,874,1644,2337
0132-000,2016,12,14,11,778,826,1604,1644
0132-000,2016,12,14,12,770,724,1494,1604
0132-000,2016,12,14,13,718,685,1403,1494
0132-000,2016,12,14,14,748,769,1517,1403
0132-000,2016,12,14,15,843,787,1630,1517
0132-000,2016,12,14,16,848,772,1620,1630
0132-000,2016,12,14,17,910,764,1674,1620
0132-000,2016,12,14,18,1305,860,2165,1674
0132-000,2016,12,14,19,1326,737,2063,2165
0132-000,2016,12,14,20,874,602,1476,2063
0132-000,2016,12,14,21,726,507,1233,1476
0132-000,2016,12,14,22,564,411,975,1233
0132-000,2016,12,14,23,350,329,679,975
0132-000,2016,12,14,24,213,220,433,679
0132-000,2016,12,15,1,182,149,331,433
0132-000,2016,12,15,2,83,83,166,331
0132-000,2016,12,15,3,79,91,170,166
0132-000,2016,12,15,4,76,98,174,170
0132-000,2016,12,15,5,79,105,184,174
0132-000,2016,12,15,6,236,164,400,184
0132-000,2016,12,15,7,413,497,910,400
0132-000,2016,12,15,8,610,1633,2243,910
0132-000,2016,12,15,9,814,1417,2231,2243
0132-000,2016,12,15,10,742,883,1625,2231
0132-000,2016,12,15,11,688,784,1472,1625
0132-000,2016,12,15,12,784,809,1593,1472
0132-000,2016,12,15,13,718,710,1428,1593
0132-000,2016,12,15,14,857,743,1600,1428
0132-000,2016,12,15,15,854,786,1640,1600
0132-000,2016,12,15,16,875,742,1617,1640
0132-000,2016,12,15,17,913,795,1708,1617
0132-000,2016,12,15,18,1196,865,2061,1708
0132-000,2016,12,15,19,1354,778,2132,2061
0132-000,2016,12,15,20,910,644,1554,2132
0132-000,2016,12,15,21,795,503,1298,1554
0132-000,2016,12,15,22,613,437,1050,1298
0132-000,2016,12,15,23,419,328,747,1050
0132-000,2016,12,15,24,235,249,484,747
0132-000,2016,12,16,1,180,146,326,484
0132-000,2016,12,16,2,99,104,203,326
0132-000,2016,12,16,3,79,111,190,203
0132-000,2016,12,16,4,80,98,178,190
0132-000,2016,12,16,5,105,126,231,178
0132-000,2016,12,16,6,228,175,403,231
0132-000,2016,12,16,7,372,487,859,403
0132-000,2016,12,16,8,618,1619,2237,859
0132-000,2016,12,16,9,806,1418,2224,2237
0132-000,2016,12,16,10,719,836,1555,2224
0132-000,2016,12,16,11,741,863,1604,1555
0132-000,2016,12,16,12,762,762,1524,1604
0132-000,2016,12,16,13,804,749,1553,1524
0132-000,2016,12,16,14,841,786,1627,1553
0132-000,2016,12,16,15,853,839,1692,1627
0132-000,2016,12,16,16,1002,804,1806,1692
0132-000,2016,12,16,17,1069,860,1929,1806
0132-000,2016,12,16,18,1370,915,2285,1929
0132-000,2016,12,16,19,1642,792,2434,2285
0132-000,2016,12,16,20,939,725,1664,2434
0132-000,2016,12,16,21,779,548,1327,1664
0132-000,2016,12,16,22,664,498,1162,1327
0132-000,2016,12,16,23,411,384,795,1162
0132-000,2016,12,16,24,289,298,587,795
0132-000,2016,12,17,1,209,217,426,587
0132-000,2016,12,17,2,160,144,304,426
0132-000,2016,12,17,3,91,120,211,304
0132-000,2016,12,17,4,86,111,197,211
0132-000,2016,12,17,5,131,105,236,197
0132-000,2016,12,17,6,201,169,370,236
0132-000,2016,12,17,7,303,341,644,370
0132-000,2016,12,17,8,502,717,1219,644
0132-000,2016,12,17,9,641,877,1518,1219
0132-000,2016,12,17,10,714,872,1586,1518
0132-000,2016,12,17,11,882,915,1797,1586
0132-000,2016,12,17,12,920,940,1860,1797
0132-000,2016,12,17,13,1124,862,1986,1860
0132-000,2016,12,17,14,1008,993,2001,1986
0132-000,2016,12,17,15,912,953,1865,2001
0132-000,2016,12,17,16,984,933,1917,1865
0132-000,2016,12,17,17,1113,1024,2137,1917
0132-000,2016,12,17,18,1356,1022,2378,2137
0132-000,2016,12,17,19,1111,891,2002,2378
0132-000,2016,12,17,20,691,621,1312,2002
0132-000,2016,12,17,21,560,495,1055,1312
0132-000,2016,12,17,22,493,417,910,1055
0132-000,2016,12,17,23,355,377,732,910
0132-000,2016,12,17,24,271,308,579,732
0132-000,2016,12,18,1,176,211,387,579
0132-000,2016,12,18,2,145,157,302,387
0132-000,2016,12,18,3,132,138,270,302
0132-000,2016,12,18,4,99,95,194,270
0132-000,2016,12,18,5,90,84,174,194
0132-000,2016,12,18,6,128,119,247,174
0132-000,2016,12,18,7,195,166,361,247
0132-000,2016,12,18,8,235,342,577,361
0132-000,2016,12,18,9,353,432,785,577
0132-000,2016,12,18,10,429,568,997,785
0132-000,2016,12,18,11,543,599,1142,997
0132-000,2016,12,18,12,573,655,1228,1142
0132-000,2016,12,18,13,682,732,1414,1228
0132-000,2016,12,18,14,739,707,1446,1414
0132-000,2016,12,18,15,824,795,1619,1446
0132-000,2016,12,18,16,843,808,1651,1619
0132-000,2016,12,18,17,942,713,1655,1651
0132-000,2016,12,18,18,1116,874,1990,1655
0132-000,2016,12,18,19,876,573,1449,1990
0132-000,2016,12,18,20,648,467,1115,1449
0132-000,2016,12,18,21,483,427,910,1115
0132-000,2016,12,18,22,392,367,759,910
0132-000,2016,12,18,23,247,271,518,759
0132-000,2016,12,18,24,196,200,396,518
0132-000,2016,12,19,1,109,125,234,396
0132-000,2016,12,19,2,66,91,157,234
0132-000,2016,12,19,3,48,70,118,157
0132-000,2016,12,19,4,44,71,115,118
0132-000,2016,12,19,5,98,77,175,115
0132-000,2016,12,19,6,236,175,411,175
0132-000,2016,12,19,7,405,535,940,411
0132-000,2016,12,19,8,600,1695,2295,940
0132-000,2016,12,19,9,812,1500,2312,2295
0132-000,2016,12,19,10,720,876,1596,2312
0132-000,2016,12,19,11,755,797,1552,1596
0132-000,2016,12,19,12,786,794,1580,1552
0132-000,2016,12,19,13,762,720,1482,1580
0132-000,2016,12,19,14,774,827,1601,1482
0132-000,2016,12,19,15,818,823,1641,1601
0132-000,2016,12,19,16,920,766,1686,1641
0132-000,2016,12,19,17,912,823,1735,1686
0132-000,2016,12,19,18,1234,851,2085,1735
0132-000,2016,12,19,19,1354,717,2071,2085
0132-000,2016,12,19,20,819,792,1611,2071
0132-000,2016,12,19,21,800,555,1355,1611
0132-000,2016,12,19,22,614,443,1057,1355
0132-000,2016,12,19,23,340,312,652,1057
0132-000,2016,12,19,24,180,189,369,652
0132-000,2016,12,20,1,134,138,272,369
0132-000,2016,12,20,2,111,89,200,272
0132-000,2016,12,20,3,72,92,164,200
0132-000,2016,12,20,4,78,86,164,164
0132-000,2016,12,20,5,100,102,202,164
0132-000,2016,12,20,6,237,158,395,202
0132-000,2016,12,20,7,406,506,912,395
0132-000,2016,12,20,8,606,1653,2259,912
0132-000,2016,12,20,9,828,1501,2329,2259
0132-000,2016,12,20,10,751,826,1577,2329
0132-000,2016,12,20,11,728,817,1545,1577
0132-000,2016,12,20,12,746,818,1564,1545
0132-000,2016,12,20,13,769,808,1577,1564
0132-000,2016,12,20,14,785,744,1529,1577
0132-000,2016,12,20,15,893,767,1660,1529
0132-000,2016,12,20,16,857,762,1619,1660
0132-000,2016,12,20,17,923,774,1697,1619
0132-000,2016,12,20,18,1265,863,2128,1697
0132-000,2016,12,20,19,1407,752,2159,2128
0132-000,2016,12,20,20,887,662,1549,2159
0132-000,2016,12,20,21,770,528,1298,1549
0132-000,2016,12,20,22,620,452,1072,1298
0132-000,2016,12,20,23,403,350,753,1072
0132-000,2016,12,20,24,238,236,474,753
0132-000,2016,12,21,1,160,162,322,474
0132-000,2016,12,21,2,88,114,202,322
0132-000,2016,12,21,3,65,111,176,202
0132-000,2016,12,21,4,84,75,159,176
0132-000,2016,12,21,5,111,111,222,159
0132-000,2016,12,21,6,243,189,432,222
0132-000,2016,12,21,7,436,520,956,432
0132-000,2016,12,21,8,583,1692,2275,956
0132-000,2016,12,21,9,818,1472,2290,2275
0132-000,2016,12,21,10,752,893,1645,2290
0132-000,2016,12,21,11,788,846,1634,1645
0132-000,2016,12,21,12,784,826,1610,1634
0132-000,2016,12,21,13,818,720,1538,1610
0132-000,2016,12,21,14,819,757,1576,1538
0132-000,2016,12,21,15,861,835,1696,1576
0132-000,2016,12,21,16,922,827,1749,1696
0132-000,2016,12,21,17,985,845,1830,1749
0132-000,2016,12,21,18,1255,808,2063,1830
0132-000,2016,12,21,19,1363,704,2067,2063
0132-000,2016,12,21,20,926,621,1547,2067
0132-000,2016,12,21,21,736,457,1193,1547
0132-000,2016,12,21,22,542,418,960,1193
0132-000,2016,12,21,23,368,365,733,960
0132-000,2016,12,21,24,210,218,428,733
0132-000,2016,12,22,1,180,155,335,428
0132-000,2016,12,22,2,112,123,235,335
0132-000,2016,12,22,3,74,101,175,235
0132-000,2016,12,22,4,76,87,163,175
0132-000,2016,12,22,5,93,115,208,163
0132-000,2016,12,22,6,190,149,339,208
0132-000,2016,12,22,7,357,447,804,339
0132-000,2016,12,22,8,547,1550,2097,804
0132-000,2016,12,22,9,730,1393,2123,2097
0132-000,2016,12,22,10,734,810,1544,2123
0132-000,2016,12,22,11,696,799,1495,1544
0132-000,2016,12,22,12,751,807,1558,1495
0132-000,2016,12,22,13,688,712,1400,1558
0132-000,2016,12,22,14,800,719,1519,1400
0132-000,2016,12,22,15,788,890,1678,1519
0132-000,2016,12,22,16,852,702,1554,1678
0132-000,2016,12,22,17,833,705,1538,1554
0132-000,2016,12,22,18,1159,731,1890,1538
0132-000,2016,12,22,19,1317,707,2024,1890
0132-000,2016,12,22,20,822,571,1393,2024
0132-000,2016,12,22,21,746,411,1157,1393
0132-000,2016,12,22,22,499,425,924,1157
0132-000,2016,12,22,23,385,360,745,924
0132-000,2016,12,22,24,233,227,460,745
0132-000,2016,12,23,1,173,157,330,460
0132-000,2016,12,23,2,122,139,261,330
0132-000,2016,12,23,3,80,93,173,261
0132-000,2016,12,23,4,82,97,179,173
0132-000,2016,12,23,5,100,93,193,179
0132-000,2016,12,23,6,202,152,354,193
0132-000,2016,12,23,7,342,425,767,354
0132-000,2016,12,23,8,581,1520,2101,767
0132-000,2016,12,23,9,754,1307,2061,2101
0132-000,2016,12,23,10,606,878,1484,2061
0132-000,2016,12,23,11,666,893,1559,1484
0132-000,2016,12,23,12,713,827,1540,1559
0132-000,2016,12,23,13,654,718,1372,1540
0132-000,2016,12,23,14,804,731,1535,1372
0132-000,2016,12,23,15,896,719,1615,1535
0132-000,2016,12,23,16,851,740,1591,1615
0132-000,2016,12,23,17,923,763,1686,1591
0132-000,2016,12,23,18,1236,781,2017,1686
0132-000,2016,12,23,19,1418,776,2194,2017
0132-000,2016,12,23,20,869,626,1495,2194
0132-000,2016,12,23,21,740,481,1221,1495
0132-000,2016,12,23,22,544,451,995,1221
0132-000,2016,12,23,23,407,366,773,995
0132-000,2016,12,23,24,239,287,526,773
0132-000,2016,12,24,1,206,195,401,526
0132-000,2016,12,24,2,127,157,284,401
0132-000,2016,12,24,3,102,100,202,284
0132-000,2016,12,24,4,105,125,230,202
0132-000,2016,12,24,5,120,114,234,230
0132-000,2016,12,24,6,163,143,306,234
0132-000,2016,12,24,7,296,287,583,306
0132-000,2016,12,24,8,444,640,1084,583
0132-000,2016,12,24,9,568,739,1307,1084
0132-000,2016,12,24,10,579,717,1296,1307
0132-000,2016,12,24,11,655,764,1419,1296
0132-000,2016,12,24,12,701,818,1519,1419
0132-000,2016,12,24,13,781,805,1586,1519
0132-000,2016,12,24,14,836,949,1785,1586
0132-000,2016,12,24,15,813,802,1615,1785
0132-000,2016,12,24,16,923,834,1757,1615
0132-000,2016,12,24,17,1053,895,1948,1757
0132-000,2016,12,24,18,1214,940,2154,1948
0132-000,2016,12,24,19,975,742,1717,2154
0132-000,2016,12,24,20,624,563,1187,1717
0132-000,2016,12,24,21,525,443,968,1187
0132-000,2016,12,24,22,415,392,807,968
0132-000,2016,12,24,23,322,336,658,807
0132-000,2016,12,24,24,235,246,481,658
0132-000,2016,12,25,1,160,205,365,481
0132-000,2016,12,25,2,119,145,264,365
0132-000,2016,12,25,3,95,119,214,264
0132-000,2016,12,25,4,78,95,173,214
0132-000,2016,12,25,5,69,91,160,173
0132-000,2016,12,25,6,108,93,201,160
0132-000,2016,12,25,7,172,151,323,201
0132-000,2016,12,25,8,196,272,468,323
0132-000,2016,12,25,9,294,329,623,468
0132-000,2016,12,25,10,370,432,802,623
0132-000,2016,12,25,11,516,528,1044,802
0132-000,2016,12,25,12,523,599,1122,1044
0132-000,2016,12,25,13,613,604,1217,1122
0132-000,2016,12,25,14,681,696,1377,1217
0132-000,2016,12,25,15,737,653,1390,1377
0132-000,2016,12,25,16,798,703,1501,1390
0132-000,2016,12,25,17,841,774,1615,1501
0132-000,2016,12,25,18,819,624,1443,1615
0132-000,2016,12,25,19,687,514,1201,1443
0132-000,2016,12,25,20,516,479,995,1201
0132-000,2016,12,25,21,428,400,828,995
0132-000,2016,12,25,22,373,337,710,828
0132-000,2016,12,25,23,275,264,539,710
0132-000,2016,12,25,24,165,193,358,539
0132-000,2016,12,26,1,105,143,248,358
0132-000,2016,12,26,2,57,92,149,248
0132-000,2016,12,26,3,54,73,127,149
0132-000,2016,12,26,4,62,68,130,127
0132-000,2016,12,26,5,103,83,186,130
0132-000,2016,12,26,6,252,191,443,186
0132-000,2016,12,26,7,458,588,1046,443
0132-000,2016,12,26,8,671,1651,2322,1046
0132-000,2016,12,26,9,784,1378,2162,2322
0132-000,2016,12,26,10,739,846,1585,2162
0132-000,2016,12,26,11,724,779,1503,1585
0132-000,2016,12,26,12,787,825,1612,1503
0132-000,2016,12,26,13,767,786,1553,1612
0132-000,2016,12,26,14,816,822,1638,1553
0132-000,2016,12,26,15,808,766,1574,1638
0132-000,2016,12,26,16,838,757,1595,1574
0132-000,2016,12,26,17,918,800,1718,1595
0132-000,2016,12,26,18,1161,833,1994,1718
0132-000,2016,12,26,19,1320,791,2111,1994
0132-000,2016,12,26,20,780,590,1370,2111
0132-000,2016,12,26,21,773,483,1256,1370
0132-000,2016,12,26,22,556,402,958,1256
0132-000,2016,12,26,23,378,314,692,958
0132-000,2016,12,26,24,208,195,403,692
0132-000,2016,12,27,1,177,168,345,403
0132-000,2016,12,27,2,108,100,208,345
0132-000,2016,12,27,3,88,90,178,208
0132-000,2016,12,27,4,69,99,168,178
0132-000,2016,12,27,5,88,88,176,168
0132-000,2016,12,27,6,211,158,369,176
0132-000,2016,12,27,7,385,476,861,369
0132-000,2016,12,27,8,583,1581,2164,861
0132-000,2016,12,27,9,781,1403,2184,2164
0132-000,2016,12,27,10,726,830,1556,2184
0132-000,2016,12,27,11,760,750,1510,1556
0132-000,2016,12,27,12,758,770,1528,1510
0132-000,2016,12,27,13,695,715,1410,1528
0132-000,2016,12,27,14,804,703,1507,1410
0132-000,2016,12,27,15,810,767,1577,1507
0132-000,2016,12,27,16,819,730,1549,1577
0132-000,2016,12,27,17,915,769,1684,1549
0132-000,2016,12,27,18,1177,844,2021,1684
0132-000,2016,12,27,19,1320,707,2027,2021
0132-000,2016,12,27,20,824,636,1460,2027
0132-000,2016,12,27,21,775,471,1246,1460
0132-000,2016,12,27,22,566,432,998,1246
0132-000,2016,12,27,23,361,340,701,998
0132-000,2016,12,27,24,235,230,465,701
0132-000,2016,12,28,1,176,166,342,465
0132-000,2016,12,28,2,93,104,197,342
0132-000,2016,12,28,3,61,96,157,197
0132-000,2016,12,28,4,67,84,151,157
0132-000,2016,12,28,5,95,101,196,151
0132-000,2016,12,28,6,213,144,357,196
0132-000,2016,12,28,7,417,461,878,357
0132-000,2016,12,28,8,603,1579,2182,878
0132-000,2016,12,28,9,790,1311,2101,2182
0132-000,2016,12,28,10,752,809,1561,2101
0132-000,2016,12,28,11,747,728,1475,1561
0132-000,2016,12,28,12,727,789,1516,1475
0132-000,2016,12,28,13,796,712,1508,1516
0132-000,2016,12,28,14,809,790,1599,1508
0132-000,2016,12,28,15,846,825,1671,1599
0132-000,2016,12,28,16,830,772,1602,1671
0132-000,2016,12,28,17,928,776,1704,1602
0132-000,2016,12,28,18,1285,916,2201,1704
0132-000,2016,12,28,19,1478,759,2237,2201
0132-000,2016,12,28,20,795,626,1421,2237
0132-000,2016,12,28,21,697,510,1207,1421
0132-000,2016,12,28,22,555,417,972,1207
0132-000,2016,12,28,23,352,310,662,972
0132-000,2016,12,28,24,263,248,511,662
0132-000,2016,12,29,1,175,190,365,511
0132-000,2016,12,29,2,144,106,250,365
0132-000,2016,12,29,3,72,115,187,250
0132-000,2016,12,29,4,89,97,186,187
0132-000,2016,12,29,5,116,105,221,186
0132-000,2016,12,29,6,188,141,329,221
0132-000,2016,12,29,7,345,422,767,329
0132-000,2016,12,29,8,490,1444,1934,767
0132-000,2016,12,29,9,747,1320,2067,1934
0132-000,2016,12,29,10,658,765,1423,2067
0132-000,2016,12,29,11,683,753,1436,1423
0132-000,2016,12,29,12,692,668,1360,1436
0132-000,2016,12,29,13,699,678,1377,1360
0132-000,2016,12,29,14,710,799,1509,1377
0132-000,2016,12,29,15,813,757,1570,1509
0132-000,2016,12,29,16,821,758,1579,1570
0132-000,2016,12,29,17,919,769,1688,1579
0132-000,2016,12,29,18,1205,806,2011,1688
0132-000,2016,12,29,19,1396,687,2083,2011
0132-000,2016,12,29,20,790,556,1346,2083
0132-000,2016,12,29,21,739,478,1217,1346
0132-000,2016,12,29,22,523,436,959,1217
0132-000,2016,12,29,23,371,330,701,959
0132-000,2016,12,29,24,261,254,515,701
0132-000,2016,12,30,1,170,191,361,515
0132-000,2016,12,30,2,130,112,242,361
0132-000,2016,12,30,3,82,117,199,242
0132-000,2016,12,30,4,80,98,178,199
0132-000,2016,12,30,5,111,95,206,178
0132-000,2016,12,30,6,177,158,335,206
0132-000,2016,12,30,7,340,395,735,335
0132-000,2016,12,30,8,513,1438,1951,735
0132-000,2016,12,30,9,839,1243,2082,1951
0132-000,2016,12,30,10,664,788,1452,2082
0132-000,2016,12,30,11,726,843,1569,1452
0132-000,2016,12,30,12,811,810,1621,1569
0132-000,2016,12,30,13,752,718,1470,1621
0132-000,2016,12,30,14,818,828,1646,1470
0132-000,2016,12,30,15,924,901,1825,1646
0132-000,2016,12,30,16,1010,884,1894,1825
0132-000,2016,12,30,17,1115,929,2044,1894
0132-000,2016,12,30,18,1365,950,2315,2044
0132-000,2016,12,30,19,1338,896,2234,2315
0132-000,2016,12,30,20,836,738,1574,2234
0132-000,2016,12,30,21,678,549,1227,1574
0132-000,2016,12,30,22,511,422,933,1227
0132-000,2016,12,30,23,420,377,797,933
0132-000,2016,12,30,24,302,274,576,797
0132-000,2016,12,31,1,198,209,407,576
0132-000,2016,12,31,2,153,168,321,407
0132-000,2016,12,31,3,113,129,242,321
0132-000,2016,12,31,4,101,117,218,242
0132-000,2016,12,31,5,80,106,186,218
0132-000,2016,12,31,6,171,130,301,186
0132-000,2016,12,31,7,234,247,481,301
0132-000,2016,12,31,8,372,537,909,481
0132-000,2016,12,31,9,523,628,1151,909
0132-000,2016,12,31,10,594,708,1302,1151
0132-000,2016,12,31,11,662,761,1423,1302
0132-000,2016,12,31,12,711,833,1544,1423
0132-000,2016,12,31,13,771,923,1694,1544
0132-000,2016,12,31,14,751,887,1638,1694
0132-000,2016,12,31,15,870,877,1747,1638
0132-000,2016,12,31,16,925,977,1902,1747
0132-000,2016,12,31,17,918,899,1817,1902
0132-000,2016,12,31,18,1105,848,1953,1817
0132-000,2016,12,31,19,900,699,1599,1953
0132-000,2016,12,31,20,618,493,1111,1599
0132-000,2016,12,31,21,478,435,913,1111
0132-000,2016,12,31,22,366,370,736,913
0132-000,2016,12,31,23,278,291,569,736
0132-000,2016,12,31,24,211,211,422,569
0132-000,2017,1,1,1,165,183,348,422
0132-000,2017,1,1,2,156,173,329,348
0132-000,2017,1,1,3,97,111,208,329
0132-000,2017,1,1,4,71,91,162,208
0132-000,2017,1,1,5,65,76,141,162
0132-000,2017,1,1,6,68,97,165,141
0132-000,2017,1,1,7,104,149,253,165
0132-000,2017,1,1,8,141,188,329,253
0132-000,2017,1,1,9,224,257,481,329
0132-000,2017,1,1,10,335,329,664,481
0132-000,2017,1,1,11,437,419,856,664
0132-000,2017,1,1,12,517,491,1008,856
0132-000,2017,1,1,13,590,589,1179,1008
0132-000,2017,1,1,14,648,624,1272,1179
0132-000,2017,1,1,15,681,645,1326,1272
0132-000,2017,1,1,16,773,660,1433,1326
0132-000,2017,1,1,17,836,622,1458,1433
0132-000,2017,1,1,18,796,580,1376,1458
0132-000,2017,1,1,19,716,650,1366,1376
0132-000,2017,1,1,20,558,432,990,1366
0132-000,2017,1,1,21,492,396,888,990
0132-000,2017,1,1,22,389,320,709,888
0132-000,2017,1,1,23,288,278,566,709
0132-000,2017,1,1,24,167,196,363,566
0132-000,2017,1,2,1,104,124,228,363
0132-000,2017,1,2,2,71,73,144,228
0132-000,2017,1,2,3,38,68,106,144
0132-000,2017,1,2,4,50,54,104,106
0132-000,2017,1,2,5,86,75,161,104
0132-000,2017,1,2,6,232,147,379,161
0132-000,2017,1,2,7,372,516,888,379
0132-000,2017,1,2,8,600,1574,2174,888
0132-000,2017,1,2,9,656,1213,1869,2174
0132-000,2017,1,2,10,642,721,1363,1869
0132-000,2017,1,2,11,687,682,1369,1363
0132-000,2017,1,2,12,649,716,1365,1369
0132-000,2017,1,2,13,669,675,1344,1365
0132-000,2017,1,2,14,731,714,1445,1344
0132-000,2017,1,2,15,818,767,1585,1445
0132-000,2017,1,2,16,825,724,1549,1585
0132-000,2017,1,2,17,843,694,1537,1549
0132-000,2017,1,2,18,1228,785,2013,1537
0132-000,2017,1,2,19,1284,891,2175,2013
0132-000,2017,1,2,20,737,578,1315,2175
0132-000,2017,1,2,21,696,471,1167,1315
0132-000,2017,1,2,22,561,350,911,1167
0132-000,2017,1,2,23,294,254,548,911
0132-000,2017,1,2,24,158,185,343,548
0132-000,2017,1,3,1,135,140,275,343
0132-000,2017,1,3,2,92,86,178,275
0132-000,2017,1,3,3,64,80,144,178
0132-000,2017,1,3,4,58,76,134,144
0132-000,2017,1,3,5,82,92,174,134
0132-000,2017,1,3,6,200,147,347,174
0132-000,2017,1,3,7,359,462,821,347
0132-000,2017,1,3,8,566,1565,2131,821
0132-000,2017,1,3,9,743,1411,2154,2131
0132-000,2017,1,3,10,660,804,1464,2154
0132-000,2017,1,3,11,713,768,1481,1464
0132-000,2017,1,3,12,740,745,1485,1481
0132-000,2017,1,3,13,694,750,1444,1485
0132-000,2017,1,3,14,790,735,1525,1444
0132-000,2017,1,3,15,821,753,1574,1525
0132-000,2017,1,3,16,853,723,1576,1574
0132-000,2017,1,3,17,884,766,1650,1576
0132-000,2017,1,3,18,1202,784,1986,1650
0132-000,2017,1,3,19,1307,780,2087,1986
0132-000,2017,1,3,20,858,607,1465,2087
0132-000,2017,1,3,21,777,495,1272,1465
0132-000,2017,1,3,22,565,403,968,1272
0132-000,2017,1,3,23,338,321,659,968
0132-000,2017,1,3,24,210,199,409,659
0132-000,2017,1,4,1,140,134,274,409
0132-000,2017,1,4,2,101,104,205,274
0132-000,2017,1,4,3,65,80,145,205
0132-000,2017,1,4,4,56,83,139,145
0132-000,2017,1,4,5,93,96,189,139
0132-000,2017,1,4,6,223,172,395,189
0132-000,2017,1,4,7,391,492,883,395
0132-000,2017,1,4,8,588,1631,2219,883
0132-000,2017,1,4,9,790,1430,2220,2219
0132-000,2017,1,4,10,735,843,1578,2220
0132-000,2017,1,4,11,755,771,1526,1578
0132-000,2017,1,4,12,762,762,1524,1526
0132-000,2017,1,4,13,690,697,1387,1524
0132-000,2017,1,4,14,795,750,1545,1387
0132-000,2017,1,4,15,845,809,1654,1545
0132-000,2017,1,4,16,881,758,1639,1654
0132-000,2017,1,4,17,913,796,1709,1639
0132-000,2017,1,4,18,1277,863,2140,1709
0132-000,2017,1,4,19,1430,774,2204,2140
0132-000,2017,1,4,20,926,640,1566,2204
0132-000,2017,1,4,21,736,500,1236,1566
0132-000,2017,1,4,22,553,407,960,1236
0132-000,2017,1,4,23,354,309,663,960
0132-000,2017,1,4,24,213,209,422,663
0132-000,2017,1,5,1,151,149,300,422
0132-000,2017,1,5,2,104,95,199,300
0132-000,2017,1,5,3,65,100,165,199
0132-000,2017,1,5,4,66,85,151,165
0132-000,2017,1,5,5,92,94,186,151
0132-000,2017,1,5,6,216,155,371,186
0132-000,2017,1,5,7,386,461,847,371
0132-000,2017,1,5,8,560,1638,2198,847
0132-000,2017,1,5,9,798,1449,2247,2198
0132-000,2017,1,5,10,754,870,1624,2247
0132-000,2017,1,5,11,739,795,1534,1624
0132-000,2017,1,5,12,689,875,1564,1534
0132-000,2017,1,5,13,704,668,1372,1564
0132-000,2017,1,5,14,808,786,1594,1372
0132-000,2017,1,5,15,836,776,1612,1594
0132-000,2017,1,5,16,863,741,1604,1612
0132-000,2017,1,5,17,920,833,1753,1604
0132-000,2017,1,5,18,1239,848,2087,1753
0132-000,2017,1,5,19,1358,767,2125,2087
0132-000,2017,1,5,20,870,613,1483,2125
0132-000,2017,1,5,21,785,487,1272,1483
0132-000,2017,1,5,22,552,404,956,1272
0132-000,2017,1,5,23,382,311,693,956
0132-000,2017,1,5,24,214,213,427,693
0132-000,2017,1,6,1,164,152,316,427
0132-000,2017,1,6,2,114,110,224,316
0132-000,2017,1,6,3,77,96,173,224
0132-000,2017,1,6,4,66,84,150,173
0132-000,2017,1,6,5,91,108,199,150
0132-000,2017,1,6,6,232,161,393,199
0132-000,2017,1,6,7,365,464,829,393
0132-000,2017,1,6,8,604,1607,2211,829
0132-000,2017,1,6,9,788,1452,2240,2211
0132-000,2017,1,6,10,753,858,1611,2240
0132-000,2017,1,6,11,739,813,1552,1611
0132-000,2017,1,6,12,793,783,1576,1552
0132-000,2017,1,6,13,697,716,1413,1576
0132-000,2017,1,6,14,797,774,1571,1413
0132-000,2017,1,6,15,866,816,1682,1571
0132-000,2017,1,6,16,904,828,1732,1682
0132-000,2017,1,6,17,969,751,1720,1732
0132-000,2017,1,6,18,1362,888,2250,1720
0132-000,2017,1,6,19,1676,862,2538,2250
0132-000,2017,1,6,20,1045,771,1816,2538
0132-000,2017,1,6,21,873,613,1486,1816
0132-000,2017,1,6,22,623,511,1134,1486
0132-000,2017,1,6,23,410,375,785,1134
0132-000,2017,1,6,24,247,238,485,785
0132-000,2017,1,7,1,207,200,407,485
0132-000,2017,1,7,2,148,153,301,407
0132-000,2017,1,7,3,109,111,220,301
0132-000,2017,1,7,4,81,122,203,220
0132-000,2017,1,7,5,95,114,209,203
0132-000,2017,1,7,6,194,135,329,209
0132-000,2017,1,7,7,301,336,637,329
0132-000,2017,1,7,8,443,706,1149,637
0132-000,2017,1,7,9,588,881,1469,1149
0132-000,2017,1,7,10,656,824,1480,1469
0132-000,2017,1,7,11,768,864,1632,1480
0132-000,2017,1,7,12,765,874,1639,1632
0132-000,2017,1,7,13,794,782,1576,1639
0132-000,2017,1,7,14,825,815,1640,1576
0132-000,2017,1,7,15,880,858,1738,1640
0132-000,2017,1,7,16,908,885,1793,1738
0132-000,2017,1,7,17,1012,964,1976,1793
0132-000,2017,1,7,18,1276,931,2207,1976
0132-000,2017,1,7,19,1097,763,1860,2207
0132-000,2017,1,7,20,653,572,1225,1860
0132-000,2017,1,7,21,504,447,951,1225
0132-000,2017,1,7,22,416,389,805,951
0132-000,2017,1,7,23,326,304,630,805
0132-000,2017,1,7,24,220,223,443,630
0132-000,2017,1,8,1,157,171,328,443
0132-000,2017,1,8,2,101,126,227,328
0132-000,2017,1,8,3,97,106,203,227
0132-000,2017,1,8,4,89,92,181,203
0132-000,2017,1,8,5,82,95,177,181
0132-000,2017,1,8,6,133,106,239,177
0132-000,2017,1,8,7,163,179,342,239
0132-000,2017,1,8,8,214,288,502,342
0132-000,2017,1,8,9,348,452,800,502
0132-000,2017,1,8,10,401,519,920,800
0132-000,2017,1,8,11,512,564,1076,920
0132-000,2017,1,8,12,542,614,1156,1076
0132-000,2017,1,8,13,667,681,1348,1156
0132-000,2017,1,8,14,689,716,1405,1348
0132-000,2017,1,8,15,791,699,1490,1405
0132-000,2017,1,8,16,788,665,1453,1490
0132-000,2017,1,8,17,863,676,1539,1453
0132-000,2017,1,8,18,871,646,1517,1539
0132-000,2017,1,8,19,855,531,1386,1517
0132-000,2017,1,8,20,564,457,1021,1386
0132-000,2017,1,8,21,449,405,854,1021
0132-000,2017,1,8,22,352,327,679,854
0132-000,2017,1,8,23,234,258,492,679
0132-000,2017,1,8,24,171,174,345,492
0132-000,2017,1,9,1,106,132,238,345
0132-000,2017,1,9,2,66,79,145,238
0132-000,2017,1,9,3,46,62,108,145
0132-000,2017,1,9,4,54,67,121,108
0132-000,2017,1,9,5,82,82,164,121
0132-000,2017,1,9,6,258,169,427,164
0132-000,2017,1,9,7,424,581,1005,427
0132-000,2017,1,9,8,634,1739,2373,1005
0132-000,2017,1,9,9,798,1482,2280,2373
0132-000,2017,1,9,10,699,841,1540,2280
0132-000,2017,1,9,11,764,807,1571,1540
0132-000,2017,1,9,12,761,781,1542,1571
0132-000,2017,1,9,13,712,733,1445,1542
0132-000,2017,1,9,14,774,755,1529,1445
0132-000,2017,1,9,15,830,803,1633,1529
0132-000,2017,1,9,16,864,782,1646,1633
0132-000,2017,1,9,17,895,832,1727,1646
0132-000,2017,1,9,18,1243,881,2124,1727
0132-000,2017,1,9,19,1345,797,2142,2124
0132-000,2017,1,9,20,893,653,1546,2142
0132-000,2017,1,9,21,793,490,1283,1546
0132-000,2017,1,9,22,610,412,1022,1283
0132-000,2017,1,9,23,345,311,656,1022
0132-000,2017,1,9,24,207,190,397,656
0132-000,2017,1,10,1,136,132,268,397
0132-000,2017,1,10,2,90,82,172,268
0132-000,2017,1,10,3,68,80,148,172
0132-000,2017,1,10,4,58,81,139,148
0132-000,2017,1,10,5,86,101,187,139
0132-000,2017,1,10,6,227,168,395,187
0132-000,2017,1,10,7,395,494,889,395
0132-000,2017,1,10,8,603,1692,2295,889
0132-000,2017,1,10,9,811,1459,2270,2295
0132-000,2017,1,10,10,773,854,1627,2270
0132-000,2017,1,10,11,721,770,1491,1627
0132-000,2017,1,10,12,755,793,1548,1491
0132-000,2017,1,10,13,750,713,1463,1548
0132-000,2017,1,10,14,809,736,1545,1463
0132-000,2017,1,10,15,803,765,1568,1545
0132-000,2017,1,10,16,892,775,1667,1568
0132-000,2017,1,10,17,932,827,1759,1667
0132-000,2017,1,10,18,1187,806,1993,1759
0132-000,2017,1,10,19,1295,760,2055,1993
0132-000,2017,1,10,20,876,595,1471,2055
0132-000,2017,1,10,21,799,497,1296,1471
0132-000,2017,1,10,22,603,444,1047,1296
0132-000,2017,1,10,23,360,305,665,1047
0132-000,2017,1,10,24,214,211,425,665
0132-000,2017,1,11,1,160,149,309,425
0132-000,2017,1,11,2,104,106,210,309
0132-000,2017,1,11,3,71,89,160,210
0132-000,2017,1,11,4,69,84,153,160
0132-000,2017,1,11,5,91,107,198,153
0132-000,2017,1,11,6,227,154,381,198
0132-000,2017,1,11,7,414,493,907,381
0132-000,2017,1,11,8,615,1652,2267,907
0132-000,2017,1,11,9,825,1454,2279,2267
0132-000,2017,1,11,10,757,842,1599,2279
0132-000,2017,1,11,11,740,795,1535,1599
0132-000,2017,1,11,12,753,745,1498,1535
0132-000,2017,1,11,13,719,686,1405,1498
0132-000,2017,1,11,14,755,762,1517,1405
0132-000,2017,1,11,15,822,782,1604,1517
0132-000,2017,1,11,16,835,783,1618,1604
0132-000,2017,1,11,17,910,759,1669,1618
0132-000,2017,1,11,18,1249,854,2103,1669
0132-000,2017,1,11,19,1363,739,2102,2103
0132-000,2017,1,11,20,875,629,1504,2102
0132-000,2017,1,11,21,739,503,1242,1504
0132-000,2017,1,11,22,555,407,962,1242
0132-000,2017,1,11,23,351,349,700,962
0132-000,2017,1,11,24,213,204,417,700
0132-000,2017,1,12,1,157,149,306,417
0132-000,2017,1,12,2,96,90,186,306
0132-000,2017,1,12,3,87,89,176,186
0132-000,2017,1,12,4,69,87,156,176
0132-000,2017,1,12,5,78,100,178,156
0132-000,2017,1,12,6,214,153,367,178
0132-000,2017,1,12,7,387,481,868,367
0132-000,2017,1,12,8,610,1631,2241,868
0132-000,2017,1,12,9,803,1385,2188,2241
0132-000,2017,1,12,10,719,908,1627,2188
0132-000,2017,1,12,11,701,922,1623,1627
0132-000,2017,1,12,12,789,849,1638,1623
0132-000,2017,1,12,13,817,714,1531,1638
0132-000,2017,1,12,14,952,739,1691,1531
0132-000,2017,1,12,15,886,793,1679,1691
0132-000,2017,1,12,16,866,755,1621,1679
0132-000,2017,1,12,17,914,788,1702,1621
0132-000,2017,1,12,18,1207,853,2060,1702
0132-000,2017,1,12,19,1306,772,2078,2060
0132-000,2017,1,12,20,859,624,1483,2078
0132-000,2017,1,12,21,778,492,1270,1483
0132-000,2017,1,12,22,589,405,994,1270
0132-000,2017,1,12,23,394,316,710,994
0132-000,2017,1,12,24,231,238,469,710
0132-000,2017,1,13,1,165,137,302,469
0132-000,2017,1,13,2,98,107,205,302
0132-000,2017,1,13,3,77,102,179,205
0132-000,2017,1,13,4,71,92,163,179
0132-000,2017,1,13,5,96,101,197,163
0132-000,2017,1,13,6,200,163,363,197
0132-000,2017,1,13,7,357,456,813,363
0132-000,2017,1,13,8,585,1608,2193,813
0132-000,2017,1,13,9,811,1393,2204,2193
0132-000,2017,1,13,10,730,841,1571,2204
0132-000,2017,1,13,11,731,830,1561,1571
0132-000,2017,1,13,12,754,743,1497,1561
0132-000,2017,1,13,13,781,748,1529,1497
0132-000,2017,1,13,14,814,757,1571,1529
0132-000,2017,1,13,15,831,792,1623,1571
0132-000,2017,1,13,16,920,783,1703,1623
0132-000,2017,1,13,17,993,799,1792,1703
0132-000,2017,1,13,18,1340,861,2201,1792
0132-000,2017,1,13,19,1582,806,2388,2201
0132-000,2017,1,13,20,943,714,1657,2388
0132-000,2017,1,13,21,768,547,1315,1657
0132-000,2017,1,13,22,618,462,1080,1315
0132-000,2017,1,13,23,377,360,737,1080
0132-000,2017,1,13,24,259,281,540,737
0132-000,2017,1,14,1,190,192,382,540
0132-000,2017,1,14,2,155,150,305,382
0132-000,2017,1,14,3,100,123,223,305
0132-000,2017,1,14,4,85,122,207,223
0132-000,2017,1,14,5,118,101,219,207
0132-000,2017,1,14,6,192,152,344,219
0132-000,2017,1,14,7,301,311,612,344
0132-000,2017,1,14,8,454,711,1165,612
0132-000,2017,1,14,9,597,858,1455,1165
0132-000,2017,1,14,10,695,889,1584,1455
0132-000,2017,1,14,11,815,902,1717,1584
0132-000,2017,1,14,12,873,958,1831,1717
0132-000,2017,1,14,13,1012,860,1872,1831
0132-000,2017,1,14,14,952,896,1848,1872
0132-000,2017,1,14,15,878,892,1770,1848
0132-000,2017,1,14,16,947,883,1830,1770
0132-000,2017,1,14,17,1012,921,1933,1830
0132-000,2017,1,14,18,1285,978,2263,1933
0132-000,2017,1,14,19,1062,810,1872,2263
0132-000,2017,1,14,20,679,572,1251,1872
0132-000,2017,1,14,21,513,469,982,1251
0132-000,2017,1,14,22,470,413,883,982
0132-000,2017,1,14,23,322,336,658,883
0132-000,2017,1,14,24,250,267,517,658
0132-000,2017,1,15,1,169,192,361,517
0132-000,2017,1,15,2,129,141,270,361
0132-000,2017,1,15,3,110,120,230,270
0132-000,2017,1,15,4,82,87,169,230
0132-000,2017,1,15,5,80,84,164,169
0132-000,2017,1,15,6,120,107,227,164
0132-000,2017,1,15,7,161,157,318,227
0132-000,2017,1,15,8,228,320,548,318
0132-000,2017,1,15,9,319,415,734,548
0132-000,2017,1,15,10,422,536,958,734
0132-000,2017,1,15,11,528,576,1104,958
0132-000,2017,1,15,12,567,613,1180,1104
0132-000,2017,1,15,13,649,654,1303,1180
0132-000,2017,1,15,14,685,668,1353,1303
0132-000,2017,1,15,15,776,746,1522,1353
0132-000,2017,1,15,16,786,754,1540,1522
0132-000,2017,1,15,17,900,691,1591,1540
0132-000,2017,1,15,18,998,760,1758,1591
0132-000,2017,1,15,19,848,565,1413,1758
0132-000,2017,1,15,20,622,451,1073,1413
0132-000,2017,1,15,21,477,408,885,1073
0132-000,2017,1,15,22,380,366,746,885
0132-000,2017,1,15,23,249,270,519,746
0132-000,2017,1,15,24,183,196,379,519
0132-000,2017,1,16,1,111,129,240,379
0132-000,2017,1,16,2,66,92,158,240
0132-000,2017,1,16,3,48,68,116,158
0132-000,2017,1,16,4,47,64,111,116
0132-000,2017,1,16,5,90,75,165,111
0132-000,2017,1,16,6,233,171,404,165
0132-000,2017,1,16,7,394,529,923,404
0132-000,2017,1,16,8,599,1720,2319,923
0132-000,2017,1,16,9,786,1468,2254,2319
0132-000,2017,1,16,10,699,868,1567,2254
0132-000,2017,1,16,11,758,809,1567,1567
0132-000,2017,1,16,12,774,764,1538,1567
0132-000,2017,1,16,13,725,696,1421,1538
0132-000,2017,1,16,14,786,821,1607,1421
0132-000,2017,1,16,15,829,803,1632,1607
0132-000,2017,1,16,16,875,759,1634,1632
0132-000,2017,1,16,17,888,782,1670,1634
0132-000,2017,1,16,18,1215,803,2018,1670
0132-000,2017,1,16,19,1328,730,2058,2018
0132-000,2017,1,16,20,824,694,1518,2058
0132-000,2017,1,16,21,790,527,1317,1518
0132-000,2017,1,16,22,578,409,987,1317
0132-000,2017,1,16,23,340,293,633,987
0132-000,2017,1,16,24,199,186,385,633
0132-000,2017,1,17,1,135,139,274,385
0132-000,2017,1,17,2,104,87,191,274
0132-000,2017,1,17,3,67,90,157,191
0132-000,2017,1,17,4,78,81,159,157
0132-000,2017,1,17,5,93,92,185,159
0132-000,2017,1,17,6,223,155,378,185
0132-000,2017,1,17,7,382,470,852,378
0132-000,2017,1,17,8,590,1622,2212,852
0132-000,2017,1,17,9,820,1476,2296,2212
0132-000,2017,1,17,10,747,827,1574,2296
0132-000,2017,1,17,11,707,794,1501,1574
0132-000,2017,1,17,12,735,803,1538,1501
0132-000,2017,1,17,13,757,761,1518,1538
0132-000,2017,1,17,14,776,750,1526,1518
0132-000,2017,1,17,15,835,766,1601,1526
0132-000,2017,1,17,16,854,728,1582,1601
0132-000,2017,1,17,17,908,743,1651,1582
0132-000,2017,1,17,18,1214,837,2051,1651
0132-000,2017,1,17,19,1357,790,2147,2051
0132-000,2017,1,17,20,898,656,1554,2147
0132-000,2017,1,17,21,809,514,1323,1554
0132-000,2017,1,17,22,586,443,1029,1323
0132-000,2017,1,17,23,390,331,721,1029
0132-000,2017,1,17,24,243,226,469,721
0132-000,2017,1,18,1,149,163,312,469
0132-000,2017,1,18,2,91,101,192,312
0132-000,2017,1,18,3,76,108,184,192
0132-000,2017,1,18,4,73,85,158,184
0132-000,2017,1,18,5,97,101,198,158
0132-000,2017,1,18,6,233,158,391,198
0132-000,2017,1,18,7,403,491,894,391
0132-000,2017,1,18,8,588,1684,2272,894
0132-000,2017,1,18,9,817,1445,2262,2272
0132-000,2017,1,18,10,741,880,1621,2262
0132-000,2017,1,18,11,782,824,1606,1621
0132-000,2017,1,18,12,790,781,1571,1606
0132-000,2017,1,18,13,762,729,1491,1571
0132-000,2017,1,18,14,804,777,1581,1491
0132-000,2017,1,18,15,839,816,1655,1581
0132-000,2017,1,18,16,900,812,1712,1655
0132-000,2017,1,18,17,924,805,1729,1712
0132-000,2017,1,18,18,1279,813,2092,1729
0132-000,2017,1,18,19,1395,773,2168,2092
0132-000,2017,1,18,20,911,627,1538,2168
0132-000,2017,1,18,21,748,469,1217,1538
0132-000,2017,1,18,22,532,405,937,1217
0132-000,2017,1,18,23,379,347,726,937
0132-000,2017,1,18,24,212,204,416,726
0132-000,2017,1,19,1,171,156,327,416
0132-000,2017,1,19,2,108,117,225,327
0132-000,2017,1,19,3,72,98,170,225
0132-000,2017,1,19,4,79,88,167,170
0132-000,2017,1,19,5,94,110,204,167
0132-000,2017,1,19,6,201,152,353,204
0132-000,2017,1,19,7,342,467,809,353
0132-000,2017,1,19,8,573,1610,2183,809
0132-000,2017,1,19,9,772,1415,2187,2183
0132-000,2017,1,19,10,734,845,1579,2187
0132-000,2017,1,19,11,720,800,1520,1579
0132-000,2017,1,19,12,747,802,1549,1520
0132-000,2017,1,19,13,780,731,1511,1549
0132-000,2017,1,19,14,806,753,1559,1511
0132-000,2017,1,19,15,820,824,1644,1559
0132-000,2017,1,19,16,868,742,1610,1644
0132-000,2017,1,19,17,877,740,1617,1610
0132-000,2017,1,19,18,1207,789,1996,1617
0132-000,2017,1,19,19,1325,733,2058,1996
0132-000,2017,1,19,20,862,595,1457,2058
0132-000,2017,1,19,21,784,462,1246,1457
0132-000,2017,1,19,22,534,413,947,1246
0132-000,2017,1,19,23,364,339,703,947
0132-000,2017,1,19,24,238,209,447,703
0132-000,2017,1,20,1,171,158,329,447
0132-000,2017,1,20,2,117,116,233,329
0132-000,2017,1,20,3,74,95,169,233
0132-000,2017,1,20,4,74,85,159,169
0132-000,2017,1,20,5,100,100,200,159
0132-000,2017,1,20,6,201,144,345,200
0132-000,2017,1,20,7,338,454,792,345
0132-000,2017,1,20,8,594,1561,2155,792
0132-000,2017,1,20,9,775,1384,2159,2155
0132-000,2017,1,20,10,675,882,1557,2159
0132-000,2017,1,20,11,679,848,1527,1557
0132-000,2017,1,20,12,723,792,1515,1527
0132-000,2017,1,20,13,686,719,1405,1515
0132-000,2017,1,20,14,796,737,1533,1405
0132-000,2017,1,20,15,867,757,1624,1533
0132-000,2017,1,20,16,827,740,1567,1624
0132-000,2017,1,20,17,905,723,1628,1567
0132-000,2017,1,20,18,1263,792,2055,1628
0132-000,2017,1,20,19,1495,774,2269,2055
0132-000,2017,1,20,20,906,662,1568,2269
0132-000,2017,1,20,21,738,504,1242,1568
0132-000,2017,1,20,22,536,430,966,1242
0132-000,2017,1,20,23,397,355,752,966
0132-000,2017,1,20,24,241,254,495,752
0132-000,2017,1,21,1,169,180,349,495
0132-000,2017,1,21,2,120,121,241,349
0132-000,2017,1,21,3,76,100,176,241
0132-000,2017,1,21,4,69,89,158,176
0132-000,2017,1,21,5,86,106,192,158
0132-000,2017,1,21,6,165,146,311,192
0132-000,2017,1,21,7,262,262,524,311
0132-000,2017,1,21,8,407,636,1043,524
0132-000,2017,1,21,9,664,834,1498,1043
0132-000,2017,1,21,10,606,760,1366,1498
0132-000,2017,1,21,11,666,806,1472,1366
0132-000,2017,1,21,12,718,816,1534,1472
0132-000,2017,1,21,13,786,816,1602,1534
0132-000,2017,1,21,14,792,818,1610,1602
0132-000,2017,1,21,15,870,857,1727,1610
0132-000,2017,1,21,16,901,845,1746,1727
0132-000,2017,1,21,17,1012,843,1855,1746
0132-000,2017,1,21,18,1164,807,1971,1855
0132-000,2017,1,21,19,1032,737,1769,1971
0132-000,2017,1,21,20,598,559,1157,1769
0132-000,2017,1,21,21,499,412,911,1157
0132-000,2017,1,21,22,361,313,674,911
0132-000,2017,1,21,23,243,225,468,674
0132-000,2017,1,21,24,132,173,305,468
0132-000,2017,1,22,1,109,127,236,305
0132-000,2017,1,22,2,82,105,187,236
0132-000,2017,1,22,3,68,74,142,187
0132-000,2017,1,22,4,52,66,118,142
0132-000,2017,1,22,5,53,51,104,118
0132-000,2017,1,22,6,86,68,154,104
0132-000,2017,1,22,7,119,125,244,154
0132-000,2017,1,22,8,156,232,388,244
0132-000,2017,1,22,9,247,343,590,388
0132-000,2017,1,22,10,331,397,728,590
0132-000,2017,1,22,11,404,410,814,728
0132-000,2017,1,22,12,406,500,906,814
0132-000,2017,1,22,13,448,518,966,906
0132-000,2017,1,22,14,554,583,1137,966
0132-000,2017,1,22,15,617,558,1175,1137
0132-000,2017,1,22,16,640,557,1197,1175
0132-000,2017,1,22,17,676,579,1255,1197
0132-000,2017,1,22,18,713,578,1291,1255
0132-000,2017,1,22,19,625,440,1065,1291
0132-000,2017,1,22,20,462,366,828,1065
0132-000,2017,1,22,21,356,345,701,828
0132-000,2017,1,22,22,315,282,597,701
0132-000,2017,1,22,23,175,220,395,597
0132-000,2017,1,22,24,142,140,282,395
0132-000,2017,1,23,1,96,100,196,282
0132-000,2017,1,23,2,57,69,126,196
0132-000,2017,1,23,3,34,61,95,126
0132-000,2017,1,23,4,47,73,120,95
0132-000,2017,1,23,5,79,73,152,120
0132-000,2017,1,23,6,171,129,300,152
0132-000,2017,1,23,7,367,504,871,300
0132-000,2017,1,23,8,540,1643,2183,871
0132-000,2017,1,23,9,716,1427,2143,2183
0132-000,2017,1,23,10,718,806,1524,2143
0132-000,2017,1,23,11,730,787,1517,1524
0132-000,2017,1,23,12,736,797,1533,1517
0132-000,2017,1,23,13,800,729,1529,1533
0132-000,2017,1,23,14,806,823,1629,1529
0132-000,2017,1,23,15,940,799,1739,1629
0132-000,2017,1,23,16,853,780,1633,1739
0132-000,2017,1,23,17,937,776,1713,1633
0132-000,2017,1,23,18,1244,824,2068,1713
0132-000,2017,1,23,19,1355,753,2108,2068
0132-000,2017,1,23,20,886,664,1550,2108
0132-000,2017,1,23,21,826,492,1318,1550
0132-000,2017,1,23,22,530,366,896,1318
0132-000,2017,1,23,23,346,285,631,896
0132-000,2017,1,23,24,189,187,376,631
0132-000,2017,1,24,1,135,130,265,376
0132-000,2017,1,24,2,98,88,186,265
0132-000,2017,1,24,3,54,79,133,186
0132-000,2017,1,24,4,61,87,148,133
0132-000,2017,1,24,5,76,104,180,148
0132-000,2017,1,24,6,209,136,345,180
0132-000,2017,1,24,7,342,447,789,345
0132-000,2017,1,24,8,554,1602,2156,789
0132-000,2017,1,24,9,783,1406,2189,2156
0132-000,2017,1,24,10,715,785,1500,2189
0132-000,2017,1,24,11,739,822,1561,1500
0132-000,2017,1,24,12,847,847,1694,1561
0132-000,2017,1,24,13,743,829,1572,1694
0132-000,2017,1,24,14,883,771,1654,1572
0132-000,2017,1,24,15,866,816,1682,1654
0132-000,2017,1,24,16,943,798,1741,1682
0132-000,2017,1,24,17,946,848,1794,1741
0132-000,2017,1,24,18,1278,848,2126,1794
0132-000,2017,1,24,19,1316,814,2130,2126
0132-000,2017,1,24,20,929,662,1591,2130
0132-000,2017,1,24,21,845,476,1321,1591
0132-000,2017,1,24,22,616,444,1060,1321
0132-000,2017,1,24,23,386,335,721,1060
0132-000,2017,1,24,24,242,206,448,721
0132-000,2017,1,25,1,171,179,350,448
0132-000,2017,1,25,2,122,93,215,350
0132-000,2017,1,25,3,71,95,166,215
0132-000,2017,1,25,4,65,102,167,166
0132-000,2017,1,25,5,94,111,205,167
0132-000,2017,1,25,6,187,122,309,205
0132-000,2017,1,25,7,356,454,810,309
0132-000,2017,1,25,8,554,1564,2118,810
0132-000,2017,1,25,9,817,1385,2202,2118
0132-000,2017,1,25,10,754,868,1622,2202
0132-000,2017,1,25,11,805,876,1681,1622
0132-000,2017,1,25,12,775,880,1655,1681
0132-000,2017,1,25,13,796,767,1563,1655
0132-000,2017,1,25,14,906,833,1739,1563
0132-000,2017,1,25,15,919,928,1847,1739
0132-000,2017,1,25,16,1063,911,1974,1847
0132-000,2017,1,25,17,1076,858,1934,1974
0132-000,2017,1,25,18,1412,985,2397,1934
0132-000,2017,1,25,19,1497,845,2342,2397
0132-000,2017,1,25,20,948,749,1697,2342
0132-000,2017,1,25,21,788,575,1363,1697
0132-000,2017,1,25,22,581,443,1024,1363
0132-000,2017,1,25,23,450,404,854,1024
0132-000,2017,1,25,24,264,244,508,854
0132-000,2017,1,26,1,173,178,351,508
0132-000,2017,1,26,2,140,114,254,351
0132-000,2017,1,26,3,78,114,192,254
0132-000,2017,1,26,4,77,84,161,192
0132-000,2017,1,26,5,88,102,190,161
0132-000,2017,1,26,6,169,138,307,190
0132-000,2017,1,26,7,276,416,692,307
0132-000,2017,1,26,8,578,1470,2048,692
0132-000,2017,1,26,9,721,1331,2052,2048
0132-000,2017,1,26,10,699,830,1529,2052
0132-000,2017,1,26,11,791,873,1664,1529
0132-000,2017,1,26,12,831,1000,1831,1664
0132-000,2017,1,26,13,874,1033,1907,1831
0132-000,2017,1,26,14,865,1184,2049,1907
0132-000,2017,1,26,15,972,1440,2412,2049
0132-000,2017,1,26,16,1173,1433,2606,2412
0132-000,2017,1,26,17,1253,1485,2738,2606
0132-000,2017,1,26,18,1486,1562,3048,2738
0132-000,2017,1,26,19,1217,1575,2792,3048
0132-000,2017,1,26,20,714,1588,2302,2792
0132-000,2017,1,26,21,536,1113,1649,2302
0132-000,2017,1,26,22,454,718,1172,1649
0132-000,2017,1,26,23,279,519,798,1172
0132-000,2017,1,26,24,230,488,718,798
0132-000,2017,1,27,1,179,378,557,718
0132-000,2017,1,27,2,114,299,413,557
0132-000,2017,1,27,3,99,250,349,413
0132-000,2017,1,27,4,87,258,345,349
0132-000,2017,1,27,5,63,266,329,345
0132-000,2017,1,27,6,105,256,361,329
0132-000,2017,1,27,7,104,476,580,361
0132-000,2017,1,27,8,161,843,1004,580
0132-000,2017,1,27,9,281,753,1034,1004
0132-000,2017,1,27,10,383,876,1259,1034
0132-000,2017,1,27,11,575,875,1450,1259
0132-000,2017,1,27,12,606,884,1490,1450
0132-000,2017,1,27,13,593,894,1487,1490
0132-000,2017,1,27,14,626,874,1500,1487
0132-000,2017,1,27,15,593,770,1363,1500
0132-000,2017,1,27,16,550,711,1261,1363
0132-000,2017,1,27,17,549,664,1213,1261
0132-000,2017,1,27,18,553,542,1095,1213
0132-000,2017,1,27,19,485,473,958,1095
0132-000,2017,1,27,20,393,357,750,958
0132-000,2017,1,27,21,345,302,647,750
0132-000,2017,1,27,22,263,265,528,647
0132-000,2017,1,27,23,180,198,378,528
0132-000,2017,1,27,24,129,156,285,378
0132-000,2017,1,28,1,94,98,192,285
0132-000,2017,1,28,2,61,78,139,192
0132-000,2017,1,28,3,39,55,94,139
0132-000,2017,1,28,4,36,40,76,94
0132-000,2017,1,28,5,32,49,81,76
0132-000,2017,1,28,6,74,86,160,81
0132-000,2017,1,28,7,167,254,421,160
0132-000,2017,1,28,8,318,542,860,421
0132-000,2017,1,28,9,376,506,882,860
0132-000,2017,1,28,10,406,487,893,882
0132-000,2017,1,28,11,755,775,1530,893
0132-000,2017,1,28,12,1123,1048,2171,1530
0132-000,2017,1,28,13,1351,1116,2467,2171
0132-000,2017,1,28,14,1748,1063,2811,2467
0132-000,2017,1,28,15,1718,1196,2914,2811
0132-000,2017,1,28,16,1858,1072,2930,2914
0132-000,2017,1,28,17,2029,1045,3074,2930
0132-000,2017,1,28,18,2030,749,2779,3074
0132-000,2017,1,28,19,1661,522,2183,2779
0132-000,2017,1,28,20,1462,410,1872,2183
0132-000,2017,1,28,21,925,375,1300,1872
0132-000,2017,1,28,22,616,294,910,1300
0132-000,2017,1,28,23,353,248,601,910
0132-000,2017,1,28,24,231,167,398,601
0132-000,2017,1,29,1,155,108,263,398
0132-000,2017,1,29,2,107,84,191,263
0132-000,2017,1,29,3,88,61,149,191
0132-000,2017,1,29,4,45,37,82,149
0132-000,2017,1,29,5,46,41,87,82
0132-000,2017,1,29,6,62,46,108,87
0132-000,2017,1,29,7,80,61,141,108
0132-000,2017,1,29,8,146,108,254,141
0132-000,2017,1,29,9,223,190,413,254
0132-000,2017,1,29,10,315,323,638,413
0132-000,2017,1,29,11,511,396,907,638
0132-000,2017,1,29,12,648,502,1150,907
0132-000,2017,1,29,13,741,591,1332,1150
0132-000,2017,1,29,14,803,608,1411,1332
0132-000,2017,1,29,15,991,572,1563,1411
0132-000,2017,1,29,16,1076,573,1649,1563
0132-000,2017,1,29,17,1547,554,2101,1649
0132-000,2017,1,29,18,1647,520,2167,2101
0132-000,2017,1,29,19,1313,367,1680,2167
0132-000,2017,1,29,20,1215,345,1560,1680
0132-000,2017,1,29,21,1045,290,1335,1560
0132-000,2017,1,29,22,773,240,1013,1335
0132-000,2017,1,29,23,525,162,687,1013
0132-000,2017,1,29,24,301,142,443,687
0132-000,2017,1,30,1,187,125,312,443
0132-000,2017,1,30,2,129,92,221,312
0132-000,2017,1,30,3,49,61,110,221
0132-000,2017,1,30,4,65,52,117,110
0132-000,2017,1,30,5,47,60,107,117
0132-000,2017,1,30,6,48,55,103,107
0132-000,2017,1,30,7,96,105,201,103
0132-000,2017,1,30,8,164,244,408,201
0132-000,2017,1,30,9,240,301,541,408
0132-000,2017,1,30,10,316,306,622,541
0132-000,2017,1,30,11,409,382,791,622
0132-000,2017,1,30,12,482,509,991,791
0132-000,2017,1,30,13,569,573,1142,991
0132-000,2017,1,30,14,715,562,1277,1142
0132-000,2017,1,30,15,718,608,1326,1277
0132-000,2017,1,30,16,779,577,1356,1326
0132-000,2017,1,30,17,827,583,1410,1356
0132-000,2017,1,30,18,957,539,1496,1410
0132-000,2017,1,30,19,720,461,1181,1496
0132-000,2017,1,30,20,560,394,954,1181
0132-000,2017,1,30,21,445,322,767,954
0132-000,2017,1,30,22,337,278,615,767
0132-000,2017,1,30,23,228,263,491,615
0132-000,2017,1,30,24,175,180,355,491
0132-000,2017,1,31,1,125,127,252,355
0132-000,2017,1,31,2,78,83,161,252
0132-000,2017,1,31,3,70,67,137,161
0132-000,2017,1,31,4,44,49,93,137
0132-000,2017,1,31,5,56,63,119,93
0132-000,2017,1,31,6,164,130,294,119
0132-000,2017,1,31,7,251,386,637,294
0132-000,2017,1,31,8,497,1383,1880,637
0132-000,2017,1,31,9,627,1231,1858,1880
0132-000,2017,1,31,10,566,680,1246,1858
0132-000,2017,1,31,11,662,695,1357,1246
0132-000,2017,1,31,12,709,695,1404,1357
0132-000,2017,1,31,13,661,730,1391,1404
0132-000,2017,1,31,14,718,657,1375,1391
0132-000,2017,1,31,15,792,687,1479,1375
0132-000,2017,1,31,16,793,718,1511,1479
0132-000,2017,1,31,17,810,672,1482,1511
0132-000,2017,1,31,18,1086,721,1807,1482
0132-000,2017,1,31,19,1227,699,1926,1807
0132-000,2017,1,31,20,771,562,1333,1926
0132-000,2017,1,31,21,697,427,1124,1333
0132-000,2017,1,31,22,472,361,833,1124
0132-000,2017,1,31,23,284,287,571,833
0132-000,2017,1,31,24,195,176,371,571
0132-000,2017,2,1,1,126,139,265,371
0132-000,2017,2,1,2,89,110,199,265
0132-000,2017,2,1,3,62,71,133,199
0132-000,2017,2,1,4,53,75,128,133
0132-000,2017,2,1,5,75,92,167,128
0132-000,2017,2,1,6,199,173,372,167
0132-000,2017,2,1,7,367,476,843,372
0132-000,2017,2,1,8,534,1641,2175,843
0132-000,2017,2,1,9,758,1355,2113,2175
0132-000,2017,2,1,10,727,768,1495,2113
0132-000,2017,2,1,11,735,748,1483,1495
0132-000,2017,2,1,12,731,767,1498,1483
0132-000,2017,2,1,13,708,689,1397,1498
0132-000,2017,2,1,14,789,706,1495,1397
0132-000,2017,2,1,15,807,755,1562,1495
0132-000,2017,2,1,16,860,712,1572,1562
0132-000,2017,2,1,17,812,770,1582,1572
0132-000,2017,2,1,18,1177,790,1967,1582
0132-000,2017,2,1,19,1404,750,2154,1967
0132-000,2017,2,1,20,922,598,1520,2154
0132-000,2017,2,1,21,690,469,1159,1520
0132-000,2017,2,1,22,516,386,902,1159
0132-000,2017,2,1,23,328,279,607,902
0132-000,2017,2,1,24,205,206,411,607
0132-000,2017,2,2,1,143,142,285,411
0132-000,2017,2,2,2,97,92,189,285
0132-000,2017,2,2,3,60,86,146,189
0132-000,2017,2,2,4,64,86,150,146
0132-000,2017,2,2,5,81,86,167,150
0132-000,2017,2,2,6,206,142,348,167
0132-000,2017,2,2,7,354,424,778,348
0132-000,2017,2,2,8,533,1625,2158,778
0132-000,2017,2,2,9,753,1348,2101,2158
0132-000,2017,2,2,10,701,810,1511,2101
0132-000,2017,2,2,11,702,747,1449,1511
0132-000,2017,2,2,12,733,795,1528,1449
0132-000,2017,2,2,13,743,672,1415,1528
0132-000,2017,2,2,14,700,759,1459,1415
0132-000,2017,2,2,15,793,720,1513,1459
0132-000,2017,2,2,16,828,719,1547,1513
0132-000,2017,2,2,17,838,741,1579,1547
0132-000,2017,2,2,18,1137,774,1911,1579
0132-000,2017,2,2,19,1326,757,2083,1911
0132-000,2017,2,2,20,880,586,1466,2083
0132-000,2017,2,2,21,776,504,1280,1466
0132-000,2017,2,2,22,527,424,951,1280
0132-000,2017,2,2,23,359,291,650,951
0132-000,2017,2,2,24,209,193,402,650
0132-000,2017,2,3,1,158,142,300,402
0132-000,2017,2,3,2,103,99,202,300
0132-000,2017,2,3,3,74,86,160,202
0132-000,2017,2,3,4,67,79,146,160
0132-000,2017,2,3,5,85,96,181,146
0132-000,2017,2,3,6,228,171,399,181
0132-000,2017,2,3,7,350,430,780,399
0132-000,2017,2,3,8,572,1597,2169,780
0132-000,2017,2,3,9,774,1450,2224,2169
0132-000,2017,2,3,10,731,823,1554,2224
0132-000,2017,2,3,11,733,777,1510,1554
0132-000,2017,2,3,12,797,759,1556,1510
0132-000,2017,2,3,13,674,697,1371,1556
0132-000,2017,2,3,14,771,749,1520,1371
0132-000,2017,2,3,15,844,787,1631,1520
0132-000,2017,2,3,16,889,785,1674,1631
0132-000,2017,2,3,17,886,683,1569,1674
0132-000,2017,2,3,18,1320,824,2144,1569
0132-000,2017,2,3,19,1629,802,2431,2144
0132-000,2017,2,3,20,928,677,1605,2431
0132-000,2017,2,3,21,786,518,1304,1605
0132-000,2017,2,3,22,539,424,963,1304
0132-000,2017,2,3,23,395,330,725,963
0132-000,2017,2,3,24,223,206,429,725
0132-000,2017,2,4,1,220,197,417,429
0132-000,2017,2,4,2,135,147,282,417
0132-000,2017,2,4,3,99,104,203,282
0132-000,2017,2,4,4,76,124,200,203
0132-000,2017,2,4,5,88,96,184,200
0132-000,2017,2,4,6,190,121,311,184
0132-000,2017,2,4,7,302,293,595,311
0132-000,2017,2,4,8,425,692,1117,595
0132-000,2017,2,4,9,565,863,1428,1117
0132-000,2017,2,4,10,600,829,1429,1428
0132-000,2017,2,4,11,752,847,1599,1429
0132-000,2017,2,4,12,710,836,1546,1599
0132-000,2017,2,4,13,811,752,1563,1546
0132-000,2017,2,4,14,754,770,1524,1563
0132-000,2017,2,4,15,855,813,1668,1524
0132-000,2017,2,4,16,887,782,1669,1668
0132-000,2017,2,4,17,972,871,1843,1669
0132-000,2017,2,4,18,1182,862,2044,1843
0132-000,2017,2,4,19,1013,715,1728,2044
0132-000,2017,2,4,20,613,558,1171,1728
0132-000,2017,2,4,21,474,402,876,1171
0132-000,2017,2,4,22,408,357,765,876
0132-000,2017,2,4,23,286,283,569,765
0132-000,2017,2,4,24,203,187,390,569
0132-000,2017,2,5,1,139,171,310,390
0132-000,2017,2,5,2,96,107,203,310
0132-000,2017,2,5,3,85,88,173,203
0132-000,2017,2,5,4,71,83,154,173
0132-000,2017,2,5,5,67,71,138,154
0132-000,2017,2,5,6,120,82,202,138
0132-000,2017,2,5,7,146,156,302,202
0132-000,2017,2,5,8,218,245,463,302
0132-000,2017,2,5,9,315,429,744,463
0132-000,2017,2,5,10,361,465,826,744
0132-000,2017,2,5,11,458,539,997,826
0132-000,2017,2,5,12,506,594,1100,997
0132-000,2017,2,5,13,605,629,1234,1100
0132-000,2017,2,5,14,675,706,1381,1234
0132-000,2017,2,5,15,726,675,1401,1381
0132-000,2017,2,5,16,717,627,1344,1401
0132-000,2017,2,5,17,778,634,1412,1344
0132-000,2017,2,5,18,738,571,1309,1412
0132-000,2017,2,5,19,741,502,1243,1309
0132-000,2017,2,5,20,487,429,916,1243
0132-000,2017,2,5,21,405,359,764,916
0132-000,2017,2,5,22,318,287,605,764
0132-000,2017,2,5,23,236,238,474,605
0132-000,2017,2,5,24,152,159,311,474
0132-000,2017,2,6,1,106,131,237,311
0132-000,2017,2,6,2,51,72,123,237
0132-000,2017,2,6,3,46,70,116,123
0132-000,2017,2,6,4,59,64,123,116
0132-000,2017,2,6,5,73,80,153,123
0132-000,2017,2,6,6,246,155,401,153
0132-000,2017,2,6,7,395,556,951,401
0132-000,2017,2,6,8,599,1717,2316,951
0132-000,2017,2,6,9,777,1457,2234,2316
0132-000,2017,2,6,10,679,819,1498,2234
0132-000,2017,2,6,11,741,814,1555,1498
0132-000,2017,2,6,12,729,769,1498,1555
0132-000,2017,2,6,13,713,712,1425,1498
0132-000,2017,2,6,14,742,748,1490,1425
0132-000,2017,2,6,15,845,777,1622,1490
0132-000,2017,2,6,16,831,765,1596,1622
0132-000,2017,2,6,17,870,798,1668,1596
0132-000,2017,2,6,18,1181,846,2027,1668
0132-000,2017,2,6,19,1369,814,2183,2027
0132-000,2017,2,6,20,905,643,1548,2183
0132-000,2017,2,6,21,820,496,1316,1548
0132-000,2017,2,6,22,578,406,984,1316
0132-000,2017,2,6,23,352,302,654,984
0132-000,2017,2,6,24,206,172,378,654
0132-000,2017,2,7,1,130,134,264,378
0132-000,2017,2,7,2,108,81,189,264
0132-000,2017,2,7,3,74,82,156,189
0132-000,2017,2,7,4,59,89,148,156
0132-000,2017,2,7,5,84,100,184,148
0132-000,2017,2,7,6,220,158,378,184
0132-000,2017,2,7,7,380,489,869,378
0132-000,2017,2,7,8,595,1685,2280,869
0132-000,2017,2,7,9,806,1404,2210,2280
0132-000,2017,2,7,10,784,861,1645,2210
0132-000,2017,2,7,11,708,753,1461,1645
0132-000,2017,2,7,12,764,795,1559,1461
0132-000,2017,2,7,13,720,677,1397,1559
0132-000,2017,2,7,14,820,742,1562,1397
0132-000,2017,2,7,15,782,724,1506,1562
0132-000,2017,2,7,16,884,749,1633,1506
0132-000,2017,2,7,17,897,768,1665,1633
0132-000,2017,2,7,18,1115,762,1877,1665
0132-000,2017,2,7,19,1238,735,1973,1877
0132-000,2017,2,7,20,879,622,1501,1973
0132-000,2017,2,7,21,804,503,1307,1501
0132-000,2017,2,7,22,589,456,1045,1307
0132-000,2017,2,7,23,328,276,604,1045
0132-000,2017,2,7,24,210,196,406,604
0132-000,2017,2,8,1,161,154,315,406
0132-000,2017,2,8,2,96,111,207,315
0132-000,2017,2,8,3,81,93,174,207
0132-000,2017,2,8,4,71,81,152,174
0132-000,2017,2,8,5,84,88,172,152
0132-000,2017,2,8,6,206,152,358,172
0132-000,2017,2,8,7,400,477,877,358
0132-000,2017,2,8,8,593,1631,2224,877
0132-000,2017,2,8,9,823,1397,2220,2224
0132-000,2017,2,8,10,744,809,1553,2220
0132-000,2017,2,8,11,701,763,1464,1553
0132-000,2017,2,8,12,736,765,1501,1464
0132-000,2017,2,8,13,720,687,1407,1501
0132-000,2017,2,8,14,762,754,1516,1407
0132-000,2017,2,8,15,801,776,1577,1516
0132-000,2017,2,8,16,822,793,1615,1577
0132-000,2017,2,8,17,910,754,1664,1615
0132-000,2017,2,8,18,1193,847,2040,1664
0132-000,2017,2,8,19,1400,741,2141,2040
0132-000,2017,2,8,20,876,655,1531,2141
0132-000,2017,2,8,21,751,498,1249,1531
0132-000,2017,2,8,22,545,403,948,1249
0132-000,2017,2,8,23,352,368,720,948
0132-000,2017,2,8,24,213,188,401,720
0132-000,2017,2,9,1,132,149,281,401
0132-000,2017,2,9,2,108,97,205,281
0132-000,2017,2,9,3,95,87,182,205
0132-000,2017,2,9,4,62,76,138,182
0132-000,2017,2,9,5,76,95,171,138
0132-000,2017,2,9,6,192,141,333,171
0132-000,2017,2,9,7,360,465,825,333
0132-000,2017,2,9,8,609,1629,2238,825
0132-000,2017,2,9,9,791,1352,2143,2238
0132-000,2017,2,9,10,696,933,1629,2143
0132-000,2017,2,9,11,714,1060,1774,1629
0132-000,2017,2,9,12,793,888,1681,1774
0132-000,2017,2,9,13,915,718,1633,1681
0132-000,2017,2,9,14,1046,735,1781,1633
0132-000,2017,2,9,15,917,800,1717,1781
0132-000,2017,2,9,16,856,767,1623,1717
0132-000,2017,2,9,17,914,780,1694,1623
0132-000,2017,2,9,18,1218,840,2058,1694
0132-000,2017,2,9,19,1257,765,2022,2058
0132-000,2017,2,9,20,807,604,1411,2022
0132-000,2017,2,9,21,761,481,1242,1411
0132-000,2017,2,9,22,565,372,937,1242
0132-000,2017,2,9,23,368,304,672,937
0132-000,2017,2,9,24,227,226,453,672
0132-000,2017,2,10,1,150,128,278,453
0132-000,2017,2,10,2,96,110,206,278
0132-000,2017,2,10,3,74,93,167,206
0132-000,2017,2,10,4,62,86,148,167
0132-000,2017,2,10,5,87,75,162,148
0132-000,2017,2,10,6,172,150,322,162
0132-000,2017,2,10,7,341,424,765,322
0132-000,2017,2,10,8,551,1597,2148,765
0132-000,2017,2,10,9,816,1367,2183,2148
0132-000,2017,2,10,10,740,846,1586,2183
0132-000,2017,2,10,11,720,796,1516,1586
0132-000,2017,2,10,12,745,724,1469,1516
0132-000,2017,2,10,13,758,746,1504,1469
0132-000,2017,2,10,14,787,727,1514,1504
0132-000,2017,2,10,15,809,745,1554,1514
0132-000,2017,2,10,16,838,762,1600,1554
0132-000,2017,2,10,17,917,737,1654,1600
0132-000,2017,2,10,18,1310,807,2117,1654
0132-000,2017,2,10,19,1522,819,2341,2117
0132-000,2017,2,10,20,946,703,1649,2341
0132-000,2017,2,10,21,757,545,1302,1649
0132-000,2017,2,10,22,571,425,996,1302
0132-000,2017,2,10,23,342,336,678,996
0132-000,2017,2,10,24,229,263,492,678
0132-000,2017,2,11,1,171,166,337,492
0132-000,2017,2,11,2,150,156,306,337
0132-000,2017,2,11,3,109,125,234,306
0132-000,2017,2,11,4,84,132,216,234
0132-000,2017,2,11,5,104,96,200,216
0132-000,2017,2,11,6,182,135,317,200
0132-000,2017,2,11,7,298,280,578,317
0132-000,2017,2,11,8,405,705,1110,578
0132-000,2017,2,11,9,552,838,1390,1110
0132-000,2017,2,11,10,675,906,1581,1390
0132-000,2017,2,11,11,748,888,1636,1581
0132-000,2017,2,11,12,825,975,1800,1636
0132-000,2017,2,11,13,900,858,1758,1800
0132-000,2017,2,11,14,895,799,1694,1758
0132-000,2017,2,11,15,844,830,1674,1694
0132-000,2017,2,11,16,910,833,1743,1674
0132-000,2017,2,11,17,910,817,1727,1743
0132-000,2017,2,11,18,1214,934,2148,1727
0132-000,2017,2,11,19,1012,728,1740,2148
0132-000,2017,2,11,20,667,522,1189,1740
0132-000,2017,2,11,21,466,443,909,1189
0132-000,2017,2,11,22,446,408,854,909
0132-000,2017,2,11,23,289,294,583,854
0132-000,2017,2,11,24,228,225,453,583
0132-000,2017,2,12,1,161,173,334,453
0132-000,2017,2,12,2,112,124,236,334
0132-000,2017,2,12,3,87,101,188,236
0132-000,2017,2,12,4,65,79,144,188
0132-000,2017,2,12,5,69,83,152,144
0132-000,2017,2,12,6,112,95,207,152
0132-000,2017,2,12,7,126,147,273,207
0132-000,2017,2,12,8,220,297,517,273
0132-000,2017,2,12,9,285,397,682,517
0132-000,2017,2,12,10,415,503,918,682
0132-000,2017,2,12,11,513,553,1066,918
0132-000,2017,2,12,12,560,571,1131,1066
0132-000,2017,2,12,13,616,575,1191,1131
0132-000,2017,2,12,14,631,628,1259,1191
0132-000,2017,2,12,15,728,696,1424,1259
0132-000,2017,2,12,16,729,699,1428,1424
0132-000,2017,2,12,17,858,668,1526,1428
0132-000,2017,2,12,18,879,645,1524,1526
0132-000,2017,2,12,19,820,557,1377,1524
0132-000,2017,2,12,20,596,435,1031,1377
0132-000,2017,2,12,21,470,388,858,1031
0132-000,2017,2,12,22,367,365,732,858
0132-000,2017,2,12,23,250,268,518,732
0132-000,2017,2,12,24,169,192,361,518
0132-000,2017,2,13,1,113,133,246,361
0132-000,2017,2,13,2,66,93,159,246
0132-000,2017,2,13,3,47,65,112,159
0132-000,2017,2,13,4,49,56,105,112
0132-000,2017,2,13,5,81,72,153,105
0132-000,2017,2,13,6,230,167,397,153
0132-000,2017,2,13,7,382,522,904,397
0132-000,2017,2,13,8,597,1744,2341,904
0132-000,2017,2,13,9,760,1435,2195,2341
0132-000,2017,2,13,10,678,860,1538,2195
0132-000,2017,2,13,11,760,821,1581,1538
0132-000,2017,2,13,12,761,734,1495,1581
0132-000,2017,2,13,13,688,671,1359,1495
0132-000,2017,2,13,14,798,815,1613,1359
0132-000,2017,2,13,15,839,783,1622,1613
0132-000,2017,2,13,16,830,751,1581,1622
0132-000,2017,2,13,17,863,741,1604,1581
0132-000,2017,2,13,18,1196,754,1950,1604
0132-000,2017,2,13,19,1302,743,2045,1950
0132-000,2017,2,13,20,828,596,1424,2045
0132-000,2017,2,13,21,780,498,1278,1424
0132-000,2017,2,13,22,542,375,917,1278
0132-000,2017,2,13,23,339,273,612,917
0132-000,2017,2,13,24,217,182,399,612
0132-000,2017,2,14,1,136,140,276,399
0132-000,2017,2,14,2,97,85,182,276
0132-000,2017,2,14,3,61,88,149,182
0132-000,2017,2,14,4,77,76,153,149
0132-000,2017,2,14,5,86,82,168,153
0132-000,2017,2,14,6,208,152,360,168
0132-000,2017,2,14,7,357,433,790,360
0132-000,2017,2,14,8,574,1591,2165,790
0132-000,2017,2,14,9,812,1450,2262,2165
0132-000,2017,2,14,10,742,827,1569,2262
0132-000,2017,2,14,11,686,771,1457,1569
0132-000,2017,2,14,12,724,787,1511,1457
0132-000,2017,2,14,13,744,714,1458,1511
0132-000,2017,2,14,14,767,755,1522,1458
0132-000,2017,2,14,15,777,765,1542,1522
0132-000,2017,2,14,16,851,693,1544,1542
0132-000,2017,2,14,17,892,712,1604,1544
0132-000,2017,2,14,18,1162,811,1973,1604
0132-000,2017,2,14,19,1306,827,2133,1973
0132-000,2017,2,14,20,909,649,1558,2133
0132-000,2017,2,14,21,847,499,1346,1558
0132-000,2017,2,14,22,552,433,985,1346
0132-000,2017,2,14,23,377,312,689,985
0132-000,2017,2,14,24,248,216,464,689
0132-000,2017,2,15,1,137,163,300,464
0132-000,2017,2,15,2,94,88,182,300
0132-000,2017,2,15,3,87,105,192,182
0132-000,2017,2,15,4,62,95,157,192
0132-000,2017,2,15,5,83,90,173,157
0132-000,2017,2,15,6,222,127,349,173
0132-000,2017,2,15,7,369,462,831,349
0132-000,2017,2,15,8,592,1676,2268,831
0132-000,2017,2,15,9,816,1418,2234,2268
0132-000,2017,2,15,10,729,867,1596,2234
0132-000,2017,2,15,11,775,802,1577,1596
0132-000,2017,2,15,12,795,736,1531,1577
0132-000,2017,2,15,13,706,737,1443,1531
0132-000,2017,2,15,14,789,797,1586,1443
0132-000,2017,2,15,15,816,796,1612,1586
0132-000,2017,2,15,16,878,797,1675,1612
0132-000,2017,2,15,17,863,765,1628,1675
0132-000,2017,2,15,18,1303,818,2121,1628
0132-000,2017,2,15,19,1426,841,2267,2121
0132-000,2017,2,15,20,896,633,1529,2267
0132-000,2017,2,15,21,759,480,1239,1529
0132-000,2017,2,15,22,522,392,914,1239
0132-000,2017,2,15,23,389,329,718,914
0132-000,2017,2,15,24,214,189,403,718
0132-000,2017,2,16,1,161,157,318,403
0132-000,2017,2,16,2,104,110,214,318
0132-000,2017,2,16,3,69,94,163,214
0132-000,2017,2,16,4,82,89,171,163
0132-000,2017,2,16,5,95,105,200,171
0132-000,2017,2,16,6,212,155,367,200
0132-000,2017,2,16,7,327,486,813,367
0132-000,2017,2,16,8,598,1669,2267,813
0132-000,2017,2,16,9,813,1436,2249,2267
0132-000,2017,2,16,10,733,879,1612,2249
0132-000,2017,2,16,11,743,801,1544,1612
0132-000,2017,2,16,12,743,797,1540,1544
0132-000,2017,2,16,13,872,750,1622,1540
0132-000,2017,2,16,14,811,786,1597,1622
0132-000,2017,2,16,15,852,757,1609,1597
0132-000,2017,2,16,16,884,781,1665,1609
0132-000,2017,2,16,17,921,775,1696,1665
0132-000,2017,2,16,18,1255,847,2102,1696
0132-000,2017,2,16,19,1333,759,2092,2102
0132-000,2017,2,16,20,901,618,1519,2092
0132-000,2017,2,16,21,822,512,1334,1519
0132-000,2017,2,16,22,569,401,970,1334
0132-000,2017,2,16,23,343,318,661,970
0132-000,2017,2,16,24,243,190,433,661
0132-000,2017,2,17,1,168,159,327,433
0132-000,2017,2,17,2,111,93,204,327
0132-000,2017,2,17,3,67,96,163,204
0132-000,2017,2,17,4,65,72,137,163
0132-000,2017,2,17,5,100,107,207,137
0132-000,2017,2,17,6,200,136,336,207
0132-000,2017,2,17,7,334,483,817,336
0132-000,2017,2,17,8,607,1601,2208,817
0132-000,2017,2,17,9,795,1461,2256,2208
0132-000,2017,2,17,10,744,885,1629,2256
0132-000,2017,2,17,11,692,802,1494,1629
0132-000,2017,2,17,12,733,757,1490,1494
0132-000,2017,2,17,13,717,720,1437,1490
0132-000,2017,2,17,14,787,743,1530,1437
0132-000,2017,2,17,15,838,795,1633,1530
0132-000,2017,2,17,16,803,740,1543,1633
0132-000,2017,2,17,17,886,683,1569,1543
0132-000,2017,2,17,18,1289,802,2091,1569
0132-000,2017,2,17,19,1571,772,2343,2091
0132-000,2017,2,17,20,942,697,1639,2343
0132-000,2017,2,17,21,736,527,1263,1639
0132-000,2017,2,17,22,527,409,936,1263
0132-000,2017,2,17,23,386,344,730,936
0132-000,2017,2,17,24,243,220,463,730
0132-000,2017,2,18,1,189,217,406,463
0132-000,2017,2,18,2,128,127,255,406
0132-000,2017,2,18,3,108,115,223,255
0132-000,2017,2,18,4,70,100,170,223
0132-000,2017,2,18,5,106,112,218,170
0132-000,2017,2,18,6,188,134,322,218
0132-000,2017,2,18,7,295,332,627,322
0132-000,2017,2,18,8,441,686,1127,627
0132-000,2017,2,18,9,598,870,1468,1127
0132-000,2017,2,18,10,692,827,1519,1468
0132-000,2017,2,18,11,720,829,1549,1519
0132-000,2017,2,18,12,764,889,1653,1549
0132-000,2017,2,18,13,819,784,1603,1653
0132-000,2017,2,18,14,761,820,1581,1603
0132-000,2017,2,18,15,817,847,1664,1581
0132-000,2017,2,18,16,884,854,1738,1664
0132-000,2017,2,18,17,1029,872,1901,1738
0132-000,2017,2,18,18,1205,938,2143,1901
0132-000,2017,2,18,19,1078,822,1900,2143
0132-000,2017,2,18,20,664,613,1277,1900
0132-000,2017,2,18,21,552,493,1045,1277
0132-000,2017,2,18,22,446,323,769,1045
0132-000,2017,2,18,23,313,333,646,769
0132-000,2017,2,18,24,193,219,412,646
0132-000,2017,2,19,1,167,175,342,412
0132-000,2017,2,19,2,104,122,226,342
0132-000,2017,2,19,3,104,118,222,226
0132-000,2017,2,19,4,89,101,190,222
0132-000,2017,2,19,5,74,77,151,190
0132-000,2017,2,19,6,105,84,189,151
0132-000,2017,2,19,7,158,181,339,189
0132-000,2017,2,19,8,243,285,528,339
0132-000,2017,2,19,9,344,406,750,528
0132-000,2017,2,19,10,433,526,959,750
0132-000,2017,2,19,11,490,568,1058,959
0132-000,2017,2,19,12,555,587,1142,1058
0132-000,2017,2,19,13,615,636,1251,1142
0132-000,2017,2,19,14,650,749,1399,1251
0132-000,2017,2,19,15,720,715,1435,1399
0132-000,2017,2,19,16,867,714,1581,1435
0132-000,2017,2,19,17,801,624,1425,1581
0132-000,2017,2,19,18,887,641,1528,1425
0132-000,2017,2,19,19,808,566,1374,1528
0132-000,2017,2,19,20,555,445,1000,1374
0132-000,2017,2,19,21,476,357,833,1000
0132-000,2017,2,19,22,346,297,643,833
0132-000,2017,2,19,23,260,238,498,643
0132-000,2017,2,19,24,127,146,273,498
0132-000,2017,2,20,1,102,106,208,273
0132-000,2017,2,20,2,58,76,134,208
0132-000,2017,2,20,3,56,75,131,134
0132-000,2017,2,20,4,42,66,108,131
0132-000,2017,2,20,5,101,82,183,108
0132-000,2017,2,20,6,229,163,392,183
0132-000,2017,2,20,7,394,547,941,392
0132-000,2017,2,20,8,614,1761,2375,941
0132-000,2017,2,20,9,794,1423,2217,2375
0132-000,2017,2,20,10,654,810,1464,2217
0132-000,2017,2,20,11,750,793,1543,1464
0132-000,2017,2,20,12,714,768,1482,1543
0132-000,2017,2,20,13,740,691,1431,1482
0132-000,2017,2,20,14,701,702,1403,1431
0132-000,2017,2,20,15,818,737,1555,1403
0132-000,2017,2,20,16,907,719,1626,1555
0132-000,2017,2,20,17,885,696,1581,1626
0132-000,2017,2,20,18,1158,813,1971,1581
0132-000,2017,2,20,19,1367,765,2132,1971
0132-000,2017,2,20,20,822,657,1479,2132
0132-000,2017,2,20,21,767,472,1239,1479
0132-000,2017,2,20,22,590,391,981,1239
0132-000,2017,2,20,23,338,297,635,981
0132-000,2017,2,20,24,181,171,352,635
0132-000,2017,2,21,1,146,134,280,352
0132-000,2017,2,21,2,104,115,219,280
0132-000,2017,2,21,3,75,103,178,219
0132-000,2017,2,21,4,63,90,153,178
0132-000,2017,2,21,5,94,115,209,153
0132-000,2017,2,21,6,242,170,412,209
0132-000,2017,2,21,7,346,505,851,412
0132-000,2017,2,21,8,611,1700,2311,851
0132-000,2017,2,21,9,799,1419,2218,2311
0132-000,2017,2,21,10,817,921,1738,2218
0132-000,2017,2,21,11,810,802,1612,1738
0132-000,2017,2,21,12,776,796,1572,1612
0132-000,2017,2,21,13,732,704,1436,1572
0132-000,2017,2,21,14,816,800,1616,1436
0132-000,2017,2,21,15,857,746,1603,1616
0132-000,2017,2,21,16,829,716,1545,1603
0132-000,2017,2,21,17,918,762,1680,1545
0132-000,2017,2,21,18,1289,791,2080,1680
0132-000,2017,2,21,19,1395,792,2187,2080
0132-000,2017,2,21,20,928,630,1558,2187
0132-000,2017,2,21,21,778,527,1305,1558
0132-000,2017,2,21,22,617,408,1025,1305
0132-000,2017,2,21,23,351,332,683,1025
0132-000,2017,2,21,24,244,203,447,683
0132-000,2017,2,22,1,145,148,293,447
0132-000,2017,2,22,2,99,104,203,293
0132-000,2017,2,22,3,78,100,178,203
0132-000,2017,2,22,4,69,80,149,178
0132-000,2017,2,22,5,93,91,184,149
0132-000,2017,2,22,6,189,144,333,184
0132-000,2017,2,22,7,356,443,799,333
0132-000,2017,2,22,8,604,1678,2282,799
0132-000,2017,2,22,9,798,1367,2165,2282
0132-000,2017,2,22,10,724,857,1581,2165
0132-000,2017,2,22,11,704,728,1432,1581
0132-000,2017,2,22,12,708,710,1418,1432
0132-000,2017,2,22,13,660,660,1320,1418
0132-000,2017,2,22,14,705,686,1391,1320
0132-000,2017,2,22,15,760,653,1413,1391
0132-000,2017,2,22,16,754,663,1417,1413
0132-000,2017,2,22,17,778,701,1479,1417
0132-000,2017,2,22,18,1164,729,1893,1479
0132-000,2017,2,22,19,1339,714,2053,1893
0132-000,2017,2,22,20,846,580,1426,2053
0132-000,2017,2,22,21,696,485,1181,1426
0132-000,2017,2,22,22,496,372,868,1181
0132-000,2017,2,22,23,338,334,672,868
0132-000,2017,2,22,24,209,204,413,672
0132-000,2017,2,23,1,166,154,320,413
0132-000,2017,2,23,2,111,104,215,320
0132-000,2017,2,23,3,80,82,162,215
0132-000,2017,2,23,4,59,77,136,162
0132-000,2017,2,23,5,93,103,196,136
0132-000,2017,2,23,6,208,139,347,196
0132-000,2017,2,23,7,357,457,814,347
0132-000,2017,2,23,8,562,1680,2242,814
0132-000,2017,2,23,9,812,1405,2217,2242
0132-000,2017,2,23,10,735,839,1574,2217
0132-000,2017,2,23,11,775,865,1640,1574
0132-000,2017,2,23,12,696,821,1517,1640
0132-000,2017,2,23,13,777,746,1523,1517
0132-000,2017,2,23,14,784,744,1528,1523
0132-000,2017,2,23,15,897,788,1685,1528
0132-000,2017,2,23,16,859,771,1630,1685
0132-000,2017,2,23,17,927,741,1668,1630
0132-000,2017,2,23,18,1182,851,2033,1668
0132-000,2017,2,23,19,1345,777,2122,2033
0132-000,2017,2,23,20,850,617,1467,2122
0132-000,2017,2,23,21,755,541,1296,1467
0132-000,2017,2,23,22,640,420,1060,1296
0132-000,2017,2,23,23,387,316,703,1060
0132-000,2017,2,23,24,211,211,422,703
0132-000,2017,2,24,1,181,156,337,422
0132-000,2017,2,24,2,111,112,223,337
0132-000,2017,2,24,3,77,79,156,223
0132-000,2017,2,24,4,86,89,175,156
0132-000,2017,2,24,5,84,100,184,175
0132-000,2017,2,24,6,219,162,381,184
0132-000,2017,2,24,7,384,487,871,381
0132-000,2017,2,24,8,686,1648,2334,871
0132-000,2017,2,24,9,821,1451,2272,2334
0132-000,2017,2,24,10,743,828,1571,2272
0132-000,2017,2,24,11,745,803,1548,1571
0132-000,2017,2,24,12,757,756,1513,1548
0132-000,2017,2,24,13,752,739,1491,1513
0132-000,2017,2,24,14,783,783,1566,1491
0132-000,2017,2,24,15,895,842,1737,1566
0132-000,2017,2,24,16,954,785,1739,1737
0132-000,2017,2,24,17,937,812,1749,1739
0132-000,2017,2,24,18,1318,883,2201,1749
0132-000,2017,2,24,19,1625,857,2482,2201
0132-000,2017,2,24,20,1001,703,1704,2482
0132-000,2017,2,24,21,821,588,1409,1704
0132-000,2017,2,24,22,616,474,1090,1409
0132-000,2017,2,24,23,423,356,779,1090
0132-000,2017,2,24,24,260,237,497,779
0132-000,2017,2,25,1,219,197,416,497
0132-000,2017,2,25,2,130,161,291,416
0132-000,2017,2,25,3,104,117,221,291
0132-000,2017,2,25,4,92,105,197,221
0132-000,2017,2,25,5,99,113,212,197
0132-000,2017,2,25,6,193,144,337,212
0132-000,2017,2,25,7,306,334,640,337
0132-000,2017,2,25,8,455,739,1194,640
0132-000,2017,2,25,9,639,835,1474,1194
0132-000,2017,2,25,10,689,827,1516,1474
0132-000,2017,2,25,11,722,854,1576,1516
0132-000,2017,2,25,12,870,927,1797,1576
0132-000,2017,2,25,13,994,866,1860,1797
0132-000,2017,2,25,14,849,911,1760,1860
0132-000,2017,2,25,15,915,910,1825,1760
0132-000,2017,2,25,16,985,887,1872,1825
0132-000,2017,2,25,17,1036,898,1934,1872
0132-000,2017,2,25,18,1288,967,2255,1934
0132-000,2017,2,25,19,1244,829,2073,2255
0132-000,2017,2,25,20,833,647,1480,2073
0132-000,2017,2,25,21,561,523,1084,1480
0132-000,2017,2,25,22,509,400,909,1084
0132-000,2017,2,25,23,328,304,632,909
0132-000,2017,2,25,24,230,223,453,632
0132-000,2017,2,26,1,158,169,327,453
0132-000,2017,2,26,2,125,159,284,327
0132-000,2017,2,26,3,95,93,188,284
0132-000,2017,2,26,4,75,74,149,188
0132-000,2017,2,26,5,79,76,155,149
0132-000,2017,2,26,6,134,116,250,155
0132-000,2017,2,26,7,174,193,367,250
0132-000,2017,2,26,8,246,348,594,367
0132-000,2017,2,26,9,375,485,860,594
0132-000,2017,2,26,10,451,553,1004,860
0132-000,2017,2,26,11,522,612,1134,1004
0132-000,2017,2,26,12,539,628,1167,1134
0132-000,2017,2,26,13,699,665,1364,1167
0132-000,2017,2,26,14,658,698,1356,1364
0132-000,2017,2,26,15,776,727,1503,1356
0132-000,2017,2,26,16,819,675,1494,1503
0132-000,2017,2,26,17,834,671,1505,1494
0132-000,2017,2,26,18,980,657,1637,1505
0132-000,2017,2,26,19,885,567,1452,1637
0132-000,2017,2,26,20,668,472,1140,1452
0132-000,2017,2,26,21,623,490,1113,1140
0132-000,2017,2,26,22,459,376,835,1113
0132-000,2017,2,26,23,253,288,541,835
0132-000,2017,2,26,24,206,206,412,541
0132-000,2017,2,27,1,138,127,265,412
0132-000,2017,2,27,2,48,95,143,265
0132-000,2017,2,27,3,60,67,127,143
0132-000,2017,2,27,4,46,72,118,127
0132-000,2017,2,27,5,89,63,152,118
0132-000,2017,2,27,6,239,171,410,152
0132-000,2017,2,27,7,419,533,952,410
0132-000,2017,2,27,8,641,1728,2369,952
0132-000,2017,2,27,9,794,1444,2238,2369
0132-000,2017,2,27,10,758,848,1606,2238
0132-000,2017,2,27,11,747,854,1601,1606
0132-000,2017,2,27,12,703,773,1476,1601
0132-000,2017,2,27,13,721,736,1457,1476
0132-000,2017,2,27,14,780,800,1580,1457
0132-000,2017,2,27,15,919,861,1780,1580
0132-000,2017,2,27,16,855,793,1648,1780
0132-000,2017,2,27,17,904,790,1694,1648
0132-000,2017,2,27,18,1208,882,2090,1694
0132-000,2017,2,27,19,1410,810,2220,2090
0132-000,2017,2,27,20,939,639,1578,2220
0132-000,2017,2,27,21,772,525,1297,1578
0132-000,2017,2,27,22,625,405,1030,1297
0132-000,2017,2,27,23,368,325,693,1030
0132-000,2017,2,27,24,233,191,424,693
0132-000,2017,2,28,1,149,148,297,424
0132-000,2017,2,28,2,103,95,198,297
0132-000,2017,2,28,3,70,80,150,198
0132-000,2017,2,28,4,75,95,170,150
0132-000,2017,2,28,5,112,98,210,170
0132-000,2017,2,28,6,216,138,354,210
0132-000,2017,2,28,7,373,457,830,354
0132-000,2017,2,28,8,669,1698,2367,830
0132-000,2017,2,28,9,828,1416,2244,2367
0132-000,2017,2,28,10,804,867,1671,2244
0132-000,2017,2,28,11,699,841,1540,1671
0132-000,2017,2,28,12,796,786,1582,1540
0132-000,2017,2,28,13,741,710,1451,1582
0132-000,2017,2,28,14,821,776,1597,1451
0132-000,2017,2,28,15,831,757,1588,1597
0132-000,2017,2,28,16,889,777,1666,1588
0132-000,2017,2,28,17,974,795,1769,1666
0132-000,2017,2,28,18,1293,839,2132,1769
0132-000,2017,2,28,19,1574,859,2433,2132
0132-000,2017,2,28,20,964,717,1681,2433
0132-000,2017,2,28,21,836,711,1547,1681
0132-000,2017,2,28,22,682,540,1222,1547
0132-000,2017,2,28,23,408,396,804,1222
0132-000,2017,2,28,24,262,235,497,804
0132-000,2017,3,1,1,205,177,382,497
0132-000,2017,3,1,2,128,130,258,382
0132-000,2017,3,1,3,93,130,223,258
0132-000,2017,3,1,4,103,110,213,223
0132-000,2017,3,1,5,107,111,218,213
0132-000,2017,3,1,6,219,124,343,218
0132-000,2017,3,1,7,329,345,674,343
0132-000,2017,3,1,8,420,762,1182,674
0132-000,2017,3,1,9,547,786,1333,1182
0132-000,2017,3,1,10,551,698,1249,1333
0132-000,2017,3,1,11,608,747,1355,1249
0132-000,2017,3,1,12,722,872,1594,1355
0132-000,2017,3,1,13,705,879,1584,1594
0132-000,2017,3,1,14,835,834,1669,1584
0132-000,2017,3,1,15,924,839,1763,1669
0132-000,2017,3,1,16,927,806,1733,1763
0132-000,2017,3,1,17,1090,793,1883,1733
0132-000,2017,3,1,18,1304,819,2123,1883
0132-000,2017,3,1,19,1180,651,1831,2123
0132-000,2017,3,1,20,675,573,1248,1831
0132-000,2017,3,1,21,548,440,988,1248
0132-000,2017,3,1,22,427,317,744,988
0132-000,2017,3,1,23,253,273,526,744
0132-000,2017,3,1,24,148,163,311,526
0132-000,2017,3,2,1,136,116,252,311
0132-000,2017,3,2,2,82,81,163,252
0132-000,2017,3,2,3,51,75,126,163
0132-000,2017,3,2,4,38,58,96,126
0132-000,2017,3,2,5,72,72,144,96
0132-000,2017,3,2,6,209,143,352,144
0132-000,2017,3,2,7,367,505,872,352
0132-000,2017,3,2,8,617,1714,2331,872
0132-000,2017,3,2,9,870,1529,2399,2331
0132-000,2017,3,2,10,721,870,1591,2399
0132-000,2017,3,2,11,740,765,1505,1591
0132-000,2017,3,2,12,741,774,1515,1505
0132-000,2017,3,2,13,748,735,1483,1515
0132-000,2017,3,2,14,759,789,1548,1483
0132-000,2017,3,2,15,793,744,1537,1548
0132-000,2017,3,2,16,899,743,1642,1537
0132-000,2017,3,2,17,887,786,1673,1642
0132-000,2017,3,2,18,1174,772,1946,1673
0132-000,2017,3,2,19,1384,809,2193,1946
0132-000,2017,3,2,20,929,705,1634,2193
0132-000,2017,3,2,21,811,535,1346,1634
0132-000,2017,3,2,22,611,379,990,1346
0132-000,2017,3,2,23,378,306,684,990
0132-000,2017,3,2,24,210,215,425,684
0132-000,2017,3,3,1,190,136,326,425
0132-000,2017,3,3,2,114,107,221,326
0132-000,2017,3,3,3,66,69,135,221
0132-000,2017,3,3,4,73,82,155,135
0132-000,2017,3,3,5,99,100,199,155
0132-000,2017,3,3,6,203,165,368,199
0132-000,2017,3,3,7,372,486,858,368
0132-000,2017,3,3,8,672,1706,2378,858
0132-000,2017,3,3,9,878,1506,2384,2378
0132-000,2017,3,3,10,774,863,1637,2384
0132-000,2017,3,3,11,776,816,1592,1637
0132-000,2017,3,3,12,752,794,1546,1592
0132-000,2017,3,3,13,744,763,1507,1546
0132-000,2017,3,3,14,835,803,1638,1507
0132-000,2017,3,3,15,887,760,1647,1638
0132-000,2017,3,3,16,868,807,1675,1647
0132-000,2017,3,3,17,1027,802,1829,1675
0132-000,2017,3,3,18,1319,932,2251,1829
0132-000,2017,3,3,19,1588,868,2456,2251
0132-000,2017,3,3,20,1015,709,1724,2456
0132-000,2017,3,3,21,862,545,1407,1724
0132-000,2017,3,3,22,570,439,1009,1407
0132-000,2017,3,3,23,381,344,725,1009
0132-000,2017,3,3,24,217,268,485,725
0132-000,2017,3,4,1,228,195,423,485
0132-000,2017,3,4,2,125,138,263,423
0132-000,2017,3,4,3,106,128,234,263
0132-000,2017,3,4,4,91,98,189,234
0132-000,2017,3,4,5,95,123,218,189
0132-000,2017,3,4,6,219,147,366,218
0132-000,2017,3,4,7,313,322,635,366
0132-000,2017,3,4,8,495,781,1276,635
0132-000,2017,3,4,9,578,897,1475,1276
0132-000,2017,3,4,10,702,794,1496,1475
0132-000,2017,3,4,11,675,816,1491,1496
0132-000,2017,3,4,12,785,921,1706,1491
0132-000,2017,3,4,13,825,836,1661,1706
0132-000,2017,3,4,14,818,803,1621,1661
0132-000,2017,3,4,15,840,797,1637,1621
0132-000,2017,3,4,16,887,873,1760,1637
0132-000,2017,3,4,17,944,838,1782,1760
0132-000,2017,3,4,18,1214,950,2164,1782
0132-000,2017,3,4,19,1076,812,1888,2164
0132-000,2017,3,4,20,694,571,1265,1888
0132-000,2017,3,4,21,532,462,994,1265
0132-000,2017,3,4,22,429,378,807,994
0132-000,2017,3,4,23,340,299,639,807
0132-000,2017,3,4,24,197,250,447,639
0132-000,2017,3,5,1,165,168,333,447
0132-000,2017,3,5,2,105,112,217,333
0132-000,2017,3,5,3,83,99,182,217
0132-000,2017,3,5,4,82,76,158,182
0132-000,2017,3,5,5,65,88,153,158
0132-000,2017,3,5,6,130,109,239,153
0132-000,2017,3,5,7,193,160,353,239
0132-000,2017,3,5,8,246,361,607,353
0132-000,2017,3,5,9,370,580,950,607
0132-000,2017,3,5,10,430,549,979,950
0132-000,2017,3,5,11,492,638,1130,979
0132-000,2017,3,5,12,604,708,1312,1130
0132-000,2017,3,5,13,655,692,1347,1312
0132-000,2017,3,5,14,706,628,1334,1347
0132-000,2017,3,5,15,791,713,1504,1334
0132-000,2017,3,5,16,852,734,1586,1504
0132-000,2017,3,5,17,898,727,1625,1586
0132-000,2017,3,5,18,986,712,1698,1625
0132-000,2017,3,5,19,854,621,1475,1698
0132-000,2017,3,5,20,646,546,1192,1475
0132-000,2017,3,5,21,524,457,981,1192
0132-000,2017,3,5,22,433,386,819,981
0132-000,2017,3,5,23,253,230,483,819
0132-000,2017,3,5,24,148,170,318,483
0132-000,2017,3,6,1,101,110,211,318
0132-000,2017,3,6,2,68,85,153,211
0132-000,2017,3,6,3,52,76,128,153
0132-000,2017,3,6,4,49,57,106,128
0132-000,2017,3,6,5,86,75,161,106
0132-000,2017,3,6,6,226,163,389,161
0132-000,2017,3,6,7,469,564,1033,389
0132-000,2017,3,6,8,722,1833,2555,1033
0132-000,2017,3,6,9,802,1595,2397,2555
0132-000,2017,3,6,10,782,891,1673,2397
0132-000,2017,3,6,11,801,845,1646,1673
0132-000,2017,3,6,12,784,838,1622,1646
0132-000,2017,3,6,13,729,806,1535,1622
0132-000,2017,3,6,14,799,801,1600,1535
0132-000,2017,3,6,15,854,852,1706,1600
0132-000,2017,3,6,16,894,736,1630,1706
0132-000,2017,3,6,17,867,733,1600,1630
0132-000,2017,3,6,18,1172,796,1968,1600
0132-000,2017,3,6,19,1393,836,2229,1968
0132-000,2017,3,6,20,900,626,1526,2229
0132-000,2017,3,6,21,855,524,1379,1526
0132-000,2017,3,6,22,609,401,1010,1379
0132-000,2017,3,6,23,345,268,613,1010
0132-000,2017,3,6,24,205,178,383,613
0132-000,2017,3,7,1,154,147,301,383
0132-000,2017,3,7,2,83,72,155,301
0132-000,2017,3,7,3,66,81,147,155
0132-000,2017,3,7,4,52,83,135,147
0132-000,2017,3,7,5,80,95,175,135
0132-000,2017,3,7,6,225,146,371,175
0132-000,2017,3,7,7,366,515,881,371
0132-000,2017,3,7,8,665,1762,2427,881
0132-000,2017,3,7,9,871,1556,2427,2427
0132-000,2017,3,7,10,767,914,1681,2427
0132-000,2017,3,7,11,814,845,1659,1681
0132-000,2017,3,7,12,737,774,1511,1659
0132-000,2017,3,7,13,745,677,1422,1511
0132-000,2017,3,7,14,744,778,1522,1422
0132-000,2017,3,7,15,846,797,1643,1522
0132-000,2017,3,7,16,775,749,1524,1643
0132-000,2017,3,7,17,901,734,1635,1524
0132-000,2017,3,7,18,1152,843,1995,1635
0132-000,2017,3,7,19,1387,796,2183,1995
0132-000,2017,3,7,20,921,712,1633,2183
0132-000,2017,3,7,21,879,498,1377,1633
0132-000,2017,3,7,22,607,426,1033,1377
0132-000,2017,3,7,23,353,297,650,1033
0132-000,2017,3,7,24,228,215,443,650
0132-000,2017,3,8,1,166,140,306,443
0132-000,2017,3,8,2,94,94,188,306
0132-000,2017,3,8,3,67,85,152,188
0132-000,2017,3,8,4,73,77,150,152
0132-000,2017,3,8,5,77,111,188,150
0132-000,2017,3,8,6,231,129,360,188
0132-000,2017,3,8,7,391,496,887,360
0132-000,2017,3,8,8,680,1741,2421,887
0132-000,2017,3,8,9,790,1560,2350,2421
0132-000,2017,3,8,10,790,886,1676,2350
0132-000,2017,3,8,11,752,784,1536,1676
0132-000,2017,3,8,12,748,765,1513,1536
0132-000,2017,3,8,13,747,738,1485,1513
0132-000,2017,3,8,14,795,819,1614,1485
0132-000,2017,3,8,15,854,766,1620,1614
0132-000,2017,3,8,16,862,725,1587,1620
0132-000,2017,3,8,17,882,764,1646,1587
0132-000,2017,3,8,18,1285,893,2178,1646
0132-000,2017,3,8,19,1443,794,2237,2178
0132-000,2017,3,8,20,895,654,1549,2237
0132-000,2017,3,8,21,767,510,1277,1549
0132-000,2017,3,8,22,572,439,1011,1277
0132-000,2017,3,8,23,357,299,656,1011
0132-000,2017,3,8,24,240,199,439,656
0132-000,2017,3,9,1,170,137,307,439
0132-000,2017,3,9,2,103,117,220,307
0132-000,2017,3,9,3,69,83,152,220
0132-000,2017,3,9,4,70,92,162,152
0132-000,2017,3,9,5,92,98,190,162
0132-000,2017,3,9,6,222,141,363,190
0132-000,2017,3,9,7,437,494,931,363
0132-000,2017,3,9,8,648,1748,2396,931
0132-000,2017,3,9,9,812,1580,2392,2396
0132-000,2017,3,9,10,749,884,1633,2392
0132-000,2017,3,9,11,746,826,1572,1633
0132-000,2017,3,9,12,769,759,1528,1572
0132-000,2017,3,9,13,707,689,1396,1528
0132-000,2017,3,9,14,765,755,1520,1396
0132-000,2017,3,9,15,789,756,1545,1520
0132-000,2017,3,9,16,809,693,1502,1545
0132-000,2017,3,9,17,848,721,1569,1502
0132-000,2017,3,9,18,1240,812,2052,1569
0132-000,2017,3,9,19,1382,772,2154,2052
0132-000,2017,3,9,20,957,684,1641,2154
0132-000,2017,3,9,21,864,525,1389,1641
0132-000,2017,3,9,22,646,400,1046,1389
0132-000,2017,3,9,23,371,339,710,1046
0132-000,2017,3,9,24,247,204,451,710
0132-000,2017,3,10,1,136,143,279,451
0132-000,2017,3,10,2,98,114,212,279
0132-000,2017,3,10,3,55,79,134,212
0132-000,2017,3,10,4,82,93,175,134
0132-000,2017,3,10,5,75,110,185,175
0132-000,2017,3,10,6,228,166,394,185
0132-000,2017,3,10,7,403,512,915,394
0132-000,2017,3,10,8,686,1748,2434,915
0132-000,2017,3,10,9,803,1503,2306,2434
0132-000,2017,3,10,10,785,873,1658,2306
0132-000,2017,3,10,11,736,834,1570,1658
0132-000,2017,3,10,12,696,774,1470,1570
0132-000,2017,3,10,13,765,693,1458,1470
0132-000,2017,3,10,14,767,762,1529,1458
0132-000,2017,3,10,15,839,764,1603,1529
0132-000,2017,3,10,16,944,700,1644,1603
0132-000,2017,3,10,17,1000,807,1807,1644
0132-000,2017,3,10,18,1270,930,2200,1807
0132-000,2017,3,10,19,1731,899,2630,2200
0132-000,2017,3,10,20,956,798,1754,2630
0132-000,2017,3,10,21,862,564,1426,1754
0132-000,2017,3,10,22,617,445,1062,1426
0132-000,2017,3,10,23,378,383,761,1062
0132-000,2017,3,10,24,218,272,490,761
0132-000,2017,3,11,1,205,213,418,490
0132-000,2017,3,11,2,145,166,311,418
0132-000,2017,3,11,3,103,128,231,311
0132-000,2017,3,11,4,95,101,196,231
0132-000,2017,3,11,5,108,103,211,196
0132-000,2017,3,11,6,214,165,379,211
0132-000,2017,3,11,7,335,351,686,379
0132-000,2017,3,11,8,506,813,1319,686
0132-000,2017,3,11,9,621,1005,1626,1319
0132-000,2017,3,11,10,688,853,1541,1626
0132-000,2017,3,11,11,771,841,1612,1541
0132-000,2017,3,11,12,796,907,1703,1612
0132-000,2017,3,11,13,825,821,1646,1703
0132-000,2017,3,11,14,807,846,1653,1646
0132-000,2017,3,11,15,863,894,1757,1653
0132-000,2017,3,11,16,906,881,1787,1757
0132-000,2017,3,11,17,987,890,1877,1787
0132-000,2017,3,11,18,1384,1007,2391,1877
0132-000,2017,3,11,19,1224,879,2103,2391
0132-000,2017,3,11,20,818,648,1466,2103
0132-000,2017,3,11,21,540,482,1022,1466
0132-000,2017,3,11,22,427,409,836,1022
0132-000,2017,3,11,23,325,284,609,836
0132-000,2017,3,11,24,229,210,439,609
0132-000,2017,3,12,1,168,168,336,439
0132-000,2017,3,12,2,126,146,272,336
0132-000,2017,3,12,3,90,85,175,272
0132-000,2017,3,12,4,62,95,157,175
0132-000,2017,3,12,5,72,79,151,157
0132-000,2017,3,12,6,128,115,243,151
0132-000,2017,3,12,7,209,193,402,243
0132-000,2017,3,12,8,273,324,597,402
0132-000,2017,3,12,9,382,507,889,597
0132-000,2017,3,12,10,409,573,982,889
0132-000,2017,3,12,11,482,632,1114,982
0132-000,2017,3,12,12,565,597,1162,1114
0132-000,2017,3,12,13,621,687,1308,1162
0132-000,2017,3,12,14,712,662,1374,1308
0132-000,2017,3,12,15,809,677,1486,1374
0132-000,2017,3,12,16,788,677,1465,1486
0132-000,2017,3,12,17,973,689,1662,1465
0132-000,2017,3,12,18,1098,703,1801,1662
0132-000,2017,3,12,19,982,609,1591,1801
0132-000,2017,3,12,20,625,474,1099,1591
0132-000,2017,3,12,21,582,449,1031,1099
0132-000,2017,3,12,22,390,422,812,1031
0132-000,2017,3,12,23,221,248,469,812
0132-000,2017,3,12,24,180,186,366,469
0132-000,2017,3,13,1,140,105,245,366
0132-000,2017,3,13,2,58,82,140,245
0132-000,2017,3,13,3,39,82,121,140
0132-000,2017,3,13,4,43,58,101,121
0132-000,2017,3,13,5,87,69,156,101
0132-000,2017,3,13,6,253,179,432,156
0132-000,2017,3,13,7,445,587,1032,432
0132-000,2017,3,13,8,695,1869,2564,1032
0132-000,2017,3,13,9,819,1488,2307,2564
0132-000,2017,3,13,10,792,852,1644,2307
0132-000,2017,3,13,11,725,841,1566,1644
0132-000,2017,3,13,12,727,793,1520,1566
0132-000,2017,3,13,13,729,736,1465,1520
0132-000,2017,3,13,14,774,738,1512,1465
0132-000,2017,3,13,15,810,800,1610,1512
0132-000,2017,3,13,16,880,756,1636,1610
0132-000,2017,3,13,17,926,859,1785,1636
0132-000,2017,3,13,18,1224,913,2137,1785
0132-000,2017,3,13,19,1432,809,2241,2137
0132-000,2017,3,13,20,992,760,1752,2241
0132-000,2017,3,13,21,876,541,1417,1752
0132-000,2017,3,13,22,665,407,1072,1417
0132-000,2017,3,13,23,331,268,599,1072
0132-000,2017,3,13,24,253,205,458,599
0132-000,2017,3,14,1,163,135,298,458
0132-000,2017,3,14,2,115,107,222,298
0132-000,2017,3,14,3,55,92,147,222
0132-000,2017,3,14,4,74,78,152,147
0132-000,2017,3,14,5,89,98,187,152
0132-000,2017,3,14,6,256,159,415,187
0132-000,2017,3,14,7,421,546,967,415
0132-000,2017,3,14,8,658,1754,2412,967
0132-000,2017,3,14,9,866,1551,2417,2412
0132-000,2017,3,14,10,787,903,1690,2417
0132-000,2017,3,14,11,807,855,1662,1690
0132-000,2017,3,14,12,774,800,1574,1662
0132-000,2017,3,14,13,739,743,1482,1574
0132-000,2017,3,14,14,800,788,1588,1482
0132-000,2017,3,14,15,888,821,1709,1588
0132-000,2017,3,14,16,871,721,1592,1709
0132-000,2017,3,14,17,930,808,1738,1592
0132-000,2017,3,14,18,1216,903,2119,1738
0132-000,2017,3,14,19,1440,800,2240,2119
0132-000,2017,3,14,20,976,655,1631,2240
0132-000,2017,3,14,21,825,575,1400,1631
0132-000,2017,3,14,22,617,446,1063,1400
0132-000,2017,3,14,23,382,345,727,1063
0132-000,2017,3,14,24,202,207,409,727
0132-000,2017,3,15,1,161,140,301,409
0132-000,2017,3,15,2,98,103,201,301
0132-000,2017,3,15,3,64,94,158,201
0132-000,2017,3,15,4,64,74,138,158
0132-000,2017,3,15,5,108,100,208,138
0132-000,2017,3,15,6,215,153,368,208
0132-000,2017,3,15,7,425,519,944,368
0132-000,2017,3,15,8,658,1720,2378,944
0132-000,2017,3,15,9,846,1524,2370,2378
0132-000,2017,3,15,10,734,888,1622,2370
0132-000,2017,3,15,11,791,773,1564,1622
0132-000,2017,3,15,12,764,780,1544,1564
0132-000,2017,3,15,13,740,697,1437,1544
0132-000,2017,3,15,14,774,746,1520,1437
0132-000,2017,3,15,15,830,777,1607,1520
0132-000,2017,3,15,16,887,801,1688,1607
0132-000,2017,3,15,17,893,783,1676,1688
0132-000,2017,3,15,18,1377,938,2315,1676
0132-000,2017,3,15,19,1447,825,2272,2315
0132-000,2017,3,15,20,1013,712,1725,2272
0132-000,2017,3,15,21,828,524,1352,1725
0132-000,2017,3,15,22,596,427,1023,1352
0132-000,2017,3,15,23,325,341,666,1023
0132-000,2017,3,15,24,257,205,462,666
0132-000,2017,3,16,1,175,156,331,462
0132-000,2017,3,16,2,126,98,224,331
0132-000,2017,3,16,3,81,85,166,224
0132-000,2017,3,16,4,84,92,176,166
0132-000,2017,3,16,5,95,94,189,176
0132-000,2017,3,16,6,235,183,418,189
0132-000,2017,3,16,7,404,546,950,418
0132-000,2017,3,16,8,666,1759,2425,950
0132-000,2017,3,16,9,827,1574,2401,2425
0132-000,2017,3,16,10,791,913,1704,2401
0132-000,2017,3,16,11,693,767,1460,1704
0132-000,2017,3,16,12,786,783,1569,1460
0132-000,2017,3,16,13,722,721,1443,1569
0132-000,2017,3,16,14,800,715,1515,1443
0132-000,2017,3,16,15,842,749,1591,1515
0132-000,2017,3,16,16,854,786,1640,1591
0132-000,2017,3,16,17,960,749,1709,1640
0132-000,2017,3,16,18,1239,889,2128,1709
0132-000,2017,3,16,19,1482,854,2336,2128
0132-000,2017,3,16,20,887,655,1542,2336
0132-000,2017,3,16,21,898,572,1470,1542
0132-000,2017,3,16,22,618,422,1040,1470
0132-000,2017,3,16,23,410,293,703,1040
0132-000,2017,3,16,24,228,224,452,703
0132-000,2017,3,17,1,194,164,358,452
0132-000,2017,3,17,2,105,107,212,358
0132-000,2017,3,17,3,71,101,172,212
0132-000,2017,3,17,4,75,86,161,172
0132-000,2017,3,17,5,99,105,204,161
0132-000,2017,3,17,6,211,168,379,204
0132-000,2017,3,17,7,403,537,940,379
0132-000,2017,3,17,8,644,1737,2381,940
0132-000,2017,3,17,9,922,1452,2374,2381
0132-000,2017,3,17,10,776,937,1713,2374
0132-000,2017,3,17,11,771,845,1616,1713
0132-000,2017,3,17,12,792,789,1581,1616
0132-000,2017,3,17,13,790,725,1515,1581
0132-000,2017,3,17,14,823,815,1638,1515
0132-000,2017,3,17,15,875,815,1690,1638
0132-000,2017,3,17,16,944,789,1733,1690
0132-000,2017,3,17,17,1015,820,1835,1733
0132-000,2017,3,17,18,1364,963,2327,1835
0132-000,2017,3,17,19,1607,921,2528,2327
0132-000,2017,3,17,20,999,787,1786,2528
0132-000,2017,3,17,21,785,586,1371,1786
0132-000,2017,3,17,22,650,475,1125,1371
0132-000,2017,3,17,23,403,313,716,1125
0132-000,2017,3,17,24,260,218,478,716
0132-000,2017,3,18,1,212,219,431,478
0132-000,2017,3,18,2,143,152,295,431
0132-000,2017,3,18,3,91,120,211,295
0132-000,2017,3,18,4,94,96,190,211
0132-000,2017,3,18,5,92,119,211,190
0132-000,2017,3,18,6,232,156,388,211
0132-000,2017,3,18,7,332,408,740,388
0132-000,2017,3,18,8,540,778,1318,740
0132-000,2017,3,18,9,679,994,1673,1318
0132-000,2017,3,18,10,779,1003,1782,1673
0132-000,2017,3,18,11,759,878,1637,1782
0132-000,2017,3,18,12,822,885,1707,1637
0132-000,2017,3,18,13,886,896,1782,1707
0132-000,2017,3,18,14,874,881,1755,1782
0132-000,2017,3,18,15,880,977,1857,1755
0132-000,2017,3,18,16,924,886,1810,1857
0132-000,2017,3,18,17,1073,885,1958,1810
0132-000,2017,3,18,18,1280,1027,2307,1958
0132-000,2017,3,18,19,1245,879,2124,2307
0132-000,2017,3,18,20,814,653,1467,2124
0132-000,2017,3,18,21,542,523,1065,1467
0132-000,2017,3,18,22,468,424,892,1065
0132-000,2017,3,18,23,322,330,652,892
0132-000,2017,3,18,24,235,235,470,652
0132-000,2017,3,19,1,156,206,362,470
0132-000,2017,3,19,2,114,116,230,362
0132-000,2017,3,19,3,95,95,190,230
0132-000,2017,3,19,4,67,82,149,190
0132-000,2017,3,19,5,88,83,171,149
0132-000,2017,3,19,6,122,125,247,171
0132-000,2017,3,19,7,231,197,428,247
0132-000,2017,3,19,8,253,384,637,428
0132-000,2017,3,19,9,418,538,956,637
0132-000,2017,3,19,10,475,586,1061,956
0132-000,2017,3,19,11,510,642,1152,1061
0132-000,2017,3,19,12,602,624,1226,1152
0132-000,2017,3,19,13,700,687,1387,1226
0132-000,2017,3,19,14,688,705,1393,1387
0132-000,2017,3,19,15,753,763,1516,1393
0132-000,2017,3,19,16,828,690,1518,1516
0132-000,2017,3,19,17,935,708,1643,1518
0132-000,2017,3,19,18,1061,681,1742,1643
0132-000,2017,3,19,19,980,593,1573,1742
0132-000,2017,3,19,20,675,537,1212,1573
0132-000,2017,3,19,21,544,472,1016,1212
0132-000,2017,3,19,22,454,386,840,1016
0132-000,2017,3,19,23,259,278,537,840
0132-000,2017,3,19,24,186,163,349,537
0132-000,2017,3,20,1,131,113,244,349
0132-000,2017,3,20,2,65,71,136,244
0132-000,2017,3,20,3,45,51,96,136
0132-000,2017,3,20,4,45,67,112,96
0132-000,2017,3,20,5,101,85,186,112
0132-000,2017,3,20,6,249,174,423,186
0132-000,2017,3,20,7,468,614,1082,423
0132-000,2017,3,20,8,696,1863,2559,1082
0132-000,2017,3,20,9,873,1573,2446,2559
0132-000,2017,3,20,10,733,863,1596,2446
0132-000,2017,3,20,11,787,817,1604,1596
0132-000,2017,3,20,12,765,798,1563,1604
0132-000,2017,3,20,13,723,721,1444,1563
0132-000,2017,3,20,14,775,719,1494,1444
0132-000,2017,3,20,15,787,807,1594,1494
0132-000,2017,3,20,16,872,723,1595,1594
0132-000,2017,3,20,17,880,728,1608,1595
0132-000,2017,3,20,18,1232,866,2098,1608
0132-000,2017,3,20,19,1399,792,2191,2098
0132-000,2017,3,20,20,924,692,1616,2191
0132-000,2017,3,20,21,846,521,1367,1616
0132-000,2017,3,20,22,620,403,1023,1367
0132-000,2017,3,20,23,362,309,671,1023
0132-000,2017,3,20,24,225,185,410,671
0132-000,2017,3,21,1,139,118,257,410
0132-000,2017,3,21,2,99,78,177,257
0132-000,2017,3,21,3,73,96,169,177
0132-000,2017,3,21,4,72,93,165,169
0132-000,2017,3,21,5,72,103,175,165
0132-000,2017,3,21,6,233,182,415,175
0132-000,2017,3,21,7,430,536,966,415
0132-000,2017,3,21,8,697,1836,2533,966
0132-000,2017,3,21,9,864,1556,2420,2533
0132-000,2017,3,21,10,752,933,1685,2420
0132-000,2017,3,21,11,785,846,1631,1685
0132-000,2017,3,21,12,857,869,1726,1631
0132-000,2017,3,21,13,782,817,1599,1726
0132-000,2017,3,21,14,880,776,1656,1599
0132-000,2017,3,21,15,903,764,1667,1656
0132-000,2017,3,21,16,890,788,1678,1667
0132-000,2017,3,21,17,927,811,1738,1678
0132-000,2017,3,21,18,1200,918,2118,1738
0132-000,2017,3,21,19,1453,818,2271,2118
0132-000,2017,3,21,20,888,674,1562,2271
0132-000,2017,3,21,21,848,510,1358,1562
0132-000,2017,3,21,22,654,435,1089,1358
0132-000,2017,3,21,23,343,318,661,1089
0132-000,2017,3,21,24,210,192,402,661
0132-000,2017,3,22,1,171,146,317,402
0132-000,2017,3,22,2,129,82,211,317
0132-000,2017,3,22,3,73,88,161,211
0132-000,2017,3,22,4,61,90,151,161
0132-000,2017,3,22,5,104,110,214,151
0132-000,2017,3,22,6,241,173,414,214
0132-000,2017,3,22,7,454,533,987,414
0132-000,2017,3,22,8,664,1770,2434,987
0132-000,2017,3,22,9,851,1577,2428,2434
0132-000,2017,3,22,10,748,847,1595,2428
0132-000,2017,3,22,11,765,774,1539,1595
0132-000,2017,3,22,12,734,753,1487,1539
0132-000,2017,3,22,13,658,699,1357,1487
0132-000,2017,3,22,14,788,749,1537,1357
0132-000,2017,3,22,15,859,773,1632,1537
0132-000,2017,3,22,16,851,739,1590,1632
0132-000,2017,3,22,17,877,761,1638,1590
0132-000,2017,3,22,18,1329,880,2209,1638
0132-000,2017,3,22,19,1472,784,2256,2209
0132-000,2017,3,22,20,986,655,1641,2256
0132-000,2017,3,22,21,785,525,1310,1641
0132-000,2017,3,22,22,556,401,957,1310
0132-000,2017,3,22,23,370,343,713,957
0132-000,2017,3,22,24,224,197,421,713
0132-000,2017,3,23,1,162,171,333,421
0132-000,2017,3,23,2,100,105,205,333
0132-000,2017,3,23,3,75,82,157,205
0132-000,2017,3,23,4,70,98,168,157
0132-000,2017,3,23,5,91,96,187,168
0132-000,2017,3,23,6,228,165,393,187
0132-000,2017,3,23,7,440,546,986,393
0132-000,2017,3,23,8,650,1751,2401,986
0132-000,2017,3,23,9,835,1496,2331,2401
0132-000,2017,3,23,10,752,848,1600,2331
0132-000,2017,3,23,11,746,784,1530,1600
0132-000,2017,3,23,12,785,794,1579,1530
0132-000,2017,3,23,13,697,684,1381,1579
0132-000,2017,3,23,14,790,778,1568,1381
0132-000,2017,3,23,15,818,763,1581,1568
0132-000,2017,3,23,16,878,737,1615,1581
0132-000,2017,3,23,17,904,816,1720,1615
0132-000,2017,3,23,18,1208,891,2099,1720
0132-000,2017,3,23,19,1453,831,2284,2099
0132-000,2017,3,23,20,992,683,1675,2284
0132-000,2017,3,23,21,804,514,1318,1675
0132-000,2017,3,23,22,618,439,1057,1318
0132-000,2017,3,23,23,376,322,698,1057
0132-000,2017,3,23,24,270,207,477,698
0132-000,2017,3,24,1,174,157,331,477
0132-000,2017,3,24,2,101,94,195,331
0132-000,2017,3,24,3,88,96,184,195
0132-000,2017,3,24,4,84,87,171,184
0132-000,2017,3,24,5,96,112,208,171
0132-000,2017,3,24,6,217,161,378,208
0132-000,2017,3,24,7,420,509,929,378
0132-000,2017,3,24,8,686,1740,2426,929
0132-000,2017,3,24,9,873,1498,2371,2426
0132-000,2017,3,24,10,724,862,1586,2371
0132-000,2017,3,24,11,781,818,1599,1586
0132-000,2017,3,24,12,756,797,1553,1599
0132-000,2017,3,24,13,753,698,1451,1553
0132-000,2017,3,24,14,827,756,1583,1451
0132-000,2017,3,24,15,823,796,1619,1583
0132-000,2017,3,24,16,899,754,1653,1619
0132-000,2017,3,24,17,949,779,1728,1653
0132-000,2017,3,24,18,1302,1027,2329,1728
0132-000,2017,3,24,19,1767,845,2612,2329
0132-000,2017,3,24,20,1019,742,1761,2612
0132-000,2017,3,24,21,804,562,1366,1761
0132-000,2017,3,24,22,614,448,1062,1366
0132-000,2017,3,24,23,397,389,786,1062
0132-000,2017,3,24,24,237,221,458,786
0132-000,2017,3,25,1,218,203,421,458
0132-000,2017,3,25,2,166,143,309,421
0132-000,2017,3,25,3,110,127,237,309
0132-000,2017,3,25,4,82,113,195,237
0132-000,2017,3,25,5,91,105,196,195
0132-000,2017,3,25,6,194,148,342,196
0132-000,2017,3,25,7,360,397,757,342
0132-000,2017,3,25,8,479,829,1308,757
0132-000,2017,3,25,9,691,928,1619,1308
0132-000,2017,3,25,10,706,924,1630,1619
0132-000,2017,3,25,11,714,880,1594,1630
0132-000,2017,3,25,12,788,826,1614,1594
0132-000,2017,3,25,13,834,834,1668,1614
0132-000,2017,3,25,14,847,928,1775,1668
0132-000,2017,3,25,15,849,873,1722,1775
0132-000,2017,3,25,16,891,936,1827,1722
0132-000,2017,3,25,17,962,893,1855,1827
0132-000,2017,3,25,18,1352,945,2297,1855
0132-000,2017,3,25,19,1185,808,1993,2297
0132-000,2017,3,25,20,689,626,1315,1993
0132-000,2017,3,25,21,530,498,1028,1315
0132-000,2017,3,25,22,421,416,837,1028
0132-000,2017,3,25,23,347,332,679,837
0132-000,2017,3,25,24,222,218,440,679
0132-000,2017,3,26,1,150,155,305,440
0132-000,2017,3,26,2,118,130,248,305
0132-000,2017,3,26,3,80,97,177,248
0132-000,2017,3,26,4,69,68,137,177
0132-000,2017,3,26,5,66,104,170,137
0132-000,2017,3,26,6,116,102,218,170
0132-000,2017,3,26,7,220,232,452,218
0132-000,2017,3,26,8,301,423,724,452
0132-000,2017,3,26,9,379,555,934,724
0132-000,2017,3,26,10,473,608,1081,934
0132-000,2017,3,26,11,569,640,1209,1081
0132-000,2017,3,26,12,578,684,1262,1209
0132-000,2017,3,26,13,648,698,1346,1262
0132-000,2017,3,26,14,698,769,1467,1346
0132-000,2017,3,26,15,795,707,1502,1467
0132-000,2017,3,26,16,820,647,1467,1502
0132-000,2017,3,26,17,948,693,1641,1467
0132-000,2017,3,26,18,1109,701,1810,1641
0132-000,2017,3,26,19,922,598,1520,1810
0132-000,2017,3,26,20,662,529,1191,1520
0132-000,2017,3,26,21,558,455,1013,1191
0132-000,2017,3,26,22,452,353,805,1013
0132-000,2017,3,26,23,229,278,507,805
0132-000,2017,3,26,24,175,181,356,507
0132-000,2017,3,27,1,108,125,233,356
0132-000,2017,3,27,2,60,73,133,233
0132-000,2017,3,27,3,49,61,110,133
0132-000,2017,3,27,4,46,83,129,110
0132-000,2017,3,27,5,97,79,176,129
0132-000,2017,3,27,6,264,170,434,176
0132-000,2017,3,27,7,484,605,1089,434
0132-000,2017,3,27,8,679,1848,2527,1089
0132-000,2017,3,27,9,832,1471,2303,2527
0132-000,2017,3,27,10,744,906,1650,2303
0132-000,2017,3,27,11,745,801,1546,1650
0132-000,2017,3,27,12,736,753,1489,1546
0132-000,2017,3,27,13,734,736,1470,1489
0132-000,2017,3,27,14,779,726,1505,1470
0132-000,2017,3,27,15,789,757,1546,1505
0132-000,2017,3,27,16,828,754,1582,1546
0132-000,2017,3,27,17,912,754,1666,1582
0132-000,2017,3,27,18,1176,889,2065,1666
0132-000,2017,3,27,19,1371,806,2177,2065
0132-000,2017,3,27,20,923,667,1590,2177
0132-000,2017,3,27,21,850,507,1357,1590
0132-000,2017,3,27,22,587,402,989,1357
0132-000,2017,3,27,23,349,307,656,989
0132-000,2017,3,27,24,220,182,402,656
0132-000,2017,3,28,1,136,127,263,402
0132-000,2017,3,28,2,100,89,189,263
0132-000,2017,3,28,3,66,85,151,189
0132-000,2017,3,28,4,83,83,166,151
0132-000,2017,3,28,5,0,0,0,166
0132-000,2017,3,28,6,251,157,408,0
0132-000,2017,3,28,7,439,572,1011,408
0132-000,2017,3,28,8,673,1766,2439,1011
0132-000,2017,3,28,9,876,1535,2411,2439
0132-000,2017,3,28,10,798,864,1662,2411
0132-000,2017,3,28,11,692,779,1471,1662
0132-000,2017,3,28,12,773,791,1564,1471
0132-000,2017,3,28,13,722,663,1385,1564
0132-000,2017,3,28,14,821,763,1584,1385
0132-000,2017,3,28,15,811,787,1598,1584
0132-000,2017,3,28,16,784,722,1506,1598
0132-000,2017,3,28,17,987,796,1783,1506
0132-000,2017,3,28,18,1235,898,2133,1783
0132-000,2017,3,28,19,1453,812,2265,2133
0132-000,2017,3,28,20,890,636,1526,2265
0132-000,2017,3,28,21,802,486,1288,1526
0132-000,2017,3,28,22,554,406,960,1288
0132-000,2017,3,28,23,365,304,669,960
0132-000,2017,3,28,24,205,195,400,669
0132-000,2017,3,29,1,162,139,301,400
0132-000,2017,3,29,2,93,95,188,301
0132-000,2017,3,29,3,63,86,149,188
0132-000,2017,3,29,4,83,83,166,149
0132-000,2017,3,29,5,89,108,197,166
0132-000,2017,3,29,6,212,176,388,197
0132-000,2017,3,29,7,450,565,1015,388
0132-000,2017,3,29,8,660,1727,2387,1015
0132-000,2017,3,29,9,831,1494,2325,2387
0132-000,2017,3,29,10,812,886,1698,2325
0132-000,2017,3,29,11,773,764,1537,1698
0132-000,2017,3,29,12,789,776,1565,1537
0132-000,2017,3,29,13,670,739,1409,1565
0132-000,2017,3,29,14,762,727,1489,1409
0132-000,2017,3,29,15,816,769,1585,1489
0132-000,2017,3,29,16,865,763,1628,1585
0132-000,2017,3,29,17,940,789,1729,1628
0132-000,2017,3,29,18,1302,900,2202,1729
0132-000,2017,3,29,19,1496,832,2328,2202
0132-000,2017,3,29,20,924,639,1563,2328
0132-000,2017,3,29,21,785,486,1271,1563
0132-000,2017,3,29,22,613,445,1058,1271
0132-000,2017,3,29,23,350,314,664,1058
0132-000,2017,3,29,24,252,220,472,664
0132-000,2017,3,30,1,179,148,327,472
0132-000,2017,3,30,2,127,122,249,327
0132-000,2017,3,30,3,60,98,158,249
0132-000,2017,3,30,4,87,81,168,158
0132-000,2017,3,30,5,89,112,201,168
0132-000,2017,3,30,6,222,176,398,201
0132-000,2017,3,30,7,443,530,973,398
0132-000,2017,3,30,8,644,1768,2412,973
0132-000,2017,3,30,9,868,1475,2343,2412
0132-000,2017,3,30,10,749,957,1706,2343
0132-000,2017,3,30,11,765,731,1496,1706
0132-000,2017,3,30,12,720,771,1491,1496
0132-000,2017,3,30,13,744,707,1451,1491
0132-000,2017,3,30,14,775,742,1517,1451
0132-000,2017,3,30,15,782,864,1646,1517
0132-000,2017,3,30,16,882,763,1645,1646
0132-000,2017,3,30,17,987,827,1814,1645
0132-000,2017,3,30,18,1264,912,2176,1814
0132-000,2017,3,30,19,1434,818,2252,2176
0132-000,2017,3,30,20,918,646,1564,2252
0132-000,2017,3,30,21,812,579,1391,1564
0132-000,2017,3,30,22,663,401,1064,1391
0132-000,2017,3,30,23,375,345,720,1064
0132-000,2017,3,30,24,231,220,451,720
0132-000,2017,3,31,1,195,156,351,451
0132-000,2017,3,31,2,124,102,226,351
0132-000,2017,3,31,3,68,87,155,226
0132-000,2017,3,31,4,70,101,171,155
0132-000,2017,3,31,5,86,98,184,171
0132-000,2017,3,31,6,226,179,405,184
0132-000,2017,3,31,7,419,537,956,405
0132-000,2017,3,31,8,650,1690,2340,956
0132-000,2017,3,31,9,896,1471,2367,2340
0132-000,2017,3,31,10,807,879,1686,2367
0132-000,2017,3,31,11,754,846,1600,1686
0132-000,2017,3,31,12,789,728,1517,1600
0132-000,2017,3,31,13,746,691,1437,1517
0132-000,2017,3,31,14,783,736,1519,1437
0132-000,2017,3,31,15,878,787,1665,1519
0132-000,2017,3,31,16,889,746,1635,1665
0132-000,2017,3,31,17,891,816,1707,1635
0132-000,2017,3,31,18,1313,891,2204,1707
0132-000,2017,3,31,19,1593,886,2479,2204
0132-000,2017,3,31,20,989,733,1722,2479
0132-000,2017,3,31,21,767,547,1314,1722
0132-000,2017,3,31,22,610,519,1129,1314
0132-000,2017,3,31,23,388,351,739,1129
0132-000,2017,3,31,24,237,242,479,739
0132-000,2017,4,1,1,226,205,431,479
0132-000,2017,4,1,2,144,152,296,431
0132-000,2017,4,1,3,97,110,207,296
0132-000,2017,4,1,4,90,103,193,207
0132-000,2017,4,1,5,77,115,192,193
0132-000,2017,4,1,6,210,161,371,192
0132-000,2017,4,1,7,391,386,777,371
0132-000,2017,4,1,8,478,822,1300,777
0132-000,2017,4,1,9,638,958,1596,1300
0132-000,2017,4,1,10,680,868,1548,1596
0132-000,2017,4,1,11,697,943,1640,1548
0132-000,2017,4,1,12,840,945,1785,1640
0132-000,2017,4,1,13,831,1004,1835,1785
0132-000,2017,4,1,14,880,977,1857,1835
0132-000,2017,4,1,15,916,978,1894,1857
0132-000,2017,4,1,16,944,910,1854,1894
0132-000,2017,4,1,17,1008,896,1904,1854
0132-000,2017,4,1,18,1279,997,2276,1904
0132-000,2017,4,1,19,1204,875,2079,2276
0132-000,2017,4,1,20,822,651,1473,2079
0132-000,2017,4,1,21,627,526,1153,1473
0132-000,2017,4,1,22,483,405,888,1153
0132-000,2017,4,1,23,327,360,687,888
0132-000,2017,4,1,24,216,206,422,687
0132-000,2017,4,2,1,190,157,347,422
0132-000,2017,4,2,2,128,139,267,347
0132-000,2017,4,2,3,106,104,210,267
0132-000,2017,4,2,4,71,66,137,210
0132-000,2017,4,2,5,97,97,194,137
0132-000,2017,4,2,6,135,136,271,194
0132-000,2017,4,2,7,218,196,414,271
0132-000,2017,4,2,8,260,361,621,414
0132-000,2017,4,2,9,371,571,942,621
0132-000,2017,4,2,10,462,632,1094,942
0132-000,2017,4,2,11,538,621,1159,1094
0132-000,2017,4,2,12,586,646,1232,1159
0132-000,2017,4,2,13,666,647,1313,1232
0132-000,2017,4,2,14,708,714,1422,1313
0132-000,2017,4,2,15,838,719,1557,1422
0132-000,2017,4,2,16,817,733,1550,1557
0132-000,2017,4,2,17,957,820,1777,1550
0132-000,2017,4,2,18,1122,712,1834,1777
0132-000,2017,4,2,19,1105,630,1735,1834
0132-000,2017,4,2,20,857,475,1332,1735
0132-000,2017,4,2,21,712,476,1188,1332
0132-000,2017,4,2,22,534,346,880,1188
0132-000,2017,4,2,23,315,286,601,880
0132-000,2017,4,2,24,211,202,413,601
0132-000,2017,4,3,1,119,133,252,413
0132-000,2017,4,3,2,77,93,170,252
0132-000,2017,4,3,3,62,66,128,170
0132-000,2017,4,3,4,45,54,99,128
0132-000,2017,4,3,5,102,79,181,99
0132-000,2017,4,3,6,244,210,454,181
0132-000,2017,4,3,7,484,643,1127,454
0132-000,2017,4,3,8,733,1893,2626,1127
0132-000,2017,4,3,9,827,1554,2381,2626
0132-000,2017,4,3,10,753,915,1668,2381
0132-000,2017,4,3,11,751,825,1576,1668
0132-000,2017,4,3,12,726,789,1515,1576
0132-000,2017,4,3,13,717,722,1439,1515
0132-000,2017,4,3,14,817,782,1599,1439
0132-000,2017,4,3,15,841,787,1628,1599
0132-000,2017,4,3,16,889,768,1657,1628
0132-000,2017,4,3,17,952,745,1697,1657
0132-000,2017,4,3,18,1255,874,2129,1697
0132-000,2017,4,3,19,1338,876,2214,2129
0132-000,2017,4,3,20,987,655,1642,2214
0132-000,2017,4,3,21,956,566,1522,1642
0132-000,2017,4,3,22,639,447,1086,1522
0132-000,2017,4,3,23,353,334,687,1086
0132-000,2017,4,3,24,205,206,411,687
0132-000,2017,4,4,1,189,130,319,411
0132-000,2017,4,4,2,83,89,172,319
0132-000,2017,4,4,3,76,81,157,172
0132-000,2017,4,4,4,61,79,140,157
0132-000,2017,4,4,5,90,93,183,140
0132-000,2017,4,4,6,237,175,412,183
0132-000,2017,4,4,7,683,580,1263,412
0132-000,2017,4,4,8,720,1795,2515,1263
0132-000,2017,4,4,9,891,1562,2453,2515
0132-000,2017,4,4,10,784,826,1610,2453
0132-000,2017,4,4,11,769,814,1583,1610
0132-000,2017,4,4,12,725,788,1513,1583
0132-000,2017,4,4,13,669,725,1394,1513
0132-000,2017,4,4,14,849,809,1658,1394
0132-000,2017,4,4,15,836,784,1620,1658
0132-000,2017,4,4,16,920,752,1672,1620
0132-000,2017,4,4,17,923,812,1735,1672
0132-000,2017,4,4,18,1183,939,2122,1735
0132-000,2017,4,4,19,1422,881,2303,2122
0132-000,2017,4,4,20,936,696,1632,2303
0132-000,2017,4,4,21,896,528,1424,1632
0132-000,2017,4,4,22,653,413,1066,1424
0132-000,2017,4,4,23,370,330,700,1066
0132-000,2017,4,4,24,239,194,433,700
0132-000,2017,4,5,1,157,162,319,433
0132-000,2017,4,5,2,93,92,185,319
0132-000,2017,4,5,3,67,97,164,185
0132-000,2017,4,5,4,90,77,167,164
0132-000,2017,4,5,5,91,95,186,167
0132-000,2017,4,5,6,216,170,386,186
0132-000,2017,4,5,7,446,519,965,386
0132-000,2017,4,5,8,736,1713,2449,965
0132-000,2017,4,5,9,901,1482,2383,2449
0132-000,2017,4,5,10,783,909,1692,2383
0132-000,2017,4,5,11,799,756,1555,1692
0132-000,2017,4,5,12,725,767,1492,1555
0132-000,2017,4,5,13,765,733,1498,1492
0132-000,2017,4,5,14,790,777,1567,1498
0132-000,2017,4,5,15,825,754,1579,1567
0132-000,2017,4,5,16,1023,715,1738,1579
0132-000,2017,4,5,17,936,787,1723,1738
0132-000,2017,4,5,18,1200,768,1968,1723
0132-000,2017,4,5,19,1436,777,2213,1968
0132-000,2017,4,5,20,896,572,1468,2213
0132-000,2017,4,5,21,738,497,1235,1468
0132-000,2017,4,5,22,565,402,967,1235
0132-000,2017,4,5,23,381,282,663,967
0132-000,2017,4,5,24,218,176,394,663
0132-000,2017,4,6,1,173,159,332,394
0132-000,2017,4,6,2,121,121,242,332
0132-000,2017,4,6,3,64,84,148,242
0132-000,2017,4,6,4,56,84,140,148
0132-000,2017,4,6,5,91,93,184,140
0132-000,2017,4,6,6,179,163,342,184
0132-000,2017,4,6,7,404,517,921,342
0132-000,2017,4,6,8,607,1707,2314,921
0132-000,2017,4,6,9,810,1518,2328,2314
0132-000,2017,4,6,10,740,850,1590,2328
0132-000,2017,4,6,11,809,837,1646,1590
0132-000,2017,4,6,12,825,760,1585,1646
0132-000,2017,4,6,13,791,686,1477,1585
0132-000,2017,4,6,14,886,791,1677,1477
0132-000,2017,4,6,15,933,762,1695,1677
0132-000,2017,4,6,16,907,707,1614,1695
0132-000,2017,4,6,17,1016,752,1768,1614
0132-000,2017,4,6,18,1159,818,1977,1768
0132-000,2017,4,6,19,1504,798,2302,1977
0132-000,2017,4,6,20,976,636,1612,2302
0132-000,2017,4,6,21,895,498,1393,1612
0132-000,2017,4,6,22,671,447,1118,1393
0132-000,2017,4,6,23,376,330,706,1118
0132-000,2017,4,6,24,250,250,500,706
0132-000,2017,4,7,1,229,166,395,500
0132-000,2017,4,7,2,149,102,251,395
0132-000,2017,4,7,3,101,108,209,251
0132-000,2017,4,7,4,90,83,173,209
0132-000,2017,4,7,5,122,114,236,173
0132-000,2017,4,7,6,291,183,474,236
0132-000,2017,4,7,7,511,551,1062,474
0132-000,2017,4,7,8,708,1695,2403,1062
0132-000,2017,4,7,9,915,1498,2413,2403
0132-000,2017,4,7,10,864,863,1727,2413
0132-000,2017,4,7,11,858,851,1709,1727
0132-000,2017,4,7,12,1102,788,1890,1709
0132-000,2017,4,7,13,785,713,1498,1890
0132-000,2017,4,7,14,741,744,1485,1498
0132-000,2017,4,7,15,810,813,1623,1485
0132-000,2017,4,7,16,871,768,1639,1623
0132-000,2017,4,7,17,936,863,1799,1639
0132-000,2017,4,7,18,1299,923,2222,1799
0132-000,2017,4,7,19,1686,902,2588,2222
0132-000,2017,4,7,20,1031,789,1820,2588
0132-000,2017,4,7,21,915,611,1526,1820
0132-000,2017,4,7,22,638,516,1154,1526
0132-000,2017,4,7,23,419,392,811,1154
0132-000,2017,4,7,24,274,271,545,811
0132-000,2017,4,8,1,231,182,413,545
0132-000,2017,4,8,2,146,137,283,413
0132-000,2017,4,8,3,95,120,215,283
0132-000,2017,4,8,4,82,117,199,215
0132-000,2017,4,8,5,94,105,199,199
0132-000,2017,4,8,6,215,181,396,199
0132-000,2017,4,8,7,381,403,784,396
0132-000,2017,4,8,8,550,865,1415,784
0132-000,2017,4,8,9,601,967,1568,1415
0132-000,2017,4,8,10,686,914,1600,1568
0132-000,2017,4,8,11,755,1031,1786,1600
0132-000,2017,4,8,12,774,1076,1850,1786
0132-000,2017,4,8,13,769,941,1710,1850
0132-000,2017,4,8,14,788,971,1759,1710
0132-000,2017,4,8,15,824,933,1757,1759
0132-000,2017,4,8,16,880,878,1758,1757
0132-000,2017,4,8,17,973,840,1813,1758
0132-000,2017,4,8,18,1274,961,2235,1813
0132-000,2017,4,8,19,1179,863,2042,2235
0132-000,2017,4,8,20,816,582,1398,2042
0132-000,2017,4,8,21,610,491,1101,1398
0132-000,2017,4,8,22,531,394,925,1101
0132-000,2017,4,8,23,316,302,618,925
0132-000,2017,4,8,24,222,227,449,618
0132-000,2017,4,9,1,180,169,349,449
0132-000,2017,4,9,2,124,118,242,349
0132-000,2017,4,9,3,106,91,197,242
0132-000,2017,4,9,4,65,82,147,197
0132-000,2017,4,9,5,78,81,159,147
0132-000,2017,4,9,6,145,108,253,159
0132-000,2017,4,9,7,212,272,484,253
0132-000,2017,4,9,8,263,390,653,484
0132-000,2017,4,9,9,358,488,846,653
0132-000,2017,4,9,10,481,582,1063,846
0132-000,2017,4,9,11,519,634,1153,1063
0132-000,2017,4,9,12,510,658,1168,1153
0132-000,2017,4,9,13,612,654,1266,1168
0132-000,2017,4,9,14,666,687,1353,1266
0132-000,2017,4,9,15,751,624,1375,1353
0132-000,2017,4,9,16,843,682,1525,1375
0132-000,2017,4,9,17,917,616,1533,1525
0132-000,2017,4,9,18,935,668,1603,1533
0132-000,2017,4,9,19,883,583,1466,1603
0132-000,2017,4,9,20,713,489,1202,1466
0132-000,2017,4,9,21,628,432,1060,1202
0132-000,2017,4,9,22,430,392,822,1060
0132-000,2017,4,9,23,403,288,691,822
0132-000,2017,4,9,24,171,183,354,691
0132-000,2017,4,10,1,112,125,237,354
0132-000,2017,4,10,2,60,85,145,237
0132-000,2017,4,10,3,56,50,106,145
0132-000,2017,4,10,4,36,72,108,106
0132-000,2017,4,10,5,80,84,164,108
0132-000,2017,4,10,6,272,181,453,164
0132-000,2017,4,10,7,517,596,1113,453
0132-000,2017,4,10,8,678,1864,2542,1113
0132-000,2017,4,10,9,802,1535,2337,2542
0132-000,2017,4,10,10,730,872,1602,2337
0132-000,2017,4,10,11,714,834,1548,1602
0132-000,2017,4,10,12,751,841,1592,1548
0132-000,2017,4,10,13,690,730,1420,1592
0132-000,2017,4,10,14,809,821,1630,1420
0132-000,2017,4,10,15,838,780,1618,1630
0132-000,2017,4,10,16,895,760,1655,1618
0132-000,2017,4,10,17,913,831,1744,1655
0132-000,2017,4,10,18,1218,955,2173,1744
0132-000,2017,4,10,19,1466,847,2313,2173
0132-000,2017,4,10,20,998,688,1686,2313
0132-000,2017,4,10,21,846,542,1388,1686
0132-000,2017,4,10,22,708,448,1156,1388
0132-000,2017,4,10,23,366,322,688,1156
0132-000,2017,4,10,24,224,219,443,688
0132-000,2017,4,11,1,164,153,317,443
0132-000,2017,4,11,2,100,98,198,317
0132-000,2017,4,11,3,57,88,145,198
0132-000,2017,4,11,4,61,82,143,145
0132-000,2017,4,11,5,83,123,206,143
0132-000,2017,4,11,6,204,162,366,206
0132-000,2017,4,11,7,426,549,975,366
0132-000,2017,4,11,8,655,1722,2377,975
0132-000,2017,4,11,9,861,1577,2438,2377
0132-000,2017,4,11,10,778,902,1680,2438
0132-000,2017,4,11,11,718,863,1581,1680
0132-000,2017,4,11,12,827,780,1607,1581
0132-000,2017,4,11,13,668,741,1409,1607
0132-000,2017,4,11,14,830,722,1552,1409
0132-000,2017,4,11,15,811,805,1616,1552
0132-000,2017,4,11,16,835,716,1551,1616
0132-000,2017,4,11,17,877,704,1581,1551
0132-000,2017,4,11,18,1143,899,2042,1581
0132-000,2017,4,11,19,1403,815,2218,2042
0132-000,2017,4,11,20,1003,681,1684,2218
0132-000,2017,4,11,21,916,458,1374,1684
0132-000,2017,4,11,22,608,461,1069,1374
0132-000,2017,4,11,23,368,340,708,1069
0132-000,2017,4,11,24,216,219,435,708
0132-000,2017,4,12,1,168,139,307,435
0132-000,2017,4,12,2,85,116,201,307
0132-000,2017,4,12,3,65,90,155,201
0132-000,2017,4,12,4,58,63,121,155
0132-000,2017,4,12,5,94,121,215,121
0132-000,2017,4,12,6,259,168,427,215
0132-000,2017,4,12,7,509,552,1061,427
0132-000,2017,4,12,8,703,1784,2487,1061
0132-000,2017,4,12,9,803,1528,2331,2487
0132-000,2017,4,12,10,770,872,1642,2331
0132-000,2017,4,12,11,756,807,1563,1642
0132-000,2017,4,12,12,756,828,1584,1563
0132-000,2017,4,12,13,698,670,1368,1584
0132-000,2017,4,12,14,751,821,1572,1368
0132-000,2017,4,12,15,811,765,1576,1572
0132-000,2017,4,12,16,836,764,1600,1576
0132-000,2017,4,12,17,867,774,1641,1600
0132-000,2017,4,12,18,1297,890,2187,1641
0132-000,2017,4,12,19,1478,838,2316,2187
0132-000,2017,4,12,20,945,695,1640,2316
0132-000,2017,4,12,21,787,548,1335,1640
0132-000,2017,4,12,22,598,455,1053,1335
0132-000,2017,4,12,23,405,308,713,1053
0132-000,2017,4,12,24,236,229,465,713
0132-000,2017,4,13,1,187,189,376,465
0132-000,2017,4,13,2,115,98,213,376
0132-000,2017,4,13,3,74,99,173,213
0132-000,2017,4,13,4,64,86,150,173
0132-000,2017,4,13,5,92,119,211,150
0132-000,2017,4,13,6,259,174,433,211
0132-000,2017,4,13,7,454,584,1038,433
0132-000,2017,4,13,8,677,1752,2429,1038
0132-000,2017,4,13,9,876,1516,2392,2429
0132-000,2017,4,13,10,767,955,1722,2392
0132-000,2017,4,13,11,782,794,1576,1722
0132-000,2017,4,13,12,745,771,1516,1576
0132-000,2017,4,13,13,727,735,1462,1516
0132-000,2017,4,13,14,814,801,1615,1462
0132-000,2017,4,13,15,874,827,1701,1615
0132-000,2017,4,13,16,847,790,1637,1701
0132-000,2017,4,13,17,996,849,1845,1637
0132-000,2017,4,13,18,1206,997,2203,1845
0132-000,2017,4,13,19,1418,847,2265,2203
0132-000,2017,4,13,20,965,677,1642,2265
0132-000,2017,4,13,21,846,515,1361,1642
0132-000,2017,4,13,22,614,428,1042,1361
0132-000,2017,4,13,23,409,360,769,1042
0132-000,2017,4,13,24,252,229,481,769
0132-000,2017,4,14,1,182,160,342,481
0132-000,2017,4,14,2,105,123,228,342
0132-000,2017,4,14,3,67,100,167,228
0132-000,2017,4,14,4,65,83,148,167
0132-000,2017,4,14,5,93,97,190,148
0132-000,2017,4,14,6,218,155,373,190
0132-000,2017,4,14,7,483,596,1079,373
0132-000,2017,4,14,8,672,1735,2407,1079
0132-000,2017,4,14,9,888,1482,2370,2407
0132-000,2017,4,14,10,791,873,1664,2370
0132-000,2017,4,14,11,742,866,1608,1664
0132-000,2017,4,14,12,758,798,1556,1608
0132-000,2017,4,14,13,757,775,1532,1556
0132-000,2017,4,14,14,742,777,1519,1532
0132-000,2017,4,14,15,794,819,1613,1519
0132-000,2017,4,14,16,879,767,1646,1613
0132-000,2017,4,14,17,903,818,1721,1646
0132-000,2017,4,14,18,1329,933,2262,1721
0132-000,2017,4,14,19,1522,838,2360,2262
0132-000,2017,4,14,20,977,760,1737,2360
0132-000,2017,4,14,21,868,536,1404,1737
0132-000,2017,4,14,22,599,471,1070,1404
0132-000,2017,4,14,23,398,379,777,1070
0132-000,2017,4,14,24,249,257,506,777
0132-000,2017,4,15,1,206,207,413,506
0132-000,2017,4,15,2,153,152,305,413
0132-000,2017,4,15,3,92,106,198,305
0132-000,2017,4,15,4,81,114,195,198
0132-000,2017,4,15,5,98,131,229,195
0132-000,2017,4,15,6,210,158,368,229
0132-000,2017,4,15,7,403,433,836,368
0132-000,2017,4,15,8,495,855,1350,836
0132-000,2017,4,15,9,675,1003,1678,1350
0132-000,2017,4,15,10,718,951,1669,1678
0132-000,2017,4,15,11,765,854,1619,1669
0132-000,2017,4,15,12,829,929,1758,1619
0132-000,2017,4,15,13,848,893,1741,1758
0132-000,2017,4,15,14,794,931,1725,1741
0132-000,2017,4,15,15,909,964,1873,1725
0132-000,2017,4,15,16,907,879,1786,1873
0132-000,2017,4,15,17,958,918,1876,1786
0132-000,2017,4,15,18,1300,958,2258,1876
0132-000,2017,4,15,19,1159,863,2022,2258
0132-000,2017,4,15,20,761,627,1388,2022
0132-000,2017,4,15,21,611,525,1136,1388
0132-000,2017,4,15,22,440,442,882,1136
0132-000,2017,4,15,23,338,348,686,882
0132-000,2017,4,15,24,220,237,457,686
0132-000,2017,4,16,1,159,179,338,457
0132-000,2017,4,16,2,132,141,273,338
0132-000,2017,4,16,3,91,102,193,273
0132-000,2017,4,16,4,82,94,176,193
0132-000,2017,4,16,5,96,100,196,176
0132-000,2017,4,16,6,159,133,292,196
0132-000,2017,4,16,7,256,284,540,292
0132-000,2017,4,16,8,319,467,786,540
0132-000,2017,4,16,9,391,555,946,786
0132-000,2017,4,16,10,498,645,1143,946
0132-000,2017,4,16,11,604,738,1342,1143
0132-000,2017,4,16,12,632,708,1340,1342
0132-000,2017,4,16,13,650,738,1388,1340
0132-000,2017,4,16,14,743,768,1511,1388
0132-000,2017,4,16,15,854,687,1541,1511
0132-000,2017,4,16,16,863,748,1611,1541
0132-000,2017,4,16,17,992,749,1741,1611
0132-000,2017,4,16,18,1014,746,1760,1741
0132-000,2017,4,16,19,1018,589,1607,1760
0132-000,2017,4,16,20,821,522,1343,1607
0132-000,2017,4,16,21,693,513,1206,1343
0132-000,2017,4,16,22,517,408,925,1206
0132-000,2017,4,16,23,303,290,593,925
0132-000,2017,4,16,24,181,188,369,593
0132-000,2017,4,17,1,126,138,264,369
0132-000,2017,4,17,2,95,92,187,264
0132-000,2017,4,17,3,37,77,114,187
0132-000,2017,4,17,4,53,57,110,114
0132-000,2017,4,17,5,88,96,184,110
0132-000,2017,4,17,6,256,193,449,184
0132-000,2017,4,17,7,441,646,1087,449
0132-000,2017,4,17,8,713,1844,2557,1087
0132-000,2017,4,17,9,836,1529,2365,2557
0132-000,2017,4,17,10,746,889,1635,2365
0132-000,2017,4,17,11,783,801,1584,1635
0132-000,2017,4,17,12,717,755,1472,1584
0132-000,2017,4,17,13,702,757,1459,1472
0132-000,2017,4,17,14,736,740,1476,1459
0132-000,2017,4,17,15,786,754,1540,1476
0132-000,2017,4,17,16,763,728,1491,1540
0132-000,2017,4,17,17,805,767,1572,1491
0132-000,2017,4,17,18,1105,766,1871,1572
0132-000,2017,4,17,19,1367,791,2158,1871
0132-000,2017,4,17,20,894,622,1516,2158
0132-000,2017,4,17,21,809,494,1303,1516
0132-000,2017,4,17,22,637,430,1067,1303
0132-000,2017,4,17,23,326,297,623,1067
0132-000,2017,4,17,24,201,208,409,623
0132-000,2017,4,18,1,154,139,293,409
0132-000,2017,4,18,2,82,92,174,293
0132-000,2017,4,18,3,72,70,142,174
0132-000,2017,4,18,4,55,90,145,142
0132-000,2017,4,18,5,71,98,169,145
0132-000,2017,4,18,6,250,190,440,169
0132-000,2017,4,18,7,444,596,1040,440
0132-000,2017,4,18,8,733,1807,2540,1040
0132-000,2017,4,18,9,866,1565,2431,2540
0132-000,2017,4,18,10,779,887,1666,2431
0132-000,2017,4,18,11,740,753,1493,1666
0132-000,2017,4,18,12,710,783,1493,1493
0132-000,2017,4,18,13,707,762,1469,1493
0132-000,2017,4,18,14,759,743,1502,1469
0132-000,2017,4,18,15,831,797,1628,1502
0132-000,2017,4,18,16,901,759,1660,1628
0132-000,2017,4,18,17,941,775,1716,1660
0132-000,2017,4,18,18,1103,797,1900,1716
0132-000,2017,4,18,19,1324,809,2133,1900
0132-000,2017,4,18,20,851,642,1493,2133
0132-000,2017,4,18,21,786,511,1297,1493
0132-000,2017,4,18,22,593,438,1031,1297
0132-000,2017,4,18,23,348,302,650,1031
0132-000,2017,4,18,24,227,215,442,650
0132-000,2017,4,19,1,147,141,288,442
0132-000,2017,4,19,2,109,108,217,288
0132-000,2017,4,19,3,66,83,149,217
0132-000,2017,4,19,4,56,96,152,149
0132-000,2017,4,19,5,94,96,190,152
0132-000,2017,4,19,6,247,179,426,190
0132-000,2017,4,19,7,444,568,1012,426
0132-000,2017,4,19,8,717,1803,2520,1012
0132-000,2017,4,19,9,821,1510,2331,2520
0132-000,2017,4,19,10,712,833,1545,2331
0132-000,2017,4,19,11,766,801,1567,1545
0132-000,2017,4,19,12,718,767,1485,1567
0132-000,2017,4,19,13,683,709,1392,1485
0132-000,2017,4,19,14,787,781,1568,1392
0132-000,2017,4,19,15,766,751,1517,1568
0132-000,2017,4,19,16,843,808,1651,1517
0132-000,2017,4,19,17,892,795,1687,1651
0132-000,2017,4,19,18,1256,931,2187,1687
0132-000,2017,4,19,19,1444,830,2274,2187
0132-000,2017,4,19,20,993,730,1723,2274
0132-000,2017,4,19,21,787,537,1324,1723
0132-000,2017,4,19,22,619,465,1084,1324
0132-000,2017,4,19,23,397,322,719,1084
0132-000,2017,4,19,24,256,235,491,719
0132-000,2017,4,20,1,181,181,362,491
0132-000,2017,4,20,2,121,125,246,362
0132-000,2017,4,20,3,83,103,186,246
0132-000,2017,4,20,4,77,102,179,186
0132-000,2017,4,20,5,87,108,195,179
0132-000,2017,4,20,6,221,192,413,195
0132-000,2017,4,20,7,442,559,1001,413
0132-000,2017,4,20,8,701,1789,2490,1001
0132-000,2017,4,20,9,857,1478,2335,2490
0132-000,2017,4,20,10,728,865,1593,2335
0132-000,2017,4,20,11,732,838,1570,1593
0132-000,2017,4,20,12,742,786,1528,1570
0132-000,2017,4,20,13,720,712,1432,1528
0132-000,2017,4,20,14,758,774,1532,1432
0132-000,2017,4,20,15,844,755,1599,1532
0132-000,2017,4,20,16,812,757,1569,1599
0132-000,2017,4,20,17,850,798,1648,1569
0132-000,2017,4,20,18,1225,912,2137,1648
0132-000,2017,4,20,19,1337,836,2173,2137
0132-000,2017,4,20,20,874,671,1545,2173
0132-000,2017,4,20,21,829,528,1357,1545
0132-000,2017,4,20,22,644,459,1103,1357
0132-000,2017,4,20,23,379,344,723,1103
0132-000,2017,4,20,24,267,238,505,723
0132-000,2017,4,21,1,185,146,331,505
0132-000,2017,4,21,2,107,119,226,331
0132-000,2017,4,21,3,72,105,177,226
0132-000,2017,4,21,4,83,107,190,177
0132-000,2017,4,21,5,87,95,182,190
0132-000,2017,4,21,6,241,230,471,182
0132-000,2017,4,21,7,455,610,1065,471
0132-000,2017,4,21,8,699,1791,2490,1065
0132-000,2017,4,21,9,837,1530,2367,2490
0132-000,2017,4,21,10,765,902,1667,2367
0132-000,2017,4,21,11,796,872,1668,1667
0132-000,2017,4,21,12,775,836,1611,1668
0132-000,2017,4,21,13,759,767,1526,1611
0132-000,2017,4,21,14,832,746,1578,1526
0132-000,2017,4,21,15,857,795,1652,1578
0132-000,2017,4,21,16,879,855,1734,1652
0132-000,2017,4,21,17,971,870,1841,1734
0132-000,2017,4,21,18,1218,954,2172,1841
0132-000,2017,4,21,19,1634,892,2526,2172
0132-000,2017,4,21,20,1043,771,1814,2526
0132-000,2017,4,21,21,794,558,1352,1814
0132-000,2017,4,21,22,613,502,1115,1352
0132-000,2017,4,21,23,403,353,756,1115
0132-000,2017,4,21,24,235,265,500,756
0132-000,2017,4,22,1,194,202,396,500
0132-000,2017,4,22,2,161,129,290,396
0132-000,2017,4,22,3,92,135,227,290
0132-000,2017,4,22,4,85,109,194,227
0132-000,2017,4,22,5,108,137,245,194
0132-000,2017,4,22,6,222,167,389,245
0132-000,2017,4,22,7,412,410,822,389
0132-000,2017,4,22,8,523,871,1394,822
0132-000,2017,4,22,9,661,1025,1686,1394
0132-000,2017,4,22,10,690,920,1610,1686
0132-000,2017,4,22,11,714,844,1558,1610
0132-000,2017,4,22,12,718,873,1591,1558
0132-000,2017,4,22,13,785,880,1665,1591
0132-000,2017,4,22,14,760,803,1563,1665
0132-000,2017,4,22,15,807,891,1698,1563
0132-000,2017,4,22,16,831,862,1693,1698
0132-000,2017,4,22,17,980,913,1893,1693
0132-000,2017,4,22,18,1213,970,2183,1893
0132-000,2017,4,22,19,1150,837,1987,2183
0132-000,2017,4,22,20,766,684,1450,1987
0132-000,2017,4,22,21,633,512,1145,1450
0132-000,2017,4,22,22,478,418,896,1145
0132-000,2017,4,22,23,340,320,660,896
0132-000,2017,4,22,24,221,253,474,660
0132-000,2017,4,23,1,185,182,367,474
0132-000,2017,4,23,2,118,138,256,367
0132-000,2017,4,23,3,106,109,215,256
0132-000,2017,4,23,4,66,89,155,215
0132-000,2017,4,23,5,73,90,163,155
0132-000,2017,4,23,6,154,116,270,163
0132-000,2017,4,23,7,249,274,523,270
0132-000,2017,4,23,8,299,429,728,523
0132-000,2017,4,23,9,374,468,842,728
0132-000,2017,4,23,10,423,648,1071,842
0132-000,2017,4,23,11,513,567,1080,1071
0132-000,2017,4,23,12,575,612,1187,1080
0132-000,2017,4,23,13,644,661,1305,1187
0132-000,2017,4,23,14,638,680,1318,1305
0132-000,2017,4,23,15,689,668,1357,1318
0132-000,2017,4,23,16,815,650,1465,1357
0132-000,2017,4,23,17,887,658,1545,1465
0132-000,2017,4,23,18,931,689,1620,1545
0132-000,2017,4,23,19,962,598,1560,1620
0132-000,2017,4,23,20,705,587,1292,1560
0132-000,2017,4,23,21,548,472,1020,1292
0132-000,2017,4,23,22,467,369,836,1020
0132-000,2017,4,23,23,273,303,576,836
0132-000,2017,4,23,24,169,188,357,576
0132-000,2017,4,24,1,152,116,268,357
0132-000,2017,4,24,2,69,64,133,268
0132-000,2017,4,24,3,48,68,116,133
0132-000,2017,4,24,4,53,60,113,116
0132-000,2017,4,24,5,72,80,152,113
0132-000,2017,4,24,6,303,214,517,152
0132-000,2017,4,24,7,494,630,1124,517
0132-000,2017,4,24,8,682,1834,2516,1124
0132-000,2017,4,24,9,784,1552,2336,2516
0132-000,2017,4,24,10,716,895,1611,2336
0132-000,2017,4,24,11,736,844,1580,1611
0132-000,2017,4,24,12,769,746,1515,1580
0132-000,2017,4,24,13,752,709,1461,1515
0132-000,2017,4,24,14,721,804,1525,1461
0132-000,2017,4,24,15,787,765,1552,1525
0132-000,2017,4,24,16,827,771,1598,1552
0132-000,2017,4,24,17,871,788,1659,1598
0132-000,2017,4,24,18,1224,872,2096,1659
0132-000,2017,4,24,19,1345,860,2205,2096
0132-000,2017,4,24,20,942,742,1684,2205
0132-000,2017,4,24,21,872,550,1422,1684
0132-000,2017,4,24,22,663,457,1120,1422
0132-000,2017,4,24,23,369,342,711,1120
0132-000,2017,4,24,24,234,217,451,711
0132-000,2017,4,25,1,152,119,271,451
0132-000,2017,4,25,2,99,93,192,271
0132-000,2017,4,25,3,58,98,156,192
0132-000,2017,4,25,4,55,85,140,156
0132-000,2017,4,25,5,78,117,195,140
0132-000,2017,4,25,6,256,171,427,195
0132-000,2017,4,25,7,453,581,1034,427
0132-000,2017,4,25,8,626,1753,2379,1034
0132-000,2017,4,25,9,838,1543,2381,2379
0132-000,2017,4,25,10,768,900,1668,2381
0132-000,2017,4,25,11,747,842,1589,1668
0132-000,2017,4,25,12,791,758,1549,1589
0132-000,2017,4,25,13,740,727,1467,1549
0132-000,2017,4,25,14,738,801,1539,1467
0132-000,2017,4,25,15,805,796,1601,1539
0132-000,2017,4,25,16,853,724,1577,1601
0132-000,2017,4,25,17,883,831,1714,1577
0132-000,2017,4,25,18,1218,898,2116,1714
0132-000,2017,4,25,19,1362,805,2167,2116
0132-000,2017,4,25,20,869,681,1550,2167
0132-000,2017,4,25,21,846,536,1382,1550
0132-000,2017,4,25,22,618,423,1041,1382
0132-000,2017,4,25,23,372,325,697,1041
0132-000,2017,4,25,24,241,204,445,697
0132-000,2017,4,26,1,189,139,328,445
0132-000,2017,4,26,2,89,94,183,328
0132-000,2017,4,26,3,69,92,161,183
0132-000,2017,4,26,4,70,97,167,161
0132-000,2017,4,26,5,85,100,185,167
0132-000,2017,4,26,6,271,188,459,185
0132-000,2017,4,26,7,483,591,1074,459
0132-000,2017,4,26,8,689,1715,2404,1074
0132-000,2017,4,26,9,821,1555,2376,2404
0132-000,2017,4,26,10,763,918,1681,2376
0132-000,2017,4,26,11,761,856,1617,1681
0132-000,2017,4,26,12,754,780,1534,1617
0132-000,2017,4,26,13,689,757,1446,1534
0132-000,2017,4,26,14,739,758,1497,1446
0132-000,2017,4,26,15,817,845,1662,1497
0132-000,2017,4,26,16,885,775,1660,1662
0132-000,2017,4,26,17,918,785,1703,1660
0132-000,2017,4,26,18,1225,844,2069,1703
0132-000,2017,4,26,19,1448,795,2243,2069
0132-000,2017,4,26,20,897,704,1601,2243
0132-000,2017,4,26,21,772,544,1316,1601
0132-000,2017,4,26,22,640,427,1067,1316
0132-000,2017,4,26,23,361,337,698,1067
0132-000,2017,4,26,24,228,231,459,698
0132-000,2017,4,27,1,165,181,346,459
0132-000,2017,4,27,2,120,105,225,346
0132-000,2017,4,27,3,64,89,153,225
0132-000,2017,4,27,4,75,81,156,153
0132-000,2017,4,27,5,86,125,211,156
0132-000,2017,4,27,6,253,189,442,211
0132-000,2017,4,27,7,456,621,1077,442
0132-000,2017,4,27,8,690,1686,2376,1077
0132-000,2017,4,27,9,817,1488,2305,2376
0132-000,2017,4,27,10,781,899,1680,2305
0132-000,2017,4,27,11,771,831,1602,1680
0132-000,2017,4,27,12,749,800,1549,1602
0132-000,2017,4,27,13,733,790,1523,1549
0132-000,2017,4,27,14,729,805,1534,1523
0132-000,2017,4,27,15,818,773,1591,1534
0132-000,2017,4,27,16,882,780,1662,1591
0132-000,2017,4,27,17,864,790,1654,1662
0132-000,2017,4,27,18,1301,862,2163,1654
0132-000,2017,4,27,19,1418,770,2188,2163
0132-000,2017,4,27,20,879,711,1590,2188
0132-000,2017,4,27,21,851,526,1377,1590
0132-000,2017,4,27,22,608,444,1052,1377
0132-000,2017,4,27,23,359,355,714,1052
0132-000,2017,4,27,24,238,252,490,714
0132-000,2017,4,28,1,177,152,329,490
0132-000,2017,4,28,2,136,112,248,329
0132-000,2017,4,28,3,63,99,162,248
0132-000,2017,4,28,4,74,103,177,162
0132-000,2017,4,28,5,94,97,191,177
0132-000,2017,4,28,6,277,232,509,191
0132-000,2017,4,28,7,485,589,1074,509
0132-000,2017,4,28,8,670,1787,2457,1074
0132-000,2017,4,28,9,835,1449,2284,2457
0132-000,2017,4,28,10,743,876,1619,2284
0132-000,2017,4,28,11,750,774,1524,1619
0132-000,2017,4,28,12,768,785,1553,1524
0132-000,2017,4,28,13,744,684,1428,1553
0132-000,2017,4,28,14,750,779,1529,1428
0132-000,2017,4,28,15,802,797,1599,1529
0132-000,2017,4,28,16,908,809,1717,1599
0132-000,2017,4,28,17,931,812,1743,1717
0132-000,2017,4,28,18,1279,897,2176,1743
0132-000,2017,4,28,19,1553,929,2482,2176
0132-000,2017,4,28,20,1025,763,1788,2482
0132-000,2017,4,28,21,853,617,1470,1788
0132-000,2017,4,28,22,599,450,1049,1470
0132-000,2017,4,28,23,407,398,805,1049
0132-000,2017,4,28,24,248,260,508,805
0132-000,2017,4,29,1,217,219,436,508
0132-000,2017,4,29,2,160,149,309,436
0132-000,2017,4,29,3,88,136,224,309
0132-000,2017,4,29,4,80,104,184,224
0132-000,2017,4,29,5,93,120,213,184
0132-000,2017,4,29,6,279,216,495,213
0132-000,2017,4,29,7,428,408,836,495
0132-000,2017,4,29,8,531,881,1412,836
0132-000,2017,4,29,9,730,1121,1851,1412
0132-000,2017,4,29,10,670,1092,1762,1851
0132-000,2017,4,29,11,671,1007,1678,1762
0132-000,2017,4,29,12,724,1109,1833,1678
0132-000,2017,4,29,13,764,1030,1794,1833
0132-000,2017,4,29,14,745,980,1725,1794
0132-000,2017,4,29,15,772,932,1704,1725
0132-000,2017,4,29,16,885,968,1853,1704
0132-000,2017,4,29,17,987,1180,2167,1853
0132-000,2017,4,29,18,1137,1002,2139,2167
0132-000,2017,4,29,19,1114,832,1946,2139
0132-000,2017,4,29,20,803,720,1523,1946
0132-000,2017,4,29,21,593,546,1139,1523
0132-000,2017,4,29,22,455,432,887,1139
0132-000,2017,4,29,23,340,322,662,887
0132-000,2017,4,29,24,198,212,410,662
0132-000,2017,4,30,1,192,203,395,410
0132-000,2017,4,30,2,130,145,275,395
0132-000,2017,4,30,3,94,110,204,275
0132-000,2017,4,30,4,84,99,183,204
0132-000,2017,4,30,5,80,100,180,183
0132-000,2017,4,30,6,130,160,290,180
0132-000,2017,4,30,7,211,242,453,290
0132-000,2017,4,30,8,319,425,744,453
0132-000,2017,4,30,9,366,617,983,744
0132-000,2017,4,30,10,459,591,1050,983
0132-000,2017,4,30,11,538,666,1204,1050
0132-000,2017,4,30,12,555,691,1246,1204
0132-000,2017,4,30,13,596,632,1228,1246
0132-000,2017,4,30,14,686,754,1440,1228
0132-000,2017,4,30,15,760,690,1450,1440
0132-000,2017,4,30,16,755,684,1439,1450
0132-000,2017,4,30,17,885,714,1599,1439
0132-000,2017,4,30,18,933,738,1671,1599
0132-000,2017,4,30,19,922,642,1564,1671
0132-000,2017,4,30,20,748,539,1287,1564
0132-000,2017,4,30,21,663,452,1115,1287
0132-000,2017,4,30,22,427,376,803,1115
0132-000,2017,4,30,23,315,281,596,803
0132-000,2017,4,30,24,194,192,386,596
0132-000,2017,5,1,1,139,164,303,386
0132-000,2017,5,1,2,84,87,171,303
0132-000,2017,5,1,3,69,79,148,171
0132-000,2017,5,1,4,46,76,122,148
0132-000,2017,5,1,5,72,92,164,122
0132-000,2017,5,1,6,114,154,268,164
0132-000,2017,5,1,7,280,409,689,268
0132-000,2017,5,1,8,494,1115,1609,689
0132-000,2017,5,1,9,692,1160,1852,1609
0132-000,2017,5,1,10,682,839,1521,1852
0132-000,2017,5,1,11,661,787,1448,1521
0132-000,2017,5,1,12,713,807,1520,1448
0132-000,2017,5,1,13,746,752,1498,1520
0132-000,2017,5,1,14,834,802,1636,1498
0132-000,2017,5,1,15,840,712,1552,1636
0132-000,2017,5,1,16,947,793,1740,1552
0132-000,2017,5,1,17,905,679,1584,1740
0132-000,2017,5,1,18,1156,766,1922,1584
0132-000,2017,5,1,19,1177,746,1923,1922
0132-000,2017,5,1,20,860,568,1428,1923
0132-000,2017,5,1,21,674,459,1133,1428
0132-000,2017,5,1,22,488,419,907,1133
0132-000,2017,5,1,23,308,327,635,907
0132-000,2017,5,1,24,204,211,415,635
0132-000,2017,5,2,1,152,139,291,415
0132-000,2017,5,2,2,106,110,216,291
0132-000,2017,5,2,3,65,89,154,216
0132-000,2017,5,2,4,64,98,162,154
0132-000,2017,5,2,5,89,105,194,162
0132-000,2017,5,2,6,283,212,495,194
0132-000,2017,5,2,7,507,591,1098,495
0132-000,2017,5,2,8,665,1656,2321,1098
0132-000,2017,5,2,9,802,1420,2222,2321
0132-000,2017,5,2,10,794,910,1704,2222
0132-000,2017,5,2,11,744,824,1568,1704
0132-000,2017,5,2,12,764,810,1574,1568
0132-000,2017,5,2,13,744,786,1530,1574
0132-000,2017,5,2,14,841,812,1653,1530
0132-000,2017,5,2,15,823,840,1663,1653
0132-000,2017,5,2,16,900,762,1662,1663
0132-000,2017,5,2,17,980,881,1861,1662
0132-000,2017,5,2,18,1175,897,2072,1861
0132-000,2017,5,2,19,1423,899,2322,2072
0132-000,2017,5,2,20,999,780,1779,2322
0132-000,2017,5,2,21,858,575,1433,1779
0132-000,2017,5,2,22,598,476,1074,1433
0132-000,2017,5,2,23,363,380,743,1074
0132-000,2017,5,2,24,230,254,484,743
0132-000,2017,5,3,1,172,183,355,484
0132-000,2017,5,3,2,132,144,276,355
0132-000,2017,5,3,3,89,102,191,276
0132-000,2017,5,3,4,73,111,184,191
0132-000,2017,5,3,5,101,103,204,184
0132-000,2017,5,3,6,237,206,443,204
0132-000,2017,5,3,7,417,441,858,443
0132-000,2017,5,3,8,473,910,1383,858
0132-000,2017,5,3,9,587,1001,1588,1383
0132-000,2017,5,3,10,636,954,1590,1588
0132-000,2017,5,3,11,566,1010,1576,1590
0132-000,2017,5,3,12,627,1142,1769,1576
0132-000,2017,5,3,13,702,1032,1734,1769
0132-000,2017,5,3,14,764,993,1757,1734
0132-000,2017,5,3,15,774,899,1673,1757
0132-000,2017,5,3,16,791,836,1627,1673
0132-000,2017,5,3,17,900,787,1687,1627
0132-000,2017,5,3,18,1072,852,1924,1687
0132-000,2017,5,3,19,1009,800,1809,1924
0132-000,2017,5,3,20,752,591,1343,1809
0132-000,2017,5,3,21,593,444,1037,1343
0132-000,2017,5,3,22,484,388,872,1037
0132-000,2017,5,3,23,316,309,625,872
0132-000,2017,5,3,24,191,187,378,625
0132-000,2017,5,4,1,165,143,308,378
0132-000,2017,5,4,2,89,104,193,308
0132-000,2017,5,4,3,69,75,144,193
0132-000,2017,5,4,4,55,78,133,144
0132-000,2017,5,4,5,81,99,180,133
0132-000,2017,5,4,6,233,184,417,180
0132-000,2017,5,4,7,411,508,919,417
0132-000,2017,5,4,8,593,1239,1832,919
0132-000,2017,5,4,9,732,1086,1818,1832
0132-000,2017,5,4,10,677,735,1412,1818
0132-000,2017,5,4,11,737,791,1528,1412
0132-000,2017,5,4,12,713,765,1478,1528
0132-000,2017,5,4,13,725,779,1504,1478
0132-000,2017,5,4,14,746,752,1498,1504
0132-000,2017,5,4,15,802,767,1569,1498
0132-000,2017,5,4,16,801,844,1645,1569
0132-000,2017,5,4,17,867,770,1637,1645
0132-000,2017,5,4,18,1029,896,1925,1637
0132-000,2017,5,4,19,1278,911,2189,1925
0132-000,2017,5,4,20,835,732,1567,2189
0132-000,2017,5,4,21,704,559,1263,1567
0132-000,2017,5,4,22,548,449,997,1263
0132-000,2017,5,4,23,330,363,693,997
0132-000,2017,5,4,24,216,227,443,693
0132-000,2017,5,5,1,180,170,350,443
0132-000,2017,5,5,2,129,111,240,350
0132-000,2017,5,5,3,82,102,184,240
0132-000,2017,5,5,4,90,87,177,184
0132-000,2017,5,5,5,83,89,172,177
0132-000,2017,5,5,6,214,167,381,172
0132-000,2017,5,5,7,364,342,706,381
0132-000,2017,5,5,8,384,593,977,706
0132-000,2017,5,5,9,475,762,1237,977
0132-000,2017,5,5,10,547,904,1451,1237
0132-000,2017,5,5,11,550,1125,1675,1451
0132-000,2017,5,5,12,642,1452,2094,1675
0132-000,2017,5,5,13,620,1405,2025,2094
0132-000,2017,5,5,14,632,1134,1766,2025
0132-000,2017,5,5,15,632,881,1513,1766
0132-000,2017,5,5,16,714,790,1504,1513
0132-000,2017,5,5,17,802,785,1587,1504
0132-000,2017,5,5,18,942,776,1718,1587
0132-000,2017,5,5,19,887,705,1592,1718
0132-000,2017,5,5,20,669,544,1213,1592
0132-000,2017,5,5,21,599,447,1046,1213
0132-000,2017,5,5,22,467,373,840,1046
0132-000,2017,5,5,23,326,273,599,840
0132-000,2017,5,5,24,196,207,403,599
0132-000,2017,5,6,1,125,122,247,403
0132-000,2017,5,6,2,92,90,182,247
0132-000,2017,5,6,3,62,87,149,182
0132-000,2017,5,6,4,71,72,143,149
0132-000,2017,5,6,5,65,105,170,143
0132-000,2017,5,6,6,213,155,368,170
0132-000,2017,5,6,7,327,344,671,368
0132-000,2017,5,6,8,369,587,956,671
0132-000,2017,5,6,9,485,661,1146,956
0132-000,2017,5,6,10,605,723,1328,1146
0132-000,2017,5,6,11,616,729,1345,1328
0132-000,2017,5,6,12,662,774,1436,1345
0132-000,2017,5,6,13,774,955,1729,1436
0132-000,2017,5,6,14,752,892,1644,1729
0132-000,2017,5,6,15,790,912,1702,1644
0132-000,2017,5,6,16,858,915,1773,1702
0132-000,2017,5,6,17,984,1046,2030,1773
0132-000,2017,5,6,18,1175,986,2161,2030
0132-000,2017,5,6,19,1321,708,2029,2161
0132-000,2017,5,6,20,1219,541,1760,2029
0132-000,2017,5,6,21,1086,490,1576,1760
0132-000,2017,5,6,22,770,412,1182,1576
0132-000,2017,5,6,23,461,308,769,1182
0132-000,2017,5,6,24,268,225,493,769
0132-000,2017,5,7,1,163,149,312,493
0132-000,2017,5,7,2,104,102,206,312
0132-000,2017,5,7,3,82,114,196,206
0132-000,2017,5,7,4,64,69,133,196
0132-000,2017,5,7,5,78,84,162,133
0132-000,2017,5,7,6,168,127,295,162
0132-000,2017,5,7,7,212,218,430,295
0132-000,2017,5,7,8,241,389,630,430
0132-000,2017,5,7,9,338,471,809,630
0132-000,2017,5,7,10,476,560,1036,809
0132-000,2017,5,7,11,556,628,1184,1036
0132-000,2017,5,7,12,644,662,1306,1184
0132-000,2017,5,7,13,688,661,1349,1306
0132-000,2017,5,7,14,737,666,1403,1349
0132-000,2017,5,7,15,833,722,1555,1403
0132-000,2017,5,7,16,1007,695,1702,1555
0132-000,2017,5,7,17,1142,710,1852,1702
0132-000,2017,5,7,18,1209,718,1927,1852
0132-000,2017,5,7,19,1135,569,1704,1927
0132-000,2017,5,7,20,905,591,1496,1704
0132-000,2017,5,7,21,752,450,1202,1496
0132-000,2017,5,7,22,476,421,897,1202
0132-000,2017,5,7,23,307,309,616,897
0132-000,2017,5,7,24,186,192,378,616
0132-000,2017,5,8,1,130,131,261,378
0132-000,2017,5,8,2,87,67,154,261
0132-000,2017,5,8,3,45,53,98,154
0132-000,2017,5,8,4,45,68,113,98
0132-000,2017,5,8,5,92,85,177,113
0132-000,2017,5,8,6,246,222,468,177
0132-000,2017,5,8,7,428,661,1089,468
0132-000,2017,5,8,8,637,1795,2432,1089
0132-000,2017,5,8,9,812,1407,2219,2432
0132-000,2017,5,8,10,746,793,1539,2219
0132-000,2017,5,8,11,729,841,1570,1539
0132-000,2017,5,8,12,817,824,1641,1570
0132-000,2017,5,8,13,757,758,1515,1641
0132-000,2017,5,8,14,809,842,1651,1515
0132-000,2017,5,8,15,836,843,1679,1651
0132-000,2017,5,8,16,839,724,1563,1679
0132-000,2017,5,8,17,908,846,1754,1563
0132-000,2017,5,8,18,1297,898,2195,1754
0132-000,2017,5,8,19,1404,895,2299,2195
0132-000,2017,5,8,20,1056,769,1825,2299
0132-000,2017,5,8,21,843,578,1421,1825
0132-000,2017,5,8,22,621,460,1081,1421
0132-000,2017,5,8,23,376,310,686,1081
0132-000,2017,5,8,24,244,243,487,686
0132-000,2017,5,9,1,189,180,369,487
0132-000,2017,5,9,2,118,130,248,369
0132-000,2017,5,9,3,83,86,169,248
0132-000,2017,5,9,4,73,104,177,169
0132-000,2017,5,9,5,94,111,205,177
0132-000,2017,5,9,6,195,132,327,205
0132-000,2017,5,9,7,357,410,767,327
0132-000,2017,5,9,8,506,934,1440,767
0132-000,2017,5,9,9,666,895,1561,1440
0132-000,2017,5,9,10,700,885,1585,1561
0132-000,2017,5,9,11,660,804,1464,1585
0132-000,2017,5,9,12,734,778,1512,1464
0132-000,2017,5,9,13,749,782,1531,1512
0132-000,2017,5,9,14,844,768,1612,1531
0132-000,2017,5,9,15,773,810,1583,1612
0132-000,2017,5,9,16,800,766,1566,1583
0132-000,2017,5,9,17,879,738,1617,1566
0132-000,2017,5,9,18,1042,758,1800,1617
0132-000,2017,5,9,19,968,689,1657,1800
0132-000,2017,5,9,20,607,570,1177,1657
0132-000,2017,5,9,21,619,400,1019,1177
0132-000,2017,5,9,22,400,371,771,1019
0132-000,2017,5,9,23,274,257,531,771
0132-000,2017,5,9,24,173,138,311,531
0132-000,2017,5,10,1,114,128,242,311
0132-000,2017,5,10,2,78,74,152,242
0132-000,2017,5,10,3,51,79,130,152
0132-000,2017,5,10,4,50,62,112,130
0132-000,2017,5,10,5,95,103,198,112
0132-000,2017,5,10,6,260,182,442,198
0132-000,2017,5,10,7,419,531,950,442
0132-000,2017,5,10,8,659,1803,2462,950
0132-000,2017,5,10,9,818,1544,2362,2462
0132-000,2017,5,10,10,716,891,1607,2362
0132-000,2017,5,10,11,757,809,1566,1607
0132-000,2017,5,10,12,712,740,1452,1566
0132-000,2017,5,10,13,681,779,1460,1452
0132-000,2017,5,10,14,775,732,1507,1460
0132-000,2017,5,10,15,815,795,1610,1507
0132-000,2017,5,10,16,843,779,1622,1610
0132-000,2017,5,10,17,887,822,1709,1622
0132-000,2017,5,10,18,1212,872,2084,1709
0132-000,2017,5,10,19,1435,848,2283,2084
0132-000,2017,5,10,20,960,725,1685,2283
0132-000,2017,5,10,21,860,540,1400,1685
0132-000,2017,5,10,22,624,434,1058,1400
0132-000,2017,5,10,23,414,338,752,1058
0132-000,2017,5,10,24,221,237,458,752
0132-000,2017,5,11,1,148,167,315,458
0132-000,2017,5,11,2,124,103,227,315
0132-000,2017,5,11,3,82,103,185,227
0132-000,2017,5,11,4,73,92,165,185
0132-000,2017,5,11,5,96,120,216,165
0132-000,2017,5,11,6,271,204,475,216
0132-000,2017,5,11,7,437,567,1004,475
0132-000,2017,5,11,8,703,1795,2498,1004
0132-000,2017,5,11,9,820,1587,2407,2498
0132-000,2017,5,11,10,771,882,1653,2407
0132-000,2017,5,11,11,759,846,1605,1653
0132-000,2017,5,11,12,750,865,1615,1605
0132-000,2017,5,11,13,692,731,1423,1615
0132-000,2017,5,11,14,748,755,1503,1423
0132-000,2017,5,11,15,815,763,1578,1503
0132-000,2017,5,11,16,869,778,1647,1578
0132-000,2017,5,11,17,859,805,1664,1647
0132-000,2017,5,11,18,1207,898,2105,1664
0132-000,2017,5,11,19,1379,822,2201,2105
0132-000,2017,5,11,20,982,679,1661,2201
0132-000,2017,5,11,21,897,490,1387,1661
0132-000,2017,5,11,22,615,446,1061,1387
0132-000,2017,5,11,23,404,339,743,1061
0132-000,2017,5,11,24,282,231,513,743
0132-000,2017,5,12,1,207,152,359,513
0132-000,2017,5,12,2,117,109,226,359
0132-000,2017,5,12,3,69,104,173,226
0132-000,2017,5,12,4,81,105,186,173
0132-000,2017,5,12,5,87,118,205,186
0132-000,2017,5,12,6,282,197,479,205
0132-000,2017,5,12,7,448,616,1064,479
0132-000,2017,5,12,8,661,1770,2431,1064
0132-000,2017,5,12,9,830,1498,2328,2431
0132-000,2017,5,12,10,784,863,1647,2328
0132-000,2017,5,12,11,754,782,1536,1647
0132-000,2017,5,12,12,742,768,1510,1536
0132-000,2017,5,12,13,759,776,1535,1510
0132-000,2017,5,12,14,791,807,1598,1535
0132-000,2017,5,12,15,811,821,1632,1598
0132-000,2017,5,12,16,862,787,1649,1632
0132-000,2017,5,12,17,958,859,1817,1649
0132-000,2017,5,12,18,1251,907,2158,1817
0132-000,2017,5,12,19,1610,929,2539,2158
0132-000,2017,5,12,20,1005,757,1762,2539
0132-000,2017,5,12,21,852,551,1403,1762
0132-000,2017,5,12,22,621,488,1109,1403
0132-000,2017,5,12,23,385,382,767,1109
0132-000,2017,5,12,24,225,255,480,767
0132-000,2017,5,13,1,235,208,443,480
0132-000,2017,5,13,2,130,160,290,443
0132-000,2017,5,13,3,112,107,219,290
0132-000,2017,5,13,4,98,124,222,219
0132-000,2017,5,13,5,115,146,261,222
0132-000,2017,5,13,6,260,208,468,261
0132-000,2017,5,13,7,419,437,856,468
0132-000,2017,5,13,8,491,854,1345,856
0132-000,2017,5,13,9,629,1042,1671,1345
0132-000,2017,5,13,10,724,836,1560,1671
0132-000,2017,5,13,11,721,833,1554,1560
0132-000,2017,5,13,12,774,812,1586,1554
0132-000,2017,5,13,13,787,791,1578,1586
0132-000,2017,5,13,14,757,799,1556,1578
0132-000,2017,5,13,15,791,840,1631,1556
0132-000,2017,5,13,16,807,913,1720,1631
0132-000,2017,5,13,17,986,889,1875,1720
0132-000,2017,5,13,18,1156,985,2141,1875
0132-000,2017,5,13,19,1054,724,1778,2141
0132-000,2017,5,13,20,655,582,1237,1778
0132-000,2017,5,13,21,570,531,1101,1237
0132-000,2017,5,13,22,457,447,904,1101
0132-000,2017,5,13,23,335,302,637,904
0132-000,2017,5,13,24,194,221,415,637
0132-000,2017,5,14,1,173,177,350,415
0132-000,2017,5,14,2,119,143,262,350
0132-000,2017,5,14,3,88,106,194,262
0132-000,2017,5,14,4,67,101,168,194
0132-000,2017,5,14,5,85,96,181,168
0132-000,2017,5,14,6,189,146,335,181
0132-000,2017,5,14,7,230,281,511,335
0132-000,2017,5,14,8,312,395,707,511
0132-000,2017,5,14,9,393,504,897,707
0132-000,2017,5,14,10,469,580,1049,897
0132-000,2017,5,14,11,555,582,1137,1049
0132-000,2017,5,14,12,527,595,1122,1137
0132-000,2017,5,14,13,610,614,1224,1122
0132-000,2017,5,14,14,645,698,1343,1224
0132-000,2017,5,14,15,736,671,1407,1343
0132-000,2017,5,14,16,727,652,1379,1407
0132-000,2017,5,14,17,787,691,1478,1379
0132-000,2017,5,14,18,879,718,1597,1478
0132-000,2017,5,14,19,817,595,1412,1597
0132-000,2017,5,14,20,662,488,1150,1412
0132-000,2017,5,14,21,557,480,1037,1150
0132-000,2017,5,14,22,439,409,848,1037
0132-000,2017,5,14,23,289,331,620,848
0132-000,2017,5,14,24,210,210,420,620
0132-000,2017,5,15,1,134,151,285,420
0132-000,2017,5,15,2,75,70,145,285
0132-000,2017,5,15,3,53,70,123,145
0132-000,2017,5,15,4,49,62,111,123
0132-000,2017,5,15,5,99,100,199,111
0132-000,2017,5,15,6,300,213,513,199
0132-000,2017,5,15,7,484,688,1172,513
0132-000,2017,5,15,8,708,1909,2617,1172
0132-000,2017,5,15,9,806,1548,2354,2617
0132-000,2017,5,15,10,755,905,1660,2354
0132-000,2017,5,15,11,788,765,1553,1660
0132-000,2017,5,15,12,714,759,1473,1553
0132-000,2017,5,15,13,688,795,1483,1473
0132-000,2017,5,15,14,797,766,1563,1483
0132-000,2017,5,15,15,826,817,1643,1563
0132-000,2017,5,15,16,845,793,1638,1643
0132-000,2017,5,15,17,901,831,1732,1638
0132-000,2017,5,15,18,1173,871,2044,1732
0132-000,2017,5,15,19,1390,832,2222,2044
0132-000,2017,5,15,20,947,754,1701,2222
0132-000,2017,5,15,21,935,564,1499,1701
0132-000,2017,5,15,22,602,451,1053,1499
0132-000,2017,5,15,23,367,307,674,1053
0132-000,2017,5,15,24,259,219,478,674
0132-000,2017,5,16,1,162,133,295,478
0132-000,2017,5,16,2,117,109,226,295
0132-000,2017,5,16,3,58,82,140,226
0132-000,2017,5,16,4,83,104,187,140
0132-000,2017,5,16,5,94,107,201,187
0132-000,2017,5,16,6,288,211,499,201
0132-000,2017,5,16,7,467,614,1081,499
0132-000,2017,5,16,8,671,1827,2498,1081
0132-000,2017,5,16,9,837,1602,2439,2498
0132-000,2017,5,16,10,771,935,1706,2439
0132-000,2017,5,16,11,788,844,1632,1706
0132-000,2017,5,16,12,750,762,1512,1632
0132-000,2017,5,16,13,673,776,1449,1512
0132-000,2017,5,16,14,788,748,1536,1449
0132-000,2017,5,16,15,788,767,1555,1536
0132-000,2017,5,16,16,860,737,1597,1555
0132-000,2017,5,16,17,886,786,1672,1597
0132-000,2017,5,16,18,1211,859,2070,1672
0132-000,2017,5,16,19,1285,797,2082,2070
0132-000,2017,5,16,20,957,691,1648,2082
0132-000,2017,5,16,21,874,559,1433,1648
0132-000,2017,5,16,22,604,453,1057,1433
0132-000,2017,5,16,23,417,281,698,1057
0132-000,2017,5,16,24,262,208,470,698
0132-000,2017,5,17,1,188,174,362,470
0132-000,2017,5,17,2,92,117,209,362
0132-000,2017,5,17,3,75,94,169,209
0132-000,2017,5,17,4,87,91,178,169
0132-000,2017,5,17,5,99,131,230,178
0132-000,2017,5,17,6,279,217,496,230
0132-000,2017,5,17,7,480,618,1098,496
0132-000,2017,5,17,8,662,1846,2508,1098
0132-000,2017,5,17,9,804,1455,2259,2508
0132-000,2017,5,17,10,781,822,1603,2259
0132-000,2017,5,17,11,800,840,1640,1603
0132-000,2017,5,17,12,718,798,1516,1640
0132-000,2017,5,17,13,686,718,1404,1516
0132-000,2017,5,17,14,787,784,1571,1404
0132-000,2017,5,17,15,812,782,1594,1571
0132-000,2017,5,17,16,861,790,1651,1594
0132-000,2017,5,17,17,935,811,1746,1651
0132-000,2017,5,17,18,1285,946,2231,1746
0132-000,2017,5,17,19,1413,888,2301,2231
0132-000,2017,5,17,20,949,695,1644,2301
0132-000,2017,5,17,21,807,543,1350,1644
0132-000,2017,5,17,22,628,499,1127,1350
0132-000,2017,5,17,23,435,353,788,1127
0132-000,2017,5,17,24,262,255,517,788
0132-000,2017,5,18,1,189,171,360,517
0132-000,2017,5,18,2,128,114,242,360
0132-000,2017,5,18,3,96,103,199,242
0132-000,2017,5,18,4,74,81,155,199
0132-000,2017,5,18,5,83,119,202,155
0132-000,2017,5,18,6,292,221,513,202
0132-000,2017,5,18,7,477,597,1074,513
0132-000,2017,5,18,8,658,1796,2454,1074
0132-000,2017,5,18,9,830,1492,2322,2454
0132-000,2017,5,18,10,729,860,1589,2322
0132-000,2017,5,18,11,758,828,1586,1589
0132-000,2017,5,18,12,750,741,1491,1586
0132-000,2017,5,18,13,665,689,1354,1491
0132-000,2017,5,18,14,760,777,1537,1354
0132-000,2017,5,18,15,793,765,1558,1537
0132-000,2017,5,18,16,799,735,1534,1558
0132-000,2017,5,18,17,965,784,1749,1534
0132-000,2017,5,18,18,1129,899,2028,1749
0132-000,2017,5,18,19,1339,843,2182,2028
0132-000,2017,5,18,20,997,757,1754,2182
0132-000,2017,5,18,21,895,581,1476,1754
0132-000,2017,5,18,22,639,515,1154,1476
0132-000,2017,5,18,23,453,340,793,1154
0132-000,2017,5,18,24,257,257,514,793
0132-000,2017,5,19,1,156,152,308,514
0132-000,2017,5,19,2,129,112,241,308
0132-000,2017,5,19,3,77,95,172,241
0132-000,2017,5,19,4,85,106,191,172
0132-000,2017,5,19,5,94,98,192,191
0132-000,2017,5,19,6,282,240,522,192
0132-000,2017,5,19,7,466,601,1067,522
0132-000,2017,5,19,8,634,1817,2451,1067
0132-000,2017,5,19,9,789,1418,2207,2451
0132-000,2017,5,19,10,763,834,1597,2207
0132-000,2017,5,19,11,742,812,1554,1597
0132-000,2017,5,19,12,705,780,1485,1554
0132-000,2017,5,19,13,669,734,1403,1485
0132-000,2017,5,19,14,748,695,1443,1403
0132-000,2017,5,19,15,783,765,1548,1443
0132-000,2017,5,19,16,832,740,1572,1548
0132-000,2017,5,19,17,893,844,1737,1572
0132-000,2017,5,19,18,1215,964,2179,1737
0132-000,2017,5,19,19,1547,908,2455,2179
0132-000,2017,5,19,20,1079,800,1879,2455
0132-000,2017,5,19,21,898,601,1499,1879
0132-000,2017,5,19,22,631,493,1124,1499
0132-000,2017,5,19,23,422,392,814,1124
0132-000,2017,5,19,24,262,285,547,814
0132-000,2017,5,20,1,212,224,436,547
0132-000,2017,5,20,2,162,156,318,436
0132-000,2017,5,20,3,94,112,206,318
0132-000,2017,5,20,4,96,103,199,206
0132-000,2017,5,20,5,103,133,236,199
0132-000,2017,5,20,6,296,220,516,236
0132-000,2017,5,20,7,471,467,938,516
0132-000,2017,5,20,8,505,868,1373,938
0132-000,2017,5,20,9,689,970,1659,1373
0132-000,2017,5,20,10,713,848,1561,1659
0132-000,2017,5,20,11,679,907,1586,1561
0132-000,2017,5,20,12,734,908,1642,1586
0132-000,2017,5,20,13,735,878,1613,1642
0132-000,2017,5,20,14,834,791,1625,1613
0132-000,2017,5,20,15,842,847,1689,1625
0132-000,2017,5,20,16,812,875,1687,1689
0132-000,2017,5,20,17,978,942,1920,1687
0132-000,2017,5,20,18,1252,992,2244,1920
0132-000,2017,5,20,19,1016,786,1802,2244
0132-000,2017,5,20,20,781,641,1422,1802
0132-000,2017,5,20,21,590,514,1104,1422
0132-000,2017,5,20,22,453,392,845,1104
0132-000,2017,5,20,23,318,323,641,845
0132-000,2017,5,20,24,202,286,488,641
0132-000,2017,5,21,1,173,197,370,488
0132-000,2017,5,21,2,144,149,293,370
0132-000,2017,5,21,3,105,100,205,293
0132-000,2017,5,21,4,87,101,188,205
0132-000,2017,5,21,5,95,101,196,188
0132-000,2017,5,21,6,179,177,356,196
0132-000,2017,5,21,7,272,294,566,356
0132-000,2017,5,21,8,292,423,715,566
0132-000,2017,5,21,9,377,511,888,715
0132-000,2017,5,21,10,495,565,1060,888
0132-000,2017,5,21,11,526,691,1217,1060
0132-000,2017,5,21,12,582,698,1280,1217
0132-000,2017,5,21,13,641,725,1366,1280
0132-000,2017,5,21,14,720,732,1452,1366
0132-000,2017,5,21,15,798,687,1485,1452
0132-000,2017,5,21,16,791,722,1513,1485
0132-000,2017,5,21,17,914,671,1585,1513
0132-000,2017,5,21,18,926,738,1664,1585
0132-000,2017,5,21,19,869,635,1504,1664
0132-000,2017,5,21,20,746,543,1289,1504
0132-000,2017,5,21,21,610,500,1110,1289
0132-000,2017,5,21,22,497,433,930,1110
0132-000,2017,5,21,23,299,307,606,930
0132-000,2017,5,21,24,170,215,385,606
0132-000,2017,5,22,1,131,138,269,385
0132-000,2017,5,22,2,75,93,168,269
0132-000,2017,5,22,3,61,69,130,168
0132-000,2017,5,22,4,49,61,110,130
0132-000,2017,5,22,5,94,90,184,110
0132-000,2017,5,22,6,324,220,544,184
0132-000,2017,5,22,7,507,684,1191,544
0132-000,2017,5,22,8,684,1857,2541,1191
0132-000,2017,5,22,9,770,1543,2313,2541
0132-000,2017,5,22,10,736,875,1611,2313
0132-000,2017,5,22,11,757,857,1614,1611
0132-000,2017,5,22,12,756,764,1520,1614
0132-000,2017,5,22,13,720,728,1448,1520
0132-000,2017,5,22,14,789,702,1491,1448
0132-000,2017,5,22,15,785,758,1543,1491
0132-000,2017,5,22,16,804,729,1533,1543
0132-000,2017,5,22,17,913,833,1746,1533
0132-000,2017,5,22,18,1141,907,2048,1746
0132-000,2017,5,22,19,1363,850,2213,2048
0132-000,2017,5,22,20,943,750,1693,2213
0132-000,2017,5,22,21,882,529,1411,1693
0132-000,2017,5,22,22,619,465,1084,1411
0132-000,2017,5,22,23,388,338,726,1084
0132-000,2017,5,22,24,232,221,453,726
0132-000,2017,5,23,1,175,148,323,453
0132-000,2017,5,23,2,110,93,203,323
0132-000,2017,5,23,3,64,79,143,203
0132-000,2017,5,23,4,70,102,172,143
0132-000,2017,5,23,5,104,124,228,172
0132-000,2017,5,23,6,294,198,492,228
0132-000,2017,5,23,7,470,615,1085,492
0132-000,2017,5,23,8,704,1752,2456,1085
0132-000,2017,5,23,9,799,1551,2350,2456
0132-000,2017,5,23,10,777,939,1716,2350
0132-000,2017,5,23,11,745,817,1562,1716
0132-000,2017,5,23,12,737,827,1564,1562
0132-000,2017,5,23,13,717,713,1430,1564
0132-000,2017,5,23,14,787,732,1519,1430
0132-000,2017,5,23,15,801,787,1588,1519
0132-000,2017,5,23,16,795,721,1516,1588
0132-000,2017,5,23,17,882,735,1617,1516
0132-000,2017,5,23,18,1156,952,2108,1617
0132-000,2017,5,23,19,1347,834,2181,2108
0132-000,2017,5,23,20,897,618,1515,2181
0132-000,2017,5,23,21,871,494,1365,1515
0132-000,2017,5,23,22,629,428,1057,1365
0132-000,2017,5,23,23,365,342,707,1057
0132-000,2017,5,23,24,236,227,463,707
0132-000,2017,5,24,1,138,165,303,463
0132-000,2017,5,24,2,61,110,171,303
0132-000,2017,5,24,3,53,77,130,171
0132-000,2017,5,24,4,46,93,139,130
0132-000,2017,5,24,5,44,113,157,139
0132-000,2017,5,24,6,178,201,379,157
0132-000,2017,5,24,7,226,567,793,379
0132-000,2017,5,24,8,378,1747,2125,793
0132-000,2017,5,24,9,773,1537,2310,2125
0132-000,2017,5,24,10,805,838,1643,2310
0132-000,2017,5,24,11,753,812,1565,1643
0132-000,2017,5,24,12,714,806,1520,1565
0132-000,2017,5,24,13,698,714,1412,1520
0132-000,2017,5,24,14,765,725,1490,1412
0132-000,2017,5,24,15,790,821,1611,1490
0132-000,2017,5,24,16,853,779,1632,1611
0132-000,2017,5,24,17,821,799,1620,1632
0132-000,2017,5,24,18,1256,946,2202,1620
0132-000,2017,5,24,19,1488,782,2270,2202
0132-000,2017,5,24,20,945,697,1642,2270
0132-000,2017,5,24,21,819,518,1337,1642
0132-000,2017,5,24,22,596,450,1046,1337
0132-000,2017,5,24,23,419,348,767,1046
0132-000,2017,5,24,24,223,224,447,767
0132-000,2017,5,25,1,155,145,300,447
0132-000,2017,5,25,2,110,97,207,300
0132-000,2017,5,25,3,63,94,157,207
0132-000,2017,5,25,4,60,89,149,157
0132-000,2017,5,25,5,90,122,212,149
0132-000,2017,5,25,6,292,215,507,212
0132-000,2017,5,25,7,496,611,1107,507
0132-000,2017,5,25,8,671,1780,2451,1107
0132-000,2017,5,25,9,758,1516,2274,2451
0132-000,2017,5,25,10,740,873,1613,2274
0132-000,2017,5,25,11,718,789,1507,1613
0132-000,2017,5,25,12,691,808,1499,1507
0132-000,2017,5,25,13,703,673,1376,1499
0132-000,2017,5,25,14,743,748,1491,1376
0132-000,2017,5,25,15,815,793,1608,1491
0132-000,2017,5,25,16,798,703,1501,1608
0132-000,2017,5,25,17,913,784,1697,1501
0132-000,2017,5,25,18,1218,917,2135,1697
0132-000,2017,5,25,19,1409,811,2220,2135
0132-000,2017,5,25,20,972,739,1711,2220
0132-000,2017,5,25,21,854,496,1350,1711
0132-000,2017,5,25,22,695,478,1173,1350
0132-000,2017,5,25,23,464,388,852,1173
0132-000,2017,5,25,24,233,222,455,852
0132-000,2017,5,26,1,179,172,351,455
0132-000,2017,5,26,2,111,121,232,351
0132-000,2017,5,26,3,64,97,161,232
0132-000,2017,5,26,4,90,102,192,161
0132-000,2017,5,26,5,91,128,219,192
0132-000,2017,5,26,6,297,217,514,219
0132-000,2017,5,26,7,469,618,1087,514
0132-000,2017,5,26,8,701,1778,2479,1087
0132-000,2017,5,26,9,800,1554,2354,2479
0132-000,2017,5,26,10,769,882,1651,2354
0132-000,2017,5,26,11,750,836,1586,1651
0132-000,2017,5,26,12,764,868,1632,1586
0132-000,2017,5,26,13,692,737,1429,1632
0132-000,2017,5,26,14,787,769,1556,1429
0132-000,2017,5,26,15,881,807,1688,1556
0132-000,2017,5,26,16,848,774,1622,1688
0132-000,2017,5,26,17,900,848,1748,1622
0132-000,2017,5,26,18,1341,1002,2343,1748
0132-000,2017,5,26,19,1618,920,2538,2343
0132-000,2017,5,26,20,1034,837,1871,2538
0132-000,2017,5,26,21,874,588,1462,1871
0132-000,2017,5,26,22,636,498,1134,1462
0132-000,2017,5,26,23,459,370,829,1134
0132-000,2017,5,26,24,282,271,553,829
0132-000,2017,5,27,1,196,229,425,553
0132-000,2017,5,27,2,152,160,312,425
0132-000,2017,5,27,3,94,111,205,312
0132-000,2017,5,27,4,102,109,211,205
0132-000,2017,5,27,5,113,136,249,211
0132-000,2017,5,27,6,285,233,518,249
0132-000,2017,5,27,7,384,440,824,518
0132-000,2017,5,27,8,514,845,1359,824
0132-000,2017,5,27,9,682,974,1656,1359
0132-000,2017,5,27,10,700,861,1561,1656
0132-000,2017,5,27,11,711,922,1633,1561
0132-000,2017,5,27,12,788,882,1670,1633
0132-000,2017,5,27,13,781,856,1637,1670
0132-000,2017,5,27,14,759,830,1589,1637
0132-000,2017,5,27,15,849,863,1712,1589
0132-000,2017,5,27,16,808,813,1621,1712
0132-000,2017,5,27,17,952,861,1813,1621
0132-000,2017,5,27,18,1285,959,2244,1813
0132-000,2017,5,27,19,1240,943,2183,2244
0132-000,2017,5,27,20,767,710,1477,2183
0132-000,2017,5,27,21,609,515,1124,1477
0132-000,2017,5,27,22,490,445,935,1124
0132-000,2017,5,27,23,421,323,744,935
0132-000,2017,5,27,24,232,271,503,744
0132-000,2017,5,28,1,182,185,367,503
0132-000,2017,5,28,2,153,136,289,367
0132-000,2017,5,28,3,113,112,225,289
0132-000,2017,5,28,4,79,90,169,225
0132-000,2017,5,28,5,102,102,204,169
0132-000,2017,5,28,6,175,158,333,204
0132-000,2017,5,28,7,256,265,521,333
0132-000,2017,5,28,8,311,398,709,521
0132-000,2017,5,28,9,368,535,903,709
0132-000,2017,5,28,10,458,558,1016,903
0132-000,2017,5,28,11,543,599,1142,1016
0132-000,2017,5,28,12,530,659,1189,1142
0132-000,2017,5,28,13,634,662,1296,1189
0132-000,2017,5,28,14,618,629,1247,1296
0132-000,2017,5,28,15,721,611,1332,1247
0132-000,2017,5,28,16,770,697,1467,1332
0132-000,2017,5,28,17,774,704,1478,1467
0132-000,2017,5,28,18,852,658,1510,1478
0132-000,2017,5,28,19,838,550,1388,1510
0132-000,2017,5,28,20,679,501,1180,1388
0132-000,2017,5,28,21,572,484,1056,1180
0132-000,2017,5,28,22,441,385,826,1056
0132-000,2017,5,28,23,290,302,592,826
0132-000,2017,5,28,24,205,217,422,592
0132-000,2017,5,29,1,141,143,284,422
0132-000,2017,5,29,2,89,82,171,284
0132-000,2017,5,29,3,56,69,125,171
0132-000,2017,5,29,4,47,64,111,125
0132-000,2017,5,29,5,71,101,172,111
0132-000,2017,5,29,6,312,240,552,172
0132-000,2017,5,29,7,487,671,1158,552
0132-000,2017,5,29,8,697,1864,2561,1158
0132-000,2017,5,29,9,756,1622,2378,2561
0132-000,2017,5,29,10,699,841,1540,2378
0132-000,2017,5,29,11,767,785,1552,1540
0132-000,2017,5,29,12,725,757,1482,1552
0132-000,2017,5,29,13,689,733,1422,1482
0132-000,2017,5,29,14,756,721,1477,1422
0132-000,2017,5,29,15,750,763,1513,1477
0132-000,2017,5,29,16,860,783,1643,1513
0132-000,2017,5,29,17,855,792,1647,1643
0132-000,2017,5,29,18,1206,878,2084,1647
0132-000,2017,5,29,19,1400,856,2256,2084
0132-000,2017,5,29,20,893,686,1579,2256
0132-000,2017,5,29,21,883,562,1445,1579
0132-000,2017,5,29,22,635,473,1108,1445
0132-000,2017,5,29,23,366,336,702,1108
0132-000,2017,5,29,24,219,194,413,702
0132-000,2017,5,30,1,159,128,287,413
0132-000,2017,5,30,2,109,98,207,287
0132-000,2017,5,30,3,80,80,160,207
0132-000,2017,5,30,4,65,88,153,160
0132-000,2017,5,30,5,100,122,222,153
0132-000,2017,5,30,6,282,223,505,222
0132-000,2017,5,30,7,470,633,1103,505
0132-000,2017,5,30,8,706,1771,2477,1103
0132-000,2017,5,30,9,813,1581,2394,2477
0132-000,2017,5,30,10,733,873,1606,2394
0132-000,2017,5,30,11,736,842,1578,1606
0132-000,2017,5,30,12,749,865,1614,1578
0132-000,2017,5,30,13,741,756,1497,1614
0132-000,2017,5,30,14,800,739,1539,1497
0132-000,2017,5,30,15,811,832,1643,1539
0132-000,2017,5,30,16,872,768,1640,1643
0132-000,2017,5,30,17,869,884,1753,1640
0132-000,2017,5,30,18,1212,915,2127,1753
0132-000,2017,5,30,19,1383,901,2284,2127
0132-000,2017,5,30,20,916,694,1610,2284
0132-000,2017,5,30,21,864,497,1361,1610
0132-000,2017,5,30,22,555,434,989,1361
0132-000,2017,5,30,23,544,306,850,989
0132-000,2017,5,30,24,255,252,507,850
0132-000,2017,5,31,1,186,158,344,507
0132-000,2017,5,31,2,129,92,221,344
0132-000,2017,5,31,3,77,101,178,221
0132-000,2017,5,31,4,79,96,175,178
0132-000,2017,5,31,5,103,117,220,175
0132-000,2017,5,31,6,288,213,501,220
0132-000,2017,5,31,7,463,621,1084,501
0132-000,2017,5,31,8,657,1766,2423,1084
0132-000,2017,5,31,9,778,1562,2340,2423
0132-000,2017,5,31,10,679,841,1520,2340
0132-000,2017,5,31,11,766,786,1552,1520
0132-000,2017,5,31,12,726,816,1542,1552
0132-000,2017,5,31,13,627,747,1374,1542
0132-000,2017,5,31,14,739,727,1466,1374
0132-000,2017,5,31,15,727,769,1496,1466
0132-000,2017,5,31,16,788,768,1556,1496
0132-000,2017,5,31,17,845,747,1592,1556
0132-000,2017,5,31,18,1233,854,2087,1592
0132-000,2017,5,31,19,1523,848,2371,2087
0132-000,2017,5,31,20,963,713,1676,2371
0132-000,2017,5,31,21,753,527,1280,1676
0132-000,2017,5,31,22,644,451,1095,1280
0132-000,2017,5,31,23,403,358,761,1095
0132-000,2017,5,31,24,234,260,494,761
0132-000,2017,6,1,1,162,178,340,494
0132-000,2017,6,1,2,120,101,221,340
0132-000,2017,6,1,3,74,95,169,221
0132-000,2017,6,1,4,67,94,161,169
0132-000,2017,6,1,5,94,131,225,161
0132-000,2017,6,1,6,303,211,514,225
0132-000,2017,6,1,7,475,617,1092,514
0132-000,2017,6,1,8,628,1811,2439,1092
0132-000,2017,6,1,9,764,1480,2244,2439
0132-000,2017,6,1,10,750,918,1668,2244
0132-000,2017,6,1,11,746,744,1490,1668
0132-000,2017,6,1,12,730,774,1504,1490
0132-000,2017,6,1,13,692,711,1403,1504
0132-000,2017,6,1,14,744,735,1479,1403
0132-000,2017,6,1,15,784,774,1558,1479
0132-000,2017,6,1,16,786,694,1480,1558
0132-000,2017,6,1,17,896,763,1659,1480
0132-000,2017,6,1,18,1168,888,2056,1659
0132-000,2017,6,1,19,1336,809,2145,2056
0132-000,2017,6,1,20,1024,680,1704,2145
0132-000,2017,6,1,21,871,576,1447,1704
0132-000,2017,6,1,22,568,457,1025,1447
0132-000,2017,6,1,23,406,313,719,1025
0132-000,2017,6,1,24,249,240,489,719
0132-000,2017,6,2,1,160,155,315,489
0132-000,2017,6,2,2,115,122,237,315
0132-000,2017,6,2,3,74,103,177,237
0132-000,2017,6,2,4,78,94,172,177
0132-000,2017,6,2,5,111,107,218,172
0132-000,2017,6,2,6,285,224,509,218
0132-000,2017,6,2,7,475,654,1129,509
0132-000,2017,6,2,8,679,1774,2453,1129
0132-000,2017,6,2,9,804,1476,2280,2453
0132-000,2017,6,2,10,725,824,1549,2280
0132-000,2017,6,2,11,761,850,1611,1549
0132-000,2017,6,2,12,734,792,1526,1611
0132-000,2017,6,2,13,722,686,1408,1526
0132-000,2017,6,2,14,790,782,1572,1408
0132-000,2017,6,2,15,810,833,1643,1572
0132-000,2017,6,2,16,844,796,1640,1643
0132-000,2017,6,2,17,885,853,1738,1640
0132-000,2017,6,2,18,1236,954,2190,1738
0132-000,2017,6,2,19,1533,925,2458,2190
0132-000,2017,6,2,20,1078,851,1929,2458
0132-000,2017,6,2,21,911,600,1511,1929
0132-000,2017,6,2,22,659,530,1189,1511
0132-000,2017,6,2,23,431,389,820,1189
0132-000,2017,6,2,24,307,296,603,820
0132-000,2017,6,3,1,225,223,448,603
0132-000,2017,6,3,2,135,170,305,448
0132-000,2017,6,3,3,111,130,241,305
0132-000,2017,6,3,4,91,128,219,241
0132-000,2017,6,3,5,118,124,242,219
0132-000,2017,6,3,6,279,228,507,242
0132-000,2017,6,3,7,408,446,854,507
0132-000,2017,6,3,8,531,851,1382,854
0132-000,2017,6,3,9,594,917,1511,1382
0132-000,2017,6,3,10,709,871,1580,1511
0132-000,2017,6,3,11,719,890,1609,1580
0132-000,2017,6,3,12,750,987,1737,1609
0132-000,2017,6,3,13,773,911,1684,1737
0132-000,2017,6,3,14,712,927,1639,1684
0132-000,2017,6,3,15,836,920,1756,1639
0132-000,2017,6,3,16,821,867,1688,1756
0132-000,2017,6,3,17,934,917,1851,1688
0132-000,2017,6,3,18,1132,1001,2133,1851
0132-000,2017,6,3,19,1156,826,1982,2133
0132-000,2017,6,3,20,685,701,1386,1982
0132-000,2017,6,3,21,619,575,1194,1386
0132-000,2017,6,3,22,476,439,915,1194
0132-000,2017,6,3,23,372,354,726,915
0132-000,2017,6,3,24,190,249,439,726
0132-000,2017,6,4,1,175,191,366,439
0132-000,2017,6,4,2,133,114,247,366
0132-000,2017,6,4,3,86,92,178,247
0132-000,2017,6,4,4,81,99,180,178
0132-000,2017,6,4,5,88,94,182,180
0132-000,2017,6,4,6,163,165,328,182
0132-000,2017,6,4,7,213,255,468,328
0132-000,2017,6,4,8,301,386,687,468
0132-000,2017,6,4,9,363,465,828,687
0132-000,2017,6,4,10,468,567,1035,828
0132-000,2017,6,4,11,499,658,1157,1035
0132-000,2017,6,4,12,584,678,1262,1157
0132-000,2017,6,4,13,621,639,1260,1262
0132-000,2017,6,4,14,634,663,1297,1260
0132-000,2017,6,4,15,702,723,1425,1297
0132-000,2017,6,4,16,835,668,1503,1425
0132-000,2017,6,4,17,882,658,1540,1503
0132-000,2017,6,4,18,929,638,1567,1540
0132-000,2017,6,4,19,943,602,1545,1567
0132-000,2017,6,4,20,693,496,1189,1545
0132-000,2017,6,4,21,647,493,1140,1189
0132-000,2017,6,4,22,496,383,879,1140
0132-000,2017,6,4,23,315,310,625,879
0132-000,2017,6,4,24,201,212,413,625
0132-000,2017,6,5,1,127,128,255,413
0132-000,2017,6,5,2,57,74,131,255
0132-000,2017,6,5,3,47,72,119,131
0132-000,2017,6,5,4,56,76,132,119
0132-000,2017,6,5,5,93,89,182,132
0132-000,2017,6,5,6,303,228,531,182
0132-000,2017,6,5,7,487,701,1188,531
0132-000,2017,6,5,8,623,1733,2356,1188
0132-000,2017,6,5,9,764,1298,2062,2356
0132-000,2017,6,5,10,737,848,1585,2062
0132-000,2017,6,5,11,719,784,1503,1585
0132-000,2017,6,5,12,758,828,1586,1503
0132-000,2017,6,5,13,742,716,1458,1586
0132-000,2017,6,5,14,806,820,1626,1458
0132-000,2017,6,5,15,820,834,1654,1626
0132-000,2017,6,5,16,803,748,1551,1654
0132-000,2017,6,5,17,876,847,1723,1551
0132-000,2017,6,5,18,1169,867,2036,1723
0132-000,2017,6,5,19,1304,864,2168,2036
0132-000,2017,6,5,20,973,755,1728,2168
0132-000,2017,6,5,21,828,568,1396,1728
0132-000,2017,6,5,22,614,426,1040,1396
0132-000,2017,6,5,23,401,320,721,1040
0132-000,2017,6,5,24,255,254,509,721
0132-000,2017,6,6,1,208,176,384,509
0132-000,2017,6,6,2,118,129,247,384
0132-000,2017,6,6,3,114,125,239,247
0132-000,2017,6,6,4,91,91,182,239
0132-000,2017,6,6,5,121,118,239,182
0132-000,2017,6,6,6,265,199,464,239
0132-000,2017,6,6,7,361,456,817,464
0132-000,2017,6,6,8,497,887,1384,817
0132-000,2017,6,6,9,530,841,1371,1384
0132-000,2017,6,6,10,571,723,1294,1371
0132-000,2017,6,6,11,621,713,1334,1294
0132-000,2017,6,6,12,673,773,1446,1334
0132-000,2017,6,6,13,725,718,1443,1446
0132-000,2017,6,6,14,700,722,1422,1443
0132-000,2017,6,6,15,805,670,1475,1422
0132-000,2017,6,6,16,826,732,1558,1475
0132-000,2017,6,6,17,874,740,1614,1558
0132-000,2017,6,6,18,1124,814,1938,1614
0132-000,2017,6,6,19,793,637,1430,1938
0132-000,2017,6,6,20,301,505,806,1430
0132-000,2017,6,6,21,287,425,712,806
0132-000,2017,6,6,22,198,343,541,712
0132-000,2017,6,6,23,129,219,348,541
0132-000,2017,6,6,24,67,163,230,348
0132-000,2017,6,7,1,162,130,292,230
0132-000,2017,6,7,2,95,77,172,292
0132-000,2017,6,7,3,65,51,116,172
0132-000,2017,6,7,4,62,62,124,116
0132-000,2017,6,7,5,74,95,169,124
0132-000,2017,6,7,6,233,191,424,169
0132-000,2017,6,7,7,344,571,915,424
0132-000,2017,6,7,8,518,1716,2234,915
0132-000,2017,6,7,9,776,1535,2311,2234
0132-000,2017,6,7,10,742,829,1571,2311
0132-000,2017,6,7,11,760,800,1560,1571
0132-000,2017,6,7,12,720,763,1483,1560
0132-000,2017,6,7,13,662,743,1405,1483
0132-000,2017,6,7,14,752,725,1477,1405
0132-000,2017,6,7,15,758,789,1547,1477
0132-000,2017,6,7,16,820,720,1540,1547
0132-000,2017,6,7,17,833,749,1582,1540
0132-000,2017,6,7,18,1244,859,2103,1582
0132-000,2017,6,7,19,1506,753,2259,2103
0132-000,2017,6,7,20,766,607,1373,2259
0132-000,2017,6,7,21,769,472,1241,1373
0132-000,2017,6,7,22,546,392,938,1241
0132-000,2017,6,7,23,338,314,652,938
0132-000,2017,6,7,24,220,213,433,652
0132-000,2017,6,8,1,190,151,341,433
0132-000,2017,6,8,2,97,102,199,341
0132-000,2017,6,8,3,66,90,156,199
0132-000,2017,6,8,4,70,78,148,156
0132-000,2017,6,8,5,114,114,228,148
0132-000,2017,6,8,6,258,218,476,228
0132-000,2017,6,8,7,444,614,1058,476
0132-000,2017,6,8,8,643,1752,2395,1058
0132-000,2017,6,8,9,757,1531,2288,2395
0132-000,2017,6,8,10,673,804,1477,2288
0132-000,2017,6,8,11,700,772,1472,1477
0132-000,2017,6,8,12,704,726,1430,1472
0132-000,2017,6,8,13,677,691,1368,1430
0132-000,2017,6,8,14,706,737,1443,1368
0132-000,2017,6,8,15,796,736,1532,1443
0132-000,2017,6,8,16,821,745,1566,1532
0132-000,2017,6,8,17,863,788,1651,1566
0132-000,2017,6,8,18,1149,905,2054,1651
0132-000,2017,6,8,19,1385,811,2196,2054
0132-000,2017,6,8,20,952,731,1683,2196
0132-000,2017,6,8,21,881,518,1399,1683
0132-000,2017,6,8,22,660,482,1142,1399
0132-000,2017,6,8,23,401,351,752,1142
0132-000,2017,6,8,24,245,242,487,752
0132-000,2017,6,9,1,166,166,332,487
0132-000,2017,6,9,2,120,98,218,332
0132-000,2017,6,9,3,74,102,176,218
0132-000,2017,6,9,4,77,84,161,176
0132-000,2017,6,9,5,85,107,192,161
0132-000,2017,6,9,6,264,218,482,192
0132-000,2017,6,9,7,432,593,1025,482
0132-000,2017,6,9,8,643,1709,2352,1025
0132-000,2017,6,9,9,773,1461,2234,2352
0132-000,2017,6,9,10,704,801,1505,2234
0132-000,2017,6,9,11,707,753,1460,1505
0132-000,2017,6,9,12,696,763,1459,1460
0132-000,2017,6,9,13,700,694,1394,1459
0132-000,2017,6,9,14,820,770,1590,1394
0132-000,2017,6,9,15,729,724,1453,1590
0132-000,2017,6,9,16,847,801,1648,1453
0132-000,2017,6,9,17,909,835,1744,1648
0132-000,2017,6,9,18,1326,944,2270,1744
0132-000,2017,6,9,19,1521,930,2451,2270
0132-000,2017,6,9,20,1042,811,1853,2451
0132-000,2017,6,9,21,912,597,1509,1853
0132-000,2017,6,9,22,686,501,1187,1509
0132-000,2017,6,9,23,460,381,841,1187
0132-000,2017,6,9,24,296,250,546,841
0132-000,2017,6,10,1,226,197,423,546
0132-000,2017,6,10,2,145,142,287,423
0132-000,2017,6,10,3,108,115,223,287
0132-000,2017,6,10,4,92,108,200,223
0132-000,2017,6,10,5,118,129,247,200
0132-000,2017,6,10,6,296,231,527,247
0132-000,2017,6,10,7,386,442,828,527
0132-000,2017,6,10,8,504,827,1331,828
0132-000,2017,6,10,9,634,891,1525,1331
0132-000,2017,6,10,10,720,919,1639,1525
0132-000,2017,6,10,11,727,875,1602,1639
0132-000,2017,6,10,12,705,913,1618,1602
0132-000,2017,6,10,13,769,844,1613,1618
0132-000,2017,6,10,14,778,801,1579,1613
0132-000,2017,6,10,15,750,841,1591,1579
0132-000,2017,6,10,16,802,812,1614,1591
0132-000,2017,6,10,17,938,876,1814,1614
0132-000,2017,6,10,18,1145,904,2049,1814
0132-000,2017,6,10,19,1021,826,1847,2049
0132-000,2017,6,10,20,713,715,1428,1847
0132-000,2017,6,10,21,640,509,1149,1428
0132-000,2017,6,10,22,509,433,942,1149
0132-000,2017,6,10,23,383,323,706,942
0132-000,2017,6,10,24,230,246,476,706
0132-000,2017,6,11,1,166,200,366,476
0132-000,2017,6,11,2,146,156,302,366
0132-000,2017,6,11,3,110,124,234,302
0132-000,2017,6,11,4,89,105,194,234
0132-000,2017,6,11,5,99,134,233,194
0132-000,2017,6,11,6,185,156,341,233
0132-000,2017,6,11,7,234,268,502,341
0132-000,2017,6,11,8,276,396,672,502
0132-000,2017,6,11,9,366,492,858,672
0132-000,2017,6,11,10,437,581,1018,858
0132-000,2017,6,11,11,501,612,1113,1018
0132-000,2017,6,11,12,548,629,1177,1113
0132-000,2017,6,11,13,626,642,1268,1177
0132-000,2017,6,11,14,666,637,1303,1268
0132-000,2017,6,11,15,771,661,1432,1303
0132-000,2017,6,11,16,728,668,1396,1432
0132-000,2017,6,11,17,738,625,1363,1396
0132-000,2017,6,11,18,853,616,1469,1363
0132-000,2017,6,11,19,840,590,1430,1469
0132-000,2017,6,11,20,701,535,1236,1430
0132-000,2017,6,11,21,606,466,1072,1236
0132-000,2017,6,11,22,446,408,854,1072
0132-000,2017,6,11,23,258,284,542,854
0132-000,2017,6,11,24,188,189,377,542
0132-000,2017,6,12,1,110,119,229,377
0132-000,2017,6,12,2,77,104,181,229
0132-000,2017,6,12,3,65,66,131,181
0132-000,2017,6,12,4,44,75,119,131
0132-000,2017,6,12,5,97,107,204,119
0132-000,2017,6,12,6,301,239,540,204
0132-000,2017,6,12,7,458,695,1153,540
0132-000,2017,6,12,8,636,1883,2519,1153
0132-000,2017,6,12,9,718,1475,2193,2519
0132-000,2017,6,12,10,740,844,1584,2193
0132-000,2017,6,12,11,727,802,1529,1584
0132-000,2017,6,12,12,695,846,1541,1529
0132-000,2017,6,12,13,704,752,1456,1541
0132-000,2017,6,12,14,749,768,1517,1456
0132-000,2017,6,12,15,797,736,1533,1517
0132-000,2017,6,12,16,845,734,1579,1533
0132-000,2017,6,12,17,809,798,1607,1579
0132-000,2017,6,12,18,1162,919,2081,1607
0132-000,2017,6,12,19,1357,843,2200,2081
0132-000,2017,6,12,20,884,680,1564,2200
0132-000,2017,6,12,21,798,482,1280,1564
0132-000,2017,6,12,22,624,424,1048,1280
0132-000,2017,6,12,23,318,303,621,1048
0132-000,2017,6,12,24,209,194,403,621
0132-000,2017,6,13,1,163,134,297,403
0132-000,2017,6,13,2,104,97,201,297
0132-000,2017,6,13,3,68,92,160,201
0132-000,2017,6,13,4,66,84,150,160
0132-000,2017,6,13,5,110,132,242,150
0132-000,2017,6,13,6,297,226,523,242
0132-000,2017,6,13,7,473,614,1087,523
0132-000,2017,6,13,8,684,1727,2411,1087
0132-000,2017,6,13,9,781,1516,2297,2411
0132-000,2017,6,13,10,717,842,1559,2297
0132-000,2017,6,13,11,713,743,1456,1559
0132-000,2017,6,13,12,718,753,1471,1456
0132-000,2017,6,13,13,704,696,1400,1471
0132-000,2017,6,13,14,712,745,1457,1400
0132-000,2017,6,13,15,790,740,1530,1457
0132-000,2017,6,13,16,855,739,1594,1530
0132-000,2017,6,13,17,878,745,1623,1594
0132-000,2017,6,13,18,1142,895,2037,1623
0132-000,2017,6,13,19,1335,876,2211,2037
0132-000,2017,6,13,20,996,685,1681,2211
0132-000,2017,6,13,21,889,495,1384,1681
0132-000,2017,6,13,22,631,443,1074,1384
0132-000,2017,6,13,23,409,368,777,1074
0132-000,2017,6,13,24,240,240,480,777
0132-000,2017,6,14,1,153,175,328,480
0132-000,2017,6,14,2,101,97,198,328
0132-000,2017,6,14,3,67,100,167,198
0132-000,2017,6,14,4,67,94,161,167
0132-000,2017,6,14,5,111,131,242,161
0132-000,2017,6,14,6,293,230,523,242
0132-000,2017,6,14,7,466,642,1108,523
0132-000,2017,6,14,8,634,1758,2392,1108
0132-000,2017,6,14,9,788,1469,2257,2392
0132-000,2017,6,14,10,766,912,1678,2257
0132-000,2017,6,14,11,774,779,1553,1678
0132-000,2017,6,14,12,708,794,1502,1553
0132-000,2017,6,14,13,671,701,1372,1502
0132-000,2017,6,14,14,756,738,1494,1372
0132-000,2017,6,14,15,763,742,1505,1494
0132-000,2017,6,14,16,855,706,1561,1505
0132-000,2017,6,14,17,874,829,1703,1561
0132-000,2017,6,14,18,1204,901,2105,1703
0132-000,2017,6,14,19,1492,855,2347,2105
0132-000,2017,6,14,20,979,700,1679,2347
0132-000,2017,6,14,21,824,549,1373,1679
0132-000,2017,6,14,22,597,457,1054,1373
0132-000,2017,6,14,23,415,341,756,1054
0132-000,2017,6,14,24,230,236,466,756
0132-000,2017,6,15,1,159,171,330,466
0132-000,2017,6,15,2,116,119,235,330
0132-000,2017,6,15,3,78,113,191,235
0132-000,2017,6,15,4,69,99,168,191
0132-000,2017,6,15,5,100,115,215,168
0132-000,2017,6,15,6,294,253,547,215
0132-000,2017,6,15,7,495,601,1096,547
0132-000,2017,6,15,8,629,1771,2400,1096
0132-000,2017,6,15,9,800,1423,2223,2400
0132-000,2017,6,15,10,695,849,1544,2223
0132-000,2017,6,15,11,687,773,1460,1544
0132-000,2017,6,15,12,710,804,1514,1460
0132-000,2017,6,15,13,706,742,1448,1514
0132-000,2017,6,15,14,773,719,1492,1448
0132-000,2017,6,15,15,760,707,1467,1492
0132-000,2017,6,15,16,849,710,1559,1467
0132-000,2017,6,15,17,884,813,1697,1559
0132-000,2017,6,15,18,1144,931,2075,1697
0132-000,2017,6,15,19,1392,846,2238,2075
0132-000,2017,6,15,20,1001,687,1688,2238
0132-000,2017,6,15,21,864,528,1392,1688
0132-000,2017,6,15,22,661,456,1117,1392
0132-000,2017,6,15,23,421,354,775,1117
0132-000,2017,6,15,24,253,242,495,775
0132-000,2017,6,16,1,179,175,354,495
0132-000,2017,6,16,2,117,129,246,354
0132-000,2017,6,16,3,87,118,205,246
0132-000,2017,6,16,4,82,112,194,205
0132-000,2017,6,16,5,128,129,257,194
0132-000,2017,6,16,6,286,240,526,257
0132-000,2017,6,16,7,454,648,1102,526
0132-000,2017,6,16,8,623,1730,2353,1102
0132-000,2017,6,16,9,740,1432,2172,2353
0132-000,2017,6,16,10,707,823,1530,2172
0132-000,2017,6,16,11,805,810,1615,1530
0132-000,2017,6,16,12,713,796,1509,1615
0132-000,2017,6,16,13,696,760,1456,1509
0132-000,2017,6,16,14,804,805,1609,1456
0132-000,2017,6,16,15,862,820,1682,1609
0132-000,2017,6,16,16,840,764,1604,1682
0132-000,2017,6,16,17,954,824,1778,1604
0132-000,2017,6,16,18,1274,1000,2274,1778
0132-000,2017,6,16,19,1624,886,2510,2274
0132-000,2017,6,16,20,1081,809,1890,2510
0132-000,2017,6,16,21,911,599,1510,1890
0132-000,2017,6,16,22,749,540,1289,1510
0132-000,2017,6,16,23,449,405,854,1289
0132-000,2017,6,16,24,266,294,560,854
0132-000,2017,6,17,1,214,220,434,560
0132-000,2017,6,17,2,167,151,318,434
0132-000,2017,6,17,3,113,151,264,318
0132-000,2017,6,17,4,94,125,219,264
0132-000,2017,6,17,5,138,160,298,219
0132-000,2017,6,17,6,282,229,511,298
0132-000,2017,6,17,7,411,421,832,511
0132-000,2017,6,17,8,473,793,1266,832
0132-000,2017,6,17,9,620,946,1566,1266
0132-000,2017,6,17,10,716,910,1626,1566
0132-000,2017,6,17,11,712,903,1615,1626
0132-000,2017,6,17,12,759,919,1678,1615
0132-000,2017,6,17,13,843,812,1655,1678
0132-000,2017,6,17,14,810,938,1748,1655
0132-000,2017,6,17,15,810,850,1660,1748
0132-000,2017,6,17,16,829,855,1684,1660
0132-000,2017,6,17,17,980,864,1844,1684
0132-000,2017,6,17,18,1219,934,2153,1844
0132-000,2017,6,17,19,1113,880,1993,2153
0132-000,2017,6,17,20,786,654,1440,1993
0132-000,2017,6,17,21,644,544,1188,1440
0132-000,2017,6,17,22,502,447,949,1188
0132-000,2017,6,17,23,344,363,707,949
0132-000,2017,6,17,24,244,261,505,707
0132-000,2017,6,18,1,153,182,335,505
0132-000,2017,6,18,2,129,132,261,335
0132-000,2017,6,18,3,116,101,217,261
0132-000,2017,6,18,4,73,84,157,217
0132-000,2017,6,18,5,106,117,223,157
0132-000,2017,6,18,6,151,166,317,223
0132-000,2017,6,18,7,228,260,488,317
0132-000,2017,6,18,8,333,384,717,488
0132-000,2017,6,18,9,384,504,888,717
0132-000,2017,6,18,10,467,589,1056,888
0132-000,2017,6,18,11,519,684,1203,1056
0132-000,2017,6,18,12,558,736,1294,1203
0132-000,2017,6,18,13,643,776,1419,1294
0132-000,2017,6,18,14,609,778,1387,1419
0132-000,2017,6,18,15,709,795,1504,1387
0132-000,2017,6,18,16,829,820,1649,1504
0132-000,2017,6,18,17,845,672,1517,1649
0132-000,2017,6,18,18,868,710,1578,1517
0132-000,2017,6,18,19,914,553,1467,1578
0132-000,2017,6,18,20,726,545,1271,1467
0132-000,2017,6,18,21,607,488,1095,1271
0132-000,2017,6,18,22,456,392,848,1095
0132-000,2017,6,18,23,320,317,637,848
0132-000,2017,6,18,24,160,207,367,637
0132-000,2017,6,19,1,122,128,250,367
0132-000,2017,6,19,2,84,78,162,250
0132-000,2017,6,19,3,57,70,127,162
0132-000,2017,6,19,4,52,75,127,127
0132-000,2017,6,19,5,95,107,202,127
0132-000,2017,6,19,6,339,248,587,202
0132-000,2017,6,19,7,462,734,1196,587
0132-000,2017,6,19,8,672,1838,2510,1196
0132-000,2017,6,19,9,774,1434,2208,2510
0132-000,2017,6,19,10,725,768,1493,2208
0132-000,2017,6,19,11,747,847,1594,1493
0132-000,2017,6,19,12,704,763,1467,1594
0132-000,2017,6,19,13,712,758,1470,1467
0132-000,2017,6,19,14,733,784,1517,1470
0132-000,2017,6,19,15,790,782,1572,1517
0132-000,2017,6,19,16,836,774,1610,1572
0132-000,2017,6,19,17,892,764,1656,1610
0132-000,2017,6,19,18,1143,942,2085,1656
0132-000,2017,6,19,19,1453,825,2278,2085
0132-000,2017,6,19,20,972,699,1671,2278
0132-000,2017,6,19,21,866,505,1371,1671
0132-000,2017,6,19,22,629,427,1056,1371
0132-000,2017,6,19,23,338,325,663,1056
0132-000,2017,6,19,24,215,201,416,663
0132-000,2017,6,20,1,143,124,267,416
0132-000,2017,6,20,2,106,110,216,267
0132-000,2017,6,20,3,76,93,169,216
0132-000,2017,6,20,4,62,78,140,169
0132-000,2017,6,20,5,110,147,257,140
0132-000,2017,6,20,6,279,225,504,257
0132-000,2017,6,20,7,448,601,1049,504
0132-000,2017,6,20,8,618,1751,2369,1049
0132-000,2017,6,20,9,763,1499,2262,2369
0132-000,2017,6,20,10,898,869,1767,2262
0132-000,2017,6,20,11,1075,790,1865,1767
0132-000,2017,6,20,12,786,802,1588,1865
0132-000,2017,6,20,13,809,768,1577,1588
0132-000,2017,6,20,14,741,809,1550,1577
0132-000,2017,6,20,15,757,776,1533,1550
0132-000,2017,6,20,16,874,716,1590,1533
0132-000,2017,6,20,17,971,796,1767,1590
0132-000,2017,6,20,18,1448,867,2315,1767
0132-000,2017,6,20,19,2018,834,2852,2315
0132-000,2017,6,20,20,1135,735,1870,2852
0132-000,2017,6,20,21,827,533,1360,1870
0132-000,2017,6,20,22,608,435,1043,1360
0132-000,2017,6,20,23,364,335,699,1043
0132-000,2017,6,20,24,190,239,429,699
0132-000,2017,6,21,1,331,158,489,429
0132-000,2017,6,21,2,202,98,300,489
0132-000,2017,6,21,3,134,92,226,300
0132-000,2017,6,21,4,96,97,193,226
0132-000,2017,6,21,5,196,114,310,193
0132-000,2017,6,21,6,422,242,664,310
0132-000,2017,6,21,7,464,636,1100,664
0132-000,2017,6,21,8,649,1740,2389,1100
0132-000,2017,6,21,9,909,1479,2388,2389
0132-000,2017,6,21,10,673,797,1470,2388
0132-000,2017,6,21,11,706,739,1445,1470
0132-000,2017,6,21,12,708,780,1488,1445
0132-000,2017,6,21,13,666,669,1335,1488
0132-000,2017,6,21,14,782,744,1526,1335
0132-000,2017,6,21,15,656,738,1394,1526
0132-000,2017,6,21,16,892,765,1657,1394
0132-000,2017,6,21,17,827,780,1607,1657
0132-000,2017,6,21,18,1287,917,2204,1607
0132-000,2017,6,21,19,1571,834,2405,2204
0132-000,2017,6,21,20,1021,732,1753,2405
0132-000,2017,6,21,21,805,576,1381,1753
0132-000,2017,6,21,22,552,477,1029,1381
0132-000,2017,6,21,23,354,372,726,1029
0132-000,2017,6,21,24,246,222,468,726
0132-000,2017,6,22,1,149,173,322,468
0132-000,2017,6,22,2,94,113,207,322
0132-000,2017,6,22,3,73,81,154,207
0132-000,2017,6,22,4,88,98,186,154
0132-000,2017,6,22,5,122,123,245,186
0132-000,2017,6,22,6,352,258,610,245
0132-000,2017,6,22,7,430,615,1045,610
0132-000,2017,6,22,8,620,1718,2338,1045
0132-000,2017,6,22,9,822,1471,2293,2338
0132-000,2017,6,22,10,746,798,1544,2293
0132-000,2017,6,22,11,763,743,1506,1544
0132-000,2017,6,22,12,690,665,1355,1506
0132-000,2017,6,22,13,664,705,1369,1355
0132-000,2017,6,22,14,702,693,1395,1369
0132-000,2017,6,22,15,694,702,1396,1395
0132-000,2017,6,22,16,881,663,1544,1396
0132-000,2017,6,22,17,833,779,1612,1544
0132-000,2017,6,22,18,1156,905,2061,1612
0132-000,2017,6,22,19,1315,843,2158,2061
0132-000,2017,6,22,20,976,697,1673,2158
0132-000,2017,6,22,21,892,512,1404,1673
0132-000,2017,6,22,22,622,495,1117,1404
0132-000,2017,6,22,23,379,322,701,1117
0132-000,2017,6,22,24,250,270,520,701
0132-000,2017,6,23,1,170,175,345,520
0132-000,2017,6,23,2,132,102,234,345
0132-000,2017,6,23,3,73,111,184,234
0132-000,2017,6,23,4,63,90,153,184
0132-000,2017,6,23,5,103,129,232,153
0132-000,2017,6,23,6,291,232,523,232
0132-000,2017,6,23,7,432,639,1071,523
0132-000,2017,6,23,8,651,1722,2373,1071
0132-000,2017,6,23,9,742,1440,2182,2373
0132-000,2017,6,23,10,767,751,1518,2182
0132-000,2017,6,23,11,685,741,1426,1518
0132-000,2017,6,23,12,698,772,1470,1426
0132-000,2017,6,23,13,719,702,1421,1470
0132-000,2017,6,23,14,727,794,1521,1421
0132-000,2017,6,23,15,757,915,1672,1521
0132-000,2017,6,23,16,858,934,1792,1672
0132-000,2017,6,23,17,926,1010,1936,1792
0132-000,2017,6,23,18,1303,995,2298,1936
0132-000,2017,6,23,19,1636,922,2558,2298
0132-000,2017,6,23,20,1019,821,1840,2558
0132-000,2017,6,23,21,791,580,1371,1840
0132-000,2017,6,23,22,698,467,1165,1371
0132-000,2017,6,23,23,417,379,796,1165
0132-000,2017,6,23,24,229,276,505,796
0132-000,2017,6,24,1,204,248,452,505
0132-000,2017,6,24,2,120,149,269,452
0132-000,2017,6,24,3,96,116,212,269
0132-000,2017,6,24,4,80,131,211,212
0132-000,2017,6,24,5,99,156,255,211
0132-000,2017,6,24,6,299,231,530,255
0132-000,2017,6,24,7,364,468,832,530
0132-000,2017,6,24,8,447,769,1216,832
0132-000,2017,6,24,9,639,863,1502,1216
0132-000,2017,6,24,10,660,769,1429,1502
0132-000,2017,6,24,11,671,826,1497,1429
0132-000,2017,6,24,12,717,829,1546,1497
0132-000,2017,6,24,13,715,815,1530,1546
0132-000,2017,6,24,14,746,857,1603,1530
0132-000,2017,6,24,15,793,831,1624,1603
0132-000,2017,6,24,16,869,874,1743,1624
0132-000,2017,6,24,17,879,953,1832,1743
0132-000,2017,6,24,18,1174,940,2114,1832
0132-000,2017,6,24,19,953,744,1697,2114
0132-000,2017,6,24,20,687,601,1288,1697
0132-000,2017,6,24,21,519,436,955,1288
0132-000,2017,6,24,22,388,410,798,955
0132-000,2017,6,24,23,331,304,635,798
0132-000,2017,6,24,24,206,227,433,635
0132-000,2017,6,25,1,143,160,303,433
0132-000,2017,6,25,2,82,151,233,303
0132-000,2017,6,25,3,77,99,176,233
0132-000,2017,6,25,4,94,95,189,176
0132-000,2017,6,25,5,82,105,187,189
0132-000,2017,6,25,6,135,138,273,187
0132-000,2017,6,25,7,175,240,415,273
0132-000,2017,6,25,8,206,382,588,415
0132-000,2017,6,25,9,324,454,778,588
0132-000,2017,6,25,10,356,504,860,778
0132-000,2017,6,25,11,500,564,1064,860
0132-000,2017,6,25,12,428,596,1024,1064
0132-000,2017,6,25,13,592,616,1208,1024
0132-000,2017,6,25,14,599,607,1206,1208
0132-000,2017,6,25,15,635,666,1301,1206
0132-000,2017,6,25,16,670,665,1335,1301
0132-000,2017,6,25,17,736,649,1385,1335
0132-000,2017,6,25,18,740,663,1403,1385
0132-000,2017,6,25,19,855,591,1446,1403
0132-000,2017,6,25,20,594,527,1121,1446
0132-000,2017,6,25,21,478,455,933,1121
0132-000,2017,6,25,22,379,357,736,933
0132-000,2017,6,25,23,242,279,521,736
0132-000,2017,6,25,24,141,181,322,521
0132-000,2017,6,26,1,105,133,238,322
0132-000,2017,6,26,2,75,84,159,238
0132-000,2017,6,26,3,63,70,133,159
0132-000,2017,6,26,4,56,84,140,133
0132-000,2017,6,26,5,105,120,225,140
0132-000,2017,6,26,6,284,234,518,225
0132-000,2017,6,26,7,459,674,1133,518
0132-000,2017,6,26,8,632,1832,2464,1133
0132-000,2017,6,26,9,803,1382,2185,2464
0132-000,2017,6,26,10,681,902,1583,2185
0132-000,2017,6,26,11,690,810,1500,1583
0132-000,2017,6,26,12,713,801,1514,1500
0132-000,2017,6,26,13,696,698,1394,1514
0132-000,2017,6,26,14,721,820,1541,1394
0132-000,2017,6,26,15,787,820,1607,1541
0132-000,2017,6,26,16,833,727,1560,1607
0132-000,2017,6,26,17,846,799,1645,1560
0132-000,2017,6,26,18,1135,842,1977,1645
0132-000,2017,6,26,19,1324,799,2123,1977
0132-000,2017,6,26,20,922,634,1556,2123
0132-000,2017,6,26,21,786,532,1318,1556
0132-000,2017,6,26,22,595,435,1030,1318
0132-000,2017,6,26,23,327,274,601,1030
0132-000,2017,6,26,24,192,215,407,601
0132-000,2017,6,27,1,160,156,316,407
0132-000,2017,6,27,2,99,100,199,316
0132-000,2017,6,27,3,65,73,138,199
0132-000,2017,6,27,4,75,80,155,138
0132-000,2017,6,27,5,84,139,223,155
0132-000,2017,6,27,6,282,235,517,223
0132-000,2017,6,27,7,451,579,1030,517
0132-000,2017,6,27,8,649,1771,2420,1030
0132-000,2017,6,27,9,765,1433,2198,2420
0132-000,2017,6,27,10,763,864,1627,2198
0132-000,2017,6,27,11,717,765,1482,1627
0132-000,2017,6,27,12,633,822,1455,1482
0132-000,2017,6,27,13,618,694,1312,1455
0132-000,2017,6,27,14,725,746,1471,1312
0132-000,2017,6,27,15,782,724,1506,1471
0132-000,2017,6,27,16,829,747,1576,1506
0132-000,2017,6,27,17,854,782,1636,1576
0132-000,2017,6,27,18,1209,890,2099,1636
0132-000,2017,6,27,19,1373,807,2180,2099
0132-000,2017,6,27,20,909,625,1534,2180
0132-000,2017,6,27,21,846,490,1336,1534
0132-000,2017,6,27,22,557,465,1022,1336
0132-000,2017,6,27,23,299,289,588,1022
0132-000,2017,6,27,24,166,218,384,588
0132-000,2017,6,28,1,124,128,252,384
0132-000,2017,6,28,2,80,96,176,252
0132-000,2017,6,28,3,61,80,141,176
0132-000,2017,6,28,4,59,83,142,141
0132-000,2017,6,28,5,94,126,220,142
0132-000,2017,6,28,6,238,220,458,220
0132-000,2017,6,28,7,455,592,1047,458
0132-000,2017,6,28,8,641,1696,2337,1047
0132-000,2017,6,28,9,715,1442,2157,2337
0132-000,2017,6,28,10,740,865,1605,2157
0132-000,2017,6,28,11,666,792,1458,1605
0132-000,2017,6,28,12,736,745,1481,1458
0132-000,2017,6,28,13,641,688,1329,1481
0132-000,2017,6,28,14,628,742,1370,1329
0132-000,2017,6,28,15,770,794,1564,1370
0132-000,2017,6,28,16,746,720,1466,1564
0132-000,2017,6,28,17,797,739,1536,1466
0132-000,2017,6,28,18,1261,841,2102,1536
0132-000,2017,6,28,19,1390,786,2176,2102
0132-000,2017,6,28,20,919,699,1618,2176
0132-000,2017,6,28,21,814,510,1324,1618
0132-000,2017,6,28,22,576,417,993,1324
0132-000,2017,6,28,23,364,365,729,993
0132-000,2017,6,28,24,192,243,435,729
0132-000,2017,6,29,1,164,180,344,435
0132-000,2017,6,29,2,111,113,224,344
0132-000,2017,6,29,3,61,84,145,224
0132-000,2017,6,29,4,96,111,207,145
0132-000,2017,6,29,5,116,128,244,207
0132-000,2017,6,29,6,286,249,535,244
0132-000,2017,6,29,7,428,591,1019,535
0132-000,2017,6,29,8,641,1769,2410,1019
0132-000,2017,6,29,9,797,1384,2181,2410
0132-000,2017,6,29,10,694,826,1520,2181
0132-000,2017,6,29,11,729,801,1530,1520
0132-000,2017,6,29,12,651,731,1382,1530
0132-000,2017,6,29,13,611,655,1266,1382
0132-000,2017,6,29,14,702,702,1404,1266
0132-000,2017,6,29,15,749,717,1466,1404
0132-000,2017,6,29,16,763,764,1527,1466
0132-000,2017,6,29,17,808,770,1578,1527
0132-000,2017,6,29,18,1198,893,2091,1578
0132-000,2017,6,29,19,1389,780,2169,2091
0132-000,2017,6,29,20,882,685,1567,2169
0132-000,2017,6,29,21,844,519,1363,1567
0132-000,2017,6,29,22,594,470,1064,1363
0132-000,2017,6,29,23,350,338,688,1064
0132-000,2017,6,29,24,210,260,470,688
0132-000,2017,6,30,1,172,147,319,470
0132-000,2017,6,30,2,113,116,229,319
0132-000,2017,6,30,3,99,98,197,229
0132-000,2017,6,30,4,75,96,171,197
0132-000,2017,6,30,5,96,120,216,171
0132-000,2017,6,30,6,267,257,524,216
0132-000,2017,6,30,7,476,631,1107,524
0132-000,2017,6,30,8,651,1735,2386,1107
0132-000,2017,6,30,9,786,1439,2225,2386
0132-000,2017,6,30,10,730,768,1498,2225
0132-000,2017,6,30,11,715,744,1459,1498
0132-000,2017,6,30,12,742,736,1478,1459
0132-000,2017,6,30,13,708,701,1409,1478
0132-000,2017,6,30,14,766,768,1534,1409
0132-000,2017,6,30,15,810,793,1603,1534
0132-000,2017,6,30,16,849,773,1622,1603
0132-000,2017,6,30,17,940,850,1790,1622
0132-000,2017,6,30,18,1288,1003,2291,1790
0132-000,2017,6,30,19,1630,916,2546,2291
0132-000,2017,6,30,20,1050,853,1903,2546
0132-000,2017,6,30,21,851,595,1446,1903
0132-000,2017,6,30,22,724,499,1223,1446
0132-000,2017,6,30,23,433,366,799,1223
0132-000,2017,6,30,24,248,256,504,799
0132-000,2017,7,1,1,184,225,409,504
0132-000,2017,7,1,2,167,154,321,409
0132-000,2017,7,1,3,101,113,214,321
0132-000,2017,7,1,4,91,129,220,214
0132-000,2017,7,1,5,114,162,276,220
0132-000,2017,7,1,6,268,243,511,276
0132-000,2017,7,1,7,415,448,863,511
0132-000,2017,7,1,8,469,788,1257,863
0132-000,2017,7,1,9,614,854,1468,1257
0132-000,2017,7,1,10,686,770,1456,1468
0132-000,2017,7,1,11,681,793,1474,1456
0132-000,2017,7,1,12,768,851,1619,1474
0132-000,2017,7,1,13,856,880,1736,1619
0132-000,2017,7,1,14,846,849,1695,1736
0132-000,2017,7,1,15,814,908,1722,1695
0132-000,2017,7,1,16,855,874,1729,1722
0132-000,2017,7,1,17,939,868,1807,1729
0132-000,2017,7,1,18,1166,888,2054,1807
0132-000,2017,7,1,19,1079,767,1846,2054
0132-000,2017,7,1,20,701,573,1274,1846
0132-000,2017,7,1,21,561,502,1063,1274
0132-000,2017,7,1,22,476,393,869,1063
0132-000,2017,7,1,23,320,304,624,869
0132-000,2017,7,1,24,184,228,412,624
0132-000,2017,7,2,1,272,169,441,412
0132-000,2017,7,2,2,248,123,371,441
0132-000,2017,7,2,3,233,110,343,371
0132-000,2017,7,2,4,137,100,237,343
0132-000,2017,7,2,5,107,73,180,237
0132-000,2017,7,2,6,79,136,215,180
0132-000,2017,7,2,7,162,199,361,215
0132-000,2017,7,2,8,175,326,501,361
0132-000,2017,7,2,9,247,395,642,501
0132-000,2017,7,2,10,410,493,903,642
0132-000,2017,7,2,11,570,648,1218,903
0132-000,2017,7,2,12,521,639,1160,1218
0132-000,2017,7,2,13,641,680,1321,1160
0132-000,2017,7,2,14,684,695,1379,1321
0132-000,2017,7,2,15,737,671,1408,1379
0132-000,2017,7,2,16,733,719,1452,1408
0132-000,2017,7,2,17,814,643,1457,1452
0132-000,2017,7,2,18,789,625,1414,1457
0132-000,2017,7,2,19,725,539,1264,1414
0132-000,2017,7,2,20,738,500,1238,1264
0132-000,2017,7,2,21,477,392,869,1238
0132-000,2017,7,2,22,408,369,777,869
0132-000,2017,7,2,23,292,265,557,777
0132-000,2017,7,2,24,187,161,348,557
0132-000,2017,7,3,1,114,107,221,348
0132-000,2017,7,3,2,80,92,172,221
0132-000,2017,7,3,3,60,49,109,172
0132-000,2017,7,3,4,54,65,119,109
0132-000,2017,7,3,5,100,77,177,119
0132-000,2017,7,3,6,250,211,461,177
0132-000,2017,7,3,7,580,616,1196,461
0132-000,2017,7,3,8,600,1706,2306,1196
0132-000,2017,7,3,9,747,1477,2224,2306
0132-000,2017,7,3,10,691,753,1444,2224
0132-000,2017,7,3,11,649,726,1375,1444
0132-000,2017,7,3,12,673,749,1422,1375
0132-000,2017,7,3,13,679,694,1373,1422
0132-000,2017,7,3,14,666,677,1343,1373
0132-000,2017,7,3,15,733,693,1426,1343
0132-000,2017,7,3,16,731,734,1465,1426
0132-000,2017,7,3,17,813,732,1545,1465
0132-000,2017,7,3,18,1151,809,1960,1545
0132-000,2017,7,3,19,1321,777,2098,1960
0132-000,2017,7,3,20,887,602,1489,2098
0132-000,2017,7,3,21,816,495,1311,1489
0132-000,2017,7,3,22,549,366,915,1311
0132-000,2017,7,3,23,319,285,604,915
0132-000,2017,7,3,24,197,192,389,604
0132-000,2017,7,4,1,140,121,261,389
0132-000,2017,7,4,2,84,101,185,261
0132-000,2017,7,4,3,65,61,126,185
0132-000,2017,7,4,4,60,66,126,126
0132-000,2017,7,4,5,77,104,181,126
0132-000,2017,7,4,6,204,186,390,181
0132-000,2017,7,4,7,383,488,871,390
0132-000,2017,7,4,8,607,1706,2313,871
0132-000,2017,7,4,9,760,1547,2307,2313
0132-000,2017,7,4,10,690,784,1474,2307
0132-000,2017,7,4,11,692,787,1479,1474
0132-000,2017,7,4,12,651,735,1386,1479
0132-000,2017,7,4,13,692,680,1372,1386
0132-000,2017,7,4,14,740,716,1456,1372
0132-000,2017,7,4,15,770,771,1541,1456
0132-000,2017,7,4,16,781,707,1488,1541
0132-000,2017,7,4,17,824,745,1569,1488
0132-000,2017,7,4,18,1097,836,1933,1569
0132-000,2017,7,4,19,1384,831,2215,1933
0132-000,2017,7,4,20,948,657,1605,2215
0132-000,2017,7,4,21,862,537,1399,1605
0132-000,2017,7,4,22,617,450,1067,1399
0132-000,2017,7,4,23,385,320,705,1067
0132-000,2017,7,4,24,105,217,322,705
0132-000,2017,7,5,1,142,145,287,322
0132-000,2017,7,5,2,101,100,201,287
0132-000,2017,7,5,3,80,93,173,201
0132-000,2017,7,5,4,89,76,165,173
0132-000,2017,7,5,5,115,130,245,165
0132-000,2017,7,5,6,297,240,537,245
0132-000,2017,7,5,7,477,597,1074,537
0132-000,2017,7,5,8,640,1743,2383,1074
0132-000,2017,7,5,9,810,1479,2289,2383
0132-000,2017,7,5,10,727,840,1567,2289
0132-000,2017,7,5,11,721,712,1433,1567
0132-000,2017,7,5,12,714,765,1479,1433
0132-000,2017,7,5,13,734,641,1375,1479
0132-000,2017,7,5,14,777,726,1503,1375
0132-000,2017,7,5,15,737,756,1493,1503
0132-000,2017,7,5,16,889,757,1646,1493
0132-000,2017,7,5,17,775,772,1547,1646
0132-000,2017,7,5,18,1277,811,2088,1547
0132-000,2017,7,5,19,1506,865,2371,2088
0132-000,2017,7,5,20,958,745,1703,2371
0132-000,2017,7,5,21,764,533,1297,1703
0132-000,2017,7,5,22,578,390,968,1297
0132-000,2017,7,5,23,363,318,681,968
0132-000,2017,7,5,24,203,229,432,681
0132-000,2017,7,6,1,94,179,273,432
0132-000,2017,7,6,2,59,117,176,273
0132-000,2017,7,6,3,29,85,114,176
0132-000,2017,7,6,4,40,87,127,114
0132-000,2017,7,6,5,118,144,262,127
0132-000,2017,7,6,6,301,256,557,262
0132-000,2017,7,6,7,489,597,1086,557
0132-000,2017,7,6,8,664,1749,2413,1086
0132-000,2017,7,6,9,770,1424,2194,2413
0132-000,2017,7,6,10,746,824,1570,2194
0132-000,2017,7,6,11,671,770,1441,1570
0132-000,2017,7,6,12,709,742,1451,1441
0132-000,2017,7,6,13,675,650,1325,1451
0132-000,2017,7,6,14,722,717,1439,1325
0132-000,2017,7,6,15,765,750,1515,1439
0132-000,2017,7,6,16,773,743,1516,1515
0132-000,2017,7,6,17,788,730,1518,1516
0132-000,2017,7,6,18,1279,868,2147,1518
0132-000,2017,7,6,19,1450,841,2291,2147
0132-000,2017,7,6,20,940,684,1624,2291
0132-000,2017,7,6,21,825,504,1329,1624
0132-000,2017,7,6,22,628,449,1077,1329
0132-000,2017,7,6,23,367,333,700,1077
0132-000,2017,7,6,24,217,240,457,700
0132-000,2017,7,7,1,162,170,332,457
0132-000,2017,7,7,2,98,113,211,332
0132-000,2017,7,7,3,79,88,167,211
0132-000,2017,7,7,4,79,96,175,167
0132-000,2017,7,7,5,101,103,204,175
0132-000,2017,7,7,6,342,233,575,204
0132-000,2017,7,7,7,431,575,1006,575
0132-000,2017,7,7,8,584,1707,2291,1006
0132-000,2017,7,7,9,799,1310,2109,2291
0132-000,2017,7,7,10,778,765,1543,2109
0132-000,2017,7,7,11,745,787,1532,1543
0132-000,2017,7,7,12,758,793,1551,1532
0132-000,2017,7,7,13,755,689,1444,1551
0132-000,2017,7,7,14,756,759,1515,1444
0132-000,2017,7,7,15,784,795,1579,1515
0132-000,2017,7,7,16,905,753,1658,1579
0132-000,2017,7,7,17,868,832,1700,1658
0132-000,2017,7,7,18,1393,894,2287,1700
0132-000,2017,7,7,19,1582,835,2417,2287
0132-000,2017,7,7,20,1000,717,1717,2417
0132-000,2017,7,7,21,848,532,1380,1717
0132-000,2017,7,7,22,641,400,1041,1380
0132-000,2017,7,7,23,371,348,719,1041
0132-000,2017,7,7,24,231,250,481,719
0132-000,2017,7,8,1,155,192,347,481
0132-000,2017,7,8,2,136,125,261,347
0132-000,2017,7,8,3,93,109,202,261
0132-000,2017,7,8,4,93,111,204,202
0132-000,2017,7,8,5,93,130,223,204
0132-000,2017,7,8,6,197,200,397,223
0132-000,2017,7,8,7,284,365,649,397
0132-000,2017,7,8,8,419,706,1125,649
0132-000,2017,7,8,9,559,847,1406,1125
0132-000,2017,7,8,10,587,709,1296,1406
0132-000,2017,7,8,11,644,852,1496,1296
0132-000,2017,7,8,12,731,829,1560,1496
0132-000,2017,7,8,13,716,832,1548,1560
0132-000,2017,7,8,14,734,864,1598,1548
0132-000,2017,7,8,15,749,787,1536,1598
0132-000,2017,7,8,16,816,757,1573,1536
0132-000,2017,7,8,17,903,783,1686,1573
0132-000,2017,7,8,18,1181,796,1977,1686
0132-000,2017,7,8,19,1195,745,1940,1977
0132-000,2017,7,8,20,695,559,1254,1940
0132-000,2017,7,8,21,560,462,1022,1254
0132-000,2017,7,8,22,492,413,905,1022
0132-000,2017,7,8,23,384,322,706,905
0132-000,2017,7,8,24,219,262,481,706
0132-000,2017,7,9,1,147,194,341,481
0132-000,2017,7,9,2,142,121,263,341
0132-000,2017,7,9,3,155,111,266,263
0132-000,2017,7,9,4,83,85,168,266
0132-000,2017,7,9,5,72,86,158,168
0132-000,2017,7,9,6,127,136,263,158
0132-000,2017,7,9,7,183,202,385,263
0132-000,2017,7,9,8,220,307,527,385
0132-000,2017,7,9,9,342,403,745,527
0132-000,2017,7,9,10,408,482,890,745
0132-000,2017,7,9,11,518,615,1133,890
0132-000,2017,7,9,12,470,576,1046,1133
0132-000,2017,7,9,13,571,565,1136,1046
0132-000,2017,7,9,14,640,621,1261,1136
0132-000,2017,7,9,15,710,634,1344,1261
0132-000,2017,7,9,16,688,609,1297,1344
0132-000,2017,7,9,17,740,614,1354,1297
0132-000,2017,7,9,18,837,621,1458,1354
0132-000,2017,7,9,19,793,606,1399,1458
0132-000,2017,7,9,20,739,495,1234,1399
0132-000,2017,7,9,21,555,444,999,1234
0132-000,2017,7,9,22,449,430,879,999
0132-000,2017,7,9,23,284,314,598,879
0132-000,2017,7,9,24,182,189,371,598
0132-000,2017,7,10,1,114,90,204,371
0132-000,2017,7,10,2,66,67,133,204
0132-000,2017,7,10,3,43,62,105,133
0132-000,2017,7,10,4,51,72,123,105
0132-000,2017,7,10,5,100,98,198,123
0132-000,2017,7,10,6,291,210,501,198
0132-000,2017,7,10,7,433,642,1075,501
0132-000,2017,7,10,8,613,1791,2404,1075
0132-000,2017,7,10,9,772,1498,2270,2404
0132-000,2017,7,10,10,638,698,1336,2270
0132-000,2017,7,10,11,574,673,1247,1336
0132-000,2017,7,10,12,654,696,1350,1247
0132-000,2017,7,10,13,628,667,1295,1350
0132-000,2017,7,10,14,637,740,1377,1295
0132-000,2017,7,10,15,734,728,1462,1377
0132-000,2017,7,10,16,729,679,1408,1462
0132-000,2017,7,10,17,794,702,1496,1408
0132-000,2017,7,10,18,1119,788,1907,1496
0132-000,2017,7,10,19,1358,806,2164,1907
0132-000,2017,7,10,20,882,628,1510,2164
0132-000,2017,7,10,21,750,494,1244,1510
0132-000,2017,7,10,22,551,353,904,1244
0132-000,2017,7,10,23,342,289,631,904
0132-000,2017,7,10,24,201,169,370,631
0132-000,2017,7,11,1,148,136,284,370
0132-000,2017,7,11,2,104,96,200,284
0132-000,2017,7,11,3,76,73,149,200
0132-000,2017,7,11,4,58,72,130,149
0132-000,2017,7,11,5,78,93,171,130
0132-000,2017,7,11,6,267,208,475,171
0132-000,2017,7,11,7,421,569,990,475
0132-000,2017,7,11,8,632,1774,2406,990
0132-000,2017,7,11,9,735,1392,2127,2406
0132-000,2017,7,11,10,743,849,1592,2127
0132-000,2017,7,11,11,717,774,1491,1592
0132-000,2017,7,11,12,703,770,1473,1491
0132-000,2017,7,11,13,740,755,1495,1473
0132-000,2017,7,11,14,741,781,1522,1495
0132-000,2017,7,11,15,759,734,1493,1522
0132-000,2017,7,11,16,847,767,1614,1493
0132-000,2017,7,11,17,807,759,1566,1614
0132-000,2017,7,11,18,1168,858,2026,1566
0132-000,2017,7,11,19,1452,815,2267,2026
0132-000,2017,7,11,20,996,692,1688,2267
0132-000,2017,7,11,21,861,501,1362,1688
0132-000,2017,7,11,22,618,409,1027,1362
0132-000,2017,7,11,23,379,309,688,1027
0132-000,2017,7,11,24,189,215,404,688
0132-000,2017,7,12,1,169,161,330,404
0132-000,2017,7,12,2,96,114,210,330
0132-000,2017,7,12,3,61,110,171,210
0132-000,2017,7,12,4,69,76,145,171
0132-000,2017,7,12,5,87,134,221,145
0132-000,2017,7,12,6,291,229,520,221
0132-000,2017,7,12,7,437,564,1001,520
0132-000,2017,7,12,8,649,1767,2416,1001
0132-000,2017,7,12,9,783,1437,2220,2416
0132-000,2017,7,12,10,750,796,1546,2220
0132-000,2017,7,12,11,731,819,1550,1546
0132-000,2017,7,12,12,719,759,1478,1550
0132-000,2017,7,12,13,665,669,1334,1478
0132-000,2017,7,12,14,692,735,1427,1334
0132-000,2017,7,12,15,803,770,1573,1427
0132-000,2017,7,12,16,787,720,1507,1573
0132-000,2017,7,12,17,861,817,1678,1507
0132-000,2017,7,12,18,1270,893,2163,1678
0132-000,2017,7,12,19,1507,760,2267,2163
0132-000,2017,7,12,20,973,798,1771,2267
0132-000,2017,7,12,21,760,573,1333,1771
0132-000,2017,7,12,22,571,450,1021,1333
0132-000,2017,7,12,23,377,287,664,1021
0132-000,2017,7,12,24,216,225,441,664
0132-000,2017,7,13,1,170,168,338,441
0132-000,2017,7,13,2,112,107,219,338
0132-000,2017,7,13,3,69,96,165,219
0132-000,2017,7,13,4,82,89,171,165
0132-000,2017,7,13,5,117,130,247,171
0132-000,2017,7,13,6,302,215,517,247
0132-000,2017,7,13,7,452,588,1040,517
0132-000,2017,7,13,8,636,1771,2407,1040
0132-000,2017,7,13,9,752,1444,2196,2407
0132-000,2017,7,13,10,702,787,1489,2196
0132-000,2017,7,13,11,680,734,1414,1489
0132-000,2017,7,13,12,700,746,1446,1414
0132-000,2017,7,13,13,665,731,1396,1446
0132-000,2017,7,13,14,703,721,1424,1396
0132-000,2017,7,13,15,778,784,1562,1424
0132-000,2017,7,13,16,798,689,1487,1562
0132-000,2017,7,13,17,895,810,1705,1487
0132-000,2017,7,13,18,1242,896,2138,1705
0132-000,2017,7,13,19,1312,820,2132,2138
0132-000,2017,7,13,20,970,703,1673,2132
0132-000,2017,7,13,21,882,515,1397,1673
0132-000,2017,7,13,22,616,478,1094,1397
0132-000,2017,7,13,23,355,317,672,1094
0132-000,2017,7,13,24,229,228,457,672
0132-000,2017,7,14,1,173,142,315,457
0132-000,2017,7,14,2,116,124,240,315
0132-000,2017,7,14,3,67,102,169,240
0132-000,2017,7,14,4,61,81,142,169
0132-000,2017,7,14,5,95,117,212,142
0132-000,2017,7,14,6,308,232,540,212
0132-000,2017,7,14,7,481,592,1073,540
0132-000,2017,7,14,8,686,1793,2479,1073
0132-000,2017,7,14,9,809,1388,2197,2479
0132-000,2017,7,14,10,706,842,1548,2197
0132-000,2017,7,14,11,712,788,1500,1548
0132-000,2017,7,14,12,757,781,1538,1500
0132-000,2017,7,14,13,729,788,1517,1538
0132-000,2017,7,14,14,718,769,1487,1517
0132-000,2017,7,14,15,768,768,1536,1487
0132-000,2017,7,14,16,853,773,1626,1536
0132-000,2017,7,14,17,932,790,1722,1626
0132-000,2017,7,14,18,1317,945,2262,1722
0132-000,2017,7,14,19,1636,876,2512,2262
0132-000,2017,7,14,20,1081,774,1855,2512
0132-000,2017,7,14,21,855,625,1480,1855
0132-000,2017,7,14,22,647,454,1101,1480
0132-000,2017,7,14,23,377,399,776,1101
0132-000,2017,7,14,24,243,263,506,776
0132-000,2017,7,15,1,206,194,400,506
0132-000,2017,7,15,2,161,162,323,400
0132-000,2017,7,15,3,109,121,230,323
0132-000,2017,7,15,4,85,135,220,230
0132-000,2017,7,15,5,112,110,222,220
0132-000,2017,7,15,6,211,169,380,222
0132-000,2017,7,15,7,370,395,765,380
0132-000,2017,7,15,8,444,779,1223,765
0132-000,2017,7,15,9,546,889,1435,1223
0132-000,2017,7,15,10,701,794,1495,1435
0132-000,2017,7,15,11,667,764,1431,1495
0132-000,2017,7,15,12,788,834,1622,1431
0132-000,2017,7,15,13,799,826,1625,1622
0132-000,2017,7,15,14,779,847,1626,1625
0132-000,2017,7,15,15,823,837,1660,1626
0132-000,2017,7,15,16,864,888,1752,1660
0132-000,2017,7,15,17,882,817,1699,1752
0132-000,2017,7,15,18,1124,858,1982,1699
0132-000,2017,7,15,19,993,790,1783,1982
0132-000,2017,7,15,20,631,620,1251,1783
0132-000,2017,7,15,21,550,493,1043,1251
0132-000,2017,7,15,22,536,383,919,1043
0132-000,2017,7,15,23,320,298,618,919
0132-000,2017,7,15,24,179,232,411,618
0132-000,2017,7,16,1,150,169,319,411
0132-000,2017,7,16,2,134,162,296,319
0132-000,2017,7,16,3,98,106,204,296
0132-000,2017,7,16,4,59,85,144,204
0132-000,2017,7,16,5,98,76,174,144
0132-000,2017,7,16,6,100,92,192,174
0132-000,2017,7,16,7,160,180,340,192
0132-000,2017,7,16,8,255,314,569,340
0132-000,2017,7,16,9,325,399,724,569
0132-000,2017,7,16,10,441,461,902,724
0132-000,2017,7,16,11,417,597,1014,902
0132-000,2017,7,16,12,467,643,1110,1014
0132-000,2017,7,16,13,600,630,1230,1110
0132-000,2017,7,16,14,646,652,1298,1230
0132-000,2017,7,16,15,746,673,1419,1298
0132-000,2017,7,16,16,846,655,1501,1419
0132-000,2017,7,16,17,806,669,1475,1501
0132-000,2017,7,16,18,795,594,1389,1475
0132-000,2017,7,16,19,712,523,1235,1389
0132-000,2017,7,16,20,666,465,1131,1235
0132-000,2017,7,16,21,536,414,950,1131
0132-000,2017,7,16,22,386,359,745,950
0132-000,2017,7,16,23,262,283,545,745
0132-000,2017,7,16,24,136,169,305,545
0132-000,2017,7,17,1,118,109,227,305
0132-000,2017,7,17,2,71,90,161,227
0132-000,2017,7,17,3,52,68,120,161
0132-000,2017,7,17,4,61,63,124,120
0132-000,2017,7,17,5,81,84,165,124
0132-000,2017,7,17,6,279,244,523,165
0132-000,2017,7,17,7,478,650,1128,523
0132-000,2017,7,17,8,660,1767,2427,1128
0132-000,2017,7,17,9,740,1453,2193,2427
0132-000,2017,7,17,10,724,808,1532,2193
0132-000,2017,7,17,11,726,839,1565,1532
0132-000,2017,7,17,12,673,738,1411,1565
0132-000,2017,7,17,13,633,645,1278,1411
0132-000,2017,7,17,14,741,758,1499,1278
0132-000,2017,7,17,15,730,739,1469,1499
0132-000,2017,7,17,16,785,745,1530,1469
0132-000,2017,7,17,17,866,742,1608,1530
0132-000,2017,7,17,18,1147,855,2002,1608
0132-000,2017,7,17,19,1310,804,2114,2002
0132-000,2017,7,17,20,921,652,1573,2114
0132-000,2017,7,17,21,788,462,1250,1573
0132-000,2017,7,17,22,564,405,969,1250
0132-000,2017,7,17,23,324,275,599,969
0132-000,2017,7,17,24,209,198,407,599
0132-000,2017,7,18,1,143,131,274,407
0132-000,2017,7,18,2,97,104,201,274
0132-000,2017,7,18,3,62,93,155,201
0132-000,2017,7,18,4,63,82,145,155
0132-000,2017,7,18,5,98,110,208,145
0132-000,2017,7,18,6,279,212,491,208
0132-000,2017,7,18,7,445,566,1011,491
0132-000,2017,7,18,8,599,1774,2373,1011
0132-000,2017,7,18,9,814,1424,2238,2373
0132-000,2017,7,18,10,770,809,1579,2238
0132-000,2017,7,18,11,722,824,1546,1579
0132-000,2017,7,18,12,672,731,1403,1546
0132-000,2017,7,18,13,665,728,1393,1403
0132-000,2017,7,18,14,720,693,1413,1393
0132-000,2017,7,18,15,733,764,1497,1413
0132-000,2017,7,18,16,733,739,1472,1497
0132-000,2017,7,18,17,850,769,1619,1472
0132-000,2017,7,18,18,1156,824,1980,1619
0132-000,2017,7,18,19,1382,802,2184,1980
0132-000,2017,7,18,20,996,701,1697,2184
0132-000,2017,7,18,21,859,529,1388,1697
0132-000,2017,7,18,22,556,419,975,1388
0132-000,2017,7,18,23,384,325,709,975
0132-000,2017,7,18,24,201,213,414,709
0132-000,2017,7,19,1,142,136,278,414
0132-000,2017,7,19,2,101,104,205,278
0132-000,2017,7,19,3,71,83,154,205
0132-000,2017,7,19,4,62,73,135,154
0132-000,2017,7,19,5,98,124,222,135
0132-000,2017,7,19,6,293,213,506,222
0132-000,2017,7,19,7,488,586,1074,506
0132-000,2017,7,19,8,636,1727,2363,1074
0132-000,2017,7,19,9,768,1438,2206,2363
0132-000,2017,7,19,10,721,802,1523,2206
0132-000,2017,7,19,11,700,771,1471,1523
0132-000,2017,7,19,12,696,750,1446,1471
0132-000,2017,7,19,13,666,676,1342,1446
0132-000,2017,7,19,14,714,679,1393,1342
0132-000,2017,7,19,15,756,766,1522,1393
0132-000,2017,7,19,16,787,755,1542,1522
0132-000,2017,7,19,17,843,758,1601,1542
0132-000,2017,7,19,18,1273,899,2172,1601
0132-000,2017,7,19,19,1435,846,2281,2172
0132-000,2017,7,19,20,937,692,1629,2281
0132-000,2017,7,19,21,768,493,1261,1629
0132-000,2017,7,19,22,524,450,974,1261
0132-000,2017,7,19,23,391,325,716,974
0132-000,2017,7,19,24,246,227,473,716
0132-000,2017,7,20,1,175,170,345,473
0132-000,2017,7,20,2,109,111,220,345
0132-000,2017,7,20,3,75,98,173,220
0132-000,2017,7,20,4,79,77,156,173
0132-000,2017,7,20,5,99,119,218,156
0132-000,2017,7,20,6,311,225,536,218
0132-000,2017,7,20,7,449,639,1088,536
0132-000,2017,7,20,8,665,1803,2468,1088
0132-000,2017,7,20,9,799,1416,2215,2468
0132-000,2017,7,20,10,772,861,1633,2215
0132-000,2017,7,20,11,704,854,1558,1633
0132-000,2017,7,20,12,718,811,1529,1558
0132-000,2017,7,20,13,690,730,1420,1529
0132-000,2017,7,20,14,775,783,1558,1420
0132-000,2017,7,20,15,796,803,1599,1558
0132-000,2017,7,20,16,819,766,1585,1599
0132-000,2017,7,20,17,822,854,1676,1585
0132-000,2017,7,20,18,1240,890,2130,1676
0132-000,2017,7,20,19,1413,833,2246,2130
0132-000,2017,7,20,20,941,657,1598,2246
0132-000,2017,7,20,21,920,551,1471,1598
0132-000,2017,7,20,22,594,438,1032,1471
0132-000,2017,7,20,23,393,335,728,1032
0132-000,2017,7,20,24,259,212,471,728
0132-000,2017,7,21,1,175,177,352,471
0132-000,2017,7,21,2,133,135,268,352
0132-000,2017,7,21,3,66,104,170,268
0132-000,2017,7,21,4,80,106,186,170
0132-000,2017,7,21,5,94,103,197,186
0132-000,2017,7,21,6,290,230,520,197
0132-000,2017,7,21,7,450,664,1114,520
0132-000,2017,7,21,8,612,1825,2437,1114
0132-000,2017,7,21,9,835,1403,2238,2437
0132-000,2017,7,21,10,720,824,1544,2238
0132-000,2017,7,21,11,712,763,1475,1544
0132-000,2017,7,21,12,736,813,1549,1475
0132-000,2017,7,21,13,736,751,1487,1549
0132-000,2017,7,21,14,740,747,1487,1487
0132-000,2017,7,21,15,812,821,1633,1487
0132-000,2017,7,21,16,836,741,1577,1633
0132-000,2017,7,21,17,815,825,1640,1577
0132-000,2017,7,21,18,1334,894,2228,1640
0132-000,2017,7,21,19,1546,880,2426,2228
0132-000,2017,7,21,20,1163,794,1957,2426
0132-000,2017,7,21,21,895,530,1425,1957
0132-000,2017,7,21,22,669,460,1129,1425
0132-000,2017,7,21,23,398,349,747,1129
0132-000,2017,7,21,24,265,277,542,747
0132-000,2017,7,22,1,155,221,376,542
0132-000,2017,7,22,2,134,142,276,376
0132-000,2017,7,22,3,96,119,215,276
0132-000,2017,7,22,4,79,123,202,215
0132-000,2017,7,22,5,106,120,226,202
0132-000,2017,7,22,6,268,245,513,226
0132-000,2017,7,22,7,392,459,851,513
0132-000,2017,7,22,8,440,843,1283,851
0132-000,2017,7,22,9,696,875,1571,1283
0132-000,2017,7,22,10,713,880,1593,1571
0132-000,2017,7,22,11,688,800,1488,1593
0132-000,2017,7,22,12,719,875,1594,1488
0132-000,2017,7,22,13,822,876,1698,1594
0132-000,2017,7,22,14,803,802,1605,1698
0132-000,2017,7,22,15,774,814,1588,1605
0132-000,2017,7,22,16,882,814,1696,1588
0132-000,2017,7,22,17,950,868,1818,1696
0132-000,2017,7,22,18,1202,947,2149,1818
0132-000,2017,7,22,19,1064,853,1917,2149
0132-000,2017,7,22,20,700,697,1397,1917
0132-000,2017,7,22,21,621,535,1156,1397
0132-000,2017,7,22,22,572,423,995,1156
0132-000,2017,7,22,23,349,332,681,995
0132-000,2017,7,22,24,200,232,432,681
0132-000,2017,7,23,1,178,176,354,432
0132-000,2017,7,23,2,110,111,221,354
0132-000,2017,7,23,3,99,86,185,221
0132-000,2017,7,23,4,84,97,181,185
0132-000,2017,7,23,5,79,109,188,181
0132-000,2017,7,23,6,150,121,271,188
0132-000,2017,7,23,7,187,228,415,271
0132-000,2017,7,23,8,264,372,636,415
0132-000,2017,7,23,9,314,445,759,636
0132-000,2017,7,23,10,420,433,853,759
0132-000,2017,7,23,11,459,532,991,853
0132-000,2017,7,23,12,535,533,1068,991
0132-000,2017,7,23,13,616,565,1181,1068
0132-000,2017,7,23,14,672,608,1280,1181
0132-000,2017,7,23,15,671,620,1291,1280
0132-000,2017,7,23,16,669,646,1315,1291
0132-000,2017,7,23,17,772,610,1382,1315
0132-000,2017,7,23,18,796,665,1461,1382
0132-000,2017,7,23,19,731,579,1310,1461
0132-000,2017,7,23,20,687,519,1206,1310
0132-000,2017,7,23,21,523,433,956,1206
0132-000,2017,7,23,22,375,363,738,956
0132-000,2017,7,23,23,262,247,509,738
0132-000,2017,7,23,24,188,197,385,509
0132-000,2017,7,24,1,98,110,208,385
0132-000,2017,7,24,2,73,92,165,208
0132-000,2017,7,24,3,41,69,110,165
0132-000,2017,7,24,4,51,76,127,110
0132-000,2017,7,24,5,103,71,174,127
0132-000,2017,7,24,6,296,250,546,174
0132-000,2017,7,24,7,471,649,1120,546
0132-000,2017,7,24,8,637,1870,2507,1120
0132-000,2017,7,24,9,737,1381,2118,2507
0132-000,2017,7,24,10,721,776,1497,2118
0132-000,2017,7,24,11,681,711,1392,1497
0132-000,2017,7,24,12,690,758,1448,1392
0132-000,2017,7,24,13,674,766,1440,1448
0132-000,2017,7,24,14,652,699,1351,1440
0132-000,2017,7,24,15,654,712,1366,1351
0132-000,2017,7,24,16,775,683,1458,1366
0132-000,2017,7,24,17,818,709,1527,1458
0132-000,2017,7,24,18,1075,781,1856,1527
0132-000,2017,7,24,19,1301,786,2087,1856
0132-000,2017,7,24,20,907,625,1532,2087
0132-000,2017,7,24,21,845,484,1329,1532
0132-000,2017,7,24,22,584,379,963,1329
0132-000,2017,7,24,23,328,269,597,963
0132-000,2017,7,24,24,213,207,420,597
0132-000,2017,7,25,1,139,132,271,420
0132-000,2017,7,25,2,88,102,190,271
0132-000,2017,7,25,3,68,85,153,190
0132-000,2017,7,25,4,69,68,137,153
0132-000,2017,7,25,5,70,109,179,137
0132-000,2017,7,25,6,258,223,481,179
0132-000,2017,7,25,7,422,560,982,481
0132-000,2017,7,25,8,636,1732,2368,982
0132-000,2017,7,25,9,778,1423,2201,2368
0132-000,2017,7,25,10,729,856,1585,2201
0132-000,2017,7,25,11,709,776,1485,1585
0132-000,2017,7,25,12,673,808,1481,1485
0132-000,2017,7,25,13,728,693,1421,1481
0132-000,2017,7,25,14,738,813,1551,1421
0132-000,2017,7,25,15,797,747,1544,1551
0132-000,2017,7,25,16,840,770,1610,1544
0132-000,2017,7,25,17,857,740,1597,1610
0132-000,2017,7,25,18,1224,846,2070,1597
0132-000,2017,7,25,19,1422,810,2232,2070
0132-000,2017,7,25,20,955,704,1659,2232
0132-000,2017,7,25,21,885,545,1430,1659
0132-000,2017,7,25,22,648,470,1118,1430
0132-000,2017,7,25,23,365,322,687,1118
0132-000,2017,7,25,24,226,228,454,687
0132-000,2017,7,26,1,177,179,356,454
0132-000,2017,7,26,2,134,143,277,356
0132-000,2017,7,26,3,71,96,167,277
0132-000,2017,7,26,4,86,91,177,167
0132-000,2017,7,26,5,91,121,212,177
0132-000,2017,7,26,6,285,256,541,212
0132-000,2017,7,26,7,473,600,1073,541
0132-000,2017,7,26,8,581,1788,2369,1073
0132-000,2017,7,26,9,741,1349,2090,2369
0132-000,2017,7,26,10,718,815,1533,2090
0132-000,2017,7,26,11,662,763,1425,1533
0132-000,2017,7,26,12,735,774,1509,1425
0132-000,2017,7,26,13,717,705,1422,1509
0132-000,2017,7,26,14,723,782,1505,1422
0132-000,2017,7,26,15,752,747,1499,1505
0132-000,2017,7,26,16,808,735,1543,1499
0132-000,2017,7,26,17,831,770,1601,1543
0132-000,2017,7,26,18,1263,849,2112,1601
0132-000,2017,7,26,19,1527,804,2331,2112
0132-000,2017,7,26,20,1049,667,1716,2331
0132-000,2017,7,26,21,865,559,1424,1716
0132-000,2017,7,26,22,577,477,1054,1424
0132-000,2017,7,26,23,398,308,706,1054
0132-000,2017,7,26,24,232,257,489,706
0132-000,2017,7,27,1,152,177,329,489
0132-000,2017,7,27,2,105,133,238,329
0132-000,2017,7,27,3,71,92,163,238
0132-000,2017,7,27,4,80,118,198,163
0132-000,2017,7,27,5,79,101,180,198
0132-000,2017,7,27,6,301,240,541,180
0132-000,2017,7,27,7,461,588,1049,541
0132-000,2017,7,27,8,647,1587,2234,1049
0132-000,2017,7,27,9,745,1420,2165,2234
0132-000,2017,7,27,10,755,806,1561,2165
0132-000,2017,7,27,11,716,870,1586,1561
0132-000,2017,7,27,12,737,819,1556,1586
0132-000,2017,7,27,13,721,708,1429,1556
0132-000,2017,7,27,14,747,806,1553,1429
0132-000,2017,7,27,15,780,779,1559,1553
0132-000,2017,7,27,16,803,747,1550,1559
0132-000,2017,7,27,17,897,817,1714,1550
0132-000,2017,7,27,18,1229,924,2153,1714
0132-000,2017,7,27,19,1468,871,2339,2153
0132-000,2017,7,27,20,950,666,1616,2339
0132-000,2017,7,27,21,810,479,1289,1616
0132-000,2017,7,27,22,577,466,1043,1289
0132-000,2017,7,27,23,388,375,763,1043
0132-000,2017,7,27,24,233,284,517,763
0132-000,2017,7,28,1,170,173,343,517
0132-000,2017,7,28,2,110,125,235,343
0132-000,2017,7,28,3,66,102,168,235
0132-000,2017,7,28,4,68,80,148,168
0132-000,2017,7,28,5,81,109,190,148
0132-000,2017,7,28,6,231,207,438,190
0132-000,2017,7,28,7,432,544,976,438
0132-000,2017,7,28,8,587,1600,2187,976
0132-000,2017,7,28,9,698,1396,2094,2187
0132-000,2017,7,28,10,707,786,1493,2094
0132-000,2017,7,28,11,694,739,1433,1493
0132-000,2017,7,28,12,696,783,1479,1433
0132-000,2017,7,28,13,724,784,1508,1479
0132-000,2017,7,28,14,721,806,1527,1508
0132-000,2017,7,28,15,786,794,1580,1527
0132-000,2017,7,28,16,824,743,1567,1580
0132-000,2017,7,28,17,919,772,1691,1567
0132-000,2017,7,28,18,1284,844,2128,1691
0132-000,2017,7,28,19,1616,893,2509,2128
0132-000,2017,7,28,20,1000,771,1771,2509
0132-000,2017,7,28,21,793,552,1345,1771
0132-000,2017,7,28,22,577,453,1030,1345
0132-000,2017,7,28,23,368,322,690,1030
0132-000,2017,7,28,24,233,244,477,690
0132-000,2017,7,29,1,169,205,374,477
0132-000,2017,7,29,2,124,153,277,374
0132-000,2017,7,29,3,98,109,207,277
0132-000,2017,7,29,4,91,128,219,207
0132-000,2017,7,29,5,91,112,203,219
0132-000,2017,7,29,6,240,194,434,203
0132-000,2017,7,29,7,358,392,750,434
0132-000,2017,7,29,8,441,775,1216,750
0132-000,2017,7,29,9,608,860,1468,1216
0132-000,2017,7,29,10,636,874,1510,1468
0132-000,2017,7,29,11,674,973,1647,1510
0132-000,2017,7,29,12,784,996,1780,1647
0132-000,2017,7,29,13,798,980,1778,1780
0132-000,2017,7,29,14,781,944,1725,1778
0132-000,2017,7,29,15,813,833,1646,1725
0132-000,2017,7,29,16,828,854,1682,1646
0132-000,2017,7,29,17,917,860,1777,1682
0132-000,2017,7,29,18,972,883,1855,1777
0132-000,2017,7,29,19,962,794,1756,1855
0132-000,2017,7,29,20,675,627,1302,1756
0132-000,2017,7,29,21,584,470,1054,1302
0132-000,2017,7,29,22,497,424,921,1054
0132-000,2017,7,29,23,330,300,630,921
0132-000,2017,7,29,24,194,230,424,630
0132-000,2017,7,30,1,157,164,321,424
0132-000,2017,7,30,2,129,144,273,321
0132-000,2017,7,30,3,85,92,177,273
0132-000,2017,7,30,4,80,82,162,177
0132-000,2017,7,30,5,88,92,180,162
0132-000,2017,7,30,6,153,156,309,180
0132-000,2017,7,30,7,198,252,450,309
0132-000,2017,7,30,8,263,347,610,450
0132-000,2017,7,30,9,366,463,829,610
0132-000,2017,7,30,10,426,545,971,829
0132-000,2017,7,30,11,452,638,1090,971
0132-000,2017,7,30,12,488,613,1101,1090
0132-000,2017,7,30,13,562,642,1204,1101
0132-000,2017,7,30,14,640,639,1279,1204
0132-000,2017,7,30,15,620,604,1224,1279
0132-000,2017,7,30,16,699,656,1355,1224
0132-000,2017,7,30,17,813,591,1404,1355
0132-000,2017,7,30,18,879,646,1525,1404
0132-000,2017,7,30,19,830,540,1370,1525
0132-000,2017,7,30,20,754,483,1237,1370
0132-000,2017,7,30,21,597,414,1011,1237
0132-000,2017,7,30,22,399,335,734,1011
0132-000,2017,7,30,23,260,286,546,734
0132-000,2017,7,30,24,190,203,393,546
0132-000,2017,7,31,1,101,115,216,393
0132-000,2017,7,31,2,80,94,174,216
0132-000,2017,7,31,3,60,69,129,174
0132-000,2017,7,31,4,43,61,104,129
0132-000,2017,7,31,5,79,78,157,104
0132-000,2017,7,31,6,257,195,452,157
0132-000,2017,7,31,7,412,456,868,452
0132-000,2017,7,31,8,487,1168,1655,868
0132-000,2017,7,31,9,622,1092,1714,1655
0132-000,2017,7,31,10,548,605,1153,1714
0132-000,2017,7,31,11,521,727,1248,1153
0132-000,2017,7,31,12,588,806,1394,1248
0132-000,2017,7,31,13,563,785,1348,1394
0132-000,2017,7,31,14,666,704,1370,1348
0132-000,2017,7,31,15,680,666,1346,1370
0132-000,2017,7,31,16,717,671,1388,1346
0132-000,2017,7,31,17,745,676,1421,1388
0132-000,2017,7,31,18,1025,713,1738,1421
0132-000,2017,7,31,19,1085,692,1777,1738
0132-000,2017,7,31,20,750,540,1290,1777
0132-000,2017,7,31,21,588,419,1007,1290
0132-000,2017,7,31,22,427,329,756,1007
0132-000,2017,7,31,23,295,273,568,756
0132-000,2017,7,31,24,183,196,379,568
0132-000,2017,8,1,1,131,119,250,379
0132-000,2017,8,1,2,74,92,166,250
0132-000,2017,8,1,3,57,77,134,166
0132-000,2017,8,1,4,60,66,126,134
0132-000,2017,8,1,5,91,90,181,126
0132-000,2017,8,1,6,201,152,353,181
0132-000,2017,8,1,7,359,438,797,353
0132-000,2017,8,1,8,520,1109,1629,797
0132-000,2017,8,1,9,598,1066,1664,1629
0132-000,2017,8,1,10,614,678,1292,1664
0132-000,2017,8,1,11,632,703,1335,1292
0132-000,2017,8,1,12,662,730,1392,1335
0132-000,2017,8,1,13,661,754,1415,1392
0132-000,2017,8,1,14,693,730,1423,1415
0132-000,2017,8,1,15,750,759,1509,1423
0132-000,2017,8,1,16,752,683,1435,1509
0132-000,2017,8,1,17,788,672,1460,1435
0132-000,2017,8,1,18,1046,847,1893,1460
0132-000,2017,8,1,19,1239,809,2048,1893
0132-000,2017,8,1,20,810,623,1433,2048
0132-000,2017,8,1,21,694,525,1219,1433
0132-000,2017,8,1,22,578,358,936,1219
0132-000,2017,8,1,23,368,322,690,936
0132-000,2017,8,1,24,179,205,384,690
0132-000,2017,8,2,1,165,157,322,384
0132-000,2017,8,2,2,100,93,193,322
0132-000,2017,8,2,3,71,90,161,193
0132-000,2017,8,2,4,67,83,150,161
0132-000,2017,8,2,5,100,88,188,150
0132-000,2017,8,2,6,254,205,459,188
0132-000,2017,8,2,7,417,450,867,459
0132-000,2017,8,2,8,504,1133,1637,867
0132-000,2017,8,2,9,660,1059,1719,1637
0132-000,2017,8,2,10,668,727,1395,1719
0132-000,2017,8,2,11,624,742,1366,1395
0132-000,2017,8,2,12,718,749,1467,1366
0132-000,2017,8,2,13,690,727,1417,1467
0132-000,2017,8,2,14,736,772,1508,1417
0132-000,2017,8,2,15,774,741,1515,1508
0132-000,2017,8,2,16,729,760,1489,1515
0132-000,2017,8,2,17,713,717,1430,1489
0132-000,2017,8,2,18,1049,844,1893,1430
0132-000,2017,8,2,19,1286,753,2039,1893
0132-000,2017,8,2,20,832,609,1441,2039
0132-000,2017,8,2,21,657,516,1173,1441
0132-000,2017,8,2,22,483,378,861,1173
0132-000,2017,8,2,23,289,300,589,861
0132-000,2017,8,2,24,225,231,456,589
0132-000,2017,8,3,1,157,159,316,456
0132-000,2017,8,3,2,92,108,200,316
0132-000,2017,8,3,3,63,89,152,200
0132-000,2017,8,3,4,63,92,155,152
0132-000,2017,8,3,5,101,84,185,155
0132-000,2017,8,3,6,282,187,469,185
0132-000,2017,8,3,7,401,441,842,469
0132-000,2017,8,3,8,532,1281,1813,842
0132-000,2017,8,3,9,650,1070,1720,1813
0132-000,2017,8,3,10,628,721,1349,1720
0132-000,2017,8,3,11,600,742,1342,1349
0132-000,2017,8,3,12,715,846,1561,1342
0132-000,2017,8,3,13,648,771,1419,1561
0132-000,2017,8,3,14,625,671,1296,1419
0132-000,2017,8,3,15,757,723,1480,1296
0132-000,2017,8,3,16,715,689,1404,1480
0132-000,2017,8,3,17,736,753,1489,1404
0132-000,2017,8,3,18,1058,825,1883,1489
0132-000,2017,8,3,19,1276,816,2092,1883
0132-000,2017,8,3,20,889,603,1492,2092
0132-000,2017,8,3,21,673,487,1160,1492
0132-000,2017,8,3,22,524,380,904,1160
0132-000,2017,8,3,23,325,303,628,904
0132-000,2017,8,3,24,208,254,462,628
0132-000,2017,8,4,1,153,166,319,462
0132-000,2017,8,4,2,103,102,205,319
0132-000,2017,8,4,3,77,91,168,205
0132-000,2017,8,4,4,46,97,143,168
0132-000,2017,8,4,5,97,93,190,143
0132-000,2017,8,4,6,262,216,478,190
0132-000,2017,8,4,7,404,485,889,478
0132-000,2017,8,4,8,542,1275,1817,889
0132-000,2017,8,4,9,706,1077,1783,1817
0132-000,2017,8,4,10,628,710,1338,1783
0132-000,2017,8,4,11,697,743,1440,1338
0132-000,2017,8,4,12,682,738,1420,1440
0132-000,2017,8,4,13,691,777,1468,1420
0132-000,2017,8,4,14,695,749,1444,1468
0132-000,2017,8,4,15,787,727,1514,1444
0132-000,2017,8,4,16,811,755,1566,1514
0132-000,2017,8,4,17,834,801,1635,1566
0132-000,2017,8,4,18,1129,936,2065,1635
0132-000,2017,8,4,19,1377,894,2271,2065
0132-000,2017,8,4,20,923,661,1584,2271
0132-000,2017,8,4,21,711,541,1252,1584
0132-000,2017,8,4,22,616,424,1040,1252
0132-000,2017,8,4,23,341,316,657,1040
0132-000,2017,8,4,24,208,247,455,657
0132-000,2017,8,5,1,162,176,338,455
0132-000,2017,8,5,2,120,130,250,338
0132-000,2017,8,5,3,80,109,189,250
0132-000,2017,8,5,4,76,83,159,189
0132-000,2017,8,5,5,102,95,197,159
0132-000,2017,8,5,6,239,212,451,197
0132-000,2017,8,5,7,353,382,735,451
0132-000,2017,8,5,8,386,672,1058,735
0132-000,2017,8,5,9,545,722,1267,1058
0132-000,2017,8,5,10,593,759,1352,1267
0132-000,2017,8,5,11,620,842,1462,1352
0132-000,2017,8,5,12,723,785,1508,1462
0132-000,2017,8,5,13,715,813,1528,1508
0132-000,2017,8,5,14,723,772,1495,1528
0132-000,2017,8,5,15,792,781,1573,1495
0132-000,2017,8,5,16,877,762,1639,1573
0132-000,2017,8,5,17,952,812,1764,1639
0132-000,2017,8,5,18,1093,796,1889,1764
0132-000,2017,8,5,19,943,747,1690,1889
0132-000,2017,8,5,20,808,607,1415,1690
0132-000,2017,8,5,21,628,479,1107,1415
0132-000,2017,8,5,22,543,407,950,1107
0132-000,2017,8,5,23,355,335,690,950
0132-000,2017,8,5,24,208,207,415,690
0132-000,2017,8,6,1,165,171,336,415
0132-000,2017,8,6,2,108,137,245,336
0132-000,2017,8,6,3,98,94,192,245
0132-000,2017,8,6,4,69,71,140,192
0132-000,2017,8,6,5,76,108,184,140
0132-000,2017,8,6,6,134,167,301,184
0132-000,2017,8,6,7,223,206,429,301
0132-000,2017,8,6,8,249,313,562,429
0132-000,2017,8,6,9,318,414,732,562
0132-000,2017,8,6,10,401,493,894,732
0132-000,2017,8,6,11,481,574,1055,894
0132-000,2017,8,6,12,494,583,1077,1055
0132-000,2017,8,6,13,625,620,1245,1077
0132-000,2017,8,6,14,661,680,1341,1245
0132-000,2017,8,6,15,689,655,1344,1341
0132-000,2017,8,6,16,724,626,1350,1344
0132-000,2017,8,6,17,776,654,1430,1350
0132-000,2017,8,6,18,903,634,1537,1430
0132-000,2017,8,6,19,909,542,1451,1537
0132-000,2017,8,6,20,788,462,1250,1451
0132-000,2017,8,6,21,629,503,1132,1250
0132-000,2017,8,6,22,447,388,835,1132
0132-000,2017,8,6,23,287,303,590,835
0132-000,2017,8,6,24,175,212,387,590
0132-000,2017,8,7,1,133,158,291,387
0132-000,2017,8,7,2,95,84,179,291
0132-000,2017,8,7,3,54,81,135,179
0132-000,2017,8,7,4,59,61,120,135
0132-000,2017,8,7,5,88,90,178,120
0132-000,2017,8,7,6,261,213,474,178
0132-000,2017,8,7,7,442,654,1096,474
0132-000,2017,8,7,8,597,1776,2373,1096
0132-000,2017,8,7,9,723,1272,1995,2373
0132-000,2017,8,7,10,687,759,1446,1995
0132-000,2017,8,7,11,676,733,1409,1446
0132-000,2017,8,7,12,678,695,1373,1409
0132-000,2017,8,7,13,626,696,1322,1373
0132-000,2017,8,7,14,733,765,1498,1322
0132-000,2017,8,7,15,730,743,1473,1498
0132-000,2017,8,7,16,760,670,1430,1473
0132-000,2017,8,7,17,817,762,1579,1430
0132-000,2017,8,7,18,1145,805,1950,1579
0132-000,2017,8,7,19,1337,827,2164,1950
0132-000,2017,8,7,20,922,664,1586,2164
0132-000,2017,8,7,21,863,533,1396,1586
0132-000,2017,8,7,22,593,409,1002,1396
0132-000,2017,8,7,23,340,286,626,1002
0132-000,2017,8,7,24,216,219,435,626
0132-000,2017,8,8,1,146,145,291,435
0132-000,2017,8,8,2,87,92,179,291
0132-000,2017,8,8,3,57,88,145,179
0132-000,2017,8,8,4,63,96,159,145
0132-000,2017,8,8,5,89,99,188,159
0132-000,2017,8,8,6,279,213,492,188
0132-000,2017,8,8,7,418,571,989,492
0132-000,2017,8,8,8,567,1755,2322,989
0132-000,2017,8,8,9,779,1308,2087,2322
0132-000,2017,8,8,10,747,803,1550,2087
0132-000,2017,8,8,11,705,754,1459,1550
0132-000,2017,8,8,12,698,755,1453,1459
0132-000,2017,8,8,13,694,679,1373,1453
0132-000,2017,8,8,14,713,716,1429,1373
0132-000,2017,8,8,15,730,746,1476,1429
0132-000,2017,8,8,16,809,689,1498,1476
0132-000,2017,8,8,17,956,782,1738,1498
0132-000,2017,8,8,18,1201,808,2009,1738
0132-000,2017,8,8,19,1366,804,2170,2009
0132-000,2017,8,8,20,947,692,1639,2170
0132-000,2017,8,8,21,826,525,1351,1639
0132-000,2017,8,8,22,604,382,986,1351
0132-000,2017,8,8,23,347,298,645,986
0132-000,2017,8,8,24,234,238,472,645
0132-000,2017,8,9,1,136,161,297,472
0132-000,2017,8,9,2,101,104,205,297
0132-000,2017,8,9,3,71,77,148,205
0132-000,2017,8,9,4,79,87,166,148
0132-000,2017,8,9,5,109,114,223,166
0132-000,2017,8,9,6,264,189,453,223
0132-000,2017,8,9,7,399,604,1003,453
0132-000,2017,8,9,8,620,1684,2304,1003
0132-000,2017,8,9,9,755,1379,2134,2304
0132-000,2017,8,9,10,719,820,1539,2134
0132-000,2017,8,9,11,751,735,1486,1539
0132-000,2017,8,9,12,725,747,1472,1486
0132-000,2017,8,9,13,644,681,1325,1472
0132-000,2017,8,9,14,732,708,1440,1325
0132-000,2017,8,9,15,761,782,1543,1440
0132-000,2017,8,9,16,784,749,1533,1543
0132-000,2017,8,9,17,863,767,1630,1533
0132-000,2017,8,9,18,1231,788,2019,1630
0132-000,2017,8,9,19,1373,784,2157,2019
0132-000,2017,8,9,20,895,664,1559,2157
0132-000,2017,8,9,21,790,519,1309,1559
0132-000,2017,8,9,22,529,399,928,1309
0132-000,2017,8,9,23,340,308,648,928
0132-000,2017,8,9,24,231,212,443,648
0132-000,2017,8,10,1,147,186,333,443
0132-000,2017,8,10,2,93,105,198,333
0132-000,2017,8,10,3,73,80,153,198
0132-000,2017,8,10,4,64,105,169,153
0132-000,2017,8,10,5,99,92,191,169
0132-000,2017,8,10,6,264,207,471,191
0132-000,2017,8,10,7,405,560,965,471
0132-000,2017,8,10,8,617,1642,2259,965
0132-000,2017,8,10,9,703,1345,2048,2259
0132-000,2017,8,10,10,686,748,1434,2048
0132-000,2017,8,10,11,648,722,1370,1434
0132-000,2017,8,10,12,691,755,1446,1370
0132-000,2017,8,10,13,707,786,1493,1446
0132-000,2017,8,10,14,686,682,1368,1493
0132-000,2017,8,10,15,724,754,1478,1368
0132-000,2017,8,10,16,807,754,1561,1478
0132-000,2017,8,10,17,820,783,1603,1561
0132-000,2017,8,10,18,1163,798,1961,1603
0132-000,2017,8,10,19,1349,813,2162,1961
0132-000,2017,8,10,20,988,651,1639,2162
0132-000,2017,8,10,21,819,542,1361,1639
0132-000,2017,8,10,22,655,427,1082,1361
0132-000,2017,8,10,23,325,320,645,1082
0132-000,2017,8,10,24,235,237,472,645
0132-000,2017,8,11,1,172,164,336,472
0132-000,2017,8,11,2,127,121,248,336
0132-000,2017,8,11,3,71,83,154,248
0132-000,2017,8,11,4,67,98,165,154
0132-000,2017,8,11,5,94,98,192,165
0132-000,2017,8,11,6,252,222,474,192
0132-000,2017,8,11,7,411,602,1013,474
0132-000,2017,8,11,8,597,1691,2288,1013
0132-000,2017,8,11,9,742,1280,2022,2288
0132-000,2017,8,11,10,746,791,1537,2022
0132-000,2017,8,11,11,723,855,1578,1537
0132-000,2017,8,11,12,768,772,1540,1578
0132-000,2017,8,11,13,742,836,1578,1540
0132-000,2017,8,11,14,768,780,1548,1578
0132-000,2017,8,11,15,766,855,1621,1548
0132-000,2017,8,11,16,838,800,1638,1621
0132-000,2017,8,11,17,877,813,1690,1638
0132-000,2017,8,11,18,1214,861,2075,1690
0132-000,2017,8,11,19,1641,922,2563,2075
0132-000,2017,8,11,20,1091,803,1894,2563
0132-000,2017,8,11,21,907,598,1505,1894
0132-000,2017,8,11,22,634,468,1102,1505
0132-000,2017,8,11,23,451,354,805,1102
0132-000,2017,8,11,24,264,262,526,805
0132-000,2017,8,12,1,171,192,363,526
0132-000,2017,8,12,2,117,144,261,363
0132-000,2017,8,12,3,112,116,228,261
0132-000,2017,8,12,4,79,124,203,228
0132-000,2017,8,12,5,111,119,230,203
0132-000,2017,8,12,6,277,219,496,230
0132-000,2017,8,12,7,342,398,740,496
0132-000,2017,8,12,8,480,772,1252,740
0132-000,2017,8,12,9,614,864,1478,1252
0132-000,2017,8,12,10,640,864,1504,1478
0132-000,2017,8,12,11,665,953,1618,1504
0132-000,2017,8,12,12,740,1066,1806,1618
0132-000,2017,8,12,13,765,1042,1807,1806
0132-000,2017,8,12,14,731,914,1645,1807
0132-000,2017,8,12,15,800,894,1694,1645
0132-000,2017,8,12,16,850,849,1699,1694
0132-000,2017,8,12,17,860,918,1778,1699
0132-000,2017,8,12,18,1115,915,2030,1778
0132-000,2017,8,12,19,1017,810,1827,2030
0132-000,2017,8,12,20,744,610,1354,1827
0132-000,2017,8,12,21,611,483,1094,1354
0132-000,2017,8,12,22,498,390,888,1094
0132-000,2017,8,12,23,347,322,669,888
0132-000,2017,8,12,24,216,236,452,669
0132-000,2017,8,13,1,152,193,345,452
0132-000,2017,8,13,2,124,126,250,345
0132-000,2017,8,13,3,93,117,210,250
0132-000,2017,8,13,4,71,85,156,210
0132-000,2017,8,13,5,75,94,169,156
0132-000,2017,8,13,6,142,142,284,169
0132-000,2017,8,13,7,217,265,482,284
0132-000,2017,8,13,8,272,336,608,482
0132-000,2017,8,13,9,354,451,805,608
0132-000,2017,8,13,10,443,519,962,805
0132-000,2017,8,13,11,496,630,1126,962
0132-000,2017,8,13,12,497,571,1068,1126
0132-000,2017,8,13,13,567,589,1156,1068
0132-000,2017,8,13,14,626,613,1239,1156
0132-000,2017,8,13,15,673,609,1282,1239
0132-000,2017,8,13,16,727,648,1375,1282
0132-000,2017,8,13,17,702,583,1285,1375
0132-000,2017,8,13,18,774,575,1349,1285
0132-000,2017,8,13,19,826,531,1357,1349
0132-000,2017,8,13,20,750,454,1204,1357
0132-000,2017,8,13,21,539,414,953,1204
0132-000,2017,8,13,22,397,345,742,953
0132-000,2017,8,13,23,237,269,506,742
0132-000,2017,8,13,24,241,167,408,506
0132-000,2017,8,14,1,114,117,231,408
0132-000,2017,8,14,2,69,68,137,231
0132-000,2017,8,14,3,48,76,124,137
0132-000,2017,8,14,4,52,72,124,124
0132-000,2017,8,14,5,69,73,142,124
0132-000,2017,8,14,6,253,208,461,142
0132-000,2017,8,14,7,418,579,997,461
0132-000,2017,8,14,8,568,1572,2140,997
0132-000,2017,8,14,9,731,1192,1923,2140
0132-000,2017,8,14,10,682,710,1392,1923
0132-000,2017,8,14,11,716,784,1500,1392
0132-000,2017,8,14,12,666,739,1405,1500
0132-000,2017,8,14,13,728,739,1467,1405
0132-000,2017,8,14,14,707,735,1442,1467
0132-000,2017,8,14,15,760,719,1479,1442
0132-000,2017,8,14,16,852,669,1521,1479
0132-000,2017,8,14,17,914,740,1654,1521
0132-000,2017,8,14,18,1188,767,1955,1654
0132-000,2017,8,14,19,1348,779,2127,1955
0132-000,2017,8,14,20,867,620,1487,2127
0132-000,2017,8,14,21,733,521,1254,1487
0132-000,2017,8,14,22,502,352,854,1254
0132-000,2017,8,14,23,326,287,613,854
0132-000,2017,8,14,24,202,223,425,613
0132-000,2017,8,15,1,142,161,303,425
0132-000,2017,8,15,2,121,130,251,303
0132-000,2017,8,15,3,67,103,170,251
0132-000,2017,8,15,4,70,87,157,170
0132-000,2017,8,15,5,84,80,164,157
0132-000,2017,8,15,6,201,166,367,164
0132-000,2017,8,15,7,272,306,578,367
0132-000,2017,8,15,8,379,690,1069,578
0132-000,2017,8,15,9,430,683,1113,1069
0132-000,2017,8,15,10,518,621,1139,1113
0132-000,2017,8,15,11,559,660,1219,1139
0132-000,2017,8,15,12,613,780,1393,1219
0132-000,2017,8,15,13,606,687,1293,1393
0132-000,2017,8,15,14,676,707,1383,1293
0132-000,2017,8,15,15,767,693,1460,1383
0132-000,2017,8,15,16,781,635,1416,1460
0132-000,2017,8,15,17,830,712,1542,1416
0132-000,2017,8,15,18,1021,742,1763,1542
0132-000,2017,8,15,19,909,624,1533,1763
0132-000,2017,8,15,20,618,483,1101,1533
0132-000,2017,8,15,21,535,406,941,1101
0132-000,2017,8,15,22,373,317,690,941
0132-000,2017,8,15,23,228,243,471,690
0132-000,2017,8,15,24,163,186,349,471
0132-000,2017,8,16,1,95,126,221,349
0132-000,2017,8,16,2,80,97,177,221
0132-000,2017,8,16,3,55,71,126,177
0132-000,2017,8,16,4,72,70,142,126
0132-000,2017,8,16,5,71,94,165,142
0132-000,2017,8,16,6,249,190,439,165
0132-000,2017,8,16,7,449,586,1035,439
0132-000,2017,8,16,8,642,1821,2463,1035
0132-000,2017,8,16,9,770,1354,2124,2463
0132-000,2017,8,16,10,698,797,1495,2124
0132-000,2017,8,16,11,742,806,1548,1495
0132-000,2017,8,16,12,737,783,1520,1548
0132-000,2017,8,16,13,660,710,1370,1520
0132-000,2017,8,16,14,731,758,1489,1370
0132-000,2017,8,16,15,803,783,1586,1489
0132-000,2017,8,16,16,826,765,1591,1586
0132-000,2017,8,16,17,828,765,1593,1591
0132-000,2017,8,16,18,1258,903,2161,1593
0132-000,2017,8,16,19,1362,773,2135,2161
0132-000,2017,8,16,20,959,678,1637,2135
0132-000,2017,8,16,21,726,490,1216,1637
0132-000,2017,8,16,22,573,345,918,1216
0132-000,2017,8,16,23,339,294,633,918
0132-000,2017,8,16,24,226,222,448,633
0132-000,2017,8,17,1,125,155,280,448
0132-000,2017,8,17,2,88,125,213,280
0132-000,2017,8,17,3,65,76,141,213
0132-000,2017,8,17,4,80,88,168,141
0132-000,2017,8,17,5,92,89,181,168
0132-000,2017,8,17,6,253,199,452,181
0132-000,2017,8,17,7,447,567,1014,452
0132-000,2017,8,17,8,605,1725,2330,1014
0132-000,2017,8,17,9,778,1468,2246,2330
0132-000,2017,8,17,10,800,760,1560,2246
0132-000,2017,8,17,11,671,810,1481,1560
0132-000,2017,8,17,12,695,848,1543,1481
0132-000,2017,8,17,13,668,728,1396,1543
0132-000,2017,8,17,14,697,763,1460,1396
0132-000,2017,8,17,15,749,794,1543,1460
0132-000,2017,8,17,16,758,692,1450,1543
0132-000,2017,8,17,17,860,731,1591,1450
0132-000,2017,8,17,18,1167,895,2062,1591
0132-000,2017,8,17,19,1397,800,2197,2062
0132-000,2017,8,17,20,915,627,1542,2197
0132-000,2017,8,17,21,813,518,1331,1542
0132-000,2017,8,17,22,580,427,1007,1331
0132-000,2017,8,17,23,371,352,723,1007
0132-000,2017,8,17,24,233,227,460,723
0132-000,2017,8,18,1,161,204,365,460
0132-000,2017,8,18,2,102,96,198,365
0132-000,2017,8,18,3,69,88,157,198
0132-000,2017,8,18,4,69,97,166,157
0132-000,2017,8,18,5,97,110,207,166
0132-000,2017,8,18,6,289,198,487,207
0132-000,2017,8,18,7,439,605,1044,487
0132-000,2017,8,18,8,684,1734,2418,1044
0132-000,2017,8,18,9,833,1373,2206,2418
0132-000,2017,8,18,10,742,821,1563,2206
0132-000,2017,8,18,11,681,743,1424,1563
0132-000,2017,8,18,12,725,797,1522,1424
0132-000,2017,8,18,13,696,705,1401,1522
0132-000,2017,8,18,14,720,784,1504,1401
0132-000,2017,8,18,15,814,783,1597,1504
0132-000,2017,8,18,16,809,768,1577,1597
0132-000,2017,8,18,17,846,781,1627,1577
0132-000,2017,8,18,18,1207,986,2193,1627
0132-000,2017,8,18,19,1553,885,2438,2193
0132-000,2017,8,18,20,1086,711,1797,2438
0132-000,2017,8,18,21,875,591,1466,1797
0132-000,2017,8,18,22,611,471,1082,1466
0132-000,2017,8,18,23,401,359,760,1082
0132-000,2017,8,18,24,225,280,505,760
0132-000,2017,8,19,1,174,196,370,505
0132-000,2017,8,19,2,144,147,291,370
0132-000,2017,8,19,3,92,125,217,291
0132-000,2017,8,19,4,109,126,235,217
0132-000,2017,8,19,5,113,110,223,235
0132-000,2017,8,19,6,269,221,490,223
0132-000,2017,8,19,7,408,470,878,490
0132-000,2017,8,19,8,440,785,1225,878
0132-000,2017,8,19,9,619,853,1472,1225
0132-000,2017,8,19,10,676,752,1428,1472
0132-000,2017,8,19,11,689,802,1491,1428
0132-000,2017,8,19,12,755,848,1603,1491
0132-000,2017,8,19,13,782,783,1565,1603
0132-000,2017,8,19,14,793,830,1623,1565
0132-000,2017,8,19,15,779,790,1569,1623
0132-000,2017,8,19,16,835,825,1660,1569
0132-000,2017,8,19,17,961,864,1825,1660
0132-000,2017,8,19,18,1188,964,2152,1825
0132-000,2017,8,19,19,1037,798,1835,2152
0132-000,2017,8,19,20,667,569,1236,1835
0132-000,2017,8,19,21,552,488,1040,1236
0132-000,2017,8,19,22,452,389,841,1040
0132-000,2017,8,19,23,296,275,571,841
0132-000,2017,8,19,24,219,248,467,571
0132-000,2017,8,20,1,146,171,317,467
0132-000,2017,8,20,2,129,124,253,317
0132-000,2017,8,20,3,104,106,210,253
0132-000,2017,8,20,4,71,77,148,210
0132-000,2017,8,20,5,75,86,161,148
0132-000,2017,8,20,6,119,117,236,161
0132-000,2017,8,20,7,173,177,350,236
0132-000,2017,8,20,8,210,262,472,350
0132-000,2017,8,20,9,345,376,721,472
0132-000,2017,8,20,10,411,404,815,721
0132-000,2017,8,20,11,492,537,1029,815
0132-000,2017,8,20,12,457,638,1095,1029
0132-000,2017,8,20,13,589,646,1235,1095
0132-000,2017,8,20,14,614,713,1327,1235
0132-000,2017,8,20,15,722,741,1463,1327
0132-000,2017,8,20,16,723,624,1347,1463
0132-000,2017,8,20,17,855,643,1498,1347
0132-000,2017,8,20,18,844,585,1429,1498
0132-000,2017,8,20,19,791,576,1367,1429
0132-000,2017,8,20,20,754,459,1213,1367
0132-000,2017,8,20,21,493,411,904,1213
0132-000,2017,8,20,22,408,320,728,904
0132-000,2017,8,20,23,242,277,519,728
0132-000,2017,8,20,24,142,189,331,519
0132-000,2017,8,21,1,90,109,199,331
0132-000,2017,8,21,2,68,92,160,199
0132-000,2017,8,21,3,47,62,109,160
0132-000,2017,8,21,4,41,66,107,109
0132-000,2017,8,21,5,95,63,158,107
0132-000,2017,8,21,6,242,191,433,158
0132-000,2017,8,21,7,458,646,1104,433
0132-000,2017,8,21,8,632,1760,2392,1104
0132-000,2017,8,21,9,764,1473,2237,2392
0132-000,2017,8,21,10,705,793,1498,2237
0132-000,2017,8,21,11,774,744,1518,1498
0132-000,2017,8,21,12,709,870,1579,1518
0132-000,2017,8,21,13,705,748,1453,1579
0132-000,2017,8,21,14,725,713,1438,1453
0132-000,2017,8,21,15,676,802,1478,1438
0132-000,2017,8,21,16,840,783,1623,1478
0132-000,2017,8,21,17,834,755,1589,1623
0132-000,2017,8,21,18,1081,817,1898,1589
0132-000,2017,8,21,19,1448,822,2270,1898
0132-000,2017,8,21,20,877,642,1519,2270
0132-000,2017,8,21,21,819,494,1313,1519
0132-000,2017,8,21,22,557,365,922,1313
0132-000,2017,8,21,23,299,278,577,922
0132-000,2017,8,21,24,186,204,390,577
0132-000,2017,8,22,1,135,164,299,390
0132-000,2017,8,22,2,105,105,210,299
0132-000,2017,8,22,3,67,75,142,210
0132-000,2017,8,22,4,65,86,151,142
0132-000,2017,8,22,5,87,103,190,151
0132-000,2017,8,22,6,274,200,474,190
0132-000,2017,8,22,7,510,617,1127,474
0132-000,2017,8,22,8,649,1821,2470,1127
0132-000,2017,8,22,9,771,1461,2232,2470
0132-000,2017,8,22,10,767,855,1622,2232
0132-000,2017,8,22,11,698,795,1493,1622
0132-000,2017,8,22,12,732,723,1455,1493
0132-000,2017,8,22,13,719,677,1396,1455
0132-000,2017,8,22,14,781,765,1546,1396
0132-000,2017,8,22,15,805,838,1643,1546
0132-000,2017,8,22,16,832,761,1593,1643
0132-000,2017,8,22,17,866,813,1679,1593
0132-000,2017,8,22,18,1174,863,2037,1679
0132-000,2017,8,22,19,1403,819,2222,2037
0132-000,2017,8,22,20,996,668,1664,2222
0132-000,2017,8,22,21,855,535,1390,1664
0132-000,2017,8,22,22,577,477,1054,1390
0132-000,2017,8,22,23,355,325,680,1054
0132-000,2017,8,22,24,243,288,531,680
0132-000,2017,8,23,1,166,153,319,531
0132-000,2017,8,23,2,96,112,208,319
0132-000,2017,8,23,3,85,101,186,208
0132-000,2017,8,23,4,74,101,175,186
0132-000,2017,8,23,5,93,94,187,175
0132-000,2017,8,23,6,243,197,440,187
0132-000,2017,8,23,7,405,572,977,440
0132-000,2017,8,23,8,686,1679,2365,977
0132-000,2017,8,23,9,777,1493,2270,2365
0132-000,2017,8,23,10,681,793,1474,2270
0132-000,2017,8,23,11,684,778,1462,1474
0132-000,2017,8,23,12,649,791,1440,1462
0132-000,2017,8,23,13,681,678,1359,1440
0132-000,2017,8,23,14,685,729,1414,1359
0132-000,2017,8,23,15,737,719,1456,1414
0132-000,2017,8,23,16,733,684,1417,1456
0132-000,2017,8,23,17,782,753,1535,1417
0132-000,2017,8,23,18,1272,845,2117,1535
0132-000,2017,8,23,19,1440,784,2224,2117
0132-000,2017,8,23,20,966,676,1642,2224
0132-000,2017,8,23,21,766,462,1228,1642
0132-000,2017,8,23,22,527,441,968,1228
0132-000,2017,8,23,23,370,310,680,968
0132-000,2017,8,23,24,220,252,472,680
0132-000,2017,8,24,1,145,162,307,472
0132-000,2017,8,24,2,110,104,214,307
0132-000,2017,8,24,3,66,74,140,214
0132-000,2017,8,24,4,63,87,150,140
0132-000,2017,8,24,5,101,96,197,150
0132-000,2017,8,24,6,248,192,440,197
0132-000,2017,8,24,7,432,562,994,440
0132-000,2017,8,24,8,640,1723,2363,994
0132-000,2017,8,24,9,750,1401,2151,2363
0132-000,2017,8,24,10,749,783,1532,2151
0132-000,2017,8,24,11,683,797,1480,1532
0132-000,2017,8,24,12,657,741,1398,1480
0132-000,2017,8,24,13,700,668,1368,1398
0132-000,2017,8,24,14,698,733,1431,1368
0132-000,2017,8,24,15,717,772,1489,1431
0132-000,2017,8,24,16,750,664,1414,1489
0132-000,2017,8,24,17,857,818,1675,1414
0132-000,2017,8,24,18,1206,958,2164,1675
0132-000,2017,8,24,19,1366,771,2137,2164
0132-000,2017,8,24,20,866,633,1499,2137
0132-000,2017,8,24,21,807,442,1249,1499
0132-000,2017,8,24,22,543,446,989,1249
0132-000,2017,8,24,23,338,267,605,989
0132-000,2017,8,24,24,206,199,405,605
0132-000,2017,8,25,1,164,157,321,405
0132-000,2017,8,25,2,111,107,218,321
0132-000,2017,8,25,3,66,109,175,218
0132-000,2017,8,25,4,67,104,171,175
0132-000,2017,8,25,5,122,96,218,171
0132-000,2017,8,25,6,252,209,461,218
0132-000,2017,8,25,7,444,602,1046,461
0132-000,2017,8,25,8,666,1760,2426,1046
0132-000,2017,8,25,9,849,1355,2204,2426
0132-000,2017,8,25,10,731,855,1586,2204
0132-000,2017,8,25,11,707,807,1514,1586
0132-000,2017,8,25,12,782,774,1556,1514
0132-000,2017,8,25,13,731,713,1444,1556
0132-000,2017,8,25,14,741,795,1536,1444
0132-000,2017,8,25,15,732,733,1465,1536
0132-000,2017,8,25,16,834,717,1551,1465
0132-000,2017,8,25,17,878,839,1717,1551
0132-000,2017,8,25,18,1340,973,2313,1717
0132-000,2017,8,25,19,1584,880,2464,2313
0132-000,2017,8,25,20,1104,770,1874,2464
0132-000,2017,8,25,21,874,634,1508,1874
0132-000,2017,8,25,22,676,541,1217,1508
0132-000,2017,8,25,23,449,364,813,1217
0132-000,2017,8,25,24,263,289,552,813
0132-000,2017,8,26,1,221,223,444,552
0132-000,2017,8,26,2,156,156,312,444
0132-000,2017,8,26,3,108,128,236,312
0132-000,2017,8,26,4,84,115,199,236
0132-000,2017,8,26,5,115,122,237,199
0132-000,2017,8,26,6,267,225,492,237
0132-000,2017,8,26,7,399,486,885,492
0132-000,2017,8,26,8,513,868,1381,885
0132-000,2017,8,26,9,613,938,1551,1381
0132-000,2017,8,26,10,710,796,1506,1551
0132-000,2017,8,26,11,706,881,1587,1506
0132-000,2017,8,26,12,765,842,1607,1587
0132-000,2017,8,26,13,832,918,1750,1607
0132-000,2017,8,26,14,793,873,1666,1750
0132-000,2017,8,26,15,819,856,1675,1666
0132-000,2017,8,26,16,877,950,1827,1675
0132-000,2017,8,26,17,976,936,1912,1827
0132-000,2017,8,26,18,1179,1059,2238,1912
0132-000,2017,8,26,19,1246,837,2083,2238
0132-000,2017,8,26,20,1026,702,1728,2083
0132-000,2017,8,26,21,709,550,1259,1728
0132-000,2017,8,26,22,589,494,1083,1259
0132-000,2017,8,26,23,337,343,680,1083
0132-000,2017,8,26,24,256,314,570,680
0132-000,2017,8,27,1,183,209,392,570
0132-000,2017,8,27,2,134,148,282,392
0132-000,2017,8,27,3,101,121,222,282
0132-000,2017,8,27,4,73,107,180,222
0132-000,2017,8,27,5,75,127,202,180
0132-000,2017,8,27,6,154,133,287,202
0132-000,2017,8,27,7,269,274,543,287
0132-000,2017,8,27,8,303,371,674,543
0132-000,2017,8,27,9,355,498,853,674
0132-000,2017,8,27,10,482,599,1081,853
0132-000,2017,8,27,11,589,714,1303,1081
0132-000,2017,8,27,12,580,718,1298,1303
0132-000,2017,8,27,13,648,708,1356,1298
0132-000,2017,8,27,14,689,761,1450,1356
0132-000,2017,8,27,15,817,783,1600,1450
0132-000,2017,8,27,16,1064,896,1960,1600
0132-000,2017,8,27,17,1312,841,2153,1960
0132-000,2017,8,27,18,1592,824,2416,2153
0132-000,2017,8,27,19,1698,714,2412,2416
0132-000,2017,8,27,20,1613,594,2207,2412
0132-000,2017,8,27,21,1528,529,2057,2207
0132-000,2017,8,27,22,949,457,1406,2057
0132-000,2017,8,27,23,425,378,803,1406
0132-000,2017,8,27,24,178,242,420,803
0132-000,2017,8,28,1,117,153,270,420
0132-000,2017,8,28,2,77,81,158,270
0132-000,2017,8,28,3,43,70,113,158
0132-000,2017,8,28,4,51,90,141,113
0132-000,2017,8,28,5,117,87,204,141
0132-000,2017,8,28,6,333,274,607,204
0132-000,2017,8,28,7,532,784,1316,607
0132-000,2017,8,28,8,675,1960,2635,1316
0132-000,2017,8,28,9,818,1830,2648,2635
0132-000,2017,8,28,10,856,977,1833,2648
0132-000,2017,8,28,11,788,939,1727,1833
0132-000,2017,8,28,12,828,914,1742,1727
0132-000,2017,8,28,13,793,914,1707,1742
0132-000,2017,8,28,14,831,946,1777,1707
0132-000,2017,8,28,15,869,899,1768,1777
0132-000,2017,8,28,16,938,911,1849,1768
0132-000,2017,8,28,17,978,911,1889,1849
0132-000,2017,8,28,18,1265,902,2167,1889
0132-000,2017,8,28,19,1538,809,2347,2167
0132-000,2017,8,28,20,995,717,1712,2347
0132-000,2017,8,28,21,845,568,1413,1712
0132-000,2017,8,28,22,528,408,936,1413
0132-000,2017,8,28,23,320,299,619,936
0132-000,2017,8,28,24,213,213,426,619
0132-000,2017,8,29,1,150,144,294,426
0132-000,2017,8,29,2,78,89,167,294
0132-000,2017,8,29,3,51,76,127,167
0132-000,2017,8,29,4,72,81,153,127
0132-000,2017,8,29,5,95,95,190,153
0132-000,2017,8,29,6,298,203,501,190
0132-000,2017,8,29,7,483,633,1116,501
0132-000,2017,8,29,8,679,1894,2573,1116
0132-000,2017,8,29,9,864,1729,2593,2573
0132-000,2017,8,29,10,871,992,1863,2593
0132-000,2017,8,29,11,808,1003,1811,1863
0132-000,2017,8,29,12,781,949,1730,1811
0132-000,2017,8,29,13,673,876,1549,1730
0132-000,2017,8,29,14,775,843,1618,1549
0132-000,2017,8,29,15,822,940,1762,1618
0132-000,2017,8,29,16,900,868,1768,1762
0132-000,2017,8,29,17,988,877,1865,1768
0132-000,2017,8,29,18,1299,974,2273,1865
0132-000,2017,8,29,19,1611,874,2485,2273
0132-000,2017,8,29,20,1019,753,1772,2485
0132-000,2017,8,29,21,886,578,1464,1772
0132-000,2017,8,29,22,679,480,1159,1464
0132-000,2017,8,29,23,372,332,704,1159
0132-000,2017,8,29,24,216,216,432,704
0132-000,2017,8,30,1,146,156,302,432
0132-000,2017,8,30,2,122,125,247,302
0132-000,2017,8,30,3,62,89,151,247
0132-000,2017,8,30,4,74,106,180,151
0132-000,2017,8,30,5,113,106,219,180
0132-000,2017,8,30,6,322,243,565,219
0132-000,2017,8,30,7,503,667,1170,565
0132-000,2017,8,30,8,704,1845,2549,1170
0132-000,2017,8,30,9,840,1688,2528,2549
0132-000,2017,8,30,10,805,922,1727,2528
0132-000,2017,8,30,11,760,884,1644,1727
0132-000,2017,8,30,12,759,953,1712,1644
0132-000,2017,8,30,13,756,899,1655,1712
0132-000,2017,8,30,14,800,820,1620,1655
0132-000,2017,8,30,15,901,898,1799,1620
0132-000,2017,8,30,16,933,884,1817,1799
0132-000,2017,8,30,17,1020,905,1925,1817
0132-000,2017,8,30,18,1417,1001,2418,1925
0132-000,2017,8,30,19,1649,904,2553,2418
0132-000,2017,8,30,20,1070,787,1857,2553
0132-000,2017,8,30,21,802,574,1376,1857
0132-000,2017,8,30,22,594,475,1069,1376
0132-000,2017,8,30,23,421,321,742,1069
0132-000,2017,8,30,24,256,262,518,742
0132-000,2017,8,31,1,149,188,337,518
0132-000,2017,8,31,2,100,129,229,337
0132-000,2017,8,31,3,66,82,148,229
0132-000,2017,8,31,4,83,101,184,148
0132-000,2017,8,31,5,123,127,250,184
0132-000,2017,8,31,6,312,215,527,250
0132-000,2017,8,31,7,467,656,1123,527
0132-000,2017,8,31,8,703,1901,2604,1123
0132-000,2017,8,31,9,847,1668,2515,2604
0132-000,2017,8,31,10,783,938,1721,2515
0132-000,2017,8,31,11,756,889,1645,1721
0132-000,2017,8,31,12,759,915,1674,1645
0132-000,2017,8,31,13,758,807,1565,1674
0132-000,2017,8,31,14,776,825,1601,1565
0132-000,2017,8,31,15,865,920,1785,1601
0132-000,2017,8,31,16,924,924,1848,1785
0132-000,2017,8,31,17,1004,838,1842,1848
0132-000,2017,8,31,18,1324,954,2278,1842
0132-000,2017,8,31,19,1614,886,2500,2278
0132-000,2017,8,31,20,1026,734,1760,2500
0132-000,2017,8,31,21,911,554,1465,1760
0132-000,2017,8,31,22,639,521,1160,1465
0132-000,2017,8,31,23,376,342,718,1160
0132-000,2017,8,31,24,261,284,545,718
0132-000,2017,9,1,1,172,176,348,545
0132-000,2017,9,1,2,136,124,260,348
0132-000,2017,9,1,3,70,102,172,260
0132-000,2017,9,1,4,69,94,163,172
0132-000,2017,9,1,5,122,105,227,163
0132-000,2017,9,1,6,302,236,538,227
0132-000,2017,9,1,7,492,691,1183,538
0132-000,2017,9,1,8,722,1904,2626,1183
0132-000,2017,9,1,9,802,1609,2411,2626
0132-000,2017,9,1,10,785,886,1671,2411
0132-000,2017,9,1,11,787,875,1662,1671
0132-000,2017,9,1,12,798,885,1683,1662
0132-000,2017,9,1,13,776,826,1602,1683
0132-000,2017,9,1,14,760,798,1558,1602
0132-000,2017,9,1,15,871,892,1763,1558
0132-000,2017,9,1,16,950,845,1795,1763
0132-000,2017,9,1,17,1004,912,1916,1795
0132-000,2017,9,1,18,1466,1036,2502,1916
0132-000,2017,9,1,19,1788,1000,2788,2502
0132-000,2017,9,1,20,1287,886,2173,2788
0132-000,2017,9,1,21,938,667,1605,2173
0132-000,2017,9,1,22,657,505,1162,1605
0132-000,2017,9,1,23,466,436,902,1162
0132-000,2017,9,1,24,264,304,568,902
0132-000,2017,9,2,1,167,228,395,568
0132-000,2017,9,2,2,121,148,269,395
0132-000,2017,9,2,3,102,131,233,269
0132-000,2017,9,2,4,93,107,200,233
0132-000,2017,9,2,5,130,130,260,200
0132-000,2017,9,2,6,295,207,502,260
0132-000,2017,9,2,7,417,449,866,502
0132-000,2017,9,2,8,525,930,1455,866
0132-000,2017,9,2,9,621,1022,1643,1455
0132-000,2017,9,2,10,746,991,1737,1643
0132-000,2017,9,2,11,755,1106,1861,1737
0132-000,2017,9,2,12,744,1172,1916,1861
0132-000,2017,9,2,13,950,1010,1960,1916
0132-000,2017,9,2,14,1064,1103,2167,1960
0132-000,2017,9,2,15,940,1203,2143,2167
0132-000,2017,9,2,16,989,1283,2272,2143
0132-000,2017,9,2,17,1107,1044,2151,2272
0132-000,2017,9,2,18,1536,1097,2633,2151
0132-000,2017,9,2,19,1353,928,2281,2633
0132-000,2017,9,2,20,1001,751,1752,2281
0132-000,2017,9,2,21,722,507,1229,1752
0132-000,2017,9,2,22,470,455,925,1229
0132-000,2017,9,2,23,312,363,675,925
0132-000,2017,9,2,24,199,250,449,675
0132-000,2017,9,3,1,143,170,313,449
0132-000,2017,9,3,2,124,141,265,313
0132-000,2017,9,3,3,97,88,185,265
0132-000,2017,9,3,4,84,84,168,185
0132-000,2017,9,3,5,95,87,182,168
0132-000,2017,9,3,6,141,153,294,182
0132-000,2017,9,3,7,258,256,514,294
0132-000,2017,9,3,8,321,437,758,514
0132-000,2017,9,3,9,382,509,891,758
0132-000,2017,9,3,10,451,596,1047,891
0132-000,2017,9,3,11,546,634,1180,1047
0132-000,2017,9,3,12,620,710,1330,1180
0132-000,2017,9,3,13,712,740,1452,1330
0132-000,2017,9,3,14,740,732,1472,1452
0132-000,2017,9,3,15,856,770,1626,1472
0132-000,2017,9,3,16,940,828,1768,1626
0132-000,2017,9,3,17,1263,810,2073,1768
0132-000,2017,9,3,18,1605,769,2374,2073
0132-000,2017,9,3,19,1695,674,2369,2374
0132-000,2017,9,3,20,1396,589,1985,2369
0132-000,2017,9,3,21,1082,592,1674,1985
0132-000,2017,9,3,22,614,446,1060,1674
0132-000,2017,9,3,23,341,328,669,1060
0132-000,2017,9,3,24,203,220,423,669
0132-000,2017,9,4,1,110,155,265,423
0132-000,2017,9,4,2,84,87,171,265
0132-000,2017,9,4,3,54,64,118,171
0132-000,2017,9,4,4,57,66,123,118
0132-000,2017,9,4,5,106,90,196,123
0132-000,2017,9,4,6,318,255,573,196
0132-000,2017,9,4,7,550,774,1324,573
0132-000,2017,9,4,8,701,1966,2667,1324
0132-000,2017,9,4,9,842,1680,2522,2667
0132-000,2017,9,4,10,777,935,1712,2522
0132-000,2017,9,4,11,775,965,1740,1712
0132-000,2017,9,4,12,763,910,1673,1740
0132-000,2017,9,4,13,742,829,1571,1673
0132-000,2017,9,4,14,773,832,1605,1571
0132-000,2017,9,4,15,830,852,1682,1605
0132-000,2017,9,4,16,880,875,1755,1682
0132-000,2017,9,4,17,921,904,1825,1755
0132-000,2017,9,4,18,1372,979,2351,1825
0132-000,2017,9,4,19,1527,887,2414,2351
0132-000,2017,9,4,20,1019,761,1780,2414
0132-000,2017,9,4,21,868,542,1410,1780
0132-000,2017,9,4,22,617,444,1061,1410
0132-000,2017,9,4,23,398,329,727,1061
0132-000,2017,9,4,24,247,238,485,727
0132-000,2017,9,5,1,152,155,307,485
0132-000,2017,9,5,2,82,87,169,307
0132-000,2017,9,5,3,65,97,162,169
0132-000,2017,9,5,4,59,82,141,162
0132-000,2017,9,5,5,129,101,230,141
0132-000,2017,9,5,6,284,223,507,230
0132-000,2017,9,5,7,524,665,1189,507
0132-000,2017,9,5,8,702,1906,2608,1189
0132-000,2017,9,5,9,907,1711,2618,2608
0132-000,2017,9,5,10,795,981,1776,2618
0132-000,2017,9,5,11,765,976,1741,1776
0132-000,2017,9,5,12,811,860,1671,1741
0132-000,2017,9,5,13,753,834,1587,1671
0132-000,2017,9,5,14,817,848,1665,1587
0132-000,2017,9,5,15,880,832,1712,1665
0132-000,2017,9,5,16,894,824,1718,1712
0132-000,2017,9,5,17,962,870,1832,1718
0132-000,2017,9,5,18,1329,1006,2335,1832
0132-000,2017,9,5,19,1531,869,2400,2335
0132-000,2017,9,5,20,1029,705,1734,2400
0132-000,2017,9,5,21,859,551,1410,1734
0132-000,2017,9,5,22,623,460,1083,1410
0132-000,2017,9,5,23,381,327,708,1083
0132-000,2017,9,5,24,226,238,464,708
0132-000,2017,9,6,1,137,154,291,464
0132-000,2017,9,6,2,103,96,199,291
0132-000,2017,9,6,3,74,87,161,199
0132-000,2017,9,6,4,59,95,154,161
0132-000,2017,9,6,5,113,87,200,154
0132-000,2017,9,6,6,271,230,501,200
0132-000,2017,9,6,7,457,696,1153,501
0132-000,2017,9,6,8,684,1854,2538,1153
0132-000,2017,9,6,9,851,1697,2548,2538
0132-000,2017,9,6,10,798,973,1771,2548
0132-000,2017,9,6,11,775,873,1648,1771
0132-000,2017,9,6,12,737,888,1625,1648
0132-000,2017,9,6,13,771,774,1545,1625
0132-000,2017,9,6,14,770,850,1620,1545
0132-000,2017,9,6,15,834,882,1716,1620
0132-000,2017,9,6,16,841,815,1656,1716
0132-000,2017,9,6,17,974,797,1771,1656
0132-000,2017,9,6,18,1438,922,2360,1771
0132-000,2017,9,6,19,1756,827,2583,2360
0132-000,2017,9,6,20,967,710,1677,2583
0132-000,2017,9,6,21,782,581,1363,1677
0132-000,2017,9,6,22,596,439,1035,1363
0132-000,2017,9,6,23,372,359,731,1035
0132-000,2017,9,6,24,211,239,450,731
0132-000,2017,9,7,1,136,161,297,450
0132-000,2017,9,7,2,111,126,237,297
0132-000,2017,9,7,3,78,103,181,237
0132-000,2017,9,7,4,86,97,183,181
0132-000,2017,9,7,5,108,92,200,183
0132-000,2017,9,7,6,287,223,510,200
0132-000,2017,9,7,7,484,700,1184,510
0132-000,2017,9,7,8,737,1902,2639,1184
0132-000,2017,9,7,9,854,1716,2570,2639
0132-000,2017,9,7,10,774,992,1766,2570
0132-000,2017,9,7,11,793,909,1702,1766
0132-000,2017,9,7,12,742,872,1614,1702
0132-000,2017,9,7,13,753,788,1541,1614
0132-000,2017,9,7,14,798,792,1590,1541
0132-000,2017,9,7,15,824,875,1699,1590
0132-000,2017,9,7,16,904,837,1741,1699
0132-000,2017,9,7,17,1027,932,1959,1741
0132-000,2017,9,7,18,1362,950,2312,1959
0132-000,2017,9,7,19,1606,908,2514,2312
0132-000,2017,9,7,20,1037,773,1810,2514
0132-000,2017,9,7,21,847,582,1429,1810
0132-000,2017,9,7,22,681,495,1176,1429
0132-000,2017,9,7,23,436,357,793,1176
0132-000,2017,9,7,24,249,261,510,793
0132-000,2017,9,8,1,161,164,325,510
0132-000,2017,9,8,2,104,82,186,325
0132-000,2017,9,8,3,73,101,174,186
0132-000,2017,9,8,4,70,91,161,174
0132-000,2017,9,8,5,109,113,222,161
0132-000,2017,9,8,6,299,227,526,222
0132-000,2017,9,8,7,512,704,1216,526
0132-000,2017,9,8,8,730,1908,2638,1216
0132-000,2017,9,8,9,848,1591,2439,2638
0132-000,2017,9,8,10,839,942,1781,2439
0132-000,2017,9,8,11,794,971,1765,1781
0132-000,2017,9,8,12,840,958,1798,1765
0132-000,2017,9,8,13,807,842,1649,1798
0132-000,2017,9,8,14,852,886,1738,1649
0132-000,2017,9,8,15,896,894,1790,1738
0132-000,2017,9,8,16,993,892,1885,1790
0132-000,2017,9,8,17,1199,991,2190,1885
0132-000,2017,9,8,18,1613,1066,2679,2190
0132-000,2017,9,8,19,1870,978,2848,2679
0132-000,2017,9,8,20,1325,846,2171,2848
0132-000,2017,9,8,21,920,657,1577,2171
0132-000,2017,9,8,22,668,514,1182,1577
0132-000,2017,9,8,23,399,379,778,1182
0132-000,2017,9,8,24,269,296,565,778
0132-000,2017,9,9,1,183,220,403,565
0132-000,2017,9,9,2,151,150,301,403
0132-000,2017,9,9,3,89,135,224,301
0132-000,2017,9,9,4,111,136,247,224
0132-000,2017,9,9,5,134,134,268,247
0132-000,2017,9,9,6,276,222,498,268
0132-000,2017,9,9,7,447,537,984,498
0132-000,2017,9,9,8,532,967,1499,984
0132-000,2017,9,9,9,753,1075,1828,1499
0132-000,2017,9,9,10,723,1046,1769,1828
0132-000,2017,9,9,11,792,1116,1908,1769
0132-000,2017,9,9,12,875,1267,2142,1908
0132-000,2017,9,9,13,895,1403,2298,2142
0132-000,2017,9,9,14,907,1301,2208,2298
0132-000,2017,9,9,15,954,997,1951,2208
0132-000,2017,9,9,16,909,856,1765,1951
0132-000,2017,9,9,17,1043,898,1941,1765
0132-000,2017,9,9,18,1372,1016,2388,1941
0132-000,2017,9,9,19,1219,838,2057,2388
0132-000,2017,9,9,20,823,638,1461,2057
0132-000,2017,9,9,21,633,503,1136,1461
0132-000,2017,9,9,22,463,420,883,1136
0132-000,2017,9,9,23,318,328,646,883
0132-000,2017,9,9,24,206,231,437,646
0132-000,2017,9,10,1,176,199,375,437
0132-000,2017,9,10,2,126,118,244,375
0132-000,2017,9,10,3,80,109,189,244
0132-000,2017,9,10,4,63,88,151,189
0132-000,2017,9,10,5,76,79,155,151
0132-000,2017,9,10,6,162,125,287,155
0132-000,2017,9,10,7,243,271,514,287
0132-000,2017,9,10,8,332,485,817,514
0132-000,2017,9,10,9,359,500,859,817
0132-000,2017,9,10,10,471,595,1066,859
0132-000,2017,9,10,11,590,639,1229,1066
0132-000,2017,9,10,12,560,612,1172,1229
0132-000,2017,9,10,13,664,659,1323,1172
0132-000,2017,9,10,14,726,694,1420,1323
0132-000,2017,9,10,15,773,640,1413,1420
0132-000,2017,9,10,16,837,718,1555,1413
0132-000,2017,9,10,17,880,684,1564,1555
0132-000,2017,9,10,18,1055,663,1718,1564
0132-000,2017,9,10,19,992,599,1591,1718
0132-000,2017,9,10,20,717,561,1278,1591
0132-000,2017,9,10,21,567,467,1034,1278
0132-000,2017,9,10,22,414,335,749,1034
0132-000,2017,9,10,23,287,297,584,749
0132-000,2017,9,10,24,189,218,407,584
0132-000,2017,9,11,1,107,136,243,407
0132-000,2017,9,11,2,56,83,139,243
0132-000,2017,9,11,3,42,69,111,139
0132-000,2017,9,11,4,62,69,131,111
0132-000,2017,9,11,5,97,73,170,131
0132-000,2017,9,11,6,236,192,428,170
0132-000,2017,9,11,7,398,596,994,428
0132-000,2017,9,11,8,632,1874,2506,994
0132-000,2017,9,11,9,759,1669,2428,2506
0132-000,2017,9,11,10,720,837,1557,2428
0132-000,2017,9,11,11,735,765,1500,1557
0132-000,2017,9,11,12,705,756,1461,1500
0132-000,2017,9,11,13,758,701,1459,1461
0132-000,2017,9,11,14,737,789,1526,1459
0132-000,2017,9,11,15,821,779,1600,1526
0132-000,2017,9,11,16,848,716,1564,1600
0132-000,2017,9,11,17,837,788,1625,1564
0132-000,2017,9,11,18,1224,813,2037,1625
0132-000,2017,9,11,19,1447,791,2238,2037
0132-000,2017,9,11,20,984,641,1625,2238
0132-000,2017,9,11,21,784,495,1279,1625
0132-000,2017,9,11,22,585,439,1024,1279
0132-000,2017,9,11,23,344,287,631,1024
0132-000,2017,9,11,24,221,216,437,631
0132-000,2017,9,12,1,147,146,293,437
0132-000,2017,9,12,2,90,91,181,293
0132-000,2017,9,12,3,58,84,142,181
0132-000,2017,9,12,4,63,83,146,142
0132-000,2017,9,12,5,99,109,208,146
0132-000,2017,9,12,6,288,194,482,208
0132-000,2017,9,12,7,469,663,1132,482
0132-000,2017,9,12,8,691,1933,2624,1132
0132-000,2017,9,12,9,837,1550,2387,2624
0132-000,2017,9,12,10,758,861,1619,2387
0132-000,2017,9,12,11,783,833,1616,1619
0132-000,2017,9,12,12,749,787,1536,1616
0132-000,2017,9,12,13,743,740,1483,1536
0132-000,2017,9,12,14,821,774,1595,1483
0132-000,2017,9,12,15,785,824,1609,1595
0132-000,2017,9,12,16,820,776,1596,1609
0132-000,2017,9,12,17,911,826,1737,1596
0132-000,2017,9,12,18,1269,859,2128,1737
0132-000,2017,9,12,19,1481,847,2328,2128
0132-000,2017,9,12,20,996,687,1683,2328
0132-000,2017,9,12,21,833,525,1358,1683
0132-000,2017,9,12,22,634,421,1055,1358
0132-000,2017,9,12,23,398,328,726,1055
0132-000,2017,9,12,24,224,242,466,726
0132-000,2017,9,13,1,168,157,325,466
0132-000,2017,9,13,2,88,110,198,325
0132-000,2017,9,13,3,60,81,141,198
0132-000,2017,9,13,4,75,77,152,141
0132-000,2017,9,13,5,96,115,211,152
0132-000,2017,9,13,6,276,235,511,211
0132-000,2017,9,13,7,489,663,1152,511
0132-000,2017,9,13,8,692,1870,2562,1152
0132-000,2017,9,13,9,796,1509,2305,2562
0132-000,2017,9,13,10,749,849,1598,2305
0132-000,2017,9,13,11,736,762,1498,1598
0132-000,2017,9,13,12,782,808,1590,1498
0132-000,2017,9,13,13,728,708,1436,1590
0132-000,2017,9,13,14,700,723,1423,1436
0132-000,2017,9,13,15,767,748,1515,1423
0132-000,2017,9,13,16,812,781,1593,1515
0132-000,2017,9,13,17,905,817,1722,1593
0132-000,2017,9,13,18,1394,937,2331,1722
0132-000,2017,9,13,19,1595,812,2407,2331
0132-000,2017,9,13,20,999,706,1705,2407
0132-000,2017,9,13,21,828,546,1374,1705
0132-000,2017,9,13,22,607,438,1045,1374
0132-000,2017,9,13,23,381,360,741,1045
0132-000,2017,9,13,24,230,227,457,741
0132-000,2017,9,14,1,149,161,310,457
0132-000,2017,9,14,2,98,98,196,310
0132-000,2017,9,14,3,77,100,177,196
0132-000,2017,9,14,4,74,92,166,177
0132-000,2017,9,14,5,113,99,212,166
0132-000,2017,9,14,6,291,216,507,212
0132-000,2017,9,14,7,506,655,1161,507
0132-000,2017,9,14,8,737,1954,2691,1161
0132-000,2017,9,14,9,820,1560,2380,2691
0132-000,2017,9,14,10,717,835,1552,2380
0132-000,2017,9,14,11,693,813,1506,1552
0132-000,2017,9,14,12,750,789,1539,1506
0132-000,2017,9,14,13,772,703,1475,1539
0132-000,2017,9,14,14,729,767,1496,1475
0132-000,2017,9,14,15,832,811,1643,1496
0132-000,2017,9,14,16,840,812,1652,1643
0132-000,2017,9,14,17,927,854,1781,1652
0132-000,2017,9,14,18,1300,961,2261,1781
0132-000,2017,9,14,19,1561,845,2406,2261
0132-000,2017,9,14,20,927,690,1617,2406
0132-000,2017,9,14,21,883,529,1412,1617
0132-000,2017,9,14,22,649,463,1112,1412
0132-000,2017,9,14,23,424,303,727,1112
0132-000,2017,9,14,24,253,240,493,727
0132-000,2017,9,15,1,177,190,367,493
0132-000,2017,9,15,2,93,113,206,367
0132-000,2017,9,15,3,83,95,178,206
0132-000,2017,9,15,4,65,92,157,178
0132-000,2017,9,15,5,93,122,215,157
0132-000,2017,9,15,6,292,221,513,215
0132-000,2017,9,15,7,422,637,1059,513
0132-000,2017,9,15,8,731,1905,2636,1059
0132-000,2017,9,15,9,823,1457,2280,2636
0132-000,2017,9,15,10,788,901,1689,2280
0132-000,2017,9,15,11,717,837,1554,1689
0132-000,2017,9,15,12,711,798,1509,1554
0132-000,2017,9,15,13,734,732,1466,1509
0132-000,2017,9,15,14,782,735,1517,1466
0132-000,2017,9,15,15,808,800,1608,1517
0132-000,2017,9,15,16,957,844,1801,1608
0132-000,2017,9,15,17,1072,887,1959,1801
0132-000,2017,9,15,18,1405,1040,2445,1959
0132-000,2017,9,15,19,1728,911,2639,2445
0132-000,2017,9,15,20,1074,781,1855,2639
0132-000,2017,9,15,21,860,565,1425,1855
0132-000,2017,9,15,22,640,527,1167,1425
0132-000,2017,9,15,23,412,350,762,1167
0132-000,2017,9,15,24,278,286,564,762
0132-000,2017,9,16,1,209,193,402,564
0132-000,2017,9,16,2,145,167,312,402
0132-000,2017,9,16,3,88,123,211,312
0132-000,2017,9,16,4,100,114,214,211
0132-000,2017,9,16,5,133,154,287,214
0132-000,2017,9,16,6,265,203,468,287
0132-000,2017,9,16,7,454,577,1031,468
0132-000,2017,9,16,8,573,992,1565,1031
0132-000,2017,9,16,9,747,1106,1853,1565
0132-000,2017,9,16,10,776,1030,1806,1853
0132-000,2017,9,16,11,907,1013,1920,1806
0132-000,2017,9,16,12,911,1071,1982,1920
0132-000,2017,9,16,13,881,1054,1935,1982
0132-000,2017,9,16,14,865,1051,1916,1935
0132-000,2017,9,16,15,938,977,1915,1916
0132-000,2017,9,16,16,974,945,1919,1915
0132-000,2017,9,16,17,1074,1007,2081,1919
0132-000,2017,9,16,18,1478,1098,2576,2081
0132-000,2017,9,16,19,1425,849,2274,2576
0132-000,2017,9,16,20,967,646,1613,2274
0132-000,2017,9,16,21,657,520,1177,1613
0132-000,2017,9,16,22,474,431,905,1177
0132-000,2017,9,16,23,335,305,640,905
0132-000,2017,9,16,24,230,258,488,640
0132-000,2017,9,17,1,197,186,383,488
0132-000,2017,9,17,2,127,139,266,383
0132-000,2017,9,17,3,88,105,193,266
0132-000,2017,9,17,4,72,73,145,193
0132-000,2017,9,17,5,74,82,156,145
0132-000,2017,9,17,6,161,162,323,156
0132-000,2017,9,17,7,244,350,594,323
0132-000,2017,9,17,8,333,550,883,594
0132-000,2017,9,17,9,398,621,1019,883
0132-000,2017,9,17,10,509,598,1107,1019
0132-000,2017,9,17,11,642,668,1310,1107
0132-000,2017,9,17,12,612,669,1281,1310
0132-000,2017,9,17,13,712,705,1417,1281
0132-000,2017,9,17,14,850,729,1579,1417
0132-000,2017,9,17,15,886,761,1647,1579
0132-000,2017,9,17,16,1033,694,1727,1647
0132-000,2017,9,17,17,1276,680,1956,1727
0132-000,2017,9,17,18,1555,737,2292,1956
0132-000,2017,9,17,19,1575,618,2193,2292
0132-000,2017,9,17,20,1280,482,1762,2193
0132-000,2017,9,17,21,1083,530,1613,1762
0132-000,2017,9,17,22,621,442,1063,1613
0132-000,2017,9,17,23,311,273,584,1063
0132-000,2017,9,17,24,196,164,360,584
0132-000,2017,9,18,1,103,140,243,360
0132-000,2017,9,18,2,65,87,152,243
0132-000,2017,9,18,3,54,66,120,152
0132-000,2017,9,18,4,74,71,145,120
0132-000,2017,9,18,5,100,69,169,145
0132-000,2017,9,18,6,300,233,533,169
0132-000,2017,9,18,7,516,741,1257,533
0132-000,2017,9,18,8,696,1959,2655,1257
0132-000,2017,9,18,9,802,1561,2363,2655
0132-000,2017,9,18,10,726,892,1618,2363
0132-000,2017,9,18,11,711,785,1496,1618
0132-000,2017,9,18,12,717,729,1446,1496
0132-000,2017,9,18,13,712,718,1430,1446
0132-000,2017,9,18,14,759,775,1534,1430
0132-000,2017,9,18,15,781,797,1578,1534
0132-000,2017,9,18,16,827,788,1615,1578
0132-000,2017,9,18,17,957,871,1828,1615
0132-000,2017,9,18,18,1250,973,2223,1828
0132-000,2017,9,18,19,1488,824,2312,2223
0132-000,2017,9,18,20,980,649,1629,2312
0132-000,2017,9,18,21,849,549,1398,1629
0132-000,2017,9,18,22,624,444,1068,1398
0132-000,2017,9,18,23,317,321,638,1068
0132-000,2017,9,18,24,214,199,413,638
0132-000,2017,9,19,1,133,137,270,413
0132-000,2017,9,19,2,95,93,188,270
0132-000,2017,9,19,3,70,79,149,188
0132-000,2017,9,19,4,56,79,135,149
0132-000,2017,9,19,5,97,120,217,135
0132-000,2017,9,19,6,282,234,516,217
0132-000,2017,9,19,7,513,659,1172,516
0132-000,2017,9,19,8,665,1907,2572,1172
0132-000,2017,9,19,9,794,1596,2390,2572
0132-000,2017,9,19,10,778,870,1648,2390
0132-000,2017,9,19,11,743,792,1535,1648
0132-000,2017,9,19,12,713,762,1475,1535
0132-000,2017,9,19,13,776,762,1538,1475
0132-000,2017,9,19,14,767,768,1535,1538
0132-000,2017,9,19,15,818,768,1586,1535
0132-000,2017,9,19,16,833,781,1614,1586
0132-000,2017,9,19,17,922,861,1783,1614
0132-000,2017,9,19,18,1282,876,2158,1783
0132-000,2017,9,19,19,1517,832,2349,2158
0132-000,2017,9,19,20,950,717,1667,2349
0132-000,2017,9,19,21,921,508,1429,1667
0132-000,2017,9,19,22,618,441,1059,1429
0132-000,2017,9,19,23,392,307,699,1059
0132-000,2017,9,19,24,229,243,472,699
0132-000,2017,9,20,1,187,159,346,472
0132-000,2017,9,20,2,94,94,188,346
0132-000,2017,9,20,3,67,79,146,188
0132-000,2017,9,20,4,84,101,185,146
0132-000,2017,9,20,5,106,104,210,185
0132-000,2017,9,20,6,276,240,516,210
0132-000,2017,9,20,7,484,651,1135,516
0132-000,2017,9,20,8,712,1898,2610,1135
0132-000,2017,9,20,9,832,1593,2425,2610
0132-000,2017,9,20,10,776,888,1664,2425
0132-000,2017,9,20,11,754,864,1618,1664
0132-000,2017,9,20,12,729,810,1539,1618
0132-000,2017,9,20,13,725,747,1472,1539
0132-000,2017,9,20,14,771,792,1563,1472
0132-000,2017,9,20,15,821,796,1617,1563
0132-000,2017,9,20,16,862,782,1644,1617
0132-000,2017,9,20,17,955,849,1804,1644
0132-000,2017,9,20,18,1373,1007,2380,1804
0132-000,2017,9,20,19,1571,844,2415,2380
0132-000,2017,9,20,20,1019,665,1684,2415
0132-000,2017,9,20,21,806,533,1339,1684
0132-000,2017,9,20,22,584,460,1044,1339
0132-000,2017,9,20,23,389,318,707,1044
0132-000,2017,9,20,24,226,241,467,707
0132-000,2017,9,21,1,154,185,339,467
0132-000,2017,9,21,2,112,102,214,339
0132-000,2017,9,21,3,74,96,170,214
0132-000,2017,9,21,4,76,90,166,170
0132-000,2017,9,21,5,92,112,204,166
0132-000,2017,9,21,6,263,230,493,204
0132-000,2017,9,21,7,479,642,1121,493
0132-000,2017,9,21,8,712,1889,2601,1121
0132-000,2017,9,21,9,842,1549,2391,2601
0132-000,2017,9,21,10,768,929,1697,2391
0132-000,2017,9,21,11,747,873,1620,1697
0132-000,2017,9,21,12,748,735,1483,1620
0132-000,2017,9,21,13,707,720,1427,1483
0132-000,2017,9,21,14,743,818,1561,1427
0132-000,2017,9,21,15,879,784,1663,1561
0132-000,2017,9,21,16,829,804,1633,1663
0132-000,2017,9,21,17,965,841,1806,1633
0132-000,2017,9,21,18,1335,930,2265,1806
0132-000,2017,9,21,19,1511,878,2389,2265
0132-000,2017,9,21,20,1013,672,1685,2389
0132-000,2017,9,21,21,866,516,1382,1685
0132-000,2017,9,21,22,688,443,1131,1382
0132-000,2017,9,21,23,404,333,737,1131
0132-000,2017,9,21,24,228,236,464,737
0132-000,2017,9,22,1,158,202,360,464
0132-000,2017,9,22,2,115,115,230,360
0132-000,2017,9,22,3,63,96,159,230
0132-000,2017,9,22,4,72,95,167,159
0132-000,2017,9,22,5,101,108,209,167
0132-000,2017,9,22,6,255,217,472,209
0132-000,2017,9,22,7,484,685,1169,472
0132-000,2017,9,22,8,687,1832,2519,1169
0132-000,2017,9,22,9,828,1499,2327,2519
0132-000,2017,9,22,10,773,868,1641,2327
0132-000,2017,9,22,11,810,863,1673,1641
0132-000,2017,9,22,12,757,799,1556,1673
0132-000,2017,9,22,13,734,711,1445,1556
0132-000,2017,9,22,14,768,773,1541,1445
0132-000,2017,9,22,15,801,803,1604,1541
0132-000,2017,9,22,16,834,816,1650,1604
0132-000,2017,9,22,17,998,900,1898,1650
0132-000,2017,9,22,18,1423,1038,2461,1898
0132-000,2017,9,22,19,1722,944,2666,2461
0132-000,2017,9,22,20,1106,777,1883,2666
0132-000,2017,9,22,21,881,587,1468,1883
0132-000,2017,9,22,22,653,453,1106,1468
0132-000,2017,9,22,23,365,389,754,1106
0132-000,2017,9,22,24,276,234,510,754
0132-000,2017,9,23,1,169,227,396,510
0132-000,2017,9,23,2,132,130,262,396
0132-000,2017,9,23,3,98,115,213,262
0132-000,2017,9,23,4,70,136,206,213
0132-000,2017,9,23,5,126,127,253,206
0132-000,2017,9,23,6,255,225,480,253
0132-000,2017,9,23,7,425,542,967,480
0132-000,2017,9,23,8,570,1018,1588,967
0132-000,2017,9,23,9,700,1091,1791,1588
0132-000,2017,9,23,10,754,967,1721,1791
0132-000,2017,9,23,11,770,1004,1774,1721
0132-000,2017,9,23,12,934,978,1912,1774
0132-000,2017,9,23,13,878,975,1853,1912
0132-000,2017,9,23,14,814,920,1734,1853
0132-000,2017,9,23,15,1009,961,1970,1734
0132-000,2017,9,23,16,984,930,1914,1970
0132-000,2017,9,23,17,1157,937,2094,1914
0132-000,2017,9,23,18,1614,1078,2692,2094
0132-000,2017,9,23,19,1563,825,2388,2692
0132-000,2017,9,23,20,1076,677,1753,2388
0132-000,2017,9,23,21,777,484,1261,1753
0132-000,2017,9,23,22,512,441,953,1261
0132-000,2017,9,23,23,384,333,717,953
0132-000,2017,9,23,24,231,250,481,717
0132-000,2017,9,24,1,173,173,346,481
0132-000,2017,9,24,2,115,125,240,346
0132-000,2017,9,24,3,86,108,194,240
0132-000,2017,9,24,4,90,96,186,194
0132-000,2017,9,24,5,78,77,155,186
0132-000,2017,9,24,6,161,131,292,155
0132-000,2017,9,24,7,252,341,593,292
0132-000,2017,9,24,8,341,550,891,593
0132-000,2017,9,24,9,387,572,959,891
0132-000,2017,9,24,10,502,628,1130,959
0132-000,2017,9,24,11,595,640,1235,1130
0132-000,2017,9,24,12,588,645,1233,1235
0132-000,2017,9,24,13,731,648,1379,1233
0132-000,2017,9,24,14,732,739,1471,1379
0132-000,2017,9,24,15,798,697,1495,1471
0132-000,2017,9,24,16,904,643,1547,1495
0132-000,2017,9,24,17,925,742,1667,1547
0132-000,2017,9,24,18,1018,689,1707,1667
0132-000,2017,9,24,19,983,664,1647,1707
0132-000,2017,9,24,20,726,510,1236,1647
0132-000,2017,9,24,21,571,477,1048,1236
0132-000,2017,9,24,22,387,409,796,1048
0132-000,2017,9,24,23,249,277,526,796
0132-000,2017,9,24,24,178,188,366,526
0132-000,2017,9,25,1,103,142,245,366
0132-000,2017,9,25,2,79,78,157,245
0132-000,2017,9,25,3,52,66,118,157
0132-000,2017,9,25,4,47,55,102,118
0132-000,2017,9,25,5,112,102,214,102
0132-000,2017,9,25,6,286,237,523,214
0132-000,2017,9,25,7,513,695,1208,523
0132-000,2017,9,25,8,742,1990,2732,1208
0132-000,2017,9,25,9,816,1602,2418,2732
0132-000,2017,9,25,10,755,897,1652,2418
0132-000,2017,9,25,11,728,827,1555,1652
0132-000,2017,9,25,12,736,804,1540,1555
0132-000,2017,9,25,13,744,771,1515,1540
0132-000,2017,9,25,14,839,826,1665,1515
0132-000,2017,9,25,15,854,805,1659,1665
0132-000,2017,9,25,16,857,808,1665,1659
0132-000,2017,9,25,17,946,855,1801,1665
0132-000,2017,9,25,18,1300,965,2265,1801
0132-000,2017,9,25,19,1454,849,2303,2265
0132-000,2017,9,25,20,1037,675,1712,2303
0132-000,2017,9,25,21,865,533,1398,1712
0132-000,2017,9,25,22,676,432,1108,1398
0132-000,2017,9,25,23,371,340,711,1108
0132-000,2017,9,25,24,213,233,446,711
0132-000,2017,9,26,1,169,161,330,446
0132-000,2017,9,26,2,120,103,223,330
0132-000,2017,9,26,3,65,87,152,223
0132-000,2017,9,26,4,71,111,182,152
0132-000,2017,9,26,5,85,120,205,182
0132-000,2017,9,26,6,261,219,480,205
0132-000,2017,9,26,7,471,698,1169,480
0132-000,2017,9,26,8,744,1945,2689,1169
0132-000,2017,9,26,9,804,1571,2375,2689
0132-000,2017,9,26,10,775,922,1697,2375
0132-000,2017,9,26,11,774,856,1630,1697
0132-000,2017,9,26,12,797,828,1625,1630
0132-000,2017,9,26,13,789,790,1579,1625
0132-000,2017,9,26,14,815,807,1622,1579
0132-000,2017,9,26,15,845,783,1628,1622
0132-000,2017,9,26,16,850,843,1693,1628
0132-000,2017,9,26,17,942,829,1771,1693
0132-000,2017,9,26,18,1290,906,2196,1771
0132-000,2017,9,26,19,1549,886,2435,2196
0132-000,2017,9,26,20,990,652,1642,2435
0132-000,2017,9,26,21,889,549,1438,1642
0132-000,2017,9,26,22,644,438,1082,1438
0132-000,2017,9,26,23,397,351,748,1082
0132-000,2017,9,26,24,227,231,458,748
0132-000,2017,9,27,1,163,165,328,458
0132-000,2017,9,27,2,103,128,231,328
0132-000,2017,9,27,3,71,89,160,231
0132-000,2017,9,27,4,85,89,174,160
0132-000,2017,9,27,5,94,121,215,174
0132-000,2017,9,27,6,226,165,391,215
0132-000,2017,9,27,7,464,618,1082,391
0132-000,2017,9,27,8,673,1849,2522,1082
0132-000,2017,9,27,9,869,1581,2450,2522
0132-000,2017,9,27,10,806,909,1715,2450
0132-000,2017,9,27,11,823,859,1682,1715
0132-000,2017,9,27,12,800,838,1638,1682
0132-000,2017,9,27,13,703,737,1440,1638
0132-000,2017,9,27,14,794,788,1582,1440
0132-000,2017,9,27,15,858,853,1711,1582
0132-000,2017,9,27,16,889,820,1709,1711
0132-000,2017,9,27,17,920,800,1720,1709
0132-000,2017,9,27,18,1405,873,2278,1720
0132-000,2017,9,27,19,1604,861,2465,2278
0132-000,2017,9,27,20,1007,712,1719,2465
0132-000,2017,9,27,21,776,593,1369,1719
0132-000,2017,9,27,22,616,422,1038,1369
0132-000,2017,9,27,23,347,351,698,1038
0132-000,2017,9,27,24,249,256,505,698
0132-000,2017,9,28,1,174,174,348,505
0132-000,2017,9,28,2,94,104,198,348
0132-000,2017,9,28,3,75,109,184,198
0132-000,2017,9,28,4,82,100,182,184
0132-000,2017,9,28,5,94,116,210,182
0132-000,2017,9,28,6,262,216,478,210
0132-000,2017,9,28,7,491,633,1124,478
0132-000,2017,9,28,8,717,1907,2624,1124
0132-000,2017,9,28,9,835,1517,2352,2624
0132-000,2017,9,28,10,763,965,1728,2352
0132-000,2017,9,28,11,770,842,1612,1728
0132-000,2017,9,28,12,800,809,1609,1612
0132-000,2017,9,28,13,822,797,1619,1609
0132-000,2017,9,28,14,828,819,1647,1619
0132-000,2017,9,28,15,852,881,1733,1647
0132-000,2017,9,28,16,952,807,1759,1733
0132-000,2017,9,28,17,984,916,1900,1759
0132-000,2017,9,28,18,1288,1017,2305,1900
0132-000,2017,9,28,19,1656,842,2498,2305
0132-000,2017,9,28,20,1069,727,1796,2498
0132-000,2017,9,28,21,874,584,1458,1796
0132-000,2017,9,28,22,646,442,1088,1458
0132-000,2017,9,28,23,426,359,785,1088
0132-000,2017,9,28,24,268,259,527,785
0132-000,2017,9,29,1,200,195,395,527
0132-000,2017,9,29,2,125,125,250,395
0132-000,2017,9,29,3,65,95,160,250
0132-000,2017,9,29,4,97,115,212,160
0132-000,2017,9,29,5,98,120,218,212
0132-000,2017,9,29,6,293,230,523,218
0132-000,2017,9,29,7,458,647,1105,523
0132-000,2017,9,29,8,679,1917,2596,1105
0132-000,2017,9,29,9,838,1489,2327,2596
0132-000,2017,9,29,10,787,1000,1787,2327
0132-000,2017,9,29,11,790,865,1655,1787
0132-000,2017,9,29,12,795,860,1655,1655
0132-000,2017,9,29,13,782,831,1613,1655
0132-000,2017,9,29,14,772,817,1589,1613
0132-000,2017,9,29,15,836,797,1633,1589
0132-000,2017,9,29,16,954,877,1831,1633
0132-000,2017,9,29,17,1017,902,1919,1831
0132-000,2017,9,29,18,1501,990,2491,1919
0132-000,2017,9,29,19,1789,838,2627,2491
0132-000,2017,9,29,20,1127,744,1871,2627
0132-000,2017,9,29,21,794,615,1409,1871
0132-000,2017,9,29,22,586,431,1017,1409
0132-000,2017,9,29,23,404,382,786,1017
0132-000,2017,9,29,24,217,286,503,786
0132-000,2017,9,30,1,177,215,392,503
0132-000,2017,9,30,2,118,152,270,392
0132-000,2017,9,30,3,104,119,223,270
0132-000,2017,9,30,4,100,110,210,223
0132-000,2017,9,30,5,118,139,257,210
0132-000,2017,9,30,6,250,243,493,257
0132-000,2017,9,30,7,410,461,871,493
0132-000,2017,9,30,8,559,1031,1590,871
0132-000,2017,9,30,9,635,936,1571,1590
0132-000,2017,9,30,10,735,921,1656,1571
0132-000,2017,9,30,11,764,934,1698,1656
0132-000,2017,9,30,12,790,976,1766,1698
0132-000,2017,9,30,13,806,872,1678,1766
0132-000,2017,9,30,14,816,903,1719,1678
0132-000,2017,9,30,15,838,924,1762,1719
0132-000,2017,9,30,16,899,851,1750,1762
0132-000,2017,9,30,17,978,900,1878,1750
0132-000,2017,9,30,18,1240,984,2224,1878
0132-000,2017,9,30,19,1105,819,1924,2224
0132-000,2017,9,30,20,730,618,1348,1924
0132-000,2017,9,30,21,539,467,1006,1348
0132-000,2017,9,30,22,427,372,799,1006
0132-000,2017,9,30,23,311,306,617,799
0132-000,2017,9,30,24,223,246,469,617
0132-000,2017,10,1,1,159,159,318,469
0132-000,2017,10,1,2,106,120,226,318
0132-000,2017,10,1,3,87,93,180,226
0132-000,2017,10,1,4,70,97,167,180
0132-000,2017,10,1,5,89,109,198,167
0132-000,2017,10,1,6,154,140,294,198
0132-000,2017,10,1,7,274,314,588,294
0132-000,2017,10,1,8,329,559,888,588
0132-000,2017,10,1,9,427,656,1083,888
0132-000,2017,10,1,10,464,701,1165,1083
0132-000,2017,10,1,11,535,741,1276,1165
0132-000,2017,10,1,12,612,734,1346,1276
0132-000,2017,10,1,13,685,734,1419,1346
0132-000,2017,10,1,14,678,791,1469,1419
0132-000,2017,10,1,15,753,838,1591,1469
0132-000,2017,10,1,16,759,705,1464,1591
0132-000,2017,10,1,17,842,704,1546,1464
0132-000,2017,10,1,18,893,693,1586,1546
0132-000,2017,10,1,19,920,574,1494,1586
0132-000,2017,10,1,20,565,461,1026,1494
0132-000,2017,10,1,21,450,397,847,1026
0132-000,2017,10,1,22,366,343,709,847
0132-000,2017,10,1,23,224,250,474,709
0132-000,2017,10,1,24,146,176,322,474
0132-000,2017,10,2,1,114,120,234,322
0132-000,2017,10,2,2,72,74,146,234
0132-000,2017,10,2,3,63,74,137,146
0132-000,2017,10,2,4,58,74,132,137
0132-000,2017,10,2,5,51,74,125,132
0132-000,2017,10,2,6,114,150,264,125
0132-000,2017,10,2,7,244,329,573,264
0132-000,2017,10,2,8,422,728,1150,573
0132-000,2017,10,2,9,493,749,1242,1150
0132-000,2017,10,2,10,585,775,1360,1242
0132-000,2017,10,2,11,697,920,1617,1360
0132-000,2017,10,2,12,697,967,1664,1617
0132-000,2017,10,2,13,749,1165,1914,1664
0132-000,2017,10,2,14,736,1327,2063,1914
0132-000,2017,10,2,15,839,1230,2069,2063
0132-000,2017,10,2,16,912,1235,2147,2069
0132-000,2017,10,2,17,934,1298,2232,2147
0132-000,2017,10,2,18,1012,1396,2408,2232
0132-000,2017,10,2,19,918,1036,1954,2408
0132-000,2017,10,2,20,620,653,1273,1954
0132-000,2017,10,2,21,512,504,1016,1273
0132-000,2017,10,2,22,395,438,833,1016
0132-000,2017,10,2,23,261,332,593,833
0132-000,2017,10,2,24,181,255,436,593
0132-000,2017,10,3,1,151,179,330,436
0132-000,2017,10,3,2,83,117,200,330
0132-000,2017,10,3,3,88,103,191,200
0132-000,2017,10,3,4,68,98,166,191
0132-000,2017,10,3,5,72,99,171,166
0132-000,2017,10,3,6,118,141,259,171
0132-000,2017,10,3,7,127,396,523,259
0132-000,2017,10,3,8,223,646,869,523
0132-000,2017,10,3,9,341,1034,1375,869
0132-000,2017,10,3,10,440,1175,1615,1375
0132-000,2017,10,3,11,546,1357,1903,1615
0132-000,2017,10,3,12,616,1452,2068,1903
0132-000,2017,10,3,13,565,1709,2274,2068
0132-000,2017,10,3,14,550,1308,1858,2274
0132-000,2017,10,3,15,533,1084,1617,1858
0132-000,2017,10,3,16,569,871,1440,1617
0132-000,2017,10,3,17,568,811,1379,1440
0132-000,2017,10,3,18,571,617,1188,1379
0132-000,2017,10,3,19,540,501,1041,1188
0132-000,2017,10,3,20,419,339,758,1041
0132-000,2017,10,3,21,313,312,625,758
0132-000,2017,10,3,22,263,298,561,625
0132-000,2017,10,3,23,171,193,364,561
0132-000,2017,10,3,24,136,154,290,364
0132-000,2017,10,4,1,103,111,214,290
0132-000,2017,10,4,2,59,72,131,214
0132-000,2017,10,4,3,49,59,108,131
0132-000,2017,10,4,4,43,57,100,108
0132-000,2017,10,4,5,39,44,83,100
0132-000,2017,10,4,6,66,102,168,83
0132-000,2017,10,4,7,188,316,504,168
0132-000,2017,10,4,8,352,638,990,504
0132-000,2017,10,4,9,378,583,961,990
0132-000,2017,10,4,10,382,696,1078,961
0132-000,2017,10,4,11,651,1051,1702,1078
0132-000,2017,10,4,12,920,1326,2246,1702
0132-000,2017,10,4,13,972,1670,2642,2246
0132-000,2017,10,4,14,1331,1781,3112,2642
0132-000,2017,10,4,15,1451,1707,3158,3112
0132-000,2017,10,4,16,1629,1758,3387,3158
0132-000,2017,10,4,17,1861,1847,3708,3387
0132-000,2017,10,4,18,1830,1394,3224,3708
0132-000,2017,10,4,19,1811,1404,3215,3224
0132-000,2017,10,4,20,1769,1051,2820,3215
0132-000,2017,10,4,21,1469,441,1910,2820
0132-000,2017,10,4,22,1214,288,1502,1910
0132-000,2017,10,4,23,648,245,893,1502
0132-000,2017,10,4,24,525,196,721,893
0132-000,2017,10,5,1,284,125,409,721
0132-000,2017,10,5,2,138,85,223,409
0132-000,2017,10,5,3,81,46,127,223
0132-000,2017,10,5,4,43,51,94,127
0132-000,2017,10,5,5,53,48,101,94
0132-000,2017,10,5,6,69,78,147,101
0132-000,2017,10,5,7,114,130,244,147
0132-000,2017,10,5,8,216,237,453,244
0132-000,2017,10,5,9,273,319,592,453
0132-000,2017,10,5,10,372,505,877,592
0132-000,2017,10,5,11,528,787,1315,877
0132-000,2017,10,5,12,714,973,1687,1315
0132-000,2017,10,5,13,674,1018,1692,1687
0132-000,2017,10,5,14,627,1091,1718,1692
0132-000,2017,10,5,15,812,1112,1924,1718
0132-000,2017,10,5,16,966,798,1764,1924
0132-000,2017,10,5,17,1179,698,1877,1764
0132-000,2017,10,5,18,1520,543,2063,1877
0132-000,2017,10,5,19,1727,435,2162,2063
0132-000,2017,10,5,20,1499,354,1853,2162
0132-000,2017,10,5,21,1688,302,1990,1853
0132-000,2017,10,5,22,1528,257,1785,1990
0132-000,2017,10,5,23,1881,240,2121,1785
0132-000,2017,10,5,24,1500,178,1678,2121
0132-000,2017,10,6,1,1495,114,1609,1678
0132-000,2017,10,6,2,538,120,658,1609
0132-000,2017,10,6,3,253,104,357,658
0132-000,2017,10,6,4,104,68,172,357
0132-000,2017,10,6,5,73,73,146,172
0132-000,2017,10,6,6,81,91,172,146
0132-000,2017,10,6,7,154,176,330,172
0132-000,2017,10,6,8,279,386,665,330
0132-000,2017,10,6,9,321,401,722,665
0132-000,2017,10,6,10,422,431,853,722
0132-000,2017,10,6,11,499,570,1069,853
0132-000,2017,10,6,12,621,652,1273,1069
0132-000,2017,10,6,13,611,625,1236,1273
0132-000,2017,10,6,14,685,669,1354,1236
0132-000,2017,10,6,15,764,622,1386,1354
0132-000,2017,10,6,16,911,592,1503,1386
0132-000,2017,10,6,17,1097,599,1696,1503
0132-000,2017,10,6,18,1363,601,1964,1696
0132-000,2017,10,6,19,1483,494,1977,1964
0132-000,2017,10,6,20,1342,391,1733,1977
0132-000,2017,10,6,21,1232,366,1598,1733
0132-000,2017,10,6,22,1002,302,1304,1598
0132-000,2017,10,6,23,931,247,1178,1304
0132-000,2017,10,6,24,584,207,791,1178
0132-000,2017,10,7,1,334,176,510,791
0132-000,2017,10,7,2,97,132,229,510
0132-000,2017,10,7,3,81,101,182,229
0132-000,2017,10,7,4,56,105,161,182
0132-000,2017,10,7,5,69,91,160,161
0132-000,2017,10,7,6,102,115,217,160
0132-000,2017,10,7,7,203,267,470,217
0132-000,2017,10,7,8,307,489,796,470
0132-000,2017,10,7,9,422,502,924,796
0132-000,2017,10,7,10,507,574,1081,924
0132-000,2017,10,7,11,596,693,1289,1081
0132-000,2017,10,7,12,633,660,1293,1289
0132-000,2017,10,7,13,703,719,1422,1293
0132-000,2017,10,7,14,731,657,1388,1422
0132-000,2017,10,7,15,695,693,1388,1388
0132-000,2017,10,7,16,786,658,1444,1388
0132-000,2017,10,7,17,904,629,1533,1444
0132-000,2017,10,7,18,1159,714,1873,1533
0132-000,2017,10,7,19,1141,581,1722,1873
0132-000,2017,10,7,20,932,422,1354,1722
0132-000,2017,10,7,21,785,362,1147,1354
0132-000,2017,10,7,22,446,338,784,1147
0132-000,2017,10,7,23,285,261,546,784
0132-000,2017,10,7,24,198,198,396,546
0132-000,2017,10,8,1,157,157,314,396
0132-000,2017,10,8,2,108,138,246,314
0132-000,2017,10,8,3,90,107,197,246
0132-000,2017,10,8,4,60,75,135,197
0132-000,2017,10,8,5,80,78,158,135
0132-000,2017,10,8,6,101,97,198,158
0132-000,2017,10,8,7,191,210,401,198
0132-000,2017,10,8,8,306,369,675,401
0132-000,2017,10,8,9,318,431,749,675
0132-000,2017,10,8,10,427,500,927,749
0132-000,2017,10,8,11,504,568,1072,927
0132-000,2017,10,8,12,518,577,1095,1072
0132-000,2017,10,8,13,566,665,1231,1095
0132-000,2017,10,8,14,644,632,1276,1231
0132-000,2017,10,8,15,773,694,1467,1276
0132-000,2017,10,8,16,750,667,1417,1467
0132-000,2017,10,8,17,790,651,1441,1417
0132-000,2017,10,8,18,966,659,1625,1441
0132-000,2017,10,8,19,836,541,1377,1625
0132-000,2017,10,8,20,608,424,1032,1377
0132-000,2017,10,8,21,494,371,865,1032
0132-000,2017,10,8,22,378,320,698,865
0132-000,2017,10,8,23,239,282,521,698
0132-000,2017,10,8,24,170,220,390,521
0132-000,2017,10,9,1,138,153,291,390
0132-000,2017,10,9,2,81,101,182,291
0132-000,2017,10,9,3,76,87,163,182
0132-000,2017,10,9,4,66,99,165,163
0132-000,2017,10,9,5,92,75,167,165
0132-000,2017,10,9,6,165,173,338,167
0132-000,2017,10,9,7,336,396,732,338
0132-000,2017,10,9,8,494,961,1455,732
0132-000,2017,10,9,9,479,697,1176,1455
0132-000,2017,10,9,10,541,645,1186,1176
0132-000,2017,10,9,11,571,707,1278,1186
0132-000,2017,10,9,12,639,696,1335,1278
0132-000,2017,10,9,13,693,688,1381,1335
0132-000,2017,10,9,14,734,741,1475,1381
0132-000,2017,10,9,15,762,784,1546,1475
0132-000,2017,10,9,16,809,739,1548,1546
0132-000,2017,10,9,17,845,736,1581,1548
0132-000,2017,10,9,18,1154,814,1968,1581
0132-000,2017,10,9,19,1036,667,1703,1968
0132-000,2017,10,9,20,671,532,1203,1703
0132-000,2017,10,9,21,507,474,981,1203
0132-000,2017,10,9,22,376,334,710,981
0132-000,2017,10,9,23,248,274,522,710
0132-000,2017,10,9,24,156,197,353,522
0132-000,2017,10,10,1,104,116,220,353
0132-000,2017,10,10,2,74,77,151,220
0132-000,2017,10,10,3,57,77,134,151
0132-000,2017,10,10,4,55,68,123,134
0132-000,2017,10,10,5,89,92,181,123
0132-000,2017,10,10,6,253,188,441,181
0132-000,2017,10,10,7,458,625,1083,441
0132-000,2017,10,10,8,721,1927,2648,1083
0132-000,2017,10,10,9,829,1630,2459,2648
0132-000,2017,10,10,10,739,796,1535,2459
0132-000,2017,10,10,11,717,790,1507,1535
0132-000,2017,10,10,12,771,821,1592,1507
0132-000,2017,10,10,13,736,726,1462,1592
0132-000,2017,10,10,14,737,822,1559,1462
0132-000,2017,10,10,15,786,819,1605,1559
0132-000,2017,10,10,16,811,776,1587,1605
0132-000,2017,10,10,17,941,785,1726,1587
0132-000,2017,10,10,18,1279,945,2224,1726
0132-000,2017,10,10,19,1560,834,2394,2224
0132-000,2017,10,10,20,957,655,1612,2394
0132-000,2017,10,10,21,824,484,1308,1612
0132-000,2017,10,10,22,553,399,952,1308
0132-000,2017,10,10,23,343,307,650,952
0132-000,2017,10,10,24,211,190,401,650
0132-000,2017,10,11,1,158,156,314,401
0132-000,2017,10,11,2,102,82,184,314
0132-000,2017,10,11,3,57,80,137,184
0132-000,2017,10,11,4,71,90,161,137
0132-000,2017,10,11,5,88,96,184,161
0132-000,2017,10,11,6,215,183,398,184
0132-000,2017,10,11,7,361,549,910,398
0132-000,2017,10,11,8,604,1763,2367,910
0132-000,2017,10,11,9,775,1593,2368,2367
0132-000,2017,10,11,10,733,856,1589,2368
0132-000,2017,10,11,11,702,778,1480,1589
0132-000,2017,10,11,12,705,733,1438,1480
0132-000,2017,10,11,13,695,719,1414,1438
0132-000,2017,10,11,14,764,762,1526,1414
0132-000,2017,10,11,15,824,789,1613,1526
0132-000,2017,10,11,16,820,772,1592,1613
0132-000,2017,10,11,17,893,785,1678,1592
0132-000,2017,10,11,18,1244,875,2119,1678
0132-000,2017,10,11,19,1587,795,2382,2119
0132-000,2017,10,11,20,917,656,1573,2382
0132-000,2017,10,11,21,770,475,1245,1573
0132-000,2017,10,11,22,559,439,998,1245
0132-000,2017,10,11,23,337,315,652,998
0132-000,2017,10,11,24,213,236,449,652
0132-000,2017,10,12,1,150,158,308,449
0132-000,2017,10,12,2,113,101,214,308
0132-000,2017,10,12,3,72,90,162,214
0132-000,2017,10,12,4,67,98,165,162
0132-000,2017,10,12,5,112,105,217,165
0132-000,2017,10,12,6,263,220,483,217
0132-000,2017,10,12,7,442,569,1011,483
0132-000,2017,10,12,8,681,1852,2533,1011
0132-000,2017,10,12,9,826,1566,2392,2533
0132-000,2017,10,12,10,743,930,1673,2392
0132-000,2017,10,12,11,773,827,1600,1673
0132-000,2017,10,12,12,711,783,1494,1600
0132-000,2017,10,12,13,690,745,1435,1494
0132-000,2017,10,12,14,724,747,1471,1435
0132-000,2017,10,12,15,726,740,1466,1471
0132-000,2017,10,12,16,791,737,1528,1466
0132-000,2017,10,12,17,919,782,1701,1528
0132-000,2017,10,12,18,1277,910,2187,1701
0132-000,2017,10,12,19,1426,784,2210,2187
0132-000,2017,10,12,20,907,677,1584,2210
0132-000,2017,10,12,21,862,510,1372,1584
0132-000,2017,10,12,22,629,431,1060,1372
0132-000,2017,10,12,23,353,330,683,1060
0132-000,2017,10,12,24,263,214,477,683
0132-000,2017,10,13,1,166,161,327,477
0132-000,2017,10,13,2,98,112,210,327
0132-000,2017,10,13,3,78,72,150,210
0132-000,2017,10,13,4,81,72,153,150
0132-000,2017,10,13,5,100,111,211,153
0132-000,2017,10,13,6,250,200,450,211
0132-000,2017,10,13,7,421,591,1012,450
0132-000,2017,10,13,8,687,1852,2539,1012
0132-000,2017,10,13,9,828,1551,2379,2539
0132-000,2017,10,13,10,829,902,1731,2379
0132-000,2017,10,13,11,789,860,1649,1731
0132-000,2017,10,13,12,762,885,1647,1649
0132-000,2017,10,13,13,815,780,1595,1647
0132-000,2017,10,13,14,781,821,1602,1595
0132-000,2017,10,13,15,888,884,1772,1602
0132-000,2017,10,13,16,892,804,1696,1772
0132-000,2017,10,13,17,1069,843,1912,1696
0132-000,2017,10,13,18,1437,1041,2478,1912
0132-000,2017,10,13,19,1736,916,2652,2478
0132-000,2017,10,13,20,1081,741,1822,2652
0132-000,2017,10,13,21,848,563,1411,1822
0132-000,2017,10,13,22,603,463,1066,1411
0132-000,2017,10,13,23,351,349,700,1066
0132-000,2017,10,13,24,241,254,495,700
0132-000,2017,10,14,1,196,204,400,495
0132-000,2017,10,14,2,132,139,271,400
0132-000,2017,10,14,3,87,123,210,271
0132-000,2017,10,14,4,86,100,186,210
0132-000,2017,10,14,5,89,120,209,186
0132-000,2017,10,14,6,265,185,450,209
0132-000,2017,10,14,7,389,467,856,450
0132-000,2017,10,14,8,507,1011,1518,856
0132-000,2017,10,14,9,707,1074,1781,1518
0132-000,2017,10,14,10,799,843,1642,1781
0132-000,2017,10,14,11,789,862,1651,1642
0132-000,2017,10,14,12,812,889,1701,1651
0132-000,2017,10,14,13,776,833,1609,1701
0132-000,2017,10,14,14,793,855,1648,1609
0132-000,2017,10,14,15,1002,942,1944,1648
0132-000,2017,10,14,16,963,869,1832,1944
0132-000,2017,10,14,17,1056,927,1983,1832
0132-000,2017,10,14,18,1459,937,2396,1983
0132-000,2017,10,14,19,1220,795,2015,2396
0132-000,2017,10,14,20,689,608,1297,2015
0132-000,2017,10,14,21,562,461,1023,1297
0132-000,2017,10,14,22,403,394,797,1023
0132-000,2017,10,14,23,313,293,606,797
0132-000,2017,10,14,24,206,227,433,606
0132-000,2017,10,15,1,159,202,361,433
0132-000,2017,10,15,2,123,106,229,361
0132-000,2017,10,15,3,102,100,202,229
0132-000,2017,10,15,4,66,88,154,202
0132-000,2017,10,15,5,65,86,151,154
0132-000,2017,10,15,6,164,136,300,151
0132-000,2017,10,15,7,229,256,485,300
0132-000,2017,10,15,8,333,445,778,485
0132-000,2017,10,15,9,390,497,887,778
0132-000,2017,10,15,10,484,632,1116,887
0132-000,2017,10,15,11,561,684,1245,1116
0132-000,2017,10,15,12,613,680,1293,1245
0132-000,2017,10,15,13,625,697,1322,1293
0132-000,2017,10,15,14,664,727,1391,1322
0132-000,2017,10,15,15,787,811,1598,1391
0132-000,2017,10,15,16,818,769,1587,1598
0132-000,2017,10,15,17,939,794,1733,1587
0132-000,2017,10,15,18,1087,762,1849,1733
0132-000,2017,10,15,19,926,674,1600,1849
0132-000,2017,10,15,20,698,525,1223,1600
0132-000,2017,10,15,21,541,434,975,1223
0132-000,2017,10,15,22,353,367,720,975
0132-000,2017,10,15,23,252,292,544,720
0132-000,2017,10,15,24,137,175,312,544
0132-000,2017,10,16,1,115,121,236,312
0132-000,2017,10,16,2,73,84,157,236
0132-000,2017,10,16,3,38,71,109,157
0132-000,2017,10,16,4,52,77,129,109
0132-000,2017,10,16,5,92,85,177,129
0132-000,2017,10,16,6,280,208,488,177
0132-000,2017,10,16,7,463,677,1140,488
0132-000,2017,10,16,8,703,1958,2661,1140
0132-000,2017,10,16,9,797,1619,2416,2661
0132-000,2017,10,16,10,725,870,1595,2416
0132-000,2017,10,16,11,787,775,1562,1595
0132-000,2017,10,16,12,766,841,1607,1562
0132-000,2017,10,16,13,712,777,1489,1607
0132-000,2017,10,16,14,793,808,1601,1489
0132-000,2017,10,16,15,787,852,1639,1601
0132-000,2017,10,16,16,904,783,1687,1639
0132-000,2017,10,16,17,935,922,1857,1687
0132-000,2017,10,16,18,1262,962,2224,1857
0132-000,2017,10,16,19,1521,831,2352,2224
0132-000,2017,10,16,20,956,663,1619,2352
0132-000,2017,10,16,21,876,473,1349,1619
0132-000,2017,10,16,22,599,447,1046,1349
0132-000,2017,10,16,23,357,324,681,1046
0132-000,2017,10,16,24,187,201,388,681
0132-000,2017,10,17,1,144,141,285,388
0132-000,2017,10,17,2,99,102,201,285
0132-000,2017,10,17,3,76,76,152,201
0132-000,2017,10,17,4,54,93,147,152
0132-000,2017,10,17,5,92,94,186,147
0132-000,2017,10,17,6,275,193,468,186
0132-000,2017,10,17,7,439,559,998,468
0132-000,2017,10,17,8,677,1889,2566,998
0132-000,2017,10,17,9,840,1583,2423,2566
0132-000,2017,10,17,10,740,951,1691,2423
0132-000,2017,10,17,11,759,800,1559,1691
0132-000,2017,10,17,12,755,755,1510,1559
0132-000,2017,10,17,13,752,777,1529,1510
0132-000,2017,10,17,14,815,773,1588,1529
0132-000,2017,10,17,15,825,794,1619,1588
0132-000,2017,10,17,16,858,816,1674,1619
0132-000,2017,10,17,17,968,846,1814,1674
0132-000,2017,10,17,18,1383,1018,2401,1814
0132-000,2017,10,17,19,1462,805,2267,2401
0132-000,2017,10,17,20,883,640,1523,2267
0132-000,2017,10,17,21,855,525,1380,1523
0132-000,2017,10,17,22,643,492,1135,1380
0132-000,2017,10,17,23,344,308,652,1135
0132-000,2017,10,17,24,252,228,480,652
0132-000,2017,10,18,1,162,167,329,480
0132-000,2017,10,18,2,104,102,206,329
0132-000,2017,10,18,3,68,77,145,206
0132-000,2017,10,18,4,69,80,149,145
0132-000,2017,10,18,5,108,98,206,149
0132-000,2017,10,18,6,263,223,486,206
0132-000,2017,10,18,7,433,580,1013,486
0132-000,2017,10,18,8,675,1872,2547,1013
0132-000,2017,10,18,9,882,1575,2457,2547
0132-000,2017,10,18,10,755,926,1681,2457
0132-000,2017,10,18,11,736,803,1539,1681
0132-000,2017,10,18,12,766,788,1554,1539
0132-000,2017,10,18,13,710,806,1516,1554
0132-000,2017,10,18,14,771,774,1545,1516
0132-000,2017,10,18,15,838,799,1637,1545
0132-000,2017,10,18,16,883,747,1630,1637
0132-000,2017,10,18,17,894,878,1772,1630
0132-000,2017,10,18,18,1431,934,2365,1772
0132-000,2017,10,18,19,1620,789,2409,2365
0132-000,2017,10,18,20,921,650,1571,2409
0132-000,2017,10,18,21,754,504,1258,1571
0132-000,2017,10,18,22,506,401,907,1258
0132-000,2017,10,18,23,344,309,653,907
0132-000,2017,10,18,24,211,236,447,653
0132-000,2017,10,19,1,174,183,357,447
0132-000,2017,10,19,2,113,116,229,357
0132-000,2017,10,19,3,73,96,169,229
0132-000,2017,10,19,4,56,84,140,169
0132-000,2017,10,19,5,84,108,192,140
0132-000,2017,10,19,6,263,212,475,192
0132-000,2017,10,19,7,458,580,1038,475
0132-000,2017,10,19,8,718,1843,2561,1038
0132-000,2017,10,19,9,846,1631,2477,2561
0132-000,2017,10,19,10,772,910,1682,2477
0132-000,2017,10,19,11,815,792,1607,1682
0132-000,2017,10,19,12,737,827,1564,1607
0132-000,2017,10,19,13,719,757,1476,1564
0132-000,2017,10,19,14,774,795,1569,1476
0132-000,2017,10,19,15,824,833,1657,1569
0132-000,2017,10,19,16,892,821,1713,1657
0132-000,2017,10,19,17,963,849,1812,1713
0132-000,2017,10,19,18,1383,995,2378,1812
0132-000,2017,10,19,19,1407,847,2254,2378
0132-000,2017,10,19,20,886,626,1512,2254
0132-000,2017,10,19,21,827,486,1313,1512
0132-000,2017,10,19,22,621,452,1073,1313
0132-000,2017,10,19,23,400,316,716,1073
0132-000,2017,10,19,24,227,219,446,716
0132-000,2017,10,20,1,162,148,310,446
0132-000,2017,10,20,2,91,113,204,310
0132-000,2017,10,20,3,61,76,137,204
0132-000,2017,10,20,4,66,80,146,137
0132-000,2017,10,20,5,108,126,234,146
0132-000,2017,10,20,6,262,193,455,234
0132-000,2017,10,20,7,461,596,1057,455
0132-000,2017,10,20,8,689,1834,2523,1057
0132-000,2017,10,20,9,870,1612,2482,2523
0132-000,2017,10,20,10,826,960,1786,2482
0132-000,2017,10,20,11,788,891,1679,1786
0132-000,2017,10,20,12,829,855,1684,1679
0132-000,2017,10,20,13,796,783,1579,1684
0132-000,2017,10,20,14,816,796,1612,1579
0132-000,2017,10,20,15,894,871,1765,1612
0132-000,2017,10,20,16,941,887,1828,1765
0132-000,2017,10,20,17,1035,890,1925,1828
0132-000,2017,10,20,18,1386,1040,2426,1925
0132-000,2017,10,20,19,1457,926,2383,2426
0132-000,2017,10,20,20,1045,732,1777,2383
0132-000,2017,10,20,21,893,519,1412,1777
0132-000,2017,10,20,22,619,457,1076,1412
0132-000,2017,10,20,23,392,355,747,1076
0132-000,2017,10,20,24,247,297,544,747
0132-000,2017,10,21,1,202,186,388,544
0132-000,2017,10,21,2,137,148,285,388
0132-000,2017,10,21,3,107,130,237,285
0132-000,2017,10,21,4,89,104,193,237
0132-000,2017,10,21,5,124,141,265,193
0132-000,2017,10,21,6,258,189,447,265
0132-000,2017,10,21,7,445,488,933,447
0132-000,2017,10,21,8,592,939,1531,933
0132-000,2017,10,21,9,759,1038,1797,1531
0132-000,2017,10,21,10,801,931,1732,1797
0132-000,2017,10,21,11,773,1025,1798,1732
0132-000,2017,10,21,12,755,1041,1796,1798
0132-000,2017,10,21,13,896,988,1884,1796
0132-000,2017,10,21,14,796,958,1754,1884
0132-000,2017,10,21,15,905,916,1821,1754
0132-000,2017,10,21,16,928,940,1868,1821
0132-000,2017,10,21,17,1039,914,1953,1868
0132-000,2017,10,21,18,1320,973,2293,1953
0132-000,2017,10,21,19,1300,865,2165,2293
0132-000,2017,10,21,20,788,618,1406,2165
0132-000,2017,10,21,21,582,474,1056,1406
0132-000,2017,10,21,22,505,422,927,1056
0132-000,2017,10,21,23,323,318,641,927
0132-000,2017,10,21,24,220,235,455,641
0132-000,2017,10,22,1,173,174,347,455
0132-000,2017,10,22,2,113,138,251,347
0132-000,2017,10,22,3,99,115,214,251
0132-000,2017,10,22,4,73,88,161,214
0132-000,2017,10,22,5,79,88,167,161
0132-000,2017,10,22,6,138,138,276,167
0132-000,2017,10,22,7,223,233,456,276
0132-000,2017,10,22,8,338,435,773,456
0132-000,2017,10,22,9,446,520,966,773
0132-000,2017,10,22,10,502,635,1137,966
0132-000,2017,10,22,11,606,652,1258,1137
0132-000,2017,10,22,12,640,698,1338,1258
0132-000,2017,10,22,13,701,638,1339,1338
0132-000,2017,10,22,14,688,751,1439,1339
0132-000,2017,10,22,15,827,719,1546,1439
0132-000,2017,10,22,16,828,718,1546,1546
0132-000,2017,10,22,17,982,729,1711,1546
0132-000,2017,10,22,18,1041,762,1803,1711
0132-000,2017,10,22,19,977,610,1587,1803
0132-000,2017,10,22,20,699,510,1209,1587
0132-000,2017,10,22,21,596,448,1044,1209
0132-000,2017,10,22,22,382,376,758,1044
0132-000,2017,10,22,23,257,275,532,758
0132-000,2017,10,22,24,176,198,374,532
0132-000,2017,10,23,1,118,152,270,374
0132-000,2017,10,23,2,74,75,149,270
0132-000,2017,10,23,3,53,68,121,149
0132-000,2017,10,23,4,51,61,112,121
0132-000,2017,10,23,5,108,75,183,112
0132-000,2017,10,23,6,287,251,538,183
0132-000,2017,10,23,7,517,667,1184,538
0132-000,2017,10,23,8,684,1871,2555,1184
0132-000,2017,10,23,9,850,1594,2444,2555
0132-000,2017,10,23,10,724,900,1624,2444
0132-000,2017,10,23,11,772,811,1583,1624
0132-000,2017,10,23,12,751,816,1567,1583
0132-000,2017,10,23,13,741,770,1511,1567
0132-000,2017,10,23,14,821,805,1626,1511
0132-000,2017,10,23,15,831,810,1641,1626
0132-000,2017,10,23,16,832,779,1611,1641
0132-000,2017,10,23,17,985,855,1840,1611
0132-000,2017,10,23,18,1349,1029,2378,1840
0132-000,2017,10,23,19,1492,846,2338,2378
0132-000,2017,10,23,20,903,650,1553,2338
0132-000,2017,10,23,21,832,513,1345,1553
0132-000,2017,10,23,22,575,420,995,1345
0132-000,2017,10,23,23,326,295,621,995
0132-000,2017,10,23,24,226,183,409,621
0132-000,2017,10,24,1,144,141,285,409
0132-000,2017,10,24,2,92,122,214,285
0132-000,2017,10,24,3,62,79,141,214
0132-000,2017,10,24,4,86,98,184,141
0132-000,2017,10,24,5,96,107,203,184
0132-000,2017,10,24,6,270,231,501,203
0132-000,2017,10,24,7,467,602,1069,501
0132-000,2017,10,24,8,727,1873,2600,1069
0132-000,2017,10,24,9,843,1568,2411,2600
0132-000,2017,10,24,10,791,924,1715,2411
0132-000,2017,10,24,11,709,825,1534,1715
0132-000,2017,10,24,12,760,815,1575,1534
0132-000,2017,10,24,13,686,768,1454,1575
0132-000,2017,10,24,14,770,773,1543,1454
0132-000,2017,10,24,15,869,834,1703,1543
0132-000,2017,10,24,16,920,772,1692,1703
0132-000,2017,10,24,17,931,872,1803,1692
0132-000,2017,10,24,18,1309,955,2264,1803
0132-000,2017,10,24,19,1518,876,2394,2264
0132-000,2017,10,24,20,857,654,1511,2394
0132-000,2017,10,24,21,838,492,1330,1511
0132-000,2017,10,24,22,624,423,1047,1330
0132-000,2017,10,24,23,311,280,591,1047
0132-000,2017,10,24,24,232,209,441,591
0132-000,2017,10,25,1,157,159,316,441
0132-000,2017,10,25,2,106,97,203,316
0132-000,2017,10,25,3,76,76,152,203
0132-000,2017,10,25,4,73,76,149,152
0132-000,2017,10,25,5,97,114,211,149
0132-000,2017,10,25,6,260,226,486,211
0132-000,2017,10,25,7,472,569,1041,486
0132-000,2017,10,25,8,697,1885,2582,1041
0132-000,2017,10,25,9,860,1493,2353,2582
0132-000,2017,10,25,10,723,908,1631,2353
0132-000,2017,10,25,11,769,823,1592,1631
0132-000,2017,10,25,12,762,839,1601,1592
0132-000,2017,10,25,13,748,759,1507,1601
0132-000,2017,10,25,14,806,821,1627,1507
0132-000,2017,10,25,15,813,857,1670,1627
0132-000,2017,10,25,16,896,808,1704,1670
0132-000,2017,10,25,17,962,918,1880,1704
0132-000,2017,10,25,18,1418,981,2399,1880
0132-000,2017,10,25,19,1638,834,2472,2399
0132-000,2017,10,25,20,947,651,1598,2472
0132-000,2017,10,25,21,738,534,1272,1598
0132-000,2017,10,25,22,524,450,974,1272
0132-000,2017,10,25,23,344,321,665,974
0132-000,2017,10,25,24,214,230,444,665
0132-000,2017,10,26,1,162,167,329,444
0132-000,2017,10,26,2,120,113,233,329
0132-000,2017,10,26,3,73,96,169,233
0132-000,2017,10,26,4,72,77,149,169
0132-000,2017,10,26,5,104,103,207,149
0132-000,2017,10,26,6,259,207,466,207
0132-000,2017,10,26,7,452,609,1061,466
0132-000,2017,10,26,8,709,1762,2471,1061
0132-000,2017,10,26,9,811,1625,2436,2471
0132-000,2017,10,26,10,768,884,1652,2436
0132-000,2017,10,26,11,754,782,1536,1652
0132-000,2017,10,26,12,742,836,1578,1536
0132-000,2017,10,26,13,704,728,1432,1578
0132-000,2017,10,26,14,742,800,1542,1432
0132-000,2017,10,26,15,777,771,1548,1542
0132-000,2017,10,26,16,820,785,1605,1548
0132-000,2017,10,26,17,927,837,1764,1605
0132-000,2017,10,26,18,1346,900,2246,1764
0132-000,2017,10,26,19,1520,801,2321,2246
0132-000,2017,10,26,20,905,659,1564,2321
0132-000,2017,10,26,21,835,528,1363,1564
0132-000,2017,10,26,22,607,451,1058,1363
0132-000,2017,10,26,23,362,289,651,1058
0132-000,2017,10,26,24,207,213,420,651
0132-000,2017,10,27,1,144,178,322,420
0132-000,2017,10,27,2,107,96,203,322
0132-000,2017,10,27,3,58,90,148,203
0132-000,2017,10,27,4,73,101,174,148
0132-000,2017,10,27,5,116,103,219,174
0132-000,2017,10,27,6,242,227,469,219
0132-000,2017,10,27,7,475,614,1089,469
0132-000,2017,10,27,8,685,1813,2498,1089
0132-000,2017,10,27,9,862,1491,2353,2498
0132-000,2017,10,27,10,765,872,1637,2353
0132-000,2017,10,27,11,774,863,1637,1637
0132-000,2017,10,27,12,766,842,1608,1637
0132-000,2017,10,27,13,764,742,1506,1608
0132-000,2017,10,27,14,812,781,1593,1506
0132-000,2017,10,27,15,824,847,1671,1593
0132-000,2017,10,27,16,882,778,1660,1671
0132-000,2017,10,27,17,1023,837,1860,1660
0132-000,2017,10,27,18,1438,1012,2450,1860
0132-000,2017,10,27,19,1620,909,2529,2450
0132-000,2017,10,27,20,1077,758,1835,2529
0132-000,2017,10,27,21,837,530,1367,1835
0132-000,2017,10,27,22,574,484,1058,1367
0132-000,2017,10,27,23,402,355,757,1058
0132-000,2017,10,27,24,217,278,495,757
0132-000,2017,10,28,1,186,194,380,495
0132-000,2017,10,28,2,127,160,287,380
0132-000,2017,10,28,3,86,126,212,287
0132-000,2017,10,28,4,94,110,204,212
0132-000,2017,10,28,5,122,117,239,204
0132-000,2017,10,28,6,223,206,429,239
0132-000,2017,10,28,7,419,448,867,429
0132-000,2017,10,28,8,593,995,1588,867
0132-000,2017,10,28,9,751,1066,1817,1588
0132-000,2017,10,28,10,750,1007,1757,1817
0132-000,2017,10,28,11,904,1034,1938,1757
0132-000,2017,10,28,12,955,1116,2071,1938
0132-000,2017,10,28,13,1015,1042,2057,2071
0132-000,2017,10,28,14,919,1032,1951,2057
0132-000,2017,10,28,15,983,1038,2021,1951
0132-000,2017,10,28,16,1059,971,2030,2021
0132-000,2017,10,28,17,1248,966,2214,2030
0132-000,2017,10,28,18,1530,1015,2545,2214
0132-000,2017,10,28,19,1413,827,2240,2545
0132-000,2017,10,28,20,932,612,1544,2240
0132-000,2017,10,28,21,620,520,1140,1544
0132-000,2017,10,28,22,469,425,894,1140
0132-000,2017,10,28,23,310,316,626,894
0132-000,2017,10,28,24,221,243,464,626
0132-000,2017,10,29,1,164,166,330,464
0132-000,2017,10,29,2,125,148,273,330
0132-000,2017,10,29,3,68,88,156,273
0132-000,2017,10,29,4,85,86,171,156
0132-000,2017,10,29,5,74,87,161,171
0132-000,2017,10,29,6,139,120,259,161
0132-000,2017,10,29,7,244,243,487,259
0132-000,2017,10,29,8,288,445,733,487
0132-000,2017,10,29,9,368,500,868,733
0132-000,2017,10,29,10,478,623,1101,868
0132-000,2017,10,29,11,609,670,1279,1101
0132-000,2017,10,29,12,707,713,1420,1279
0132-000,2017,10,29,13,697,736,1433,1420
0132-000,2017,10,29,14,728,761,1489,1433
0132-000,2017,10,29,15,878,775,1653,1489
0132-000,2017,10,29,16,919,754,1673,1653
0132-000,2017,10,29,17,1012,778,1790,1673
0132-000,2017,10,29,18,1165,709,1874,1790
0132-000,2017,10,29,19,1037,599,1636,1874
0132-000,2017,10,29,20,824,478,1302,1636
0132-000,2017,10,29,21,591,465,1056,1302
0132-000,2017,10,29,22,414,342,756,1056
0132-000,2017,10,29,23,273,298,571,756
0132-000,2017,10,29,24,180,182,362,571
0132-000,2017,10,30,1,108,121,229,362
0132-000,2017,10,30,2,63,75,138,229
0132-000,2017,10,30,3,43,64,107,138
0132-000,2017,10,30,4,57,61,118,107
0132-000,2017,10,30,5,94,91,185,118
0132-000,2017,10,30,6,263,244,507,185
0132-000,2017,10,30,7,476,650,1126,507
0132-000,2017,10,30,8,666,1873,2539,1126
0132-000,2017,10,30,9,788,1588,2376,2539
0132-000,2017,10,30,10,752,875,1627,2376
0132-000,2017,10,30,11,775,864,1639,1627
0132-000,2017,10,30,12,717,829,1546,1639
0132-000,2017,10,30,13,742,713,1455,1546
0132-000,2017,10,30,14,784,815,1599,1455
0132-000,2017,10,30,15,816,789,1605,1599
0132-000,2017,10,30,16,840,805,1645,1605
0132-000,2017,10,30,17,931,831,1762,1645
0132-000,2017,10,30,18,1324,918,2242,1762
0132-000,2017,10,30,19,1467,876,2343,2242
0132-000,2017,10,30,20,951,636,1587,2343
0132-000,2017,10,30,21,842,487,1329,1587
0132-000,2017,10,30,22,553,438,991,1329
0132-000,2017,10,30,23,329,324,653,991
0132-000,2017,10,30,24,208,181,389,653
0132-000,2017,10,31,1,132,139,271,389
0132-000,2017,10,31,2,89,93,182,271
0132-000,2017,10,31,3,70,78,148,182
0132-000,2017,10,31,4,60,82,142,148
0132-000,2017,10,31,5,107,108,215,142
0132-000,2017,10,31,6,241,190,431,215
0132-000,2017,10,31,7,434,544,978,431
0132-000,2017,10,31,8,679,1830,2509,978
0132-000,2017,10,31,9,830,1633,2463,2509
0132-000,2017,10,31,10,775,893,1668,2463
0132-000,2017,10,31,11,804,833,1637,1668
0132-000,2017,10,31,12,755,772,1527,1637
0132-000,2017,10,31,13,761,718,1479,1527
0132-000,2017,10,31,14,765,769,1534,1479
0132-000,2017,10,31,15,846,832,1678,1534
0132-000,2017,10,31,16,888,826,1714,1678
0132-000,2017,10,31,17,926,851,1777,1714
0132-000,2017,10,31,18,1340,900,2240,1777
0132-000,2017,10,31,19,1475,813,2288,2240
0132-000,2017,10,31,20,904,667,1571,2288
0132-000,2017,10,31,21,859,502,1361,1571
0132-000,2017,10,31,22,595,438,1033,1361
0132-000,2017,10,31,23,334,347,681,1033
0132-000,2017,10,31,24,245,205,450,681
0132-000,2017,11,1,1,141,154,295,450
0132-000,2017,11,1,2,109,106,215,295
0132-000,2017,11,1,3,69,94,163,215
0132-000,2017,11,1,4,67,91,158,163
0132-000,2017,11,1,5,89,111,200,158
0132-000,2017,11,1,6,245,214,459,200
0132-000,2017,11,1,7,436,613,1049,459
0132-000,2017,11,1,8,683,1852,2535,1049
0132-000,2017,11,1,9,867,1560,2427,2535
0132-000,2017,11,1,10,807,924,1731,2427
0132-000,2017,11,1,11,760,887,1647,1731
0132-000,2017,11,1,12,752,842,1594,1647
0132-000,2017,11,1,13,694,775,1469,1594
0132-000,2017,11,1,14,826,845,1671,1469
0132-000,2017,11,1,15,835,781,1616,1671
0132-000,2017,11,1,16,881,850,1731,1616
0132-000,2017,11,1,17,910,867,1777,1731
0132-000,2017,11,1,18,1411,934,2345,1777
0132-000,2017,11,1,19,1586,765,2351,2345
0132-000,2017,11,1,20,927,687,1614,2351
0132-000,2017,11,1,21,800,518,1318,1614
0132-000,2017,11,1,22,531,451,982,1318
0132-000,2017,11,1,23,315,305,620,982
0132-000,2017,11,1,24,278,241,519,620
0132-000,2017,11,2,1,146,167,313,519
0132-000,2017,11,2,2,102,119,221,313
0132-000,2017,11,2,3,69,77,146,221
0132-000,2017,11,2,4,67,90,157,146
0132-000,2017,11,2,5,96,114,210,157
0132-000,2017,11,2,6,260,211,471,210
0132-000,2017,11,2,7,451,588,1039,471
0132-000,2017,11,2,8,628,1785,2413,1039
0132-000,2017,11,2,9,839,1502,2341,2413
0132-000,2017,11,2,10,760,877,1637,2341
0132-000,2017,11,2,11,757,806,1563,1637
0132-000,2017,11,2,12,751,798,1549,1563
0132-000,2017,11,2,13,725,702,1427,1549
0132-000,2017,11,2,14,799,748,1547,1427
0132-000,2017,11,2,15,811,801,1612,1547
0132-000,2017,11,2,16,850,742,1592,1612
0132-000,2017,11,2,17,935,822,1757,1592
0132-000,2017,11,2,18,1346,950,2296,1757
0132-000,2017,11,2,19,1471,795,2266,2296
0132-000,2017,11,2,20,915,618,1533,2266
0132-000,2017,11,2,21,829,527,1356,1533
0132-000,2017,11,2,22,585,425,1010,1356
0132-000,2017,11,2,23,343,310,653,1010
0132-000,2017,11,2,24,231,213,444,653
0132-000,2017,11,3,1,171,142,313,444
0132-000,2017,11,3,2,92,96,188,313
0132-000,2017,11,3,3,72,92,164,188
0132-000,2017,11,3,4,73,74,147,164
0132-000,2017,11,3,5,102,107,209,147
0132-000,2017,11,3,6,242,200,442,209
0132-000,2017,11,3,7,417,633,1050,442
0132-000,2017,11,3,8,636,1780,2416,1050
0132-000,2017,11,3,9,802,1452,2254,2416
0132-000,2017,11,3,10,754,825,1579,2254
0132-000,2017,11,3,11,717,858,1575,1579
0132-000,2017,11,3,12,740,829,1569,1575
0132-000,2017,11,3,13,685,772,1457,1569
0132-000,2017,11,3,14,825,743,1568,1457
0132-000,2017,11,3,15,789,782,1571,1568
0132-000,2017,11,3,16,881,807,1688,1571
0132-000,2017,11,3,17,922,852,1774,1688
0132-000,2017,11,3,18,1381,923,2304,1774
0132-000,2017,11,3,19,1688,856,2544,2304
0132-000,2017,11,3,20,984,723,1707,2544
0132-000,2017,11,3,21,817,535,1352,1707
0132-000,2017,11,3,22,537,454,991,1352
0132-000,2017,11,3,23,380,336,716,991
0132-000,2017,11,3,24,266,228,494,716
0132-000,2017,11,4,1,197,197,394,494
0132-000,2017,11,4,2,118,128,246,394
0132-000,2017,11,4,3,103,122,225,246
0132-000,2017,11,4,4,75,115,190,225
0132-000,2017,11,4,5,114,115,229,190
0132-000,2017,11,4,6,235,177,412,229
0132-000,2017,11,4,7,385,424,809,412
0132-000,2017,11,4,8,476,893,1369,809
0132-000,2017,11,4,9,645,988,1633,1369
0132-000,2017,11,4,10,664,954,1618,1633
0132-000,2017,11,4,11,790,917,1707,1618
0132-000,2017,11,4,12,801,1007,1808,1707
0132-000,2017,11,4,13,857,963,1820,1808
0132-000,2017,11,4,14,796,980,1776,1820
0132-000,2017,11,4,15,917,962,1879,1776
0132-000,2017,11,4,16,937,928,1865,1879
0132-000,2017,11,4,17,1063,942,2005,1865
0132-000,2017,11,4,18,1298,998,2296,2005
0132-000,2017,11,4,19,1155,804,1959,2296
0132-000,2017,11,4,20,810,554,1364,1959
0132-000,2017,11,4,21,571,470,1041,1364
0132-000,2017,11,4,22,457,427,884,1041
0132-000,2017,11,4,23,343,321,664,884
0132-000,2017,11,4,24,207,220,427,664
0132-000,2017,11,5,1,169,188,357,427
0132-000,2017,11,5,2,118,123,241,357
0132-000,2017,11,5,3,97,96,193,241
0132-000,2017,11,5,4,80,81,161,193
0132-000,2017,11,5,5,64,101,165,161
0132-000,2017,11,5,6,134,124,258,165
0132-000,2017,11,5,7,201,242,443,258
0132-000,2017,11,5,8,281,375,656,443
0132-000,2017,11,5,9,389,485,874,656
0132-000,2017,11,5,10,447,637,1084,874
0132-000,2017,11,5,11,604,674,1278,1084
0132-000,2017,11,5,12,595,710,1305,1278
0132-000,2017,11,5,13,674,722,1396,1305
0132-000,2017,11,5,14,734,728,1462,1396
0132-000,2017,11,5,15,838,775,1613,1462
0132-000,2017,11,5,16,934,823,1757,1613
0132-000,2017,11,5,17,1040,752,1792,1757
0132-000,2017,11,5,18,1214,711,1925,1792
0132-000,2017,11,5,19,1159,608,1767,1925
0132-000,2017,11,5,20,823,526,1349,1767
0132-000,2017,11,5,21,591,472,1063,1349
0132-000,2017,11,5,22,465,405,870,1063
0132-000,2017,11,5,23,304,307,611,870
0132-000,2017,11,5,24,196,198,394,611
0132-000,2017,11,6,1,91,110,201,394
0132-000,2017,11,6,2,67,76,143,201
0132-000,2017,11,6,3,55,53,108,143
0132-000,2017,11,6,4,51,57,108,108
0132-000,2017,11,6,5,87,91,178,108
0132-000,2017,11,6,6,266,222,488,178
0132-000,2017,11,6,7,484,645,1129,488
0132-000,2017,11,6,8,593,1850,2443,1129
0132-000,2017,11,6,9,823,1638,2461,2443
0132-000,2017,11,6,10,765,864,1629,2461
0132-000,2017,11,6,11,721,817,1538,1629
0132-000,2017,11,6,12,727,873,1600,1538
0132-000,2017,11,6,13,749,781,1530,1600
0132-000,2017,11,6,14,785,788,1573,1530
0132-000,2017,11,6,15,851,826,1677,1573
0132-000,2017,11,6,16,882,820,1702,1677
0132-000,2017,11,6,17,953,849,1802,1702
0132-000,2017,11,6,18,1294,938,2232,1802
0132-000,2017,11,6,19,1495,854,2349,2232
0132-000,2017,11,6,20,932,585,1517,2349
0132-000,2017,11,6,21,880,493,1373,1517
0132-000,2017,11,6,22,592,391,983,1373
0132-000,2017,11,6,23,325,320,645,983
0132-000,2017,11,6,24,206,182,388,645
0132-000,2017,11,7,1,152,137,289,388
0132-000,2017,11,7,2,94,81,175,289
0132-000,2017,11,7,3,60,78,138,175
0132-000,2017,11,7,4,72,81,153,138
0132-000,2017,11,7,5,92,118,210,153
0132-000,2017,11,7,6,242,193,435,210
0132-000,2017,11,7,7,414,627,1041,435
0132-000,2017,11,7,8,678,1854,2532,1041
0132-000,2017,11,7,9,816,1546,2362,2532
0132-000,2017,11,7,10,819,956,1775,2362
0132-000,2017,11,7,11,771,916,1687,1775
0132-000,2017,11,7,12,744,841,1585,1687
0132-000,2017,11,7,13,692,742,1434,1585
0132-000,2017,11,7,14,731,787,1518,1434
0132-000,2017,11,7,15,775,802,1577,1518
0132-000,2017,11,7,16,857,803,1660,1577
0132-000,2017,11,7,17,902,792,1694,1660
0132-000,2017,11,7,18,1278,839,2117,1694
0132-000,2017,11,7,19,1500,796,2296,2117
0132-000,2017,11,7,20,939,594,1533,2296
0132-000,2017,11,7,21,819,457,1276,1533
0132-000,2017,11,7,22,566,411,977,1276
0132-000,2017,11,7,23,378,301,679,977
0132-000,2017,11,7,24,205,195,400,679
0132-000,2017,11,8,1,155,150,305,400
0132-000,2017,11,8,2,85,110,195,305
0132-000,2017,11,8,3,69,81,150,195
0132-000,2017,11,8,4,74,71,145,150
0132-000,2017,11,8,5,115,117,232,145
0132-000,2017,11,8,6,255,193,448,232
0132-000,2017,11,8,7,438,604,1042,448
0132-000,2017,11,8,8,672,1824,2496,1042
0132-000,2017,11,8,9,883,1525,2408,2496
0132-000,2017,11,8,10,759,937,1696,2408
0132-000,2017,11,8,11,734,831,1565,1696
0132-000,2017,11,8,12,691,751,1442,1565
0132-000,2017,11,8,13,672,750,1422,1442
0132-000,2017,11,8,14,767,770,1537,1422
0132-000,2017,11,8,15,799,772,1571,1537
0132-000,2017,11,8,16,854,706,1560,1571
0132-000,2017,11,8,17,898,867,1765,1560
0132-000,2017,11,8,18,1340,877,2217,1765
0132-000,2017,11,8,19,1602,753,2355,2217
0132-000,2017,11,8,20,906,632,1538,2355
0132-000,2017,11,8,21,785,512,1297,1538
0132-000,2017,11,8,22,563,420,983,1297
0132-000,2017,11,8,23,359,311,670,983
0132-000,2017,11,8,24,229,197,426,670
0132-000,2017,11,9,1,130,146,276,426
0132-000,2017,11,9,2,87,115,202,276
0132-000,2017,11,9,3,86,87,173,202
0132-000,2017,11,9,4,68,96,164,173
0132-000,2017,11,9,5,106,107,213,164
0132-000,2017,11,9,6,261,208,469,213
0132-000,2017,11,9,7,448,577,1025,469
0132-000,2017,11,9,8,642,1798,2440,1025
0132-000,2017,11,9,9,832,1598,2430,2440
0132-000,2017,11,9,10,784,897,1681,2430
0132-000,2017,11,9,11,728,798,1526,1681
0132-000,2017,11,9,12,721,843,1564,1526
0132-000,2017,11,9,13,672,710,1382,1564
0132-000,2017,11,9,14,783,756,1539,1382
0132-000,2017,11,9,15,761,814,1575,1539
0132-000,2017,11,9,16,852,749,1601,1575
0132-000,2017,11,9,17,977,874,1851,1601
0132-000,2017,11,9,18,1317,907,2224,1851
0132-000,2017,11,9,19,1450,776,2226,2224
0132-000,2017,11,9,20,873,621,1494,2226
0132-000,2017,11,9,21,911,488,1399,1494
0132-000,2017,11,9,22,568,423,991,1399
0132-000,2017,11,9,23,397,313,710,991
0132-000,2017,11,9,24,218,196,414,710
0132-000,2017,11,10,1,161,158,319,414
0132-000,2017,11,10,2,113,115,228,319
0132-000,2017,11,10,3,65,95,160,228
0132-000,2017,11,10,4,57,84,141,160
0132-000,2017,11,10,5,94,114,208,141
0132-000,2017,11,10,6,245,205,450,208
0132-000,2017,11,10,7,431,592,1023,450
0132-000,2017,11,10,8,636,1738,2374,1023
0132-000,2017,11,10,9,818,1521,2339,2374
0132-000,2017,11,10,10,730,922,1652,2339
0132-000,2017,11,10,11,728,813,1541,1652
0132-000,2017,11,10,12,768,816,1584,1541
0132-000,2017,11,10,13,720,767,1487,1584
0132-000,2017,11,10,14,796,813,1609,1487
0132-000,2017,11,10,15,843,815,1658,1609
0132-000,2017,11,10,16,843,828,1671,1658
0132-000,2017,11,10,17,959,906,1865,1671
0132-000,2017,11,10,18,1417,925,2342,1865
0132-000,2017,11,10,19,1638,785,2423,2342
0132-000,2017,11,10,20,973,730,1703,2423
0132-000,2017,11,10,21,796,529,1325,1703
0132-000,2017,11,10,22,548,413,961,1325
0132-000,2017,11,10,23,393,358,751,961
0132-000,2017,11,10,24,209,248,457,751
0132-000,2017,11,11,1,170,195,365,457
0132-000,2017,11,11,2,139,163,302,365
0132-000,2017,11,11,3,98,99,197,302
0132-000,2017,11,11,4,78,96,174,197
0132-000,2017,11,11,5,110,114,224,174
0132-000,2017,11,11,6,253,196,449,224
0132-000,2017,11,11,7,382,444,826,449
0132-000,2017,11,11,8,501,880,1381,826
0132-000,2017,11,11,9,662,999,1661,1381
0132-000,2017,11,11,10,709,940,1649,1661
0132-000,2017,11,11,11,810,898,1708,1649
0132-000,2017,11,11,12,773,989,1762,1708
0132-000,2017,11,11,13,845,1001,1846,1762
0132-000,2017,11,11,14,797,974,1771,1846
0132-000,2017,11,11,15,921,936,1857,1771
0132-000,2017,11,11,16,929,964,1893,1857
0132-000,2017,11,11,17,1014,914,1928,1893
0132-000,2017,11,11,18,1338,961,2299,1928
0132-000,2017,11,11,19,1143,821,1964,2299
0132-000,2017,11,11,20,759,605,1364,1964
0132-000,2017,11,11,21,536,496,1032,1364
0132-000,2017,11,11,22,451,411,862,1032
0132-000,2017,11,11,23,297,313,610,862
0132-000,2017,11,11,24,200,239,439,610
0132-000,2017,11,12,1,170,155,325,439
0132-000,2017,11,12,2,113,158,271,325
0132-000,2017,11,12,3,81,105,186,271
0132-000,2017,11,12,4,80,95,175,186
0132-000,2017,11,12,5,82,97,179,175
0132-000,2017,11,12,6,129,125,254,179
0132-000,2017,11,12,7,193,256,449,254
0132-000,2017,11,12,8,259,381,640,449
0132-000,2017,11,12,9,394,511,905,640
0132-000,2017,11,12,10,482,588,1070,905
0132-000,2017,11,12,11,602,637,1239,1070
0132-000,2017,11,12,12,591,602,1193,1239
0132-000,2017,11,12,13,701,663,1364,1193
0132-000,2017,11,12,14,696,707,1403,1364
0132-000,2017,11,12,15,791,725,1516,1403
0132-000,2017,11,12,16,914,780,1694,1516
0132-000,2017,11,12,17,1002,772,1774,1694
0132-000,2017,11,12,18,1276,649,1925,1774
0132-000,2017,11,12,19,1296,584,1880,1925
0132-000,2017,11,12,20,960,551,1511,1880
0132-000,2017,11,12,21,705,462,1167,1511
0132-000,2017,11,12,22,444,377,821,1167
0132-000,2017,11,12,23,261,325,586,821
0132-000,2017,11,12,24,170,203,373,586
0132-000,2017,11,13,1,110,120,230,373
0132-000,2017,11,13,2,69,71,140,230
0132-000,2017,11,13,3,45,58,103,140
0132-000,2017,11,13,4,55,57,112,103
0132-000,2017,11,13,5,106,81,187,112
0132-000,2017,11,13,6,269,239,508,187
0132-000,2017,11,13,7,452,645,1097,508
0132-000,2017,11,13,8,668,1852,2520,1097
0132-000,2017,11,13,9,822,1608,2430,2520
0132-000,2017,11,13,10,718,827,1545,2430
0132-000,2017,11,13,11,717,796,1513,1545
0132-000,2017,11,13,12,731,813,1544,1513
0132-000,2017,11,13,13,721,775,1496,1544
0132-000,2017,11,13,14,754,787,1541,1496
0132-000,2017,11,13,15,795,806,1601,1541
0132-000,2017,11,13,16,881,834,1715,1601
0132-000,2017,11,13,17,928,829,1757,1715
0132-000,2017,11,13,18,1270,917,2187,1757
0132-000,2017,11,13,19,1436,778,2214,2187
0132-000,2017,11,13,20,895,614,1509,2214
0132-000,2017,11,13,21,831,522,1353,1509
0132-000,2017,11,13,22,584,383,967,1353
0132-000,2017,11,13,23,334,272,606,967
0132-000,2017,11,13,24,171,202,373,606
0132-000,2017,11,14,1,117,123,240,373
0132-000,2017,11,14,2,86,95,181,240
0132-000,2017,11,14,3,64,78,142,181
0132-000,2017,11,14,4,72,76,148,142
0132-000,2017,11,14,5,100,117,217,148
0132-000,2017,11,14,6,251,205,456,217
0132-000,2017,11,14,7,454,548,1002,456
0132-000,2017,11,14,8,657,1808,2465,1002
0132-000,2017,11,14,9,821,1628,2449,2465
0132-000,2017,11,14,10,738,841,1579,2449
0132-000,2017,11,14,11,742,792,1534,1579
0132-000,2017,11,14,12,702,775,1477,1534
0132-000,2017,11,14,13,686,690,1376,1477
0132-000,2017,11,14,14,753,778,1531,1376
0132-000,2017,11,14,15,832,778,1610,1531
0132-000,2017,11,14,16,853,838,1691,1610
0132-000,2017,11,14,17,963,851,1814,1691
0132-000,2017,11,14,18,1303,947,2250,1814
0132-000,2017,11,14,19,1432,775,2207,2250
0132-000,2017,11,14,20,842,618,1460,2207
0132-000,2017,11,14,21,819,492,1311,1460
0132-000,2017,11,14,22,575,372,947,1311
0132-000,2017,11,14,23,367,318,685,947
0132-000,2017,11,14,24,205,182,387,685
0132-000,2017,11,15,1,158,159,317,387
0132-000,2017,11,15,2,96,100,196,317
0132-000,2017,11,15,3,61,72,133,196
0132-000,2017,11,15,4,68,74,142,133
0132-000,2017,11,15,5,99,99,198,142
0132-000,2017,11,15,6,238,187,425,198
0132-000,2017,11,15,7,422,562,984,425
0132-000,2017,11,15,8,625,1741,2366,984
0132-000,2017,11,15,9,800,1583,2383,2366
0132-000,2017,11,15,10,758,989,1747,2383
0132-000,2017,11,15,11,705,841,1546,1747
0132-000,2017,11,15,12,730,782,1512,1546
0132-000,2017,11,15,13,731,761,1492,1512
0132-000,2017,11,15,14,773,764,1537,1492
0132-000,2017,11,15,15,832,767,1599,1537
0132-000,2017,11,15,16,897,831,1728,1599
0132-000,2017,11,15,17,974,862,1836,1728
0132-000,2017,11,15,18,1396,893,2289,1836
0132-000,2017,11,15,19,1619,750,2369,2289
0132-000,2017,11,15,20,858,649,1507,2369
0132-000,2017,11,15,21,729,501,1230,1507
0132-000,2017,11,15,22,507,439,946,1230
0132-000,2017,11,15,23,356,330,686,946
0132-000,2017,11,15,24,228,261,489,686
0132-000,2017,11,16,1,161,179,340,489
0132-000,2017,11,16,2,99,94,193,340
0132-000,2017,11,16,3,67,91,158,193
0132-000,2017,11,16,4,68,65,133,158
0132-000,2017,11,16,5,97,121,218,133
0132-000,2017,11,16,6,239,207,446,218
0132-000,2017,11,16,7,405,552,957,446
0132-000,2017,11,16,8,664,1676,2340,957
0132-000,2017,11,16,9,826,1618,2444,2340
0132-000,2017,11,16,10,772,953,1725,2444
0132-000,2017,11,16,11,743,868,1611,1725
0132-000,2017,11,16,12,751,870,1621,1611
0132-000,2017,11,16,13,716,716,1432,1621
0132-000,2017,11,16,14,780,839,1619,1432
0132-000,2017,11,16,15,878,787,1665,1619
0132-000,2017,11,16,16,866,819,1685,1665
0132-000,2017,11,16,17,959,835,1794,1685
0132-000,2017,11,16,18,1391,887,2278,1794
0132-000,2017,11,16,19,1465,790,2255,2278
0132-000,2017,11,16,20,905,585,1490,2255
0132-000,2017,11,16,21,829,500,1329,1490
0132-000,2017,11,16,22,558,437,995,1329
0132-000,2017,11,16,23,349,318,667,995
0132-000,2017,11,16,24,190,198,388,667
0132-000,2017,11,17,1,165,170,335,388
0132-000,2017,11,17,2,91,108,199,335
0132-000,2017,11,17,3,72,79,151,199
0132-000,2017,11,17,4,64,73,137,151
0132-000,2017,11,17,5,96,123,219,137
0132-000,2017,11,17,6,245,176,421,219
0132-000,2017,11,17,7,436,556,992,421
0132-000,2017,11,17,8,651,1714,2365,992
0132-000,2017,11,17,9,864,1571,2435,2365
0132-000,2017,11,17,10,746,901,1647,2435
0132-000,2017,11,17,11,691,880,1571,1647
0132-000,2017,11,17,12,744,775,1519,1571
0132-000,2017,11,17,13,754,735,1489,1519
0132-000,2017,11,17,14,815,805,1620,1489
0132-000,2017,11,17,15,859,849,1708,1620
0132-000,2017,11,17,16,939,834,1773,1708
0132-000,2017,11,17,17,977,817,1794,1773
0132-000,2017,11,17,18,1361,924,2285,1794
0132-000,2017,11,17,19,1696,837,2533,2285
0132-000,2017,11,17,20,921,728,1649,2533
0132-000,2017,11,17,21,744,576,1320,1649
0132-000,2017,11,17,22,591,509,1100,1320
0132-000,2017,11,17,23,355,314,669,1100
0132-000,2017,11,17,24,243,222,465,669
0132-000,2017,11,18,1,183,206,389,465
0132-000,2017,11,18,2,143,140,283,389
0132-000,2017,11,18,3,102,114,216,283
0132-000,2017,11,18,4,81,104,185,216
0132-000,2017,11,18,5,109,136,245,185
0132-000,2017,11,18,6,227,181,408,245
0132-000,2017,11,18,7,373,392,765,408
0132-000,2017,11,18,8,472,798,1270,765
0132-000,2017,11,18,9,634,934,1568,1270
0132-000,2017,11,18,10,726,937,1663,1568
0132-000,2017,11,18,11,774,948,1722,1663
0132-000,2017,11,18,12,847,967,1814,1722
0132-000,2017,11,18,13,821,907,1728,1814
0132-000,2017,11,18,14,815,871,1686,1728
0132-000,2017,11,18,15,988,1025,2013,1686
0132-000,2017,11,18,16,860,929,1789,2013
0132-000,2017,11,18,17,1118,936,2054,1789
0132-000,2017,11,18,18,1301,1010,2311,2054
0132-000,2017,11,18,19,1146,768,1914,2311
0132-000,2017,11,18,20,762,622,1384,1914
0132-000,2017,11,18,21,562,471,1033,1384
0132-000,2017,11,18,22,417,392,809,1033
0132-000,2017,11,18,23,286,300,586,809
0132-000,2017,11,18,24,186,238,424,586
0132-000,2017,11,19,1,149,143,292,424
0132-000,2017,11,19,2,105,118,223,292
0132-000,2017,11,19,3,76,102,178,223
0132-000,2017,11,19,4,70,84,154,178
0132-000,2017,11,19,5,72,72,144,154
0132-000,2017,11,19,6,111,106,217,144
0132-000,2017,11,19,7,170,220,390,217
0132-000,2017,11,19,8,258,335,593,390
0132-000,2017,11,19,9,376,492,868,593
0132-000,2017,11,19,10,482,603,1085,868
0132-000,2017,11,19,11,579,641,1220,1085
0132-000,2017,11,19,12,579,664,1243,1220
0132-000,2017,11,19,13,674,700,1374,1243
0132-000,2017,11,19,14,709,712,1421,1374
0132-000,2017,11,19,15,911,770,1681,1421
0132-000,2017,11,19,16,1007,840,1847,1681
0132-000,2017,11,19,17,1312,778,2090,1847
0132-000,2017,11,19,18,1496,680,2176,2090
0132-000,2017,11,19,19,1408,599,2007,2176
0132-000,2017,11,19,20,1132,498,1630,2007
0132-000,2017,11,19,21,804,446,1250,1630
0132-000,2017,11,19,22,485,399,884,1250
0132-000,2017,11,19,23,269,273,542,884
0132-000,2017,11,19,24,152,191,343,542
0132-000,2017,11,20,1,104,107,211,343
0132-000,2017,11,20,2,76,80,156,211
0132-000,2017,11,20,3,43,50,93,156
0132-000,2017,11,20,4,55,74,129,93
0132-000,2017,11,20,5,92,72,164,129
0132-000,2017,11,20,6,264,215,479,164
0132-000,2017,11,20,7,470,620,1090,479
0132-000,2017,11,20,8,664,1831,2495,1090
0132-000,2017,11,20,9,765,1574,2339,2495
0132-000,2017,11,20,10,697,815,1512,2339
0132-000,2017,11,20,11,733,861,1594,1512
0132-000,2017,11,20,12,769,787,1556,1594
0132-000,2017,11,20,13,724,756,1480,1556
0132-000,2017,11,20,14,796,838,1634,1480
0132-000,2017,11,20,15,850,810,1660,1634
0132-000,2017,11,20,16,840,824,1664,1660
0132-000,2017,11,20,17,914,810,1724,1664
0132-000,2017,11,20,18,1226,869,2095,1724
0132-000,2017,11,20,19,1423,810,2233,2095
0132-000,2017,11,20,20,901,606,1507,2233
0132-000,2017,11,20,21,809,471,1280,1507
0132-000,2017,11,20,22,562,368,930,1280
0132-000,2017,11,20,23,296,318,614,930
0132-000,2017,11,20,24,214,184,398,614
0132-000,2017,11,21,1,140,118,258,398
0132-000,2017,11,21,2,57,96,153,258
0132-000,2017,11,21,3,60,70,130,153
0132-000,2017,11,21,4,62,83,145,130
0132-000,2017,11,21,5,108,100,208,145
0132-000,2017,11,21,6,256,190,446,208
0132-000,2017,11,21,7,431,566,997,446
0132-000,2017,11,21,8,627,1606,2233,997
0132-000,2017,11,21,9,825,1877,2702,2233
0132-000,2017,11,21,10,747,916,1663,2702
0132-000,2017,11,21,11,718,804,1522,1663
0132-000,2017,11,21,12,764,793,1557,1522
0132-000,2017,11,21,13,685,735,1420,1557
0132-000,2017,11,21,14,789,774,1563,1420
0132-000,2017,11,21,15,802,790,1592,1563
0132-000,2017,11,21,16,903,796,1699,1592
0132-000,2017,11,21,17,933,808,1741,1699
0132-000,2017,11,21,18,1312,944,2256,1741
0132-000,2017,11,21,19,1510,837,2347,2256
0132-000,2017,11,21,20,866,595,1461,2347
0132-000,2017,11,21,21,827,527,1354,1461
0132-000,2017,11,21,22,569,404,973,1354
0132-000,2017,11,21,23,334,300,634,973
0132-000,2017,11,21,24,213,218,431,634
0132-000,2017,11,22,1,139,140,279,431
0132-000,2017,11,22,2,77,123,200,279
0132-000,2017,11,22,3,68,83,151,200
0132-000,2017,11,22,4,58,82,140,151
0132-000,2017,11,22,5,94,109,203,140
0132-000,2017,11,22,6,241,183,424,203
0132-000,2017,11,22,7,432,578,1010,424
0132-000,2017,11,22,8,620,1698,2318,1010
0132-000,2017,11,22,9,869,1520,2389,2318
0132-000,2017,11,22,10,744,899,1643,2389
0132-000,2017,11,22,11,775,833,1608,1643
0132-000,2017,11,22,12,731,783,1514,1608
0132-000,2017,11,22,13,712,757,1469,1514
0132-000,2017,11,22,14,751,806,1557,1469
0132-000,2017,11,22,15,852,799,1651,1557
0132-000,2017,11,22,16,857,811,1668,1651
0132-000,2017,11,22,17,950,834,1784,1668
0132-000,2017,11,22,18,1340,884,2224,1784
0132-000,2017,11,22,19,1525,782,2307,2224
0132-000,2017,11,22,20,846,548,1394,2307
0132-000,2017,11,22,21,773,482,1255,1394
0132-000,2017,11,22,22,507,402,909,1255
0132-000,2017,11,22,23,354,332,686,909
0132-000,2017,11,22,24,193,224,417,686
0132-000,2017,11,23,1,172,168,340,417
0132-000,2017,11,23,2,75,97,172,340
0132-000,2017,11,23,3,58,90,148,172
0132-000,2017,11,23,4,65,71,136,148
0132-000,2017,11,23,5,108,107,215,136
0132-000,2017,11,23,6,205,193,398,215
0132-000,2017,11,23,7,407,534,941,398
0132-000,2017,11,23,8,582,1748,2330,941
0132-000,2017,11,23,9,856,1515,2371,2330
0132-000,2017,11,23,10,732,945,1677,2371
0132-000,2017,11,23,11,743,767,1510,1677
0132-000,2017,11,23,12,759,760,1519,1510
0132-000,2017,11,23,13,615,717,1332,1519
0132-000,2017,11,23,14,758,753,1511,1332
0132-000,2017,11,23,15,854,825,1679,1511
0132-000,2017,11,23,16,859,753,1612,1679
0132-000,2017,11,23,17,906,869,1775,1612
0132-000,2017,11,23,18,1250,835,2085,1775
0132-000,2017,11,23,19,1397,788,2185,2085
0132-000,2017,11,23,20,907,587,1494,2185
0132-000,2017,11,23,21,820,515,1335,1494
0132-000,2017,11,23,22,562,406,968,1335
0132-000,2017,11,23,23,324,322,646,968
0132-000,2017,11,23,24,205,199,404,646
0132-000,2017,11,24,1,155,123,278,404
0132-000,2017,11,24,2,82,116,198,278
0132-000,2017,11,24,3,51,76,127,198
0132-000,2017,11,24,4,55,67,122,127
0132-000,2017,11,24,5,68,100,168,122
0132-000,2017,11,24,6,146,156,302,168
0132-000,2017,11,24,7,289,484,773,302
0132-000,2017,11,24,8,502,1592,2094,773
0132-000,2017,11,24,9,693,1353,2046,2094
0132-000,2017,11,24,10,631,762,1393,2046
0132-000,2017,11,24,11,647,709,1356,1393
0132-000,2017,11,24,12,605,736,1341,1356
0132-000,2017,11,24,13,628,651,1279,1341
0132-000,2017,11,24,14,729,754,1483,1279
0132-000,2017,11,24,15,699,715,1414,1483
0132-000,2017,11,24,16,829,666,1495,1414
0132-000,2017,11,24,17,865,794,1659,1495
0132-000,2017,11,24,18,1214,818,2032,1659
0132-000,2017,11,24,19,1581,779,2360,2032
0132-000,2017,11,24,20,876,638,1514,2360
0132-000,2017,11,24,21,768,495,1263,1514
0132-000,2017,11,24,22,562,389,951,1263
0132-000,2017,11,24,23,380,310,690,951
0132-000,2017,11,24,24,215,240,455,690
0132-000,2017,11,25,1,176,194,370,455
0132-000,2017,11,25,2,123,137,260,370
0132-000,2017,11,25,3,80,108,188,260
0132-000,2017,11,25,4,56,89,145,188
0132-000,2017,11,25,5,106,106,212,145
0132-000,2017,11,25,6,191,164,355,212
0132-000,2017,11,25,7,297,347,644,355
0132-000,2017,11,25,8,450,750,1200,644
0132-000,2017,11,25,9,623,874,1497,1200
0132-000,2017,11,25,10,703,879,1582,1497
0132-000,2017,11,25,11,728,942,1670,1582
0132-000,2017,11,25,12,786,948,1734,1670
0132-000,2017,11,25,13,882,894,1776,1734
0132-000,2017,11,25,14,887,924,1811,1776
0132-000,2017,11,25,15,826,1021,1847,1811
0132-000,2017,11,25,16,842,851,1693,1847
0132-000,2017,11,25,17,979,953,1932,1693
0132-000,2017,11,25,18,1233,1002,2235,1932
0132-000,2017,11,25,19,979,828,1807,2235
0132-000,2017,11,25,20,674,548,1222,1807
0132-000,2017,11,25,21,516,427,943,1222
0132-000,2017,11,25,22,489,354,843,943
0132-000,2017,11,25,23,290,214,504,843
0132-000,2017,11,25,24,201,216,417,504
0132-000,2017,11,26,1,160,149,309,417
0132-000,2017,11,26,2,109,138,247,309
0132-000,2017,11,26,3,79,104,183,247
0132-000,2017,11,26,4,75,90,165,183
0132-000,2017,11,26,5,77,85,162,165
0132-000,2017,11,26,6,120,116,236,162
0132-000,2017,11,26,7,182,238,420,236
0132-000,2017,11,26,8,259,358,617,420
0132-000,2017,11,26,9,385,502,887,617
0132-000,2017,11,26,10,482,596,1078,887
0132-000,2017,11,26,11,591,639,1230,1078
0132-000,2017,11,26,12,585,633,1218,1230
0132-000,2017,11,26,13,688,682,1370,1218
0132-000,2017,11,26,14,703,710,1413,1370
0132-000,2017,11,26,15,851,748,1599,1413
0132-000,2017,11,26,16,961,810,1771,1599
0132-000,2017,11,26,17,1157,775,1932,1771
0132-000,2017,11,26,18,1386,665,2051,1932
0132-000,2017,11,26,19,1352,592,1944,2051
0132-000,2017,11,26,20,1046,525,1571,1944
0132-000,2017,11,26,21,755,454,1209,1571
0132-000,2017,11,26,22,465,388,853,1209
0132-000,2017,11,26,23,265,299,564,853
0132-000,2017,11,26,24,161,197,358,564
0132-000,2017,11,27,1,107,114,221,358
0132-000,2017,11,27,2,73,76,149,221
0132-000,2017,11,27,3,44,54,98,149
0132-000,2017,11,27,4,55,66,121,98
0132-000,2017,11,27,5,99,77,176,121
0132-000,2017,11,27,6,267,227,494,176
0132-000,2017,11,27,7,461,633,1094,494
0132-000,2017,11,27,8,666,1842,2508,1094
0132-000,2017,11,27,9,794,1591,2385,2508
0132-000,2017,11,27,10,708,821,1529,2385
0132-000,2017,11,27,11,725,829,1554,1529
0132-000,2017,11,27,12,750,800,1550,1554
0132-000,2017,11,27,13,723,766,1489,1550
0132-000,2017,11,27,14,775,813,1588,1489
0132-000,2017,11,27,15,823,808,1631,1588
0132-000,2017,11,27,16,861,829,1690,1631
0132-000,2017,11,27,17,921,820,1741,1690
0132-000,2017,11,27,18,1248,893,2141,1741
0132-000,2017,11,27,19,1430,794,2224,2141
0132-000,2017,11,27,20,898,610,1508,2224
0132-000,2017,11,27,21,820,497,1317,1508
0132-000,2017,11,27,22,573,376,949,1317
0132-000,2017,11,27,23,315,295,610,949
0132-000,2017,11,27,24,193,193,386,610
0132-000,2017,11,28,1,129,121,250,386
0132-000,2017,11,28,2,72,96,168,250
0132-000,2017,11,28,3,62,74,136,168
0132-000,2017,11,28,4,67,80,147,136
0132-000,2017,11,28,5,104,109,213,147
0132-000,2017,11,28,6,254,198,452,213
0132-000,2017,11,28,7,443,557,1000,452
0132-000,2017,11,28,8,642,1707,2349,1000
0132-000,2017,11,28,9,823,1753,2576,2349
0132-000,2017,11,28,10,743,879,1622,2576
0132-000,2017,11,28,11,730,798,1528,1622
0132-000,2017,11,28,12,733,784,1517,1528
0132-000,2017,11,28,13,686,713,1399,1517
0132-000,2017,11,28,14,771,776,1547,1399
0132-000,2017,11,28,15,817,784,1601,1547
0132-000,2017,11,28,16,878,817,1695,1601
0132-000,2017,11,28,17,948,830,1778,1695
0132-000,2017,11,28,18,1308,946,2254,1778
0132-000,2017,11,28,19,1471,806,2277,2254
0132-000,2017,11,28,20,854,607,1461,2277
0132-000,2017,11,28,21,823,510,1333,1461
0132-000,2017,11,28,22,572,388,960,1333
0132-000,2017,11,28,23,351,309,660,960
0132-000,2017,11,28,24,209,200,409,660
0132-000,2017,11,29,1,149,150,299,409
0132-000,2017,11,29,2,87,112,199,299
0132-000,2017,11,29,3,65,78,143,199
0132-000,2017,11,29,4,63,78,141,143
0132-000,2017,11,29,5,97,104,201,141
0132-000,2017,11,29,6,240,185,425,201
0132-000,2017,11,29,7,427,570,997,425
0132-000,2017,11,29,8,623,1720,2343,997
0132-000,2017,11,29,9,835,1552,2387,2343
0132-000,2017,11,29,10,751,944,1695,2387
0132-000,2017,11,29,11,740,837,1577,1695
0132-000,2017,11,29,12,731,783,1514,1577
0132-000,2017,11,29,13,722,759,1481,1514
0132-000,2017,11,29,14,762,785,1547,1481
0132-000,2017,11,29,15,842,783,1625,1547
0132-000,2017,11,29,16,877,821,1698,1625
0132-000,2017,11,29,17,962,848,1810,1698
0132-000,2017,11,29,18,1368,889,2257,1810
0132-000,2017,11,29,19,1572,766,2338,2257
0132-000,2017,11,29,20,852,599,1451,2338
0132-000,2017,11,29,21,751,492,1243,1451
0132-000,2017,11,29,22,507,421,928,1243
0132-000,2017,11,29,23,355,331,686,928
0132-000,2017,11,29,24,211,243,454,686
0132-000,2017,11,30,1,167,174,341,454
0132-000,2017,11,30,2,87,96,183,341
0132-000,2017,11,30,3,63,91,154,183
0132-000,2017,11,30,4,67,68,135,154
0132-000,2017,11,30,5,103,114,217,135
0132-000,2017,11,30,6,222,200,422,217
0132-000,2017,11,30,7,406,543,949,422
0132-000,2017,11,30,8,623,1712,2335,949
0132-000,2017,11,30,9,841,1567,2408,2335
0132-000,2017,11,30,10,752,949,1701,2408
0132-000,2017,11,30,11,743,818,1561,1701
0132-000,2017,11,30,12,755,815,1570,1561
0132-000,2017,11,30,13,666,717,1383,1570
0132-000,2017,11,30,14,769,796,1565,1383
0132-000,2017,11,30,15,866,806,1672,1565
0132-000,2017,11,30,16,863,786,1649,1672
0132-000,2017,11,30,17,933,852,1785,1649
0132-000,2017,11,30,18,1321,861,2182,1785
0132-000,2017,11,30,19,1431,789,2220,2182
0132-000,2017,11,30,20,906,586,1492,2220
0132-000,2017,11,30,21,825,508,1333,1492
0132-000,2017,11,30,22,560,422,982,1333
0132-000,2017,11,30,23,337,320,657,982
0132-000,2017,11,30,24,198,199,397,657
0132-000,2017,12,1,1,160,146,306,397
0132-000,2017,12,1,2,86,112,198,306
0132-000,2017,12,1,3,62,78,140,198
0132-000,2017,12,1,4,60,70,130,140
0132-000,2017,12,1,5,82,112,194,130
0132-000,2017,12,1,6,196,166,362,194
0132-000,2017,12,1,7,362,520,882,362
0132-000,2017,12,1,8,576,1653,2229,882
0132-000,2017,12,1,9,778,1462,2240,2229
0132-000,2017,12,1,10,688,832,1520,2240
0132-000,2017,12,1,11,669,794,1463,1520
0132-000,2017,12,1,12,674,756,1430,1463
0132-000,2017,12,1,13,691,693,1384,1430
0132-000,2017,12,1,14,772,780,1552,1384
0132-000,2017,12,1,15,762,752,1514,1552
0132-000,2017,12,1,16,826,721,1547,1514
0132-000,2017,12,1,17,898,779,1677,1547
0132-000,2017,12,1,18,1291,866,2157,1677
0132-000,2017,12,1,19,1631,832,2463,2157
0132-000,2017,12,1,20,923,672,1595,2463
0132-000,2017,12,1,21,755,507,1262,1595
0132-000,2017,12,1,22,560,409,969,1262
0132-000,2017,12,1,23,373,332,705,969
0132-000,2017,12,1,24,241,264,505,705
0132-000,2017,12,2,1,173,199,372,505
0132-000,2017,12,2,2,134,164,298,372
0132-000,2017,12,2,3,88,111,199,298
0132-000,2017,12,2,4,69,96,165,199
0132-000,2017,12,2,5,112,114,226,165
0132-000,2017,12,2,6,199,171,370,226
0132-000,2017,12,2,7,326,334,660,370
0132-000,2017,12,2,8,430,715,1145,660
0132-000,2017,12,2,9,606,882,1488,1145
0132-000,2017,12,2,10,656,829,1485,1488
0132-000,2017,12,2,11,704,860,1564,1485
0132-000,2017,12,2,12,786,912,1698,1564
0132-000,2017,12,2,13,901,864,1765,1698
0132-000,2017,12,2,14,844,882,1726,1765
0132-000,2017,12,2,15,838,942,1780,1726
0132-000,2017,12,2,16,861,868,1729,1780
0132-000,2017,12,2,17,977,932,1909,1729
0132-000,2017,12,2,18,1264,983,2247,1909
0132-000,2017,12,2,19,1023,763,1786,2247
0132-000,2017,12,2,20,657,572,1229,1786
0132-000,2017,12,2,21,508,431,939,1229
0132-000,2017,12,2,22,452,372,824,939
0132-000,2017,12,2,23,299,262,561,824
0132-000,2017,12,2,24,213,226,439,561
0132-000,2017,12,3,1,177,166,343,439
0132-000,2017,12,3,2,122,139,261,343
0132-000,2017,12,3,3,86,113,199,261
0132-000,2017,12,3,4,72,88,160,199
0132-000,2017,12,3,5,68,87,155,160
0132-000,2017,12,3,6,101,104,205,155
0132-000,2017,12,3,7,176,211,387,205
0132-000,2017,12,3,8,231,319,550,387
0132-000,2017,12,3,9,363,471,834,550
0132-000,2017,12,3,10,426,528,954,834
0132-000,2017,12,3,11,554,596,1150,954
0132-000,2017,12,3,12,594,610,1204,1150
0132-000,2017,12,3,13,675,627,1302,1204
0132-000,2017,12,3,14,665,694,1359,1302
0132-000,2017,12,3,15,782,704,1486,1359
0132-000,2017,12,3,16,861,739,1600,1486
0132-000,2017,12,3,17,973,705,1678,1600
0132-000,2017,12,3,18,1096,637,1733,1678
0132-000,2017,12,3,19,1053,546,1599,1733
0132-000,2017,12,3,20,774,468,1242,1599
0132-000,2017,12,3,21,580,420,1000,1242
0132-000,2017,12,3,22,391,343,734,1000
0132-000,2017,12,3,23,246,296,542,734
0132-000,2017,12,3,24,157,190,347,542
0132-000,2017,12,4,1,103,112,215,347
0132-000,2017,12,4,2,68,80,148,215
0132-000,2017,12,4,3,43,46,89,148
0132-000,2017,12,4,4,52,69,121,89
0132-000,2017,12,4,5,96,76,172,121
0132-000,2017,12,4,6,256,218,474,172
0132-000,2017,12,4,7,427,599,1026,474
0132-000,2017,12,4,8,624,1825,2449,1026
0132-000,2017,12,4,9,770,1573,2343,2449
0132-000,2017,12,4,10,660,832,1492,2343
0132-000,2017,12,4,11,722,799,1521,1492
0132-000,2017,12,4,12,766,768,1534,1521
0132-000,2017,12,4,13,723,751,1474,1534
0132-000,2017,12,4,14,756,762,1518,1474
0132-000,2017,12,4,15,800,759,1559,1518
0132-000,2017,12,4,16,843,832,1675,1559
0132-000,2017,12,4,17,882,816,1698,1675
0132-000,2017,12,4,18,1232,859,2091,1698
0132-000,2017,12,4,19,1393,769,2162,2091
0132-000,2017,12,4,20,873,597,1470,2162
0132-000,2017,12,4,21,802,473,1275,1470
0132-000,2017,12,4,22,528,368,896,1275
0132-000,2017,12,4,23,306,273,579,896
0132-000,2017,12,4,24,196,201,397,579
0132-000,2017,12,5,1,131,120,251,397
0132-000,2017,12,5,2,80,93,173,251
0132-000,2017,12,5,3,65,82,147,173
0132-000,2017,12,5,4,57,75,132,147
0132-000,2017,12,5,5,96,100,196,132
0132-000,2017,12,5,6,229,170,399,196
0132-000,2017,12,5,7,423,530,953,399
0132-000,2017,12,5,8,605,1678,2283,953
0132-000,2017,12,5,9,803,1671,2474,2283
0132-000,2017,12,5,10,729,846,1575,2474
0132-000,2017,12,5,11,735,802,1537,1575
0132-000,2017,12,5,12,733,752,1485,1537
0132-000,2017,12,5,13,691,723,1414,1485
0132-000,2017,12,5,14,685,714,1399,1414
0132-000,2017,12,5,15,773,757,1530,1399
0132-000,2017,12,5,16,752,776,1528,1530
0132-000,2017,12,5,17,760,784,1544,1528
0132-000,2017,12,5,18,1259,907,2166,1544
0132-000,2017,12,5,19,1437,768,2205,2166
0132-000,2017,12,5,20,827,599,1426,2205
0132-000,2017,12,5,21,792,496,1288,1426
0132-000,2017,12,5,22,567,387,954,1288
0132-000,2017,12,5,23,336,303,639,954
0132-000,2017,12,5,24,208,202,410,639
0132-000,2017,12,6,1,161,146,307,410
0132-000,2017,12,6,2,92,111,203,307
0132-000,2017,12,6,3,63,83,146,203
0132-000,2017,12,6,4,60,75,135,146
0132-000,2017,12,6,5,94,97,191,135
0132-000,2017,12,6,6,215,175,390,191
0132-000,2017,12,6,7,399,522,921,390
0132-000,2017,12,6,8,612,1693,2305,921
0132-000,2017,12,6,9,814,1551,2365,2305
0132-000,2017,12,6,10,738,888,1626,2365
0132-000,2017,12,6,11,703,766,1469,1626
0132-000,2017,12,6,12,746,787,1533,1469
0132-000,2017,12,6,13,692,727,1419,1533
0132-000,2017,12,6,14,747,754,1501,1419
0132-000,2017,12,6,15,782,769,1551,1501
0132-000,2017,12,6,16,842,774,1616,1551
0132-000,2017,12,6,17,924,796,1720,1616
0132-000,2017,12,6,18,1096,858,1954,1720
0132-000,2017,12,6,19,1345,781,2126,1954
0132-000,2017,12,6,20,920,602,1522,2126
0132-000,2017,12,6,21,739,492,1231,1522
0132-000,2017,12,6,22,523,423,946,1231
0132-000,2017,12,6,23,344,326,670,946
0132-000,2017,12,6,24,208,212,420,670
0132-000,2017,12,7,1,156,166,322,420
0132-000,2017,12,7,2,88,101,189,322
0132-000,2017,12,7,3,63,79,142,189
0132-000,2017,12,7,4,63,74,137,142
0132-000,2017,12,7,5,91,104,195,137
0132-000,2017,12,7,6,209,183,392,195
0132-000,2017,12,7,7,398,524,922,392
0132-000,2017,12,7,8,603,1711,2314,922
0132-000,2017,12,7,9,815,1551,2366,2314
0132-000,2017,12,7,10,717,860,1577,2366
0132-000,2017,12,7,11,716,804,1520,1577
0132-000,2017,12,7,12,768,773,1541,1520
0132-000,2017,12,7,13,678,700,1378,1541
0132-000,2017,12,7,14,762,764,1526,1378
0132-000,2017,12,7,15,795,789,1584,1526
0132-000,2017,12,7,16,846,785,1631,1584
0132-000,2017,12,7,17,919,826,1745,1631
0132-000,2017,12,7,18,1280,851,2131,1745
0132-000,2017,12,7,19,1395,744,2139,2131
0132-000,2017,12,7,20,860,583,1443,2139
0132-000,2017,12,7,21,822,488,1310,1443
0132-000,2017,12,7,22,551,430,981,1310
0132-000,2017,12,7,23,331,316,647,981
0132-000,2017,12,7,24,220,222,442,647
0132-000,2017,12,8,1,158,134,292,442
0132-000,2017,12,8,2,84,114,198,292
0132-000,2017,12,8,3,56,77,133,198
0132-000,2017,12,8,4,58,68,126,133
0132-000,2017,12,8,5,75,106,181,126
0132-000,2017,12,8,6,171,161,332,181
0132-000,2017,12,8,7,326,502,828,332
0132-000,2017,12,8,8,539,1622,2161,828
0132-000,2017,12,8,9,736,1408,2144,2161
0132-000,2017,12,8,10,660,797,1457,2144
0132-000,2017,12,8,11,658,752,1410,1457
0132-000,2017,12,8,12,640,746,1386,1410
0132-000,2017,12,8,13,660,672,1332,1386
0132-000,2017,12,8,14,750,767,1517,1332
0132-000,2017,12,8,15,825,789,1614,1517
0132-000,2017,12,8,16,823,776,1599,1614
0132-000,2017,12,8,17,931,764,1695,1599
0132-000,2017,12,8,18,1368,914,2282,1695
0132-000,2017,12,8,19,1680,884,2564,2282
0132-000,2017,12,8,20,969,705,1674,2564
0132-000,2017,12,8,21,741,519,1260,1674
0132-000,2017,12,8,22,557,429,986,1260
0132-000,2017,12,8,23,365,353,718,986
0132-000,2017,12,8,24,267,288,555,718
0132-000,2017,12,9,1,169,204,373,555
0132-000,2017,12,9,2,145,190,335,373
0132-000,2017,12,9,3,95,114,209,335
0132-000,2017,12,9,4,81,103,184,209
0132-000,2017,12,9,5,117,121,238,184
0132-000,2017,12,9,6,207,177,384,238
0132-000,2017,12,9,7,354,321,675,384
0132-000,2017,12,9,8,409,679,1088,675
0132-000,2017,12,9,9,589,889,1478,1088
0132-000,2017,12,9,10,609,779,1388,1478
0132-000,2017,12,9,11,680,778,1458,1388
0132-000,2017,12,9,12,785,875,1660,1458
0132-000,2017,12,9,13,919,834,1753,1660
0132-000,2017,12,9,14,801,840,1641,1753
0132-000,2017,12,9,15,849,863,1712,1641
0132-000,2017,12,9,16,880,884,1764,1712
0132-000,2017,12,9,17,975,910,1885,1764
0132-000,2017,12,9,18,1294,964,2258,1885
0132-000,2017,12,9,19,1067,697,1764,2258
0132-000,2017,12,9,20,640,595,1235,1764
0132-000,2017,12,9,21,499,434,933,1235
0132-000,2017,12,9,22,414,389,803,933
0132-000,2017,12,9,23,308,310,618,803
0132-000,2017,12,9,24,225,235,460,618
0132-000,2017,12,10,1,194,183,377,460
0132-000,2017,12,10,2,134,139,273,377
0132-000,2017,12,10,3,93,122,215,273
0132-000,2017,12,10,4,68,86,154,215
0132-000,2017,12,10,5,59,88,147,154
0132-000,2017,12,10,6,82,91,173,147
0132-000,2017,12,10,7,169,183,352,173
0132-000,2017,12,10,8,203,280,483,352
0132-000,2017,12,10,9,341,440,781,483
0132-000,2017,12,10,10,369,460,829,781
0132-000,2017,12,10,11,517,553,1070,829
0132-000,2017,12,10,12,602,587,1189,1070
0132-000,2017,12,10,13,662,572,1234,1189
0132-000,2017,12,10,14,627,678,1305,1234
0132-000,2017,12,10,15,712,659,1371,1305
0132-000,2017,12,10,16,761,667,1428,1371
0132-000,2017,12,10,17,789,634,1423,1428
0132-000,2017,12,10,18,806,608,1414,1423
0132-000,2017,12,10,19,753,500,1253,1414
0132-000,2017,12,10,20,501,411,912,1253
0132-000,2017,12,10,21,405,386,791,912
0132-000,2017,12,10,22,316,298,614,791
0132-000,2017,12,10,23,226,293,519,614
0132-000,2017,12,10,24,153,182,335,519
0132-000,2017,12,11,1,98,109,207,335
0132-000,2017,12,11,2,63,84,147,207
0132-000,2017,12,11,3,41,38,79,147
0132-000,2017,12,11,4,48,71,119,79
0132-000,2017,12,11,5,92,75,167,119
0132-000,2017,12,11,6,244,208,452,167
0132-000,2017,12,11,7,393,565,958,452
0132-000,2017,12,11,8,581,1807,2388,958
0132-000,2017,12,11,9,746,1554,2300,2388
0132-000,2017,12,11,10,611,842,1453,2300
0132-000,2017,12,11,11,719,769,1488,1453
0132-000,2017,12,11,12,782,735,1517,1488
0132-000,2017,12,11,13,722,735,1457,1517
0132-000,2017,12,11,14,737,710,1447,1457
0132-000,2017,12,11,15,776,709,1485,1447
0132-000,2017,12,11,16,824,835,1659,1485
0132-000,2017,12,11,17,843,812,1655,1659
0132-000,2017,12,11,18,1216,824,2040,1655
0132-000,2017,12,11,19,1355,743,2098,2040
0132-000,2017,12,11,20,848,583,1431,2098
0132-000,2017,12,11,21,783,448,1231,1431
0132-000,2017,12,11,22,483,360,843,1231
0132-000,2017,12,11,23,296,251,547,843
0132-000,2017,12,11,24,199,209,408,547
0132-000,2017,12,12,1,132,118,250,408
0132-000,2017,12,12,2,87,89,176,250
0132-000,2017,12,12,3,68,89,157,176
0132-000,2017,12,12,4,47,70,117,157
0132-000,2017,12,12,5,88,90,178,117
0132-000,2017,12,12,6,204,142,346,178
0132-000,2017,12,12,7,403,503,906,346
0132-000,2017,12,12,8,567,1649,2216,906
0132-000,2017,12,12,9,782,1588,2370,2216
0132-000,2017,12,12,10,715,812,1527,2370
0132-000,2017,12,12,11,739,805,1544,1527
0132-000,2017,12,12,12,733,720,1453,1544
0132-000,2017,12,12,13,696,733,1429,1453
0132-000,2017,12,12,14,599,651,1250,1429
0132-000,2017,12,12,15,728,730,1458,1250
0132-000,2017,12,12,16,626,735,1361,1458
0132-000,2017,12,12,17,571,738,1309,1361
0132-000,2017,12,12,18,1210,868,2078,1309
0132-000,2017,12,12,19,1402,729,2131,2078
0132-000,2017,12,12,20,800,590,1390,2131
0132-000,2017,12,12,21,761,481,1242,1390
0132-000,2017,12,12,22,561,385,946,1242
0132-000,2017,12,12,23,320,297,617,946
0132-000,2017,12,12,24,206,203,409,617
0132-000,2017,12,13,1,173,141,314,409
0132-000,2017,12,13,2,97,110,207,314
0132-000,2017,12,13,3,61,88,149,207
0132-000,2017,12,13,4,57,71,128,149
0132-000,2017,12,13,5,91,90,181,128
0132-000,2017,12,13,6,189,165,354,181
0132-000,2017,12,13,7,371,474,845,354
0132-000,2017,12,13,8,601,1665,2266,845
0132-000,2017,12,13,9,792,1549,2341,2266
0132-000,2017,12,13,10,724,831,1555,2341
0132-000,2017,12,13,11,665,694,1359,1555
0132-000,2017,12,13,12,761,790,1551,1359
0132-000,2017,12,13,13,661,695,1356,1551
0132-000,2017,12,13,14,732,722,1454,1356
0132-000,2017,12,13,15,722,754,1476,1454
0132-000,2017,12,13,16,807,727,1534,1476
0132-000,2017,12,13,17,886,743,1629,1534
0132-000,2017,12,13,18,823,827,1650,1629
0132-000,2017,12,13,19,1118,795,1913,1650
0132-000,2017,12,13,20,987,604,1591,1913
0132-000,2017,12,13,21,727,491,1218,1591
0132-000,2017,12,13,22,538,425,963,1218
0132-000,2017,12,13,23,332,320,652,963
0132-000,2017,12,13,24,204,180,384,652
0132-000,2017,12,14,1,145,157,302,384
0132-000,2017,12,14,2,88,105,193,302
0132-000,2017,12,14,3,62,67,129,193
0132-000,2017,12,14,4,59,80,139,129
0132-000,2017,12,14,5,78,93,171,139
0132-000,2017,12,14,6,196,165,361,171
0132-000,2017,12,14,7,389,505,894,361
0132-000,2017,12,14,8,583,1709,2292,894
0132-000,2017,12,14,9,789,1534,2323,2292
0132-000,2017,12,14,10,681,771,1452,2323
0132-000,2017,12,14,11,688,789,1477,1452
0132-000,2017,12,14,12,780,731,1511,1477
0132-000,2017,12,14,13,690,683,1373,1511
0132-000,2017,12,14,14,754,732,1486,1373
0132-000,2017,12,14,15,723,772,1495,1486
0132-000,2017,12,14,16,828,783,1611,1495
0132-000,2017,12,14,17,904,800,1704,1611
0132-000,2017,12,14,18,1238,841,2079,1704
0132-000,2017,12,14,19,1358,699,2057,2079
0132-000,2017,12,14,20,814,580,1394,2057
0132-000,2017,12,14,21,819,467,1286,1394
0132-000,2017,12,14,22,541,438,979,1286
0132-000,2017,12,14,23,325,311,636,979
0132-000,2017,12,14,24,242,245,487,636
0132-000,2017,12,15,1,174,171,345,487
0132-000,2017,12,15,2,104,111,215,345
0132-000,2017,12,15,3,83,91,174,215
0132-000,2017,12,15,4,75,98,173,174
0132-000,2017,12,15,5,81,96,177,173
0132-000,2017,12,15,6,193,139,332,177
0132-000,2017,12,15,7,376,523,899,332
0132-000,2017,12,15,8,606,1754,2360,899
0132-000,2017,12,15,9,803,1470,2273,2360
0132-000,2017,12,15,10,763,878,1641,2273
0132-000,2017,12,15,11,705,816,1521,1641
0132-000,2017,12,15,12,733,767,1500,1521
0132-000,2017,12,15,13,774,738,1512,1500
0132-000,2017,12,15,14,799,806,1605,1512
0132-000,2017,12,15,15,748,779,1527,1605
0132-000,2017,12,15,16,891,856,1747,1527
0132-000,2017,12,15,17,1041,825,1866,1747
0132-000,2017,12,15,18,1417,918,2335,1866
0132-000,2017,12,15,19,1635,819,2454,2335
0132-000,2017,12,15,20,861,686,1547,2454
0132-000,2017,12,15,21,792,544,1336,1547
0132-000,2017,12,15,22,568,446,1014,1336
0132-000,2017,12,15,23,400,357,757,1014
0132-000,2017,12,15,24,255,281,536,757
0132-000,2017,12,16,1,200,206,406,536
0132-000,2017,12,16,2,161,137,298,406
0132-000,2017,12,16,3,100,138,238,298
0132-000,2017,12,16,4,87,112,199,238
0132-000,2017,12,16,5,105,126,231,199
0132-000,2017,12,16,6,185,164,349,231
0132-000,2017,12,16,7,313,294,607,349
0132-000,2017,12,16,8,442,767,1209,607
0132-000,2017,12,16,9,553,825,1378,1209
0132-000,2017,12,16,10,594,795,1389,1378
0132-000,2017,12,16,11,684,768,1452,1389
0132-000,2017,12,16,12,754,819,1573,1452
0132-000,2017,12,16,13,859,841,1700,1573
0132-000,2017,12,16,14,772,820,1592,1700
0132-000,2017,12,16,15,868,881,1749,1592
0132-000,2017,12,16,16,869,894,1763,1749
0132-000,2017,12,16,17,928,885,1813,1763
0132-000,2017,12,16,18,1207,912,2119,1813
0132-000,2017,12,16,19,937,754,1691,2119
0132-000,2017,12,16,20,671,522,1193,1691
0132-000,2017,12,16,21,504,422,926,1193
0132-000,2017,12,16,22,422,412,834,926
0132-000,2017,12,16,23,311,335,646,834
0132-000,2017,12,16,24,203,251,454,646
0132-000,2017,12,17,1,188,207,395,454
0132-000,2017,12,17,2,167,138,305,395
0132-000,2017,12,17,3,89,118,207,305
0132-000,2017,12,17,4,81,86,167,207
0132-000,2017,12,17,5,72,87,159,167
0132-000,2017,12,17,6,100,107,207,159
0132-000,2017,12,17,7,144,155,299,207
0132-000,2017,12,17,8,227,347,574,299
0132-000,2017,12,17,9,343,395,738,574
0132-000,2017,12,17,10,381,483,864,738
0132-000,2017,12,17,11,536,571,1107,864
0132-000,2017,12,17,12,557,646,1203,1107
0132-000,2017,12,17,13,789,708,1497,1203
0132-000,2017,12,17,14,658,675,1333,1497
0132-000,2017,12,17,15,792,761,1553,1333
0132-000,2017,12,17,16,824,759,1583,1553
0132-000,2017,12,17,17,854,742,1596,1583
0132-000,2017,12,17,18,938,658,1596,1596
0132-000,2017,12,17,19,791,546,1337,1596
0132-000,2017,12,17,20,593,438,1031,1337
0132-000,2017,12,17,21,459,414,873,1031
0132-000,2017,12,17,22,369,331,700,873
0132-000,2017,12,17,23,217,237,454,700
0132-000,2017,12,17,24,140,182,322,454
0132-000,2017,12,18,1,105,96,201,322
0132-000,2017,12,18,2,73,81,154,201
0132-000,2017,12,18,3,50,51,101,154
0132-000,2017,12,18,4,46,44,90,101
0132-000,2017,12,18,5,87,76,163,90
0132-000,2017,12,18,6,234,166,400,163
0132-000,2017,12,18,7,392,546,938,400
0132-000,2017,12,18,8,552,1812,2364,938
0132-000,2017,12,18,9,768,1361,2129,2364
0132-000,2017,12,18,10,681,782,1463,2129
0132-000,2017,12,18,11,722,740,1462,1463
0132-000,2017,12,18,12,694,754,1448,1462
0132-000,2017,12,18,13,688,685,1373,1448
0132-000,2017,12,18,14,720,746,1466,1373
0132-000,2017,12,18,15,798,811,1609,1466
0132-000,2017,12,18,16,804,740,1544,1609
0132-000,2017,12,18,17,826,785,1611,1544
0132-000,2017,12,18,18,1272,809,2081,1611
0132-000,2017,12,18,19,1323,694,2017,2081
0132-000,2017,12,18,20,795,591,1386,2017
0132-000,2017,12,18,21,744,451,1195,1386
0132-000,2017,12,18,22,509,350,859,1195
0132-000,2017,12,18,23,280,297,577,859
0132-000,2017,12,18,24,202,214,416,577
0132-000,2017,12,19,1,134,129,263,416
0132-000,2017,12,19,2,107,96,203,263
0132-000,2017,12,19,3,67,72,139,203
0132-000,2017,12,19,4,64,64,128,139
0132-000,2017,12,19,5,96,91,187,128
0132-000,2017,12,19,6,193,163,356,187
0132-000,2017,12,19,7,367,515,882,356
0132-000,2017,12,19,8,566,1793,2359,882
0132-000,2017,12,19,9,805,1452,2257,2359
0132-000,2017,12,19,10,687,808,1495,2257
0132-000,2017,12,19,11,702,780,1482,1495
0132-000,2017,12,19,12,675,710,1385,1482
0132-000,2017,12,19,13,699,698,1397,1385
0132-000,2017,12,19,14,729,801,1530,1397
0132-000,2017,12,19,15,786,720,1506,1530
0132-000,2017,12,19,16,738,712,1450,1506
0132-000,2017,12,19,17,887,742,1629,1450
0132-000,2017,12,19,18,1235,835,2070,1629
0132-000,2017,12,19,19,1325,725,2050,2070
0132-000,2017,12,19,20,830,555,1385,2050
0132-000,2017,12,19,21,806,488,1294,1385
0132-000,2017,12,19,22,568,384,952,1294
0132-000,2017,12,19,23,333,306,639,952
0132-000,2017,12,19,24,217,241,458,639
0132-000,2017,12,20,1,125,161,286,458
0132-000,2017,12,20,2,113,116,229,286
0132-000,2017,12,20,3,80,100,180,229
0132-000,2017,12,20,4,63,76,139,180
0132-000,2017,12,20,5,84,108,192,139
0132-000,2017,12,20,6,225,173,398,192
0132-000,2017,12,20,7,372,484,856,398
0132-000,2017,12,20,8,573,1742,2315,856
0132-000,2017,12,20,9,788,1449,2237,2315
0132-000,2017,12,20,10,728,775,1503,2237
0132-000,2017,12,20,11,705,762,1467,1503
0132-000,2017,12,20,12,725,796,1521,1467
0132-000,2017,12,20,13,767,690,1457,1521
0132-000,2017,12,20,14,752,706,1458,1457
0132-000,2017,12,20,15,822,804,1626,1458
0132-000,2017,12,20,16,809,728,1537,1626
0132-000,2017,12,20,17,870,816,1686,1537
0132-000,2017,12,20,18,1347,820,2167,1686
0132-000,2017,12,20,19,1496,687,2183,2167
0132-000,2017,12,20,20,736,616,1352,2183
0132-000,2017,12,20,21,673,444,1117,1352
0132-000,2017,12,20,22,435,333,768,1117
0132-000,2017,12,20,23,313,313,626,768
0132-000,2017,12,20,24,192,213,405,626
0132-000,2017,12,21,1,165,159,324,405
0132-000,2017,12,21,2,91,121,212,324
0132-000,2017,12,21,3,68,85,153,212
0132-000,2017,12,21,4,60,88,148,153
0132-000,2017,12,21,5,92,95,187,148
0132-000,2017,12,21,6,186,171,357,187
0132-000,2017,12,21,7,353,477,830,357
0132-000,2017,12,21,8,562,1754,2316,830
0132-000,2017,12,21,9,753,1419,2172,2316
0132-000,2017,12,21,10,624,772,1396,2172
0132-000,2017,12,21,11,654,704,1358,1396
0132-000,2017,12,21,12,706,790,1496,1358
0132-000,2017,12,21,13,768,681,1449,1496
0132-000,2017,12,21,14,685,702,1387,1449
0132-000,2017,12,21,15,802,779,1581,1387
0132-000,2017,12,21,16,837,776,1613,1581
0132-000,2017,12,21,17,928,799,1727,1613
0132-000,2017,12,21,18,1330,837,2167,1727
0132-000,2017,12,21,19,1382,695,2077,2167
0132-000,2017,12,21,20,769,596,1365,2077
0132-000,2017,12,21,21,748,483,1231,1365
0132-000,2017,12,21,22,582,429,1011,1231
0132-000,2017,12,21,23,361,318,679,1011
0132-000,2017,12,21,24,245,258,503,679
0132-000,2017,12,22,1,178,160,338,503
0132-000,2017,12,22,2,137,138,275,338
0132-000,2017,12,22,3,87,85,172,275
0132-000,2017,12,22,4,57,83,140,172
0132-000,2017,12,22,5,105,122,227,140
0132-000,2017,12,22,6,212,176,388,227
0132-000,2017,12,22,7,396,487,883,388
0132-000,2017,12,22,8,617,1695,2312,883
0132-000,2017,12,22,9,816,1383,2199,2312
0132-000,2017,12,22,10,759,896,1655,2199
0132-000,2017,12,22,11,743,878,1621,1655
0132-000,2017,12,22,12,724,894,1618,1621
0132-000,2017,12,22,13,771,750,1521,1618
0132-000,2017,12,22,14,799,789,1588,1521
0132-000,2017,12,22,15,838,828,1666,1588
0132-000,2017,12,22,16,878,774,1652,1666
0132-000,2017,12,22,17,945,879,1824,1652
0132-000,2017,12,22,18,1502,930,2432,1824
0132-000,2017,12,22,19,1687,758,2445,2432
0132-000,2017,12,22,20,991,754,1745,2445
0132-000,2017,12,22,21,734,534,1268,1745
0132-000,2017,12,22,22,605,493,1098,1268
0132-000,2017,12,22,23,383,377,760,1098
0132-000,2017,12,22,24,237,289,526,760
0132-000,2017,12,23,1,193,215,408,526
0132-000,2017,12,23,2,129,176,305,408
0132-000,2017,12,23,3,108,134,242,305
0132-000,2017,12,23,4,93,117,210,242
0132-000,2017,12,23,5,97,123,220,210
0132-000,2017,12,23,6,207,152,359,220
0132-000,2017,12,23,7,342,328,670,359
0132-000,2017,12,23,8,439,668,1107,670
0132-000,2017,12,23,9,590,815,1405,1107
0132-000,2017,12,23,10,668,792,1460,1405
0132-000,2017,12,23,11,771,831,1602,1460
0132-000,2017,12,23,12,755,918,1673,1602
0132-000,2017,12,23,13,846,855,1701,1673
0132-000,2017,12,23,14,819,884,1703,1701
0132-000,2017,12,23,15,873,854,1727,1703
0132-000,2017,12,23,16,808,917,1725,1727
0132-000,2017,12,23,17,941,946,1887,1725
0132-000,2017,12,23,18,1110,1020,2130,1887
0132-000,2017,12,23,19,999,802,1801,2130
0132-000,2017,12,23,20,659,575,1234,1801
0132-000,2017,12,23,21,501,445,946,1234
0132-000,2017,12,23,22,438,417,855,946
0132-000,2017,12,23,23,285,314,599,855
0132-000,2017,12,23,24,238,202,440,599
0132-000,2017,12,24,1,191,203,394,440
0132-000,2017,12,24,2,139,109,248,394
0132-000,2017,12,24,3,78,100,178,248
0132-000,2017,12,24,4,73,96,169,178
0132-000,2017,12,24,5,61,85,146,169
0132-000,2017,12,24,6,103,86,189,146
0132-000,2017,12,24,7,150,133,283,189
0132-000,2017,12,24,8,192,241,433,283
0132-000,2017,12,24,9,259,316,575,433
0132-000,2017,12,24,10,359,425,784,575
0132-000,2017,12,24,11,473,520,993,784
0132-000,2017,12,24,12,465,549,1014,993
0132-000,2017,12,24,13,538,551,1089,1014
0132-000,2017,12,24,14,573,585,1158,1089
0132-000,2017,12,24,15,607,586,1193,1158
0132-000,2017,12,24,16,660,616,1276,1193
0132-000,2017,12,24,17,732,565,1297,1276
0132-000,2017,12,24,18,649,508,1157,1297
0132-000,2017,12,24,19,608,446,1054,1157
0132-000,2017,12,24,20,435,393,828,1054
0132-000,2017,12,24,21,319,306,625,828
0132-000,2017,12,24,22,322,310,632,625
0132-000,2017,12,24,23,235,257,492,632
0132-000,2017,12,24,24,169,176,345,492
0132-000,2017,12,25,1,120,169,289,345
0132-000,2017,12,25,2,108,128,236,289
0132-000,2017,12,25,3,73,73,146,236
0132-000,2017,12,25,4,56,63,119,146
0132-000,2017,12,25,5,75,80,155,119
0132-000,2017,12,25,6,127,124,251,155
0132-000,2017,12,25,7,205,187,392,251
0132-000,2017,12,25,8,258,359,617,392
0132-000,2017,12,25,9,298,354,652,617
0132-000,2017,12,25,10,378,448,826,652
0132-000,2017,12,25,11,523,619,1142,826
0132-000,2017,12,25,12,558,669,1227,1142
0132-000,2017,12,25,13,661,773,1434,1227
0132-000,2017,12,25,14,752,783,1535,1434
0132-000,2017,12,25,15,815,728,1543,1535
0132-000,2017,12,25,16,799,720,1519,1543
0132-000,2017,12,25,17,841,709,1550,1519
0132-000,2017,12,25,18,920,740,1660,1550
0132-000,2017,12,25,19,689,538,1227,1660
0132-000,2017,12,25,20,534,430,964,1227
0132-000,2017,12,25,21,457,425,882,964
0132-000,2017,12,25,22,366,309,675,882
0132-000,2017,12,25,23,248,303,551,675
0132-000,2017,12,25,24,166,189,355,551
0132-000,2017,12,26,1,106,152,258,355
0132-000,2017,12,26,2,76,92,168,258
0132-000,2017,12,26,3,58,75,133,168
0132-000,2017,12,26,4,45,65,110,133
0132-000,2017,12,26,5,80,77,157,110
0132-000,2017,12,26,6,219,202,421,157
0132-000,2017,12,26,7,387,515,902,421
0132-000,2017,12,26,8,562,1775,2337,902
0132-000,2017,12,26,9,728,1486,2214,2337
0132-000,2017,12,26,10,647,749,1396,2214
0132-000,2017,12,26,11,697,794,1491,1396
0132-000,2017,12,26,12,664,770,1434,1491
0132-000,2017,12,26,13,660,736,1396,1434
0132-000,2017,12,26,14,750,764,1514,1396
0132-000,2017,12,26,15,842,752,1594,1514
0132-000,2017,12,26,16,838,742,1580,1594
0132-000,2017,12,26,17,894,830,1724,1580
0132-000,2017,12,26,18,1231,808,2039,1724
0132-000,2017,12,26,19,1444,733,2177,2039
0132-000,2017,12,26,20,779,582,1361,2177
0132-000,2017,12,26,21,695,466,1161,1361
0132-000,2017,12,26,22,490,382,872,1161
0132-000,2017,12,26,23,321,303,624,872
0132-000,2017,12,26,24,215,198,413,624
0132-000,2017,12,27,1,124,164,288,413
0132-000,2017,12,27,2,99,79,178,288
0132-000,2017,12,27,3,67,82,149,178
0132-000,2017,12,27,4,50,71,121,149
0132-000,2017,12,27,5,88,97,185,121
0132-000,2017,12,27,6,201,182,383,185
0132-000,2017,12,27,7,343,455,798,383
0132-000,2017,12,27,8,573,1722,2295,798
0132-000,2017,12,27,9,751,1425,2176,2295
0132-000,2017,12,27,10,664,749,1413,2176
0132-000,2017,12,27,11,683,733,1416,1413
0132-000,2017,12,27,12,674,766,1440,1416
0132-000,2017,12,27,13,702,660,1362,1440
0132-000,2017,12,27,14,737,693,1430,1362
0132-000,2017,12,27,15,783,727,1510,1430
0132-000,2017,12,27,16,777,764,1541,1510
0132-000,2017,12,27,17,860,762,1622,1541
0132-000,2017,12,27,18,1369,821,2190,1622
0132-000,2017,12,27,19,1450,714,2164,2190
0132-000,2017,12,27,20,806,619,1425,2164
0132-000,2017,12,27,21,645,475,1120,1425
0132-000,2017,12,27,22,538,405,943,1120
0132-000,2017,12,27,23,306,310,616,943
0132-000,2017,12,27,24,205,224,429,616
0132-000,2017,12,28,1,156,173,329,429
0132-000,2017,12,28,2,104,103,207,329
0132-000,2017,12,28,3,78,85,163,207
0132-000,2017,12,28,4,66,72,138,163
0132-000,2017,12,28,5,70,109,179,138
0132-000,2017,12,28,6,221,173,394,179
0132-000,2017,12,28,7,367,453,820,394
0132-000,2017,12,28,8,580,1737,2317,820
0132-000,2017,12,28,9,765,1334,2099,2317
0132-000,2017,12,28,10,726,758,1484,2099
0132-000,2017,12,28,11,709,814,1523,1484
0132-000,2017,12,28,12,719,743,1462,1523
0132-000,2017,12,28,13,653,679,1332,1462
0132-000,2017,12,28,14,787,764,1551,1332
0132-000,2017,12,28,15,794,751,1545,1551
0132-000,2017,12,28,16,831,733,1564,1545
0132-000,2017,12,28,17,856,781,1637,1564
0132-000,2017,12,28,18,1262,817,2079,1637
0132-000,2017,12,28,19,1307,664,1971,2079
0132-000,2017,12,28,20,807,580,1387,1971
0132-000,2017,12,28,21,727,493,1220,1387
0132-000,2017,12,28,22,486,431,917,1220
0132-000,2017,12,28,23,353,321,674,917
0132-000,2017,12,28,24,247,245,492,674
0132-000,2017,12,29,1,182,172,354,492
0132-000,2017,12,29,2,114,131,245,354
0132-000,2017,12,29,3,76,99,175,245
0132-000,2017,12,29,4,61,91,152,175
0132-000,2017,12,29,5,97,107,204,152
0132-000,2017,12,29,6,199,168,367,204
0132-000,2017,12,29,7,356,441,797,367
0132-000,2017,12,29,8,595,1562,2157,797
0132-000,2017,12,29,9,749,1293,2042,2157
0132-000,2017,12,29,10,707,794,1501,2042
0132-000,2017,12,29,11,728,817,1545,1501
0132-000,2017,12,29,12,726,811,1537,1545
0132-000,2017,12,29,13,794,754,1548,1537
0132-000,2017,12,29,14,811,780,1591,1548
0132-000,2017,12,29,15,885,826,1711,1591
0132-000,2017,12,29,16,905,768,1673,1711
0132-000,2017,12,29,17,1004,859,1863,1673
0132-000,2017,12,29,18,1408,893,2301,1863
0132-000,2017,12,29,19,1346,758,2104,2301
0132-000,2017,12,29,20,773,654,1427,2104
0132-000,2017,12,29,21,617,522,1139,1427
0132-000,2017,12,29,22,447,433,880,1139
0132-000,2017,12,29,23,375,362,737,880
0132-000,2017,12,29,24,263,276,539,737
0132-000,2017,12,30,1,207,201,408,539
0132-000,2017,12,30,2,143,142,285,408
0132-000,2017,12,30,3,93,136,229,285
0132-000,2017,12,30,4,72,106,178,229
0132-000,2017,12,30,5,100,113,213,178
0132-000,2017,12,30,6,168,151,319,213
0132-000,2017,12,30,7,306,291,597,319
0132-000,2017,12,30,8,360,553,913,597
0132-000,2017,12,30,9,512,647,1159,913
0132-000,2017,12,30,10,595,632,1227,1159
0132-000,2017,12,30,11,638,764,1402,1227
0132-000,2017,12,30,12,676,847,1523,1402
0132-000,2017,12,30,13,772,775,1547,1523
0132-000,2017,12,30,14,716,830,1546,1547
0132-000,2017,12,30,15,814,890,1704,1546
0132-000,2017,12,30,16,797,873,1670,1704
0132-000,2017,12,30,17,891,953,1844,1670
0132-000,2017,12,30,18,1049,802,1851,1844
0132-000,2017,12,30,19,816,712,1528,1851
0132-000,2017,12,30,20,592,467,1059,1528
0132-000,2017,12,30,21,462,441,903,1059
0132-000,2017,12,30,22,377,343,720,903
0132-000,2017,12,30,23,265,282,547,720
0132-000,2017,12,30,24,190,211,401,547
0132-000,2017,12,31,1,157,178,335,401
0132-000,2017,12,31,2,117,130,247,335
0132-000,2017,12,31,3,95,97,192,247
0132-000,2017,12,31,4,75,92,167,192
0132-000,2017,12,31,5,57,77,134,167
0132-000,2017,12,31,6,64,71,135,134
0132-000,2017,12,31,7,102,115,217,135
0132-000,2017,12,31,8,172,205,377,217
0132-000,2017,12,31,9,286,325,611,377
0132-000,2017,12,31,10,324,459,783,611
0132-000,2017,12,31,11,472,568,1040,783
0132-000,2017,12,31,12,450,581,1031,1040
0132-000,2017,12,31,13,588,650,1238,1031
0132-000,2017,12,31,14,598,645,1243,1238
0132-000,2017,12,31,15,686,697,1383,1243
0132-000,2017,12,31,16,665,716,1381,1383
0132-000,2017,12,31,17,742,670,1412,1381
0132-000,2017,12,31,18,767,604,1371,1412
0132-000,2017,12,31,19,732,515,1247,1371
0132-000,2017,12,31,20,533,391,924,1247
0132-000,2017,12,31,21,361,342,703,924
0132-000,2017,12,31,22,291,291,582,703
0132-000,2017,12,31,23,254,260,514,582
0132-000,2017,12,31,24,165,202,367,514
0132-000,2018,1,1,1,152,143,295,367
0132-000,2018,1,1,2,138,149,287,295
0132-000,2018,1,1,3,74,122,196,287
0132-000,2018,1,1,4,58,69,127,196
0132-000,2018,1,1,5,62,70,132,127
0132-000,2018,1,1,6,62,100,162,132
0132-000,2018,1,1,7,94,155,249,162
0132-000,2018,1,1,8,156,206,362,249
0132-000,2018,1,1,9,242,231,473,362
0132-000,2018,1,1,10,309,314,623,473
0132-000,2018,1,1,11,376,446,822,623
0132-000,2018,1,1,12,480,554,1034,822
0132-000,2018,1,1,13,724,590,1314,1034
0132-000,2018,1,1,14,662,618,1280,1314
0132-000,2018,1,1,15,753,584,1337,1280
0132-000,2018,1,1,16,802,604,1406,1337
0132-000,2018,1,1,17,803,552,1355,1406
0132-000,2018,1,1,18,833,593,1426,1355
0132-000,2018,1,1,19,672,480,1152,1426
0132-000,2018,1,1,20,540,413,953,1152
0132-000,2018,1,1,21,454,379,833,953
0132-000,2018,1,1,22,346,311,657,833
0132-000,2018,1,1,23,236,256,492,657
0132-000,2018,1,1,24,130,152,282,492
0132-000,2018,1,2,1,114,141,255,282
0132-000,2018,1,2,2,67,75,142,255
0132-000,2018,1,2,3,37,49,86,142
0132-000,2018,1,2,4,48,55,103,86
0132-000,2018,1,2,5,93,76,169,103
0132-000,2018,1,2,6,209,170,379,169
0132-000,2018,1,2,7,348,456,804,379
0132-000,2018,1,2,8,522,1735,2257,804
0132-000,2018,1,2,9,640,1180,1820,2257
0132-000,2018,1,2,10,552,690,1242,1820
0132-000,2018,1,2,11,666,664,1330,1242
0132-000,2018,1,2,12,645,703,1348,1330
0132-000,2018,1,2,13,609,672,1281,1348
0132-000,2018,1,2,14,755,716,1471,1281
0132-000,2018,1,2,15,735,698,1433,1471
0132-000,2018,1,2,16,743,711,1454,1433
0132-000,2018,1,2,17,785,682,1467,1454
0132-000,2018,1,2,18,1176,763,1939,1467
0132-000,2018,1,2,19,1387,713,2100,1939
0132-000,2018,1,2,20,767,575,1342,2100
0132-000,2018,1,2,21,666,459,1125,1342
0132-000,2018,1,2,22,436,323,759,1125
0132-000,2018,1,2,23,250,259,509,759
0132-000,2018,1,2,24,158,159,317,509
0132-000,2018,1,3,1,110,115,225,317
0132-000,2018,1,3,2,72,81,153,225
0132-000,2018,1,3,3,47,68,115,153
0132-000,2018,1,3,4,58,79,137,115
0132-000,2018,1,3,5,91,86,177,137
0132-000,2018,1,3,6,212,170,382,177
0132-000,2018,1,3,7,376,470,846,382
0132-000,2018,1,3,8,511,1800,2311,846
0132-000,2018,1,3,9,702,1344,2046,2311
0132-000,2018,1,3,10,632,754,1386,2046
0132-000,2018,1,3,11,653,680,1333,1386
0132-000,2018,1,3,12,653,764,1417,1333
0132-000,2018,1,3,13,714,622,1336,1417
0132-000,2018,1,3,14,711,741,1452,1336
0132-000,2018,1,3,15,751,721,1472,1452
0132-000,2018,1,3,16,765,662,1427,1472
0132-000,2018,1,3,17,796,782,1578,1427
0132-000,2018,1,3,18,1302,770,2072,1578
0132-000,2018,1,3,19,1400,752,2152,2072
0132-000,2018,1,3,20,847,563,1410,2152
0132-000,2018,1,3,21,694,478,1172,1410
0132-000,2018,1,3,22,473,359,832,1172
0132-000,2018,1,3,23,286,287,573,832
0132-000,2018,1,3,24,202,216,418,573
0132-000,2018,1,4,1,144,128,272,418
0132-000,2018,1,4,2,72,81,153,272
0132-000,2018,1,4,3,64,86,150,153
0132-000,2018,1,4,4,63,75,138,150
0132-000,2018,1,4,5,90,96,186,138
0132-000,2018,1,4,6,217,170,387,186
0132-000,2018,1,4,7,361,496,857,387
0132-000,2018,1,4,8,549,1717,2266,857
0132-000,2018,1,4,9,777,1436,2213,2266
0132-000,2018,1,4,10,631,769,1400,2213
0132-000,2018,1,4,11,674,738,1412,1400
0132-000,2018,1,4,12,693,739,1432,1412
0132-000,2018,1,4,13,687,705,1392,1432
0132-000,2018,1,4,14,718,719,1437,1392
0132-000,2018,1,4,15,746,695,1441,1437
0132-000,2018,1,4,16,753,691,1444,1441
0132-000,2018,1,4,17,848,758,1606,1444
0132-000,2018,1,4,18,1219,793,2012,1606
0132-000,2018,1,4,19,1375,726,2101,2012
0132-000,2018,1,4,20,809,576,1385,2101
0132-000,2018,1,4,21,732,469,1201,1385
0132-000,2018,1,4,22,464,365,829,1201
0132-000,2018,1,4,23,299,275,574,829
0132-000,2018,1,4,24,217,199,416,574
0132-000,2018,1,5,1,143,123,266,416
0132-000,2018,1,5,2,87,101,188,266
0132-000,2018,1,5,3,62,63,125,188
0132-000,2018,1,5,4,46,75,121,125
0132-000,2018,1,5,5,83,80,163,121
0132-000,2018,1,5,6,226,161,387,163
0132-000,2018,1,5,7,370,485,855,387
0132-000,2018,1,5,8,567,1703,2270,855
0132-000,2018,1,5,9,763,1378,2141,2270
0132-000,2018,1,5,10,689,823,1512,2141
0132-000,2018,1,5,11,688,752,1440,1512
0132-000,2018,1,5,12,685,792,1477,1440
0132-000,2018,1,5,13,739,738,1477,1477
0132-000,2018,1,5,14,775,749,1524,1477
0132-000,2018,1,5,15,807,772,1579,1524
0132-000,2018,1,5,16,784,778,1562,1579
0132-000,2018,1,5,17,909,820,1729,1562
0132-000,2018,1,5,18,1324,879,2203,1729
0132-000,2018,1,5,19,1614,781,2395,2203
0132-000,2018,1,5,20,942,656,1598,2395
0132-000,2018,1,5,21,734,514,1248,1598
0132-000,2018,1,5,22,538,393,931,1248
0132-000,2018,1,5,23,315,307,622,931
0132-000,2018,1,5,24,231,230,461,622
0132-000,2018,1,6,1,182,200,382,461
0132-000,2018,1,6,2,117,134,251,382
0132-000,2018,1,6,3,94,116,210,251
0132-000,2018,1,6,4,79,85,164,210
0132-000,2018,1,6,5,112,93,205,164
0132-000,2018,1,6,6,223,123,346,205
0132-000,2018,1,6,7,323,308,631,346
0132-000,2018,1,6,8,428,698,1126,631
0132-000,2018,1,6,9,568,752,1320,1126
0132-000,2018,1,6,10,635,733,1368,1320
0132-000,2018,1,6,11,705,868,1573,1368
0132-000,2018,1,6,12,756,826,1582,1573
0132-000,2018,1,6,13,808,790,1598,1582
0132-000,2018,1,6,14,786,850,1636,1598
0132-000,2018,1,6,15,880,833,1713,1636
0132-000,2018,1,6,16,911,872,1783,1713
0132-000,2018,1,6,17,884,828,1712,1783
0132-000,2018,1,6,18,1096,909,2005,1712
0132-000,2018,1,6,19,910,669,1579,2005
0132-000,2018,1,6,20,555,549,1104,1579
0132-000,2018,1,6,21,475,420,895,1104
0132-000,2018,1,6,22,376,351,727,895
0132-000,2018,1,6,23,292,293,585,727
0132-000,2018,1,6,24,175,229,404,585
0132-000,2018,1,7,1,139,167,306,404
0132-000,2018,1,7,2,114,130,244,306
0132-000,2018,1,7,3,93,111,204,244
0132-000,2018,1,7,4,76,88,164,204
0132-000,2018,1,7,5,69,77,146,164
0132-000,2018,1,7,6,101,93,194,146
0132-000,2018,1,7,7,149,146,295,194
0132-000,2018,1,7,8,187,256,443,295
0132-000,2018,1,7,9,285,342,627,443
0132-000,2018,1,7,10,380,458,838,627
0132-000,2018,1,7,11,456,591,1047,838
0132-000,2018,1,7,12,506,565,1071,1047
0132-000,2018,1,7,13,608,591,1199,1071
0132-000,2018,1,7,14,617,658,1275,1199
0132-000,2018,1,7,15,714,674,1388,1275
0132-000,2018,1,7,16,735,715,1450,1388
0132-000,2018,1,7,17,737,662,1399,1450
0132-000,2018,1,7,18,785,633,1418,1399
0132-000,2018,1,7,19,759,479,1238,1418
0132-000,2018,1,7,20,502,412,914,1238
0132-000,2018,1,7,21,428,389,817,914
0132-000,2018,1,7,22,344,331,675,817
0132-000,2018,1,7,23,246,244,490,675
0132-000,2018,1,7,24,149,175,324,490
0132-000,2018,1,8,1,103,120,223,324
0132-000,2018,1,8,2,63,64,127,223
0132-000,2018,1,8,3,40,71,111,127
0132-000,2018,1,8,4,42,67,109,111
0132-000,2018,1,8,5,94,73,167,109
0132-000,2018,1,8,6,235,192,427,167
0132-000,2018,1,8,7,415,478,893,427
0132-000,2018,1,8,8,541,1862,2403,893
0132-000,2018,1,8,9,726,1388,2114,2403
0132-000,2018,1,8,10,615,742,1357,2114
0132-000,2018,1,8,11,672,735,1407,1357
0132-000,2018,1,8,12,686,721,1407,1407
0132-000,2018,1,8,13,676,690,1366,1407
0132-000,2018,1,8,14,710,768,1478,1366
0132-000,2018,1,8,15,815,761,1576,1478
0132-000,2018,1,8,16,777,736,1513,1576
0132-000,2018,1,8,17,806,746,1552,1513
0132-000,2018,1,8,18,1185,788,1973,1552
0132-000,2018,1,8,19,1358,744,2102,1973
0132-000,2018,1,8,20,809,551,1360,2102
0132-000,2018,1,8,21,705,415,1120,1360
0132-000,2018,1,8,22,449,329,778,1120
0132-000,2018,1,8,23,253,238,491,778
0132-000,2018,1,8,24,149,166,315,491
0132-000,2018,1,9,1,96,112,208,315
0132-000,2018,1,9,2,74,81,155,208
0132-000,2018,1,9,3,48,57,105,155
0132-000,2018,1,9,4,64,67,131,105
0132-000,2018,1,9,5,57,71,128,131
0132-000,2018,1,9,6,150,134,284,128
0132-000,2018,1,9,7,250,432,682,284
0132-000,2018,1,9,8,428,1567,1995,682
0132-000,2018,1,9,9,593,1335,1928,1995
0132-000,2018,1,9,10,522,695,1217,1928
0132-000,2018,1,9,11,587,646,1233,1217
0132-000,2018,1,9,12,596,677,1273,1233
0132-000,2018,1,9,13,648,595,1243,1273
0132-000,2018,1,9,14,694,671,1365,1243
0132-000,2018,1,9,15,685,672,1357,1365
0132-000,2018,1,9,16,717,676,1393,1357
0132-000,2018,1,9,17,694,623,1317,1393
0132-000,2018,1,9,18,961,626,1587,1317
0132-000,2018,1,9,19,1132,597,1729,1587
0132-000,2018,1,9,20,802,441,1243,1729
0132-000,2018,1,9,21,612,374,986,1243
0132-000,2018,1,9,22,440,302,742,986
0132-000,2018,1,9,23,242,222,464,742
0132-000,2018,1,9,24,149,140,289,464
0132-000,2018,1,10,1,84,98,182,289
0132-000,2018,1,10,2,79,63,142,182
0132-000,2018,1,10,3,49,50,99,142
0132-000,2018,1,10,4,34,74,108,99
0132-000,2018,1,10,5,66,72,138,108
0132-000,2018,1,10,6,128,112,240,138
0132-000,2018,1,10,7,231,344,575,240
0132-000,2018,1,10,8,365,1150,1515,575
0132-000,2018,1,10,9,552,1394,1946,1515
0132-000,2018,1,10,10,464,702,1166,1946
0132-000,2018,1,10,11,531,590,1121,1166
0132-000,2018,1,10,12,624,613,1237,1121
0132-000,2018,1,10,13,531,582,1113,1237
0132-000,2018,1,10,14,610,674,1284,1113
0132-000,2018,1,10,15,680,643,1323,1284
0132-000,2018,1,10,16,658,586,1244,1323
0132-000,2018,1,10,17,740,657,1397,1244
0132-000,2018,1,10,18,1139,709,1848,1397
0132-000,2018,1,10,19,1371,640,2011,1848
0132-000,2018,1,10,20,793,512,1305,2011
0132-000,2018,1,10,21,561,357,918,1305
0132-000,2018,1,10,22,400,304,704,918
0132-000,2018,1,10,23,263,250,513,704
0132-000,2018,1,10,24,157,148,305,513
0132-000,2018,1,11,1,118,133,251,305
0132-000,2018,1,11,2,70,73,143,251
0132-000,2018,1,11,3,67,77,144,143
0132-000,2018,1,11,4,111,56,167,144
0132-000,2018,1,11,5,80,90,170,167
0132-000,2018,1,11,6,295,176,471,170
0132-000,2018,1,11,7,354,421,775,471
0132-000,2018,1,11,8,478,1653,2131,775
0132-000,2018,1,11,9,727,1269,1996,2131
0132-000,2018,1,11,10,618,726,1344,1996
0132-000,2018,1,11,11,614,687,1301,1344
0132-000,2018,1,11,12,629,726,1355,1301
0132-000,2018,1,11,13,612,600,1212,1355
0132-000,2018,1,11,14,691,707,1398,1212
0132-000,2018,1,11,15,694,665,1359,1398
0132-000,2018,1,11,16,711,641,1352,1359
0132-000,2018,1,11,17,742,672,1414,1352
0132-000,2018,1,11,18,1150,700,1850,1414
0132-000,2018,1,11,19,1264,608,1872,1850
0132-000,2018,1,11,20,731,510,1241,1872
0132-000,2018,1,11,21,632,377,1009,1241
0132-000,2018,1,11,22,446,313,759,1009
0132-000,2018,1,11,23,270,234,504,759
0132-000,2018,1,11,24,159,169,328,504
0132-000,2018,1,12,1,110,109,219,328
0132-000,2018,1,12,2,64,78,142,219
0132-000,2018,1,12,3,50,60,110,142
0132-000,2018,1,12,4,85,63,148,110
0132-000,2018,1,12,5,126,80,206,148
0132-000,2018,1,12,6,182,155,337,206
0132-000,2018,1,12,7,280,425,705,337
0132-000,2018,1,12,8,443,1612,2055,705
0132-000,2018,1,12,9,665,1273,1938,2055
0132-000,2018,1,12,10,588,673,1261,1938
0132-000,2018,1,12,11,600,699,1299,1261
0132-000,2018,1,12,12,678,725,1403,1299
0132-000,2018,1,12,13,686,655,1341,1403
0132-000,2018,1,12,14,700,683,1383,1341
0132-000,2018,1,12,15,807,687,1494,1383
0132-000,2018,1,12,16,792,769,1561,1494
0132-000,2018,1,12,17,861,713,1574,1561
0132-000,2018,1,12,18,1276,777,2053,1574
0132-000,2018,1,12,19,1613,691,2304,2053
0132-000,2018,1,12,20,902,645,1547,2304
0132-000,2018,1,12,21,701,470,1171,1547
0132-000,2018,1,12,22,477,393,870,1171
0132-000,2018,1,12,23,297,317,614,870
0132-000,2018,1,12,24,198,241,439,614
0132-000,2018,1,13,1,148,148,296,439
0132-000,2018,1,13,2,106,116,222,296
0132-000,2018,1,13,3,102,119,221,222
0132-000,2018,1,13,4,65,103,168,221
0132-000,2018,1,13,5,74,92,166,168
0132-000,2018,1,13,6,180,123,303,166
0132-000,2018,1,13,7,215,218,433,303
0132-000,2018,1,13,8,308,547,855,433
0132-000,2018,1,13,9,469,644,1113,855
0132-000,2018,1,13,10,541,620,1161,1113
0132-000,2018,1,13,11,573,648,1221,1161
0132-000,2018,1,13,12,611,667,1278,1221
0132-000,2018,1,13,13,639,642,1281,1278
0132-000,2018,1,13,14,690,732,1422,1281
0132-000,2018,1,13,15,743,713,1456,1422
0132-000,2018,1,13,16,702,710,1412,1456
0132-000,2018,1,13,17,791,797,1588,1412
0132-000,2018,1,13,18,1035,792,1827,1588
0132-000,2018,1,13,19,841,666,1507,1827
0132-000,2018,1,13,20,542,498,1040,1507
0132-000,2018,1,13,21,426,377,803,1040
0132-000,2018,1,13,22,317,302,619,803
0132-000,2018,1,13,23,259,274,533,619
0132-000,2018,1,13,24,178,206,384,533
0132-000,2018,1,14,1,145,174,319,384
0132-000,2018,1,14,2,89,109,198,319
0132-000,2018,1,14,3,94,99,193,198
0132-000,2018,1,14,4,71,96,167,193
0132-000,2018,1,14,5,68,77,145,167
0132-000,2018,1,14,6,93,105,198,145
0132-000,2018,1,14,7,160,141,301,198
0132-000,2018,1,14,8,173,249,422,301
0132-000,2018,1,14,9,260,338,598,422
0132-000,2018,1,14,10,380,453,833,598
0132-000,2018,1,14,11,440,520,960,833
0132-000,2018,1,14,12,485,582,1067,960
0132-000,2018,1,14,13,605,555,1160,1067
0132-000,2018,1,14,14,574,571,1145,1160
0132-000,2018,1,14,15,670,634,1304,1145
0132-000,2018,1,14,16,696,677,1373,1304
0132-000,2018,1,14,17,710,627,1337,1373
0132-000,2018,1,14,18,827,570,1397,1337
0132-000,2018,1,14,19,721,491,1212,1397
0132-000,2018,1,14,20,449,381,830,1212
0132-000,2018,1,14,21,353,344,697,830
0132-000,2018,1,14,22,311,324,635,697
0132-000,2018,1,14,23,240,245,485,635
0132-000,2018,1,14,24,158,161,319,485
0132-000,2018,1,15,1,81,122,203,319
0132-000,2018,1,15,2,54,74,128,203
0132-000,2018,1,15,3,38,55,93,128
0132-000,2018,1,15,4,43,65,108,93
0132-000,2018,1,15,5,111,101,212,108
0132-000,2018,1,15,6,225,180,405,212
0132-000,2018,1,15,7,405,511,916,405
0132-000,2018,1,15,8,543,1823,2366,916
0132-000,2018,1,15,9,714,1398,2112,2366
0132-000,2018,1,15,10,673,782,1455,2112
0132-000,2018,1,15,11,694,768,1462,1455
0132-000,2018,1,15,12,685,800,1485,1462
0132-000,2018,1,15,13,698,744,1442,1485
0132-000,2018,1,15,14,739,757,1496,1442
0132-000,2018,1,15,15,713,815,1528,1496
0132-000,2018,1,15,16,831,732,1563,1528
0132-000,2018,1,15,17,834,783,1617,1563
0132-000,2018,1,15,18,1272,814,2086,1617
0132-000,2018,1,15,19,1441,781,2222,2086
0132-000,2018,1,15,20,842,595,1437,2222
0132-000,2018,1,15,21,769,457,1226,1437
0132-000,2018,1,15,22,513,356,869,1226
0132-000,2018,1,15,23,285,302,587,869
0132-000,2018,1,15,24,198,171,369,587
0132-000,2018,1,16,1,123,121,244,369
0132-000,2018,1,16,2,83,109,192,244
0132-000,2018,1,16,3,91,83,174,192
0132-000,2018,1,16,4,67,73,140,174
0132-000,2018,1,16,5,72,89,161,140
0132-000,2018,1,16,6,223,159,382,161
0132-000,2018,1,16,7,343,477,820,382
0132-000,2018,1,16,8,563,1792,2355,820
0132-000,2018,1,16,9,745,1355,2100,2355
0132-000,2018,1,16,10,642,811,1453,2100
0132-000,2018,1,16,11,682,766,1448,1453
0132-000,2018,1,16,12,701,749,1450,1448
0132-000,2018,1,16,13,680,717,1397,1450
0132-000,2018,1,16,14,709,725,1434,1397
0132-000,2018,1,16,15,743,699,1442,1434
0132-000,2018,1,16,16,777,695,1472,1442
0132-000,2018,1,16,17,851,755,1606,1472
0132-000,2018,1,16,18,1193,804,1997,1606
0132-000,2018,1,16,19,1364,724,2088,1997
0132-000,2018,1,16,20,783,572,1355,2088
0132-000,2018,1,16,21,781,428,1209,1355
0132-000,2018,1,16,22,492,358,850,1209
0132-000,2018,1,16,23,333,242,575,850
0132-000,2018,1,16,24,190,209,399,575
0132-000,2018,1,17,1,180,154,334,399
0132-000,2018,1,17,2,81,115,196,334
0132-000,2018,1,17,3,80,77,157,196
0132-000,2018,1,17,4,54,82,136,157
0132-000,2018,1,17,5,86,101,187,136
0132-000,2018,1,17,6,214,172,386,187
0132-000,2018,1,17,7,328,446,774,386
0132-000,2018,1,17,8,567,1753,2320,774
0132-000,2018,1,17,9,710,1408,2118,2320
0132-000,2018,1,17,10,691,796,1487,2118
0132-000,2018,1,17,11,725,731,1456,1487
0132-000,2018,1,17,12,708,773,1481,1456
0132-000,2018,1,17,13,727,704,1431,1481
0132-000,2018,1,17,14,733,742,1475,1431
0132-000,2018,1,17,15,732,722,1454,1475
0132-000,2018,1,17,16,757,712,1469,1454
0132-000,2018,1,17,17,831,722,1553,1469
0132-000,2018,1,17,18,1287,758,2045,1553
0132-000,2018,1,17,19,1505,712,2217,2045
0132-000,2018,1,17,20,831,626,1457,2217
0132-000,2018,1,17,21,694,410,1104,1457
0132-000,2018,1,17,22,463,376,839,1104
0132-000,2018,1,17,23,302,308,610,839
0132-000,2018,1,17,24,172,209,381,610
0132-000,2018,1,18,1,145,127,272,381
0132-000,2018,1,18,2,98,97,195,272
0132-000,2018,1,18,3,74,76,150,195
0132-000,2018,1,18,4,62,79,141,150
0132-000,2018,1,18,5,87,93,180,141
0132-000,2018,1,18,6,234,164,398,180
0132-000,2018,1,18,7,381,482,863,398
0132-000,2018,1,18,8,544,1742,2286,863
0132-000,2018,1,18,9,742,1354,2096,2286
0132-000,2018,1,18,10,657,815,1472,2096
0132-000,2018,1,18,11,712,775,1487,1472
0132-000,2018,1,18,12,700,778,1478,1487
0132-000,2018,1,18,13,766,687,1453,1478
0132-000,2018,1,18,14,758,724,1482,1453
0132-000,2018,1,18,15,737,739,1476,1482
0132-000,2018,1,18,16,813,742,1555,1476
0132-000,2018,1,18,17,825,795,1620,1555
0132-000,2018,1,18,18,1261,850,2111,1620
0132-000,2018,1,18,19,1408,693,2101,2111
0132-000,2018,1,18,20,821,577,1398,2101
0132-000,2018,1,18,21,704,475,1179,1398
0132-000,2018,1,18,22,500,362,862,1179
0132-000,2018,1,18,23,317,286,603,862
0132-000,2018,1,18,24,207,218,425,603
0132-000,2018,1,19,1,174,164,338,425
0132-000,2018,1,19,2,96,102,198,338
0132-000,2018,1,19,3,77,73,150,198
0132-000,2018,1,19,4,67,93,160,150
0132-000,2018,1,19,5,78,98,176,160
0132-000,2018,1,19,6,240,177,417,176
0132-000,2018,1,19,7,367,465,832,417
0132-000,2018,1,19,8,532,1752,2284,832
0132-000,2018,1,19,9,729,1343,2072,2284
0132-000,2018,1,19,10,658,754,1412,2072
0132-000,2018,1,19,11,733,790,1523,1412
0132-000,2018,1,19,12,726,815,1541,1523
0132-000,2018,1,19,13,714,711,1425,1541
0132-000,2018,1,19,14,766,720,1486,1425
0132-000,2018,1,19,15,885,755,1640,1486
0132-000,2018,1,19,16,840,774,1614,1640
0132-000,2018,1,19,17,948,785,1733,1614
0132-000,2018,1,19,18,1426,857,2283,1733
0132-000,2018,1,19,19,1644,823,2467,2283
0132-000,2018,1,19,20,897,683,1580,2467
0132-000,2018,1,19,21,727,494,1221,1580
0132-000,2018,1,19,22,546,421,967,1221
0132-000,2018,1,19,23,336,341,677,967
0132-000,2018,1,19,24,190,271,461,677
0132-000,2018,1,20,1,203,189,392,461
0132-000,2018,1,20,2,119,150,269,392
0132-000,2018,1,20,3,93,101,194,269
0132-000,2018,1,20,4,83,89,172,194
0132-000,2018,1,20,5,93,114,207,172
0132-000,2018,1,20,6,209,156,365,207
0132-000,2018,1,20,7,288,299,587,365
0132-000,2018,1,20,8,422,744,1166,587
0132-000,2018,1,20,9,579,787,1366,1166
0132-000,2018,1,20,10,609,736,1345,1366
0132-000,2018,1,20,11,686,746,1432,1345
0132-000,2018,1,20,12,696,836,1532,1432
0132-000,2018,1,20,13,830,843,1673,1532
0132-000,2018,1,20,14,836,818,1654,1673
0132-000,2018,1,20,15,821,842,1663,1654
0132-000,2018,1,20,16,835,852,1687,1663
0132-000,2018,1,20,17,895,902,1797,1687
0132-000,2018,1,20,18,1203,939,2142,1797
0132-000,2018,1,20,19,950,768,1718,2142
0132-000,2018,1,20,20,603,522,1125,1718
0132-000,2018,1,20,21,537,442,979,1125
0132-000,2018,1,20,22,366,398,764,979
0132-000,2018,1,20,23,294,297,591,764
0132-000,2018,1,20,24,201,207,408,591
0132-000,2018,1,21,1,161,174,335,408
0132-000,2018,1,21,2,116,130,246,335
0132-000,2018,1,21,3,107,109,216,246
0132-000,2018,1,21,4,72,58,130,216
0132-000,2018,1,21,5,61,64,125,130
0132-000,2018,1,21,6,99,93,192,125
0132-000,2018,1,21,7,136,183,319,192
0132-000,2018,1,21,8,195,309,504,319
0132-000,2018,1,21,9,263,340,603,504
0132-000,2018,1,21,10,374,454,828,603
0132-000,2018,1,21,11,448,534,982,828
0132-000,2018,1,21,12,499,600,1099,982
0132-000,2018,1,21,13,602,625,1227,1099
0132-000,2018,1,21,14,645,688,1333,1227
0132-000,2018,1,21,15,751,715,1466,1333
0132-000,2018,1,21,16,793,690,1483,1466
0132-000,2018,1,21,17,886,667,1553,1483
0132-000,2018,1,21,18,870,666,1536,1553
0132-000,2018,1,21,19,825,482,1307,1536
0132-000,2018,1,21,20,561,440,1001,1307
0132-000,2018,1,21,21,423,376,799,1001
0132-000,2018,1,21,22,363,308,671,799
0132-000,2018,1,21,23,234,258,492,671
0132-000,2018,1,21,24,147,170,317,492
0132-000,2018,1,22,1,107,132,239,317
0132-000,2018,1,22,2,67,70,137,239
0132-000,2018,1,22,3,53,55,108,137
0132-000,2018,1,22,4,38,57,95,108
0132-000,2018,1,22,5,96,76,172,95
0132-000,2018,1,22,6,226,207,433,172
0132-000,2018,1,22,7,416,503,919,433
0132-000,2018,1,22,8,531,1886,2417,919
0132-000,2018,1,22,9,731,1290,2021,2417
0132-000,2018,1,22,10,653,839,1492,2021
0132-000,2018,1,22,11,665,783,1448,1492
0132-000,2018,1,22,12,666,717,1383,1448
0132-000,2018,1,22,13,674,674,1348,1383
0132-000,2018,1,22,14,739,712,1451,1348
0132-000,2018,1,22,15,770,746,1516,1451
0132-000,2018,1,22,16,844,766,1610,1516
0132-000,2018,1,22,17,828,720,1548,1610
0132-000,2018,1,22,18,1187,764,1951,1548
0132-000,2018,1,22,19,1382,734,2116,1951
0132-000,2018,1,22,20,806,580,1386,2116
0132-000,2018,1,22,21,683,441,1124,1386
0132-000,2018,1,22,22,464,328,792,1124
0132-000,2018,1,22,23,276,244,520,792
0132-000,2018,1,22,24,159,167,326,520
0132-000,2018,1,23,1,105,110,215,326
0132-000,2018,1,23,2,79,81,160,215
0132-000,2018,1,23,3,62,76,138,160
0132-000,2018,1,23,4,40,65,105,138
0132-000,2018,1,23,5,78,84,162,105
0132-000,2018,1,23,6,199,141,340,162
0132-000,2018,1,23,7,335,454,789,340
0132-000,2018,1,23,8,574,1762,2336,789
0132-000,2018,1,23,9,685,1321,2006,2336
0132-000,2018,1,23,10,668,788,1456,2006
0132-000,2018,1,23,11,658,744,1402,1456
0132-000,2018,1,23,12,663,813,1476,1402
0132-000,2018,1,23,13,635,627,1262,1476
0132-000,2018,1,23,14,735,729,1464,1262
0132-000,2018,1,23,15,763,713,1476,1464
0132-000,2018,1,23,16,769,725,1494,1476
0132-000,2018,1,23,17,835,722,1557,1494
0132-000,2018,1,23,18,1212,778,1990,1557
0132-000,2018,1,23,19,1345,731,2076,1990
0132-000,2018,1,23,20,795,595,1390,2076
0132-000,2018,1,23,21,765,454,1219,1390
0132-000,2018,1,23,22,444,373,817,1219
0132-000,2018,1,23,23,318,259,577,817
0132-000,2018,1,23,24,173,186,359,577
0132-000,2018,1,24,1,133,127,260,359
0132-000,2018,1,24,2,89,98,187,260
0132-000,2018,1,24,3,65,69,134,187
0132-000,2018,1,24,4,56,66,122,134
0132-000,2018,1,24,5,73,73,146,122
0132-000,2018,1,24,6,178,151,329,146
0132-000,2018,1,24,7,325,414,739,329
0132-000,2018,1,24,8,528,1716,2244,739
0132-000,2018,1,24,9,707,1349,2056,2244
0132-000,2018,1,24,10,645,760,1405,2056
0132-000,2018,1,24,11,630,745,1375,1405
0132-000,2018,1,24,12,671,701,1372,1375
0132-000,2018,1,24,13,673,653,1326,1372
0132-000,2018,1,24,14,708,662,1370,1326
0132-000,2018,1,24,15,722,702,1424,1370
0132-000,2018,1,24,16,723,713,1436,1424
0132-000,2018,1,24,17,832,729,1561,1436
0132-000,2018,1,24,18,1325,774,2099,1561
0132-000,2018,1,24,19,1468,743,2211,2099
0132-000,2018,1,24,20,801,578,1379,2211
0132-000,2018,1,24,21,703,468,1171,1379
0132-000,2018,1,24,22,262,376,638,1171
0132-000,2018,1,24,23,157,277,434,638
0132-000,2018,1,24,24,86,183,269,434
0132-000,2018,1,25,1,63,123,186,269
0132-000,2018,1,25,2,38,84,122,186
0132-000,2018,1,25,3,24,67,91,122
0132-000,2018,1,25,4,26,61,87,91
0132-000,2018,1,25,5,45,88,133,87
0132-000,2018,1,25,6,98,150,248,133
0132-000,2018,1,25,7,362,353,715,248
0132-000,2018,1,25,8,612,1543,2155,715
0132-000,2018,1,25,9,681,1464,2145,2155
0132-000,2018,1,25,10,590,782,1372,2145
0132-000,2018,1,25,11,616,717,1333,1372
0132-000,2018,1,25,12,600,645,1245,1333
0132-000,2018,1,25,13,678,660,1338,1245
0132-000,2018,1,25,14,734,718,1452,1338
0132-000,2018,1,25,15,743,741,1484,1452
0132-000,2018,1,25,16,740,721,1461,1484
0132-000,2018,1,25,17,833,715,1548,1461
0132-000,2018,1,25,18,1226,717,1943,1548
0132-000,2018,1,25,19,1260,671,1931,1943
0132-000,2018,1,25,20,783,554,1337,1931
0132-000,2018,1,25,21,692,422,1114,1337
0132-000,2018,1,25,22,361,378,739,1114
0132-000,2018,1,25,23,163,273,436,739
0132-000,2018,1,25,24,99,209,308,436
0132-000,2018,1,26,1,80,121,201,308
0132-000,2018,1,26,2,70,82,152,201
0132-000,2018,1,26,3,23,68,91,152
0132-000,2018,1,26,4,49,80,129,91
0132-000,2018,1,26,5,70,96,166,129
0132-000,2018,1,26,6,273,155,428,166
0132-000,2018,1,26,7,539,435,974,428
0132-000,2018,1,26,8,492,1664,2156,974
0132-000,2018,1,26,9,477,1346,1823,2156
0132-000,2018,1,26,10,529,756,1285,1823
0132-000,2018,1,26,11,622,754,1376,1285
0132-000,2018,1,26,12,672,720,1392,1376
0132-000,2018,1,26,13,691,686,1377,1392
0132-000,2018,1,26,14,716,702,1418,1377
0132-000,2018,1,26,15,770,731,1501,1418
0132-000,2018,1,26,16,835,738,1573,1501
0132-000,2018,1,26,17,836,755,1591,1573
0132-000,2018,1,26,18,1338,781,2119,1591
0132-000,2018,1,26,19,1584,769,2353,2119
0132-000,2018,1,26,20,852,652,1504,2353
0132-000,2018,1,26,21,672,462,1134,1504
0132-000,2018,1,26,22,347,438,785,1134
0132-000,2018,1,26,23,170,340,510,785
0132-000,2018,1,26,24,99,211,310,510
0132-000,2018,1,27,1,262,177,439,310
0132-000,2018,1,27,2,159,150,309,439
0132-000,2018,1,27,3,51,90,141,309
0132-000,2018,1,27,4,35,75,110,141
0132-000,2018,1,27,5,150,88,238,110
0132-000,2018,1,27,6,135,111,246,238
0132-000,2018,1,27,7,290,294,584,246
0132-000,2018,1,27,8,376,663,1039,584
0132-000,2018,1,27,9,557,775,1332,1039
0132-000,2018,1,27,10,618,705,1323,1332
0132-000,2018,1,27,11,664,826,1490,1323
0132-000,2018,1,27,12,724,978,1702,1490
0132-000,2018,1,27,13,705,855,1560,1702
0132-000,2018,1,27,14,791,792,1583,1560
0132-000,2018,1,27,15,838,842,1680,1583
0132-000,2018,1,27,16,845,807,1652,1680
0132-000,2018,1,27,17,922,775,1697,1652
0132-000,2018,1,27,18,1087,858,1945,1697
0132-000,2018,1,27,19,912,733,1645,1945
0132-000,2018,1,27,20,624,508,1132,1645
0132-000,2018,1,27,21,469,395,864,1132
0132-000,2018,1,27,22,413,337,750,864
0132-000,2018,1,27,23,317,281,598,750
0132-000,2018,1,27,24,160,171,331,598
0132-000,2018,1,28,1,285,158,443,331
0132-000,2018,1,28,2,177,114,291,443
0132-000,2018,1,28,3,187,98,285,291
0132-000,2018,1,28,4,121,71,192,285
0132-000,2018,1,28,5,66,63,129,192
0132-000,2018,1,28,6,95,81,176,129
0132-000,2018,1,28,7,115,179,294,176
0132-000,2018,1,28,8,189,275,464,294
0132-000,2018,1,28,9,249,332,581,464
0132-000,2018,1,28,10,317,468,785,581
0132-000,2018,1,28,11,454,547,1001,785
0132-000,2018,1,28,12,467,550,1017,1001
0132-000,2018,1,28,13,535,554,1089,1017
0132-000,2018,1,28,14,567,676,1243,1089
0132-000,2018,1,28,15,678,656,1334,1243
0132-000,2018,1,28,16,676,661,1337,1334
0132-000,2018,1,28,17,727,588,1315,1337
0132-000,2018,1,28,18,723,610,1333,1315
0132-000,2018,1,28,19,721,458,1179,1333
0132-000,2018,1,28,20,441,390,831,1179
0132-000,2018,1,28,21,353,399,752,831
0132-000,2018,1,28,22,298,326,624,752
0132-000,2018,1,28,23,193,241,434,624
0132-000,2018,1,28,24,108,187,295,434
0132-000,2018,1,29,1,100,112,212,295
0132-000,2018,1,29,2,53,84,137,212
0132-000,2018,1,29,3,51,61,112,137
0132-000,2018,1,29,4,25,67,92,112
0132-000,2018,1,29,5,85,73,158,92
0132-000,2018,1,29,6,236,190,426,158
0132-000,2018,1,29,7,369,533,902,426
0132-000,2018,1,29,8,607,1845,2452,902
0132-000,2018,1,29,9,817,1486,2303,2452
0132-000,2018,1,29,10,752,810,1562,2303
0132-000,2018,1,29,11,676,693,1369,1562
0132-000,2018,1,29,12,729,777,1506,1369
0132-000,2018,1,29,13,684,678,1362,1506
0132-000,2018,1,29,14,697,748,1445,1362
0132-000,2018,1,29,15,836,778,1614,1445
0132-000,2018,1,29,16,784,744,1528,1614
0132-000,2018,1,29,17,900,702,1602,1528
0132-000,2018,1,29,18,1382,809,2191,1602
0132-000,2018,1,29,19,1452,747,2199,2191
0132-000,2018,1,29,20,870,604,1474,2199
0132-000,2018,1,29,21,808,497,1305,1474
0132-000,2018,1,29,22,481,358,839,1305
0132-000,2018,1,29,23,266,260,526,839
0132-000,2018,1,29,24,187,216,403,526
0132-000,2018,1,30,1,140,118,258,403
0132-000,2018,1,30,2,55,74,129,258
0132-000,2018,1,30,3,49,84,133,129
0132-000,2018,1,30,4,53,77,130,133
0132-000,2018,1,30,5,74,86,160,130
0132-000,2018,1,30,6,211,156,367,160
0132-000,2018,1,30,7,351,510,861,367
0132-000,2018,1,30,8,618,1760,2378,861
0132-000,2018,1,30,9,793,1399,2192,2378
0132-000,2018,1,30,10,712,760,1472,2192
0132-000,2018,1,30,11,691,751,1442,1472
0132-000,2018,1,30,12,757,789,1546,1442
0132-000,2018,1,30,13,680,669,1349,1546
0132-000,2018,1,30,14,731,731,1462,1349
0132-000,2018,1,30,15,836,761,1597,1462
0132-000,2018,1,30,16,819,806,1625,1597
0132-000,2018,1,30,17,934,730,1664,1625
0132-000,2018,1,30,18,1281,851,2132,1664
0132-000,2018,1,30,19,1474,761,2235,2132
0132-000,2018,1,30,20,825,589,1414,2235
0132-000,2018,1,30,21,906,444,1350,1414
0132-000,2018,1,30,22,467,386,853,1350
0132-000,2018,1,30,23,339,273,612,853
0132-000,2018,1,30,24,170,188,358,612
0132-000,2018,1,31,1,138,122,260,358
0132-000,2018,1,31,2,80,100,180,260
0132-000,2018,1,31,3,68,61,129,180
0132-000,2018,1,31,4,66,96,162,129
0132-000,2018,1,31,5,85,85,170,162
0132-000,2018,1,31,6,236,170,406,170
0132-000,2018,1,31,7,394,468,862,406
0132-000,2018,1,31,8,577,1764,2341,862
0132-000,2018,1,31,9,782,1363,2145,2341
0132-000,2018,1,31,10,744,794,1538,2145
0132-000,2018,1,31,11,716,729,1445,1538
0132-000,2018,1,31,12,688,725,1413,1445
0132-000,2018,1,31,13,618,706,1324,1413
0132-000,2018,1,31,14,767,726,1493,1324
0132-000,2018,1,31,15,793,763,1556,1493
0132-000,2018,1,31,16,812,731,1543,1556
0132-000,2018,1,31,17,827,748,1575,1543
0132-000,2018,1,31,18,1488,804,2292,1575
0132-000,2018,1,31,19,1536,753,2289,2292
0132-000,2018,1,31,20,819,634,1453,2289
0132-000,2018,1,31,21,678,490,1168,1453
0132-000,2018,1,31,22,492,365,857,1168
0132-000,2018,1,31,23,337,266,603,857
0132-000,2018,1,31,24,240,228,468,603
0132-000,2018,2,1,1,152,142,294,468
0132-000,2018,2,1,2,94,92,186,294
0132-000,2018,2,1,3,69,80,149,186
0132-000,2018,2,1,4,62,89,151,149
0132-000,2018,2,1,5,90,100,190,151
0132-000,2018,2,1,6,215,183,398,190
0132-000,2018,2,1,7,385,511,896,398
0132-000,2018,2,1,8,666,1754,2420,896
0132-000,2018,2,1,9,804,1432,2236,2420
0132-000,2018,2,1,10,733,810,1543,2236
0132-000,2018,2,1,11,704,737,1441,1543
0132-000,2018,2,1,12,769,737,1506,1441
0132-000,2018,2,1,13,660,803,1463,1506
0132-000,2018,2,1,14,792,745,1537,1463
0132-000,2018,2,1,15,861,766,1627,1537
0132-000,2018,2,1,16,865,729,1594,1627
0132-000,2018,2,1,17,844,737,1581,1594
0132-000,2018,2,1,18,1263,831,2094,1581
0132-000,2018,2,1,19,1583,741,2324,2094
0132-000,2018,2,1,20,867,615,1482,2324
0132-000,2018,2,1,21,827,469,1296,1482
0132-000,2018,2,1,22,549,379,928,1296
0132-000,2018,2,1,23,284,302,586,928
0132-000,2018,2,1,24,180,209,389,586
0132-000,2018,2,2,1,150,136,286,389
0132-000,2018,2,2,2,67,98,165,286
0132-000,2018,2,2,3,73,72,145,165
0132-000,2018,2,2,4,64,94,158,145
0132-000,2018,2,2,5,85,91,176,158
0132-000,2018,2,2,6,203,175,378,176
0132-000,2018,2,2,7,350,504,854,378
0132-000,2018,2,2,8,639,1770,2409,854
0132-000,2018,2,2,9,829,1379,2208,2409
0132-000,2018,2,2,10,727,800,1527,2208
0132-000,2018,2,2,11,727,791,1518,1527
0132-000,2018,2,2,12,762,792,1554,1518
0132-000,2018,2,2,13,727,694,1421,1554
0132-000,2018,2,2,14,737,726,1463,1421
0132-000,2018,2,2,15,832,742,1574,1463
0132-000,2018,2,2,16,829,784,1613,1574
0132-000,2018,2,2,17,951,849,1800,1613
0132-000,2018,2,2,18,1500,869,2369,1800
0132-000,2018,2,2,19,1818,788,2606,2369
0132-000,2018,2,2,20,997,696,1693,2606
0132-000,2018,2,2,21,867,487,1354,1693
0132-000,2018,2,2,22,507,410,917,1354
0132-000,2018,2,2,23,324,341,665,917
0132-000,2018,2,2,24,182,236,418,665
0132-000,2018,2,3,1,176,187,363,418
0132-000,2018,2,3,2,121,127,248,363
0132-000,2018,2,3,3,75,102,177,248
0132-000,2018,2,3,4,69,122,191,177
0132-000,2018,2,3,5,88,100,188,191
0132-000,2018,2,3,6,207,143,350,188
0132-000,2018,2,3,7,264,294,558,350
0132-000,2018,2,3,8,425,764,1189,558
0132-000,2018,2,3,9,597,777,1374,1189
0132-000,2018,2,3,10,551,749,1300,1374
0132-000,2018,2,3,11,687,784,1471,1300
0132-000,2018,2,3,12,762,830,1592,1471
0132-000,2018,2,3,13,827,799,1626,1592
0132-000,2018,2,3,14,762,822,1584,1626
0132-000,2018,2,3,15,922,759,1681,1584
0132-000,2018,2,3,16,850,831,1681,1681
0132-000,2018,2,3,17,888,805,1693,1681
0132-000,2018,2,3,18,1164,936,2100,1693
0132-000,2018,2,3,19,943,721,1664,2100
0132-000,2018,2,3,20,612,548,1160,1664
0132-000,2018,2,3,21,496,445,941,1160
0132-000,2018,2,3,22,335,327,662,941
0132-000,2018,2,3,23,253,296,549,662
0132-000,2018,2,3,24,165,199,364,549
0132-000,2018,2,4,1,223,152,375,364
0132-000,2018,2,4,2,146,105,251,375
0132-000,2018,2,4,3,147,90,237,251
0132-000,2018,2,4,4,96,63,159,237
0132-000,2018,2,4,5,64,74,138,159
0132-000,2018,2,4,6,97,111,208,138
0132-000,2018,2,4,7,126,156,282,208
0132-000,2018,2,4,8,192,291,483,282
0132-000,2018,2,4,9,256,376,632,483
0132-000,2018,2,4,10,346,527,873,632
0132-000,2018,2,4,11,451,562,1013,873
0132-000,2018,2,4,12,483,582,1065,1013
0132-000,2018,2,4,13,568,670,1238,1065
0132-000,2018,2,4,14,606,696,1302,1238
0132-000,2018,2,4,15,714,675,1389,1302
0132-000,2018,2,4,16,734,706,1440,1389
0132-000,2018,2,4,17,806,589,1395,1440
0132-000,2018,2,4,18,796,593,1389,1395
0132-000,2018,2,4,19,773,475,1248,1389
0132-000,2018,2,4,20,501,448,949,1248
0132-000,2018,2,4,21,388,369,757,949
0132-000,2018,2,4,22,330,298,628,757
0132-000,2018,2,4,23,214,242,456,628
0132-000,2018,2,4,24,128,161,289,456
0132-000,2018,2,5,1,43,121,164,289
0132-000,2018,2,5,2,22,56,78,164
0132-000,2018,2,5,3,23,41,64,78
0132-000,2018,2,5,4,23,70,93,64
0132-000,2018,2,5,5,56,62,118,93
0132-000,2018,2,5,6,172,182,354,118
0132-000,2018,2,5,7,394,512,906,354
0132-000,2018,2,5,8,338,1857,2195,906
0132-000,2018,2,5,9,725,1486,2211,2195
0132-000,2018,2,5,10,618,770,1388,2211
0132-000,2018,2,5,11,618,757,1375,1388
0132-000,2018,2,5,12,717,801,1518,1375
0132-000,2018,2,5,13,688,683,1371,1518
0132-000,2018,2,5,14,699,704,1403,1371
0132-000,2018,2,5,15,775,758,1533,1403
0132-000,2018,2,5,16,822,719,1541,1533
0132-000,2018,2,5,17,829,773,1602,1541
0132-000,2018,2,5,18,1224,807,2031,1602
0132-000,2018,2,5,19,1426,722,2148,2031
0132-000,2018,2,5,20,898,623,1521,2148
0132-000,2018,2,5,21,759,486,1245,1521
0132-000,2018,2,5,22,529,387,916,1245
0132-000,2018,2,5,23,290,277,567,916
0132-000,2018,2,5,24,162,142,304,567
0132-000,2018,2,6,1,118,118,236,304
0132-000,2018,2,6,2,64,100,164,236
0132-000,2018,2,6,3,56,67,123,164
0132-000,2018,2,6,4,46,70,116,123
0132-000,2018,2,6,5,76,104,180,116
0132-000,2018,2,6,6,205,154,359,180
0132-000,2018,2,6,7,343,498,841,359
0132-000,2018,2,6,8,596,1755,2351,841
0132-000,2018,2,6,9,739,1389,2128,2351
0132-000,2018,2,6,10,690,923,1613,2128
0132-000,2018,2,6,11,674,1013,1687,1613
0132-000,2018,2,6,12,710,902,1612,1687
0132-000,2018,2,6,13,658,699,1357,1612
0132-000,2018,2,6,14,733,780,1513,1357
0132-000,2018,2,6,15,800,762,1562,1513
0132-000,2018,2,6,16,794,779,1573,1562
0132-000,2018,2,6,17,884,734,1618,1573
0132-000,2018,2,6,18,1246,810,2056,1618
0132-000,2018,2,6,19,1410,783,2193,2056
0132-000,2018,2,6,20,810,608,1418,2193
0132-000,2018,2,6,21,836,482,1318,1418
0132-000,2018,2,6,22,456,393,849,1318
0132-000,2018,2,6,23,328,300,628,849
0132-000,2018,2,6,24,172,172,344,628
0132-000,2018,2,7,1,61,131,192,344
0132-000,2018,2,7,2,32,81,113,192
0132-000,2018,2,7,3,30,57,87,113
0132-000,2018,2,7,4,92,70,162,87
0132-000,2018,2,7,5,217,101,318,162
0132-000,2018,2,7,6,201,147,348,318
0132-000,2018,2,7,7,359,464,823,348
0132-000,2018,2,7,8,582,1775,2357,823
0132-000,2018,2,7,9,785,1453,2238,2357
0132-000,2018,2,7,10,644,780,1424,2238
0132-000,2018,2,7,11,724,753,1477,1424
0132-000,2018,2,7,12,715,730,1445,1477
0132-000,2018,2,7,13,646,746,1392,1445
0132-000,2018,2,7,14,763,788,1551,1392
0132-000,2018,2,7,15,775,769,1544,1551
0132-000,2018,2,7,16,864,755,1619,1544
0132-000,2018,2,7,17,879,758,1637,1619
0132-000,2018,2,7,18,1358,885,2243,1637
0132-000,2018,2,7,19,1570,778,2348,2243
0132-000,2018,2,7,20,893,642,1535,2348
0132-000,2018,2,7,21,733,517,1250,1535
0132-000,2018,2,7,22,514,433,947,1250
0132-000,2018,2,7,23,338,310,648,947
0132-000,2018,2,7,24,194,208,402,648
0132-000,2018,2,8,1,143,136,279,402
0132-000,2018,2,8,2,99,122,221,279
0132-000,2018,2,8,3,82,93,175,221
0132-000,2018,2,8,4,71,86,157,175
0132-000,2018,2,8,5,97,97,194,157
0132-000,2018,2,8,6,210,190,400,194
0132-000,2018,2,8,7,380,474,854,400
0132-000,2018,2,8,8,580,1758,2338,854
0132-000,2018,2,8,9,746,1421,2167,2338
0132-000,2018,2,8,10,668,925,1593,2167
0132-000,2018,2,8,11,732,945,1677,1593
0132-000,2018,2,8,12,804,777,1581,1677
0132-000,2018,2,8,13,844,771,1615,1581
0132-000,2018,2,8,14,840,834,1674,1615
0132-000,2018,2,8,15,910,872,1782,1674
0132-000,2018,2,8,16,934,800,1734,1782
0132-000,2018,2,8,17,945,813,1758,1734
0132-000,2018,2,8,18,1310,886,2196,1758
0132-000,2018,2,8,19,1428,807,2235,2196
0132-000,2018,2,8,20,880,633,1513,2235
0132-000,2018,2,8,21,829,506,1335,1513
0132-000,2018,2,8,22,583,460,1043,1335
0132-000,2018,2,8,23,400,307,707,1043
0132-000,2018,2,8,24,195,220,415,707
0132-000,2018,2,9,1,139,153,292,415
0132-000,2018,2,9,2,105,104,209,292
0132-000,2018,2,9,3,61,72,133,209
0132-000,2018,2,9,4,78,85,163,133
0132-000,2018,2,9,5,93,100,193,163
0132-000,2018,2,9,6,212,187,399,193
0132-000,2018,2,9,7,368,476,844,399
0132-000,2018,2,9,8,582,1751,2333,844
0132-000,2018,2,9,9,740,1382,2122,2333
0132-000,2018,2,9,10,658,919,1577,2122
0132-000,2018,2,9,11,659,796,1455,1577
0132-000,2018,2,9,12,713,809,1522,1455
0132-000,2018,2,9,13,774,738,1512,1522
0132-000,2018,2,9,14,793,778,1571,1512
0132-000,2018,2,9,15,800,769,1569,1571
0132-000,2018,2,9,16,853,778,1631,1569
0132-000,2018,2,9,17,928,802,1730,1631
0132-000,2018,2,9,18,1388,840,2228,1730
0132-000,2018,2,9,19,1628,834,2462,2228
0132-000,2018,2,9,20,982,967,1949,2462
0132-000,2018,2,9,21,797,563,1360,1949
0132-000,2018,2,9,22,561,418,979,1360
0132-000,2018,2,9,23,370,342,712,979
0132-000,2018,2,9,24,211,246,457,712
0132-000,2018,2,10,1,181,181,362,457
0132-000,2018,2,10,2,116,142,258,362
0132-000,2018,2,10,3,96,95,191,258
0132-000,2018,2,10,4,96,104,200,191
0132-000,2018,2,10,5,91,108,199,200
0132-000,2018,2,10,6,206,172,378,199
0132-000,2018,2,10,7,290,302,592,378
0132-000,2018,2,10,8,410,809,1219,592
0132-000,2018,2,10,9,552,832,1384,1219
0132-000,2018,2,10,10,618,828,1446,1384
0132-000,2018,2,10,11,761,858,1619,1446
0132-000,2018,2,10,12,691,842,1533,1619
0132-000,2018,2,10,13,803,808,1611,1533
0132-000,2018,2,10,14,829,851,1680,1611
0132-000,2018,2,10,15,857,855,1712,1680
0132-000,2018,2,10,16,851,823,1674,1712
0132-000,2018,2,10,17,924,836,1760,1674
0132-000,2018,2,10,18,1274,900,2174,1760
0132-000,2018,2,10,19,1064,795,1859,2174
0132-000,2018,2,10,20,641,576,1217,1859
0132-000,2018,2,10,21,533,425,958,1217
0132-000,2018,2,10,22,421,357,778,958
0132-000,2018,2,10,23,310,277,587,778
0132-000,2018,2,10,24,188,218,406,587
0132-000,2018,2,11,1,141,166,307,406
0132-000,2018,2,11,2,82,108,190,307
0132-000,2018,2,11,3,90,93,183,190
0132-000,2018,2,11,4,68,84,152,183
0132-000,2018,2,11,5,71,74,145,152
0132-000,2018,2,11,6,134,99,233,145
0132-000,2018,2,11,7,155,224,379,233
0132-000,2018,2,11,8,221,343,564,379
0132-000,2018,2,11,9,320,475,795,564
0132-000,2018,2,11,10,396,518,914,795
0132-000,2018,2,11,11,485,540,1025,914
0132-000,2018,2,11,12,550,645,1195,1025
0132-000,2018,2,11,13,651,645,1296,1195
0132-000,2018,2,11,14,704,706,1410,1296
0132-000,2018,2,11,15,760,674,1434,1410
0132-000,2018,2,11,16,771,710,1481,1434
0132-000,2018,2,11,17,797,638,1435,1481
0132-000,2018,2,11,18,768,569,1337,1435
0132-000,2018,2,11,19,686,514,1200,1337
0132-000,2018,2,11,20,408,379,787,1200
0132-000,2018,2,11,21,364,341,705,787
0132-000,2018,2,11,22,267,245,512,705
0132-000,2018,2,11,23,194,202,396,512
0132-000,2018,2,11,24,105,140,245,396
0132-000,2018,2,12,1,94,90,184,245
0132-000,2018,2,12,2,48,54,102,184
0132-000,2018,2,12,3,44,57,101,102
0132-000,2018,2,12,4,22,53,75,101
0132-000,2018,2,12,5,69,62,131,75
0132-000,2018,2,12,6,173,170,343,131
0132-000,2018,2,12,7,313,463,776,343
0132-000,2018,2,12,8,528,1448,1976,776
0132-000,2018,2,12,9,648,1571,2219,1976
0132-000,2018,2,12,10,613,718,1331,2219
0132-000,2018,2,12,11,723,793,1516,1331
0132-000,2018,2,12,12,739,771,1510,1516
0132-000,2018,2,12,13,706,781,1487,1510
0132-000,2018,2,12,14,743,747,1490,1487
0132-000,2018,2,12,15,833,815,1648,1490
0132-000,2018,2,12,16,857,740,1597,1648
0132-000,2018,2,12,17,910,814,1724,1597
0132-000,2018,2,12,18,1196,816,2012,1724
0132-000,2018,2,12,19,1339,801,2140,2012
0132-000,2018,2,12,20,927,565,1492,2140
0132-000,2018,2,12,21,842,501,1343,1492
0132-000,2018,2,12,22,516,379,895,1343
0132-000,2018,2,12,23,318,265,583,895
0132-000,2018,2,12,24,171,165,336,583
0132-000,2018,2,13,1,129,95,224,336
0132-000,2018,2,13,2,66,54,120,224
0132-000,2018,2,13,3,61,87,148,120
0132-000,2018,2,13,4,67,85,152,148
0132-000,2018,2,13,5,79,72,151,152
0132-000,2018,2,13,6,144,167,311,151
0132-000,2018,2,13,7,316,449,765,311
0132-000,2018,2,13,8,493,1635,2128,765
0132-000,2018,2,13,9,697,1408,2105,2128
0132-000,2018,2,13,10,655,793,1448,2105
0132-000,2018,2,13,11,748,817,1565,1448
0132-000,2018,2,13,12,766,824,1590,1565
0132-000,2018,2,13,13,761,773,1534,1590
0132-000,2018,2,13,14,844,793,1637,1534
0132-000,2018,2,13,15,886,833,1719,1637
0132-000,2018,2,13,16,917,844,1761,1719
0132-000,2018,2,13,17,940,866,1806,1761
0132-000,2018,2,13,18,1164,866,2030,1806
0132-000,2018,2,13,19,1473,827,2300,2030
0132-000,2018,2,13,20,946,678,1624,2300
0132-000,2018,2,13,21,816,474,1290,1624
0132-000,2018,2,13,22,590,412,1002,1290
0132-000,2018,2,13,23,335,337,672,1002
0132-000,2018,2,13,24,243,211,454,672
0132-000,2018,2,14,1,168,180,348,454
0132-000,2018,2,14,2,129,103,232,348
0132-000,2018,2,14,3,84,96,180,232
0132-000,2018,2,14,4,75,90,165,180
0132-000,2018,2,14,5,72,102,174,165
0132-000,2018,2,14,6,160,167,327,174
0132-000,2018,2,14,7,310,412,722,327
0132-000,2018,2,14,8,533,1601,2134,722
0132-000,2018,2,14,9,707,1310,2017,2134
0132-000,2018,2,14,10,671,871,1542,2017
0132-000,2018,2,14,11,671,830,1501,1542
0132-000,2018,2,14,12,782,902,1684,1501
0132-000,2018,2,14,13,820,953,1773,1684
0132-000,2018,2,14,14,914,1047,1961,1773
0132-000,2018,2,14,15,835,1046,1881,1961
0132-000,2018,2,14,16,1063,1047,2110,1881
0132-000,2018,2,14,17,1181,1119,2300,2110
0132-000,2018,2,14,18,1474,1177,2651,2300
0132-000,2018,2,14,19,1229,1218,2447,2651
0132-000,2018,2,14,20,647,1038,1685,2447
0132-000,2018,2,14,21,516,636,1152,1685
0132-000,2018,2,14,22,410,480,890,1152
0132-000,2018,2,14,23,322,409,731,890
0132-000,2018,2,14,24,222,317,539,731
0132-000,2018,2,15,1,150,234,384,539
0132-000,2018,2,15,2,120,214,334,384
0132-000,2018,2,15,3,80,141,221,334
0132-000,2018,2,15,4,74,132,206,221
0132-000,2018,2,15,5,61,228,289,206
0132-000,2018,2,15,6,94,461,555,289
0132-000,2018,2,15,7,121,1350,1471,555
0132-000,2018,2,15,8,188,859,1047,1471
0132-000,2018,2,15,9,289,1106,1395,1047
0132-000,2018,2,15,10,426,1858,2284,1395
0132-000,2018,2,15,11,481,1220,1701,2284
0132-000,2018,2,15,12,595,1189,1784,1701
0132-000,2018,2,15,13,575,1213,1788,1784
0132-000,2018,2,15,14,601,912,1513,1788
0132-000,2018,2,15,15,572,876,1448,1513
0132-000,2018,2,15,16,560,780,1340,1448
0132-000,2018,2,15,17,538,654,1192,1340
0132-000,2018,2,15,18,528,545,1073,1192
0132-000,2018,2,15,19,480,464,944,1073
0132-000,2018,2,15,20,384,347,731,944
0132-000,2018,2,15,21,318,305,623,731
0132-000,2018,2,15,22,286,269,555,623
0132-000,2018,2,15,23,164,175,339,555
0132-000,2018,2,15,24,127,159,286,339
0132-000,2018,2,16,1,90,103,193,286
0132-000,2018,2,16,2,56,88,144,193
0132-000,2018,2,16,3,43,52,95,144
0132-000,2018,2,16,4,32,49,81,95
0132-000,2018,2,16,5,43,46,89,81
0132-000,2018,2,16,6,64,82,146,89
0132-000,2018,2,16,7,149,246,395,146
0132-000,2018,2,16,8,359,557,916,395
0132-000,2018,2,16,9,347,546,893,916
0132-000,2018,2,16,10,369,493,862,893
0132-000,2018,2,16,11,692,767,1459,862
0132-000,2018,2,16,12,1078,896,1974,1459
0132-000,2018,2,16,13,1200,1081,2281,1974
0132-000,2018,2,16,14,1518,1078,2596,2281
0132-000,2018,2,16,15,1840,1219,3059,2596
0132-000,2018,2,16,16,1865,1111,2976,3059
0132-000,2018,2,16,17,1892,976,2868,2976
0132-000,2018,2,16,18,1738,731,2469,2868
0132-000,2018,2,16,19,1645,536,2181,2469
0132-000,2018,2,16,20,1474,356,1830,2181
0132-000,2018,2,16,21,1375,328,1703,1830
0132-000,2018,2,16,22,873,299,1172,1703
0132-000,2018,2,16,23,448,217,665,1172
0132-000,2018,2,16,24,221,153,374,665
0132-000,2018,2,17,1,131,109,240,374
0132-000,2018,2,17,2,94,79,173,240
0132-000,2018,2,17,3,47,52,99,173
0132-000,2018,2,17,4,50,47,97,99
0132-000,2018,2,17,5,46,47,93,97
0132-000,2018,2,17,6,57,48,105,93
0132-000,2018,2,17,7,86,85,171,105
0132-000,2018,2,17,8,168,159,327,171
0132-000,2018,2,17,9,248,213,461,327
0132-000,2018,2,17,10,360,344,704,461
0132-000,2018,2,17,11,478,474,952,704
0132-000,2018,2,17,12,666,639,1305,952
0132-000,2018,2,17,13,730,634,1364,1305
0132-000,2018,2,17,14,818,592,1410,1364
0132-000,2018,2,17,15,963,550,1513,1410
0132-000,2018,2,17,16,1251,559,1810,1513
0132-000,2018,2,17,17,1579,550,2129,1810
0132-000,2018,2,17,18,1409,518,1927,2129
0132-000,2018,2,17,19,1593,436,2029,1927
0132-000,2018,2,17,20,1064,348,1412,2029
0132-000,2018,2,17,21,1208,320,1528,1412
0132-000,2018,2,17,22,683,243,926,1528
0132-000,2018,2,17,23,403,224,627,926
0132-000,2018,2,17,24,230,176,406,627
0132-000,2018,2,18,1,189,134,323,406
0132-000,2018,2,18,2,131,99,230,323
0132-000,2018,2,18,3,117,94,211,230
0132-000,2018,2,18,4,78,71,149,211
0132-000,2018,2,18,5,64,62,126,149
0132-000,2018,2,18,6,63,60,123,126
0132-000,2018,2,18,7,93,113,206,123
0132-000,2018,2,18,8,168,189,357,206
0132-000,2018,2,18,9,226,258,484,357
0132-000,2018,2,18,10,316,328,644,484
0132-000,2018,2,18,11,452,483,935,644
0132-000,2018,2,18,12,475,502,977,935
0132-000,2018,2,18,13,595,568,1163,977
0132-000,2018,2,18,14,641,597,1238,1163
0132-000,2018,2,18,15,729,607,1336,1238
0132-000,2018,2,18,16,677,657,1334,1336
0132-000,2018,2,18,17,753,555,1308,1334
0132-000,2018,2,18,18,747,555,1302,1308
0132-000,2018,2,18,19,628,488,1116,1302
0132-000,2018,2,18,20,476,403,879,1116
0132-000,2018,2,18,21,366,337,703,879
0132-000,2018,2,18,22,316,274,590,703
0132-000,2018,2,18,23,252,228,480,590
0132-000,2018,2,18,24,173,158,331,480
0132-000,2018,2,19,1,109,108,217,331
0132-000,2018,2,19,2,73,65,138,217
0132-000,2018,2,19,3,26,59,85,138
0132-000,2018,2,19,4,49,59,108,85
0132-000,2018,2,19,5,89,71,160,108
0132-000,2018,2,19,6,195,167,362,160
0132-000,2018,2,19,7,371,456,827,362
0132-000,2018,2,19,8,542,1642,2184,827
0132-000,2018,2,19,9,677,1287,1964,2184
0132-000,2018,2,19,10,637,733,1370,1964
0132-000,2018,2,19,11,669,691,1360,1370
0132-000,2018,2,19,12,689,736,1425,1360
0132-000,2018,2,19,13,624,705,1329,1425
0132-000,2018,2,19,14,726,764,1490,1329
0132-000,2018,2,19,15,742,763,1505,1490
0132-000,2018,2,19,16,779,654,1433,1505
0132-000,2018,2,19,17,842,756,1598,1433
0132-000,2018,2,19,18,1157,787,1944,1598
0132-000,2018,2,19,19,1362,761,2123,1944
0132-000,2018,2,19,20,848,539,1387,2123
0132-000,2018,2,19,21,681,408,1089,1387
0132-000,2018,2,19,22,471,341,812,1089
0132-000,2018,2,19,23,273,272,545,812
0132-000,2018,2,19,24,160,190,350,545
0132-000,2018,2,20,1,133,118,251,350
0132-000,2018,2,20,2,80,79,159,251
0132-000,2018,2,20,3,66,72,138,159
0132-000,2018,2,20,4,58,83,141,138
0132-000,2018,2,20,5,95,95,190,141
0132-000,2018,2,20,6,211,163,374,190
0132-000,2018,2,20,7,377,507,884,374
0132-000,2018,2,20,8,548,1800,2348,884
0132-000,2018,2,20,9,752,1377,2129,2348
0132-000,2018,2,20,10,654,848,1502,2129
0132-000,2018,2,20,11,694,802,1496,1502
0132-000,2018,2,20,12,741,759,1500,1496
0132-000,2018,2,20,13,719,693,1412,1500
0132-000,2018,2,20,14,764,726,1490,1412
0132-000,2018,2,20,15,812,762,1574,1490
0132-000,2018,2,20,16,778,707,1485,1574
0132-000,2018,2,20,17,874,789,1663,1485
0132-000,2018,2,20,18,1214,900,2114,1663
0132-000,2018,2,20,19,1439,730,2169,2114
0132-000,2018,2,20,20,859,608,1467,2169
0132-000,2018,2,20,21,741,484,1225,1467
0132-000,2018,2,20,22,521,385,906,1225
0132-000,2018,2,20,23,348,275,623,906
0132-000,2018,2,20,24,206,208,414,623
0132-000,2018,2,21,1,153,127,280,414
0132-000,2018,2,21,2,86,88,174,280
0132-000,2018,2,21,3,75,80,155,174
0132-000,2018,2,21,4,71,76,147,155
0132-000,2018,2,21,5,91,95,186,147
0132-000,2018,2,21,6,214,176,390,186
0132-000,2018,2,21,7,409,515,924,390
0132-000,2018,2,21,8,601,1772,2373,924
0132-000,2018,2,21,9,752,1463,2215,2373
0132-000,2018,2,21,10,699,889,1588,2215
0132-000,2018,2,21,11,737,720,1457,1588
0132-000,2018,2,21,12,710,813,1523,1457
0132-000,2018,2,21,13,662,719,1381,1523
0132-000,2018,2,21,14,744,733,1477,1381
0132-000,2018,2,21,15,768,745,1513,1477
0132-000,2018,2,21,16,841,689,1530,1513
0132-000,2018,2,21,17,862,750,1612,1530
0132-000,2018,2,21,18,1354,863,2217,1612
0132-000,2018,2,21,19,1563,766,2329,2217
0132-000,2018,2,21,20,894,654,1548,2329
0132-000,2018,2,21,21,695,500,1195,1548
0132-000,2018,2,21,22,543,388,931,1195
0132-000,2018,2,21,23,326,291,617,931
0132-000,2018,2,21,24,201,220,421,617
0132-000,2018,2,22,1,127,149,276,421
0132-000,2018,2,22,2,83,102,185,276
0132-000,2018,2,22,3,67,81,148,185
0132-000,2018,2,22,4,63,84,147,148
0132-000,2018,2,22,5,86,91,177,147
0132-000,2018,2,22,6,236,179,415,177
0132-000,2018,2,22,7,401,487,888,415
0132-000,2018,2,22,8,576,1694,2270,888
0132-000,2018,2,22,9,751,1517,2268,2270
0132-000,2018,2,22,10,669,874,1543,2268
0132-000,2018,2,22,11,652,793,1445,1543
0132-000,2018,2,22,12,724,689,1413,1445
0132-000,2018,2,22,13,701,696,1397,1413
0132-000,2018,2,22,14,801,752,1553,1397
0132-000,2018,2,22,15,758,833,1591,1553
0132-000,2018,2,22,16,807,710,1517,1591
0132-000,2018,2,22,17,892,723,1615,1517
0132-000,2018,2,22,18,1249,757,2006,1615
0132-000,2018,2,22,19,1476,756,2232,2006
0132-000,2018,2,22,20,951,584,1535,2232
0132-000,2018,2,22,21,776,477,1253,1535
0132-000,2018,2,22,22,513,432,945,1253
0132-000,2018,2,22,23,290,317,607,945
0132-000,2018,2,22,24,209,213,422,607
0132-000,2018,2,23,1,130,151,281,422
0132-000,2018,2,23,2,103,101,204,281
0132-000,2018,2,23,3,50,89,139,204
0132-000,2018,2,23,4,64,84,148,139
0132-000,2018,2,23,5,93,88,181,148
0132-000,2018,2,23,6,220,173,393,181
0132-000,2018,2,23,7,408,485,893,393
0132-000,2018,2,23,8,581,1768,2349,893
0132-000,2018,2,23,9,719,1355,2074,2349
0132-000,2018,2,23,10,652,781,1433,2074
0132-000,2018,2,23,11,701,768,1469,1433
0132-000,2018,2,23,12,753,821,1574,1469
0132-000,2018,2,23,13,741,736,1477,1574
0132-000,2018,2,23,14,762,731,1493,1477
0132-000,2018,2,23,15,820,789,1609,1493
0132-000,2018,2,23,16,869,790,1659,1609
0132-000,2018,2,23,17,929,804,1733,1659
0132-000,2018,2,23,18,1318,866,2184,1733
0132-000,2018,2,23,19,1674,815,2489,2184
0132-000,2018,2,23,20,952,706,1658,2489
0132-000,2018,2,23,21,811,500,1311,1658
0132-000,2018,2,23,22,537,435,972,1311
0132-000,2018,2,23,23,373,347,720,972
0132-000,2018,2,23,24,261,256,517,720
0132-000,2018,2,24,1,178,180,358,517
0132-000,2018,2,24,2,146,146,292,358
0132-000,2018,2,24,3,94,113,207,292
0132-000,2018,2,24,4,97,103,200,207
0132-000,2018,2,24,5,117,116,233,200
0132-000,2018,2,24,6,229,148,377,233
0132-000,2018,2,24,7,346,346,692,377
0132-000,2018,2,24,8,447,792,1239,692
0132-000,2018,2,24,9,569,862,1431,1239
0132-000,2018,2,24,10,628,784,1412,1431
0132-000,2018,2,24,11,690,779,1469,1412
0132-000,2018,2,24,12,770,849,1619,1469
0132-000,2018,2,24,13,821,828,1649,1619
0132-000,2018,2,24,14,824,856,1680,1649
0132-000,2018,2,24,15,846,830,1676,1680
0132-000,2018,2,24,16,851,819,1670,1676
0132-000,2018,2,24,17,906,870,1776,1670
0132-000,2018,2,24,18,1269,919,2188,1776
0132-000,2018,2,24,19,968,765,1733,2188
0132-000,2018,2,24,20,669,561,1230,1733
0132-000,2018,2,24,21,519,435,954,1230
0132-000,2018,2,24,22,388,350,738,954
0132-000,2018,2,24,23,327,305,632,738
0132-000,2018,2,24,24,197,205,402,632
0132-000,2018,2,25,1,153,172,325,402
0132-000,2018,2,25,2,103,111,214,325
0132-000,2018,2,25,3,74,102,176,214
0132-000,2018,2,25,4,85,83,168,176
0132-000,2018,2,25,5,78,87,165,168
0132-000,2018,2,25,6,140,113,253,165
0132-000,2018,2,25,7,188,227,415,253
0132-000,2018,2,25,8,257,314,571,415
0132-000,2018,2,25,9,353,432,785,571
0132-000,2018,2,25,10,379,482,861,785
0132-000,2018,2,25,11,491,594,1085,861
0132-000,2018,2,25,12,539,627,1166,1085
0132-000,2018,2,25,13,594,641,1235,1166
0132-000,2018,2,25,14,649,731,1380,1235
0132-000,2018,2,25,15,716,687,1403,1380
0132-000,2018,2,25,16,804,715,1519,1403
0132-000,2018,2,25,17,801,624,1425,1519
0132-000,2018,2,25,18,835,678,1513,1425
0132-000,2018,2,25,19,761,542,1303,1513
0132-000,2018,2,25,20,583,435,1018,1303
0132-000,2018,2,25,21,412,384,796,1018
0132-000,2018,2,25,22,361,313,674,796
0132-000,2018,2,25,23,249,274,523,674
0132-000,2018,2,25,24,159,176,335,523
0132-000,2018,2,26,1,104,106,210,335
0132-000,2018,2,26,2,56,82,138,210
0132-000,2018,2,26,3,46,62,108,138
0132-000,2018,2,26,4,43,61,104,108
0132-000,2018,2,26,5,99,84,183,104
0132-000,2018,2,26,6,256,185,441,183
0132-000,2018,2,26,7,451,538,989,441
0132-000,2018,2,26,8,580,1914,2494,989
0132-000,2018,2,26,9,781,1523,2304,2494
0132-000,2018,2,26,10,712,868,1580,2304
0132-000,2018,2,26,11,710,815,1525,1580
0132-000,2018,2,26,12,785,779,1564,1525
0132-000,2018,2,26,13,764,764,1528,1564
0132-000,2018,2,26,14,810,777,1587,1528
0132-000,2018,2,26,15,829,789,1618,1587
0132-000,2018,2,26,16,831,733,1564,1618
0132-000,2018,2,26,17,857,796,1653,1564
0132-000,2018,2,26,18,1266,852,2118,1653
0132-000,2018,2,26,19,1435,767,2202,2118
0132-000,2018,2,26,20,933,605,1538,2202
0132-000,2018,2,26,21,866,503,1369,1538
0132-000,2018,2,26,22,548,423,971,1369
0132-000,2018,2,26,23,325,260,585,971
0132-000,2018,2,26,24,160,232,392,585
0132-000,2018,2,27,1,124,116,240,392
0132-000,2018,2,27,2,82,97,179,240
0132-000,2018,2,27,3,68,86,154,179
0132-000,2018,2,27,4,57,83,140,154
0132-000,2018,2,27,5,101,88,189,140
0132-000,2018,2,27,6,233,185,418,189
0132-000,2018,2,27,7,402,500,902,418
0132-000,2018,2,27,8,601,1855,2456,902
0132-000,2018,2,27,9,755,1427,2182,2456
0132-000,2018,2,27,10,702,853,1555,2182
0132-000,2018,2,27,11,729,707,1436,1555
0132-000,2018,2,27,12,724,774,1498,1436
0132-000,2018,2,27,13,715,677,1392,1498
0132-000,2018,2,27,14,702,752,1454,1392
0132-000,2018,2,27,15,765,725,1490,1454
0132-000,2018,2,27,16,766,757,1523,1490
0132-000,2018,2,27,17,890,760,1650,1523
0132-000,2018,2,27,18,1217,844,2061,1650
0132-000,2018,2,27,19,1429,749,2178,2061
0132-000,2018,2,27,20,904,594,1498,2178
0132-000,2018,2,27,21,844,466,1310,1498
0132-000,2018,2,27,22,533,378,911,1310
0132-000,2018,2,27,23,342,318,660,911
0132-000,2018,2,27,24,216,216,432,660
0132-000,2018,2,28,1,148,143,291,432
0132-000,2018,2,28,2,99,100,199,291
0132-000,2018,2,28,3,71,86,157,199
0132-000,2018,2,28,4,87,91,178,157
0132-000,2018,2,28,5,94,99,193,178
0132-000,2018,2,28,6,234,196,430,193
0132-000,2018,2,28,7,401,470,871,430
0132-000,2018,2,28,8,602,1776,2378,871
0132-000,2018,2,28,9,769,1455,2224,2378
0132-000,2018,2,28,10,714,843,1557,2224
0132-000,2018,2,28,11,731,778,1509,1557
0132-000,2018,2,28,12,814,794,1608,1509
0132-000,2018,2,28,13,722,725,1447,1608
0132-000,2018,2,28,14,774,799,1573,1447
0132-000,2018,2,28,15,807,784,1591,1573
0132-000,2018,2,28,16,747,739,1486,1591
0132-000,2018,2,28,17,859,771,1630,1486
0132-000,2018,2,28,18,1300,829,2129,1630
0132-000,2018,2,28,19,1649,727,2376,2129
0132-000,2018,2,28,20,918,651,1569,2376
0132-000,2018,2,28,21,721,546,1267,1569
0132-000,2018,2,28,22,488,433,921,1267
0132-000,2018,2,28,23,347,342,689,921
0132-000,2018,2,28,24,225,238,463,689
0132-000,2018,3,1,1,187,184,371,463
0132-000,2018,3,1,2,111,131,242,371
0132-000,2018,3,1,3,85,103,188,242
0132-000,2018,3,1,4,102,106,208,188
0132-000,2018,3,1,5,95,103,198,208
0132-000,2018,3,1,6,207,149,356,198
0132-000,2018,3,1,7,273,309,582,356
0132-000,2018,3,1,8,382,729,1111,582
0132-000,2018,3,1,9,479,663,1142,1111
0132-000,2018,3,1,10,512,664,1176,1142
0132-000,2018,3,1,11,576,771,1347,1176
0132-000,2018,3,1,12,673,823,1496,1347
0132-000,2018,3,1,13,659,763,1422,1496
0132-000,2018,3,1,14,745,764,1509,1422
0132-000,2018,3,1,15,807,692,1499,1509
0132-000,2018,3,1,16,858,688,1546,1499
0132-000,2018,3,1,17,897,741,1638,1546
0132-000,2018,3,1,18,1088,753,1841,1638
0132-000,2018,3,1,19,888,659,1547,1841
0132-000,2018,3,1,20,575,516,1091,1547
0132-000,2018,3,1,21,517,394,911,1091
0132-000,2018,3,1,22,401,356,757,911
0132-000,2018,3,1,23,267,245,512,757
0132-000,2018,3,1,24,150,156,306,512
0132-000,2018,3,2,1,93,105,198,306
0132-000,2018,3,2,2,74,94,168,198
0132-000,2018,3,2,3,63,65,128,168
0132-000,2018,3,2,4,44,53,97,128
0132-000,2018,3,2,5,87,78,165,97
0132-000,2018,3,2,6,212,162,374,165
0132-000,2018,3,2,7,414,480,894,374
0132-000,2018,3,2,8,626,1715,2341,894
0132-000,2018,3,2,9,767,1275,2042,2341
0132-000,2018,3,2,10,650,867,1517,2042
0132-000,2018,3,2,11,690,775,1465,1517
0132-000,2018,3,2,12,711,798,1509,1465
0132-000,2018,3,2,13,723,736,1459,1509
0132-000,2018,3,2,14,750,732,1482,1459
0132-000,2018,3,2,15,732,752,1484,1482
0132-000,2018,3,2,16,861,771,1632,1484
0132-000,2018,3,2,17,853,791,1644,1632
0132-000,2018,3,2,18,1198,889,2087,1644
0132-000,2018,3,2,19,1579,823,2402,2087
0132-000,2018,3,2,20,935,707,1642,2402
0132-000,2018,3,2,21,785,500,1285,1642
0132-000,2018,3,2,22,543,421,964,1285
0132-000,2018,3,2,23,336,339,675,964
0132-000,2018,3,2,24,197,223,420,675
0132-000,2018,3,3,1,161,178,339,420
0132-000,2018,3,3,2,137,107,244,339
0132-000,2018,3,3,3,96,131,227,244
0132-000,2018,3,3,4,96,92,188,227
0132-000,2018,3,3,5,113,106,219,188
0132-000,2018,3,3,6,209,151,360,219
0132-000,2018,3,3,7,369,341,710,360
0132-000,2018,3,3,8,468,736,1204,710
0132-000,2018,3,3,9,523,807,1330,1204
0132-000,2018,3,3,10,656,795,1451,1330
0132-000,2018,3,3,11,744,808,1552,1451
0132-000,2018,3,3,12,808,835,1643,1552
0132-000,2018,3,3,13,772,774,1546,1643
0132-000,2018,3,3,14,806,861,1667,1546
0132-000,2018,3,3,15,857,812,1669,1667
0132-000,2018,3,3,16,830,850,1680,1669
0132-000,2018,3,3,17,872,840,1712,1680
0132-000,2018,3,3,18,1118,954,2072,1712
0132-000,2018,3,3,19,1038,741,1779,2072
0132-000,2018,3,3,20,668,568,1236,1779
0132-000,2018,3,3,21,472,449,921,1236
0132-000,2018,3,3,22,429,361,790,921
0132-000,2018,3,3,23,264,276,540,790
0132-000,2018,3,3,24,182,228,410,540
0132-000,2018,3,4,1,130,183,313,410
0132-000,2018,3,4,2,132,121,253,313
0132-000,2018,3,4,3,67,89,156,253
0132-000,2018,3,4,4,81,94,175,156
0132-000,2018,3,4,5,100,82,182,175
0132-000,2018,3,4,6,134,100,234,182
0132-000,2018,3,4,7,174,204,378,234
0132-000,2018,3,4,8,248,336,584,378
0132-000,2018,3,4,9,324,532,856,584
0132-000,2018,3,4,10,385,545,930,856
0132-000,2018,3,4,11,507,607,1114,930
0132-000,2018,3,4,12,613,653,1266,1114
0132-000,2018,3,4,13,692,628,1320,1266
0132-000,2018,3,4,14,657,704,1361,1320
0132-000,2018,3,4,15,755,731,1486,1361
0132-000,2018,3,4,16,870,741,1611,1486
0132-000,2018,3,4,17,916,668,1584,1611
0132-000,2018,3,4,18,850,691,1541,1584
0132-000,2018,3,4,19,807,514,1321,1541
0132-000,2018,3,4,20,652,533,1185,1321
0132-000,2018,3,4,21,466,400,866,1185
0132-000,2018,3,4,22,373,330,703,866
0132-000,2018,3,4,23,255,268,523,703
0132-000,2018,3,4,24,136,142,278,523
0132-000,2018,3,5,1,107,101,208,278
0132-000,2018,3,5,2,53,67,120,208
0132-000,2018,3,5,3,45,51,96,120
0132-000,2018,3,5,4,38,68,106,96
0132-000,2018,3,5,5,85,64,149,106
0132-000,2018,3,5,6,217,180,397,149
0132-000,2018,3,5,7,399,535,934,397
0132-000,2018,3,5,8,584,1857,2441,934
0132-000,2018,3,5,9,763,1640,2403,2441
0132-000,2018,3,5,10,672,816,1488,2403
0132-000,2018,3,5,11,716,762,1478,1488
0132-000,2018,3,5,12,766,792,1558,1478
0132-000,2018,3,5,13,724,718,1442,1558
0132-000,2018,3,5,14,700,732,1432,1442
0132-000,2018,3,5,15,797,721,1518,1432
0132-000,2018,3,5,16,781,693,1474,1518
0132-000,2018,3,5,17,848,733,1581,1474
0132-000,2018,3,5,18,1181,832,2013,1581
0132-000,2018,3,5,19,1439,765,2204,2013
0132-000,2018,3,5,20,962,619,1581,2204
0132-000,2018,3,5,21,763,538,1301,1581
0132-000,2018,3,5,22,522,414,936,1301
0132-000,2018,3,5,23,326,266,592,936
0132-000,2018,3,5,24,189,192,381,592
0132-000,2018,3,6,1,137,147,284,381
0132-000,2018,3,6,2,90,97,187,284
0132-000,2018,3,6,3,74,73,147,187
0132-000,2018,3,6,4,56,70,126,147
0132-000,2018,3,6,5,83,94,177,126
0132-000,2018,3,6,6,232,187,419,177
0132-000,2018,3,6,7,428,510,938,419
0132-000,2018,3,6,8,617,1913,2530,938
0132-000,2018,3,6,9,806,1570,2376,2530
0132-000,2018,3,6,10,709,920,1629,2376
0132-000,2018,3,6,11,697,890,1587,1629
0132-000,2018,3,6,12,731,813,1544,1587
0132-000,2018,3,6,13,743,728,1471,1544
0132-000,2018,3,6,14,745,771,1516,1471
0132-000,2018,3,6,15,773,735,1508,1516
0132-000,2018,3,6,16,829,737,1566,1508
0132-000,2018,3,6,17,892,769,1661,1566
0132-000,2018,3,6,18,1248,852,2100,1661
0132-000,2018,3,6,19,1492,801,2293,2100
0132-000,2018,3,6,20,979,646,1625,2293
0132-000,2018,3,6,21,865,486,1351,1625
0132-000,2018,3,6,22,561,400,961,1351
0132-000,2018,3,6,23,341,312,653,961
0132-000,2018,3,6,24,176,217,393,653
0132-000,2018,3,7,1,128,135,263,393
0132-000,2018,3,7,2,97,102,199,263
0132-000,2018,3,7,3,65,66,131,199
0132-000,2018,3,7,4,75,63,138,131
0132-000,2018,3,7,5,85,95,180,138
0132-000,2018,3,7,6,244,179,423,180
0132-000,2018,3,7,7,427,533,960,423
0132-000,2018,3,7,8,646,1859,2505,960
0132-000,2018,3,7,9,818,1554,2372,2505
0132-000,2018,3,7,10,729,874,1603,2372
0132-000,2018,3,7,11,721,795,1516,1603
0132-000,2018,3,7,12,747,763,1510,1516
0132-000,2018,3,7,13,687,724,1411,1510
0132-000,2018,3,7,14,785,740,1525,1411
0132-000,2018,3,7,15,765,750,1515,1525
0132-000,2018,3,7,16,860,732,1592,1515
0132-000,2018,3,7,17,885,756,1641,1592
0132-000,2018,3,7,18,1285,865,2150,1641
0132-000,2018,3,7,19,1593,805,2398,2150
0132-000,2018,3,7,20,889,619,1508,2398
0132-000,2018,3,7,21,725,510,1235,1508
0132-000,2018,3,7,22,492,391,883,1235
0132-000,2018,3,7,23,342,323,665,883
0132-000,2018,3,7,24,198,188,386,665
0132-000,2018,3,8,1,158,138,296,386
0132-000,2018,3,8,2,80,84,164,296
0132-000,2018,3,8,3,66,75,141,164
0132-000,2018,3,8,4,73,68,141,141
0132-000,2018,3,8,5,84,93,177,141
0132-000,2018,3,8,6,207,159,366,177
0132-000,2018,3,8,7,350,445,795,366
0132-000,2018,3,8,8,584,1744,2328,795
0132-000,2018,3,8,9,786,1580,2366,2328
0132-000,2018,3,8,10,702,801,1503,2366
0132-000,2018,3,8,11,667,717,1384,1503
0132-000,2018,3,8,12,692,743,1435,1384
0132-000,2018,3,8,13,682,652,1334,1435
0132-000,2018,3,8,14,733,699,1432,1334
0132-000,2018,3,8,15,725,692,1417,1432
0132-000,2018,3,8,16,779,717,1496,1417
0132-000,2018,3,8,17,810,706,1516,1496
0132-000,2018,3,8,18,1153,793,1946,1516
0132-000,2018,3,8,19,1465,729,2194,1946
0132-000,2018,3,8,20,870,613,1483,2194
0132-000,2018,3,8,21,838,522,1360,1483
0132-000,2018,3,8,22,549,455,1004,1360
0132-000,2018,3,8,23,319,317,636,1004
0132-000,2018,3,8,24,200,206,406,636
0132-000,2018,3,9,1,163,117,280,406
0132-000,2018,3,9,2,101,88,189,280
0132-000,2018,3,9,3,72,84,156,189
0132-000,2018,3,9,4,61,86,147,156
0132-000,2018,3,9,5,106,112,218,147
0132-000,2018,3,9,6,197,180,377,218
0132-000,2018,3,9,7,416,540,956,377
0132-000,2018,3,9,8,650,1867,2517,956
0132-000,2018,3,9,9,805,1548,2353,2517
0132-000,2018,3,9,10,750,895,1645,2353
0132-000,2018,3,9,11,744,796,1540,1645
0132-000,2018,3,9,12,725,773,1498,1540
0132-000,2018,3,9,13,743,733,1476,1498
0132-000,2018,3,9,14,820,738,1558,1476
0132-000,2018,3,9,15,846,789,1635,1558
0132-000,2018,3,9,16,872,723,1595,1635
0132-000,2018,3,9,17,973,836,1809,1595
0132-000,2018,3,9,18,1393,920,2313,1809
0132-000,2018,3,9,19,1783,879,2662,2313
0132-000,2018,3,9,20,986,691,1677,2662
0132-000,2018,3,9,21,832,588,1420,1677
0132-000,2018,3,9,22,567,464,1031,1420
0132-000,2018,3,9,23,368,355,723,1031
0132-000,2018,3,9,24,228,248,476,723
0132-000,2018,3,10,1,202,197,399,476
0132-000,2018,3,10,2,133,138,271,399
0132-000,2018,3,10,3,103,115,218,271
0132-000,2018,3,10,4,71,94,165,218
0132-000,2018,3,10,5,116,118,234,165
0132-000,2018,3,10,6,224,175,399,234
0132-000,2018,3,10,7,354,361,715,399
0132-000,2018,3,10,8,473,761,1234,715
0132-000,2018,3,10,9,634,918,1552,1234
0132-000,2018,3,10,10,642,799,1441,1552
0132-000,2018,3,10,11,733,825,1558,1441
0132-000,2018,3,10,12,787,824,1611,1558
0132-000,2018,3,10,13,864,742,1606,1611
0132-000,2018,3,10,14,770,854,1624,1606
0132-000,2018,3,10,15,842,844,1686,1624
0132-000,2018,3,10,16,836,850,1686,1686
0132-000,2018,3,10,17,966,829,1795,1686
0132-000,2018,3,10,18,1175,967,2142,1795
0132-000,2018,3,10,19,1077,795,1872,2142
0132-000,2018,3,10,20,716,601,1317,1872
0132-000,2018,3,10,21,536,459,995,1317
0132-000,2018,3,10,22,450,416,866,995
0132-000,2018,3,10,23,303,329,632,866
0132-000,2018,3,10,24,223,240,463,632
0132-000,2018,3,11,1,191,173,364,463
0132-000,2018,3,11,2,127,141,268,364
0132-000,2018,3,11,3,91,95,186,268
0132-000,2018,3,11,4,74,93,167,186
0132-000,2018,3,11,5,92,93,185,167
0132-000,2018,3,11,6,144,125,269,185
0132-000,2018,3,11,7,184,249,433,269
0132-000,2018,3,11,8,302,370,672,433
0132-000,2018,3,11,9,331,473,804,672
0132-000,2018,3,11,10,465,568,1033,804
0132-000,2018,3,11,11,586,630,1216,1033
0132-000,2018,3,11,12,600,651,1251,1216
0132-000,2018,3,11,13,573,630,1203,1251
0132-000,2018,3,11,14,704,722,1426,1203
0132-000,2018,3,11,15,732,747,1479,1426
0132-000,2018,3,11,16,810,701,1511,1479
0132-000,2018,3,11,17,848,718,1566,1511
0132-000,2018,3,11,18,946,726,1672,1566
0132-000,2018,3,11,19,839,606,1445,1672
0132-000,2018,3,11,20,623,506,1129,1445
0132-000,2018,3,11,21,484,446,930,1129
0132-000,2018,3,11,22,406,416,822,930
0132-000,2018,3,11,23,246,290,536,822
0132-000,2018,3,11,24,170,184,354,536
0132-000,2018,3,12,1,114,119,233,354
0132-000,2018,3,12,2,77,88,165,233
0132-000,2018,3,12,3,45,75,120,165
0132-000,2018,3,12,4,55,60,115,120
0132-000,2018,3,12,5,98,82,180,115
0132-000,2018,3,12,6,261,208,469,180
0132-000,2018,3,12,7,466,598,1064,469
0132-000,2018,3,12,8,642,2003,2645,1064
0132-000,2018,3,12,9,746,1571,2317,2645
0132-000,2018,3,12,10,744,894,1638,2317
0132-000,2018,3,12,11,710,779,1489,1638
0132-000,2018,3,12,12,731,782,1513,1489
0132-000,2018,3,12,13,697,733,1430,1513
0132-000,2018,3,12,14,650,764,1414,1430
0132-000,2018,3,12,15,753,748,1501,1414
0132-000,2018,3,12,16,863,743,1606,1501
0132-000,2018,3,12,17,888,803,1691,1606
0132-000,2018,3,12,18,1331,873,2204,1691
0132-000,2018,3,12,19,1499,761,2260,2204
0132-000,2018,3,12,20,947,647,1594,2260
0132-000,2018,3,12,21,842,500,1342,1594
0132-000,2018,3,12,22,559,394,953,1342
0132-000,2018,3,12,23,347,295,642,953
0132-000,2018,3,12,24,164,168,332,642
0132-000,2018,3,13,1,133,124,257,332
0132-000,2018,3,13,2,72,83,155,257
0132-000,2018,3,13,3,75,73,148,155
0132-000,2018,3,13,4,64,68,132,148
0132-000,2018,3,13,5,96,95,191,132
0132-000,2018,3,13,6,245,211,456,191
0132-000,2018,3,13,7,423,551,974,456
0132-000,2018,3,13,8,639,1946,2585,974
0132-000,2018,3,13,9,841,1607,2448,2585
0132-000,2018,3,13,10,725,913,1638,2448
0132-000,2018,3,13,11,723,796,1519,1638
0132-000,2018,3,13,12,751,747,1498,1519
0132-000,2018,3,13,13,685,697,1382,1498
0132-000,2018,3,13,14,745,769,1514,1382
0132-000,2018,3,13,15,760,745,1505,1514
0132-000,2018,3,13,16,833,701,1534,1505
0132-000,2018,3,13,17,880,817,1697,1534
0132-000,2018,3,13,18,1284,896,2180,1697
0132-000,2018,3,13,19,1528,796,2324,2180
0132-000,2018,3,13,20,952,603,1555,2324
0132-000,2018,3,13,21,837,536,1373,1555
0132-000,2018,3,13,22,536,456,992,1373
0132-000,2018,3,13,23,385,337,722,992
0132-000,2018,3,13,24,210,228,438,722
0132-000,2018,3,14,1,159,140,299,438
0132-000,2018,3,14,2,94,89,183,299
0132-000,2018,3,14,3,74,98,172,183
0132-000,2018,3,14,4,68,65,133,172
0132-000,2018,3,14,5,116,89,205,133
0132-000,2018,3,14,6,242,177,419,205
0132-000,2018,3,14,7,456,573,1029,419
0132-000,2018,3,14,8,640,1874,2514,1029
0132-000,2018,3,14,9,804,1626,2430,2514
0132-000,2018,3,14,10,770,896,1666,2430
0132-000,2018,3,14,11,759,816,1575,1666
0132-000,2018,3,14,12,705,746,1451,1575
0132-000,2018,3,14,13,685,692,1377,1451
0132-000,2018,3,14,14,763,772,1535,1377
0132-000,2018,3,14,15,674,728,1402,1535
0132-000,2018,3,14,16,824,698,1522,1402
0132-000,2018,3,14,17,916,862,1778,1522
0132-000,2018,3,14,18,1388,913,2301,1778
0132-000,2018,3,14,19,1726,824,2550,2301
0132-000,2018,3,14,20,930,669,1599,2550
0132-000,2018,3,14,21,805,556,1361,1599
0132-000,2018,3,14,22,519,422,941,1361
0132-000,2018,3,14,23,386,344,730,941
0132-000,2018,3,14,24,233,246,479,730
0132-000,2018,3,15,1,153,155,308,479
0132-000,2018,3,15,2,101,95,196,308
0132-000,2018,3,15,3,94,100,194,196
0132-000,2018,3,15,4,69,75,144,194
0132-000,2018,3,15,5,89,86,175,144
0132-000,2018,3,15,6,217,183,400,175
0132-000,2018,3,15,7,365,491,856,400
0132-000,2018,3,15,8,592,1800,2392,856
0132-000,2018,3,15,9,780,1606,2386,2392
0132-000,2018,3,15,10,715,871,1586,2386
0132-000,2018,3,15,11,692,767,1459,1586
0132-000,2018,3,15,12,658,729,1387,1459
0132-000,2018,3,15,13,700,702,1402,1387
0132-000,2018,3,15,14,715,722,1437,1402
0132-000,2018,3,15,15,686,732,1418,1437
0132-000,2018,3,15,16,820,704,1524,1418
0132-000,2018,3,15,17,852,744,1596,1524
0132-000,2018,3,15,18,1214,777,1991,1596
0132-000,2018,3,15,19,1410,663,2073,1991
0132-000,2018,3,15,20,822,607,1429,2073
0132-000,2018,3,15,21,822,513,1335,1429
0132-000,2018,3,15,22,556,434,990,1335
0132-000,2018,3,15,23,312,267,579,990
0132-000,2018,3,15,24,207,186,393,579
0132-000,2018,3,16,1,171,163,334,393
0132-000,2018,3,16,2,121,114,235,334
0132-000,2018,3,16,3,79,95,174,235
0132-000,2018,3,16,4,56,77,133,174
0132-000,2018,3,16,5,111,103,214,133
0132-000,2018,3,16,6,213,203,416,214
0132-000,2018,3,16,7,444,569,1013,416
0132-000,2018,3,16,8,638,1859,2497,1013
0132-000,2018,3,16,9,818,1556,2374,2497
0132-000,2018,3,16,10,739,967,1706,2374
0132-000,2018,3,16,11,742,878,1620,1706
0132-000,2018,3,16,12,804,801,1605,1620
0132-000,2018,3,16,13,772,731,1503,1605
0132-000,2018,3,16,14,843,750,1593,1503
0132-000,2018,3,16,15,838,803,1641,1593
0132-000,2018,3,16,16,918,849,1767,1641
0132-000,2018,3,16,17,920,854,1774,1767
0132-000,2018,3,16,18,1433,961,2394,1774
0132-000,2018,3,16,19,1783,891,2674,2394
0132-000,2018,3,16,20,1084,678,1762,2674
0132-000,2018,3,16,21,868,626,1494,1762
0132-000,2018,3,16,22,592,475,1067,1494
0132-000,2018,3,16,23,361,404,765,1067
0132-000,2018,3,16,24,272,261,533,765
0132-000,2018,3,17,1,189,198,387,533
0132-000,2018,3,17,2,116,138,254,387
0132-000,2018,3,17,3,109,96,205,254
0132-000,2018,3,17,4,92,110,202,205
0132-000,2018,3,17,5,110,115,225,202
0132-000,2018,3,17,6,217,196,413,225
0132-000,2018,3,17,7,363,436,799,413
0132-000,2018,3,17,8,485,835,1320,799
0132-000,2018,3,17,9,643,923,1566,1320
0132-000,2018,3,17,10,733,865,1598,1566
0132-000,2018,3,17,11,750,868,1618,1598
0132-000,2018,3,17,12,791,934,1725,1618
0132-000,2018,3,17,13,817,873,1690,1725
0132-000,2018,3,17,14,884,878,1762,1690
0132-000,2018,3,17,15,932,885,1817,1762
0132-000,2018,3,17,16,854,861,1715,1817
0132-000,2018,3,17,17,1009,839,1848,1715
0132-000,2018,3,17,18,1270,939,2209,1848
0132-000,2018,3,17,19,1075,794,1869,2209
0132-000,2018,3,17,20,718,583,1301,1869
0132-000,2018,3,17,21,544,461,1005,1301
0132-000,2018,3,17,22,447,432,879,1005
0132-000,2018,3,17,23,286,358,644,879
0132-000,2018,3,17,24,210,217,427,644
0132-000,2018,3,18,1,150,148,298,427
0132-000,2018,3,18,2,118,131,249,298
0132-000,2018,3,18,3,106,91,197,249
0132-000,2018,3,18,4,77,82,159,197
0132-000,2018,3,18,5,77,84,161,159
0132-000,2018,3,18,6,143,119,262,161
0132-000,2018,3,18,7,227,259,486,262
0132-000,2018,3,18,8,269,389,658,486
0132-000,2018,3,18,9,374,467,841,658
0132-000,2018,3,18,10,447,585,1032,841
0132-000,2018,3,18,11,523,677,1200,1032
0132-000,2018,3,18,12,575,670,1245,1200
0132-000,2018,3,18,13,654,706,1360,1245
0132-000,2018,3,18,14,721,750,1471,1360
0132-000,2018,3,18,15,802,798,1600,1471
0132-000,2018,3,18,16,842,751,1593,1600
0132-000,2018,3,18,17,898,645,1543,1593
0132-000,2018,3,18,18,908,684,1592,1543
0132-000,2018,3,18,19,824,568,1392,1592
0132-000,2018,3,18,20,649,480,1129,1392
0132-000,2018,3,18,21,542,444,986,1129
0132-000,2018,3,18,22,377,354,731,986
0132-000,2018,3,18,23,241,266,507,731
0132-000,2018,3,18,24,151,165,316,507
0132-000,2018,3,19,1,121,96,217,316
0132-000,2018,3,19,2,63,74,137,217
0132-000,2018,3,19,3,45,55,100,137
0132-000,2018,3,19,4,47,72,119,100
0132-000,2018,3,19,5,88,83,171,119
0132-000,2018,3,19,6,218,177,395,171
0132-000,2018,3,19,7,425,561,986,395
0132-000,2018,3,19,8,596,1905,2501,986
0132-000,2018,3,19,9,735,1580,2315,2501
0132-000,2018,3,19,10,706,854,1560,2315
0132-000,2018,3,19,11,724,817,1541,1560
0132-000,2018,3,19,12,675,752,1427,1541
0132-000,2018,3,19,13,642,721,1363,1427
0132-000,2018,3,19,14,740,726,1466,1363
0132-000,2018,3,19,15,807,755,1562,1466
0132-000,2018,3,19,16,757,815,1572,1562
0132-000,2018,3,19,17,851,700,1551,1572
0132-000,2018,3,19,18,1161,821,1982,1551
0132-000,2018,3,19,19,1480,761,2241,1982
0132-000,2018,3,19,20,947,606,1553,2241
0132-000,2018,3,19,21,794,488,1282,1553
0132-000,2018,3,19,22,524,402,926,1282
0132-000,2018,3,19,23,323,284,607,926
0132-000,2018,3,19,24,171,185,356,607
0132-000,2018,3,20,1,149,127,276,356
0132-000,2018,3,20,2,82,83,165,276
0132-000,2018,3,20,3,82,77,159,165
0132-000,2018,3,20,4,54,74,128,159
0132-000,2018,3,20,5,93,80,173,128
0132-000,2018,3,20,6,229,195,424,173
0132-000,2018,3,20,7,457,572,1029,424
0132-000,2018,3,20,8,633,1878,2511,1029
0132-000,2018,3,20,9,794,1605,2399,2511
0132-000,2018,3,20,10,738,883,1621,2399
0132-000,2018,3,20,11,722,790,1512,1621
0132-000,2018,3,20,12,717,778,1495,1512
0132-000,2018,3,20,13,743,680,1423,1495
0132-000,2018,3,20,14,737,785,1522,1423
0132-000,2018,3,20,15,775,765,1540,1522
0132-000,2018,3,20,16,796,770,1566,1540
0132-000,2018,3,20,17,897,776,1673,1566
0132-000,2018,3,20,18,1313,885,2198,1673
0132-000,2018,3,20,19,1469,767,2236,2198
0132-000,2018,3,20,20,936,588,1524,2236
0132-000,2018,3,20,21,841,499,1340,1524
0132-000,2018,3,20,22,530,429,959,1340
0132-000,2018,3,20,23,323,309,632,959
0132-000,2018,3,20,24,198,215,413,632
0132-000,2018,3,21,1,154,130,284,413
0132-000,2018,3,21,2,89,88,177,284
0132-000,2018,3,21,3,51,67,118,177
0132-000,2018,3,21,4,60,80,140,118
0132-000,2018,3,21,5,94,79,173,140
0132-000,2018,3,21,6,226,197,423,173
0132-000,2018,3,21,7,446,556,1002,423
0132-000,2018,3,21,8,605,1844,2449,1002
0132-000,2018,3,21,9,787,1679,2466,2449
0132-000,2018,3,21,10,729,884,1613,2466
0132-000,2018,3,21,11,734,737,1471,1613
0132-000,2018,3,21,12,674,713,1387,1471
0132-000,2018,3,21,13,656,678,1334,1387
0132-000,2018,3,21,14,726,805,1531,1334
0132-000,2018,3,21,15,763,714,1477,1531
0132-000,2018,3,21,16,839,727,1566,1477
0132-000,2018,3,21,17,905,742,1647,1566
0132-000,2018,3,21,18,1309,808,2117,1647
0132-000,2018,3,21,19,1546,783,2329,2117
0132-000,2018,3,21,20,885,554,1439,2329
0132-000,2018,3,21,21,713,498,1211,1439
0132-000,2018,3,21,22,511,382,893,1211
0132-000,2018,3,21,23,317,281,598,893
0132-000,2018,3,21,24,188,188,376,598
0132-000,2018,3,22,1,156,134,290,376
0132-000,2018,3,22,2,83,85,168,290
0132-000,2018,3,22,3,58,64,122,168
0132-000,2018,3,22,4,56,67,123,122
0132-000,2018,3,22,5,93,101,194,123
0132-000,2018,3,22,6,221,198,419,194
0132-000,2018,3,22,7,438,530,968,419
0132-000,2018,3,22,8,620,1853,2473,968
0132-000,2018,3,22,9,781,1615,2396,2473
0132-000,2018,3,22,10,714,858,1572,2396
0132-000,2018,3,22,11,681,766,1447,1572
0132-000,2018,3,22,12,712,783,1495,1447
0132-000,2018,3,22,13,688,674,1362,1495
0132-000,2018,3,22,14,747,779,1526,1362
0132-000,2018,3,22,15,750,755,1505,1526
0132-000,2018,3,22,16,783,773,1556,1505
0132-000,2018,3,22,17,916,774,1690,1556
0132-000,2018,3,22,18,1284,836,2120,1690
0132-000,2018,3,22,19,1501,821,2322,2120
0132-000,2018,3,22,20,917,594,1511,2322
0132-000,2018,3,22,21,869,490,1359,1511
0132-000,2018,3,22,22,572,460,1032,1359
0132-000,2018,3,22,23,357,312,669,1032
0132-000,2018,3,22,24,210,220,430,669
0132-000,2018,3,23,1,162,152,314,430
0132-000,2018,3,23,2,89,89,178,314
0132-000,2018,3,23,3,71,81,152,178
0132-000,2018,3,23,4,79,81,160,152
0132-000,2018,3,23,5,104,93,197,160
0132-000,2018,3,23,6,254,191,445,197
0132-000,2018,3,23,7,457,591,1048,445
0132-000,2018,3,23,8,636,1859,2495,1048
0132-000,2018,3,23,9,796,1613,2409,2495
0132-000,2018,3,23,10,737,866,1603,2409
0132-000,2018,3,23,11,735,837,1572,1603
0132-000,2018,3,23,12,729,802,1531,1572
0132-000,2018,3,23,13,775,702,1477,1531
0132-000,2018,3,23,14,760,772,1532,1477
0132-000,2018,3,23,15,799,743,1542,1532
0132-000,2018,3,23,16,899,804,1703,1542
0132-000,2018,3,23,17,911,848,1759,1703
0132-000,2018,3,23,18,1399,977,2376,1759
0132-000,2018,3,23,19,1745,845,2590,2376
0132-000,2018,3,23,20,1060,707,1767,2590
0132-000,2018,3,23,21,828,557,1385,1767
0132-000,2018,3,23,22,575,473,1048,1385
0132-000,2018,3,23,23,353,406,759,1048
0132-000,2018,3,23,24,230,277,507,759
0132-000,2018,3,24,1,210,192,402,507
0132-000,2018,3,24,2,130,139,269,402
0132-000,2018,3,24,3,73,94,167,269
0132-000,2018,3,24,4,82,107,189,167
0132-000,2018,3,24,5,124,111,235,189
0132-000,2018,3,24,6,231,162,393,235
0132-000,2018,3,24,7,389,421,810,393
0132-000,2018,3,24,8,456,850,1306,810
0132-000,2018,3,24,9,618,887,1505,1306
0132-000,2018,3,24,10,645,883,1528,1505
0132-000,2018,3,24,11,740,862,1602,1528
0132-000,2018,3,24,12,796,898,1694,1602
0132-000,2018,3,24,13,800,825,1625,1694
0132-000,2018,3,24,14,771,843,1614,1625
0132-000,2018,3,24,15,831,851,1682,1614
0132-000,2018,3,24,16,856,815,1671,1682
0132-000,2018,3,24,17,931,824,1755,1671
0132-000,2018,3,24,18,1260,908,2168,1755
0132-000,2018,3,24,19,955,772,1727,2168
0132-000,2018,3,24,20,688,564,1252,1727
0132-000,2018,3,24,21,573,469,1042,1252
0132-000,2018,3,24,22,457,420,877,1042
0132-000,2018,3,24,23,362,297,659,877
0132-000,2018,3,24,24,200,231,431,659
0132-000,2018,3,25,1,149,152,301,431
0132-000,2018,3,25,2,126,113,239,301
0132-000,2018,3,25,3,87,95,182,239
0132-000,2018,3,25,4,67,82,149,182
0132-000,2018,3,25,5,90,91,181,149
0132-000,2018,3,25,6,136,144,280,181
0132-000,2018,3,25,7,196,240,436,280
0132-000,2018,3,25,8,256,336,592,436
0132-000,2018,3,25,9,321,448,769,592
0132-000,2018,3,25,10,396,564,960,769
0132-000,2018,3,25,11,550,638,1188,960
0132-000,2018,3,25,12,533,615,1148,1188
0132-000,2018,3,25,13,631,592,1223,1148
0132-000,2018,3,25,14,747,683,1430,1223
0132-000,2018,3,25,15,830,683,1513,1430
0132-000,2018,3,25,16,909,663,1572,1513
0132-000,2018,3,25,17,938,730,1668,1572
0132-000,2018,3,25,18,973,730,1703,1668
0132-000,2018,3,25,19,921,590,1511,1703
0132-000,2018,3,25,20,721,514,1235,1511
0132-000,2018,3,25,21,560,448,1008,1235
0132-000,2018,3,25,22,418,387,805,1008
0132-000,2018,3,25,23,285,260,545,805
0132-000,2018,3,25,24,135,161,296,545
0132-000,2018,3,26,1,96,101,197,296
0132-000,2018,3,26,2,72,95,167,197
0132-000,2018,3,26,3,47,55,102,167
0132-000,2018,3,26,4,38,59,97,102
0132-000,2018,3,26,5,102,76,178,97
0132-000,2018,3,26,6,241,192,433,178
0132-000,2018,3,26,7,451,632,1083,433
0132-000,2018,3,26,8,663,1954,2617,1083
0132-000,2018,3,26,9,840,1645,2485,2617
0132-000,2018,3,26,10,738,923,1661,2485
0132-000,2018,3,26,11,771,789,1560,1661
0132-000,2018,3,26,12,752,789,1541,1560
0132-000,2018,3,26,13,682,774,1456,1541
0132-000,2018,3,26,14,775,820,1595,1456
0132-000,2018,3,26,15,824,775,1599,1595
0132-000,2018,3,26,16,869,773,1642,1599
0132-000,2018,3,26,17,905,832,1737,1642
0132-000,2018,3,26,18,1273,970,2243,1737
0132-000,2018,3,26,19,1561,847,2408,2243
0132-000,2018,3,26,20,1019,624,1643,2408
0132-000,2018,3,26,21,888,499,1387,1643
0132-000,2018,3,26,22,591,383,974,1387
0132-000,2018,3,26,23,324,280,604,974
0132-000,2018,3,26,24,204,184,388,604
0132-000,2018,3,27,1,158,127,285,388
0132-000,2018,3,27,2,95,85,180,285
0132-000,2018,3,27,3,61,83,144,180
0132-000,2018,3,27,4,77,78,155,144
0132-000,2018,3,27,5,119,100,219,155
0132-000,2018,3,27,6,241,171,412,219
0132-000,2018,3,27,7,439,625,1064,412
0132-000,2018,3,27,8,668,1918,2586,1064
0132-000,2018,3,27,9,811,1643,2454,2586
0132-000,2018,3,27,10,783,888,1671,2454
0132-000,2018,3,27,11,738,846,1584,1671
0132-000,2018,3,27,12,727,819,1546,1584
0132-000,2018,3,27,13,699,734,1433,1546
0132-000,2018,3,27,14,794,723,1517,1433
0132-000,2018,3,27,15,775,776,1551,1517
0132-000,2018,3,27,16,793,725,1518,1551
0132-000,2018,3,27,17,853,862,1715,1518
0132-000,2018,3,27,18,1268,939,2207,1715
0132-000,2018,3,27,19,1532,807,2339,2207
0132-000,2018,3,27,20,1017,624,1641,2339
0132-000,2018,3,27,21,836,511,1347,1641
0132-000,2018,3,27,22,574,457,1031,1347
0132-000,2018,3,27,23,344,288,632,1031
0132-000,2018,3,27,24,169,206,375,632
0132-000,2018,3,28,1,137,141,278,375
0132-000,2018,3,28,2,105,94,199,278
0132-000,2018,3,28,3,69,81,150,199
0132-000,2018,3,28,4,67,70,137,150
0132-000,2018,3,28,5,103,110,213,137
0132-000,2018,3,28,6,252,184,436,213
0132-000,2018,3,28,7,426,636,1062,436
0132-000,2018,3,28,8,726,1913,2639,1062
0132-000,2018,3,28,9,811,1612,2423,2639
0132-000,2018,3,28,10,778,901,1679,2423
0132-000,2018,3,28,11,775,808,1583,1679
0132-000,2018,3,28,12,741,833,1574,1583
0132-000,2018,3,28,13,687,749,1436,1574
0132-000,2018,3,28,14,768,759,1527,1436
0132-000,2018,3,28,15,777,792,1569,1527
0132-000,2018,3,28,16,854,777,1631,1569
0132-000,2018,3,28,17,981,857,1838,1631
0132-000,2018,3,28,18,1418,895,2313,1838
0132-000,2018,3,28,19,1652,854,2506,2313
0132-000,2018,3,28,20,1022,642,1664,2506
0132-000,2018,3,28,21,749,524,1273,1664
0132-000,2018,3,28,22,581,414,995,1273
0132-000,2018,3,28,23,380,367,747,995
0132-000,2018,3,28,24,204,264,468,747
0132-000,2018,3,29,1,158,139,297,468
0132-000,2018,3,29,2,110,94,204,297
0132-000,2018,3,29,3,71,99,170,204
0132-000,2018,3,29,4,84,85,169,170
0132-000,2018,3,29,5,105,103,208,169
0132-000,2018,3,29,6,273,190,463,208
0132-000,2018,3,29,7,465,659,1124,463
0132-000,2018,3,29,8,661,1861,2522,1124
0132-000,2018,3,29,9,820,1591,2411,2522
0132-000,2018,3,29,10,726,905,1631,2411
0132-000,2018,3,29,11,730,761,1491,1631
0132-000,2018,3,29,12,699,742,1441,1491
0132-000,2018,3,29,13,724,711,1435,1441
0132-000,2018,3,29,14,738,768,1506,1435
0132-000,2018,3,29,15,807,720,1527,1506
0132-000,2018,3,29,16,777,733,1510,1527
0132-000,2018,3,29,17,904,779,1683,1510
0132-000,2018,3,29,18,1266,913,2179,1683
0132-000,2018,3,29,19,1599,780,2379,2179
0132-000,2018,3,29,20,940,648,1588,2379
0132-000,2018,3,29,21,845,511,1356,1588
0132-000,2018,3,29,22,565,484,1049,1356
0132-000,2018,3,29,23,337,341,678,1049
0132-000,2018,3,29,24,197,198,395,678
0132-000,2018,3,30,1,155,150,305,395
0132-000,2018,3,30,2,120,105,225,305
0132-000,2018,3,30,3,71,83,154,225
0132-000,2018,3,30,4,82,62,144,154
0132-000,2018,3,30,5,128,111,239,144
0132-000,2018,3,30,6,259,200,459,239
0132-000,2018,3,30,7,455,642,1097,459
0132-000,2018,3,30,8,639,1840,2479,1097
0132-000,2018,3,30,9,847,1544,2391,2479
0132-000,2018,3,30,10,771,931,1702,2391
0132-000,2018,3,30,11,732,844,1576,1702
0132-000,2018,3,30,12,776,884,1660,1576
0132-000,2018,3,30,13,780,758,1538,1660
0132-000,2018,3,30,14,787,814,1601,1538
0132-000,2018,3,30,15,840,780,1620,1601
0132-000,2018,3,30,16,891,757,1648,1620
0132-000,2018,3,30,17,968,835,1803,1648
0132-000,2018,3,30,18,1384,1064,2448,1803
0132-000,2018,3,30,19,1754,876,2630,2448
0132-000,2018,3,30,20,1007,725,1732,2630
0132-000,2018,3,30,21,822,570,1392,1732
0132-000,2018,3,30,22,559,437,996,1392
0132-000,2018,3,30,23,360,379,739,996
0132-000,2018,3,30,24,236,241,477,739
0132-000,2018,3,31,1,190,180,370,477
0132-000,2018,3,31,2,145,140,285,370
0132-000,2018,3,31,3,89,108,197,285
0132-000,2018,3,31,4,85,108,193,197
0132-000,2018,3,31,5,126,113,239,193
0132-000,2018,3,31,6,226,191,417,239
0132-000,2018,3,31,7,367,395,762,417
0132-000,2018,3,31,8,468,844,1312,762
0132-000,2018,3,31,9,604,964,1568,1312
0132-000,2018,3,31,10,699,920,1619,1568
0132-000,2018,3,31,11,790,918,1708,1619
0132-000,2018,3,31,12,798,948,1746,1708
0132-000,2018,3,31,13,845,842,1687,1746
0132-000,2018,3,31,14,906,899,1805,1687
0132-000,2018,3,31,15,852,908,1760,1805
0132-000,2018,3,31,16,952,880,1832,1760
0132-000,2018,3,31,17,956,911,1867,1832
0132-000,2018,3,31,18,1251,893,2144,1867
0132-000,2018,3,31,19,1106,763,1869,2144
0132-000,2018,3,31,20,696,597,1293,1869
0132-000,2018,3,31,21,547,458,1005,1293
0132-000,2018,3,31,22,437,382,819,1005
0132-000,2018,3,31,23,342,308,650,819
0132-000,2018,3,31,24,200,234,434,650
0132-000,2018,4,1,1,180,194,374,434
0132-000,2018,4,1,2,139,131,270,374
0132-000,2018,4,1,3,94,96,190,270
0132-000,2018,4,1,4,75,98,173,190
0132-000,2018,4,1,5,99,94,193,173
0132-000,2018,4,1,6,150,148,298,193
0132-000,2018,4,1,7,223,228,451,298
0132-000,2018,4,1,8,301,394,695,451
0132-000,2018,4,1,9,369,501,870,695
0132-000,2018,4,1,10,422,673,1095,870
0132-000,2018,4,1,11,548,713,1261,1095
0132-000,2018,4,1,12,557,683,1240,1261
0132-000,2018,4,1,13,665,682,1347,1240
0132-000,2018,4,1,14,764,758,1522,1347
0132-000,2018,4,1,15,847,669,1516,1522
0132-000,2018,4,1,16,881,720,1601,1516
0132-000,2018,4,1,17,892,661,1553,1601
0132-000,2018,4,1,18,977,618,1595,1553
0132-000,2018,4,1,19,975,571,1546,1595
0132-000,2018,4,1,20,732,476,1208,1546
0132-000,2018,4,1,21,554,471,1025,1208
0132-000,2018,4,1,22,398,371,769,1025
0132-000,2018,4,1,23,274,283,557,769
0132-000,2018,4,1,24,172,176,348,557
0132-000,2018,4,2,1,89,120,209,348
0132-000,2018,4,2,2,79,69,148,209
0132-000,2018,4,2,3,57,67,124,148
0132-000,2018,4,2,4,58,63,121,124
0132-000,2018,4,2,5,101,91,192,121
0132-000,2018,4,2,6,275,203,478,192
0132-000,2018,4,2,7,537,665,1202,478
0132-000,2018,4,2,8,667,2001,2668,1202
0132-000,2018,4,2,9,825,1639,2464,2668
0132-000,2018,4,2,10,754,926,1680,2464
0132-000,2018,4,2,11,815,917,1732,1680
0132-000,2018,4,2,12,828,845,1673,1732
0132-000,2018,4,2,13,754,779,1533,1673
0132-000,2018,4,2,14,798,775,1573,1533
0132-000,2018,4,2,15,792,819,1611,1573
0132-000,2018,4,2,16,857,804,1661,1611
0132-000,2018,4,2,17,949,808,1757,1661
0132-000,2018,4,2,18,1228,873,2101,1757
0132-000,2018,4,2,19,1525,835,2360,2101
0132-000,2018,4,2,20,999,666,1665,2360
0132-000,2018,4,2,21,819,497,1316,1665
0132-000,2018,4,2,22,537,386,923,1316
0132-000,2018,4,2,23,321,287,608,923
0132-000,2018,4,2,24,187,199,386,608
0132-000,2018,4,3,1,138,137,275,386
0132-000,2018,4,3,2,82,86,168,275
0132-000,2018,4,3,3,66,83,149,168
0132-000,2018,4,3,4,66,74,140,149
0132-000,2018,4,3,5,128,95,223,140
0132-000,2018,4,3,6,276,206,482,223
0132-000,2018,4,3,7,484,577,1061,482
0132-000,2018,4,3,8,674,1942,2616,1061
0132-000,2018,4,3,9,800,1676,2476,2616
0132-000,2018,4,3,10,757,895,1652,2476
0132-000,2018,4,3,11,761,830,1591,1652
0132-000,2018,4,3,12,728,746,1474,1591
0132-000,2018,4,3,13,689,717,1406,1474
0132-000,2018,4,3,14,742,789,1531,1406
0132-000,2018,4,3,15,821,841,1662,1531
0132-000,2018,4,3,16,878,842,1720,1662
0132-000,2018,4,3,17,935,846,1781,1720
0132-000,2018,4,3,18,1268,958,2226,1781
0132-000,2018,4,3,19,1529,811,2340,2226
0132-000,2018,4,3,20,985,632,1617,2340
0132-000,2018,4,3,21,861,537,1398,1617
0132-000,2018,4,3,22,559,417,976,1398
0132-000,2018,4,3,23,337,329,666,976
0132-000,2018,4,3,24,219,175,394,666
0132-000,2018,4,4,1,163,160,323,394
0132-000,2018,4,4,2,96,99,195,323
0132-000,2018,4,4,3,78,68,146,195
0132-000,2018,4,4,4,61,80,141,146
0132-000,2018,4,4,5,90,95,185,141
0132-000,2018,4,4,6,218,174,392,185
0132-000,2018,4,4,7,391,521,912,392
0132-000,2018,4,4,8,640,1869,2509,912
0132-000,2018,4,4,9,839,1620,2459,2509
0132-000,2018,4,4,10,733,848,1581,2459
0132-000,2018,4,4,11,716,795,1511,1581
0132-000,2018,4,4,12,727,815,1542,1511
0132-000,2018,4,4,13,695,762,1457,1542
0132-000,2018,4,4,14,737,712,1449,1457
0132-000,2018,4,4,15,810,805,1615,1449
0132-000,2018,4,4,16,850,751,1601,1615
0132-000,2018,4,4,17,960,868,1828,1601
0132-000,2018,4,4,18,1326,853,2179,1828
0132-000,2018,4,4,19,1636,739,2375,2179
0132-000,2018,4,4,20,911,593,1504,2375
0132-000,2018,4,4,21,732,480,1212,1504
0132-000,2018,4,4,22,499,421,920,1212
0132-000,2018,4,4,23,331,337,668,920
0132-000,2018,4,4,24,219,217,436,668
0132-000,2018,4,5,1,178,134,312,436
0132-000,2018,4,5,2,96,121,217,312
0132-000,2018,4,5,3,62,84,146,217
0132-000,2018,4,5,4,56,68,124,146
0132-000,2018,4,5,5,107,109,216,124
0132-000,2018,4,5,6,206,161,367,216
0132-000,2018,4,5,7,373,485,858,367
0132-000,2018,4,5,8,584,1791,2375,858
0132-000,2018,4,5,9,753,1605,2358,2375
0132-000,2018,4,5,10,703,864,1567,2358
0132-000,2018,4,5,11,653,787,1440,1567
0132-000,2018,4,5,12,695,764,1459,1440
0132-000,2018,4,5,13,693,633,1326,1459
0132-000,2018,4,5,14,775,764,1539,1326
0132-000,2018,4,5,15,790,703,1493,1539
0132-000,2018,4,5,16,753,723,1476,1493
0132-000,2018,4,5,17,825,730,1555,1476
0132-000,2018,4,5,18,1179,788,1967,1555
0132-000,2018,4,5,19,1542,725,2267,1967
0132-000,2018,4,5,20,855,596,1451,2267
0132-000,2018,4,5,21,782,461,1243,1451
0132-000,2018,4,5,22,490,400,890,1243
0132-000,2018,4,5,23,295,339,634,890
0132-000,2018,4,5,24,190,194,384,634
0132-000,2018,4,6,1,141,130,271,384
0132-000,2018,4,6,2,121,115,236,271
0132-000,2018,4,6,3,87,71,158,236
0132-000,2018,4,6,4,58,67,125,158
0132-000,2018,4,6,5,96,88,184,125
0132-000,2018,4,6,6,221,178,399,184
0132-000,2018,4,6,7,434,559,993,399
0132-000,2018,4,6,8,605,1814,2419,993
0132-000,2018,4,6,9,793,1533,2326,2419
0132-000,2018,4,6,10,734,921,1655,2326
0132-000,2018,4,6,11,770,898,1668,1655
0132-000,2018,4,6,12,758,845,1603,1668
0132-000,2018,4,6,13,780,736,1516,1603
0132-000,2018,4,6,14,796,860,1656,1516
0132-000,2018,4,6,15,846,771,1617,1656
0132-000,2018,4,6,16,880,806,1686,1617
0132-000,2018,4,6,17,1011,853,1864,1686
0132-000,2018,4,6,18,1401,922,2323,1864
0132-000,2018,4,6,19,1786,878,2664,2323
0132-000,2018,4,6,20,1044,688,1732,2664
0132-000,2018,4,6,21,818,557,1375,1732
0132-000,2018,4,6,22,547,441,988,1375
0132-000,2018,4,6,23,348,345,693,988
0132-000,2018,4,6,24,219,255,474,693
0132-000,2018,4,7,1,178,196,374,474
0132-000,2018,4,7,2,117,126,243,374
0132-000,2018,4,7,3,85,96,181,243
0132-000,2018,4,7,4,69,72,141,181
0132-000,2018,4,7,5,112,107,219,141
0132-000,2018,4,7,6,225,174,399,219
0132-000,2018,4,7,7,381,402,783,399
0132-000,2018,4,7,8,502,870,1372,783
0132-000,2018,4,7,9,620,898,1518,1372
0132-000,2018,4,7,10,676,919,1595,1518
0132-000,2018,4,7,11,737,1036,1773,1595
0132-000,2018,4,7,12,794,1094,1888,1773
0132-000,2018,4,7,13,821,993,1814,1888
0132-000,2018,4,7,14,849,905,1754,1814
0132-000,2018,4,7,15,907,930,1837,1754
0132-000,2018,4,7,16,862,856,1718,1837
0132-000,2018,4,7,17,974,883,1857,1718
0132-000,2018,4,7,18,1200,920,2120,1857
0132-000,2018,4,7,19,1033,804,1837,2120
0132-000,2018,4,7,20,691,630,1321,1837
0132-000,2018,4,7,21,579,478,1057,1321
0132-000,2018,4,7,22,435,353,788,1057
0132-000,2018,4,7,23,304,303,607,788
0132-000,2018,4,7,24,190,232,422,607
0132-000,2018,4,8,1,168,161,329,422
0132-000,2018,4,8,2,103,130,233,329
0132-000,2018,4,8,3,77,101,178,233
0132-000,2018,4,8,4,67,68,135,178
0132-000,2018,4,8,5,88,77,165,135
0132-000,2018,4,8,6,140,151,291,165
0132-000,2018,4,8,7,234,228,462,291
0132-000,2018,4,8,8,289,376,665,462
0132-000,2018,4,8,9,383,501,884,665
0132-000,2018,4,8,10,475,672,1147,884
0132-000,2018,4,8,11,578,617,1195,1147
0132-000,2018,4,8,12,540,616,1156,1195
0132-000,2018,4,8,13,705,650,1355,1156
0132-000,2018,4,8,14,656,680,1336,1355
0132-000,2018,4,8,15,833,648,1481,1336
0132-000,2018,4,8,16,796,755,1551,1481
0132-000,2018,4,8,17,827,711,1538,1551
0132-000,2018,4,8,18,950,677,1627,1538
0132-000,2018,4,8,19,817,537,1354,1627
0132-000,2018,4,8,20,641,487,1128,1354
0132-000,2018,4,8,21,571,421,992,1128
0132-000,2018,4,8,22,421,362,783,992
0132-000,2018,4,8,23,265,247,512,783
0132-000,2018,4,8,24,158,134,292,512
0132-000,2018,4,9,1,103,118,221,292
0132-000,2018,4,9,2,57,79,136,221
0132-000,2018,4,9,3,37,63,100,136
0132-000,2018,4,9,4,50,51,101,100
0132-000,2018,4,9,5,109,71,180,101
0132-000,2018,4,9,6,260,216,476,180
0132-000,2018,4,9,7,518,661,1179,476
0132-000,2018,4,9,8,680,2022,2702,1179
0132-000,2018,4,9,9,820,1592,2412,2702
0132-000,2018,4,9,10,743,911,1654,2412
0132-000,2018,4,9,11,748,845,1593,1654
0132-000,2018,4,9,12,745,791,1536,1593
0132-000,2018,4,9,13,714,797,1511,1536
0132-000,2018,4,9,14,771,769,1540,1511
0132-000,2018,4,9,15,795,756,1551,1540
0132-000,2018,4,9,16,836,863,1699,1551
0132-000,2018,4,9,17,951,856,1807,1699
0132-000,2018,4,9,18,1308,915,2223,1807
0132-000,2018,4,9,19,1584,813,2397,2223
0132-000,2018,4,9,20,1026,637,1663,2397
0132-000,2018,4,9,21,824,554,1378,1663
0132-000,2018,4,9,22,581,439,1020,1378
0132-000,2018,4,9,23,340,306,646,1020
0132-000,2018,4,9,24,224,208,432,646
0132-000,2018,4,10,1,157,110,267,432
0132-000,2018,4,10,2,92,90,182,267
0132-000,2018,4,10,3,66,79,145,182
0132-000,2018,4,10,4,63,66,129,145
0132-000,2018,4,10,5,122,96,218,129
0132-000,2018,4,10,6,279,203,482,218
0132-000,2018,4,10,7,547,614,1161,482
0132-000,2018,4,10,8,717,1964,2681,1161
0132-000,2018,4,10,9,845,1660,2505,2681
0132-000,2018,4,10,10,799,900,1699,2505
0132-000,2018,4,10,11,731,883,1614,1699
0132-000,2018,4,10,12,757,794,1551,1614
0132-000,2018,4,10,13,760,714,1474,1551
0132-000,2018,4,10,14,786,770,1556,1474
0132-000,2018,4,10,15,833,767,1600,1556
0132-000,2018,4,10,16,835,798,1633,1600
0132-000,2018,4,10,17,944,832,1776,1633
0132-000,2018,4,10,18,1337,898,2235,1776
0132-000,2018,4,10,19,1521,839,2360,2235
0132-000,2018,4,10,20,986,623,1609,2360
0132-000,2018,4,10,21,848,526,1374,1609
0132-000,2018,4,10,22,546,431,977,1374
0132-000,2018,4,10,23,323,321,644,977
0132-000,2018,4,10,24,195,199,394,644
0132-000,2018,4,11,1,145,140,285,394
0132-000,2018,4,11,2,97,112,209,285
0132-000,2018,4,11,3,67,79,146,209
0132-000,2018,4,11,4,67,80,147,146
0132-000,2018,4,11,5,105,97,202,147
0132-000,2018,4,11,6,271,190,461,202
0132-000,2018,4,11,7,472,591,1063,461
0132-000,2018,4,11,8,685,1895,2580,1063
0132-000,2018,4,11,9,840,1636,2476,2580
0132-000,2018,4,11,10,750,937,1687,2476
0132-000,2018,4,11,11,796,856,1652,1687
0132-000,2018,4,11,12,702,810,1512,1652
0132-000,2018,4,11,13,699,759,1458,1512
0132-000,2018,4,11,14,793,739,1532,1458
0132-000,2018,4,11,15,805,812,1617,1532
0132-000,2018,4,11,16,825,814,1639,1617
0132-000,2018,4,11,17,948,789,1737,1639
0132-000,2018,4,11,18,1425,886,2311,1737
0132-000,2018,4,11,19,1680,798,2478,2311
0132-000,2018,4,11,20,969,682,1651,2478
0132-000,2018,4,11,21,786,521,1307,1651
0132-000,2018,4,11,22,551,432,983,1307
0132-000,2018,4,11,23,361,336,697,983
0132-000,2018,4,11,24,233,224,457,697
0132-000,2018,4,12,1,175,148,323,457
0132-000,2018,4,12,2,97,98,195,323
0132-000,2018,4,12,3,79,82,161,195
0132-000,2018,4,12,4,54,98,152,161
0132-000,2018,4,12,5,123,114,237,152
0132-000,2018,4,12,6,291,191,482,237
0132-000,2018,4,12,7,519,648,1167,482
0132-000,2018,4,12,8,684,1943,2627,1167
0132-000,2018,4,12,9,806,1613,2419,2627
0132-000,2018,4,12,10,760,895,1655,2419
0132-000,2018,4,12,11,698,814,1512,1655
0132-000,2018,4,12,12,730,743,1473,1512
0132-000,2018,4,12,13,694,712,1406,1473
0132-000,2018,4,12,14,789,797,1586,1406
0132-000,2018,4,12,15,813,763,1576,1586
0132-000,2018,4,12,16,779,773,1552,1576
0132-000,2018,4,12,17,938,786,1724,1552
0132-000,2018,4,12,18,1363,910,2273,1724
0132-000,2018,4,12,19,1590,835,2425,2273
0132-000,2018,4,12,20,954,626,1580,2425
0132-000,2018,4,12,21,898,511,1409,1580
0132-000,2018,4,12,22,548,490,1038,1409
0132-000,2018,4,12,23,356,331,687,1038
0132-000,2018,4,12,24,243,216,459,687
0132-000,2018,4,13,1,151,150,301,459
0132-000,2018,4,13,2,92,102,194,301
0132-000,2018,4,13,3,77,87,164,194
0132-000,2018,4,13,4,81,71,152,164
0132-000,2018,4,13,5,112,102,214,152
0132-000,2018,4,13,6,290,222,512,214
0132-000,2018,4,13,7,521,621,1142,512
0132-000,2018,4,13,8,682,1951,2633,1142
0132-000,2018,4,13,9,829,1572,2401,2633
0132-000,2018,4,13,10,781,917,1698,2401
0132-000,2018,4,13,11,749,851,1600,1698
0132-000,2018,4,13,12,772,829,1601,1600
0132-000,2018,4,13,13,664,763,1427,1601
0132-000,2018,4,13,14,787,725,1512,1427
0132-000,2018,4,13,15,825,791,1616,1512
0132-000,2018,4,13,16,869,865,1734,1616
0132-000,2018,4,13,17,987,851,1838,1734
0132-000,2018,4,13,18,1455,1009,2464,1838
0132-000,2018,4,13,19,1812,836,2648,2464
0132-000,2018,4,13,20,1060,740,1800,2648
0132-000,2018,4,13,21,828,528,1356,1800
0132-000,2018,4,13,22,509,457,966,1356
0132-000,2018,4,13,23,372,375,747,966
0132-000,2018,4,13,24,251,243,494,747
0132-000,2018,4,14,1,184,210,394,494
0132-000,2018,4,14,2,127,145,272,394
0132-000,2018,4,14,3,127,134,261,272
0132-000,2018,4,14,4,95,108,203,261
0132-000,2018,4,14,5,76,115,191,203
0132-000,2018,4,14,6,184,153,337,191
0132-000,2018,4,14,7,311,351,662,337
0132-000,2018,4,14,8,417,735,1152,662
0132-000,2018,4,14,9,600,815,1415,1152
0132-000,2018,4,14,10,622,828,1450,1415
0132-000,2018,4,14,11,709,878,1587,1450
0132-000,2018,4,14,12,792,915,1707,1587
0132-000,2018,4,14,13,763,883,1646,1707
0132-000,2018,4,14,14,752,827,1579,1646
0132-000,2018,4,14,15,742,811,1553,1579
0132-000,2018,4,14,16,787,849,1636,1553
0132-000,2018,4,14,17,873,730,1603,1636
0132-000,2018,4,14,18,1047,815,1862,1603
0132-000,2018,4,14,19,903,691,1594,1862
0132-000,2018,4,14,20,675,571,1246,1594
0132-000,2018,4,14,21,497,401,898,1246
0132-000,2018,4,14,22,390,374,764,898
0132-000,2018,4,14,23,268,340,608,764
0132-000,2018,4,14,24,207,209,416,608
0132-000,2018,4,15,1,166,165,331,416
0132-000,2018,4,15,2,125,137,262,331
0132-000,2018,4,15,3,84,104,188,262
0132-000,2018,4,15,4,61,82,143,188
0132-000,2018,4,15,5,89,86,175,143
0132-000,2018,4,15,6,120,139,259,175
0132-000,2018,4,15,7,234,262,496,259
0132-000,2018,4,15,8,301,416,717,496
0132-000,2018,4,15,9,364,551,915,717
0132-000,2018,4,15,10,464,604,1068,915
0132-000,2018,4,15,11,570,647,1217,1068
0132-000,2018,4,15,12,612,683,1295,1217
0132-000,2018,4,15,13,655,706,1361,1295
0132-000,2018,4,15,14,721,725,1446,1361
0132-000,2018,4,15,15,806,745,1551,1446
0132-000,2018,4,15,16,859,717,1576,1551
0132-000,2018,4,15,17,967,728,1695,1576
0132-000,2018,4,15,18,1037,679,1716,1695
0132-000,2018,4,15,19,947,568,1515,1716
0132-000,2018,4,15,20,728,507,1235,1515
0132-000,2018,4,15,21,602,474,1076,1235
0132-000,2018,4,15,22,428,364,792,1076
0132-000,2018,4,15,23,283,291,574,792
0132-000,2018,4,15,24,186,200,386,574
0132-000,2018,4,16,1,136,116,252,386
0132-000,2018,4,16,2,66,98,164,252
0132-000,2018,4,16,3,54,57,111,164
0132-000,2018,4,16,4,62,61,123,111
0132-000,2018,4,16,5,93,93,186,123
0132-000,2018,4,16,6,305,237,542,186
0132-000,2018,4,16,7,513,709,1222,542
0132-000,2018,4,16,8,697,2030,2727,1222
0132-000,2018,4,16,9,904,1791,2695,2727
0132-000,2018,4,16,10,794,923,1717,2695
0132-000,2018,4,16,11,801,845,1646,1717
0132-000,2018,4,16,12,747,815,1562,1646
0132-000,2018,4,16,13,676,789,1465,1562
0132-000,2018,4,16,14,765,806,1571,1465
0132-000,2018,4,16,15,880,832,1712,1571
0132-000,2018,4,16,16,877,823,1700,1712
0132-000,2018,4,16,17,930,840,1770,1700
0132-000,2018,4,16,18,1294,951,2245,1770
0132-000,2018,4,16,19,1545,814,2359,2245
0132-000,2018,4,16,20,1046,621,1667,2359
0132-000,2018,4,16,21,831,518,1349,1667
0132-000,2018,4,16,22,550,416,966,1349
0132-000,2018,4,16,23,335,288,623,966
0132-000,2018,4,16,24,187,220,407,623
0132-000,2018,4,17,1,135,141,276,407
0132-000,2018,4,17,2,98,96,194,276
0132-000,2018,4,17,3,63,95,158,194
0132-000,2018,4,17,4,57,77,134,158
0132-000,2018,4,17,5,109,107,216,134
0132-000,2018,4,17,6,267,222,489,216
0132-000,2018,4,17,7,525,653,1178,489
0132-000,2018,4,17,8,686,1897,2583,1178
0132-000,2018,4,17,9,926,1798,2724,2583
0132-000,2018,4,17,10,733,879,1612,2724
0132-000,2018,4,17,11,747,787,1534,1612
0132-000,2018,4,17,12,736,804,1540,1534
0132-000,2018,4,17,13,695,737,1432,1540
0132-000,2018,4,17,14,808,749,1557,1432
0132-000,2018,4,17,15,824,805,1629,1557
0132-000,2018,4,17,16,890,798,1688,1629
0132-000,2018,4,17,17,931,778,1709,1688
0132-000,2018,4,17,18,1357,953,2310,1709
0132-000,2018,4,17,19,1494,855,2349,2310
0132-000,2018,4,17,20,974,646,1620,2349
0132-000,2018,4,17,21,812,537,1349,1620
0132-000,2018,4,17,22,555,446,1001,1349
0132-000,2018,4,17,23,361,307,668,1001
0132-000,2018,4,17,24,199,204,403,668
0132-000,2018,4,18,1,154,136,290,403
0132-000,2018,4,18,2,82,109,191,290
0132-000,2018,4,18,3,61,72,133,191
0132-000,2018,4,18,4,69,79,148,133
0132-000,2018,4,18,5,108,108,216,148
0132-000,2018,4,18,6,262,198,460,216
0132-000,2018,4,18,7,521,624,1145,460
0132-000,2018,4,18,8,716,1921,2637,1145
0132-000,2018,4,18,9,860,1659,2519,2637
0132-000,2018,4,18,10,769,919,1688,2519
0132-000,2018,4,18,11,814,836,1650,1688
0132-000,2018,4,18,12,736,813,1549,1650
0132-000,2018,4,18,13,706,704,1410,1549
0132-000,2018,4,18,14,771,854,1625,1410
0132-000,2018,4,18,15,847,833,1680,1625
0132-000,2018,4,18,16,849,740,1589,1680
0132-000,2018,4,18,17,916,821,1737,1589
0132-000,2018,4,18,18,1387,888,2275,1737
0132-000,2018,4,18,19,1664,791,2455,2275
0132-000,2018,4,18,20,949,680,1629,2455
0132-000,2018,4,18,21,744,526,1270,1629
0132-000,2018,4,18,22,544,432,976,1270
0132-000,2018,4,18,23,385,337,722,976
0132-000,2018,4,18,24,224,223,447,722
0132-000,2018,4,19,1,183,136,319,447
0132-000,2018,4,19,2,101,102,203,319
0132-000,2018,4,19,3,81,77,158,203
0132-000,2018,4,19,4,59,65,124,158
0132-000,2018,4,19,5,97,118,215,124
0132-000,2018,4,19,6,282,202,484,215
0132-000,2018,4,19,7,509,638,1147,484
0132-000,2018,4,19,8,663,1885,2548,1147
0132-000,2018,4,19,9,792,1522,2314,2548
0132-000,2018,4,19,10,776,967,1743,2314
0132-000,2018,4,19,11,676,817,1493,1743
0132-000,2018,4,19,12,712,757,1469,1493
0132-000,2018,4,19,13,694,732,1426,1469
0132-000,2018,4,19,14,843,811,1654,1426
0132-000,2018,4,19,15,812,741,1553,1654
0132-000,2018,4,19,16,802,764,1566,1553
0132-000,2018,4,19,17,922,759,1681,1566
0132-000,2018,4,19,18,1281,884,2165,1681
0132-000,2018,4,19,19,1458,843,2301,2165
0132-000,2018,4,19,20,956,616,1572,2301
0132-000,2018,4,19,21,839,518,1357,1572
0132-000,2018,4,19,22,583,449,1032,1357
0132-000,2018,4,19,23,377,335,712,1032
0132-000,2018,4,19,24,208,201,409,712
0132-000,2018,4,20,1,175,144,319,409
0132-000,2018,4,20,2,105,116,221,319
0132-000,2018,4,20,3,65,92,157,221
0132-000,2018,4,20,4,73,91,164,157
0132-000,2018,4,20,5,105,93,198,164
0132-000,2018,4,20,6,272,196,468,198
0132-000,2018,4,20,7,519,639,1158,468
0132-000,2018,4,20,8,673,1928,2601,1158
0132-000,2018,4,20,9,788,1657,2445,2601
0132-000,2018,4,20,10,782,902,1684,2445
0132-000,2018,4,20,11,760,875,1635,1684
0132-000,2018,4,20,12,765,820,1585,1635
0132-000,2018,4,20,13,764,747,1511,1585
0132-000,2018,4,20,14,796,762,1558,1511
0132-000,2018,4,20,15,814,771,1585,1558
0132-000,2018,4,20,16,903,820,1723,1585
0132-000,2018,4,20,17,992,960,1952,1723
0132-000,2018,4,20,18,1419,976,2395,1952
0132-000,2018,4,20,19,1687,908,2595,2395
0132-000,2018,4,20,20,1034,766,1800,2595
0132-000,2018,4,20,21,864,545,1409,1800
0132-000,2018,4,20,22,591,453,1044,1409
0132-000,2018,4,20,23,381,382,763,1044
0132-000,2018,4,20,24,235,248,483,763
0132-000,2018,4,21,1,202,224,426,483
0132-000,2018,4,21,2,141,127,268,426
0132-000,2018,4,21,3,89,116,205,268
0132-000,2018,4,21,4,72,89,161,205
0132-000,2018,4,21,5,111,115,226,161
0132-000,2018,4,21,6,245,262,507,226
0132-000,2018,4,21,7,446,508,954,507
0132-000,2018,4,21,8,460,851,1311,954
0132-000,2018,4,21,9,610,915,1525,1311
0132-000,2018,4,21,10,649,943,1592,1525
0132-000,2018,4,21,11,723,880,1603,1592
0132-000,2018,4,21,12,793,1006,1799,1603
0132-000,2018,4,21,13,853,914,1767,1799
0132-000,2018,4,21,14,814,919,1733,1767
0132-000,2018,4,21,15,881,935,1816,1733
0132-000,2018,4,21,16,896,876,1772,1816
0132-000,2018,4,21,17,1019,876,1895,1772
0132-000,2018,4,21,18,1259,957,2216,1895
0132-000,2018,4,21,19,1113,811,1924,2216
0132-000,2018,4,21,20,828,643,1471,1924
0132-000,2018,4,21,21,610,492,1102,1471
0132-000,2018,4,21,22,500,465,965,1102
0132-000,2018,4,21,23,342,330,672,965
0132-000,2018,4,21,24,220,241,461,672
0132-000,2018,4,22,1,181,157,338,461
0132-000,2018,4,22,2,120,143,263,338
0132-000,2018,4,22,3,100,105,205,263
0132-000,2018,4,22,4,79,95,174,205
0132-000,2018,4,22,5,73,87,160,174
0132-000,2018,4,22,6,145,169,314,160
0132-000,2018,4,22,7,264,284,548,314
0132-000,2018,4,22,8,281,378,659,548
0132-000,2018,4,22,9,379,448,827,659
0132-000,2018,4,22,10,506,539,1045,827
0132-000,2018,4,22,11,591,559,1150,1045
0132-000,2018,4,22,12,575,627,1202,1150
0132-000,2018,4,22,13,630,646,1276,1202
0132-000,2018,4,22,14,704,708,1412,1276
0132-000,2018,4,22,15,736,662,1398,1412
0132-000,2018,4,22,16,759,645,1404,1398
0132-000,2018,4,22,17,805,623,1428,1404
0132-000,2018,4,22,18,826,626,1452,1428
0132-000,2018,4,22,19,898,562,1460,1452
0132-000,2018,4,22,20,670,471,1141,1460
0132-000,2018,4,22,21,508,422,930,1141
0132-000,2018,4,22,22,372,367,739,930
0132-000,2018,4,22,23,238,241,479,739
0132-000,2018,4,22,24,147,152,299,479
0132-000,2018,4,23,1,116,120,236,299
0132-000,2018,4,23,2,83,91,174,236
0132-000,2018,4,23,3,49,56,105,174
0132-000,2018,4,23,4,37,54,91,105
0132-000,2018,4,23,5,94,93,187,91
0132-000,2018,4,23,6,222,177,399,187
0132-000,2018,4,23,7,453,560,1013,399
0132-000,2018,4,23,8,582,1798,2380,1013
0132-000,2018,4,23,9,708,1652,2360,2380
0132-000,2018,4,23,10,576,804,1380,2360
0132-000,2018,4,23,11,681,758,1439,1380
0132-000,2018,4,23,12,685,724,1409,1439
0132-000,2018,4,23,13,670,682,1352,1409
0132-000,2018,4,23,14,721,718,1439,1352
0132-000,2018,4,23,15,740,682,1422,1439
0132-000,2018,4,23,16,800,684,1484,1422
0132-000,2018,4,23,17,811,682,1493,1484
0132-000,2018,4,23,18,1196,798,1994,1493
0132-000,2018,4,23,19,1442,767,2209,1994
0132-000,2018,4,23,20,820,558,1378,2209
0132-000,2018,4,23,21,776,479,1255,1378
0132-000,2018,4,23,22,523,356,879,1255
0132-000,2018,4,23,23,331,276,607,879
0132-000,2018,4,23,24,199,157,356,607
0132-000,2018,4,24,1,132,132,264,356
0132-000,2018,4,24,2,88,86,174,264
0132-000,2018,4,24,3,59,80,139,174
0132-000,2018,4,24,4,54,73,127,139
0132-000,2018,4,24,5,90,91,181,127
0132-000,2018,4,24,6,263,202,465,181
0132-000,2018,4,24,7,458,577,1035,465
0132-000,2018,4,24,8,626,1886,2512,1035
0132-000,2018,4,24,9,805,1634,2439,2512
0132-000,2018,4,24,10,743,939,1682,2439
0132-000,2018,4,24,11,766,856,1622,1682
0132-000,2018,4,24,12,762,785,1547,1622
0132-000,2018,4,24,13,676,726,1402,1547
0132-000,2018,4,24,14,799,757,1556,1402
0132-000,2018,4,24,15,816,876,1692,1556
0132-000,2018,4,24,16,839,837,1676,1692
0132-000,2018,4,24,17,885,769,1654,1676
0132-000,2018,4,24,18,1248,844,2092,1654
0132-000,2018,4,24,19,1495,815,2310,2092
0132-000,2018,4,24,20,863,633,1496,2310
0132-000,2018,4,24,21,829,479,1308,1496
0132-000,2018,4,24,22,570,429,999,1308
0132-000,2018,4,24,23,315,308,623,999
0132-000,2018,4,24,24,228,194,422,623
0132-000,2018,4,25,1,128,138,266,422
0132-000,2018,4,25,2,96,102,198,266
0132-000,2018,4,25,3,66,77,143,198
0132-000,2018,4,25,4,61,78,139,143
0132-000,2018,4,25,5,107,102,209,139
0132-000,2018,4,25,6,278,213,491,209
0132-000,2018,4,25,7,533,620,1153,491
0132-000,2018,4,25,8,677,1930,2607,1153
0132-000,2018,4,25,9,846,1547,2393,2607
0132-000,2018,4,25,10,732,922,1654,2393
0132-000,2018,4,25,11,813,842,1655,1654
0132-000,2018,4,25,12,747,800,1547,1655
0132-000,2018,4,25,13,701,734,1435,1547
0132-000,2018,4,25,14,767,822,1589,1435
0132-000,2018,4,25,15,830,849,1679,1589
0132-000,2018,4,25,16,861,771,1632,1679
0132-000,2018,4,25,17,999,865,1864,1632
0132-000,2018,4,25,18,1316,982,2298,1864
0132-000,2018,4,25,19,1665,840,2505,2298
0132-000,2018,4,25,20,1001,679,1680,2505
0132-000,2018,4,25,21,809,532,1341,1680
0132-000,2018,4,25,22,535,428,963,1341
0132-000,2018,4,25,23,393,387,780,963
0132-000,2018,4,25,24,208,225,433,780
0132-000,2018,4,26,1,153,149,302,433
0132-000,2018,4,26,2,94,99,193,302
0132-000,2018,4,26,3,76,85,161,193
0132-000,2018,4,26,4,69,84,153,161
0132-000,2018,4,26,5,114,109,223,153
0132-000,2018,4,26,6,307,244,551,223
0132-000,2018,4,26,7,521,652,1173,551
0132-000,2018,4,26,8,684,1864,2548,1173
0132-000,2018,4,26,9,842,1684,2526,2548
0132-000,2018,4,26,10,775,932,1707,2526
0132-000,2018,4,26,11,752,842,1594,1707
0132-000,2018,4,26,12,774,844,1618,1594
0132-000,2018,4,26,13,748,731,1479,1618
0132-000,2018,4,26,14,827,714,1541,1479
0132-000,2018,4,26,15,851,838,1689,1541
0132-000,2018,4,26,16,923,813,1736,1689
0132-000,2018,4,26,17,979,851,1830,1736
0132-000,2018,4,26,18,1327,920,2247,1830
0132-000,2018,4,26,19,1563,824,2387,2247
0132-000,2018,4,26,20,964,663,1627,2387
0132-000,2018,4,26,21,843,536,1379,1627
0132-000,2018,4,26,22,607,446,1053,1379
0132-000,2018,4,26,23,397,332,729,1053
0132-000,2018,4,26,24,219,214,433,729
0132-000,2018,4,27,1,163,150,313,433
0132-000,2018,4,27,2,98,113,211,313
0132-000,2018,4,27,3,71,102,173,211
0132-000,2018,4,27,4,66,83,149,173
0132-000,2018,4,27,5,104,116,220,149
0132-000,2018,4,27,6,291,223,514,220
0132-000,2018,4,27,7,562,620,1182,514
0132-000,2018,4,27,8,654,1823,2477,1182
0132-000,2018,4,27,9,860,1575,2435,2477
0132-000,2018,4,27,10,712,945,1657,2435
0132-000,2018,4,27,11,749,888,1637,1657
0132-000,2018,4,27,12,743,784,1527,1637
0132-000,2018,4,27,13,735,729,1464,1527
0132-000,2018,4,27,14,775,776,1551,1464
0132-000,2018,4,27,15,848,767,1615,1551
0132-000,2018,4,27,16,899,840,1739,1615
0132-000,2018,4,27,17,963,883,1846,1739
0132-000,2018,4,27,18,1422,1001,2423,1846
0132-000,2018,4,27,19,1677,896,2573,2423
0132-000,2018,4,27,20,1107,814,1921,2573
0132-000,2018,4,27,21,831,587,1418,1921
0132-000,2018,4,27,22,603,496,1099,1418
0132-000,2018,4,27,23,449,400,849,1099
0132-000,2018,4,27,24,260,264,524,849
0132-000,2018,4,28,1,190,176,366,524
0132-000,2018,4,28,2,136,144,280,366
0132-000,2018,4,28,3,116,117,233,280
0132-000,2018,4,28,4,84,92,176,233
0132-000,2018,4,28,5,117,130,247,176
0132-000,2018,4,28,6,297,218,515,247
0132-000,2018,4,28,7,466,475,941,515
0132-000,2018,4,28,8,542,931,1473,941
0132-000,2018,4,28,9,675,1125,1800,1473
0132-000,2018,4,28,10,723,1054,1777,1800
0132-000,2018,4,28,11,805,1029,1834,1777
0132-000,2018,4,28,12,967,1192,2159,1834
0132-000,2018,4,28,13,903,948,1851,2159
0132-000,2018,4,28,14,843,980,1823,1851
0132-000,2018,4,28,15,932,950,1882,1823
0132-000,2018,4,28,16,952,932,1884,1882
0132-000,2018,4,28,17,1045,961,2006,1884
0132-000,2018,4,28,18,1212,908,2120,2006
0132-000,2018,4,28,19,1123,873,1996,2120
0132-000,2018,4,28,20,740,628,1368,1996
0132-000,2018,4,28,21,655,522,1177,1368
0132-000,2018,4,28,22,473,417,890,1177
0132-000,2018,4,28,23,308,341,649,890
0132-000,2018,4,28,24,213,232,445,649
0132-000,2018,4,29,1,150,185,335,445
0132-000,2018,4,29,2,116,132,248,335
0132-000,2018,4,29,3,84,110,194,248
0132-000,2018,4,29,4,91,97,188,194
0132-000,2018,4,29,5,80,81,161,188
0132-000,2018,4,29,6,158,178,336,161
0132-000,2018,4,29,7,285,283,568,336
0132-000,2018,4,29,8,309,445,754,568
0132-000,2018,4,29,9,371,571,942,754
0132-000,2018,4,29,10,461,654,1115,942
0132-000,2018,4,29,11,535,668,1203,1115
0132-000,2018,4,29,12,626,680,1306,1203
0132-000,2018,4,29,13,690,635,1325,1306
0132-000,2018,4,29,14,686,745,1431,1325
0132-000,2018,4,29,15,748,665,1413,1431
0132-000,2018,4,29,16,741,721,1462,1413
0132-000,2018,4,29,17,957,714,1671,1462
0132-000,2018,4,29,18,1008,648,1656,1671
0132-000,2018,4,29,19,1019,599,1618,1656
0132-000,2018,4,29,20,783,543,1326,1618
0132-000,2018,4,29,21,615,483,1098,1326
0132-000,2018,4,29,22,459,378,837,1098
0132-000,2018,4,29,23,284,264,548,837
0132-000,2018,4,29,24,192,180,372,548
0132-000,2018,4,30,1,131,147,278,372
0132-000,2018,4,30,2,74,94,168,278
0132-000,2018,4,30,3,58,73,131,168
0132-000,2018,4,30,4,49,56,105,131
0132-000,2018,4,30,5,91,105,196,105
0132-000,2018,4,30,6,254,228,482,196
0132-000,2018,4,30,7,553,615,1168,482
0132-000,2018,4,30,8,681,1918,2599,1168
0132-000,2018,4,30,9,836,1574,2410,2599
0132-000,2018,4,30,10,807,889,1696,2410
0132-000,2018,4,30,11,728,894,1622,1696
0132-000,2018,4,30,12,730,792,1522,1622
0132-000,2018,4,30,13,722,766,1488,1522
0132-000,2018,4,30,14,825,836,1661,1488
0132-000,2018,4,30,15,766,768,1534,1661
0132-000,2018,4,30,16,866,854,1720,1534
0132-000,2018,4,30,17,980,823,1803,1720
0132-000,2018,4,30,18,1330,899,2229,1803
0132-000,2018,4,30,19,1657,935,2592,2229
0132-000,2018,4,30,20,1045,691,1736,2592
0132-000,2018,4,30,21,803,565,1368,1736
0132-000,2018,4,30,22,545,438,983,1368
0132-000,2018,4,30,23,319,354,673,983
0132-000,2018,4,30,24,234,216,450,673
0132-000,2018,5,1,1,184,203,387,450
0132-000,2018,5,1,2,115,132,247,387
0132-000,2018,5,1,3,91,102,193,247
0132-000,2018,5,1,4,81,93,174,193
0132-000,2018,5,1,5,76,122,198,174
0132-000,2018,5,1,6,143,166,309,198
0132-000,2018,5,1,7,301,408,709,309
0132-000,2018,5,1,8,501,1004,1505,709
0132-000,2018,5,1,9,674,1098,1772,1505
0132-000,2018,5,1,10,686,890,1576,1772
0132-000,2018,5,1,11,743,888,1631,1576
0132-000,2018,5,1,12,666,918,1584,1631
0132-000,2018,5,1,13,699,823,1522,1584
0132-000,2018,5,1,14,836,753,1589,1522
0132-000,2018,5,1,15,857,766,1623,1589
0132-000,2018,5,1,16,896,727,1623,1623
0132-000,2018,5,1,17,986,806,1792,1623
0132-000,2018,5,1,18,1096,793,1889,1792
0132-000,2018,5,1,19,1025,656,1681,1889
0132-000,2018,5,1,20,697,516,1213,1681
0132-000,2018,5,1,21,532,429,961,1213
0132-000,2018,5,1,22,431,346,777,961
0132-000,2018,5,1,23,313,277,590,777
0132-000,2018,5,1,24,187,200,387,590
0132-000,2018,5,2,1,133,126,259,387
0132-000,2018,5,2,2,65,101,166,259
0132-000,2018,5,2,3,59,74,133,166
0132-000,2018,5,2,4,51,68,119,133
0132-000,2018,5,2,5,91,97,188,119
0132-000,2018,5,2,6,258,184,442,188
0132-000,2018,5,2,7,481,563,1044,442
0132-000,2018,5,2,8,607,1787,2394,1044
0132-000,2018,5,2,9,778,1768,2546,2394
0132-000,2018,5,2,10,756,889,1645,2546
0132-000,2018,5,2,11,787,823,1610,1645
0132-000,2018,5,2,12,673,739,1412,1610
0132-000,2018,5,2,13,706,668,1374,1412
0132-000,2018,5,2,14,775,809,1584,1374
0132-000,2018,5,2,15,768,724,1492,1584
0132-000,2018,5,2,16,824,760,1584,1492
0132-000,2018,5,2,17,975,805,1780,1584
0132-000,2018,5,2,18,1251,799,2050,1780
0132-000,2018,5,2,19,1577,781,2358,2050
0132-000,2018,5,2,20,919,612,1531,2358
0132-000,2018,5,2,21,696,472,1168,1531
0132-000,2018,5,2,22,496,379,875,1168
0132-000,2018,5,2,23,299,297,596,875
0132-000,2018,5,2,24,200,180,380,596
0132-000,2018,5,3,1,145,150,295,380
0132-000,2018,5,3,2,76,100,176,295
0132-000,2018,5,3,3,75,75,150,176
0132-000,2018,5,3,4,63,68,131,150
0132-000,2018,5,3,5,100,103,203,131
0132-000,2018,5,3,6,287,222,509,203
0132-000,2018,5,3,7,526,608,1134,509
0132-000,2018,5,3,8,673,1872,2545,1134
0132-000,2018,5,3,9,854,1718,2572,2545
0132-000,2018,5,3,10,790,971,1761,2572
0132-000,2018,5,3,11,752,820,1572,1761
0132-000,2018,5,3,12,738,770,1508,1572
0132-000,2018,5,3,13,705,724,1429,1508
0132-000,2018,5,3,14,803,799,1602,1429
0132-000,2018,5,3,15,822,778,1600,1602
0132-000,2018,5,3,16,893,799,1692,1600
0132-000,2018,5,3,17,936,844,1780,1692
0132-000,2018,5,3,18,1309,940,2249,1780
0132-000,2018,5,3,19,1496,844,2340,2249
0132-000,2018,5,3,20,892,680,1572,2340
0132-000,2018,5,3,21,870,545,1415,1572
0132-000,2018,5,3,22,580,458,1038,1415
0132-000,2018,5,3,23,346,312,658,1038
0132-000,2018,5,3,24,238,232,470,658
0132-000,2018,5,4,1,162,130,292,470
0132-000,2018,5,4,2,97,110,207,292
0132-000,2018,5,4,3,75,83,158,207
0132-000,2018,5,4,4,63,83,146,158
0132-000,2018,5,4,5,108,97,205,146
0132-000,2018,5,4,6,294,223,517,205
0132-000,2018,5,4,7,540,612,1152,517
0132-000,2018,5,4,8,662,1962,2624,1152
0132-000,2018,5,4,9,793,1546,2339,2624
0132-000,2018,5,4,10,761,892,1653,2339
0132-000,2018,5,4,11,771,860,1631,1653
0132-000,2018,5,4,12,753,795,1548,1631
0132-000,2018,5,4,13,765,779,1544,1548
0132-000,2018,5,4,14,827,761,1588,1544
0132-000,2018,5,4,15,860,925,1785,1588
0132-000,2018,5,4,16,918,904,1822,1785
0132-000,2018,5,4,17,959,895,1854,1822
0132-000,2018,5,4,18,1442,984,2426,1854
0132-000,2018,5,4,19,1810,1012,2822,2426
0132-000,2018,5,4,20,1149,1097,2246,2822
0132-000,2018,5,4,21,911,902,1813,2246
0132-000,2018,5,4,22,639,711,1350,1813
0132-000,2018,5,4,23,428,456,884,1350
0132-000,2018,5,4,24,222,346,568,884
0132-000,2018,5,5,1,188,283,471,568
0132-000,2018,5,5,2,135,239,374,471
0132-000,2018,5,5,3,82,128,210,374
0132-000,2018,5,5,4,96,98,194,210
0132-000,2018,5,5,5,117,108,225,194
0132-000,2018,5,5,6,244,214,458,225
0132-000,2018,5,5,7,393,407,800,458
0132-000,2018,5,5,8,443,731,1174,800
0132-000,2018,5,5,9,564,973,1537,1174
0132-000,2018,5,5,10,623,1499,2122,1537
0132-000,2018,5,5,11,653,1686,2339,2122
0132-000,2018,5,5,12,666,1876,2542,2339
0132-000,2018,5,5,13,732,1763,2495,2542
0132-000,2018,5,5,14,675,1616,2291,2495
0132-000,2018,5,5,15,762,1417,2179,2291
0132-000,2018,5,5,16,838,1426,2264,2179
0132-000,2018,5,5,17,862,1309,2171,2264
0132-000,2018,5,5,18,1033,1480,2513,2171
0132-000,2018,5,5,19,1029,1152,2181,2513
0132-000,2018,5,5,20,648,977,1625,2181
0132-000,2018,5,5,21,608,568,1176,1625
0132-000,2018,5,5,22,500,408,908,1176
0132-000,2018,5,5,23,299,335,634,908
0132-000,2018,5,5,24,203,224,427,634
0132-000,2018,5,6,1,166,171,337,427
0132-000,2018,5,6,2,118,138,256,337
0132-000,2018,5,6,3,92,108,200,256
0132-000,2018,5,6,4,85,96,181,200
0132-000,2018,5,6,5,77,84,161,181
0132-000,2018,5,6,6,152,174,326,161
0132-000,2018,5,6,7,275,284,559,326
0132-000,2018,5,6,8,295,412,707,559
0132-000,2018,5,6,9,375,510,885,707
0132-000,2018,5,6,10,484,597,1081,885
0132-000,2018,5,6,11,563,614,1177,1081
0132-000,2018,5,6,12,601,654,1255,1177
0132-000,2018,5,6,13,660,641,1301,1255
0132-000,2018,5,6,14,695,727,1422,1301
0132-000,2018,5,6,15,742,664,1406,1422
0132-000,2018,5,6,16,750,683,1433,1406
0132-000,2018,5,6,17,881,669,1550,1433
0132-000,2018,5,6,18,917,637,1554,1550
0132-000,2018,5,6,19,959,581,1540,1554
0132-000,2018,5,6,20,727,507,1234,1540
0132-000,2018,5,6,21,562,453,1015,1234
0132-000,2018,5,6,22,416,373,789,1015
0132-000,2018,5,6,23,261,253,514,789
0132-000,2018,5,6,24,170,166,336,514
0132-000,2018,5,7,1,124,134,258,336
0132-000,2018,5,7,2,79,93,172,258
0132-000,2018,5,7,3,54,65,119,172
0132-000,2018,5,7,4,43,55,98,119
0132-000,2018,5,7,5,93,99,192,98
0132-000,2018,5,7,6,238,203,441,192
0132-000,2018,5,7,7,503,588,1091,441
0132-000,2018,5,7,8,632,1858,2490,1091
0132-000,2018,5,7,9,772,1613,2385,2490
0132-000,2018,5,7,10,692,847,1539,2385
0132-000,2018,5,7,11,705,826,1531,1539
0132-000,2018,5,7,12,708,758,1466,1531
0132-000,2018,5,7,13,696,724,1420,1466
0132-000,2018,5,7,14,773,777,1550,1420
0132-000,2018,5,7,15,753,725,1478,1550
0132-000,2018,5,7,16,833,769,1602,1478
0132-000,2018,5,7,17,896,753,1649,1602
0132-000,2018,5,7,18,1263,849,2112,1649
0132-000,2018,5,7,19,1550,851,2401,2112
0132-000,2018,5,7,20,933,625,1558,2401
0132-000,2018,5,7,21,790,522,1312,1558
0132-000,2018,5,7,22,534,397,931,1312
0132-000,2018,5,7,23,325,315,640,931
0132-000,2018,5,7,24,217,187,404,640
0132-000,2018,5,8,1,158,168,326,404
0132-000,2018,5,8,2,102,109,211,326
0132-000,2018,5,8,3,75,91,166,211
0132-000,2018,5,8,4,68,83,151,166
0132-000,2018,5,8,5,83,107,190,151
0132-000,2018,5,8,6,203,184,387,190
0132-000,2018,5,8,7,380,493,873,387
0132-000,2018,5,8,8,564,1445,2009,873
0132-000,2018,5,8,9,740,1366,2106,2009
0132-000,2018,5,8,10,715,915,1630,2106
0132-000,2018,5,8,11,755,872,1627,1630
0132-000,2018,5,8,12,714,852,1566,1627
0132-000,2018,5,8,13,688,775,1463,1566
0132-000,2018,5,8,14,818,755,1573,1463
0132-000,2018,5,8,15,837,821,1658,1573
0132-000,2018,5,8,16,868,782,1650,1658
0132-000,2018,5,8,17,936,788,1724,1650
0132-000,2018,5,8,18,1172,819,1991,1724
0132-000,2018,5,8,19,1260,736,1996,1991
0132-000,2018,5,8,20,780,575,1355,1996
0132-000,2018,5,8,21,681,454,1135,1355
0132-000,2018,5,8,22,501,388,889,1135
0132-000,2018,5,8,23,314,293,607,889
0132-000,2018,5,8,24,208,197,405,607
0132-000,2018,5,9,1,131,132,263,405
0132-000,2018,5,9,2,81,102,183,263
0132-000,2018,5,9,3,63,76,139,183
0132-000,2018,5,9,4,56,73,129,139
0132-000,2018,5,9,5,99,100,199,129
0132-000,2018,5,9,6,268,199,467,199
0132-000,2018,5,9,7,507,592,1099,467
0132-000,2018,5,9,8,642,1859,2501,1099
0132-000,2018,5,9,9,812,1658,2470,2501
0132-000,2018,5,9,10,744,906,1650,2470
0132-000,2018,5,9,11,800,833,1633,1650
0132-000,2018,5,9,12,710,770,1480,1633
0132-000,2018,5,9,13,704,701,1405,1480
0132-000,2018,5,9,14,771,816,1587,1405
0132-000,2018,5,9,15,799,787,1586,1587
0132-000,2018,5,9,16,843,766,1609,1586
0132-000,2018,5,9,17,987,835,1822,1609
0132-000,2018,5,9,18,1284,891,2175,1822
0132-000,2018,5,9,19,1621,811,2432,2175
0132-000,2018,5,9,20,960,646,1606,2432
0132-000,2018,5,9,21,753,502,1255,1606
0132-000,2018,5,9,22,516,404,920,1255
0132-000,2018,5,9,23,346,342,688,920
0132-000,2018,5,9,24,204,203,407,688
0132-000,2018,5,10,1,169,153,322,407
0132-000,2018,5,10,2,104,121,225,322
0132-000,2018,5,10,3,73,81,154,225
0132-000,2018,5,10,4,80,100,180,154
0132-000,2018,5,10,5,116,121,237,180
0132-000,2018,5,10,6,319,226,545,237
0132-000,2018,5,10,7,544,676,1220,545
0132-000,2018,5,10,8,694,1915,2609,1220
0132-000,2018,5,10,9,786,1560,2346,2609
0132-000,2018,5,10,10,720,914,1634,2346
0132-000,2018,5,10,11,714,813,1527,1634
0132-000,2018,5,10,12,686,773,1459,1527
0132-000,2018,5,10,13,705,712,1417,1459
0132-000,2018,5,10,14,752,725,1477,1417
0132-000,2018,5,10,15,798,763,1561,1477
0132-000,2018,5,10,16,815,793,1608,1561
0132-000,2018,5,10,17,925,842,1767,1608
0132-000,2018,5,10,18,1337,935,2272,1767
0132-000,2018,5,10,19,1514,827,2341,2272
0132-000,2018,5,10,20,912,640,1552,2341
0132-000,2018,5,10,21,899,528,1427,1552
0132-000,2018,5,10,22,597,446,1043,1427
0132-000,2018,5,10,23,358,319,677,1043
0132-000,2018,5,10,24,248,239,487,677
0132-000,2018,5,11,1,179,157,336,487
0132-000,2018,5,11,2,99,113,212,336
0132-000,2018,5,11,3,88,84,172,212
0132-000,2018,5,11,4,70,90,160,172
0132-000,2018,5,11,5,114,101,215,160
0132-000,2018,5,11,6,345,254,599,215
0132-000,2018,5,11,7,514,646,1160,599
0132-000,2018,5,11,8,661,1918,2579,1160
0132-000,2018,5,11,9,828,1506,2334,2579
0132-000,2018,5,11,10,680,885,1565,2334
0132-000,2018,5,11,11,728,876,1604,1565
0132-000,2018,5,11,12,551,810,1361,1604
0132-000,2018,5,11,13,810,720,1530,1361
0132-000,2018,5,11,14,825,811,1636,1530
0132-000,2018,5,11,15,835,797,1632,1636
0132-000,2018,5,11,16,893,905,1798,1632
0132-000,2018,5,11,17,986,888,1874,1798
0132-000,2018,5,11,18,1323,1162,2485,1874
0132-000,2018,5,11,19,1709,1328,3037,2485
0132-000,2018,5,11,20,1026,754,1780,3037
0132-000,2018,5,11,21,848,589,1437,1780
0132-000,2018,5,11,22,595,455,1050,1437
0132-000,2018,5,11,23,388,395,783,1050
0132-000,2018,5,11,24,280,253,533,783
0132-000,2018,5,12,1,187,180,367,533
0132-000,2018,5,12,2,167,142,309,367
0132-000,2018,5,12,3,103,104,207,309
0132-000,2018,5,12,4,100,116,216,207
0132-000,2018,5,12,5,111,124,235,216
0132-000,2018,5,12,6,227,192,419,235
0132-000,2018,5,12,7,374,385,759,419
0132-000,2018,5,12,8,444,821,1265,759
0132-000,2018,5,12,9,610,873,1483,1265
0132-000,2018,5,12,10,584,850,1434,1483
0132-000,2018,5,12,11,677,798,1475,1434
0132-000,2018,5,12,12,957,854,1811,1475
0132-000,2018,5,12,13,818,771,1589,1811
0132-000,2018,5,12,14,759,849,1608,1589
0132-000,2018,5,12,15,847,755,1602,1608
0132-000,2018,5,12,16,862,775,1637,1602
0132-000,2018,5,12,17,837,786,1623,1637
0132-000,2018,5,12,18,1069,781,1850,1623
0132-000,2018,5,12,19,835,670,1505,1850
0132-000,2018,5,12,20,613,526,1139,1505
0132-000,2018,5,12,21,481,472,953,1139
0132-000,2018,5,12,22,434,332,766,953
0132-000,2018,5,12,23,276,275,551,766
0132-000,2018,5,12,24,178,223,401,551
0132-000,2018,5,13,1,349,149,498,401
0132-000,2018,5,13,2,252,147,399,498
0132-000,2018,5,13,3,200,86,286,399
0132-000,2018,5,13,4,161,66,227,286
0132-000,2018,5,13,5,195,86,281,227
0132-000,2018,5,13,6,206,162,368,281
0132-000,2018,5,13,7,252,214,466,368
0132-000,2018,5,13,8,306,334,640,466
0132-000,2018,5,13,9,368,457,825,640
0132-000,2018,5,13,10,330,556,886,825
0132-000,2018,5,13,11,516,612,1128,886
0132-000,2018,5,13,12,596,638,1234,1128
0132-000,2018,5,13,13,678,634,1312,1234
0132-000,2018,5,13,14,743,696,1439,1312
0132-000,2018,5,13,15,758,655,1413,1439
0132-000,2018,5,13,16,786,674,1460,1413
0132-000,2018,5,13,17,823,676,1499,1460
0132-000,2018,5,13,18,817,647,1464,1499
0132-000,2018,5,13,19,965,579,1544,1464
0132-000,2018,5,13,20,663,517,1180,1544
0132-000,2018,5,13,21,680,477,1157,1180
0132-000,2018,5,13,22,442,374,816,1157
0132-000,2018,5,13,23,304,308,612,816
0132-000,2018,5,13,24,195,189,384,612
0132-000,2018,5,14,1,133,133,266,384
0132-000,2018,5,14,2,109,89,198,266
0132-000,2018,5,14,3,68,62,130,198
0132-000,2018,5,14,4,50,76,126,130
0132-000,2018,5,14,5,126,97,223,126
0132-000,2018,5,14,6,379,242,621,223
0132-000,2018,5,14,7,542,731,1273,621
0132-000,2018,5,14,8,589,2039,2628,1273
0132-000,2018,5,14,9,715,1626,2341,2628
0132-000,2018,5,14,10,698,886,1584,2341
0132-000,2018,5,14,11,741,826,1567,1584
0132-000,2018,5,14,12,669,790,1459,1567
0132-000,2018,5,14,13,780,750,1530,1459
0132-000,2018,5,14,14,711,721,1432,1530
0132-000,2018,5,14,15,745,778,1523,1432
0132-000,2018,5,14,16,814,734,1548,1523
0132-000,2018,5,14,17,819,822,1641,1548
0132-000,2018,5,14,18,1282,877,2159,1641
0132-000,2018,5,14,19,1418,882,2300,2159
0132-000,2018,5,14,20,975,709,1684,2300
0132-000,2018,5,14,21,823,565,1388,1684
0132-000,2018,5,14,22,635,438,1073,1388
0132-000,2018,5,14,23,377,296,673,1073
0132-000,2018,5,14,24,254,206,460,673
0132-000,2018,5,15,1,165,153,318,460
0132-000,2018,5,15,2,98,89,187,318
0132-000,2018,5,15,3,89,85,174,187
0132-000,2018,5,15,4,68,67,135,174
0132-000,2018,5,15,5,115,94,209,135
0132-000,2018,5,15,6,334,246,580,209
0132-000,2018,5,15,7,472,686,1158,580
0132-000,2018,5,15,8,626,1933,2559,1158
0132-000,2018,5,15,9,719,1615,2334,2559
0132-000,2018,5,15,10,706,908,1614,2334
0132-000,2018,5,15,11,704,820,1524,1614
0132-000,2018,5,15,12,760,799,1559,1524
0132-000,2018,5,15,13,784,755,1539,1559
0132-000,2018,5,15,14,747,770,1517,1539
0132-000,2018,5,15,15,730,831,1561,1517
0132-000,2018,5,15,16,788,768,1556,1561
0132-000,2018,5,15,17,890,830,1720,1556
0132-000,2018,5,15,18,1193,928,2121,1720
0132-000,2018,5,15,19,1380,829,2209,2121
0132-000,2018,5,15,20,1011,696,1707,2209
0132-000,2018,5,15,21,812,578,1390,1707
0132-000,2018,5,15,22,622,457,1079,1390
0132-000,2018,5,15,23,381,327,708,1079
0132-000,2018,5,15,24,260,231,491,708
0132-000,2018,5,16,1,174,154,328,491
0132-000,2018,5,16,2,107,109,216,328
0132-000,2018,5,16,3,102,85,187,216
0132-000,2018,5,16,4,35,94,129,187
0132-000,2018,5,16,5,120,103,223,129
0132-000,2018,5,16,6,241,201,442,223
0132-000,2018,5,16,7,444,560,1004,442
0132-000,2018,5,16,8,630,1898,2528,1004
0132-000,2018,5,16,9,719,1606,2325,2528
0132-000,2018,5,16,10,717,859,1576,2325
0132-000,2018,5,16,11,704,817,1521,1576
0132-000,2018,5,16,12,760,768,1528,1521
0132-000,2018,5,16,13,734,732,1466,1528
0132-000,2018,5,16,14,760,727,1487,1466
0132-000,2018,5,16,15,830,756,1586,1487
0132-000,2018,5,16,16,730,732,1462,1586
0132-000,2018,5,16,17,817,783,1600,1462
0132-000,2018,5,16,18,1226,837,2063,1600
0132-000,2018,5,16,19,1512,791,2303,2063
0132-000,2018,5,16,20,836,559,1395,2303
0132-000,2018,5,16,21,745,464,1209,1395
0132-000,2018,5,16,22,511,404,915,1209
0132-000,2018,5,16,23,304,305,609,915
0132-000,2018,5,16,24,232,217,449,609
0132-000,2018,5,17,1,76,141,217,449
0132-000,2018,5,17,2,54,111,165,217
0132-000,2018,5,17,3,38,80,118,165
0132-000,2018,5,17,4,36,86,122,118
0132-000,2018,5,17,5,36,97,133,122
0132-000,2018,5,17,6,298,222,520,133
0132-000,2018,5,17,7,468,608,1076,520
0132-000,2018,5,17,8,652,1914,2566,1076
0132-000,2018,5,17,9,768,1577,2345,2566
0132-000,2018,5,17,10,706,864,1570,2345
0132-000,2018,5,17,11,866,842,1708,1570
0132-000,2018,5,17,12,758,788,1546,1708
0132-000,2018,5,17,13,832,726,1558,1546
0132-000,2018,5,17,14,970,754,1724,1558
0132-000,2018,5,17,15,1044,766,1810,1724
0132-000,2018,5,17,16,871,784,1655,1810
0132-000,2018,5,17,17,976,834,1810,1655
0132-000,2018,5,17,18,1472,957,2429,1810
0132-000,2018,5,17,19,1628,956,2584,2429
0132-000,2018,5,17,20,918,650,1568,2584
0132-000,2018,5,17,21,810,512,1322,1568
0132-000,2018,5,17,22,554,429,983,1322
0132-000,2018,5,17,23,341,348,689,983
0132-000,2018,5,17,24,250,238,488,689
0132-000,2018,5,18,1,165,145,310,488
0132-000,2018,5,18,2,103,112,215,310
0132-000,2018,5,18,3,76,90,166,215
0132-000,2018,5,18,4,67,90,157,166
0132-000,2018,5,18,5,106,105,211,157
0132-000,2018,5,18,6,354,244,598,211
0132-000,2018,5,18,7,492,655,1147,598
0132-000,2018,5,18,8,675,1930,2605,1147
0132-000,2018,5,18,9,817,1548,2365,2605
0132-000,2018,5,18,10,696,869,1565,2365
0132-000,2018,5,18,11,1028,868,1896,1565
0132-000,2018,5,18,12,756,807,1563,1896
0132-000,2018,5,18,13,930,719,1649,1563
0132-000,2018,5,18,14,1181,782,1963,1649
0132-000,2018,5,18,15,1257,776,2033,1963
0132-000,2018,5,18,16,1012,836,1848,2033
0132-000,2018,5,18,17,1134,885,2019,1848
0132-000,2018,5,18,18,1718,1077,2795,2019
0132-000,2018,5,18,19,1744,1121,2865,2795
0132-000,2018,5,18,20,999,742,1741,2865
0132-000,2018,5,18,21,875,560,1435,1741
0132-000,2018,5,18,22,598,454,1052,1435
0132-000,2018,5,18,23,378,392,770,1052
0132-000,2018,5,18,24,268,259,527,770
0132-000,2018,5,19,1,199,188,387,527
0132-000,2018,5,19,2,151,147,298,387
0132-000,2018,5,19,3,102,104,206,298
0132-000,2018,5,19,4,93,115,208,206
0132-000,2018,5,19,5,117,127,244,208
0132-000,2018,5,19,6,260,210,470,244
0132-000,2018,5,19,7,393,450,843,470
0132-000,2018,5,19,8,473,851,1324,843
0132-000,2018,5,19,9,493,912,1405,1324
0132-000,2018,5,19,10,538,881,1419,1405
0132-000,2018,5,19,11,671,867,1538,1419
0132-000,2018,5,19,12,744,872,1616,1538
0132-000,2018,5,19,13,666,802,1468,1616
0132-000,2018,5,19,14,692,865,1557,1468
0132-000,2018,5,19,15,685,825,1510,1557
0132-000,2018,5,19,16,664,810,1474,1510
0132-000,2018,5,19,17,755,815,1570,1474
0132-000,2018,5,19,18,1207,863,2070,1570
0132-000,2018,5,19,19,1097,703,1800,2070
0132-000,2018,5,19,20,487,579,1066,1800
0132-000,2018,5,19,21,394,462,856,1066
0132-000,2018,5,19,22,332,377,709,856
0132-000,2018,5,19,23,249,308,557,709
0132-000,2018,5,19,24,198,234,432,557
0132-000,2018,5,20,1,255,162,417,432
0132-000,2018,5,20,2,184,140,324,417
0132-000,2018,5,20,3,139,87,226,324
0132-000,2018,5,20,4,96,75,171,226
0132-000,2018,5,20,5,122,92,214,171
0132-000,2018,5,20,6,141,158,299,214
0132-000,2018,5,20,7,192,255,447,299
0132-000,2018,5,20,8,229,371,600,447
0132-000,2018,5,20,9,273,448,721,600
0132-000,2018,5,20,10,297,554,851,721
0132-000,2018,5,20,11,399,602,1001,851
0132-000,2018,5,20,12,974,622,1596,1001
0132-000,2018,5,20,13,1144,592,1736,1596
0132-000,2018,5,20,14,693,657,1350,1736
0132-000,2018,5,20,15,649,648,1297,1350
0132-000,2018,5,20,16,712,651,1363,1297
0132-000,2018,5,20,17,1182,671,1853,1363
0132-000,2018,5,20,18,628,656,1284,1853
0132-000,2018,5,20,19,694,555,1249,1284
0132-000,2018,5,20,20,523,522,1045,1249
0132-000,2018,5,20,21,467,476,943,1045
0132-000,2018,5,20,22,315,383,698,943
0132-000,2018,5,20,23,224,305,529,698
0132-000,2018,5,20,24,142,184,326,529
0132-000,2018,5,21,1,95,133,228,326
0132-000,2018,5,21,2,71,85,156,228
0132-000,2018,5,21,3,55,66,121,156
0132-000,2018,5,21,4,42,72,114,121
0132-000,2018,5,21,5,92,91,183,114
0132-000,2018,5,21,6,289,245,534,183
0132-000,2018,5,21,7,409,745,1154,534
0132-000,2018,5,21,8,486,2019,2505,1154
0132-000,2018,5,21,9,589,1597,2186,2505
0132-000,2018,5,21,10,923,865,1788,2186
0132-000,2018,5,21,11,859,819,1678,1788
0132-000,2018,5,21,12,687,770,1457,1678
0132-000,2018,5,21,13,570,744,1314,1457
0132-000,2018,5,21,14,583,735,1318,1314
0132-000,2018,5,21,15,796,819,1615,1318
0132-000,2018,5,21,16,837,713,1550,1615
0132-000,2018,5,21,17,907,842,1749,1550
0132-000,2018,5,21,18,1292,886,2178,1749
0132-000,2018,5,21,19,1467,834,2301,2178
0132-000,2018,5,21,20,985,713,1698,2301
0132-000,2018,5,21,21,838,527,1365,1698
0132-000,2018,5,21,22,639,441,1080,1365
0132-000,2018,5,21,23,375,295,670,1080
0132-000,2018,5,21,24,226,202,428,670
0132-000,2018,5,22,1,163,143,306,428
0132-000,2018,5,22,2,93,87,180,306
0132-000,2018,5,22,3,73,85,158,180
0132-000,2018,5,22,4,63,72,135,158
0132-000,2018,5,22,5,116,109,225,135
0132-000,2018,5,22,6,352,248,600,225
0132-000,2018,5,22,7,501,658,1159,600
0132-000,2018,5,22,8,688,1947,2635,1159
0132-000,2018,5,22,9,775,1624,2399,2635
0132-000,2018,5,22,10,767,897,1664,2399
0132-000,2018,5,22,11,764,812,1576,1664
0132-000,2018,5,22,12,749,794,1543,1576
0132-000,2018,5,22,13,743,745,1488,1543
0132-000,2018,5,22,14,750,737,1487,1488
0132-000,2018,5,22,15,764,826,1590,1487
0132-000,2018,5,22,16,816,778,1594,1590
0132-000,2018,5,22,17,897,814,1711,1594
0132-000,2018,5,22,18,1247,944,2191,1711
0132-000,2018,5,22,19,1496,841,2337,2191
0132-000,2018,5,22,20,974,673,1647,2337
0132-000,2018,5,22,21,846,544,1390,1647
0132-000,2018,5,22,22,655,433,1088,1390
0132-000,2018,5,22,23,364,334,698,1088
0132-000,2018,5,22,24,236,221,457,698
0132-000,2018,5,23,1,152,143,295,457
0132-000,2018,5,23,2,94,106,200,295
0132-000,2018,5,23,3,82,80,162,200
0132-000,2018,5,23,4,46,84,130,162
0132-000,2018,5,23,5,110,102,212,130
0132-000,2018,5,23,6,254,200,454,212
0132-000,2018,5,23,7,476,576,1052,454
0132-000,2018,5,23,8,636,1878,2514,1052
0132-000,2018,5,23,9,766,1632,2398,2514
0132-000,2018,5,23,10,730,882,1612,2398
0132-000,2018,5,23,11,752,825,1577,1612
0132-000,2018,5,23,12,735,769,1504,1577
0132-000,2018,5,23,13,719,716,1435,1504
0132-000,2018,5,23,14,766,772,1538,1435
0132-000,2018,5,23,15,830,811,1641,1538
0132-000,2018,5,23,16,853,833,1686,1641
0132-000,2018,5,23,17,1036,938,1974,1686
0132-000,2018,5,23,18,1614,927,2541,1974
0132-000,2018,5,23,19,1838,841,2679,2541
0132-000,2018,5,23,20,945,658,1603,2679
0132-000,2018,5,23,21,801,533,1334,1603
0132-000,2018,5,23,22,592,430,1022,1334
0132-000,2018,5,23,23,362,336,698,1022
0132-000,2018,5,23,24,216,201,417,698
0132-000,2018,5,24,1,156,151,307,417
0132-000,2018,5,24,2,76,105,181,307
0132-000,2018,5,24,3,68,78,146,181
0132-000,2018,5,24,4,63,66,129,146
0132-000,2018,5,24,5,98,111,209,129
0132-000,2018,5,24,6,326,254,580,209
0132-000,2018,5,24,7,497,671,1168,580
0132-000,2018,5,24,8,704,1958,2662,1168
0132-000,2018,5,24,9,809,1643,2452,2662
0132-000,2018,5,24,10,767,931,1698,2452
0132-000,2018,5,24,11,790,849,1639,1698
0132-000,2018,5,24,12,722,822,1544,1639
0132-000,2018,5,24,13,768,683,1451,1544
0132-000,2018,5,24,14,861,793,1654,1451
0132-000,2018,5,24,15,921,782,1703,1654
0132-000,2018,5,24,16,843,735,1578,1703
0132-000,2018,5,24,17,950,774,1724,1578
0132-000,2018,5,24,18,1404,935,2339,1724
0132-000,2018,5,24,19,1571,890,2461,2339
0132-000,2018,5,24,20,915,663,1578,2461
0132-000,2018,5,24,21,854,507,1361,1578
0132-000,2018,5,24,22,576,422,998,1361
0132-000,2018,5,24,23,359,333,692,998
0132-000,2018,5,24,24,251,205,456,692
0132-000,2018,5,25,1,150,132,282,456
0132-000,2018,5,25,2,107,111,218,282
0132-000,2018,5,25,3,64,96,160,218
0132-000,2018,5,25,4,63,89,152,160
0132-000,2018,5,25,5,97,108,205,152
0132-000,2018,5,25,6,362,234,596,205
0132-000,2018,5,25,7,470,663,1133,596
0132-000,2018,5,25,8,689,1941,2630,1133
0132-000,2018,5,25,9,806,1590,2396,2630
0132-000,2018,5,25,10,711,852,1563,2396
0132-000,2018,5,25,11,878,859,1737,1563
0132-000,2018,5,25,12,654,803,1457,1737
0132-000,2018,5,25,13,870,717,1587,1457
0132-000,2018,5,25,14,1003,753,1756,1587
0132-000,2018,5,25,15,1046,755,1801,1756
0132-000,2018,5,25,16,952,767,1719,1801
0132-000,2018,5,25,17,1060,881,1941,1719
0132-000,2018,5,25,18,1520,992,2512,1941
0132-000,2018,5,25,19,1726,914,2640,2512
0132-000,2018,5,25,20,1012,730,1742,2640
0132-000,2018,5,25,21,862,530,1392,1742
0132-000,2018,5,25,22,596,452,1048,1392
0132-000,2018,5,25,23,367,389,756,1048
0132-000,2018,5,25,24,256,265,521,756
0132-000,2018,5,26,1,211,195,406,521
0132-000,2018,5,26,2,135,152,287,406
0132-000,2018,5,26,3,101,103,204,287
0132-000,2018,5,26,4,85,113,198,204
0132-000,2018,5,26,5,123,129,252,198
0132-000,2018,5,26,6,292,227,519,252
0132-000,2018,5,26,7,384,515,899,519
0132-000,2018,5,26,8,458,881,1339,899
0132-000,2018,5,26,9,552,951,1503,1339
0132-000,2018,5,26,10,561,911,1472,1503
0132-000,2018,5,26,11,674,935,1609,1472
0132-000,2018,5,26,12,850,889,1739,1609
0132-000,2018,5,26,13,742,833,1575,1739
0132-000,2018,5,26,14,726,880,1606,1575
0132-000,2018,5,26,15,766,895,1661,1606
0132-000,2018,5,26,16,763,845,1608,1661
0132-000,2018,5,26,17,796,843,1639,1608
0132-000,2018,5,26,18,1138,944,2082,1639
0132-000,2018,5,26,19,966,736,1702,2082
0132-000,2018,5,26,20,550,631,1181,1702
0132-000,2018,5,26,21,438,451,889,1181
0132-000,2018,5,26,22,383,422,805,889
0132-000,2018,5,26,23,262,340,602,805
0132-000,2018,5,26,24,217,244,461,602
0132-000,2018,5,27,1,160,175,335,461
0132-000,2018,5,27,2,115,133,248,335
0132-000,2018,5,27,3,170,88,258,248
0132-000,2018,5,27,4,128,83,211,258
0132-000,2018,5,27,5,158,98,256,211
0132-000,2018,5,27,6,174,154,328,256
0132-000,2018,5,27,7,222,296,518,328
0132-000,2018,5,27,8,268,407,675,518
0132-000,2018,5,27,9,320,439,759,675
0132-000,2018,5,27,10,314,552,866,759
0132-000,2018,5,27,11,458,591,1049,866
0132-000,2018,5,27,12,785,606,1391,1049
0132-000,2018,5,27,13,911,550,1461,1391
0132-000,2018,5,27,14,718,618,1336,1461
0132-000,2018,5,27,15,704,641,1345,1336
0132-000,2018,5,27,16,749,628,1377,1345
0132-000,2018,5,27,17,1002,665,1667,1377
0132-000,2018,5,27,18,722,664,1386,1667
0132-000,2018,5,27,19,830,531,1361,1386
0132-000,2018,5,27,20,593,526,1119,1361
0132-000,2018,5,27,21,574,475,1049,1119
0132-000,2018,5,27,22,378,392,770,1049
0132-000,2018,5,27,23,264,302,566,770
0132-000,2018,5,27,24,168,179,347,566
0132-000,2018,5,28,1,56,132,188,347
0132-000,2018,5,28,2,32,81,113,188
0132-000,2018,5,28,3,42,69,111,113
0132-000,2018,5,28,4,34,68,102,111
0132-000,2018,5,28,5,58,84,142,102
0132-000,2018,5,28,6,319,248,567,142
0132-000,2018,5,28,7,473,758,1231,567
0132-000,2018,5,28,8,600,1999,2599,1231
0132-000,2018,5,28,9,698,1568,2266,2599
0132-000,2018,5,28,10,830,844,1674,2266
0132-000,2018,5,28,11,816,812,1628,1674
0132-000,2018,5,28,12,726,750,1476,1628
0132-000,2018,5,28,13,654,737,1391,1476
0132-000,2018,5,28,14,688,749,1437,1391
0132-000,2018,5,28,15,846,860,1706,1437
0132-000,2018,5,28,16,859,691,1550,1706
0132-000,2018,5,28,17,995,861,1856,1550
0132-000,2018,5,28,18,1302,894,2196,1856
0132-000,2018,5,28,19,1515,785,2300,2196
0132-000,2018,5,28,20,994,717,1711,2300
0132-000,2018,5,28,21,853,489,1342,1711
0132-000,2018,5,28,22,643,444,1087,1342
0132-000,2018,5,28,23,372,294,666,1087
0132-000,2018,5,28,24,198,198,396,666
0132-000,2018,5,29,1,160,132,292,396
0132-000,2018,5,29,2,87,85,172,292
0132-000,2018,5,29,3,57,85,142,172
0132-000,2018,5,29,4,58,76,134,142
0132-000,2018,5,29,5,117,124,241,134
0132-000,2018,5,29,6,369,249,618,241
0132-000,2018,5,29,7,530,630,1160,618
0132-000,2018,5,29,8,750,1960,2710,1160
0132-000,2018,5,29,9,831,1632,2463,2710
0132-000,2018,5,29,10,828,885,1713,2463
0132-000,2018,5,29,11,823,804,1627,1713
0132-000,2018,5,29,12,738,789,1527,1627
0132-000,2018,5,29,13,701,735,1436,1527
0132-000,2018,5,29,14,753,704,1457,1436
0132-000,2018,5,29,15,797,820,1617,1457
0132-000,2018,5,29,16,844,787,1631,1617
0132-000,2018,5,29,17,903,797,1700,1631
0132-000,2018,5,29,18,1300,959,2259,1700
0132-000,2018,5,29,19,1611,852,2463,2259
0132-000,2018,5,29,20,937,650,1587,2463
0132-000,2018,5,29,21,880,510,1390,1587
0132-000,2018,5,29,22,688,409,1097,1390
0132-000,2018,5,29,23,346,341,687,1097
0132-000,2018,5,29,24,212,210,422,687
0132-000,2018,5,30,1,148,138,286,422
0132-000,2018,5,30,2,105,85,190,286
0132-000,2018,5,30,3,81,87,168,190
0132-000,2018,5,30,4,60,79,139,168
0132-000,2018,5,30,5,111,87,198,139
0132-000,2018,5,30,6,310,222,532,198
0132-000,2018,5,30,7,552,621,1173,532
0132-000,2018,5,30,8,735,1871,2606,1173
0132-000,2018,5,30,9,867,1638,2505,2606
0132-000,2018,5,30,10,922,983,1905,2505
0132-000,2018,5,30,11,958,835,1793,1905
0132-000,2018,5,30,12,895,787,1682,1793
0132-000,2018,5,30,13,837,753,1590,1682
0132-000,2018,5,30,14,860,805,1665,1590
0132-000,2018,5,30,15,859,837,1696,1665
0132-000,2018,5,30,16,926,800,1726,1696
0132-000,2018,5,30,17,962,879,1841,1726
0132-000,2018,5,30,18,1331,902,2233,1841
0132-000,2018,5,30,19,1694,837,2531,2233
0132-000,2018,5,30,20,957,676,1633,2531
0132-000,2018,5,30,21,792,509,1301,1633
0132-000,2018,5,30,22,517,443,960,1301
0132-000,2018,5,30,23,388,336,724,960
0132-000,2018,5,30,24,229,226,455,724
0132-000,2018,5,31,1,160,175,335,455
0132-000,2018,5,31,2,106,111,217,335
0132-000,2018,5,31,3,79,103,182,217
0132-000,2018,5,31,4,59,78,137,182
0132-000,2018,5,31,5,106,103,209,137
0132-000,2018,5,31,6,315,229,544,209
0132-000,2018,5,31,7,488,654,1142,544
0132-000,2018,5,31,8,688,1913,2601,1142
0132-000,2018,5,31,9,841,1576,2417,2601
0132-000,2018,5,31,10,702,863,1565,2417
0132-000,2018,5,31,11,700,839,1539,1565
0132-000,2018,5,31,12,759,745,1504,1539
0132-000,2018,5,31,13,686,694,1380,1504
0132-000,2018,5,31,14,777,736,1513,1380
0132-000,2018,5,31,15,761,693,1454,1513
0132-000,2018,5,31,16,824,776,1600,1454
0132-000,2018,5,31,17,910,828,1738,1600
0132-000,2018,5,31,18,1289,867,2156,1738
0132-000,2018,5,31,19,1549,881,2430,2156
0132-000,2018,5,31,20,960,663,1623,2430
0132-000,2018,5,31,21,840,527,1367,1623
0132-000,2018,5,31,22,587,457,1044,1367
0132-000,2018,5,31,23,409,324,733,1044
0132-000,2018,5,31,24,253,229,482,733
0132-000,2018,6,1,1,165,149,314,482
0132-000,2018,6,1,2,101,113,214,314
0132-000,2018,6,1,3,86,83,169,214
0132-000,2018,6,1,4,54,99,153,169
0132-000,2018,6,1,5,106,103,209,153
0132-000,2018,6,1,6,319,247,566,209
0132-000,2018,6,1,7,536,607,1143,566
0132-000,2018,6,1,8,704,1928,2632,1143
0132-000,2018,6,1,9,811,1567,2378,2632
0132-000,2018,6,1,10,803,869,1672,2378
0132-000,2018,6,1,11,747,837,1584,1672
0132-000,2018,6,1,12,763,775,1538,1584
0132-000,2018,6,1,13,738,739,1477,1538
0132-000,2018,6,1,14,762,721,1483,1477
0132-000,2018,6,1,15,818,789,1607,1483
0132-000,2018,6,1,16,846,811,1657,1607
0132-000,2018,6,1,17,964,887,1851,1657
0132-000,2018,6,1,18,1394,1043,2437,1851
0132-000,2018,6,1,19,1772,876,2648,2437
0132-000,2018,6,1,20,1116,822,1938,2648
0132-000,2018,6,1,21,827,541,1368,1938
0132-000,2018,6,1,22,598,439,1037,1368
0132-000,2018,6,1,23,420,391,811,1037
0132-000,2018,6,1,24,224,266,490,811
0132-000,2018,6,2,1,184,182,366,490
0132-000,2018,6,2,2,141,152,293,366
0132-000,2018,6,2,3,76,110,186,293
0132-000,2018,6,2,4,92,91,183,186
0132-000,2018,6,2,5,139,125,264,183
0132-000,2018,6,2,6,311,234,545,264
0132-000,2018,6,2,7,411,451,862,545
0132-000,2018,6,2,8,503,811,1314,862
0132-000,2018,6,2,9,641,843,1484,1314
0132-000,2018,6,2,10,690,962,1652,1484
0132-000,2018,6,2,11,775,952,1727,1652
0132-000,2018,6,2,12,885,912,1797,1727
0132-000,2018,6,2,13,871,899,1770,1797
0132-000,2018,6,2,14,820,861,1681,1770
0132-000,2018,6,2,15,777,891,1668,1681
0132-000,2018,6,2,16,909,852,1761,1668
0132-000,2018,6,2,17,984,832,1816,1761
0132-000,2018,6,2,18,1071,969,2040,1816
0132-000,2018,6,2,19,999,784,1783,2040
0132-000,2018,6,2,20,717,611,1328,1783
0132-000,2018,6,2,21,598,542,1140,1328
0132-000,2018,6,2,22,439,399,838,1140
0132-000,2018,6,2,23,330,333,663,838
0132-000,2018,6,2,24,212,239,451,663
0132-000,2018,6,3,1,162,184,346,451
0132-000,2018,6,3,2,111,132,243,346
0132-000,2018,6,3,3,97,116,213,243
0132-000,2018,6,3,4,71,82,153,213
0132-000,2018,6,3,5,99,92,191,153
0132-000,2018,6,3,6,209,189,398,191
0132-000,2018,6,3,7,253,265,518,398
0132-000,2018,6,3,8,308,383,691,518
0132-000,2018,6,3,9,367,439,806,691
0132-000,2018,6,3,10,417,536,953,806
0132-000,2018,6,3,11,556,622,1178,953
0132-000,2018,6,3,12,552,611,1163,1178
0132-000,2018,6,3,13,683,646,1329,1163
0132-000,2018,6,3,14,584,698,1282,1329
0132-000,2018,6,3,15,676,693,1369,1282
0132-000,2018,6,3,16,773,680,1453,1369
0132-000,2018,6,3,17,786,671,1457,1453
0132-000,2018,6,3,18,954,680,1634,1457
0132-000,2018,6,3,19,834,552,1386,1634
0132-000,2018,6,3,20,654,484,1138,1386
0132-000,2018,6,3,21,544,494,1038,1138
0132-000,2018,6,3,22,507,372,879,1038
0132-000,2018,6,3,23,300,295,595,879
0132-000,2018,6,3,24,171,167,338,595
0132-000,2018,6,4,1,133,139,272,338
0132-000,2018,6,4,2,72,79,151,272
0132-000,2018,6,4,3,33,59,92,151
0132-000,2018,6,4,4,57,78,135,92
0132-000,2018,6,4,5,103,93,196,135
0132-000,2018,6,4,6,349,252,601,196
0132-000,2018,6,4,7,537,668,1205,601
0132-000,2018,6,4,8,715,2005,2720,1205
0132-000,2018,6,4,9,807,1533,2340,2720
0132-000,2018,6,4,10,738,859,1597,2340
0132-000,2018,6,4,11,773,848,1621,1597
0132-000,2018,6,4,12,766,771,1537,1621
0132-000,2018,6,4,13,739,734,1473,1537
0132-000,2018,6,4,14,792,794,1586,1473
0132-000,2018,6,4,15,914,834,1748,1586
0132-000,2018,6,4,16,1070,858,1928,1748
0132-000,2018,6,4,17,1094,852,1946,1928
0132-000,2018,6,4,18,1208,951,2159,1946
0132-000,2018,6,4,19,1505,841,2346,2159
0132-000,2018,6,4,20,955,631,1586,2346
0132-000,2018,6,4,21,806,493,1299,1586
0132-000,2018,6,4,22,601,392,993,1299
0132-000,2018,6,4,23,343,314,657,993
0132-000,2018,6,4,24,187,177,364,657
0132-000,2018,6,5,1,158,116,274,364
0132-000,2018,6,5,2,88,95,183,274
0132-000,2018,6,5,3,57,73,130,183
0132-000,2018,6,5,4,57,77,134,130
0132-000,2018,6,5,5,111,112,223,134
0132-000,2018,6,5,6,340,234,574,223
0132-000,2018,6,5,7,550,664,1214,574
0132-000,2018,6,5,8,704,1913,2617,1214
0132-000,2018,6,5,9,835,1590,2425,2617
0132-000,2018,6,5,10,770,903,1673,2425
0132-000,2018,6,5,11,746,842,1588,1673
0132-000,2018,6,5,12,795,770,1565,1588
0132-000,2018,6,5,13,830,725,1555,1565
0132-000,2018,6,5,14,828,785,1613,1555
0132-000,2018,6,5,15,1015,812,1827,1613
0132-000,2018,6,5,16,921,803,1724,1827
0132-000,2018,6,5,17,1158,910,2068,1724
0132-000,2018,6,5,18,1327,903,2230,2068
0132-000,2018,6,5,19,1607,945,2552,2230
0132-000,2018,6,5,20,994,789,1783,2552
0132-000,2018,6,5,21,876,551,1427,1783
0132-000,2018,6,5,22,601,458,1059,1427
0132-000,2018,6,5,23,398,383,781,1059
0132-000,2018,6,5,24,242,280,522,781
0132-000,2018,6,6,1,182,198,380,522
0132-000,2018,6,6,2,116,142,258,380
0132-000,2018,6,6,3,112,121,233,258
0132-000,2018,6,6,4,80,83,163,233
0132-000,2018,6,6,5,148,131,279,163
0132-000,2018,6,6,6,311,254,565,279
0132-000,2018,6,6,7,452,477,929,565
0132-000,2018,6,6,8,472,874,1346,929
0132-000,2018,6,6,9,580,849,1429,1346
0132-000,2018,6,6,10,657,761,1418,1429
0132-000,2018,6,6,11,664,818,1482,1418
0132-000,2018,6,6,12,704,808,1512,1482
0132-000,2018,6,6,13,834,783,1617,1512
0132-000,2018,6,6,14,868,778,1646,1617
0132-000,2018,6,6,15,797,744,1541,1646
0132-000,2018,6,6,16,1098,733,1831,1541
0132-000,2018,6,6,17,1081,774,1855,1831
0132-000,2018,6,6,18,1280,801,2081,1855
0132-000,2018,6,6,19,1124,726,1850,2081
0132-000,2018,6,6,20,809,582,1391,1850
0132-000,2018,6,6,21,689,443,1132,1391
0132-000,2018,6,6,22,419,388,807,1132
0132-000,2018,6,6,23,336,304,640,807
0132-000,2018,6,6,24,172,192,364,640
0132-000,2018,6,7,1,121,108,229,364
0132-000,2018,6,7,2,70,91,161,229
0132-000,2018,6,7,3,56,62,118,161
0132-000,2018,6,7,4,61,78,139,118
0132-000,2018,6,7,5,112,89,201,139
0132-000,2018,6,7,6,371,248,619,201
0132-000,2018,6,7,7,546,633,1179,619
0132-000,2018,6,7,8,707,1943,2650,1179
0132-000,2018,6,7,9,853,1655,2508,2650
0132-000,2018,6,7,10,769,995,1764,2508
0132-000,2018,6,7,11,778,792,1570,1764
0132-000,2018,6,7,12,749,792,1541,1570
0132-000,2018,6,7,13,729,757,1486,1541
0132-000,2018,6,7,14,767,770,1537,1486
0132-000,2018,6,7,15,817,834,1651,1537
0132-000,2018,6,7,16,859,757,1616,1651
0132-000,2018,6,7,17,929,843,1772,1616
0132-000,2018,6,7,18,1262,942,2204,1772
0132-000,2018,6,7,19,1483,840,2323,2204
0132-000,2018,6,7,20,1014,695,1709,2323
0132-000,2018,6,7,21,803,522,1325,1709
0132-000,2018,6,7,22,574,439,1013,1325
0132-000,2018,6,7,23,349,333,682,1013
0132-000,2018,6,7,24,218,205,423,682
0132-000,2018,6,8,1,182,151,333,423
0132-000,2018,6,8,2,106,79,185,333
0132-000,2018,6,8,3,71,86,157,185
0132-000,2018,6,8,4,58,83,141,157
0132-000,2018,6,8,5,115,132,247,141
0132-000,2018,6,8,6,355,246,601,247
0132-000,2018,6,8,7,518,648,1166,601
0132-000,2018,6,8,8,663,1877,2540,1166
0132-000,2018,6,8,9,820,1615,2435,2540
0132-000,2018,6,8,10,768,870,1638,2435
0132-000,2018,6,8,11,753,833,1586,1638
0132-000,2018,6,8,12,771,759,1530,1586
0132-000,2018,6,8,13,774,714,1488,1530
0132-000,2018,6,8,14,898,784,1682,1488
0132-000,2018,6,8,15,1004,768,1772,1682
0132-000,2018,6,8,16,927,822,1749,1772
0132-000,2018,6,8,17,981,846,1827,1749
0132-000,2018,6,8,18,1331,979,2310,1827
0132-000,2018,6,8,19,1601,920,2521,2310
0132-000,2018,6,8,20,1100,784,1884,2521
0132-000,2018,6,8,21,845,587,1432,1884
0132-000,2018,6,8,22,601,491,1092,1432
0132-000,2018,6,8,23,358,363,721,1092
0132-000,2018,6,8,24,251,240,491,721
0132-000,2018,6,9,1,212,183,395,491
0132-000,2018,6,9,2,134,129,263,395
0132-000,2018,6,9,3,108,129,237,263
0132-000,2018,6,9,4,94,105,199,237
0132-000,2018,6,9,5,112,139,251,199
0132-000,2018,6,9,6,308,246,554,251
0132-000,2018,6,9,7,445,415,860,554
0132-000,2018,6,9,8,493,830,1323,860
0132-000,2018,6,9,9,667,940,1607,1323
0132-000,2018,6,9,10,680,857,1537,1607
0132-000,2018,6,9,11,759,853,1612,1537
0132-000,2018,6,9,12,842,875,1717,1612
0132-000,2018,6,9,13,840,816,1656,1717
0132-000,2018,6,9,14,888,854,1742,1656
0132-000,2018,6,9,15,823,837,1660,1742
0132-000,2018,6,9,16,796,821,1617,1660
0132-000,2018,6,9,17,873,900,1773,1617
0132-000,2018,6,9,18,1107,817,1924,1773
0132-000,2018,6,9,19,997,727,1724,1924
0132-000,2018,6,9,20,748,621,1369,1724
0132-000,2018,6,9,21,509,457,966,1369
0132-000,2018,6,9,22,430,366,796,966
0132-000,2018,6,9,23,384,302,686,796
0132-000,2018,6,9,24,205,221,426,686
0132-000,2018,6,10,1,153,172,325,426
0132-000,2018,6,10,2,125,144,269,325
0132-000,2018,6,10,3,81,93,174,269
0132-000,2018,6,10,4,87,85,172,174
0132-000,2018,6,10,5,118,88,206,172
0132-000,2018,6,10,6,239,138,377,206
0132-000,2018,6,10,7,311,230,541,377
0132-000,2018,6,10,8,328,348,676,541
0132-000,2018,6,10,9,381,443,824,676
0132-000,2018,6,10,10,432,510,942,824
0132-000,2018,6,10,11,536,612,1148,942
0132-000,2018,6,10,12,588,640,1228,1148
0132-000,2018,6,10,13,615,600,1215,1228
0132-000,2018,6,10,14,629,641,1270,1215
0132-000,2018,6,10,15,729,681,1410,1270
0132-000,2018,6,10,16,788,707,1495,1410
0132-000,2018,6,10,17,1138,677,1815,1495
0132-000,2018,6,10,18,813,642,1455,1815
0132-000,2018,6,10,19,781,555,1336,1455
0132-000,2018,6,10,20,631,498,1129,1336
0132-000,2018,6,10,21,535,459,994,1129
0132-000,2018,6,10,22,375,388,763,994
0132-000,2018,6,10,23,296,303,599,763
0132-000,2018,6,10,24,181,198,379,599
0132-000,2018,6,11,1,106,101,207,379
0132-000,2018,6,11,2,68,76,144,207
0132-000,2018,6,11,3,54,48,102,144
0132-000,2018,6,11,4,49,76,125,102
0132-000,2018,6,11,5,128,106,234,125
0132-000,2018,6,11,6,353,258,611,234
0132-000,2018,6,11,7,565,717,1282,611
0132-000,2018,6,11,8,691,2025,2716,1282
0132-000,2018,6,11,9,794,1631,2425,2716
0132-000,2018,6,11,10,750,842,1592,2425
0132-000,2018,6,11,11,801,899,1700,1592
0132-000,2018,6,11,12,810,771,1581,1700
0132-000,2018,6,11,13,692,740,1432,1581
0132-000,2018,6,11,14,795,738,1533,1432
0132-000,2018,6,11,15,796,819,1615,1533
0132-000,2018,6,11,16,815,810,1625,1615
0132-000,2018,6,11,17,864,811,1675,1625
0132-000,2018,6,11,18,1225,875,2100,1675
0132-000,2018,6,11,19,1479,846,2325,2100
0132-000,2018,6,11,20,1028,626,1654,2325
0132-000,2018,6,11,21,812,520,1332,1654
0132-000,2018,6,11,22,565,396,961,1332
0132-000,2018,6,11,23,342,303,645,961
0132-000,2018,6,11,24,194,187,381,645
0132-000,2018,6,12,1,156,110,266,381
0132-000,2018,6,12,2,88,100,188,266
0132-000,2018,6,12,3,81,67,148,188
0132-000,2018,6,12,4,71,83,154,148
0132-000,2018,6,12,5,128,101,229,154
0132-000,2018,6,12,6,383,243,626,229
0132-000,2018,6,12,7,549,650,1199,626
0132-000,2018,6,12,8,746,1942,2688,1199
0132-000,2018,6,12,9,923,1641,2564,2688
0132-000,2018,6,12,10,834,908,1742,2564
0132-000,2018,6,12,11,855,831,1686,1742
0132-000,2018,6,12,12,886,759,1645,1686
0132-000,2018,6,12,13,811,692,1503,1645
0132-000,2018,6,12,14,806,817,1623,1503
0132-000,2018,6,12,15,915,787,1702,1623
0132-000,2018,6,12,16,916,791,1707,1702
0132-000,2018,6,12,17,1006,892,1898,1707
0132-000,2018,6,12,18,1447,990,2437,1898
0132-000,2018,6,12,19,1741,902,2643,2437
0132-000,2018,6,12,20,1578,695,2273,2643
0132-000,2018,6,12,21,854,568,1422,2273
0132-000,2018,6,12,22,647,466,1113,1422
0132-000,2018,6,12,23,431,378,809,1113
0132-000,2018,6,12,24,274,270,544,809
0132-000,2018,6,13,1,201,198,399,544
0132-000,2018,6,13,2,150,171,321,399
0132-000,2018,6,13,3,118,99,217,321
0132-000,2018,6,13,4,89,110,199,217
0132-000,2018,6,13,5,132,166,298,199
0132-000,2018,6,13,6,258,225,483,298
0132-000,2018,6,13,7,435,463,898,483
0132-000,2018,6,13,8,517,932,1449,898
0132-000,2018,6,13,9,628,912,1540,1449
0132-000,2018,6,13,10,683,871,1554,1540
0132-000,2018,6,13,11,673,841,1514,1554
0132-000,2018,6,13,12,767,821,1588,1514
0132-000,2018,6,13,13,774,776,1550,1588
0132-000,2018,6,13,14,781,789,1570,1550
0132-000,2018,6,13,15,790,768,1558,1570
0132-000,2018,6,13,16,939,794,1733,1558
0132-000,2018,6,13,17,967,839,1806,1733
0132-000,2018,6,13,18,1189,819,2008,1806
0132-000,2018,6,13,19,968,642,1610,2008
0132-000,2018,6,13,20,688,561,1249,1610
0132-000,2018,6,13,21,592,461,1053,1249
0132-000,2018,6,13,22,426,381,807,1053
0132-000,2018,6,13,23,275,298,573,807
0132-000,2018,6,13,24,188,169,357,573
0132-000,2018,6,14,1,134,122,256,357
0132-000,2018,6,14,2,77,80,157,256
0132-000,2018,6,14,3,66,74,140,157
0132-000,2018,6,14,4,73,75,148,140
0132-000,2018,6,14,5,120,121,241,148
0132-000,2018,6,14,6,343,282,625,241
0132-000,2018,6,14,7,527,642,1169,625
0132-000,2018,6,14,8,656,1889,2545,1169
0132-000,2018,6,14,9,822,1673,2495,2545
0132-000,2018,6,14,10,743,873,1616,2495
0132-000,2018,6,14,11,754,810,1564,1616
0132-000,2018,6,14,12,763,849,1612,1564
0132-000,2018,6,14,13,674,755,1429,1612
0132-000,2018,6,14,14,831,761,1592,1429
0132-000,2018,6,14,15,822,790,1612,1592
0132-000,2018,6,14,16,861,758,1619,1612
0132-000,2018,6,14,17,898,824,1722,1619
0132-000,2018,6,14,18,1254,905,2159,1722
0132-000,2018,6,14,19,1472,817,2289,2159
0132-000,2018,6,14,20,1000,679,1679,2289
0132-000,2018,6,14,21,843,525,1368,1679
0132-000,2018,6,14,22,584,417,1001,1368
0132-000,2018,6,14,23,356,318,674,1001
0132-000,2018,6,14,24,235,229,464,674
0132-000,2018,6,15,1,141,139,280,464
0132-000,2018,6,15,2,115,115,230,280
0132-000,2018,6,15,3,80,88,168,230
0132-000,2018,6,15,4,68,89,157,168
0132-000,2018,6,15,5,112,116,228,157
0132-000,2018,6,15,6,349,233,582,228
0132-000,2018,6,15,7,556,629,1185,582
0132-000,2018,6,15,8,684,1875,2559,1185
0132-000,2018,6,15,9,738,1523,2261,2559
0132-000,2018,6,15,10,760,878,1638,2261
0132-000,2018,6,15,11,756,864,1620,1638
0132-000,2018,6,15,12,817,787,1604,1620
0132-000,2018,6,15,13,776,728,1504,1604
0132-000,2018,6,15,14,806,769,1575,1504
0132-000,2018,6,15,15,830,764,1594,1575
0132-000,2018,6,15,16,933,835,1768,1594
0132-000,2018,6,15,17,966,846,1812,1768
0132-000,2018,6,15,18,1467,974,2441,1812
0132-000,2018,6,15,19,2044,931,2975,2441
0132-000,2018,6,15,20,1140,764,1904,2975
0132-000,2018,6,15,21,830,569,1399,1904
0132-000,2018,6,15,22,631,483,1114,1399
0132-000,2018,6,15,23,381,395,776,1114
0132-000,2018,6,15,24,278,254,532,776
0132-000,2018,6,16,1,205,175,380,532
0132-000,2018,6,16,2,150,169,319,380
0132-000,2018,6,16,3,99,110,209,319
0132-000,2018,6,16,4,80,103,183,209
0132-000,2018,6,16,5,131,150,281,183
0132-000,2018,6,16,6,326,255,581,281
0132-000,2018,6,16,7,433,415,848,581
0132-000,2018,6,16,8,491,772,1263,848
0132-000,2018,6,16,9,627,913,1540,1263
0132-000,2018,6,16,10,740,862,1602,1540
0132-000,2018,6,16,11,749,907,1656,1602
0132-000,2018,6,16,12,739,891,1630,1656
0132-000,2018,6,16,13,793,820,1613,1630
0132-000,2018,6,16,14,796,834,1630,1613
0132-000,2018,6,16,15,845,795,1640,1630
0132-000,2018,6,16,16,810,851,1661,1640
0132-000,2018,6,16,17,943,845,1788,1661
0132-000,2018,6,16,18,1122,986,2108,1788
0132-000,2018,6,16,19,1060,748,1808,2108
0132-000,2018,6,16,20,815,602,1417,1808
0132-000,2018,6,16,21,589,467,1056,1417
0132-000,2018,6,16,22,434,406,840,1056
0132-000,2018,6,16,23,357,334,691,840
0132-000,2018,6,16,24,208,246,454,691
0132-000,2018,6,17,1,184,166,350,454
0132-000,2018,6,17,2,137,161,298,350
0132-000,2018,6,17,3,86,110,196,298
0132-000,2018,6,17,4,87,97,184,196
0132-000,2018,6,17,5,126,111,237,184
0132-000,2018,6,17,6,192,171,363,237
0132-000,2018,6,17,7,249,270,519,363
0132-000,2018,6,17,8,296,344,640,519
0132-000,2018,6,17,9,352,485,837,640
0132-000,2018,6,17,10,431,574,1005,837
0132-000,2018,6,17,11,484,563,1047,1005
0132-000,2018,6,17,12,510,594,1104,1047
0132-000,2018,6,17,13,624,573,1197,1104
0132-000,2018,6,17,14,665,632,1297,1197
0132-000,2018,6,17,15,725,680,1405,1297
0132-000,2018,6,17,16,737,696,1433,1405
0132-000,2018,6,17,17,799,689,1488,1433
0132-000,2018,6,17,18,874,660,1534,1488
0132-000,2018,6,17,19,881,525,1406,1534
0132-000,2018,6,17,20,682,472,1154,1406
0132-000,2018,6,17,21,542,433,975,1154
0132-000,2018,6,17,22,407,368,775,975
0132-000,2018,6,17,23,264,293,557,775
0132-000,2018,6,17,24,159,170,329,557
0132-000,2018,6,18,1,97,128,225,329
0132-000,2018,6,18,2,73,79,152,225
0132-000,2018,6,18,3,47,63,110,152
0132-000,2018,6,18,4,58,66,124,110
0132-000,2018,6,18,5,110,104,214,124
0132-000,2018,6,18,6,356,236,592,214
0132-000,2018,6,18,7,517,663,1180,592
0132-000,2018,6,18,8,725,1956,2681,1180
0132-000,2018,6,18,9,801,1582,2383,2681
0132-000,2018,6,18,10,754,892,1646,2383
0132-000,2018,6,18,11,880,827,1707,1646
0132-000,2018,6,18,12,810,839,1649,1707
0132-000,2018,6,18,13,714,857,1571,1649
0132-000,2018,6,18,14,773,818,1591,1571
0132-000,2018,6,18,15,861,829,1690,1591
0132-000,2018,6,18,16,846,863,1709,1690
0132-000,2018,6,18,17,844,893,1737,1709
0132-000,2018,6,18,18,1354,962,2316,1737
0132-000,2018,6,18,19,1531,794,2325,2316
0132-000,2018,6,18,20,1037,684,1721,2325
0132-000,2018,6,18,21,860,495,1355,1721
0132-000,2018,6,18,22,418,356,774,1355
0132-000,2018,6,18,23,240,210,450,774
0132-000,2018,6,18,24,208,226,434,450
0132-000,2018,6,19,1,125,125,250,434
0132-000,2018,6,19,2,76,83,159,250
0132-000,2018,6,19,3,66,68,134,159
0132-000,2018,6,19,4,60,78,138,134
0132-000,2018,6,19,5,131,114,245,138
0132-000,2018,6,19,6,329,242,571,245
0132-000,2018,6,19,7,512,625,1137,571
0132-000,2018,6,19,8,713,1872,2585,1137
0132-000,2018,6,19,9,806,1599,2405,2585
0132-000,2018,6,19,10,798,885,1683,2405
0132-000,2018,6,19,11,824,833,1657,1683
0132-000,2018,6,19,12,814,740,1554,1657
0132-000,2018,6,19,13,760,749,1509,1554
0132-000,2018,6,19,14,854,789,1643,1509
0132-000,2018,6,19,15,809,789,1598,1643
0132-000,2018,6,19,16,873,824,1697,1598
0132-000,2018,6,19,17,928,867,1795,1697
0132-000,2018,6,19,18,1308,944,2252,1795
0132-000,2018,6,19,19,1541,793,2334,2252
0132-000,2018,6,19,20,865,669,1534,2334
0132-000,2018,6,19,21,803,501,1304,1534
0132-000,2018,6,19,22,576,380,956,1304
0132-000,2018,6,19,23,325,314,639,956
0132-000,2018,6,19,24,208,217,425,639
0132-000,2018,6,20,1,146,139,285,425
0132-000,2018,6,20,2,110,88,198,285
0132-000,2018,6,20,3,73,76,149,198
0132-000,2018,6,20,4,69,69,138,149
0132-000,2018,6,20,5,128,139,267,138
0132-000,2018,6,20,6,349,224,573,267
0132-000,2018,6,20,7,520,602,1122,573
0132-000,2018,6,20,8,717,1872,2589,1122
0132-000,2018,6,20,9,796,1579,2375,2589
0132-000,2018,6,20,10,828,891,1719,2375
0132-000,2018,6,20,11,836,878,1714,1719
0132-000,2018,6,20,12,788,784,1572,1714
0132-000,2018,6,20,13,746,750,1496,1572
0132-000,2018,6,20,14,819,815,1634,1496
0132-000,2018,6,20,15,894,793,1687,1634
0132-000,2018,6,20,16,876,872,1748,1687
0132-000,2018,6,20,17,939,881,1820,1748
0132-000,2018,6,20,18,1425,933,2358,1820
0132-000,2018,6,20,19,1763,861,2624,2358
0132-000,2018,6,20,20,963,703,1666,2624
0132-000,2018,6,20,21,766,534,1300,1666
0132-000,2018,6,20,22,635,451,1086,1300
0132-000,2018,6,20,23,359,337,696,1086
0132-000,2018,6,20,24,201,238,439,696
0132-000,2018,6,21,1,177,158,335,439
0132-000,2018,6,21,2,100,114,214,335
0132-000,2018,6,21,3,105,105,210,214
0132-000,2018,6,21,4,54,88,142,210
0132-000,2018,6,21,5,120,137,257,142
0132-000,2018,6,21,6,376,223,599,257
0132-000,2018,6,21,7,500,645,1145,599
0132-000,2018,6,21,8,658,1827,2485,1145
0132-000,2018,6,21,9,817,1606,2423,2485
0132-000,2018,6,21,10,814,840,1654,2423
0132-000,2018,6,21,11,830,767,1597,1654
0132-000,2018,6,21,12,752,782,1534,1597
0132-000,2018,6,21,13,688,701,1389,1534
0132-000,2018,6,21,14,799,739,1538,1389
0132-000,2018,6,21,15,809,811,1620,1538
0132-000,2018,6,21,16,805,803,1608,1620
0132-000,2018,6,21,17,909,834,1743,1608
0132-000,2018,6,21,18,1296,904,2200,1743
0132-000,2018,6,21,19,1485,793,2278,2200
0132-000,2018,6,21,20,1014,686,1700,2278
0132-000,2018,6,21,21,866,519,1385,1700
0132-000,2018,6,21,22,568,418,986,1385
0132-000,2018,6,21,23,333,324,657,986
0132-000,2018,6,21,24,211,229,440,657
0132-000,2018,6,22,1,173,141,314,440
0132-000,2018,6,22,2,98,97,195,314
0132-000,2018,6,22,3,74,89,163,195
0132-000,2018,6,22,4,73,99,172,163
0132-000,2018,6,22,5,132,120,252,172
0132-000,2018,6,22,6,340,251,591,252
0132-000,2018,6,22,7,522,670,1192,591
0132-000,2018,6,22,8,702,1837,2539,1192
0132-000,2018,6,22,9,834,1492,2326,2539
0132-000,2018,6,22,10,822,849,1671,2326
0132-000,2018,6,22,11,824,843,1667,1671
0132-000,2018,6,22,12,855,794,1649,1667
0132-000,2018,6,22,13,715,774,1489,1649
0132-000,2018,6,22,14,760,746,1506,1489
0132-000,2018,6,22,15,815,802,1617,1506
0132-000,2018,6,22,16,888,816,1704,1617
0132-000,2018,6,22,17,930,889,1819,1704
0132-000,2018,6,22,18,1336,1070,2406,1819
0132-000,2018,6,22,19,1789,876,2665,2406
0132-000,2018,6,22,20,1008,782,1790,2665
0132-000,2018,6,22,21,847,582,1429,1790
0132-000,2018,6,22,22,584,446,1030,1429
0132-000,2018,6,22,23,396,416,812,1030
0132-000,2018,6,22,24,245,242,487,812
0132-000,2018,6,23,1,178,181,359,487
0132-000,2018,6,23,2,154,149,303,359
0132-000,2018,6,23,3,105,121,226,303
0132-000,2018,6,23,4,80,113,193,226
0132-000,2018,6,23,5,142,150,292,193
0132-000,2018,6,23,6,331,274,605,292
0132-000,2018,6,23,7,428,481,909,605
0132-000,2018,6,23,8,498,770,1268,909
0132-000,2018,6,23,9,597,877,1474,1268
0132-000,2018,6,23,10,704,922,1626,1474
0132-000,2018,6,23,11,728,928,1656,1626
0132-000,2018,6,23,12,767,965,1732,1656
0132-000,2018,6,23,13,809,880,1689,1732
0132-000,2018,6,23,14,809,888,1697,1689
0132-000,2018,6,23,15,839,836,1675,1697
0132-000,2018,6,23,16,823,883,1706,1675
0132-000,2018,6,23,17,952,910,1862,1706
0132-000,2018,6,23,18,1156,984,2140,1862
0132-000,2018,6,23,19,974,780,1754,2140
0132-000,2018,6,23,20,639,602,1241,1754
0132-000,2018,6,23,21,581,491,1072,1241
0132-000,2018,6,23,22,443,406,849,1072
0132-000,2018,6,23,23,326,354,680,849
0132-000,2018,6,23,24,214,234,448,680
0132-000,2018,6,24,1,150,126,276,448
0132-000,2018,6,24,2,91,100,191,276
0132-000,2018,6,24,3,110,105,215,191
0132-000,2018,6,24,4,82,66,148,215
0132-000,2018,6,24,5,87,114,201,148
0132-000,2018,6,24,6,192,179,371,201
0132-000,2018,6,24,7,235,261,496,371
0132-000,2018,6,24,8,264,388,652,496
0132-000,2018,6,24,9,336,460,796,652
0132-000,2018,6,24,10,462,588,1050,796
0132-000,2018,6,24,11,548,567,1115,1050
0132-000,2018,6,24,12,561,552,1113,1115
0132-000,2018,6,24,13,604,537,1141,1113
0132-000,2018,6,24,14,649,656,1305,1141
0132-000,2018,6,24,15,702,627,1329,1305
0132-000,2018,6,24,16,733,696,1429,1329
0132-000,2018,6,24,17,794,670,1464,1429
0132-000,2018,6,24,18,850,652,1502,1464
0132-000,2018,6,24,19,822,531,1353,1502
0132-000,2018,6,24,20,641,486,1127,1353
0132-000,2018,6,24,21,551,447,998,1127
0132-000,2018,6,24,22,390,371,761,998
0132-000,2018,6,24,23,261,279,540,761
0132-000,2018,6,24,24,166,174,340,540
0132-000,2018,6,25,1,114,106,220,340
0132-000,2018,6,25,2,72,73,145,220
0132-000,2018,6,25,3,51,65,116,145
0132-000,2018,6,25,4,46,62,108,116
0132-000,2018,6,25,5,121,115,236,108
0132-000,2018,6,25,6,362,261,623,236
0132-000,2018,6,25,7,506,691,1197,623
0132-000,2018,6,25,8,708,1955,2663,1197
0132-000,2018,6,25,9,802,1633,2435,2663
0132-000,2018,6,25,10,787,824,1611,2435
0132-000,2018,6,25,11,747,885,1632,1611
0132-000,2018,6,25,12,732,776,1508,1632
0132-000,2018,6,25,13,731,789,1520,1508
0132-000,2018,6,25,14,815,793,1608,1520
0132-000,2018,6,25,15,816,850,1666,1608
0132-000,2018,6,25,16,761,721,1482,1666
0132-000,2018,6,25,17,872,852,1724,1482
0132-000,2018,6,25,18,1336,920,2256,1724
0132-000,2018,6,25,19,1570,856,2426,2256
0132-000,2018,6,25,20,1042,771,1813,2426
0132-000,2018,6,25,21,851,545,1396,1813
0132-000,2018,6,25,22,571,395,966,1396
0132-000,2018,6,25,23,351,311,662,966
0132-000,2018,6,25,24,199,208,407,662
0132-000,2018,6,26,1,157,121,278,407
0132-000,2018,6,26,2,107,87,194,278
0132-000,2018,6,26,3,63,85,148,194
0132-000,2018,6,26,4,58,85,143,148
0132-000,2018,6,26,5,89,104,193,143
0132-000,2018,6,26,6,280,213,493,193
0132-000,2018,6,26,7,400,596,996,493
0132-000,2018,6,26,8,624,1778,2402,996
0132-000,2018,6,26,9,711,1511,2222,2402
0132-000,2018,6,26,10,661,774,1435,2222
0132-000,2018,6,26,11,596,672,1268,1435
0132-000,2018,6,26,12,637,693,1330,1268
0132-000,2018,6,26,13,647,668,1315,1330
0132-000,2018,6,26,14,614,644,1258,1315
0132-000,2018,6,26,15,704,698,1402,1258
0132-000,2018,6,26,16,725,708,1433,1402
0132-000,2018,6,26,17,806,685,1491,1433
0132-000,2018,6,26,18,1187,798,1985,1491
0132-000,2018,6,26,19,1502,753,2255,1985
0132-000,2018,6,26,20,848,573,1421,2255
0132-000,2018,6,26,21,759,468,1227,1421
0132-000,2018,6,26,22,533,378,911,1227
0132-000,2018,6,26,23,327,273,600,911
0132-000,2018,6,26,24,170,212,382,600
0132-000,2018,6,27,1,171,129,300,382
0132-000,2018,6,27,2,91,100,191,300
0132-000,2018,6,27,3,59,84,143,191
0132-000,2018,6,27,4,72,82,154,143
0132-000,2018,6,27,5,100,99,199,154
0132-000,2018,6,27,6,301,213,514,199
0132-000,2018,6,27,7,418,538,956,514
0132-000,2018,6,27,8,630,1838,2468,956
0132-000,2018,6,27,9,752,1539,2291,2468
0132-000,2018,6,27,10,754,797,1551,2291
0132-000,2018,6,27,11,688,783,1471,1551
0132-000,2018,6,27,12,714,727,1441,1471
0132-000,2018,6,27,13,713,749,1462,1441
0132-000,2018,6,27,14,790,742,1532,1462
0132-000,2018,6,27,15,750,818,1568,1532
0132-000,2018,6,27,16,814,769,1583,1568
0132-000,2018,6,27,17,908,840,1748,1583
0132-000,2018,6,27,18,1294,865,2159,1748
0132-000,2018,6,27,19,1597,834,2431,2159
0132-000,2018,6,27,20,905,634,1539,2431
0132-000,2018,6,27,21,745,496,1241,1539
0132-000,2018,6,27,22,541,427,968,1241
0132-000,2018,6,27,23,362,382,744,968
0132-000,2018,6,27,24,208,217,425,744
0132-000,2018,6,28,1,114,102,216,425
0132-000,2018,6,28,2,105,123,228,216
0132-000,2018,6,28,3,74,96,170,228
0132-000,2018,6,28,4,49,69,118,170
0132-000,2018,6,28,5,113,123,236,118
0132-000,2018,6,28,6,317,234,551,236
0132-000,2018,6,28,7,449,638,1087,551
0132-000,2018,6,28,8,670,1895,2565,1087
0132-000,2018,6,28,9,785,1533,2318,2565
0132-000,2018,6,28,10,741,847,1588,2318
0132-000,2018,6,28,11,749,847,1596,1588
0132-000,2018,6,28,12,741,789,1530,1596
0132-000,2018,6,28,13,726,740,1466,1530
0132-000,2018,6,28,14,621,572,1193,1466
0132-000,2018,6,28,15,820,786,1606,1193
0132-000,2018,6,28,16,840,781,1621,1606
0132-000,2018,6,28,17,938,822,1760,1621
0132-000,2018,6,28,18,1284,835,2119,1760
0132-000,2018,6,28,19,1494,832,2326,2119
0132-000,2018,6,28,20,908,677,1585,2326
0132-000,2018,6,28,21,766,486,1252,1585
0132-000,2018,6,28,22,497,409,906,1252
0132-000,2018,6,28,23,337,308,645,906
0132-000,2018,6,28,24,204,197,401,645
0132-000,2018,6,29,1,155,141,296,401
0132-000,2018,6,29,2,109,103,212,296
0132-000,2018,6,29,3,58,82,140,212
0132-000,2018,6,29,4,59,69,128,140
0132-000,2018,6,29,5,113,124,237,128
0132-000,2018,6,29,6,314,228,542,237
0132-000,2018,6,29,7,491,630,1121,542
0132-000,2018,6,29,8,694,1846,2540,1121
0132-000,2018,6,29,9,816,1563,2379,2540
0132-000,2018,6,29,10,742,893,1635,2379
0132-000,2018,6,29,11,755,847,1602,1635
0132-000,2018,6,29,12,734,770,1504,1602
0132-000,2018,6,29,13,692,741,1433,1504
0132-000,2018,6,29,14,732,719,1451,1433
0132-000,2018,6,29,15,802,839,1641,1451
0132-000,2018,6,29,16,839,836,1675,1641
0132-000,2018,6,29,17,1021,894,1915,1675
0132-000,2018,6,29,18,1428,987,2415,1915
0132-000,2018,6,29,19,1691,863,2554,2415
0132-000,2018,6,29,20,1088,814,1902,2554
0132-000,2018,6,29,21,885,624,1509,1902
0132-000,2018,6,29,22,570,520,1090,1509
0132-000,2018,6,29,23,424,403,827,1090
0132-000,2018,6,29,24,258,304,562,827
0132-000,2018,6,30,1,189,203,392,562
0132-000,2018,6,30,2,130,143,273,392
0132-000,2018,6,30,3,110,140,250,273
0132-000,2018,6,30,4,93,109,202,250
0132-000,2018,6,30,5,125,113,238,202
0132-000,2018,6,30,6,278,224,502,238
0132-000,2018,6,30,7,371,412,783,502
0132-000,2018,6,30,8,503,742,1245,783
0132-000,2018,6,30,9,653,828,1481,1245
0132-000,2018,6,30,10,667,901,1568,1481
0132-000,2018,6,30,11,718,853,1571,1568
0132-000,2018,6,30,12,781,915,1696,1571
0132-000,2018,6,30,13,807,827,1634,1696
0132-000,2018,6,30,14,780,874,1654,1634
0132-000,2018,6,30,15,862,829,1691,1654
0132-000,2018,6,30,16,885,826,1711,1691
0132-000,2018,6,30,17,833,853,1686,1711
0132-000,2018,6,30,18,1028,838,1866,1686
0132-000,2018,6,30,19,892,716,1608,1866
0132-000,2018,6,30,20,533,477,1010,1608
0132-000,2018,6,30,21,532,482,1014,1010
0132-000,2018,6,30,22,441,395,836,1014
0132-000,2018,6,30,23,322,325,647,836
0132-000,2018,6,30,24,210,197,407,647
0132-000,2018,7,1,1,167,146,313,407
0132-000,2018,7,1,2,114,130,244,313
0132-000,2018,7,1,3,98,108,206,244
0132-000,2018,7,1,4,84,82,166,206
0132-000,2018,7,1,5,106,112,218,166
0132-000,2018,7,1,6,119,111,230,218
0132-000,2018,7,1,7,194,171,365,230
0132-000,2018,7,1,8,234,235,469,365
0132-000,2018,7,1,9,308,360,668,469
0132-000,2018,7,1,10,424,461,885,668
0132-000,2018,7,1,11,482,552,1034,885
0132-000,2018,7,1,12,520,544,1064,1034
0132-000,2018,7,1,13,642,573,1215,1064
0132-000,2018,7,1,14,726,619,1345,1215
0132-000,2018,7,1,15,661,660,1321,1345
0132-000,2018,7,1,16,675,580,1255,1321
0132-000,2018,7,1,17,706,560,1266,1255
0132-000,2018,7,1,18,858,590,1448,1266
0132-000,2018,7,1,19,717,480,1197,1448
0132-000,2018,7,1,20,590,419,1009,1197
0132-000,2018,7,1,21,458,354,812,1009
0132-000,2018,7,1,22,386,286,672,812
0132-000,2018,7,1,23,251,240,491,672
0132-000,2018,7,1,24,245,145,390,491
0132-000,2018,7,2,1,135,99,234,390
0132-000,2018,7,2,2,113,52,165,234
0132-000,2018,7,2,3,109,59,168,165
0132-000,2018,7,2,4,64,52,116,168
0132-000,2018,7,2,5,139,69,208,116
0132-000,2018,7,2,6,372,160,532,208
0132-000,2018,7,2,7,445,593,1038,532
0132-000,2018,7,2,8,618,1956,2574,1038
0132-000,2018,7,2,9,711,1605,2316,2574
0132-000,2018,7,2,10,703,774,1477,2316
0132-000,2018,7,2,11,721,789,1510,1477
0132-000,2018,7,2,12,659,752,1411,1510
0132-000,2018,7,2,13,688,702,1390,1411
0132-000,2018,7,2,14,714,732,1446,1390
0132-000,2018,7,2,15,758,802,1560,1446
0132-000,2018,7,2,16,767,697,1464,1560
0132-000,2018,7,2,17,836,733,1569,1464
0132-000,2018,7,2,18,1223,825,2048,1569
0132-000,2018,7,2,19,1490,768,2258,2048
0132-000,2018,7,2,20,902,645,1547,2258
0132-000,2018,7,2,21,756,457,1213,1547
0132-000,2018,7,2,22,535,365,900,1213
0132-000,2018,7,2,23,362,278,640,900
0132-000,2018,7,2,24,191,166,357,640
0132-000,2018,7,3,1,144,126,270,357
0132-000,2018,7,3,2,97,93,190,270
0132-000,2018,7,3,3,74,77,151,190
0132-000,2018,7,3,4,66,78,144,151
0132-000,2018,7,3,5,85,87,172,144
0132-000,2018,7,3,6,310,202,512,172
0132-000,2018,7,3,7,460,613,1073,512
0132-000,2018,7,3,8,648,1847,2495,1073
0132-000,2018,7,3,9,767,1556,2323,2495
0132-000,2018,7,3,10,719,806,1525,2323
0132-000,2018,7,3,11,701,806,1507,1525
0132-000,2018,7,3,12,769,731,1500,1507
0132-000,2018,7,3,13,635,653,1288,1500
0132-000,2018,7,3,14,737,761,1498,1288
0132-000,2018,7,3,15,824,813,1637,1498
0132-000,2018,7,3,16,825,693,1518,1637
0132-000,2018,7,3,17,803,788,1591,1518
0132-000,2018,7,3,18,1236,900,2136,1591
0132-000,2018,7,3,19,1479,802,2281,2136
0132-000,2018,7,3,20,916,667,1583,2281
0132-000,2018,7,3,21,838,536,1374,1583
0132-000,2018,7,3,22,601,405,1006,1374
0132-000,2018,7,3,23,333,341,674,1006
0132-000,2018,7,3,24,205,207,412,674
0132-000,2018,7,4,1,147,143,290,412
0132-000,2018,7,4,2,107,83,190,290
0132-000,2018,7,4,3,72,74,146,190
0132-000,2018,7,4,4,61,89,150,146
0132-000,2018,7,4,5,109,99,208,150
0132-000,2018,7,4,6,343,218,561,208
0132-000,2018,7,4,7,495,640,1135,561
0132-000,2018,7,4,8,704,1892,2596,1135
0132-000,2018,7,4,9,798,1558,2356,2596
0132-000,2018,7,4,10,684,853,1537,2356
0132-000,2018,7,4,11,753,830,1583,1537
0132-000,2018,7,4,12,740,750,1490,1583
0132-000,2018,7,4,13,779,702,1481,1490
0132-000,2018,7,4,14,827,821,1648,1481
0132-000,2018,7,4,15,781,822,1603,1648
0132-000,2018,7,4,16,871,812,1683,1603
0132-000,2018,7,4,17,936,875,1811,1683
0132-000,2018,7,4,18,1350,943,2293,1811
0132-000,2018,7,4,19,1657,820,2477,2293
0132-000,2018,7,4,20,968,673,1641,2477
0132-000,2018,7,4,21,755,511,1266,1641
0132-000,2018,7,4,22,550,441,991,1266
0132-000,2018,7,4,23,386,310,696,991
0132-000,2018,7,4,24,207,193,400,696
0132-000,2018,7,5,1,125,148,273,400
0132-000,2018,7,5,2,124,96,220,273
0132-000,2018,7,5,3,59,93,152,220
0132-000,2018,7,5,4,69,83,152,152
0132-000,2018,7,5,5,100,106,206,152
0132-000,2018,7,5,6,331,222,553,206
0132-000,2018,7,5,7,504,594,1098,553
0132-000,2018,7,5,8,679,1869,2548,1098
0132-000,2018,7,5,9,770,1556,2326,2548
0132-000,2018,7,5,10,742,829,1571,2326
0132-000,2018,7,5,11,764,831,1595,1571
0132-000,2018,7,5,12,754,752,1506,1595
0132-000,2018,7,5,13,681,708,1389,1506
0132-000,2018,7,5,14,752,737,1489,1389
0132-000,2018,7,5,15,806,694,1500,1489
0132-000,2018,7,5,16,776,766,1542,1500
0132-000,2018,7,5,17,866,830,1696,1542
0132-000,2018,7,5,18,1308,878,2186,1696
0132-000,2018,7,5,19,1512,770,2282,2186
0132-000,2018,7,5,20,912,615,1527,2282
0132-000,2018,7,5,21,769,506,1275,1527
0132-000,2018,7,5,22,560,384,944,1275
0132-000,2018,7,5,23,335,305,640,944
0132-000,2018,7,5,24,169,225,394,640
0132-000,2018,7,6,1,156,128,284,394
0132-000,2018,7,6,2,102,92,194,284
0132-000,2018,7,6,3,78,71,149,194
0132-000,2018,7,6,4,66,99,165,149
0132-000,2018,7,6,5,104,103,207,165
0132-000,2018,7,6,6,350,221,571,207
0132-000,2018,7,6,7,494,635,1129,571
0132-000,2018,7,6,8,691,1886,2577,1129
0132-000,2018,7,6,9,775,1517,2292,2577
0132-000,2018,7,6,10,718,824,1542,2292
0132-000,2018,7,6,11,702,833,1535,1542
0132-000,2018,7,6,12,720,763,1483,1535
0132-000,2018,7,6,13,748,755,1503,1483
0132-000,2018,7,6,14,749,765,1514,1503
0132-000,2018,7,6,15,837,828,1665,1514
0132-000,2018,7,6,16,833,805,1638,1665
0132-000,2018,7,6,17,936,874,1810,1638
0132-000,2018,7,6,18,1441,1014,2455,1810
0132-000,2018,7,6,19,1742,890,2632,2455
0132-000,2018,7,6,20,1081,821,1902,2632
0132-000,2018,7,6,21,834,555,1389,1902
0132-000,2018,7,6,22,616,447,1063,1389
0132-000,2018,7,6,23,376,381,757,1063
0132-000,2018,7,6,24,244,261,505,757
0132-000,2018,7,7,1,182,185,367,505
0132-000,2018,7,7,2,153,140,293,367
0132-000,2018,7,7,3,104,107,211,293
0132-000,2018,7,7,4,83,90,173,211
0132-000,2018,7,7,5,126,128,254,173
0132-000,2018,7,7,6,306,231,537,254
0132-000,2018,7,7,7,406,415,821,537
0132-000,2018,7,7,8,492,788,1280,821
0132-000,2018,7,7,9,629,859,1488,1280
0132-000,2018,7,7,10,703,858,1561,1488
0132-000,2018,7,7,11,746,898,1644,1561
0132-000,2018,7,7,12,768,939,1707,1644
0132-000,2018,7,7,13,883,1021,1904,1707
0132-000,2018,7,7,14,792,921,1713,1904
0132-000,2018,7,7,15,859,925,1784,1713
0132-000,2018,7,7,16,906,884,1790,1784
0132-000,2018,7,7,17,958,944,1902,1790
0132-000,2018,7,7,18,1031,993,2024,1902
0132-000,2018,7,7,19,959,752,1711,2024
0132-000,2018,7,7,20,655,582,1237,1711
0132-000,2018,7,7,21,593,480,1073,1237
0132-000,2018,7,7,22,510,463,973,1073
0132-000,2018,7,7,23,344,365,709,973
0132-000,2018,7,7,24,197,232,429,709
0132-000,2018,7,8,1,153,158,311,429
0132-000,2018,7,8,2,133,137,270,311
0132-000,2018,7,8,3,86,100,186,270
0132-000,2018,7,8,4,91,76,167,186
0132-000,2018,7,8,5,83,103,186,167
0132-000,2018,7,8,6,195,153,348,186
0132-000,2018,7,8,7,254,277,531,348
0132-000,2018,7,8,8,296,345,641,531
0132-000,2018,7,8,9,324,431,755,641
0132-000,2018,7,8,10,446,534,980,755
0132-000,2018,7,8,11,548,565,1113,980
0132-000,2018,7,8,12,536,607,1143,1113
0132-000,2018,7,8,13,611,601,1212,1143
0132-000,2018,7,8,14,696,662,1358,1212
0132-000,2018,7,8,15,681,637,1318,1358
0132-000,2018,7,8,16,725,682,1407,1318
0132-000,2018,7,8,17,827,693,1520,1407
0132-000,2018,7,8,18,912,644,1556,1520
0132-000,2018,7,8,19,854,580,1434,1556
0132-000,2018,7,8,20,675,530,1205,1434
0132-000,2018,7,8,21,519,423,942,1205
0132-000,2018,7,8,22,423,387,810,942
0132-000,2018,7,8,23,248,294,542,810
0132-000,2018,7,8,24,183,199,382,542
0132-000,2018,7,9,1,96,120,216,382
0132-000,2018,7,9,2,60,73,133,216
0132-000,2018,7,9,3,48,62,110,133
0132-000,2018,7,9,4,38,70,108,110
0132-000,2018,7,9,5,117,79,196,108
0132-000,2018,7,9,6,312,206,518,196
0132-000,2018,7,9,7,452,648,1100,518
0132-000,2018,7,9,8,600,1890,2490,1100
0132-000,2018,7,9,9,694,1597,2291,2490
0132-000,2018,7,9,10,682,820,1502,2291
0132-000,2018,7,9,11,711,753,1464,1502
0132-000,2018,7,9,12,652,736,1388,1464
0132-000,2018,7,9,13,662,632,1294,1388
0132-000,2018,7,9,14,646,732,1378,1294
0132-000,2018,7,9,15,733,730,1463,1378
0132-000,2018,7,9,16,765,674,1439,1463
0132-000,2018,7,9,17,753,697,1450,1439
0132-000,2018,7,9,18,1202,783,1985,1450
0132-000,2018,7,9,19,1463,751,2214,1985
0132-000,2018,7,9,20,848,610,1458,2214
0132-000,2018,7,9,21,749,467,1216,1458
0132-000,2018,7,9,22,503,378,881,1216
0132-000,2018,7,9,23,292,265,557,881
0132-000,2018,7,9,24,162,165,327,557
0132-000,2018,7,10,1,144,105,249,327
0132-000,2018,7,10,2,80,87,167,249
0132-000,2018,7,10,3,52,75,127,167
0132-000,2018,7,10,4,50,69,119,127
0132-000,2018,7,10,5,86,89,175,119
0132-000,2018,7,10,6,296,214,510,175
0132-000,2018,7,10,7,466,596,1062,510
0132-000,2018,7,10,8,673,1922,2595,1062
0132-000,2018,7,10,9,780,1553,2333,2595
0132-000,2018,7,10,10,752,844,1596,2333
0132-000,2018,7,10,11,771,844,1615,1596
0132-000,2018,7,10,12,743,767,1510,1615
0132-000,2018,7,10,13,706,730,1436,1510
0132-000,2018,7,10,14,766,743,1509,1436
0132-000,2018,7,10,15,839,719,1558,1509
0132-000,2018,7,10,16,838,762,1600,1558
0132-000,2018,7,10,17,800,791,1591,1600
0132-000,2018,7,10,18,1318,880,2198,1591
0132-000,2018,7,10,19,1424,814,2238,2198
0132-000,2018,7,10,20,929,665,1594,2238
0132-000,2018,7,10,21,819,488,1307,1594
0132-000,2018,7,10,22,555,370,925,1307
0132-000,2018,7,10,23,340,329,669,925
0132-000,2018,7,10,24,245,210,455,669
0132-000,2018,7,11,1,133,138,271,455
0132-000,2018,7,11,2,111,115,226,271
0132-000,2018,7,11,3,62,84,146,226
0132-000,2018,7,11,4,66,88,154,146
0132-000,2018,7,11,5,100,88,188,154
0132-000,2018,7,11,6,327,215,542,188
0132-000,2018,7,11,7,480,628,1108,542
0132-000,2018,7,11,8,684,1897,2581,1108
0132-000,2018,7,11,9,753,1603,2356,2581
0132-000,2018,7,11,10,731,826,1557,2356
0132-000,2018,7,11,11,676,800,1476,1557
0132-000,2018,7,11,12,717,745,1462,1476
0132-000,2018,7,11,13,675,735,1410,1462
0132-000,2018,7,11,14,728,706,1434,1410
0132-000,2018,7,11,15,746,733,1479,1434
0132-000,2018,7,11,16,783,742,1525,1479
0132-000,2018,7,11,17,853,813,1666,1525
0132-000,2018,7,11,18,1368,907,2275,1666
0132-000,2018,7,11,19,1568,834,2402,2275
0132-000,2018,7,11,20,919,697,1616,2402
0132-000,2018,7,11,21,755,516,1271,1616
0132-000,2018,7,11,22,510,402,912,1271
0132-000,2018,7,11,23,298,329,627,912
0132-000,2018,7,11,24,196,211,407,627
0132-000,2018,7,12,1,153,130,283,407
0132-000,2018,7,12,2,94,115,209,283
0132-000,2018,7,12,3,61,73,134,209
0132-000,2018,7,12,4,54,82,136,134
0132-000,2018,7,12,5,105,102,207,136
0132-000,2018,7,12,6,314,227,541,207
0132-000,2018,7,12,7,520,636,1156,541
0132-000,2018,7,12,8,631,1889,2520,1156
0132-000,2018,7,12,9,728,1576,2304,2520
0132-000,2018,7,12,10,736,839,1575,2304
0132-000,2018,7,12,11,672,780,1452,1575
0132-000,2018,7,12,12,707,771,1478,1452
0132-000,2018,7,12,13,696,677,1373,1478
0132-000,2018,7,12,14,715,715,1430,1373
0132-000,2018,7,12,15,756,741,1497,1430
0132-000,2018,7,12,16,815,774,1589,1497
0132-000,2018,7,12,17,845,781,1626,1589
0132-000,2018,7,12,18,1303,904,2207,1626
0132-000,2018,7,12,19,1475,791,2266,2207
0132-000,2018,7,12,20,919,727,1646,2266
0132-000,2018,7,12,21,820,492,1312,1646
0132-000,2018,7,12,22,575,475,1050,1312
0132-000,2018,7,12,23,365,360,725,1050
0132-000,2018,7,12,24,219,206,425,725
0132-000,2018,7,13,1,162,146,308,425
0132-000,2018,7,13,2,105,86,191,308
0132-000,2018,7,13,3,60,88,148,191
0132-000,2018,7,13,4,61,85,146,148
0132-000,2018,7,13,5,98,101,199,146
0132-000,2018,7,13,6,308,222,530,199
0132-000,2018,7,13,7,518,650,1168,530
0132-000,2018,7,13,8,663,1868,2531,1168
0132-000,2018,7,13,9,796,1572,2368,2531
0132-000,2018,7,13,10,738,832,1570,2368
0132-000,2018,7,13,11,758,816,1574,1570
0132-000,2018,7,13,12,708,811,1519,1574
0132-000,2018,7,13,13,706,711,1417,1519
0132-000,2018,7,13,14,764,752,1516,1417
0132-000,2018,7,13,15,783,756,1539,1516
0132-000,2018,7,13,16,826,787,1613,1539
0132-000,2018,7,13,17,878,875,1753,1613
0132-000,2018,7,13,18,1399,987,2386,1753
0132-000,2018,7,13,19,1627,931,2558,2386
0132-000,2018,7,13,20,1013,768,1781,2558
0132-000,2018,7,13,21,787,607,1394,1781
0132-000,2018,7,13,22,680,478,1158,1394
0132-000,2018,7,13,23,373,400,773,1158
0132-000,2018,7,13,24,244,261,505,773
0132-000,2018,7,14,1,205,175,380,505
0132-000,2018,7,14,2,161,151,312,380
0132-000,2018,7,14,3,93,129,222,312
0132-000,2018,7,14,4,90,104,194,222
0132-000,2018,7,14,5,105,123,228,194
0132-000,2018,7,14,6,305,232,537,228
0132-000,2018,7,14,7,368,490,858,537
0132-000,2018,7,14,8,485,827,1312,858
0132-000,2018,7,14,9,644,901,1545,1312
0132-000,2018,7,14,10,728,816,1544,1545
0132-000,2018,7,14,11,820,937,1757,1544
0132-000,2018,7,14,12,817,915,1732,1757
0132-000,2018,7,14,13,850,932,1782,1732
0132-000,2018,7,14,14,851,948,1799,1782
0132-000,2018,7,14,15,839,849,1688,1799
0132-000,2018,7,14,16,835,856,1691,1688
0132-000,2018,7,14,17,895,942,1837,1691
0132-000,2018,7,14,18,1038,966,2004,1837
0132-000,2018,7,14,19,885,779,1664,2004
0132-000,2018,7,14,20,637,632,1269,1664
0132-000,2018,7,14,21,573,469,1042,1269
0132-000,2018,7,14,22,528,423,951,1042
0132-000,2018,7,14,23,354,356,710,951
0132-000,2018,7,14,24,191,226,417,710
0132-000,2018,7,15,1,173,153,326,417
0132-000,2018,7,15,2,116,146,262,326
0132-000,2018,7,15,3,89,109,198,262
0132-000,2018,7,15,4,77,71,148,198
0132-000,2018,7,15,5,67,82,149,148
0132-000,2018,7,15,6,168,160,328,149
0132-000,2018,7,15,7,210,233,443,328
0132-000,2018,7,15,8,273,359,632,443
0132-000,2018,7,15,9,328,439,767,632
0132-000,2018,7,15,10,424,582,1006,767
0132-000,2018,7,15,11,530,648,1178,1006
0132-000,2018,7,15,12,537,631,1168,1178
0132-000,2018,7,15,13,631,676,1307,1168
0132-000,2018,7,15,14,589,625,1214,1307
0132-000,2018,7,15,15,690,621,1311,1214
0132-000,2018,7,15,16,703,693,1396,1311
0132-000,2018,7,15,17,770,676,1446,1396
0132-000,2018,7,15,18,871,655,1526,1446
0132-000,2018,7,15,19,820,618,1438,1526
0132-000,2018,7,15,20,692,498,1190,1438
0132-000,2018,7,15,21,568,455,1023,1190
0132-000,2018,7,15,22,443,400,843,1023
0132-000,2018,7,15,23,253,282,535,843
0132-000,2018,7,15,24,161,173,334,535
0132-000,2018,7,16,1,94,124,218,334
0132-000,2018,7,16,2,60,76,136,218
0132-000,2018,7,16,3,57,88,145,136
0132-000,2018,7,16,4,43,72,115,145
0132-000,2018,7,16,5,108,87,195,115
0132-000,2018,7,16,6,389,257,646,195
0132-000,2018,7,16,7,497,706,1203,646
0132-000,2018,7,16,8,689,1906,2595,1203
0132-000,2018,7,16,9,757,1536,2293,2595
0132-000,2018,7,16,10,746,858,1604,2293
0132-000,2018,7,16,11,739,857,1596,1604
0132-000,2018,7,16,12,771,796,1567,1596
0132-000,2018,7,16,13,673,696,1369,1567
0132-000,2018,7,16,14,693,756,1449,1369
0132-000,2018,7,16,15,801,819,1620,1449
0132-000,2018,7,16,16,851,760,1611,1620
0132-000,2018,7,16,17,893,819,1712,1611
0132-000,2018,7,16,18,1299,963,2262,1712
0132-000,2018,7,16,19,1464,881,2345,2262
0132-000,2018,7,16,20,938,684,1622,2345
0132-000,2018,7,16,21,860,537,1397,1622
0132-000,2018,7,16,22,512,396,908,1397
0132-000,2018,7,16,23,329,266,595,908
0132-000,2018,7,16,24,184,231,415,595
0132-000,2018,7,17,1,146,129,275,415
0132-000,2018,7,17,2,89,90,179,275
0132-000,2018,7,17,3,76,73,149,179
0132-000,2018,7,17,4,54,78,132,149
0132-000,2018,7,17,5,105,104,209,132
0132-000,2018,7,17,6,346,236,582,209
0132-000,2018,7,17,7,499,659,1158,582
0132-000,2018,7,17,8,676,1860,2536,1158
0132-000,2018,7,17,9,795,1477,2272,2536
0132-000,2018,7,17,10,715,912,1627,2272
0132-000,2018,7,17,11,742,807,1549,1627
0132-000,2018,7,17,12,687,700,1387,1549
0132-000,2018,7,17,13,674,681,1355,1387
0132-000,2018,7,17,14,725,697,1422,1355
0132-000,2018,7,17,15,727,764,1491,1422
0132-000,2018,7,17,16,803,755,1558,1491
0132-000,2018,7,17,17,846,795,1641,1558
0132-000,2018,7,17,18,1281,862,2143,1641
0132-000,2018,7,17,19,1496,811,2307,2143
0132-000,2018,7,17,20,907,696,1603,2307
0132-000,2018,7,17,21,803,526,1329,1603
0132-000,2018,7,17,22,562,421,983,1329
0132-000,2018,7,17,23,364,327,691,983
0132-000,2018,7,17,24,198,217,415,691
0132-000,2018,7,18,1,149,141,290,415
0132-000,2018,7,18,2,85,106,191,290
0132-000,2018,7,18,3,78,87,165,191
0132-000,2018,7,18,4,61,99,160,165
0132-000,2018,7,18,5,106,112,218,160
0132-000,2018,7,18,6,329,234,563,218
0132-000,2018,7,18,7,509,643,1152,563
0132-000,2018,7,18,8,668,1823,2491,1152
0132-000,2018,7,18,9,769,1506,2275,2491
0132-000,2018,7,18,10,731,822,1553,2275
0132-000,2018,7,18,11,751,746,1497,1553
0132-000,2018,7,18,12,760,716,1476,1497
0132-000,2018,7,18,13,646,710,1356,1476
0132-000,2018,7,18,14,742,706,1448,1356
0132-000,2018,7,18,15,749,753,1502,1448
0132-000,2018,7,18,16,846,713,1559,1502
0132-000,2018,7,18,17,867,808,1675,1559
0132-000,2018,7,18,18,1349,889,2238,1675
0132-000,2018,7,18,19,1577,811,2388,2238
0132-000,2018,7,18,20,909,674,1583,2388
0132-000,2018,7,18,21,702,483,1185,1583
0132-000,2018,7,18,22,489,405,894,1185
0132-000,2018,7,18,23,348,330,678,894
0132-000,2018,7,18,24,214,219,433,678
0132-000,2018,7,19,1,141,121,262,433
0132-000,2018,7,19,2,90,104,194,262
0132-000,2018,7,19,3,51,89,140,194
0132-000,2018,7,19,4,70,81,151,140
0132-000,2018,7,19,5,100,109,209,151
0132-000,2018,7,19,6,348,216,564,209
0132-000,2018,7,19,7,500,607,1107,564
0132-000,2018,7,19,8,656,1901,2557,1107
0132-000,2018,7,19,9,761,1495,2256,2557
0132-000,2018,7,19,10,744,832,1576,2256
0132-000,2018,7,19,11,668,809,1477,1576
0132-000,2018,7,19,12,736,805,1541,1477
0132-000,2018,7,19,13,685,723,1408,1541
0132-000,2018,7,19,14,734,791,1525,1408
0132-000,2018,7,19,15,746,724,1470,1525
0132-000,2018,7,19,16,797,759,1556,1470
0132-000,2018,7,19,17,844,814,1658,1556
0132-000,2018,7,19,18,1249,905,2154,1658
0132-000,2018,7,19,19,1493,786,2279,2154
0132-000,2018,7,19,20,878,664,1542,2279
0132-000,2018,7,19,21,865,506,1371,1542
0132-000,2018,7,19,22,539,432,971,1371
0132-000,2018,7,19,23,364,329,693,971
0132-000,2018,7,19,24,204,196,400,693
0132-000,2018,7,20,1,164,149,313,400
0132-000,2018,7,20,2,112,101,213,313
0132-000,2018,7,20,3,66,108,174,213
0132-000,2018,7,20,4,71,78,149,174
0132-000,2018,7,20,5,123,104,227,149
0132-000,2018,7,20,6,379,203,582,227
0132-000,2018,7,20,7,498,637,1135,582
0132-000,2018,7,20,8,644,1848,2492,1135
0132-000,2018,7,20,9,759,1488,2247,2492
0132-000,2018,7,20,10,746,839,1585,2247
0132-000,2018,7,20,11,763,849,1612,1585
0132-000,2018,7,20,12,762,773,1535,1612
0132-000,2018,7,20,13,756,769,1525,1535
0132-000,2018,7,20,14,760,802,1562,1525
0132-000,2018,7,20,15,802,747,1549,1562
0132-000,2018,7,20,16,845,804,1649,1549
0132-000,2018,7,20,17,971,806,1777,1649
0132-000,2018,7,20,18,1357,1017,2374,1777
0132-000,2018,7,20,19,1695,888,2583,2374
0132-000,2018,7,20,20,1045,808,1853,2583
0132-000,2018,7,20,21,844,554,1398,1853
0132-000,2018,7,20,22,663,498,1161,1398
0132-000,2018,7,20,23,357,391,748,1161
0132-000,2018,7,20,24,281,272,553,748
0132-000,2018,7,21,1,212,195,407,553
0132-000,2018,7,21,2,141,140,281,407
0132-000,2018,7,21,3,120,109,229,281
0132-000,2018,7,21,4,91,103,194,229
0132-000,2018,7,21,5,101,125,226,194
0132-000,2018,7,21,6,288,256,544,226
0132-000,2018,7,21,7,423,453,876,544
0132-000,2018,7,21,8,506,839,1345,876
0132-000,2018,7,21,9,790,891,1681,1345
0132-000,2018,7,21,10,761,824,1585,1681
0132-000,2018,7,21,11,855,951,1806,1585
0132-000,2018,7,21,12,826,936,1762,1806
0132-000,2018,7,21,13,868,839,1707,1762
0132-000,2018,7,21,14,776,830,1606,1707
0132-000,2018,7,21,15,793,821,1614,1606
0132-000,2018,7,21,16,911,797,1708,1614
0132-000,2018,7,21,17,955,779,1734,1708
0132-000,2018,7,21,18,1211,897,2108,1734
0132-000,2018,7,21,19,979,748,1727,2108
0132-000,2018,7,21,20,735,628,1363,1727
0132-000,2018,7,21,21,663,502,1165,1363
0132-000,2018,7,21,22,597,378,975,1165
0132-000,2018,7,21,23,379,290,669,975
0132-000,2018,7,21,24,267,237,504,669
0132-000,2018,7,22,1,172,176,348,504
0132-000,2018,7,22,2,136,111,247,348
0132-000,2018,7,22,3,82,115,197,247
0132-000,2018,7,22,4,72,75,147,197
0132-000,2018,7,22,5,78,124,202,147
0132-000,2018,7,22,6,162,177,339,202
0132-000,2018,7,22,7,225,234,459,339
0132-000,2018,7,22,8,309,386,695,459
0132-000,2018,7,22,9,363,467,830,695
0132-000,2018,7,22,10,472,519,991,830
0132-000,2018,7,22,11,586,576,1162,991
0132-000,2018,7,22,12,537,593,1130,1162
0132-000,2018,7,22,13,624,589,1213,1130
0132-000,2018,7,22,14,659,634,1293,1213
0132-000,2018,7,22,15,690,620,1310,1293
0132-000,2018,7,22,16,696,631,1327,1310
0132-000,2018,7,22,17,820,616,1436,1327
0132-000,2018,7,22,18,851,610,1461,1436
0132-000,2018,7,22,19,821,558,1379,1461
0132-000,2018,7,22,20,575,535,1110,1379
0132-000,2018,7,22,21,526,449,975,1110
0132-000,2018,7,22,22,348,334,682,975
0132-000,2018,7,22,23,265,295,560,682
0132-000,2018,7,22,24,188,188,376,560
0132-000,2018,7,23,1,123,143,266,376
0132-000,2018,7,23,2,81,89,170,266
0132-000,2018,7,23,3,45,68,113,170
0132-000,2018,7,23,4,47,55,102,113
0132-000,2018,7,23,5,116,109,225,102
0132-000,2018,7,23,6,349,234,583,225
0132-000,2018,7,23,7,532,702,1234,583
0132-000,2018,7,23,8,663,1930,2593,1234
0132-000,2018,7,23,9,736,1534,2270,2593
0132-000,2018,7,23,10,710,827,1537,2270
0132-000,2018,7,23,11,748,836,1584,1537
0132-000,2018,7,23,12,698,764,1462,1584
0132-000,2018,7,23,13,774,727,1501,1462
0132-000,2018,7,23,14,718,735,1453,1501
0132-000,2018,7,23,15,749,794,1543,1453
0132-000,2018,7,23,16,838,771,1609,1543
0132-000,2018,7,23,17,881,813,1694,1609
0132-000,2018,7,23,18,1324,929,2253,1694
0132-000,2018,7,23,19,1488,845,2333,2253
0132-000,2018,7,23,20,1028,717,1745,2333
0132-000,2018,7,23,21,871,498,1369,1745
0132-000,2018,7,23,22,525,407,932,1369
0132-000,2018,7,23,23,366,291,657,932
0132-000,2018,7,23,24,193,180,373,657
0132-000,2018,7,24,1,132,130,262,373
0132-000,2018,7,24,2,93,96,189,262
0132-000,2018,7,24,3,65,104,169,189
0132-000,2018,7,24,4,79,86,165,169
0132-000,2018,7,24,5,104,130,234,165
0132-000,2018,7,24,6,342,217,559,234
0132-000,2018,7,24,7,476,661,1137,559
0132-000,2018,7,24,8,702,1929,2631,1137
0132-000,2018,7,24,9,804,1507,2311,2631
0132-000,2018,7,24,10,759,878,1637,2311
0132-000,2018,7,24,11,714,844,1558,1637
0132-000,2018,7,24,12,698,781,1479,1558
0132-000,2018,7,24,13,741,762,1503,1479
0132-000,2018,7,24,14,717,745,1462,1503
0132-000,2018,7,24,15,830,694,1524,1462
0132-000,2018,7,24,16,774,758,1532,1524
0132-000,2018,7,24,17,858,796,1654,1532
0132-000,2018,7,24,18,1308,904,2212,1654
0132-000,2018,7,24,19,1510,862,2372,2212
0132-000,2018,7,24,20,970,643,1613,2372
0132-000,2018,7,24,21,860,462,1322,1613
0132-000,2018,7,24,22,539,438,977,1322
0132-000,2018,7,24,23,343,279,622,977
0132-000,2018,7,24,24,233,182,415,622
0132-000,2018,7,25,1,153,156,309,415
0132-000,2018,7,25,2,94,107,201,309
0132-000,2018,7,25,3,78,99,177,201
0132-000,2018,7,25,4,80,91,171,177
0132-000,2018,7,25,5,113,118,231,171
0132-000,2018,7,25,6,332,231,563,231
0132-000,2018,7,25,7,494,643,1137,563
0132-000,2018,7,25,8,670,1878,2548,1137
0132-000,2018,7,25,9,778,1398,2176,2548
0132-000,2018,7,25,10,733,821,1554,2176
0132-000,2018,7,25,11,724,811,1535,1554
0132-000,2018,7,25,12,779,768,1547,1535
0132-000,2018,7,25,13,713,715,1428,1547
0132-000,2018,7,25,14,751,739,1490,1428
0132-000,2018,7,25,15,789,790,1579,1490
0132-000,2018,7,25,16,833,783,1616,1579
0132-000,2018,7,25,17,846,845,1691,1616
0132-000,2018,7,25,18,1330,976,2306,1691
0132-000,2018,7,25,19,1676,826,2502,2306
0132-000,2018,7,25,20,910,614,1524,2502
0132-000,2018,7,25,21,832,520,1352,1524
0132-000,2018,7,25,22,521,450,971,1352
0132-000,2018,7,25,23,378,327,705,971
0132-000,2018,7,25,24,206,216,422,705
0132-000,2018,7,26,1,136,167,303,422
0132-000,2018,7,26,2,103,110,213,303
0132-000,2018,7,26,3,78,102,180,213
0132-000,2018,7,26,4,101,94,195,180
0132-000,2018,7,26,5,109,122,231,195
0132-000,2018,7,26,6,327,231,558,231
0132-000,2018,7,26,7,500,643,1143,558
0132-000,2018,7,26,8,620,1758,2378,1143
0132-000,2018,7,26,9,794,1520,2314,2378
0132-000,2018,7,26,10,734,861,1595,2314
0132-000,2018,7,26,11,682,818,1500,1595
0132-000,2018,7,26,12,754,770,1524,1500
0132-000,2018,7,26,13,744,714,1458,1524
0132-000,2018,7,26,14,777,790,1567,1458
0132-000,2018,7,26,15,772,787,1559,1567
0132-000,2018,7,26,16,844,811,1655,1559
0132-000,2018,7,26,17,949,859,1808,1655
0132-000,2018,7,26,18,1295,929,2224,1808
0132-000,2018,7,26,19,1546,805,2351,2224
0132-000,2018,7,26,20,981,709,1690,2351
0132-000,2018,7,26,21,821,514,1335,1690
0132-000,2018,7,26,22,552,421,973,1335
0132-000,2018,7,26,23,353,336,689,973
0132-000,2018,7,26,24,232,219,451,689
0132-000,2018,7,27,1,172,155,327,451
0132-000,2018,7,27,2,105,109,214,327
0132-000,2018,7,27,3,67,84,151,214
0132-000,2018,7,27,4,108,87,195,151
0132-000,2018,7,27,5,124,122,246,195
0132-000,2018,7,27,6,308,191,499,246
0132-000,2018,7,27,7,503,649,1152,499
0132-000,2018,7,27,8,616,1808,2424,1152
0132-000,2018,7,27,9,769,1456,2225,2424
0132-000,2018,7,27,10,732,825,1557,2225
0132-000,2018,7,27,11,717,790,1507,1557
0132-000,2018,7,27,12,770,793,1563,1507
0132-000,2018,7,27,13,747,817,1564,1563
0132-000,2018,7,27,14,748,816,1564,1564
0132-000,2018,7,27,15,825,833,1658,1564
0132-000,2018,7,27,16,827,763,1590,1658
0132-000,2018,7,27,17,974,908,1882,1590
0132-000,2018,7,27,18,1461,968,2429,1882
0132-000,2018,7,27,19,1844,1044,2888,2429
0132-000,2018,7,27,20,1075,879,1954,2888
0132-000,2018,7,27,21,799,624,1423,1954
0132-000,2018,7,27,22,659,478,1137,1423
0132-000,2018,7,27,23,354,343,697,1137
0132-000,2018,7,27,24,244,256,500,697
0132-000,2018,7,28,1,177,186,363,500
0132-000,2018,7,28,2,134,142,276,363
0132-000,2018,7,28,3,84,122,206,276
0132-000,2018,7,28,4,109,123,232,206
0132-000,2018,7,28,5,135,128,263,232
0132-000,2018,7,28,6,275,217,492,263
0132-000,2018,7,28,7,407,422,829,492
0132-000,2018,7,28,8,480,758,1238,829
0132-000,2018,7,28,9,607,844,1451,1238
0132-000,2018,7,28,10,704,799,1503,1451
0132-000,2018,7,28,11,791,990,1781,1503
0132-000,2018,7,28,12,732,1023,1755,1781
0132-000,2018,7,28,13,783,889,1672,1755
0132-000,2018,7,28,14,754,903,1657,1672
0132-000,2018,7,28,15,796,800,1596,1657
0132-000,2018,7,28,16,756,920,1676,1596
0132-000,2018,7,28,17,852,909,1761,1676
0132-000,2018,7,28,18,962,885,1847,1761
0132-000,2018,7,28,19,897,756,1653,1847
0132-000,2018,7,28,20,636,557,1193,1653
0132-000,2018,7,28,21,536,469,1005,1193
0132-000,2018,7,28,22,525,381,906,1005
0132-000,2018,7,28,23,294,300,594,906
0132-000,2018,7,28,24,200,210,410,594
0132-000,2018,7,29,1,149,152,301,410
0132-000,2018,7,29,2,103,137,240,301
0132-000,2018,7,29,3,86,95,181,240
0132-000,2018,7,29,4,76,102,178,181
0132-000,2018,7,29,5,66,95,161,178
0132-000,2018,7,29,6,141,144,285,161
0132-000,2018,7,29,7,200,241,441,285
0132-000,2018,7,29,8,241,346,587,441
0132-000,2018,7,29,9,315,476,791,587
0132-000,2018,7,29,10,432,551,983,791
0132-000,2018,7,29,11,537,606,1143,983
0132-000,2018,7,29,12,518,626,1144,1143
0132-000,2018,7,29,13,612,643,1255,1144
0132-000,2018,7,29,14,610,687,1297,1255
0132-000,2018,7,29,15,789,674,1463,1297
0132-000,2018,7,29,16,780,633,1413,1463
0132-000,2018,7,29,17,836,624,1460,1413
0132-000,2018,7,29,18,877,634,1511,1460
0132-000,2018,7,29,19,834,552,1386,1511
0132-000,2018,7,29,20,645,513,1158,1386
0132-000,2018,7,29,21,524,445,969,1158
0132-000,2018,7,29,22,409,396,805,969
0132-000,2018,7,29,23,297,297,594,805
0132-000,2018,7,29,24,184,184,368,594
0132-000,2018,7,30,1,127,156,283,368
0132-000,2018,7,30,2,58,93,151,283
0132-000,2018,7,30,3,59,84,143,151
0132-000,2018,7,30,4,72,67,139,143
0132-000,2018,7,30,5,99,84,183,139
0132-000,2018,7,30,6,316,230,546,183
0132-000,2018,7,30,7,478,554,1032,546
0132-000,2018,7,30,8,606,1486,2092,1032
0132-000,2018,7,30,9,673,1216,1889,2092
0132-000,2018,7,30,10,658,773,1431,1889
0132-000,2018,7,30,11,701,735,1436,1431
0132-000,2018,7,30,12,691,740,1431,1436
0132-000,2018,7,30,13,701,709,1410,1431
0132-000,2018,7,30,14,755,752,1507,1410
0132-000,2018,7,30,15,708,776,1484,1507
0132-000,2018,7,30,16,821,792,1613,1484
0132-000,2018,7,30,17,870,718,1588,1613
0132-000,2018,7,30,18,1237,920,2157,1588
0132-000,2018,7,30,19,1364,798,2162,2157
0132-000,2018,7,30,20,878,579,1457,2162
0132-000,2018,7,30,21,651,464,1115,1457
0132-000,2018,7,30,22,431,349,780,1115
0132-000,2018,7,30,23,299,296,595,780
0132-000,2018,7,30,24,191,219,410,595
0132-000,2018,7,31,1,135,165,300,410
0132-000,2018,7,31,2,87,115,202,300
0132-000,2018,7,31,3,74,76,150,202
0132-000,2018,7,31,4,79,88,167,150
0132-000,2018,7,31,5,101,116,217,167
0132-000,2018,7,31,6,300,190,490,217
0132-000,2018,7,31,7,411,458,869,490
0132-000,2018,7,31,8,543,1359,1902,869
0132-000,2018,7,31,9,670,1163,1833,1902
0132-000,2018,7,31,10,645,772,1417,1833
0132-000,2018,7,31,11,701,831,1532,1417
0132-000,2018,7,31,12,697,769,1466,1532
0132-000,2018,7,31,13,661,747,1408,1466
0132-000,2018,7,31,14,721,756,1477,1408
0132-000,2018,7,31,15,756,749,1505,1477
0132-000,2018,7,31,16,794,727,1521,1505
0132-000,2018,7,31,17,828,775,1603,1521
0132-000,2018,7,31,18,1177,914,2091,1603
0132-000,2018,7,31,19,1346,761,2107,2091
0132-000,2018,7,31,20,830,610,1440,2107
0132-000,2018,7,31,21,677,437,1114,1440
0132-000,2018,7,31,22,502,369,871,1114
0132-000,2018,7,31,23,321,295,616,871
0132-000,2018,7,31,24,181,208,389,616
0132-000,2018,8,1,1,164,147,311,389
0132-000,2018,8,1,2,95,108,203,311
0132-000,2018,8,1,3,71,86,157,203
0132-000,2018,8,1,4,92,82,174,157
0132-000,2018,8,1,5,135,108,243,174
0132-000,2018,8,1,6,264,215,479,243
0132-000,2018,8,1,7,411,474,885,479
0132-000,2018,8,1,8,550,1194,1744,885
0132-000,2018,8,1,9,646,1274,1920,1744
0132-000,2018,8,1,10,654,777,1431,1920
0132-000,2018,8,1,11,666,747,1413,1431
0132-000,2018,8,1,12,763,769,1532,1413
0132-000,2018,8,1,13,720,786,1506,1532
0132-000,2018,8,1,14,722,771,1493,1506
0132-000,2018,8,1,15,699,761,1460,1493
0132-000,2018,8,1,16,751,797,1548,1460
0132-000,2018,8,1,17,799,738,1537,1548
0132-000,2018,8,1,18,1109,824,1933,1537
0132-000,2018,8,1,19,1189,694,1883,1933
0132-000,2018,8,1,20,752,596,1348,1883
0132-000,2018,8,1,21,666,471,1137,1348
0132-000,2018,8,1,22,497,368,865,1137
0132-000,2018,8,1,23,320,337,657,865
0132-000,2018,8,1,24,199,409,608,657
0132-000,2018,8,2,1,159,144,303,608
0132-000,2018,8,2,2,96,107,203,303
0132-000,2018,8,2,3,67,96,163,203
0132-000,2018,8,2,4,110,88,198,163
0132-000,2018,8,2,5,125,154,279,198
0132-000,2018,8,2,6,258,378,636,279
0132-000,2018,8,2,7,395,542,937,636
0132-000,2018,8,2,8,527,1215,1742,937
0132-000,2018,8,2,9,626,1148,1774,1742
0132-000,2018,8,2,10,657,916,1573,1774
0132-000,2018,8,2,11,617,876,1493,1573
0132-000,2018,8,2,12,672,741,1413,1493
0132-000,2018,8,2,13,661,747,1408,1413
0132-000,2018,8,2,14,715,739,1454,1408
0132-000,2018,8,2,15,687,708,1395,1454
0132-000,2018,8,2,16,751,679,1430,1395
0132-000,2018,8,2,17,770,722,1492,1430
0132-000,2018,8,2,18,1062,818,1880,1492
0132-000,2018,8,2,19,1248,765,2013,1880
0132-000,2018,8,2,20,758,549,1307,2013
0132-000,2018,8,2,21,608,474,1082,1307
0132-000,2018,8,2,22,459,366,825,1082
0132-000,2018,8,2,23,316,412,728,825
0132-000,2018,8,2,24,221,275,496,728
0132-000,2018,8,3,1,130,208,338,496
0132-000,2018,8,3,2,85,105,190,338
0132-000,2018,8,3,3,75,148,223,190
0132-000,2018,8,3,4,121,152,273,223
0132-000,2018,8,3,5,128,169,297,273
0132-000,2018,8,3,6,254,248,502,297
0132-000,2018,8,3,7,391,471,862,502
0132-000,2018,8,3,8,492,1192,1684,862
0132-000,2018,8,3,9,636,1118,1754,1684
0132-000,2018,8,3,10,640,715,1355,1754
0132-000,2018,8,3,11,622,730,1352,1355
0132-000,2018,8,3,12,679,819,1498,1352
0132-000,2018,8,3,13,728,797,1525,1498
0132-000,2018,8,3,14,757,745,1502,1525
0132-000,2018,8,3,15,804,759,1563,1502
0132-000,2018,8,3,16,793,789,1582,1563
0132-000,2018,8,3,17,870,786,1656,1582
0132-000,2018,8,3,18,1155,845,2000,1656
0132-000,2018,8,3,19,1348,738,2086,2000
0132-000,2018,8,3,20,871,637,1508,2086
0132-000,2018,8,3,21,692,491,1183,1508
0132-000,2018,8,3,22,556,514,1070,1183
0132-000,2018,8,3,23,340,480,820,1070
0132-000,2018,8,3,24,248,327,575,820
0132-000,2018,8,4,1,177,182,359,575
0132-000,2018,8,4,2,126,156,282,359
0132-000,2018,8,4,3,81,143,224,282
0132-000,2018,8,4,4,134,118,252,224
0132-000,2018,8,4,5,114,146,260,252
0132-000,2018,8,4,6,191,192,383,260
0132-000,2018,8,4,7,296,328,624,383
0132-000,2018,8,4,8,353,597,950,624
0132-000,2018,8,4,9,483,690,1173,950
0132-000,2018,8,4,10,542,703,1245,1173
0132-000,2018,8,4,11,633,782,1415,1245
0132-000,2018,8,4,12,665,813,1478,1415
0132-000,2018,8,4,13,739,760,1499,1478
0132-000,2018,8,4,14,725,812,1537,1499
0132-000,2018,8,4,15,746,738,1484,1537
0132-000,2018,8,4,16,735,700,1435,1484
0132-000,2018,8,4,17,810,725,1535,1435
0132-000,2018,8,4,18,896,762,1658,1535
0132-000,2018,8,4,19,823,634,1457,1658
0132-000,2018,8,4,20,677,531,1208,1457
0132-000,2018,8,4,21,589,632,1221,1208
0132-000,2018,8,4,22,492,483,975,1221
0132-000,2018,8,4,23,314,341,655,975
0132-000,2018,8,4,24,206,269,475,655
0132-000,2018,8,5,1,144,197,341,475
0132-000,2018,8,5,2,118,157,275,341
0132-000,2018,8,5,3,73,87,160,275
0132-000,2018,8,5,4,71,71,142,160
0132-000,2018,8,5,5,69,116,185,142
0132-000,2018,8,5,6,116,155,271,185
0132-000,2018,8,5,7,203,206,409,271
0132-000,2018,8,5,8,267,349,616,409
0132-000,2018,8,5,9,302,408,710,616
0132-000,2018,8,5,10,422,537,959,710
0132-000,2018,8,5,11,533,589,1122,959
0132-000,2018,8,5,12,556,591,1147,1122
0132-000,2018,8,5,13,592,627,1219,1147
0132-000,2018,8,5,14,585,639,1224,1219
0132-000,2018,8,5,15,724,637,1361,1224
0132-000,2018,8,5,16,730,628,1358,1361
0132-000,2018,8,5,17,871,607,1478,1358
0132-000,2018,8,5,18,815,591,1406,1478
0132-000,2018,8,5,19,848,569,1417,1406
0132-000,2018,8,5,20,656,493,1149,1417
0132-000,2018,8,5,21,562,424,986,1149
0132-000,2018,8,5,22,398,364,762,986
0132-000,2018,8,5,23,284,279,563,762
0132-000,2018,8,5,24,187,191,378,563
0132-000,2018,8,6,1,123,151,274,378
0132-000,2018,8,6,2,73,108,181,274
0132-000,2018,8,6,3,63,83,146,181
0132-000,2018,8,6,4,86,96,182,146
0132-000,2018,8,6,5,112,108,220,182
0132-000,2018,8,6,6,329,218,547,220
0132-000,2018,8,6,7,463,644,1107,547
0132-000,2018,8,6,8,591,1854,2445,1107
0132-000,2018,8,6,9,661,1385,2046,2445
0132-000,2018,8,6,10,721,764,1485,2046
0132-000,2018,8,6,11,751,757,1508,1485
0132-000,2018,8,6,12,691,733,1424,1508
0132-000,2018,8,6,13,709,815,1524,1424
0132-000,2018,8,6,14,717,769,1486,1524
0132-000,2018,8,6,15,769,766,1535,1486
0132-000,2018,8,6,16,822,754,1576,1535
0132-000,2018,8,6,17,816,775,1591,1576
0132-000,2018,8,6,18,1261,846,2107,1591
0132-000,2018,8,6,19,1441,785,2226,2107
0132-000,2018,8,6,20,973,648,1621,2226
0132-000,2018,8,6,21,772,511,1283,1621
0132-000,2018,8,6,22,519,414,933,1283
0132-000,2018,8,6,23,318,298,616,933
0132-000,2018,8,6,24,188,214,402,616
0132-000,2018,8,7,1,138,125,263,402
0132-000,2018,8,7,2,96,110,206,263
0132-000,2018,8,7,3,69,84,153,206
0132-000,2018,8,7,4,81,87,168,153
0132-000,2018,8,7,5,120,109,229,168
0132-000,2018,8,7,6,292,242,534,229
0132-000,2018,8,7,7,462,641,1103,534
0132-000,2018,8,7,8,635,1853,2488,1103
0132-000,2018,8,7,9,787,1405,2192,2488
0132-000,2018,8,7,10,750,813,1563,2192
0132-000,2018,8,7,11,678,789,1467,1563
0132-000,2018,8,7,12,716,731,1447,1467
0132-000,2018,8,7,13,670,688,1358,1447
0132-000,2018,8,7,14,710,824,1534,1358
0132-000,2018,8,7,15,766,745,1511,1534
0132-000,2018,8,7,16,820,724,1544,1511
0132-000,2018,8,7,17,895,814,1709,1544
0132-000,2018,8,7,18,1285,881,2166,1709
0132-000,2018,8,7,19,1451,803,2254,2166
0132-000,2018,8,7,20,945,697,1642,2254
0132-000,2018,8,7,21,752,491,1243,1642
0132-000,2018,8,7,22,593,434,1027,1243
0132-000,2018,8,7,23,304,334,638,1027
0132-000,2018,8,7,24,200,217,417,638
0132-000,2018,8,8,1,136,158,294,417
0132-000,2018,8,8,2,98,103,201,294
0132-000,2018,8,8,3,78,97,175,201
0132-000,2018,8,8,4,104,99,203,175
0132-000,2018,8,8,5,117,99,216,203
0132-000,2018,8,8,6,294,237,531,216
0132-000,2018,8,8,7,454,643,1097,531
0132-000,2018,8,8,8,614,1819,2433,1097
0132-000,2018,8,8,9,773,1440,2213,2433
0132-000,2018,8,8,10,720,826,1546,2213
0132-000,2018,8,8,11,710,833,1543,1546
0132-000,2018,8,8,12,708,749,1457,1543
0132-000,2018,8,8,13,749,716,1465,1457
0132-000,2018,8,8,14,704,775,1479,1465
0132-000,2018,8,8,15,753,714,1467,1479
0132-000,2018,8,8,16,788,752,1540,1467
0132-000,2018,8,8,17,843,779,1622,1540
0132-000,2018,8,8,18,1373,958,2331,1622
0132-000,2018,8,8,19,1497,771,2268,2331
0132-000,2018,8,8,20,972,645,1617,2268
0132-000,2018,8,8,21,771,501,1272,1617
0132-000,2018,8,8,22,532,395,927,1272
0132-000,2018,8,8,23,355,323,678,927
0132-000,2018,8,8,24,193,270,463,678
0132-000,2018,8,9,1,169,189,358,463
0132-000,2018,8,9,2,99,119,218,358
0132-000,2018,8,9,3,79,80,159,218
0132-000,2018,8,9,4,82,89,171,159
0132-000,2018,8,9,5,105,95,200,171
0132-000,2018,8,9,6,300,246,546,200
0132-000,2018,8,9,7,510,607,1117,546
0132-000,2018,8,9,8,604,1845,2449,1117
0132-000,2018,8,9,9,763,1410,2173,2449
0132-000,2018,8,9,10,683,826,1509,2173
0132-000,2018,8,9,11,639,764,1403,1509
0132-000,2018,8,9,12,718,745,1463,1403
0132-000,2018,8,9,13,691,711,1402,1463
0132-000,2018,8,9,14,740,738,1478,1402
0132-000,2018,8,9,15,768,761,1529,1478
0132-000,2018,8,9,16,784,707,1491,1529
0132-000,2018,8,9,17,876,734,1610,1491
0132-000,2018,8,9,18,1284,904,2188,1610
0132-000,2018,8,9,19,1483,755,2238,2188
0132-000,2018,8,9,20,887,661,1548,2238
0132-000,2018,8,9,21,772,458,1230,1548
0132-000,2018,8,9,22,554,386,940,1230
0132-000,2018,8,9,23,348,402,750,940
0132-000,2018,8,9,24,216,232,448,750
0132-000,2018,8,10,1,144,197,341,448
0132-000,2018,8,10,2,88,119,207,341
0132-000,2018,8,10,3,68,90,158,207
0132-000,2018,8,10,4,96,85,181,158
0132-000,2018,8,10,5,114,135,249,181
0132-000,2018,8,10,6,297,247,544,249
0132-000,2018,8,10,7,476,682,1158,544
0132-000,2018,8,10,8,592,1783,2375,1158
0132-000,2018,8,10,9,784,1492,2276,2375
0132-000,2018,8,10,10,786,812,1598,2276
0132-000,2018,8,10,11,686,794,1480,1598
0132-000,2018,8,10,12,703,813,1516,1480
0132-000,2018,8,10,13,819,777,1596,1516
0132-000,2018,8,10,14,772,768,1540,1596
0132-000,2018,8,10,15,853,806,1659,1540
0132-000,2018,8,10,16,910,794,1704,1659
0132-000,2018,8,10,17,910,830,1740,1704
0132-000,2018,8,10,18,1344,973,2317,1740
0132-000,2018,8,10,19,1716,886,2602,2317
0132-000,2018,8,10,20,1020,846,1866,2602
0132-000,2018,8,10,21,811,622,1433,1866
0132-000,2018,8,10,22,658,507,1165,1433
0132-000,2018,8,10,23,406,434,840,1165
0132-000,2018,8,10,24,235,305,540,840
0132-000,2018,8,11,1,159,192,351,540
0132-000,2018,8,11,2,134,153,287,351
0132-000,2018,8,11,3,101,144,245,287
0132-000,2018,8,11,4,122,150,272,245
0132-000,2018,8,11,5,127,130,257,272
0132-000,2018,8,11,6,261,214,475,257
0132-000,2018,8,11,7,383,499,882,475
0132-000,2018,8,11,8,479,825,1304,882
0132-000,2018,8,11,9,601,857,1458,1304
0132-000,2018,8,11,10,648,787,1435,1458
0132-000,2018,8,11,11,663,881,1544,1435
0132-000,2018,8,11,12,746,877,1623,1544
0132-000,2018,8,11,13,783,825,1608,1623
0132-000,2018,8,11,14,732,892,1624,1608
0132-000,2018,8,11,15,791,781,1572,1624
0132-000,2018,8,11,16,765,818,1583,1572
0132-000,2018,8,11,17,833,800,1633,1583
0132-000,2018,8,11,18,985,866,1851,1633
0132-000,2018,8,11,19,931,766,1697,1851
0132-000,2018,8,11,20,714,611,1325,1697
0132-000,2018,8,11,21,563,459,1022,1325
0132-000,2018,8,11,22,527,417,944,1022
0132-000,2018,8,11,23,358,401,759,944
0132-000,2018,8,11,24,239,259,498,759
0132-000,2018,8,12,1,167,172,339,498
0132-000,2018,8,12,2,128,171,299,339
0132-000,2018,8,12,3,96,120,216,299
0132-000,2018,8,12,4,79,85,164,216
0132-000,2018,8,12,5,98,111,209,164
0132-000,2018,8,12,6,140,176,316,209
0132-000,2018,8,12,7,202,235,437,316
0132-000,2018,8,12,8,258,362,620,437
0132-000,2018,8,12,9,337,459,796,620
0132-000,2018,8,12,10,417,536,953,796
0132-000,2018,8,12,11,488,555,1043,953
0132-000,2018,8,12,12,508,565,1073,1043
0132-000,2018,8,12,13,592,501,1093,1073
0132-000,2018,8,12,14,614,682,1296,1093
0132-000,2018,8,12,15,680,650,1330,1296
0132-000,2018,8,12,16,695,618,1313,1330
0132-000,2018,8,12,17,766,628,1394,1313
0132-000,2018,8,12,18,852,659,1511,1394
0132-000,2018,8,12,19,840,570,1410,1511
0132-000,2018,8,12,20,574,543,1117,1410
0132-000,2018,8,12,21,487,430,917,1117
0132-000,2018,8,12,22,378,401,779,917
0132-000,2018,8,12,23,254,320,574,779
0132-000,2018,8,12,24,172,214,386,574
0132-000,2018,8,13,1,96,117,213,386
0132-000,2018,8,13,2,75,101,176,213
0132-000,2018,8,13,3,53,83,136,176
0132-000,2018,8,13,4,64,65,129,136
0132-000,2018,8,13,5,123,85,208,129
0132-000,2018,8,13,6,322,247,569,208
0132-000,2018,8,13,7,498,718,1216,569
0132-000,2018,8,13,8,619,1918,2537,1216
0132-000,2018,8,13,9,764,1406,2170,2537
0132-000,2018,8,13,10,698,858,1556,2170
0132-000,2018,8,13,11,768,843,1611,1556
0132-000,2018,8,13,12,781,792,1573,1611
0132-000,2018,8,13,13,717,744,1461,1573
0132-000,2018,8,13,14,676,758,1434,1461
0132-000,2018,8,13,15,788,816,1604,1434
0132-000,2018,8,13,16,836,777,1613,1604
0132-000,2018,8,13,17,907,776,1683,1613
0132-000,2018,8,13,18,1244,858,2102,1683
0132-000,2018,8,13,19,1487,849,2336,2102
0132-000,2018,8,13,20,900,704,1604,2336
0132-000,2018,8,13,21,810,482,1292,1604
0132-000,2018,8,13,22,522,384,906,1292
0132-000,2018,8,13,23,315,307,622,906
0132-000,2018,8,13,24,167,225,392,622
0132-000,2018,8,14,1,133,133,266,392
0132-000,2018,8,14,2,90,113,203,266
0132-000,2018,8,14,3,66,101,167,203
0132-000,2018,8,14,4,75,116,191,167
0132-000,2018,8,14,5,108,135,243,191
0132-000,2018,8,14,6,333,233,566,243
0132-000,2018,8,14,7,443,626,1069,566
0132-000,2018,8,14,8,656,1814,2470,1069
0132-000,2018,8,14,9,811,1391,2202,2470
0132-000,2018,8,14,10,748,828,1576,2202
0132-000,2018,8,14,11,698,939,1637,1576
0132-000,2018,8,14,12,672,831,1503,1637
0132-000,2018,8,14,13,771,779,1550,1503
0132-000,2018,8,14,14,769,707,1476,1550
0132-000,2018,8,14,15,822,801,1623,1476
0132-000,2018,8,14,16,826,847,1673,1623
0132-000,2018,8,14,17,849,870,1719,1673
0132-000,2018,8,14,18,1357,912,2269,1719
0132-000,2018,8,14,19,1649,857,2506,2269
0132-000,2018,8,14,20,999,777,1776,2506
0132-000,2018,8,14,21,759,528,1287,1776
0132-000,2018,8,14,22,549,424,973,1287
0132-000,2018,8,14,23,323,328,651,973
0132-000,2018,8,14,24,247,287,534,651
0132-000,2018,8,15,1,161,226,387,534
0132-000,2018,8,15,2,125,207,332,387
0132-000,2018,8,15,3,83,165,248,332
0132-000,2018,8,15,4,115,124,239,248
0132-000,2018,8,15,5,130,139,269,239
0132-000,2018,8,15,6,250,225,475,269
0132-000,2018,8,15,7,367,450,817,475
0132-000,2018,8,15,8,430,843,1273,817
0132-000,2018,8,15,9,496,803,1299,1273
0132-000,2018,8,15,10,572,667,1239,1299
0132-000,2018,8,15,11,604,736,1340,1239
0132-000,2018,8,15,12,642,839,1481,1340
0132-000,2018,8,15,13,708,746,1454,1481
0132-000,2018,8,15,14,718,765,1483,1454
0132-000,2018,8,15,15,745,732,1477,1483
0132-000,2018,8,15,16,817,649,1466,1477
0132-000,2018,8,15,17,807,777,1584,1466
0132-000,2018,8,15,18,1100,753,1853,1584
0132-000,2018,8,15,19,920,666,1586,1853
0132-000,2018,8,15,20,731,586,1317,1586
0132-000,2018,8,15,21,529,488,1017,1317
0132-000,2018,8,15,22,405,401,806,1017
0132-000,2018,8,15,23,246,288,534,806
0132-000,2018,8,15,24,175,199,374,534
0132-000,2018,8,16,1,118,160,278,374
0132-000,2018,8,16,2,83,87,170,278
0132-000,2018,8,16,3,55,81,136,170
0132-000,2018,8,16,4,89,96,185,136
0132-000,2018,8,16,5,110,114,224,185
0132-000,2018,8,16,6,342,256,598,224
0132-000,2018,8,16,7,502,640,1142,598
0132-000,2018,8,16,8,637,1898,2535,1142
0132-000,2018,8,16,9,810,1538,2348,2535
0132-000,2018,8,16,10,700,906,1606,2348
0132-000,2018,8,16,11,711,857,1568,1606
0132-000,2018,8,16,12,752,817,1569,1568
0132-000,2018,8,16,13,687,703,1390,1569
0132-000,2018,8,16,14,807,763,1570,1390
0132-000,2018,8,16,15,857,831,1688,1570
0132-000,2018,8,16,16,871,803,1674,1688
0132-000,2018,8,16,17,844,817,1661,1674
0132-000,2018,8,16,18,1265,919,2184,1661
0132-000,2018,8,16,19,1521,793,2314,2184
0132-000,2018,8,16,20,906,725,1631,2314
0132-000,2018,8,16,21,762,572,1334,1631
0132-000,2018,8,16,22,590,374,964,1334
0132-000,2018,8,16,23,365,335,700,964
0132-000,2018,8,16,24,216,233,449,700
0132-000,2018,8,17,1,138,157,295,449
0132-000,2018,8,17,2,97,170,267,295
0132-000,2018,8,17,3,72,100,172,267
0132-000,2018,8,17,4,98,119,217,172
0132-000,2018,8,17,5,114,106,220,217
0132-000,2018,8,17,6,349,241,590,220
0132-000,2018,8,17,7,456,673,1129,590
0132-000,2018,8,17,8,680,1799,2479,1129
0132-000,2018,8,17,9,811,1523,2334,2479
0132-000,2018,8,17,10,746,902,1648,2334
0132-000,2018,8,17,11,762,851,1613,1648
0132-000,2018,8,17,12,748,790,1538,1613
0132-000,2018,8,17,13,714,800,1514,1538
0132-000,2018,8,17,14,762,788,1550,1514
0132-000,2018,8,17,15,836,820,1656,1550
0132-000,2018,8,17,16,842,796,1638,1656
0132-000,2018,8,17,17,945,888,1833,1638
0132-000,2018,8,17,18,1452,976,2428,1833
0132-000,2018,8,17,19,1622,885,2507,2428
0132-000,2018,8,17,20,1066,801,1867,2507
0132-000,2018,8,17,21,847,590,1437,1867
0132-000,2018,8,17,22,632,466,1098,1437
0132-000,2018,8,17,23,368,334,702,1098
0132-000,2018,8,17,24,218,247,465,702
0132-000,2018,8,18,1,193,181,374,465
0132-000,2018,8,18,2,121,156,277,374
0132-000,2018,8,18,3,87,127,214,277
0132-000,2018,8,18,4,113,121,234,214
0132-000,2018,8,18,5,100,128,228,234
0132-000,2018,8,18,6,285,231,516,228
0132-000,2018,8,18,7,406,422,828,516
0132-000,2018,8,18,8,429,786,1215,828
0132-000,2018,8,18,9,618,806,1424,1215
0132-000,2018,8,18,10,653,746,1399,1424
0132-000,2018,8,18,11,722,948,1670,1399
0132-000,2018,8,18,12,749,889,1638,1670
0132-000,2018,8,18,13,816,845,1661,1638
0132-000,2018,8,18,14,795,846,1641,1661
0132-000,2018,8,18,15,773,802,1575,1641
0132-000,2018,8,18,16,811,805,1616,1575
0132-000,2018,8,18,17,855,832,1687,1616
0132-000,2018,8,18,18,1113,903,2016,1687
0132-000,2018,8,18,19,950,908,1858,2016
0132-000,2018,8,18,20,657,592,1249,1858
0132-000,2018,8,18,21,614,516,1130,1249
0132-000,2018,8,18,22,497,438,935,1130
0132-000,2018,8,18,23,337,342,679,935
0132-000,2018,8,18,24,229,228,457,679
0132-000,2018,8,19,1,147,197,344,457
0132-000,2018,8,19,2,137,115,252,344
0132-000,2018,8,19,3,83,113,196,252
0132-000,2018,8,19,4,84,84,168,196
0132-000,2018,8,19,5,95,94,189,168
0132-000,2018,8,19,6,131,148,279,189
0132-000,2018,8,19,7,223,239,462,279
0132-000,2018,8,19,8,235,348,583,462
0132-000,2018,8,19,9,345,443,788,583
0132-000,2018,8,19,10,424,529,953,788
0132-000,2018,8,19,11,514,563,1077,953
0132-000,2018,8,19,12,562,654,1216,1077
0132-000,2018,8,19,13,645,651,1296,1216
0132-000,2018,8,19,14,615,659,1274,1296
0132-000,2018,8,19,15,713,669,1382,1274
0132-000,2018,8,19,16,804,720,1524,1382
0132-000,2018,8,19,17,809,684,1493,1524
0132-000,2018,8,19,18,874,660,1534,1493
0132-000,2018,8,19,19,880,593,1473,1534
0132-000,2018,8,19,20,657,552,1209,1473
0132-000,2018,8,19,21,547,500,1047,1209
0132-000,2018,8,19,22,408,395,803,1047
0132-000,2018,8,19,23,243,262,505,803
0132-000,2018,8,19,24,146,180,326,505
0132-000,2018,8,20,1,122,163,285,326
0132-000,2018,8,20,2,73,84,157,285
0132-000,2018,8,20,3,51,54,105,157
0132-000,2018,8,20,4,71,80,151,105
0132-000,2018,8,20,5,116,97,213,151
0132-000,2018,8,20,6,358,222,580,213
0132-000,2018,8,20,7,476,715,1191,580
0132-000,2018,8,20,8,647,1945,2592,1191
0132-000,2018,8,20,9,776,1493,2269,2592
0132-000,2018,8,20,10,752,787,1539,2269
0132-000,2018,8,20,11,778,778,1556,1539
0132-000,2018,8,20,12,748,836,1584,1556
0132-000,2018,8,20,13,704,748,1452,1584
0132-000,2018,8,20,14,753,815,1568,1452
0132-000,2018,8,20,15,853,750,1603,1568
0132-000,2018,8,20,16,784,815,1599,1603
0132-000,2018,8,20,17,882,886,1768,1599
0132-000,2018,8,20,18,1280,917,2197,1768
0132-000,2018,8,20,19,1526,856,2382,2197
0132-000,2018,8,20,20,966,727,1693,2382
0132-000,2018,8,20,21,845,529,1374,1693
0132-000,2018,8,20,22,523,371,894,1374
0132-000,2018,8,20,23,294,318,612,894
0132-000,2018,8,20,24,188,200,388,612
0132-000,2018,8,21,1,137,122,259,388
0132-000,2018,8,21,2,69,96,165,259
0132-000,2018,8,21,3,65,84,149,165
0132-000,2018,8,21,4,67,85,152,149
0132-000,2018,8,21,5,115,85,200,152
0132-000,2018,8,21,6,324,196,520,200
0132-000,2018,8,21,7,489,648,1137,520
0132-000,2018,8,21,8,605,1872,2477,1137
0132-000,2018,8,21,9,834,1588,2422,2477
0132-000,2018,8,21,10,736,861,1597,2422
0132-000,2018,8,21,11,703,811,1514,1597
0132-000,2018,8,21,12,727,760,1487,1514
0132-000,2018,8,21,13,733,686,1419,1487
0132-000,2018,8,21,14,787,760,1547,1419
0132-000,2018,8,21,15,764,671,1435,1547
0132-000,2018,8,21,16,820,708,1528,1435
0132-000,2018,8,21,17,855,756,1611,1528
0132-000,2018,8,21,18,1263,811,2074,1611
0132-000,2018,8,21,19,1519,799,2318,2074
0132-000,2018,8,21,20,960,594,1554,2318
0132-000,2018,8,21,21,820,472,1292,1554
0132-000,2018,8,21,22,521,377,898,1292
0132-000,2018,8,21,23,364,333,697,898
0132-000,2018,8,21,24,204,181,385,697
0132-000,2018,8,22,1,123,129,252,385
0132-000,2018,8,22,2,94,84,178,252
0132-000,2018,8,22,3,73,82,155,178
0132-000,2018,8,22,4,78,77,155,155
0132-000,2018,8,22,5,97,88,185,155
0132-000,2018,8,22,6,346,213,559,185
0132-000,2018,8,22,7,470,585,1055,559
0132-000,2018,8,22,8,638,1872,2510,1055
0132-000,2018,8,22,9,852,1550,2402,2510
0132-000,2018,8,22,10,794,889,1683,2402
0132-000,2018,8,22,11,678,837,1515,1683
0132-000,2018,8,22,12,730,833,1563,1515
0132-000,2018,8,22,13,720,718,1438,1563
0132-000,2018,8,22,14,844,784,1628,1438
0132-000,2018,8,22,15,845,864,1709,1628
0132-000,2018,8,22,16,906,771,1677,1709
0132-000,2018,8,22,17,906,818,1724,1677
0132-000,2018,8,22,18,1388,965,2353,1724
0132-000,2018,8,22,19,1584,865,2449,2353
0132-000,2018,8,22,20,1039,687,1726,2449
0132-000,2018,8,22,21,740,507,1247,1726
0132-000,2018,8,22,22,550,403,953,1247
0132-000,2018,8,22,23,318,329,647,953
0132-000,2018,8,22,24,190,215,405,647
0132-000,2018,8,23,1,133,135,268,405
0132-000,2018,8,23,2,102,126,228,268
0132-000,2018,8,23,3,63,87,150,228
0132-000,2018,8,23,4,64,84,148,150
0132-000,2018,8,23,5,97,118,215,148
0132-000,2018,8,23,6,244,162,406,215
0132-000,2018,8,23,7,398,566,964,406
0132-000,2018,8,23,8,584,1830,2414,964
0132-000,2018,8,23,9,777,1508,2285,2414
0132-000,2018,8,23,10,688,797,1485,2285
0132-000,2018,8,23,11,700,775,1475,1485
0132-000,2018,8,23,12,683,732,1415,1475
0132-000,2018,8,23,13,668,660,1328,1415
0132-000,2018,8,23,14,670,750,1420,1328
0132-000,2018,8,23,15,735,796,1531,1420
0132-000,2018,8,23,16,773,755,1528,1531
0132-000,2018,8,23,17,791,776,1567,1528
0132-000,2018,8,23,18,1261,912,2173,1567
0132-000,2018,8,23,19,1505,774,2279,2173
0132-000,2018,8,23,20,867,693,1560,2279
0132-000,2018,8,23,21,717,515,1232,1560
0132-000,2018,8,23,22,398,347,745,1232
0132-000,2018,8,23,23,210,187,397,745
0132-000,2018,8,23,24,126,147,273,397
0132-000,2018,8,24,1,132,99,231,273
0132-000,2018,8,24,2,74,87,161,231
0132-000,2018,8,24,3,53,66,119,161
0132-000,2018,8,24,4,44,67,111,119
0132-000,2018,8,24,5,65,67,132,111
0132-000,2018,8,24,6,154,122,276,132
0132-000,2018,8,24,7,318,471,789,276
0132-000,2018,8,24,8,509,1657,2166,789
0132-000,2018,8,24,9,662,1329,1991,2166
0132-000,2018,8,24,10,577,722,1299,1991
0132-000,2018,8,24,11,626,692,1318,1299
0132-000,2018,8,24,12,631,699,1330,1318
0132-000,2018,8,24,13,608,659,1267,1330
0132-000,2018,8,24,14,656,693,1349,1267
0132-000,2018,8,24,15,710,679,1389,1349
0132-000,2018,8,24,16,772,688,1460,1389
0132-000,2018,8,24,17,837,739,1576,1460
0132-000,2018,8,24,18,1362,830,2192,1576
0132-000,2018,8,24,19,1573,786,2359,2192
0132-000,2018,8,24,20,931,669,1600,2359
0132-000,2018,8,24,21,817,455,1272,1600
0132-000,2018,8,24,22,614,371,985,1272
0132-000,2018,8,24,23,377,323,700,985
0132-000,2018,8,24,24,235,248,483,700
0132-000,2018,8,25,1,193,180,373,483
0132-000,2018,8,25,2,128,133,261,373
0132-000,2018,8,25,3,88,107,195,261
0132-000,2018,8,25,4,75,88,163,195
0132-000,2018,8,25,5,111,101,212,163
0132-000,2018,8,25,6,308,210,518,212
0132-000,2018,8,25,7,375,412,787,518
0132-000,2018,8,25,8,474,824,1298,787
0132-000,2018,8,25,9,638,877,1515,1298
0132-000,2018,8,25,10,698,866,1564,1515
0132-000,2018,8,25,11,715,858,1573,1564
0132-000,2018,8,25,12,787,901,1688,1573
0132-000,2018,8,25,13,861,945,1806,1688
0132-000,2018,8,25,14,805,933,1738,1806
0132-000,2018,8,25,15,853,866,1719,1738
0132-000,2018,8,25,16,873,828,1701,1719
0132-000,2018,8,25,17,940,926,1866,1701
0132-000,2018,8,25,18,1064,923,1987,1866
0132-000,2018,8,25,19,890,755,1645,1987
0132-000,2018,8,25,20,634,559,1193,1645
0132-000,2018,8,25,21,570,499,1069,1193
0132-000,2018,8,25,22,546,345,891,1069
0132-000,2018,8,25,23,307,288,595,891
0132-000,2018,8,25,24,236,215,451,595
0132-000,2018,8,26,1,174,179,353,451
0132-000,2018,8,26,2,128,113,241,353
0132-000,2018,8,26,3,106,91,197,241
0132-000,2018,8,26,4,93,83,176,197
0132-000,2018,8,26,5,95,86,181,176
0132-000,2018,8,26,6,202,122,324,181
0132-000,2018,8,26,7,206,208,414,324
0132-000,2018,8,26,8,269,336,605,414
0132-000,2018,8,26,9,325,379,704,605
0132-000,2018,8,26,10,417,448,865,704
0132-000,2018,8,26,11,535,601,1136,865
0132-000,2018,8,26,12,580,589,1169,1136
0132-000,2018,8,26,13,644,613,1257,1169
0132-000,2018,8,26,14,649,566,1215,1257
0132-000,2018,8,26,15,676,567,1243,1215
0132-000,2018,8,26,16,776,606,1382,1243
0132-000,2018,8,26,17,783,532,1315,1382
0132-000,2018,8,26,18,784,503,1287,1315
0132-000,2018,8,26,19,843,457,1300,1287
0132-000,2018,8,26,20,656,385,1041,1300
0132-000,2018,8,26,21,524,379,903,1041
0132-000,2018,8,26,22,338,323,661,903
0132-000,2018,8,26,23,221,224,445,661
0132-000,2018,8,26,24,149,136,285,445
0132-000,2018,8,27,1,99,96,195,285
0132-000,2018,8,27,2,63,71,134,195
0132-000,2018,8,27,3,52,60,112,134
0132-000,2018,8,27,4,45,69,114,112
0132-000,2018,8,27,5,81,68,149,114
0132-000,2018,8,27,6,267,163,430,149
0132-000,2018,8,27,7,409,558,967,430
0132-000,2018,8,27,8,640,1644,2284,967
0132-000,2018,8,27,9,795,1568,2363,2284
0132-000,2018,8,27,10,650,744,1394,2363
0132-000,2018,8,27,11,673,771,1444,1394
0132-000,2018,8,27,12,649,656,1305,1444
0132-000,2018,8,27,13,587,681,1268,1305
0132-000,2018,8,27,14,634,730,1364,1268
0132-000,2018,8,27,15,651,732,1383,1364
0132-000,2018,8,27,16,790,712,1502,1383
0132-000,2018,8,27,17,881,759,1640,1502
0132-000,2018,8,27,18,1256,826,2082,1640
0132-000,2018,8,27,19,1480,737,2217,2082
0132-000,2018,8,27,20,813,557,1370,2217
0132-000,2018,8,27,21,703,382,1085,1370
0132-000,2018,8,27,22,481,317,798,1085
0132-000,2018,8,27,23,298,230,528,798
0132-000,2018,8,27,24,196,166,362,528
0132-000,2018,8,28,1,126,110,236,362
0132-000,2018,8,28,2,89,71,160,236
0132-000,2018,8,28,3,59,81,140,160
0132-000,2018,8,28,4,60,83,143,140
0132-000,2018,8,28,5,76,84,160,143
0132-000,2018,8,28,6,241,142,383,160
0132-000,2018,8,28,7,388,474,862,383
0132-000,2018,8,28,8,577,1619,2196,862
0132-000,2018,8,28,9,812,1354,2166,2196
0132-000,2018,8,28,10,687,781,1468,2166
0132-000,2018,8,28,11,686,783,1469,1468
0132-000,2018,8,28,12,692,699,1391,1469
0132-000,2018,8,28,13,627,665,1292,1391
0132-000,2018,8,28,14,731,684,1415,1292
0132-000,2018,8,28,15,754,740,1494,1415
0132-000,2018,8,28,16,829,721,1550,1494
0132-000,2018,8,28,17,880,717,1597,1550
0132-000,2018,8,28,18,1229,722,1951,1597
0132-000,2018,8,28,19,1447,732,2179,1951
0132-000,2018,8,28,20,842,541,1383,2179
0132-000,2018,8,28,21,807,399,1206,1383
0132-000,2018,8,28,22,524,313,837,1206
0132-000,2018,8,28,23,298,256,554,837
0132-000,2018,8,28,24,207,159,366,554
0132-000,2018,8,29,1,134,90,224,366
0132-000,2018,8,29,2,85,97,182,224
0132-000,2018,8,29,3,63,56,119,182
0132-000,2018,8,29,4,83,83,166,119
0132-000,2018,8,29,5,91,88,179,166
0132-000,2018,8,29,6,300,167,467,179
0132-000,2018,8,29,7,439,536,975,467
0132-000,2018,8,29,8,663,1673,2336,975
0132-000,2018,8,29,9,773,1504,2277,2336
0132-000,2018,8,29,10,715,869,1584,2277
0132-000,2018,8,29,11,727,870,1597,1584
0132-000,2018,8,29,12,709,847,1556,1597
0132-000,2018,8,29,13,736,847,1583,1556
0132-000,2018,8,29,14,752,873,1625,1583
0132-000,2018,8,29,15,836,895,1731,1625
0132-000,2018,8,29,16,898,928,1826,1731
0132-000,2018,8,29,17,938,1029,1967,1826
0132-000,2018,8,29,18,1481,972,2453,1967
0132-000,2018,8,29,19,1639,884,2523,2453
0132-000,2018,8,29,20,795,615,1410,2523
0132-000,2018,8,29,21,692,499,1191,1410
0132-000,2018,8,29,22,460,398,858,1191
0132-000,2018,8,29,23,346,272,618,858
0132-000,2018,8,29,24,209,176,385,618
0132-000,2018,8,30,1,156,132,288,385
0132-000,2018,8,30,2,117,119,236,288
0132-000,2018,8,30,3,81,87,168,236
0132-000,2018,8,30,4,65,87,152,168
0132-000,2018,8,30,5,72,90,162,152
0132-000,2018,8,30,6,301,166,467,162
0132-000,2018,8,30,7,438,533,971,467
0132-000,2018,8,30,8,595,1680,2275,971
0132-000,2018,8,30,9,729,1643,2372,2275
0132-000,2018,8,30,10,699,939,1638,2372
0132-000,2018,8,30,11,736,950,1686,1638
0132-000,2018,8,30,12,747,856,1603,1686
0132-000,2018,8,30,13,676,847,1523,1603
0132-000,2018,8,30,14,730,812,1542,1523
0132-000,2018,8,30,15,751,820,1571,1542
0132-000,2018,8,30,16,767,772,1539,1571
0132-000,2018,8,30,17,901,803,1704,1539
0132-000,2018,8,30,18,1236,777,2013,1704
0132-000,2018,8,30,19,1636,784,2420,2013
0132-000,2018,8,30,20,955,628,1583,2420
0132-000,2018,8,30,21,779,384,1163,1583
0132-000,2018,8,30,22,478,349,827,1163
0132-000,2018,8,30,23,300,252,552,827
0132-000,2018,8,30,24,186,166,352,552
0132-000,2018,8,31,1,160,132,292,352
0132-000,2018,8,31,2,85,91,176,292
0132-000,2018,8,31,3,58,111,169,176
0132-000,2018,8,31,4,76,82,158,169
0132-000,2018,8,31,5,78,74,152,158
0132-000,2018,8,31,6,291,154,445,152
0132-000,2018,8,31,7,447,558,1005,445
0132-000,2018,8,31,8,599,1719,2318,1005
0132-000,2018,8,31,9,757,1505,2262,2318
0132-000,2018,8,31,10,688,856,1544,2262
0132-000,2018,8,31,11,587,700,1287,1544
0132-000,2018,8,31,12,719,844,1563,1287
0132-000,2018,8,31,13,694,823,1517,1563
0132-000,2018,8,31,14,745,894,1639,1517
0132-000,2018,8,31,15,781,923,1704,1639
0132-000,2018,8,31,16,920,953,1873,1704
0132-000,2018,8,31,17,973,1090,2063,1873
0132-000,2018,8,31,18,1383,1117,2500,2063
0132-000,2018,8,31,19,1699,873,2572,2500
0132-000,2018,8,31,20,1059,829,1888,2572
0132-000,2018,8,31,21,768,464,1232,1888
0132-000,2018,8,31,22,627,462,1089,1232
0132-000,2018,8,31,23,380,368,748,1089
0132-000,2018,8,31,24,254,269,523,748
0132-000,2018,9,1,1,228,213,441,523
0132-000,2018,9,1,2,149,156,305,441
0132-000,2018,9,1,3,106,177,283,305
0132-000,2018,9,1,4,104,174,278,283
0132-000,2018,9,1,5,104,119,223,278
0132-000,2018,9,1,6,308,217,525,223
0132-000,2018,9,1,7,429,445,874,525
0132-000,2018,9,1,8,496,813,1309,874
0132-000,2018,9,1,9,585,881,1466,1309
0132-000,2018,9,1,10,710,769,1479,1466
0132-000,2018,9,1,11,689,910,1599,1479
0132-000,2018,9,1,12,818,913,1731,1599
0132-000,2018,9,1,13,838,940,1778,1731
0132-000,2018,9,1,14,853,977,1830,1778
0132-000,2018,9,1,15,835,948,1783,1830
0132-000,2018,9,1,16,858,919,1777,1783
0132-000,2018,9,1,17,899,903,1802,1777
0132-000,2018,9,1,18,1048,949,1997,1802
0132-000,2018,9,1,19,989,722,1711,1997
0132-000,2018,9,1,20,734,650,1384,1711
0132-000,2018,9,1,21,596,480,1076,1384
0132-000,2018,9,1,22,390,325,715,1076
0132-000,2018,9,1,23,223,223,446,715
0132-000,2018,9,1,24,256,245,501,446
0132-000,2018,9,2,1,165,230,395,501
0132-000,2018,9,2,2,112,132,244,395
0132-000,2018,9,2,3,78,144,222,244
0132-000,2018,9,2,4,86,140,226,222
0132-000,2018,9,2,5,92,174,266,226
0132-000,2018,9,2,6,197,198,395,266
0132-000,2018,9,2,7,248,293,541,395
0132-000,2018,9,2,8,260,409,669,541
0132-000,2018,9,2,9,320,442,762,669
0132-000,2018,9,2,10,447,780,1227,762
0132-000,2018,9,2,11,518,666,1184,1227
0132-000,2018,9,2,12,566,927,1493,1184
0132-000,2018,9,2,13,639,1158,1797,1493
0132-000,2018,9,2,14,727,735,1462,1797
0132-000,2018,9,2,15,738,801,1539,1462
0132-000,2018,9,2,16,847,748,1595,1539
0132-000,2018,9,2,17,836,1038,1874,1595
0132-000,2018,9,2,18,965,840,1805,1874
0132-000,2018,9,2,19,944,673,1617,1805
0132-000,2018,9,2,20,633,560,1193,1617
0132-000,2018,9,2,21,551,498,1049,1193
0132-000,2018,9,2,22,408,390,798,1049
0132-000,2018,9,2,23,272,369,641,798
0132-000,2018,9,2,24,158,211,369,641
0132-000,2018,9,3,1,116,147,263,369
0132-000,2018,9,3,2,74,73,147,263
0132-000,2018,9,3,3,42,48,90,147
0132-000,2018,9,3,4,54,98,152,90
0132-000,2018,9,3,5,94,112,206,152
0132-000,2018,9,3,6,359,338,697,206
0132-000,2018,9,3,7,510,709,1219,697
0132-000,2018,9,3,8,655,2020,2675,1219
0132-000,2018,9,3,9,795,1565,2360,2675
0132-000,2018,9,3,10,722,843,1565,2360
0132-000,2018,9,3,11,707,763,1470,1565
0132-000,2018,9,3,12,647,722,1369,1470
0132-000,2018,9,3,13,688,718,1406,1369
0132-000,2018,9,3,14,587,613,1200,1406
0132-000,2018,9,3,15,728,747,1475,1200
0132-000,2018,9,3,16,792,770,1562,1475
0132-000,2018,9,3,17,843,774,1617,1562
0132-000,2018,9,3,18,1275,1091,2366,1617
0132-000,2018,9,3,19,1543,923,2466,2366
0132-000,2018,9,3,20,957,684,1641,2466
0132-000,2018,9,3,21,753,403,1156,1641
0132-000,2018,9,3,22,482,392,874,1156
0132-000,2018,9,3,23,315,317,632,874
0132-000,2018,9,3,24,158,163,321,632
0132-000,2018,9,4,1,134,130,264,321
0132-000,2018,9,4,2,86,85,171,264
0132-000,2018,9,4,3,60,81,141,171
0132-000,2018,9,4,4,62,64,126,141
0132-000,2018,9,4,5,85,84,169,126
0132-000,2018,9,4,6,324,182,506,169
0132-000,2018,9,4,7,485,592,1077,506
0132-000,2018,9,4,8,637,1911,2548,1077
0132-000,2018,9,4,9,814,1632,2446,2548
0132-000,2018,9,4,10,729,846,1575,2446
0132-000,2018,9,4,11,718,812,1530,1575
0132-000,2018,9,4,12,742,705,1447,1530
0132-000,2018,9,4,13,670,737,1407,1447
0132-000,2018,9,4,14,779,795,1574,1407
0132-000,2018,9,4,15,801,693,1494,1574
0132-000,2018,9,4,16,758,687,1445,1494
0132-000,2018,9,4,17,910,850,1760,1445
0132-000,2018,9,4,18,1322,897,2219,1760
0132-000,2018,9,4,19,1592,808,2400,2219
0132-000,2018,9,4,20,1059,613,1672,2400
0132-000,2018,9,4,21,826,479,1305,1672
0132-000,2018,9,4,22,547,417,964,1305
0132-000,2018,9,4,23,370,325,695,964
0132-000,2018,9,4,24,226,221,447,695
0132-000,2018,9,5,1,157,137,294,447
0132-000,2018,9,5,2,94,104,198,294
0132-000,2018,9,5,3,56,69,125,198
0132-000,2018,9,5,4,82,82,164,125
0132-000,2018,9,5,5,111,93,204,164
0132-000,2018,9,5,6,327,211,538,204
0132-000,2018,9,5,7,496,676,1172,538
0132-000,2018,9,5,8,683,1930,2613,1172
0132-000,2018,9,5,9,825,1611,2436,2613
0132-000,2018,9,5,10,709,878,1587,2436
0132-000,2018,9,5,11,781,846,1627,1587
0132-000,2018,9,5,12,709,777,1486,1627
0132-000,2018,9,5,13,726,764,1490,1486
0132-000,2018,9,5,14,762,727,1489,1490
0132-000,2018,9,5,15,809,765,1574,1489
0132-000,2018,9,5,16,859,798,1657,1574
0132-000,2018,9,5,17,949,906,1855,1657
0132-000,2018,9,5,18,1490,979,2469,1855
0132-000,2018,9,5,19,1674,864,2538,2469
0132-000,2018,9,5,20,1021,734,1755,2538
0132-000,2018,9,5,21,819,543,1362,1755
0132-000,2018,9,5,22,580,544,1124,1362
0132-000,2018,9,5,23,367,430,797,1124
0132-000,2018,9,5,24,223,290,513,797
0132-000,2018,9,6,1,146,151,297,513
0132-000,2018,9,6,2,120,121,241,297
0132-000,2018,9,6,3,72,86,158,241
0132-000,2018,9,6,4,69,87,156,158
0132-000,2018,9,6,5,106,96,202,156
0132-000,2018,9,6,6,352,218,570,202
0132-000,2018,9,6,7,499,665,1164,570
0132-000,2018,9,6,8,694,1929,2623,1164
0132-000,2018,9,6,9,804,1677,2481,2623
0132-000,2018,9,6,10,709,827,1536,2481
0132-000,2018,9,6,11,689,839,1528,1536
0132-000,2018,9,6,12,737,835,1572,1528
0132-000,2018,9,6,13,745,834,1579,1572
0132-000,2018,9,6,14,826,859,1685,1579
0132-000,2018,9,6,15,851,781,1632,1685
0132-000,2018,9,6,16,840,821,1661,1632
0132-000,2018,9,6,17,922,789,1711,1661
0132-000,2018,9,6,18,1439,979,2418,1711
0132-000,2018,9,6,19,1585,854,2439,2418
0132-000,2018,9,6,20,945,601,1546,2439
0132-000,2018,9,6,21,813,462,1275,1546
0132-000,2018,9,6,22,543,390,933,1275
0132-000,2018,9,6,23,334,313,647,933
0132-000,2018,9,6,24,180,210,390,647
0132-000,2018,9,7,1,174,162,336,390
0132-000,2018,9,7,2,94,100,194,336
0132-000,2018,9,7,3,66,80,146,194
0132-000,2018,9,7,4,71,88,159,146
0132-000,2018,9,7,5,105,89,194,159
0132-000,2018,9,7,6,320,209,529,194
0132-000,2018,9,7,7,475,598,1073,529
0132-000,2018,9,7,8,670,1840,2510,1073
0132-000,2018,9,7,9,795,1558,2353,2510
0132-000,2018,9,7,10,756,839,1595,2353
0132-000,2018,9,7,11,766,876,1642,1595
0132-000,2018,9,7,12,733,827,1560,1642
0132-000,2018,9,7,13,734,986,1720,1560
0132-000,2018,9,7,14,828,797,1625,1720
0132-000,2018,9,7,15,839,805,1644,1625
0132-000,2018,9,7,16,827,863,1690,1644
0132-000,2018,9,7,17,1015,829,1844,1690
0132-000,2018,9,7,18,1431,964,2395,1844
0132-000,2018,9,7,19,1854,997,2851,2395
0132-000,2018,9,7,20,1083,807,1890,2851
0132-000,2018,9,7,21,811,529,1340,1890
0132-000,2018,9,7,22,556,429,985,1340
0132-000,2018,9,7,23,420,376,796,985
0132-000,2018,9,7,24,244,217,461,796
0132-000,2018,9,8,1,185,195,380,461
0132-000,2018,9,8,2,129,148,277,380
0132-000,2018,9,8,3,100,106,206,277
0132-000,2018,9,8,4,82,107,189,206
0132-000,2018,9,8,5,125,114,239,189
0132-000,2018,9,8,6,296,238,534,239
0132-000,2018,9,8,7,413,455,868,534
0132-000,2018,9,8,8,485,921,1406,868
0132-000,2018,9,8,9,624,989,1613,1406
0132-000,2018,9,8,10,714,964,1678,1613
0132-000,2018,9,8,11,740,1014,1754,1678
0132-000,2018,9,8,12,1007,1028,2035,1754
0132-000,2018,9,8,13,1065,1006,2071,2035
0132-000,2018,9,8,14,912,948,1860,2071
0132-000,2018,9,8,15,887,869,1756,1860
0132-000,2018,9,8,16,863,846,1709,1756
0132-000,2018,9,8,17,1015,894,1909,1709
0132-000,2018,9,8,18,1469,1275,2744,1909
0132-000,2018,9,8,19,1314,1011,2325,2744
0132-000,2018,9,8,20,924,646,1570,2325
0132-000,2018,9,8,21,623,469,1092,1570
0132-000,2018,9,8,22,486,405,891,1092
0132-000,2018,9,8,23,310,353,663,891
0132-000,2018,9,8,24,226,214,440,663
0132-000,2018,9,9,1,163,166,329,440
0132-000,2018,9,9,2,109,130,239,329
0132-000,2018,9,9,3,85,98,183,239
0132-000,2018,9,9,4,100,94,194,183
0132-000,2018,9,9,5,81,69,150,194
0132-000,2018,9,9,6,157,152,309,150
0132-000,2018,9,9,7,245,337,582,309
0132-000,2018,9,9,8,283,372,655,582
0132-000,2018,9,9,9,399,410,809,655
0132-000,2018,9,9,10,426,614,1040,809
0132-000,2018,9,9,11,538,634,1172,1040
0132-000,2018,9,9,12,606,758,1364,1172
0132-000,2018,9,9,13,717,886,1603,1364
0132-000,2018,9,9,14,760,650,1410,1603
0132-000,2018,9,9,15,814,684,1498,1410
0132-000,2018,9,9,16,1076,677,1753,1498
0132-000,2018,9,9,17,1413,785,2198,1753
0132-000,2018,9,9,18,1517,672,2189,2198
0132-000,2018,9,9,19,1599,565,2164,2189
0132-000,2018,9,9,20,1337,472,1809,2164
0132-000,2018,9,9,21,1040,438,1478,1809
0132-000,2018,9,9,22,688,356,1044,1478
0132-000,2018,9,9,23,345,296,641,1044
0132-000,2018,9,9,24,179,174,353,641
0132-000,2018,9,10,1,112,117,229,353
0132-000,2018,9,10,2,77,78,155,229
0132-000,2018,9,10,3,49,58,107,155
0132-000,2018,9,10,4,54,66,120,107
0132-000,2018,9,10,5,119,70,189,120
0132-000,2018,9,10,6,336,219,555,189
0132-000,2018,9,10,7,510,680,1190,555
0132-000,2018,9,10,8,695,1989,2684,1190
0132-000,2018,9,10,9,774,1680,2454,2684
0132-000,2018,9,10,10,751,903,1654,2454
0132-000,2018,9,10,11,646,827,1473,1654
0132-000,2018,9,10,12,705,814,1519,1473
0132-000,2018,9,10,13,727,784,1511,1519
0132-000,2018,9,10,14,763,778,1541,1511
0132-000,2018,9,10,15,774,810,1584,1541
0132-000,2018,9,10,16,873,792,1665,1584
0132-000,2018,9,10,17,947,815,1762,1665
0132-000,2018,9,10,18,1389,914,2303,1762
0132-000,2018,9,10,19,1628,893,2521,2303
0132-000,2018,9,10,20,994,684,1678,2521
0132-000,2018,9,10,21,847,485,1332,1678
0132-000,2018,9,10,22,543,398,941,1332
0132-000,2018,9,10,23,341,319,660,941
0132-000,2018,9,10,24,217,184,401,660
0132-000,2018,9,11,1,151,166,317,401
0132-000,2018,9,11,2,100,86,186,317
0132-000,2018,9,11,3,77,83,160,186
0132-000,2018,9,11,4,65,86,151,160
0132-000,2018,9,11,5,97,95,192,151
0132-000,2018,9,11,6,349,204,553,192
0132-000,2018,9,11,7,465,614,1079,553
0132-000,2018,9,11,8,657,1925,2582,1079
0132-000,2018,9,11,9,825,1656,2481,2582
0132-000,2018,9,11,10,780,1013,1793,2481
0132-000,2018,9,11,11,751,839,1590,1793
0132-000,2018,9,11,12,714,816,1530,1590
0132-000,2018,9,11,13,744,766,1510,1530
0132-000,2018,9,11,14,817,770,1587,1510
0132-000,2018,9,11,15,781,812,1593,1587
0132-000,2018,9,11,16,879,875,1754,1593
0132-000,2018,9,11,17,963,897,1860,1754
0132-000,2018,9,11,18,1373,947,2320,1860
0132-000,2018,9,11,19,1621,842,2463,2320
0132-000,2018,9,11,20,1000,680,1680,2463
0132-000,2018,9,11,21,797,450,1247,1680
0132-000,2018,9,11,22,559,361,920,1247
0132-000,2018,9,11,23,343,326,669,920
0132-000,2018,9,11,24,198,201,399,669
0132-000,2018,9,12,1,158,163,321,399
0132-000,2018,9,12,2,110,116,226,321
0132-000,2018,9,12,3,66,71,137,226
0132-000,2018,9,12,4,71,80,151,137
0132-000,2018,9,12,5,99,86,185,151
0132-000,2018,9,12,6,366,204,570,185
0132-000,2018,9,12,7,540,610,1150,570
0132-000,2018,9,12,8,692,1873,2565,1150
0132-000,2018,9,12,9,801,1625,2426,2565
0132-000,2018,9,12,10,758,922,1680,2426
0132-000,2018,9,12,11,760,863,1623,1680
0132-000,2018,9,12,12,744,778,1522,1623
0132-000,2018,9,12,13,700,760,1460,1522
0132-000,2018,9,12,14,790,800,1590,1460
0132-000,2018,9,12,15,835,851,1686,1590
0132-000,2018,9,12,16,827,769,1596,1686
0132-000,2018,9,12,17,949,858,1807,1596
0132-000,2018,9,12,18,1443,938,2381,1807
0132-000,2018,9,12,19,1747,842,2589,2381
0132-000,2018,9,12,20,953,681,1634,2589
0132-000,2018,9,12,21,756,443,1199,1634
0132-000,2018,9,12,22,527,453,980,1199
0132-000,2018,9,12,23,345,334,679,980
0132-000,2018,9,12,24,205,193,398,679
0132-000,2018,9,13,1,159,128,287,398
0132-000,2018,9,13,2,116,98,214,287
0132-000,2018,9,13,3,77,101,178,214
0132-000,2018,9,13,4,99,84,183,178
0132-000,2018,9,13,5,120,101,221,183
0132-000,2018,9,13,6,351,215,566,221
0132-000,2018,9,13,7,492,570,1062,566
0132-000,2018,9,13,8,677,1855,2532,1062
0132-000,2018,9,13,9,827,1696,2523,2532
0132-000,2018,9,13,10,726,931,1657,2523
0132-000,2018,9,13,11,753,821,1574,1657
0132-000,2018,9,13,12,764,789,1553,1574
0132-000,2018,9,13,13,728,760,1488,1553
0132-000,2018,9,13,14,803,798,1601,1488
0132-000,2018,9,13,15,831,787,1618,1601
0132-000,2018,9,13,16,886,882,1768,1618
0132-000,2018,9,13,17,896,888,1784,1768
0132-000,2018,9,13,18,1337,967,2304,1784
0132-000,2018,9,13,19,1622,831,2453,2304
0132-000,2018,9,13,20,954,712,1666,2453
0132-000,2018,9,13,21,860,493,1353,1666
0132-000,2018,9,13,22,575,451,1026,1353
0132-000,2018,9,13,23,380,337,717,1026
0132-000,2018,9,13,24,255,203,458,717
0132-000,2018,9,14,1,154,174,328,458
0132-000,2018,9,14,2,119,109,228,328
0132-000,2018,9,14,3,74,93,167,228
0132-000,2018,9,14,4,78,89,167,167
0132-000,2018,9,14,5,121,107,228,167
0132-000,2018,9,14,6,369,205,574,228
0132-000,2018,9,14,7,477,606,1083,574
0132-000,2018,9,14,8,707,1859,2566,1083
0132-000,2018,9,14,9,822,1655,2477,2566
0132-000,2018,9,14,10,728,880,1608,2477
0132-000,2018,9,14,11,724,850,1574,1608
0132-000,2018,9,14,12,796,764,1560,1574
0132-000,2018,9,14,13,754,754,1508,1560
0132-000,2018,9,14,14,763,775,1538,1508
0132-000,2018,9,14,15,793,810,1603,1538
0132-000,2018,9,14,16,872,816,1688,1603
0132-000,2018,9,14,17,941,889,1830,1688
0132-000,2018,9,14,18,1445,1020,2465,1830
0132-000,2018,9,14,19,1713,842,2555,2465
0132-000,2018,9,14,20,1085,723,1808,2555
0132-000,2018,9,14,21,789,511,1300,1808
0132-000,2018,9,14,22,578,435,1013,1300
0132-000,2018,9,14,23,357,368,725,1013
0132-000,2018,9,14,24,252,211,463,725
0132-000,2018,9,15,1,168,158,326,463
0132-000,2018,9,15,2,117,140,257,326
0132-000,2018,9,15,3,104,114,218,257
0132-000,2018,9,15,4,88,99,187,218
0132-000,2018,9,15,5,117,106,223,187
0132-000,2018,9,15,6,275,202,477,223
0132-000,2018,9,15,7,387,433,820,477
0132-000,2018,9,15,8,467,928,1395,820
0132-000,2018,9,15,9,635,1001,1636,1395
0132-000,2018,9,15,10,685,997,1682,1636
0132-000,2018,9,15,11,783,1128,1911,1682
0132-000,2018,9,15,12,887,1109,1996,1911
0132-000,2018,9,15,13,905,1210,2115,1996
0132-000,2018,9,15,14,816,1002,1818,2115
0132-000,2018,9,15,15,944,900,1844,1818
0132-000,2018,9,15,16,937,983,1920,1844
0132-000,2018,9,15,17,1069,911,1980,1920
0132-000,2018,9,15,18,1311,886,2197,1980
0132-000,2018,9,15,19,1195,788,1983,2197
0132-000,2018,9,15,20,767,593,1360,1983
0132-000,2018,9,15,21,627,477,1104,1360
0132-000,2018,9,15,22,457,396,853,1104
0132-000,2018,9,15,23,276,318,594,853
0132-000,2018,9,15,24,210,214,424,594
0132-000,2018,9,16,1,180,169,349,424
0132-000,2018,9,16,2,120,241,361,349
0132-000,2018,9,16,3,93,104,197,361
0132-000,2018,9,16,4,96,113,209,197
0132-000,2018,9,16,5,79,77,156,209
0132-000,2018,9,16,6,219,154,373,156
0132-000,2018,9,16,7,266,349,615,373
0132-000,2018,9,16,8,328,497,825,615
0132-000,2018,9,16,9,399,619,1018,825
0132-000,2018,9,16,10,456,675,1131,1018
0132-000,2018,9,16,11,570,724,1294,1131
0132-000,2018,9,16,12,555,782,1337,1294
0132-000,2018,9,16,13,717,796,1513,1337
0132-000,2018,9,16,14,770,874,1644,1513
0132-000,2018,9,16,15,925,800,1725,1644
0132-000,2018,9,16,16,970,984,1954,1725
0132-000,2018,9,16,17,1012,739,1751,1954
0132-000,2018,9,16,18,1138,731,1869,1751
0132-000,2018,9,16,19,1169,547,1716,1869
0132-000,2018,9,16,20,782,467,1249,1716
0132-000,2018,9,16,21,593,418,1011,1249
0132-000,2018,9,16,22,416,365,781,1011
0132-000,2018,9,16,23,271,315,586,781
0132-000,2018,9,16,24,173,188,361,586
0132-000,2018,9,17,1,105,111,216,361
0132-000,2018,9,17,2,74,70,144,216
0132-000,2018,9,17,3,62,64,126,144
0132-000,2018,9,17,4,64,90,154,126
0132-000,2018,9,17,5,98,94,192,154
0132-000,2018,9,17,6,360,202,562,192
0132-000,2018,9,17,7,526,657,1183,562
0132-000,2018,9,17,8,669,1978,2647,1183
0132-000,2018,9,17,9,779,1728,2507,2647
0132-000,2018,9,17,10,738,913,1651,2507
0132-000,2018,9,17,11,762,862,1624,1651
0132-000,2018,9,17,12,785,933,1718,1624
0132-000,2018,9,17,13,766,855,1621,1718
0132-000,2018,9,17,14,829,913,1742,1621
0132-000,2018,9,17,15,905,845,1750,1742
0132-000,2018,9,17,16,905,838,1743,1750
0132-000,2018,9,17,17,1042,890,1932,1743
0132-000,2018,9,17,18,1351,990,2341,1932
0132-000,2018,9,17,19,1542,829,2371,2341
0132-000,2018,9,17,20,1058,715,1773,2371
0132-000,2018,9,17,21,873,471,1344,1773
0132-000,2018,9,17,22,619,432,1051,1344
0132-000,2018,9,17,23,378,302,680,1051
0132-000,2018,9,17,24,241,227,468,680
0132-000,2018,9,18,1,169,187,356,468
0132-000,2018,9,18,2,94,99,193,356
0132-000,2018,9,18,3,59,126,185,193
0132-000,2018,9,18,4,71,193,264,185
0132-000,2018,9,18,5,120,243,363,264
0132-000,2018,9,18,6,362,199,561,363
0132-000,2018,9,18,7,520,649,1169,561
0132-000,2018,9,18,8,697,1927,2624,1169
0132-000,2018,9,18,9,799,1631,2430,2624
0132-000,2018,9,18,10,828,943,1771,2430
0132-000,2018,9,18,11,741,916,1657,1771
0132-000,2018,9,18,12,807,882,1689,1657
0132-000,2018,9,18,13,813,798,1611,1689
0132-000,2018,9,18,14,857,879,1736,1611
0132-000,2018,9,18,15,814,857,1671,1736
0132-000,2018,9,18,16,959,804,1763,1671
0132-000,2018,9,18,17,1042,846,1888,1763
0132-000,2018,9,18,18,1438,984,2422,1888
0132-000,2018,9,18,19,1676,846,2522,2422
0132-000,2018,9,18,20,980,685,1665,2522
0132-000,2018,9,18,21,867,488,1355,1665
0132-000,2018,9,18,22,623,441,1064,1355
0132-000,2018,9,18,23,387,366,753,1064
0132-000,2018,9,18,24,239,194,433,753
0132-000,2018,9,19,1,145,139,284,433
0132-000,2018,9,19,2,95,111,206,284
0132-000,2018,9,19,3,72,70,142,206
0132-000,2018,9,19,4,82,83,165,142
0132-000,2018,9,19,5,106,98,204,165
0132-000,2018,9,19,6,351,205,556,204
0132-000,2018,9,19,7,525,613,1138,556
0132-000,2018,9,19,8,692,1951,2643,1138
0132-000,2018,9,19,9,834,1642,2476,2643
0132-000,2018,9,19,10,816,929,1745,2476
0132-000,2018,9,19,11,787,902,1689,1745
0132-000,2018,9,19,12,778,839,1617,1689
0132-000,2018,9,19,13,770,808,1578,1617
0132-000,2018,9,19,14,903,804,1707,1578
0132-000,2018,9,19,15,912,912,1824,1707
0132-000,2018,9,19,16,924,791,1715,1824
0132-000,2018,9,19,17,1073,902,1975,1715
0132-000,2018,9,19,18,1442,991,2433,1975
0132-000,2018,9,19,19,1754,885,2639,2433
0132-000,2018,9,19,20,997,686,1683,2639
0132-000,2018,9,19,21,826,546,1372,1683
0132-000,2018,9,19,22,559,460,1019,1372
0132-000,2018,9,19,23,356,375,731,1019
0132-000,2018,9,19,24,275,226,501,731
0132-000,2018,9,20,1,164,184,348,501
0132-000,2018,9,20,2,118,120,238,348
0132-000,2018,9,20,3,78,94,172,238
0132-000,2018,9,20,4,82,91,173,172
0132-000,2018,9,20,5,106,106,212,173
0132-000,2018,9,20,6,303,202,505,212
0132-000,2018,9,20,7,478,538,1016,505
0132-000,2018,9,20,8,653,1786,2439,1016
0132-000,2018,9,20,9,776,1756,2532,2439
0132-000,2018,9,20,10,792,978,1770,2532
0132-000,2018,9,20,11,772,839,1611,1770
0132-000,2018,9,20,12,851,857,1708,1611
0132-000,2018,9,20,13,800,819,1619,1708
0132-000,2018,9,20,14,876,833,1709,1619
0132-000,2018,9,20,15,838,887,1725,1709
0132-000,2018,9,20,16,913,892,1805,1725
0132-000,2018,9,20,17,1011,838,1849,1805
0132-000,2018,9,20,18,1428,952,2380,1849
0132-000,2018,9,20,19,1725,792,2517,2380
0132-000,2018,9,20,20,975,690,1665,2517
0132-000,2018,9,20,21,807,500,1307,1665
0132-000,2018,9,20,22,598,430,1028,1307
0132-000,2018,9,20,23,370,340,710,1028
0132-000,2018,9,20,24,263,252,515,710
0132-000,2018,9,21,1,198,160,358,515
0132-000,2018,9,21,2,131,133,264,358
0132-000,2018,9,21,3,95,101,196,264
0132-000,2018,9,21,4,62,111,173,196
0132-000,2018,9,21,5,98,106,204,173
0132-000,2018,9,21,6,225,166,391,204
0132-000,2018,9,21,7,392,548,940,391
0132-000,2018,9,21,8,618,1795,2413,940
0132-000,2018,9,21,9,826,1668,2494,2413
0132-000,2018,9,21,10,693,879,1572,2494
0132-000,2018,9,21,11,729,870,1599,1572
0132-000,2018,9,21,12,764,897,1661,1599
0132-000,2018,9,21,13,826,838,1664,1661
0132-000,2018,9,21,14,932,865,1797,1664
0132-000,2018,9,21,15,1003,939,1942,1797
0132-000,2018,9,21,16,1097,1019,2116,1942
0132-000,2018,9,21,17,1303,1055,2358,2116
0132-000,2018,9,21,18,1668,973,2641,2358
0132-000,2018,9,21,19,1485,863,2348,2641
0132-000,2018,9,21,20,921,702,1623,2348
0132-000,2018,9,21,21,673,577,1250,1623
0132-000,2018,9,21,22,534,443,977,1250
0132-000,2018,9,21,23,364,378,742,977
0132-000,2018,9,21,24,248,235,483,742
0132-000,2018,9,22,1,200,199,399,483
0132-000,2018,9,22,2,122,116,238,399
0132-000,2018,9,22,3,98,98,196,238
0132-000,2018,9,22,4,108,116,224,196
0132-000,2018,9,22,5,104,124,228,224
0132-000,2018,9,22,6,169,188,357,228
0132-000,2018,9,22,7,283,353,636,357
0132-000,2018,9,22,8,356,718,1074,636
0132-000,2018,9,22,9,536,901,1437,1074
0132-000,2018,9,22,10,610,1111,1721,1437
0132-000,2018,9,22,11,699,1119,1818,1721
0132-000,2018,9,22,12,748,1024,1772,1818
0132-000,2018,9,22,13,814,1070,1884,1772
0132-000,2018,9,22,14,795,1450,2245,1884
0132-000,2018,9,22,15,838,854,1692,2245
0132-000,2018,9,22,16,781,905,1686,1692
0132-000,2018,9,22,17,840,956,1796,1686
0132-000,2018,9,22,18,859,782,1641,1796
0132-000,2018,9,22,19,770,657,1427,1641
0132-000,2018,9,22,20,603,520,1123,1427
0132-000,2018,9,22,21,445,440,885,1123
0132-000,2018,9,22,22,372,343,715,885
0132-000,2018,9,22,23,270,285,555,715
0132-000,2018,9,22,24,185,250,435,555
0132-000,2018,9,23,1,150,181,331,435
0132-000,2018,9,23,2,117,137,254,331
0132-000,2018,9,23,3,71,101,172,254
0132-000,2018,9,23,4,69,87,156,172
0132-000,2018,9,23,5,64,121,185,156
0132-000,2018,9,23,6,107,159,266,185
0132-000,2018,9,23,7,173,330,503,266
0132-000,2018,9,23,8,179,513,692,503
0132-000,2018,9,23,9,318,678,996,692
0132-000,2018,9,23,10,426,780,1206,996
0132-000,2018,9,23,11,582,843,1425,1206
0132-000,2018,9,23,12,539,757,1296,1425
0132-000,2018,9,23,13,564,754,1318,1296
0132-000,2018,9,23,14,537,716,1253,1318
0132-000,2018,9,23,15,609,658,1267,1253
0132-000,2018,9,23,16,576,667,1243,1267
0132-000,2018,9,23,17,516,671,1187,1243
0132-000,2018,9,23,18,527,538,1065,1187
0132-000,2018,9,23,19,451,437,888,1065
0132-000,2018,9,23,20,456,377,833,888
0132-000,2018,9,23,21,349,342,691,833
0132-000,2018,9,23,22,268,271,539,691
0132-000,2018,9,23,23,181,217,398,539
0132-000,2018,9,23,24,128,148,276,398
0132-000,2018,9,24,1,95,112,207,276
0132-000,2018,9,24,2,59,75,134,207
0132-000,2018,9,24,3,55,46,101,134
0132-000,2018,9,24,4,40,67,107,101
0132-000,2018,9,24,5,32,37,69,107
0132-000,2018,9,24,6,68,74,142,69
0132-000,2018,9,24,7,175,322,497,142
0132-000,2018,9,24,8,353,604,957,497
0132-000,2018,9,24,9,351,562,913,957
0132-000,2018,9,24,10,408,743,1151,913
0132-000,2018,9,24,11,686,1082,1768,1151
0132-000,2018,9,24,12,1063,1355,2418,1768
0132-000,2018,9,24,13,1498,1406,2904,2418
0132-000,2018,9,24,14,1638,1475,3113,2904
0132-000,2018,9,24,15,1878,1275,3153,3113
0132-000,2018,9,24,16,2031,1059,3090,3153
0132-000,2018,9,24,17,1754,1017,2771,3090
0132-000,2018,9,24,18,2029,1134,3163,2771
0132-000,2018,9,24,19,1962,801,2763,3163
0132-000,2018,9,24,20,1985,420,2405,2763
0132-000,2018,9,24,21,1746,347,2093,2405
0132-000,2018,9,24,22,1456,294,1750,2093
0132-000,2018,9,24,23,1057,228,1285,1750
0132-000,2018,9,24,24,555,166,721,1285
0132-000,2018,9,25,1,351,126,477,721
0132-000,2018,9,25,2,194,85,279,477
0132-000,2018,9,25,3,74,48,122,279
0132-000,2018,9,25,4,53,38,91,122
0132-000,2018,9,25,5,51,70,121,91
0132-000,2018,9,25,6,70,65,135,121
0132-000,2018,9,25,7,129,288,417,135
0132-000,2018,9,25,8,185,221,406,417
0132-000,2018,9,25,9,263,285,548,406
0132-000,2018,9,25,10,368,381,749,548
0132-000,2018,9,25,11,472,566,1038,749
0132-000,2018,9,25,12,656,578,1234,1038
0132-000,2018,9,25,13,715,582,1297,1234
0132-000,2018,9,25,14,839,563,1402,1297
0132-000,2018,9,25,15,1079,615,1694,1402
0132-000,2018,9,25,16,1246,597,1843,1694
0132-000,2018,9,25,17,1478,548,2026,1843
0132-000,2018,9,25,18,1849,524,2373,2026
0132-000,2018,9,25,19,1780,452,2232,2373
0132-000,2018,9,25,20,1566,379,1945,2232
0132-000,2018,9,25,21,1339,382,1721,1945
0132-000,2018,9,25,22,1053,310,1363,1721
0132-000,2018,9,25,23,836,234,1070,1363
0132-000,2018,9,25,24,687,166,853,1070
0132-000,2018,9,26,1,398,136,534,853
0132-000,2018,9,26,2,313,109,422,534
0132-000,2018,9,26,3,113,84,197,422
0132-000,2018,9,26,4,90,62,152,197
0132-000,2018,9,26,5,83,75,158,152
0132-000,2018,9,26,6,103,115,218,158
0132-000,2018,9,26,7,176,214,390,218
0132-000,2018,9,26,8,270,425,695,390
0132-000,2018,9,26,9,312,431,743,695
0132-000,2018,9,26,10,402,480,882,743
0132-000,2018,9,26,11,498,546,1044,882
0132-000,2018,9,26,12,549,662,1211,1044
0132-000,2018,9,26,13,660,616,1276,1211
0132-000,2018,9,26,14,687,658,1345,1276
0132-000,2018,9,26,15,744,680,1424,1345
0132-000,2018,9,26,16,818,650,1468,1424
0132-000,2018,9,26,17,801,636,1437,1468
0132-000,2018,9,26,18,963,642,1605,1437
0132-000,2018,9,26,19,813,560,1373,1605
0132-000,2018,9,26,20,633,461,1094,1373
0132-000,2018,9,26,21,523,434,957,1094
0132-000,2018,9,26,22,411,324,735,957
0132-000,2018,9,26,23,287,265,552,735
0132-000,2018,9,26,24,165,180,345,552
0132-000,2018,9,27,1,95,103,198,345
0132-000,2018,9,27,2,93,71,164,198
0132-000,2018,9,27,3,51,64,115,164
0132-000,2018,9,27,4,64,96,160,115
0132-000,2018,9,27,5,95,81,176,160
0132-000,2018,9,27,6,325,191,516,176
0132-000,2018,9,27,7,459,575,1034,516
0132-000,2018,9,27,8,614,1806,2420,1034
0132-000,2018,9,27,9,753,1503,2256,2420
0132-000,2018,9,27,10,708,829,1537,2256
0132-000,2018,9,27,11,654,726,1380,1537
0132-000,2018,9,27,12,789,765,1554,1380
0132-000,2018,9,27,13,719,690,1409,1554
0132-000,2018,9,27,14,749,714,1463,1409
0132-000,2018,9,27,15,747,721,1468,1463
0132-000,2018,9,27,16,800,741,1541,1468
0132-000,2018,9,27,17,856,796,1652,1541
0132-000,2018,9,27,18,1307,886,2193,1652
0132-000,2018,9,27,19,1516,859,2375,2193
0132-000,2018,9,27,20,828,602,1430,2375
0132-000,2018,9,27,21,725,432,1157,1430
0132-000,2018,9,27,22,481,392,873,1157
0132-000,2018,9,27,23,310,294,604,873
0132-000,2018,9,27,24,214,161,375,604
0132-000,2018,9,28,1,157,137,294,375
0132-000,2018,9,28,2,100,103,203,294
0132-000,2018,9,28,3,62,90,152,203
0132-000,2018,9,28,4,75,86,161,152
0132-000,2018,9,28,5,110,78,188,161
0132-000,2018,9,28,6,328,189,517,188
0132-000,2018,9,28,7,483,586,1069,517
0132-000,2018,9,28,8,685,1880,2565,1069
0132-000,2018,9,28,9,800,1561,2361,2565
0132-000,2018,9,28,10,764,833,1597,2361
0132-000,2018,9,28,11,771,860,1631,1597
0132-000,2018,9,28,12,758,828,1586,1631
0132-000,2018,9,28,13,722,778,1500,1586
0132-000,2018,9,28,14,771,781,1552,1500
0132-000,2018,9,28,15,881,835,1716,1552
0132-000,2018,9,28,16,874,815,1689,1716
0132-000,2018,9,28,17,962,842,1804,1689
0132-000,2018,9,28,18,1382,987,2369,1804
0132-000,2018,9,28,19,1743,838,2581,2369
0132-000,2018,9,28,20,956,705,1661,2581
0132-000,2018,9,28,21,767,475,1242,1661
0132-000,2018,9,28,22,488,422,910,1242
0132-000,2018,9,28,23,360,337,697,910
0132-000,2018,9,28,24,228,225,453,697
0132-000,2018,9,29,1,195,189,384,453
0132-000,2018,9,29,2,114,126,240,384
0132-000,2018,9,29,3,106,108,214,240
0132-000,2018,9,29,4,82,98,180,214
0132-000,2018,9,29,5,110,104,214,180
0132-000,2018,9,29,6,295,202,497,214
0132-000,2018,9,29,7,399,413,812,497
0132-000,2018,9,29,8,445,878,1323,812
0132-000,2018,9,29,9,633,892,1525,1323
0132-000,2018,9,29,10,673,877,1550,1525
0132-000,2018,9,29,11,718,844,1562,1550
0132-000,2018,9,29,12,765,826,1591,1562
0132-000,2018,9,29,13,806,816,1622,1591
0132-000,2018,9,29,14,783,840,1623,1622
0132-000,2018,9,29,15,808,860,1668,1623
0132-000,2018,9,29,16,823,797,1620,1668
0132-000,2018,9,29,17,912,838,1750,1620
0132-000,2018,9,29,18,1190,903,2093,1750
0132-000,2018,9,29,19,1034,773,1807,2093
0132-000,2018,9,29,20,681,579,1260,1807
0132-000,2018,9,29,21,490,472,962,1260
0132-000,2018,9,29,22,420,327,747,962
0132-000,2018,9,29,23,287,310,597,747
0132-000,2018,9,29,24,193,213,406,597
0132-000,2018,9,30,1,162,167,329,406
0132-000,2018,9,30,2,112,122,234,329
0132-000,2018,9,30,3,89,88,177,234
0132-000,2018,9,30,4,85,75,160,177
0132-000,2018,9,30,5,80,101,181,160
0132-000,2018,9,30,6,193,141,334,181
0132-000,2018,9,30,7,244,249,493,334
0132-000,2018,9,30,8,279,452,731,493
0132-000,2018,9,30,9,358,504,862,731
0132-000,2018,9,30,10,418,617,1035,862
0132-000,2018,9,30,11,525,621,1146,1035
0132-000,2018,9,30,12,559,598,1157,1146
0132-000,2018,9,30,13,633,644,1277,1157
0132-000,2018,9,30,14,735,696,1431,1277
0132-000,2018,9,30,15,714,669,1383,1431
0132-000,2018,9,30,16,790,713,1503,1383
0132-000,2018,9,30,17,899,693,1592,1503
0132-000,2018,9,30,18,916,761,1677,1592
0132-000,2018,9,30,19,842,565,1407,1677
0132-000,2018,9,30,20,605,462,1067,1407
0132-000,2018,9,30,21,453,424,877,1067
0132-000,2018,9,30,22,343,328,671,877
0132-000,2018,9,30,23,233,265,498,671
0132-000,2018,9,30,24,156,163,319,498
0132-000,2018,10,1,1,124,110,234,319
0132-000,2018,10,1,2,65,82,147,234
0132-000,2018,10,1,3,45,66,111,147
0132-000,2018,10,1,4,46,80,126,111
0132-000,2018,10,1,5,131,94,225,126
0132-000,2018,10,1,6,341,209,550,225
0132-000,2018,10,1,7,480,645,1125,550
0132-000,2018,10,1,8,672,1967,2639,1125
0132-000,2018,10,1,9,794,1692,2486,2639
0132-000,2018,10,1,10,729,826,1555,2486
0132-000,2018,10,1,11,766,862,1628,1555
0132-000,2018,10,1,12,722,793,1515,1628
0132-000,2018,10,1,13,723,736,1459,1515
0132-000,2018,10,1,14,747,768,1515,1459
0132-000,2018,10,1,15,812,761,1573,1515
0132-000,2018,10,1,16,858,752,1610,1573
0132-000,2018,10,1,17,884,788,1672,1610
0132-000,2018,10,1,18,1257,877,2134,1672
0132-000,2018,10,1,19,1590,782,2372,2134
0132-000,2018,10,1,20,931,650,1581,2372
0132-000,2018,10,1,21,777,424,1201,1581
0132-000,2018,10,1,22,493,370,863,1201
0132-000,2018,10,1,23,322,258,580,863
0132-000,2018,10,1,24,194,169,363,580
0132-000,2018,10,2,1,147,102,249,363
0132-000,2018,10,2,2,103,91,194,249
0132-000,2018,10,2,3,55,98,153,194
0132-000,2018,10,2,4,52,99,151,153
0132-000,2018,10,2,5,102,124,226,151
0132-000,2018,10,2,6,309,216,525,226
0132-000,2018,10,2,7,477,762,1239,525
0132-000,2018,10,2,8,656,2005,2661,1239
0132-000,2018,10,2,9,786,1648,2434,2661
0132-000,2018,10,2,10,739,867,1606,2434
0132-000,2018,10,2,11,789,880,1669,1606
0132-000,2018,10,2,12,705,732,1437,1669
0132-000,2018,10,2,13,723,725,1448,1437
0132-000,2018,10,2,14,820,753,1573,1448
0132-000,2018,10,2,15,811,882,1693,1573
0132-000,2018,10,2,16,847,792,1639,1693
0132-000,2018,10,2,17,946,864,1810,1639
0132-000,2018,10,2,18,1343,983,2326,1810
0132-000,2018,10,2,19,1751,817,2568,2326
0132-000,2018,10,2,20,1123,700,1823,2568
0132-000,2018,10,2,21,774,473,1247,1823
0132-000,2018,10,2,22,545,434,979,1247
0132-000,2018,10,2,23,358,351,709,979
0132-000,2018,10,2,24,233,220,453,709
0132-000,2018,10,3,1,155,157,312,453
0132-000,2018,10,3,2,140,98,238,312
0132-000,2018,10,3,3,85,98,183,238
0132-000,2018,10,3,4,94,92,186,183
0132-000,2018,10,3,5,132,123,255,186
0132-000,2018,10,3,6,274,286,560,255
0132-000,2018,10,3,7,412,554,966,560
0132-000,2018,10,3,8,478,978,1456,966
0132-000,2018,10,3,9,547,818,1365,1456
0132-000,2018,10,3,10,614,759,1373,1365
0132-000,2018,10,3,11,610,791,1401,1373
0132-000,2018,10,3,12,752,776,1528,1401
0132-000,2018,10,3,13,703,725,1428,1528
0132-000,2018,10,3,14,721,783,1504,1428
0132-000,2018,10,3,15,779,770,1549,1504
0132-000,2018,10,3,16,852,738,1590,1549
0132-000,2018,10,3,17,905,817,1722,1590
0132-000,2018,10,3,18,1246,865,2111,1722
0132-000,2018,10,3,19,1042,702,1744,2111
0132-000,2018,10,3,20,642,595,1237,1744
0132-000,2018,10,3,21,548,404,952,1237
0132-000,2018,10,3,22,373,336,709,952
0132-000,2018,10,3,23,255,272,527,709
0132-000,2018,10,3,24,177,175,352,527
0132-000,2018,10,4,1,118,119,237,352
0132-000,2018,10,4,2,82,105,187,237
0132-000,2018,10,4,3,60,69,129,187
0132-000,2018,10,4,4,74,71,145,129
0132-000,2018,10,4,5,101,89,190,145
0132-000,2018,10,4,6,318,184,502,190
0132-000,2018,10,4,7,496,639,1135,502
0132-000,2018,10,4,8,713,1945,2658,1135
0132-000,2018,10,4,9,804,1669,2473,2658
0132-000,2018,10,4,10,743,873,1616,2473
0132-000,2018,10,4,11,751,852,1603,1616
0132-000,2018,10,4,12,770,793,1563,1603
0132-000,2018,10,4,13,699,800,1499,1563
0132-000,2018,10,4,14,821,812,1633,1499
0132-000,2018,10,4,15,843,812,1655,1633
0132-000,2018,10,4,16,882,787,1669,1655
0132-000,2018,10,4,17,895,866,1761,1669
0132-000,2018,10,4,18,1313,927,2240,1761
0132-000,2018,10,4,19,1646,832,2478,2240
0132-000,2018,10,4,20,1019,635,1654,2478
0132-000,2018,10,4,21,764,431,1195,1654
0132-000,2018,10,4,22,580,397,977,1195
0132-000,2018,10,4,23,348,170,518,977
0132-000,2018,10,4,24,225,113,338,518
0132-000,2018,10,5,1,165,172,337,338
0132-000,2018,10,5,2,111,143,254,337
0132-000,2018,10,5,3,82,113,195,254
0132-000,2018,10,5,4,81,111,192,195
0132-000,2018,10,5,5,119,105,224,192
0132-000,2018,10,5,6,265,210,475,224
0132-000,2018,10,5,7,421,498,919,475
0132-000,2018,10,5,8,643,1537,2180,919
0132-000,2018,10,5,9,762,1450,2212,2180
0132-000,2018,10,5,10,698,812,1510,2212
0132-000,2018,10,5,11,710,772,1482,1510
0132-000,2018,10,5,12,697,766,1463,1482
0132-000,2018,10,5,13,704,776,1480,1463
0132-000,2018,10,5,14,783,760,1543,1480
0132-000,2018,10,5,15,793,721,1514,1543
0132-000,2018,10,5,16,785,755,1540,1514
0132-000,2018,10,5,17,904,742,1646,1540
0132-000,2018,10,5,18,1423,882,2305,1646
0132-000,2018,10,5,19,1727,774,2501,2305
0132-000,2018,10,5,20,980,666,1646,2501
0132-000,2018,10,5,21,785,515,1300,1646
0132-000,2018,10,5,22,539,401,940,1300
0132-000,2018,10,5,23,292,306,598,940
0132-000,2018,10,5,24,219,225,444,598
0132-000,2018,10,6,1,150,173,323,444
0132-000,2018,10,6,2,120,170,290,323
0132-000,2018,10,6,3,85,118,203,290
0132-000,2018,10,6,4,85,97,182,203
0132-000,2018,10,6,5,78,126,204,182
0132-000,2018,10,6,6,171,156,327,204
0132-000,2018,10,6,7,230,268,498,327
0132-000,2018,10,6,8,361,677,1038,498
0132-000,2018,10,6,9,529,825,1354,1038
0132-000,2018,10,6,10,613,757,1370,1354
0132-000,2018,10,6,11,697,800,1497,1370
0132-000,2018,10,6,12,771,835,1606,1497
0132-000,2018,10,6,13,775,831,1606,1606
0132-000,2018,10,6,14,728,795,1523,1606
0132-000,2018,10,6,15,832,810,1642,1523
0132-000,2018,10,6,16,818,766,1584,1642
0132-000,2018,10,6,17,888,835,1723,1584
0132-000,2018,10,6,18,1097,836,1933,1723
0132-000,2018,10,6,19,943,648,1591,1933
0132-000,2018,10,6,20,585,552,1137,1591
0132-000,2018,10,6,21,480,438,918,1137
0132-000,2018,10,6,22,367,331,698,918
0132-000,2018,10,6,23,280,306,586,698
0132-000,2018,10,6,24,192,221,413,586
0132-000,2018,10,7,1,154,196,350,413
0132-000,2018,10,7,2,103,120,223,350
0132-000,2018,10,7,3,92,128,220,223
0132-000,2018,10,7,4,74,109,183,220
0132-000,2018,10,7,5,88,96,184,183
0132-000,2018,10,7,6,157,124,281,184
0132-000,2018,10,7,7,244,266,510,281
0132-000,2018,10,7,8,298,483,781,510
0132-000,2018,10,7,9,347,588,935,781
0132-000,2018,10,7,10,458,593,1051,935
0132-000,2018,10,7,11,564,705,1269,1051
0132-000,2018,10,7,12,604,652,1256,1269
0132-000,2018,10,7,13,626,751,1377,1256
0132-000,2018,10,7,14,646,709,1355,1377
0132-000,2018,10,7,15,804,779,1583,1355
0132-000,2018,10,7,16,777,705,1482,1583
0132-000,2018,10,7,17,924,684,1608,1482
0132-000,2018,10,7,18,1018,728,1746,1608
0132-000,2018,10,7,19,862,601,1463,1746
0132-000,2018,10,7,20,622,515,1137,1463
0132-000,2018,10,7,21,435,443,878,1137
0132-000,2018,10,7,22,369,354,723,878
0132-000,2018,10,7,23,263,274,537,723
0132-000,2018,10,7,24,176,198,374,537
0132-000,2018,10,8,1,113,134,247,374
0132-000,2018,10,8,2,47,109,156,247
0132-000,2018,10,8,3,45,48,93,156
0132-000,2018,10,8,4,48,71,119,93
0132-000,2018,10,8,5,126,114,240,119
0132-000,2018,10,8,6,300,217,517,240
0132-000,2018,10,8,7,511,607,1118,517
0132-000,2018,10,8,8,682,1625,2307,1118
0132-000,2018,10,8,9,744,1268,2012,2307
0132-000,2018,10,8,10,796,810,1606,2012
0132-000,2018,10,8,11,751,816,1567,1606
0132-000,2018,10,8,12,801,818,1619,1567
0132-000,2018,10,8,13,776,829,1605,1619
0132-000,2018,10,8,14,793,800,1593,1605
0132-000,2018,10,8,15,875,856,1731,1593
0132-000,2018,10,8,16,929,823,1752,1731
0132-000,2018,10,8,17,1005,876,1881,1752
0132-000,2018,10,8,18,1385,966,2351,1881
0132-000,2018,10,8,19,1614,774,2388,2351
0132-000,2018,10,8,20,951,669,1620,2388
0132-000,2018,10,8,21,810,496,1306,1620
0132-000,2018,10,8,22,513,403,916,1306
0132-000,2018,10,8,23,342,354,696,916
0132-000,2018,10,8,24,214,261,475,696
0132-000,2018,10,9,1,172,172,344,475
0132-000,2018,10,9,2,124,145,269,344
0132-000,2018,10,9,3,89,130,219,269
0132-000,2018,10,9,4,91,152,243,219
0132-000,2018,10,9,5,131,99,230,243
0132-000,2018,10,9,6,293,223,516,230
0132-000,2018,10,9,7,402,384,786,516
0132-000,2018,10,9,8,464,780,1244,786
0132-000,2018,10,9,9,520,730,1250,1244
0132-000,2018,10,9,10,570,683,1253,1250
0132-000,2018,10,9,11,587,698,1285,1253
0132-000,2018,10,9,12,688,743,1431,1285
0132-000,2018,10,9,13,688,755,1443,1431
0132-000,2018,10,9,14,808,719,1527,1443
0132-000,2018,10,9,15,805,734,1539,1527
0132-000,2018,10,9,16,885,774,1659,1539
0132-000,2018,10,9,17,887,711,1598,1659
0132-000,2018,10,9,18,1308,848,2156,1598
0132-000,2018,10,9,19,1007,702,1709,2156
0132-000,2018,10,9,20,631,578,1209,1709
0132-000,2018,10,9,21,525,392,917,1209
0132-000,2018,10,9,22,387,394,781,917
0132-000,2018,10,9,23,232,242,474,781
0132-000,2018,10,9,24,159,172,331,474
0132-000,2018,10,10,1,130,139,269,331
0132-000,2018,10,10,2,78,96,174,269
0132-000,2018,10,10,3,50,67,117,174
0132-000,2018,10,10,4,64,86,150,117
0132-000,2018,10,10,5,121,107,228,150
0132-000,2018,10,10,6,338,219,557,228
0132-000,2018,10,10,7,509,563,1072,557
0132-000,2018,10,10,8,670,1654,2324,1072
0132-000,2018,10,10,9,810,1462,2272,2324
0132-000,2018,10,10,10,816,816,1632,2272
0132-000,2018,10,10,11,738,755,1493,1632
0132-000,2018,10,10,12,703,762,1465,1493
0132-000,2018,10,10,13,727,722,1449,1465
0132-000,2018,10,10,14,738,719,1457,1449
0132-000,2018,10,10,15,820,804,1624,1457
0132-000,2018,10,10,16,870,780,1650,1624
0132-000,2018,10,10,17,941,818,1759,1650
0132-000,2018,10,10,18,1411,865,2276,1759
0132-000,2018,10,10,19,1649,772,2421,2276
0132-000,2018,10,10,20,929,620,1549,2421
0132-000,2018,10,10,21,777,476,1253,1549
0132-000,2018,10,10,22,485,430,915,1253
0132-000,2018,10,10,23,367,289,656,915
0132-000,2018,10,10,24,205,210,415,656
0132-000,2018,10,11,1,145,156,301,415
0132-000,2018,10,11,2,103,126,229,301
0132-000,2018,10,11,3,70,71,141,229
0132-000,2018,10,11,4,81,124,205,141
0132-000,2018,10,11,5,121,147,268,205
0132-000,2018,10,11,6,322,198,520,268
0132-000,2018,10,11,7,483,521,1004,520
0132-000,2018,10,11,8,690,1633,2323,1004
0132-000,2018,10,11,9,817,1534,2351,2323
0132-000,2018,10,11,10,731,846,1577,2351
0132-000,2018,10,11,11,747,812,1559,1577
0132-000,2018,10,11,12,790,823,1613,1559
0132-000,2018,10,11,13,749,717,1466,1613
0132-000,2018,10,11,14,823,728,1551,1466
0132-000,2018,10,11,15,832,806,1638,1551
0132-000,2018,10,11,16,883,757,1640,1638
0132-000,2018,10,11,17,1019,806,1825,1640
0132-000,2018,10,11,18,1382,854,2236,1825
0132-000,2018,10,11,19,1647,751,2398,2236
0132-000,2018,10,11,20,940,667,1607,2398
0132-000,2018,10,11,21,796,496,1292,1607
0132-000,2018,10,11,22,537,403,940,1292
0132-000,2018,10,11,23,325,327,652,940
0132-000,2018,10,11,24,206,238,444,652
0132-000,2018,10,12,1,135,156,291,444
0132-000,2018,10,12,2,71,92,163,291
0132-000,2018,10,12,3,80,103,183,163
0132-000,2018,10,12,4,78,109,187,183
0132-000,2018,10,12,5,130,128,258,187
0132-000,2018,10,12,6,303,204,507,258
0132-000,2018,10,12,7,471,567,1038,507
0132-000,2018,10,12,8,681,1558,2239,1038
0132-000,2018,10,12,9,826,1446,2272,2239
0132-000,2018,10,12,10,762,797,1559,2272
0132-000,2018,10,12,11,789,823,1612,1559
0132-000,2018,10,12,12,753,812,1565,1612
0132-000,2018,10,12,13,728,795,1523,1565
0132-000,2018,10,12,14,783,785,1568,1523
0132-000,2018,10,12,15,910,848,1758,1568
0132-000,2018,10,12,16,947,818,1765,1758
0132-000,2018,10,12,17,1021,806,1827,1765
0132-000,2018,10,12,18,1494,996,2490,1827
0132-000,2018,10,12,19,1812,798,2610,2490
0132-000,2018,10,12,20,1069,650,1719,2610
0132-000,2018,10,12,21,786,519,1305,1719
0132-000,2018,10,12,22,486,400,886,1305
0132-000,2018,10,12,23,396,324,720,886
0132-000,2018,10,12,24,238,248,486,720
0132-000,2018,10,13,1,150,185,335,486
0132-000,2018,10,13,2,130,154,284,335
0132-000,2018,10,13,3,89,135,224,284
0132-000,2018,10,13,4,103,154,257,224
0132-000,2018,10,13,5,138,147,285,257
0132-000,2018,10,13,6,283,187,470,285
0132-000,2018,10,13,7,395,430,825,470
0132-000,2018,10,13,8,481,884,1365,825
0132-000,2018,10,13,9,675,947,1622,1365
0132-000,2018,10,13,10,730,947,1677,1622
0132-000,2018,10,13,11,761,867,1628,1677
0132-000,2018,10,13,12,847,941,1788,1628
0132-000,2018,10,13,13,870,884,1754,1788
0132-000,2018,10,13,14,806,928,1734,1754
0132-000,2018,10,13,15,916,821,1737,1734
0132-000,2018,10,13,16,1002,886,1888,1737
0132-000,2018,10,13,17,1020,897,1917,1888
0132-000,2018,10,13,18,1248,950,2198,1917
0132-000,2018,10,13,19,1047,768,1815,2198
0132-000,2018,10,13,20,724,629,1353,1815
0132-000,2018,10,13,21,532,455,987,1353
0132-000,2018,10,13,22,429,390,819,987
0132-000,2018,10,13,23,302,386,688,819
0132-000,2018,10,13,24,208,181,389,688
0132-000,2018,10,14,1,146,208,354,389
0132-000,2018,10,14,2,116,149,265,354
0132-000,2018,10,14,3,96,101,197,265
0132-000,2018,10,14,4,91,120,211,197
0132-000,2018,10,14,5,83,94,177,211
0132-000,2018,10,14,6,158,139,297,177
0132-000,2018,10,14,7,241,276,517,297
0132-000,2018,10,14,8,300,460,760,517
0132-000,2018,10,14,9,356,502,858,760
0132-000,2018,10,14,10,450,605,1055,858
0132-000,2018,10,14,11,578,671,1249,1055
0132-000,2018,10,14,12,508,658,1166,1249
0132-000,2018,10,14,13,684,595,1279,1166
0132-000,2018,10,14,14,700,743,1443,1279
0132-000,2018,10,14,15,828,776,1604,1443
0132-000,2018,10,14,16,831,734,1565,1604
0132-000,2018,10,14,17,933,759,1692,1565
0132-000,2018,10,14,18,1034,734,1768,1692
0132-000,2018,10,14,19,849,605,1454,1768
0132-000,2018,10,14,20,622,504,1126,1454
0132-000,2018,10,14,21,481,430,911,1126
0132-000,2018,10,14,22,355,352,707,911
0132-000,2018,10,14,23,220,274,494,707
0132-000,2018,10,14,24,163,185,348,494
0132-000,2018,10,15,1,88,118,206,348
0132-000,2018,10,15,2,61,82,143,206
0132-000,2018,10,15,3,53,56,109,143
0132-000,2018,10,15,4,55,101,156,109
0132-000,2018,10,15,5,119,99,218,156
0132-000,2018,10,15,6,351,223,574,218
0132-000,2018,10,15,7,518,582,1100,574
0132-000,2018,10,15,8,676,1684,2360,1100
0132-000,2018,10,15,9,792,1444,2236,2360
0132-000,2018,10,15,10,794,793,1587,2236
0132-000,2018,10,15,11,750,838,1588,1587
0132-000,2018,10,15,12,788,762,1550,1588
0132-000,2018,10,15,13,772,759,1531,1550
0132-000,2018,10,15,14,818,757,1575,1531
0132-000,2018,10,15,15,824,810,1634,1575
0132-000,2018,10,15,16,892,835,1727,1634
0132-000,2018,10,15,17,970,829,1799,1727
0132-000,2018,10,15,18,1415,874,2289,1799
0132-000,2018,10,15,19,1638,797,2435,2289
0132-000,2018,10,15,20,926,572,1498,2435
0132-000,2018,10,15,21,767,439,1206,1498
0132-000,2018,10,15,22,514,418,932,1206
0132-000,2018,10,15,23,346,303,649,932
0132-000,2018,10,15,24,196,183,379,649
0132-000,2018,10,16,1,138,143,281,379
0132-000,2018,10,16,2,93,101,194,281
0132-000,2018,10,16,3,53,92,145,194
0132-000,2018,10,16,4,71,88,159,145
0132-000,2018,10,16,5,117,97,214,159
0132-000,2018,10,16,6,306,170,476,214
0132-000,2018,10,16,7,493,512,1005,476
0132-000,2018,10,16,8,680,1653,2333,1005
0132-000,2018,10,16,9,789,1545,2334,2333
0132-000,2018,10,16,10,763,810,1573,2334
0132-000,2018,10,16,11,715,774,1489,1573
0132-000,2018,10,16,12,793,825,1618,1489
0132-000,2018,10,16,13,738,732,1470,1618
0132-000,2018,10,16,14,870,781,1651,1470
0132-000,2018,10,16,15,848,806,1654,1651
0132-000,2018,10,16,16,914,829,1743,1654
0132-000,2018,10,16,17,967,770,1737,1743
0132-000,2018,10,16,18,1356,905,2261,1737
0132-000,2018,10,16,19,1646,814,2460,2261
0132-000,2018,10,16,20,920,608,1528,2460
0132-000,2018,10,16,21,783,432,1215,1528
0132-000,2018,10,16,22,486,411,897,1215
0132-000,2018,10,16,23,438,306,744,897
0132-000,2018,10,16,24,250,200,450,744
0132-000,2018,10,17,1,163,132,295,450
0132-000,2018,10,17,2,98,101,199,295
0132-000,2018,10,17,3,64,94,158,199
0132-000,2018,10,17,4,53,94,147,158
0132-000,2018,10,17,5,104,99,203,147
0132-000,2018,10,17,6,315,211,526,203
0132-000,2018,10,17,7,521,521,1042,526
0132-000,2018,10,17,8,680,1549,2229,1042
0132-000,2018,10,17,9,825,1522,2347,2229
0132-000,2018,10,17,10,759,818,1577,2347
0132-000,2018,10,17,11,799,861,1660,1577
0132-000,2018,10,17,12,720,833,1553,1660
0132-000,2018,10,17,13,728,770,1498,1553
0132-000,2018,10,17,14,781,762,1543,1498
0132-000,2018,10,17,15,843,846,1689,1543
0132-000,2018,10,17,16,929,751,1680,1689
0132-000,2018,10,17,17,914,770,1684,1680
0132-000,2018,10,17,18,1484,871,2355,1684
0132-000,2018,10,17,19,1324,764,2088,2355
0132-000,2018,10,17,20,1044,666,1710,2088
0132-000,2018,10,17,21,734,453,1187,1710
0132-000,2018,10,17,22,470,426,896,1187
0132-000,2018,10,17,23,357,299,656,896
0132-000,2018,10,17,24,257,221,478,656
0132-000,2018,10,18,1,161,175,336,478
0132-000,2018,10,18,2,99,120,219,336
0132-000,2018,10,18,3,65,82,147,219
0132-000,2018,10,18,4,79,107,186,147
0132-000,2018,10,18,5,122,128,250,186
0132-000,2018,10,18,6,371,215,586,250
0132-000,2018,10,18,7,495,548,1043,586
0132-000,2018,10,18,8,641,1496,2137,1043
0132-000,2018,10,18,9,761,1554,2315,2137
0132-000,2018,10,18,10,728,810,1538,2315
0132-000,2018,10,18,11,765,810,1575,1538
0132-000,2018,10,18,12,751,816,1567,1575
0132-000,2018,10,18,13,748,787,1535,1567
0132-000,2018,10,18,14,851,749,1600,1535
0132-000,2018,10,18,15,913,778,1691,1600
0132-000,2018,10,18,16,869,821,1690,1691
0132-000,2018,10,18,17,1006,778,1784,1690
0132-000,2018,10,18,18,1450,874,2324,1784
0132-000,2018,10,18,19,1660,747,2407,2324
0132-000,2018,10,18,20,896,620,1516,2407
0132-000,2018,10,18,21,732,441,1173,1516
0132-000,2018,10,18,22,544,379,923,1173
0132-000,2018,10,18,23,368,354,722,923
0132-000,2018,10,18,24,218,160,378,722
0132-000,2018,10,19,1,135,154,289,378
0132-000,2018,10,19,2,73,111,184,289
0132-000,2018,10,19,3,66,107,173,184
0132-000,2018,10,19,4,75,113,188,173
0132-000,2018,10,19,5,112,111,223,188
0132-000,2018,10,19,6,332,204,536,223
0132-000,2018,10,19,7,486,532,1018,536
0132-000,2018,10,19,8,661,1535,2196,1018
0132-000,2018,10,19,9,780,1498,2278,2196
0132-000,2018,10,19,10,801,795,1596,2278
0132-000,2018,10,19,11,774,728,1502,1596
0132-000,2018,10,19,12,723,759,1482,1502
0132-000,2018,10,19,13,722,749,1471,1482
0132-000,2018,10,19,14,824,783,1607,1471
0132-000,2018,10,19,15,865,795,1660,1607
0132-000,2018,10,19,16,931,859,1790,1660
0132-000,2018,10,19,17,1022,800,1822,1790
0132-000,2018,10,19,18,1461,973,2434,1822
0132-000,2018,10,19,19,1819,823,2642,2434
0132-000,2018,10,19,20,1047,764,1811,2642
0132-000,2018,10,19,21,792,512,1304,1811
0132-000,2018,10,19,22,539,456,995,1304
0132-000,2018,10,19,23,376,375,751,995
0132-000,2018,10,19,24,248,221,469,751
0132-000,2018,10,20,1,182,187,369,469
0132-000,2018,10,20,2,121,166,287,369
0132-000,2018,10,20,3,94,120,214,287
0132-000,2018,10,20,4,85,118,203,214
0132-000,2018,10,20,5,115,149,264,203
0132-000,2018,10,20,6,294,223,517,264
0132-000,2018,10,20,7,395,401,796,517
0132-000,2018,10,20,8,525,787,1312,796
0132-000,2018,10,20,9,593,899,1492,1312
0132-000,2018,10,20,10,697,852,1549,1492
0132-000,2018,10,20,11,775,928,1703,1549
0132-000,2018,10,20,12,834,1063,1897,1703
0132-000,2018,10,20,13,915,1047,1962,1897
0132-000,2018,10,20,14,805,865,1670,1962
0132-000,2018,10,20,15,854,835,1689,1670
0132-000,2018,10,20,16,944,854,1798,1689
0132-000,2018,10,20,17,1083,867,1950,1798
0132-000,2018,10,20,18,1336,916,2252,1950
0132-000,2018,10,20,19,1153,745,1898,2252
0132-000,2018,10,20,20,714,593,1307,1898
0132-000,2018,10,20,21,550,500,1050,1307
0132-000,2018,10,20,22,454,447,901,1050
0132-000,2018,10,20,23,309,272,581,901
0132-000,2018,10,20,24,231,232,463,581
0132-000,2018,10,21,1,124,162,286,463
0132-000,2018,10,21,2,103,143,246,286
0132-000,2018,10,21,3,73,101,174,246
0132-000,2018,10,21,4,77,92,169,174
0132-000,2018,10,21,5,87,78,165,169
0132-000,2018,10,21,6,161,183,344,165
0132-000,2018,10,21,7,228,257,485,344
0132-000,2018,10,21,8,293,439,732,485
0132-000,2018,10,21,9,352,508,860,732
0132-000,2018,10,21,10,430,643,1073,860
0132-000,2018,10,21,11,568,690,1258,1073
0132-000,2018,10,21,12,542,740,1282,1258
0132-000,2018,10,21,13,682,673,1355,1282
0132-000,2018,10,21,14,720,816,1536,1355
0132-000,2018,10,21,15,802,717,1519,1536
0132-000,2018,10,21,16,910,753,1663,1519
0132-000,2018,10,21,17,1009,717,1726,1663
0132-000,2018,10,21,18,1107,719,1826,1726
0132-000,2018,10,21,19,1048,616,1664,1826
0132-000,2018,10,21,20,795,487,1282,1664
0132-000,2018,10,21,21,575,460,1035,1282
0132-000,2018,10,21,22,450,375,825,1035
0132-000,2018,10,21,23,398,263,661,825
0132-000,2018,10,21,24,198,162,360,661
0132-000,2018,10,22,1,116,134,250,360
0132-000,2018,10,22,2,58,92,150,250
0132-000,2018,10,22,3,51,86,137,150
0132-000,2018,10,22,4,66,76,142,137
0132-000,2018,10,22,5,135,105,240,142
0132-000,2018,10,22,6,384,208,592,240
0132-000,2018,10,22,7,517,584,1101,592
0132-000,2018,10,22,8,637,1744,2381,1101
0132-000,2018,10,22,9,728,1431,2159,2381
0132-000,2018,10,22,10,769,827,1596,2159
0132-000,2018,10,22,11,718,785,1503,1596
0132-000,2018,10,22,12,778,806,1584,1503
0132-000,2018,10,22,13,731,713,1444,1584
0132-000,2018,10,22,14,778,713,1491,1444
0132-000,2018,10,22,15,893,736,1629,1491
0132-000,2018,10,22,16,859,730,1589,1629
0132-000,2018,10,22,17,960,802,1762,1589
0132-000,2018,10,22,18,1360,918,2278,1762
0132-000,2018,10,22,19,1743,740,2483,2278
0132-000,2018,10,22,20,879,652,1531,2483
0132-000,2018,10,22,21,767,420,1187,1531
0132-000,2018,10,22,22,485,398,883,1187
0132-000,2018,10,22,23,321,282,603,883
0132-000,2018,10,22,24,218,152,370,603
0132-000,2018,10,23,1,151,120,271,370
0132-000,2018,10,23,2,92,101,193,271
0132-000,2018,10,23,3,49,75,124,193
0132-000,2018,10,23,4,67,105,172,124
0132-000,2018,10,23,5,131,135,266,172
0132-000,2018,10,23,6,355,192,547,266
0132-000,2018,10,23,7,483,510,993,547
0132-000,2018,10,23,8,656,1656,2312,993
0132-000,2018,10,23,9,774,1405,2179,2312
0132-000,2018,10,23,10,756,730,1486,2179
0132-000,2018,10,23,11,733,776,1509,1486
0132-000,2018,10,23,12,753,740,1493,1509
0132-000,2018,10,23,13,734,681,1415,1493
0132-000,2018,10,23,14,766,772,1538,1415
0132-000,2018,10,23,15,845,753,1598,1538
0132-000,2018,10,23,16,853,721,1574,1598
0132-000,2018,10,23,17,964,736,1700,1574
0132-000,2018,10,23,18,1339,827,2166,1700
0132-000,2018,10,23,19,1599,745,2344,2166
0132-000,2018,10,23,20,893,570,1463,2344
0132-000,2018,10,23,21,740,500,1240,1463
0132-000,2018,10,23,22,541,375,916,1240
0132-000,2018,10,23,23,326,295,621,916
0132-000,2018,10,23,24,239,213,452,621
0132-000,2018,10,24,1,160,154,314,452
0132-000,2018,10,24,2,92,120,212,314
0132-000,2018,10,24,3,61,99,160,212
0132-000,2018,10,24,4,77,107,184,160
0132-000,2018,10,24,5,130,126,256,184
0132-000,2018,10,24,6,335,219,554,256
0132-000,2018,10,24,7,464,517,981,554
0132-000,2018,10,24,8,660,1626,2286,981
0132-000,2018,10,24,9,783,1464,2247,2286
0132-000,2018,10,24,10,689,823,1512,2247
0132-000,2018,10,24,11,790,772,1562,1512
0132-000,2018,10,24,12,774,753,1527,1562
0132-000,2018,10,24,13,682,667,1349,1527
0132-000,2018,10,24,14,794,717,1511,1349
0132-000,2018,10,24,15,866,762,1628,1511
0132-000,2018,10,24,16,864,743,1607,1628
0132-000,2018,10,24,17,1008,871,1879,1607
0132-000,2018,10,24,18,1456,840,2296,1879
0132-000,2018,10,24,19,1750,747,2497,2296
0132-000,2018,10,24,20,954,622,1576,2497
0132-000,2018,10,24,21,735,500,1235,1576
0132-000,2018,10,24,22,536,430,966,1235
0132-000,2018,10,24,23,359,324,683,966
0132-000,2018,10,24,24,226,173,399,683
0132-000,2018,10,25,1,135,135,270,399
0132-000,2018,10,25,2,93,84,177,270
0132-000,2018,10,25,3,59,75,134,177
0132-000,2018,10,25,4,78,114,192,134
0132-000,2018,10,25,5,137,143,280,192
0132-000,2018,10,25,6,360,248,608,280
0132-000,2018,10,25,7,510,512,1022,608
0132-000,2018,10,25,8,662,1593,2255,1022
0132-000,2018,10,25,9,762,1384,2146,2255
0132-000,2018,10,25,10,742,880,1622,2146
0132-000,2018,10,25,11,718,736,1454,1622
0132-000,2018,10,25,12,733,747,1480,1454
0132-000,2018,10,25,13,685,684,1369,1480
0132-000,2018,10,25,14,777,738,1515,1369
0132-000,2018,10,25,15,814,792,1606,1515
0132-000,2018,10,25,16,821,789,1610,1606
0132-000,2018,10,25,17,941,792,1733,1610
0132-000,2018,10,25,18,1419,864,2283,1733
0132-000,2018,10,25,19,1563,749,2312,2283
0132-000,2018,10,25,20,1048,644,1692,2312
0132-000,2018,10,25,21,755,468,1223,1692
0132-000,2018,10,25,22,515,391,906,1223
0132-000,2018,10,25,23,338,340,678,906
0132-000,2018,10,25,24,263,199,462,678
0132-000,2018,10,26,1,200,141,341,462
0132-000,2018,10,26,2,116,90,206,341
0132-000,2018,10,26,3,55,81,136,206
0132-000,2018,10,26,4,76,77,153,136
0132-000,2018,10,26,5,127,110,237,153
0132-000,2018,10,26,6,320,183,503,237
0132-000,2018,10,26,7,411,531,942,503
0132-000,2018,10,26,8,635,1788,2423,942
0132-000,2018,10,26,9,764,1584,2348,2423
0132-000,2018,10,26,10,684,934,1618,2348
0132-000,2018,10,26,11,723,851,1574,1618
0132-000,2018,10,26,12,784,814,1598,1574
0132-000,2018,10,26,13,705,706,1411,1598
0132-000,2018,10,26,14,746,785,1531,1411
0132-000,2018,10,26,15,826,755,1581,1531
0132-000,2018,10,26,16,889,777,1666,1581
0132-000,2018,10,26,17,980,877,1857,1666
0132-000,2018,10,26,18,1527,927,2454,1857
0132-000,2018,10,26,19,1754,832,2586,2454
0132-000,2018,10,26,20,929,727,1656,2586
0132-000,2018,10,26,21,749,499,1248,1656
0132-000,2018,10,26,22,497,405,902,1248
0132-000,2018,10,26,23,357,408,765,902
0132-000,2018,10,26,24,231,207,438,765
0132-000,2018,10,27,1,156,194,350,438
0132-000,2018,10,27,2,117,143,260,350
0132-000,2018,10,27,3,92,93,185,260
0132-000,2018,10,27,4,74,87,161,185
0132-000,2018,10,27,5,124,101,225,161
0132-000,2018,10,27,6,289,147,436,225
0132-000,2018,10,27,7,404,329,733,436
0132-000,2018,10,27,8,475,777,1252,733
0132-000,2018,10,27,9,623,979,1602,1252
0132-000,2018,10,27,10,639,921,1560,1602
0132-000,2018,10,27,11,749,1014,1763,1560
0132-000,2018,10,27,12,760,1075,1835,1763
0132-000,2018,10,27,13,889,986,1875,1835
0132-000,2018,10,27,14,830,911,1741,1875
0132-000,2018,10,27,15,882,877,1759,1741
0132-000,2018,10,27,16,869,892,1761,1759
0132-000,2018,10,27,17,1022,897,1919,1761
0132-000,2018,10,27,18,1202,1014,2216,1919
0132-000,2018,10,27,19,1054,756,1810,2216
0132-000,2018,10,27,20,694,552,1246,1810
0132-000,2018,10,27,21,512,443,955,1246
0132-000,2018,10,27,22,403,363,766,955
0132-000,2018,10,27,23,315,296,611,766
0132-000,2018,10,27,24,201,198,399,611
0132-000,2018,10,28,1,156,153,309,399
0132-000,2018,10,28,2,132,131,263,309
0132-000,2018,10,28,3,76,88,164,263
0132-000,2018,10,28,4,69,85,154,164
0132-000,2018,10,28,5,73,69,142,154
0132-000,2018,10,28,6,147,117,264,142
0132-000,2018,10,28,7,204,192,396,264
0132-000,2018,10,28,8,266,341,607,396
0132-000,2018,10,28,9,357,449,806,607
0132-000,2018,10,28,10,472,572,1044,806
0132-000,2018,10,28,11,584,606,1190,1044
0132-000,2018,10,28,12,551,628,1179,1190
0132-000,2018,10,28,13,760,648,1408,1179
0132-000,2018,10,28,14,806,655,1461,1408
0132-000,2018,10,28,15,811,643,1454,1461
0132-000,2018,10,28,16,869,671,1540,1454
0132-000,2018,10,28,17,906,680,1586,1540
0132-000,2018,10,28,18,994,596,1590,1586
0132-000,2018,10,28,19,1011,528,1539,1590
0132-000,2018,10,28,20,711,470,1181,1539
0132-000,2018,10,28,21,547,395,942,1181
0132-000,2018,10,28,22,371,315,686,942
0132-000,2018,10,28,23,245,233,478,686
0132-000,2018,10,28,24,147,147,294,478
0132-000,2018,10,29,1,93,99,192,294
0132-000,2018,10,29,2,75,84,159,192
0132-000,2018,10,29,3,41,62,103,159
0132-000,2018,10,29,4,51,71,122,103
0132-000,2018,10,29,5,143,80,223,122
0132-000,2018,10,29,6,330,189,519,223
0132-000,2018,10,29,7,479,614,1093,519
0132-000,2018,10,29,8,638,1924,2562,1093
0132-000,2018,10,29,9,694,1707,2401,2562
0132-000,2018,10,29,10,742,871,1613,2401
0132-000,2018,10,29,11,712,788,1500,1613
0132-000,2018,10,29,12,689,777,1466,1500
0132-000,2018,10,29,13,709,730,1439,1466
0132-000,2018,10,29,14,758,763,1521,1439
0132-000,2018,10,29,15,811,811,1622,1521
0132-000,2018,10,29,16,880,782,1662,1622
0132-000,2018,10,29,17,961,816,1777,1662
0132-000,2018,10,29,18,1342,896,2238,1777
0132-000,2018,10,29,19,1662,768,2430,2238
0132-000,2018,10,29,20,922,612,1534,2430
0132-000,2018,10,29,21,765,430,1195,1534
0132-000,2018,10,29,22,528,408,936,1195
0132-000,2018,10,29,23,311,292,603,936
0132-000,2018,10,29,24,159,168,327,603
0132-000,2018,10,30,1,130,130,260,327
0132-000,2018,10,30,2,74,84,158,260
0132-000,2018,10,30,3,56,103,159,158
0132-000,2018,10,30,4,72,88,160,159
0132-000,2018,10,30,5,135,130,265,160
0132-000,2018,10,30,6,332,192,524,265
0132-000,2018,10,30,7,453,536,989,524
0132-000,2018,10,30,8,661,1546,2207,989
0132-000,2018,10,30,9,785,1471,2256,2207
0132-000,2018,10,30,10,790,821,1611,2256
0132-000,2018,10,30,11,814,821,1635,1611
0132-000,2018,10,30,12,746,804,1550,1635
0132-000,2018,10,30,13,761,749,1510,1550
0132-000,2018,10,30,14,803,745,1548,1510
0132-000,2018,10,30,15,862,781,1643,1548
0132-000,2018,10,30,16,933,781,1714,1643
0132-000,2018,10,30,17,957,806,1763,1714
0132-000,2018,10,30,18,1409,930,2339,1763
0132-000,2018,10,30,19,1670,774,2444,2339
0132-000,2018,10,30,20,945,648,1593,2444
0132-000,2018,10,30,21,733,476,1209,1593
0132-000,2018,10,30,22,543,411,954,1209
0132-000,2018,10,30,23,347,299,646,954
0132-000,2018,10,30,24,219,183,402,646
0132-000,2018,10,31,1,142,126,268,402
0132-000,2018,10,31,2,83,124,207,268
0132-000,2018,10,31,3,60,96,156,207
0132-000,2018,10,31,4,77,96,173,156
0132-000,2018,10,31,5,145,122,267,173
0132-000,2018,10,31,6,316,154,470,267
0132-000,2018,10,31,7,482,553,1035,470
0132-000,2018,10,31,8,647,1601,2248,1035
0132-000,2018,10,31,9,794,1492,2286,2248
0132-000,2018,10,31,10,768,871,1639,2286
0132-000,2018,10,31,11,747,798,1545,1639
0132-000,2018,10,31,12,719,702,1421,1545
0132-000,2018,10,31,13,689,705,1394,1421
0132-000,2018,10,31,14,795,677,1472,1394
0132-000,2018,10,31,15,805,762,1567,1472
0132-000,2018,10,31,16,846,774,1620,1567
0132-000,2018,10,31,17,989,768,1757,1620
0132-000,2018,10,31,18,1437,829,2266,1757
0132-000,2018,10,31,19,1708,749,2457,2266
0132-000,2018,10,31,20,932,608,1540,2457
0132-000,2018,10,31,21,697,439,1136,1540
0132-000,2018,10,31,22,529,379,908,1136
0132-000,2018,10,31,23,354,344,698,908
0132-000,2018,10,31,24,217,211,428,698
0132-000,2018,11,1,1,156,190,346,428
0132-000,2018,11,1,2,99,142,241,346
0132-000,2018,11,1,3,74,99,173,241
0132-000,2018,11,1,4,68,115,183,173
0132-000,2018,11,1,5,143,130,273,183
0132-000,2018,11,1,6,292,230,522,273
0132-000,2018,11,1,7,486,539,1025,522
0132-000,2018,11,1,8,675,1679,2354,1025
0132-000,2018,11,1,9,759,1565,2324,2354
0132-000,2018,11,1,10,757,863,1620,2324
0132-000,2018,11,1,11,688,841,1529,1620
0132-000,2018,11,1,12,714,775,1489,1529
0132-000,2018,11,1,13,707,700,1407,1489
0132-000,2018,11,1,14,793,750,1543,1407
0132-000,2018,11,1,15,868,789,1657,1543
0132-000,2018,11,1,16,838,738,1576,1657
0132-000,2018,11,1,17,908,841,1749,1576
0132-000,2018,11,1,18,1409,922,2331,1749
0132-000,2018,11,1,19,1654,833,2487,2331
0132-000,2018,11,1,20,920,642,1562,2487
0132-000,2018,11,1,21,729,521,1250,1562
0132-000,2018,11,1,22,535,434,969,1250
0132-000,2018,11,1,23,379,317,696,969
0132-000,2018,11,1,24,211,210,421,696
0132-000,2018,11,2,1,147,174,321,421
0132-000,2018,11,2,2,97,144,241,321
0132-000,2018,11,2,3,71,101,172,241
0132-000,2018,11,2,4,64,103,167,172
0132-000,2018,11,2,5,132,138,270,167
0132-000,2018,11,2,6,327,208,535,270
0132-000,2018,11,2,7,480,549,1029,535
0132-000,2018,11,2,8,640,1671,2311,1029
0132-000,2018,11,2,9,807,1514,2321,2311
0132-000,2018,11,2,10,804,926,1730,2321
0132-000,2018,11,2,11,671,863,1534,1730
0132-000,2018,11,2,12,717,873,1590,1534
0132-000,2018,11,2,13,738,760,1498,1590
0132-000,2018,11,2,14,812,801,1613,1498
0132-000,2018,11,2,15,873,769,1642,1613
0132-000,2018,11,2,16,931,805,1736,1642
0132-000,2018,11,2,17,1030,914,1944,1736
0132-000,2018,11,2,18,1485,1000,2485,1944
0132-000,2018,11,2,19,1803,896,2699,2485
0132-000,2018,11,2,20,1226,734,1960,2699
0132-000,2018,11,2,21,837,525,1362,1960
0132-000,2018,11,2,22,511,482,993,1362
0132-000,2018,11,2,23,351,388,739,993
0132-000,2018,11,2,24,246,277,523,739
0132-000,2018,11,3,1,188,222,410,523
0132-000,2018,11,3,2,120,174,294,410
0132-000,2018,11,3,3,84,109,193,294
0132-000,2018,11,3,4,98,128,226,193
0132-000,2018,11,3,5,135,136,271,226
0132-000,2018,11,3,6,274,202,476,271
0132-000,2018,11,3,7,410,398,808,476
0132-000,2018,11,3,8,446,734,1180,808
0132-000,2018,11,3,9,658,877,1535,1180
0132-000,2018,11,3,10,702,898,1600,1535
0132-000,2018,11,3,11,758,1111,1869,1600
0132-000,2018,11,3,12,759,1101,1860,1869
0132-000,2018,11,3,13,800,978,1778,1860
0132-000,2018,11,3,14,789,976,1765,1778
0132-000,2018,11,3,15,859,994,1853,1765
0132-000,2018,11,3,16,862,912,1774,1853
0132-000,2018,11,3,17,1021,968,1989,1774
0132-000,2018,11,3,18,1247,1017,2264,1989
0132-000,2018,11,3,19,1134,807,1941,2264
0132-000,2018,11,3,20,731,607,1338,1941
0132-000,2018,11,3,21,547,545,1092,1338
0132-000,2018,11,3,22,479,424,903,1092
0132-000,2018,11,3,23,298,359,657,903
0132-000,2018,11,3,24,188,212,400,657
0132-000,2018,11,4,1,144,170,314,400
0132-000,2018,11,4,2,92,117,209,314
0132-000,2018,11,4,3,96,101,197,209
0132-000,2018,11,4,4,82,85,167,197
0132-000,2018,11,4,5,85,121,206,167
0132-000,2018,11,4,6,197,140,337,206
0132-000,2018,11,4,7,247,236,483,337
0132-000,2018,11,4,8,242,414,656,483
0132-000,2018,11,4,9,349,611,960,656
0132-000,2018,11,4,10,416,644,1060,960
0132-000,2018,11,4,11,516,805,1321,1060
0132-000,2018,11,4,12,520,712,1232,1321
0132-000,2018,11,4,13,648,763,1411,1232
0132-000,2018,11,4,14,686,825,1511,1411
0132-000,2018,11,4,15,822,787,1609,1511
0132-000,2018,11,4,16,904,775,1679,1609
0132-000,2018,11,4,17,1029,688,1717,1679
0132-000,2018,11,4,18,1245,767,2012,1717
0132-000,2018,11,4,19,1174,625,1799,2012
0132-000,2018,11,4,20,972,513,1485,1799
0132-000,2018,11,4,21,690,422,1112,1485
0132-000,2018,11,4,22,434,388,822,1112
0132-000,2018,11,4,23,273,301,574,822
0132-000,2018,11,4,24,169,178,347,574
0132-000,2018,11,5,1,127,138,265,347
0132-000,2018,11,5,2,62,95,157,265
0132-000,2018,11,5,3,53,71,124,157
0132-000,2018,11,5,4,58,85,143,124
0132-000,2018,11,5,5,152,117,269,143
0132-000,2018,11,5,6,350,246,596,269
0132-000,2018,11,5,7,519,555,1074,596
0132-000,2018,11,5,8,661,1827,2488,1074
0132-000,2018,11,5,9,738,1539,2277,2488
0132-000,2018,11,5,10,736,883,1619,2277
0132-000,2018,11,5,11,690,869,1559,1619
0132-000,2018,11,5,12,745,765,1510,1559
0132-000,2018,11,5,13,737,785,1522,1510
0132-000,2018,11,5,14,867,831,1698,1522
0132-000,2018,11,5,15,838,787,1625,1698
0132-000,2018,11,5,16,815,795,1610,1625
0132-000,2018,11,5,17,921,847,1768,1610
0132-000,2018,11,5,18,1365,932,2297,1768
0132-000,2018,11,5,19,1575,795,2370,2297
0132-000,2018,11,5,20,907,650,1557,2370
0132-000,2018,11,5,21,769,448,1217,1557
0132-000,2018,11,5,22,494,375,869,1217
0132-000,2018,11,5,23,319,347,666,869
0132-000,2018,11,5,24,192,176,368,666
0132-000,2018,11,6,1,139,132,271,368
0132-000,2018,11,6,2,88,152,240,271
0132-000,2018,11,6,3,62,89,151,240
0132-000,2018,11,6,4,73,103,176,151
0132-000,2018,11,6,5,133,123,256,176
0132-000,2018,11,6,6,329,232,561,256
0132-000,2018,11,6,7,477,529,1006,561
0132-000,2018,11,6,8,651,1771,2422,1006
0132-000,2018,11,6,9,800,1514,2314,2422
0132-000,2018,11,6,10,799,833,1632,2314
0132-000,2018,11,6,11,739,799,1538,1632
0132-000,2018,11,6,12,687,815,1502,1538
0132-000,2018,11,6,13,715,712,1427,1502
0132-000,2018,11,6,14,734,748,1482,1427
0132-000,2018,11,6,15,806,805,1611,1482
0132-000,2018,11,6,16,860,837,1697,1611
0132-000,2018,11,6,17,975,867,1842,1697
0132-000,2018,11,6,18,1357,938,2295,1842
0132-000,2018,11,6,19,1632,771,2403,2295
0132-000,2018,11,6,20,961,648,1609,2403
0132-000,2018,11,6,21,817,458,1275,1609
0132-000,2018,11,6,22,553,410,963,1275
0132-000,2018,11,6,23,309,301,610,963
0132-000,2018,11,6,24,159,192,351,610
0132-000,2018,11,7,1,134,164,298,351
0132-000,2018,11,7,2,99,134,233,298
0132-000,2018,11,7,3,65,99,164,233
0132-000,2018,11,7,4,60,101,161,164
0132-000,2018,11,7,5,125,99,224,161
0132-000,2018,11,7,6,293,184,477,224
0132-000,2018,11,7,7,467,513,980,477
0132-000,2018,11,7,8,653,1658,2311,980
0132-000,2018,11,7,9,730,1543,2273,2311
0132-000,2018,11,7,10,750,821,1571,2273
0132-000,2018,11,7,11,676,815,1491,1571
0132-000,2018,11,7,12,711,767,1478,1491
0132-000,2018,11,7,13,684,714,1398,1478
0132-000,2018,11,7,14,751,807,1558,1398
0132-000,2018,11,7,15,819,765,1584,1558
0132-000,2018,11,7,16,847,742,1589,1584
0132-000,2018,11,7,17,954,843,1797,1589
0132-000,2018,11,7,18,1417,922,2339,1797
0132-000,2018,11,7,19,1683,777,2460,2339
0132-000,2018,11,7,20,851,644,1495,2460
0132-000,2018,11,7,21,690,468,1158,1495
0132-000,2018,11,7,22,475,430,905,1158
0132-000,2018,11,7,23,348,365,713,905
0132-000,2018,11,7,24,213,214,427,713
0132-000,2018,11,8,1,138,144,282,427
0132-000,2018,11,8,2,81,115,196,282
0132-000,2018,11,8,3,66,93,159,196
0132-000,2018,11,8,4,51,83,134,159
0132-000,2018,11,8,5,110,117,227,134
0132-000,2018,11,8,6,244,178,422,227
0132-000,2018,11,8,7,389,470,859,422
0132-000,2018,11,8,8,576,1594,2170,859
0132-000,2018,11,8,9,746,1589,2335,2170
0132-000,2018,11,8,10,735,855,1590,2335
0132-000,2018,11,8,11,680,771,1451,1590
0132-000,2018,11,8,12,654,890,1544,1451
0132-000,2018,11,8,13,661,670,1331,1544
0132-000,2018,11,8,14,716,688,1404,1331
0132-000,2018,11,8,15,764,728,1492,1404
0132-000,2018,11,8,16,798,704,1502,1492
0132-000,2018,11,8,17,842,849,1691,1502
0132-000,2018,11,8,18,1254,865,2119,1691
0132-000,2018,11,8,19,1585,779,2364,2119
0132-000,2018,11,8,20,835,619,1454,2364
0132-000,2018,11,8,21,745,466,1211,1454
0132-000,2018,11,8,22,518,357,875,1211
0132-000,2018,11,8,23,281,291,572,875
0132-000,2018,11,8,24,195,184,379,572
0132-000,2018,11,9,1,138,150,288,379
0132-000,2018,11,9,2,84,109,193,288
0132-000,2018,11,9,3,54,89,143,193
0132-000,2018,11,9,4,62,91,153,143
0132-000,2018,11,9,5,119,101,220,153
0132-000,2018,11,9,6,337,196,533,220
0132-000,2018,11,9,7,440,488,928,533
0132-000,2018,11,9,8,643,1657,2300,928
0132-000,2018,11,9,9,811,1446,2257,2300
0132-000,2018,11,9,10,801,847,1648,2257
0132-000,2018,11,9,11,737,883,1620,1648
0132-000,2018,11,9,12,743,857,1600,1620
0132-000,2018,11,9,13,734,765,1499,1600
0132-000,2018,11,9,14,797,863,1660,1499
0132-000,2018,11,9,15,835,873,1708,1660
0132-000,2018,11,9,16,923,881,1804,1708
0132-000,2018,11,9,17,1031,853,1884,1804
0132-000,2018,11,9,18,1383,1012,2395,1884
0132-000,2018,11,9,19,1786,845,2631,2395
0132-000,2018,11,9,20,969,714,1683,2631
0132-000,2018,11,9,21,782,529,1311,1683
0132-000,2018,11,9,22,502,428,930,1311
0132-000,2018,11,9,23,343,367,710,930
0132-000,2018,11,9,24,214,265,479,710
0132-000,2018,11,10,1,170,224,394,479
0132-000,2018,11,10,2,136,144,280,394
0132-000,2018,11,10,3,117,123,240,280
0132-000,2018,11,10,4,96,134,230,240
0132-000,2018,11,10,5,141,154,295,230
0132-000,2018,11,10,6,278,186,464,295
0132-000,2018,11,10,7,395,392,787,464
0132-000,2018,11,10,8,448,744,1192,787
0132-000,2018,11,10,9,612,859,1471,1192
0132-000,2018,11,10,10,684,881,1565,1471
0132-000,2018,11,10,11,695,986,1681,1565
0132-000,2018,11,10,12,798,990,1788,1681
0132-000,2018,11,10,13,862,940,1802,1788
0132-000,2018,11,10,14,812,982,1794,1802
0132-000,2018,11,10,15,926,944,1870,1794
0132-000,2018,11,10,16,920,908,1828,1870
0132-000,2018,11,10,17,999,942,1941,1828
0132-000,2018,11,10,18,1177,948,2125,1941
0132-000,2018,11,10,19,1066,823,1889,2125
0132-000,2018,11,10,20,740,636,1376,1889
0132-000,2018,11,10,21,573,472,1045,1376
0132-000,2018,11,10,22,467,420,887,1045
0132-000,2018,11,10,23,331,329,660,887
0132-000,2018,11,10,24,183,218,401,660
0132-000,2018,11,11,1,160,198,358,401
0132-000,2018,11,11,2,107,152,259,358
0132-000,2018,11,11,3,92,144,236,259
0132-000,2018,11,11,4,88,107,195,236
0132-000,2018,11,11,5,95,95,190,195
0132-000,2018,11,11,6,184,194,378,190
0132-000,2018,11,11,7,205,259,464,378
0132-000,2018,11,11,8,225,384,609,464
0132-000,2018,11,11,9,374,519,893,609
0132-000,2018,11,11,10,412,656,1068,893
0132-000,2018,11,11,11,526,652,1178,1068
0132-000,2018,11,11,12,581,766,1347,1178
0132-000,2018,11,11,13,651,708,1359,1347
0132-000,2018,11,11,14,734,736,1470,1359
0132-000,2018,11,11,15,941,758,1699,1470
0132-000,2018,11,11,16,939,746,1685,1699
0132-000,2018,11,11,17,1096,758,1854,1685
0132-000,2018,11,11,18,1338,648,1986,1854
0132-000,2018,11,11,19,1296,613,1909,1986
0132-000,2018,11,11,20,972,513,1485,1909
0132-000,2018,11,11,21,759,428,1187,1485
0132-000,2018,11,11,22,472,379,851,1187
0132-000,2018,11,11,23,251,305,556,851
0132-000,2018,11,11,24,163,190,353,556
0132-000,2018,11,12,1,116,113,229,353
0132-000,2018,11,12,2,64,101,165,229
0132-000,2018,11,12,3,47,81,128,165
0132-000,2018,11,12,4,53,91,144,128
0132-000,2018,11,12,5,142,95,237,144
0132-000,2018,11,12,6,356,222,578,237
0132-000,2018,11,12,7,485,545,1030,578
0132-000,2018,11,12,8,643,1806,2449,1030
0132-000,2018,11,12,9,756,1561,2317,2449
0132-000,2018,11,12,10,776,823,1599,2317
0132-000,2018,11,12,11,775,871,1646,1599
0132-000,2018,11,12,12,704,851,1555,1646
0132-000,2018,11,12,13,694,767,1461,1555
0132-000,2018,11,12,14,862,831,1693,1461
0132-000,2018,11,12,15,861,861,1722,1693
0132-000,2018,11,12,16,874,807,1681,1722
0132-000,2018,11,12,17,920,815,1735,1681
0132-000,2018,11,12,18,1364,950,2314,1735
0132-000,2018,11,12,19,1642,785,2427,2314
0132-000,2018,11,12,20,939,692,1631,2427
0132-000,2018,11,12,21,811,488,1299,1631
0132-000,2018,11,12,22,510,420,930,1299
0132-000,2018,11,12,23,293,309,602,930
0132-000,2018,11,12,24,198,182,380,602
0132-000,2018,11,13,1,129,74,203,380
0132-000,2018,11,13,2,80,48,128,203
0132-000,2018,11,13,3,59,55,114,128
0132-000,2018,11,13,4,64,41,105,114
0132-000,2018,11,13,5,130,96,226,105
0132-000,2018,11,13,6,335,198,533,226
0132-000,2018,11,13,7,451,540,991,533
0132-000,2018,11,13,8,653,1836,2489,991
0132-000,2018,11,13,9,779,1611,2390,2489
0132-000,2018,11,13,10,744,846,1590,2390
0132-000,2018,11,13,11,730,872,1602,1590
0132-000,2018,11,13,12,678,791,1469,1602
0132-000,2018,11,13,13,677,766,1443,1469
0132-000,2018,11,13,14,821,792,1613,1443
0132-000,2018,11,13,15,830,841,1671,1613
0132-000,2018,11,13,16,913,784,1697,1671
0132-000,2018,11,13,17,969,870,1839,1697
0132-000,2018,11,13,18,1429,884,2313,1839
0132-000,2018,11,13,19,1634,786,2420,2313
0132-000,2018,11,13,20,897,604,1501,2420
0132-000,2018,11,13,21,817,515,1332,1501
0132-000,2018,11,13,22,554,410,964,1332
0132-000,2018,11,13,23,322,309,631,964
0132-000,2018,11,13,24,198,168,366,631
0132-000,2018,11,14,1,118,114,232,366
0132-000,2018,11,14,2,91,97,188,232
0132-000,2018,11,14,3,68,79,147,188
0132-000,2018,11,14,4,62,75,137,147
0132-000,2018,11,14,5,148,98,246,137
0132-000,2018,11,14,6,323,173,496,246
0132-000,2018,11,14,7,465,535,1000,496
0132-000,2018,11,14,8,656,1867,2523,1000
0132-000,2018,11,14,9,770,1661,2431,2523
0132-000,2018,11,14,10,775,869,1644,2431
0132-000,2018,11,14,11,707,873,1580,1644
0132-000,2018,11,14,12,714,731,1445,1580
0132-000,2018,11,14,13,758,764,1522,1445
0132-000,2018,11,14,14,768,752,1520,1522
0132-000,2018,11,14,15,834,821,1655,1520
0132-000,2018,11,14,16,906,760,1666,1655
0132-000,2018,11,14,17,965,856,1821,1666
0132-000,2018,11,14,18,1514,925,2439,1821
0132-000,2018,11,14,19,1692,736,2428,2439
0132-000,2018,11,14,20,922,580,1502,2428
0132-000,2018,11,14,21,725,460,1185,1502
0132-000,2018,11,14,22,526,415,941,1185
0132-000,2018,11,14,23,325,333,658,941
0132-000,2018,11,14,24,225,189,414,658
0132-000,2018,11,15,1,115,131,246,414
0132-000,2018,11,15,2,85,97,182,246
0132-000,2018,11,15,3,61,77,138,182
0132-000,2018,11,15,4,70,90,160,138
0132-000,2018,11,15,5,118,99,217,160
0132-000,2018,11,15,6,341,165,506,217
0132-000,2018,11,15,7,486,551,1037,506
0132-000,2018,11,15,8,637,1807,2444,1037
0132-000,2018,11,15,9,798,1669,2467,2444
0132-000,2018,11,15,10,830,969,1799,2467
0132-000,2018,11,15,11,726,799,1525,1799
0132-000,2018,11,15,12,768,767,1535,1525
0132-000,2018,11,15,13,706,753,1459,1535
0132-000,2018,11,15,14,785,775,1560,1459
0132-000,2018,11,15,15,830,773,1603,1560
0132-000,2018,11,15,16,839,768,1607,1603
0132-000,2018,11,15,17,954,811,1765,1607
0132-000,2018,11,15,18,1475,957,2432,1765
0132-000,2018,11,15,19,1590,770,2360,2432
0132-000,2018,11,15,20,895,614,1509,2360
0132-000,2018,11,15,21,760,414,1174,1509
0132-000,2018,11,15,22,551,389,940,1174
0132-000,2018,11,15,23,378,353,731,940
0132-000,2018,11,15,24,203,195,398,731
0132-000,2018,11,16,1,153,145,298,398
0132-000,2018,11,16,2,78,95,173,298
0132-000,2018,11,16,3,74,87,161,173
0132-000,2018,11,16,4,78,88,166,161
0132-000,2018,11,16,5,158,120,278,166
0132-000,2018,11,16,6,306,188,494,278
0132-000,2018,11,16,7,468,527,995,494
0132-000,2018,11,16,8,660,1855,2515,995
0132-000,2018,11,16,9,797,1620,2417,2515
0132-000,2018,11,16,10,782,939,1721,2417
0132-000,2018,11,16,11,803,901,1704,1721
0132-000,2018,11,16,12,791,789,1580,1704
0132-000,2018,11,16,13,723,751,1474,1580
0132-000,2018,11,16,14,805,782,1587,1474
0132-000,2018,11,16,15,866,811,1677,1587
0132-000,2018,11,16,16,944,886,1830,1677
0132-000,2018,11,16,17,1089,895,1984,1830
0132-000,2018,11,16,18,1582,1021,2603,1984
0132-000,2018,11,16,19,1843,940,2783,2603
0132-000,2018,11,16,20,989,734,1723,2783
0132-000,2018,11,16,21,769,493,1262,1723
0132-000,2018,11,16,22,531,462,993,1262
0132-000,2018,11,16,23,388,327,715,993
0132-000,2018,11,16,24,233,201,434,715
0132-000,2018,11,17,1,195,175,370,434
0132-000,2018,11,17,2,116,142,258,370
0132-000,2018,11,17,3,105,115,220,258
0132-000,2018,11,17,4,85,105,190,220
0132-000,2018,11,17,5,147,116,263,190
0132-000,2018,11,17,6,304,192,496,263
0132-000,2018,11,17,7,399,336,735,496
0132-000,2018,11,17,8,462,789,1251,735
0132-000,2018,11,17,9,668,863,1531,1251
0132-000,2018,11,17,10,716,1009,1725,1531
0132-000,2018,11,17,11,760,1101,1861,1725
0132-000,2018,11,17,12,841,1094,1935,1861
0132-000,2018,11,17,13,1004,1031,2035,1935
0132-000,2018,11,17,14,986,1080,2066,2035
0132-000,2018,11,17,15,977,1084,2061,2066
0132-000,2018,11,17,16,936,963,1899,2061
0132-000,2018,11,17,17,970,1029,1999,1899
0132-000,2018,11,17,18,1296,1044,2340,1999
0132-000,2018,11,17,19,1029,757,1786,2340
0132-000,2018,11,17,20,733,520,1253,1786
0132-000,2018,11,17,21,517,422,939,1253
0132-000,2018,11,17,22,388,372,760,939
0132-000,2018,11,17,23,307,296,603,760
0132-000,2018,11,17,24,207,178,385,603
0132-000,2018,11,18,1,149,166,315,385
0132-000,2018,11,18,2,120,114,234,315
0132-000,2018,11,18,3,77,102,179,234
0132-000,2018,11,18,4,76,93,169,179
0132-000,2018,11,18,5,84,99,183,169
0132-000,2018,11,18,6,161,124,285,183
0132-000,2018,11,18,7,225,240,465,285
0132-000,2018,11,18,8,252,334,586,465
0132-000,2018,11,18,9,364,533,897,586
0132-000,2018,11,18,10,454,603,1057,897
0132-000,2018,11,18,11,550,674,1224,1057
0132-000,2018,11,18,12,611,672,1283,1224
0132-000,2018,11,18,13,720,705,1425,1283
0132-000,2018,11,18,14,837,714,1551,1425
0132-000,2018,11,18,15,911,733,1644,1551
0132-000,2018,11,18,16,1099,784,1883,1644
0132-000,2018,11,18,17,1417,763,2180,1883
0132-000,2018,11,18,18,1720,718,2438,2180
0132-000,2018,11,18,19,1629,560,2189,2438
0132-000,2018,11,18,20,1466,487,1953,2189
0132-000,2018,11,18,21,1076,426,1502,1953
0132-000,2018,11,18,22,735,357,1092,1502
0132-000,2018,11,18,23,409,232,641,1092
0132-000,2018,11,18,24,143,171,314,641
0132-000,2018,11,19,1,113,114,227,314
0132-000,2018,11,19,2,73,81,154,227
0132-000,2018,11,19,3,51,63,114,154
0132-000,2018,11,19,4,47,58,105,114
0132-000,2018,11,19,5,142,82,224,105
0132-000,2018,11,19,6,360,198,558,224
0132-000,2018,11,19,7,519,598,1117,558
0132-000,2018,11,19,8,674,1924,2598,1117
0132-000,2018,11,19,9,772,1726,2498,2598
0132-000,2018,11,19,10,810,946,1756,2498
0132-000,2018,11,19,11,702,829,1531,1756
0132-000,2018,11,19,12,725,733,1458,1531
0132-000,2018,11,19,13,692,731,1423,1458
0132-000,2018,11,19,14,821,758,1579,1423
0132-000,2018,11,19,15,809,790,1599,1579
0132-000,2018,11,19,16,910,807,1717,1599
0132-000,2018,11,19,17,1027,841,1868,1717
0132-000,2018,11,19,18,1315,957,2272,1868
0132-000,2018,11,19,19,1682,814,2496,2272
0132-000,2018,11,19,20,929,612,1541,2496
0132-000,2018,11,19,21,771,433,1204,1541
0132-000,2018,11,19,22,521,424,945,1204
0132-000,2018,11,19,23,321,283,604,945
0132-000,2018,11,19,24,182,165,347,604
0132-000,2018,11,20,1,125,114,239,347
0132-000,2018,11,20,2,85,88,173,239
0132-000,2018,11,20,3,44,69,113,173
0132-000,2018,11,20,4,61,85,146,113
0132-000,2018,11,20,5,130,92,222,146
0132-000,2018,11,20,6,357,164,521,222
0132-000,2018,11,20,7,476,532,1008,521
0132-000,2018,11,20,8,630,1884,2514,1008
0132-000,2018,11,20,9,845,1723,2568,2514
0132-000,2018,11,20,10,787,885,1672,2568
0132-000,2018,11,20,11,756,840,1596,1672
0132-000,2018,11,20,12,750,777,1527,1596
0132-000,2018,11,20,13,726,736,1462,1527
0132-000,2018,11,20,14,828,735,1563,1462
0132-000,2018,11,20,15,828,771,1599,1563
0132-000,2018,11,20,16,857,750,1607,1599
0132-000,2018,11,20,17,989,836,1825,1607
0132-000,2018,11,20,18,1448,975,2423,1825
0132-000,2018,11,20,19,1654,782,2436,2423
0132-000,2018,11,20,20,889,565,1454,2436
0132-000,2018,11,20,21,763,466,1229,1454
0132-000,2018,11,20,22,497,398,895,1229
0132-000,2018,11,20,23,340,266,606,895
0132-000,2018,11,20,24,183,173,356,606
0132-000,2018,11,21,1,118,117,235,356
0132-000,2018,11,21,2,83,83,166,235
0132-000,2018,11,21,3,61,83,144,166
0132-000,2018,11,21,4,53,67,120,144
0132-000,2018,11,21,5,129,90,219,120
0132-000,2018,11,21,6,321,171,492,219
0132-000,2018,11,21,7,444,519,963,492
0132-000,2018,11,21,8,627,1841,2468,963
0132-000,2018,11,21,9,755,1745,2500,2468
0132-000,2018,11,21,10,764,882,1646,2500
0132-000,2018,11,21,11,741,834,1575,1646
0132-000,2018,11,21,12,658,736,1394,1575
0132-000,2018,11,21,13,714,776,1490,1394
0132-000,2018,11,21,14,793,733,1526,1490
0132-000,2018,11,21,15,803,711,1514,1526
0132-000,2018,11,21,16,851,727,1578,1514
0132-000,2018,11,21,17,880,771,1651,1578
0132-000,2018,11,21,18,1385,781,2166,1651
0132-000,2018,11,21,19,1677,734,2411,2166
0132-000,2018,11,21,20,870,562,1432,2411
0132-000,2018,11,21,21,673,449,1122,1432
0132-000,2018,11,21,22,499,346,845,1122
0132-000,2018,11,21,23,320,273,593,845
0132-000,2018,11,21,24,188,184,372,593
0132-000,2018,11,22,1,130,120,250,372
0132-000,2018,11,22,2,80,83,163,250
0132-000,2018,11,22,3,62,85,147,163
0132-000,2018,11,22,4,61,77,138,147
0132-000,2018,11,22,5,130,95,225,138
0132-000,2018,11,22,6,338,174,512,225
0132-000,2018,11,22,7,462,542,1004,512
0132-000,2018,11,22,8,642,1834,2476,1004
0132-000,2018,11,22,9,793,1707,2500,2476
0132-000,2018,11,22,10,761,937,1698,2500
0132-000,2018,11,22,11,757,828,1585,1698
0132-000,2018,11,22,12,758,781,1539,1585
0132-000,2018,11,22,13,694,716,1410,1539
0132-000,2018,11,22,14,845,773,1618,1410
0132-000,2018,11,22,15,779,797,1576,1618
0132-000,2018,11,22,16,872,758,1630,1576
0132-000,2018,11,22,17,999,819,1818,1630
0132-000,2018,11,22,18,1445,983,2428,1818
0132-000,2018,11,22,19,1601,822,2423,2428
0132-000,2018,11,22,20,867,603,1470,2423
0132-000,2018,11,22,21,798,449,1247,1470
0132-000,2018,11,22,22,519,392,911,1247
0132-000,2018,11,22,23,344,305,649,911
0132-000,2018,11,22,24,208,211,419,649
0132-000,2018,11,23,1,153,138,291,419
0132-000,2018,11,23,2,90,94,184,291
0132-000,2018,11,23,3,71,84,155,184
0132-000,2018,11,23,4,56,69,125,155
0132-000,2018,11,23,5,155,104,259,125
0132-000,2018,11,23,6,331,171,502,259
0132-000,2018,11,23,7,477,500,977,502
0132-000,2018,11,23,8,652,1871,2523,977
0132-000,2018,11,23,9,818,1546,2364,2523
0132-000,2018,11,23,10,766,899,1665,2364
0132-000,2018,11,23,11,764,895,1659,1665
0132-000,2018,11,23,12,744,828,1572,1659
0132-000,2018,11,23,13,760,703,1463,1572
0132-000,2018,11,23,14,816,782,1598,1463
0132-000,2018,11,23,15,894,793,1687,1598
0132-000,2018,11,23,16,914,817,1731,1687
0132-000,2018,11,23,17,1050,891,1941,1731
0132-000,2018,11,23,18,1519,1060,2579,1941
0132-000,2018,11,23,19,1860,839,2699,2579
0132-000,2018,11,23,20,988,713,1701,2699
0132-000,2018,11,23,21,798,519,1317,1701
0132-000,2018,11,23,22,523,448,971,1317
0132-000,2018,11,23,23,354,365,719,971
0132-000,2018,11,23,24,230,220,450,719
0132-000,2018,11,24,1,174,150,324,450
0132-000,2018,11,24,2,133,119,252,324
0132-000,2018,11,24,3,78,96,174,252
0132-000,2018,11,24,4,78,85,163,174
0132-000,2018,11,24,5,123,115,238,163
0132-000,2018,11,24,6,268,161,429,238
0132-000,2018,11,24,7,320,303,623,429
0132-000,2018,11,24,8,439,711,1150,623
0132-000,2018,11,24,9,576,851,1427,1150
0132-000,2018,11,24,10,665,926,1591,1427
0132-000,2018,11,24,11,721,915,1636,1591
0132-000,2018,11,24,12,708,935,1643,1636
0132-000,2018,11,24,13,867,984,1851,1643
0132-000,2018,11,24,14,759,1023,1782,1851
0132-000,2018,11,24,15,790,936,1726,1782
0132-000,2018,11,24,16,876,933,1809,1726
0132-000,2018,11,24,17,985,860,1845,1809
0132-000,2018,11,24,18,1154,936,2090,1845
0132-000,2018,11,24,19,985,701,1686,2090
0132-000,2018,11,24,20,636,468,1104,1686
0132-000,2018,11,24,21,520,454,974,1104
0132-000,2018,11,24,22,425,326,751,974
0132-000,2018,11,24,23,390,313,703,751
0132-000,2018,11,24,24,178,200,378,703
0132-000,2018,11,25,1,163,158,321,378
0132-000,2018,11,25,2,127,127,254,321
0132-000,2018,11,25,3,92,109,201,254
0132-000,2018,11,25,4,65,76,141,201
0132-000,2018,11,25,5,93,93,186,141
0132-000,2018,11,25,6,183,118,301,186
0132-000,2018,11,25,7,199,193,392,301
0132-000,2018,11,25,8,224,299,523,392
0132-000,2018,11,25,9,306,434,740,523
0132-000,2018,11,25,10,419,524,943,740
0132-000,2018,11,25,11,550,559,1109,943
0132-000,2018,11,25,12,562,589,1151,1109
0132-000,2018,11,25,13,628,596,1224,1151
0132-000,2018,11,25,14,678,705,1383,1224
0132-000,2018,11,25,15,838,688,1526,1383
0132-000,2018,11,25,16,868,747,1615,1526
0132-000,2018,11,25,17,1130,704,1834,1615
0132-000,2018,11,25,18,1411,722,2133,1834
0132-000,2018,11,25,19,1290,554,1844,2133
0132-000,2018,11,25,20,1025,458,1483,1844
0132-000,2018,11,25,21,669,394,1063,1483
0132-000,2018,11,25,22,476,399,875,1063
0132-000,2018,11,25,23,228,292,520,875
0132-000,2018,11,25,24,170,305,475,520
0132-000,2018,11,26,1,116,119,235,475
0132-000,2018,11,26,2,72,79,151,235
0132-000,2018,11,26,3,47,62,109,151
0132-000,2018,11,26,4,60,66,126,109
0132-000,2018,11,26,5,142,82,224,126
0132-000,2018,11,26,6,352,207,559,224
0132-000,2018,11,26,7,491,563,1054,559
0132-000,2018,11,26,8,639,1907,2546,1054
0132-000,2018,11,26,9,774,1690,2464,2546
0132-000,2018,11,26,10,740,927,1667,2464
0132-000,2018,11,26,11,696,833,1529,1667
0132-000,2018,11,26,12,801,785,1586,1529
0132-000,2018,11,26,13,757,780,1537,1586
0132-000,2018,11,26,14,841,755,1596,1537
0132-000,2018,11,26,15,889,816,1705,1596
0132-000,2018,11,26,16,897,802,1699,1705
0132-000,2018,11,26,17,952,879,1831,1699
0132-000,2018,11,26,18,1492,949,2441,1831
0132-000,2018,11,26,19,1654,804,2458,2441
0132-000,2018,11,26,20,900,622,1522,2458
0132-000,2018,11,26,21,758,428,1186,1522
0132-000,2018,11,26,22,518,411,929,1186
0132-000,2018,11,26,23,332,272,604,929
0132-000,2018,11,26,24,189,193,382,604
0132-000,2018,11,27,1,135,119,254,382
0132-000,2018,11,27,2,86,98,184,254
0132-000,2018,11,27,3,56,75,131,184
0132-000,2018,11,27,4,68,63,131,131
0132-000,2018,11,27,5,127,118,245,131
0132-000,2018,11,27,6,316,190,506,245
0132-000,2018,11,27,7,474,526,1000,506
0132-000,2018,11,27,8,660,1887,2547,1000
0132-000,2018,11,27,9,817,1650,2467,2547
0132-000,2018,11,27,10,785,894,1679,2467
0132-000,2018,11,27,11,728,905,1633,1679
0132-000,2018,11,27,12,748,819,1567,1633
0132-000,2018,11,27,13,693,773,1466,1567
0132-000,2018,11,27,14,823,761,1584,1466
0132-000,2018,11,27,15,949,789,1738,1584
0132-000,2018,11,27,16,849,758,1607,1738
0132-000,2018,11,27,17,963,843,1806,1607
0132-000,2018,11,27,18,1406,882,2288,1806
0132-000,2018,11,27,19,1533,777,2310,2288
0132-000,2018,11,27,20,874,609,1483,2310
0132-000,2018,11,27,21,802,413,1215,1483
0132-000,2018,11,27,22,527,367,894,1215
0132-000,2018,11,27,23,335,286,621,894
0132-000,2018,11,27,24,205,173,378,621
0132-000,2018,11,28,1,136,124,260,378
0132-000,2018,11,28,2,83,114,197,260
0132-000,2018,11,28,3,64,82,146,197
0132-000,2018,11,28,4,56,80,136,146
0132-000,2018,11,28,5,142,90,232,136
0132-000,2018,11,28,6,318,174,492,232
0132-000,2018,11,28,7,450,523,973,492
0132-000,2018,11,28,8,634,1850,2484,973
0132-000,2018,11,28,9,807,1618,2425,2484
0132-000,2018,11,28,10,729,873,1602,2425
0132-000,2018,11,28,11,729,776,1505,1602
0132-000,2018,11,28,12,745,759,1504,1505
0132-000,2018,11,28,13,686,740,1426,1504
0132-000,2018,11,28,14,740,776,1516,1426
0132-000,2018,11,28,15,803,759,1562,1516
0132-000,2018,11,28,16,871,743,1614,1562
0132-000,2018,11,28,17,916,855,1771,1614
0132-000,2018,11,28,18,1552,936,2488,1771
0132-000,2018,11,28,19,1628,796,2424,2488
0132-000,2018,11,28,20,890,597,1487,2424
0132-000,2018,11,28,21,703,443,1146,1487
0132-000,2018,11,28,22,523,359,882,1146
0132-000,2018,11,28,23,342,334,676,882
0132-000,2018,11,28,24,195,171,366,676
0132-000,2018,11,29,1,141,131,272,366
0132-000,2018,11,29,2,91,100,191,272
0132-000,2018,11,29,3,62,91,153,191
0132-000,2018,11,29,4,73,87,160,153
0132-000,2018,11,29,5,144,99,243,160
0132-000,2018,11,29,6,309,173,482,243
0132-000,2018,11,29,7,482,504,986,482
0132-000,2018,11,29,8,635,1823,2458,986
0132-000,2018,11,29,9,801,1667,2468,2458
0132-000,2018,11,29,10,804,857,1661,2468
0132-000,2018,11,29,11,741,881,1622,1661
0132-000,2018,11,29,12,642,724,1366,1622
0132-000,2018,11,29,13,715,767,1482,1366
0132-000,2018,11,29,14,778,738,1516,1482
0132-000,2018,11,29,15,808,800,1608,1516
0132-000,2018,11,29,16,883,773,1656,1608
0132-000,2018,11,29,17,917,863,1780,1656
0132-000,2018,11,29,18,1459,904,2363,1780
0132-000,2018,11,29,19,1478,766,2244,2363
0132-000,2018,11,29,20,839,622,1461,2244
0132-000,2018,11,29,21,741,391,1132,1461
0132-000,2018,11,29,22,558,406,964,1132
0132-000,2018,11,29,23,355,334,689,964
0132-000,2018,11,29,24,200,198,398,689
0132-000,2018,11,30,1,153,168,321,398
0132-000,2018,11,30,2,104,112,216,321
0132-000,2018,11,30,3,65,78,143,216
0132-000,2018,11,30,4,61,74,135,143
0132-000,2018,11,30,5,142,98,240,135
0132-000,2018,11,30,6,324,168,492,240
0132-000,2018,11,30,7,474,506,980,492
0132-000,2018,11,30,8,672,1812,2484,980
0132-000,2018,11,30,9,849,1596,2445,2484
0132-000,2018,11,30,10,755,925,1680,2445
0132-000,2018,11,30,11,758,833,1591,1680
0132-000,2018,11,30,12,743,769,1512,1591
0132-000,2018,11,30,13,740,720,1460,1512
0132-000,2018,11,30,14,760,733,1493,1460
0132-000,2018,11,30,15,935,826,1761,1493
0132-000,2018,11,30,16,892,785,1677,1761
0132-000,2018,11,30,17,1057,872,1929,1677
0132-000,2018,11,30,18,1587,995,2582,1929
0132-000,2018,11,30,19,1904,813,2717,2582
0132-000,2018,11,30,20,1012,702,1714,2717
0132-000,2018,11,30,21,765,552,1317,1714
0132-000,2018,11,30,22,548,423,971,1317
0132-000,2018,11,30,23,399,369,768,971
0132-000,2018,11,30,24,240,247,487,768
0132-000,2018,12,1,1,235,200,435,487
0132-000,2018,12,1,2,126,148,274,435
0132-000,2018,12,1,3,88,107,195,274
0132-000,2018,12,1,4,77,100,177,195
0132-000,2018,12,1,5,159,107,266,177
0132-000,2018,12,1,6,274,191,465,266
0132-000,2018,12,1,7,374,344,718,465
0132-000,2018,12,1,8,475,700,1175,718
0132-000,2018,12,1,9,624,864,1488,1175
0132-000,2018,12,1,10,670,929,1599,1488
0132-000,2018,12,1,11,775,958,1733,1599
0132-000,2018,12,1,12,759,946,1705,1733
0132-000,2018,12,1,13,826,985,1811,1705
0132-000,2018,12,1,14,846,945,1791,1811
0132-000,2018,12,1,15,938,862,1800,1791
0132-000,2018,12,1,16,903,922,1825,1800
0132-000,2018,12,1,17,991,894,1885,1825
0132-000,2018,12,1,18,1227,986,2213,1885
0132-000,2018,12,1,19,995,731,1726,2213
0132-000,2018,12,1,20,656,518,1174,1726
0132-000,2018,12,1,21,525,422,947,1174
0132-000,2018,12,1,22,419,371,790,947
0132-000,2018,12,1,23,309,293,602,790
0132-000,2018,12,1,24,234,240,474,602
0132-000,2018,12,2,1,138,197,335,474
0132-000,2018,12,2,2,135,141,276,335
0132-000,2018,12,2,3,80,113,193,276
0132-000,2018,12,2,4,80,73,153,193
0132-000,2018,12,2,5,80,79,159,153
0132-000,2018,12,2,6,147,108,255,159
0132-000,2018,12,2,7,201,175,376,255
0132-000,2018,12,2,8,224,324,548,376
0132-000,2018,12,2,9,325,405,730,548
0132-000,2018,12,2,10,412,557,969,730
0132-000,2018,12,2,11,495,656,1151,969
0132-000,2018,12,2,12,575,673,1248,1151
0132-000,2018,12,2,13,675,682,1357,1248
0132-000,2018,12,2,14,724,820,1544,1357
0132-000,2018,12,2,15,849,716,1565,1544
0132-000,2018,12,2,16,830,703,1533,1565
0132-000,2018,12,2,17,946,659,1605,1533
0132-000,2018,12,2,18,1081,700,1781,1605
0132-000,2018,12,2,19,876,569,1445,1781
0132-000,2018,12,2,20,618,484,1102,1445
0132-000,2018,12,2,21,504,391,895,1102
0132-000,2018,12,2,22,378,350,728,895
0132-000,2018,12,2,23,255,238,493,728
0132-000,2018,12,2,24,160,157,317,493
0132-000,2018,12,3,1,99,96,195,317
0132-000,2018,12,3,2,67,74,141,195
0132-000,2018,12,3,3,52,51,103,141
0132-000,2018,12,3,4,59,60,119,103
0132-000,2018,12,3,5,147,93,240,119
0132-000,2018,12,3,6,276,177,453,240
0132-000,2018,12,3,7,380,508,888,453
0132-000,2018,12,3,8,600,1785,2385,888
0132-000,2018,12,3,9,729,1717,2446,2385
0132-000,2018,12,3,10,768,839,1607,2446
0132-000,2018,12,3,11,687,787,1474,1607
0132-000,2018,12,3,12,718,715,1433,1474
0132-000,2018,12,3,13,709,772,1481,1433
0132-000,2018,12,3,14,729,756,1485,1481
0132-000,2018,12,3,15,779,770,1549,1485
0132-000,2018,12,3,16,845,762,1607,1549
0132-000,2018,12,3,17,909,782,1691,1607
0132-000,2018,12,3,18,1357,863,2220,1691
0132-000,2018,12,3,19,1461,804,2265,2220
0132-000,2018,12,3,20,867,515,1382,2265
0132-000,2018,12,3,21,780,400,1180,1382
0132-000,2018,12,3,22,545,373,918,1180
0132-000,2018,12,3,23,315,256,571,918
0132-000,2018,12,3,24,190,169,359,571
0132-000,2018,12,4,1,137,110,247,359
0132-000,2018,12,4,2,92,82,174,247
0132-000,2018,12,4,3,69,64,133,174
0132-000,2018,12,4,4,59,73,132,133
0132-000,2018,12,4,5,118,107,225,132
0132-000,2018,12,4,6,248,148,396,225
0132-000,2018,12,4,7,365,465,830,396
0132-000,2018,12,4,8,600,1771,2371,830
0132-000,2018,12,4,9,785,1680,2465,2371
0132-000,2018,12,4,10,761,882,1643,2465
0132-000,2018,12,4,11,724,869,1593,1643
0132-000,2018,12,4,12,771,846,1617,1593
0132-000,2018,12,4,13,764,783,1547,1617
0132-000,2018,12,4,14,833,784,1617,1547
0132-000,2018,12,4,15,820,839,1659,1617
0132-000,2018,12,4,16,863,720,1583,1659
0132-000,2018,12,4,17,890,751,1641,1583
0132-000,2018,12,4,18,1383,903,2286,1641
0132-000,2018,12,4,19,1544,736,2280,2286
0132-000,2018,12,4,20,887,557,1444,2280
0132-000,2018,12,4,21,798,418,1216,1444
0132-000,2018,12,4,22,537,378,915,1216
0132-000,2018,12,4,23,377,319,696,915
0132-000,2018,12,4,24,199,192,391,696
0132-000,2018,12,5,1,140,124,264,391
0132-000,2018,12,5,2,80,105,185,264
0132-000,2018,12,5,3,60,69,129,185
0132-000,2018,12,5,4,56,74,130,129
0132-000,2018,12,5,5,135,97,232,130
0132-000,2018,12,5,6,299,170,469,232
0132-000,2018,12,5,7,427,501,928,469
0132-000,2018,12,5,8,650,1801,2451,928
0132-000,2018,12,5,9,803,1659,2462,2451
0132-000,2018,12,5,10,753,895,1648,2462
0132-000,2018,12,5,11,741,840,1581,1648
0132-000,2018,12,5,12,733,801,1534,1581
0132-000,2018,12,5,13,782,759,1541,1534
0132-000,2018,12,5,14,776,793,1569,1541
0132-000,2018,12,5,15,818,784,1602,1569
0132-000,2018,12,5,16,880,747,1627,1602
0132-000,2018,12,5,17,900,789,1689,1627
0132-000,2018,12,5,18,1479,964,2443,1689
0132-000,2018,12,5,19,1670,777,2447,2443
0132-000,2018,12,5,20,907,584,1491,2447
0132-000,2018,12,5,21,708,412,1120,1491
0132-000,2018,12,5,22,488,377,865,1120
0132-000,2018,12,5,23,334,309,643,865
0132-000,2018,12,5,24,233,189,422,643
0132-000,2018,12,6,1,152,150,302,422
0132-000,2018,12,6,2,96,94,190,302
0132-000,2018,12,6,3,71,92,163,190
0132-000,2018,12,6,4,69,89,158,163
0132-000,2018,12,6,5,146,105,251,158
0132-000,2018,12,6,6,285,179,464,251
0132-000,2018,12,6,7,443,514,957,464
0132-000,2018,12,6,8,624,1729,2353,957
0132-000,2018,12,6,9,772,1733,2505,2353
0132-000,2018,12,6,10,748,860,1608,2505
0132-000,2018,12,6,11,749,910,1659,1608
0132-000,2018,12,6,12,723,794,1517,1659
0132-000,2018,12,6,13,660,747,1407,1517
0132-000,2018,12,6,14,773,732,1505,1407
0132-000,2018,12,6,15,789,771,1560,1505
0132-000,2018,12,6,16,833,743,1576,1560
0132-000,2018,12,6,17,923,738,1661,1576
0132-000,2018,12,6,18,1401,929,2330,1661
0132-000,2018,12,6,19,1641,725,2366,2330
0132-000,2018,12,6,20,867,607,1474,2366
0132-000,2018,12,6,21,733,428,1161,1474
0132-000,2018,12,6,22,544,404,948,1161
0132-000,2018,12,6,23,331,331,662,948
0132-000,2018,12,6,24,199,192,391,662
0132-000,2018,12,7,1,153,131,284,391
0132-000,2018,12,7,2,105,104,209,284
0132-000,2018,12,7,3,77,87,164,209
0132-000,2018,12,7,4,76,78,154,164
0132-000,2018,12,7,5,150,87,237,154
0132-000,2018,12,7,6,315,167,482,237
0132-000,2018,12,7,7,411,478,889,482
0132-000,2018,12,7,8,627,1817,2444,889
0132-000,2018,12,7,9,778,1533,2311,2444
0132-000,2018,12,7,10,704,911,1615,2311
0132-000,2018,12,7,11,716,842,1558,1615
0132-000,2018,12,7,12,695,717,1412,1558
0132-000,2018,12,7,13,775,740,1515,1412
0132-000,2018,12,7,14,831,783,1614,1515
0132-000,2018,12,7,15,794,813,1607,1614
0132-000,2018,12,7,16,925,779,1704,1607
0132-000,2018,12,7,17,1014,864,1878,1704
0132-000,2018,12,7,18,1478,970,2448,1878
0132-000,2018,12,7,19,1855,834,2689,2448
0132-000,2018,12,7,20,987,690,1677,2689
0132-000,2018,12,7,21,716,447,1163,1677
0132-000,2018,12,7,22,497,419,916,1163
0132-000,2018,12,7,23,369,372,741,916
0132-000,2018,12,7,24,242,238,480,741
0132-000,2018,12,8,1,180,186,366,480
0132-000,2018,12,8,2,117,136,253,366
0132-000,2018,12,8,3,97,107,204,253
0132-000,2018,12,8,4,82,86,168,204
0132-000,2018,12,8,5,148,109,257,168
0132-000,2018,12,8,6,241,124,365,257
0132-000,2018,12,8,7,307,286,593,365
0132-000,2018,12,8,8,407,681,1088,593
0132-000,2018,12,8,9,603,817,1420,1088
0132-000,2018,12,8,10,579,806,1385,1420
0132-000,2018,12,8,11,703,800,1503,1385
0132-000,2018,12,8,12,749,877,1626,1503
0132-000,2018,12,8,13,828,786,1614,1626
0132-000,2018,12,8,14,805,847,1652,1614
0132-000,2018,12,8,15,790,864,1654,1652
0132-000,2018,12,8,16,898,832,1730,1654
0132-000,2018,12,8,17,955,979,1934,1730
0132-000,2018,12,8,18,1183,929,2112,1934
0132-000,2018,12,8,19,930,732,1662,2112
0132-000,2018,12,8,20,586,521,1107,1662
0132-000,2018,12,8,21,507,435,942,1107
0132-000,2018,12,8,22,407,343,750,942
0132-000,2018,12,8,23,304,319,623,750
0132-000,2018,12,8,24,200,221,421,623
0132-000,2018,12,9,1,163,182,345,421
0132-000,2018,12,9,2,123,152,275,345
0132-000,2018,12,9,3,92,93,185,275
0132-000,2018,12,9,4,49,76,125,185
0132-000,2018,12,9,5,95,72,167,125
0132-000,2018,12,9,6,137,90,227,167
0132-000,2018,12,9,7,155,166,321,227
0132-000,2018,12,9,8,201,250,451,321
0132-000,2018,12,9,9,289,399,688,451
0132-000,2018,12,9,10,376,458,834,688
0132-000,2018,12,9,11,491,578,1069,834
0132-000,2018,12,9,12,565,597,1162,1069
0132-000,2018,12,9,13,672,548,1220,1162
0132-000,2018,12,9,14,664,669,1333,1220
0132-000,2018,12,9,15,709,678,1387,1333
0132-000,2018,12,9,16,752,664,1416,1387
0132-000,2018,12,9,17,809,664,1473,1416
0132-000,2018,12,9,18,806,643,1449,1473
0132-000,2018,12,9,19,722,516,1238,1449
0132-000,2018,12,9,20,509,431,940,1238
0132-000,2018,12,9,21,402,379,781,940
0132-000,2018,12,9,22,362,278,640,781
0132-000,2018,12,9,23,224,241,465,640
0132-000,2018,12,9,24,143,142,285,465
0132-000,2018,12,10,1,104,91,195,285
0132-000,2018,12,10,2,57,66,123,195
0132-000,2018,12,10,3,42,49,91,123
0132-000,2018,12,10,4,54,51,105,91
0132-000,2018,12,10,5,144,90,234,105
0132-000,2018,12,10,6,325,181,506,234
0132-000,2018,12,10,7,445,516,961,506
0132-000,2018,12,10,8,646,1900,2546,961
0132-000,2018,12,10,9,725,1661,2386,2546
0132-000,2018,12,10,10,708,887,1595,2386
0132-000,2018,12,10,11,694,761,1455,1595
0132-000,2018,12,10,12,743,779,1522,1455
0132-000,2018,12,10,13,675,732,1407,1522
0132-000,2018,12,10,14,774,742,1516,1407
0132-000,2018,12,10,15,828,860,1688,1516
0132-000,2018,12,10,16,875,767,1642,1688
0132-000,2018,12,10,17,950,805,1755,1642
0132-000,2018,12,10,18,1385,897,2282,1755
0132-000,2018,12,10,19,1599,830,2429,2282
0132-000,2018,12,10,20,925,539,1464,2429
0132-000,2018,12,10,21,775,440,1215,1464
0132-000,2018,12,10,22,463,365,828,1215
0132-000,2018,12,10,23,316,304,620,828
0132-000,2018,12,10,24,186,194,380,620
0132-000,2018,12,11,1,114,131,245,380
0132-000,2018,12,11,2,72,84,156,245
0132-000,2018,12,11,3,77,96,173,156
0132-000,2018,12,11,4,63,84,147,173
0132-000,2018,12,11,5,178,97,275,147
0132-000,2018,12,11,6,292,165,457,275
0132-000,2018,12,11,7,430,505,935,457
0132-000,2018,12,11,8,639,1894,2533,935
0132-000,2018,12,11,9,771,1650,2421,2533
0132-000,2018,12,11,10,754,902,1656,2421
0132-000,2018,12,11,11,705,807,1512,1656
0132-000,2018,12,11,12,758,768,1526,1512
0132-000,2018,12,11,13,734,695,1429,1526
0132-000,2018,12,11,14,802,760,1562,1429
0132-000,2018,12,11,15,787,759,1546,1562
0132-000,2018,12,11,16,860,712,1572,1546
0132-000,2018,12,11,17,954,792,1746,1572
0132-000,2018,12,11,18,1355,908,2263,1746
0132-000,2018,12,11,19,1556,694,2250,2263
0132-000,2018,12,11,20,872,591,1463,2250
0132-000,2018,12,11,21,754,410,1164,1463
0132-000,2018,12,11,22,459,367,826,1164
0132-000,2018,12,11,23,346,301,647,826
0132-000,2018,12,11,24,189,203,392,647
0132-000,2018,12,12,1,122,122,244,392
0132-000,2018,12,12,2,88,103,191,244
0132-000,2018,12,12,3,77,92,169,191
0132-000,2018,12,12,4,61,76,137,169
0132-000,2018,12,12,5,176,102,278,137
0132-000,2018,12,12,6,300,165,465,278
0132-000,2018,12,12,7,439,513,952,465
0132-000,2018,12,12,8,615,1750,2365,952
0132-000,2018,12,12,9,740,1642,2382,2365
0132-000,2018,12,12,10,729,893,1622,2382
0132-000,2018,12,12,11,739,864,1603,1622
0132-000,2018,12,12,12,736,751,1487,1603
0132-000,2018,12,12,13,726,723,1449,1487
0132-000,2018,12,12,14,762,763,1525,1449
0132-000,2018,12,12,15,852,817,1669,1525
0132-000,2018,12,12,16,871,769,1640,1669
0132-000,2018,12,12,17,1007,800,1807,1640
0132-000,2018,12,12,18,1482,916,2398,1807
0132-000,2018,12,12,19,1659,749,2408,2398
0132-000,2018,12,12,20,854,583,1437,2408
0132-000,2018,12,12,21,718,408,1126,1437
0132-000,2018,12,12,22,532,380,912,1126
0132-000,2018,12,12,23,343,353,696,912
0132-000,2018,12,12,24,218,188,406,696
0132-000,2018,12,13,1,143,125,268,406
0132-000,2018,12,13,2,95,109,204,268
0132-000,2018,12,13,3,77,85,162,204
0132-000,2018,12,13,4,62,77,139,162
0132-000,2018,12,13,5,145,97,242,139
0132-000,2018,12,13,6,305,177,482,242
0132-000,2018,12,13,7,416,486,902,482
0132-000,2018,12,13,8,618,1834,2452,902
0132-000,2018,12,13,9,734,1544,2278,2452
0132-000,2018,12,13,10,754,830,1584,2278
0132-000,2018,12,13,11,727,807,1534,1584
0132-000,2018,12,13,12,720,703,1423,1534
0132-000,2018,12,13,13,646,683,1329,1423
0132-000,2018,12,13,14,680,659,1339,1329
0132-000,2018,12,13,15,751,709,1460,1339
0132-000,2018,12,13,16,793,697,1490,1460
0132-000,2018,12,13,17,812,742,1554,1490
0132-000,2018,12,13,18,1331,826,2157,1554
0132-000,2018,12,13,19,1418,756,2174,2157
0132-000,2018,12,13,20,803,538,1341,2174
0132-000,2018,12,13,21,696,428,1124,1341
0132-000,2018,12,13,22,491,371,862,1124
0132-000,2018,12,13,23,301,289,590,862
0132-000,2018,12,13,24,260,191,451,590
0132-000,2018,12,14,1,139,133,272,451
0132-000,2018,12,14,2,116,95,211,272
0132-000,2018,12,14,3,80,95,175,211
0132-000,2018,12,14,4,68,85,153,175
0132-000,2018,12,14,5,147,85,232,153
0132-000,2018,12,14,6,261,158,419,232
0132-000,2018,12,14,7,392,457,849,419
0132-000,2018,12,14,8,580,1720,2300,849
0132-000,2018,12,14,9,770,1485,2255,2300
0132-000,2018,12,14,10,742,851,1593,2255
0132-000,2018,12,14,11,666,835,1501,1593
0132-000,2018,12,14,12,785,769,1554,1501
0132-000,2018,12,14,13,731,747,1478,1554
0132-000,2018,12,14,14,819,793,1612,1478
0132-000,2018,12,14,15,838,781,1619,1612
0132-000,2018,12,14,16,900,808,1708,1619
0132-000,2018,12,14,17,956,806,1762,1708
0132-000,2018,12,14,18,1554,954,2508,1762
0132-000,2018,12,14,19,1760,802,2562,2508
0132-000,2018,12,14,20,865,675,1540,2562
0132-000,2018,12,14,21,739,480,1219,1540
0132-000,2018,12,14,22,533,461,994,1219
0132-000,2018,12,14,23,371,379,750,994
0132-000,2018,12,14,24,231,251,482,750
0132-000,2018,12,15,1,188,185,373,482
0132-000,2018,12,15,2,143,167,310,373
0132-000,2018,12,15,3,91,106,197,310
0132-000,2018,12,15,4,107,115,222,197
0132-000,2018,12,15,5,151,102,253,222
0132-000,2018,12,15,6,256,127,383,253
0132-000,2018,12,15,7,345,297,642,383
0132-000,2018,12,15,8,442,621,1063,642
0132-000,2018,12,15,9,526,753,1279,1063
0132-000,2018,12,15,10,632,771,1403,1279
0132-000,2018,12,15,11,660,891,1551,1403
0132-000,2018,12,15,12,909,892,1801,1551
0132-000,2018,12,15,13,876,845,1721,1801
0132-000,2018,12,15,14,826,872,1698,1721
0132-000,2018,12,15,15,854,840,1694,1698
0132-000,2018,12,15,16,868,846,1714,1694
0132-000,2018,12,15,17,950,856,1806,1714
0132-000,2018,12,15,18,1053,929,1982,1806
0132-000,2018,12,15,19,925,678,1603,1982
0132-000,2018,12,15,20,680,528,1208,1603
0132-000,2018,12,15,21,490,434,924,1208
0132-000,2018,12,15,22,378,391,769,924
0132-000,2018,12,15,23,306,306,612,769
0132-000,2018,12,15,24,213,215,428,612
0132-000,2018,12,16,1,168,193,361,428
0132-000,2018,12,16,2,129,147,276,361
0132-000,2018,12,16,3,113,118,231,276
0132-000,2018,12,16,4,93,99,192,231
0132-000,2018,12,16,5,80,72,152,192
0132-000,2018,12,16,6,138,110,248,152
0132-000,2018,12,16,7,166,165,331,248
0132-000,2018,12,16,8,194,273,467,331
0132-000,2018,12,16,9,295,359,654,467
0132-000,2018,12,16,10,328,509,837,654
0132-000,2018,12,16,11,508,594,1102,837
0132-000,2018,12,16,12,543,631,1174,1102
0132-000,2018,12,16,13,658,679,1337,1174
0132-000,2018,12,16,14,697,756,1453,1337
0132-000,2018,12,16,15,785,768,1553,1453
0132-000,2018,12,16,16,801,752,1553,1553
0132-000,2018,12,16,17,901,636,1537,1553
0132-000,2018,12,16,18,947,675,1622,1537
0132-000,2018,12,16,19,728,489,1217,1622
0132-000,2018,12,16,20,533,460,993,1217
0132-000,2018,12,16,21,466,375,841,993
0132-000,2018,12,16,22,354,296,650,841
0132-000,2018,12,16,23,229,232,461,650
0132-000,2018,12,16,24,151,163,314,461
0132-000,2018,12,17,1,108,87,195,314
0132-000,2018,12,17,2,93,95,188,195
0132-000,2018,12,17,3,54,73,127,188
0132-000,2018,12,17,4,53,65,118,127
0132-000,2018,12,17,5,170,87,257,118
0132-000,2018,12,17,6,326,163,489,257
0132-000,2018,12,17,7,447,477,924,489
0132-000,2018,12,17,8,585,857,1442,924
0132-000,2018,12,17,9,702,1099,1801,1442
0132-000,2018,12,17,10,721,1367,2088,1801
0132-000,2018,12,17,11,711,813,1524,2088
0132-000,2018,12,17,12,767,775,1542,1524
0132-000,2018,12,17,13,730,771,1501,1542
0132-000,2018,12,17,14,830,783,1613,1501
0132-000,2018,12,17,15,800,774,1574,1613
0132-000,2018,12,17,16,797,818,1615,1574
0132-000,2018,12,17,17,964,803,1767,1615
0132-000,2018,12,17,18,1354,906,2260,1767
0132-000,2018,12,17,19,1464,689,2153,2260
0132-000,2018,12,17,20,857,577,1434,2153
0132-000,2018,12,17,21,752,414,1166,1434
0132-000,2018,12,17,22,450,366,816,1166
0132-000,2018,12,17,23,329,269,598,816
0132-000,2018,12,17,24,189,158,347,598
0132-000,2018,12,18,1,134,126,260,347
0132-000,2018,12,18,2,83,92,175,260
0132-000,2018,12,18,3,70,76,146,175
0132-000,2018,12,18,4,67,62,129,146
0132-000,2018,12,18,5,150,103,253,129
0132-000,2018,12,18,6,294,165,459,253
0132-000,2018,12,18,7,414,477,891,459
0132-000,2018,12,18,8,639,1796,2435,891
0132-000,2018,12,18,9,780,1576,2356,2435
0132-000,2018,12,18,10,677,818,1495,2356
0132-000,2018,12,18,11,732,803,1535,1495
0132-000,2018,12,18,12,669,774,1443,1535
0132-000,2018,12,18,13,687,716,1403,1443
0132-000,2018,12,18,14,737,746,1483,1403
0132-000,2018,12,18,15,827,746,1573,1483
0132-000,2018,12,18,16,829,778,1607,1573
0132-000,2018,12,18,17,926,718,1644,1607
0132-000,2018,12,18,18,1378,879,2257,1644
0132-000,2018,12,18,19,1491,771,2262,2257
0132-000,2018,12,18,20,865,541,1406,2262
0132-000,2018,12,18,21,722,457,1179,1406
0132-000,2018,12,18,22,559,408,967,1179
0132-000,2018,12,18,23,329,335,664,967
0132-000,2018,12,18,24,204,183,387,664
0132-000,2018,12,19,1,150,142,292,387
0132-000,2018,12,19,2,93,113,206,292
0132-000,2018,12,19,3,62,91,153,206
0132-000,2018,12,19,4,78,73,151,153
0132-000,2018,12,19,5,156,101,257,151
0132-000,2018,12,19,6,312,178,490,257
0132-000,2018,12,19,7,447,486,933,490
0132-000,2018,12,19,8,598,1796,2394,933
0132-000,2018,12,19,9,807,1574,2381,2394
0132-000,2018,12,19,10,757,881,1638,2381
0132-000,2018,12,19,11,753,808,1561,1638
0132-000,2018,12,19,12,731,789,1520,1561
0132-000,2018,12,19,13,702,730,1432,1520
0132-000,2018,12,19,14,804,718,1522,1432
0132-000,2018,12,19,15,821,798,1619,1522
0132-000,2018,12,19,16,900,754,1654,1619
0132-000,2018,12,19,17,913,793,1706,1654
0132-000,2018,12,19,18,1479,969,2448,1706
0132-000,2018,12,19,19,1522,733,2255,2448
0132-000,2018,12,19,20,840,570,1410,2255
0132-000,2018,12,19,21,671,436,1107,1410
0132-000,2018,12,19,22,485,373,858,1107
0132-000,2018,12,19,23,333,305,638,858
0132-000,2018,12,19,24,207,190,397,638
0132-000,2018,12,20,1,199,151,350,397
0132-000,2018,12,20,2,95,111,206,350
0132-000,2018,12,20,3,60,78,138,206
0132-000,2018,12,20,4,75,104,179,138
0132-000,2018,12,20,5,174,93,267,179
0132-000,2018,12,20,6,293,148,441,267
0132-000,2018,12,20,7,451,464,915,441
0132-000,2018,12,20,8,606,1798,2404,915
0132-000,2018,12,20,9,762,1488,2250,2404
0132-000,2018,12,20,10,737,828,1565,2250
0132-000,2018,12,20,11,660,826,1486,1565
0132-000,2018,12,20,12,752,831,1583,1486
0132-000,2018,12,20,13,793,753,1546,1583
0132-000,2018,12,20,14,799,760,1559,1546
0132-000,2018,12,20,15,793,740,1533,1559
0132-000,2018,12,20,16,830,728,1558,1533
0132-000,2018,12,20,17,948,777,1725,1558
0132-000,2018,12,20,18,1405,906,2311,1725
0132-000,2018,12,20,19,1579,733,2312,2311
0132-000,2018,12,20,20,813,593,1406,2312
0132-000,2018,12,20,21,746,438,1184,1406
0132-000,2018,12,20,22,515,402,917,1184
0132-000,2018,12,20,23,299,336,635,917
0132-000,2018,12,20,24,256,180,436,635
0132-000,2018,12,21,1,165,176,341,436
0132-000,2018,12,21,2,89,118,207,341
0132-000,2018,12,21,3,73,95,168,207
0132-000,2018,12,21,4,78,76,154,168
0132-000,2018,12,21,5,146,103,249,154
0132-000,2018,12,21,6,313,174,487,249
0132-000,2018,12,21,7,443,481,924,487
0132-000,2018,12,21,8,662,1806,2468,924
0132-000,2018,12,21,9,808,1515,2323,2468
0132-000,2018,12,21,10,781,924,1705,2323
0132-000,2018,12,21,11,754,889,1643,1705
0132-000,2018,12,21,12,776,820,1596,1643
0132-000,2018,12,21,13,804,775,1579,1596
0132-000,2018,12,21,14,800,748,1548,1579
0132-000,2018,12,21,15,869,782,1651,1548
0132-000,2018,12,21,16,1008,831,1839,1651
0132-000,2018,12,21,17,1063,882,1945,1839
0132-000,2018,12,21,18,1567,975,2542,1945
0132-000,2018,12,21,19,1685,748,2433,2542
0132-000,2018,12,21,20,881,649,1530,2433
0132-000,2018,12,21,21,752,509,1261,1530
0132-000,2018,12,21,22,563,459,1022,1261
0132-000,2018,12,21,23,416,374,790,1022
0132-000,2018,12,21,24,225,263,488,790
0132-000,2018,12,22,1,180,185,365,488
0132-000,2018,12,22,2,149,147,296,365
0132-000,2018,12,22,3,105,106,211,296
0132-000,2018,12,22,4,102,108,210,211
0132-000,2018,12,22,5,156,85,241,210
0132-000,2018,12,22,6,291,153,444,241
0132-000,2018,12,22,7,349,324,673,444
0132-000,2018,12,22,8,389,690,1079,673
0132-000,2018,12,22,9,592,851,1443,1079
0132-000,2018,12,22,10,671,828,1499,1443
0132-000,2018,12,22,11,829,927,1756,1499
0132-000,2018,12,22,12,827,924,1751,1756
0132-000,2018,12,22,13,841,905,1746,1751
0132-000,2018,12,22,14,844,899,1743,1746
0132-000,2018,12,22,15,908,895,1803,1743
0132-000,2018,12,22,16,1026,850,1876,1803
0132-000,2018,12,22,17,1079,857,1936,1876
0132-000,2018,12,22,18,1151,946,2097,1936
0132-000,2018,12,22,19,918,741,1659,2097
0132-000,2018,12,22,20,565,515,1080,1659
0132-000,2018,12,22,21,513,455,968,1080
0132-000,2018,12,22,22,363,373,736,968
0132-000,2018,12,22,23,299,296,595,736
0132-000,2018,12,22,24,212,198,410,595
0132-000,2018,12,23,1,160,177,337,410
0132-000,2018,12,23,2,117,130,247,337
0132-000,2018,12,23,3,87,102,189,247
0132-000,2018,12,23,4,78,71,149,189
0132-000,2018,12,23,5,82,86,168,149
0132-000,2018,12,23,6,130,101,231,168
0132-000,2018,12,23,7,159,175,334,231
0132-000,2018,12,23,8,248,264,512,334
0132-000,2018,12,23,9,291,382,673,512
0132-000,2018,12,23,10,388,525,913,673
0132-000,2018,12,23,11,492,569,1061,913
0132-000,2018,12,23,12,528,602,1130,1061
0132-000,2018,12,23,13,645,639,1284,1130
0132-000,2018,12,23,14,660,670,1330,1284
0132-000,2018,12,23,15,683,621,1304,1330
0132-000,2018,12,23,16,705,633,1338,1304
0132-000,2018,12,23,17,850,662,1512,1338
0132-000,2018,12,23,18,790,624,1414,1512
0132-000,2018,12,23,19,678,489,1167,1414
0132-000,2018,12,23,20,479,419,898,1167
0132-000,2018,12,23,21,426,365,791,898
0132-000,2018,12,23,22,333,253,586,791
0132-000,2018,12,23,23,207,247,454,586
0132-000,2018,12,23,24,145,130,275,454
0132-000,2018,12,24,1,107,108,215,275
0132-000,2018,12,24,2,75,76,151,215
0132-000,2018,12,24,3,43,62,105,151
0132-000,2018,12,24,4,53,59,112,105
0132-000,2018,12,24,5,156,73,229,112
0132-000,2018,12,24,6,307,155,462,229
0132-000,2018,12,24,7,400,459,859,462
0132-000,2018,12,24,8,557,1553,2110,859
0132-000,2018,12,24,9,722,1292,2014,2110
0132-000,2018,12,24,10,666,827,1493,2014
0132-000,2018,12,24,11,725,847,1572,1493
0132-000,2018,12,24,12,774,824,1598,1572
0132-000,2018,12,24,13,771,812,1583,1598
0132-000,2018,12,24,14,841,819,1660,1583
0132-000,2018,12,24,15,888,847,1735,1660
0132-000,2018,12,24,16,904,818,1722,1735
0132-000,2018,12,24,17,1003,833,1836,1722
0132-000,2018,12,24,18,1497,941,2438,1836
0132-000,2018,12,24,19,1436,759,2195,2438
0132-000,2018,12,24,20,768,649,1417,2195
0132-000,2018,12,24,21,584,501,1085,1417
0132-000,2018,12,24,22,435,382,817,1085
0132-000,2018,12,24,23,323,318,641,817
0132-000,2018,12,24,24,203,217,420,641
0132-000,2018,12,25,1,158,182,340,420
0132-000,2018,12,25,2,120,137,257,340
0132-000,2018,12,25,3,98,106,204,257
0132-000,2018,12,25,4,85,95,180,204
0132-000,2018,12,25,5,135,101,236,180
0132-000,2018,12,25,6,232,112,344,236
0132-000,2018,12,25,7,272,229,501,344
0132-000,2018,12,25,8,276,467,743,501
0132-000,2018,12,25,9,375,440,815,743
0132-000,2018,12,25,10,443,432,875,815
0132-000,2018,12,25,11,565,624,1189,875
0132-000,2018,12,25,12,492,631,1123,1189
0132-000,2018,12,25,13,633,641,1274,1123
0132-000,2018,12,25,14,680,726,1406,1274
0132-000,2018,12,25,15,706,723,1429,1406
0132-000,2018,12,25,16,751,705,1456,1429
0132-000,2018,12,25,17,794,694,1488,1456
0132-000,2018,12,25,18,858,665,1523,1488
0132-000,2018,12,25,19,694,527,1221,1523
0132-000,2018,12,25,20,461,429,890,1221
0132-000,2018,12,25,21,475,366,841,890
0132-000,2018,12,25,22,340,334,674,841
0132-000,2018,12,25,23,212,251,463,674
0132-000,2018,12,25,24,149,147,296,463
0132-000,2018,12,26,1,97,109,206,296
0132-000,2018,12,26,2,66,92,158,206
0132-000,2018,12,26,3,59,77,136,158
0132-000,2018,12,26,4,61,59,120,136
0132-000,2018,12,26,5,162,87,249,120
0132-000,2018,12,26,6,319,177,496,249
0132-000,2018,12,26,7,431,508,939,496
0132-000,2018,12,26,8,589,1827,2416,939
0132-000,2018,12,26,9,757,1531,2288,2416
0132-000,2018,12,26,10,722,831,1553,2288
0132-000,2018,12,26,11,723,773,1496,1553
0132-000,2018,12,26,12,715,743,1458,1496
0132-000,2018,12,26,13,746,684,1430,1458
0132-000,2018,12,26,14,754,815,1569,1430
0132-000,2018,12,26,15,846,806,1652,1569
0132-000,2018,12,26,16,885,780,1665,1652
0132-000,2018,12,26,17,948,830,1778,1665
0132-000,2018,12,26,18,1477,852,2329,1778
0132-000,2018,12,26,19,1497,740,2237,2329
0132-000,2018,12,26,20,821,581,1402,2237
0132-000,2018,12,26,21,659,424,1083,1402
0132-000,2018,12,26,22,451,385,836,1083
0132-000,2018,12,26,23,303,299,602,836
0132-000,2018,12,26,24,219,198,417,602
0132-000,2018,12,27,1,149,142,291,417
0132-000,2018,12,27,2,127,95,222,291
0132-000,2018,12,27,3,117,95,212,222
0132-000,2018,12,27,4,61,67,128,212
0132-000,2018,12,27,5,156,96,252,128
0132-000,2018,12,27,6,301,169,470,252
0132-000,2018,12,27,7,362,455,817,470
0132-000,2018,12,27,8,607,1708,2315,817
0132-000,2018,12,27,9,809,1580,2389,2315
0132-000,2018,12,27,10,722,801,1523,2389
0132-000,2018,12,27,11,705,808,1513,1523
0132-000,2018,12,27,12,711,735,1446,1513
0132-000,2018,12,27,13,709,652,1361,1446
0132-000,2018,12,27,14,729,750,1479,1361
0132-000,2018,12,27,15,762,777,1539,1479
0132-000,2018,12,27,16,814,764,1578,1539
0132-000,2018,12,27,17,923,732,1655,1578
0132-000,2018,12,27,18,1420,862,2282,1655
0132-000,2018,12,27,19,1423,693,2116,2282
0132-000,2018,12,27,20,791,570,1361,2116
0132-000,2018,12,27,21,702,433,1135,1361
0132-000,2018,12,27,22,515,390,905,1135
0132-000,2018,12,27,23,342,339,681,905
0132-000,2018,12,27,24,225,229,454,681
0132-000,2018,12,28,1,151,146,297,454
0132-000,2018,12,28,2,101,109,210,297
0132-000,2018,12,28,3,61,92,153,210
0132-000,2018,12,28,4,70,82,152,153
0132-000,2018,12,28,5,132,101,233,152
0132-000,2018,12,28,6,277,137,414,233
0132-000,2018,12,28,7,368,454,822,414
0132-000,2018,12,28,8,590,1615,2205,822
0132-000,2018,12,28,9,737,1460,2197,2205
0132-000,2018,12,28,10,697,821,1518,2197
0132-000,2018,12,28,11,716,812,1528,1518
0132-000,2018,12,28,12,713,779,1492,1528
0132-000,2018,12,28,13,729,727,1456,1492
0132-000,2018,12,28,14,773,735,1508,1456
0132-000,2018,12,28,15,863,763,1626,1508
0132-000,2018,12,28,16,838,758,1596,1626
0132-000,2018,12,28,17,1041,802,1843,1596
0132-000,2018,12,28,18,1480,906,2386,1843
0132-000,2018,12,28,19,1595,769,2364,2386
0132-000,2018,12,28,20,800,626,1426,2364
0132-000,2018,12,28,21,600,482,1082,1426
0132-000,2018,12,28,22,475,392,867,1082
0132-000,2018,12,28,23,332,348,680,867
0132-000,2018,12,28,24,217,252,469,680
0132-000,2018,12,29,1,204,173,377,469
0132-000,2018,12,29,2,145,156,301,377
0132-000,2018,12,29,3,98,110,208,301
0132-000,2018,12,29,4,91,95,186,208
0132-000,2018,12,29,5,141,106,247,186
0132-000,2018,12,29,6,246,138,384,247
0132-000,2018,12,29,7,254,252,506,384
0132-000,2018,12,29,8,342,606,948,506
0132-000,2018,12,29,9,537,720,1257,948
0132-000,2018,12,29,10,573,694,1267,1257
0132-000,2018,12,29,11,645,752,1397,1267
0132-000,2018,12,29,12,730,809,1539,1397
0132-000,2018,12,29,13,745,824,1569,1539
0132-000,2018,12,29,14,739,848,1587,1569
0132-000,2018,12,29,15,799,763,1562,1587
0132-000,2018,12,29,16,806,855,1661,1562
0132-000,2018,12,29,17,867,750,1617,1661
0132-000,2018,12,29,18,1033,869,1902,1617
0132-000,2018,12,29,19,816,680,1496,1902
0132-000,2018,12,29,20,560,479,1039,1496
0132-000,2018,12,29,21,431,420,851,1039
0132-000,2018,12,29,22,365,333,698,851
0132-000,2018,12,29,23,267,290,557,698
0132-000,2018,12,29,24,176,193,369,557
0132-000,2018,12,30,1,152,145,297,369
0132-000,2018,12,30,2,127,137,264,297
0132-000,2018,12,30,3,70,88,158,264
0132-000,2018,12,30,4,80,76,156,158
0132-000,2018,12,30,5,78,76,154,156
0132-000,2018,12,30,6,149,86,235,154
0132-000,2018,12,30,7,119,109,228,235
0132-000,2018,12,30,8,173,223,396,228
0132-000,2018,12,30,9,241,323,564,396
0132-000,2018,12,30,10,334,483,817,564
0132-000,2018,12,30,11,478,595,1073,817
0132-000,2018,12,30,12,472,612,1084,1073
0132-000,2018,12,30,13,564,621,1185,1084
0132-000,2018,12,30,14,635,648,1283,1185
0132-000,2018,12,30,15,698,673,1371,1283
0132-000,2018,12,30,16,823,718,1541,1371
0132-000,2018,12,30,17,803,607,1410,1541
0132-000,2018,12,30,18,836,603,1439,1410
0132-000,2018,12,30,19,685,488,1173,1439
0132-000,2018,12,30,20,506,394,900,1173
0132-000,2018,12,30,21,403,354,757,900
0132-000,2018,12,30,22,345,279,624,757
0132-000,2018,12,30,23,233,217,450,624
0132-000,2018,12,30,24,142,154,296,450
0132-000,2018,12,31,1,93,131,224,296
0132-000,2018,12,31,2,77,82,159,224
0132-000,2018,12,31,3,55,59,114,159
0132-000,2018,12,31,4,62,69,131,114
0132-000,2018,12,31,5,76,78,154,131
0132-000,2018,12,31,6,177,127,304,154
0132-000,2018,12,31,7,257,341,598,304
0132-000,2018,12,31,8,439,1078,1517,598
0132-000,2018,12,31,9,602,1032,1634,1517
0132-000,2018,12,31,10,614,716,1330,1634
0132-000,2018,12,31,11,692,758,1450,1330
0132-000,2018,12,31,12,752,801,1553,1450
0132-000,2018,12,31,13,749,786,1535,1553
0132-000,2018,12,31,14,824,740,1564,1535
0132-000,2018,12,31,15,909,816,1725,1564
0132-000,2018,12,31,16,966,814,1780,1725
0132-000,2018,12,31,17,918,874,1792,1780
0132-000,2018,12,31,18,1209,823,2032,1792
0132-000,2018,12,31,19,1042,712,1754,2032
0132-000,2018,12,31,20,626,533,1159,1754
0132-000,2018,12,31,21,465,380,845,1159
0132-000,2018,12,31,22,363,319,682,845
0132-000,2018,12,31,23,283,308,591,682
0132-000,2018,12,31,24,187,214,401,591
