ID,Year,M,D,H,1,2,sum,sump
0131-002,2011,1,1,1,175,143,318,0
0131-002,2011,1,1,2,123,94,217,318
0131-002,2011,1,1,3,76,70,146,217
0131-002,2011,1,1,4,72,83,155,146
0131-002,2011,1,1,5,76,91,167,155
0131-002,2011,1,1,6,114,152,266,167
0131-002,2011,1,1,7,313,312,625,266
0131-002,2011,1,1,8,803,669,1472,625
0131-002,2011,1,1,9,895,917,1812,1472
0131-002,2011,1,1,10,692,754,1446,1812
0131-002,2011,1,1,11,676,708,1384,1446
0131-002,2011,1,1,12,693,689,1382,1384
0131-002,2011,1,1,13,675,686,1361,1382
0131-002,2011,1,1,14,722,795,1517,1361
0131-002,2011,1,1,15,855,907,1762,1517
0131-002,2011,1,1,16,880,933,1813,1762
0131-002,2011,1,1,17,789,830,1619,1813
0131-002,2011,1,1,18,840,977,1817,1619
0131-002,2011,1,1,19,837,1069,1906,1817
0131-002,2011,1,1,20,639,739,1378,1906
0131-002,2011,1,1,21,515,596,1111,1378
0131-002,2011,1,1,22,455,454,909,1111
0131-002,2011,1,1,23,350,281,631,909
0131-002,2011,1,1,24,224,188,412,631
0131-002,2011,1,2,1,143,91,234,412
0131-002,2011,1,2,2,88,67,155,234
0131-002,2011,1,2,3,65,50,115,155
0131-002,2011,1,2,4,44,37,81,115
0131-002,2011,1,2,5,57,57,114,81
0131-002,2011,1,2,6,88,92,180,114
0131-002,2011,1,2,7,238,183,421,180
0131-002,2011,1,2,8,541,383,924,421
0131-002,2011,1,2,9,621,513,1134,924
0131-002,2011,1,2,10,520,467,987,1134
0131-002,2011,1,2,11,548,440,988,987
0131-002,2011,1,2,12,515,409,924,988
0131-002,2011,1,2,13,467,414,881,924
0131-002,2011,1,2,14,550,485,1035,881
0131-002,2011,1,2,15,583,479,1062,1035
0131-002,2011,1,2,16,556,449,1005,1062
0131-002,2011,1,2,17,587,517,1104,1005
0131-002,2011,1,2,18,630,590,1220,1104
0131-002,2011,1,2,19,634,638,1272,1220
0131-002,2011,1,2,20,473,424,897,1272
0131-002,2011,1,2,21,420,389,809,897
0131-002,2011,1,2,22,433,366,799,809
0131-002,2011,1,2,23,317,213,530,799
0131-002,2011,1,2,24,212,147,359,530
0131-002,2011,1,3,1,129,101,230,359
0131-002,2011,1,3,2,88,69,157,230
0131-002,2011,1,3,3,64,55,119,157
0131-002,2011,1,3,4,52,56,108,119
0131-002,2011,1,3,5,60,69,129,108
0131-002,2011,1,3,6,83,123,206,129
0131-002,2011,1,3,7,255,243,498,206
0131-002,2011,1,3,8,565,462,1027,498
0131-002,2011,1,3,9,640,635,1275,1027
0131-002,2011,1,3,10,537,560,1097,1275
0131-002,2011,1,3,11,577,581,1158,1097
0131-002,2011,1,3,12,554,566,1120,1158
0131-002,2011,1,3,13,479,494,973,1120
0131-002,2011,1,3,14,560,556,1116,973
0131-002,2011,1,3,15,593,610,1203,1116
0131-002,2011,1,3,16,627,639,1266,1203
0131-002,2011,1,3,17,608,677,1285,1266
0131-002,2011,1,3,18,645,734,1379,1285
0131-002,2011,1,3,19,638,726,1364,1379
0131-002,2011,1,3,20,514,580,1094,1364
0131-002,2011,1,3,21,398,425,823,1094
0131-002,2011,1,3,22,388,409,797,823
0131-002,2011,1,3,23,291,234,525,797
0131-002,2011,1,3,24,203,160,363,525
0131-002,2011,1,4,1,170,123,293,363
0131-002,2011,1,4,2,126,108,234,293
0131-002,2011,1,4,3,90,74,164,234
0131-002,2011,1,4,4,69,64,133,164
0131-002,2011,1,4,5,77,79,156,133
0131-002,2011,1,4,6,99,124,223,156
0131-002,2011,1,4,7,220,210,430,223
0131-002,2011,1,4,8,482,409,891,430
0131-002,2011,1,4,9,619,563,1182,891
0131-002,2011,1,4,10,528,541,1069,1182
0131-002,2011,1,4,11,586,586,1172,1069
0131-002,2011,1,4,12,698,735,1433,1172
0131-002,2011,1,4,13,756,913,1669,1433
0131-002,2011,1,4,14,768,969,1737,1669
0131-002,2011,1,4,15,771,846,1617,1737
0131-002,2011,1,4,16,663,737,1400,1617
0131-002,2011,1,4,17,647,723,1370,1400
0131-002,2011,1,4,18,646,581,1227,1370
0131-002,2011,1,4,19,632,767,1399,1227
0131-002,2011,1,4,20,549,587,1136,1399
0131-002,2011,1,4,21,464,451,915,1136
0131-002,2011,1,4,22,394,381,775,915
0131-002,2011,1,4,23,292,226,518,775
0131-002,2011,1,4,24,221,163,384,518
0131-002,2011,1,5,1,247,226,473,384
0131-002,2011,1,5,2,155,151,306,473
0131-002,2011,1,5,3,145,153,298,306
0131-002,2011,1,5,4,102,117,219,298
0131-002,2011,1,5,5,91,83,174,219
0131-002,2011,1,5,6,102,161,263,174
0131-002,2011,1,5,7,203,228,431,263
0131-002,2011,1,5,8,281,423,704,431
0131-002,2011,1,5,9,412,599,1011,704
0131-002,2011,1,5,10,512,675,1187,1011
0131-002,2011,1,5,11,614,858,1472,1187
0131-002,2011,1,5,12,719,1087,1806,1472
0131-002,2011,1,5,13,906,1122,2028,1806
0131-002,2011,1,5,14,930,1040,1970,2028
0131-002,2011,1,5,15,932,1033,1965,1970
0131-002,2011,1,5,16,782,746,1528,1965
0131-002,2011,1,5,17,830,699,1529,1528
0131-002,2011,1,5,18,915,746,1661,1529
0131-002,2011,1,5,19,934,665,1599,1661
0131-002,2011,1,5,20,714,443,1157,1599
0131-002,2011,1,5,21,545,343,888,1157
0131-002,2011,1,5,22,437,322,759,888
0131-002,2011,1,5,23,332,222,554,759
0131-002,2011,1,5,24,216,190,406,554
0131-002,2011,1,6,1,127,111,238,406
0131-002,2011,1,6,2,78,71,149,238
0131-002,2011,1,6,3,52,52,104,149
0131-002,2011,1,6,4,45,49,94,104
0131-002,2011,1,6,5,74,98,172,94
0131-002,2011,1,6,6,117,173,290,172
0131-002,2011,1,6,7,368,316,684,290
0131-002,2011,1,6,8,780,661,1441,684
0131-002,2011,1,6,9,869,843,1712,1441
0131-002,2011,1,6,10,675,802,1477,1712
0131-002,2011,1,6,11,689,688,1377,1477
0131-002,2011,1,6,12,685,708,1393,1377
0131-002,2011,1,6,13,628,594,1222,1393
0131-002,2011,1,6,14,765,876,1641,1222
0131-002,2011,1,6,15,789,811,1600,1641
0131-002,2011,1,6,16,829,886,1715,1600
0131-002,2011,1,6,17,765,802,1567,1715
0131-002,2011,1,6,18,792,928,1720,1567
0131-002,2011,1,6,19,787,897,1684,1720
0131-002,2011,1,6,20,590,669,1259,1684
0131-002,2011,1,6,21,513,593,1106,1259
0131-002,2011,1,6,22,463,518,981,1106
0131-002,2011,1,6,23,294,258,552,981
0131-002,2011,1,6,24,204,184,388,552
0131-002,2011,1,7,1,155,118,273,388
0131-002,2011,1,7,2,115,110,225,273
0131-002,2011,1,7,3,76,67,143,225
0131-002,2011,1,7,4,61,62,123,143
0131-002,2011,1,7,5,65,79,144,123
0131-002,2011,1,7,6,114,170,284,144
0131-002,2011,1,7,7,340,319,659,284
0131-002,2011,1,7,8,823,648,1471,659
0131-002,2011,1,7,9,927,927,1854,1471
0131-002,2011,1,7,10,717,719,1436,1854
0131-002,2011,1,7,11,741,705,1446,1436
0131-002,2011,1,7,12,738,716,1454,1446
0131-002,2011,1,7,13,714,731,1445,1454
0131-002,2011,1,7,14,809,846,1655,1445
0131-002,2011,1,7,15,869,882,1751,1655
0131-002,2011,1,7,16,897,921,1818,1751
0131-002,2011,1,7,17,860,877,1737,1818
0131-002,2011,1,7,18,903,1029,1932,1737
0131-002,2011,1,7,19,848,1023,1871,1932
0131-002,2011,1,7,20,694,742,1436,1871
0131-002,2011,1,7,21,569,648,1217,1436
0131-002,2011,1,7,22,543,597,1140,1217
0131-002,2011,1,7,23,378,303,681,1140
0131-002,2011,1,7,24,274,227,501,681
0131-002,2011,1,8,1,157,128,285,501
0131-002,2011,1,8,2,117,90,207,285
0131-002,2011,1,8,3,74,69,143,207
0131-002,2011,1,8,4,71,90,161,143
0131-002,2011,1,8,5,79,97,176,161
0131-002,2011,1,8,6,103,149,252,176
0131-002,2011,1,8,7,322,322,644,252
0131-002,2011,1,8,8,780,684,1464,644
0131-002,2011,1,8,9,825,827,1652,1464
0131-002,2011,1,8,10,709,788,1497,1652
0131-002,2011,1,8,11,664,712,1376,1497
0131-002,2011,1,8,12,690,701,1391,1376
0131-002,2011,1,8,13,603,631,1234,1391
0131-002,2011,1,8,14,626,738,1364,1234
0131-002,2011,1,8,15,934,1014,1948,1364
0131-002,2011,1,8,16,861,945,1806,1948
0131-002,2011,1,8,17,686,726,1412,1806
0131-002,2011,1,8,18,718,874,1592,1412
0131-002,2011,1,8,19,786,1024,1810,1592
0131-002,2011,1,8,20,544,626,1170,1810
0131-002,2011,1,8,21,469,561,1030,1170
0131-002,2011,1,8,22,409,405,814,1030
0131-002,2011,1,8,23,303,231,534,814
0131-002,2011,1,8,24,204,184,388,534
0131-002,2011,1,9,1,112,79,191,388
0131-002,2011,1,9,2,75,53,128,191
0131-002,2011,1,9,3,48,37,85,128
0131-002,2011,1,9,4,55,49,104,85
0131-002,2011,1,9,5,41,37,78,104
0131-002,2011,1,9,6,77,96,173,78
0131-002,2011,1,9,7,207,154,361,173
0131-002,2011,1,9,8,445,315,760,361
0131-002,2011,1,9,9,521,429,950,760
0131-002,2011,1,9,10,466,431,897,950
0131-002,2011,1,9,11,521,448,969,897
0131-002,2011,1,9,12,548,471,1019,969
0131-002,2011,1,9,13,524,427,951,1019
0131-002,2011,1,9,14,632,545,1177,951
0131-002,2011,1,9,15,647,600,1247,1177
0131-002,2011,1,9,16,668,579,1247,1247
0131-002,2011,1,9,17,626,516,1142,1247
0131-002,2011,1,9,18,691,721,1412,1142
0131-002,2011,1,9,19,701,715,1416,1412
0131-002,2011,1,9,20,546,546,1092,1416
0131-002,2011,1,9,21,450,427,877,1092
0131-002,2011,1,9,22,443,383,826,877
0131-002,2011,1,9,23,313,207,520,826
0131-002,2011,1,9,24,205,147,352,520
0131-002,2011,1,10,1,168,137,305,352
0131-002,2011,1,10,2,126,108,234,305
0131-002,2011,1,10,3,91,85,176,234
0131-002,2011,1,10,4,62,65,127,176
0131-002,2011,1,10,5,74,90,164,127
0131-002,2011,1,10,6,107,139,246,164
0131-002,2011,1,10,7,293,278,571,246
0131-002,2011,1,10,8,644,523,1167,571
0131-002,2011,1,10,9,691,711,1402,1167
0131-002,2011,1,10,10,588,620,1208,1402
0131-002,2011,1,10,11,665,703,1368,1208
0131-002,2011,1,10,12,717,754,1471,1368
0131-002,2011,1,10,13,646,702,1348,1471
0131-002,2011,1,10,14,802,838,1640,1348
0131-002,2011,1,10,15,844,897,1741,1640
0131-002,2011,1,10,16,889,906,1795,1741
0131-002,2011,1,10,17,818,900,1718,1795
0131-002,2011,1,10,18,887,1054,1941,1718
0131-002,2011,1,10,19,872,1053,1925,1941
0131-002,2011,1,10,20,678,795,1473,1925
0131-002,2011,1,10,21,604,691,1295,1473
0131-002,2011,1,10,22,569,624,1193,1295
0131-002,2011,1,10,23,413,345,758,1193
0131-002,2011,1,10,24,310,251,561,758
0131-002,2011,1,11,1,222,154,376,561
0131-002,2011,1,11,2,146,122,268,376
0131-002,2011,1,11,3,131,100,231,268
0131-002,2011,1,11,4,90,73,163,231
0131-002,2011,1,11,5,90,98,188,163
0131-002,2011,1,11,6,141,172,313,188
0131-002,2011,1,11,7,250,242,492,313
0131-002,2011,1,11,8,476,398,874,492
0131-002,2011,1,11,9,587,588,1175,874
0131-002,2011,1,11,10,659,691,1350,1175
0131-002,2011,1,11,11,754,793,1547,1350
0131-002,2011,1,11,12,835,944,1779,1547
0131-002,2011,1,11,13,857,992,1849,1779
0131-002,2011,1,11,14,900,1018,1918,1849
0131-002,2011,1,11,15,892,928,1820,1918
0131-002,2011,1,11,16,898,979,1877,1820
0131-002,2011,1,11,17,901,1012,1913,1877
0131-002,2011,1,11,18,827,887,1714,1913
0131-002,2011,1,11,19,742,789,1531,1714
0131-002,2011,1,11,20,646,736,1382,1531
0131-002,2011,1,11,21,567,472,1039,1382
0131-002,2011,1,11,22,477,404,881,1039
0131-002,2011,1,11,23,336,268,604,881
0131-002,2011,1,11,24,254,187,441,604
0131-002,2011,1,12,1,253,217,470,441
0131-002,2011,1,12,2,174,167,341,470
0131-002,2011,1,12,3,150,150,300,341
0131-002,2011,1,12,4,121,129,250,300
0131-002,2011,1,12,5,99,109,208,250
0131-002,2011,1,12,6,104,159,263,208
0131-002,2011,1,12,7,191,212,403,263
0131-002,2011,1,12,8,297,366,663,403
0131-002,2011,1,12,9,421,589,1010,663
0131-002,2011,1,12,10,385,549,934,1010
0131-002,2011,1,12,11,628,872,1500,934
0131-002,2011,1,12,12,878,1321,2199,1500
0131-002,2011,1,12,13,794,1173,1967,2199
0131-002,2011,1,12,14,899,941,1840,1967
0131-002,2011,1,12,15,950,948,1898,1840
0131-002,2011,1,12,16,868,831,1699,1898
0131-002,2011,1,12,17,878,762,1640,1699
0131-002,2011,1,12,18,953,796,1749,1640
0131-002,2011,1,12,19,916,670,1586,1749
0131-002,2011,1,12,20,779,551,1330,1586
0131-002,2011,1,12,21,622,454,1076,1330
0131-002,2011,1,12,22,464,408,872,1076
0131-002,2011,1,12,23,322,279,601,872
0131-002,2011,1,12,24,200,189,389,601
0131-002,2011,1,13,1,117,94,211,389
0131-002,2011,1,13,2,84,80,164,211
0131-002,2011,1,13,3,57,52,109,164
0131-002,2011,1,13,4,60,57,117,109
0131-002,2011,1,13,5,65,81,146,117
0131-002,2011,1,13,6,135,185,320,146
0131-002,2011,1,13,7,372,317,689,320
0131-002,2011,1,13,8,823,633,1456,689
0131-002,2011,1,13,9,925,915,1840,1456
0131-002,2011,1,13,10,740,864,1604,1840
0131-002,2011,1,13,11,701,687,1388,1604
0131-002,2011,1,13,12,674,681,1355,1388
0131-002,2011,1,13,13,651,676,1327,1355
0131-002,2011,1,13,14,732,735,1467,1327
0131-002,2011,1,13,15,808,825,1633,1467
0131-002,2011,1,13,16,803,772,1575,1633
0131-002,2011,1,13,17,784,811,1595,1575
0131-002,2011,1,13,18,865,1033,1898,1595
0131-002,2011,1,13,19,878,1040,1918,1898
0131-002,2011,1,13,20,661,711,1372,1918
0131-002,2011,1,13,21,587,685,1272,1372
0131-002,2011,1,13,22,509,541,1050,1272
0131-002,2011,1,13,23,357,288,645,1050
0131-002,2011,1,13,24,264,209,473,645
0131-002,2011,1,14,1,171,134,305,473
0131-002,2011,1,14,2,120,106,226,305
0131-002,2011,1,14,3,76,68,144,226
0131-002,2011,1,14,4,63,58,121,144
0131-002,2011,1,14,5,74,84,158,121
0131-002,2011,1,14,6,118,144,262,158
0131-002,2011,1,14,7,338,309,647,262
0131-002,2011,1,14,8,859,726,1585,647
0131-002,2011,1,14,9,931,911,1842,1585
0131-002,2011,1,14,10,768,706,1474,1842
0131-002,2011,1,14,11,783,794,1577,1474
0131-002,2011,1,14,12,784,724,1508,1577
0131-002,2011,1,14,13,710,756,1466,1508
0131-002,2011,1,14,14,843,904,1747,1466
0131-002,2011,1,14,15,869,861,1730,1747
0131-002,2011,1,14,16,932,862,1794,1730
0131-002,2011,1,14,17,829,863,1692,1794
0131-002,2011,1,14,18,871,967,1838,1692
0131-002,2011,1,14,19,907,1090,1997,1838
0131-002,2011,1,14,20,646,749,1395,1997
0131-002,2011,1,14,21,627,799,1426,1395
0131-002,2011,1,14,22,530,511,1041,1426
0131-002,2011,1,14,23,380,324,704,1041
0131-002,2011,1,14,24,251,198,449,704
0131-002,2011,1,15,1,192,158,350,449
0131-002,2011,1,15,2,129,97,226,350
0131-002,2011,1,15,3,78,70,148,226
0131-002,2011,1,15,4,72,76,148,148
0131-002,2011,1,15,5,72,85,157,148
0131-002,2011,1,15,6,124,154,278,157
0131-002,2011,1,15,7,303,301,604,278
0131-002,2011,1,15,8,825,653,1478,604
0131-002,2011,1,15,9,964,1006,1970,1478
0131-002,2011,1,15,10,674,720,1394,1970
0131-002,2011,1,15,11,688,704,1392,1394
0131-002,2011,1,15,12,696,676,1372,1392
0131-002,2011,1,15,13,746,740,1486,1372
0131-002,2011,1,15,14,818,852,1670,1486
0131-002,2011,1,15,15,775,800,1575,1670
0131-002,2011,1,15,16,898,921,1819,1575
0131-002,2011,1,15,17,892,933,1825,1819
0131-002,2011,1,15,18,962,1080,2042,1825
0131-002,2011,1,15,19,887,1113,2000,2042
0131-002,2011,1,15,20,733,852,1585,2000
0131-002,2011,1,15,21,561,630,1191,1585
0131-002,2011,1,15,22,501,503,1004,1191
0131-002,2011,1,15,23,397,330,727,1004
0131-002,2011,1,15,24,243,192,435,727
0131-002,2011,1,16,1,135,96,231,435
0131-002,2011,1,16,2,96,67,163,231
0131-002,2011,1,16,3,60,48,108,163
0131-002,2011,1,16,4,55,52,107,108
0131-002,2011,1,16,5,53,50,103,107
0131-002,2011,1,16,6,80,92,172,103
0131-002,2011,1,16,7,211,166,377,172
0131-002,2011,1,16,8,591,415,1006,377
0131-002,2011,1,16,9,612,556,1168,1006
0131-002,2011,1,16,10,468,407,875,1168
0131-002,2011,1,16,11,519,467,986,875
0131-002,2011,1,16,12,471,409,880,986
0131-002,2011,1,16,13,519,469,988,880
0131-002,2011,1,16,14,649,609,1258,988
0131-002,2011,1,16,15,662,597,1259,1258
0131-002,2011,1,16,16,637,574,1211,1259
0131-002,2011,1,16,17,652,613,1265,1211
0131-002,2011,1,16,18,722,701,1423,1265
0131-002,2011,1,16,19,690,773,1463,1423
0131-002,2011,1,16,20,514,537,1051,1463
0131-002,2011,1,16,21,457,467,924,1051
0131-002,2011,1,16,22,389,342,731,924
0131-002,2011,1,16,23,304,202,506,731
0131-002,2011,1,16,24,228,167,395,506
0131-002,2011,1,17,1,194,154,348,395
0131-002,2011,1,17,2,134,118,252,348
0131-002,2011,1,17,3,100,94,194,252
0131-002,2011,1,17,4,72,68,140,194
0131-002,2011,1,17,5,79,98,177,140
0131-002,2011,1,17,6,124,135,259,177
0131-002,2011,1,17,7,327,289,616,259
0131-002,2011,1,17,8,819,618,1437,616
0131-002,2011,1,17,9,671,682,1353,1437
0131-002,2011,1,17,10,721,769,1490,1353
0131-002,2011,1,17,11,573,596,1169,1490
0131-002,2011,1,17,12,637,646,1283,1169
0131-002,2011,1,17,13,634,680,1314,1283
0131-002,2011,1,17,14,753,777,1530,1314
0131-002,2011,1,17,15,860,881,1741,1530
0131-002,2011,1,17,16,902,860,1762,1741
0131-002,2011,1,17,17,860,874,1734,1762
0131-002,2011,1,17,18,945,1090,2035,1734
0131-002,2011,1,17,19,937,1114,2051,2035
0131-002,2011,1,17,20,787,898,1685,2051
0131-002,2011,1,17,21,654,756,1410,1685
0131-002,2011,1,17,22,606,649,1255,1410
0131-002,2011,1,17,23,474,384,858,1255
0131-002,2011,1,17,24,353,274,627,858
0131-002,2011,1,18,1,228,182,410,627
0131-002,2011,1,18,2,193,152,345,410
0131-002,2011,1,18,3,111,81,192,345
0131-002,2011,1,18,4,96,96,192,192
0131-002,2011,1,18,5,98,94,192,192
0131-002,2011,1,18,6,123,149,272,192
0131-002,2011,1,18,7,243,220,463,272
0131-002,2011,1,18,8,544,442,986,463
0131-002,2011,1,18,9,748,701,1449,986
0131-002,2011,1,18,10,650,650,1300,1449
0131-002,2011,1,18,11,740,814,1554,1300
0131-002,2011,1,18,12,815,854,1669,1554
0131-002,2011,1,18,13,841,1013,1854,1669
0131-002,2011,1,18,14,890,1037,1927,1854
0131-002,2011,1,18,15,963,1035,1998,1927
0131-002,2011,1,18,16,922,1035,1957,1998
0131-002,2011,1,18,17,966,1060,2026,1957
0131-002,2011,1,18,18,879,975,1854,2026
0131-002,2011,1,18,19,804,920,1724,1854
0131-002,2011,1,18,20,654,645,1299,1724
0131-002,2011,1,18,21,545,540,1085,1299
0131-002,2011,1,18,22,484,427,911,1085
0131-002,2011,1,18,23,359,284,643,911
0131-002,2011,1,18,24,254,180,434,643
0131-002,2011,1,19,1,281,255,536,434
0131-002,2011,1,19,2,204,191,395,536
0131-002,2011,1,19,3,142,112,254,395
0131-002,2011,1,19,4,128,129,257,254
0131-002,2011,1,19,5,103,112,215,257
0131-002,2011,1,19,6,115,166,281,215
0131-002,2011,1,19,7,198,191,389,281
0131-002,2011,1,19,8,295,302,597,389
0131-002,2011,1,19,9,481,642,1123,597
0131-002,2011,1,19,10,484,596,1080,1123
0131-002,2011,1,19,11,623,769,1392,1080
0131-002,2011,1,19,12,656,952,1608,1392
0131-002,2011,1,19,13,775,915,1690,1608
0131-002,2011,1,19,14,871,955,1826,1690
0131-002,2011,1,19,15,905,978,1883,1826
0131-002,2011,1,19,16,989,1006,1995,1883
0131-002,2011,1,19,17,982,885,1867,1995
0131-002,2011,1,19,18,984,782,1766,1867
0131-002,2011,1,19,19,859,605,1464,1766
0131-002,2011,1,19,20,616,475,1091,1464
0131-002,2011,1,19,21,579,459,1038,1091
0131-002,2011,1,19,22,468,394,862,1038
0131-002,2011,1,19,23,376,295,671,862
0131-002,2011,1,19,24,242,228,470,671
0131-002,2011,1,20,1,139,110,249,470
0131-002,2011,1,20,2,90,79,169,249
0131-002,2011,1,20,3,56,56,112,169
0131-002,2011,1,20,4,58,55,113,112
0131-002,2011,1,20,5,65,72,137,113
0131-002,2011,1,20,6,117,137,254,137
0131-002,2011,1,20,7,351,322,673,254
0131-002,2011,1,20,8,822,642,1464,673
0131-002,2011,1,20,9,875,834,1709,1464
0131-002,2011,1,20,10,706,725,1431,1709
0131-002,2011,1,20,11,744,802,1546,1431
0131-002,2011,1,20,12,769,761,1530,1546
0131-002,2011,1,20,13,740,741,1481,1530
0131-002,2011,1,20,14,813,839,1652,1481
0131-002,2011,1,20,15,851,855,1706,1652
0131-002,2011,1,20,16,885,867,1752,1706
0131-002,2011,1,20,17,872,906,1778,1752
0131-002,2011,1,20,18,872,988,1860,1778
0131-002,2011,1,20,19,825,920,1745,1860
0131-002,2011,1,20,20,667,748,1415,1745
0131-002,2011,1,20,21,579,739,1318,1415
0131-002,2011,1,20,22,493,490,983,1318
0131-002,2011,1,20,23,371,316,687,983
0131-002,2011,1,20,24,254,220,474,687
0131-002,2011,1,21,1,189,147,336,474
0131-002,2011,1,21,2,146,118,264,336
0131-002,2011,1,21,3,100,76,176,264
0131-002,2011,1,21,4,89,83,172,176
0131-002,2011,1,21,5,84,107,191,172
0131-002,2011,1,21,6,112,121,233,191
0131-002,2011,1,21,7,344,330,674,233
0131-002,2011,1,21,8,878,700,1578,674
0131-002,2011,1,21,9,901,832,1733,1578
0131-002,2011,1,21,10,783,794,1577,1733
0131-002,2011,1,21,11,789,807,1596,1577
0131-002,2011,1,21,12,729,670,1399,1596
0131-002,2011,1,21,13,673,687,1360,1399
0131-002,2011,1,21,14,779,798,1577,1360
0131-002,2011,1,21,15,879,841,1720,1577
0131-002,2011,1,21,16,814,790,1604,1720
0131-002,2011,1,21,17,835,844,1679,1604
0131-002,2011,1,21,18,894,1002,1896,1679
0131-002,2011,1,21,19,863,1064,1927,1896
0131-002,2011,1,21,20,690,746,1436,1927
0131-002,2011,1,21,21,598,661,1259,1436
0131-002,2011,1,21,22,522,549,1071,1259
0131-002,2011,1,21,23,390,290,680,1071
0131-002,2011,1,21,24,279,255,534,680
0131-002,2011,1,22,1,191,160,351,534
0131-002,2011,1,22,2,124,115,239,351
0131-002,2011,1,22,3,90,79,169,239
0131-002,2011,1,22,4,80,74,154,169
0131-002,2011,1,22,5,76,86,162,154
0131-002,2011,1,22,6,117,131,248,162
0131-002,2011,1,22,7,342,320,662,248
0131-002,2011,1,22,8,802,671,1473,662
0131-002,2011,1,22,9,902,936,1838,1473
0131-002,2011,1,22,10,753,780,1533,1838
0131-002,2011,1,22,11,796,852,1648,1533
0131-002,2011,1,22,12,778,868,1646,1648
0131-002,2011,1,22,13,711,752,1463,1646
0131-002,2011,1,22,14,784,878,1662,1463
0131-002,2011,1,22,15,851,926,1777,1662
0131-002,2011,1,22,16,870,934,1804,1777
0131-002,2011,1,22,17,816,935,1751,1804
0131-002,2011,1,22,18,904,958,1862,1751
0131-002,2011,1,22,19,935,1055,1990,1862
0131-002,2011,1,22,20,689,672,1361,1990
0131-002,2011,1,22,21,584,559,1143,1361
0131-002,2011,1,22,22,568,426,994,1143
0131-002,2011,1,22,23,455,346,801,994
0131-002,2011,1,22,24,302,231,533,801
0131-002,2011,1,23,1,174,118,292,533
0131-002,2011,1,23,2,117,89,206,292
0131-002,2011,1,23,3,73,54,127,206
0131-002,2011,1,23,4,68,58,126,127
0131-002,2011,1,23,5,67,66,133,126
0131-002,2011,1,23,6,86,88,174,133
0131-002,2011,1,23,7,262,204,466,174
0131-002,2011,1,23,8,638,434,1072,466
0131-002,2011,1,23,9,687,589,1276,1072
0131-002,2011,1,23,10,573,529,1102,1276
0131-002,2011,1,23,11,615,557,1172,1102
0131-002,2011,1,23,12,587,530,1117,1172
0131-002,2011,1,23,13,522,459,981,1117
0131-002,2011,1,23,14,618,579,1197,981
0131-002,2011,1,23,15,676,620,1296,1197
0131-002,2011,1,23,16,682,616,1298,1296
0131-002,2011,1,23,17,636,595,1231,1298
0131-002,2011,1,23,18,684,654,1338,1231
0131-002,2011,1,23,19,691,709,1400,1338
0131-002,2011,1,23,20,530,506,1036,1400
0131-002,2011,1,23,21,464,412,876,1036
0131-002,2011,1,23,22,453,373,826,876
0131-002,2011,1,23,23,337,234,571,826
0131-002,2011,1,23,24,260,181,441,571
0131-002,2011,1,24,1,194,141,335,441
0131-002,2011,1,24,2,147,120,267,335
0131-002,2011,1,24,3,90,74,164,267
0131-002,2011,1,24,4,81,84,165,164
0131-002,2011,1,24,5,81,92,173,165
0131-002,2011,1,24,6,122,150,272,173
0131-002,2011,1,24,7,280,245,525,272
0131-002,2011,1,24,8,751,562,1313,525
0131-002,2011,1,24,9,815,772,1587,1313
0131-002,2011,1,24,10,656,709,1365,1587
0131-002,2011,1,24,11,719,728,1447,1365
0131-002,2011,1,24,12,693,674,1367,1447
0131-002,2011,1,24,13,596,575,1171,1367
0131-002,2011,1,24,14,758,785,1543,1171
0131-002,2011,1,24,15,793,810,1603,1543
0131-002,2011,1,24,16,812,793,1605,1603
0131-002,2011,1,24,17,799,802,1601,1605
0131-002,2011,1,24,18,886,1005,1891,1601
0131-002,2011,1,24,19,829,1028,1857,1891
0131-002,2011,1,24,20,847,1006,1853,1857
0131-002,2011,1,24,21,695,738,1433,1853
0131-002,2011,1,24,22,536,496,1032,1433
0131-002,2011,1,24,23,436,344,780,1032
0131-002,2011,1,24,24,308,227,535,780
0131-002,2011,1,25,1,358,270,628,535
0131-002,2011,1,25,2,230,183,413,628
0131-002,2011,1,25,3,186,131,317,413
0131-002,2011,1,25,4,161,135,296,317
0131-002,2011,1,25,5,117,128,245,296
0131-002,2011,1,25,6,164,179,343,245
0131-002,2011,1,25,7,292,249,541,343
0131-002,2011,1,25,8,444,368,812,541
0131-002,2011,1,25,9,543,527,1070,812
0131-002,2011,1,25,10,649,602,1251,1070
0131-002,2011,1,25,11,839,856,1695,1251
0131-002,2011,1,25,12,848,871,1719,1695
0131-002,2011,1,25,13,940,1076,2016,1719
0131-002,2011,1,25,14,1083,1242,2325,2016
0131-002,2011,1,25,15,1086,1261,2347,2325
0131-002,2011,1,25,16,1098,1196,2294,2347
0131-002,2011,1,25,17,1032,1166,2198,2294
0131-002,2011,1,25,18,913,955,1868,2198
0131-002,2011,1,25,19,411,492,903,1868
0131-002,2011,1,25,20,422,413,835,903
0131-002,2011,1,25,21,426,346,772,835
0131-002,2011,1,25,22,381,346,727,772
0131-002,2011,1,25,23,269,190,459,727
0131-002,2011,1,25,24,228,154,382,459
0131-002,2011,1,26,1,172,141,313,382
0131-002,2011,1,26,2,119,108,227,313
0131-002,2011,1,26,3,92,91,183,227
0131-002,2011,1,26,4,76,67,143,183
0131-002,2011,1,26,5,58,57,115,143
0131-002,2011,1,26,6,91,119,210,115
0131-002,2011,1,26,7,158,167,325,210
0131-002,2011,1,26,8,231,253,484,325
0131-002,2011,1,26,9,336,405,741,484
0131-002,2011,1,26,10,468,609,1077,741
0131-002,2011,1,26,11,551,666,1217,1077
0131-002,2011,1,26,12,679,814,1493,1217
0131-002,2011,1,26,13,930,1252,2182,1493
0131-002,2011,1,26,14,994,1157,2151,2182
0131-002,2011,1,26,15,1356,1276,2632,2151
0131-002,2011,1,26,16,1345,1236,2581,2632
0131-002,2011,1,26,17,1356,1101,2457,2581
0131-002,2011,1,26,18,1394,1053,2447,2457
0131-002,2011,1,26,19,790,626,1416,2447
0131-002,2011,1,26,20,688,589,1277,1416
0131-002,2011,1,26,21,561,473,1034,1277
0131-002,2011,1,26,22,475,369,844,1034
0131-002,2011,1,26,23,319,260,579,844
0131-002,2011,1,26,24,241,221,462,579
0131-002,2011,1,27,1,97,62,159,462
0131-002,2011,1,27,2,64,47,111,159
0131-002,2011,1,27,3,42,41,83,111
0131-002,2011,1,27,4,46,39,85,83
0131-002,2011,1,27,5,52,67,119,85
0131-002,2011,1,27,6,96,108,204,119
0131-002,2011,1,27,7,310,244,554,204
0131-002,2011,1,27,8,692,482,1174,554
0131-002,2011,1,27,9,813,771,1584,1174
0131-002,2011,1,27,10,774,810,1584,1584
0131-002,2011,1,27,11,739,707,1446,1584
0131-002,2011,1,27,12,748,707,1455,1446
0131-002,2011,1,27,13,729,746,1475,1455
0131-002,2011,1,27,14,865,864,1729,1475
0131-002,2011,1,27,15,968,909,1877,1729
0131-002,2011,1,27,16,968,953,1921,1877
0131-002,2011,1,27,17,948,887,1835,1921
0131-002,2011,1,27,18,947,996,1943,1835
0131-002,2011,1,27,19,980,1085,2065,1943
0131-002,2011,1,27,20,738,861,1599,2065
0131-002,2011,1,27,21,609,643,1252,1599
0131-002,2011,1,27,22,558,549,1107,1252
0131-002,2011,1,27,23,391,279,670,1107
0131-002,2011,1,27,24,286,204,490,670
0131-002,2011,1,28,1,231,171,402,490
0131-002,2011,1,28,2,144,108,252,402
0131-002,2011,1,28,3,107,84,191,252
0131-002,2011,1,28,4,72,65,137,191
0131-002,2011,1,28,5,96,96,192,137
0131-002,2011,1,28,6,133,143,276,192
0131-002,2011,1,28,7,386,360,746,276
0131-002,2011,1,28,8,979,892,1871,746
0131-002,2011,1,28,9,1041,1162,2203,1871
0131-002,2011,1,28,10,933,884,1817,2203
0131-002,2011,1,28,11,1038,1160,2198,1817
0131-002,2011,1,28,12,866,934,1800,2198
0131-002,2011,1,28,13,716,922,1638,1800
0131-002,2011,1,28,14,939,1016,1955,1638
0131-002,2011,1,28,15,1034,1118,2152,1955
0131-002,2011,1,28,16,1022,998,2020,2152
0131-002,2011,1,28,17,900,835,1735,2020
0131-002,2011,1,28,18,873,817,1690,1735
0131-002,2011,1,28,19,589,545,1134,1690
0131-002,2011,1,28,20,682,565,1247,1134
0131-002,2011,1,28,21,607,500,1107,1247
0131-002,2011,1,28,22,558,429,987,1107
0131-002,2011,1,28,23,362,244,606,987
0131-002,2011,1,28,24,232,186,418,606
0131-002,2011,1,29,1,137,108,245,418
0131-002,2011,1,29,2,112,92,204,245
0131-002,2011,1,29,3,93,92,185,204
0131-002,2011,1,29,4,77,79,156,185
0131-002,2011,1,29,5,73,68,141,156
0131-002,2011,1,29,6,89,112,201,141
0131-002,2011,1,29,7,258,218,476,201
0131-002,2011,1,29,8,511,399,910,476
0131-002,2011,1,29,9,634,608,1242,910
0131-002,2011,1,29,10,682,737,1419,1242
0131-002,2011,1,29,11,878,848,1726,1419
0131-002,2011,1,29,12,753,718,1471,1726
0131-002,2011,1,29,13,726,696,1422,1471
0131-002,2011,1,29,14,843,895,1738,1422
0131-002,2011,1,29,15,888,844,1732,1738
0131-002,2011,1,29,16,962,936,1898,1732
0131-002,2011,1,29,17,962,915,1877,1898
0131-002,2011,1,29,18,942,1004,1946,1877
0131-002,2011,1,29,19,921,1218,2139,1946
0131-002,2011,1,29,20,724,816,1540,2139
0131-002,2011,1,29,21,583,691,1274,1540
0131-002,2011,1,29,22,547,528,1075,1274
0131-002,2011,1,29,23,438,381,819,1075
0131-002,2011,1,29,24,309,245,554,819
0131-002,2011,1,30,1,156,109,265,554
0131-002,2011,1,30,2,110,84,194,265
0131-002,2011,1,30,3,84,79,163,194
0131-002,2011,1,30,4,79,47,126,163
0131-002,2011,1,30,5,57,52,109,126
0131-002,2011,1,30,6,91,86,177,109
0131-002,2011,1,30,7,230,124,354,177
0131-002,2011,1,30,8,563,290,853,354
0131-002,2011,1,30,9,573,427,1000,853
0131-002,2011,1,30,10,533,495,1028,1000
0131-002,2011,1,30,11,576,485,1061,1028
0131-002,2011,1,30,12,546,451,997,1061
0131-002,2011,1,30,13,536,465,1001,997
0131-002,2011,1,30,14,643,571,1214,1001
0131-002,2011,1,30,15,719,687,1406,1214
0131-002,2011,1,30,16,730,666,1396,1406
0131-002,2011,1,30,17,712,690,1402,1396
0131-002,2011,1,30,18,743,803,1546,1402
0131-002,2011,1,30,19,744,933,1677,1546
0131-002,2011,1,30,20,532,580,1112,1677
0131-002,2011,1,30,21,444,386,830,1112
0131-002,2011,1,30,22,386,306,692,830
0131-002,2011,1,30,23,347,278,625,692
0131-002,2011,1,30,24,256,196,452,625
0131-002,2011,1,31,1,206,144,350,452
0131-002,2011,1,31,2,176,138,314,350
0131-002,2011,1,31,3,113,89,202,314
0131-002,2011,1,31,4,111,111,222,202
0131-002,2011,1,31,5,95,104,199,222
0131-002,2011,1,31,6,138,163,301,199
0131-002,2011,1,31,7,274,230,504,301
0131-002,2011,1,31,8,820,589,1409,504
0131-002,2011,1,31,9,888,808,1696,1409
0131-002,2011,1,31,10,711,737,1448,1696
0131-002,2011,1,31,11,823,799,1622,1448
0131-002,2011,1,31,12,835,780,1615,1622
0131-002,2011,1,31,13,655,606,1261,1615
0131-002,2011,1,31,14,744,739,1483,1261
0131-002,2011,1,31,15,854,837,1691,1483
0131-002,2011,1,31,16,922,864,1786,1691
0131-002,2011,1,31,17,926,892,1818,1786
0131-002,2011,1,31,18,950,1021,1971,1818
0131-002,2011,1,31,19,793,955,1748,1971
0131-002,2011,1,31,20,688,784,1472,1748
0131-002,2011,1,31,21,518,529,1047,1472
0131-002,2011,1,31,22,485,430,915,1047
0131-002,2011,1,31,23,413,312,725,915
0131-002,2011,1,31,24,270,191,461,725
0131-002,2011,2,1,1,20,22,42,461
0131-002,2011,2,1,2,14,13,27,42
0131-002,2011,2,1,3,11,12,23,27
0131-002,2011,2,1,4,10,5,15,23
0131-002,2011,2,1,5,7,12,19,15
0131-002,2011,2,1,6,18,22,40,19
0131-002,2011,2,1,7,55,25,80,40
0131-002,2011,2,1,8,216,165,381,80
0131-002,2011,2,1,9,159,187,346,381
0131-002,2011,2,1,10,127,141,268,346
0131-002,2011,2,1,11,131,155,286,268
0131-002,2011,2,1,12,124,172,296,286
0131-002,2011,2,1,13,115,255,370,296
0131-002,2011,2,1,14,125,332,457,370
0131-002,2011,2,1,15,168,376,544,457
0131-002,2011,2,1,16,144,404,548,544
0131-002,2011,2,1,17,172,432,604,548
0131-002,2011,2,1,18,181,490,671,604
0131-002,2011,2,1,19,160,471,631,671
0131-002,2011,2,1,20,122,398,520,631
0131-002,2011,2,1,21,77,388,465,520
0131-002,2011,2,1,22,74,292,366,465
0131-002,2011,2,1,23,57,377,434,366
0131-002,2011,2,1,24,22,289,311,434
0131-002,2011,2,2,1,31,366,397,311
0131-002,2011,2,2,2,17,315,332,397
0131-002,2011,2,2,3,13,319,332,332
0131-002,2011,2,2,4,9,210,219,332
0131-002,2011,2,2,5,12,266,278,219
0131-002,2011,2,2,6,16,335,351,278
0131-002,2011,2,2,7,25,385,410,351
0131-002,2011,2,2,8,28,448,476,410
0131-002,2011,2,2,9,65,456,521,476
0131-002,2011,2,2,10,71,499,570,521
0131-002,2011,2,2,11,108,458,566,570
0131-002,2011,2,2,12,126,404,530,566
0131-002,2011,2,2,13,111,451,562,530
0131-002,2011,2,2,14,142,459,601,562
0131-002,2011,2,2,15,154,474,628,601
0131-002,2011,2,2,16,157,487,644,628
0131-002,2011,2,2,17,134,415,549,644
0131-002,2011,2,2,18,85,386,471,549
0131-002,2011,2,2,19,63,229,292,471
0131-002,2011,2,2,20,49,114,163,292
0131-002,2011,2,2,21,34,74,108,163
0131-002,2011,2,2,22,33,49,82,108
0131-002,2011,2,2,23,34,26,60,82
0131-002,2011,2,2,24,15,16,31,60
0131-002,2011,2,3,1,13,13,26,31
0131-002,2011,2,3,2,5,10,15,26
0131-002,2011,2,3,3,6,3,9,15
0131-002,2011,2,3,4,3,2,5,9
0131-002,2011,2,3,5,5,3,8,5
0131-002,2011,2,3,6,4,10,14,8
0131-002,2011,2,3,7,26,26,52,14
0131-002,2011,2,3,8,42,52,94,52
0131-002,2011,2,3,9,64,57,121,94
0131-002,2011,2,3,10,31,77,108,121
0131-002,2011,2,3,11,102,106,208,108
0131-002,2011,2,3,12,237,219,456,208
0131-002,2011,2,3,13,318,378,696,456
0131-002,2011,2,3,14,343,341,684,696
0131-002,2011,2,3,15,341,404,745,684
0131-002,2011,2,3,16,459,507,966,745
0131-002,2011,2,3,17,399,550,949,966
0131-002,2011,2,3,18,412,526,938,949
0131-002,2011,2,3,19,397,441,838,938
0131-002,2011,2,3,20,400,448,848,838
0131-002,2011,2,3,21,333,389,722,848
0131-002,2011,2,3,22,234,276,510,722
0131-002,2011,2,3,23,152,155,307,510
0131-002,2011,2,3,24,62,44,106,307
0131-002,2011,2,4,1,53,20,73,106
0131-002,2011,2,4,2,23,12,35,73
0131-002,2011,2,4,3,15,6,21,35
0131-002,2011,2,4,4,10,4,14,21
0131-002,2011,2,4,5,6,2,8,14
0131-002,2011,2,4,6,7,7,14,8
0131-002,2011,2,4,7,9,11,20,14
0131-002,2011,2,4,8,17,14,31,20
0131-002,2011,2,4,9,36,33,69,31
0131-002,2011,2,4,10,56,45,101,69
0131-002,2011,2,4,11,138,70,208,101
0131-002,2011,2,4,12,239,89,328,208
0131-002,2011,2,4,13,298,103,401,328
0131-002,2011,2,4,14,345,128,473,401
0131-002,2011,2,4,15,328,161,489,473
0131-002,2011,2,4,16,436,136,572,489
0131-002,2011,2,4,17,437,151,588,572
0131-002,2011,2,4,18,446,143,589,588
0131-002,2011,2,4,19,438,101,539,589
0131-002,2011,2,4,20,391,72,463,539
0131-002,2011,2,4,21,420,63,483,463
0131-002,2011,2,4,22,206,50,256,483
0131-002,2011,2,4,23,225,42,267,256
0131-002,2011,2,4,24,214,17,231,267
0131-002,2011,2,5,1,367,16,383,231
0131-002,2011,2,5,2,159,15,174,383
0131-002,2011,2,5,3,73,3,76,174
0131-002,2011,2,5,4,15,5,20,76
0131-002,2011,2,5,5,9,8,17,20
0131-002,2011,2,5,6,10,7,17,17
0131-002,2011,2,5,7,20,17,37,17
0131-002,2011,2,5,8,42,54,96,37
0131-002,2011,2,5,9,77,66,143,96
0131-002,2011,2,5,10,152,79,231,143
0131-002,2011,2,5,11,210,97,307,231
0131-002,2011,2,5,12,318,88,406,307
0131-002,2011,2,5,13,322,91,413,406
0131-002,2011,2,5,14,375,105,480,413
0131-002,2011,2,5,15,418,113,531,480
0131-002,2011,2,5,16,462,111,573,531
0131-002,2011,2,5,17,421,116,537,573
0131-002,2011,2,5,18,406,112,518,537
0131-002,2011,2,5,19,353,110,463,518
0131-002,2011,2,5,20,360,69,429,463
0131-002,2011,2,5,21,390,68,458,429
0131-002,2011,2,5,22,385,51,436,458
0131-002,2011,2,5,23,316,40,356,436
0131-002,2011,2,5,24,179,36,215,356
0131-002,2011,2,6,1,63,19,82,215
0131-002,2011,2,6,2,19,11,30,82
0131-002,2011,2,6,3,12,15,27,30
0131-002,2011,2,6,4,14,10,24,27
0131-002,2011,2,6,5,7,8,15,24
0131-002,2011,2,6,6,10,9,19,15
0131-002,2011,2,6,7,8,15,23,19
0131-002,2011,2,6,8,28,39,67,23
0131-002,2011,2,6,9,46,62,108,67
0131-002,2011,2,6,10,60,57,117,108
0131-002,2011,2,6,11,74,66,140,117
0131-002,2011,2,6,12,62,62,124,140
0131-002,2011,2,6,13,145,88,233,124
0131-002,2011,2,6,14,148,108,256,233
0131-002,2011,2,6,15,177,120,297,256
0131-002,2011,2,6,16,195,120,315,297
0131-002,2011,2,6,17,199,137,336,315
0131-002,2011,2,6,18,174,117,291,336
0131-002,2011,2,6,19,95,78,173,291
0131-002,2011,2,6,20,84,53,137,173
0131-002,2011,2,6,21,61,49,110,137
0131-002,2011,2,6,22,62,53,115,110
0131-002,2011,2,6,23,34,35,69,115
0131-002,2011,2,6,24,21,19,40,69
0131-002,2011,2,7,1,14,15,29,40
0131-002,2011,2,7,2,10,15,25,29
0131-002,2011,2,7,3,6,6,12,25
0131-002,2011,2,7,4,3,7,10,12
0131-002,2011,2,7,5,5,12,17,10
0131-002,2011,2,7,6,16,18,34,17
0131-002,2011,2,7,7,69,39,108,34
0131-002,2011,2,7,8,275,252,527,108
0131-002,2011,2,7,9,212,222,434,527
0131-002,2011,2,7,10,138,174,312,434
0131-002,2011,2,7,11,118,188,306,312
0131-002,2011,2,7,12,127,180,307,306
0131-002,2011,2,7,13,108,159,267,307
0131-002,2011,2,7,14,138,165,303,267
0131-002,2011,2,7,15,161,158,319,303
0131-002,2011,2,7,16,155,150,305,319
0131-002,2011,2,7,17,178,166,344,305
0131-002,2011,2,7,18,188,211,399,344
0131-002,2011,2,7,19,202,238,440,399
0131-002,2011,2,7,20,156,137,293,440
0131-002,2011,2,7,21,116,110,226,293
0131-002,2011,2,7,22,93,110,203,226
0131-002,2011,2,7,23,67,65,132,203
0131-002,2011,2,7,24,33,37,70,132
0131-002,2011,2,8,1,24,29,53,70
0131-002,2011,2,8,2,16,16,32,53
0131-002,2011,2,8,3,3,9,12,32
0131-002,2011,2,8,4,8,8,16,12
0131-002,2011,2,8,5,6,13,19,16
0131-002,2011,2,8,6,22,15,37,19
0131-002,2011,2,8,7,82,45,127,37
0131-002,2011,2,8,8,267,217,484,127
0131-002,2011,2,8,9,267,223,490,484
0131-002,2011,2,8,10,158,175,333,490
0131-002,2011,2,8,11,145,174,319,333
0131-002,2011,2,8,12,150,137,287,319
0131-002,2011,2,8,13,117,114,231,287
0131-002,2011,2,8,14,138,136,274,231
0131-002,2011,2,8,15,174,164,338,274
0131-002,2011,2,8,16,163,181,344,338
0131-002,2011,2,8,17,163,187,350,344
0131-002,2011,2,8,18,193,226,419,350
0131-002,2011,2,8,19,217,238,455,419
0131-002,2011,2,8,20,146,153,299,455
0131-002,2011,2,8,21,113,126,239,299
0131-002,2011,2,8,22,104,109,213,239
0131-002,2011,2,8,23,74,70,144,213
0131-002,2011,2,8,24,51,47,98,144
0131-002,2011,2,9,1,25,29,54,98
0131-002,2011,2,9,2,19,17,36,54
0131-002,2011,2,9,3,8,11,19,36
0131-002,2011,2,9,4,15,8,23,19
0131-002,2011,2,9,5,11,18,29,23
0131-002,2011,2,9,6,20,19,39,29
0131-002,2011,2,9,7,86,62,148,39
0131-002,2011,2,9,8,320,230,550,148
0131-002,2011,2,9,9,252,282,534,550
0131-002,2011,2,9,10,160,157,317,534
0131-002,2011,2,9,11,160,160,320,317
0131-002,2011,2,9,12,156,155,311,320
0131-002,2011,2,9,13,124,119,243,311
0131-002,2011,2,9,14,160,167,327,243
0131-002,2011,2,9,15,159,170,329,327
0131-002,2011,2,9,16,195,183,378,329
0131-002,2011,2,9,17,182,184,366,378
0131-002,2011,2,9,18,205,236,441,366
0131-002,2011,2,9,19,233,236,469,441
0131-002,2011,2,9,20,122,176,298,469
0131-002,2011,2,9,21,116,130,246,298
0131-002,2011,2,9,22,77,119,196,246
0131-002,2011,2,9,23,66,76,142,196
0131-002,2011,2,9,24,52,56,108,142
0131-002,2011,2,10,1,31,37,68,108
0131-002,2011,2,10,2,10,16,26,68
0131-002,2011,2,10,3,14,6,20,26
0131-002,2011,2,10,4,11,14,25,20
0131-002,2011,2,10,5,10,15,25,25
0131-002,2011,2,10,6,25,17,42,25
0131-002,2011,2,10,7,76,50,126,42
0131-002,2011,2,10,8,314,224,538,126
0131-002,2011,2,10,9,255,299,554,538
0131-002,2011,2,10,10,191,179,370,554
0131-002,2011,2,10,11,168,156,324,370
0131-002,2011,2,10,12,147,186,333,324
0131-002,2011,2,10,13,141,143,284,333
0131-002,2011,2,10,14,164,200,364,284
0131-002,2011,2,10,15,182,198,380,364
0131-002,2011,2,10,16,200,193,393,380
0131-002,2011,2,10,17,155,182,337,393
0131-002,2011,2,10,18,212,206,418,337
0131-002,2011,2,10,19,239,244,483,418
0131-002,2011,2,10,20,151,180,331,483
0131-002,2011,2,10,21,114,128,242,331
0131-002,2011,2,10,22,112,123,235,242
0131-002,2011,2,10,23,75,70,145,235
0131-002,2011,2,10,24,40,43,83,145
0131-002,2011,2,11,1,39,33,72,83
0131-002,2011,2,11,2,18,25,43,72
0131-002,2011,2,11,3,15,9,24,43
0131-002,2011,2,11,4,6,15,21,24
0131-002,2011,2,11,5,14,22,36,21
0131-002,2011,2,11,6,28,15,43,36
0131-002,2011,2,11,7,79,56,135,43
0131-002,2011,2,11,8,327,244,571,135
0131-002,2011,2,11,9,256,281,537,571
0131-002,2011,2,11,10,153,200,353,537
0131-002,2011,2,11,11,171,160,331,353
0131-002,2011,2,11,12,140,170,310,331
0131-002,2011,2,11,13,133,135,268,310
0131-002,2011,2,11,14,149,156,305,268
0131-002,2011,2,11,15,184,222,406,305
0131-002,2011,2,11,16,229,185,414,406
0131-002,2011,2,11,17,217,197,414,414
0131-002,2011,2,11,18,247,270,517,414
0131-002,2011,2,11,19,234,285,519,517
0131-002,2011,2,11,20,171,172,343,519
0131-002,2011,2,11,21,127,141,268,343
0131-002,2011,2,11,22,96,129,225,268
0131-002,2011,2,11,23,78,76,154,225
0131-002,2011,2,11,24,41,54,95,154
0131-002,2011,2,12,1,39,36,75,95
0131-002,2011,2,12,2,23,19,42,75
0131-002,2011,2,12,3,18,24,42,42
0131-002,2011,2,12,4,14,16,30,42
0131-002,2011,2,12,5,14,13,27,30
0131-002,2011,2,12,6,24,19,43,27
0131-002,2011,2,12,7,59,43,102,43
0131-002,2011,2,12,8,167,106,273,102
0131-002,2011,2,12,9,200,182,382,273
0131-002,2011,2,12,10,178,194,372,382
0131-002,2011,2,12,11,184,185,369,372
0131-002,2011,2,12,12,161,197,358,369
0131-002,2011,2,12,13,153,220,373,358
0131-002,2011,2,12,14,176,198,374,373
0131-002,2011,2,12,15,194,226,420,374
0131-002,2011,2,12,16,187,193,380,420
0131-002,2011,2,12,17,208,213,421,380
0131-002,2011,2,12,18,242,227,469,421
0131-002,2011,2,12,19,184,205,389,469
0131-002,2011,2,12,20,131,116,247,389
0131-002,2011,2,12,21,103,98,201,247
0131-002,2011,2,12,22,85,77,162,201
0131-002,2011,2,12,23,65,77,142,162
0131-002,2011,2,12,24,42,31,73,142
0131-002,2011,2,13,1,26,36,62,73
0131-002,2011,2,13,2,16,16,32,62
0131-002,2011,2,13,3,13,11,24,32
0131-002,2011,2,13,4,10,10,20,24
0131-002,2011,2,13,5,10,12,22,20
0131-002,2011,2,13,6,11,11,22,22
0131-002,2011,2,13,7,25,26,51,22
0131-002,2011,2,13,8,61,50,111,51
0131-002,2011,2,13,9,73,74,147,111
0131-002,2011,2,13,10,86,85,171,147
0131-002,2011,2,13,11,104,117,221,171
0131-002,2011,2,13,12,91,115,206,221
0131-002,2011,2,13,13,129,125,254,206
0131-002,2011,2,13,14,119,136,255,254
0131-002,2011,2,13,15,145,133,278,255
0131-002,2011,2,13,16,179,147,326,278
0131-002,2011,2,13,17,224,164,388,326
0131-002,2011,2,13,18,229,150,379,388
0131-002,2011,2,13,19,169,108,277,379
0131-002,2011,2,13,20,106,115,221,277
0131-002,2011,2,13,21,85,77,162,221
0131-002,2011,2,13,22,82,77,159,162
0131-002,2011,2,13,23,54,47,101,159
0131-002,2011,2,13,24,26,27,53,101
0131-002,2011,2,14,1,18,18,36,53
0131-002,2011,2,14,2,13,14,27,36
0131-002,2011,2,14,3,8,9,17,27
0131-002,2011,2,14,4,6,9,15,17
0131-002,2011,2,14,5,13,24,37,15
0131-002,2011,2,14,6,23,29,52,37
0131-002,2011,2,14,7,101,71,172,52
0131-002,2011,2,14,8,346,292,638,172
0131-002,2011,2,14,9,256,288,544,638
0131-002,2011,2,14,10,171,203,374,544
0131-002,2011,2,14,11,154,192,346,374
0131-002,2011,2,14,12,157,163,320,346
0131-002,2011,2,14,13,135,137,272,320
0131-002,2011,2,14,14,163,155,318,272
0131-002,2011,2,14,15,197,176,373,318
0131-002,2011,2,14,16,202,224,426,373
0131-002,2011,2,14,17,169,207,376,426
0131-002,2011,2,14,18,211,245,456,376
0131-002,2011,2,14,19,230,241,471,456
0131-002,2011,2,14,20,173,191,364,471
0131-002,2011,2,14,21,144,146,290,364
0131-002,2011,2,14,22,126,138,264,290
0131-002,2011,2,14,23,62,73,135,264
0131-002,2011,2,14,24,36,45,81,135
0131-002,2011,2,15,1,28,46,74,81
0131-002,2011,2,15,2,22,13,35,74
0131-002,2011,2,15,3,9,17,26,35
0131-002,2011,2,15,4,7,13,20,26
0131-002,2011,2,15,5,14,24,38,20
0131-002,2011,2,15,6,30,17,47,38
0131-002,2011,2,15,7,90,63,153,47
0131-002,2011,2,15,8,343,257,600,153
0131-002,2011,2,15,9,253,299,552,600
0131-002,2011,2,15,10,190,201,391,552
0131-002,2011,2,15,11,198,152,350,391
0131-002,2011,2,15,12,173,166,339,350
0131-002,2011,2,15,13,118,162,280,339
0131-002,2011,2,15,14,181,185,366,280
0131-002,2011,2,15,15,196,209,405,366
0131-002,2011,2,15,16,200,191,391,405
0131-002,2011,2,15,17,195,206,401,391
0131-002,2011,2,15,18,216,275,491,401
0131-002,2011,2,15,19,254,272,526,491
0131-002,2011,2,15,20,137,193,330,526
0131-002,2011,2,15,21,142,160,302,330
0131-002,2011,2,15,22,104,152,256,302
0131-002,2011,2,15,23,78,80,158,256
0131-002,2011,2,15,24,43,40,83,158
0131-002,2011,2,16,1,29,24,53,83
0131-002,2011,2,16,2,15,23,38,53
0131-002,2011,2,16,3,18,11,29,38
0131-002,2011,2,16,4,10,21,31,29
0131-002,2011,2,16,5,11,25,36,31
0131-002,2011,2,16,6,24,14,38,36
0131-002,2011,2,16,7,88,59,147,38
0131-002,2011,2,16,8,345,262,607,147
0131-002,2011,2,16,9,274,310,584,607
0131-002,2011,2,16,10,207,212,419,584
0131-002,2011,2,16,11,197,181,378,419
0131-002,2011,2,16,12,175,165,340,378
0131-002,2011,2,16,13,124,137,261,340
0131-002,2011,2,16,14,177,188,365,261
0131-002,2011,2,16,15,206,187,393,365
0131-002,2011,2,16,16,197,195,392,393
0131-002,2011,2,16,17,186,193,379,392
0131-002,2011,2,16,18,240,307,547,379
0131-002,2011,2,16,19,252,264,516,547
0131-002,2011,2,16,20,158,180,338,516
0131-002,2011,2,16,21,132,147,279,338
0131-002,2011,2,16,22,103,150,253,279
0131-002,2011,2,16,23,98,81,179,253
0131-002,2011,2,16,24,39,62,101,179
0131-002,2011,2,17,1,31,25,56,101
0131-002,2011,2,17,2,20,19,39,56
0131-002,2011,2,17,3,11,7,18,39
0131-002,2011,2,17,4,8,9,17,18
0131-002,2011,2,17,5,6,15,21,17
0131-002,2011,2,17,6,15,22,37,21
0131-002,2011,2,17,7,56,49,105,37
0131-002,2011,2,17,8,291,233,524,105
0131-002,2011,2,17,9,233,267,500,524
0131-002,2011,2,17,10,162,180,342,500
0131-002,2011,2,17,11,183,196,379,342
0131-002,2011,2,17,12,161,191,352,379
0131-002,2011,2,17,13,125,160,285,352
0131-002,2011,2,17,14,179,163,342,285
0131-002,2011,2,17,15,222,190,412,342
0131-002,2011,2,17,16,213,198,411,412
0131-002,2011,2,17,17,187,192,379,411
0131-002,2011,2,17,18,222,254,476,379
0131-002,2011,2,17,19,221,270,491,476
0131-002,2011,2,17,20,155,172,327,491
0131-002,2011,2,17,21,130,167,297,327
0131-002,2011,2,17,22,131,139,270,297
0131-002,2011,2,17,23,74,70,144,270
0131-002,2011,2,17,24,51,51,102,144
0131-002,2011,2,18,1,44,29,73,102
0131-002,2011,2,18,2,15,17,32,73
0131-002,2011,2,18,3,15,14,29,32
0131-002,2011,2,18,4,6,11,17,29
0131-002,2011,2,18,5,17,22,39,17
0131-002,2011,2,18,6,29,17,46,39
0131-002,2011,2,18,7,88,52,140,46
0131-002,2011,2,18,8,365,287,652,140
0131-002,2011,2,18,9,284,336,620,652
0131-002,2011,2,18,10,220,248,468,620
0131-002,2011,2,18,11,203,201,404,468
0131-002,2011,2,18,12,175,188,363,404
0131-002,2011,2,18,13,171,176,347,363
0131-002,2011,2,18,14,179,214,393,347
0131-002,2011,2,18,15,227,210,437,393
0131-002,2011,2,18,16,228,221,449,437
0131-002,2011,2,18,17,225,228,453,449
0131-002,2011,2,18,18,251,304,555,453
0131-002,2011,2,18,19,284,300,584,555
0131-002,2011,2,18,20,193,225,418,584
0131-002,2011,2,18,21,147,156,303,418
0131-002,2011,2,18,22,109,121,230,303
0131-002,2011,2,18,23,77,75,152,230
0131-002,2011,2,18,24,53,60,113,152
0131-002,2011,2,19,1,35,30,65,113
0131-002,2011,2,19,2,29,27,56,65
0131-002,2011,2,19,3,25,13,38,56
0131-002,2011,2,19,4,9,16,25,38
0131-002,2011,2,19,5,8,20,28,25
0131-002,2011,2,19,6,32,20,52,28
0131-002,2011,2,19,7,71,51,122,52
0131-002,2011,2,19,8,195,180,375,122
0131-002,2011,2,19,9,195,217,412,375
0131-002,2011,2,19,10,180,185,365,412
0131-002,2011,2,19,11,177,210,387,365
0131-002,2011,2,19,12,210,254,464,387
0131-002,2011,2,19,13,207,263,470,464
0131-002,2011,2,19,14,244,295,539,470
0131-002,2011,2,19,15,270,304,574,539
0131-002,2011,2,19,16,309,306,615,574
0131-002,2011,2,19,17,304,306,610,615
0131-002,2011,2,19,18,371,348,719,610
0131-002,2011,2,19,19,336,286,622,719
0131-002,2011,2,19,20,279,171,450,622
0131-002,2011,2,19,21,160,114,274,450
0131-002,2011,2,19,22,70,112,182,274
0131-002,2011,2,19,23,73,64,137,182
0131-002,2011,2,19,24,41,43,84,137
0131-002,2011,2,20,1,28,30,58,84
0131-002,2011,2,20,2,21,20,41,58
0131-002,2011,2,20,3,10,12,22,41
0131-002,2011,2,20,4,11,12,23,22
0131-002,2011,2,20,5,11,16,27,23
0131-002,2011,2,20,6,20,14,34,27
0131-002,2011,2,20,7,29,25,54,34
0131-002,2011,2,20,8,69,68,137,54
0131-002,2011,2,20,9,88,109,197,137
0131-002,2011,2,20,10,89,113,202,197
0131-002,2011,2,20,11,130,147,277,202
0131-002,2011,2,20,12,135,137,272,277
0131-002,2011,2,20,13,124,145,269,272
0131-002,2011,2,20,14,147,134,281,269
0131-002,2011,2,20,15,165,154,319,281
0131-002,2011,2,20,16,199,163,362,319
0131-002,2011,2,20,17,260,214,474,362
0131-002,2011,2,20,18,342,161,503,474
0131-002,2011,2,20,19,285,174,459,503
0131-002,2011,2,20,20,145,111,256,459
0131-002,2011,2,20,21,105,94,199,256
0131-002,2011,2,20,22,81,78,159,199
0131-002,2011,2,20,23,79,68,147,159
0131-002,2011,2,20,24,33,29,62,147
0131-002,2011,2,21,1,20,22,42,62
0131-002,2011,2,21,2,12,10,22,42
0131-002,2011,2,21,3,9,6,15,22
0131-002,2011,2,21,4,4,14,18,15
0131-002,2011,2,21,5,9,20,29,18
0131-002,2011,2,21,6,23,29,52,29
0131-002,2011,2,21,7,110,65,175,52
0131-002,2011,2,21,8,393,336,729,175
0131-002,2011,2,21,9,319,360,679,729
0131-002,2011,2,21,10,193,232,425,679
0131-002,2011,2,21,11,190,225,415,425
0131-002,2011,2,21,12,192,188,380,415
0131-002,2011,2,21,13,179,192,371,380
0131-002,2011,2,21,14,228,200,428,371
0131-002,2011,2,21,15,219,265,484,428
0131-002,2011,2,21,16,249,214,463,484
0131-002,2011,2,21,17,230,225,455,463
0131-002,2011,2,21,18,228,306,534,455
0131-002,2011,2,21,19,262,280,542,534
0131-002,2011,2,21,20,191,211,402,542
0131-002,2011,2,21,21,131,167,298,402
0131-002,2011,2,21,22,113,141,254,298
0131-002,2011,2,21,23,80,84,164,254
0131-002,2011,2,21,24,37,51,88,164
0131-002,2011,2,22,1,34,21,55,88
0131-002,2011,2,22,2,20,24,44,55
0131-002,2011,2,22,3,9,20,29,44
0131-002,2011,2,22,4,13,15,28,29
0131-002,2011,2,22,5,19,18,37,28
0131-002,2011,2,22,6,29,30,59,37
0131-002,2011,2,22,7,98,69,167,59
0131-002,2011,2,22,8,387,282,669,167
0131-002,2011,2,22,9,318,345,663,669
0131-002,2011,2,22,10,234,265,499,663
0131-002,2011,2,22,11,210,209,419,499
0131-002,2011,2,22,12,182,231,413,419
0131-002,2011,2,22,13,168,156,324,413
0131-002,2011,2,22,14,221,190,411,324
0131-002,2011,2,22,15,191,267,458,411
0131-002,2011,2,22,16,211,228,439,458
0131-002,2011,2,22,17,217,231,448,439
0131-002,2011,2,22,18,290,293,583,448
0131-002,2011,2,22,19,253,314,567,583
0131-002,2011,2,22,20,167,198,365,567
0131-002,2011,2,22,21,163,176,339,365
0131-002,2011,2,22,22,129,151,280,339
0131-002,2011,2,22,23,95,97,192,280
0131-002,2011,2,22,24,53,53,106,192
0131-002,2011,2,23,1,26,27,53,106
0131-002,2011,2,23,2,15,18,33,53
0131-002,2011,2,23,3,12,13,25,33
0131-002,2011,2,23,4,7,11,18,25
0131-002,2011,2,23,5,17,27,44,18
0131-002,2011,2,23,6,34,21,55,44
0131-002,2011,2,23,7,111,62,173,55
0131-002,2011,2,23,8,355,281,636,173
0131-002,2011,2,23,9,296,359,655,636
0131-002,2011,2,23,10,218,245,463,655
0131-002,2011,2,23,11,209,192,401,463
0131-002,2011,2,23,12,196,216,412,401
0131-002,2011,2,23,13,171,192,363,412
0131-002,2011,2,23,14,189,220,409,363
0131-002,2011,2,23,15,223,277,500,409
0131-002,2011,2,23,16,225,245,470,500
0131-002,2011,2,23,17,240,225,465,470
0131-002,2011,2,23,18,284,297,581,465
0131-002,2011,2,23,19,261,348,609,581
0131-002,2011,2,23,20,177,199,376,609
0131-002,2011,2,23,21,133,178,311,376
0131-002,2011,2,23,22,117,131,248,311
0131-002,2011,2,23,23,95,76,171,248
0131-002,2011,2,23,24,53,50,103,171
0131-002,2011,2,24,1,32,36,68,103
0131-002,2011,2,24,2,19,20,39,68
0131-002,2011,2,24,3,9,12,21,39
0131-002,2011,2,24,4,8,16,24,21
0131-002,2011,2,24,5,13,28,41,24
0131-002,2011,2,24,6,30,21,51,41
0131-002,2011,2,24,7,107,56,163,51
0131-002,2011,2,24,8,391,283,674,163
0131-002,2011,2,24,9,309,343,652,674
0131-002,2011,2,24,10,216,254,470,652
0131-002,2011,2,24,11,238,218,456,470
0131-002,2011,2,24,12,196,204,400,456
0131-002,2011,2,24,13,172,183,355,400
0131-002,2011,2,24,14,197,193,390,355
0131-002,2011,2,24,15,209,253,462,390
0131-002,2011,2,24,16,229,192,421,462
0131-002,2011,2,24,17,237,215,452,421
0131-002,2011,2,24,18,247,308,555,452
0131-002,2011,2,24,19,263,362,625,555
0131-002,2011,2,24,20,197,227,424,625
0131-002,2011,2,24,21,157,189,346,424
0131-002,2011,2,24,22,143,159,302,346
0131-002,2011,2,24,23,82,75,157,302
0131-002,2011,2,24,24,56,66,122,157
0131-002,2011,2,25,1,58,42,100,122
0131-002,2011,2,25,2,17,14,31,100
0131-002,2011,2,25,3,15,16,31,31
0131-002,2011,2,25,4,13,17,30,31
0131-002,2011,2,25,5,17,30,47,30
0131-002,2011,2,25,6,22,21,43,47
0131-002,2011,2,25,7,118,60,178,43
0131-002,2011,2,25,8,396,308,704,178
0131-002,2011,2,25,9,333,329,662,704
0131-002,2011,2,25,10,225,254,479,662
0131-002,2011,2,25,11,238,218,456,479
0131-002,2011,2,25,12,198,225,423,456
0131-002,2011,2,25,13,163,185,348,423
0131-002,2011,2,25,14,202,218,420,348
0131-002,2011,2,25,15,244,233,477,420
0131-002,2011,2,25,16,256,251,507,477
0131-002,2011,2,25,17,256,268,524,507
0131-002,2011,2,25,18,300,324,624,524
0131-002,2011,2,25,19,291,339,630,624
0131-002,2011,2,25,20,269,274,543,630
0131-002,2011,2,25,21,201,235,436,543
0131-002,2011,2,25,22,125,153,278,436
0131-002,2011,2,25,23,114,99,213,278
0131-002,2011,2,25,24,61,71,132,213
0131-002,2011,2,26,1,40,36,76,132
0131-002,2011,2,26,2,22,29,51,76
0131-002,2011,2,26,3,21,15,36,51
0131-002,2011,2,26,4,11,25,36,36
0131-002,2011,2,26,5,19,28,47,36
0131-002,2011,2,26,6,21,27,48,47
0131-002,2011,2,26,7,72,60,132,48
0131-002,2011,2,26,8,239,170,409,132
0131-002,2011,2,26,9,259,257,516,409
0131-002,2011,2,26,10,244,240,484,516
0131-002,2011,2,26,11,221,319,540,484
0131-002,2011,2,26,12,315,353,668,540
0131-002,2011,2,26,13,310,358,668,668
0131-002,2011,2,26,14,323,399,722,668
0131-002,2011,2,26,15,305,425,730,722
0131-002,2011,2,26,16,336,425,761,730
0131-002,2011,2,26,17,367,455,822,761
0131-002,2011,2,26,18,391,488,879,822
0131-002,2011,2,26,19,335,372,707,879
0131-002,2011,2,26,20,190,252,442,707
0131-002,2011,2,26,21,157,142,299,442
0131-002,2011,2,26,22,131,118,249,299
0131-002,2011,2,26,23,73,84,157,249
0131-002,2011,2,26,24,50,47,97,157
0131-002,2011,2,27,1,42,38,80,97
0131-002,2011,2,27,2,26,28,54,80
0131-002,2011,2,27,3,16,25,41,54
0131-002,2011,2,27,4,14,22,36,41
0131-002,2011,2,27,5,11,9,20,36
0131-002,2011,2,27,6,18,16,34,20
0131-002,2011,2,27,7,21,31,52,34
0131-002,2011,2,27,8,55,61,116,52
0131-002,2011,2,27,9,94,92,186,116
0131-002,2011,2,27,10,105,100,205,186
0131-002,2011,2,27,11,127,123,250,205
0131-002,2011,2,27,12,145,131,276,250
0131-002,2011,2,27,13,194,151,345,276
0131-002,2011,2,27,14,208,167,375,345
0131-002,2011,2,27,15,247,215,462,375
0131-002,2011,2,27,16,312,218,530,462
0131-002,2011,2,27,17,350,271,621,530
0131-002,2011,2,27,18,344,258,602,621
0131-002,2011,2,27,19,292,208,500,602
0131-002,2011,2,27,20,282,140,422,500
0131-002,2011,2,27,21,250,121,371,422
0131-002,2011,2,27,22,182,92,274,371
0131-002,2011,2,27,23,48,49,97,274
0131-002,2011,2,27,24,41,36,77,97
0131-002,2011,2,28,1,15,30,45,77
0131-002,2011,2,28,2,8,19,27,45
0131-002,2011,2,28,3,5,9,14,27
0131-002,2011,2,28,4,9,10,19,14
0131-002,2011,2,28,5,16,24,40,19
0131-002,2011,2,28,6,27,21,48,40
0131-002,2011,2,28,7,111,68,179,48
0131-002,2011,2,28,8,378,321,699,179
0131-002,2011,2,28,9,329,312,641,699
0131-002,2011,2,28,10,203,225,428,641
0131-002,2011,2,28,11,219,248,467,428
0131-002,2011,2,28,12,191,201,392,467
0131-002,2011,2,28,13,221,205,426,392
0131-002,2011,2,28,14,197,217,414,426
0131-002,2011,2,28,15,212,260,472,414
0131-002,2011,2,28,16,300,253,553,472
0131-002,2011,2,28,17,258,260,518,553
0131-002,2011,2,28,18,278,329,607,518
0131-002,2011,2,28,19,259,301,560,607
0131-002,2011,2,28,20,207,218,425,560
0131-002,2011,2,28,21,171,171,342,425
0131-002,2011,2,28,22,134,144,278,342
0131-002,2011,2,28,23,106,107,213,278
0131-002,2011,2,28,24,70,57,127,213
0131-002,2011,3,1,1,49,49,98,127
0131-002,2011,3,1,2,18,41,59,98
0131-002,2011,3,1,3,17,21,38,59
0131-002,2011,3,1,4,12,19,31,38
0131-002,2011,3,1,5,14,22,36,31
0131-002,2011,3,1,6,20,23,43,36
0131-002,2011,3,1,7,64,43,107,43
0131-002,2011,3,1,8,138,141,279,107
0131-002,2011,3,1,9,150,143,293,279
0131-002,2011,3,1,10,155,130,285,293
0131-002,2011,3,1,11,169,192,361,285
0131-002,2011,3,1,12,186,215,401,361
0131-002,2011,3,1,13,136,254,390,401
0131-002,2011,3,1,14,197,280,477,390
0131-002,2011,3,1,15,221,299,520,477
0131-002,2011,3,1,16,224,294,518,520
0131-002,2011,3,1,17,320,350,670,518
0131-002,2011,3,1,18,399,303,702,670
0131-002,2011,3,1,19,362,257,619,702
0131-002,2011,3,1,20,286,130,416,619
0131-002,2011,3,1,21,225,107,332,416
0131-002,2011,3,1,22,111,100,211,332
0131-002,2011,3,1,23,58,69,127,211
0131-002,2011,3,1,24,38,34,72,127
0131-002,2011,3,2,1,26,37,63,72
0131-002,2011,3,2,2,14,16,30,63
0131-002,2011,3,2,3,6,11,17,30
0131-002,2011,3,2,4,10,14,24,17
0131-002,2011,3,2,5,10,27,37,24
0131-002,2011,3,2,6,29,23,52,37
0131-002,2011,3,2,7,133,64,197,52
0131-002,2011,3,2,8,394,334,728,197
0131-002,2011,3,2,9,329,362,691,728
0131-002,2011,3,2,10,250,258,508,691
0131-002,2011,3,2,11,223,202,425,508
0131-002,2011,3,2,12,230,184,414,425
0131-002,2011,3,2,13,153,193,346,414
0131-002,2011,3,2,14,202,199,401,346
0131-002,2011,3,2,15,241,251,492,401
0131-002,2011,3,2,16,238,261,499,492
0131-002,2011,3,2,17,258,247,505,499
0131-002,2011,3,2,18,232,271,503,505
0131-002,2011,3,2,19,300,301,601,503
0131-002,2011,3,2,20,190,254,444,601
0131-002,2011,3,2,21,165,198,363,444
0131-002,2011,3,2,22,116,134,250,363
0131-002,2011,3,2,23,95,102,197,250
0131-002,2011,3,2,24,57,62,119,197
0131-002,2011,3,3,1,35,42,77,119
0131-002,2011,3,3,2,23,22,45,77
0131-002,2011,3,3,3,13,17,30,45
0131-002,2011,3,3,4,16,22,38,30
0131-002,2011,3,3,5,17,20,37,38
0131-002,2011,3,3,6,39,22,61,37
0131-002,2011,3,3,7,127,67,194,61
0131-002,2011,3,3,8,427,341,768,194
0131-002,2011,3,3,9,295,381,676,768
0131-002,2011,3,3,10,276,269,545,676
0131-002,2011,3,3,11,235,233,468,545
0131-002,2011,3,3,12,221,224,445,468
0131-002,2011,3,3,13,176,205,381,445
0131-002,2011,3,3,14,216,219,435,381
0131-002,2011,3,3,15,283,232,515,435
0131-002,2011,3,3,16,273,247,520,515
0131-002,2011,3,3,17,239,291,530,520
0131-002,2011,3,3,18,269,283,552,530
0131-002,2011,3,3,19,297,307,604,552
0131-002,2011,3,3,20,204,216,420,604
0131-002,2011,3,3,21,192,179,371,420
0131-002,2011,3,3,22,158,152,310,371
0131-002,2011,3,3,23,93,95,188,310
0131-002,2011,3,3,24,59,56,115,188
0131-002,2011,3,4,1,50,40,90,115
0131-002,2011,3,4,2,28,15,43,90
0131-002,2011,3,4,3,15,20,35,43
0131-002,2011,3,4,4,16,18,34,35
0131-002,2011,3,4,5,15,27,42,34
0131-002,2011,3,4,6,28,22,50,42
0131-002,2011,3,4,7,132,70,202,50
0131-002,2011,3,4,8,423,329,752,202
0131-002,2011,3,4,9,351,358,709,752
0131-002,2011,3,4,10,248,256,504,709
0131-002,2011,3,4,11,236,222,458,504
0131-002,2011,3,4,12,220,234,454,458
0131-002,2011,3,4,13,199,198,397,454
0131-002,2011,3,4,14,228,231,459,397
0131-002,2011,3,4,15,268,258,526,459
0131-002,2011,3,4,16,194,148,342,526
0131-002,2011,3,4,17,229,272,501,342
0131-002,2011,3,4,18,293,346,639,501
0131-002,2011,3,4,19,362,364,726,639
0131-002,2011,3,4,20,228,247,475,726
0131-002,2011,3,4,21,192,181,373,475
0131-002,2011,3,4,22,159,165,324,373
0131-002,2011,3,4,23,97,99,196,324
0131-002,2011,3,4,24,71,61,132,196
0131-002,2011,3,5,1,33,59,92,132
0131-002,2011,3,5,2,19,26,45,92
0131-002,2011,3,5,3,22,26,48,45
0131-002,2011,3,5,4,23,17,40,48
0131-002,2011,3,5,5,16,23,39,40
0131-002,2011,3,5,6,36,34,70,39
0131-002,2011,3,5,7,83,62,145,70
0131-002,2011,3,5,8,299,203,502,145
0131-002,2011,3,5,9,274,269,543,502
0131-002,2011,3,5,10,244,245,489,543
0131-002,2011,3,5,11,203,243,446,489
0131-002,2011,3,5,12,217,228,445,446
0131-002,2011,3,5,13,215,252,467,445
0131-002,2011,3,5,14,246,274,520,467
0131-002,2011,3,5,15,243,246,489,520
0131-002,2011,3,5,16,264,273,537,489
0131-002,2011,3,5,17,374,259,633,537
0131-002,2011,3,5,18,411,325,736,633
0131-002,2011,3,5,19,333,282,615,736
0131-002,2011,3,5,20,196,146,342,615
0131-002,2011,3,5,21,145,157,302,342
0131-002,2011,3,5,22,95,116,211,302
0131-002,2011,3,5,23,63,72,135,211
0131-002,2011,3,5,24,52,50,102,135
0131-002,2011,3,6,1,26,40,66,102
0131-002,2011,3,6,2,19,16,35,66
0131-002,2011,3,6,3,17,15,32,35
0131-002,2011,3,6,4,13,12,25,32
0131-002,2011,3,6,5,12,9,21,25
0131-002,2011,3,6,6,11,19,30,21
0131-002,2011,3,6,7,57,50,107,30
0131-002,2011,3,6,8,94,103,197,107
0131-002,2011,3,6,9,112,99,211,197
0131-002,2011,3,6,10,112,107,219,211
0131-002,2011,3,6,11,156,153,309,219
0131-002,2011,3,6,12,130,143,273,309
0131-002,2011,3,6,13,155,147,302,273
0131-002,2011,3,6,14,149,164,313,302
0131-002,2011,3,6,15,182,180,362,313
0131-002,2011,3,6,16,238,160,398,362
0131-002,2011,3,6,17,285,221,506,398
0131-002,2011,3,6,18,266,198,464,506
0131-002,2011,3,6,19,222,160,382,464
0131-002,2011,3,6,20,148,124,272,382
0131-002,2011,3,6,21,120,121,241,272
0131-002,2011,3,6,22,106,112,218,241
0131-002,2011,3,6,23,66,65,131,218
0131-002,2011,3,6,24,42,26,68,131
0131-002,2011,3,7,1,25,32,57,68
0131-002,2011,3,7,2,15,21,36,57
0131-002,2011,3,7,3,6,21,27,36
0131-002,2011,3,7,4,11,13,24,27
0131-002,2011,3,7,5,9,16,25,24
0131-002,2011,3,7,6,30,26,56,25
0131-002,2011,3,7,7,147,117,264,56
0131-002,2011,3,7,8,438,376,814,264
0131-002,2011,3,7,9,346,408,754,814
0131-002,2011,3,7,10,275,246,521,754
0131-002,2011,3,7,11,236,240,476,521
0131-002,2011,3,7,12,212,239,451,476
0131-002,2011,3,7,13,208,204,412,451
0131-002,2011,3,7,14,238,222,460,412
0131-002,2011,3,7,15,256,245,501,460
0131-002,2011,3,7,16,256,260,516,501
0131-002,2011,3,7,17,246,237,483,516
0131-002,2011,3,7,18,271,281,552,483
0131-002,2011,3,7,19,285,349,634,552
0131-002,2011,3,7,20,205,208,413,634
0131-002,2011,3,7,21,166,210,376,413
0131-002,2011,3,7,22,146,174,320,376
0131-002,2011,3,7,23,98,90,188,320
0131-002,2011,3,7,24,69,53,122,188
0131-002,2011,3,8,1,45,38,83,122
0131-002,2011,3,8,2,19,35,54,83
0131-002,2011,3,8,3,10,20,30,54
0131-002,2011,3,8,4,13,15,28,30
0131-002,2011,3,8,5,14,25,39,28
0131-002,2011,3,8,6,44,30,74,39
0131-002,2011,3,8,7,113,82,195,74
0131-002,2011,3,8,8,421,362,783,195
0131-002,2011,3,8,9,363,373,736,783
0131-002,2011,3,8,10,237,263,500,736
0131-002,2011,3,8,11,245,243,488,500
0131-002,2011,3,8,12,212,214,426,488
0131-002,2011,3,8,13,160,209,369,426
0131-002,2011,3,8,14,237,215,452,369
0131-002,2011,3,8,15,259,254,513,452
0131-002,2011,3,8,16,213,289,502,513
0131-002,2011,3,8,17,258,250,508,502
0131-002,2011,3,8,18,278,304,582,508
0131-002,2011,3,8,19,321,366,687,582
0131-002,2011,3,8,20,200,237,437,687
0131-002,2011,3,8,21,160,193,353,437
0131-002,2011,3,8,22,146,146,292,353
0131-002,2011,3,8,23,108,101,209,292
0131-002,2011,3,8,24,56,49,105,209
0131-002,2011,3,9,1,40,39,79,105
0131-002,2011,3,9,2,17,27,44,79
0131-002,2011,3,9,3,12,13,25,44
0131-002,2011,3,9,4,7,15,22,25
0131-002,2011,3,9,5,14,23,37,22
0131-002,2011,3,9,6,21,25,46,37
0131-002,2011,3,9,7,146,79,225,46
0131-002,2011,3,9,8,425,328,753,225
0131-002,2011,3,9,9,359,385,744,753
0131-002,2011,3,9,10,276,269,545,744
0131-002,2011,3,9,11,215,247,462,545
0131-002,2011,3,9,12,213,207,420,462
0131-002,2011,3,9,13,166,190,356,420
0131-002,2011,3,9,14,231,223,454,356
0131-002,2011,3,9,15,242,253,495,454
0131-002,2011,3,9,16,255,260,515,495
0131-002,2011,3,9,17,273,267,540,515
0131-002,2011,3,9,18,304,336,640,540
0131-002,2011,3,9,19,297,365,662,640
0131-002,2011,3,9,20,168,233,401,662
0131-002,2011,3,9,21,155,186,341,401
0131-002,2011,3,9,22,120,140,260,341
0131-002,2011,3,9,23,91,95,186,260
0131-002,2011,3,9,24,53,49,102,186
0131-002,2011,3,10,1,31,33,64,102
0131-002,2011,3,10,2,26,24,50,64
0131-002,2011,3,10,3,14,9,23,50
0131-002,2011,3,10,4,10,20,30,23
0131-002,2011,3,10,5,12,22,34,30
0131-002,2011,3,10,6,36,21,57,34
0131-002,2011,3,10,7,135,87,222,57
0131-002,2011,3,10,8,439,353,792,222
0131-002,2011,3,10,9,361,365,726,792
0131-002,2011,3,10,10,266,252,518,726
0131-002,2011,3,10,11,228,261,489,518
0131-002,2011,3,10,12,214,213,427,489
0131-002,2011,3,10,13,151,197,348,427
0131-002,2011,3,10,14,220,222,442,348
0131-002,2011,3,10,15,292,240,532,442
0131-002,2011,3,10,16,258,232,490,532
0131-002,2011,3,10,17,259,275,534,490
0131-002,2011,3,10,18,284,333,617,534
0131-002,2011,3,10,19,300,312,612,617
0131-002,2011,3,10,20,206,218,424,612
0131-002,2011,3,10,21,142,182,324,424
0131-002,2011,3,10,22,140,154,294,324
0131-002,2011,3,10,23,95,81,176,294
0131-002,2011,3,10,24,61,59,120,176
0131-002,2011,3,11,1,41,38,79,120
0131-002,2011,3,11,2,38,16,54,79
0131-002,2011,3,11,3,15,23,38,54
0131-002,2011,3,11,4,18,18,36,38
0131-002,2011,3,11,5,13,24,37,36
0131-002,2011,3,11,6,33,22,55,37
0131-002,2011,3,11,7,147,81,228,55
0131-002,2011,3,11,8,450,350,800,228
0131-002,2011,3,11,9,369,386,755,800
0131-002,2011,3,11,10,271,258,529,755
0131-002,2011,3,11,11,234,225,459,529
0131-002,2011,3,11,12,241,244,485,459
0131-002,2011,3,11,13,235,212,447,485
0131-002,2011,3,11,14,255,244,499,447
0131-002,2011,3,11,15,291,283,574,499
0131-002,2011,3,11,16,280,256,536,574
0131-002,2011,3,11,17,272,255,527,536
0131-002,2011,3,11,18,302,366,668,527
0131-002,2011,3,11,19,367,345,712,668
0131-002,2011,3,11,20,236,263,499,712
0131-002,2011,3,11,21,188,196,384,499
0131-002,2011,3,11,22,161,163,324,384
0131-002,2011,3,11,23,103,125,228,324
0131-002,2011,3,11,24,60,69,129,228
0131-002,2011,3,12,1,41,42,83,129
0131-002,2011,3,12,2,33,26,59,83
0131-002,2011,3,12,3,28,22,50,59
0131-002,2011,3,12,4,7,21,28,50
0131-002,2011,3,12,5,22,26,48,28
0131-002,2011,3,12,6,28,32,60,48
0131-002,2011,3,12,7,97,72,169,60
0131-002,2011,3,12,8,226,193,419,169
0131-002,2011,3,12,9,259,245,504,419
0131-002,2011,3,12,10,237,248,485,504
0131-002,2011,3,12,11,245,283,528,485
0131-002,2011,3,12,12,265,328,593,528
0131-002,2011,3,12,13,233,323,556,593
0131-002,2011,3,12,14,257,357,614,556
0131-002,2011,3,12,15,269,372,641,614
0131-002,2011,3,12,16,285,333,618,641
0131-002,2011,3,12,17,291,336,627,618
0131-002,2011,3,12,18,348,378,726,627
0131-002,2011,3,12,19,319,346,665,726
0131-002,2011,3,12,20,197,211,408,665
0131-002,2011,3,12,21,196,147,343,408
0131-002,2011,3,12,22,119,122,241,343
0131-002,2011,3,12,23,78,88,166,241
0131-002,2011,3,12,24,62,62,124,166
0131-002,2011,3,13,1,26,34,60,124
0131-002,2011,3,13,2,22,21,43,60
0131-002,2011,3,13,3,25,16,41,43
0131-002,2011,3,13,4,12,15,27,41
0131-002,2011,3,13,5,11,10,21,27
0131-002,2011,3,13,6,11,16,27,21
0131-002,2011,3,13,7,53,36,89,27
0131-002,2011,3,13,8,87,88,175,89
0131-002,2011,3,13,9,124,141,265,175
0131-002,2011,3,13,10,120,119,239,265
0131-002,2011,3,13,11,145,172,317,239
0131-002,2011,3,13,12,166,184,350,317
0131-002,2011,3,13,13,169,172,341,350
0131-002,2011,3,13,14,207,180,387,341
0131-002,2011,3,13,15,246,191,437,387
0131-002,2011,3,13,16,296,201,497,437
0131-002,2011,3,13,17,456,207,663,497
0131-002,2011,3,13,18,445,235,680,663
0131-002,2011,3,13,19,382,210,592,680
0131-002,2011,3,13,20,275,135,410,592
0131-002,2011,3,13,21,168,139,307,410
0131-002,2011,3,13,22,128,102,230,307
0131-002,2011,3,13,23,73,69,142,230
0131-002,2011,3,13,24,40,35,75,142
0131-002,2011,3,14,1,22,30,52,75
0131-002,2011,3,14,2,24,24,48,52
0131-002,2011,3,14,3,13,13,26,48
0131-002,2011,3,14,4,13,19,32,26
0131-002,2011,3,14,5,11,20,31,32
0131-002,2011,3,14,6,24,26,50,31
0131-002,2011,3,14,7,172,105,277,50
0131-002,2011,3,14,8,494,383,877,277
0131-002,2011,3,14,9,383,420,803,877
0131-002,2011,3,14,10,249,249,498,803
0131-002,2011,3,14,11,239,242,481,498
0131-002,2011,3,14,12,244,235,479,481
0131-002,2011,3,14,13,202,207,409,479
0131-002,2011,3,14,14,273,217,490,409
0131-002,2011,3,14,15,277,296,573,490
0131-002,2011,3,14,16,243,233,476,573
0131-002,2011,3,14,17,256,288,544,476
0131-002,2011,3,14,18,298,310,608,544
0131-002,2011,3,14,19,285,354,639,608
0131-002,2011,3,14,20,202,288,490,639
0131-002,2011,3,14,21,169,190,359,490
0131-002,2011,3,14,22,150,153,303,359
0131-002,2011,3,14,23,81,115,196,303
0131-002,2011,3,14,24,53,47,100,196
0131-002,2011,3,15,1,46,35,81,100
0131-002,2011,3,15,2,18,23,41,81
0131-002,2011,3,15,3,15,18,33,41
0131-002,2011,3,15,4,17,19,36,33
0131-002,2011,3,15,5,18,23,41,36
0131-002,2011,3,15,6,27,34,61,41
0131-002,2011,3,15,7,140,91,231,61
0131-002,2011,3,15,8,477,374,851,231
0131-002,2011,3,15,9,362,408,770,851
0131-002,2011,3,15,10,291,277,568,770
0131-002,2011,3,15,11,265,259,524,568
0131-002,2011,3,15,12,214,234,448,524
0131-002,2011,3,15,13,170,179,349,448
0131-002,2011,3,15,14,250,256,506,349
0131-002,2011,3,15,15,295,267,562,506
0131-002,2011,3,15,16,269,257,526,562
0131-002,2011,3,15,17,278,257,535,526
0131-002,2011,3,15,18,283,307,590,535
0131-002,2011,3,15,19,268,378,646,590
0131-002,2011,3,15,20,217,246,463,646
0131-002,2011,3,15,21,174,206,380,463
0131-002,2011,3,15,22,148,144,292,380
0131-002,2011,3,15,23,97,98,195,292
0131-002,2011,3,15,24,50,64,114,195
0131-002,2011,3,16,1,39,29,68,114
0131-002,2011,3,16,2,20,22,42,68
0131-002,2011,3,16,3,13,12,25,42
0131-002,2011,3,16,4,10,13,23,25
0131-002,2011,3,16,5,23,24,47,23
0131-002,2011,3,16,6,37,40,77,47
0131-002,2011,3,16,7,155,99,254,77
0131-002,2011,3,16,8,466,355,821,254
0131-002,2011,3,16,9,339,388,727,821
0131-002,2011,3,16,10,276,248,524,727
0131-002,2011,3,16,11,264,248,512,524
0131-002,2011,3,16,12,238,228,466,512
0131-002,2011,3,16,13,170,189,359,466
0131-002,2011,3,16,14,255,233,488,359
0131-002,2011,3,16,15,260,276,536,488
0131-002,2011,3,16,16,267,268,535,536
0131-002,2011,3,16,17,274,241,515,535
0131-002,2011,3,16,18,295,347,642,515
0131-002,2011,3,16,19,309,367,676,642
0131-002,2011,3,16,20,220,274,494,676
0131-002,2011,3,16,21,179,182,361,494
0131-002,2011,3,16,22,163,176,339,361
0131-002,2011,3,16,23,118,91,209,339
0131-002,2011,3,16,24,57,72,129,209
0131-002,2011,3,17,1,39,36,75,129
0131-002,2011,3,17,2,27,23,50,75
0131-002,2011,3,17,3,14,16,30,50
0131-002,2011,3,17,4,15,22,37,30
0131-002,2011,3,17,5,16,27,43,37
0131-002,2011,3,17,6,36,42,78,43
0131-002,2011,3,17,7,150,86,236,78
0131-002,2011,3,17,8,458,374,832,236
0131-002,2011,3,17,9,372,405,777,832
0131-002,2011,3,17,10,264,259,523,777
0131-002,2011,3,17,11,247,223,470,523
0131-002,2011,3,17,12,206,231,437,470
0131-002,2011,3,17,13,179,213,392,437
0131-002,2011,3,17,14,268,239,507,392
0131-002,2011,3,17,15,260,263,523,507
0131-002,2011,3,17,16,296,254,550,523
0131-002,2011,3,17,17,259,277,536,550
0131-002,2011,3,17,18,323,327,650,536
0131-002,2011,3,17,19,303,337,640,650
0131-002,2011,3,17,20,196,257,453,640
0131-002,2011,3,17,21,180,184,364,453
0131-002,2011,3,17,22,163,157,320,364
0131-002,2011,3,17,23,103,109,212,320
0131-002,2011,3,17,24,58,53,111,212
0131-002,2011,3,18,1,36,31,67,111
0131-002,2011,3,18,2,25,22,47,67
0131-002,2011,3,18,3,19,27,46,47
0131-002,2011,3,18,4,15,22,37,46
0131-002,2011,3,18,5,17,26,43,37
0131-002,2011,3,18,6,27,38,65,43
0131-002,2011,3,18,7,156,92,248,65
0131-002,2011,3,18,8,466,371,837,248
0131-002,2011,3,18,9,373,431,804,837
0131-002,2011,3,18,10,283,270,553,804
0131-002,2011,3,18,11,238,234,472,553
0131-002,2011,3,18,12,245,257,502,472
0131-002,2011,3,18,13,194,200,394,502
0131-002,2011,3,18,14,254,250,504,394
0131-002,2011,3,18,15,287,269,556,504
0131-002,2011,3,18,16,272,262,534,556
0131-002,2011,3,18,17,303,331,634,534
0131-002,2011,3,18,18,307,327,634,634
0131-002,2011,3,18,19,341,411,752,634
0131-002,2011,3,18,20,271,241,512,752
0131-002,2011,3,18,21,165,199,364,512
0131-002,2011,3,18,22,159,154,313,364
0131-002,2011,3,18,23,107,104,211,313
0131-002,2011,3,18,24,63,62,125,211
0131-002,2011,3,19,1,47,47,94,125
0131-002,2011,3,19,2,30,36,66,94
0131-002,2011,3,19,3,17,22,39,66
0131-002,2011,3,19,4,23,25,48,39
0131-002,2011,3,19,5,15,27,42,48
0131-002,2011,3,19,6,35,29,64,42
0131-002,2011,3,19,7,94,78,172,64
0131-002,2011,3,19,8,264,224,488,172
0131-002,2011,3,19,9,302,238,540,488
0131-002,2011,3,19,10,258,250,508,540
0131-002,2011,3,19,11,241,273,514,508
0131-002,2011,3,19,12,231,273,504,514
0131-002,2011,3,19,13,223,305,528,504
0131-002,2011,3,19,14,284,287,571,528
0131-002,2011,3,19,15,268,303,571,571
0131-002,2011,3,19,16,260,283,543,571
0131-002,2011,3,19,17,344,299,643,543
0131-002,2011,3,19,18,422,349,771,643
0131-002,2011,3,19,19,367,347,714,771
0131-002,2011,3,19,20,207,197,404,714
0131-002,2011,3,19,21,159,140,299,404
0131-002,2011,3,19,22,134,128,262,299
0131-002,2011,3,19,23,76,85,161,262
0131-002,2011,3,19,24,51,56,107,161
0131-002,2011,3,20,1,40,42,82,107
0131-002,2011,3,20,2,41,26,67,82
0131-002,2011,3,20,3,33,27,60,67
0131-002,2011,3,20,4,7,19,26,60
0131-002,2011,3,20,5,15,18,33,26
0131-002,2011,3,20,6,12,18,30,33
0131-002,2011,3,20,7,30,35,65,30
0131-002,2011,3,20,8,77,67,144,65
0131-002,2011,3,20,9,103,104,207,144
0131-002,2011,3,20,10,93,116,209,207
0131-002,2011,3,20,11,124,149,273,209
0131-002,2011,3,20,12,136,157,293,273
0131-002,2011,3,20,13,163,150,313,293
0131-002,2011,3,20,14,175,166,341,313
0131-002,2011,3,20,15,219,184,403,341
0131-002,2011,3,20,16,212,179,391,403
0131-002,2011,3,20,17,272,206,478,391
0131-002,2011,3,20,18,270,186,456,478
0131-002,2011,3,20,19,231,169,400,456
0131-002,2011,3,20,20,178,120,298,400
0131-002,2011,3,20,21,155,113,268,298
0131-002,2011,3,20,22,111,105,216,268
0131-002,2011,3,20,23,74,69,143,216
0131-002,2011,3,20,24,35,42,77,143
0131-002,2011,3,21,1,27,24,51,77
0131-002,2011,3,21,2,11,20,31,51
0131-002,2011,3,21,3,10,10,20,31
0131-002,2011,3,21,4,10,21,31,20
0131-002,2011,3,21,5,17,26,43,31
0131-002,2011,3,21,6,32,33,65,43
0131-002,2011,3,21,7,175,110,285,65
0131-002,2011,3,21,8,493,408,901,285
0131-002,2011,3,21,9,359,411,770,901
0131-002,2011,3,21,10,287,255,542,770
0131-002,2011,3,21,11,232,282,514,542
0131-002,2011,3,21,12,253,216,469,514
0131-002,2011,3,21,13,201,192,393,469
0131-002,2011,3,21,14,229,237,466,393
0131-002,2011,3,21,15,271,258,529,466
0131-002,2011,3,21,16,270,301,571,529
0131-002,2011,3,21,17,297,262,559,571
0131-002,2011,3,21,18,316,331,647,559
0131-002,2011,3,21,19,295,365,660,647
0131-002,2011,3,21,20,214,230,444,660
0131-002,2011,3,21,21,174,199,373,444
0131-002,2011,3,21,22,159,154,313,373
0131-002,2011,3,21,23,104,117,221,313
0131-002,2011,3,21,24,57,46,103,221
0131-002,2011,3,22,1,34,39,73,103
0131-002,2011,3,22,2,21,20,41,73
0131-002,2011,3,22,3,21,19,40,41
0131-002,2011,3,22,4,11,16,27,40
0131-002,2011,3,22,5,13,27,40,27
0131-002,2011,3,22,6,35,36,71,40
0131-002,2011,3,22,7,143,99,242,71
0131-002,2011,3,22,8,493,406,899,242
0131-002,2011,3,22,9,377,408,785,899
0131-002,2011,3,22,10,282,277,559,785
0131-002,2011,3,22,11,266,276,542,559
0131-002,2011,3,22,12,252,231,483,542
0131-002,2011,3,22,13,200,180,380,483
0131-002,2011,3,22,14,270,259,529,380
0131-002,2011,3,22,15,310,249,559,529
0131-002,2011,3,22,16,293,300,593,559
0131-002,2011,3,22,17,262,303,565,593
0131-002,2011,3,22,18,290,339,629,565
0131-002,2011,3,22,19,333,368,701,629
0131-002,2011,3,22,20,229,262,491,701
0131-002,2011,3,22,21,167,212,379,491
0131-002,2011,3,22,22,161,182,343,379
0131-002,2011,3,22,23,108,117,225,343
0131-002,2011,3,22,24,71,61,132,225
0131-002,2011,3,23,1,38,37,75,132
0131-002,2011,3,23,2,21,22,43,75
0131-002,2011,3,23,3,18,19,37,43
0131-002,2011,3,23,4,14,20,34,37
0131-002,2011,3,23,5,14,24,38,34
0131-002,2011,3,23,6,40,35,75,38
0131-002,2011,3,23,7,148,104,252,75
0131-002,2011,3,23,8,492,403,895,252
0131-002,2011,3,23,9,368,407,775,895
0131-002,2011,3,23,10,282,289,571,775
0131-002,2011,3,23,11,264,271,535,571
0131-002,2011,3,23,12,261,242,503,535
0131-002,2011,3,23,13,192,188,380,503
0131-002,2011,3,23,14,267,250,517,380
0131-002,2011,3,23,15,262,297,559,517
0131-002,2011,3,23,16,309,283,592,559
0131-002,2011,3,23,17,308,270,578,592
0131-002,2011,3,23,18,299,335,634,578
0131-002,2011,3,23,19,352,353,705,634
0131-002,2011,3,23,20,245,257,502,705
0131-002,2011,3,23,21,151,223,374,502
0131-002,2011,3,23,22,175,167,342,374
0131-002,2011,3,23,23,116,114,230,342
0131-002,2011,3,23,24,68,68,136,230
0131-002,2011,3,24,1,42,35,77,136
0131-002,2011,3,24,2,21,23,44,77
0131-002,2011,3,24,3,16,19,35,44
0131-002,2011,3,24,4,16,24,40,35
0131-002,2011,3,24,5,15,22,37,40
0131-002,2011,3,24,6,46,34,80,37
0131-002,2011,3,24,7,153,108,261,80
0131-002,2011,3,24,8,492,400,892,261
0131-002,2011,3,24,9,360,406,766,892
0131-002,2011,3,24,10,281,301,582,766
0131-002,2011,3,24,11,263,266,529,582
0131-002,2011,3,24,12,270,252,522,529
0131-002,2011,3,24,13,183,195,378,522
0131-002,2011,3,24,14,264,242,506,378
0131-002,2011,3,24,15,336,266,602,506
0131-002,2011,3,24,16,307,278,585,602
0131-002,2011,3,24,17,273,301,574,585
0131-002,2011,3,24,18,245,338,583,574
0131-002,2011,3,24,19,310,303,613,583
0131-002,2011,3,24,20,180,199,379,613
0131-002,2011,3,24,21,141,167,308,379
0131-002,2011,3,24,22,143,135,278,308
0131-002,2011,3,24,23,83,76,159,278
0131-002,2011,3,24,24,66,49,115,159
0131-002,2011,3,25,1,29,31,60,115
0131-002,2011,3,25,2,24,16,40,60
0131-002,2011,3,25,3,15,14,29,40
0131-002,2011,3,25,4,11,15,26,29
0131-002,2011,3,25,5,15,15,30,26
0131-002,2011,3,25,6,28,25,53,30
0131-002,2011,3,25,7,147,77,224,53
0131-002,2011,3,25,8,437,316,753,224
0131-002,2011,3,25,9,385,415,800,753
0131-002,2011,3,25,10,270,251,521,800
0131-002,2011,3,25,11,239,243,482,521
0131-002,2011,3,25,12,240,239,479,482
0131-002,2011,3,25,13,192,199,391,479
0131-002,2011,3,25,14,221,246,467,391
0131-002,2011,3,25,15,309,288,597,467
0131-002,2011,3,25,16,253,282,535,597
0131-002,2011,3,25,17,281,304,585,535
0131-002,2011,3,25,18,319,346,665,585
0131-002,2011,3,25,19,362,414,776,665
0131-002,2011,3,25,20,279,309,588,776
0131-002,2011,3,25,21,187,233,420,588
0131-002,2011,3,25,22,159,167,326,420
0131-002,2011,3,25,23,110,115,225,326
0131-002,2011,3,25,24,75,59,134,225
0131-002,2011,3,26,1,42,59,101,134
0131-002,2011,3,26,2,21,37,58,101
0131-002,2011,3,26,3,23,25,48,58
0131-002,2011,3,26,4,17,22,39,48
0131-002,2011,3,26,5,21,22,43,39
0131-002,2011,3,26,6,23,32,55,43
0131-002,2011,3,26,7,110,66,176,55
0131-002,2011,3,26,8,255,197,452,176
0131-002,2011,3,26,9,303,275,578,452
0131-002,2011,3,26,10,267,253,520,578
0131-002,2011,3,26,11,250,344,594,520
0131-002,2011,3,26,12,274,399,673,594
0131-002,2011,3,26,13,258,452,710,673
0131-002,2011,3,26,14,280,408,688,710
0131-002,2011,3,26,15,288,421,709,688
0131-002,2011,3,26,16,326,389,715,709
0131-002,2011,3,26,17,281,395,676,715
0131-002,2011,3,26,18,389,371,760,676
0131-002,2011,3,26,19,435,391,826,760
0131-002,2011,3,26,20,239,211,450,826
0131-002,2011,3,26,21,202,167,369,450
0131-002,2011,3,26,22,158,131,289,369
0131-002,2011,3,26,23,101,95,196,289
0131-002,2011,3,26,24,50,45,95,196
0131-002,2011,3,27,1,49,43,92,95
0131-002,2011,3,27,2,23,35,58,92
0131-002,2011,3,27,3,20,18,38,58
0131-002,2011,3,27,4,14,11,25,38
0131-002,2011,3,27,5,15,10,25,25
0131-002,2011,3,27,6,13,15,28,25
0131-002,2011,3,27,7,79,62,141,28
0131-002,2011,3,27,8,98,84,182,141
0131-002,2011,3,27,9,125,156,281,182
0131-002,2011,3,27,10,140,145,285,281
0131-002,2011,3,27,11,168,208,376,285
0131-002,2011,3,27,12,159,169,328,376
0131-002,2011,3,27,13,184,158,342,328
0131-002,2011,3,27,14,219,186,405,342
0131-002,2011,3,27,15,209,186,395,405
0131-002,2011,3,27,16,335,226,561,395
0131-002,2011,3,27,17,409,241,650,561
0131-002,2011,3,27,18,428,237,665,650
0131-002,2011,3,27,19,400,224,624,665
0131-002,2011,3,27,20,229,141,370,624
0131-002,2011,3,27,21,170,124,294,370
0131-002,2011,3,27,22,150,106,256,294
0131-002,2011,3,27,23,95,55,150,256
0131-002,2011,3,27,24,45,48,93,150
0131-002,2011,3,28,1,31,22,53,93
0131-002,2011,3,28,2,30,19,49,53
0131-002,2011,3,28,3,13,10,23,49
0131-002,2011,3,28,4,8,18,26,23
0131-002,2011,3,28,5,11,19,30,26
0131-002,2011,3,28,6,28,36,64,30
0131-002,2011,3,28,7,190,119,309,64
0131-002,2011,3,28,8,486,460,946,309
0131-002,2011,3,28,9,375,403,778,946
0131-002,2011,3,28,10,295,290,585,778
0131-002,2011,3,28,11,263,281,544,585
0131-002,2011,3,28,12,265,255,520,544
0131-002,2011,3,28,13,188,217,405,520
0131-002,2011,3,28,14,252,233,485,405
0131-002,2011,3,28,15,276,288,564,485
0131-002,2011,3,28,16,305,272,577,564
0131-002,2011,3,28,17,307,282,589,577
0131-002,2011,3,28,18,326,333,659,589
0131-002,2011,3,28,19,308,389,697,659
0131-002,2011,3,28,20,221,240,461,697
0131-002,2011,3,28,21,197,236,433,461
0131-002,2011,3,28,22,151,188,339,433
0131-002,2011,3,28,23,112,113,225,339
0131-002,2011,3,28,24,65,58,123,225
0131-002,2011,3,29,1,39,38,77,123
0131-002,2011,3,29,2,23,17,40,77
0131-002,2011,3,29,3,19,13,32,40
0131-002,2011,3,29,4,12,16,28,32
0131-002,2011,3,29,5,21,25,46,28
0131-002,2011,3,29,6,28,35,63,46
0131-002,2011,3,29,7,164,93,257,63
0131-002,2011,3,29,8,449,385,834,257
0131-002,2011,3,29,9,350,385,735,834
0131-002,2011,3,29,10,299,307,606,735
0131-002,2011,3,29,11,262,277,539,606
0131-002,2011,3,29,12,249,286,535,539
0131-002,2011,3,29,13,189,236,425,535
0131-002,2011,3,29,14,257,273,530,425
0131-002,2011,3,29,15,279,262,541,530
0131-002,2011,3,29,16,303,262,565,541
0131-002,2011,3,29,17,304,293,597,565
0131-002,2011,3,29,18,341,347,688,597
0131-002,2011,3,29,19,298,399,697,688
0131-002,2011,3,29,20,240,243,483,697
0131-002,2011,3,29,21,202,231,433,483
0131-002,2011,3,29,22,151,181,332,433
0131-002,2011,3,29,23,101,102,203,332
0131-002,2011,3,29,24,77,60,137,203
0131-002,2011,3,30,1,46,32,78,137
0131-002,2011,3,30,2,24,27,51,78
0131-002,2011,3,30,3,23,21,44,51
0131-002,2011,3,30,4,18,16,34,44
0131-002,2011,3,30,5,18,33,51,34
0131-002,2011,3,30,6,42,36,78,51
0131-002,2011,3,30,7,179,118,297,78
0131-002,2011,3,30,8,477,401,878,297
0131-002,2011,3,30,9,388,421,809,878
0131-002,2011,3,30,10,313,288,601,809
0131-002,2011,3,30,11,276,317,593,601
0131-002,2011,3,30,12,248,301,549,593
0131-002,2011,3,30,13,226,234,460,549
0131-002,2011,3,30,14,273,257,530,460
0131-002,2011,3,30,15,259,305,564,530
0131-002,2011,3,30,16,296,284,580,564
0131-002,2011,3,30,17,298,306,604,580
0131-002,2011,3,30,18,346,390,736,604
0131-002,2011,3,30,19,356,387,743,736
0131-002,2011,3,30,20,244,274,518,743
0131-002,2011,3,30,21,170,211,381,518
0131-002,2011,3,30,22,164,165,329,381
0131-002,2011,3,30,23,105,112,217,329
0131-002,2011,3,30,24,74,64,138,217
0131-002,2011,3,31,1,38,46,84,138
0131-002,2011,3,31,2,25,34,59,84
0131-002,2011,3,31,3,16,16,32,59
0131-002,2011,3,31,4,16,22,38,32
0131-002,2011,3,31,5,23,25,48,38
0131-002,2011,3,31,6,34,32,66,48
0131-002,2011,3,31,7,164,121,285,66
0131-002,2011,3,31,8,470,361,831,285
0131-002,2011,3,31,9,409,433,842,831
0131-002,2011,3,31,10,303,281,584,842
0131-002,2011,3,31,11,272,271,543,584
0131-002,2011,3,31,12,233,239,472,543
0131-002,2011,3,31,13,204,231,435,472
0131-002,2011,3,31,14,246,275,521,435
0131-002,2011,3,31,15,322,287,609,521
0131-002,2011,3,31,16,317,291,608,609
0131-002,2011,3,31,17,297,318,615,608
0131-002,2011,3,31,18,307,359,666,615
0131-002,2011,3,31,19,313,361,674,666
0131-002,2011,3,31,20,237,293,530,674
0131-002,2011,3,31,21,178,235,413,530
0131-002,2011,3,31,22,164,190,354,413
0131-002,2011,3,31,23,144,140,284,354
0131-002,2011,3,31,24,67,61,128,284
0131-002,2011,4,1,1,48,44,92,128
0131-002,2011,4,1,2,24,24,48,92
0131-002,2011,4,1,3,13,17,30,48
0131-002,2011,4,1,4,11,17,28,30
0131-002,2011,4,1,5,27,23,50,28
0131-002,2011,4,1,6,39,32,71,50
0131-002,2011,4,1,7,163,97,260,71
0131-002,2011,4,1,8,465,391,856,260
0131-002,2011,4,1,9,373,443,816,856
0131-002,2011,4,1,10,285,281,566,816
0131-002,2011,4,1,11,283,234,517,566
0131-002,2011,4,1,12,247,265,512,517
0131-002,2011,4,1,13,223,232,455,512
0131-002,2011,4,1,14,275,260,535,455
0131-002,2011,4,1,15,283,283,566,535
0131-002,2011,4,1,16,317,315,632,566
0131-002,2011,4,1,17,294,310,604,632
0131-002,2011,4,1,18,311,392,703,604
0131-002,2011,4,1,19,392,409,801,703
0131-002,2011,4,1,20,279,284,563,801
0131-002,2011,4,1,21,203,223,426,563
0131-002,2011,4,1,22,172,186,358,426
0131-002,2011,4,1,23,105,113,218,358
0131-002,2011,4,1,24,76,71,147,218
0131-002,2011,4,2,1,57,45,102,147
0131-002,2011,4,2,2,24,33,57,102
0131-002,2011,4,2,3,21,22,43,57
0131-002,2011,4,2,4,22,27,49,43
0131-002,2011,4,2,5,24,24,48,49
0131-002,2011,4,2,6,33,44,77,48
0131-002,2011,4,2,7,139,79,218,77
0131-002,2011,4,2,8,280,220,500,218
0131-002,2011,4,2,9,295,306,601,500
0131-002,2011,4,2,10,293,302,595,601
0131-002,2011,4,2,11,272,344,616,595
0131-002,2011,4,2,12,241,428,669,616
0131-002,2011,4,2,13,257,486,743,669
0131-002,2011,4,2,14,304,480,784,743
0131-002,2011,4,2,15,306,490,796,784
0131-002,2011,4,2,16,325,495,820,796
0131-002,2011,4,2,17,343,452,795,820
0131-002,2011,4,2,18,412,532,944,795
0131-002,2011,4,2,19,406,497,903,944
0131-002,2011,4,2,20,214,300,514,903
0131-002,2011,4,2,21,184,199,383,514
0131-002,2011,4,2,22,128,136,264,383
0131-002,2011,4,2,23,79,80,159,264
0131-002,2011,4,2,24,49,69,118,159
0131-002,2011,4,3,1,40,47,87,118
0131-002,2011,4,3,2,28,36,64,87
0131-002,2011,4,3,3,24,18,42,64
0131-002,2011,4,3,4,15,13,28,42
0131-002,2011,4,3,5,25,14,39,28
0131-002,2011,4,3,6,27,17,44,39
0131-002,2011,4,3,7,67,53,120,44
0131-002,2011,4,3,8,94,108,202,120
0131-002,2011,4,3,9,145,154,299,202
0131-002,2011,4,3,10,133,163,296,299
0131-002,2011,4,3,11,166,179,345,296
0131-002,2011,4,3,12,154,210,364,345
0131-002,2011,4,3,13,179,171,350,364
0131-002,2011,4,3,14,215,210,425,350
0131-002,2011,4,3,15,326,191,517,425
0131-002,2011,4,3,16,437,208,645,517
0131-002,2011,4,3,17,442,210,652,645
0131-002,2011,4,3,18,458,231,689,652
0131-002,2011,4,3,19,448,206,654,689
0131-002,2011,4,3,20,398,163,561,654
0131-002,2011,4,3,21,433,136,569,561
0131-002,2011,4,3,22,394,113,507,569
0131-002,2011,4,3,23,166,76,242,507
0131-002,2011,4,3,24,47,44,91,242
0131-002,2011,4,4,1,37,32,69,91
0131-002,2011,4,4,2,14,23,37,69
0131-002,2011,4,4,3,12,13,25,37
0131-002,2011,4,4,4,10,23,33,25
0131-002,2011,4,4,5,9,14,23,33
0131-002,2011,4,4,6,43,52,95,23
0131-002,2011,4,4,7,200,121,321,95
0131-002,2011,4,4,8,502,461,963,321
0131-002,2011,4,4,9,384,449,833,963
0131-002,2011,4,4,10,310,289,599,833
0131-002,2011,4,4,11,274,273,547,599
0131-002,2011,4,4,12,256,244,500,547
0131-002,2011,4,4,13,209,227,436,500
0131-002,2011,4,4,14,193,261,454,436
0131-002,2011,4,4,15,276,308,584,454
0131-002,2011,4,4,16,250,319,569,584
0131-002,2011,4,4,17,316,308,624,569
0131-002,2011,4,4,18,329,356,685,624
0131-002,2011,4,4,19,339,393,732,685
0131-002,2011,4,4,20,248,278,526,732
0131-002,2011,4,4,21,200,245,445,526
0131-002,2011,4,4,22,180,172,352,445
0131-002,2011,4,4,23,111,111,222,352
0131-002,2011,4,4,24,54,72,126,222
0131-002,2011,4,5,1,45,43,88,126
0131-002,2011,4,5,2,15,30,45,88
0131-002,2011,4,5,3,19,21,40,45
0131-002,2011,4,5,4,8,14,22,40
0131-002,2011,4,5,5,16,23,39,22
0131-002,2011,4,5,6,32,46,78,39
0131-002,2011,4,5,7,175,116,291,78
0131-002,2011,4,5,8,497,418,915,291
0131-002,2011,4,5,9,371,428,799,915
0131-002,2011,4,5,10,309,298,607,799
0131-002,2011,4,5,11,311,261,572,607
0131-002,2011,4,5,12,252,245,497,572
0131-002,2011,4,5,13,207,232,439,497
0131-002,2011,4,5,14,253,243,496,439
0131-002,2011,4,5,15,287,264,551,496
0131-002,2011,4,5,16,292,288,580,551
0131-002,2011,4,5,17,288,310,598,580
0131-002,2011,4,5,18,304,346,650,598
0131-002,2011,4,5,19,307,366,673,650
0131-002,2011,4,5,20,256,289,545,673
0131-002,2011,4,5,21,213,231,444,545
0131-002,2011,4,5,22,186,170,356,444
0131-002,2011,4,5,23,127,119,246,356
0131-002,2011,4,5,24,81,58,139,246
0131-002,2011,4,6,1,37,42,79,139
0131-002,2011,4,6,2,21,32,53,79
0131-002,2011,4,6,3,15,14,29,53
0131-002,2011,4,6,4,18,19,37,29
0131-002,2011,4,6,5,19,30,49,37
0131-002,2011,4,6,6,37,35,72,49
0131-002,2011,4,6,7,172,117,289,72
0131-002,2011,4,6,8,466,405,871,289
0131-002,2011,4,6,9,349,437,786,871
0131-002,2011,4,6,10,324,291,615,786
0131-002,2011,4,6,11,280,266,546,615
0131-002,2011,4,6,12,255,267,522,546
0131-002,2011,4,6,13,207,224,431,522
0131-002,2011,4,6,14,290,277,567,431
0131-002,2011,4,6,15,296,267,563,567
0131-002,2011,4,6,16,324,309,633,563
0131-002,2011,4,6,17,314,321,635,633
0131-002,2011,4,6,18,361,393,754,635
0131-002,2011,4,6,19,332,418,750,754
0131-002,2011,4,6,20,247,250,497,750
0131-002,2011,4,6,21,196,210,406,497
0131-002,2011,4,6,22,171,188,359,406
0131-002,2011,4,6,23,131,108,239,359
0131-002,2011,4,6,24,76,55,131,239
0131-002,2011,4,7,1,47,37,84,131
0131-002,2011,4,7,2,32,35,67,84
0131-002,2011,4,7,3,15,11,26,67
0131-002,2011,4,7,4,10,15,25,26
0131-002,2011,4,7,5,18,24,42,25
0131-002,2011,4,7,6,29,42,71,42
0131-002,2011,4,7,7,147,76,223,71
0131-002,2011,4,7,8,462,373,835,223
0131-002,2011,4,7,9,370,446,816,835
0131-002,2011,4,7,10,295,263,558,816
0131-002,2011,4,7,11,293,237,530,558
0131-002,2011,4,7,12,201,261,462,530
0131-002,2011,4,7,13,208,186,394,462
0131-002,2011,4,7,14,221,236,457,394
0131-002,2011,4,7,15,299,266,565,457
0131-002,2011,4,7,16,290,234,524,565
0131-002,2011,4,7,17,248,277,525,524
0131-002,2011,4,7,18,262,333,595,525
0131-002,2011,4,7,19,291,363,654,595
0131-002,2011,4,7,20,216,246,462,654
0131-002,2011,4,7,21,178,202,380,462
0131-002,2011,4,7,22,150,186,336,380
0131-002,2011,4,7,23,115,114,229,336
0131-002,2011,4,7,24,78,63,141,229
0131-002,2011,4,8,1,42,46,88,141
0131-002,2011,4,8,2,26,16,42,88
0131-002,2011,4,8,3,22,8,30,42
0131-002,2011,4,8,4,10,17,27,30
0131-002,2011,4,8,5,18,28,46,27
0131-002,2011,4,8,6,34,33,67,46
0131-002,2011,4,8,7,158,102,260,67
0131-002,2011,4,8,8,469,357,826,260
0131-002,2011,4,8,9,373,429,802,826
0131-002,2011,4,8,10,290,291,581,802
0131-002,2011,4,8,11,300,262,562,581
0131-002,2011,4,8,12,274,257,531,562
0131-002,2011,4,8,13,227,220,447,531
0131-002,2011,4,8,14,295,260,555,447
0131-002,2011,4,8,15,305,306,611,555
0131-002,2011,4,8,16,335,354,689,611
0131-002,2011,4,8,17,332,303,635,689
0131-002,2011,4,8,18,353,365,718,635
0131-002,2011,4,8,19,388,385,773,718
0131-002,2011,4,8,20,307,335,642,773
0131-002,2011,4,8,21,222,238,460,642
0131-002,2011,4,8,22,163,168,331,460
0131-002,2011,4,8,23,141,122,263,331
0131-002,2011,4,8,24,87,83,170,263
0131-002,2011,4,9,1,60,66,126,170
0131-002,2011,4,9,2,38,38,76,126
0131-002,2011,4,9,3,24,24,48,76
0131-002,2011,4,9,4,14,31,45,48
0131-002,2011,4,9,5,27,33,60,45
0131-002,2011,4,9,6,31,33,64,60
0131-002,2011,4,9,7,114,81,195,64
0131-002,2011,4,9,8,248,226,474,195
0131-002,2011,4,9,9,274,279,553,474
0131-002,2011,4,9,10,262,353,615,553
0131-002,2011,4,9,11,294,499,793,615
0131-002,2011,4,9,12,256,678,934,793
0131-002,2011,4,9,13,275,710,985,934
0131-002,2011,4,9,14,301,713,1014,985
0131-002,2011,4,9,15,329,638,967,1014
0131-002,2011,4,9,16,389,683,1072,967
0131-002,2011,4,9,17,355,693,1048,1072
0131-002,2011,4,9,18,388,663,1051,1048
0131-002,2011,4,9,19,356,561,917,1051
0131-002,2011,4,9,20,270,331,601,917
0131-002,2011,4,9,21,183,212,395,601
0131-002,2011,4,9,22,162,142,304,395
0131-002,2011,4,9,23,124,120,244,304
0131-002,2011,4,9,24,66,75,141,244
0131-002,2011,4,10,1,47,67,114,141
0131-002,2011,4,10,2,27,26,53,114
0131-002,2011,4,10,3,21,31,52,53
0131-002,2011,4,10,4,27,13,40,52
0131-002,2011,4,10,5,18,8,26,40
0131-002,2011,4,10,6,23,25,48,26
0131-002,2011,4,10,7,74,59,133,48
0131-002,2011,4,10,8,100,115,215,133
0131-002,2011,4,10,9,150,148,298,215
0131-002,2011,4,10,10,148,166,314,298
0131-002,2011,4,10,11,162,196,358,314
0131-002,2011,4,10,12,200,179,379,358
0131-002,2011,4,10,13,212,166,378,379
0131-002,2011,4,10,14,337,200,537,378
0131-002,2011,4,10,15,413,261,674,537
0131-002,2011,4,10,16,478,219,697,674
0131-002,2011,4,10,17,553,211,764,697
0131-002,2011,4,10,18,466,207,673,764
0131-002,2011,4,10,19,536,189,725,673
0131-002,2011,4,10,20,450,165,615,725
0131-002,2011,4,10,21,422,128,550,615
0131-002,2011,4,10,22,386,110,496,550
0131-002,2011,4,10,23,379,85,464,496
0131-002,2011,4,10,24,228,67,295,464
0131-002,2011,4,11,1,33,25,58,295
0131-002,2011,4,11,2,22,18,40,58
0131-002,2011,4,11,3,13,7,20,40
0131-002,2011,4,11,4,15,19,34,20
0131-002,2011,4,11,5,18,21,39,34
0131-002,2011,4,11,6,42,40,82,39
0131-002,2011,4,11,7,219,135,354,82
0131-002,2011,4,11,8,513,450,963,354
0131-002,2011,4,11,9,385,441,826,963
0131-002,2011,4,11,10,320,294,614,826
0131-002,2011,4,11,11,306,292,598,614
0131-002,2011,4,11,12,258,261,519,598
0131-002,2011,4,11,13,229,253,482,519
0131-002,2011,4,11,14,241,265,506,482
0131-002,2011,4,11,15,307,292,599,506
0131-002,2011,4,11,16,364,303,667,599
0131-002,2011,4,11,17,323,313,636,667
0131-002,2011,4,11,18,327,369,696,636
0131-002,2011,4,11,19,325,370,695,696
0131-002,2011,4,11,20,278,278,556,695
0131-002,2011,4,11,21,216,244,460,556
0131-002,2011,4,11,22,185,196,381,460
0131-002,2011,4,11,23,115,112,227,381
0131-002,2011,4,11,24,66,65,131,227
0131-002,2011,4,12,1,39,46,85,131
0131-002,2011,4,12,2,25,29,54,85
0131-002,2011,4,12,3,16,11,27,54
0131-002,2011,4,12,4,19,17,36,27
0131-002,2011,4,12,5,15,24,39,36
0131-002,2011,4,12,6,47,37,84,39
0131-002,2011,4,12,7,207,122,329,84
0131-002,2011,4,12,8,483,387,870,329
0131-002,2011,4,12,9,393,472,865,870
0131-002,2011,4,12,10,317,301,618,865
0131-002,2011,4,12,11,296,274,570,618
0131-002,2011,4,12,12,247,280,527,570
0131-002,2011,4,12,13,217,232,449,527
0131-002,2011,4,12,14,264,278,542,449
0131-002,2011,4,12,15,289,321,610,542
0131-002,2011,4,12,16,299,319,618,610
0131-002,2011,4,12,17,328,314,642,618
0131-002,2011,4,12,18,351,363,714,642
0131-002,2011,4,12,19,336,373,709,714
0131-002,2011,4,12,20,264,294,558,709
0131-002,2011,4,12,21,199,234,433,558
0131-002,2011,4,12,22,169,171,340,433
0131-002,2011,4,12,23,123,111,234,340
0131-002,2011,4,12,24,63,74,137,234
0131-002,2011,4,13,1,45,41,86,137
0131-002,2011,4,13,2,26,26,52,86
0131-002,2011,4,13,3,11,10,21,52
0131-002,2011,4,13,4,12,16,28,21
0131-002,2011,4,13,5,16,34,50,28
0131-002,2011,4,13,6,46,39,85,50
0131-002,2011,4,13,7,198,118,316,85
0131-002,2011,4,13,8,504,405,909,316
0131-002,2011,4,13,9,414,466,880,909
0131-002,2011,4,13,10,322,327,649,880
0131-002,2011,4,13,11,320,301,621,649
0131-002,2011,4,13,12,256,260,516,621
0131-002,2011,4,13,13,238,258,496,516
0131-002,2011,4,13,14,298,275,573,496
0131-002,2011,4,13,15,310,331,641,573
0131-002,2011,4,13,16,345,296,641,641
0131-002,2011,4,13,17,288,343,631,641
0131-002,2011,4,13,18,362,383,745,631
0131-002,2011,4,13,19,336,399,735,745
0131-002,2011,4,13,20,263,303,566,735
0131-002,2011,4,13,21,191,215,406,566
0131-002,2011,4,13,22,168,199,367,406
0131-002,2011,4,13,23,128,128,256,367
0131-002,2011,4,13,24,70,67,137,256
0131-002,2011,4,14,1,55,46,101,137
0131-002,2011,4,14,2,19,37,56,101
0131-002,2011,4,14,3,10,24,34,56
0131-002,2011,4,14,4,22,28,50,34
0131-002,2011,4,14,5,22,18,40,50
0131-002,2011,4,14,6,49,45,94,40
0131-002,2011,4,14,7,220,113,333,94
0131-002,2011,4,14,8,515,427,942,333
0131-002,2011,4,14,9,430,482,912,942
0131-002,2011,4,14,10,279,303,582,912
0131-002,2011,4,14,11,260,251,511,582
0131-002,2011,4,14,12,269,281,550,511
0131-002,2011,4,14,13,195,236,431,550
0131-002,2011,4,14,14,249,290,539,431
0131-002,2011,4,14,15,295,288,583,539
0131-002,2011,4,14,16,335,312,647,583
0131-002,2011,4,14,17,309,338,647,647
0131-002,2011,4,14,18,349,399,748,647
0131-002,2011,4,14,19,370,523,893,748
0131-002,2011,4,14,20,263,330,593,893
0131-002,2011,4,14,21,217,222,439,593
0131-002,2011,4,14,22,186,198,384,439
0131-002,2011,4,14,23,144,96,240,384
0131-002,2011,4,14,24,65,63,128,240
0131-002,2011,4,15,1,54,60,114,128
0131-002,2011,4,15,2,25,27,52,114
0131-002,2011,4,15,3,13,16,29,52
0131-002,2011,4,15,4,15,24,39,29
0131-002,2011,4,15,5,17,22,39,39
0131-002,2011,4,15,6,57,51,108,39
0131-002,2011,4,15,7,210,112,322,108
0131-002,2011,4,15,8,489,400,889,322
0131-002,2011,4,15,9,410,467,877,889
0131-002,2011,4,15,10,307,334,641,877
0131-002,2011,4,15,11,311,283,594,641
0131-002,2011,4,15,12,265,310,575,594
0131-002,2011,4,15,13,260,264,524,575
0131-002,2011,4,15,14,288,302,590,524
0131-002,2011,4,15,15,305,316,621,590
0131-002,2011,4,15,16,363,331,694,621
0131-002,2011,4,15,17,297,355,652,694
0131-002,2011,4,15,18,373,418,791,652
0131-002,2011,4,15,19,405,455,860,791
0131-002,2011,4,15,20,293,298,591,860
0131-002,2011,4,15,21,230,220,450,591
0131-002,2011,4,15,22,148,182,330,450
0131-002,2011,4,15,23,125,116,241,330
0131-002,2011,4,15,24,76,73,149,241
0131-002,2011,4,16,1,70,64,134,149
0131-002,2011,4,16,2,31,29,60,134
0131-002,2011,4,16,3,27,26,53,60
0131-002,2011,4,16,4,20,33,53,53
0131-002,2011,4,16,5,21,26,47,53
0131-002,2011,4,16,6,54,34,88,47
0131-002,2011,4,16,7,128,99,227,88
0131-002,2011,4,16,8,314,259,573,227
0131-002,2011,4,16,9,319,315,634,573
0131-002,2011,4,16,10,304,311,615,634
0131-002,2011,4,16,11,292,381,673,615
0131-002,2011,4,16,12,267,462,729,673
0131-002,2011,4,16,13,253,480,733,729
0131-002,2011,4,16,14,306,497,803,733
0131-002,2011,4,16,15,272,407,679,803
0131-002,2011,4,16,16,331,483,814,679
0131-002,2011,4,16,17,309,488,797,814
0131-002,2011,4,16,18,407,494,901,797
0131-002,2011,4,16,19,391,462,853,901
0131-002,2011,4,16,20,227,266,493,853
0131-002,2011,4,16,21,193,194,387,493
0131-002,2011,4,16,22,144,140,284,387
0131-002,2011,4,16,23,118,107,225,284
0131-002,2011,4,16,24,98,75,173,225
0131-002,2011,4,17,1,46,70,116,173
0131-002,2011,4,17,2,25,37,62,116
0131-002,2011,4,17,3,27,28,55,62
0131-002,2011,4,17,4,11,19,30,55
0131-002,2011,4,17,5,17,20,37,30
0131-002,2011,4,17,6,20,31,51,37
0131-002,2011,4,17,7,80,59,139,51
0131-002,2011,4,17,8,121,120,241,139
0131-002,2011,4,17,9,150,165,315,241
0131-002,2011,4,17,10,184,185,369,315
0131-002,2011,4,17,11,216,225,441,369
0131-002,2011,4,17,12,184,200,384,441
0131-002,2011,4,17,13,178,189,367,384
0131-002,2011,4,17,14,183,229,412,367
0131-002,2011,4,17,15,249,234,483,412
0131-002,2011,4,17,16,385,226,611,483
0131-002,2011,4,17,17,453,259,712,611
0131-002,2011,4,17,18,459,237,696,712
0131-002,2011,4,17,19,445,209,654,696
0131-002,2011,4,17,20,440,164,604,654
0131-002,2011,4,17,21,282,136,418,604
0131-002,2011,4,17,22,230,136,366,418
0131-002,2011,4,17,23,125,93,218,366
0131-002,2011,4,17,24,64,52,116,218
0131-002,2011,4,18,1,37,31,68,116
0131-002,2011,4,18,2,22,22,44,68
0131-002,2011,4,18,3,10,12,22,44
0131-002,2011,4,18,4,7,20,27,22
0131-002,2011,4,18,5,22,29,51,27
0131-002,2011,4,18,6,49,50,99,51
0131-002,2011,4,18,7,189,138,327,99
0131-002,2011,4,18,8,540,432,972,327
0131-002,2011,4,18,9,437,462,899,972
0131-002,2011,4,18,10,306,288,594,899
0131-002,2011,4,18,11,290,238,528,594
0131-002,2011,4,18,12,266,289,555,528
0131-002,2011,4,18,13,252,243,495,555
0131-002,2011,4,18,14,287,252,539,495
0131-002,2011,4,18,15,315,293,608,539
0131-002,2011,4,18,16,292,283,575,608
0131-002,2011,4,18,17,298,300,598,575
0131-002,2011,4,18,18,318,347,665,598
0131-002,2011,4,18,19,346,396,742,665
0131-002,2011,4,18,20,231,291,522,742
0131-002,2011,4,18,21,162,244,406,522
0131-002,2011,4,18,22,147,170,317,406
0131-002,2011,4,18,23,120,108,228,317
0131-002,2011,4,18,24,60,72,132,228
0131-002,2011,4,19,1,45,49,94,132
0131-002,2011,4,19,2,19,31,50,94
0131-002,2011,4,19,3,13,10,23,50
0131-002,2011,4,19,4,11,22,33,23
0131-002,2011,4,19,5,22,25,47,33
0131-002,2011,4,19,6,41,51,92,47
0131-002,2011,4,19,7,194,116,310,92
0131-002,2011,4,19,8,531,422,953,310
0131-002,2011,4,19,9,395,439,834,953
0131-002,2011,4,19,10,313,326,639,834
0131-002,2011,4,19,11,304,288,592,639
0131-002,2011,4,19,12,262,288,550,592
0131-002,2011,4,19,13,254,261,515,550
0131-002,2011,4,19,14,254,266,520,515
0131-002,2011,4,19,15,299,321,620,520
0131-002,2011,4,19,16,320,337,657,620
0131-002,2011,4,19,17,320,327,647,657
0131-002,2011,4,19,18,335,355,690,647
0131-002,2011,4,19,19,348,426,774,690
0131-002,2011,4,19,20,282,324,606,774
0131-002,2011,4,19,21,204,245,449,606
0131-002,2011,4,19,22,170,182,352,449
0131-002,2011,4,19,23,117,112,229,352
0131-002,2011,4,19,24,79,60,139,229
0131-002,2011,4,20,1,42,53,95,139
0131-002,2011,4,20,2,22,29,51,95
0131-002,2011,4,20,3,9,16,25,51
0131-002,2011,4,20,4,17,15,32,25
0131-002,2011,4,20,5,24,27,51,32
0131-002,2011,4,20,6,52,43,95,51
0131-002,2011,4,20,7,195,115,310,95
0131-002,2011,4,20,8,503,424,927,310
0131-002,2011,4,20,9,445,470,915,927
0131-002,2011,4,20,10,301,296,597,915
0131-002,2011,4,20,11,298,270,568,597
0131-002,2011,4,20,12,232,289,521,568
0131-002,2011,4,20,13,225,258,483,521
0131-002,2011,4,20,14,271,268,539,483
0131-002,2011,4,20,15,329,330,659,539
0131-002,2011,4,20,16,340,324,664,659
0131-002,2011,4,20,17,324,271,595,664
0131-002,2011,4,20,18,359,388,747,595
0131-002,2011,4,20,19,400,418,818,747
0131-002,2011,4,20,20,258,292,550,818
0131-002,2011,4,20,21,177,256,433,550
0131-002,2011,4,20,22,178,183,361,433
0131-002,2011,4,20,23,116,134,250,361
0131-002,2011,4,20,24,86,68,154,250
0131-002,2011,4,21,1,49,41,90,154
0131-002,2011,4,21,2,18,26,44,90
0131-002,2011,4,21,3,7,20,27,44
0131-002,2011,4,21,4,11,30,41,27
0131-002,2011,4,21,5,20,21,41,41
0131-002,2011,4,21,6,50,44,94,41
0131-002,2011,4,21,7,186,119,305,94
0131-002,2011,4,21,8,528,425,953,305
0131-002,2011,4,21,9,438,435,873,953
0131-002,2011,4,21,10,317,293,610,873
0131-002,2011,4,21,11,280,296,576,610
0131-002,2011,4,21,12,273,254,527,576
0131-002,2011,4,21,13,237,251,488,527
0131-002,2011,4,21,14,292,268,560,488
0131-002,2011,4,21,15,314,316,630,560
0131-002,2011,4,21,16,294,314,608,630
0131-002,2011,4,21,17,297,331,628,608
0131-002,2011,4,21,18,337,398,735,628
0131-002,2011,4,21,19,347,432,779,735
0131-002,2011,4,21,20,258,290,548,779
0131-002,2011,4,21,21,223,247,470,548
0131-002,2011,4,21,22,194,213,407,470
0131-002,2011,4,21,23,105,137,242,407
0131-002,2011,4,21,24,82,76,158,242
0131-002,2011,4,22,1,65,52,117,158
0131-002,2011,4,22,2,22,31,53,117
0131-002,2011,4,22,3,19,27,46,53
0131-002,2011,4,22,4,19,14,33,46
0131-002,2011,4,22,5,29,28,57,33
0131-002,2011,4,22,6,47,43,90,57
0131-002,2011,4,22,7,139,109,248,90
0131-002,2011,4,22,8,496,375,871,248
0131-002,2011,4,22,9,411,428,839,871
0131-002,2011,4,22,10,291,320,611,839
0131-002,2011,4,22,11,299,266,565,611
0131-002,2011,4,22,12,223,289,512,565
0131-002,2011,4,22,13,243,213,456,512
0131-002,2011,4,22,14,263,247,510,456
0131-002,2011,4,22,15,300,288,588,510
0131-002,2011,4,22,16,316,344,660,588
0131-002,2011,4,22,17,273,324,597,660
0131-002,2011,4,22,18,384,369,753,597
0131-002,2011,4,22,19,387,441,828,753
0131-002,2011,4,22,20,292,309,601,828
0131-002,2011,4,22,21,210,247,457,601
0131-002,2011,4,22,22,138,179,317,457
0131-002,2011,4,22,23,109,124,233,317
0131-002,2011,4,22,24,72,73,145,233
0131-002,2011,4,23,1,73,48,121,145
0131-002,2011,4,23,2,28,37,65,121
0131-002,2011,4,23,3,32,32,64,65
0131-002,2011,4,23,4,20,27,47,64
0131-002,2011,4,23,5,21,31,52,47
0131-002,2011,4,23,6,43,50,93,52
0131-002,2011,4,23,7,121,84,205,93
0131-002,2011,4,23,8,324,214,538,205
0131-002,2011,4,23,9,305,283,588,538
0131-002,2011,4,23,10,279,340,619,588
0131-002,2011,4,23,11,305,336,641,619
0131-002,2011,4,23,12,278,501,779,641
0131-002,2011,4,23,13,283,511,794,779
0131-002,2011,4,23,14,285,525,810,794
0131-002,2011,4,23,15,299,508,807,810
0131-002,2011,4,23,16,347,441,788,807
0131-002,2011,4,23,17,311,425,736,788
0131-002,2011,4,23,18,405,485,890,736
0131-002,2011,4,23,19,335,370,705,890
0131-002,2011,4,23,20,255,255,510,705
0131-002,2011,4,23,21,204,195,399,510
0131-002,2011,4,23,22,132,153,285,399
0131-002,2011,4,23,23,118,100,218,285
0131-002,2011,4,23,24,74,72,146,218
0131-002,2011,4,24,1,49,55,104,146
0131-002,2011,4,24,2,30,29,59,104
0131-002,2011,4,24,3,25,26,51,59
0131-002,2011,4,24,4,15,19,34,51
0131-002,2011,4,24,5,27,20,47,34
0131-002,2011,4,24,6,37,29,66,47
0131-002,2011,4,24,7,82,64,146,66
0131-002,2011,4,24,8,163,104,267,146
0131-002,2011,4,24,9,171,175,346,267
0131-002,2011,4,24,10,186,194,380,346
0131-002,2011,4,24,11,188,218,406,380
0131-002,2011,4,24,12,183,181,364,406
0131-002,2011,4,24,13,191,192,383,364
0131-002,2011,4,24,14,227,242,469,383
0131-002,2011,4,24,15,368,228,596,469
0131-002,2011,4,24,16,447,260,707,596
0131-002,2011,4,24,17,481,221,702,707
0131-002,2011,4,24,18,505,229,734,702
0131-002,2011,4,24,19,491,241,732,734
0131-002,2011,4,24,20,484,193,677,732
0131-002,2011,4,24,21,327,173,500,677
0131-002,2011,4,24,22,198,129,327,500
0131-002,2011,4,24,23,135,94,229,327
0131-002,2011,4,24,24,73,61,134,229
0131-002,2011,4,25,1,36,32,68,134
0131-002,2011,4,25,2,26,26,52,68
0131-002,2011,4,25,3,14,11,25,52
0131-002,2011,4,25,4,11,20,31,25
0131-002,2011,4,25,5,23,24,47,31
0131-002,2011,4,25,6,60,50,110,47
0131-002,2011,4,25,7,238,173,411,110
0131-002,2011,4,25,8,597,494,1091,411
0131-002,2011,4,25,9,443,482,925,1091
0131-002,2011,4,25,10,313,370,683,925
0131-002,2011,4,25,11,307,304,611,683
0131-002,2011,4,25,12,252,277,529,611
0131-002,2011,4,25,13,227,270,497,529
0131-002,2011,4,25,14,309,293,602,497
0131-002,2011,4,25,15,319,300,619,602
0131-002,2011,4,25,16,333,350,683,619
0131-002,2011,4,25,17,335,385,720,683
0131-002,2011,4,25,18,386,423,809,720
0131-002,2011,4,25,19,403,386,789,809
0131-002,2011,4,25,20,260,302,562,789
0131-002,2011,4,25,21,194,271,465,562
0131-002,2011,4,25,22,171,199,370,465
0131-002,2011,4,25,23,102,115,217,370
0131-002,2011,4,25,24,73,77,150,217
0131-002,2011,4,26,1,43,39,82,150
0131-002,2011,4,26,2,25,23,48,82
0131-002,2011,4,26,3,21,21,42,48
0131-002,2011,4,26,4,8,15,23,42
0131-002,2011,4,26,5,14,28,42,23
0131-002,2011,4,26,6,46,52,98,42
0131-002,2011,4,26,7,166,102,268,98
0131-002,2011,4,26,8,517,436,953,268
0131-002,2011,4,26,9,456,453,909,953
0131-002,2011,4,26,10,328,365,693,909
0131-002,2011,4,26,11,297,292,589,693
0131-002,2011,4,26,12,289,298,587,589
0131-002,2011,4,26,13,216,268,484,587
0131-002,2011,4,26,14,300,246,546,484
0131-002,2011,4,26,15,295,321,616,546
0131-002,2011,4,26,16,339,330,669,616
0131-002,2011,4,26,17,296,291,587,669
0131-002,2011,4,26,18,273,376,649,587
0131-002,2011,4,26,19,330,400,730,649
0131-002,2011,4,26,20,259,250,509,730
0131-002,2011,4,26,21,205,238,443,509
0131-002,2011,4,26,22,159,205,364,443
0131-002,2011,4,26,23,112,118,230,364
0131-002,2011,4,26,24,72,59,131,230
0131-002,2011,4,27,1,46,38,84,131
0131-002,2011,4,27,2,22,24,46,84
0131-002,2011,4,27,3,26,18,44,46
0131-002,2011,4,27,4,14,17,31,44
0131-002,2011,4,27,5,13,26,39,31
0131-002,2011,4,27,6,59,40,99,39
0131-002,2011,4,27,7,193,106,299,99
0131-002,2011,4,27,8,502,425,927,299
0131-002,2011,4,27,9,458,486,944,927
0131-002,2011,4,27,10,353,341,694,944
0131-002,2011,4,27,11,368,293,661,694
0131-002,2011,4,27,12,285,317,602,661
0131-002,2011,4,27,13,261,270,531,602
0131-002,2011,4,27,14,313,310,623,531
0131-002,2011,4,27,15,328,368,696,623
0131-002,2011,4,27,16,374,344,718,696
0131-002,2011,4,27,17,338,343,681,718
0131-002,2011,4,27,18,349,421,770,681
0131-002,2011,4,27,19,355,446,801,770
0131-002,2011,4,27,20,272,290,562,801
0131-002,2011,4,27,21,219,237,456,562
0131-002,2011,4,27,22,163,199,362,456
0131-002,2011,4,27,23,120,114,234,362
0131-002,2011,4,27,24,73,79,152,234
0131-002,2011,4,28,1,58,47,105,152
0131-002,2011,4,28,2,27,25,52,105
0131-002,2011,4,28,3,17,19,36,52
0131-002,2011,4,28,4,10,22,32,36
0131-002,2011,4,28,5,25,30,55,32
0131-002,2011,4,28,6,52,46,98,55
0131-002,2011,4,28,7,169,126,295,98
0131-002,2011,4,28,8,562,441,1003,295
0131-002,2011,4,28,9,434,485,919,1003
0131-002,2011,4,28,10,342,372,714,919
0131-002,2011,4,28,11,304,308,612,714
0131-002,2011,4,28,12,268,291,559,612
0131-002,2011,4,28,13,267,260,527,559
0131-002,2011,4,28,14,265,303,568,527
0131-002,2011,4,28,15,348,325,673,568
0131-002,2011,4,28,16,326,328,654,673
0131-002,2011,4,28,17,330,356,686,654
0131-002,2011,4,28,18,371,407,778,686
0131-002,2011,4,28,19,417,429,846,778
0131-002,2011,4,28,20,269,315,584,846
0131-002,2011,4,28,21,197,258,455,584
0131-002,2011,4,28,22,182,184,366,455
0131-002,2011,4,28,23,117,140,257,366
0131-002,2011,4,28,24,83,80,163,257
0131-002,2011,4,29,1,46,57,103,163
0131-002,2011,4,29,2,33,36,69,103
0131-002,2011,4,29,3,18,27,45,69
0131-002,2011,4,29,4,12,14,26,45
0131-002,2011,4,29,5,25,17,42,26
0131-002,2011,4,29,6,54,39,93,42
0131-002,2011,4,29,7,207,132,339,93
0131-002,2011,4,29,8,545,435,980,339
0131-002,2011,4,29,9,466,482,948,980
0131-002,2011,4,29,10,371,313,684,948
0131-002,2011,4,29,11,355,318,673,684
0131-002,2011,4,29,12,304,336,640,673
0131-002,2011,4,29,13,277,280,557,640
0131-002,2011,4,29,14,326,325,651,557
0131-002,2011,4,29,15,370,367,737,651
0131-002,2011,4,29,16,381,354,735,737
0131-002,2011,4,29,17,342,373,715,735
0131-002,2011,4,29,18,427,433,860,715
0131-002,2011,4,29,19,438,427,865,860
0131-002,2011,4,29,20,330,366,696,865
0131-002,2011,4,29,21,223,264,487,696
0131-002,2011,4,29,22,169,201,370,487
0131-002,2011,4,29,23,147,130,277,370
0131-002,2011,4,29,24,101,79,180,277
0131-002,2011,4,30,1,63,53,116,180
0131-002,2011,4,30,2,38,32,70,116
0131-002,2011,4,30,3,24,16,40,70
0131-002,2011,4,30,4,18,20,38,40
0131-002,2011,4,30,5,27,29,56,38
0131-002,2011,4,30,6,31,35,66,56
0131-002,2011,4,30,7,93,46,139,66
0131-002,2011,4,30,8,282,214,496,139
0131-002,2011,4,30,9,318,307,625,496
0131-002,2011,4,30,10,282,253,535,625
0131-002,2011,4,30,11,257,312,569,535
0131-002,2011,4,30,12,259,292,551,569
0131-002,2011,4,30,13,255,307,562,551
0131-002,2011,4,30,14,268,304,572,562
0131-002,2011,4,30,15,353,315,668,572
0131-002,2011,4,30,16,300,363,663,668
0131-002,2011,4,30,17,318,339,657,663
0131-002,2011,4,30,18,364,419,783,657
0131-002,2011,4,30,19,330,351,681,783
0131-002,2011,4,30,20,200,188,388,681
0131-002,2011,4,30,21,132,163,295,388
0131-002,2011,4,30,22,116,130,246,295
0131-002,2011,4,30,23,100,95,195,246
0131-002,2011,4,30,24,68,63,131,195
0131-002,2011,5,1,1,27,35,62,131
0131-002,2011,5,1,2,27,33,60,62
0131-002,2011,5,1,3,14,14,28,60
0131-002,2011,5,1,4,13,15,28,28
0131-002,2011,5,1,5,16,19,35,28
0131-002,2011,5,1,6,31,18,49,35
0131-002,2011,5,1,7,57,62,119,49
0131-002,2011,5,1,8,115,96,211,119
0131-002,2011,5,1,9,157,143,300,211
0131-002,2011,5,1,10,182,143,325,300
0131-002,2011,5,1,11,193,192,385,325
0131-002,2011,5,1,12,191,208,399,385
0131-002,2011,5,1,13,189,221,410,399
0131-002,2011,5,1,14,250,215,465,410
0131-002,2011,5,1,15,255,215,470,465
0131-002,2011,5,1,16,264,242,506,470
0131-002,2011,5,1,17,360,265,625,506
0131-002,2011,5,1,18,457,251,708,625
0131-002,2011,5,1,19,410,203,613,708
0131-002,2011,5,1,20,331,208,539,613
0131-002,2011,5,1,21,212,157,369,539
0131-002,2011,5,1,22,194,136,330,369
0131-002,2011,5,1,23,101,98,199,330
0131-002,2011,5,1,24,68,57,125,199
0131-002,2011,5,2,1,40,42,82,125
0131-002,2011,5,2,2,12,30,42,82
0131-002,2011,5,2,3,11,10,21,42
0131-002,2011,5,2,4,14,21,35,21
0131-002,2011,5,2,5,19,28,47,35
0131-002,2011,5,2,6,47,51,98,47
0131-002,2011,5,2,7,229,154,383,98
0131-002,2011,5,2,8,585,492,1077,383
0131-002,2011,5,2,9,419,493,912,1077
0131-002,2011,5,2,10,305,314,619,912
0131-002,2011,5,2,11,333,320,653,619
0131-002,2011,5,2,12,302,330,632,653
0131-002,2011,5,2,13,248,271,519,632
0131-002,2011,5,2,14,302,303,605,519
0131-002,2011,5,2,15,340,371,711,605
0131-002,2011,5,2,16,329,372,701,711
0131-002,2011,5,2,17,325,336,661,701
0131-002,2011,5,2,18,366,403,769,661
0131-002,2011,5,2,19,378,451,829,769
0131-002,2011,5,2,20,268,316,584,829
0131-002,2011,5,2,21,229,237,466,584
0131-002,2011,5,2,22,186,194,380,466
0131-002,2011,5,2,23,135,152,287,380
0131-002,2011,5,2,24,77,80,157,287
0131-002,2011,5,3,1,39,45,84,157
0131-002,2011,5,3,2,31,34,65,84
0131-002,2011,5,3,3,18,16,34,65
0131-002,2011,5,3,4,11,17,28,34
0131-002,2011,5,3,5,22,28,50,28
0131-002,2011,5,3,6,45,50,95,50
0131-002,2011,5,3,7,212,124,336,95
0131-002,2011,5,3,8,527,426,953,336
0131-002,2011,5,3,9,421,475,896,953
0131-002,2011,5,3,10,333,341,674,896
0131-002,2011,5,3,11,300,312,612,674
0131-002,2011,5,3,12,276,293,569,612
0131-002,2011,5,3,13,240,257,497,569
0131-002,2011,5,3,14,316,301,617,497
0131-002,2011,5,3,15,325,338,663,617
0131-002,2011,5,3,16,357,344,701,663
0131-002,2011,5,3,17,352,322,674,701
0131-002,2011,5,3,18,351,403,754,674
0131-002,2011,5,3,19,355,435,790,754
0131-002,2011,5,3,20,270,341,611,790
0131-002,2011,5,3,21,240,259,499,611
0131-002,2011,5,3,22,183,212,395,499
0131-002,2011,5,3,23,137,136,273,395
0131-002,2011,5,3,24,85,84,169,273
0131-002,2011,5,4,1,40,51,91,169
0131-002,2011,5,4,2,23,38,61,91
0131-002,2011,5,4,3,22,32,54,61
0131-002,2011,5,4,4,19,24,43,54
0131-002,2011,5,4,5,22,33,55,43
0131-002,2011,5,4,6,61,38,99,55
0131-002,2011,5,4,7,197,130,327,99
0131-002,2011,5,4,8,519,423,942,327
0131-002,2011,5,4,9,439,466,905,942
0131-002,2011,5,4,10,351,346,697,905
0131-002,2011,5,4,11,328,352,680,697
0131-002,2011,5,4,12,288,307,595,680
0131-002,2011,5,4,13,256,264,520,595
0131-002,2011,5,4,14,311,326,637,520
0131-002,2011,5,4,15,367,344,711,637
0131-002,2011,5,4,16,391,365,756,711
0131-002,2011,5,4,17,369,381,750,756
0131-002,2011,5,4,18,451,482,933,750
0131-002,2011,5,4,19,478,543,1021,933
0131-002,2011,5,4,20,351,398,749,1021
0131-002,2011,5,4,21,296,307,603,749
0131-002,2011,5,4,22,191,261,452,603
0131-002,2011,5,4,23,158,152,310,452
0131-002,2011,5,4,24,97,78,175,310
0131-002,2011,5,5,1,55,73,128,175
0131-002,2011,5,5,2,39,59,98,128
0131-002,2011,5,5,3,35,25,60,98
0131-002,2011,5,5,4,24,29,53,60
0131-002,2011,5,5,5,19,21,40,53
0131-002,2011,5,5,6,52,57,109,40
0131-002,2011,5,5,7,116,93,209,109
0131-002,2011,5,5,8,269,202,471,209
0131-002,2011,5,5,9,241,278,519,471
0131-002,2011,5,5,10,242,330,572,519
0131-002,2011,5,5,11,232,443,675,572
0131-002,2011,5,5,12,257,487,744,675
0131-002,2011,5,5,13,222,488,710,744
0131-002,2011,5,5,14,218,438,656,710
0131-002,2011,5,5,15,239,295,534,656
0131-002,2011,5,5,16,253,256,509,534
0131-002,2011,5,5,17,275,237,512,509
0131-002,2011,5,5,18,312,320,632,512
0131-002,2011,5,5,19,285,291,576,632
0131-002,2011,5,5,20,221,264,485,576
0131-002,2011,5,5,21,204,201,405,485
0131-002,2011,5,5,22,171,157,328,405
0131-002,2011,5,5,23,108,102,210,328
0131-002,2011,5,5,24,62,81,143,210
0131-002,2011,5,6,1,39,47,86,143
0131-002,2011,5,6,2,27,24,51,86
0131-002,2011,5,6,3,11,26,37,51
0131-002,2011,5,6,4,17,20,37,37
0131-002,2011,5,6,5,23,24,47,37
0131-002,2011,5,6,6,49,56,105,47
0131-002,2011,5,6,7,205,118,323,105
0131-002,2011,5,6,8,532,454,986,323
0131-002,2011,5,6,9,437,443,880,986
0131-002,2011,5,6,10,357,310,667,880
0131-002,2011,5,6,11,313,327,640,667
0131-002,2011,5,6,12,269,356,625,640
0131-002,2011,5,6,13,245,301,546,625
0131-002,2011,5,6,14,285,312,597,546
0131-002,2011,5,6,15,378,344,722,597
0131-002,2011,5,6,16,359,401,760,722
0131-002,2011,5,6,17,356,384,740,760
0131-002,2011,5,6,18,395,456,851,740
0131-002,2011,5,6,19,410,463,873,851
0131-002,2011,5,6,20,282,340,622,873
0131-002,2011,5,6,21,245,272,517,622
0131-002,2011,5,6,22,178,220,398,517
0131-002,2011,5,6,23,126,148,274,398
0131-002,2011,5,6,24,93,86,179,274
0131-002,2011,5,7,1,43,63,106,179
0131-002,2011,5,7,2,29,38,67,106
0131-002,2011,5,7,3,17,28,45,67
0131-002,2011,5,7,4,25,21,46,45
0131-002,2011,5,7,5,22,31,53,46
0131-002,2011,5,7,6,42,47,89,53
0131-002,2011,5,7,7,125,74,199,89
0131-002,2011,5,7,8,296,229,525,199
0131-002,2011,5,7,9,329,301,630,525
0131-002,2011,5,7,10,253,358,611,630
0131-002,2011,5,7,11,281,522,803,611
0131-002,2011,5,7,12,340,707,1047,803
0131-002,2011,5,7,13,298,785,1083,1047
0131-002,2011,5,7,14,301,767,1068,1083
0131-002,2011,5,7,15,345,863,1208,1068
0131-002,2011,5,7,16,418,924,1342,1208
0131-002,2011,5,7,17,507,1002,1509,1342
0131-002,2011,5,7,18,547,1077,1624,1509
0131-002,2011,5,7,19,500,825,1325,1624
0131-002,2011,5,7,20,450,779,1229,1325
0131-002,2011,5,7,21,411,753,1164,1229
0131-002,2011,5,7,22,241,755,996,1164
0131-002,2011,5,7,23,166,626,792,996
0131-002,2011,5,7,24,75,429,504,792
0131-002,2011,5,8,1,42,139,181,504
0131-002,2011,5,8,2,30,36,66,181
0131-002,2011,5,8,3,21,27,48,66
0131-002,2011,5,8,4,12,20,32,48
0131-002,2011,5,8,5,19,24,43,32
0131-002,2011,5,8,6,27,28,55,43
0131-002,2011,5,8,7,86,72,158,55
0131-002,2011,5,8,8,120,105,225,158
0131-002,2011,5,8,9,138,168,306,225
0131-002,2011,5,8,10,180,212,392,306
0131-002,2011,5,8,11,230,298,528,392
0131-002,2011,5,8,12,337,339,676,528
0131-002,2011,5,8,13,476,310,786,676
0131-002,2011,5,8,14,482,261,743,786
0131-002,2011,5,8,15,512,275,787,743
0131-002,2011,5,8,16,578,333,911,787
0131-002,2011,5,8,17,555,343,898,911
0131-002,2011,5,8,18,551,338,889,898
0131-002,2011,5,8,19,517,312,829,889
0131-002,2011,5,8,20,484,247,731,829
0131-002,2011,5,8,21,550,215,765,731
0131-002,2011,5,8,22,500,179,679,765
0131-002,2011,5,8,23,518,130,648,679
0131-002,2011,5,8,24,463,87,550,648
0131-002,2011,5,9,1,443,56,499,550
0131-002,2011,5,9,2,341,24,365,499
0131-002,2011,5,9,3,32,17,49,365
0131-002,2011,5,9,4,13,28,41,49
0131-002,2011,5,9,5,19,32,51,41
0131-002,2011,5,9,6,48,44,92,51
0131-002,2011,5,9,7,204,140,344,92
0131-002,2011,5,9,8,511,427,938,344
0131-002,2011,5,9,9,435,426,861,938
0131-002,2011,5,9,10,279,353,632,861
0131-002,2011,5,9,11,340,323,663,632
0131-002,2011,5,9,12,296,300,596,663
0131-002,2011,5,9,13,285,309,594,596
0131-002,2011,5,9,14,290,335,625,594
0131-002,2011,5,9,15,308,377,685,625
0131-002,2011,5,9,16,373,341,714,685
0131-002,2011,5,9,17,315,372,687,714
0131-002,2011,5,9,18,389,403,792,687
0131-002,2011,5,9,19,419,393,812,792
0131-002,2011,5,9,20,336,279,615,812
0131-002,2011,5,9,21,248,237,485,615
0131-002,2011,5,9,22,180,192,372,485
0131-002,2011,5,9,23,120,111,231,372
0131-002,2011,5,9,24,86,73,159,231
0131-002,2011,5,10,1,53,50,103,159
0131-002,2011,5,10,2,23,43,66,103
0131-002,2011,5,10,3,16,27,43,66
0131-002,2011,5,10,4,19,23,42,43
0131-002,2011,5,10,5,20,23,43,42
0131-002,2011,5,10,6,34,30,64,43
0131-002,2011,5,10,7,112,74,186,64
0131-002,2011,5,10,8,217,181,398,186
0131-002,2011,5,10,9,243,241,484,398
0131-002,2011,5,10,10,241,250,491,484
0131-002,2011,5,10,11,229,244,473,491
0131-002,2011,5,10,12,222,268,490,473
0131-002,2011,5,10,13,208,218,426,490
0131-002,2011,5,10,14,293,236,529,426
0131-002,2011,5,10,15,355,271,626,529
0131-002,2011,5,10,16,357,246,603,626
0131-002,2011,5,10,17,386,252,638,603
0131-002,2011,5,10,18,434,274,708,638
0131-002,2011,5,10,19,428,268,696,708
0131-002,2011,5,10,20,236,188,424,696
0131-002,2011,5,10,21,138,153,291,424
0131-002,2011,5,10,22,119,111,230,291
0131-002,2011,5,10,23,84,103,187,230
0131-002,2011,5,10,24,54,63,117,187
0131-002,2011,5,11,1,43,36,79,117
0131-002,2011,5,11,2,16,23,39,79
0131-002,2011,5,11,3,11,19,30,39
0131-002,2011,5,11,4,6,9,15,30
0131-002,2011,5,11,5,16,27,43,15
0131-002,2011,5,11,6,39,39,78,43
0131-002,2011,5,11,7,188,101,289,78
0131-002,2011,5,11,8,506,429,935,289
0131-002,2011,5,11,9,456,479,935,935
0131-002,2011,5,11,10,340,319,659,935
0131-002,2011,5,11,11,320,300,620,659
0131-002,2011,5,11,12,310,310,620,620
0131-002,2011,5,11,13,242,286,528,620
0131-002,2011,5,11,14,294,295,589,528
0131-002,2011,5,11,15,318,354,672,589
0131-002,2011,5,11,16,345,343,688,672
0131-002,2011,5,11,17,304,317,621,688
0131-002,2011,5,11,18,326,376,702,621
0131-002,2011,5,11,19,338,430,768,702
0131-002,2011,5,11,20,283,314,597,768
0131-002,2011,5,11,21,216,248,464,597
0131-002,2011,5,11,22,168,209,377,464
0131-002,2011,5,11,23,110,146,256,377
0131-002,2011,5,11,24,72,74,146,256
0131-002,2011,5,12,1,46,49,95,146
0131-002,2011,5,12,2,24,33,57,95
0131-002,2011,5,12,3,22,30,52,57
0131-002,2011,5,12,4,11,12,23,52
0131-002,2011,5,12,5,24,26,50,23
0131-002,2011,5,12,6,56,56,112,50
0131-002,2011,5,12,7,195,102,297,112
0131-002,2011,5,12,8,524,427,951,297
0131-002,2011,5,12,9,472,476,948,951
0131-002,2011,5,12,10,381,372,753,948
0131-002,2011,5,12,11,324,345,669,753
0131-002,2011,5,12,12,286,289,575,669
0131-002,2011,5,12,13,228,270,498,575
0131-002,2011,5,12,14,291,299,590,498
0131-002,2011,5,12,15,328,380,708,590
0131-002,2011,5,12,16,366,343,709,708
0131-002,2011,5,12,17,386,368,754,709
0131-002,2011,5,12,18,336,427,763,754
0131-002,2011,5,12,19,375,426,801,763
0131-002,2011,5,12,20,275,340,615,801
0131-002,2011,5,12,21,238,276,514,615
0131-002,2011,5,12,22,196,217,413,514
0131-002,2011,5,12,23,156,133,289,413
0131-002,2011,5,12,24,79,84,163,289
0131-002,2011,5,13,1,52,61,113,163
0131-002,2011,5,13,2,18,41,59,113
0131-002,2011,5,13,3,25,25,50,59
0131-002,2011,5,13,4,17,20,37,50
0131-002,2011,5,13,5,28,33,61,37
0131-002,2011,5,13,6,67,42,109,61
0131-002,2011,5,13,7,200,123,323,109
0131-002,2011,5,13,8,558,430,988,323
0131-002,2011,5,13,9,453,446,899,988
0131-002,2011,5,13,10,344,344,688,899
0131-002,2011,5,13,11,335,360,695,688
0131-002,2011,5,13,12,267,343,610,695
0131-002,2011,5,13,13,252,304,556,610
0131-002,2011,5,13,14,355,349,704,556
0131-002,2011,5,13,15,304,349,653,704
0131-002,2011,5,13,16,378,364,742,653
0131-002,2011,5,13,17,365,382,747,742
0131-002,2011,5,13,18,443,448,891,747
0131-002,2011,5,13,19,460,540,1000,891
0131-002,2011,5,13,20,346,396,742,1000
0131-002,2011,5,13,21,252,319,571,742
0131-002,2011,5,13,22,224,228,452,571
0131-002,2011,5,13,23,155,175,330,452
0131-002,2011,5,13,24,101,91,192,330
0131-002,2011,5,14,1,69,75,144,192
0131-002,2011,5,14,2,37,48,85,144
0131-002,2011,5,14,3,27,25,52,85
0131-002,2011,5,14,4,21,39,60,52
0131-002,2011,5,14,5,33,24,57,60
0131-002,2011,5,14,6,73,56,129,57
0131-002,2011,5,14,7,166,103,269,129
0131-002,2011,5,14,8,345,285,630,269
0131-002,2011,5,14,9,360,311,671,630
0131-002,2011,5,14,10,319,370,689,671
0131-002,2011,5,14,11,308,465,773,689
0131-002,2011,5,14,12,322,591,913,773
0131-002,2011,5,14,13,267,623,890,913
0131-002,2011,5,14,14,298,575,873,890
0131-002,2011,5,14,15,340,539,879,873
0131-002,2011,5,14,16,333,461,794,879
0131-002,2011,5,14,17,388,600,988,794
0131-002,2011,5,14,18,459,571,1030,988
0131-002,2011,5,14,19,505,536,1041,1030
0131-002,2011,5,14,20,341,316,657,1041
0131-002,2011,5,14,21,202,225,427,657
0131-002,2011,5,14,22,177,175,352,427
0131-002,2011,5,14,23,146,136,282,352
0131-002,2011,5,14,24,77,81,158,282
0131-002,2011,5,15,1,38,66,104,158
0131-002,2011,5,15,2,41,45,86,104
0131-002,2011,5,15,3,22,29,51,86
0131-002,2011,5,15,4,23,22,45,51
0131-002,2011,5,15,5,18,30,48,45
0131-002,2011,5,15,6,33,38,71,48
0131-002,2011,5,15,7,91,65,156,71
0131-002,2011,5,15,8,145,137,282,156
0131-002,2011,5,15,9,145,165,310,282
0131-002,2011,5,15,10,174,186,360,310
0131-002,2011,5,15,11,197,226,423,360
0131-002,2011,5,15,12,199,234,433,423
0131-002,2011,5,15,13,318,240,558,433
0131-002,2011,5,15,14,388,253,641,558
0131-002,2011,5,15,15,384,230,614,641
0131-002,2011,5,15,16,485,241,726,614
0131-002,2011,5,15,17,520,289,809,726
0131-002,2011,5,15,18,543,283,826,809
0131-002,2011,5,15,19,565,261,826,826
0131-002,2011,5,15,20,455,191,646,826
0131-002,2011,5,15,21,376,183,559,646
0131-002,2011,5,15,22,262,156,418,559
0131-002,2011,5,15,23,144,104,248,418
0131-002,2011,5,15,24,92,83,175,248
0131-002,2011,5,16,1,56,59,115,175
0131-002,2011,5,16,2,19,33,52,115
0131-002,2011,5,16,3,14,24,38,52
0131-002,2011,5,16,4,15,10,25,38
0131-002,2011,5,16,5,21,26,47,25
0131-002,2011,5,16,6,54,63,117,47
0131-002,2011,5,16,7,256,150,406,117
0131-002,2011,5,16,8,573,518,1091,406
0131-002,2011,5,16,9,484,516,1000,1091
0131-002,2011,5,16,10,355,337,692,1000
0131-002,2011,5,16,11,312,336,648,692
0131-002,2011,5,16,12,288,358,646,648
0131-002,2011,5,16,13,247,280,527,646
0131-002,2011,5,16,14,283,307,590,527
0131-002,2011,5,16,15,323,344,667,590
0131-002,2011,5,16,16,331,358,689,667
0131-002,2011,5,16,17,354,336,690,689
0131-002,2011,5,16,18,353,410,763,690
0131-002,2011,5,16,19,388,457,845,763
0131-002,2011,5,16,20,291,346,637,845
0131-002,2011,5,16,21,247,290,537,637
0131-002,2011,5,16,22,214,234,448,537
0131-002,2011,5,16,23,132,154,286,448
0131-002,2011,5,16,24,81,80,161,286
0131-002,2011,5,17,1,50,52,102,161
0131-002,2011,5,17,2,23,33,56,102
0131-002,2011,5,17,3,23,21,44,56
0131-002,2011,5,17,4,17,21,38,44
0131-002,2011,5,17,5,21,30,51,38
0131-002,2011,5,17,6,78,53,131,51
0131-002,2011,5,17,7,236,132,368,131
0131-002,2011,5,17,8,565,478,1043,368
0131-002,2011,5,17,9,455,507,962,1043
0131-002,2011,5,17,10,339,340,679,962
0131-002,2011,5,17,11,337,375,712,679
0131-002,2011,5,17,12,295,303,598,712
0131-002,2011,5,17,13,230,269,499,598
0131-002,2011,5,17,14,315,277,592,499
0131-002,2011,5,17,15,332,325,657,592
0131-002,2011,5,17,16,301,383,684,657
0131-002,2011,5,17,17,317,375,692,684
0131-002,2011,5,17,18,405,408,813,692
0131-002,2011,5,17,19,364,470,834,813
0131-002,2011,5,17,20,291,353,644,834
0131-002,2011,5,17,21,231,287,518,644
0131-002,2011,5,17,22,217,254,471,518
0131-002,2011,5,17,23,142,137,279,471
0131-002,2011,5,17,24,95,88,183,279
0131-002,2011,5,18,1,52,45,97,183
0131-002,2011,5,18,2,27,36,63,97
0131-002,2011,5,18,3,22,18,40,63
0131-002,2011,5,18,4,15,27,42,40
0131-002,2011,5,18,5,21,35,56,42
0131-002,2011,5,18,6,55,61,116,56
0131-002,2011,5,18,7,254,142,396,116
0131-002,2011,5,18,8,549,472,1021,396
0131-002,2011,5,18,9,465,527,992,1021
0131-002,2011,5,18,10,367,342,709,992
0131-002,2011,5,18,11,332,338,670,709
0131-002,2011,5,18,12,285,303,588,670
0131-002,2011,5,18,13,273,275,548,588
0131-002,2011,5,18,14,279,331,610,548
0131-002,2011,5,18,15,326,337,663,610
0131-002,2011,5,18,16,346,360,706,663
0131-002,2011,5,18,17,323,374,697,706
0131-002,2011,5,18,18,381,491,872,697
0131-002,2011,5,18,19,418,470,888,872
0131-002,2011,5,18,20,299,366,665,888
0131-002,2011,5,18,21,247,267,514,665
0131-002,2011,5,18,22,222,191,413,514
0131-002,2011,5,18,23,121,138,259,413
0131-002,2011,5,18,24,93,91,184,259
0131-002,2011,5,19,1,52,72,124,184
0131-002,2011,5,19,2,34,34,68,124
0131-002,2011,5,19,3,17,28,45,68
0131-002,2011,5,19,4,24,22,46,45
0131-002,2011,5,19,5,27,30,57,46
0131-002,2011,5,19,6,66,56,122,57
0131-002,2011,5,19,7,240,146,386,122
0131-002,2011,5,19,8,564,473,1037,386
0131-002,2011,5,19,9,487,492,979,1037
0131-002,2011,5,19,10,320,366,686,979
0131-002,2011,5,19,11,346,309,655,686
0131-002,2011,5,19,12,267,322,589,655
0131-002,2011,5,19,13,246,292,538,589
0131-002,2011,5,19,14,330,313,643,538
0131-002,2011,5,19,15,343,364,707,643
0131-002,2011,5,19,16,332,373,705,707
0131-002,2011,5,19,17,348,347,695,705
0131-002,2011,5,19,18,403,440,843,695
0131-002,2011,5,19,19,386,466,852,843
0131-002,2011,5,19,20,319,309,628,852
0131-002,2011,5,19,21,250,293,543,628
0131-002,2011,5,19,22,206,229,435,543
0131-002,2011,5,19,23,148,136,284,435
0131-002,2011,5,19,24,94,97,191,284
0131-002,2011,5,20,1,54,74,128,191
0131-002,2011,5,20,2,34,26,60,128
0131-002,2011,5,20,3,21,26,47,60
0131-002,2011,5,20,4,16,28,44,47
0131-002,2011,5,20,5,29,35,64,44
0131-002,2011,5,20,6,55,61,116,64
0131-002,2011,5,20,7,221,131,352,116
0131-002,2011,5,20,8,577,476,1053,352
0131-002,2011,5,20,9,468,513,981,1053
0131-002,2011,5,20,10,342,363,705,981
0131-002,2011,5,20,11,332,376,708,705
0131-002,2011,5,20,12,312,325,637,708
0131-002,2011,5,20,13,244,289,533,637
0131-002,2011,5,20,14,289,334,623,533
0131-002,2011,5,20,15,341,364,705,623
0131-002,2011,5,20,16,348,352,700,705
0131-002,2011,5,20,17,347,387,734,700
0131-002,2011,5,20,18,432,451,883,734
0131-002,2011,5,20,19,458,499,957,883
0131-002,2011,5,20,20,344,355,699,957
0131-002,2011,5,20,21,255,305,560,699
0131-002,2011,5,20,22,184,223,407,560
0131-002,2011,5,20,23,129,167,296,407
0131-002,2011,5,20,24,109,94,203,296
0131-002,2011,5,21,1,52,72,124,203
0131-002,2011,5,21,2,36,50,86,124
0131-002,2011,5,21,3,21,18,39,86
0131-002,2011,5,21,4,19,15,34,39
0131-002,2011,5,21,5,28,33,61,34
0131-002,2011,5,21,6,42,44,86,61
0131-002,2011,5,21,7,154,81,235,86
0131-002,2011,5,21,8,317,253,570,235
0131-002,2011,5,21,9,325,355,680,570
0131-002,2011,5,21,10,344,287,631,680
0131-002,2011,5,21,11,298,377,675,631
0131-002,2011,5,21,12,300,409,709,675
0131-002,2011,5,21,13,336,442,778,709
0131-002,2011,5,21,14,346,470,816,778
0131-002,2011,5,21,15,352,553,905,816
0131-002,2011,5,21,16,322,480,802,905
0131-002,2011,5,21,17,377,512,889,802
0131-002,2011,5,21,18,507,539,1046,889
0131-002,2011,5,21,19,498,491,989,1046
0131-002,2011,5,21,20,261,367,628,989
0131-002,2011,5,21,21,218,208,426,628
0131-002,2011,5,21,22,154,171,325,426
0131-002,2011,5,21,23,106,120,226,325
0131-002,2011,5,21,24,72,82,154,226
0131-002,2011,5,22,1,49,63,112,154
0131-002,2011,5,22,2,38,28,66,112
0131-002,2011,5,22,3,26,37,63,66
0131-002,2011,5,22,4,17,24,41,63
0131-002,2011,5,22,5,22,27,49,41
0131-002,2011,5,22,6,27,30,57,49
0131-002,2011,5,22,7,107,72,179,57
0131-002,2011,5,22,8,133,157,290,179
0131-002,2011,5,22,9,166,184,350,290
0131-002,2011,5,22,10,183,193,376,350
0131-002,2011,5,22,11,182,216,398,376
0131-002,2011,5,22,12,244,246,490,398
0131-002,2011,5,22,13,233,234,467,490
0131-002,2011,5,22,14,241,236,477,467
0131-002,2011,5,22,15,295,265,560,477
0131-002,2011,5,22,16,331,249,580,560
0131-002,2011,5,22,17,450,272,722,580
0131-002,2011,5,22,18,382,287,669,722
0131-002,2011,5,22,19,444,293,737,669
0131-002,2011,5,22,20,218,213,431,737
0131-002,2011,5,22,21,269,202,471,431
0131-002,2011,5,22,22,197,200,397,471
0131-002,2011,5,22,23,135,119,254,397
0131-002,2011,5,22,24,58,91,149,254
0131-002,2011,5,23,1,32,50,82,149
0131-002,2011,5,23,2,23,28,51,82
0131-002,2011,5,23,3,10,18,28,51
0131-002,2011,5,23,4,18,13,31,28
0131-002,2011,5,23,5,21,31,52,31
0131-002,2011,5,23,6,80,70,150,52
0131-002,2011,5,23,7,257,173,430,150
0131-002,2011,5,23,8,610,504,1114,430
0131-002,2011,5,23,9,459,511,970,1114
0131-002,2011,5,23,10,373,321,694,970
0131-002,2011,5,23,11,343,361,704,694
0131-002,2011,5,23,12,302,321,623,704
0131-002,2011,5,23,13,239,297,536,623
0131-002,2011,5,23,14,297,323,620,536
0131-002,2011,5,23,15,343,355,698,620
0131-002,2011,5,23,16,389,317,706,698
0131-002,2011,5,23,17,376,375,751,706
0131-002,2011,5,23,18,359,417,776,751
0131-002,2011,5,23,19,381,523,904,776
0131-002,2011,5,23,20,299,371,670,904
0131-002,2011,5,23,21,276,290,566,670
0131-002,2011,5,23,22,182,260,442,566
0131-002,2011,5,23,23,136,141,277,442
0131-002,2011,5,23,24,96,86,182,277
0131-002,2011,5,24,1,40,66,106,182
0131-002,2011,5,24,2,23,25,48,106
0131-002,2011,5,24,3,20,19,39,48
0131-002,2011,5,24,4,25,23,48,39
0131-002,2011,5,24,5,24,30,54,48
0131-002,2011,5,24,6,66,69,135,54
0131-002,2011,5,24,7,231,138,369,135
0131-002,2011,5,24,8,583,482,1065,369
0131-002,2011,5,24,9,458,493,951,1065
0131-002,2011,5,24,10,314,345,659,951
0131-002,2011,5,24,11,316,323,639,659
0131-002,2011,5,24,12,275,304,579,639
0131-002,2011,5,24,13,248,286,534,579
0131-002,2011,5,24,14,304,377,681,534
0131-002,2011,5,24,15,327,349,676,681
0131-002,2011,5,24,16,371,339,710,676
0131-002,2011,5,24,17,345,371,716,710
0131-002,2011,5,24,18,422,422,844,716
0131-002,2011,5,24,19,391,478,869,844
0131-002,2011,5,24,20,283,351,634,869
0131-002,2011,5,24,21,239,307,546,634
0131-002,2011,5,24,22,197,232,429,546
0131-002,2011,5,24,23,135,156,291,429
0131-002,2011,5,24,24,102,74,176,291
0131-002,2011,5,25,1,53,62,115,176
0131-002,2011,5,25,2,38,37,75,115
0131-002,2011,5,25,3,22,35,57,75
0131-002,2011,5,25,4,15,22,37,57
0131-002,2011,5,25,5,26,32,58,37
0131-002,2011,5,25,6,73,60,133,58
0131-002,2011,5,25,7,230,141,371,133
0131-002,2011,5,25,8,605,456,1061,371
0131-002,2011,5,25,9,456,507,963,1061
0131-002,2011,5,25,10,381,348,729,963
0131-002,2011,5,25,11,317,346,663,729
0131-002,2011,5,25,12,330,321,651,663
0131-002,2011,5,25,13,273,292,565,651
0131-002,2011,5,25,14,325,318,643,565
0131-002,2011,5,25,15,371,346,717,643
0131-002,2011,5,25,16,329,374,703,717
0131-002,2011,5,25,17,379,403,782,703
0131-002,2011,5,25,18,398,463,861,782
0131-002,2011,5,25,19,414,457,871,861
0131-002,2011,5,25,20,310,356,666,871
0131-002,2011,5,25,21,240,268,508,666
0131-002,2011,5,25,22,190,226,416,508
0131-002,2011,5,25,23,147,121,268,416
0131-002,2011,5,25,24,81,75,156,268
0131-002,2011,5,26,1,46,46,92,156
0131-002,2011,5,26,2,31,32,63,92
0131-002,2011,5,26,3,19,30,49,63
0131-002,2011,5,26,4,21,21,42,49
0131-002,2011,5,26,5,20,31,51,42
0131-002,2011,5,26,6,60,59,119,51
0131-002,2011,5,26,7,228,135,363,119
0131-002,2011,5,26,8,531,427,958,363
0131-002,2011,5,26,9,463,495,958,958
0131-002,2011,5,26,10,340,341,681,958
0131-002,2011,5,26,11,353,309,662,681
0131-002,2011,5,26,12,264,317,581,662
0131-002,2011,5,26,13,251,302,553,581
0131-002,2011,5,26,14,304,306,610,553
0131-002,2011,5,26,15,377,365,742,610
0131-002,2011,5,26,16,322,352,674,742
0131-002,2011,5,26,17,349,343,692,674
0131-002,2011,5,26,18,327,407,734,692
0131-002,2011,5,26,19,356,456,812,734
0131-002,2011,5,26,20,257,332,589,812
0131-002,2011,5,26,21,244,330,574,589
0131-002,2011,5,26,22,197,221,418,574
0131-002,2011,5,26,23,143,156,299,418
0131-002,2011,5,26,24,101,73,174,299
0131-002,2011,5,27,1,66,70,136,174
0131-002,2011,5,27,2,42,40,82,136
0131-002,2011,5,27,3,16,24,40,82
0131-002,2011,5,27,4,16,19,35,40
0131-002,2011,5,27,5,29,31,60,35
0131-002,2011,5,27,6,64,51,115,60
0131-002,2011,5,27,7,236,146,382,115
0131-002,2011,5,27,8,593,455,1048,382
0131-002,2011,5,27,9,470,510,980,1048
0131-002,2011,5,27,10,348,347,695,980
0131-002,2011,5,27,11,347,347,694,695
0131-002,2011,5,27,12,316,333,649,694
0131-002,2011,5,27,13,262,295,557,649
0131-002,2011,5,27,14,334,345,679,557
0131-002,2011,5,27,15,387,372,759,679
0131-002,2011,5,27,16,329,338,667,759
0131-002,2011,5,27,17,358,377,735,667
0131-002,2011,5,27,18,466,474,940,735
0131-002,2011,5,27,19,485,519,1004,940
0131-002,2011,5,27,20,381,419,800,1004
0131-002,2011,5,27,21,258,311,569,800
0131-002,2011,5,27,22,254,268,522,569
0131-002,2011,5,27,23,158,146,304,522
0131-002,2011,5,27,24,87,106,193,304
0131-002,2011,5,28,1,59,72,131,193
0131-002,2011,5,28,2,45,55,100,131
0131-002,2011,5,28,3,27,37,64,100
0131-002,2011,5,28,4,20,30,50,64
0131-002,2011,5,28,5,21,40,61,50
0131-002,2011,5,28,6,62,62,124,61
0131-002,2011,5,28,7,193,132,325,124
0131-002,2011,5,28,8,341,261,602,325
0131-002,2011,5,28,9,352,342,694,602
0131-002,2011,5,28,10,295,351,646,694
0131-002,2011,5,28,11,335,443,778,646
0131-002,2011,5,28,12,335,564,899,778
0131-002,2011,5,28,13,313,607,920,899
0131-002,2011,5,28,14,334,569,903,920
0131-002,2011,5,28,15,340,552,892,903
0131-002,2011,5,28,16,359,540,899,892
0131-002,2011,5,28,17,362,534,896,899
0131-002,2011,5,28,18,418,651,1069,896
0131-002,2011,5,28,19,393,567,960,1069
0131-002,2011,5,28,20,268,375,643,960
0131-002,2011,5,28,21,236,218,454,643
0131-002,2011,5,28,22,161,193,354,454
0131-002,2011,5,28,23,115,152,267,354
0131-002,2011,5,28,24,79,102,181,267
0131-002,2011,5,29,1,50,61,111,181
0131-002,2011,5,29,2,36,33,69,111
0131-002,2011,5,29,3,35,37,72,69
0131-002,2011,5,29,4,19,20,39,72
0131-002,2011,5,29,5,27,16,43,39
0131-002,2011,5,29,6,42,42,84,43
0131-002,2011,5,29,7,93,101,194,84
0131-002,2011,5,29,8,136,137,273,194
0131-002,2011,5,29,9,181,178,359,273
0131-002,2011,5,29,10,196,214,410,359
0131-002,2011,5,29,11,200,226,426,410
0131-002,2011,5,29,12,172,178,350,426
0131-002,2011,5,29,13,219,255,474,350
0131-002,2011,5,29,14,224,202,426,474
0131-002,2011,5,29,15,242,237,479,426
0131-002,2011,5,29,16,400,262,662,479
0131-002,2011,5,29,17,459,274,733,662
0131-002,2011,5,29,18,515,302,817,733
0131-002,2011,5,29,19,538,254,792,817
0131-002,2011,5,29,20,341,218,559,792
0131-002,2011,5,29,21,236,192,428,559
0131-002,2011,5,29,22,197,153,350,428
0131-002,2011,5,29,23,133,116,249,350
0131-002,2011,5,29,24,68,72,140,249
0131-002,2011,5,30,1,41,46,87,140
0131-002,2011,5,30,2,19,27,46,87
0131-002,2011,5,30,3,9,19,28,46
0131-002,2011,5,30,4,16,21,37,28
0131-002,2011,5,30,5,27,29,56,37
0131-002,2011,5,30,6,68,74,142,56
0131-002,2011,5,30,7,278,204,482,142
0131-002,2011,5,30,8,649,505,1154,482
0131-002,2011,5,30,9,502,557,1059,1154
0131-002,2011,5,30,10,387,358,745,1059
0131-002,2011,5,30,11,364,369,733,745
0131-002,2011,5,30,12,311,319,630,733
0131-002,2011,5,30,13,254,308,562,630
0131-002,2011,5,30,14,323,335,658,562
0131-002,2011,5,30,15,365,414,779,658
0131-002,2011,5,30,16,364,351,715,779
0131-002,2011,5,30,17,401,405,806,715
0131-002,2011,5,30,18,371,445,816,806
0131-002,2011,5,30,19,432,489,921,816
0131-002,2011,5,30,20,305,343,648,921
0131-002,2011,5,30,21,233,276,509,648
0131-002,2011,5,30,22,182,253,435,509
0131-002,2011,5,30,23,135,158,293,435
0131-002,2011,5,30,24,89,66,155,293
0131-002,2011,5,31,1,46,46,92,155
0131-002,2011,5,31,2,35,33,68,92
0131-002,2011,5,31,3,18,23,41,68
0131-002,2011,5,31,4,17,20,37,41
0131-002,2011,5,31,5,30,26,56,37
0131-002,2011,5,31,6,59,69,128,56
0131-002,2011,5,31,7,230,154,384,128
0131-002,2011,5,31,8,606,464,1070,384
0131-002,2011,5,31,9,466,506,972,1070
0131-002,2011,5,31,10,342,333,675,972
0131-002,2011,5,31,11,345,377,722,675
0131-002,2011,5,31,12,285,341,626,722
0131-002,2011,5,31,13,291,294,585,626
0131-002,2011,5,31,14,308,344,652,585
0131-002,2011,5,31,15,363,346,709,652
0131-002,2011,5,31,16,389,370,759,709
0131-002,2011,5,31,17,351,348,699,759
0131-002,2011,5,31,18,378,421,799,699
0131-002,2011,5,31,19,372,491,863,799
0131-002,2011,5,31,20,292,310,602,863
0131-002,2011,5,31,21,237,280,517,602
0131-002,2011,5,31,22,203,240,443,517
0131-002,2011,5,31,23,145,170,315,443
0131-002,2011,5,31,24,86,84,170,315
0131-002,2011,6,1,1,50,48,98,170
0131-002,2011,6,1,2,43,35,78,98
0131-002,2011,6,1,3,12,27,39,78
0131-002,2011,6,1,4,21,22,43,39
0131-002,2011,6,1,5,19,26,45,43
0131-002,2011,6,1,6,38,44,82,45
0131-002,2011,6,1,7,165,110,275,82
0131-002,2011,6,1,8,540,389,929,275
0131-002,2011,6,1,9,434,497,931,929
0131-002,2011,6,1,10,312,325,637,931
0131-002,2011,6,1,11,338,299,637,637
0131-002,2011,6,1,12,297,315,612,637
0131-002,2011,6,1,13,262,266,528,612
0131-002,2011,6,1,14,261,339,600,528
0131-002,2011,6,1,15,341,324,665,600
0131-002,2011,6,1,16,348,358,706,665
0131-002,2011,6,1,17,368,354,722,706
0131-002,2011,6,1,18,355,402,757,722
0131-002,2011,6,1,19,380,429,809,757
0131-002,2011,6,1,20,304,351,655,809
0131-002,2011,6,1,21,243,264,507,655
0131-002,2011,6,1,22,179,211,390,507
0131-002,2011,6,1,23,143,155,298,390
0131-002,2011,6,1,24,73,86,159,298
0131-002,2011,6,2,1,57,45,102,159
0131-002,2011,6,2,2,43,37,80,102
0131-002,2011,6,2,3,22,22,44,80
0131-002,2011,6,2,4,13,23,36,44
0131-002,2011,6,2,5,15,36,51,36
0131-002,2011,6,2,6,56,76,132,51
0131-002,2011,6,2,7,212,148,360,132
0131-002,2011,6,2,8,587,463,1050,360
0131-002,2011,6,2,9,496,517,1013,1050
0131-002,2011,6,2,10,347,390,737,1013
0131-002,2011,6,2,11,377,351,728,737
0131-002,2011,6,2,12,291,314,605,728
0131-002,2011,6,2,13,258,277,535,605
0131-002,2011,6,2,14,330,330,660,535
0131-002,2011,6,2,15,371,381,752,660
0131-002,2011,6,2,16,390,381,771,752
0131-002,2011,6,2,17,411,395,806,771
0131-002,2011,6,2,18,392,428,820,806
0131-002,2011,6,2,19,406,461,867,820
0131-002,2011,6,2,20,267,354,621,867
0131-002,2011,6,2,21,277,329,606,621
0131-002,2011,6,2,22,216,220,436,606
0131-002,2011,6,2,23,165,149,314,436
0131-002,2011,6,2,24,69,114,183,314
0131-002,2011,6,3,1,47,54,101,183
0131-002,2011,6,3,2,24,32,56,101
0131-002,2011,6,3,3,29,19,48,56
0131-002,2011,6,3,4,19,34,53,48
0131-002,2011,6,3,5,26,39,65,53
0131-002,2011,6,3,6,75,65,140,65
0131-002,2011,6,3,7,217,161,378,140
0131-002,2011,6,3,8,547,472,1019,378
0131-002,2011,6,3,9,472,473,945,1019
0131-002,2011,6,3,10,367,354,721,945
0131-002,2011,6,3,11,370,352,722,721
0131-002,2011,6,3,12,313,348,661,722
0131-002,2011,6,3,13,258,309,567,661
0131-002,2011,6,3,14,308,335,643,567
0131-002,2011,6,3,15,345,384,729,643
0131-002,2011,6,3,16,355,387,742,729
0131-002,2011,6,3,17,411,381,792,742
0131-002,2011,6,3,18,504,466,970,792
0131-002,2011,6,3,19,523,523,1046,970
0131-002,2011,6,3,20,398,405,803,1046
0131-002,2011,6,3,21,279,372,651,803
0131-002,2011,6,3,22,194,254,448,651
0131-002,2011,6,3,23,156,154,310,448
0131-002,2011,6,3,24,79,107,186,310
0131-002,2011,6,4,1,57,61,118,186
0131-002,2011,6,4,2,35,38,73,118
0131-002,2011,6,4,3,33,25,58,73
0131-002,2011,6,4,4,21,24,45,58
0131-002,2011,6,4,5,15,31,46,45
0131-002,2011,6,4,6,59,58,117,46
0131-002,2011,6,4,7,166,132,298,117
0131-002,2011,6,4,8,381,287,668,298
0131-002,2011,6,4,9,366,361,727,668
0131-002,2011,6,4,10,355,438,793,727
0131-002,2011,6,4,11,306,600,906,793
0131-002,2011,6,4,12,334,693,1027,906
0131-002,2011,6,4,13,301,695,996,1027
0131-002,2011,6,4,14,348,728,1076,996
0131-002,2011,6,4,15,424,827,1251,1076
0131-002,2011,6,4,16,369,806,1175,1251
0131-002,2011,6,4,17,405,923,1328,1175
0131-002,2011,6,4,18,530,901,1431,1328
0131-002,2011,6,4,19,527,887,1414,1431
0131-002,2011,6,4,20,341,909,1250,1414
0131-002,2011,6,4,21,240,777,1017,1250
0131-002,2011,6,4,22,202,727,929,1017
0131-002,2011,6,4,23,131,457,588,929
0131-002,2011,6,4,24,91,290,381,588
0131-002,2011,6,5,1,62,96,158,381
0131-002,2011,6,5,2,33,47,80,158
0131-002,2011,6,5,3,23,26,49,80
0131-002,2011,6,5,4,15,14,29,49
0131-002,2011,6,5,5,22,31,53,29
0131-002,2011,6,5,6,37,32,69,53
0131-002,2011,6,5,7,86,83,169,69
0131-002,2011,6,5,8,169,160,329,169
0131-002,2011,6,5,9,193,206,399,329
0131-002,2011,6,5,10,200,279,479,399
0131-002,2011,6,5,11,219,371,590,479
0131-002,2011,6,5,12,219,398,617,590
0131-002,2011,6,5,13,219,439,658,617
0131-002,2011,6,5,14,244,417,661,658
0131-002,2011,6,5,15,243,419,662,661
0131-002,2011,6,5,16,330,410,740,662
0131-002,2011,6,5,17,474,436,910,740
0131-002,2011,6,5,18,483,447,930,910
0131-002,2011,6,5,19,538,378,916,930
0131-002,2011,6,5,20,516,237,753,916
0131-002,2011,6,5,21,448,189,637,753
0131-002,2011,6,5,22,349,168,517,637
0131-002,2011,6,5,23,167,119,286,517
0131-002,2011,6,5,24,135,89,224,286
0131-002,2011,6,6,1,70,73,143,224
0131-002,2011,6,6,2,25,35,60,143
0131-002,2011,6,6,3,18,17,35,60
0131-002,2011,6,6,4,18,25,43,35
0131-002,2011,6,6,5,16,24,40,43
0131-002,2011,6,6,6,62,46,108,40
0131-002,2011,6,6,7,150,100,250,108
0131-002,2011,6,6,8,305,219,524,250
0131-002,2011,6,6,9,267,233,500,524
0131-002,2011,6,6,10,264,242,506,500
0131-002,2011,6,6,11,364,268,632,506
0131-002,2011,6,6,12,532,267,799,632
0131-002,2011,6,6,13,473,237,710,799
0131-002,2011,6,6,14,523,307,830,710
0131-002,2011,6,6,15,484,287,771,830
0131-002,2011,6,6,16,496,283,779,771
0131-002,2011,6,6,17,554,276,830,779
0131-002,2011,6,6,18,549,337,886,830
0131-002,2011,6,6,19,564,286,850,886
0131-002,2011,6,6,20,557,266,823,850
0131-002,2011,6,6,21,460,213,673,823
0131-002,2011,6,6,22,277,154,431,673
0131-002,2011,6,6,23,133,118,251,431
0131-002,2011,6,6,24,92,71,163,251
0131-002,2011,6,7,1,53,44,97,163
0131-002,2011,6,7,2,23,22,45,97
0131-002,2011,6,7,3,6,16,22,45
0131-002,2011,6,7,4,10,13,23,22
0131-002,2011,6,7,5,30,27,57,23
0131-002,2011,6,7,6,73,68,141,57
0131-002,2011,6,7,7,268,204,472,141
0131-002,2011,6,7,8,627,532,1159,472
0131-002,2011,6,7,9,471,522,993,1159
0131-002,2011,6,7,10,355,368,723,993
0131-002,2011,6,7,11,342,325,667,723
0131-002,2011,6,7,12,313,353,666,667
0131-002,2011,6,7,13,249,303,552,666
0131-002,2011,6,7,14,337,309,646,552
0131-002,2011,6,7,15,387,387,774,646
0131-002,2011,6,7,16,387,352,739,774
0131-002,2011,6,7,17,375,367,742,739
0131-002,2011,6,7,18,406,475,881,742
0131-002,2011,6,7,19,372,497,869,881
0131-002,2011,6,7,20,326,365,691,869
0131-002,2011,6,7,21,247,270,517,691
0131-002,2011,6,7,22,211,237,448,517
0131-002,2011,6,7,23,146,156,302,448
0131-002,2011,6,7,24,79,90,169,302
0131-002,2011,6,8,1,55,51,106,169
0131-002,2011,6,8,2,38,42,80,106
0131-002,2011,6,8,3,27,34,61,80
0131-002,2011,6,8,4,13,16,29,61
0131-002,2011,6,8,5,25,30,55,29
0131-002,2011,6,8,6,84,62,146,55
0131-002,2011,6,8,7,224,136,360,146
0131-002,2011,6,8,8,579,477,1056,360
0131-002,2011,6,8,9,483,496,979,1056
0131-002,2011,6,8,10,341,381,722,979
0131-002,2011,6,8,11,327,342,669,722
0131-002,2011,6,8,12,298,326,624,669
0131-002,2011,6,8,13,288,275,563,624
0131-002,2011,6,8,14,266,320,586,563
0131-002,2011,6,8,15,359,381,740,586
0131-002,2011,6,8,16,364,350,714,740
0131-002,2011,6,8,17,368,389,757,714
0131-002,2011,6,8,18,400,439,839,757
0131-002,2011,6,8,19,444,458,902,839
0131-002,2011,6,8,20,326,371,697,902
0131-002,2011,6,8,21,218,313,531,697
0131-002,2011,6,8,22,211,249,460,531
0131-002,2011,6,8,23,141,155,296,460
0131-002,2011,6,8,24,89,79,168,296
0131-002,2011,6,9,1,61,53,114,168
0131-002,2011,6,9,2,33,36,69,114
0131-002,2011,6,9,3,21,23,44,69
0131-002,2011,6,9,4,25,24,49,44
0131-002,2011,6,9,5,21,29,50,49
0131-002,2011,6,9,6,50,60,110,50
0131-002,2011,6,9,7,231,135,366,110
0131-002,2011,6,9,8,562,487,1049,366
0131-002,2011,6,9,9,481,511,992,1049
0131-002,2011,6,9,10,348,380,728,992
0131-002,2011,6,9,11,341,372,713,728
0131-002,2011,6,9,12,328,316,644,713
0131-002,2011,6,9,13,256,273,529,644
0131-002,2011,6,9,14,346,340,686,529
0131-002,2011,6,9,15,335,373,708,686
0131-002,2011,6,9,16,417,411,828,708
0131-002,2011,6,9,17,337,367,704,828
0131-002,2011,6,9,18,391,401,792,704
0131-002,2011,6,9,19,429,432,861,792
0131-002,2011,6,9,20,340,329,669,861
0131-002,2011,6,9,21,242,336,578,669
0131-002,2011,6,9,22,211,266,477,578
0131-002,2011,6,9,23,148,145,293,477
0131-002,2011,6,9,24,83,98,181,293
0131-002,2011,6,10,1,58,66,124,181
0131-002,2011,6,10,2,40,38,78,124
0131-002,2011,6,10,3,23,30,53,78
0131-002,2011,6,10,4,15,28,43,53
0131-002,2011,6,10,5,23,38,61,43
0131-002,2011,6,10,6,70,72,142,61
0131-002,2011,6,10,7,233,157,390,142
0131-002,2011,6,10,8,607,485,1092,390
0131-002,2011,6,10,9,466,485,951,1092
0131-002,2011,6,10,10,383,345,728,951
0131-002,2011,6,10,11,316,352,668,728
0131-002,2011,6,10,12,341,352,693,668
0131-002,2011,6,10,13,270,310,580,693
0131-002,2011,6,10,14,302,364,666,580
0131-002,2011,6,10,15,348,339,687,666
0131-002,2011,6,10,16,386,376,762,687
0131-002,2011,6,10,17,413,401,814,762
0131-002,2011,6,10,18,428,475,903,814
0131-002,2011,6,10,19,472,516,988,903
0131-002,2011,6,10,20,368,360,728,988
0131-002,2011,6,10,21,322,345,667,728
0131-002,2011,6,10,22,219,230,449,667
0131-002,2011,6,10,23,181,194,375,449
0131-002,2011,6,10,24,113,126,239,375
0131-002,2011,6,11,1,72,74,146,239
0131-002,2011,6,11,2,46,44,90,146
0131-002,2011,6,11,3,31,38,69,90
0131-002,2011,6,11,4,28,26,54,69
0131-002,2011,6,11,5,30,59,89,54
0131-002,2011,6,11,6,60,79,139,89
0131-002,2011,6,11,7,206,149,355,139
0131-002,2011,6,11,8,362,295,657,355
0131-002,2011,6,11,9,382,372,754,657
0131-002,2011,6,11,10,350,364,714,754
0131-002,2011,6,11,11,329,496,825,714
0131-002,2011,6,11,12,344,661,1005,825
0131-002,2011,6,11,13,319,613,932,1005
0131-002,2011,6,11,14,327,579,906,932
0131-002,2011,6,11,15,376,576,952,906
0131-002,2011,6,11,16,341,549,890,952
0131-002,2011,6,11,17,468,506,974,890
0131-002,2011,6,11,18,573,546,1119,974
0131-002,2011,6,11,19,518,490,1008,1119
0131-002,2011,6,11,20,297,403,700,1008
0131-002,2011,6,11,21,213,289,502,700
0131-002,2011,6,11,22,168,180,348,502
0131-002,2011,6,11,23,148,133,281,348
0131-002,2011,6,11,24,89,102,191,281
0131-002,2011,6,12,1,71,54,125,191
0131-002,2011,6,12,2,39,46,85,125
0131-002,2011,6,12,3,35,43,78,85
0131-002,2011,6,12,4,19,15,34,78
0131-002,2011,6,12,5,27,34,61,34
0131-002,2011,6,12,6,43,48,91,61
0131-002,2011,6,12,7,111,93,204,91
0131-002,2011,6,12,8,148,156,304,204
0131-002,2011,6,12,9,172,184,356,304
0131-002,2011,6,12,10,180,195,375,356
0131-002,2011,6,12,11,192,240,432,375
0131-002,2011,6,12,12,215,223,438,432
0131-002,2011,6,12,13,226,212,438,438
0131-002,2011,6,12,14,266,213,479,438
0131-002,2011,6,12,15,280,249,529,479
0131-002,2011,6,12,16,380,297,677,529
0131-002,2011,6,12,17,421,282,703,677
0131-002,2011,6,12,18,479,297,776,703
0131-002,2011,6,12,19,435,256,691,776
0131-002,2011,6,12,20,272,214,486,691
0131-002,2011,6,12,21,231,195,426,486
0131-002,2011,6,12,22,188,167,355,426
0131-002,2011,6,12,23,131,136,267,355
0131-002,2011,6,12,24,74,84,158,267
0131-002,2011,6,13,1,45,43,88,158
0131-002,2011,6,13,2,17,25,42,88
0131-002,2011,6,13,3,12,13,25,42
0131-002,2011,6,13,4,8,18,26,25
0131-002,2011,6,13,5,28,31,59,26
0131-002,2011,6,13,6,78,87,165,59
0131-002,2011,6,13,7,284,188,472,165
0131-002,2011,6,13,8,600,517,1117,472
0131-002,2011,6,13,9,471,558,1029,1117
0131-002,2011,6,13,10,377,369,746,1029
0131-002,2011,6,13,11,337,331,668,746
0131-002,2011,6,13,12,301,317,618,668
0131-002,2011,6,13,13,260,297,557,618
0131-002,2011,6,13,14,324,300,624,557
0131-002,2011,6,13,15,374,416,790,624
0131-002,2011,6,13,16,356,336,692,790
0131-002,2011,6,13,17,351,353,704,692
0131-002,2011,6,13,18,374,444,818,704
0131-002,2011,6,13,19,409,470,879,818
0131-002,2011,6,13,20,346,358,704,879
0131-002,2011,6,13,21,288,300,588,704
0131-002,2011,6,13,22,215,242,457,588
0131-002,2011,6,13,23,149,160,309,457
0131-002,2011,6,13,24,103,99,202,309
0131-002,2011,6,14,1,49,54,103,202
0131-002,2011,6,14,2,34,32,66,103
0131-002,2011,6,14,3,19,17,36,66
0131-002,2011,6,14,4,17,28,45,36
0131-002,2011,6,14,5,20,44,64,45
0131-002,2011,6,14,6,79,74,153,64
0131-002,2011,6,14,7,251,142,393,153
0131-002,2011,6,14,8,583,479,1062,393
0131-002,2011,6,14,9,464,499,963,1062
0131-002,2011,6,14,10,363,327,690,963
0131-002,2011,6,14,11,367,336,703,690
0131-002,2011,6,14,12,329,319,648,703
0131-002,2011,6,14,13,267,255,522,648
0131-002,2011,6,14,14,340,321,661,522
0131-002,2011,6,14,15,342,343,685,661
0131-002,2011,6,14,16,339,362,701,685
0131-002,2011,6,14,17,366,378,744,701
0131-002,2011,6,14,18,402,436,838,744
0131-002,2011,6,14,19,452,440,892,838
0131-002,2011,6,14,20,321,358,679,892
0131-002,2011,6,14,21,286,301,587,679
0131-002,2011,6,14,22,228,279,507,587
0131-002,2011,6,14,23,149,162,311,507
0131-002,2011,6,14,24,83,87,170,311
0131-002,2011,6,15,1,67,62,129,170
0131-002,2011,6,15,2,36,40,76,129
0131-002,2011,6,15,3,24,23,47,76
0131-002,2011,6,15,4,18,22,40,47
0131-002,2011,6,15,5,29,36,65,40
0131-002,2011,6,15,6,83,96,179,65
0131-002,2011,6,15,7,255,135,390,179
0131-002,2011,6,15,8,559,480,1039,390
0131-002,2011,6,15,9,495,496,991,1039
0131-002,2011,6,15,10,356,374,730,991
0131-002,2011,6,15,11,311,366,677,730
0131-002,2011,6,15,12,324,334,658,677
0131-002,2011,6,15,13,253,281,534,658
0131-002,2011,6,15,14,298,376,674,534
0131-002,2011,6,15,15,409,385,794,674
0131-002,2011,6,15,16,387,368,755,794
0131-002,2011,6,15,17,405,370,775,755
0131-002,2011,6,15,18,412,486,898,775
0131-002,2011,6,15,19,411,531,942,898
0131-002,2011,6,15,20,332,385,717,942
0131-002,2011,6,15,21,267,306,573,717
0131-002,2011,6,15,22,208,246,454,573
0131-002,2011,6,15,23,163,140,303,454
0131-002,2011,6,15,24,97,84,181,303
0131-002,2011,6,16,1,64,65,129,181
0131-002,2011,6,16,2,30,36,66,129
0131-002,2011,6,16,3,21,17,38,66
0131-002,2011,6,16,4,14,24,38,38
0131-002,2011,6,16,5,17,29,46,38
0131-002,2011,6,16,6,78,80,158,46
0131-002,2011,6,16,7,267,154,421,158
0131-002,2011,6,16,8,576,481,1057,421
0131-002,2011,6,16,9,447,502,949,1057
0131-002,2011,6,16,10,335,381,716,949
0131-002,2011,6,16,11,367,351,718,716
0131-002,2011,6,16,12,355,326,681,718
0131-002,2011,6,16,13,288,292,580,681
0131-002,2011,6,16,14,315,337,652,580
0131-002,2011,6,16,15,352,376,728,652
0131-002,2011,6,16,16,383,389,772,728
0131-002,2011,6,16,17,408,384,792,772
0131-002,2011,6,16,18,403,439,842,792
0131-002,2011,6,16,19,403,454,857,842
0131-002,2011,6,16,20,318,357,675,857
0131-002,2011,6,16,21,267,309,576,675
0131-002,2011,6,16,22,226,233,459,576
0131-002,2011,6,16,23,167,186,353,459
0131-002,2011,6,16,24,93,97,190,353
0131-002,2011,6,17,1,58,57,115,190
0131-002,2011,6,17,2,28,37,65,115
0131-002,2011,6,17,3,22,26,48,65
0131-002,2011,6,17,4,16,27,43,48
0131-002,2011,6,17,5,22,38,60,43
0131-002,2011,6,17,6,93,84,177,60
0131-002,2011,6,17,7,222,145,367,177
0131-002,2011,6,17,8,583,447,1030,367
0131-002,2011,6,17,9,463,510,973,1030
0131-002,2011,6,17,10,358,376,734,973
0131-002,2011,6,17,11,383,352,735,734
0131-002,2011,6,17,12,323,378,701,735
0131-002,2011,6,17,13,288,311,599,701
0131-002,2011,6,17,14,317,339,656,599
0131-002,2011,6,17,15,402,419,821,656
0131-002,2011,6,17,16,405,411,816,821
0131-002,2011,6,17,17,433,443,876,816
0131-002,2011,6,17,18,403,502,905,876
0131-002,2011,6,17,19,469,476,945,905
0131-002,2011,6,17,20,418,390,808,945
0131-002,2011,6,17,21,290,322,612,808
0131-002,2011,6,17,22,202,252,454,612
0131-002,2011,6,17,23,156,164,320,454
0131-002,2011,6,17,24,116,108,224,320
0131-002,2011,6,18,1,62,76,138,224
0131-002,2011,6,18,2,51,59,110,138
0131-002,2011,6,18,3,28,35,63,110
0131-002,2011,6,18,4,25,38,63,63
0131-002,2011,6,18,5,20,42,62,63
0131-002,2011,6,18,6,72,84,156,62
0131-002,2011,6,18,7,199,110,309,156
0131-002,2011,6,18,8,388,276,664,309
0131-002,2011,6,18,9,409,366,775,664
0131-002,2011,6,18,10,379,374,753,775
0131-002,2011,6,18,11,343,409,752,753
0131-002,2011,6,18,12,320,437,757,752
0131-002,2011,6,18,13,291,483,774,757
0131-002,2011,6,18,14,340,473,813,774
0131-002,2011,6,18,15,338,488,826,813
0131-002,2011,6,18,16,379,572,951,826
0131-002,2011,6,18,17,400,563,963,951
0131-002,2011,6,18,18,406,534,940,963
0131-002,2011,6,18,19,388,434,822,940
0131-002,2011,6,18,20,277,335,612,822
0131-002,2011,6,18,21,234,220,454,612
0131-002,2011,6,18,22,199,189,388,454
0131-002,2011,6,18,23,156,148,304,388
0131-002,2011,6,18,24,88,107,195,304
0131-002,2011,6,19,1,53,62,115,195
0131-002,2011,6,19,2,38,48,86,115
0131-002,2011,6,19,3,37,34,71,86
0131-002,2011,6,19,4,35,24,59,71
0131-002,2011,6,19,5,26,38,64,59
0131-002,2011,6,19,6,72,66,138,64
0131-002,2011,6,19,7,125,87,212,138
0131-002,2011,6,19,8,162,128,290,212
0131-002,2011,6,19,9,170,215,385,290
0131-002,2011,6,19,10,199,200,399,385
0131-002,2011,6,19,11,228,239,467,399
0131-002,2011,6,19,12,214,252,466,467
0131-002,2011,6,19,13,218,215,433,466
0131-002,2011,6,19,14,248,227,475,433
0131-002,2011,6,19,15,282,237,519,475
0131-002,2011,6,19,16,323,260,583,519
0131-002,2011,6,19,17,489,265,754,583
0131-002,2011,6,19,18,490,236,726,754
0131-002,2011,6,19,19,426,244,670,726
0131-002,2011,6,19,20,300,241,541,670
0131-002,2011,6,19,21,254,213,467,541
0131-002,2011,6,19,22,209,176,385,467
0131-002,2011,6,19,23,135,136,271,385
0131-002,2011,6,19,24,82,79,161,271
0131-002,2011,6,20,1,43,59,102,161
0131-002,2011,6,20,2,32,24,56,102
0131-002,2011,6,20,3,15,12,27,56
0131-002,2011,6,20,4,16,20,36,27
0131-002,2011,6,20,5,23,28,51,36
0131-002,2011,6,20,6,86,91,177,51
0131-002,2011,6,20,7,264,176,440,177
0131-002,2011,6,20,8,609,529,1138,440
0131-002,2011,6,20,9,493,527,1020,1138
0131-002,2011,6,20,10,391,411,802,1020
0131-002,2011,6,20,11,379,384,763,802
0131-002,2011,6,20,12,352,360,712,763
0131-002,2011,6,20,13,298,322,620,712
0131-002,2011,6,20,14,345,312,657,620
0131-002,2011,6,20,15,360,418,778,657
0131-002,2011,6,20,16,401,402,803,778
0131-002,2011,6,20,17,394,359,753,803
0131-002,2011,6,20,18,398,426,824,753
0131-002,2011,6,20,19,422,449,871,824
0131-002,2011,6,20,20,290,343,633,871
0131-002,2011,6,20,21,270,319,589,633
0131-002,2011,6,20,22,229,223,452,589
0131-002,2011,6,20,23,144,163,307,452
0131-002,2011,6,20,24,78,73,151,307
0131-002,2011,6,21,1,38,63,101,151
0131-002,2011,6,21,2,22,25,47,101
0131-002,2011,6,21,3,19,19,38,47
0131-002,2011,6,21,4,10,30,40,38
0131-002,2011,6,21,5,25,39,64,40
0131-002,2011,6,21,6,99,74,173,64
0131-002,2011,6,21,7,245,181,426,173
0131-002,2011,6,21,8,551,471,1022,426
0131-002,2011,6,21,9,472,479,951,1022
0131-002,2011,6,21,10,359,396,755,951
0131-002,2011,6,21,11,383,372,755,755
0131-002,2011,6,21,12,324,355,679,755
0131-002,2011,6,21,13,241,278,519,679
0131-002,2011,6,21,14,318,302,620,519
0131-002,2011,6,21,15,346,359,705,620
0131-002,2011,6,21,16,388,388,776,705
0131-002,2011,6,21,17,404,371,775,776
0131-002,2011,6,21,18,385,427,812,775
0131-002,2011,6,21,19,434,465,899,812
0131-002,2011,6,21,20,318,379,697,899
0131-002,2011,6,21,21,291,333,624,697
0131-002,2011,6,21,22,221,245,466,624
0131-002,2011,6,21,23,158,164,322,466
0131-002,2011,6,21,24,86,102,188,322
0131-002,2011,6,22,1,58,50,108,188
0131-002,2011,6,22,2,28,33,61,108
0131-002,2011,6,22,3,36,34,70,61
0131-002,2011,6,22,4,18,28,46,70
0131-002,2011,6,22,5,35,35,70,46
0131-002,2011,6,22,6,72,49,121,70
0131-002,2011,6,22,7,249,132,381,121
0131-002,2011,6,22,8,543,439,982,381
0131-002,2011,6,22,9,492,473,965,982
0131-002,2011,6,22,10,369,389,758,965
0131-002,2011,6,22,11,380,319,699,758
0131-002,2011,6,22,12,322,293,615,699
0131-002,2011,6,22,13,249,286,535,615
0131-002,2011,6,22,14,354,328,682,535
0131-002,2011,6,22,15,339,325,664,682
0131-002,2011,6,22,16,359,361,720,664
0131-002,2011,6,22,17,358,376,734,720
0131-002,2011,6,22,18,402,443,845,734
0131-002,2011,6,22,19,428,488,916,845
0131-002,2011,6,22,20,299,316,615,916
0131-002,2011,6,22,21,206,300,506,615
0131-002,2011,6,22,22,172,202,374,506
0131-002,2011,6,22,23,134,115,249,374
0131-002,2011,6,22,24,89,105,194,249
0131-002,2011,6,23,1,57,49,106,194
0131-002,2011,6,23,2,31,35,66,106
0131-002,2011,6,23,3,24,22,46,66
0131-002,2011,6,23,4,18,23,41,46
0131-002,2011,6,23,5,23,39,62,41
0131-002,2011,6,23,6,77,67,144,62
0131-002,2011,6,23,7,202,126,328,144
0131-002,2011,6,23,8,526,441,967,328
0131-002,2011,6,23,9,464,501,965,967
0131-002,2011,6,23,10,370,366,736,965
0131-002,2011,6,23,11,337,312,649,736
0131-002,2011,6,23,12,258,294,552,649
0131-002,2011,6,23,13,254,270,524,552
0131-002,2011,6,23,14,290,311,601,524
0131-002,2011,6,23,15,358,348,706,601
0131-002,2011,6,23,16,334,341,675,706
0131-002,2011,6,23,17,320,322,642,675
0131-002,2011,6,23,18,359,436,795,642
0131-002,2011,6,23,19,369,434,803,795
0131-002,2011,6,23,20,291,300,591,803
0131-002,2011,6,23,21,226,276,502,591
0131-002,2011,6,23,22,190,210,400,502
0131-002,2011,6,23,23,142,129,271,400
0131-002,2011,6,23,24,69,95,164,271
0131-002,2011,6,24,1,73,50,123,164
0131-002,2011,6,24,2,37,37,74,123
0131-002,2011,6,24,3,30,22,52,74
0131-002,2011,6,24,4,14,20,34,52
0131-002,2011,6,24,5,18,25,43,34
0131-002,2011,6,24,6,51,48,99,43
0131-002,2011,6,24,7,165,97,262,99
0131-002,2011,6,24,8,520,428,948,262
0131-002,2011,6,24,9,482,471,953,948
0131-002,2011,6,24,10,350,350,700,953
0131-002,2011,6,24,11,328,351,679,700
0131-002,2011,6,24,12,348,342,690,679
0131-002,2011,6,24,13,238,278,516,690
0131-002,2011,6,24,14,309,311,620,516
0131-002,2011,6,24,15,356,396,752,620
0131-002,2011,6,24,16,357,324,681,752
0131-002,2011,6,24,17,397,369,766,681
0131-002,2011,6,24,18,465,451,916,766
0131-002,2011,6,24,19,527,525,1052,916
0131-002,2011,6,24,20,451,407,858,1052
0131-002,2011,6,24,21,256,329,585,858
0131-002,2011,6,24,22,207,218,425,585
0131-002,2011,6,24,23,150,152,302,425
0131-002,2011,6,24,24,89,108,197,302
0131-002,2011,6,25,1,57,76,133,197
0131-002,2011,6,25,2,48,58,106,133
0131-002,2011,6,25,3,39,30,69,106
0131-002,2011,6,25,4,28,28,56,69
0131-002,2011,6,25,5,21,38,59,56
0131-002,2011,6,25,6,47,46,93,59
0131-002,2011,6,25,7,117,106,223,93
0131-002,2011,6,25,8,291,235,526,223
0131-002,2011,6,25,9,311,290,601,526
0131-002,2011,6,25,10,297,344,641,601
0131-002,2011,6,25,11,330,341,671,641
0131-002,2011,6,25,12,312,326,638,671
0131-002,2011,6,25,13,281,377,658,638
0131-002,2011,6,25,14,274,337,611,658
0131-002,2011,6,25,15,309,359,668,611
0131-002,2011,6,25,16,356,358,714,668
0131-002,2011,6,25,17,439,412,851,714
0131-002,2011,6,25,18,495,509,1004,851
0131-002,2011,6,25,19,394,406,800,1004
0131-002,2011,6,25,20,223,270,493,800
0131-002,2011,6,25,21,207,202,409,493
0131-002,2011,6,25,22,177,154,331,409
0131-002,2011,6,25,23,100,133,233,331
0131-002,2011,6,25,24,64,62,126,233
0131-002,2011,6,26,1,59,54,113,126
0131-002,2011,6,26,2,34,42,76,113
0131-002,2011,6,26,3,16,22,38,76
0131-002,2011,6,26,4,17,16,33,38
0131-002,2011,6,26,5,23,21,44,33
0131-002,2011,6,26,6,29,30,59,44
0131-002,2011,6,26,7,58,35,93,59
0131-002,2011,6,26,8,110,107,217,93
0131-002,2011,6,26,9,128,140,268,217
0131-002,2011,6,26,10,169,148,317,268
0131-002,2011,6,26,11,191,193,384,317
0131-002,2011,6,26,12,161,187,348,384
0131-002,2011,6,26,13,175,223,398,348
0131-002,2011,6,26,14,221,218,439,398
0131-002,2011,6,26,15,243,242,485,439
0131-002,2011,6,26,16,266,236,502,485
0131-002,2011,6,26,17,301,245,546,502
0131-002,2011,6,26,18,261,227,488,546
0131-002,2011,6,26,19,261,199,460,488
0131-002,2011,6,26,20,210,178,388,460
0131-002,2011,6,26,21,199,159,358,388
0131-002,2011,6,26,22,157,128,285,358
0131-002,2011,6,26,23,100,96,196,285
0131-002,2011,6,26,24,73,60,133,196
0131-002,2011,6,27,1,40,46,86,133
0131-002,2011,6,27,2,20,24,44,86
0131-002,2011,6,27,3,17,19,36,44
0131-002,2011,6,27,4,12,20,32,36
0131-002,2011,6,27,5,19,21,40,32
0131-002,2011,6,27,6,52,67,119,40
0131-002,2011,6,27,7,226,148,374,119
0131-002,2011,6,27,8,582,490,1072,374
0131-002,2011,6,27,9,474,517,991,1072
0131-002,2011,6,27,10,319,322,641,991
0131-002,2011,6,27,11,311,347,658,641
0131-002,2011,6,27,12,326,341,667,658
0131-002,2011,6,27,13,258,241,499,667
0131-002,2011,6,27,14,319,339,658,499
0131-002,2011,6,27,15,320,376,696,658
0131-002,2011,6,27,16,346,368,714,696
0131-002,2011,6,27,17,351,353,704,714
0131-002,2011,6,27,18,367,428,795,704
0131-002,2011,6,27,19,391,463,854,795
0131-002,2011,6,27,20,287,323,610,854
0131-002,2011,6,27,21,244,287,531,610
0131-002,2011,6,27,22,198,227,425,531
0131-002,2011,6,27,23,119,139,258,425
0131-002,2011,6,27,24,95,108,203,258
0131-002,2011,6,28,1,52,42,94,203
0131-002,2011,6,28,2,29,45,74,94
0131-002,2011,6,28,3,11,26,37,74
0131-002,2011,6,28,4,20,19,39,37
0131-002,2011,6,28,5,28,47,75,39
0131-002,2011,6,28,6,67,77,144,75
0131-002,2011,6,28,7,240,158,398,144
0131-002,2011,6,28,8,586,472,1058,398
0131-002,2011,6,28,9,462,496,958,1058
0131-002,2011,6,28,10,368,339,707,958
0131-002,2011,6,28,11,343,329,672,707
0131-002,2011,6,28,12,319,345,664,672
0131-002,2011,6,28,13,292,303,595,664
0131-002,2011,6,28,14,330,326,656,595
0131-002,2011,6,28,15,387,368,755,656
0131-002,2011,6,28,16,408,376,784,755
0131-002,2011,6,28,17,390,413,803,784
0131-002,2011,6,28,18,416,429,845,803
0131-002,2011,6,28,19,406,462,868,845
0131-002,2011,6,28,20,342,374,716,868
0131-002,2011,6,28,21,272,333,605,716
0131-002,2011,6,28,22,230,248,478,605
0131-002,2011,6,28,23,141,160,301,478
0131-002,2011,6,28,24,82,99,181,301
0131-002,2011,6,29,1,63,57,120,181
0131-002,2011,6,29,2,32,42,74,120
0131-002,2011,6,29,3,16,21,37,74
0131-002,2011,6,29,4,12,21,33,37
0131-002,2011,6,29,5,21,31,52,33
0131-002,2011,6,29,6,60,56,116,52
0131-002,2011,6,29,7,210,116,326,116
0131-002,2011,6,29,8,552,455,1007,326
0131-002,2011,6,29,9,465,507,972,1007
0131-002,2011,6,29,10,347,372,719,972
0131-002,2011,6,29,11,382,341,723,719
0131-002,2011,6,29,12,313,298,611,723
0131-002,2011,6,29,13,280,306,586,611
0131-002,2011,6,29,14,286,294,580,586
0131-002,2011,6,29,15,340,371,711,580
0131-002,2011,6,29,16,343,371,714,711
0131-002,2011,6,29,17,374,334,708,714
0131-002,2011,6,29,18,348,392,740,708
0131-002,2011,6,29,19,373,425,798,740
0131-002,2011,6,29,20,255,303,558,798
0131-002,2011,6,29,21,209,227,436,558
0131-002,2011,6,29,22,182,208,390,436
0131-002,2011,6,29,23,138,152,290,390
0131-002,2011,6,29,24,81,74,155,290
0131-002,2011,6,30,1,50,51,101,155
0131-002,2011,6,30,2,23,29,52,101
0131-002,2011,6,30,3,28,26,54,52
0131-002,2011,6,30,4,8,21,29,54
0131-002,2011,6,30,5,26,21,47,29
0131-002,2011,6,30,6,48,48,96,47
0131-002,2011,6,30,7,184,95,279,96
0131-002,2011,6,30,8,544,440,984,279
0131-002,2011,6,30,9,454,450,904,984
0131-002,2011,6,30,10,346,336,682,904
0131-002,2011,6,30,11,310,303,613,682
0131-002,2011,6,30,12,299,377,676,613
0131-002,2011,6,30,13,274,318,592,676
0131-002,2011,6,30,14,299,309,608,592
0131-002,2011,6,30,15,361,368,729,608
0131-002,2011,6,30,16,371,338,709,729
0131-002,2011,6,30,17,361,351,712,709
0131-002,2011,6,30,18,371,405,776,712
0131-002,2011,6,30,19,421,425,846,776
0131-002,2011,6,30,20,340,367,707,846
0131-002,2011,6,30,21,250,265,515,707
0131-002,2011,6,30,22,210,237,447,515
0131-002,2011,6,30,23,167,168,335,447
0131-002,2011,6,30,24,101,87,188,335
0131-002,2011,7,1,1,61,70,131,188
0131-002,2011,7,1,2,37,38,75,131
0131-002,2011,7,1,3,28,26,54,75
0131-002,2011,7,1,4,29,34,63,54
0131-002,2011,7,1,5,35,42,77,63
0131-002,2011,7,1,6,76,88,164,77
0131-002,2011,7,1,7,228,150,378,164
0131-002,2011,7,1,8,595,448,1043,378
0131-002,2011,7,1,9,479,457,936,1043
0131-002,2011,7,1,10,345,380,725,936
0131-002,2011,7,1,11,342,379,721,725
0131-002,2011,7,1,12,340,370,710,721
0131-002,2011,7,1,13,281,289,570,710
0131-002,2011,7,1,14,349,329,678,570
0131-002,2011,7,1,15,370,388,758,678
0131-002,2011,7,1,16,385,376,761,758
0131-002,2011,7,1,17,420,371,791,761
0131-002,2011,7,1,18,396,411,807,791
0131-002,2011,7,1,19,469,494,963,807
0131-002,2011,7,1,20,358,413,771,963
0131-002,2011,7,1,21,290,326,616,771
0131-002,2011,7,1,22,213,234,447,616
0131-002,2011,7,1,23,173,153,326,447
0131-002,2011,7,1,24,109,103,212,326
0131-002,2011,7,2,1,66,82,148,212
0131-002,2011,7,2,2,52,52,104,148
0131-002,2011,7,2,3,37,38,75,104
0131-002,2011,7,2,4,26,33,59,75
0131-002,2011,7,2,5,29,26,55,59
0131-002,2011,7,2,6,81,72,153,55
0131-002,2011,7,2,7,167,122,289,153
0131-002,2011,7,2,8,375,230,605,289
0131-002,2011,7,2,9,362,354,716,605
0131-002,2011,7,2,10,361,334,695,716
0131-002,2011,7,2,11,332,354,686,695
0131-002,2011,7,2,12,311,372,683,686
0131-002,2011,7,2,13,292,331,623,683
0131-002,2011,7,2,14,301,373,674,623
0131-002,2011,7,2,15,340,375,715,674
0131-002,2011,7,2,16,332,431,763,715
0131-002,2011,7,2,17,368,518,886,763
0131-002,2011,7,2,18,428,554,982,886
0131-002,2011,7,2,19,378,511,889,982
0131-002,2011,7,2,20,282,307,589,889
0131-002,2011,7,2,21,241,232,473,589
0131-002,2011,7,2,22,188,192,380,473
0131-002,2011,7,2,23,123,144,267,380
0131-002,2011,7,2,24,104,97,201,267
0131-002,2011,7,3,1,66,51,117,201
0131-002,2011,7,3,2,42,47,89,117
0131-002,2011,7,3,3,21,30,51,89
0131-002,2011,7,3,4,18,16,34,51
0131-002,2011,7,3,5,21,20,41,34
0131-002,2011,7,3,6,37,40,77,41
0131-002,2011,7,3,7,57,47,104,77
0131-002,2011,7,3,8,107,91,198,104
0131-002,2011,7,3,9,138,155,293,198
0131-002,2011,7,3,10,136,187,323,293
0131-002,2011,7,3,11,174,199,373,323
0131-002,2011,7,3,12,141,158,299,373
0131-002,2011,7,3,13,174,186,360,299
0131-002,2011,7,3,14,210,189,399,360
0131-002,2011,7,3,15,243,223,466,399
0131-002,2011,7,3,16,372,205,577,466
0131-002,2011,7,3,17,454,258,712,577
0131-002,2011,7,3,18,502,240,742,712
0131-002,2011,7,3,19,488,177,665,742
0131-002,2011,7,3,20,225,148,373,665
0131-002,2011,7,3,21,198,170,368,373
0131-002,2011,7,3,22,143,121,264,368
0131-002,2011,7,3,23,84,95,179,264
0131-002,2011,7,3,24,76,64,140,179
0131-002,2011,7,4,1,42,42,84,140
0131-002,2011,7,4,2,22,31,53,84
0131-002,2011,7,4,3,11,18,29,53
0131-002,2011,7,4,4,12,19,31,29
0131-002,2011,7,4,5,26,28,54,31
0131-002,2011,7,4,6,62,52,114,54
0131-002,2011,7,4,7,227,149,376,114
0131-002,2011,7,4,8,623,486,1109,376
0131-002,2011,7,4,9,471,514,985,1109
0131-002,2011,7,4,10,320,356,676,985
0131-002,2011,7,4,11,368,373,741,676
0131-002,2011,7,4,12,308,314,622,741
0131-002,2011,7,4,13,241,296,537,622
0131-002,2011,7,4,14,311,299,610,537
0131-002,2011,7,4,15,338,344,682,610
0131-002,2011,7,4,16,374,386,760,682
0131-002,2011,7,4,17,325,366,691,760
0131-002,2011,7,4,18,383,386,769,691
0131-002,2011,7,4,19,399,445,844,769
0131-002,2011,7,4,20,330,338,668,844
0131-002,2011,7,4,21,282,328,610,668
0131-002,2011,7,4,22,243,254,497,610
0131-002,2011,7,4,23,148,149,297,497
0131-002,2011,7,4,24,93,86,179,297
0131-002,2011,7,5,1,56,54,110,179
0131-002,2011,7,5,2,24,26,50,110
0131-002,2011,7,5,3,28,19,47,50
0131-002,2011,7,5,4,16,25,41,47
0131-002,2011,7,5,5,25,43,68,41
0131-002,2011,7,5,6,82,72,154,68
0131-002,2011,7,5,7,250,169,419,154
0131-002,2011,7,5,8,559,485,1044,419
0131-002,2011,7,5,9,456,458,914,1044
0131-002,2011,7,5,10,356,350,706,914
0131-002,2011,7,5,11,348,299,647,706
0131-002,2011,7,5,12,335,327,662,647
0131-002,2011,7,5,13,261,302,563,662
0131-002,2011,7,5,14,351,321,672,563
0131-002,2011,7,5,15,379,367,746,672
0131-002,2011,7,5,16,363,354,717,746
0131-002,2011,7,5,17,352,365,717,717
0131-002,2011,7,5,18,398,426,824,717
0131-002,2011,7,5,19,417,456,873,824
0131-002,2011,7,5,20,330,378,708,873
0131-002,2011,7,5,21,274,327,601,708
0131-002,2011,7,5,22,217,248,465,601
0131-002,2011,7,5,23,175,142,317,465
0131-002,2011,7,5,24,82,101,183,317
0131-002,2011,7,6,1,64,54,118,183
0131-002,2011,7,6,2,39,36,75,118
0131-002,2011,7,6,3,22,23,45,75
0131-002,2011,7,6,4,20,24,44,45
0131-002,2011,7,6,5,34,46,80,44
0131-002,2011,7,6,6,84,75,159,80
0131-002,2011,7,6,7,238,147,385,159
0131-002,2011,7,6,8,617,470,1087,385
0131-002,2011,7,6,9,484,476,960,1087
0131-002,2011,7,6,10,364,361,725,960
0131-002,2011,7,6,11,355,330,685,725
0131-002,2011,7,6,12,310,337,647,685
0131-002,2011,7,6,13,269,273,542,647
0131-002,2011,7,6,14,358,322,680,542
0131-002,2011,7,6,15,383,365,748,680
0131-002,2011,7,6,16,430,362,792,748
0131-002,2011,7,6,17,395,403,798,792
0131-002,2011,7,6,18,393,445,838,798
0131-002,2011,7,6,19,432,516,948,838
0131-002,2011,7,6,20,315,380,695,948
0131-002,2011,7,6,21,269,306,575,695
0131-002,2011,7,6,22,229,216,445,575
0131-002,2011,7,6,23,160,136,296,445
0131-002,2011,7,6,24,94,93,187,296
0131-002,2011,7,7,1,64,61,125,187
0131-002,2011,7,7,2,29,46,75,125
0131-002,2011,7,7,3,23,22,45,75
0131-002,2011,7,7,4,17,20,37,45
0131-002,2011,7,7,5,26,31,57,37
0131-002,2011,7,7,6,51,55,106,57
0131-002,2011,7,7,7,173,123,296,106
0131-002,2011,7,7,8,570,441,1011,296
0131-002,2011,7,7,9,471,511,982,1011
0131-002,2011,7,7,10,354,352,706,982
0131-002,2011,7,7,11,360,333,693,706
0131-002,2011,7,7,12,314,344,658,693
0131-002,2011,7,7,13,264,304,568,658
0131-002,2011,7,7,14,250,326,576,568
0131-002,2011,7,7,15,361,360,721,576
0131-002,2011,7,7,16,348,313,661,721
0131-002,2011,7,7,17,361,336,697,661
0131-002,2011,7,7,18,353,416,769,697
0131-002,2011,7,7,19,384,393,777,769
0131-002,2011,7,7,20,254,327,581,777
0131-002,2011,7,7,21,228,293,521,581
0131-002,2011,7,7,22,207,230,437,521
0131-002,2011,7,7,23,136,114,250,437
0131-002,2011,7,7,24,94,101,195,250
0131-002,2011,7,8,1,56,52,108,195
0131-002,2011,7,8,2,29,42,71,108
0131-002,2011,7,8,3,15,15,30,71
0131-002,2011,7,8,4,14,27,41,30
0131-002,2011,7,8,5,18,31,49,41
0131-002,2011,7,8,6,53,52,105,49
0131-002,2011,7,8,7,202,109,311,105
0131-002,2011,7,8,8,560,436,996,311
0131-002,2011,7,8,9,481,504,985,996
0131-002,2011,7,8,10,332,343,675,985
0131-002,2011,7,8,11,348,349,697,675
0131-002,2011,7,8,12,306,313,619,697
0131-002,2011,7,8,13,290,270,560,619
0131-002,2011,7,8,14,334,319,653,560
0131-002,2011,7,8,15,348,325,673,653
0131-002,2011,7,8,16,390,353,743,673
0131-002,2011,7,8,17,365,336,701,743
0131-002,2011,7,8,18,392,433,825,701
0131-002,2011,7,8,19,497,479,976,825
0131-002,2011,7,8,20,364,396,760,976
0131-002,2011,7,8,21,258,322,580,760
0131-002,2011,7,8,22,207,242,449,580
0131-002,2011,7,8,23,154,169,323,449
0131-002,2011,7,8,24,105,96,201,323
0131-002,2011,7,9,1,69,49,118,201
0131-002,2011,7,9,2,46,44,90,118
0131-002,2011,7,9,3,27,36,63,90
0131-002,2011,7,9,4,31,25,56,63
0131-002,2011,7,9,5,22,29,51,56
0131-002,2011,7,9,6,55,51,106,51
0131-002,2011,7,9,7,107,84,191,106
0131-002,2011,7,9,8,294,216,510,191
0131-002,2011,7,9,9,309,300,609,510
0131-002,2011,7,9,10,285,310,595,609
0131-002,2011,7,9,11,298,375,673,595
0131-002,2011,7,9,12,333,397,730,673
0131-002,2011,7,9,13,276,446,722,730
0131-002,2011,7,9,14,315,418,733,722
0131-002,2011,7,9,15,318,432,750,733
0131-002,2011,7,9,16,341,418,759,750
0131-002,2011,7,9,17,354,420,774,759
0131-002,2011,7,9,18,407,428,835,774
0131-002,2011,7,9,19,390,434,824,835
0131-002,2011,7,9,20,253,274,527,824
0131-002,2011,7,9,21,206,229,435,527
0131-002,2011,7,9,22,188,180,368,435
0131-002,2011,7,9,23,136,126,262,368
0131-002,2011,7,9,24,96,90,186,262
0131-002,2011,7,10,1,61,86,147,186
0131-002,2011,7,10,2,38,48,86,147
0131-002,2011,7,10,3,29,27,56,86
0131-002,2011,7,10,4,16,24,40,56
0131-002,2011,7,10,5,20,22,42,40
0131-002,2011,7,10,6,45,54,99,42
0131-002,2011,7,10,7,58,68,126,99
0131-002,2011,7,10,8,92,104,196,126
0131-002,2011,7,10,9,143,132,275,196
0131-002,2011,7,10,10,156,163,319,275
0131-002,2011,7,10,11,215,190,405,319
0131-002,2011,7,10,12,200,219,419,405
0131-002,2011,7,10,13,190,196,386,419
0131-002,2011,7,10,14,232,230,462,386
0131-002,2011,7,10,15,270,229,499,462
0131-002,2011,7,10,16,380,230,610,499
0131-002,2011,7,10,17,376,232,608,610
0131-002,2011,7,10,18,450,242,692,608
0131-002,2011,7,10,19,411,216,627,692
0131-002,2011,7,10,20,386,156,542,627
0131-002,2011,7,10,21,304,155,459,542
0131-002,2011,7,10,22,178,153,331,459
0131-002,2011,7,10,23,81,108,189,331
0131-002,2011,7,10,24,71,71,142,189
0131-002,2011,7,11,1,54,37,91,142
0131-002,2011,7,11,2,25,19,44,91
0131-002,2011,7,11,3,23,23,46,44
0131-002,2011,7,11,4,8,18,26,46
0131-002,2011,7,11,5,18,20,38,26
0131-002,2011,7,11,6,52,55,107,38
0131-002,2011,7,11,7,216,137,353,107
0131-002,2011,7,11,8,595,477,1072,353
0131-002,2011,7,11,9,473,522,995,1072
0131-002,2011,7,11,10,294,304,598,995
0131-002,2011,7,11,11,306,318,624,598
0131-002,2011,7,11,12,335,313,648,624
0131-002,2011,7,11,13,243,296,539,648
0131-002,2011,7,11,14,280,299,579,539
0131-002,2011,7,11,15,355,332,687,579
0131-002,2011,7,11,16,335,316,651,687
0131-002,2011,7,11,17,287,320,607,651
0131-002,2011,7,11,18,339,394,733,607
0131-002,2011,7,11,19,375,386,761,733
0131-002,2011,7,11,20,280,326,606,761
0131-002,2011,7,11,21,227,272,499,606
0131-002,2011,7,11,22,189,226,415,499
0131-002,2011,7,11,23,144,129,273,415
0131-002,2011,7,11,24,65,69,134,273
0131-002,2011,7,12,1,54,41,95,134
0131-002,2011,7,12,2,23,39,62,95
0131-002,2011,7,12,3,20,22,42,62
0131-002,2011,7,12,4,15,25,40,42
0131-002,2011,7,12,5,13,26,39,40
0131-002,2011,7,12,6,55,46,101,39
0131-002,2011,7,12,7,164,114,278,101
0131-002,2011,7,12,8,545,410,955,278
0131-002,2011,7,12,9,446,498,944,955
0131-002,2011,7,12,10,337,330,667,944
0131-002,2011,7,12,11,310,279,589,667
0131-002,2011,7,12,12,300,304,604,589
0131-002,2011,7,12,13,231,292,523,604
0131-002,2011,7,12,14,300,329,629,523
0131-002,2011,7,12,15,311,361,672,629
0131-002,2011,7,12,16,337,339,676,672
0131-002,2011,7,12,17,304,350,654,676
0131-002,2011,7,12,18,346,415,761,654
0131-002,2011,7,12,19,393,426,819,761
0131-002,2011,7,12,20,287,340,627,819
0131-002,2011,7,12,21,244,303,547,627
0131-002,2011,7,12,22,212,238,450,547
0131-002,2011,7,12,23,142,161,303,450
0131-002,2011,7,12,24,75,73,148,303
0131-002,2011,7,13,1,53,46,99,148
0131-002,2011,7,13,2,45,38,83,99
0131-002,2011,7,13,3,24,28,52,83
0131-002,2011,7,13,4,17,23,40,52
0131-002,2011,7,13,5,16,34,50,40
0131-002,2011,7,13,6,50,54,104,50
0131-002,2011,7,13,7,180,126,306,104
0131-002,2011,7,13,8,551,430,981,306
0131-002,2011,7,13,9,460,498,958,981
0131-002,2011,7,13,10,365,327,692,958
0131-002,2011,7,13,11,364,332,696,692
0131-002,2011,7,13,12,329,326,655,696
0131-002,2011,7,13,13,269,293,562,655
0131-002,2011,7,13,14,319,308,627,562
0131-002,2011,7,13,15,346,343,689,627
0131-002,2011,7,13,16,361,328,689,689
0131-002,2011,7,13,17,361,379,740,689
0131-002,2011,7,13,18,385,417,802,740
0131-002,2011,7,13,19,407,443,850,802
0131-002,2011,7,13,20,293,318,611,850
0131-002,2011,7,13,21,232,251,483,611
0131-002,2011,7,13,22,179,183,362,483
0131-002,2011,7,13,23,139,157,296,362
0131-002,2011,7,13,24,94,73,167,296
0131-002,2011,7,14,1,51,55,106,167
0131-002,2011,7,14,2,27,34,61,106
0131-002,2011,7,14,3,20,24,44,61
0131-002,2011,7,14,4,23,21,44,44
0131-002,2011,7,14,5,17,28,45,44
0131-002,2011,7,14,6,54,52,106,45
0131-002,2011,7,14,7,179,125,304,106
0131-002,2011,7,14,8,556,444,1000,304
0131-002,2011,7,14,9,460,461,921,1000
0131-002,2011,7,14,10,362,309,671,921
0131-002,2011,7,14,11,339,348,687,671
0131-002,2011,7,14,12,298,305,603,687
0131-002,2011,7,14,13,256,293,549,603
0131-002,2011,7,14,14,283,333,616,549
0131-002,2011,7,14,15,354,367,721,616
0131-002,2011,7,14,16,359,360,719,721
0131-002,2011,7,14,17,342,373,715,719
0131-002,2011,7,14,18,377,415,792,715
0131-002,2011,7,14,19,425,484,909,792
0131-002,2011,7,14,20,304,330,634,909
0131-002,2011,7,14,21,255,306,561,634
0131-002,2011,7,14,22,203,220,423,561
0131-002,2011,7,14,23,142,153,295,423
0131-002,2011,7,14,24,93,81,174,295
0131-002,2011,7,15,1,43,57,100,174
0131-002,2011,7,15,2,23,36,59,100
0131-002,2011,7,15,3,23,28,51,59
0131-002,2011,7,15,4,15,24,39,51
0131-002,2011,7,15,5,20,46,66,39
0131-002,2011,7,15,6,53,48,101,66
0131-002,2011,7,15,7,186,126,312,101
0131-002,2011,7,15,8,546,463,1009,312
0131-002,2011,7,15,9,492,514,1006,1009
0131-002,2011,7,15,10,383,362,745,1006
0131-002,2011,7,15,11,340,344,684,745
0131-002,2011,7,15,12,314,412,726,684
0131-002,2011,7,15,13,262,366,628,726
0131-002,2011,7,15,14,356,359,715,628
0131-002,2011,7,15,15,383,379,762,715
0131-002,2011,7,15,16,397,431,828,762
0131-002,2011,7,15,17,392,385,777,828
0131-002,2011,7,15,18,410,493,903,777
0131-002,2011,7,15,19,489,518,1007,903
0131-002,2011,7,15,20,327,371,698,1007
0131-002,2011,7,15,21,288,303,591,698
0131-002,2011,7,15,22,263,263,526,591
0131-002,2011,7,15,23,166,186,352,526
0131-002,2011,7,15,24,107,83,190,352
0131-002,2011,7,16,1,64,74,138,190
0131-002,2011,7,16,2,44,57,101,138
0131-002,2011,7,16,3,44,39,83,101
0131-002,2011,7,16,4,23,25,48,83
0131-002,2011,7,16,5,34,29,63,48
0131-002,2011,7,16,6,57,67,124,63
0131-002,2011,7,16,7,141,104,245,124
0131-002,2011,7,16,8,351,260,611,245
0131-002,2011,7,16,9,322,376,698,611
0131-002,2011,7,16,10,344,308,652,698
0131-002,2011,7,16,11,313,352,665,652
0131-002,2011,7,16,12,328,438,766,665
0131-002,2011,7,16,13,280,486,766,766
0131-002,2011,7,16,14,282,468,750,766
0131-002,2011,7,16,15,321,585,906,750
0131-002,2011,7,16,16,381,520,901,906
0131-002,2011,7,16,17,450,538,988,901
0131-002,2011,7,16,18,397,570,967,988
0131-002,2011,7,16,19,348,506,854,967
0131-002,2011,7,16,20,258,323,581,854
0131-002,2011,7,16,21,236,219,455,581
0131-002,2011,7,16,22,226,164,390,455
0131-002,2011,7,16,23,105,157,262,390
0131-002,2011,7,16,24,88,77,165,262
0131-002,2011,7,17,1,50,59,109,165
0131-002,2011,7,17,2,37,44,81,109
0131-002,2011,7,17,3,32,28,60,81
0131-002,2011,7,17,4,14,21,35,60
0131-002,2011,7,17,5,24,25,49,35
0131-002,2011,7,17,6,28,55,83,49
0131-002,2011,7,17,7,86,80,166,83
0131-002,2011,7,17,8,112,144,256,166
0131-002,2011,7,17,9,176,143,319,256
0131-002,2011,7,17,10,185,155,340,319
0131-002,2011,7,17,11,196,203,399,340
0131-002,2011,7,17,12,178,197,375,399
0131-002,2011,7,17,13,188,206,394,375
0131-002,2011,7,17,14,236,244,480,394
0131-002,2011,7,17,15,228,262,490,480
0131-002,2011,7,17,16,370,263,633,490
0131-002,2011,7,17,17,465,271,736,633
0131-002,2011,7,17,18,515,279,794,736
0131-002,2011,7,17,19,451,263,714,794
0131-002,2011,7,17,20,311,200,511,714
0131-002,2011,7,17,21,289,192,481,511
0131-002,2011,7,17,22,278,164,442,481
0131-002,2011,7,17,23,102,128,230,442
0131-002,2011,7,17,24,91,81,172,230
0131-002,2011,7,18,1,43,50,93,172
0131-002,2011,7,18,2,26,24,50,93
0131-002,2011,7,18,3,23,24,47,50
0131-002,2011,7,18,4,13,17,30,47
0131-002,2011,7,18,5,25,38,63,30
0131-002,2011,7,18,6,87,72,159,63
0131-002,2011,7,18,7,282,211,493,159
0131-002,2011,7,18,8,618,541,1159,493
0131-002,2011,7,18,9,488,514,1002,1159
0131-002,2011,7,18,10,400,348,748,1002
0131-002,2011,7,18,11,360,360,720,748
0131-002,2011,7,18,12,302,358,660,720
0131-002,2011,7,18,13,307,316,623,660
0131-002,2011,7,18,14,330,355,685,623
0131-002,2011,7,18,15,374,382,756,685
0131-002,2011,7,18,16,388,341,729,756
0131-002,2011,7,18,17,371,394,765,729
0131-002,2011,7,18,18,379,430,809,765
0131-002,2011,7,18,19,422,486,908,809
0131-002,2011,7,18,20,359,380,739,908
0131-002,2011,7,18,21,282,336,618,739
0131-002,2011,7,18,22,240,246,486,618
0131-002,2011,7,18,23,146,133,279,486
0131-002,2011,7,18,24,82,86,168,279
0131-002,2011,7,19,1,42,67,109,168
0131-002,2011,7,19,2,29,36,65,109
0131-002,2011,7,19,3,24,26,50,65
0131-002,2011,7,19,4,22,28,50,50
0131-002,2011,7,19,5,24,46,70,50
0131-002,2011,7,19,6,88,82,170,70
0131-002,2011,7,19,7,240,150,390,170
0131-002,2011,7,19,8,579,452,1031,390
0131-002,2011,7,19,9,460,519,979,1031
0131-002,2011,7,19,10,367,387,754,979
0131-002,2011,7,19,11,363,374,737,754
0131-002,2011,7,19,12,345,341,686,737
0131-002,2011,7,19,13,261,299,560,686
0131-002,2011,7,19,14,320,320,640,560
0131-002,2011,7,19,15,359,340,699,640
0131-002,2011,7,19,16,359,379,738,699
0131-002,2011,7,19,17,425,368,793,738
0131-002,2011,7,19,18,387,415,802,793
0131-002,2011,7,19,19,381,456,837,802
0131-002,2011,7,19,20,362,349,711,837
0131-002,2011,7,19,21,270,336,606,711
0131-002,2011,7,19,22,231,245,476,606
0131-002,2011,7,19,23,168,159,327,476
0131-002,2011,7,19,24,111,102,213,327
0131-002,2011,7,20,1,62,58,120,213
0131-002,2011,7,20,2,30,43,73,120
0131-002,2011,7,20,3,18,21,39,73
0131-002,2011,7,20,4,15,25,40,39
0131-002,2011,7,20,5,33,51,84,40
0131-002,2011,7,20,6,92,91,183,84
0131-002,2011,7,20,7,229,160,389,183
0131-002,2011,7,20,8,589,486,1075,389
0131-002,2011,7,20,9,461,478,939,1075
0131-002,2011,7,20,10,394,376,770,939
0131-002,2011,7,20,11,390,385,775,770
0131-002,2011,7,20,12,339,315,654,775
0131-002,2011,7,20,13,248,328,576,654
0131-002,2011,7,20,14,305,351,656,576
0131-002,2011,7,20,15,377,411,788,656
0131-002,2011,7,20,16,346,413,759,788
0131-002,2011,7,20,17,386,364,750,759
0131-002,2011,7,20,18,404,416,820,750
0131-002,2011,7,20,19,449,510,959,820
0131-002,2011,7,20,20,345,351,696,959
0131-002,2011,7,20,21,265,289,554,696
0131-002,2011,7,20,22,214,236,450,554
0131-002,2011,7,20,23,175,172,347,450
0131-002,2011,7,20,24,109,105,214,347
0131-002,2011,7,21,1,59,70,129,214
0131-002,2011,7,21,2,36,52,88,129
0131-002,2011,7,21,3,25,24,49,88
0131-002,2011,7,21,4,14,28,42,49
0131-002,2011,7,21,5,25,36,61,42
0131-002,2011,7,21,6,106,70,176,61
0131-002,2011,7,21,7,220,152,372,176
0131-002,2011,7,21,8,570,498,1068,372
0131-002,2011,7,21,9,498,527,1025,1068
0131-002,2011,7,21,10,403,381,784,1025
0131-002,2011,7,21,11,347,373,720,784
0131-002,2011,7,21,12,340,350,690,720
0131-002,2011,7,21,13,261,302,563,690
0131-002,2011,7,21,14,302,364,666,563
0131-002,2011,7,21,15,396,390,786,666
0131-002,2011,7,21,16,425,361,786,786
0131-002,2011,7,21,17,373,399,772,786
0131-002,2011,7,21,18,405,455,860,772
0131-002,2011,7,21,19,425,443,868,860
0131-002,2011,7,21,20,318,395,713,868
0131-002,2011,7,21,21,260,323,583,713
0131-002,2011,7,21,22,223,244,467,583
0131-002,2011,7,21,23,173,170,343,467
0131-002,2011,7,21,24,107,100,207,343
0131-002,2011,7,22,1,74,46,120,207
0131-002,2011,7,22,2,37,37,74,120
0131-002,2011,7,22,3,19,32,51,74
0131-002,2011,7,22,4,18,25,43,51
0131-002,2011,7,22,5,27,41,68,43
0131-002,2011,7,22,6,70,58,128,68
0131-002,2011,7,22,7,181,155,336,128
0131-002,2011,7,22,8,580,472,1052,336
0131-002,2011,7,22,9,448,548,996,1052
0131-002,2011,7,22,10,349,355,704,996
0131-002,2011,7,22,11,350,389,739,704
0131-002,2011,7,22,12,364,354,718,739
0131-002,2011,7,22,13,267,297,564,718
0131-002,2011,7,22,14,326,344,670,564
0131-002,2011,7,22,15,409,389,798,670
0131-002,2011,7,22,16,368,424,792,798
0131-002,2011,7,22,17,382,358,740,792
0131-002,2011,7,22,18,397,429,826,740
0131-002,2011,7,22,19,570,560,1130,826
0131-002,2011,7,22,20,385,429,814,1130
0131-002,2011,7,22,21,291,342,633,814
0131-002,2011,7,22,22,261,236,497,633
0131-002,2011,7,22,23,159,212,371,497
0131-002,2011,7,22,24,114,103,217,371
0131-002,2011,7,23,1,72,81,153,217
0131-002,2011,7,23,2,45,52,97,153
0131-002,2011,7,23,3,43,39,82,97
0131-002,2011,7,23,4,23,28,51,82
0131-002,2011,7,23,5,28,48,76,51
0131-002,2011,7,23,6,86,66,152,76
0131-002,2011,7,23,7,145,127,272,152
0131-002,2011,7,23,8,344,357,701,272
0131-002,2011,7,23,9,371,404,775,701
0131-002,2011,7,23,10,351,450,801,775
0131-002,2011,7,23,11,326,612,938,801
0131-002,2011,7,23,12,338,683,1021,938
0131-002,2011,7,23,13,298,694,992,1021
0131-002,2011,7,23,14,305,542,847,992
0131-002,2011,7,23,15,331,589,920,847
0131-002,2011,7,23,16,318,594,912,920
0131-002,2011,7,23,17,382,483,865,912
0131-002,2011,7,23,18,444,479,923,865
0131-002,2011,7,23,19,488,398,886,923
0131-002,2011,7,23,20,267,283,550,886
0131-002,2011,7,23,21,230,270,500,550
0131-002,2011,7,23,22,218,165,383,500
0131-002,2011,7,23,23,129,142,271,383
0131-002,2011,7,23,24,72,95,167,271
0131-002,2011,7,24,1,47,66,113,167
0131-002,2011,7,24,2,23,61,84,113
0131-002,2011,7,24,3,35,35,70,84
0131-002,2011,7,24,4,35,18,53,70
0131-002,2011,7,24,5,22,29,51,53
0131-002,2011,7,24,6,37,33,70,51
0131-002,2011,7,24,7,67,54,121,70
0131-002,2011,7,24,8,106,171,277,121
0131-002,2011,7,24,9,138,172,310,277
0131-002,2011,7,24,10,144,151,295,310
0131-002,2011,7,24,11,183,188,371,295
0131-002,2011,7,24,12,202,195,397,371
0131-002,2011,7,24,13,184,222,406,397
0131-002,2011,7,24,14,239,210,449,406
0131-002,2011,7,24,15,339,258,597,449
0131-002,2011,7,24,16,491,288,779,597
0131-002,2011,7,24,17,559,266,825,779
0131-002,2011,7,24,18,605,226,831,825
0131-002,2011,7,24,19,456,235,691,831
0131-002,2011,7,24,20,256,192,448,691
0131-002,2011,7,24,21,236,179,415,448
0131-002,2011,7,24,22,229,157,386,415
0131-002,2011,7,24,23,118,116,234,386
0131-002,2011,7,24,24,76,73,149,234
0131-002,2011,7,25,1,36,49,85,149
0131-002,2011,7,25,2,34,31,65,85
0131-002,2011,7,25,3,11,16,27,65
0131-002,2011,7,25,4,17,18,35,27
0131-002,2011,7,25,5,19,29,48,35
0131-002,2011,7,25,6,63,61,124,48
0131-002,2011,7,25,7,271,163,434,124
0131-002,2011,7,25,8,584,503,1087,434
0131-002,2011,7,25,9,494,533,1027,1087
0131-002,2011,7,25,10,345,382,727,1027
0131-002,2011,7,25,11,366,387,753,727
0131-002,2011,7,25,12,360,324,684,753
0131-002,2011,7,25,13,292,297,589,684
0131-002,2011,7,25,14,308,341,649,589
0131-002,2011,7,25,15,391,393,784,649
0131-002,2011,7,25,16,399,381,780,784
0131-002,2011,7,25,17,394,385,779,780
0131-002,2011,7,25,18,378,446,824,779
0131-002,2011,7,25,19,448,509,957,824
0131-002,2011,7,25,20,364,369,733,957
0131-002,2011,7,25,21,274,310,584,733
0131-002,2011,7,25,22,221,228,449,584
0131-002,2011,7,25,23,137,163,300,449
0131-002,2011,7,25,24,84,88,172,300
0131-002,2011,7,26,1,55,68,123,172
0131-002,2011,7,26,2,28,31,59,123
0131-002,2011,7,26,3,29,21,50,59
0131-002,2011,7,26,4,11,21,32,50
0131-002,2011,7,26,5,25,37,62,32
0131-002,2011,7,26,6,63,60,123,62
0131-002,2011,7,26,7,194,146,340,123
0131-002,2011,7,26,8,565,474,1039,340
0131-002,2011,7,26,9,527,528,1055,1039
0131-002,2011,7,26,10,409,357,766,1055
0131-002,2011,7,26,11,350,363,713,766
0131-002,2011,7,26,12,355,342,697,713
0131-002,2011,7,26,13,279,307,586,697
0131-002,2011,7,26,14,347,381,728,586
0131-002,2011,7,26,15,404,414,818,728
0131-002,2011,7,26,16,404,381,785,818
0131-002,2011,7,26,17,404,372,776,785
0131-002,2011,7,26,18,428,446,874,776
0131-002,2011,7,26,19,409,459,868,874
0131-002,2011,7,26,20,312,310,622,868
0131-002,2011,7,26,21,239,317,556,622
0131-002,2011,7,26,22,210,243,453,556
0131-002,2011,7,26,23,160,148,308,453
0131-002,2011,7,26,24,79,89,168,308
0131-002,2011,7,27,1,69,56,125,168
0131-002,2011,7,27,2,32,40,72,125
0131-002,2011,7,27,3,19,19,38,72
0131-002,2011,7,27,4,21,25,46,38
0131-002,2011,7,27,5,29,28,57,46
0131-002,2011,7,27,6,46,46,92,57
0131-002,2011,7,27,7,157,109,266,92
0131-002,2011,7,27,8,527,402,929,266
0131-002,2011,7,27,9,483,500,983,929
0131-002,2011,7,27,10,311,340,651,983
0131-002,2011,7,27,11,302,341,643,651
0131-002,2011,7,27,12,319,293,612,643
0131-002,2011,7,27,13,236,265,501,612
0131-002,2011,7,27,14,301,296,597,501
0131-002,2011,7,27,15,349,348,697,597
0131-002,2011,7,27,16,355,365,720,697
0131-002,2011,7,27,17,362,361,723,720
0131-002,2011,7,27,18,376,445,821,723
0131-002,2011,7,27,19,406,438,844,821
0131-002,2011,7,27,20,338,365,703,844
0131-002,2011,7,27,21,225,284,509,703
0131-002,2011,7,27,22,191,234,425,509
0131-002,2011,7,27,23,144,170,314,425
0131-002,2011,7,27,24,112,110,222,314
0131-002,2011,7,28,1,49,45,94,222
0131-002,2011,7,28,2,23,44,67,94
0131-002,2011,7,28,3,13,38,51,67
0131-002,2011,7,28,4,18,28,46,51
0131-002,2011,7,28,5,33,33,66,46
0131-002,2011,7,28,6,55,38,93,66
0131-002,2011,7,28,7,190,108,298,93
0131-002,2011,7,28,8,540,432,972,298
0131-002,2011,7,28,9,450,472,922,972
0131-002,2011,7,28,10,352,358,710,922
0131-002,2011,7,28,11,322,340,662,710
0131-002,2011,7,28,12,303,328,631,662
0131-002,2011,7,28,13,230,279,509,631
0131-002,2011,7,28,14,287,308,595,509
0131-002,2011,7,28,15,385,383,768,595
0131-002,2011,7,28,16,357,353,710,768
0131-002,2011,7,28,17,362,396,758,710
0131-002,2011,7,28,18,371,429,800,758
0131-002,2011,7,28,19,421,457,878,800
0131-002,2011,7,28,20,296,391,687,878
0131-002,2011,7,28,21,245,306,551,687
0131-002,2011,7,28,22,218,201,419,551
0131-002,2011,7,28,23,180,148,328,419
0131-002,2011,7,28,24,97,86,183,328
0131-002,2011,7,29,1,53,46,99,183
0131-002,2011,7,29,2,29,36,65,99
0131-002,2011,7,29,3,19,26,45,65
0131-002,2011,7,29,4,21,23,44,45
0131-002,2011,7,29,5,22,39,61,44
0131-002,2011,7,29,6,66,62,128,61
0131-002,2011,7,29,7,179,123,302,128
0131-002,2011,7,29,8,527,452,979,302
0131-002,2011,7,29,9,463,467,930,979
0131-002,2011,7,29,10,332,351,683,930
0131-002,2011,7,29,11,334,347,681,683
0131-002,2011,7,29,12,324,346,670,681
0131-002,2011,7,29,13,251,269,520,670
0131-002,2011,7,29,14,370,352,722,520
0131-002,2011,7,29,15,379,436,815,722
0131-002,2011,7,29,16,367,428,795,815
0131-002,2011,7,29,17,371,471,842,795
0131-002,2011,7,29,18,473,600,1073,842
0131-002,2011,7,29,19,526,667,1193,1073
0131-002,2011,7,29,20,473,607,1080,1193
0131-002,2011,7,29,21,300,453,753,1080
0131-002,2011,7,29,22,248,362,610,753
0131-002,2011,7,29,23,181,296,477,610
0131-002,2011,7,29,24,113,199,312,477
0131-002,2011,7,30,1,68,209,277,312
0131-002,2011,7,30,2,45,95,140,277
0131-002,2011,7,30,3,30,35,65,140
0131-002,2011,7,30,4,35,39,74,65
0131-002,2011,7,30,5,35,43,78,74
0131-002,2011,7,30,6,58,55,113,78
0131-002,2011,7,30,7,151,135,286,113
0131-002,2011,7,30,8,296,247,543,286
0131-002,2011,7,30,9,368,572,940,543
0131-002,2011,7,30,10,303,685,988,940
0131-002,2011,7,30,11,331,781,1112,988
0131-002,2011,7,30,12,293,835,1128,1112
0131-002,2011,7,30,13,287,764,1051,1128
0131-002,2011,7,30,14,299,764,1063,1051
0131-002,2011,7,30,15,280,909,1189,1063
0131-002,2011,7,30,16,321,925,1246,1189
0131-002,2011,7,30,17,294,856,1150,1246
0131-002,2011,7,30,18,392,923,1315,1150
0131-002,2011,7,30,19,332,908,1240,1315
0131-002,2011,7,30,20,287,750,1037,1240
0131-002,2011,7,30,21,219,322,541,1037
0131-002,2011,7,30,22,195,200,395,541
0131-002,2011,7,30,23,121,152,273,395
0131-002,2011,7,30,24,82,83,165,273
0131-002,2011,7,31,1,47,49,96,165
0131-002,2011,7,31,2,28,33,61,96
0131-002,2011,7,31,3,19,21,40,61
0131-002,2011,7,31,4,34,20,54,40
0131-002,2011,7,31,5,21,20,41,54
0131-002,2011,7,31,6,33,48,81,41
0131-002,2011,7,31,7,98,96,194,81
0131-002,2011,7,31,8,137,108,245,194
0131-002,2011,7,31,9,161,202,363,245
0131-002,2011,7,31,10,175,260,435,363
0131-002,2011,7,31,11,197,320,517,435
0131-002,2011,7,31,12,188,343,531,517
0131-002,2011,7,31,13,167,307,474,531
0131-002,2011,7,31,14,220,325,545,474
0131-002,2011,7,31,15,253,285,538,545
0131-002,2011,7,31,16,395,347,742,538
0131-002,2011,7,31,17,444,345,789,742
0131-002,2011,7,31,18,487,345,832,789
0131-002,2011,7,31,19,472,281,753,832
0131-002,2011,7,31,20,340,225,565,753
0131-002,2011,7,31,21,300,186,486,565
0131-002,2011,7,31,22,195,132,327,486
0131-002,2011,7,31,23,131,88,219,327
0131-002,2011,7,31,24,97,71,168,219
0131-002,2011,8,1,1,46,48,94,168
0131-002,2011,8,1,2,12,31,43,94
0131-002,2011,8,1,3,16,11,27,43
0131-002,2011,8,1,4,24,16,40,27
0131-002,2011,8,1,5,15,34,49,40
0131-002,2011,8,1,6,48,45,93,49
0131-002,2011,8,1,7,171,143,314,93
0131-002,2011,8,1,8,421,369,790,314
0131-002,2011,8,1,9,273,350,623,790
0131-002,2011,8,1,10,263,317,580,623
0131-002,2011,8,1,11,276,298,574,580
0131-002,2011,8,1,12,269,311,580,574
0131-002,2011,8,1,13,221,287,508,580
0131-002,2011,8,1,14,241,288,529,508
0131-002,2011,8,1,15,304,322,626,529
0131-002,2011,8,1,16,362,330,692,626
0131-002,2011,8,1,17,335,318,653,692
0131-002,2011,8,1,18,343,352,695,653
0131-002,2011,8,1,19,398,391,789,695
0131-002,2011,8,1,20,296,265,561,789
0131-002,2011,8,1,21,207,214,421,561
0131-002,2011,8,1,22,183,176,359,421
0131-002,2011,8,1,23,118,124,242,359
0131-002,2011,8,1,24,93,81,174,242
0131-002,2011,8,2,1,42,44,86,174
0131-002,2011,8,2,2,28,46,74,86
0131-002,2011,8,2,3,14,28,42,74
0131-002,2011,8,2,4,12,20,32,42
0131-002,2011,8,2,5,21,25,46,32
0131-002,2011,8,2,6,51,51,102,46
0131-002,2011,8,2,7,190,119,309,102
0131-002,2011,8,2,8,382,325,707,309
0131-002,2011,8,2,9,294,390,684,707
0131-002,2011,8,2,10,310,279,589,684
0131-002,2011,8,2,11,320,289,609,589
0131-002,2011,8,2,12,279,335,614,609
0131-002,2011,8,2,13,252,277,529,614
0131-002,2011,8,2,14,285,314,599,529
0131-002,2011,8,2,15,332,292,624,599
0131-002,2011,8,2,16,361,318,679,624
0131-002,2011,8,2,17,356,343,699,679
0131-002,2011,8,2,18,444,362,806,699
0131-002,2011,8,2,19,503,391,894,806
0131-002,2011,8,2,20,473,289,762,894
0131-002,2011,8,2,21,283,231,514,762
0131-002,2011,8,2,22,213,197,410,514
0131-002,2011,8,2,23,164,109,273,410
0131-002,2011,8,2,24,98,97,195,273
0131-002,2011,8,3,1,53,58,111,195
0131-002,2011,8,3,2,34,42,76,111
0131-002,2011,8,3,3,18,29,47,76
0131-002,2011,8,3,4,19,18,37,47
0131-002,2011,8,3,5,26,25,51,37
0131-002,2011,8,3,6,63,56,119,51
0131-002,2011,8,3,7,175,146,321,119
0131-002,2011,8,3,8,417,325,742,321
0131-002,2011,8,3,9,321,367,688,742
0131-002,2011,8,3,10,282,294,576,688
0131-002,2011,8,3,11,301,307,608,576
0131-002,2011,8,3,12,282,290,572,608
0131-002,2011,8,3,13,241,290,531,572
0131-002,2011,8,3,14,285,325,610,531
0131-002,2011,8,3,15,297,303,600,610
0131-002,2011,8,3,16,372,306,678,600
0131-002,2011,8,3,17,414,342,756,678
0131-002,2011,8,3,18,474,368,842,756
0131-002,2011,8,3,19,631,427,1058,842
0131-002,2011,8,3,20,605,277,882,1058
0131-002,2011,8,3,21,450,228,678,882
0131-002,2011,8,3,22,283,181,464,678
0131-002,2011,8,3,23,148,133,281,464
0131-002,2011,8,3,24,83,80,163,281
0131-002,2011,8,4,1,58,56,114,163
0131-002,2011,8,4,2,31,36,67,114
0131-002,2011,8,4,3,25,31,56,67
0131-002,2011,8,4,4,13,26,39,56
0131-002,2011,8,4,5,18,29,47,39
0131-002,2011,8,4,6,59,69,128,47
0131-002,2011,8,4,7,181,117,298,128
0131-002,2011,8,4,8,499,386,885,298
0131-002,2011,8,4,9,367,434,801,885
0131-002,2011,8,4,10,308,341,649,801
0131-002,2011,8,4,11,336,326,662,649
0131-002,2011,8,4,12,328,299,627,662
0131-002,2011,8,4,13,237,301,538,627
0131-002,2011,8,4,14,287,304,591,538
0131-002,2011,8,4,15,352,393,745,591
0131-002,2011,8,4,16,363,343,706,745
0131-002,2011,8,4,17,410,359,769,706
0131-002,2011,8,4,18,445,358,803,769
0131-002,2011,8,4,19,409,441,850,803
0131-002,2011,8,4,20,258,313,571,850
0131-002,2011,8,4,21,247,247,494,571
0131-002,2011,8,4,22,213,194,407,494
0131-002,2011,8,4,23,115,157,272,407
0131-002,2011,8,4,24,95,80,175,272
0131-002,2011,8,5,1,55,52,107,175
0131-002,2011,8,5,2,24,36,60,107
0131-002,2011,8,5,3,9,27,36,60
0131-002,2011,8,5,4,10,25,35,36
0131-002,2011,8,5,5,30,41,71,35
0131-002,2011,8,5,6,70,66,136,71
0131-002,2011,8,5,7,197,132,329,136
0131-002,2011,8,5,8,474,404,878,329
0131-002,2011,8,5,9,409,426,835,878
0131-002,2011,8,5,10,372,338,710,835
0131-002,2011,8,5,11,326,370,696,710
0131-002,2011,8,5,12,325,348,673,696
0131-002,2011,8,5,13,290,325,615,673
0131-002,2011,8,5,14,316,381,697,615
0131-002,2011,8,5,15,350,381,731,697
0131-002,2011,8,5,16,367,400,767,731
0131-002,2011,8,5,17,403,356,759,767
0131-002,2011,8,5,18,471,388,859,759
0131-002,2011,8,5,19,449,458,907,859
0131-002,2011,8,5,20,384,354,738,907
0131-002,2011,8,5,21,265,308,573,738
0131-002,2011,8,5,22,258,231,489,573
0131-002,2011,8,5,23,161,145,306,489
0131-002,2011,8,5,24,105,101,206,306
0131-002,2011,8,6,1,79,58,137,206
0131-002,2011,8,6,2,49,48,97,137
0131-002,2011,8,6,3,37,38,75,97
0131-002,2011,8,6,4,23,33,56,75
0131-002,2011,8,6,5,38,42,80,56
0131-002,2011,8,6,6,73,69,142,80
0131-002,2011,8,6,7,122,161,283,142
0131-002,2011,8,6,8,341,253,594,283
0131-002,2011,8,6,9,325,327,652,594
0131-002,2011,8,6,10,315,356,671,652
0131-002,2011,8,6,11,301,410,711,671
0131-002,2011,8,6,12,315,489,804,711
0131-002,2011,8,6,13,322,461,783,804
0131-002,2011,8,6,14,346,487,833,783
0131-002,2011,8,6,15,387,445,832,833
0131-002,2011,8,6,16,439,408,847,832
0131-002,2011,8,6,17,483,369,852,847
0131-002,2011,8,6,18,547,372,919,852
0131-002,2011,8,6,19,539,336,875,919
0131-002,2011,8,6,20,438,276,714,875
0131-002,2011,8,6,21,249,198,447,714
0131-002,2011,8,6,22,242,165,407,447
0131-002,2011,8,6,23,138,128,266,407
0131-002,2011,8,6,24,95,96,191,266
0131-002,2011,8,7,1,62,64,126,191
0131-002,2011,8,7,2,33,44,77,126
0131-002,2011,8,7,3,27,23,50,77
0131-002,2011,8,7,4,20,32,52,50
0131-002,2011,8,7,5,27,34,61,52
0131-002,2011,8,7,6,55,30,85,61
0131-002,2011,8,7,7,74,111,185,85
0131-002,2011,8,7,8,129,121,250,185
0131-002,2011,8,7,9,183,176,359,250
0131-002,2011,8,7,10,198,187,385,359
0131-002,2011,8,7,11,185,217,402,385
0131-002,2011,8,7,12,234,215,449,402
0131-002,2011,8,7,13,403,232,635,449
0131-002,2011,8,7,14,396,242,638,635
0131-002,2011,8,7,15,419,252,671,638
0131-002,2011,8,7,16,501,267,768,671
0131-002,2011,8,7,17,561,266,827,768
0131-002,2011,8,7,18,520,268,788,827
0131-002,2011,8,7,19,478,220,698,788
0131-002,2011,8,7,20,402,208,610,698
0131-002,2011,8,7,21,305,175,480,610
0131-002,2011,8,7,22,229,150,379,480
0131-002,2011,8,7,23,101,100,201,379
0131-002,2011,8,7,24,64,58,122,201
0131-002,2011,8,8,1,40,40,80,122
0131-002,2011,8,8,2,27,31,58,80
0131-002,2011,8,8,3,16,22,38,58
0131-002,2011,8,8,4,11,17,28,38
0131-002,2011,8,8,5,17,28,45,28
0131-002,2011,8,8,6,47,58,105,45
0131-002,2011,8,8,7,205,155,360,105
0131-002,2011,8,8,8,629,519,1148,360
0131-002,2011,8,8,9,427,451,878,1148
0131-002,2011,8,8,10,312,363,675,878
0131-002,2011,8,8,11,303,348,651,675
0131-002,2011,8,8,12,317,325,642,651
0131-002,2011,8,8,13,302,291,593,642
0131-002,2011,8,8,14,301,316,617,593
0131-002,2011,8,8,15,351,348,699,617
0131-002,2011,8,8,16,360,344,704,699
0131-002,2011,8,8,17,358,363,721,704
0131-002,2011,8,8,18,329,401,730,721
0131-002,2011,8,8,19,409,445,854,730
0131-002,2011,8,8,20,302,310,612,854
0131-002,2011,8,8,21,233,264,497,612
0131-002,2011,8,8,22,205,225,430,497
0131-002,2011,8,8,23,159,125,284,430
0131-002,2011,8,8,24,61,82,143,284
0131-002,2011,8,9,1,53,53,106,143
0131-002,2011,8,9,2,24,28,52,106
0131-002,2011,8,9,3,20,25,45,52
0131-002,2011,8,9,4,18,23,41,45
0131-002,2011,8,9,5,17,31,48,41
0131-002,2011,8,9,6,52,55,107,48
0131-002,2011,8,9,7,213,132,345,107
0131-002,2011,8,9,8,618,485,1103,345
0131-002,2011,8,9,9,431,445,876,1103
0131-002,2011,8,9,10,328,370,698,876
0131-002,2011,8,9,11,313,325,638,698
0131-002,2011,8,9,12,317,344,661,638
0131-002,2011,8,9,13,227,282,509,661
0131-002,2011,8,9,14,311,331,642,509
0131-002,2011,8,9,15,370,383,753,642
0131-002,2011,8,9,16,364,375,739,753
0131-002,2011,8,9,17,387,381,768,739
0131-002,2011,8,9,18,382,367,749,768
0131-002,2011,8,9,19,409,468,877,749
0131-002,2011,8,9,20,295,377,672,877
0131-002,2011,8,9,21,244,327,571,672
0131-002,2011,8,9,22,230,203,433,571
0131-002,2011,8,9,23,148,147,295,433
0131-002,2011,8,9,24,103,83,186,295
0131-002,2011,8,10,1,66,52,118,186
0131-002,2011,8,10,2,45,32,77,118
0131-002,2011,8,10,3,21,25,46,77
0131-002,2011,8,10,4,19,25,44,46
0131-002,2011,8,10,5,30,32,62,44
0131-002,2011,8,10,6,67,60,127,62
0131-002,2011,8,10,7,202,135,337,127
0131-002,2011,8,10,8,546,480,1026,337
0131-002,2011,8,10,9,506,526,1032,1026
0131-002,2011,8,10,10,387,381,768,1032
0131-002,2011,8,10,11,376,353,729,768
0131-002,2011,8,10,12,349,365,714,729
0131-002,2011,8,10,13,300,342,642,714
0131-002,2011,8,10,14,348,348,696,642
0131-002,2011,8,10,15,382,389,771,696
0131-002,2011,8,10,16,384,361,745,771
0131-002,2011,8,10,17,366,395,761,745
0131-002,2011,8,10,18,438,465,903,761
0131-002,2011,8,10,19,463,547,1010,903
0131-002,2011,8,10,20,313,381,694,1010
0131-002,2011,8,10,21,238,270,508,694
0131-002,2011,8,10,22,195,217,412,508
0131-002,2011,8,10,23,165,148,313,412
0131-002,2011,8,10,24,92,102,194,313
0131-002,2011,8,11,1,46,56,102,194
0131-002,2011,8,11,2,49,58,107,102
0131-002,2011,8,11,3,32,30,62,107
0131-002,2011,8,11,4,22,26,48,62
0131-002,2011,8,11,5,33,47,80,48
0131-002,2011,8,11,6,79,67,146,80
0131-002,2011,8,11,7,250,151,401,146
0131-002,2011,8,11,8,575,507,1082,401
0131-002,2011,8,11,9,521,527,1048,1082
0131-002,2011,8,11,10,351,340,691,1048
0131-002,2011,8,11,11,385,372,757,691
0131-002,2011,8,11,12,332,370,702,757
0131-002,2011,8,11,13,256,333,589,702
0131-002,2011,8,11,14,375,352,727,589
0131-002,2011,8,11,15,394,404,798,727
0131-002,2011,8,11,16,393,390,783,798
0131-002,2011,8,11,17,411,400,811,783
0131-002,2011,8,11,18,422,431,853,811
0131-002,2011,8,11,19,452,459,911,853
0131-002,2011,8,11,20,316,386,702,911
0131-002,2011,8,11,21,247,305,552,702
0131-002,2011,8,11,22,222,260,482,552
0131-002,2011,8,11,23,178,146,324,482
0131-002,2011,8,11,24,96,101,197,324
0131-002,2011,8,12,1,57,59,116,197
0131-002,2011,8,12,2,43,30,73,116
0131-002,2011,8,12,3,28,28,56,73
0131-002,2011,8,12,4,23,21,44,56
0131-002,2011,8,12,5,31,42,73,44
0131-002,2011,8,12,6,64,68,132,73
0131-002,2011,8,12,7,213,149,362,132
0131-002,2011,8,12,8,556,463,1019,362
0131-002,2011,8,12,9,483,543,1026,1019
0131-002,2011,8,12,10,377,401,778,1026
0131-002,2011,8,12,11,355,398,753,778
0131-002,2011,8,12,12,343,341,684,753
0131-002,2011,8,12,13,255,344,599,684
0131-002,2011,8,12,14,314,348,662,599
0131-002,2011,8,12,15,406,403,809,662
0131-002,2011,8,12,16,339,437,776,809
0131-002,2011,8,12,17,422,498,920,776
0131-002,2011,8,12,18,490,637,1127,920
0131-002,2011,8,12,19,603,623,1226,1127
0131-002,2011,8,12,20,533,558,1091,1226
0131-002,2011,8,12,21,415,526,941,1091
0131-002,2011,8,12,22,312,368,680,941
0131-002,2011,8,12,23,152,268,420,680
0131-002,2011,8,12,24,101,147,248,420
0131-002,2011,8,13,1,82,68,150,248
0131-002,2011,8,13,2,35,41,76,150
0131-002,2011,8,13,3,29,35,64,76
0131-002,2011,8,13,4,31,28,59,64
0131-002,2011,8,13,5,21,35,56,59
0131-002,2011,8,13,6,51,47,98,56
0131-002,2011,8,13,7,137,127,264,98
0131-002,2011,8,13,8,320,290,610,264
0131-002,2011,8,13,9,333,407,740,610
0131-002,2011,8,13,10,316,440,756,740
0131-002,2011,8,13,11,341,623,964,756
0131-002,2011,8,13,12,310,683,993,964
0131-002,2011,8,13,13,275,845,1120,993
0131-002,2011,8,13,14,297,902,1199,1120
0131-002,2011,8,13,15,340,926,1266,1199
0131-002,2011,8,13,16,360,944,1304,1266
0131-002,2011,8,13,17,359,940,1299,1304
0131-002,2011,8,13,18,394,1038,1432,1299
0131-002,2011,8,13,19,368,877,1245,1432
0131-002,2011,8,13,20,274,719,993,1245
0131-002,2011,8,13,21,252,921,1173,993
0131-002,2011,8,13,22,213,425,638,1173
0131-002,2011,8,13,23,137,220,357,638
0131-002,2011,8,13,24,83,94,177,357
0131-002,2011,8,14,1,57,66,123,177
0131-002,2011,8,14,2,35,42,77,123
0131-002,2011,8,14,3,28,20,48,77
0131-002,2011,8,14,4,25,30,55,48
0131-002,2011,8,14,5,26,31,57,55
0131-002,2011,8,14,6,29,28,57,57
0131-002,2011,8,14,7,93,75,168,57
0131-002,2011,8,14,8,143,134,277,168
0131-002,2011,8,14,9,160,196,356,277
0131-002,2011,8,14,10,161,208,369,356
0131-002,2011,8,14,11,183,266,449,369
0131-002,2011,8,14,12,223,308,531,449
0131-002,2011,8,14,13,184,301,485,531
0131-002,2011,8,14,14,220,295,515,485
0131-002,2011,8,14,15,295,297,592,515
0131-002,2011,8,14,16,415,337,752,592
0131-002,2011,8,14,17,504,351,855,752
0131-002,2011,8,14,18,531,388,919,855
0131-002,2011,8,14,19,490,368,858,919
0131-002,2011,8,14,20,519,274,793,858
0131-002,2011,8,14,21,488,176,664,793
0131-002,2011,8,14,22,398,140,538,664
0131-002,2011,8,14,23,293,113,406,538
0131-002,2011,8,14,24,116,82,198,406
0131-002,2011,8,15,1,70,55,125,198
0131-002,2011,8,15,2,24,48,72,125
0131-002,2011,8,15,3,29,20,49,72
0131-002,2011,8,15,4,15,23,38,49
0131-002,2011,8,15,5,24,32,56,38
0131-002,2011,8,15,6,47,72,119,56
0131-002,2011,8,15,7,125,122,247,119
0131-002,2011,8,15,8,258,205,463,247
0131-002,2011,8,15,9,241,236,477,463
0131-002,2011,8,15,10,230,238,468,477
0131-002,2011,8,15,11,286,260,546,468
0131-002,2011,8,15,12,460,258,718,546
0131-002,2011,8,15,13,476,264,740,718
0131-002,2011,8,15,14,468,239,707,740
0131-002,2011,8,15,15,479,264,743,707
0131-002,2011,8,15,16,746,260,1006,743
0131-002,2011,8,15,17,770,293,1063,1006
0131-002,2011,8,15,18,658,279,937,1063
0131-002,2011,8,15,19,535,300,835,937
0131-002,2011,8,15,20,527,226,753,835
0131-002,2011,8,15,21,560,206,766,753
0131-002,2011,8,15,22,283,163,446,766
0131-002,2011,8,15,23,180,134,314,446
0131-002,2011,8,15,24,102,79,181,314
0131-002,2011,8,16,1,58,41,99,181
0131-002,2011,8,16,2,32,25,57,99
0131-002,2011,8,16,3,28,18,46,57
0131-002,2011,8,16,4,14,30,44,46
0131-002,2011,8,16,5,18,40,58,44
0131-002,2011,8,16,6,79,80,159,58
0131-002,2011,8,16,7,272,196,468,159
0131-002,2011,8,16,8,609,571,1180,468
0131-002,2011,8,16,9,503,503,1006,1180
0131-002,2011,8,16,10,378,398,776,1006
0131-002,2011,8,16,11,392,391,783,776
0131-002,2011,8,16,12,381,409,790,783
0131-002,2011,8,16,13,301,338,639,790
0131-002,2011,8,16,14,355,376,731,639
0131-002,2011,8,16,15,388,431,819,731
0131-002,2011,8,16,16,396,355,751,819
0131-002,2011,8,16,17,365,407,772,751
0131-002,2011,8,16,18,455,398,853,772
0131-002,2011,8,16,19,408,435,843,853
0131-002,2011,8,16,20,329,366,695,843
0131-002,2011,8,16,21,260,308,568,695
0131-002,2011,8,16,22,193,244,437,568
0131-002,2011,8,16,23,139,127,266,437
0131-002,2011,8,16,24,90,102,192,266
0131-002,2011,8,17,1,56,51,107,192
0131-002,2011,8,17,2,30,27,57,107
0131-002,2011,8,17,3,19,18,37,57
0131-002,2011,8,17,4,6,15,21,37
0131-002,2011,8,17,5,15,25,40,21
0131-002,2011,8,17,6,51,47,98,40
0131-002,2011,8,17,7,183,121,304,98
0131-002,2011,8,17,8,545,424,969,304
0131-002,2011,8,17,9,477,480,957,969
0131-002,2011,8,17,10,351,338,689,957
0131-002,2011,8,17,11,355,373,728,689
0131-002,2011,8,17,12,367,341,708,728
0131-002,2011,8,17,13,299,329,628,708
0131-002,2011,8,17,14,338,331,669,628
0131-002,2011,8,17,15,375,376,751,669
0131-002,2011,8,17,16,380,410,790,751
0131-002,2011,8,17,17,370,399,769,790
0131-002,2011,8,17,18,407,443,850,769
0131-002,2011,8,17,19,385,469,854,850
0131-002,2011,8,17,20,305,331,636,854
0131-002,2011,8,17,21,222,267,489,636
0131-002,2011,8,17,22,198,202,400,489
0131-002,2011,8,17,23,129,153,282,400
0131-002,2011,8,17,24,77,81,158,282
0131-002,2011,8,18,1,57,42,99,158
0131-002,2011,8,18,2,19,26,45,99
0131-002,2011,8,18,3,33,22,55,45
0131-002,2011,8,18,4,8,28,36,55
0131-002,2011,8,18,5,14,25,39,36
0131-002,2011,8,18,6,66,39,105,39
0131-002,2011,8,18,7,212,155,367,105
0131-002,2011,8,18,8,541,492,1033,367
0131-002,2011,8,18,9,526,518,1044,1033
0131-002,2011,8,18,10,344,365,709,1044
0131-002,2011,8,18,11,348,416,764,709
0131-002,2011,8,18,12,328,373,701,764
0131-002,2011,8,18,13,251,293,544,701
0131-002,2011,8,18,14,318,363,681,544
0131-002,2011,8,18,15,347,362,709,681
0131-002,2011,8,18,16,403,383,786,709
0131-002,2011,8,18,17,406,383,789,786
0131-002,2011,8,18,18,419,461,880,789
0131-002,2011,8,18,19,454,492,946,880
0131-002,2011,8,18,20,331,383,714,946
0131-002,2011,8,18,21,301,326,627,714
0131-002,2011,8,18,22,232,252,484,627
0131-002,2011,8,18,23,158,178,336,484
0131-002,2011,8,18,24,92,101,193,336
0131-002,2011,8,19,1,51,70,121,193
0131-002,2011,8,19,2,33,41,74,121
0131-002,2011,8,19,3,28,21,49,74
0131-002,2011,8,19,4,16,32,48,49
0131-002,2011,8,19,5,21,43,64,48
0131-002,2011,8,19,6,89,85,174,64
0131-002,2011,8,19,7,221,160,381,174
0131-002,2011,8,19,8,581,512,1093,381
0131-002,2011,8,19,9,545,529,1074,1093
0131-002,2011,8,19,10,389,401,790,1074
0131-002,2011,8,19,11,357,382,739,790
0131-002,2011,8,19,12,345,338,683,739
0131-002,2011,8,19,13,309,347,656,683
0131-002,2011,8,19,14,350,398,748,656
0131-002,2011,8,19,15,396,435,831,748
0131-002,2011,8,19,16,448,439,887,831
0131-002,2011,8,19,17,429,429,858,887
0131-002,2011,8,19,18,456,490,946,858
0131-002,2011,8,19,19,541,531,1072,946
0131-002,2011,8,19,20,387,454,841,1072
0131-002,2011,8,19,21,319,306,625,841
0131-002,2011,8,19,22,230,272,502,625
0131-002,2011,8,19,23,163,201,364,502
0131-002,2011,8,19,24,109,107,216,364
0131-002,2011,8,20,1,62,73,135,216
0131-002,2011,8,20,2,55,43,98,135
0131-002,2011,8,20,3,26,27,53,98
0131-002,2011,8,20,4,27,29,56,53
0131-002,2011,8,20,5,26,51,77,56
0131-002,2011,8,20,6,80,82,162,77
0131-002,2011,8,20,7,151,133,284,162
0131-002,2011,8,20,8,363,305,668,284
0131-002,2011,8,20,9,386,358,744,668
0131-002,2011,8,20,10,394,398,792,744
0131-002,2011,8,20,11,374,432,806,792
0131-002,2011,8,20,12,359,543,902,806
0131-002,2011,8,20,13,329,556,885,902
0131-002,2011,8,20,14,350,570,920,885
0131-002,2011,8,20,15,360,647,1007,920
0131-002,2011,8,20,16,426,568,994,1007
0131-002,2011,8,20,17,489,541,1030,994
0131-002,2011,8,20,18,500,465,965,1030
0131-002,2011,8,20,19,458,389,847,965
0131-002,2011,8,20,20,300,309,609,847
0131-002,2011,8,20,21,201,240,441,609
0131-002,2011,8,20,22,177,201,378,441
0131-002,2011,8,20,23,125,126,251,378
0131-002,2011,8,20,24,84,97,181,251
0131-002,2011,8,21,1,54,73,127,181
0131-002,2011,8,21,2,36,37,73,127
0131-002,2011,8,21,3,27,28,55,73
0131-002,2011,8,21,4,16,27,43,55
0131-002,2011,8,21,5,28,51,79,43
0131-002,2011,8,21,6,67,48,115,79
0131-002,2011,8,21,7,125,114,239,115
0131-002,2011,8,21,8,197,138,335,239
0131-002,2011,8,21,9,217,227,444,335
0131-002,2011,8,21,10,251,224,475,444
0131-002,2011,8,21,11,236,285,521,475
0131-002,2011,8,21,12,228,260,488,521
0131-002,2011,8,21,13,237,250,487,488
0131-002,2011,8,21,14,259,247,506,487
0131-002,2011,8,21,15,306,258,564,506
0131-002,2011,8,21,16,485,252,737,564
0131-002,2011,8,21,17,514,276,790,737
0131-002,2011,8,21,18,598,303,901,790
0131-002,2011,8,21,19,587,275,862,901
0131-002,2011,8,21,20,488,252,740,862
0131-002,2011,8,21,21,314,206,520,740
0131-002,2011,8,21,22,205,167,372,520
0131-002,2011,8,21,23,117,138,255,372
0131-002,2011,8,21,24,97,82,179,255
0131-002,2011,8,22,1,53,52,105,179
0131-002,2011,8,22,2,25,23,48,105
0131-002,2011,8,22,3,12,13,25,48
0131-002,2011,8,22,4,18,23,41,25
0131-002,2011,8,22,5,22,33,55,41
0131-002,2011,8,22,6,66,65,131,55
0131-002,2011,8,22,7,273,205,478,131
0131-002,2011,8,22,8,638,539,1177,478
0131-002,2011,8,22,9,487,535,1022,1177
0131-002,2011,8,22,10,372,405,777,1022
0131-002,2011,8,22,11,365,393,758,777
0131-002,2011,8,22,12,345,366,711,758
0131-002,2011,8,22,13,280,333,613,711
0131-002,2011,8,22,14,346,351,697,613
0131-002,2011,8,22,15,424,413,837,697
0131-002,2011,8,22,16,401,383,784,837
0131-002,2011,8,22,17,421,413,834,784
0131-002,2011,8,22,18,391,461,852,834
0131-002,2011,8,22,19,440,475,915,852
0131-002,2011,8,22,20,345,382,727,915
0131-002,2011,8,22,21,253,335,588,727
0131-002,2011,8,22,22,230,290,520,588
0131-002,2011,8,22,23,152,169,321,520
0131-002,2011,8,22,24,100,107,207,321
0131-002,2011,8,23,1,65,56,121,207
0131-002,2011,8,23,2,34,27,61,121
0131-002,2011,8,23,3,17,22,39,61
0131-002,2011,8,23,4,14,17,31,39
0131-002,2011,8,23,5,20,37,57,31
0131-002,2011,8,23,6,78,64,142,57
0131-002,2011,8,23,7,255,161,416,142
0131-002,2011,8,23,8,598,514,1112,416
0131-002,2011,8,23,9,522,533,1055,1112
0131-002,2011,8,23,10,379,395,774,1055
0131-002,2011,8,23,11,378,407,785,774
0131-002,2011,8,23,12,360,330,690,785
0131-002,2011,8,23,13,274,356,630,690
0131-002,2011,8,23,14,355,361,716,630
0131-002,2011,8,23,15,376,406,782,716
0131-002,2011,8,23,16,425,367,792,782
0131-002,2011,8,23,17,371,447,818,792
0131-002,2011,8,23,18,422,469,891,818
0131-002,2011,8,23,19,422,467,889,891
0131-002,2011,8,23,20,355,410,765,889
0131-002,2011,8,23,21,263,332,595,765
0131-002,2011,8,23,22,219,254,473,595
0131-002,2011,8,23,23,147,147,294,473
0131-002,2011,8,23,24,88,102,190,294
0131-002,2011,8,24,1,49,53,102,190
0131-002,2011,8,24,2,38,42,80,102
0131-002,2011,8,24,3,18,26,44,80
0131-002,2011,8,24,4,19,22,41,44
0131-002,2011,8,24,5,27,37,64,41
0131-002,2011,8,24,6,65,61,126,64
0131-002,2011,8,24,7,251,165,416,126
0131-002,2011,8,24,8,613,485,1098,416
0131-002,2011,8,24,9,532,530,1062,1098
0131-002,2011,8,24,10,405,378,783,1062
0131-002,2011,8,24,11,386,408,794,783
0131-002,2011,8,24,12,372,392,764,794
0131-002,2011,8,24,13,304,330,634,764
0131-002,2011,8,24,14,344,356,700,634
0131-002,2011,8,24,15,389,377,766,700
0131-002,2011,8,24,16,379,412,791,766
0131-002,2011,8,24,17,434,410,844,791
0131-002,2011,8,24,18,414,466,880,844
0131-002,2011,8,24,19,433,511,944,880
0131-002,2011,8,24,20,335,347,682,944
0131-002,2011,8,24,21,252,296,548,682
0131-002,2011,8,24,22,210,237,447,548
0131-002,2011,8,24,23,140,143,283,447
0131-002,2011,8,24,24,87,101,188,283
0131-002,2011,8,25,1,63,55,118,188
0131-002,2011,8,25,2,24,25,49,118
0131-002,2011,8,25,3,15,17,32,49
0131-002,2011,8,25,4,17,17,34,32
0131-002,2011,8,25,5,25,39,64,34
0131-002,2011,8,25,6,64,50,114,64
0131-002,2011,8,25,7,240,182,422,114
0131-002,2011,8,25,8,621,501,1122,422
0131-002,2011,8,25,9,546,524,1070,1122
0131-002,2011,8,25,10,369,369,738,1070
0131-002,2011,8,25,11,385,434,819,738
0131-002,2011,8,25,12,351,349,700,819
0131-002,2011,8,25,13,286,307,593,700
0131-002,2011,8,25,14,340,384,724,593
0131-002,2011,8,25,15,385,412,797,724
0131-002,2011,8,25,16,423,415,838,797
0131-002,2011,8,25,17,445,383,828,838
0131-002,2011,8,25,18,423,454,877,828
0131-002,2011,8,25,19,483,506,989,877
0131-002,2011,8,25,20,319,365,684,989
0131-002,2011,8,25,21,271,317,588,684
0131-002,2011,8,25,22,232,263,495,588
0131-002,2011,8,25,23,152,165,317,495
0131-002,2011,8,25,24,95,99,194,317
0131-002,2011,8,26,1,61,67,128,194
0131-002,2011,8,26,2,44,39,83,128
0131-002,2011,8,26,3,26,28,54,83
0131-002,2011,8,26,4,14,31,45,54
0131-002,2011,8,26,5,19,37,56,45
0131-002,2011,8,26,6,63,57,120,56
0131-002,2011,8,26,7,223,162,385,120
0131-002,2011,8,26,8,642,516,1158,385
0131-002,2011,8,26,9,520,555,1075,1158
0131-002,2011,8,26,10,393,396,789,1075
0131-002,2011,8,26,11,407,426,833,789
0131-002,2011,8,26,12,358,423,781,833
0131-002,2011,8,26,13,295,372,667,781
0131-002,2011,8,26,14,387,408,795,667
0131-002,2011,8,26,15,426,445,871,795
0131-002,2011,8,26,16,460,446,906,871
0131-002,2011,8,26,17,381,437,818,906
0131-002,2011,8,26,18,486,495,981,818
0131-002,2011,8,26,19,524,538,1062,981
0131-002,2011,8,26,20,413,463,876,1062
0131-002,2011,8,26,21,321,362,683,876
0131-002,2011,8,26,22,270,254,524,683
0131-002,2011,8,26,23,180,194,374,524
0131-002,2011,8,26,24,103,107,210,374
0131-002,2011,8,27,1,70,83,153,210
0131-002,2011,8,27,2,62,55,117,153
0131-002,2011,8,27,3,24,48,72,117
0131-002,2011,8,27,4,34,38,72,72
0131-002,2011,8,27,5,27,48,75,72
0131-002,2011,8,27,6,64,53,117,75
0131-002,2011,8,27,7,145,146,291,117
0131-002,2011,8,27,8,363,276,639,291
0131-002,2011,8,27,9,353,462,815,639
0131-002,2011,8,27,10,349,606,955,815
0131-002,2011,8,27,11,302,654,956,955
0131-002,2011,8,27,12,385,840,1225,956
0131-002,2011,8,27,13,382,828,1210,1225
0131-002,2011,8,27,14,430,772,1202,1210
0131-002,2011,8,27,15,418,746,1164,1202
0131-002,2011,8,27,16,534,786,1320,1164
0131-002,2011,8,27,17,580,835,1415,1320
0131-002,2011,8,27,18,704,775,1479,1415
0131-002,2011,8,27,19,679,660,1339,1479
0131-002,2011,8,27,20,541,467,1008,1339
0131-002,2011,8,27,21,419,269,688,1008
0131-002,2011,8,27,22,246,215,461,688
0131-002,2011,8,27,23,153,155,308,461
0131-002,2011,8,27,24,83,101,184,308
0131-002,2011,8,28,1,66,66,132,184
0131-002,2011,8,28,2,39,45,84,132
0131-002,2011,8,28,3,33,38,71,84
0131-002,2011,8,28,4,28,29,57,71
0131-002,2011,8,28,5,29,35,64,57
0131-002,2011,8,28,6,55,62,117,64
0131-002,2011,8,28,7,111,126,237,117
0131-002,2011,8,28,8,181,237,418,237
0131-002,2011,8,28,9,190,310,500,418
0131-002,2011,8,28,10,221,336,557,500
0131-002,2011,8,28,11,218,366,584,557
0131-002,2011,8,28,12,345,368,713,584
0131-002,2011,8,28,13,443,300,743,713
0131-002,2011,8,28,14,468,271,739,743
0131-002,2011,8,28,15,620,295,915,739
0131-002,2011,8,28,16,697,260,957,915
0131-002,2011,8,28,17,771,288,1059,957
0131-002,2011,8,28,18,697,293,990,1059
0131-002,2011,8,28,19,739,256,995,990
0131-002,2011,8,28,20,662,219,881,995
0131-002,2011,8,28,21,693,225,918,881
0131-002,2011,8,28,22,688,190,878,918
0131-002,2011,8,28,23,728,121,849,878
0131-002,2011,8,28,24,500,83,583,849
0131-002,2011,8,29,1,261,70,331,583
0131-002,2011,8,29,2,36,33,69,331
0131-002,2011,8,29,3,16,23,39,69
0131-002,2011,8,29,4,13,23,36,39
0131-002,2011,8,29,5,25,29,54,36
0131-002,2011,8,29,6,81,72,153,54
0131-002,2011,8,29,7,280,208,488,153
0131-002,2011,8,29,8,626,586,1212,488
0131-002,2011,8,29,9,529,555,1084,1212
0131-002,2011,8,29,10,426,412,838,1084
0131-002,2011,8,29,11,393,395,788,838
0131-002,2011,8,29,12,344,418,762,788
0131-002,2011,8,29,13,293,346,639,762
0131-002,2011,8,29,14,339,379,718,639
0131-002,2011,8,29,15,412,411,823,718
0131-002,2011,8,29,16,434,389,823,823
0131-002,2011,8,29,17,420,398,818,823
0131-002,2011,8,29,18,420,479,899,818
0131-002,2011,8,29,19,439,501,940,899
0131-002,2011,8,29,20,311,372,683,940
0131-002,2011,8,29,21,266,313,579,683
0131-002,2011,8,29,22,227,251,478,579
0131-002,2011,8,29,23,151,159,310,478
0131-002,2011,8,29,24,105,95,200,310
0131-002,2011,8,30,1,51,58,109,200
0131-002,2011,8,30,2,44,39,83,109
0131-002,2011,8,30,3,26,35,61,83
0131-002,2011,8,30,4,20,19,39,61
0131-002,2011,8,30,5,24,43,67,39
0131-002,2011,8,30,6,59,56,115,67
0131-002,2011,8,30,7,253,167,420,115
0131-002,2011,8,30,8,572,524,1096,420
0131-002,2011,8,30,9,528,532,1060,1096
0131-002,2011,8,30,10,420,425,845,1060
0131-002,2011,8,30,11,418,427,845,845
0131-002,2011,8,30,12,351,336,687,845
0131-002,2011,8,30,13,299,387,686,687
0131-002,2011,8,30,14,338,377,715,686
0131-002,2011,8,30,15,412,444,856,715
0131-002,2011,8,30,16,411,406,817,856
0131-002,2011,8,30,17,418,420,838,817
0131-002,2011,8,30,18,487,472,959,838
0131-002,2011,8,30,19,464,513,977,959
0131-002,2011,8,30,20,313,404,717,977
0131-002,2011,8,30,21,277,346,623,717
0131-002,2011,8,30,22,203,234,437,623
0131-002,2011,8,30,23,162,156,318,437
0131-002,2011,8,30,24,102,99,201,318
0131-002,2011,8,31,1,64,59,123,201
0131-002,2011,8,31,2,40,40,80,123
0131-002,2011,8,31,3,22,26,48,80
0131-002,2011,8,31,4,13,26,39,48
0131-002,2011,8,31,5,26,41,67,39
0131-002,2011,8,31,6,70,69,139,67
0131-002,2011,8,31,7,257,171,428,139
0131-002,2011,8,31,8,624,516,1140,428
0131-002,2011,8,31,9,509,549,1058,1140
0131-002,2011,8,31,10,390,422,812,1058
0131-002,2011,8,31,11,398,391,789,812
0131-002,2011,8,31,12,342,388,730,789
0131-002,2011,8,31,13,295,316,611,730
0131-002,2011,8,31,14,363,364,727,611
0131-002,2011,8,31,15,392,400,792,727
0131-002,2011,8,31,16,411,385,796,792
0131-002,2011,8,31,17,367,435,802,796
0131-002,2011,8,31,18,427,481,908,802
0131-002,2011,8,31,19,511,533,1044,908
0131-002,2011,8,31,20,364,412,776,1044
0131-002,2011,8,31,21,258,317,575,776
0131-002,2011,8,31,22,217,228,445,575
0131-002,2011,8,31,23,174,153,327,445
0131-002,2011,8,31,24,87,111,198,327
0131-002,2011,9,1,1,85,68,153,198
0131-002,2011,9,1,2,46,39,85,153
0131-002,2011,9,1,3,23,40,63,85
0131-002,2011,9,1,4,16,34,50,63
0131-002,2011,9,1,5,21,39,60,50
0131-002,2011,9,1,6,72,71,143,60
0131-002,2011,9,1,7,281,162,443,143
0131-002,2011,9,1,8,590,522,1112,443
0131-002,2011,9,1,9,511,550,1061,1112
0131-002,2011,9,1,10,418,392,810,1061
0131-002,2011,9,1,11,374,415,789,810
0131-002,2011,9,1,12,344,350,694,789
0131-002,2011,9,1,13,309,292,601,694
0131-002,2011,9,1,14,320,360,680,601
0131-002,2011,9,1,15,360,415,775,680
0131-002,2011,9,1,16,429,408,837,775
0131-002,2011,9,1,17,421,440,861,837
0131-002,2011,9,1,18,435,492,927,861
0131-002,2011,9,1,19,418,527,945,927
0131-002,2011,9,1,20,322,430,752,945
0131-002,2011,9,1,21,281,323,604,752
0131-002,2011,9,1,22,249,286,535,604
0131-002,2011,9,1,23,177,155,332,535
0131-002,2011,9,1,24,89,100,189,332
0131-002,2011,9,2,1,64,63,127,189
0131-002,2011,9,2,2,41,44,85,127
0131-002,2011,9,2,3,20,34,54,85
0131-002,2011,9,2,4,18,28,46,54
0131-002,2011,9,2,5,18,40,58,46
0131-002,2011,9,2,6,77,72,149,58
0131-002,2011,9,2,7,258,202,460,149
0131-002,2011,9,2,8,641,530,1171,460
0131-002,2011,9,2,9,513,559,1072,1171
0131-002,2011,9,2,10,387,386,773,1072
0131-002,2011,9,2,11,381,377,758,773
0131-002,2011,9,2,12,369,388,757,758
0131-002,2011,9,2,13,300,357,657,757
0131-002,2011,9,2,14,334,404,738,657
0131-002,2011,9,2,15,418,422,840,738
0131-002,2011,9,2,16,395,442,837,840
0131-002,2011,9,2,17,470,392,862,837
0131-002,2011,9,2,18,462,563,1025,862
0131-002,2011,9,2,19,530,531,1061,1025
0131-002,2011,9,2,20,420,468,888,1061
0131-002,2011,9,2,21,305,359,664,888
0131-002,2011,9,2,22,213,260,473,664
0131-002,2011,9,2,23,190,201,391,473
0131-002,2011,9,2,24,124,119,243,391
0131-002,2011,9,3,1,76,79,155,243
0131-002,2011,9,3,2,49,43,92,155
0131-002,2011,9,3,3,37,36,73,92
0131-002,2011,9,3,4,26,41,67,73
0131-002,2011,9,3,5,33,41,74,67
0131-002,2011,9,3,6,77,82,159,74
0131-002,2011,9,3,7,221,156,377,159
0131-002,2011,9,3,8,402,339,741,377
0131-002,2011,9,3,9,406,458,864,741
0131-002,2011,9,3,10,347,479,826,864
0131-002,2011,9,3,11,364,631,995,826
0131-002,2011,9,3,12,379,634,1013,995
0131-002,2011,9,3,13,330,575,905,1013
0131-002,2011,9,3,14,346,489,835,905
0131-002,2011,9,3,15,379,449,828,835
0131-002,2011,9,3,16,552,377,929,828
0131-002,2011,9,3,17,523,436,959,929
0131-002,2011,9,3,18,585,525,1110,959
0131-002,2011,9,3,19,562,454,1016,1110
0131-002,2011,9,3,20,372,292,664,1016
0131-002,2011,9,3,21,260,243,503,664
0131-002,2011,9,3,22,197,176,373,503
0131-002,2011,9,3,23,120,173,293,373
0131-002,2011,9,3,24,95,99,194,293
0131-002,2011,9,4,1,82,81,163,194
0131-002,2011,9,4,2,41,49,90,163
0131-002,2011,9,4,3,40,39,79,90
0131-002,2011,9,4,4,34,30,64,79
0131-002,2011,9,4,5,29,21,50,64
0131-002,2011,9,4,6,57,50,107,50
0131-002,2011,9,4,7,116,117,233,107
0131-002,2011,9,4,8,188,191,379,233
0131-002,2011,9,4,9,195,238,433,379
0131-002,2011,9,4,10,197,255,452,433
0131-002,2011,9,4,11,238,288,526,452
0131-002,2011,9,4,12,233,267,500,526
0131-002,2011,9,4,13,278,238,516,500
0131-002,2011,9,4,14,482,286,768,516
0131-002,2011,9,4,15,540,315,855,768
0131-002,2011,9,4,16,632,333,965,855
0131-002,2011,9,4,17,633,298,931,965
0131-002,2011,9,4,18,562,309,871,931
0131-002,2011,9,4,19,406,313,719,871
0131-002,2011,9,4,20,305,252,557,719
0131-002,2011,9,4,21,243,197,440,557
0131-002,2011,9,4,22,210,198,408,440
0131-002,2011,9,4,23,118,124,242,408
0131-002,2011,9,4,24,72,85,157,242
0131-002,2011,9,5,1,49,59,108,157
0131-002,2011,9,5,2,24,31,55,108
0131-002,2011,9,5,3,19,21,40,55
0131-002,2011,9,5,4,16,17,33,40
0131-002,2011,9,5,5,16,35,51,33
0131-002,2011,9,5,6,82,70,152,51
0131-002,2011,9,5,7,305,215,520,152
0131-002,2011,9,5,8,600,580,1180,520
0131-002,2011,9,5,9,528,574,1102,1180
0131-002,2011,9,5,10,386,432,818,1102
0131-002,2011,9,5,11,385,417,802,818
0131-002,2011,9,5,12,365,394,759,802
0131-002,2011,9,5,13,330,326,656,759
0131-002,2011,9,5,14,354,411,765,656
0131-002,2011,9,5,15,410,433,843,765
0131-002,2011,9,5,16,405,423,828,843
0131-002,2011,9,5,17,418,441,859,828
0131-002,2011,9,5,18,432,502,934,859
0131-002,2011,9,5,19,577,582,1159,934
0131-002,2011,9,5,20,315,452,767,1159
0131-002,2011,9,5,21,288,340,628,767
0131-002,2011,9,5,22,221,247,468,628
0131-002,2011,9,5,23,145,168,313,468
0131-002,2011,9,5,24,79,100,179,313
0131-002,2011,9,6,1,66,67,133,179
0131-002,2011,9,6,2,42,30,72,133
0131-002,2011,9,6,3,25,28,53,72
0131-002,2011,9,6,4,18,28,46,53
0131-002,2011,9,6,5,22,29,51,46
0131-002,2011,9,6,6,69,58,127,51
0131-002,2011,9,6,7,246,167,413,127
0131-002,2011,9,6,8,644,532,1176,413
0131-002,2011,9,6,9,475,560,1035,1176
0131-002,2011,9,6,10,387,410,797,1035
0131-002,2011,9,6,11,410,420,830,797
0131-002,2011,9,6,12,378,364,742,830
0131-002,2011,9,6,13,304,322,626,742
0131-002,2011,9,6,14,384,369,753,626
0131-002,2011,9,6,15,389,454,843,753
0131-002,2011,9,6,16,419,398,817,843
0131-002,2011,9,6,17,434,448,882,817
0131-002,2011,9,6,18,433,486,919,882
0131-002,2011,9,6,19,441,555,996,919
0131-002,2011,9,6,20,332,389,721,996
0131-002,2011,9,6,21,328,345,673,721
0131-002,2011,9,6,22,265,273,538,673
0131-002,2011,9,6,23,171,190,361,538
0131-002,2011,9,6,24,98,108,206,361
0131-002,2011,9,7,1,55,71,126,206
0131-002,2011,9,7,2,37,44,81,126
0131-002,2011,9,7,3,34,33,67,81
0131-002,2011,9,7,4,13,28,41,67
0131-002,2011,9,7,5,20,35,55,41
0131-002,2011,9,7,6,82,72,154,55
0131-002,2011,9,7,7,240,180,420,154
0131-002,2011,9,7,8,607,505,1112,420
0131-002,2011,9,7,9,460,577,1037,1112
0131-002,2011,9,7,10,421,446,867,1037
0131-002,2011,9,7,11,397,377,774,867
0131-002,2011,9,7,12,396,409,805,774
0131-002,2011,9,7,13,303,375,678,805
0131-002,2011,9,7,14,383,427,810,678
0131-002,2011,9,7,15,440,476,916,810
0131-002,2011,9,7,16,443,446,889,916
0131-002,2011,9,7,17,465,451,916,889
0131-002,2011,9,7,18,500,522,1022,916
0131-002,2011,9,7,19,477,518,995,1022
0131-002,2011,9,7,20,362,425,787,995
0131-002,2011,9,7,21,299,334,633,787
0131-002,2011,9,7,22,238,246,484,633
0131-002,2011,9,7,23,172,184,356,484
0131-002,2011,9,7,24,112,109,221,356
0131-002,2011,9,8,1,48,69,117,221
0131-002,2011,9,8,2,33,49,82,117
0131-002,2011,9,8,3,29,33,62,82
0131-002,2011,9,8,4,18,29,47,62
0131-002,2011,9,8,5,23,37,60,47
0131-002,2011,9,8,6,88,53,141,60
0131-002,2011,9,8,7,243,178,421,141
0131-002,2011,9,8,8,652,504,1156,421
0131-002,2011,9,8,9,493,565,1058,1156
0131-002,2011,9,8,10,393,432,825,1058
0131-002,2011,9,8,11,439,441,880,825
0131-002,2011,9,8,12,411,424,835,880
0131-002,2011,9,8,13,325,357,682,835
0131-002,2011,9,8,14,399,452,851,682
0131-002,2011,9,8,15,450,463,913,851
0131-002,2011,9,8,16,463,458,921,913
0131-002,2011,9,8,17,487,490,977,921
0131-002,2011,9,8,18,480,521,1001,977
0131-002,2011,9,8,19,496,554,1050,1001
0131-002,2011,9,8,20,375,431,806,1050
0131-002,2011,9,8,21,334,374,708,806
0131-002,2011,9,8,22,261,301,562,708
0131-002,2011,9,8,23,180,201,381,562
0131-002,2011,9,8,24,130,157,287,381
0131-002,2011,9,9,1,54,80,134,287
0131-002,2011,9,9,2,57,40,97,134
0131-002,2011,9,9,3,31,34,65,97
0131-002,2011,9,9,4,25,30,55,65
0131-002,2011,9,9,5,25,42,67,55
0131-002,2011,9,9,6,65,54,119,67
0131-002,2011,9,9,7,219,149,368,119
0131-002,2011,9,9,8,581,485,1066,368
0131-002,2011,9,9,9,524,535,1059,1066
0131-002,2011,9,9,10,373,461,834,1059
0131-002,2011,9,9,11,424,400,824,834
0131-002,2011,9,9,12,409,410,819,824
0131-002,2011,9,9,13,351,406,757,819
0131-002,2011,9,9,14,340,457,797,757
0131-002,2011,9,9,15,420,542,962,797
0131-002,2011,9,9,16,457,660,1117,962
0131-002,2011,9,9,17,499,731,1230,1117
0131-002,2011,9,9,18,490,771,1261,1230
0131-002,2011,9,9,19,494,728,1222,1261
0131-002,2011,9,9,20,386,687,1073,1222
0131-002,2011,9,9,21,252,524,776,1073
0131-002,2011,9,9,22,185,424,609,776
0131-002,2011,9,9,23,150,311,461,609
0131-002,2011,9,9,24,90,205,295,461
0131-002,2011,9,10,1,48,96,144,295
0131-002,2011,9,10,2,36,83,119,144
0131-002,2011,9,10,3,28,62,90,119
0131-002,2011,9,10,4,27,46,73,90
0131-002,2011,9,10,5,26,54,80,73
0131-002,2011,9,10,6,45,145,190,80
0131-002,2011,9,10,7,122,486,608,190
0131-002,2011,9,10,8,200,906,1106,608
0131-002,2011,9,10,9,256,1011,1267,1106
0131-002,2011,9,10,10,254,903,1157,1267
0131-002,2011,9,10,11,313,913,1226,1157
0131-002,2011,9,10,12,292,918,1210,1226
0131-002,2011,9,10,13,310,942,1252,1210
0131-002,2011,9,10,14,300,732,1032,1252
0131-002,2011,9,10,15,302,597,899,1032
0131-002,2011,9,10,16,286,483,769,899
0131-002,2011,9,10,17,280,437,717,769
0131-002,2011,9,10,18,283,354,637,717
0131-002,2011,9,10,19,220,282,502,637
0131-002,2011,9,10,20,164,204,368,502
0131-002,2011,9,10,21,138,153,291,368
0131-002,2011,9,10,22,109,159,268,291
0131-002,2011,9,10,23,103,169,272,268
0131-002,2011,9,10,24,58,153,211,272
0131-002,2011,9,11,1,31,114,145,211
0131-002,2011,9,11,2,36,60,96,145
0131-002,2011,9,11,3,12,46,58,96
0131-002,2011,9,11,4,19,33,52,58
0131-002,2011,9,11,5,19,55,74,52
0131-002,2011,9,11,6,31,71,102,74
0131-002,2011,9,11,7,45,201,246,102
0131-002,2011,9,11,8,69,428,497,246
0131-002,2011,9,11,9,126,588,714,497
0131-002,2011,9,11,10,219,643,862,714
0131-002,2011,9,11,11,383,662,1045,862
0131-002,2011,9,11,12,503,582,1085,1045
0131-002,2011,9,11,13,429,569,998,1085
0131-002,2011,9,11,14,307,416,723,998
0131-002,2011,9,11,15,231,437,668,723
0131-002,2011,9,11,16,220,314,534,668
0131-002,2011,9,11,17,210,287,497,534
0131-002,2011,9,11,18,182,249,431,497
0131-002,2011,9,11,19,143,201,344,431
0131-002,2011,9,11,20,117,136,253,344
0131-002,2011,9,11,21,113,142,255,253
0131-002,2011,9,11,22,88,107,195,255
0131-002,2011,9,11,23,56,78,134,195
0131-002,2011,9,11,24,40,55,95,134
0131-002,2011,9,12,1,23,26,49,95
0131-002,2011,9,12,2,25,26,51,49
0131-002,2011,9,12,3,16,26,42,51
0131-002,2011,9,12,4,17,17,34,42
0131-002,2011,9,12,5,14,27,41,34
0131-002,2011,9,12,6,24,25,49,41
0131-002,2011,9,12,7,75,68,143,49
0131-002,2011,9,12,8,154,165,319,143
0131-002,2011,9,12,9,124,262,386,319
0131-002,2011,9,12,10,187,340,527,386
0131-002,2011,9,12,11,511,603,1114,527
0131-002,2011,9,12,12,758,767,1525,1114
0131-002,2011,9,12,13,826,869,1695,1525
0131-002,2011,9,12,14,656,817,1473,1695
0131-002,2011,9,12,15,726,833,1559,1473
0131-002,2011,9,12,16,753,889,1642,1559
0131-002,2011,9,12,17,815,904,1719,1642
0131-002,2011,9,12,18,872,766,1638,1719
0131-002,2011,9,12,19,864,591,1455,1638
0131-002,2011,9,12,20,704,404,1108,1455
0131-002,2011,9,12,21,777,227,1004,1108
0131-002,2011,9,12,22,788,176,964,1004
0131-002,2011,9,12,23,760,139,899,964
0131-002,2011,9,12,24,538,91,629,899
0131-002,2011,9,13,1,574,59,633,629
0131-002,2011,9,13,2,751,48,799,633
0131-002,2011,9,13,3,520,22,542,799
0131-002,2011,9,13,4,485,22,507,542
0131-002,2011,9,13,5,282,19,301,507
0131-002,2011,9,13,6,334,35,369,301
0131-002,2011,9,13,7,645,41,686,369
0131-002,2011,9,13,8,742,72,814,686
0131-002,2011,9,13,9,829,90,919,814
0131-002,2011,9,13,10,638,128,766,919
0131-002,2011,9,13,11,561,177,738,766
0131-002,2011,9,13,12,604,220,824,738
0131-002,2011,9,13,13,774,220,994,824
0131-002,2011,9,13,14,812,234,1046,994
0131-002,2011,9,13,15,791,235,1026,1046
0131-002,2011,9,13,16,727,250,977,1026
0131-002,2011,9,13,17,796,259,1055,977
0131-002,2011,9,13,18,762,254,1016,1055
0131-002,2011,9,13,19,699,259,958,1016
0131-002,2011,9,13,20,532,229,761,958
0131-002,2011,9,13,21,500,171,671,761
0131-002,2011,9,13,22,473,184,657,671
0131-002,2011,9,13,23,508,128,636,657
0131-002,2011,9,13,24,466,87,553,636
0131-002,2011,9,14,1,313,58,371,553
0131-002,2011,9,14,2,128,37,165,371
0131-002,2011,9,14,3,38,34,72,165
0131-002,2011,9,14,4,19,16,35,72
0131-002,2011,9,14,5,21,31,52,35
0131-002,2011,9,14,6,55,38,93,52
0131-002,2011,9,14,7,181,142,323,93
0131-002,2011,9,14,8,523,421,944,323
0131-002,2011,9,14,9,337,487,824,944
0131-002,2011,9,14,10,287,374,661,824
0131-002,2011,9,14,11,334,390,724,661
0131-002,2011,9,14,12,332,376,708,724
0131-002,2011,9,14,13,284,332,616,708
0131-002,2011,9,14,14,376,327,703,616
0131-002,2011,9,14,15,421,366,787,703
0131-002,2011,9,14,16,519,336,855,787
0131-002,2011,9,14,17,545,382,927,855
0131-002,2011,9,14,18,503,396,899,927
0131-002,2011,9,14,19,458,391,849,899
0131-002,2011,9,14,20,356,329,685,849
0131-002,2011,9,14,21,222,270,492,685
0131-002,2011,9,14,22,188,184,372,492
0131-002,2011,9,14,23,138,131,269,372
0131-002,2011,9,14,24,91,83,174,269
0131-002,2011,9,15,1,50,54,104,174
0131-002,2011,9,15,2,36,30,66,104
0131-002,2011,9,15,3,19,33,52,66
0131-002,2011,9,15,4,27,30,57,52
0131-002,2011,9,15,5,28,44,72,57
0131-002,2011,9,15,6,66,68,134,72
0131-002,2011,9,15,7,262,185,447,134
0131-002,2011,9,15,8,621,546,1167,447
0131-002,2011,9,15,9,506,593,1099,1167
0131-002,2011,9,15,10,384,427,811,1099
0131-002,2011,9,15,11,403,417,820,811
0131-002,2011,9,15,12,365,389,754,820
0131-002,2011,9,15,13,307,322,629,754
0131-002,2011,9,15,14,370,351,721,629
0131-002,2011,9,15,15,414,474,888,721
0131-002,2011,9,15,16,405,417,822,888
0131-002,2011,9,15,17,397,401,798,822
0131-002,2011,9,15,18,421,514,935,798
0131-002,2011,9,15,19,452,517,969,935
0131-002,2011,9,15,20,318,413,731,969
0131-002,2011,9,15,21,254,330,584,731
0131-002,2011,9,15,22,238,222,460,584
0131-002,2011,9,15,23,152,143,295,460
0131-002,2011,9,15,24,105,91,196,295
0131-002,2011,9,16,1,45,45,90,196
0131-002,2011,9,16,2,35,43,78,90
0131-002,2011,9,16,3,31,28,59,78
0131-002,2011,9,16,4,25,30,55,59
0131-002,2011,9,16,5,25,43,68,55
0131-002,2011,9,16,6,65,69,134,68
0131-002,2011,9,16,7,251,155,406,134
0131-002,2011,9,16,8,612,537,1149,406
0131-002,2011,9,16,9,496,522,1018,1149
0131-002,2011,9,16,10,416,436,852,1018
0131-002,2011,9,16,11,380,429,809,852
0131-002,2011,9,16,12,356,403,759,809
0131-002,2011,9,16,13,299,363,662,759
0131-002,2011,9,16,14,404,392,796,662
0131-002,2011,9,16,15,406,407,813,796
0131-002,2011,9,16,16,409,424,833,813
0131-002,2011,9,16,17,404,489,893,833
0131-002,2011,9,16,18,470,499,969,893
0131-002,2011,9,16,19,535,583,1118,969
0131-002,2011,9,16,20,409,422,831,1118
0131-002,2011,9,16,21,260,354,614,831
0131-002,2011,9,16,22,222,276,498,614
0131-002,2011,9,16,23,158,186,344,498
0131-002,2011,9,16,24,95,106,201,344
0131-002,2011,9,17,1,76,74,150,201
0131-002,2011,9,17,2,46,45,91,150
0131-002,2011,9,17,3,43,41,84,91
0131-002,2011,9,17,4,25,33,58,84
0131-002,2011,9,17,5,38,42,80,58
0131-002,2011,9,17,6,64,61,125,80
0131-002,2011,9,17,7,203,126,329,125
0131-002,2011,9,17,8,390,312,702,329
0131-002,2011,9,17,9,431,378,809,702
0131-002,2011,9,17,10,361,370,731,809
0131-002,2011,9,17,11,336,406,742,731
0131-002,2011,9,17,12,370,437,807,742
0131-002,2011,9,17,13,354,485,839,807
0131-002,2011,9,17,14,391,455,846,839
0131-002,2011,9,17,15,384,393,777,846
0131-002,2011,9,17,16,353,353,706,777
0131-002,2011,9,17,17,384,404,788,706
0131-002,2011,9,17,18,438,461,899,788
0131-002,2011,9,17,19,397,463,860,899
0131-002,2011,9,17,20,252,264,516,860
0131-002,2011,9,17,21,195,214,409,516
0131-002,2011,9,17,22,157,192,349,409
0131-002,2011,9,17,23,124,134,258,349
0131-002,2011,9,17,24,78,105,183,258
0131-002,2011,9,18,1,52,77,129,183
0131-002,2011,9,18,2,43,40,83,129
0131-002,2011,9,18,3,16,30,46,83
0131-002,2011,9,18,4,19,25,44,46
0131-002,2011,9,18,5,26,26,52,44
0131-002,2011,9,18,6,42,40,82,52
0131-002,2011,9,18,7,103,93,196,82
0131-002,2011,9,18,8,158,128,286,196
0131-002,2011,9,18,9,170,225,395,286
0131-002,2011,9,18,10,165,202,367,395
0131-002,2011,9,18,11,201,237,438,367
0131-002,2011,9,18,12,225,244,469,438
0131-002,2011,9,18,13,208,234,442,469
0131-002,2011,9,18,14,222,294,516,442
0131-002,2011,9,18,15,252,293,545,516
0131-002,2011,9,18,16,288,314,602,545
0131-002,2011,9,18,17,310,280,590,602
0131-002,2011,9,18,18,313,334,647,590
0131-002,2011,9,18,19,307,315,622,647
0131-002,2011,9,18,20,233,209,442,622
0131-002,2011,9,18,21,198,197,395,442
0131-002,2011,9,18,22,150,149,299,395
0131-002,2011,9,18,23,129,94,223,299
0131-002,2011,9,18,24,60,91,151,223
0131-002,2011,9,19,1,43,57,100,151
0131-002,2011,9,19,2,22,29,51,100
0131-002,2011,9,19,3,13,16,29,51
0131-002,2011,9,19,4,15,28,43,29
0131-002,2011,9,19,5,24,28,52,43
0131-002,2011,9,19,6,53,92,145,52
0131-002,2011,9,19,7,291,207,498,145
0131-002,2011,9,19,8,665,585,1250,498
0131-002,2011,9,19,9,510,603,1113,1250
0131-002,2011,9,19,10,359,414,773,1113
0131-002,2011,9,19,11,366,441,807,773
0131-002,2011,9,19,12,382,413,795,807
0131-002,2011,9,19,13,326,356,682,795
0131-002,2011,9,19,14,386,386,772,682
0131-002,2011,9,19,15,435,437,872,772
0131-002,2011,9,19,16,397,417,814,872
0131-002,2011,9,19,17,401,429,830,814
0131-002,2011,9,19,18,399,492,891,830
0131-002,2011,9,19,19,424,489,913,891
0131-002,2011,9,19,20,321,351,672,913
0131-002,2011,9,19,21,242,322,564,672
0131-002,2011,9,19,22,231,237,468,564
0131-002,2011,9,19,23,127,138,265,468
0131-002,2011,9,19,24,86,87,173,265
0131-002,2011,9,20,1,61,57,118,173
0131-002,2011,9,20,2,28,29,57,118
0131-002,2011,9,20,3,21,23,44,57
0131-002,2011,9,20,4,14,24,38,44
0131-002,2011,9,20,5,22,35,57,38
0131-002,2011,9,20,6,55,51,106,57
0131-002,2011,9,20,7,255,185,440,106
0131-002,2011,9,20,8,622,514,1136,440
0131-002,2011,9,20,9,479,581,1060,1136
0131-002,2011,9,20,10,420,491,911,1060
0131-002,2011,9,20,11,408,406,814,911
0131-002,2011,9,20,12,392,400,792,814
0131-002,2011,9,20,13,319,359,678,792
0131-002,2011,9,20,14,380,405,785,678
0131-002,2011,9,20,15,396,416,812,785
0131-002,2011,9,20,16,389,430,819,812
0131-002,2011,9,20,17,431,438,869,819
0131-002,2011,9,20,18,445,529,974,869
0131-002,2011,9,20,19,444,510,954,974
0131-002,2011,9,20,20,301,369,670,954
0131-002,2011,9,20,21,276,331,607,670
0131-002,2011,9,20,22,240,244,484,607
0131-002,2011,9,20,23,155,136,291,484
0131-002,2011,9,20,24,83,94,177,291
0131-002,2011,9,21,1,53,57,110,177
0131-002,2011,9,21,2,36,42,78,110
0131-002,2011,9,21,3,23,30,53,78
0131-002,2011,9,21,4,15,21,36,53
0131-002,2011,9,21,5,23,46,69,36
0131-002,2011,9,21,6,68,71,139,69
0131-002,2011,9,21,7,237,171,408,139
0131-002,2011,9,21,8,639,525,1164,408
0131-002,2011,9,21,9,513,563,1076,1164
0131-002,2011,9,21,10,413,407,820,1076
0131-002,2011,9,21,11,418,387,805,820
0131-002,2011,9,21,12,378,377,755,805
0131-002,2011,9,21,13,301,385,686,755
0131-002,2011,9,21,14,365,379,744,686
0131-002,2011,9,21,15,429,449,878,744
0131-002,2011,9,21,16,441,453,894,878
0131-002,2011,9,21,17,410,434,844,894
0131-002,2011,9,21,18,451,487,938,844
0131-002,2011,9,21,19,451,525,976,938
0131-002,2011,9,21,20,343,393,736,976
0131-002,2011,9,21,21,276,337,613,736
0131-002,2011,9,21,22,206,243,449,613
0131-002,2011,9,21,23,160,180,340,449
0131-002,2011,9,21,24,91,107,198,340
0131-002,2011,9,22,1,59,54,113,198
0131-002,2011,9,22,2,40,40,80,113
0131-002,2011,9,22,3,30,35,65,80
0131-002,2011,9,22,4,19,36,55,65
0131-002,2011,9,22,5,21,25,46,55
0131-002,2011,9,22,6,71,73,144,46
0131-002,2011,9,22,7,261,163,424,144
0131-002,2011,9,22,8,631,539,1170,424
0131-002,2011,9,22,9,494,597,1091,1170
0131-002,2011,9,22,10,393,436,829,1091
0131-002,2011,9,22,11,419,424,843,829
0131-002,2011,9,22,12,371,409,780,843
0131-002,2011,9,22,13,278,357,635,780
0131-002,2011,9,22,14,364,425,789,635
0131-002,2011,9,22,15,430,431,861,789
0131-002,2011,9,22,16,433,436,869,861
0131-002,2011,9,22,17,402,438,840,869
0131-002,2011,9,22,18,446,529,975,840
0131-002,2011,9,22,19,513,490,1003,975
0131-002,2011,9,22,20,362,410,772,1003
0131-002,2011,9,22,21,272,334,606,772
0131-002,2011,9,22,22,232,272,504,606
0131-002,2011,9,22,23,164,183,347,504
0131-002,2011,9,22,24,109,81,190,347
0131-002,2011,9,23,1,59,52,111,190
0131-002,2011,9,23,2,30,37,67,111
0131-002,2011,9,23,3,34,36,70,67
0131-002,2011,9,23,4,23,35,58,70
0131-002,2011,9,23,5,24,36,60,58
0131-002,2011,9,23,6,69,76,145,60
0131-002,2011,9,23,7,240,160,400,145
0131-002,2011,9,23,8,616,513,1129,400
0131-002,2011,9,23,9,529,581,1110,1129
0131-002,2011,9,23,10,424,418,842,1110
0131-002,2011,9,23,11,398,420,818,842
0131-002,2011,9,23,12,423,387,810,818
0131-002,2011,9,23,13,288,356,644,810
0131-002,2011,9,23,14,394,428,822,644
0131-002,2011,9,23,15,412,502,914,822
0131-002,2011,9,23,16,417,475,892,914
0131-002,2011,9,23,17,451,508,959,892
0131-002,2011,9,23,18,457,539,996,959
0131-002,2011,9,23,19,536,563,1099,996
0131-002,2011,9,23,20,434,459,893,1099
0131-002,2011,9,23,21,332,346,678,893
0131-002,2011,9,23,22,226,276,502,678
0131-002,2011,9,23,23,179,201,380,502
0131-002,2011,9,23,24,108,120,228,380
0131-002,2011,9,24,1,73,76,149,228
0131-002,2011,9,24,2,50,67,117,149
0131-002,2011,9,24,3,39,40,79,117
0131-002,2011,9,24,4,23,35,58,79
0131-002,2011,9,24,5,30,50,80,58
0131-002,2011,9,24,6,62,69,131,80
0131-002,2011,9,24,7,157,162,319,131
0131-002,2011,9,24,8,358,314,672,319
0131-002,2011,9,24,9,401,416,817,672
0131-002,2011,9,24,10,367,588,955,817
0131-002,2011,9,24,11,399,621,1020,955
0131-002,2011,9,24,12,457,744,1201,1020
0131-002,2011,9,24,13,365,750,1115,1201
0131-002,2011,9,24,14,339,637,976,1115
0131-002,2011,9,24,15,411,604,1015,976
0131-002,2011,9,24,16,428,611,1039,1015
0131-002,2011,9,24,17,497,484,981,1039
0131-002,2011,9,24,18,589,548,1137,981
0131-002,2011,9,24,19,587,457,1044,1137
0131-002,2011,9,24,20,505,325,830,1044
0131-002,2011,9,24,21,270,245,515,830
0131-002,2011,9,24,22,209,182,391,515
0131-002,2011,9,24,23,132,167,299,391
0131-002,2011,9,24,24,90,96,186,299
0131-002,2011,9,25,1,67,70,137,186
0131-002,2011,9,25,2,41,47,88,137
0131-002,2011,9,25,3,33,44,77,88
0131-002,2011,9,25,4,31,26,57,77
0131-002,2011,9,25,5,22,30,52,57
0131-002,2011,9,25,6,37,55,92,52
0131-002,2011,9,25,7,111,84,195,92
0131-002,2011,9,25,8,181,168,349,195
0131-002,2011,9,25,9,213,222,435,349
0131-002,2011,9,25,10,213,238,451,435
0131-002,2011,9,25,11,272,331,603,451
0131-002,2011,9,25,12,264,290,554,603
0131-002,2011,9,25,13,227,292,519,554
0131-002,2011,9,25,14,294,277,571,519
0131-002,2011,9,25,15,337,326,663,571
0131-002,2011,9,25,16,407,338,745,663
0131-002,2011,9,25,17,496,360,856,745
0131-002,2011,9,25,18,596,371,967,856
0131-002,2011,9,25,19,530,316,846,967
0131-002,2011,9,25,20,358,262,620,846
0131-002,2011,9,25,21,264,228,492,620
0131-002,2011,9,25,22,179,177,356,492
0131-002,2011,9,25,23,153,115,268,356
0131-002,2011,9,25,24,65,84,149,268
0131-002,2011,9,26,1,42,49,91,149
0131-002,2011,9,26,2,22,30,52,91
0131-002,2011,9,26,3,17,15,32,52
0131-002,2011,9,26,4,9,18,27,32
0131-002,2011,9,26,5,22,42,64,27
0131-002,2011,9,26,6,65,80,145,64
0131-002,2011,9,26,7,264,199,463,145
0131-002,2011,9,26,8,662,558,1220,463
0131-002,2011,9,26,9,490,599,1089,1220
0131-002,2011,9,26,10,406,447,853,1089
0131-002,2011,9,26,11,377,425,802,853
0131-002,2011,9,26,12,366,374,740,802
0131-002,2011,9,26,13,305,357,662,740
0131-002,2011,9,26,14,367,383,750,662
0131-002,2011,9,26,15,421,460,881,750
0131-002,2011,9,26,16,445,455,900,881
0131-002,2011,9,26,17,473,434,907,900
0131-002,2011,9,26,18,419,532,951,907
0131-002,2011,9,26,19,435,519,954,951
0131-002,2011,9,26,20,323,414,737,954
0131-002,2011,9,26,21,271,339,610,737
0131-002,2011,9,26,22,235,244,479,610
0131-002,2011,9,26,23,154,161,315,479
0131-002,2011,9,26,24,83,89,172,315
0131-002,2011,9,27,1,54,57,111,172
0131-002,2011,9,27,2,34,39,73,111
0131-002,2011,9,27,3,24,25,49,73
0131-002,2011,9,27,4,22,33,55,49
0131-002,2011,9,27,5,24,36,60,55
0131-002,2011,9,27,6,74,52,126,60
0131-002,2011,9,27,7,216,167,383,126
0131-002,2011,9,27,8,594,510,1104,383
0131-002,2011,9,27,9,521,569,1090,1104
0131-002,2011,9,27,10,377,394,771,1090
0131-002,2011,9,27,11,388,461,849,771
0131-002,2011,9,27,12,379,370,749,849
0131-002,2011,9,27,13,292,343,635,749
0131-002,2011,9,27,14,351,393,744,635
0131-002,2011,9,27,15,447,439,886,744
0131-002,2011,9,27,16,425,460,885,886
0131-002,2011,9,27,17,372,443,815,885
0131-002,2011,9,27,18,475,537,1012,815
0131-002,2011,9,27,19,426,513,939,1012
0131-002,2011,9,27,20,320,409,729,939
0131-002,2011,9,27,21,264,334,598,729
0131-002,2011,9,27,22,232,250,482,598
0131-002,2011,9,27,23,167,153,320,482
0131-002,2011,9,27,24,80,99,179,320
0131-002,2011,9,28,1,48,46,94,179
0131-002,2011,9,28,2,40,40,80,94
0131-002,2011,9,28,3,30,28,58,80
0131-002,2011,9,28,4,18,25,43,58
0131-002,2011,9,28,5,22,37,59,43
0131-002,2011,9,28,6,61,64,125,59
0131-002,2011,9,28,7,245,160,405,125
0131-002,2011,9,28,8,628,529,1157,405
0131-002,2011,9,28,9,520,542,1062,1157
0131-002,2011,9,28,10,419,429,848,1062
0131-002,2011,9,28,11,409,430,839,848
0131-002,2011,9,28,12,360,380,740,839
0131-002,2011,9,28,13,315,370,685,740
0131-002,2011,9,28,14,376,421,797,685
0131-002,2011,9,28,15,434,459,893,797
0131-002,2011,9,28,16,459,469,928,893
0131-002,2011,9,28,17,411,478,889,928
0131-002,2011,9,28,18,491,546,1037,889
0131-002,2011,9,28,19,412,536,948,1037
0131-002,2011,9,28,20,341,378,719,948
0131-002,2011,9,28,21,271,330,601,719
0131-002,2011,9,28,22,227,239,466,601
0131-002,2011,9,28,23,178,186,364,466
0131-002,2011,9,28,24,107,111,218,364
0131-002,2011,9,29,1,66,53,119,218
0131-002,2011,9,29,2,45,34,79,119
0131-002,2011,9,29,3,17,26,43,79
0131-002,2011,9,29,4,16,28,44,43
0131-002,2011,9,29,5,28,33,61,44
0131-002,2011,9,29,6,61,64,125,61
0131-002,2011,9,29,7,239,155,394,125
0131-002,2011,9,29,8,624,521,1145,394
0131-002,2011,9,29,9,456,577,1033,1145
0131-002,2011,9,29,10,391,387,778,1033
0131-002,2011,9,29,11,381,381,762,778
0131-002,2011,9,29,12,361,374,735,762
0131-002,2011,9,29,13,276,313,589,735
0131-002,2011,9,29,14,338,344,682,589
0131-002,2011,9,29,15,378,401,779,682
0131-002,2011,9,29,16,376,383,759,779
0131-002,2011,9,29,17,360,416,776,759
0131-002,2011,9,29,18,412,483,895,776
0131-002,2011,9,29,19,409,508,917,895
0131-002,2011,9,29,20,301,364,665,917
0131-002,2011,9,29,21,251,316,567,665
0131-002,2011,9,29,22,213,228,441,567
0131-002,2011,9,29,23,142,161,303,441
0131-002,2011,9,29,24,97,94,191,303
0131-002,2011,9,30,1,63,73,136,191
0131-002,2011,9,30,2,34,44,78,136
0131-002,2011,9,30,3,32,23,55,78
0131-002,2011,9,30,4,29,31,60,55
0131-002,2011,9,30,5,25,43,68,60
0131-002,2011,9,30,6,63,63,126,68
0131-002,2011,9,30,7,230,162,392,126
0131-002,2011,9,30,8,651,529,1180,392
0131-002,2011,9,30,9,505,570,1075,1180
0131-002,2011,9,30,10,412,422,834,1075
0131-002,2011,9,30,11,381,393,774,834
0131-002,2011,9,30,12,368,418,786,774
0131-002,2011,9,30,13,328,339,667,786
0131-002,2011,9,30,14,392,383,775,667
0131-002,2011,9,30,15,441,467,908,775
0131-002,2011,9,30,16,425,497,922,908
0131-002,2011,9,30,17,411,456,867,922
0131-002,2011,9,30,18,466,515,981,867
0131-002,2011,9,30,19,506,561,1067,981
0131-002,2011,9,30,20,434,450,884,1067
0131-002,2011,9,30,21,289,364,653,884
0131-002,2011,9,30,22,246,302,548,653
0131-002,2011,9,30,23,207,172,379,548
0131-002,2011,9,30,24,122,132,254,379
0131-002,2011,10,1,1,73,73,146,254
0131-002,2011,10,1,2,50,51,101,146
0131-002,2011,10,1,3,43,45,88,101
0131-002,2011,10,1,4,22,33,55,88
0131-002,2011,10,1,5,30,43,73,55
0131-002,2011,10,1,6,54,93,147,73
0131-002,2011,10,1,7,193,147,340,147
0131-002,2011,10,1,8,404,360,764,340
0131-002,2011,10,1,9,447,407,854,764
0131-002,2011,10,1,10,390,493,883,854
0131-002,2011,10,1,11,384,613,997,883
0131-002,2011,10,1,12,346,817,1163,997
0131-002,2011,10,1,13,343,885,1228,1163
0131-002,2011,10,1,14,399,901,1300,1228
0131-002,2011,10,1,15,393,889,1282,1300
0131-002,2011,10,1,16,459,909,1368,1282
0131-002,2011,10,1,17,584,719,1303,1368
0131-002,2011,10,1,18,578,1093,1671,1303
0131-002,2011,10,1,19,551,925,1476,1671
0131-002,2011,10,1,20,424,889,1313,1476
0131-002,2011,10,1,21,258,652,910,1313
0131-002,2011,10,1,22,217,508,725,910
0131-002,2011,10,1,23,163,276,439,725
0131-002,2011,10,1,24,83,109,192,439
0131-002,2011,10,2,1,55,66,121,192
0131-002,2011,10,2,2,34,52,86,121
0131-002,2011,10,2,3,22,37,59,86
0131-002,2011,10,2,4,21,20,41,59
0131-002,2011,10,2,5,18,20,38,41
0131-002,2011,10,2,6,29,42,71,38
0131-002,2011,10,2,7,92,81,173,71
0131-002,2011,10,2,8,181,179,360,173
0131-002,2011,10,2,9,213,205,418,360
0131-002,2011,10,2,10,206,293,499,418
0131-002,2011,10,2,11,229,476,705,499
0131-002,2011,10,2,12,234,510,744,705
0131-002,2011,10,2,13,252,486,738,744
0131-002,2011,10,2,14,252,434,686,738
0131-002,2011,10,2,15,310,327,637,686
0131-002,2011,10,2,16,362,306,668,637
0131-002,2011,10,2,17,537,320,857,668
0131-002,2011,10,2,18,589,348,937,857
0131-002,2011,10,2,19,601,329,930,937
0131-002,2011,10,2,20,535,202,737,930
0131-002,2011,10,2,21,483,230,713,737
0131-002,2011,10,2,22,386,169,555,713
0131-002,2011,10,2,23,209,146,355,555
0131-002,2011,10,2,24,112,94,206,355
0131-002,2011,10,3,1,62,61,123,206
0131-002,2011,10,3,2,33,33,66,123
0131-002,2011,10,3,3,20,26,46,66
0131-002,2011,10,3,4,16,25,41,46
0131-002,2011,10,3,5,23,32,55,41
0131-002,2011,10,3,6,51,53,104,55
0131-002,2011,10,3,7,132,110,242,104
0131-002,2011,10,3,8,317,239,556,242
0131-002,2011,10,3,9,257,257,514,556
0131-002,2011,10,3,10,264,274,538,514
0131-002,2011,10,3,11,298,299,597,538
0131-002,2011,10,3,12,367,319,686,597
0131-002,2011,10,3,13,407,306,713,686
0131-002,2011,10,3,14,553,304,857,713
0131-002,2011,10,3,15,523,374,897,857
0131-002,2011,10,3,16,551,337,888,897
0131-002,2011,10,3,17,615,355,970,888
0131-002,2011,10,3,18,771,383,1154,970
0131-002,2011,10,3,19,642,371,1013,1154
0131-002,2011,10,3,20,427,299,726,1013
0131-002,2011,10,3,21,335,227,562,726
0131-002,2011,10,3,22,233,200,433,562
0131-002,2011,10,3,23,166,120,286,433
0131-002,2011,10,3,24,96,77,173,286
0131-002,2011,10,4,1,48,43,91,173
0131-002,2011,10,4,2,33,29,62,91
0131-002,2011,10,4,3,19,24,43,62
0131-002,2011,10,4,4,9,28,37,43
0131-002,2011,10,4,5,24,27,51,37
0131-002,2011,10,4,6,52,72,124,51
0131-002,2011,10,4,7,265,198,463,124
0131-002,2011,10,4,8,678,600,1278,463
0131-002,2011,10,4,9,519,587,1106,1278
0131-002,2011,10,4,10,401,440,841,1106
0131-002,2011,10,4,11,450,367,817,841
0131-002,2011,10,4,12,346,424,770,817
0131-002,2011,10,4,13,317,352,669,770
0131-002,2011,10,4,14,381,383,764,669
0131-002,2011,10,4,15,441,414,855,764
0131-002,2011,10,4,16,406,459,865,855
0131-002,2011,10,4,17,406,449,855,865
0131-002,2011,10,4,18,457,522,979,855
0131-002,2011,10,4,19,437,555,992,979
0131-002,2011,10,4,20,373,402,775,992
0131-002,2011,10,4,21,261,335,596,775
0131-002,2011,10,4,22,234,263,497,596
0131-002,2011,10,4,23,135,161,296,497
0131-002,2011,10,4,24,116,104,220,296
0131-002,2011,10,5,1,55,59,114,220
0131-002,2011,10,5,2,35,37,72,114
0131-002,2011,10,5,3,22,30,52,72
0131-002,2011,10,5,4,17,40,57,52
0131-002,2011,10,5,5,28,36,64,57
0131-002,2011,10,5,6,60,52,112,64
0131-002,2011,10,5,7,273,168,441,112
0131-002,2011,10,5,8,593,570,1163,441
0131-002,2011,10,5,9,549,546,1095,1163
0131-002,2011,10,5,10,362,490,852,1095
0131-002,2011,10,5,11,417,431,848,852
0131-002,2011,10,5,12,382,368,750,848
0131-002,2011,10,5,13,288,382,670,750
0131-002,2011,10,5,14,346,405,751,670
0131-002,2011,10,5,15,447,458,905,751
0131-002,2011,10,5,16,467,464,931,905
0131-002,2011,10,5,17,429,434,863,931
0131-002,2011,10,5,18,479,560,1039,863
0131-002,2011,10,5,19,439,547,986,1039
0131-002,2011,10,5,20,357,414,771,986
0131-002,2011,10,5,21,266,313,579,771
0131-002,2011,10,5,22,235,282,517,579
0131-002,2011,10,5,23,169,167,336,517
0131-002,2011,10,5,24,89,96,185,336
0131-002,2011,10,6,1,58,69,127,185
0131-002,2011,10,6,2,42,52,94,127
0131-002,2011,10,6,3,26,30,56,94
0131-002,2011,10,6,4,12,26,38,56
0131-002,2011,10,6,5,17,41,58,38
0131-002,2011,10,6,6,57,66,123,58
0131-002,2011,10,6,7,245,141,386,123
0131-002,2011,10,6,8,621,547,1168,386
0131-002,2011,10,6,9,552,594,1146,1168
0131-002,2011,10,6,10,409,393,802,1146
0131-002,2011,10,6,11,442,459,901,802
0131-002,2011,10,6,12,380,410,790,901
0131-002,2011,10,6,13,324,369,693,790
0131-002,2011,10,6,14,377,417,794,693
0131-002,2011,10,6,15,413,478,891,794
0131-002,2011,10,6,16,422,451,873,891
0131-002,2011,10,6,17,449,461,910,873
0131-002,2011,10,6,18,466,494,960,910
0131-002,2011,10,6,19,466,466,932,960
0131-002,2011,10,6,20,335,398,733,932
0131-002,2011,10,6,21,263,355,618,733
0131-002,2011,10,6,22,220,255,475,618
0131-002,2011,10,6,23,173,151,324,475
0131-002,2011,10,6,24,92,108,200,324
0131-002,2011,10,7,1,77,73,150,200
0131-002,2011,10,7,2,27,42,69,150
0131-002,2011,10,7,3,21,31,52,69
0131-002,2011,10,7,4,21,34,55,52
0131-002,2011,10,7,5,27,40,67,55
0131-002,2011,10,7,6,57,67,124,67
0131-002,2011,10,7,7,252,136,388,124
0131-002,2011,10,7,8,635,536,1171,388
0131-002,2011,10,7,9,498,562,1060,1171
0131-002,2011,10,7,10,417,402,819,1060
0131-002,2011,10,7,11,411,430,841,819
0131-002,2011,10,7,12,408,404,812,841
0131-002,2011,10,7,13,314,340,654,812
0131-002,2011,10,7,14,361,435,796,654
0131-002,2011,10,7,15,389,492,881,796
0131-002,2011,10,7,16,462,463,925,881
0131-002,2011,10,7,17,460,462,922,925
0131-002,2011,10,7,18,537,555,1092,922
0131-002,2011,10,7,19,562,551,1113,1092
0131-002,2011,10,7,20,438,463,901,1113
0131-002,2011,10,7,21,314,332,646,901
0131-002,2011,10,7,22,256,292,548,646
0131-002,2011,10,7,23,177,195,372,548
0131-002,2011,10,7,24,109,147,256,372
0131-002,2011,10,8,1,69,89,158,256
0131-002,2011,10,8,2,42,53,95,158
0131-002,2011,10,8,3,29,40,69,95
0131-002,2011,10,8,4,31,28,59,69
0131-002,2011,10,8,5,27,59,86,59
0131-002,2011,10,8,6,56,54,110,86
0131-002,2011,10,8,7,186,111,297,110
0131-002,2011,10,8,8,395,325,720,297
0131-002,2011,10,8,9,347,407,754,720
0131-002,2011,10,8,10,354,460,814,754
0131-002,2011,10,8,11,373,648,1021,814
0131-002,2011,10,8,12,394,795,1189,1021
0131-002,2011,10,8,13,455,773,1228,1189
0131-002,2011,10,8,14,456,724,1180,1228
0131-002,2011,10,8,15,403,660,1063,1180
0131-002,2011,10,8,16,535,660,1195,1063
0131-002,2011,10,8,17,692,609,1301,1195
0131-002,2011,10,8,18,622,667,1289,1301
0131-002,2011,10,8,19,621,551,1172,1289
0131-002,2011,10,8,20,558,312,870,1172
0131-002,2011,10,8,21,513,252,765,870
0131-002,2011,10,8,22,281,213,494,765
0131-002,2011,10,8,23,139,136,275,494
0131-002,2011,10,8,24,84,119,203,275
0131-002,2011,10,9,1,48,81,129,203
0131-002,2011,10,9,2,42,29,71,129
0131-002,2011,10,9,3,34,30,64,71
0131-002,2011,10,9,4,24,24,48,64
0131-002,2011,10,9,5,26,31,57,48
0131-002,2011,10,9,6,30,42,72,57
0131-002,2011,10,9,7,105,85,190,72
0131-002,2011,10,9,8,185,165,350,190
0131-002,2011,10,9,9,190,212,402,350
0131-002,2011,10,9,10,209,238,447,402
0131-002,2011,10,9,11,244,278,522,447
0131-002,2011,10,9,12,239,283,522,522
0131-002,2011,10,9,13,249,278,527,522
0131-002,2011,10,9,14,290,289,579,527
0131-002,2011,10,9,15,328,294,622,579
0131-002,2011,10,9,16,436,296,732,622
0131-002,2011,10,9,17,554,324,878,732
0131-002,2011,10,9,18,637,342,979,878
0131-002,2011,10,9,19,589,334,923,979
0131-002,2011,10,9,20,437,229,666,923
0131-002,2011,10,9,21,284,227,511,666
0131-002,2011,10,9,22,235,192,427,511
0131-002,2011,10,9,23,141,126,267,427
0131-002,2011,10,9,24,74,88,162,267
0131-002,2011,10,10,1,44,55,99,162
0131-002,2011,10,10,2,33,28,61,99
0131-002,2011,10,10,3,20,28,48,61
0131-002,2011,10,10,4,14,23,37,48
0131-002,2011,10,10,5,21,24,45,37
0131-002,2011,10,10,6,65,60,125,45
0131-002,2011,10,10,7,260,199,459,125
0131-002,2011,10,10,8,669,564,1233,459
0131-002,2011,10,10,9,569,630,1199,1233
0131-002,2011,10,10,10,385,423,808,1199
0131-002,2011,10,10,11,380,400,780,808
0131-002,2011,10,10,12,406,393,799,780
0131-002,2011,10,10,13,315,372,687,799
0131-002,2011,10,10,14,364,418,782,687
0131-002,2011,10,10,15,407,460,867,782
0131-002,2011,10,10,16,462,424,886,867
0131-002,2011,10,10,17,432,450,882,886
0131-002,2011,10,10,18,452,540,992,882
0131-002,2011,10,10,19,445,510,955,992
0131-002,2011,10,10,20,337,377,714,955
0131-002,2011,10,10,21,269,356,625,714
0131-002,2011,10,10,22,235,258,493,625
0131-002,2011,10,10,23,149,166,315,493
0131-002,2011,10,10,24,87,87,174,315
0131-002,2011,10,11,1,48,78,126,174
0131-002,2011,10,11,2,29,40,69,126
0131-002,2011,10,11,3,28,34,62,69
0131-002,2011,10,11,4,20,34,54,62
0131-002,2011,10,11,5,15,30,45,54
0131-002,2011,10,11,6,58,69,127,45
0131-002,2011,10,11,7,234,154,388,127
0131-002,2011,10,11,8,626,545,1171,388
0131-002,2011,10,11,9,540,562,1102,1171
0131-002,2011,10,11,10,443,435,878,1102
0131-002,2011,10,11,11,368,416,784,878
0131-002,2011,10,11,12,356,388,744,784
0131-002,2011,10,11,13,305,333,638,744
0131-002,2011,10,11,14,361,366,727,638
0131-002,2011,10,11,15,421,445,866,727
0131-002,2011,10,11,16,437,458,895,866
0131-002,2011,10,11,17,410,485,895,895
0131-002,2011,10,11,18,470,490,960,895
0131-002,2011,10,11,19,451,507,958,960
0131-002,2011,10,11,20,325,375,700,958
0131-002,2011,10,11,21,262,331,593,700
0131-002,2011,10,11,22,214,270,484,593
0131-002,2011,10,11,23,146,173,319,484
0131-002,2011,10,11,24,115,102,217,319
0131-002,2011,10,12,1,57,59,116,217
0131-002,2011,10,12,2,37,44,81,116
0131-002,2011,10,12,3,25,24,49,81
0131-002,2011,10,12,4,17,20,37,49
0131-002,2011,10,12,5,23,38,61,37
0131-002,2011,10,12,6,59,54,113,61
0131-002,2011,10,12,7,243,154,397,113
0131-002,2011,10,12,8,677,558,1235,397
0131-002,2011,10,12,9,549,585,1134,1235
0131-002,2011,10,12,10,382,433,815,1134
0131-002,2011,10,12,11,426,422,848,815
0131-002,2011,10,12,12,362,386,748,848
0131-002,2011,10,12,13,315,386,701,748
0131-002,2011,10,12,14,395,352,747,701
0131-002,2011,10,12,15,436,449,885,747
0131-002,2011,10,12,16,409,480,889,885
0131-002,2011,10,12,17,435,442,877,889
0131-002,2011,10,12,18,479,560,1039,877
0131-002,2011,10,12,19,474,537,1011,1039
0131-002,2011,10,12,20,328,354,682,1011
0131-002,2011,10,12,21,276,339,615,682
0131-002,2011,10,12,22,235,272,507,615
0131-002,2011,10,12,23,178,170,348,507
0131-002,2011,10,12,24,87,111,198,348
0131-002,2011,10,13,1,71,61,132,198
0131-002,2011,10,13,2,34,43,77,132
0131-002,2011,10,13,3,19,23,42,77
0131-002,2011,10,13,4,21,24,45,42
0131-002,2011,10,13,5,21,34,55,45
0131-002,2011,10,13,6,54,53,107,55
0131-002,2011,10,13,7,242,161,403,107
0131-002,2011,10,13,8,663,541,1204,403
0131-002,2011,10,13,9,559,615,1174,1204
0131-002,2011,10,13,10,407,448,855,1174
0131-002,2011,10,13,11,412,437,849,855
0131-002,2011,10,13,12,354,371,725,849
0131-002,2011,10,13,13,340,347,687,725
0131-002,2011,10,13,14,382,420,802,687
0131-002,2011,10,13,15,423,410,833,802
0131-002,2011,10,13,16,416,427,843,833
0131-002,2011,10,13,17,430,462,892,843
0131-002,2011,10,13,18,482,502,984,892
0131-002,2011,10,13,19,494,500,994,984
0131-002,2011,10,13,20,325,393,718,994
0131-002,2011,10,13,21,234,338,572,718
0131-002,2011,10,13,22,216,252,468,572
0131-002,2011,10,13,23,158,164,322,468
0131-002,2011,10,13,24,106,98,204,322
0131-002,2011,10,14,1,57,72,129,204
0131-002,2011,10,14,2,39,32,71,129
0131-002,2011,10,14,3,21,33,54,71
0131-002,2011,10,14,4,18,32,50,54
0131-002,2011,10,14,5,11,42,53,50
0131-002,2011,10,14,6,57,69,126,53
0131-002,2011,10,14,7,194,154,348,126
0131-002,2011,10,14,8,637,506,1143,348
0131-002,2011,10,14,9,512,580,1092,1143
0131-002,2011,10,14,10,397,384,781,1092
0131-002,2011,10,14,11,365,454,819,781
0131-002,2011,10,14,12,378,366,744,819
0131-002,2011,10,14,13,305,337,642,744
0131-002,2011,10,14,14,340,399,739,642
0131-002,2011,10,14,15,390,455,845,739
0131-002,2011,10,14,16,448,478,926,845
0131-002,2011,10,14,17,405,438,843,926
0131-002,2011,10,14,18,459,474,933,843
0131-002,2011,10,14,19,500,517,1017,933
0131-002,2011,10,14,20,350,436,786,1017
0131-002,2011,10,14,21,287,317,604,786
0131-002,2011,10,14,22,225,284,509,604
0131-002,2011,10,14,23,159,181,340,509
0131-002,2011,10,14,24,108,105,213,340
0131-002,2011,10,15,1,66,87,153,213
0131-002,2011,10,15,2,42,53,95,153
0131-002,2011,10,15,3,29,38,67,95
0131-002,2011,10,15,4,27,31,58,67
0131-002,2011,10,15,5,28,43,71,58
0131-002,2011,10,15,6,59,60,119,71
0131-002,2011,10,15,7,178,123,301,119
0131-002,2011,10,15,8,381,310,691,301
0131-002,2011,10,15,9,353,436,789,691
0131-002,2011,10,15,10,371,370,741,789
0131-002,2011,10,15,11,425,558,983,741
0131-002,2011,10,15,12,355,589,944,983
0131-002,2011,10,15,13,333,640,973,944
0131-002,2011,10,15,14,373,591,964,973
0131-002,2011,10,15,15,380,554,934,964
0131-002,2011,10,15,16,436,533,969,934
0131-002,2011,10,15,17,473,567,1040,969
0131-002,2011,10,15,18,590,507,1097,1040
0131-002,2011,10,15,19,561,442,1003,1097
0131-002,2011,10,15,20,373,296,669,1003
0131-002,2011,10,15,21,227,279,506,669
0131-002,2011,10,15,22,192,207,399,506
0131-002,2011,10,15,23,202,147,349,399
0131-002,2011,10,15,24,105,88,193,349
0131-002,2011,10,16,1,54,59,113,193
0131-002,2011,10,16,2,38,50,88,113
0131-002,2011,10,16,3,23,25,48,88
0131-002,2011,10,16,4,16,23,39,48
0131-002,2011,10,16,5,22,25,47,39
0131-002,2011,10,16,6,23,43,66,47
0131-002,2011,10,16,7,71,78,149,66
0131-002,2011,10,16,8,152,143,295,149
0131-002,2011,10,16,9,149,202,351,295
0131-002,2011,10,16,10,183,219,402,351
0131-002,2011,10,16,11,264,263,527,402
0131-002,2011,10,16,12,237,299,536,527
0131-002,2011,10,16,13,233,256,489,536
0131-002,2011,10,16,14,274,274,548,489
0131-002,2011,10,16,15,332,297,629,548
0131-002,2011,10,16,16,432,323,755,629
0131-002,2011,10,16,17,511,319,830,755
0131-002,2011,10,16,18,557,354,911,830
0131-002,2011,10,16,19,526,284,810,911
0131-002,2011,10,16,20,439,236,675,810
0131-002,2011,10,16,21,290,232,522,675
0131-002,2011,10,16,22,227,168,395,522
0131-002,2011,10,16,23,137,132,269,395
0131-002,2011,10,16,24,92,85,177,269
0131-002,2011,10,17,1,43,55,98,177
0131-002,2011,10,17,2,25,26,51,98
0131-002,2011,10,17,3,25,22,47,51
0131-002,2011,10,17,4,14,25,39,47
0131-002,2011,10,17,5,26,33,59,39
0131-002,2011,10,17,6,57,54,111,59
0131-002,2011,10,17,7,256,194,450,111
0131-002,2011,10,17,8,676,629,1305,450
0131-002,2011,10,17,9,531,627,1158,1305
0131-002,2011,10,17,10,396,388,784,1158
0131-002,2011,10,17,11,425,411,836,784
0131-002,2011,10,17,12,347,363,710,836
0131-002,2011,10,17,13,313,357,670,710
0131-002,2011,10,17,14,333,411,744,670
0131-002,2011,10,17,15,396,431,827,744
0131-002,2011,10,17,16,421,444,865,827
0131-002,2011,10,17,17,427,418,845,865
0131-002,2011,10,17,18,445,539,984,845
0131-002,2011,10,17,19,466,489,955,984
0131-002,2011,10,17,20,316,369,685,955
0131-002,2011,10,17,21,281,318,599,685
0131-002,2011,10,17,22,214,266,480,599
0131-002,2011,10,17,23,153,167,320,480
0131-002,2011,10,17,24,111,99,210,320
0131-002,2011,10,18,1,44,67,111,210
0131-002,2011,10,18,2,29,32,61,111
0131-002,2011,10,18,3,19,22,41,61
0131-002,2011,10,18,4,11,22,33,41
0131-002,2011,10,18,5,27,33,60,33
0131-002,2011,10,18,6,51,67,118,60
0131-002,2011,10,18,7,259,144,403,118
0131-002,2011,10,18,8,652,568,1220,403
0131-002,2011,10,18,9,532,618,1150,1220
0131-002,2011,10,18,10,409,441,850,1150
0131-002,2011,10,18,11,413,443,856,850
0131-002,2011,10,18,12,406,423,829,856
0131-002,2011,10,18,13,321,298,619,829
0131-002,2011,10,18,14,390,413,803,619
0131-002,2011,10,18,15,439,481,920,803
0131-002,2011,10,18,16,428,435,863,920
0131-002,2011,10,18,17,411,471,882,863
0131-002,2011,10,18,18,475,510,985,882
0131-002,2011,10,18,19,451,512,963,985
0131-002,2011,10,18,20,286,396,682,963
0131-002,2011,10,18,21,274,338,612,682
0131-002,2011,10,18,22,219,272,491,612
0131-002,2011,10,18,23,167,148,315,491
0131-002,2011,10,18,24,89,105,194,315
0131-002,2011,10,19,1,62,64,126,194
0131-002,2011,10,19,2,39,43,82,126
0131-002,2011,10,19,3,30,29,59,82
0131-002,2011,10,19,4,17,29,46,59
0131-002,2011,10,19,5,25,35,60,46
0131-002,2011,10,19,6,51,45,96,60
0131-002,2011,10,19,7,248,152,400,96
0131-002,2011,10,19,8,631,527,1158,400
0131-002,2011,10,19,9,547,582,1129,1158
0131-002,2011,10,19,10,388,462,850,1129
0131-002,2011,10,19,11,416,412,828,850
0131-002,2011,10,19,12,354,404,758,828
0131-002,2011,10,19,13,291,374,665,758
0131-002,2011,10,19,14,370,403,773,665
0131-002,2011,10,19,15,402,461,863,773
0131-002,2011,10,19,16,455,458,913,863
0131-002,2011,10,19,17,433,450,883,913
0131-002,2011,10,19,18,489,517,1006,883
0131-002,2011,10,19,19,456,516,972,1006
0131-002,2011,10,19,20,312,384,696,972
0131-002,2011,10,19,21,281,323,604,696
0131-002,2011,10,19,22,199,251,450,604
0131-002,2011,10,19,23,159,165,324,450
0131-002,2011,10,19,24,90,101,191,324
0131-002,2011,10,20,1,71,70,141,191
0131-002,2011,10,20,2,31,39,70,141
0131-002,2011,10,20,3,24,28,52,70
0131-002,2011,10,20,4,24,33,57,52
0131-002,2011,10,20,5,14,43,57,57
0131-002,2011,10,20,6,60,74,134,57
0131-002,2011,10,20,7,253,165,418,134
0131-002,2011,10,20,8,701,547,1248,418
0131-002,2011,10,20,9,533,642,1175,1248
0131-002,2011,10,20,10,388,504,892,1175
0131-002,2011,10,20,11,451,400,851,892
0131-002,2011,10,20,12,380,422,802,851
0131-002,2011,10,20,13,314,375,689,802
0131-002,2011,10,20,14,399,374,773,689
0131-002,2011,10,20,15,434,505,939,773
0131-002,2011,10,20,16,508,443,951,939
0131-002,2011,10,20,17,431,453,884,951
0131-002,2011,10,20,18,476,516,992,884
0131-002,2011,10,20,19,444,539,983,992
0131-002,2011,10,20,20,299,407,706,983
0131-002,2011,10,20,21,267,347,614,706
0131-002,2011,10,20,22,224,259,483,614
0131-002,2011,10,20,23,148,146,294,483
0131-002,2011,10,20,24,110,100,210,294
0131-002,2011,10,21,1,67,66,133,210
0131-002,2011,10,21,2,38,40,78,133
0131-002,2011,10,21,3,30,34,64,78
0131-002,2011,10,21,4,15,22,37,64
0131-002,2011,10,21,5,16,47,63,37
0131-002,2011,10,21,6,72,60,132,63
0131-002,2011,10,21,7,226,131,357,132
0131-002,2011,10,21,8,645,531,1176,357
0131-002,2011,10,21,9,516,554,1070,1176
0131-002,2011,10,21,10,377,455,832,1070
0131-002,2011,10,21,11,446,405,851,832
0131-002,2011,10,21,12,371,454,825,851
0131-002,2011,10,21,13,299,360,659,825
0131-002,2011,10,21,14,381,449,830,659
0131-002,2011,10,21,15,416,475,891,830
0131-002,2011,10,21,16,441,472,913,891
0131-002,2011,10,21,17,470,478,948,913
0131-002,2011,10,21,18,484,580,1064,948
0131-002,2011,10,21,19,553,534,1087,1064
0131-002,2011,10,21,20,358,423,781,1087
0131-002,2011,10,21,21,310,349,659,781
0131-002,2011,10,21,22,222,266,488,659
0131-002,2011,10,21,23,168,195,363,488
0131-002,2011,10,21,24,92,133,225,363
0131-002,2011,10,22,1,76,84,160,225
0131-002,2011,10,22,2,49,49,98,160
0131-002,2011,10,22,3,34,34,68,98
0131-002,2011,10,22,4,27,35,62,68
0131-002,2011,10,22,5,38,42,80,62
0131-002,2011,10,22,6,44,77,121,80
0131-002,2011,10,22,7,128,107,235,121
0131-002,2011,10,22,8,374,318,692,235
0131-002,2011,10,22,9,369,408,777,692
0131-002,2011,10,22,10,322,462,784,777
0131-002,2011,10,22,11,369,659,1028,784
0131-002,2011,10,22,12,411,727,1138,1028
0131-002,2011,10,22,13,370,776,1146,1138
0131-002,2011,10,22,14,383,764,1147,1146
0131-002,2011,10,22,15,407,703,1110,1147
0131-002,2011,10,22,16,420,656,1076,1110
0131-002,2011,10,22,17,550,718,1268,1076
0131-002,2011,10,22,18,596,669,1265,1268
0131-002,2011,10,22,19,568,500,1068,1265
0131-002,2011,10,22,20,417,345,762,1068
0131-002,2011,10,22,21,252,274,526,762
0131-002,2011,10,22,22,185,187,372,526
0131-002,2011,10,22,23,130,133,263,372
0131-002,2011,10,22,24,84,103,187,263
0131-002,2011,10,23,1,57,73,130,187
0131-002,2011,10,23,2,38,37,75,130
0131-002,2011,10,23,3,39,36,75,75
0131-002,2011,10,23,4,16,41,57,75
0131-002,2011,10,23,5,28,28,56,57
0131-002,2011,10,23,6,46,68,114,56
0131-002,2011,10,23,7,100,78,178,114
0131-002,2011,10,23,8,191,164,355,178
0131-002,2011,10,23,9,217,232,449,355
0131-002,2011,10,23,10,224,273,497,449
0131-002,2011,10,23,11,279,308,587,497
0131-002,2011,10,23,12,273,316,589,587
0131-002,2011,10,23,13,258,292,550,589
0131-002,2011,10,23,14,298,320,618,550
0131-002,2011,10,23,15,422,375,797,618
0131-002,2011,10,23,16,521,305,826,797
0131-002,2011,10,23,17,564,318,882,826
0131-002,2011,10,23,18,611,374,985,882
0131-002,2011,10,23,19,573,349,922,985
0131-002,2011,10,23,20,546,240,786,922
0131-002,2011,10,23,21,558,221,779,786
0131-002,2011,10,23,22,509,190,699,779
0131-002,2011,10,23,23,269,155,424,699
0131-002,2011,10,23,24,101,98,199,424
0131-002,2011,10,24,1,48,58,106,199
0131-002,2011,10,24,2,40,35,75,106
0131-002,2011,10,24,3,23,18,41,75
0131-002,2011,10,24,4,15,24,39,41
0131-002,2011,10,24,5,16,40,56,39
0131-002,2011,10,24,6,51,75,126,56
0131-002,2011,10,24,7,276,192,468,126
0131-002,2011,10,24,8,698,621,1319,468
0131-002,2011,10,24,9,561,634,1195,1319
0131-002,2011,10,24,10,353,434,787,1195
0131-002,2011,10,24,11,438,445,883,787
0131-002,2011,10,24,12,374,386,760,883
0131-002,2011,10,24,13,339,337,676,760
0131-002,2011,10,24,14,397,419,816,676
0131-002,2011,10,24,15,445,467,912,816
0131-002,2011,10,24,16,403,422,825,912
0131-002,2011,10,24,17,393,484,877,825
0131-002,2011,10,24,18,396,499,895,877
0131-002,2011,10,24,19,455,515,970,895
0131-002,2011,10,24,20,322,325,647,970
0131-002,2011,10,24,21,257,326,583,647
0131-002,2011,10,24,22,195,271,466,583
0131-002,2011,10,24,23,159,157,316,466
0131-002,2011,10,24,24,77,95,172,316
0131-002,2011,10,25,1,46,49,95,172
0131-002,2011,10,25,2,40,37,77,95
0131-002,2011,10,25,3,19,32,51,77
0131-002,2011,10,25,4,14,30,44,51
0131-002,2011,10,25,5,28,32,60,44
0131-002,2011,10,25,6,58,56,114,60
0131-002,2011,10,25,7,224,142,366,114
0131-002,2011,10,25,8,677,556,1233,366
0131-002,2011,10,25,9,518,631,1149,1233
0131-002,2011,10,25,10,383,431,814,1149
0131-002,2011,10,25,11,411,412,823,814
0131-002,2011,10,25,12,367,392,759,823
0131-002,2011,10,25,13,311,343,654,759
0131-002,2011,10,25,14,355,397,752,654
0131-002,2011,10,25,15,472,411,883,752
0131-002,2011,10,25,16,444,448,892,883
0131-002,2011,10,25,17,444,465,909,892
0131-002,2011,10,25,18,466,533,999,909
0131-002,2011,10,25,19,472,609,1081,999
0131-002,2011,10,25,20,304,412,716,1081
0131-002,2011,10,25,21,251,322,573,716
0131-002,2011,10,25,22,238,265,503,573
0131-002,2011,10,25,23,160,174,334,503
0131-002,2011,10,25,24,88,94,182,334
0131-002,2011,10,26,1,56,60,116,182
0131-002,2011,10,26,2,38,40,78,116
0131-002,2011,10,26,3,20,29,49,78
0131-002,2011,10,26,4,15,37,52,49
0131-002,2011,10,26,5,24,36,60,52
0131-002,2011,10,26,6,43,63,106,60
0131-002,2011,10,26,7,208,148,356,106
0131-002,2011,10,26,8,688,562,1250,356
0131-002,2011,10,26,9,554,615,1169,1250
0131-002,2011,10,26,10,408,459,867,1169
0131-002,2011,10,26,11,440,415,855,867
0131-002,2011,10,26,12,389,432,821,855
0131-002,2011,10,26,13,303,361,664,821
0131-002,2011,10,26,14,388,433,821,664
0131-002,2011,10,26,15,440,454,894,821
0131-002,2011,10,26,16,459,405,864,894
0131-002,2011,10,26,17,426,439,865,864
0131-002,2011,10,26,18,452,532,984,865
0131-002,2011,10,26,19,439,562,1001,984
0131-002,2011,10,26,20,344,352,696,1001
0131-002,2011,10,26,21,239,340,579,696
0131-002,2011,10,26,22,226,241,467,579
0131-002,2011,10,26,23,154,164,318,467
0131-002,2011,10,26,24,81,106,187,318
0131-002,2011,10,27,1,50,69,119,187
0131-002,2011,10,27,2,41,39,80,119
0131-002,2011,10,27,3,24,29,53,80
0131-002,2011,10,27,4,19,32,51,53
0131-002,2011,10,27,5,23,45,68,51
0131-002,2011,10,27,6,42,61,103,68
0131-002,2011,10,27,7,215,169,384,103
0131-002,2011,10,27,8,668,512,1180,384
0131-002,2011,10,27,9,545,591,1136,1180
0131-002,2011,10,27,10,410,468,878,1136
0131-002,2011,10,27,11,411,400,811,878
0131-002,2011,10,27,12,379,379,758,811
0131-002,2011,10,27,13,292,351,643,758
0131-002,2011,10,27,14,364,401,765,643
0131-002,2011,10,27,15,401,448,849,765
0131-002,2011,10,27,16,451,454,905,849
0131-002,2011,10,27,17,463,447,910,905
0131-002,2011,10,27,18,447,577,1024,910
0131-002,2011,10,27,19,443,513,956,1024
0131-002,2011,10,27,20,306,397,703,956
0131-002,2011,10,27,21,273,311,584,703
0131-002,2011,10,27,22,217,251,468,584
0131-002,2011,10,27,23,156,153,309,468
0131-002,2011,10,27,24,109,101,210,309
0131-002,2011,10,28,1,63,75,138,210
0131-002,2011,10,28,2,48,46,94,138
0131-002,2011,10,28,3,26,24,50,94
0131-002,2011,10,28,4,19,32,51,50
0131-002,2011,10,28,5,13,42,55,51
0131-002,2011,10,28,6,55,69,124,55
0131-002,2011,10,28,7,223,162,385,124
0131-002,2011,10,28,8,679,539,1218,385
0131-002,2011,10,28,9,565,599,1164,1218
0131-002,2011,10,28,10,434,424,858,1164
0131-002,2011,10,28,11,432,433,865,858
0131-002,2011,10,28,12,402,428,830,865
0131-002,2011,10,28,13,299,377,676,830
0131-002,2011,10,28,14,438,415,853,676
0131-002,2011,10,28,15,460,468,928,853
0131-002,2011,10,28,16,441,501,942,928
0131-002,2011,10,28,17,472,480,952,942
0131-002,2011,10,28,18,514,566,1080,952
0131-002,2011,10,28,19,520,556,1076,1080
0131-002,2011,10,28,20,381,412,793,1076
0131-002,2011,10,28,21,301,378,679,793
0131-002,2011,10,28,22,237,262,499,679
0131-002,2011,10,28,23,178,201,379,499
0131-002,2011,10,28,24,141,126,267,379
0131-002,2011,10,29,1,80,100,180,267
0131-002,2011,10,29,2,46,51,97,180
0131-002,2011,10,29,3,36,34,70,97
0131-002,2011,10,29,4,29,33,62,70
0131-002,2011,10,29,5,22,39,61,62
0131-002,2011,10,29,6,46,45,91,61
0131-002,2011,10,29,7,124,112,236,91
0131-002,2011,10,29,8,347,284,631,236
0131-002,2011,10,29,9,406,411,817,631
0131-002,2011,10,29,10,324,390,714,817
0131-002,2011,10,29,11,354,569,923,714
0131-002,2011,10,29,12,407,722,1129,923
0131-002,2011,10,29,13,497,762,1259,1129
0131-002,2011,10,29,14,390,760,1150,1259
0131-002,2011,10,29,15,405,723,1128,1150
0131-002,2011,10,29,16,394,733,1127,1128
0131-002,2011,10,29,17,407,797,1204,1127
0131-002,2011,10,29,18,508,730,1238,1204
0131-002,2011,10,29,19,539,576,1115,1238
0131-002,2011,10,29,20,406,400,806,1115
0131-002,2011,10,29,21,307,264,571,806
0131-002,2011,10,29,22,208,212,420,571
0131-002,2011,10,29,23,131,138,269,420
0131-002,2011,10,29,24,84,115,199,269
0131-002,2011,10,30,1,69,64,133,199
0131-002,2011,10,30,2,43,46,89,133
0131-002,2011,10,30,3,18,33,51,89
0131-002,2011,10,30,4,25,30,55,51
0131-002,2011,10,30,5,28,25,53,55
0131-002,2011,10,30,6,44,35,79,53
0131-002,2011,10,30,7,75,74,149,79
0131-002,2011,10,30,8,173,165,338,149
0131-002,2011,10,30,9,218,213,431,338
0131-002,2011,10,30,10,213,274,487,431
0131-002,2011,10,30,11,260,323,583,487
0131-002,2011,10,30,12,251,271,522,583
0131-002,2011,10,30,13,305,271,576,522
0131-002,2011,10,30,14,307,301,608,576
0131-002,2011,10,30,15,369,281,650,608
0131-002,2011,10,30,16,557,349,906,650
0131-002,2011,10,30,17,565,397,962,906
0131-002,2011,10,30,18,626,384,1010,962
0131-002,2011,10,30,19,632,301,933,1010
0131-002,2011,10,30,20,509,241,750,933
0131-002,2011,10,30,21,494,205,699,750
0131-002,2011,10,30,22,441,171,612,699
0131-002,2011,10,30,23,325,114,439,612
0131-002,2011,10,30,24,96,110,206,439
0131-002,2011,10,31,1,42,40,82,206
0131-002,2011,10,31,2,28,22,50,82
0131-002,2011,10,31,3,22,22,44,50
0131-002,2011,10,31,4,18,26,44,44
0131-002,2011,10,31,5,15,29,44,44
0131-002,2011,10,31,6,53,56,109,44
0131-002,2011,10,31,7,251,200,451,109
0131-002,2011,10,31,8,681,569,1250,451
0131-002,2011,10,31,9,518,620,1138,1250
0131-002,2011,10,31,10,410,388,798,1138
0131-002,2011,10,31,11,386,433,819,798
0131-002,2011,10,31,12,352,439,791,819
0131-002,2011,10,31,13,295,343,638,791
0131-002,2011,10,31,14,387,394,781,638
0131-002,2011,10,31,15,430,415,845,781
0131-002,2011,10,31,16,408,453,861,845
0131-002,2011,10,31,17,418,473,891,861
0131-002,2011,10,31,18,441,525,966,891
0131-002,2011,10,31,19,445,497,942,966
0131-002,2011,10,31,20,360,399,759,942
0131-002,2011,10,31,21,256,297,553,759
0131-002,2011,10,31,22,232,253,485,553
0131-002,2011,10,31,23,154,173,327,485
0131-002,2011,10,31,24,89,103,192,327
0131-002,2011,11,1,1,60,69,129,192
0131-002,2011,11,1,2,42,42,84,129
0131-002,2011,11,1,3,16,24,40,84
0131-002,2011,11,1,4,20,25,45,40
0131-002,2011,11,1,5,35,42,77,45
0131-002,2011,11,1,6,58,64,122,77
0131-002,2011,11,1,7,225,142,367,122
0131-002,2011,11,1,8,684,538,1222,367
0131-002,2011,11,1,9,532,569,1101,1222
0131-002,2011,11,1,10,401,403,804,1101
0131-002,2011,11,1,11,430,429,859,804
0131-002,2011,11,1,12,352,398,750,859
0131-002,2011,11,1,13,300,357,657,750
0131-002,2011,11,1,14,387,426,813,657
0131-002,2011,11,1,15,425,431,856,813
0131-002,2011,11,1,16,411,441,852,856
0131-002,2011,11,1,17,380,441,821,852
0131-002,2011,11,1,18,454,494,948,821
0131-002,2011,11,1,19,469,498,967,948
0131-002,2011,11,1,20,292,344,636,967
0131-002,2011,11,1,21,250,341,591,636
0131-002,2011,11,1,22,223,252,475,591
0131-002,2011,11,1,23,155,157,312,475
0131-002,2011,11,1,24,101,107,208,312
0131-002,2011,11,2,1,50,68,118,208
0131-002,2011,11,2,2,42,42,84,118
0131-002,2011,11,2,3,30,29,59,84
0131-002,2011,11,2,4,14,26,40,59
0131-002,2011,11,2,5,30,45,75,40
0131-002,2011,11,2,6,60,59,119,75
0131-002,2011,11,2,7,204,172,376,119
0131-002,2011,11,2,8,661,511,1172,376
0131-002,2011,11,2,9,538,603,1141,1172
0131-002,2011,11,2,10,364,453,817,1141
0131-002,2011,11,2,11,398,410,808,817
0131-002,2011,11,2,12,364,399,763,808
0131-002,2011,11,2,13,314,379,693,763
0131-002,2011,11,2,14,342,403,745,693
0131-002,2011,11,2,15,406,419,825,745
0131-002,2011,11,2,16,400,455,855,825
0131-002,2011,11,2,17,427,445,872,855
0131-002,2011,11,2,18,461,546,1007,872
0131-002,2011,11,2,19,461,515,976,1007
0131-002,2011,11,2,20,306,332,638,976
0131-002,2011,11,2,21,272,339,611,638
0131-002,2011,11,2,22,220,273,493,611
0131-002,2011,11,2,23,165,145,310,493
0131-002,2011,11,2,24,78,99,177,310
0131-002,2011,11,3,1,77,62,139,177
0131-002,2011,11,3,2,42,39,81,139
0131-002,2011,11,3,3,28,24,52,81
0131-002,2011,11,3,4,24,24,48,52
0131-002,2011,11,3,5,24,32,56,48
0131-002,2011,11,3,6,49,46,95,56
0131-002,2011,11,3,7,214,149,363,95
0131-002,2011,11,3,8,639,508,1147,363
0131-002,2011,11,3,9,567,621,1188,1147
0131-002,2011,11,3,10,389,461,850,1188
0131-002,2011,11,3,11,381,403,784,850
0131-002,2011,11,3,12,397,375,772,784
0131-002,2011,11,3,13,331,331,662,772
0131-002,2011,11,3,14,396,421,817,662
0131-002,2011,11,3,15,412,444,856,817
0131-002,2011,11,3,16,398,429,827,856
0131-002,2011,11,3,17,419,411,830,827
0131-002,2011,11,3,18,453,556,1009,830
0131-002,2011,11,3,19,429,507,936,1009
0131-002,2011,11,3,20,332,398,730,936
0131-002,2011,11,3,21,274,346,620,730
0131-002,2011,11,3,22,221,231,452,620
0131-002,2011,11,3,23,147,173,320,452
0131-002,2011,11,3,24,101,75,176,320
0131-002,2011,11,4,1,58,79,137,176
0131-002,2011,11,4,2,28,39,67,137
0131-002,2011,11,4,3,18,37,55,67
0131-002,2011,11,4,4,24,37,61,55
0131-002,2011,11,4,5,36,38,74,61
0131-002,2011,11,4,6,53,64,117,74
0131-002,2011,11,4,7,229,145,374,117
0131-002,2011,11,4,8,641,542,1183,374
0131-002,2011,11,4,9,547,582,1129,1183
0131-002,2011,11,4,10,442,434,876,1129
0131-002,2011,11,4,11,427,431,858,876
0131-002,2011,11,4,12,378,401,779,858
0131-002,2011,11,4,13,298,411,709,779
0131-002,2011,11,4,14,380,419,799,709
0131-002,2011,11,4,15,439,465,904,799
0131-002,2011,11,4,16,444,516,960,904
0131-002,2011,11,4,17,463,465,928,960
0131-002,2011,11,4,18,456,638,1094,928
0131-002,2011,11,4,19,568,579,1147,1094
0131-002,2011,11,4,20,399,460,859,1147
0131-002,2011,11,4,21,277,368,645,859
0131-002,2011,11,4,22,253,263,516,645
0131-002,2011,11,4,23,193,180,373,516
0131-002,2011,11,4,24,115,139,254,373
0131-002,2011,11,5,1,63,89,152,254
0131-002,2011,11,5,2,47,57,104,152
0131-002,2011,11,5,3,31,37,68,104
0131-002,2011,11,5,4,27,28,55,68
0131-002,2011,11,5,5,25,41,66,55
0131-002,2011,11,5,6,45,68,113,66
0131-002,2011,11,5,7,128,91,219,113
0131-002,2011,11,5,8,359,300,659,219
0131-002,2011,11,5,9,436,383,819,659
0131-002,2011,11,5,10,397,409,806,819
0131-002,2011,11,5,11,341,605,946,806
0131-002,2011,11,5,12,375,698,1073,946
0131-002,2011,11,5,13,358,762,1120,1073
0131-002,2011,11,5,14,357,706,1063,1120
0131-002,2011,11,5,15,434,709,1143,1063
0131-002,2011,11,5,16,484,712,1196,1143
0131-002,2011,11,5,17,523,689,1212,1196
0131-002,2011,11,5,18,574,639,1213,1212
0131-002,2011,11,5,19,640,566,1206,1213
0131-002,2011,11,5,20,443,462,905,1206
0131-002,2011,11,5,21,282,304,586,905
0131-002,2011,11,5,22,222,213,435,586
0131-002,2011,11,5,23,131,137,268,435
0131-002,2011,11,5,24,84,89,173,268
0131-002,2011,11,6,1,67,66,133,173
0131-002,2011,11,6,2,40,59,99,133
0131-002,2011,11,6,3,29,34,63,99
0131-002,2011,11,6,4,28,34,62,63
0131-002,2011,11,6,5,23,19,42,62
0131-002,2011,11,6,6,28,36,64,42
0131-002,2011,11,6,7,66,72,138,64
0131-002,2011,11,6,8,125,122,247,138
0131-002,2011,11,6,9,158,218,376,247
0131-002,2011,11,6,10,191,238,429,376
0131-002,2011,11,6,11,253,276,529,429
0131-002,2011,11,6,12,240,280,520,529
0131-002,2011,11,6,13,336,281,617,520
0131-002,2011,11,6,14,321,263,584,617
0131-002,2011,11,6,15,406,275,681,584
0131-002,2011,11,6,16,521,347,868,681
0131-002,2011,11,6,17,561,336,897,868
0131-002,2011,11,6,18,586,286,872,897
0131-002,2011,11,6,19,612,288,900,872
0131-002,2011,11,6,20,523,204,727,900
0131-002,2011,11,6,21,564,212,776,727
0131-002,2011,11,6,22,533,171,704,776
0131-002,2011,11,6,23,332,129,461,704
0131-002,2011,11,6,24,106,98,204,461
0131-002,2011,11,7,1,56,47,103,204
0131-002,2011,11,7,2,28,31,59,103
0131-002,2011,11,7,3,13,25,38,59
0131-002,2011,11,7,4,12,20,32,38
0131-002,2011,11,7,5,11,35,46,32
0131-002,2011,11,7,6,46,87,133,46
0131-002,2011,11,7,7,237,196,433,133
0131-002,2011,11,7,8,723,563,1286,433
0131-002,2011,11,7,9,558,642,1200,1286
0131-002,2011,11,7,10,415,446,861,1200
0131-002,2011,11,7,11,416,472,888,861
0131-002,2011,11,7,12,402,423,825,888
0131-002,2011,11,7,13,330,338,668,825
0131-002,2011,11,7,14,393,519,912,668
0131-002,2011,11,7,15,472,433,905,912
0131-002,2011,11,7,16,427,413,840,905
0131-002,2011,11,7,17,427,419,846,840
0131-002,2011,11,7,18,422,494,916,846
0131-002,2011,11,7,19,425,486,911,916
0131-002,2011,11,7,20,294,389,683,911
0131-002,2011,11,7,21,253,336,589,683
0131-002,2011,11,7,22,191,249,440,589
0131-002,2011,11,7,23,148,161,309,440
0131-002,2011,11,7,24,93,92,185,309
0131-002,2011,11,8,1,64,55,119,185
0131-002,2011,11,8,2,30,37,67,119
0131-002,2011,11,8,3,29,27,56,67
0131-002,2011,11,8,4,20,22,42,56
0131-002,2011,11,8,5,26,48,74,42
0131-002,2011,11,8,6,66,76,142,74
0131-002,2011,11,8,7,241,148,389,142
0131-002,2011,11,8,8,672,554,1226,389
0131-002,2011,11,8,9,545,610,1155,1226
0131-002,2011,11,8,10,390,449,839,1155
0131-002,2011,11,8,11,458,476,934,839
0131-002,2011,11,8,12,407,400,807,934
0131-002,2011,11,8,13,313,350,663,807
0131-002,2011,11,8,14,392,398,790,663
0131-002,2011,11,8,15,398,422,820,790
0131-002,2011,11,8,16,415,450,865,820
0131-002,2011,11,8,17,402,452,854,865
0131-002,2011,11,8,18,461,506,967,854
0131-002,2011,11,8,19,391,514,905,967
0131-002,2011,11,8,20,305,351,656,905
0131-002,2011,11,8,21,250,325,575,656
0131-002,2011,11,8,22,216,234,450,575
0131-002,2011,11,8,23,142,163,305,450
0131-002,2011,11,8,24,110,100,210,305
0131-002,2011,11,9,1,59,62,121,210
0131-002,2011,11,9,2,40,45,85,121
0131-002,2011,11,9,3,24,35,59,85
0131-002,2011,11,9,4,24,23,47,59
0131-002,2011,11,9,5,22,35,57,47
0131-002,2011,11,9,6,54,58,112,57
0131-002,2011,11,9,7,225,150,375,112
0131-002,2011,11,9,8,628,508,1136,375
0131-002,2011,11,9,9,553,581,1134,1136
0131-002,2011,11,9,10,392,437,829,1134
0131-002,2011,11,9,11,400,394,794,829
0131-002,2011,11,9,12,366,451,817,794
0131-002,2011,11,9,13,311,307,618,817
0131-002,2011,11,9,14,348,410,758,618
0131-002,2011,11,9,15,453,441,894,758
0131-002,2011,11,9,16,461,424,885,894
0131-002,2011,11,9,17,407,448,855,885
0131-002,2011,11,9,18,451,569,1020,855
0131-002,2011,11,9,19,479,494,973,1020
0131-002,2011,11,9,20,281,388,669,973
0131-002,2011,11,9,21,238,319,557,669
0131-002,2011,11,9,22,222,237,459,557
0131-002,2011,11,9,23,160,162,322,459
0131-002,2011,11,9,24,108,112,220,322
0131-002,2011,11,10,1,61,70,131,220
0131-002,2011,11,10,2,37,44,81,131
0131-002,2011,11,10,3,33,30,63,81
0131-002,2011,11,10,4,21,22,43,63
0131-002,2011,11,10,5,19,47,66,43
0131-002,2011,11,10,6,68,58,126,66
0131-002,2011,11,10,7,223,153,376,126
0131-002,2011,11,10,8,599,528,1127,376
0131-002,2011,11,10,9,560,602,1162,1127
0131-002,2011,11,10,10,438,442,880,1162
0131-002,2011,11,10,11,416,444,860,880
0131-002,2011,11,10,12,354,384,738,860
0131-002,2011,11,10,13,309,364,673,738
0131-002,2011,11,10,14,353,429,782,673
0131-002,2011,11,10,15,425,437,862,782
0131-002,2011,11,10,16,424,468,892,862
0131-002,2011,11,10,17,429,445,874,892
0131-002,2011,11,10,18,459,496,955,874
0131-002,2011,11,10,19,436,520,956,955
0131-002,2011,11,10,20,370,375,745,956
0131-002,2011,11,10,21,249,324,573,745
0131-002,2011,11,10,22,230,259,489,573
0131-002,2011,11,10,23,188,167,355,489
0131-002,2011,11,10,24,78,104,182,355
0131-002,2011,11,11,1,66,74,140,182
0131-002,2011,11,11,2,39,39,78,140
0131-002,2011,11,11,3,36,20,56,78
0131-002,2011,11,11,4,24,25,49,56
0131-002,2011,11,11,5,18,33,51,49
0131-002,2011,11,11,6,62,53,115,51
0131-002,2011,11,11,7,201,123,324,115
0131-002,2011,11,11,8,615,470,1085,324
0131-002,2011,11,11,9,529,598,1127,1085
0131-002,2011,11,11,10,420,430,850,1127
0131-002,2011,11,11,11,401,445,846,850
0131-002,2011,11,11,12,380,420,800,846
0131-002,2011,11,11,13,359,392,751,800
0131-002,2011,11,11,14,385,424,809,751
0131-002,2011,11,11,15,453,466,919,809
0131-002,2011,11,11,16,482,474,956,919
0131-002,2011,11,11,17,440,497,937,956
0131-002,2011,11,11,18,466,528,994,937
0131-002,2011,11,11,19,532,542,1074,994
0131-002,2011,11,11,20,368,470,838,1074
0131-002,2011,11,11,21,274,381,655,838
0131-002,2011,11,11,22,253,285,538,655
0131-002,2011,11,11,23,203,207,410,538
0131-002,2011,11,11,24,114,145,259,410
0131-002,2011,11,12,1,68,95,163,259
0131-002,2011,11,12,2,45,59,104,163
0131-002,2011,11,12,3,23,47,70,104
0131-002,2011,11,12,4,30,36,66,70
0131-002,2011,11,12,5,27,50,77,66
0131-002,2011,11,12,6,60,78,138,77
0131-002,2011,11,12,7,190,138,328,138
0131-002,2011,11,12,8,323,324,647,328
0131-002,2011,11,12,9,416,444,860,647
0131-002,2011,11,12,10,416,512,928,860
0131-002,2011,11,12,11,394,680,1074,928
0131-002,2011,11,12,12,447,831,1278,1074
0131-002,2011,11,12,13,478,859,1337,1278
0131-002,2011,11,12,14,466,863,1329,1337
0131-002,2011,11,12,15,440,859,1299,1329
0131-002,2011,11,12,16,456,835,1291,1299
0131-002,2011,11,12,17,553,816,1369,1291
0131-002,2011,11,12,18,654,820,1474,1369
0131-002,2011,11,12,19,636,679,1315,1474
0131-002,2011,11,12,20,504,570,1074,1315
0131-002,2011,11,12,21,464,477,941,1074
0131-002,2011,11,12,22,275,295,570,941
0131-002,2011,11,12,23,162,162,324,570
0131-002,2011,11,12,24,91,99,190,324
0131-002,2011,11,13,1,69,77,146,190
0131-002,2011,11,13,2,46,36,82,146
0131-002,2011,11,13,3,33,29,62,82
0131-002,2011,11,13,4,24,31,55,62
0131-002,2011,11,13,5,27,48,75,55
0131-002,2011,11,13,6,43,66,109,75
0131-002,2011,11,13,7,110,85,195,109
0131-002,2011,11,13,8,166,158,324,195
0131-002,2011,11,13,9,225,248,473,324
0131-002,2011,11,13,10,253,270,523,473
0131-002,2011,11,13,11,294,277,571,523
0131-002,2011,11,13,12,311,320,631,571
0131-002,2011,11,13,13,443,278,721,631
0131-002,2011,11,13,14,533,342,875,721
0131-002,2011,11,13,15,582,367,949,875
0131-002,2011,11,13,16,625,406,1031,949
0131-002,2011,11,13,17,645,344,989,1031
0131-002,2011,11,13,18,652,392,1044,989
0131-002,2011,11,13,19,682,341,1023,1044
0131-002,2011,11,13,20,761,267,1028,1023
0131-002,2011,11,13,21,648,242,890,1028
0131-002,2011,11,13,22,564,216,780,890
0131-002,2011,11,13,23,629,116,745,780
0131-002,2011,11,13,24,579,100,679,745
0131-002,2011,11,14,1,97,60,157,679
0131-002,2011,11,14,2,31,21,52,157
0131-002,2011,11,14,3,12,22,34,52
0131-002,2011,11,14,4,14,27,41,34
0131-002,2011,11,14,5,23,44,67,41
0131-002,2011,11,14,6,60,62,122,67
0131-002,2011,11,14,7,271,184,455,122
0131-002,2011,11,14,8,678,565,1243,455
0131-002,2011,11,14,9,555,676,1231,1243
0131-002,2011,11,14,10,402,439,841,1231
0131-002,2011,11,14,11,425,457,882,841
0131-002,2011,11,14,12,424,378,802,882
0131-002,2011,11,14,13,320,390,710,802
0131-002,2011,11,14,14,413,443,856,710
0131-002,2011,11,14,15,496,491,987,856
0131-002,2011,11,14,16,482,449,931,987
0131-002,2011,11,14,17,482,469,951,931
0131-002,2011,11,14,18,424,524,948,951
0131-002,2011,11,14,19,439,473,912,948
0131-002,2011,11,14,20,318,383,701,912
0131-002,2011,11,14,21,287,337,624,701
0131-002,2011,11,14,22,224,224,448,624
0131-002,2011,11,14,23,161,155,316,448
0131-002,2011,11,14,24,84,94,178,316
0131-002,2011,11,15,1,55,54,109,178
0131-002,2011,11,15,2,27,47,74,109
0131-002,2011,11,15,3,23,28,51,74
0131-002,2011,11,15,4,13,28,41,51
0131-002,2011,11,15,5,14,39,53,41
0131-002,2011,11,15,6,71,75,146,53
0131-002,2011,11,15,7,226,148,374,146
0131-002,2011,11,15,8,603,545,1148,374
0131-002,2011,11,15,9,582,610,1192,1148
0131-002,2011,11,15,10,435,468,903,1192
0131-002,2011,11,15,11,451,432,883,903
0131-002,2011,11,15,12,417,431,848,883
0131-002,2011,11,15,13,319,361,680,848
0131-002,2011,11,15,14,409,422,831,680
0131-002,2011,11,15,15,394,441,835,831
0131-002,2011,11,15,16,488,426,914,835
0131-002,2011,11,15,17,435,428,863,914
0131-002,2011,11,15,18,475,489,964,863
0131-002,2011,11,15,19,405,516,921,964
0131-002,2011,11,15,20,313,353,666,921
0131-002,2011,11,15,21,288,372,660,666
0131-002,2011,11,15,22,223,239,462,660
0131-002,2011,11,15,23,165,133,298,462
0131-002,2011,11,15,24,79,94,173,298
0131-002,2011,11,16,1,56,68,124,173
0131-002,2011,11,16,2,41,35,76,124
0131-002,2011,11,16,3,20,28,48,76
0131-002,2011,11,16,4,24,33,57,48
0131-002,2011,11,16,5,21,39,60,57
0131-002,2011,11,16,6,56,60,116,60
0131-002,2011,11,16,7,202,144,346,116
0131-002,2011,11,16,8,644,487,1131,346
0131-002,2011,11,16,9,487,633,1120,1131
0131-002,2011,11,16,10,453,469,922,1120
0131-002,2011,11,16,11,388,391,779,922
0131-002,2011,11,16,12,358,402,760,779
0131-002,2011,11,16,13,331,337,668,760
0131-002,2011,11,16,14,370,422,792,668
0131-002,2011,11,16,15,397,418,815,792
0131-002,2011,11,16,16,472,440,912,815
0131-002,2011,11,16,17,431,471,902,912
0131-002,2011,11,16,18,461,573,1034,902
0131-002,2011,11,16,19,456,487,943,1034
0131-002,2011,11,16,20,331,386,717,943
0131-002,2011,11,16,21,215,306,521,717
0131-002,2011,11,16,22,228,243,471,521
0131-002,2011,11,16,23,170,165,335,471
0131-002,2011,11,16,24,105,111,216,335
0131-002,2011,11,17,1,55,79,134,216
0131-002,2011,11,17,2,38,41,79,134
0131-002,2011,11,17,3,24,23,47,79
0131-002,2011,11,17,4,21,28,49,47
0131-002,2011,11,17,5,21,38,59,49
0131-002,2011,11,17,6,58,64,122,59
0131-002,2011,11,17,7,241,157,398,122
0131-002,2011,11,17,8,619,521,1140,398
0131-002,2011,11,17,9,504,601,1105,1140
0131-002,2011,11,17,10,435,452,887,1105
0131-002,2011,11,17,11,431,395,826,887
0131-002,2011,11,17,12,382,401,783,826
0131-002,2011,11,17,13,315,318,633,783
0131-002,2011,11,17,14,364,461,825,633
0131-002,2011,11,17,15,454,415,869,825
0131-002,2011,11,17,16,437,447,884,869
0131-002,2011,11,17,17,435,447,882,884
0131-002,2011,11,17,18,475,511,986,882
0131-002,2011,11,17,19,439,539,978,986
0131-002,2011,11,17,20,319,369,688,978
0131-002,2011,11,17,21,289,322,611,688
0131-002,2011,11,17,22,250,229,479,611
0131-002,2011,11,17,23,162,176,338,479
0131-002,2011,11,17,24,111,116,227,338
0131-002,2011,11,18,1,69,81,150,227
0131-002,2011,11,18,2,32,46,78,150
0131-002,2011,11,18,3,19,31,50,78
0131-002,2011,11,18,4,20,32,52,50
0131-002,2011,11,18,5,19,43,62,52
0131-002,2011,11,18,6,51,51,102,62
0131-002,2011,11,18,7,176,124,300,102
0131-002,2011,11,18,8,578,465,1043,300
0131-002,2011,11,18,9,557,578,1135,1043
0131-002,2011,11,18,10,369,462,831,1135
0131-002,2011,11,18,11,445,403,848,831
0131-002,2011,11,18,12,320,419,739,848
0131-002,2011,11,18,13,297,350,647,739
0131-002,2011,11,18,14,399,410,809,647
0131-002,2011,11,18,15,457,457,914,809
0131-002,2011,11,18,16,467,440,907,914
0131-002,2011,11,18,17,465,477,942,907
0131-002,2011,11,18,18,493,555,1048,942
0131-002,2011,11,18,19,492,568,1060,1048
0131-002,2011,11,18,20,381,438,819,1060
0131-002,2011,11,18,21,271,360,631,819
0131-002,2011,11,18,22,251,277,528,631
0131-002,2011,11,18,23,172,211,383,528
0131-002,2011,11,18,24,110,124,234,383
0131-002,2011,11,19,1,60,69,129,234
0131-002,2011,11,19,2,51,81,132,129
0131-002,2011,11,19,3,30,45,75,132
0131-002,2011,11,19,4,23,39,62,75
0131-002,2011,11,19,5,21,36,57,62
0131-002,2011,11,19,6,42,46,88,57
0131-002,2011,11,19,7,132,115,247,88
0131-002,2011,11,19,8,293,291,584,247
0131-002,2011,11,19,9,410,379,789,584
0131-002,2011,11,19,10,371,419,790,789
0131-002,2011,11,19,11,384,617,1001,790
0131-002,2011,11,19,12,383,652,1035,1001
0131-002,2011,11,19,13,336,706,1042,1035
0131-002,2011,11,19,14,357,672,1029,1042
0131-002,2011,11,19,15,437,720,1157,1029
0131-002,2011,11,19,16,445,802,1247,1157
0131-002,2011,11,19,17,511,740,1251,1247
0131-002,2011,11,19,18,685,732,1417,1251
0131-002,2011,11,19,19,546,647,1193,1417
0131-002,2011,11,19,20,480,476,956,1193
0131-002,2011,11,19,21,279,369,648,956
0131-002,2011,11,19,22,218,268,486,648
0131-002,2011,11,19,23,140,154,294,486
0131-002,2011,11,19,24,99,104,203,294
0131-002,2011,11,20,1,64,74,138,203
0131-002,2011,11,20,2,35,42,77,138
0131-002,2011,11,20,3,20,36,56,77
0131-002,2011,11,20,4,14,31,45,56
0131-002,2011,11,20,5,20,20,40,45
0131-002,2011,11,20,6,40,47,87,40
0131-002,2011,11,20,7,96,78,174,87
0131-002,2011,11,20,8,162,150,312,174
0131-002,2011,11,20,9,207,197,404,312
0131-002,2011,11,20,10,212,240,452,404
0131-002,2011,11,20,11,284,285,569,452
0131-002,2011,11,20,12,342,305,647,569
0131-002,2011,11,20,13,430,363,793,647
0131-002,2011,11,20,14,486,295,781,793
0131-002,2011,11,20,15,600,377,977,781
0131-002,2011,11,20,16,652,380,1032,977
0131-002,2011,11,20,17,714,370,1084,1032
0131-002,2011,11,20,18,764,315,1079,1084
0131-002,2011,11,20,19,639,321,960,1079
0131-002,2011,11,20,20,581,236,817,960
0131-002,2011,11,20,21,597,205,802,817
0131-002,2011,11,20,22,650,184,834,802
0131-002,2011,11,20,23,542,146,688,834
0131-002,2011,11,20,24,258,98,356,688
0131-002,2011,11,21,1,58,51,109,356
0131-002,2011,11,21,2,17,24,41,109
0131-002,2011,11,21,3,20,12,32,41
0131-002,2011,11,21,4,14,30,44,32
0131-002,2011,11,21,5,10,29,39,44
0131-002,2011,11,21,6,45,54,99,39
0131-002,2011,11,21,7,232,167,399,99
0131-002,2011,11,21,8,688,576,1264,399
0131-002,2011,11,21,9,563,610,1173,1264
0131-002,2011,11,21,10,365,388,753,1173
0131-002,2011,11,21,11,383,419,802,753
0131-002,2011,11,21,12,352,397,749,802
0131-002,2011,11,21,13,276,366,642,749
0131-002,2011,11,21,14,378,425,803,642
0131-002,2011,11,21,15,424,469,893,803
0131-002,2011,11,21,16,432,448,880,893
0131-002,2011,11,21,17,433,432,865,880
0131-002,2011,11,21,18,476,527,1003,865
0131-002,2011,11,21,19,439,495,934,1003
0131-002,2011,11,21,20,304,376,680,934
0131-002,2011,11,21,21,257,309,566,680
0131-002,2011,11,21,22,237,244,481,566
0131-002,2011,11,21,23,151,145,296,481
0131-002,2011,11,21,24,95,93,188,296
0131-002,2011,11,22,1,39,55,94,188
0131-002,2011,11,22,2,41,44,85,94
0131-002,2011,11,22,3,20,19,39,85
0131-002,2011,11,22,4,15,34,49,39
0131-002,2011,11,22,5,12,38,50,49
0131-002,2011,11,22,6,55,48,103,50
0131-002,2011,11,22,7,200,136,336,103
0131-002,2011,11,22,8,608,526,1134,336
0131-002,2011,11,22,9,568,563,1131,1134
0131-002,2011,11,22,10,379,452,831,1131
0131-002,2011,11,22,11,376,420,796,831
0131-002,2011,11,22,12,345,417,762,796
0131-002,2011,11,22,13,317,352,669,762
0131-002,2011,11,22,14,380,407,787,669
0131-002,2011,11,22,15,453,436,889,787
0131-002,2011,11,22,16,385,379,764,889
0131-002,2011,11,22,17,373,401,774,764
0131-002,2011,11,22,18,435,506,941,774
0131-002,2011,11,22,19,415,532,947,941
0131-002,2011,11,22,20,298,352,650,947
0131-002,2011,11,22,21,286,328,614,650
0131-002,2011,11,22,22,229,246,475,614
0131-002,2011,11,22,23,144,156,300,475
0131-002,2011,11,22,24,73,92,165,300
0131-002,2011,11,23,1,62,52,114,165
0131-002,2011,11,23,2,39,45,84,114
0131-002,2011,11,23,3,26,25,51,84
0131-002,2011,11,23,4,18,22,40,51
0131-002,2011,11,23,5,19,27,46,40
0131-002,2011,11,23,6,41,59,100,46
0131-002,2011,11,23,7,173,126,299,100
0131-002,2011,11,23,8,582,480,1062,299
0131-002,2011,11,23,9,545,570,1115,1062
0131-002,2011,11,23,10,409,378,787,1115
0131-002,2011,11,23,11,379,399,778,787
0131-002,2011,11,23,12,363,372,735,778
0131-002,2011,11,23,13,296,351,647,735
0131-002,2011,11,23,14,353,404,757,647
0131-002,2011,11,23,15,416,423,839,757
0131-002,2011,11,23,16,411,491,902,839
0131-002,2011,11,23,17,399,506,905,902
0131-002,2011,11,23,18,445,546,991,905
0131-002,2011,11,23,19,434,470,904,991
0131-002,2011,11,23,20,294,346,640,904
0131-002,2011,11,23,21,246,310,556,640
0131-002,2011,11,23,22,220,200,420,556
0131-002,2011,11,23,23,136,157,293,420
0131-002,2011,11,23,24,94,97,191,293
0131-002,2011,11,24,1,48,62,110,191
0131-002,2011,11,24,2,39,38,77,110
0131-002,2011,11,24,3,25,39,64,77
0131-002,2011,11,24,4,9,32,41,64
0131-002,2011,11,24,5,8,33,41,41
0131-002,2011,11,24,6,44,53,97,41
0131-002,2011,11,24,7,176,118,294,97
0131-002,2011,11,24,8,588,485,1073,294
0131-002,2011,11,24,9,518,574,1092,1073
0131-002,2011,11,24,10,359,432,791,1092
0131-002,2011,11,24,11,375,377,752,791
0131-002,2011,11,24,12,327,380,707,752
0131-002,2011,11,24,13,330,339,669,707
0131-002,2011,11,24,14,381,403,784,669
0131-002,2011,11,24,15,433,439,872,784
0131-002,2011,11,24,16,407,391,798,872
0131-002,2011,11,24,17,418,422,840,798
0131-002,2011,11,24,18,461,509,970,840
0131-002,2011,11,24,19,400,488,888,970
0131-002,2011,11,24,20,315,386,701,888
0131-002,2011,11,24,21,275,334,609,701
0131-002,2011,11,24,22,235,250,485,609
0131-002,2011,11,24,23,158,152,310,485
0131-002,2011,11,24,24,104,92,196,310
0131-002,2011,11,25,1,63,57,120,196
0131-002,2011,11,25,2,31,59,90,120
0131-002,2011,11,25,3,31,24,55,90
0131-002,2011,11,25,4,20,32,52,55
0131-002,2011,11,25,5,20,41,61,52
0131-002,2011,11,25,6,49,62,111,61
0131-002,2011,11,25,7,215,142,357,111
0131-002,2011,11,25,8,615,471,1086,357
0131-002,2011,11,25,9,581,566,1147,1086
0131-002,2011,11,25,10,411,458,869,1147
0131-002,2011,11,25,11,438,433,871,869
0131-002,2011,11,25,12,380,429,809,871
0131-002,2011,11,25,13,340,378,718,809
0131-002,2011,11,25,14,380,441,821,718
0131-002,2011,11,25,15,416,453,869,821
0131-002,2011,11,25,16,476,471,947,869
0131-002,2011,11,25,17,476,478,954,947
0131-002,2011,11,25,18,471,610,1081,954
0131-002,2011,11,25,19,517,528,1045,1081
0131-002,2011,11,25,20,408,439,847,1045
0131-002,2011,11,25,21,289,397,686,847
0131-002,2011,11,25,22,267,309,576,686
0131-002,2011,11,25,23,158,226,384,576
0131-002,2011,11,25,24,112,132,244,384
0131-002,2011,11,26,1,79,82,161,244
0131-002,2011,11,26,2,62,42,104,161
0131-002,2011,11,26,3,40,38,78,104
0131-002,2011,11,26,4,26,33,59,78
0131-002,2011,11,26,5,30,45,75,59
0131-002,2011,11,26,6,48,60,108,75
0131-002,2011,11,26,7,142,98,240,108
0131-002,2011,11,26,8,327,280,607,240
0131-002,2011,11,26,9,353,416,769,607
0131-002,2011,11,26,10,367,474,841,769
0131-002,2011,11,26,11,398,639,1037,841
0131-002,2011,11,26,12,500,839,1339,1037
0131-002,2011,11,26,13,438,905,1343,1339
0131-002,2011,11,26,14,397,918,1315,1343
0131-002,2011,11,26,15,401,880,1281,1315
0131-002,2011,11,26,16,420,865,1285,1281
0131-002,2011,11,26,17,657,900,1557,1285
0131-002,2011,11,26,18,619,923,1542,1557
0131-002,2011,11,26,19,580,756,1336,1542
0131-002,2011,11,26,20,481,627,1108,1336
0131-002,2011,11,26,21,403,458,861,1108
0131-002,2011,11,26,22,242,293,535,861
0131-002,2011,11,26,23,138,143,281,535
0131-002,2011,11,26,24,86,110,196,281
0131-002,2011,11,27,1,65,62,127,196
0131-002,2011,11,27,2,45,46,91,127
0131-002,2011,11,27,3,28,44,72,91
0131-002,2011,11,27,4,14,26,40,72
0131-002,2011,11,27,5,29,25,54,40
0131-002,2011,11,27,6,31,37,68,54
0131-002,2011,11,27,7,80,61,141,68
0131-002,2011,11,27,8,115,141,256,141
0131-002,2011,11,27,9,208,183,391,256
0131-002,2011,11,27,10,236,225,461,391
0131-002,2011,11,27,11,226,240,466,461
0131-002,2011,11,27,12,362,290,652,466
0131-002,2011,11,27,13,525,292,817,652
0131-002,2011,11,27,14,625,268,893,817
0131-002,2011,11,27,15,607,323,930,893
0131-002,2011,11,27,16,604,323,927,930
0131-002,2011,11,27,17,622,328,950,927
0131-002,2011,11,27,18,705,317,1022,950
0131-002,2011,11,27,19,659,261,920,1022
0131-002,2011,11,27,20,680,219,899,920
0131-002,2011,11,27,21,707,228,935,899
0131-002,2011,11,27,22,690,184,874,935
0131-002,2011,11,27,23,539,125,664,874
0131-002,2011,11,27,24,252,75,327,664
0131-002,2011,11,28,1,57,62,119,327
0131-002,2011,11,28,2,34,35,69,119
0131-002,2011,11,28,3,30,19,49,69
0131-002,2011,11,28,4,16,21,37,49
0131-002,2011,11,28,5,16,38,54,37
0131-002,2011,11,28,6,46,67,113,54
0131-002,2011,11,28,7,252,166,418,113
0131-002,2011,11,28,8,641,564,1205,418
0131-002,2011,11,28,9,551,662,1213,1205
0131-002,2011,11,28,10,410,405,815,1213
0131-002,2011,11,28,11,420,443,863,815
0131-002,2011,11,28,12,417,468,885,863
0131-002,2011,11,28,13,307,381,688,885
0131-002,2011,11,28,14,409,436,845,688
0131-002,2011,11,28,15,441,460,901,845
0131-002,2011,11,28,16,462,461,923,901
0131-002,2011,11,28,17,421,438,859,923
0131-002,2011,11,28,18,434,497,931,859
0131-002,2011,11,28,19,435,516,951,931
0131-002,2011,11,28,20,301,371,672,951
0131-002,2011,11,28,21,282,317,599,672
0131-002,2011,11,28,22,204,238,442,599
0131-002,2011,11,28,23,144,158,302,442
0131-002,2011,11,28,24,96,107,203,302
0131-002,2011,11,29,1,51,71,122,203
0131-002,2011,11,29,2,40,25,65,122
0131-002,2011,11,29,3,17,24,41,65
0131-002,2011,11,29,4,23,28,51,41
0131-002,2011,11,29,5,30,38,68,51
0131-002,2011,11,29,6,56,65,121,68
0131-002,2011,11,29,7,199,131,330,121
0131-002,2011,11,29,8,640,519,1159,330
0131-002,2011,11,29,9,551,595,1146,1159
0131-002,2011,11,29,10,448,436,884,1146
0131-002,2011,11,29,11,436,433,869,884
0131-002,2011,11,29,12,393,394,787,869
0131-002,2011,11,29,13,329,397,726,787
0131-002,2011,11,29,14,375,447,822,726
0131-002,2011,11,29,15,473,502,975,822
0131-002,2011,11,29,16,478,429,907,975
0131-002,2011,11,29,17,424,493,917,907
0131-002,2011,11,29,18,444,491,935,917
0131-002,2011,11,29,19,427,509,936,935
0131-002,2011,11,29,20,307,370,677,936
0131-002,2011,11,29,21,291,331,622,677
0131-002,2011,11,29,22,233,254,487,622
0131-002,2011,11,29,23,152,171,323,487
0131-002,2011,11,29,24,95,104,199,323
0131-002,2011,11,30,1,83,81,164,199
0131-002,2011,11,30,2,55,50,105,164
0131-002,2011,11,30,3,25,27,52,105
0131-002,2011,11,30,4,19,28,47,52
0131-002,2011,11,30,5,19,34,53,47
0131-002,2011,11,30,6,45,52,97,53
0131-002,2011,11,30,7,169,105,274,97
0131-002,2011,11,30,8,548,477,1025,274
0131-002,2011,11,30,9,502,549,1051,1025
0131-002,2011,11,30,10,367,409,776,1051
0131-002,2011,11,30,11,345,392,737,776
0131-002,2011,11,30,12,349,335,684,737
0131-002,2011,11,30,13,271,332,603,684
0131-002,2011,11,30,14,307,392,699,603
0131-002,2011,11,30,15,390,378,768,699
0131-002,2011,11,30,16,404,365,769,768
0131-002,2011,11,30,17,358,405,763,769
0131-002,2011,11,30,18,402,471,873,763
0131-002,2011,11,30,19,427,479,906,873
0131-002,2011,11,30,20,277,327,604,906
0131-002,2011,11,30,21,241,306,547,604
0131-002,2011,11,30,22,219,226,445,547
0131-002,2011,11,30,23,152,163,315,445
0131-002,2011,11,30,24,96,106,202,315
0131-002,2011,12,1,1,63,69,132,202
0131-002,2011,12,1,2,33,35,68,132
0131-002,2011,12,1,3,25,26,51,68
0131-002,2011,12,1,4,14,29,43,51
0131-002,2011,12,1,5,20,33,53,43
0131-002,2011,12,1,6,46,60,106,53
0131-002,2011,12,1,7,182,124,306,106
0131-002,2011,12,1,8,600,464,1064,306
0131-002,2011,12,1,9,539,617,1156,1064
0131-002,2011,12,1,10,387,391,778,1156
0131-002,2011,12,1,11,394,379,773,778
0131-002,2011,12,1,12,347,385,732,773
0131-002,2011,12,1,13,344,340,684,732
0131-002,2011,12,1,14,359,406,765,684
0131-002,2011,12,1,15,398,459,857,765
0131-002,2011,12,1,16,439,402,841,857
0131-002,2011,12,1,17,412,409,821,841
0131-002,2011,12,1,18,380,469,849,821
0131-002,2011,12,1,19,411,500,911,849
0131-002,2011,12,1,20,320,363,683,911
0131-002,2011,12,1,21,255,284,539,683
0131-002,2011,12,1,22,225,227,452,539
0131-002,2011,12,1,23,145,163,308,452
0131-002,2011,12,1,24,101,103,204,308
0131-002,2011,12,2,1,67,77,144,204
0131-002,2011,12,2,2,37,50,87,144
0131-002,2011,12,2,3,30,39,69,87
0131-002,2011,12,2,4,19,32,51,69
0131-002,2011,12,2,5,19,33,52,51
0131-002,2011,12,2,6,51,61,112,52
0131-002,2011,12,2,7,192,145,337,112
0131-002,2011,12,2,8,565,446,1011,337
0131-002,2011,12,2,9,588,615,1203,1011
0131-002,2011,12,2,10,400,394,794,1203
0131-002,2011,12,2,11,393,416,809,794
0131-002,2011,12,2,12,376,424,800,809
0131-002,2011,12,2,13,299,355,654,800
0131-002,2011,12,2,14,335,405,740,654
0131-002,2011,12,2,15,415,442,857,740
0131-002,2011,12,2,16,440,467,907,857
0131-002,2011,12,2,17,412,454,866,907
0131-002,2011,12,2,18,501,526,1027,866
0131-002,2011,12,2,19,506,539,1045,1027
0131-002,2011,12,2,20,373,396,769,1045
0131-002,2011,12,2,21,291,352,643,769
0131-002,2011,12,2,22,209,259,468,643
0131-002,2011,12,2,23,158,198,356,468
0131-002,2011,12,2,24,120,106,226,356
0131-002,2011,12,3,1,65,84,149,226
0131-002,2011,12,3,2,34,52,86,149
0131-002,2011,12,3,3,55,39,94,86
0131-002,2011,12,3,4,19,31,50,94
0131-002,2011,12,3,5,25,38,63,50
0131-002,2011,12,3,6,46,44,90,63
0131-002,2011,12,3,7,105,81,186,90
0131-002,2011,12,3,8,304,236,540,186
0131-002,2011,12,3,9,413,390,803,540
0131-002,2011,12,3,10,371,359,730,803
0131-002,2011,12,3,11,377,532,909,730
0131-002,2011,12,3,12,408,587,995,909
0131-002,2011,12,3,13,355,551,906,995
0131-002,2011,12,3,14,385,556,941,906
0131-002,2011,12,3,15,423,536,959,941
0131-002,2011,12,3,16,459,629,1088,959
0131-002,2011,12,3,17,497,667,1164,1088
0131-002,2011,12,3,18,538,632,1170,1164
0131-002,2011,12,3,19,544,540,1084,1170
0131-002,2011,12,3,20,260,380,640,1084
0131-002,2011,12,3,21,238,228,466,640
0131-002,2011,12,3,22,200,178,378,466
0131-002,2011,12,3,23,131,148,279,378
0131-002,2011,12,3,24,107,99,206,279
0131-002,2011,12,4,1,72,81,153,206
0131-002,2011,12,4,2,47,44,91,153
0131-002,2011,12,4,3,32,38,70,91
0131-002,2011,12,4,4,29,25,54,70
0131-002,2011,12,4,5,28,23,51,54
0131-002,2011,12,4,6,37,36,73,51
0131-002,2011,12,4,7,48,58,106,73
0131-002,2011,12,4,8,125,114,239,106
0131-002,2011,12,4,9,174,174,348,239
0131-002,2011,12,4,10,183,227,410,348
0131-002,2011,12,4,11,221,261,482,410
0131-002,2011,12,4,12,194,263,457,482
0131-002,2011,12,4,13,337,287,624,457
0131-002,2011,12,4,14,363,273,636,624
0131-002,2011,12,4,15,438,281,719,636
0131-002,2011,12,4,16,521,336,857,719
0131-002,2011,12,4,17,581,310,891,857
0131-002,2011,12,4,18,616,340,956,891
0131-002,2011,12,4,19,487,247,734,956
0131-002,2011,12,4,20,330,243,573,734
0131-002,2011,12,4,21,238,198,436,573
0131-002,2011,12,4,22,187,168,355,436
0131-002,2011,12,4,23,122,114,236,355
0131-002,2011,12,4,24,87,78,165,236
0131-002,2011,12,5,1,39,59,98,165
0131-002,2011,12,5,2,18,31,49,98
0131-002,2011,12,5,3,15,18,33,49
0131-002,2011,12,5,4,18,29,47,33
0131-002,2011,12,5,5,14,40,54,47
0131-002,2011,12,5,6,53,68,121,54
0131-002,2011,12,5,7,203,163,366,121
0131-002,2011,12,5,8,660,492,1152,366
0131-002,2011,12,5,9,555,614,1169,1152
0131-002,2011,12,5,10,385,404,789,1169
0131-002,2011,12,5,11,406,403,809,789
0131-002,2011,12,5,12,410,393,803,809
0131-002,2011,12,5,13,294,363,657,803
0131-002,2011,12,5,14,376,395,771,657
0131-002,2011,12,5,15,407,456,863,771
0131-002,2011,12,5,16,406,447,853,863
0131-002,2011,12,5,17,467,433,900,853
0131-002,2011,12,5,18,425,513,938,900
0131-002,2011,12,5,19,428,449,877,938
0131-002,2011,12,5,20,305,378,683,877
0131-002,2011,12,5,21,265,343,608,683
0131-002,2011,12,5,22,202,257,459,608
0131-002,2011,12,5,23,155,143,298,459
0131-002,2011,12,5,24,86,123,209,298
0131-002,2011,12,6,1,72,48,120,209
0131-002,2011,12,6,2,29,40,69,120
0131-002,2011,12,6,3,38,31,69,69
0131-002,2011,12,6,4,19,26,45,69
0131-002,2011,12,6,5,19,31,50,45
0131-002,2011,12,6,6,42,61,103,50
0131-002,2011,12,6,7,186,154,340,103
0131-002,2011,12,6,8,605,466,1071,340
0131-002,2011,12,6,9,532,622,1154,1071
0131-002,2011,12,6,10,406,417,823,1154
0131-002,2011,12,6,11,415,398,813,823
0131-002,2011,12,6,12,382,401,783,813
0131-002,2011,12,6,13,288,354,642,783
0131-002,2011,12,6,14,388,407,795,642
0131-002,2011,12,6,15,452,482,934,795
0131-002,2011,12,6,16,441,450,891,934
0131-002,2011,12,6,17,418,416,834,891
0131-002,2011,12,6,18,410,498,908,834
0131-002,2011,12,6,19,393,499,892,908
0131-002,2011,12,6,20,289,373,662,892
0131-002,2011,12,6,21,273,355,628,662
0131-002,2011,12,6,22,206,224,430,628
0131-002,2011,12,6,23,137,135,272,430
0131-002,2011,12,6,24,87,89,176,272
0131-002,2011,12,7,1,58,62,120,176
0131-002,2011,12,7,2,39,41,80,120
0131-002,2011,12,7,3,32,22,54,80
0131-002,2011,12,7,4,27,25,52,54
0131-002,2011,12,7,5,19,38,57,52
0131-002,2011,12,7,6,37,55,92,57
0131-002,2011,12,7,7,183,124,307,92
0131-002,2011,12,7,8,627,482,1109,307
0131-002,2011,12,7,9,580,605,1185,1109
0131-002,2011,12,7,10,376,447,823,1185
0131-002,2011,12,7,11,418,415,833,823
0131-002,2011,12,7,12,376,385,761,833
0131-002,2011,12,7,13,290,378,668,761
0131-002,2011,12,7,14,393,417,810,668
0131-002,2011,12,7,15,430,416,846,810
0131-002,2011,12,7,16,454,442,896,846
0131-002,2011,12,7,17,417,429,846,896
0131-002,2011,12,7,18,474,497,971,846
0131-002,2011,12,7,19,449,505,954,971
0131-002,2011,12,7,20,299,325,624,954
0131-002,2011,12,7,21,255,305,560,624
0131-002,2011,12,7,22,207,252,459,560
0131-002,2011,12,7,23,140,159,299,459
0131-002,2011,12,7,24,94,110,204,299
0131-002,2011,12,8,1,50,46,96,204
0131-002,2011,12,8,2,34,48,82,96
0131-002,2011,12,8,3,37,41,78,82
0131-002,2011,12,8,4,19,32,51,78
0131-002,2011,12,8,5,23,48,71,51
0131-002,2011,12,8,6,49,67,116,71
0131-002,2011,12,8,7,193,123,316,116
0131-002,2011,12,8,8,577,497,1074,316
0131-002,2011,12,8,9,532,601,1133,1074
0131-002,2011,12,8,10,380,418,798,1133
0131-002,2011,12,8,11,359,421,780,798
0131-002,2011,12,8,12,346,379,725,780
0131-002,2011,12,8,13,297,363,660,725
0131-002,2011,12,8,14,385,387,772,660
0131-002,2011,12,8,15,421,410,831,772
0131-002,2011,12,8,16,393,409,802,831
0131-002,2011,12,8,17,428,444,872,802
0131-002,2011,12,8,18,455,484,939,872
0131-002,2011,12,8,19,378,458,836,939
0131-002,2011,12,8,20,309,357,666,836
0131-002,2011,12,8,21,254,341,595,666
0131-002,2011,12,8,22,228,212,440,595
0131-002,2011,12,8,23,146,153,299,440
0131-002,2011,12,8,24,98,98,196,299
0131-002,2011,12,9,1,70,72,142,196
0131-002,2011,12,9,2,38,33,71,142
0131-002,2011,12,9,3,17,34,51,71
0131-002,2011,12,9,4,19,28,47,51
0131-002,2011,12,9,5,27,40,67,47
0131-002,2011,12,9,6,50,55,105,67
0131-002,2011,12,9,7,175,129,304,105
0131-002,2011,12,9,8,567,453,1020,304
0131-002,2011,12,9,9,552,579,1131,1020
0131-002,2011,12,9,10,397,378,775,1131
0131-002,2011,12,9,11,385,438,823,775
0131-002,2011,12,9,12,356,436,792,823
0131-002,2011,12,9,13,306,336,642,792
0131-002,2011,12,9,14,405,403,808,642
0131-002,2011,12,9,15,411,430,841,808
0131-002,2011,12,9,16,447,478,925,841
0131-002,2011,12,9,17,439,427,866,925
0131-002,2011,12,9,18,478,524,1002,866
0131-002,2011,12,9,19,524,505,1029,1002
0131-002,2011,12,9,20,358,416,774,1029
0131-002,2011,12,9,21,293,339,632,774
0131-002,2011,12,9,22,268,294,562,632
0131-002,2011,12,9,23,196,181,377,562
0131-002,2011,12,9,24,115,125,240,377
0131-002,2011,12,10,1,87,89,176,240
0131-002,2011,12,10,2,47,52,99,176
0131-002,2011,12,10,3,42,51,93,99
0131-002,2011,12,10,4,25,31,56,93
0131-002,2011,12,10,5,31,40,71,56
0131-002,2011,12,10,6,45,48,93,71
0131-002,2011,12,10,7,106,96,202,93
0131-002,2011,12,10,8,262,244,506,202
0131-002,2011,12,10,9,356,320,676,506
0131-002,2011,12,10,10,331,325,656,676
0131-002,2011,12,10,11,382,407,789,656
0131-002,2011,12,10,12,417,448,865,789
0131-002,2011,12,10,13,318,508,826,865
0131-002,2011,12,10,14,387,485,872,826
0131-002,2011,12,10,15,382,515,897,872
0131-002,2011,12,10,16,449,511,960,897
0131-002,2011,12,10,17,551,569,1120,960
0131-002,2011,12,10,18,578,601,1179,1120
0131-002,2011,12,10,19,496,497,993,1179
0131-002,2011,12,10,20,312,267,579,993
0131-002,2011,12,10,21,219,239,458,579
0131-002,2011,12,10,22,166,157,323,458
0131-002,2011,12,10,23,120,134,254,323
0131-002,2011,12,10,24,92,93,185,254
0131-002,2011,12,11,1,62,75,137,185
0131-002,2011,12,11,2,38,39,77,137
0131-002,2011,12,11,3,27,32,59,77
0131-002,2011,12,11,4,21,22,43,59
0131-002,2011,12,11,5,15,15,30,43
0131-002,2011,12,11,6,26,22,48,30
0131-002,2011,12,11,7,43,58,101,48
0131-002,2011,12,11,8,105,82,187,101
0131-002,2011,12,11,9,159,138,297,187
0131-002,2011,12,11,10,150,185,335,297
0131-002,2011,12,11,11,229,253,482,335
0131-002,2011,12,11,12,206,267,473,482
0131-002,2011,12,11,13,347,276,623,473
0131-002,2011,12,11,14,486,261,747,623
0131-002,2011,12,11,15,529,278,807,747
0131-002,2011,12,11,16,566,330,896,807
0131-002,2011,12,11,17,564,339,903,896
0131-002,2011,12,11,18,542,300,842,903
0131-002,2011,12,11,19,508,264,772,842
0131-002,2011,12,11,20,354,201,555,772
0131-002,2011,12,11,21,217,173,390,555
0131-002,2011,12,11,22,184,152,336,390
0131-002,2011,12,11,23,115,117,232,336
0131-002,2011,12,11,24,93,83,176,232
0131-002,2011,12,12,1,51,51,102,176
0131-002,2011,12,12,2,24,22,46,102
0131-002,2011,12,12,3,25,26,51,46
0131-002,2011,12,12,4,8,20,28,51
0131-002,2011,12,12,5,25,37,62,28
0131-002,2011,12,12,6,46,44,90,62
0131-002,2011,12,12,7,212,156,368,90
0131-002,2011,12,12,8,615,526,1141,368
0131-002,2011,12,12,9,564,620,1184,1141
0131-002,2011,12,12,10,400,409,809,1184
0131-002,2011,12,12,11,373,418,791,809
0131-002,2011,12,12,12,392,353,745,791
0131-002,2011,12,12,13,314,347,661,745
0131-002,2011,12,12,14,380,426,806,661
0131-002,2011,12,12,15,425,442,867,806
0131-002,2011,12,12,16,416,426,842,867
0131-002,2011,12,12,17,427,438,865,842
0131-002,2011,12,12,18,430,517,947,865
0131-002,2011,12,12,19,400,484,884,947
0131-002,2011,12,12,20,309,333,642,884
0131-002,2011,12,12,21,242,310,552,642
0131-002,2011,12,12,22,211,231,442,552
0131-002,2011,12,12,23,152,151,303,442
0131-002,2011,12,12,24,114,103,217,303
0131-002,2011,12,13,1,43,48,91,217
0131-002,2011,12,13,2,40,37,77,91
0131-002,2011,12,13,3,19,30,49,77
0131-002,2011,12,13,4,14,39,53,49
0131-002,2011,12,13,5,19,30,49,53
0131-002,2011,12,13,6,39,54,93,49
0131-002,2011,12,13,7,166,130,296,93
0131-002,2011,12,13,8,572,458,1030,296
0131-002,2011,12,13,9,539,588,1127,1030
0131-002,2011,12,13,10,391,428,819,1127
0131-002,2011,12,13,11,422,386,808,819
0131-002,2011,12,13,12,374,415,789,808
0131-002,2011,12,13,13,322,375,697,789
0131-002,2011,12,13,14,370,377,747,697
0131-002,2011,12,13,15,445,445,890,747
0131-002,2011,12,13,16,456,428,884,890
0131-002,2011,12,13,17,431,435,866,884
0131-002,2011,12,13,18,472,500,972,866
0131-002,2011,12,13,19,412,467,879,972
0131-002,2011,12,13,20,285,315,600,879
0131-002,2011,12,13,21,267,307,574,600
0131-002,2011,12,13,22,220,218,438,574
0131-002,2011,12,13,23,149,151,300,438
0131-002,2011,12,13,24,95,86,181,300
0131-002,2011,12,14,1,54,61,115,181
0131-002,2011,12,14,2,38,45,83,115
0131-002,2011,12,14,3,22,39,61,83
0131-002,2011,12,14,4,19,34,53,61
0131-002,2011,12,14,5,20,42,62,53
0131-002,2011,12,14,6,44,48,92,62
0131-002,2011,12,14,7,167,143,310,92
0131-002,2011,12,14,8,578,453,1031,310
0131-002,2011,12,14,9,549,617,1166,1031
0131-002,2011,12,14,10,385,446,831,1166
0131-002,2011,12,14,11,408,405,813,831
0131-002,2011,12,14,12,381,403,784,813
0131-002,2011,12,14,13,301,346,647,784
0131-002,2011,12,14,14,378,418,796,647
0131-002,2011,12,14,15,400,417,817,796
0131-002,2011,12,14,16,420,403,823,817
0131-002,2011,12,14,17,443,405,848,823
0131-002,2011,12,14,18,472,513,985,848
0131-002,2011,12,14,19,417,480,897,985
0131-002,2011,12,14,20,314,362,676,897
0131-002,2011,12,14,21,258,250,508,676
0131-002,2011,12,14,22,203,224,427,508
0131-002,2011,12,14,23,151,158,309,427
0131-002,2011,12,14,24,107,103,210,309
0131-002,2011,12,15,1,53,58,111,210
0131-002,2011,12,15,2,49,43,92,111
0131-002,2011,12,15,3,25,26,51,92
0131-002,2011,12,15,4,25,26,51,51
0131-002,2011,12,15,5,18,26,44,51
0131-002,2011,12,15,6,44,50,94,44
0131-002,2011,12,15,7,162,103,265,94
0131-002,2011,12,15,8,579,444,1023,265
0131-002,2011,12,15,9,575,575,1150,1023
0131-002,2011,12,15,10,411,423,834,1150
0131-002,2011,12,15,11,375,374,749,834
0131-002,2011,12,15,12,373,441,814,749
0131-002,2011,12,15,13,316,381,697,814
0131-002,2011,12,15,14,353,386,739,697
0131-002,2011,12,15,15,428,459,887,739
0131-002,2011,12,15,16,422,405,827,887
0131-002,2011,12,15,17,418,384,802,827
0131-002,2011,12,15,18,420,523,943,802
0131-002,2011,12,15,19,435,478,913,943
0131-002,2011,12,15,20,290,366,656,913
0131-002,2011,12,15,21,256,297,553,656
0131-002,2011,12,15,22,178,234,412,553
0131-002,2011,12,15,23,155,157,312,412
0131-002,2011,12,15,24,110,93,203,312
0131-002,2011,12,16,1,65,85,150,203
0131-002,2011,12,16,2,49,45,94,150
0131-002,2011,12,16,3,24,34,58,94
0131-002,2011,12,16,4,22,39,61,58
0131-002,2011,12,16,5,14,34,48,61
0131-002,2011,12,16,6,42,51,93,48
0131-002,2011,12,16,7,157,111,268,93
0131-002,2011,12,16,8,575,451,1026,268
0131-002,2011,12,16,9,532,578,1110,1026
0131-002,2011,12,16,10,377,423,800,1110
0131-002,2011,12,16,11,396,393,789,800
0131-002,2011,12,16,12,360,412,772,789
0131-002,2011,12,16,13,332,349,681,772
0131-002,2011,12,16,14,367,467,834,681
0131-002,2011,12,16,15,435,413,848,834
0131-002,2011,12,16,16,454,407,861,848
0131-002,2011,12,16,17,482,416,898,861
0131-002,2011,12,16,18,466,544,1010,898
0131-002,2011,12,16,19,500,524,1024,1010
0131-002,2011,12,16,20,335,363,698,1024
0131-002,2011,12,16,21,260,308,568,698
0131-002,2011,12,16,22,204,220,424,568
0131-002,2011,12,16,23,164,151,315,424
0131-002,2011,12,16,24,105,107,212,315
0131-002,2011,12,17,1,66,78,144,212
0131-002,2011,12,17,2,58,58,116,144
0131-002,2011,12,17,3,37,36,73,116
0131-002,2011,12,17,4,24,41,65,73
0131-002,2011,12,17,5,27,40,67,65
0131-002,2011,12,17,6,37,51,88,67
0131-002,2011,12,17,7,103,101,204,88
0131-002,2011,12,17,8,284,235,519,204
0131-002,2011,12,17,9,377,339,716,519
0131-002,2011,12,17,10,325,341,666,716
0131-002,2011,12,17,11,351,454,805,666
0131-002,2011,12,17,12,394,509,903,805
0131-002,2011,12,17,13,390,487,877,903
0131-002,2011,12,17,14,405,481,886,877
0131-002,2011,12,17,15,460,564,1024,886
0131-002,2011,12,17,16,600,570,1170,1024
0131-002,2011,12,17,17,657,554,1211,1170
0131-002,2011,12,17,18,719,662,1381,1211
0131-002,2011,12,17,19,568,506,1074,1381
0131-002,2011,12,17,20,413,355,768,1074
0131-002,2011,12,17,21,231,215,446,768
0131-002,2011,12,17,22,228,223,451,446
0131-002,2011,12,17,23,133,135,268,451
0131-002,2011,12,17,24,120,94,214,268
0131-002,2011,12,18,1,74,81,155,214
0131-002,2011,12,18,2,51,61,112,155
0131-002,2011,12,18,3,37,50,87,112
0131-002,2011,12,18,4,25,35,60,87
0131-002,2011,12,18,5,30,28,58,60
0131-002,2011,12,18,6,25,38,63,58
0131-002,2011,12,18,7,60,47,107,63
0131-002,2011,12,18,8,122,84,206,107
0131-002,2011,12,18,9,140,188,328,206
0131-002,2011,12,18,10,170,176,346,328
0131-002,2011,12,18,11,208,247,455,346
0131-002,2011,12,18,12,247,261,508,455
0131-002,2011,12,18,13,295,298,593,508
0131-002,2011,12,18,14,354,256,610,593
0131-002,2011,12,18,15,440,257,697,610
0131-002,2011,12,18,16,506,331,837,697
0131-002,2011,12,18,17,525,327,852,837
0131-002,2011,12,18,18,553,323,876,852
0131-002,2011,12,18,19,491,276,767,876
0131-002,2011,12,18,20,301,205,506,767
0131-002,2011,12,18,21,235,181,416,506
0131-002,2011,12,18,22,190,138,328,416
0131-002,2011,12,18,23,117,122,239,328
0131-002,2011,12,18,24,86,99,185,239
0131-002,2011,12,19,1,54,42,96,185
0131-002,2011,12,19,2,35,31,66,96
0131-002,2011,12,19,3,17,15,32,66
0131-002,2011,12,19,4,13,24,37,32
0131-002,2011,12,19,5,19,26,45,37
0131-002,2011,12,19,6,43,55,98,45
0131-002,2011,12,19,7,207,159,366,98
0131-002,2011,12,19,8,623,526,1149,366
0131-002,2011,12,19,9,569,605,1174,1149
0131-002,2011,12,19,10,372,402,774,1174
0131-002,2011,12,19,11,389,359,748,774
0131-002,2011,12,19,12,376,420,796,748
0131-002,2011,12,19,13,267,338,605,796
0131-002,2011,12,19,14,357,381,738,605
0131-002,2011,12,19,15,409,443,852,738
0131-002,2011,12,19,16,387,411,798,852
0131-002,2011,12,19,17,416,427,843,798
0131-002,2011,12,19,18,447,489,936,843
0131-002,2011,12,19,19,426,474,900,936
0131-002,2011,12,19,20,301,317,618,900
0131-002,2011,12,19,21,253,316,569,618
0131-002,2011,12,19,22,221,259,480,569
0131-002,2011,12,19,23,144,156,300,480
0131-002,2011,12,19,24,84,78,162,300
0131-002,2011,12,20,1,49,57,106,162
0131-002,2011,12,20,2,39,46,85,106
0131-002,2011,12,20,3,25,24,49,85
0131-002,2011,12,20,4,22,26,48,49
0131-002,2011,12,20,5,15,33,48,48
0131-002,2011,12,20,6,38,48,86,48
0131-002,2011,12,20,7,178,126,304,86
0131-002,2011,12,20,8,586,481,1067,304
0131-002,2011,12,20,9,559,585,1144,1067
0131-002,2011,12,20,10,416,397,813,1144
0131-002,2011,12,20,11,411,429,840,813
0131-002,2011,12,20,12,350,341,691,840
0131-002,2011,12,20,13,291,342,633,691
0131-002,2011,12,20,14,377,392,769,633
0131-002,2011,12,20,15,392,428,820,769
0131-002,2011,12,20,16,426,410,836,820
0131-002,2011,12,20,17,469,426,895,836
0131-002,2011,12,20,18,426,469,895,895
0131-002,2011,12,20,19,434,482,916,895
0131-002,2011,12,20,20,285,339,624,916
0131-002,2011,12,20,21,261,295,556,624
0131-002,2011,12,20,22,221,252,473,556
0131-002,2011,12,20,23,156,167,323,473
0131-002,2011,12,20,24,99,91,190,323
0131-002,2011,12,21,1,51,72,123,190
0131-002,2011,12,21,2,36,43,79,123
0131-002,2011,12,21,3,31,33,64,79
0131-002,2011,12,21,4,28,23,51,64
0131-002,2011,12,21,5,20,20,40,51
0131-002,2011,12,21,6,42,60,102,40
0131-002,2011,12,21,7,149,116,265,102
0131-002,2011,12,21,8,574,463,1037,265
0131-002,2011,12,21,9,535,589,1124,1037
0131-002,2011,12,21,10,436,425,861,1124
0131-002,2011,12,21,11,397,365,762,861
0131-002,2011,12,21,12,360,388,748,762
0131-002,2011,12,21,13,277,349,626,748
0131-002,2011,12,21,14,341,396,737,626
0131-002,2011,12,21,15,463,446,909,737
0131-002,2011,12,21,16,436,423,859,909
0131-002,2011,12,21,17,442,395,837,859
0131-002,2011,12,21,18,399,517,916,837
0131-002,2011,12,21,19,441,466,907,916
0131-002,2011,12,21,20,330,321,651,907
0131-002,2011,12,21,21,239,278,517,651
0131-002,2011,12,21,22,204,223,427,517
0131-002,2011,12,21,23,139,149,288,427
0131-002,2011,12,21,24,111,99,210,288
0131-002,2011,12,22,1,59,78,137,210
0131-002,2011,12,22,2,47,46,93,137
0131-002,2011,12,22,3,24,27,51,93
0131-002,2011,12,22,4,18,40,58,51
0131-002,2011,12,22,5,18,39,57,58
0131-002,2011,12,22,6,32,60,92,57
0131-002,2011,12,22,7,133,103,236,92
0131-002,2011,12,22,8,496,446,942,236
0131-002,2011,12,22,9,528,550,1078,942
0131-002,2011,12,22,10,362,368,730,1078
0131-002,2011,12,22,11,365,386,751,730
0131-002,2011,12,22,12,381,399,780,751
0131-002,2011,12,22,13,273,309,582,780
0131-002,2011,12,22,14,358,379,737,582
0131-002,2011,12,22,15,381,428,809,737
0131-002,2011,12,22,16,428,412,840,809
0131-002,2011,12,22,17,404,404,808,840
0131-002,2011,12,22,18,497,492,989,808
0131-002,2011,12,22,19,425,492,917,989
0131-002,2011,12,22,20,299,341,640,917
0131-002,2011,12,22,21,264,309,573,640
0131-002,2011,12,22,22,204,211,415,573
0131-002,2011,12,22,23,143,154,297,415
0131-002,2011,12,22,24,112,82,194,297
0131-002,2011,12,23,1,71,74,145,194
0131-002,2011,12,23,2,50,49,99,145
0131-002,2011,12,23,3,28,26,54,99
0131-002,2011,12,23,4,25,34,59,54
0131-002,2011,12,23,5,17,36,53,59
0131-002,2011,12,23,6,37,41,78,53
0131-002,2011,12,23,7,152,126,278,78
0131-002,2011,12,23,8,534,453,987,278
0131-002,2011,12,23,9,537,535,1072,987
0131-002,2011,12,23,10,384,394,778,1072
0131-002,2011,12,23,11,397,357,754,778
0131-002,2011,12,23,12,365,389,754,754
0131-002,2011,12,23,13,320,353,673,754
0131-002,2011,12,23,14,347,389,736,673
0131-002,2011,12,23,15,452,449,901,736
0131-002,2011,12,23,16,480,419,899,901
0131-002,2011,12,23,17,473,401,874,899
0131-002,2011,12,23,18,525,539,1064,874
0131-002,2011,12,23,19,499,566,1065,1064
0131-002,2011,12,23,20,419,420,839,1065
0131-002,2011,12,23,21,292,339,631,839
0131-002,2011,12,23,22,304,258,562,631
0131-002,2011,12,23,23,203,168,371,562
0131-002,2011,12,23,24,98,99,197,371
0131-002,2011,12,24,1,51,62,113,197
0131-002,2011,12,24,2,39,48,87,113
0131-002,2011,12,24,3,31,42,73,87
0131-002,2011,12,24,4,25,46,71,73
0131-002,2011,12,24,5,19,26,45,71
0131-002,2011,12,24,6,34,31,65,45
0131-002,2011,12,24,7,53,56,109,65
0131-002,2011,12,24,8,106,100,206,109
0131-002,2011,12,24,9,155,153,308,206
0131-002,2011,12,24,10,170,147,317,308
0131-002,2011,12,24,11,178,150,328,317
0131-002,2011,12,24,12,221,259,480,328
0131-002,2011,12,24,13,219,352,571,480
0131-002,2011,12,24,14,305,356,661,571
0131-002,2011,12,24,15,305,373,678,661
0131-002,2011,12,24,16,324,355,679,678
0131-002,2011,12,24,17,424,312,736,679
0131-002,2011,12,24,18,306,290,596,736
0131-002,2011,12,24,19,266,235,501,596
0131-002,2011,12,24,20,172,146,318,501
0131-002,2011,12,24,21,131,115,246,318
0131-002,2011,12,24,22,101,91,192,246
0131-002,2011,12,24,23,102,95,197,192
0131-002,2011,12,24,24,52,57,109,197
0131-002,2011,12,25,1,41,47,88,109
0131-002,2011,12,25,2,30,29,59,88
0131-002,2011,12,25,3,22,29,51,59
0131-002,2011,12,25,4,16,13,29,51
0131-002,2011,12,25,5,10,22,32,29
0131-002,2011,12,25,6,12,26,38,32
0131-002,2011,12,25,7,33,28,61,38
0131-002,2011,12,25,8,63,47,110,61
0131-002,2011,12,25,9,82,85,167,110
0131-002,2011,12,25,10,115,119,234,167
0131-002,2011,12,25,11,148,135,283,234
0131-002,2011,12,25,12,146,185,331,283
0131-002,2011,12,25,13,206,189,395,331
0131-002,2011,12,25,14,223,227,450,395
0131-002,2011,12,25,15,258,260,518,450
0131-002,2011,12,25,16,345,235,580,518
0131-002,2011,12,25,17,385,261,646,580
0131-002,2011,12,25,18,279,284,563,646
0131-002,2011,12,25,19,211,190,401,563
0131-002,2011,12,25,20,190,182,372,401
0131-002,2011,12,25,21,185,140,325,372
0131-002,2011,12,25,22,153,121,274,325
0131-002,2011,12,25,23,108,103,211,274
0131-002,2011,12,25,24,83,75,158,211
0131-002,2011,12,26,1,37,39,76,158
0131-002,2011,12,26,2,30,22,52,76
0131-002,2011,12,26,3,16,18,34,52
0131-002,2011,12,26,4,13,20,33,34
0131-002,2011,12,26,5,18,27,45,33
0131-002,2011,12,26,6,45,47,92,45
0131-002,2011,12,26,7,176,128,304,92
0131-002,2011,12,26,8,505,450,955,304
0131-002,2011,12,26,9,487,564,1051,955
0131-002,2011,12,26,10,348,359,707,1051
0131-002,2011,12,26,11,327,369,696,707
0131-002,2011,12,26,12,380,372,752,696
0131-002,2011,12,26,13,305,305,610,752
0131-002,2011,12,26,14,410,366,776,610
0131-002,2011,12,26,15,423,369,792,776
0131-002,2011,12,26,16,435,389,824,792
0131-002,2011,12,26,17,442,400,842,824
0131-002,2011,12,26,18,411,452,863,842
0131-002,2011,12,26,19,386,435,821,863
0131-002,2011,12,26,20,269,284,553,821
0131-002,2011,12,26,21,231,271,502,553
0131-002,2011,12,26,22,195,228,423,502
0131-002,2011,12,26,23,136,136,272,423
0131-002,2011,12,26,24,87,78,165,272
0131-002,2011,12,27,1,57,70,127,165
0131-002,2011,12,27,2,39,37,76,127
0131-002,2011,12,27,3,19,21,40,76
0131-002,2011,12,27,4,18,27,45,40
0131-002,2011,12,27,5,15,20,35,45
0131-002,2011,12,27,6,30,45,75,35
0131-002,2011,12,27,7,141,102,243,75
0131-002,2011,12,27,8,494,438,932,243
0131-002,2011,12,27,9,523,534,1057,932
0131-002,2011,12,27,10,396,412,808,1057
0131-002,2011,12,27,11,380,374,754,808
0131-002,2011,12,27,12,362,363,725,754
0131-002,2011,12,27,13,310,316,626,725
0131-002,2011,12,27,14,340,365,705,626
0131-002,2011,12,27,15,407,436,843,705
0131-002,2011,12,27,16,421,400,821,843
0131-002,2011,12,27,17,404,418,822,821
0131-002,2011,12,27,18,402,485,887,822
0131-002,2011,12,27,19,381,493,874,887
0131-002,2011,12,27,20,280,338,618,874
0131-002,2011,12,27,21,229,263,492,618
0131-002,2011,12,27,22,215,215,430,492
0131-002,2011,12,27,23,144,148,292,430
0131-002,2011,12,27,24,112,79,191,292
0131-002,2011,12,28,1,73,66,139,191
0131-002,2011,12,28,2,39,41,80,139
0131-002,2011,12,28,3,31,31,62,80
0131-002,2011,12,28,4,17,26,43,62
0131-002,2011,12,28,5,27,41,68,43
0131-002,2011,12,28,6,43,49,92,68
0131-002,2011,12,28,7,146,97,243,92
0131-002,2011,12,28,8,503,446,949,243
0131-002,2011,12,28,9,531,543,1074,949
0131-002,2011,12,28,10,328,389,717,1074
0131-002,2011,12,28,11,408,391,799,717
0131-002,2011,12,28,12,360,411,771,799
0131-002,2011,12,28,13,348,336,684,771
0131-002,2011,12,28,14,331,391,722,684
0131-002,2011,12,28,15,454,429,883,722
0131-002,2011,12,28,16,407,433,840,883
0131-002,2011,12,28,17,387,411,798,840
0131-002,2011,12,28,18,424,467,891,798
0131-002,2011,12,28,19,448,486,934,891
0131-002,2011,12,28,20,305,312,617,934
0131-002,2011,12,28,21,226,239,465,617
0131-002,2011,12,28,22,195,194,389,465
0131-002,2011,12,28,23,167,142,309,389
0131-002,2011,12,28,24,108,101,209,309
0131-002,2011,12,29,1,60,72,132,209
0131-002,2011,12,29,2,38,43,81,132
0131-002,2011,12,29,3,26,28,54,81
0131-002,2011,12,29,4,20,29,49,54
0131-002,2011,12,29,5,19,30,49,49
0131-002,2011,12,29,6,45,42,87,49
0131-002,2011,12,29,7,145,95,240,87
0131-002,2011,12,29,8,500,397,897,240
0131-002,2011,12,29,9,539,546,1085,897
0131-002,2011,12,29,10,374,396,770,1085
0131-002,2011,12,29,11,403,404,807,770
0131-002,2011,12,29,12,356,417,773,807
0131-002,2011,12,29,13,299,337,636,773
0131-002,2011,12,29,14,359,380,739,636
0131-002,2011,12,29,15,443,446,889,739
0131-002,2011,12,29,16,425,418,843,889
0131-002,2011,12,29,17,417,409,826,843
0131-002,2011,12,29,18,409,496,905,826
0131-002,2011,12,29,19,399,491,890,905
0131-002,2011,12,29,20,294,318,612,890
0131-002,2011,12,29,21,258,251,509,612
0131-002,2011,12,29,22,194,209,403,509
0131-002,2011,12,29,23,159,143,302,403
0131-002,2011,12,29,24,127,103,230,302
0131-002,2011,12,30,1,74,73,147,230
0131-002,2011,12,30,2,42,70,112,147
0131-002,2011,12,30,3,32,39,71,112
0131-002,2011,12,30,4,18,35,53,71
0131-002,2011,12,30,5,20,30,50,53
0131-002,2011,12,30,6,28,37,65,50
0131-002,2011,12,30,7,139,107,246,65
0131-002,2011,12,30,8,458,386,844,246
0131-002,2011,12,30,9,484,483,967,844
0131-002,2011,12,30,10,327,341,668,967
0131-002,2011,12,30,11,393,404,797,668
0131-002,2011,12,30,12,402,446,848,797
0131-002,2011,12,30,13,330,416,746,848
0131-002,2011,12,30,14,398,503,901,746
0131-002,2011,12,30,15,477,535,1012,901
0131-002,2011,12,30,16,452,574,1026,1012
0131-002,2011,12,30,17,538,551,1089,1026
0131-002,2011,12,30,18,483,699,1182,1089
0131-002,2011,12,30,19,451,550,1001,1182
0131-002,2011,12,30,20,343,394,737,1001
0131-002,2011,12,30,21,277,282,559,737
0131-002,2011,12,30,22,231,237,468,559
0131-002,2011,12,30,23,151,165,316,468
0131-002,2011,12,30,24,136,113,249,316
0131-002,2011,12,31,1,77,103,180,249
0131-002,2011,12,31,2,48,68,116,180
0131-002,2011,12,31,3,38,45,83,116
0131-002,2011,12,31,4,38,43,81,83
0131-002,2011,12,31,5,38,36,74,81
0131-002,2011,12,31,6,45,53,98,74
0131-002,2011,12,31,7,99,69,168,98
0131-002,2011,12,31,8,238,199,437,168
0131-002,2011,12,31,9,276,290,566,437
0131-002,2011,12,31,10,283,322,605,566
0131-002,2011,12,31,11,334,375,709,605
0131-002,2011,12,31,12,357,415,772,709
0131-002,2011,12,31,13,354,496,850,772
0131-002,2011,12,31,14,380,525,905,850
0131-002,2011,12,31,15,400,519,919,905
0131-002,2011,12,31,16,380,512,892,919
0131-002,2011,12,31,17,481,511,992,892
0131-002,2011,12,31,18,491,488,979,992
0131-002,2011,12,31,19,328,388,716,979
0131-002,2011,12,31,20,245,267,512,716
0131-002,2011,12,31,21,212,227,439,512
0131-002,2011,12,31,22,177,180,357,439
0131-002,2011,12,31,23,129,137,266,357
0131-002,2011,12,31,24,98,98,196,266
0131-002,2012,1,1,1,46,55,101,196
0131-002,2012,1,1,2,36,48,84,101
0131-002,2012,1,1,3,20,27,47,84
0131-002,2012,1,1,4,18,22,40,47
0131-002,2012,1,1,5,24,25,49,40
0131-002,2012,1,1,6,24,30,54,49
0131-002,2012,1,1,7,29,29,58,54
0131-002,2012,1,1,8,59,42,101,58
0131-002,2012,1,1,9,63,70,133,101
0131-002,2012,1,1,10,82,107,189,133
0131-002,2012,1,1,11,139,130,269,189
0131-002,2012,1,1,12,161,162,323,269
0131-002,2012,1,1,13,184,164,348,323
0131-002,2012,1,1,14,263,210,473,348
0131-002,2012,1,1,15,301,242,543,473
0131-002,2012,1,1,16,356,264,620,543
0131-002,2012,1,1,17,388,257,645,620
0131-002,2012,1,1,18,382,266,648,645
0131-002,2012,1,1,19,358,237,595,648
0131-002,2012,1,1,20,299,170,469,595
0131-002,2012,1,1,21,283,134,417,469
0131-002,2012,1,1,22,158,98,256,417
0131-002,2012,1,1,23,88,90,178,256
0131-002,2012,1,1,24,49,53,102,178
0131-002,2012,1,2,1,38,37,75,102
0131-002,2012,1,2,2,24,24,48,75
0131-002,2012,1,2,3,14,15,29,48
0131-002,2012,1,2,4,16,14,30,29
0131-002,2012,1,2,5,13,16,29,30
0131-002,2012,1,2,6,39,47,86,29
0131-002,2012,1,2,7,128,85,213,86
0131-002,2012,1,2,8,406,324,730,213
0131-002,2012,1,2,9,315,368,683,730
0131-002,2012,1,2,10,232,256,488,683
0131-002,2012,1,2,11,260,289,549,488
0131-002,2012,1,2,12,265,296,561,549
0131-002,2012,1,2,13,231,263,494,561
0131-002,2012,1,2,14,261,298,559,494
0131-002,2012,1,2,15,306,319,625,559
0131-002,2012,1,2,16,300,329,629,625
0131-002,2012,1,2,17,303,342,645,629
0131-002,2012,1,2,18,288,370,658,645
0131-002,2012,1,2,19,291,372,663,658
0131-002,2012,1,2,20,207,270,477,663
0131-002,2012,1,2,21,176,238,414,477
0131-002,2012,1,2,22,146,158,304,414
0131-002,2012,1,2,23,100,108,208,304
0131-002,2012,1,2,24,77,53,130,208
0131-002,2012,1,3,1,30,41,71,130
0131-002,2012,1,3,2,21,28,49,71
0131-002,2012,1,3,3,18,18,36,49
0131-002,2012,1,3,4,18,28,46,36
0131-002,2012,1,3,5,20,29,49,46
0131-002,2012,1,3,6,39,54,93,49
0131-002,2012,1,3,7,160,87,247,93
0131-002,2012,1,3,8,506,355,861,247
0131-002,2012,1,3,9,462,398,860,861
0131-002,2012,1,3,10,302,349,651,860
0131-002,2012,1,3,11,327,334,661,651
0131-002,2012,1,3,12,287,308,595,661
0131-002,2012,1,3,13,260,286,546,595
0131-002,2012,1,3,14,301,359,660,546
0131-002,2012,1,3,15,368,381,749,660
0131-002,2012,1,3,16,364,368,732,749
0131-002,2012,1,3,17,326,399,725,732
0131-002,2012,1,3,18,324,406,730,725
0131-002,2012,1,3,19,270,408,678,730
0131-002,2012,1,3,20,212,311,523,678
0131-002,2012,1,3,21,183,268,451,523
0131-002,2012,1,3,22,151,168,319,451
0131-002,2012,1,3,23,100,111,211,319
0131-002,2012,1,3,24,60,72,132,211
0131-002,2012,1,4,1,46,45,91,132
0131-002,2012,1,4,2,28,34,62,91
0131-002,2012,1,4,3,21,25,46,62
0131-002,2012,1,4,4,12,17,29,46
0131-002,2012,1,4,5,24,28,52,29
0131-002,2012,1,4,6,45,42,87,52
0131-002,2012,1,4,7,140,78,218,87
0131-002,2012,1,4,8,500,336,836,218
0131-002,2012,1,4,9,431,432,863,836
0131-002,2012,1,4,10,308,316,624,863
0131-002,2012,1,4,11,334,359,693,624
0131-002,2012,1,4,12,296,344,640,693
0131-002,2012,1,4,13,269,272,541,640
0131-002,2012,1,4,14,323,334,657,541
0131-002,2012,1,4,15,333,396,729,657
0131-002,2012,1,4,16,356,378,734,729
0131-002,2012,1,4,17,330,361,691,734
0131-002,2012,1,4,18,322,446,768,691
0131-002,2012,1,4,19,321,438,759,768
0131-002,2012,1,4,20,205,322,527,759
0131-002,2012,1,4,21,192,251,443,527
0131-002,2012,1,4,22,154,181,335,443
0131-002,2012,1,4,23,108,118,226,335
0131-002,2012,1,4,24,90,70,160,226
0131-002,2012,1,5,1,47,59,106,160
0131-002,2012,1,5,2,36,34,70,106
0131-002,2012,1,5,3,24,26,50,70
0131-002,2012,1,5,4,17,30,47,50
0131-002,2012,1,5,5,28,34,62,47
0131-002,2012,1,5,6,45,42,87,62
0131-002,2012,1,5,7,157,90,247,87
0131-002,2012,1,5,8,525,334,859,247
0131-002,2012,1,5,9,466,436,902,859
0131-002,2012,1,5,10,298,351,649,902
0131-002,2012,1,5,11,322,344,666,649
0131-002,2012,1,5,12,322,328,650,666
0131-002,2012,1,5,13,263,309,572,650
0131-002,2012,1,5,14,316,356,672,572
0131-002,2012,1,5,15,367,396,763,672
0131-002,2012,1,5,16,360,367,727,763
0131-002,2012,1,5,17,320,377,697,727
0131-002,2012,1,5,18,325,433,758,697
0131-002,2012,1,5,19,346,445,791,758
0131-002,2012,1,5,20,234,321,555,791
0131-002,2012,1,5,21,186,274,460,555
0131-002,2012,1,5,22,170,196,366,460
0131-002,2012,1,5,23,125,148,273,366
0131-002,2012,1,5,24,90,80,170,273
0131-002,2012,1,6,1,50,65,115,170
0131-002,2012,1,6,2,33,45,78,115
0131-002,2012,1,6,3,26,26,52,78
0131-002,2012,1,6,4,17,26,43,52
0131-002,2012,1,6,5,25,36,61,43
0131-002,2012,1,6,6,49,38,87,61
0131-002,2012,1,6,7,142,85,227,87
0131-002,2012,1,6,8,512,357,869,227
0131-002,2012,1,6,9,512,431,943,869
0131-002,2012,1,6,10,334,379,713,943
0131-002,2012,1,6,11,327,369,696,713
0131-002,2012,1,6,12,316,346,662,696
0131-002,2012,1,6,13,297,312,609,662
0131-002,2012,1,6,14,352,374,726,609
0131-002,2012,1,6,15,395,402,797,726
0131-002,2012,1,6,16,373,406,779,797
0131-002,2012,1,6,17,400,415,815,779
0131-002,2012,1,6,18,379,484,863,815
0131-002,2012,1,6,19,400,490,890,863
0131-002,2012,1,6,20,292,360,652,890
0131-002,2012,1,6,21,245,312,557,652
0131-002,2012,1,6,22,175,220,395,557
0131-002,2012,1,6,23,133,139,272,395
0131-002,2012,1,6,24,89,100,189,272
0131-002,2012,1,7,1,58,69,127,189
0131-002,2012,1,7,2,44,46,90,127
0131-002,2012,1,7,3,28,32,60,90
0131-002,2012,1,7,4,18,28,46,60
0131-002,2012,1,7,5,21,36,57,46
0131-002,2012,1,7,6,51,46,97,57
0131-002,2012,1,7,7,107,76,183,97
0131-002,2012,1,7,8,279,194,473,183
0131-002,2012,1,7,9,321,276,597,473
0131-002,2012,1,7,10,308,318,626,597
0131-002,2012,1,7,11,273,342,615,626
0131-002,2012,1,7,12,307,379,686,615
0131-002,2012,1,7,13,260,404,664,686
0131-002,2012,1,7,14,317,356,673,664
0131-002,2012,1,7,15,309,445,754,673
0131-002,2012,1,7,16,342,460,802,754
0131-002,2012,1,7,17,359,454,813,802
0131-002,2012,1,7,18,372,463,835,813
0131-002,2012,1,7,19,336,414,750,835
0131-002,2012,1,7,20,220,299,519,750
0131-002,2012,1,7,21,186,172,358,519
0131-002,2012,1,7,22,139,146,285,358
0131-002,2012,1,7,23,111,107,218,285
0131-002,2012,1,7,24,74,74,148,218
0131-002,2012,1,8,1,45,58,103,148
0131-002,2012,1,8,2,40,36,76,103
0131-002,2012,1,8,3,24,30,54,76
0131-002,2012,1,8,4,21,23,44,54
0131-002,2012,1,8,5,20,20,40,44
0131-002,2012,1,8,6,24,27,51,40
0131-002,2012,1,8,7,49,46,95,51
0131-002,2012,1,8,8,114,76,190,95
0131-002,2012,1,8,9,122,135,257,190
0131-002,2012,1,8,10,153,154,307,257
0131-002,2012,1,8,11,172,196,368,307
0131-002,2012,1,8,12,171,198,369,368
0131-002,2012,1,8,13,184,222,406,369
0131-002,2012,1,8,14,211,232,443,406
0131-002,2012,1,8,15,234,252,486,443
0131-002,2012,1,8,16,319,247,566,486
0131-002,2012,1,8,17,358,256,614,566
0131-002,2012,1,8,18,357,263,620,614
0131-002,2012,1,8,19,301,219,520,620
0131-002,2012,1,8,20,184,152,336,520
0131-002,2012,1,8,21,162,148,310,336
0131-002,2012,1,8,22,155,162,317,310
0131-002,2012,1,8,23,95,91,186,317
0131-002,2012,1,8,24,65,64,129,186
0131-002,2012,1,9,1,36,42,78,129
0131-002,2012,1,9,2,25,25,50,78
0131-002,2012,1,9,3,17,20,37,50
0131-002,2012,1,9,4,18,25,43,37
0131-002,2012,1,9,5,24,24,48,43
0131-002,2012,1,9,6,52,52,104,48
0131-002,2012,1,9,7,199,126,325,104
0131-002,2012,1,9,8,556,403,959,325
0131-002,2012,1,9,9,543,436,979,959
0131-002,2012,1,9,10,352,373,725,979
0131-002,2012,1,9,11,355,356,711,725
0131-002,2012,1,9,12,343,393,736,711
0131-002,2012,1,9,13,278,339,617,736
0131-002,2012,1,9,14,319,378,697,617
0131-002,2012,1,9,15,365,383,748,697
0131-002,2012,1,9,16,366,392,758,748
0131-002,2012,1,9,17,392,417,809,758
0131-002,2012,1,9,18,347,425,772,809
0131-002,2012,1,9,19,334,419,753,772
0131-002,2012,1,9,20,269,353,622,753
0131-002,2012,1,9,21,207,305,512,622
0131-002,2012,1,9,22,162,213,375,512
0131-002,2012,1,9,23,99,132,231,375
0131-002,2012,1,9,24,79,82,161,231
0131-002,2012,1,10,1,52,47,99,161
0131-002,2012,1,10,2,34,35,69,99
0131-002,2012,1,10,3,20,19,39,69
0131-002,2012,1,10,4,14,24,38,39
0131-002,2012,1,10,5,24,36,60,38
0131-002,2012,1,10,6,46,45,91,60
0131-002,2012,1,10,7,164,96,260,91
0131-002,2012,1,10,8,542,358,900,260
0131-002,2012,1,10,9,541,428,969,900
0131-002,2012,1,10,10,333,379,712,969
0131-002,2012,1,10,11,369,367,736,712
0131-002,2012,1,10,12,322,388,710,736
0131-002,2012,1,10,13,271,324,595,710
0131-002,2012,1,10,14,337,379,716,595
0131-002,2012,1,10,15,380,419,799,716
0131-002,2012,1,10,16,356,366,722,799
0131-002,2012,1,10,17,310,402,712,722
0131-002,2012,1,10,18,338,436,774,712
0131-002,2012,1,10,19,321,419,740,774
0131-002,2012,1,10,20,271,313,584,740
0131-002,2012,1,10,21,220,322,542,584
0131-002,2012,1,10,22,175,211,386,542
0131-002,2012,1,10,23,130,147,277,386
0131-002,2012,1,10,24,96,85,181,277
0131-002,2012,1,11,1,58,64,122,181
0131-002,2012,1,11,2,35,38,73,122
0131-002,2012,1,11,3,25,32,57,73
0131-002,2012,1,11,4,20,25,45,57
0131-002,2012,1,11,5,22,35,57,45
0131-002,2012,1,11,6,45,42,87,57
0131-002,2012,1,11,7,164,100,264,87
0131-002,2012,1,11,8,521,353,874,264
0131-002,2012,1,11,9,499,436,935,874
0131-002,2012,1,11,10,333,338,671,935
0131-002,2012,1,11,11,347,344,691,671
0131-002,2012,1,11,12,322,373,695,691
0131-002,2012,1,11,13,299,334,633,695
0131-002,2012,1,11,14,308,360,668,633
0131-002,2012,1,11,15,365,413,778,668
0131-002,2012,1,11,16,388,412,800,778
0131-002,2012,1,11,17,344,371,715,800
0131-002,2012,1,11,18,352,443,795,715
0131-002,2012,1,11,19,324,429,753,795
0131-002,2012,1,11,20,280,318,598,753
0131-002,2012,1,11,21,210,284,494,598
0131-002,2012,1,11,22,190,212,402,494
0131-002,2012,1,11,23,113,135,248,402
0131-002,2012,1,11,24,83,91,174,248
0131-002,2012,1,12,1,52,64,116,174
0131-002,2012,1,12,2,34,35,69,116
0131-002,2012,1,12,3,19,25,44,69
0131-002,2012,1,12,4,18,28,46,44
0131-002,2012,1,12,5,26,33,59,46
0131-002,2012,1,12,6,47,49,96,59
0131-002,2012,1,12,7,173,100,273,96
0131-002,2012,1,12,8,516,373,889,273
0131-002,2012,1,12,9,516,448,964,889
0131-002,2012,1,12,10,378,366,744,964
0131-002,2012,1,12,11,367,375,742,744
0131-002,2012,1,12,12,324,373,697,742
0131-002,2012,1,12,13,288,310,598,697
0131-002,2012,1,12,14,330,398,728,598
0131-002,2012,1,12,15,372,406,778,728
0131-002,2012,1,12,16,386,414,800,778
0131-002,2012,1,12,17,341,413,754,800
0131-002,2012,1,12,18,352,441,793,754
0131-002,2012,1,12,19,320,424,744,793
0131-002,2012,1,12,20,248,316,564,744
0131-002,2012,1,12,21,202,282,484,564
0131-002,2012,1,12,22,179,208,387,484
0131-002,2012,1,12,23,146,133,279,387
0131-002,2012,1,12,24,83,98,181,279
0131-002,2012,1,13,1,58,70,128,181
0131-002,2012,1,13,2,35,40,75,128
0131-002,2012,1,13,3,33,30,63,75
0131-002,2012,1,13,4,13,30,43,63
0131-002,2012,1,13,5,22,41,63,43
0131-002,2012,1,13,6,47,38,85,63
0131-002,2012,1,13,7,172,89,261,85
0131-002,2012,1,13,8,532,356,888,261
0131-002,2012,1,13,9,534,478,1012,888
0131-002,2012,1,13,10,375,400,775,1012
0131-002,2012,1,13,11,414,389,803,775
0131-002,2012,1,13,12,357,379,736,803
0131-002,2012,1,13,13,301,366,667,736
0131-002,2012,1,13,14,360,417,777,667
0131-002,2012,1,13,15,406,443,849,777
0131-002,2012,1,13,16,373,426,799,849
0131-002,2012,1,13,17,382,413,795,799
0131-002,2012,1,13,18,413,481,894,795
0131-002,2012,1,13,19,408,476,884,894
0131-002,2012,1,13,20,356,366,722,884
0131-002,2012,1,13,21,234,334,568,722
0131-002,2012,1,13,22,185,216,401,568
0131-002,2012,1,13,23,162,140,302,401
0131-002,2012,1,13,24,89,88,177,302
0131-002,2012,1,14,1,58,74,132,177
0131-002,2012,1,14,2,34,49,83,132
0131-002,2012,1,14,3,28,41,69,83
0131-002,2012,1,14,4,25,37,62,69
0131-002,2012,1,14,5,24,43,67,62
0131-002,2012,1,14,6,52,50,102,67
0131-002,2012,1,14,7,114,89,203,102
0131-002,2012,1,14,8,288,198,486,203
0131-002,2012,1,14,9,334,310,644,486
0131-002,2012,1,14,10,315,331,646,644
0131-002,2012,1,14,11,314,375,689,646
0131-002,2012,1,14,12,332,419,751,689
0131-002,2012,1,14,13,293,393,686,751
0131-002,2012,1,14,14,341,422,763,686
0131-002,2012,1,14,15,353,402,755,763
0131-002,2012,1,14,16,320,389,709,755
0131-002,2012,1,14,17,372,409,781,709
0131-002,2012,1,14,18,395,415,810,781
0131-002,2012,1,14,19,390,344,734,810
0131-002,2012,1,14,20,243,243,486,734
0131-002,2012,1,14,21,208,185,393,486
0131-002,2012,1,14,22,158,157,315,393
0131-002,2012,1,14,23,114,108,222,315
0131-002,2012,1,14,24,98,82,180,222
0131-002,2012,1,15,1,59,59,118,180
0131-002,2012,1,15,2,38,36,74,118
0131-002,2012,1,15,3,22,30,52,74
0131-002,2012,1,15,4,18,28,46,52
0131-002,2012,1,15,5,23,26,49,46
0131-002,2012,1,15,6,30,27,57,49
0131-002,2012,1,15,7,64,59,123,57
0131-002,2012,1,15,8,143,103,246,123
0131-002,2012,1,15,9,142,171,313,246
0131-002,2012,1,15,10,163,180,343,313
0131-002,2012,1,15,11,198,234,432,343
0131-002,2012,1,15,12,201,228,429,432
0131-002,2012,1,15,13,194,219,413,429
0131-002,2012,1,15,14,252,251,503,413
0131-002,2012,1,15,15,230,273,503,503
0131-002,2012,1,15,16,303,290,593,503
0131-002,2012,1,15,17,302,281,583,593
0131-002,2012,1,15,18,292,288,580,583
0131-002,2012,1,15,19,277,218,495,580
0131-002,2012,1,15,20,166,174,340,495
0131-002,2012,1,15,21,163,168,331,340
0131-002,2012,1,15,22,147,127,274,331
0131-002,2012,1,15,23,106,123,229,274
0131-002,2012,1,15,24,82,68,150,229
0131-002,2012,1,16,1,35,49,84,150
0131-002,2012,1,16,2,30,28,58,84
0131-002,2012,1,16,3,11,17,28,58
0131-002,2012,1,16,4,17,19,36,28
0131-002,2012,1,16,5,22,35,57,36
0131-002,2012,1,16,6,60,54,114,57
0131-002,2012,1,16,7,202,130,332,114
0131-002,2012,1,16,8,619,422,1041,332
0131-002,2012,1,16,9,558,483,1041,1041
0131-002,2012,1,16,10,331,384,715,1041
0131-002,2012,1,16,11,356,388,744,715
0131-002,2012,1,16,12,396,408,804,744
0131-002,2012,1,16,13,284,338,622,804
0131-002,2012,1,16,14,352,380,732,622
0131-002,2012,1,16,15,391,435,826,732
0131-002,2012,1,16,16,385,388,773,826
0131-002,2012,1,16,17,395,381,776,773
0131-002,2012,1,16,18,342,476,818,776
0131-002,2012,1,16,19,378,437,815,818
0131-002,2012,1,16,20,257,350,607,815
0131-002,2012,1,16,21,228,336,564,607
0131-002,2012,1,16,22,190,227,417,564
0131-002,2012,1,16,23,130,152,282,417
0131-002,2012,1,16,24,80,87,167,282
0131-002,2012,1,17,1,57,54,111,167
0131-002,2012,1,17,2,26,35,61,111
0131-002,2012,1,17,3,24,30,54,61
0131-002,2012,1,17,4,18,33,51,54
0131-002,2012,1,17,5,29,35,64,51
0131-002,2012,1,17,6,52,47,99,64
0131-002,2012,1,17,7,171,109,280,99
0131-002,2012,1,17,8,559,367,926,280
0131-002,2012,1,17,9,539,471,1010,926
0131-002,2012,1,17,10,395,403,798,1010
0131-002,2012,1,17,11,388,367,755,798
0131-002,2012,1,17,12,352,363,715,755
0131-002,2012,1,17,13,286,335,621,715
0131-002,2012,1,17,14,360,367,727,621
0131-002,2012,1,17,15,388,450,838,727
0131-002,2012,1,17,16,414,438,852,838
0131-002,2012,1,17,17,389,447,836,852
0131-002,2012,1,17,18,368,465,833,836
0131-002,2012,1,17,19,356,464,820,833
0131-002,2012,1,17,20,252,374,626,820
0131-002,2012,1,17,21,223,313,536,626
0131-002,2012,1,17,22,188,234,422,536
0131-002,2012,1,17,23,128,155,283,422
0131-002,2012,1,17,24,108,89,197,283
0131-002,2012,1,18,1,54,64,118,197
0131-002,2012,1,18,2,36,38,74,118
0131-002,2012,1,18,3,22,29,51,74
0131-002,2012,1,18,4,25,30,55,51
0131-002,2012,1,18,5,34,39,73,55
0131-002,2012,1,18,6,52,46,98,73
0131-002,2012,1,18,7,178,94,272,98
0131-002,2012,1,18,8,557,357,914,272
0131-002,2012,1,18,9,549,487,1036,914
0131-002,2012,1,18,10,388,409,797,1036
0131-002,2012,1,18,11,388,397,785,797
0131-002,2012,1,18,12,351,393,744,785
0131-002,2012,1,18,13,286,367,653,744
0131-002,2012,1,18,14,366,396,762,653
0131-002,2012,1,18,15,400,425,825,762
0131-002,2012,1,18,16,405,422,827,825
0131-002,2012,1,18,17,409,447,856,827
0131-002,2012,1,18,18,382,496,878,856
0131-002,2012,1,18,19,338,495,833,878
0131-002,2012,1,18,20,299,379,678,833
0131-002,2012,1,18,21,255,303,558,678
0131-002,2012,1,18,22,172,237,409,558
0131-002,2012,1,18,23,154,155,309,409
0131-002,2012,1,18,24,105,90,195,309
0131-002,2012,1,19,1,40,65,105,195
0131-002,2012,1,19,2,49,43,92,105
0131-002,2012,1,19,3,26,31,57,92
0131-002,2012,1,19,4,24,37,61,57
0131-002,2012,1,19,5,30,36,66,61
0131-002,2012,1,19,6,52,49,101,66
0131-002,2012,1,19,7,163,94,257,101
0131-002,2012,1,19,8,531,344,875,257
0131-002,2012,1,19,9,543,453,996,875
0131-002,2012,1,19,10,379,422,801,996
0131-002,2012,1,19,11,412,408,820,801
0131-002,2012,1,19,12,351,398,749,820
0131-002,2012,1,19,13,331,326,657,749
0131-002,2012,1,19,14,359,409,768,657
0131-002,2012,1,19,15,398,441,839,768
0131-002,2012,1,19,16,416,447,863,839
0131-002,2012,1,19,17,367,408,775,863
0131-002,2012,1,19,18,356,461,817,775
0131-002,2012,1,19,19,376,460,836,817
0131-002,2012,1,19,20,265,370,635,836
0131-002,2012,1,19,21,244,316,560,635
0131-002,2012,1,19,22,200,230,430,560
0131-002,2012,1,19,23,148,143,291,430
0131-002,2012,1,19,24,97,100,197,291
0131-002,2012,1,20,1,56,82,138,197
0131-002,2012,1,20,2,44,47,91,138
0131-002,2012,1,20,3,31,33,64,91
0131-002,2012,1,20,4,36,38,74,64
0131-002,2012,1,20,5,31,44,75,74
0131-002,2012,1,20,6,48,48,96,75
0131-002,2012,1,20,7,172,86,258,96
0131-002,2012,1,20,8,552,342,894,258
0131-002,2012,1,20,9,545,485,1030,894
0131-002,2012,1,20,10,380,399,779,1030
0131-002,2012,1,20,11,382,417,799,779
0131-002,2012,1,20,12,366,411,777,799
0131-002,2012,1,20,13,319,367,686,777
0131-002,2012,1,20,14,366,431,797,686
0131-002,2012,1,20,15,388,561,949,797
0131-002,2012,1,20,16,371,613,984,949
0131-002,2012,1,20,17,391,665,1056,984
0131-002,2012,1,20,18,391,686,1077,1056
0131-002,2012,1,20,19,401,623,1024,1077
0131-002,2012,1,20,20,291,548,839,1024
0131-002,2012,1,20,21,205,503,708,839
0131-002,2012,1,20,22,169,401,570,708
0131-002,2012,1,20,23,132,220,352,570
0131-002,2012,1,20,24,89,132,221,352
0131-002,2012,1,21,1,52,87,139,221
0131-002,2012,1,21,2,36,55,91,139
0131-002,2012,1,21,3,36,46,82,91
0131-002,2012,1,21,4,33,47,80,82
0131-002,2012,1,21,5,34,45,79,80
0131-002,2012,1,21,6,49,89,138,79
0131-002,2012,1,21,7,72,227,299,138
0131-002,2012,1,21,8,152,412,564,299
0131-002,2012,1,21,9,220,609,829,564
0131-002,2012,1,21,10,230,616,846,829
0131-002,2012,1,21,11,225,532,757,846
0131-002,2012,1,21,12,230,591,821,757
0131-002,2012,1,21,13,218,618,836,821
0131-002,2012,1,21,14,218,600,818,836
0131-002,2012,1,21,15,231,592,823,818
0131-002,2012,1,21,16,231,579,810,823
0131-002,2012,1,21,17,226,496,722,810
0131-002,2012,1,21,18,207,489,696,722
0131-002,2012,1,21,19,187,382,569,696
0131-002,2012,1,21,20,130,228,358,569
0131-002,2012,1,21,21,100,150,250,358
0131-002,2012,1,21,22,105,120,225,250
0131-002,2012,1,21,23,77,84,161,225
0131-002,2012,1,21,24,58,80,138,161
0131-002,2012,1,22,1,51,59,110,138
0131-002,2012,1,22,2,24,49,73,110
0131-002,2012,1,22,3,21,36,57,73
0131-002,2012,1,22,4,17,30,47,57
0131-002,2012,1,22,5,20,31,51,47
0131-002,2012,1,22,6,17,51,68,51
0131-002,2012,1,22,7,32,85,117,68
0131-002,2012,1,22,8,51,139,190,117
0131-002,2012,1,22,9,97,292,389,190
0131-002,2012,1,22,10,155,306,461,389
0131-002,2012,1,22,11,193,316,509,461
0131-002,2012,1,22,12,187,326,513,509
0131-002,2012,1,22,13,184,323,507,513
0131-002,2012,1,22,14,192,278,470,507
0131-002,2012,1,22,15,180,251,431,470
0131-002,2012,1,22,16,188,262,450,431
0131-002,2012,1,22,17,153,234,387,450
0131-002,2012,1,22,18,162,220,382,387
0131-002,2012,1,22,19,136,172,308,382
0131-002,2012,1,22,20,97,100,197,308
0131-002,2012,1,22,21,93,125,218,197
0131-002,2012,1,22,22,82,74,156,218
0131-002,2012,1,22,23,55,66,121,156
0131-002,2012,1,22,24,39,52,91,121
0131-002,2012,1,23,1,28,38,66,91
0131-002,2012,1,23,2,24,25,49,66
0131-002,2012,1,23,3,13,16,29,49
0131-002,2012,1,23,4,14,18,32,29
0131-002,2012,1,23,5,12,10,22,32
0131-002,2012,1,23,6,22,24,46,22
0131-002,2012,1,23,7,69,46,115,46
0131-002,2012,1,23,8,123,107,230,115
0131-002,2012,1,23,9,139,125,264,230
0131-002,2012,1,23,10,105,156,261,264
0131-002,2012,1,23,11,307,289,596,261
0131-002,2012,1,23,12,538,447,985,596
0131-002,2012,1,23,13,499,584,1083,985
0131-002,2012,1,23,14,590,609,1199,1083
0131-002,2012,1,23,15,600,651,1251,1199
0131-002,2012,1,23,16,629,658,1287,1251
0131-002,2012,1,23,17,585,665,1250,1287
0131-002,2012,1,23,18,636,576,1212,1250
0131-002,2012,1,23,19,630,486,1116,1212
0131-002,2012,1,23,20,611,382,993,1116
0131-002,2012,1,23,21,594,261,855,993
0131-002,2012,1,23,22,499,143,642,855
0131-002,2012,1,23,23,600,113,713,642
0131-002,2012,1,23,24,441,63,504,713
0131-002,2012,1,24,1,429,48,477,504
0131-002,2012,1,24,2,397,38,435,477
0131-002,2012,1,24,3,204,20,224,435
0131-002,2012,1,24,4,98,17,115,224
0131-002,2012,1,24,5,52,12,64,115
0131-002,2012,1,24,6,37,13,50,64
0131-002,2012,1,24,7,38,13,51,50
0131-002,2012,1,24,8,80,34,114,51
0131-002,2012,1,24,9,187,72,259,114
0131-002,2012,1,24,10,257,82,339,259
0131-002,2012,1,24,11,433,145,578,339
0131-002,2012,1,24,12,449,220,669,578
0131-002,2012,1,24,13,555,209,764,669
0131-002,2012,1,24,14,637,308,945,764
0131-002,2012,1,24,15,648,401,1049,945
0131-002,2012,1,24,16,600,359,959,1049
0131-002,2012,1,24,17,564,314,878,959
0131-002,2012,1,24,18,512,255,767,878
0131-002,2012,1,24,19,588,195,783,767
0131-002,2012,1,24,20,568,153,721,783
0131-002,2012,1,24,21,488,162,650,721
0131-002,2012,1,24,22,378,128,506,650
0131-002,2012,1,24,23,464,88,552,506
0131-002,2012,1,24,24,379,55,434,552
0131-002,2012,1,25,1,190,38,228,434
0131-002,2012,1,25,2,64,24,88,228
0131-002,2012,1,25,3,19,18,37,88
0131-002,2012,1,25,4,15,13,28,37
0131-002,2012,1,25,5,11,17,28,28
0131-002,2012,1,25,6,37,26,63,28
0131-002,2012,1,25,7,85,60,145,63
0131-002,2012,1,25,8,354,245,599,145
0131-002,2012,1,25,9,308,324,632,599
0131-002,2012,1,25,10,222,226,448,632
0131-002,2012,1,25,11,230,271,501,448
0131-002,2012,1,25,12,249,274,523,501
0131-002,2012,1,25,13,366,240,606,523
0131-002,2012,1,25,14,393,284,677,606
0131-002,2012,1,25,15,431,286,717,677
0131-002,2012,1,25,16,494,289,783,717
0131-002,2012,1,25,17,456,266,722,783
0131-002,2012,1,25,18,513,337,850,722
0131-002,2012,1,25,19,478,358,836,850
0131-002,2012,1,25,20,441,236,677,836
0131-002,2012,1,25,21,276,218,494,677
0131-002,2012,1,25,22,180,151,331,494
0131-002,2012,1,25,23,108,107,215,331
0131-002,2012,1,25,24,78,69,147,215
0131-002,2012,1,26,1,49,45,94,147
0131-002,2012,1,26,2,30,36,66,94
0131-002,2012,1,26,3,18,21,39,66
0131-002,2012,1,26,4,15,22,37,39
0131-002,2012,1,26,5,27,24,51,37
0131-002,2012,1,26,6,64,44,108,51
0131-002,2012,1,26,7,162,100,262,108
0131-002,2012,1,26,8,532,375,907,262
0131-002,2012,1,26,9,532,423,955,907
0131-002,2012,1,26,10,366,371,737,955
0131-002,2012,1,26,11,344,382,726,737
0131-002,2012,1,26,12,379,351,730,726
0131-002,2012,1,26,13,307,338,645,730
0131-002,2012,1,26,14,353,396,749,645
0131-002,2012,1,26,15,391,430,821,749
0131-002,2012,1,26,16,352,389,741,821
0131-002,2012,1,26,17,350,406,756,741
0131-002,2012,1,26,18,344,406,750,756
0131-002,2012,1,26,19,316,424,740,750
0131-002,2012,1,26,20,252,352,604,740
0131-002,2012,1,26,21,188,288,476,604
0131-002,2012,1,26,22,172,234,406,476
0131-002,2012,1,26,23,111,126,237,406
0131-002,2012,1,26,24,98,82,180,237
0131-002,2012,1,27,1,50,46,96,180
0131-002,2012,1,27,2,30,36,66,96
0131-002,2012,1,27,3,23,24,47,66
0131-002,2012,1,27,4,19,29,48,47
0131-002,2012,1,27,5,25,31,56,48
0131-002,2012,1,27,6,53,46,99,56
0131-002,2012,1,27,7,169,98,267,99
0131-002,2012,1,27,8,527,328,855,267
0131-002,2012,1,27,9,535,450,985,855
0131-002,2012,1,27,10,351,346,697,985
0131-002,2012,1,27,11,363,363,726,697
0131-002,2012,1,27,12,359,403,762,726
0131-002,2012,1,27,13,287,359,646,762
0131-002,2012,1,27,14,335,372,707,646
0131-002,2012,1,27,15,389,414,803,707
0131-002,2012,1,27,16,367,385,752,803
0131-002,2012,1,27,17,356,382,738,752
0131-002,2012,1,27,18,360,472,832,738
0131-002,2012,1,27,19,399,463,862,832
0131-002,2012,1,27,20,296,367,663,862
0131-002,2012,1,27,21,237,312,549,663
0131-002,2012,1,27,22,187,236,423,549
0131-002,2012,1,27,23,144,141,285,423
0131-002,2012,1,27,24,88,93,181,285
0131-002,2012,1,28,1,58,60,118,181
0131-002,2012,1,28,2,46,39,85,118
0131-002,2012,1,28,3,33,44,77,85
0131-002,2012,1,28,4,32,33,65,77
0131-002,2012,1,28,5,18,43,61,65
0131-002,2012,1,28,6,59,53,112,61
0131-002,2012,1,28,7,118,88,206,112
0131-002,2012,1,28,8,301,190,491,206
0131-002,2012,1,28,9,342,299,641,491
0131-002,2012,1,28,10,344,321,665,641
0131-002,2012,1,28,11,322,387,709,665
0131-002,2012,1,28,12,303,359,662,709
0131-002,2012,1,28,13,273,356,629,662
0131-002,2012,1,28,14,292,384,676,629
0131-002,2012,1,28,15,327,369,696,676
0131-002,2012,1,28,16,317,310,627,696
0131-002,2012,1,28,17,343,376,719,627
0131-002,2012,1,28,18,365,386,751,719
0131-002,2012,1,28,19,330,340,670,751
0131-002,2012,1,28,20,221,184,405,670
0131-002,2012,1,28,21,162,162,324,405
0131-002,2012,1,28,22,126,152,278,324
0131-002,2012,1,28,23,116,111,227,278
0131-002,2012,1,28,24,80,69,149,227
0131-002,2012,1,29,1,45,60,105,149
0131-002,2012,1,29,2,26,36,62,105
0131-002,2012,1,29,3,29,27,56,62
0131-002,2012,1,29,4,18,20,38,56
0131-002,2012,1,29,5,18,19,37,38
0131-002,2012,1,29,6,24,37,61,37
0131-002,2012,1,29,7,66,48,114,61
0131-002,2012,1,29,8,111,82,193,114
0131-002,2012,1,29,9,130,143,273,193
0131-002,2012,1,29,10,150,187,337,273
0131-002,2012,1,29,11,200,198,398,337
0131-002,2012,1,29,12,187,196,383,398
0131-002,2012,1,29,13,201,225,426,383
0131-002,2012,1,29,14,210,259,469,426
0131-002,2012,1,29,15,241,244,485,469
0131-002,2012,1,29,16,266,259,525,485
0131-002,2012,1,29,17,299,269,568,525
0131-002,2012,1,29,18,306,263,569,568
0131-002,2012,1,29,19,252,233,485,569
0131-002,2012,1,29,20,174,178,352,485
0131-002,2012,1,29,21,129,167,296,352
0131-002,2012,1,29,22,146,118,264,296
0131-002,2012,1,29,23,99,101,200,264
0131-002,2012,1,29,24,72,56,128,200
0131-002,2012,1,30,1,42,45,87,128
0131-002,2012,1,30,2,27,34,61,87
0131-002,2012,1,30,3,19,18,37,61
0131-002,2012,1,30,4,23,24,47,37
0131-002,2012,1,30,5,18,36,54,47
0131-002,2012,1,30,6,49,49,98,54
0131-002,2012,1,30,7,213,122,335,98
0131-002,2012,1,30,8,635,402,1037,335
0131-002,2012,1,30,9,564,471,1035,1037
0131-002,2012,1,30,10,373,367,740,1035
0131-002,2012,1,30,11,396,421,817,740
0131-002,2012,1,30,12,373,400,773,817
0131-002,2012,1,30,13,285,349,634,773
0131-002,2012,1,30,14,373,398,771,634
0131-002,2012,1,30,15,379,440,819,771
0131-002,2012,1,30,16,381,417,798,819
0131-002,2012,1,30,17,378,417,795,798
0131-002,2012,1,30,18,357,477,834,795
0131-002,2012,1,30,19,344,445,789,834
0131-002,2012,1,30,20,265,371,636,789
0131-002,2012,1,30,21,227,307,534,636
0131-002,2012,1,30,22,184,219,403,534
0131-002,2012,1,30,23,130,161,291,403
0131-002,2012,1,30,24,81,92,173,291
0131-002,2012,1,31,1,73,53,126,173
0131-002,2012,1,31,2,30,39,69,126
0131-002,2012,1,31,3,28,28,56,69
0131-002,2012,1,31,4,19,36,55,56
0131-002,2012,1,31,5,28,28,56,55
0131-002,2012,1,31,6,54,45,99,56
0131-002,2012,1,31,7,170,93,263,99
0131-002,2012,1,31,8,556,366,922,263
0131-002,2012,1,31,9,532,428,960,922
0131-002,2012,1,31,10,385,401,786,960
0131-002,2012,1,31,11,370,399,769,786
0131-002,2012,1,31,12,359,402,761,769
0131-002,2012,1,31,13,320,328,648,761
0131-002,2012,1,31,14,352,388,740,648
0131-002,2012,1,31,15,396,439,835,740
0131-002,2012,1,31,16,394,388,782,835
0131-002,2012,1,31,17,307,411,718,782
0131-002,2012,1,31,18,263,438,701,718
0131-002,2012,1,31,19,307,368,675,701
0131-002,2012,1,31,20,187,252,439,675
0131-002,2012,1,31,21,140,200,340,439
0131-002,2012,1,31,22,102,128,230,340
0131-002,2012,1,31,23,68,83,151,230
0131-002,2012,1,31,24,54,52,106,151
0131-002,2012,2,1,1,50,29,79,106
0131-002,2012,2,1,2,20,23,43,79
0131-002,2012,2,1,3,18,18,36,43
0131-002,2012,2,1,4,12,18,30,36
0131-002,2012,2,1,5,12,19,31,30
0131-002,2012,2,1,6,36,31,67,31
0131-002,2012,2,1,7,116,65,181,67
0131-002,2012,2,1,8,391,235,626,181
0131-002,2012,2,1,9,382,356,738,626
0131-002,2012,2,1,10,267,270,537,738
0131-002,2012,2,1,11,309,297,606,537
0131-002,2012,2,1,12,273,324,597,606
0131-002,2012,2,1,13,234,282,516,597
0131-002,2012,2,1,14,303,317,620,516
0131-002,2012,2,1,15,334,384,718,620
0131-002,2012,2,1,16,335,357,692,718
0131-002,2012,2,1,17,338,350,688,692
0131-002,2012,2,1,18,307,432,739,688
0131-002,2012,2,1,19,316,430,746,739
0131-002,2012,2,1,20,234,335,569,746
0131-002,2012,2,1,21,202,250,452,569
0131-002,2012,2,1,22,166,186,352,452
0131-002,2012,2,1,23,106,141,247,352
0131-002,2012,2,1,24,71,84,155,247
0131-002,2012,2,2,1,46,58,104,155
0131-002,2012,2,2,2,33,29,62,104
0131-002,2012,2,2,3,25,25,50,62
0131-002,2012,2,2,4,19,22,41,50
0131-002,2012,2,2,5,22,31,53,41
0131-002,2012,2,2,6,37,36,73,53
0131-002,2012,2,2,7,148,76,224,73
0131-002,2012,2,2,8,539,342,881,224
0131-002,2012,2,2,9,533,483,1016,881
0131-002,2012,2,2,10,404,374,778,1016
0131-002,2012,2,2,11,351,384,735,778
0131-002,2012,2,2,12,342,351,693,735
0131-002,2012,2,2,13,276,332,608,693
0131-002,2012,2,2,14,346,395,741,608
0131-002,2012,2,2,15,388,408,796,741
0131-002,2012,2,2,16,406,408,814,796
0131-002,2012,2,2,17,378,414,792,814
0131-002,2012,2,2,18,349,479,828,792
0131-002,2012,2,2,19,329,442,771,828
0131-002,2012,2,2,20,269,363,632,771
0131-002,2012,2,2,21,235,308,543,632
0131-002,2012,2,2,22,166,234,400,543
0131-002,2012,2,2,23,131,150,281,400
0131-002,2012,2,2,24,88,96,184,281
0131-002,2012,2,3,1,51,62,113,184
0131-002,2012,2,3,2,30,33,63,113
0131-002,2012,2,3,3,23,28,51,63
0131-002,2012,2,3,4,16,27,43,51
0131-002,2012,2,3,5,23,25,48,43
0131-002,2012,2,3,6,45,46,91,48
0131-002,2012,2,3,7,162,101,263,91
0131-002,2012,2,3,8,597,334,931,263
0131-002,2012,2,3,9,554,472,1026,931
0131-002,2012,2,3,10,375,387,762,1026
0131-002,2012,2,3,11,405,415,820,762
0131-002,2012,2,3,12,401,429,830,820
0131-002,2012,2,3,13,361,355,716,830
0131-002,2012,2,3,14,371,425,796,716
0131-002,2012,2,3,15,385,447,832,796
0131-002,2012,2,3,16,382,461,843,832
0131-002,2012,2,3,17,401,454,855,843
0131-002,2012,2,3,18,399,552,951,855
0131-002,2012,2,3,19,414,564,978,951
0131-002,2012,2,3,20,344,384,728,978
0131-002,2012,2,3,21,245,362,607,728
0131-002,2012,2,3,22,206,242,448,607
0131-002,2012,2,3,23,152,161,313,448
0131-002,2012,2,3,24,100,98,198,313
0131-002,2012,2,4,1,63,68,131,198
0131-002,2012,2,4,2,45,47,92,131
0131-002,2012,2,4,3,35,32,67,92
0131-002,2012,2,4,4,18,40,58,67
0131-002,2012,2,4,5,18,36,54,58
0131-002,2012,2,4,6,63,58,121,54
0131-002,2012,2,4,7,115,72,187,121
0131-002,2012,2,4,8,290,198,488,187
0131-002,2012,2,4,9,352,335,687,488
0131-002,2012,2,4,10,344,355,699,687
0131-002,2012,2,4,11,360,365,725,699
0131-002,2012,2,4,12,359,387,746,725
0131-002,2012,2,4,13,324,382,706,746
0131-002,2012,2,4,14,350,435,785,706
0131-002,2012,2,4,15,360,432,792,785
0131-002,2012,2,4,16,371,417,788,792
0131-002,2012,2,4,17,442,401,843,788
0131-002,2012,2,4,18,462,418,880,843
0131-002,2012,2,4,19,404,379,783,880
0131-002,2012,2,4,20,262,249,511,783
0131-002,2012,2,4,21,211,198,409,511
0131-002,2012,2,4,22,151,166,317,409
0131-002,2012,2,4,23,119,107,226,317
0131-002,2012,2,4,24,76,79,155,226
0131-002,2012,2,5,1,54,71,125,155
0131-002,2012,2,5,2,33,46,79,125
0131-002,2012,2,5,3,23,29,52,79
0131-002,2012,2,5,4,26,30,56,52
0131-002,2012,2,5,5,20,26,46,56
0131-002,2012,2,5,6,32,20,52,46
0131-002,2012,2,5,7,51,44,95,52
0131-002,2012,2,5,8,102,70,172,95
0131-002,2012,2,5,9,128,155,283,172
0131-002,2012,2,5,10,153,188,341,283
0131-002,2012,2,5,11,182,222,404,341
0131-002,2012,2,5,12,193,238,431,404
0131-002,2012,2,5,13,215,265,480,431
0131-002,2012,2,5,14,260,276,536,480
0131-002,2012,2,5,15,252,272,524,536
0131-002,2012,2,5,16,298,306,604,524
0131-002,2012,2,5,17,311,281,592,604
0131-002,2012,2,5,18,288,298,586,592
0131-002,2012,2,5,19,273,226,499,586
0131-002,2012,2,5,20,213,213,426,499
0131-002,2012,2,5,21,155,182,337,426
0131-002,2012,2,5,22,162,142,304,337
0131-002,2012,2,5,23,117,98,215,304
0131-002,2012,2,5,24,76,81,157,215
0131-002,2012,2,6,1,47,42,89,157
0131-002,2012,2,6,2,31,32,63,89
0131-002,2012,2,6,3,14,15,29,63
0131-002,2012,2,6,4,20,18,38,29
0131-002,2012,2,6,5,24,30,54,38
0131-002,2012,2,6,6,50,47,97,54
0131-002,2012,2,6,7,230,128,358,97
0131-002,2012,2,6,8,669,422,1091,358
0131-002,2012,2,6,9,596,530,1126,1091
0131-002,2012,2,6,10,407,440,847,1126
0131-002,2012,2,6,11,364,416,780,847
0131-002,2012,2,6,12,352,409,761,780
0131-002,2012,2,6,13,320,330,650,761
0131-002,2012,2,6,14,353,414,767,650
0131-002,2012,2,6,15,421,424,845,767
0131-002,2012,2,6,16,409,406,815,845
0131-002,2012,2,6,17,368,449,817,815
0131-002,2012,2,6,18,374,485,859,817
0131-002,2012,2,6,19,375,457,832,859
0131-002,2012,2,6,20,294,397,691,832
0131-002,2012,2,6,21,211,345,556,691
0131-002,2012,2,6,22,191,241,432,556
0131-002,2012,2,6,23,140,152,292,432
0131-002,2012,2,6,24,90,90,180,292
0131-002,2012,2,7,1,47,63,110,180
0131-002,2012,2,7,2,40,42,82,110
0131-002,2012,2,7,3,18,29,47,82
0131-002,2012,2,7,4,23,29,52,47
0131-002,2012,2,7,5,32,30,62,52
0131-002,2012,2,7,6,53,48,101,62
0131-002,2012,2,7,7,180,105,285,101
0131-002,2012,2,7,8,614,396,1010,285
0131-002,2012,2,7,9,595,492,1087,1010
0131-002,2012,2,7,10,443,418,861,1087
0131-002,2012,2,7,11,428,415,843,861
0131-002,2012,2,7,12,396,431,827,843
0131-002,2012,2,7,13,329,353,682,827
0131-002,2012,2,7,14,361,372,733,682
0131-002,2012,2,7,15,392,456,848,733
0131-002,2012,2,7,16,414,459,873,848
0131-002,2012,2,7,17,383,396,779,873
0131-002,2012,2,7,18,359,494,853,779
0131-002,2012,2,7,19,374,498,872,853
0131-002,2012,2,7,20,260,383,643,872
0131-002,2012,2,7,21,236,344,580,643
0131-002,2012,2,7,22,168,226,394,580
0131-002,2012,2,7,23,119,148,267,394
0131-002,2012,2,7,24,98,95,193,267
0131-002,2012,2,8,1,62,59,121,193
0131-002,2012,2,8,2,26,44,70,121
0131-002,2012,2,8,3,29,33,62,70
0131-002,2012,2,8,4,18,25,43,62
0131-002,2012,2,8,5,26,36,62,43
0131-002,2012,2,8,6,53,43,96,62
0131-002,2012,2,8,7,143,99,242,96
0131-002,2012,2,8,8,555,378,933,242
0131-002,2012,2,8,9,470,519,989,933
0131-002,2012,2,8,10,397,396,793,989
0131-002,2012,2,8,11,392,396,788,793
0131-002,2012,2,8,12,374,407,781,788
0131-002,2012,2,8,13,296,343,639,781
0131-002,2012,2,8,14,350,391,741,639
0131-002,2012,2,8,15,411,461,872,741
0131-002,2012,2,8,16,404,452,856,872
0131-002,2012,2,8,17,382,438,820,856
0131-002,2012,2,8,18,350,520,870,820
0131-002,2012,2,8,19,383,511,894,870
0131-002,2012,2,8,20,288,370,658,894
0131-002,2012,2,8,21,215,322,537,658
0131-002,2012,2,8,22,152,208,360,537
0131-002,2012,2,8,23,124,121,245,360
0131-002,2012,2,8,24,79,80,159,245
0131-002,2012,2,9,1,39,45,84,159
0131-002,2012,2,9,2,31,36,67,84
0131-002,2012,2,9,3,18,28,46,67
0131-002,2012,2,9,4,12,23,35,46
0131-002,2012,2,9,5,22,26,48,35
0131-002,2012,2,9,6,56,38,94,48
0131-002,2012,2,9,7,144,75,219,94
0131-002,2012,2,9,8,523,309,832,219
0131-002,2012,2,9,9,526,455,981,832
0131-002,2012,2,9,10,385,364,749,981
0131-002,2012,2,9,11,389,425,814,749
0131-002,2012,2,9,12,404,409,813,814
0131-002,2012,2,9,13,295,355,650,813
0131-002,2012,2,9,14,389,380,769,650
0131-002,2012,2,9,15,404,429,833,769
0131-002,2012,2,9,16,429,458,887,833
0131-002,2012,2,9,17,406,442,848,887
0131-002,2012,2,9,18,329,504,833,848
0131-002,2012,2,9,19,396,497,893,833
0131-002,2012,2,9,20,278,342,620,893
0131-002,2012,2,9,21,249,330,579,620
0131-002,2012,2,9,22,172,244,416,579
0131-002,2012,2,9,23,135,152,287,416
0131-002,2012,2,9,24,102,89,191,287
0131-002,2012,2,10,1,45,52,97,191
0131-002,2012,2,10,2,42,53,95,97
0131-002,2012,2,10,3,24,32,56,95
0131-002,2012,2,10,4,24,28,52,56
0131-002,2012,2,10,5,25,31,56,52
0131-002,2012,2,10,6,54,48,102,56
0131-002,2012,2,10,7,191,105,296,102
0131-002,2012,2,10,8,611,377,988,296
0131-002,2012,2,10,9,605,522,1127,988
0131-002,2012,2,10,10,448,411,859,1127
0131-002,2012,2,10,11,414,454,868,859
0131-002,2012,2,10,12,360,430,790,868
0131-002,2012,2,10,13,350,399,749,790
0131-002,2012,2,10,14,372,433,805,749
0131-002,2012,2,10,15,414,453,867,805
0131-002,2012,2,10,16,400,450,850,867
0131-002,2012,2,10,17,418,479,897,850
0131-002,2012,2,10,18,432,564,996,897
0131-002,2012,2,10,19,424,602,1026,996
0131-002,2012,2,10,20,370,432,802,1026
0131-002,2012,2,10,21,273,378,651,802
0131-002,2012,2,10,22,218,250,468,651
0131-002,2012,2,10,23,141,167,308,468
0131-002,2012,2,10,24,118,108,226,308
0131-002,2012,2,11,1,73,82,155,226
0131-002,2012,2,11,2,44,67,111,155
0131-002,2012,2,11,3,30,46,76,111
0131-002,2012,2,11,4,36,45,81,76
0131-002,2012,2,11,5,36,51,87,81
0131-002,2012,2,11,6,62,59,121,87
0131-002,2012,2,11,7,112,80,192,121
0131-002,2012,2,11,8,305,202,507,192
0131-002,2012,2,11,9,387,321,708,507
0131-002,2012,2,11,10,314,353,667,708
0131-002,2012,2,11,11,328,455,783,667
0131-002,2012,2,11,12,352,468,820,783
0131-002,2012,2,11,13,432,524,956,820
0131-002,2012,2,11,14,413,504,917,956
0131-002,2012,2,11,15,396,515,911,917
0131-002,2012,2,11,16,425,451,876,911
0131-002,2012,2,11,17,492,515,1007,876
0131-002,2012,2,11,18,461,486,947,1007
0131-002,2012,2,11,19,485,504,989,947
0131-002,2012,2,11,20,288,288,576,989
0131-002,2012,2,11,21,198,225,423,576
0131-002,2012,2,11,22,174,197,371,423
0131-002,2012,2,11,23,121,138,259,371
0131-002,2012,2,11,24,89,91,180,259
0131-002,2012,2,12,1,61,64,125,180
0131-002,2012,2,12,2,35,52,87,125
0131-002,2012,2,12,3,29,29,58,87
0131-002,2012,2,12,4,26,27,53,58
0131-002,2012,2,12,5,33,24,57,53
0131-002,2012,2,12,6,21,33,54,57
0131-002,2012,2,12,7,46,59,105,54
0131-002,2012,2,12,8,128,90,218,105
0131-002,2012,2,12,9,144,160,304,218
0131-002,2012,2,12,10,162,194,356,304
0131-002,2012,2,12,11,193,249,442,356
0131-002,2012,2,12,12,207,241,448,442
0131-002,2012,2,12,13,209,303,512,448
0131-002,2012,2,12,14,262,280,542,512
0131-002,2012,2,12,15,310,254,564,542
0131-002,2012,2,12,16,334,316,650,564
0131-002,2012,2,12,17,400,333,733,650
0131-002,2012,2,12,18,411,342,753,733
0131-002,2012,2,12,19,319,278,597,753
0131-002,2012,2,12,20,234,192,426,597
0131-002,2012,2,12,21,198,183,381,426
0131-002,2012,2,12,22,189,137,326,381
0131-002,2012,2,12,23,112,99,211,326
0131-002,2012,2,12,24,80,70,150,211
0131-002,2012,2,13,1,46,45,91,150
0131-002,2012,2,13,2,25,28,53,91
0131-002,2012,2,13,3,11,23,34,53
0131-002,2012,2,13,4,14,21,35,34
0131-002,2012,2,13,5,30,29,59,35
0131-002,2012,2,13,6,56,69,125,59
0131-002,2012,2,13,7,223,137,360,125
0131-002,2012,2,13,8,697,438,1135,360
0131-002,2012,2,13,9,631,525,1156,1135
0131-002,2012,2,13,10,396,393,789,1156
0131-002,2012,2,13,11,429,476,905,789
0131-002,2012,2,13,12,377,404,781,905
0131-002,2012,2,13,13,339,371,710,781
0131-002,2012,2,13,14,391,393,784,710
0131-002,2012,2,13,15,424,479,903,784
0131-002,2012,2,13,16,437,476,913,903
0131-002,2012,2,13,17,396,442,838,913
0131-002,2012,2,13,18,380,526,906,838
0131-002,2012,2,13,19,392,509,901,906
0131-002,2012,2,13,20,294,424,718,901
0131-002,2012,2,13,21,257,365,622,718
0131-002,2012,2,13,22,222,252,474,622
0131-002,2012,2,13,23,142,150,292,474
0131-002,2012,2,13,24,79,88,167,292
0131-002,2012,2,14,1,51,54,105,167
0131-002,2012,2,14,2,44,44,88,105
0131-002,2012,2,14,3,22,30,52,88
0131-002,2012,2,14,4,18,36,54,52
0131-002,2012,2,14,5,36,42,78,54
0131-002,2012,2,14,6,64,51,115,78
0131-002,2012,2,14,7,185,118,303,115
0131-002,2012,2,14,8,653,411,1064,303
0131-002,2012,2,14,9,608,540,1148,1064
0131-002,2012,2,14,10,400,421,821,1148
0131-002,2012,2,14,11,439,435,874,821
0131-002,2012,2,14,12,409,378,787,874
0131-002,2012,2,14,13,332,344,676,787
0131-002,2012,2,14,14,375,409,784,676
0131-002,2012,2,14,15,384,501,885,784
0131-002,2012,2,14,16,425,471,896,885
0131-002,2012,2,14,17,396,438,834,896
0131-002,2012,2,14,18,360,540,900,834
0131-002,2012,2,14,19,357,532,889,900
0131-002,2012,2,14,20,319,422,741,889
0131-002,2012,2,14,21,258,367,625,741
0131-002,2012,2,14,22,206,231,437,625
0131-002,2012,2,14,23,153,170,323,437
0131-002,2012,2,14,24,99,124,223,323
0131-002,2012,2,15,1,69,64,133,223
0131-002,2012,2,15,2,36,42,78,133
0131-002,2012,2,15,3,26,29,55,78
0131-002,2012,2,15,4,18,33,51,55
0131-002,2012,2,15,5,31,40,71,51
0131-002,2012,2,15,6,62,53,115,71
0131-002,2012,2,15,7,217,106,323,115
0131-002,2012,2,15,8,640,389,1029,323
0131-002,2012,2,15,9,591,550,1141,1029
0131-002,2012,2,15,10,403,425,828,1141
0131-002,2012,2,15,11,415,418,833,828
0131-002,2012,2,15,12,358,425,783,833
0131-002,2012,2,15,13,316,357,673,783
0131-002,2012,2,15,14,400,426,826,673
0131-002,2012,2,15,15,412,483,895,826
0131-002,2012,2,15,16,396,467,863,895
0131-002,2012,2,15,17,412,475,887,863
0131-002,2012,2,15,18,370,555,925,887
0131-002,2012,2,15,19,393,559,952,925
0131-002,2012,2,15,20,294,378,672,952
0131-002,2012,2,15,21,204,328,532,672
0131-002,2012,2,15,22,178,243,421,532
0131-002,2012,2,15,23,133,152,285,421
0131-002,2012,2,15,24,90,100,190,285
0131-002,2012,2,16,1,56,63,119,190
0131-002,2012,2,16,2,43,49,92,119
0131-002,2012,2,16,3,31,36,67,92
0131-002,2012,2,16,4,18,36,54,67
0131-002,2012,2,16,5,24,36,60,54
0131-002,2012,2,16,6,57,51,108,60
0131-002,2012,2,16,7,204,124,328,108
0131-002,2012,2,16,8,647,396,1043,328
0131-002,2012,2,16,9,586,514,1100,1043
0131-002,2012,2,16,10,405,432,837,1100
0131-002,2012,2,16,11,434,424,858,837
0131-002,2012,2,16,12,388,443,831,858
0131-002,2012,2,16,13,310,373,683,831
0131-002,2012,2,16,14,402,430,832,683
0131-002,2012,2,16,15,422,488,910,832
0131-002,2012,2,16,16,442,460,902,910
0131-002,2012,2,16,17,431,425,856,902
0131-002,2012,2,16,18,418,537,955,856
0131-002,2012,2,16,19,406,501,907,955
0131-002,2012,2,16,20,298,382,680,907
0131-002,2012,2,16,21,249,378,627,680
0131-002,2012,2,16,22,229,262,491,627
0131-002,2012,2,16,23,152,150,302,491
0131-002,2012,2,16,24,82,96,178,302
0131-002,2012,2,17,1,56,67,123,178
0131-002,2012,2,17,2,40,38,78,123
0131-002,2012,2,17,3,32,36,68,78
0131-002,2012,2,17,4,24,35,59,68
0131-002,2012,2,17,5,21,42,63,59
0131-002,2012,2,17,6,63,52,115,63
0131-002,2012,2,17,7,188,121,309,115
0131-002,2012,2,17,8,660,407,1067,309
0131-002,2012,2,17,9,555,515,1070,1067
0131-002,2012,2,17,10,414,442,856,1070
0131-002,2012,2,17,11,408,453,861,856
0131-002,2012,2,17,12,400,432,832,861
0131-002,2012,2,17,13,360,394,754,832
0131-002,2012,2,17,14,412,422,834,754
0131-002,2012,2,17,15,453,499,952,834
0131-002,2012,2,17,16,447,460,907,952
0131-002,2012,2,17,17,407,465,872,907
0131-002,2012,2,17,18,463,586,1049,872
0131-002,2012,2,17,19,458,584,1042,1049
0131-002,2012,2,17,20,345,444,789,1042
0131-002,2012,2,17,21,231,371,602,789
0131-002,2012,2,17,22,240,262,502,602
0131-002,2012,2,17,23,152,160,312,502
0131-002,2012,2,17,24,103,91,194,312
0131-002,2012,2,18,1,52,76,128,194
0131-002,2012,2,18,2,48,53,101,128
0131-002,2012,2,18,3,29,37,66,101
0131-002,2012,2,18,4,23,40,63,66
0131-002,2012,2,18,5,27,47,74,63
0131-002,2012,2,18,6,58,51,109,74
0131-002,2012,2,18,7,118,97,215,109
0131-002,2012,2,18,8,250,223,473,215
0131-002,2012,2,18,9,323,328,651,473
0131-002,2012,2,18,10,334,383,717,651
0131-002,2012,2,18,11,334,404,738,717
0131-002,2012,2,18,12,371,500,871,738
0131-002,2012,2,18,13,355,555,910,871
0131-002,2012,2,18,14,396,583,979,910
0131-002,2012,2,18,15,416,573,989,979
0131-002,2012,2,18,16,443,522,965,989
0131-002,2012,2,18,17,516,563,1079,965
0131-002,2012,2,18,18,511,573,1084,1079
0131-002,2012,2,18,19,452,519,971,1084
0131-002,2012,2,18,20,358,308,666,971
0131-002,2012,2,18,21,233,238,471,666
0131-002,2012,2,18,22,184,167,351,471
0131-002,2012,2,18,23,139,123,262,351
0131-002,2012,2,18,24,74,82,156,262
0131-002,2012,2,19,1,37,64,101,156
0131-002,2012,2,19,2,41,43,84,101
0131-002,2012,2,19,3,26,40,66,84
0131-002,2012,2,19,4,28,23,51,66
0131-002,2012,2,19,5,27,26,53,51
0131-002,2012,2,19,6,33,28,61,53
0131-002,2012,2,19,7,62,54,116,61
0131-002,2012,2,19,8,87,94,181,116
0131-002,2012,2,19,9,155,156,311,181
0131-002,2012,2,19,10,172,197,369,311
0131-002,2012,2,19,11,208,216,424,369
0131-002,2012,2,19,12,234,293,527,424
0131-002,2012,2,19,13,237,264,501,527
0131-002,2012,2,19,14,259,272,531,501
0131-002,2012,2,19,15,304,285,589,531
0131-002,2012,2,19,16,432,308,740,589
0131-002,2012,2,19,17,428,303,731,740
0131-002,2012,2,19,18,422,308,730,731
0131-002,2012,2,19,19,408,274,682,730
0131-002,2012,2,19,20,277,197,474,682
0131-002,2012,2,19,21,181,184,365,474
0131-002,2012,2,19,22,177,173,350,365
0131-002,2012,2,19,23,119,103,222,350
0131-002,2012,2,19,24,92,78,170,222
0131-002,2012,2,20,1,54,45,99,170
0131-002,2012,2,20,2,33,29,62,99
0131-002,2012,2,20,3,18,20,38,62
0131-002,2012,2,20,4,24,29,53,38
0131-002,2012,2,20,5,20,35,55,53
0131-002,2012,2,20,6,54,46,100,55
0131-002,2012,2,20,7,209,146,355,100
0131-002,2012,2,20,8,600,458,1058,355
0131-002,2012,2,20,9,611,517,1128,1058
0131-002,2012,2,20,10,437,428,865,1128
0131-002,2012,2,20,11,422,436,858,865
0131-002,2012,2,20,12,422,418,840,858
0131-002,2012,2,20,13,342,378,720,840
0131-002,2012,2,20,14,366,400,766,720
0131-002,2012,2,20,15,404,463,867,766
0131-002,2012,2,20,16,435,461,896,867
0131-002,2012,2,20,17,418,484,902,896
0131-002,2012,2,20,18,371,513,884,902
0131-002,2012,2,20,19,410,527,937,884
0131-002,2012,2,20,20,310,409,719,937
0131-002,2012,2,20,21,269,331,600,719
0131-002,2012,2,20,22,200,271,471,600
0131-002,2012,2,20,23,135,156,291,471
0131-002,2012,2,20,24,86,87,173,291
0131-002,2012,2,21,1,51,58,109,173
0131-002,2012,2,21,2,34,46,80,109
0131-002,2012,2,21,3,22,30,52,80
0131-002,2012,2,21,4,21,27,48,52
0131-002,2012,2,21,5,29,33,62,48
0131-002,2012,2,21,6,54,53,107,62
0131-002,2012,2,21,7,209,119,328,107
0131-002,2012,2,21,8,644,393,1037,328
0131-002,2012,2,21,9,640,526,1166,1037
0131-002,2012,2,21,10,443,451,894,1166
0131-002,2012,2,21,11,436,456,892,894
0131-002,2012,2,21,12,396,405,801,892
0131-002,2012,2,21,13,337,371,708,801
0131-002,2012,2,21,14,406,375,781,708
0131-002,2012,2,21,15,432,480,912,781
0131-002,2012,2,21,16,419,455,874,912
0131-002,2012,2,21,17,421,478,899,874
0131-002,2012,2,21,18,404,517,921,899
0131-002,2012,2,21,19,373,497,870,921
0131-002,2012,2,21,20,312,397,709,870
0131-002,2012,2,21,21,242,362,604,709
0131-002,2012,2,21,22,201,263,464,604
0131-002,2012,2,21,23,153,158,311,464
0131-002,2012,2,21,24,89,100,189,311
0131-002,2012,2,22,1,54,66,120,189
0131-002,2012,2,22,2,37,45,82,120
0131-002,2012,2,22,3,20,22,42,82
0131-002,2012,2,22,4,18,27,45,42
0131-002,2012,2,22,5,31,40,71,45
0131-002,2012,2,22,6,58,44,102,71
0131-002,2012,2,22,7,196,116,312,102
0131-002,2012,2,22,8,675,434,1109,312
0131-002,2012,2,22,9,625,540,1165,1109
0131-002,2012,2,22,10,418,458,876,1165
0131-002,2012,2,22,11,458,432,890,876
0131-002,2012,2,22,12,405,419,824,890
0131-002,2012,2,22,13,327,342,669,824
0131-002,2012,2,22,14,393,420,813,669
0131-002,2012,2,22,15,436,458,894,813
0131-002,2012,2,22,16,431,490,921,894
0131-002,2012,2,22,17,393,469,862,921
0131-002,2012,2,22,18,404,581,985,862
0131-002,2012,2,22,19,397,546,943,985
0131-002,2012,2,22,20,302,422,724,943
0131-002,2012,2,22,21,233,323,556,724
0131-002,2012,2,22,22,200,242,442,556
0131-002,2012,2,22,23,136,159,295,442
0131-002,2012,2,22,24,87,78,165,295
0131-002,2012,2,23,1,67,60,127,165
0131-002,2012,2,23,2,35,47,82,127
0131-002,2012,2,23,3,33,30,63,82
0131-002,2012,2,23,4,24,39,63,63
0131-002,2012,2,23,5,35,43,78,63
0131-002,2012,2,23,6,63,56,119,78
0131-002,2012,2,23,7,208,90,298,119
0131-002,2012,2,23,8,632,382,1014,298
0131-002,2012,2,23,9,598,510,1108,1014
0131-002,2012,2,23,10,429,482,911,1108
0131-002,2012,2,23,11,458,468,926,911
0131-002,2012,2,23,12,403,442,845,926
0131-002,2012,2,23,13,387,360,747,845
0131-002,2012,2,23,14,386,441,827,747
0131-002,2012,2,23,15,434,479,913,827
0131-002,2012,2,23,16,419,488,907,913
0131-002,2012,2,23,17,422,459,881,907
0131-002,2012,2,23,18,399,520,919,881
0131-002,2012,2,23,19,375,509,884,919
0131-002,2012,2,23,20,306,397,703,884
0131-002,2012,2,23,21,232,350,582,703
0131-002,2012,2,23,22,184,263,447,582
0131-002,2012,2,23,23,140,165,305,447
0131-002,2012,2,23,24,94,106,200,305
0131-002,2012,2,24,1,66,64,130,200
0131-002,2012,2,24,2,44,44,88,130
0131-002,2012,2,24,3,29,32,61,88
0131-002,2012,2,24,4,26,39,65,61
0131-002,2012,2,24,5,34,46,80,65
0131-002,2012,2,24,6,59,47,106,80
0131-002,2012,2,24,7,221,119,340,106
0131-002,2012,2,24,8,658,387,1045,340
0131-002,2012,2,24,9,620,540,1160,1045
0131-002,2012,2,24,10,421,476,897,1160
0131-002,2012,2,24,11,422,454,876,897
0131-002,2012,2,24,12,429,446,875,876
0131-002,2012,2,24,13,343,374,717,875
0131-002,2012,2,24,14,396,440,836,717
0131-002,2012,2,24,15,440,518,958,836
0131-002,2012,2,24,16,432,467,899,958
0131-002,2012,2,24,17,423,455,878,899
0131-002,2012,2,24,18,472,591,1063,878
0131-002,2012,2,24,19,463,562,1025,1063
0131-002,2012,2,24,20,388,446,834,1025
0131-002,2012,2,24,21,257,386,643,834
0131-002,2012,2,24,22,231,254,485,643
0131-002,2012,2,24,23,167,175,342,485
0131-002,2012,2,24,24,103,128,231,342
0131-002,2012,2,25,1,71,80,151,231
0131-002,2012,2,25,2,51,60,111,151
0131-002,2012,2,25,3,40,40,80,111
0131-002,2012,2,25,4,28,53,81,80
0131-002,2012,2,25,5,33,51,84,81
0131-002,2012,2,25,6,72,46,118,84
0131-002,2012,2,25,7,147,89,236,118
0131-002,2012,2,25,8,333,236,569,236
0131-002,2012,2,25,9,387,346,733,569
0131-002,2012,2,25,10,352,397,749,733
0131-002,2012,2,25,11,373,462,835,749
0131-002,2012,2,25,12,411,538,949,835
0131-002,2012,2,25,13,388,587,975,949
0131-002,2012,2,25,14,365,590,955,975
0131-002,2012,2,25,15,412,567,979,955
0131-002,2012,2,25,16,378,502,880,979
0131-002,2012,2,25,17,456,566,1022,880
0131-002,2012,2,25,18,504,601,1105,1022
0131-002,2012,2,25,19,453,478,931,1105
0131-002,2012,2,25,20,337,361,698,931
0131-002,2012,2,25,21,226,259,485,698
0131-002,2012,2,25,22,188,186,374,485
0131-002,2012,2,25,23,126,137,263,374
0131-002,2012,2,25,24,84,105,189,263
0131-002,2012,2,26,1,54,72,126,189
0131-002,2012,2,26,2,34,46,80,126
0131-002,2012,2,26,3,28,36,64,80
0131-002,2012,2,26,4,28,31,59,64
0131-002,2012,2,26,5,17,19,36,59
0131-002,2012,2,26,6,37,31,68,36
0131-002,2012,2,26,7,84,51,135,68
0131-002,2012,2,26,8,114,102,216,135
0131-002,2012,2,26,9,151,155,306,216
0131-002,2012,2,26,10,179,208,387,306
0131-002,2012,2,26,11,188,254,442,387
0131-002,2012,2,26,12,231,215,446,442
0131-002,2012,2,26,13,236,270,506,446
0131-002,2012,2,26,14,270,266,536,506
0131-002,2012,2,26,15,288,317,605,536
0131-002,2012,2,26,16,435,304,739,605
0131-002,2012,2,26,17,486,328,814,739
0131-002,2012,2,26,18,511,337,848,814
0131-002,2012,2,26,19,504,316,820,848
0131-002,2012,2,26,20,332,226,558,820
0131-002,2012,2,26,21,217,216,433,558
0131-002,2012,2,26,22,177,148,325,433
0131-002,2012,2,26,23,121,116,237,325
0131-002,2012,2,26,24,97,86,183,237
0131-002,2012,2,27,1,46,54,100,183
0131-002,2012,2,27,2,33,32,65,100
0131-002,2012,2,27,3,25,27,52,65
0131-002,2012,2,27,4,22,21,43,52
0131-002,2012,2,27,5,31,36,67,43
0131-002,2012,2,27,6,63,73,136,67
0131-002,2012,2,27,7,267,144,411,136
0131-002,2012,2,27,8,677,488,1165,411
0131-002,2012,2,27,9,638,552,1190,1165
0131-002,2012,2,27,10,459,441,900,1190
0131-002,2012,2,27,11,466,473,939,900
0131-002,2012,2,27,12,384,424,808,939
0131-002,2012,2,27,13,368,383,751,808
0131-002,2012,2,27,14,436,422,858,751
0131-002,2012,2,27,15,414,512,926,858
0131-002,2012,2,27,16,458,486,944,926
0131-002,2012,2,27,17,443,480,923,944
0131-002,2012,2,27,18,425,545,970,923
0131-002,2012,2,27,19,400,512,912,970
0131-002,2012,2,27,20,278,425,703,912
0131-002,2012,2,27,21,246,400,646,703
0131-002,2012,2,27,22,217,257,474,646
0131-002,2012,2,27,23,141,178,319,474
0131-002,2012,2,27,24,88,108,196,319
0131-002,2012,2,28,1,51,62,113,196
0131-002,2012,2,28,2,36,45,81,113
0131-002,2012,2,28,3,28,29,57,81
0131-002,2012,2,28,4,27,33,60,57
0131-002,2012,2,28,5,37,47,84,60
0131-002,2012,2,28,6,69,60,129,84
0131-002,2012,2,28,7,220,116,336,129
0131-002,2012,2,28,8,680,426,1106,336
0131-002,2012,2,28,9,572,539,1111,1106
0131-002,2012,2,28,10,432,463,895,1111
0131-002,2012,2,28,11,463,476,939,895
0131-002,2012,2,28,12,442,458,900,939
0131-002,2012,2,28,13,327,394,721,900
0131-002,2012,2,28,14,383,458,841,721
0131-002,2012,2,28,15,465,517,982,841
0131-002,2012,2,28,16,465,480,945,982
0131-002,2012,2,28,17,451,478,929,945
0131-002,2012,2,28,18,388,543,931,929
0131-002,2012,2,28,19,374,517,891,931
0131-002,2012,2,28,20,305,420,725,891
0131-002,2012,2,28,21,251,360,611,725
0131-002,2012,2,28,22,210,277,487,611
0131-002,2012,2,28,23,155,169,324,487
0131-002,2012,2,28,24,90,104,194,324
0131-002,2012,2,29,1,65,72,137,194
0131-002,2012,2,29,2,40,54,94,137
0131-002,2012,2,29,3,26,32,58,94
0131-002,2012,2,29,4,22,38,60,58
0131-002,2012,2,29,5,34,51,85,60
0131-002,2012,2,29,6,53,54,107,85
0131-002,2012,2,29,7,231,112,343,107
0131-002,2012,2,29,8,678,412,1090,343
0131-002,2012,2,29,9,596,546,1142,1090
0131-002,2012,2,29,10,446,455,901,1142
0131-002,2012,2,29,11,447,471,918,901
0131-002,2012,2,29,12,422,427,849,918
0131-002,2012,2,29,13,347,386,733,849
0131-002,2012,2,29,14,414,404,818,733
0131-002,2012,2,29,15,435,506,941,818
0131-002,2012,2,29,16,436,497,933,941
0131-002,2012,2,29,17,433,468,901,933
0131-002,2012,2,29,18,464,602,1066,901
0131-002,2012,2,29,19,465,605,1070,1066
0131-002,2012,2,29,20,350,462,812,1070
0131-002,2012,2,29,21,278,386,664,812
0131-002,2012,2,29,22,215,292,507,664
0131-002,2012,2,29,23,173,173,346,507
0131-002,2012,2,29,24,99,104,203,346
0131-002,2012,3,1,1,83,120,203,203
0131-002,2012,3,1,2,52,49,101,203
0131-002,2012,3,1,3,39,52,91,101
0131-002,2012,3,1,4,28,42,70,91
0131-002,2012,3,1,5,31,39,70,70
0131-002,2012,3,1,6,64,52,116,70
0131-002,2012,3,1,7,143,99,242,116
0131-002,2012,3,1,8,418,250,668,242
0131-002,2012,3,1,9,378,316,694,668
0131-002,2012,3,1,10,343,334,677,694
0131-002,2012,3,1,11,374,426,800,677
0131-002,2012,3,1,12,349,641,990,800
0131-002,2012,3,1,13,339,534,873,990
0131-002,2012,3,1,14,342,503,845,873
0131-002,2012,3,1,15,362,519,881,845
0131-002,2012,3,1,16,442,505,947,881
0131-002,2012,3,1,17,477,512,989,947
0131-002,2012,3,1,18,572,638,1210,989
0131-002,2012,3,1,19,556,450,1006,1210
0131-002,2012,3,1,20,421,296,717,1006
0131-002,2012,3,1,21,285,266,551,717
0131-002,2012,3,1,22,221,178,399,551
0131-002,2012,3,1,23,135,133,268,399
0131-002,2012,3,1,24,86,88,174,268
0131-002,2012,3,2,1,56,58,114,174
0131-002,2012,3,2,2,31,37,68,114
0131-002,2012,3,2,3,25,22,47,68
0131-002,2012,3,2,4,22,26,48,47
0131-002,2012,3,2,5,31,38,69,48
0131-002,2012,3,2,6,56,52,108,69
0131-002,2012,3,2,7,208,114,322,108
0131-002,2012,3,2,8,613,427,1040,322
0131-002,2012,3,2,9,586,542,1128,1040
0131-002,2012,3,2,10,397,415,812,1128
0131-002,2012,3,2,11,437,418,855,812
0131-002,2012,3,2,12,429,452,881,855
0131-002,2012,3,2,13,369,379,748,881
0131-002,2012,3,2,14,377,418,795,748
0131-002,2012,3,2,15,438,465,903,795
0131-002,2012,3,2,16,424,474,898,903
0131-002,2012,3,2,17,447,454,901,898
0131-002,2012,3,2,18,448,541,989,901
0131-002,2012,3,2,19,478,544,1022,989
0131-002,2012,3,2,20,340,446,786,1022
0131-002,2012,3,2,21,264,341,605,786
0131-002,2012,3,2,22,224,294,518,605
0131-002,2012,3,2,23,167,199,366,518
0131-002,2012,3,2,24,101,126,227,366
0131-002,2012,3,3,1,78,90,168,227
0131-002,2012,3,3,2,47,59,106,168
0131-002,2012,3,3,3,52,40,92,106
0131-002,2012,3,3,4,36,46,82,92
0131-002,2012,3,3,5,28,40,68,82
0131-002,2012,3,3,6,85,47,132,68
0131-002,2012,3,3,7,166,106,272,132
0131-002,2012,3,3,8,368,246,614,272
0131-002,2012,3,3,9,376,367,743,614
0131-002,2012,3,3,10,394,378,772,743
0131-002,2012,3,3,11,410,448,858,772
0131-002,2012,3,3,12,336,533,869,858
0131-002,2012,3,3,13,313,526,839,869
0131-002,2012,3,3,14,339,485,824,839
0131-002,2012,3,3,15,369,516,885,824
0131-002,2012,3,3,16,390,492,882,885
0131-002,2012,3,3,17,464,498,962,882
0131-002,2012,3,3,18,551,575,1126,962
0131-002,2012,3,3,19,460,466,926,1126
0131-002,2012,3,3,20,268,282,550,926
0131-002,2012,3,3,21,229,224,453,550
0131-002,2012,3,3,22,168,165,333,453
0131-002,2012,3,3,23,112,127,239,333
0131-002,2012,3,3,24,89,100,189,239
0131-002,2012,3,4,1,43,58,101,189
0131-002,2012,3,4,2,28,42,70,101
0131-002,2012,3,4,3,31,33,64,70
0131-002,2012,3,4,4,30,30,60,64
0131-002,2012,3,4,5,22,28,50,60
0131-002,2012,3,4,6,34,30,64,50
0131-002,2012,3,4,7,59,64,123,64
0131-002,2012,3,4,8,140,114,254,123
0131-002,2012,3,4,9,169,170,339,254
0131-002,2012,3,4,10,180,203,383,339
0131-002,2012,3,4,11,240,260,500,383
0131-002,2012,3,4,12,262,264,526,500
0131-002,2012,3,4,13,229,326,555,526
0131-002,2012,3,4,14,271,274,545,555
0131-002,2012,3,4,15,322,329,651,545
0131-002,2012,3,4,16,468,335,803,651
0131-002,2012,3,4,17,504,311,815,803
0131-002,2012,3,4,18,498,330,828,815
0131-002,2012,3,4,19,506,288,794,828
0131-002,2012,3,4,20,470,220,690,794
0131-002,2012,3,4,21,241,196,437,690
0131-002,2012,3,4,22,201,144,345,437
0131-002,2012,3,4,23,130,113,243,345
0131-002,2012,3,4,24,93,88,181,243
0131-002,2012,3,5,1,48,48,96,181
0131-002,2012,3,5,2,35,32,67,96
0131-002,2012,3,5,3,22,17,39,67
0131-002,2012,3,5,4,17,25,42,39
0131-002,2012,3,5,5,34,34,68,42
0131-002,2012,3,5,6,70,51,121,68
0131-002,2012,3,5,7,274,148,422,121
0131-002,2012,3,5,8,740,476,1216,422
0131-002,2012,3,5,9,642,557,1199,1216
0131-002,2012,3,5,10,460,460,920,1199
0131-002,2012,3,5,11,411,480,891,920
0131-002,2012,3,5,12,429,414,843,891
0131-002,2012,3,5,13,338,372,710,843
0131-002,2012,3,5,14,381,398,779,710
0131-002,2012,3,5,15,437,501,938,779
0131-002,2012,3,5,16,436,437,873,938
0131-002,2012,3,5,17,391,422,813,873
0131-002,2012,3,5,18,396,516,912,813
0131-002,2012,3,5,19,353,536,889,912
0131-002,2012,3,5,20,326,420,746,889
0131-002,2012,3,5,21,253,355,608,746
0131-002,2012,3,5,22,202,274,476,608
0131-002,2012,3,5,23,156,167,323,476
0131-002,2012,3,5,24,82,94,176,323
0131-002,2012,3,6,1,60,57,117,176
0131-002,2012,3,6,2,39,36,75,117
0131-002,2012,3,6,3,29,33,62,75
0131-002,2012,3,6,4,22,26,48,62
0131-002,2012,3,6,5,33,41,74,48
0131-002,2012,3,6,6,58,39,97,74
0131-002,2012,3,6,7,194,100,294,97
0131-002,2012,3,6,8,660,398,1058,294
0131-002,2012,3,6,9,597,556,1153,1058
0131-002,2012,3,6,10,438,471,909,1153
0131-002,2012,3,6,11,419,430,849,909
0131-002,2012,3,6,12,407,429,836,849
0131-002,2012,3,6,13,341,369,710,836
0131-002,2012,3,6,14,398,450,848,710
0131-002,2012,3,6,15,443,461,904,848
0131-002,2012,3,6,16,426,508,934,904
0131-002,2012,3,6,17,403,426,829,934
0131-002,2012,3,6,18,394,526,920,829
0131-002,2012,3,6,19,360,551,911,920
0131-002,2012,3,6,20,316,440,756,911
0131-002,2012,3,6,21,208,353,561,756
0131-002,2012,3,6,22,208,312,520,561
0131-002,2012,3,6,23,144,155,299,520
0131-002,2012,3,6,24,102,108,210,299
0131-002,2012,3,7,1,80,66,146,210
0131-002,2012,3,7,2,41,48,89,146
0131-002,2012,3,7,3,34,30,64,89
0131-002,2012,3,7,4,30,34,64,64
0131-002,2012,3,7,5,36,40,76,64
0131-002,2012,3,7,6,76,50,126,76
0131-002,2012,3,7,7,265,129,394,126
0131-002,2012,3,7,8,698,451,1149,394
0131-002,2012,3,7,9,681,584,1265,1149
0131-002,2012,3,7,10,448,484,932,1265
0131-002,2012,3,7,11,424,445,869,932
0131-002,2012,3,7,12,381,454,835,869
0131-002,2012,3,7,13,350,386,736,835
0131-002,2012,3,7,14,421,438,859,736
0131-002,2012,3,7,15,443,502,945,859
0131-002,2012,3,7,16,438,498,936,945
0131-002,2012,3,7,17,396,482,878,936
0131-002,2012,3,7,18,409,573,982,878
0131-002,2012,3,7,19,410,618,1028,982
0131-002,2012,3,7,20,321,424,745,1028
0131-002,2012,3,7,21,251,373,624,745
0131-002,2012,3,7,22,193,268,461,624
0131-002,2012,3,7,23,138,180,318,461
0131-002,2012,3,7,24,93,101,194,318
0131-002,2012,3,8,1,76,73,149,194
0131-002,2012,3,8,2,40,42,82,149
0131-002,2012,3,8,3,24,40,64,82
0131-002,2012,3,8,4,27,37,64,64
0131-002,2012,3,8,5,32,50,82,64
0131-002,2012,3,8,6,58,60,118,82
0131-002,2012,3,8,7,222,122,344,118
0131-002,2012,3,8,8,608,468,1076,344
0131-002,2012,3,8,9,576,568,1144,1076
0131-002,2012,3,8,10,506,477,983,1144
0131-002,2012,3,8,11,477,459,936,983
0131-002,2012,3,8,12,448,438,886,936
0131-002,2012,3,8,13,360,405,765,886
0131-002,2012,3,8,14,415,472,887,765
0131-002,2012,3,8,15,491,483,974,887
0131-002,2012,3,8,16,453,482,935,974
0131-002,2012,3,8,17,447,484,931,935
0131-002,2012,3,8,18,435,578,1013,931
0131-002,2012,3,8,19,390,588,978,1013
0131-002,2012,3,8,20,301,438,739,978
0131-002,2012,3,8,21,250,401,651,739
0131-002,2012,3,8,22,206,288,494,651
0131-002,2012,3,8,23,153,160,313,494
0131-002,2012,3,8,24,89,109,198,313
0131-002,2012,3,9,1,73,72,145,198
0131-002,2012,3,9,2,34,51,85,145
0131-002,2012,3,9,3,34,30,64,85
0131-002,2012,3,9,4,20,32,52,64
0131-002,2012,3,9,5,36,51,87,52
0131-002,2012,3,9,6,58,54,112,87
0131-002,2012,3,9,7,230,141,371,112
0131-002,2012,3,9,8,700,462,1162,371
0131-002,2012,3,9,9,628,572,1200,1162
0131-002,2012,3,9,10,458,434,892,1200
0131-002,2012,3,9,11,418,498,916,892
0131-002,2012,3,9,12,420,470,890,916
0131-002,2012,3,9,13,348,435,783,890
0131-002,2012,3,9,14,400,438,838,783
0131-002,2012,3,9,15,460,473,933,838
0131-002,2012,3,9,16,452,495,947,933
0131-002,2012,3,9,17,456,540,996,947
0131-002,2012,3,9,18,462,640,1102,996
0131-002,2012,3,9,19,492,648,1140,1102
0131-002,2012,3,9,20,386,478,864,1140
0131-002,2012,3,9,21,268,403,671,864
0131-002,2012,3,9,22,247,312,559,671
0131-002,2012,3,9,23,174,197,371,559
0131-002,2012,3,9,24,126,114,240,371
0131-002,2012,3,10,1,92,90,182,240
0131-002,2012,3,10,2,52,60,112,182
0131-002,2012,3,10,3,29,53,82,112
0131-002,2012,3,10,4,29,39,68,82
0131-002,2012,3,10,5,36,52,88,68
0131-002,2012,3,10,6,87,70,157,88
0131-002,2012,3,10,7,154,117,271,157
0131-002,2012,3,10,8,378,276,654,271
0131-002,2012,3,10,9,440,396,836,654
0131-002,2012,3,10,10,388,438,826,836
0131-002,2012,3,10,11,404,465,869,826
0131-002,2012,3,10,12,398,511,909,869
0131-002,2012,3,10,13,405,613,1018,909
0131-002,2012,3,10,14,411,522,933,1018
0131-002,2012,3,10,15,433,576,1009,933
0131-002,2012,3,10,16,432,550,982,1009
0131-002,2012,3,10,17,518,541,1059,982
0131-002,2012,3,10,18,562,571,1133,1059
0131-002,2012,3,10,19,512,558,1070,1133
0131-002,2012,3,10,20,358,316,674,1070
0131-002,2012,3,10,21,220,246,466,674
0131-002,2012,3,10,22,186,206,392,466
0131-002,2012,3,10,23,138,142,280,392
0131-002,2012,3,10,24,101,100,201,280
0131-002,2012,3,11,1,78,89,167,201
0131-002,2012,3,11,2,40,46,86,167
0131-002,2012,3,11,3,27,40,67,86
0131-002,2012,3,11,4,24,28,52,67
0131-002,2012,3,11,5,22,29,51,52
0131-002,2012,3,11,6,42,37,79,51
0131-002,2012,3,11,7,102,55,157,79
0131-002,2012,3,11,8,167,138,305,157
0131-002,2012,3,11,9,192,190,382,305
0131-002,2012,3,11,10,222,230,452,382
0131-002,2012,3,11,11,246,269,515,452
0131-002,2012,3,11,12,270,281,551,515
0131-002,2012,3,11,13,288,304,592,551
0131-002,2012,3,11,14,282,324,606,592
0131-002,2012,3,11,15,348,336,684,606
0131-002,2012,3,11,16,501,336,837,684
0131-002,2012,3,11,17,488,351,839,837
0131-002,2012,3,11,18,504,360,864,839
0131-002,2012,3,11,19,453,278,731,864
0131-002,2012,3,11,20,249,232,481,731
0131-002,2012,3,11,21,208,228,436,481
0131-002,2012,3,11,22,179,172,351,436
0131-002,2012,3,11,23,126,106,232,351
0131-002,2012,3,11,24,95,82,177,232
0131-002,2012,3,12,1,49,53,102,177
0131-002,2012,3,12,2,30,31,61,102
0131-002,2012,3,12,3,23,20,43,61
0131-002,2012,3,12,4,17,27,44,43
0131-002,2012,3,12,5,21,34,55,44
0131-002,2012,3,12,6,63,48,111,55
0131-002,2012,3,12,7,287,160,447,111
0131-002,2012,3,12,8,774,502,1276,447
0131-002,2012,3,12,9,651,585,1236,1276
0131-002,2012,3,12,10,449,468,917,1236
0131-002,2012,3,12,11,461,454,915,917
0131-002,2012,3,12,12,427,439,866,915
0131-002,2012,3,12,13,394,399,793,866
0131-002,2012,3,12,14,426,428,854,793
0131-002,2012,3,12,15,465,533,998,854
0131-002,2012,3,12,16,453,462,915,998
0131-002,2012,3,12,17,433,498,931,915
0131-002,2012,3,12,18,467,556,1023,931
0131-002,2012,3,12,19,436,585,1021,1023
0131-002,2012,3,12,20,336,461,797,1021
0131-002,2012,3,12,21,262,396,658,797
0131-002,2012,3,12,22,236,335,571,658
0131-002,2012,3,12,23,172,178,350,571
0131-002,2012,3,12,24,96,94,190,350
0131-002,2012,3,13,1,73,76,149,190
0131-002,2012,3,13,2,40,40,80,149
0131-002,2012,3,13,3,36,36,72,80
0131-002,2012,3,13,4,34,27,61,72
0131-002,2012,3,13,5,34,48,82,61
0131-002,2012,3,13,6,72,52,124,82
0131-002,2012,3,13,7,230,124,354,124
0131-002,2012,3,13,8,742,462,1204,354
0131-002,2012,3,13,9,632,574,1206,1204
0131-002,2012,3,13,10,461,518,979,1206
0131-002,2012,3,13,11,472,445,917,979
0131-002,2012,3,13,12,432,451,883,917
0131-002,2012,3,13,13,352,376,728,883
0131-002,2012,3,13,14,414,449,863,728
0131-002,2012,3,13,15,458,520,978,863
0131-002,2012,3,13,16,474,539,1013,978
0131-002,2012,3,13,17,432,477,909,1013
0131-002,2012,3,13,18,484,589,1073,909
0131-002,2012,3,13,19,445,599,1044,1073
0131-002,2012,3,13,20,346,434,780,1044
0131-002,2012,3,13,21,255,408,663,780
0131-002,2012,3,13,22,247,298,545,663
0131-002,2012,3,13,23,149,178,327,545
0131-002,2012,3,13,24,100,99,199,327
0131-002,2012,3,14,1,80,70,150,199
0131-002,2012,3,14,2,39,37,76,150
0131-002,2012,3,14,3,26,34,60,76
0131-002,2012,3,14,4,24,30,54,60
0131-002,2012,3,14,5,32,46,78,54
0131-002,2012,3,14,6,76,54,130,78
0131-002,2012,3,14,7,252,136,388,130
0131-002,2012,3,14,8,745,472,1217,388
0131-002,2012,3,14,9,640,582,1222,1217
0131-002,2012,3,14,10,497,477,974,1222
0131-002,2012,3,14,11,526,483,1009,974
0131-002,2012,3,14,12,404,487,891,1009
0131-002,2012,3,14,13,358,452,810,891
0131-002,2012,3,14,14,437,457,894,810
0131-002,2012,3,14,15,496,496,992,894
0131-002,2012,3,14,16,474,516,990,992
0131-002,2012,3,14,17,420,480,900,990
0131-002,2012,3,14,18,448,619,1067,900
0131-002,2012,3,14,19,487,608,1095,1067
0131-002,2012,3,14,20,334,440,774,1095
0131-002,2012,3,14,21,262,363,625,774
0131-002,2012,3,14,22,226,233,459,625
0131-002,2012,3,14,23,163,178,341,459
0131-002,2012,3,14,24,125,118,243,341
0131-002,2012,3,15,1,79,82,161,243
0131-002,2012,3,15,2,37,40,77,161
0131-002,2012,3,15,3,23,34,57,77
0131-002,2012,3,15,4,21,30,51,57
0131-002,2012,3,15,5,38,51,89,51
0131-002,2012,3,15,6,59,60,119,89
0131-002,2012,3,15,7,251,122,373,119
0131-002,2012,3,15,8,773,454,1227,373
0131-002,2012,3,15,9,651,603,1254,1227
0131-002,2012,3,15,10,465,490,955,1254
0131-002,2012,3,15,11,462,506,968,955
0131-002,2012,3,15,12,431,441,872,968
0131-002,2012,3,15,13,355,399,754,872
0131-002,2012,3,15,14,408,464,872,754
0131-002,2012,3,15,15,474,522,996,872
0131-002,2012,3,15,16,486,504,990,996
0131-002,2012,3,15,17,434,506,940,990
0131-002,2012,3,15,18,472,607,1079,940
0131-002,2012,3,15,19,423,600,1023,1079
0131-002,2012,3,15,20,358,453,811,1023
0131-002,2012,3,15,21,257,421,678,811
0131-002,2012,3,15,22,249,290,539,678
0131-002,2012,3,15,23,174,173,347,539
0131-002,2012,3,15,24,134,114,248,347
0131-002,2012,3,16,1,74,72,146,248
0131-002,2012,3,16,2,44,47,91,146
0131-002,2012,3,16,3,34,32,66,91
0131-002,2012,3,16,4,34,27,61,66
0131-002,2012,3,16,5,34,47,81,61
0131-002,2012,3,16,6,74,60,134,81
0131-002,2012,3,16,7,246,124,370,134
0131-002,2012,3,16,8,692,463,1155,370
0131-002,2012,3,16,9,676,566,1242,1155
0131-002,2012,3,16,10,467,462,929,1242
0131-002,2012,3,16,11,478,468,946,929
0131-002,2012,3,16,12,409,473,882,946
0131-002,2012,3,16,13,374,414,788,882
0131-002,2012,3,16,14,457,437,894,788
0131-002,2012,3,16,15,478,540,1018,894
0131-002,2012,3,16,16,462,528,990,1018
0131-002,2012,3,16,17,432,504,936,990
0131-002,2012,3,16,18,480,611,1091,936
0131-002,2012,3,16,19,489,621,1110,1091
0131-002,2012,3,16,20,361,468,829,1110
0131-002,2012,3,16,21,293,388,681,829
0131-002,2012,3,16,22,206,298,504,681
0131-002,2012,3,16,23,153,192,345,504
0131-002,2012,3,16,24,130,112,242,345
0131-002,2012,3,17,1,78,87,165,242
0131-002,2012,3,17,2,48,61,109,165
0131-002,2012,3,17,3,36,43,79,109
0131-002,2012,3,17,4,32,37,69,79
0131-002,2012,3,17,5,34,48,82,69
0131-002,2012,3,17,6,68,53,121,82
0131-002,2012,3,17,7,119,90,209,121
0131-002,2012,3,17,8,336,255,591,209
0131-002,2012,3,17,9,417,388,805,591
0131-002,2012,3,17,10,396,413,809,805
0131-002,2012,3,17,11,372,530,902,809
0131-002,2012,3,17,12,400,612,1012,902
0131-002,2012,3,17,13,382,587,969,1012
0131-002,2012,3,17,14,378,528,906,969
0131-002,2012,3,17,15,435,443,878,906
0131-002,2012,3,17,16,407,461,868,878
0131-002,2012,3,17,17,408,481,889,868
0131-002,2012,3,17,18,442,484,926,889
0131-002,2012,3,17,19,381,450,831,926
0131-002,2012,3,17,20,240,297,537,831
0131-002,2012,3,17,21,225,257,482,537
0131-002,2012,3,17,22,174,188,362,482
0131-002,2012,3,17,23,142,127,269,362
0131-002,2012,3,17,24,98,90,188,269
0131-002,2012,3,18,1,72,71,143,188
0131-002,2012,3,18,2,47,51,98,143
0131-002,2012,3,18,3,30,34,64,98
0131-002,2012,3,18,4,34,40,74,64
0131-002,2012,3,18,5,19,33,52,74
0131-002,2012,3,18,6,38,30,68,52
0131-002,2012,3,18,7,88,63,151,68
0131-002,2012,3,18,8,168,138,306,151
0131-002,2012,3,18,9,186,208,394,306
0131-002,2012,3,18,10,214,229,443,394
0131-002,2012,3,18,11,241,285,526,443
0131-002,2012,3,18,12,251,257,508,526
0131-002,2012,3,18,13,273,262,535,508
0131-002,2012,3,18,14,282,283,565,535
0131-002,2012,3,18,15,336,324,660,565
0131-002,2012,3,18,16,451,342,793,660
0131-002,2012,3,18,17,492,332,824,793
0131-002,2012,3,18,18,474,351,825,824
0131-002,2012,3,18,19,494,267,761,825
0131-002,2012,3,18,20,316,238,554,761
0131-002,2012,3,18,21,246,246,492,554
0131-002,2012,3,18,22,172,171,343,492
0131-002,2012,3,18,23,139,117,256,343
0131-002,2012,3,18,24,90,76,166,256
0131-002,2012,3,19,1,60,57,117,166
0131-002,2012,3,19,2,31,29,60,117
0131-002,2012,3,19,3,33,18,51,60
0131-002,2012,3,19,4,18,25,43,51
0131-002,2012,3,19,5,28,41,69,43
0131-002,2012,3,19,6,76,57,133,69
0131-002,2012,3,19,7,288,175,463,133
0131-002,2012,3,19,8,767,540,1307,463
0131-002,2012,3,19,9,647,589,1236,1307
0131-002,2012,3,19,10,484,455,939,1236
0131-002,2012,3,19,11,456,484,940,939
0131-002,2012,3,19,12,386,462,848,940
0131-002,2012,3,19,13,362,376,738,848
0131-002,2012,3,19,14,430,448,878,738
0131-002,2012,3,19,15,472,519,991,878
0131-002,2012,3,19,16,488,509,997,991
0131-002,2012,3,19,17,451,516,967,997
0131-002,2012,3,19,18,436,568,1004,967
0131-002,2012,3,19,19,444,579,1023,1004
0131-002,2012,3,19,20,355,420,775,1023
0131-002,2012,3,19,21,268,385,653,775
0131-002,2012,3,19,22,246,300,546,653
0131-002,2012,3,19,23,173,192,365,546
0131-002,2012,3,19,24,108,115,223,365
0131-002,2012,3,20,1,72,65,137,223
0131-002,2012,3,20,2,34,39,73,137
0131-002,2012,3,20,3,32,35,67,73
0131-002,2012,3,20,4,24,22,46,67
0131-002,2012,3,20,5,33,52,85,46
0131-002,2012,3,20,6,72,54,126,85
0131-002,2012,3,20,7,262,143,405,126
0131-002,2012,3,20,8,768,464,1232,405
0131-002,2012,3,20,9,624,612,1236,1232
0131-002,2012,3,20,10,456,479,935,1236
0131-002,2012,3,20,11,506,473,979,935
0131-002,2012,3,20,12,442,421,863,979
0131-002,2012,3,20,13,349,386,735,863
0131-002,2012,3,20,14,432,451,883,735
0131-002,2012,3,20,15,474,523,997,883
0131-002,2012,3,20,16,463,518,981,997
0131-002,2012,3,20,17,452,510,962,981
0131-002,2012,3,20,18,457,588,1045,962
0131-002,2012,3,20,19,436,586,1022,1045
0131-002,2012,3,20,20,322,432,754,1022
0131-002,2012,3,20,21,253,410,663,754
0131-002,2012,3,20,22,241,296,537,663
0131-002,2012,3,20,23,162,177,339,537
0131-002,2012,3,20,24,118,120,238,339
0131-002,2012,3,21,1,69,71,140,238
0131-002,2012,3,21,2,37,39,76,140
0131-002,2012,3,21,3,29,39,68,76
0131-002,2012,3,21,4,21,31,52,68
0131-002,2012,3,21,5,36,46,82,52
0131-002,2012,3,21,6,74,59,133,82
0131-002,2012,3,21,7,256,138,394,133
0131-002,2012,3,21,8,735,460,1195,394
0131-002,2012,3,21,9,642,602,1244,1195
0131-002,2012,3,21,10,470,528,998,1244
0131-002,2012,3,21,11,484,456,940,998
0131-002,2012,3,21,12,422,393,815,940
0131-002,2012,3,21,13,388,408,796,815
0131-002,2012,3,21,14,429,424,853,796
0131-002,2012,3,21,15,482,496,978,853
0131-002,2012,3,21,16,465,538,1003,978
0131-002,2012,3,21,17,486,541,1027,1003
0131-002,2012,3,21,18,544,624,1168,1027
0131-002,2012,3,21,19,444,610,1054,1168
0131-002,2012,3,21,20,335,445,780,1054
0131-002,2012,3,21,21,268,405,673,780
0131-002,2012,3,21,22,235,275,510,673
0131-002,2012,3,21,23,190,168,358,510
0131-002,2012,3,21,24,107,122,229,358
0131-002,2012,3,22,1,78,77,155,229
0131-002,2012,3,22,2,47,46,93,155
0131-002,2012,3,22,3,18,34,52,93
0131-002,2012,3,22,4,33,39,72,52
0131-002,2012,3,22,5,30,41,71,72
0131-002,2012,3,22,6,72,57,129,71
0131-002,2012,3,22,7,264,136,400,129
0131-002,2012,3,22,8,732,452,1184,400
0131-002,2012,3,22,9,616,603,1219,1184
0131-002,2012,3,22,10,503,488,991,1219
0131-002,2012,3,22,11,470,466,936,991
0131-002,2012,3,22,12,419,454,873,936
0131-002,2012,3,22,13,351,385,736,873
0131-002,2012,3,22,14,444,466,910,736
0131-002,2012,3,22,15,526,490,1016,910
0131-002,2012,3,22,16,479,458,937,1016
0131-002,2012,3,22,17,418,496,914,937
0131-002,2012,3,22,18,402,578,980,914
0131-002,2012,3,22,19,436,580,1016,980
0131-002,2012,3,22,20,314,412,726,1016
0131-002,2012,3,22,21,240,390,630,726
0131-002,2012,3,22,22,236,320,556,630
0131-002,2012,3,22,23,187,183,370,556
0131-002,2012,3,22,24,117,114,231,370
0131-002,2012,3,23,1,78,74,152,231
0131-002,2012,3,23,2,49,50,99,152
0131-002,2012,3,23,3,36,30,66,99
0131-002,2012,3,23,4,25,34,59,66
0131-002,2012,3,23,5,38,42,80,59
0131-002,2012,3,23,6,68,63,131,80
0131-002,2012,3,23,7,196,112,308,131
0131-002,2012,3,23,8,685,408,1093,308
0131-002,2012,3,23,9,599,569,1168,1093
0131-002,2012,3,23,10,426,426,852,1168
0131-002,2012,3,23,11,461,460,921,852
0131-002,2012,3,23,12,414,502,916,921
0131-002,2012,3,23,13,358,404,762,916
0131-002,2012,3,23,14,411,430,841,762
0131-002,2012,3,23,15,408,488,896,841
0131-002,2012,3,23,16,452,454,906,896
0131-002,2012,3,23,17,414,529,943,906
0131-002,2012,3,23,18,469,554,1023,943
0131-002,2012,3,23,19,452,590,1042,1023
0131-002,2012,3,23,20,361,458,819,1042
0131-002,2012,3,23,21,253,400,653,819
0131-002,2012,3,23,22,243,312,555,653
0131-002,2012,3,23,23,160,181,341,555
0131-002,2012,3,23,24,112,120,232,341
0131-002,2012,3,24,1,87,81,168,232
0131-002,2012,3,24,2,55,58,113,168
0131-002,2012,3,24,3,36,34,70,113
0131-002,2012,3,24,4,40,40,80,70
0131-002,2012,3,24,5,42,46,88,80
0131-002,2012,3,24,6,71,58,129,88
0131-002,2012,3,24,7,142,102,244,129
0131-002,2012,3,24,8,335,247,582,244
0131-002,2012,3,24,9,426,378,804,582
0131-002,2012,3,24,10,402,417,819,804
0131-002,2012,3,24,11,366,597,963,819
0131-002,2012,3,24,12,451,658,1109,963
0131-002,2012,3,24,13,453,635,1088,1109
0131-002,2012,3,24,14,403,669,1072,1088
0131-002,2012,3,24,15,432,588,1020,1072
0131-002,2012,3,24,16,444,576,1020,1020
0131-002,2012,3,24,17,508,568,1076,1020
0131-002,2012,3,24,18,564,630,1194,1076
0131-002,2012,3,24,19,551,544,1095,1194
0131-002,2012,3,24,20,340,364,704,1095
0131-002,2012,3,24,21,243,238,481,704
0131-002,2012,3,24,22,188,192,380,481
0131-002,2012,3,24,23,145,172,317,380
0131-002,2012,3,24,24,102,101,203,317
0131-002,2012,3,25,1,72,63,135,203
0131-002,2012,3,25,2,44,48,92,135
0131-002,2012,3,25,3,25,40,65,92
0131-002,2012,3,25,4,22,28,50,65
0131-002,2012,3,25,5,31,28,59,50
0131-002,2012,3,25,6,52,36,88,59
0131-002,2012,3,25,7,86,80,166,88
0131-002,2012,3,25,8,160,138,298,166
0131-002,2012,3,25,9,174,203,377,298
0131-002,2012,3,25,10,224,216,440,377
0131-002,2012,3,25,11,251,292,543,440
0131-002,2012,3,25,12,276,300,576,543
0131-002,2012,3,25,13,269,286,555,576
0131-002,2012,3,25,14,296,291,587,555
0131-002,2012,3,25,15,331,288,619,587
0131-002,2012,3,25,16,415,335,750,619
0131-002,2012,3,25,17,503,342,845,750
0131-002,2012,3,25,18,584,354,938,845
0131-002,2012,3,25,19,533,313,846,938
0131-002,2012,3,25,20,392,238,630,846
0131-002,2012,3,25,21,289,220,509,630
0131-002,2012,3,25,22,229,146,375,509
0131-002,2012,3,25,23,141,125,266,375
0131-002,2012,3,25,24,95,76,171,266
0131-002,2012,3,26,1,56,47,103,171
0131-002,2012,3,26,2,33,27,60,103
0131-002,2012,3,26,3,25,24,49,60
0131-002,2012,3,26,4,18,19,37,49
0131-002,2012,3,26,5,32,29,61,37
0131-002,2012,3,26,6,70,58,128,61
0131-002,2012,3,26,7,321,169,490,128
0131-002,2012,3,26,8,801,510,1311,490
0131-002,2012,3,26,9,662,606,1268,1311
0131-002,2012,3,26,10,460,447,907,1268
0131-002,2012,3,26,11,465,454,919,907
0131-002,2012,3,26,12,419,445,864,919
0131-002,2012,3,26,13,343,395,738,864
0131-002,2012,3,26,14,411,430,841,738
0131-002,2012,3,26,15,456,509,965,841
0131-002,2012,3,26,16,459,486,945,965
0131-002,2012,3,26,17,463,508,971,945
0131-002,2012,3,26,18,463,573,1036,971
0131-002,2012,3,26,19,424,586,1010,1036
0131-002,2012,3,26,20,322,436,758,1010
0131-002,2012,3,26,21,259,382,641,758
0131-002,2012,3,26,22,232,292,524,641
0131-002,2012,3,26,23,148,190,338,524
0131-002,2012,3,26,24,100,96,196,338
0131-002,2012,3,27,1,70,75,145,196
0131-002,2012,3,27,2,34,53,87,145
0131-002,2012,3,27,3,31,35,66,87
0131-002,2012,3,27,4,23,27,50,66
0131-002,2012,3,27,5,38,48,86,50
0131-002,2012,3,27,6,72,59,131,86
0131-002,2012,3,27,7,285,162,447,131
0131-002,2012,3,27,8,709,474,1183,447
0131-002,2012,3,27,9,622,592,1214,1183
0131-002,2012,3,27,10,518,500,1018,1214
0131-002,2012,3,27,11,450,476,926,1018
0131-002,2012,3,27,12,439,462,901,926
0131-002,2012,3,27,13,348,415,763,901
0131-002,2012,3,27,14,451,432,883,763
0131-002,2012,3,27,15,448,544,992,883
0131-002,2012,3,27,16,473,503,976,992
0131-002,2012,3,27,17,449,508,957,976
0131-002,2012,3,27,18,430,582,1012,957
0131-002,2012,3,27,19,444,594,1038,1012
0131-002,2012,3,27,20,313,426,739,1038
0131-002,2012,3,27,21,285,403,688,739
0131-002,2012,3,27,22,219,282,501,688
0131-002,2012,3,27,23,161,204,365,501
0131-002,2012,3,27,24,120,92,212,365
0131-002,2012,3,28,1,61,79,140,212
0131-002,2012,3,28,2,48,48,96,140
0131-002,2012,3,28,3,32,38,70,96
0131-002,2012,3,28,4,22,35,57,70
0131-002,2012,3,28,5,34,52,86,57
0131-002,2012,3,28,6,84,57,141,86
0131-002,2012,3,28,7,274,135,409,141
0131-002,2012,3,28,8,730,444,1174,409
0131-002,2012,3,28,9,672,612,1284,1174
0131-002,2012,3,28,10,457,509,966,1284
0131-002,2012,3,28,11,445,450,895,966
0131-002,2012,3,28,12,446,436,882,895
0131-002,2012,3,28,13,373,376,749,882
0131-002,2012,3,28,14,418,460,878,749
0131-002,2012,3,28,15,446,511,957,878
0131-002,2012,3,28,16,483,486,969,957
0131-002,2012,3,28,17,458,502,960,969
0131-002,2012,3,28,18,469,590,1059,960
0131-002,2012,3,28,19,491,614,1105,1059
0131-002,2012,3,28,20,341,459,800,1105
0131-002,2012,3,28,21,256,403,659,800
0131-002,2012,3,28,22,220,304,524,659
0131-002,2012,3,28,23,165,180,345,524
0131-002,2012,3,28,24,108,126,234,345
0131-002,2012,3,29,1,75,62,137,234
0131-002,2012,3,29,2,46,57,103,137
0131-002,2012,3,29,3,37,42,79,103
0131-002,2012,3,29,4,25,30,55,79
0131-002,2012,3,29,5,49,54,103,55
0131-002,2012,3,29,6,89,58,147,103
0131-002,2012,3,29,7,276,148,424,147
0131-002,2012,3,29,8,774,478,1252,424
0131-002,2012,3,29,9,606,623,1229,1252
0131-002,2012,3,29,10,487,490,977,1229
0131-002,2012,3,29,11,489,466,955,977
0131-002,2012,3,29,12,421,467,888,955
0131-002,2012,3,29,13,378,417,795,888
0131-002,2012,3,29,14,447,433,880,795
0131-002,2012,3,29,15,472,532,1004,880
0131-002,2012,3,29,16,478,522,1000,1004
0131-002,2012,3,29,17,477,514,991,1000
0131-002,2012,3,29,18,474,628,1102,991
0131-002,2012,3,29,19,472,570,1042,1102
0131-002,2012,3,29,20,336,440,776,1042
0131-002,2012,3,29,21,281,421,702,776
0131-002,2012,3,29,22,246,306,552,702
0131-002,2012,3,29,23,173,200,373,552
0131-002,2012,3,29,24,133,127,260,373
0131-002,2012,3,30,1,95,73,168,260
0131-002,2012,3,30,2,44,58,102,168
0131-002,2012,3,30,3,29,42,71,102
0131-002,2012,3,30,4,33,31,64,71
0131-002,2012,3,30,5,34,47,81,64
0131-002,2012,3,30,6,68,56,124,81
0131-002,2012,3,30,7,221,116,337,124
0131-002,2012,3,30,8,684,416,1100,337
0131-002,2012,3,30,9,618,595,1213,1100
0131-002,2012,3,30,10,498,473,971,1213
0131-002,2012,3,30,11,484,451,935,971
0131-002,2012,3,30,12,430,504,934,935
0131-002,2012,3,30,13,366,411,777,934
0131-002,2012,3,30,14,408,491,899,777
0131-002,2012,3,30,15,443,517,960,899
0131-002,2012,3,30,16,490,510,1000,960
0131-002,2012,3,30,17,449,529,978,1000
0131-002,2012,3,30,18,466,568,1034,978
0131-002,2012,3,30,19,486,592,1078,1034
0131-002,2012,3,30,20,389,480,869,1078
0131-002,2012,3,30,21,271,398,669,869
0131-002,2012,3,30,22,254,320,574,669
0131-002,2012,3,30,23,182,219,401,574
0131-002,2012,3,30,24,140,122,262,401
0131-002,2012,3,31,1,87,86,173,262
0131-002,2012,3,31,2,58,54,112,173
0131-002,2012,3,31,3,32,43,75,112
0131-002,2012,3,31,4,28,46,74,75
0131-002,2012,3,31,5,37,50,87,74
0131-002,2012,3,31,6,75,58,133,87
0131-002,2012,3,31,7,178,125,303,133
0131-002,2012,3,31,8,353,295,648,303
0131-002,2012,3,31,9,442,407,849,648
0131-002,2012,3,31,10,398,473,871,849
0131-002,2012,3,31,11,447,633,1080,871
0131-002,2012,3,31,12,422,725,1147,1080
0131-002,2012,3,31,13,453,680,1133,1147
0131-002,2012,3,31,14,446,684,1130,1133
0131-002,2012,3,31,15,450,646,1096,1130
0131-002,2012,3,31,16,440,584,1024,1096
0131-002,2012,3,31,17,515,607,1122,1024
0131-002,2012,3,31,18,559,640,1199,1122
0131-002,2012,3,31,19,593,516,1109,1199
0131-002,2012,3,31,20,433,388,821,1109
0131-002,2012,3,31,21,242,282,524,821
0131-002,2012,3,31,22,201,219,420,524
0131-002,2012,3,31,23,163,144,307,420
0131-002,2012,3,31,24,86,101,187,307
0131-002,2012,4,1,1,59,52,111,187
0131-002,2012,4,1,2,36,52,88,111
0131-002,2012,4,1,3,33,36,69,88
0131-002,2012,4,1,4,20,19,39,69
0131-002,2012,4,1,5,30,27,57,39
0131-002,2012,4,1,6,38,36,74,57
0131-002,2012,4,1,7,120,80,200,74
0131-002,2012,4,1,8,158,135,293,200
0131-002,2012,4,1,9,169,233,402,293
0131-002,2012,4,1,10,220,262,482,402
0131-002,2012,4,1,11,257,279,536,482
0131-002,2012,4,1,12,260,280,540,536
0131-002,2012,4,1,13,259,271,530,540
0131-002,2012,4,1,14,300,264,564,530
0131-002,2012,4,1,15,365,298,663,564
0131-002,2012,4,1,16,550,346,896,663
0131-002,2012,4,1,17,504,348,852,896
0131-002,2012,4,1,18,550,378,928,852
0131-002,2012,4,1,19,564,306,870,928
0131-002,2012,4,1,20,502,253,755,870
0131-002,2012,4,1,21,480,234,714,755
0131-002,2012,4,1,22,358,198,556,714
0131-002,2012,4,1,23,202,130,332,556
0131-002,2012,4,1,24,112,82,194,332
0131-002,2012,4,2,1,49,46,95,194
0131-002,2012,4,2,2,35,28,63,95
0131-002,2012,4,2,3,24,24,48,63
0131-002,2012,4,2,4,22,30,52,48
0131-002,2012,4,2,5,34,34,68,52
0131-002,2012,4,2,6,84,66,150,68
0131-002,2012,4,2,7,314,185,499,150
0131-002,2012,4,2,8,806,488,1294,499
0131-002,2012,4,2,9,652,581,1233,1294
0131-002,2012,4,2,10,399,451,850,1233
0131-002,2012,4,2,11,456,438,894,850
0131-002,2012,4,2,12,429,442,871,894
0131-002,2012,4,2,13,381,415,796,871
0131-002,2012,4,2,14,394,443,837,796
0131-002,2012,4,2,15,460,486,946,837
0131-002,2012,4,2,16,459,520,979,946
0131-002,2012,4,2,17,444,485,929,979
0131-002,2012,4,2,18,437,566,1003,929
0131-002,2012,4,2,19,396,513,909,1003
0131-002,2012,4,2,20,304,421,725,909
0131-002,2012,4,2,21,238,379,617,725
0131-002,2012,4,2,22,222,282,504,617
0131-002,2012,4,2,23,161,196,357,504
0131-002,2012,4,2,24,110,103,213,357
0131-002,2012,4,3,1,62,72,134,213
0131-002,2012,4,3,2,44,41,85,134
0131-002,2012,4,3,3,34,30,64,85
0131-002,2012,4,3,4,28,31,59,64
0131-002,2012,4,3,5,23,46,69,59
0131-002,2012,4,3,6,66,59,125,69
0131-002,2012,4,3,7,218,105,323,125
0131-002,2012,4,3,8,658,426,1084,323
0131-002,2012,4,3,9,580,533,1113,1084
0131-002,2012,4,3,10,438,448,886,1113
0131-002,2012,4,3,11,452,424,876,886
0131-002,2012,4,3,12,375,374,749,876
0131-002,2012,4,3,13,342,312,654,749
0131-002,2012,4,3,14,387,447,834,654
0131-002,2012,4,3,15,416,468,884,834
0131-002,2012,4,3,16,430,468,898,884
0131-002,2012,4,3,17,407,456,863,898
0131-002,2012,4,3,18,368,508,876,863
0131-002,2012,4,3,19,400,508,908,876
0131-002,2012,4,3,20,324,429,753,908
0131-002,2012,4,3,21,264,379,643,753
0131-002,2012,4,3,22,212,294,506,643
0131-002,2012,4,3,23,160,174,334,506
0131-002,2012,4,3,24,88,94,182,334
0131-002,2012,4,4,1,72,63,135,182
0131-002,2012,4,4,2,49,40,89,135
0131-002,2012,4,4,3,40,49,89,89
0131-002,2012,4,4,4,27,30,57,89
0131-002,2012,4,4,5,34,34,68,57
0131-002,2012,4,4,6,75,49,124,68
0131-002,2012,4,4,7,268,148,416,124
0131-002,2012,4,4,8,716,458,1174,416
0131-002,2012,4,4,9,639,595,1234,1174
0131-002,2012,4,4,10,453,456,909,1234
0131-002,2012,4,4,11,471,467,938,909
0131-002,2012,4,4,12,443,434,877,938
0131-002,2012,4,4,13,366,409,775,877
0131-002,2012,4,4,14,422,443,865,775
0131-002,2012,4,4,15,486,484,970,865
0131-002,2012,4,4,16,463,484,947,970
0131-002,2012,4,4,17,430,517,947,947
0131-002,2012,4,4,18,448,582,1030,947
0131-002,2012,4,4,19,456,591,1047,1030
0131-002,2012,4,4,20,327,450,777,1047
0131-002,2012,4,4,21,256,400,656,777
0131-002,2012,4,4,22,232,292,524,656
0131-002,2012,4,4,23,184,201,385,524
0131-002,2012,4,4,24,89,119,208,385
0131-002,2012,4,5,1,76,88,164,208
0131-002,2012,4,5,2,47,37,84,164
0131-002,2012,4,5,3,33,31,64,84
0131-002,2012,4,5,4,28,30,58,64
0131-002,2012,4,5,5,31,44,75,58
0131-002,2012,4,5,6,87,67,154,75
0131-002,2012,4,5,7,249,164,413,154
0131-002,2012,4,5,8,691,461,1152,413
0131-002,2012,4,5,9,636,601,1237,1152
0131-002,2012,4,5,10,478,495,973,1237
0131-002,2012,4,5,11,462,481,943,973
0131-002,2012,4,5,12,458,479,937,943
0131-002,2012,4,5,13,345,406,751,937
0131-002,2012,4,5,14,442,476,918,751
0131-002,2012,4,5,15,453,526,979,918
0131-002,2012,4,5,16,480,496,976,979
0131-002,2012,4,5,17,490,483,973,976
0131-002,2012,4,5,18,490,609,1099,973
0131-002,2012,4,5,19,435,569,1004,1099
0131-002,2012,4,5,20,352,446,798,1004
0131-002,2012,4,5,21,296,372,668,798
0131-002,2012,4,5,22,238,313,551,668
0131-002,2012,4,5,23,168,175,343,551
0131-002,2012,4,5,24,123,127,250,343
0131-002,2012,4,6,1,70,73,143,250
0131-002,2012,4,6,2,37,48,85,143
0131-002,2012,4,6,3,36,33,69,85
0131-002,2012,4,6,4,22,32,54,69
0131-002,2012,4,6,5,33,41,74,54
0131-002,2012,4,6,6,84,54,138,74
0131-002,2012,4,6,7,277,161,438,138
0131-002,2012,4,6,8,723,462,1185,438
0131-002,2012,4,6,9,650,598,1248,1185
0131-002,2012,4,6,10,513,478,991,1248
0131-002,2012,4,6,11,478,526,1004,991
0131-002,2012,4,6,12,432,483,915,1004
0131-002,2012,4,6,13,351,422,773,915
0131-002,2012,4,6,14,467,451,918,773
0131-002,2012,4,6,15,418,478,896,918
0131-002,2012,4,6,16,466,533,999,896
0131-002,2012,4,6,17,464,492,956,999
0131-002,2012,4,6,18,493,614,1107,956
0131-002,2012,4,6,19,520,622,1142,1107
0131-002,2012,4,6,20,418,525,943,1142
0131-002,2012,4,6,21,309,430,739,943
0131-002,2012,4,6,22,252,310,562,739
0131-002,2012,4,6,23,171,188,359,562
0131-002,2012,4,6,24,118,127,245,359
0131-002,2012,4,7,1,78,76,154,245
0131-002,2012,4,7,2,51,66,117,154
0131-002,2012,4,7,3,38,45,83,117
0131-002,2012,4,7,4,33,40,73,83
0131-002,2012,4,7,5,34,36,70,73
0131-002,2012,4,7,6,77,66,143,70
0131-002,2012,4,7,7,182,146,328,143
0131-002,2012,4,7,8,420,298,718,328
0131-002,2012,4,7,9,402,433,835,718
0131-002,2012,4,7,10,403,514,917,835
0131-002,2012,4,7,11,395,611,1006,917
0131-002,2012,4,7,12,401,672,1073,1006
0131-002,2012,4,7,13,372,679,1051,1073
0131-002,2012,4,7,14,376,659,1035,1051
0131-002,2012,4,7,15,388,614,1002,1035
0131-002,2012,4,7,16,418,600,1018,1002
0131-002,2012,4,7,17,485,586,1071,1018
0131-002,2012,4,7,18,539,597,1136,1071
0131-002,2012,4,7,19,519,484,1003,1136
0131-002,2012,4,7,20,382,304,686,1003
0131-002,2012,4,7,21,263,264,527,686
0131-002,2012,4,7,22,210,195,405,527
0131-002,2012,4,7,23,154,156,310,405
0131-002,2012,4,7,24,109,106,215,310
0131-002,2012,4,8,1,70,76,146,215
0131-002,2012,4,8,2,51,48,99,146
0131-002,2012,4,8,3,28,35,63,99
0131-002,2012,4,8,4,28,24,52,63
0131-002,2012,4,8,5,34,19,53,52
0131-002,2012,4,8,6,42,50,92,53
0131-002,2012,4,8,7,96,78,174,92
0131-002,2012,4,8,8,172,137,309,174
0131-002,2012,4,8,9,177,222,399,309
0131-002,2012,4,8,10,251,234,485,399
0131-002,2012,4,8,11,274,300,574,485
0131-002,2012,4,8,12,267,298,565,574
0131-002,2012,4,8,13,264,269,533,565
0131-002,2012,4,8,14,334,319,653,533
0131-002,2012,4,8,15,391,328,719,653
0131-002,2012,4,8,16,512,342,854,719
0131-002,2012,4,8,17,558,346,904,854
0131-002,2012,4,8,18,572,396,968,904
0131-002,2012,4,8,19,552,303,855,968
0131-002,2012,4,8,20,508,268,776,855
0131-002,2012,4,8,21,464,220,684,776
0131-002,2012,4,8,22,431,170,601,684
0131-002,2012,4,8,23,202,138,340,601
0131-002,2012,4,8,24,130,78,208,340
0131-002,2012,4,9,1,68,53,121,208
0131-002,2012,4,9,2,34,39,73,121
0131-002,2012,4,9,3,23,22,45,73
0131-002,2012,4,9,4,22,22,44,45
0131-002,2012,4,9,5,34,51,85,44
0131-002,2012,4,9,6,84,72,156,85
0131-002,2012,4,9,7,352,189,541,156
0131-002,2012,4,9,8,781,526,1307,541
0131-002,2012,4,9,9,636,595,1231,1307
0131-002,2012,4,9,10,488,503,991,1231
0131-002,2012,4,9,11,449,493,942,991
0131-002,2012,4,9,12,428,456,884,942
0131-002,2012,4,9,13,393,383,776,884
0131-002,2012,4,9,14,444,454,898,776
0131-002,2012,4,9,15,505,486,991,898
0131-002,2012,4,9,16,454,506,960,991
0131-002,2012,4,9,17,445,481,926,960
0131-002,2012,4,9,18,447,578,1025,926
0131-002,2012,4,9,19,444,588,1032,1025
0131-002,2012,4,9,20,305,459,764,1032
0131-002,2012,4,9,21,268,425,693,764
0131-002,2012,4,9,22,253,302,555,693
0131-002,2012,4,9,23,166,163,329,555
0131-002,2012,4,9,24,102,96,198,329
0131-002,2012,4,10,1,68,72,140,198
0131-002,2012,4,10,2,46,56,102,140
0131-002,2012,4,10,3,22,37,59,102
0131-002,2012,4,10,4,31,24,55,59
0131-002,2012,4,10,5,36,48,84,55
0131-002,2012,4,10,6,86,61,147,84
0131-002,2012,4,10,7,282,164,446,147
0131-002,2012,4,10,8,752,463,1215,446
0131-002,2012,4,10,9,624,586,1210,1215
0131-002,2012,4,10,10,512,521,1033,1210
0131-002,2012,4,10,11,491,500,991,1033
0131-002,2012,4,10,12,448,467,915,991
0131-002,2012,4,10,13,385,381,766,915
0131-002,2012,4,10,14,454,450,904,766
0131-002,2012,4,10,15,473,519,992,904
0131-002,2012,4,10,16,465,531,996,992
0131-002,2012,4,10,17,516,501,1017,996
0131-002,2012,4,10,18,458,591,1049,1017
0131-002,2012,4,10,19,448,580,1028,1049
0131-002,2012,4,10,20,358,447,805,1028
0131-002,2012,4,10,21,298,398,696,805
0131-002,2012,4,10,22,267,310,577,696
0131-002,2012,4,10,23,156,178,334,577
0131-002,2012,4,10,24,112,104,216,334
0131-002,2012,4,11,1,78,87,165,216
0131-002,2012,4,11,2,57,60,117,165
0131-002,2012,4,11,3,52,38,90,117
0131-002,2012,4,11,4,34,38,72,90
0131-002,2012,4,11,5,33,42,75,72
0131-002,2012,4,11,6,69,34,103,75
0131-002,2012,4,11,7,142,106,248,103
0131-002,2012,4,11,8,340,215,555,248
0131-002,2012,4,11,9,415,336,751,555
0131-002,2012,4,11,10,379,378,757,751
0131-002,2012,4,11,11,388,356,744,757
0131-002,2012,4,11,12,370,423,793,744
0131-002,2012,4,11,13,319,352,671,793
0131-002,2012,4,11,14,376,400,776,671
0131-002,2012,4,11,15,398,400,798,776
0131-002,2012,4,11,16,398,388,786,798
0131-002,2012,4,11,17,366,409,775,786
0131-002,2012,4,11,18,372,460,832,775
0131-002,2012,4,11,19,319,406,725,832
0131-002,2012,4,11,20,279,300,579,725
0131-002,2012,4,11,21,221,274,495,579
0131-002,2012,4,11,22,202,203,405,495
0131-002,2012,4,11,23,144,154,298,405
0131-002,2012,4,11,24,99,90,189,298
0131-002,2012,4,12,1,48,48,96,189
0131-002,2012,4,12,2,41,36,77,96
0131-002,2012,4,12,3,28,26,54,77
0131-002,2012,4,12,4,24,41,65,54
0131-002,2012,4,12,5,36,46,82,65
0131-002,2012,4,12,6,89,64,153,82
0131-002,2012,4,12,7,304,190,494,153
0131-002,2012,4,12,8,751,480,1231,494
0131-002,2012,4,12,9,622,623,1245,1231
0131-002,2012,4,12,10,480,494,974,1245
0131-002,2012,4,12,11,495,502,997,974
0131-002,2012,4,12,12,478,504,982,997
0131-002,2012,4,12,13,366,384,750,982
0131-002,2012,4,12,14,451,464,915,750
0131-002,2012,4,12,15,468,501,969,915
0131-002,2012,4,12,16,457,525,982,969
0131-002,2012,4,12,17,443,456,899,982
0131-002,2012,4,12,18,434,607,1041,899
0131-002,2012,4,12,19,432,577,1009,1041
0131-002,2012,4,12,20,312,436,748,1009
0131-002,2012,4,12,21,287,415,702,748
0131-002,2012,4,12,22,266,281,547,702
0131-002,2012,4,12,23,180,188,368,547
0131-002,2012,4,12,24,89,112,201,368
0131-002,2012,4,13,1,79,68,147,201
0131-002,2012,4,13,2,54,49,103,147
0131-002,2012,4,13,3,33,34,67,103
0131-002,2012,4,13,4,30,39,69,67
0131-002,2012,4,13,5,29,45,74,69
0131-002,2012,4,13,6,91,61,152,74
0131-002,2012,4,13,7,281,157,438,152
0131-002,2012,4,13,8,731,478,1209,438
0131-002,2012,4,13,9,616,628,1244,1209
0131-002,2012,4,13,10,484,520,1004,1244
0131-002,2012,4,13,11,466,509,975,1004
0131-002,2012,4,13,12,468,476,944,975
0131-002,2012,4,13,13,385,406,791,944
0131-002,2012,4,13,14,424,472,896,791
0131-002,2012,4,13,15,460,520,980,896
0131-002,2012,4,13,16,492,514,1006,980
0131-002,2012,4,13,17,454,560,1014,1006
0131-002,2012,4,13,18,618,594,1212,1014
0131-002,2012,4,13,19,575,670,1245,1212
0131-002,2012,4,13,20,395,480,875,1245
0131-002,2012,4,13,21,329,473,802,875
0131-002,2012,4,13,22,254,357,611,802
0131-002,2012,4,13,23,174,196,370,611
0131-002,2012,4,13,24,136,126,262,370
0131-002,2012,4,14,1,94,97,191,262
0131-002,2012,4,14,2,76,62,138,191
0131-002,2012,4,14,3,51,54,105,138
0131-002,2012,4,14,4,25,37,62,105
0131-002,2012,4,14,5,29,49,78,62
0131-002,2012,4,14,6,104,63,167,78
0131-002,2012,4,14,7,200,138,338,167
0131-002,2012,4,14,8,418,295,713,338
0131-002,2012,4,14,9,412,448,860,713
0131-002,2012,4,14,10,428,526,954,860
0131-002,2012,4,14,11,395,654,1049,954
0131-002,2012,4,14,12,417,750,1167,1049
0131-002,2012,4,14,13,384,832,1216,1167
0131-002,2012,4,14,14,421,751,1172,1216
0131-002,2012,4,14,15,424,652,1076,1172
0131-002,2012,4,14,16,396,650,1046,1076
0131-002,2012,4,14,17,509,622,1131,1046
0131-002,2012,4,14,18,575,682,1257,1131
0131-002,2012,4,14,19,575,611,1186,1257
0131-002,2012,4,14,20,399,370,769,1186
0131-002,2012,4,14,21,271,263,534,769
0131-002,2012,4,14,22,242,202,444,534
0131-002,2012,4,14,23,157,152,309,444
0131-002,2012,4,14,24,108,90,198,309
0131-002,2012,4,15,1,54,72,126,198
0131-002,2012,4,15,2,38,44,82,126
0131-002,2012,4,15,3,40,36,76,82
0131-002,2012,4,15,4,30,29,59,76
0131-002,2012,4,15,5,33,26,59,59
0131-002,2012,4,15,6,42,42,84,59
0131-002,2012,4,15,7,121,94,215,84
0131-002,2012,4,15,8,178,156,334,215
0131-002,2012,4,15,9,184,237,421,334
0131-002,2012,4,15,10,219,275,494,421
0131-002,2012,4,15,11,270,316,586,494
0131-002,2012,4,15,12,291,312,603,586
0131-002,2012,4,15,13,281,294,575,603
0131-002,2012,4,15,14,438,329,767,575
0131-002,2012,4,15,15,492,369,861,767
0131-002,2012,4,15,16,537,356,893,861
0131-002,2012,4,15,17,573,381,954,893
0131-002,2012,4,15,18,639,364,1003,954
0131-002,2012,4,15,19,600,353,953,1003
0131-002,2012,4,15,20,588,294,882,953
0131-002,2012,4,15,21,495,240,735,882
0131-002,2012,4,15,22,434,178,612,735
0131-002,2012,4,15,23,263,148,411,612
0131-002,2012,4,15,24,148,81,229,411
0131-002,2012,4,16,1,70,42,112,229
0131-002,2012,4,16,2,36,27,63,112
0131-002,2012,4,16,3,25,24,49,63
0131-002,2012,4,16,4,22,28,50,49
0131-002,2012,4,16,5,34,36,70,50
0131-002,2012,4,16,6,99,78,177,70
0131-002,2012,4,16,7,368,217,585,177
0131-002,2012,4,16,8,847,557,1404,585
0131-002,2012,4,16,9,622,600,1222,1404
0131-002,2012,4,16,10,433,457,890,1222
0131-002,2012,4,16,11,473,452,925,890
0131-002,2012,4,16,12,394,450,844,925
0131-002,2012,4,16,13,352,408,760,844
0131-002,2012,4,16,14,366,461,827,760
0131-002,2012,4,16,15,473,496,969,827
0131-002,2012,4,16,16,484,507,991,969
0131-002,2012,4,16,17,462,507,969,991
0131-002,2012,4,16,18,436,603,1039,969
0131-002,2012,4,16,19,446,565,1011,1039
0131-002,2012,4,16,20,315,466,781,1011
0131-002,2012,4,16,21,273,412,685,781
0131-002,2012,4,16,22,225,310,535,685
0131-002,2012,4,16,23,174,196,370,535
0131-002,2012,4,16,24,115,106,221,370
0131-002,2012,4,17,1,60,78,138,221
0131-002,2012,4,17,2,44,49,93,138
0131-002,2012,4,17,3,28,32,60,93
0131-002,2012,4,17,4,35,28,63,60
0131-002,2012,4,17,5,37,47,84,63
0131-002,2012,4,17,6,105,63,168,84
0131-002,2012,4,17,7,329,190,519,168
0131-002,2012,4,17,8,756,508,1264,519
0131-002,2012,4,17,9,591,591,1182,1264
0131-002,2012,4,17,10,467,516,983,1182
0131-002,2012,4,17,11,484,478,962,983
0131-002,2012,4,17,12,437,486,923,962
0131-002,2012,4,17,13,370,360,730,923
0131-002,2012,4,17,14,408,448,856,730
0131-002,2012,4,17,15,465,483,948,856
0131-002,2012,4,17,16,473,487,960,948
0131-002,2012,4,17,17,480,499,979,960
0131-002,2012,4,17,18,425,594,1019,979
0131-002,2012,4,17,19,408,603,1011,1019
0131-002,2012,4,17,20,325,453,778,1011
0131-002,2012,4,17,21,248,378,626,778
0131-002,2012,4,17,22,262,287,549,626
0131-002,2012,4,17,23,196,202,398,549
0131-002,2012,4,17,24,117,104,221,398
0131-002,2012,4,18,1,80,70,150,221
0131-002,2012,4,18,2,44,48,92,150
0131-002,2012,4,18,3,36,34,70,92
0131-002,2012,4,18,4,25,33,58,70
0131-002,2012,4,18,5,51,45,96,58
0131-002,2012,4,18,6,94,67,161,96
0131-002,2012,4,18,7,342,182,524,161
0131-002,2012,4,18,8,756,489,1245,524
0131-002,2012,4,18,9,613,612,1225,1245
0131-002,2012,4,18,10,466,520,986,1225
0131-002,2012,4,18,11,491,491,982,986
0131-002,2012,4,18,12,422,451,873,982
0131-002,2012,4,18,13,333,371,704,873
0131-002,2012,4,18,14,456,454,910,704
0131-002,2012,4,18,15,454,465,919,910
0131-002,2012,4,18,16,464,521,985,919
0131-002,2012,4,18,17,457,516,973,985
0131-002,2012,4,18,18,432,622,1054,973
0131-002,2012,4,18,19,454,582,1036,1054
0131-002,2012,4,18,20,328,451,779,1036
0131-002,2012,4,18,21,242,386,628,779
0131-002,2012,4,18,22,260,279,539,628
0131-002,2012,4,18,23,179,188,367,539
0131-002,2012,4,18,24,109,126,235,367
0131-002,2012,4,19,1,75,84,159,235
0131-002,2012,4,19,2,39,41,80,159
0131-002,2012,4,19,3,34,36,70,80
0131-002,2012,4,19,4,25,34,59,70
0131-002,2012,4,19,5,40,44,84,59
0131-002,2012,4,19,6,92,72,164,84
0131-002,2012,4,19,7,321,174,495,164
0131-002,2012,4,19,8,754,510,1264,495
0131-002,2012,4,19,9,647,602,1249,1264
0131-002,2012,4,19,10,465,500,965,1249
0131-002,2012,4,19,11,456,491,947,965
0131-002,2012,4,19,12,448,432,880,947
0131-002,2012,4,19,13,357,401,758,880
0131-002,2012,4,19,14,435,465,900,758
0131-002,2012,4,19,15,477,531,1008,900
0131-002,2012,4,19,16,475,494,969,1008
0131-002,2012,4,19,17,434,526,960,969
0131-002,2012,4,19,18,461,567,1028,960
0131-002,2012,4,19,19,455,568,1023,1028
0131-002,2012,4,19,20,364,452,816,1023
0131-002,2012,4,19,21,270,429,699,816
0131-002,2012,4,19,22,264,274,538,699
0131-002,2012,4,19,23,183,190,373,538
0131-002,2012,4,19,24,110,123,233,373
0131-002,2012,4,20,1,72,96,168,233
0131-002,2012,4,20,2,47,34,81,168
0131-002,2012,4,20,3,31,30,61,81
0131-002,2012,4,20,4,30,45,75,61
0131-002,2012,4,20,5,48,40,88,75
0131-002,2012,4,20,6,102,86,188,88
0131-002,2012,4,20,7,345,162,507,188
0131-002,2012,4,20,8,747,489,1236,507
0131-002,2012,4,20,9,596,611,1207,1236
0131-002,2012,4,20,10,448,506,954,1207
0131-002,2012,4,20,11,480,492,972,954
0131-002,2012,4,20,12,442,474,916,972
0131-002,2012,4,20,13,363,444,807,916
0131-002,2012,4,20,14,453,466,919,807
0131-002,2012,4,20,15,488,538,1026,919
0131-002,2012,4,20,16,502,507,1009,1026
0131-002,2012,4,20,17,472,545,1017,1009
0131-002,2012,4,20,18,515,643,1158,1017
0131-002,2012,4,20,19,528,654,1182,1158
0131-002,2012,4,20,20,409,570,979,1182
0131-002,2012,4,20,21,327,494,821,979
0131-002,2012,4,20,22,271,351,622,821
0131-002,2012,4,20,23,185,270,455,622
0131-002,2012,4,20,24,142,149,291,455
0131-002,2012,4,21,1,93,96,189,291
0131-002,2012,4,21,2,64,60,124,189
0131-002,2012,4,21,3,42,54,96,124
0131-002,2012,4,21,4,25,42,67,96
0131-002,2012,4,21,5,40,61,101,67
0131-002,2012,4,21,6,88,72,160,101
0131-002,2012,4,21,7,184,150,334,160
0131-002,2012,4,21,8,389,302,691,334
0131-002,2012,4,21,9,415,427,842,691
0131-002,2012,4,21,10,436,416,852,842
0131-002,2012,4,21,11,406,476,882,852
0131-002,2012,4,21,12,375,463,838,882
0131-002,2012,4,21,13,353,448,801,838
0131-002,2012,4,21,14,376,478,854,801
0131-002,2012,4,21,15,438,446,884,854
0131-002,2012,4,21,16,480,420,900,884
0131-002,2012,4,21,17,511,486,997,900
0131-002,2012,4,21,18,512,475,987,997
0131-002,2012,4,21,19,388,416,804,987
0131-002,2012,4,21,20,270,263,533,804
0131-002,2012,4,21,21,213,196,409,533
0131-002,2012,4,21,22,162,176,338,409
0131-002,2012,4,21,23,116,132,248,338
0131-002,2012,4,21,24,94,84,178,248
0131-002,2012,4,22,1,62,54,116,178
0131-002,2012,4,22,2,34,49,83,116
0131-002,2012,4,22,3,30,46,76,83
0131-002,2012,4,22,4,24,24,48,76
0131-002,2012,4,22,5,23,30,53,48
0131-002,2012,4,22,6,28,31,59,53
0131-002,2012,4,22,7,72,55,127,59
0131-002,2012,4,22,8,137,148,285,127
0131-002,2012,4,22,9,198,222,420,285
0131-002,2012,4,22,10,190,210,400,420
0131-002,2012,4,22,11,219,238,457,400
0131-002,2012,4,22,12,250,256,506,457
0131-002,2012,4,22,13,245,259,504,506
0131-002,2012,4,22,14,252,288,540,504
0131-002,2012,4,22,15,313,297,610,540
0131-002,2012,4,22,16,378,316,694,610
0131-002,2012,4,22,17,481,337,818,694
0131-002,2012,4,22,18,419,333,752,818
0131-002,2012,4,22,19,358,256,614,752
0131-002,2012,4,22,20,273,214,487,614
0131-002,2012,4,22,21,210,208,418,487
0131-002,2012,4,22,22,204,153,357,418
0131-002,2012,4,22,23,144,110,254,357
0131-002,2012,4,22,24,96,82,178,254
0131-002,2012,4,23,1,48,59,107,178
0131-002,2012,4,23,2,30,33,63,107
0131-002,2012,4,23,3,24,22,46,63
0131-002,2012,4,23,4,26,30,56,46
0131-002,2012,4,23,5,40,54,94,56
0131-002,2012,4,23,6,93,85,178,94
0131-002,2012,4,23,7,413,222,635,178
0131-002,2012,4,23,8,840,564,1404,635
0131-002,2012,4,23,9,605,605,1210,1404
0131-002,2012,4,23,10,449,439,888,1210
0131-002,2012,4,23,11,449,490,939,888
0131-002,2012,4,23,12,424,505,929,939
0131-002,2012,4,23,13,376,437,813,929
0131-002,2012,4,23,14,428,483,911,813
0131-002,2012,4,23,15,484,515,999,911
0131-002,2012,4,23,16,488,545,1033,999
0131-002,2012,4,23,17,462,510,972,1033
0131-002,2012,4,23,18,448,561,1009,972
0131-002,2012,4,23,19,504,594,1098,1009
0131-002,2012,4,23,20,337,489,826,1098
0131-002,2012,4,23,21,284,396,680,826
0131-002,2012,4,23,22,246,285,531,680
0131-002,2012,4,23,23,171,202,373,531
0131-002,2012,4,23,24,102,120,222,373
0131-002,2012,4,24,1,70,74,144,222
0131-002,2012,4,24,2,55,48,103,144
0131-002,2012,4,24,3,33,50,83,103
0131-002,2012,4,24,4,30,26,56,83
0131-002,2012,4,24,5,52,50,102,56
0131-002,2012,4,24,6,84,64,148,102
0131-002,2012,4,24,7,329,196,525,148
0131-002,2012,4,24,8,775,549,1324,525
0131-002,2012,4,24,9,570,622,1192,1324
0131-002,2012,4,24,10,501,474,975,1192
0131-002,2012,4,24,11,495,494,989,975
0131-002,2012,4,24,12,410,468,878,989
0131-002,2012,4,24,13,386,406,792,878
0131-002,2012,4,24,14,440,475,915,792
0131-002,2012,4,24,15,466,526,992,915
0131-002,2012,4,24,16,506,503,1009,992
0131-002,2012,4,24,17,476,553,1029,1009
0131-002,2012,4,24,18,456,567,1023,1029
0131-002,2012,4,24,19,422,605,1027,1023
0131-002,2012,4,24,20,378,460,838,1027
0131-002,2012,4,24,21,328,427,755,838
0131-002,2012,4,24,22,224,294,518,755
0131-002,2012,4,24,23,156,200,356,518
0131-002,2012,4,24,24,94,118,212,356
0131-002,2012,4,25,1,64,90,154,212
0131-002,2012,4,25,2,42,48,90,154
0131-002,2012,4,25,3,40,32,72,90
0131-002,2012,4,25,4,30,39,69,72
0131-002,2012,4,25,5,40,44,84,69
0131-002,2012,4,25,6,85,59,144,84
0131-002,2012,4,25,7,310,142,452,144
0131-002,2012,4,25,8,718,472,1190,452
0131-002,2012,4,25,9,583,544,1127,1190
0131-002,2012,4,25,10,433,474,907,1127
0131-002,2012,4,25,11,463,460,923,907
0131-002,2012,4,25,12,421,416,837,923
0131-002,2012,4,25,13,343,390,733,837
0131-002,2012,4,25,14,382,461,843,733
0131-002,2012,4,25,15,485,454,939,843
0131-002,2012,4,25,16,410,467,877,939
0131-002,2012,4,25,17,425,459,884,877
0131-002,2012,4,25,18,410,540,950,884
0131-002,2012,4,25,19,384,540,924,950
0131-002,2012,4,25,20,329,395,724,924
0131-002,2012,4,25,21,244,376,620,724
0131-002,2012,4,25,22,217,262,479,620
0131-002,2012,4,25,23,179,177,356,479
0131-002,2012,4,25,24,113,107,220,356
0131-002,2012,4,26,1,75,57,132,220
0131-002,2012,4,26,2,56,59,115,132
0131-002,2012,4,26,3,35,36,71,115
0131-002,2012,4,26,4,30,34,64,71
0131-002,2012,4,26,5,35,43,78,64
0131-002,2012,4,26,6,96,76,172,78
0131-002,2012,4,26,7,321,156,477,172
0131-002,2012,4,26,8,760,533,1293,477
0131-002,2012,4,26,9,568,607,1175,1293
0131-002,2012,4,26,10,494,507,1001,1175
0131-002,2012,4,26,11,503,492,995,1001
0131-002,2012,4,26,12,450,464,914,995
0131-002,2012,4,26,13,383,422,805,914
0131-002,2012,4,26,14,442,460,902,805
0131-002,2012,4,26,15,474,526,1000,902
0131-002,2012,4,26,16,512,518,1030,1000
0131-002,2012,4,26,17,515,561,1076,1030
0131-002,2012,4,26,18,496,618,1114,1076
0131-002,2012,4,26,19,457,551,1008,1114
0131-002,2012,4,26,20,379,501,880,1008
0131-002,2012,4,26,21,282,424,706,880
0131-002,2012,4,26,22,278,336,614,706
0131-002,2012,4,26,23,188,214,402,614
0131-002,2012,4,26,24,120,120,240,402
0131-002,2012,4,27,1,74,85,159,240
0131-002,2012,4,27,2,54,57,111,159
0131-002,2012,4,27,3,29,41,70,111
0131-002,2012,4,27,4,40,36,76,70
0131-002,2012,4,27,5,42,61,103,76
0131-002,2012,4,27,6,106,71,177,103
0131-002,2012,4,27,7,353,186,539,177
0131-002,2012,4,27,8,783,527,1310,539
0131-002,2012,4,27,9,612,604,1216,1310
0131-002,2012,4,27,10,502,491,993,1216
0131-002,2012,4,27,11,544,515,1059,993
0131-002,2012,4,27,12,435,481,916,1059
0131-002,2012,4,27,13,373,444,817,916
0131-002,2012,4,27,14,438,462,900,817
0131-002,2012,4,27,15,479,545,1024,900
0131-002,2012,4,27,16,504,536,1040,1024
0131-002,2012,4,27,17,498,534,1032,1040
0131-002,2012,4,27,18,520,684,1204,1032
0131-002,2012,4,27,19,537,609,1146,1204
0131-002,2012,4,27,20,414,526,940,1146
0131-002,2012,4,27,21,347,425,772,940
0131-002,2012,4,27,22,251,321,572,772
0131-002,2012,4,27,23,207,212,419,572
0131-002,2012,4,27,24,133,144,277,419
0131-002,2012,4,28,1,98,102,200,277
0131-002,2012,4,28,2,61,56,117,200
0131-002,2012,4,28,3,36,51,87,117
0131-002,2012,4,28,4,40,48,88,87
0131-002,2012,4,28,5,42,62,104,88
0131-002,2012,4,28,6,109,69,178,104
0131-002,2012,4,28,7,249,187,436,178
0131-002,2012,4,28,8,483,346,829,436
0131-002,2012,4,28,9,439,491,930,829
0131-002,2012,4,28,10,427,537,964,930
0131-002,2012,4,28,11,440,642,1082,964
0131-002,2012,4,28,12,407,626,1033,1082
0131-002,2012,4,28,13,376,588,964,1033
0131-002,2012,4,28,14,428,618,1046,964
0131-002,2012,4,28,15,412,588,1000,1046
0131-002,2012,4,28,16,411,546,957,1000
0131-002,2012,4,28,17,438,607,1045,957
0131-002,2012,4,28,18,444,704,1148,1045
0131-002,2012,4,28,19,420,569,989,1148
0131-002,2012,4,28,20,316,357,673,989
0131-002,2012,4,28,21,271,272,543,673
0131-002,2012,4,28,22,222,227,449,543
0131-002,2012,4,28,23,142,152,294,449
0131-002,2012,4,28,24,115,113,228,294
0131-002,2012,4,29,1,79,73,152,228
0131-002,2012,4,29,2,50,48,98,152
0131-002,2012,4,29,3,40,43,83,98
0131-002,2012,4,29,4,24,32,56,83
0131-002,2012,4,29,5,28,28,56,56
0131-002,2012,4,29,6,73,56,129,56
0131-002,2012,4,29,7,161,112,273,129
0131-002,2012,4,29,8,218,180,398,273
0131-002,2012,4,29,9,236,235,471,398
0131-002,2012,4,29,10,264,244,508,471
0131-002,2012,4,29,11,252,294,546,508
0131-002,2012,4,29,12,279,271,550,546
0131-002,2012,4,29,13,250,282,532,550
0131-002,2012,4,29,14,289,290,579,532
0131-002,2012,4,29,15,329,303,632,579
0131-002,2012,4,29,16,454,374,828,632
0131-002,2012,4,29,17,544,376,920,828
0131-002,2012,4,29,18,498,401,899,920
0131-002,2012,4,29,19,543,354,897,899
0131-002,2012,4,29,20,442,252,694,897
0131-002,2012,4,29,21,364,247,611,694
0131-002,2012,4,29,22,304,203,507,611
0131-002,2012,4,29,23,174,118,292,507
0131-002,2012,4,29,24,111,100,211,292
0131-002,2012,4,30,1,58,48,106,211
0131-002,2012,4,30,2,30,34,64,106
0131-002,2012,4,30,3,22,28,50,64
0131-002,2012,4,30,4,24,38,62,50
0131-002,2012,4,30,5,33,53,86,62
0131-002,2012,4,30,6,106,70,176,86
0131-002,2012,4,30,7,384,206,590,176
0131-002,2012,4,30,8,792,585,1377,590
0131-002,2012,4,30,9,589,605,1194,1377
0131-002,2012,4,30,10,420,492,912,1194
0131-002,2012,4,30,11,502,484,986,912
0131-002,2012,4,30,12,436,463,899,986
0131-002,2012,4,30,13,362,433,795,899
0131-002,2012,4,30,14,458,490,948,795
0131-002,2012,4,30,15,477,514,991,948
0131-002,2012,4,30,16,480,498,978,991
0131-002,2012,4,30,17,459,574,1033,978
0131-002,2012,4,30,18,446,612,1058,1033
0131-002,2012,4,30,19,462,570,1032,1058
0131-002,2012,4,30,20,402,492,894,1032
0131-002,2012,4,30,21,305,408,713,894
0131-002,2012,4,30,22,244,308,552,713
0131-002,2012,4,30,23,198,203,401,552
0131-002,2012,4,30,24,136,124,260,401
0131-002,2012,5,1,1,92,96,188,260
0131-002,2012,5,1,2,47,48,95,188
0131-002,2012,5,1,3,27,49,76,95
0131-002,2012,5,1,4,38,36,74,76
0131-002,2012,5,1,5,44,50,94,74
0131-002,2012,5,1,6,81,70,151,94
0131-002,2012,5,1,7,198,137,335,151
0131-002,2012,5,1,8,504,350,854,335
0131-002,2012,5,1,9,432,454,886,854
0131-002,2012,5,1,10,397,432,829,886
0131-002,2012,5,1,11,392,416,808,829
0131-002,2012,5,1,12,394,374,768,808
0131-002,2012,5,1,13,359,336,695,768
0131-002,2012,5,1,14,336,360,696,695
0131-002,2012,5,1,15,347,407,754,696
0131-002,2012,5,1,16,364,360,724,754
0131-002,2012,5,1,17,357,394,751,724
0131-002,2012,5,1,18,356,504,860,751
0131-002,2012,5,1,19,348,390,738,860
0131-002,2012,5,1,20,274,294,568,738
0131-002,2012,5,1,21,230,251,481,568
0131-002,2012,5,1,22,207,196,403,481
0131-002,2012,5,1,23,133,142,275,403
0131-002,2012,5,1,24,106,100,206,275
0131-002,2012,5,2,1,54,60,114,206
0131-002,2012,5,2,2,33,35,68,114
0131-002,2012,5,2,3,25,34,59,68
0131-002,2012,5,2,4,27,36,63,59
0131-002,2012,5,2,5,37,48,85,63
0131-002,2012,5,2,6,112,74,186,85
0131-002,2012,5,2,7,376,180,556,186
0131-002,2012,5,2,8,828,532,1360,556
0131-002,2012,5,2,9,609,600,1209,1360
0131-002,2012,5,2,10,430,502,932,1209
0131-002,2012,5,2,11,482,470,952,932
0131-002,2012,5,2,12,469,503,972,952
0131-002,2012,5,2,13,400,424,824,972
0131-002,2012,5,2,14,443,468,911,824
0131-002,2012,5,2,15,515,586,1101,911
0131-002,2012,5,2,16,540,536,1076,1101
0131-002,2012,5,2,17,454,540,994,1076
0131-002,2012,5,2,18,452,609,1061,994
0131-002,2012,5,2,19,444,582,1026,1061
0131-002,2012,5,2,20,346,513,859,1026
0131-002,2012,5,2,21,250,401,651,859
0131-002,2012,5,2,22,234,306,540,651
0131-002,2012,5,2,23,172,206,378,540
0131-002,2012,5,2,24,120,127,247,378
0131-002,2012,5,3,1,72,74,146,247
0131-002,2012,5,3,2,55,60,115,146
0131-002,2012,5,3,3,36,42,78,115
0131-002,2012,5,3,4,32,43,75,78
0131-002,2012,5,3,5,58,52,110,75
0131-002,2012,5,3,6,114,84,198,110
0131-002,2012,5,3,7,343,191,534,198
0131-002,2012,5,3,8,784,511,1295,534
0131-002,2012,5,3,9,624,616,1240,1295
0131-002,2012,5,3,10,526,491,1017,1240
0131-002,2012,5,3,11,438,534,972,1017
0131-002,2012,5,3,12,470,478,948,972
0131-002,2012,5,3,13,390,426,816,948
0131-002,2012,5,3,14,483,508,991,816
0131-002,2012,5,3,15,519,551,1070,991
0131-002,2012,5,3,16,508,530,1038,1070
0131-002,2012,5,3,17,478,536,1014,1038
0131-002,2012,5,3,18,504,647,1151,1014
0131-002,2012,5,3,19,469,585,1054,1151
0131-002,2012,5,3,20,382,486,868,1054
0131-002,2012,5,3,21,288,457,745,868
0131-002,2012,5,3,22,242,323,565,745
0131-002,2012,5,3,23,197,217,414,565
0131-002,2012,5,3,24,130,146,276,414
0131-002,2012,5,4,1,93,76,169,276
0131-002,2012,5,4,2,54,48,102,169
0131-002,2012,5,4,3,35,36,71,102
0131-002,2012,5,4,4,26,52,78,71
0131-002,2012,5,4,5,40,52,92,78
0131-002,2012,5,4,6,109,78,187,92
0131-002,2012,5,4,7,388,168,556,187
0131-002,2012,5,4,8,768,532,1300,556
0131-002,2012,5,4,9,618,619,1237,1300
0131-002,2012,5,4,10,486,561,1047,1237
0131-002,2012,5,4,11,496,528,1024,1047
0131-002,2012,5,4,12,473,498,971,1024
0131-002,2012,5,4,13,381,418,799,971
0131-002,2012,5,4,14,450,483,933,799
0131-002,2012,5,4,15,488,539,1027,933
0131-002,2012,5,4,16,516,547,1063,1027
0131-002,2012,5,4,17,516,558,1074,1063
0131-002,2012,5,4,18,552,684,1236,1074
0131-002,2012,5,4,19,580,730,1310,1236
0131-002,2012,5,4,20,448,690,1138,1310
0131-002,2012,5,4,21,372,632,1004,1138
0131-002,2012,5,4,22,304,557,861,1004
0131-002,2012,5,4,23,227,509,736,861
0131-002,2012,5,4,24,146,438,584,736
0131-002,2012,5,5,1,100,355,455,584
0131-002,2012,5,5,2,68,156,224,455
0131-002,2012,5,5,3,39,71,110,224
0131-002,2012,5,5,4,47,46,93,110
0131-002,2012,5,5,5,43,58,101,93
0131-002,2012,5,5,6,108,70,178,101
0131-002,2012,5,5,7,210,147,357,178
0131-002,2012,5,5,8,322,307,629,357
0131-002,2012,5,5,9,358,540,898,629
0131-002,2012,5,5,10,370,679,1049,898
0131-002,2012,5,5,11,360,721,1081,1049
0131-002,2012,5,5,12,380,729,1109,1081
0131-002,2012,5,5,13,363,707,1070,1109
0131-002,2012,5,5,14,337,655,992,1070
0131-002,2012,5,5,15,360,712,1072,992
0131-002,2012,5,5,16,342,612,954,1072
0131-002,2012,5,5,17,414,666,1080,954
0131-002,2012,5,5,18,408,630,1038,1080
0131-002,2012,5,5,19,384,508,892,1038
0131-002,2012,5,5,20,276,330,606,892
0131-002,2012,5,5,21,243,246,489,606
0131-002,2012,5,5,22,208,218,426,489
0131-002,2012,5,5,23,142,151,293,426
0131-002,2012,5,5,24,104,126,230,293
0131-002,2012,5,6,1,54,62,116,230
0131-002,2012,5,6,2,40,36,76,116
0131-002,2012,5,6,3,21,29,50,76
0131-002,2012,5,6,4,21,25,46,50
0131-002,2012,5,6,5,19,30,49,46
0131-002,2012,5,6,6,50,43,93,49
0131-002,2012,5,6,7,144,96,240,93
0131-002,2012,5,6,8,198,131,329,240
0131-002,2012,5,6,9,190,226,416,329
0131-002,2012,5,6,10,264,231,495,416
0131-002,2012,5,6,11,435,299,734,495
0131-002,2012,5,6,12,534,345,879,734
0131-002,2012,5,6,13,568,262,830,879
0131-002,2012,5,6,14,538,301,839,830
0131-002,2012,5,6,15,555,340,895,839
0131-002,2012,5,6,16,566,352,918,895
0131-002,2012,5,6,17,691,403,1094,918
0131-002,2012,5,6,18,651,406,1057,1094
0131-002,2012,5,6,19,626,357,983,1057
0131-002,2012,5,6,20,600,315,915,983
0131-002,2012,5,6,21,546,299,845,915
0131-002,2012,5,6,22,600,274,874,845
0131-002,2012,5,6,23,499,157,656,874
0131-002,2012,5,6,24,408,107,515,656
0131-002,2012,5,7,1,136,58,194,515
0131-002,2012,5,7,2,54,36,90,194
0131-002,2012,5,7,3,28,22,50,90
0131-002,2012,5,7,4,27,28,55,50
0131-002,2012,5,7,5,33,53,86,55
0131-002,2012,5,7,6,129,88,217,86
0131-002,2012,5,7,7,421,224,645,217
0131-002,2012,5,7,8,862,581,1443,645
0131-002,2012,5,7,9,639,606,1245,1443
0131-002,2012,5,7,10,439,526,965,1245
0131-002,2012,5,7,11,498,521,1019,965
0131-002,2012,5,7,12,473,484,957,1019
0131-002,2012,5,7,13,409,461,870,957
0131-002,2012,5,7,14,449,514,963,870
0131-002,2012,5,7,15,502,531,1033,963
0131-002,2012,5,7,16,489,520,1009,1033
0131-002,2012,5,7,17,474,522,996,1009
0131-002,2012,5,7,18,487,594,1081,996
0131-002,2012,5,7,19,500,598,1098,1081
0131-002,2012,5,7,20,333,471,804,1098
0131-002,2012,5,7,21,291,484,775,804
0131-002,2012,5,7,22,285,306,591,775
0131-002,2012,5,7,23,190,197,387,591
0131-002,2012,5,7,24,106,129,235,387
0131-002,2012,5,8,1,80,82,162,235
0131-002,2012,5,8,2,43,60,103,162
0131-002,2012,5,8,3,44,40,84,103
0131-002,2012,5,8,4,33,46,79,84
0131-002,2012,5,8,5,48,52,100,79
0131-002,2012,5,8,6,106,90,196,100
0131-002,2012,5,8,7,334,210,544,196
0131-002,2012,5,8,8,794,520,1314,544
0131-002,2012,5,8,9,601,636,1237,1314
0131-002,2012,5,8,10,472,508,980,1237
0131-002,2012,5,8,11,491,502,993,980
0131-002,2012,5,8,12,452,484,936,993
0131-002,2012,5,8,13,394,433,827,936
0131-002,2012,5,8,14,480,450,930,827
0131-002,2012,5,8,15,508,535,1043,930
0131-002,2012,5,8,16,523,548,1071,1043
0131-002,2012,5,8,17,493,574,1067,1071
0131-002,2012,5,8,18,562,636,1198,1067
0131-002,2012,5,8,19,550,610,1160,1198
0131-002,2012,5,8,20,406,464,870,1160
0131-002,2012,5,8,21,292,429,721,870
0131-002,2012,5,8,22,232,336,568,721
0131-002,2012,5,8,23,179,200,379,568
0131-002,2012,5,8,24,94,114,208,379
0131-002,2012,5,9,1,71,68,139,208
0131-002,2012,5,9,2,54,48,102,139
0131-002,2012,5,9,3,30,34,64,102
0131-002,2012,5,9,4,36,36,72,64
0131-002,2012,5,9,5,44,54,98,72
0131-002,2012,5,9,6,114,88,202,98
0131-002,2012,5,9,7,360,203,563,202
0131-002,2012,5,9,8,782,540,1322,563
0131-002,2012,5,9,9,597,631,1228,1322
0131-002,2012,5,9,10,466,498,964,1228
0131-002,2012,5,9,11,479,496,975,964
0131-002,2012,5,9,12,433,472,905,975
0131-002,2012,5,9,13,366,406,772,905
0131-002,2012,5,9,14,438,442,880,772
0131-002,2012,5,9,15,471,569,1040,880
0131-002,2012,5,9,16,489,523,1012,1040
0131-002,2012,5,9,17,492,498,990,1012
0131-002,2012,5,9,18,555,610,1165,990
0131-002,2012,5,9,19,493,574,1067,1165
0131-002,2012,5,9,20,354,462,816,1067
0131-002,2012,5,9,21,292,406,698,816
0131-002,2012,5,9,22,257,288,545,698
0131-002,2012,5,9,23,181,204,385,545
0131-002,2012,5,9,24,120,125,245,385
0131-002,2012,5,10,1,96,86,182,245
0131-002,2012,5,10,2,60,42,102,182
0131-002,2012,5,10,3,37,36,73,102
0131-002,2012,5,10,4,40,43,83,73
0131-002,2012,5,10,5,37,65,102,83
0131-002,2012,5,10,6,108,86,194,102
0131-002,2012,5,10,7,356,180,536,194
0131-002,2012,5,10,8,762,520,1282,536
0131-002,2012,5,10,9,630,655,1285,1282
0131-002,2012,5,10,10,491,524,1015,1285
0131-002,2012,5,10,11,509,518,1027,1015
0131-002,2012,5,10,12,448,479,927,1027
0131-002,2012,5,10,13,359,402,761,927
0131-002,2012,5,10,14,447,486,933,761
0131-002,2012,5,10,15,484,545,1029,933
0131-002,2012,5,10,16,474,521,995,1029
0131-002,2012,5,10,17,497,528,1025,995
0131-002,2012,5,10,18,600,603,1203,1025
0131-002,2012,5,10,19,556,582,1138,1203
0131-002,2012,5,10,20,331,461,792,1138
0131-002,2012,5,10,21,307,430,737,792
0131-002,2012,5,10,22,256,287,543,737
0131-002,2012,5,10,23,170,193,363,543
0131-002,2012,5,10,24,109,131,240,363
0131-002,2012,5,11,1,86,73,159,240
0131-002,2012,5,11,2,53,54,107,159
0131-002,2012,5,11,3,37,43,80,107
0131-002,2012,5,11,4,27,31,58,80
0131-002,2012,5,11,5,58,59,117,58
0131-002,2012,5,11,6,111,96,207,117
0131-002,2012,5,11,7,327,188,515,207
0131-002,2012,5,11,8,767,502,1269,515
0131-002,2012,5,11,9,636,618,1254,1269
0131-002,2012,5,11,10,477,532,1009,1254
0131-002,2012,5,11,11,484,500,984,1009
0131-002,2012,5,11,12,483,506,989,984
0131-002,2012,5,11,13,360,456,816,989
0131-002,2012,5,11,14,446,570,1016,816
0131-002,2012,5,11,15,526,585,1111,1016
0131-002,2012,5,11,16,532,580,1112,1111
0131-002,2012,5,11,17,534,568,1102,1112
0131-002,2012,5,11,18,640,668,1308,1102
0131-002,2012,5,11,19,666,663,1329,1308
0131-002,2012,5,11,20,510,509,1019,1329
0131-002,2012,5,11,21,323,456,779,1019
0131-002,2012,5,11,22,276,326,602,779
0131-002,2012,5,11,23,190,226,416,602
0131-002,2012,5,11,24,155,114,269,416
0131-002,2012,5,12,1,87,99,186,269
0131-002,2012,5,12,2,69,68,137,186
0131-002,2012,5,12,3,36,62,98,137
0131-002,2012,5,12,4,33,46,79,98
0131-002,2012,5,12,5,48,59,107,79
0131-002,2012,5,12,6,100,77,177,107
0131-002,2012,5,12,7,236,181,417,177
0131-002,2012,5,12,8,436,322,758,417
0131-002,2012,5,12,9,491,490,981,758
0131-002,2012,5,12,10,400,507,907,981
0131-002,2012,5,12,11,400,504,904,907
0131-002,2012,5,12,12,415,612,1027,904
0131-002,2012,5,12,13,380,650,1030,1027
0131-002,2012,5,12,14,404,576,980,1030
0131-002,2012,5,12,15,462,464,926,980
0131-002,2012,5,12,16,376,491,867,926
0131-002,2012,5,12,17,400,529,929,867
0131-002,2012,5,12,18,518,728,1246,929
0131-002,2012,5,12,19,510,580,1090,1246
0131-002,2012,5,12,20,327,359,686,1090
0131-002,2012,5,12,21,269,270,539,686
0131-002,2012,5,12,22,232,220,452,539
0131-002,2012,5,12,23,154,171,325,452
0131-002,2012,5,12,24,109,110,219,325
0131-002,2012,5,13,1,75,80,155,219
0131-002,2012,5,13,2,54,49,103,155
0131-002,2012,5,13,3,33,44,77,103
0131-002,2012,5,13,4,22,32,54,77
0131-002,2012,5,13,5,40,32,72,54
0131-002,2012,5,13,6,68,48,116,72
0131-002,2012,5,13,7,130,94,224,116
0131-002,2012,5,13,8,177,177,354,224
0131-002,2012,5,13,9,213,213,426,354
0131-002,2012,5,13,10,232,238,470,426
0131-002,2012,5,13,11,264,295,559,470
0131-002,2012,5,13,12,268,300,568,559
0131-002,2012,5,13,13,380,282,662,568
0131-002,2012,5,13,14,420,314,734,662
0131-002,2012,5,13,15,506,301,807,734
0131-002,2012,5,13,16,526,328,854,807
0131-002,2012,5,13,17,555,360,915,854
0131-002,2012,5,13,18,517,379,896,915
0131-002,2012,5,13,19,439,374,813,896
0131-002,2012,5,13,20,347,319,666,813
0131-002,2012,5,13,21,292,257,549,666
0131-002,2012,5,13,22,250,200,450,549
0131-002,2012,5,13,23,182,145,327,450
0131-002,2012,5,13,24,102,78,180,327
0131-002,2012,5,14,1,59,51,110,180
0131-002,2012,5,14,2,40,32,72,110
0131-002,2012,5,14,3,36,32,68,72
0131-002,2012,5,14,4,30,32,62,68
0131-002,2012,5,14,5,34,34,68,62
0131-002,2012,5,14,6,113,83,196,68
0131-002,2012,5,14,7,407,248,655,196
0131-002,2012,5,14,8,851,534,1385,655
0131-002,2012,5,14,9,630,600,1230,1385
0131-002,2012,5,14,10,462,485,947,1230
0131-002,2012,5,14,11,440,477,917,947
0131-002,2012,5,14,12,428,448,876,917
0131-002,2012,5,14,13,353,441,794,876
0131-002,2012,5,14,14,406,455,861,794
0131-002,2012,5,14,15,462,487,949,861
0131-002,2012,5,14,16,463,485,948,949
0131-002,2012,5,14,17,449,490,939,948
0131-002,2012,5,14,18,412,580,992,939
0131-002,2012,5,14,19,415,538,953,992
0131-002,2012,5,14,20,326,450,776,953
0131-002,2012,5,14,21,278,407,685,776
0131-002,2012,5,14,22,233,283,516,685
0131-002,2012,5,14,23,166,176,342,516
0131-002,2012,5,14,24,95,87,182,342
0131-002,2012,5,15,1,74,70,144,182
0131-002,2012,5,15,2,46,35,81,144
0131-002,2012,5,15,3,28,34,62,81
0131-002,2012,5,15,4,34,36,70,62
0131-002,2012,5,15,5,42,51,93,70
0131-002,2012,5,15,6,114,72,186,93
0131-002,2012,5,15,7,314,180,494,186
0131-002,2012,5,15,8,762,525,1287,494
0131-002,2012,5,15,9,642,600,1242,1287
0131-002,2012,5,15,10,485,532,1017,1242
0131-002,2012,5,15,11,486,507,993,1017
0131-002,2012,5,15,12,465,480,945,993
0131-002,2012,5,15,13,360,424,784,945
0131-002,2012,5,15,14,479,484,963,784
0131-002,2012,5,15,15,511,531,1042,963
0131-002,2012,5,15,16,482,546,1028,1042
0131-002,2012,5,15,17,490,569,1059,1028
0131-002,2012,5,15,18,560,590,1150,1059
0131-002,2012,5,15,19,486,542,1028,1150
0131-002,2012,5,15,20,384,474,858,1028
0131-002,2012,5,15,21,276,444,720,858
0131-002,2012,5,15,22,282,283,565,720
0131-002,2012,5,15,23,164,189,353,565
0131-002,2012,5,15,24,114,126,240,353
0131-002,2012,5,16,1,70,88,158,240
0131-002,2012,5,16,2,54,49,103,158
0131-002,2012,5,16,3,30,42,72,103
0131-002,2012,5,16,4,31,40,71,72
0131-002,2012,5,16,5,46,49,95,71
0131-002,2012,5,16,6,113,82,195,95
0131-002,2012,5,16,7,348,198,546,195
0131-002,2012,5,16,8,776,545,1321,546
0131-002,2012,5,16,9,580,634,1214,1321
0131-002,2012,5,16,10,516,496,1012,1214
0131-002,2012,5,16,11,486,475,961,1012
0131-002,2012,5,16,12,454,480,934,961
0131-002,2012,5,16,13,377,391,768,934
0131-002,2012,5,16,14,426,450,876,768
0131-002,2012,5,16,15,504,546,1050,876
0131-002,2012,5,16,16,467,560,1027,1050
0131-002,2012,5,16,17,467,502,969,1027
0131-002,2012,5,16,18,481,617,1098,969
0131-002,2012,5,16,19,512,628,1140,1098
0131-002,2012,5,16,20,382,482,864,1140
0131-002,2012,5,16,21,292,405,697,864
0131-002,2012,5,16,22,222,305,527,697
0131-002,2012,5,16,23,178,193,371,527
0131-002,2012,5,16,24,132,111,243,371
0131-002,2012,5,17,1,72,84,156,243
0131-002,2012,5,17,2,50,64,114,156
0131-002,2012,5,17,3,35,39,74,114
0131-002,2012,5,17,4,36,32,68,74
0131-002,2012,5,17,5,47,55,102,68
0131-002,2012,5,17,6,111,88,199,102
0131-002,2012,5,17,7,352,185,537,199
0131-002,2012,5,17,8,792,564,1356,537
0131-002,2012,5,17,9,618,638,1256,1356
0131-002,2012,5,17,10,499,540,1039,1256
0131-002,2012,5,17,11,485,460,945,1039
0131-002,2012,5,17,12,444,502,946,945
0131-002,2012,5,17,13,377,390,767,946
0131-002,2012,5,17,14,430,492,922,767
0131-002,2012,5,17,15,492,531,1023,922
0131-002,2012,5,17,16,468,470,938,1023
0131-002,2012,5,17,17,480,512,992,938
0131-002,2012,5,17,18,519,611,1130,992
0131-002,2012,5,17,19,466,557,1023,1130
0131-002,2012,5,17,20,366,496,862,1023
0131-002,2012,5,17,21,288,397,685,862
0131-002,2012,5,17,22,230,311,541,685
0131-002,2012,5,17,23,200,198,398,541
0131-002,2012,5,17,24,139,126,265,398
0131-002,2012,5,18,1,88,74,162,265
0131-002,2012,5,18,2,53,51,104,162
0131-002,2012,5,18,3,36,37,73,104
0131-002,2012,5,18,4,35,53,88,73
0131-002,2012,5,18,5,42,52,94,88
0131-002,2012,5,18,6,114,98,212,94
0131-002,2012,5,18,7,359,192,551,212
0131-002,2012,5,18,8,780,534,1314,551
0131-002,2012,5,18,9,613,654,1267,1314
0131-002,2012,5,18,10,444,510,954,1267
0131-002,2012,5,18,11,460,484,944,954
0131-002,2012,5,18,12,442,482,924,944
0131-002,2012,5,18,13,396,424,820,924
0131-002,2012,5,18,14,468,504,972,820
0131-002,2012,5,18,15,496,549,1045,972
0131-002,2012,5,18,16,534,496,1030,1045
0131-002,2012,5,18,17,618,516,1134,1030
0131-002,2012,5,18,18,624,678,1302,1134
0131-002,2012,5,18,19,647,646,1293,1302
0131-002,2012,5,18,20,481,513,994,1293
0131-002,2012,5,18,21,324,458,782,994
0131-002,2012,5,18,22,288,348,636,782
0131-002,2012,5,18,23,195,264,459,636
0131-002,2012,5,18,24,141,138,279,459
0131-002,2012,5,19,1,96,100,196,279
0131-002,2012,5,19,2,59,64,123,196
0131-002,2012,5,19,3,42,47,89,123
0131-002,2012,5,19,4,35,40,75,89
0131-002,2012,5,19,5,39,58,97,75
0131-002,2012,5,19,6,127,97,224,97
0131-002,2012,5,19,7,280,165,445,224
0131-002,2012,5,19,8,522,363,885,445
0131-002,2012,5,19,9,494,442,936,885
0131-002,2012,5,19,10,385,472,857,936
0131-002,2012,5,19,11,410,603,1013,857
0131-002,2012,5,19,12,407,612,1019,1013
0131-002,2012,5,19,13,397,568,965,1019
0131-002,2012,5,19,14,393,559,952,965
0131-002,2012,5,19,15,370,478,848,952
0131-002,2012,5,19,16,398,481,879,848
0131-002,2012,5,19,17,513,468,981,879
0131-002,2012,5,19,18,513,564,1077,981
0131-002,2012,5,19,19,442,491,933,1077
0131-002,2012,5,19,20,315,336,651,933
0131-002,2012,5,19,21,252,266,518,651
0131-002,2012,5,19,22,201,222,423,518
0131-002,2012,5,19,23,139,186,325,423
0131-002,2012,5,19,24,96,135,231,325
0131-002,2012,5,20,1,68,85,153,231
0131-002,2012,5,20,2,49,51,100,153
0131-002,2012,5,20,3,36,32,68,100
0131-002,2012,5,20,4,32,30,62,68
0131-002,2012,5,20,5,29,36,65,62
0131-002,2012,5,20,6,58,59,117,65
0131-002,2012,5,20,7,146,120,266,117
0131-002,2012,5,20,8,218,178,396,266
0131-002,2012,5,20,9,222,235,457,396
0131-002,2012,5,20,10,226,258,484,457
0131-002,2012,5,20,11,273,290,563,484
0131-002,2012,5,20,12,241,291,532,563
0131-002,2012,5,20,13,284,284,568,532
0131-002,2012,5,20,14,277,286,563,568
0131-002,2012,5,20,15,292,304,596,563
0131-002,2012,5,20,16,402,362,764,596
0131-002,2012,5,20,17,494,346,840,764
0131-002,2012,5,20,18,507,427,934,840
0131-002,2012,5,20,19,381,341,722,934
0131-002,2012,5,20,20,299,306,605,722
0131-002,2012,5,20,21,274,226,500,605
0131-002,2012,5,20,22,234,220,454,500
0131-002,2012,5,20,23,167,150,317,454
0131-002,2012,5,20,24,107,104,211,317
0131-002,2012,5,21,1,71,76,147,211
0131-002,2012,5,21,2,34,40,74,147
0131-002,2012,5,21,3,31,21,52,74
0131-002,2012,5,21,4,26,32,58,52
0131-002,2012,5,21,5,36,45,81,58
0131-002,2012,5,21,6,122,100,222,81
0131-002,2012,5,21,7,417,267,684,222
0131-002,2012,5,21,8,847,608,1455,684
0131-002,2012,5,21,9,652,580,1232,1455
0131-002,2012,5,21,10,510,504,1014,1232
0131-002,2012,5,21,11,478,520,998,1014
0131-002,2012,5,21,12,430,506,936,998
0131-002,2012,5,21,13,405,426,831,936
0131-002,2012,5,21,14,451,452,903,831
0131-002,2012,5,21,15,480,545,1025,903
0131-002,2012,5,21,16,479,504,983,1025
0131-002,2012,5,21,17,470,540,1010,983
0131-002,2012,5,21,18,480,598,1078,1010
0131-002,2012,5,21,19,414,562,976,1078
0131-002,2012,5,21,20,399,473,872,976
0131-002,2012,5,21,21,321,457,778,872
0131-002,2012,5,21,22,244,306,550,778
0131-002,2012,5,21,23,168,204,372,550
0131-002,2012,5,21,24,112,121,233,372
0131-002,2012,5,22,1,78,84,162,233
0131-002,2012,5,22,2,47,50,97,162
0131-002,2012,5,22,3,32,38,70,97
0131-002,2012,5,22,4,30,44,74,70
0131-002,2012,5,22,5,43,53,96,74
0131-002,2012,5,22,6,133,100,233,96
0131-002,2012,5,22,7,367,203,570,233
0131-002,2012,5,22,8,769,558,1327,570
0131-002,2012,5,22,9,592,632,1224,1327
0131-002,2012,5,22,10,511,524,1035,1224
0131-002,2012,5,22,11,506,537,1043,1035
0131-002,2012,5,22,12,459,474,933,1043
0131-002,2012,5,22,13,374,423,797,933
0131-002,2012,5,22,14,441,457,898,797
0131-002,2012,5,22,15,508,535,1043,898
0131-002,2012,5,22,16,507,513,1020,1043
0131-002,2012,5,22,17,492,528,1020,1020
0131-002,2012,5,22,18,465,606,1071,1020
0131-002,2012,5,22,19,468,580,1048,1071
0131-002,2012,5,22,20,347,501,848,1048
0131-002,2012,5,22,21,292,445,737,848
0131-002,2012,5,22,22,230,279,509,737
0131-002,2012,5,22,23,207,209,416,509
0131-002,2012,5,22,24,112,125,237,416
0131-002,2012,5,23,1,78,82,160,237
0131-002,2012,5,23,2,46,64,110,160
0131-002,2012,5,23,3,34,40,74,110
0131-002,2012,5,23,4,31,35,66,74
0131-002,2012,5,23,5,46,58,104,66
0131-002,2012,5,23,6,114,94,208,104
0131-002,2012,5,23,7,352,199,551,208
0131-002,2012,5,23,8,806,534,1340,551
0131-002,2012,5,23,9,654,636,1290,1340
0131-002,2012,5,23,10,496,527,1023,1290
0131-002,2012,5,23,11,509,539,1048,1023
0131-002,2012,5,23,12,502,600,1102,1048
0131-002,2012,5,23,13,358,436,794,1102
0131-002,2012,5,23,14,474,478,952,794
0131-002,2012,5,23,15,517,527,1044,952
0131-002,2012,5,23,16,475,521,996,1044
0131-002,2012,5,23,17,482,504,986,996
0131-002,2012,5,23,18,473,645,1118,986
0131-002,2012,5,23,19,516,610,1126,1118
0131-002,2012,5,23,20,357,460,817,1126
0131-002,2012,5,23,21,310,422,732,817
0131-002,2012,5,23,22,254,306,560,732
0131-002,2012,5,23,23,171,239,410,560
0131-002,2012,5,23,24,123,130,253,410
0131-002,2012,5,24,1,83,98,181,253
0131-002,2012,5,24,2,57,54,111,181
0131-002,2012,5,24,3,39,42,81,111
0131-002,2012,5,24,4,34,35,69,81
0131-002,2012,5,24,5,30,66,96,69
0131-002,2012,5,24,6,118,84,202,96
0131-002,2012,5,24,7,369,201,570,202
0131-002,2012,5,24,8,778,526,1304,570
0131-002,2012,5,24,9,617,635,1252,1304
0131-002,2012,5,24,10,462,504,966,1252
0131-002,2012,5,24,11,518,510,1028,966
0131-002,2012,5,24,12,473,490,963,1028
0131-002,2012,5,24,13,376,408,784,963
0131-002,2012,5,24,14,462,464,926,784
0131-002,2012,5,24,15,480,550,1030,926
0131-002,2012,5,24,16,488,544,1032,1030
0131-002,2012,5,24,17,474,522,996,1032
0131-002,2012,5,24,18,465,639,1104,996
0131-002,2012,5,24,19,467,556,1023,1104
0131-002,2012,5,24,20,360,437,797,1023
0131-002,2012,5,24,21,274,416,690,797
0131-002,2012,5,24,22,263,286,549,690
0131-002,2012,5,24,23,184,210,394,549
0131-002,2012,5,24,24,138,143,281,394
0131-002,2012,5,25,1,90,84,174,281
0131-002,2012,5,25,2,55,50,105,174
0131-002,2012,5,25,3,46,40,86,105
0131-002,2012,5,25,4,25,42,67,86
0131-002,2012,5,25,5,53,66,119,67
0131-002,2012,5,25,6,114,82,196,119
0131-002,2012,5,25,7,342,202,544,196
0131-002,2012,5,25,8,773,537,1310,544
0131-002,2012,5,25,9,638,622,1260,1310
0131-002,2012,5,25,10,557,532,1089,1260
0131-002,2012,5,25,11,520,564,1084,1089
0131-002,2012,5,25,12,481,529,1010,1084
0131-002,2012,5,25,13,426,558,984,1010
0131-002,2012,5,25,14,457,525,982,984
0131-002,2012,5,25,15,526,567,1093,982
0131-002,2012,5,25,16,535,556,1091,1093
0131-002,2012,5,25,17,548,628,1176,1091
0131-002,2012,5,25,18,633,779,1412,1176
0131-002,2012,5,25,19,574,794,1368,1412
0131-002,2012,5,25,20,471,738,1209,1368
0131-002,2012,5,25,21,361,662,1023,1209
0131-002,2012,5,25,22,287,508,795,1023
0131-002,2012,5,25,23,218,412,630,795
0131-002,2012,5,25,24,172,293,465,630
0131-002,2012,5,26,1,90,188,278,465
0131-002,2012,5,26,2,64,69,133,278
0131-002,2012,5,26,3,42,60,102,133
0131-002,2012,5,26,4,44,43,87,102
0131-002,2012,5,26,5,52,67,119,87
0131-002,2012,5,26,6,158,113,271,119
0131-002,2012,5,26,7,234,175,409,271
0131-002,2012,5,26,8,466,404,870,409
0131-002,2012,5,26,9,473,710,1183,870
0131-002,2012,5,26,10,408,817,1225,1183
0131-002,2012,5,26,11,472,784,1256,1225
0131-002,2012,5,26,12,543,654,1197,1256
0131-002,2012,5,26,13,483,642,1125,1197
0131-002,2012,5,26,14,412,714,1126,1125
0131-002,2012,5,26,15,418,834,1252,1126
0131-002,2012,5,26,16,460,850,1310,1252
0131-002,2012,5,26,17,464,907,1371,1310
0131-002,2012,5,26,18,474,952,1426,1371
0131-002,2012,5,26,19,471,948,1419,1426
0131-002,2012,5,26,20,356,864,1220,1419
0131-002,2012,5,26,21,268,773,1041,1220
0131-002,2012,5,26,22,214,483,697,1041
0131-002,2012,5,26,23,132,286,418,697
0131-002,2012,5,26,24,92,119,211,418
0131-002,2012,5,27,1,64,83,147,211
0131-002,2012,5,27,2,37,45,82,147
0131-002,2012,5,27,3,36,38,74,82
0131-002,2012,5,27,4,26,27,53,74
0131-002,2012,5,27,5,33,42,75,53
0131-002,2012,5,27,6,54,71,125,75
0131-002,2012,5,27,7,122,114,236,125
0131-002,2012,5,27,8,235,187,422,236
0131-002,2012,5,27,9,239,270,509,422
0131-002,2012,5,27,10,279,313,592,509
0131-002,2012,5,27,11,337,396,733,592
0131-002,2012,5,27,12,318,412,730,733
0131-002,2012,5,27,13,306,424,730,730
0131-002,2012,5,27,14,318,412,730,730
0131-002,2012,5,27,15,332,444,776,730
0131-002,2012,5,27,16,373,451,824,776
0131-002,2012,5,27,17,501,442,943,824
0131-002,2012,5,27,18,517,454,971,943
0131-002,2012,5,27,19,513,344,857,971
0131-002,2012,5,27,20,506,307,813,857
0131-002,2012,5,27,21,414,247,661,813
0131-002,2012,5,27,22,371,220,591,661
0131-002,2012,5,27,23,252,194,446,591
0131-002,2012,5,27,24,171,121,292,446
0131-002,2012,5,28,1,117,76,193,292
0131-002,2012,5,28,2,44,42,86,193
0131-002,2012,5,28,3,26,44,70,86
0131-002,2012,5,28,4,25,38,63,70
0131-002,2012,5,28,5,26,41,67,63
0131-002,2012,5,28,6,102,83,185,67
0131-002,2012,5,28,7,215,144,359,185
0131-002,2012,5,28,8,336,250,586,359
0131-002,2012,5,28,9,316,281,597,586
0131-002,2012,5,28,10,362,335,697,597
0131-002,2012,5,28,11,425,346,771,697
0131-002,2012,5,28,12,572,348,920,771
0131-002,2012,5,28,13,572,294,866,920
0131-002,2012,5,28,14,655,331,986,866
0131-002,2012,5,28,15,647,402,1049,986
0131-002,2012,5,28,16,651,370,1021,1049
0131-002,2012,5,28,17,670,371,1041,1021
0131-002,2012,5,28,18,670,408,1078,1041
0131-002,2012,5,28,19,578,355,933,1078
0131-002,2012,5,28,20,486,320,806,933
0131-002,2012,5,28,21,332,267,599,806
0131-002,2012,5,28,22,302,207,509,599
0131-002,2012,5,28,23,163,162,325,509
0131-002,2012,5,28,24,111,70,181,325
0131-002,2012,5,29,1,73,61,134,181
0131-002,2012,5,29,2,28,28,56,134
0131-002,2012,5,29,3,36,21,57,56
0131-002,2012,5,29,4,25,36,61,57
0131-002,2012,5,29,5,52,47,99,61
0131-002,2012,5,29,6,119,110,229,99
0131-002,2012,5,29,7,426,250,676,229
0131-002,2012,5,29,8,836,625,1461,676
0131-002,2012,5,29,9,656,620,1276,1461
0131-002,2012,5,29,10,507,484,991,1276
0131-002,2012,5,29,11,472,530,1002,991
0131-002,2012,5,29,12,475,508,983,1002
0131-002,2012,5,29,13,382,439,821,983
0131-002,2012,5,29,14,478,477,955,821
0131-002,2012,5,29,15,528,527,1055,955
0131-002,2012,5,29,16,522,564,1086,1055
0131-002,2012,5,29,17,478,547,1025,1086
0131-002,2012,5,29,18,438,568,1006,1025
0131-002,2012,5,29,19,484,592,1076,1006
0131-002,2012,5,29,20,350,484,834,1076
0131-002,2012,5,29,21,312,439,751,834
0131-002,2012,5,29,22,247,312,559,751
0131-002,2012,5,29,23,190,204,394,559
0131-002,2012,5,29,24,103,97,200,394
0131-002,2012,5,30,1,71,78,149,200
0131-002,2012,5,30,2,49,47,96,149
0131-002,2012,5,30,3,32,41,73,96
0131-002,2012,5,30,4,43,46,89,73
0131-002,2012,5,30,5,45,52,97,89
0131-002,2012,5,30,6,102,100,202,97
0131-002,2012,5,30,7,329,171,500,202
0131-002,2012,5,30,8,746,537,1283,500
0131-002,2012,5,30,9,646,610,1256,1283
0131-002,2012,5,30,10,476,520,996,1256
0131-002,2012,5,30,11,490,520,1010,996
0131-002,2012,5,30,12,484,473,957,1010
0131-002,2012,5,30,13,394,432,826,957
0131-002,2012,5,30,14,434,471,905,826
0131-002,2012,5,30,15,494,544,1038,905
0131-002,2012,5,30,16,466,523,989,1038
0131-002,2012,5,30,17,456,492,948,989
0131-002,2012,5,30,18,470,601,1071,948
0131-002,2012,5,30,19,487,621,1108,1071
0131-002,2012,5,30,20,363,447,810,1108
0131-002,2012,5,30,21,280,377,657,810
0131-002,2012,5,30,22,236,296,532,657
0131-002,2012,5,30,23,182,210,392,532
0131-002,2012,5,30,24,113,121,234,392
0131-002,2012,5,31,1,79,86,165,234
0131-002,2012,5,31,2,48,47,95,165
0131-002,2012,5,31,3,33,40,73,95
0131-002,2012,5,31,4,35,42,77,73
0131-002,2012,5,31,5,34,55,89,77
0131-002,2012,5,31,6,108,88,196,89
0131-002,2012,5,31,7,336,199,535,196
0131-002,2012,5,31,8,778,562,1340,535
0131-002,2012,5,31,9,636,631,1267,1340
0131-002,2012,5,31,10,509,542,1051,1267
0131-002,2012,5,31,11,522,532,1054,1051
0131-002,2012,5,31,12,445,514,959,1054
0131-002,2012,5,31,13,396,426,822,959
0131-002,2012,5,31,14,440,491,931,822
0131-002,2012,5,31,15,478,545,1023,931
0131-002,2012,5,31,16,518,574,1092,1023
0131-002,2012,5,31,17,479,508,987,1092
0131-002,2012,5,31,18,442,574,1016,987
0131-002,2012,5,31,19,466,599,1065,1016
0131-002,2012,5,31,20,369,454,823,1065
0131-002,2012,5,31,21,300,421,721,823
0131-002,2012,5,31,22,273,313,586,721
0131-002,2012,5,31,23,193,204,397,586
0131-002,2012,5,31,24,126,149,275,397
0131-002,2012,6,1,1,83,80,163,275
0131-002,2012,6,1,2,60,52,112,163
0131-002,2012,6,1,3,30,52,82,112
0131-002,2012,6,1,4,34,54,88,82
0131-002,2012,6,1,5,51,53,104,88
0131-002,2012,6,1,6,119,95,214,104
0131-002,2012,6,1,7,351,186,537,214
0131-002,2012,6,1,8,765,507,1272,537
0131-002,2012,6,1,9,577,599,1176,1272
0131-002,2012,6,1,10,479,490,969,1176
0131-002,2012,6,1,11,456,526,982,969
0131-002,2012,6,1,12,462,508,970,982
0131-002,2012,6,1,13,386,454,840,970
0131-002,2012,6,1,14,476,506,982,840
0131-002,2012,6,1,15,510,520,1030,982
0131-002,2012,6,1,16,511,556,1067,1030
0131-002,2012,6,1,17,454,538,992,1067
0131-002,2012,6,1,18,496,670,1166,992
0131-002,2012,6,1,19,598,606,1204,1166
0131-002,2012,6,1,20,408,553,961,1204
0131-002,2012,6,1,21,314,461,775,961
0131-002,2012,6,1,22,300,340,640,775
0131-002,2012,6,1,23,235,239,474,640
0131-002,2012,6,1,24,191,142,333,474
0131-002,2012,6,2,1,106,97,203,333
0131-002,2012,6,2,2,64,64,128,203
0131-002,2012,6,2,3,46,42,88,128
0131-002,2012,6,2,4,48,48,96,88
0131-002,2012,6,2,5,48,52,100,96
0131-002,2012,6,2,6,112,85,197,100
0131-002,2012,6,2,7,233,171,404,197
0131-002,2012,6,2,8,438,339,777,404
0131-002,2012,6,2,9,445,454,899,777
0131-002,2012,6,2,10,426,546,972,899
0131-002,2012,6,2,11,388,663,1051,972
0131-002,2012,6,2,12,446,702,1148,1051
0131-002,2012,6,2,13,490,678,1168,1148
0131-002,2012,6,2,14,400,627,1027,1168
0131-002,2012,6,2,15,445,558,1003,1027
0131-002,2012,6,2,16,442,491,933,1003
0131-002,2012,6,2,17,506,517,1023,933
0131-002,2012,6,2,18,550,597,1147,1023
0131-002,2012,6,2,19,554,492,1046,1147
0131-002,2012,6,2,20,331,322,653,1046
0131-002,2012,6,2,21,245,250,495,653
0131-002,2012,6,2,22,196,224,420,495
0131-002,2012,6,2,23,154,172,326,420
0131-002,2012,6,2,24,110,113,223,326
0131-002,2012,6,3,1,80,86,166,223
0131-002,2012,6,3,2,51,52,103,166
0131-002,2012,6,3,3,40,52,92,103
0131-002,2012,6,3,4,30,32,62,92
0131-002,2012,6,3,5,36,40,76,62
0131-002,2012,6,3,6,64,59,123,76
0131-002,2012,6,3,7,162,105,267,123
0131-002,2012,6,3,8,230,153,383,267
0131-002,2012,6,3,9,219,223,442,383
0131-002,2012,6,3,10,249,263,512,442
0131-002,2012,6,3,11,307,283,590,512
0131-002,2012,6,3,12,251,298,549,590
0131-002,2012,6,3,13,264,304,568,549
0131-002,2012,6,3,14,274,302,576,568
0131-002,2012,6,3,15,316,353,669,576
0131-002,2012,6,3,16,409,324,733,669
0131-002,2012,6,3,17,515,335,850,733
0131-002,2012,6,3,18,509,378,887,850
0131-002,2012,6,3,19,518,327,845,887
0131-002,2012,6,3,20,327,274,601,845
0131-002,2012,6,3,21,244,262,506,601
0131-002,2012,6,3,22,231,243,474,506
0131-002,2012,6,3,23,180,176,356,474
0131-002,2012,6,3,24,112,112,224,356
0131-002,2012,6,4,1,69,59,128,224
0131-002,2012,6,4,2,42,30,72,128
0131-002,2012,6,4,3,22,30,52,72
0131-002,2012,6,4,4,30,32,62,52
0131-002,2012,6,4,5,36,54,90,62
0131-002,2012,6,4,6,130,94,224,90
0131-002,2012,6,4,7,428,247,675,224
0131-002,2012,6,4,8,859,580,1439,675
0131-002,2012,6,4,9,636,620,1256,1439
0131-002,2012,6,4,10,460,490,950,1256
0131-002,2012,6,4,11,498,501,999,950
0131-002,2012,6,4,12,474,475,949,999
0131-002,2012,6,4,13,378,468,846,949
0131-002,2012,6,4,14,490,490,980,846
0131-002,2012,6,4,15,495,558,1053,980
0131-002,2012,6,4,16,497,562,1059,1053
0131-002,2012,6,4,17,453,552,1005,1059
0131-002,2012,6,4,18,462,611,1073,1005
0131-002,2012,6,4,19,469,559,1028,1073
0131-002,2012,6,4,20,376,490,866,1028
0131-002,2012,6,4,21,300,466,766,866
0131-002,2012,6,4,22,256,331,587,766
0131-002,2012,6,4,23,180,205,385,587
0131-002,2012,6,4,24,132,115,247,385
0131-002,2012,6,5,1,68,74,142,247
0131-002,2012,6,5,2,58,48,106,142
0131-002,2012,6,5,3,43,40,83,106
0131-002,2012,6,5,4,36,44,80,83
0131-002,2012,6,5,5,36,54,90,80
0131-002,2012,6,5,6,102,101,203,90
0131-002,2012,6,5,7,347,205,552,203
0131-002,2012,6,5,8,827,515,1342,552
0131-002,2012,6,5,9,631,598,1229,1342
0131-002,2012,6,5,10,520,548,1068,1229
0131-002,2012,6,5,11,518,545,1063,1068
0131-002,2012,6,5,12,461,508,969,1063
0131-002,2012,6,5,13,410,418,828,969
0131-002,2012,6,5,14,487,518,1005,828
0131-002,2012,6,5,15,523,511,1034,1005
0131-002,2012,6,5,16,532,544,1076,1034
0131-002,2012,6,5,17,524,540,1064,1076
0131-002,2012,6,5,18,564,713,1277,1064
0131-002,2012,6,5,19,534,635,1169,1277
0131-002,2012,6,5,20,420,508,928,1169
0131-002,2012,6,5,21,318,494,812,928
0131-002,2012,6,5,22,298,348,646,812
0131-002,2012,6,5,23,196,233,429,646
0131-002,2012,6,5,24,123,150,273,429
0131-002,2012,6,6,1,87,97,184,273
0131-002,2012,6,6,2,58,74,132,184
0131-002,2012,6,6,3,48,52,100,132
0131-002,2012,6,6,4,45,52,97,100
0131-002,2012,6,6,5,44,55,99,97
0131-002,2012,6,6,6,116,87,203,99
0131-002,2012,6,6,7,225,169,394,203
0131-002,2012,6,6,8,458,334,792,394
0131-002,2012,6,6,9,429,369,798,792
0131-002,2012,6,6,10,338,380,718,798
0131-002,2012,6,6,11,391,384,775,718
0131-002,2012,6,6,12,364,374,738,775
0131-002,2012,6,6,13,311,353,664,738
0131-002,2012,6,6,14,360,321,681,664
0131-002,2012,6,6,15,384,415,799,681
0131-002,2012,6,6,16,347,382,729,799
0131-002,2012,6,6,17,364,400,764,729
0131-002,2012,6,6,18,362,514,876,764
0131-002,2012,6,6,19,341,412,753,876
0131-002,2012,6,6,20,291,326,617,753
0131-002,2012,6,6,21,216,296,512,617
0131-002,2012,6,6,22,191,216,407,512
0131-002,2012,6,6,23,151,158,309,407
0131-002,2012,6,6,24,104,98,202,309
0131-002,2012,6,7,1,66,53,119,202
0131-002,2012,6,7,2,35,46,81,119
0131-002,2012,6,7,3,29,21,50,81
0131-002,2012,6,7,4,26,34,60,50
0131-002,2012,6,7,5,34,44,78,60
0131-002,2012,6,7,6,120,88,208,78
0131-002,2012,6,7,7,379,224,603,208
0131-002,2012,6,7,8,829,598,1427,603
0131-002,2012,6,7,9,645,621,1266,1427
0131-002,2012,6,7,10,481,520,1001,1266
0131-002,2012,6,7,11,500,519,1019,1001
0131-002,2012,6,7,12,445,523,968,1019
0131-002,2012,6,7,13,381,459,840,968
0131-002,2012,6,7,14,503,546,1049,840
0131-002,2012,6,7,15,538,569,1107,1049
0131-002,2012,6,7,16,530,535,1065,1107
0131-002,2012,6,7,17,514,540,1054,1065
0131-002,2012,6,7,18,564,607,1171,1054
0131-002,2012,6,7,19,513,575,1088,1171
0131-002,2012,6,7,20,380,477,857,1088
0131-002,2012,6,7,21,298,436,734,857
0131-002,2012,6,7,22,268,321,589,734
0131-002,2012,6,7,23,188,184,372,589
0131-002,2012,6,7,24,154,138,292,372
0131-002,2012,6,8,1,88,79,167,292
0131-002,2012,6,8,2,67,59,126,167
0131-002,2012,6,8,3,42,39,81,126
0131-002,2012,6,8,4,40,33,73,81
0131-002,2012,6,8,5,46,60,106,73
0131-002,2012,6,8,6,120,97,217,106
0131-002,2012,6,8,7,356,188,544,217
0131-002,2012,6,8,8,762,546,1308,544
0131-002,2012,6,8,9,624,635,1259,1308
0131-002,2012,6,8,10,517,520,1037,1259
0131-002,2012,6,8,11,486,504,990,1037
0131-002,2012,6,8,12,519,519,1038,990
0131-002,2012,6,8,13,423,463,886,1038
0131-002,2012,6,8,14,473,522,995,886
0131-002,2012,6,8,15,504,620,1124,995
0131-002,2012,6,8,16,496,579,1075,1124
0131-002,2012,6,8,17,522,562,1084,1075
0131-002,2012,6,8,18,597,618,1215,1084
0131-002,2012,6,8,19,568,616,1184,1215
0131-002,2012,6,8,20,478,559,1037,1184
0131-002,2012,6,8,21,336,476,812,1037
0131-002,2012,6,8,22,306,366,672,812
0131-002,2012,6,8,23,186,216,402,672
0131-002,2012,6,8,24,132,133,265,402
0131-002,2012,6,9,1,93,87,180,265
0131-002,2012,6,9,2,58,69,127,180
0131-002,2012,6,9,3,44,36,80,127
0131-002,2012,6,9,4,43,51,94,80
0131-002,2012,6,9,5,42,68,110,94
0131-002,2012,6,9,6,118,100,218,110
0131-002,2012,6,9,7,237,172,409,218
0131-002,2012,6,9,8,435,329,764,409
0131-002,2012,6,9,9,466,458,924,764
0131-002,2012,6,9,10,436,519,955,924
0131-002,2012,6,9,11,408,653,1061,955
0131-002,2012,6,9,12,445,658,1103,1061
0131-002,2012,6,9,13,429,636,1065,1103
0131-002,2012,6,9,14,419,547,966,1065
0131-002,2012,6,9,15,404,568,972,966
0131-002,2012,6,9,16,438,578,1016,972
0131-002,2012,6,9,17,472,630,1102,1016
0131-002,2012,6,9,18,508,652,1160,1102
0131-002,2012,6,9,19,492,598,1090,1160
0131-002,2012,6,9,20,333,351,684,1090
0131-002,2012,6,9,21,248,294,542,684
0131-002,2012,6,9,22,214,229,443,542
0131-002,2012,6,9,23,165,187,352,443
0131-002,2012,6,9,24,114,123,237,352
0131-002,2012,6,10,1,85,90,175,237
0131-002,2012,6,10,2,52,53,105,175
0131-002,2012,6,10,3,40,48,88,105
0131-002,2012,6,10,4,29,36,65,88
0131-002,2012,6,10,5,48,54,102,65
0131-002,2012,6,10,6,77,60,137,102
0131-002,2012,6,10,7,135,106,241,137
0131-002,2012,6,10,8,173,162,335,241
0131-002,2012,6,10,9,225,204,429,335
0131-002,2012,6,10,10,214,246,460,429
0131-002,2012,6,10,11,225,324,549,460
0131-002,2012,6,10,12,277,279,556,549
0131-002,2012,6,10,13,310,281,591,556
0131-002,2012,6,10,14,307,360,667,591
0131-002,2012,6,10,15,454,323,777,667
0131-002,2012,6,10,16,488,360,848,777
0131-002,2012,6,10,17,496,369,865,848
0131-002,2012,6,10,18,567,368,935,865
0131-002,2012,6,10,19,511,312,823,935
0131-002,2012,6,10,20,335,280,615,823
0131-002,2012,6,10,21,305,263,568,615
0131-002,2012,6,10,22,268,230,498,568
0131-002,2012,6,10,23,166,148,314,498
0131-002,2012,6,10,24,118,93,211,314
0131-002,2012,6,11,1,66,65,131,211
0131-002,2012,6,11,2,40,34,74,131
0131-002,2012,6,11,3,31,18,49,74
0131-002,2012,6,11,4,24,30,54,49
0131-002,2012,6,11,5,42,48,90,54
0131-002,2012,6,11,6,136,111,247,90
0131-002,2012,6,11,7,438,255,693,247
0131-002,2012,6,11,8,833,583,1416,693
0131-002,2012,6,11,9,628,641,1269,1416
0131-002,2012,6,11,10,442,507,949,1269
0131-002,2012,6,11,11,493,487,980,949
0131-002,2012,6,11,12,452,497,949,980
0131-002,2012,6,11,13,374,437,811,949
0131-002,2012,6,11,14,502,489,991,811
0131-002,2012,6,11,15,526,570,1096,991
0131-002,2012,6,11,16,495,541,1036,1096
0131-002,2012,6,11,17,462,538,1000,1036
0131-002,2012,6,11,18,445,582,1027,1000
0131-002,2012,6,11,19,448,555,1003,1027
0131-002,2012,6,11,20,365,504,869,1003
0131-002,2012,6,11,21,270,484,754,869
0131-002,2012,6,11,22,270,312,582,754
0131-002,2012,6,11,23,174,174,348,582
0131-002,2012,6,11,24,120,100,220,348
0131-002,2012,6,12,1,77,67,144,220
0131-002,2012,6,12,2,47,43,90,144
0131-002,2012,6,12,3,46,34,80,90
0131-002,2012,6,12,4,22,36,58,80
0131-002,2012,6,12,5,43,48,91,58
0131-002,2012,6,12,6,117,103,220,91
0131-002,2012,6,12,7,374,186,560,220
0131-002,2012,6,12,8,761,573,1334,560
0131-002,2012,6,12,9,620,628,1248,1334
0131-002,2012,6,12,10,495,564,1059,1248
0131-002,2012,6,12,11,525,512,1037,1059
0131-002,2012,6,12,12,475,508,983,1037
0131-002,2012,6,12,13,386,424,810,983
0131-002,2012,6,12,14,487,528,1015,810
0131-002,2012,6,12,15,520,553,1073,1015
0131-002,2012,6,12,16,506,539,1045,1073
0131-002,2012,6,12,17,496,543,1039,1045
0131-002,2012,6,12,18,474,586,1060,1039
0131-002,2012,6,12,19,497,586,1083,1060
0131-002,2012,6,12,20,394,530,924,1083
0131-002,2012,6,12,21,261,436,697,924
0131-002,2012,6,12,22,246,284,530,697
0131-002,2012,6,12,23,172,196,368,530
0131-002,2012,6,12,24,114,102,216,368
0131-002,2012,6,13,1,72,84,156,216
0131-002,2012,6,13,2,42,47,89,156
0131-002,2012,6,13,3,32,38,70,89
0131-002,2012,6,13,4,34,40,74,70
0131-002,2012,6,13,5,47,58,105,74
0131-002,2012,6,13,6,132,96,228,105
0131-002,2012,6,13,7,370,208,578,228
0131-002,2012,6,13,8,769,534,1303,578
0131-002,2012,6,13,9,660,639,1299,1303
0131-002,2012,6,13,10,506,513,1019,1299
0131-002,2012,6,13,11,516,544,1060,1019
0131-002,2012,6,13,12,446,552,998,1060
0131-002,2012,6,13,13,373,427,800,998
0131-002,2012,6,13,14,454,446,900,800
0131-002,2012,6,13,15,501,552,1053,900
0131-002,2012,6,13,16,498,543,1041,1053
0131-002,2012,6,13,17,492,529,1021,1041
0131-002,2012,6,13,18,498,628,1126,1021
0131-002,2012,6,13,19,491,628,1119,1126
0131-002,2012,6,13,20,370,503,873,1119
0131-002,2012,6,13,21,270,419,689,873
0131-002,2012,6,13,22,280,305,585,689
0131-002,2012,6,13,23,180,211,391,585
0131-002,2012,6,13,24,112,112,224,391
0131-002,2012,6,14,1,81,84,165,224
0131-002,2012,6,14,2,40,53,93,165
0131-002,2012,6,14,3,31,34,65,93
0131-002,2012,6,14,4,30,39,69,65
0131-002,2012,6,14,5,52,57,109,69
0131-002,2012,6,14,6,130,95,225,109
0131-002,2012,6,14,7,378,208,586,225
0131-002,2012,6,14,8,774,564,1338,586
0131-002,2012,6,14,9,610,641,1251,1338
0131-002,2012,6,14,10,472,536,1008,1251
0131-002,2012,6,14,11,476,522,998,1008
0131-002,2012,6,14,12,471,515,986,998
0131-002,2012,6,14,13,369,468,837,986
0131-002,2012,6,14,14,461,462,923,837
0131-002,2012,6,14,15,468,553,1021,923
0131-002,2012,6,14,16,495,545,1040,1021
0131-002,2012,6,14,17,486,505,991,1040
0131-002,2012,6,14,18,460,633,1093,991
0131-002,2012,6,14,19,469,558,1027,1093
0131-002,2012,6,14,20,367,489,856,1027
0131-002,2012,6,14,21,292,447,739,856
0131-002,2012,6,14,22,295,298,593,739
0131-002,2012,6,14,23,198,205,403,593
0131-002,2012,6,14,24,114,148,262,403
0131-002,2012,6,15,1,84,89,173,262
0131-002,2012,6,15,2,72,59,131,173
0131-002,2012,6,15,3,46,52,98,131
0131-002,2012,6,15,4,30,38,68,98
0131-002,2012,6,15,5,54,59,113,68
0131-002,2012,6,15,6,132,108,240,113
0131-002,2012,6,15,7,356,217,573,240
0131-002,2012,6,15,8,747,525,1272,573
0131-002,2012,6,15,9,663,630,1293,1272
0131-002,2012,6,15,10,520,483,1003,1293
0131-002,2012,6,15,11,477,534,1011,1003
0131-002,2012,6,15,12,444,509,953,1011
0131-002,2012,6,15,13,365,424,789,953
0131-002,2012,6,15,14,464,496,960,789
0131-002,2012,6,15,15,522,576,1098,960
0131-002,2012,6,15,16,556,558,1114,1098
0131-002,2012,6,15,17,528,587,1115,1114
0131-002,2012,6,15,18,555,695,1250,1115
0131-002,2012,6,15,19,590,641,1231,1250
0131-002,2012,6,15,20,436,577,1013,1231
0131-002,2012,6,15,21,324,445,769,1013
0131-002,2012,6,15,22,313,357,670,769
0131-002,2012,6,15,23,183,238,421,670
0131-002,2012,6,15,24,126,135,261,421
0131-002,2012,6,16,1,93,105,198,261
0131-002,2012,6,16,2,54,64,118,198
0131-002,2012,6,16,3,45,52,97,118
0131-002,2012,6,16,4,36,45,81,97
0131-002,2012,6,16,5,39,70,109,81
0131-002,2012,6,16,6,136,111,247,109
0131-002,2012,6,16,7,249,190,439,247
0131-002,2012,6,16,8,453,342,795,439
0131-002,2012,6,16,9,475,468,943,795
0131-002,2012,6,16,10,456,475,931,943
0131-002,2012,6,16,11,429,645,1074,931
0131-002,2012,6,16,12,426,662,1088,1074
0131-002,2012,6,16,13,396,637,1033,1088
0131-002,2012,6,16,14,419,642,1061,1033
0131-002,2012,6,16,15,438,607,1045,1061
0131-002,2012,6,16,16,442,552,994,1045
0131-002,2012,6,16,17,480,603,1083,994
0131-002,2012,6,16,18,529,657,1186,1083
0131-002,2012,6,16,19,465,595,1060,1186
0131-002,2012,6,16,20,328,426,754,1060
0131-002,2012,6,16,21,262,286,548,754
0131-002,2012,6,16,22,231,258,489,548
0131-002,2012,6,16,23,148,184,332,489
0131-002,2012,6,16,24,94,128,222,332
0131-002,2012,6,17,1,84,92,176,222
0131-002,2012,6,17,2,57,61,118,176
0131-002,2012,6,17,3,41,46,87,118
0131-002,2012,6,17,4,37,28,65,87
0131-002,2012,6,17,5,34,46,80,65
0131-002,2012,6,17,6,62,72,134,80
0131-002,2012,6,17,7,138,115,253,134
0131-002,2012,6,17,8,174,140,314,253
0131-002,2012,6,17,9,223,236,459,314
0131-002,2012,6,17,10,204,267,471,459
0131-002,2012,6,17,11,255,340,595,471
0131-002,2012,6,17,12,384,290,674,595
0131-002,2012,6,17,13,401,307,708,674
0131-002,2012,6,17,14,346,318,664,708
0131-002,2012,6,17,15,497,379,876,664
0131-002,2012,6,17,16,504,342,846,876
0131-002,2012,6,17,17,528,339,867,846
0131-002,2012,6,17,18,598,374,972,867
0131-002,2012,6,17,19,556,366,922,972
0131-002,2012,6,17,20,450,310,760,922
0131-002,2012,6,17,21,304,277,581,760
0131-002,2012,6,17,22,272,243,515,581
0131-002,2012,6,17,23,156,172,328,515
0131-002,2012,6,17,24,111,92,203,328
0131-002,2012,6,18,1,64,55,119,203
0131-002,2012,6,18,2,42,32,74,119
0131-002,2012,6,18,3,27,28,55,74
0131-002,2012,6,18,4,26,29,55,55
0131-002,2012,6,18,5,48,53,101,55
0131-002,2012,6,18,6,124,118,242,101
0131-002,2012,6,18,7,457,270,727,242
0131-002,2012,6,18,8,796,562,1358,727
0131-002,2012,6,18,9,604,604,1208,1358
0131-002,2012,6,18,10,477,495,972,1208
0131-002,2012,6,18,11,482,486,968,972
0131-002,2012,6,18,12,465,501,966,968
0131-002,2012,6,18,13,394,547,941,966
0131-002,2012,6,18,14,454,585,1039,941
0131-002,2012,6,18,15,494,614,1108,1039
0131-002,2012,6,18,16,529,570,1099,1108
0131-002,2012,6,18,17,446,540,986,1099
0131-002,2012,6,18,18,494,627,1121,986
0131-002,2012,6,18,19,454,541,995,1121
0131-002,2012,6,18,20,378,480,858,995
0131-002,2012,6,18,21,292,409,701,858
0131-002,2012,6,18,22,279,344,623,701
0131-002,2012,6,18,23,148,197,345,623
0131-002,2012,6,18,24,116,112,228,345
0131-002,2012,6,19,1,75,70,145,228
0131-002,2012,6,19,2,46,46,92,145
0131-002,2012,6,19,3,32,45,77,92
0131-002,2012,6,19,4,43,34,77,77
0131-002,2012,6,19,5,62,57,119,77
0131-002,2012,6,19,6,130,99,229,119
0131-002,2012,6,19,7,376,212,588,229
0131-002,2012,6,19,8,762,541,1303,588
0131-002,2012,6,19,9,595,603,1198,1303
0131-002,2012,6,19,10,496,528,1024,1198
0131-002,2012,6,19,11,513,569,1082,1024
0131-002,2012,6,19,12,474,494,968,1082
0131-002,2012,6,19,13,388,497,885,968
0131-002,2012,6,19,14,473,505,978,885
0131-002,2012,6,19,15,524,575,1099,978
0131-002,2012,6,19,16,508,544,1052,1099
0131-002,2012,6,19,17,481,540,1021,1052
0131-002,2012,6,19,18,486,604,1090,1021
0131-002,2012,6,19,19,454,598,1052,1090
0131-002,2012,6,19,20,385,450,835,1052
0131-002,2012,6,19,21,314,466,780,835
0131-002,2012,6,19,22,280,321,601,780
0131-002,2012,6,19,23,180,222,402,601
0131-002,2012,6,19,24,118,121,239,402
0131-002,2012,6,20,1,76,82,158,239
0131-002,2012,6,20,2,60,64,124,158
0131-002,2012,6,20,3,32,37,69,124
0131-002,2012,6,20,4,37,50,87,69
0131-002,2012,6,20,5,46,70,116,87
0131-002,2012,6,20,6,119,112,231,116
0131-002,2012,6,20,7,388,190,578,231
0131-002,2012,6,20,8,761,553,1314,578
0131-002,2012,6,20,9,639,613,1252,1314
0131-002,2012,6,20,10,525,515,1040,1252
0131-002,2012,6,20,11,510,486,996,1040
0131-002,2012,6,20,12,461,527,988,996
0131-002,2012,6,20,13,395,447,842,988
0131-002,2012,6,20,14,428,515,943,842
0131-002,2012,6,20,15,482,580,1062,943
0131-002,2012,6,20,16,534,545,1079,1062
0131-002,2012,6,20,17,512,558,1070,1079
0131-002,2012,6,20,18,498,628,1126,1070
0131-002,2012,6,20,19,516,600,1116,1126
0131-002,2012,6,20,20,410,464,874,1116
0131-002,2012,6,20,21,291,436,727,874
0131-002,2012,6,20,22,265,306,571,727
0131-002,2012,6,20,23,182,238,420,571
0131-002,2012,6,20,24,128,119,247,420
0131-002,2012,6,21,1,92,96,188,247
0131-002,2012,6,21,2,48,66,114,188
0131-002,2012,6,21,3,44,31,75,114
0131-002,2012,6,21,4,26,32,58,75
0131-002,2012,6,21,5,52,66,118,58
0131-002,2012,6,21,6,123,96,219,118
0131-002,2012,6,21,7,389,228,617,219
0131-002,2012,6,21,8,770,552,1322,617
0131-002,2012,6,21,9,695,625,1320,1322
0131-002,2012,6,21,10,528,504,1032,1320
0131-002,2012,6,21,11,529,530,1059,1032
0131-002,2012,6,21,12,520,526,1046,1059
0131-002,2012,6,21,13,376,444,820,1046
0131-002,2012,6,21,14,397,526,923,820
0131-002,2012,6,21,15,542,597,1139,923
0131-002,2012,6,21,16,521,547,1068,1139
0131-002,2012,6,21,17,496,532,1028,1068
0131-002,2012,6,21,18,465,637,1102,1028
0131-002,2012,6,21,19,462,561,1023,1102
0131-002,2012,6,21,20,378,486,864,1023
0131-002,2012,6,21,21,308,456,764,864
0131-002,2012,6,21,22,276,337,613,764
0131-002,2012,6,21,23,197,230,427,613
0131-002,2012,6,21,24,118,130,248,427
0131-002,2012,6,22,1,76,92,168,248
0131-002,2012,6,22,2,54,58,112,168
0131-002,2012,6,22,3,52,34,86,112
0131-002,2012,6,22,4,35,42,77,86
0131-002,2012,6,22,5,53,67,120,77
0131-002,2012,6,22,6,120,106,226,120
0131-002,2012,6,22,7,376,201,577,226
0131-002,2012,6,22,8,749,569,1318,577
0131-002,2012,6,22,9,665,615,1280,1318
0131-002,2012,6,22,10,532,562,1094,1280
0131-002,2012,6,22,11,564,568,1132,1094
0131-002,2012,6,22,12,498,555,1053,1132
0131-002,2012,6,22,13,432,454,886,1053
0131-002,2012,6,22,14,481,498,979,886
0131-002,2012,6,22,15,517,586,1103,979
0131-002,2012,6,22,16,494,555,1049,1103
0131-002,2012,6,22,17,542,582,1124,1049
0131-002,2012,6,22,18,570,704,1274,1124
0131-002,2012,6,22,19,586,787,1373,1274
0131-002,2012,6,22,20,464,671,1135,1373
0131-002,2012,6,22,21,348,519,867,1135
0131-002,2012,6,22,22,289,364,653,867
0131-002,2012,6,22,23,208,238,446,653
0131-002,2012,6,22,24,159,150,309,446
0131-002,2012,6,23,1,108,97,205,309
0131-002,2012,6,23,2,70,76,146,205
0131-002,2012,6,23,3,57,52,109,146
0131-002,2012,6,23,4,40,74,114,109
0131-002,2012,6,23,5,62,64,126,114
0131-002,2012,6,23,6,136,116,252,126
0131-002,2012,6,23,7,267,191,458,252
0131-002,2012,6,23,8,433,318,751,458
0131-002,2012,6,23,9,484,490,974,751
0131-002,2012,6,23,10,442,529,971,974
0131-002,2012,6,23,11,473,567,1040,971
0131-002,2012,6,23,12,510,630,1140,1040
0131-002,2012,6,23,13,403,611,1014,1140
0131-002,2012,6,23,14,399,610,1009,1014
0131-002,2012,6,23,15,484,623,1107,1009
0131-002,2012,6,23,16,430,648,1078,1107
0131-002,2012,6,23,17,454,630,1084,1078
0131-002,2012,6,23,18,507,678,1185,1084
0131-002,2012,6,23,19,541,569,1110,1185
0131-002,2012,6,23,20,328,396,724,1110
0131-002,2012,6,23,21,295,302,597,724
0131-002,2012,6,23,22,244,216,460,597
0131-002,2012,6,23,23,168,204,372,460
0131-002,2012,6,23,24,113,108,221,372
0131-002,2012,6,24,1,82,96,178,221
0131-002,2012,6,24,2,62,55,117,178
0131-002,2012,6,24,3,39,64,103,117
0131-002,2012,6,24,4,34,40,74,103
0131-002,2012,6,24,5,36,40,76,74
0131-002,2012,6,24,6,74,55,129,76
0131-002,2012,6,24,7,151,118,269,129
0131-002,2012,6,24,8,208,178,386,269
0131-002,2012,6,24,9,238,240,478,386
0131-002,2012,6,24,10,253,286,539,478
0131-002,2012,6,24,11,276,363,639,539
0131-002,2012,6,24,12,291,331,622,639
0131-002,2012,6,24,13,302,299,601,622
0131-002,2012,6,24,14,337,346,683,601
0131-002,2012,6,24,15,354,333,687,683
0131-002,2012,6,24,16,460,361,821,687
0131-002,2012,6,24,17,537,375,912,821
0131-002,2012,6,24,18,557,421,978,912
0131-002,2012,6,24,19,566,343,909,978
0131-002,2012,6,24,20,414,300,714,909
0131-002,2012,6,24,21,384,270,654,714
0131-002,2012,6,24,22,300,242,542,654
0131-002,2012,6,24,23,190,168,358,542
0131-002,2012,6,24,24,124,104,228,358
0131-002,2012,6,25,1,70,55,125,228
0131-002,2012,6,25,2,40,39,79,125
0131-002,2012,6,25,3,33,28,61,79
0131-002,2012,6,25,4,28,30,58,61
0131-002,2012,6,25,5,47,61,108,58
0131-002,2012,6,25,6,126,118,244,108
0131-002,2012,6,25,7,399,266,665,244
0131-002,2012,6,25,8,825,594,1419,665
0131-002,2012,6,25,9,614,594,1208,1419
0131-002,2012,6,25,10,480,500,980,1208
0131-002,2012,6,25,11,463,532,995,980
0131-002,2012,6,25,12,492,582,1074,995
0131-002,2012,6,25,13,383,457,840,1074
0131-002,2012,6,25,14,449,544,993,840
0131-002,2012,6,25,15,478,598,1076,993
0131-002,2012,6,25,16,498,578,1076,1076
0131-002,2012,6,25,17,484,536,1020,1076
0131-002,2012,6,25,18,472,574,1046,1020
0131-002,2012,6,25,19,485,584,1069,1046
0131-002,2012,6,25,20,381,540,921,1069
0131-002,2012,6,25,21,310,426,736,921
0131-002,2012,6,25,22,246,318,564,736
0131-002,2012,6,25,23,168,212,380,564
0131-002,2012,6,25,24,106,118,224,380
0131-002,2012,6,26,1,66,60,126,224
0131-002,2012,6,26,2,42,48,90,126
0131-002,2012,6,26,3,34,41,75,90
0131-002,2012,6,26,4,37,46,83,75
0131-002,2012,6,26,5,44,57,101,83
0131-002,2012,6,26,6,125,103,228,101
0131-002,2012,6,26,7,348,209,557,228
0131-002,2012,6,26,8,750,533,1283,557
0131-002,2012,6,26,9,639,597,1236,1283
0131-002,2012,6,26,10,456,532,988,1236
0131-002,2012,6,26,11,474,528,1002,988
0131-002,2012,6,26,12,460,494,954,1002
0131-002,2012,6,26,13,384,429,813,954
0131-002,2012,6,26,14,470,493,963,813
0131-002,2012,6,26,15,506,532,1038,963
0131-002,2012,6,26,16,493,532,1025,1038
0131-002,2012,6,26,17,488,517,1005,1025
0131-002,2012,6,26,18,490,611,1101,1005
0131-002,2012,6,26,19,484,544,1028,1101
0131-002,2012,6,26,20,400,477,877,1028
0131-002,2012,6,26,21,295,445,740,877
0131-002,2012,6,26,22,299,342,641,740
0131-002,2012,6,26,23,198,219,417,641
0131-002,2012,6,26,24,132,123,255,417
0131-002,2012,6,27,1,89,82,171,255
0131-002,2012,6,27,2,50,51,101,171
0131-002,2012,6,27,3,29,40,69,101
0131-002,2012,6,27,4,37,48,85,69
0131-002,2012,6,27,5,48,67,115,85
0131-002,2012,6,27,6,128,102,230,115
0131-002,2012,6,27,7,336,196,532,230
0131-002,2012,6,27,8,751,531,1282,532
0131-002,2012,6,27,9,616,613,1229,1282
0131-002,2012,6,27,10,492,531,1023,1229
0131-002,2012,6,27,11,510,520,1030,1023
0131-002,2012,6,27,12,453,649,1102,1030
0131-002,2012,6,27,13,381,542,923,1102
0131-002,2012,6,27,14,457,511,968,923
0131-002,2012,6,27,15,518,526,1044,968
0131-002,2012,6,27,16,484,544,1028,1044
0131-002,2012,6,27,17,482,512,994,1028
0131-002,2012,6,27,18,439,602,1041,994
0131-002,2012,6,27,19,490,611,1101,1041
0131-002,2012,6,27,20,395,480,875,1101
0131-002,2012,6,27,21,319,416,735,875
0131-002,2012,6,27,22,307,304,611,735
0131-002,2012,6,27,23,184,222,406,611
0131-002,2012,6,27,24,127,116,243,406
0131-002,2012,6,28,1,77,91,168,243
0131-002,2012,6,28,2,52,52,104,168
0131-002,2012,6,28,3,40,39,79,104
0131-002,2012,6,28,4,27,43,70,79
0131-002,2012,6,28,5,59,70,129,70
0131-002,2012,6,28,6,134,102,236,129
0131-002,2012,6,28,7,359,209,568,236
0131-002,2012,6,28,8,756,556,1312,568
0131-002,2012,6,28,9,638,611,1249,1312
0131-002,2012,6,28,10,493,526,1019,1249
0131-002,2012,6,28,11,498,509,1007,1019
0131-002,2012,6,28,12,437,496,933,1007
0131-002,2012,6,28,13,398,426,824,933
0131-002,2012,6,28,14,458,515,973,824
0131-002,2012,6,28,15,500,510,1010,973
0131-002,2012,6,28,16,486,567,1053,1010
0131-002,2012,6,28,17,475,559,1034,1053
0131-002,2012,6,28,18,473,535,1008,1034
0131-002,2012,6,28,19,460,543,1003,1008
0131-002,2012,6,28,20,382,519,901,1003
0131-002,2012,6,28,21,309,438,747,901
0131-002,2012,6,28,22,283,337,620,747
0131-002,2012,6,28,23,186,210,396,620
0131-002,2012,6,28,24,133,138,271,396
0131-002,2012,6,29,1,90,89,179,271
0131-002,2012,6,29,2,48,58,106,179
0131-002,2012,6,29,3,37,38,75,106
0131-002,2012,6,29,4,30,42,72,75
0131-002,2012,6,29,5,54,73,127,72
0131-002,2012,6,29,6,127,97,224,127
0131-002,2012,6,29,7,355,204,559,224
0131-002,2012,6,29,8,751,534,1285,559
0131-002,2012,6,29,9,646,620,1266,1285
0131-002,2012,6,29,10,501,546,1047,1266
0131-002,2012,6,29,11,482,531,1013,1047
0131-002,2012,6,29,12,460,514,974,1013
0131-002,2012,6,29,13,441,455,896,974
0131-002,2012,6,29,14,455,490,945,896
0131-002,2012,6,29,15,486,541,1027,945
0131-002,2012,6,29,16,515,557,1072,1027
0131-002,2012,6,29,17,505,539,1044,1072
0131-002,2012,6,29,18,532,607,1139,1044
0131-002,2012,6,29,19,572,655,1227,1139
0131-002,2012,6,29,20,462,545,1007,1227
0131-002,2012,6,29,21,300,464,764,1007
0131-002,2012,6,29,22,238,335,573,764
0131-002,2012,6,29,23,196,215,411,573
0131-002,2012,6,29,24,162,148,310,411
0131-002,2012,6,30,1,90,110,200,310
0131-002,2012,6,30,2,52,60,112,200
0131-002,2012,6,30,3,37,52,89,112
0131-002,2012,6,30,4,34,49,83,89
0131-002,2012,6,30,5,45,50,95,83
0131-002,2012,6,30,6,88,64,152,95
0131-002,2012,6,30,7,160,135,295,152
0131-002,2012,6,30,8,348,262,610,295
0131-002,2012,6,30,9,421,360,781,610
0131-002,2012,6,30,10,388,446,834,781
0131-002,2012,6,30,11,365,441,806,834
0131-002,2012,6,30,12,450,522,972,806
0131-002,2012,6,30,13,402,520,922,972
0131-002,2012,6,30,14,372,540,912,922
0131-002,2012,6,30,15,385,540,925,912
0131-002,2012,6,30,16,399,565,964,925
0131-002,2012,6,30,17,492,565,1057,964
0131-002,2012,6,30,18,515,550,1065,1057
0131-002,2012,6,30,19,457,434,891,1065
0131-002,2012,6,30,20,276,302,578,891
0131-002,2012,6,30,21,244,242,486,578
0131-002,2012,6,30,22,200,194,394,486
0131-002,2012,6,30,23,156,160,316,394
0131-002,2012,6,30,24,90,130,220,316
0131-002,2012,7,1,1,67,86,153,220
0131-002,2012,7,1,2,53,54,107,153
0131-002,2012,7,1,3,37,36,73,107
0131-002,2012,7,1,4,30,34,64,73
0131-002,2012,7,1,5,46,42,88,64
0131-002,2012,7,1,6,60,52,112,88
0131-002,2012,7,1,7,102,99,201,112
0131-002,2012,7,1,8,149,126,275,201
0131-002,2012,7,1,9,166,237,403,275
0131-002,2012,7,1,10,244,312,556,403
0131-002,2012,7,1,11,261,305,566,556
0131-002,2012,7,1,12,298,288,586,566
0131-002,2012,7,1,13,294,313,607,586
0131-002,2012,7,1,14,304,315,619,607
0131-002,2012,7,1,15,366,347,713,619
0131-002,2012,7,1,16,362,360,722,713
0131-002,2012,7,1,17,447,364,811,722
0131-002,2012,7,1,18,445,358,803,811
0131-002,2012,7,1,19,427,336,763,803
0131-002,2012,7,1,20,319,278,597,763
0131-002,2012,7,1,21,270,280,550,597
0131-002,2012,7,1,22,238,228,466,550
0131-002,2012,7,1,23,168,166,334,466
0131-002,2012,7,1,24,119,110,229,334
0131-002,2012,7,2,1,65,70,135,229
0131-002,2012,7,2,2,33,46,79,135
0131-002,2012,7,2,3,36,19,55,79
0131-002,2012,7,2,4,29,36,65,55
0131-002,2012,7,2,5,54,66,120,65
0131-002,2012,7,2,6,131,107,238,120
0131-002,2012,7,2,7,415,265,680,238
0131-002,2012,7,2,8,818,586,1404,680
0131-002,2012,7,2,9,664,611,1275,1404
0131-002,2012,7,2,10,476,493,969,1275
0131-002,2012,7,2,11,492,493,985,969
0131-002,2012,7,2,12,459,522,981,985
0131-002,2012,7,2,13,386,436,822,981
0131-002,2012,7,2,14,451,516,967,822
0131-002,2012,7,2,15,462,566,1028,967
0131-002,2012,7,2,16,494,586,1080,1028
0131-002,2012,7,2,17,492,548,1040,1080
0131-002,2012,7,2,18,478,553,1031,1040
0131-002,2012,7,2,19,484,550,1034,1031
0131-002,2012,7,2,20,379,477,856,1034
0131-002,2012,7,2,21,298,479,777,856
0131-002,2012,7,2,22,258,306,564,777
0131-002,2012,7,2,23,151,228,379,564
0131-002,2012,7,2,24,117,109,226,379
0131-002,2012,7,3,1,78,82,160,226
0131-002,2012,7,3,2,42,49,91,160
0131-002,2012,7,3,3,41,40,81,91
0131-002,2012,7,3,4,36,36,72,81
0131-002,2012,7,3,5,47,64,111,72
0131-002,2012,7,3,6,108,105,213,111
0131-002,2012,7,3,7,392,210,602,213
0131-002,2012,7,3,8,764,499,1263,602
0131-002,2012,7,3,9,646,593,1239,1263
0131-002,2012,7,3,10,499,538,1037,1239
0131-002,2012,7,3,11,524,557,1081,1037
0131-002,2012,7,3,12,475,484,959,1081
0131-002,2012,7,3,13,407,486,893,959
0131-002,2012,7,3,14,472,517,989,893
0131-002,2012,7,3,15,539,580,1119,989
0131-002,2012,7,3,16,509,543,1052,1119
0131-002,2012,7,3,17,446,534,980,1052
0131-002,2012,7,3,18,478,595,1073,980
0131-002,2012,7,3,19,449,582,1031,1073
0131-002,2012,7,3,20,364,506,870,1031
0131-002,2012,7,3,21,291,418,709,870
0131-002,2012,7,3,22,253,331,584,709
0131-002,2012,7,3,23,177,168,345,584
0131-002,2012,7,3,24,122,126,248,345
0131-002,2012,7,4,1,65,77,142,248
0131-002,2012,7,4,2,46,52,98,142
0131-002,2012,7,4,3,42,47,89,98
0131-002,2012,7,4,4,31,37,68,89
0131-002,2012,7,4,5,43,60,103,68
0131-002,2012,7,4,6,109,105,214,103
0131-002,2012,7,4,7,378,201,579,214
0131-002,2012,7,4,8,756,522,1278,579
0131-002,2012,7,4,9,636,597,1233,1278
0131-002,2012,7,4,10,523,560,1083,1233
0131-002,2012,7,4,11,502,528,1030,1083
0131-002,2012,7,4,12,466,521,987,1030
0131-002,2012,7,4,13,382,431,813,987
0131-002,2012,7,4,14,486,523,1009,813
0131-002,2012,7,4,15,492,590,1082,1009
0131-002,2012,7,4,16,481,564,1045,1082
0131-002,2012,7,4,17,497,556,1053,1045
0131-002,2012,7,4,18,486,662,1148,1053
0131-002,2012,7,4,19,496,779,1275,1148
0131-002,2012,7,4,20,375,499,874,1275
0131-002,2012,7,4,21,298,393,691,874
0131-002,2012,7,4,22,249,312,561,691
0131-002,2012,7,4,23,165,202,367,561
0131-002,2012,7,4,24,124,136,260,367
0131-002,2012,7,5,1,83,78,161,260
0131-002,2012,7,5,2,58,71,129,161
0131-002,2012,7,5,3,36,48,84,129
0131-002,2012,7,5,4,34,40,74,84
0131-002,2012,7,5,5,45,44,89,74
0131-002,2012,7,5,6,105,88,193,89
0131-002,2012,7,5,7,330,178,508,193
0131-002,2012,7,5,8,746,512,1258,508
0131-002,2012,7,5,9,588,623,1211,1258
0131-002,2012,7,5,10,486,483,969,1211
0131-002,2012,7,5,11,475,503,978,969
0131-002,2012,7,5,12,412,486,898,978
0131-002,2012,7,5,13,374,432,806,898
0131-002,2012,7,5,14,402,473,875,806
0131-002,2012,7,5,15,450,489,939,875
0131-002,2012,7,5,16,462,510,972,939
0131-002,2012,7,5,17,410,484,894,972
0131-002,2012,7,5,18,415,553,968,894
0131-002,2012,7,5,19,330,549,879,968
0131-002,2012,7,5,20,338,396,734,879
0131-002,2012,7,5,21,284,389,673,734
0131-002,2012,7,5,22,236,276,512,673
0131-002,2012,7,5,23,164,210,374,512
0131-002,2012,7,5,24,121,118,239,374
0131-002,2012,7,6,1,78,65,143,239
0131-002,2012,7,6,2,42,48,90,143
0131-002,2012,7,6,3,36,36,72,90
0131-002,2012,7,6,4,41,40,81,72
0131-002,2012,7,6,5,32,46,78,81
0131-002,2012,7,6,6,84,75,159,78
0131-002,2012,7,6,7,294,141,435,159
0131-002,2012,7,6,8,691,442,1133,435
0131-002,2012,7,6,9,614,583,1197,1133
0131-002,2012,7,6,10,392,456,848,1197
0131-002,2012,7,6,11,485,451,936,848
0131-002,2012,7,6,12,422,496,918,936
0131-002,2012,7,6,13,362,409,771,918
0131-002,2012,7,6,14,448,442,890,771
0131-002,2012,7,6,15,473,522,995,890
0131-002,2012,7,6,16,489,511,1000,995
0131-002,2012,7,6,17,437,515,952,1000
0131-002,2012,7,6,18,485,581,1066,952
0131-002,2012,7,6,19,584,566,1150,1066
0131-002,2012,7,6,20,388,547,935,1150
0131-002,2012,7,6,21,272,406,678,935
0131-002,2012,7,6,22,212,299,511,678
0131-002,2012,7,6,23,173,219,392,511
0131-002,2012,7,6,24,122,132,254,392
0131-002,2012,7,7,1,96,94,190,254
0131-002,2012,7,7,2,63,63,126,190
0131-002,2012,7,7,3,45,58,103,126
0131-002,2012,7,7,4,36,45,81,103
0131-002,2012,7,7,5,50,56,106,81
0131-002,2012,7,7,6,114,97,211,106
0131-002,2012,7,7,7,240,177,417,211
0131-002,2012,7,7,8,449,324,773,417
0131-002,2012,7,7,9,454,413,867,773
0131-002,2012,7,7,10,464,497,961,867
0131-002,2012,7,7,11,413,528,941,961
0131-002,2012,7,7,12,448,595,1043,941
0131-002,2012,7,7,13,425,609,1034,1043
0131-002,2012,7,7,14,415,569,984,1034
0131-002,2012,7,7,15,406,590,996,984
0131-002,2012,7,7,16,413,593,1006,996
0131-002,2012,7,7,17,528,580,1108,1006
0131-002,2012,7,7,18,547,573,1120,1108
0131-002,2012,7,7,19,501,503,1004,1120
0131-002,2012,7,7,20,311,342,653,1004
0131-002,2012,7,7,21,263,298,561,653
0131-002,2012,7,7,22,235,243,478,561
0131-002,2012,7,7,23,169,205,374,478
0131-002,2012,7,7,24,119,128,247,374
0131-002,2012,7,8,1,81,82,163,247
0131-002,2012,7,8,2,52,52,104,163
0131-002,2012,7,8,3,47,48,95,104
0131-002,2012,7,8,4,35,34,69,95
0131-002,2012,7,8,5,35,45,80,69
0131-002,2012,7,8,6,78,73,151,80
0131-002,2012,7,8,7,153,113,266,151
0131-002,2012,7,8,8,192,192,384,266
0131-002,2012,7,8,9,207,224,431,384
0131-002,2012,7,8,10,244,279,523,431
0131-002,2012,7,8,11,276,334,610,523
0131-002,2012,7,8,12,280,316,596,610
0131-002,2012,7,8,13,264,339,603,596
0131-002,2012,7,8,14,298,294,592,603
0131-002,2012,7,8,15,370,324,694,592
0131-002,2012,7,8,16,532,352,884,694
0131-002,2012,7,8,17,531,393,924,884
0131-002,2012,7,8,18,537,396,933,924
0131-002,2012,7,8,19,539,353,892,933
0131-002,2012,7,8,20,434,308,742,892
0131-002,2012,7,8,21,318,268,586,742
0131-002,2012,7,8,22,243,246,489,586
0131-002,2012,7,8,23,180,156,336,489
0131-002,2012,7,8,24,102,108,210,336
0131-002,2012,7,9,1,69,66,135,210
0131-002,2012,7,9,2,31,40,71,135
0131-002,2012,7,9,3,33,26,59,71
0131-002,2012,7,9,4,34,28,62,59
0131-002,2012,7,9,5,48,70,118,62
0131-002,2012,7,9,6,142,106,248,118
0131-002,2012,7,9,7,436,280,716,248
0131-002,2012,7,9,8,819,538,1357,716
0131-002,2012,7,9,9,628,615,1243,1357
0131-002,2012,7,9,10,496,589,1085,1243
0131-002,2012,7,9,11,518,498,1016,1085
0131-002,2012,7,9,12,490,474,964,1016
0131-002,2012,7,9,13,388,428,816,964
0131-002,2012,7,9,14,462,510,972,816
0131-002,2012,7,9,15,530,575,1105,972
0131-002,2012,7,9,16,518,537,1055,1105
0131-002,2012,7,9,17,474,558,1032,1055
0131-002,2012,7,9,18,484,576,1060,1032
0131-002,2012,7,9,19,499,574,1073,1060
0131-002,2012,7,9,20,365,486,851,1073
0131-002,2012,7,9,21,302,478,780,851
0131-002,2012,7,9,22,262,333,595,780
0131-002,2012,7,9,23,182,216,398,595
0131-002,2012,7,9,24,114,121,235,398
0131-002,2012,7,10,1,70,79,149,235
0131-002,2012,7,10,2,50,45,95,149
0131-002,2012,7,10,3,43,43,86,95
0131-002,2012,7,10,4,34,43,77,86
0131-002,2012,7,10,5,46,65,111,77
0131-002,2012,7,10,6,127,115,242,111
0131-002,2012,7,10,7,361,228,589,242
0131-002,2012,7,10,8,781,552,1333,589
0131-002,2012,7,10,9,630,634,1264,1333
0131-002,2012,7,10,10,537,525,1062,1264
0131-002,2012,7,10,11,515,579,1094,1062
0131-002,2012,7,10,12,504,566,1070,1094
0131-002,2012,7,10,13,417,522,939,1070
0131-002,2012,7,10,14,522,544,1066,939
0131-002,2012,7,10,15,556,580,1136,1066
0131-002,2012,7,10,16,510,562,1072,1136
0131-002,2012,7,10,17,470,576,1046,1072
0131-002,2012,7,10,18,488,623,1111,1046
0131-002,2012,7,10,19,471,587,1058,1111
0131-002,2012,7,10,20,325,492,817,1058
0131-002,2012,7,10,21,285,430,715,817
0131-002,2012,7,10,22,252,291,543,715
0131-002,2012,7,10,23,186,202,388,543
0131-002,2012,7,10,24,121,117,238,388
0131-002,2012,7,11,1,78,71,149,238
0131-002,2012,7,11,2,44,59,103,149
0131-002,2012,7,11,3,42,43,85,103
0131-002,2012,7,11,4,27,37,64,85
0131-002,2012,7,11,5,37,46,83,64
0131-002,2012,7,11,6,91,77,168,83
0131-002,2012,7,11,7,267,165,432,168
0131-002,2012,7,11,8,741,494,1235,432
0131-002,2012,7,11,9,606,600,1206,1235
0131-002,2012,7,11,10,486,453,939,1206
0131-002,2012,7,11,11,425,511,936,939
0131-002,2012,7,11,12,406,484,890,936
0131-002,2012,7,11,13,360,412,772,890
0131-002,2012,7,11,14,450,492,942,772
0131-002,2012,7,11,15,499,544,1043,942
0131-002,2012,7,11,16,505,536,1041,1043
0131-002,2012,7,11,17,444,489,933,1041
0131-002,2012,7,11,18,444,590,1034,933
0131-002,2012,7,11,19,464,557,1021,1034
0131-002,2012,7,11,20,388,476,864,1021
0131-002,2012,7,11,21,315,386,701,864
0131-002,2012,7,11,22,240,315,555,701
0131-002,2012,7,11,23,188,208,396,555
0131-002,2012,7,11,24,108,111,219,396
0131-002,2012,7,12,1,85,87,172,219
0131-002,2012,7,12,2,48,59,107,172
0131-002,2012,7,12,3,51,42,93,107
0131-002,2012,7,12,4,44,42,86,93
0131-002,2012,7,12,5,52,62,114,86
0131-002,2012,7,12,6,110,105,215,114
0131-002,2012,7,12,7,335,204,539,215
0131-002,2012,7,12,8,815,565,1380,539
0131-002,2012,7,12,9,669,664,1333,1380
0131-002,2012,7,12,10,550,553,1103,1333
0131-002,2012,7,12,11,554,547,1101,1103
0131-002,2012,7,12,12,482,522,1004,1101
0131-002,2012,7,12,13,382,467,849,1004
0131-002,2012,7,12,14,443,503,946,849
0131-002,2012,7,12,15,526,560,1086,946
0131-002,2012,7,12,16,491,581,1072,1086
0131-002,2012,7,12,17,528,561,1089,1072
0131-002,2012,7,12,18,473,588,1061,1089
0131-002,2012,7,12,19,486,586,1072,1061
0131-002,2012,7,12,20,404,502,906,1072
0131-002,2012,7,12,21,322,438,760,906
0131-002,2012,7,12,22,304,336,640,760
0131-002,2012,7,12,23,169,197,366,640
0131-002,2012,7,12,24,107,158,265,366
0131-002,2012,7,13,1,85,84,169,265
0131-002,2012,7,13,2,66,56,122,169
0131-002,2012,7,13,3,46,46,92,122
0131-002,2012,7,13,4,28,43,71,92
0131-002,2012,7,13,5,41,54,95,71
0131-002,2012,7,13,6,95,103,198,95
0131-002,2012,7,13,7,306,190,496,198
0131-002,2012,7,13,8,774,556,1330,496
0131-002,2012,7,13,9,624,688,1312,1330
0131-002,2012,7,13,10,531,526,1057,1312
0131-002,2012,7,13,11,500,534,1034,1057
0131-002,2012,7,13,12,456,576,1032,1034
0131-002,2012,7,13,13,392,454,846,1032
0131-002,2012,7,13,14,472,540,1012,846
0131-002,2012,7,13,15,538,527,1065,1012
0131-002,2012,7,13,16,504,563,1067,1065
0131-002,2012,7,13,17,561,570,1131,1067
0131-002,2012,7,13,18,589,640,1229,1131
0131-002,2012,7,13,19,645,600,1245,1229
0131-002,2012,7,13,20,410,516,926,1245
0131-002,2012,7,13,21,344,428,772,926
0131-002,2012,7,13,22,291,305,596,772
0131-002,2012,7,13,23,185,235,420,596
0131-002,2012,7,13,24,135,139,274,420
0131-002,2012,7,14,1,84,114,198,274
0131-002,2012,7,14,2,66,82,148,198
0131-002,2012,7,14,3,52,42,94,148
0131-002,2012,7,14,4,42,52,94,94
0131-002,2012,7,14,5,44,60,104,94
0131-002,2012,7,14,6,108,83,191,104
0131-002,2012,7,14,7,186,164,350,191
0131-002,2012,7,14,8,439,373,812,350
0131-002,2012,7,14,9,422,455,877,812
0131-002,2012,7,14,10,428,488,916,877
0131-002,2012,7,14,11,424,553,977,916
0131-002,2012,7,14,12,401,621,1022,977
0131-002,2012,7,14,13,389,567,956,1022
0131-002,2012,7,14,14,406,538,944,956
0131-002,2012,7,14,15,414,542,956,944
0131-002,2012,7,14,16,408,549,957,956
0131-002,2012,7,14,17,436,534,970,957
0131-002,2012,7,14,18,556,573,1129,970
0131-002,2012,7,14,19,568,468,1036,1129
0131-002,2012,7,14,20,403,324,727,1036
0131-002,2012,7,14,21,258,264,522,727
0131-002,2012,7,14,22,206,220,426,522
0131-002,2012,7,14,23,148,168,316,426
0131-002,2012,7,14,24,97,118,215,316
0131-002,2012,7,15,1,63,84,147,215
0131-002,2012,7,15,2,64,52,116,147
0131-002,2012,7,15,3,31,36,67,116
0131-002,2012,7,15,4,23,34,57,67
0131-002,2012,7,15,5,26,28,54,57
0131-002,2012,7,15,6,36,50,86,54
0131-002,2012,7,15,7,85,82,167,86
0131-002,2012,7,15,8,135,211,346,167
0131-002,2012,7,15,9,142,238,380,346
0131-002,2012,7,15,10,198,267,465,380
0131-002,2012,7,15,11,219,304,523,465
0131-002,2012,7,15,12,241,301,542,523
0131-002,2012,7,15,13,256,280,536,542
0131-002,2012,7,15,14,312,324,636,536
0131-002,2012,7,15,15,312,324,636,636
0131-002,2012,7,15,16,464,346,810,636
0131-002,2012,7,15,17,532,374,906,810
0131-002,2012,7,15,18,559,340,899,906
0131-002,2012,7,15,19,550,295,845,899
0131-002,2012,7,15,20,306,252,558,845
0131-002,2012,7,15,21,324,235,559,558
0131-002,2012,7,15,22,244,204,448,559
0131-002,2012,7,15,23,145,131,276,448
0131-002,2012,7,15,24,111,97,208,276
0131-002,2012,7,16,1,63,52,115,208
0131-002,2012,7,16,2,45,42,87,115
0131-002,2012,7,16,3,31,22,53,87
0131-002,2012,7,16,4,26,29,55,53
0131-002,2012,7,16,5,39,66,105,55
0131-002,2012,7,16,6,100,100,200,105
0131-002,2012,7,16,7,372,238,610,200
0131-002,2012,7,16,8,809,582,1391,610
0131-002,2012,7,16,9,618,617,1235,1391
0131-002,2012,7,16,10,490,520,1010,1235
0131-002,2012,7,16,11,504,499,1003,1010
0131-002,2012,7,16,12,480,551,1031,1003
0131-002,2012,7,16,13,408,474,882,1031
0131-002,2012,7,16,14,492,561,1053,882
0131-002,2012,7,16,15,527,553,1080,1053
0131-002,2012,7,16,16,539,571,1110,1080
0131-002,2012,7,16,17,502,526,1028,1110
0131-002,2012,7,16,18,516,620,1136,1028
0131-002,2012,7,16,19,490,569,1059,1136
0131-002,2012,7,16,20,389,469,858,1059
0131-002,2012,7,16,21,309,460,769,858
0131-002,2012,7,16,22,263,320,583,769
0131-002,2012,7,16,23,168,220,388,583
0131-002,2012,7,16,24,122,118,240,388
0131-002,2012,7,17,1,78,84,162,240
0131-002,2012,7,17,2,45,44,89,162
0131-002,2012,7,17,3,31,46,77,89
0131-002,2012,7,17,4,30,34,64,77
0131-002,2012,7,17,5,40,60,100,64
0131-002,2012,7,17,6,130,94,224,100
0131-002,2012,7,17,7,330,203,533,224
0131-002,2012,7,17,8,786,517,1303,533
0131-002,2012,7,17,9,636,649,1285,1303
0131-002,2012,7,17,10,528,557,1085,1285
0131-002,2012,7,17,11,539,537,1076,1085
0131-002,2012,7,17,12,511,508,1019,1076
0131-002,2012,7,17,13,407,424,831,1019
0131-002,2012,7,17,14,461,522,983,831
0131-002,2012,7,17,15,515,561,1076,983
0131-002,2012,7,17,16,526,564,1090,1076
0131-002,2012,7,17,17,473,552,1025,1090
0131-002,2012,7,17,18,456,626,1082,1025
0131-002,2012,7,17,19,430,565,995,1082
0131-002,2012,7,17,20,328,460,788,995
0131-002,2012,7,17,21,295,426,721,788
0131-002,2012,7,17,22,264,262,526,721
0131-002,2012,7,17,23,160,202,362,526
0131-002,2012,7,17,24,103,102,205,362
0131-002,2012,7,18,1,58,88,146,205
0131-002,2012,7,18,2,39,46,85,146
0131-002,2012,7,18,3,44,39,83,85
0131-002,2012,7,18,4,37,54,91,83
0131-002,2012,7,18,5,43,59,102,91
0131-002,2012,7,18,6,96,96,192,102
0131-002,2012,7,18,7,290,160,450,192
0131-002,2012,7,18,8,706,500,1206,450
0131-002,2012,7,18,9,647,601,1248,1206
0131-002,2012,7,18,10,501,483,984,1248
0131-002,2012,7,18,11,497,527,1024,984
0131-002,2012,7,18,12,450,492,942,1024
0131-002,2012,7,18,13,384,410,794,942
0131-002,2012,7,18,14,452,508,960,794
0131-002,2012,7,18,15,494,516,1010,960
0131-002,2012,7,18,16,450,504,954,1010
0131-002,2012,7,18,17,483,537,1020,954
0131-002,2012,7,18,18,456,598,1054,1020
0131-002,2012,7,18,19,520,604,1124,1054
0131-002,2012,7,18,20,333,498,831,1124
0131-002,2012,7,18,21,298,405,703,831
0131-002,2012,7,18,22,244,289,533,703
0131-002,2012,7,18,23,163,207,370,533
0131-002,2012,7,18,24,110,130,240,370
0131-002,2012,7,19,1,68,77,145,240
0131-002,2012,7,19,2,46,43,89,145
0131-002,2012,7,19,3,36,41,77,89
0131-002,2012,7,19,4,45,37,82,77
0131-002,2012,7,19,5,30,43,73,82
0131-002,2012,7,19,6,71,64,135,73
0131-002,2012,7,19,7,283,156,439,135
0131-002,2012,7,19,8,732,481,1213,439
0131-002,2012,7,19,9,604,596,1200,1213
0131-002,2012,7,19,10,460,499,959,1200
0131-002,2012,7,19,11,467,480,947,959
0131-002,2012,7,19,12,448,455,903,947
0131-002,2012,7,19,13,368,444,812,903
0131-002,2012,7,19,14,452,454,906,812
0131-002,2012,7,19,15,468,518,986,906
0131-002,2012,7,19,16,490,486,976,986
0131-002,2012,7,19,17,450,498,948,976
0131-002,2012,7,19,18,416,586,1002,948
0131-002,2012,7,19,19,456,550,1006,1002
0131-002,2012,7,19,20,359,470,829,1006
0131-002,2012,7,19,21,305,430,735,829
0131-002,2012,7,19,22,270,289,559,735
0131-002,2012,7,19,23,180,221,401,559
0131-002,2012,7,19,24,114,141,255,401
0131-002,2012,7,20,1,89,94,183,255
0131-002,2012,7,20,2,60,52,112,183
0131-002,2012,7,20,3,38,42,80,112
0131-002,2012,7,20,4,29,42,71,80
0131-002,2012,7,20,5,43,73,116,71
0131-002,2012,7,20,6,114,95,209,116
0131-002,2012,7,20,7,331,184,515,209
0131-002,2012,7,20,8,791,527,1318,515
0131-002,2012,7,20,9,615,636,1251,1318
0131-002,2012,7,20,10,502,543,1045,1251
0131-002,2012,7,20,11,516,554,1070,1045
0131-002,2012,7,20,12,500,532,1032,1070
0131-002,2012,7,20,13,415,589,1004,1032
0131-002,2012,7,20,14,469,610,1079,1004
0131-002,2012,7,20,15,515,647,1162,1079
0131-002,2012,7,20,16,526,569,1095,1162
0131-002,2012,7,20,17,570,696,1266,1095
0131-002,2012,7,20,18,660,717,1377,1266
0131-002,2012,7,20,19,636,643,1279,1377
0131-002,2012,7,20,20,474,537,1011,1279
0131-002,2012,7,20,21,361,498,859,1011
0131-002,2012,7,20,22,303,340,643,859
0131-002,2012,7,20,23,200,231,431,643
0131-002,2012,7,20,24,128,144,272,431
0131-002,2012,7,21,1,84,104,188,272
0131-002,2012,7,21,2,72,85,157,188
0131-002,2012,7,21,3,56,52,108,157
0131-002,2012,7,21,4,42,44,86,108
0131-002,2012,7,21,5,47,82,129,86
0131-002,2012,7,21,6,111,97,208,129
0131-002,2012,7,21,7,234,185,419,208
0131-002,2012,7,21,8,433,330,763,419
0131-002,2012,7,21,9,454,439,893,763
0131-002,2012,7,21,10,419,476,895,893
0131-002,2012,7,21,11,417,557,974,895
0131-002,2012,7,21,12,442,662,1104,974
0131-002,2012,7,21,13,358,661,1019,1104
0131-002,2012,7,21,14,443,650,1093,1019
0131-002,2012,7,21,15,383,593,976,1093
0131-002,2012,7,21,16,383,562,945,976
0131-002,2012,7,21,17,417,528,945,945
0131-002,2012,7,21,18,468,618,1086,945
0131-002,2012,7,21,19,448,484,932,1086
0131-002,2012,7,21,20,322,338,660,932
0131-002,2012,7,21,21,298,296,594,660
0131-002,2012,7,21,22,256,259,515,594
0131-002,2012,7,21,23,150,202,352,515
0131-002,2012,7,21,24,104,130,234,352
0131-002,2012,7,22,1,76,107,183,234
0131-002,2012,7,22,2,50,71,121,183
0131-002,2012,7,22,3,51,60,111,121
0131-002,2012,7,22,4,33,38,71,111
0131-002,2012,7,22,5,34,44,78,71
0131-002,2012,7,22,6,70,64,134,78
0131-002,2012,7,22,7,120,124,244,134
0131-002,2012,7,22,8,186,174,360,244
0131-002,2012,7,22,9,190,222,412,360
0131-002,2012,7,22,10,208,242,450,412
0131-002,2012,7,22,11,245,298,543,450
0131-002,2012,7,22,12,255,294,549,543
0131-002,2012,7,22,13,307,361,668,549
0131-002,2012,7,22,14,306,337,643,668
0131-002,2012,7,22,15,337,347,684,643
0131-002,2012,7,22,16,474,366,840,684
0131-002,2012,7,22,17,410,394,804,840
0131-002,2012,7,22,18,392,385,777,804
0131-002,2012,7,22,19,384,314,698,777
0131-002,2012,7,22,20,316,297,613,698
0131-002,2012,7,22,21,334,281,615,613
0131-002,2012,7,22,22,280,223,503,615
0131-002,2012,7,22,23,180,168,348,503
0131-002,2012,7,22,24,118,98,216,348
0131-002,2012,7,23,1,64,76,140,216
0131-002,2012,7,23,2,41,37,78,140
0131-002,2012,7,23,3,28,30,58,78
0131-002,2012,7,23,4,27,30,57,58
0131-002,2012,7,23,5,46,59,105,57
0131-002,2012,7,23,6,111,101,212,105
0131-002,2012,7,23,7,416,232,648,212
0131-002,2012,7,23,8,838,576,1414,648
0131-002,2012,7,23,9,615,634,1249,1414
0131-002,2012,7,23,10,507,534,1041,1249
0131-002,2012,7,23,11,474,541,1015,1041
0131-002,2012,7,23,12,466,675,1141,1015
0131-002,2012,7,23,13,382,640,1022,1141
0131-002,2012,7,23,14,411,558,969,1022
0131-002,2012,7,23,15,485,584,1069,969
0131-002,2012,7,23,16,500,524,1024,1069
0131-002,2012,7,23,17,491,590,1081,1024
0131-002,2012,7,23,18,470,590,1060,1081
0131-002,2012,7,23,19,500,582,1082,1060
0131-002,2012,7,23,20,367,496,863,1082
0131-002,2012,7,23,21,293,459,752,863
0131-002,2012,7,23,22,266,301,567,752
0131-002,2012,7,23,23,166,204,370,567
0131-002,2012,7,23,24,108,130,238,370
0131-002,2012,7,24,1,87,82,169,238
0131-002,2012,7,24,2,57,46,103,169
0131-002,2012,7,24,3,40,34,74,103
0131-002,2012,7,24,4,29,43,72,74
0131-002,2012,7,24,5,46,55,101,72
0131-002,2012,7,24,6,107,102,209,101
0131-002,2012,7,24,7,358,189,547,209
0131-002,2012,7,24,8,758,521,1279,547
0131-002,2012,7,24,9,606,634,1240,1279
0131-002,2012,7,24,10,516,546,1062,1240
0131-002,2012,7,24,11,481,520,1001,1062
0131-002,2012,7,24,12,470,538,1008,1001
0131-002,2012,7,24,13,377,601,978,1008
0131-002,2012,7,24,14,460,527,987,978
0131-002,2012,7,24,15,498,559,1057,987
0131-002,2012,7,24,16,477,563,1040,1057
0131-002,2012,7,24,17,442,647,1089,1040
0131-002,2012,7,24,18,484,818,1302,1089
0131-002,2012,7,24,19,536,741,1277,1302
0131-002,2012,7,24,20,394,508,902,1277
0131-002,2012,7,24,21,294,466,760,902
0131-002,2012,7,24,22,267,324,591,760
0131-002,2012,7,24,23,188,199,387,591
0131-002,2012,7,24,24,118,148,266,387
0131-002,2012,7,25,1,93,96,189,266
0131-002,2012,7,25,2,52,60,112,189
0131-002,2012,7,25,3,46,54,100,112
0131-002,2012,7,25,4,30,43,73,100
0131-002,2012,7,25,5,43,66,109,73
0131-002,2012,7,25,6,117,114,231,109
0131-002,2012,7,25,7,342,171,513,231
0131-002,2012,7,25,8,721,537,1258,513
0131-002,2012,7,25,9,616,648,1264,1258
0131-002,2012,7,25,10,538,521,1059,1264
0131-002,2012,7,25,11,522,530,1052,1059
0131-002,2012,7,25,12,456,525,981,1052
0131-002,2012,7,25,13,421,454,875,981
0131-002,2012,7,25,14,447,494,941,875
0131-002,2012,7,25,15,508,566,1074,941
0131-002,2012,7,25,16,514,559,1073,1074
0131-002,2012,7,25,17,465,562,1027,1073
0131-002,2012,7,25,18,492,597,1089,1027
0131-002,2012,7,25,19,479,595,1074,1089
0131-002,2012,7,25,20,370,496,866,1074
0131-002,2012,7,25,21,310,424,734,866
0131-002,2012,7,25,22,249,323,572,734
0131-002,2012,7,25,23,148,220,368,572
0131-002,2012,7,25,24,136,141,277,368
0131-002,2012,7,26,1,84,90,174,277
0131-002,2012,7,26,2,51,72,123,174
0131-002,2012,7,26,3,45,46,91,123
0131-002,2012,7,26,4,34,36,70,91
0131-002,2012,7,26,5,43,66,109,70
0131-002,2012,7,26,6,102,113,215,109
0131-002,2012,7,26,7,346,204,550,215
0131-002,2012,7,26,8,784,539,1323,550
0131-002,2012,7,26,9,654,607,1261,1323
0131-002,2012,7,26,10,506,540,1046,1261
0131-002,2012,7,26,11,467,520,987,1046
0131-002,2012,7,26,12,474,499,973,987
0131-002,2012,7,26,13,424,424,848,973
0131-002,2012,7,26,14,442,462,904,848
0131-002,2012,7,26,15,461,575,1036,904
0131-002,2012,7,26,16,510,545,1055,1036
0131-002,2012,7,26,17,460,562,1022,1055
0131-002,2012,7,26,18,487,600,1087,1022
0131-002,2012,7,26,19,506,588,1094,1087
0131-002,2012,7,26,20,400,497,897,1094
0131-002,2012,7,26,21,322,451,773,897
0131-002,2012,7,26,22,233,338,571,773
0131-002,2012,7,26,23,157,237,394,571
0131-002,2012,7,26,24,106,124,230,394
0131-002,2012,7,27,1,76,90,166,230
0131-002,2012,7,27,2,56,52,108,166
0131-002,2012,7,27,3,36,46,82,108
0131-002,2012,7,27,4,44,52,96,82
0131-002,2012,7,27,5,48,73,121,96
0131-002,2012,7,27,6,117,108,225,121
0131-002,2012,7,27,7,353,208,561,225
0131-002,2012,7,27,8,754,501,1255,561
0131-002,2012,7,27,9,616,636,1252,1255
0131-002,2012,7,27,10,504,531,1035,1252
0131-002,2012,7,27,11,528,553,1081,1035
0131-002,2012,7,27,12,466,534,1000,1081
0131-002,2012,7,27,13,436,472,908,1000
0131-002,2012,7,27,14,450,535,985,908
0131-002,2012,7,27,15,504,569,1073,985
0131-002,2012,7,27,16,559,577,1136,1073
0131-002,2012,7,27,17,562,643,1205,1136
0131-002,2012,7,27,18,618,661,1279,1205
0131-002,2012,7,27,19,538,665,1203,1279
0131-002,2012,7,27,20,472,543,1015,1203
0131-002,2012,7,27,21,353,472,825,1015
0131-002,2012,7,27,22,272,344,616,825
0131-002,2012,7,27,23,176,222,398,616
0131-002,2012,7,27,24,142,181,323,398
0131-002,2012,7,28,1,84,118,202,323
0131-002,2012,7,28,2,62,88,150,202
0131-002,2012,7,28,3,51,54,105,150
0131-002,2012,7,28,4,46,58,104,105
0131-002,2012,7,28,5,42,74,116,104
0131-002,2012,7,28,6,105,113,218,116
0131-002,2012,7,28,7,239,193,432,218
0131-002,2012,7,28,8,412,325,737,432
0131-002,2012,7,28,9,434,508,942,737
0131-002,2012,7,28,10,422,663,1085,942
0131-002,2012,7,28,11,423,682,1105,1085
0131-002,2012,7,28,12,424,848,1272,1105
0131-002,2012,7,28,13,393,817,1210,1272
0131-002,2012,7,28,14,375,858,1233,1210
0131-002,2012,7,28,15,421,766,1187,1233
0131-002,2012,7,28,16,401,737,1138,1187
0131-002,2012,7,28,17,385,704,1089,1138
0131-002,2012,7,28,18,427,642,1069,1089
0131-002,2012,7,28,19,430,526,956,1069
0131-002,2012,7,28,20,278,328,606,956
0131-002,2012,7,28,21,267,297,564,606
0131-002,2012,7,28,22,256,264,520,564
0131-002,2012,7,28,23,162,165,327,520
0131-002,2012,7,28,24,104,122,226,327
0131-002,2012,7,29,1,64,83,147,226
0131-002,2012,7,29,2,40,66,106,147
0131-002,2012,7,29,3,31,34,65,106
0131-002,2012,7,29,4,28,33,61,65
0131-002,2012,7,29,5,39,28,67,61
0131-002,2012,7,29,6,62,64,126,67
0131-002,2012,7,29,7,122,133,255,126
0131-002,2012,7,29,8,199,187,386,255
0131-002,2012,7,29,9,222,246,468,386
0131-002,2012,7,29,10,252,281,533,468
0131-002,2012,7,29,11,225,286,511,533
0131-002,2012,7,29,12,265,335,600,511
0131-002,2012,7,29,13,244,306,550,600
0131-002,2012,7,29,14,297,310,607,550
0131-002,2012,7,29,15,332,355,687,607
0131-002,2012,7,29,16,328,342,670,687
0131-002,2012,7,29,17,384,321,705,670
0131-002,2012,7,29,18,508,358,866,705
0131-002,2012,7,29,19,380,309,689,866
0131-002,2012,7,29,20,312,276,588,689
0131-002,2012,7,29,21,268,237,505,588
0131-002,2012,7,29,22,309,211,520,505
0131-002,2012,7,29,23,157,199,356,520
0131-002,2012,7,29,24,114,102,216,356
0131-002,2012,7,30,1,60,76,136,216
0131-002,2012,7,30,2,42,41,83,136
0131-002,2012,7,30,3,24,34,58,83
0131-002,2012,7,30,4,28,28,56,58
0131-002,2012,7,30,5,42,61,103,56
0131-002,2012,7,30,6,102,116,218,103
0131-002,2012,7,30,7,330,236,566,218
0131-002,2012,7,30,8,636,487,1123,566
0131-002,2012,7,30,9,544,555,1099,1123
0131-002,2012,7,30,10,441,496,937,1099
0131-002,2012,7,30,11,456,474,930,937
0131-002,2012,7,30,12,462,474,936,930
0131-002,2012,7,30,13,357,393,750,936
0131-002,2012,7,30,14,426,504,930,750
0131-002,2012,7,30,15,472,516,988,930
0131-002,2012,7,30,16,472,508,980,988
0131-002,2012,7,30,17,444,457,901,980
0131-002,2012,7,30,18,441,556,997,901
0131-002,2012,7,30,19,454,502,956,997
0131-002,2012,7,30,20,334,427,761,956
0131-002,2012,7,30,21,272,341,613,761
0131-002,2012,7,30,22,243,270,513,613
0131-002,2012,7,30,23,150,198,348,513
0131-002,2012,7,30,24,108,120,228,348
0131-002,2012,7,31,1,72,81,153,228
0131-002,2012,7,31,2,47,51,98,153
0131-002,2012,7,31,3,37,41,78,98
0131-002,2012,7,31,4,40,31,71,78
0131-002,2012,7,31,5,40,67,107,71
0131-002,2012,7,31,6,98,81,179,107
0131-002,2012,7,31,7,267,202,469,179
0131-002,2012,7,31,8,602,462,1064,469
0131-002,2012,7,31,9,493,528,1021,1064
0131-002,2012,7,31,10,405,468,873,1021
0131-002,2012,7,31,11,462,441,903,873
0131-002,2012,7,31,12,413,486,899,903
0131-002,2012,7,31,13,370,383,753,899
0131-002,2012,7,31,14,432,454,886,753
0131-002,2012,7,31,15,438,498,936,886
0131-002,2012,7,31,16,484,506,990,936
0131-002,2012,7,31,17,409,469,878,990
0131-002,2012,7,31,18,446,540,986,878
0131-002,2012,7,31,19,456,572,1028,986
0131-002,2012,7,31,20,336,436,772,1028
0131-002,2012,7,31,21,277,348,625,772
0131-002,2012,7,31,22,246,310,556,625
0131-002,2012,7,31,23,150,181,331,556
0131-002,2012,7,31,24,119,141,260,331
0131-002,2012,8,1,1,60,84,144,260
0131-002,2012,8,1,2,59,64,123,144
0131-002,2012,8,1,3,32,42,74,123
0131-002,2012,8,1,4,30,46,76,74
0131-002,2012,8,1,5,49,66,115,76
0131-002,2012,8,1,6,95,90,185,115
0131-002,2012,8,1,7,261,170,431,185
0131-002,2012,8,1,8,545,404,949,431
0131-002,2012,8,1,9,480,520,1000,949
0131-002,2012,8,1,10,448,446,894,1000
0131-002,2012,8,1,11,428,497,925,894
0131-002,2012,8,1,12,406,522,928,925
0131-002,2012,8,1,13,328,518,846,928
0131-002,2012,8,1,14,360,582,942,846
0131-002,2012,8,1,15,409,664,1073,942
0131-002,2012,8,1,16,426,613,1039,1073
0131-002,2012,8,1,17,438,603,1041,1039
0131-002,2012,8,1,18,457,667,1124,1041
0131-002,2012,8,1,19,474,626,1100,1124
0131-002,2012,8,1,20,333,438,771,1100
0131-002,2012,8,1,21,266,330,596,771
0131-002,2012,8,1,22,218,257,475,596
0131-002,2012,8,1,23,166,180,346,475
0131-002,2012,8,1,24,112,132,244,346
0131-002,2012,8,2,1,66,86,152,244
0131-002,2012,8,2,2,52,54,106,152
0131-002,2012,8,2,3,40,24,64,106
0131-002,2012,8,2,4,29,44,73,64
0131-002,2012,8,2,5,32,57,89,73
0131-002,2012,8,2,6,86,90,176,89
0131-002,2012,8,2,7,249,190,439,176
0131-002,2012,8,2,8,516,402,918,439
0131-002,2012,8,2,9,490,497,987,918
0131-002,2012,8,2,10,381,448,829,987
0131-002,2012,8,2,11,442,508,950,829
0131-002,2012,8,2,12,399,600,999,950
0131-002,2012,8,2,13,359,590,949,999
0131-002,2012,8,2,14,412,631,1043,949
0131-002,2012,8,2,15,436,698,1134,1043
0131-002,2012,8,2,16,400,589,989,1134
0131-002,2012,8,2,17,411,550,961,989
0131-002,2012,8,2,18,397,570,967,961
0131-002,2012,8,2,19,437,472,909,967
0131-002,2012,8,2,20,360,391,751,909
0131-002,2012,8,2,21,269,330,599,751
0131-002,2012,8,2,22,223,238,461,599
0131-002,2012,8,2,23,167,195,362,461
0131-002,2012,8,2,24,104,106,210,362
0131-002,2012,8,3,1,63,78,141,210
0131-002,2012,8,3,2,40,53,93,141
0131-002,2012,8,3,3,30,39,69,93
0131-002,2012,8,3,4,20,31,51,69
0131-002,2012,8,3,5,47,59,106,51
0131-002,2012,8,3,6,79,96,175,106
0131-002,2012,8,3,7,261,158,419,175
0131-002,2012,8,3,8,512,376,888,419
0131-002,2012,8,3,9,453,472,925,888
0131-002,2012,8,3,10,384,409,793,925
0131-002,2012,8,3,11,401,440,841,793
0131-002,2012,8,3,12,373,467,840,841
0131-002,2012,8,3,13,334,461,795,840
0131-002,2012,8,3,14,374,514,888,795
0131-002,2012,8,3,15,424,528,952,888
0131-002,2012,8,3,16,426,467,893,952
0131-002,2012,8,3,17,420,497,917,893
0131-002,2012,8,3,18,450,515,965,917
0131-002,2012,8,3,19,492,525,1017,965
0131-002,2012,8,3,20,434,440,874,1017
0131-002,2012,8,3,21,341,361,702,874
0131-002,2012,8,3,22,318,273,591,702
0131-002,2012,8,3,23,172,195,367,591
0131-002,2012,8,3,24,132,136,268,367
0131-002,2012,8,4,1,71,101,172,268
0131-002,2012,8,4,2,56,68,124,172
0131-002,2012,8,4,3,42,43,85,124
0131-002,2012,8,4,4,21,44,65,85
0131-002,2012,8,4,5,42,45,87,65
0131-002,2012,8,4,6,75,103,178,87
0131-002,2012,8,4,7,171,146,317,178
0131-002,2012,8,4,8,320,252,572,317
0131-002,2012,8,4,9,328,389,717,572
0131-002,2012,8,4,10,364,505,869,717
0131-002,2012,8,4,11,350,600,950,869
0131-002,2012,8,4,12,348,652,1000,950
0131-002,2012,8,4,13,358,604,962,1000
0131-002,2012,8,4,14,372,548,920,962
0131-002,2012,8,4,15,396,488,884,920
0131-002,2012,8,4,16,456,429,885,884
0131-002,2012,8,4,17,523,407,930,885
0131-002,2012,8,4,18,525,440,965,930
0131-002,2012,8,4,19,484,380,864,965
0131-002,2012,8,4,20,377,298,675,864
0131-002,2012,8,4,21,379,265,644,675
0131-002,2012,8,4,22,336,248,584,644
0131-002,2012,8,4,23,186,174,360,584
0131-002,2012,8,4,24,123,112,235,360
0131-002,2012,8,5,1,72,94,166,235
0131-002,2012,8,5,2,51,58,109,166
0131-002,2012,8,5,3,34,48,82,109
0131-002,2012,8,5,4,28,22,50,82
0131-002,2012,8,5,5,31,33,64,50
0131-002,2012,8,5,6,51,60,111,64
0131-002,2012,8,5,7,104,98,202,111
0131-002,2012,8,5,8,196,166,362,202
0131-002,2012,8,5,9,150,210,360,362
0131-002,2012,8,5,10,209,205,414,360
0131-002,2012,8,5,11,227,240,467,414
0131-002,2012,8,5,12,238,262,500,467
0131-002,2012,8,5,13,328,288,616,500
0131-002,2012,8,5,14,334,321,655,616
0131-002,2012,8,5,15,445,334,779,655
0131-002,2012,8,5,16,480,339,819,779
0131-002,2012,8,5,17,484,322,806,819
0131-002,2012,8,5,18,516,367,883,806
0131-002,2012,8,5,19,512,448,960,883
0131-002,2012,8,5,20,501,282,783,960
0131-002,2012,8,5,21,364,268,632,783
0131-002,2012,8,5,22,351,250,601,632
0131-002,2012,8,5,23,186,172,358,601
0131-002,2012,8,5,24,126,94,220,358
0131-002,2012,8,6,1,69,75,144,220
0131-002,2012,8,6,2,36,38,74,144
0131-002,2012,8,6,3,28,30,58,74
0131-002,2012,8,6,4,23,30,53,58
0131-002,2012,8,6,5,46,57,103,53
0131-002,2012,8,6,6,98,98,196,103
0131-002,2012,8,6,7,346,228,574,196
0131-002,2012,8,6,8,744,568,1312,574
0131-002,2012,8,6,9,634,566,1200,1312
0131-002,2012,8,6,10,475,474,949,1200
0131-002,2012,8,6,11,466,466,932,949
0131-002,2012,8,6,12,489,510,999,932
0131-002,2012,8,6,13,361,418,779,999
0131-002,2012,8,6,14,459,507,966,779
0131-002,2012,8,6,15,481,526,1007,966
0131-002,2012,8,6,16,478,532,1010,1007
0131-002,2012,8,6,17,464,515,979,1010
0131-002,2012,8,6,18,457,575,1032,979
0131-002,2012,8,6,19,507,564,1071,1032
0131-002,2012,8,6,20,357,456,813,1071
0131-002,2012,8,6,21,263,426,689,813
0131-002,2012,8,6,22,239,299,538,689
0131-002,2012,8,6,23,154,181,335,538
0131-002,2012,8,6,24,124,109,233,335
0131-002,2012,8,7,1,72,78,150,233
0131-002,2012,8,7,2,57,56,113,150
0131-002,2012,8,7,3,32,43,75,113
0131-002,2012,8,7,4,34,36,70,75
0131-002,2012,8,7,5,54,60,114,70
0131-002,2012,8,7,6,111,110,221,114
0131-002,2012,8,7,7,332,203,535,221
0131-002,2012,8,7,8,709,477,1186,535
0131-002,2012,8,7,9,610,621,1231,1186
0131-002,2012,8,7,10,480,537,1017,1231
0131-002,2012,8,7,11,479,532,1011,1017
0131-002,2012,8,7,12,508,506,1014,1011
0131-002,2012,8,7,13,368,498,866,1014
0131-002,2012,8,7,14,452,566,1018,866
0131-002,2012,8,7,15,484,646,1130,1018
0131-002,2012,8,7,16,522,552,1074,1130
0131-002,2012,8,7,17,484,494,978,1074
0131-002,2012,8,7,18,480,560,1040,978
0131-002,2012,8,7,19,469,564,1033,1040
0131-002,2012,8,7,20,383,482,865,1033
0131-002,2012,8,7,21,299,423,722,865
0131-002,2012,8,7,22,237,301,538,722
0131-002,2012,8,7,23,167,228,395,538
0131-002,2012,8,7,24,100,125,225,395
0131-002,2012,8,8,1,76,76,152,225
0131-002,2012,8,8,2,39,53,92,152
0131-002,2012,8,8,3,36,35,71,92
0131-002,2012,8,8,4,35,41,76,71
0131-002,2012,8,8,5,44,60,104,76
0131-002,2012,8,8,6,101,94,195,104
0131-002,2012,8,8,7,327,194,521,195
0131-002,2012,8,8,8,687,512,1199,521
0131-002,2012,8,8,9,638,616,1254,1199
0131-002,2012,8,8,10,455,498,953,1254
0131-002,2012,8,8,11,490,498,988,953
0131-002,2012,8,8,12,453,493,946,988
0131-002,2012,8,8,13,379,423,802,946
0131-002,2012,8,8,14,445,494,939,802
0131-002,2012,8,8,15,487,521,1008,939
0131-002,2012,8,8,16,497,527,1024,1008
0131-002,2012,8,8,17,487,549,1036,1024
0131-002,2012,8,8,18,452,603,1055,1036
0131-002,2012,8,8,19,514,599,1113,1055
0131-002,2012,8,8,20,351,448,799,1113
0131-002,2012,8,8,21,276,397,673,799
0131-002,2012,8,8,22,220,306,526,673
0131-002,2012,8,8,23,133,215,348,526
0131-002,2012,8,8,24,100,128,228,348
0131-002,2012,8,9,1,63,79,142,228
0131-002,2012,8,9,2,52,61,113,142
0131-002,2012,8,9,3,40,47,87,113
0131-002,2012,8,9,4,24,44,68,87
0131-002,2012,8,9,5,45,62,107,68
0131-002,2012,8,9,6,90,92,182,107
0131-002,2012,8,9,7,329,202,531,182
0131-002,2012,8,9,8,696,508,1204,531
0131-002,2012,8,9,9,640,614,1254,1204
0131-002,2012,8,9,10,484,545,1029,1254
0131-002,2012,8,9,11,505,520,1025,1029
0131-002,2012,8,9,12,483,535,1018,1025
0131-002,2012,8,9,13,383,424,807,1018
0131-002,2012,8,9,14,454,454,908,807
0131-002,2012,8,9,15,499,532,1031,908
0131-002,2012,8,9,16,433,509,942,1031
0131-002,2012,8,9,17,449,515,964,942
0131-002,2012,8,9,18,406,624,1030,964
0131-002,2012,8,9,19,438,566,1004,1030
0131-002,2012,8,9,20,341,487,828,1004
0131-002,2012,8,9,21,292,411,703,828
0131-002,2012,8,9,22,250,310,560,703
0131-002,2012,8,9,23,162,205,367,560
0131-002,2012,8,9,24,112,109,221,367
0131-002,2012,8,10,1,84,90,174,221
0131-002,2012,8,10,2,50,53,103,174
0131-002,2012,8,10,3,39,34,73,103
0131-002,2012,8,10,4,40,48,88,73
0131-002,2012,8,10,5,48,65,113,88
0131-002,2012,8,10,6,89,106,195,113
0131-002,2012,8,10,7,347,168,515,195
0131-002,2012,8,10,8,674,503,1177,515
0131-002,2012,8,10,9,610,646,1256,1177
0131-002,2012,8,10,10,466,495,961,1256
0131-002,2012,8,10,11,466,474,940,961
0131-002,2012,8,10,12,428,487,915,940
0131-002,2012,8,10,13,413,468,881,915
0131-002,2012,8,10,14,438,492,930,881
0131-002,2012,8,10,15,458,565,1023,930
0131-002,2012,8,10,16,498,589,1087,1023
0131-002,2012,8,10,17,546,600,1146,1087
0131-002,2012,8,10,18,492,657,1149,1146
0131-002,2012,8,10,19,550,663,1213,1149
0131-002,2012,8,10,20,436,540,976,1213
0131-002,2012,8,10,21,338,451,789,976
0131-002,2012,8,10,22,330,351,681,789
0131-002,2012,8,10,23,177,235,412,681
0131-002,2012,8,10,24,129,151,280,412
0131-002,2012,8,11,1,92,114,206,280
0131-002,2012,8,11,2,66,75,141,206
0131-002,2012,8,11,3,45,61,106,141
0131-002,2012,8,11,4,45,58,103,106
0131-002,2012,8,11,5,35,51,86,103
0131-002,2012,8,11,6,100,88,188,86
0131-002,2012,8,11,7,234,184,418,188
0131-002,2012,8,11,8,414,322,736,418
0131-002,2012,8,11,9,396,418,814,736
0131-002,2012,8,11,10,408,441,849,814
0131-002,2012,8,11,11,393,568,961,849
0131-002,2012,8,11,12,377,652,1029,961
0131-002,2012,8,11,13,330,635,965,1029
0131-002,2012,8,11,14,372,650,1022,965
0131-002,2012,8,11,15,366,608,974,1022
0131-002,2012,8,11,16,374,511,885,974
0131-002,2012,8,11,17,407,511,918,885
0131-002,2012,8,11,18,435,578,1013,918
0131-002,2012,8,11,19,362,490,852,1013
0131-002,2012,8,11,20,287,357,644,852
0131-002,2012,8,11,21,252,254,506,644
0131-002,2012,8,11,22,288,257,545,506
0131-002,2012,8,11,23,136,154,290,545
0131-002,2012,8,11,24,117,107,224,290
0131-002,2012,8,12,1,58,89,147,224
0131-002,2012,8,12,2,54,58,112,147
0131-002,2012,8,12,3,37,49,86,112
0131-002,2012,8,12,4,39,38,77,86
0131-002,2012,8,12,5,30,36,66,77
0131-002,2012,8,12,6,63,57,120,66
0131-002,2012,8,12,7,122,104,226,120
0131-002,2012,8,12,8,166,137,303,226
0131-002,2012,8,12,9,181,198,379,303
0131-002,2012,8,12,10,210,231,441,379
0131-002,2012,8,12,11,232,288,520,441
0131-002,2012,8,12,12,246,277,523,520
0131-002,2012,8,12,13,242,307,549,523
0131-002,2012,8,12,14,255,318,573,549
0131-002,2012,8,12,15,359,313,672,573
0131-002,2012,8,12,16,344,317,661,672
0131-002,2012,8,12,17,381,324,705,661
0131-002,2012,8,12,18,390,298,688,705
0131-002,2012,8,12,19,386,249,635,688
0131-002,2012,8,12,20,366,258,624,635
0131-002,2012,8,12,21,292,187,479,624
0131-002,2012,8,12,22,264,175,439,479
0131-002,2012,8,12,23,141,137,278,439
0131-002,2012,8,12,24,100,84,184,278
0131-002,2012,8,13,1,67,54,121,184
0131-002,2012,8,13,2,40,38,78,121
0131-002,2012,8,13,3,27,37,64,78
0131-002,2012,8,13,4,26,35,61,64
0131-002,2012,8,13,5,33,42,75,61
0131-002,2012,8,13,6,84,82,166,75
0131-002,2012,8,13,7,391,204,595,166
0131-002,2012,8,13,8,774,511,1285,595
0131-002,2012,8,13,9,617,617,1234,1285
0131-002,2012,8,13,10,468,485,953,1234
0131-002,2012,8,13,11,491,503,994,953
0131-002,2012,8,13,12,462,505,967,994
0131-002,2012,8,13,13,373,478,851,967
0131-002,2012,8,13,14,467,478,945,851
0131-002,2012,8,13,15,496,553,1049,945
0131-002,2012,8,13,16,500,543,1043,1049
0131-002,2012,8,13,17,522,529,1051,1043
0131-002,2012,8,13,18,442,586,1028,1051
0131-002,2012,8,13,19,514,547,1061,1028
0131-002,2012,8,13,20,341,492,833,1061
0131-002,2012,8,13,21,314,445,759,833
0131-002,2012,8,13,22,251,321,572,759
0131-002,2012,8,13,23,168,231,399,572
0131-002,2012,8,13,24,132,114,246,399
0131-002,2012,8,14,1,85,68,153,246
0131-002,2012,8,14,2,36,53,89,153
0131-002,2012,8,14,3,44,35,79,89
0131-002,2012,8,14,4,31,43,74,79
0131-002,2012,8,14,5,35,49,84,74
0131-002,2012,8,14,6,123,94,217,84
0131-002,2012,8,14,7,332,208,540,217
0131-002,2012,8,14,8,745,519,1264,540
0131-002,2012,8,14,9,625,579,1204,1264
0131-002,2012,8,14,10,491,544,1035,1204
0131-002,2012,8,14,11,538,514,1052,1035
0131-002,2012,8,14,12,498,520,1018,1052
0131-002,2012,8,14,13,396,471,867,1018
0131-002,2012,8,14,14,462,520,982,867
0131-002,2012,8,14,15,513,604,1117,982
0131-002,2012,8,14,16,504,593,1097,1117
0131-002,2012,8,14,17,498,602,1100,1097
0131-002,2012,8,14,18,549,671,1220,1100
0131-002,2012,8,14,19,535,714,1249,1220
0131-002,2012,8,14,20,395,578,973,1249
0131-002,2012,8,14,21,342,479,821,973
0131-002,2012,8,14,22,247,348,595,821
0131-002,2012,8,14,23,180,223,403,595
0131-002,2012,8,14,24,120,156,276,403
0131-002,2012,8,15,1,87,91,178,276
0131-002,2012,8,15,2,71,78,149,178
0131-002,2012,8,15,3,48,47,95,149
0131-002,2012,8,15,4,43,43,86,95
0131-002,2012,8,15,5,47,60,107,86
0131-002,2012,8,15,6,64,70,134,107
0131-002,2012,8,15,7,187,123,310,134
0131-002,2012,8,15,8,394,236,630,310
0131-002,2012,8,15,9,367,342,709,630
0131-002,2012,8,15,10,329,345,674,709
0131-002,2012,8,15,11,314,361,675,674
0131-002,2012,8,15,12,336,355,691,675
0131-002,2012,8,15,13,282,350,632,691
0131-002,2012,8,15,14,300,337,637,632
0131-002,2012,8,15,15,306,366,672,637
0131-002,2012,8,15,16,316,400,716,672
0131-002,2012,8,15,17,371,370,741,716
0131-002,2012,8,15,18,428,398,826,741
0131-002,2012,8,15,19,342,332,674,826
0131-002,2012,8,15,20,234,274,508,674
0131-002,2012,8,15,21,192,220,412,508
0131-002,2012,8,15,22,146,156,302,412
0131-002,2012,8,15,23,114,130,244,302
0131-002,2012,8,15,24,65,84,149,244
0131-002,2012,8,16,1,67,58,125,149
0131-002,2012,8,16,2,34,40,74,125
0131-002,2012,8,16,3,26,22,48,74
0131-002,2012,8,16,4,29,37,66,48
0131-002,2012,8,16,5,39,46,85,66
0131-002,2012,8,16,6,85,78,163,85
0131-002,2012,8,16,7,306,173,479,163
0131-002,2012,8,16,8,797,515,1312,479
0131-002,2012,8,16,9,647,593,1240,1312
0131-002,2012,8,16,10,495,487,982,1240
0131-002,2012,8,16,11,504,492,996,982
0131-002,2012,8,16,12,476,523,999,996
0131-002,2012,8,16,13,390,454,844,999
0131-002,2012,8,16,14,484,505,989,844
0131-002,2012,8,16,15,517,590,1107,989
0131-002,2012,8,16,16,520,556,1076,1107
0131-002,2012,8,16,17,491,572,1063,1076
0131-002,2012,8,16,18,446,540,986,1063
0131-002,2012,8,16,19,450,567,1017,986
0131-002,2012,8,16,20,356,498,854,1017
0131-002,2012,8,16,21,292,448,740,854
0131-002,2012,8,16,22,234,304,538,740
0131-002,2012,8,16,23,159,205,364,538
0131-002,2012,8,16,24,132,122,254,364
0131-002,2012,8,17,1,85,89,174,254
0131-002,2012,8,17,2,46,50,96,174
0131-002,2012,8,17,3,31,30,61,96
0131-002,2012,8,17,4,44,42,86,61
0131-002,2012,8,17,5,48,68,116,86
0131-002,2012,8,17,6,101,89,190,116
0131-002,2012,8,17,7,336,183,519,190
0131-002,2012,8,17,8,745,505,1250,519
0131-002,2012,8,17,9,646,607,1253,1250
0131-002,2012,8,17,10,537,551,1088,1253
0131-002,2012,8,17,11,520,561,1081,1088
0131-002,2012,8,17,12,510,564,1074,1081
0131-002,2012,8,17,13,388,466,854,1074
0131-002,2012,8,17,14,488,510,998,854
0131-002,2012,8,17,15,538,567,1105,998
0131-002,2012,8,17,16,496,589,1085,1105
0131-002,2012,8,17,17,528,570,1098,1085
0131-002,2012,8,17,18,516,636,1152,1098
0131-002,2012,8,17,19,526,636,1162,1152
0131-002,2012,8,17,20,450,522,972,1162
0131-002,2012,8,17,21,369,492,861,972
0131-002,2012,8,17,22,302,342,644,861
0131-002,2012,8,17,23,201,214,415,644
0131-002,2012,8,17,24,129,150,279,415
0131-002,2012,8,18,1,83,106,189,279
0131-002,2012,8,18,2,71,102,173,189
0131-002,2012,8,18,3,35,59,94,173
0131-002,2012,8,18,4,38,49,87,94
0131-002,2012,8,18,5,47,73,120,87
0131-002,2012,8,18,6,93,82,175,120
0131-002,2012,8,18,7,238,162,400,175
0131-002,2012,8,18,8,453,300,753,400
0131-002,2012,8,18,9,424,415,839,753
0131-002,2012,8,18,10,436,434,870,839
0131-002,2012,8,18,11,412,514,926,870
0131-002,2012,8,18,12,405,555,960,926
0131-002,2012,8,18,13,374,568,942,960
0131-002,2012,8,18,14,426,593,1019,942
0131-002,2012,8,18,15,440,608,1048,1019
0131-002,2012,8,18,16,402,538,940,1048
0131-002,2012,8,18,17,398,505,903,940
0131-002,2012,8,18,18,417,545,962,903
0131-002,2012,8,18,19,367,441,808,962
0131-002,2012,8,18,20,288,345,633,808
0131-002,2012,8,18,21,262,264,526,633
0131-002,2012,8,18,22,245,222,467,526
0131-002,2012,8,18,23,137,214,351,467
0131-002,2012,8,18,24,85,114,199,351
0131-002,2012,8,19,1,62,72,134,199
0131-002,2012,8,19,2,56,67,123,134
0131-002,2012,8,19,3,42,50,92,123
0131-002,2012,8,19,4,31,41,72,92
0131-002,2012,8,19,5,35,35,70,72
0131-002,2012,8,19,6,59,58,117,70
0131-002,2012,8,19,7,118,92,210,117
0131-002,2012,8,19,8,178,114,292,210
0131-002,2012,8,19,9,210,204,414,292
0131-002,2012,8,19,10,217,209,426,414
0131-002,2012,8,19,11,257,257,514,426
0131-002,2012,8,19,12,246,300,546,514
0131-002,2012,8,19,13,246,310,556,546
0131-002,2012,8,19,14,296,315,611,556
0131-002,2012,8,19,15,334,327,661,611
0131-002,2012,8,19,16,382,337,719,661
0131-002,2012,8,19,17,413,370,783,719
0131-002,2012,8,19,18,432,403,835,783
0131-002,2012,8,19,19,346,330,676,835
0131-002,2012,8,19,20,274,312,586,676
0131-002,2012,8,19,21,264,250,514,586
0131-002,2012,8,19,22,262,208,470,514
0131-002,2012,8,19,23,150,150,300,470
0131-002,2012,8,19,24,106,84,190,300
0131-002,2012,8,20,1,61,64,125,190
0131-002,2012,8,20,2,37,45,82,125
0131-002,2012,8,20,3,34,32,66,82
0131-002,2012,8,20,4,30,33,63,66
0131-002,2012,8,20,5,43,54,97,63
0131-002,2012,8,20,6,93,102,195,97
0131-002,2012,8,20,7,358,216,574,195
0131-002,2012,8,20,8,744,574,1318,574
0131-002,2012,8,20,9,630,563,1193,1318
0131-002,2012,8,20,10,435,485,920,1193
0131-002,2012,8,20,11,517,510,1027,920
0131-002,2012,8,20,12,453,460,913,1027
0131-002,2012,8,20,13,421,432,853,913
0131-002,2012,8,20,14,430,452,882,853
0131-002,2012,8,20,15,426,538,964,882
0131-002,2012,8,20,16,482,520,1002,964
0131-002,2012,8,20,17,437,534,971,1002
0131-002,2012,8,20,18,451,560,1011,971
0131-002,2012,8,20,19,438,553,991,1011
0131-002,2012,8,20,20,330,462,792,991
0131-002,2012,8,20,21,252,418,670,792
0131-002,2012,8,20,22,227,283,510,670
0131-002,2012,8,20,23,140,180,320,510
0131-002,2012,8,20,24,101,116,217,320
0131-002,2012,8,21,1,58,81,139,217
0131-002,2012,8,21,2,40,58,98,139
0131-002,2012,8,21,3,30,33,63,98
0131-002,2012,8,21,4,25,39,64,63
0131-002,2012,8,21,5,40,44,84,64
0131-002,2012,8,21,6,86,90,176,84
0131-002,2012,8,21,7,292,163,455,176
0131-002,2012,8,21,8,746,506,1252,455
0131-002,2012,8,21,9,628,615,1243,1252
0131-002,2012,8,21,10,486,502,988,1243
0131-002,2012,8,21,11,511,484,995,988
0131-002,2012,8,21,12,450,508,958,995
0131-002,2012,8,21,13,368,432,800,958
0131-002,2012,8,21,14,463,494,957,800
0131-002,2012,8,21,15,474,567,1041,957
0131-002,2012,8,21,16,456,490,946,1041
0131-002,2012,8,21,17,467,520,987,946
0131-002,2012,8,21,18,461,574,1035,987
0131-002,2012,8,21,19,424,570,994,1035
0131-002,2012,8,21,20,348,474,822,994
0131-002,2012,8,21,21,304,440,744,822
0131-002,2012,8,21,22,259,287,546,744
0131-002,2012,8,21,23,150,216,366,546
0131-002,2012,8,21,24,118,113,231,366
0131-002,2012,8,22,1,76,67,143,231
0131-002,2012,8,22,2,47,65,112,143
0131-002,2012,8,22,3,34,39,73,112
0131-002,2012,8,22,4,35,38,73,73
0131-002,2012,8,22,5,34,53,87,73
0131-002,2012,8,22,6,78,64,142,87
0131-002,2012,8,22,7,278,143,421,142
0131-002,2012,8,22,8,688,522,1210,421
0131-002,2012,8,22,9,615,587,1202,1210
0131-002,2012,8,22,10,482,522,1004,1202
0131-002,2012,8,22,11,430,487,917,1004
0131-002,2012,8,22,12,447,473,920,917
0131-002,2012,8,22,13,380,400,780,920
0131-002,2012,8,22,14,438,462,900,780
0131-002,2012,8,22,15,438,493,931,900
0131-002,2012,8,22,16,498,540,1038,931
0131-002,2012,8,22,17,496,488,984,1038
0131-002,2012,8,22,18,453,585,1038,984
0131-002,2012,8,22,19,453,589,1042,1038
0131-002,2012,8,22,20,355,438,793,1042
0131-002,2012,8,22,21,273,380,653,793
0131-002,2012,8,22,22,229,290,519,653
0131-002,2012,8,22,23,154,193,347,519
0131-002,2012,8,22,24,108,110,218,347
0131-002,2012,8,23,1,83,80,163,218
0131-002,2012,8,23,2,53,60,113,163
0131-002,2012,8,23,3,33,50,83,113
0131-002,2012,8,23,4,34,38,72,83
0131-002,2012,8,23,5,39,55,94,72
0131-002,2012,8,23,6,90,84,174,94
0131-002,2012,8,23,7,334,166,500,174
0131-002,2012,8,23,8,740,522,1262,500
0131-002,2012,8,23,9,620,590,1210,1262
0131-002,2012,8,23,10,501,523,1024,1210
0131-002,2012,8,23,11,484,525,1009,1024
0131-002,2012,8,23,12,491,506,997,1009
0131-002,2012,8,23,13,390,454,844,997
0131-002,2012,8,23,14,454,508,962,844
0131-002,2012,8,23,15,484,528,1012,962
0131-002,2012,8,23,16,509,501,1010,1012
0131-002,2012,8,23,17,461,502,963,1010
0131-002,2012,8,23,18,503,609,1112,963
0131-002,2012,8,23,19,481,540,1021,1112
0131-002,2012,8,23,20,362,486,848,1021
0131-002,2012,8,23,21,298,432,730,848
0131-002,2012,8,23,22,248,308,556,730
0131-002,2012,8,23,23,174,201,375,556
0131-002,2012,8,23,24,112,115,227,375
0131-002,2012,8,24,1,75,95,170,227
0131-002,2012,8,24,2,58,54,112,170
0131-002,2012,8,24,3,47,46,93,112
0131-002,2012,8,24,4,26,40,66,93
0131-002,2012,8,24,5,41,58,99,66
0131-002,2012,8,24,6,78,78,156,99
0131-002,2012,8,24,7,283,151,434,156
0131-002,2012,8,24,8,721,514,1235,434
0131-002,2012,8,24,9,625,602,1227,1235
0131-002,2012,8,24,10,515,516,1031,1227
0131-002,2012,8,24,11,492,499,991,1031
0131-002,2012,8,24,12,480,515,995,991
0131-002,2012,8,24,13,390,452,842,995
0131-002,2012,8,24,14,472,502,974,842
0131-002,2012,8,24,15,512,559,1071,974
0131-002,2012,8,24,16,447,532,979,1071
0131-002,2012,8,24,17,466,585,1051,979
0131-002,2012,8,24,18,533,605,1138,1051
0131-002,2012,8,24,19,537,604,1141,1138
0131-002,2012,8,24,20,417,508,925,1141
0131-002,2012,8,24,21,305,432,737,925
0131-002,2012,8,24,22,247,318,565,737
0131-002,2012,8,24,23,172,208,380,565
0131-002,2012,8,24,24,122,138,260,380
0131-002,2012,8,25,1,88,99,187,260
0131-002,2012,8,25,2,59,80,139,187
0131-002,2012,8,25,3,41,51,92,139
0131-002,2012,8,25,4,31,54,85,92
0131-002,2012,8,25,5,42,62,104,85
0131-002,2012,8,25,6,101,92,193,104
0131-002,2012,8,25,7,195,169,364,193
0131-002,2012,8,25,8,442,308,750,364
0131-002,2012,8,25,9,488,439,927,750
0131-002,2012,8,25,10,444,503,947,927
0131-002,2012,8,25,11,443,571,1014,947
0131-002,2012,8,25,12,459,603,1062,1014
0131-002,2012,8,25,13,430,590,1020,1062
0131-002,2012,8,25,14,430,553,983,1020
0131-002,2012,8,25,15,418,533,951,983
0131-002,2012,8,25,16,418,584,1002,951
0131-002,2012,8,25,17,510,664,1174,1002
0131-002,2012,8,25,18,528,775,1303,1174
0131-002,2012,8,25,19,450,605,1055,1303
0131-002,2012,8,25,20,334,395,729,1055
0131-002,2012,8,25,21,264,273,537,729
0131-002,2012,8,25,22,216,232,448,537
0131-002,2012,8,25,23,184,189,373,448
0131-002,2012,8,25,24,115,132,247,373
0131-002,2012,8,26,1,82,98,180,247
0131-002,2012,8,26,2,50,58,108,180
0131-002,2012,8,26,3,49,45,94,108
0131-002,2012,8,26,4,38,42,80,94
0131-002,2012,8,26,5,35,38,73,80
0131-002,2012,8,26,6,54,49,103,73
0131-002,2012,8,26,7,126,88,214,103
0131-002,2012,8,26,8,208,150,358,214
0131-002,2012,8,26,9,218,239,457,358
0131-002,2012,8,26,10,220,244,464,457
0131-002,2012,8,26,11,260,316,576,464
0131-002,2012,8,26,12,304,321,625,576
0131-002,2012,8,26,13,300,320,620,625
0131-002,2012,8,26,14,361,331,692,620
0131-002,2012,8,26,15,363,372,735,692
0131-002,2012,8,26,16,394,364,758,735
0131-002,2012,8,26,17,451,418,869,758
0131-002,2012,8,26,18,468,408,876,869
0131-002,2012,8,26,19,426,347,773,876
0131-002,2012,8,26,20,343,321,664,773
0131-002,2012,8,26,21,327,268,595,664
0131-002,2012,8,26,22,296,248,544,595
0131-002,2012,8,26,23,184,169,353,544
0131-002,2012,8,26,24,103,127,230,353
0131-002,2012,8,27,1,74,66,140,230
0131-002,2012,8,27,2,46,47,93,140
0131-002,2012,8,27,3,24,22,46,93
0131-002,2012,8,27,4,28,42,70,46
0131-002,2012,8,27,5,38,61,99,70
0131-002,2012,8,27,6,107,106,213,99
0131-002,2012,8,27,7,398,232,630,213
0131-002,2012,8,27,8,835,596,1431,630
0131-002,2012,8,27,9,665,611,1276,1431
0131-002,2012,8,27,10,536,508,1044,1276
0131-002,2012,8,27,11,522,546,1068,1044
0131-002,2012,8,27,12,487,525,1012,1068
0131-002,2012,8,27,13,406,451,857,1012
0131-002,2012,8,27,14,501,539,1040,857
0131-002,2012,8,27,15,537,558,1095,1040
0131-002,2012,8,27,16,526,547,1073,1095
0131-002,2012,8,27,17,510,536,1046,1073
0131-002,2012,8,27,18,512,630,1142,1046
0131-002,2012,8,27,19,503,622,1125,1142
0131-002,2012,8,27,20,397,515,912,1125
0131-002,2012,8,27,21,312,471,783,912
0131-002,2012,8,27,22,249,316,565,783
0131-002,2012,8,27,23,154,191,345,565
0131-002,2012,8,27,24,102,133,235,345
0131-002,2012,8,28,1,56,76,132,235
0131-002,2012,8,28,2,52,58,110,132
0131-002,2012,8,28,3,32,41,73,110
0131-002,2012,8,28,4,31,37,68,73
0131-002,2012,8,28,5,30,48,78,68
0131-002,2012,8,28,6,72,81,153,78
0131-002,2012,8,28,7,261,135,396,153
0131-002,2012,8,28,8,633,426,1059,396
0131-002,2012,8,28,9,536,491,1027,1059
0131-002,2012,8,28,10,339,386,725,1027
0131-002,2012,8,28,11,321,348,669,725
0131-002,2012,8,28,12,259,329,588,669
0131-002,2012,8,28,13,232,270,502,588
0131-002,2012,8,28,14,245,281,526,502
0131-002,2012,8,28,15,276,344,620,526
0131-002,2012,8,28,16,293,338,631,620
0131-002,2012,8,28,17,263,327,590,631
0131-002,2012,8,28,18,294,414,708,590
0131-002,2012,8,28,19,346,426,772,708
0131-002,2012,8,28,20,251,323,574,772
0131-002,2012,8,28,21,179,327,506,574
0131-002,2012,8,28,22,138,209,347,506
0131-002,2012,8,28,23,108,129,237,347
0131-002,2012,8,28,24,76,84,160,237
0131-002,2012,8,29,1,43,59,102,160
0131-002,2012,8,29,2,42,40,82,102
0131-002,2012,8,29,3,31,24,55,82
0131-002,2012,8,29,4,19,28,47,55
0131-002,2012,8,29,5,30,46,76,47
0131-002,2012,8,29,6,85,82,167,76
0131-002,2012,8,29,7,319,150,469,167
0131-002,2012,8,29,8,723,510,1233,469
0131-002,2012,8,29,9,642,623,1265,1233
0131-002,2012,8,29,10,513,507,1020,1265
0131-002,2012,8,29,11,510,557,1067,1020
0131-002,2012,8,29,12,486,516,1002,1067
0131-002,2012,8,29,13,377,480,857,1002
0131-002,2012,8,29,14,448,526,974,857
0131-002,2012,8,29,15,534,563,1097,974
0131-002,2012,8,29,16,514,562,1076,1097
0131-002,2012,8,29,17,493,518,1011,1076
0131-002,2012,8,29,18,513,628,1141,1011
0131-002,2012,8,29,19,480,624,1104,1141
0131-002,2012,8,29,20,382,494,876,1104
0131-002,2012,8,29,21,261,424,685,876
0131-002,2012,8,29,22,256,304,560,685
0131-002,2012,8,29,23,169,202,371,560
0131-002,2012,8,29,24,123,141,264,371
0131-002,2012,8,30,1,99,95,194,264
0131-002,2012,8,30,2,51,58,109,194
0131-002,2012,8,30,3,32,48,80,109
0131-002,2012,8,30,4,42,47,89,80
0131-002,2012,8,30,5,42,60,102,89
0131-002,2012,8,30,6,72,68,140,102
0131-002,2012,8,30,7,304,151,455,140
0131-002,2012,8,30,8,705,496,1201,455
0131-002,2012,8,30,9,623,578,1201,1201
0131-002,2012,8,30,10,460,480,940,1201
0131-002,2012,8,30,11,401,434,835,940
0131-002,2012,8,30,12,435,448,883,835
0131-002,2012,8,30,13,372,433,805,883
0131-002,2012,8,30,14,399,446,845,805
0131-002,2012,8,30,15,390,426,816,845
0131-002,2012,8,30,16,472,464,936,816
0131-002,2012,8,30,17,389,423,812,936
0131-002,2012,8,30,18,411,505,916,812
0131-002,2012,8,30,19,477,535,1012,916
0131-002,2012,8,30,20,324,436,760,1012
0131-002,2012,8,30,21,268,388,656,760
0131-002,2012,8,30,22,214,265,479,656
0131-002,2012,8,30,23,145,168,313,479
0131-002,2012,8,30,24,108,111,219,313
0131-002,2012,8,31,1,54,69,123,219
0131-002,2012,8,31,2,54,50,104,123
0131-002,2012,8,31,3,48,46,94,104
0131-002,2012,8,31,4,28,43,71,94
0131-002,2012,8,31,5,40,56,96,71
0131-002,2012,8,31,6,83,84,167,96
0131-002,2012,8,31,7,326,174,500,167
0131-002,2012,8,31,8,746,532,1278,500
0131-002,2012,8,31,9,644,631,1275,1278
0131-002,2012,8,31,10,520,521,1041,1275
0131-002,2012,8,31,11,558,565,1123,1041
0131-002,2012,8,31,12,520,557,1077,1123
0131-002,2012,8,31,13,392,454,846,1077
0131-002,2012,8,31,14,486,516,1002,846
0131-002,2012,8,31,15,527,575,1102,1002
0131-002,2012,8,31,16,492,585,1077,1102
0131-002,2012,8,31,17,467,586,1053,1077
0131-002,2012,8,31,18,611,680,1291,1053
0131-002,2012,8,31,19,546,614,1160,1291
0131-002,2012,8,31,20,451,549,1000,1160
0131-002,2012,8,31,21,320,453,773,1000
0131-002,2012,8,31,22,290,372,662,773
0131-002,2012,8,31,23,212,256,468,662
0131-002,2012,8,31,24,156,177,333,468
0131-002,2012,9,1,1,58,89,147,333
0131-002,2012,9,1,2,46,69,115,147
0131-002,2012,9,1,3,45,51,96,115
0131-002,2012,9,1,4,37,52,89,96
0131-002,2012,9,1,5,26,49,75,89
0131-002,2012,9,1,6,69,81,150,75
0131-002,2012,9,1,7,177,153,330,150
0131-002,2012,9,1,8,338,290,628,330
0131-002,2012,9,1,9,337,418,755,628
0131-002,2012,9,1,10,249,425,674,755
0131-002,2012,9,1,11,278,488,766,674
0131-002,2012,9,1,12,250,552,802,766
0131-002,2012,9,1,13,246,556,802,802
0131-002,2012,9,1,14,230,574,804,802
0131-002,2012,9,1,15,280,554,834,804
0131-002,2012,9,1,16,302,596,898,834
0131-002,2012,9,1,17,302,599,901,898
0131-002,2012,9,1,18,357,585,942,901
0131-002,2012,9,1,19,363,499,862,942
0131-002,2012,9,1,20,264,340,604,862
0131-002,2012,9,1,21,215,260,475,604
0131-002,2012,9,1,22,204,229,433,475
0131-002,2012,9,1,23,146,161,307,433
0131-002,2012,9,1,24,73,93,166,307
0131-002,2012,9,2,1,49,62,111,166
0131-002,2012,9,2,2,21,35,56,111
0131-002,2012,9,2,3,31,33,64,56
0131-002,2012,9,2,4,25,28,53,64
0131-002,2012,9,2,5,27,19,46,53
0131-002,2012,9,2,6,34,36,70,46
0131-002,2012,9,2,7,74,77,151,70
0131-002,2012,9,2,8,130,121,251,151
0131-002,2012,9,2,9,156,171,327,251
0131-002,2012,9,2,10,205,225,430,327
0131-002,2012,9,2,11,199,250,449,430
0131-002,2012,9,2,12,200,249,449,449
0131-002,2012,9,2,13,174,216,390,449
0131-002,2012,9,2,14,232,240,472,390
0131-002,2012,9,2,15,268,283,551,472
0131-002,2012,9,2,16,264,273,537,551
0131-002,2012,9,2,17,399,329,728,537
0131-002,2012,9,2,18,495,344,839,728
0131-002,2012,9,2,19,316,254,570,839
0131-002,2012,9,2,20,256,225,481,570
0131-002,2012,9,2,21,232,202,434,481
0131-002,2012,9,2,22,233,158,391,434
0131-002,2012,9,2,23,86,107,193,391
0131-002,2012,9,2,24,85,75,160,193
0131-002,2012,9,3,1,42,53,95,160
0131-002,2012,9,3,2,35,35,70,95
0131-002,2012,9,3,3,20,27,47,70
0131-002,2012,9,3,4,23,24,47,47
0131-002,2012,9,3,5,29,42,71,47
0131-002,2012,9,3,6,76,86,162,71
0131-002,2012,9,3,7,285,206,491,162
0131-002,2012,9,3,8,686,531,1217,491
0131-002,2012,9,3,9,515,533,1048,1217
0131-002,2012,9,3,10,377,428,805,1048
0131-002,2012,9,3,11,443,465,908,805
0131-002,2012,9,3,12,423,439,862,908
0131-002,2012,9,3,13,353,393,746,862
0131-002,2012,9,3,14,367,439,806,746
0131-002,2012,9,3,15,453,501,954,806
0131-002,2012,9,3,16,462,503,965,954
0131-002,2012,9,3,17,480,501,981,965
0131-002,2012,9,3,18,416,531,947,981
0131-002,2012,9,3,19,448,501,949,947
0131-002,2012,9,3,20,300,390,690,949
0131-002,2012,9,3,21,308,390,698,690
0131-002,2012,9,3,22,226,254,480,698
0131-002,2012,9,3,23,128,170,298,480
0131-002,2012,9,3,24,90,100,190,298
0131-002,2012,9,4,1,63,70,133,190
0131-002,2012,9,4,2,37,40,77,133
0131-002,2012,9,4,3,28,30,58,77
0131-002,2012,9,4,4,43,35,78,58
0131-002,2012,9,4,5,29,50,79,78
0131-002,2012,9,4,6,93,78,171,79
0131-002,2012,9,4,7,229,175,404,171
0131-002,2012,9,4,8,561,437,998,404
0131-002,2012,9,4,9,460,489,949,998
0131-002,2012,9,4,10,375,441,816,949
0131-002,2012,9,4,11,419,407,826,816
0131-002,2012,9,4,12,319,381,700,826
0131-002,2012,9,4,13,334,352,686,700
0131-002,2012,9,4,14,380,405,785,686
0131-002,2012,9,4,15,367,424,791,785
0131-002,2012,9,4,16,377,400,777,791
0131-002,2012,9,4,17,351,409,760,777
0131-002,2012,9,4,18,371,456,827,760
0131-002,2012,9,4,19,326,426,752,827
0131-002,2012,9,4,20,281,371,652,752
0131-002,2012,9,4,21,254,326,580,652
0131-002,2012,9,4,22,169,215,384,580
0131-002,2012,9,4,23,128,157,285,384
0131-002,2012,9,4,24,80,95,175,285
0131-002,2012,9,5,1,42,60,102,175
0131-002,2012,9,5,2,39,43,82,102
0131-002,2012,9,5,3,18,23,41,82
0131-002,2012,9,5,4,19,29,48,41
0131-002,2012,9,5,5,29,40,69,48
0131-002,2012,9,5,6,66,65,131,69
0131-002,2012,9,5,7,215,150,365,131
0131-002,2012,9,5,8,567,436,1003,365
0131-002,2012,9,5,9,467,527,994,1003
0131-002,2012,9,5,10,431,447,878,994
0131-002,2012,9,5,11,368,445,813,878
0131-002,2012,9,5,12,316,424,740,813
0131-002,2012,9,5,13,214,351,565,740
0131-002,2012,9,5,14,262,440,702,565
0131-002,2012,9,5,15,259,445,704,702
0131-002,2012,9,5,16,315,472,787,704
0131-002,2012,9,5,17,331,475,806,787
0131-002,2012,9,5,18,350,519,869,806
0131-002,2012,9,5,19,338,465,803,869
0131-002,2012,9,5,20,311,426,737,803
0131-002,2012,9,5,21,271,351,622,737
0131-002,2012,9,5,22,212,261,473,622
0131-002,2012,9,5,23,171,194,365,473
0131-002,2012,9,5,24,92,112,204,365
0131-002,2012,9,6,1,68,90,158,204
0131-002,2012,9,6,2,47,51,98,158
0131-002,2012,9,6,3,58,35,93,98
0131-002,2012,9,6,4,24,37,61,93
0131-002,2012,9,6,5,25,46,71,61
0131-002,2012,9,6,6,76,84,160,71
0131-002,2012,9,6,7,235,186,421,160
0131-002,2012,9,6,8,583,466,1049,421
0131-002,2012,9,6,9,537,555,1092,1049
0131-002,2012,9,6,10,386,469,855,1092
0131-002,2012,9,6,11,391,466,857,855
0131-002,2012,9,6,12,282,440,722,857
0131-002,2012,9,6,13,234,398,632,722
0131-002,2012,9,6,14,266,422,688,632
0131-002,2012,9,6,15,297,501,798,688
0131-002,2012,9,6,16,321,489,810,798
0131-002,2012,9,6,17,345,478,823,810
0131-002,2012,9,6,18,346,515,861,823
0131-002,2012,9,6,19,434,485,919,861
0131-002,2012,9,6,20,386,434,820,919
0131-002,2012,9,6,21,260,332,592,820
0131-002,2012,9,6,22,252,278,530,592
0131-002,2012,9,6,23,146,177,323,530
0131-002,2012,9,6,24,114,120,234,323
0131-002,2012,9,7,1,71,89,160,234
0131-002,2012,9,7,2,37,49,86,160
0131-002,2012,9,7,3,30,39,69,86
0131-002,2012,9,7,4,21,33,54,69
0131-002,2012,9,7,5,42,54,96,54
0131-002,2012,9,7,6,76,93,169,96
0131-002,2012,9,7,7,290,178,468,169
0131-002,2012,9,7,8,642,476,1118,468
0131-002,2012,9,7,9,517,546,1063,1118
0131-002,2012,9,7,10,424,456,880,1063
0131-002,2012,9,7,11,447,496,943,880
0131-002,2012,9,7,12,367,465,832,943
0131-002,2012,9,7,13,283,397,680,832
0131-002,2012,9,7,14,323,450,773,680
0131-002,2012,9,7,15,409,514,923,773
0131-002,2012,9,7,16,460,511,971,923
0131-002,2012,9,7,17,442,529,971,971
0131-002,2012,9,7,18,494,564,1058,971
0131-002,2012,9,7,19,479,526,1005,1058
0131-002,2012,9,7,20,446,457,903,1005
0131-002,2012,9,7,21,372,399,771,903
0131-002,2012,9,7,22,325,282,607,771
0131-002,2012,9,7,23,200,228,428,607
0131-002,2012,9,7,24,195,203,398,428
0131-002,2012,9,8,1,67,98,165,398
0131-002,2012,9,8,2,53,63,116,165
0131-002,2012,9,8,3,48,50,98,116
0131-002,2012,9,8,4,17,35,52,98
0131-002,2012,9,8,5,43,45,88,52
0131-002,2012,9,8,6,56,78,134,88
0131-002,2012,9,8,7,152,131,283,134
0131-002,2012,9,8,8,355,284,639,283
0131-002,2012,9,8,9,333,401,734,639
0131-002,2012,9,8,10,306,433,739,734
0131-002,2012,9,8,11,321,559,880,739
0131-002,2012,9,8,12,284,550,834,880
0131-002,2012,9,8,13,336,566,902,834
0131-002,2012,9,8,14,363,542,905,902
0131-002,2012,9,8,15,379,475,854,905
0131-002,2012,9,8,16,487,464,951,854
0131-002,2012,9,8,17,511,404,915,951
0131-002,2012,9,8,18,552,466,1018,915
0131-002,2012,9,8,19,498,397,895,1018
0131-002,2012,9,8,20,368,294,662,895
0131-002,2012,9,8,21,340,241,581,662
0131-002,2012,9,8,22,269,202,471,581
0131-002,2012,9,8,23,164,156,320,471
0131-002,2012,9,8,24,118,110,228,320
0131-002,2012,9,9,1,45,55,100,228
0131-002,2012,9,9,2,38,40,78,100
0131-002,2012,9,9,3,24,30,54,78
0131-002,2012,9,9,4,38,28,66,54
0131-002,2012,9,9,5,27,26,53,66
0131-002,2012,9,9,6,40,44,84,53
0131-002,2012,9,9,7,90,81,171,84
0131-002,2012,9,9,8,197,157,354,171
0131-002,2012,9,9,9,151,201,352,354
0131-002,2012,9,9,10,194,179,373,352
0131-002,2012,9,9,11,223,223,446,373
0131-002,2012,9,9,12,245,256,501,446
0131-002,2012,9,9,13,295,244,539,501
0131-002,2012,9,9,14,288,261,549,539
0131-002,2012,9,9,15,384,271,655,549
0131-002,2012,9,9,16,409,273,682,655
0131-002,2012,9,9,17,442,277,719,682
0131-002,2012,9,9,18,485,322,807,719
0131-002,2012,9,9,19,346,287,633,807
0131-002,2012,9,9,20,444,235,679,633
0131-002,2012,9,9,21,260,181,441,679
0131-002,2012,9,9,22,263,177,440,441
0131-002,2012,9,9,23,140,121,261,440
0131-002,2012,9,9,24,99,70,169,261
0131-002,2012,9,10,1,48,52,100,169
0131-002,2012,9,10,2,37,39,76,100
0131-002,2012,9,10,3,18,20,38,76
0131-002,2012,9,10,4,23,30,53,38
0131-002,2012,9,10,5,31,39,70,53
0131-002,2012,9,10,6,79,79,158,70
0131-002,2012,9,10,7,280,187,467,158
0131-002,2012,9,10,8,663,508,1171,467
0131-002,2012,9,10,9,577,524,1101,1171
0131-002,2012,9,10,10,440,443,883,1101
0131-002,2012,9,10,11,448,453,901,883
0131-002,2012,9,10,12,421,444,865,901
0131-002,2012,9,10,13,333,389,722,865
0131-002,2012,9,10,14,384,429,813,722
0131-002,2012,9,10,15,428,474,902,813
0131-002,2012,9,10,16,431,484,915,902
0131-002,2012,9,10,17,419,470,889,915
0131-002,2012,9,10,18,397,504,901,889
0131-002,2012,9,10,19,440,495,935,901
0131-002,2012,9,10,20,331,427,758,935
0131-002,2012,9,10,21,233,381,614,758
0131-002,2012,9,10,22,207,262,469,614
0131-002,2012,9,10,23,141,167,308,469
0131-002,2012,9,10,24,126,112,238,308
0131-002,2012,9,11,1,75,83,158,238
0131-002,2012,9,11,2,43,43,86,158
0131-002,2012,9,11,3,31,42,73,86
0131-002,2012,9,11,4,40,43,83,73
0131-002,2012,9,11,5,52,57,109,83
0131-002,2012,9,11,6,75,76,151,109
0131-002,2012,9,11,7,283,177,460,151
0131-002,2012,9,11,8,693,472,1165,460
0131-002,2012,9,11,9,553,560,1113,1165
0131-002,2012,9,11,10,400,455,855,1113
0131-002,2012,9,11,11,399,451,850,855
0131-002,2012,9,11,12,452,456,908,850
0131-002,2012,9,11,13,306,421,727,908
0131-002,2012,9,11,14,369,470,839,727
0131-002,2012,9,11,15,348,478,826,839
0131-002,2012,9,11,16,469,504,973,826
0131-002,2012,9,11,17,477,495,972,973
0131-002,2012,9,11,18,478,566,1044,972
0131-002,2012,9,11,19,405,495,900,1044
0131-002,2012,9,11,20,319,408,727,900
0131-002,2012,9,11,21,250,359,609,727
0131-002,2012,9,11,22,203,262,465,609
0131-002,2012,9,11,23,126,174,300,465
0131-002,2012,9,11,24,82,103,185,300
0131-002,2012,9,12,1,74,75,149,185
0131-002,2012,9,12,2,37,51,88,149
0131-002,2012,9,12,3,30,30,60,88
0131-002,2012,9,12,4,34,39,73,60
0131-002,2012,9,12,5,33,45,78,73
0131-002,2012,9,12,6,86,80,166,78
0131-002,2012,9,12,7,326,196,522,166
0131-002,2012,9,12,8,616,466,1082,522
0131-002,2012,9,12,9,540,538,1078,1082
0131-002,2012,9,12,10,409,454,863,1078
0131-002,2012,9,12,11,462,476,938,863
0131-002,2012,9,12,12,498,550,1048,938
0131-002,2012,9,12,13,576,639,1215,1048
0131-002,2012,9,12,14,471,530,1001,1215
0131-002,2012,9,12,15,494,536,1030,1001
0131-002,2012,9,12,16,465,500,965,1030
0131-002,2012,9,12,17,456,521,977,965
0131-002,2012,9,12,18,428,579,1007,977
0131-002,2012,9,12,19,461,545,1006,1007
0131-002,2012,9,12,20,322,416,738,1006
0131-002,2012,9,12,21,231,336,567,738
0131-002,2012,9,12,22,190,269,459,567
0131-002,2012,9,12,23,113,184,297,459
0131-002,2012,9,12,24,88,115,203,297
0131-002,2012,9,13,1,59,75,134,203
0131-002,2012,9,13,2,43,50,93,134
0131-002,2012,9,13,3,32,38,70,93
0131-002,2012,9,13,4,20,35,55,70
0131-002,2012,9,13,5,29,40,69,55
0131-002,2012,9,13,6,80,84,164,69
0131-002,2012,9,13,7,250,153,403,164
0131-002,2012,9,13,8,626,464,1090,403
0131-002,2012,9,13,9,555,542,1097,1090
0131-002,2012,9,13,10,402,461,863,1097
0131-002,2012,9,13,11,429,449,878,863
0131-002,2012,9,13,12,359,406,765,878
0131-002,2012,9,13,13,355,401,756,765
0131-002,2012,9,13,14,394,403,797,756
0131-002,2012,9,13,15,399,433,832,797
0131-002,2012,9,13,16,378,452,830,832
0131-002,2012,9,13,17,349,408,757,830
0131-002,2012,9,13,18,303,475,778,757
0131-002,2012,9,13,19,338,444,782,778
0131-002,2012,9,13,20,275,401,676,782
0131-002,2012,9,13,21,245,352,597,676
0131-002,2012,9,13,22,205,260,465,597
0131-002,2012,9,13,23,133,170,303,465
0131-002,2012,9,13,24,103,104,207,303
0131-002,2012,9,14,1,71,77,148,207
0131-002,2012,9,14,2,46,49,95,148
0131-002,2012,9,14,3,43,39,82,95
0131-002,2012,9,14,4,33,40,73,82
0131-002,2012,9,14,5,33,46,79,73
0131-002,2012,9,14,6,54,65,119,79
0131-002,2012,9,14,7,329,162,491,119
0131-002,2012,9,14,8,583,439,1022,491
0131-002,2012,9,14,9,512,550,1062,1022
0131-002,2012,9,14,10,415,447,862,1062
0131-002,2012,9,14,11,430,446,876,862
0131-002,2012,9,14,12,372,430,802,876
0131-002,2012,9,14,13,353,407,760,802
0131-002,2012,9,14,14,399,456,855,760
0131-002,2012,9,14,15,413,518,931,855
0131-002,2012,9,14,16,416,501,917,931
0131-002,2012,9,14,17,494,553,1047,917
0131-002,2012,9,14,18,434,588,1022,1047
0131-002,2012,9,14,19,463,567,1030,1022
0131-002,2012,9,14,20,380,479,859,1030
0131-002,2012,9,14,21,291,395,686,859
0131-002,2012,9,14,22,261,281,542,686
0131-002,2012,9,14,23,147,199,346,542
0131-002,2012,9,14,24,119,141,260,346
0131-002,2012,9,15,1,74,94,168,260
0131-002,2012,9,15,2,49,58,107,168
0131-002,2012,9,15,3,37,52,89,107
0131-002,2012,9,15,4,35,47,82,89
0131-002,2012,9,15,5,39,57,96,82
0131-002,2012,9,15,6,90,82,172,96
0131-002,2012,9,15,7,204,170,374,172
0131-002,2012,9,15,8,447,363,810,374
0131-002,2012,9,15,9,516,566,1082,810
0131-002,2012,9,15,10,588,674,1262,1082
0131-002,2012,9,15,11,512,772,1284,1262
0131-002,2012,9,15,12,457,816,1273,1284
0131-002,2012,9,15,13,372,746,1118,1273
0131-002,2012,9,15,14,425,792,1217,1118
0131-002,2012,9,15,15,396,685,1081,1217
0131-002,2012,9,15,16,521,743,1264,1081
0131-002,2012,9,15,17,483,634,1117,1264
0131-002,2012,9,15,18,439,594,1033,1117
0131-002,2012,9,15,19,398,561,959,1033
0131-002,2012,9,15,20,305,397,702,959
0131-002,2012,9,15,21,269,282,551,702
0131-002,2012,9,15,22,256,239,495,551
0131-002,2012,9,15,23,138,163,301,495
0131-002,2012,9,15,24,138,131,269,301
0131-002,2012,9,16,1,51,75,126,269
0131-002,2012,9,16,2,45,46,91,126
0131-002,2012,9,16,3,29,36,65,91
0131-002,2012,9,16,4,22,21,43,65
0131-002,2012,9,16,5,37,43,80,43
0131-002,2012,9,16,6,68,59,127,80
0131-002,2012,9,16,7,123,98,221,127
0131-002,2012,9,16,8,236,189,425,221
0131-002,2012,9,16,9,194,206,400,425
0131-002,2012,9,16,10,231,246,477,400
0131-002,2012,9,16,11,208,251,459,477
0131-002,2012,9,16,12,224,245,469,459
0131-002,2012,9,16,13,214,263,477,469
0131-002,2012,9,16,14,215,261,476,477
0131-002,2012,9,16,15,353,299,652,476
0131-002,2012,9,16,16,329,293,622,652
0131-002,2012,9,16,17,373,298,671,622
0131-002,2012,9,16,18,402,297,699,671
0131-002,2012,9,16,19,416,265,681,699
0131-002,2012,9,16,20,293,201,494,681
0131-002,2012,9,16,21,328,203,531,494
0131-002,2012,9,16,22,233,149,382,531
0131-002,2012,9,16,23,119,113,232,382
0131-002,2012,9,16,24,81,66,147,232
0131-002,2012,9,17,1,65,53,118,147
0131-002,2012,9,17,2,34,33,67,118
0131-002,2012,9,17,3,15,21,36,67
0131-002,2012,9,17,4,22,30,52,36
0131-002,2012,9,17,5,34,44,78,52
0131-002,2012,9,17,6,62,60,122,78
0131-002,2012,9,17,7,314,165,479,122
0131-002,2012,9,17,8,660,438,1098,479
0131-002,2012,9,17,9,461,463,924,1098
0131-002,2012,9,17,10,358,374,732,924
0131-002,2012,9,17,11,342,353,695,732
0131-002,2012,9,17,12,311,343,654,695
0131-002,2012,9,17,13,246,318,564,654
0131-002,2012,9,17,14,301,310,611,564
0131-002,2012,9,17,15,329,369,698,611
0131-002,2012,9,17,16,331,362,693,698
0131-002,2012,9,17,17,337,344,681,693
0131-002,2012,9,17,18,297,397,694,681
0131-002,2012,9,17,19,347,372,719,694
0131-002,2012,9,17,20,231,336,567,719
0131-002,2012,9,17,21,209,298,507,567
0131-002,2012,9,17,22,167,213,380,507
0131-002,2012,9,17,23,94,129,223,380
0131-002,2012,9,17,24,103,89,192,223
0131-002,2012,9,18,1,63,51,114,192
0131-002,2012,9,18,2,26,38,64,114
0131-002,2012,9,18,3,41,33,74,64
0131-002,2012,9,18,4,30,41,71,74
0131-002,2012,9,18,5,33,47,80,71
0131-002,2012,9,18,6,79,61,140,80
0131-002,2012,9,18,7,233,147,380,140
0131-002,2012,9,18,8,646,458,1104,380
0131-002,2012,9,18,9,593,548,1141,1104
0131-002,2012,9,18,10,410,462,872,1141
0131-002,2012,9,18,11,499,484,983,872
0131-002,2012,9,18,12,415,441,856,983
0131-002,2012,9,18,13,324,392,716,856
0131-002,2012,9,18,14,369,423,792,716
0131-002,2012,9,18,15,397,476,873,792
0131-002,2012,9,18,16,383,458,841,873
0131-002,2012,9,18,17,396,487,883,841
0131-002,2012,9,18,18,437,543,980,883
0131-002,2012,9,18,19,359,498,857,980
0131-002,2012,9,18,20,288,430,718,857
0131-002,2012,9,18,21,252,359,611,718
0131-002,2012,9,18,22,207,295,502,611
0131-002,2012,9,18,23,147,184,331,502
0131-002,2012,9,18,24,92,120,212,331
0131-002,2012,9,19,1,85,90,175,212
0131-002,2012,9,19,2,48,52,100,175
0131-002,2012,9,19,3,47,46,93,100
0131-002,2012,9,19,4,40,41,81,93
0131-002,2012,9,19,5,38,48,86,81
0131-002,2012,9,19,6,66,72,138,86
0131-002,2012,9,19,7,277,182,459,138
0131-002,2012,9,19,8,755,459,1214,459
0131-002,2012,9,19,9,605,553,1158,1214
0131-002,2012,9,19,10,455,477,932,1158
0131-002,2012,9,19,11,394,454,848,932
0131-002,2012,9,19,12,431,456,887,848
0131-002,2012,9,19,13,315,391,706,887
0131-002,2012,9,19,14,393,442,835,706
0131-002,2012,9,19,15,419,502,921,835
0131-002,2012,9,19,16,387,490,877,921
0131-002,2012,9,19,17,470,470,940,877
0131-002,2012,9,19,18,596,560,1156,940
0131-002,2012,9,19,19,541,527,1068,1156
0131-002,2012,9,19,20,377,441,818,1068
0131-002,2012,9,19,21,296,338,634,818
0131-002,2012,9,19,22,241,257,498,634
0131-002,2012,9,19,23,167,191,358,498
0131-002,2012,9,19,24,94,123,217,358
0131-002,2012,9,20,1,84,74,158,217
0131-002,2012,9,20,2,40,46,86,158
0131-002,2012,9,20,3,49,41,90,86
0131-002,2012,9,20,4,35,46,81,90
0131-002,2012,9,20,5,47,56,103,81
0131-002,2012,9,20,6,85,79,164,103
0131-002,2012,9,20,7,302,169,471,164
0131-002,2012,9,20,8,722,470,1192,471
0131-002,2012,9,20,9,618,564,1182,1192
0131-002,2012,9,20,10,491,488,979,1182
0131-002,2012,9,20,11,468,462,930,979
0131-002,2012,9,20,12,399,441,840,930
0131-002,2012,9,20,13,316,370,686,840
0131-002,2012,9,20,14,407,430,837,686
0131-002,2012,9,20,15,422,494,916,837
0131-002,2012,9,20,16,447,482,929,916
0131-002,2012,9,20,17,424,498,922,929
0131-002,2012,9,20,18,426,521,947,922
0131-002,2012,9,20,19,391,495,886,947
0131-002,2012,9,20,20,324,457,781,886
0131-002,2012,9,20,21,246,381,627,781
0131-002,2012,9,20,22,214,279,493,627
0131-002,2012,9,20,23,164,213,377,493
0131-002,2012,9,20,24,121,112,233,377
0131-002,2012,9,21,1,66,70,136,233
0131-002,2012,9,21,2,42,46,88,136
0131-002,2012,9,21,3,43,41,84,88
0131-002,2012,9,21,4,52,51,103,84
0131-002,2012,9,21,5,35,51,86,103
0131-002,2012,9,21,6,84,75,159,86
0131-002,2012,9,21,7,329,174,503,159
0131-002,2012,9,21,8,718,489,1207,503
0131-002,2012,9,21,9,561,532,1093,1207
0131-002,2012,9,21,10,436,451,887,1093
0131-002,2012,9,21,11,458,497,955,887
0131-002,2012,9,21,12,429,478,907,955
0131-002,2012,9,21,13,324,392,716,907
0131-002,2012,9,21,14,407,429,836,716
0131-002,2012,9,21,15,453,482,935,836
0131-002,2012,9,21,16,363,435,798,935
0131-002,2012,9,21,17,386,420,806,798
0131-002,2012,9,21,18,464,577,1041,806
0131-002,2012,9,21,19,475,580,1055,1041
0131-002,2012,9,21,20,411,481,892,1055
0131-002,2012,9,21,21,296,397,693,892
0131-002,2012,9,21,22,268,306,574,693
0131-002,2012,9,21,23,196,209,405,574
0131-002,2012,9,21,24,116,136,252,405
0131-002,2012,9,22,1,79,104,183,252
0131-002,2012,9,22,2,51,75,126,183
0131-002,2012,9,22,3,27,45,72,126
0131-002,2012,9,22,4,37,49,86,72
0131-002,2012,9,22,5,37,59,96,86
0131-002,2012,9,22,6,88,80,168,96
0131-002,2012,9,22,7,231,161,392,168
0131-002,2012,9,22,8,471,314,785,392
0131-002,2012,9,22,9,438,443,881,785
0131-002,2012,9,22,10,504,517,1021,881
0131-002,2012,9,22,11,499,642,1141,1021
0131-002,2012,9,22,12,392,555,947,1141
0131-002,2012,9,22,13,335,526,861,947
0131-002,2012,9,22,14,307,442,749,861
0131-002,2012,9,22,15,285,413,698,749
0131-002,2012,9,22,16,248,343,591,698
0131-002,2012,9,22,17,299,392,691,591
0131-002,2012,9,22,18,362,490,852,691
0131-002,2012,9,22,19,330,409,739,852
0131-002,2012,9,22,20,252,311,563,739
0131-002,2012,9,22,21,235,245,480,563
0131-002,2012,9,22,22,251,235,486,480
0131-002,2012,9,22,23,93,150,243,486
0131-002,2012,9,22,24,83,115,198,243
0131-002,2012,9,23,1,124,143,267,198
0131-002,2012,9,23,2,58,69,127,267
0131-002,2012,9,23,3,55,64,119,127
0131-002,2012,9,23,4,40,52,92,119
0131-002,2012,9,23,5,52,52,104,92
0131-002,2012,9,23,6,69,68,137,104
0131-002,2012,9,23,7,194,151,345,137
0131-002,2012,9,23,8,414,266,680,345
0131-002,2012,9,23,9,370,359,729,680
0131-002,2012,9,23,10,402,386,788,729
0131-002,2012,9,23,11,426,426,852,788
0131-002,2012,9,23,12,249,302,551,852
0131-002,2012,9,23,13,192,241,433,551
0131-002,2012,9,23,14,182,193,375,433
0131-002,2012,9,23,15,216,211,427,375
0131-002,2012,9,23,16,278,245,523,427
0131-002,2012,9,23,17,268,239,507,523
0131-002,2012,9,23,18,312,292,604,507
0131-002,2012,9,23,19,267,254,521,604
0131-002,2012,9,23,20,157,178,335,521
0131-002,2012,9,23,21,160,151,311,335
0131-002,2012,9,23,22,143,113,256,311
0131-002,2012,9,23,23,70,69,139,256
0131-002,2012,9,23,24,60,47,107,139
0131-002,2012,9,24,1,27,27,54,107
0131-002,2012,9,24,2,10,12,22,54
0131-002,2012,9,24,3,13,12,25,22
0131-002,2012,9,24,4,14,14,28,25
0131-002,2012,9,24,5,19,23,42,28
0131-002,2012,9,24,6,25,27,52,42
0131-002,2012,9,24,7,233,140,373,52
0131-002,2012,9,24,8,518,402,920,373
0131-002,2012,9,24,9,467,417,884,920
0131-002,2012,9,24,10,287,320,607,884
0131-002,2012,9,24,11,293,289,582,607
0131-002,2012,9,24,12,329,333,662,582
0131-002,2012,9,24,13,263,270,533,662
0131-002,2012,9,24,14,323,339,662,533
0131-002,2012,9,24,15,299,377,676,662
0131-002,2012,9,24,16,332,357,689,676
0131-002,2012,9,24,17,314,384,698,689
0131-002,2012,9,24,18,361,447,808,698
0131-002,2012,9,24,19,298,375,673,808
0131-002,2012,9,24,20,252,351,603,673
0131-002,2012,9,24,21,162,268,430,603
0131-002,2012,9,24,22,145,181,326,430
0131-002,2012,9,24,23,71,90,161,326
0131-002,2012,9,24,24,47,54,101,161
0131-002,2012,9,25,1,26,36,62,101
0131-002,2012,9,25,2,16,23,39,62
0131-002,2012,9,25,3,9,9,18,39
0131-002,2012,9,25,4,8,11,19,18
0131-002,2012,9,25,5,22,24,46,19
0131-002,2012,9,25,6,36,37,73,46
0131-002,2012,9,25,7,167,93,260,73
0131-002,2012,9,25,8,509,340,849,260
0131-002,2012,9,25,9,435,435,870,849
0131-002,2012,9,25,10,339,350,689,870
0131-002,2012,9,25,11,342,323,665,689
0131-002,2012,9,25,12,314,353,667,665
0131-002,2012,9,25,13,240,282,522,667
0131-002,2012,9,25,14,330,351,681,522
0131-002,2012,9,25,15,313,374,687,681
0131-002,2012,9,25,16,327,351,678,687
0131-002,2012,9,25,17,313,348,661,678
0131-002,2012,9,25,18,382,475,857,661
0131-002,2012,9,25,19,325,437,762,857
0131-002,2012,9,25,20,229,311,540,762
0131-002,2012,9,25,21,187,270,457,540
0131-002,2012,9,25,22,174,192,366,457
0131-002,2012,9,25,23,74,106,180,366
0131-002,2012,9,25,24,69,66,135,180
0131-002,2012,9,26,1,41,36,77,135
0131-002,2012,9,26,2,21,29,50,77
0131-002,2012,9,26,3,10,11,21,50
0131-002,2012,9,26,4,15,16,31,21
0131-002,2012,9,26,5,12,19,31,31
0131-002,2012,9,26,6,40,32,72,31
0131-002,2012,9,26,7,205,105,310,72
0131-002,2012,9,26,8,478,355,833,310
0131-002,2012,9,26,9,463,442,905,833
0131-002,2012,9,26,10,352,381,733,905
0131-002,2012,9,26,11,278,315,593,733
0131-002,2012,9,26,12,345,365,710,593
0131-002,2012,9,26,13,256,269,525,710
0131-002,2012,9,26,14,334,352,686,525
0131-002,2012,9,26,15,336,378,714,686
0131-002,2012,9,26,16,382,414,796,714
0131-002,2012,9,26,17,370,364,734,796
0131-002,2012,9,26,18,365,471,836,734
0131-002,2012,9,26,19,331,438,769,836
0131-002,2012,9,26,20,284,350,634,769
0131-002,2012,9,26,21,182,253,435,634
0131-002,2012,9,26,22,156,197,353,435
0131-002,2012,9,26,23,89,112,201,353
0131-002,2012,9,26,24,69,69,138,201
0131-002,2012,9,27,1,51,49,100,138
0131-002,2012,9,27,2,32,36,68,100
0131-002,2012,9,27,3,14,20,34,68
0131-002,2012,9,27,4,16,18,34,34
0131-002,2012,9,27,5,14,19,33,34
0131-002,2012,9,27,6,39,36,75,33
0131-002,2012,9,27,7,174,86,260,75
0131-002,2012,9,27,8,541,374,915,260
0131-002,2012,9,27,9,512,487,999,915
0131-002,2012,9,27,10,367,383,750,999
0131-002,2012,9,27,11,325,352,677,750
0131-002,2012,9,27,12,387,398,785,677
0131-002,2012,9,27,13,253,294,547,785
0131-002,2012,9,27,14,321,359,680,547
0131-002,2012,9,27,15,387,422,809,680
0131-002,2012,9,27,16,405,398,803,809
0131-002,2012,9,27,17,374,406,780,803
0131-002,2012,9,27,18,391,481,872,780
0131-002,2012,9,27,19,384,431,815,872
0131-002,2012,9,27,20,292,392,684,815
0131-002,2012,9,27,21,212,307,519,684
0131-002,2012,9,27,22,161,200,361,519
0131-002,2012,9,27,23,109,125,234,361
0131-002,2012,9,27,24,84,86,170,234
0131-002,2012,9,28,1,30,38,68,170
0131-002,2012,9,28,2,22,20,42,68
0131-002,2012,9,28,3,16,15,31,42
0131-002,2012,9,28,4,10,15,25,31
0131-002,2012,9,28,5,5,6,11,25
0131-002,2012,9,28,6,30,30,60,11
0131-002,2012,9,28,7,152,81,233,60
0131-002,2012,9,28,8,473,331,804,233
0131-002,2012,9,28,9,411,403,814,804
0131-002,2012,9,28,10,327,327,654,814
0131-002,2012,9,28,11,349,353,702,654
0131-002,2012,9,28,12,382,410,792,702
0131-002,2012,9,28,13,358,414,772,792
0131-002,2012,9,28,14,471,500,971,772
0131-002,2012,9,28,15,596,650,1246,971
0131-002,2012,9,28,16,626,744,1370,1246
0131-002,2012,9,28,17,625,785,1410,1370
0131-002,2012,9,28,18,772,876,1648,1410
0131-002,2012,9,28,19,671,755,1426,1648
0131-002,2012,9,28,20,532,647,1179,1426
0131-002,2012,9,28,21,420,594,1014,1179
0131-002,2012,9,28,22,400,514,914,1014
0131-002,2012,9,28,23,445,538,983,914
0131-002,2012,9,28,24,462,524,986,983
0131-002,2012,9,29,1,497,556,1053,986
0131-002,2012,9,29,2,294,399,693,1053
0131-002,2012,9,29,3,357,442,799,693
0131-002,2012,9,29,4,349,603,952,799
0131-002,2012,9,29,5,434,646,1080,952
0131-002,2012,9,29,6,541,492,1033,1080
0131-002,2012,9,29,7,609,529,1138,1033
0131-002,2012,9,29,8,758,528,1286,1138
0131-002,2012,9,29,9,563,506,1069,1286
0131-002,2012,9,29,10,461,522,983,1069
0131-002,2012,9,29,11,482,621,1103,983
0131-002,2012,9,29,12,456,599,1055,1103
0131-002,2012,9,29,13,450,617,1067,1055
0131-002,2012,9,29,14,602,774,1376,1067
0131-002,2012,9,29,15,469,597,1066,1376
0131-002,2012,9,29,16,408,570,978,1066
0131-002,2012,9,29,17,548,713,1261,978
0131-002,2012,9,29,18,464,678,1142,1261
0131-002,2012,9,29,19,314,421,735,1142
0131-002,2012,9,29,20,209,247,456,735
0131-002,2012,9,29,21,195,201,396,456
0131-002,2012,9,29,22,110,117,227,396
0131-002,2012,9,29,23,50,51,101,227
0131-002,2012,9,29,24,27,31,58,101
0131-002,2012,9,30,1,13,15,28,58
0131-002,2012,9,30,2,14,15,29,28
0131-002,2012,9,30,3,16,14,30,29
0131-002,2012,9,30,4,2,2,4,30
0131-002,2012,9,30,5,2,2,4,4
0131-002,2012,9,30,6,16,14,30,4
0131-002,2012,9,30,7,83,57,140,30
0131-002,2012,9,30,8,274,197,471,140
0131-002,2012,9,30,9,164,179,343,471
0131-002,2012,9,30,10,237,262,499,343
0131-002,2012,9,30,11,320,389,709,499
0131-002,2012,9,30,12,515,544,1059,709
0131-002,2012,9,30,13,519,554,1073,1059
0131-002,2012,9,30,14,643,589,1232,1073
0131-002,2012,9,30,15,707,724,1431,1232
0131-002,2012,9,30,16,813,749,1562,1431
0131-002,2012,9,30,17,801,767,1568,1562
0131-002,2012,9,30,18,871,737,1608,1568
0131-002,2012,9,30,19,732,596,1328,1608
0131-002,2012,9,30,20,580,541,1121,1328
0131-002,2012,9,30,21,405,331,736,1121
0131-002,2012,9,30,22,263,220,483,736
0131-002,2012,9,30,23,119,109,228,483
0131-002,2012,9,30,24,28,34,62,228
0131-002,2012,10,1,1,56,43,99,62
0131-002,2012,10,1,2,51,32,83,99
0131-002,2012,10,1,3,11,24,35,83
0131-002,2012,10,1,4,10,12,22,35
0131-002,2012,10,1,5,13,10,23,22
0131-002,2012,10,1,6,13,15,28,23
0131-002,2012,10,1,7,31,18,49,28
0131-002,2012,10,1,8,65,50,115,49
0131-002,2012,10,1,9,66,88,154,115
0131-002,2012,10,1,10,130,151,281,154
0131-002,2012,10,1,11,279,252,531,281
0131-002,2012,10,1,12,298,304,602,531
0131-002,2012,10,1,13,339,346,685,602
0131-002,2012,10,1,14,359,449,808,685
0131-002,2012,10,1,15,334,423,757,808
0131-002,2012,10,1,16,388,403,791,757
0131-002,2012,10,1,17,508,338,846,791
0131-002,2012,10,1,18,534,324,858,846
0131-002,2012,10,1,19,476,324,800,858
0131-002,2012,10,1,20,561,237,798,800
0131-002,2012,10,1,21,439,182,621,798
0131-002,2012,10,1,22,585,123,708,621
0131-002,2012,10,1,23,650,121,771,708
0131-002,2012,10,1,24,451,77,528,771
0131-002,2012,10,2,1,353,40,393,528
0131-002,2012,10,2,2,176,17,193,393
0131-002,2012,10,2,3,31,27,58,193
0131-002,2012,10,2,4,15,9,24,58
0131-002,2012,10,2,5,12,17,29,24
0131-002,2012,10,2,6,23,21,44,29
0131-002,2012,10,2,7,77,68,145,44
0131-002,2012,10,2,8,277,224,501,145
0131-002,2012,10,2,9,242,272,514,501
0131-002,2012,10,2,10,194,269,463,514
0131-002,2012,10,2,11,243,292,535,463
0131-002,2012,10,2,12,317,304,621,535
0131-002,2012,10,2,13,293,319,612,621
0131-002,2012,10,2,14,346,330,676,612
0131-002,2012,10,2,15,466,346,812,676
0131-002,2012,10,2,16,509,333,842,812
0131-002,2012,10,2,17,631,350,981,842
0131-002,2012,10,2,18,589,429,1018,981
0131-002,2012,10,2,19,685,380,1065,1018
0131-002,2012,10,2,20,505,255,760,1065
0131-002,2012,10,2,21,368,206,574,760
0131-002,2012,10,2,22,321,173,494,574
0131-002,2012,10,2,23,223,123,346,494
0131-002,2012,10,2,24,95,68,163,346
0131-002,2012,10,3,1,49,60,109,163
0131-002,2012,10,3,2,22,29,51,109
0131-002,2012,10,3,3,20,28,48,51
0131-002,2012,10,3,4,3,9,12,48
0131-002,2012,10,3,5,9,22,31,12
0131-002,2012,10,3,6,11,27,38,31
0131-002,2012,10,3,7,123,75,198,38
0131-002,2012,10,3,8,343,173,516,198
0131-002,2012,10,3,9,202,196,398,516
0131-002,2012,10,3,10,252,272,524,398
0131-002,2012,10,3,11,277,265,542,524
0131-002,2012,10,3,12,290,330,620,542
0131-002,2012,10,3,13,318,299,617,620
0131-002,2012,10,3,14,317,313,630,617
0131-002,2012,10,3,15,334,348,682,630
0131-002,2012,10,3,16,361,369,730,682
0131-002,2012,10,3,17,391,417,808,730
0131-002,2012,10,3,18,489,436,925,808
0131-002,2012,10,3,19,374,408,782,925
0131-002,2012,10,3,20,278,282,560,782
0131-002,2012,10,3,21,201,216,417,560
0131-002,2012,10,3,22,170,145,315,417
0131-002,2012,10,3,23,90,98,188,315
0131-002,2012,10,3,24,80,39,119,188
0131-002,2012,10,4,1,24,23,47,119
0131-002,2012,10,4,2,13,23,36,47
0131-002,2012,10,4,3,13,15,28,36
0131-002,2012,10,4,4,2,10,12,28
0131-002,2012,10,4,5,11,19,30,12
0131-002,2012,10,4,6,45,41,86,30
0131-002,2012,10,4,7,358,118,476,86
0131-002,2012,10,4,8,995,577,1572,476
0131-002,2012,10,4,9,653,543,1196,1572
0131-002,2012,10,4,10,390,447,837,1196
0131-002,2012,10,4,11,403,402,805,837
0131-002,2012,10,4,12,318,419,737,805
0131-002,2012,10,4,13,265,348,613,737
0131-002,2012,10,4,14,355,408,763,613
0131-002,2012,10,4,15,434,418,852,763
0131-002,2012,10,4,16,421,469,890,852
0131-002,2012,10,4,17,393,460,853,890
0131-002,2012,10,4,18,438,547,985,853
0131-002,2012,10,4,19,367,559,926,985
0131-002,2012,10,4,20,253,406,659,926
0131-002,2012,10,4,21,217,304,521,659
0131-002,2012,10,4,22,172,220,392,521
0131-002,2012,10,4,23,105,144,249,392
0131-002,2012,10,4,24,74,60,134,249
0131-002,2012,10,5,1,20,54,74,134
0131-002,2012,10,5,2,17,26,43,74
0131-002,2012,10,5,3,3,24,27,43
0131-002,2012,10,5,4,11,13,24,27
0131-002,2012,10,5,5,10,20,30,24
0131-002,2012,10,5,6,29,41,70,30
0131-002,2012,10,5,7,241,133,374,70
0131-002,2012,10,5,8,898,500,1398,374
0131-002,2012,10,5,9,660,607,1267,1398
0131-002,2012,10,5,10,407,465,872,1267
0131-002,2012,10,5,11,391,487,878,872
0131-002,2012,10,5,12,431,483,914,878
0131-002,2012,10,5,13,305,350,655,914
0131-002,2012,10,5,14,401,465,866,655
0131-002,2012,10,5,15,450,459,909,866
0131-002,2012,10,5,16,452,497,949,909
0131-002,2012,10,5,17,421,472,893,949
0131-002,2012,10,5,18,492,602,1094,893
0131-002,2012,10,5,19,472,547,1019,1094
0131-002,2012,10,5,20,317,419,736,1019
0131-002,2012,10,5,21,223,377,600,736
0131-002,2012,10,5,22,157,280,437,600
0131-002,2012,10,5,23,127,121,248,437
0131-002,2012,10,5,24,75,80,155,248
0131-002,2012,10,6,1,33,48,81,155
0131-002,2012,10,6,2,34,41,75,81
0131-002,2012,10,6,3,9,30,39,75
0131-002,2012,10,6,4,4,28,32,39
0131-002,2012,10,6,5,11,34,45,32
0131-002,2012,10,6,6,37,43,80,45
0131-002,2012,10,6,7,140,111,251,80
0131-002,2012,10,6,8,585,311,896,251
0131-002,2012,10,6,9,436,470,906,896
0131-002,2012,10,6,10,404,457,861,906
0131-002,2012,10,6,11,401,577,978,861
0131-002,2012,10,6,12,374,704,1078,978
0131-002,2012,10,6,13,406,573,979,1078
0131-002,2012,10,6,14,438,489,927,979
0131-002,2012,10,6,15,451,462,913,927
0131-002,2012,10,6,16,377,457,834,913
0131-002,2012,10,6,17,453,469,922,834
0131-002,2012,10,6,18,513,604,1117,922
0131-002,2012,10,6,19,438,504,942,1117
0131-002,2012,10,6,20,252,272,524,942
0131-002,2012,10,6,21,186,178,364,524
0131-002,2012,10,6,22,151,167,318,364
0131-002,2012,10,6,23,95,104,199,318
0131-002,2012,10,6,24,38,57,95,199
0131-002,2012,10,7,1,31,71,102,95
0131-002,2012,10,7,2,28,51,79,102
0131-002,2012,10,7,3,16,26,42,79
0131-002,2012,10,7,4,2,27,29,42
0131-002,2012,10,7,5,16,16,32,29
0131-002,2012,10,7,6,20,28,48,32
0131-002,2012,10,7,7,52,77,129,48
0131-002,2012,10,7,8,213,168,381,129
0131-002,2012,10,7,9,196,232,428,381
0131-002,2012,10,7,10,179,250,429,428
0131-002,2012,10,7,11,234,308,542,429
0131-002,2012,10,7,12,327,231,558,542
0131-002,2012,10,7,13,251,280,531,558
0131-002,2012,10,7,14,283,331,614,531
0131-002,2012,10,7,15,357,339,696,614
0131-002,2012,10,7,16,395,405,800,696
0131-002,2012,10,7,17,425,416,841,800
0131-002,2012,10,7,18,445,453,898,841
0131-002,2012,10,7,19,420,437,857,898
0131-002,2012,10,7,20,250,263,513,857
0131-002,2012,10,7,21,222,189,411,513
0131-002,2012,10,7,22,183,106,289,411
0131-002,2012,10,7,23,96,99,195,289
0131-002,2012,10,7,24,55,47,102,195
0131-002,2012,10,8,1,24,29,53,102
0131-002,2012,10,8,2,17,26,43,53
0131-002,2012,10,8,3,5,14,19,43
0131-002,2012,10,8,4,10,4,14,19
0131-002,2012,10,8,5,13,24,37,14
0131-002,2012,10,8,6,39,34,73,37
0131-002,2012,10,8,7,344,155,499,73
0131-002,2012,10,8,8,1006,541,1547,499
0131-002,2012,10,8,9,695,604,1299,1547
0131-002,2012,10,8,10,414,423,837,1299
0131-002,2012,10,8,11,452,467,919,837
0131-002,2012,10,8,12,366,427,793,919
0131-002,2012,10,8,13,306,337,643,793
0131-002,2012,10,8,14,387,383,770,643
0131-002,2012,10,8,15,491,479,970,770
0131-002,2012,10,8,16,428,468,896,970
0131-002,2012,10,8,17,391,544,935,896
0131-002,2012,10,8,18,454,574,1028,935
0131-002,2012,10,8,19,425,553,978,1028
0131-002,2012,10,8,20,279,439,718,978
0131-002,2012,10,8,21,212,332,544,718
0131-002,2012,10,8,22,152,249,401,544
0131-002,2012,10,8,23,103,127,230,401
0131-002,2012,10,8,24,51,76,127,230
0131-002,2012,10,9,1,29,34,63,127
0131-002,2012,10,9,2,10,32,42,63
0131-002,2012,10,9,3,2,15,17,42
0131-002,2012,10,9,4,10,16,26,17
0131-002,2012,10,9,5,4,25,29,26
0131-002,2012,10,9,6,37,48,85,29
0131-002,2012,10,9,7,253,130,383,85
0131-002,2012,10,9,8,883,488,1371,383
0131-002,2012,10,9,9,703,581,1284,1371
0131-002,2012,10,9,10,464,493,957,1284
0131-002,2012,10,9,11,413,507,920,957
0131-002,2012,10,9,12,394,432,826,920
0131-002,2012,10,9,13,359,364,723,826
0131-002,2012,10,9,14,377,372,749,723
0131-002,2012,10,9,15,455,520,975,749
0131-002,2012,10,9,16,438,508,946,975
0131-002,2012,10,9,17,398,527,925,946
0131-002,2012,10,9,18,466,602,1068,925
0131-002,2012,10,9,19,400,563,963,1068
0131-002,2012,10,9,20,253,436,689,963
0131-002,2012,10,9,21,210,354,564,689
0131-002,2012,10,9,22,157,224,381,564
0131-002,2012,10,9,23,116,148,264,381
0131-002,2012,10,9,24,56,70,126,264
0131-002,2012,10,10,1,29,45,74,126
0131-002,2012,10,10,2,19,25,44,74
0131-002,2012,10,10,3,4,16,20,44
0131-002,2012,10,10,4,11,13,24,20
0131-002,2012,10,10,5,10,17,27,24
0131-002,2012,10,10,6,38,43,81,27
0131-002,2012,10,10,7,230,110,340,81
0131-002,2012,10,10,8,860,479,1339,340
0131-002,2012,10,10,9,710,629,1339,1339
0131-002,2012,10,10,10,439,441,880,1339
0131-002,2012,10,10,11,440,477,917,880
0131-002,2012,10,10,12,380,465,845,917
0131-002,2012,10,10,13,341,379,720,845
0131-002,2012,10,10,14,367,375,742,720
0131-002,2012,10,10,15,396,463,859,742
0131-002,2012,10,10,16,435,496,931,859
0131-002,2012,10,10,17,370,535,905,931
0131-002,2012,10,10,18,453,643,1096,905
0131-002,2012,10,10,19,438,596,1034,1096
0131-002,2012,10,10,20,296,405,701,1034
0131-002,2012,10,10,21,180,321,501,701
0131-002,2012,10,10,22,191,221,412,501
0131-002,2012,10,10,23,109,138,247,412
0131-002,2012,10,10,24,53,92,145,247
0131-002,2012,10,11,1,32,35,67,145
0131-002,2012,10,11,2,22,32,54,67
0131-002,2012,10,11,3,4,30,34,54
0131-002,2012,10,11,4,2,17,19,34
0131-002,2012,10,11,5,15,30,45,19
0131-002,2012,10,11,6,45,33,78,45
0131-002,2012,10,11,7,241,113,354,78
0131-002,2012,10,11,8,945,488,1433,354
0131-002,2012,10,11,9,725,615,1340,1433
0131-002,2012,10,11,10,459,416,875,1340
0131-002,2012,10,11,11,456,455,911,875
0131-002,2012,10,11,12,387,473,860,911
0131-002,2012,10,11,13,335,384,719,860
0131-002,2012,10,11,14,371,418,789,719
0131-002,2012,10,11,15,446,489,935,789
0131-002,2012,10,11,16,419,529,948,935
0131-002,2012,10,11,17,368,577,945,948
0131-002,2012,10,11,18,390,597,987,945
0131-002,2012,10,11,19,422,611,1033,987
0131-002,2012,10,11,20,281,460,741,1033
0131-002,2012,10,11,21,232,335,567,741
0131-002,2012,10,11,22,198,245,443,567
0131-002,2012,10,11,23,106,155,261,443
0131-002,2012,10,11,24,67,88,155,261
0131-002,2012,10,12,1,34,50,84,155
0131-002,2012,10,12,2,14,19,33,84
0131-002,2012,10,12,3,12,14,26,33
0131-002,2012,10,12,4,8,19,27,26
0131-002,2012,10,12,5,4,21,25,27
0131-002,2012,10,12,6,41,35,76,25
0131-002,2012,10,12,7,255,136,391,76
0131-002,2012,10,12,8,896,471,1367,391
0131-002,2012,10,12,9,707,626,1333,1367
0131-002,2012,10,12,10,441,464,905,1333
0131-002,2012,10,12,11,431,410,841,905
0131-002,2012,10,12,12,418,447,865,841
0131-002,2012,10,12,13,300,375,675,865
0131-002,2012,10,12,14,399,427,826,675
0131-002,2012,10,12,15,401,526,927,826
0131-002,2012,10,12,16,438,497,935,927
0131-002,2012,10,12,17,454,573,1027,935
0131-002,2012,10,12,18,619,639,1258,1027
0131-002,2012,10,12,19,607,671,1278,1258
0131-002,2012,10,12,20,363,475,838,1278
0131-002,2012,10,12,21,255,395,650,838
0131-002,2012,10,12,22,183,286,469,650
0131-002,2012,10,12,23,125,173,298,469
0131-002,2012,10,12,24,79,75,154,298
0131-002,2012,10,13,1,48,46,94,154
0131-002,2012,10,13,2,18,36,54,94
0131-002,2012,10,13,3,23,22,45,54
0131-002,2012,10,13,4,7,22,29,45
0131-002,2012,10,13,5,14,22,36,29
0131-002,2012,10,13,6,52,46,98,36
0131-002,2012,10,13,7,146,95,241,98
0131-002,2012,10,13,8,453,245,698,241
0131-002,2012,10,13,9,475,430,905,698
0131-002,2012,10,13,10,396,510,906,905
0131-002,2012,10,13,11,389,619,1008,906
0131-002,2012,10,13,12,367,741,1108,1008
0131-002,2012,10,13,13,502,775,1277,1108
0131-002,2012,10,13,14,417,765,1182,1277
0131-002,2012,10,13,15,467,680,1147,1182
0131-002,2012,10,13,16,393,621,1014,1147
0131-002,2012,10,13,17,480,578,1058,1014
0131-002,2012,10,13,18,520,632,1152,1058
0131-002,2012,10,13,19,469,526,995,1152
0131-002,2012,10,13,20,338,290,628,995
0131-002,2012,10,13,21,224,176,400,628
0131-002,2012,10,13,22,168,148,316,400
0131-002,2012,10,13,23,75,99,174,316
0131-002,2012,10,13,24,48,55,103,174
0131-002,2012,10,14,1,35,53,88,103
0131-002,2012,10,14,2,24,39,63,88
0131-002,2012,10,14,3,21,21,42,63
0131-002,2012,10,14,4,2,17,19,42
0131-002,2012,10,14,5,11,14,25,19
0131-002,2012,10,14,6,24,24,48,25
0131-002,2012,10,14,7,84,72,156,48
0131-002,2012,10,14,8,183,149,332,156
0131-002,2012,10,14,9,174,242,416,332
0131-002,2012,10,14,10,230,284,514,416
0131-002,2012,10,14,11,270,309,579,514
0131-002,2012,10,14,12,248,283,531,579
0131-002,2012,10,14,13,287,259,546,531
0131-002,2012,10,14,14,298,272,570,546
0131-002,2012,10,14,15,330,381,711,570
0131-002,2012,10,14,16,416,393,809,711
0131-002,2012,10,14,17,470,437,907,809
0131-002,2012,10,14,18,465,513,978,907
0131-002,2012,10,14,19,446,381,827,978
0131-002,2012,10,14,20,342,262,604,827
0131-002,2012,10,14,21,298,262,560,604
0131-002,2012,10,14,22,335,160,495,560
0131-002,2012,10,14,23,134,112,246,495
0131-002,2012,10,14,24,73,71,144,246
0131-002,2012,10,15,1,28,27,55,144
0131-002,2012,10,15,2,13,24,37,55
0131-002,2012,10,15,3,2,14,16,37
0131-002,2012,10,15,4,10,14,24,16
0131-002,2012,10,15,5,4,11,15,24
0131-002,2012,10,15,6,55,34,89,15
0131-002,2012,10,15,7,329,162,491,89
0131-002,2012,10,15,8,1045,490,1535,491
0131-002,2012,10,15,9,790,635,1425,1535
0131-002,2012,10,15,10,401,468,869,1425
0131-002,2012,10,15,11,411,474,885,869
0131-002,2012,10,15,12,410,419,829,885
0131-002,2012,10,15,13,322,384,706,829
0131-002,2012,10,15,14,373,449,822,706
0131-002,2012,10,15,15,428,469,897,822
0131-002,2012,10,15,16,383,488,871,897
0131-002,2012,10,15,17,427,484,911,871
0131-002,2012,10,15,18,453,657,1110,911
0131-002,2012,10,15,19,364,606,970,1110
0131-002,2012,10,15,20,308,395,703,970
0131-002,2012,10,15,21,229,376,605,703
0131-002,2012,10,15,22,154,288,442,605
0131-002,2012,10,15,23,95,152,247,442
0131-002,2012,10,15,24,46,49,95,247
0131-002,2012,10,16,1,29,36,65,95
0131-002,2012,10,16,2,14,33,47,65
0131-002,2012,10,16,3,3,13,16,47
0131-002,2012,10,16,4,4,15,19,16
0131-002,2012,10,16,5,7,21,28,19
0131-002,2012,10,16,6,55,51,106,28
0131-002,2012,10,16,7,275,107,382,106
0131-002,2012,10,16,8,918,501,1419,382
0131-002,2012,10,16,9,738,579,1317,1419
0131-002,2012,10,16,10,411,506,917,1317
0131-002,2012,10,16,11,425,417,842,917
0131-002,2012,10,16,12,388,385,773,842
0131-002,2012,10,16,13,309,340,649,773
0131-002,2012,10,16,14,376,435,811,649
0131-002,2012,10,16,15,422,500,922,811
0131-002,2012,10,16,16,417,485,902,922
0131-002,2012,10,16,17,444,550,994,902
0131-002,2012,10,16,18,431,606,1037,994
0131-002,2012,10,16,19,364,593,957,1037
0131-002,2012,10,16,20,313,410,723,957
0131-002,2012,10,16,21,223,355,578,723
0131-002,2012,10,16,22,177,236,413,578
0131-002,2012,10,16,23,123,175,298,413
0131-002,2012,10,16,24,51,85,136,298
0131-002,2012,10,17,1,30,31,61,136
0131-002,2012,10,17,2,14,16,30,61
0131-002,2012,10,17,3,4,20,24,30
0131-002,2012,10,17,4,13,16,29,24
0131-002,2012,10,17,5,13,16,29,29
0131-002,2012,10,17,6,38,40,78,29
0131-002,2012,10,17,7,248,103,351,78
0131-002,2012,10,17,8,826,475,1301,351
0131-002,2012,10,17,9,720,634,1354,1301
0131-002,2012,10,17,10,417,460,877,1354
0131-002,2012,10,17,11,406,438,844,877
0131-002,2012,10,17,12,401,387,788,844
0131-002,2012,10,17,13,314,370,684,788
0131-002,2012,10,17,14,387,381,768,684
0131-002,2012,10,17,15,371,488,859,768
0131-002,2012,10,17,16,359,498,857,859
0131-002,2012,10,17,17,373,484,857,857
0131-002,2012,10,17,18,455,689,1144,857
0131-002,2012,10,17,19,442,606,1048,1144
0131-002,2012,10,17,20,290,398,688,1048
0131-002,2012,10,17,21,202,367,569,688
0131-002,2012,10,17,22,157,207,364,569
0131-002,2012,10,17,23,130,127,257,364
0131-002,2012,10,17,24,45,76,121,257
0131-002,2012,10,18,1,39,34,73,121
0131-002,2012,10,18,2,14,29,43,73
0131-002,2012,10,18,3,12,17,29,43
0131-002,2012,10,18,4,14,14,28,29
0131-002,2012,10,18,5,10,21,31,28
0131-002,2012,10,18,6,25,30,55,31
0131-002,2012,10,18,7,275,116,391,55
0131-002,2012,10,18,8,943,490,1433,391
0131-002,2012,10,18,9,763,624,1387,1433
0131-002,2012,10,18,10,439,445,884,1387
0131-002,2012,10,18,11,408,422,830,884
0131-002,2012,10,18,12,403,443,846,830
0131-002,2012,10,18,13,347,367,714,846
0131-002,2012,10,18,14,376,396,772,714
0131-002,2012,10,18,15,470,512,982,772
0131-002,2012,10,18,16,412,451,863,982
0131-002,2012,10,18,17,368,569,937,863
0131-002,2012,10,18,18,454,658,1112,937
0131-002,2012,10,18,19,393,560,953,1112
0131-002,2012,10,18,20,293,387,680,953
0131-002,2012,10,18,21,207,373,580,680
0131-002,2012,10,18,22,177,238,415,580
0131-002,2012,10,18,23,136,138,274,415
0131-002,2012,10,18,24,60,94,154,274
0131-002,2012,10,19,1,30,52,82,154
0131-002,2012,10,19,2,19,35,54,82
0131-002,2012,10,19,3,11,15,26,54
0131-002,2012,10,19,4,12,21,33,26
0131-002,2012,10,19,5,20,22,42,33
0131-002,2012,10,19,6,49,54,103,42
0131-002,2012,10,19,7,272,117,389,103
0131-002,2012,10,19,8,882,492,1374,389
0131-002,2012,10,19,9,714,598,1312,1374
0131-002,2012,10,19,10,408,457,865,1312
0131-002,2012,10,19,11,435,418,853,865
0131-002,2012,10,19,12,352,439,791,853
0131-002,2012,10,19,13,258,365,623,791
0131-002,2012,10,19,14,399,409,808,623
0131-002,2012,10,19,15,450,529,979,808
0131-002,2012,10,19,16,462,543,1005,979
0131-002,2012,10,19,17,474,606,1080,1005
0131-002,2012,10,19,18,486,693,1179,1080
0131-002,2012,10,19,19,487,712,1199,1179
0131-002,2012,10,19,20,357,498,855,1199
0131-002,2012,10,19,21,250,385,635,855
0131-002,2012,10,19,22,197,249,446,635
0131-002,2012,10,19,23,105,153,258,446
0131-002,2012,10,19,24,61,71,132,258
0131-002,2012,10,20,1,54,46,100,132
0131-002,2012,10,20,2,14,30,44,100
0131-002,2012,10,20,3,15,31,46,44
0131-002,2012,10,20,4,11,19,30,46
0131-002,2012,10,20,5,11,30,41,30
0131-002,2012,10,20,6,36,29,65,41
0131-002,2012,10,20,7,138,123,261,65
0131-002,2012,10,20,8,532,274,806,261
0131-002,2012,10,20,9,468,482,950,806
0131-002,2012,10,20,10,389,519,908,950
0131-002,2012,10,20,11,388,558,946,908
0131-002,2012,10,20,12,400,801,1201,946
0131-002,2012,10,20,13,461,852,1313,1201
0131-002,2012,10,20,14,399,773,1172,1313
0131-002,2012,10,20,15,425,768,1193,1172
0131-002,2012,10,20,16,388,713,1101,1193
0131-002,2012,10,20,17,488,681,1169,1101
0131-002,2012,10,20,18,570,781,1351,1169
0131-002,2012,10,20,19,393,583,976,1351
0131-002,2012,10,20,20,295,309,604,976
0131-002,2012,10,20,21,246,198,444,604
0131-002,2012,10,20,22,171,154,325,444
0131-002,2012,10,20,23,95,99,194,325
0131-002,2012,10,20,24,54,65,119,194
0131-002,2012,10,21,1,50,49,99,119
0131-002,2012,10,21,2,10,49,59,99
0131-002,2012,10,21,3,11,22,33,59
0131-002,2012,10,21,4,16,30,46,33
0131-002,2012,10,21,5,14,17,31,46
0131-002,2012,10,21,6,26,27,53,31
0131-002,2012,10,21,7,56,74,130,53
0131-002,2012,10,21,8,141,171,312,130
0131-002,2012,10,21,9,181,240,421,312
0131-002,2012,10,21,10,221,285,506,421
0131-002,2012,10,21,11,226,331,557,506
0131-002,2012,10,21,12,251,286,537,557
0131-002,2012,10,21,13,263,282,545,537
0131-002,2012,10,21,14,300,300,600,545
0131-002,2012,10,21,15,304,320,624,600
0131-002,2012,10,21,16,403,380,783,624
0131-002,2012,10,21,17,508,411,919,783
0131-002,2012,10,21,18,624,511,1135,919
0131-002,2012,10,21,19,596,403,999,1135
0131-002,2012,10,21,20,490,281,771,999
0131-002,2012,10,21,21,470,231,701,771
0131-002,2012,10,21,22,518,161,679,701
0131-002,2012,10,21,23,276,102,378,679
0131-002,2012,10,21,24,92,73,165,378
0131-002,2012,10,22,1,27,29,56,165
0131-002,2012,10,22,2,10,22,32,56
0131-002,2012,10,22,3,4,11,15,32
0131-002,2012,10,22,4,4,12,16,15
0131-002,2012,10,22,5,11,18,29,16
0131-002,2012,10,22,6,57,44,101,29
0131-002,2012,10,22,7,260,121,381,101
0131-002,2012,10,22,8,947,516,1463,381
0131-002,2012,10,22,9,768,614,1382,1463
0131-002,2012,10,22,10,363,436,799,1382
0131-002,2012,10,22,11,413,389,802,799
0131-002,2012,10,22,12,347,315,662,802
0131-002,2012,10,22,13,258,270,528,662
0131-002,2012,10,22,14,294,325,619,528
0131-002,2012,10,22,15,356,389,745,619
0131-002,2012,10,22,16,422,445,867,745
0131-002,2012,10,22,17,397,463,860,867
0131-002,2012,10,22,18,412,562,974,860
0131-002,2012,10,22,19,329,580,909,974
0131-002,2012,10,22,20,229,403,632,909
0131-002,2012,10,22,21,218,383,601,632
0131-002,2012,10,22,22,128,250,378,601
0131-002,2012,10,22,23,89,124,213,378
0131-002,2012,10,22,24,52,65,117,213
0131-002,2012,10,23,1,30,40,70,117
0131-002,2012,10,23,2,18,17,35,70
0131-002,2012,10,23,3,4,12,16,35
0131-002,2012,10,23,4,7,14,21,16
0131-002,2012,10,23,5,7,15,22,21
0131-002,2012,10,23,6,50,33,83,22
0131-002,2012,10,23,7,223,119,342,83
0131-002,2012,10,23,8,890,479,1369,342
0131-002,2012,10,23,9,776,638,1414,1369
0131-002,2012,10,23,10,420,485,905,1414
0131-002,2012,10,23,11,490,507,997,905
0131-002,2012,10,23,12,389,478,867,997
0131-002,2012,10,23,13,291,394,685,867
0131-002,2012,10,23,14,385,391,776,685
0131-002,2012,10,23,15,472,502,974,776
0131-002,2012,10,23,16,398,511,909,974
0131-002,2012,10,23,17,375,498,873,909
0131-002,2012,10,23,18,473,655,1128,873
0131-002,2012,10,23,19,403,555,958,1128
0131-002,2012,10,23,20,292,407,699,958
0131-002,2012,10,23,21,192,334,526,699
0131-002,2012,10,23,22,185,252,437,526
0131-002,2012,10,23,23,124,131,255,437
0131-002,2012,10,23,24,47,74,121,255
0131-002,2012,10,24,1,41,30,71,121
0131-002,2012,10,24,2,25,24,49,71
0131-002,2012,10,24,3,4,18,22,49
0131-002,2012,10,24,4,7,14,21,22
0131-002,2012,10,24,5,13,30,43,21
0131-002,2012,10,24,6,38,56,94,43
0131-002,2012,10,24,7,235,108,343,94
0131-002,2012,10,24,8,905,483,1388,343
0131-002,2012,10,24,9,791,666,1457,1388
0131-002,2012,10,24,10,407,510,917,1457
0131-002,2012,10,24,11,448,455,903,917
0131-002,2012,10,24,12,378,443,821,903
0131-002,2012,10,24,13,373,372,745,821
0131-002,2012,10,24,14,380,385,765,745
0131-002,2012,10,24,15,415,459,874,765
0131-002,2012,10,24,16,421,528,949,874
0131-002,2012,10,24,17,409,545,954,949
0131-002,2012,10,24,18,485,720,1205,954
0131-002,2012,10,24,19,403,639,1042,1205
0131-002,2012,10,24,20,283,401,684,1042
0131-002,2012,10,24,21,193,331,524,684
0131-002,2012,10,24,22,168,210,378,524
0131-002,2012,10,24,23,103,111,214,378
0131-002,2012,10,24,24,56,56,112,214
0131-002,2012,10,25,1,34,45,79,112
0131-002,2012,10,25,2,15,25,40,79
0131-002,2012,10,25,3,13,18,31,40
0131-002,2012,10,25,4,4,14,18,31
0131-002,2012,10,25,5,12,17,29,18
0131-002,2012,10,25,6,42,44,86,29
0131-002,2012,10,25,7,258,113,371,86
0131-002,2012,10,25,8,962,523,1485,371
0131-002,2012,10,25,9,740,678,1418,1485
0131-002,2012,10,25,10,475,476,951,1418
0131-002,2012,10,25,11,439,495,934,951
0131-002,2012,10,25,12,405,500,905,934
0131-002,2012,10,25,13,343,379,722,905
0131-002,2012,10,25,14,415,482,897,722
0131-002,2012,10,25,15,461,444,905,897
0131-002,2012,10,25,16,452,498,950,905
0131-002,2012,10,25,17,453,490,943,950
0131-002,2012,10,25,18,448,630,1078,943
0131-002,2012,10,25,19,362,663,1025,1078
0131-002,2012,10,25,20,271,407,678,1025
0131-002,2012,10,25,21,185,375,560,678
0131-002,2012,10,25,22,189,236,425,560
0131-002,2012,10,25,23,112,121,233,425
0131-002,2012,10,25,24,60,65,125,233
0131-002,2012,10,26,1,38,37,75,125
0131-002,2012,10,26,2,16,21,37,75
0131-002,2012,10,26,3,13,16,29,37
0131-002,2012,10,26,4,11,27,38,29
0131-002,2012,10,26,5,4,26,30,38
0131-002,2012,10,26,6,39,57,96,30
0131-002,2012,10,26,7,233,123,356,96
0131-002,2012,10,26,8,871,462,1333,356
0131-002,2012,10,26,9,747,602,1349,1333
0131-002,2012,10,26,10,440,427,867,1349
0131-002,2012,10,26,11,428,464,892,867
0131-002,2012,10,26,12,382,458,840,892
0131-002,2012,10,26,13,299,347,646,840
0131-002,2012,10,26,14,300,468,768,646
0131-002,2012,10,26,15,444,495,939,768
0131-002,2012,10,26,16,487,559,1046,939
0131-002,2012,10,26,17,461,539,1000,1046
0131-002,2012,10,26,18,490,703,1193,1000
0131-002,2012,10,26,19,479,678,1157,1193
0131-002,2012,10,26,20,369,551,920,1157
0131-002,2012,10,26,21,219,421,640,920
0131-002,2012,10,26,22,220,259,479,640
0131-002,2012,10,26,23,111,168,279,479
0131-002,2012,10,26,24,64,88,152,279
0131-002,2012,10,27,1,48,74,122,152
0131-002,2012,10,27,2,23,32,55,122
0131-002,2012,10,27,3,16,29,45,55
0131-002,2012,10,27,4,19,20,39,45
0131-002,2012,10,27,5,15,26,41,39
0131-002,2012,10,27,6,49,30,79,41
0131-002,2012,10,27,7,89,52,141,79
0131-002,2012,10,27,8,318,217,535,141
0131-002,2012,10,27,9,374,384,758,535
0131-002,2012,10,27,10,334,417,751,758
0131-002,2012,10,27,11,352,571,923,751
0131-002,2012,10,27,12,330,664,994,923
0131-002,2012,10,27,13,317,679,996,994
0131-002,2012,10,27,14,328,652,980,996
0131-002,2012,10,27,15,380,661,1041,980
0131-002,2012,10,27,16,419,588,1007,1041
0131-002,2012,10,27,17,481,562,1043,1007
0131-002,2012,10,27,18,528,622,1150,1043
0131-002,2012,10,27,19,473,429,902,1150
0131-002,2012,10,27,20,305,238,543,902
0131-002,2012,10,27,21,228,180,408,543
0131-002,2012,10,27,22,147,131,278,408
0131-002,2012,10,27,23,106,75,181,278
0131-002,2012,10,27,24,38,61,99,181
0131-002,2012,10,28,1,30,59,89,99
0131-002,2012,10,28,2,23,29,52,89
0131-002,2012,10,28,3,18,16,34,52
0131-002,2012,10,28,4,9,11,20,34
0131-002,2012,10,28,5,22,28,50,20
0131-002,2012,10,28,6,31,20,51,50
0131-002,2012,10,28,7,64,56,120,51
0131-002,2012,10,28,8,140,133,273,120
0131-002,2012,10,28,9,168,224,392,273
0131-002,2012,10,28,10,240,266,506,392
0131-002,2012,10,28,11,192,292,484,506
0131-002,2012,10,28,12,239,279,518,484
0131-002,2012,10,28,13,287,320,607,518
0131-002,2012,10,28,14,265,303,568,607
0131-002,2012,10,28,15,303,332,635,568
0131-002,2012,10,28,16,358,415,773,635
0131-002,2012,10,28,17,380,455,835,773
0131-002,2012,10,28,18,518,466,984,835
0131-002,2012,10,28,19,433,366,799,984
0131-002,2012,10,28,20,435,264,699,799
0131-002,2012,10,28,21,403,224,627,699
0131-002,2012,10,28,22,399,166,565,627
0131-002,2012,10,28,23,208,96,304,565
0131-002,2012,10,28,24,95,46,141,304
0131-002,2012,10,29,1,34,40,74,141
0131-002,2012,10,29,2,23,25,48,74
0131-002,2012,10,29,3,5,8,13,48
0131-002,2012,10,29,4,2,4,6,13
0131-002,2012,10,29,5,16,16,32,6
0131-002,2012,10,29,6,39,50,89,32
0131-002,2012,10,29,7,333,155,488,89
0131-002,2012,10,29,8,996,485,1481,488
0131-002,2012,10,29,9,810,574,1384,1481
0131-002,2012,10,29,10,424,419,843,1384
0131-002,2012,10,29,11,390,479,869,843
0131-002,2012,10,29,12,355,429,784,869
0131-002,2012,10,29,13,347,450,797,784
0131-002,2012,10,29,14,364,424,788,797
0131-002,2012,10,29,15,417,492,909,788
0131-002,2012,10,29,16,464,540,1004,909
0131-002,2012,10,29,17,458,522,980,1004
0131-002,2012,10,29,18,423,640,1063,980
0131-002,2012,10,29,19,381,557,938,1063
0131-002,2012,10,29,20,250,362,612,938
0131-002,2012,10,29,21,195,386,581,612
0131-002,2012,10,29,22,152,228,380,581
0131-002,2012,10,29,23,102,137,239,380
0131-002,2012,10,29,24,46,71,117,239
0131-002,2012,10,30,1,33,41,74,117
0131-002,2012,10,30,2,16,18,34,74
0131-002,2012,10,30,3,4,17,21,34
0131-002,2012,10,30,4,4,21,25,21
0131-002,2012,10,30,5,4,17,21,25
0131-002,2012,10,30,6,40,58,98,21
0131-002,2012,10,30,7,241,100,341,98
0131-002,2012,10,30,8,891,468,1359,341
0131-002,2012,10,30,9,703,598,1301,1359
0131-002,2012,10,30,10,421,486,907,1301
0131-002,2012,10,30,11,443,470,913,907
0131-002,2012,10,30,12,355,444,799,913
0131-002,2012,10,30,13,334,379,713,799
0131-002,2012,10,30,14,400,470,870,713
0131-002,2012,10,30,15,485,451,936,870
0131-002,2012,10,30,16,492,575,1067,936
0131-002,2012,10,30,17,461,555,1016,1067
0131-002,2012,10,30,18,464,661,1125,1016
0131-002,2012,10,30,19,395,576,971,1125
0131-002,2012,10,30,20,324,353,677,971
0131-002,2012,10,30,21,193,353,546,677
0131-002,2012,10,30,22,193,235,428,546
0131-002,2012,10,30,23,111,151,262,428
0131-002,2012,10,30,24,67,78,145,262
0131-002,2012,10,31,1,31,38,69,145
0131-002,2012,10,31,2,23,23,46,69
0131-002,2012,10,31,3,7,15,22,46
0131-002,2012,10,31,4,11,14,25,22
0131-002,2012,10,31,5,15,19,34,25
0131-002,2012,10,31,6,38,34,72,34
0131-002,2012,10,31,7,222,121,343,72
0131-002,2012,10,31,8,926,468,1394,343
0131-002,2012,10,31,9,707,621,1328,1394
0131-002,2012,10,31,10,403,442,845,1328
0131-002,2012,10,31,11,389,471,860,845
0131-002,2012,10,31,12,333,422,755,860
0131-002,2012,10,31,13,360,368,728,755
0131-002,2012,10,31,14,390,396,786,728
0131-002,2012,10,31,15,423,503,926,786
0131-002,2012,10,31,16,421,496,917,926
0131-002,2012,10,31,17,375,487,862,917
0131-002,2012,10,31,18,502,624,1126,862
0131-002,2012,10,31,19,387,596,983,1126
0131-002,2012,10,31,20,271,397,668,983
0131-002,2012,10,31,21,191,331,522,668
0131-002,2012,10,31,22,137,208,345,522
0131-002,2012,10,31,23,105,134,239,345
0131-002,2012,10,31,24,80,65,145,239
0131-002,2012,11,1,1,27,21,48,145
0131-002,2012,11,1,2,5,12,17,48
0131-002,2012,11,1,3,4,8,12,17
0131-002,2012,11,1,4,6,13,19,12
0131-002,2012,11,1,5,11,15,26,19
0131-002,2012,11,1,6,29,24,53,26
0131-002,2012,11,1,7,160,73,233,53
0131-002,2012,11,1,8,655,344,999,233
0131-002,2012,11,1,9,536,442,978,999
0131-002,2012,11,1,10,285,335,620,978
0131-002,2012,11,1,11,286,324,610,620
0131-002,2012,11,1,12,281,351,632,610
0131-002,2012,11,1,13,205,247,452,632
0131-002,2012,11,1,14,271,312,583,452
0131-002,2012,11,1,15,289,381,670,583
0131-002,2012,11,1,16,290,357,647,670
0131-002,2012,11,1,17,266,363,629,647
0131-002,2012,11,1,18,315,440,755,629
0131-002,2012,11,1,19,266,426,692,755
0131-002,2012,11,1,20,181,315,496,692
0131-002,2012,11,1,21,147,267,414,496
0131-002,2012,11,1,22,136,185,321,414
0131-002,2012,11,1,23,75,103,178,321
0131-002,2012,11,1,24,39,40,79,178
0131-002,2012,11,2,1,26,34,60,79
0131-002,2012,11,2,2,14,19,33,60
0131-002,2012,11,2,3,12,10,22,33
0131-002,2012,11,2,4,7,8,15,22
0131-002,2012,11,2,5,4,15,19,15
0131-002,2012,11,2,6,29,24,53,19
0131-002,2012,11,2,7,160,102,262,53
0131-002,2012,11,2,8,663,326,989,262
0131-002,2012,11,2,9,530,458,988,989
0131-002,2012,11,2,10,306,317,623,988
0131-002,2012,11,2,11,309,367,676,623
0131-002,2012,11,2,12,257,350,607,676
0131-002,2012,11,2,13,201,260,461,607
0131-002,2012,11,2,14,274,307,581,461
0131-002,2012,11,2,15,280,350,630,581
0131-002,2012,11,2,16,316,406,722,630
0131-002,2012,11,2,17,325,380,705,722
0131-002,2012,11,2,18,347,516,863,705
0131-002,2012,11,2,19,317,496,813,863
0131-002,2012,11,2,20,259,372,631,813
0131-002,2012,11,2,21,150,309,459,631
0131-002,2012,11,2,22,134,192,326,459
0131-002,2012,11,2,23,88,140,228,326
0131-002,2012,11,2,24,45,61,106,228
0131-002,2012,11,3,1,30,36,66,106
0131-002,2012,11,3,2,22,26,48,66
0131-002,2012,11,3,3,10,21,31,48
0131-002,2012,11,3,4,9,15,24,31
0131-002,2012,11,3,5,10,26,36,24
0131-002,2012,11,3,6,24,27,51,36
0131-002,2012,11,3,7,93,85,178,51
0131-002,2012,11,3,8,297,207,504,178
0131-002,2012,11,3,9,311,301,612,504
0131-002,2012,11,3,10,243,407,650,612
0131-002,2012,11,3,11,272,607,879,650
0131-002,2012,11,3,12,274,623,897,879
0131-002,2012,11,3,13,237,666,903,897
0131-002,2012,11,3,14,263,623,886,903
0131-002,2012,11,3,15,285,550,835,886
0131-002,2012,11,3,16,325,509,834,835
0131-002,2012,11,3,17,352,526,878,834
0131-002,2012,11,3,18,374,559,933,878
0131-002,2012,11,3,19,320,400,720,933
0131-002,2012,11,3,20,299,190,489,720
0131-002,2012,11,3,21,249,154,403,489
0131-002,2012,11,3,22,193,116,309,403
0131-002,2012,11,3,23,70,74,144,309
0131-002,2012,11,3,24,36,51,87,144
0131-002,2012,11,4,1,20,26,46,87
0131-002,2012,11,4,2,11,15,26,46
0131-002,2012,11,4,3,8,14,22,26
0131-002,2012,11,4,4,5,9,14,22
0131-002,2012,11,4,5,7,9,16,14
0131-002,2012,11,4,6,13,17,30,16
0131-002,2012,11,4,7,22,37,59,30
0131-002,2012,11,4,8,91,71,162,59
0131-002,2012,11,4,9,84,117,201,162
0131-002,2012,11,4,10,106,146,252,201
0131-002,2012,11,4,11,149,184,333,252
0131-002,2012,11,4,12,131,181,312,333
0131-002,2012,11,4,13,182,172,354,312
0131-002,2012,11,4,14,157,176,333,354
0131-002,2012,11,4,15,213,216,429,333
0131-002,2012,11,4,16,290,231,521,429
0131-002,2012,11,4,17,407,234,641,521
0131-002,2012,11,4,18,367,197,564,641
0131-002,2012,11,4,19,350,152,502,564
0131-002,2012,11,4,20,330,111,441,502
0131-002,2012,11,4,21,241,110,351,441
0131-002,2012,11,4,22,188,74,262,351
0131-002,2012,11,4,23,87,45,132,262
0131-002,2012,11,4,24,38,41,79,132
0131-002,2012,11,5,1,13,22,35,79
0131-002,2012,11,5,2,9,7,16,35
0131-002,2012,11,5,3,3,6,9,16
0131-002,2012,11,5,4,5,7,12,9
0131-002,2012,11,5,5,11,15,26,12
0131-002,2012,11,5,6,37,40,77,26
0131-002,2012,11,5,7,210,88,298,77
0131-002,2012,11,5,8,740,379,1119,298
0131-002,2012,11,5,9,594,460,1054,1119
0131-002,2012,11,5,10,271,332,603,1054
0131-002,2012,11,5,11,279,332,611,603
0131-002,2012,11,5,12,285,346,631,611
0131-002,2012,11,5,13,218,239,457,631
0131-002,2012,11,5,14,283,285,568,457
0131-002,2012,11,5,15,287,345,632,568
0131-002,2012,11,5,16,297,371,668,632
0131-002,2012,11,5,17,262,357,619,668
0131-002,2012,11,5,18,270,440,710,619
0131-002,2012,11,5,19,264,374,638,710
0131-002,2012,11,5,20,168,269,437,638
0131-002,2012,11,5,21,142,290,432,437
0131-002,2012,11,5,22,102,191,293,432
0131-002,2012,11,5,23,74,81,155,293
0131-002,2012,11,5,24,23,38,61,155
0131-002,2012,11,6,1,17,30,47,61
0131-002,2012,11,6,2,7,12,19,47
0131-002,2012,11,6,3,14,9,23,19
0131-002,2012,11,6,4,9,13,22,23
0131-002,2012,11,6,5,7,17,24,22
0131-002,2012,11,6,6,32,39,71,24
0131-002,2012,11,6,7,147,90,237,71
0131-002,2012,11,6,8,616,380,996,237
0131-002,2012,11,6,9,550,402,952,996
0131-002,2012,11,6,10,279,344,623,952
0131-002,2012,11,6,11,297,319,616,623
0131-002,2012,11,6,12,263,269,532,616
0131-002,2012,11,6,13,209,230,439,532
0131-002,2012,11,6,14,260,304,564,439
0131-002,2012,11,6,15,264,351,615,564
0131-002,2012,11,6,16,307,349,656,615
0131-002,2012,11,6,17,276,330,606,656
0131-002,2012,11,6,18,276,424,700,606
0131-002,2012,11,6,19,244,364,608,700
0131-002,2012,11,6,20,167,259,426,608
0131-002,2012,11,6,21,145,278,423,426
0131-002,2012,11,6,22,113,164,277,423
0131-002,2012,11,6,23,76,83,159,277
0131-002,2012,11,6,24,28,42,70,159
0131-002,2012,11,7,1,23,25,48,70
0131-002,2012,11,7,2,16,12,28,48
0131-002,2012,11,7,3,7,14,21,28
0131-002,2012,11,7,4,2,8,10,21
0131-002,2012,11,7,5,4,21,25,10
0131-002,2012,11,7,6,26,30,56,25
0131-002,2012,11,7,7,146,69,215,56
0131-002,2012,11,7,8,634,326,960,215
0131-002,2012,11,7,9,536,484,1020,960
0131-002,2012,11,7,10,265,346,611,1020
0131-002,2012,11,7,11,289,345,634,611
0131-002,2012,11,7,12,266,320,586,634
0131-002,2012,11,7,13,218,251,469,586
0131-002,2012,11,7,14,279,302,581,469
0131-002,2012,11,7,15,312,362,674,581
0131-002,2012,11,7,16,302,387,689,674
0131-002,2012,11,7,17,344,363,707,689
0131-002,2012,11,7,18,339,508,847,707
0131-002,2012,11,7,19,288,455,743,847
0131-002,2012,11,7,20,189,304,493,743
0131-002,2012,11,7,21,131,274,405,493
0131-002,2012,11,7,22,112,173,285,405
0131-002,2012,11,7,23,79,93,172,285
0131-002,2012,11,7,24,40,58,98,172
0131-002,2012,11,8,1,24,32,56,98
0131-002,2012,11,8,2,16,17,33,56
0131-002,2012,11,8,3,7,12,19,33
0131-002,2012,11,8,4,8,11,19,19
0131-002,2012,11,8,5,6,18,24,19
0131-002,2012,11,8,6,23,28,51,24
0131-002,2012,11,8,7,181,82,263,51
0131-002,2012,11,8,8,651,351,1002,263
0131-002,2012,11,8,9,566,475,1041,1002
0131-002,2012,11,8,10,335,364,699,1041
0131-002,2012,11,8,11,336,374,710,699
0131-002,2012,11,8,12,288,345,633,710
0131-002,2012,11,8,13,221,290,511,633
0131-002,2012,11,8,14,266,329,595,511
0131-002,2012,11,8,15,356,363,719,595
0131-002,2012,11,8,16,302,350,652,719
0131-002,2012,11,8,17,310,400,710,652
0131-002,2012,11,8,18,319,463,782,710
0131-002,2012,11,8,19,262,412,674,782
0131-002,2012,11,8,20,188,312,500,674
0131-002,2012,11,8,21,142,274,416,500
0131-002,2012,11,8,22,118,189,307,416
0131-002,2012,11,8,23,93,106,199,307
0131-002,2012,11,8,24,33,56,89,199
0131-002,2012,11,9,1,19,30,49,89
0131-002,2012,11,9,2,22,10,32,49
0131-002,2012,11,9,3,9,16,25,32
0131-002,2012,11,9,4,9,11,20,25
0131-002,2012,11,9,5,13,14,27,20
0131-002,2012,11,9,6,23,25,48,27
0131-002,2012,11,9,7,166,75,241,48
0131-002,2012,11,9,8,583,322,905,241
0131-002,2012,11,9,9,507,461,968,905
0131-002,2012,11,9,10,291,297,588,968
0131-002,2012,11,9,11,306,315,621,588
0131-002,2012,11,9,12,258,321,579,621
0131-002,2012,11,9,13,254,296,550,579
0131-002,2012,11,9,14,286,294,580,550
0131-002,2012,11,9,15,379,363,742,580
0131-002,2012,11,9,16,309,426,735,742
0131-002,2012,11,9,17,352,430,782,735
0131-002,2012,11,9,18,369,543,912,782
0131-002,2012,11,9,19,316,494,810,912
0131-002,2012,11,9,20,249,375,624,810
0131-002,2012,11,9,21,177,303,480,624
0131-002,2012,11,9,22,150,215,365,480
0131-002,2012,11,9,23,78,131,209,365
0131-002,2012,11,9,24,57,61,118,209
0131-002,2012,11,10,1,44,51,95,118
0131-002,2012,11,10,2,25,21,46,95
0131-002,2012,11,10,3,14,19,33,46
0131-002,2012,11,10,4,11,15,26,33
0131-002,2012,11,10,5,16,17,33,26
0131-002,2012,11,10,6,33,21,54,33
0131-002,2012,11,10,7,101,72,173,54
0131-002,2012,11,10,8,285,208,493,173
0131-002,2012,11,10,9,318,337,655,493
0131-002,2012,11,10,10,267,414,681,655
0131-002,2012,11,10,11,283,520,803,681
0131-002,2012,11,10,12,351,610,961,803
0131-002,2012,11,10,13,307,584,891,961
0131-002,2012,11,10,14,280,554,834,891
0131-002,2012,11,10,15,302,561,863,834
0131-002,2012,11,10,16,305,515,820,863
0131-002,2012,11,10,17,357,548,905,820
0131-002,2012,11,10,18,457,554,1011,905
0131-002,2012,11,10,19,403,428,831,1011
0131-002,2012,11,10,20,328,232,560,831
0131-002,2012,11,10,21,207,157,364,560
0131-002,2012,11,10,22,179,126,305,364
0131-002,2012,11,10,23,84,68,152,305
0131-002,2012,11,10,24,49,45,94,152
0131-002,2012,11,11,1,26,25,51,94
0131-002,2012,11,11,2,18,32,50,51
0131-002,2012,11,11,3,8,16,24,50
0131-002,2012,11,11,4,8,17,25,24
0131-002,2012,11,11,5,9,14,23,25
0131-002,2012,11,11,6,8,21,29,23
0131-002,2012,11,11,7,24,32,56,29
0131-002,2012,11,11,8,58,45,103,56
0131-002,2012,11,11,9,84,106,190,103
0131-002,2012,11,11,10,101,117,218,190
0131-002,2012,11,11,11,111,140,251,218
0131-002,2012,11,11,12,157,155,312,251
0131-002,2012,11,11,13,177,186,363,312
0131-002,2012,11,11,14,207,219,426,363
0131-002,2012,11,11,15,249,204,453,426
0131-002,2012,11,11,16,378,203,581,453
0131-002,2012,11,11,17,387,259,646,581
0131-002,2012,11,11,18,363,223,586,646
0131-002,2012,11,11,19,341,161,502,586
0131-002,2012,11,11,20,339,144,483,502
0131-002,2012,11,11,21,254,120,374,483
0131-002,2012,11,11,22,193,96,289,374
0131-002,2012,11,11,23,81,44,125,289
0131-002,2012,11,11,24,50,32,82,125
0131-002,2012,11,12,1,23,14,37,82
0131-002,2012,11,12,2,11,9,20,37
0131-002,2012,11,12,3,2,11,13,20
0131-002,2012,11,12,4,4,11,15,13
0131-002,2012,11,12,5,13,16,29,15
0131-002,2012,11,12,6,25,35,60,29
0131-002,2012,11,12,7,224,86,310,60
0131-002,2012,11,12,8,720,361,1081,310
0131-002,2012,11,12,9,595,472,1067,1081
0131-002,2012,11,12,10,270,331,601,1067
0131-002,2012,11,12,11,289,345,634,601
0131-002,2012,11,12,12,251,326,577,634
0131-002,2012,11,12,13,241,251,492,577
0131-002,2012,11,12,14,280,285,565,492
0131-002,2012,11,12,15,514,348,862,565
0131-002,2012,11,12,16,479,321,800,862
0131-002,2012,11,12,17,309,351,660,800
0131-002,2012,11,12,18,269,439,708,660
0131-002,2012,11,12,19,251,354,605,708
0131-002,2012,11,12,20,168,309,477,605
0131-002,2012,11,12,21,120,238,358,477
0131-002,2012,11,12,22,140,163,303,358
0131-002,2012,11,12,23,62,87,149,303
0131-002,2012,11,12,24,39,48,87,149
0131-002,2012,11,13,1,21,23,44,87
0131-002,2012,11,13,2,19,21,40,44
0131-002,2012,11,13,3,6,26,32,40
0131-002,2012,11,13,4,7,13,20,32
0131-002,2012,11,13,5,6,18,24,20
0131-002,2012,11,13,6,15,31,46,24
0131-002,2012,11,13,7,130,59,189,46
0131-002,2012,11,13,8,604,321,925,189
0131-002,2012,11,13,9,515,471,986,925
0131-002,2012,11,13,10,292,352,644,986
0131-002,2012,11,13,11,270,352,622,644
0131-002,2012,11,13,12,273,286,559,622
0131-002,2012,11,13,13,197,239,436,559
0131-002,2012,11,13,14,246,273,519,436
0131-002,2012,11,13,15,284,370,654,519
0131-002,2012,11,13,16,285,354,639,654
0131-002,2012,11,13,17,292,358,650,639
0131-002,2012,11,13,18,275,436,711,650
0131-002,2012,11,13,19,244,391,635,711
0131-002,2012,11,13,20,183,286,469,635
0131-002,2012,11,13,21,142,262,404,469
0131-002,2012,11,13,22,102,162,264,404
0131-002,2012,11,13,23,79,97,176,264
0131-002,2012,11,13,24,48,47,95,176
0131-002,2012,11,14,1,17,24,41,95
0131-002,2012,11,14,2,16,20,36,41
0131-002,2012,11,14,3,5,14,19,36
0131-002,2012,11,14,4,2,23,25,19
0131-002,2012,11,14,5,7,13,20,25
0131-002,2012,11,14,6,22,26,48,20
0131-002,2012,11,14,7,135,59,194,48
0131-002,2012,11,14,8,634,338,972,194
0131-002,2012,11,14,9,572,498,1070,972
0131-002,2012,11,14,10,301,337,638,1070
0131-002,2012,11,14,11,286,354,640,638
0131-002,2012,11,14,12,275,339,614,640
0131-002,2012,11,14,13,226,263,489,614
0131-002,2012,11,14,14,288,337,625,489
0131-002,2012,11,14,15,295,355,650,625
0131-002,2012,11,14,16,284,376,660,650
0131-002,2012,11,14,17,294,427,721,660
0131-002,2012,11,14,18,358,490,848,721
0131-002,2012,11,14,19,294,482,776,848
0131-002,2012,11,14,20,203,318,521,776
0131-002,2012,11,14,21,138,265,403,521
0131-002,2012,11,14,22,125,157,282,403
0131-002,2012,11,14,23,79,115,194,282
0131-002,2012,11,14,24,46,54,100,194
0131-002,2012,11,15,1,35,31,66,100
0131-002,2012,11,15,2,13,23,36,66
0131-002,2012,11,15,3,7,13,20,36
0131-002,2012,11,15,4,7,9,16,20
0131-002,2012,11,15,5,7,17,24,16
0131-002,2012,11,15,6,23,36,59,24
0131-002,2012,11,15,7,170,70,240,59
0131-002,2012,11,15,8,649,362,1011,240
0131-002,2012,11,15,9,556,465,1021,1011
0131-002,2012,11,15,10,283,348,631,1021
0131-002,2012,11,15,11,322,356,678,631
0131-002,2012,11,15,12,291,342,633,678
0131-002,2012,11,15,13,216,284,500,633
0131-002,2012,11,15,14,244,306,550,500
0131-002,2012,11,15,15,320,390,710,550
0131-002,2012,11,15,16,328,399,727,710
0131-002,2012,11,15,17,327,393,720,727
0131-002,2012,11,15,18,329,490,819,720
0131-002,2012,11,15,19,270,420,690,819
0131-002,2012,11,15,20,207,316,523,690
0131-002,2012,11,15,21,153,272,425,523
0131-002,2012,11,15,22,156,197,353,425
0131-002,2012,11,15,23,73,112,185,353
0131-002,2012,11,15,24,49,53,102,185
0131-002,2012,11,16,1,25,37,62,102
0131-002,2012,11,16,2,12,18,30,62
0131-002,2012,11,16,3,7,11,18,30
0131-002,2012,11,16,4,8,21,29,18
0131-002,2012,11,16,5,10,9,19,29
0131-002,2012,11,16,6,25,25,50,19
0131-002,2012,11,16,7,153,89,242,50
0131-002,2012,11,16,8,630,335,965,242
0131-002,2012,11,16,9,521,504,1025,965
0131-002,2012,11,16,10,306,362,668,1025
0131-002,2012,11,16,11,306,354,660,668
0131-002,2012,11,16,12,334,345,679,660
0131-002,2012,11,16,13,240,319,559,679
0131-002,2012,11,16,14,283,337,620,559
0131-002,2012,11,16,15,346,412,758,620
0131-002,2012,11,16,16,337,363,700,758
0131-002,2012,11,16,17,354,406,760,700
0131-002,2012,11,16,18,346,529,875,760
0131-002,2012,11,16,19,306,511,817,875
0131-002,2012,11,16,20,236,369,605,817
0131-002,2012,11,16,21,152,326,478,605
0131-002,2012,11,16,22,135,210,345,478
0131-002,2012,11,16,23,75,110,185,345
0131-002,2012,11,16,24,47,62,109,185
0131-002,2012,11,17,1,40,47,87,109
0131-002,2012,11,17,2,17,28,45,87
0131-002,2012,11,17,3,11,16,27,45
0131-002,2012,11,17,4,7,11,18,27
0131-002,2012,11,17,5,6,15,21,18
0131-002,2012,11,17,6,26,21,47,21
0131-002,2012,11,17,7,64,58,122,47
0131-002,2012,11,17,8,236,181,417,122
0131-002,2012,11,17,9,343,299,642,417
0131-002,2012,11,17,10,263,401,664,642
0131-002,2012,11,17,11,296,505,801,664
0131-002,2012,11,17,12,313,609,922,801
0131-002,2012,11,17,13,255,600,855,922
0131-002,2012,11,17,14,267,541,808,855
0131-002,2012,11,17,15,263,521,784,808
0131-002,2012,11,17,16,345,591,936,784
0131-002,2012,11,17,17,415,621,1036,936
0131-002,2012,11,17,18,378,588,966,1036
0131-002,2012,11,17,19,385,487,872,966
0131-002,2012,11,17,20,276,392,668,872
0131-002,2012,11,17,21,190,222,412,668
0131-002,2012,11,17,22,129,128,257,412
0131-002,2012,11,17,23,68,72,140,257
0131-002,2012,11,17,24,42,56,98,140
0131-002,2012,11,18,1,25,35,60,98
0131-002,2012,11,18,2,16,15,31,60
0131-002,2012,11,18,3,11,19,30,31
0131-002,2012,11,18,4,4,13,17,30
0131-002,2012,11,18,5,6,11,17,17
0131-002,2012,11,18,6,18,13,31,17
0131-002,2012,11,18,7,36,21,57,31
0131-002,2012,11,18,8,80,66,146,57
0131-002,2012,11,18,9,131,103,234,146
0131-002,2012,11,18,10,120,142,262,234
0131-002,2012,11,18,11,138,203,341,262
0131-002,2012,11,18,12,169,166,335,341
0131-002,2012,11,18,13,181,176,357,335
0131-002,2012,11,18,14,244,199,443,357
0131-002,2012,11,18,15,340,233,573,443
0131-002,2012,11,18,16,430,257,687,573
0131-002,2012,11,18,17,387,285,672,687
0131-002,2012,11,18,18,441,261,702,672
0131-002,2012,11,18,19,441,221,662,702
0131-002,2012,11,18,20,432,174,606,662
0131-002,2012,11,18,21,443,129,572,606
0131-002,2012,11,18,22,453,96,549,572
0131-002,2012,11,18,23,335,59,394,549
0131-002,2012,11,18,24,210,47,257,394
0131-002,2012,11,19,1,44,30,74,257
0131-002,2012,11,19,2,11,9,20,74
0131-002,2012,11,19,3,1,9,10,20
0131-002,2012,11,19,4,5,11,16,10
0131-002,2012,11,19,5,9,10,19,16
0131-002,2012,11,19,6,35,33,68,19
0131-002,2012,11,19,7,216,100,316,68
0131-002,2012,11,19,8,658,306,964,316
0131-002,2012,11,19,9,589,502,1091,964
0131-002,2012,11,19,10,257,318,575,1091
0131-002,2012,11,19,11,287,298,585,575
0131-002,2012,11,19,12,246,299,545,585
0131-002,2012,11,19,13,215,261,476,545
0131-002,2012,11,19,14,273,318,591,476
0131-002,2012,11,19,15,332,366,698,591
0131-002,2012,11,19,16,336,370,706,698
0131-002,2012,11,19,17,318,369,687,706
0131-002,2012,11,19,18,304,475,779,687
0131-002,2012,11,19,19,237,428,665,779
0131-002,2012,11,19,20,185,335,520,665
0131-002,2012,11,19,21,132,256,388,520
0131-002,2012,11,19,22,116,174,290,388
0131-002,2012,11,19,23,70,93,163,290
0131-002,2012,11,19,24,42,45,87,163
0131-002,2012,11,20,1,21,28,49,87
0131-002,2012,11,20,2,10,11,21,49
0131-002,2012,11,20,3,9,16,25,21
0131-002,2012,11,20,4,4,7,11,25
0131-002,2012,11,20,5,7,15,22,11
0131-002,2012,11,20,6,27,36,63,22
0131-002,2012,11,20,7,178,64,242,63
0131-002,2012,11,20,8,665,334,999,242
0131-002,2012,11,20,9,513,483,996,999
0131-002,2012,11,20,10,314,335,649,996
0131-002,2012,11,20,11,316,336,652,649
0131-002,2012,11,20,12,275,285,560,652
0131-002,2012,11,20,13,223,298,521,560
0131-002,2012,11,20,14,277,316,593,521
0131-002,2012,11,20,15,342,393,735,593
0131-002,2012,11,20,16,350,393,743,735
0131-002,2012,11,20,17,319,439,758,743
0131-002,2012,11,20,18,344,505,849,758
0131-002,2012,11,20,19,286,458,744,849
0131-002,2012,11,20,20,193,323,516,744
0131-002,2012,11,20,21,161,284,445,516
0131-002,2012,11,20,22,130,188,318,445
0131-002,2012,11,20,23,72,104,176,318
0131-002,2012,11,20,24,37,49,86,176
0131-002,2012,11,21,1,17,41,58,86
0131-002,2012,11,21,2,16,12,28,58
0131-002,2012,11,21,3,4,9,13,28
0131-002,2012,11,21,4,2,9,11,13
0131-002,2012,11,21,5,8,19,27,11
0131-002,2012,11,21,6,24,28,52,27
0131-002,2012,11,21,7,170,63,233,52
0131-002,2012,11,21,8,673,359,1032,233
0131-002,2012,11,21,9,569,502,1071,1032
0131-002,2012,11,21,10,297,331,628,1071
0131-002,2012,11,21,11,316,332,648,628
0131-002,2012,11,21,12,234,427,661,648
0131-002,2012,11,21,13,216,294,510,661
0131-002,2012,11,21,14,257,290,547,510
0131-002,2012,11,21,15,347,396,743,547
0131-002,2012,11,21,16,316,363,679,743
0131-002,2012,11,21,17,316,401,717,679
0131-002,2012,11,21,18,304,571,875,717
0131-002,2012,11,21,19,280,475,755,875
0131-002,2012,11,21,20,206,317,523,755
0131-002,2012,11,21,21,159,248,407,523
0131-002,2012,11,21,22,114,168,282,407
0131-002,2012,11,21,23,77,97,174,282
0131-002,2012,11,21,24,47,54,101,174
0131-002,2012,11,22,1,33,30,63,101
0131-002,2012,11,22,2,11,12,23,63
0131-002,2012,11,22,3,9,17,26,23
0131-002,2012,11,22,4,4,14,18,26
0131-002,2012,11,22,5,6,14,20,18
0131-002,2012,11,22,6,27,25,52,20
0131-002,2012,11,22,7,148,87,235,52
0131-002,2012,11,22,8,681,351,1032,235
0131-002,2012,11,22,9,585,491,1076,1032
0131-002,2012,11,22,10,331,361,692,1076
0131-002,2012,11,22,11,332,367,699,692
0131-002,2012,11,22,12,284,314,598,699
0131-002,2012,11,22,13,236,277,513,598
0131-002,2012,11,22,14,267,334,601,513
0131-002,2012,11,22,15,341,391,732,601
0131-002,2012,11,22,16,307,399,706,732
0131-002,2012,11,22,17,296,420,716,706
0131-002,2012,11,22,18,331,460,791,716
0131-002,2012,11,22,19,285,450,735,791
0131-002,2012,11,22,20,176,302,478,735
0131-002,2012,11,22,21,133,271,404,478
0131-002,2012,11,22,22,115,167,282,404
0131-002,2012,11,22,23,83,119,202,282
0131-002,2012,11,22,24,44,63,107,202
0131-002,2012,11,23,1,30,36,66,107
0131-002,2012,11,23,2,11,19,30,66
0131-002,2012,11,23,3,9,18,27,30
0131-002,2012,11,23,4,9,10,19,27
0131-002,2012,11,23,5,9,19,28,19
0131-002,2012,11,23,6,22,31,53,28
0131-002,2012,11,23,7,153,84,237,53
0131-002,2012,11,23,8,647,344,991,237
0131-002,2012,11,23,9,543,461,1004,991
0131-002,2012,11,23,10,285,374,659,1004
0131-002,2012,11,23,11,328,382,710,659
0131-002,2012,11,23,12,276,334,610,710
0131-002,2012,11,23,13,199,310,509,610
0131-002,2012,11,23,14,247,335,582,509
0131-002,2012,11,23,15,325,377,702,582
0131-002,2012,11,23,16,347,407,754,702
0131-002,2012,11,23,17,313,426,739,754
0131-002,2012,11,23,18,337,548,885,739
0131-002,2012,11,23,19,370,550,920,885
0131-002,2012,11,23,20,271,461,732,920
0131-002,2012,11,23,21,189,381,570,732
0131-002,2012,11,23,22,143,254,397,570
0131-002,2012,11,23,23,95,148,243,397
0131-002,2012,11,23,24,51,99,150,243
0131-002,2012,11,24,1,35,33,68,150
0131-002,2012,11,24,2,17,35,52,68
0131-002,2012,11,24,3,10,20,30,52
0131-002,2012,11,24,4,10,10,20,30
0131-002,2012,11,24,5,11,24,35,20
0131-002,2012,11,24,6,28,26,54,35
0131-002,2012,11,24,7,76,92,168,54
0131-002,2012,11,24,8,274,185,459,168
0131-002,2012,11,24,9,297,367,664,459
0131-002,2012,11,24,10,244,439,683,664
0131-002,2012,11,24,11,300,577,877,683
0131-002,2012,11,24,12,281,657,938,877
0131-002,2012,11,24,13,315,722,1037,938
0131-002,2012,11,24,14,421,678,1099,1037
0131-002,2012,11,24,15,376,661,1037,1099
0131-002,2012,11,24,16,372,706,1078,1037
0131-002,2012,11,24,17,413,716,1129,1078
0131-002,2012,11,24,18,465,786,1251,1129
0131-002,2012,11,24,19,422,557,979,1251
0131-002,2012,11,24,20,359,443,802,979
0131-002,2012,11,24,21,234,297,531,802
0131-002,2012,11,24,22,195,229,424,531
0131-002,2012,11,24,23,61,84,145,424
0131-002,2012,11,24,24,51,56,107,145
0131-002,2012,11,25,1,31,40,71,107
0131-002,2012,11,25,2,21,23,44,71
0131-002,2012,11,25,3,13,20,33,44
0131-002,2012,11,25,4,7,13,20,33
0131-002,2012,11,25,5,3,15,18,20
0131-002,2012,11,25,6,12,16,28,18
0131-002,2012,11,25,7,47,45,92,28
0131-002,2012,11,25,8,85,70,155,92
0131-002,2012,11,25,9,99,116,215,155
0131-002,2012,11,25,10,110,133,243,215
0131-002,2012,11,25,11,165,158,323,243
0131-002,2012,11,25,12,201,215,416,323
0131-002,2012,11,25,13,239,188,427,416
0131-002,2012,11,25,14,371,204,575,427
0131-002,2012,11,25,15,442,201,643,575
0131-002,2012,11,25,16,500,248,748,643
0131-002,2012,11,25,17,538,255,793,748
0131-002,2012,11,25,18,490,261,751,793
0131-002,2012,11,25,19,434,179,613,751
0131-002,2012,11,25,20,518,137,655,613
0131-002,2012,11,25,21,500,138,638,655
0131-002,2012,11,25,22,528,113,641,638
0131-002,2012,11,25,23,467,60,527,641
0131-002,2012,11,25,24,406,45,451,527
0131-002,2012,11,26,1,168,24,192,451
0131-002,2012,11,26,2,36,12,48,192
0131-002,2012,11,26,3,2,16,18,48
0131-002,2012,11,26,4,6,4,10,18
0131-002,2012,11,26,5,10,13,23,10
0131-002,2012,11,26,6,29,32,61,23
0131-002,2012,11,26,7,196,97,293,61
0131-002,2012,11,26,8,669,350,1019,293
0131-002,2012,11,26,9,599,478,1077,1019
0131-002,2012,11,26,10,281,328,609,1077
0131-002,2012,11,26,11,288,305,593,609
0131-002,2012,11,26,12,301,319,620,593
0131-002,2012,11,26,13,228,308,536,620
0131-002,2012,11,26,14,284,333,617,536
0131-002,2012,11,26,15,317,334,651,617
0131-002,2012,11,26,16,281,330,611,651
0131-002,2012,11,26,17,298,382,680,611
0131-002,2012,11,26,18,321,423,744,680
0131-002,2012,11,26,19,255,416,671,744
0131-002,2012,11,26,20,183,292,475,671
0131-002,2012,11,26,21,134,283,417,475
0131-002,2012,11,26,22,115,191,306,417
0131-002,2012,11,26,23,72,94,166,306
0131-002,2012,11,26,24,42,38,80,166
0131-002,2012,11,27,1,42,18,60,80
0131-002,2012,11,27,2,15,14,29,60
0131-002,2012,11,27,3,3,10,13,29
0131-002,2012,11,27,4,7,6,13,13
0131-002,2012,11,27,5,2,11,13,13
0131-002,2012,11,27,6,21,29,50,13
0131-002,2012,11,27,7,152,73,225,50
0131-002,2012,11,27,8,639,345,984,225
0131-002,2012,11,27,9,569,476,1045,984
0131-002,2012,11,27,10,283,305,588,1045
0131-002,2012,11,27,11,340,346,686,588
0131-002,2012,11,27,12,259,340,599,686
0131-002,2012,11,27,13,212,287,499,599
0131-002,2012,11,27,14,251,305,556,499
0131-002,2012,11,27,15,282,396,678,556
0131-002,2012,11,27,16,271,361,632,678
0131-002,2012,11,27,17,299,378,677,632
0131-002,2012,11,27,18,328,462,790,677
0131-002,2012,11,27,19,276,450,726,790
0131-002,2012,11,27,20,167,307,474,726
0131-002,2012,11,27,21,158,256,414,474
0131-002,2012,11,27,22,146,196,342,414
0131-002,2012,11,27,23,93,85,178,342
0131-002,2012,11,27,24,45,59,104,178
0131-002,2012,11,28,1,27,36,63,104
0131-002,2012,11,28,2,10,19,29,63
0131-002,2012,11,28,3,6,14,20,29
0131-002,2012,11,28,4,3,19,22,20
0131-002,2012,11,28,5,3,8,11,22
0131-002,2012,11,28,6,33,22,55,11
0131-002,2012,11,28,7,163,64,227,55
0131-002,2012,11,28,8,630,336,966,227
0131-002,2012,11,28,9,541,524,1065,966
0131-002,2012,11,28,10,302,355,657,1065
0131-002,2012,11,28,11,315,336,651,657
0131-002,2012,11,28,12,286,300,586,651
0131-002,2012,11,28,13,211,247,458,586
0131-002,2012,11,28,14,224,300,524,458
0131-002,2012,11,28,15,292,394,686,524
0131-002,2012,11,28,16,326,368,694,686
0131-002,2012,11,28,17,330,379,709,694
0131-002,2012,11,28,18,285,470,755,709
0131-002,2012,11,28,19,307,448,755,755
0131-002,2012,11,28,20,187,284,471,755
0131-002,2012,11,28,21,140,285,425,471
0131-002,2012,11,28,22,125,195,320,425
0131-002,2012,11,28,23,85,113,198,320
0131-002,2012,11,28,24,65,47,112,198
0131-002,2012,11,29,1,23,41,64,112
0131-002,2012,11,29,2,9,17,26,64
0131-002,2012,11,29,3,2,11,13,26
0131-002,2012,11,29,4,9,10,19,13
0131-002,2012,11,29,5,7,15,22,19
0131-002,2012,11,29,6,21,34,55,22
0131-002,2012,11,29,7,156,76,232,55
0131-002,2012,11,29,8,672,279,951,232
0131-002,2012,11,29,9,581,520,1101,951
0131-002,2012,11,29,10,326,455,781,1101
0131-002,2012,11,29,11,315,388,703,781
0131-002,2012,11,29,12,311,363,674,703
0131-002,2012,11,29,13,247,297,544,674
0131-002,2012,11,29,14,276,326,602,544
0131-002,2012,11,29,15,323,375,698,602
0131-002,2012,11,29,16,285,394,679,698
0131-002,2012,11,29,17,315,392,707,679
0131-002,2012,11,29,18,348,492,840,707
0131-002,2012,11,29,19,268,425,693,840
0131-002,2012,11,29,20,215,311,526,693
0131-002,2012,11,29,21,151,268,419,526
0131-002,2012,11,29,22,120,225,345,419
0131-002,2012,11,29,23,80,98,178,345
0131-002,2012,11,29,24,47,43,90,178
0131-002,2012,11,30,1,17,44,61,90
0131-002,2012,11,30,2,18,21,39,61
0131-002,2012,11,30,3,8,10,18,39
0131-002,2012,11,30,4,5,14,19,18
0131-002,2012,11,30,5,1,19,20,19
0131-002,2012,11,30,6,28,30,58,20
0131-002,2012,11,30,7,174,82,256,58
0131-002,2012,11,30,8,636,326,962,256
0131-002,2012,11,30,9,593,482,1075,962
0131-002,2012,11,30,10,307,337,644,1075
0131-002,2012,11,30,11,349,338,687,644
0131-002,2012,11,30,12,328,351,679,687
0131-002,2012,11,30,13,226,333,559,679
0131-002,2012,11,30,14,271,344,615,559
0131-002,2012,11,30,15,344,408,752,615
0131-002,2012,11,30,16,307,393,700,752
0131-002,2012,11,30,17,379,504,883,700
0131-002,2012,11,30,18,360,522,882,883
0131-002,2012,11,30,19,322,529,851,882
0131-002,2012,11,30,20,234,364,598,851
0131-002,2012,11,30,21,141,293,434,598
0131-002,2012,11,30,22,120,193,313,434
0131-002,2012,11,30,23,85,127,212,313
0131-002,2012,11,30,24,70,77,147,212
0131-002,2012,12,1,1,36,42,78,147
0131-002,2012,12,1,2,17,30,47,78
0131-002,2012,12,1,3,13,23,36,47
0131-002,2012,12,1,4,6,25,31,36
0131-002,2012,12,1,5,10,23,33,31
0131-002,2012,12,1,6,19,36,55,33
0131-002,2012,12,1,7,65,58,123,55
0131-002,2012,12,1,8,282,192,474,123
0131-002,2012,12,1,9,326,280,606,474
0131-002,2012,12,1,10,272,354,626,606
0131-002,2012,12,1,11,280,457,737,626
0131-002,2012,12,1,12,279,544,823,737
0131-002,2012,12,1,13,232,636,868,823
0131-002,2012,12,1,14,254,477,731,868
0131-002,2012,12,1,15,301,552,853,731
0131-002,2012,12,1,16,336,506,842,853
0131-002,2012,12,1,17,324,482,806,842
0131-002,2012,12,1,18,306,567,873,806
0131-002,2012,12,1,19,298,411,709,873
0131-002,2012,12,1,20,166,257,423,709
0131-002,2012,12,1,21,135,179,314,423
0131-002,2012,12,1,22,106,124,230,314
0131-002,2012,12,1,23,55,78,133,230
0131-002,2012,12,1,24,44,49,93,133
0131-002,2012,12,2,1,26,31,57,93
0131-002,2012,12,2,2,17,27,44,57
0131-002,2012,12,2,3,6,11,17,44
0131-002,2012,12,2,4,5,16,21,17
0131-002,2012,12,2,5,5,11,16,21
0131-002,2012,12,2,6,12,11,23,16
0131-002,2012,12,2,7,20,27,47,23
0131-002,2012,12,2,8,85,69,154,47
0131-002,2012,12,2,9,90,130,220,154
0131-002,2012,12,2,10,109,176,285,220
0131-002,2012,12,2,11,125,173,298,285
0131-002,2012,12,2,12,195,187,382,298
0131-002,2012,12,2,13,216,204,420,382
0131-002,2012,12,2,14,258,220,478,420
0131-002,2012,12,2,15,270,205,475,478
0131-002,2012,12,2,16,404,205,609,475
0131-002,2012,12,2,17,450,225,675,609
0131-002,2012,12,2,18,470,263,733,675
0131-002,2012,12,2,19,422,195,617,733
0131-002,2012,12,2,20,393,128,521,617
0131-002,2012,12,2,21,342,131,473,521
0131-002,2012,12,2,22,220,88,308,473
0131-002,2012,12,2,23,112,60,172,308
0131-002,2012,12,2,24,50,36,86,172
0131-002,2012,12,3,1,21,20,41,86
0131-002,2012,12,3,2,14,12,26,41
0131-002,2012,12,3,3,3,13,16,26
0131-002,2012,12,3,4,4,6,10,16
0131-002,2012,12,3,5,9,6,15,10
0131-002,2012,12,3,6,36,21,57,15
0131-002,2012,12,3,7,242,101,343,57
0131-002,2012,12,3,8,757,375,1132,343
0131-002,2012,12,3,9,640,491,1131,1132
0131-002,2012,12,3,10,276,290,566,1131
0131-002,2012,12,3,11,279,358,637,566
0131-002,2012,12,3,12,242,321,563,637
0131-002,2012,12,3,13,220,258,478,563
0131-002,2012,12,3,14,283,328,611,478
0131-002,2012,12,3,15,265,305,570,611
0131-002,2012,12,3,16,282,339,621,570
0131-002,2012,12,3,17,242,364,606,621
0131-002,2012,12,3,18,255,422,677,606
0131-002,2012,12,3,19,244,377,621,677
0131-002,2012,12,3,20,180,284,464,621
0131-002,2012,12,3,21,119,249,368,464
0131-002,2012,12,3,22,102,134,236,368
0131-002,2012,12,3,23,72,76,148,236
0131-002,2012,12,3,24,30,39,69,148
0131-002,2012,12,4,1,11,31,42,69
0131-002,2012,12,4,2,11,9,20,42
0131-002,2012,12,4,3,6,8,14,20
0131-002,2012,12,4,4,1,6,7,14
0131-002,2012,12,4,5,4,9,13,7
0131-002,2012,12,4,6,16,22,38,13
0131-002,2012,12,4,7,120,49,169,38
0131-002,2012,12,4,8,569,284,853,169
0131-002,2012,12,4,9,499,448,947,853
0131-002,2012,12,4,10,258,305,563,947
0131-002,2012,12,4,11,295,303,598,563
0131-002,2012,12,4,12,320,298,618,598
0131-002,2012,12,4,13,218,280,498,618
0131-002,2012,12,4,14,288,310,598,498
0131-002,2012,12,4,15,290,413,703,598
0131-002,2012,12,4,16,295,376,671,703
0131-002,2012,12,4,17,326,399,725,671
0131-002,2012,12,4,18,322,492,814,725
0131-002,2012,12,4,19,264,394,658,814
0131-002,2012,12,4,20,188,312,500,658
0131-002,2012,12,4,21,113,266,379,500
0131-002,2012,12,4,22,110,169,279,379
0131-002,2012,12,4,23,64,89,153,279
0131-002,2012,12,4,24,34,43,77,153
0131-002,2012,12,5,1,17,38,55,77
0131-002,2012,12,5,2,9,16,25,55
0131-002,2012,12,5,3,3,14,17,25
0131-002,2012,12,5,4,7,8,15,17
0131-002,2012,12,5,5,4,11,15,15
0131-002,2012,12,5,6,15,8,23,15
0131-002,2012,12,5,7,143,65,208,23
0131-002,2012,12,5,8,643,309,952,208
0131-002,2012,12,5,9,579,491,1070,952
0131-002,2012,12,5,10,294,331,625,1070
0131-002,2012,12,5,11,290,321,611,625
0131-002,2012,12,5,12,303,332,635,611
0131-002,2012,12,5,13,252,263,515,635
0131-002,2012,12,5,14,238,259,497,515
0131-002,2012,12,5,15,179,244,423,497
0131-002,2012,12,5,16,207,240,447,423
0131-002,2012,12,5,17,183,203,386,447
0131-002,2012,12,5,18,172,308,480,386
0131-002,2012,12,5,19,142,265,407,480
0131-002,2012,12,5,20,98,136,234,407
0131-002,2012,12,5,21,45,103,148,234
0131-002,2012,12,5,22,28,61,89,148
0131-002,2012,12,5,23,7,26,33,89
0131-002,2012,12,5,24,10,3,13,33
0131-002,2012,12,6,1,1,9,10,13
0131-002,2012,12,6,2,2,0,2,10
0131-002,2012,12,6,3,2,1,3,2
0131-002,2012,12,6,4,1,1,2,3
0131-002,2012,12,6,5,2,2,4,2
0131-002,2012,12,6,6,9,3,12,4
0131-002,2012,12,6,7,54,13,67,12
0131-002,2012,12,6,8,336,129,465,67
0131-002,2012,12,6,9,330,224,554,465
0131-002,2012,12,6,10,142,151,293,554
0131-002,2012,12,6,11,181,188,369,293
0131-002,2012,12,6,12,178,174,352,369
0131-002,2012,12,6,13,117,180,297,352
0131-002,2012,12,6,14,158,213,371,297
0131-002,2012,12,6,15,240,227,467,371
0131-002,2012,12,6,16,214,272,486,467
0131-002,2012,12,6,17,201,258,459,486
0131-002,2012,12,6,18,178,311,489,459
0131-002,2012,12,6,19,186,353,539,489
0131-002,2012,12,6,20,140,236,376,539
0131-002,2012,12,6,21,69,197,266,376
0131-002,2012,12,6,22,55,128,183,266
0131-002,2012,12,6,23,33,54,87,183
0131-002,2012,12,6,24,15,43,58,87
0131-002,2012,12,7,1,9,19,28,58
0131-002,2012,12,7,2,6,11,17,28
0131-002,2012,12,7,3,2,2,4,17
0131-002,2012,12,7,4,3,3,6,4
0131-002,2012,12,7,5,1,2,3,6
0131-002,2012,12,7,6,9,11,20,3
0131-002,2012,12,7,7,91,28,119,20
0131-002,2012,12,7,8,475,196,671,119
0131-002,2012,12,7,9,365,309,674,671
0131-002,2012,12,7,10,172,240,412,674
0131-002,2012,12,7,11,186,222,408,412
0131-002,2012,12,7,12,181,208,389,408
0131-002,2012,12,7,13,143,229,372,389
0131-002,2012,12,7,14,143,204,347,372
0131-002,2012,12,7,15,181,276,457,347
0131-002,2012,12,7,16,204,278,482,457
0131-002,2012,12,7,17,191,298,489,482
0131-002,2012,12,7,18,193,394,587,489
0131-002,2012,12,7,19,177,315,492,587
0131-002,2012,12,7,20,127,211,338,492
0131-002,2012,12,7,21,73,198,271,338
0131-002,2012,12,7,22,58,106,164,271
0131-002,2012,12,7,23,29,57,86,164
0131-002,2012,12,7,24,13,31,44,86
0131-002,2012,12,8,1,15,27,42,44
0131-002,2012,12,8,2,8,11,19,42
0131-002,2012,12,8,3,3,8,11,19
0131-002,2012,12,8,4,2,6,8,11
0131-002,2012,12,8,5,3,5,8,8
0131-002,2012,12,8,6,10,13,23,8
0131-002,2012,12,8,7,21,29,50,23
0131-002,2012,12,8,8,169,88,257,50
0131-002,2012,12,8,9,152,179,331,257
0131-002,2012,12,8,10,153,181,334,331
0131-002,2012,12,8,11,148,212,360,334
0131-002,2012,12,8,12,138,296,434,360
0131-002,2012,12,8,13,134,222,356,434
0131-002,2012,12,8,14,148,259,407,356
0131-002,2012,12,8,15,156,242,398,407
0131-002,2012,12,8,16,197,243,440,398
0131-002,2012,12,8,17,213,293,506,440
0131-002,2012,12,8,18,197,283,480,506
0131-002,2012,12,8,19,137,200,337,480
0131-002,2012,12,8,20,68,108,176,337
0131-002,2012,12,8,21,73,79,152,176
0131-002,2012,12,8,22,51,54,105,152
0131-002,2012,12,8,23,37,42,79,105
0131-002,2012,12,8,24,9,26,35,79
0131-002,2012,12,9,1,6,11,17,35
0131-002,2012,12,9,2,2,4,6,17
0131-002,2012,12,9,3,0,2,2,6
0131-002,2012,12,9,4,1,1,2,2
0131-002,2012,12,9,5,0,1,1,2
0131-002,2012,12,9,6,4,2,6,1
0131-002,2012,12,9,7,4,5,9,6
0131-002,2012,12,9,8,21,13,34,9
0131-002,2012,12,9,9,30,40,70,34
0131-002,2012,12,9,10,49,81,130,70
0131-002,2012,12,9,11,52,125,177,130
0131-002,2012,12,9,12,79,116,195,177
0131-002,2012,12,9,13,89,112,201,195
0131-002,2012,12,9,14,127,146,273,201
0131-002,2012,12,9,15,133,141,274,273
0131-002,2012,12,9,16,160,176,336,274
0131-002,2012,12,9,17,176,179,355,336
0131-002,2012,12,9,18,150,174,324,355
0131-002,2012,12,9,19,166,108,274,324
0131-002,2012,12,9,20,90,72,162,274
0131-002,2012,12,9,21,86,75,161,162
0131-002,2012,12,9,22,76,39,115,161
0131-002,2012,12,9,23,53,34,87,115
0131-002,2012,12,9,24,30,25,55,87
0131-002,2012,12,10,1,14,7,21,55
0131-002,2012,12,10,2,6,8,14,21
0131-002,2012,12,10,3,0,3,3,14
0131-002,2012,12,10,4,3,4,7,3
0131-002,2012,12,10,5,4,9,13,7
0131-002,2012,12,10,6,14,13,27,13
0131-002,2012,12,10,7,161,68,229,27
0131-002,2012,12,10,8,640,336,976,229
0131-002,2012,12,10,9,539,418,957,976
0131-002,2012,12,10,10,244,304,548,957
0131-002,2012,12,10,11,252,324,576,548
0131-002,2012,12,10,12,261,302,563,576
0131-002,2012,12,10,13,227,262,489,563
0131-002,2012,12,10,14,245,291,536,489
0131-002,2012,12,10,15,313,371,684,536
0131-002,2012,12,10,16,307,322,629,684
0131-002,2012,12,10,17,271,381,652,629
0131-002,2012,12,10,18,275,466,741,652
0131-002,2012,12,10,19,246,425,671,741
0131-002,2012,12,10,20,184,299,483,671
0131-002,2012,12,10,21,123,256,379,483
0131-002,2012,12,10,22,87,158,245,379
0131-002,2012,12,10,23,67,84,151,245
0131-002,2012,12,10,24,25,35,60,151
0131-002,2012,12,11,1,19,21,40,60
0131-002,2012,12,11,2,8,11,19,40
0131-002,2012,12,11,3,5,16,21,19
0131-002,2012,12,11,4,5,10,15,21
0131-002,2012,12,11,5,8,13,21,15
0131-002,2012,12,11,6,15,21,36,21
0131-002,2012,12,11,7,107,57,164,36
0131-002,2012,12,11,8,593,295,888,164
0131-002,2012,12,11,9,543,448,991,888
0131-002,2012,12,11,10,280,322,602,991
0131-002,2012,12,11,11,255,303,558,602
0131-002,2012,12,11,12,252,315,567,558
0131-002,2012,12,11,13,212,287,499,567
0131-002,2012,12,11,14,244,302,546,499
0131-002,2012,12,11,15,302,351,653,546
0131-002,2012,12,11,16,297,379,676,653
0131-002,2012,12,11,17,289,387,676,676
0131-002,2012,12,11,18,270,484,754,676
0131-002,2012,12,11,19,251,435,686,754
0131-002,2012,12,11,20,176,266,442,686
0131-002,2012,12,11,21,119,236,355,442
0131-002,2012,12,11,22,105,176,281,355
0131-002,2012,12,11,23,53,106,159,281
0131-002,2012,12,11,24,27,50,77,159
0131-002,2012,12,12,1,11,31,42,77
0131-002,2012,12,12,2,10,21,31,42
0131-002,2012,12,12,3,7,9,16,31
0131-002,2012,12,12,4,2,10,12,16
0131-002,2012,12,12,5,9,8,17,12
0131-002,2012,12,12,6,12,21,33,17
0131-002,2012,12,12,7,127,52,179,33
0131-002,2012,12,12,8,598,294,892,179
0131-002,2012,12,12,9,569,486,1055,892
0131-002,2012,12,12,10,310,292,602,1055
0131-002,2012,12,12,11,278,303,581,602
0131-002,2012,12,12,12,281,328,609,581
0131-002,2012,12,12,13,211,290,501,609
0131-002,2012,12,12,14,263,319,582,501
0131-002,2012,12,12,15,297,364,661,582
0131-002,2012,12,12,16,293,354,647,661
0131-002,2012,12,12,17,282,398,680,647
0131-002,2012,12,12,18,309,560,869,680
0131-002,2012,12,12,19,263,414,677,869
0131-002,2012,12,12,20,195,302,497,677
0131-002,2012,12,12,21,129,265,394,497
0131-002,2012,12,12,22,119,182,301,394
0131-002,2012,12,12,23,66,81,147,301
0131-002,2012,12,12,24,41,41,82,147
0131-002,2012,12,13,1,23,31,54,82
0131-002,2012,12,13,2,14,15,29,54
0131-002,2012,12,13,3,5,16,21,29
0131-002,2012,12,13,4,3,10,13,21
0131-002,2012,12,13,5,6,17,23,13
0131-002,2012,12,13,6,22,22,44,23
0131-002,2012,12,13,7,137,56,193,44
0131-002,2012,12,13,8,649,299,948,193
0131-002,2012,12,13,9,591,474,1065,948
0131-002,2012,12,13,10,300,326,626,1065
0131-002,2012,12,13,11,294,336,630,626
0131-002,2012,12,13,12,275,321,596,630
0131-002,2012,12,13,13,208,268,476,596
0131-002,2012,12,13,14,282,328,610,476
0131-002,2012,12,13,15,303,350,653,610
0131-002,2012,12,13,16,306,356,662,653
0131-002,2012,12,13,17,262,450,712,662
0131-002,2012,12,13,18,305,499,804,712
0131-002,2012,12,13,19,256,434,690,804
0131-002,2012,12,13,20,191,350,541,690
0131-002,2012,12,13,21,148,265,413,541
0131-002,2012,12,13,22,115,151,266,413
0131-002,2012,12,13,23,74,106,180,266
0131-002,2012,12,13,24,52,49,101,180
0131-002,2012,12,14,1,36,38,74,101
0131-002,2012,12,14,2,12,16,28,74
0131-002,2012,12,14,3,13,22,35,28
0131-002,2012,12,14,4,10,16,26,35
0131-002,2012,12,14,5,4,23,27,26
0131-002,2012,12,14,6,31,26,57,27
0131-002,2012,12,14,7,95,35,130,57
0131-002,2012,12,14,8,385,215,600,130
0131-002,2012,12,14,9,443,363,806,600
0131-002,2012,12,14,10,348,322,670,806
0131-002,2012,12,14,11,214,234,448,670
0131-002,2012,12,14,12,187,272,459,448
0131-002,2012,12,14,13,162,216,378,459
0131-002,2012,12,14,14,215,270,485,378
0131-002,2012,12,14,15,238,314,552,485
0131-002,2012,12,14,16,286,307,593,552
0131-002,2012,12,14,17,308,342,650,593
0131-002,2012,12,14,18,264,455,719,650
0131-002,2012,12,14,19,262,400,662,719
0131-002,2012,12,14,20,190,261,451,662
0131-002,2012,12,14,21,115,217,332,451
0131-002,2012,12,14,22,91,137,228,332
0131-002,2012,12,14,23,63,78,141,228
0131-002,2012,12,14,24,35,53,88,141
0131-002,2012,12,15,1,24,37,61,88
0131-002,2012,12,15,2,16,19,35,61
0131-002,2012,12,15,3,9,18,27,35
0131-002,2012,12,15,4,5,13,18,27
0131-002,2012,12,15,5,7,20,27,18
0131-002,2012,12,15,6,11,22,33,27
0131-002,2012,12,15,7,61,37,98,33
0131-002,2012,12,15,8,214,121,335,98
0131-002,2012,12,15,9,213,235,448,335
0131-002,2012,12,15,10,217,266,483,448
0131-002,2012,12,15,11,236,371,607,483
0131-002,2012,12,15,12,278,464,742,607
0131-002,2012,12,15,13,223,463,686,742
0131-002,2012,12,15,14,244,447,691,686
0131-002,2012,12,15,15,218,483,701,691
0131-002,2012,12,15,16,362,476,838,701
0131-002,2012,12,15,17,366,489,855,838
0131-002,2012,12,15,18,314,508,822,855
0131-002,2012,12,15,19,267,336,603,822
0131-002,2012,12,15,20,140,203,343,603
0131-002,2012,12,15,21,104,133,237,343
0131-002,2012,12,15,22,75,90,165,237
0131-002,2012,12,15,23,54,86,140,165
0131-002,2012,12,15,24,28,43,71,140
0131-002,2012,12,16,1,27,29,56,71
0131-002,2012,12,16,2,12,16,28,56
0131-002,2012,12,16,3,4,18,22,28
0131-002,2012,12,16,4,9,6,15,22
0131-002,2012,12,16,5,6,11,17,15
0131-002,2012,12,16,6,10,7,17,17
0131-002,2012,12,16,7,21,16,37,17
0131-002,2012,12,16,8,45,55,100,37
0131-002,2012,12,16,9,56,92,148,100
0131-002,2012,12,16,10,72,94,166,148
0131-002,2012,12,16,11,85,172,257,166
0131-002,2012,12,16,12,104,151,255,257
0131-002,2012,12,16,13,139,172,311,255
0131-002,2012,12,16,14,189,145,334,311
0131-002,2012,12,16,15,176,176,352,334
0131-002,2012,12,16,16,239,200,439,352
0131-002,2012,12,16,17,239,199,438,439
0131-002,2012,12,16,18,243,231,474,438
0131-002,2012,12,16,19,219,163,382,474
0131-002,2012,12,16,20,152,101,253,382
0131-002,2012,12,16,21,113,107,220,253
0131-002,2012,12,16,22,88,67,155,220
0131-002,2012,12,16,23,57,57,114,155
0131-002,2012,12,16,24,20,24,44,114
0131-002,2012,12,17,1,12,24,36,44
0131-002,2012,12,17,2,7,14,21,36
0131-002,2012,12,17,3,2,7,9,21
0131-002,2012,12,17,4,1,3,4,9
0131-002,2012,12,17,5,7,9,16,4
0131-002,2012,12,17,6,27,20,47,16
0131-002,2012,12,17,7,174,64,238,47
0131-002,2012,12,17,8,642,300,942,238
0131-002,2012,12,17,9,596,449,1045,942
0131-002,2012,12,17,10,255,277,532,1045
0131-002,2012,12,17,11,262,262,524,532
0131-002,2012,12,17,12,258,281,539,524
0131-002,2012,12,17,13,218,283,501,539
0131-002,2012,12,17,14,273,318,591,501
0131-002,2012,12,17,15,286,361,647,591
0131-002,2012,12,17,16,313,388,701,647
0131-002,2012,12,17,17,302,400,702,701
0131-002,2012,12,17,18,312,487,799,702
0131-002,2012,12,17,19,268,439,707,799
0131-002,2012,12,17,20,169,300,469,707
0131-002,2012,12,17,21,148,286,434,469
0131-002,2012,12,17,22,121,173,294,434
0131-002,2012,12,17,23,62,87,149,294
0131-002,2012,12,17,24,31,60,91,149
0131-002,2012,12,18,1,20,29,49,91
0131-002,2012,12,18,2,12,15,27,49
0131-002,2012,12,18,3,6,12,18,27
0131-002,2012,12,18,4,2,11,13,18
0131-002,2012,12,18,5,12,20,32,13
0131-002,2012,12,18,6,23,21,44,32
0131-002,2012,12,18,7,148,71,219,44
0131-002,2012,12,18,8,660,321,981,219
0131-002,2012,12,18,9,577,503,1080,981
0131-002,2012,12,18,10,332,380,712,1080
0131-002,2012,12,18,11,321,357,678,712
0131-002,2012,12,18,12,275,367,642,678
0131-002,2012,12,18,13,226,282,508,642
0131-002,2012,12,18,14,267,308,575,508
0131-002,2012,12,18,15,308,394,702,575
0131-002,2012,12,18,16,333,347,680,702
0131-002,2012,12,18,17,328,403,731,680
0131-002,2012,12,18,18,341,528,869,731
0131-002,2012,12,18,19,280,506,786,869
0131-002,2012,12,18,20,239,314,553,786
0131-002,2012,12,18,21,162,282,444,553
0131-002,2012,12,18,22,127,214,341,444
0131-002,2012,12,18,23,105,116,221,341
0131-002,2012,12,18,24,52,57,109,221
0131-002,2012,12,19,1,25,41,66,109
0131-002,2012,12,19,2,14,27,41,66
0131-002,2012,12,19,3,16,23,39,41
0131-002,2012,12,19,4,10,19,29,39
0131-002,2012,12,19,5,7,16,23,29
0131-002,2012,12,19,6,21,22,43,23
0131-002,2012,12,19,7,68,43,111,43
0131-002,2012,12,19,8,216,120,336,111
0131-002,2012,12,19,9,279,219,498,336
0131-002,2012,12,19,10,294,288,582,498
0131-002,2012,12,19,11,260,248,508,582
0131-002,2012,12,19,12,241,289,530,508
0131-002,2012,12,19,13,227,286,513,530
0131-002,2012,12,19,14,220,275,495,513
0131-002,2012,12,19,15,260,316,576,495
0131-002,2012,12,19,16,287,299,586,576
0131-002,2012,12,19,17,269,317,586,586
0131-002,2012,12,19,18,203,350,553,586
0131-002,2012,12,19,19,164,253,417,553
0131-002,2012,12,19,20,118,160,278,417
0131-002,2012,12,19,21,88,139,227,278
0131-002,2012,12,19,22,79,95,174,227
0131-002,2012,12,19,23,45,57,102,174
0131-002,2012,12,19,24,36,26,62,102
0131-002,2012,12,20,1,21,24,45,62
0131-002,2012,12,20,2,13,11,24,45
0131-002,2012,12,20,3,4,14,18,24
0131-002,2012,12,20,4,2,11,13,18
0131-002,2012,12,20,5,9,10,19,13
0131-002,2012,12,20,6,29,32,61,19
0131-002,2012,12,20,7,181,60,241,61
0131-002,2012,12,20,8,656,336,992,241
0131-002,2012,12,20,9,600,472,1072,992
0131-002,2012,12,20,10,276,336,612,1072
0131-002,2012,12,20,11,308,316,624,612
0131-002,2012,12,20,12,272,329,601,624
0131-002,2012,12,20,13,218,325,543,601
0131-002,2012,12,20,14,278,308,586,543
0131-002,2012,12,20,15,366,382,748,586
0131-002,2012,12,20,16,319,410,729,748
0131-002,2012,12,20,17,314,407,721,729
0131-002,2012,12,20,18,339,529,868,721
0131-002,2012,12,20,19,257,437,694,868
0131-002,2012,12,20,20,189,293,482,694
0131-002,2012,12,20,21,151,246,397,482
0131-002,2012,12,20,22,140,166,306,397
0131-002,2012,12,20,23,81,104,185,306
0131-002,2012,12,20,24,51,51,102,185
0131-002,2012,12,21,1,35,31,66,102
0131-002,2012,12,21,2,4,16,20,66
0131-002,2012,12,21,3,10,16,26,20
0131-002,2012,12,21,4,9,9,18,26
0131-002,2012,12,21,5,13,23,36,18
0131-002,2012,12,21,6,30,23,53,36
0131-002,2012,12,21,7,142,44,186,53
0131-002,2012,12,21,8,609,300,909,186
0131-002,2012,12,21,9,556,478,1034,909
0131-002,2012,12,21,10,300,374,674,1034
0131-002,2012,12,21,11,267,323,590,674
0131-002,2012,12,21,12,233,234,467,590
0131-002,2012,12,21,13,181,233,414,467
0131-002,2012,12,21,14,226,223,449,414
0131-002,2012,12,21,15,261,307,568,449
0131-002,2012,12,21,16,258,335,593,568
0131-002,2012,12,21,17,266,357,623,593
0131-002,2012,12,21,18,309,502,811,623
0131-002,2012,12,21,19,257,454,711,811
0131-002,2012,12,21,20,181,308,489,711
0131-002,2012,12,21,21,121,277,398,489
0131-002,2012,12,21,22,105,171,276,398
0131-002,2012,12,21,23,83,104,187,276
0131-002,2012,12,21,24,50,42,92,187
0131-002,2012,12,22,1,32,39,71,92
0131-002,2012,12,22,2,19,24,43,71
0131-002,2012,12,22,3,7,13,20,43
0131-002,2012,12,22,4,8,14,22,20
0131-002,2012,12,22,5,5,21,26,22
0131-002,2012,12,22,6,13,16,29,26
0131-002,2012,12,22,7,60,43,103,29
0131-002,2012,12,22,8,228,111,339,103
0131-002,2012,12,22,9,220,231,451,339
0131-002,2012,12,22,10,241,261,502,451
0131-002,2012,12,22,11,215,309,524,502
0131-002,2012,12,22,12,209,354,563,524
0131-002,2012,12,22,13,208,420,628,563
0131-002,2012,12,22,14,243,364,607,628
0131-002,2012,12,22,15,215,400,615,607
0131-002,2012,12,22,16,263,438,701,615
0131-002,2012,12,22,17,264,435,699,701
0131-002,2012,12,22,18,298,543,841,699
0131-002,2012,12,22,19,224,314,538,841
0131-002,2012,12,22,20,139,191,330,538
0131-002,2012,12,22,21,98,108,206,330
0131-002,2012,12,22,22,77,95,172,206
0131-002,2012,12,22,23,53,59,112,172
0131-002,2012,12,22,24,31,43,74,112
0131-002,2012,12,23,1,29,28,57,74
0131-002,2012,12,23,2,10,26,36,57
0131-002,2012,12,23,3,5,17,22,36
0131-002,2012,12,23,4,3,11,14,22
0131-002,2012,12,23,5,1,13,14,14
0131-002,2012,12,23,6,5,15,20,14
0131-002,2012,12,23,7,2,9,11,20
0131-002,2012,12,23,8,21,30,51,11
0131-002,2012,12,23,9,25,86,111,51
0131-002,2012,12,23,10,53,102,155,111
0131-002,2012,12,23,11,54,145,199,155
0131-002,2012,12,23,12,80,148,228,199
0131-002,2012,12,23,13,81,166,247,228
0131-002,2012,12,23,14,130,142,272,247
0131-002,2012,12,23,15,151,166,317,272
0131-002,2012,12,23,16,180,156,336,317
0131-002,2012,12,23,17,211,177,388,336
0131-002,2012,12,23,18,182,190,372,388
0131-002,2012,12,23,19,166,132,298,372
0131-002,2012,12,23,20,102,99,201,298
0131-002,2012,12,23,21,78,102,180,201
0131-002,2012,12,23,22,76,62,138,180
0131-002,2012,12,23,23,40,39,79,138
0131-002,2012,12,23,24,23,29,52,79
0131-002,2012,12,24,1,11,25,36,52
0131-002,2012,12,24,2,3,9,12,36
0131-002,2012,12,24,3,2,9,11,12
0131-002,2012,12,24,4,2,7,9,11
0131-002,2012,12,24,5,5,11,16,9
0131-002,2012,12,24,6,13,20,33,16
0131-002,2012,12,24,7,102,67,169,33
0131-002,2012,12,24,8,538,261,799,169
0131-002,2012,12,24,9,395,383,778,799
0131-002,2012,12,24,10,233,274,507,778
0131-002,2012,12,24,11,296,325,621,507
0131-002,2012,12,24,12,234,338,572,621
0131-002,2012,12,24,13,203,271,474,572
0131-002,2012,12,24,14,249,282,531,474
0131-002,2012,12,24,15,295,364,659,531
0131-002,2012,12,24,16,325,360,685,659
0131-002,2012,12,24,17,287,391,678,685
0131-002,2012,12,24,18,296,503,799,678
0131-002,2012,12,24,19,292,467,759,799
0131-002,2012,12,24,20,196,331,527,759
0131-002,2012,12,24,21,159,211,370,527
0131-002,2012,12,24,22,117,150,267,370
0131-002,2012,12,24,23,59,97,156,267
0131-002,2012,12,24,24,38,44,82,156
0131-002,2012,12,25,1,19,20,39,82
0131-002,2012,12,25,2,11,24,35,39
0131-002,2012,12,25,3,2,2,4,35
0131-002,2012,12,25,4,2,6,8,4
0131-002,2012,12,25,5,6,9,15,8
0131-002,2012,12,25,6,8,5,13,15
0131-002,2012,12,25,7,32,31,63,13
0131-002,2012,12,25,8,112,57,169,63
0131-002,2012,12,25,9,118,175,293,169
0131-002,2012,12,25,10,116,158,274,293
0131-002,2012,12,25,11,93,112,205,274
0131-002,2012,12,25,12,94,130,224,205
0131-002,2012,12,25,13,79,126,205,224
0131-002,2012,12,25,14,132,157,289,205
0131-002,2012,12,25,15,93,173,266,289
0131-002,2012,12,25,16,123,208,331,266
0131-002,2012,12,25,17,128,207,335,331
0131-002,2012,12,25,18,158,229,387,335
0131-002,2012,12,25,19,97,129,226,387
0131-002,2012,12,25,20,84,107,191,226
0131-002,2012,12,25,21,65,79,144,191
0131-002,2012,12,25,22,67,52,119,144
0131-002,2012,12,25,23,37,42,79,119
0131-002,2012,12,25,24,25,29,54,79
0131-002,2012,12,26,1,9,17,26,54
0131-002,2012,12,26,2,8,11,19,26
0131-002,2012,12,26,3,4,4,8,19
0131-002,2012,12,26,4,3,13,16,8
0131-002,2012,12,26,5,3,7,10,16
0131-002,2012,12,26,6,13,12,25,10
0131-002,2012,12,26,7,142,53,195,25
0131-002,2012,12,26,8,625,299,924,195
0131-002,2012,12,26,9,552,393,945,924
0131-002,2012,12,26,10,269,286,555,945
0131-002,2012,12,26,11,237,303,540,555
0131-002,2012,12,26,12,271,291,562,540
0131-002,2012,12,26,13,252,298,550,562
0131-002,2012,12,26,14,268,294,562,550
0131-002,2012,12,26,15,295,368,663,562
0131-002,2012,12,26,16,238,381,619,663
0131-002,2012,12,26,17,268,365,633,619
0131-002,2012,12,26,18,292,510,802,633
0131-002,2012,12,26,19,267,460,727,802
0131-002,2012,12,26,20,163,301,464,727
0131-002,2012,12,26,21,144,236,380,464
0131-002,2012,12,26,22,135,186,321,380
0131-002,2012,12,26,23,52,89,141,321
0131-002,2012,12,26,24,40,50,90,141
0131-002,2012,12,27,1,18,32,50,90
0131-002,2012,12,27,2,7,8,15,50
0131-002,2012,12,27,3,10,8,18,15
0131-002,2012,12,27,4,3,13,16,18
0131-002,2012,12,27,5,4,19,23,16
0131-002,2012,12,27,6,13,15,28,23
0131-002,2012,12,27,7,104,43,147,28
0131-002,2012,12,27,8,581,262,843,147
0131-002,2012,12,27,9,531,441,972,843
0131-002,2012,12,27,10,270,367,637,972
0131-002,2012,12,27,11,307,346,653,637
0131-002,2012,12,27,12,308,364,672,653
0131-002,2012,12,27,13,260,307,567,672
0131-002,2012,12,27,14,265,315,580,567
0131-002,2012,12,27,15,315,391,706,580
0131-002,2012,12,27,16,321,381,702,706
0131-002,2012,12,27,17,294,421,715,702
0131-002,2012,12,27,18,257,525,782,715
0131-002,2012,12,27,19,277,443,720,782
0131-002,2012,12,27,20,189,309,498,720
0131-002,2012,12,27,21,126,273,399,498
0131-002,2012,12,27,22,131,180,311,399
0131-002,2012,12,27,23,82,94,176,311
0131-002,2012,12,27,24,49,50,99,176
0131-002,2012,12,28,1,20,39,59,99
0131-002,2012,12,28,2,16,22,38,59
0131-002,2012,12,28,3,6,15,21,38
0131-002,2012,12,28,4,6,16,22,21
0131-002,2012,12,28,5,6,16,22,22
0131-002,2012,12,28,6,19,35,54,22
0131-002,2012,12,28,7,102,35,137,54
0131-002,2012,12,28,8,510,244,754,137
0131-002,2012,12,28,9,440,437,877,754
0131-002,2012,12,28,10,244,246,490,877
0131-002,2012,12,28,11,260,264,524,490
0131-002,2012,12,28,12,224,304,528,524
0131-002,2012,12,28,13,185,272,457,528
0131-002,2012,12,28,14,243,289,532,457
0131-002,2012,12,28,15,277,317,594,532
0131-002,2012,12,28,16,275,321,596,594
0131-002,2012,12,28,17,293,365,658,596
0131-002,2012,12,28,18,279,531,810,658
0131-002,2012,12,28,19,290,443,733,810
0131-002,2012,12,28,20,178,246,424,733
0131-002,2012,12,28,21,121,209,330,424
0131-002,2012,12,28,22,106,169,275,330
0131-002,2012,12,28,23,68,104,172,275
0131-002,2012,12,28,24,36,59,95,172
0131-002,2012,12,29,1,36,48,84,95
0131-002,2012,12,29,2,18,29,47,84
0131-002,2012,12,29,3,13,12,25,47
0131-002,2012,12,29,4,4,22,26,25
0131-002,2012,12,29,5,8,18,26,26
0131-002,2012,12,29,6,14,29,43,26
0131-002,2012,12,29,7,65,35,100,43
0131-002,2012,12,29,8,191,119,310,100
0131-002,2012,12,29,9,264,236,500,310
0131-002,2012,12,29,10,216,252,468,500
0131-002,2012,12,29,11,251,291,542,468
0131-002,2012,12,29,12,223,325,548,542
0131-002,2012,12,29,13,198,375,573,548
0131-002,2012,12,29,14,228,364,592,573
0131-002,2012,12,29,15,226,423,649,592
0131-002,2012,12,29,16,272,425,697,649
0131-002,2012,12,29,17,278,466,744,697
0131-002,2012,12,29,18,263,445,708,744
0131-002,2012,12,29,19,201,276,477,708
0131-002,2012,12,29,20,118,141,259,477
0131-002,2012,12,29,21,47,98,145,259
0131-002,2012,12,29,22,64,62,126,145
0131-002,2012,12,29,23,30,39,69,126
0131-002,2012,12,29,24,23,17,40,69
0131-002,2012,12,30,1,5,25,30,40
0131-002,2012,12,30,2,15,15,30,30
0131-002,2012,12,30,3,6,15,21,30
0131-002,2012,12,30,4,11,11,22,21
0131-002,2012,12,30,5,4,9,13,22
0131-002,2012,12,30,6,4,4,8,13
0131-002,2012,12,30,7,7,9,16,8
0131-002,2012,12,30,8,31,48,79,16
0131-002,2012,12,30,9,39,96,135,79
0131-002,2012,12,30,10,92,129,221,135
0131-002,2012,12,30,11,149,125,274,221
0131-002,2012,12,30,12,158,86,244,274
0131-002,2012,12,30,13,115,96,211,244
0131-002,2012,12,30,14,94,128,222,211
0131-002,2012,12,30,15,87,167,254,222
0131-002,2012,12,30,16,151,177,328,254
0131-002,2012,12,30,17,122,277,399,328
0131-002,2012,12,30,18,115,313,428,399
0131-002,2012,12,30,19,98,125,223,428
0131-002,2012,12,30,20,52,73,125,223
0131-002,2012,12,30,21,30,60,90,125
0131-002,2012,12,30,22,39,41,80,90
0131-002,2012,12,30,23,15,27,42,80
0131-002,2012,12,30,24,12,13,25,42
0131-002,2012,12,31,1,13,11,24,25
0131-002,2012,12,31,2,1,9,10,24
0131-002,2012,12,31,3,2,4,6,10
0131-002,2012,12,31,4,1,2,3,6
0131-002,2012,12,31,5,2,5,7,3
0131-002,2012,12,31,6,4,11,15,7
0131-002,2012,12,31,7,44,29,73,15
0131-002,2012,12,31,8,310,154,464,73
0131-002,2012,12,31,9,251,269,520,464
0131-002,2012,12,31,10,148,194,342,520
0131-002,2012,12,31,11,185,220,405,342
0131-002,2012,12,31,12,186,263,449,405
0131-002,2012,12,31,13,158,259,417,449
0131-002,2012,12,31,14,199,285,484,417
0131-002,2012,12,31,15,201,267,468,484
0131-002,2012,12,31,16,208,296,504,468
0131-002,2012,12,31,17,237,298,535,504
0131-002,2012,12,31,18,225,397,622,535
0131-002,2012,12,31,19,200,298,498,622
0131-002,2012,12,31,20,129,209,338,498
0131-002,2012,12,31,21,100,135,235,338
0131-002,2012,12,31,22,64,92,156,235
0131-002,2012,12,31,23,53,59,112,156
0131-002,2012,12,31,24,21,38,59,112
0131-002,2013,1,1,1,20,50,70,59
0131-002,2013,1,1,2,20,50,70,70
0131-002,2013,1,1,3,20,36,56,70
0131-002,2013,1,1,4,10,20,30,56
0131-002,2013,1,1,5,8,24,32,30
0131-002,2013,1,1,6,16,24,40,32
0131-002,2013,1,1,7,26,30,56,40
0131-002,2013,1,1,8,32,34,66,56
0131-002,2013,1,1,9,26,32,58,66
0131-002,2013,1,1,10,42,20,62,58
0131-002,2013,1,1,11,62,78,140,62
0131-002,2013,1,1,12,120,234,354,140
0131-002,2013,1,1,13,204,220,424,354
0131-002,2013,1,1,14,196,180,376,424
0131-002,2013,1,1,15,242,182,424,376
0131-002,2013,1,1,16,284,244,528,424
0131-002,2013,1,1,17,278,252,530,528
0131-002,2013,1,1,18,258,192,450,530
0131-002,2013,1,1,19,216,184,400,450
0131-002,2013,1,1,20,122,120,242,400
0131-002,2013,1,1,21,114,130,244,242
0131-002,2013,1,1,22,80,88,168,244
0131-002,2013,1,1,23,44,66,110,168
0131-002,2013,1,1,24,34,38,72,110
0131-002,2013,1,2,1,18,12,30,72
0131-002,2013,1,2,2,8,18,26,30
0131-002,2013,1,2,3,0,8,8,26
0131-002,2013,1,2,4,2,2,4,8
0131-002,2013,1,2,5,2,12,14,4
0131-002,2013,1,2,6,4,36,40,14
0131-002,2013,1,2,7,56,66,122,40
0131-002,2013,1,2,8,550,312,862,122
0131-002,2013,1,2,9,652,458,1110,862
0131-002,2013,1,2,10,336,288,624,1110
0131-002,2013,1,2,11,240,306,546,624
0131-002,2013,1,2,12,246,268,514,546
0131-002,2013,1,2,13,304,366,670,514
0131-002,2013,1,2,14,300,486,786,670
0131-002,2013,1,2,15,406,576,982,786
0131-002,2013,1,2,16,428,556,984,982
0131-002,2013,1,2,17,390,534,924,984
0131-002,2013,1,2,18,402,808,1210,924
0131-002,2013,1,2,19,348,684,1032,1210
0131-002,2013,1,2,20,246,470,716,1032
0131-002,2013,1,2,21,150,328,478,716
0131-002,2013,1,2,22,116,194,310,478
0131-002,2013,1,2,23,110,150,260,310
0131-002,2013,1,2,24,32,62,94,260
0131-002,2013,1,3,1,36,36,72,94
0131-002,2013,1,3,2,12,14,26,72
0131-002,2013,1,3,3,2,18,20,26
0131-002,2013,1,3,4,8,30,38,20
0131-002,2013,1,3,5,6,22,28,38
0131-002,2013,1,3,6,22,24,46,28
0131-002,2013,1,3,7,200,90,290,46
0131-002,2013,1,3,8,1034,510,1544,290
0131-002,2013,1,3,9,896,728,1624,1544
0131-002,2013,1,3,10,514,564,1078,1624
0131-002,2013,1,3,11,494,624,1118,1078
0131-002,2013,1,3,12,452,592,1044,1118
0131-002,2013,1,3,13,422,544,966,1044
0131-002,2013,1,3,14,458,556,1014,966
0131-002,2013,1,3,15,572,750,1322,1014
0131-002,2013,1,3,16,520,606,1126,1322
0131-002,2013,1,3,17,520,712,1232,1126
0131-002,2013,1,3,18,558,792,1350,1232
0131-002,2013,1,3,19,444,858,1302,1350
0131-002,2013,1,3,20,348,584,932,1302
0131-002,2013,1,3,21,218,490,708,932
0131-002,2013,1,3,22,196,320,516,708
0131-002,2013,1,3,23,102,168,270,516
0131-002,2013,1,3,24,62,86,148,270
0131-002,2013,1,4,1,28,34,62,148
0131-002,2013,1,4,2,24,26,50,62
0131-002,2013,1,4,3,2,22,24,50
0131-002,2013,1,4,4,6,18,24,24
0131-002,2013,1,4,5,8,24,32,24
0131-002,2013,1,4,6,30,42,72,32
0131-002,2013,1,4,7,196,116,312,72
0131-002,2013,1,4,8,1094,548,1642,312
0131-002,2013,1,4,9,990,830,1820,1642
0131-002,2013,1,4,10,496,530,1026,1820
0131-002,2013,1,4,11,622,790,1412,1026
0131-002,2013,1,4,12,566,642,1208,1412
0131-002,2013,1,4,13,410,606,1016,1208
0131-002,2013,1,4,14,520,626,1146,1016
0131-002,2013,1,4,15,610,672,1282,1146
0131-002,2013,1,4,16,622,750,1372,1282
0131-002,2013,1,4,17,644,750,1394,1372
0131-002,2013,1,4,18,638,1000,1638,1394
0131-002,2013,1,4,19,616,1032,1648,1638
0131-002,2013,1,4,20,472,690,1162,1648
0131-002,2013,1,4,21,264,630,894,1162
0131-002,2013,1,4,22,228,336,564,894
0131-002,2013,1,4,23,146,220,366,564
0131-002,2013,1,4,24,78,130,208,366
0131-002,2013,1,5,1,38,72,110,208
0131-002,2013,1,5,2,22,44,66,110
0131-002,2013,1,5,3,24,30,54,66
0131-002,2013,1,5,4,12,18,30,54
0131-002,2013,1,5,5,10,44,54,30
0131-002,2013,1,5,6,44,34,78,54
0131-002,2013,1,5,7,132,82,214,78
0131-002,2013,1,5,8,510,238,748,214
0131-002,2013,1,5,9,508,390,898,748
0131-002,2013,1,5,10,400,476,876,898
0131-002,2013,1,5,11,440,542,982,876
0131-002,2013,1,5,12,440,526,966,982
0131-002,2013,1,5,13,450,698,1148,966
0131-002,2013,1,5,14,356,706,1062,1148
0131-002,2013,1,5,15,410,744,1154,1062
0131-002,2013,1,5,16,406,700,1106,1154
0131-002,2013,1,5,17,474,746,1220,1106
0131-002,2013,1,5,18,486,888,1374,1220
0131-002,2013,1,5,19,384,614,998,1374
0131-002,2013,1,5,20,284,346,630,998
0131-002,2013,1,5,21,190,240,430,630
0131-002,2013,1,5,22,116,140,256,430
0131-002,2013,1,5,23,82,102,184,256
0131-002,2013,1,5,24,58,104,162,184
0131-002,2013,1,6,1,36,34,70,162
0131-002,2013,1,6,2,14,32,46,70
0131-002,2013,1,6,3,16,20,36,46
0131-002,2013,1,6,4,18,20,38,36
0131-002,2013,1,6,5,20,18,38,38
0131-002,2013,1,6,6,18,20,38,38
0131-002,2013,1,6,7,34,40,74,38
0131-002,2013,1,6,8,90,82,172,74
0131-002,2013,1,6,9,108,164,272,172
0131-002,2013,1,6,10,130,184,314,272
0131-002,2013,1,6,11,162,220,382,314
0131-002,2013,1,6,12,198,314,512,382
0131-002,2013,1,6,13,228,288,516,512
0131-002,2013,1,6,14,250,374,624,516
0131-002,2013,1,6,15,310,368,678,624
0131-002,2013,1,6,16,362,372,734,678
0131-002,2013,1,6,17,372,384,756,734
0131-002,2013,1,6,18,436,392,828,756
0131-002,2013,1,6,19,352,276,628,828
0131-002,2013,1,6,20,212,194,406,628
0131-002,2013,1,6,21,146,142,288,406
0131-002,2013,1,6,22,150,114,264,288
0131-002,2013,1,6,23,82,62,144,264
0131-002,2013,1,6,24,50,46,96,144
0131-002,2013,1,7,1,32,40,72,96
0131-002,2013,1,7,2,2,22,24,72
0131-002,2013,1,7,3,0,10,10,24
0131-002,2013,1,7,4,4,10,14,10
0131-002,2013,1,7,5,10,20,30,14
0131-002,2013,1,7,6,44,40,84,30
0131-002,2013,1,7,7,350,142,492,84
0131-002,2013,1,7,8,1366,648,2014,492
0131-002,2013,1,7,9,1148,880,2028,2014
0131-002,2013,1,7,10,566,610,1176,2028
0131-002,2013,1,7,11,576,626,1202,1176
0131-002,2013,1,7,12,542,650,1192,1202
0131-002,2013,1,7,13,462,570,1032,1192
0131-002,2013,1,7,14,580,604,1184,1032
0131-002,2013,1,7,15,556,746,1302,1184
0131-002,2013,1,7,16,628,758,1386,1302
0131-002,2013,1,7,17,596,744,1340,1386
0131-002,2013,1,7,18,588,830,1418,1340
0131-002,2013,1,7,19,484,802,1286,1418
0131-002,2013,1,7,20,336,534,870,1286
0131-002,2013,1,7,21,246,570,816,870
0131-002,2013,1,7,22,172,374,546,816
0131-002,2013,1,7,23,116,172,288,546
0131-002,2013,1,7,24,84,98,182,288
0131-002,2013,1,8,1,34,80,114,182
0131-002,2013,1,8,2,24,28,52,114
0131-002,2013,1,8,3,8,16,24,52
0131-002,2013,1,8,4,10,24,34,24
0131-002,2013,1,8,5,12,42,54,34
0131-002,2013,1,8,6,38,22,60,54
0131-002,2013,1,8,7,268,132,400,60
0131-002,2013,1,8,8,1194,536,1730,400
0131-002,2013,1,8,9,1058,916,1974,1730
0131-002,2013,1,8,10,524,620,1144,1974
0131-002,2013,1,8,11,562,636,1198,1144
0131-002,2013,1,8,12,570,606,1176,1198
0131-002,2013,1,8,13,520,550,1070,1176
0131-002,2013,1,8,14,494,602,1096,1070
0131-002,2013,1,8,15,622,778,1400,1096
0131-002,2013,1,8,16,540,670,1210,1400
0131-002,2013,1,8,17,526,818,1344,1210
0131-002,2013,1,8,18,552,986,1538,1344
0131-002,2013,1,8,19,492,848,1340,1538
0131-002,2013,1,8,20,346,598,944,1340
0131-002,2013,1,8,21,298,534,832,944
0131-002,2013,1,8,22,212,364,576,832
0131-002,2013,1,8,23,114,150,264,576
0131-002,2013,1,8,24,64,128,192,264
0131-002,2013,1,9,1,32,46,78,192
0131-002,2013,1,9,2,16,40,56,78
0131-002,2013,1,9,3,10,28,38,56
0131-002,2013,1,9,4,10,18,28,38
0131-002,2013,1,9,5,4,16,20,28
0131-002,2013,1,9,6,28,46,74,20
0131-002,2013,1,9,7,270,128,398,74
0131-002,2013,1,9,8,1152,608,1760,398
0131-002,2013,1,9,9,1094,864,1958,1760
0131-002,2013,1,9,10,534,618,1152,1958
0131-002,2013,1,9,11,596,656,1252,1152
0131-002,2013,1,9,12,558,600,1158,1252
0131-002,2013,1,9,13,424,518,942,1158
0131-002,2013,1,9,14,476,646,1122,942
0131-002,2013,1,9,15,622,688,1310,1122
0131-002,2013,1,9,16,582,790,1372,1310
0131-002,2013,1,9,17,510,770,1280,1372
0131-002,2013,1,9,18,604,996,1600,1280
0131-002,2013,1,9,19,556,944,1500,1600
0131-002,2013,1,9,20,376,592,968,1500
0131-002,2013,1,9,21,284,456,740,968
0131-002,2013,1,9,22,256,316,572,740
0131-002,2013,1,9,23,152,162,314,572
0131-002,2013,1,9,24,74,86,160,314
0131-002,2013,1,10,1,42,78,120,160
0131-002,2013,1,10,2,20,44,64,120
0131-002,2013,1,10,3,12,28,40,64
0131-002,2013,1,10,4,4,14,18,40
0131-002,2013,1,10,5,10,26,36,18
0131-002,2013,1,10,6,38,54,92,36
0131-002,2013,1,10,7,228,104,332,92
0131-002,2013,1,10,8,1220,618,1838,332
0131-002,2013,1,10,9,1134,872,2006,1838
0131-002,2013,1,10,10,628,654,1282,2006
0131-002,2013,1,10,11,644,662,1306,1282
0131-002,2013,1,10,12,572,708,1280,1306
0131-002,2013,1,10,13,500,552,1052,1280
0131-002,2013,1,10,14,534,574,1108,1052
0131-002,2013,1,10,15,594,742,1336,1108
0131-002,2013,1,10,16,524,708,1232,1336
0131-002,2013,1,10,17,550,828,1378,1232
0131-002,2013,1,10,18,604,950,1554,1378
0131-002,2013,1,10,19,518,856,1374,1554
0131-002,2013,1,10,20,396,606,1002,1374
0131-002,2013,1,10,21,284,596,880,1002
0131-002,2013,1,10,22,234,318,552,880
0131-002,2013,1,10,23,148,168,316,552
0131-002,2013,1,10,24,92,100,192,316
0131-002,2013,1,11,1,62,52,114,192
0131-002,2013,1,11,2,30,52,82,114
0131-002,2013,1,11,3,14,22,36,82
0131-002,2013,1,11,4,8,24,32,36
0131-002,2013,1,11,5,6,30,36,32
0131-002,2013,1,11,6,40,46,86,36
0131-002,2013,1,11,7,252,104,356,86
0131-002,2013,1,11,8,1224,610,1834,356
0131-002,2013,1,11,9,1098,944,2042,1834
0131-002,2013,1,11,10,592,680,1272,2042
0131-002,2013,1,11,11,584,764,1348,1272
0131-002,2013,1,11,12,642,650,1292,1348
0131-002,2013,1,11,13,438,676,1114,1292
0131-002,2013,1,11,14,604,702,1306,1114
0131-002,2013,1,11,15,636,730,1366,1306
0131-002,2013,1,11,16,654,800,1454,1366
0131-002,2013,1,11,17,598,856,1454,1454
0131-002,2013,1,11,18,672,1106,1778,1454
0131-002,2013,1,11,19,664,1126,1790,1778
0131-002,2013,1,11,20,402,798,1200,1790
0131-002,2013,1,11,21,354,618,972,1200
0131-002,2013,1,11,22,240,426,666,972
0131-002,2013,1,11,23,142,202,344,666
0131-002,2013,1,11,24,98,112,210,344
0131-002,2013,1,12,1,62,92,154,210
0131-002,2013,1,12,2,42,54,96,154
0131-002,2013,1,12,3,18,36,54,96
0131-002,2013,1,12,4,26,30,56,54
0131-002,2013,1,12,5,8,38,46,56
0131-002,2013,1,12,6,38,32,70,46
0131-002,2013,1,12,7,128,90,218,70
0131-002,2013,1,12,8,448,264,712,218
0131-002,2013,1,12,9,582,518,1100,712
0131-002,2013,1,12,10,526,570,1096,1100
0131-002,2013,1,12,11,406,676,1082,1096
0131-002,2013,1,12,12,396,652,1048,1082
0131-002,2013,1,12,13,408,772,1180,1048
0131-002,2013,1,12,14,422,774,1196,1180
0131-002,2013,1,12,15,372,850,1222,1196
0131-002,2013,1,12,16,498,752,1250,1222
0131-002,2013,1,12,17,556,708,1264,1250
0131-002,2013,1,12,18,558,984,1542,1264
0131-002,2013,1,12,19,556,722,1278,1542
0131-002,2013,1,12,20,270,434,704,1278
0131-002,2013,1,12,21,192,228,420,704
0131-002,2013,1,12,22,178,188,366,420
0131-002,2013,1,12,23,82,108,190,366
0131-002,2013,1,12,24,94,70,164,190
0131-002,2013,1,13,1,40,54,94,164
0131-002,2013,1,13,2,26,34,60,94
0131-002,2013,1,13,3,16,28,44,60
0131-002,2013,1,13,4,14,36,50,44
0131-002,2013,1,13,5,8,20,28,50
0131-002,2013,1,13,6,24,26,50,28
0131-002,2013,1,13,7,32,48,80,50
0131-002,2013,1,13,8,92,64,156,80
0131-002,2013,1,13,9,144,178,322,156
0131-002,2013,1,13,10,160,252,412,322
0131-002,2013,1,13,11,176,338,514,412
0131-002,2013,1,13,12,200,228,428,514
0131-002,2013,1,13,13,320,286,606,428
0131-002,2013,1,13,14,272,360,632,606
0131-002,2013,1,13,15,390,366,756,632
0131-002,2013,1,13,16,408,376,784,756
0131-002,2013,1,13,17,540,406,946,784
0131-002,2013,1,13,18,570,394,964,946
0131-002,2013,1,13,19,492,328,820,964
0131-002,2013,1,13,20,322,240,562,820
0131-002,2013,1,13,21,270,146,416,562
0131-002,2013,1,13,22,194,164,358,416
0131-002,2013,1,13,23,72,106,178,358
0131-002,2013,1,13,24,78,58,136,178
0131-002,2013,1,14,1,56,44,100,136
0131-002,2013,1,14,2,14,12,26,100
0131-002,2013,1,14,3,4,22,26,26
0131-002,2013,1,14,4,10,6,16,26
0131-002,2013,1,14,5,16,30,46,16
0131-002,2013,1,14,6,68,60,128,46
0131-002,2013,1,14,7,392,142,534,128
0131-002,2013,1,14,8,1384,598,1982,534
0131-002,2013,1,14,9,1264,882,2146,1982
0131-002,2013,1,14,10,544,616,1160,2146
0131-002,2013,1,14,11,582,614,1196,1160
0131-002,2013,1,14,12,580,648,1228,1196
0131-002,2013,1,14,13,464,548,1012,1228
0131-002,2013,1,14,14,552,680,1232,1012
0131-002,2013,1,14,15,668,740,1408,1232
0131-002,2013,1,14,16,638,760,1398,1408
0131-002,2013,1,14,17,582,684,1266,1398
0131-002,2013,1,14,18,572,940,1512,1266
0131-002,2013,1,14,19,540,858,1398,1512
0131-002,2013,1,14,20,344,596,940,1398
0131-002,2013,1,14,21,310,592,902,940
0131-002,2013,1,14,22,208,408,616,902
0131-002,2013,1,14,23,108,154,262,616
0131-002,2013,1,14,24,68,90,158,262
0131-002,2013,1,15,1,28,64,92,158
0131-002,2013,1,15,2,14,34,48,92
0131-002,2013,1,15,3,14,20,34,48
0131-002,2013,1,15,4,8,26,34,34
0131-002,2013,1,15,5,20,22,42,34
0131-002,2013,1,15,6,36,50,86,42
0131-002,2013,1,15,7,268,92,360,86
0131-002,2013,1,15,8,1200,590,1790,360
0131-002,2013,1,15,9,1048,944,1992,1790
0131-002,2013,1,15,10,632,640,1272,1992
0131-002,2013,1,15,11,654,628,1282,1272
0131-002,2013,1,15,12,532,636,1168,1282
0131-002,2013,1,15,13,422,584,1006,1168
0131-002,2013,1,15,14,542,690,1232,1006
0131-002,2013,1,15,15,666,816,1482,1232
0131-002,2013,1,15,16,660,752,1412,1482
0131-002,2013,1,15,17,614,782,1396,1412
0131-002,2013,1,15,18,600,896,1496,1396
0131-002,2013,1,15,19,608,892,1500,1496
0131-002,2013,1,15,20,368,640,1008,1500
0131-002,2013,1,15,21,320,560,880,1008
0131-002,2013,1,15,22,208,376,584,880
0131-002,2013,1,15,23,120,142,262,584
0131-002,2013,1,15,24,78,110,188,262
0131-002,2013,1,16,1,36,52,88,188
0131-002,2013,1,16,2,34,32,66,88
0131-002,2013,1,16,3,18,24,42,66
0131-002,2013,1,16,4,10,12,22,42
0131-002,2013,1,16,5,18,34,52,22
0131-002,2013,1,16,6,36,54,90,52
0131-002,2013,1,16,7,300,110,410,90
0131-002,2013,1,16,8,1182,600,1782,410
0131-002,2013,1,16,9,1120,932,2052,1782
0131-002,2013,1,16,10,672,742,1414,2052
0131-002,2013,1,16,11,668,714,1382,1414
0131-002,2013,1,16,12,610,656,1266,1382
0131-002,2013,1,16,13,410,512,922,1266
0131-002,2013,1,16,14,444,508,952,922
0131-002,2013,1,16,15,542,670,1212,952
0131-002,2013,1,16,16,560,624,1184,1212
0131-002,2013,1,16,17,528,738,1266,1184
0131-002,2013,1,16,18,524,912,1436,1266
0131-002,2013,1,16,19,546,912,1458,1436
0131-002,2013,1,16,20,338,570,908,1458
0131-002,2013,1,16,21,230,518,748,908
0131-002,2013,1,16,22,178,232,410,748
0131-002,2013,1,16,23,122,160,282,410
0131-002,2013,1,16,24,58,128,186,282
0131-002,2013,1,17,1,46,36,82,186
0131-002,2013,1,17,2,20,38,58,82
0131-002,2013,1,17,3,14,36,50,58
0131-002,2013,1,17,4,6,18,24,50
0131-002,2013,1,17,5,8,30,38,24
0131-002,2013,1,17,6,40,46,86,38
0131-002,2013,1,17,7,228,92,320,86
0131-002,2013,1,17,8,1286,584,1870,320
0131-002,2013,1,17,9,1104,890,1994,1870
0131-002,2013,1,17,10,598,612,1210,1994
0131-002,2013,1,17,11,636,664,1300,1210
0131-002,2013,1,17,12,598,644,1242,1300
0131-002,2013,1,17,13,448,598,1046,1242
0131-002,2013,1,17,14,544,636,1180,1046
0131-002,2013,1,17,15,638,722,1360,1180
0131-002,2013,1,17,16,576,694,1270,1360
0131-002,2013,1,17,17,580,748,1328,1270
0131-002,2013,1,17,18,568,910,1478,1328
0131-002,2013,1,17,19,562,914,1476,1478
0131-002,2013,1,17,20,390,636,1026,1476
0131-002,2013,1,17,21,232,574,806,1026
0131-002,2013,1,17,22,240,332,572,806
0131-002,2013,1,17,23,144,198,342,572
0131-002,2013,1,17,24,90,98,188,342
0131-002,2013,1,18,1,38,70,108,188
0131-002,2013,1,18,2,42,24,66,108
0131-002,2013,1,18,3,20,20,40,66
0131-002,2013,1,18,4,10,32,42,40
0131-002,2013,1,18,5,14,44,58,42
0131-002,2013,1,18,6,38,50,88,58
0131-002,2013,1,18,7,262,114,376,88
0131-002,2013,1,18,8,1262,538,1800,376
0131-002,2013,1,18,9,1122,886,2008,1800
0131-002,2013,1,18,10,622,656,1278,2008
0131-002,2013,1,18,11,592,728,1320,1278
0131-002,2013,1,18,12,518,656,1174,1320
0131-002,2013,1,18,13,550,600,1150,1174
0131-002,2013,1,18,14,606,634,1240,1150
0131-002,2013,1,18,15,606,692,1298,1240
0131-002,2013,1,18,16,640,826,1466,1298
0131-002,2013,1,18,17,626,772,1398,1466
0131-002,2013,1,18,18,634,1148,1782,1398
0131-002,2013,1,18,19,724,990,1714,1782
0131-002,2013,1,18,20,478,830,1308,1714
0131-002,2013,1,18,21,286,652,938,1308
0131-002,2013,1,18,22,280,376,656,938
0131-002,2013,1,18,23,164,216,380,656
0131-002,2013,1,18,24,102,100,202,380
0131-002,2013,1,19,1,44,102,146,202
0131-002,2013,1,19,2,34,44,78,146
0131-002,2013,1,19,3,20,28,48,78
0131-002,2013,1,19,4,10,36,46,48
0131-002,2013,1,19,5,24,36,60,46
0131-002,2013,1,19,6,56,28,84,60
0131-002,2013,1,19,7,126,122,248,84
0131-002,2013,1,19,8,550,310,860,248
0131-002,2013,1,19,9,634,586,1220,860
0131-002,2013,1,19,10,452,610,1062,1220
0131-002,2013,1,19,11,498,706,1204,1062
0131-002,2013,1,19,12,552,776,1328,1204
0131-002,2013,1,19,13,544,872,1416,1328
0131-002,2013,1,19,14,450,854,1304,1416
0131-002,2013,1,19,15,494,740,1234,1304
0131-002,2013,1,19,16,544,792,1336,1234
0131-002,2013,1,19,17,630,818,1448,1336
0131-002,2013,1,19,18,614,952,1566,1448
0131-002,2013,1,19,19,538,614,1152,1566
0131-002,2013,1,19,20,324,364,688,1152
0131-002,2013,1,19,21,222,312,534,688
0131-002,2013,1,19,22,162,222,384,534
0131-002,2013,1,19,23,102,136,238,384
0131-002,2013,1,19,24,86,82,168,238
0131-002,2013,1,20,1,50,58,108,168
0131-002,2013,1,20,2,18,36,54,108
0131-002,2013,1,20,3,14,34,48,54
0131-002,2013,1,20,4,8,20,28,48
0131-002,2013,1,20,5,14,18,32,28
0131-002,2013,1,20,6,28,36,64,32
0131-002,2013,1,20,7,52,52,104,64
0131-002,2013,1,20,8,160,112,272,104
0131-002,2013,1,20,9,152,196,348,272
0131-002,2013,1,20,10,152,278,430,348
0131-002,2013,1,20,11,236,320,556,430
0131-002,2013,1,20,12,258,378,636,556
0131-002,2013,1,20,13,310,396,706,636
0131-002,2013,1,20,14,388,364,752,706
0131-002,2013,1,20,15,386,448,834,752
0131-002,2013,1,20,16,444,454,898,834
0131-002,2013,1,20,17,486,488,974,898
0131-002,2013,1,20,18,548,454,1002,974
0131-002,2013,1,20,19,454,336,790,1002
0131-002,2013,1,20,20,318,234,552,790
0131-002,2013,1,20,21,244,168,412,552
0131-002,2013,1,20,22,252,154,406,412
0131-002,2013,1,20,23,154,122,276,406
0131-002,2013,1,20,24,106,76,182,276
0131-002,2013,1,21,1,44,70,114,182
0131-002,2013,1,21,2,14,22,36,114
0131-002,2013,1,21,3,12,24,36,36
0131-002,2013,1,21,4,8,12,20,36
0131-002,2013,1,21,5,24,22,46,20
0131-002,2013,1,21,6,48,54,102,46
0131-002,2013,1,21,7,328,124,452,102
0131-002,2013,1,21,8,1294,588,1882,452
0131-002,2013,1,21,9,1042,778,1820,1882
0131-002,2013,1,21,10,498,554,1052,1820
0131-002,2013,1,21,11,494,508,1002,1052
0131-002,2013,1,21,12,434,536,970,1002
0131-002,2013,1,21,13,362,466,828,970
0131-002,2013,1,21,14,446,502,948,828
0131-002,2013,1,21,15,554,572,1126,948
0131-002,2013,1,21,16,550,444,994,1126
0131-002,2013,1,21,17,472,658,1130,994
0131-002,2013,1,21,18,442,736,1178,1130
0131-002,2013,1,21,19,478,752,1230,1178
0131-002,2013,1,21,20,298,562,860,1230
0131-002,2013,1,21,21,236,568,804,860
0131-002,2013,1,21,22,224,350,574,804
0131-002,2013,1,21,23,108,146,254,574
0131-002,2013,1,21,24,70,98,168,254
0131-002,2013,1,22,1,42,58,100,168
0131-002,2013,1,22,2,18,48,66,100
0131-002,2013,1,22,3,18,22,40,66
0131-002,2013,1,22,4,10,22,32,40
0131-002,2013,1,22,5,10,24,34,32
0131-002,2013,1,22,6,42,38,80,34
0131-002,2013,1,22,7,244,102,346,80
0131-002,2013,1,22,8,1118,566,1684,346
0131-002,2013,1,22,9,1100,940,2040,1684
0131-002,2013,1,22,10,542,680,1222,2040
0131-002,2013,1,22,11,636,564,1200,1222
0131-002,2013,1,22,12,546,642,1188,1200
0131-002,2013,1,22,13,450,546,996,1188
0131-002,2013,1,22,14,552,616,1168,996
0131-002,2013,1,22,15,710,754,1464,1168
0131-002,2013,1,22,16,624,680,1304,1464
0131-002,2013,1,22,17,492,770,1262,1304
0131-002,2013,1,22,18,510,910,1420,1262
0131-002,2013,1,22,19,586,940,1526,1420
0131-002,2013,1,22,20,362,632,994,1526
0131-002,2013,1,22,21,302,536,838,994
0131-002,2013,1,22,22,226,380,606,838
0131-002,2013,1,22,23,104,186,290,606
0131-002,2013,1,22,24,84,102,186,290
0131-002,2013,1,23,1,40,46,86,186
0131-002,2013,1,23,2,30,32,62,86
0131-002,2013,1,23,3,20,44,64,62
0131-002,2013,1,23,4,12,32,44,64
0131-002,2013,1,23,5,20,60,80,44
0131-002,2013,1,23,6,50,56,106,80
0131-002,2013,1,23,7,312,110,422,106
0131-002,2013,1,23,8,1206,568,1774,422
0131-002,2013,1,23,9,1126,910,2036,1774
0131-002,2013,1,23,10,612,698,1310,2036
0131-002,2013,1,23,11,670,672,1342,1310
0131-002,2013,1,23,12,570,694,1264,1342
0131-002,2013,1,23,13,476,568,1044,1264
0131-002,2013,1,23,14,586,668,1254,1044
0131-002,2013,1,23,15,646,754,1400,1254
0131-002,2013,1,23,16,660,658,1318,1400
0131-002,2013,1,23,17,490,788,1278,1318
0131-002,2013,1,23,18,614,928,1542,1278
0131-002,2013,1,23,19,530,910,1440,1542
0131-002,2013,1,23,20,358,606,964,1440
0131-002,2013,1,23,21,286,516,802,964
0131-002,2013,1,23,22,250,304,554,802
0131-002,2013,1,23,23,124,200,324,554
0131-002,2013,1,23,24,64,84,148,324
0131-002,2013,1,24,1,48,64,112,148
0131-002,2013,1,24,2,28,26,54,112
0131-002,2013,1,24,3,14,18,32,54
0131-002,2013,1,24,4,14,28,42,32
0131-002,2013,1,24,5,6,44,50,42
0131-002,2013,1,24,6,52,58,110,50
0131-002,2013,1,24,7,294,124,418,110
0131-002,2013,1,24,8,1258,582,1840,418
0131-002,2013,1,24,9,1132,928,2060,1840
0131-002,2013,1,24,10,598,600,1198,2060
0131-002,2013,1,24,11,602,654,1256,1198
0131-002,2013,1,24,12,568,572,1140,1256
0131-002,2013,1,24,13,412,576,988,1140
0131-002,2013,1,24,14,566,648,1214,988
0131-002,2013,1,24,15,650,738,1388,1214
0131-002,2013,1,24,16,580,706,1286,1388
0131-002,2013,1,24,17,628,696,1324,1286
0131-002,2013,1,24,18,516,968,1484,1324
0131-002,2013,1,24,19,584,924,1508,1484
0131-002,2013,1,24,20,420,668,1088,1508
0131-002,2013,1,24,21,266,570,836,1088
0131-002,2013,1,24,22,288,338,626,836
0131-002,2013,1,24,23,164,194,358,626
0131-002,2013,1,24,24,78,90,168,358
0131-002,2013,1,25,1,68,88,156,168
0131-002,2013,1,25,2,22,46,68,156
0131-002,2013,1,25,3,16,28,44,68
0131-002,2013,1,25,4,12,28,40,44
0131-002,2013,1,25,5,16,28,44,40
0131-002,2013,1,25,6,26,38,64,44
0131-002,2013,1,25,7,208,102,310,64
0131-002,2013,1,25,8,1250,636,1886,310
0131-002,2013,1,25,9,1072,860,1932,1886
0131-002,2013,1,25,10,648,642,1290,1932
0131-002,2013,1,25,11,682,696,1378,1290
0131-002,2013,1,25,12,550,706,1256,1378
0131-002,2013,1,25,13,464,650,1114,1256
0131-002,2013,1,25,14,544,688,1232,1114
0131-002,2013,1,25,15,642,818,1460,1232
0131-002,2013,1,25,16,602,774,1376,1460
0131-002,2013,1,25,17,614,812,1426,1376
0131-002,2013,1,25,18,616,1190,1806,1426
0131-002,2013,1,25,19,756,1128,1884,1806
0131-002,2013,1,25,20,512,760,1272,1884
0131-002,2013,1,25,21,360,592,952,1272
0131-002,2013,1,25,22,304,402,706,952
0131-002,2013,1,25,23,174,216,390,706
0131-002,2013,1,25,24,106,124,230,390
0131-002,2013,1,26,1,58,86,144,230
0131-002,2013,1,26,2,36,78,114,144
0131-002,2013,1,26,3,14,50,64,114
0131-002,2013,1,26,4,24,42,66,64
0131-002,2013,1,26,5,30,54,84,66
0131-002,2013,1,26,6,46,54,100,84
0131-002,2013,1,26,7,132,108,240,100
0131-002,2013,1,26,8,498,314,812,240
0131-002,2013,1,26,9,556,550,1106,812
0131-002,2013,1,26,10,460,536,996,1106
0131-002,2013,1,26,11,500,702,1202,996
0131-002,2013,1,26,12,454,750,1204,1202
0131-002,2013,1,26,13,500,828,1328,1204
0131-002,2013,1,26,14,504,750,1254,1328
0131-002,2013,1,26,15,498,832,1330,1254
0131-002,2013,1,26,16,450,780,1230,1330
0131-002,2013,1,26,17,544,798,1342,1230
0131-002,2013,1,26,18,604,966,1570,1342
0131-002,2013,1,26,19,478,630,1108,1570
0131-002,2013,1,26,20,314,346,660,1108
0131-002,2013,1,26,21,236,312,548,660
0131-002,2013,1,26,22,186,186,372,548
0131-002,2013,1,26,23,130,176,306,372
0131-002,2013,1,26,24,50,84,134,306
0131-002,2013,1,27,1,22,92,114,134
0131-002,2013,1,27,2,34,46,80,114
0131-002,2013,1,27,3,10,18,28,80
0131-002,2013,1,27,4,10,16,26,28
0131-002,2013,1,27,5,12,42,54,26
0131-002,2013,1,27,6,28,30,58,54
0131-002,2013,1,27,7,38,22,60,58
0131-002,2013,1,27,8,78,92,170,60
0131-002,2013,1,27,9,122,166,288,170
0131-002,2013,1,27,10,146,232,378,288
0131-002,2013,1,27,11,192,342,534,378
0131-002,2013,1,27,12,242,322,564,534
0131-002,2013,1,27,13,280,372,652,564
0131-002,2013,1,27,14,302,394,696,652
0131-002,2013,1,27,15,360,338,698,696
0131-002,2013,1,27,16,420,370,790,698
0131-002,2013,1,27,17,528,396,924,790
0131-002,2013,1,27,18,498,360,858,924
0131-002,2013,1,27,19,412,310,722,858
0131-002,2013,1,27,20,250,244,494,722
0131-002,2013,1,27,21,270,190,460,494
0131-002,2013,1,27,22,198,166,364,460
0131-002,2013,1,27,23,126,122,248,364
0131-002,2013,1,27,24,64,70,134,248
0131-002,2013,1,28,1,28,60,88,134
0131-002,2013,1,28,2,22,30,52,88
0131-002,2013,1,28,3,2,12,14,52
0131-002,2013,1,28,4,6,12,18,14
0131-002,2013,1,28,5,4,28,32,18
0131-002,2013,1,28,6,76,54,130,32
0131-002,2013,1,28,7,362,168,530,130
0131-002,2013,1,28,8,1444,696,2140,530
0131-002,2013,1,28,9,1228,922,2150,2140
0131-002,2013,1,28,10,562,628,1190,2150
0131-002,2013,1,28,11,566,584,1150,1190
0131-002,2013,1,28,12,566,652,1218,1150
0131-002,2013,1,28,13,496,548,1044,1218
0131-002,2013,1,28,14,546,656,1202,1044
0131-002,2013,1,28,15,654,714,1368,1202
0131-002,2013,1,28,16,598,772,1370,1368
0131-002,2013,1,28,17,624,768,1392,1370
0131-002,2013,1,28,18,610,1018,1628,1392
0131-002,2013,1,28,19,522,888,1410,1628
0131-002,2013,1,28,20,374,652,1026,1410
0131-002,2013,1,28,21,264,638,902,1026
0131-002,2013,1,28,22,262,388,650,902
0131-002,2013,1,28,23,92,168,260,650
0131-002,2013,1,28,24,84,100,184,260
0131-002,2013,1,29,1,56,46,102,184
0131-002,2013,1,29,2,30,42,72,102
0131-002,2013,1,29,3,8,18,26,72
0131-002,2013,1,29,4,6,16,22,26
0131-002,2013,1,29,5,16,44,60,22
0131-002,2013,1,29,6,52,60,112,60
0131-002,2013,1,29,7,286,118,404,112
0131-002,2013,1,29,8,1268,666,1934,404
0131-002,2013,1,29,9,1190,966,2156,1934
0131-002,2013,1,29,10,662,754,1416,2156
0131-002,2013,1,29,11,730,764,1494,1416
0131-002,2013,1,29,12,680,674,1354,1494
0131-002,2013,1,29,13,534,636,1170,1354
0131-002,2013,1,29,14,588,664,1252,1170
0131-002,2013,1,29,15,636,770,1406,1252
0131-002,2013,1,29,16,668,740,1408,1406
0131-002,2013,1,29,17,600,828,1428,1408
0131-002,2013,1,29,18,604,1072,1676,1428
0131-002,2013,1,29,19,574,958,1532,1676
0131-002,2013,1,29,20,402,672,1074,1532
0131-002,2013,1,29,21,330,632,962,1074
0131-002,2013,1,29,22,226,412,638,962
0131-002,2013,1,29,23,132,198,330,638
0131-002,2013,1,29,24,92,118,210,330
0131-002,2013,1,30,1,46,46,92,210
0131-002,2013,1,30,2,38,40,78,92
0131-002,2013,1,30,3,6,32,38,78
0131-002,2013,1,30,4,12,20,32,38
0131-002,2013,1,30,5,18,46,64,32
0131-002,2013,1,30,6,50,40,90,64
0131-002,2013,1,30,7,304,106,410,90
0131-002,2013,1,30,8,1204,682,1886,410
0131-002,2013,1,30,9,1272,962,2234,1886
0131-002,2013,1,30,10,656,720,1376,2234
0131-002,2013,1,30,11,728,718,1446,1376
0131-002,2013,1,30,12,568,794,1362,1446
0131-002,2013,1,30,13,524,612,1136,1362
0131-002,2013,1,30,14,696,676,1372,1136
0131-002,2013,1,30,15,654,746,1400,1372
0131-002,2013,1,30,16,610,898,1508,1400
0131-002,2013,1,30,17,630,844,1474,1508
0131-002,2013,1,30,18,656,1116,1772,1474
0131-002,2013,1,30,19,644,1078,1722,1772
0131-002,2013,1,30,20,402,686,1088,1722
0131-002,2013,1,30,21,346,522,868,1088
0131-002,2013,1,30,22,228,356,584,868
0131-002,2013,1,30,23,174,198,372,584
0131-002,2013,1,30,24,82,126,208,372
0131-002,2013,1,31,1,66,82,148,208
0131-002,2013,1,31,2,32,46,78,148
0131-002,2013,1,31,3,26,26,52,78
0131-002,2013,1,31,4,18,24,42,52
0131-002,2013,1,31,5,14,32,46,42
0131-002,2013,1,31,6,40,68,108,46
0131-002,2013,1,31,7,320,146,466,108
0131-002,2013,1,31,8,1322,660,1982,466
0131-002,2013,1,31,9,1258,970,2228,1982
0131-002,2013,1,31,10,694,650,1344,2228
0131-002,2013,1,31,11,652,726,1378,1344
0131-002,2013,1,31,12,596,664,1260,1378
0131-002,2013,1,31,13,576,632,1208,1260
0131-002,2013,1,31,14,604,684,1288,1208
0131-002,2013,1,31,15,678,800,1478,1288
0131-002,2013,1,31,16,568,744,1312,1478
0131-002,2013,1,31,17,688,800,1488,1312
0131-002,2013,1,31,18,634,942,1576,1488
0131-002,2013,1,31,19,602,1028,1630,1576
0131-002,2013,1,31,20,426,676,1102,1630
0131-002,2013,1,31,21,334,614,948,1102
0131-002,2013,1,31,22,242,400,642,948
0131-002,2013,1,31,23,156,242,398,642
0131-002,2013,1,31,24,102,140,242,398
0131-002,2013,2,1,1,48,90,138,242
0131-002,2013,2,1,2,34,44,78,138
0131-002,2013,2,1,3,20,34,54,78
0131-002,2013,2,1,4,18,22,40,54
0131-002,2013,2,1,5,14,34,48,40
0131-002,2013,2,1,6,46,62,108,48
0131-002,2013,2,1,7,234,80,314,108
0131-002,2013,2,1,8,1118,508,1626,314
0131-002,2013,2,1,9,1090,928,2018,1626
0131-002,2013,2,1,10,516,636,1152,2018
0131-002,2013,2,1,11,522,670,1192,1152
0131-002,2013,2,1,12,498,614,1112,1192
0131-002,2013,2,1,13,422,532,954,1112
0131-002,2013,2,1,14,486,598,1084,954
0131-002,2013,2,1,15,524,604,1128,1084
0131-002,2013,2,1,16,594,656,1250,1128
0131-002,2013,2,1,17,686,774,1460,1250
0131-002,2013,2,1,18,734,1132,1866,1460
0131-002,2013,2,1,19,718,1120,1838,1866
0131-002,2013,2,1,20,496,832,1328,1838
0131-002,2013,2,1,21,286,628,914,1328
0131-002,2013,2,1,22,206,384,590,914
0131-002,2013,2,1,23,136,266,402,590
0131-002,2013,2,1,24,88,146,234,402
0131-002,2013,2,2,1,62,110,172,234
0131-002,2013,2,2,2,42,74,116,172
0131-002,2013,2,2,3,48,52,100,116
0131-002,2013,2,2,4,22,56,78,100
0131-002,2013,2,2,5,20,62,82,78
0131-002,2013,2,2,6,40,72,112,82
0131-002,2013,2,2,7,128,156,284,112
0131-002,2013,2,2,8,502,342,844,284
0131-002,2013,2,2,9,674,638,1312,844
0131-002,2013,2,2,10,492,632,1124,1312
0131-002,2013,2,2,11,550,706,1256,1124
0131-002,2013,2,2,12,588,742,1330,1256
0131-002,2013,2,2,13,570,772,1342,1330
0131-002,2013,2,2,14,536,804,1340,1342
0131-002,2013,2,2,15,504,842,1346,1340
0131-002,2013,2,2,16,540,822,1362,1346
0131-002,2013,2,2,17,592,816,1408,1362
0131-002,2013,2,2,18,794,914,1708,1408
0131-002,2013,2,2,19,644,710,1354,1708
0131-002,2013,2,2,20,330,380,710,1354
0131-002,2013,2,2,21,244,350,594,710
0131-002,2013,2,2,22,200,296,496,594
0131-002,2013,2,2,23,136,162,298,496
0131-002,2013,2,2,24,62,136,198,298
0131-002,2013,2,3,1,44,82,126,198
0131-002,2013,2,3,2,32,64,96,126
0131-002,2013,2,3,3,16,74,90,96
0131-002,2013,2,3,4,20,34,54,90
0131-002,2013,2,3,5,14,48,62,54
0131-002,2013,2,3,6,30,56,86,62
0131-002,2013,2,3,7,58,82,140,86
0131-002,2013,2,3,8,114,136,250,140
0131-002,2013,2,3,9,194,244,438,250
0131-002,2013,2,3,10,242,336,578,438
0131-002,2013,2,3,11,248,418,666,578
0131-002,2013,2,3,12,260,364,624,666
0131-002,2013,2,3,13,316,442,758,624
0131-002,2013,2,3,14,396,428,824,758
0131-002,2013,2,3,15,416,456,872,824
0131-002,2013,2,3,16,448,518,966,872
0131-002,2013,2,3,17,500,472,972,966
0131-002,2013,2,3,18,466,460,926,972
0131-002,2013,2,3,19,424,358,782,926
0131-002,2013,2,3,20,312,298,610,782
0131-002,2013,2,3,21,220,236,456,610
0131-002,2013,2,3,22,198,176,374,456
0131-002,2013,2,3,23,124,124,248,374
0131-002,2013,2,3,24,100,60,160,248
0131-002,2013,2,4,1,28,38,66,160
0131-002,2013,2,4,2,34,32,66,66
0131-002,2013,2,4,3,8,44,52,66
0131-002,2013,2,4,4,20,16,36,52
0131-002,2013,2,4,5,24,42,66,36
0131-002,2013,2,4,6,16,44,60,66
0131-002,2013,2,4,7,180,102,282,60
0131-002,2013,2,4,8,1034,516,1550,282
0131-002,2013,2,4,9,932,782,1714,1550
0131-002,2013,2,4,10,480,532,1012,1714
0131-002,2013,2,4,11,504,524,1028,1012
0131-002,2013,2,4,12,480,524,1004,1028
0131-002,2013,2,4,13,474,562,1036,1004
0131-002,2013,2,4,14,472,594,1066,1036
0131-002,2013,2,4,15,612,736,1348,1066
0131-002,2013,2,4,16,596,754,1350,1348
0131-002,2013,2,4,17,502,704,1206,1350
0131-002,2013,2,4,18,578,888,1466,1206
0131-002,2013,2,4,19,484,878,1362,1466
0131-002,2013,2,4,20,380,700,1080,1362
0131-002,2013,2,4,21,256,596,852,1080
0131-002,2013,2,4,22,198,380,578,852
0131-002,2013,2,4,23,126,210,336,578
0131-002,2013,2,4,24,90,164,254,336
0131-002,2013,2,5,1,40,70,110,254
0131-002,2013,2,5,2,34,58,92,110
0131-002,2013,2,5,3,24,28,52,92
0131-002,2013,2,5,4,30,28,58,52
0131-002,2013,2,5,5,26,44,70,58
0131-002,2013,2,5,6,46,66,112,70
0131-002,2013,2,5,7,282,132,414,112
0131-002,2013,2,5,8,1328,608,1936,414
0131-002,2013,2,5,9,1108,894,2002,1936
0131-002,2013,2,5,10,672,766,1438,2002
0131-002,2013,2,5,11,660,724,1384,1438
0131-002,2013,2,5,12,656,742,1398,1384
0131-002,2013,2,5,13,522,630,1152,1398
0131-002,2013,2,5,14,608,630,1238,1152
0131-002,2013,2,5,15,732,920,1652,1238
0131-002,2013,2,5,16,710,874,1584,1652
0131-002,2013,2,5,17,636,818,1454,1584
0131-002,2013,2,5,18,604,1008,1612,1454
0131-002,2013,2,5,19,528,862,1390,1612
0131-002,2013,2,5,20,364,698,1062,1390
0131-002,2013,2,5,21,318,608,926,1062
0131-002,2013,2,5,22,240,356,596,926
0131-002,2013,2,5,23,94,214,308,596
0131-002,2013,2,5,24,68,72,140,308
0131-002,2013,2,6,1,38,50,88,140
0131-002,2013,2,6,2,16,38,54,88
0131-002,2013,2,6,3,10,4,14,54
0131-002,2013,2,6,4,18,14,32,14
0131-002,2013,2,6,5,22,26,48,32
0131-002,2013,2,6,6,44,92,136,48
0131-002,2013,2,6,7,254,178,432,136
0131-002,2013,2,6,8,880,714,1594,432
0131-002,2013,2,6,9,818,1042,1860,1594
0131-002,2013,2,6,10,614,868,1482,1860
0131-002,2013,2,6,11,558,728,1286,1482
0131-002,2013,2,6,12,578,632,1210,1286
0131-002,2013,2,6,13,462,572,1034,1210
0131-002,2013,2,6,14,554,680,1234,1034
0131-002,2013,2,6,15,648,778,1426,1234
0131-002,2013,2,6,16,698,838,1536,1426
0131-002,2013,2,6,17,668,796,1464,1536
0131-002,2013,2,6,18,636,1076,1712,1464
0131-002,2013,2,6,19,558,1026,1584,1712
0131-002,2013,2,6,20,370,672,1042,1584
0131-002,2013,2,6,21,326,588,914,1042
0131-002,2013,2,6,22,282,372,654,914
0131-002,2013,2,6,23,140,224,364,654
0131-002,2013,2,6,24,100,150,250,364
0131-002,2013,2,7,1,56,92,148,250
0131-002,2013,2,7,2,18,64,82,148
0131-002,2013,2,7,3,30,34,64,82
0131-002,2013,2,7,4,10,22,32,64
0131-002,2013,2,7,5,14,20,34,32
0131-002,2013,2,7,6,34,46,80,34
0131-002,2013,2,7,7,208,74,282,80
0131-002,2013,2,7,8,966,476,1442,282
0131-002,2013,2,7,9,766,896,1662,1442
0131-002,2013,2,7,10,566,666,1232,1662
0131-002,2013,2,7,11,666,906,1572,1232
0131-002,2013,2,7,12,576,782,1358,1572
0131-002,2013,2,7,13,554,810,1364,1358
0131-002,2013,2,7,14,680,870,1550,1364
0131-002,2013,2,7,15,778,970,1748,1550
0131-002,2013,2,7,16,798,984,1782,1748
0131-002,2013,2,7,17,780,1002,1782,1782
0131-002,2013,2,7,18,692,1138,1830,1782
0131-002,2013,2,7,19,680,1152,1832,1830
0131-002,2013,2,7,20,550,874,1424,1832
0131-002,2013,2,7,21,380,714,1094,1424
0131-002,2013,2,7,22,250,464,714,1094
0131-002,2013,2,7,23,178,290,468,714
0131-002,2013,2,7,24,96,110,206,468
0131-002,2013,2,8,1,70,110,180,206
0131-002,2013,2,8,2,48,72,120,180
0131-002,2013,2,8,3,22,46,68,120
0131-002,2013,2,8,4,26,48,74,68
0131-002,2013,2,8,5,24,44,68,74
0131-002,2013,2,8,6,44,80,124,68
0131-002,2013,2,8,7,238,148,386,124
0131-002,2013,2,8,8,1200,532,1732,386
0131-002,2013,2,8,9,856,830,1686,1732
0131-002,2013,2,8,10,544,680,1224,1686
0131-002,2013,2,8,11,592,770,1362,1224
0131-002,2013,2,8,12,634,980,1614,1362
0131-002,2013,2,8,13,446,1040,1486,1614
0131-002,2013,2,8,14,520,1328,1848,1486
0131-002,2013,2,8,15,546,1446,1992,1848
0131-002,2013,2,8,16,534,1666,2200,1992
0131-002,2013,2,8,17,674,1664,2338,2200
0131-002,2013,2,8,18,682,1360,2042,2338
0131-002,2013,2,8,19,562,1158,1720,2042
0131-002,2013,2,8,20,420,1092,1512,1720
0131-002,2013,2,8,21,298,1312,1610,1512
0131-002,2013,2,8,22,250,1266,1516,1610
0131-002,2013,2,8,23,126,920,1046,1516
0131-002,2013,2,8,24,92,396,488,1046
0131-002,2013,2,9,1,58,312,370,488
0131-002,2013,2,9,2,18,194,212,370
0131-002,2013,2,9,3,30,148,178,212
0131-002,2013,2,9,4,12,120,132,178
0131-002,2013,2,9,5,14,270,284,132
0131-002,2013,2,9,6,28,488,516,284
0131-002,2013,2,9,7,46,682,728,516
0131-002,2013,2,9,8,104,810,914,728
0131-002,2013,2,9,9,120,1152,1272,914
0131-002,2013,2,9,10,262,738,1000,1272
0131-002,2013,2,9,11,338,698,1036,1000
0131-002,2013,2,9,12,382,584,966,1036
0131-002,2013,2,9,13,362,506,868,966
0131-002,2013,2,9,14,300,452,752,868
0131-002,2013,2,9,15,266,388,654,752
0131-002,2013,2,9,16,218,274,492,654
0131-002,2013,2,9,17,242,238,480,492
0131-002,2013,2,9,18,218,226,444,480
0131-002,2013,2,9,19,160,170,330,444
0131-002,2013,2,9,20,136,146,282,330
0131-002,2013,2,9,21,84,124,208,282
0131-002,2013,2,9,22,96,98,194,208
0131-002,2013,2,9,23,62,96,158,194
0131-002,2013,2,9,24,32,56,88,158
0131-002,2013,2,10,1,18,52,70,88
0131-002,2013,2,10,2,12,16,28,70
0131-002,2013,2,10,3,2,22,24,28
0131-002,2013,2,10,4,10,6,16,24
0131-002,2013,2,10,5,4,8,12,16
0131-002,2013,2,10,6,16,24,40,12
0131-002,2013,2,10,7,40,58,98,40
0131-002,2013,2,10,8,84,54,138,98
0131-002,2013,2,10,9,102,108,210,138
0131-002,2013,2,10,10,96,172,268,210
0131-002,2013,2,10,11,306,366,672,268
0131-002,2013,2,10,12,640,604,1244,672
0131-002,2013,2,10,13,936,710,1646,1244
0131-002,2013,2,10,14,1122,872,1994,1646
0131-002,2013,2,10,15,1024,992,2016,1994
0131-002,2013,2,10,16,1230,924,2154,2016
0131-002,2013,2,10,17,1214,910,2124,2154
0131-002,2013,2,10,18,1180,600,1780,2124
0131-002,2013,2,10,19,972,306,1278,1780
0131-002,2013,2,10,20,522,288,810,1278
0131-002,2013,2,10,21,262,198,460,810
0131-002,2013,2,10,22,188,162,350,460
0131-002,2013,2,10,23,108,112,220,350
0131-002,2013,2,10,24,92,100,192,220
0131-002,2013,2,11,1,120,50,170,192
0131-002,2013,2,11,2,96,28,124,170
0131-002,2013,2,11,3,26,18,44,124
0131-002,2013,2,11,4,18,20,38,44
0131-002,2013,2,11,5,8,10,18,38
0131-002,2013,2,11,6,20,22,42,18
0131-002,2013,2,11,7,32,18,50,42
0131-002,2013,2,11,8,48,48,96,50
0131-002,2013,2,11,9,82,76,158,96
0131-002,2013,2,11,10,108,104,212,158
0131-002,2013,2,11,11,298,202,500,212
0131-002,2013,2,11,12,574,270,844,500
0131-002,2013,2,11,13,706,364,1070,844
0131-002,2013,2,11,14,766,376,1142,1070
0131-002,2013,2,11,15,722,428,1150,1142
0131-002,2013,2,11,16,580,448,1028,1150
0131-002,2013,2,11,17,570,434,1004,1028
0131-002,2013,2,11,18,634,412,1046,1004
0131-002,2013,2,11,19,558,334,892,1046
0131-002,2013,2,11,20,616,226,842,892
0131-002,2013,2,11,21,684,184,868,842
0131-002,2013,2,11,22,632,142,774,868
0131-002,2013,2,11,23,452,134,586,774
0131-002,2013,2,11,24,304,52,356,586
0131-002,2013,2,12,1,158,58,216,356
0131-002,2013,2,12,2,70,30,100,216
0131-002,2013,2,12,3,24,16,40,100
0131-002,2013,2,12,4,18,18,36,40
0131-002,2013,2,12,5,16,22,38,36
0131-002,2013,2,12,6,38,40,78,38
0131-002,2013,2,12,7,164,94,258,78
0131-002,2013,2,12,8,744,434,1178,258
0131-002,2013,2,12,9,644,588,1232,1178
0131-002,2013,2,12,10,414,468,882,1232
0131-002,2013,2,12,11,458,450,908,882
0131-002,2013,2,12,12,450,450,900,908
0131-002,2013,2,12,13,466,464,930,900
0131-002,2013,2,12,14,484,498,982,930
0131-002,2013,2,12,15,570,554,1124,982
0131-002,2013,2,12,16,588,586,1174,1124
0131-002,2013,2,12,17,656,598,1254,1174
0131-002,2013,2,12,18,642,692,1334,1254
0131-002,2013,2,12,19,512,644,1156,1334
0131-002,2013,2,12,20,372,392,764,1156
0131-002,2013,2,12,21,250,324,574,764
0131-002,2013,2,12,22,232,226,458,574
0131-002,2013,2,12,23,134,162,296,458
0131-002,2013,2,12,24,74,54,128,296
0131-002,2013,2,13,1,72,66,138,128
0131-002,2013,2,13,2,16,26,42,138
0131-002,2013,2,13,3,18,20,38,42
0131-002,2013,2,13,4,18,22,40,38
0131-002,2013,2,13,5,30,38,68,40
0131-002,2013,2,13,6,66,54,120,68
0131-002,2013,2,13,7,306,136,442,120
0131-002,2013,2,13,8,1294,626,1920,442
0131-002,2013,2,13,9,1080,890,1970,1920
0131-002,2013,2,13,10,600,650,1250,1970
0131-002,2013,2,13,11,648,740,1388,1250
0131-002,2013,2,13,12,552,656,1208,1388
0131-002,2013,2,13,13,512,578,1090,1208
0131-002,2013,2,13,14,590,656,1246,1090
0131-002,2013,2,13,15,642,774,1416,1246
0131-002,2013,2,13,16,614,692,1306,1416
0131-002,2013,2,13,17,614,734,1348,1306
0131-002,2013,2,13,18,614,994,1608,1348
0131-002,2013,2,13,19,610,894,1504,1608
0131-002,2013,2,13,20,398,596,994,1504
0131-002,2013,2,13,21,280,492,772,994
0131-002,2013,2,13,22,258,330,588,772
0131-002,2013,2,13,23,128,190,318,588
0131-002,2013,2,13,24,82,116,198,318
0131-002,2013,2,14,1,74,56,130,198
0131-002,2013,2,14,2,42,40,82,130
0131-002,2013,2,14,3,10,24,34,82
0131-002,2013,2,14,4,10,26,36,34
0131-002,2013,2,14,5,12,36,48,36
0131-002,2013,2,14,6,46,84,130,48
0131-002,2013,2,14,7,328,124,452,130
0131-002,2013,2,14,8,1326,654,1980,452
0131-002,2013,2,14,9,1118,978,2096,1980
0131-002,2013,2,14,10,704,770,1474,2096
0131-002,2013,2,14,11,732,766,1498,1474
0131-002,2013,2,14,12,664,774,1438,1498
0131-002,2013,2,14,13,504,628,1132,1438
0131-002,2013,2,14,14,598,688,1286,1132
0131-002,2013,2,14,15,728,766,1494,1286
0131-002,2013,2,14,16,654,864,1518,1494
0131-002,2013,2,14,17,632,730,1362,1518
0131-002,2013,2,14,18,652,1004,1656,1362
0131-002,2013,2,14,19,562,900,1462,1656
0131-002,2013,2,14,20,424,714,1138,1462
0131-002,2013,2,14,21,326,622,948,1138
0131-002,2013,2,14,22,260,388,648,948
0131-002,2013,2,14,23,134,220,354,648
0131-002,2013,2,14,24,94,132,226,354
0131-002,2013,2,15,1,66,94,160,226
0131-002,2013,2,15,2,26,60,86,160
0131-002,2013,2,15,3,14,30,44,86
0131-002,2013,2,15,4,12,24,36,44
0131-002,2013,2,15,5,12,64,76,36
0131-002,2013,2,15,6,78,72,150,76
0131-002,2013,2,15,7,348,120,468,150
0131-002,2013,2,15,8,1354,678,2032,468
0131-002,2013,2,15,9,1148,998,2146,2032
0131-002,2013,2,15,10,616,752,1368,2146
0131-002,2013,2,15,11,676,792,1468,1368
0131-002,2013,2,15,12,604,664,1268,1468
0131-002,2013,2,15,13,436,710,1146,1268
0131-002,2013,2,15,14,644,670,1314,1146
0131-002,2013,2,15,15,678,820,1498,1314
0131-002,2013,2,15,16,638,848,1486,1498
0131-002,2013,2,15,17,688,928,1616,1486
0131-002,2013,2,15,18,660,1232,1892,1616
0131-002,2013,2,15,19,738,1232,1970,1892
0131-002,2013,2,15,20,570,838,1408,1970
0131-002,2013,2,15,21,338,636,974,1408
0131-002,2013,2,15,22,302,430,732,974
0131-002,2013,2,15,23,116,218,334,732
0131-002,2013,2,15,24,100,96,196,334
0131-002,2013,2,16,1,66,100,166,196
0131-002,2013,2,16,2,52,52,104,166
0131-002,2013,2,16,3,26,32,58,104
0131-002,2013,2,16,4,30,40,70,58
0131-002,2013,2,16,5,32,56,88,70
0131-002,2013,2,16,6,60,60,120,88
0131-002,2013,2,16,7,206,112,318,120
0131-002,2013,2,16,8,574,316,890,318
0131-002,2013,2,16,9,562,570,1132,890
0131-002,2013,2,16,10,540,664,1204,1132
0131-002,2013,2,16,11,498,744,1242,1204
0131-002,2013,2,16,12,528,816,1344,1242
0131-002,2013,2,16,13,452,922,1374,1344
0131-002,2013,2,16,14,532,868,1400,1374
0131-002,2013,2,16,15,516,888,1404,1400
0131-002,2013,2,16,16,568,814,1382,1404
0131-002,2013,2,16,17,536,754,1290,1382
0131-002,2013,2,16,18,664,1002,1666,1290
0131-002,2013,2,16,19,538,674,1212,1666
0131-002,2013,2,16,20,282,368,650,1212
0131-002,2013,2,16,21,252,278,530,650
0131-002,2013,2,16,22,204,232,436,530
0131-002,2013,2,16,23,84,140,224,436
0131-002,2013,2,16,24,70,90,160,224
0131-002,2013,2,17,1,34,78,112,160
0131-002,2013,2,17,2,28,40,68,112
0131-002,2013,2,17,3,20,34,54,68
0131-002,2013,2,17,4,12,20,32,54
0131-002,2013,2,17,5,20,30,50,32
0131-002,2013,2,17,6,16,38,54,50
0131-002,2013,2,17,7,66,50,116,54
0131-002,2013,2,17,8,124,114,238,116
0131-002,2013,2,17,9,180,230,410,238
0131-002,2013,2,17,10,198,268,466,410
0131-002,2013,2,17,11,242,318,560,466
0131-002,2013,2,17,12,250,322,572,560
0131-002,2013,2,17,13,300,298,598,572
0131-002,2013,2,17,14,354,358,712,598
0131-002,2013,2,17,15,390,422,812,712
0131-002,2013,2,17,16,502,434,936,812
0131-002,2013,2,17,17,470,480,950,936
0131-002,2013,2,17,18,444,522,966,950
0131-002,2013,2,17,19,452,396,848,966
0131-002,2013,2,17,20,242,214,456,848
0131-002,2013,2,17,21,234,230,464,456
0131-002,2013,2,17,22,228,168,396,464
0131-002,2013,2,17,23,148,128,276,396
0131-002,2013,2,17,24,56,84,140,276
0131-002,2013,2,18,1,50,44,94,140
0131-002,2013,2,18,2,30,16,46,94
0131-002,2013,2,18,3,10,16,26,46
0131-002,2013,2,18,4,8,20,28,26
0131-002,2013,2,18,5,14,40,54,28
0131-002,2013,2,18,6,56,64,120,54
0131-002,2013,2,18,7,412,178,590,120
0131-002,2013,2,18,8,1482,756,2238,590
0131-002,2013,2,18,9,1278,964,2242,2238
0131-002,2013,2,18,10,578,702,1280,2242
0131-002,2013,2,18,11,740,712,1452,1280
0131-002,2013,2,18,12,570,726,1296,1452
0131-002,2013,2,18,13,514,572,1086,1296
0131-002,2013,2,18,14,590,594,1184,1086
0131-002,2013,2,18,15,686,818,1504,1184
0131-002,2013,2,18,16,674,726,1400,1504
0131-002,2013,2,18,17,706,790,1496,1400
0131-002,2013,2,18,18,628,928,1556,1496
0131-002,2013,2,18,19,554,894,1448,1556
0131-002,2013,2,18,20,406,664,1070,1448
0131-002,2013,2,18,21,322,634,956,1070
0131-002,2013,2,18,22,222,376,598,956
0131-002,2013,2,18,23,110,166,276,598
0131-002,2013,2,18,24,100,92,192,276
0131-002,2013,2,19,1,58,84,142,192
0131-002,2013,2,19,2,24,50,74,142
0131-002,2013,2,19,3,18,24,42,74
0131-002,2013,2,19,4,16,28,44,42
0131-002,2013,2,19,5,40,40,80,44
0131-002,2013,2,19,6,58,56,114,80
0131-002,2013,2,19,7,330,116,446,114
0131-002,2013,2,19,8,1318,702,2020,446
0131-002,2013,2,19,9,1130,1078,2208,2020
0131-002,2013,2,19,10,654,720,1374,2208
0131-002,2013,2,19,11,718,796,1514,1374
0131-002,2013,2,19,12,550,676,1226,1514
0131-002,2013,2,19,13,532,622,1154,1226
0131-002,2013,2,19,14,630,644,1274,1154
0131-002,2013,2,19,15,626,814,1440,1274
0131-002,2013,2,19,16,596,816,1412,1440
0131-002,2013,2,19,17,600,790,1390,1412
0131-002,2013,2,19,18,560,910,1470,1390
0131-002,2013,2,19,19,666,912,1578,1470
0131-002,2013,2,19,20,422,700,1122,1578
0131-002,2013,2,19,21,326,658,984,1122
0131-002,2013,2,19,22,238,416,654,984
0131-002,2013,2,19,23,140,226,366,654
0131-002,2013,2,19,24,84,108,192,366
0131-002,2013,2,20,1,32,86,118,192
0131-002,2013,2,20,2,26,48,74,118
0131-002,2013,2,20,3,28,22,50,74
0131-002,2013,2,20,4,22,24,46,50
0131-002,2013,2,20,5,18,34,52,46
0131-002,2013,2,20,6,60,48,108,52
0131-002,2013,2,20,7,342,138,480,108
0131-002,2013,2,20,8,1292,672,1964,480
0131-002,2013,2,20,9,1068,974,2042,1964
0131-002,2013,2,20,10,722,762,1484,2042
0131-002,2013,2,20,11,704,672,1376,1484
0131-002,2013,2,20,12,602,706,1308,1376
0131-002,2013,2,20,13,510,632,1142,1308
0131-002,2013,2,20,14,606,654,1260,1142
0131-002,2013,2,20,15,660,834,1494,1260
0131-002,2013,2,20,16,642,778,1420,1494
0131-002,2013,2,20,17,660,906,1566,1420
0131-002,2013,2,20,18,638,1120,1758,1566
0131-002,2013,2,20,19,620,1094,1714,1758
0131-002,2013,2,20,20,464,638,1102,1714
0131-002,2013,2,20,21,330,554,884,1102
0131-002,2013,2,20,22,236,370,606,884
0131-002,2013,2,20,23,172,204,376,606
0131-002,2013,2,20,24,88,110,198,376
0131-002,2013,2,21,1,54,76,130,198
0131-002,2013,2,21,2,34,38,72,130
0131-002,2013,2,21,3,12,14,26,72
0131-002,2013,2,21,4,10,10,20,26
0131-002,2013,2,21,5,14,18,32,20
0131-002,2013,2,21,6,42,38,80,32
0131-002,2013,2,21,7,326,126,452,80
0131-002,2013,2,21,8,1350,626,1976,452
0131-002,2013,2,21,9,1160,1020,2180,1976
0131-002,2013,2,21,10,674,708,1382,2180
0131-002,2013,2,21,11,718,802,1520,1382
0131-002,2013,2,21,12,640,742,1382,1520
0131-002,2013,2,21,13,468,610,1078,1382
0131-002,2013,2,21,14,562,764,1326,1078
0131-002,2013,2,21,15,780,770,1550,1326
0131-002,2013,2,21,16,702,716,1418,1550
0131-002,2013,2,21,17,658,774,1432,1418
0131-002,2013,2,21,18,658,1004,1662,1432
0131-002,2013,2,21,19,648,1036,1684,1662
0131-002,2013,2,21,20,496,652,1148,1684
0131-002,2013,2,21,21,374,620,994,1148
0131-002,2013,2,21,22,272,412,684,994
0131-002,2013,2,21,23,198,244,442,684
0131-002,2013,2,21,24,104,126,230,442
0131-002,2013,2,22,1,58,76,134,230
0131-002,2013,2,22,2,34,42,76,134
0131-002,2013,2,22,3,16,28,44,76
0131-002,2013,2,22,4,12,28,40,44
0131-002,2013,2,22,5,36,38,74,40
0131-002,2013,2,22,6,62,66,128,74
0131-002,2013,2,22,7,264,80,344,128
0131-002,2013,2,22,8,840,462,1302,344
0131-002,2013,2,22,9,1078,968,2046,1302
0131-002,2013,2,22,10,662,720,1382,2046
0131-002,2013,2,22,11,626,766,1392,1382
0131-002,2013,2,22,12,564,732,1296,1392
0131-002,2013,2,22,13,480,710,1190,1296
0131-002,2013,2,22,14,602,928,1530,1190
0131-002,2013,2,22,15,646,944,1590,1530
0131-002,2013,2,22,16,720,790,1510,1590
0131-002,2013,2,22,17,636,866,1502,1510
0131-002,2013,2,22,18,690,1070,1760,1502
0131-002,2013,2,22,19,778,1148,1926,1760
0131-002,2013,2,22,20,574,808,1382,1926
0131-002,2013,2,22,21,354,624,978,1382
0131-002,2013,2,22,22,246,454,700,978
0131-002,2013,2,22,23,182,252,434,700
0131-002,2013,2,22,24,120,128,248,434
0131-002,2013,2,23,1,102,102,204,248
0131-002,2013,2,23,2,74,62,136,204
0131-002,2013,2,23,3,26,38,64,136
0131-002,2013,2,23,4,18,44,62,64
0131-002,2013,2,23,5,34,54,88,62
0131-002,2013,2,23,6,62,60,122,88
0131-002,2013,2,23,7,174,122,296,122
0131-002,2013,2,23,8,584,356,940,296
0131-002,2013,2,23,9,618,604,1222,940
0131-002,2013,2,23,10,550,602,1152,1222
0131-002,2013,2,23,11,542,802,1344,1152
0131-002,2013,2,23,12,530,1046,1576,1344
0131-002,2013,2,23,13,490,994,1484,1576
0131-002,2013,2,23,14,516,914,1430,1484
0131-002,2013,2,23,15,570,878,1448,1430
0131-002,2013,2,23,16,626,846,1472,1448
0131-002,2013,2,23,17,616,872,1488,1472
0131-002,2013,2,23,18,706,974,1680,1488
0131-002,2013,2,23,19,630,852,1482,1680
0131-002,2013,2,23,20,382,420,802,1482
0131-002,2013,2,23,21,336,258,594,802
0131-002,2013,2,23,22,218,238,456,594
0131-002,2013,2,23,23,194,162,356,456
0131-002,2013,2,23,24,84,78,162,356
0131-002,2013,2,24,1,50,74,124,162
0131-002,2013,2,24,2,24,56,80,124
0131-002,2013,2,24,3,8,34,42,80
0131-002,2013,2,24,4,22,44,66,42
0131-002,2013,2,24,5,6,26,32,66
0131-002,2013,2,24,6,26,34,60,32
0131-002,2013,2,24,7,62,56,118,60
0131-002,2013,2,24,8,128,126,254,118
0131-002,2013,2,24,9,194,252,446,254
0131-002,2013,2,24,10,210,304,514,446
0131-002,2013,2,24,11,276,392,668,514
0131-002,2013,2,24,12,296,396,692,668
0131-002,2013,2,24,13,340,404,744,692
0131-002,2013,2,24,14,390,440,830,744
0131-002,2013,2,24,15,458,514,972,830
0131-002,2013,2,24,16,498,478,976,972
0131-002,2013,2,24,17,564,538,1102,976
0131-002,2013,2,24,18,568,562,1130,1102
0131-002,2013,2,24,19,512,396,908,1130
0131-002,2013,2,24,20,298,274,572,908
0131-002,2013,2,24,21,246,236,482,572
0131-002,2013,2,24,22,254,208,462,482
0131-002,2013,2,24,23,142,132,274,462
0131-002,2013,2,24,24,108,96,204,274
0131-002,2013,2,25,1,70,48,118,204
0131-002,2013,2,25,2,24,28,52,118
0131-002,2013,2,25,3,8,18,26,52
0131-002,2013,2,25,4,12,16,28,26
0131-002,2013,2,25,5,18,16,34,28
0131-002,2013,2,25,6,70,58,128,34
0131-002,2013,2,25,7,462,152,614,128
0131-002,2013,2,25,8,1608,718,2326,614
0131-002,2013,2,25,9,1178,1024,2202,2326
0131-002,2013,2,25,10,608,720,1328,2202
0131-002,2013,2,25,11,730,728,1458,1328
0131-002,2013,2,25,12,608,658,1266,1458
0131-002,2013,2,25,13,522,626,1148,1266
0131-002,2013,2,25,14,602,684,1286,1148
0131-002,2013,2,25,15,708,790,1498,1286
0131-002,2013,2,25,16,668,868,1536,1498
0131-002,2013,2,25,17,702,848,1550,1536
0131-002,2013,2,25,18,672,1030,1702,1550
0131-002,2013,2,25,19,608,1086,1694,1702
0131-002,2013,2,25,20,460,712,1172,1694
0131-002,2013,2,25,21,390,706,1096,1172
0131-002,2013,2,25,22,266,390,656,1096
0131-002,2013,2,25,23,140,218,358,656
0131-002,2013,2,25,24,108,114,222,358
0131-002,2013,2,26,1,76,72,148,222
0131-002,2013,2,26,2,42,46,88,148
0131-002,2013,2,26,3,8,20,28,88
0131-002,2013,2,26,4,20,12,32,28
0131-002,2013,2,26,5,26,40,66,32
0131-002,2013,2,26,6,46,54,100,66
0131-002,2013,2,26,7,336,146,482,100
0131-002,2013,2,26,8,1322,678,2000,482
0131-002,2013,2,26,9,1194,982,2176,2000
0131-002,2013,2,26,10,696,772,1468,2176
0131-002,2013,2,26,11,740,814,1554,1468
0131-002,2013,2,26,12,652,812,1464,1554
0131-002,2013,2,26,13,526,626,1152,1464
0131-002,2013,2,26,14,620,754,1374,1152
0131-002,2013,2,26,15,608,844,1452,1374
0131-002,2013,2,26,16,740,840,1580,1452
0131-002,2013,2,26,17,594,876,1470,1580
0131-002,2013,2,26,18,678,924,1602,1470
0131-002,2013,2,26,19,602,1030,1632,1602
0131-002,2013,2,26,20,434,706,1140,1632
0131-002,2013,2,26,21,374,610,984,1140
0131-002,2013,2,26,22,306,436,742,984
0131-002,2013,2,26,23,170,232,402,742
0131-002,2013,2,26,24,100,126,226,402
0131-002,2013,2,27,1,62,56,118,226
0131-002,2013,2,27,2,26,54,80,118
0131-002,2013,2,27,3,20,36,56,80
0131-002,2013,2,27,4,22,28,50,56
0131-002,2013,2,27,5,20,42,62,50
0131-002,2013,2,27,6,42,68,110,62
0131-002,2013,2,27,7,394,96,490,110
0131-002,2013,2,27,8,1252,708,1960,490
0131-002,2013,2,27,9,1152,1014,2166,1960
0131-002,2013,2,27,10,744,776,1520,2166
0131-002,2013,2,27,11,782,720,1502,1520
0131-002,2013,2,27,12,672,708,1380,1502
0131-002,2013,2,27,13,498,626,1124,1380
0131-002,2013,2,27,14,700,682,1382,1124
0131-002,2013,2,27,15,762,894,1656,1382
0131-002,2013,2,27,16,710,870,1580,1656
0131-002,2013,2,27,17,578,892,1470,1580
0131-002,2013,2,27,18,664,1170,1834,1470
0131-002,2013,2,27,19,668,1014,1682,1834
0131-002,2013,2,27,20,494,684,1178,1682
0131-002,2013,2,27,21,380,600,980,1178
0131-002,2013,2,27,22,300,418,718,980
0131-002,2013,2,27,23,194,236,430,718
0131-002,2013,2,27,24,94,154,248,430
0131-002,2013,2,28,1,60,60,120,248
0131-002,2013,2,28,2,32,38,70,120
0131-002,2013,2,28,3,24,40,64,70
0131-002,2013,2,28,4,16,38,54,64
0131-002,2013,2,28,5,32,26,58,54
0131-002,2013,2,28,6,60,64,124,58
0131-002,2013,2,28,7,376,144,520,124
0131-002,2013,2,28,8,1322,684,2006,520
0131-002,2013,2,28,9,1140,1058,2198,2006
0131-002,2013,2,28,10,718,756,1474,2198
0131-002,2013,2,28,11,672,732,1404,1474
0131-002,2013,2,28,12,652,806,1458,1404
0131-002,2013,2,28,13,506,674,1180,1458
0131-002,2013,2,28,14,638,748,1386,1180
0131-002,2013,2,28,15,692,842,1534,1386
0131-002,2013,2,28,16,662,870,1532,1534
0131-002,2013,2,28,17,716,898,1614,1532
0131-002,2013,2,28,18,784,1344,2128,1614
0131-002,2013,2,28,19,788,1308,2096,2128
0131-002,2013,2,28,20,538,958,1496,2096
0131-002,2013,2,28,21,368,716,1084,1496
0131-002,2013,2,28,22,298,466,764,1084
0131-002,2013,2,28,23,226,288,514,764
0131-002,2013,2,28,24,126,130,256,514
0131-002,2013,3,1,1,94,124,218,256
0131-002,2013,3,1,2,50,62,112,218
0131-002,2013,3,1,3,32,56,88,112
0131-002,2013,3,1,4,38,90,128,88
0131-002,2013,3,1,5,22,24,46,128
0131-002,2013,3,1,6,46,50,96,46
0131-002,2013,3,1,7,164,50,214,96
0131-002,2013,3,1,8,556,306,862,214
0131-002,2013,3,1,9,510,458,968,862
0131-002,2013,3,1,10,492,536,1028,968
0131-002,2013,3,1,11,444,544,988,1028
0131-002,2013,3,1,12,482,626,1108,988
0131-002,2013,3,1,13,420,622,1042,1108
0131-002,2013,3,1,14,434,670,1104,1042
0131-002,2013,3,1,15,470,688,1158,1104
0131-002,2013,3,1,16,576,632,1208,1158
0131-002,2013,3,1,17,558,760,1318,1208
0131-002,2013,3,1,18,642,996,1638,1318
0131-002,2013,3,1,19,618,912,1530,1638
0131-002,2013,3,1,20,440,620,1060,1530
0131-002,2013,3,1,21,278,492,770,1060
0131-002,2013,3,1,22,238,440,678,770
0131-002,2013,3,1,23,160,222,382,678
0131-002,2013,3,1,24,78,84,162,382
0131-002,2013,3,2,1,36,80,116,162
0131-002,2013,3,2,2,38,34,72,116
0131-002,2013,3,2,3,12,26,38,72
0131-002,2013,3,2,4,18,26,44,38
0131-002,2013,3,2,5,8,48,56,44
0131-002,2013,3,2,6,60,34,94,56
0131-002,2013,3,2,7,146,96,242,94
0131-002,2013,3,2,8,448,252,700,242
0131-002,2013,3,2,9,406,506,912,700
0131-002,2013,3,2,10,344,472,816,912
0131-002,2013,3,2,11,492,664,1156,816
0131-002,2013,3,2,12,490,796,1286,1156
0131-002,2013,3,2,13,448,844,1292,1286
0131-002,2013,3,2,14,498,998,1496,1292
0131-002,2013,3,2,15,500,1078,1578,1496
0131-002,2013,3,2,16,530,1042,1572,1578
0131-002,2013,3,2,17,684,894,1578,1572
0131-002,2013,3,2,18,918,1016,1934,1578
0131-002,2013,3,2,19,848,738,1586,1934
0131-002,2013,3,2,20,760,520,1280,1586
0131-002,2013,3,2,21,692,288,980,1280
0131-002,2013,3,2,22,616,228,844,980
0131-002,2013,3,2,23,360,136,496,844
0131-002,2013,3,2,24,188,94,282,496
0131-002,2013,3,3,1,56,60,116,282
0131-002,2013,3,3,2,22,42,64,116
0131-002,2013,3,3,3,14,24,38,64
0131-002,2013,3,3,4,10,32,42,38
0131-002,2013,3,3,5,12,18,30,42
0131-002,2013,3,3,6,16,30,46,30
0131-002,2013,3,3,7,60,48,108,46
0131-002,2013,3,3,8,132,108,240,108
0131-002,2013,3,3,9,194,226,420,240
0131-002,2013,3,3,10,168,284,452,420
0131-002,2013,3,3,11,384,364,748,452
0131-002,2013,3,3,12,522,398,920,748
0131-002,2013,3,3,13,566,514,1080,920
0131-002,2013,3,3,14,680,528,1208,1080
0131-002,2013,3,3,15,702,514,1216,1208
0131-002,2013,3,3,16,926,622,1548,1216
0131-002,2013,3,3,17,812,706,1518,1548
0131-002,2013,3,3,18,816,758,1574,1518
0131-002,2013,3,3,19,866,530,1396,1574
0131-002,2013,3,3,20,626,442,1068,1396
0131-002,2013,3,3,21,496,282,778,1068
0131-002,2013,3,3,22,382,196,578,778
0131-002,2013,3,3,23,198,124,322,578
0131-002,2013,3,3,24,118,62,180,322
0131-002,2013,3,4,1,30,42,72,180
0131-002,2013,3,4,2,10,26,36,72
0131-002,2013,3,4,3,14,10,24,36
0131-002,2013,3,4,4,18,12,30,24
0131-002,2013,3,4,5,18,20,38,30
0131-002,2013,3,4,6,70,80,150,38
0131-002,2013,3,4,7,486,232,718,150
0131-002,2013,3,4,8,1450,774,2224,718
0131-002,2013,3,4,9,1278,1014,2292,2224
0131-002,2013,3,4,10,756,726,1482,2292
0131-002,2013,3,4,11,600,746,1346,1482
0131-002,2013,3,4,12,562,744,1306,1346
0131-002,2013,3,4,13,560,574,1134,1306
0131-002,2013,3,4,14,582,674,1256,1134
0131-002,2013,3,4,15,764,836,1600,1256
0131-002,2013,3,4,16,636,848,1484,1600
0131-002,2013,3,4,17,582,822,1404,1484
0131-002,2013,3,4,18,596,1074,1670,1404
0131-002,2013,3,4,19,620,918,1538,1670
0131-002,2013,3,4,20,486,744,1230,1538
0131-002,2013,3,4,21,350,660,1010,1230
0131-002,2013,3,4,22,270,350,620,1010
0131-002,2013,3,4,23,164,244,408,620
0131-002,2013,3,4,24,122,136,258,408
0131-002,2013,3,5,1,42,60,102,258
0131-002,2013,3,5,2,32,36,68,102
0131-002,2013,3,5,3,10,20,30,68
0131-002,2013,3,5,4,14,32,46,30
0131-002,2013,3,5,5,24,36,60,46
0131-002,2013,3,5,6,40,66,106,60
0131-002,2013,3,5,7,366,156,522,106
0131-002,2013,3,5,8,1390,760,2150,522
0131-002,2013,3,5,9,1158,1070,2228,2150
0131-002,2013,3,5,10,704,688,1392,2228
0131-002,2013,3,5,11,716,778,1494,1392
0131-002,2013,3,5,12,620,778,1398,1494
0131-002,2013,3,5,13,552,552,1104,1398
0131-002,2013,3,5,14,592,684,1276,1104
0131-002,2013,3,5,15,738,786,1524,1276
0131-002,2013,3,5,16,666,830,1496,1524
0131-002,2013,3,5,17,662,828,1490,1496
0131-002,2013,3,5,18,580,1086,1666,1490
0131-002,2013,3,5,19,660,1088,1748,1666
0131-002,2013,3,5,20,466,718,1184,1748
0131-002,2013,3,5,21,304,646,950,1184
0131-002,2013,3,5,22,290,426,716,950
0131-002,2013,3,5,23,138,222,360,716
0131-002,2013,3,5,24,72,98,170,360
0131-002,2013,3,6,1,68,52,120,170
0131-002,2013,3,6,2,24,36,60,120
0131-002,2013,3,6,3,20,26,46,60
0131-002,2013,3,6,4,18,14,32,46
0131-002,2013,3,6,5,26,38,64,32
0131-002,2013,3,6,6,38,52,90,64
0131-002,2013,3,6,7,414,120,534,90
0131-002,2013,3,6,8,1508,756,2264,534
0131-002,2013,3,6,9,1262,1088,2350,2264
0131-002,2013,3,6,10,746,794,1540,2350
0131-002,2013,3,6,11,666,736,1402,1540
0131-002,2013,3,6,12,598,736,1334,1402
0131-002,2013,3,6,13,508,590,1098,1334
0131-002,2013,3,6,14,582,634,1216,1098
0131-002,2013,3,6,15,644,834,1478,1216
0131-002,2013,3,6,16,622,820,1442,1478
0131-002,2013,3,6,17,686,850,1536,1442
0131-002,2013,3,6,18,676,1160,1836,1536
0131-002,2013,3,6,19,630,1154,1784,1836
0131-002,2013,3,6,20,530,748,1278,1784
0131-002,2013,3,6,21,336,596,932,1278
0131-002,2013,3,6,22,268,410,678,932
0131-002,2013,3,6,23,178,276,454,678
0131-002,2013,3,6,24,84,112,196,454
0131-002,2013,3,7,1,74,62,136,196
0131-002,2013,3,7,2,38,36,74,136
0131-002,2013,3,7,3,14,40,54,74
0131-002,2013,3,7,4,18,30,48,54
0131-002,2013,3,7,5,28,38,66,48
0131-002,2013,3,7,6,50,66,116,66
0131-002,2013,3,7,7,388,146,534,116
0131-002,2013,3,7,8,1258,738,1996,534
0131-002,2013,3,7,9,1164,1046,2210,1996
0131-002,2013,3,7,10,684,730,1414,2210
0131-002,2013,3,7,11,520,792,1312,1414
0131-002,2013,3,7,12,646,758,1404,1312
0131-002,2013,3,7,13,526,668,1194,1404
0131-002,2013,3,7,14,700,746,1446,1194
0131-002,2013,3,7,15,748,756,1504,1446
0131-002,2013,3,7,16,666,912,1578,1504
0131-002,2013,3,7,17,588,804,1392,1578
0131-002,2013,3,7,18,692,944,1636,1392
0131-002,2013,3,7,19,610,962,1572,1636
0131-002,2013,3,7,20,474,716,1190,1572
0131-002,2013,3,7,21,334,630,964,1190
0131-002,2013,3,7,22,330,396,726,964
0131-002,2013,3,7,23,140,248,388,726
0131-002,2013,3,7,24,122,110,232,388
0131-002,2013,3,8,1,42,62,104,232
0131-002,2013,3,8,2,14,48,62,104
0131-002,2013,3,8,3,12,16,28,62
0131-002,2013,3,8,4,8,40,48,28
0131-002,2013,3,8,5,30,32,62,48
0131-002,2013,3,8,6,104,50,154,62
0131-002,2013,3,8,7,414,144,558,154
0131-002,2013,3,8,8,1352,766,2118,558
0131-002,2013,3,8,9,1260,1098,2358,2118
0131-002,2013,3,8,10,678,744,1422,2358
0131-002,2013,3,8,11,776,826,1602,1422
0131-002,2013,3,8,12,684,794,1478,1602
0131-002,2013,3,8,13,580,656,1236,1478
0131-002,2013,3,8,14,650,678,1328,1236
0131-002,2013,3,8,15,762,896,1658,1328
0131-002,2013,3,8,16,692,844,1536,1658
0131-002,2013,3,8,17,634,880,1514,1536
0131-002,2013,3,8,18,798,1318,2116,1514
0131-002,2013,3,8,19,742,1180,1922,2116
0131-002,2013,3,8,20,558,994,1552,1922
0131-002,2013,3,8,21,424,708,1132,1552
0131-002,2013,3,8,22,312,412,724,1132
0131-002,2013,3,8,23,200,250,450,724
0131-002,2013,3,8,24,154,134,288,450
0131-002,2013,3,9,1,68,100,168,288
0131-002,2013,3,9,2,62,52,114,168
0131-002,2013,3,9,3,36,56,92,114
0131-002,2013,3,9,4,24,44,68,92
0131-002,2013,3,9,5,28,32,60,68
0131-002,2013,3,9,6,66,66,132,60
0131-002,2013,3,9,7,222,140,362,132
0131-002,2013,3,9,8,596,402,998,362
0131-002,2013,3,9,9,622,596,1218,998
0131-002,2013,3,9,10,508,774,1282,1218
0131-002,2013,3,9,11,544,770,1314,1282
0131-002,2013,3,9,12,566,914,1480,1314
0131-002,2013,3,9,13,518,940,1458,1480
0131-002,2013,3,9,14,584,922,1506,1458
0131-002,2013,3,9,15,586,900,1486,1506
0131-002,2013,3,9,16,562,776,1338,1486
0131-002,2013,3,9,17,576,766,1342,1338
0131-002,2013,3,9,18,740,960,1700,1342
0131-002,2013,3,9,19,606,850,1456,1700
0131-002,2013,3,9,20,414,432,846,1456
0131-002,2013,3,9,21,288,350,638,846
0131-002,2013,3,9,22,280,202,482,638
0131-002,2013,3,9,23,156,200,356,482
0131-002,2013,3,9,24,74,110,184,356
0131-002,2013,3,10,1,68,76,144,184
0131-002,2013,3,10,2,32,36,68,144
0131-002,2013,3,10,3,8,40,48,68
0131-002,2013,3,10,4,8,28,36,48
0131-002,2013,3,10,5,6,24,30,36
0131-002,2013,3,10,6,26,42,68,30
0131-002,2013,3,10,7,88,50,138,68
0131-002,2013,3,10,8,134,144,278,138
0131-002,2013,3,10,9,216,232,448,278
0131-002,2013,3,10,10,252,306,558,448
0131-002,2013,3,10,11,272,446,718,558
0131-002,2013,3,10,12,298,436,734,718
0131-002,2013,3,10,13,358,444,802,734
0131-002,2013,3,10,14,346,394,740,802
0131-002,2013,3,10,15,480,438,918,740
0131-002,2013,3,10,16,506,524,1030,918
0131-002,2013,3,10,17,482,504,986,1030
0131-002,2013,3,10,18,598,560,1158,986
0131-002,2013,3,10,19,552,446,998,1158
0131-002,2013,3,10,20,390,358,748,998
0131-002,2013,3,10,21,276,254,530,748
0131-002,2013,3,10,22,258,194,452,530
0131-002,2013,3,10,23,174,104,278,452
0131-002,2013,3,10,24,102,94,196,278
0131-002,2013,3,11,1,42,44,86,196
0131-002,2013,3,11,2,28,24,52,86
0131-002,2013,3,11,3,6,8,14,52
0131-002,2013,3,11,4,34,16,50,14
0131-002,2013,3,11,5,18,36,54,50
0131-002,2013,3,11,6,70,58,128,54
0131-002,2013,3,11,7,560,164,724,128
0131-002,2013,3,11,8,1596,774,2370,724
0131-002,2013,3,11,9,1294,1004,2298,2370
0131-002,2013,3,11,10,626,758,1384,2298
0131-002,2013,3,11,11,710,738,1448,1384
0131-002,2013,3,11,12,608,650,1258,1448
0131-002,2013,3,11,13,576,624,1200,1258
0131-002,2013,3,11,14,626,588,1214,1200
0131-002,2013,3,11,15,744,882,1626,1214
0131-002,2013,3,11,16,548,860,1408,1626
0131-002,2013,3,11,17,558,886,1444,1408
0131-002,2013,3,11,18,658,1014,1672,1444
0131-002,2013,3,11,19,640,1006,1646,1672
0131-002,2013,3,11,20,468,790,1258,1646
0131-002,2013,3,11,21,322,604,926,1258
0131-002,2013,3,11,22,330,446,776,926
0131-002,2013,3,11,23,192,190,382,776
0131-002,2013,3,11,24,90,114,204,382
0131-002,2013,3,12,1,50,62,112,204
0131-002,2013,3,12,2,26,22,48,112
0131-002,2013,3,12,3,22,28,50,48
0131-002,2013,3,12,4,24,24,48,50
0131-002,2013,3,12,5,22,36,58,48
0131-002,2013,3,12,6,64,72,136,58
0131-002,2013,3,12,7,454,152,606,136
0131-002,2013,3,12,8,1426,772,2198,606
0131-002,2013,3,12,9,1182,1048,2230,2198
0131-002,2013,3,12,10,734,872,1606,2230
0131-002,2013,3,12,11,736,800,1536,1606
0131-002,2013,3,12,12,582,680,1262,1536
0131-002,2013,3,12,13,484,634,1118,1262
0131-002,2013,3,12,14,678,672,1350,1118
0131-002,2013,3,12,15,734,938,1672,1350
0131-002,2013,3,12,16,662,936,1598,1672
0131-002,2013,3,12,17,646,886,1532,1598
0131-002,2013,3,12,18,778,1026,1804,1532
0131-002,2013,3,12,19,584,1108,1692,1804
0131-002,2013,3,12,20,410,682,1092,1692
0131-002,2013,3,12,21,318,594,912,1092
0131-002,2013,3,12,22,238,342,580,912
0131-002,2013,3,12,23,146,196,342,580
0131-002,2013,3,12,24,110,116,226,342
0131-002,2013,3,13,1,56,76,132,226
0131-002,2013,3,13,2,22,40,62,132
0131-002,2013,3,13,3,24,12,36,62
0131-002,2013,3,13,4,24,20,44,36
0131-002,2013,3,13,5,14,34,48,44
0131-002,2013,3,13,6,44,60,104,48
0131-002,2013,3,13,7,276,104,380,104
0131-002,2013,3,13,8,1202,716,1918,380
0131-002,2013,3,13,9,1140,1050,2190,1918
0131-002,2013,3,13,10,692,762,1454,2190
0131-002,2013,3,13,11,680,780,1460,1454
0131-002,2013,3,13,12,656,692,1348,1460
0131-002,2013,3,13,13,530,608,1138,1348
0131-002,2013,3,13,14,624,664,1288,1138
0131-002,2013,3,13,15,618,736,1354,1288
0131-002,2013,3,13,16,724,824,1548,1354
0131-002,2013,3,13,17,624,802,1426,1548
0131-002,2013,3,13,18,674,1146,1820,1426
0131-002,2013,3,13,19,614,962,1576,1820
0131-002,2013,3,13,20,500,692,1192,1576
0131-002,2013,3,13,21,342,610,952,1192
0131-002,2013,3,13,22,292,418,710,952
0131-002,2013,3,13,23,198,242,440,710
0131-002,2013,3,13,24,120,142,262,440
0131-002,2013,3,14,1,60,74,134,262
0131-002,2013,3,14,2,28,28,56,134
0131-002,2013,3,14,3,22,10,32,56
0131-002,2013,3,14,4,10,24,34,32
0131-002,2013,3,14,5,18,42,60,34
0131-002,2013,3,14,6,72,58,130,60
0131-002,2013,3,14,7,378,146,524,130
0131-002,2013,3,14,8,1362,756,2118,524
0131-002,2013,3,14,9,1250,1094,2344,2118
0131-002,2013,3,14,10,768,764,1532,2344
0131-002,2013,3,14,11,776,762,1538,1532
0131-002,2013,3,14,12,676,684,1360,1538
0131-002,2013,3,14,13,492,610,1102,1360
0131-002,2013,3,14,14,628,708,1336,1102
0131-002,2013,3,14,15,664,930,1594,1336
0131-002,2013,3,14,16,690,918,1608,1594
0131-002,2013,3,14,17,704,828,1532,1608
0131-002,2013,3,14,18,698,1174,1872,1532
0131-002,2013,3,14,19,774,1112,1886,1872
0131-002,2013,3,14,20,516,872,1388,1886
0131-002,2013,3,14,21,326,630,956,1388
0131-002,2013,3,14,22,318,428,746,956
0131-002,2013,3,14,23,248,234,482,746
0131-002,2013,3,14,24,116,146,262,482
0131-002,2013,3,15,1,80,58,138,262
0131-002,2013,3,15,2,32,36,68,138
0131-002,2013,3,15,3,16,36,52,68
0131-002,2013,3,15,4,26,40,66,52
0131-002,2013,3,15,5,16,56,72,66
0131-002,2013,3,15,6,90,66,156,72
0131-002,2013,3,15,7,404,170,574,156
0131-002,2013,3,15,8,1520,724,2244,574
0131-002,2013,3,15,9,1230,1026,2256,2244
0131-002,2013,3,15,10,716,778,1494,2256
0131-002,2013,3,15,11,724,936,1660,1494
0131-002,2013,3,15,12,660,848,1508,1660
0131-002,2013,3,15,13,642,670,1312,1508
0131-002,2013,3,15,14,624,758,1382,1312
0131-002,2013,3,15,15,742,882,1624,1382
0131-002,2013,3,15,16,754,966,1720,1624
0131-002,2013,3,15,17,624,996,1620,1720
0131-002,2013,3,15,18,824,1202,2026,1620
0131-002,2013,3,15,19,892,1354,2246,2026
0131-002,2013,3,15,20,604,878,1482,2246
0131-002,2013,3,15,21,368,736,1104,1482
0131-002,2013,3,15,22,270,448,718,1104
0131-002,2013,3,15,23,220,248,468,718
0131-002,2013,3,15,24,108,132,240,468
0131-002,2013,3,16,1,112,108,220,240
0131-002,2013,3,16,2,30,60,90,220
0131-002,2013,3,16,3,36,48,84,90
0131-002,2013,3,16,4,24,44,68,84
0131-002,2013,3,16,5,22,36,58,68
0131-002,2013,3,16,6,78,64,142,58
0131-002,2013,3,16,7,214,148,362,142
0131-002,2013,3,16,8,622,378,1000,362
0131-002,2013,3,16,9,658,808,1466,1000
0131-002,2013,3,16,10,586,758,1344,1466
0131-002,2013,3,16,11,600,884,1484,1344
0131-002,2013,3,16,12,596,906,1502,1484
0131-002,2013,3,16,13,544,942,1486,1502
0131-002,2013,3,16,14,642,832,1474,1486
0131-002,2013,3,16,15,640,878,1518,1474
0131-002,2013,3,16,16,620,784,1404,1518
0131-002,2013,3,16,17,700,894,1594,1404
0131-002,2013,3,16,18,730,1066,1796,1594
0131-002,2013,3,16,19,620,870,1490,1796
0131-002,2013,3,16,20,392,520,912,1490
0131-002,2013,3,16,21,268,336,604,912
0131-002,2013,3,16,22,266,258,524,604
0131-002,2013,3,16,23,144,168,312,524
0131-002,2013,3,16,24,76,92,168,312
0131-002,2013,3,17,1,64,92,156,168
0131-002,2013,3,17,2,22,36,58,156
0131-002,2013,3,17,3,24,34,58,58
0131-002,2013,3,17,4,18,40,58,58
0131-002,2013,3,17,5,28,26,54,58
0131-002,2013,3,17,6,36,38,74,54
0131-002,2013,3,17,7,120,70,190,74
0131-002,2013,3,17,8,200,154,354,190
0131-002,2013,3,17,9,248,256,504,354
0131-002,2013,3,17,10,194,336,530,504
0131-002,2013,3,17,11,344,424,768,530
0131-002,2013,3,17,12,272,332,604,768
0131-002,2013,3,17,13,320,390,710,604
0131-002,2013,3,17,14,424,424,848,710
0131-002,2013,3,17,15,498,458,956,848
0131-002,2013,3,17,16,512,518,1030,956
0131-002,2013,3,17,17,684,684,1368,1030
0131-002,2013,3,17,18,736,670,1406,1368
0131-002,2013,3,17,19,566,486,1052,1406
0131-002,2013,3,17,20,340,294,634,1052
0131-002,2013,3,17,21,266,276,542,634
0131-002,2013,3,17,22,208,160,368,542
0131-002,2013,3,17,23,148,100,248,368
0131-002,2013,3,17,24,80,62,142,248
0131-002,2013,3,18,1,40,58,98,142
0131-002,2013,3,18,2,30,30,60,98
0131-002,2013,3,18,3,16,26,42,60
0131-002,2013,3,18,4,12,16,28,42
0131-002,2013,3,18,5,16,32,48,28
0131-002,2013,3,18,6,64,52,116,48
0131-002,2013,3,18,7,404,210,614,116
0131-002,2013,3,18,8,1616,798,2414,614
0131-002,2013,3,18,9,1362,1038,2400,2414
0131-002,2013,3,18,10,658,704,1362,2400
0131-002,2013,3,18,11,694,690,1384,1362
0131-002,2013,3,18,12,662,708,1370,1384
0131-002,2013,3,18,13,488,560,1048,1370
0131-002,2013,3,18,14,610,654,1264,1048
0131-002,2013,3,18,15,694,776,1470,1264
0131-002,2013,3,18,16,688,790,1478,1470
0131-002,2013,3,18,17,642,866,1508,1478
0131-002,2013,3,18,18,624,1070,1694,1508
0131-002,2013,3,18,19,672,1046,1718,1694
0131-002,2013,3,18,20,464,750,1214,1718
0131-002,2013,3,18,21,360,682,1042,1214
0131-002,2013,3,18,22,272,406,678,1042
0131-002,2013,3,18,23,156,212,368,678
0131-002,2013,3,18,24,90,144,234,368
0131-002,2013,3,19,1,56,52,108,234
0131-002,2013,3,19,2,34,34,68,108
0131-002,2013,3,19,3,8,26,34,68
0131-002,2013,3,19,4,18,26,44,34
0131-002,2013,3,19,5,18,28,46,44
0131-002,2013,3,19,6,54,64,118,46
0131-002,2013,3,19,7,418,150,568,118
0131-002,2013,3,19,8,1428,674,2102,568
0131-002,2013,3,19,9,1240,1052,2292,2102
0131-002,2013,3,19,10,768,804,1572,2292
0131-002,2013,3,19,11,710,844,1554,1572
0131-002,2013,3,19,12,592,668,1260,1554
0131-002,2013,3,19,13,512,644,1156,1260
0131-002,2013,3,19,14,640,640,1280,1156
0131-002,2013,3,19,15,752,770,1522,1280
0131-002,2013,3,19,16,736,836,1572,1522
0131-002,2013,3,19,17,630,826,1456,1572
0131-002,2013,3,19,18,660,1082,1742,1456
0131-002,2013,3,19,19,652,1016,1668,1742
0131-002,2013,3,19,20,492,786,1278,1668
0131-002,2013,3,19,21,316,720,1036,1278
0131-002,2013,3,19,22,326,428,754,1036
0131-002,2013,3,19,23,192,262,454,754
0131-002,2013,3,19,24,120,110,230,454
0131-002,2013,3,20,1,62,82,144,230
0131-002,2013,3,20,2,30,42,72,144
0131-002,2013,3,20,3,16,30,46,72
0131-002,2013,3,20,4,12,24,36,46
0131-002,2013,3,20,5,24,60,84,36
0131-002,2013,3,20,6,72,64,136,84
0131-002,2013,3,20,7,322,138,460,136
0131-002,2013,3,20,8,744,736,1480,460
0131-002,2013,3,20,9,712,1008,1720,1480
0131-002,2013,3,20,10,682,722,1404,1720
0131-002,2013,3,20,11,764,764,1528,1404
0131-002,2013,3,20,12,504,792,1296,1528
0131-002,2013,3,20,13,560,690,1250,1296
0131-002,2013,3,20,14,682,654,1336,1250
0131-002,2013,3,20,15,734,798,1532,1336
0131-002,2013,3,20,16,612,866,1478,1532
0131-002,2013,3,20,17,556,784,1340,1478
0131-002,2013,3,20,18,624,1158,1782,1340
0131-002,2013,3,20,19,604,1084,1688,1782
0131-002,2013,3,20,20,548,654,1202,1688
0131-002,2013,3,20,21,350,608,958,1202
0131-002,2013,3,20,22,286,384,670,958
0131-002,2013,3,20,23,146,232,378,670
0131-002,2013,3,20,24,90,108,198,378
0131-002,2013,3,21,1,86,84,170,198
0131-002,2013,3,21,2,30,44,74,170
0131-002,2013,3,21,3,30,32,62,74
0131-002,2013,3,21,4,12,24,36,62
0131-002,2013,3,21,5,22,34,56,36
0131-002,2013,3,21,6,70,62,132,56
0131-002,2013,3,21,7,418,162,580,132
0131-002,2013,3,21,8,1442,786,2228,580
0131-002,2013,3,21,9,1158,990,2148,2228
0131-002,2013,3,21,10,746,708,1454,2148
0131-002,2013,3,21,11,648,792,1440,1454
0131-002,2013,3,21,12,666,714,1380,1440
0131-002,2013,3,21,13,460,632,1092,1380
0131-002,2013,3,21,14,648,676,1324,1092
0131-002,2013,3,21,15,674,794,1468,1324
0131-002,2013,3,21,16,600,866,1466,1468
0131-002,2013,3,21,17,664,894,1558,1466
0131-002,2013,3,21,18,628,1144,1772,1558
0131-002,2013,3,21,19,646,1182,1828,1772
0131-002,2013,3,21,20,484,780,1264,1828
0131-002,2013,3,21,21,350,686,1036,1264
0131-002,2013,3,21,22,350,342,692,1036
0131-002,2013,3,21,23,174,258,432,692
0131-002,2013,3,21,24,124,150,274,432
0131-002,2013,3,22,1,76,70,146,274
0131-002,2013,3,22,2,40,32,72,146
0131-002,2013,3,22,3,14,34,48,72
0131-002,2013,3,22,4,16,48,64,48
0131-002,2013,3,22,5,38,40,78,64
0131-002,2013,3,22,6,60,56,116,78
0131-002,2013,3,22,7,468,200,668,116
0131-002,2013,3,22,8,1256,852,2108,668
0131-002,2013,3,22,9,862,1052,1914,2108
0131-002,2013,3,22,10,726,832,1558,1914
0131-002,2013,3,22,11,664,864,1528,1558
0131-002,2013,3,22,12,666,834,1500,1528
0131-002,2013,3,22,13,506,742,1248,1500
0131-002,2013,3,22,14,656,690,1346,1248
0131-002,2013,3,22,15,706,892,1598,1346
0131-002,2013,3,22,16,804,924,1728,1598
0131-002,2013,3,22,17,642,988,1630,1728
0131-002,2013,3,22,18,696,1278,1974,1630
0131-002,2013,3,22,19,880,1334,2214,1974
0131-002,2013,3,22,20,610,852,1462,2214
0131-002,2013,3,22,21,390,726,1116,1462
0131-002,2013,3,22,22,286,480,766,1116
0131-002,2013,3,22,23,198,260,458,766
0131-002,2013,3,22,24,122,156,278,458
0131-002,2013,3,23,1,92,82,174,278
0131-002,2013,3,23,2,32,52,84,174
0131-002,2013,3,23,3,34,44,78,84
0131-002,2013,3,23,4,28,42,70,78
0131-002,2013,3,23,5,22,50,72,70
0131-002,2013,3,23,6,70,68,138,72
0131-002,2013,3,23,7,212,146,358,138
0131-002,2013,3,23,8,564,424,988,358
0131-002,2013,3,23,9,706,764,1470,988
0131-002,2013,3,23,10,598,806,1404,1470
0131-002,2013,3,23,11,642,1020,1662,1404
0131-002,2013,3,23,12,530,1090,1620,1662
0131-002,2013,3,23,13,474,1058,1532,1620
0131-002,2013,3,23,14,564,1006,1570,1532
0131-002,2013,3,23,15,568,862,1430,1570
0131-002,2013,3,23,16,548,860,1408,1430
0131-002,2013,3,23,17,600,856,1456,1408
0131-002,2013,3,23,18,728,1062,1790,1456
0131-002,2013,3,23,19,634,796,1430,1790
0131-002,2013,3,23,20,372,578,950,1430
0131-002,2013,3,23,21,334,362,696,950
0131-002,2013,3,23,22,230,256,486,696
0131-002,2013,3,23,23,154,192,346,486
0131-002,2013,3,23,24,86,100,186,346
0131-002,2013,3,24,1,50,66,116,186
0131-002,2013,3,24,2,36,48,84,116
0131-002,2013,3,24,3,18,28,46,84
0131-002,2013,3,24,4,16,18,34,46
0131-002,2013,3,24,5,28,32,60,34
0131-002,2013,3,24,6,38,22,60,60
0131-002,2013,3,24,7,88,70,158,60
0131-002,2013,3,24,8,234,200,434,158
0131-002,2013,3,24,9,270,328,598,434
0131-002,2013,3,24,10,204,330,534,598
0131-002,2013,3,24,11,340,432,772,534
0131-002,2013,3,24,12,328,378,706,772
0131-002,2013,3,24,13,358,452,810,706
0131-002,2013,3,24,14,432,388,820,810
0131-002,2013,3,24,15,508,500,1008,820
0131-002,2013,3,24,16,506,510,1016,1008
0131-002,2013,3,24,17,664,550,1214,1016
0131-002,2013,3,24,18,654,636,1290,1214
0131-002,2013,3,24,19,612,504,1116,1290
0131-002,2013,3,24,20,388,298,686,1116
0131-002,2013,3,24,21,312,284,596,686
0131-002,2013,3,24,22,322,208,530,596
0131-002,2013,3,24,23,180,104,284,530
0131-002,2013,3,24,24,92,86,178,284
0131-002,2013,3,25,1,44,54,98,178
0131-002,2013,3,25,2,12,24,36,98
0131-002,2013,3,25,3,10,30,40,36
0131-002,2013,3,25,4,10,16,26,40
0131-002,2013,3,25,5,22,28,50,26
0131-002,2013,3,25,6,68,50,118,50
0131-002,2013,3,25,7,564,236,800,118
0131-002,2013,3,25,8,1744,868,2612,800
0131-002,2013,3,25,9,1394,1036,2430,2612
0131-002,2013,3,25,10,708,688,1396,2430
0131-002,2013,3,25,11,720,760,1480,1396
0131-002,2013,3,25,12,606,832,1438,1480
0131-002,2013,3,25,13,492,612,1104,1438
0131-002,2013,3,25,14,590,684,1274,1104
0131-002,2013,3,25,15,646,934,1580,1274
0131-002,2013,3,25,16,572,840,1412,1580
0131-002,2013,3,25,17,566,886,1452,1412
0131-002,2013,3,25,18,604,1202,1806,1452
0131-002,2013,3,25,19,628,1064,1692,1806
0131-002,2013,3,25,20,420,782,1202,1692
0131-002,2013,3,25,21,304,634,938,1202
0131-002,2013,3,25,22,228,408,636,938
0131-002,2013,3,25,23,138,240,378,636
0131-002,2013,3,25,24,108,100,208,378
0131-002,2013,3,26,1,50,80,130,208
0131-002,2013,3,26,2,46,44,90,130
0131-002,2013,3,26,3,20,42,62,90
0131-002,2013,3,26,4,22,28,50,62
0131-002,2013,3,26,5,28,52,80,50
0131-002,2013,3,26,6,76,40,116,80
0131-002,2013,3,26,7,452,206,658,116
0131-002,2013,3,26,8,1538,826,2364,658
0131-002,2013,3,26,9,1198,1142,2340,2364
0131-002,2013,3,26,10,730,800,1530,2340
0131-002,2013,3,26,11,706,852,1558,1530
0131-002,2013,3,26,12,666,812,1478,1558
0131-002,2013,3,26,13,574,626,1200,1478
0131-002,2013,3,26,14,694,696,1390,1200
0131-002,2013,3,26,15,684,914,1598,1390
0131-002,2013,3,26,16,644,872,1516,1598
0131-002,2013,3,26,17,632,952,1584,1516
0131-002,2013,3,26,18,702,1120,1822,1584
0131-002,2013,3,26,19,574,1136,1710,1822
0131-002,2013,3,26,20,470,768,1238,1710
0131-002,2013,3,26,21,368,626,994,1238
0131-002,2013,3,26,22,294,428,722,994
0131-002,2013,3,26,23,180,248,428,722
0131-002,2013,3,26,24,84,102,186,428
0131-002,2013,3,27,1,72,86,158,186
0131-002,2013,3,27,2,40,36,76,158
0131-002,2013,3,27,3,12,30,42,76
0131-002,2013,3,27,4,32,38,70,42
0131-002,2013,3,27,5,22,40,62,70
0131-002,2013,3,27,6,62,76,138,62
0131-002,2013,3,27,7,476,162,638,138
0131-002,2013,3,27,8,1424,812,2236,638
0131-002,2013,3,27,9,1234,1102,2336,2236
0131-002,2013,3,27,10,748,774,1522,2336
0131-002,2013,3,27,11,640,840,1480,1522
0131-002,2013,3,27,12,650,756,1406,1480
0131-002,2013,3,27,13,482,626,1108,1406
0131-002,2013,3,27,14,652,722,1374,1108
0131-002,2013,3,27,15,614,942,1556,1374
0131-002,2013,3,27,16,632,868,1500,1556
0131-002,2013,3,27,17,654,888,1542,1500
0131-002,2013,3,27,18,644,1202,1846,1542
0131-002,2013,3,27,19,734,1184,1918,1846
0131-002,2013,3,27,20,492,744,1236,1918
0131-002,2013,3,27,21,368,626,994,1236
0131-002,2013,3,27,22,274,428,702,994
0131-002,2013,3,27,23,158,242,400,702
0131-002,2013,3,27,24,98,142,240,400
0131-002,2013,3,28,1,72,74,146,240
0131-002,2013,3,28,2,24,40,64,146
0131-002,2013,3,28,3,14,32,46,64
0131-002,2013,3,28,4,24,34,58,46
0131-002,2013,3,28,5,40,42,82,58
0131-002,2013,3,28,6,78,74,152,82
0131-002,2013,3,28,7,446,196,642,152
0131-002,2013,3,28,8,1472,852,2324,642
0131-002,2013,3,28,9,1274,1148,2422,2324
0131-002,2013,3,28,10,812,834,1646,2422
0131-002,2013,3,28,11,772,862,1634,1646
0131-002,2013,3,28,12,638,848,1486,1634
0131-002,2013,3,28,13,550,690,1240,1486
0131-002,2013,3,28,14,724,724,1448,1240
0131-002,2013,3,28,15,776,898,1674,1448
0131-002,2013,3,28,16,764,882,1646,1674
0131-002,2013,3,28,17,664,994,1658,1646
0131-002,2013,3,28,18,688,1180,1868,1658
0131-002,2013,3,28,19,668,1220,1888,1868
0131-002,2013,3,28,20,448,854,1302,1888
0131-002,2013,3,28,21,358,612,970,1302
0131-002,2013,3,28,22,320,424,744,970
0131-002,2013,3,28,23,198,198,396,744
0131-002,2013,3,28,24,100,134,234,396
0131-002,2013,3,29,1,60,48,108,234
0131-002,2013,3,29,2,36,72,108,108
0131-002,2013,3,29,3,26,30,56,108
0131-002,2013,3,29,4,28,34,62,56
0131-002,2013,3,29,5,36,42,78,62
0131-002,2013,3,29,6,54,66,120,78
0131-002,2013,3,29,7,464,182,646,120
0131-002,2013,3,29,8,1482,770,2252,646
0131-002,2013,3,29,9,1310,1102,2412,2252
0131-002,2013,3,29,10,732,800,1532,2412
0131-002,2013,3,29,11,756,888,1644,1532
0131-002,2013,3,29,12,688,750,1438,1644
0131-002,2013,3,29,13,468,706,1174,1438
0131-002,2013,3,29,14,658,696,1354,1174
0131-002,2013,3,29,15,720,862,1582,1354
0131-002,2013,3,29,16,722,956,1678,1582
0131-002,2013,3,29,17,706,908,1614,1678
0131-002,2013,3,29,18,704,1262,1966,1614
0131-002,2013,3,29,19,884,1374,2258,1966
0131-002,2013,3,29,20,646,972,1618,2258
0131-002,2013,3,29,21,406,692,1098,1618
0131-002,2013,3,29,22,302,492,794,1098
0131-002,2013,3,29,23,218,264,482,794
0131-002,2013,3,29,24,144,148,292,482
0131-002,2013,3,30,1,88,84,172,292
0131-002,2013,3,30,2,60,80,140,172
0131-002,2013,3,30,3,32,52,84,140
0131-002,2013,3,30,4,16,24,40,84
0131-002,2013,3,30,5,42,70,112,40
0131-002,2013,3,30,6,78,66,144,112
0131-002,2013,3,30,7,280,166,446,144
0131-002,2013,3,30,8,650,456,1106,446
0131-002,2013,3,30,9,728,676,1404,1106
0131-002,2013,3,30,10,592,908,1500,1404
0131-002,2013,3,30,11,658,1234,1892,1500
0131-002,2013,3,30,12,690,1492,2182,1892
0131-002,2013,3,30,13,1098,1368,2466,2182
0131-002,2013,3,30,14,772,1078,1850,2466
0131-002,2013,3,30,15,714,1002,1716,1850
0131-002,2013,3,30,16,670,958,1628,1716
0131-002,2013,3,30,17,610,1170,1780,1628
0131-002,2013,3,30,18,754,1258,2012,1780
0131-002,2013,3,30,19,238,944,1182,2012
0131-002,2013,3,30,20,348,478,826,1182
0131-002,2013,3,30,21,218,304,522,826
0131-002,2013,3,30,22,184,278,462,522
0131-002,2013,3,30,23,98,164,262,462
0131-002,2013,3,30,24,76,102,178,262
0131-002,2013,3,31,1,38,60,98,178
0131-002,2013,3,31,2,26,56,82,98
0131-002,2013,3,31,3,16,34,50,82
0131-002,2013,3,31,4,16,28,44,50
0131-002,2013,3,31,5,8,26,34,44
0131-002,2013,3,31,6,22,22,44,34
0131-002,2013,3,31,7,78,62,140,44
0131-002,2013,3,31,8,154,144,298,140
0131-002,2013,3,31,9,170,278,448,298
0131-002,2013,3,31,10,202,326,528,448
0131-002,2013,3,31,11,314,402,716,528
0131-002,2013,3,31,12,318,378,696,716
0131-002,2013,3,31,13,332,438,770,696
0131-002,2013,3,31,14,432,412,844,770
0131-002,2013,3,31,15,512,558,1070,844
0131-002,2013,3,31,16,586,540,1126,1070
0131-002,2013,3,31,17,684,580,1264,1126
0131-002,2013,3,31,18,728,652,1380,1264
0131-002,2013,3,31,19,680,520,1200,1380
0131-002,2013,3,31,20,446,340,786,1200
0131-002,2013,3,31,21,328,306,634,786
0131-002,2013,3,31,22,284,266,550,634
0131-002,2013,3,31,23,202,156,358,550
0131-002,2013,3,31,24,114,58,172,358
0131-002,2013,4,1,1,42,38,80,172
0131-002,2013,4,1,2,38,30,68,80
0131-002,2013,4,1,3,20,18,38,68
0131-002,2013,4,1,4,12,16,28,38
0131-002,2013,4,1,5,32,32,64,28
0131-002,2013,4,1,6,98,76,174,64
0131-002,2013,4,1,7,450,264,714,174
0131-002,2013,4,1,8,1428,864,2292,714
0131-002,2013,4,1,9,1198,1066,2264,2292
0131-002,2013,4,1,10,666,752,1418,2264
0131-002,2013,4,1,11,824,790,1614,1418
0131-002,2013,4,1,12,726,746,1472,1614
0131-002,2013,4,1,13,606,658,1264,1472
0131-002,2013,4,1,14,676,758,1434,1264
0131-002,2013,4,1,15,784,828,1612,1434
0131-002,2013,4,1,16,738,834,1572,1612
0131-002,2013,4,1,17,774,844,1618,1572
0131-002,2013,4,1,18,814,1052,1866,1618
0131-002,2013,4,1,19,846,1094,1940,1866
0131-002,2013,4,1,20,570,788,1358,1940
0131-002,2013,4,1,21,418,664,1082,1358
0131-002,2013,4,1,22,350,444,794,1082
0131-002,2013,4,1,23,190,230,420,794
0131-002,2013,4,1,24,130,120,250,420
0131-002,2013,4,2,1,58,66,124,250
0131-002,2013,4,2,2,34,30,64,124
0131-002,2013,4,2,3,42,36,78,64
0131-002,2013,4,2,4,20,22,42,78
0131-002,2013,4,2,5,20,38,58,42
0131-002,2013,4,2,6,54,48,102,58
0131-002,2013,4,2,7,304,146,450,102
0131-002,2013,4,2,8,1182,764,1946,450
0131-002,2013,4,2,9,1102,1012,2114,1946
0131-002,2013,4,2,10,752,768,1520,2114
0131-002,2013,4,2,11,838,786,1624,1520
0131-002,2013,4,2,12,766,762,1528,1624
0131-002,2013,4,2,13,710,646,1356,1528
0131-002,2013,4,2,14,630,726,1356,1356
0131-002,2013,4,2,15,746,838,1584,1356
0131-002,2013,4,2,16,758,824,1582,1584
0131-002,2013,4,2,17,778,870,1648,1582
0131-002,2013,4,2,18,750,1034,1784,1648
0131-002,2013,4,2,19,808,1026,1834,1784
0131-002,2013,4,2,20,558,738,1296,1834
0131-002,2013,4,2,21,492,704,1196,1296
0131-002,2013,4,2,22,310,428,738,1196
0131-002,2013,4,2,23,188,204,392,738
0131-002,2013,4,2,24,78,82,160,392
0131-002,2013,4,3,1,68,58,126,160
0131-002,2013,4,3,2,48,38,86,126
0131-002,2013,4,3,3,24,28,52,86
0131-002,2013,4,3,4,28,30,58,52
0131-002,2013,4,3,5,52,50,102,58
0131-002,2013,4,3,6,98,64,162,102
0131-002,2013,4,3,7,334,184,518,162
0131-002,2013,4,3,8,1192,762,1954,518
0131-002,2013,4,3,9,1136,1056,2192,1954
0131-002,2013,4,3,10,814,818,1632,2192
0131-002,2013,4,3,11,754,746,1500,1632
0131-002,2013,4,3,12,700,684,1384,1500
0131-002,2013,4,3,13,562,628,1190,1384
0131-002,2013,4,3,14,690,724,1414,1190
0131-002,2013,4,3,15,900,896,1796,1414
0131-002,2013,4,3,16,858,896,1754,1796
0131-002,2013,4,3,17,752,902,1654,1754
0131-002,2013,4,3,18,960,1246,2206,1654
0131-002,2013,4,3,19,936,1212,2148,2206
0131-002,2013,4,3,20,578,794,1372,2148
0131-002,2013,4,3,21,396,616,1012,1372
0131-002,2013,4,3,22,342,428,770,1012
0131-002,2013,4,3,23,190,206,396,770
0131-002,2013,4,3,24,76,100,176,396
0131-002,2013,4,4,1,82,94,176,176
0131-002,2013,4,4,2,78,60,138,176
0131-002,2013,4,4,3,38,34,72,138
0131-002,2013,4,4,4,36,38,74,72
0131-002,2013,4,4,5,36,50,86,74
0131-002,2013,4,4,6,82,62,144,86
0131-002,2013,4,4,7,302,198,500,144
0131-002,2013,4,4,8,1224,816,2040,500
0131-002,2013,4,4,9,1218,1150,2368,2040
0131-002,2013,4,4,10,714,738,1452,2368
0131-002,2013,4,4,11,732,762,1494,1452
0131-002,2013,4,4,12,800,836,1636,1494
0131-002,2013,4,4,13,612,720,1332,1636
0131-002,2013,4,4,14,644,692,1336,1332
0131-002,2013,4,4,15,744,862,1606,1336
0131-002,2013,4,4,16,788,814,1602,1606
0131-002,2013,4,4,17,942,928,1870,1602
0131-002,2013,4,4,18,918,1140,2058,1870
0131-002,2013,4,4,19,810,1058,1868,2058
0131-002,2013,4,4,20,576,728,1304,1868
0131-002,2013,4,4,21,508,636,1144,1304
0131-002,2013,4,4,22,356,468,824,1144
0131-002,2013,4,4,23,242,252,494,824
0131-002,2013,4,4,24,128,132,260,494
0131-002,2013,4,5,1,84,86,170,260
0131-002,2013,4,5,2,32,40,72,170
0131-002,2013,4,5,3,30,26,56,72
0131-002,2013,4,5,4,18,26,44,56
0131-002,2013,4,5,5,42,50,92,44
0131-002,2013,4,5,6,106,68,174,92
0131-002,2013,4,5,7,420,244,664,174
0131-002,2013,4,5,8,1372,876,2248,664
0131-002,2013,4,5,9,1134,1042,2176,2248
0131-002,2013,4,5,10,950,884,1834,2176
0131-002,2013,4,5,11,822,904,1726,1834
0131-002,2013,4,5,12,702,784,1486,1726
0131-002,2013,4,5,13,538,646,1184,1486
0131-002,2013,4,5,14,784,756,1540,1184
0131-002,2013,4,5,15,824,942,1766,1540
0131-002,2013,4,5,16,830,948,1778,1766
0131-002,2013,4,5,17,962,1018,1980,1778
0131-002,2013,4,5,18,1044,1300,2344,1980
0131-002,2013,4,5,19,1172,1400,2572,2344
0131-002,2013,4,5,20,830,1042,1872,2572
0131-002,2013,4,5,21,490,680,1170,1872
0131-002,2013,4,5,22,392,482,874,1170
0131-002,2013,4,5,23,242,266,508,874
0131-002,2013,4,5,24,152,162,314,508
0131-002,2013,4,6,1,106,102,208,314
0131-002,2013,4,6,2,54,68,122,208
0131-002,2013,4,6,3,48,56,104,122
0131-002,2013,4,6,4,32,38,70,104
0131-002,2013,4,6,5,54,56,110,70
0131-002,2013,4,6,6,48,40,88,110
0131-002,2013,4,6,7,106,84,190,88
0131-002,2013,4,6,8,452,320,772,190
0131-002,2013,4,6,9,510,548,1058,772
0131-002,2013,4,6,10,514,654,1168,1058
0131-002,2013,4,6,11,616,952,1568,1168
0131-002,2013,4,6,12,626,1048,1674,1568
0131-002,2013,4,6,13,556,1014,1570,1674
0131-002,2013,4,6,14,580,1014,1594,1570
0131-002,2013,4,6,15,604,954,1558,1594
0131-002,2013,4,6,16,520,744,1264,1558
0131-002,2013,4,6,17,690,832,1522,1264
0131-002,2013,4,6,18,702,776,1478,1522
0131-002,2013,4,6,19,664,618,1282,1478
0131-002,2013,4,6,20,434,344,778,1282
0131-002,2013,4,6,21,306,306,612,778
0131-002,2013,4,6,22,206,190,396,612
0131-002,2013,4,6,23,124,124,248,396
0131-002,2013,4,6,24,62,60,122,248
0131-002,2013,4,7,1,76,82,158,122
0131-002,2013,4,7,2,48,44,92,158
0131-002,2013,4,7,3,22,26,48,92
0131-002,2013,4,7,4,38,32,70,48
0131-002,2013,4,7,5,34,18,52,70
0131-002,2013,4,7,6,32,36,68,52
0131-002,2013,4,7,7,82,66,148,68
0131-002,2013,4,7,8,134,106,240,148
0131-002,2013,4,7,9,206,258,464,240
0131-002,2013,4,7,10,376,350,726,464
0131-002,2013,4,7,11,370,404,774,726
0131-002,2013,4,7,12,358,398,756,774
0131-002,2013,4,7,13,388,394,782,756
0131-002,2013,4,7,14,398,380,778,782
0131-002,2013,4,7,15,628,526,1154,778
0131-002,2013,4,7,16,722,482,1204,1154
0131-002,2013,4,7,17,788,488,1276,1204
0131-002,2013,4,7,18,740,512,1252,1276
0131-002,2013,4,7,19,744,408,1152,1252
0131-002,2013,4,7,20,582,306,888,1152
0131-002,2013,4,7,21,566,268,834,888
0131-002,2013,4,7,22,558,220,778,834
0131-002,2013,4,7,23,168,114,282,778
0131-002,2013,4,7,24,112,66,178,282
0131-002,2013,4,8,1,50,38,88,178
0131-002,2013,4,8,2,22,24,46,88
0131-002,2013,4,8,3,22,20,42,46
0131-002,2013,4,8,4,8,6,14,42
0131-002,2013,4,8,5,18,26,44,14
0131-002,2013,4,8,6,80,68,148,44
0131-002,2013,4,8,7,452,242,694,148
0131-002,2013,4,8,8,1316,886,2202,694
0131-002,2013,4,8,9,1106,1034,2140,2202
0131-002,2013,4,8,10,788,812,1600,2140
0131-002,2013,4,8,11,688,754,1442,1600
0131-002,2013,4,8,12,716,762,1478,1442
0131-002,2013,4,8,13,628,612,1240,1478
0131-002,2013,4,8,14,676,690,1366,1240
0131-002,2013,4,8,15,876,842,1718,1366
0131-002,2013,4,8,16,678,754,1432,1718
0131-002,2013,4,8,17,820,886,1706,1432
0131-002,2013,4,8,18,840,1084,1924,1706
0131-002,2013,4,8,19,808,1068,1876,1924
0131-002,2013,4,8,20,464,698,1162,1876
0131-002,2013,4,8,21,400,632,1032,1162
0131-002,2013,4,8,22,354,422,776,1032
0131-002,2013,4,8,23,170,166,336,776
0131-002,2013,4,8,24,116,108,224,336
0131-002,2013,4,9,1,82,86,168,224
0131-002,2013,4,9,2,38,44,82,168
0131-002,2013,4,9,3,16,24,40,82
0131-002,2013,4,9,4,42,32,74,40
0131-002,2013,4,9,5,34,44,78,74
0131-002,2013,4,9,6,108,76,184,78
0131-002,2013,4,9,7,338,196,534,184
0131-002,2013,4,9,8,1310,806,2116,534
0131-002,2013,4,9,9,1100,1032,2132,2116
0131-002,2013,4,9,10,726,738,1464,2132
0131-002,2013,4,9,11,834,848,1682,1464
0131-002,2013,4,9,12,644,670,1314,1682
0131-002,2013,4,9,13,622,614,1236,1314
0131-002,2013,4,9,14,672,666,1338,1236
0131-002,2013,4,9,15,768,842,1610,1338
0131-002,2013,4,9,16,678,774,1452,1610
0131-002,2013,4,9,17,980,950,1930,1452
0131-002,2013,4,9,18,800,1030,1830,1930
0131-002,2013,4,9,19,878,1136,2014,1830
0131-002,2013,4,9,20,624,778,1402,2014
0131-002,2013,4,9,21,484,644,1128,1402
0131-002,2013,4,9,22,372,430,802,1128
0131-002,2013,4,9,23,220,250,470,802
0131-002,2013,4,9,24,108,100,208,470
0131-002,2013,4,10,1,60,66,126,208
0131-002,2013,4,10,2,36,36,72,126
0131-002,2013,4,10,3,28,20,48,72
0131-002,2013,4,10,4,22,24,46,48
0131-002,2013,4,10,5,22,26,48,46
0131-002,2013,4,10,6,148,72,220,48
0131-002,2013,4,10,7,296,220,516,220
0131-002,2013,4,10,8,1244,786,2030,516
0131-002,2013,4,10,9,1372,1110,2482,2030
0131-002,2013,4,10,10,816,812,1628,2482
0131-002,2013,4,10,11,940,862,1802,1628
0131-002,2013,4,10,12,620,708,1328,1802
0131-002,2013,4,10,13,550,606,1156,1328
0131-002,2013,4,10,14,628,666,1294,1156
0131-002,2013,4,10,15,762,764,1526,1294
0131-002,2013,4,10,16,906,882,1788,1526
0131-002,2013,4,10,17,802,894,1696,1788
0131-002,2013,4,10,18,992,1226,2218,1696
0131-002,2013,4,10,19,932,1186,2118,2218
0131-002,2013,4,10,20,682,732,1414,2118
0131-002,2013,4,10,21,508,628,1136,1414
0131-002,2013,4,10,22,454,456,910,1136
0131-002,2013,4,10,23,178,190,368,910
0131-002,2013,4,10,24,132,120,252,368
0131-002,2013,4,11,1,92,92,184,252
0131-002,2013,4,11,2,48,42,90,184
0131-002,2013,4,11,3,44,40,84,90
0131-002,2013,4,11,4,20,34,54,84
0131-002,2013,4,11,5,30,38,68,54
0131-002,2013,4,11,6,78,56,134,68
0131-002,2013,4,11,7,324,202,526,134
0131-002,2013,4,11,8,1258,804,2062,526
0131-002,2013,4,11,9,1106,1106,2212,2062
0131-002,2013,4,11,10,836,860,1696,2212
0131-002,2013,4,11,11,784,794,1578,1696
0131-002,2013,4,11,12,774,814,1588,1578
0131-002,2013,4,11,13,556,582,1138,1588
0131-002,2013,4,11,14,620,636,1256,1138
0131-002,2013,4,11,15,866,926,1792,1256
0131-002,2013,4,11,16,748,858,1606,1792
0131-002,2013,4,11,17,838,862,1700,1606
0131-002,2013,4,11,18,758,1060,1818,1700
0131-002,2013,4,11,19,852,1136,1988,1818
0131-002,2013,4,11,20,534,744,1278,1988
0131-002,2013,4,11,21,480,694,1174,1278
0131-002,2013,4,11,22,396,418,814,1174
0131-002,2013,4,11,23,260,270,530,814
0131-002,2013,4,11,24,94,118,212,530
0131-002,2013,4,12,1,82,70,152,212
0131-002,2013,4,12,2,68,60,128,152
0131-002,2013,4,12,3,40,40,80,128
0131-002,2013,4,12,4,24,30,54,80
0131-002,2013,4,12,5,38,56,94,54
0131-002,2013,4,12,6,96,64,160,94
0131-002,2013,4,12,7,374,208,582,160
0131-002,2013,4,12,8,1310,856,2166,582
0131-002,2013,4,12,9,1114,1134,2248,2166
0131-002,2013,4,12,10,762,818,1580,2248
0131-002,2013,4,12,11,674,736,1410,1580
0131-002,2013,4,12,12,792,804,1596,1410
0131-002,2013,4,12,13,592,624,1216,1596
0131-002,2013,4,12,14,652,724,1376,1216
0131-002,2013,4,12,15,750,846,1596,1376
0131-002,2013,4,12,16,826,862,1688,1596
0131-002,2013,4,12,17,878,1082,1960,1688
0131-002,2013,4,12,18,1364,1310,2674,1960
0131-002,2013,4,12,19,1234,1436,2670,2674
0131-002,2013,4,12,20,830,1008,1838,2670
0131-002,2013,4,12,21,500,718,1218,1838
0131-002,2013,4,12,22,372,522,894,1218
0131-002,2013,4,12,23,200,224,424,894
0131-002,2013,4,12,24,168,154,322,424
0131-002,2013,4,13,1,96,98,194,322
0131-002,2013,4,13,2,72,58,130,194
0131-002,2013,4,13,3,44,46,90,130
0131-002,2013,4,13,4,34,50,84,90
0131-002,2013,4,13,5,38,62,100,84
0131-002,2013,4,13,6,120,72,192,100
0131-002,2013,4,13,7,338,232,570,192
0131-002,2013,4,13,8,642,452,1094,570
0131-002,2013,4,13,9,796,864,1660,1094
0131-002,2013,4,13,10,936,1150,2086,1660
0131-002,2013,4,13,11,858,1418,2276,2086
0131-002,2013,4,13,12,862,1550,2412,2276
0131-002,2013,4,13,13,692,1498,2190,2412
0131-002,2013,4,13,14,644,1146,1790,2190
0131-002,2013,4,13,15,898,1380,2278,1790
0131-002,2013,4,13,16,708,1160,1868,2278
0131-002,2013,4,13,17,1094,1336,2430,1868
0131-002,2013,4,13,18,1162,1376,2538,2430
0131-002,2013,4,13,19,1092,1160,2252,2538
0131-002,2013,4,13,20,644,596,1240,2252
0131-002,2013,4,13,21,400,388,788,1240
0131-002,2013,4,13,22,330,274,604,788
0131-002,2013,4,13,23,154,148,302,604
0131-002,2013,4,13,24,116,96,212,302
0131-002,2013,4,14,1,52,68,120,212
0131-002,2013,4,14,2,44,50,94,120
0131-002,2013,4,14,3,28,24,52,94
0131-002,2013,4,14,4,36,34,70,52
0131-002,2013,4,14,5,28,22,50,70
0131-002,2013,4,14,6,44,44,88,50
0131-002,2013,4,14,7,106,82,188,88
0131-002,2013,4,14,8,156,136,292,188
0131-002,2013,4,14,9,222,284,506,292
0131-002,2013,4,14,10,266,334,600,506
0131-002,2013,4,14,11,376,440,816,600
0131-002,2013,4,14,12,402,430,832,816
0131-002,2013,4,14,13,388,404,792,832
0131-002,2013,4,14,14,534,400,934,792
0131-002,2013,4,14,15,680,510,1190,934
0131-002,2013,4,14,16,812,538,1350,1190
0131-002,2013,4,14,17,740,492,1232,1350
0131-002,2013,4,14,18,918,522,1440,1232
0131-002,2013,4,14,19,794,466,1260,1440
0131-002,2013,4,14,20,652,326,978,1260
0131-002,2013,4,14,21,604,292,896,978
0131-002,2013,4,14,22,556,228,784,896
0131-002,2013,4,14,23,236,132,368,784
0131-002,2013,4,14,24,144,78,222,368
0131-002,2013,4,15,1,72,42,114,222
0131-002,2013,4,15,2,36,26,62,114
0131-002,2013,4,15,3,18,16,34,62
0131-002,2013,4,15,4,16,18,34,34
0131-002,2013,4,15,5,30,30,60,34
0131-002,2013,4,15,6,116,90,206,60
0131-002,2013,4,15,7,452,266,718,206
0131-002,2013,4,15,8,1404,922,2326,718
0131-002,2013,4,15,9,1004,968,1972,2326
0131-002,2013,4,15,10,732,772,1504,1972
0131-002,2013,4,15,11,900,860,1760,1504
0131-002,2013,4,15,12,678,774,1452,1760
0131-002,2013,4,15,13,566,654,1220,1452
0131-002,2013,4,15,14,610,768,1378,1220
0131-002,2013,4,15,15,764,800,1564,1378
0131-002,2013,4,15,16,924,966,1890,1564
0131-002,2013,4,15,17,858,940,1798,1890
0131-002,2013,4,15,18,774,1068,1842,1798
0131-002,2013,4,15,19,816,1032,1848,1842
0131-002,2013,4,15,20,462,682,1144,1848
0131-002,2013,4,15,21,440,664,1104,1144
0131-002,2013,4,15,22,292,402,694,1104
0131-002,2013,4,15,23,198,222,420,694
0131-002,2013,4,15,24,112,102,214,420
0131-002,2013,4,16,1,34,44,78,214
0131-002,2013,4,16,2,36,38,74,78
0131-002,2013,4,16,3,20,22,42,74
0131-002,2013,4,16,4,24,18,42,42
0131-002,2013,4,16,5,38,48,86,42
0131-002,2013,4,16,6,132,78,210,86
0131-002,2013,4,16,7,386,222,608,210
0131-002,2013,4,16,8,1248,838,2086,608
0131-002,2013,4,16,9,1100,1098,2198,2086
0131-002,2013,4,16,10,792,874,1666,2198
0131-002,2013,4,16,11,818,806,1624,1666
0131-002,2013,4,16,12,678,754,1432,1624
0131-002,2013,4,16,13,720,700,1420,1432
0131-002,2013,4,16,14,608,666,1274,1420
0131-002,2013,4,16,15,798,828,1626,1274
0131-002,2013,4,16,16,886,912,1798,1626
0131-002,2013,4,16,17,828,860,1688,1798
0131-002,2013,4,16,18,816,1140,1956,1688
0131-002,2013,4,16,19,760,1122,1882,1956
0131-002,2013,4,16,20,538,748,1286,1882
0131-002,2013,4,16,21,410,622,1032,1286
0131-002,2013,4,16,22,430,470,900,1032
0131-002,2013,4,16,23,176,180,356,900
0131-002,2013,4,16,24,154,136,290,356
0131-002,2013,4,17,1,80,70,150,290
0131-002,2013,4,17,2,50,54,104,150
0131-002,2013,4,17,3,32,30,62,104
0131-002,2013,4,17,4,26,34,60,62
0131-002,2013,4,17,5,56,48,104,60
0131-002,2013,4,17,6,124,88,212,104
0131-002,2013,4,17,7,396,210,606,212
0131-002,2013,4,17,8,1322,854,2176,606
0131-002,2013,4,17,9,1090,1088,2178,2176
0131-002,2013,4,17,10,750,836,1586,2178
0131-002,2013,4,17,11,816,814,1630,1586
0131-002,2013,4,17,12,860,918,1778,1630
0131-002,2013,4,17,13,598,666,1264,1778
0131-002,2013,4,17,14,682,678,1360,1264
0131-002,2013,4,17,15,796,814,1610,1360
0131-002,2013,4,17,16,766,860,1626,1610
0131-002,2013,4,17,17,832,938,1770,1626
0131-002,2013,4,17,18,844,1214,2058,1770
0131-002,2013,4,17,19,916,1174,2090,2058
0131-002,2013,4,17,20,518,710,1228,2090
0131-002,2013,4,17,21,372,592,964,1228
0131-002,2013,4,17,22,372,398,770,964
0131-002,2013,4,17,23,236,246,482,770
0131-002,2013,4,17,24,98,112,210,482
0131-002,2013,4,18,1,56,62,118,210
0131-002,2013,4,18,2,42,44,86,118
0131-002,2013,4,18,3,28,28,56,86
0131-002,2013,4,18,4,20,26,46,56
0131-002,2013,4,18,5,52,56,108,46
0131-002,2013,4,18,6,132,102,234,108
0131-002,2013,4,18,7,414,224,638,234
0131-002,2013,4,18,8,1302,880,2182,638
0131-002,2013,4,18,9,1166,1084,2250,2182
0131-002,2013,4,18,10,798,856,1654,2250
0131-002,2013,4,18,11,752,808,1560,1654
0131-002,2013,4,18,12,796,766,1562,1560
0131-002,2013,4,18,13,584,654,1238,1562
0131-002,2013,4,18,14,682,728,1410,1238
0131-002,2013,4,18,15,706,784,1490,1410
0131-002,2013,4,18,16,884,918,1802,1490
0131-002,2013,4,18,17,794,962,1756,1802
0131-002,2013,4,18,18,886,1088,1974,1756
0131-002,2013,4,18,19,908,1132,2040,1974
0131-002,2013,4,18,20,642,796,1438,2040
0131-002,2013,4,18,21,398,630,1028,1438
0131-002,2013,4,18,22,422,436,858,1028
0131-002,2013,4,18,23,230,238,468,858
0131-002,2013,4,18,24,118,130,248,468
0131-002,2013,4,19,1,58,76,134,248
0131-002,2013,4,19,2,76,54,130,134
0131-002,2013,4,19,3,38,36,74,130
0131-002,2013,4,19,4,20,28,48,74
0131-002,2013,4,19,5,56,46,102,48
0131-002,2013,4,19,6,86,72,158,102
0131-002,2013,4,19,7,470,220,690,158
0131-002,2013,4,19,8,1354,886,2240,690
0131-002,2013,4,19,9,1074,1100,2174,2240
0131-002,2013,4,19,10,746,842,1588,2174
0131-002,2013,4,19,11,758,776,1534,1588
0131-002,2013,4,19,12,748,802,1550,1534
0131-002,2013,4,19,13,544,664,1208,1550
0131-002,2013,4,19,14,700,720,1420,1208
0131-002,2013,4,19,15,768,846,1614,1420
0131-002,2013,4,19,16,880,888,1768,1614
0131-002,2013,4,19,17,938,1082,2020,1768
0131-002,2013,4,19,18,1066,1330,2396,2020
0131-002,2013,4,19,19,1098,1358,2456,2396
0131-002,2013,4,19,20,688,958,1646,2456
0131-002,2013,4,19,21,486,734,1220,1646
0131-002,2013,4,19,22,394,508,902,1220
0131-002,2013,4,19,23,162,234,396,902
0131-002,2013,4,19,24,150,156,306,396
0131-002,2013,4,20,1,92,94,186,306
0131-002,2013,4,20,2,74,68,142,186
0131-002,2013,4,20,3,28,36,64,142
0131-002,2013,4,20,4,36,58,94,64
0131-002,2013,4,20,5,26,38,64,94
0131-002,2013,4,20,6,64,52,116,64
0131-002,2013,4,20,7,176,142,318,116
0131-002,2013,4,20,8,568,440,1008,318
0131-002,2013,4,20,9,696,716,1412,1008
0131-002,2013,4,20,10,820,782,1602,1412
0131-002,2013,4,20,11,1102,1290,2392,1602
0131-002,2013,4,20,12,1006,1240,2246,2392
0131-002,2013,4,20,13,1048,1330,2378,2246
0131-002,2013,4,20,14,1008,1280,2288,2378
0131-002,2013,4,20,15,1068,1086,2154,2288
0131-002,2013,4,20,16,1254,1096,2350,2154
0131-002,2013,4,20,17,1438,1366,2804,2350
0131-002,2013,4,20,18,1304,1208,2512,2804
0131-002,2013,4,20,19,834,894,1728,2512
0131-002,2013,4,20,20,528,514,1042,1728
0131-002,2013,4,20,21,364,334,698,1042
0131-002,2013,4,20,22,208,224,432,698
0131-002,2013,4,20,23,126,142,268,432
0131-002,2013,4,20,24,106,94,200,268
0131-002,2013,4,21,1,64,54,118,200
0131-002,2013,4,21,2,38,54,92,118
0131-002,2013,4,21,3,16,22,38,92
0131-002,2013,4,21,4,36,34,70,38
0131-002,2013,4,21,5,20,24,44,70
0131-002,2013,4,21,6,48,52,100,44
0131-002,2013,4,21,7,130,98,228,100
0131-002,2013,4,21,8,154,166,320,228
0131-002,2013,4,21,9,278,310,588,320
0131-002,2013,4,21,10,286,316,602,588
0131-002,2013,4,21,11,438,474,912,602
0131-002,2013,4,21,12,450,460,910,912
0131-002,2013,4,21,13,392,414,806,910
0131-002,2013,4,21,14,366,418,784,806
0131-002,2013,4,21,15,522,494,1016,784
0131-002,2013,4,21,16,712,594,1306,1016
0131-002,2013,4,21,17,706,494,1200,1306
0131-002,2013,4,21,18,668,530,1198,1200
0131-002,2013,4,21,19,730,522,1252,1198
0131-002,2013,4,21,20,442,346,788,1252
0131-002,2013,4,21,21,320,316,636,788
0131-002,2013,4,21,22,316,236,552,636
0131-002,2013,4,21,23,198,150,348,552
0131-002,2013,4,21,24,104,88,192,348
0131-002,2013,4,22,1,32,38,70,192
0131-002,2013,4,22,2,20,20,40,70
0131-002,2013,4,22,3,24,22,46,40
0131-002,2013,4,22,4,28,30,58,46
0131-002,2013,4,22,5,28,36,64,58
0131-002,2013,4,22,6,96,86,182,64
0131-002,2013,4,22,7,544,292,836,182
0131-002,2013,4,22,8,1454,976,2430,836
0131-002,2013,4,22,9,1032,1030,2062,2430
0131-002,2013,4,22,10,770,752,1522,2062
0131-002,2013,4,22,11,680,740,1420,1522
0131-002,2013,4,22,12,636,756,1392,1420
0131-002,2013,4,22,13,518,600,1118,1392
0131-002,2013,4,22,14,654,736,1390,1118
0131-002,2013,4,22,15,766,814,1580,1390
0131-002,2013,4,22,16,720,802,1522,1580
0131-002,2013,4,22,17,778,858,1636,1522
0131-002,2013,4,22,18,928,1160,2088,1636
0131-002,2013,4,22,19,942,1110,2052,2088
0131-002,2013,4,22,20,542,786,1328,2052
0131-002,2013,4,22,21,494,688,1182,1328
0131-002,2013,4,22,22,418,482,900,1182
0131-002,2013,4,22,23,210,248,458,900
0131-002,2013,4,22,24,114,134,248,458
0131-002,2013,4,23,1,68,70,138,248
0131-002,2013,4,23,2,40,34,74,138
0131-002,2013,4,23,3,22,32,54,74
0131-002,2013,4,23,4,44,38,82,54
0131-002,2013,4,23,5,36,34,70,82
0131-002,2013,4,23,6,128,96,224,70
0131-002,2013,4,23,7,364,216,580,224
0131-002,2013,4,23,8,1254,888,2142,580
0131-002,2013,4,23,9,1050,1144,2194,2142
0131-002,2013,4,23,10,942,890,1832,2194
0131-002,2013,4,23,11,836,834,1670,1832
0131-002,2013,4,23,12,648,738,1386,1670
0131-002,2013,4,23,13,596,626,1222,1386
0131-002,2013,4,23,14,734,792,1526,1222
0131-002,2013,4,23,15,674,760,1434,1526
0131-002,2013,4,23,16,710,704,1414,1434
0131-002,2013,4,23,17,656,762,1418,1414
0131-002,2013,4,23,18,708,878,1586,1418
0131-002,2013,4,23,19,624,892,1516,1586
0131-002,2013,4,23,20,474,576,1050,1516
0131-002,2013,4,23,21,464,604,1068,1050
0131-002,2013,4,23,22,294,384,678,1068
0131-002,2013,4,23,23,138,176,314,678
0131-002,2013,4,23,24,118,146,264,314
0131-002,2013,4,24,1,58,80,138,264
0131-002,2013,4,24,2,44,48,92,138
0131-002,2013,4,24,3,52,40,92,92
0131-002,2013,4,24,4,14,18,32,92
0131-002,2013,4,24,5,34,36,70,32
0131-002,2013,4,24,6,108,74,182,70
0131-002,2013,4,24,7,424,194,618,182
0131-002,2013,4,24,8,1290,848,2138,618
0131-002,2013,4,24,9,1130,1054,2184,2138
0131-002,2013,4,24,10,854,934,1788,2184
0131-002,2013,4,24,11,812,806,1618,1788
0131-002,2013,4,24,12,752,742,1494,1618
0131-002,2013,4,24,13,588,668,1256,1494
0131-002,2013,4,24,14,652,786,1438,1256
0131-002,2013,4,24,15,984,920,1904,1438
0131-002,2013,4,24,16,746,848,1594,1904
0131-002,2013,4,24,17,838,904,1742,1594
0131-002,2013,4,24,18,814,1070,1884,1742
0131-002,2013,4,24,19,824,1156,1980,1884
0131-002,2013,4,24,20,646,774,1420,1980
0131-002,2013,4,24,21,430,660,1090,1420
0131-002,2013,4,24,22,400,482,882,1090
0131-002,2013,4,24,23,242,238,480,882
0131-002,2013,4,24,24,124,116,240,480
0131-002,2013,4,25,1,80,60,140,240
0131-002,2013,4,25,2,40,42,82,140
0131-002,2013,4,25,3,32,32,64,82
0131-002,2013,4,25,4,18,20,38,64
0131-002,2013,4,25,5,38,46,84,38
0131-002,2013,4,25,6,108,84,192,84
0131-002,2013,4,25,7,528,256,784,192
0131-002,2013,4,25,8,1316,922,2238,784
0131-002,2013,4,25,9,1102,1176,2278,2238
0131-002,2013,4,25,10,726,744,1470,2278
0131-002,2013,4,25,11,840,820,1660,1470
0131-002,2013,4,25,12,720,742,1462,1660
0131-002,2013,4,25,13,588,646,1234,1462
0131-002,2013,4,25,14,640,666,1306,1234
0131-002,2013,4,25,15,748,830,1578,1306
0131-002,2013,4,25,16,844,852,1696,1578
0131-002,2013,4,25,17,832,906,1738,1696
0131-002,2013,4,25,18,800,996,1796,1738
0131-002,2013,4,25,19,872,1050,1922,1796
0131-002,2013,4,25,20,532,702,1234,1922
0131-002,2013,4,25,21,424,636,1060,1234
0131-002,2013,4,25,22,384,464,848,1060
0131-002,2013,4,25,23,206,234,440,848
0131-002,2013,4,25,24,88,88,176,440
0131-002,2013,4,26,1,70,80,150,176
0131-002,2013,4,26,2,44,46,90,150
0131-002,2013,4,26,3,22,30,52,90
0131-002,2013,4,26,4,28,24,52,52
0131-002,2013,4,26,5,24,34,58,52
0131-002,2013,4,26,6,118,78,196,58
0131-002,2013,4,26,7,438,230,668,196
0131-002,2013,4,26,8,1358,914,2272,668
0131-002,2013,4,26,9,1080,1064,2144,2272
0131-002,2013,4,26,10,886,866,1752,2144
0131-002,2013,4,26,11,862,816,1678,1752
0131-002,2013,4,26,12,722,798,1520,1678
0131-002,2013,4,26,13,592,704,1296,1520
0131-002,2013,4,26,14,680,716,1396,1296
0131-002,2013,4,26,15,744,846,1590,1396
0131-002,2013,4,26,16,860,914,1774,1590
0131-002,2013,4,26,17,1008,1080,2088,1774
0131-002,2013,4,26,18,1026,1348,2374,2088
0131-002,2013,4,26,19,1130,1280,2410,2374
0131-002,2013,4,26,20,716,908,1624,2410
0131-002,2013,4,26,21,612,748,1360,1624
0131-002,2013,4,26,22,386,492,878,1360
0131-002,2013,4,26,23,240,244,484,878
0131-002,2013,4,26,24,146,158,304,484
0131-002,2013,4,27,1,128,132,260,304
0131-002,2013,4,27,2,72,66,138,260
0131-002,2013,4,27,3,34,46,80,138
0131-002,2013,4,27,4,30,34,64,80
0131-002,2013,4,27,5,38,56,94,64
0131-002,2013,4,27,6,140,88,228,94
0131-002,2013,4,27,7,300,224,524,228
0131-002,2013,4,27,8,718,514,1232,524
0131-002,2013,4,27,9,712,796,1508,1232
0131-002,2013,4,27,10,730,918,1648,1508
0131-002,2013,4,27,11,752,1096,1848,1648
0131-002,2013,4,27,12,844,1296,2140,1848
0131-002,2013,4,27,13,766,1196,1962,2140
0131-002,2013,4,27,14,744,1074,1818,1962
0131-002,2013,4,27,15,722,1030,1752,1818
0131-002,2013,4,27,16,764,1014,1778,1752
0131-002,2013,4,27,17,718,994,1712,1778
0131-002,2013,4,27,18,714,1132,1846,1712
0131-002,2013,4,27,19,658,890,1548,1846
0131-002,2013,4,27,20,450,508,958,1548
0131-002,2013,4,27,21,350,350,700,958
0131-002,2013,4,27,22,240,244,484,700
0131-002,2013,4,27,23,182,194,376,484
0131-002,2013,4,27,24,142,138,280,376
0131-002,2013,4,28,1,66,60,126,280
0131-002,2013,4,28,2,70,66,136,126
0131-002,2013,4,28,3,38,40,78,136
0131-002,2013,4,28,4,28,36,64,78
0131-002,2013,4,28,5,16,16,32,64
0131-002,2013,4,28,6,46,34,80,32
0131-002,2013,4,28,7,128,88,216,80
0131-002,2013,4,28,8,294,242,536,216
0131-002,2013,4,28,9,316,314,630,536
0131-002,2013,4,28,10,484,446,930,630
0131-002,2013,4,28,11,390,454,844,930
0131-002,2013,4,28,12,418,406,824,844
0131-002,2013,4,28,13,386,434,820,824
0131-002,2013,4,28,14,434,434,868,820
0131-002,2013,4,28,15,542,498,1040,868
0131-002,2013,4,28,16,726,598,1324,1040
0131-002,2013,4,28,17,852,588,1440,1324
0131-002,2013,4,28,18,800,644,1444,1440
0131-002,2013,4,28,19,918,598,1516,1444
0131-002,2013,4,28,20,756,430,1186,1516
0131-002,2013,4,28,21,432,292,724,1186
0131-002,2013,4,28,22,402,268,670,724
0131-002,2013,4,28,23,202,136,338,670
0131-002,2013,4,28,24,98,88,186,338
0131-002,2013,4,29,1,84,68,152,186
0131-002,2013,4,29,2,30,32,62,152
0131-002,2013,4,29,3,8,10,18,62
0131-002,2013,4,29,4,14,22,36,18
0131-002,2013,4,29,5,24,36,60,36
0131-002,2013,4,29,6,94,62,156,60
0131-002,2013,4,29,7,400,214,614,156
0131-002,2013,4,29,8,1160,856,2016,614
0131-002,2013,4,29,9,932,956,1888,2016
0131-002,2013,4,29,10,596,698,1294,1888
0131-002,2013,4,29,11,836,806,1642,1294
0131-002,2013,4,29,12,626,664,1290,1642
0131-002,2013,4,29,13,480,574,1054,1290
0131-002,2013,4,29,14,554,592,1146,1054
0131-002,2013,4,29,15,684,736,1420,1146
0131-002,2013,4,29,16,794,822,1616,1420
0131-002,2013,4,29,17,692,864,1556,1616
0131-002,2013,4,29,18,744,1020,1764,1556
0131-002,2013,4,29,19,830,1022,1852,1764
0131-002,2013,4,29,20,626,764,1390,1852
0131-002,2013,4,29,21,530,708,1238,1390
0131-002,2013,4,29,22,374,472,846,1238
0131-002,2013,4,29,23,236,240,476,846
0131-002,2013,4,29,24,142,128,270,476
0131-002,2013,4,30,1,52,54,106,270
0131-002,2013,4,30,2,54,54,108,106
0131-002,2013,4,30,3,10,18,28,108
0131-002,2013,4,30,4,26,24,50,28
0131-002,2013,4,30,5,40,44,84,50
0131-002,2013,4,30,6,96,82,178,84
0131-002,2013,4,30,7,374,258,632,178
0131-002,2013,4,30,8,1308,908,2216,632
0131-002,2013,4,30,9,994,1044,2038,2216
0131-002,2013,4,30,10,818,890,1708,2038
0131-002,2013,4,30,11,782,828,1610,1708
0131-002,2013,4,30,12,818,776,1594,1610
0131-002,2013,4,30,13,686,642,1328,1594
0131-002,2013,4,30,14,798,854,1652,1328
0131-002,2013,4,30,15,726,850,1576,1652
0131-002,2013,4,30,16,1018,1006,2024,1576
0131-002,2013,4,30,17,850,938,1788,2024
0131-002,2013,4,30,18,924,1306,2230,1788
0131-002,2013,4,30,19,1228,1374,2602,2230
0131-002,2013,4,30,20,952,1020,1972,2602
0131-002,2013,4,30,21,694,756,1450,1972
0131-002,2013,4,30,22,468,442,910,1450
0131-002,2013,4,30,23,296,314,610,910
0131-002,2013,4,30,24,166,156,322,610
0131-002,2013,5,1,1,102,112,214,322
0131-002,2013,5,1,2,64,66,130,214
0131-002,2013,5,1,3,30,40,70,130
0131-002,2013,5,1,4,22,28,50,70
0131-002,2013,5,1,5,22,26,48,50
0131-002,2013,5,1,6,86,56,142,48
0131-002,2013,5,1,7,402,192,594,142
0131-002,2013,5,1,8,820,526,1346,594
0131-002,2013,5,1,9,736,724,1460,1346
0131-002,2013,5,1,10,620,722,1342,1460
0131-002,2013,5,1,11,662,644,1306,1342
0131-002,2013,5,1,12,510,546,1056,1306
0131-002,2013,5,1,13,490,518,1008,1056
0131-002,2013,5,1,14,592,624,1216,1008
0131-002,2013,5,1,15,530,602,1132,1216
0131-002,2013,5,1,16,638,632,1270,1132
0131-002,2013,5,1,17,610,724,1334,1270
0131-002,2013,5,1,18,678,912,1590,1334
0131-002,2013,5,1,19,546,714,1260,1590
0131-002,2013,5,1,20,292,430,722,1260
0131-002,2013,5,1,21,196,314,510,722
0131-002,2013,5,1,22,172,224,396,510
0131-002,2013,5,1,23,128,152,280,396
0131-002,2013,5,1,24,70,74,144,280
0131-002,2013,5,2,1,60,60,120,144
0131-002,2013,5,2,2,36,38,74,120
0131-002,2013,5,2,3,22,24,46,74
0131-002,2013,5,2,4,16,20,36,46
0131-002,2013,5,2,5,38,34,72,36
0131-002,2013,5,2,6,96,70,166,72
0131-002,2013,5,2,7,496,276,772,166
0131-002,2013,5,2,8,1318,858,2176,772
0131-002,2013,5,2,9,1004,990,1994,2176
0131-002,2013,5,2,10,912,850,1762,1994
0131-002,2013,5,2,11,694,844,1538,1762
0131-002,2013,5,2,12,764,776,1540,1538
0131-002,2013,5,2,13,584,636,1220,1540
0131-002,2013,5,2,14,694,728,1422,1220
0131-002,2013,5,2,15,850,902,1752,1422
0131-002,2013,5,2,16,928,968,1896,1752
0131-002,2013,5,2,17,780,874,1654,1896
0131-002,2013,5,2,18,946,1212,2158,1654
0131-002,2013,5,2,19,948,1182,2130,2158
0131-002,2013,5,2,20,618,786,1404,2130
0131-002,2013,5,2,21,444,704,1148,1404
0131-002,2013,5,2,22,330,440,770,1148
0131-002,2013,5,2,23,250,274,524,770
0131-002,2013,5,2,24,130,144,274,524
0131-002,2013,5,3,1,118,96,214,274
0131-002,2013,5,3,2,44,38,82,214
0131-002,2013,5,3,3,42,42,84,82
0131-002,2013,5,3,4,16,28,44,84
0131-002,2013,5,3,5,34,42,76,44
0131-002,2013,5,3,6,136,96,232,76
0131-002,2013,5,3,7,522,226,748,232
0131-002,2013,5,3,8,1268,878,2146,748
0131-002,2013,5,3,9,1058,1058,2116,2146
0131-002,2013,5,3,10,814,938,1752,2116
0131-002,2013,5,3,11,818,870,1688,1752
0131-002,2013,5,3,12,782,822,1604,1688
0131-002,2013,5,3,13,660,724,1384,1604
0131-002,2013,5,3,14,770,826,1596,1384
0131-002,2013,5,3,15,846,934,1780,1596
0131-002,2013,5,3,16,900,952,1852,1780
0131-002,2013,5,3,17,960,1036,1996,1852
0131-002,2013,5,3,18,1174,1454,2628,1996
0131-002,2013,5,3,19,1180,1484,2664,2628
0131-002,2013,5,3,20,708,1090,1798,2664
0131-002,2013,5,3,21,530,898,1428,1798
0131-002,2013,5,3,22,394,720,1114,1428
0131-002,2013,5,3,23,224,498,722,1114
0131-002,2013,5,3,24,60,180,240,722
0131-002,2013,5,4,1,20,70,90,240
0131-002,2013,5,4,2,42,96,138,90
0131-002,2013,5,4,3,26,46,72,138
0131-002,2013,5,4,4,28,26,54,72
0131-002,2013,5,4,5,42,56,98,54
0131-002,2013,5,4,6,134,86,220,98
0131-002,2013,5,4,7,258,180,438,220
0131-002,2013,5,4,8,530,504,1034,438
0131-002,2013,5,4,9,576,868,1444,1034
0131-002,2013,5,4,10,588,1078,1666,1444
0131-002,2013,5,4,11,724,1450,2174,1666
0131-002,2013,5,4,12,788,1510,2298,2174
0131-002,2013,5,4,13,800,1556,2356,2298
0131-002,2013,5,4,14,660,1280,1940,2356
0131-002,2013,5,4,15,624,1234,1858,1940
0131-002,2013,5,4,16,766,1370,2136,1858
0131-002,2013,5,4,17,796,1278,2074,2136
0131-002,2013,5,4,18,882,1360,2242,2074
0131-002,2013,5,4,19,776,1024,1800,2242
0131-002,2013,5,4,20,482,574,1056,1800
0131-002,2013,5,4,21,438,442,880,1056
0131-002,2013,5,4,22,336,352,688,880
0131-002,2013,5,4,23,164,174,338,688
0131-002,2013,5,4,24,112,134,246,338
0131-002,2013,5,5,1,82,92,174,246
0131-002,2013,5,5,2,26,22,48,174
0131-002,2013,5,5,3,22,28,50,48
0131-002,2013,5,5,4,14,16,30,50
0131-002,2013,5,5,5,14,22,36,30
0131-002,2013,5,5,6,52,44,96,36
0131-002,2013,5,5,7,148,98,246,96
0131-002,2013,5,5,8,236,156,392,246
0131-002,2013,5,5,9,224,266,490,392
0131-002,2013,5,5,10,436,380,816,490
0131-002,2013,5,5,11,656,450,1106,816
0131-002,2013,5,5,12,610,394,1004,1106
0131-002,2013,5,5,13,820,378,1198,1004
0131-002,2013,5,5,14,766,428,1194,1198
0131-002,2013,5,5,15,814,498,1312,1194
0131-002,2013,5,5,16,834,518,1352,1312
0131-002,2013,5,5,17,998,582,1580,1352
0131-002,2013,5,5,18,1068,666,1734,1580
0131-002,2013,5,5,19,1064,606,1670,1734
0131-002,2013,5,5,20,900,472,1372,1670
0131-002,2013,5,5,21,654,358,1012,1372
0131-002,2013,5,5,22,662,302,964,1012
0131-002,2013,5,5,23,496,156,652,964
0131-002,2013,5,5,24,374,98,472,652
0131-002,2013,5,6,1,118,50,168,472
0131-002,2013,5,6,2,44,28,72,168
0131-002,2013,5,6,3,22,16,38,72
0131-002,2013,5,6,4,30,30,60,38
0131-002,2013,5,6,5,14,22,36,60
0131-002,2013,5,6,6,136,92,228,36
0131-002,2013,5,6,7,636,338,974,228
0131-002,2013,5,6,8,1552,1046,2598,974
0131-002,2013,5,6,9,1140,1080,2220,2598
0131-002,2013,5,6,10,702,840,1542,2220
0131-002,2013,5,6,11,724,756,1480,1542
0131-002,2013,5,6,12,724,740,1464,1480
0131-002,2013,5,6,13,552,620,1172,1464
0131-002,2013,5,6,14,646,738,1384,1172
0131-002,2013,5,6,15,806,852,1658,1384
0131-002,2013,5,6,16,838,890,1728,1658
0131-002,2013,5,6,17,816,898,1714,1728
0131-002,2013,5,6,18,1002,1222,2224,1714
0131-002,2013,5,6,19,1024,1224,2248,2224
0131-002,2013,5,6,20,594,840,1434,2248
0131-002,2013,5,6,21,462,766,1228,1434
0131-002,2013,5,6,22,444,476,920,1228
0131-002,2013,5,6,23,198,204,402,920
0131-002,2013,5,6,24,120,146,266,402
0131-002,2013,5,7,1,66,66,132,266
0131-002,2013,5,7,2,28,38,66,132
0131-002,2013,5,7,3,28,24,52,66
0131-002,2013,5,7,4,22,28,50,52
0131-002,2013,5,7,5,44,46,90,50
0131-002,2013,5,7,6,100,84,184,90
0131-002,2013,5,7,7,430,270,700,184
0131-002,2013,5,7,8,1442,944,2386,700
0131-002,2013,5,7,9,1024,1082,2106,2386
0131-002,2013,5,7,10,816,878,1694,2106
0131-002,2013,5,7,11,786,802,1588,1694
0131-002,2013,5,7,12,744,796,1540,1588
0131-002,2013,5,7,13,598,656,1254,1540
0131-002,2013,5,7,14,778,728,1506,1254
0131-002,2013,5,7,15,878,924,1802,1506
0131-002,2013,5,7,16,802,840,1642,1802
0131-002,2013,5,7,17,868,1010,1878,1642
0131-002,2013,5,7,18,986,1114,2100,1878
0131-002,2013,5,7,19,988,1094,2082,2100
0131-002,2013,5,7,20,722,824,1546,2082
0131-002,2013,5,7,21,516,756,1272,1546
0131-002,2013,5,7,22,386,558,944,1272
0131-002,2013,5,7,23,246,274,520,944
0131-002,2013,5,7,24,112,134,246,520
0131-002,2013,5,8,1,84,80,164,246
0131-002,2013,5,8,2,34,30,64,164
0131-002,2013,5,8,3,28,30,58,64
0131-002,2013,5,8,4,44,42,86,58
0131-002,2013,5,8,5,34,40,74,86
0131-002,2013,5,8,6,120,92,212,74
0131-002,2013,5,8,7,490,276,766,212
0131-002,2013,5,8,8,1382,954,2336,766
0131-002,2013,5,8,9,1016,1072,2088,2336
0131-002,2013,5,8,10,838,894,1732,2088
0131-002,2013,5,8,11,824,852,1676,1732
0131-002,2013,5,8,12,712,774,1486,1676
0131-002,2013,5,8,13,550,610,1160,1486
0131-002,2013,5,8,14,728,734,1462,1160
0131-002,2013,5,8,15,766,924,1690,1462
0131-002,2013,5,8,16,932,996,1928,1690
0131-002,2013,5,8,17,998,1010,2008,1928
0131-002,2013,5,8,18,1356,1490,2846,2008
0131-002,2013,5,8,19,1218,1418,2636,2846
0131-002,2013,5,8,20,580,756,1336,2636
0131-002,2013,5,8,21,500,694,1194,1336
0131-002,2013,5,8,22,460,514,974,1194
0131-002,2013,5,8,23,276,310,586,974
0131-002,2013,5,8,24,154,160,314,586
0131-002,2013,5,9,1,74,66,140,314
0131-002,2013,5,9,2,64,44,108,140
0131-002,2013,5,9,3,48,46,94,108
0131-002,2013,5,9,4,28,28,56,94
0131-002,2013,5,9,5,34,58,92,56
0131-002,2013,5,9,6,144,114,258,92
0131-002,2013,5,9,7,472,238,710,258
0131-002,2013,5,9,8,1376,938,2314,710
0131-002,2013,5,9,9,1082,1124,2206,2314
0131-002,2013,5,9,10,782,834,1616,2206
0131-002,2013,5,9,11,762,774,1536,1616
0131-002,2013,5,9,12,702,750,1452,1536
0131-002,2013,5,9,13,606,678,1284,1452
0131-002,2013,5,9,14,708,768,1476,1284
0131-002,2013,5,9,15,790,888,1678,1476
0131-002,2013,5,9,16,908,998,1906,1678
0131-002,2013,5,9,17,836,888,1724,1906
0131-002,2013,5,9,18,1086,1090,2176,1724
0131-002,2013,5,9,19,1126,1178,2304,2176
0131-002,2013,5,9,20,522,726,1248,2304
0131-002,2013,5,9,21,468,654,1122,1248
0131-002,2013,5,9,22,400,448,848,1122
0131-002,2013,5,9,23,230,260,490,848
0131-002,2013,5,9,24,112,134,246,490
0131-002,2013,5,10,1,108,90,198,246
0131-002,2013,5,10,2,58,58,116,198
0131-002,2013,5,10,3,48,54,102,116
0131-002,2013,5,10,4,28,30,58,102
0131-002,2013,5,10,5,40,40,80,58
0131-002,2013,5,10,6,84,72,156,80
0131-002,2013,5,10,7,324,186,510,156
0131-002,2013,5,10,8,1146,750,1896,510
0131-002,2013,5,10,9,1144,1110,2254,1896
0131-002,2013,5,10,10,654,728,1382,2254
0131-002,2013,5,10,11,826,852,1678,1382
0131-002,2013,5,10,12,848,888,1736,1678
0131-002,2013,5,10,13,504,636,1140,1736
0131-002,2013,5,10,14,680,868,1548,1140
0131-002,2013,5,10,15,878,976,1854,1548
0131-002,2013,5,10,16,806,878,1684,1854
0131-002,2013,5,10,17,882,938,1820,1684
0131-002,2013,5,10,18,1190,1242,2432,1820
0131-002,2013,5,10,19,1226,1220,2446,2432
0131-002,2013,5,10,20,878,876,1754,2446
0131-002,2013,5,10,21,550,774,1324,1754
0131-002,2013,5,10,22,420,494,914,1324
0131-002,2013,5,10,23,238,282,520,914
0131-002,2013,5,10,24,302,222,524,520
0131-002,2013,5,11,1,122,138,260,524
0131-002,2013,5,11,2,62,60,122,260
0131-002,2013,5,11,3,28,46,74,122
0131-002,2013,5,11,4,28,38,66,74
0131-002,2013,5,11,5,54,64,118,66
0131-002,2013,5,11,6,94,72,166,118
0131-002,2013,5,11,7,266,204,470,166
0131-002,2013,5,11,8,714,526,1240,470
0131-002,2013,5,11,9,816,814,1630,1240
0131-002,2013,5,11,10,1026,1300,2326,1630
0131-002,2013,5,11,11,1176,1480,2656,2326
0131-002,2013,5,11,12,992,1462,2454,2656
0131-002,2013,5,11,13,812,1388,2200,2454
0131-002,2013,5,11,14,840,1196,2036,2200
0131-002,2013,5,11,15,1174,1178,2352,2036
0131-002,2013,5,11,16,878,1144,2022,2352
0131-002,2013,5,11,17,834,1102,1936,2022
0131-002,2013,5,11,18,996,1398,2394,1936
0131-002,2013,5,11,19,948,1078,2026,2394
0131-002,2013,5,11,20,634,696,1330,2026
0131-002,2013,5,11,21,378,378,756,1330
0131-002,2013,5,11,22,314,296,610,756
0131-002,2013,5,11,23,178,196,374,610
0131-002,2013,5,11,24,108,108,216,374
0131-002,2013,5,12,1,72,76,148,216
0131-002,2013,5,12,2,54,48,102,148
0131-002,2013,5,12,3,26,34,60,102
0131-002,2013,5,12,4,22,30,52,60
0131-002,2013,5,12,5,54,42,96,52
0131-002,2013,5,12,6,74,52,126,96
0131-002,2013,5,12,7,190,136,326,126
0131-002,2013,5,12,8,164,164,328,326
0131-002,2013,5,12,9,288,288,576,328
0131-002,2013,5,12,10,380,388,768,576
0131-002,2013,5,12,11,426,476,902,768
0131-002,2013,5,12,12,416,464,880,902
0131-002,2013,5,12,13,562,416,978,880
0131-002,2013,5,12,14,582,434,1016,978
0131-002,2013,5,12,15,778,462,1240,1016
0131-002,2013,5,12,16,816,508,1324,1240
0131-002,2013,5,12,17,910,590,1500,1324
0131-002,2013,5,12,18,854,626,1480,1500
0131-002,2013,5,12,19,586,498,1084,1480
0131-002,2013,5,12,20,416,382,798,1084
0131-002,2013,5,12,21,372,326,698,798
0131-002,2013,5,12,22,336,268,604,698
0131-002,2013,5,12,23,190,150,340,604
0131-002,2013,5,12,24,116,88,204,340
0131-002,2013,5,13,1,76,64,140,204
0131-002,2013,5,13,2,24,18,42,140
0131-002,2013,5,13,3,22,18,40,42
0131-002,2013,5,13,4,28,28,56,40
0131-002,2013,5,13,5,44,42,86,56
0131-002,2013,5,13,6,158,116,274,86
0131-002,2013,5,13,7,496,302,798,274
0131-002,2013,5,13,8,1614,1012,2626,798
0131-002,2013,5,13,9,1086,1034,2120,2626
0131-002,2013,5,13,10,764,800,1564,2120
0131-002,2013,5,13,11,746,808,1554,1564
0131-002,2013,5,13,12,772,806,1578,1554
0131-002,2013,5,13,13,502,626,1128,1578
0131-002,2013,5,13,14,602,674,1276,1128
0131-002,2013,5,13,15,752,792,1544,1276
0131-002,2013,5,13,16,788,824,1612,1544
0131-002,2013,5,13,17,724,790,1514,1612
0131-002,2013,5,13,18,404,568,972,1514
0131-002,2013,5,13,19,662,858,1520,972
0131-002,2013,5,13,20,552,760,1312,1520
0131-002,2013,5,13,21,458,670,1128,1312
0131-002,2013,5,13,22,242,292,534,1128
0131-002,2013,5,13,23,280,296,576,534
0131-002,2013,5,13,24,156,142,298,576
0131-002,2013,5,14,1,80,74,154,298
0131-002,2013,5,14,2,72,54,126,154
0131-002,2013,5,14,3,20,22,42,126
0131-002,2013,5,14,4,26,26,52,42
0131-002,2013,5,14,5,42,50,92,52
0131-002,2013,5,14,6,118,74,192,92
0131-002,2013,5,14,7,486,278,764,192
0131-002,2013,5,14,8,1446,996,2442,764
0131-002,2013,5,14,9,1188,1110,2298,2442
0131-002,2013,5,14,10,806,882,1688,2298
0131-002,2013,5,14,11,796,830,1626,1688
0131-002,2013,5,14,12,734,756,1490,1626
0131-002,2013,5,14,13,620,730,1350,1490
0131-002,2013,5,14,14,738,744,1482,1350
0131-002,2013,5,14,15,940,976,1916,1482
0131-002,2013,5,14,16,816,924,1740,1916
0131-002,2013,5,14,17,806,934,1740,1740
0131-002,2013,5,14,18,1048,1104,2152,1740
0131-002,2013,5,14,19,1018,1134,2152,2152
0131-002,2013,5,14,20,622,766,1388,2152
0131-002,2013,5,14,21,454,728,1182,1388
0131-002,2013,5,14,22,478,478,956,1182
0131-002,2013,5,14,23,236,270,506,956
0131-002,2013,5,14,24,144,158,302,506
0131-002,2013,5,15,1,62,76,138,302
0131-002,2013,5,15,2,46,40,86,138
0131-002,2013,5,15,3,32,42,74,86
0131-002,2013,5,15,4,30,38,68,74
0131-002,2013,5,15,5,38,40,78,68
0131-002,2013,5,15,6,114,82,196,78
0131-002,2013,5,15,7,420,238,658,196
0131-002,2013,5,15,8,1282,900,2182,658
0131-002,2013,5,15,9,1082,1182,2264,2182
0131-002,2013,5,15,10,932,894,1826,2264
0131-002,2013,5,15,11,920,898,1818,1826
0131-002,2013,5,15,12,774,818,1592,1818
0131-002,2013,5,15,13,622,644,1266,1592
0131-002,2013,5,15,14,762,804,1566,1266
0131-002,2013,5,15,15,842,912,1754,1566
0131-002,2013,5,15,16,738,884,1622,1754
0131-002,2013,5,15,17,886,952,1838,1622
0131-002,2013,5,15,18,920,1180,2100,1838
0131-002,2013,5,15,19,1040,1274,2314,2100
0131-002,2013,5,15,20,656,826,1482,2314
0131-002,2013,5,15,21,472,652,1124,1482
0131-002,2013,5,15,22,370,508,878,1124
0131-002,2013,5,15,23,270,292,562,878
0131-002,2013,5,15,24,216,180,396,562
0131-002,2013,5,16,1,116,134,250,396
0131-002,2013,5,16,2,48,60,108,250
0131-002,2013,5,16,3,44,48,92,108
0131-002,2013,5,16,4,42,36,78,92
0131-002,2013,5,16,5,46,52,98,78
0131-002,2013,5,16,6,112,88,200,98
0131-002,2013,5,16,7,530,278,808,200
0131-002,2013,5,16,8,1274,906,2180,808
0131-002,2013,5,16,9,1098,1132,2230,2180
0131-002,2013,5,16,10,838,906,1744,2230
0131-002,2013,5,16,11,996,944,1940,1744
0131-002,2013,5,16,12,750,846,1596,1940
0131-002,2013,5,16,13,678,700,1378,1596
0131-002,2013,5,16,14,666,762,1428,1378
0131-002,2013,5,16,15,870,938,1808,1428
0131-002,2013,5,16,16,952,956,1908,1808
0131-002,2013,5,16,17,1038,1106,2144,1908
0131-002,2013,5,16,18,1282,1508,2790,2144
0131-002,2013,5,16,19,1446,1726,3172,2790
0131-002,2013,5,16,20,1104,1496,2600,3172
0131-002,2013,5,16,21,814,1122,1936,2600
0131-002,2013,5,16,22,690,932,1622,1936
0131-002,2013,5,16,23,982,972,1954,1622
0131-002,2013,5,16,24,1056,956,2012,1954
0131-002,2013,5,17,1,252,526,778,2012
0131-002,2013,5,17,2,128,136,264,778
0131-002,2013,5,17,3,38,54,92,264
0131-002,2013,5,17,4,64,62,126,92
0131-002,2013,5,17,5,62,78,140,126
0131-002,2013,5,17,6,136,96,232,140
0131-002,2013,5,17,7,416,310,726,232
0131-002,2013,5,17,8,884,766,1650,726
0131-002,2013,5,17,9,920,1380,2300,1650
0131-002,2013,5,17,10,736,1470,2206,2300
0131-002,2013,5,17,11,854,1416,2270,2206
0131-002,2013,5,17,12,1174,1412,2586,2270
0131-002,2013,5,17,13,816,1082,1898,2586
0131-002,2013,5,17,14,538,932,1470,1898
0131-002,2013,5,17,15,486,968,1454,1470
0131-002,2013,5,17,16,456,842,1298,1454
0131-002,2013,5,17,17,536,1044,1580,1298
0131-002,2013,5,17,18,620,1242,1862,1580
0131-002,2013,5,17,19,466,936,1402,1862
0131-002,2013,5,17,20,218,528,746,1402
0131-002,2013,5,17,21,154,440,594,746
0131-002,2013,5,17,22,132,296,428,594
0131-002,2013,5,17,23,98,210,308,428
0131-002,2013,5,17,24,98,126,224,308
0131-002,2013,5,18,1,48,60,108,224
0131-002,2013,5,18,2,46,54,100,108
0131-002,2013,5,18,3,34,34,68,100
0131-002,2013,5,18,4,26,26,52,68
0131-002,2013,5,18,5,42,52,94,52
0131-002,2013,5,18,6,62,80,142,94
0131-002,2013,5,18,7,182,170,352,142
0131-002,2013,5,18,8,526,418,944,352
0131-002,2013,5,18,9,450,508,958,944
0131-002,2013,5,18,10,614,688,1302,958
0131-002,2013,5,18,11,544,638,1182,1302
0131-002,2013,5,18,12,508,656,1164,1182
0131-002,2013,5,18,13,390,540,930,1164
0131-002,2013,5,18,14,454,586,1040,930
0131-002,2013,5,18,15,428,570,998,1040
0131-002,2013,5,18,16,556,670,1226,998
0131-002,2013,5,18,17,722,636,1358,1226
0131-002,2013,5,18,18,954,836,1790,1358
0131-002,2013,5,18,19,1066,714,1780,1790
0131-002,2013,5,18,20,706,428,1134,1780
0131-002,2013,5,18,21,580,346,926,1134
0131-002,2013,5,18,22,460,272,732,926
0131-002,2013,5,18,23,202,154,356,732
0131-002,2013,5,18,24,122,86,208,356
0131-002,2013,5,19,1,100,64,164,208
0131-002,2013,5,19,2,48,44,92,164
0131-002,2013,5,19,3,20,32,52,92
0131-002,2013,5,19,4,16,24,40,52
0131-002,2013,5,19,5,16,24,40,40
0131-002,2013,5,19,6,46,36,82,40
0131-002,2013,5,19,7,102,68,170,82
0131-002,2013,5,19,8,128,94,222,170
0131-002,2013,5,19,9,222,196,418,222
0131-002,2013,5,19,10,340,314,654,418
0131-002,2013,5,19,11,418,340,758,654
0131-002,2013,5,19,12,622,378,1000,758
0131-002,2013,5,19,13,732,376,1108,1000
0131-002,2013,5,19,14,780,394,1174,1108
0131-002,2013,5,19,15,652,404,1056,1174
0131-002,2013,5,19,16,834,474,1308,1056
0131-002,2013,5,19,17,778,430,1208,1308
0131-002,2013,5,19,18,780,474,1254,1208
0131-002,2013,5,19,19,588,360,948,1254
0131-002,2013,5,19,20,508,334,842,948
0131-002,2013,5,19,21,396,318,714,842
0131-002,2013,5,19,22,272,186,458,714
0131-002,2013,5,19,23,144,142,286,458
0131-002,2013,5,19,24,118,74,192,286
0131-002,2013,5,20,1,48,50,98,192
0131-002,2013,5,20,2,20,22,42,98
0131-002,2013,5,20,3,16,10,26,42
0131-002,2013,5,20,4,12,14,26,26
0131-002,2013,5,20,5,36,44,80,26
0131-002,2013,5,20,6,136,110,246,80
0131-002,2013,5,20,7,444,284,728,246
0131-002,2013,5,20,8,1370,982,2352,728
0131-002,2013,5,20,9,1274,1132,2406,2352
0131-002,2013,5,20,10,788,778,1566,2406
0131-002,2013,5,20,11,692,752,1444,1566
0131-002,2013,5,20,12,590,692,1282,1444
0131-002,2013,5,20,13,572,600,1172,1282
0131-002,2013,5,20,14,650,650,1300,1172
0131-002,2013,5,20,15,812,920,1732,1300
0131-002,2013,5,20,16,786,826,1612,1732
0131-002,2013,5,20,17,830,952,1782,1612
0131-002,2013,5,20,18,874,1088,1962,1782
0131-002,2013,5,20,19,808,1096,1904,1962
0131-002,2013,5,20,20,684,810,1494,1904
0131-002,2013,5,20,21,516,732,1248,1494
0131-002,2013,5,20,22,408,510,918,1248
0131-002,2013,5,20,23,188,228,416,918
0131-002,2013,5,20,24,134,144,278,416
0131-002,2013,5,21,1,62,66,128,278
0131-002,2013,5,21,2,38,40,78,128
0131-002,2013,5,21,3,16,18,34,78
0131-002,2013,5,21,4,30,42,72,34
0131-002,2013,5,21,5,44,52,96,72
0131-002,2013,5,21,6,128,96,224,96
0131-002,2013,5,21,7,474,262,736,224
0131-002,2013,5,21,8,1376,998,2374,736
0131-002,2013,5,21,9,994,1060,2054,2374
0131-002,2013,5,21,10,848,868,1716,2054
0131-002,2013,5,21,11,774,820,1594,1716
0131-002,2013,5,21,12,750,774,1524,1594
0131-002,2013,5,21,13,586,662,1248,1524
0131-002,2013,5,21,14,732,758,1490,1248
0131-002,2013,5,21,15,800,842,1642,1490
0131-002,2013,5,21,16,890,900,1790,1642
0131-002,2013,5,21,17,920,986,1906,1790
0131-002,2013,5,21,18,912,1188,2100,1906
0131-002,2013,5,21,19,930,1152,2082,2100
0131-002,2013,5,21,20,540,778,1318,2082
0131-002,2013,5,21,21,448,682,1130,1318
0131-002,2013,5,21,22,452,548,1000,1130
0131-002,2013,5,21,23,248,250,498,1000
0131-002,2013,5,21,24,134,148,282,498
0131-002,2013,5,22,1,96,100,196,282
0131-002,2013,5,22,2,36,50,86,196
0131-002,2013,5,22,3,32,36,68,86
0131-002,2013,5,22,4,24,26,50,68
0131-002,2013,5,22,5,26,32,58,50
0131-002,2013,5,22,6,98,80,178,58
0131-002,2013,5,22,7,400,226,626,178
0131-002,2013,5,22,8,1564,1036,2600,626
0131-002,2013,5,22,9,1176,1142,2318,2600
0131-002,2013,5,22,10,790,838,1628,2318
0131-002,2013,5,22,11,754,798,1552,1628
0131-002,2013,5,22,12,684,816,1500,1552
0131-002,2013,5,22,13,460,560,1020,1500
0131-002,2013,5,22,14,682,686,1368,1020
0131-002,2013,5,22,15,872,888,1760,1368
0131-002,2013,5,22,16,806,882,1688,1760
0131-002,2013,5,22,17,886,926,1812,1688
0131-002,2013,5,22,18,1002,1366,2368,1812
0131-002,2013,5,22,19,998,1178,2176,2368
0131-002,2013,5,22,20,616,792,1408,2176
0131-002,2013,5,22,21,500,678,1178,1408
0131-002,2013,5,22,22,388,466,854,1178
0131-002,2013,5,22,23,164,228,392,854
0131-002,2013,5,22,24,110,116,226,392
0131-002,2013,5,23,1,64,74,138,226
0131-002,2013,5,23,2,54,50,104,138
0131-002,2013,5,23,3,48,50,98,104
0131-002,2013,5,23,4,32,32,64,98
0131-002,2013,5,23,5,20,42,62,64
0131-002,2013,5,23,6,148,104,252,62
0131-002,2013,5,23,7,460,250,710,252
0131-002,2013,5,23,8,1416,956,2372,710
0131-002,2013,5,23,9,1116,1148,2264,2372
0131-002,2013,5,23,10,760,828,1588,2264
0131-002,2013,5,23,11,806,792,1598,1588
0131-002,2013,5,23,12,744,770,1514,1598
0131-002,2013,5,23,13,582,630,1212,1514
0131-002,2013,5,23,14,704,706,1410,1212
0131-002,2013,5,23,15,816,934,1750,1410
0131-002,2013,5,23,16,758,844,1602,1750
0131-002,2013,5,23,17,880,968,1848,1602
0131-002,2013,5,23,18,854,1172,2026,1848
0131-002,2013,5,23,19,924,1098,2022,2026
0131-002,2013,5,23,20,730,884,1614,2022
0131-002,2013,5,23,21,480,726,1206,1614
0131-002,2013,5,23,22,438,476,914,1206
0131-002,2013,5,23,23,242,274,516,914
0131-002,2013,5,23,24,176,182,358,516
0131-002,2013,5,24,1,112,104,216,358
0131-002,2013,5,24,2,58,52,110,216
0131-002,2013,5,24,3,40,34,74,110
0131-002,2013,5,24,4,30,48,78,74
0131-002,2013,5,24,5,56,68,124,78
0131-002,2013,5,24,6,112,80,192,124
0131-002,2013,5,24,7,388,228,616,192
0131-002,2013,5,24,8,1270,882,2152,616
0131-002,2013,5,24,9,1136,1106,2242,2152
0131-002,2013,5,24,10,906,864,1770,2242
0131-002,2013,5,24,11,792,858,1650,1770
0131-002,2013,5,24,12,788,866,1654,1650
0131-002,2013,5,24,13,530,692,1222,1654
0131-002,2013,5,24,14,700,802,1502,1222
0131-002,2013,5,24,15,792,852,1644,1502
0131-002,2013,5,24,16,970,1008,1978,1644
0131-002,2013,5,24,17,880,1008,1888,1978
0131-002,2013,5,24,18,1076,1322,2398,1888
0131-002,2013,5,24,19,1022,1412,2434,2398
0131-002,2013,5,24,20,640,1000,1640,2434
0131-002,2013,5,24,21,454,830,1284,1640
0131-002,2013,5,24,22,296,522,818,1284
0131-002,2013,5,24,23,158,298,456,818
0131-002,2013,5,24,24,104,174,278,456
0131-002,2013,5,25,1,50,104,154,278
0131-002,2013,5,25,2,68,72,140,154
0131-002,2013,5,25,3,30,42,72,140
0131-002,2013,5,25,4,50,48,98,72
0131-002,2013,5,25,5,54,68,122,98
0131-002,2013,5,25,6,130,92,222,122
0131-002,2013,5,25,7,344,256,600,222
0131-002,2013,5,25,8,666,576,1242,600
0131-002,2013,5,25,9,590,884,1474,1242
0131-002,2013,5,25,10,518,1034,1552,1474
0131-002,2013,5,25,11,666,1106,1772,1552
0131-002,2013,5,25,12,1000,1204,2204,1772
0131-002,2013,5,25,13,894,1188,2082,2204
0131-002,2013,5,25,14,662,1144,1806,2082
0131-002,2013,5,25,15,424,842,1266,1806
0131-002,2013,5,25,16,410,754,1164,1266
0131-002,2013,5,25,17,438,856,1294,1164
0131-002,2013,5,25,18,492,986,1478,1294
0131-002,2013,5,25,19,412,828,1240,1478
0131-002,2013,5,25,20,240,582,822,1240
0131-002,2013,5,25,21,142,404,546,822
0131-002,2013,5,25,22,152,340,492,546
0131-002,2013,5,25,23,96,208,304,492
0131-002,2013,5,25,24,96,122,218,304
0131-002,2013,5,26,1,74,94,168,218
0131-002,2013,5,26,2,56,66,122,168
0131-002,2013,5,26,3,32,32,64,122
0131-002,2013,5,26,4,28,28,56,64
0131-002,2013,5,26,5,36,44,80,56
0131-002,2013,5,26,6,52,68,120,80
0131-002,2013,5,26,7,102,94,196,120
0131-002,2013,5,26,8,352,280,632,196
0131-002,2013,5,26,9,266,300,566,632
0131-002,2013,5,26,10,372,416,788,566
0131-002,2013,5,26,11,404,474,878,788
0131-002,2013,5,26,12,326,420,746,878
0131-002,2013,5,26,13,292,402,694,746
0131-002,2013,5,26,14,374,482,856,694
0131-002,2013,5,26,15,342,456,798,856
0131-002,2013,5,26,16,460,554,1014,798
0131-002,2013,5,26,17,564,496,1060,1014
0131-002,2013,5,26,18,686,602,1288,1060
0131-002,2013,5,26,19,690,462,1152,1288
0131-002,2013,5,26,20,644,390,1034,1152
0131-002,2013,5,26,21,624,372,996,1034
0131-002,2013,5,26,22,426,252,678,996
0131-002,2013,5,26,23,172,132,304,678
0131-002,2013,5,26,24,136,96,232,304
0131-002,2013,5,27,1,60,64,124,232
0131-002,2013,5,27,2,26,30,56,124
0131-002,2013,5,27,3,18,12,30,56
0131-002,2013,5,27,4,18,20,38,30
0131-002,2013,5,27,5,40,48,88,38
0131-002,2013,5,27,6,98,80,178,88
0131-002,2013,5,27,7,454,290,744,178
0131-002,2013,5,27,8,1352,970,2322,744
0131-002,2013,5,27,9,1234,1096,2330,2322
0131-002,2013,5,27,10,772,762,1534,2330
0131-002,2013,5,27,11,668,726,1394,1534
0131-002,2013,5,27,12,592,696,1288,1394
0131-002,2013,5,27,13,440,462,902,1288
0131-002,2013,5,27,14,626,626,1252,902
0131-002,2013,5,27,15,606,688,1294,1252
0131-002,2013,5,27,16,626,658,1284,1294
0131-002,2013,5,27,17,668,766,1434,1284
0131-002,2013,5,27,18,696,866,1562,1434
0131-002,2013,5,27,19,712,966,1678,1562
0131-002,2013,5,27,20,550,652,1202,1678
0131-002,2013,5,27,21,432,614,1046,1202
0131-002,2013,5,27,22,286,358,644,1046
0131-002,2013,5,27,23,178,214,392,644
0131-002,2013,5,27,24,134,144,278,392
0131-002,2013,5,28,1,70,58,128,278
0131-002,2013,5,28,2,52,52,104,128
0131-002,2013,5,28,3,36,20,56,104
0131-002,2013,5,28,4,20,28,48,56
0131-002,2013,5,28,5,34,30,64,48
0131-002,2013,5,28,6,84,76,160,64
0131-002,2013,5,28,7,250,146,396,160
0131-002,2013,5,28,8,1170,874,2044,396
0131-002,2013,5,28,9,1140,1076,2216,2044
0131-002,2013,5,28,10,834,796,1630,2216
0131-002,2013,5,28,11,718,804,1522,1630
0131-002,2013,5,28,12,600,640,1240,1522
0131-002,2013,5,28,13,530,608,1138,1240
0131-002,2013,5,28,14,734,732,1466,1138
0131-002,2013,5,28,15,740,738,1478,1466
0131-002,2013,5,28,16,718,774,1492,1478
0131-002,2013,5,28,17,818,934,1752,1492
0131-002,2013,5,28,18,824,1066,1890,1752
0131-002,2013,5,28,19,890,1088,1978,1890
0131-002,2013,5,28,20,568,784,1352,1978
0131-002,2013,5,28,21,464,652,1116,1352
0131-002,2013,5,28,22,316,398,714,1116
0131-002,2013,5,28,23,204,218,422,714
0131-002,2013,5,28,24,148,138,286,422
0131-002,2013,5,29,1,58,62,120,286
0131-002,2013,5,29,2,40,38,78,120
0131-002,2013,5,29,3,32,40,72,78
0131-002,2013,5,29,4,36,38,74,72
0131-002,2013,5,29,5,36,40,76,74
0131-002,2013,5,29,6,88,86,174,76
0131-002,2013,5,29,7,412,214,626,174
0131-002,2013,5,29,8,1298,934,2232,626
0131-002,2013,5,29,9,1144,1080,2224,2232
0131-002,2013,5,29,10,780,852,1632,2224
0131-002,2013,5,29,11,774,820,1594,1632
0131-002,2013,5,29,12,786,768,1554,1594
0131-002,2013,5,29,13,596,652,1248,1554
0131-002,2013,5,29,14,648,702,1350,1248
0131-002,2013,5,29,15,788,866,1654,1350
0131-002,2013,5,29,16,804,902,1706,1654
0131-002,2013,5,29,17,784,844,1628,1706
0131-002,2013,5,29,18,898,1148,2046,1628
0131-002,2013,5,29,19,836,1064,1900,2046
0131-002,2013,5,29,20,584,718,1302,1900
0131-002,2013,5,29,21,486,654,1140,1302
0131-002,2013,5,29,22,332,414,746,1140
0131-002,2013,5,29,23,196,226,422,746
0131-002,2013,5,29,24,128,136,264,422
0131-002,2013,5,30,1,82,88,170,264
0131-002,2013,5,30,2,54,52,106,170
0131-002,2013,5,30,3,30,36,66,106
0131-002,2013,5,30,4,30,34,64,66
0131-002,2013,5,30,5,44,70,114,64
0131-002,2013,5,30,6,122,98,220,114
0131-002,2013,5,30,7,366,216,582,220
0131-002,2013,5,30,8,1308,944,2252,582
0131-002,2013,5,30,9,1196,1186,2382,2252
0131-002,2013,5,30,10,814,866,1680,2382
0131-002,2013,5,30,11,794,808,1602,1680
0131-002,2013,5,30,12,750,866,1616,1602
0131-002,2013,5,30,13,712,764,1476,1616
0131-002,2013,5,30,14,858,956,1814,1476
0131-002,2013,5,30,15,822,936,1758,1814
0131-002,2013,5,30,16,772,854,1626,1758
0131-002,2013,5,30,17,852,902,1754,1626
0131-002,2013,5,30,18,926,1200,2126,1754
0131-002,2013,5,30,19,876,1126,2002,2126
0131-002,2013,5,30,20,756,928,1684,2002
0131-002,2013,5,30,21,512,718,1230,1684
0131-002,2013,5,30,22,398,456,854,1230
0131-002,2013,5,30,23,288,304,592,854
0131-002,2013,5,30,24,122,144,266,592
0131-002,2013,5,31,1,76,72,148,266
0131-002,2013,5,31,2,56,48,104,148
0131-002,2013,5,31,3,20,32,52,104
0131-002,2013,5,31,4,24,36,60,52
0131-002,2013,5,31,5,50,50,100,60
0131-002,2013,5,31,6,122,96,218,100
0131-002,2013,5,31,7,424,224,648,218
0131-002,2013,5,31,8,1404,930,2334,648
0131-002,2013,5,31,9,1028,1066,2094,2334
0131-002,2013,5,31,10,814,832,1646,2094
0131-002,2013,5,31,11,710,818,1528,1646
0131-002,2013,5,31,12,768,844,1612,1528
0131-002,2013,5,31,13,610,716,1326,1612
0131-002,2013,5,31,14,738,784,1522,1326
0131-002,2013,5,31,15,838,854,1692,1522
0131-002,2013,5,31,16,872,948,1820,1692
0131-002,2013,5,31,17,824,976,1800,1820
0131-002,2013,5,31,18,1036,1398,2434,1800
0131-002,2013,5,31,19,1442,1460,2902,2434
0131-002,2013,5,31,20,688,932,1620,2902
0131-002,2013,5,31,21,538,788,1326,1620
0131-002,2013,5,31,22,412,466,878,1326
0131-002,2013,5,31,23,300,304,604,878
0131-002,2013,5,31,24,268,198,466,604
0131-002,2013,6,1,1,86,78,164,466
0131-002,2013,6,1,2,52,52,104,164
0131-002,2013,6,1,3,58,52,110,104
0131-002,2013,6,1,4,20,18,38,110
0131-002,2013,6,1,5,48,52,100,38
0131-002,2013,6,1,6,140,106,246,100
0131-002,2013,6,1,7,334,244,578,246
0131-002,2013,6,1,8,702,542,1244,578
0131-002,2013,6,1,9,780,794,1574,1244
0131-002,2013,6,1,10,688,880,1568,1574
0131-002,2013,6,1,11,594,1014,1608,1568
0131-002,2013,6,1,12,702,1102,1804,1608
0131-002,2013,6,1,13,636,878,1514,1804
0131-002,2013,6,1,14,554,866,1420,1514
0131-002,2013,6,1,15,556,696,1252,1420
0131-002,2013,6,1,16,646,716,1362,1252
0131-002,2013,6,1,17,776,792,1568,1362
0131-002,2013,6,1,18,1032,1120,2152,1568
0131-002,2013,6,1,19,1072,952,2024,2152
0131-002,2013,6,1,20,538,522,1060,2024
0131-002,2013,6,1,21,404,412,816,1060
0131-002,2013,6,1,22,268,304,572,816
0131-002,2013,6,1,23,160,178,338,572
0131-002,2013,6,1,24,152,156,308,338
0131-002,2013,6,2,1,96,102,198,308
0131-002,2013,6,2,2,42,42,84,198
0131-002,2013,6,2,3,40,50,90,84
0131-002,2013,6,2,4,30,30,60,90
0131-002,2013,6,2,5,40,44,84,60
0131-002,2013,6,2,6,86,78,164,84
0131-002,2013,6,2,7,180,116,296,164
0131-002,2013,6,2,8,346,230,576,296
0131-002,2013,6,2,9,296,300,596,576
0131-002,2013,6,2,10,372,392,764,596
0131-002,2013,6,2,11,438,402,840,764
0131-002,2013,6,2,12,370,438,808,840
0131-002,2013,6,2,13,394,452,846,808
0131-002,2013,6,2,14,378,416,794,846
0131-002,2013,6,2,15,390,434,824,794
0131-002,2013,6,2,16,614,486,1100,824
0131-002,2013,6,2,17,760,494,1254,1100
0131-002,2013,6,2,18,812,602,1414,1254
0131-002,2013,6,2,19,932,588,1520,1414
0131-002,2013,6,2,20,502,420,922,1520
0131-002,2013,6,2,21,312,334,646,922
0131-002,2013,6,2,22,292,306,598,646
0131-002,2013,6,2,23,168,164,332,598
0131-002,2013,6,2,24,68,66,134,332
0131-002,2013,6,3,1,64,54,118,134
0131-002,2013,6,3,2,56,40,96,118
0131-002,2013,6,3,3,10,12,22,96
0131-002,2013,6,3,4,24,24,48,22
0131-002,2013,6,3,5,26,38,64,48
0131-002,2013,6,3,6,144,104,248,64
0131-002,2013,6,3,7,528,304,832,248
0131-002,2013,6,3,8,1526,1030,2556,832
0131-002,2013,6,3,9,1106,1078,2184,2556
0131-002,2013,6,3,10,766,814,1580,2184
0131-002,2013,6,3,11,810,814,1624,1580
0131-002,2013,6,3,12,748,748,1496,1624
0131-002,2013,6,3,13,598,740,1338,1496
0131-002,2013,6,3,14,844,842,1686,1338
0131-002,2013,6,3,15,836,942,1778,1686
0131-002,2013,6,3,16,762,860,1622,1778
0131-002,2013,6,3,17,804,978,1782,1622
0131-002,2013,6,3,18,838,1108,1946,1782
0131-002,2013,6,3,19,920,1096,2016,1946
0131-002,2013,6,3,20,648,844,1492,2016
0131-002,2013,6,3,21,488,756,1244,1492
0131-002,2013,6,3,22,382,492,874,1244
0131-002,2013,6,3,23,208,236,444,874
0131-002,2013,6,3,24,170,148,318,444
0131-002,2013,6,4,1,82,88,170,318
0131-002,2013,6,4,2,32,26,58,170
0131-002,2013,6,4,3,32,28,60,58
0131-002,2013,6,4,4,36,42,78,60
0131-002,2013,6,4,5,28,40,68,78
0131-002,2013,6,4,6,104,102,206,68
0131-002,2013,6,4,7,404,238,642,206
0131-002,2013,6,4,8,1536,956,2492,642
0131-002,2013,6,4,9,1232,1166,2398,2492
0131-002,2013,6,4,10,876,922,1798,2398
0131-002,2013,6,4,11,808,850,1658,1798
0131-002,2013,6,4,12,806,886,1692,1658
0131-002,2013,6,4,13,746,760,1506,1692
0131-002,2013,6,4,14,748,794,1542,1506
0131-002,2013,6,4,15,938,916,1854,1542
0131-002,2013,6,4,16,1078,1102,2180,1854
0131-002,2013,6,4,17,942,970,1912,2180
0131-002,2013,6,4,18,1010,1276,2286,1912
0131-002,2013,6,4,19,1038,1234,2272,2286
0131-002,2013,6,4,20,718,868,1586,2272
0131-002,2013,6,4,21,488,758,1246,1586
0131-002,2013,6,4,22,432,504,936,1246
0131-002,2013,6,4,23,246,292,538,936
0131-002,2013,6,4,24,104,126,230,538
0131-002,2013,6,5,1,72,80,152,230
0131-002,2013,6,5,2,38,46,84,152
0131-002,2013,6,5,3,46,48,94,84
0131-002,2013,6,5,4,28,32,60,94
0131-002,2013,6,5,5,30,36,66,60
0131-002,2013,6,5,6,128,96,224,66
0131-002,2013,6,5,7,350,262,612,224
0131-002,2013,6,5,8,1334,972,2306,612
0131-002,2013,6,5,9,1382,1188,2570,2306
0131-002,2013,6,5,10,824,926,1750,2570
0131-002,2013,6,5,11,906,888,1794,1750
0131-002,2013,6,5,12,856,878,1734,1794
0131-002,2013,6,5,13,650,736,1386,1734
0131-002,2013,6,5,14,914,814,1728,1386
0131-002,2013,6,5,15,886,956,1842,1728
0131-002,2013,6,5,16,938,1032,1970,1842
0131-002,2013,6,5,17,952,1046,1998,1970
0131-002,2013,6,5,18,1016,1442,2458,1998
0131-002,2013,6,5,19,1142,1378,2520,2458
0131-002,2013,6,5,20,860,962,1822,2520
0131-002,2013,6,5,21,616,842,1458,1822
0131-002,2013,6,5,22,474,534,1008,1458
0131-002,2013,6,5,23,308,322,630,1008
0131-002,2013,6,5,24,194,182,376,630
0131-002,2013,6,6,1,148,118,266,376
0131-002,2013,6,6,2,56,72,128,266
0131-002,2013,6,6,3,48,34,82,128
0131-002,2013,6,6,4,34,42,76,82
0131-002,2013,6,6,5,48,62,110,76
0131-002,2013,6,6,6,138,100,238,110
0131-002,2013,6,6,7,366,216,582,238
0131-002,2013,6,6,8,746,538,1284,582
0131-002,2013,6,6,9,844,812,1656,1284
0131-002,2013,6,6,10,804,868,1672,1656
0131-002,2013,6,6,11,980,1016,1996,1672
0131-002,2013,6,6,12,1112,1306,2418,1996
0131-002,2013,6,6,13,884,1064,1948,2418
0131-002,2013,6,6,14,702,760,1462,1948
0131-002,2013,6,6,15,608,642,1250,1462
0131-002,2013,6,6,16,642,648,1290,1250
0131-002,2013,6,6,17,618,648,1266,1290
0131-002,2013,6,6,18,840,904,1744,1266
0131-002,2013,6,6,19,642,718,1360,1744
0131-002,2013,6,6,20,404,506,910,1360
0131-002,2013,6,6,21,288,420,708,910
0131-002,2013,6,6,22,258,308,566,708
0131-002,2013,6,6,23,166,162,328,566
0131-002,2013,6,6,24,100,88,188,328
0131-002,2013,6,7,1,100,88,188,188
0131-002,2013,6,7,2,38,32,70,188
0131-002,2013,6,7,3,36,32,68,70
0131-002,2013,6,7,4,22,18,40,68
0131-002,2013,6,7,5,48,62,110,40
0131-002,2013,6,7,6,114,92,206,110
0131-002,2013,6,7,7,494,260,754,206
0131-002,2013,6,7,8,1308,936,2244,754
0131-002,2013,6,7,9,1082,1100,2182,2244
0131-002,2013,6,7,10,922,926,1848,2182
0131-002,2013,6,7,11,820,850,1670,1848
0131-002,2013,6,7,12,816,816,1632,1670
0131-002,2013,6,7,13,694,758,1452,1632
0131-002,2013,6,7,14,734,808,1542,1452
0131-002,2013,6,7,15,722,886,1608,1542
0131-002,2013,6,7,16,808,942,1750,1608
0131-002,2013,6,7,17,982,1056,2038,1750
0131-002,2013,6,7,18,1206,1248,2454,2038
0131-002,2013,6,7,19,1270,1376,2646,2454
0131-002,2013,6,7,20,808,944,1752,2646
0131-002,2013,6,7,21,524,740,1264,1752
0131-002,2013,6,7,22,490,586,1076,1264
0131-002,2013,6,7,23,304,352,656,1076
0131-002,2013,6,7,24,200,200,400,656
0131-002,2013,6,8,1,104,96,200,400
0131-002,2013,6,8,2,72,84,156,200
0131-002,2013,6,8,3,58,46,104,156
0131-002,2013,6,8,4,38,44,82,104
0131-002,2013,6,8,5,36,56,92,82
0131-002,2013,6,8,6,140,118,258,92
0131-002,2013,6,8,7,328,238,566,258
0131-002,2013,6,8,8,644,486,1130,566
0131-002,2013,6,8,9,874,858,1732,1130
0131-002,2013,6,8,10,806,958,1764,1732
0131-002,2013,6,8,11,614,980,1594,1764
0131-002,2013,6,8,12,662,976,1638,1594
0131-002,2013,6,8,13,754,1116,1870,1638
0131-002,2013,6,8,14,730,952,1682,1870
0131-002,2013,6,8,15,600,842,1442,1682
0131-002,2013,6,8,16,568,748,1316,1442
0131-002,2013,6,8,17,574,766,1340,1316
0131-002,2013,6,8,18,776,994,1770,1340
0131-002,2013,6,8,19,760,922,1682,1770
0131-002,2013,6,8,20,474,498,972,1682
0131-002,2013,6,8,21,308,364,672,972
0131-002,2013,6,8,22,262,280,542,672
0131-002,2013,6,8,23,186,210,396,542
0131-002,2013,6,8,24,138,148,286,396
0131-002,2013,6,9,1,58,60,118,286
0131-002,2013,6,9,2,54,54,108,118
0131-002,2013,6,9,3,32,36,68,108
0131-002,2013,6,9,4,32,38,70,68
0131-002,2013,6,9,5,36,40,76,70
0131-002,2013,6,9,6,80,62,142,76
0131-002,2013,6,9,7,156,122,278,142
0131-002,2013,6,9,8,218,204,422,278
0131-002,2013,6,9,9,364,330,694,422
0131-002,2013,6,9,10,316,362,678,694
0131-002,2013,6,9,11,302,434,736,678
0131-002,2013,6,9,12,454,456,910,736
0131-002,2013,6,9,13,402,364,766,910
0131-002,2013,6,9,14,368,430,798,766
0131-002,2013,6,9,15,644,458,1102,798
0131-002,2013,6,9,16,720,530,1250,1102
0131-002,2013,6,9,17,622,462,1084,1250
0131-002,2013,6,9,18,900,584,1484,1084
0131-002,2013,6,9,19,860,524,1384,1484
0131-002,2013,6,9,20,422,352,774,1384
0131-002,2013,6,9,21,416,358,774,774
0131-002,2013,6,9,22,302,258,560,774
0131-002,2013,6,9,23,160,142,302,560
0131-002,2013,6,9,24,150,118,268,302
0131-002,2013,6,10,1,52,50,102,268
0131-002,2013,6,10,2,26,22,48,102
0131-002,2013,6,10,3,42,24,66,48
0131-002,2013,6,10,4,22,26,48,66
0131-002,2013,6,10,5,32,36,68,48
0131-002,2013,6,10,6,126,102,228,68
0131-002,2013,6,10,7,496,288,784,228
0131-002,2013,6,10,8,1418,992,2410,784
0131-002,2013,6,10,9,994,1014,2008,2410
0131-002,2013,6,10,10,742,850,1592,2008
0131-002,2013,6,10,11,944,932,1876,1592
0131-002,2013,6,10,12,802,880,1682,1876
0131-002,2013,6,10,13,766,894,1660,1682
0131-002,2013,6,10,14,858,834,1692,1660
0131-002,2013,6,10,15,806,872,1678,1692
0131-002,2013,6,10,16,790,862,1652,1678
0131-002,2013,6,10,17,818,952,1770,1652
0131-002,2013,6,10,18,866,1130,1996,1770
0131-002,2013,6,10,19,978,1210,2188,1996
0131-002,2013,6,10,20,618,852,1470,2188
0131-002,2013,6,10,21,446,798,1244,1470
0131-002,2013,6,10,22,434,500,934,1244
0131-002,2013,6,10,23,288,288,576,934
0131-002,2013,6,10,24,152,126,278,576
0131-002,2013,6,11,1,90,78,168,278
0131-002,2013,6,11,2,68,62,130,168
0131-002,2013,6,11,3,52,38,90,130
0131-002,2013,6,11,4,8,12,20,90
0131-002,2013,6,11,5,68,74,142,20
0131-002,2013,6,11,6,94,82,176,142
0131-002,2013,6,11,7,576,286,862,176
0131-002,2013,6,11,8,1238,932,2170,862
0131-002,2013,6,11,9,1190,1204,2394,2170
0131-002,2013,6,11,10,818,932,1750,2394
0131-002,2013,6,11,11,982,956,1938,1750
0131-002,2013,6,11,12,794,848,1642,1938
0131-002,2013,6,11,13,768,842,1610,1642
0131-002,2013,6,11,14,762,826,1588,1610
0131-002,2013,6,11,15,874,928,1802,1588
0131-002,2013,6,11,16,938,998,1936,1802
0131-002,2013,6,11,17,846,924,1770,1936
0131-002,2013,6,11,18,958,1182,2140,1770
0131-002,2013,6,11,19,1034,1218,2252,2140
0131-002,2013,6,11,20,680,914,1594,2252
0131-002,2013,6,11,21,356,592,948,1594
0131-002,2013,6,11,22,354,408,762,948
0131-002,2013,6,11,23,216,246,462,762
0131-002,2013,6,11,24,128,114,242,462
0131-002,2013,6,12,1,82,94,176,242
0131-002,2013,6,12,2,42,46,88,176
0131-002,2013,6,12,3,30,34,64,88
0131-002,2013,6,12,4,24,26,50,64
0131-002,2013,6,12,5,44,52,96,50
0131-002,2013,6,12,6,86,62,148,96
0131-002,2013,6,12,7,290,162,452,148
0131-002,2013,6,12,8,1202,834,2036,452
0131-002,2013,6,12,9,1198,1158,2356,2036
0131-002,2013,6,12,10,820,830,1650,2356
0131-002,2013,6,12,11,756,796,1552,1650
0131-002,2013,6,12,12,628,776,1404,1552
0131-002,2013,6,12,13,598,684,1282,1404
0131-002,2013,6,12,14,718,704,1422,1282
0131-002,2013,6,12,15,786,866,1652,1422
0131-002,2013,6,12,16,754,822,1576,1652
0131-002,2013,6,12,17,796,854,1650,1576
0131-002,2013,6,12,18,906,1142,2048,1650
0131-002,2013,6,12,19,854,1090,1944,2048
0131-002,2013,6,12,20,548,744,1292,1944
0131-002,2013,6,12,21,434,672,1106,1292
0131-002,2013,6,12,22,438,476,914,1106
0131-002,2013,6,12,23,218,254,472,914
0131-002,2013,6,12,24,124,124,248,472
0131-002,2013,6,13,1,88,90,178,248
0131-002,2013,6,13,2,40,52,92,178
0131-002,2013,6,13,3,32,34,66,92
0131-002,2013,6,13,4,16,20,36,66
0131-002,2013,6,13,5,66,72,138,36
0131-002,2013,6,13,6,160,116,276,138
0131-002,2013,6,13,7,448,246,694,276
0131-002,2013,6,13,8,1330,968,2298,694
0131-002,2013,6,13,9,1078,1132,2210,2298
0131-002,2013,6,13,10,780,884,1664,2210
0131-002,2013,6,13,11,848,928,1776,1664
0131-002,2013,6,13,12,836,912,1748,1776
0131-002,2013,6,13,13,650,822,1472,1748
0131-002,2013,6,13,14,774,774,1548,1472
0131-002,2013,6,13,15,728,858,1586,1548
0131-002,2013,6,13,16,812,894,1706,1586
0131-002,2013,6,13,17,916,950,1866,1706
0131-002,2013,6,13,18,850,1168,2018,1866
0131-002,2013,6,13,19,982,1168,2150,2018
0131-002,2013,6,13,20,666,886,1552,2150
0131-002,2013,6,13,21,470,718,1188,1552
0131-002,2013,6,13,22,466,470,936,1188
0131-002,2013,6,13,23,286,296,582,936
0131-002,2013,6,13,24,104,134,238,582
0131-002,2013,6,14,1,74,78,152,238
0131-002,2013,6,14,2,72,58,130,152
0131-002,2013,6,14,3,34,38,72,130
0131-002,2013,6,14,4,40,50,90,72
0131-002,2013,6,14,5,36,38,74,90
0131-002,2013,6,14,6,150,122,272,74
0131-002,2013,6,14,7,418,254,672,272
0131-002,2013,6,14,8,1332,936,2268,672
0131-002,2013,6,14,9,1142,1084,2226,2268
0131-002,2013,6,14,10,952,884,1836,2226
0131-002,2013,6,14,11,836,934,1770,1836
0131-002,2013,6,14,12,854,978,1832,1770
0131-002,2013,6,14,13,700,812,1512,1832
0131-002,2013,6,14,14,764,816,1580,1512
0131-002,2013,6,14,15,840,926,1766,1580
0131-002,2013,6,14,16,906,908,1814,1766
0131-002,2013,6,14,17,1134,1260,2394,1814
0131-002,2013,6,14,18,1190,1490,2680,2394
0131-002,2013,6,14,19,1386,1504,2890,2680
0131-002,2013,6,14,20,820,1084,1904,2890
0131-002,2013,6,14,21,632,868,1500,1904
0131-002,2013,6,14,22,458,522,980,1500
0131-002,2013,6,14,23,242,314,556,980
0131-002,2013,6,14,24,176,188,364,556
0131-002,2013,6,15,1,76,84,160,364
0131-002,2013,6,15,2,68,80,148,160
0131-002,2013,6,15,3,44,50,94,148
0131-002,2013,6,15,4,26,32,58,94
0131-002,2013,6,15,5,40,70,110,58
0131-002,2013,6,15,6,126,102,228,110
0131-002,2013,6,15,7,326,248,574,228
0131-002,2013,6,15,8,734,554,1288,574
0131-002,2013,6,15,9,870,856,1726,1288
0131-002,2013,6,15,10,1068,1112,2180,1726
0131-002,2013,6,15,11,764,1146,1910,2180
0131-002,2013,6,15,12,734,1138,1872,1910
0131-002,2013,6,15,13,722,1160,1882,1872
0131-002,2013,6,15,14,728,1114,1842,1882
0131-002,2013,6,15,15,706,978,1684,1842
0131-002,2013,6,15,16,760,948,1708,1684
0131-002,2013,6,15,17,840,1054,1894,1708
0131-002,2013,6,15,18,952,1180,2132,1894
0131-002,2013,6,15,19,738,944,1682,2132
0131-002,2013,6,15,20,480,622,1102,1682
0131-002,2013,6,15,21,380,414,794,1102
0131-002,2013,6,15,22,308,342,650,794
0131-002,2013,6,15,23,180,222,402,650
0131-002,2013,6,15,24,114,154,268,402
0131-002,2013,6,16,1,70,76,146,268
0131-002,2013,6,16,2,58,60,118,146
0131-002,2013,6,16,3,34,38,72,118
0131-002,2013,6,16,4,54,40,94,72
0131-002,2013,6,16,5,28,36,64,94
0131-002,2013,6,16,6,58,66,124,64
0131-002,2013,6,16,7,162,134,296,124
0131-002,2013,6,16,8,244,196,440,296
0131-002,2013,6,16,9,260,274,534,440
0131-002,2013,6,16,10,284,370,654,534
0131-002,2013,6,16,11,342,454,796,654
0131-002,2013,6,16,12,546,412,958,796
0131-002,2013,6,16,13,612,468,1080,958
0131-002,2013,6,16,14,552,506,1058,1080
0131-002,2013,6,16,15,570,434,1004,1058
0131-002,2013,6,16,16,720,488,1208,1004
0131-002,2013,6,16,17,718,460,1178,1208
0131-002,2013,6,16,18,884,552,1436,1178
0131-002,2013,6,16,19,830,546,1376,1436
0131-002,2013,6,16,20,632,434,1066,1376
0131-002,2013,6,16,21,392,356,748,1066
0131-002,2013,6,16,22,332,296,628,748
0131-002,2013,6,16,23,156,170,326,628
0131-002,2013,6,16,24,104,86,190,326
0131-002,2013,6,17,1,50,42,92,190
0131-002,2013,6,17,2,50,38,88,92
0131-002,2013,6,17,3,14,14,28,88
0131-002,2013,6,17,4,26,28,54,28
0131-002,2013,6,17,5,30,32,62,54
0131-002,2013,6,17,6,136,128,264,62
0131-002,2013,6,17,7,586,346,932,264
0131-002,2013,6,17,8,1556,1098,2654,932
0131-002,2013,6,17,9,1048,1048,2096,2654
0131-002,2013,6,17,10,726,752,1478,2096
0131-002,2013,6,17,11,860,866,1726,1478
0131-002,2013,6,17,12,714,768,1482,1726
0131-002,2013,6,17,13,594,822,1416,1482
0131-002,2013,6,17,14,632,812,1444,1416
0131-002,2013,6,17,15,764,948,1712,1444
0131-002,2013,6,17,16,826,888,1714,1712
0131-002,2013,6,17,17,770,930,1700,1714
0131-002,2013,6,17,18,950,1204,2154,1700
0131-002,2013,6,17,19,948,1128,2076,2154
0131-002,2013,6,17,20,692,878,1570,2076
0131-002,2013,6,17,21,532,744,1276,1570
0131-002,2013,6,17,22,392,482,874,1276
0131-002,2013,6,17,23,184,244,428,874
0131-002,2013,6,17,24,126,120,246,428
0131-002,2013,6,18,1,78,72,150,246
0131-002,2013,6,18,2,52,50,102,150
0131-002,2013,6,18,3,38,52,90,102
0131-002,2013,6,18,4,42,32,74,90
0131-002,2013,6,18,5,36,32,68,74
0131-002,2013,6,18,6,62,46,108,68
0131-002,2013,6,18,7,330,186,516,108
0131-002,2013,6,18,8,1218,864,2082,516
0131-002,2013,6,18,9,1042,1056,2098,2082
0131-002,2013,6,18,10,676,718,1394,2098
0131-002,2013,6,18,11,676,748,1424,1394
0131-002,2013,6,18,12,662,688,1350,1424
0131-002,2013,6,18,13,440,562,1002,1350
0131-002,2013,6,18,14,596,636,1232,1002
0131-002,2013,6,18,15,678,742,1420,1232
0131-002,2013,6,18,16,650,696,1346,1420
0131-002,2013,6,18,17,678,760,1438,1346
0131-002,2013,6,18,18,776,962,1738,1438
0131-002,2013,6,18,19,720,946,1666,1738
0131-002,2013,6,18,20,626,730,1356,1666
0131-002,2013,6,18,21,444,658,1102,1356
0131-002,2013,6,18,22,320,366,686,1102
0131-002,2013,6,18,23,164,200,364,686
0131-002,2013,6,18,24,98,100,198,364
0131-002,2013,6,19,1,68,72,140,198
0131-002,2013,6,19,2,32,34,66,140
0131-002,2013,6,19,3,20,22,42,66
0131-002,2013,6,19,4,28,36,64,42
0131-002,2013,6,19,5,22,32,54,64
0131-002,2013,6,19,6,100,94,194,54
0131-002,2013,6,19,7,454,222,676,194
0131-002,2013,6,19,8,1176,854,2030,676
0131-002,2013,6,19,9,1170,1122,2292,2030
0131-002,2013,6,19,10,894,876,1770,2292
0131-002,2013,6,19,11,852,810,1662,1770
0131-002,2013,6,19,12,674,770,1444,1662
0131-002,2013,6,19,13,604,682,1286,1444
0131-002,2013,6,19,14,620,746,1366,1286
0131-002,2013,6,19,15,788,946,1734,1366
0131-002,2013,6,19,16,874,890,1764,1734
0131-002,2013,6,19,17,720,784,1504,1764
0131-002,2013,6,19,18,1012,1276,2288,1504
0131-002,2013,6,19,19,1084,1260,2344,2288
0131-002,2013,6,19,20,716,810,1526,2344
0131-002,2013,6,19,21,456,682,1138,1526
0131-002,2013,6,19,22,396,456,852,1138
0131-002,2013,6,19,23,222,290,512,852
0131-002,2013,6,19,24,140,130,270,512
0131-002,2013,6,20,1,72,74,146,270
0131-002,2013,6,20,2,50,68,118,146
0131-002,2013,6,20,3,78,54,132,118
0131-002,2013,6,20,4,30,36,66,132
0131-002,2013,6,20,5,46,56,102,66
0131-002,2013,6,20,6,164,128,292,102
0131-002,2013,6,20,7,466,272,738,292
0131-002,2013,6,20,8,1376,986,2362,738
0131-002,2013,6,20,9,1254,1126,2380,2362
0131-002,2013,6,20,10,842,802,1644,2380
0131-002,2013,6,20,11,912,912,1824,1644
0131-002,2013,6,20,12,820,828,1648,1824
0131-002,2013,6,20,13,632,744,1376,1648
0131-002,2013,6,20,14,592,782,1374,1376
0131-002,2013,6,20,15,772,850,1622,1374
0131-002,2013,6,20,16,892,936,1828,1622
0131-002,2013,6,20,17,858,920,1778,1828
0131-002,2013,6,20,18,850,1164,2014,1778
0131-002,2013,6,20,19,1036,1256,2292,2014
0131-002,2013,6,20,20,624,802,1426,2292
0131-002,2013,6,20,21,546,806,1352,1426
0131-002,2013,6,20,22,432,526,958,1352
0131-002,2013,6,20,23,232,270,502,958
0131-002,2013,6,20,24,120,130,250,502
0131-002,2013,6,21,1,62,74,136,250
0131-002,2013,6,21,2,48,50,98,136
0131-002,2013,6,21,3,66,42,108,98
0131-002,2013,6,21,4,34,40,74,108
0131-002,2013,6,21,5,46,58,104,74
0131-002,2013,6,21,6,118,104,222,104
0131-002,2013,6,21,7,476,254,730,222
0131-002,2013,6,21,8,1294,982,2276,730
0131-002,2013,6,21,9,1226,1132,2358,2276
0131-002,2013,6,21,10,832,878,1710,2358
0131-002,2013,6,21,11,874,880,1754,1710
0131-002,2013,6,21,12,788,876,1664,1754
0131-002,2013,6,21,13,854,896,1750,1664
0131-002,2013,6,21,14,784,810,1594,1750
0131-002,2013,6,21,15,890,1008,1898,1594
0131-002,2013,6,21,16,852,956,1808,1898
0131-002,2013,6,21,17,1014,1088,2102,1808
0131-002,2013,6,21,18,1182,1458,2640,2102
0131-002,2013,6,21,19,1064,1428,2492,2640
0131-002,2013,6,21,20,806,1164,1970,2492
0131-002,2013,6,21,21,554,826,1380,1970
0131-002,2013,6,21,22,436,548,984,1380
0131-002,2013,6,21,23,312,356,668,984
0131-002,2013,6,21,24,186,174,360,668
0131-002,2013,6,22,1,90,80,170,360
0131-002,2013,6,22,2,64,68,132,170
0131-002,2013,6,22,3,64,58,122,132
0131-002,2013,6,22,4,26,46,72,122
0131-002,2013,6,22,5,74,76,150,72
0131-002,2013,6,22,6,152,128,280,150
0131-002,2013,6,22,7,330,236,566,280
0131-002,2013,6,22,8,700,514,1214,566
0131-002,2013,6,22,9,768,776,1544,1214
0131-002,2013,6,22,10,722,862,1584,1544
0131-002,2013,6,22,11,940,1126,2066,1584
0131-002,2013,6,22,12,914,1128,2042,2066
0131-002,2013,6,22,13,690,1044,1734,2042
0131-002,2013,6,22,14,574,876,1450,1734
0131-002,2013,6,22,15,768,986,1754,1450
0131-002,2013,6,22,16,656,986,1642,1754
0131-002,2013,6,22,17,764,1060,1824,1642
0131-002,2013,6,22,18,896,1196,2092,1824
0131-002,2013,6,22,19,984,1034,2018,2092
0131-002,2013,6,22,20,546,658,1204,2018
0131-002,2013,6,22,21,400,408,808,1204
0131-002,2013,6,22,22,388,342,730,808
0131-002,2013,6,22,23,160,192,352,730
0131-002,2013,6,22,24,144,136,280,352
0131-002,2013,6,23,1,64,74,138,280
0131-002,2013,6,23,2,58,50,108,138
0131-002,2013,6,23,3,26,40,66,108
0131-002,2013,6,23,4,28,32,60,66
0131-002,2013,6,23,5,54,58,112,60
0131-002,2013,6,23,6,112,82,194,112
0131-002,2013,6,23,7,154,120,274,194
0131-002,2013,6,23,8,242,206,448,274
0131-002,2013,6,23,9,312,314,626,448
0131-002,2013,6,23,10,276,310,586,626
0131-002,2013,6,23,11,334,438,772,586
0131-002,2013,6,23,12,334,378,712,772
0131-002,2013,6,23,13,478,472,950,712
0131-002,2013,6,23,14,424,434,858,950
0131-002,2013,6,23,15,520,488,1008,858
0131-002,2013,6,23,16,692,542,1234,1008
0131-002,2013,6,23,17,778,542,1320,1234
0131-002,2013,6,23,18,806,608,1414,1320
0131-002,2013,6,23,19,850,514,1364,1414
0131-002,2013,6,23,20,506,366,872,1364
0131-002,2013,6,23,21,490,344,834,872
0131-002,2013,6,23,22,380,306,686,834
0131-002,2013,6,23,23,192,168,360,686
0131-002,2013,6,23,24,102,84,186,360
0131-002,2013,6,24,1,56,44,100,186
0131-002,2013,6,24,2,34,32,66,100
0131-002,2013,6,24,3,32,26,58,66
0131-002,2013,6,24,4,32,34,66,58
0131-002,2013,6,24,5,48,60,108,66
0131-002,2013,6,24,6,116,108,224,108
0131-002,2013,6,24,7,488,324,812,224
0131-002,2013,6,24,8,1434,1032,2466,812
0131-002,2013,6,24,9,1130,1092,2222,2466
0131-002,2013,6,24,10,766,796,1562,2222
0131-002,2013,6,24,11,694,796,1490,1562
0131-002,2013,6,24,12,630,744,1374,1490
0131-002,2013,6,24,13,752,896,1648,1374
0131-002,2013,6,24,14,654,792,1446,1648
0131-002,2013,6,24,15,728,910,1638,1446
0131-002,2013,6,24,16,778,902,1680,1638
0131-002,2013,6,24,17,862,954,1816,1680
0131-002,2013,6,24,18,908,1104,2012,1816
0131-002,2013,6,24,19,1020,1228,2248,2012
0131-002,2013,6,24,20,570,806,1376,2248
0131-002,2013,6,24,21,588,806,1394,1376
0131-002,2013,6,24,22,410,528,938,1394
0131-002,2013,6,24,23,226,284,510,938
0131-002,2013,6,24,24,106,116,222,510
0131-002,2013,6,25,1,78,70,148,222
0131-002,2013,6,25,2,30,34,64,148
0131-002,2013,6,25,3,28,32,60,64
0131-002,2013,6,25,4,34,42,76,60
0131-002,2013,6,25,5,32,40,72,76
0131-002,2013,6,25,6,140,114,254,72
0131-002,2013,6,25,7,464,278,742,254
0131-002,2013,6,25,8,1360,966,2326,742
0131-002,2013,6,25,9,1236,1154,2390,2326
0131-002,2013,6,25,10,756,880,1636,2390
0131-002,2013,6,25,11,766,852,1618,1636
0131-002,2013,6,25,12,862,924,1786,1618
0131-002,2013,6,25,13,656,732,1388,1786
0131-002,2013,6,25,14,712,746,1458,1388
0131-002,2013,6,25,15,848,890,1738,1458
0131-002,2013,6,25,16,832,896,1728,1738
0131-002,2013,6,25,17,910,964,1874,1728
0131-002,2013,6,25,18,972,1210,2182,1874
0131-002,2013,6,25,19,988,1110,2098,2182
0131-002,2013,6,25,20,626,746,1372,2098
0131-002,2013,6,25,21,484,728,1212,1372
0131-002,2013,6,25,22,396,452,848,1212
0131-002,2013,6,25,23,264,290,554,848
0131-002,2013,6,25,24,156,144,300,554
0131-002,2013,6,26,1,114,104,218,300
0131-002,2013,6,26,2,66,66,132,218
0131-002,2013,6,26,3,24,32,56,132
0131-002,2013,6,26,4,44,56,100,56
0131-002,2013,6,26,5,44,60,104,100
0131-002,2013,6,26,6,116,92,208,104
0131-002,2013,6,26,7,372,216,588,208
0131-002,2013,6,26,8,1350,954,2304,588
0131-002,2013,6,26,9,1072,1066,2138,2304
0131-002,2013,6,26,10,740,798,1538,2138
0131-002,2013,6,26,11,762,776,1538,1538
0131-002,2013,6,26,12,574,822,1396,1538
0131-002,2013,6,26,13,518,736,1254,1396
0131-002,2013,6,26,14,668,746,1414,1254
0131-002,2013,6,26,15,890,902,1792,1414
0131-002,2013,6,26,16,774,868,1642,1792
0131-002,2013,6,26,17,772,818,1590,1642
0131-002,2013,6,26,18,846,1158,2004,1590
0131-002,2013,6,26,19,964,1200,2164,2004
0131-002,2013,6,26,20,692,840,1532,2164
0131-002,2013,6,26,21,520,678,1198,1532
0131-002,2013,6,26,22,492,486,978,1198
0131-002,2013,6,26,23,270,324,594,978
0131-002,2013,6,26,24,146,132,278,594
0131-002,2013,6,27,1,68,80,148,278
0131-002,2013,6,27,2,76,76,152,148
0131-002,2013,6,27,3,34,32,66,152
0131-002,2013,6,27,4,24,38,62,66
0131-002,2013,6,27,5,46,54,100,62
0131-002,2013,6,27,6,190,144,334,100
0131-002,2013,6,27,7,406,236,642,334
0131-002,2013,6,27,8,1352,994,2346,642
0131-002,2013,6,27,9,1140,1090,2230,2346
0131-002,2013,6,27,10,862,918,1780,2230
0131-002,2013,6,27,11,838,856,1694,1780
0131-002,2013,6,27,12,702,796,1498,1694
0131-002,2013,6,27,13,732,782,1514,1498
0131-002,2013,6,27,14,644,724,1368,1514
0131-002,2013,6,27,15,932,950,1882,1368
0131-002,2013,6,27,16,778,906,1684,1882
0131-002,2013,6,27,17,758,892,1650,1684
0131-002,2013,6,27,18,990,1118,2108,1650
0131-002,2013,6,27,19,954,1124,2078,2108
0131-002,2013,6,27,20,640,868,1508,2078
0131-002,2013,6,27,21,516,730,1246,1508
0131-002,2013,6,27,22,448,532,980,1246
0131-002,2013,6,27,23,216,242,458,980
0131-002,2013,6,27,24,180,186,366,458
0131-002,2013,6,28,1,106,104,210,366
0131-002,2013,6,28,2,56,66,122,210
0131-002,2013,6,28,3,36,36,72,122
0131-002,2013,6,28,4,20,26,46,72
0131-002,2013,6,28,5,46,60,106,46
0131-002,2013,6,28,6,132,100,232,106
0131-002,2013,6,28,7,460,264,724,232
0131-002,2013,6,28,8,1308,930,2238,724
0131-002,2013,6,28,9,1148,1100,2248,2238
0131-002,2013,6,28,10,758,826,1584,2248
0131-002,2013,6,28,11,768,846,1614,1584
0131-002,2013,6,28,12,788,880,1668,1614
0131-002,2013,6,28,13,738,760,1498,1668
0131-002,2013,6,28,14,738,794,1532,1498
0131-002,2013,6,28,15,802,892,1694,1532
0131-002,2013,6,28,16,868,938,1806,1694
0131-002,2013,6,28,17,958,1022,1980,1806
0131-002,2013,6,28,18,1180,1346,2526,1980
0131-002,2013,6,28,19,1212,1386,2598,2526
0131-002,2013,6,28,20,922,1086,2008,2598
0131-002,2013,6,28,21,506,780,1286,2008
0131-002,2013,6,28,22,426,598,1024,1286
0131-002,2013,6,28,23,324,354,678,1024
0131-002,2013,6,28,24,178,162,340,678
0131-002,2013,6,29,1,118,144,262,340
0131-002,2013,6,29,2,58,66,124,262
0131-002,2013,6,29,3,46,64,110,124
0131-002,2013,6,29,4,42,58,100,110
0131-002,2013,6,29,5,62,68,130,100
0131-002,2013,6,29,6,176,128,304,130
0131-002,2013,6,29,7,290,244,534,304
0131-002,2013,6,29,8,670,504,1174,534
0131-002,2013,6,29,9,944,806,1750,1174
0131-002,2013,6,29,10,806,926,1732,1750
0131-002,2013,6,29,11,872,1052,1924,1732
0131-002,2013,6,29,12,960,1112,2072,1924
0131-002,2013,6,29,13,770,996,1766,2072
0131-002,2013,6,29,14,664,962,1626,1766
0131-002,2013,6,29,15,660,924,1584,1626
0131-002,2013,6,29,16,648,916,1564,1584
0131-002,2013,6,29,17,852,978,1830,1564
0131-002,2013,6,29,18,960,1024,1984,1830
0131-002,2013,6,29,19,858,814,1672,1984
0131-002,2013,6,29,20,494,540,1034,1672
0131-002,2013,6,29,21,406,402,808,1034
0131-002,2013,6,29,22,358,346,704,808
0131-002,2013,6,29,23,240,246,486,704
0131-002,2013,6,29,24,102,146,248,486
0131-002,2013,6,30,1,68,76,144,248
0131-002,2013,6,30,2,58,56,114,144
0131-002,2013,6,30,3,30,40,70,114
0131-002,2013,6,30,4,42,36,78,70
0131-002,2013,6,30,5,42,48,90,78
0131-002,2013,6,30,6,86,74,160,90
0131-002,2013,6,30,7,158,128,286,160
0131-002,2013,6,30,8,244,202,446,286
0131-002,2013,6,30,9,286,294,580,446
0131-002,2013,6,30,10,280,340,620,580
0131-002,2013,6,30,11,338,446,784,620
0131-002,2013,6,30,12,440,396,836,784
0131-002,2013,6,30,13,546,470,1016,836
0131-002,2013,6,30,14,488,470,958,1016
0131-002,2013,6,30,15,546,462,1008,958
0131-002,2013,6,30,16,706,516,1222,1008
0131-002,2013,6,30,17,748,502,1250,1222
0131-002,2013,6,30,18,846,580,1426,1250
0131-002,2013,6,30,19,840,530,1370,1426
0131-002,2013,6,30,20,570,400,970,1370
0131-002,2013,6,30,21,442,350,792,970
0131-002,2013,6,30,22,356,302,658,792
0131-002,2013,6,30,23,174,170,344,658
0131-002,2013,6,30,24,104,86,190,344
0131-002,2013,7,1,1,108,66,174,190
0131-002,2013,7,1,2,56,26,82,174
0131-002,2013,7,1,3,48,18,66,82
0131-002,2013,7,1,4,42,18,60,66
0131-002,2013,7,1,5,80,46,126,60
0131-002,2013,7,1,6,194,92,286,126
0131-002,2013,7,1,7,642,332,974,286
0131-002,2013,7,1,8,1442,1066,2508,974
0131-002,2013,7,1,9,1136,994,2130,2508
0131-002,2013,7,1,10,796,776,1572,2130
0131-002,2013,7,1,11,860,766,1626,1572
0131-002,2013,7,1,12,768,816,1584,1626
0131-002,2013,7,1,13,628,676,1304,1584
0131-002,2013,7,1,14,762,724,1486,1304
0131-002,2013,7,1,15,800,870,1670,1486
0131-002,2013,7,1,16,868,814,1682,1670
0131-002,2013,7,1,17,818,886,1704,1682
0131-002,2013,7,1,18,862,1048,1910,1704
0131-002,2013,7,1,19,884,1098,1982,1910
0131-002,2013,7,1,20,710,878,1588,1982
0131-002,2013,7,1,21,580,790,1370,1588
0131-002,2013,7,1,22,502,416,918,1370
0131-002,2013,7,1,23,300,262,562,918
0131-002,2013,7,1,24,210,154,364,562
0131-002,2013,7,2,1,134,90,224,364
0131-002,2013,7,2,2,66,46,112,224
0131-002,2013,7,2,3,70,28,98,112
0131-002,2013,7,2,4,52,28,80,98
0131-002,2013,7,2,5,72,46,118,80
0131-002,2013,7,2,6,190,76,266,118
0131-002,2013,7,2,7,642,192,834,266
0131-002,2013,7,2,8,1324,918,2242,834
0131-002,2013,7,2,9,1102,1054,2156,2242
0131-002,2013,7,2,10,856,702,1558,2156
0131-002,2013,7,2,11,872,814,1686,1558
0131-002,2013,7,2,12,810,868,1678,1686
0131-002,2013,7,2,13,668,580,1248,1678
0131-002,2013,7,2,14,824,610,1434,1248
0131-002,2013,7,2,15,918,876,1794,1434
0131-002,2013,7,2,16,872,790,1662,1794
0131-002,2013,7,2,17,798,940,1738,1662
0131-002,2013,7,2,18,876,906,1782,1738
0131-002,2013,7,2,19,866,1026,1892,1782
0131-002,2013,7,2,20,694,714,1408,1892
0131-002,2013,7,2,21,566,694,1260,1408
0131-002,2013,7,2,22,470,434,904,1260
0131-002,2013,7,2,23,352,228,580,904
0131-002,2013,7,2,24,204,120,324,580
0131-002,2013,7,3,1,130,72,202,324
0131-002,2013,7,3,2,86,60,146,202
0131-002,2013,7,3,3,64,22,86,146
0131-002,2013,7,3,4,52,40,92,86
0131-002,2013,7,3,5,78,38,116,92
0131-002,2013,7,3,6,194,66,260,116
0131-002,2013,7,3,7,616,182,798,260
0131-002,2013,7,3,8,1374,832,2206,798
0131-002,2013,7,3,9,1120,940,2060,2206
0131-002,2013,7,3,10,888,756,1644,2060
0131-002,2013,7,3,11,858,742,1600,1644
0131-002,2013,7,3,12,776,754,1530,1600
0131-002,2013,7,3,13,652,564,1216,1530
0131-002,2013,7,3,14,844,704,1548,1216
0131-002,2013,7,3,15,876,792,1668,1548
0131-002,2013,7,3,16,912,816,1728,1668
0131-002,2013,7,3,17,892,886,1778,1728
0131-002,2013,7,3,18,880,1246,2126,1778
0131-002,2013,7,3,19,928,1232,2160,2126
0131-002,2013,7,3,20,690,828,1518,2160
0131-002,2013,7,3,21,568,636,1204,1518
0131-002,2013,7,3,22,478,494,972,1204
0131-002,2013,7,3,23,326,288,614,972
0131-002,2013,7,3,24,218,132,350,614
0131-002,2013,7,4,1,148,82,230,350
0131-002,2013,7,4,2,88,44,132,230
0131-002,2013,7,4,3,60,36,96,132
0131-002,2013,7,4,4,52,28,80,96
0131-002,2013,7,4,5,72,60,132,80
0131-002,2013,7,4,6,156,100,256,132
0131-002,2013,7,4,7,504,206,710,256
0131-002,2013,7,4,8,1316,874,2190,710
0131-002,2013,7,4,9,1060,1052,2112,2190
0131-002,2013,7,4,10,840,804,1644,2112
0131-002,2013,7,4,11,836,810,1646,1644
0131-002,2013,7,4,12,726,778,1504,1646
0131-002,2013,7,4,13,638,622,1260,1504
0131-002,2013,7,4,14,652,812,1464,1260
0131-002,2013,7,4,15,812,908,1720,1464
0131-002,2013,7,4,16,810,844,1654,1720
0131-002,2013,7,4,17,772,886,1658,1654
0131-002,2013,7,4,18,768,1124,1892,1658
0131-002,2013,7,4,19,714,1118,1832,1892
0131-002,2013,7,4,20,592,784,1376,1832
0131-002,2013,7,4,21,512,750,1262,1376
0131-002,2013,7,4,22,444,424,868,1262
0131-002,2013,7,4,23,300,238,538,868
0131-002,2013,7,4,24,216,174,390,538
0131-002,2013,7,5,1,134,98,232,390
0131-002,2013,7,5,2,72,54,126,232
0131-002,2013,7,5,3,52,28,80,126
0131-002,2013,7,5,4,56,40,96,80
0131-002,2013,7,5,5,50,40,90,96
0131-002,2013,7,5,6,138,54,192,90
0131-002,2013,7,5,7,496,158,654,192
0131-002,2013,7,5,8,1252,860,2112,654
0131-002,2013,7,5,9,1096,1034,2130,2112
0131-002,2013,7,5,10,724,844,1568,2130
0131-002,2013,7,5,11,834,866,1700,1568
0131-002,2013,7,5,12,728,816,1544,1700
0131-002,2013,7,5,13,652,634,1286,1544
0131-002,2013,7,5,14,782,722,1504,1286
0131-002,2013,7,5,15,822,922,1744,1504
0131-002,2013,7,5,16,880,870,1750,1744
0131-002,2013,7,5,17,802,948,1750,1750
0131-002,2013,7,5,18,878,1274,2152,1750
0131-002,2013,7,5,19,1082,1366,2448,2152
0131-002,2013,7,5,20,752,894,1646,2448
0131-002,2013,7,5,21,530,828,1358,1646
0131-002,2013,7,5,22,420,496,916,1358
0131-002,2013,7,5,23,328,344,672,916
0131-002,2013,7,5,24,228,150,378,672
0131-002,2013,7,6,1,166,80,246,378
0131-002,2013,7,6,2,110,48,158,246
0131-002,2013,7,6,3,72,36,108,158
0131-002,2013,7,6,4,68,46,114,108
0131-002,2013,7,6,5,72,62,134,114
0131-002,2013,7,6,6,170,110,280,134
0131-002,2013,7,6,7,348,140,488,280
0131-002,2013,7,6,8,744,510,1254,488
0131-002,2013,7,6,9,764,788,1552,1254
0131-002,2013,7,6,10,750,820,1570,1552
0131-002,2013,7,6,11,712,872,1584,1570
0131-002,2013,7,6,12,782,1016,1798,1584
0131-002,2013,7,6,13,702,880,1582,1798
0131-002,2013,7,6,14,730,878,1608,1582
0131-002,2013,7,6,15,724,834,1558,1608
0131-002,2013,7,6,16,754,838,1592,1558
0131-002,2013,7,6,17,882,872,1754,1592
0131-002,2013,7,6,18,954,1014,1968,1754
0131-002,2013,7,6,19,892,808,1700,1968
0131-002,2013,7,6,20,564,538,1102,1700
0131-002,2013,7,6,21,470,362,832,1102
0131-002,2013,7,6,22,424,370,794,832
0131-002,2013,7,6,23,306,184,490,794
0131-002,2013,7,6,24,216,136,352,490
0131-002,2013,7,7,1,142,82,224,352
0131-002,2013,7,7,2,90,64,154,224
0131-002,2013,7,7,3,76,38,114,154
0131-002,2013,7,7,4,52,22,74,114
0131-002,2013,7,7,5,56,24,80,74
0131-002,2013,7,7,6,124,70,194,80
0131-002,2013,7,7,7,212,80,292,194
0131-002,2013,7,7,8,284,146,430,292
0131-002,2013,7,7,9,350,272,622,430
0131-002,2013,7,7,10,400,334,734,622
0131-002,2013,7,7,11,492,354,846,734
0131-002,2013,7,7,12,480,390,870,846
0131-002,2013,7,7,13,454,480,934,870
0131-002,2013,7,7,14,530,438,968,934
0131-002,2013,7,7,15,640,496,1136,968
0131-002,2013,7,7,16,912,504,1416,1136
0131-002,2013,7,7,17,908,460,1368,1416
0131-002,2013,7,7,18,988,586,1574,1368
0131-002,2013,7,7,19,950,392,1342,1574
0131-002,2013,7,7,20,820,268,1088,1342
0131-002,2013,7,7,21,622,276,898,1088
0131-002,2013,7,7,22,422,232,654,898
0131-002,2013,7,7,23,262,124,386,654
0131-002,2013,7,7,24,174,82,256,386
0131-002,2013,7,8,1,124,40,164,256
0131-002,2013,7,8,2,56,14,70,164
0131-002,2013,7,8,3,56,18,74,70
0131-002,2013,7,8,4,42,32,74,74
0131-002,2013,7,8,5,66,30,96,74
0131-002,2013,7,8,6,194,102,296,96
0131-002,2013,7,8,7,652,262,914,296
0131-002,2013,7,8,8,1414,1028,2442,914
0131-002,2013,7,8,9,1102,1012,2114,2442
0131-002,2013,7,8,10,790,762,1552,2114
0131-002,2013,7,8,11,824,724,1548,1552
0131-002,2013,7,8,12,826,662,1488,1548
0131-002,2013,7,8,13,632,522,1154,1488
0131-002,2013,7,8,14,742,564,1306,1154
0131-002,2013,7,8,15,886,782,1668,1306
0131-002,2013,7,8,16,854,806,1660,1668
0131-002,2013,7,8,17,762,840,1602,1660
0131-002,2013,7,8,18,824,1012,1836,1602
0131-002,2013,7,8,19,874,1080,1954,1836
0131-002,2013,7,8,20,646,666,1312,1954
0131-002,2013,7,8,21,530,666,1196,1312
0131-002,2013,7,8,22,452,418,870,1196
0131-002,2013,7,8,23,326,216,542,870
0131-002,2013,7,8,24,180,84,264,542
0131-002,2013,7,9,1,124,78,202,264
0131-002,2013,7,9,2,74,52,126,202
0131-002,2013,7,9,3,64,38,102,126
0131-002,2013,7,9,4,50,32,82,102
0131-002,2013,7,9,5,60,32,92,82
0131-002,2013,7,9,6,182,114,296,92
0131-002,2013,7,9,7,526,204,730,296
0131-002,2013,7,9,8,1326,884,2210,730
0131-002,2013,7,9,9,1076,1136,2212,2210
0131-002,2013,7,9,10,874,804,1678,2212
0131-002,2013,7,9,11,826,818,1644,1678
0131-002,2013,7,9,12,804,732,1536,1644
0131-002,2013,7,9,13,648,698,1346,1536
0131-002,2013,7,9,14,822,728,1550,1346
0131-002,2013,7,9,15,868,906,1774,1550
0131-002,2013,7,9,16,848,940,1788,1774
0131-002,2013,7,9,17,774,942,1716,1788
0131-002,2013,7,9,18,834,1070,1904,1716
0131-002,2013,7,9,19,864,1142,2006,1904
0131-002,2013,7,9,20,612,848,1460,2006
0131-002,2013,7,9,21,530,756,1286,1460
0131-002,2013,7,9,22,464,524,988,1286
0131-002,2013,7,9,23,328,244,572,988
0131-002,2013,7,9,24,196,110,306,572
0131-002,2013,7,10,1,132,74,206,306
0131-002,2013,7,10,2,90,64,154,206
0131-002,2013,7,10,3,66,42,108,154
0131-002,2013,7,10,4,44,30,74,108
0131-002,2013,7,10,5,54,54,108,74
0131-002,2013,7,10,6,142,118,260,108
0131-002,2013,7,10,7,448,224,672,260
0131-002,2013,7,10,8,1292,890,2182,672
0131-002,2013,7,10,9,1066,1176,2242,2182
0131-002,2013,7,10,10,852,876,1728,2242
0131-002,2013,7,10,11,790,764,1554,1728
0131-002,2013,7,10,12,736,834,1570,1554
0131-002,2013,7,10,13,630,660,1290,1570
0131-002,2013,7,10,14,770,748,1518,1290
0131-002,2013,7,10,15,846,902,1748,1518
0131-002,2013,7,10,16,866,910,1776,1748
0131-002,2013,7,10,17,806,910,1716,1776
0131-002,2013,7,10,18,830,1292,2122,1716
0131-002,2013,7,10,19,872,1216,2088,2122
0131-002,2013,7,10,20,682,856,1538,2088
0131-002,2013,7,10,21,548,720,1268,1538
0131-002,2013,7,10,22,420,450,870,1268
0131-002,2013,7,10,23,328,234,562,870
0131-002,2013,7,10,24,202,122,324,562
0131-002,2013,7,11,1,136,92,228,324
0131-002,2013,7,11,2,76,50,126,228
0131-002,2013,7,11,3,72,36,108,126
0131-002,2013,7,11,4,68,36,104,108
0131-002,2013,7,11,5,70,56,126,104
0131-002,2013,7,11,6,164,108,272,126
0131-002,2013,7,11,7,514,266,780,272
0131-002,2013,7,11,8,1372,894,2266,780
0131-002,2013,7,11,9,1130,1074,2204,2266
0131-002,2013,7,11,10,912,836,1748,2204
0131-002,2013,7,11,11,894,858,1752,1748
0131-002,2013,7,11,12,780,814,1594,1752
0131-002,2013,7,11,13,638,726,1364,1594
0131-002,2013,7,11,14,726,736,1462,1364
0131-002,2013,7,11,15,880,928,1808,1462
0131-002,2013,7,11,16,850,888,1738,1808
0131-002,2013,7,11,17,870,966,1836,1738
0131-002,2013,7,11,18,850,1168,2018,1836
0131-002,2013,7,11,19,912,1154,2066,2018
0131-002,2013,7,11,20,708,850,1558,2066
0131-002,2013,7,11,21,578,696,1274,1558
0131-002,2013,7,11,22,508,474,982,1274
0131-002,2013,7,11,23,312,250,562,982
0131-002,2013,7,11,24,200,132,332,562
0131-002,2013,7,12,1,128,112,240,332
0131-002,2013,7,12,2,90,62,152,240
0131-002,2013,7,12,3,70,42,112,152
0131-002,2013,7,12,4,44,42,86,112
0131-002,2013,7,12,5,62,56,118,86
0131-002,2013,7,12,6,148,98,246,118
0131-002,2013,7,12,7,492,270,762,246
0131-002,2013,7,12,8,1320,1004,2324,762
0131-002,2013,7,12,9,1116,1068,2184,2324
0131-002,2013,7,12,10,914,824,1738,2184
0131-002,2013,7,12,11,840,906,1746,1738
0131-002,2013,7,12,12,770,882,1652,1746
0131-002,2013,7,12,13,654,670,1324,1652
0131-002,2013,7,12,14,828,832,1660,1324
0131-002,2013,7,12,15,922,982,1904,1660
0131-002,2013,7,12,16,902,894,1796,1904
0131-002,2013,7,12,17,954,994,1948,1796
0131-002,2013,7,12,18,1000,1340,2340,1948
0131-002,2013,7,12,19,1134,1576,2710,2340
0131-002,2013,7,12,20,738,1088,1826,2710
0131-002,2013,7,12,21,632,756,1388,1826
0131-002,2013,7,12,22,554,464,1018,1388
0131-002,2013,7,12,23,352,290,642,1018
0131-002,2013,7,12,24,242,134,376,642
0131-002,2013,7,13,1,148,98,246,376
0131-002,2013,7,13,2,110,72,182,246
0131-002,2013,7,13,3,96,50,146,182
0131-002,2013,7,13,4,66,38,104,146
0131-002,2013,7,13,5,78,72,150,104
0131-002,2013,7,13,6,166,82,248,150
0131-002,2013,7,13,7,328,164,492,248
0131-002,2013,7,13,8,790,556,1346,492
0131-002,2013,7,13,9,744,860,1604,1346
0131-002,2013,7,13,10,772,770,1542,1604
0131-002,2013,7,13,11,738,932,1670,1542
0131-002,2013,7,13,12,730,1076,1806,1670
0131-002,2013,7,13,13,670,1118,1788,1806
0131-002,2013,7,13,14,688,930,1618,1788
0131-002,2013,7,13,15,736,926,1662,1618
0131-002,2013,7,13,16,790,994,1784,1662
0131-002,2013,7,13,17,886,968,1854,1784
0131-002,2013,7,13,18,954,1194,2148,1854
0131-002,2013,7,13,19,916,872,1788,2148
0131-002,2013,7,13,20,662,426,1088,1788
0131-002,2013,7,13,21,494,358,852,1088
0131-002,2013,7,13,22,432,238,670,852
0131-002,2013,7,13,23,254,172,426,670
0131-002,2013,7,13,24,186,116,302,426
0131-002,2013,7,14,1,114,102,216,302
0131-002,2013,7,14,2,102,56,158,216
0131-002,2013,7,14,3,64,22,86,158
0131-002,2013,7,14,4,38,38,76,86
0131-002,2013,7,14,5,50,36,86,76
0131-002,2013,7,14,6,64,50,114,86
0131-002,2013,7,14,7,172,88,260,114
0131-002,2013,7,14,8,248,164,412,260
0131-002,2013,7,14,9,318,286,604,412
0131-002,2013,7,14,10,384,314,698,604
0131-002,2013,7,14,11,416,374,790,698
0131-002,2013,7,14,12,420,346,766,790
0131-002,2013,7,14,13,444,318,762,766
0131-002,2013,7,14,14,548,272,820,762
0131-002,2013,7,14,15,540,340,880,820
0131-002,2013,7,14,16,834,396,1230,880
0131-002,2013,7,14,17,998,392,1390,1230
0131-002,2013,7,14,18,1074,420,1494,1390
0131-002,2013,7,14,19,1002,308,1310,1494
0131-002,2013,7,14,20,618,284,902,1310
0131-002,2013,7,14,21,614,228,842,902
0131-002,2013,7,14,22,522,186,708,842
0131-002,2013,7,14,23,248,116,364,708
0131-002,2013,7,14,24,202,78,280,364
0131-002,2013,7,15,1,106,64,170,280
0131-002,2013,7,15,2,72,32,104,170
0131-002,2013,7,15,3,54,20,74,104
0131-002,2013,7,15,4,40,22,62,74
0131-002,2013,7,15,5,64,46,110,62
0131-002,2013,7,15,6,188,108,296,110
0131-002,2013,7,15,7,654,254,908,296
0131-002,2013,7,15,8,1428,978,2406,908
0131-002,2013,7,15,9,1106,1032,2138,2406
0131-002,2013,7,15,10,890,726,1616,2138
0131-002,2013,7,15,11,864,816,1680,1616
0131-002,2013,7,15,12,782,768,1550,1680
0131-002,2013,7,15,13,716,676,1392,1550
0131-002,2013,7,15,14,822,742,1564,1392
0131-002,2013,7,15,15,902,866,1768,1564
0131-002,2013,7,15,16,928,842,1770,1768
0131-002,2013,7,15,17,874,850,1724,1770
0131-002,2013,7,15,18,896,1016,1912,1724
0131-002,2013,7,15,19,912,1072,1984,1912
0131-002,2013,7,15,20,748,824,1572,1984
0131-002,2013,7,15,21,592,728,1320,1572
0131-002,2013,7,15,22,504,456,960,1320
0131-002,2013,7,15,23,314,206,520,960
0131-002,2013,7,15,24,204,150,354,520
0131-002,2013,7,16,1,120,102,222,354
0131-002,2013,7,16,2,74,40,114,222
0131-002,2013,7,16,3,56,22,78,114
0131-002,2013,7,16,4,52,54,106,78
0131-002,2013,7,16,5,64,52,116,106
0131-002,2013,7,16,6,218,106,324,116
0131-002,2013,7,16,7,570,246,816,324
0131-002,2013,7,16,8,1366,912,2278,816
0131-002,2013,7,16,9,1096,1016,2112,2278
0131-002,2013,7,16,10,896,848,1744,2112
0131-002,2013,7,16,11,902,886,1788,1744
0131-002,2013,7,16,12,856,770,1626,1788
0131-002,2013,7,16,13,668,674,1342,1626
0131-002,2013,7,16,14,782,740,1522,1342
0131-002,2013,7,16,15,874,802,1676,1522
0131-002,2013,7,16,16,886,858,1744,1676
0131-002,2013,7,16,17,898,944,1842,1744
0131-002,2013,7,16,18,844,1162,2006,1842
0131-002,2013,7,16,19,812,1180,1992,2006
0131-002,2013,7,16,20,690,862,1552,1992
0131-002,2013,7,16,21,566,722,1288,1552
0131-002,2013,7,16,22,496,530,1026,1288
0131-002,2013,7,16,23,328,282,610,1026
0131-002,2013,7,16,24,214,108,322,610
0131-002,2013,7,17,1,120,100,220,322
0131-002,2013,7,17,2,70,58,128,220
0131-002,2013,7,17,3,62,28,90,128
0131-002,2013,7,17,4,52,38,90,90
0131-002,2013,7,17,5,76,42,118,90
0131-002,2013,7,17,6,188,94,282,118
0131-002,2013,7,17,7,520,150,670,282
0131-002,2013,7,17,8,1296,746,2042,670
0131-002,2013,7,17,9,1108,894,2002,2042
0131-002,2013,7,17,10,896,684,1580,2002
0131-002,2013,7,17,11,888,706,1594,1580
0131-002,2013,7,17,12,790,690,1480,1594
0131-002,2013,7,17,13,632,694,1326,1480
0131-002,2013,7,17,14,758,704,1462,1326
0131-002,2013,7,17,15,872,810,1682,1462
0131-002,2013,7,17,16,796,758,1554,1682
0131-002,2013,7,17,17,870,792,1662,1554
0131-002,2013,7,17,18,860,1138,1998,1662
0131-002,2013,7,17,19,970,1064,2034,1998
0131-002,2013,7,17,20,678,684,1362,2034
0131-002,2013,7,17,21,564,544,1108,1362
0131-002,2013,7,17,22,458,430,888,1108
0131-002,2013,7,17,23,338,246,584,888
0131-002,2013,7,17,24,220,126,346,584
0131-002,2013,7,18,1,128,100,228,346
0131-002,2013,7,18,2,82,34,116,228
0131-002,2013,7,18,3,62,34,96,116
0131-002,2013,7,18,4,60,26,86,96
0131-002,2013,7,18,5,56,38,94,86
0131-002,2013,7,18,6,178,90,268,94
0131-002,2013,7,18,7,504,234,738,268
0131-002,2013,7,18,8,1302,886,2188,738
0131-002,2013,7,18,9,1102,974,2076,2188
0131-002,2013,7,18,10,864,902,1766,2076
0131-002,2013,7,18,11,814,840,1654,1766
0131-002,2013,7,18,12,788,880,1668,1654
0131-002,2013,7,18,13,630,810,1440,1668
0131-002,2013,7,18,14,754,870,1624,1440
0131-002,2013,7,18,15,864,940,1804,1624
0131-002,2013,7,18,16,916,858,1774,1804
0131-002,2013,7,18,17,824,902,1726,1774
0131-002,2013,7,18,18,822,1110,1932,1726
0131-002,2013,7,18,19,882,1156,2038,1932
0131-002,2013,7,18,20,678,846,1524,2038
0131-002,2013,7,18,21,566,756,1322,1524
0131-002,2013,7,18,22,494,538,1032,1322
0131-002,2013,7,18,23,354,304,658,1032
0131-002,2013,7,18,24,222,128,350,658
0131-002,2013,7,19,1,164,84,248,350
0131-002,2013,7,19,2,98,68,166,248
0131-002,2013,7,19,3,58,42,100,166
0131-002,2013,7,19,4,48,52,100,100
0131-002,2013,7,19,5,70,50,120,100
0131-002,2013,7,19,6,184,96,280,120
0131-002,2013,7,19,7,512,266,778,280
0131-002,2013,7,19,8,1372,1024,2396,778
0131-002,2013,7,19,9,1064,1140,2204,2396
0131-002,2013,7,19,10,852,886,1738,2204
0131-002,2013,7,19,11,866,874,1740,1738
0131-002,2013,7,19,12,864,868,1732,1740
0131-002,2013,7,19,13,682,822,1504,1732
0131-002,2013,7,19,14,796,806,1602,1504
0131-002,2013,7,19,15,924,1002,1926,1602
0131-002,2013,7,19,16,894,962,1856,1926
0131-002,2013,7,19,17,952,986,1938,1856
0131-002,2013,7,19,18,1058,1374,2432,1938
0131-002,2013,7,19,19,1206,1494,2700,2432
0131-002,2013,7,19,20,860,1142,2002,2700
0131-002,2013,7,19,21,652,820,1472,2002
0131-002,2013,7,19,22,564,564,1128,1472
0131-002,2013,7,19,23,360,328,688,1128
0131-002,2013,7,19,24,242,182,424,688
0131-002,2013,7,20,1,156,110,266,424
0131-002,2013,7,20,2,118,86,204,266
0131-002,2013,7,20,3,100,58,158,204
0131-002,2013,7,20,4,66,34,100,158
0131-002,2013,7,20,5,76,44,120,100
0131-002,2013,7,20,6,198,88,286,120
0131-002,2013,7,20,7,380,244,624,286
0131-002,2013,7,20,8,778,568,1346,624
0131-002,2013,7,20,9,826,832,1658,1346
0131-002,2013,7,20,10,770,960,1730,1658
0131-002,2013,7,20,11,744,1202,1946,1730
0131-002,2013,7,20,12,780,1186,1966,1946
0131-002,2013,7,20,13,656,1016,1672,1966
0131-002,2013,7,20,14,748,1046,1794,1672
0131-002,2013,7,20,15,714,928,1642,1794
0131-002,2013,7,20,16,702,856,1558,1642
0131-002,2013,7,20,17,800,850,1650,1558
0131-002,2013,7,20,18,912,990,1902,1650
0131-002,2013,7,20,19,936,912,1848,1902
0131-002,2013,7,20,20,590,462,1052,1848
0131-002,2013,7,20,21,528,360,888,1052
0131-002,2013,7,20,22,474,312,786,888
0131-002,2013,7,20,23,280,230,510,786
0131-002,2013,7,20,24,176,102,278,510
0131-002,2013,7,21,1,124,90,214,278
0131-002,2013,7,21,2,74,50,124,214
0131-002,2013,7,21,3,86,44,130,124
0131-002,2013,7,21,4,68,30,98,130
0131-002,2013,7,21,5,56,24,80,98
0131-002,2013,7,21,6,108,58,166,80
0131-002,2013,7,21,7,188,128,316,166
0131-002,2013,7,21,8,292,240,532,316
0131-002,2013,7,21,9,328,400,728,532
0131-002,2013,7,21,10,352,376,728,728
0131-002,2013,7,21,11,428,380,808,728
0131-002,2013,7,21,12,458,362,820,808
0131-002,2013,7,21,13,492,458,950,820
0131-002,2013,7,21,14,546,418,964,950
0131-002,2013,7,21,15,676,498,1174,964
0131-002,2013,7,21,16,966,482,1448,1174
0131-002,2013,7,21,17,970,476,1446,1448
0131-002,2013,7,21,18,998,560,1558,1446
0131-002,2013,7,21,19,840,442,1282,1558
0131-002,2013,7,21,20,572,356,928,1282
0131-002,2013,7,21,21,570,328,898,928
0131-002,2013,7,21,22,510,196,706,898
0131-002,2013,7,21,23,298,152,450,706
0131-002,2013,7,21,24,194,80,274,450
0131-002,2013,7,22,1,100,38,138,274
0131-002,2013,7,22,2,76,34,110,138
0131-002,2013,7,22,3,40,18,58,110
0131-002,2013,7,22,4,44,28,72,58
0131-002,2013,7,22,5,66,38,104,72
0131-002,2013,7,22,6,174,56,230,104
0131-002,2013,7,22,7,688,252,940,230
0131-002,2013,7,22,8,1422,866,2288,940
0131-002,2013,7,22,9,1110,1022,2132,2288
0131-002,2013,7,22,10,852,746,1598,2132
0131-002,2013,7,22,11,840,750,1590,1598
0131-002,2013,7,22,12,826,772,1598,1590
0131-002,2013,7,22,13,674,702,1376,1598
0131-002,2013,7,22,14,720,714,1434,1376
0131-002,2013,7,22,15,876,914,1790,1434
0131-002,2013,7,22,16,900,922,1822,1790
0131-002,2013,7,22,17,886,882,1768,1822
0131-002,2013,7,22,18,848,1132,1980,1768
0131-002,2013,7,22,19,948,1180,2128,1980
0131-002,2013,7,22,20,732,804,1536,2128
0131-002,2013,7,22,21,568,762,1330,1536
0131-002,2013,7,22,22,488,456,944,1330
0131-002,2013,7,22,23,304,250,554,944
0131-002,2013,7,22,24,192,126,318,554
0131-002,2013,7,23,1,142,58,200,318
0131-002,2013,7,23,2,86,54,140,200
0131-002,2013,7,23,3,70,44,114,140
0131-002,2013,7,23,4,40,58,98,114
0131-002,2013,7,23,5,72,44,116,98
0131-002,2013,7,23,6,170,100,270,116
0131-002,2013,7,23,7,552,220,772,270
0131-002,2013,7,23,8,1324,920,2244,772
0131-002,2013,7,23,9,1134,1058,2192,2244
0131-002,2013,7,23,10,926,720,1646,2192
0131-002,2013,7,23,11,832,706,1538,1646
0131-002,2013,7,23,12,826,752,1578,1538
0131-002,2013,7,23,13,656,608,1264,1578
0131-002,2013,7,23,14,808,678,1486,1264
0131-002,2013,7,23,15,902,742,1644,1486
0131-002,2013,7,23,16,882,860,1742,1644
0131-002,2013,7,23,17,846,858,1704,1742
0131-002,2013,7,23,18,912,972,1884,1704
0131-002,2013,7,23,19,946,1042,1988,1884
0131-002,2013,7,23,20,706,842,1548,1988
0131-002,2013,7,23,21,534,680,1214,1548
0131-002,2013,7,23,22,478,448,926,1214
0131-002,2013,7,23,23,348,258,606,926
0131-002,2013,7,23,24,198,126,324,606
0131-002,2013,7,24,1,162,108,270,324
0131-002,2013,7,24,2,84,36,120,270
0131-002,2013,7,24,3,66,24,90,120
0131-002,2013,7,24,4,52,42,94,90
0131-002,2013,7,24,5,72,26,98,94
0131-002,2013,7,24,6,164,70,234,98
0131-002,2013,7,24,7,500,180,680,234
0131-002,2013,7,24,8,1248,774,2022,680
0131-002,2013,7,24,9,1100,1052,2152,2022
0131-002,2013,7,24,10,850,894,1744,2152
0131-002,2013,7,24,11,824,808,1632,1744
0131-002,2013,7,24,12,776,714,1490,1632
0131-002,2013,7,24,13,658,600,1258,1490
0131-002,2013,7,24,14,748,690,1438,1258
0131-002,2013,7,24,15,858,818,1676,1438
0131-002,2013,7,24,16,870,894,1764,1676
0131-002,2013,7,24,17,828,912,1740,1764
0131-002,2013,7,24,18,868,1170,2038,1740
0131-002,2013,7,24,19,886,1226,2112,2038
0131-002,2013,7,24,20,708,816,1524,2112
0131-002,2013,7,24,21,536,710,1246,1524
0131-002,2013,7,24,22,440,450,890,1246
0131-002,2013,7,24,23,292,284,576,890
0131-002,2013,7,24,24,248,160,408,576
0131-002,2013,7,25,1,134,64,198,408
0131-002,2013,7,25,2,74,52,126,198
0131-002,2013,7,25,3,58,20,78,126
0131-002,2013,7,25,4,52,42,94,78
0131-002,2013,7,25,5,76,48,124,94
0131-002,2013,7,25,6,158,94,252,124
0131-002,2013,7,25,7,536,250,786,252
0131-002,2013,7,25,8,1324,818,2142,786
0131-002,2013,7,25,9,1104,1090,2194,2142
0131-002,2013,7,25,10,858,848,1706,2194
0131-002,2013,7,25,11,790,840,1630,1706
0131-002,2013,7,25,12,778,762,1540,1630
0131-002,2013,7,25,13,654,778,1432,1540
0131-002,2013,7,25,14,730,856,1586,1432
0131-002,2013,7,25,15,846,940,1786,1586
0131-002,2013,7,25,16,868,926,1794,1786
0131-002,2013,7,25,17,822,1046,1868,1794
0131-002,2013,7,25,18,858,1290,2148,1868
0131-002,2013,7,25,19,928,1224,2152,2148
0131-002,2013,7,25,20,696,850,1546,2152
0131-002,2013,7,25,21,568,592,1160,1546
0131-002,2013,7,25,22,452,466,918,1160
0131-002,2013,7,25,23,338,250,588,918
0131-002,2013,7,25,24,204,156,360,588
0131-002,2013,7,26,1,130,112,242,360
0131-002,2013,7,26,2,86,76,162,242
0131-002,2013,7,26,3,56,52,108,162
0131-002,2013,7,26,4,66,30,96,108
0131-002,2013,7,26,5,70,58,128,96
0131-002,2013,7,26,6,184,78,262,128
0131-002,2013,7,26,7,532,234,766,262
0131-002,2013,7,26,8,1282,880,2162,766
0131-002,2013,7,26,9,1080,1020,2100,2162
0131-002,2013,7,26,10,836,880,1716,2100
0131-002,2013,7,26,11,862,910,1772,1716
0131-002,2013,7,26,12,790,812,1602,1772
0131-002,2013,7,26,13,688,744,1432,1602
0131-002,2013,7,26,14,820,770,1590,1432
0131-002,2013,7,26,15,884,932,1816,1590
0131-002,2013,7,26,16,926,986,1912,1816
0131-002,2013,7,26,17,934,1160,2094,1912
0131-002,2013,7,26,18,1092,1442,2534,2094
0131-002,2013,7,26,19,1064,1660,2724,2534
0131-002,2013,7,26,20,946,1226,2172,2724
0131-002,2013,7,26,21,654,810,1464,2172
0131-002,2013,7,26,22,520,600,1120,1464
0131-002,2013,7,26,23,358,380,738,1120
0131-002,2013,7,26,24,256,168,424,738
0131-002,2013,7,27,1,152,112,264,424
0131-002,2013,7,27,2,108,68,176,264
0131-002,2013,7,27,3,82,50,132,176
0131-002,2013,7,27,4,82,54,136,132
0131-002,2013,7,27,5,78,58,136,136
0131-002,2013,7,27,6,164,118,282,136
0131-002,2013,7,27,7,390,244,634,282
0131-002,2013,7,27,8,708,558,1266,634
0131-002,2013,7,27,9,802,946,1748,1266
0131-002,2013,7,27,10,726,1372,2098,1748
0131-002,2013,7,27,11,754,1398,2152,2098
0131-002,2013,7,27,12,718,1498,2216,2152
0131-002,2013,7,27,13,680,1380,2060,2216
0131-002,2013,7,27,14,674,1322,1996,2060
0131-002,2013,7,27,15,702,1252,1954,1996
0131-002,2013,7,27,16,722,1146,1868,1954
0131-002,2013,7,27,17,680,1188,1868,1868
0131-002,2013,7,27,18,820,1174,1994,1868
0131-002,2013,7,27,19,762,876,1638,1994
0131-002,2013,7,27,20,566,488,1054,1638
0131-002,2013,7,27,21,486,418,904,1054
0131-002,2013,7,27,22,452,288,740,904
0131-002,2013,7,27,23,284,196,480,740
0131-002,2013,7,27,24,186,106,292,480
0131-002,2013,7,28,1,112,66,178,292
0131-002,2013,7,28,2,68,24,92,178
0131-002,2013,7,28,3,50,50,100,92
0131-002,2013,7,28,4,62,32,94,100
0131-002,2013,7,28,5,60,24,84,94
0131-002,2013,7,28,6,96,58,154,84
0131-002,2013,7,28,7,220,82,302,154
0131-002,2013,7,28,8,336,154,490,302
0131-002,2013,7,28,9,384,254,638,490
0131-002,2013,7,28,10,428,266,694,638
0131-002,2013,7,28,11,422,328,750,694
0131-002,2013,7,28,12,454,306,760,750
0131-002,2013,7,28,13,412,362,774,760
0131-002,2013,7,28,14,518,398,916,774
0131-002,2013,7,28,15,586,466,1052,916
0131-002,2013,7,28,16,724,462,1186,1052
0131-002,2013,7,28,17,828,446,1274,1186
0131-002,2013,7,28,18,996,494,1490,1274
0131-002,2013,7,28,19,852,416,1268,1490
0131-002,2013,7,28,20,652,316,968,1268
0131-002,2013,7,28,21,568,240,808,968
0131-002,2013,7,28,22,504,196,700,808
0131-002,2013,7,28,23,288,158,446,700
0131-002,2013,7,28,24,212,72,284,446
0131-002,2013,7,29,1,106,36,142,284
0131-002,2013,7,29,2,54,36,90,142
0131-002,2013,7,29,3,40,22,62,90
0131-002,2013,7,29,4,52,22,74,62
0131-002,2013,7,29,5,58,32,90,74
0131-002,2013,7,29,6,150,62,212,90
0131-002,2013,7,29,7,502,226,728,212
0131-002,2013,7,29,8,1058,884,1942,728
0131-002,2013,7,29,9,818,1000,1818,1942
0131-002,2013,7,29,10,704,710,1414,1818
0131-002,2013,7,29,11,732,786,1518,1414
0131-002,2013,7,29,12,732,682,1414,1518
0131-002,2013,7,29,13,578,710,1288,1414
0131-002,2013,7,29,14,668,768,1436,1288
0131-002,2013,7,29,15,776,778,1554,1436
0131-002,2013,7,29,16,834,840,1674,1554
0131-002,2013,7,29,17,780,752,1532,1674
0131-002,2013,7,29,18,784,896,1680,1532
0131-002,2013,7,29,19,852,1018,1870,1680
0131-002,2013,7,29,20,630,622,1252,1870
0131-002,2013,7,29,21,480,562,1042,1252
0131-002,2013,7,29,22,426,422,848,1042
0131-002,2013,7,29,23,268,224,492,848
0131-002,2013,7,29,24,202,130,332,492
0131-002,2013,7,30,1,114,56,170,332
0131-002,2013,7,30,2,76,46,122,170
0131-002,2013,7,30,3,52,38,90,122
0131-002,2013,7,30,4,52,36,88,90
0131-002,2013,7,30,5,62,46,108,88
0131-002,2013,7,30,6,150,72,222,108
0131-002,2013,7,30,7,458,206,664,222
0131-002,2013,7,30,8,984,778,1762,664
0131-002,2013,7,30,9,788,932,1720,1762
0131-002,2013,7,30,10,716,662,1378,1720
0131-002,2013,7,30,11,782,796,1578,1378
0131-002,2013,7,30,12,692,738,1430,1578
0131-002,2013,7,30,13,622,612,1234,1430
0131-002,2013,7,30,14,718,844,1562,1234
0131-002,2013,7,30,15,770,898,1668,1562
0131-002,2013,7,30,16,846,810,1656,1668
0131-002,2013,7,30,17,766,864,1630,1656
0131-002,2013,7,30,18,890,914,1804,1630
0131-002,2013,7,30,19,960,1088,2048,1804
0131-002,2013,7,30,20,810,612,1422,2048
0131-002,2013,7,30,21,560,522,1082,1422
0131-002,2013,7,30,22,460,360,820,1082
0131-002,2013,7,30,23,314,268,582,820
0131-002,2013,7,30,24,218,106,324,582
0131-002,2013,7,31,1,114,80,194,324
0131-002,2013,7,31,2,94,38,132,194
0131-002,2013,7,31,3,50,44,94,132
0131-002,2013,7,31,4,50,32,82,94
0131-002,2013,7,31,5,76,50,126,82
0131-002,2013,7,31,6,158,74,232,126
0131-002,2013,7,31,7,436,176,612,232
0131-002,2013,7,31,8,962,626,1588,612
0131-002,2013,7,31,9,802,834,1636,1588
0131-002,2013,7,31,10,730,704,1434,1636
0131-002,2013,7,31,11,730,682,1412,1434
0131-002,2013,7,31,12,688,698,1386,1412
0131-002,2013,7,31,13,570,638,1208,1386
0131-002,2013,7,31,14,646,826,1472,1208
0131-002,2013,7,31,15,706,852,1558,1472
0131-002,2013,7,31,16,798,840,1638,1558
0131-002,2013,7,31,17,852,810,1662,1638
0131-002,2013,7,31,18,932,1024,1956,1662
0131-002,2013,7,31,19,1106,976,2082,1956
0131-002,2013,7,31,20,938,662,1600,2082
0131-002,2013,7,31,21,716,510,1226,1600
0131-002,2013,7,31,22,502,400,902,1226
0131-002,2013,7,31,23,314,222,536,902
0131-002,2013,7,31,24,196,122,318,536
0131-002,2013,8,1,1,116,132,248,318
0131-002,2013,8,1,2,76,98,174,248
0131-002,2013,8,1,3,54,62,116,174
0131-002,2013,8,1,4,48,72,120,116
0131-002,2013,8,1,5,66,90,156,120
0131-002,2013,8,1,6,142,128,270,156
0131-002,2013,8,1,7,440,298,738,270
0131-002,2013,8,1,8,1056,834,1890,738
0131-002,2013,8,1,9,940,970,1910,1890
0131-002,2013,8,1,10,734,806,1540,1910
0131-002,2013,8,1,11,764,848,1612,1540
0131-002,2013,8,1,12,702,928,1630,1612
0131-002,2013,8,1,13,590,870,1460,1630
0131-002,2013,8,1,14,700,940,1640,1460
0131-002,2013,8,1,15,822,1082,1904,1640
0131-002,2013,8,1,16,758,942,1700,1904
0131-002,2013,8,1,17,774,946,1720,1700
0131-002,2013,8,1,18,768,1000,1768,1720
0131-002,2013,8,1,19,858,930,1788,1768
0131-002,2013,8,1,20,656,782,1438,1788
0131-002,2013,8,1,21,514,636,1150,1438
0131-002,2013,8,1,22,442,440,882,1150
0131-002,2013,8,1,23,348,344,692,882
0131-002,2013,8,1,24,202,192,394,692
0131-002,2013,8,2,1,116,124,240,394
0131-002,2013,8,2,2,70,90,160,240
0131-002,2013,8,2,3,50,66,116,160
0131-002,2013,8,2,4,42,54,96,116
0131-002,2013,8,2,5,70,98,168,96
0131-002,2013,8,2,6,146,158,304,168
0131-002,2013,8,2,7,440,282,722,304
0131-002,2013,8,2,8,1040,828,1868,722
0131-002,2013,8,2,9,916,940,1856,1868
0131-002,2013,8,2,10,716,760,1476,1856
0131-002,2013,8,2,11,736,788,1524,1476
0131-002,2013,8,2,12,698,814,1512,1524
0131-002,2013,8,2,13,586,730,1316,1512
0131-002,2013,8,2,14,744,866,1610,1316
0131-002,2013,8,2,15,804,964,1768,1610
0131-002,2013,8,2,16,794,896,1690,1768
0131-002,2013,8,2,17,792,968,1760,1690
0131-002,2013,8,2,18,924,1116,2040,1760
0131-002,2013,8,2,19,1018,1192,2210,2040
0131-002,2013,8,2,20,908,1048,1956,2210
0131-002,2013,8,2,21,642,814,1456,1956
0131-002,2013,8,2,22,566,636,1202,1456
0131-002,2013,8,2,23,354,492,846,1202
0131-002,2013,8,2,24,246,336,582,846
0131-002,2013,8,3,1,140,310,450,582
0131-002,2013,8,3,2,102,164,266,450
0131-002,2013,8,3,3,72,78,150,266
0131-002,2013,8,3,4,56,84,140,150
0131-002,2013,8,3,5,78,88,166,140
0131-002,2013,8,3,6,134,158,292,166
0131-002,2013,8,3,7,322,282,604,292
0131-002,2013,8,3,8,616,500,1116,604
0131-002,2013,8,3,9,696,962,1658,1116
0131-002,2013,8,3,10,668,1190,1858,1658
0131-002,2013,8,3,11,682,1382,2064,1858
0131-002,2013,8,3,12,642,1488,2130,2064
0131-002,2013,8,3,13,646,1368,2014,2130
0131-002,2013,8,3,14,672,1312,1984,2014
0131-002,2013,8,3,15,676,1398,2074,1984
0131-002,2013,8,3,16,778,1354,2132,2074
0131-002,2013,8,3,17,818,1264,2082,2132
0131-002,2013,8,3,18,918,1364,2282,2082
0131-002,2013,8,3,19,816,1288,2104,2282
0131-002,2013,8,3,20,664,1048,1712,2104
0131-002,2013,8,3,21,598,588,1186,1712
0131-002,2013,8,3,22,532,448,980,1186
0131-002,2013,8,3,23,308,326,634,980
0131-002,2013,8,3,24,206,196,402,634
0131-002,2013,8,4,1,120,144,264,402
0131-002,2013,8,4,2,80,92,172,264
0131-002,2013,8,4,3,54,70,124,172
0131-002,2013,8,4,4,62,42,104,124
0131-002,2013,8,4,5,52,54,106,104
0131-002,2013,8,4,6,84,108,192,106
0131-002,2013,8,4,7,202,194,396,192
0131-002,2013,8,4,8,334,274,608,396
0131-002,2013,8,4,9,312,412,724,608
0131-002,2013,8,4,10,384,466,850,724
0131-002,2013,8,4,11,424,560,984,850
0131-002,2013,8,4,12,426,606,1032,984
0131-002,2013,8,4,13,496,596,1092,1032
0131-002,2013,8,4,14,554,646,1200,1092
0131-002,2013,8,4,15,698,620,1318,1200
0131-002,2013,8,4,16,876,686,1562,1318
0131-002,2013,8,4,17,928,668,1596,1562
0131-002,2013,8,4,18,1004,712,1716,1596
0131-002,2013,8,4,19,984,730,1714,1716
0131-002,2013,8,4,20,842,508,1350,1714
0131-002,2013,8,4,21,664,454,1118,1350
0131-002,2013,8,4,22,546,382,928,1118
0131-002,2013,8,4,23,318,260,578,928
0131-002,2013,8,4,24,224,166,390,578
0131-002,2013,8,5,1,116,124,240,390
0131-002,2013,8,5,2,48,70,118,240
0131-002,2013,8,5,3,44,42,86,118
0131-002,2013,8,5,4,48,46,94,86
0131-002,2013,8,5,5,62,92,154,94
0131-002,2013,8,5,6,146,144,290,154
0131-002,2013,8,5,7,518,372,890,290
0131-002,2013,8,5,8,1166,938,2104,890
0131-002,2013,8,5,9,908,916,1824,2104
0131-002,2013,8,5,10,738,792,1530,1824
0131-002,2013,8,5,11,742,764,1506,1530
0131-002,2013,8,5,12,758,822,1580,1506
0131-002,2013,8,5,13,582,706,1288,1580
0131-002,2013,8,5,14,700,796,1496,1288
0131-002,2013,8,5,15,786,848,1634,1496
0131-002,2013,8,5,16,840,862,1702,1634
0131-002,2013,8,5,17,800,834,1634,1702
0131-002,2013,8,5,18,800,928,1728,1634
0131-002,2013,8,5,19,906,956,1862,1728
0131-002,2013,8,5,20,654,722,1376,1862
0131-002,2013,8,5,21,470,640,1110,1376
0131-002,2013,8,5,22,422,476,898,1110
0131-002,2013,8,5,23,272,306,578,898
0131-002,2013,8,5,24,218,190,408,578
0131-002,2013,8,6,1,114,122,236,408
0131-002,2013,8,6,2,86,102,188,236
0131-002,2013,8,6,3,46,72,118,188
0131-002,2013,8,6,4,46,56,102,118
0131-002,2013,8,6,5,76,86,162,102
0131-002,2013,8,6,6,162,162,324,162
0131-002,2013,8,6,7,522,322,844,324
0131-002,2013,8,6,8,1092,802,1894,844
0131-002,2013,8,6,9,904,1012,1916,1894
0131-002,2013,8,6,10,790,816,1606,1916
0131-002,2013,8,6,11,800,822,1622,1606
0131-002,2013,8,6,12,788,842,1630,1622
0131-002,2013,8,6,13,620,776,1396,1630
0131-002,2013,8,6,14,738,880,1618,1396
0131-002,2013,8,6,15,816,938,1754,1618
0131-002,2013,8,6,16,884,870,1754,1754
0131-002,2013,8,6,17,840,838,1678,1754
0131-002,2013,8,6,18,924,922,1846,1678
0131-002,2013,8,6,19,972,956,1928,1846
0131-002,2013,8,6,20,856,772,1628,1928
0131-002,2013,8,6,21,582,654,1236,1628
0131-002,2013,8,6,22,450,498,948,1236
0131-002,2013,8,6,23,332,338,670,948
0131-002,2013,8,6,24,198,222,420,670
0131-002,2013,8,7,1,130,134,264,420
0131-002,2013,8,7,2,74,96,170,264
0131-002,2013,8,7,3,54,64,118,170
0131-002,2013,8,7,4,54,60,114,118
0131-002,2013,8,7,5,70,86,156,114
0131-002,2013,8,7,6,164,150,314,156
0131-002,2013,8,7,7,502,340,842,314
0131-002,2013,8,7,8,1104,838,1942,842
0131-002,2013,8,7,9,960,984,1944,1942
0131-002,2013,8,7,10,738,792,1530,1944
0131-002,2013,8,7,11,792,806,1598,1530
0131-002,2013,8,7,12,736,784,1520,1598
0131-002,2013,8,7,13,620,714,1334,1520
0131-002,2013,8,7,14,730,820,1550,1334
0131-002,2013,8,7,15,784,824,1608,1550
0131-002,2013,8,7,16,870,834,1704,1608
0131-002,2013,8,7,17,902,892,1794,1704
0131-002,2013,8,7,18,926,972,1898,1794
0131-002,2013,8,7,19,1146,1026,2172,1898
0131-002,2013,8,7,20,956,726,1682,2172
0131-002,2013,8,7,21,726,626,1352,1682
0131-002,2013,8,7,22,504,488,992,1352
0131-002,2013,8,7,23,282,348,630,992
0131-002,2013,8,7,24,184,208,392,630
0131-002,2013,8,8,1,122,136,258,392
0131-002,2013,8,8,2,84,98,182,258
0131-002,2013,8,8,3,66,78,144,182
0131-002,2013,8,8,4,38,70,108,144
0131-002,2013,8,8,5,64,92,156,108
0131-002,2013,8,8,6,150,162,312,156
0131-002,2013,8,8,7,510,320,830,312
0131-002,2013,8,8,8,1196,894,2090,830
0131-002,2013,8,8,9,1008,1048,2056,2090
0131-002,2013,8,8,10,792,886,1678,2056
0131-002,2013,8,8,11,842,846,1688,1678
0131-002,2013,8,8,12,812,834,1646,1688
0131-002,2013,8,8,13,620,726,1346,1646
0131-002,2013,8,8,14,742,758,1500,1346
0131-002,2013,8,8,15,852,926,1778,1500
0131-002,2013,8,8,16,796,852,1648,1778
0131-002,2013,8,8,17,860,874,1734,1648
0131-002,2013,8,8,18,852,982,1834,1734
0131-002,2013,8,8,19,848,1008,1856,1834
0131-002,2013,8,8,20,600,800,1400,1856
0131-002,2013,8,8,21,540,658,1198,1400
0131-002,2013,8,8,22,464,504,968,1198
0131-002,2013,8,8,23,278,362,640,968
0131-002,2013,8,8,24,208,190,398,640
0131-002,2013,8,9,1,140,142,282,398
0131-002,2013,8,9,2,74,90,164,282
0131-002,2013,8,9,3,48,62,110,164
0131-002,2013,8,9,4,50,74,124,110
0131-002,2013,8,9,5,78,106,184,124
0131-002,2013,8,9,6,160,172,332,184
0131-002,2013,8,9,7,544,300,844,332
0131-002,2013,8,9,8,1148,908,2056,844
0131-002,2013,8,9,9,1020,1072,2092,2056
0131-002,2013,8,9,10,838,834,1672,2092
0131-002,2013,8,9,11,792,844,1636,1672
0131-002,2013,8,9,12,754,836,1590,1636
0131-002,2013,8,9,13,704,794,1498,1590
0131-002,2013,8,9,14,754,874,1628,1498
0131-002,2013,8,9,15,808,946,1754,1628
0131-002,2013,8,9,16,866,990,1856,1754
0131-002,2013,8,9,17,950,956,1906,1856
0131-002,2013,8,9,18,964,1046,2010,1906
0131-002,2013,8,9,19,1000,1122,2122,2010
0131-002,2013,8,9,20,820,894,1714,2122
0131-002,2013,8,9,21,604,760,1364,1714
0131-002,2013,8,9,22,588,582,1170,1364
0131-002,2013,8,9,23,338,380,718,1170
0131-002,2013,8,9,24,234,252,486,718
0131-002,2013,8,10,1,172,172,344,486
0131-002,2013,8,10,2,116,124,240,344
0131-002,2013,8,10,3,82,100,182,240
0131-002,2013,8,10,4,68,92,160,182
0131-002,2013,8,10,5,74,94,168,160
0131-002,2013,8,10,6,174,158,332,168
0131-002,2013,8,10,7,356,346,702,332
0131-002,2013,8,10,8,756,576,1332,702
0131-002,2013,8,10,9,722,746,1468,1332
0131-002,2013,8,10,10,724,798,1522,1468
0131-002,2013,8,10,11,694,978,1672,1522
0131-002,2013,8,10,12,692,1142,1834,1672
0131-002,2013,8,10,13,652,1096,1748,1834
0131-002,2013,8,10,14,718,1138,1856,1748
0131-002,2013,8,10,15,754,1054,1808,1856
0131-002,2013,8,10,16,814,920,1734,1808
0131-002,2013,8,10,17,890,880,1770,1734
0131-002,2013,8,10,18,982,950,1932,1770
0131-002,2013,8,10,19,902,826,1728,1932
0131-002,2013,8,10,20,726,634,1360,1728
0131-002,2013,8,10,21,502,452,954,1360
0131-002,2013,8,10,22,530,422,952,954
0131-002,2013,8,10,23,274,282,556,952
0131-002,2013,8,10,24,212,204,416,556
0131-002,2013,8,11,1,120,154,274,416
0131-002,2013,8,11,2,88,102,190,274
0131-002,2013,8,11,3,64,72,136,190
0131-002,2013,8,11,4,60,70,130,136
0131-002,2013,8,11,5,58,70,128,130
0131-002,2013,8,11,6,118,88,206,128
0131-002,2013,8,11,7,196,216,412,206
0131-002,2013,8,11,8,296,258,554,412
0131-002,2013,8,11,9,364,374,738,554
0131-002,2013,8,11,10,408,418,826,738
0131-002,2013,8,11,11,418,506,924,826
0131-002,2013,8,11,12,480,492,972,924
0131-002,2013,8,11,13,646,540,1186,972
0131-002,2013,8,11,14,652,560,1212,1186
0131-002,2013,8,11,15,778,566,1344,1212
0131-002,2013,8,11,16,846,584,1430,1344
0131-002,2013,8,11,17,942,590,1532,1430
0131-002,2013,8,11,18,910,566,1476,1532
0131-002,2013,8,11,19,864,470,1334,1476
0131-002,2013,8,11,20,768,466,1234,1334
0131-002,2013,8,11,21,598,362,960,1234
0131-002,2013,8,11,22,494,326,820,960
0131-002,2013,8,11,23,242,238,480,820
0131-002,2013,8,11,24,164,142,306,480
0131-002,2013,8,12,1,108,94,202,306
0131-002,2013,8,12,2,68,70,138,202
0131-002,2013,8,12,3,44,60,104,138
0131-002,2013,8,12,4,38,52,90,104
0131-002,2013,8,12,5,50,70,120,90
0131-002,2013,8,12,6,132,140,272,120
0131-002,2013,8,12,7,596,360,956,272
0131-002,2013,8,12,8,1404,1030,2434,956
0131-002,2013,8,12,9,1044,1068,2112,2434
0131-002,2013,8,12,10,780,848,1628,2112
0131-002,2013,8,12,11,794,852,1646,1628
0131-002,2013,8,12,12,780,830,1610,1646
0131-002,2013,8,12,13,676,770,1446,1610
0131-002,2013,8,12,14,768,794,1562,1446
0131-002,2013,8,12,15,848,902,1750,1562
0131-002,2013,8,12,16,860,888,1748,1750
0131-002,2013,8,12,17,880,892,1772,1748
0131-002,2013,8,12,18,772,988,1760,1772
0131-002,2013,8,12,19,924,992,1916,1760
0131-002,2013,8,12,20,644,802,1446,1916
0131-002,2013,8,12,21,548,710,1258,1446
0131-002,2013,8,12,22,456,546,1002,1258
0131-002,2013,8,12,23,328,356,684,1002
0131-002,2013,8,12,24,194,196,390,684
0131-002,2013,8,13,1,138,122,260,390
0131-002,2013,8,13,2,60,82,142,260
0131-002,2013,8,13,3,64,60,124,142
0131-002,2013,8,13,4,50,66,116,124
0131-002,2013,8,13,5,52,80,132,116
0131-002,2013,8,13,6,176,150,326,132
0131-002,2013,8,13,7,546,340,886,326
0131-002,2013,8,13,8,1364,1004,2368,886
0131-002,2013,8,13,9,1056,1024,2080,2368
0131-002,2013,8,13,10,820,914,1734,2080
0131-002,2013,8,13,11,852,840,1692,1734
0131-002,2013,8,13,12,816,864,1680,1692
0131-002,2013,8,13,13,624,754,1378,1680
0131-002,2013,8,13,14,774,852,1626,1378
0131-002,2013,8,13,15,884,988,1872,1626
0131-002,2013,8,13,16,868,968,1836,1872
0131-002,2013,8,13,17,886,984,1870,1836
0131-002,2013,8,13,18,932,1038,1970,1870
0131-002,2013,8,13,19,944,1182,2126,1970
0131-002,2013,8,13,20,690,956,1646,2126
0131-002,2013,8,13,21,586,806,1392,1646
0131-002,2013,8,13,22,478,552,1030,1392
0131-002,2013,8,13,23,328,370,698,1030
0131-002,2013,8,13,24,224,240,464,698
0131-002,2013,8,14,1,154,144,298,464
0131-002,2013,8,14,2,116,110,226,298
0131-002,2013,8,14,3,70,72,142,226
0131-002,2013,8,14,4,62,68,130,142
0131-002,2013,8,14,5,78,92,170,130
0131-002,2013,8,14,6,132,130,262,170
0131-002,2013,8,14,7,390,258,648,262
0131-002,2013,8,14,8,940,716,1656,648
0131-002,2013,8,14,9,874,868,1742,1656
0131-002,2013,8,14,10,716,726,1442,1742
0131-002,2013,8,14,11,690,714,1404,1442
0131-002,2013,8,14,12,686,720,1406,1404
0131-002,2013,8,14,13,582,692,1274,1406
0131-002,2013,8,14,14,648,686,1334,1274
0131-002,2013,8,14,15,688,756,1444,1334
0131-002,2013,8,14,16,700,762,1462,1444
0131-002,2013,8,14,17,738,766,1504,1462
0131-002,2013,8,14,18,866,864,1730,1504
0131-002,2013,8,14,19,806,880,1686,1730
0131-002,2013,8,14,20,548,656,1204,1686
0131-002,2013,8,14,21,430,490,920,1204
0131-002,2013,8,14,22,342,374,716,920
0131-002,2013,8,14,23,280,278,558,716
0131-002,2013,8,14,24,158,186,344,558
0131-002,2013,8,15,1,114,114,228,344
0131-002,2013,8,15,2,84,98,182,228
0131-002,2013,8,15,3,58,52,110,182
0131-002,2013,8,15,4,52,64,116,110
0131-002,2013,8,15,5,72,94,166,116
0131-002,2013,8,15,6,164,146,310,166
0131-002,2013,8,15,7,556,324,880,310
0131-002,2013,8,15,8,1372,1022,2394,880
0131-002,2013,8,15,9,1168,1120,2288,2394
0131-002,2013,8,15,10,846,828,1674,2288
0131-002,2013,8,15,11,890,864,1754,1674
0131-002,2013,8,15,12,808,894,1702,1754
0131-002,2013,8,15,13,646,788,1434,1702
0131-002,2013,8,15,14,860,858,1718,1434
0131-002,2013,8,15,15,912,994,1906,1718
0131-002,2013,8,15,16,914,946,1860,1906
0131-002,2013,8,15,17,902,972,1874,1860
0131-002,2013,8,15,18,868,972,1840,1874
0131-002,2013,8,15,19,902,1026,1928,1840
0131-002,2013,8,15,20,672,884,1556,1928
0131-002,2013,8,15,21,540,754,1294,1556
0131-002,2013,8,15,22,456,564,1020,1294
0131-002,2013,8,15,23,338,352,690,1020
0131-002,2013,8,15,24,228,224,452,690
0131-002,2013,8,16,1,142,148,290,452
0131-002,2013,8,16,2,90,80,170,290
0131-002,2013,8,16,3,60,58,118,170
0131-002,2013,8,16,4,68,64,132,118
0131-002,2013,8,16,5,80,110,190,132
0131-002,2013,8,16,6,166,158,324,190
0131-002,2013,8,16,7,550,332,882,324
0131-002,2013,8,16,8,1302,968,2270,882
0131-002,2013,8,16,9,1130,1150,2280,2270
0131-002,2013,8,16,10,914,952,1866,2280
0131-002,2013,8,16,11,876,960,1836,1866
0131-002,2013,8,16,12,854,906,1760,1836
0131-002,2013,8,16,13,644,810,1454,1760
0131-002,2013,8,16,14,802,858,1660,1454
0131-002,2013,8,16,15,944,970,1914,1660
0131-002,2013,8,16,16,836,1026,1862,1914
0131-002,2013,8,16,17,950,1068,2018,1862
0131-002,2013,8,16,18,1006,1274,2280,2018
0131-002,2013,8,16,19,1130,1260,2390,2280
0131-002,2013,8,16,20,984,1080,2064,2390
0131-002,2013,8,16,21,784,1018,1802,2064
0131-002,2013,8,16,22,614,710,1324,1802
0131-002,2013,8,16,23,354,482,836,1324
0131-002,2013,8,16,24,230,298,528,836
0131-002,2013,8,17,1,166,174,340,528
0131-002,2013,8,17,2,106,144,250,340
0131-002,2013,8,17,3,64,94,158,250
0131-002,2013,8,17,4,70,78,148,158
0131-002,2013,8,17,5,68,108,176,148
0131-002,2013,8,17,6,144,130,274,176
0131-002,2013,8,17,7,376,290,666,274
0131-002,2013,8,17,8,774,590,1364,666
0131-002,2013,8,17,9,758,822,1580,1364
0131-002,2013,8,17,10,752,874,1626,1580
0131-002,2013,8,17,11,754,1138,1892,1626
0131-002,2013,8,17,12,716,1238,1954,1892
0131-002,2013,8,17,13,650,1414,2064,1954
0131-002,2013,8,17,14,724,1496,2220,2064
0131-002,2013,8,17,15,780,1534,2314,2220
0131-002,2013,8,17,16,762,1482,2244,2314
0131-002,2013,8,17,17,758,1446,2204,2244
0131-002,2013,8,17,18,812,1584,2396,2204
0131-002,2013,8,17,19,736,1318,2054,2396
0131-002,2013,8,17,20,562,1064,1626,2054
0131-002,2013,8,17,21,514,1186,1700,1626
0131-002,2013,8,17,22,458,648,1106,1700
0131-002,2013,8,17,23,274,434,708,1106
0131-002,2013,8,17,24,168,208,376,708
0131-002,2013,8,18,1,120,138,258,376
0131-002,2013,8,18,2,92,110,202,258
0131-002,2013,8,18,3,70,70,140,202
0131-002,2013,8,18,4,56,72,128,140
0131-002,2013,8,18,5,62,66,128,128
0131-002,2013,8,18,6,88,86,174,128
0131-002,2013,8,18,7,212,168,380,174
0131-002,2013,8,18,8,322,248,570,380
0131-002,2013,8,18,9,370,400,770,570
0131-002,2013,8,18,10,378,418,796,770
0131-002,2013,8,18,11,440,524,964,796
0131-002,2013,8,18,12,470,608,1078,964
0131-002,2013,8,18,13,430,612,1042,1078
0131-002,2013,8,18,14,516,610,1126,1042
0131-002,2013,8,18,15,630,624,1254,1126
0131-002,2013,8,18,16,798,674,1472,1254
0131-002,2013,8,18,17,918,722,1640,1472
0131-002,2013,8,18,18,964,792,1756,1640
0131-002,2013,8,18,19,836,698,1534,1756
0131-002,2013,8,18,20,794,586,1380,1534
0131-002,2013,8,18,21,752,426,1178,1380
0131-002,2013,8,18,22,660,348,1008,1178
0131-002,2013,8,18,23,444,264,708,1008
0131-002,2013,8,18,24,222,166,388,708
0131-002,2013,8,19,1,132,120,252,388
0131-002,2013,8,19,2,62,94,156,252
0131-002,2013,8,19,3,64,52,116,156
0131-002,2013,8,19,4,46,56,102,116
0131-002,2013,8,19,5,68,86,154,102
0131-002,2013,8,19,6,140,174,314,154
0131-002,2013,8,19,7,484,338,822,314
0131-002,2013,8,19,8,1002,780,1782,822
0131-002,2013,8,19,9,872,800,1672,1782
0131-002,2013,8,19,10,666,724,1390,1672
0131-002,2013,8,19,11,804,770,1574,1390
0131-002,2013,8,19,12,914,718,1632,1574
0131-002,2013,8,19,13,898,696,1594,1632
0131-002,2013,8,19,14,898,692,1590,1594
0131-002,2013,8,19,15,906,802,1708,1590
0131-002,2013,8,19,16,1228,780,2008,1708
0131-002,2013,8,19,17,1208,828,2036,2008
0131-002,2013,8,19,18,1110,840,1950,2036
0131-002,2013,8,19,19,974,854,1828,1950
0131-002,2013,8,19,20,858,688,1546,1828
0131-002,2013,8,19,21,812,624,1436,1546
0131-002,2013,8,19,22,510,446,956,1436
0131-002,2013,8,19,23,320,314,634,956
0131-002,2013,8,19,24,204,196,400,634
0131-002,2013,8,20,1,116,122,238,400
0131-002,2013,8,20,2,72,84,156,238
0131-002,2013,8,20,3,58,52,110,156
0131-002,2013,8,20,4,40,70,110,110
0131-002,2013,8,20,5,58,84,142,110
0131-002,2013,8,20,6,166,170,336,142
0131-002,2013,8,20,7,564,360,924,336
0131-002,2013,8,20,8,1356,1078,2434,924
0131-002,2013,8,20,9,1132,1118,2250,2434
0131-002,2013,8,20,10,864,900,1764,2250
0131-002,2013,8,20,11,904,876,1780,1764
0131-002,2013,8,20,12,832,918,1750,1780
0131-002,2013,8,20,13,670,770,1440,1750
0131-002,2013,8,20,14,818,870,1688,1440
0131-002,2013,8,20,15,862,998,1860,1688
0131-002,2013,8,20,16,852,846,1698,1860
0131-002,2013,8,20,17,832,928,1760,1698
0131-002,2013,8,20,18,916,972,1888,1760
0131-002,2013,8,20,19,832,1006,1838,1888
0131-002,2013,8,20,20,678,840,1518,1838
0131-002,2013,8,20,21,564,748,1312,1518
0131-002,2013,8,20,22,452,532,984,1312
0131-002,2013,8,20,23,290,344,634,984
0131-002,2013,8,20,24,208,216,424,634
0131-002,2013,8,21,1,132,118,250,424
0131-002,2013,8,21,2,78,92,170,250
0131-002,2013,8,21,3,54,58,112,170
0131-002,2013,8,21,4,42,54,96,112
0131-002,2013,8,21,5,50,78,128,96
0131-002,2013,8,21,6,130,112,242,128
0131-002,2013,8,21,7,462,264,726,242
0131-002,2013,8,21,8,1234,946,2180,726
0131-002,2013,8,21,9,1092,1068,2160,2180
0131-002,2013,8,21,10,834,860,1694,2160
0131-002,2013,8,21,11,786,860,1646,1694
0131-002,2013,8,21,12,814,814,1628,1646
0131-002,2013,8,21,13,680,730,1410,1628
0131-002,2013,8,21,14,776,794,1570,1410
0131-002,2013,8,21,15,814,870,1684,1570
0131-002,2013,8,21,16,878,950,1828,1684
0131-002,2013,8,21,17,866,888,1754,1828
0131-002,2013,8,21,18,860,1028,1888,1754
0131-002,2013,8,21,19,838,1058,1896,1888
0131-002,2013,8,21,20,660,770,1430,1896
0131-002,2013,8,21,21,496,648,1144,1430
0131-002,2013,8,21,22,428,492,920,1144
0131-002,2013,8,21,23,284,346,630,920
0131-002,2013,8,21,24,186,192,378,630
0131-002,2013,8,22,1,140,122,262,378
0131-002,2013,8,22,2,72,86,158,262
0131-002,2013,8,22,3,66,72,138,158
0131-002,2013,8,22,4,42,66,108,138
0131-002,2013,8,22,5,54,80,134,108
0131-002,2013,8,22,6,156,124,280,134
0131-002,2013,8,22,7,546,322,868,280
0131-002,2013,8,22,8,1282,1014,2296,868
0131-002,2013,8,22,9,1146,1108,2254,2296
0131-002,2013,8,22,10,846,888,1734,2254
0131-002,2013,8,22,11,832,942,1774,1734
0131-002,2013,8,22,12,820,880,1700,1774
0131-002,2013,8,22,13,642,748,1390,1700
0131-002,2013,8,22,14,772,872,1644,1390
0131-002,2013,8,22,15,832,890,1722,1644
0131-002,2013,8,22,16,912,884,1796,1722
0131-002,2013,8,22,17,868,886,1754,1796
0131-002,2013,8,22,18,922,1070,1992,1754
0131-002,2013,8,22,19,936,1032,1968,1992
0131-002,2013,8,22,20,694,870,1564,1968
0131-002,2013,8,22,21,600,758,1358,1564
0131-002,2013,8,22,22,480,560,1040,1358
0131-002,2013,8,22,23,332,380,712,1040
0131-002,2013,8,22,24,204,216,420,712
0131-002,2013,8,23,1,126,166,292,420
0131-002,2013,8,23,2,92,96,188,292
0131-002,2013,8,23,3,76,68,144,188
0131-002,2013,8,23,4,42,72,114,144
0131-002,2013,8,23,5,62,102,164,114
0131-002,2013,8,23,6,168,164,332,164
0131-002,2013,8,23,7,504,312,816,332
0131-002,2013,8,23,8,1302,1026,2328,816
0131-002,2013,8,23,9,1170,1132,2302,2328
0131-002,2013,8,23,10,904,918,1822,2302
0131-002,2013,8,23,11,850,882,1732,1822
0131-002,2013,8,23,12,826,854,1680,1732
0131-002,2013,8,23,13,700,800,1500,1680
0131-002,2013,8,23,14,822,900,1722,1500
0131-002,2013,8,23,15,908,994,1902,1722
0131-002,2013,8,23,16,896,972,1868,1902
0131-002,2013,8,23,17,896,1014,1910,1868
0131-002,2013,8,23,18,990,1096,2086,1910
0131-002,2013,8,23,19,1078,1136,2214,2086
0131-002,2013,8,23,20,804,962,1766,2214
0131-002,2013,8,23,21,624,738,1362,1766
0131-002,2013,8,23,22,478,590,1068,1362
0131-002,2013,8,23,23,336,410,746,1068
0131-002,2013,8,23,24,232,246,478,746
0131-002,2013,8,24,1,150,172,322,478
0131-002,2013,8,24,2,114,124,238,322
0131-002,2013,8,24,3,68,78,146,238
0131-002,2013,8,24,4,58,84,142,146
0131-002,2013,8,24,5,68,114,182,142
0131-002,2013,8,24,6,182,174,356,182
0131-002,2013,8,24,7,346,302,648,356
0131-002,2013,8,24,8,806,614,1420,648
0131-002,2013,8,24,9,874,798,1672,1420
0131-002,2013,8,24,10,838,902,1740,1672
0131-002,2013,8,24,11,818,1004,1822,1740
0131-002,2013,8,24,12,818,1146,1964,1822
0131-002,2013,8,24,13,760,1146,1906,1964
0131-002,2013,8,24,14,780,1124,1904,1906
0131-002,2013,8,24,15,778,1180,1958,1904
0131-002,2013,8,24,16,844,1152,1996,1958
0131-002,2013,8,24,17,1000,1206,2206,1996
0131-002,2013,8,24,18,1028,1240,2268,2206
0131-002,2013,8,24,19,908,994,1902,2268
0131-002,2013,8,24,20,634,704,1338,1902
0131-002,2013,8,24,21,466,514,980,1338
0131-002,2013,8,24,22,394,434,828,980
0131-002,2013,8,24,23,310,316,626,828
0131-002,2013,8,24,24,200,230,430,626
0131-002,2013,8,25,1,136,172,308,430
0131-002,2013,8,25,2,86,96,182,308
0131-002,2013,8,25,3,76,74,150,182
0131-002,2013,8,25,4,54,70,124,150
0131-002,2013,8,25,5,64,90,154,124
0131-002,2013,8,25,6,122,98,220,154
0131-002,2013,8,25,7,252,202,454,220
0131-002,2013,8,25,8,406,288,694,454
0131-002,2013,8,25,9,436,466,902,694
0131-002,2013,8,25,10,472,468,940,902
0131-002,2013,8,25,11,496,602,1098,940
0131-002,2013,8,25,12,532,582,1114,1098
0131-002,2013,8,25,13,538,570,1108,1114
0131-002,2013,8,25,14,620,578,1198,1108
0131-002,2013,8,25,15,670,630,1300,1198
0131-002,2013,8,25,16,880,616,1496,1300
0131-002,2013,8,25,17,966,694,1660,1496
0131-002,2013,8,25,18,1066,712,1778,1660
0131-002,2013,8,25,19,1014,622,1636,1778
0131-002,2013,8,25,20,832,574,1406,1636
0131-002,2013,8,25,21,642,474,1116,1406
0131-002,2013,8,25,22,502,416,918,1116
0131-002,2013,8,25,23,302,308,610,918
0131-002,2013,8,25,24,200,210,410,610
0131-002,2013,8,26,1,128,118,246,410
0131-002,2013,8,26,2,72,70,142,246
0131-002,2013,8,26,3,36,36,72,142
0131-002,2013,8,26,4,46,66,112,72
0131-002,2013,8,26,5,60,94,154,112
0131-002,2013,8,26,6,174,172,346,154
0131-002,2013,8,26,7,672,438,1110,346
0131-002,2013,8,26,8,1474,1136,2610,1110
0131-002,2013,8,26,9,1152,1146,2298,2610
0131-002,2013,8,26,10,908,914,1822,2298
0131-002,2013,8,26,11,888,940,1828,1822
0131-002,2013,8,26,12,832,892,1724,1828
0131-002,2013,8,26,13,686,784,1470,1724
0131-002,2013,8,26,14,848,890,1738,1470
0131-002,2013,8,26,15,962,972,1934,1738
0131-002,2013,8,26,16,928,930,1858,1934
0131-002,2013,8,26,17,932,950,1882,1858
0131-002,2013,8,26,18,904,1092,1996,1882
0131-002,2013,8,26,19,944,1098,2042,1996
0131-002,2013,8,26,20,742,898,1640,2042
0131-002,2013,8,26,21,566,806,1372,1640
0131-002,2013,8,26,22,480,606,1086,1372
0131-002,2013,8,26,23,306,360,666,1086
0131-002,2013,8,26,24,202,240,442,666
0131-002,2013,8,27,1,122,132,254,442
0131-002,2013,8,27,2,86,86,172,254
0131-002,2013,8,27,3,50,64,114,172
0131-002,2013,8,27,4,46,54,100,114
0131-002,2013,8,27,5,50,86,136,100
0131-002,2013,8,27,6,150,146,296,136
0131-002,2013,8,27,7,516,296,812,296
0131-002,2013,8,27,8,1232,940,2172,812
0131-002,2013,8,27,9,1058,1024,2082,2172
0131-002,2013,8,27,10,718,782,1500,2082
0131-002,2013,8,27,11,700,756,1456,1500
0131-002,2013,8,27,12,620,660,1280,1456
0131-002,2013,8,27,13,506,626,1132,1280
0131-002,2013,8,27,14,600,642,1242,1132
0131-002,2013,8,27,15,652,750,1402,1242
0131-002,2013,8,27,16,718,706,1424,1402
0131-002,2013,8,27,17,634,774,1408,1424
0131-002,2013,8,27,18,716,884,1600,1408
0131-002,2013,8,27,19,768,894,1662,1600
0131-002,2013,8,27,20,606,734,1340,1662
0131-002,2013,8,27,21,442,660,1102,1340
0131-002,2013,8,27,22,358,464,822,1102
0131-002,2013,8,27,23,256,276,532,822
0131-002,2013,8,27,24,164,186,350,532
0131-002,2013,8,28,1,92,112,204,350
0131-002,2013,8,28,2,80,82,162,204
0131-002,2013,8,28,3,50,50,100,162
0131-002,2013,8,28,4,38,50,88,100
0131-002,2013,8,28,5,58,84,142,88
0131-002,2013,8,28,6,150,144,294,142
0131-002,2013,8,28,7,570,316,886,294
0131-002,2013,8,28,8,1336,996,2332,886
0131-002,2013,8,28,9,1174,1154,2328,2332
0131-002,2013,8,28,10,918,886,1804,2328
0131-002,2013,8,28,11,896,966,1862,1804
0131-002,2013,8,28,12,858,908,1766,1862
0131-002,2013,8,28,13,682,810,1492,1766
0131-002,2013,8,28,14,792,882,1674,1492
0131-002,2013,8,28,15,924,940,1864,1674
0131-002,2013,8,28,16,894,974,1868,1864
0131-002,2013,8,28,17,928,928,1856,1868
0131-002,2013,8,28,18,928,1094,2022,1856
0131-002,2013,8,28,19,914,1136,2050,2022
0131-002,2013,8,28,20,718,842,1560,2050
0131-002,2013,8,28,21,514,720,1234,1560
0131-002,2013,8,28,22,466,542,1008,1234
0131-002,2013,8,28,23,310,346,656,1008
0131-002,2013,8,28,24,210,242,452,656
0131-002,2013,8,29,1,162,150,312,452
0131-002,2013,8,29,2,76,84,160,312
0131-002,2013,8,29,3,48,66,114,160
0131-002,2013,8,29,4,60,64,124,114
0131-002,2013,8,29,5,68,100,168,124
0131-002,2013,8,29,6,136,118,254,168
0131-002,2013,8,29,7,544,334,878,254
0131-002,2013,8,29,8,1326,998,2324,878
0131-002,2013,8,29,9,1170,1102,2272,2324
0131-002,2013,8,29,10,830,850,1680,2272
0131-002,2013,8,29,11,786,868,1654,1680
0131-002,2013,8,29,12,786,798,1584,1654
0131-002,2013,8,29,13,658,740,1398,1584
0131-002,2013,8,29,14,740,830,1570,1398
0131-002,2013,8,29,15,776,838,1614,1570
0131-002,2013,8,29,16,896,880,1776,1614
0131-002,2013,8,29,17,834,806,1640,1776
0131-002,2013,8,29,18,834,960,1794,1640
0131-002,2013,8,29,19,960,1042,2002,1794
0131-002,2013,8,29,20,644,802,1446,2002
0131-002,2013,8,29,21,540,706,1246,1446
0131-002,2013,8,29,22,446,528,974,1246
0131-002,2013,8,29,23,298,334,632,974
0131-002,2013,8,29,24,204,210,414,632
0131-002,2013,8,30,1,116,136,252,414
0131-002,2013,8,30,2,98,90,188,252
0131-002,2013,8,30,3,74,74,148,188
0131-002,2013,8,30,4,42,74,116,148
0131-002,2013,8,30,5,60,94,154,116
0131-002,2013,8,30,6,146,142,288,154
0131-002,2013,8,30,7,550,336,886,288
0131-002,2013,8,30,8,1388,1048,2436,886
0131-002,2013,8,30,9,1164,1186,2350,2436
0131-002,2013,8,30,10,914,918,1832,2350
0131-002,2013,8,30,11,966,992,1958,1832
0131-002,2013,8,30,12,878,980,1858,1958
0131-002,2013,8,30,13,688,826,1514,1858
0131-002,2013,8,30,14,874,924,1798,1514
0131-002,2013,8,30,15,954,1020,1974,1798
0131-002,2013,8,30,16,952,1032,1984,1974
0131-002,2013,8,30,17,848,1024,1872,1984
0131-002,2013,8,30,18,1098,1176,2274,1872
0131-002,2013,8,30,19,1070,1152,2222,2274
0131-002,2013,8,30,20,864,1012,1876,2222
0131-002,2013,8,30,21,642,816,1458,1876
0131-002,2013,8,30,22,560,626,1186,1458
0131-002,2013,8,30,23,392,450,842,1186
0131-002,2013,8,30,24,260,284,544,842
0131-002,2013,8,31,1,128,172,300,544
0131-002,2013,8,31,2,108,124,232,300
0131-002,2013,8,31,3,70,100,170,232
0131-002,2013,8,31,4,72,90,162,170
0131-002,2013,8,31,5,54,98,152,162
0131-002,2013,8,31,6,134,134,268,152
0131-002,2013,8,31,7,322,300,622,268
0131-002,2013,8,31,8,702,566,1268,622
0131-002,2013,8,31,9,690,880,1570,1268
0131-002,2013,8,31,10,598,1032,1630,1570
0131-002,2013,8,31,11,580,1142,1722,1630
0131-002,2013,8,31,12,636,1392,2028,1722
0131-002,2013,8,31,13,628,1384,2012,2028
0131-002,2013,8,31,14,660,1346,2006,2012
0131-002,2013,8,31,15,698,1300,1998,2006
0131-002,2013,8,31,16,836,1382,2218,1998
0131-002,2013,8,31,17,882,1434,2316,2218
0131-002,2013,8,31,18,1062,1360,2422,2316
0131-002,2013,8,31,19,1042,1160,2202,2422
0131-002,2013,8,31,20,806,808,1614,2202
0131-002,2013,8,31,21,634,530,1164,1614
0131-002,2013,8,31,22,450,444,894,1164
0131-002,2013,8,31,23,300,316,616,894
0131-002,2013,8,31,24,156,194,350,616
0131-002,2013,9,1,1,117,124,241,350
0131-002,2013,9,1,2,93,100,193,241
0131-002,2013,9,1,3,68,76,144,193
0131-002,2013,9,1,4,69,66,135,144
0131-002,2013,9,1,5,71,79,150,135
0131-002,2013,9,1,6,117,100,217,150
0131-002,2013,9,1,7,286,212,498,217
0131-002,2013,9,1,8,409,347,756,498
0131-002,2013,9,1,9,418,462,880,756
0131-002,2013,9,1,10,420,520,940,880
0131-002,2013,9,1,11,480,547,1027,940
0131-002,2013,9,1,12,540,601,1141,1027
0131-002,2013,9,1,13,569,584,1153,1141
0131-002,2013,9,1,14,627,585,1212,1153
0131-002,2013,9,1,15,705,618,1323,1212
0131-002,2013,9,1,16,793,663,1456,1323
0131-002,2013,9,1,17,827,645,1472,1456
0131-002,2013,9,1,18,833,708,1541,1472
0131-002,2013,9,1,19,885,612,1497,1541
0131-002,2013,9,1,20,685,525,1210,1497
0131-002,2013,9,1,21,591,417,1008,1210
0131-002,2013,9,1,22,417,352,769,1008
0131-002,2013,9,1,23,280,252,532,769
0131-002,2013,9,1,24,162,163,325,532
0131-002,2013,9,2,1,120,98,218,325
0131-002,2013,9,2,2,76,58,134,218
0131-002,2013,9,2,3,58,44,102,134
0131-002,2013,9,2,4,56,55,111,102
0131-002,2013,9,2,5,102,86,188,111
0131-002,2013,9,2,6,195,159,354,188
0131-002,2013,9,2,7,694,358,1052,354
0131-002,2013,9,2,8,1616,1007,2623,1052
0131-002,2013,9,2,9,1303,1016,2319,2623
0131-002,2013,9,2,10,884,956,1840,2319
0131-002,2013,9,2,11,938,923,1861,1840
0131-002,2013,9,2,12,914,933,1847,1861
0131-002,2013,9,2,13,787,836,1623,1847
0131-002,2013,9,2,14,908,962,1870,1623
0131-002,2013,9,2,15,1038,1059,2097,1870
0131-002,2013,9,2,16,998,1013,2011,2097
0131-002,2013,9,2,17,939,1012,1951,2011
0131-002,2013,9,2,18,888,1195,2083,1951
0131-002,2013,9,2,19,876,1200,2076,2083
0131-002,2013,9,2,20,677,919,1596,2076
0131-002,2013,9,2,21,542,788,1330,1596
0131-002,2013,9,2,22,453,583,1036,1330
0131-002,2013,9,2,23,310,332,642,1036
0131-002,2013,9,2,24,212,210,422,642
0131-002,2013,9,3,1,99,117,216,422
0131-002,2013,9,3,2,93,84,177,216
0131-002,2013,9,3,3,80,73,153,177
0131-002,2013,9,3,4,69,80,149,153
0131-002,2013,9,3,5,113,103,216,149
0131-002,2013,9,3,6,181,177,358,216
0131-002,2013,9,3,7,660,384,1044,358
0131-002,2013,9,3,8,1463,938,2401,1044
0131-002,2013,9,3,9,1275,1058,2333,2401
0131-002,2013,9,3,10,946,946,1892,2333
0131-002,2013,9,3,11,947,915,1862,1892
0131-002,2013,9,3,12,847,934,1781,1862
0131-002,2013,9,3,13,680,760,1440,1781
0131-002,2013,9,3,14,796,838,1634,1440
0131-002,2013,9,3,15,906,935,1841,1634
0131-002,2013,9,3,16,897,952,1849,1841
0131-002,2013,9,3,17,861,975,1836,1849
0131-002,2013,9,3,18,873,1177,2050,1836
0131-002,2013,9,3,19,845,1073,1918,2050
0131-002,2013,9,3,20,651,898,1549,1918
0131-002,2013,9,3,21,519,716,1235,1549
0131-002,2013,9,3,22,432,540,972,1235
0131-002,2013,9,3,23,285,310,595,972
0131-002,2013,9,3,24,201,195,396,595
0131-002,2013,9,4,1,144,125,269,396
0131-002,2013,9,4,2,76,79,155,269
0131-002,2013,9,4,3,69,62,131,155
0131-002,2013,9,4,4,70,80,150,131
0131-002,2013,9,4,5,88,114,202,150
0131-002,2013,9,4,6,216,172,388,202
0131-002,2013,9,4,7,657,356,1013,388
0131-002,2013,9,4,8,1363,959,2322,1013
0131-002,2013,9,4,9,1248,1100,2348,2322
0131-002,2013,9,4,10,898,957,1855,2348
0131-002,2013,9,4,11,889,919,1808,1855
0131-002,2013,9,4,12,829,902,1731,1808
0131-002,2013,9,4,13,745,781,1526,1731
0131-002,2013,9,4,14,852,856,1708,1526
0131-002,2013,9,4,15,882,998,1880,1708
0131-002,2013,9,4,16,898,919,1817,1880
0131-002,2013,9,4,17,863,947,1810,1817
0131-002,2013,9,4,18,926,1178,2104,1810
0131-002,2013,9,4,19,894,1136,2030,2104
0131-002,2013,9,4,20,643,813,1456,2030
0131-002,2013,9,4,21,481,698,1179,1456
0131-002,2013,9,4,22,450,525,975,1179
0131-002,2013,9,4,23,296,302,598,975
0131-002,2013,9,4,24,194,209,403,598
0131-002,2013,9,5,1,133,146,279,403
0131-002,2013,9,5,2,91,74,165,279
0131-002,2013,9,5,3,77,58,135,165
0131-002,2013,9,5,4,56,71,127,135
0131-002,2013,9,5,5,102,103,205,127
0131-002,2013,9,5,6,184,171,355,205
0131-002,2013,9,5,7,672,367,1039,355
0131-002,2013,9,5,8,1336,953,2289,1039
0131-002,2013,9,5,9,1286,1075,2361,2289
0131-002,2013,9,5,10,838,919,1757,2361
0131-002,2013,9,5,11,927,853,1780,1757
0131-002,2013,9,5,12,831,923,1754,1780
0131-002,2013,9,5,13,743,775,1518,1754
0131-002,2013,9,5,14,784,880,1664,1518
0131-002,2013,9,5,15,967,972,1939,1664
0131-002,2013,9,5,16,947,979,1926,1939
0131-002,2013,9,5,17,849,952,1801,1926
0131-002,2013,9,5,18,914,1138,2052,1801
0131-002,2013,9,5,19,868,1105,1973,2052
0131-002,2013,9,5,20,643,889,1532,1973
0131-002,2013,9,5,21,518,718,1236,1532
0131-002,2013,9,5,22,451,571,1022,1236
0131-002,2013,9,5,23,323,351,674,1022
0131-002,2013,9,5,24,205,197,402,674
0131-002,2013,9,6,1,129,121,250,402
0131-002,2013,9,6,2,90,94,184,250
0131-002,2013,9,6,3,82,62,144,184
0131-002,2013,9,6,4,71,74,145,144
0131-002,2013,9,6,5,117,108,225,145
0131-002,2013,9,6,6,179,171,350,225
0131-002,2013,9,6,7,600,349,949,350
0131-002,2013,9,6,8,1315,941,2256,949
0131-002,2013,9,6,9,1158,1083,2241,2256
0131-002,2013,9,6,10,931,958,1889,2241
0131-002,2013,9,6,11,952,947,1899,1889
0131-002,2013,9,6,12,872,921,1793,1899
0131-002,2013,9,6,13,768,859,1627,1793
0131-002,2013,9,6,14,786,897,1683,1627
0131-002,2013,9,6,15,884,1027,1911,1683
0131-002,2013,9,6,16,856,993,1849,1911
0131-002,2013,9,6,17,931,1117,2048,1849
0131-002,2013,9,6,18,889,1348,2237,2048
0131-002,2013,9,6,19,914,1334,2248,2237
0131-002,2013,9,6,20,787,1101,1888,2248
0131-002,2013,9,6,21,588,807,1395,1888
0131-002,2013,9,6,22,433,600,1033,1395
0131-002,2013,9,6,23,320,367,687,1033
0131-002,2013,9,6,24,220,228,448,687
0131-002,2013,9,7,1,156,171,327,448
0131-002,2013,9,7,2,114,106,220,327
0131-002,2013,9,7,3,76,79,155,220
0131-002,2013,9,7,4,78,82,160,155
0131-002,2013,9,7,5,112,109,221,160
0131-002,2013,9,7,6,197,183,380,221
0131-002,2013,9,7,7,472,344,816,380
0131-002,2013,9,7,8,826,774,1600,816
0131-002,2013,9,7,9,829,1136,1965,1600
0131-002,2013,9,7,10,801,1239,2040,1965
0131-002,2013,9,7,11,796,1303,2099,2040
0131-002,2013,9,7,12,887,1283,2170,2099
0131-002,2013,9,7,13,771,1238,2009,2170
0131-002,2013,9,7,14,805,992,1797,2009
0131-002,2013,9,7,15,806,945,1751,1797
0131-002,2013,9,7,16,877,849,1726,1751
0131-002,2013,9,7,17,968,774,1742,1726
0131-002,2013,9,7,18,1003,1049,2052,1742
0131-002,2013,9,7,19,1001,893,1894,2052
0131-002,2013,9,7,20,849,669,1518,1894
0131-002,2013,9,7,21,636,528,1164,1518
0131-002,2013,9,7,22,494,448,942,1164
0131-002,2013,9,7,23,312,262,574,942
0131-002,2013,9,7,24,187,193,380,574
0131-002,2013,9,8,1,107,131,238,380
0131-002,2013,9,8,2,80,99,179,238
0131-002,2013,9,8,3,74,74,148,179
0131-002,2013,9,8,4,77,63,140,148
0131-002,2013,9,8,5,61,72,133,140
0131-002,2013,9,8,6,114,98,212,133
0131-002,2013,9,8,7,251,241,492,212
0131-002,2013,9,8,8,380,378,758,492
0131-002,2013,9,8,9,416,492,908,758
0131-002,2013,9,8,10,412,519,931,908
0131-002,2013,9,8,11,466,521,987,931
0131-002,2013,9,8,12,566,568,1134,987
0131-002,2013,9,8,13,585,564,1149,1134
0131-002,2013,9,8,14,693,601,1294,1149
0131-002,2013,9,8,15,807,613,1420,1294
0131-002,2013,9,8,16,969,673,1642,1420
0131-002,2013,9,8,17,990,624,1614,1642
0131-002,2013,9,8,18,1047,713,1760,1614
0131-002,2013,9,8,19,1038,592,1630,1760
0131-002,2013,9,8,20,895,489,1384,1630
0131-002,2013,9,8,21,745,410,1155,1384
0131-002,2013,9,8,22,451,378,829,1155
0131-002,2013,9,8,23,301,246,547,829
0131-002,2013,9,8,24,165,149,314,547
0131-002,2013,9,9,1,117,86,203,314
0131-002,2013,9,9,2,76,57,133,203
0131-002,2013,9,9,3,55,46,101,133
0131-002,2013,9,9,4,56,54,110,101
0131-002,2013,9,9,5,100,80,180,110
0131-002,2013,9,9,6,213,161,374,180
0131-002,2013,9,9,7,739,369,1108,374
0131-002,2013,9,9,8,1653,1029,2682,1108
0131-002,2013,9,9,9,1337,1020,2357,2682
0131-002,2013,9,9,10,876,940,1816,2357
0131-002,2013,9,9,11,926,897,1823,1816
0131-002,2013,9,9,12,884,908,1792,1823
0131-002,2013,9,9,13,750,786,1536,1792
0131-002,2013,9,9,14,872,935,1807,1536
0131-002,2013,9,9,15,1041,975,2016,1807
0131-002,2013,9,9,16,988,926,1914,2016
0131-002,2013,9,9,17,901,998,1899,1914
0131-002,2013,9,9,18,876,1206,2082,1899
0131-002,2013,9,9,19,828,1202,2030,2082
0131-002,2013,9,9,20,627,877,1504,2030
0131-002,2013,9,9,21,512,801,1313,1504
0131-002,2013,9,9,22,451,541,992,1313
0131-002,2013,9,9,23,287,305,592,992
0131-002,2013,9,9,24,190,189,379,592
0131-002,2013,9,10,1,125,126,251,379
0131-002,2013,9,10,2,87,74,161,251
0131-002,2013,9,10,3,67,52,119,161
0131-002,2013,9,10,4,75,72,147,119
0131-002,2013,9,10,5,106,106,212,147
0131-002,2013,9,10,6,188,164,352,212
0131-002,2013,9,10,7,622,373,995,352
0131-002,2013,9,10,8,1340,948,2288,995
0131-002,2013,9,10,9,1338,1127,2465,2288
0131-002,2013,9,10,10,964,979,1943,2465
0131-002,2013,9,10,11,959,982,1941,1943
0131-002,2013,9,10,12,921,914,1835,1941
0131-002,2013,9,10,13,801,821,1622,1835
0131-002,2013,9,10,14,875,952,1827,1622
0131-002,2013,9,10,15,945,1019,1964,1827
0131-002,2013,9,10,16,1005,995,2000,1964
0131-002,2013,9,10,17,902,1027,1929,2000
0131-002,2013,9,10,18,896,1250,2146,1929
0131-002,2013,9,10,19,825,1157,1982,2146
0131-002,2013,9,10,20,643,885,1528,1982
0131-002,2013,9,10,21,533,765,1298,1528
0131-002,2013,9,10,22,408,570,978,1298
0131-002,2013,9,10,23,283,295,578,978
0131-002,2013,9,10,24,189,206,395,578
0131-002,2013,9,11,1,146,136,282,395
0131-002,2013,9,11,2,71,79,150,282
0131-002,2013,9,11,3,64,75,139,150
0131-002,2013,9,11,4,88,65,153,139
0131-002,2013,9,11,5,96,111,207,153
0131-002,2013,9,11,6,163,134,297,207
0131-002,2013,9,11,7,511,292,803,297
0131-002,2013,9,11,8,1320,890,2210,803
0131-002,2013,9,11,9,1215,1066,2281,2210
0131-002,2013,9,11,10,865,951,1816,2281
0131-002,2013,9,11,11,889,896,1785,1816
0131-002,2013,9,11,12,886,925,1811,1785
0131-002,2013,9,11,13,769,842,1611,1811
0131-002,2013,9,11,14,896,890,1786,1611
0131-002,2013,9,11,15,905,1045,1950,1786
0131-002,2013,9,11,16,990,1002,1992,1950
0131-002,2013,9,11,17,874,1014,1888,1992
0131-002,2013,9,11,18,883,1150,2033,1888
0131-002,2013,9,11,19,902,1077,1979,2033
0131-002,2013,9,11,20,646,866,1512,1979
0131-002,2013,9,11,21,537,719,1256,1512
0131-002,2013,9,11,22,432,579,1011,1256
0131-002,2013,9,11,23,351,358,709,1011
0131-002,2013,9,11,24,177,200,377,709
0131-002,2013,9,12,1,142,150,292,377
0131-002,2013,9,12,2,112,105,217,292
0131-002,2013,9,12,3,96,81,177,217
0131-002,2013,9,12,4,64,81,145,177
0131-002,2013,9,12,5,120,116,236,145
0131-002,2013,9,12,6,175,164,339,236
0131-002,2013,9,12,7,648,356,1004,339
0131-002,2013,9,12,8,1358,965,2323,1004
0131-002,2013,9,12,9,1186,1045,2231,2323
0131-002,2013,9,12,10,985,924,1909,2231
0131-002,2013,9,12,11,906,990,1896,1909
0131-002,2013,9,12,12,904,941,1845,1896
0131-002,2013,9,12,13,745,850,1595,1845
0131-002,2013,9,12,14,910,909,1819,1595
0131-002,2013,9,12,15,1038,1022,2060,1819
0131-002,2013,9,12,16,987,1019,2006,2060
0131-002,2013,9,12,17,953,1079,2032,2006
0131-002,2013,9,12,18,835,1161,1996,2032
0131-002,2013,9,12,19,894,1143,2037,1996
0131-002,2013,9,12,20,639,869,1508,2037
0131-002,2013,9,12,21,519,817,1336,1508
0131-002,2013,9,12,22,436,568,1004,1336
0131-002,2013,9,12,23,342,349,691,1004
0131-002,2013,9,12,24,244,227,471,691
0131-002,2013,9,13,1,142,148,290,471
0131-002,2013,9,13,2,91,114,205,290
0131-002,2013,9,13,3,78,85,163,205
0131-002,2013,9,13,4,76,86,162,163
0131-002,2013,9,13,5,109,103,212,162
0131-002,2013,9,13,6,144,146,290,212
0131-002,2013,9,13,7,531,287,818,290
0131-002,2013,9,13,8,1400,914,2314,818
0131-002,2013,9,13,9,1246,1052,2298,2314
0131-002,2013,9,13,10,944,975,1919,2298
0131-002,2013,9,13,11,927,1070,1997,1919
0131-002,2013,9,13,12,937,965,1902,1997
0131-002,2013,9,13,13,764,863,1627,1902
0131-002,2013,9,13,14,926,943,1869,1627
0131-002,2013,9,13,15,952,1069,2021,1869
0131-002,2013,9,13,16,968,1013,1981,2021
0131-002,2013,9,13,17,916,1046,1962,1981
0131-002,2013,9,13,18,864,1230,2094,1962
0131-002,2013,9,13,19,957,1217,2174,2094
0131-002,2013,9,13,20,732,993,1725,2174
0131-002,2013,9,13,21,575,773,1348,1725
0131-002,2013,9,13,22,477,605,1082,1348
0131-002,2013,9,13,23,342,362,704,1082
0131-002,2013,9,13,24,254,239,493,704
0131-002,2013,9,14,1,163,168,331,493
0131-002,2013,9,14,2,120,125,245,331
0131-002,2013,9,14,3,97,82,179,245
0131-002,2013,9,14,4,77,94,171,179
0131-002,2013,9,14,5,99,97,196,171
0131-002,2013,9,14,6,187,122,309,196
0131-002,2013,9,14,7,357,242,599,309
0131-002,2013,9,14,8,752,551,1303,599
0131-002,2013,9,14,9,809,745,1554,1303
0131-002,2013,9,14,10,704,794,1498,1554
0131-002,2013,9,14,11,760,869,1629,1498
0131-002,2013,9,14,12,674,924,1598,1629
0131-002,2013,9,14,13,742,848,1590,1598
0131-002,2013,9,14,14,729,830,1559,1590
0131-002,2013,9,14,15,683,833,1516,1559
0131-002,2013,9,14,16,735,800,1535,1516
0131-002,2013,9,14,17,717,807,1524,1535
0131-002,2013,9,14,18,837,895,1732,1524
0131-002,2013,9,14,19,809,764,1573,1732
0131-002,2013,9,14,20,550,613,1163,1573
0131-002,2013,9,14,21,508,472,980,1163
0131-002,2013,9,14,22,369,391,760,980
0131-002,2013,9,14,23,248,298,546,760
0131-002,2013,9,14,24,173,186,359,546
0131-002,2013,9,15,1,126,116,242,359
0131-002,2013,9,15,2,105,100,205,242
0131-002,2013,9,15,3,62,77,139,205
0131-002,2013,9,15,4,60,68,128,139
0131-002,2013,9,15,5,80,85,165,128
0131-002,2013,9,15,6,120,102,222,165
0131-002,2013,9,15,7,320,183,503,222
0131-002,2013,9,15,8,437,316,753,503
0131-002,2013,9,15,9,419,431,850,753
0131-002,2013,9,15,10,427,520,947,850
0131-002,2013,9,15,11,493,573,1066,947
0131-002,2013,9,15,12,513,633,1146,1066
0131-002,2013,9,15,13,552,603,1155,1146
0131-002,2013,9,15,14,561,569,1130,1155
0131-002,2013,9,15,15,602,623,1225,1130
0131-002,2013,9,15,16,617,653,1270,1225
0131-002,2013,9,15,17,664,666,1330,1270
0131-002,2013,9,15,18,618,703,1321,1330
0131-002,2013,9,15,19,732,631,1363,1321
0131-002,2013,9,15,20,474,560,1034,1363
0131-002,2013,9,15,21,437,424,861,1034
0131-002,2013,9,15,22,383,325,708,861
0131-002,2013,9,15,23,259,258,517,708
0131-002,2013,9,15,24,158,177,335,517
0131-002,2013,9,16,1,123,109,232,335
0131-002,2013,9,16,2,76,59,135,232
0131-002,2013,9,16,3,60,41,101,135
0131-002,2013,9,16,4,56,55,111,101
0131-002,2013,9,16,5,104,91,195,111
0131-002,2013,9,16,6,176,157,333,195
0131-002,2013,9,16,7,649,347,996,333
0131-002,2013,9,16,8,1579,984,2563,996
0131-002,2013,9,16,9,1268,1012,2280,2563
0131-002,2013,9,16,10,891,971,1862,2280
0131-002,2013,9,16,11,950,949,1899,1862
0131-002,2013,9,16,12,943,958,1901,1899
0131-002,2013,9,16,13,823,885,1708,1901
0131-002,2013,9,16,14,943,988,1931,1708
0131-002,2013,9,16,15,1035,1143,2178,1931
0131-002,2013,9,16,16,1008,1099,2107,2178
0131-002,2013,9,16,17,976,1026,2002,2107
0131-002,2013,9,16,18,899,1184,2083,2002
0131-002,2013,9,16,19,923,1197,2120,2083
0131-002,2013,9,16,20,727,960,1687,2120
0131-002,2013,9,16,21,571,774,1345,1687
0131-002,2013,9,16,22,455,624,1079,1345
0131-002,2013,9,16,23,332,359,691,1079
0131-002,2013,9,16,24,234,230,464,691
0131-002,2013,9,17,1,145,164,309,464
0131-002,2013,9,17,2,101,99,200,309
0131-002,2013,9,17,3,73,81,154,200
0131-002,2013,9,17,4,80,83,163,154
0131-002,2013,9,17,5,112,104,216,163
0131-002,2013,9,17,6,189,150,339,216
0131-002,2013,9,17,7,551,318,869,339
0131-002,2013,9,17,8,1249,863,2112,869
0131-002,2013,9,17,9,1141,1019,2160,2112
0131-002,2013,9,17,10,871,924,1795,2160
0131-002,2013,9,17,11,867,974,1841,1795
0131-002,2013,9,17,12,868,896,1764,1841
0131-002,2013,9,17,13,693,870,1563,1764
0131-002,2013,9,17,14,786,1047,1833,1563
0131-002,2013,9,17,15,780,1169,1949,1833
0131-002,2013,9,17,16,864,1341,2205,1949
0131-002,2013,9,17,17,838,1491,2329,2205
0131-002,2013,9,17,18,860,1595,2455,2329
0131-002,2013,9,17,19,964,1255,2219,2455
0131-002,2013,9,17,20,641,1088,1729,2219
0131-002,2013,9,17,21,503,1156,1659,1729
0131-002,2013,9,17,22,425,1171,1596,1659
0131-002,2013,9,17,23,271,1113,1384,1596
0131-002,2013,9,17,24,201,978,1179,1384
0131-002,2013,9,18,1,131,611,742,1179
0131-002,2013,9,18,2,110,582,692,742
0131-002,2013,9,18,3,78,609,687,692
0131-002,2013,9,18,4,65,680,745,687
0131-002,2013,9,18,5,81,1078,1159,745
0131-002,2013,9,18,6,128,1164,1292,1159
0131-002,2013,9,18,7,163,759,922,1292
0131-002,2013,9,18,8,255,585,840,922
0131-002,2013,9,18,9,366,667,1033,840
0131-002,2013,9,18,10,456,684,1140,1033
0131-002,2013,9,18,11,554,665,1219,1140
0131-002,2013,9,18,12,629,881,1510,1219
0131-002,2013,9,18,13,662,920,1582,1510
0131-002,2013,9,18,14,620,1195,1815,1582
0131-002,2013,9,18,15,546,831,1377,1815
0131-002,2013,9,18,16,491,564,1055,1377
0131-002,2013,9,18,17,344,512,856,1055
0131-002,2013,9,18,18,400,482,882,856
0131-002,2013,9,18,19,291,436,727,882
0131-002,2013,9,18,20,272,329,601,727
0131-002,2013,9,18,21,230,267,497,601
0131-002,2013,9,18,22,186,219,405,497
0131-002,2013,9,18,23,154,189,343,405
0131-002,2013,9,18,24,87,101,188,343
0131-002,2013,9,19,1,74,84,158,188
0131-002,2013,9,19,2,48,53,101,158
0131-002,2013,9,19,3,25,38,63,101
0131-002,2013,9,19,4,31,39,70,63
0131-002,2013,9,19,5,36,33,69,70
0131-002,2013,9,19,6,45,92,137,69
0131-002,2013,9,19,7,150,207,357,137
0131-002,2013,9,19,8,359,451,810,357
0131-002,2013,9,19,9,322,520,842,810
0131-002,2013,9,19,10,352,734,1086,842
0131-002,2013,9,19,11,686,1219,1905,1086
0131-002,2013,9,19,12,878,1372,2250,1905
0131-002,2013,9,19,13,985,1340,2325,2250
0131-002,2013,9,19,14,1032,1535,2567,2325
0131-002,2013,9,19,15,1091,1767,2858,2567
0131-002,2013,9,19,16,1159,1582,2741,2858
0131-002,2013,9,19,17,1267,1358,2625,2741
0131-002,2013,9,19,18,1194,1427,2621,2625
0131-002,2013,9,19,19,1052,940,1992,2621
0131-002,2013,9,19,20,1087,592,1679,1992
0131-002,2013,9,19,21,1008,412,1420,1679
0131-002,2013,9,19,22,688,313,1001,1420
0131-002,2013,9,19,23,464,233,697,1001
0131-002,2013,9,19,24,332,159,491,697
0131-002,2013,9,20,1,233,80,313,491
0131-002,2013,9,20,2,150,73,223,313
0131-002,2013,9,20,3,74,50,124,223
0131-002,2013,9,20,4,44,35,79,124
0131-002,2013,9,20,5,60,49,109,79
0131-002,2013,9,20,6,67,43,110,109
0131-002,2013,9,20,7,121,78,199,110
0131-002,2013,9,20,8,177,155,332,199
0131-002,2013,9,20,9,243,238,481,332
0131-002,2013,9,20,10,358,316,674,481
0131-002,2013,9,20,11,497,455,952,674
0131-002,2013,9,20,12,646,503,1149,952
0131-002,2013,9,20,13,765,473,1238,1149
0131-002,2013,9,20,14,833,503,1336,1238
0131-002,2013,9,20,15,874,555,1429,1336
0131-002,2013,9,20,16,935,500,1435,1429
0131-002,2013,9,20,17,993,510,1503,1435
0131-002,2013,9,20,18,992,505,1497,1503
0131-002,2013,9,20,19,868,463,1331,1497
0131-002,2013,9,20,20,813,437,1250,1331
0131-002,2013,9,20,21,739,382,1121,1250
0131-002,2013,9,20,22,904,284,1188,1121
0131-002,2013,9,20,23,915,238,1153,1188
0131-002,2013,9,20,24,765,159,924,1153
0131-002,2013,9,21,1,523,106,629,924
0131-002,2013,9,21,2,362,83,445,629
0131-002,2013,9,21,3,195,58,253,445
0131-002,2013,9,21,4,90,45,135,253
0131-002,2013,9,21,5,73,54,127,135
0131-002,2013,9,21,6,96,69,165,127
0131-002,2013,9,21,7,202,154,356,165
0131-002,2013,9,21,8,331,247,578,356
0131-002,2013,9,21,9,411,329,740,578
0131-002,2013,9,21,10,466,421,887,740
0131-002,2013,9,21,11,651,527,1178,887
0131-002,2013,9,21,12,706,548,1254,1178
0131-002,2013,9,21,13,793,506,1299,1254
0131-002,2013,9,21,14,883,550,1433,1299
0131-002,2013,9,21,15,832,561,1393,1433
0131-002,2013,9,21,16,915,531,1446,1393
0131-002,2013,9,21,17,992,543,1535,1446
0131-002,2013,9,21,18,876,626,1502,1535
0131-002,2013,9,21,19,947,550,1497,1502
0131-002,2013,9,21,20,944,400,1344,1497
0131-002,2013,9,21,21,1000,352,1352,1344
0131-002,2013,9,21,22,926,298,1224,1352
0131-002,2013,9,21,23,519,222,741,1224
0131-002,2013,9,21,24,349,146,495,741
0131-002,2013,9,22,1,209,126,335,495
0131-002,2013,9,22,2,116,79,195,335
0131-002,2013,9,22,3,84,66,150,195
0131-002,2013,9,22,4,66,60,126,150
0131-002,2013,9,22,5,63,40,103,126
0131-002,2013,9,22,6,95,71,166,103
0131-002,2013,9,22,7,162,119,281,166
0131-002,2013,9,22,8,290,209,499,281
0131-002,2013,9,22,9,324,271,595,499
0131-002,2013,9,22,10,361,320,681,595
0131-002,2013,9,22,11,425,404,829,681
0131-002,2013,9,22,12,498,382,880,829
0131-002,2013,9,22,13,479,452,931,880
0131-002,2013,9,22,14,555,501,1056,931
0131-002,2013,9,22,15,555,492,1047,1056
0131-002,2013,9,22,16,566,524,1090,1047
0131-002,2013,9,22,17,561,564,1125,1090
0131-002,2013,9,22,18,536,584,1120,1125
0131-002,2013,9,22,19,509,506,1015,1120
0131-002,2013,9,22,20,421,442,863,1015
0131-002,2013,9,22,21,393,364,757,863
0131-002,2013,9,22,22,342,307,649,757
0131-002,2013,9,22,23,247,166,413,649
0131-002,2013,9,22,24,181,130,311,413
0131-002,2013,9,23,1,142,81,223,311
0131-002,2013,9,23,2,79,68,147,223
0131-002,2013,9,23,3,64,43,107,147
0131-002,2013,9,23,4,52,44,96,107
0131-002,2013,9,23,5,106,100,206,96
0131-002,2013,9,23,6,239,153,392,206
0131-002,2013,9,23,7,675,389,1064,392
0131-002,2013,9,23,8,1640,987,2627,1064
0131-002,2013,9,23,9,1271,1038,2309,2627
0131-002,2013,9,23,10,871,860,1731,2309
0131-002,2013,9,23,11,879,924,1803,1731
0131-002,2013,9,23,12,862,860,1722,1803
0131-002,2013,9,23,13,778,747,1525,1722
0131-002,2013,9,23,14,886,855,1741,1525
0131-002,2013,9,23,15,891,933,1824,1741
0131-002,2013,9,23,16,928,934,1862,1824
0131-002,2013,9,23,17,835,930,1765,1862
0131-002,2013,9,23,18,835,1056,1891,1765
0131-002,2013,9,23,19,807,1119,1926,1891
0131-002,2013,9,23,20,638,854,1492,1926
0131-002,2013,9,23,21,483,770,1253,1492
0131-002,2013,9,23,22,422,548,970,1253
0131-002,2013,9,23,23,302,296,598,970
0131-002,2013,9,23,24,209,214,423,598
0131-002,2013,9,24,1,143,136,279,423
0131-002,2013,9,24,2,89,96,185,279
0131-002,2013,9,24,3,78,87,165,185
0131-002,2013,9,24,4,90,84,174,165
0131-002,2013,9,24,5,105,109,214,174
0131-002,2013,9,24,6,210,145,355,214
0131-002,2013,9,24,7,576,368,944,355
0131-002,2013,9,24,8,1386,932,2318,944
0131-002,2013,9,24,9,1319,1088,2407,2318
0131-002,2013,9,24,10,930,947,1877,2407
0131-002,2013,9,24,11,899,915,1814,1877
0131-002,2013,9,24,12,860,912,1772,1814
0131-002,2013,9,24,13,719,806,1525,1772
0131-002,2013,9,24,14,817,855,1672,1525
0131-002,2013,9,24,15,949,945,1894,1672
0131-002,2013,9,24,16,845,932,1777,1894
0131-002,2013,9,24,17,762,932,1694,1777
0131-002,2013,9,24,18,754,990,1744,1694
0131-002,2013,9,24,19,785,1037,1822,1744
0131-002,2013,9,24,20,631,811,1442,1822
0131-002,2013,9,24,21,479,734,1213,1442
0131-002,2013,9,24,22,413,535,948,1213
0131-002,2013,9,24,23,276,273,549,948
0131-002,2013,9,24,24,198,191,389,549
0131-002,2013,9,25,1,147,114,261,389
0131-002,2013,9,25,2,97,92,189,261
0131-002,2013,9,25,3,86,78,164,189
0131-002,2013,9,25,4,78,82,160,164
0131-002,2013,9,25,5,121,104,225,160
0131-002,2013,9,25,6,199,162,361,225
0131-002,2013,9,25,7,583,353,936,361
0131-002,2013,9,25,8,1345,932,2277,936
0131-002,2013,9,25,9,1257,1091,2348,2277
0131-002,2013,9,25,10,934,985,1919,2348
0131-002,2013,9,25,11,890,919,1809,1919
0131-002,2013,9,25,12,897,917,1814,1809
0131-002,2013,9,25,13,761,771,1532,1814
0131-002,2013,9,25,14,843,831,1674,1532
0131-002,2013,9,25,15,957,1026,1983,1674
0131-002,2013,9,25,16,908,963,1871,1983
0131-002,2013,9,25,17,804,1010,1814,1871
0131-002,2013,9,25,18,904,1168,2072,1814
0131-002,2013,9,25,19,924,1161,2085,2072
0131-002,2013,9,25,20,651,855,1506,2085
0131-002,2013,9,25,21,522,717,1239,1506
0131-002,2013,9,25,22,448,540,988,1239
0131-002,2013,9,25,23,324,376,700,988
0131-002,2013,9,25,24,238,192,430,700
0131-002,2013,9,26,1,137,150,287,430
0131-002,2013,9,26,2,109,98,207,287
0131-002,2013,9,26,3,85,85,170,207
0131-002,2013,9,26,4,82,80,162,170
0131-002,2013,9,26,5,110,118,228,162
0131-002,2013,9,26,6,226,174,400,228
0131-002,2013,9,26,7,611,356,967,400
0131-002,2013,9,26,8,1387,951,2338,967
0131-002,2013,9,26,9,1317,1102,2419,2338
0131-002,2013,9,26,10,896,951,1847,2419
0131-002,2013,9,26,11,959,908,1867,1847
0131-002,2013,9,26,12,837,882,1719,1867
0131-002,2013,9,26,13,738,809,1547,1719
0131-002,2013,9,26,14,804,882,1686,1547
0131-002,2013,9,26,15,964,969,1933,1686
0131-002,2013,9,26,16,996,1020,2016,1933
0131-002,2013,9,26,17,950,969,1919,2016
0131-002,2013,9,26,18,886,1101,1987,1919
0131-002,2013,9,26,19,865,1142,2007,1987
0131-002,2013,9,26,20,647,878,1525,2007
0131-002,2013,9,26,21,527,764,1291,1525
0131-002,2013,9,26,22,429,546,975,1291
0131-002,2013,9,26,23,293,315,608,975
0131-002,2013,9,26,24,206,231,437,608
0131-002,2013,9,27,1,145,128,273,437
0131-002,2013,9,27,2,112,101,213,273
0131-002,2013,9,27,3,97,81,178,213
0131-002,2013,9,27,4,65,84,149,178
0131-002,2013,9,27,5,122,105,227,149
0131-002,2013,9,27,6,203,167,370,227
0131-002,2013,9,27,7,591,363,954,370
0131-002,2013,9,27,8,1366,961,2327,954
0131-002,2013,9,27,9,1274,1045,2319,2327
0131-002,2013,9,27,10,858,971,1829,2319
0131-002,2013,9,27,11,929,932,1861,1829
0131-002,2013,9,27,12,897,856,1753,1861
0131-002,2013,9,27,13,711,741,1452,1753
0131-002,2013,9,27,14,924,859,1783,1452
0131-002,2013,9,27,15,911,1023,1934,1783
0131-002,2013,9,27,16,943,965,1908,1934
0131-002,2013,9,27,17,901,1065,1966,1908
0131-002,2013,9,27,18,983,1233,2216,1966
0131-002,2013,9,27,19,989,1323,2312,2216
0131-002,2013,9,27,20,787,1036,1823,2312
0131-002,2013,9,27,21,561,790,1351,1823
0131-002,2013,9,27,22,411,598,1009,1351
0131-002,2013,9,27,23,334,361,695,1009
0131-002,2013,9,27,24,214,238,452,695
0131-002,2013,9,28,1,142,165,307,452
0131-002,2013,9,28,2,121,131,252,307
0131-002,2013,9,28,3,94,101,195,252
0131-002,2013,9,28,4,102,89,191,195
0131-002,2013,9,28,5,108,96,204,191
0131-002,2013,9,28,6,199,183,382,204
0131-002,2013,9,28,7,464,281,745,382
0131-002,2013,9,28,8,833,637,1470,745
0131-002,2013,9,28,9,865,876,1741,1470
0131-002,2013,9,28,10,815,940,1755,1741
0131-002,2013,9,28,11,811,886,1697,1755
0131-002,2013,9,28,12,854,882,1736,1697
0131-002,2013,9,28,13,806,766,1572,1736
0131-002,2013,9,28,14,791,856,1647,1572
0131-002,2013,9,28,15,785,890,1675,1647
0131-002,2013,9,28,16,813,872,1685,1675
0131-002,2013,9,28,17,842,914,1756,1685
0131-002,2013,9,28,18,984,1128,2112,1756
0131-002,2013,9,28,19,902,906,1808,2112
0131-002,2013,9,28,20,634,643,1277,1808
0131-002,2013,9,28,21,484,465,949,1277
0131-002,2013,9,28,22,347,359,706,949
0131-002,2013,9,28,23,270,285,555,706
0131-002,2013,9,28,24,144,174,318,555
0131-002,2013,9,29,1,111,115,226,318
0131-002,2013,9,29,2,93,87,180,226
0131-002,2013,9,29,3,67,76,143,180
0131-002,2013,9,29,4,77,58,135,143
0131-002,2013,9,29,5,56,63,119,135
0131-002,2013,9,29,6,88,79,167,119
0131-002,2013,9,29,7,164,110,274,167
0131-002,2013,9,29,8,279,211,490,274
0131-002,2013,9,29,9,333,322,655,490
0131-002,2013,9,29,10,355,387,742,655
0131-002,2013,9,29,11,396,486,882,742
0131-002,2013,9,29,12,415,442,857,882
0131-002,2013,9,29,13,466,499,965,857
0131-002,2013,9,29,14,471,528,999,965
0131-002,2013,9,29,15,523,590,1113,999
0131-002,2013,9,29,16,578,622,1200,1113
0131-002,2013,9,29,17,565,536,1101,1200
0131-002,2013,9,29,18,585,578,1163,1101
0131-002,2013,9,29,19,586,529,1115,1163
0131-002,2013,9,29,20,444,400,844,1115
0131-002,2013,9,29,21,408,338,746,844
0131-002,2013,9,29,22,326,276,602,746
0131-002,2013,9,29,23,237,168,405,602
0131-002,2013,9,29,24,175,132,307,405
0131-002,2013,9,30,1,138,82,220,307
0131-002,2013,9,30,2,77,65,142,220
0131-002,2013,9,30,3,56,48,104,142
0131-002,2013,9,30,4,61,48,109,104
0131-002,2013,9,30,5,94,93,187,109
0131-002,2013,9,30,6,228,163,391,187
0131-002,2013,9,30,7,706,380,1086,391
0131-002,2013,9,30,8,1611,983,2594,1086
0131-002,2013,9,30,9,1313,1043,2356,2594
0131-002,2013,9,30,10,885,868,1753,2356
0131-002,2013,9,30,11,893,926,1819,1753
0131-002,2013,9,30,12,858,881,1739,1819
0131-002,2013,9,30,13,757,750,1507,1739
0131-002,2013,9,30,14,913,841,1754,1507
0131-002,2013,9,30,15,928,995,1923,1754
0131-002,2013,9,30,16,960,971,1931,1923
0131-002,2013,9,30,17,899,982,1881,1931
0131-002,2013,9,30,18,869,1121,1990,1881
0131-002,2013,9,30,19,827,1143,1970,1990
0131-002,2013,9,30,20,651,853,1504,1970
0131-002,2013,9,30,21,508,775,1283,1504
0131-002,2013,9,30,22,414,558,972,1283
0131-002,2013,9,30,23,307,304,611,972
0131-002,2013,9,30,24,194,205,399,611
0131-002,2013,10,1,1,155,143,298,399
0131-002,2013,10,1,2,108,94,202,298
0131-002,2013,10,1,3,70,99,169,202
0131-002,2013,10,1,4,74,78,152,169
0131-002,2013,10,1,5,109,114,223,152
0131-002,2013,10,1,6,203,152,355,223
0131-002,2013,10,1,7,611,346,957,355
0131-002,2013,10,1,8,1404,956,2360,957
0131-002,2013,10,1,9,1246,993,2239,2360
0131-002,2013,10,1,10,923,985,1908,2239
0131-002,2013,10,1,11,929,952,1881,1908
0131-002,2013,10,1,12,914,893,1807,1881
0131-002,2013,10,1,13,743,801,1544,1807
0131-002,2013,10,1,14,773,872,1645,1544
0131-002,2013,10,1,15,959,964,1923,1645
0131-002,2013,10,1,16,961,967,1928,1923
0131-002,2013,10,1,17,867,1045,1912,1928
0131-002,2013,10,1,18,899,1166,2065,1912
0131-002,2013,10,1,19,859,1159,2018,2065
0131-002,2013,10,1,20,635,859,1494,2018
0131-002,2013,10,1,21,523,732,1255,1494
0131-002,2013,10,1,22,438,518,956,1255
0131-002,2013,10,1,23,288,316,604,956
0131-002,2013,10,1,24,184,195,379,604
0131-002,2013,10,2,1,135,131,266,379
0131-002,2013,10,2,2,105,87,192,266
0131-002,2013,10,2,3,68,78,146,192
0131-002,2013,10,2,4,88,72,160,146
0131-002,2013,10,2,5,86,104,190,160
0131-002,2013,10,2,6,182,153,335,190
0131-002,2013,10,2,7,577,318,895,335
0131-002,2013,10,2,8,1411,899,2310,895
0131-002,2013,10,2,9,1313,1089,2402,2310
0131-002,2013,10,2,10,921,935,1856,2402
0131-002,2013,10,2,11,907,874,1781,1856
0131-002,2013,10,2,12,828,953,1781,1781
0131-002,2013,10,2,13,768,822,1590,1781
0131-002,2013,10,2,14,845,875,1720,1590
0131-002,2013,10,2,15,980,1039,2019,1720
0131-002,2013,10,2,16,1033,983,2016,2019
0131-002,2013,10,2,17,1068,1048,2116,2016
0131-002,2013,10,2,18,969,1220,2189,2116
0131-002,2013,10,2,19,1027,1325,2352,2189
0131-002,2013,10,2,20,887,964,1851,2352
0131-002,2013,10,2,21,582,779,1361,1851
0131-002,2013,10,2,22,445,581,1026,1361
0131-002,2013,10,2,23,306,316,622,1026
0131-002,2013,10,2,24,204,224,428,622
0131-002,2013,10,3,1,165,176,341,428
0131-002,2013,10,3,2,149,109,258,341
0131-002,2013,10,3,3,95,77,172,258
0131-002,2013,10,3,4,82,83,165,172
0131-002,2013,10,3,5,106,98,204,165
0131-002,2013,10,3,6,193,140,333,204
0131-002,2013,10,3,7,450,293,743,333
0131-002,2013,10,3,8,923,592,1515,743
0131-002,2013,10,3,9,790,753,1543,1515
0131-002,2013,10,3,10,739,809,1548,1543
0131-002,2013,10,3,11,731,909,1640,1548
0131-002,2013,10,3,12,771,906,1677,1640
0131-002,2013,10,3,13,593,784,1377,1677
0131-002,2013,10,3,14,721,765,1486,1377
0131-002,2013,10,3,15,703,777,1480,1486
0131-002,2013,10,3,16,781,818,1599,1480
0131-002,2013,10,3,17,737,819,1556,1599
0131-002,2013,10,3,18,853,1072,1925,1556
0131-002,2013,10,3,19,794,874,1668,1925
0131-002,2013,10,3,20,580,627,1207,1668
0131-002,2013,10,3,21,437,478,915,1207
0131-002,2013,10,3,22,409,345,754,915
0131-002,2013,10,3,23,221,243,464,754
0131-002,2013,10,3,24,172,141,313,464
0131-002,2013,10,4,1,103,111,214,313
0131-002,2013,10,4,2,85,86,171,214
0131-002,2013,10,4,3,66,67,133,171
0131-002,2013,10,4,4,75,68,143,133
0131-002,2013,10,4,5,85,98,183,143
0131-002,2013,10,4,6,185,130,315,183
0131-002,2013,10,4,7,639,331,970,315
0131-002,2013,10,4,8,1368,936,2304,970
0131-002,2013,10,4,9,1267,1045,2312,2304
0131-002,2013,10,4,10,892,947,1839,2312
0131-002,2013,10,4,11,940,956,1896,1839
0131-002,2013,10,4,12,889,952,1841,1896
0131-002,2013,10,4,13,768,782,1550,1841
0131-002,2013,10,4,14,827,939,1766,1550
0131-002,2013,10,4,15,965,1039,2004,1766
0131-002,2013,10,4,16,956,1012,1968,2004
0131-002,2013,10,4,17,981,1034,2015,1968
0131-002,2013,10,4,18,897,1280,2177,2015
0131-002,2013,10,4,19,914,1273,2187,2177
0131-002,2013,10,4,20,708,952,1660,2187
0131-002,2013,10,4,21,528,753,1281,1660
0131-002,2013,10,4,22,435,576,1011,1281
0131-002,2013,10,4,23,322,353,675,1011
0131-002,2013,10,4,24,225,205,430,675
0131-002,2013,10,5,1,164,177,341,430
0131-002,2013,10,5,2,132,117,249,341
0131-002,2013,10,5,3,85,90,175,249
0131-002,2013,10,5,4,88,89,177,175
0131-002,2013,10,5,5,82,100,182,177
0131-002,2013,10,5,6,178,157,335,182
0131-002,2013,10,5,7,389,314,703,335
0131-002,2013,10,5,8,831,627,1458,703
0131-002,2013,10,5,9,769,936,1705,1458
0131-002,2013,10,5,10,810,970,1780,1705
0131-002,2013,10,5,11,872,1021,1893,1780
0131-002,2013,10,5,12,853,1092,1945,1893
0131-002,2013,10,5,13,920,943,1863,1945
0131-002,2013,10,5,14,976,885,1861,1863
0131-002,2013,10,5,15,888,827,1715,1861
0131-002,2013,10,5,16,991,853,1844,1715
0131-002,2013,10,5,17,982,871,1853,1844
0131-002,2013,10,5,18,1074,1096,2170,1853
0131-002,2013,10,5,19,927,868,1795,2170
0131-002,2013,10,5,20,673,628,1301,1795
0131-002,2013,10,5,21,514,447,961,1301
0131-002,2013,10,5,22,424,371,795,961
0131-002,2013,10,5,23,283,291,574,795
0131-002,2013,10,5,24,155,192,347,574
0131-002,2013,10,6,1,140,144,284,347
0131-002,2013,10,6,2,102,94,196,284
0131-002,2013,10,6,3,80,91,171,196
0131-002,2013,10,6,4,56,65,121,171
0131-002,2013,10,6,5,61,68,129,121
0131-002,2013,10,6,6,105,101,206,129
0131-002,2013,10,6,7,227,207,434,206
0131-002,2013,10,6,8,413,365,778,434
0131-002,2013,10,6,9,384,474,858,778
0131-002,2013,10,6,10,432,485,917,858
0131-002,2013,10,6,11,546,554,1100,917
0131-002,2013,10,6,12,585,585,1170,1100
0131-002,2013,10,6,13,621,514,1135,1170
0131-002,2013,10,6,14,592,563,1155,1135
0131-002,2013,10,6,15,643,646,1289,1155
0131-002,2013,10,6,16,784,630,1414,1289
0131-002,2013,10,6,17,898,728,1626,1414
0131-002,2013,10,6,18,900,847,1747,1626
0131-002,2013,10,6,19,906,656,1562,1747
0131-002,2013,10,6,20,794,517,1311,1562
0131-002,2013,10,6,21,644,437,1081,1311
0131-002,2013,10,6,22,495,277,772,1081
0131-002,2013,10,6,23,321,201,522,772
0131-002,2013,10,6,24,193,148,341,522
0131-002,2013,10,7,1,134,83,217,341
0131-002,2013,10,7,2,75,61,136,217
0131-002,2013,10,7,3,48,52,100,136
0131-002,2013,10,7,4,69,51,120,100
0131-002,2013,10,7,5,82,86,168,120
0131-002,2013,10,7,6,217,173,390,168
0131-002,2013,10,7,7,736,370,1106,390
0131-002,2013,10,7,8,1582,978,2560,1106
0131-002,2013,10,7,9,1354,1047,2401,2560
0131-002,2013,10,7,10,898,876,1774,2401
0131-002,2013,10,7,11,907,927,1834,1774
0131-002,2013,10,7,12,854,901,1755,1834
0131-002,2013,10,7,13,736,753,1489,1755
0131-002,2013,10,7,14,939,826,1765,1489
0131-002,2013,10,7,15,964,1057,2021,1765
0131-002,2013,10,7,16,992,1008,2000,2021
0131-002,2013,10,7,17,962,1033,1995,2000
0131-002,2013,10,7,18,902,1185,2087,1995
0131-002,2013,10,7,19,847,1167,2014,2087
0131-002,2013,10,7,20,663,851,1514,2014
0131-002,2013,10,7,21,532,780,1312,1514
0131-002,2013,10,7,22,406,567,973,1312
0131-002,2013,10,7,23,312,312,624,973
0131-002,2013,10,7,24,178,195,373,624
0131-002,2013,10,8,1,145,133,278,373
0131-002,2013,10,8,2,87,90,177,278
0131-002,2013,10,8,3,75,71,146,177
0131-002,2013,10,8,4,72,73,145,146
0131-002,2013,10,8,5,95,95,190,145
0131-002,2013,10,8,6,144,155,299,190
0131-002,2013,10,8,7,496,267,763,299
0131-002,2013,10,8,8,1303,837,2140,763
0131-002,2013,10,8,9,1225,1053,2278,2140
0131-002,2013,10,8,10,855,951,1806,2278
0131-002,2013,10,8,11,922,836,1758,1806
0131-002,2013,10,8,12,857,848,1705,1758
0131-002,2013,10,8,13,727,741,1468,1705
0131-002,2013,10,8,14,747,814,1561,1468
0131-002,2013,10,8,15,893,960,1853,1561
0131-002,2013,10,8,16,877,926,1803,1853
0131-002,2013,10,8,17,859,984,1843,1803
0131-002,2013,10,8,18,833,1107,1940,1843
0131-002,2013,10,8,19,832,1224,2056,1940
0131-002,2013,10,8,20,653,874,1527,2056
0131-002,2013,10,8,21,534,728,1262,1527
0131-002,2013,10,8,22,391,566,957,1262
0131-002,2013,10,8,23,322,333,655,957
0131-002,2013,10,8,24,227,191,418,655
0131-002,2013,10,9,1,144,149,293,418
0131-002,2013,10,9,2,90,101,191,293
0131-002,2013,10,9,3,85,90,175,191
0131-002,2013,10,9,4,69,67,136,175
0131-002,2013,10,9,5,86,89,175,136
0131-002,2013,10,9,6,196,141,337,175
0131-002,2013,10,9,7,410,269,679,337
0131-002,2013,10,9,8,860,537,1397,679
0131-002,2013,10,9,9,802,734,1536,1397
0131-002,2013,10,9,10,747,666,1413,1536
0131-002,2013,10,9,11,718,733,1451,1413
0131-002,2013,10,9,12,696,764,1460,1451
0131-002,2013,10,9,13,646,732,1378,1460
0131-002,2013,10,9,14,712,756,1468,1378
0131-002,2013,10,9,15,723,804,1527,1468
0131-002,2013,10,9,16,740,779,1519,1527
0131-002,2013,10,9,17,710,836,1546,1519
0131-002,2013,10,9,18,834,1002,1836,1546
0131-002,2013,10,9,19,735,900,1635,1836
0131-002,2013,10,9,20,500,595,1095,1635
0131-002,2013,10,9,21,398,402,800,1095
0131-002,2013,10,9,22,303,369,672,800
0131-002,2013,10,9,23,247,242,489,672
0131-002,2013,10,9,24,173,145,318,489
0131-002,2013,10,10,1,115,122,237,318
0131-002,2013,10,10,2,77,83,160,237
0131-002,2013,10,10,3,75,66,141,160
0131-002,2013,10,10,4,58,63,121,141
0131-002,2013,10,10,5,81,109,190,121
0131-002,2013,10,10,6,178,143,321,190
0131-002,2013,10,10,7,608,310,918,321
0131-002,2013,10,10,8,1532,988,2520,918
0131-002,2013,10,10,9,1395,1124,2519,2520
0131-002,2013,10,10,10,954,881,1835,2519
0131-002,2013,10,10,11,902,1021,1923,1835
0131-002,2013,10,10,12,895,909,1804,1923
0131-002,2013,10,10,13,752,792,1544,1804
0131-002,2013,10,10,14,876,898,1774,1544
0131-002,2013,10,10,15,1011,1033,2044,1774
0131-002,2013,10,10,16,966,1037,2003,2044
0131-002,2013,10,10,17,942,1046,1988,2003
0131-002,2013,10,10,18,889,1238,2127,1988
0131-002,2013,10,10,19,856,1201,2057,2127
0131-002,2013,10,10,20,662,815,1477,2057
0131-002,2013,10,10,21,466,714,1180,1477
0131-002,2013,10,10,22,450,559,1009,1180
0131-002,2013,10,10,23,308,370,678,1009
0131-002,2013,10,10,24,201,223,424,678
0131-002,2013,10,11,1,141,156,297,424
0131-002,2013,10,11,2,94,81,175,297
0131-002,2013,10,11,3,75,75,150,175
0131-002,2013,10,11,4,90,81,171,150
0131-002,2013,10,11,5,120,122,242,171
0131-002,2013,10,11,6,216,158,374,242
0131-002,2013,10,11,7,604,334,938,374
0131-002,2013,10,11,8,1415,928,2343,938
0131-002,2013,10,11,9,1309,1099,2408,2343
0131-002,2013,10,11,10,935,1002,1937,2408
0131-002,2013,10,11,11,988,961,1949,1937
0131-002,2013,10,11,12,906,989,1895,1949
0131-002,2013,10,11,13,735,867,1602,1895
0131-002,2013,10,11,14,880,913,1793,1602
0131-002,2013,10,11,15,977,1029,2006,1793
0131-002,2013,10,11,16,1027,1067,2094,2006
0131-002,2013,10,11,17,896,1072,1968,2094
0131-002,2013,10,11,18,922,1254,2176,1968
0131-002,2013,10,11,19,1006,1284,2290,2176
0131-002,2013,10,11,20,736,973,1709,2290
0131-002,2013,10,11,21,526,814,1340,1709
0131-002,2013,10,11,22,451,597,1048,1340
0131-002,2013,10,11,23,325,355,680,1048
0131-002,2013,10,11,24,185,231,416,680
0131-002,2013,10,12,1,157,156,313,416
0131-002,2013,10,12,2,119,119,238,313
0131-002,2013,10,12,3,73,89,162,238
0131-002,2013,10,12,4,76,78,154,162
0131-002,2013,10,12,5,114,89,203,154
0131-002,2013,10,12,6,217,139,356,203
0131-002,2013,10,12,7,481,325,806,356
0131-002,2013,10,12,8,888,644,1532,806
0131-002,2013,10,12,9,854,901,1755,1532
0131-002,2013,10,12,10,864,960,1824,1755
0131-002,2013,10,12,11,819,1110,1929,1824
0131-002,2013,10,12,12,773,1080,1853,1929
0131-002,2013,10,12,13,839,1037,1876,1853
0131-002,2013,10,12,14,758,856,1614,1876
0131-002,2013,10,12,15,845,839,1684,1614
0131-002,2013,10,12,16,866,891,1757,1684
0131-002,2013,10,12,17,1032,954,1986,1757
0131-002,2013,10,12,18,1061,1112,2173,1986
0131-002,2013,10,12,19,941,934,1875,2173
0131-002,2013,10,12,20,750,600,1350,1875
0131-002,2013,10,12,21,558,466,1024,1350
0131-002,2013,10,12,22,386,395,781,1024
0131-002,2013,10,12,23,259,255,514,781
0131-002,2013,10,12,24,179,193,372,514
0131-002,2013,10,13,1,104,140,244,372
0131-002,2013,10,13,2,91,80,171,244
0131-002,2013,10,13,3,68,72,140,171
0131-002,2013,10,13,4,54,63,117,140
0131-002,2013,10,13,5,58,62,120,117
0131-002,2013,10,13,6,119,118,237,120
0131-002,2013,10,13,7,224,170,394,237
0131-002,2013,10,13,8,393,349,742,394
0131-002,2013,10,13,9,395,390,785,742
0131-002,2013,10,13,10,425,486,911,785
0131-002,2013,10,13,11,471,565,1036,911
0131-002,2013,10,13,12,466,587,1053,1036
0131-002,2013,10,13,13,534,569,1103,1053
0131-002,2013,10,13,14,576,580,1156,1103
0131-002,2013,10,13,15,701,596,1297,1156
0131-002,2013,10,13,16,764,635,1399,1297
0131-002,2013,10,13,17,883,740,1623,1399
0131-002,2013,10,13,18,916,783,1699,1623
0131-002,2013,10,13,19,873,711,1584,1699
0131-002,2013,10,13,20,729,574,1303,1584
0131-002,2013,10,13,21,694,476,1170,1303
0131-002,2013,10,13,22,571,364,935,1170
0131-002,2013,10,13,23,345,227,572,935
0131-002,2013,10,13,24,196,145,341,572
0131-002,2013,10,14,1,117,97,214,341
0131-002,2013,10,14,2,89,68,157,214
0131-002,2013,10,14,3,65,36,101,157
0131-002,2013,10,14,4,66,52,118,101
0131-002,2013,10,14,5,106,81,187,118
0131-002,2013,10,14,6,219,168,387,187
0131-002,2013,10,14,7,741,376,1117,387
0131-002,2013,10,14,8,1622,965,2587,1117
0131-002,2013,10,14,9,1356,985,2341,2587
0131-002,2013,10,14,10,900,883,1783,2341
0131-002,2013,10,14,11,965,989,1954,1783
0131-002,2013,10,14,12,932,920,1852,1954
0131-002,2013,10,14,13,742,810,1552,1852
0131-002,2013,10,14,14,905,898,1803,1552
0131-002,2013,10,14,15,976,1024,2000,1803
0131-002,2013,10,14,16,988,979,1967,2000
0131-002,2013,10,14,17,877,1045,1922,1967
0131-002,2013,10,14,18,908,1210,2118,1922
0131-002,2013,10,14,19,849,1186,2035,2118
0131-002,2013,10,14,20,619,889,1508,2035
0131-002,2013,10,14,21,489,721,1210,1508
0131-002,2013,10,14,22,408,509,917,1210
0131-002,2013,10,14,23,281,309,590,917
0131-002,2013,10,14,24,216,196,412,590
0131-002,2013,10,15,1,117,136,253,412
0131-002,2013,10,15,2,107,76,183,253
0131-002,2013,10,15,3,69,68,137,183
0131-002,2013,10,15,4,90,76,166,137
0131-002,2013,10,15,5,102,96,198,166
0131-002,2013,10,15,6,202,162,364,198
0131-002,2013,10,15,7,595,330,925,364
0131-002,2013,10,15,8,1389,882,2271,925
0131-002,2013,10,15,9,1309,1068,2377,2271
0131-002,2013,10,15,10,919,963,1882,2377
0131-002,2013,10,15,11,979,1014,1993,1882
0131-002,2013,10,15,12,915,914,1829,1993
0131-002,2013,10,15,13,744,783,1527,1829
0131-002,2013,10,15,14,877,936,1813,1527
0131-002,2013,10,15,15,891,953,1844,1813
0131-002,2013,10,15,16,899,1031,1930,1844
0131-002,2013,10,15,17,815,1028,1843,1930
0131-002,2013,10,15,18,801,1173,1974,1843
0131-002,2013,10,15,19,780,1062,1842,1974
0131-002,2013,10,15,20,609,785,1394,1842
0131-002,2013,10,15,21,476,657,1133,1394
0131-002,2013,10,15,22,392,507,899,1133
0131-002,2013,10,15,23,364,282,646,899
0131-002,2013,10,15,24,210,179,389,646
0131-002,2013,10,16,1,128,117,245,389
0131-002,2013,10,16,2,86,65,151,245
0131-002,2013,10,16,3,64,81,145,151
0131-002,2013,10,16,4,78,66,144,145
0131-002,2013,10,16,5,101,102,203,144
0131-002,2013,10,16,6,199,159,358,203
0131-002,2013,10,16,7,570,303,873,358
0131-002,2013,10,16,8,1386,930,2316,873
0131-002,2013,10,16,9,1320,1059,2379,2316
0131-002,2013,10,16,10,965,940,1905,2379
0131-002,2013,10,16,11,963,985,1948,1905
0131-002,2013,10,16,12,906,891,1797,1948
0131-002,2013,10,16,13,725,757,1482,1797
0131-002,2013,10,16,14,854,851,1705,1482
0131-002,2013,10,16,15,978,1040,2018,1705
0131-002,2013,10,16,16,918,998,1916,2018
0131-002,2013,10,16,17,912,1040,1952,1916
0131-002,2013,10,16,18,948,1256,2204,1952
0131-002,2013,10,16,19,862,1169,2031,2204
0131-002,2013,10,16,20,642,813,1455,2031
0131-002,2013,10,16,21,519,687,1206,1455
0131-002,2013,10,16,22,438,551,989,1206
0131-002,2013,10,16,23,308,303,611,989
0131-002,2013,10,16,24,198,180,378,611
0131-002,2013,10,17,1,118,120,238,378
0131-002,2013,10,17,2,108,107,215,238
0131-002,2013,10,17,3,65,77,142,215
0131-002,2013,10,17,4,74,58,132,142
0131-002,2013,10,17,5,99,88,187,132
0131-002,2013,10,17,6,207,145,352,187
0131-002,2013,10,17,7,588,339,927,352
0131-002,2013,10,17,8,1436,929,2365,927
0131-002,2013,10,17,9,1284,1128,2412,2365
0131-002,2013,10,17,10,944,966,1910,2412
0131-002,2013,10,17,11,913,917,1830,1910
0131-002,2013,10,17,12,843,899,1742,1830
0131-002,2013,10,17,13,697,787,1484,1742
0131-002,2013,10,17,14,794,894,1688,1484
0131-002,2013,10,17,15,967,978,1945,1688
0131-002,2013,10,17,16,875,1024,1899,1945
0131-002,2013,10,17,17,892,1010,1902,1899
0131-002,2013,10,17,18,884,1176,2060,1902
0131-002,2013,10,17,19,819,1130,1949,2060
0131-002,2013,10,17,20,636,814,1450,1949
0131-002,2013,10,17,21,470,719,1189,1450
0131-002,2013,10,17,22,466,529,995,1189
0131-002,2013,10,17,23,285,359,644,995
0131-002,2013,10,17,24,204,188,392,644
0131-002,2013,10,18,1,130,127,257,392
0131-002,2013,10,18,2,82,95,177,257
0131-002,2013,10,18,3,78,77,155,177
0131-002,2013,10,18,4,84,77,161,155
0131-002,2013,10,18,5,102,101,203,161
0131-002,2013,10,18,6,205,134,339,203
0131-002,2013,10,18,7,575,339,914,339
0131-002,2013,10,18,8,1360,918,2278,914
0131-002,2013,10,18,9,1334,1077,2411,2278
0131-002,2013,10,18,10,947,958,1905,2411
0131-002,2013,10,18,11,973,907,1880,1905
0131-002,2013,10,18,12,888,926,1814,1880
0131-002,2013,10,18,13,802,849,1651,1814
0131-002,2013,10,18,14,912,934,1846,1651
0131-002,2013,10,18,15,1007,1095,2102,1846
0131-002,2013,10,18,16,982,1021,2003,2102
0131-002,2013,10,18,17,970,1095,2065,2003
0131-002,2013,10,18,18,976,1381,2357,2065
0131-002,2013,10,18,19,992,1392,2384,2357
0131-002,2013,10,18,20,732,952,1684,2384
0131-002,2013,10,18,21,568,776,1344,1684
0131-002,2013,10,18,22,451,561,1012,1344
0131-002,2013,10,18,23,309,352,661,1012
0131-002,2013,10,18,24,201,242,443,661
0131-002,2013,10,19,1,179,162,341,443
0131-002,2013,10,19,2,121,105,226,341
0131-002,2013,10,19,3,85,105,190,226
0131-002,2013,10,19,4,99,87,186,190
0131-002,2013,10,19,5,95,111,206,186
0131-002,2013,10,19,6,171,169,340,206
0131-002,2013,10,19,7,412,303,715,340
0131-002,2013,10,19,8,893,595,1488,715
0131-002,2013,10,19,9,911,854,1765,1488
0131-002,2013,10,19,10,755,982,1737,1765
0131-002,2013,10,19,11,814,1038,1852,1737
0131-002,2013,10,19,12,856,1104,1960,1852
0131-002,2013,10,19,13,767,1041,1808,1960
0131-002,2013,10,19,14,790,884,1674,1808
0131-002,2013,10,19,15,860,918,1778,1674
0131-002,2013,10,19,16,844,959,1803,1778
0131-002,2013,10,19,17,978,899,1877,1803
0131-002,2013,10,19,18,974,1209,2183,1877
0131-002,2013,10,19,19,953,951,1904,2183
0131-002,2013,10,19,20,788,612,1400,1904
0131-002,2013,10,19,21,564,436,1000,1400
0131-002,2013,10,19,22,412,393,805,1000
0131-002,2013,10,19,23,245,232,477,805
0131-002,2013,10,19,24,153,191,344,477
0131-002,2013,10,20,1,157,144,301,344
0131-002,2013,10,20,2,98,111,209,301
0131-002,2013,10,20,3,63,88,151,209
0131-002,2013,10,20,4,64,63,127,151
0131-002,2013,10,20,5,64,61,125,127
0131-002,2013,10,20,6,128,108,236,125
0131-002,2013,10,20,7,211,151,362,236
0131-002,2013,10,20,8,378,287,665,362
0131-002,2013,10,20,9,414,378,792,665
0131-002,2013,10,20,10,439,470,909,792
0131-002,2013,10,20,11,456,540,996,909
0131-002,2013,10,20,12,517,514,1031,996
0131-002,2013,10,20,13,538,564,1102,1031
0131-002,2013,10,20,14,572,569,1141,1102
0131-002,2013,10,20,15,654,598,1252,1141
0131-002,2013,10,20,16,819,702,1521,1252
0131-002,2013,10,20,17,878,731,1609,1521
0131-002,2013,10,20,18,961,877,1838,1609
0131-002,2013,10,20,19,959,719,1678,1838
0131-002,2013,10,20,20,841,518,1359,1678
0131-002,2013,10,20,21,846,437,1283,1359
0131-002,2013,10,20,22,707,349,1056,1283
0131-002,2013,10,20,23,442,189,631,1056
0131-002,2013,10,20,24,215,125,340,631
0131-002,2013,10,21,1,126,85,211,340
0131-002,2013,10,21,2,74,61,135,211
0131-002,2013,10,21,3,50,44,94,135
0131-002,2013,10,21,4,54,57,111,94
0131-002,2013,10,21,5,90,81,171,111
0131-002,2013,10,21,6,223,164,387,171
0131-002,2013,10,21,7,641,345,986,387
0131-002,2013,10,21,8,1629,943,2572,986
0131-002,2013,10,21,9,1429,1017,2446,2572
0131-002,2013,10,21,10,944,907,1851,2446
0131-002,2013,10,21,11,952,885,1837,1851
0131-002,2013,10,21,12,882,899,1781,1837
0131-002,2013,10,21,13,776,811,1587,1781
0131-002,2013,10,21,14,869,865,1734,1587
0131-002,2013,10,21,15,921,996,1917,1734
0131-002,2013,10,21,16,963,1051,2014,1917
0131-002,2013,10,21,17,859,983,1842,2014
0131-002,2013,10,21,18,895,1212,2107,1842
0131-002,2013,10,21,19,877,1130,2007,2107
0131-002,2013,10,21,20,620,845,1465,2007
0131-002,2013,10,21,21,481,738,1219,1465
0131-002,2013,10,21,22,388,474,862,1219
0131-002,2013,10,21,23,280,329,609,862
0131-002,2013,10,21,24,163,191,354,609
0131-002,2013,10,22,1,160,131,291,354
0131-002,2013,10,22,2,84,73,157,291
0131-002,2013,10,22,3,81,75,156,157
0131-002,2013,10,22,4,79,89,168,156
0131-002,2013,10,22,5,121,94,215,168
0131-002,2013,10,22,6,227,167,394,215
0131-002,2013,10,22,7,604,326,930,394
0131-002,2013,10,22,8,1385,934,2319,930
0131-002,2013,10,22,9,1337,1089,2426,2319
0131-002,2013,10,22,10,981,1033,2014,2426
0131-002,2013,10,22,11,958,948,1906,2014
0131-002,2013,10,22,12,823,963,1786,1906
0131-002,2013,10,22,13,743,809,1552,1786
0131-002,2013,10,22,14,866,911,1777,1552
0131-002,2013,10,22,15,1007,1037,2044,1777
0131-002,2013,10,22,16,974,954,1928,2044
0131-002,2013,10,22,17,880,1089,1969,1928
0131-002,2013,10,22,18,859,1263,2122,1969
0131-002,2013,10,22,19,889,1126,2015,2122
0131-002,2013,10,22,20,579,857,1436,2015
0131-002,2013,10,22,21,545,711,1256,1436
0131-002,2013,10,22,22,415,542,957,1256
0131-002,2013,10,22,23,292,326,618,957
0131-002,2013,10,22,24,196,195,391,618
0131-002,2013,10,23,1,131,138,269,391
0131-002,2013,10,23,2,106,90,196,269
0131-002,2013,10,23,3,86,87,173,196
0131-002,2013,10,23,4,66,74,140,173
0131-002,2013,10,23,5,105,105,210,140
0131-002,2013,10,23,6,198,162,360,210
0131-002,2013,10,23,7,624,305,929,360
0131-002,2013,10,23,8,1414,917,2331,929
0131-002,2013,10,23,9,1311,1045,2356,2331
0131-002,2013,10,23,10,1017,978,1995,2356
0131-002,2013,10,23,11,942,926,1868,1995
0131-002,2013,10,23,12,879,884,1763,1868
0131-002,2013,10,23,13,728,842,1570,1763
0131-002,2013,10,23,14,863,857,1720,1570
0131-002,2013,10,23,15,957,1003,1960,1720
0131-002,2013,10,23,16,948,1015,1963,1960
0131-002,2013,10,23,17,855,1006,1861,1963
0131-002,2013,10,23,18,924,1208,2132,1861
0131-002,2013,10,23,19,843,1158,2001,2132
0131-002,2013,10,23,20,623,882,1505,2001
0131-002,2013,10,23,21,481,722,1203,1505
0131-002,2013,10,23,22,410,523,933,1203
0131-002,2013,10,23,23,296,323,619,933
0131-002,2013,10,23,24,210,197,407,619
0131-002,2013,10,24,1,138,130,268,407
0131-002,2013,10,24,2,106,82,188,268
0131-002,2013,10,24,3,79,75,154,188
0131-002,2013,10,24,4,79,85,164,154
0131-002,2013,10,24,5,109,95,204,164
0131-002,2013,10,24,6,182,170,352,204
0131-002,2013,10,24,7,574,357,931,352
0131-002,2013,10,24,8,1382,927,2309,931
0131-002,2013,10,24,9,1352,1094,2446,2309
0131-002,2013,10,24,10,1007,937,1944,2446
0131-002,2013,10,24,11,939,991,1930,1944
0131-002,2013,10,24,12,895,955,1850,1930
0131-002,2013,10,24,13,764,794,1558,1850
0131-002,2013,10,24,14,868,891,1759,1558
0131-002,2013,10,24,15,925,1069,1994,1759
0131-002,2013,10,24,16,989,1001,1990,1994
0131-002,2013,10,24,17,940,1061,2001,1990
0131-002,2013,10,24,18,832,1246,2078,2001
0131-002,2013,10,24,19,858,1092,1950,2078
0131-002,2013,10,24,20,620,822,1442,1950
0131-002,2013,10,24,21,494,703,1197,1442
0131-002,2013,10,24,22,409,459,868,1197
0131-002,2013,10,24,23,303,331,634,868
0131-002,2013,10,24,24,209,223,432,634
0131-002,2013,10,25,1,132,135,267,432
0131-002,2013,10,25,2,85,101,186,267
0131-002,2013,10,25,3,82,74,156,186
0131-002,2013,10,25,4,57,67,124,156
0131-002,2013,10,25,5,97,112,209,124
0131-002,2013,10,25,6,212,159,371,209
0131-002,2013,10,25,7,542,318,860,371
0131-002,2013,10,25,8,1399,914,2313,860
0131-002,2013,10,25,9,1331,1100,2431,2313
0131-002,2013,10,25,10,942,1005,1947,2431
0131-002,2013,10,25,11,968,1013,1981,1947
0131-002,2013,10,25,12,897,980,1877,1981
0131-002,2013,10,25,13,795,844,1639,1877
0131-002,2013,10,25,14,901,915,1816,1639
0131-002,2013,10,25,15,1033,1090,2123,1816
0131-002,2013,10,25,16,944,1098,2042,2123
0131-002,2013,10,25,17,948,1057,2005,2042
0131-002,2013,10,25,18,992,1325,2317,2005
0131-002,2013,10,25,19,950,1316,2266,2317
0131-002,2013,10,25,20,699,948,1647,2266
0131-002,2013,10,25,21,576,741,1317,1647
0131-002,2013,10,25,22,468,573,1041,1317
0131-002,2013,10,25,23,325,347,672,1041
0131-002,2013,10,25,24,212,244,456,672
0131-002,2013,10,26,1,161,172,333,456
0131-002,2013,10,26,2,97,128,225,333
0131-002,2013,10,26,3,103,86,189,225
0131-002,2013,10,26,4,90,67,157,189
0131-002,2013,10,26,5,105,112,217,157
0131-002,2013,10,26,6,202,150,352,217
0131-002,2013,10,26,7,400,325,725,352
0131-002,2013,10,26,8,857,571,1428,725
0131-002,2013,10,26,9,810,806,1616,1428
0131-002,2013,10,26,10,843,951,1794,1616
0131-002,2013,10,26,11,796,1390,2186,1794
0131-002,2013,10,26,12,865,1141,2006,2186
0131-002,2013,10,26,13,817,1011,1828,2006
0131-002,2013,10,26,14,825,921,1746,1828
0131-002,2013,10,26,15,824,822,1646,1746
0131-002,2013,10,26,16,861,880,1741,1646
0131-002,2013,10,26,17,858,952,1810,1741
0131-002,2013,10,26,18,835,1172,2007,1810
0131-002,2013,10,26,19,816,903,1719,2007
0131-002,2013,10,26,20,633,576,1209,1719
0131-002,2013,10,26,21,462,474,936,1209
0131-002,2013,10,26,22,357,383,740,936
0131-002,2013,10,26,23,254,259,513,740
0131-002,2013,10,26,24,168,179,347,513
0131-002,2013,10,27,1,97,114,211,347
0131-002,2013,10,27,2,91,78,169,211
0131-002,2013,10,27,3,52,61,113,169
0131-002,2013,10,27,4,54,64,118,113
0131-002,2013,10,27,5,54,58,112,118
0131-002,2013,10,27,6,126,88,214,112
0131-002,2013,10,27,7,209,165,374,214
0131-002,2013,10,27,8,371,278,649,374
0131-002,2013,10,27,9,387,380,767,649
0131-002,2013,10,27,10,435,487,922,767
0131-002,2013,10,27,11,469,582,1051,922
0131-002,2013,10,27,12,497,527,1024,1051
0131-002,2013,10,27,13,562,456,1018,1024
0131-002,2013,10,27,14,652,637,1289,1018
0131-002,2013,10,27,15,680,633,1313,1289
0131-002,2013,10,27,16,767,751,1518,1313
0131-002,2013,10,27,17,874,810,1684,1518
0131-002,2013,10,27,18,886,928,1814,1684
0131-002,2013,10,27,19,809,726,1535,1814
0131-002,2013,10,27,20,908,504,1412,1535
0131-002,2013,10,27,21,929,429,1358,1412
0131-002,2013,10,27,22,817,348,1165,1358
0131-002,2013,10,27,23,497,194,691,1165
0131-002,2013,10,27,24,230,133,363,691
0131-002,2013,10,28,1,127,95,222,363
0131-002,2013,10,28,2,51,55,106,222
0131-002,2013,10,28,3,52,44,96,106
0131-002,2013,10,28,4,61,54,115,96
0131-002,2013,10,28,5,93,84,177,115
0131-002,2013,10,28,6,219,149,368,177
0131-002,2013,10,28,7,698,331,1029,368
0131-002,2013,10,28,8,1603,927,2530,1029
0131-002,2013,10,28,9,1352,1001,2353,2530
0131-002,2013,10,28,10,869,912,1781,2353
0131-002,2013,10,28,11,900,908,1808,1781
0131-002,2013,10,28,12,865,914,1779,1808
0131-002,2013,10,28,13,754,776,1530,1779
0131-002,2013,10,28,14,867,865,1732,1530
0131-002,2013,10,28,15,995,1000,1995,1732
0131-002,2013,10,28,16,972,1003,1975,1995
0131-002,2013,10,28,17,874,1012,1886,1975
0131-002,2013,10,28,18,854,1161,2015,1886
0131-002,2013,10,28,19,791,1112,1903,2015
0131-002,2013,10,28,20,650,823,1473,1903
0131-002,2013,10,28,21,482,736,1218,1473
0131-002,2013,10,28,22,387,528,915,1218
0131-002,2013,10,28,23,296,326,622,915
0131-002,2013,10,28,24,171,164,335,622
0131-002,2013,10,29,1,110,108,218,335
0131-002,2013,10,29,2,82,75,157,218
0131-002,2013,10,29,3,60,66,126,157
0131-002,2013,10,29,4,67,70,137,126
0131-002,2013,10,29,5,93,105,198,137
0131-002,2013,10,29,6,184,144,328,198
0131-002,2013,10,29,7,558,279,837,328
0131-002,2013,10,29,8,1352,907,2259,837
0131-002,2013,10,29,9,1343,1051,2394,2259
0131-002,2013,10,29,10,890,942,1832,2394
0131-002,2013,10,29,11,913,968,1881,1832
0131-002,2013,10,29,12,970,832,1802,1881
0131-002,2013,10,29,13,704,843,1547,1802
0131-002,2013,10,29,14,879,944,1823,1547
0131-002,2013,10,29,15,961,1056,2017,1823
0131-002,2013,10,29,16,991,943,1934,2017
0131-002,2013,10,29,17,888,1075,1963,1934
0131-002,2013,10,29,18,846,1184,2030,1963
0131-002,2013,10,29,19,771,1042,1813,2030
0131-002,2013,10,29,20,607,805,1412,1813
0131-002,2013,10,29,21,478,742,1220,1412
0131-002,2013,10,29,22,392,489,881,1220
0131-002,2013,10,29,23,297,309,606,881
0131-002,2013,10,29,24,183,202,385,606
0131-002,2013,10,30,1,135,141,276,385
0131-002,2013,10,30,2,80,83,163,276
0131-002,2013,10,30,3,61,78,139,163
0131-002,2013,10,30,4,70,79,149,139
0131-002,2013,10,30,5,92,92,184,149
0131-002,2013,10,30,6,187,143,330,184
0131-002,2013,10,30,7,533,312,845,330
0131-002,2013,10,30,8,1363,846,2209,845
0131-002,2013,10,30,9,1285,1060,2345,2209
0131-002,2013,10,30,10,987,914,1901,2345
0131-002,2013,10,30,11,891,961,1852,1901
0131-002,2013,10,30,12,870,924,1794,1852
0131-002,2013,10,30,13,710,726,1436,1794
0131-002,2013,10,30,14,926,921,1847,1436
0131-002,2013,10,30,15,980,1009,1989,1847
0131-002,2013,10,30,16,931,1105,2036,1989
0131-002,2013,10,30,17,899,1036,1935,2036
0131-002,2013,10,30,18,895,1219,2114,1935
0131-002,2013,10,30,19,820,1132,1952,2114
0131-002,2013,10,30,20,654,797,1451,1952
0131-002,2013,10,30,21,483,671,1154,1451
0131-002,2013,10,30,22,422,493,915,1154
0131-002,2013,10,30,23,318,310,628,915
0131-002,2013,10,30,24,188,199,387,628
0131-002,2013,10,31,1,141,145,286,387
0131-002,2013,10,31,2,87,85,172,286
0131-002,2013,10,31,3,67,68,135,172
0131-002,2013,10,31,4,62,84,146,135
0131-002,2013,10,31,5,107,96,203,146
0131-002,2013,10,31,6,170,130,300,203
0131-002,2013,10,31,7,571,303,874,300
0131-002,2013,10,31,8,1380,889,2269,874
0131-002,2013,10,31,9,1355,997,2352,2269
0131-002,2013,10,31,10,951,910,1861,2352
0131-002,2013,10,31,11,952,972,1924,1861
0131-002,2013,10,31,12,843,1020,1863,1924
0131-002,2013,10,31,13,690,740,1430,1863
0131-002,2013,10,31,14,815,896,1711,1430
0131-002,2013,10,31,15,963,997,1960,1711
0131-002,2013,10,31,16,893,974,1867,1960
0131-002,2013,10,31,17,898,1010,1908,1867
0131-002,2013,10,31,18,928,1182,2110,1908
0131-002,2013,10,31,19,803,1165,1968,2110
0131-002,2013,10,31,20,619,807,1426,1968
0131-002,2013,10,31,21,512,686,1198,1426
0131-002,2013,10,31,22,429,486,915,1198
0131-002,2013,10,31,23,302,344,646,915
0131-002,2013,10,31,24,214,230,444,646
0131-002,2013,11,1,1,127,163,290,444
0131-002,2013,11,1,2,106,104,210,290
0131-002,2013,11,1,3,86,93,179,210
0131-002,2013,11,1,4,80,80,160,179
0131-002,2013,11,1,5,106,80,186,160
0131-002,2013,11,1,6,203,153,356,186
0131-002,2013,11,1,7,560,299,859,356
0131-002,2013,11,1,8,1325,925,2250,859
0131-002,2013,11,1,9,1361,1026,2387,2250
0131-002,2013,11,1,10,900,973,1873,2387
0131-002,2013,11,1,11,875,965,1840,1873
0131-002,2013,11,1,12,862,925,1787,1840
0131-002,2013,11,1,13,757,858,1615,1787
0131-002,2013,11,1,14,847,946,1793,1615
0131-002,2013,11,1,15,986,1037,2023,1793
0131-002,2013,11,1,16,976,1028,2004,2023
0131-002,2013,11,1,17,948,1067,2015,2004
0131-002,2013,11,1,18,1008,1334,2342,2015
0131-002,2013,11,1,19,924,1308,2232,2342
0131-002,2013,11,1,20,707,916,1623,2232
0131-002,2013,11,1,21,495,752,1247,1623
0131-002,2013,11,1,22,441,529,970,1247
0131-002,2013,11,1,23,336,403,739,970
0131-002,2013,11,1,24,205,224,429,739
0131-002,2013,11,2,1,163,155,318,429
0131-002,2013,11,2,2,102,117,219,318
0131-002,2013,11,2,3,91,97,188,219
0131-002,2013,11,2,4,94,79,173,188
0131-002,2013,11,2,5,114,96,210,173
0131-002,2013,11,2,6,180,125,305,210
0131-002,2013,11,2,7,406,301,707,305
0131-002,2013,11,2,8,768,578,1346,707
0131-002,2013,11,2,9,809,784,1593,1346
0131-002,2013,11,2,10,781,949,1730,1593
0131-002,2013,11,2,11,749,1023,1772,1730
0131-002,2013,11,2,12,788,1031,1819,1772
0131-002,2013,11,2,13,730,929,1659,1819
0131-002,2013,11,2,14,689,942,1631,1659
0131-002,2013,11,2,15,697,970,1667,1631
0131-002,2013,11,2,16,806,991,1797,1667
0131-002,2013,11,2,17,871,999,1870,1797
0131-002,2013,11,2,18,966,1055,2021,1870
0131-002,2013,11,2,19,821,840,1661,2021
0131-002,2013,11,2,20,770,517,1287,1661
0131-002,2013,11,2,21,503,446,949,1287
0131-002,2013,11,2,22,428,347,775,949
0131-002,2013,11,2,23,232,213,445,775
0131-002,2013,11,2,24,136,131,267,445
0131-002,2013,11,3,1,117,98,215,267
0131-002,2013,11,3,2,95,83,178,215
0131-002,2013,11,3,3,67,63,130,178
0131-002,2013,11,3,4,51,50,101,130
0131-002,2013,11,3,5,64,56,120,101
0131-002,2013,11,3,6,93,102,195,120
0131-002,2013,11,3,7,179,135,314,195
0131-002,2013,11,3,8,369,265,634,314
0131-002,2013,11,3,9,370,386,756,634
0131-002,2013,11,3,10,421,479,900,756
0131-002,2013,11,3,11,452,582,1034,900
0131-002,2013,11,3,12,540,506,1046,1034
0131-002,2013,11,3,13,535,554,1089,1046
0131-002,2013,11,3,14,674,605,1279,1089
0131-002,2013,11,3,15,870,667,1537,1279
0131-002,2013,11,3,16,980,653,1633,1537
0131-002,2013,11,3,17,1005,676,1681,1633
0131-002,2013,11,3,18,999,758,1757,1681
0131-002,2013,11,3,19,915,641,1556,1757
0131-002,2013,11,3,20,1148,472,1620,1556
0131-002,2013,11,3,21,1014,373,1387,1620
0131-002,2013,11,3,22,965,331,1296,1387
0131-002,2013,11,3,23,647,219,866,1296
0131-002,2013,11,3,24,284,165,449,866
0131-002,2013,11,4,1,124,92,216,449
0131-002,2013,11,4,2,73,72,145,216
0131-002,2013,11,4,3,61,44,105,145
0131-002,2013,11,4,4,55,55,110,105
0131-002,2013,11,4,5,101,84,185,110
0131-002,2013,11,4,6,209,142,351,185
0131-002,2013,11,4,7,610,323,933,351
0131-002,2013,11,4,8,1512,890,2402,933
0131-002,2013,11,4,9,1386,905,2291,2402
0131-002,2013,11,4,10,880,901,1781,2291
0131-002,2013,11,4,11,928,893,1821,1781
0131-002,2013,11,4,12,844,1002,1846,1821
0131-002,2013,11,4,13,749,800,1549,1846
0131-002,2013,11,4,14,871,874,1745,1549
0131-002,2013,11,4,15,1017,1010,2027,1745
0131-002,2013,11,4,16,954,1014,1968,2027
0131-002,2013,11,4,17,923,1026,1949,1968
0131-002,2013,11,4,18,853,1170,2023,1949
0131-002,2013,11,4,19,862,1074,1936,2023
0131-002,2013,11,4,20,598,841,1439,1936
0131-002,2013,11,4,21,485,752,1237,1439
0131-002,2013,11,4,22,409,515,924,1237
0131-002,2013,11,4,23,257,313,570,924
0131-002,2013,11,4,24,193,167,360,570
0131-002,2013,11,5,1,122,133,255,360
0131-002,2013,11,5,2,78,71,149,255
0131-002,2013,11,5,3,80,70,150,149
0131-002,2013,11,5,4,58,61,119,150
0131-002,2013,11,5,5,107,93,200,119
0131-002,2013,11,5,6,172,144,316,200
0131-002,2013,11,5,7,520,295,815,316
0131-002,2013,11,5,8,1357,848,2205,815
0131-002,2013,11,5,9,1284,1030,2314,2205
0131-002,2013,11,5,10,955,971,1926,2314
0131-002,2013,11,5,11,964,932,1896,1926
0131-002,2013,11,5,12,924,935,1859,1896
0131-002,2013,11,5,13,707,796,1503,1859
0131-002,2013,11,5,14,883,948,1831,1503
0131-002,2013,11,5,15,928,1008,1936,1831
0131-002,2013,11,5,16,991,1040,2031,1936
0131-002,2013,11,5,17,922,1058,1980,2031
0131-002,2013,11,5,18,922,1192,2114,1980
0131-002,2013,11,5,19,772,1093,1865,2114
0131-002,2013,11,5,20,635,808,1443,1865
0131-002,2013,11,5,21,504,701,1205,1443
0131-002,2013,11,5,22,388,527,915,1205
0131-002,2013,11,5,23,287,288,575,915
0131-002,2013,11,5,24,200,200,400,575
0131-002,2013,11,6,1,132,128,260,400
0131-002,2013,11,6,2,102,95,197,260
0131-002,2013,11,6,3,64,75,139,197
0131-002,2013,11,6,4,69,55,124,139
0131-002,2013,11,6,5,107,94,201,124
0131-002,2013,11,6,6,189,146,335,201
0131-002,2013,11,6,7,538,304,842,335
0131-002,2013,11,6,8,1348,877,2225,842
0131-002,2013,11,6,9,1345,1063,2408,2225
0131-002,2013,11,6,10,879,957,1836,2408
0131-002,2013,11,6,11,953,912,1865,1836
0131-002,2013,11,6,12,903,905,1808,1865
0131-002,2013,11,6,13,744,846,1590,1808
0131-002,2013,11,6,14,887,921,1808,1590
0131-002,2013,11,6,15,936,1014,1950,1808
0131-002,2013,11,6,16,966,1012,1978,1950
0131-002,2013,11,6,17,865,1031,1896,1978
0131-002,2013,11,6,18,932,1207,2139,1896
0131-002,2013,11,6,19,838,1097,1935,2139
0131-002,2013,11,6,20,587,762,1349,1935
0131-002,2013,11,6,21,517,644,1161,1349
0131-002,2013,11,6,22,390,495,885,1161
0131-002,2013,11,6,23,301,301,602,885
0131-002,2013,11,6,24,196,210,406,602
0131-002,2013,11,7,1,122,109,231,406
0131-002,2013,11,7,2,67,94,161,231
0131-002,2013,11,7,3,55,67,122,161
0131-002,2013,11,7,4,52,76,128,122
0131-002,2013,11,7,5,112,89,201,128
0131-002,2013,11,7,6,183,131,314,201
0131-002,2013,11,7,7,531,296,827,314
0131-002,2013,11,7,8,1373,884,2257,827
0131-002,2013,11,7,9,1296,1059,2355,2257
0131-002,2013,11,7,10,940,916,1856,2355
0131-002,2013,11,7,11,979,973,1952,1856
0131-002,2013,11,7,12,904,858,1762,1952
0131-002,2013,11,7,13,723,794,1517,1762
0131-002,2013,11,7,14,838,892,1730,1517
0131-002,2013,11,7,15,990,974,1964,1730
0131-002,2013,11,7,16,902,1004,1906,1964
0131-002,2013,11,7,17,945,994,1939,1906
0131-002,2013,11,7,18,912,1252,2164,1939
0131-002,2013,11,7,19,861,1105,1966,2164
0131-002,2013,11,7,20,579,820,1399,1966
0131-002,2013,11,7,21,545,748,1293,1399
0131-002,2013,11,7,22,430,535,965,1293
0131-002,2013,11,7,23,280,294,574,965
0131-002,2013,11,7,24,210,217,427,574
0131-002,2013,11,8,1,167,137,304,427
0131-002,2013,11,8,2,97,70,167,304
0131-002,2013,11,8,3,70,82,152,167
0131-002,2013,11,8,4,75,83,158,152
0131-002,2013,11,8,5,98,97,195,158
0131-002,2013,11,8,6,201,130,331,195
0131-002,2013,11,8,7,542,304,846,331
0131-002,2013,11,8,8,1357,897,2254,846
0131-002,2013,11,8,9,1387,1072,2459,2254
0131-002,2013,11,8,10,998,968,1966,2459
0131-002,2013,11,8,11,976,993,1969,1966
0131-002,2013,11,8,12,937,1009,1946,1969
0131-002,2013,11,8,13,750,863,1613,1946
0131-002,2013,11,8,14,891,952,1843,1613
0131-002,2013,11,8,15,991,1032,2023,1843
0131-002,2013,11,8,16,1036,1020,2056,2023
0131-002,2013,11,8,17,988,1095,2083,2056
0131-002,2013,11,8,18,969,1344,2313,2083
0131-002,2013,11,8,19,951,1321,2272,2313
0131-002,2013,11,8,20,742,975,1717,2272
0131-002,2013,11,8,21,520,797,1317,1717
0131-002,2013,11,8,22,465,606,1071,1317
0131-002,2013,11,8,23,354,376,730,1071
0131-002,2013,11,8,24,236,248,484,730
0131-002,2013,11,9,1,156,167,323,484
0131-002,2013,11,9,2,118,129,247,323
0131-002,2013,11,9,3,89,111,200,247
0131-002,2013,11,9,4,88,82,170,200
0131-002,2013,11,9,5,126,104,230,170
0131-002,2013,11,9,6,184,155,339,230
0131-002,2013,11,9,7,395,285,680,339
0131-002,2013,11,9,8,781,623,1404,680
0131-002,2013,11,9,9,802,870,1672,1404
0131-002,2013,11,9,10,800,909,1709,1672
0131-002,2013,11,9,11,794,1009,1803,1709
0131-002,2013,11,9,12,755,1060,1815,1803
0131-002,2013,11,9,13,786,981,1767,1815
0131-002,2013,11,9,14,835,941,1776,1767
0131-002,2013,11,9,15,789,873,1662,1776
0131-002,2013,11,9,16,787,943,1730,1662
0131-002,2013,11,9,17,869,1036,1905,1730
0131-002,2013,11,9,18,824,1073,1897,1905
0131-002,2013,11,9,19,754,777,1531,1897
0131-002,2013,11,9,20,687,614,1301,1531
0131-002,2013,11,9,21,572,424,996,1301
0131-002,2013,11,9,22,430,306,736,996
0131-002,2013,11,9,23,257,254,511,736
0131-002,2013,11,9,24,146,159,305,511
0131-002,2013,11,10,1,126,116,242,305
0131-002,2013,11,10,2,95,93,188,242
0131-002,2013,11,10,3,55,58,113,188
0131-002,2013,11,10,4,47,37,84,113
0131-002,2013,11,10,5,48,53,101,84
0131-002,2013,11,10,6,96,92,188,101
0131-002,2013,11,10,7,149,134,283,188
0131-002,2013,11,10,8,301,272,573,283
0131-002,2013,11,10,9,374,356,730,573
0131-002,2013,11,10,10,414,471,885,730
0131-002,2013,11,10,11,473,543,1016,885
0131-002,2013,11,10,12,506,550,1056,1016
0131-002,2013,11,10,13,485,577,1062,1056
0131-002,2013,11,10,14,698,621,1319,1062
0131-002,2013,11,10,15,842,654,1496,1319
0131-002,2013,11,10,16,936,699,1635,1496
0131-002,2013,11,10,17,984,693,1677,1635
0131-002,2013,11,10,18,1013,743,1756,1677
0131-002,2013,11,10,19,928,568,1496,1756
0131-002,2013,11,10,20,933,495,1428,1496
0131-002,2013,11,10,21,861,393,1254,1428
0131-002,2013,11,10,22,1069,319,1388,1254
0131-002,2013,11,10,23,750,207,957,1388
0131-002,2013,11,10,24,308,143,451,957
0131-002,2013,11,11,1,136,84,220,451
0131-002,2013,11,11,2,96,63,159,220
0131-002,2013,11,11,3,69,44,113,159
0131-002,2013,11,11,4,62,52,114,113
0131-002,2013,11,11,5,93,69,162,114
0131-002,2013,11,11,6,210,153,363,162
0131-002,2013,11,11,7,654,358,1012,363
0131-002,2013,11,11,8,1522,915,2437,1012
0131-002,2013,11,11,9,1477,1005,2482,2437
0131-002,2013,11,11,10,940,931,1871,2482
0131-002,2013,11,11,11,985,886,1871,1871
0131-002,2013,11,11,12,895,941,1836,1871
0131-002,2013,11,11,13,718,825,1543,1836
0131-002,2013,11,11,14,887,886,1773,1543
0131-002,2013,11,11,15,1049,1041,2090,1773
0131-002,2013,11,11,16,904,1035,1939,2090
0131-002,2013,11,11,17,918,1071,1989,1939
0131-002,2013,11,11,18,917,1165,2082,1989
0131-002,2013,11,11,19,804,1047,1851,2082
0131-002,2013,11,11,20,633,848,1481,1851
0131-002,2013,11,11,21,507,725,1232,1481
0131-002,2013,11,11,22,425,524,949,1232
0131-002,2013,11,11,23,268,318,586,949
0131-002,2013,11,11,24,189,182,371,586
0131-002,2013,11,12,1,123,128,251,371
0131-002,2013,11,12,2,88,87,175,251
0131-002,2013,11,12,3,63,73,136,175
0131-002,2013,11,12,4,57,58,115,136
0131-002,2013,11,12,5,117,86,203,115
0131-002,2013,11,12,6,174,158,332,203
0131-002,2013,11,12,7,556,312,868,332
0131-002,2013,11,12,8,1364,867,2231,868
0131-002,2013,11,12,9,1372,1073,2445,2231
0131-002,2013,11,12,10,905,1012,1917,2445
0131-002,2013,11,12,11,975,962,1937,1917
0131-002,2013,11,12,12,952,965,1917,1937
0131-002,2013,11,12,13,737,815,1552,1917
0131-002,2013,11,12,14,869,893,1762,1552
0131-002,2013,11,12,15,995,1046,2041,1762
0131-002,2013,11,12,16,972,989,1961,2041
0131-002,2013,11,12,17,961,1106,2067,1961
0131-002,2013,11,12,18,896,1268,2164,2067
0131-002,2013,11,12,19,802,1065,1867,2164
0131-002,2013,11,12,20,609,828,1437,1867
0131-002,2013,11,12,21,503,690,1193,1437
0131-002,2013,11,12,22,400,518,918,1193
0131-002,2013,11,12,23,283,325,608,918
0131-002,2013,11,12,24,181,201,382,608
0131-002,2013,11,13,1,149,112,261,382
0131-002,2013,11,13,2,94,79,173,261
0131-002,2013,11,13,3,68,72,140,173
0131-002,2013,11,13,4,60,71,131,140
0131-002,2013,11,13,5,100,85,185,131
0131-002,2013,11,13,6,200,182,382,185
0131-002,2013,11,13,7,557,323,880,382
0131-002,2013,11,13,8,1369,809,2178,880
0131-002,2013,11,13,9,1360,1035,2395,2178
0131-002,2013,11,13,10,975,983,1958,2395
0131-002,2013,11,13,11,1055,980,2035,1958
0131-002,2013,11,13,12,920,986,1906,2035
0131-002,2013,11,13,13,763,783,1546,1906
0131-002,2013,11,13,14,895,884,1779,1546
0131-002,2013,11,13,15,995,995,1990,1779
0131-002,2013,11,13,16,969,1061,2030,1990
0131-002,2013,11,13,17,926,1105,2031,2030
0131-002,2013,11,13,18,892,1237,2129,2031
0131-002,2013,11,13,19,833,1133,1966,2129
0131-002,2013,11,13,20,618,797,1415,1966
0131-002,2013,11,13,21,500,713,1213,1415
0131-002,2013,11,13,22,371,513,884,1213
0131-002,2013,11,13,23,305,298,603,884
0131-002,2013,11,13,24,189,169,358,603
0131-002,2013,11,14,1,131,135,266,358
0131-002,2013,11,14,2,85,99,184,266
0131-002,2013,11,14,3,75,84,159,184
0131-002,2013,11,14,4,78,76,154,159
0131-002,2013,11,14,5,91,106,197,154
0131-002,2013,11,14,6,201,158,359,197
0131-002,2013,11,14,7,568,338,906,359
0131-002,2013,11,14,8,1335,849,2184,906
0131-002,2013,11,14,9,1508,1049,2557,2184
0131-002,2013,11,14,10,1053,985,2038,2557
0131-002,2013,11,14,11,964,964,1928,2038
0131-002,2013,11,14,12,897,951,1848,1928
0131-002,2013,11,14,13,723,814,1537,1848
0131-002,2013,11,14,14,867,969,1836,1537
0131-002,2013,11,14,15,980,995,1975,1836
0131-002,2013,11,14,16,977,1019,1996,1975
0131-002,2013,11,14,17,984,1009,1993,1996
0131-002,2013,11,14,18,854,1219,2073,1993
0131-002,2013,11,14,19,834,1073,1907,2073
0131-002,2013,11,14,20,639,836,1475,1907
0131-002,2013,11,14,21,485,757,1242,1475
0131-002,2013,11,14,22,485,533,1018,1242
0131-002,2013,11,14,23,307,326,633,1018
0131-002,2013,11,14,24,204,205,409,633
0131-002,2013,11,15,1,134,148,282,409
0131-002,2013,11,15,2,98,119,217,282
0131-002,2013,11,15,3,82,96,178,217
0131-002,2013,11,15,4,77,87,164,178
0131-002,2013,11,15,5,96,102,198,164
0131-002,2013,11,15,6,199,158,357,198
0131-002,2013,11,15,7,522,290,812,357
0131-002,2013,11,15,8,1349,871,2220,812
0131-002,2013,11,15,9,1321,1060,2381,2220
0131-002,2013,11,15,10,946,948,1894,2381
0131-002,2013,11,15,11,972,959,1931,1894
0131-002,2013,11,15,12,926,952,1878,1931
0131-002,2013,11,15,13,804,835,1639,1878
0131-002,2013,11,15,14,880,937,1817,1639
0131-002,2013,11,15,15,969,1098,2067,1817
0131-002,2013,11,15,16,1027,1080,2107,2067
0131-002,2013,11,15,17,989,1202,2191,2107
0131-002,2013,11,15,18,1050,1385,2435,2191
0131-002,2013,11,15,19,990,1408,2398,2435
0131-002,2013,11,15,20,826,1088,1914,2398
0131-002,2013,11,15,21,589,889,1478,1914
0131-002,2013,11,15,22,424,619,1043,1478
0131-002,2013,11,15,23,335,389,724,1043
0131-002,2013,11,15,24,211,261,472,724
0131-002,2013,11,16,1,154,157,311,472
0131-002,2013,11,16,2,105,119,224,311
0131-002,2013,11,16,3,94,100,194,224
0131-002,2013,11,16,4,76,74,150,194
0131-002,2013,11,16,5,108,104,212,150
0131-002,2013,11,16,6,175,147,322,212
0131-002,2013,11,16,7,384,267,651,322
0131-002,2013,11,16,8,790,543,1333,651
0131-002,2013,11,16,9,944,932,1876,1333
0131-002,2013,11,16,10,790,979,1769,1876
0131-002,2013,11,16,11,850,1165,2015,1769
0131-002,2013,11,16,12,826,1137,1963,2015
0131-002,2013,11,16,13,810,1029,1839,1963
0131-002,2013,11,16,14,872,1040,1912,1839
0131-002,2013,11,16,15,826,1103,1929,1912
0131-002,2013,11,16,16,815,1071,1886,1929
0131-002,2013,11,16,17,950,1066,2016,1886
0131-002,2013,11,16,18,974,1210,2184,2016
0131-002,2013,11,16,19,879,947,1826,2184
0131-002,2013,11,16,20,854,593,1447,1826
0131-002,2013,11,16,21,717,512,1229,1447
0131-002,2013,11,16,22,540,385,925,1229
0131-002,2013,11,16,23,323,269,592,925
0131-002,2013,11,16,24,177,179,356,592
0131-002,2013,11,17,1,117,138,255,356
0131-002,2013,11,17,2,82,98,180,255
0131-002,2013,11,17,3,70,70,140,180
0131-002,2013,11,17,4,55,47,102,140
0131-002,2013,11,17,5,47,50,97,102
0131-002,2013,11,17,6,93,82,175,97
0131-002,2013,11,17,7,215,132,347,175
0131-002,2013,11,17,8,356,252,608,347
0131-002,2013,11,17,9,412,359,771,608
0131-002,2013,11,17,10,472,495,967,771
0131-002,2013,11,17,11,509,557,1066,967
0131-002,2013,11,17,12,619,615,1234,1066
0131-002,2013,11,17,13,635,580,1215,1234
0131-002,2013,11,17,14,741,683,1424,1215
0131-002,2013,11,17,15,895,702,1597,1424
0131-002,2013,11,17,16,1025,698,1723,1597
0131-002,2013,11,17,17,1030,739,1769,1723
0131-002,2013,11,17,18,991,759,1750,1769
0131-002,2013,11,17,19,876,636,1512,1750
0131-002,2013,11,17,20,953,510,1463,1512
0131-002,2013,11,17,21,814,379,1193,1463
0131-002,2013,11,17,22,876,342,1218,1193
0131-002,2013,11,17,23,833,239,1072,1218
0131-002,2013,11,17,24,414,139,553,1072
0131-002,2013,11,18,1,131,74,205,553
0131-002,2013,11,18,2,91,52,143,205
0131-002,2013,11,18,3,59,45,104,143
0131-002,2013,11,18,4,63,52,115,104
0131-002,2013,11,18,5,72,77,149,115
0131-002,2013,11,18,6,208,168,376,149
0131-002,2013,11,18,7,665,318,983,376
0131-002,2013,11,18,8,1568,910,2478,983
0131-002,2013,11,18,9,1418,1019,2437,2478
0131-002,2013,11,18,10,936,856,1792,2437
0131-002,2013,11,18,11,873,927,1800,1792
0131-002,2013,11,18,12,840,895,1735,1800
0131-002,2013,11,18,13,796,833,1629,1735
0131-002,2013,11,18,14,828,870,1698,1629
0131-002,2013,11,18,15,919,917,1836,1698
0131-002,2013,11,18,16,913,946,1859,1836
0131-002,2013,11,18,17,880,999,1879,1859
0131-002,2013,11,18,18,772,1172,1944,1879
0131-002,2013,11,18,19,802,1034,1836,1944
0131-002,2013,11,18,20,569,820,1389,1836
0131-002,2013,11,18,21,437,747,1184,1389
0131-002,2013,11,18,22,360,502,862,1184
0131-002,2013,11,18,23,270,283,553,862
0131-002,2013,11,18,24,169,148,317,553
0131-002,2013,11,19,1,120,115,235,317
0131-002,2013,11,19,2,86,77,163,235
0131-002,2013,11,19,3,64,83,147,163
0131-002,2013,11,19,4,54,88,142,147
0131-002,2013,11,19,5,94,85,179,142
0131-002,2013,11,19,6,203,150,353,179
0131-002,2013,11,19,7,522,279,801,353
0131-002,2013,11,19,8,1353,656,2009,801
0131-002,2013,11,19,9,1331,853,2184,2009
0131-002,2013,11,19,10,899,770,1669,2184
0131-002,2013,11,19,11,962,834,1796,1669
0131-002,2013,11,19,12,886,785,1671,1796
0131-002,2013,11,19,13,691,666,1357,1671
0131-002,2013,11,19,14,827,773,1600,1357
0131-002,2013,11,19,15,985,823,1808,1600
0131-002,2013,11,19,16,939,816,1755,1808
0131-002,2013,11,19,17,888,838,1726,1755
0131-002,2013,11,19,18,885,964,1849,1726
0131-002,2013,11,19,19,794,870,1664,1849
0131-002,2013,11,19,20,523,678,1201,1664
0131-002,2013,11,19,21,490,616,1106,1201
0131-002,2013,11,19,22,442,444,886,1106
0131-002,2013,11,19,23,278,262,540,886
0131-002,2013,11,19,24,189,194,383,540
0131-002,2013,11,20,1,136,119,255,383
0131-002,2013,11,20,2,98,101,199,255
0131-002,2013,11,20,3,73,72,145,199
0131-002,2013,11,20,4,50,73,123,145
0131-002,2013,11,20,5,106,105,211,123
0131-002,2013,11,20,6,187,133,320,211
0131-002,2013,11,20,7,521,274,795,320
0131-002,2013,11,20,8,1373,703,2076,795
0131-002,2013,11,20,9,1380,804,2184,2076
0131-002,2013,11,20,10,930,798,1728,2184
0131-002,2013,11,20,11,882,800,1682,1728
0131-002,2013,11,20,12,893,808,1701,1682
0131-002,2013,11,20,13,715,692,1407,1701
0131-002,2013,11,20,14,871,756,1627,1407
0131-002,2013,11,20,15,951,819,1770,1627
0131-002,2013,11,20,16,968,852,1820,1770
0131-002,2013,11,20,17,884,844,1728,1820
0131-002,2013,11,20,18,938,1008,1946,1728
0131-002,2013,11,20,19,843,938,1781,1946
0131-002,2013,11,20,20,564,644,1208,1781
0131-002,2013,11,20,21,499,597,1096,1208
0131-002,2013,11,20,22,387,450,837,1096
0131-002,2013,11,20,23,311,306,617,837
0131-002,2013,11,20,24,196,184,380,617
0131-002,2013,11,21,1,148,131,279,380
0131-002,2013,11,21,2,89,90,179,279
0131-002,2013,11,21,3,86,83,169,179
0131-002,2013,11,21,4,70,75,145,169
0131-002,2013,11,21,5,85,95,180,145
0131-002,2013,11,21,6,203,152,355,180
0131-002,2013,11,21,7,593,274,867,355
0131-002,2013,11,21,8,1346,673,2019,867
0131-002,2013,11,21,9,1394,852,2246,2019
0131-002,2013,11,21,10,957,752,1709,2246
0131-002,2013,11,21,11,908,850,1758,1709
0131-002,2013,11,21,12,949,794,1743,1758
0131-002,2013,11,21,13,722,689,1411,1743
0131-002,2013,11,21,14,831,786,1617,1411
0131-002,2013,11,21,15,1030,822,1852,1617
0131-002,2013,11,21,16,928,832,1760,1852
0131-002,2013,11,21,17,876,863,1739,1760
0131-002,2013,11,21,18,887,982,1869,1739
0131-002,2013,11,21,19,794,915,1709,1869
0131-002,2013,11,21,20,574,657,1231,1709
0131-002,2013,11,21,21,524,603,1127,1231
0131-002,2013,11,21,22,406,457,863,1127
0131-002,2013,11,21,23,268,277,545,863
0131-002,2013,11,21,24,233,180,413,545
0131-002,2013,11,22,1,159,129,288,413
0131-002,2013,11,22,2,101,89,190,288
0131-002,2013,11,22,3,59,83,142,190
0131-002,2013,11,22,4,71,77,148,142
0131-002,2013,11,22,5,108,98,206,148
0131-002,2013,11,22,6,200,170,370,206
0131-002,2013,11,22,7,571,282,853,370
0131-002,2013,11,22,8,1416,689,2105,853
0131-002,2013,11,22,9,1419,838,2257,2105
0131-002,2013,11,22,10,914,815,1729,2257
0131-002,2013,11,22,11,951,848,1799,1729
0131-002,2013,11,22,12,941,800,1741,1799
0131-002,2013,11,22,13,749,690,1439,1741
0131-002,2013,11,22,14,864,788,1652,1439
0131-002,2013,11,22,15,1010,913,1923,1652
0131-002,2013,11,22,16,1012,879,1891,1923
0131-002,2013,11,22,17,960,919,1879,1891
0131-002,2013,11,22,18,976,1177,2153,1879
0131-002,2013,11,22,19,987,1155,2142,2153
0131-002,2013,11,22,20,700,853,1553,2142
0131-002,2013,11,22,21,556,680,1236,1553
0131-002,2013,11,22,22,426,566,992,1236
0131-002,2013,11,22,23,331,340,671,992
0131-002,2013,11,22,24,225,204,429,671
0131-002,2013,11,23,1,136,164,300,429
0131-002,2013,11,23,2,126,102,228,300
0131-002,2013,11,23,3,81,94,175,228
0131-002,2013,11,23,4,92,85,177,175
0131-002,2013,11,23,5,101,90,191,177
0131-002,2013,11,23,6,213,131,344,191
0131-002,2013,11,23,7,404,278,682,344
0131-002,2013,11,23,8,810,488,1298,682
0131-002,2013,11,23,9,848,705,1553,1298
0131-002,2013,11,23,10,842,713,1555,1553
0131-002,2013,11,23,11,814,794,1608,1555
0131-002,2013,11,23,12,862,812,1674,1608
0131-002,2013,11,23,13,771,788,1559,1674
0131-002,2013,11,23,14,792,827,1619,1559
0131-002,2013,11,23,15,850,772,1622,1619
0131-002,2013,11,23,16,852,713,1565,1622
0131-002,2013,11,23,17,905,832,1737,1565
0131-002,2013,11,23,18,976,908,1884,1737
0131-002,2013,11,23,19,900,712,1612,1884
0131-002,2013,11,23,20,778,524,1302,1612
0131-002,2013,11,23,21,490,393,883,1302
0131-002,2013,11,23,22,397,350,747,883
0131-002,2013,11,23,23,256,242,498,747
0131-002,2013,11,23,24,160,139,299,498
0131-002,2013,11,24,1,127,104,231,299
0131-002,2013,11,24,2,83,79,162,231
0131-002,2013,11,24,3,56,71,127,162
0131-002,2013,11,24,4,50,53,103,127
0131-002,2013,11,24,5,58,58,116,103
0131-002,2013,11,24,6,77,67,144,116
0131-002,2013,11,24,7,176,148,324,144
0131-002,2013,11,24,8,295,222,517,324
0131-002,2013,11,24,9,381,319,700,517
0131-002,2013,11,24,10,411,393,804,700
0131-002,2013,11,24,11,475,437,912,804
0131-002,2013,11,24,12,558,486,1044,912
0131-002,2013,11,24,13,665,530,1195,1044
0131-002,2013,11,24,14,714,513,1227,1195
0131-002,2013,11,24,15,886,557,1443,1227
0131-002,2013,11,24,16,941,680,1621,1443
0131-002,2013,11,24,17,878,681,1559,1621
0131-002,2013,11,24,18,806,692,1498,1559
0131-002,2013,11,24,19,766,574,1340,1498
0131-002,2013,11,24,20,918,437,1355,1340
0131-002,2013,11,24,21,896,352,1248,1355
0131-002,2013,11,24,22,877,323,1200,1248
0131-002,2013,11,24,23,742,194,936,1200
0131-002,2013,11,24,24,472,135,607,936
0131-002,2013,11,25,1,173,85,258,607
0131-002,2013,11,25,2,71,55,126,258
0131-002,2013,11,25,3,43,52,95,126
0131-002,2013,11,25,4,54,55,109,95
0131-002,2013,11,25,5,82,67,149,109
0131-002,2013,11,25,6,192,126,318,149
0131-002,2013,11,25,7,610,272,882,318
0131-002,2013,11,25,8,1493,704,2197,882
0131-002,2013,11,25,9,1452,842,2294,2197
0131-002,2013,11,25,10,913,732,1645,2294
0131-002,2013,11,25,11,871,772,1643,1645
0131-002,2013,11,25,12,832,748,1580,1643
0131-002,2013,11,25,13,695,707,1402,1580
0131-002,2013,11,25,14,842,798,1640,1402
0131-002,2013,11,25,15,947,821,1768,1640
0131-002,2013,11,25,16,967,815,1782,1768
0131-002,2013,11,25,17,838,894,1732,1782
0131-002,2013,11,25,18,807,989,1796,1732
0131-002,2013,11,25,19,786,872,1658,1796
0131-002,2013,11,25,20,572,697,1269,1658
0131-002,2013,11,25,21,470,615,1085,1269
0131-002,2013,11,25,22,371,458,829,1085
0131-002,2013,11,25,23,284,297,581,829
0131-002,2013,11,25,24,190,175,365,581
0131-002,2013,11,26,1,126,120,246,365
0131-002,2013,11,26,2,93,98,191,246
0131-002,2013,11,26,3,78,62,140,191
0131-002,2013,11,26,4,69,85,154,140
0131-002,2013,11,26,5,99,90,189,154
0131-002,2013,11,26,6,199,146,345,189
0131-002,2013,11,26,7,521,296,817,345
0131-002,2013,11,26,8,1384,659,2043,817
0131-002,2013,11,26,9,1344,840,2184,2043
0131-002,2013,11,26,10,923,796,1719,2184
0131-002,2013,11,26,11,1029,878,1907,1719
0131-002,2013,11,26,12,953,875,1828,1907
0131-002,2013,11,26,13,746,761,1507,1828
0131-002,2013,11,26,14,893,833,1726,1507
0131-002,2013,11,26,15,924,910,1834,1726
0131-002,2013,11,26,16,943,901,1844,1834
0131-002,2013,11,26,17,889,915,1804,1844
0131-002,2013,11,26,18,893,966,1859,1804
0131-002,2013,11,26,19,773,974,1747,1859
0131-002,2013,11,26,20,583,655,1238,1747
0131-002,2013,11,26,21,454,599,1053,1238
0131-002,2013,11,26,22,404,456,860,1053
0131-002,2013,11,26,23,294,278,572,860
0131-002,2013,11,26,24,197,175,372,572
0131-002,2013,11,27,1,138,134,272,372
0131-002,2013,11,27,2,85,111,196,272
0131-002,2013,11,27,3,82,80,162,196
0131-002,2013,11,27,4,62,70,132,162
0131-002,2013,11,27,5,82,64,146,132
0131-002,2013,11,27,6,134,143,277,146
0131-002,2013,11,27,7,456,250,706,277
0131-002,2013,11,27,8,1235,664,1899,706
0131-002,2013,11,27,9,1276,837,2113,1899
0131-002,2013,11,27,10,855,753,1608,2113
0131-002,2013,11,27,11,912,797,1709,1608
0131-002,2013,11,27,12,816,786,1602,1709
0131-002,2013,11,27,13,676,687,1363,1602
0131-002,2013,11,27,14,800,781,1581,1363
0131-002,2013,11,27,15,882,876,1758,1581
0131-002,2013,11,27,16,894,826,1720,1758
0131-002,2013,11,27,17,789,785,1574,1720
0131-002,2013,11,27,18,739,867,1606,1574
0131-002,2013,11,27,19,695,863,1558,1606
0131-002,2013,11,27,20,460,631,1091,1558
0131-002,2013,11,27,21,382,319,701,1091
0131-002,2013,11,27,22,313,271,584,701
0131-002,2013,11,27,23,186,228,414,584
0131-002,2013,11,27,24,140,123,263,414
0131-002,2013,11,28,1,115,81,196,263
0131-002,2013,11,28,2,62,67,129,196
0131-002,2013,11,28,3,47,71,118,129
0131-002,2013,11,28,4,46,49,95,118
0131-002,2013,11,28,5,56,81,137,95
0131-002,2013,11,28,6,125,107,232,137
0131-002,2013,11,28,7,359,183,542,232
0131-002,2013,11,28,8,913,223,1136,542
0131-002,2013,11,28,9,987,302,1289,1136
0131-002,2013,11,28,10,758,466,1224,1289
0131-002,2013,11,28,11,810,789,1599,1224
0131-002,2013,11,28,12,804,745,1549,1599
0131-002,2013,11,28,13,651,722,1373,1549
0131-002,2013,11,28,14,830,708,1538,1373
0131-002,2013,11,28,15,959,797,1756,1538
0131-002,2013,11,28,16,865,777,1642,1756
0131-002,2013,11,28,17,808,785,1593,1642
0131-002,2013,11,28,18,837,984,1821,1593
0131-002,2013,11,28,19,736,786,1522,1821
0131-002,2013,11,28,20,494,691,1185,1522
0131-002,2013,11,28,21,447,563,1010,1185
0131-002,2013,11,28,22,343,391,734,1010
0131-002,2013,11,28,23,218,275,493,734
0131-002,2013,11,28,24,170,180,350,493
0131-002,2013,11,29,1,115,100,215,350
0131-002,2013,11,29,2,65,86,151,215
0131-002,2013,11,29,3,59,74,133,151
0131-002,2013,11,29,4,61,62,123,133
0131-002,2013,11,29,5,80,96,176,123
0131-002,2013,11,29,6,147,109,256,176
0131-002,2013,11,29,7,430,222,652,256
0131-002,2013,11,29,8,1109,629,1738,652
0131-002,2013,11,29,9,1275,807,2082,1738
0131-002,2013,11,29,10,956,752,1708,2082
0131-002,2013,11,29,11,926,907,1833,1708
0131-002,2013,11,29,12,872,840,1712,1833
0131-002,2013,11,29,13,755,675,1430,1712
0131-002,2013,11,29,14,863,780,1643,1430
0131-002,2013,11,29,15,1029,798,1827,1643
0131-002,2013,11,29,16,890,835,1725,1827
0131-002,2013,11,29,17,903,896,1799,1725
0131-002,2013,11,29,18,953,1033,1986,1799
0131-002,2013,11,29,19,887,1072,1959,1986
0131-002,2013,11,29,20,632,756,1388,1959
0131-002,2013,11,29,21,504,643,1147,1388
0131-002,2013,11,29,22,411,494,905,1147
0131-002,2013,11,29,23,288,338,626,905
0131-002,2013,11,29,24,186,204,390,626
0131-002,2013,11,30,1,161,151,312,390
0131-002,2013,11,30,2,110,133,243,312
0131-002,2013,11,30,3,84,87,171,243
0131-002,2013,11,30,4,93,90,183,171
0131-002,2013,11,30,5,111,100,211,183
0131-002,2013,11,30,6,172,133,305,211
0131-002,2013,11,30,7,347,217,564,305
0131-002,2013,11,30,8,771,457,1228,564
0131-002,2013,11,30,9,802,666,1468,1228
0131-002,2013,11,30,10,737,710,1447,1468
0131-002,2013,11,30,11,736,757,1493,1447
0131-002,2013,11,30,12,759,773,1532,1493
0131-002,2013,11,30,13,708,679,1387,1532
0131-002,2013,11,30,14,759,663,1422,1387
0131-002,2013,11,30,15,739,631,1370,1422
0131-002,2013,11,30,16,786,690,1476,1370
0131-002,2013,11,30,17,849,716,1565,1476
0131-002,2013,11,30,18,900,810,1710,1565
0131-002,2013,11,30,19,804,644,1448,1710
0131-002,2013,11,30,20,699,449,1148,1448
0131-002,2013,11,30,21,460,361,821,1148
0131-002,2013,11,30,22,322,326,648,821
0131-002,2013,11,30,23,241,226,467,648
0131-002,2013,11,30,24,158,142,300,467
0131-002,2013,12,1,1,148,137,285,300
0131-002,2013,12,1,2,92,97,189,285
0131-002,2013,12,1,3,62,62,124,189
0131-002,2013,12,1,4,70,54,124,124
0131-002,2013,12,1,5,63,67,130,124
0131-002,2013,12,1,6,77,78,155,130
0131-002,2013,12,1,7,206,126,332,155
0131-002,2013,12,1,8,308,242,550,332
0131-002,2013,12,1,9,376,364,740,550
0131-002,2013,12,1,10,388,400,788,740
0131-002,2013,12,1,11,448,462,910,788
0131-002,2013,12,1,12,517,500,1017,910
0131-002,2013,12,1,13,616,525,1141,1017
0131-002,2013,12,1,14,699,517,1216,1141
0131-002,2013,12,1,15,764,548,1312,1216
0131-002,2013,12,1,16,805,546,1351,1312
0131-002,2013,12,1,17,898,597,1495,1351
0131-002,2013,12,1,18,909,631,1540,1495
0131-002,2013,12,1,19,822,510,1332,1540
0131-002,2013,12,1,20,833,374,1207,1332
0131-002,2013,12,1,21,615,353,968,1207
0131-002,2013,12,1,22,527,301,828,968
0131-002,2013,12,1,23,290,186,476,828
0131-002,2013,12,1,24,174,125,299,476
0131-002,2013,12,2,1,119,81,200,299
0131-002,2013,12,2,2,75,59,134,200
0131-002,2013,12,2,3,62,51,113,134
0131-002,2013,12,2,4,71,47,118,113
0131-002,2013,12,2,5,76,74,150,118
0131-002,2013,12,2,6,195,128,323,150
0131-002,2013,12,2,7,658,311,969,323
0131-002,2013,12,2,8,1598,692,2290,969
0131-002,2013,12,2,9,1481,741,2222,2290
0131-002,2013,12,2,10,856,730,1586,2222
0131-002,2013,12,2,11,895,746,1641,1586
0131-002,2013,12,2,12,881,751,1632,1641
0131-002,2013,12,2,13,726,664,1390,1632
0131-002,2013,12,2,14,854,726,1580,1390
0131-002,2013,12,2,15,976,807,1783,1580
0131-002,2013,12,2,16,956,826,1782,1783
0131-002,2013,12,2,17,897,859,1756,1782
0131-002,2013,12,2,18,843,972,1815,1756
0131-002,2013,12,2,19,783,816,1599,1815
0131-002,2013,12,2,20,584,685,1269,1599
0131-002,2013,12,2,21,481,602,1083,1269
0131-002,2013,12,2,22,384,432,816,1083
0131-002,2013,12,2,23,280,289,569,816
0131-002,2013,12,2,24,183,199,382,569
0131-002,2013,12,3,1,126,125,251,382
0131-002,2013,12,3,2,83,100,183,251
0131-002,2013,12,3,3,69,83,152,183
0131-002,2013,12,3,4,80,67,147,152
0131-002,2013,12,3,5,117,93,210,147
0131-002,2013,12,3,6,179,120,299,210
0131-002,2013,12,3,7,567,268,835,299
0131-002,2013,12,3,8,1367,688,2055,835
0131-002,2013,12,3,9,1372,781,2153,2055
0131-002,2013,12,3,10,944,807,1751,2153
0131-002,2013,12,3,11,980,826,1806,1751
0131-002,2013,12,3,12,893,755,1648,1806
0131-002,2013,12,3,13,736,655,1391,1648
0131-002,2013,12,3,14,911,738,1649,1391
0131-002,2013,12,3,15,992,841,1833,1649
0131-002,2013,12,3,16,941,819,1760,1833
0131-002,2013,12,3,17,939,862,1801,1760
0131-002,2013,12,3,18,799,978,1777,1801
0131-002,2013,12,3,19,795,860,1655,1777
0131-002,2013,12,3,20,591,681,1272,1655
0131-002,2013,12,3,21,504,601,1105,1272
0131-002,2013,12,3,22,416,461,877,1105
0131-002,2013,12,3,23,253,275,528,877
0131-002,2013,12,3,24,195,213,408,528
0131-002,2013,12,4,1,117,119,236,408
0131-002,2013,12,4,2,75,108,183,236
0131-002,2013,12,4,3,70,83,153,183
0131-002,2013,12,4,4,65,75,140,153
0131-002,2013,12,4,5,108,105,213,140
0131-002,2013,12,4,6,161,127,288,213
0131-002,2013,12,4,7,542,283,825,288
0131-002,2013,12,4,8,1340,647,1987,825
0131-002,2013,12,4,9,1365,794,2159,1987
0131-002,2013,12,4,10,987,761,1748,2159
0131-002,2013,12,4,11,927,798,1725,1748
0131-002,2013,12,4,12,963,801,1764,1725
0131-002,2013,12,4,13,798,628,1426,1764
0131-002,2013,12,4,14,895,773,1668,1426
0131-002,2013,12,4,15,978,821,1799,1668
0131-002,2013,12,4,16,1000,852,1852,1799
0131-002,2013,12,4,17,911,869,1780,1852
0131-002,2013,12,4,18,888,1084,1972,1780
0131-002,2013,12,4,19,829,947,1776,1972
0131-002,2013,12,4,20,563,649,1212,1776
0131-002,2013,12,4,21,466,541,1007,1212
0131-002,2013,12,4,22,412,430,842,1007
0131-002,2013,12,4,23,308,300,608,842
0131-002,2013,12,4,24,210,192,402,608
0131-002,2013,12,5,1,154,115,269,402
0131-002,2013,12,5,2,92,101,193,269
0131-002,2013,12,5,3,72,95,167,193
0131-002,2013,12,5,4,65,78,143,167
0131-002,2013,12,5,5,99,98,197,143
0131-002,2013,12,5,6,194,139,333,197
0131-002,2013,12,5,7,576,295,871,333
0131-002,2013,12,5,8,1356,651,2007,871
0131-002,2013,12,5,9,1367,819,2186,2007
0131-002,2013,12,5,10,966,778,1744,2186
0131-002,2013,12,5,11,937,808,1745,1744
0131-002,2013,12,5,12,943,738,1681,1745
0131-002,2013,12,5,13,763,710,1473,1681
0131-002,2013,12,5,14,896,755,1651,1473
0131-002,2013,12,5,15,945,845,1790,1651
0131-002,2013,12,5,16,1026,842,1868,1790
0131-002,2013,12,5,17,1090,810,1900,1868
0131-002,2013,12,5,18,1172,954,2126,1900
0131-002,2013,12,5,19,1050,941,1991,2126
0131-002,2013,12,5,20,703,798,1501,1991
0131-002,2013,12,5,21,512,689,1201,1501
0131-002,2013,12,5,22,402,451,853,1201
0131-002,2013,12,5,23,274,295,569,853
0131-002,2013,12,5,24,208,196,404,569
0131-002,2013,12,6,1,132,117,249,404
0131-002,2013,12,6,2,102,86,188,249
0131-002,2013,12,6,3,87,88,175,188
0131-002,2013,12,6,4,84,66,150,175
0131-002,2013,12,6,5,98,97,195,150
0131-002,2013,12,6,6,170,146,316,195
0131-002,2013,12,6,7,542,274,816,316
0131-002,2013,12,6,8,1396,656,2052,816
0131-002,2013,12,6,9,1392,780,2172,2052
0131-002,2013,12,6,10,872,833,1705,2172
0131-002,2013,12,6,11,1005,805,1810,1705
0131-002,2013,12,6,12,918,743,1661,1810
0131-002,2013,12,6,13,775,728,1503,1661
0131-002,2013,12,6,14,855,747,1602,1503
0131-002,2013,12,6,15,987,830,1817,1602
0131-002,2013,12,6,16,993,864,1857,1817
0131-002,2013,12,6,17,934,860,1794,1857
0131-002,2013,12,6,18,965,1052,2017,1794
0131-002,2013,12,6,19,909,976,1885,2017
0131-002,2013,12,6,20,700,807,1507,1885
0131-002,2013,12,6,21,512,629,1141,1507
0131-002,2013,12,6,22,422,494,916,1141
0131-002,2013,12,6,23,345,350,695,916
0131-002,2013,12,6,24,224,233,457,695
0131-002,2013,12,7,1,174,164,338,457
0131-002,2013,12,7,2,132,130,262,338
0131-002,2013,12,7,3,101,97,198,262
0131-002,2013,12,7,4,84,81,165,198
0131-002,2013,12,7,5,96,92,188,165
0131-002,2013,12,7,6,176,123,299,188
0131-002,2013,12,7,7,365,254,619,299
0131-002,2013,12,7,8,791,449,1240,619
0131-002,2013,12,7,9,854,641,1495,1240
0131-002,2013,12,7,10,736,697,1433,1495
0131-002,2013,12,7,11,843,740,1583,1433
0131-002,2013,12,7,12,747,722,1469,1583
0131-002,2013,12,7,13,715,633,1348,1469
0131-002,2013,12,7,14,778,681,1459,1348
0131-002,2013,12,7,15,788,630,1418,1459
0131-002,2013,12,7,16,781,692,1473,1418
0131-002,2013,12,7,17,771,714,1485,1473
0131-002,2013,12,7,18,855,808,1663,1485
0131-002,2013,12,7,19,744,659,1403,1663
0131-002,2013,12,7,20,505,419,924,1403
0131-002,2013,12,7,21,380,371,751,924
0131-002,2013,12,7,22,336,307,643,751
0131-002,2013,12,7,23,272,271,543,643
0131-002,2013,12,7,24,183,162,345,543
0131-002,2013,12,8,1,138,138,276,345
0131-002,2013,12,8,2,77,83,160,276
0131-002,2013,12,8,3,88,72,160,160
0131-002,2013,12,8,4,68,64,132,160
0131-002,2013,12,8,5,42,61,103,132
0131-002,2013,12,8,6,86,58,144,103
0131-002,2013,12,8,7,183,131,314,144
0131-002,2013,12,8,8,302,195,497,314
0131-002,2013,12,8,9,331,312,643,497
0131-002,2013,12,8,10,373,359,732,643
0131-002,2013,12,8,11,443,446,889,732
0131-002,2013,12,8,12,538,459,997,889
0131-002,2013,12,8,13,528,480,1008,997
0131-002,2013,12,8,14,596,485,1081,1008
0131-002,2013,12,8,15,643,492,1135,1081
0131-002,2013,12,8,16,726,555,1281,1135
0131-002,2013,12,8,17,810,565,1375,1281
0131-002,2013,12,8,18,735,605,1340,1375
0131-002,2013,12,8,19,742,486,1228,1340
0131-002,2013,12,8,20,595,380,975,1228
0131-002,2013,12,8,21,473,295,768,975
0131-002,2013,12,8,22,423,278,701,768
0131-002,2013,12,8,23,264,180,444,701
0131-002,2013,12,8,24,194,130,324,444
0131-002,2013,12,9,1,117,77,194,324
0131-002,2013,12,9,2,80,52,132,194
0131-002,2013,12,9,3,47,44,91,132
0131-002,2013,12,9,4,57,58,115,91
0131-002,2013,12,9,5,88,77,165,115
0131-002,2013,12,9,6,171,132,303,165
0131-002,2013,12,9,7,590,287,877,303
0131-002,2013,12,9,8,1357,689,2046,877
0131-002,2013,12,9,9,1379,825,2204,2046
0131-002,2013,12,9,10,857,694,1551,2204
0131-002,2013,12,9,11,851,735,1586,1551
0131-002,2013,12,9,12,805,738,1543,1586
0131-002,2013,12,9,13,683,696,1379,1543
0131-002,2013,12,9,14,798,765,1563,1379
0131-002,2013,12,9,15,863,811,1674,1563
0131-002,2013,12,9,16,876,833,1709,1674
0131-002,2013,12,9,17,776,782,1558,1709
0131-002,2013,12,9,18,742,923,1665,1558
0131-002,2013,12,9,19,731,868,1599,1665
0131-002,2013,12,9,20,555,639,1194,1599
0131-002,2013,12,9,21,437,586,1023,1194
0131-002,2013,12,9,22,393,422,815,1023
0131-002,2013,12,9,23,269,255,524,815
0131-002,2013,12,9,24,172,167,339,524
0131-002,2013,12,10,1,122,116,238,339
0131-002,2013,12,10,2,79,88,167,238
0131-002,2013,12,10,3,75,63,138,167
0131-002,2013,12,10,4,71,66,137,138
0131-002,2013,12,10,5,100,84,184,137
0131-002,2013,12,10,6,171,132,303,184
0131-002,2013,12,10,7,488,244,732,303
0131-002,2013,12,10,8,1384,660,2044,732
0131-002,2013,12,10,9,1349,787,2136,2044
0131-002,2013,12,10,10,897,778,1675,2136
0131-002,2013,12,10,11,982,819,1801,1675
0131-002,2013,12,10,12,945,743,1688,1801
0131-002,2013,12,10,13,719,725,1444,1688
0131-002,2013,12,10,14,872,746,1618,1444
0131-002,2013,12,10,15,987,816,1803,1618
0131-002,2013,12,10,16,957,790,1747,1803
0131-002,2013,12,10,17,845,869,1714,1747
0131-002,2013,12,10,18,853,946,1799,1714
0131-002,2013,12,10,19,810,865,1675,1799
0131-002,2013,12,10,20,569,674,1243,1675
0131-002,2013,12,10,21,495,621,1116,1243
0131-002,2013,12,10,22,433,496,929,1116
0131-002,2013,12,10,23,282,301,583,929
0131-002,2013,12,10,24,233,197,430,583
0131-002,2013,12,11,1,158,146,304,430
0131-002,2013,12,11,2,144,101,245,304
0131-002,2013,12,11,3,80,79,159,245
0131-002,2013,12,11,4,74,83,157,159
0131-002,2013,12,11,5,94,92,186,157
0131-002,2013,12,11,6,117,110,227,186
0131-002,2013,12,11,7,132,206,338,227
0131-002,2013,12,11,8,296,591,887,338
0131-002,2013,12,11,9,587,833,1420,887
0131-002,2013,12,11,10,800,680,1480,1420
0131-002,2013,12,11,11,844,723,1567,1480
0131-002,2013,12,11,12,775,722,1497,1567
0131-002,2013,12,11,13,703,630,1333,1497
0131-002,2013,12,11,14,809,673,1482,1333
0131-002,2013,12,11,15,910,781,1691,1482
0131-002,2013,12,11,16,817,851,1668,1691
0131-002,2013,12,11,17,639,834,1473,1668
0131-002,2013,12,11,18,565,965,1530,1473
0131-002,2013,12,11,19,588,851,1439,1530
0131-002,2013,12,11,20,457,623,1080,1439
0131-002,2013,12,11,21,307,401,708,1080
0131-002,2013,12,11,22,231,299,530,708
0131-002,2013,12,11,23,188,203,391,530
0131-002,2013,12,11,24,132,121,253,391
0131-002,2013,12,12,1,89,87,176,253
0131-002,2013,12,12,2,76,68,144,176
0131-002,2013,12,12,3,62,56,118,144
0131-002,2013,12,12,4,63,44,107,118
0131-002,2013,12,12,5,60,65,125,107
0131-002,2013,12,12,6,132,100,232,125
0131-002,2013,12,12,7,341,194,535,232
0131-002,2013,12,12,8,890,509,1399,535
0131-002,2013,12,12,9,839,743,1582,1399
0131-002,2013,12,12,10,821,728,1549,1582
0131-002,2013,12,12,11,894,778,1672,1549
0131-002,2013,12,12,12,861,694,1555,1672
0131-002,2013,12,12,13,683,662,1345,1555
0131-002,2013,12,12,14,737,790,1527,1345
0131-002,2013,12,12,15,846,827,1673,1527
0131-002,2013,12,12,16,856,763,1619,1673
0131-002,2013,12,12,17,985,724,1709,1619
0131-002,2013,12,12,18,698,867,1565,1709
0131-002,2013,12,12,19,644,783,1427,1565
0131-002,2013,12,12,20,474,547,1021,1427
0131-002,2013,12,12,21,363,459,822,1021
0131-002,2013,12,12,22,345,322,667,822
0131-002,2013,12,12,23,173,219,392,667
0131-002,2013,12,12,24,156,169,325,392
0131-002,2013,12,13,1,112,105,217,325
0131-002,2013,12,13,2,83,66,149,217
0131-002,2013,12,13,3,59,52,111,149
0131-002,2013,12,13,4,54,56,110,111
0131-002,2013,12,13,5,72,55,127,110
0131-002,2013,12,13,6,116,89,205,127
0131-002,2013,12,13,7,407,179,586,205
0131-002,2013,12,13,8,1135,568,1703,586
0131-002,2013,12,13,9,1113,776,1889,1703
0131-002,2013,12,13,10,800,700,1500,1889
0131-002,2013,12,13,11,828,745,1573,1500
0131-002,2013,12,13,12,838,771,1609,1573
0131-002,2013,12,13,13,699,725,1424,1609
0131-002,2013,12,13,14,840,711,1551,1424
0131-002,2013,12,13,15,930,806,1736,1551
0131-002,2013,12,13,16,882,842,1724,1736
0131-002,2013,12,13,17,916,909,1825,1724
0131-002,2013,12,13,18,900,1063,1963,1825
0131-002,2013,12,13,19,828,1031,1859,1963
0131-002,2013,12,13,20,643,746,1389,1859
0131-002,2013,12,13,21,473,636,1109,1389
0131-002,2013,12,13,22,372,434,806,1109
0131-002,2013,12,13,23,291,267,558,806
0131-002,2013,12,13,24,230,200,430,558
0131-002,2013,12,14,1,146,155,301,430
0131-002,2013,12,14,2,114,117,231,301
0131-002,2013,12,14,3,90,100,190,231
0131-002,2013,12,14,4,69,85,154,190
0131-002,2013,12,14,5,62,44,106,154
0131-002,2013,12,14,6,139,47,186,106
0131-002,2013,12,14,7,230,89,319,186
0131-002,2013,12,14,8,525,198,723,319
0131-002,2013,12,14,9,689,292,981,723
0131-002,2013,12,14,10,584,357,941,981
0131-002,2013,12,14,11,703,427,1130,941
0131-002,2013,12,14,12,723,425,1148,1130
0131-002,2013,12,14,13,745,420,1165,1148
0131-002,2013,12,14,14,680,465,1145,1165
0131-002,2013,12,14,15,720,470,1190,1145
0131-002,2013,12,14,16,763,396,1159,1190
0131-002,2013,12,14,17,778,661,1439,1159
0131-002,2013,12,14,18,816,826,1642,1439
0131-002,2013,12,14,19,689,598,1287,1642
0131-002,2013,12,14,20,445,417,862,1287
0131-002,2013,12,14,21,355,333,688,862
0131-002,2013,12,14,22,269,275,544,688
0131-002,2013,12,14,23,217,228,445,544
0131-002,2013,12,14,24,170,170,340,445
0131-002,2013,12,15,1,142,119,261,340
0131-002,2013,12,15,2,99,96,195,261
0131-002,2013,12,15,3,78,81,159,195
0131-002,2013,12,15,4,61,55,116,159
0131-002,2013,12,15,5,49,34,83,116
0131-002,2013,12,15,6,81,71,152,83
0131-002,2013,12,15,7,189,124,313,152
0131-002,2013,12,15,8,278,189,467,313
0131-002,2013,12,15,9,359,292,651,467
0131-002,2013,12,15,10,356,390,746,651
0131-002,2013,12,15,11,410,438,848,746
0131-002,2013,12,15,12,483,498,981,848
0131-002,2013,12,15,13,491,445,936,981
0131-002,2013,12,15,14,572,511,1083,936
0131-002,2013,12,15,15,594,581,1175,1083
0131-002,2013,12,15,16,664,557,1221,1175
0131-002,2013,12,15,17,723,521,1244,1221
0131-002,2013,12,15,18,683,569,1252,1244
0131-002,2013,12,15,19,583,432,1015,1252
0131-002,2013,12,15,20,417,357,774,1015
0131-002,2013,12,15,21,400,295,695,774
0131-002,2013,12,15,22,363,269,632,695
0131-002,2013,12,15,23,263,186,449,632
0131-002,2013,12,15,24,166,123,289,449
0131-002,2013,12,16,1,118,84,202,289
0131-002,2013,12,16,2,77,56,133,202
0131-002,2013,12,16,3,56,38,94,133
0131-002,2013,12,16,4,74,66,140,94
0131-002,2013,12,16,5,67,57,124,140
0131-002,2013,12,16,6,186,134,320,124
0131-002,2013,12,16,7,579,264,843,320
0131-002,2013,12,16,8,1432,706,2138,843
0131-002,2013,12,16,9,1495,775,2270,2138
0131-002,2013,12,16,10,910,708,1618,2270
0131-002,2013,12,16,11,907,788,1695,1618
0131-002,2013,12,16,12,928,761,1689,1695
0131-002,2013,12,16,13,728,710,1438,1689
0131-002,2013,12,16,14,873,767,1640,1438
0131-002,2013,12,16,15,995,916,1911,1640
0131-002,2013,12,16,16,977,837,1814,1911
0131-002,2013,12,16,17,881,883,1764,1814
0131-002,2013,12,16,18,884,1051,1935,1764
0131-002,2013,12,16,19,745,900,1645,1935
0131-002,2013,12,16,20,567,670,1237,1645
0131-002,2013,12,16,21,456,547,1003,1237
0131-002,2013,12,16,22,374,455,829,1003
0131-002,2013,12,16,23,259,302,561,829
0131-002,2013,12,16,24,220,195,415,561
0131-002,2013,12,17,1,135,137,272,415
0131-002,2013,12,17,2,114,97,211,272
0131-002,2013,12,17,3,83,74,157,211
0131-002,2013,12,17,4,67,69,136,157
0131-002,2013,12,17,5,82,97,179,136
0131-002,2013,12,17,6,172,136,308,179
0131-002,2013,12,17,7,543,280,823,308
0131-002,2013,12,17,8,1294,736,2030,823
0131-002,2013,12,17,9,1392,828,2220,2030
0131-002,2013,12,17,10,978,780,1758,2220
0131-002,2013,12,17,11,980,841,1821,1758
0131-002,2013,12,17,12,907,749,1656,1821
0131-002,2013,12,17,13,756,770,1526,1656
0131-002,2013,12,17,14,886,784,1670,1526
0131-002,2013,12,17,15,1025,893,1918,1670
0131-002,2013,12,17,16,957,859,1816,1918
0131-002,2013,12,17,17,871,856,1727,1816
0131-002,2013,12,17,18,905,1122,2027,1727
0131-002,2013,12,17,19,756,939,1695,2027
0131-002,2013,12,17,20,566,668,1234,1695
0131-002,2013,12,17,21,444,573,1017,1234
0131-002,2013,12,17,22,395,454,849,1017
0131-002,2013,12,17,23,261,272,533,849
0131-002,2013,12,17,24,197,196,393,533
0131-002,2013,12,18,1,149,129,278,393
0131-002,2013,12,18,2,99,91,190,278
0131-002,2013,12,18,3,68,85,153,190
0131-002,2013,12,18,4,76,74,150,153
0131-002,2013,12,18,5,92,93,185,150
0131-002,2013,12,18,6,165,144,309,185
0131-002,2013,12,18,7,491,290,781,309
0131-002,2013,12,18,8,1368,669,2037,781
0131-002,2013,12,18,9,1369,814,2183,2037
0131-002,2013,12,18,10,925,831,1756,2183
0131-002,2013,12,18,11,942,827,1769,1756
0131-002,2013,12,18,12,866,752,1618,1769
0131-002,2013,12,18,13,742,656,1398,1618
0131-002,2013,12,18,14,897,764,1661,1398
0131-002,2013,12,18,15,994,907,1901,1661
0131-002,2013,12,18,16,965,905,1870,1901
0131-002,2013,12,18,17,902,876,1778,1870
0131-002,2013,12,18,18,930,1042,1972,1778
0131-002,2013,12,18,19,808,972,1780,1972
0131-002,2013,12,18,20,597,662,1259,1780
0131-002,2013,12,18,21,480,632,1112,1259
0131-002,2013,12,18,22,400,472,872,1112
0131-002,2013,12,18,23,298,294,592,872
0131-002,2013,12,18,24,197,204,401,592
0131-002,2013,12,19,1,160,158,318,401
0131-002,2013,12,19,2,83,105,188,318
0131-002,2013,12,19,3,79,88,167,188
0131-002,2013,12,19,4,55,79,134,167
0131-002,2013,12,19,5,88,99,187,134
0131-002,2013,12,19,6,137,124,261,187
0131-002,2013,12,19,7,422,237,659,261
0131-002,2013,12,19,8,1075,613,1688,659
0131-002,2013,12,19,9,1017,831,1848,1688
0131-002,2013,12,19,10,562,627,1189,1848
0131-002,2013,12,19,11,454,649,1103,1189
0131-002,2013,12,19,12,565,732,1297,1103
0131-002,2013,12,19,13,702,761,1463,1297
0131-002,2013,12,19,14,772,871,1643,1463
0131-002,2013,12,19,15,770,879,1649,1643
0131-002,2013,12,19,16,709,776,1485,1649
0131-002,2013,12,19,17,730,713,1443,1485
0131-002,2013,12,19,18,578,539,1117,1443
0131-002,2013,12,19,19,530,658,1188,1117
0131-002,2013,12,19,20,561,542,1103,1188
0131-002,2013,12,19,21,329,339,668,1103
0131-002,2013,12,19,22,254,276,530,668
0131-002,2013,12,19,23,162,206,368,530
0131-002,2013,12,19,24,110,87,197,368
0131-002,2013,12,20,1,65,66,131,197
0131-002,2013,12,20,2,37,52,89,131
0131-002,2013,12,20,3,45,62,107,89
0131-002,2013,12,20,4,47,35,82,107
0131-002,2013,12,20,5,60,60,120,82
0131-002,2013,12,20,6,104,83,187,120
0131-002,2013,12,20,7,258,166,424,187
0131-002,2013,12,20,8,643,350,993,424
0131-002,2013,12,20,9,714,505,1219,993
0131-002,2013,12,20,10,644,496,1140,1219
0131-002,2013,12,20,11,715,596,1311,1140
0131-002,2013,12,20,12,669,677,1346,1311
0131-002,2013,12,20,13,592,612,1204,1346
0131-002,2013,12,20,14,685,715,1400,1204
0131-002,2013,12,20,15,848,829,1677,1400
0131-002,2013,12,20,16,843,798,1641,1677
0131-002,2013,12,20,17,807,896,1703,1641
0131-002,2013,12,20,18,798,1076,1874,1703
0131-002,2013,12,20,19,800,1003,1803,1874
0131-002,2013,12,20,20,569,645,1214,1803
0131-002,2013,12,20,21,431,548,979,1214
0131-002,2013,12,20,22,311,361,672,979
0131-002,2013,12,20,23,264,247,511,672
0131-002,2013,12,20,24,179,185,364,511
0131-002,2013,12,21,1,141,144,285,364
0131-002,2013,12,21,2,101,126,227,285
0131-002,2013,12,21,3,92,89,181,227
0131-002,2013,12,21,4,79,76,155,181
0131-002,2013,12,21,5,74,83,157,155
0131-002,2013,12,21,6,118,121,239,157
0131-002,2013,12,21,7,267,172,439,239
0131-002,2013,12,21,8,569,364,933,439
0131-002,2013,12,21,9,628,541,1169,933
0131-002,2013,12,21,10,624,779,1403,1169
0131-002,2013,12,21,11,693,832,1525,1403
0131-002,2013,12,21,12,715,806,1521,1525
0131-002,2013,12,21,13,624,724,1348,1521
0131-002,2013,12,21,14,735,700,1435,1348
0131-002,2013,12,21,15,717,755,1472,1435
0131-002,2013,12,21,16,676,724,1400,1472
0131-002,2013,12,21,17,771,662,1433,1400
0131-002,2013,12,21,18,841,891,1732,1433
0131-002,2013,12,21,19,710,617,1327,1732
0131-002,2013,12,21,20,492,364,856,1327
0131-002,2013,12,21,21,337,326,663,856
0131-002,2013,12,21,22,282,301,583,663
0131-002,2013,12,21,23,208,236,444,583
0131-002,2013,12,21,24,162,163,325,444
0131-002,2013,12,22,1,118,128,246,325
0131-002,2013,12,22,2,91,85,176,246
0131-002,2013,12,22,3,67,82,149,176
0131-002,2013,12,22,4,53,50,103,149
0131-002,2013,12,22,5,50,53,103,103
0131-002,2013,12,22,6,72,63,135,103
0131-002,2013,12,22,7,156,105,261,135
0131-002,2013,12,22,8,240,169,409,261
0131-002,2013,12,22,9,291,255,546,409
0131-002,2013,12,22,10,301,374,675,546
0131-002,2013,12,22,11,396,435,831,675
0131-002,2013,12,22,12,459,466,925,831
0131-002,2013,12,22,13,488,514,1002,925
0131-002,2013,12,22,14,639,501,1140,1002
0131-002,2013,12,22,15,666,540,1206,1140
0131-002,2013,12,22,16,732,570,1302,1206
0131-002,2013,12,22,17,732,545,1277,1302
0131-002,2013,12,22,18,684,588,1272,1277
0131-002,2013,12,22,19,662,436,1098,1272
0131-002,2013,12,22,20,442,343,785,1098
0131-002,2013,12,22,21,370,271,641,785
0131-002,2013,12,22,22,334,260,594,641
0131-002,2013,12,22,23,247,176,423,594
0131-002,2013,12,22,24,163,135,298,423
0131-002,2013,12,23,1,118,86,204,298
0131-002,2013,12,23,2,74,71,145,204
0131-002,2013,12,23,3,49,37,86,145
0131-002,2013,12,23,4,60,47,107,86
0131-002,2013,12,23,5,70,83,153,107
0131-002,2013,12,23,6,207,122,329,153
0131-002,2013,12,23,7,566,300,866,329
0131-002,2013,12,23,8,1427,707,2134,866
0131-002,2013,12,23,9,1445,799,2244,2134
0131-002,2013,12,23,10,925,758,1683,2244
0131-002,2013,12,23,11,886,820,1706,1683
0131-002,2013,12,23,12,917,850,1767,1706
0131-002,2013,12,23,13,763,693,1456,1767
0131-002,2013,12,23,14,882,769,1651,1456
0131-002,2013,12,23,15,958,896,1854,1651
0131-002,2013,12,23,16,946,856,1802,1854
0131-002,2013,12,23,17,919,908,1827,1802
0131-002,2013,12,23,18,894,1046,1940,1827
0131-002,2013,12,23,19,759,956,1715,1940
0131-002,2013,12,23,20,586,726,1312,1715
0131-002,2013,12,23,21,471,593,1064,1312
0131-002,2013,12,23,22,417,475,892,1064
0131-002,2013,12,23,23,242,327,569,892
0131-002,2013,12,23,24,204,209,413,569
0131-002,2013,12,24,1,176,148,324,413
0131-002,2013,12,24,2,87,93,180,324
0131-002,2013,12,24,3,78,87,165,180
0131-002,2013,12,24,4,91,71,162,165
0131-002,2013,12,24,5,94,87,181,162
0131-002,2013,12,24,6,158,141,299,181
0131-002,2013,12,24,7,490,239,729,299
0131-002,2013,12,24,8,1273,609,1882,729
0131-002,2013,12,24,9,1334,831,2165,1882
0131-002,2013,12,24,10,904,747,1651,2165
0131-002,2013,12,24,11,943,806,1749,1651
0131-002,2013,12,24,12,930,835,1765,1749
0131-002,2013,12,24,13,826,755,1581,1765
0131-002,2013,12,24,14,861,780,1641,1581
0131-002,2013,12,24,15,920,894,1814,1641
0131-002,2013,12,24,16,903,876,1779,1814
0131-002,2013,12,24,17,936,903,1839,1779
0131-002,2013,12,24,18,965,1227,2192,1839
0131-002,2013,12,24,19,920,1246,2166,2192
0131-002,2013,12,24,20,760,892,1652,2166
0131-002,2013,12,24,21,530,656,1186,1652
0131-002,2013,12,24,22,385,435,820,1186
0131-002,2013,12,24,23,301,267,568,820
0131-002,2013,12,24,24,178,204,382,568
0131-002,2013,12,25,1,148,167,315,382
0131-002,2013,12,25,2,105,112,217,315
0131-002,2013,12,25,3,93,89,182,217
0131-002,2013,12,25,4,92,81,173,182
0131-002,2013,12,25,5,99,95,194,173
0131-002,2013,12,25,6,130,103,233,194
0131-002,2013,12,25,7,285,170,455,233
0131-002,2013,12,25,8,429,278,707,455
0131-002,2013,12,25,9,441,364,805,707
0131-002,2013,12,25,10,441,416,857,805
0131-002,2013,12,25,11,567,482,1049,857
0131-002,2013,12,25,12,525,496,1021,1049
0131-002,2013,12,25,13,533,480,1013,1021
0131-002,2013,12,25,14,589,577,1166,1013
0131-002,2013,12,25,15,600,558,1158,1166
0131-002,2013,12,25,16,612,577,1189,1158
0131-002,2013,12,25,17,639,571,1210,1189
0131-002,2013,12,25,18,624,638,1262,1210
0131-002,2013,12,25,19,493,542,1035,1262
0131-002,2013,12,25,20,402,370,772,1035
0131-002,2013,12,25,21,384,337,721,772
0131-002,2013,12,25,22,378,294,672,721
0131-002,2013,12,25,23,254,194,448,672
0131-002,2013,12,25,24,170,144,314,448
0131-002,2013,12,26,1,121,100,221,314
0131-002,2013,12,26,2,68,60,128,221
0131-002,2013,12,26,3,53,56,109,128
0131-002,2013,12,26,4,62,61,123,109
0131-002,2013,12,26,5,82,81,163,123
0131-002,2013,12,26,6,149,131,280,163
0131-002,2013,12,26,7,585,244,829,280
0131-002,2013,12,26,8,1437,695,2132,829
0131-002,2013,12,26,9,1299,768,2067,2132
0131-002,2013,12,26,10,840,773,1613,2067
0131-002,2013,12,26,11,945,759,1704,1613
0131-002,2013,12,26,12,846,835,1681,1704
0131-002,2013,12,26,13,717,716,1433,1681
0131-002,2013,12,26,14,821,794,1615,1433
0131-002,2013,12,26,15,903,850,1753,1615
0131-002,2013,12,26,16,850,929,1779,1753
0131-002,2013,12,26,17,832,875,1707,1779
0131-002,2013,12,26,18,750,982,1732,1707
0131-002,2013,12,26,19,748,832,1580,1732
0131-002,2013,12,26,20,504,628,1132,1580
0131-002,2013,12,26,21,436,534,970,1132
0131-002,2013,12,26,22,380,425,805,970
0131-002,2013,12,26,23,245,304,549,805
0131-002,2013,12,26,24,190,191,381,549
0131-002,2013,12,27,1,142,109,251,381
0131-002,2013,12,27,2,99,98,197,251
0131-002,2013,12,27,3,66,78,144,197
0131-002,2013,12,27,4,61,75,136,144
0131-002,2013,12,27,5,77,97,174,136
0131-002,2013,12,27,6,151,125,276,174
0131-002,2013,12,27,7,437,213,650,276
0131-002,2013,12,27,8,1192,623,1815,650
0131-002,2013,12,27,9,1238,757,1995,1815
0131-002,2013,12,27,10,844,698,1542,1995
0131-002,2013,12,27,11,894,775,1669,1542
0131-002,2013,12,27,12,826,804,1630,1669
0131-002,2013,12,27,13,669,652,1321,1630
0131-002,2013,12,27,14,842,739,1581,1321
0131-002,2013,12,27,15,941,860,1801,1581
0131-002,2013,12,27,16,886,835,1721,1801
0131-002,2013,12,27,17,866,896,1762,1721
0131-002,2013,12,27,18,870,1058,1928,1762
0131-002,2013,12,27,19,804,1019,1823,1928
0131-002,2013,12,27,20,649,711,1360,1823
0131-002,2013,12,27,21,461,587,1048,1360
0131-002,2013,12,27,22,397,465,862,1048
0131-002,2013,12,27,23,302,337,639,862
0131-002,2013,12,27,24,258,217,475,639
0131-002,2013,12,28,1,167,164,331,475
0131-002,2013,12,28,2,118,118,236,331
0131-002,2013,12,28,3,75,91,166,236
0131-002,2013,12,28,4,100,85,185,166
0131-002,2013,12,28,5,81,99,180,185
0131-002,2013,12,28,6,129,96,225,180
0131-002,2013,12,28,7,302,204,506,225
0131-002,2013,12,28,8,637,405,1042,506
0131-002,2013,12,28,9,752,566,1318,1042
0131-002,2013,12,28,10,702,609,1311,1318
0131-002,2013,12,28,11,733,679,1412,1311
0131-002,2013,12,28,12,699,737,1436,1412
0131-002,2013,12,28,13,717,636,1353,1436
0131-002,2013,12,28,14,768,661,1429,1353
0131-002,2013,12,28,15,701,698,1399,1429
0131-002,2013,12,28,16,734,705,1439,1399
0131-002,2013,12,28,17,720,682,1402,1439
0131-002,2013,12,28,18,784,798,1582,1402
0131-002,2013,12,28,19,686,610,1296,1582
0131-002,2013,12,28,20,429,412,841,1296
0131-002,2013,12,28,21,319,337,656,841
0131-002,2013,12,28,22,298,274,572,656
0131-002,2013,12,28,23,212,221,433,572
0131-002,2013,12,28,24,151,152,303,433
0131-002,2013,12,29,1,111,127,238,303
0131-002,2013,12,29,2,98,79,177,238
0131-002,2013,12,29,3,61,89,150,177
0131-002,2013,12,29,4,62,55,117,150
0131-002,2013,12,29,5,58,59,117,117
0131-002,2013,12,29,6,77,55,132,117
0131-002,2013,12,29,7,136,97,233,132
0131-002,2013,12,29,8,271,170,441,233
0131-002,2013,12,29,9,308,238,546,441
0131-002,2013,12,29,10,332,332,664,546
0131-002,2013,12,29,11,354,444,798,664
0131-002,2013,12,29,12,392,403,795,798
0131-002,2013,12,29,13,418,473,891,795
0131-002,2013,12,29,14,606,478,1084,891
0131-002,2013,12,29,15,560,472,1032,1084
0131-002,2013,12,29,16,688,505,1193,1032
0131-002,2013,12,29,17,730,521,1251,1193
0131-002,2013,12,29,18,650,534,1184,1251
0131-002,2013,12,29,19,612,397,1009,1184
0131-002,2013,12,29,20,487,317,804,1009
0131-002,2013,12,29,21,338,276,614,804
0131-002,2013,12,29,22,329,278,607,614
0131-002,2013,12,29,23,246,158,404,607
0131-002,2013,12,29,24,172,124,296,404
0131-002,2013,12,30,1,122,68,190,296
0131-002,2013,12,30,2,62,47,109,190
0131-002,2013,12,30,3,69,44,113,109
0131-002,2013,12,30,4,51,36,87,113
0131-002,2013,12,30,5,66,67,133,87
0131-002,2013,12,30,6,183,120,303,133
0131-002,2013,12,30,7,507,248,755,303
0131-002,2013,12,30,8,1446,628,2074,755
0131-002,2013,12,30,9,1313,725,2038,2074
0131-002,2013,12,30,10,818,704,1522,2038
0131-002,2013,12,30,11,947,854,1801,1522
0131-002,2013,12,30,12,863,741,1604,1801
0131-002,2013,12,30,13,753,717,1470,1604
0131-002,2013,12,30,14,870,748,1618,1470
0131-002,2013,12,30,15,915,874,1789,1618
0131-002,2013,12,30,16,960,855,1815,1789
0131-002,2013,12,30,17,864,840,1704,1815
0131-002,2013,12,30,18,807,1023,1830,1704
0131-002,2013,12,30,19,723,873,1596,1830
0131-002,2013,12,30,20,550,609,1159,1596
0131-002,2013,12,30,21,461,506,967,1159
0131-002,2013,12,30,22,399,450,849,967
0131-002,2013,12,30,23,286,299,585,849
0131-002,2013,12,30,24,217,224,441,585
0131-002,2013,12,31,1,163,134,297,441
0131-002,2013,12,31,2,112,131,243,297
0131-002,2013,12,31,3,88,60,148,243
0131-002,2013,12,31,4,93,100,193,148
0131-002,2013,12,31,5,91,92,183,193
0131-002,2013,12,31,6,139,111,250,183
0131-002,2013,12,31,7,410,214,624,250
0131-002,2013,12,31,8,1102,550,1652,624
0131-002,2013,12,31,9,1089,742,1831,1652
0131-002,2013,12,31,10,707,732,1439,1831
0131-002,2013,12,31,11,786,736,1522,1439
0131-002,2013,12,31,12,786,703,1489,1522
0131-002,2013,12,31,13,688,656,1344,1489
0131-002,2013,12,31,14,744,718,1462,1344
0131-002,2013,12,31,15,798,748,1546,1462
0131-002,2013,12,31,16,724,814,1538,1546
0131-002,2013,12,31,17,862,811,1673,1538
0131-002,2013,12,31,18,859,991,1850,1673
0131-002,2013,12,31,19,716,865,1581,1850
0131-002,2013,12,31,20,562,572,1134,1581
0131-002,2013,12,31,21,400,419,819,1134
0131-002,2013,12,31,22,352,377,729,819
0131-002,2013,12,31,23,273,261,534,729
0131-002,2013,12,31,24,189,202,391,534
0131-002,2014,1,1,1,165,134,299,391
0131-002,2014,1,1,2,143,155,298,299
0131-002,2014,1,1,3,103,129,232,298
0131-002,2014,1,1,4,79,82,161,232
0131-002,2014,1,1,5,113,74,187,161
0131-002,2014,1,1,6,118,79,197,187
0131-002,2014,1,1,7,155,104,259,197
0131-002,2014,1,1,8,173,153,326,259
0131-002,2014,1,1,9,244,260,504,326
0131-002,2014,1,1,10,276,332,608,504
0131-002,2014,1,1,11,366,369,735,608
0131-002,2014,1,1,12,493,463,956,735
0131-002,2014,1,1,13,483,451,934,956
0131-002,2014,1,1,14,515,438,953,934
0131-002,2014,1,1,15,576,539,1115,953
0131-002,2014,1,1,16,623,523,1146,1115
0131-002,2014,1,1,17,625,522,1147,1146
0131-002,2014,1,1,18,621,513,1134,1147
0131-002,2014,1,1,19,524,465,989,1134
0131-002,2014,1,1,20,456,368,824,989
0131-002,2014,1,1,21,354,327,681,824
0131-002,2014,1,1,22,334,235,569,681
0131-002,2014,1,1,23,243,157,400,569
0131-002,2014,1,1,24,147,112,259,400
0131-002,2014,1,2,1,124,89,213,259
0131-002,2014,1,2,2,57,64,121,213
0131-002,2014,1,2,3,55,43,98,121
0131-002,2014,1,2,4,62,47,109,98
0131-002,2014,1,2,5,62,54,116,109
0131-002,2014,1,2,6,143,120,263,116
0131-002,2014,1,2,7,542,231,773,263
0131-002,2014,1,2,8,1310,665,1975,773
0131-002,2014,1,2,9,1200,718,1918,1975
0131-002,2014,1,2,10,768,621,1389,1918
0131-002,2014,1,2,11,796,718,1514,1389
0131-002,2014,1,2,12,788,731,1519,1514
0131-002,2014,1,2,13,700,626,1326,1519
0131-002,2014,1,2,14,788,648,1436,1326
0131-002,2014,1,2,15,871,808,1679,1436
0131-002,2014,1,2,16,835,760,1595,1679
0131-002,2014,1,2,17,776,807,1583,1595
0131-002,2014,1,2,18,769,824,1593,1583
0131-002,2014,1,2,19,715,792,1507,1593
0131-002,2014,1,2,20,551,635,1186,1507
0131-002,2014,1,2,21,436,513,949,1186
0131-002,2014,1,2,22,361,379,740,949
0131-002,2014,1,2,23,291,267,558,740
0131-002,2014,1,2,24,176,170,346,558
0131-002,2014,1,3,1,137,119,256,346
0131-002,2014,1,3,2,106,82,188,256
0131-002,2014,1,3,3,72,62,134,188
0131-002,2014,1,3,4,60,71,131,134
0131-002,2014,1,3,5,96,93,189,131
0131-002,2014,1,3,6,190,141,331,189
0131-002,2014,1,3,7,499,241,740,331
0131-002,2014,1,3,8,1372,614,1986,740
0131-002,2014,1,3,9,1225,807,2032,1986
0131-002,2014,1,3,10,851,730,1581,2032
0131-002,2014,1,3,11,896,890,1786,1581
0131-002,2014,1,3,12,825,784,1609,1786
0131-002,2014,1,3,13,779,680,1459,1609
0131-002,2014,1,3,14,852,724,1576,1459
0131-002,2014,1,3,15,948,817,1765,1576
0131-002,2014,1,3,16,921,838,1759,1765
0131-002,2014,1,3,17,849,835,1684,1759
0131-002,2014,1,3,18,867,970,1837,1684
0131-002,2014,1,3,19,846,971,1817,1837
0131-002,2014,1,3,20,590,715,1305,1817
0131-002,2014,1,3,21,472,600,1072,1305
0131-002,2014,1,3,22,393,459,852,1072
0131-002,2014,1,3,23,293,321,614,852
0131-002,2014,1,3,24,176,177,353,614
0131-002,2014,1,4,1,150,142,292,353
0131-002,2014,1,4,2,112,115,227,292
0131-002,2014,1,4,3,73,87,160,227
0131-002,2014,1,4,4,77,79,156,160
0131-002,2014,1,4,5,93,103,196,156
0131-002,2014,1,4,6,148,118,266,196
0131-002,2014,1,4,7,316,240,556,266
0131-002,2014,1,4,8,691,382,1073,556
0131-002,2014,1,4,9,737,579,1316,1073
0131-002,2014,1,4,10,715,645,1360,1316
0131-002,2014,1,4,11,703,670,1373,1360
0131-002,2014,1,4,12,676,685,1361,1373
0131-002,2014,1,4,13,658,612,1270,1361
0131-002,2014,1,4,14,699,640,1339,1270
0131-002,2014,1,4,15,645,661,1306,1339
0131-002,2014,1,4,16,717,676,1393,1306
0131-002,2014,1,4,17,665,677,1342,1393
0131-002,2014,1,4,18,795,774,1569,1342
0131-002,2014,1,4,19,680,563,1243,1569
0131-002,2014,1,4,20,444,403,847,1243
0131-002,2014,1,4,21,353,343,696,847
0131-002,2014,1,4,22,286,307,593,696
0131-002,2014,1,4,23,203,222,425,593
0131-002,2014,1,4,24,146,145,291,425
0131-002,2014,1,5,1,105,113,218,291
0131-002,2014,1,5,2,65,85,150,218
0131-002,2014,1,5,3,55,74,129,150
0131-002,2014,1,5,4,49,56,105,129
0131-002,2014,1,5,5,52,51,103,105
0131-002,2014,1,5,6,70,67,137,103
0131-002,2014,1,5,7,155,112,267,137
0131-002,2014,1,5,8,278,189,467,267
0131-002,2014,1,5,9,315,271,586,467
0131-002,2014,1,5,10,318,337,655,586
0131-002,2014,1,5,11,364,407,771,655
0131-002,2014,1,5,12,466,432,898,771
0131-002,2014,1,5,13,439,472,911,898
0131-002,2014,1,5,14,519,473,992,911
0131-002,2014,1,5,15,578,515,1093,992
0131-002,2014,1,5,16,721,528,1249,1093
0131-002,2014,1,5,17,687,502,1189,1249
0131-002,2014,1,5,18,732,532,1264,1189
0131-002,2014,1,5,19,656,421,1077,1264
0131-002,2014,1,5,20,440,317,757,1077
0131-002,2014,1,5,21,359,302,661,757
0131-002,2014,1,5,22,329,264,593,661
0131-002,2014,1,5,23,247,154,401,593
0131-002,2014,1,5,24,147,108,255,401
0131-002,2014,1,6,1,95,70,165,255
0131-002,2014,1,6,2,64,53,117,165
0131-002,2014,1,6,3,44,32,76,117
0131-002,2014,1,6,4,48,52,100,76
0131-002,2014,1,6,5,76,54,130,100
0131-002,2014,1,6,6,203,119,322,130
0131-002,2014,1,6,7,589,270,859,322
0131-002,2014,1,6,8,1430,660,2090,859
0131-002,2014,1,6,9,1378,778,2156,2090
0131-002,2014,1,6,10,868,747,1615,2156
0131-002,2014,1,6,11,937,801,1738,1615
0131-002,2014,1,6,12,807,750,1557,1738
0131-002,2014,1,6,13,780,662,1442,1557
0131-002,2014,1,6,14,805,749,1554,1442
0131-002,2014,1,6,15,939,840,1779,1554
0131-002,2014,1,6,16,924,768,1692,1779
0131-002,2014,1,6,17,856,839,1695,1692
0131-002,2014,1,6,18,808,954,1762,1695
0131-002,2014,1,6,19,766,865,1631,1762
0131-002,2014,1,6,20,547,641,1188,1631
0131-002,2014,1,6,21,479,628,1107,1188
0131-002,2014,1,6,22,355,451,806,1107
0131-002,2014,1,6,23,238,279,517,806
0131-002,2014,1,6,24,179,152,331,517
0131-002,2014,1,7,1,110,117,227,331
0131-002,2014,1,7,2,89,84,173,227
0131-002,2014,1,7,3,71,83,154,173
0131-002,2014,1,7,4,73,75,148,154
0131-002,2014,1,7,5,83,95,178,148
0131-002,2014,1,7,6,149,117,266,178
0131-002,2014,1,7,7,512,284,796,266
0131-002,2014,1,7,8,1278,608,1886,796
0131-002,2014,1,7,9,1348,854,2202,1886
0131-002,2014,1,7,10,899,802,1701,2202
0131-002,2014,1,7,11,916,803,1719,1701
0131-002,2014,1,7,12,897,824,1721,1719
0131-002,2014,1,7,13,722,709,1431,1721
0131-002,2014,1,7,14,885,796,1681,1431
0131-002,2014,1,7,15,978,877,1855,1681
0131-002,2014,1,7,16,917,878,1795,1855
0131-002,2014,1,7,17,926,876,1802,1795
0131-002,2014,1,7,18,838,931,1769,1802
0131-002,2014,1,7,19,763,920,1683,1769
0131-002,2014,1,7,20,606,631,1237,1683
0131-002,2014,1,7,21,479,607,1086,1237
0131-002,2014,1,7,22,394,471,865,1086
0131-002,2014,1,7,23,285,288,573,865
0131-002,2014,1,7,24,188,182,370,573
0131-002,2014,1,8,1,145,119,264,370
0131-002,2014,1,8,2,98,84,182,264
0131-002,2014,1,8,3,81,70,151,182
0131-002,2014,1,8,4,67,72,139,151
0131-002,2014,1,8,5,70,80,150,139
0131-002,2014,1,8,6,152,128,280,150
0131-002,2014,1,8,7,468,242,710,280
0131-002,2014,1,8,8,1300,669,1969,710
0131-002,2014,1,8,9,1204,864,2068,1969
0131-002,2014,1,8,10,853,729,1582,2068
0131-002,2014,1,8,11,975,791,1766,1582
0131-002,2014,1,8,12,846,741,1587,1766
0131-002,2014,1,8,13,683,713,1396,1587
0131-002,2014,1,8,14,866,758,1624,1396
0131-002,2014,1,8,15,950,831,1781,1624
0131-002,2014,1,8,16,847,830,1677,1781
0131-002,2014,1,8,17,822,806,1628,1677
0131-002,2014,1,8,18,845,909,1754,1628
0131-002,2014,1,8,19,756,850,1606,1754
0131-002,2014,1,8,20,521,654,1175,1606
0131-002,2014,1,8,21,463,590,1053,1175
0131-002,2014,1,8,22,398,392,790,1053
0131-002,2014,1,8,23,262,288,550,790
0131-002,2014,1,8,24,188,174,362,550
0131-002,2014,1,9,1,125,119,244,362
0131-002,2014,1,9,2,95,81,176,244
0131-002,2014,1,9,3,48,56,104,176
0131-002,2014,1,9,4,64,80,144,104
0131-002,2014,1,9,5,87,86,173,144
0131-002,2014,1,9,6,166,105,271,173
0131-002,2014,1,9,7,446,273,719,271
0131-002,2014,1,9,8,1318,608,1926,719
0131-002,2014,1,9,9,1288,781,2069,1926
0131-002,2014,1,9,10,836,742,1578,2069
0131-002,2014,1,9,11,891,758,1649,1578
0131-002,2014,1,9,12,834,743,1577,1649
0131-002,2014,1,9,13,703,710,1413,1577
0131-002,2014,1,9,14,849,776,1625,1413
0131-002,2014,1,9,15,913,814,1727,1625
0131-002,2014,1,9,16,821,790,1611,1727
0131-002,2014,1,9,17,804,811,1615,1611
0131-002,2014,1,9,18,735,907,1642,1615
0131-002,2014,1,9,19,781,837,1618,1642
0131-002,2014,1,9,20,538,661,1199,1618
0131-002,2014,1,9,21,485,594,1079,1199
0131-002,2014,1,9,22,409,442,851,1079
0131-002,2014,1,9,23,273,248,521,851
0131-002,2014,1,9,24,180,181,361,521
0131-002,2014,1,10,1,122,140,262,361
0131-002,2014,1,10,2,89,83,172,262
0131-002,2014,1,10,3,58,81,139,172
0131-002,2014,1,10,4,69,71,140,139
0131-002,2014,1,10,5,82,88,170,140
0131-002,2014,1,10,6,158,106,264,170
0131-002,2014,1,10,7,444,244,688,264
0131-002,2014,1,10,8,1267,584,1851,688
0131-002,2014,1,10,9,1230,758,1988,1851
0131-002,2014,1,10,10,867,678,1545,1988
0131-002,2014,1,10,11,947,800,1747,1545
0131-002,2014,1,10,12,857,809,1666,1747
0131-002,2014,1,10,13,675,715,1390,1666
0131-002,2014,1,10,14,857,762,1619,1390
0131-002,2014,1,10,15,936,900,1836,1619
0131-002,2014,1,10,16,889,856,1745,1836
0131-002,2014,1,10,17,850,863,1713,1745
0131-002,2014,1,10,18,822,1071,1893,1713
0131-002,2014,1,10,19,850,1077,1927,1893
0131-002,2014,1,10,20,666,768,1434,1927
0131-002,2014,1,10,21,510,608,1118,1434
0131-002,2014,1,10,22,392,470,862,1118
0131-002,2014,1,10,23,294,313,607,862
0131-002,2014,1,10,24,196,183,379,607
0131-002,2014,1,11,1,150,146,296,379
0131-002,2014,1,11,2,94,123,217,296
0131-002,2014,1,11,3,87,86,173,217
0131-002,2014,1,11,4,60,75,135,173
0131-002,2014,1,11,5,102,97,199,135
0131-002,2014,1,11,6,161,106,267,199
0131-002,2014,1,11,7,276,192,468,267
0131-002,2014,1,11,8,693,399,1092,468
0131-002,2014,1,11,9,753,561,1314,1092
0131-002,2014,1,11,10,692,630,1322,1314
0131-002,2014,1,11,11,728,703,1431,1322
0131-002,2014,1,11,12,746,722,1468,1431
0131-002,2014,1,11,13,711,713,1424,1468
0131-002,2014,1,11,14,705,670,1375,1424
0131-002,2014,1,11,15,702,743,1445,1375
0131-002,2014,1,11,16,762,678,1440,1445
0131-002,2014,1,11,17,786,702,1488,1440
0131-002,2014,1,11,18,788,812,1600,1488
0131-002,2014,1,11,19,685,662,1347,1600
0131-002,2014,1,11,20,461,416,877,1347
0131-002,2014,1,11,21,333,398,731,877
0131-002,2014,1,11,22,305,306,611,731
0131-002,2014,1,11,23,248,210,458,611
0131-002,2014,1,11,24,158,187,345,458
0131-002,2014,1,12,1,130,113,243,345
0131-002,2014,1,12,2,87,65,152,243
0131-002,2014,1,12,3,63,88,151,152
0131-002,2014,1,12,4,65,52,117,151
0131-002,2014,1,12,5,51,51,102,117
0131-002,2014,1,12,6,77,70,147,102
0131-002,2014,1,12,7,135,90,225,147
0131-002,2014,1,12,8,242,174,416,225
0131-002,2014,1,12,9,284,277,561,416
0131-002,2014,1,12,10,342,332,674,561
0131-002,2014,1,12,11,355,425,780,674
0131-002,2014,1,12,12,410,431,841,780
0131-002,2014,1,12,13,478,444,922,841
0131-002,2014,1,12,14,507,464,971,922
0131-002,2014,1,12,15,552,468,1020,971
0131-002,2014,1,12,16,652,515,1167,1020
0131-002,2014,1,12,17,663,518,1181,1167
0131-002,2014,1,12,18,777,534,1311,1181
0131-002,2014,1,12,19,644,400,1044,1311
0131-002,2014,1,12,20,448,343,791,1044
0131-002,2014,1,12,21,373,295,668,791
0131-002,2014,1,12,22,339,256,595,668
0131-002,2014,1,12,23,243,183,426,595
0131-002,2014,1,12,24,179,134,313,426
0131-002,2014,1,13,1,110,90,200,313
0131-002,2014,1,13,2,71,55,126,200
0131-002,2014,1,13,3,41,45,86,126
0131-002,2014,1,13,4,60,49,109,86
0131-002,2014,1,13,5,68,76,144,109
0131-002,2014,1,13,6,202,133,335,144
0131-002,2014,1,13,7,550,245,795,335
0131-002,2014,1,13,8,1553,671,2224,795
0131-002,2014,1,13,9,1323,757,2080,2224
0131-002,2014,1,13,10,824,722,1546,2080
0131-002,2014,1,13,11,880,738,1618,1546
0131-002,2014,1,13,12,855,799,1654,1618
0131-002,2014,1,13,13,718,649,1367,1654
0131-002,2014,1,13,14,796,732,1528,1367
0131-002,2014,1,13,15,924,846,1770,1528
0131-002,2014,1,13,16,914,796,1710,1770
0131-002,2014,1,13,17,847,837,1684,1710
0131-002,2014,1,13,18,853,852,1705,1684
0131-002,2014,1,13,19,778,895,1673,1705
0131-002,2014,1,13,20,573,660,1233,1673
0131-002,2014,1,13,21,445,610,1055,1233
0131-002,2014,1,13,22,378,421,799,1055
0131-002,2014,1,13,23,241,284,525,799
0131-002,2014,1,13,24,168,163,331,525
0131-002,2014,1,14,1,118,98,216,331
0131-002,2014,1,14,2,84,68,152,216
0131-002,2014,1,14,3,56,67,123,152
0131-002,2014,1,14,4,67,74,141,123
0131-002,2014,1,14,5,86,82,168,141
0131-002,2014,1,14,6,162,110,272,168
0131-002,2014,1,14,7,463,244,707,272
0131-002,2014,1,14,8,1296,617,1913,707
0131-002,2014,1,14,9,1274,829,2103,1913
0131-002,2014,1,14,10,894,715,1609,2103
0131-002,2014,1,14,11,883,795,1678,1609
0131-002,2014,1,14,12,837,754,1591,1678
0131-002,2014,1,14,13,767,697,1464,1591
0131-002,2014,1,14,14,836,773,1609,1464
0131-002,2014,1,14,15,916,819,1735,1609
0131-002,2014,1,14,16,904,811,1715,1735
0131-002,2014,1,14,17,822,853,1675,1715
0131-002,2014,1,14,18,799,931,1730,1675
0131-002,2014,1,14,19,775,868,1643,1730
0131-002,2014,1,14,20,584,694,1278,1643
0131-002,2014,1,14,21,462,589,1051,1278
0131-002,2014,1,14,22,407,401,808,1051
0131-002,2014,1,14,23,247,266,513,808
0131-002,2014,1,14,24,162,189,351,513
0131-002,2014,1,15,1,141,113,254,351
0131-002,2014,1,15,2,77,74,151,254
0131-002,2014,1,15,3,71,61,132,151
0131-002,2014,1,15,4,65,79,144,132
0131-002,2014,1,15,5,87,87,174,144
0131-002,2014,1,15,6,174,137,311,174
0131-002,2014,1,15,7,466,226,692,311
0131-002,2014,1,15,8,1314,639,1953,692
0131-002,2014,1,15,9,1263,792,2055,1953
0131-002,2014,1,15,10,910,740,1650,2055
0131-002,2014,1,15,11,917,803,1720,1650
0131-002,2014,1,15,12,852,767,1619,1720
0131-002,2014,1,15,13,723,679,1402,1619
0131-002,2014,1,15,14,866,744,1610,1402
0131-002,2014,1,15,15,923,814,1737,1610
0131-002,2014,1,15,16,919,826,1745,1737
0131-002,2014,1,15,17,843,826,1669,1745
0131-002,2014,1,15,18,846,1018,1864,1669
0131-002,2014,1,15,19,802,945,1747,1864
0131-002,2014,1,15,20,564,661,1225,1747
0131-002,2014,1,15,21,479,565,1044,1225
0131-002,2014,1,15,22,430,451,881,1044
0131-002,2014,1,15,23,253,284,537,881
0131-002,2014,1,15,24,191,185,376,537
0131-002,2014,1,16,1,141,101,242,376
0131-002,2014,1,16,2,95,86,181,242
0131-002,2014,1,16,3,60,78,138,181
0131-002,2014,1,16,4,60,87,147,138
0131-002,2014,1,16,5,93,92,185,147
0131-002,2014,1,16,6,155,118,273,185
0131-002,2014,1,16,7,483,259,742,273
0131-002,2014,1,16,8,1293,613,1906,742
0131-002,2014,1,16,9,1297,784,2081,1906
0131-002,2014,1,16,10,921,806,1727,2081
0131-002,2014,1,16,11,948,851,1799,1727
0131-002,2014,1,16,12,915,773,1688,1799
0131-002,2014,1,16,13,715,723,1438,1688
0131-002,2014,1,16,14,827,791,1618,1438
0131-002,2014,1,16,15,969,865,1834,1618
0131-002,2014,1,16,16,978,846,1824,1834
0131-002,2014,1,16,17,869,888,1757,1824
0131-002,2014,1,16,18,826,964,1790,1757
0131-002,2014,1,16,19,756,885,1641,1790
0131-002,2014,1,16,20,554,737,1291,1641
0131-002,2014,1,16,21,481,625,1106,1291
0131-002,2014,1,16,22,416,460,876,1106
0131-002,2014,1,16,23,262,283,545,876
0131-002,2014,1,16,24,201,189,390,545
0131-002,2014,1,17,1,145,139,284,390
0131-002,2014,1,17,2,92,88,180,284
0131-002,2014,1,17,3,57,68,125,180
0131-002,2014,1,17,4,78,64,142,125
0131-002,2014,1,17,5,80,100,180,142
0131-002,2014,1,17,6,160,130,290,180
0131-002,2014,1,17,7,437,250,687,290
0131-002,2014,1,17,8,1337,611,1948,687
0131-002,2014,1,17,9,1267,780,2047,1948
0131-002,2014,1,17,10,877,741,1618,2047
0131-002,2014,1,17,11,918,829,1747,1618
0131-002,2014,1,17,12,904,792,1696,1747
0131-002,2014,1,17,13,746,695,1441,1696
0131-002,2014,1,17,14,889,783,1672,1441
0131-002,2014,1,17,15,925,871,1796,1672
0131-002,2014,1,17,16,869,833,1702,1796
0131-002,2014,1,17,17,883,895,1778,1702
0131-002,2014,1,17,18,892,1003,1895,1778
0131-002,2014,1,17,19,896,1019,1915,1895
0131-002,2014,1,17,20,747,765,1512,1915
0131-002,2014,1,17,21,515,613,1128,1512
0131-002,2014,1,17,22,436,451,887,1128
0131-002,2014,1,17,23,269,300,569,887
0131-002,2014,1,17,24,199,203,402,569
0131-002,2014,1,18,1,142,146,288,402
0131-002,2014,1,18,2,104,120,224,288
0131-002,2014,1,18,3,94,77,171,224
0131-002,2014,1,18,4,90,80,170,171
0131-002,2014,1,18,5,79,114,193,170
0131-002,2014,1,18,6,181,122,303,193
0131-002,2014,1,18,7,317,211,528,303
0131-002,2014,1,18,8,720,445,1165,528
0131-002,2014,1,18,9,747,585,1332,1165
0131-002,2014,1,18,10,708,679,1387,1332
0131-002,2014,1,18,11,725,717,1442,1387
0131-002,2014,1,18,12,756,661,1417,1442
0131-002,2014,1,18,13,710,663,1373,1417
0131-002,2014,1,18,14,721,686,1407,1373
0131-002,2014,1,18,15,739,738,1477,1407
0131-002,2014,1,18,16,723,717,1440,1477
0131-002,2014,1,18,17,728,678,1406,1440
0131-002,2014,1,18,18,836,733,1569,1406
0131-002,2014,1,18,19,775,646,1421,1569
0131-002,2014,1,18,20,500,436,936,1421
0131-002,2014,1,18,21,372,366,738,936
0131-002,2014,1,18,22,327,286,613,738
0131-002,2014,1,18,23,242,231,473,613
0131-002,2014,1,18,24,176,160,336,473
0131-002,2014,1,19,1,117,145,262,336
0131-002,2014,1,19,2,79,77,156,262
0131-002,2014,1,19,3,59,63,122,156
0131-002,2014,1,19,4,37,55,92,122
0131-002,2014,1,19,5,57,59,116,92
0131-002,2014,1,19,6,65,91,156,116
0131-002,2014,1,19,7,140,98,238,156
0131-002,2014,1,19,8,304,193,497,238
0131-002,2014,1,19,9,313,291,604,497
0131-002,2014,1,19,10,336,377,713,604
0131-002,2014,1,19,11,422,451,873,713
0131-002,2014,1,19,12,482,432,914,873
0131-002,2014,1,19,13,495,466,961,914
0131-002,2014,1,19,14,570,496,1066,961
0131-002,2014,1,19,15,632,518,1150,1066
0131-002,2014,1,19,16,641,592,1233,1150
0131-002,2014,1,19,17,667,560,1227,1233
0131-002,2014,1,19,18,725,564,1289,1227
0131-002,2014,1,19,19,656,489,1145,1289
0131-002,2014,1,19,20,495,391,886,1145
0131-002,2014,1,19,21,401,332,733,886
0131-002,2014,1,19,22,370,258,628,733
0131-002,2014,1,19,23,275,168,443,628
0131-002,2014,1,19,24,182,142,324,443
0131-002,2014,1,20,1,137,76,213,324
0131-002,2014,1,20,2,83,51,134,213
0131-002,2014,1,20,3,54,58,112,134
0131-002,2014,1,20,4,58,50,108,112
0131-002,2014,1,20,5,67,79,146,108
0131-002,2014,1,20,6,126,95,221,146
0131-002,2014,1,20,7,481,219,700,221
0131-002,2014,1,20,8,1142,586,1728,700
0131-002,2014,1,20,9,1169,741,1910,1728
0131-002,2014,1,20,10,787,715,1502,1910
0131-002,2014,1,20,11,792,706,1498,1502
0131-002,2014,1,20,12,777,700,1477,1498
0131-002,2014,1,20,13,652,665,1317,1477
0131-002,2014,1,20,14,762,667,1429,1317
0131-002,2014,1,20,15,904,854,1758,1429
0131-002,2014,1,20,16,874,751,1625,1758
0131-002,2014,1,20,17,787,820,1607,1625
0131-002,2014,1,20,18,725,897,1622,1607
0131-002,2014,1,20,19,673,942,1615,1622
0131-002,2014,1,20,20,515,639,1154,1615
0131-002,2014,1,20,21,350,564,914,1154
0131-002,2014,1,20,22,307,366,673,914
0131-002,2014,1,20,23,189,228,417,673
0131-002,2014,1,20,24,131,127,258,417
0131-002,2014,1,21,1,82,87,169,258
0131-002,2014,1,21,2,72,72,144,169
0131-002,2014,1,21,3,45,54,99,144
0131-002,2014,1,21,4,38,55,93,99
0131-002,2014,1,21,5,61,86,147,93
0131-002,2014,1,21,6,117,89,206,147
0131-002,2014,1,21,7,325,204,529,206
0131-002,2014,1,21,8,958,620,1578,529
0131-002,2014,1,21,9,1039,783,1822,1578
0131-002,2014,1,21,10,793,773,1566,1822
0131-002,2014,1,21,11,872,832,1704,1566
0131-002,2014,1,21,12,831,806,1637,1704
0131-002,2014,1,21,13,698,633,1331,1637
0131-002,2014,1,21,14,811,705,1516,1331
0131-002,2014,1,21,15,940,834,1774,1516
0131-002,2014,1,21,16,863,865,1728,1774
0131-002,2014,1,21,17,810,804,1614,1728
0131-002,2014,1,21,18,778,893,1671,1614
0131-002,2014,1,21,19,669,910,1579,1671
0131-002,2014,1,21,20,546,647,1193,1579
0131-002,2014,1,21,21,458,619,1077,1193
0131-002,2014,1,21,22,378,403,781,1077
0131-002,2014,1,21,23,257,259,516,781
0131-002,2014,1,21,24,179,165,344,516
0131-002,2014,1,22,1,105,113,218,344
0131-002,2014,1,22,2,85,92,177,218
0131-002,2014,1,22,3,62,68,130,177
0131-002,2014,1,22,4,77,56,133,130
0131-002,2014,1,22,5,82,92,174,133
0131-002,2014,1,22,6,142,115,257,174
0131-002,2014,1,22,7,445,251,696,257
0131-002,2014,1,22,8,1267,607,1874,696
0131-002,2014,1,22,9,1271,822,2093,1874
0131-002,2014,1,22,10,869,770,1639,2093
0131-002,2014,1,22,11,933,749,1682,1639
0131-002,2014,1,22,12,853,762,1615,1682
0131-002,2014,1,22,13,710,656,1366,1615
0131-002,2014,1,22,14,810,785,1595,1366
0131-002,2014,1,22,15,948,820,1768,1595
0131-002,2014,1,22,16,896,816,1712,1768
0131-002,2014,1,22,17,837,853,1690,1712
0131-002,2014,1,22,18,838,969,1807,1690
0131-002,2014,1,22,19,808,979,1787,1807
0131-002,2014,1,22,20,624,708,1332,1787
0131-002,2014,1,22,21,462,611,1073,1332
0131-002,2014,1,22,22,379,457,836,1073
0131-002,2014,1,22,23,298,276,574,836
0131-002,2014,1,22,24,200,183,383,574
0131-002,2014,1,23,1,115,128,243,383
0131-002,2014,1,23,2,93,90,183,243
0131-002,2014,1,23,3,77,70,147,183
0131-002,2014,1,23,4,64,82,146,147
0131-002,2014,1,23,5,88,102,190,146
0131-002,2014,1,23,6,139,138,277,190
0131-002,2014,1,23,7,505,264,769,277
0131-002,2014,1,23,8,1283,634,1917,769
0131-002,2014,1,23,9,1298,807,2105,1917
0131-002,2014,1,23,10,923,764,1687,2105
0131-002,2014,1,23,11,902,822,1724,1687
0131-002,2014,1,23,12,886,789,1675,1724
0131-002,2014,1,23,13,675,751,1426,1675
0131-002,2014,1,23,14,858,769,1627,1426
0131-002,2014,1,23,15,982,854,1836,1627
0131-002,2014,1,23,16,953,914,1867,1836
0131-002,2014,1,23,17,895,827,1722,1867
0131-002,2014,1,23,18,823,1018,1841,1722
0131-002,2014,1,23,19,758,921,1679,1841
0131-002,2014,1,23,20,611,756,1367,1679
0131-002,2014,1,23,21,476,636,1112,1367
0131-002,2014,1,23,22,422,486,908,1112
0131-002,2014,1,23,23,272,282,554,908
0131-002,2014,1,23,24,213,178,391,554
0131-002,2014,1,24,1,130,127,257,391
0131-002,2014,1,24,2,100,99,199,257
0131-002,2014,1,24,3,81,70,151,199
0131-002,2014,1,24,4,67,79,146,151
0131-002,2014,1,24,5,86,96,182,146
0131-002,2014,1,24,6,150,131,281,182
0131-002,2014,1,24,7,490,264,754,281
0131-002,2014,1,24,8,1291,640,1931,754
0131-002,2014,1,24,9,1268,847,2115,1931
0131-002,2014,1,24,10,908,804,1712,2115
0131-002,2014,1,24,11,946,875,1821,1712
0131-002,2014,1,24,12,832,820,1652,1821
0131-002,2014,1,24,13,772,757,1529,1652
0131-002,2014,1,24,14,851,740,1591,1529
0131-002,2014,1,24,15,965,882,1847,1591
0131-002,2014,1,24,16,926,949,1875,1847
0131-002,2014,1,24,17,927,846,1773,1875
0131-002,2014,1,24,18,957,1020,1977,1773
0131-002,2014,1,24,19,894,1058,1952,1977
0131-002,2014,1,24,20,719,831,1550,1952
0131-002,2014,1,24,21,510,653,1163,1550
0131-002,2014,1,24,22,428,491,919,1163
0131-002,2014,1,24,23,296,317,613,919
0131-002,2014,1,24,24,231,193,424,613
0131-002,2014,1,25,1,127,147,274,424
0131-002,2014,1,25,2,103,100,203,274
0131-002,2014,1,25,3,97,83,180,203
0131-002,2014,1,25,4,87,76,163,180
0131-002,2014,1,25,5,105,109,214,163
0131-002,2014,1,25,6,156,123,279,214
0131-002,2014,1,25,7,301,206,507,279
0131-002,2014,1,25,8,689,398,1087,507
0131-002,2014,1,25,9,748,634,1382,1087
0131-002,2014,1,25,10,744,709,1453,1382
0131-002,2014,1,25,11,699,722,1421,1453
0131-002,2014,1,25,12,779,705,1484,1421
0131-002,2014,1,25,13,672,662,1334,1484
0131-002,2014,1,25,14,668,696,1364,1334
0131-002,2014,1,25,15,734,747,1481,1364
0131-002,2014,1,25,16,703,679,1382,1481
0131-002,2014,1,25,17,683,648,1331,1382
0131-002,2014,1,25,18,768,717,1485,1331
0131-002,2014,1,25,19,587,611,1198,1485
0131-002,2014,1,25,20,490,402,892,1198
0131-002,2014,1,25,21,350,338,688,892
0131-002,2014,1,25,22,335,308,643,688
0131-002,2014,1,25,23,204,211,415,643
0131-002,2014,1,25,24,144,164,308,415
0131-002,2014,1,26,1,105,110,215,308
0131-002,2014,1,26,2,90,83,173,215
0131-002,2014,1,26,3,71,65,136,173
0131-002,2014,1,26,4,66,56,122,136
0131-002,2014,1,26,5,49,56,105,122
0131-002,2014,1,26,6,85,92,177,105
0131-002,2014,1,26,7,156,111,267,177
0131-002,2014,1,26,8,296,216,512,267
0131-002,2014,1,26,9,378,327,705,512
0131-002,2014,1,26,10,361,372,733,705
0131-002,2014,1,26,11,417,441,858,733
0131-002,2014,1,26,12,409,393,802,858
0131-002,2014,1,26,13,500,513,1013,802
0131-002,2014,1,26,14,542,509,1051,1013
0131-002,2014,1,26,15,573,482,1055,1051
0131-002,2014,1,26,16,591,526,1117,1055
0131-002,2014,1,26,17,647,523,1170,1117
0131-002,2014,1,26,18,650,579,1229,1170
0131-002,2014,1,26,19,551,471,1022,1229
0131-002,2014,1,26,20,394,347,741,1022
0131-002,2014,1,26,21,359,288,647,741
0131-002,2014,1,26,22,348,272,620,647
0131-002,2014,1,26,23,250,184,434,620
0131-002,2014,1,26,24,155,132,287,434
0131-002,2014,1,27,1,135,90,225,287
0131-002,2014,1,27,2,64,52,116,225
0131-002,2014,1,27,3,53,49,102,116
0131-002,2014,1,27,4,52,48,100,102
0131-002,2014,1,27,5,83,77,160,100
0131-002,2014,1,27,6,169,117,286,160
0131-002,2014,1,27,7,539,264,803,286
0131-002,2014,1,27,8,1481,643,2124,803
0131-002,2014,1,27,9,1323,766,2089,2124
0131-002,2014,1,27,10,861,721,1582,2089
0131-002,2014,1,27,11,898,830,1728,1582
0131-002,2014,1,27,12,920,796,1716,1728
0131-002,2014,1,27,13,785,772,1557,1716
0131-002,2014,1,27,14,874,803,1677,1557
0131-002,2014,1,27,15,962,832,1794,1677
0131-002,2014,1,27,16,961,865,1826,1794
0131-002,2014,1,27,17,872,866,1738,1826
0131-002,2014,1,27,18,843,964,1807,1738
0131-002,2014,1,27,19,829,983,1812,1807
0131-002,2014,1,27,20,635,708,1343,1812
0131-002,2014,1,27,21,515,684,1199,1343
0131-002,2014,1,27,22,444,469,913,1199
0131-002,2014,1,27,23,267,289,556,913
0131-002,2014,1,27,24,199,201,400,556
0131-002,2014,1,28,1,135,141,276,400
0131-002,2014,1,28,2,89,71,160,276
0131-002,2014,1,28,3,69,85,154,160
0131-002,2014,1,28,4,78,65,143,154
0131-002,2014,1,28,5,90,98,188,143
0131-002,2014,1,28,6,153,119,272,188
0131-002,2014,1,28,7,448,256,704,272
0131-002,2014,1,28,8,1240,645,1885,704
0131-002,2014,1,28,9,1233,938,2171,1885
0131-002,2014,1,28,10,951,831,1782,2171
0131-002,2014,1,28,11,1009,869,1878,1782
0131-002,2014,1,28,12,978,859,1837,1878
0131-002,2014,1,28,13,809,746,1555,1837
0131-002,2014,1,28,14,891,874,1765,1555
0131-002,2014,1,28,15,1039,917,1956,1765
0131-002,2014,1,28,16,1041,930,1971,1956
0131-002,2014,1,28,17,947,888,1835,1971
0131-002,2014,1,28,18,896,1044,1940,1835
0131-002,2014,1,28,19,797,1072,1869,1940
0131-002,2014,1,28,20,636,834,1470,1869
0131-002,2014,1,28,21,536,655,1191,1470
0131-002,2014,1,28,22,434,476,910,1191
0131-002,2014,1,28,23,309,339,648,910
0131-002,2014,1,28,24,180,207,387,648
0131-002,2014,1,29,1,147,145,292,387
0131-002,2014,1,29,2,103,92,195,292
0131-002,2014,1,29,3,61,72,133,195
0131-002,2014,1,29,4,83,76,159,133
0131-002,2014,1,29,5,72,93,165,159
0131-002,2014,1,29,6,133,115,248,165
0131-002,2014,1,29,7,379,201,580,248
0131-002,2014,1,29,8,1195,562,1757,580
0131-002,2014,1,29,9,1028,737,1765,1757
0131-002,2014,1,29,10,771,768,1539,1765
0131-002,2014,1,29,11,808,830,1638,1539
0131-002,2014,1,29,12,802,815,1617,1638
0131-002,2014,1,29,13,682,841,1523,1617
0131-002,2014,1,29,14,689,1036,1725,1523
0131-002,2014,1,29,15,770,1043,1813,1725
0131-002,2014,1,29,16,808,1130,1938,1813
0131-002,2014,1,29,17,831,1236,2067,1938
0131-002,2014,1,29,18,825,1411,2236,2067
0131-002,2014,1,29,19,762,921,1683,2236
0131-002,2014,1,29,20,553,763,1316,1683
0131-002,2014,1,29,21,498,1048,1546,1316
0131-002,2014,1,29,22,347,1068,1415,1546
0131-002,2014,1,29,23,249,890,1139,1415
0131-002,2014,1,29,24,172,506,678,1139
0131-002,2014,1,30,1,129,354,483,678
0131-002,2014,1,30,2,82,356,438,483
0131-002,2014,1,30,3,62,357,419,438
0131-002,2014,1,30,4,52,348,400,419
0131-002,2014,1,30,5,59,508,567,400
0131-002,2014,1,30,6,100,1151,1251,567
0131-002,2014,1,30,7,116,1105,1221,1251
0131-002,2014,1,30,8,203,879,1082,1221
0131-002,2014,1,30,9,252,800,1052,1082
0131-002,2014,1,30,10,360,750,1110,1052
0131-002,2014,1,30,11,471,758,1229,1110
0131-002,2014,1,30,12,637,659,1296,1229
0131-002,2014,1,30,13,539,627,1166,1296
0131-002,2014,1,30,14,553,572,1125,1166
0131-002,2014,1,30,15,510,514,1024,1125
0131-002,2014,1,30,16,457,439,896,1024
0131-002,2014,1,30,17,411,406,817,896
0131-002,2014,1,30,18,339,365,704,817
0131-002,2014,1,30,19,291,290,581,704
0131-002,2014,1,30,20,206,252,458,581
0131-002,2014,1,30,21,186,222,408,458
0131-002,2014,1,30,22,159,166,325,408
0131-002,2014,1,30,23,121,111,232,325
0131-002,2014,1,30,24,102,81,183,232
0131-002,2014,1,31,1,60,48,108,183
0131-002,2014,1,31,2,43,47,90,108
0131-002,2014,1,31,3,28,30,58,90
0131-002,2014,1,31,4,26,34,60,58
0131-002,2014,1,31,5,22,26,48,60
0131-002,2014,1,31,6,39,60,99,48
0131-002,2014,1,31,7,129,140,269,99
0131-002,2014,1,31,8,314,266,580,269
0131-002,2014,1,31,9,251,305,556,580
0131-002,2014,1,31,10,226,356,582,556
0131-002,2014,1,31,11,580,584,1164,582
0131-002,2014,1,31,12,858,746,1604,1164
0131-002,2014,1,31,13,974,851,1825,1604
0131-002,2014,1,31,14,1144,880,2024,1825
0131-002,2014,1,31,15,1175,987,2162,2024
0131-002,2014,1,31,16,1247,1000,2247,2162
0131-002,2014,1,31,17,1133,1132,2265,2247
0131-002,2014,1,31,18,1060,994,2054,2265
0131-002,2014,1,31,19,940,878,1818,2054
0131-002,2014,1,31,20,768,486,1254,1818
0131-002,2014,1,31,21,593,340,933,1254
0131-002,2014,1,31,22,444,301,745,933
0131-002,2014,1,31,23,374,186,560,745
0131-002,2014,1,31,24,272,138,410,560
0131-002,2014,2,1,1,227,106,333,410
0131-002,2014,2,1,2,155,71,226,333
0131-002,2014,2,1,3,73,42,115,226
0131-002,2014,2,1,4,41,34,75,115
0131-002,2014,2,1,5,48,37,85,75
0131-002,2014,2,1,6,54,56,110,85
0131-002,2014,2,1,7,70,61,131,110
0131-002,2014,2,1,8,131,92,223,131
0131-002,2014,2,1,9,151,151,302,223
0131-002,2014,2,1,10,235,219,454,302
0131-002,2014,2,1,11,442,376,818,454
0131-002,2014,2,1,12,691,485,1176,818
0131-002,2014,2,1,13,797,509,1306,1176
0131-002,2014,2,1,14,856,505,1361,1306
0131-002,2014,2,1,15,934,534,1468,1361
0131-002,2014,2,1,16,1009,598,1607,1468
0131-002,2014,2,1,17,960,537,1497,1607
0131-002,2014,2,1,18,1031,521,1552,1497
0131-002,2014,2,1,19,1057,405,1462,1552
0131-002,2014,2,1,20,962,350,1312,1462
0131-002,2014,2,1,21,822,262,1084,1312
0131-002,2014,2,1,22,862,268,1130,1084
0131-002,2014,2,1,23,711,188,899,1130
0131-002,2014,2,1,24,491,132,623,899
0131-002,2014,2,2,1,439,90,529,623
0131-002,2014,2,2,2,333,71,404,529
0131-002,2014,2,2,3,213,56,269,404
0131-002,2014,2,2,4,70,35,105,269
0131-002,2014,2,2,5,52,47,99,105
0131-002,2014,2,2,6,60,62,122,99
0131-002,2014,2,2,7,87,54,141,122
0131-002,2014,2,2,8,166,117,283,141
0131-002,2014,2,2,9,208,220,428,283
0131-002,2014,2,2,10,274,301,575,428
0131-002,2014,2,2,11,426,365,791,575
0131-002,2014,2,2,12,523,384,907,791
0131-002,2014,2,2,13,656,413,1069,907
0131-002,2014,2,2,14,800,499,1299,1069
0131-002,2014,2,2,15,816,486,1302,1299
0131-002,2014,2,2,16,814,550,1364,1302
0131-002,2014,2,2,17,809,583,1392,1364
0131-002,2014,2,2,18,714,453,1167,1392
0131-002,2014,2,2,19,576,358,934,1167
0131-002,2014,2,2,20,457,309,766,934
0131-002,2014,2,2,21,337,318,655,766
0131-002,2014,2,2,22,299,271,570,655
0131-002,2014,2,2,23,258,167,425,570
0131-002,2014,2,2,24,205,136,341,425
0131-002,2014,2,3,1,142,80,222,341
0131-002,2014,2,3,2,86,63,149,222
0131-002,2014,2,3,3,67,61,128,149
0131-002,2014,2,3,4,59,47,106,128
0131-002,2014,2,3,5,80,66,146,106
0131-002,2014,2,3,6,168,125,293,146
0131-002,2014,2,3,7,482,246,728,293
0131-002,2014,2,3,8,1319,712,2031,728
0131-002,2014,2,3,9,1117,796,1913,2031
0131-002,2014,2,3,10,721,727,1448,1913
0131-002,2014,2,3,11,736,809,1545,1448
0131-002,2014,2,3,12,739,720,1459,1545
0131-002,2014,2,3,13,596,685,1281,1459
0131-002,2014,2,3,14,713,800,1513,1281
0131-002,2014,2,3,15,868,876,1744,1513
0131-002,2014,2,3,16,831,868,1699,1744
0131-002,2014,2,3,17,751,762,1513,1699
0131-002,2014,2,3,18,821,918,1739,1513
0131-002,2014,2,3,19,709,911,1620,1739
0131-002,2014,2,3,20,552,690,1242,1620
0131-002,2014,2,3,21,458,599,1057,1242
0131-002,2014,2,3,22,353,439,792,1057
0131-002,2014,2,3,23,214,287,501,792
0131-002,2014,2,3,24,206,182,388,501
0131-002,2014,2,4,1,109,124,233,388
0131-002,2014,2,4,2,93,88,181,233
0131-002,2014,2,4,3,63,62,125,181
0131-002,2014,2,4,4,69,61,130,125
0131-002,2014,2,4,5,69,103,172,130
0131-002,2014,2,4,6,143,136,279,172
0131-002,2014,2,4,7,486,261,747,279
0131-002,2014,2,4,8,1354,725,2079,747
0131-002,2014,2,4,9,1285,890,2175,2079
0131-002,2014,2,4,10,862,839,1701,2175
0131-002,2014,2,4,11,880,933,1813,1701
0131-002,2014,2,4,12,828,862,1690,1813
0131-002,2014,2,4,13,646,724,1370,1690
0131-002,2014,2,4,14,843,814,1657,1370
0131-002,2014,2,4,15,889,917,1806,1657
0131-002,2014,2,4,16,872,915,1787,1806
0131-002,2014,2,4,17,822,941,1763,1787
0131-002,2014,2,4,18,699,1051,1750,1763
0131-002,2014,2,4,19,782,999,1781,1750
0131-002,2014,2,4,20,615,773,1388,1781
0131-002,2014,2,4,21,476,655,1131,1388
0131-002,2014,2,4,22,402,493,895,1131
0131-002,2014,2,4,23,255,302,557,895
0131-002,2014,2,4,24,169,166,335,557
0131-002,2014,2,5,1,144,133,277,335
0131-002,2014,2,5,2,73,91,164,277
0131-002,2014,2,5,3,66,82,148,164
0131-002,2014,2,5,4,70,85,155,148
0131-002,2014,2,5,5,82,82,164,155
0131-002,2014,2,5,6,160,133,293,164
0131-002,2014,2,5,7,475,263,738,293
0131-002,2014,2,5,8,1310,698,2008,738
0131-002,2014,2,5,9,1242,888,2130,2008
0131-002,2014,2,5,10,901,839,1740,2130
0131-002,2014,2,5,11,867,896,1763,1740
0131-002,2014,2,5,12,874,816,1690,1763
0131-002,2014,2,5,13,665,790,1455,1690
0131-002,2014,2,5,14,837,804,1641,1455
0131-002,2014,2,5,15,912,967,1879,1641
0131-002,2014,2,5,16,873,913,1786,1879
0131-002,2014,2,5,17,843,923,1766,1786
0131-002,2014,2,5,18,799,1182,1981,1766
0131-002,2014,2,5,19,816,1040,1856,1981
0131-002,2014,2,5,20,579,782,1361,1856
0131-002,2014,2,5,21,489,645,1134,1361
0131-002,2014,2,5,22,426,485,911,1134
0131-002,2014,2,5,23,254,328,582,911
0131-002,2014,2,5,24,208,232,440,582
0131-002,2014,2,6,1,124,151,275,440
0131-002,2014,2,6,2,99,102,201,275
0131-002,2014,2,6,3,68,76,144,201
0131-002,2014,2,6,4,70,84,154,144
0131-002,2014,2,6,5,73,90,163,154
0131-002,2014,2,6,6,148,141,289,163
0131-002,2014,2,6,7,506,307,813,289
0131-002,2014,2,6,8,1265,697,1962,813
0131-002,2014,2,6,9,1302,945,2247,1962
0131-002,2014,2,6,10,838,855,1693,2247
0131-002,2014,2,6,11,941,909,1850,1693
0131-002,2014,2,6,12,870,832,1702,1850
0131-002,2014,2,6,13,675,797,1472,1702
0131-002,2014,2,6,14,812,870,1682,1472
0131-002,2014,2,6,15,925,933,1858,1682
0131-002,2014,2,6,16,939,966,1905,1858
0131-002,2014,2,6,17,862,1005,1867,1905
0131-002,2014,2,6,18,808,1039,1847,1867
0131-002,2014,2,6,19,746,1011,1757,1847
0131-002,2014,2,6,20,607,757,1364,1757
0131-002,2014,2,6,21,494,713,1207,1364
0131-002,2014,2,6,22,428,523,951,1207
0131-002,2014,2,6,23,282,290,572,951
0131-002,2014,2,6,24,217,219,436,572
0131-002,2014,2,7,1,145,168,313,436
0131-002,2014,2,7,2,92,85,177,313
0131-002,2014,2,7,3,70,82,152,177
0131-002,2014,2,7,4,84,71,155,152
0131-002,2014,2,7,5,86,93,179,155
0131-002,2014,2,7,6,133,149,282,179
0131-002,2014,2,7,7,505,262,767,282
0131-002,2014,2,7,8,1274,737,2011,767
0131-002,2014,2,7,9,1278,930,2208,2011
0131-002,2014,2,7,10,896,871,1767,2208
0131-002,2014,2,7,11,952,954,1906,1767
0131-002,2014,2,7,12,826,934,1760,1906
0131-002,2014,2,7,13,740,794,1534,1760
0131-002,2014,2,7,14,851,837,1688,1534
0131-002,2014,2,7,15,992,1011,2003,1688
0131-002,2014,2,7,16,924,1032,1956,2003
0131-002,2014,2,7,17,854,995,1849,1956
0131-002,2014,2,7,18,865,1178,2043,1849
0131-002,2014,2,7,19,902,1232,2134,2043
0131-002,2014,2,7,20,685,949,1634,2134
0131-002,2014,2,7,21,487,688,1175,1634
0131-002,2014,2,7,22,387,533,920,1175
0131-002,2014,2,7,23,265,347,612,920
0131-002,2014,2,7,24,203,214,417,612
0131-002,2014,2,8,1,170,178,348,417
0131-002,2014,2,8,2,122,120,242,348
0131-002,2014,2,8,3,81,98,179,242
0131-002,2014,2,8,4,81,103,184,179
0131-002,2014,2,8,5,68,115,183,184
0131-002,2014,2,8,6,143,120,263,183
0131-002,2014,2,8,7,298,242,540,263
0131-002,2014,2,8,8,659,438,1097,540
0131-002,2014,2,8,9,728,698,1426,1097
0131-002,2014,2,8,10,653,710,1363,1426
0131-002,2014,2,8,11,658,737,1395,1363
0131-002,2014,2,8,12,742,726,1468,1395
0131-002,2014,2,8,13,669,735,1404,1468
0131-002,2014,2,8,14,702,737,1439,1404
0131-002,2014,2,8,15,674,764,1438,1439
0131-002,2014,2,8,16,672,737,1409,1438
0131-002,2014,2,8,17,682,764,1446,1409
0131-002,2014,2,8,18,722,876,1598,1446
0131-002,2014,2,8,19,593,752,1345,1598
0131-002,2014,2,8,20,427,495,922,1345
0131-002,2014,2,8,21,329,421,750,922
0131-002,2014,2,8,22,287,317,604,750
0131-002,2014,2,8,23,201,234,435,604
0131-002,2014,2,8,24,165,188,353,435
0131-002,2014,2,9,1,95,100,195,353
0131-002,2014,2,9,2,78,82,160,195
0131-002,2014,2,9,3,41,61,102,160
0131-002,2014,2,9,4,31,50,81,102
0131-002,2014,2,9,5,57,60,117,81
0131-002,2014,2,9,6,76,77,153,117
0131-002,2014,2,9,7,130,118,248,153
0131-002,2014,2,9,8,238,186,424,248
0131-002,2014,2,9,9,267,313,580,424
0131-002,2014,2,9,10,272,404,676,580
0131-002,2014,2,9,11,346,451,797,676
0131-002,2014,2,9,12,353,480,833,797
0131-002,2014,2,9,13,429,485,914,833
0131-002,2014,2,9,14,481,528,1009,914
0131-002,2014,2,9,15,525,549,1074,1009
0131-002,2014,2,9,16,556,519,1075,1074
0131-002,2014,2,9,17,583,540,1123,1075
0131-002,2014,2,9,18,535,555,1090,1123
0131-002,2014,2,9,19,538,454,992,1090
0131-002,2014,2,9,20,401,319,720,992
0131-002,2014,2,9,21,291,319,610,720
0131-002,2014,2,9,22,308,247,555,610
0131-002,2014,2,9,23,214,178,392,555
0131-002,2014,2,9,24,144,120,264,392
0131-002,2014,2,10,1,102,82,184,264
0131-002,2014,2,10,2,69,47,116,184
0131-002,2014,2,10,3,46,42,88,116
0131-002,2014,2,10,4,43,47,90,88
0131-002,2014,2,10,5,53,71,124,90
0131-002,2014,2,10,6,160,114,274,124
0131-002,2014,2,10,7,403,286,689,274
0131-002,2014,2,10,8,432,454,886,689
0131-002,2014,2,10,9,530,630,1160,886
0131-002,2014,2,10,10,1073,780,1853,1160
0131-002,2014,2,10,11,851,844,1695,1853
0131-002,2014,2,10,12,787,885,1672,1695
0131-002,2014,2,10,13,724,767,1491,1672
0131-002,2014,2,10,14,836,874,1710,1491
0131-002,2014,2,10,15,908,941,1849,1710
0131-002,2014,2,10,16,898,920,1818,1849
0131-002,2014,2,10,17,785,944,1729,1818
0131-002,2014,2,10,18,754,999,1753,1729
0131-002,2014,2,10,19,767,1049,1816,1753
0131-002,2014,2,10,20,577,808,1385,1816
0131-002,2014,2,10,21,451,701,1152,1385
0131-002,2014,2,10,22,390,476,866,1152
0131-002,2014,2,10,23,260,302,562,866
0131-002,2014,2,10,24,181,189,370,562
0131-002,2014,2,11,1,116,126,242,370
0131-002,2014,2,11,2,83,82,165,242
0131-002,2014,2,11,3,65,60,125,165
0131-002,2014,2,11,4,65,82,147,125
0131-002,2014,2,11,5,66,90,156,147
0131-002,2014,2,11,6,151,132,283,156
0131-002,2014,2,11,7,462,300,762,283
0131-002,2014,2,11,8,1263,772,2035,762
0131-002,2014,2,11,9,1269,913,2182,2035
0131-002,2014,2,11,10,930,905,1835,2182
0131-002,2014,2,11,11,899,954,1853,1835
0131-002,2014,2,11,12,902,826,1728,1853
0131-002,2014,2,11,13,723,752,1475,1728
0131-002,2014,2,11,14,813,906,1719,1475
0131-002,2014,2,11,15,923,992,1915,1719
0131-002,2014,2,11,16,935,991,1926,1915
0131-002,2014,2,11,17,837,991,1828,1926
0131-002,2014,2,11,18,775,1046,1821,1828
0131-002,2014,2,11,19,794,1050,1844,1821
0131-002,2014,2,11,20,617,769,1386,1844
0131-002,2014,2,11,21,475,749,1224,1386
0131-002,2014,2,11,22,408,566,974,1224
0131-002,2014,2,11,23,253,294,547,974
0131-002,2014,2,11,24,233,212,445,547
0131-002,2014,2,12,1,124,132,256,445
0131-002,2014,2,12,2,83,103,186,256
0131-002,2014,2,12,3,66,80,146,186
0131-002,2014,2,12,4,67,85,152,146
0131-002,2014,2,12,5,61,98,159,152
0131-002,2014,2,12,6,146,152,298,159
0131-002,2014,2,12,7,506,277,783,298
0131-002,2014,2,12,8,1266,756,2022,783
0131-002,2014,2,12,9,1268,936,2204,2022
0131-002,2014,2,12,10,885,889,1774,2204
0131-002,2014,2,12,11,873,928,1801,1774
0131-002,2014,2,12,12,905,847,1752,1801
0131-002,2014,2,12,13,738,792,1530,1752
0131-002,2014,2,12,14,793,852,1645,1530
0131-002,2014,2,12,15,929,992,1921,1645
0131-002,2014,2,12,16,880,928,1808,1921
0131-002,2014,2,12,17,787,989,1776,1808
0131-002,2014,2,12,18,881,1090,1971,1776
0131-002,2014,2,12,19,766,1081,1847,1971
0131-002,2014,2,12,20,613,714,1327,1847
0131-002,2014,2,12,21,511,645,1156,1327
0131-002,2014,2,12,22,373,537,910,1156
0131-002,2014,2,12,23,274,319,593,910
0131-002,2014,2,12,24,185,212,397,593
0131-002,2014,2,13,1,139,165,304,397
0131-002,2014,2,13,2,81,120,201,304
0131-002,2014,2,13,3,69,83,152,201
0131-002,2014,2,13,4,76,80,156,152
0131-002,2014,2,13,5,77,92,169,156
0131-002,2014,2,13,6,142,149,291,169
0131-002,2014,2,13,7,496,299,795,291
0131-002,2014,2,13,8,1221,729,1950,795
0131-002,2014,2,13,9,1317,926,2243,1950
0131-002,2014,2,13,10,953,899,1852,2243
0131-002,2014,2,13,11,1089,1076,2165,1852
0131-002,2014,2,13,12,962,982,1944,2165
0131-002,2014,2,13,13,708,866,1574,1944
0131-002,2014,2,13,14,860,869,1729,1574
0131-002,2014,2,13,15,916,961,1877,1729
0131-002,2014,2,13,16,885,949,1834,1877
0131-002,2014,2,13,17,804,929,1733,1834
0131-002,2014,2,13,18,814,1069,1883,1733
0131-002,2014,2,13,19,812,1053,1865,1883
0131-002,2014,2,13,20,572,767,1339,1865
0131-002,2014,2,13,21,497,693,1190,1339
0131-002,2014,2,13,22,410,550,960,1190
0131-002,2014,2,13,23,297,361,658,960
0131-002,2014,2,13,24,168,211,379,658
0131-002,2014,2,14,1,158,140,298,379
0131-002,2014,2,14,2,96,86,182,298
0131-002,2014,2,14,3,59,79,138,182
0131-002,2014,2,14,4,65,75,140,138
0131-002,2014,2,14,5,73,117,190,140
0131-002,2014,2,14,6,142,151,293,190
0131-002,2014,2,14,7,478,290,768,293
0131-002,2014,2,14,8,1293,721,2014,768
0131-002,2014,2,14,9,1312,920,2232,2014
0131-002,2014,2,14,10,877,905,1782,2232
0131-002,2014,2,14,11,959,946,1905,1782
0131-002,2014,2,14,12,803,982,1785,1905
0131-002,2014,2,14,13,759,796,1555,1785
0131-002,2014,2,14,14,896,831,1727,1555
0131-002,2014,2,14,15,925,989,1914,1727
0131-002,2014,2,14,16,922,1000,1922,1914
0131-002,2014,2,14,17,870,1063,1933,1922
0131-002,2014,2,14,18,906,1144,2050,1933
0131-002,2014,2,14,19,908,1184,2092,2050
0131-002,2014,2,14,20,691,974,1665,2092
0131-002,2014,2,14,21,531,722,1253,1665
0131-002,2014,2,14,22,447,567,1014,1253
0131-002,2014,2,14,23,313,472,785,1014
0131-002,2014,2,14,24,238,229,467,785
0131-002,2014,2,15,1,140,184,324,467
0131-002,2014,2,15,2,106,133,239,324
0131-002,2014,2,15,3,72,110,182,239
0131-002,2014,2,15,4,72,85,157,182
0131-002,2014,2,15,5,95,117,212,157
0131-002,2014,2,15,6,167,127,294,212
0131-002,2014,2,15,7,329,222,551,294
0131-002,2014,2,15,8,705,475,1180,551
0131-002,2014,2,15,9,720,677,1397,1180
0131-002,2014,2,15,10,737,793,1530,1397
0131-002,2014,2,15,11,712,818,1530,1530
0131-002,2014,2,15,12,695,849,1544,1530
0131-002,2014,2,15,13,698,824,1522,1544
0131-002,2014,2,15,14,684,775,1459,1522
0131-002,2014,2,15,15,659,762,1421,1459
0131-002,2014,2,15,16,823,766,1589,1421
0131-002,2014,2,15,17,702,792,1494,1589
0131-002,2014,2,15,18,808,888,1696,1494
0131-002,2014,2,15,19,750,749,1499,1696
0131-002,2014,2,15,20,512,560,1072,1499
0131-002,2014,2,15,21,403,436,839,1072
0131-002,2014,2,15,22,335,382,717,839
0131-002,2014,2,15,23,218,287,505,717
0131-002,2014,2,15,24,161,183,344,505
0131-002,2014,2,16,1,98,143,241,344
0131-002,2014,2,16,2,85,106,191,241
0131-002,2014,2,16,3,61,62,123,191
0131-002,2014,2,16,4,35,59,94,123
0131-002,2014,2,16,5,53,61,114,94
0131-002,2014,2,16,6,74,80,154,114
0131-002,2014,2,16,7,161,126,287,154
0131-002,2014,2,16,8,274,203,477,287
0131-002,2014,2,16,9,263,371,634,477
0131-002,2014,2,16,10,355,417,772,634
0131-002,2014,2,16,11,464,531,995,772
0131-002,2014,2,16,12,508,465,973,995
0131-002,2014,2,16,13,452,561,1013,973
0131-002,2014,2,16,14,600,591,1191,1013
0131-002,2014,2,16,15,580,608,1188,1191
0131-002,2014,2,16,16,646,622,1268,1188
0131-002,2014,2,16,17,679,638,1317,1268
0131-002,2014,2,16,18,679,641,1320,1317
0131-002,2014,2,16,19,652,512,1164,1320
0131-002,2014,2,16,20,462,441,903,1164
0131-002,2014,2,16,21,356,327,683,903
0131-002,2014,2,16,22,388,390,778,683
0131-002,2014,2,16,23,276,212,488,778
0131-002,2014,2,16,24,178,172,350,488
0131-002,2014,2,17,1,112,91,203,350
0131-002,2014,2,17,2,59,56,115,203
0131-002,2014,2,17,3,46,47,93,115
0131-002,2014,2,17,4,49,51,100,93
0131-002,2014,2,17,5,69,82,151,100
0131-002,2014,2,17,6,171,144,315,151
0131-002,2014,2,17,7,618,321,939,315
0131-002,2014,2,17,8,1485,822,2307,939
0131-002,2014,2,17,9,1322,919,2241,2307
0131-002,2014,2,17,10,858,864,1722,2241
0131-002,2014,2,17,11,944,923,1867,1722
0131-002,2014,2,17,12,848,860,1708,1867
0131-002,2014,2,17,13,777,760,1537,1708
0131-002,2014,2,17,14,829,850,1679,1537
0131-002,2014,2,17,15,980,918,1898,1679
0131-002,2014,2,17,16,914,979,1893,1898
0131-002,2014,2,17,17,851,961,1812,1893
0131-002,2014,2,17,18,852,1035,1887,1812
0131-002,2014,2,17,19,761,1033,1794,1887
0131-002,2014,2,17,20,587,790,1377,1794
0131-002,2014,2,17,21,470,676,1146,1377
0131-002,2014,2,17,22,400,513,913,1146
0131-002,2014,2,17,23,247,302,549,913
0131-002,2014,2,17,24,190,188,378,549
0131-002,2014,2,18,1,125,132,257,378
0131-002,2014,2,18,2,76,101,177,257
0131-002,2014,2,18,3,42,75,117,177
0131-002,2014,2,18,4,70,86,156,117
0131-002,2014,2,18,5,81,95,176,156
0131-002,2014,2,18,6,158,167,325,176
0131-002,2014,2,18,7,510,279,789,325
0131-002,2014,2,18,8,1305,769,2074,789
0131-002,2014,2,18,9,1255,974,2229,2074
0131-002,2014,2,18,10,917,905,1822,2229
0131-002,2014,2,18,11,903,994,1897,1822
0131-002,2014,2,18,12,880,891,1771,1897
0131-002,2014,2,18,13,704,793,1497,1771
0131-002,2014,2,18,14,849,829,1678,1497
0131-002,2014,2,18,15,947,982,1929,1678
0131-002,2014,2,18,16,904,1000,1904,1929
0131-002,2014,2,18,17,769,931,1700,1904
0131-002,2014,2,18,18,821,1029,1850,1700
0131-002,2014,2,18,19,766,985,1751,1850
0131-002,2014,2,18,20,634,801,1435,1751
0131-002,2014,2,18,21,503,664,1167,1435
0131-002,2014,2,18,22,437,485,922,1167
0131-002,2014,2,18,23,232,293,525,922
0131-002,2014,2,18,24,177,226,403,525
0131-002,2014,2,19,1,155,134,289,403
0131-002,2014,2,19,2,90,88,178,289
0131-002,2014,2,19,3,72,95,167,178
0131-002,2014,2,19,4,67,78,145,167
0131-002,2014,2,19,5,98,107,205,145
0131-002,2014,2,19,6,128,173,301,205
0131-002,2014,2,19,7,493,297,790,301
0131-002,2014,2,19,8,1339,733,2072,790
0131-002,2014,2,19,9,1285,969,2254,2072
0131-002,2014,2,19,10,849,911,1760,2254
0131-002,2014,2,19,11,863,913,1776,1760
0131-002,2014,2,19,12,858,887,1745,1776
0131-002,2014,2,19,13,783,785,1568,1745
0131-002,2014,2,19,14,849,844,1693,1568
0131-002,2014,2,19,15,870,943,1813,1693
0131-002,2014,2,19,16,868,946,1814,1813
0131-002,2014,2,19,17,774,962,1736,1814
0131-002,2014,2,19,18,839,1101,1940,1736
0131-002,2014,2,19,19,805,1061,1866,1940
0131-002,2014,2,19,20,623,805,1428,1866
0131-002,2014,2,19,21,465,638,1103,1428
0131-002,2014,2,19,22,383,497,880,1103
0131-002,2014,2,19,23,326,329,655,880
0131-002,2014,2,19,24,196,202,398,655
0131-002,2014,2,20,1,115,132,247,398
0131-002,2014,2,20,2,89,125,214,247
0131-002,2014,2,20,3,76,86,162,214
0131-002,2014,2,20,4,79,102,181,162
0131-002,2014,2,20,5,58,98,156,181
0131-002,2014,2,20,6,132,149,281,156
0131-002,2014,2,20,7,505,302,807,281
0131-002,2014,2,20,8,1273,743,2016,807
0131-002,2014,2,20,9,1307,1047,2354,2016
0131-002,2014,2,20,10,907,920,1827,2354
0131-002,2014,2,20,11,889,934,1823,1827
0131-002,2014,2,20,12,863,894,1757,1823
0131-002,2014,2,20,13,694,798,1492,1757
0131-002,2014,2,20,14,833,882,1715,1492
0131-002,2014,2,20,15,916,953,1869,1715
0131-002,2014,2,20,16,936,951,1887,1869
0131-002,2014,2,20,17,849,953,1802,1887
0131-002,2014,2,20,18,854,1052,1906,1802
0131-002,2014,2,20,19,815,1019,1834,1906
0131-002,2014,2,20,20,639,744,1383,1834
0131-002,2014,2,20,21,500,680,1180,1383
0131-002,2014,2,20,22,383,521,904,1180
0131-002,2014,2,20,23,299,317,616,904
0131-002,2014,2,20,24,196,223,419,616
0131-002,2014,2,21,1,129,171,300,419
0131-002,2014,2,21,2,99,118,217,300
0131-002,2014,2,21,3,56,83,139,217
0131-002,2014,2,21,4,55,72,127,139
0131-002,2014,2,21,5,86,104,190,127
0131-002,2014,2,21,6,155,158,313,190
0131-002,2014,2,21,7,503,285,788,313
0131-002,2014,2,21,8,1253,728,1981,788
0131-002,2014,2,21,9,1320,1024,2344,1981
0131-002,2014,2,21,10,903,886,1789,2344
0131-002,2014,2,21,11,897,969,1866,1789
0131-002,2014,2,21,12,833,919,1752,1866
0131-002,2014,2,21,13,703,809,1512,1752
0131-002,2014,2,21,14,867,897,1764,1512
0131-002,2014,2,21,15,935,981,1916,1764
0131-002,2014,2,21,16,826,944,1770,1916
0131-002,2014,2,21,17,836,1046,1882,1770
0131-002,2014,2,21,18,914,1137,2051,1882
0131-002,2014,2,21,19,971,1143,2114,2051
0131-002,2014,2,21,20,722,983,1705,2114
0131-002,2014,2,21,21,535,728,1263,1705
0131-002,2014,2,21,22,447,572,1019,1263
0131-002,2014,2,21,23,315,347,662,1019
0131-002,2014,2,21,24,248,238,486,662
0131-002,2014,2,22,1,125,176,301,486
0131-002,2014,2,22,2,103,122,225,301
0131-002,2014,2,22,3,83,103,186,225
0131-002,2014,2,22,4,76,88,164,186
0131-002,2014,2,22,5,80,102,182,164
0131-002,2014,2,22,6,139,130,269,182
0131-002,2014,2,22,7,332,266,598,269
0131-002,2014,2,22,8,758,489,1247,598
0131-002,2014,2,22,9,753,714,1467,1247
0131-002,2014,2,22,10,689,817,1506,1467
0131-002,2014,2,22,11,756,882,1638,1506
0131-002,2014,2,22,12,767,933,1700,1638
0131-002,2014,2,22,13,656,927,1583,1700
0131-002,2014,2,22,14,759,831,1590,1583
0131-002,2014,2,22,15,773,801,1574,1590
0131-002,2014,2,22,16,746,845,1591,1574
0131-002,2014,2,22,17,775,822,1597,1591
0131-002,2014,2,22,18,866,920,1786,1597
0131-002,2014,2,22,19,843,780,1623,1786
0131-002,2014,2,22,20,623,545,1168,1623
0131-002,2014,2,22,21,414,460,874,1168
0131-002,2014,2,22,22,378,344,722,874
0131-002,2014,2,22,23,249,256,505,722
0131-002,2014,2,22,24,166,172,338,505
0131-002,2014,2,23,1,113,134,247,338
0131-002,2014,2,23,2,77,108,185,247
0131-002,2014,2,23,3,64,72,136,185
0131-002,2014,2,23,4,37,60,97,136
0131-002,2014,2,23,5,53,53,106,97
0131-002,2014,2,23,6,74,87,161,106
0131-002,2014,2,23,7,190,114,304,161
0131-002,2014,2,23,8,282,237,519,304
0131-002,2014,2,23,9,295,349,644,519
0131-002,2014,2,23,10,330,468,798,644
0131-002,2014,2,23,11,392,523,915,798
0131-002,2014,2,23,12,415,561,976,915
0131-002,2014,2,23,13,504,557,1061,976
0131-002,2014,2,23,14,564,533,1097,1061
0131-002,2014,2,23,15,622,564,1186,1097
0131-002,2014,2,23,16,677,625,1302,1186
0131-002,2014,2,23,17,725,645,1370,1302
0131-002,2014,2,23,18,783,673,1456,1370
0131-002,2014,2,23,19,691,566,1257,1456
0131-002,2014,2,23,20,541,403,944,1257
0131-002,2014,2,23,21,438,343,781,944
0131-002,2014,2,23,22,396,325,721,781
0131-002,2014,2,23,23,251,188,439,721
0131-002,2014,2,23,24,154,138,292,439
0131-002,2014,2,24,1,119,99,218,292
0131-002,2014,2,24,2,75,53,128,218
0131-002,2014,2,24,3,44,63,107,128
0131-002,2014,2,24,4,48,48,96,107
0131-002,2014,2,24,5,70,63,133,96
0131-002,2014,2,24,6,186,150,336,133
0131-002,2014,2,24,7,651,348,999,336
0131-002,2014,2,24,8,1510,832,2342,999
0131-002,2014,2,24,9,1321,947,2268,2342
0131-002,2014,2,24,10,853,913,1766,2268
0131-002,2014,2,24,11,926,950,1876,1766
0131-002,2014,2,24,12,824,842,1666,1876
0131-002,2014,2,24,13,771,777,1548,1666
0131-002,2014,2,24,14,878,906,1784,1548
0131-002,2014,2,24,15,931,1039,1970,1784
0131-002,2014,2,24,16,929,969,1898,1970
0131-002,2014,2,24,17,839,934,1773,1898
0131-002,2014,2,24,18,857,1106,1963,1773
0131-002,2014,2,24,19,809,1051,1860,1963
0131-002,2014,2,24,20,613,841,1454,1860
0131-002,2014,2,24,21,463,729,1192,1454
0131-002,2014,2,24,22,415,521,936,1192
0131-002,2014,2,24,23,265,334,599,936
0131-002,2014,2,24,24,177,221,398,599
0131-002,2014,2,25,1,117,134,251,398
0131-002,2014,2,25,2,82,75,157,251
0131-002,2014,2,25,3,57,68,125,157
0131-002,2014,2,25,4,75,76,151,125
0131-002,2014,2,25,5,73,95,168,151
0131-002,2014,2,25,6,172,133,305,168
0131-002,2014,2,25,7,528,285,813,305
0131-002,2014,2,25,8,1344,794,2138,813
0131-002,2014,2,25,9,1299,1002,2301,2138
0131-002,2014,2,25,10,969,957,1926,2301
0131-002,2014,2,25,11,958,984,1942,1926
0131-002,2014,2,25,12,934,918,1852,1942
0131-002,2014,2,25,13,810,792,1602,1852
0131-002,2014,2,25,14,864,933,1797,1602
0131-002,2014,2,25,15,1042,986,2028,1797
0131-002,2014,2,25,16,953,1075,2028,2028
0131-002,2014,2,25,17,912,1015,1927,2028
0131-002,2014,2,25,18,885,1065,1950,1927
0131-002,2014,2,25,19,840,1051,1891,1950
0131-002,2014,2,25,20,686,807,1493,1891
0131-002,2014,2,25,21,516,778,1294,1493
0131-002,2014,2,25,22,420,539,959,1294
0131-002,2014,2,25,23,311,335,646,959
0131-002,2014,2,25,24,218,238,456,646
0131-002,2014,2,26,1,144,130,274,456
0131-002,2014,2,26,2,104,104,208,274
0131-002,2014,2,26,3,75,102,177,208
0131-002,2014,2,26,4,71,92,163,177
0131-002,2014,2,26,5,86,135,221,163
0131-002,2014,2,26,6,195,123,318,221
0131-002,2014,2,26,7,534,311,845,318
0131-002,2014,2,26,8,1316,796,2112,845
0131-002,2014,2,26,9,1302,954,2256,2112
0131-002,2014,2,26,10,927,927,1854,2256
0131-002,2014,2,26,11,943,993,1936,1854
0131-002,2014,2,26,12,894,951,1845,1936
0131-002,2014,2,26,13,782,808,1590,1845
0131-002,2014,2,26,14,911,886,1797,1590
0131-002,2014,2,26,15,994,1008,2002,1797
0131-002,2014,2,26,16,945,962,1907,2002
0131-002,2014,2,26,17,843,1007,1850,1907
0131-002,2014,2,26,18,845,1175,2020,1850
0131-002,2014,2,26,19,850,1043,1893,2020
0131-002,2014,2,26,20,635,855,1490,1893
0131-002,2014,2,26,21,483,727,1210,1490
0131-002,2014,2,26,22,418,589,1007,1210
0131-002,2014,2,26,23,307,361,668,1007
0131-002,2014,2,26,24,210,221,431,668
0131-002,2014,2,27,1,172,150,322,431
0131-002,2014,2,27,2,98,99,197,322
0131-002,2014,2,27,3,73,90,163,197
0131-002,2014,2,27,4,61,85,146,163
0131-002,2014,2,27,5,87,109,196,146
0131-002,2014,2,27,6,173,143,316,196
0131-002,2014,2,27,7,538,317,855,316
0131-002,2014,2,27,8,1327,761,2088,855
0131-002,2014,2,27,9,1275,989,2264,2088
0131-002,2014,2,27,10,929,911,1840,2264
0131-002,2014,2,27,11,944,982,1926,1840
0131-002,2014,2,27,12,900,906,1806,1926
0131-002,2014,2,27,13,737,829,1566,1806
0131-002,2014,2,27,14,910,901,1811,1566
0131-002,2014,2,27,15,912,1002,1914,1811
0131-002,2014,2,27,16,924,1026,1950,1914
0131-002,2014,2,27,17,876,936,1812,1950
0131-002,2014,2,27,18,873,1098,1971,1812
0131-002,2014,2,27,19,831,1030,1861,1971
0131-002,2014,2,27,20,670,837,1507,1861
0131-002,2014,2,27,21,529,711,1240,1507
0131-002,2014,2,27,22,439,569,1008,1240
0131-002,2014,2,27,23,370,392,762,1008
0131-002,2014,2,27,24,262,274,536,762
0131-002,2014,2,28,1,157,179,336,536
0131-002,2014,2,28,2,109,102,211,336
0131-002,2014,2,28,3,67,95,162,211
0131-002,2014,2,28,4,64,79,143,162
0131-002,2014,2,28,5,105,112,217,143
0131-002,2014,2,28,6,172,147,319,217
0131-002,2014,2,28,7,556,319,875,319
0131-002,2014,2,28,8,1304,778,2082,875
0131-002,2014,2,28,9,1288,989,2277,2082
0131-002,2014,2,28,10,884,955,1839,2277
0131-002,2014,2,28,11,956,1018,1974,1839
0131-002,2014,2,28,12,863,939,1802,1974
0131-002,2014,2,28,13,782,846,1628,1802
0131-002,2014,2,28,14,863,846,1709,1628
0131-002,2014,2,28,15,918,971,1889,1709
0131-002,2014,2,28,16,922,1037,1959,1889
0131-002,2014,2,28,17,930,1018,1948,1959
0131-002,2014,2,28,18,920,1136,2056,1948
0131-002,2014,2,28,19,992,1191,2183,2056
0131-002,2014,2,28,20,802,977,1779,2183
0131-002,2014,2,28,21,582,781,1363,1779
0131-002,2014,2,28,22,463,621,1084,1363
0131-002,2014,2,28,23,323,407,730,1084
0131-002,2014,2,28,24,231,255,486,730
0131-002,2014,3,1,1,182,165,347,486
0131-002,2014,3,1,2,124,142,266,347
0131-002,2014,3,1,3,103,114,217,266
0131-002,2014,3,1,4,86,110,196,217
0131-002,2014,3,1,5,98,104,202,196
0131-002,2014,3,1,6,163,130,293,202
0131-002,2014,3,1,7,368,274,642,293
0131-002,2014,3,1,8,662,453,1115,642
0131-002,2014,3,1,9,667,640,1307,1115
0131-002,2014,3,1,10,648,735,1383,1307
0131-002,2014,3,1,11,688,792,1480,1383
0131-002,2014,3,1,12,737,939,1676,1480
0131-002,2014,3,1,13,710,899,1609,1676
0131-002,2014,3,1,14,727,879,1606,1609
0131-002,2014,3,1,15,795,881,1676,1606
0131-002,2014,3,1,16,739,871,1610,1676
0131-002,2014,3,1,17,842,828,1670,1610
0131-002,2014,3,1,18,987,890,1877,1670
0131-002,2014,3,1,19,915,807,1722,1877
0131-002,2014,3,1,20,782,537,1319,1722
0131-002,2014,3,1,21,554,453,1007,1319
0131-002,2014,3,1,22,437,381,818,1007
0131-002,2014,3,1,23,263,247,510,818
0131-002,2014,3,1,24,198,206,404,510
0131-002,2014,3,2,1,117,148,265,404
0131-002,2014,3,2,2,82,92,174,265
0131-002,2014,3,2,3,63,62,125,174
0131-002,2014,3,2,4,44,61,105,125
0131-002,2014,3,2,5,51,53,104,105
0131-002,2014,3,2,6,82,77,159,104
0131-002,2014,3,2,7,186,92,278,159
0131-002,2014,3,2,8,284,236,520,278
0131-002,2014,3,2,9,296,380,676,520
0131-002,2014,3,2,10,372,440,812,676
0131-002,2014,3,2,11,452,532,984,812
0131-002,2014,3,2,12,520,544,1064,984
0131-002,2014,3,2,13,511,633,1144,1064
0131-002,2014,3,2,14,630,618,1248,1144
0131-002,2014,3,2,15,736,631,1367,1248
0131-002,2014,3,2,16,882,716,1598,1367
0131-002,2014,3,2,17,965,710,1675,1598
0131-002,2014,3,2,18,952,725,1677,1675
0131-002,2014,3,2,19,932,661,1593,1677
0131-002,2014,3,2,20,908,519,1427,1593
0131-002,2014,3,2,21,903,422,1325,1427
0131-002,2014,3,2,22,830,323,1153,1325
0131-002,2014,3,2,23,488,213,701,1153
0131-002,2014,3,2,24,226,156,382,701
0131-002,2014,3,3,1,107,77,184,382
0131-002,2014,3,3,2,71,42,113,184
0131-002,2014,3,3,3,55,48,103,113
0131-002,2014,3,3,4,48,51,99,103
0131-002,2014,3,3,5,79,87,166,99
0131-002,2014,3,3,6,265,154,419,166
0131-002,2014,3,3,7,702,364,1066,419
0131-002,2014,3,3,8,1648,836,2484,1066
0131-002,2014,3,3,9,1356,968,2324,2484
0131-002,2014,3,3,10,917,893,1810,2324
0131-002,2014,3,3,11,907,899,1806,1810
0131-002,2014,3,3,12,899,912,1811,1806
0131-002,2014,3,3,13,758,769,1527,1811
0131-002,2014,3,3,14,896,845,1741,1527
0131-002,2014,3,3,15,983,957,1940,1741
0131-002,2014,3,3,16,945,939,1884,1940
0131-002,2014,3,3,17,884,909,1793,1884
0131-002,2014,3,3,18,878,1144,2022,1793
0131-002,2014,3,3,19,784,1050,1834,2022
0131-002,2014,3,3,20,665,823,1488,1834
0131-002,2014,3,3,21,499,697,1196,1488
0131-002,2014,3,3,22,417,557,974,1196
0131-002,2014,3,3,23,274,339,613,974
0131-002,2014,3,3,24,204,215,419,613
0131-002,2014,3,4,1,133,136,269,419
0131-002,2014,3,4,2,79,99,178,269
0131-002,2014,3,4,3,75,95,170,178
0131-002,2014,3,4,4,70,76,146,170
0131-002,2014,3,4,5,101,107,208,146
0131-002,2014,3,4,6,185,143,328,208
0131-002,2014,3,4,7,597,324,921,328
0131-002,2014,3,4,8,1389,789,2178,921
0131-002,2014,3,4,9,1297,979,2276,2178
0131-002,2014,3,4,10,940,903,1843,2276
0131-002,2014,3,4,11,898,999,1897,1843
0131-002,2014,3,4,12,899,854,1753,1897
0131-002,2014,3,4,13,729,780,1509,1753
0131-002,2014,3,4,14,875,872,1747,1509
0131-002,2014,3,4,15,979,928,1907,1747
0131-002,2014,3,4,16,976,1023,1999,1907
0131-002,2014,3,4,17,844,978,1822,1999
0131-002,2014,3,4,18,849,1036,1885,1822
0131-002,2014,3,4,19,758,998,1756,1885
0131-002,2014,3,4,20,641,788,1429,1756
0131-002,2014,3,4,21,488,688,1176,1429
0131-002,2014,3,4,22,453,541,994,1176
0131-002,2014,3,4,23,263,358,621,994
0131-002,2014,3,4,24,173,206,379,621
0131-002,2014,3,5,1,116,138,254,379
0131-002,2014,3,5,2,96,102,198,254
0131-002,2014,3,5,3,56,85,141,198
0131-002,2014,3,5,4,68,79,147,141
0131-002,2014,3,5,5,91,116,207,147
0131-002,2014,3,5,6,200,134,334,207
0131-002,2014,3,5,7,539,318,857,334
0131-002,2014,3,5,8,1366,788,2154,857
0131-002,2014,3,5,9,1293,1016,2309,2154
0131-002,2014,3,5,10,993,878,1871,2309
0131-002,2014,3,5,11,933,990,1923,1871
0131-002,2014,3,5,12,898,813,1711,1923
0131-002,2014,3,5,13,685,796,1481,1711
0131-002,2014,3,5,14,834,848,1682,1481
0131-002,2014,3,5,15,979,1010,1989,1682
0131-002,2014,3,5,16,915,971,1886,1989
0131-002,2014,3,5,17,813,928,1741,1886
0131-002,2014,3,5,18,866,1092,1958,1741
0131-002,2014,3,5,19,806,1033,1839,1958
0131-002,2014,3,5,20,689,782,1471,1839
0131-002,2014,3,5,21,457,658,1115,1471
0131-002,2014,3,5,22,385,560,945,1115
0131-002,2014,3,5,23,299,345,644,945
0131-002,2014,3,5,24,200,240,440,644
0131-002,2014,3,6,1,119,159,278,440
0131-002,2014,3,6,2,86,93,179,278
0131-002,2014,3,6,3,79,84,163,179
0131-002,2014,3,6,4,66,87,153,163
0131-002,2014,3,6,5,90,110,200,153
0131-002,2014,3,6,6,174,146,320,200
0131-002,2014,3,6,7,568,295,863,320
0131-002,2014,3,6,8,1390,759,2149,863
0131-002,2014,3,6,9,1307,962,2269,2149
0131-002,2014,3,6,10,977,935,1912,2269
0131-002,2014,3,6,11,926,921,1847,1912
0131-002,2014,3,6,12,922,824,1746,1847
0131-002,2014,3,6,13,705,780,1485,1746
0131-002,2014,3,6,14,816,901,1717,1485
0131-002,2014,3,6,15,1011,981,1992,1717
0131-002,2014,3,6,16,973,1007,1980,1992
0131-002,2014,3,6,17,794,922,1716,1980
0131-002,2014,3,6,18,878,1093,1971,1716
0131-002,2014,3,6,19,837,1010,1847,1971
0131-002,2014,3,6,20,612,781,1393,1847
0131-002,2014,3,6,21,492,704,1196,1393
0131-002,2014,3,6,22,439,558,997,1196
0131-002,2014,3,6,23,288,345,633,997
0131-002,2014,3,6,24,207,211,418,633
0131-002,2014,3,7,1,147,156,303,418
0131-002,2014,3,7,2,98,90,188,303
0131-002,2014,3,7,3,57,86,143,188
0131-002,2014,3,7,4,75,79,154,143
0131-002,2014,3,7,5,99,134,233,154
0131-002,2014,3,7,6,165,130,295,233
0131-002,2014,3,7,7,543,269,812,295
0131-002,2014,3,7,8,1366,736,2102,812
0131-002,2014,3,7,9,1297,951,2248,2102
0131-002,2014,3,7,10,973,904,1877,2248
0131-002,2014,3,7,11,921,985,1906,1877
0131-002,2014,3,7,12,843,885,1728,1906
0131-002,2014,3,7,13,733,833,1566,1728
0131-002,2014,3,7,14,845,903,1748,1566
0131-002,2014,3,7,15,1002,1034,2036,1748
0131-002,2014,3,7,16,956,959,1915,2036
0131-002,2014,3,7,17,900,1073,1973,1915
0131-002,2014,3,7,18,879,1204,2083,1973
0131-002,2014,3,7,19,963,1114,2077,2083
0131-002,2014,3,7,20,723,923,1646,2077
0131-002,2014,3,7,21,583,727,1310,1646
0131-002,2014,3,7,22,405,556,961,1310
0131-002,2014,3,7,23,355,328,683,961
0131-002,2014,3,7,24,230,239,469,683
0131-002,2014,3,8,1,139,157,296,469
0131-002,2014,3,8,2,125,127,252,296
0131-002,2014,3,8,3,77,107,184,252
0131-002,2014,3,8,4,71,102,173,184
0131-002,2014,3,8,5,112,111,223,173
0131-002,2014,3,8,6,180,149,329,223
0131-002,2014,3,8,7,357,309,666,329
0131-002,2014,3,8,8,780,527,1307,666
0131-002,2014,3,8,9,797,724,1521,1307
0131-002,2014,3,8,10,736,850,1586,1521
0131-002,2014,3,8,11,755,828,1583,1586
0131-002,2014,3,8,12,796,849,1645,1583
0131-002,2014,3,8,13,733,740,1473,1645
0131-002,2014,3,8,14,769,718,1487,1473
0131-002,2014,3,8,15,743,808,1551,1487
0131-002,2014,3,8,16,738,765,1503,1551
0131-002,2014,3,8,17,775,775,1550,1503
0131-002,2014,3,8,18,854,883,1737,1550
0131-002,2014,3,8,19,756,782,1538,1737
0131-002,2014,3,8,20,520,547,1067,1538
0131-002,2014,3,8,21,392,423,815,1067
0131-002,2014,3,8,22,341,371,712,815
0131-002,2014,3,8,23,257,248,505,712
0131-002,2014,3,8,24,161,191,352,505
0131-002,2014,3,9,1,115,133,248,352
0131-002,2014,3,9,2,85,91,176,248
0131-002,2014,3,9,3,71,74,145,176
0131-002,2014,3,9,4,62,51,113,145
0131-002,2014,3,9,5,43,53,96,113
0131-002,2014,3,9,6,68,69,137,96
0131-002,2014,3,9,7,160,123,283,137
0131-002,2014,3,9,8,243,250,493,283
0131-002,2014,3,9,9,271,317,588,493
0131-002,2014,3,9,10,327,413,740,588
0131-002,2014,3,9,11,392,512,904,740
0131-002,2014,3,9,12,457,509,966,904
0131-002,2014,3,9,13,502,496,998,966
0131-002,2014,3,9,14,531,550,1081,998
0131-002,2014,3,9,15,606,557,1163,1081
0131-002,2014,3,9,16,675,645,1320,1163
0131-002,2014,3,9,17,648,642,1290,1320
0131-002,2014,3,9,18,690,591,1281,1290
0131-002,2014,3,9,19,611,521,1132,1281
0131-002,2014,3,9,20,485,417,902,1132
0131-002,2014,3,9,21,422,365,787,902
0131-002,2014,3,9,22,372,297,669,787
0131-002,2014,3,9,23,285,205,490,669
0131-002,2014,3,9,24,179,130,309,490
0131-002,2014,3,10,1,127,82,209,309
0131-002,2014,3,10,2,69,70,139,209
0131-002,2014,3,10,3,45,35,80,139
0131-002,2014,3,10,4,53,56,109,80
0131-002,2014,3,10,5,76,84,160,109
0131-002,2014,3,10,6,190,136,326,160
0131-002,2014,3,10,7,711,359,1070,326
0131-002,2014,3,10,8,1613,767,2380,1070
0131-002,2014,3,10,9,1376,923,2299,2380
0131-002,2014,3,10,10,869,845,1714,2299
0131-002,2014,3,10,11,887,881,1768,1714
0131-002,2014,3,10,12,920,853,1773,1768
0131-002,2014,3,10,13,826,766,1592,1773
0131-002,2014,3,10,14,854,772,1626,1592
0131-002,2014,3,10,15,887,942,1829,1626
0131-002,2014,3,10,16,964,987,1951,1829
0131-002,2014,3,10,17,812,942,1754,1951
0131-002,2014,3,10,18,843,1082,1925,1754
0131-002,2014,3,10,19,779,1056,1835,1925
0131-002,2014,3,10,20,647,878,1525,1835
0131-002,2014,3,10,21,503,744,1247,1525
0131-002,2014,3,10,22,410,561,971,1247
0131-002,2014,3,10,23,327,328,655,971
0131-002,2014,3,10,24,167,228,395,655
0131-002,2014,3,11,1,130,143,273,395
0131-002,2014,3,11,2,94,83,177,273
0131-002,2014,3,11,3,75,77,152,177
0131-002,2014,3,11,4,68,72,140,152
0131-002,2014,3,11,5,94,110,204,140
0131-002,2014,3,11,6,193,156,349,204
0131-002,2014,3,11,7,596,307,903,349
0131-002,2014,3,11,8,1397,756,2153,903
0131-002,2014,3,11,9,1308,990,2298,2153
0131-002,2014,3,11,10,991,876,1867,2298
0131-002,2014,3,11,11,959,934,1893,1867
0131-002,2014,3,11,12,846,915,1761,1893
0131-002,2014,3,11,13,739,772,1511,1761
0131-002,2014,3,11,14,792,785,1577,1511
0131-002,2014,3,11,15,968,957,1925,1577
0131-002,2014,3,11,16,930,990,1920,1925
0131-002,2014,3,11,17,898,1001,1899,1920
0131-002,2014,3,11,18,835,1035,1870,1899
0131-002,2014,3,11,19,789,1110,1899,1870
0131-002,2014,3,11,20,642,849,1491,1899
0131-002,2014,3,11,21,509,716,1225,1491
0131-002,2014,3,11,22,418,585,1003,1225
0131-002,2014,3,11,23,268,349,617,1003
0131-002,2014,3,11,24,197,216,413,617
0131-002,2014,3,12,1,158,156,314,413
0131-002,2014,3,12,2,98,101,199,314
0131-002,2014,3,12,3,54,85,139,199
0131-002,2014,3,12,4,59,78,137,139
0131-002,2014,3,12,5,88,96,184,137
0131-002,2014,3,12,6,174,156,330,184
0131-002,2014,3,12,7,543,297,840,330
0131-002,2014,3,12,8,1447,729,2176,840
0131-002,2014,3,12,9,1360,987,2347,2176
0131-002,2014,3,12,10,925,838,1763,2347
0131-002,2014,3,12,11,925,961,1886,1763
0131-002,2014,3,12,12,890,886,1776,1886
0131-002,2014,3,12,13,688,889,1577,1776
0131-002,2014,3,12,14,770,937,1707,1577
0131-002,2014,3,12,15,902,1009,1911,1707
0131-002,2014,3,12,16,845,993,1838,1911
0131-002,2014,3,12,17,807,979,1786,1838
0131-002,2014,3,12,18,814,1133,1947,1786
0131-002,2014,3,12,19,736,1093,1829,1947
0131-002,2014,3,12,20,611,800,1411,1829
0131-002,2014,3,12,21,437,630,1067,1411
0131-002,2014,3,12,22,379,516,895,1067
0131-002,2014,3,12,23,279,344,623,895
0131-002,2014,3,12,24,194,205,399,623
0131-002,2014,3,13,1,137,134,271,399
0131-002,2014,3,13,2,93,82,175,271
0131-002,2014,3,13,3,65,104,169,175
0131-002,2014,3,13,4,52,86,138,169
0131-002,2014,3,13,5,81,107,188,138
0131-002,2014,3,13,6,178,148,326,188
0131-002,2014,3,13,7,531,278,809,326
0131-002,2014,3,13,8,1349,738,2087,809
0131-002,2014,3,13,9,1356,942,2298,2087
0131-002,2014,3,13,10,899,896,1795,2298
0131-002,2014,3,13,11,969,945,1914,1795
0131-002,2014,3,13,12,873,902,1775,1914
0131-002,2014,3,13,13,696,801,1497,1775
0131-002,2014,3,13,14,838,872,1710,1497
0131-002,2014,3,13,15,951,1035,1986,1710
0131-002,2014,3,13,16,854,976,1830,1986
0131-002,2014,3,13,17,847,993,1840,1830
0131-002,2014,3,13,18,815,1073,1888,1840
0131-002,2014,3,13,19,865,1053,1918,1888
0131-002,2014,3,13,20,616,828,1444,1918
0131-002,2014,3,13,21,514,735,1249,1444
0131-002,2014,3,13,22,420,565,985,1249
0131-002,2014,3,13,23,274,342,616,985
0131-002,2014,3,13,24,200,215,415,616
0131-002,2014,3,14,1,141,157,298,415
0131-002,2014,3,14,2,92,107,199,298
0131-002,2014,3,14,3,63,82,145,199
0131-002,2014,3,14,4,65,85,150,145
0131-002,2014,3,14,5,93,91,184,150
0131-002,2014,3,14,6,182,167,349,184
0131-002,2014,3,14,7,563,308,871,349
0131-002,2014,3,14,8,1414,772,2186,871
0131-002,2014,3,14,9,1337,1034,2371,2186
0131-002,2014,3,14,10,995,963,1958,2371
0131-002,2014,3,14,11,990,963,1953,1958
0131-002,2014,3,14,12,930,882,1812,1953
0131-002,2014,3,14,13,790,899,1689,1812
0131-002,2014,3,14,14,890,992,1882,1689
0131-002,2014,3,14,15,915,961,1876,1882
0131-002,2014,3,14,16,977,1005,1982,1876
0131-002,2014,3,14,17,941,1023,1964,1982
0131-002,2014,3,14,18,968,1169,2137,1964
0131-002,2014,3,14,19,1002,1245,2247,2137
0131-002,2014,3,14,20,743,1017,1760,2247
0131-002,2014,3,14,21,571,788,1359,1760
0131-002,2014,3,14,22,449,640,1089,1359
0131-002,2014,3,14,23,328,403,731,1089
0131-002,2014,3,14,24,246,267,513,731
0131-002,2014,3,15,1,170,171,341,513
0131-002,2014,3,15,2,99,115,214,341
0131-002,2014,3,15,3,80,92,172,214
0131-002,2014,3,15,4,66,94,160,172
0131-002,2014,3,15,5,88,107,195,160
0131-002,2014,3,15,6,150,154,304,195
0131-002,2014,3,15,7,371,270,641,304
0131-002,2014,3,15,8,787,539,1326,641
0131-002,2014,3,15,9,832,737,1569,1326
0131-002,2014,3,15,10,801,809,1610,1569
0131-002,2014,3,15,11,844,861,1705,1610
0131-002,2014,3,15,12,777,804,1581,1705
0131-002,2014,3,15,13,767,777,1544,1581
0131-002,2014,3,15,14,766,728,1494,1544
0131-002,2014,3,15,15,755,783,1538,1494
0131-002,2014,3,15,16,832,809,1641,1538
0131-002,2014,3,15,17,1027,872,1899,1641
0131-002,2014,3,15,18,906,933,1839,1899
0131-002,2014,3,15,19,784,833,1617,1839
0131-002,2014,3,15,20,521,646,1167,1617
0131-002,2014,3,15,21,425,523,948,1167
0131-002,2014,3,15,22,371,412,783,948
0131-002,2014,3,15,23,259,284,543,783
0131-002,2014,3,15,24,169,239,408,543
0131-002,2014,3,16,1,137,180,317,408
0131-002,2014,3,16,2,92,150,242,317
0131-002,2014,3,16,3,72,100,172,242
0131-002,2014,3,16,4,43,60,103,172
0131-002,2014,3,16,5,52,51,103,103
0131-002,2014,3,16,6,100,85,185,103
0131-002,2014,3,16,7,209,155,364,185
0131-002,2014,3,16,8,344,250,594,364
0131-002,2014,3,16,9,320,358,678,594
0131-002,2014,3,16,10,408,489,897,678
0131-002,2014,3,16,11,483,584,1067,897
0131-002,2014,3,16,12,526,529,1055,1067
0131-002,2014,3,16,13,529,555,1084,1055
0131-002,2014,3,16,14,622,577,1199,1084
0131-002,2014,3,16,15,714,645,1359,1199
0131-002,2014,3,16,16,669,681,1350,1359
0131-002,2014,3,16,17,705,698,1403,1350
0131-002,2014,3,16,18,780,766,1546,1403
0131-002,2014,3,16,19,765,598,1363,1546
0131-002,2014,3,16,20,576,509,1085,1363
0131-002,2014,3,16,21,474,437,911,1085
0131-002,2014,3,16,22,406,326,732,911
0131-002,2014,3,16,23,279,243,522,732
0131-002,2014,3,16,24,185,155,340,522
0131-002,2014,3,17,1,120,104,224,340
0131-002,2014,3,17,2,76,59,135,224
0131-002,2014,3,17,3,52,50,102,135
0131-002,2014,3,17,4,47,58,105,102
0131-002,2014,3,17,5,82,90,172,105
0131-002,2014,3,17,6,232,162,394,172
0131-002,2014,3,17,7,662,341,1003,394
0131-002,2014,3,17,8,1611,784,2395,1003
0131-002,2014,3,17,9,1445,970,2415,2395
0131-002,2014,3,17,10,968,864,1832,2415
0131-002,2014,3,17,11,976,987,1963,1832
0131-002,2014,3,17,12,914,873,1787,1963
0131-002,2014,3,17,13,772,823,1595,1787
0131-002,2014,3,17,14,907,854,1761,1595
0131-002,2014,3,17,15,899,960,1859,1761
0131-002,2014,3,17,16,1034,1014,2048,1859
0131-002,2014,3,17,17,862,1025,1887,2048
0131-002,2014,3,17,18,829,1113,1942,1887
0131-002,2014,3,17,19,799,1042,1841,1942
0131-002,2014,3,17,20,632,816,1448,1841
0131-002,2014,3,17,21,464,704,1168,1448
0131-002,2014,3,17,22,410,528,938,1168
0131-002,2014,3,17,23,251,324,575,938
0131-002,2014,3,17,24,180,219,399,575
0131-002,2014,3,18,1,141,146,287,399
0131-002,2014,3,18,2,70,100,170,287
0131-002,2014,3,18,3,64,79,143,170
0131-002,2014,3,18,4,73,90,163,143
0131-002,2014,3,18,5,68,120,188,163
0131-002,2014,3,18,6,163,163,326,188
0131-002,2014,3,18,7,556,299,855,326
0131-002,2014,3,18,8,1361,751,2112,855
0131-002,2014,3,18,9,1324,909,2233,2112
0131-002,2014,3,18,10,915,949,1864,2233
0131-002,2014,3,18,11,986,989,1975,1864
0131-002,2014,3,18,12,915,883,1798,1975
0131-002,2014,3,18,13,743,776,1519,1798
0131-002,2014,3,18,14,922,881,1803,1519
0131-002,2014,3,18,15,929,959,1888,1803
0131-002,2014,3,18,16,896,955,1851,1888
0131-002,2014,3,18,17,826,963,1789,1851
0131-002,2014,3,18,18,917,1035,1952,1789
0131-002,2014,3,18,19,819,989,1808,1952
0131-002,2014,3,18,20,623,818,1441,1808
0131-002,2014,3,18,21,501,672,1173,1441
0131-002,2014,3,18,22,445,572,1017,1173
0131-002,2014,3,18,23,276,337,613,1017
0131-002,2014,3,18,24,220,206,426,613
0131-002,2014,3,19,1,164,162,326,426
0131-002,2014,3,19,2,91,103,194,326
0131-002,2014,3,19,3,82,90,172,194
0131-002,2014,3,19,4,57,84,141,172
0131-002,2014,3,19,5,91,112,203,141
0131-002,2014,3,19,6,193,160,353,203
0131-002,2014,3,19,7,614,303,917,353
0131-002,2014,3,19,8,1473,788,2261,917
0131-002,2014,3,19,9,1337,981,2318,2261
0131-002,2014,3,19,10,991,933,1924,2318
0131-002,2014,3,19,11,1000,931,1931,1924
0131-002,2014,3,19,12,942,952,1894,1931
0131-002,2014,3,19,13,758,832,1590,1894
0131-002,2014,3,19,14,889,882,1771,1590
0131-002,2014,3,19,15,998,951,1949,1771
0131-002,2014,3,19,16,927,991,1918,1949
0131-002,2014,3,19,17,854,994,1848,1918
0131-002,2014,3,19,18,900,1230,2130,1848
0131-002,2014,3,19,19,871,1080,1951,2130
0131-002,2014,3,19,20,595,765,1360,1951
0131-002,2014,3,19,21,509,664,1173,1360
0131-002,2014,3,19,22,397,491,888,1173
0131-002,2014,3,19,23,305,366,671,888
0131-002,2014,3,19,24,190,237,427,671
0131-002,2014,3,20,1,117,158,275,427
0131-002,2014,3,20,2,101,116,217,275
0131-002,2014,3,20,3,65,77,142,217
0131-002,2014,3,20,4,64,86,150,142
0131-002,2014,3,20,5,85,102,187,150
0131-002,2014,3,20,6,203,172,375,187
0131-002,2014,3,20,7,578,303,881,375
0131-002,2014,3,20,8,1401,730,2131,881
0131-002,2014,3,20,9,1376,989,2365,2131
0131-002,2014,3,20,10,942,889,1831,2365
0131-002,2014,3,20,11,941,975,1916,1831
0131-002,2014,3,20,12,890,899,1789,1916
0131-002,2014,3,20,13,744,768,1512,1789
0131-002,2014,3,20,14,811,865,1676,1512
0131-002,2014,3,20,15,961,1008,1969,1676
0131-002,2014,3,20,16,922,962,1884,1969
0131-002,2014,3,20,17,850,939,1789,1884
0131-002,2014,3,20,18,804,1069,1873,1789
0131-002,2014,3,20,19,879,1037,1916,1873
0131-002,2014,3,20,20,671,837,1508,1916
0131-002,2014,3,20,21,525,709,1234,1508
0131-002,2014,3,20,22,388,586,974,1234
0131-002,2014,3,20,23,283,336,619,974
0131-002,2014,3,20,24,186,226,412,619
0131-002,2014,3,21,1,139,144,283,412
0131-002,2014,3,21,2,111,109,220,283
0131-002,2014,3,21,3,82,86,168,220
0131-002,2014,3,21,4,52,83,135,168
0131-002,2014,3,21,5,83,106,189,135
0131-002,2014,3,21,6,165,135,300,189
0131-002,2014,3,21,7,567,294,861,300
0131-002,2014,3,21,8,1471,769,2240,861
0131-002,2014,3,21,9,1289,1026,2315,2240
0131-002,2014,3,21,10,899,897,1796,2315
0131-002,2014,3,21,11,938,957,1895,1796
0131-002,2014,3,21,12,919,883,1802,1895
0131-002,2014,3,21,13,696,774,1470,1802
0131-002,2014,3,21,14,842,877,1719,1470
0131-002,2014,3,21,15,927,997,1924,1719
0131-002,2014,3,21,16,957,1042,1999,1924
0131-002,2014,3,21,17,864,953,1817,1999
0131-002,2014,3,21,18,929,1111,2040,1817
0131-002,2014,3,21,19,952,1222,2174,2040
0131-002,2014,3,21,20,749,941,1690,2174
0131-002,2014,3,21,21,544,765,1309,1690
0131-002,2014,3,21,22,404,566,970,1309
0131-002,2014,3,21,23,325,428,753,970
0131-002,2014,3,21,24,227,221,448,753
0131-002,2014,3,22,1,148,156,304,448
0131-002,2014,3,22,2,122,151,273,304
0131-002,2014,3,22,3,89,74,163,273
0131-002,2014,3,22,4,74,70,144,163
0131-002,2014,3,22,5,90,128,218,144
0131-002,2014,3,22,6,180,165,345,218
0131-002,2014,3,22,7,417,277,694,345
0131-002,2014,3,22,8,841,524,1365,694
0131-002,2014,3,22,9,821,785,1606,1365
0131-002,2014,3,22,10,738,840,1578,1606
0131-002,2014,3,22,11,736,847,1583,1578
0131-002,2014,3,22,12,799,853,1652,1583
0131-002,2014,3,22,13,764,767,1531,1652
0131-002,2014,3,22,14,807,721,1528,1531
0131-002,2014,3,22,15,772,818,1590,1528
0131-002,2014,3,22,16,756,816,1572,1590
0131-002,2014,3,22,17,785,849,1634,1572
0131-002,2014,3,22,18,912,932,1844,1634
0131-002,2014,3,22,19,826,832,1658,1844
0131-002,2014,3,22,20,620,588,1208,1658
0131-002,2014,3,22,21,431,480,911,1208
0131-002,2014,3,22,22,355,381,736,911
0131-002,2014,3,22,23,252,309,561,736
0131-002,2014,3,22,24,181,187,368,561
0131-002,2014,3,23,1,137,158,295,368
0131-002,2014,3,23,2,91,112,203,295
0131-002,2014,3,23,3,80,82,162,203
0131-002,2014,3,23,4,50,69,119,162
0131-002,2014,3,23,5,50,72,122,119
0131-002,2014,3,23,6,90,92,182,122
0131-002,2014,3,23,7,199,157,356,182
0131-002,2014,3,23,8,333,269,602,356
0131-002,2014,3,23,9,391,403,794,602
0131-002,2014,3,23,10,360,431,791,794
0131-002,2014,3,23,11,515,569,1084,791
0131-002,2014,3,23,12,575,528,1103,1084
0131-002,2014,3,23,13,533,508,1041,1103
0131-002,2014,3,23,14,593,552,1145,1041
0131-002,2014,3,23,15,629,646,1275,1145
0131-002,2014,3,23,16,690,617,1307,1275
0131-002,2014,3,23,17,789,648,1437,1307
0131-002,2014,3,23,18,873,730,1603,1437
0131-002,2014,3,23,19,747,610,1357,1603
0131-002,2014,3,23,20,621,525,1146,1357
0131-002,2014,3,23,21,496,432,928,1146
0131-002,2014,3,23,22,442,339,781,928
0131-002,2014,3,23,23,300,228,528,781
0131-002,2014,3,23,24,196,165,361,528
0131-002,2014,3,24,1,131,114,245,361
0131-002,2014,3,24,2,68,70,138,245
0131-002,2014,3,24,3,46,61,107,138
0131-002,2014,3,24,4,48,62,110,107
0131-002,2014,3,24,5,91,98,189,110
0131-002,2014,3,24,6,212,154,366,189
0131-002,2014,3,24,7,749,353,1102,366
0131-002,2014,3,24,8,1664,786,2450,1102
0131-002,2014,3,24,9,1381,930,2311,2450
0131-002,2014,3,24,10,934,838,1772,2311
0131-002,2014,3,24,11,918,883,1801,1772
0131-002,2014,3,24,12,839,898,1737,1801
0131-002,2014,3,24,13,772,776,1548,1737
0131-002,2014,3,24,14,866,865,1731,1548
0131-002,2014,3,24,15,1012,1038,2050,1731
0131-002,2014,3,24,16,909,978,1887,2050
0131-002,2014,3,24,17,836,984,1820,1887
0131-002,2014,3,24,18,839,1039,1878,1820
0131-002,2014,3,24,19,890,1030,1920,1878
0131-002,2014,3,24,20,655,844,1499,1920
0131-002,2014,3,24,21,528,742,1270,1499
0131-002,2014,3,24,22,414,528,942,1270
0131-002,2014,3,24,23,258,326,584,942
0131-002,2014,3,24,24,187,207,394,584
0131-002,2014,3,25,1,145,144,289,394
0131-002,2014,3,25,2,82,94,176,289
0131-002,2014,3,25,3,70,76,146,176
0131-002,2014,3,25,4,73,84,157,146
0131-002,2014,3,25,5,114,112,226,157
0131-002,2014,3,25,6,173,167,340,226
0131-002,2014,3,25,7,592,324,916,340
0131-002,2014,3,25,8,1462,736,2198,916
0131-002,2014,3,25,9,1351,962,2313,2198
0131-002,2014,3,25,10,924,890,1814,2313
0131-002,2014,3,25,11,969,921,1890,1814
0131-002,2014,3,25,12,848,866,1714,1890
0131-002,2014,3,25,13,756,768,1524,1714
0131-002,2014,3,25,14,808,846,1654,1524
0131-002,2014,3,25,15,937,944,1881,1654
0131-002,2014,3,25,16,919,944,1863,1881
0131-002,2014,3,25,17,820,970,1790,1863
0131-002,2014,3,25,18,877,1053,1930,1790
0131-002,2014,3,25,19,899,1047,1946,1930
0131-002,2014,3,25,20,616,818,1434,1946
0131-002,2014,3,25,21,478,713,1191,1434
0131-002,2014,3,25,22,449,560,1009,1191
0131-002,2014,3,25,23,291,341,632,1009
0131-002,2014,3,25,24,204,211,415,632
0131-002,2014,3,26,1,139,158,297,415
0131-002,2014,3,26,2,99,117,216,297
0131-002,2014,3,26,3,78,62,140,216
0131-002,2014,3,26,4,56,63,119,140
0131-002,2014,3,26,5,95,104,199,119
0131-002,2014,3,26,6,172,165,337,199
0131-002,2014,3,26,7,560,325,885,337
0131-002,2014,3,26,8,1421,734,2155,885
0131-002,2014,3,26,9,1301,1001,2302,2155
0131-002,2014,3,26,10,943,876,1819,2302
0131-002,2014,3,26,11,949,904,1853,1819
0131-002,2014,3,26,12,873,852,1725,1853
0131-002,2014,3,26,13,764,770,1534,1725
0131-002,2014,3,26,14,886,890,1776,1534
0131-002,2014,3,26,15,905,957,1862,1776
0131-002,2014,3,26,16,926,962,1888,1862
0131-002,2014,3,26,17,892,942,1834,1888
0131-002,2014,3,26,18,834,1087,1921,1834
0131-002,2014,3,26,19,921,1024,1945,1921
0131-002,2014,3,26,20,682,801,1483,1945
0131-002,2014,3,26,21,496,698,1194,1483
0131-002,2014,3,26,22,445,505,950,1194
0131-002,2014,3,26,23,313,331,644,950
0131-002,2014,3,26,24,226,266,492,644
0131-002,2014,3,27,1,140,174,314,492
0131-002,2014,3,27,2,108,87,195,314
0131-002,2014,3,27,3,62,76,138,195
0131-002,2014,3,27,4,59,88,147,138
0131-002,2014,3,27,5,108,120,228,147
0131-002,2014,3,27,6,204,188,392,228
0131-002,2014,3,27,7,627,337,964,392
0131-002,2014,3,27,8,1438,750,2188,964
0131-002,2014,3,27,9,1401,959,2360,2188
0131-002,2014,3,27,10,958,911,1869,2360
0131-002,2014,3,27,11,986,936,1922,1869
0131-002,2014,3,27,12,957,874,1831,1922
0131-002,2014,3,27,13,764,826,1590,1831
0131-002,2014,3,27,14,882,906,1788,1590
0131-002,2014,3,27,15,901,997,1898,1788
0131-002,2014,3,27,16,937,958,1895,1898
0131-002,2014,3,27,17,879,999,1878,1895
0131-002,2014,3,27,18,910,1105,2015,1878
0131-002,2014,3,27,19,882,966,1848,2015
0131-002,2014,3,27,20,694,833,1527,1848
0131-002,2014,3,27,21,485,721,1206,1527
0131-002,2014,3,27,22,453,547,1000,1206
0131-002,2014,3,27,23,330,355,685,1000
0131-002,2014,3,27,24,213,215,428,685
0131-002,2014,3,28,1,154,180,334,428
0131-002,2014,3,28,2,95,136,231,334
0131-002,2014,3,28,3,69,92,161,231
0131-002,2014,3,28,4,84,84,168,161
0131-002,2014,3,28,5,89,138,227,168
0131-002,2014,3,28,6,206,163,369,227
0131-002,2014,3,28,7,599,356,955,369
0131-002,2014,3,28,8,1460,716,2176,955
0131-002,2014,3,28,9,1308,950,2258,2176
0131-002,2014,3,28,10,933,905,1838,2258
0131-002,2014,3,28,11,978,978,1956,1838
0131-002,2014,3,28,12,990,962,1952,1956
0131-002,2014,3,28,13,786,810,1596,1952
0131-002,2014,3,28,14,874,878,1752,1596
0131-002,2014,3,28,15,925,945,1870,1752
0131-002,2014,3,28,16,919,968,1887,1870
0131-002,2014,3,28,17,892,1082,1974,1887
0131-002,2014,3,28,18,936,1160,2096,1974
0131-002,2014,3,28,19,994,1232,2226,2096
0131-002,2014,3,28,20,816,955,1771,2226
0131-002,2014,3,28,21,598,744,1342,1771
0131-002,2014,3,28,22,511,610,1121,1342
0131-002,2014,3,28,23,337,383,720,1121
0131-002,2014,3,28,24,265,246,511,720
0131-002,2014,3,29,1,194,206,400,511
0131-002,2014,3,29,2,110,139,249,400
0131-002,2014,3,29,3,86,98,184,249
0131-002,2014,3,29,4,99,99,198,184
0131-002,2014,3,29,5,107,116,223,198
0131-002,2014,3,29,6,198,167,365,223
0131-002,2014,3,29,7,429,295,724,365
0131-002,2014,3,29,8,739,541,1280,724
0131-002,2014,3,29,9,780,740,1520,1280
0131-002,2014,3,29,10,746,784,1530,1520
0131-002,2014,3,29,11,787,869,1656,1530
0131-002,2014,3,29,12,825,870,1695,1656
0131-002,2014,3,29,13,703,870,1573,1695
0131-002,2014,3,29,14,733,807,1540,1573
0131-002,2014,3,29,15,733,821,1554,1540
0131-002,2014,3,29,16,770,816,1586,1554
0131-002,2014,3,29,17,764,865,1629,1586
0131-002,2014,3,29,18,883,877,1760,1629
0131-002,2014,3,29,19,801,753,1554,1760
0131-002,2014,3,29,20,540,550,1090,1554
0131-002,2014,3,29,21,418,460,878,1090
0131-002,2014,3,29,22,342,349,691,878
0131-002,2014,3,29,23,251,256,507,691
0131-002,2014,3,29,24,169,214,383,507
0131-002,2014,3,30,1,127,150,277,383
0131-002,2014,3,30,2,89,98,187,277
0131-002,2014,3,30,3,54,59,113,187
0131-002,2014,3,30,4,65,64,129,113
0131-002,2014,3,30,5,42,61,103,129
0131-002,2014,3,30,6,92,98,190,103
0131-002,2014,3,30,7,203,168,371,190
0131-002,2014,3,30,8,372,278,650,371
0131-002,2014,3,30,9,381,383,764,650
0131-002,2014,3,30,10,386,515,901,764
0131-002,2014,3,30,11,481,540,1021,901
0131-002,2014,3,30,12,578,571,1149,1021
0131-002,2014,3,30,13,524,534,1058,1149
0131-002,2014,3,30,14,595,605,1200,1058
0131-002,2014,3,30,15,641,653,1294,1200
0131-002,2014,3,30,16,675,641,1316,1294
0131-002,2014,3,30,17,806,657,1463,1316
0131-002,2014,3,30,18,878,671,1549,1463
0131-002,2014,3,30,19,796,644,1440,1549
0131-002,2014,3,30,20,707,542,1249,1440
0131-002,2014,3,30,21,628,443,1071,1249
0131-002,2014,3,30,22,483,367,850,1071
0131-002,2014,3,30,23,335,230,565,850
0131-002,2014,3,30,24,183,163,346,565
0131-002,2014,3,31,1,141,106,247,346
0131-002,2014,3,31,2,83,80,163,247
0131-002,2014,3,31,3,72,50,122,163
0131-002,2014,3,31,4,77,54,131,122
0131-002,2014,3,31,5,90,82,172,131
0131-002,2014,3,31,6,214,155,369,172
0131-002,2014,3,31,7,782,367,1149,369
0131-002,2014,3,31,8,1632,798,2430,1149
0131-002,2014,3,31,9,1439,939,2378,2430
0131-002,2014,3,31,10,924,813,1737,2378
0131-002,2014,3,31,11,896,888,1784,1737
0131-002,2014,3,31,12,871,812,1683,1784
0131-002,2014,3,31,13,718,756,1474,1683
0131-002,2014,3,31,14,814,816,1630,1474
0131-002,2014,3,31,15,977,930,1907,1630
0131-002,2014,3,31,16,961,960,1921,1907
0131-002,2014,3,31,17,877,982,1859,1921
0131-002,2014,3,31,18,860,1065,1925,1859
0131-002,2014,3,31,19,803,965,1768,1925
0131-002,2014,3,31,20,708,816,1524,1768
0131-002,2014,3,31,21,559,751,1310,1524
0131-002,2014,3,31,22,470,567,1037,1310
0131-002,2014,3,31,23,286,358,644,1037
0131-002,2014,3,31,24,204,234,438,644
0131-002,2014,4,1,1,120,166,286,438
0131-002,2014,4,1,2,93,96,189,286
0131-002,2014,4,1,3,88,92,180,189
0131-002,2014,4,1,4,78,79,157,180
0131-002,2014,4,1,5,87,119,206,157
0131-002,2014,4,1,6,195,173,368,206
0131-002,2014,4,1,7,655,375,1030,368
0131-002,2014,4,1,8,1450,757,2207,1030
0131-002,2014,4,1,9,1350,958,2308,2207
0131-002,2014,4,1,10,991,917,1908,2308
0131-002,2014,4,1,11,946,951,1897,1908
0131-002,2014,4,1,12,912,852,1764,1897
0131-002,2014,4,1,13,730,812,1542,1764
0131-002,2014,4,1,14,833,876,1709,1542
0131-002,2014,4,1,15,990,1016,2006,1709
0131-002,2014,4,1,16,938,970,1908,2006
0131-002,2014,4,1,17,880,985,1865,1908
0131-002,2014,4,1,18,861,1008,1869,1865
0131-002,2014,4,1,19,842,1027,1869,1869
0131-002,2014,4,1,20,667,822,1489,1869
0131-002,2014,4,1,21,475,717,1192,1489
0131-002,2014,4,1,22,454,557,1011,1192
0131-002,2014,4,1,23,280,351,631,1011
0131-002,2014,4,1,24,241,234,475,631
0131-002,2014,4,2,1,122,178,300,475
0131-002,2014,4,2,2,96,118,214,300
0131-002,2014,4,2,3,63,92,155,214
0131-002,2014,4,2,4,69,99,168,155
0131-002,2014,4,2,5,91,112,203,168
0131-002,2014,4,2,6,205,151,356,203
0131-002,2014,4,2,7,629,381,1010,356
0131-002,2014,4,2,8,1477,792,2269,1010
0131-002,2014,4,2,9,1321,961,2282,2269
0131-002,2014,4,2,10,944,879,1823,2282
0131-002,2014,4,2,11,918,926,1844,1823
0131-002,2014,4,2,12,901,887,1788,1844
0131-002,2014,4,2,13,759,769,1528,1788
0131-002,2014,4,2,14,871,839,1710,1528
0131-002,2014,4,2,15,1009,970,1979,1710
0131-002,2014,4,2,16,963,959,1922,1979
0131-002,2014,4,2,17,856,965,1821,1922
0131-002,2014,4,2,18,920,1053,1973,1821
0131-002,2014,4,2,19,891,1029,1920,1973
0131-002,2014,4,2,20,680,807,1487,1920
0131-002,2014,4,2,21,529,680,1209,1487
0131-002,2014,4,2,22,450,573,1023,1209
0131-002,2014,4,2,23,305,329,634,1023
0131-002,2014,4,2,24,221,237,458,634
0131-002,2014,4,3,1,140,167,307,458
0131-002,2014,4,3,2,108,104,212,307
0131-002,2014,4,3,3,92,100,192,212
0131-002,2014,4,3,4,57,77,134,192
0131-002,2014,4,3,5,85,90,175,134
0131-002,2014,4,3,6,195,170,365,175
0131-002,2014,4,3,7,643,319,962,365
0131-002,2014,4,3,8,1411,748,2159,962
0131-002,2014,4,3,9,1375,905,2280,2159
0131-002,2014,4,3,10,952,907,1859,2280
0131-002,2014,4,3,11,940,946,1886,1859
0131-002,2014,4,3,12,894,917,1811,1886
0131-002,2014,4,3,13,707,797,1504,1811
0131-002,2014,4,3,14,842,806,1648,1504
0131-002,2014,4,3,15,970,1003,1973,1648
0131-002,2014,4,3,16,915,1059,1974,1973
0131-002,2014,4,3,17,870,1045,1915,1974
0131-002,2014,4,3,18,875,1175,2050,1915
0131-002,2014,4,3,19,803,1013,1816,2050
0131-002,2014,4,3,20,631,742,1373,1816
0131-002,2014,4,3,21,502,710,1212,1373
0131-002,2014,4,3,22,482,494,976,1212
0131-002,2014,4,3,23,294,311,605,976
0131-002,2014,4,3,24,212,222,434,605
0131-002,2014,4,4,1,146,151,297,434
0131-002,2014,4,4,2,107,123,230,297
0131-002,2014,4,4,3,66,102,168,230
0131-002,2014,4,4,4,79,94,173,168
0131-002,2014,4,4,5,87,103,190,173
0131-002,2014,4,4,6,197,183,380,190
0131-002,2014,4,4,7,683,335,1018,380
0131-002,2014,4,4,8,1423,725,2148,1018
0131-002,2014,4,4,9,1365,995,2360,2148
0131-002,2014,4,4,10,905,869,1774,2360
0131-002,2014,4,4,11,979,899,1878,1774
0131-002,2014,4,4,12,893,895,1788,1878
0131-002,2014,4,4,13,788,893,1681,1788
0131-002,2014,4,4,14,835,860,1695,1681
0131-002,2014,4,4,15,974,984,1958,1695
0131-002,2014,4,4,16,1036,986,2022,1958
0131-002,2014,4,4,17,882,1037,1919,2022
0131-002,2014,4,4,18,943,1157,2100,1919
0131-002,2014,4,4,19,992,1151,2143,2100
0131-002,2014,4,4,20,856,921,1777,2143
0131-002,2014,4,4,21,560,772,1332,1777
0131-002,2014,4,4,22,452,581,1033,1332
0131-002,2014,4,4,23,292,368,660,1033
0131-002,2014,4,4,24,235,271,506,660
0131-002,2014,4,5,1,145,184,329,506
0131-002,2014,4,5,2,113,140,253,329
0131-002,2014,4,5,3,80,103,183,253
0131-002,2014,4,5,4,84,88,172,183
0131-002,2014,4,5,5,103,124,227,172
0131-002,2014,4,5,6,202,184,386,227
0131-002,2014,4,5,7,444,347,791,386
0131-002,2014,4,5,8,765,535,1300,791
0131-002,2014,4,5,9,826,798,1624,1300
0131-002,2014,4,5,10,778,975,1753,1624
0131-002,2014,4,5,11,855,1044,1899,1753
0131-002,2014,4,5,12,796,1038,1834,1899
0131-002,2014,4,5,13,730,928,1658,1834
0131-002,2014,4,5,14,796,1029,1825,1658
0131-002,2014,4,5,15,854,984,1838,1825
0131-002,2014,4,5,16,948,912,1860,1838
0131-002,2014,4,5,17,874,842,1716,1860
0131-002,2014,4,5,18,913,860,1773,1716
0131-002,2014,4,5,19,898,793,1691,1773
0131-002,2014,4,5,20,741,609,1350,1691
0131-002,2014,4,5,21,509,459,968,1350
0131-002,2014,4,5,22,376,404,780,968
0131-002,2014,4,5,23,288,276,564,780
0131-002,2014,4,5,24,192,183,375,564
0131-002,2014,4,6,1,126,155,281,375
0131-002,2014,4,6,2,78,92,170,281
0131-002,2014,4,6,3,51,68,119,170
0131-002,2014,4,6,4,47,47,94,119
0131-002,2014,4,6,5,44,60,104,94
0131-002,2014,4,6,6,87,99,186,104
0131-002,2014,4,6,7,224,179,403,186
0131-002,2014,4,6,8,299,353,652,403
0131-002,2014,4,6,9,362,492,854,652
0131-002,2014,4,6,10,416,593,1009,854
0131-002,2014,4,6,11,528,626,1154,1009
0131-002,2014,4,6,12,525,528,1053,1154
0131-002,2014,4,6,13,623,598,1221,1053
0131-002,2014,4,6,14,666,599,1265,1221
0131-002,2014,4,6,15,746,596,1342,1265
0131-002,2014,4,6,16,893,612,1505,1342
0131-002,2014,4,6,17,908,654,1562,1505
0131-002,2014,4,6,18,1014,709,1723,1562
0131-002,2014,4,6,19,936,575,1511,1723
0131-002,2014,4,6,20,867,507,1374,1511
0131-002,2014,4,6,21,865,433,1298,1374
0131-002,2014,4,6,22,852,392,1244,1298
0131-002,2014,4,6,23,550,232,782,1244
0131-002,2014,4,6,24,351,152,503,782
0131-002,2014,4,7,1,124,98,222,503
0131-002,2014,4,7,2,71,67,138,222
0131-002,2014,4,7,3,60,38,98,138
0131-002,2014,4,7,4,59,55,114,98
0131-002,2014,4,7,5,95,82,177,114
0131-002,2014,4,7,6,282,166,448,177
0131-002,2014,4,7,7,758,373,1131,448
0131-002,2014,4,7,8,1601,785,2386,1131
0131-002,2014,4,7,9,1420,922,2342,2386
0131-002,2014,4,7,10,978,841,1819,2342
0131-002,2014,4,7,11,942,902,1844,1819
0131-002,2014,4,7,12,870,881,1751,1844
0131-002,2014,4,7,13,712,759,1471,1751
0131-002,2014,4,7,14,870,891,1761,1471
0131-002,2014,4,7,15,958,951,1909,1761
0131-002,2014,4,7,16,928,999,1927,1909
0131-002,2014,4,7,17,892,917,1809,1927
0131-002,2014,4,7,18,838,1110,1948,1809
0131-002,2014,4,7,19,873,941,1814,1948
0131-002,2014,4,7,20,670,765,1435,1814
0131-002,2014,4,7,21,526,748,1274,1435
0131-002,2014,4,7,22,437,540,977,1274
0131-002,2014,4,7,23,297,349,646,977
0131-002,2014,4,7,24,207,215,422,646
0131-002,2014,4,8,1,145,167,312,422
0131-002,2014,4,8,2,97,100,197,312
0131-002,2014,4,8,3,67,71,138,197
0131-002,2014,4,8,4,84,88,172,138
0131-002,2014,4,8,5,107,132,239,172
0131-002,2014,4,8,6,179,167,346,239
0131-002,2014,4,8,7,639,381,1020,346
0131-002,2014,4,8,8,1437,797,2234,1020
0131-002,2014,4,8,9,1322,911,2233,2234
0131-002,2014,4,8,10,947,927,1874,2233
0131-002,2014,4,8,11,990,898,1888,1874
0131-002,2014,4,8,12,906,874,1780,1888
0131-002,2014,4,8,13,761,791,1552,1780
0131-002,2014,4,8,14,859,829,1688,1552
0131-002,2014,4,8,15,966,976,1942,1688
0131-002,2014,4,8,16,950,1011,1961,1942
0131-002,2014,4,8,17,882,957,1839,1961
0131-002,2014,4,8,18,838,1072,1910,1839
0131-002,2014,4,8,19,889,963,1852,1910
0131-002,2014,4,8,20,660,790,1450,1852
0131-002,2014,4,8,21,539,702,1241,1450
0131-002,2014,4,8,22,400,557,957,1241
0131-002,2014,4,8,23,316,383,699,957
0131-002,2014,4,8,24,223,213,436,699
0131-002,2014,4,9,1,139,172,311,436
0131-002,2014,4,9,2,95,107,202,311
0131-002,2014,4,9,3,70,64,134,202
0131-002,2014,4,9,4,81,76,157,134
0131-002,2014,4,9,5,95,107,202,157
0131-002,2014,4,9,6,199,175,374,202
0131-002,2014,4,9,7,652,337,989,374
0131-002,2014,4,9,8,1414,724,2138,989
0131-002,2014,4,9,9,1327,891,2218,2138
0131-002,2014,4,9,10,1001,869,1870,2218
0131-002,2014,4,9,11,893,891,1784,1870
0131-002,2014,4,9,12,885,877,1762,1784
0131-002,2014,4,9,13,745,776,1521,1762
0131-002,2014,4,9,14,830,813,1643,1521
0131-002,2014,4,9,15,913,965,1878,1643
0131-002,2014,4,9,16,937,966,1903,1878
0131-002,2014,4,9,17,824,882,1706,1903
0131-002,2014,4,9,18,863,1107,1970,1706
0131-002,2014,4,9,19,828,994,1822,1970
0131-002,2014,4,9,20,694,740,1434,1822
0131-002,2014,4,9,21,518,649,1167,1434
0131-002,2014,4,9,22,412,536,948,1167
0131-002,2014,4,9,23,312,369,681,948
0131-002,2014,4,9,24,212,219,431,681
0131-002,2014,4,10,1,162,168,330,431
0131-002,2014,4,10,2,86,77,163,330
0131-002,2014,4,10,3,80,95,175,163
0131-002,2014,4,10,4,78,76,154,175
0131-002,2014,4,10,5,103,118,221,154
0131-002,2014,4,10,6,214,188,402,221
0131-002,2014,4,10,7,691,345,1036,402
0131-002,2014,4,10,8,1462,748,2210,1036
0131-002,2014,4,10,9,1335,938,2273,2210
0131-002,2014,4,10,10,1020,828,1848,2273
0131-002,2014,4,10,11,959,929,1888,1848
0131-002,2014,4,10,12,939,880,1819,1888
0131-002,2014,4,10,13,737,774,1511,1819
0131-002,2014,4,10,14,790,863,1653,1511
0131-002,2014,4,10,15,959,991,1950,1653
0131-002,2014,4,10,16,890,958,1848,1950
0131-002,2014,4,10,17,855,925,1780,1848
0131-002,2014,4,10,18,877,1029,1906,1780
0131-002,2014,4,10,19,843,961,1804,1906
0131-002,2014,4,10,20,665,855,1520,1804
0131-002,2014,4,10,21,518,669,1187,1520
0131-002,2014,4,10,22,435,534,969,1187
0131-002,2014,4,10,23,341,373,714,969
0131-002,2014,4,10,24,219,250,469,714
0131-002,2014,4,11,1,158,178,336,469
0131-002,2014,4,11,2,110,110,220,336
0131-002,2014,4,11,3,79,98,177,220
0131-002,2014,4,11,4,77,74,151,177
0131-002,2014,4,11,5,99,124,223,151
0131-002,2014,4,11,6,218,179,397,223
0131-002,2014,4,11,7,661,361,1022,397
0131-002,2014,4,11,8,1403,751,2154,1022
0131-002,2014,4,11,9,1350,946,2296,2154
0131-002,2014,4,11,10,941,870,1811,2296
0131-002,2014,4,11,11,939,879,1818,1811
0131-002,2014,4,11,12,873,897,1770,1818
0131-002,2014,4,11,13,717,817,1534,1770
0131-002,2014,4,11,14,802,832,1634,1534
0131-002,2014,4,11,15,1032,947,1979,1634
0131-002,2014,4,11,16,1002,955,1957,1979
0131-002,2014,4,11,17,847,912,1759,1957
0131-002,2014,4,11,18,1017,1102,2119,1759
0131-002,2014,4,11,19,999,1129,2128,2119
0131-002,2014,4,11,20,806,891,1697,2128
0131-002,2014,4,11,21,551,722,1273,1697
0131-002,2014,4,11,22,424,575,999,1273
0131-002,2014,4,11,23,321,428,749,999
0131-002,2014,4,11,24,264,259,523,749
0131-002,2014,4,12,1,176,186,362,523
0131-002,2014,4,12,2,117,116,233,362
0131-002,2014,4,12,3,87,107,194,233
0131-002,2014,4,12,4,76,95,171,194
0131-002,2014,4,12,5,127,102,229,171
0131-002,2014,4,12,6,197,154,351,229
0131-002,2014,4,12,7,420,284,704,351
0131-002,2014,4,12,8,777,563,1340,704
0131-002,2014,4,12,9,825,812,1637,1340
0131-002,2014,4,12,10,699,844,1543,1637
0131-002,2014,4,12,11,781,927,1708,1543
0131-002,2014,4,12,12,776,988,1764,1708
0131-002,2014,4,12,13,689,842,1531,1764
0131-002,2014,4,12,14,749,809,1558,1531
0131-002,2014,4,12,15,762,802,1564,1558
0131-002,2014,4,12,16,709,765,1474,1564
0131-002,2014,4,12,17,850,824,1674,1474
0131-002,2014,4,12,18,939,919,1858,1674
0131-002,2014,4,12,19,875,773,1648,1858
0131-002,2014,4,12,20,631,594,1225,1648
0131-002,2014,4,12,21,472,500,972,1225
0131-002,2014,4,12,22,382,383,765,972
0131-002,2014,4,12,23,296,280,576,765
0131-002,2014,4,12,24,186,231,417,576
0131-002,2014,4,13,1,133,150,283,417
0131-002,2014,4,13,2,83,117,200,283
0131-002,2014,4,13,3,71,77,148,200
0131-002,2014,4,13,4,48,69,117,148
0131-002,2014,4,13,5,58,59,117,117
0131-002,2014,4,13,6,83,95,178,117
0131-002,2014,4,13,7,221,178,399,178
0131-002,2014,4,13,8,372,318,690,399
0131-002,2014,4,13,9,347,460,807,690
0131-002,2014,4,13,10,443,459,902,807
0131-002,2014,4,13,11,515,505,1020,902
0131-002,2014,4,13,12,522,552,1074,1020
0131-002,2014,4,13,13,574,547,1121,1074
0131-002,2014,4,13,14,589,579,1168,1121
0131-002,2014,4,13,15,705,614,1319,1168
0131-002,2014,4,13,16,778,588,1366,1319
0131-002,2014,4,13,17,944,640,1584,1366
0131-002,2014,4,13,18,940,724,1664,1584
0131-002,2014,4,13,19,1038,664,1702,1664
0131-002,2014,4,13,20,919,556,1475,1702
0131-002,2014,4,13,21,628,447,1075,1475
0131-002,2014,4,13,22,594,342,936,1075
0131-002,2014,4,13,23,350,251,601,936
0131-002,2014,4,13,24,215,142,357,601
0131-002,2014,4,14,1,120,111,231,357
0131-002,2014,4,14,2,83,68,151,231
0131-002,2014,4,14,3,59,46,105,151
0131-002,2014,4,14,4,70,55,125,105
0131-002,2014,4,14,5,68,95,163,125
0131-002,2014,4,14,6,234,187,421,163
0131-002,2014,4,14,7,800,375,1175,421
0131-002,2014,4,14,8,1684,765,2449,1175
0131-002,2014,4,14,9,1466,935,2401,2449
0131-002,2014,4,14,10,980,814,1794,2401
0131-002,2014,4,14,11,913,895,1808,1794
0131-002,2014,4,14,12,875,853,1728,1808
0131-002,2014,4,14,13,739,783,1522,1728
0131-002,2014,4,14,14,875,864,1739,1522
0131-002,2014,4,14,15,979,950,1929,1739
0131-002,2014,4,14,16,969,950,1919,1929
0131-002,2014,4,14,17,924,919,1843,1919
0131-002,2014,4,14,18,917,1112,2029,1843
0131-002,2014,4,14,19,842,942,1784,2029
0131-002,2014,4,14,20,723,805,1528,1784
0131-002,2014,4,14,21,530,752,1282,1528
0131-002,2014,4,14,22,425,567,992,1282
0131-002,2014,4,14,23,298,349,647,992
0131-002,2014,4,14,24,219,239,458,647
0131-002,2014,4,15,1,134,166,300,458
0131-002,2014,4,15,2,88,124,212,300
0131-002,2014,4,15,3,74,94,168,212
0131-002,2014,4,15,4,86,82,168,168
0131-002,2014,4,15,5,94,125,219,168
0131-002,2014,4,15,6,196,174,370,219
0131-002,2014,4,15,7,668,350,1018,370
0131-002,2014,4,15,8,1501,764,2265,1018
0131-002,2014,4,15,9,1368,954,2322,2265
0131-002,2014,4,15,10,1015,905,1920,2322
0131-002,2014,4,15,11,977,861,1838,1920
0131-002,2014,4,15,12,876,935,1811,1838
0131-002,2014,4,15,13,794,761,1555,1811
0131-002,2014,4,15,14,803,856,1659,1555
0131-002,2014,4,15,15,988,1018,2006,1659
0131-002,2014,4,15,16,957,1007,1964,2006
0131-002,2014,4,15,17,874,931,1805,1964
0131-002,2014,4,15,18,884,1064,1948,1805
0131-002,2014,4,15,19,872,1053,1925,1948
0131-002,2014,4,15,20,681,753,1434,1925
0131-002,2014,4,15,21,533,724,1257,1434
0131-002,2014,4,15,22,423,536,959,1257
0131-002,2014,4,15,23,307,328,635,959
0131-002,2014,4,15,24,208,231,439,635
0131-002,2014,4,16,1,131,174,305,439
0131-002,2014,4,16,2,111,116,227,305
0131-002,2014,4,16,3,79,118,197,227
0131-002,2014,4,16,4,80,76,156,197
0131-002,2014,4,16,5,99,124,223,156
0131-002,2014,4,16,6,175,188,363,223
0131-002,2014,4,16,7,659,347,1006,363
0131-002,2014,4,16,8,1417,752,2169,1006
0131-002,2014,4,16,9,1358,913,2271,2169
0131-002,2014,4,16,10,974,890,1864,2271
0131-002,2014,4,16,11,958,828,1786,1864
0131-002,2014,4,16,12,903,856,1759,1786
0131-002,2014,4,16,13,731,849,1580,1759
0131-002,2014,4,16,14,858,883,1741,1580
0131-002,2014,4,16,15,939,889,1828,1741
0131-002,2014,4,16,16,971,983,1954,1828
0131-002,2014,4,16,17,898,991,1889,1954
0131-002,2014,4,16,18,926,1119,2045,1889
0131-002,2014,4,16,19,914,1064,1978,2045
0131-002,2014,4,16,20,685,778,1463,1978
0131-002,2014,4,16,21,493,656,1149,1463
0131-002,2014,4,16,22,442,565,1007,1149
0131-002,2014,4,16,23,305,365,670,1007
0131-002,2014,4,16,24,211,245,456,670
0131-002,2014,4,17,1,145,168,313,456
0131-002,2014,4,17,2,103,116,219,313
0131-002,2014,4,17,3,80,102,182,219
0131-002,2014,4,17,4,76,79,155,182
0131-002,2014,4,17,5,116,111,227,155
0131-002,2014,4,17,6,200,159,359,227
0131-002,2014,4,17,7,673,351,1024,359
0131-002,2014,4,17,8,1409,752,2161,1024
0131-002,2014,4,17,9,1345,913,2258,2161
0131-002,2014,4,17,10,981,823,1804,2258
0131-002,2014,4,17,11,914,937,1851,1804
0131-002,2014,4,17,12,910,877,1787,1851
0131-002,2014,4,17,13,732,767,1499,1787
0131-002,2014,4,17,14,898,834,1732,1499
0131-002,2014,4,17,15,990,934,1924,1732
0131-002,2014,4,17,16,883,923,1806,1924
0131-002,2014,4,17,17,805,920,1725,1806
0131-002,2014,4,17,18,847,1109,1956,1725
0131-002,2014,4,17,19,838,1108,1946,1956
0131-002,2014,4,17,20,638,842,1480,1946
0131-002,2014,4,17,21,504,754,1258,1480
0131-002,2014,4,17,22,448,489,937,1258
0131-002,2014,4,17,23,320,334,654,937
0131-002,2014,4,17,24,168,234,402,654
0131-002,2014,4,18,1,144,146,290,402
0131-002,2014,4,18,2,89,90,179,290
0131-002,2014,4,18,3,53,87,140,179
0131-002,2014,4,18,4,66,71,137,140
0131-002,2014,4,18,5,111,133,244,137
0131-002,2014,4,18,6,197,181,378,244
0131-002,2014,4,18,7,670,353,1023,378
0131-002,2014,4,18,8,1373,726,2099,1023
0131-002,2014,4,18,9,1354,973,2327,2099
0131-002,2014,4,18,10,927,891,1818,2327
0131-002,2014,4,18,11,976,947,1923,1818
0131-002,2014,4,18,12,925,935,1860,1923
0131-002,2014,4,18,13,709,777,1486,1860
0131-002,2014,4,18,14,832,879,1711,1486
0131-002,2014,4,18,15,961,946,1907,1711
0131-002,2014,4,18,16,939,994,1933,1907
0131-002,2014,4,18,17,865,974,1839,1933
0131-002,2014,4,18,18,935,1159,2094,1839
0131-002,2014,4,18,19,952,1104,2056,2094
0131-002,2014,4,18,20,793,912,1705,2056
0131-002,2014,4,18,21,579,781,1360,1705
0131-002,2014,4,18,22,455,553,1008,1360
0131-002,2014,4,18,23,311,438,749,1008
0131-002,2014,4,18,24,254,242,496,749
0131-002,2014,4,19,1,160,186,346,496
0131-002,2014,4,19,2,120,130,250,346
0131-002,2014,4,19,3,83,99,182,250
0131-002,2014,4,19,4,86,84,170,182
0131-002,2014,4,19,5,101,131,232,170
0131-002,2014,4,19,6,201,158,359,232
0131-002,2014,4,19,7,482,303,785,359
0131-002,2014,4,19,8,784,555,1339,785
0131-002,2014,4,19,9,802,813,1615,1339
0131-002,2014,4,19,10,735,813,1548,1615
0131-002,2014,4,19,11,775,874,1649,1548
0131-002,2014,4,19,12,772,854,1626,1649
0131-002,2014,4,19,13,679,794,1473,1626
0131-002,2014,4,19,14,726,762,1488,1473
0131-002,2014,4,19,15,758,750,1508,1488
0131-002,2014,4,19,16,769,778,1547,1508
0131-002,2014,4,19,17,772,808,1580,1547
0131-002,2014,4,19,18,900,826,1726,1580
0131-002,2014,4,19,19,825,796,1621,1726
0131-002,2014,4,19,20,588,571,1159,1621
0131-002,2014,4,19,21,440,484,924,1159
0131-002,2014,4,19,22,375,388,763,924
0131-002,2014,4,19,23,262,296,558,763
0131-002,2014,4,19,24,197,200,397,558
0131-002,2014,4,20,1,132,147,279,397
0131-002,2014,4,20,2,106,94,200,279
0131-002,2014,4,20,3,64,83,147,200
0131-002,2014,4,20,4,56,59,115,147
0131-002,2014,4,20,5,71,77,148,115
0131-002,2014,4,20,6,118,98,216,148
0131-002,2014,4,20,7,224,190,414,216
0131-002,2014,4,20,8,369,372,741,414
0131-002,2014,4,20,9,389,493,882,741
0131-002,2014,4,20,10,428,464,892,882
0131-002,2014,4,20,11,521,531,1052,892
0131-002,2014,4,20,12,571,510,1081,1052
0131-002,2014,4,20,13,511,561,1072,1081
0131-002,2014,4,20,14,535,557,1092,1072
0131-002,2014,4,20,15,633,605,1238,1092
0131-002,2014,4,20,16,712,622,1334,1238
0131-002,2014,4,20,17,864,654,1518,1334
0131-002,2014,4,20,18,901,653,1554,1518
0131-002,2014,4,20,19,813,617,1430,1554
0131-002,2014,4,20,20,657,488,1145,1430
0131-002,2014,4,20,21,554,397,951,1145
0131-002,2014,4,20,22,441,327,768,951
0131-002,2014,4,20,23,317,232,549,768
0131-002,2014,4,20,24,199,160,359,549
0131-002,2014,4,21,1,133,93,226,359
0131-002,2014,4,21,2,80,69,149,226
0131-002,2014,4,21,3,59,59,118,149
0131-002,2014,4,21,4,76,51,127,118
0131-002,2014,4,21,5,83,93,176,127
0131-002,2014,4,21,6,236,172,408,176
0131-002,2014,4,21,7,790,389,1179,408
0131-002,2014,4,21,8,1649,825,2474,1179
0131-002,2014,4,21,9,1364,921,2285,2474
0131-002,2014,4,21,10,999,914,1913,2285
0131-002,2014,4,21,11,994,898,1892,1913
0131-002,2014,4,21,12,883,930,1813,1892
0131-002,2014,4,21,13,786,800,1586,1813
0131-002,2014,4,21,14,848,841,1689,1586
0131-002,2014,4,21,15,1020,1017,2037,1689
0131-002,2014,4,21,16,967,981,1948,2037
0131-002,2014,4,21,17,868,925,1793,1948
0131-002,2014,4,21,18,889,1032,1921,1793
0131-002,2014,4,21,19,859,926,1785,1921
0131-002,2014,4,21,20,660,832,1492,1785
0131-002,2014,4,21,21,494,726,1220,1492
0131-002,2014,4,21,22,442,532,974,1220
0131-002,2014,4,21,23,245,358,603,974
0131-002,2014,4,21,24,181,226,407,603
0131-002,2014,4,22,1,160,156,316,407
0131-002,2014,4,22,2,97,99,196,316
0131-002,2014,4,22,3,75,96,171,196
0131-002,2014,4,22,4,82,69,151,171
0131-002,2014,4,22,5,101,123,224,151
0131-002,2014,4,22,6,238,180,418,224
0131-002,2014,4,22,7,677,355,1032,418
0131-002,2014,4,22,8,1456,732,2188,1032
0131-002,2014,4,22,9,1311,971,2282,2188
0131-002,2014,4,22,10,995,894,1889,2282
0131-002,2014,4,22,11,966,935,1901,1889
0131-002,2014,4,22,12,901,959,1860,1901
0131-002,2014,4,22,13,785,801,1586,1860
0131-002,2014,4,22,14,892,934,1826,1586
0131-002,2014,4,22,15,921,1030,1951,1826
0131-002,2014,4,22,16,951,992,1943,1951
0131-002,2014,4,22,17,876,945,1821,1943
0131-002,2014,4,22,18,914,1049,1963,1821
0131-002,2014,4,22,19,832,925,1757,1963
0131-002,2014,4,22,20,674,773,1447,1757
0131-002,2014,4,22,21,503,719,1222,1447
0131-002,2014,4,22,22,456,583,1039,1222
0131-002,2014,4,22,23,288,335,623,1039
0131-002,2014,4,22,24,223,234,457,623
0131-002,2014,4,23,1,164,156,320,457
0131-002,2014,4,23,2,100,102,202,320
0131-002,2014,4,23,3,78,93,171,202
0131-002,2014,4,23,4,71,91,162,171
0131-002,2014,4,23,5,79,116,195,162
0131-002,2014,4,23,6,204,160,364,195
0131-002,2014,4,23,7,695,363,1058,364
0131-002,2014,4,23,8,1434,734,2168,1058
0131-002,2014,4,23,9,1327,946,2273,2168
0131-002,2014,4,23,10,971,848,1819,2273
0131-002,2014,4,23,11,992,901,1893,1819
0131-002,2014,4,23,12,865,846,1711,1893
0131-002,2014,4,23,13,761,792,1553,1711
0131-002,2014,4,23,14,840,848,1688,1553
0131-002,2014,4,23,15,1025,894,1919,1688
0131-002,2014,4,23,16,869,960,1829,1919
0131-002,2014,4,23,17,861,957,1818,1829
0131-002,2014,4,23,18,836,1138,1974,1818
0131-002,2014,4,23,19,924,1008,1932,1974
0131-002,2014,4,23,20,681,809,1490,1932
0131-002,2014,4,23,21,484,662,1146,1490
0131-002,2014,4,23,22,444,528,972,1146
0131-002,2014,4,23,23,290,361,651,972
0131-002,2014,4,23,24,218,242,460,651
0131-002,2014,4,24,1,153,156,309,460
0131-002,2014,4,24,2,108,134,242,309
0131-002,2014,4,24,3,71,78,149,242
0131-002,2014,4,24,4,80,90,170,149
0131-002,2014,4,24,5,113,115,228,170
0131-002,2014,4,24,6,235,167,402,228
0131-002,2014,4,24,7,676,353,1029,402
0131-002,2014,4,24,8,1467,772,2239,1029
0131-002,2014,4,24,9,1314,965,2279,2239
0131-002,2014,4,24,10,1004,893,1897,2279
0131-002,2014,4,24,11,971,951,1922,1897
0131-002,2014,4,24,12,895,877,1772,1922
0131-002,2014,4,24,13,744,816,1560,1772
0131-002,2014,4,24,14,830,883,1713,1560
0131-002,2014,4,24,15,962,999,1961,1713
0131-002,2014,4,24,16,958,941,1899,1961
0131-002,2014,4,24,17,906,933,1839,1899
0131-002,2014,4,24,18,913,1035,1948,1839
0131-002,2014,4,24,19,849,1010,1859,1948
0131-002,2014,4,24,20,656,831,1487,1859
0131-002,2014,4,24,21,517,714,1231,1487
0131-002,2014,4,24,22,421,556,977,1231
0131-002,2014,4,24,23,334,381,715,977
0131-002,2014,4,24,24,241,239,480,715
0131-002,2014,4,25,1,163,187,350,480
0131-002,2014,4,25,2,95,100,195,350
0131-002,2014,4,25,3,82,100,182,195
0131-002,2014,4,25,4,75,69,144,182
0131-002,2014,4,25,5,101,103,204,144
0131-002,2014,4,25,6,205,180,385,204
0131-002,2014,4,25,7,728,391,1119,385
0131-002,2014,4,25,8,1435,754,2189,1119
0131-002,2014,4,25,9,1266,938,2204,2189
0131-002,2014,4,25,10,919,850,1769,2204
0131-002,2014,4,25,11,975,934,1909,1769
0131-002,2014,4,25,12,971,887,1858,1909
0131-002,2014,4,25,13,776,776,1552,1858
0131-002,2014,4,25,14,778,832,1610,1552
0131-002,2014,4,25,15,929,965,1894,1610
0131-002,2014,4,25,16,978,981,1959,1894
0131-002,2014,4,25,17,897,984,1881,1959
0131-002,2014,4,25,18,910,1170,2080,1881
0131-002,2014,4,25,19,991,1021,2012,2080
0131-002,2014,4,25,20,806,904,1710,2012
0131-002,2014,4,25,21,601,757,1358,1710
0131-002,2014,4,25,22,465,586,1051,1358
0131-002,2014,4,25,23,327,421,748,1051
0131-002,2014,4,25,24,232,266,498,748
0131-002,2014,4,26,1,178,188,366,498
0131-002,2014,4,26,2,142,155,297,366
0131-002,2014,4,26,3,97,108,205,297
0131-002,2014,4,26,4,96,98,194,205
0131-002,2014,4,26,5,126,148,274,194
0131-002,2014,4,26,6,224,190,414,274
0131-002,2014,4,26,7,526,344,870,414
0131-002,2014,4,26,8,813,571,1384,870
0131-002,2014,4,26,9,861,716,1577,1384
0131-002,2014,4,26,10,825,806,1631,1577
0131-002,2014,4,26,11,785,832,1617,1631
0131-002,2014,4,26,12,835,807,1642,1617
0131-002,2014,4,26,13,717,814,1531,1642
0131-002,2014,4,26,14,790,744,1534,1531
0131-002,2014,4,26,15,801,815,1616,1534
0131-002,2014,4,26,16,763,765,1528,1616
0131-002,2014,4,26,17,844,872,1716,1528
0131-002,2014,4,26,18,932,934,1866,1716
0131-002,2014,4,26,19,899,822,1721,1866
0131-002,2014,4,26,20,600,529,1129,1721
0131-002,2014,4,26,21,485,517,1002,1129
0131-002,2014,4,26,22,398,412,810,1002
0131-002,2014,4,26,23,252,307,559,810
0131-002,2014,4,26,24,182,187,369,559
0131-002,2014,4,27,1,129,155,284,369
0131-002,2014,4,27,2,109,126,235,284
0131-002,2014,4,27,3,59,78,137,235
0131-002,2014,4,27,4,61,77,138,137
0131-002,2014,4,27,5,52,58,110,138
0131-002,2014,4,27,6,68,87,155,110
0131-002,2014,4,27,7,168,139,307,155
0131-002,2014,4,27,8,294,258,552,307
0131-002,2014,4,27,9,305,315,620,552
0131-002,2014,4,27,10,351,399,750,620
0131-002,2014,4,27,11,434,447,881,750
0131-002,2014,4,27,12,467,461,928,881
0131-002,2014,4,27,13,487,494,981,928
0131-002,2014,4,27,14,500,568,1068,981
0131-002,2014,4,27,15,543,593,1136,1068
0131-002,2014,4,27,16,655,609,1264,1136
0131-002,2014,4,27,17,672,617,1289,1264
0131-002,2014,4,27,18,729,617,1346,1289
0131-002,2014,4,27,19,688,540,1228,1346
0131-002,2014,4,27,20,561,499,1060,1228
0131-002,2014,4,27,21,448,412,860,1060
0131-002,2014,4,27,22,394,350,744,860
0131-002,2014,4,27,23,275,211,486,744
0131-002,2014,4,27,24,174,156,330,486
0131-002,2014,4,28,1,122,107,229,330
0131-002,2014,4,28,2,91,54,145,229
0131-002,2014,4,28,3,61,60,121,145
0131-002,2014,4,28,4,53,54,107,121
0131-002,2014,4,28,5,66,83,149,107
0131-002,2014,4,28,6,200,144,344,149
0131-002,2014,4,28,7,650,345,995,344
0131-002,2014,4,28,8,1523,854,2377,995
0131-002,2014,4,28,9,1345,999,2344,2377
0131-002,2014,4,28,10,919,877,1796,2344
0131-002,2014,4,28,11,896,863,1759,1796
0131-002,2014,4,28,12,786,820,1606,1759
0131-002,2014,4,28,13,752,770,1522,1606
0131-002,2014,4,28,14,820,882,1702,1522
0131-002,2014,4,28,15,893,936,1829,1702
0131-002,2014,4,28,16,892,976,1868,1829
0131-002,2014,4,28,17,831,943,1774,1868
0131-002,2014,4,28,18,812,992,1804,1774
0131-002,2014,4,28,19,798,922,1720,1804
0131-002,2014,4,28,20,611,764,1375,1720
0131-002,2014,4,28,21,482,701,1183,1375
0131-002,2014,4,28,22,393,614,1007,1183
0131-002,2014,4,28,23,267,353,620,1007
0131-002,2014,4,28,24,173,235,408,620
0131-002,2014,4,29,1,124,155,279,408
0131-002,2014,4,29,2,98,106,204,279
0131-002,2014,4,29,3,70,84,154,204
0131-002,2014,4,29,4,82,86,168,154
0131-002,2014,4,29,5,91,100,191,168
0131-002,2014,4,29,6,188,171,359,191
0131-002,2014,4,29,7,571,341,912,359
0131-002,2014,4,29,8,1355,796,2151,912
0131-002,2014,4,29,9,1212,1039,2251,2151
0131-002,2014,4,29,10,989,911,1900,2251
0131-002,2014,4,29,11,979,975,1954,1900
0131-002,2014,4,29,12,907,911,1818,1954
0131-002,2014,4,29,13,752,781,1533,1818
0131-002,2014,4,29,14,932,881,1813,1533
0131-002,2014,4,29,15,961,982,1943,1813
0131-002,2014,4,29,16,981,1025,2006,1943
0131-002,2014,4,29,17,891,950,1841,2006
0131-002,2014,4,29,18,819,1017,1836,1841
0131-002,2014,4,29,19,777,982,1759,1836
0131-002,2014,4,29,20,670,800,1470,1759
0131-002,2014,4,29,21,540,757,1297,1470
0131-002,2014,4,29,22,414,543,957,1297
0131-002,2014,4,29,23,269,345,614,957
0131-002,2014,4,29,24,245,239,484,614
0131-002,2014,4,30,1,139,147,286,484
0131-002,2014,4,30,2,102,112,214,286
0131-002,2014,4,30,3,102,98,200,214
0131-002,2014,4,30,4,93,82,175,200
0131-002,2014,4,30,5,86,133,219,175
0131-002,2014,4,30,6,244,187,431,219
0131-002,2014,4,30,7,695,396,1091,431
0131-002,2014,4,30,8,1477,751,2228,1091
0131-002,2014,4,30,9,1365,902,2267,2228
0131-002,2014,4,30,10,988,871,1859,2267
0131-002,2014,4,30,11,983,934,1917,1859
0131-002,2014,4,30,12,918,927,1845,1917
0131-002,2014,4,30,13,790,780,1570,1845
0131-002,2014,4,30,14,848,915,1763,1570
0131-002,2014,4,30,15,1012,974,1986,1763
0131-002,2014,4,30,16,980,1010,1990,1986
0131-002,2014,4,30,17,870,976,1846,1990
0131-002,2014,4,30,18,922,1119,2041,1846
0131-002,2014,4,30,19,967,1067,2034,2041
0131-002,2014,4,30,20,756,863,1619,2034
0131-002,2014,4,30,21,579,737,1316,1619
0131-002,2014,4,30,22,451,567,1018,1316
0131-002,2014,4,30,23,319,350,669,1018
0131-002,2014,4,30,24,224,255,479,669
0131-002,2014,5,1,1,148,187,335,479
0131-002,2014,5,1,2,125,141,266,335
0131-002,2014,5,1,3,76,102,178,266
0131-002,2014,5,1,4,84,94,178,178
0131-002,2014,5,1,5,84,134,218,178
0131-002,2014,5,1,6,168,194,362,218
0131-002,2014,5,1,7,487,333,820,362
0131-002,2014,5,1,8,972,607,1579,820
0131-002,2014,5,1,9,980,808,1788,1579
0131-002,2014,5,1,10,755,767,1522,1788
0131-002,2014,5,1,11,817,794,1611,1522
0131-002,2014,5,1,12,772,776,1548,1611
0131-002,2014,5,1,13,643,737,1380,1548
0131-002,2014,5,1,14,769,725,1494,1380
0131-002,2014,5,1,15,765,798,1563,1494
0131-002,2014,5,1,16,762,737,1499,1563
0131-002,2014,5,1,17,699,768,1467,1499
0131-002,2014,5,1,18,779,846,1625,1467
0131-002,2014,5,1,19,672,759,1431,1625
0131-002,2014,5,1,20,522,592,1114,1431
0131-002,2014,5,1,21,432,505,937,1114
0131-002,2014,5,1,22,388,416,804,937
0131-002,2014,5,1,23,271,286,557,804
0131-002,2014,5,1,24,190,205,395,557
0131-002,2014,5,2,1,128,115,243,395
0131-002,2014,5,2,2,101,70,171,243
0131-002,2014,5,2,3,61,67,128,171
0131-002,2014,5,2,4,71,78,149,128
0131-002,2014,5,2,5,80,103,183,149
0131-002,2014,5,2,6,251,164,415,183
0131-002,2014,5,2,7,663,355,1018,415
0131-002,2014,5,2,8,1320,722,2042,1018
0131-002,2014,5,2,9,1157,849,2006,2042
0131-002,2014,5,2,10,862,820,1682,2006
0131-002,2014,5,2,11,909,902,1811,1682
0131-002,2014,5,2,12,886,886,1772,1811
0131-002,2014,5,2,13,679,806,1485,1772
0131-002,2014,5,2,14,837,888,1725,1485
0131-002,2014,5,2,15,969,967,1936,1725
0131-002,2014,5,2,16,938,967,1905,1936
0131-002,2014,5,2,17,898,1065,1963,1905
0131-002,2014,5,2,18,889,1364,2253,1963
0131-002,2014,5,2,19,871,1238,2109,2253
0131-002,2014,5,2,20,755,861,1616,2109
0131-002,2014,5,2,21,583,767,1350,1616
0131-002,2014,5,2,22,440,581,1021,1350
0131-002,2014,5,2,23,350,472,822,1021
0131-002,2014,5,2,24,219,267,486,822
0131-002,2014,5,3,1,165,186,351,486
0131-002,2014,5,3,2,101,123,224,351
0131-002,2014,5,3,3,103,87,190,224
0131-002,2014,5,3,4,76,85,161,190
0131-002,2014,5,3,5,104,124,228,161
0131-002,2014,5,3,6,216,189,405,228
0131-002,2014,5,3,7,484,363,847,405
0131-002,2014,5,3,8,777,632,1409,847
0131-002,2014,5,3,9,778,965,1743,1409
0131-002,2014,5,3,10,791,1113,1904,1743
0131-002,2014,5,3,11,846,1290,2136,1904
0131-002,2014,5,3,12,807,1155,1962,2136
0131-002,2014,5,3,13,740,1180,1920,1962
0131-002,2014,5,3,14,933,866,1799,1920
0131-002,2014,5,3,15,936,895,1831,1799
0131-002,2014,5,3,16,856,1032,1888,1831
0131-002,2014,5,3,17,831,1228,2059,1888
0131-002,2014,5,3,18,864,1528,2392,2059
0131-002,2014,5,3,19,1047,1310,2357,2392
0131-002,2014,5,3,20,902,1141,2043,2357
0131-002,2014,5,3,21,642,1071,1713,2043
0131-002,2014,5,3,22,506,949,1455,1713
0131-002,2014,5,3,23,293,526,819,1455
0131-002,2014,5,3,24,193,296,489,819
0131-002,2014,5,4,1,106,148,254,489
0131-002,2014,5,4,2,77,96,173,254
0131-002,2014,5,4,3,77,86,163,173
0131-002,2014,5,4,4,43,43,86,163
0131-002,2014,5,4,5,47,87,134,86
0131-002,2014,5,4,6,98,130,228,134
0131-002,2014,5,4,7,270,183,453,228
0131-002,2014,5,4,8,332,349,681,453
0131-002,2014,5,4,9,372,500,872,681
0131-002,2014,5,4,10,468,726,1194,872
0131-002,2014,5,4,11,520,852,1372,1194
0131-002,2014,5,4,12,571,848,1419,1372
0131-002,2014,5,4,13,497,865,1362,1419
0131-002,2014,5,4,14,555,923,1478,1362
0131-002,2014,5,4,15,566,798,1364,1478
0131-002,2014,5,4,16,732,879,1611,1364
0131-002,2014,5,4,17,763,915,1678,1611
0131-002,2014,5,4,18,955,856,1811,1678
0131-002,2014,5,4,19,1006,753,1759,1811
0131-002,2014,5,4,20,870,590,1460,1759
0131-002,2014,5,4,21,962,487,1449,1460
0131-002,2014,5,4,22,627,372,999,1449
0131-002,2014,5,4,23,671,291,962,999
0131-002,2014,5,4,24,487,143,630,962
0131-002,2014,5,5,1,200,107,307,630
0131-002,2014,5,5,2,99,67,166,307
0131-002,2014,5,5,3,52,44,96,166
0131-002,2014,5,5,4,60,48,108,96
0131-002,2014,5,5,5,71,79,150,108
0131-002,2014,5,5,6,176,118,294,150
0131-002,2014,5,5,7,360,247,607,294
0131-002,2014,5,5,8,493,351,844,607
0131-002,2014,5,5,9,461,446,907,844
0131-002,2014,5,5,10,546,585,1131,907
0131-002,2014,5,5,11,709,658,1367,1131
0131-002,2014,5,5,12,762,699,1461,1367
0131-002,2014,5,5,13,797,657,1454,1461
0131-002,2014,5,5,14,764,622,1386,1454
0131-002,2014,5,5,15,794,664,1458,1386
0131-002,2014,5,5,16,910,693,1603,1458
0131-002,2014,5,5,17,994,698,1692,1603
0131-002,2014,5,5,18,933,695,1628,1692
0131-002,2014,5,5,19,923,692,1615,1628
0131-002,2014,5,5,20,921,542,1463,1615
0131-002,2014,5,5,21,917,436,1353,1463
0131-002,2014,5,5,22,1006,387,1393,1353
0131-002,2014,5,5,23,857,302,1159,1393
0131-002,2014,5,5,24,893,214,1107,1159
0131-002,2014,5,6,1,712,165,877,1107
0131-002,2014,5,6,2,547,109,656,877
0131-002,2014,5,6,3,684,63,747,656
0131-002,2014,5,6,4,130,75,205,747
0131-002,2014,5,6,5,79,72,151,205
0131-002,2014,5,6,6,189,128,317,151
0131-002,2014,5,6,7,389,230,619,317
0131-002,2014,5,6,8,595,405,1000,619
0131-002,2014,5,6,9,555,509,1064,1000
0131-002,2014,5,6,10,626,584,1210,1064
0131-002,2014,5,6,11,866,616,1482,1210
0131-002,2014,5,6,12,858,618,1476,1482
0131-002,2014,5,6,13,866,583,1449,1476
0131-002,2014,5,6,14,833,646,1479,1449
0131-002,2014,5,6,15,993,620,1613,1479
0131-002,2014,5,6,16,1019,705,1724,1613
0131-002,2014,5,6,17,992,671,1663,1724
0131-002,2014,5,6,18,907,695,1602,1663
0131-002,2014,5,6,19,868,676,1544,1602
0131-002,2014,5,6,20,605,525,1130,1544
0131-002,2014,5,6,21,473,470,943,1130
0131-002,2014,5,6,22,416,382,798,943
0131-002,2014,5,6,23,293,229,522,798
0131-002,2014,5,6,24,203,170,373,522
0131-002,2014,5,7,1,148,111,259,373
0131-002,2014,5,7,2,61,66,127,259
0131-002,2014,5,7,3,49,42,91,127
0131-002,2014,5,7,4,60,56,116,91
0131-002,2014,5,7,5,73,95,168,116
0131-002,2014,5,7,6,243,166,409,168
0131-002,2014,5,7,7,757,375,1132,409
0131-002,2014,5,7,8,1653,775,2428,1132
0131-002,2014,5,7,9,1358,943,2301,2428
0131-002,2014,5,7,10,904,818,1722,2301
0131-002,2014,5,7,11,941,950,1891,1722
0131-002,2014,5,7,12,913,907,1820,1891
0131-002,2014,5,7,13,764,825,1589,1820
0131-002,2014,5,7,14,890,857,1747,1589
0131-002,2014,5,7,15,984,913,1897,1747
0131-002,2014,5,7,16,935,926,1861,1897
0131-002,2014,5,7,17,895,1048,1943,1861
0131-002,2014,5,7,18,956,1042,1998,1943
0131-002,2014,5,7,19,909,1046,1955,1998
0131-002,2014,5,7,20,682,773,1455,1955
0131-002,2014,5,7,21,519,745,1264,1455
0131-002,2014,5,7,22,451,606,1057,1264
0131-002,2014,5,7,23,320,419,739,1057
0131-002,2014,5,7,24,212,220,432,739
0131-002,2014,5,8,1,155,172,327,432
0131-002,2014,5,8,2,73,82,155,327
0131-002,2014,5,8,3,89,76,165,155
0131-002,2014,5,8,4,72,98,170,165
0131-002,2014,5,8,5,95,115,210,170
0131-002,2014,5,8,6,205,191,396,210
0131-002,2014,5,8,7,613,337,950,396
0131-002,2014,5,8,8,1444,804,2248,950
0131-002,2014,5,8,9,1419,975,2394,2248
0131-002,2014,5,8,10,1033,866,1899,2394
0131-002,2014,5,8,11,1035,919,1954,1899
0131-002,2014,5,8,12,976,942,1918,1954
0131-002,2014,5,8,13,782,839,1621,1918
0131-002,2014,5,8,14,873,889,1762,1621
0131-002,2014,5,8,15,978,962,1940,1762
0131-002,2014,5,8,16,940,995,1935,1940
0131-002,2014,5,8,17,999,969,1968,1935
0131-002,2014,5,8,18,920,1035,1955,1968
0131-002,2014,5,8,19,929,1059,1988,1955
0131-002,2014,5,8,20,771,788,1559,1988
0131-002,2014,5,8,21,574,789,1363,1559
0131-002,2014,5,8,22,453,631,1084,1363
0131-002,2014,5,8,23,332,415,747,1084
0131-002,2014,5,8,24,192,223,415,747
0131-002,2014,5,9,1,129,163,292,415
0131-002,2014,5,9,2,91,93,184,292
0131-002,2014,5,9,3,74,74,148,184
0131-002,2014,5,9,4,70,76,146,148
0131-002,2014,5,9,5,86,107,193,146
0131-002,2014,5,9,6,244,196,440,193
0131-002,2014,5,9,7,665,380,1045,440
0131-002,2014,5,9,8,1542,785,2327,1045
0131-002,2014,5,9,9,1334,895,2229,2327
0131-002,2014,5,9,10,980,858,1838,2229
0131-002,2014,5,9,11,962,862,1824,1838
0131-002,2014,5,9,12,924,934,1858,1824
0131-002,2014,5,9,13,797,801,1598,1858
0131-002,2014,5,9,14,859,865,1724,1598
0131-002,2014,5,9,15,969,955,1924,1724
0131-002,2014,5,9,16,968,1010,1978,1924
0131-002,2014,5,9,17,919,1047,1966,1978
0131-002,2014,5,9,18,961,1206,2167,1966
0131-002,2014,5,9,19,1030,1153,2183,2167
0131-002,2014,5,9,20,809,937,1746,2183
0131-002,2014,5,9,21,568,815,1383,1746
0131-002,2014,5,9,22,466,589,1055,1383
0131-002,2014,5,9,23,350,416,766,1055
0131-002,2014,5,9,24,254,275,529,766
0131-002,2014,5,10,1,163,202,365,529
0131-002,2014,5,10,2,119,148,267,365
0131-002,2014,5,10,3,85,98,183,267
0131-002,2014,5,10,4,97,125,222,183
0131-002,2014,5,10,5,92,118,210,222
0131-002,2014,5,10,6,243,197,440,210
0131-002,2014,5,10,7,512,341,853,440
0131-002,2014,5,10,8,853,576,1429,853
0131-002,2014,5,10,9,876,757,1633,1429
0131-002,2014,5,10,10,806,817,1623,1633
0131-002,2014,5,10,11,846,838,1684,1623
0131-002,2014,5,10,12,813,907,1720,1684
0131-002,2014,5,10,13,768,751,1519,1720
0131-002,2014,5,10,14,819,716,1535,1519
0131-002,2014,5,10,15,817,831,1648,1535
0131-002,2014,5,10,16,726,790,1516,1648
0131-002,2014,5,10,17,790,838,1628,1516
0131-002,2014,5,10,18,895,900,1795,1628
0131-002,2014,5,10,19,819,833,1652,1795
0131-002,2014,5,10,20,601,571,1172,1652
0131-002,2014,5,10,21,464,525,989,1172
0131-002,2014,5,10,22,411,445,856,989
0131-002,2014,5,10,23,295,324,619,856
0131-002,2014,5,10,24,206,228,434,619
0131-002,2014,5,11,1,136,158,294,434
0131-002,2014,5,11,2,98,102,200,294
0131-002,2014,5,11,3,76,83,159,200
0131-002,2014,5,11,4,63,61,124,159
0131-002,2014,5,11,5,58,72,130,124
0131-002,2014,5,11,6,120,109,229,130
0131-002,2014,5,11,7,268,205,473,229
0131-002,2014,5,11,8,367,307,674,473
0131-002,2014,5,11,9,366,385,751,674
0131-002,2014,5,11,10,395,465,860,751
0131-002,2014,5,11,11,500,517,1017,860
0131-002,2014,5,11,12,471,550,1021,1017
0131-002,2014,5,11,13,477,479,956,1021
0131-002,2014,5,11,14,563,548,1111,956
0131-002,2014,5,11,15,567,585,1152,1111
0131-002,2014,5,11,16,699,606,1305,1152
0131-002,2014,5,11,17,716,633,1349,1305
0131-002,2014,5,11,18,739,685,1424,1349
0131-002,2014,5,11,19,754,579,1333,1424
0131-002,2014,5,11,20,534,510,1044,1333
0131-002,2014,5,11,21,440,429,869,1044
0131-002,2014,5,11,22,379,312,691,869
0131-002,2014,5,11,23,272,206,478,691
0131-002,2014,5,11,24,176,147,323,478
0131-002,2014,5,12,1,121,100,221,323
0131-002,2014,5,12,2,75,51,126,221
0131-002,2014,5,12,3,48,39,87,126
0131-002,2014,5,12,4,47,47,94,87
0131-002,2014,5,12,5,75,85,160,94
0131-002,2014,5,12,6,194,175,369,160
0131-002,2014,5,12,7,686,323,1009,369
0131-002,2014,5,12,8,1625,817,2442,1009
0131-002,2014,5,12,9,1418,935,2353,2442
0131-002,2014,5,12,10,954,840,1794,2353
0131-002,2014,5,12,11,934,911,1845,1794
0131-002,2014,5,12,12,913,868,1781,1845
0131-002,2014,5,12,13,798,791,1589,1781
0131-002,2014,5,12,14,969,840,1809,1589
0131-002,2014,5,12,15,983,930,1913,1809
0131-002,2014,5,12,16,994,1000,1994,1913
0131-002,2014,5,12,17,907,990,1897,1994
0131-002,2014,5,12,18,787,1084,1871,1897
0131-002,2014,5,12,19,891,965,1856,1871
0131-002,2014,5,12,20,681,844,1525,1856
0131-002,2014,5,12,21,560,759,1319,1525
0131-002,2014,5,12,22,483,589,1072,1319
0131-002,2014,5,12,23,318,390,708,1072
0131-002,2014,5,12,24,245,280,525,708
0131-002,2014,5,13,1,140,179,319,525
0131-002,2014,5,13,2,79,135,214,319
0131-002,2014,5,13,3,92,91,183,214
0131-002,2014,5,13,4,81,109,190,183
0131-002,2014,5,13,5,107,139,246,190
0131-002,2014,5,13,6,251,194,445,246
0131-002,2014,5,13,7,798,382,1180,445
0131-002,2014,5,13,8,1454,814,2268,1180
0131-002,2014,5,13,9,1292,982,2274,2268
0131-002,2014,5,13,10,978,914,1892,2274
0131-002,2014,5,13,11,940,917,1857,1892
0131-002,2014,5,13,12,879,852,1731,1857
0131-002,2014,5,13,13,761,790,1551,1731
0131-002,2014,5,13,14,900,934,1834,1551
0131-002,2014,5,13,15,975,1025,2000,1834
0131-002,2014,5,13,16,917,1110,2027,2000
0131-002,2014,5,13,17,862,1000,1862,2027
0131-002,2014,5,13,18,905,1104,2009,1862
0131-002,2014,5,13,19,868,1015,1883,2009
0131-002,2014,5,13,20,687,821,1508,1883
0131-002,2014,5,13,21,511,724,1235,1508
0131-002,2014,5,13,22,442,594,1036,1235
0131-002,2014,5,13,23,311,404,715,1036
0131-002,2014,5,13,24,194,237,431,715
0131-002,2014,5,14,1,142,168,310,431
0131-002,2014,5,14,2,105,116,221,310
0131-002,2014,5,14,3,62,99,161,221
0131-002,2014,5,14,4,90,83,173,161
0131-002,2014,5,14,5,88,106,194,173
0131-002,2014,5,14,6,235,216,451,194
0131-002,2014,5,14,7,770,398,1168,451
0131-002,2014,5,14,8,1504,809,2313,1168
0131-002,2014,5,14,9,1289,991,2280,2313
0131-002,2014,5,14,10,1022,844,1866,2280
0131-002,2014,5,14,11,983,937,1920,1866
0131-002,2014,5,14,12,954,946,1900,1920
0131-002,2014,5,14,13,773,800,1573,1900
0131-002,2014,5,14,14,945,857,1802,1573
0131-002,2014,5,14,15,964,942,1906,1802
0131-002,2014,5,14,16,922,929,1851,1906
0131-002,2014,5,14,17,823,999,1822,1851
0131-002,2014,5,14,18,934,1140,2074,1822
0131-002,2014,5,14,19,854,993,1847,2074
0131-002,2014,5,14,20,655,751,1406,1847
0131-002,2014,5,14,21,519,689,1208,1406
0131-002,2014,5,14,22,439,528,967,1208
0131-002,2014,5,14,23,292,393,685,967
0131-002,2014,5,14,24,223,229,452,685
0131-002,2014,5,15,1,158,175,333,452
0131-002,2014,5,15,2,89,116,205,333
0131-002,2014,5,15,3,59,70,129,205
0131-002,2014,5,15,4,71,96,167,129
0131-002,2014,5,15,5,110,103,213,167
0131-002,2014,5,15,6,260,208,468,213
0131-002,2014,5,15,7,767,380,1147,468
0131-002,2014,5,15,8,1459,781,2240,1147
0131-002,2014,5,15,9,1254,944,2198,2240
0131-002,2014,5,15,10,919,871,1790,2198
0131-002,2014,5,15,11,976,936,1912,1790
0131-002,2014,5,15,12,873,868,1741,1912
0131-002,2014,5,15,13,713,761,1474,1741
0131-002,2014,5,15,14,881,880,1761,1474
0131-002,2014,5,15,15,964,958,1922,1761
0131-002,2014,5,15,16,951,945,1896,1922
0131-002,2014,5,15,17,826,981,1807,1896
0131-002,2014,5,15,18,910,1027,1937,1807
0131-002,2014,5,15,19,869,976,1845,1937
0131-002,2014,5,15,20,678,775,1453,1845
0131-002,2014,5,15,21,559,695,1254,1453
0131-002,2014,5,15,22,445,544,989,1254
0131-002,2014,5,15,23,297,390,687,989
0131-002,2014,5,15,24,262,263,525,687
0131-002,2014,5,16,1,154,164,318,525
0131-002,2014,5,16,2,112,103,215,318
0131-002,2014,5,16,3,82,94,176,215
0131-002,2014,5,16,4,84,72,156,176
0131-002,2014,5,16,5,112,111,223,156
0131-002,2014,5,16,6,248,202,450,223
0131-002,2014,5,16,7,792,398,1190,450
0131-002,2014,5,16,8,1459,793,2252,1190
0131-002,2014,5,16,9,1295,961,2256,2252
0131-002,2014,5,16,10,924,893,1817,2256
0131-002,2014,5,16,11,1002,968,1970,1817
0131-002,2014,5,16,12,921,841,1762,1970
0131-002,2014,5,16,13,760,836,1596,1762
0131-002,2014,5,16,14,876,852,1728,1596
0131-002,2014,5,16,15,961,997,1958,1728
0131-002,2014,5,16,16,931,978,1909,1958
0131-002,2014,5,16,17,861,954,1815,1909
0131-002,2014,5,16,18,970,1150,2120,1815
0131-002,2014,5,16,19,981,1081,2062,2120
0131-002,2014,5,16,20,808,902,1710,2062
0131-002,2014,5,16,21,604,726,1330,1710
0131-002,2014,5,16,22,465,586,1051,1330
0131-002,2014,5,16,23,333,413,746,1051
0131-002,2014,5,16,24,253,264,517,746
0131-002,2014,5,17,1,139,213,352,517
0131-002,2014,5,17,2,155,162,317,352
0131-002,2014,5,17,3,93,117,210,317
0131-002,2014,5,17,4,107,99,206,210
0131-002,2014,5,17,5,99,125,224,206
0131-002,2014,5,17,6,227,194,421,224
0131-002,2014,5,17,7,540,367,907,421
0131-002,2014,5,17,8,882,572,1454,907
0131-002,2014,5,17,9,882,804,1686,1454
0131-002,2014,5,17,10,801,784,1585,1686
0131-002,2014,5,17,11,850,879,1729,1585
0131-002,2014,5,17,12,760,793,1553,1729
0131-002,2014,5,17,13,754,814,1568,1553
0131-002,2014,5,17,14,741,697,1438,1568
0131-002,2014,5,17,15,804,762,1566,1438
0131-002,2014,5,17,16,779,742,1521,1566
0131-002,2014,5,17,17,758,784,1542,1521
0131-002,2014,5,17,18,926,850,1776,1542
0131-002,2014,5,17,19,854,796,1650,1776
0131-002,2014,5,17,20,581,581,1162,1650
0131-002,2014,5,17,21,451,528,979,1162
0131-002,2014,5,17,22,402,447,849,979
0131-002,2014,5,17,23,265,337,602,849
0131-002,2014,5,17,24,198,218,416,602
0131-002,2014,5,18,1,123,154,277,416
0131-002,2014,5,18,2,114,127,241,277
0131-002,2014,5,18,3,75,79,154,241
0131-002,2014,5,18,4,46,59,105,154
0131-002,2014,5,18,5,75,72,147,105
0131-002,2014,5,18,6,139,143,282,147
0131-002,2014,5,18,7,251,216,467,282
0131-002,2014,5,18,8,389,300,689,467
0131-002,2014,5,18,9,353,417,770,689
0131-002,2014,5,18,10,443,487,930,770
0131-002,2014,5,18,11,480,600,1080,930
0131-002,2014,5,18,12,524,560,1084,1080
0131-002,2014,5,18,13,499,566,1065,1084
0131-002,2014,5,18,14,583,550,1133,1065
0131-002,2014,5,18,15,625,610,1235,1133
0131-002,2014,5,18,16,663,616,1279,1235
0131-002,2014,5,18,17,674,647,1321,1279
0131-002,2014,5,18,18,826,713,1539,1321
0131-002,2014,5,18,19,812,604,1416,1539
0131-002,2014,5,18,20,584,543,1127,1416
0131-002,2014,5,18,21,510,443,953,1127
0131-002,2014,5,18,22,438,414,852,953
0131-002,2014,5,18,23,328,250,578,852
0131-002,2014,5,18,24,221,157,378,578
0131-002,2014,5,19,1,109,96,205,378
0131-002,2014,5,19,2,82,55,137,205
0131-002,2014,5,19,3,56,55,111,137
0131-002,2014,5,19,4,66,58,124,111
0131-002,2014,5,19,5,95,99,194,124
0131-002,2014,5,19,6,338,203,541,194
0131-002,2014,5,19,7,882,424,1306,541
0131-002,2014,5,19,8,1704,794,2498,1306
0131-002,2014,5,19,9,1285,930,2215,2498
0131-002,2014,5,19,10,923,921,1844,2215
0131-002,2014,5,19,11,940,915,1855,1844
0131-002,2014,5,19,12,887,869,1756,1855
0131-002,2014,5,19,13,757,773,1530,1756
0131-002,2014,5,19,14,942,849,1791,1530
0131-002,2014,5,19,15,1002,952,1954,1791
0131-002,2014,5,19,16,1013,989,2002,1954
0131-002,2014,5,19,17,870,934,1804,2002
0131-002,2014,5,19,18,901,1068,1969,1804
0131-002,2014,5,19,19,858,986,1844,1969
0131-002,2014,5,19,20,653,769,1422,1844
0131-002,2014,5,19,21,450,687,1137,1422
0131-002,2014,5,19,22,430,524,954,1137
0131-002,2014,5,19,23,291,347,638,954
0131-002,2014,5,19,24,213,211,424,638
0131-002,2014,5,20,1,133,146,279,424
0131-002,2014,5,20,2,101,96,197,279
0131-002,2014,5,20,3,66,92,158,197
0131-002,2014,5,20,4,83,87,170,158
0131-002,2014,5,20,5,112,140,252,170
0131-002,2014,5,20,6,287,204,491,252
0131-002,2014,5,20,7,748,405,1153,491
0131-002,2014,5,20,8,1513,797,2310,1153
0131-002,2014,5,20,9,1272,931,2203,2310
0131-002,2014,5,20,10,1005,866,1871,2203
0131-002,2014,5,20,11,982,887,1869,1871
0131-002,2014,5,20,12,862,881,1743,1869
0131-002,2014,5,20,13,735,799,1534,1743
0131-002,2014,5,20,14,871,823,1694,1534
0131-002,2014,5,20,15,1000,931,1931,1694
0131-002,2014,5,20,16,866,941,1807,1931
0131-002,2014,5,20,17,885,928,1813,1807
0131-002,2014,5,20,18,861,1126,1987,1813
0131-002,2014,5,20,19,853,965,1818,1987
0131-002,2014,5,20,20,672,738,1410,1818
0131-002,2014,5,20,21,577,709,1286,1410
0131-002,2014,5,20,22,412,553,965,1286
0131-002,2014,5,20,23,295,345,640,965
0131-002,2014,5,20,24,212,206,418,640
0131-002,2014,5,21,1,148,164,312,418
0131-002,2014,5,21,2,100,99,199,312
0131-002,2014,5,21,3,67,87,154,199
0131-002,2014,5,21,4,64,80,144,154
0131-002,2014,5,21,5,116,111,227,144
0131-002,2014,5,21,6,289,226,515,227
0131-002,2014,5,21,7,791,391,1182,515
0131-002,2014,5,21,8,1494,790,2284,1182
0131-002,2014,5,21,9,1313,951,2264,2284
0131-002,2014,5,21,10,971,822,1793,2264
0131-002,2014,5,21,11,965,906,1871,1793
0131-002,2014,5,21,12,891,934,1825,1871
0131-002,2014,5,21,13,705,774,1479,1825
0131-002,2014,5,21,14,844,868,1712,1479
0131-002,2014,5,21,15,943,973,1916,1712
0131-002,2014,5,21,16,953,946,1899,1916
0131-002,2014,5,21,17,864,967,1831,1899
0131-002,2014,5,21,18,940,1062,2002,1831
0131-002,2014,5,21,19,925,989,1914,2002
0131-002,2014,5,21,20,637,758,1395,1914
0131-002,2014,5,21,21,529,652,1181,1395
0131-002,2014,5,21,22,440,556,996,1181
0131-002,2014,5,21,23,291,369,660,996
0131-002,2014,5,21,24,207,256,463,660
0131-002,2014,5,22,1,165,165,330,463
0131-002,2014,5,22,2,97,120,217,330
0131-002,2014,5,22,3,78,79,157,217
0131-002,2014,5,22,4,71,82,153,157
0131-002,2014,5,22,5,118,128,246,153
0131-002,2014,5,22,6,316,200,516,246
0131-002,2014,5,22,7,780,440,1220,516
0131-002,2014,5,22,8,1511,793,2304,1220
0131-002,2014,5,22,9,1317,944,2261,2304
0131-002,2014,5,22,10,1023,844,1867,2261
0131-002,2014,5,22,11,914,918,1832,1867
0131-002,2014,5,22,12,919,886,1805,1832
0131-002,2014,5,22,13,744,801,1545,1805
0131-002,2014,5,22,14,884,831,1715,1545
0131-002,2014,5,22,15,982,976,1958,1715
0131-002,2014,5,22,16,870,987,1857,1958
0131-002,2014,5,22,17,906,977,1883,1857
0131-002,2014,5,22,18,936,1050,1986,1883
0131-002,2014,5,22,19,888,973,1861,1986
0131-002,2014,5,22,20,663,804,1467,1861
0131-002,2014,5,22,21,483,773,1256,1467
0131-002,2014,5,22,22,454,542,996,1256
0131-002,2014,5,22,23,312,409,721,996
0131-002,2014,5,22,24,229,238,467,721
0131-002,2014,5,23,1,147,182,329,467
0131-002,2014,5,23,2,118,118,236,329
0131-002,2014,5,23,3,63,93,156,236
0131-002,2014,5,23,4,76,75,151,156
0131-002,2014,5,23,5,107,128,235,151
0131-002,2014,5,23,6,278,228,506,235
0131-002,2014,5,23,7,778,384,1162,506
0131-002,2014,5,23,8,1484,760,2244,1162
0131-002,2014,5,23,9,1300,969,2269,2244
0131-002,2014,5,23,10,925,914,1839,2269
0131-002,2014,5,23,11,946,938,1884,1839
0131-002,2014,5,23,12,861,913,1774,1884
0131-002,2014,5,23,13,748,845,1593,1774
0131-002,2014,5,23,14,862,877,1739,1593
0131-002,2014,5,23,15,961,952,1913,1739
0131-002,2014,5,23,16,991,987,1978,1913
0131-002,2014,5,23,17,942,1018,1960,1978
0131-002,2014,5,23,18,986,1202,2188,1960
0131-002,2014,5,23,19,993,1096,2089,2188
0131-002,2014,5,23,20,797,873,1670,2089
0131-002,2014,5,23,21,512,772,1284,1670
0131-002,2014,5,23,22,444,620,1064,1284
0131-002,2014,5,23,23,327,411,738,1064
0131-002,2014,5,23,24,237,251,488,738
0131-002,2014,5,24,1,178,182,360,488
0131-002,2014,5,24,2,135,140,275,360
0131-002,2014,5,24,3,110,111,221,275
0131-002,2014,5,24,4,93,93,186,221
0131-002,2014,5,24,5,115,116,231,186
0131-002,2014,5,24,6,301,206,507,231
0131-002,2014,5,24,7,582,383,965,507
0131-002,2014,5,24,8,930,565,1495,965
0131-002,2014,5,24,9,848,783,1631,1495
0131-002,2014,5,24,10,805,853,1658,1631
0131-002,2014,5,24,11,796,877,1673,1658
0131-002,2014,5,24,12,818,805,1623,1673
0131-002,2014,5,24,13,721,781,1502,1623
0131-002,2014,5,24,14,731,733,1464,1502
0131-002,2014,5,24,15,763,790,1553,1464
0131-002,2014,5,24,16,741,736,1477,1553
0131-002,2014,5,24,17,762,824,1586,1477
0131-002,2014,5,24,18,843,872,1715,1586
0131-002,2014,5,24,19,848,767,1615,1715
0131-002,2014,5,24,20,599,576,1175,1615
0131-002,2014,5,24,21,449,485,934,1175
0131-002,2014,5,24,22,346,420,766,934
0131-002,2014,5,24,23,275,260,535,766
0131-002,2014,5,24,24,168,197,365,535
0131-002,2014,5,25,1,136,162,298,365
0131-002,2014,5,25,2,105,107,212,298
0131-002,2014,5,25,3,66,84,150,212
0131-002,2014,5,25,4,62,87,149,150
0131-002,2014,5,25,5,66,92,158,149
0131-002,2014,5,25,6,126,138,264,158
0131-002,2014,5,25,7,284,211,495,264
0131-002,2014,5,25,8,398,347,745,495
0131-002,2014,5,25,9,391,465,856,745
0131-002,2014,5,25,10,423,491,914,856
0131-002,2014,5,25,11,486,553,1039,914
0131-002,2014,5,25,12,503,512,1015,1039
0131-002,2014,5,25,13,524,592,1116,1015
0131-002,2014,5,25,14,588,555,1143,1116
0131-002,2014,5,25,15,631,591,1222,1143
0131-002,2014,5,25,16,705,632,1337,1222
0131-002,2014,5,25,17,817,645,1462,1337
0131-002,2014,5,25,18,848,625,1473,1462
0131-002,2014,5,25,19,764,500,1264,1473
0131-002,2014,5,25,20,618,472,1090,1264
0131-002,2014,5,25,21,480,411,891,1090
0131-002,2014,5,25,22,380,325,705,891
0131-002,2014,5,25,23,277,211,488,705
0131-002,2014,5,25,24,168,148,316,488
0131-002,2014,5,26,1,112,85,197,316
0131-002,2014,5,26,2,60,56,116,197
0131-002,2014,5,26,3,58,31,89,116
0131-002,2014,5,26,4,66,54,120,89
0131-002,2014,5,26,5,81,85,166,120
0131-002,2014,5,26,6,276,194,470,166
0131-002,2014,5,26,7,865,390,1255,470
0131-002,2014,5,26,8,1696,828,2524,1255
0131-002,2014,5,26,9,1371,926,2297,2524
0131-002,2014,5,26,10,968,844,1812,2297
0131-002,2014,5,26,11,928,880,1808,1812
0131-002,2014,5,26,12,841,869,1710,1808
0131-002,2014,5,26,13,718,812,1530,1710
0131-002,2014,5,26,14,847,862,1709,1530
0131-002,2014,5,26,15,980,944,1924,1709
0131-002,2014,5,26,16,931,931,1862,1924
0131-002,2014,5,26,17,875,920,1795,1862
0131-002,2014,5,26,18,889,1006,1895,1795
0131-002,2014,5,26,19,808,944,1752,1895
0131-002,2014,5,26,20,685,746,1431,1752
0131-002,2014,5,26,21,532,756,1288,1431
0131-002,2014,5,26,22,444,594,1038,1288
0131-002,2014,5,26,23,290,367,657,1038
0131-002,2014,5,26,24,223,232,455,657
0131-002,2014,5,27,1,130,188,318,455
0131-002,2014,5,27,2,105,103,208,318
0131-002,2014,5,27,3,94,85,179,208
0131-002,2014,5,27,4,75,92,167,179
0131-002,2014,5,27,5,124,131,255,167
0131-002,2014,5,27,6,296,232,528,255
0131-002,2014,5,27,7,835,395,1230,528
0131-002,2014,5,27,8,1527,792,2319,1230
0131-002,2014,5,27,9,1288,990,2278,2319
0131-002,2014,5,27,10,982,951,1933,2278
0131-002,2014,5,27,11,953,931,1884,1933
0131-002,2014,5,27,12,784,936,1720,1884
0131-002,2014,5,27,13,706,781,1487,1720
0131-002,2014,5,27,14,861,882,1743,1487
0131-002,2014,5,27,15,942,1023,1965,1743
0131-002,2014,5,27,16,955,998,1953,1965
0131-002,2014,5,27,17,877,994,1871,1953
0131-002,2014,5,27,18,885,1112,1997,1871
0131-002,2014,5,27,19,908,1057,1965,1997
0131-002,2014,5,27,20,678,797,1475,1965
0131-002,2014,5,27,21,490,801,1291,1475
0131-002,2014,5,27,22,468,589,1057,1291
0131-002,2014,5,27,23,276,363,639,1057
0131-002,2014,5,27,24,224,224,448,639
0131-002,2014,5,28,1,139,176,315,448
0131-002,2014,5,28,2,109,120,229,315
0131-002,2014,5,28,3,82,95,177,229
0131-002,2014,5,28,4,85,87,172,177
0131-002,2014,5,28,5,90,101,191,172
0131-002,2014,5,28,6,289,239,528,191
0131-002,2014,5,28,7,770,387,1157,528
0131-002,2014,5,28,8,1533,797,2330,1157
0131-002,2014,5,28,9,1315,955,2270,2330
0131-002,2014,5,28,10,997,911,1908,2270
0131-002,2014,5,28,11,958,1011,1969,1908
0131-002,2014,5,28,12,927,869,1796,1969
0131-002,2014,5,28,13,745,813,1558,1796
0131-002,2014,5,28,14,898,968,1866,1558
0131-002,2014,5,28,15,975,1024,1999,1866
0131-002,2014,5,28,16,970,942,1912,1999
0131-002,2014,5,28,17,889,939,1828,1912
0131-002,2014,5,28,18,945,1128,2073,1828
0131-002,2014,5,28,19,932,986,1918,2073
0131-002,2014,5,28,20,682,769,1451,1918
0131-002,2014,5,28,21,545,695,1240,1451
0131-002,2014,5,28,22,413,590,1003,1240
0131-002,2014,5,28,23,283,421,704,1003
0131-002,2014,5,28,24,201,247,448,704
0131-002,2014,5,29,1,150,170,320,448
0131-002,2014,5,29,2,101,94,195,320
0131-002,2014,5,29,3,64,69,133,195
0131-002,2014,5,29,4,65,110,175,133
0131-002,2014,5,29,5,119,132,251,175
0131-002,2014,5,29,6,282,198,480,251
0131-002,2014,5,29,7,776,391,1167,480
0131-002,2014,5,29,8,1596,782,2378,1167
0131-002,2014,5,29,9,1310,973,2283,2378
0131-002,2014,5,29,10,970,946,1916,2283
0131-002,2014,5,29,11,974,934,1908,1916
0131-002,2014,5,29,12,902,923,1825,1908
0131-002,2014,5,29,13,728,762,1490,1825
0131-002,2014,5,29,14,890,881,1771,1490
0131-002,2014,5,29,15,939,1019,1958,1771
0131-002,2014,5,29,16,919,962,1881,1958
0131-002,2014,5,29,17,830,1001,1831,1881
0131-002,2014,5,29,18,950,1121,2071,1831
0131-002,2014,5,29,19,928,1034,1962,2071
0131-002,2014,5,29,20,649,830,1479,1962
0131-002,2014,5,29,21,575,752,1327,1479
0131-002,2014,5,29,22,435,605,1040,1327
0131-002,2014,5,29,23,354,383,737,1040
0131-002,2014,5,29,24,267,215,482,737
0131-002,2014,5,30,1,163,163,326,482
0131-002,2014,5,30,2,99,116,215,326
0131-002,2014,5,30,3,80,88,168,215
0131-002,2014,5,30,4,80,82,162,168
0131-002,2014,5,30,5,106,116,222,162
0131-002,2014,5,30,6,308,243,551,222
0131-002,2014,5,30,7,770,415,1185,551
0131-002,2014,5,30,8,1612,809,2421,1185
0131-002,2014,5,30,9,1281,967,2248,2421
0131-002,2014,5,30,10,958,931,1889,2248
0131-002,2014,5,30,11,945,911,1856,1889
0131-002,2014,5,30,12,899,905,1804,1856
0131-002,2014,5,30,13,713,846,1559,1804
0131-002,2014,5,30,14,841,897,1738,1559
0131-002,2014,5,30,15,951,969,1920,1738
0131-002,2014,5,30,16,926,982,1908,1920
0131-002,2014,5,30,17,911,970,1881,1908
0131-002,2014,5,30,18,948,1119,2067,1881
0131-002,2014,5,30,19,951,1090,2041,2067
0131-002,2014,5,30,20,862,874,1736,2041
0131-002,2014,5,30,21,612,785,1397,1736
0131-002,2014,5,30,22,401,636,1037,1397
0131-002,2014,5,30,23,360,401,761,1037
0131-002,2014,5,30,24,219,256,475,761
0131-002,2014,5,31,1,189,210,399,475
0131-002,2014,5,31,2,123,159,282,399
0131-002,2014,5,31,3,86,127,213,282
0131-002,2014,5,31,4,101,94,195,213
0131-002,2014,5,31,5,118,126,244,195
0131-002,2014,5,31,6,289,228,517,244
0131-002,2014,5,31,7,583,357,940,517
0131-002,2014,5,31,8,898,590,1488,940
0131-002,2014,5,31,9,839,745,1584,1488
0131-002,2014,5,31,10,796,933,1729,1584
0131-002,2014,5,31,11,804,906,1710,1729
0131-002,2014,5,31,12,707,852,1559,1710
0131-002,2014,5,31,13,742,800,1542,1559
0131-002,2014,5,31,14,766,766,1532,1542
0131-002,2014,5,31,15,843,782,1625,1532
0131-002,2014,5,31,16,780,816,1596,1625
0131-002,2014,5,31,17,842,828,1670,1596
0131-002,2014,5,31,18,838,945,1783,1670
0131-002,2014,5,31,19,816,788,1604,1783
0131-002,2014,5,31,20,597,543,1140,1604
0131-002,2014,5,31,21,461,552,1013,1140
0131-002,2014,5,31,22,415,403,818,1013
0131-002,2014,5,31,23,312,327,639,818
0131-002,2014,5,31,24,201,216,417,639
0131-002,2014,6,1,1,140,136,276,417
0131-002,2014,6,1,2,107,113,220,276
0131-002,2014,6,1,3,65,74,139,220
0131-002,2014,6,1,4,56,58,114,139
0131-002,2014,6,1,5,74,68,142,114
0131-002,2014,6,1,6,176,135,311,142
0131-002,2014,6,1,7,282,189,471,311
0131-002,2014,6,1,8,374,276,650,471
0131-002,2014,6,1,9,407,352,759,650
0131-002,2014,6,1,10,424,459,883,759
0131-002,2014,6,1,11,478,504,982,883
0131-002,2014,6,1,12,541,491,1032,982
0131-002,2014,6,1,13,533,470,1003,1032
0131-002,2014,6,1,14,535,498,1033,1003
0131-002,2014,6,1,15,586,543,1129,1033
0131-002,2014,6,1,16,702,580,1282,1129
0131-002,2014,6,1,17,780,578,1358,1282
0131-002,2014,6,1,18,760,611,1371,1358
0131-002,2014,6,1,19,778,523,1301,1371
0131-002,2014,6,1,20,562,444,1006,1301
0131-002,2014,6,1,21,542,393,935,1006
0131-002,2014,6,1,22,459,298,757,935
0131-002,2014,6,1,23,291,200,491,757
0131-002,2014,6,1,24,203,125,328,491
0131-002,2014,6,2,1,129,84,213,328
0131-002,2014,6,2,2,68,66,134,213
0131-002,2014,6,2,3,51,43,94,134
0131-002,2014,6,2,4,67,62,129,94
0131-002,2014,6,2,5,123,82,205,129
0131-002,2014,6,2,6,326,179,505,205
0131-002,2014,6,2,7,912,401,1313,505
0131-002,2014,6,2,8,1761,745,2506,1313
0131-002,2014,6,2,9,1341,809,2150,2506
0131-002,2014,6,2,10,997,804,1801,2150
0131-002,2014,6,2,11,878,859,1737,1801
0131-002,2014,6,2,12,854,889,1743,1737
0131-002,2014,6,2,13,748,756,1504,1743
0131-002,2014,6,2,14,917,781,1698,1504
0131-002,2014,6,2,15,1040,842,1882,1698
0131-002,2014,6,2,16,901,884,1785,1882
0131-002,2014,6,2,17,905,881,1786,1785
0131-002,2014,6,2,18,840,957,1797,1786
0131-002,2014,6,2,19,815,909,1724,1797
0131-002,2014,6,2,20,613,701,1314,1724
0131-002,2014,6,2,21,492,666,1158,1314
0131-002,2014,6,2,22,427,495,922,1158
0131-002,2014,6,2,23,288,314,602,922
0131-002,2014,6,2,24,172,176,348,602
0131-002,2014,6,3,1,148,147,295,348
0131-002,2014,6,3,2,105,87,192,295
0131-002,2014,6,3,3,80,72,152,192
0131-002,2014,6,3,4,74,67,141,152
0131-002,2014,6,3,5,120,93,213,141
0131-002,2014,6,3,6,216,180,396,213
0131-002,2014,6,3,7,642,318,960,396
0131-002,2014,6,3,8,1401,758,2159,960
0131-002,2014,6,3,9,1271,912,2183,2159
0131-002,2014,6,3,10,910,829,1739,2183
0131-002,2014,6,3,11,849,826,1675,1739
0131-002,2014,6,3,12,839,777,1616,1675
0131-002,2014,6,3,13,754,686,1440,1616
0131-002,2014,6,3,14,806,757,1563,1440
0131-002,2014,6,3,15,970,870,1840,1563
0131-002,2014,6,3,16,901,891,1792,1840
0131-002,2014,6,3,17,902,897,1799,1792
0131-002,2014,6,3,18,836,1012,1848,1799
0131-002,2014,6,3,19,907,1023,1930,1848
0131-002,2014,6,3,20,665,787,1452,1930
0131-002,2014,6,3,21,506,707,1213,1452
0131-002,2014,6,3,22,439,515,954,1213
0131-002,2014,6,3,23,315,339,654,954
0131-002,2014,6,3,24,214,195,409,654
0131-002,2014,6,4,1,181,182,363,409
0131-002,2014,6,4,2,121,107,228,363
0131-002,2014,6,4,3,101,82,183,228
0131-002,2014,6,4,4,89,90,179,183
0131-002,2014,6,4,5,131,100,231,179
0131-002,2014,6,4,6,254,165,419,231
0131-002,2014,6,4,7,518,263,781,419
0131-002,2014,6,4,8,938,507,1445,781
0131-002,2014,6,4,9,916,634,1550,1445
0131-002,2014,6,4,10,902,719,1621,1550
0131-002,2014,6,4,11,833,736,1569,1621
0131-002,2014,6,4,12,791,735,1526,1569
0131-002,2014,6,4,13,697,686,1383,1526
0131-002,2014,6,4,14,808,714,1522,1383
0131-002,2014,6,4,15,808,729,1537,1522
0131-002,2014,6,4,16,780,743,1523,1537
0131-002,2014,6,4,17,742,794,1536,1523
0131-002,2014,6,4,18,773,818,1591,1536
0131-002,2014,6,4,19,729,662,1391,1591
0131-002,2014,6,4,20,537,539,1076,1391
0131-002,2014,6,4,21,493,489,982,1076
0131-002,2014,6,4,22,370,394,764,982
0131-002,2014,6,4,23,287,279,566,764
0131-002,2014,6,4,24,175,170,345,566
0131-002,2014,6,5,1,143,123,266,345
0131-002,2014,6,5,2,73,66,139,266
0131-002,2014,6,5,3,81,57,138,139
0131-002,2014,6,5,4,75,92,167,138
0131-002,2014,6,5,5,109,113,222,167
0131-002,2014,6,5,6,305,165,470,222
0131-002,2014,6,5,7,801,374,1175,470
0131-002,2014,6,5,8,1434,665,2099,1175
0131-002,2014,6,5,9,1220,783,2003,2099
0131-002,2014,6,5,10,948,771,1719,2003
0131-002,2014,6,5,11,941,844,1785,1719
0131-002,2014,6,5,12,890,776,1666,1785
0131-002,2014,6,5,13,772,696,1468,1666
0131-002,2014,6,5,14,947,801,1748,1468
0131-002,2014,6,5,15,1004,891,1895,1748
0131-002,2014,6,5,16,969,832,1801,1895
0131-002,2014,6,5,17,949,906,1855,1801
0131-002,2014,6,5,18,914,1048,1962,1855
0131-002,2014,6,5,19,936,995,1931,1962
0131-002,2014,6,5,20,756,764,1520,1931
0131-002,2014,6,5,21,557,673,1230,1520
0131-002,2014,6,5,22,480,521,1001,1230
0131-002,2014,6,5,23,339,353,692,1001
0131-002,2014,6,5,24,244,232,476,692
0131-002,2014,6,6,1,160,182,342,476
0131-002,2014,6,6,2,140,112,252,342
0131-002,2014,6,6,3,74,77,151,252
0131-002,2014,6,6,4,85,98,183,151
0131-002,2014,6,6,5,126,122,248,183
0131-002,2014,6,6,6,279,201,480,248
0131-002,2014,6,6,7,563,309,872,480
0131-002,2014,6,6,8,853,519,1372,872
0131-002,2014,6,6,9,749,740,1489,1372
0131-002,2014,6,6,10,744,812,1556,1489
0131-002,2014,6,6,11,769,922,1691,1556
0131-002,2014,6,6,12,734,951,1685,1691
0131-002,2014,6,6,13,671,840,1511,1685
0131-002,2014,6,6,14,703,909,1612,1511
0131-002,2014,6,6,15,709,946,1655,1612
0131-002,2014,6,6,16,775,844,1619,1655
0131-002,2014,6,6,17,747,805,1552,1619
0131-002,2014,6,6,18,815,799,1614,1552
0131-002,2014,6,6,19,741,660,1401,1614
0131-002,2014,6,6,20,702,536,1238,1401
0131-002,2014,6,6,21,533,506,1039,1238
0131-002,2014,6,6,22,385,376,761,1039
0131-002,2014,6,6,23,287,280,567,761
0131-002,2014,6,6,24,188,190,378,567
0131-002,2014,6,7,1,110,131,241,378
0131-002,2014,6,7,2,93,93,186,241
0131-002,2014,6,7,3,64,61,125,186
0131-002,2014,6,7,4,83,57,140,125
0131-002,2014,6,7,5,103,91,194,140
0131-002,2014,6,7,6,263,163,426,194
0131-002,2014,6,7,7,479,263,742,426
0131-002,2014,6,7,8,701,391,1092,742
0131-002,2014,6,7,9,638,583,1221,1092
0131-002,2014,6,7,10,678,595,1273,1221
0131-002,2014,6,7,11,742,634,1376,1273
0131-002,2014,6,7,12,681,619,1300,1376
0131-002,2014,6,7,13,648,601,1249,1300
0131-002,2014,6,7,14,704,585,1289,1249
0131-002,2014,6,7,15,733,615,1348,1289
0131-002,2014,6,7,16,868,660,1528,1348
0131-002,2014,6,7,17,939,646,1585,1528
0131-002,2014,6,7,18,927,700,1627,1585
0131-002,2014,6,7,19,966,642,1608,1627
0131-002,2014,6,7,20,996,481,1477,1608
0131-002,2014,6,7,21,688,440,1128,1477
0131-002,2014,6,7,22,602,349,951,1128
0131-002,2014,6,7,23,443,265,708,951
0131-002,2014,6,7,24,242,189,431,708
0131-002,2014,6,8,1,138,152,290,431
0131-002,2014,6,8,2,88,101,189,290
0131-002,2014,6,8,3,62,59,121,189
0131-002,2014,6,8,4,49,59,108,121
0131-002,2014,6,8,5,81,69,150,108
0131-002,2014,6,8,6,153,138,291,150
0131-002,2014,6,8,7,291,162,453,291
0131-002,2014,6,8,8,356,255,611,453
0131-002,2014,6,8,9,337,387,724,611
0131-002,2014,6,8,10,381,453,834,724
0131-002,2014,6,8,11,490,505,995,834
0131-002,2014,6,8,12,695,524,1219,995
0131-002,2014,6,8,13,833,532,1365,1219
0131-002,2014,6,8,14,725,600,1325,1365
0131-002,2014,6,8,15,885,577,1462,1325
0131-002,2014,6,8,16,942,624,1566,1462
0131-002,2014,6,8,17,933,633,1566,1566
0131-002,2014,6,8,18,943,647,1590,1566
0131-002,2014,6,8,19,945,584,1529,1590
0131-002,2014,6,8,20,784,527,1311,1529
0131-002,2014,6,8,21,608,441,1049,1311
0131-002,2014,6,8,22,434,358,792,1049
0131-002,2014,6,8,23,324,229,553,792
0131-002,2014,6,8,24,217,165,382,553
0131-002,2014,6,9,1,137,123,260,382
0131-002,2014,6,9,2,74,74,148,260
0131-002,2014,6,9,3,83,62,145,148
0131-002,2014,6,9,4,52,70,122,145
0131-002,2014,6,9,5,119,114,233,122
0131-002,2014,6,9,6,352,219,571,233
0131-002,2014,6,9,7,885,397,1282,571
0131-002,2014,6,9,8,1774,793,2567,1282
0131-002,2014,6,9,9,1280,925,2205,2567
0131-002,2014,6,9,10,963,854,1817,2205
0131-002,2014,6,9,11,942,912,1854,1817
0131-002,2014,6,9,12,879,887,1766,1854
0131-002,2014,6,9,13,778,928,1706,1766
0131-002,2014,6,9,14,871,812,1683,1706
0131-002,2014,6,9,15,951,1003,1954,1683
0131-002,2014,6,9,16,940,930,1870,1954
0131-002,2014,6,9,17,874,910,1784,1870
0131-002,2014,6,9,18,871,1072,1943,1784
0131-002,2014,6,9,19,918,998,1916,1943
0131-002,2014,6,9,20,682,813,1495,1916
0131-002,2014,6,9,21,536,816,1352,1495
0131-002,2014,6,9,22,447,581,1028,1352
0131-002,2014,6,9,23,313,405,718,1028
0131-002,2014,6,9,24,191,262,453,718
0131-002,2014,6,10,1,138,165,303,453
0131-002,2014,6,10,2,85,111,196,303
0131-002,2014,6,10,3,110,85,195,196
0131-002,2014,6,10,4,78,103,181,195
0131-002,2014,6,10,5,121,117,238,181
0131-002,2014,6,10,6,319,207,526,238
0131-002,2014,6,10,7,807,397,1204,526
0131-002,2014,6,10,8,1580,777,2357,1204
0131-002,2014,6,10,9,1262,976,2238,2357
0131-002,2014,6,10,10,1045,936,1981,2238
0131-002,2014,6,10,11,998,909,1907,1981
0131-002,2014,6,10,12,974,913,1887,1907
0131-002,2014,6,10,13,730,857,1587,1887
0131-002,2014,6,10,14,914,947,1861,1587
0131-002,2014,6,10,15,993,1011,2004,1861
0131-002,2014,6,10,16,983,939,1922,2004
0131-002,2014,6,10,17,885,960,1845,1922
0131-002,2014,6,10,18,877,1165,2042,1845
0131-002,2014,6,10,19,864,1149,2013,2042
0131-002,2014,6,10,20,663,969,1632,2013
0131-002,2014,6,10,21,576,834,1410,1632
0131-002,2014,6,10,22,434,586,1020,1410
0131-002,2014,6,10,23,297,373,670,1020
0131-002,2014,6,10,24,204,245,449,670
0131-002,2014,6,11,1,141,187,328,449
0131-002,2014,6,11,2,99,119,218,328
0131-002,2014,6,11,3,88,99,187,218
0131-002,2014,6,11,4,75,96,171,187
0131-002,2014,6,11,5,127,101,228,171
0131-002,2014,6,11,6,276,218,494,228
0131-002,2014,6,11,7,700,372,1072,494
0131-002,2014,6,11,8,1522,814,2336,1072
0131-002,2014,6,11,9,1363,1006,2369,2336
0131-002,2014,6,11,10,1008,856,1864,2369
0131-002,2014,6,11,11,922,946,1868,1864
0131-002,2014,6,11,12,913,911,1824,1868
0131-002,2014,6,11,13,764,812,1576,1824
0131-002,2014,6,11,14,837,826,1663,1576
0131-002,2014,6,11,15,906,1008,1914,1663
0131-002,2014,6,11,16,946,997,1943,1914
0131-002,2014,6,11,17,864,1006,1870,1943
0131-002,2014,6,11,18,853,1070,1923,1870
0131-002,2014,6,11,19,875,991,1866,1923
0131-002,2014,6,11,20,669,785,1454,1866
0131-002,2014,6,11,21,552,720,1272,1454
0131-002,2014,6,11,22,405,543,948,1272
0131-002,2014,6,11,23,315,382,697,948
0131-002,2014,6,11,24,204,236,440,697
0131-002,2014,6,12,1,146,127,273,440
0131-002,2014,6,12,2,100,112,212,273
0131-002,2014,6,12,3,71,90,161,212
0131-002,2014,6,12,4,73,119,192,161
0131-002,2014,6,12,5,106,125,231,192
0131-002,2014,6,12,6,322,246,568,231
0131-002,2014,6,12,7,833,384,1217,568
0131-002,2014,6,12,8,1549,789,2338,1217
0131-002,2014,6,12,9,1306,929,2235,2338
0131-002,2014,6,12,10,1030,871,1901,2235
0131-002,2014,6,12,11,936,954,1890,1901
0131-002,2014,6,12,12,900,897,1797,1890
0131-002,2014,6,12,13,773,785,1558,1797
0131-002,2014,6,12,14,908,850,1758,1558
0131-002,2014,6,12,15,921,963,1884,1758
0131-002,2014,6,12,16,945,1002,1947,1884
0131-002,2014,6,12,17,914,1121,2035,1947
0131-002,2014,6,12,18,989,1093,2082,2035
0131-002,2014,6,12,19,910,991,1901,2082
0131-002,2014,6,12,20,698,796,1494,1901
0131-002,2014,6,12,21,545,722,1267,1494
0131-002,2014,6,12,22,438,542,980,1267
0131-002,2014,6,12,23,374,414,788,980
0131-002,2014,6,12,24,238,258,496,788
0131-002,2014,6,13,1,168,186,354,496
0131-002,2014,6,13,2,112,125,237,354
0131-002,2014,6,13,3,84,102,186,237
0131-002,2014,6,13,4,82,99,181,186
0131-002,2014,6,13,5,96,136,232,181
0131-002,2014,6,13,6,288,235,523,232
0131-002,2014,6,13,7,775,371,1146,523
0131-002,2014,6,13,8,1514,780,2294,1146
0131-002,2014,6,13,9,1326,954,2280,2294
0131-002,2014,6,13,10,965,922,1887,2280
0131-002,2014,6,13,11,1065,921,1986,1887
0131-002,2014,6,13,12,948,879,1827,1986
0131-002,2014,6,13,13,789,877,1666,1827
0131-002,2014,6,13,14,929,962,1891,1666
0131-002,2014,6,13,15,996,961,1957,1891
0131-002,2014,6,13,16,1029,995,2024,1957
0131-002,2014,6,13,17,947,1030,1977,2024
0131-002,2014,6,13,18,946,1165,2111,1977
0131-002,2014,6,13,19,991,1107,2098,2111
0131-002,2014,6,13,20,801,938,1739,2098
0131-002,2014,6,13,21,604,825,1429,1739
0131-002,2014,6,13,22,468,569,1037,1429
0131-002,2014,6,13,23,372,390,762,1037
0131-002,2014,6,13,24,256,259,515,762
0131-002,2014,6,14,1,170,197,367,515
0131-002,2014,6,14,2,125,142,267,367
0131-002,2014,6,14,3,102,109,211,267
0131-002,2014,6,14,4,84,111,195,211
0131-002,2014,6,14,5,132,130,262,195
0131-002,2014,6,14,6,260,210,470,262
0131-002,2014,6,14,7,610,332,942,470
0131-002,2014,6,14,8,856,573,1429,942
0131-002,2014,6,14,9,858,793,1651,1429
0131-002,2014,6,14,10,805,823,1628,1651
0131-002,2014,6,14,11,795,870,1665,1628
0131-002,2014,6,14,12,725,903,1628,1665
0131-002,2014,6,14,13,739,796,1535,1628
0131-002,2014,6,14,14,754,781,1535,1535
0131-002,2014,6,14,15,798,808,1606,1535
0131-002,2014,6,14,16,824,797,1621,1606
0131-002,2014,6,14,17,779,866,1645,1621
0131-002,2014,6,14,18,892,959,1851,1645
0131-002,2014,6,14,19,857,802,1659,1851
0131-002,2014,6,14,20,594,646,1240,1659
0131-002,2014,6,14,21,519,531,1050,1240
0131-002,2014,6,14,22,415,459,874,1050
0131-002,2014,6,14,23,336,336,672,874
0131-002,2014,6,14,24,191,240,431,672
0131-002,2014,6,15,1,135,171,306,431
0131-002,2014,6,15,2,94,134,228,306
0131-002,2014,6,15,3,69,95,164,228
0131-002,2014,6,15,4,61,79,140,164
0131-002,2014,6,15,5,82,92,174,140
0131-002,2014,6,15,6,150,142,292,174
0131-002,2014,6,15,7,252,205,457,292
0131-002,2014,6,15,8,375,302,677,457
0131-002,2014,6,15,9,389,355,744,677
0131-002,2014,6,15,10,397,468,865,744
0131-002,2014,6,15,11,447,574,1021,865
0131-002,2014,6,15,12,475,483,958,1021
0131-002,2014,6,15,13,470,520,990,958
0131-002,2014,6,15,14,534,582,1116,990
0131-002,2014,6,15,15,592,589,1181,1116
0131-002,2014,6,15,16,694,661,1355,1181
0131-002,2014,6,15,17,733,646,1379,1355
0131-002,2014,6,15,18,826,650,1476,1379
0131-002,2014,6,15,19,776,602,1378,1476
0131-002,2014,6,15,20,619,505,1124,1378
0131-002,2014,6,15,21,548,449,997,1124
0131-002,2014,6,15,22,427,377,804,997
0131-002,2014,6,15,23,332,282,614,804
0131-002,2014,6,15,24,204,179,383,614
0131-002,2014,6,16,1,140,114,254,383
0131-002,2014,6,16,2,97,55,152,254
0131-002,2014,6,16,3,65,48,113,152
0131-002,2014,6,16,4,69,63,132,113
0131-002,2014,6,16,5,109,100,209,132
0131-002,2014,6,16,6,364,229,593,209
0131-002,2014,6,16,7,923,421,1344,593
0131-002,2014,6,16,8,1787,801,2588,1344
0131-002,2014,6,16,9,1291,925,2216,2588
0131-002,2014,6,16,10,955,872,1827,2216
0131-002,2014,6,16,11,912,938,1850,1827
0131-002,2014,6,16,12,901,898,1799,1850
0131-002,2014,6,16,13,770,818,1588,1799
0131-002,2014,6,16,14,905,825,1730,1588
0131-002,2014,6,16,15,1026,974,2000,1730
0131-002,2014,6,16,16,962,1000,1962,2000
0131-002,2014,6,16,17,914,978,1892,1962
0131-002,2014,6,16,18,871,1020,1891,1892
0131-002,2014,6,16,19,843,1021,1864,1891
0131-002,2014,6,16,20,675,806,1481,1864
0131-002,2014,6,16,21,516,703,1219,1481
0131-002,2014,6,16,22,456,525,981,1219
0131-002,2014,6,16,23,274,335,609,981
0131-002,2014,6,16,24,181,255,436,609
0131-002,2014,6,17,1,137,171,308,436
0131-002,2014,6,17,2,106,102,208,308
0131-002,2014,6,17,3,81,91,172,208
0131-002,2014,6,17,4,83,83,166,172
0131-002,2014,6,17,5,132,122,254,166
0131-002,2014,6,17,6,294,234,528,254
0131-002,2014,6,17,7,754,390,1144,528
0131-002,2014,6,17,8,1527,760,2287,1144
0131-002,2014,6,17,9,1318,913,2231,2287
0131-002,2014,6,17,10,1067,919,1986,2231
0131-002,2014,6,17,11,942,930,1872,1986
0131-002,2014,6,17,12,890,864,1754,1872
0131-002,2014,6,17,13,712,789,1501,1754
0131-002,2014,6,17,14,887,853,1740,1501
0131-002,2014,6,17,15,1015,953,1968,1740
0131-002,2014,6,17,16,939,998,1937,1968
0131-002,2014,6,17,17,886,983,1869,1937
0131-002,2014,6,17,18,897,1025,1922,1869
0131-002,2014,6,17,19,881,958,1839,1922
0131-002,2014,6,17,20,693,799,1492,1839
0131-002,2014,6,17,21,525,745,1270,1492
0131-002,2014,6,17,22,472,571,1043,1270
0131-002,2014,6,17,23,311,379,690,1043
0131-002,2014,6,17,24,222,232,454,690
0131-002,2014,6,18,1,146,165,311,454
0131-002,2014,6,18,2,95,101,196,311
0131-002,2014,6,18,3,74,90,164,196
0131-002,2014,6,18,4,71,104,175,164
0131-002,2014,6,18,5,140,124,264,175
0131-002,2014,6,18,6,308,247,555,264
0131-002,2014,6,18,7,933,430,1363,555
0131-002,2014,6,18,8,1422,720,2142,1363
0131-002,2014,6,18,9,1118,838,1956,2142
0131-002,2014,6,18,10,1069,929,1998,1956
0131-002,2014,6,18,11,946,929,1875,1998
0131-002,2014,6,18,12,879,856,1735,1875
0131-002,2014,6,18,13,704,801,1505,1735
0131-002,2014,6,18,14,908,853,1761,1505
0131-002,2014,6,18,15,988,902,1890,1761
0131-002,2014,6,18,16,937,968,1905,1890
0131-002,2014,6,18,17,879,995,1874,1905
0131-002,2014,6,18,18,856,1099,1955,1874
0131-002,2014,6,18,19,891,989,1880,1955
0131-002,2014,6,18,20,726,729,1455,1880
0131-002,2014,6,18,21,499,734,1233,1455
0131-002,2014,6,18,22,400,548,948,1233
0131-002,2014,6,18,23,365,407,772,948
0131-002,2014,6,18,24,206,278,484,772
0131-002,2014,6,19,1,147,179,326,484
0131-002,2014,6,19,2,102,115,217,326
0131-002,2014,6,19,3,88,76,164,217
0131-002,2014,6,19,4,76,91,167,164
0131-002,2014,6,19,5,109,142,251,167
0131-002,2014,6,19,6,288,266,554,251
0131-002,2014,6,19,7,763,398,1161,554
0131-002,2014,6,19,8,1529,776,2305,1161
0131-002,2014,6,19,9,1316,962,2278,2305
0131-002,2014,6,19,10,1000,832,1832,2278
0131-002,2014,6,19,11,949,860,1809,1832
0131-002,2014,6,19,12,805,885,1690,1809
0131-002,2014,6,19,13,795,822,1617,1690
0131-002,2014,6,19,14,945,866,1811,1617
0131-002,2014,6,19,15,994,913,1907,1811
0131-002,2014,6,19,16,973,951,1924,1907
0131-002,2014,6,19,17,836,913,1749,1924
0131-002,2014,6,19,18,950,1018,1968,1749
0131-002,2014,6,19,19,845,1010,1855,1968
0131-002,2014,6,19,20,678,798,1476,1855
0131-002,2014,6,19,21,566,722,1288,1476
0131-002,2014,6,19,22,443,556,999,1288
0131-002,2014,6,19,23,322,405,727,999
0131-002,2014,6,19,24,218,245,463,727
0131-002,2014,6,20,1,128,148,276,463
0131-002,2014,6,20,2,95,104,199,276
0131-002,2014,6,20,3,84,86,170,199
0131-002,2014,6,20,4,89,109,198,170
0131-002,2014,6,20,5,120,136,256,198
0131-002,2014,6,20,6,285,212,497,256
0131-002,2014,6,20,7,757,361,1118,497
0131-002,2014,6,20,8,1517,777,2294,1118
0131-002,2014,6,20,9,1309,903,2212,2294
0131-002,2014,6,20,10,944,887,1831,2212
0131-002,2014,6,20,11,961,949,1910,1831
0131-002,2014,6,20,12,894,922,1816,1910
0131-002,2014,6,20,13,835,821,1656,1816
0131-002,2014,6,20,14,864,888,1752,1656
0131-002,2014,6,20,15,1012,1040,2052,1752
0131-002,2014,6,20,16,948,998,1946,2052
0131-002,2014,6,20,17,924,1033,1957,1946
0131-002,2014,6,20,18,984,1176,2160,1957
0131-002,2014,6,20,19,986,1114,2100,2160
0131-002,2014,6,20,20,844,937,1781,2100
0131-002,2014,6,20,21,596,863,1459,1781
0131-002,2014,6,20,22,489,615,1104,1459
0131-002,2014,6,20,23,349,414,763,1104
0131-002,2014,6,20,24,220,235,455,763
0131-002,2014,6,21,1,144,197,341,455
0131-002,2014,6,21,2,129,136,265,341
0131-002,2014,6,21,3,114,127,241,265
0131-002,2014,6,21,4,97,72,169,241
0131-002,2014,6,21,5,103,102,205,169
0131-002,2014,6,21,6,269,223,492,205
0131-002,2014,6,21,7,522,334,856,492
0131-002,2014,6,21,8,823,551,1374,856
0131-002,2014,6,21,9,833,719,1552,1374
0131-002,2014,6,21,10,775,775,1550,1552
0131-002,2014,6,21,11,785,816,1601,1550
0131-002,2014,6,21,12,783,890,1673,1601
0131-002,2014,6,21,13,731,808,1539,1673
0131-002,2014,6,21,14,782,781,1563,1539
0131-002,2014,6,21,15,782,812,1594,1563
0131-002,2014,6,21,16,779,821,1600,1594
0131-002,2014,6,21,17,769,800,1569,1600
0131-002,2014,6,21,18,906,931,1837,1569
0131-002,2014,6,21,19,832,824,1656,1837
0131-002,2014,6,21,20,543,589,1132,1656
0131-002,2014,6,21,21,465,496,961,1132
0131-002,2014,6,21,22,433,404,837,961
0131-002,2014,6,21,23,308,312,620,837
0131-002,2014,6,21,24,262,213,475,620
0131-002,2014,6,22,1,143,159,302,475
0131-002,2014,6,22,2,92,127,219,302
0131-002,2014,6,22,3,75,84,159,219
0131-002,2014,6,22,4,70,76,146,159
0131-002,2014,6,22,5,92,99,191,146
0131-002,2014,6,22,6,151,160,311,191
0131-002,2014,6,22,7,287,205,492,311
0131-002,2014,6,22,8,395,311,706,492
0131-002,2014,6,22,9,395,412,807,706
0131-002,2014,6,22,10,384,512,896,807
0131-002,2014,6,22,11,514,533,1047,896
0131-002,2014,6,22,12,497,519,1016,1047
0131-002,2014,6,22,13,509,544,1053,1016
0131-002,2014,6,22,14,566,598,1164,1053
0131-002,2014,6,22,15,595,572,1167,1164
0131-002,2014,6,22,16,798,646,1444,1167
0131-002,2014,6,22,17,872,612,1484,1444
0131-002,2014,6,22,18,988,705,1693,1484
0131-002,2014,6,22,19,929,608,1537,1693
0131-002,2014,6,22,20,712,520,1232,1537
0131-002,2014,6,22,21,623,507,1130,1232
0131-002,2014,6,22,22,480,400,880,1130
0131-002,2014,6,22,23,316,235,551,880
0131-002,2014,6,22,24,202,189,391,551
0131-002,2014,6,23,1,120,122,242,391
0131-002,2014,6,23,2,102,64,166,242
0131-002,2014,6,23,3,59,56,115,166
0131-002,2014,6,23,4,81,79,160,115
0131-002,2014,6,23,5,116,106,222,160
0131-002,2014,6,23,6,336,200,536,222
0131-002,2014,6,23,7,901,428,1329,536
0131-002,2014,6,23,8,1706,830,2536,1329
0131-002,2014,6,23,9,1319,928,2247,2536
0131-002,2014,6,23,10,901,858,1759,2247
0131-002,2014,6,23,11,914,912,1826,1759
0131-002,2014,6,23,12,899,880,1779,1826
0131-002,2014,6,23,13,801,752,1553,1779
0131-002,2014,6,23,14,874,862,1736,1553
0131-002,2014,6,23,15,986,967,1953,1736
0131-002,2014,6,23,16,937,970,1907,1953
0131-002,2014,6,23,17,891,901,1792,1907
0131-002,2014,6,23,18,899,1021,1920,1792
0131-002,2014,6,23,19,850,961,1811,1920
0131-002,2014,6,23,20,735,812,1547,1811
0131-002,2014,6,23,21,551,714,1265,1547
0131-002,2014,6,23,22,447,541,988,1265
0131-002,2014,6,23,23,301,396,697,988
0131-002,2014,6,23,24,179,220,399,697
0131-002,2014,6,24,1,154,173,327,399
0131-002,2014,6,24,2,95,122,217,327
0131-002,2014,6,24,3,76,87,163,217
0131-002,2014,6,24,4,85,70,155,163
0131-002,2014,6,24,5,130,127,257,155
0131-002,2014,6,24,6,297,191,488,257
0131-002,2014,6,24,7,747,407,1154,488
0131-002,2014,6,24,8,1578,777,2355,1154
0131-002,2014,6,24,9,1305,985,2290,2355
0131-002,2014,6,24,10,1000,845,1845,2290
0131-002,2014,6,24,11,948,937,1885,1845
0131-002,2014,6,24,12,917,855,1772,1885
0131-002,2014,6,24,13,768,821,1589,1772
0131-002,2014,6,24,14,971,961,1932,1589
0131-002,2014,6,24,15,984,1016,2000,1932
0131-002,2014,6,24,16,972,930,1902,2000
0131-002,2014,6,24,17,888,994,1882,1902
0131-002,2014,6,24,18,931,1011,1942,1882
0131-002,2014,6,24,19,917,939,1856,1942
0131-002,2014,6,24,20,728,836,1564,1856
0131-002,2014,6,24,21,546,737,1283,1564
0131-002,2014,6,24,22,469,600,1069,1283
0131-002,2014,6,24,23,313,371,684,1069
0131-002,2014,6,24,24,218,254,472,684
0131-002,2014,6,25,1,161,150,311,472
0131-002,2014,6,25,2,96,106,202,311
0131-002,2014,6,25,3,70,88,158,202
0131-002,2014,6,25,4,77,103,180,158
0131-002,2014,6,25,5,107,127,234,180
0131-002,2014,6,25,6,298,248,546,234
0131-002,2014,6,25,7,734,407,1141,546
0131-002,2014,6,25,8,1578,783,2361,1141
0131-002,2014,6,25,9,1288,921,2209,2361
0131-002,2014,6,25,10,1028,928,1956,2209
0131-002,2014,6,25,11,941,983,1924,1956
0131-002,2014,6,25,12,898,918,1816,1924
0131-002,2014,6,25,13,777,799,1576,1816
0131-002,2014,6,25,14,865,869,1734,1576
0131-002,2014,6,25,15,938,915,1853,1734
0131-002,2014,6,25,16,914,919,1833,1853
0131-002,2014,6,25,17,896,962,1858,1833
0131-002,2014,6,25,18,809,1107,1916,1858
0131-002,2014,6,25,19,907,935,1842,1916
0131-002,2014,6,25,20,679,767,1446,1842
0131-002,2014,6,25,21,531,697,1228,1446
0131-002,2014,6,25,22,442,533,975,1228
0131-002,2014,6,25,23,333,351,684,975
0131-002,2014,6,25,24,233,228,461,684
0131-002,2014,6,26,1,152,179,331,461
0131-002,2014,6,26,2,97,127,224,331
0131-002,2014,6,26,3,89,95,184,224
0131-002,2014,6,26,4,82,102,184,184
0131-002,2014,6,26,5,99,124,223,184
0131-002,2014,6,26,6,315,203,518,223
0131-002,2014,6,26,7,770,387,1157,518
0131-002,2014,6,26,8,1536,776,2312,1157
0131-002,2014,6,26,9,1309,989,2298,2312
0131-002,2014,6,26,10,971,915,1886,2298
0131-002,2014,6,26,11,945,917,1862,1886
0131-002,2014,6,26,12,943,920,1863,1862
0131-002,2014,6,26,13,773,762,1535,1863
0131-002,2014,6,26,14,908,844,1752,1535
0131-002,2014,6,26,15,970,973,1943,1752
0131-002,2014,6,26,16,971,901,1872,1943
0131-002,2014,6,26,17,864,992,1856,1872
0131-002,2014,6,26,18,966,1063,2029,1856
0131-002,2014,6,26,19,881,945,1826,2029
0131-002,2014,6,26,20,683,759,1442,1826
0131-002,2014,6,26,21,572,724,1296,1442
0131-002,2014,6,26,22,465,582,1047,1296
0131-002,2014,6,26,23,316,399,715,1047
0131-002,2014,6,26,24,233,238,471,715
0131-002,2014,6,27,1,172,179,351,471
0131-002,2014,6,27,2,81,135,216,351
0131-002,2014,6,27,3,98,74,172,216
0131-002,2014,6,27,4,101,115,216,172
0131-002,2014,6,27,5,120,132,252,216
0131-002,2014,6,27,6,264,228,492,252
0131-002,2014,6,27,7,765,383,1148,492
0131-002,2014,6,27,8,1566,865,2431,1148
0131-002,2014,6,27,9,1343,1026,2369,2431
0131-002,2014,6,27,10,993,878,1871,2369
0131-002,2014,6,27,11,887,959,1846,1871
0131-002,2014,6,27,12,954,865,1819,1846
0131-002,2014,6,27,13,804,840,1644,1819
0131-002,2014,6,27,14,899,849,1748,1644
0131-002,2014,6,27,15,1050,959,2009,1748
0131-002,2014,6,27,16,954,953,1907,2009
0131-002,2014,6,27,17,961,999,1960,1907
0131-002,2014,6,27,18,911,1053,1964,1960
0131-002,2014,6,27,19,985,1123,2108,1964
0131-002,2014,6,27,20,829,907,1736,2108
0131-002,2014,6,27,21,595,808,1403,1736
0131-002,2014,6,27,22,520,606,1126,1403
0131-002,2014,6,27,23,339,388,727,1126
0131-002,2014,6,27,24,235,238,473,727
0131-002,2014,6,28,1,167,167,334,473
0131-002,2014,6,28,2,129,166,295,334
0131-002,2014,6,28,3,96,100,196,295
0131-002,2014,6,28,4,99,109,208,196
0131-002,2014,6,28,5,121,117,238,208
0131-002,2014,6,28,6,293,230,523,238
0131-002,2014,6,28,7,557,360,917,523
0131-002,2014,6,28,8,819,588,1407,917
0131-002,2014,6,28,9,850,797,1647,1407
0131-002,2014,6,28,10,844,813,1657,1647
0131-002,2014,6,28,11,886,794,1680,1657
0131-002,2014,6,28,12,780,799,1579,1680
0131-002,2014,6,28,13,791,762,1553,1579
0131-002,2014,6,28,14,797,853,1650,1553
0131-002,2014,6,28,15,796,834,1630,1650
0131-002,2014,6,28,16,800,837,1637,1630
0131-002,2014,6,28,17,768,797,1565,1637
0131-002,2014,6,28,18,855,910,1765,1565
0131-002,2014,6,28,19,757,810,1567,1765
0131-002,2014,6,28,20,592,575,1167,1567
0131-002,2014,6,28,21,464,550,1014,1167
0131-002,2014,6,28,22,455,433,888,1014
0131-002,2014,6,28,23,331,347,678,888
0131-002,2014,6,28,24,186,242,428,678
0131-002,2014,6,29,1,152,189,341,428
0131-002,2014,6,29,2,102,114,216,341
0131-002,2014,6,29,3,71,91,162,216
0131-002,2014,6,29,4,71,63,134,162
0131-002,2014,6,29,5,67,88,155,134
0131-002,2014,6,29,6,157,158,315,155
0131-002,2014,6,29,7,274,181,455,315
0131-002,2014,6,29,8,369,301,670,455
0131-002,2014,6,29,9,371,448,819,670
0131-002,2014,6,29,10,409,497,906,819
0131-002,2014,6,29,11,478,561,1039,906
0131-002,2014,6,29,12,489,571,1060,1039
0131-002,2014,6,29,13,545,616,1161,1060
0131-002,2014,6,29,14,572,572,1144,1161
0131-002,2014,6,29,15,599,602,1201,1144
0131-002,2014,6,29,16,730,662,1392,1201
0131-002,2014,6,29,17,854,626,1480,1392
0131-002,2014,6,29,18,852,663,1515,1480
0131-002,2014,6,29,19,891,533,1424,1515
0131-002,2014,6,29,20,660,467,1127,1424
0131-002,2014,6,29,21,535,485,1020,1127
0131-002,2014,6,29,22,430,347,777,1020
0131-002,2014,6,29,23,290,243,533,777
0131-002,2014,6,29,24,198,160,358,533
0131-002,2014,6,30,1,154,108,262,358
0131-002,2014,6,30,2,73,74,147,262
0131-002,2014,6,30,3,86,53,139,147
0131-002,2014,6,30,4,73,67,140,139
0131-002,2014,6,30,5,111,100,211,140
0131-002,2014,6,30,6,352,244,596,211
0131-002,2014,6,30,7,902,424,1326,596
0131-002,2014,6,30,8,1740,822,2562,1326
0131-002,2014,6,30,9,1302,927,2229,2562
0131-002,2014,6,30,10,907,883,1790,2229
0131-002,2014,6,30,11,985,941,1926,1790
0131-002,2014,6,30,12,937,844,1781,1926
0131-002,2014,6,30,13,771,759,1530,1781
0131-002,2014,6,30,14,855,808,1663,1530
0131-002,2014,6,30,15,970,935,1905,1663
0131-002,2014,6,30,16,962,968,1930,1905
0131-002,2014,6,30,17,878,976,1854,1930
0131-002,2014,6,30,18,875,1116,1991,1854
0131-002,2014,6,30,19,873,1001,1874,1991
0131-002,2014,6,30,20,666,840,1506,1874
0131-002,2014,6,30,21,556,784,1340,1506
0131-002,2014,6,30,22,448,590,1038,1340
0131-002,2014,6,30,23,303,360,663,1038
0131-002,2014,6,30,24,202,219,421,663
0131-002,2014,7,1,1,139,137,276,421
0131-002,2014,7,1,2,102,124,226,276
0131-002,2014,7,1,3,88,77,165,226
0131-002,2014,7,1,4,94,109,203,165
0131-002,2014,7,1,5,116,135,251,203
0131-002,2014,7,1,6,310,230,540,251
0131-002,2014,7,1,7,784,388,1172,540
0131-002,2014,7,1,8,1577,805,2382,1172
0131-002,2014,7,1,9,1249,1005,2254,2382
0131-002,2014,7,1,10,999,903,1902,2254
0131-002,2014,7,1,11,985,844,1829,1902
0131-002,2014,7,1,12,941,846,1787,1829
0131-002,2014,7,1,13,741,765,1506,1787
0131-002,2014,7,1,14,849,859,1708,1506
0131-002,2014,7,1,15,1003,909,1912,1708
0131-002,2014,7,1,16,985,924,1909,1912
0131-002,2014,7,1,17,839,898,1737,1909
0131-002,2014,7,1,18,876,984,1860,1737
0131-002,2014,7,1,19,914,923,1837,1860
0131-002,2014,7,1,20,676,824,1500,1837
0131-002,2014,7,1,21,530,704,1234,1500
0131-002,2014,7,1,22,459,541,1000,1234
0131-002,2014,7,1,23,305,392,697,1000
0131-002,2014,7,1,24,192,251,443,697
0131-002,2014,7,2,1,133,168,301,443
0131-002,2014,7,2,2,91,102,193,301
0131-002,2014,7,2,3,81,95,176,193
0131-002,2014,7,2,4,85,80,165,176
0131-002,2014,7,2,5,112,97,209,165
0131-002,2014,7,2,6,275,237,512,209
0131-002,2014,7,2,7,801,402,1203,512
0131-002,2014,7,2,8,1539,813,2352,1203
0131-002,2014,7,2,9,1308,956,2264,2352
0131-002,2014,7,2,10,1018,899,1917,2264
0131-002,2014,7,2,11,1019,902,1921,1917
0131-002,2014,7,2,12,879,895,1774,1921
0131-002,2014,7,2,13,769,785,1554,1774
0131-002,2014,7,2,14,967,810,1777,1554
0131-002,2014,7,2,15,1041,989,2030,1777
0131-002,2014,7,2,16,913,938,1851,2030
0131-002,2014,7,2,17,897,926,1823,1851
0131-002,2014,7,2,18,951,1132,2083,1823
0131-002,2014,7,2,19,924,1034,1958,2083
0131-002,2014,7,2,20,674,864,1538,1958
0131-002,2014,7,2,21,483,735,1218,1538
0131-002,2014,7,2,22,409,516,925,1218
0131-002,2014,7,2,23,295,334,629,925
0131-002,2014,7,2,24,180,225,405,629
0131-002,2014,7,3,1,139,176,315,405
0131-002,2014,7,3,2,84,113,197,315
0131-002,2014,7,3,3,74,70,144,197
0131-002,2014,7,3,4,68,72,140,144
0131-002,2014,7,3,5,74,113,187,140
0131-002,2014,7,3,6,212,161,373,187
0131-002,2014,7,3,7,676,350,1026,373
0131-002,2014,7,3,8,1474,815,2289,1026
0131-002,2014,7,3,9,1293,948,2241,2289
0131-002,2014,7,3,10,947,841,1788,2241
0131-002,2014,7,3,11,922,931,1853,1788
0131-002,2014,7,3,12,847,886,1733,1853
0131-002,2014,7,3,13,731,778,1509,1733
0131-002,2014,7,3,14,904,810,1714,1509
0131-002,2014,7,3,15,988,906,1894,1714
0131-002,2014,7,3,16,896,985,1881,1894
0131-002,2014,7,3,17,905,942,1847,1881
0131-002,2014,7,3,18,838,1036,1874,1847
0131-002,2014,7,3,19,850,906,1756,1874
0131-002,2014,7,3,20,607,752,1359,1756
0131-002,2014,7,3,21,531,698,1229,1359
0131-002,2014,7,3,22,433,515,948,1229
0131-002,2014,7,3,23,298,366,664,948
0131-002,2014,7,3,24,215,215,430,664
0131-002,2014,7,4,1,150,139,289,430
0131-002,2014,7,4,2,111,107,218,289
0131-002,2014,7,4,3,77,86,163,218
0131-002,2014,7,4,4,86,90,176,163
0131-002,2014,7,4,5,105,102,207,176
0131-002,2014,7,4,6,309,188,497,207
0131-002,2014,7,4,7,806,429,1235,497
0131-002,2014,7,4,8,1576,762,2338,1235
0131-002,2014,7,4,9,1301,935,2236,2338
0131-002,2014,7,4,10,988,860,1848,2236
0131-002,2014,7,4,11,989,980,1969,1848
0131-002,2014,7,4,12,961,930,1891,1969
0131-002,2014,7,4,13,784,829,1613,1891
0131-002,2014,7,4,14,933,876,1809,1613
0131-002,2014,7,4,15,1010,992,2002,1809
0131-002,2014,7,4,16,996,1007,2003,2002
0131-002,2014,7,4,17,941,1013,1954,2003
0131-002,2014,7,4,18,957,1140,2097,1954
0131-002,2014,7,4,19,985,1150,2135,2097
0131-002,2014,7,4,20,879,893,1772,2135
0131-002,2014,7,4,21,591,762,1353,1772
0131-002,2014,7,4,22,456,576,1032,1353
0131-002,2014,7,4,23,373,417,790,1032
0131-002,2014,7,4,24,226,292,518,790
0131-002,2014,7,5,1,193,227,420,518
0131-002,2014,7,5,2,105,119,224,420
0131-002,2014,7,5,3,120,105,225,224
0131-002,2014,7,5,4,78,93,171,225
0131-002,2014,7,5,5,110,107,217,171
0131-002,2014,7,5,6,293,231,524,217
0131-002,2014,7,5,7,537,344,881,524
0131-002,2014,7,5,8,839,535,1374,881
0131-002,2014,7,5,9,825,751,1576,1374
0131-002,2014,7,5,10,869,779,1648,1576
0131-002,2014,7,5,11,826,814,1640,1648
0131-002,2014,7,5,12,832,831,1663,1640
0131-002,2014,7,5,13,757,793,1550,1663
0131-002,2014,7,5,14,759,750,1509,1550
0131-002,2014,7,5,15,816,765,1581,1509
0131-002,2014,7,5,16,795,791,1586,1581
0131-002,2014,7,5,17,809,787,1596,1586
0131-002,2014,7,5,18,881,864,1745,1596
0131-002,2014,7,5,19,806,783,1589,1745
0131-002,2014,7,5,20,566,558,1124,1589
0131-002,2014,7,5,21,503,480,983,1124
0131-002,2014,7,5,22,417,389,806,983
0131-002,2014,7,5,23,298,335,633,806
0131-002,2014,7,5,24,201,205,406,633
0131-002,2014,7,6,1,149,145,294,406
0131-002,2014,7,6,2,80,120,200,294
0131-002,2014,7,6,3,73,77,150,200
0131-002,2014,7,6,4,60,59,119,150
0131-002,2014,7,6,5,70,66,136,119
0131-002,2014,7,6,6,153,114,267,136
0131-002,2014,7,6,7,253,198,451,267
0131-002,2014,7,6,8,348,329,677,451
0131-002,2014,7,6,9,349,421,770,677
0131-002,2014,7,6,10,423,465,888,770
0131-002,2014,7,6,11,493,561,1054,888
0131-002,2014,7,6,12,520,536,1056,1054
0131-002,2014,7,6,13,527,590,1117,1056
0131-002,2014,7,6,14,554,570,1124,1117
0131-002,2014,7,6,15,700,610,1310,1124
0131-002,2014,7,6,16,761,630,1391,1310
0131-002,2014,7,6,17,815,637,1452,1391
0131-002,2014,7,6,18,856,606,1462,1452
0131-002,2014,7,6,19,885,549,1434,1462
0131-002,2014,7,6,20,644,487,1131,1434
0131-002,2014,7,6,21,500,505,1005,1131
0131-002,2014,7,6,22,422,358,780,1005
0131-002,2014,7,6,23,306,221,527,780
0131-002,2014,7,6,24,210,165,375,527
0131-002,2014,7,7,1,134,123,257,375
0131-002,2014,7,7,2,84,83,167,257
0131-002,2014,7,7,3,78,48,126,167
0131-002,2014,7,7,4,75,72,147,126
0131-002,2014,7,7,5,102,90,192,147
0131-002,2014,7,7,6,339,206,545,192
0131-002,2014,7,7,7,890,440,1330,545
0131-002,2014,7,7,8,1788,855,2643,1330
0131-002,2014,7,7,9,1326,871,2197,2643
0131-002,2014,7,7,10,926,824,1750,2197
0131-002,2014,7,7,11,960,858,1818,1750
0131-002,2014,7,7,12,838,854,1692,1818
0131-002,2014,7,7,13,805,721,1526,1692
0131-002,2014,7,7,14,905,848,1753,1526
0131-002,2014,7,7,15,1019,981,2000,1753
0131-002,2014,7,7,16,1013,921,1934,2000
0131-002,2014,7,7,17,906,950,1856,1934
0131-002,2014,7,7,18,897,985,1882,1856
0131-002,2014,7,7,19,937,961,1898,1882
0131-002,2014,7,7,20,698,790,1488,1898
0131-002,2014,7,7,21,491,674,1165,1488
0131-002,2014,7,7,22,449,499,948,1165
0131-002,2014,7,7,23,295,336,631,948
0131-002,2014,7,7,24,229,208,437,631
0131-002,2014,7,8,1,151,161,312,437
0131-002,2014,7,8,2,94,103,197,312
0131-002,2014,7,8,3,64,86,150,197
0131-002,2014,7,8,4,80,92,172,150
0131-002,2014,7,8,5,115,104,219,172
0131-002,2014,7,8,6,266,214,480,219
0131-002,2014,7,8,7,688,374,1062,480
0131-002,2014,7,8,8,1505,793,2298,1062
0131-002,2014,7,8,9,1275,991,2266,2298
0131-002,2014,7,8,10,995,926,1921,2266
0131-002,2014,7,8,11,941,932,1873,1921
0131-002,2014,7,8,12,936,866,1802,1873
0131-002,2014,7,8,13,762,777,1539,1802
0131-002,2014,7,8,14,965,834,1799,1539
0131-002,2014,7,8,15,999,901,1900,1799
0131-002,2014,7,8,16,950,930,1880,1900
0131-002,2014,7,8,17,888,946,1834,1880
0131-002,2014,7,8,18,865,996,1861,1834
0131-002,2014,7,8,19,852,984,1836,1861
0131-002,2014,7,8,20,675,768,1443,1836
0131-002,2014,7,8,21,550,745,1295,1443
0131-002,2014,7,8,22,423,544,967,1295
0131-002,2014,7,8,23,313,345,658,967
0131-002,2014,7,8,24,218,226,444,658
0131-002,2014,7,9,1,110,147,257,444
0131-002,2014,7,9,2,88,103,191,257
0131-002,2014,7,9,3,74,68,142,191
0131-002,2014,7,9,4,77,86,163,142
0131-002,2014,7,9,5,103,103,206,163
0131-002,2014,7,9,6,259,213,472,206
0131-002,2014,7,9,7,761,360,1121,472
0131-002,2014,7,9,8,1491,783,2274,1121
0131-002,2014,7,9,9,1284,948,2232,2274
0131-002,2014,7,9,10,1003,858,1861,2232
0131-002,2014,7,9,11,921,962,1883,1861
0131-002,2014,7,9,12,953,832,1785,1883
0131-002,2014,7,9,13,730,779,1509,1785
0131-002,2014,7,9,14,858,852,1710,1509
0131-002,2014,7,9,15,962,963,1925,1710
0131-002,2014,7,9,16,905,951,1856,1925
0131-002,2014,7,9,17,816,982,1798,1856
0131-002,2014,7,9,18,874,1137,2011,1798
0131-002,2014,7,9,19,840,1049,1889,2011
0131-002,2014,7,9,20,663,709,1372,1889
0131-002,2014,7,9,21,460,667,1127,1372
0131-002,2014,7,9,22,436,476,912,1127
0131-002,2014,7,9,23,289,344,633,912
0131-002,2014,7,9,24,200,225,425,633
0131-002,2014,7,10,1,152,149,301,425
0131-002,2014,7,10,2,97,125,222,301
0131-002,2014,7,10,3,87,69,156,222
0131-002,2014,7,10,4,80,83,163,156
0131-002,2014,7,10,5,88,104,192,163
0131-002,2014,7,10,6,248,191,439,192
0131-002,2014,7,10,7,781,384,1165,439
0131-002,2014,7,10,8,1520,784,2304,1165
0131-002,2014,7,10,9,1325,915,2240,2304
0131-002,2014,7,10,10,978,851,1829,2240
0131-002,2014,7,10,11,956,948,1904,1829
0131-002,2014,7,10,12,908,912,1820,1904
0131-002,2014,7,10,13,771,812,1583,1820
0131-002,2014,7,10,14,856,815,1671,1583
0131-002,2014,7,10,15,959,940,1899,1671
0131-002,2014,7,10,16,954,914,1868,1899
0131-002,2014,7,10,17,872,982,1854,1868
0131-002,2014,7,10,18,913,1130,2043,1854
0131-002,2014,7,10,19,926,1060,1986,2043
0131-002,2014,7,10,20,652,751,1403,1986
0131-002,2014,7,10,21,565,720,1285,1403
0131-002,2014,7,10,22,457,566,1023,1285
0131-002,2014,7,10,23,319,344,663,1023
0131-002,2014,7,10,24,246,218,464,663
0131-002,2014,7,11,1,132,178,310,464
0131-002,2014,7,11,2,90,146,236,310
0131-002,2014,7,11,3,93,85,178,236
0131-002,2014,7,11,4,85,90,175,178
0131-002,2014,7,11,5,127,104,231,175
0131-002,2014,7,11,6,276,244,520,231
0131-002,2014,7,11,7,795,428,1223,520
0131-002,2014,7,11,8,1500,770,2270,1223
0131-002,2014,7,11,9,1304,926,2230,2270
0131-002,2014,7,11,10,1059,880,1939,2230
0131-002,2014,7,11,11,929,943,1872,1939
0131-002,2014,7,11,12,940,915,1855,1872
0131-002,2014,7,11,13,858,845,1703,1855
0131-002,2014,7,11,14,911,873,1784,1703
0131-002,2014,7,11,15,996,1032,2028,1784
0131-002,2014,7,11,16,986,972,1958,2028
0131-002,2014,7,11,17,969,1035,2004,1958
0131-002,2014,7,11,18,965,1202,2167,2004
0131-002,2014,7,11,19,937,1228,2165,2167
0131-002,2014,7,11,20,831,952,1783,2165
0131-002,2014,7,11,21,641,769,1410,1783
0131-002,2014,7,11,22,506,572,1078,1410
0131-002,2014,7,11,23,395,397,792,1078
0131-002,2014,7,11,24,302,318,620,792
0131-002,2014,7,12,1,199,200,399,620
0131-002,2014,7,12,2,142,164,306,399
0131-002,2014,7,12,3,101,104,205,306
0131-002,2014,7,12,4,89,108,197,205
0131-002,2014,7,12,5,129,137,266,197
0131-002,2014,7,12,6,291,237,528,266
0131-002,2014,7,12,7,545,338,883,528
0131-002,2014,7,12,8,802,586,1388,883
0131-002,2014,7,12,9,821,712,1533,1388
0131-002,2014,7,12,10,793,816,1609,1533
0131-002,2014,7,12,11,857,891,1748,1609
0131-002,2014,7,12,12,832,874,1706,1748
0131-002,2014,7,12,13,774,800,1574,1706
0131-002,2014,7,12,14,725,761,1486,1574
0131-002,2014,7,12,15,806,758,1564,1486
0131-002,2014,7,12,16,808,773,1581,1564
0131-002,2014,7,12,17,767,843,1610,1581
0131-002,2014,7,12,18,903,899,1802,1610
0131-002,2014,7,12,19,781,783,1564,1802
0131-002,2014,7,12,20,559,550,1109,1564
0131-002,2014,7,12,21,533,473,1006,1109
0131-002,2014,7,12,22,424,390,814,1006
0131-002,2014,7,12,23,332,282,614,814
0131-002,2014,7,12,24,187,244,431,614
0131-002,2014,7,13,1,140,165,305,431
0131-002,2014,7,13,2,116,109,225,305
0131-002,2014,7,13,3,87,96,183,225
0131-002,2014,7,13,4,60,65,125,183
0131-002,2014,7,13,5,64,66,130,125
0131-002,2014,7,13,6,104,118,222,130
0131-002,2014,7,13,7,255,183,438,222
0131-002,2014,7,13,8,293,307,600,438
0131-002,2014,7,13,9,357,359,716,600
0131-002,2014,7,13,10,404,466,870,716
0131-002,2014,7,13,11,491,553,1044,870
0131-002,2014,7,13,12,526,549,1075,1044
0131-002,2014,7,13,13,482,566,1048,1075
0131-002,2014,7,13,14,557,549,1106,1048
0131-002,2014,7,13,15,607,602,1209,1106
0131-002,2014,7,13,16,750,637,1387,1209
0131-002,2014,7,13,17,796,639,1435,1387
0131-002,2014,7,13,18,866,610,1476,1435
0131-002,2014,7,13,19,811,579,1390,1476
0131-002,2014,7,13,20,729,479,1208,1390
0131-002,2014,7,13,21,657,459,1116,1208
0131-002,2014,7,13,22,501,362,863,1116
0131-002,2014,7,13,23,314,224,538,863
0131-002,2014,7,13,24,231,176,407,538
0131-002,2014,7,14,1,138,116,254,407
0131-002,2014,7,14,2,75,69,144,254
0131-002,2014,7,14,3,57,56,113,144
0131-002,2014,7,14,4,72,78,150,113
0131-002,2014,7,14,5,99,83,182,150
0131-002,2014,7,14,6,299,218,517,182
0131-002,2014,7,14,7,890,421,1311,517
0131-002,2014,7,14,8,1779,854,2633,1311
0131-002,2014,7,14,9,1322,872,2194,2633
0131-002,2014,7,14,10,962,802,1764,2194
0131-002,2014,7,14,11,943,849,1792,1764
0131-002,2014,7,14,12,909,855,1764,1792
0131-002,2014,7,14,13,732,813,1545,1764
0131-002,2014,7,14,14,878,805,1683,1545
0131-002,2014,7,14,15,950,942,1892,1683
0131-002,2014,7,14,16,942,933,1875,1892
0131-002,2014,7,14,17,898,942,1840,1875
0131-002,2014,7,14,18,802,983,1785,1840
0131-002,2014,7,14,19,861,1011,1872,1785
0131-002,2014,7,14,20,689,795,1484,1872
0131-002,2014,7,14,21,536,732,1268,1484
0131-002,2014,7,14,22,468,567,1035,1268
0131-002,2014,7,14,23,315,346,661,1035
0131-002,2014,7,14,24,192,221,413,661
0131-002,2014,7,15,1,147,149,296,413
0131-002,2014,7,15,2,94,96,190,296
0131-002,2014,7,15,3,66,83,149,190
0131-002,2014,7,15,4,96,95,191,149
0131-002,2014,7,15,5,117,138,255,191
0131-002,2014,7,15,6,272,229,501,255
0131-002,2014,7,15,7,742,386,1128,501
0131-002,2014,7,15,8,1552,782,2334,1128
0131-002,2014,7,15,9,1269,930,2199,2334
0131-002,2014,7,15,10,1043,864,1907,2199
0131-002,2014,7,15,11,945,894,1839,1907
0131-002,2014,7,15,12,928,889,1817,1839
0131-002,2014,7,15,13,758,775,1533,1817
0131-002,2014,7,15,14,894,872,1766,1533
0131-002,2014,7,15,15,944,955,1899,1766
0131-002,2014,7,15,16,936,999,1935,1899
0131-002,2014,7,15,17,896,994,1890,1935
0131-002,2014,7,15,18,905,1158,2063,1890
0131-002,2014,7,15,19,844,1103,1947,2063
0131-002,2014,7,15,20,686,765,1451,1947
0131-002,2014,7,15,21,522,740,1262,1451
0131-002,2014,7,15,22,410,533,943,1262
0131-002,2014,7,15,23,307,382,689,943
0131-002,2014,7,15,24,235,224,459,689
0131-002,2014,7,16,1,148,119,267,459
0131-002,2014,7,16,2,98,109,207,267
0131-002,2014,7,16,3,70,86,156,207
0131-002,2014,7,16,4,87,77,164,156
0131-002,2014,7,16,5,113,98,211,164
0131-002,2014,7,16,6,285,221,506,211
0131-002,2014,7,16,7,737,402,1139,506
0131-002,2014,7,16,8,1471,770,2241,1139
0131-002,2014,7,16,9,1324,930,2254,2241
0131-002,2014,7,16,10,1023,812,1835,2254
0131-002,2014,7,16,11,915,894,1809,1835
0131-002,2014,7,16,12,905,859,1764,1809
0131-002,2014,7,16,13,771,770,1541,1764
0131-002,2014,7,16,14,856,811,1667,1541
0131-002,2014,7,16,15,952,961,1913,1667
0131-002,2014,7,16,16,856,940,1796,1913
0131-002,2014,7,16,17,919,987,1906,1796
0131-002,2014,7,16,18,905,1079,1984,1906
0131-002,2014,7,16,19,914,1077,1991,1984
0131-002,2014,7,16,20,668,768,1436,1991
0131-002,2014,7,16,21,518,679,1197,1436
0131-002,2014,7,16,22,455,526,981,1197
0131-002,2014,7,16,23,330,334,664,981
0131-002,2014,7,16,24,220,275,495,664
0131-002,2014,7,17,1,153,144,297,495
0131-002,2014,7,17,2,85,112,197,297
0131-002,2014,7,17,3,78,85,163,197
0131-002,2014,7,17,4,106,79,185,163
0131-002,2014,7,17,5,98,119,217,185
0131-002,2014,7,17,6,302,224,526,217
0131-002,2014,7,17,7,679,397,1076,526
0131-002,2014,7,17,8,1437,788,2225,1076
0131-002,2014,7,17,9,1322,898,2220,2225
0131-002,2014,7,17,10,968,879,1847,2220
0131-002,2014,7,17,11,979,891,1870,1847
0131-002,2014,7,17,12,918,925,1843,1870
0131-002,2014,7,17,13,733,747,1480,1843
0131-002,2014,7,17,14,919,851,1770,1480
0131-002,2014,7,17,15,929,993,1922,1770
0131-002,2014,7,17,16,906,888,1794,1922
0131-002,2014,7,17,17,856,974,1830,1794
0131-002,2014,7,17,18,851,989,1840,1830
0131-002,2014,7,17,19,927,985,1912,1840
0131-002,2014,7,17,20,610,738,1348,1912
0131-002,2014,7,17,21,521,687,1208,1348
0131-002,2014,7,17,22,431,528,959,1208
0131-002,2014,7,17,23,326,357,683,959
0131-002,2014,7,17,24,204,250,454,683
0131-002,2014,7,18,1,151,157,308,454
0131-002,2014,7,18,2,106,98,204,308
0131-002,2014,7,18,3,71,97,168,204
0131-002,2014,7,18,4,89,102,191,168
0131-002,2014,7,18,5,88,102,190,191
0131-002,2014,7,18,6,173,194,367,190
0131-002,2014,7,18,7,564,319,883,367
0131-002,2014,7,18,8,1401,849,2250,883
0131-002,2014,7,18,9,1310,1121,2431,2250
0131-002,2014,7,18,10,974,915,1889,2431
0131-002,2014,7,18,11,925,986,1911,1889
0131-002,2014,7,18,12,869,933,1802,1911
0131-002,2014,7,18,13,743,834,1577,1802
0131-002,2014,7,18,14,891,856,1747,1577
0131-002,2014,7,18,15,955,962,1917,1747
0131-002,2014,7,18,16,940,954,1894,1917
0131-002,2014,7,18,17,934,1007,1941,1894
0131-002,2014,7,18,18,971,1046,2017,1941
0131-002,2014,7,18,19,988,1143,2131,2017
0131-002,2014,7,18,20,803,902,1705,2131
0131-002,2014,7,18,21,656,816,1472,1705
0131-002,2014,7,18,22,458,570,1028,1472
0131-002,2014,7,18,23,364,390,754,1028
0131-002,2014,7,18,24,258,246,504,754
0131-002,2014,7,19,1,183,195,378,504
0131-002,2014,7,19,2,139,137,276,378
0131-002,2014,7,19,3,119,104,223,276
0131-002,2014,7,19,4,104,95,199,223
0131-002,2014,7,19,5,116,128,244,199
0131-002,2014,7,19,6,258,173,431,244
0131-002,2014,7,19,7,467,310,777,431
0131-002,2014,7,19,8,767,564,1331,777
0131-002,2014,7,19,9,798,672,1470,1331
0131-002,2014,7,19,10,768,752,1520,1470
0131-002,2014,7,19,11,800,809,1609,1520
0131-002,2014,7,19,12,759,801,1560,1609
0131-002,2014,7,19,13,733,752,1485,1560
0131-002,2014,7,19,14,738,733,1471,1485
0131-002,2014,7,19,15,746,739,1485,1471
0131-002,2014,7,19,16,779,745,1524,1485
0131-002,2014,7,19,17,751,775,1526,1524
0131-002,2014,7,19,18,782,864,1646,1526
0131-002,2014,7,19,19,679,664,1343,1646
0131-002,2014,7,19,20,583,523,1106,1343
0131-002,2014,7,19,21,534,467,1001,1106
0131-002,2014,7,19,22,409,381,790,1001
0131-002,2014,7,19,23,267,286,553,790
0131-002,2014,7,19,24,203,219,422,553
0131-002,2014,7,20,1,157,163,320,422
0131-002,2014,7,20,2,107,135,242,320
0131-002,2014,7,20,3,80,78,158,242
0131-002,2014,7,20,4,57,69,126,158
0131-002,2014,7,20,5,65,64,129,126
0131-002,2014,7,20,6,142,127,269,129
0131-002,2014,7,20,7,267,185,452,269
0131-002,2014,7,20,8,320,331,651,452
0131-002,2014,7,20,9,352,446,798,651
0131-002,2014,7,20,10,398,522,920,798
0131-002,2014,7,20,11,505,572,1077,920
0131-002,2014,7,20,12,471,559,1030,1077
0131-002,2014,7,20,13,625,579,1204,1030
0131-002,2014,7,20,14,578,536,1114,1204
0131-002,2014,7,20,15,631,602,1233,1114
0131-002,2014,7,20,16,691,604,1295,1233
0131-002,2014,7,20,17,805,630,1435,1295
0131-002,2014,7,20,18,908,621,1529,1435
0131-002,2014,7,20,19,838,584,1422,1529
0131-002,2014,7,20,20,689,511,1200,1422
0131-002,2014,7,20,21,714,471,1185,1200
0131-002,2014,7,20,22,482,386,868,1185
0131-002,2014,7,20,23,329,230,559,868
0131-002,2014,7,20,24,194,175,369,559
0131-002,2014,7,21,1,140,87,227,369
0131-002,2014,7,21,2,87,68,155,227
0131-002,2014,7,21,3,69,53,122,155
0131-002,2014,7,21,4,81,78,159,122
0131-002,2014,7,21,5,98,72,170,159
0131-002,2014,7,21,6,317,208,525,170
0131-002,2014,7,21,7,874,445,1319,525
0131-002,2014,7,21,8,1744,810,2554,1319
0131-002,2014,7,21,9,1315,902,2217,2554
0131-002,2014,7,21,10,881,834,1715,2217
0131-002,2014,7,21,11,777,861,1638,1715
0131-002,2014,7,21,12,841,850,1691,1638
0131-002,2014,7,21,13,747,752,1499,1691
0131-002,2014,7,21,14,770,954,1724,1499
0131-002,2014,7,21,15,920,985,1905,1724
0131-002,2014,7,21,16,1042,933,1975,1905
0131-002,2014,7,21,17,856,976,1832,1975
0131-002,2014,7,21,18,944,1025,1969,1832
0131-002,2014,7,21,19,917,1023,1940,1969
0131-002,2014,7,21,20,668,782,1450,1940
0131-002,2014,7,21,21,538,759,1297,1450
0131-002,2014,7,21,22,401,540,941,1297
0131-002,2014,7,21,23,321,325,646,941
0131-002,2014,7,21,24,220,233,453,646
0131-002,2014,7,22,1,124,144,268,453
0131-002,2014,7,22,2,85,120,205,268
0131-002,2014,7,22,3,95,89,184,205
0131-002,2014,7,22,4,95,82,177,184
0131-002,2014,7,22,5,119,110,229,177
0131-002,2014,7,22,6,273,214,487,229
0131-002,2014,7,22,7,750,381,1131,487
0131-002,2014,7,22,8,1537,813,2350,1131
0131-002,2014,7,22,9,1331,986,2317,2350
0131-002,2014,7,22,10,1006,903,1909,2317
0131-002,2014,7,22,11,939,952,1891,1909
0131-002,2014,7,22,12,976,892,1868,1891
0131-002,2014,7,22,13,786,822,1608,1868
0131-002,2014,7,22,14,839,869,1708,1608
0131-002,2014,7,22,15,1008,906,1914,1708
0131-002,2014,7,22,16,988,1029,2017,1914
0131-002,2014,7,22,17,826,1005,1831,2017
0131-002,2014,7,22,18,955,1040,1995,1831
0131-002,2014,7,22,19,937,1121,2058,1995
0131-002,2014,7,22,20,689,811,1500,2058
0131-002,2014,7,22,21,492,721,1213,1500
0131-002,2014,7,22,22,434,548,982,1213
0131-002,2014,7,22,23,278,320,598,982
0131-002,2014,7,22,24,192,206,398,598
0131-002,2014,7,23,1,147,150,297,398
0131-002,2014,7,23,2,105,112,217,297
0131-002,2014,7,23,3,73,96,169,217
0131-002,2014,7,23,4,70,95,165,169
0131-002,2014,7,23,5,103,105,208,165
0131-002,2014,7,23,6,203,185,388,208
0131-002,2014,7,23,7,586,319,905,388
0131-002,2014,7,23,8,1390,800,2190,905
0131-002,2014,7,23,9,1165,1094,2259,2190
0131-002,2014,7,23,10,855,818,1673,2259
0131-002,2014,7,23,11,861,926,1787,1673
0131-002,2014,7,23,12,763,949,1712,1787
0131-002,2014,7,23,13,692,870,1562,1712
0131-002,2014,7,23,14,885,870,1755,1562
0131-002,2014,7,23,15,970,951,1921,1755
0131-002,2014,7,23,16,935,945,1880,1921
0131-002,2014,7,23,17,792,964,1756,1880
0131-002,2014,7,23,18,856,1134,1990,1756
0131-002,2014,7,23,19,862,1065,1927,1990
0131-002,2014,7,23,20,670,783,1453,1927
0131-002,2014,7,23,21,455,621,1076,1453
0131-002,2014,7,23,22,384,465,849,1076
0131-002,2014,7,23,23,310,338,648,849
0131-002,2014,7,23,24,222,216,438,648
0131-002,2014,7,24,1,146,169,315,438
0131-002,2014,7,24,2,71,114,185,315
0131-002,2014,7,24,3,76,103,179,185
0131-002,2014,7,24,4,78,99,177,179
0131-002,2014,7,24,5,94,80,174,177
0131-002,2014,7,24,6,228,166,394,174
0131-002,2014,7,24,7,581,364,945,394
0131-002,2014,7,24,8,1396,804,2200,945
0131-002,2014,7,24,9,1250,1041,2291,2200
0131-002,2014,7,24,10,902,868,1770,2291
0131-002,2014,7,24,11,934,854,1788,1770
0131-002,2014,7,24,12,873,863,1736,1788
0131-002,2014,7,24,13,785,714,1499,1736
0131-002,2014,7,24,14,908,852,1760,1499
0131-002,2014,7,24,15,946,1025,1971,1760
0131-002,2014,7,24,16,959,992,1951,1971
0131-002,2014,7,24,17,921,938,1859,1951
0131-002,2014,7,24,18,865,1007,1872,1859
0131-002,2014,7,24,19,877,986,1863,1872
0131-002,2014,7,24,20,664,761,1425,1863
0131-002,2014,7,24,21,512,723,1235,1425
0131-002,2014,7,24,22,532,462,994,1235
0131-002,2014,7,24,23,322,320,642,994
0131-002,2014,7,24,24,212,209,421,642
0131-002,2014,7,25,1,158,140,298,421
0131-002,2014,7,25,2,92,103,195,298
0131-002,2014,7,25,3,73,60,133,195
0131-002,2014,7,25,4,86,96,182,133
0131-002,2014,7,25,5,101,107,208,182
0131-002,2014,7,25,6,231,116,347,208
0131-002,2014,7,25,7,644,306,950,347
0131-002,2014,7,25,8,1420,745,2165,950
0131-002,2014,7,25,9,1240,979,2219,2165
0131-002,2014,7,25,10,907,871,1778,2219
0131-002,2014,7,25,11,859,925,1784,1778
0131-002,2014,7,25,12,839,831,1670,1784
0131-002,2014,7,25,13,778,804,1582,1670
0131-002,2014,7,25,14,845,852,1697,1582
0131-002,2014,7,25,15,963,924,1887,1697
0131-002,2014,7,25,16,936,985,1921,1887
0131-002,2014,7,25,17,868,931,1799,1921
0131-002,2014,7,25,18,863,1093,1956,1799
0131-002,2014,7,25,19,768,1203,1971,1956
0131-002,2014,7,25,20,532,901,1433,1971
0131-002,2014,7,25,21,442,824,1266,1433
0131-002,2014,7,25,22,302,569,871,1266
0131-002,2014,7,25,23,233,359,592,871
0131-002,2014,7,25,24,150,236,386,592
0131-002,2014,7,26,1,240,168,408,386
0131-002,2014,7,26,2,146,123,269,408
0131-002,2014,7,26,3,135,86,221,269
0131-002,2014,7,26,4,155,114,269,221
0131-002,2014,7,26,5,155,92,247,269
0131-002,2014,7,26,6,295,181,476,247
0131-002,2014,7,26,7,521,305,826,476
0131-002,2014,7,26,8,723,493,1216,826
0131-002,2014,7,26,9,943,719,1662,1216
0131-002,2014,7,26,10,989,807,1796,1662
0131-002,2014,7,26,11,822,824,1646,1796
0131-002,2014,7,26,12,727,825,1552,1646
0131-002,2014,7,26,13,690,839,1529,1552
0131-002,2014,7,26,14,782,771,1553,1529
0131-002,2014,7,26,15,730,780,1510,1553
0131-002,2014,7,26,16,720,785,1505,1510
0131-002,2014,7,26,17,737,770,1507,1505
0131-002,2014,7,26,18,803,828,1631,1507
0131-002,2014,7,26,19,768,709,1477,1631
0131-002,2014,7,26,20,571,529,1100,1477
0131-002,2014,7,26,21,548,503,1051,1100
0131-002,2014,7,26,22,435,426,861,1051
0131-002,2014,7,26,23,373,272,645,861
0131-002,2014,7,26,24,243,185,428,645
0131-002,2014,7,27,1,190,150,340,428
0131-002,2014,7,27,2,133,109,242,340
0131-002,2014,7,27,3,128,68,196,242
0131-002,2014,7,27,4,77,66,143,196
0131-002,2014,7,27,5,105,77,182,143
0131-002,2014,7,27,6,162,137,299,182
0131-002,2014,7,27,7,330,187,517,299
0131-002,2014,7,27,8,411,289,700,517
0131-002,2014,7,27,9,459,389,848,700
0131-002,2014,7,27,10,454,445,899,848
0131-002,2014,7,27,11,518,498,1016,899
0131-002,2014,7,27,12,532,521,1053,1016
0131-002,2014,7,27,13,504,574,1078,1053
0131-002,2014,7,27,14,527,506,1033,1078
0131-002,2014,7,27,15,642,576,1218,1033
0131-002,2014,7,27,16,638,584,1222,1218
0131-002,2014,7,27,17,690,623,1313,1222
0131-002,2014,7,27,18,700,600,1300,1313
0131-002,2014,7,27,19,638,597,1235,1300
0131-002,2014,7,27,20,594,492,1086,1235
0131-002,2014,7,27,21,608,483,1091,1086
0131-002,2014,7,27,22,502,350,852,1091
0131-002,2014,7,27,23,380,247,627,852
0131-002,2014,7,27,24,291,181,472,627
0131-002,2014,7,28,1,156,113,269,472
0131-002,2014,7,28,2,94,76,170,269
0131-002,2014,7,28,3,96,50,146,170
0131-002,2014,7,28,4,96,79,175,146
0131-002,2014,7,28,5,126,85,211,175
0131-002,2014,7,28,6,374,203,577,211
0131-002,2014,7,28,7,720,432,1152,577
0131-002,2014,7,28,8,1161,788,1949,1152
0131-002,2014,7,28,9,1074,875,1949,1949
0131-002,2014,7,28,10,900,862,1762,1949
0131-002,2014,7,28,11,939,881,1820,1762
0131-002,2014,7,28,12,932,859,1791,1820
0131-002,2014,7,28,13,771,769,1540,1791
0131-002,2014,7,28,14,872,842,1714,1540
0131-002,2014,7,28,15,939,964,1903,1714
0131-002,2014,7,28,16,906,972,1878,1903
0131-002,2014,7,28,17,968,979,1947,1878
0131-002,2014,7,28,18,856,1009,1865,1947
0131-002,2014,7,28,19,867,977,1844,1865
0131-002,2014,7,28,20,619,803,1422,1844
0131-002,2014,7,28,21,543,768,1311,1422
0131-002,2014,7,28,22,472,553,1025,1311
0131-002,2014,7,28,23,348,312,660,1025
0131-002,2014,7,28,24,268,213,481,660
0131-002,2014,7,29,1,215,146,361,481
0131-002,2014,7,29,2,158,96,254,361
0131-002,2014,7,29,3,132,86,218,254
0131-002,2014,7,29,4,140,80,220,218
0131-002,2014,7,29,5,140,65,205,220
0131-002,2014,7,29,6,325,163,488,205
0131-002,2014,7,29,7,691,326,1017,488
0131-002,2014,7,29,8,1115,647,1762,1017
0131-002,2014,7,29,9,984,923,1907,1762
0131-002,2014,7,29,10,993,866,1859,1907
0131-002,2014,7,29,11,931,996,1927,1859
0131-002,2014,7,29,12,870,995,1865,1927
0131-002,2014,7,29,13,750,844,1594,1865
0131-002,2014,7,29,14,874,809,1683,1594
0131-002,2014,7,29,15,984,959,1943,1683
0131-002,2014,7,29,16,911,953,1864,1943
0131-002,2014,7,29,17,899,949,1848,1864
0131-002,2014,7,29,18,899,987,1886,1848
0131-002,2014,7,29,19,865,989,1854,1886
0131-002,2014,7,29,20,621,751,1372,1854
0131-002,2014,7,29,21,576,750,1326,1372
0131-002,2014,7,29,22,454,538,992,1326
0131-002,2014,7,29,23,369,351,720,992
0131-002,2014,7,29,24,261,247,508,720
0131-002,2014,7,30,1,197,173,370,508
0131-002,2014,7,30,2,121,122,243,370
0131-002,2014,7,30,3,86,87,173,243
0131-002,2014,7,30,4,123,118,241,173
0131-002,2014,7,30,5,162,100,262,241
0131-002,2014,7,30,6,344,208,552,262
0131-002,2014,7,30,7,695,402,1097,552
0131-002,2014,7,30,8,1003,757,1760,1097
0131-002,2014,7,30,9,1020,882,1902,1760
0131-002,2014,7,30,10,904,821,1725,1902
0131-002,2014,7,30,11,954,948,1902,1725
0131-002,2014,7,30,12,899,884,1783,1902
0131-002,2014,7,30,13,824,793,1617,1783
0131-002,2014,7,30,14,870,836,1706,1617
0131-002,2014,7,30,15,936,910,1846,1706
0131-002,2014,7,30,16,908,913,1821,1846
0131-002,2014,7,30,17,883,943,1826,1821
0131-002,2014,7,30,18,872,1052,1924,1826
0131-002,2014,7,30,19,925,949,1874,1924
0131-002,2014,7,30,20,640,787,1427,1874
0131-002,2014,7,30,21,619,753,1372,1427
0131-002,2014,7,30,22,489,548,1037,1372
0131-002,2014,7,30,23,364,336,700,1037
0131-002,2014,7,30,24,259,267,526,700
0131-002,2014,7,31,1,208,163,371,526
0131-002,2014,7,31,2,156,110,266,371
0131-002,2014,7,31,3,125,89,214,266
0131-002,2014,7,31,4,144,109,253,214
0131-002,2014,7,31,5,155,107,262,253
0131-002,2014,7,31,6,323,187,510,262
0131-002,2014,7,31,7,661,388,1049,510
0131-002,2014,7,31,8,1023,727,1750,1049
0131-002,2014,7,31,9,964,934,1898,1750
0131-002,2014,7,31,10,964,839,1803,1898
0131-002,2014,7,31,11,893,963,1856,1803
0131-002,2014,7,31,12,900,844,1744,1856
0131-002,2014,7,31,13,803,842,1645,1744
0131-002,2014,7,31,14,826,841,1667,1645
0131-002,2014,7,31,15,854,994,1848,1667
0131-002,2014,7,31,16,922,870,1792,1848
0131-002,2014,7,31,17,869,752,1621,1792
0131-002,2014,7,31,18,867,701,1568,1621
0131-002,2014,7,31,19,906,613,1519,1568
0131-002,2014,7,31,20,674,576,1250,1519
0131-002,2014,7,31,21,548,459,1007,1250
0131-002,2014,7,31,22,527,436,963,1007
0131-002,2014,7,31,23,357,325,682,963
0131-002,2014,7,31,24,263,237,500,682
0131-002,2014,8,1,1,186,101,287,500
0131-002,2014,8,1,2,112,72,184,287
0131-002,2014,8,1,3,120,53,173,184
0131-002,2014,8,1,4,111,43,154,173
0131-002,2014,8,1,5,133,79,212,154
0131-002,2014,8,1,6,281,127,408,212
0131-002,2014,8,1,7,558,220,778,408
0131-002,2014,8,1,8,871,602,1473,778
0131-002,2014,8,1,9,842,706,1548,1473
0131-002,2014,8,1,10,834,585,1419,1548
0131-002,2014,8,1,11,821,614,1435,1419
0131-002,2014,8,1,12,762,641,1403,1435
0131-002,2014,8,1,13,620,596,1216,1403
0131-002,2014,8,1,14,740,690,1430,1216
0131-002,2014,8,1,15,800,746,1546,1430
0131-002,2014,8,1,16,752,682,1434,1546
0131-002,2014,8,1,17,727,733,1460,1434
0131-002,2014,8,1,18,744,816,1560,1460
0131-002,2014,8,1,19,807,859,1666,1560
0131-002,2014,8,1,20,660,744,1404,1666
0131-002,2014,8,1,21,615,588,1203,1404
0131-002,2014,8,1,22,462,455,917,1203
0131-002,2014,8,1,23,363,344,707,917
0131-002,2014,8,1,24,251,236,487,707
0131-002,2014,8,2,1,197,206,403,487
0131-002,2014,8,2,2,146,116,262,403
0131-002,2014,8,2,3,119,61,180,262
0131-002,2014,8,2,4,120,64,184,180
0131-002,2014,8,2,5,120,67,187,184
0131-002,2014,8,2,6,248,131,379,187
0131-002,2014,8,2,7,432,214,646,379
0131-002,2014,8,2,8,578,376,954,646
0131-002,2014,8,2,9,569,676,1245,954
0131-002,2014,8,2,10,629,848,1477,1245
0131-002,2014,8,2,11,623,991,1614,1477
0131-002,2014,8,2,12,693,1070,1763,1614
0131-002,2014,8,2,13,625,986,1611,1763
0131-002,2014,8,2,14,639,930,1569,1611
0131-002,2014,8,2,15,621,943,1564,1569
0131-002,2014,8,2,16,673,892,1565,1564
0131-002,2014,8,2,17,732,836,1568,1565
0131-002,2014,8,2,18,765,902,1667,1568
0131-002,2014,8,2,19,748,834,1582,1667
0131-002,2014,8,2,20,570,673,1243,1582
0131-002,2014,8,2,21,657,427,1084,1243
0131-002,2014,8,2,22,451,348,799,1084
0131-002,2014,8,2,23,301,250,551,799
0131-002,2014,8,2,24,179,154,333,551
0131-002,2014,8,3,1,149,119,268,333
0131-002,2014,8,3,2,82,75,157,268
0131-002,2014,8,3,3,72,59,131,157
0131-002,2014,8,3,4,58,32,90,131
0131-002,2014,8,3,5,69,44,113,90
0131-002,2014,8,3,6,104,84,188,113
0131-002,2014,8,3,7,203,146,349,188
0131-002,2014,8,3,8,285,220,505,349
0131-002,2014,8,3,9,317,311,628,505
0131-002,2014,8,3,10,352,336,688,628
0131-002,2014,8,3,11,471,400,871,688
0131-002,2014,8,3,12,443,434,877,871
0131-002,2014,8,3,13,497,442,939,877
0131-002,2014,8,3,14,546,484,1030,939
0131-002,2014,8,3,15,594,477,1071,1030
0131-002,2014,8,3,16,665,513,1178,1071
0131-002,2014,8,3,17,689,495,1184,1178
0131-002,2014,8,3,18,724,540,1264,1184
0131-002,2014,8,3,19,854,589,1443,1264
0131-002,2014,8,3,20,756,395,1151,1443
0131-002,2014,8,3,21,695,361,1056,1151
0131-002,2014,8,3,22,484,316,800,1056
0131-002,2014,8,3,23,321,216,537,800
0131-002,2014,8,3,24,214,130,344,537
0131-002,2014,8,4,1,131,111,242,344
0131-002,2014,8,4,2,69,60,129,242
0131-002,2014,8,4,3,79,40,119,129
0131-002,2014,8,4,4,79,42,121,119
0131-002,2014,8,4,5,87,83,170,121
0131-002,2014,8,4,6,264,134,398,170
0131-002,2014,8,4,7,494,331,825,398
0131-002,2014,8,4,8,857,830,1687,825
0131-002,2014,8,4,9,752,816,1568,1687
0131-002,2014,8,4,10,695,698,1393,1568
0131-002,2014,8,4,11,740,678,1418,1393
0131-002,2014,8,4,12,709,734,1443,1418
0131-002,2014,8,4,13,657,619,1276,1443
0131-002,2014,8,4,14,701,718,1419,1276
0131-002,2014,8,4,15,709,757,1466,1419
0131-002,2014,8,4,16,757,768,1525,1466
0131-002,2014,8,4,17,714,744,1458,1525
0131-002,2014,8,4,18,717,829,1546,1458
0131-002,2014,8,4,19,727,825,1552,1546
0131-002,2014,8,4,20,524,649,1173,1552
0131-002,2014,8,4,21,430,587,1017,1173
0131-002,2014,8,4,22,382,428,810,1017
0131-002,2014,8,4,23,280,269,549,810
0131-002,2014,8,4,24,210,166,376,549
0131-002,2014,8,5,1,135,111,246,376
0131-002,2014,8,5,2,111,87,198,246
0131-002,2014,8,5,3,82,64,146,198
0131-002,2014,8,5,4,93,51,144,146
0131-002,2014,8,5,5,123,81,204,144
0131-002,2014,8,5,6,254,150,404,204
0131-002,2014,8,5,7,491,290,781,404
0131-002,2014,8,5,8,794,705,1499,781
0131-002,2014,8,5,9,810,890,1700,1499
0131-002,2014,8,5,10,780,746,1526,1700
0131-002,2014,8,5,11,834,746,1580,1526
0131-002,2014,8,5,12,757,743,1500,1580
0131-002,2014,8,5,13,690,702,1392,1500
0131-002,2014,8,5,14,703,797,1500,1392
0131-002,2014,8,5,15,784,873,1657,1500
0131-002,2014,8,5,16,733,783,1516,1657
0131-002,2014,8,5,17,689,734,1423,1516
0131-002,2014,8,5,18,724,816,1540,1423
0131-002,2014,8,5,19,746,837,1583,1540
0131-002,2014,8,5,20,591,691,1282,1583
0131-002,2014,8,5,21,481,594,1075,1282
0131-002,2014,8,5,22,408,441,849,1075
0131-002,2014,8,5,23,349,312,661,849
0131-002,2014,8,5,24,253,192,445,661
0131-002,2014,8,6,1,170,116,286,445
0131-002,2014,8,6,2,114,83,197,286
0131-002,2014,8,6,3,95,56,151,197
0131-002,2014,8,6,4,104,57,161,151
0131-002,2014,8,6,5,136,81,217,161
0131-002,2014,8,6,6,275,135,410,217
0131-002,2014,8,6,7,538,295,833,410
0131-002,2014,8,6,8,796,744,1540,833
0131-002,2014,8,6,9,802,881,1683,1540
0131-002,2014,8,6,10,768,711,1479,1683
0131-002,2014,8,6,11,711,718,1429,1479
0131-002,2014,8,6,12,714,704,1418,1429
0131-002,2014,8,6,13,687,627,1314,1418
0131-002,2014,8,6,14,692,724,1416,1314
0131-002,2014,8,6,15,722,742,1464,1416
0131-002,2014,8,6,16,716,750,1466,1464
0131-002,2014,8,6,17,701,794,1495,1466
0131-002,2014,8,6,18,720,868,1588,1495
0131-002,2014,8,6,19,752,883,1635,1588
0131-002,2014,8,6,20,623,647,1270,1635
0131-002,2014,8,6,21,420,564,984,1270
0131-002,2014,8,6,22,363,438,801,984
0131-002,2014,8,6,23,250,311,561,801
0131-002,2014,8,6,24,197,186,383,561
0131-002,2014,8,7,1,138,119,257,383
0131-002,2014,8,7,2,85,89,174,257
0131-002,2014,8,7,3,80,70,150,174
0131-002,2014,8,7,4,101,63,164,150
0131-002,2014,8,7,5,114,85,199,164
0131-002,2014,8,7,6,226,140,366,199
0131-002,2014,8,7,7,462,288,750,366
0131-002,2014,8,7,8,818,772,1590,750
0131-002,2014,8,7,9,813,903,1716,1590
0131-002,2014,8,7,10,770,789,1559,1716
0131-002,2014,8,7,11,773,753,1526,1559
0131-002,2014,8,7,12,698,755,1453,1526
0131-002,2014,8,7,13,673,634,1307,1453
0131-002,2014,8,7,14,708,668,1376,1307
0131-002,2014,8,7,15,770,803,1573,1376
0131-002,2014,8,7,16,767,750,1517,1573
0131-002,2014,8,7,17,701,766,1467,1517
0131-002,2014,8,7,18,776,885,1661,1467
0131-002,2014,8,7,19,703,867,1570,1661
0131-002,2014,8,7,20,529,710,1239,1570
0131-002,2014,8,7,21,473,590,1063,1239
0131-002,2014,8,7,22,414,449,863,1063
0131-002,2014,8,7,23,310,313,623,863
0131-002,2014,8,7,24,226,166,392,623
0131-002,2014,8,8,1,163,128,291,392
0131-002,2014,8,8,2,144,80,224,291
0131-002,2014,8,8,3,96,53,149,224
0131-002,2014,8,8,4,117,68,185,149
0131-002,2014,8,8,5,107,95,202,185
0131-002,2014,8,8,6,245,154,399,202
0131-002,2014,8,8,7,516,258,774,399
0131-002,2014,8,8,8,824,778,1602,774
0131-002,2014,8,8,9,829,946,1775,1602
0131-002,2014,8,8,10,730,733,1463,1775
0131-002,2014,8,8,11,813,726,1539,1463
0131-002,2014,8,8,12,705,729,1434,1539
0131-002,2014,8,8,13,679,695,1374,1434
0131-002,2014,8,8,14,727,753,1480,1374
0131-002,2014,8,8,15,803,833,1636,1480
0131-002,2014,8,8,16,770,870,1640,1636
0131-002,2014,8,8,17,802,857,1659,1640
0131-002,2014,8,8,18,821,939,1760,1659
0131-002,2014,8,8,19,818,972,1790,1760
0131-002,2014,8,8,20,660,790,1450,1790
0131-002,2014,8,8,21,577,668,1245,1450
0131-002,2014,8,8,22,451,515,966,1245
0131-002,2014,8,8,23,318,340,658,966
0131-002,2014,8,8,24,230,223,453,658
0131-002,2014,8,9,1,165,158,323,453
0131-002,2014,8,9,2,175,111,286,323
0131-002,2014,8,9,3,119,90,209,286
0131-002,2014,8,9,4,115,83,198,209
0131-002,2014,8,9,5,136,81,217,198
0131-002,2014,8,9,6,259,136,395,217
0131-002,2014,8,9,7,455,292,747,395
0131-002,2014,8,9,8,593,495,1088,747
0131-002,2014,8,9,9,625,641,1266,1088
0131-002,2014,8,9,10,657,683,1340,1266
0131-002,2014,8,9,11,693,852,1545,1340
0131-002,2014,8,9,12,744,975,1719,1545
0131-002,2014,8,9,13,652,954,1606,1719
0131-002,2014,8,9,14,604,985,1589,1606
0131-002,2014,8,9,15,689,916,1605,1589
0131-002,2014,8,9,16,653,789,1442,1605
0131-002,2014,8,9,17,679,767,1446,1442
0131-002,2014,8,9,18,734,842,1576,1446
0131-002,2014,8,9,19,687,725,1412,1576
0131-002,2014,8,9,20,566,547,1113,1412
0131-002,2014,8,9,21,534,389,923,1113
0131-002,2014,8,9,22,390,375,765,923
0131-002,2014,8,9,23,305,241,546,765
0131-002,2014,8,9,24,198,172,370,546
0131-002,2014,8,10,1,143,135,278,370
0131-002,2014,8,10,2,109,89,198,278
0131-002,2014,8,10,3,84,68,152,198
0131-002,2014,8,10,4,74,60,134,152
0131-002,2014,8,10,5,95,59,154,134
0131-002,2014,8,10,6,144,81,225,154
0131-002,2014,8,10,7,325,177,502,225
0131-002,2014,8,10,8,355,219,574,502
0131-002,2014,8,10,9,364,315,679,574
0131-002,2014,8,10,10,424,358,782,679
0131-002,2014,8,10,11,440,438,878,782
0131-002,2014,8,10,12,500,424,924,878
0131-002,2014,8,10,13,478,467,945,924
0131-002,2014,8,10,14,562,484,1046,945
0131-002,2014,8,10,15,559,485,1044,1046
0131-002,2014,8,10,16,615,497,1112,1044
0131-002,2014,8,10,17,607,491,1098,1112
0131-002,2014,8,10,18,839,476,1315,1098
0131-002,2014,8,10,19,740,397,1137,1315
0131-002,2014,8,10,20,620,399,1019,1137
0131-002,2014,8,10,21,629,303,932,1019
0131-002,2014,8,10,22,420,277,697,932
0131-002,2014,8,10,23,302,208,510,697
0131-002,2014,8,10,24,211,125,336,510
0131-002,2014,8,11,1,162,82,244,336
0131-002,2014,8,11,2,88,60,148,244
0131-002,2014,8,11,3,99,54,153,148
0131-002,2014,8,11,4,93,49,142,153
0131-002,2014,8,11,5,127,62,189,142
0131-002,2014,8,11,6,317,123,440,189
0131-002,2014,8,11,7,689,311,1000,440
0131-002,2014,8,11,8,1074,850,1924,1000
0131-002,2014,8,11,9,883,918,1801,1924
0131-002,2014,8,11,10,845,735,1580,1801
0131-002,2014,8,11,11,821,747,1568,1580
0131-002,2014,8,11,12,776,736,1512,1568
0131-002,2014,8,11,13,743,688,1431,1512
0131-002,2014,8,11,14,832,701,1533,1431
0131-002,2014,8,11,15,938,802,1740,1533
0131-002,2014,8,11,16,909,789,1698,1740
0131-002,2014,8,11,17,855,783,1638,1698
0131-002,2014,8,11,18,816,867,1683,1638
0131-002,2014,8,11,19,780,848,1628,1683
0131-002,2014,8,11,20,604,713,1317,1628
0131-002,2014,8,11,21,518,637,1155,1317
0131-002,2014,8,11,22,436,478,914,1155
0131-002,2014,8,11,23,294,324,618,914
0131-002,2014,8,11,24,242,171,413,618
0131-002,2014,8,12,1,170,105,275,413
0131-002,2014,8,12,2,133,75,208,275
0131-002,2014,8,12,3,91,53,144,208
0131-002,2014,8,12,4,130,61,191,144
0131-002,2014,8,12,5,131,72,203,191
0131-002,2014,8,12,6,323,135,458,203
0131-002,2014,8,12,7,594,302,896,458
0131-002,2014,8,12,8,964,840,1804,896
0131-002,2014,8,12,9,947,884,1831,1804
0131-002,2014,8,12,10,887,803,1690,1831
0131-002,2014,8,12,11,880,746,1626,1690
0131-002,2014,8,12,12,834,763,1597,1626
0131-002,2014,8,12,13,784,676,1460,1597
0131-002,2014,8,12,14,835,756,1591,1460
0131-002,2014,8,12,15,909,877,1786,1591
0131-002,2014,8,12,16,887,861,1748,1786
0131-002,2014,8,12,17,805,874,1679,1748
0131-002,2014,8,12,18,792,942,1734,1679
0131-002,2014,8,12,19,788,1030,1818,1734
0131-002,2014,8,12,20,637,845,1482,1818
0131-002,2014,8,12,21,523,709,1232,1482
0131-002,2014,8,12,22,438,496,934,1232
0131-002,2014,8,12,23,312,328,640,934
0131-002,2014,8,12,24,238,219,457,640
0131-002,2014,8,13,1,197,130,327,457
0131-002,2014,8,13,2,123,104,227,327
0131-002,2014,8,13,3,136,67,203,227
0131-002,2014,8,13,4,96,62,158,203
0131-002,2014,8,13,5,130,84,214,158
0131-002,2014,8,13,6,296,116,412,214
0131-002,2014,8,13,7,631,260,891,412
0131-002,2014,8,13,8,915,776,1691,891
0131-002,2014,8,13,9,946,897,1843,1691
0131-002,2014,8,13,10,819,736,1555,1843
0131-002,2014,8,13,11,922,731,1653,1555
0131-002,2014,8,13,12,813,707,1520,1653
0131-002,2014,8,13,13,772,625,1397,1520
0131-002,2014,8,13,14,775,707,1482,1397
0131-002,2014,8,13,15,890,747,1637,1482
0131-002,2014,8,13,16,938,786,1724,1637
0131-002,2014,8,13,17,874,776,1650,1724
0131-002,2014,8,13,18,842,879,1721,1650
0131-002,2014,8,13,19,811,891,1702,1721
0131-002,2014,8,13,20,677,657,1334,1702
0131-002,2014,8,13,21,532,565,1097,1334
0131-002,2014,8,13,22,419,434,853,1097
0131-002,2014,8,13,23,347,225,572,853
0131-002,2014,8,13,24,205,149,354,572
0131-002,2014,8,14,1,171,95,266,354
0131-002,2014,8,14,2,114,76,190,266
0131-002,2014,8,14,3,109,41,150,190
0131-002,2014,8,14,4,141,57,198,150
0131-002,2014,8,14,5,146,78,224,198
0131-002,2014,8,14,6,310,124,434,224
0131-002,2014,8,14,7,556,275,831,434
0131-002,2014,8,14,8,926,847,1773,831
0131-002,2014,8,14,9,933,932,1865,1773
0131-002,2014,8,14,10,880,725,1605,1865
0131-002,2014,8,14,11,861,747,1608,1605
0131-002,2014,8,14,12,832,781,1613,1608
0131-002,2014,8,14,13,711,684,1395,1613
0131-002,2014,8,14,14,768,752,1520,1395
0131-002,2014,8,14,15,871,873,1744,1520
0131-002,2014,8,14,16,850,828,1678,1744
0131-002,2014,8,14,17,789,851,1640,1678
0131-002,2014,8,14,18,783,833,1616,1640
0131-002,2014,8,14,19,831,878,1709,1616
0131-002,2014,8,14,20,689,761,1450,1709
0131-002,2014,8,14,21,644,662,1306,1450
0131-002,2014,8,14,22,483,478,961,1306
0131-002,2014,8,14,23,361,308,669,961
0131-002,2014,8,14,24,251,191,442,669
0131-002,2014,8,15,1,190,132,322,442
0131-002,2014,8,15,2,141,72,213,322
0131-002,2014,8,15,3,127,49,176,213
0131-002,2014,8,15,4,122,59,181,176
0131-002,2014,8,15,5,139,99,238,181
0131-002,2014,8,15,6,266,137,403,238
0131-002,2014,8,15,7,505,285,790,403
0131-002,2014,8,15,8,666,812,1478,790
0131-002,2014,8,15,9,620,968,1588,1478
0131-002,2014,8,15,10,701,829,1530,1588
0131-002,2014,8,15,11,689,839,1528,1530
0131-002,2014,8,15,12,679,810,1489,1528
0131-002,2014,8,15,13,639,703,1342,1489
0131-002,2014,8,15,14,663,754,1417,1342
0131-002,2014,8,15,15,676,847,1523,1417
0131-002,2014,8,15,16,757,890,1647,1523
0131-002,2014,8,15,17,750,902,1652,1647
0131-002,2014,8,15,18,698,1039,1737,1652
0131-002,2014,8,15,19,724,1044,1768,1737
0131-002,2014,8,15,20,578,883,1461,1768
0131-002,2014,8,15,21,510,832,1342,1461
0131-002,2014,8,15,22,385,580,965,1342
0131-002,2014,8,15,23,323,384,707,965
0131-002,2014,8,15,24,213,247,460,707
0131-002,2014,8,16,1,168,155,323,460
0131-002,2014,8,16,2,138,136,274,323
0131-002,2014,8,16,3,111,85,196,274
0131-002,2014,8,16,4,111,71,182,196
0131-002,2014,8,16,5,127,101,228,182
0131-002,2014,8,16,6,232,117,349,228
0131-002,2014,8,16,7,499,249,748,349
0131-002,2014,8,16,8,566,491,1057,748
0131-002,2014,8,16,9,620,682,1302,1057
0131-002,2014,8,16,10,588,721,1309,1302
0131-002,2014,8,16,11,685,859,1544,1309
0131-002,2014,8,16,12,663,964,1627,1544
0131-002,2014,8,16,13,625,955,1580,1627
0131-002,2014,8,16,14,596,954,1550,1580
0131-002,2014,8,16,15,693,930,1623,1550
0131-002,2014,8,16,16,714,873,1587,1623
0131-002,2014,8,16,17,796,899,1695,1587
0131-002,2014,8,16,18,800,976,1776,1695
0131-002,2014,8,16,19,765,803,1568,1776
0131-002,2014,8,16,20,775,777,1552,1568
0131-002,2014,8,16,21,789,799,1588,1552
0131-002,2014,8,16,22,637,480,1117,1588
0131-002,2014,8,16,23,395,357,752,1117
0131-002,2014,8,16,24,258,178,436,752
0131-002,2014,8,17,1,171,116,287,436
0131-002,2014,8,17,2,117,99,216,287
0131-002,2014,8,17,3,91,67,158,216
0131-002,2014,8,17,4,93,63,156,158
0131-002,2014,8,17,5,76,57,133,156
0131-002,2014,8,17,6,167,80,247,133
0131-002,2014,8,17,7,262,144,406,247
0131-002,2014,8,17,8,318,200,518,406
0131-002,2014,8,17,9,376,333,709,518
0131-002,2014,8,17,10,396,346,742,709
0131-002,2014,8,17,11,449,431,880,742
0131-002,2014,8,17,12,540,500,1040,880
0131-002,2014,8,17,13,633,508,1141,1040
0131-002,2014,8,17,14,652,510,1162,1141
0131-002,2014,8,17,15,697,525,1222,1162
0131-002,2014,8,17,16,728,558,1286,1222
0131-002,2014,8,17,17,735,602,1337,1286
0131-002,2014,8,17,18,722,645,1367,1337
0131-002,2014,8,17,19,733,567,1300,1367
0131-002,2014,8,17,20,720,495,1215,1300
0131-002,2014,8,17,21,631,373,1004,1215
0131-002,2014,8,17,22,425,307,732,1004
0131-002,2014,8,17,23,301,228,529,732
0131-002,2014,8,17,24,206,138,344,529
0131-002,2014,8,18,1,157,102,259,344
0131-002,2014,8,18,2,101,78,179,259
0131-002,2014,8,18,3,103,47,150,179
0131-002,2014,8,18,4,98,50,148,150
0131-002,2014,8,18,5,128,78,206,148
0131-002,2014,8,18,6,250,152,402,206
0131-002,2014,8,18,7,615,306,921,402
0131-002,2014,8,18,8,985,901,1886,921
0131-002,2014,8,18,9,879,938,1817,1886
0131-002,2014,8,18,10,803,759,1562,1817
0131-002,2014,8,18,11,797,782,1579,1562
0131-002,2014,8,18,12,792,758,1550,1579
0131-002,2014,8,18,13,756,684,1440,1550
0131-002,2014,8,18,14,789,745,1534,1440
0131-002,2014,8,18,15,890,822,1712,1534
0131-002,2014,8,18,16,882,802,1684,1712
0131-002,2014,8,18,17,821,801,1622,1684
0131-002,2014,8,18,18,733,771,1504,1622
0131-002,2014,8,18,19,764,776,1540,1504
0131-002,2014,8,18,20,604,634,1238,1540
0131-002,2014,8,18,21,499,574,1073,1238
0131-002,2014,8,18,22,377,402,779,1073
0131-002,2014,8,18,23,296,272,568,779
0131-002,2014,8,18,24,190,172,362,568
0131-002,2014,8,19,1,168,113,281,362
0131-002,2014,8,19,2,104,79,183,281
0131-002,2014,8,19,3,114,48,162,183
0131-002,2014,8,19,4,120,61,181,162
0131-002,2014,8,19,5,131,71,202,181
0131-002,2014,8,19,6,248,144,392,202
0131-002,2014,8,19,7,551,289,840,392
0131-002,2014,8,19,8,923,873,1796,840
0131-002,2014,8,19,9,947,941,1888,1796
0131-002,2014,8,19,10,839,772,1611,1888
0131-002,2014,8,19,11,859,749,1608,1611
0131-002,2014,8,19,12,819,786,1605,1608
0131-002,2014,8,19,13,762,662,1424,1605
0131-002,2014,8,19,14,837,752,1589,1424
0131-002,2014,8,19,15,847,863,1710,1589
0131-002,2014,8,19,16,861,736,1597,1710
0131-002,2014,8,19,17,818,798,1616,1597
0131-002,2014,8,19,18,805,852,1657,1616
0131-002,2014,8,19,19,743,868,1611,1657
0131-002,2014,8,19,20,620,724,1344,1611
0131-002,2014,8,19,21,500,655,1155,1344
0131-002,2014,8,19,22,424,452,876,1155
0131-002,2014,8,19,23,320,309,629,876
0131-002,2014,8,19,24,246,182,428,629
0131-002,2014,8,20,1,198,103,301,428
0131-002,2014,8,20,2,135,87,222,301
0131-002,2014,8,20,3,125,54,179,222
0131-002,2014,8,20,4,107,51,158,179
0131-002,2014,8,20,5,139,73,212,158
0131-002,2014,8,20,6,291,97,388,212
0131-002,2014,8,20,7,553,225,778,388
0131-002,2014,8,20,8,977,809,1786,778
0131-002,2014,8,20,9,950,900,1850,1786
0131-002,2014,8,20,10,847,761,1608,1850
0131-002,2014,8,20,11,891,743,1634,1608
0131-002,2014,8,20,12,807,710,1517,1634
0131-002,2014,8,20,13,744,623,1367,1517
0131-002,2014,8,20,14,796,692,1488,1367
0131-002,2014,8,20,15,826,752,1578,1488
0131-002,2014,8,20,16,888,821,1709,1578
0131-002,2014,8,20,17,778,758,1536,1709
0131-002,2014,8,20,18,880,889,1769,1536
0131-002,2014,8,20,19,772,908,1680,1769
0131-002,2014,8,20,20,636,666,1302,1680
0131-002,2014,8,20,21,467,567,1034,1302
0131-002,2014,8,20,22,435,431,866,1034
0131-002,2014,8,20,23,313,298,611,866
0131-002,2014,8,20,24,251,167,418,611
0131-002,2014,8,21,1,155,112,267,418
0131-002,2014,8,21,2,123,81,204,267
0131-002,2014,8,21,3,87,68,155,204
0131-002,2014,8,21,4,127,58,185,155
0131-002,2014,8,21,5,112,75,187,185
0131-002,2014,8,21,6,240,115,355,187
0131-002,2014,8,21,7,524,269,793,355
0131-002,2014,8,21,8,924,846,1770,793
0131-002,2014,8,21,9,917,923,1840,1770
0131-002,2014,8,21,10,824,778,1602,1840
0131-002,2014,8,21,11,861,809,1670,1602
0131-002,2014,8,21,12,819,764,1583,1670
0131-002,2014,8,21,13,689,662,1351,1583
0131-002,2014,8,21,14,799,760,1559,1351
0131-002,2014,8,21,15,874,781,1655,1559
0131-002,2014,8,21,16,867,764,1631,1655
0131-002,2014,8,21,17,786,765,1551,1631
0131-002,2014,8,21,18,760,926,1686,1551
0131-002,2014,8,21,19,744,866,1610,1686
0131-002,2014,8,21,20,599,747,1346,1610
0131-002,2014,8,21,21,505,656,1161,1346
0131-002,2014,8,21,22,451,478,929,1161
0131-002,2014,8,21,23,336,321,657,929
0131-002,2014,8,21,24,218,183,401,657
0131-002,2014,8,22,1,186,145,331,401
0131-002,2014,8,22,2,135,83,218,331
0131-002,2014,8,22,3,123,63,186,218
0131-002,2014,8,22,4,98,62,160,186
0131-002,2014,8,22,5,133,89,222,160
0131-002,2014,8,22,6,312,134,446,222
0131-002,2014,8,22,7,567,256,823,446
0131-002,2014,8,22,8,960,848,1808,823
0131-002,2014,8,22,9,942,955,1897,1808
0131-002,2014,8,22,10,904,790,1694,1897
0131-002,2014,8,22,11,821,761,1582,1694
0131-002,2014,8,22,12,827,755,1582,1582
0131-002,2014,8,22,13,823,690,1513,1582
0131-002,2014,8,22,14,837,772,1609,1513
0131-002,2014,8,22,15,882,856,1738,1609
0131-002,2014,8,22,16,981,829,1810,1738
0131-002,2014,8,22,17,1042,881,1923,1810
0131-002,2014,8,22,18,898,938,1836,1923
0131-002,2014,8,22,19,845,947,1792,1836
0131-002,2014,8,22,20,724,810,1534,1792
0131-002,2014,8,22,21,580,645,1225,1534
0131-002,2014,8,22,22,473,500,973,1225
0131-002,2014,8,22,23,369,341,710,973
0131-002,2014,8,22,24,250,212,462,710
0131-002,2014,8,23,1,245,150,395,462
0131-002,2014,8,23,2,182,113,295,395
0131-002,2014,8,23,3,165,72,237,295
0131-002,2014,8,23,4,120,76,196,237
0131-002,2014,8,23,5,144,97,241,196
0131-002,2014,8,23,6,326,147,473,241
0131-002,2014,8,23,7,507,260,767,473
0131-002,2014,8,23,8,746,508,1254,767
0131-002,2014,8,23,9,708,682,1390,1254
0131-002,2014,8,23,10,754,775,1529,1390
0131-002,2014,8,23,11,776,868,1644,1529
0131-002,2014,8,23,12,773,964,1737,1644
0131-002,2014,8,23,13,701,956,1657,1737
0131-002,2014,8,23,14,733,924,1657,1657
0131-002,2014,8,23,15,736,944,1680,1657
0131-002,2014,8,23,16,722,956,1678,1680
0131-002,2014,8,23,17,802,1030,1832,1678
0131-002,2014,8,23,18,807,1103,1910,1832
0131-002,2014,8,23,19,776,881,1657,1910
0131-002,2014,8,23,20,748,606,1354,1657
0131-002,2014,8,23,21,642,434,1076,1354
0131-002,2014,8,23,22,457,367,824,1076
0131-002,2014,8,23,23,329,279,608,824
0131-002,2014,8,23,24,214,200,414,608
0131-002,2014,8,24,1,186,149,335,414
0131-002,2014,8,24,2,127,85,212,335
0131-002,2014,8,24,3,99,67,166,212
0131-002,2014,8,24,4,69,62,131,166
0131-002,2014,8,24,5,90,71,161,131
0131-002,2014,8,24,6,195,82,277,161
0131-002,2014,8,24,7,315,160,475,277
0131-002,2014,8,24,8,446,242,688,475
0131-002,2014,8,24,9,414,389,803,688
0131-002,2014,8,24,10,416,393,809,803
0131-002,2014,8,24,11,491,506,997,809
0131-002,2014,8,24,12,594,498,1092,997
0131-002,2014,8,24,13,629,491,1120,1092
0131-002,2014,8,24,14,759,502,1261,1120
0131-002,2014,8,24,15,791,552,1343,1261
0131-002,2014,8,24,16,904,540,1444,1343
0131-002,2014,8,24,17,826,613,1439,1444
0131-002,2014,8,24,18,864,603,1467,1439
0131-002,2014,8,24,19,829,535,1364,1467
0131-002,2014,8,24,20,765,494,1259,1364
0131-002,2014,8,24,21,780,409,1189,1259
0131-002,2014,8,24,22,816,366,1182,1189
0131-002,2014,8,24,23,452,264,716,1182
0131-002,2014,8,24,24,301,187,488,716
0131-002,2014,8,25,1,160,102,262,488
0131-002,2014,8,25,2,106,65,171,262
0131-002,2014,8,25,3,77,32,109,171
0131-002,2014,8,25,4,64,60,124,109
0131-002,2014,8,25,5,128,86,214,124
0131-002,2014,8,25,6,299,154,453,214
0131-002,2014,8,25,7,582,369,951,453
0131-002,2014,8,25,8,1117,954,2071,951
0131-002,2014,8,25,9,963,958,1921,2071
0131-002,2014,8,25,10,780,783,1563,1921
0131-002,2014,8,25,11,813,819,1632,1563
0131-002,2014,8,25,12,796,781,1577,1632
0131-002,2014,8,25,13,697,681,1378,1577
0131-002,2014,8,25,14,792,788,1580,1378
0131-002,2014,8,25,15,861,843,1704,1580
0131-002,2014,8,25,16,810,814,1624,1704
0131-002,2014,8,25,17,875,819,1694,1624
0131-002,2014,8,25,18,792,949,1741,1694
0131-002,2014,8,25,19,799,948,1747,1741
0131-002,2014,8,25,20,585,779,1364,1747
0131-002,2014,8,25,21,548,704,1252,1364
0131-002,2014,8,25,22,419,508,927,1252
0131-002,2014,8,25,23,342,304,646,927
0131-002,2014,8,25,24,254,206,460,646
0131-002,2014,8,26,1,171,115,286,460
0131-002,2014,8,26,2,135,80,215,286
0131-002,2014,8,26,3,114,59,173,215
0131-002,2014,8,26,4,114,51,165,173
0131-002,2014,8,26,5,144,74,218,165
0131-002,2014,8,26,6,281,126,407,218
0131-002,2014,8,26,7,602,331,933,407
0131-002,2014,8,26,8,996,855,1851,933
0131-002,2014,8,26,9,912,986,1898,1851
0131-002,2014,8,26,10,904,862,1766,1898
0131-002,2014,8,26,11,855,874,1729,1766
0131-002,2014,8,26,12,832,897,1729,1729
0131-002,2014,8,26,13,765,749,1514,1729
0131-002,2014,8,26,14,811,807,1618,1514
0131-002,2014,8,26,15,922,927,1849,1618
0131-002,2014,8,26,16,922,866,1788,1849
0131-002,2014,8,26,17,834,903,1737,1788
0131-002,2014,8,26,18,826,998,1824,1737
0131-002,2014,8,26,19,816,975,1791,1824
0131-002,2014,8,26,20,633,583,1216,1791
0131-002,2014,8,26,21,548,544,1092,1216
0131-002,2014,8,26,22,436,372,808,1092
0131-002,2014,8,26,23,337,224,561,808
0131-002,2014,8,26,24,256,149,405,561
0131-002,2014,8,27,1,181,95,276,405
0131-002,2014,8,27,2,135,68,203,276
0131-002,2014,8,27,3,104,41,145,203
0131-002,2014,8,27,4,111,43,154,145
0131-002,2014,8,27,5,131,72,203,154
0131-002,2014,8,27,6,293,125,418,203
0131-002,2014,8,27,7,625,257,882,418
0131-002,2014,8,27,8,986,830,1816,882
0131-002,2014,8,27,9,977,966,1943,1816
0131-002,2014,8,27,10,880,768,1648,1943
0131-002,2014,8,27,11,872,840,1712,1648
0131-002,2014,8,27,12,813,785,1598,1712
0131-002,2014,8,27,13,736,711,1447,1598
0131-002,2014,8,27,14,835,776,1611,1447
0131-002,2014,8,27,15,914,829,1743,1611
0131-002,2014,8,27,16,831,846,1677,1743
0131-002,2014,8,27,17,816,797,1613,1677
0131-002,2014,8,27,18,842,949,1791,1613
0131-002,2014,8,27,19,786,970,1756,1791
0131-002,2014,8,27,20,660,736,1396,1756
0131-002,2014,8,27,21,489,630,1119,1396
0131-002,2014,8,27,22,467,466,933,1119
0131-002,2014,8,27,23,347,302,649,933
0131-002,2014,8,27,24,291,212,503,649
0131-002,2014,8,28,1,202,136,338,503
0131-002,2014,8,28,2,131,79,210,338
0131-002,2014,8,28,3,120,63,183,210
0131-002,2014,8,28,4,101,62,163,183
0131-002,2014,8,28,5,159,89,248,163
0131-002,2014,8,28,6,325,103,428,248
0131-002,2014,8,28,7,636,268,904,428
0131-002,2014,8,28,8,1005,866,1871,904
0131-002,2014,8,28,9,915,983,1898,1871
0131-002,2014,8,28,10,851,851,1702,1898
0131-002,2014,8,28,11,902,878,1780,1702
0131-002,2014,8,28,12,794,846,1640,1780
0131-002,2014,8,28,13,775,754,1529,1640
0131-002,2014,8,28,14,843,831,1674,1529
0131-002,2014,8,28,15,906,908,1814,1674
0131-002,2014,8,28,16,890,867,1757,1814
0131-002,2014,8,28,17,877,831,1708,1757
0131-002,2014,8,28,18,890,950,1840,1708
0131-002,2014,8,28,19,866,890,1756,1840
0131-002,2014,8,28,20,649,761,1410,1756
0131-002,2014,8,28,21,545,603,1148,1410
0131-002,2014,8,28,22,425,438,863,1148
0131-002,2014,8,28,23,329,277,606,863
0131-002,2014,8,28,24,235,178,413,606
0131-002,2014,8,29,1,205,114,319,413
0131-002,2014,8,29,2,173,78,251,319
0131-002,2014,8,29,3,104,67,171,251
0131-002,2014,8,29,4,109,65,174,171
0131-002,2014,8,29,5,165,83,248,174
0131-002,2014,8,29,6,307,125,432,248
0131-002,2014,8,29,7,628,281,909,432
0131-002,2014,8,29,8,1023,870,1893,909
0131-002,2014,8,29,9,944,1001,1945,1893
0131-002,2014,8,29,10,866,793,1659,1945
0131-002,2014,8,29,11,887,858,1745,1659
0131-002,2014,8,29,12,842,847,1689,1745
0131-002,2014,8,29,13,778,705,1483,1689
0131-002,2014,8,29,14,813,793,1606,1483
0131-002,2014,8,29,15,885,879,1764,1606
0131-002,2014,8,29,16,877,891,1768,1764
0131-002,2014,8,29,17,894,887,1781,1768
0131-002,2014,8,29,18,917,1013,1930,1781
0131-002,2014,8,29,19,808,973,1781,1930
0131-002,2014,8,29,20,669,861,1530,1781
0131-002,2014,8,29,21,626,700,1326,1530
0131-002,2014,8,29,22,518,550,1068,1326
0131-002,2014,8,29,23,363,389,752,1068
0131-002,2014,8,29,24,259,255,514,752
0131-002,2014,8,30,1,222,145,367,514
0131-002,2014,8,30,2,160,107,267,367
0131-002,2014,8,30,3,99,84,183,267
0131-002,2014,8,30,4,128,79,207,183
0131-002,2014,8,30,5,157,82,239,207
0131-002,2014,8,30,6,320,119,439,239
0131-002,2014,8,30,7,470,250,720,439
0131-002,2014,8,30,8,752,472,1224,720
0131-002,2014,8,30,9,749,715,1464,1224
0131-002,2014,8,30,10,661,803,1464,1464
0131-002,2014,8,30,11,780,898,1678,1464
0131-002,2014,8,30,12,706,1071,1777,1678
0131-002,2014,8,30,13,759,1069,1828,1777
0131-002,2014,8,30,14,856,1058,1914,1828
0131-002,2014,8,30,15,784,1021,1805,1914
0131-002,2014,8,30,16,837,1090,1927,1805
0131-002,2014,8,30,17,877,1108,1985,1927
0131-002,2014,8,30,18,893,1072,1965,1985
0131-002,2014,8,30,19,842,914,1756,1965
0131-002,2014,8,30,20,794,633,1427,1756
0131-002,2014,8,30,21,669,435,1104,1427
0131-002,2014,8,30,22,542,372,914,1104
0131-002,2014,8,30,23,345,264,609,914
0131-002,2014,8,30,24,254,159,413,609
0131-002,2014,8,31,1,168,103,271,413
0131-002,2014,8,31,2,136,75,211,271
0131-002,2014,8,31,3,114,61,175,211
0131-002,2014,8,31,4,88,52,140,175
0131-002,2014,8,31,5,93,54,147,140
0131-002,2014,8,31,6,178,75,253,147
0131-002,2014,8,31,7,305,160,465,253
0131-002,2014,8,31,8,468,258,726,465
0131-002,2014,8,31,9,438,350,788,726
0131-002,2014,8,31,10,462,411,873,788
0131-002,2014,8,31,11,540,440,980,873
0131-002,2014,8,31,12,540,469,1009,980
0131-002,2014,8,31,13,582,441,1023,1009
0131-002,2014,8,31,14,649,455,1104,1023
0131-002,2014,8,31,15,780,497,1277,1104
0131-002,2014,8,31,16,808,516,1324,1277
0131-002,2014,8,31,17,857,537,1394,1324
0131-002,2014,8,31,18,856,569,1425,1394
0131-002,2014,8,31,19,794,477,1271,1425
0131-002,2014,8,31,20,738,413,1151,1271
0131-002,2014,8,31,21,705,342,1047,1151
0131-002,2014,8,31,22,538,281,819,1047
0131-002,2014,8,31,23,339,199,538,819
0131-002,2014,8,31,24,200,132,332,538
0131-002,2014,9,1,1,154,100,254,332
0131-002,2014,9,1,2,100,63,163,254
0131-002,2014,9,1,3,100,45,145,163
0131-002,2014,9,1,4,92,63,155,145
0131-002,2014,9,1,5,112,81,193,155
0131-002,2014,9,1,6,337,171,508,193
0131-002,2014,9,1,7,608,374,982,508
0131-002,2014,9,1,8,997,858,1855,982
0131-002,2014,9,1,9,967,902,1869,1855
0131-002,2014,9,1,10,757,866,1623,1869
0131-002,2014,9,1,11,794,858,1652,1623
0131-002,2014,9,1,12,776,853,1629,1652
0131-002,2014,9,1,13,677,764,1441,1629
0131-002,2014,9,1,14,794,860,1654,1441
0131-002,2014,9,1,15,868,964,1832,1654
0131-002,2014,9,1,16,865,944,1809,1832
0131-002,2014,9,1,17,823,947,1770,1809
0131-002,2014,9,1,18,784,1057,1841,1770
0131-002,2014,9,1,19,743,1040,1783,1841
0131-002,2014,9,1,20,607,821,1428,1783
0131-002,2014,9,1,21,521,740,1261,1428
0131-002,2014,9,1,22,448,541,989,1261
0131-002,2014,9,1,23,307,307,614,989
0131-002,2014,9,1,24,206,201,407,614
0131-002,2014,9,2,1,173,124,297,407
0131-002,2014,9,2,2,128,85,213,297
0131-002,2014,9,2,3,106,75,181,213
0131-002,2014,9,2,4,101,76,177,181
0131-002,2014,9,2,5,151,81,232,177
0131-002,2014,9,2,6,283,162,445,232
0131-002,2014,9,2,7,553,339,892,445
0131-002,2014,9,2,8,946,760,1706,892
0131-002,2014,9,2,9,865,945,1810,1706
0131-002,2014,9,2,10,836,863,1699,1810
0131-002,2014,9,2,11,818,906,1724,1699
0131-002,2014,9,2,12,832,915,1747,1724
0131-002,2014,9,2,13,755,760,1515,1747
0131-002,2014,9,2,14,749,783,1532,1515
0131-002,2014,9,2,15,898,899,1797,1532
0131-002,2014,9,2,16,809,905,1714,1797
0131-002,2014,9,2,17,788,915,1703,1714
0131-002,2014,9,2,18,752,1039,1791,1703
0131-002,2014,9,2,19,776,982,1758,1791
0131-002,2014,9,2,20,608,787,1395,1758
0131-002,2014,9,2,21,514,696,1210,1395
0131-002,2014,9,2,22,440,512,952,1210
0131-002,2014,9,2,23,311,313,624,952
0131-002,2014,9,2,24,232,209,441,624
0131-002,2014,9,3,1,145,140,285,441
0131-002,2014,9,3,2,137,94,231,285
0131-002,2014,9,3,3,94,70,164,231
0131-002,2014,9,3,4,88,93,181,164
0131-002,2014,9,3,5,119,102,221,181
0131-002,2014,9,3,6,208,180,388,221
0131-002,2014,9,3,7,479,359,838,388
0131-002,2014,9,3,8,895,820,1715,838
0131-002,2014,9,3,9,923,947,1870,1715
0131-002,2014,9,3,10,818,848,1666,1870
0131-002,2014,9,3,11,800,886,1686,1666
0131-002,2014,9,3,12,821,849,1670,1686
0131-002,2014,9,3,13,707,748,1455,1670
0131-002,2014,9,3,14,745,805,1550,1455
0131-002,2014,9,3,15,886,909,1795,1550
0131-002,2014,9,3,16,806,871,1677,1795
0131-002,2014,9,3,17,773,898,1671,1677
0131-002,2014,9,3,18,695,1069,1764,1671
0131-002,2014,9,3,19,689,995,1684,1764
0131-002,2014,9,3,20,586,761,1347,1684
0131-002,2014,9,3,21,485,688,1173,1347
0131-002,2014,9,3,22,401,509,910,1173
0131-002,2014,9,3,23,311,302,613,910
0131-002,2014,9,3,24,244,225,469,613
0131-002,2014,9,4,1,191,146,337,469
0131-002,2014,9,4,2,122,87,209,337
0131-002,2014,9,4,3,109,69,178,209
0131-002,2014,9,4,4,94,85,179,178
0131-002,2014,9,4,5,134,100,234,179
0131-002,2014,9,4,6,262,170,432,234
0131-002,2014,9,4,7,521,358,879,432
0131-002,2014,9,4,8,931,804,1735,879
0131-002,2014,9,4,9,945,958,1903,1735
0131-002,2014,9,4,10,775,837,1612,1903
0131-002,2014,9,4,11,839,860,1699,1612
0131-002,2014,9,4,12,820,842,1662,1699
0131-002,2014,9,4,13,787,767,1554,1662
0131-002,2014,9,4,14,829,819,1648,1554
0131-002,2014,9,4,15,881,939,1820,1648
0131-002,2014,9,4,16,892,881,1773,1820
0131-002,2014,9,4,17,872,815,1687,1773
0131-002,2014,9,4,18,820,885,1705,1687
0131-002,2014,9,4,19,797,829,1626,1705
0131-002,2014,9,4,20,689,704,1393,1626
0131-002,2014,9,4,21,541,566,1107,1393
0131-002,2014,9,4,22,473,482,955,1107
0131-002,2014,9,4,23,358,322,680,955
0131-002,2014,9,4,24,238,205,443,680
0131-002,2014,9,5,1,181,111,292,443
0131-002,2014,9,5,2,145,83,228,292
0131-002,2014,9,5,3,104,58,162,228
0131-002,2014,9,5,4,107,59,166,162
0131-002,2014,9,5,5,133,94,227,166
0131-002,2014,9,5,6,286,149,435,227
0131-002,2014,9,5,7,532,285,817,435
0131-002,2014,9,5,8,946,772,1718,817
0131-002,2014,9,5,9,872,895,1767,1718
0131-002,2014,9,5,10,797,772,1569,1767
0131-002,2014,9,5,11,800,781,1581,1569
0131-002,2014,9,5,12,841,781,1622,1581
0131-002,2014,9,5,13,776,728,1504,1622
0131-002,2014,9,5,14,779,794,1573,1504
0131-002,2014,9,5,15,784,887,1671,1573
0131-002,2014,9,5,16,820,838,1658,1671
0131-002,2014,9,5,17,826,925,1751,1658
0131-002,2014,9,5,18,781,1082,1863,1751
0131-002,2014,9,5,19,838,1097,1935,1863
0131-002,2014,9,5,20,608,923,1531,1935
0131-002,2014,9,5,21,455,698,1153,1531
0131-002,2014,9,5,22,431,528,959,1153
0131-002,2014,9,5,23,328,356,684,959
0131-002,2014,9,5,24,245,232,477,684
0131-002,2014,9,6,1,172,584,756,477
0131-002,2014,9,6,2,146,491,637,756
0131-002,2014,9,6,3,142,526,668,637
0131-002,2014,9,6,4,118,642,760,668
0131-002,2014,9,6,5,143,862,1005,760
0131-002,2014,9,6,6,224,828,1052,1005
0131-002,2014,9,6,7,325,644,969,1052
0131-002,2014,9,6,8,467,557,1024,969
0131-002,2014,9,6,9,482,587,1069,1024
0131-002,2014,9,6,10,485,603,1088,1069
0131-002,2014,9,6,11,539,643,1182,1088
0131-002,2014,9,6,12,541,740,1281,1182
0131-002,2014,9,6,13,503,769,1272,1281
0131-002,2014,9,6,14,526,985,1511,1272
0131-002,2014,9,6,15,523,714,1237,1511
0131-002,2014,9,6,16,548,567,1115,1237
0131-002,2014,9,6,17,530,613,1143,1115
0131-002,2014,9,6,18,506,580,1086,1143
0131-002,2014,9,6,19,512,429,941,1086
0131-002,2014,9,6,20,401,288,689,941
0131-002,2014,9,6,21,344,234,578,689
0131-002,2014,9,6,22,259,168,427,578
0131-002,2014,9,6,23,218,120,338,427
0131-002,2014,9,6,24,164,66,230,338
0131-002,2014,9,7,1,113,50,163,230
0131-002,2014,9,7,2,98,34,132,163
0131-002,2014,9,7,3,86,26,112,132
0131-002,2014,9,7,4,52,21,73,112
0131-002,2014,9,7,5,79,18,97,73
0131-002,2014,9,7,6,82,53,135,97
0131-002,2014,9,7,7,136,132,268,135
0131-002,2014,9,7,8,242,324,566,268
0131-002,2014,9,7,9,311,350,661,566
0131-002,2014,9,7,10,398,498,896,661
0131-002,2014,9,7,11,466,804,1270,896
0131-002,2014,9,7,12,462,958,1420,1270
0131-002,2014,9,7,13,442,947,1389,1420
0131-002,2014,9,7,14,473,1062,1535,1389
0131-002,2014,9,7,15,416,1246,1662,1535
0131-002,2014,9,7,16,413,1166,1579,1662
0131-002,2014,9,7,17,451,1063,1514,1579
0131-002,2014,9,7,18,394,1082,1476,1514
0131-002,2014,9,7,19,340,768,1108,1476
0131-002,2014,9,7,20,331,567,898,1108
0131-002,2014,9,7,21,250,372,622,898
0131-002,2014,9,7,22,196,267,463,622
0131-002,2014,9,7,23,181,171,352,463
0131-002,2014,9,7,24,125,97,222,352
0131-002,2014,9,8,1,80,62,142,222
0131-002,2014,9,8,2,82,53,135,142
0131-002,2014,9,8,3,55,37,92,135
0131-002,2014,9,8,4,25,24,49,92
0131-002,2014,9,8,5,37,30,67,49
0131-002,2014,9,8,6,88,29,117,67
0131-002,2014,9,8,7,262,48,310,117
0131-002,2014,9,8,8,368,103,471,310
0131-002,2014,9,8,9,308,163,471,471
0131-002,2014,9,8,10,371,234,605,471
0131-002,2014,9,8,11,611,354,965,605
0131-002,2014,9,8,12,871,404,1275,965
0131-002,2014,9,8,13,862,410,1272,1275
0131-002,2014,9,8,14,943,476,1419,1272
0131-002,2014,9,8,15,938,489,1427,1419
0131-002,2014,9,8,16,937,452,1389,1427
0131-002,2014,9,8,17,889,424,1313,1389
0131-002,2014,9,8,18,883,415,1298,1313
0131-002,2014,9,8,19,773,394,1167,1298
0131-002,2014,9,8,20,823,337,1160,1167
0131-002,2014,9,8,21,911,282,1193,1160
0131-002,2014,9,8,22,670,204,874,1193
0131-002,2014,9,8,23,890,180,1070,874
0131-002,2014,9,8,24,604,118,722,1070
0131-002,2014,9,9,1,509,73,582,722
0131-002,2014,9,9,2,446,50,496,582
0131-002,2014,9,9,3,343,43,386,496
0131-002,2014,9,9,4,134,27,161,386
0131-002,2014,9,9,5,83,36,119,161
0131-002,2014,9,9,6,95,45,140,119
0131-002,2014,9,9,7,145,111,256,140
0131-002,2014,9,9,8,259,236,495,256
0131-002,2014,9,9,9,320,301,621,495
0131-002,2014,9,9,10,430,345,775,621
0131-002,2014,9,9,11,598,410,1008,775
0131-002,2014,9,9,12,701,426,1127,1008
0131-002,2014,9,9,13,781,413,1194,1127
0131-002,2014,9,9,14,773,440,1213,1194
0131-002,2014,9,9,15,776,454,1230,1213
0131-002,2014,9,9,16,914,432,1346,1230
0131-002,2014,9,9,17,916,447,1363,1346
0131-002,2014,9,9,18,878,528,1406,1363
0131-002,2014,9,9,19,808,465,1273,1406
0131-002,2014,9,9,20,841,328,1169,1273
0131-002,2014,9,9,21,800,279,1079,1169
0131-002,2014,9,9,22,854,236,1090,1079
0131-002,2014,9,9,23,713,173,886,1090
0131-002,2014,9,9,24,724,107,831,886
0131-002,2014,9,10,1,683,121,804,831
0131-002,2014,9,10,2,395,77,472,804
0131-002,2014,9,10,3,331,63,394,472
0131-002,2014,9,10,4,131,58,189,394
0131-002,2014,9,10,5,104,92,196,189
0131-002,2014,9,10,6,146,128,274,196
0131-002,2014,9,10,7,290,280,570,274
0131-002,2014,9,10,8,530,783,1313,570
0131-002,2014,9,10,9,496,933,1429,1313
0131-002,2014,9,10,10,463,798,1261,1429
0131-002,2014,9,10,11,595,774,1369,1261
0131-002,2014,9,10,12,575,782,1357,1369
0131-002,2014,9,10,13,628,706,1334,1357
0131-002,2014,9,10,14,592,774,1366,1334
0131-002,2014,9,10,15,601,859,1460,1366
0131-002,2014,9,10,16,670,842,1512,1460
0131-002,2014,9,10,17,683,868,1551,1512
0131-002,2014,9,10,18,649,969,1618,1551
0131-002,2014,9,10,19,628,945,1573,1618
0131-002,2014,9,10,20,545,727,1272,1573
0131-002,2014,9,10,21,407,616,1023,1272
0131-002,2014,9,10,22,394,488,882,1023
0131-002,2014,9,10,23,310,320,630,882
0131-002,2014,9,10,24,202,184,386,630
0131-002,2014,9,11,1,170,129,299,386
0131-002,2014,9,11,2,101,93,194,299
0131-002,2014,9,11,3,98,72,170,194
0131-002,2014,9,11,4,88,69,157,170
0131-002,2014,9,11,5,140,97,237,157
0131-002,2014,9,11,6,298,146,444,237
0131-002,2014,9,11,7,548,309,857,444
0131-002,2014,9,11,8,947,833,1780,857
0131-002,2014,9,11,9,880,938,1818,1780
0131-002,2014,9,11,10,733,820,1553,1818
0131-002,2014,9,11,11,754,837,1591,1553
0131-002,2014,9,11,12,748,813,1561,1591
0131-002,2014,9,11,13,677,713,1390,1561
0131-002,2014,9,11,14,742,758,1500,1390
0131-002,2014,9,11,15,817,876,1693,1500
0131-002,2014,9,11,16,802,850,1652,1693
0131-002,2014,9,11,17,722,887,1609,1652
0131-002,2014,9,11,18,710,982,1692,1609
0131-002,2014,9,11,19,718,965,1683,1692
0131-002,2014,9,11,20,533,757,1290,1683
0131-002,2014,9,11,21,455,676,1131,1290
0131-002,2014,9,11,22,424,488,912,1131
0131-002,2014,9,11,23,278,317,595,912
0131-002,2014,9,11,24,178,189,367,595
0131-002,2014,9,12,1,163,132,295,367
0131-002,2014,9,12,2,130,93,223,295
0131-002,2014,9,12,3,107,67,174,223
0131-002,2014,9,12,4,94,74,168,174
0131-002,2014,9,12,5,146,95,241,168
0131-002,2014,9,12,6,292,143,435,241
0131-002,2014,9,12,7,584,261,845,435
0131-002,2014,9,12,8,923,810,1733,845
0131-002,2014,9,12,9,931,956,1887,1733
0131-002,2014,9,12,10,796,820,1616,1887
0131-002,2014,9,12,11,815,865,1680,1616
0131-002,2014,9,12,12,805,814,1619,1680
0131-002,2014,9,12,13,652,747,1399,1619
0131-002,2014,9,12,14,823,813,1636,1399
0131-002,2014,9,12,15,866,913,1779,1636
0131-002,2014,9,12,16,811,902,1713,1779
0131-002,2014,9,12,17,800,912,1712,1713
0131-002,2014,9,12,18,728,1041,1769,1712
0131-002,2014,9,12,19,764,1055,1819,1769
0131-002,2014,9,12,20,631,855,1486,1819
0131-002,2014,9,12,21,487,690,1177,1486
0131-002,2014,9,12,22,431,536,967,1177
0131-002,2014,9,12,23,317,335,652,967
0131-002,2014,9,12,24,265,221,486,652
0131-002,2014,9,13,1,164,156,320,486
0131-002,2014,9,13,2,127,113,240,320
0131-002,2014,9,13,3,115,82,197,240
0131-002,2014,9,13,4,103,85,188,197
0131-002,2014,9,13,5,161,85,246,188
0131-002,2014,9,13,6,272,123,395,246
0131-002,2014,9,13,7,445,254,699,395
0131-002,2014,9,13,8,685,500,1185,699
0131-002,2014,9,13,9,643,664,1307,1185
0131-002,2014,9,13,10,643,707,1350,1307
0131-002,2014,9,13,11,724,821,1545,1350
0131-002,2014,9,13,12,679,911,1590,1545
0131-002,2014,9,13,13,644,857,1501,1590
0131-002,2014,9,13,14,688,862,1550,1501
0131-002,2014,9,13,15,620,832,1452,1550
0131-002,2014,9,13,16,689,758,1447,1452
0131-002,2014,9,13,17,745,752,1497,1447
0131-002,2014,9,13,18,786,830,1616,1497
0131-002,2014,9,13,19,692,711,1403,1616
0131-002,2014,9,13,20,542,555,1097,1403
0131-002,2014,9,13,21,455,413,868,1097
0131-002,2014,9,13,22,344,366,710,868
0131-002,2014,9,13,23,245,258,503,710
0131-002,2014,9,13,24,172,171,343,503
0131-002,2014,9,14,1,158,119,277,343
0131-002,2014,9,14,2,119,90,209,277
0131-002,2014,9,14,3,91,69,160,209
0131-002,2014,9,14,4,71,61,132,160
0131-002,2014,9,14,5,89,69,158,132
0131-002,2014,9,14,6,139,88,227,158
0131-002,2014,9,14,7,256,172,428,227
0131-002,2014,9,14,8,353,257,610,428
0131-002,2014,9,14,9,326,359,685,610
0131-002,2014,9,14,10,427,423,850,685
0131-002,2014,9,14,11,479,485,964,850
0131-002,2014,9,14,12,535,509,1044,964
0131-002,2014,9,14,13,509,514,1023,1044
0131-002,2014,9,14,14,569,504,1073,1023
0131-002,2014,9,14,15,587,532,1119,1073
0131-002,2014,9,14,16,604,552,1156,1119
0131-002,2014,9,14,17,637,562,1199,1156
0131-002,2014,9,14,18,663,568,1231,1199
0131-002,2014,9,14,19,563,496,1059,1231
0131-002,2014,9,14,20,454,461,915,1059
0131-002,2014,9,14,21,428,350,778,915
0131-002,2014,9,14,22,340,288,628,778
0131-002,2014,9,14,23,248,223,471,628
0131-002,2014,9,14,24,199,145,344,471
0131-002,2014,9,15,1,128,92,220,344
0131-002,2014,9,15,2,95,57,152,220
0131-002,2014,9,15,3,101,45,146,152
0131-002,2014,9,15,4,94,50,144,146
0131-002,2014,9,15,5,118,74,192,144
0131-002,2014,9,15,6,254,134,388,192
0131-002,2014,9,15,7,629,315,944,388
0131-002,2014,9,15,8,1021,878,1899,944
0131-002,2014,9,15,9,908,928,1836,1899
0131-002,2014,9,15,10,841,819,1660,1836
0131-002,2014,9,15,11,805,814,1619,1660
0131-002,2014,9,15,12,845,813,1658,1619
0131-002,2014,9,15,13,737,755,1492,1658
0131-002,2014,9,15,14,713,812,1525,1492
0131-002,2014,9,15,15,839,936,1775,1525
0131-002,2014,9,15,16,842,908,1750,1775
0131-002,2014,9,15,17,767,869,1636,1750
0131-002,2014,9,15,18,751,986,1737,1636
0131-002,2014,9,15,19,734,984,1718,1737
0131-002,2014,9,15,20,628,804,1432,1718
0131-002,2014,9,15,21,472,676,1148,1432
0131-002,2014,9,15,22,395,529,924,1148
0131-002,2014,9,15,23,320,327,647,924
0131-002,2014,9,15,24,190,193,383,647
0131-002,2014,9,16,1,151,130,281,383
0131-002,2014,9,16,2,109,84,193,281
0131-002,2014,9,16,3,119,65,184,193
0131-002,2014,9,16,4,130,69,199,184
0131-002,2014,9,16,5,163,85,248,199
0131-002,2014,9,16,6,259,136,395,248
0131-002,2014,9,16,7,587,296,883,395
0131-002,2014,9,16,8,942,813,1755,883
0131-002,2014,9,16,9,925,911,1836,1755
0131-002,2014,9,16,10,821,827,1648,1836
0131-002,2014,9,16,11,835,826,1661,1648
0131-002,2014,9,16,12,790,794,1584,1661
0131-002,2014,9,16,13,721,742,1463,1584
0131-002,2014,9,16,14,782,867,1649,1463
0131-002,2014,9,16,15,841,659,1500,1649
0131-002,2014,9,16,16,799,616,1415,1500
0131-002,2014,9,16,17,769,638,1407,1415
0131-002,2014,9,16,18,731,705,1436,1407
0131-002,2014,9,16,19,718,689,1407,1436
0131-002,2014,9,16,20,563,531,1094,1407
0131-002,2014,9,16,21,464,472,936,1094
0131-002,2014,9,16,22,431,354,785,936
0131-002,2014,9,16,23,311,225,536,785
0131-002,2014,9,16,24,215,142,357,536
0131-002,2014,9,17,1,187,112,299,357
0131-002,2014,9,17,2,121,82,203,299
0131-002,2014,9,17,3,104,64,168,203
0131-002,2014,9,17,4,80,61,141,168
0131-002,2014,9,17,5,127,88,215,141
0131-002,2014,9,17,6,293,126,419,215
0131-002,2014,9,17,7,538,280,818,419
0131-002,2014,9,17,8,933,808,1741,818
0131-002,2014,9,17,9,845,946,1791,1741
0131-002,2014,9,17,10,826,818,1644,1791
0131-002,2014,9,17,11,824,786,1610,1644
0131-002,2014,9,17,12,827,710,1537,1610
0131-002,2014,9,17,13,695,721,1416,1537
0131-002,2014,9,17,14,806,854,1660,1416
0131-002,2014,9,17,15,827,856,1683,1660
0131-002,2014,9,17,16,841,848,1689,1683
0131-002,2014,9,17,17,778,858,1636,1689
0131-002,2014,9,17,18,749,978,1727,1636
0131-002,2014,9,17,19,760,969,1729,1727
0131-002,2014,9,17,20,592,728,1320,1729
0131-002,2014,9,17,21,470,616,1086,1320
0131-002,2014,9,17,22,401,477,878,1086
0131-002,2014,9,17,23,325,322,647,878
0131-002,2014,9,17,24,206,178,384,647
0131-002,2014,9,18,1,185,85,270,384
0131-002,2014,9,18,2,136,61,197,270
0131-002,2014,9,18,3,109,38,147,197
0131-002,2014,9,18,4,98,45,143,147
0131-002,2014,9,18,5,158,52,210,143
0131-002,2014,9,18,6,280,102,382,210
0131-002,2014,9,18,7,532,228,760,382
0131-002,2014,9,18,8,929,846,1775,760
0131-002,2014,9,18,9,923,957,1880,1775
0131-002,2014,9,18,10,776,824,1600,1880
0131-002,2014,9,18,11,805,829,1634,1600
0131-002,2014,9,18,12,755,800,1555,1634
0131-002,2014,9,18,13,653,709,1362,1555
0131-002,2014,9,18,14,787,772,1559,1362
0131-002,2014,9,18,15,863,858,1721,1559
0131-002,2014,9,18,16,863,854,1717,1721
0131-002,2014,9,18,17,773,860,1633,1717
0131-002,2014,9,18,18,769,976,1745,1633
0131-002,2014,9,18,19,686,964,1650,1745
0131-002,2014,9,18,20,572,642,1214,1650
0131-002,2014,9,18,21,466,507,973,1214
0131-002,2014,9,18,22,430,374,804,973
0131-002,2014,9,18,23,293,256,549,804
0131-002,2014,9,18,24,214,166,380,549
0131-002,2014,9,19,1,176,100,276,380
0131-002,2014,9,19,2,119,69,188,276
0131-002,2014,9,19,3,104,47,151,188
0131-002,2014,9,19,4,86,44,130,151
0131-002,2014,9,19,5,142,69,211,130
0131-002,2014,9,19,6,290,144,434,211
0131-002,2014,9,19,7,542,280,822,434
0131-002,2014,9,19,8,911,838,1749,822
0131-002,2014,9,19,9,909,956,1865,1749
0131-002,2014,9,19,10,829,832,1661,1865
0131-002,2014,9,19,11,794,838,1632,1661
0131-002,2014,9,19,12,797,792,1589,1632
0131-002,2014,9,19,13,740,716,1456,1589
0131-002,2014,9,19,14,830,796,1626,1456
0131-002,2014,9,19,15,832,906,1738,1626
0131-002,2014,9,19,16,856,880,1736,1738
0131-002,2014,9,19,17,806,922,1728,1736
0131-002,2014,9,19,18,842,1042,1884,1728
0131-002,2014,9,19,19,788,1076,1864,1884
0131-002,2014,9,19,20,692,619,1311,1864
0131-002,2014,9,19,21,520,569,1089,1311
0131-002,2014,9,19,22,451,405,856,1089
0131-002,2014,9,19,23,335,293,628,856
0131-002,2014,9,19,24,250,192,442,628
0131-002,2014,9,20,1,188,123,311,442
0131-002,2014,9,20,2,146,103,249,311
0131-002,2014,9,20,3,113,68,181,249
0131-002,2014,9,20,4,106,55,161,181
0131-002,2014,9,20,5,118,73,191,161
0131-002,2014,9,20,6,250,88,338,191
0131-002,2014,9,20,7,418,190,608,338
0131-002,2014,9,20,8,652,346,998,608
0131-002,2014,9,20,9,706,474,1180,998
0131-002,2014,9,20,10,667,538,1205,1180
0131-002,2014,9,20,11,739,677,1416,1205
0131-002,2014,9,20,12,707,723,1430,1416
0131-002,2014,9,20,13,701,749,1450,1430
0131-002,2014,9,20,14,680,798,1478,1450
0131-002,2014,9,20,15,698,816,1514,1478
0131-002,2014,9,20,16,697,771,1468,1514
0131-002,2014,9,20,17,724,760,1484,1468
0131-002,2014,9,20,18,721,846,1567,1484
0131-002,2014,9,20,19,732,715,1447,1567
0131-002,2014,9,20,20,605,553,1158,1447
0131-002,2014,9,20,21,518,539,1057,1158
0131-002,2014,9,20,22,364,367,731,1057
0131-002,2014,9,20,23,278,273,551,731
0131-002,2014,9,20,24,218,154,372,551
0131-002,2014,9,21,1,164,116,280,372
0131-002,2014,9,21,2,116,84,200,280
0131-002,2014,9,21,3,82,63,145,200
0131-002,2014,9,21,4,59,59,118,145
0131-002,2014,9,21,5,86,46,132,118
0131-002,2014,9,21,6,155,72,227,132
0131-002,2014,9,21,7,271,125,396,227
0131-002,2014,9,21,8,370,195,565,396
0131-002,2014,9,21,9,386,287,673,565
0131-002,2014,9,21,10,436,317,753,673
0131-002,2014,9,21,11,535,398,933,753
0131-002,2014,9,21,12,541,418,959,933
0131-002,2014,9,21,13,539,457,996,959
0131-002,2014,9,21,14,565,482,1047,996
0131-002,2014,9,21,15,610,484,1094,1047
0131-002,2014,9,21,16,614,515,1129,1094
0131-002,2014,9,21,17,682,555,1237,1129
0131-002,2014,9,21,18,746,591,1337,1237
0131-002,2014,9,21,19,688,510,1198,1337
0131-002,2014,9,21,20,524,446,970,1198
0131-002,2014,9,21,21,547,351,898,970
0131-002,2014,9,21,22,409,293,702,898
0131-002,2014,9,21,23,284,187,471,702
0131-002,2014,9,21,24,194,128,322,471
0131-002,2014,9,22,1,122,87,209,322
0131-002,2014,9,22,2,94,69,163,209
0131-002,2014,9,22,3,83,43,126,163
0131-002,2014,9,22,4,71,45,116,126
0131-002,2014,9,22,5,128,85,213,116
0131-002,2014,9,22,6,308,146,454,213
0131-002,2014,9,22,7,574,333,907,454
0131-002,2014,9,22,8,968,832,1800,907
0131-002,2014,9,22,9,922,860,1782,1800
0131-002,2014,9,22,10,770,733,1503,1782
0131-002,2014,9,22,11,841,782,1623,1503
0131-002,2014,9,22,12,775,725,1500,1623
0131-002,2014,9,22,13,698,656,1354,1500
0131-002,2014,9,22,14,784,714,1498,1354
0131-002,2014,9,22,15,898,802,1700,1498
0131-002,2014,9,22,16,809,792,1601,1700
0131-002,2014,9,22,17,806,806,1612,1601
0131-002,2014,9,22,18,785,878,1663,1612
0131-002,2014,9,22,19,785,912,1697,1663
0131-002,2014,9,22,20,560,715,1275,1697
0131-002,2014,9,22,21,476,646,1122,1275
0131-002,2014,9,22,22,416,457,873,1122
0131-002,2014,9,22,23,314,272,586,873
0131-002,2014,9,22,24,218,185,403,586
0131-002,2014,9,23,1,169,119,288,403
0131-002,2014,9,23,2,130,84,214,288
0131-002,2014,9,23,3,112,65,177,214
0131-002,2014,9,23,4,133,70,203,177
0131-002,2014,9,23,5,115,87,202,203
0131-002,2014,9,23,6,289,138,427,202
0131-002,2014,9,23,7,559,315,874,427
0131-002,2014,9,23,8,890,862,1752,874
0131-002,2014,9,23,9,902,978,1880,1752
0131-002,2014,9,23,10,820,824,1644,1880
0131-002,2014,9,23,11,842,798,1640,1644
0131-002,2014,9,23,12,788,813,1601,1640
0131-002,2014,9,23,13,709,704,1413,1601
0131-002,2014,9,23,14,781,769,1550,1413
0131-002,2014,9,23,15,866,864,1730,1550
0131-002,2014,9,23,16,880,800,1680,1730
0131-002,2014,9,23,17,805,828,1633,1680
0131-002,2014,9,23,18,751,882,1633,1633
0131-002,2014,9,23,19,761,913,1674,1633
0131-002,2014,9,23,20,605,734,1339,1674
0131-002,2014,9,23,21,470,664,1134,1339
0131-002,2014,9,23,22,454,473,927,1134
0131-002,2014,9,23,23,313,277,590,927
0131-002,2014,9,23,24,218,178,396,590
0131-002,2014,9,24,1,158,104,262,396
0131-002,2014,9,24,2,121,86,207,262
0131-002,2014,9,24,3,86,64,150,207
0131-002,2014,9,24,4,74,64,138,150
0131-002,2014,9,24,5,131,85,216,138
0131-002,2014,9,24,6,215,125,340,216
0131-002,2014,9,24,7,454,279,733,340
0131-002,2014,9,24,8,948,833,1781,733
0131-002,2014,9,24,9,907,960,1867,1781
0131-002,2014,9,24,10,788,838,1626,1867
0131-002,2014,9,24,11,778,797,1575,1626
0131-002,2014,9,24,12,754,781,1535,1575
0131-002,2014,9,24,13,662,668,1330,1535
0131-002,2014,9,24,14,731,730,1461,1330
0131-002,2014,9,24,15,776,854,1630,1461
0131-002,2014,9,24,16,764,854,1618,1630
0131-002,2014,9,24,17,713,849,1562,1618
0131-002,2014,9,24,18,722,988,1710,1562
0131-002,2014,9,24,19,686,993,1679,1710
0131-002,2014,9,24,20,526,730,1256,1679
0131-002,2014,9,24,21,451,616,1067,1256
0131-002,2014,9,24,22,403,466,869,1067
0131-002,2014,9,24,23,278,323,601,869
0131-002,2014,9,24,24,226,172,398,601
0131-002,2014,9,25,1,196,126,322,398
0131-002,2014,9,25,2,133,86,219,322
0131-002,2014,9,25,3,103,73,176,219
0131-002,2014,9,25,4,109,66,175,176
0131-002,2014,9,25,5,130,93,223,175
0131-002,2014,9,25,6,301,139,440,223
0131-002,2014,9,25,7,568,300,868,440
0131-002,2014,9,25,8,910,860,1770,868
0131-002,2014,9,25,9,919,976,1895,1770
0131-002,2014,9,25,10,773,829,1602,1895
0131-002,2014,9,25,11,815,821,1636,1602
0131-002,2014,9,25,12,778,788,1566,1636
0131-002,2014,9,25,13,650,705,1355,1566
0131-002,2014,9,25,14,815,786,1601,1355
0131-002,2014,9,25,15,865,839,1704,1601
0131-002,2014,9,25,16,848,857,1705,1704
0131-002,2014,9,25,17,866,832,1698,1705
0131-002,2014,9,25,18,749,971,1720,1698
0131-002,2014,9,25,19,766,964,1730,1720
0131-002,2014,9,25,20,634,778,1412,1730
0131-002,2014,9,25,21,506,680,1186,1412
0131-002,2014,9,25,22,428,490,918,1186
0131-002,2014,9,25,23,335,303,638,918
0131-002,2014,9,25,24,224,199,423,638
0131-002,2014,9,26,1,167,130,297,423
0131-002,2014,9,26,2,148,88,236,297
0131-002,2014,9,26,3,95,69,164,236
0131-002,2014,9,26,4,112,70,182,164
0131-002,2014,9,26,5,148,93,241,182
0131-002,2014,9,26,6,283,144,427,241
0131-002,2014,9,26,7,557,298,855,427
0131-002,2014,9,26,8,911,866,1777,855
0131-002,2014,9,26,9,869,956,1825,1777
0131-002,2014,9,26,10,766,844,1610,1825
0131-002,2014,9,26,11,796,812,1608,1610
0131-002,2014,9,26,12,740,771,1511,1608
0131-002,2014,9,26,13,772,684,1456,1511
0131-002,2014,9,26,14,787,780,1567,1456
0131-002,2014,9,26,15,854,900,1754,1567
0131-002,2014,9,26,16,811,859,1670,1754
0131-002,2014,9,26,17,763,933,1696,1670
0131-002,2014,9,26,18,827,1042,1869,1696
0131-002,2014,9,26,19,740,1097,1837,1869
0131-002,2014,9,26,20,592,886,1478,1837
0131-002,2014,9,26,21,514,688,1202,1478
0131-002,2014,9,26,22,430,526,956,1202
0131-002,2014,9,26,23,328,335,663,956
0131-002,2014,9,26,24,238,215,453,663
0131-002,2014,9,27,1,208,151,359,453
0131-002,2014,9,27,2,145,117,262,359
0131-002,2014,9,27,3,128,83,211,262
0131-002,2014,9,27,4,110,79,189,211
0131-002,2014,9,27,5,115,92,207,189
0131-002,2014,9,27,6,265,158,423,207
0131-002,2014,9,27,7,434,259,693,423
0131-002,2014,9,27,8,635,549,1184,693
0131-002,2014,9,27,9,694,748,1442,1184
0131-002,2014,9,27,10,698,822,1520,1442
0131-002,2014,9,27,11,787,837,1624,1520
0131-002,2014,9,27,12,704,879,1583,1624
0131-002,2014,9,27,13,655,817,1472,1583
0131-002,2014,9,27,14,680,848,1528,1472
0131-002,2014,9,27,15,637,874,1511,1528
0131-002,2014,9,27,16,676,870,1546,1511
0131-002,2014,9,27,17,721,925,1646,1546
0131-002,2014,9,27,18,718,1068,1786,1646
0131-002,2014,9,27,19,686,853,1539,1786
0131-002,2014,9,27,20,608,597,1205,1539
0131-002,2014,9,27,21,457,430,887,1205
0131-002,2014,9,27,22,364,346,710,887
0131-002,2014,9,27,23,275,269,544,710
0131-002,2014,9,27,24,211,178,389,544
0131-002,2014,9,28,1,142,125,267,389
0131-002,2014,9,28,2,124,82,206,267
0131-002,2014,9,28,3,79,68,147,206
0131-002,2014,9,28,4,82,57,139,147
0131-002,2014,9,28,5,95,64,159,139
0131-002,2014,9,28,6,169,77,246,159
0131-002,2014,9,28,7,271,128,399,246
0131-002,2014,9,28,8,398,215,613,399
0131-002,2014,9,28,9,407,338,745,613
0131-002,2014,9,28,10,446,372,818,745
0131-002,2014,9,28,11,515,473,988,818
0131-002,2014,9,28,12,458,447,905,988
0131-002,2014,9,28,13,460,472,932,905
0131-002,2014,9,28,14,502,492,994,932
0131-002,2014,9,28,15,557,546,1103,994
0131-002,2014,9,28,16,664,556,1220,1103
0131-002,2014,9,28,17,641,546,1187,1220
0131-002,2014,9,28,18,691,569,1260,1187
0131-002,2014,9,28,19,722,507,1229,1260
0131-002,2014,9,28,20,602,424,1026,1229
0131-002,2014,9,28,21,529,355,884,1026
0131-002,2014,9,28,22,389,304,693,884
0131-002,2014,9,28,23,272,204,476,693
0131-002,2014,9,28,24,208,151,359,476
0131-002,2014,9,29,1,146,87,233,359
0131-002,2014,9,29,2,91,62,153,233
0131-002,2014,9,29,3,80,39,119,153
0131-002,2014,9,29,4,97,51,148,119
0131-002,2014,9,29,5,121,86,207,148
0131-002,2014,9,29,6,304,151,455,207
0131-002,2014,9,29,7,599,358,957,455
0131-002,2014,9,29,8,1025,925,1950,957
0131-002,2014,9,29,9,971,961,1932,1950
0131-002,2014,9,29,10,782,790,1572,1932
0131-002,2014,9,29,11,769,835,1604,1572
0131-002,2014,9,29,12,760,795,1555,1604
0131-002,2014,9,29,13,653,684,1337,1555
0131-002,2014,9,29,14,760,778,1538,1337
0131-002,2014,9,29,15,881,880,1761,1538
0131-002,2014,9,29,16,796,855,1651,1761
0131-002,2014,9,29,17,745,863,1608,1651
0131-002,2014,9,29,18,724,991,1715,1608
0131-002,2014,9,29,19,674,1002,1676,1715
0131-002,2014,9,29,20,509,780,1289,1676
0131-002,2014,9,29,21,440,707,1147,1289
0131-002,2014,9,29,22,389,510,899,1147
0131-002,2014,9,29,23,272,290,562,899
0131-002,2014,9,29,24,238,196,434,562
0131-002,2014,9,30,1,110,124,234,434
0131-002,2014,9,30,2,79,83,162,234
0131-002,2014,9,30,3,58,76,134,162
0131-002,2014,9,30,4,70,62,132,134
0131-002,2014,9,30,5,102,91,193,132
0131-002,2014,9,30,6,180,133,313,193
0131-002,2014,9,30,7,357,281,638,313
0131-002,2014,9,30,8,1241,820,2061,638
0131-002,2014,9,30,9,1116,876,1992,2061
0131-002,2014,9,30,10,1095,785,1880,1992
0131-002,2014,9,30,11,922,752,1674,1880
0131-002,2014,9,30,12,849,694,1543,1674
0131-002,2014,9,30,13,737,625,1362,1543
0131-002,2014,9,30,14,925,667,1592,1362
0131-002,2014,9,30,15,1016,756,1772,1592
0131-002,2014,9,30,16,1000,745,1745,1772
0131-002,2014,9,30,17,934,798,1732,1745
0131-002,2014,9,30,18,977,908,1885,1732
0131-002,2014,9,30,19,979,910,1889,1885
0131-002,2014,9,30,20,594,694,1288,1889
0131-002,2014,9,30,21,548,613,1161,1288
0131-002,2014,9,30,22,431,428,859,1161
0131-002,2014,9,30,23,343,260,603,859
0131-002,2014,9,30,24,216,165,381,603
0131-002,2014,10,1,1,136,144,280,381
0131-002,2014,10,1,2,94,101,195,280
0131-002,2014,10,1,3,87,89,176,195
0131-002,2014,10,1,4,89,78,167,176
0131-002,2014,10,1,5,113,102,215,167
0131-002,2014,10,1,6,236,184,420,215
0131-002,2014,10,1,7,734,364,1098,420
0131-002,2014,10,1,8,1538,920,2458,1098
0131-002,2014,10,1,9,1356,1163,2519,2458
0131-002,2014,10,1,10,963,990,1953,2519
0131-002,2014,10,1,11,961,1068,2029,1953
0131-002,2014,10,1,12,906,986,1892,2029
0131-002,2014,10,1,13,773,826,1599,1892
0131-002,2014,10,1,14,888,955,1843,1599
0131-002,2014,10,1,15,1058,1069,2127,1843
0131-002,2014,10,1,16,1032,1084,2116,2127
0131-002,2014,10,1,17,926,1091,2017,2116
0131-002,2014,10,1,18,947,1370,2317,2017
0131-002,2014,10,1,19,926,1341,2267,2317
0131-002,2014,10,1,20,668,917,1585,2267
0131-002,2014,10,1,21,546,751,1297,1585
0131-002,2014,10,1,22,471,546,1017,1297
0131-002,2014,10,1,23,340,351,691,1017
0131-002,2014,10,1,24,209,202,411,691
0131-002,2014,10,2,1,172,151,323,411
0131-002,2014,10,2,2,111,84,195,323
0131-002,2014,10,2,3,78,76,154,195
0131-002,2014,10,2,4,77,91,168,154
0131-002,2014,10,2,5,103,83,186,168
0131-002,2014,10,2,6,265,189,454,186
0131-002,2014,10,2,7,706,383,1089,454
0131-002,2014,10,2,8,1661,899,2560,1089
0131-002,2014,10,2,9,1342,1122,2464,2560
0131-002,2014,10,2,10,1011,1046,2057,2464
0131-002,2014,10,2,11,989,1059,2048,2057
0131-002,2014,10,2,12,869,976,1845,2048
0131-002,2014,10,2,13,851,873,1724,1845
0131-002,2014,10,2,14,915,920,1835,1724
0131-002,2014,10,2,15,1039,1073,2112,1835
0131-002,2014,10,2,16,952,1107,2059,2112
0131-002,2014,10,2,17,979,1127,2106,2059
0131-002,2014,10,2,18,1075,1497,2572,2106
0131-002,2014,10,2,19,942,1531,2473,2572
0131-002,2014,10,2,20,776,1119,1895,2473
0131-002,2014,10,2,21,598,857,1455,1895
0131-002,2014,10,2,22,458,571,1029,1455
0131-002,2014,10,2,23,348,388,736,1029
0131-002,2014,10,2,24,278,272,550,736
0131-002,2014,10,3,1,176,188,364,550
0131-002,2014,10,3,2,117,115,232,364
0131-002,2014,10,3,3,78,104,182,232
0131-002,2014,10,3,4,86,72,158,182
0131-002,2014,10,3,5,123,113,236,158
0131-002,2014,10,3,6,218,189,407,236
0131-002,2014,10,3,7,522,309,831,407
0131-002,2014,10,3,8,927,612,1539,831
0131-002,2014,10,3,9,790,920,1710,1539
0131-002,2014,10,3,10,842,1123,1965,1710
0131-002,2014,10,3,11,868,1452,2320,1965
0131-002,2014,10,3,12,961,1320,2281,2320
0131-002,2014,10,3,13,754,1239,1993,2281
0131-002,2014,10,3,14,845,1302,2147,1993
0131-002,2014,10,3,15,872,1440,2312,2147
0131-002,2014,10,3,16,874,1379,2253,2312
0131-002,2014,10,3,17,913,1220,2133,2253
0131-002,2014,10,3,18,928,1231,2159,2133
0131-002,2014,10,3,19,829,1057,1886,2159
0131-002,2014,10,3,20,661,673,1334,1886
0131-002,2014,10,3,21,502,508,1010,1334
0131-002,2014,10,3,22,417,349,766,1010
0131-002,2014,10,3,23,278,248,526,766
0131-002,2014,10,3,24,171,183,354,526
0131-002,2014,10,4,1,131,133,264,354
0131-002,2014,10,4,2,82,89,171,264
0131-002,2014,10,4,3,76,74,150,171
0131-002,2014,10,4,4,74,65,139,150
0131-002,2014,10,4,5,95,108,203,139
0131-002,2014,10,4,6,205,133,338,203
0131-002,2014,10,4,7,435,296,731,338
0131-002,2014,10,4,8,722,503,1225,731
0131-002,2014,10,4,9,642,687,1329,1225
0131-002,2014,10,4,10,674,692,1366,1329
0131-002,2014,10,4,11,731,789,1520,1366
0131-002,2014,10,4,12,761,763,1524,1520
0131-002,2014,10,4,13,702,775,1477,1524
0131-002,2014,10,4,14,758,783,1541,1477
0131-002,2014,10,4,15,789,795,1584,1541
0131-002,2014,10,4,16,803,819,1622,1584
0131-002,2014,10,4,17,837,805,1642,1622
0131-002,2014,10,4,18,1012,1038,2050,1642
0131-002,2014,10,4,19,942,944,1886,2050
0131-002,2014,10,4,20,1038,602,1640,1886
0131-002,2014,10,4,21,900,483,1383,1640
0131-002,2014,10,4,22,643,421,1064,1383
0131-002,2014,10,4,23,398,258,656,1064
0131-002,2014,10,4,24,199,219,418,656
0131-002,2014,10,5,1,143,129,272,418
0131-002,2014,10,5,2,82,96,178,272
0131-002,2014,10,5,3,85,62,147,178
0131-002,2014,10,5,4,64,63,127,147
0131-002,2014,10,5,5,59,59,118,127
0131-002,2014,10,5,6,123,112,235,118
0131-002,2014,10,5,7,214,165,379,235
0131-002,2014,10,5,8,379,290,669,379
0131-002,2014,10,5,9,370,425,795,669
0131-002,2014,10,5,10,410,457,867,795
0131-002,2014,10,5,11,523,612,1135,867
0131-002,2014,10,5,12,597,597,1194,1135
0131-002,2014,10,5,13,865,608,1473,1194
0131-002,2014,10,5,14,1150,606,1756,1473
0131-002,2014,10,5,15,1032,691,1723,1756
0131-002,2014,10,5,16,1037,705,1742,1723
0131-002,2014,10,5,17,1252,762,2014,1742
0131-002,2014,10,5,18,1134,844,1978,2014
0131-002,2014,10,5,19,1122,775,1897,1978
0131-002,2014,10,5,20,813,559,1372,1897
0131-002,2014,10,5,21,719,428,1147,1372
0131-002,2014,10,5,22,527,307,834,1147
0131-002,2014,10,5,23,315,233,548,834
0131-002,2014,10,5,24,191,131,322,548
0131-002,2014,10,6,1,118,97,215,322
0131-002,2014,10,6,2,95,58,153,215
0131-002,2014,10,6,3,57,42,99,153
0131-002,2014,10,6,4,61,52,113,99
0131-002,2014,10,6,5,105,96,201,113
0131-002,2014,10,6,6,288,185,473,201
0131-002,2014,10,6,7,816,424,1240,473
0131-002,2014,10,6,8,1767,970,2737,1240
0131-002,2014,10,6,9,1448,1124,2572,2737
0131-002,2014,10,6,10,969,944,1913,2572
0131-002,2014,10,6,11,1016,1042,2058,1913
0131-002,2014,10,6,12,935,1019,1954,2058
0131-002,2014,10,6,13,825,893,1718,1954
0131-002,2014,10,6,14,962,903,1865,1718
0131-002,2014,10,6,15,1038,1081,2119,1865
0131-002,2014,10,6,16,1019,1162,2181,2119
0131-002,2014,10,6,17,946,1081,2027,2181
0131-002,2014,10,6,18,987,1332,2319,2027
0131-002,2014,10,6,19,926,1260,2186,2319
0131-002,2014,10,6,20,693,941,1634,2186
0131-002,2014,10,6,21,512,834,1346,1634
0131-002,2014,10,6,22,460,599,1059,1346
0131-002,2014,10,6,23,286,339,625,1059
0131-002,2014,10,6,24,194,218,412,625
0131-002,2014,10,7,1,147,136,283,412
0131-002,2014,10,7,2,103,95,198,283
0131-002,2014,10,7,3,68,71,139,198
0131-002,2014,10,7,4,91,72,163,139
0131-002,2014,10,7,5,101,109,210,163
0131-002,2014,10,7,6,267,204,471,210
0131-002,2014,10,7,7,735,369,1104,471
0131-002,2014,10,7,8,1592,953,2545,1104
0131-002,2014,10,7,9,1329,1167,2496,2545
0131-002,2014,10,7,10,1076,1037,2113,2496
0131-002,2014,10,7,11,1001,1043,2044,2113
0131-002,2014,10,7,12,910,1042,1952,2044
0131-002,2014,10,7,13,765,949,1714,1952
0131-002,2014,10,7,14,964,1041,2005,1714
0131-002,2014,10,7,15,1021,1119,2140,2005
0131-002,2014,10,7,16,972,1100,2072,2140
0131-002,2014,10,7,17,980,1161,2141,2072
0131-002,2014,10,7,18,931,1349,2280,2141
0131-002,2014,10,7,19,912,1197,2109,2280
0131-002,2014,10,7,20,656,912,1568,2109
0131-002,2014,10,7,21,540,848,1388,1568
0131-002,2014,10,7,22,450,618,1068,1388
0131-002,2014,10,7,23,310,396,706,1068
0131-002,2014,10,7,24,194,221,415,706
0131-002,2014,10,8,1,137,137,274,415
0131-002,2014,10,8,2,90,85,175,274
0131-002,2014,10,8,3,71,58,129,175
0131-002,2014,10,8,4,68,72,140,129
0131-002,2014,10,8,5,97,109,206,140
0131-002,2014,10,8,6,273,173,446,206
0131-002,2014,10,8,7,718,389,1107,446
0131-002,2014,10,8,8,1607,928,2535,1107
0131-002,2014,10,8,9,1338,1140,2478,2535
0131-002,2014,10,8,10,1060,991,2051,2478
0131-002,2014,10,8,11,1055,1099,2154,2051
0131-002,2014,10,8,12,971,1026,1997,2154
0131-002,2014,10,8,13,804,898,1702,1997
0131-002,2014,10,8,14,992,996,1988,1702
0131-002,2014,10,8,15,1053,1174,2227,1988
0131-002,2014,10,8,16,1039,1136,2175,2227
0131-002,2014,10,8,17,1000,1171,2171,2175
0131-002,2014,10,8,18,1054,1490,2544,2171
0131-002,2014,10,8,19,1044,1450,2494,2544
0131-002,2014,10,8,20,743,1080,1823,2494
0131-002,2014,10,8,21,577,834,1411,1823
0131-002,2014,10,8,22,463,600,1063,1411
0131-002,2014,10,8,23,302,334,636,1063
0131-002,2014,10,8,24,225,258,483,636
0131-002,2014,10,9,1,164,170,334,483
0131-002,2014,10,9,2,115,105,220,334
0131-002,2014,10,9,3,100,95,195,220
0131-002,2014,10,9,4,97,81,178,195
0131-002,2014,10,9,5,109,130,239,178
0131-002,2014,10,9,6,249,190,439,239
0131-002,2014,10,9,7,575,323,898,439
0131-002,2014,10,9,8,1004,608,1612,898
0131-002,2014,10,9,9,936,804,1740,1612
0131-002,2014,10,9,10,830,818,1648,1740
0131-002,2014,10,9,11,891,944,1835,1648
0131-002,2014,10,9,12,794,944,1738,1835
0131-002,2014,10,9,13,714,814,1528,1738
0131-002,2014,10,9,14,790,754,1544,1528
0131-002,2014,10,9,15,764,846,1610,1544
0131-002,2014,10,9,16,795,844,1639,1610
0131-002,2014,10,9,17,771,943,1714,1639
0131-002,2014,10,9,18,835,1275,2110,1714
0131-002,2014,10,9,19,750,1085,1835,2110
0131-002,2014,10,9,20,610,687,1297,1835
0131-002,2014,10,9,21,432,503,935,1297
0131-002,2014,10,9,22,376,374,750,935
0131-002,2014,10,9,23,286,254,540,750
0131-002,2014,10,9,24,169,167,336,540
0131-002,2014,10,10,1,121,107,228,336
0131-002,2014,10,10,2,108,79,187,228
0131-002,2014,10,10,3,71,55,126,187
0131-002,2014,10,10,4,75,74,149,126
0131-002,2014,10,10,5,101,108,209,149
0131-002,2014,10,10,6,257,164,421,209
0131-002,2014,10,10,7,719,345,1064,421
0131-002,2014,10,10,8,1446,928,2374,1064
0131-002,2014,10,10,9,1242,1096,2338,2374
0131-002,2014,10,10,10,974,989,1963,2338
0131-002,2014,10,10,11,977,1044,2021,1963
0131-002,2014,10,10,12,990,985,1975,2021
0131-002,2014,10,10,13,762,855,1617,1975
0131-002,2014,10,10,14,895,949,1844,1617
0131-002,2014,10,10,15,1054,1174,2228,1844
0131-002,2014,10,10,16,988,1103,2091,2228
0131-002,2014,10,10,17,984,1141,2125,2091
0131-002,2014,10,10,18,1000,1415,2415,2125
0131-002,2014,10,10,19,1053,1484,2537,2415
0131-002,2014,10,10,20,781,1120,1901,2537
0131-002,2014,10,10,21,556,808,1364,1901
0131-002,2014,10,10,22,407,546,953,1364
0131-002,2014,10,10,23,453,385,838,953
0131-002,2014,10,10,24,257,226,483,838
0131-002,2014,10,11,1,173,166,339,483
0131-002,2014,10,11,2,125,120,245,339
0131-002,2014,10,11,3,109,90,199,245
0131-002,2014,10,11,4,84,91,175,199
0131-002,2014,10,11,5,97,112,209,175
0131-002,2014,10,11,6,229,173,402,209
0131-002,2014,10,11,7,483,332,815,402
0131-002,2014,10,11,8,865,661,1526,815
0131-002,2014,10,11,9,797,1066,1863,1526
0131-002,2014,10,11,10,790,978,1768,1863
0131-002,2014,10,11,11,885,1098,1983,1768
0131-002,2014,10,11,12,931,1152,2083,1983
0131-002,2014,10,11,13,873,927,1800,2083
0131-002,2014,10,11,14,838,893,1731,1800
0131-002,2014,10,11,15,875,897,1772,1731
0131-002,2014,10,11,16,884,865,1749,1772
0131-002,2014,10,11,17,1020,944,1964,1749
0131-002,2014,10,11,18,1058,1141,2199,1964
0131-002,2014,10,11,19,991,968,1959,2199
0131-002,2014,10,11,20,899,690,1589,1959
0131-002,2014,10,11,21,690,491,1181,1589
0131-002,2014,10,11,22,568,362,930,1181
0131-002,2014,10,11,23,363,271,634,930
0131-002,2014,10,11,24,199,206,405,634
0131-002,2014,10,12,1,124,125,249,405
0131-002,2014,10,12,2,89,92,181,249
0131-002,2014,10,12,3,71,76,147,181
0131-002,2014,10,12,4,58,72,130,147
0131-002,2014,10,12,5,77,50,127,130
0131-002,2014,10,12,6,148,113,261,127
0131-002,2014,10,12,7,245,199,444,261
0131-002,2014,10,12,8,414,320,734,444
0131-002,2014,10,12,9,482,469,951,734
0131-002,2014,10,12,10,547,558,1105,951
0131-002,2014,10,12,11,570,652,1222,1105
0131-002,2014,10,12,12,617,584,1201,1222
0131-002,2014,10,12,13,632,578,1210,1201
0131-002,2014,10,12,14,672,660,1332,1210
0131-002,2014,10,12,15,819,689,1508,1332
0131-002,2014,10,12,16,968,731,1699,1508
0131-002,2014,10,12,17,1045,741,1786,1699
0131-002,2014,10,12,18,1153,857,2010,1786
0131-002,2014,10,12,19,1287,681,1968,2010
0131-002,2014,10,12,20,1111,541,1652,1968
0131-002,2014,10,12,21,1077,427,1504,1652
0131-002,2014,10,12,22,793,337,1130,1504
0131-002,2014,10,12,23,435,245,680,1130
0131-002,2014,10,12,24,262,146,408,680
0131-002,2014,10,13,1,141,87,228,408
0131-002,2014,10,13,2,82,82,164,228
0131-002,2014,10,13,3,59,59,118,164
0131-002,2014,10,13,4,62,73,135,118
0131-002,2014,10,13,5,103,91,194,135
0131-002,2014,10,13,6,319,194,513,194
0131-002,2014,10,13,7,867,424,1291,513
0131-002,2014,10,13,8,1745,969,2714,1291
0131-002,2014,10,13,9,1440,1121,2561,2714
0131-002,2014,10,13,10,995,990,1985,2561
0131-002,2014,10,13,11,1032,1001,2033,1985
0131-002,2014,10,13,12,953,951,1904,2033
0131-002,2014,10,13,13,781,888,1669,1904
0131-002,2014,10,13,14,988,909,1897,1669
0131-002,2014,10,13,15,1041,1117,2158,1897
0131-002,2014,10,13,16,1027,1091,2118,2158
0131-002,2014,10,13,17,959,1069,2028,2118
0131-002,2014,10,13,18,1003,1315,2318,2028
0131-002,2014,10,13,19,939,1282,2221,2318
0131-002,2014,10,13,20,659,942,1601,2221
0131-002,2014,10,13,21,507,839,1346,1601
0131-002,2014,10,13,22,426,538,964,1346
0131-002,2014,10,13,23,326,361,687,964
0131-002,2014,10,13,24,188,193,381,687
0131-002,2014,10,14,1,158,124,282,381
0131-002,2014,10,14,2,93,73,166,282
0131-002,2014,10,14,3,78,82,160,166
0131-002,2014,10,14,4,84,79,163,160
0131-002,2014,10,14,5,103,118,221,163
0131-002,2014,10,14,6,267,187,454,221
0131-002,2014,10,14,7,739,384,1123,454
0131-002,2014,10,14,8,1604,955,2559,1123
0131-002,2014,10,14,9,1338,1133,2471,2559
0131-002,2014,10,14,10,1098,1054,2152,2471
0131-002,2014,10,14,11,1032,1067,2099,2152
0131-002,2014,10,14,12,941,1035,1976,2099
0131-002,2014,10,14,13,787,896,1683,1976
0131-002,2014,10,14,14,915,946,1861,1683
0131-002,2014,10,14,15,1070,1071,2141,1861
0131-002,2014,10,14,16,1058,1106,2164,2141
0131-002,2014,10,14,17,930,1139,2069,2164
0131-002,2014,10,14,18,977,1317,2294,2069
0131-002,2014,10,14,19,852,1227,2079,2294
0131-002,2014,10,14,20,653,891,1544,2079
0131-002,2014,10,14,21,496,818,1314,1544
0131-002,2014,10,14,22,446,523,969,1314
0131-002,2014,10,14,23,304,340,644,969
0131-002,2014,10,14,24,188,206,394,644
0131-002,2014,10,15,1,150,112,262,394
0131-002,2014,10,15,2,105,105,210,262
0131-002,2014,10,15,3,75,89,164,210
0131-002,2014,10,15,4,77,69,146,164
0131-002,2014,10,15,5,102,99,201,146
0131-002,2014,10,15,6,281,189,470,201
0131-002,2014,10,15,7,729,390,1119,470
0131-002,2014,10,15,8,1536,923,2459,1119
0131-002,2014,10,15,9,1375,1197,2572,2459
0131-002,2014,10,15,10,1066,1069,2135,2572
0131-002,2014,10,15,11,1018,1063,2081,2135
0131-002,2014,10,15,12,957,1022,1979,2081
0131-002,2014,10,15,13,797,892,1689,1979
0131-002,2014,10,15,14,876,952,1828,1689
0131-002,2014,10,15,15,1012,1114,2126,1828
0131-002,2014,10,15,16,1059,1057,2116,2126
0131-002,2014,10,15,17,1033,1115,2148,2116
0131-002,2014,10,15,18,1048,1369,2417,2148
0131-002,2014,10,15,19,897,1321,2218,2417
0131-002,2014,10,15,20,681,914,1595,2218
0131-002,2014,10,15,21,520,716,1236,1595
0131-002,2014,10,15,22,427,479,906,1236
0131-002,2014,10,15,23,333,343,676,906
0131-002,2014,10,15,24,189,201,390,676
0131-002,2014,10,16,1,158,147,305,390
0131-002,2014,10,16,2,90,118,208,305
0131-002,2014,10,16,3,86,84,170,208
0131-002,2014,10,16,4,76,70,146,170
0131-002,2014,10,16,5,115,104,219,146
0131-002,2014,10,16,6,295,183,478,219
0131-002,2014,10,16,7,688,370,1058,478
0131-002,2014,10,16,8,1484,945,2429,1058
0131-002,2014,10,16,9,1351,1139,2490,2429
0131-002,2014,10,16,10,1112,958,2070,2490
0131-002,2014,10,16,11,950,989,1939,2070
0131-002,2014,10,16,12,929,1050,1979,1939
0131-002,2014,10,16,13,769,897,1666,1979
0131-002,2014,10,16,14,939,942,1881,1666
0131-002,2014,10,16,15,1028,1135,2163,1881
0131-002,2014,10,16,16,1055,1110,2165,2163
0131-002,2014,10,16,17,943,1099,2042,2165
0131-002,2014,10,16,18,923,1319,2242,2042
0131-002,2014,10,16,19,881,1225,2106,2242
0131-002,2014,10,16,20,674,886,1560,2106
0131-002,2014,10,16,21,518,788,1306,1560
0131-002,2014,10,16,22,464,554,1018,1306
0131-002,2014,10,16,23,281,320,601,1018
0131-002,2014,10,16,24,214,215,429,601
0131-002,2014,10,17,1,162,139,301,429
0131-002,2014,10,17,2,101,119,220,301
0131-002,2014,10,17,3,68,67,135,220
0131-002,2014,10,17,4,65,85,150,135
0131-002,2014,10,17,5,97,115,212,150
0131-002,2014,10,17,6,265,181,446,212
0131-002,2014,10,17,7,692,402,1094,446
0131-002,2014,10,17,8,1565,912,2477,1094
0131-002,2014,10,17,9,1328,1202,2530,2477
0131-002,2014,10,17,10,1025,1009,2034,2530
0131-002,2014,10,17,11,1021,1085,2106,2034
0131-002,2014,10,17,12,953,1026,1979,2106
0131-002,2014,10,17,13,797,891,1688,1979
0131-002,2014,10,17,14,944,937,1881,1688
0131-002,2014,10,17,15,1038,1147,2185,1881
0131-002,2014,10,17,16,1062,1165,2227,2185
0131-002,2014,10,17,17,1014,1170,2184,2227
0131-002,2014,10,17,18,1051,1466,2517,2184
0131-002,2014,10,17,19,1020,1529,2549,2517
0131-002,2014,10,17,20,849,1127,1976,2549
0131-002,2014,10,17,21,583,881,1464,1976
0131-002,2014,10,17,22,467,578,1045,1464
0131-002,2014,10,17,23,318,395,713,1045
0131-002,2014,10,17,24,229,223,452,713
0131-002,2014,10,18,1,168,162,330,452
0131-002,2014,10,18,2,118,138,256,330
0131-002,2014,10,18,3,74,88,162,256
0131-002,2014,10,18,4,95,84,179,162
0131-002,2014,10,18,5,112,136,248,179
0131-002,2014,10,18,6,269,218,487,248
0131-002,2014,10,18,7,544,339,883,487
0131-002,2014,10,18,8,995,686,1681,883
0131-002,2014,10,18,9,840,1054,1894,1681
0131-002,2014,10,18,10,853,1075,1928,1894
0131-002,2014,10,18,11,901,1222,2123,1928
0131-002,2014,10,18,12,921,1213,2134,2123
0131-002,2014,10,18,13,823,1202,2025,2134
0131-002,2014,10,18,14,885,957,1842,2025
0131-002,2014,10,18,15,869,902,1771,1842
0131-002,2014,10,18,16,982,983,1965,1771
0131-002,2014,10,18,17,997,1076,2073,1965
0131-002,2014,10,18,18,1091,1318,2409,2073
0131-002,2014,10,18,19,1259,947,2206,2409
0131-002,2014,10,18,20,1071,630,1701,2206
0131-002,2014,10,18,21,661,502,1163,1701
0131-002,2014,10,18,22,565,357,922,1163
0131-002,2014,10,18,23,309,262,571,922
0131-002,2014,10,18,24,178,191,369,571
0131-002,2014,10,19,1,129,127,256,369
0131-002,2014,10,19,2,96,95,191,256
0131-002,2014,10,19,3,68,87,155,191
0131-002,2014,10,19,4,50,55,105,155
0131-002,2014,10,19,5,59,65,124,105
0131-002,2014,10,19,6,126,117,243,124
0131-002,2014,10,19,7,270,185,455,243
0131-002,2014,10,19,8,427,332,759,455
0131-002,2014,10,19,9,426,462,888,759
0131-002,2014,10,19,10,497,592,1089,888
0131-002,2014,10,19,11,561,662,1223,1089
0131-002,2014,10,19,12,593,648,1241,1223
0131-002,2014,10,19,13,652,676,1328,1241
0131-002,2014,10,19,14,730,599,1329,1328
0131-002,2014,10,19,15,789,735,1524,1329
0131-002,2014,10,19,16,823,815,1638,1524
0131-002,2014,10,19,17,894,838,1732,1638
0131-002,2014,10,19,18,994,839,1833,1732
0131-002,2014,10,19,19,1079,764,1843,1833
0131-002,2014,10,19,20,1107,619,1726,1843
0131-002,2014,10,19,21,922,471,1393,1726
0131-002,2014,10,19,22,701,322,1023,1393
0131-002,2014,10,19,23,430,209,639,1023
0131-002,2014,10,19,24,221,170,391,639
0131-002,2014,10,20,1,118,98,216,391
0131-002,2014,10,20,2,112,61,173,216
0131-002,2014,10,20,3,54,45,99,173
0131-002,2014,10,20,4,61,58,119,99
0131-002,2014,10,20,5,82,58,140,119
0131-002,2014,10,20,6,241,135,376,140
0131-002,2014,10,20,7,661,368,1029,376
0131-002,2014,10,20,8,1555,850,2405,1029
0131-002,2014,10,20,9,1417,1063,2480,2405
0131-002,2014,10,20,10,877,906,1783,2480
0131-002,2014,10,20,11,889,986,1875,1783
0131-002,2014,10,20,12,892,891,1783,1875
0131-002,2014,10,20,13,809,787,1596,1783
0131-002,2014,10,20,14,828,873,1701,1596
0131-002,2014,10,20,15,916,976,1892,1701
0131-002,2014,10,20,16,861,934,1795,1892
0131-002,2014,10,20,17,888,1033,1921,1795
0131-002,2014,10,20,18,890,1165,2055,1921
0131-002,2014,10,20,19,817,1137,1954,2055
0131-002,2014,10,20,20,590,822,1412,1954
0131-002,2014,10,20,21,454,731,1185,1412
0131-002,2014,10,20,22,391,498,889,1185
0131-002,2014,10,20,23,283,312,595,889
0131-002,2014,10,20,24,188,181,369,595
0131-002,2014,10,21,1,114,137,251,369
0131-002,2014,10,21,2,96,85,181,251
0131-002,2014,10,21,3,57,56,113,181
0131-002,2014,10,21,4,60,70,130,113
0131-002,2014,10,21,5,93,85,178,130
0131-002,2014,10,21,6,172,143,315,178
0131-002,2014,10,21,7,554,273,827,315
0131-002,2014,10,21,8,1417,810,2227,827
0131-002,2014,10,21,9,1323,1107,2430,2227
0131-002,2014,10,21,10,902,942,1844,2430
0131-002,2014,10,21,11,905,939,1844,1844
0131-002,2014,10,21,12,860,963,1823,1844
0131-002,2014,10,21,13,742,783,1525,1823
0131-002,2014,10,21,14,881,865,1746,1525
0131-002,2014,10,21,15,916,985,1901,1746
0131-002,2014,10,21,16,869,1012,1881,1901
0131-002,2014,10,21,17,855,1029,1884,1881
0131-002,2014,10,21,18,825,1122,1947,1884
0131-002,2014,10,21,19,802,1078,1880,1947
0131-002,2014,10,21,20,580,776,1356,1880
0131-002,2014,10,21,21,452,741,1193,1356
0131-002,2014,10,21,22,405,486,891,1193
0131-002,2014,10,21,23,257,299,556,891
0131-002,2014,10,21,24,188,183,371,556
0131-002,2014,10,22,1,144,127,271,371
0131-002,2014,10,22,2,114,97,211,271
0131-002,2014,10,22,3,62,67,129,211
0131-002,2014,10,22,4,59,68,127,129
0131-002,2014,10,22,5,114,101,215,127
0131-002,2014,10,22,6,239,177,416,215
0131-002,2014,10,22,7,658,349,1007,416
0131-002,2014,10,22,8,1515,836,2351,1007
0131-002,2014,10,22,9,1400,1151,2551,2351
0131-002,2014,10,22,10,1039,1025,2064,2551
0131-002,2014,10,22,11,1038,1008,2046,2064
0131-002,2014,10,22,12,960,1054,2014,2046
0131-002,2014,10,22,13,837,852,1689,2014
0131-002,2014,10,22,14,983,947,1930,1689
0131-002,2014,10,22,15,1031,1047,2078,1930
0131-002,2014,10,22,16,949,1138,2087,2078
0131-002,2014,10,22,17,998,1165,2163,2087
0131-002,2014,10,22,18,969,1370,2339,2163
0131-002,2014,10,22,19,918,1251,2169,2339
0131-002,2014,10,22,20,639,973,1612,2169
0131-002,2014,10,22,21,468,733,1201,1612
0131-002,2014,10,22,22,449,550,999,1201
0131-002,2014,10,22,23,333,355,688,999
0131-002,2014,10,22,24,238,211,449,688
0131-002,2014,10,23,1,149,145,294,449
0131-002,2014,10,23,2,121,115,236,294
0131-002,2014,10,23,3,81,88,169,236
0131-002,2014,10,23,4,68,82,150,169
0131-002,2014,10,23,5,102,97,199,150
0131-002,2014,10,23,6,282,183,465,199
0131-002,2014,10,23,7,703,361,1064,465
0131-002,2014,10,23,8,1568,940,2508,1064
0131-002,2014,10,23,9,1429,1195,2624,2508
0131-002,2014,10,23,10,1056,997,2053,2624
0131-002,2014,10,23,11,1002,1112,2114,2053
0131-002,2014,10,23,12,928,1004,1932,2114
0131-002,2014,10,23,13,841,1011,1852,1932
0131-002,2014,10,23,14,983,987,1970,1852
0131-002,2014,10,23,15,996,1065,2061,1970
0131-002,2014,10,23,16,999,1105,2104,2061
0131-002,2014,10,23,17,969,1105,2074,2104
0131-002,2014,10,23,18,1023,1369,2392,2074
0131-002,2014,10,23,19,852,1236,2088,2392
0131-002,2014,10,23,20,651,890,1541,2088
0131-002,2014,10,23,21,517,741,1258,1541
0131-002,2014,10,23,22,449,541,990,1258
0131-002,2014,10,23,23,315,365,680,990
0131-002,2014,10,23,24,207,223,430,680
0131-002,2014,10,24,1,150,138,288,430
0131-002,2014,10,24,2,115,78,193,288
0131-002,2014,10,24,3,78,90,168,193
0131-002,2014,10,24,4,86,94,180,168
0131-002,2014,10,24,5,109,119,228,180
0131-002,2014,10,24,6,263,189,452,228
0131-002,2014,10,24,7,643,355,998,452
0131-002,2014,10,24,8,1544,873,2417,998
0131-002,2014,10,24,9,1430,1178,2608,2417
0131-002,2014,10,24,10,1073,1069,2142,2608
0131-002,2014,10,24,11,1005,1134,2139,2142
0131-002,2014,10,24,12,942,1034,1976,2139
0131-002,2014,10,24,13,840,955,1795,1976
0131-002,2014,10,24,14,934,993,1927,1795
0131-002,2014,10,24,15,1070,987,2057,1927
0131-002,2014,10,24,16,997,1211,2208,2057
0131-002,2014,10,24,17,1032,1214,2246,2208
0131-002,2014,10,24,18,1046,1501,2547,2246
0131-002,2014,10,24,19,1010,1433,2443,2547
0131-002,2014,10,24,20,774,1111,1885,2443
0131-002,2014,10,24,21,564,884,1448,1885
0131-002,2014,10,24,22,469,561,1030,1448
0131-002,2014,10,24,23,349,331,680,1030
0131-002,2014,10,24,24,211,258,469,680
0131-002,2014,10,25,1,164,168,332,469
0131-002,2014,10,25,2,119,122,241,332
0131-002,2014,10,25,3,94,103,197,241
0131-002,2014,10,25,4,89,93,182,197
0131-002,2014,10,25,5,106,105,211,182
0131-002,2014,10,25,6,243,200,443,211
0131-002,2014,10,25,7,484,321,805,443
0131-002,2014,10,25,8,856,634,1490,805
0131-002,2014,10,25,9,863,922,1785,1490
0131-002,2014,10,25,10,806,991,1797,1785
0131-002,2014,10,25,11,864,1070,1934,1797
0131-002,2014,10,25,12,816,993,1809,1934
0131-002,2014,10,25,13,853,932,1785,1809
0131-002,2014,10,25,14,775,1291,2066,1785
0131-002,2014,10,25,15,788,1004,1792,2066
0131-002,2014,10,25,16,862,906,1768,1792
0131-002,2014,10,25,17,892,959,1851,1768
0131-002,2014,10,25,18,1011,1167,2178,1851
0131-002,2014,10,25,19,921,1041,1962,2178
0131-002,2014,10,25,20,771,613,1384,1962
0131-002,2014,10,25,21,541,471,1012,1384
0131-002,2014,10,25,22,478,380,858,1012
0131-002,2014,10,25,23,307,284,591,858
0131-002,2014,10,25,24,178,184,362,591
0131-002,2014,10,26,1,127,126,253,362
0131-002,2014,10,26,2,104,83,187,253
0131-002,2014,10,26,3,67,81,148,187
0131-002,2014,10,26,4,61,71,132,148
0131-002,2014,10,26,5,64,54,118,132
0131-002,2014,10,26,6,119,118,237,118
0131-002,2014,10,26,7,276,183,459,237
0131-002,2014,10,26,8,388,312,700,459
0131-002,2014,10,26,9,412,425,837,700
0131-002,2014,10,26,10,459,497,956,837
0131-002,2014,10,26,11,536,583,1119,956
0131-002,2014,10,26,12,516,604,1120,1119
0131-002,2014,10,26,13,559,615,1174,1120
0131-002,2014,10,26,14,649,639,1288,1174
0131-002,2014,10,26,15,723,638,1361,1288
0131-002,2014,10,26,16,860,752,1612,1361
0131-002,2014,10,26,17,815,757,1572,1612
0131-002,2014,10,26,18,977,921,1898,1572
0131-002,2014,10,26,19,965,757,1722,1898
0131-002,2014,10,26,20,871,551,1422,1722
0131-002,2014,10,26,21,732,451,1183,1422
0131-002,2014,10,26,22,631,290,921,1183
0131-002,2014,10,26,23,421,216,637,921
0131-002,2014,10,26,24,194,142,336,637
0131-002,2014,10,27,1,118,86,204,336
0131-002,2014,10,27,2,97,64,161,204
0131-002,2014,10,27,3,71,53,124,161
0131-002,2014,10,27,4,61,68,129,124
0131-002,2014,10,27,5,87,99,186,129
0131-002,2014,10,27,6,318,192,510,186
0131-002,2014,10,27,7,790,385,1175,510
0131-002,2014,10,27,8,1796,954,2750,1175
0131-002,2014,10,27,9,1450,1143,2593,2750
0131-002,2014,10,27,10,996,941,1937,2593
0131-002,2014,10,27,11,1017,1011,2028,1937
0131-002,2014,10,27,12,913,993,1906,2028
0131-002,2014,10,27,13,745,872,1617,1906
0131-002,2014,10,27,14,968,931,1899,1617
0131-002,2014,10,27,15,1081,1086,2167,1899
0131-002,2014,10,27,16,1004,1084,2088,2167
0131-002,2014,10,27,17,1020,1087,2107,2088
0131-002,2014,10,27,18,992,1321,2313,2107
0131-002,2014,10,27,19,864,1279,2143,2313
0131-002,2014,10,27,20,679,899,1578,2143
0131-002,2014,10,27,21,547,820,1367,1578
0131-002,2014,10,27,22,423,568,991,1367
0131-002,2014,10,27,23,278,337,615,991
0131-002,2014,10,27,24,216,200,416,615
0131-002,2014,10,28,1,138,129,267,416
0131-002,2014,10,28,2,113,112,225,267
0131-002,2014,10,28,3,79,72,151,225
0131-002,2014,10,28,4,65,72,137,151
0131-002,2014,10,28,5,109,143,252,137
0131-002,2014,10,28,6,276,183,459,252
0131-002,2014,10,28,7,746,361,1107,459
0131-002,2014,10,28,8,1636,905,2541,1107
0131-002,2014,10,28,9,1405,1253,2658,2541
0131-002,2014,10,28,10,1072,1018,2090,2658
0131-002,2014,10,28,11,1018,1070,2088,2090
0131-002,2014,10,28,12,968,974,1942,2088
0131-002,2014,10,28,13,818,929,1747,1942
0131-002,2014,10,28,14,1007,995,2002,1747
0131-002,2014,10,28,15,1057,1113,2170,2002
0131-002,2014,10,28,16,1059,1103,2162,2170
0131-002,2014,10,28,17,961,1127,2088,2162
0131-002,2014,10,28,18,902,1400,2302,2088
0131-002,2014,10,28,19,877,1303,2180,2302
0131-002,2014,10,28,20,705,921,1626,2180
0131-002,2014,10,28,21,553,765,1318,1626
0131-002,2014,10,28,22,438,529,967,1318
0131-002,2014,10,28,23,301,338,639,967
0131-002,2014,10,28,24,208,194,402,639
0131-002,2014,10,29,1,129,141,270,402
0131-002,2014,10,29,2,93,111,204,270
0131-002,2014,10,29,3,66,80,146,204
0131-002,2014,10,29,4,80,68,148,146
0131-002,2014,10,29,5,105,99,204,148
0131-002,2014,10,29,6,279,165,444,204
0131-002,2014,10,29,7,693,326,1019,444
0131-002,2014,10,29,8,1649,916,2565,1019
0131-002,2014,10,29,9,1390,1179,2569,2565
0131-002,2014,10,29,10,1023,1051,2074,2569
0131-002,2014,10,29,11,932,1023,1955,2074
0131-002,2014,10,29,12,931,956,1887,1955
0131-002,2014,10,29,13,779,856,1635,1887
0131-002,2014,10,29,14,955,947,1902,1635
0131-002,2014,10,29,15,1012,1036,2048,1902
0131-002,2014,10,29,16,1008,1063,2071,2048
0131-002,2014,10,29,17,952,1145,2097,2071
0131-002,2014,10,29,18,1050,1415,2465,2097
0131-002,2014,10,29,19,939,1339,2278,2465
0131-002,2014,10,29,20,673,931,1604,2278
0131-002,2014,10,29,21,503,736,1239,1604
0131-002,2014,10,29,22,411,505,916,1239
0131-002,2014,10,29,23,307,380,687,916
0131-002,2014,10,29,24,221,247,468,687
0131-002,2014,10,30,1,150,161,311,468
0131-002,2014,10,30,2,98,119,217,311
0131-002,2014,10,30,3,68,81,149,217
0131-002,2014,10,30,4,81,82,163,149
0131-002,2014,10,30,5,104,109,213,163
0131-002,2014,10,30,6,279,198,477,213
0131-002,2014,10,30,7,701,342,1043,477
0131-002,2014,10,30,8,1581,872,2453,1043
0131-002,2014,10,30,9,1396,1203,2599,2453
0131-002,2014,10,30,10,1028,1037,2065,2599
0131-002,2014,10,30,11,998,1112,2110,2065
0131-002,2014,10,30,12,964,1110,2074,2110
0131-002,2014,10,30,13,798,815,1613,2074
0131-002,2014,10,30,14,945,984,1929,1613
0131-002,2014,10,30,15,1073,1123,2196,1929
0131-002,2014,10,30,16,1003,1110,2113,2196
0131-002,2014,10,30,17,982,1181,2163,2113
0131-002,2014,10,30,18,968,1420,2388,2163
0131-002,2014,10,30,19,892,1256,2148,2388
0131-002,2014,10,30,20,674,933,1607,2148
0131-002,2014,10,30,21,555,784,1339,1607
0131-002,2014,10,30,22,452,506,958,1339
0131-002,2014,10,30,23,329,339,668,958
0131-002,2014,10,30,24,202,221,423,668
0131-002,2014,10,31,1,150,146,296,423
0131-002,2014,10,31,2,107,99,206,296
0131-002,2014,10,31,3,87,89,176,206
0131-002,2014,10,31,4,68,74,142,176
0131-002,2014,10,31,5,94,108,202,142
0131-002,2014,10,31,6,235,170,405,202
0131-002,2014,10,31,7,571,366,937,405
0131-002,2014,10,31,8,1469,855,2324,937
0131-002,2014,10,31,9,1340,1114,2454,2324
0131-002,2014,10,31,10,937,978,1915,2454
0131-002,2014,10,31,11,935,1087,2022,1915
0131-002,2014,10,31,12,895,973,1868,2022
0131-002,2014,10,31,13,691,905,1596,1868
0131-002,2014,10,31,14,863,1005,1868,1596
0131-002,2014,10,31,15,954,1013,1967,1868
0131-002,2014,10,31,16,934,1067,2001,1967
0131-002,2014,10,31,17,1021,1091,2112,2001
0131-002,2014,10,31,18,1173,1352,2525,2112
0131-002,2014,10,31,19,1066,1322,2388,2525
0131-002,2014,10,31,20,958,1003,1961,2388
0131-002,2014,10,31,21,701,802,1503,1961
0131-002,2014,10,31,22,408,546,954,1503
0131-002,2014,10,31,23,281,354,635,954
0131-002,2014,10,31,24,208,235,443,635
0131-002,2014,11,1,1,165,185,350,443
0131-002,2014,11,1,2,121,128,249,350
0131-002,2014,11,1,3,86,111,197,249
0131-002,2014,11,1,4,92,88,180,197
0131-002,2014,11,1,5,103,121,224,180
0131-002,2014,11,1,6,190,139,329,224
0131-002,2014,11,1,7,355,272,627,329
0131-002,2014,11,1,8,758,529,1287,627
0131-002,2014,11,1,9,789,874,1663,1287
0131-002,2014,11,1,10,751,904,1655,1663
0131-002,2014,11,1,11,802,987,1789,1655
0131-002,2014,11,1,12,858,1018,1876,1789
0131-002,2014,11,1,13,775,891,1666,1876
0131-002,2014,11,1,14,751,885,1636,1666
0131-002,2014,11,1,15,876,901,1777,1636
0131-002,2014,11,1,16,838,993,1831,1777
0131-002,2014,11,1,17,848,929,1777,1831
0131-002,2014,11,1,18,910,1151,2061,1777
0131-002,2014,11,1,19,873,864,1737,2061
0131-002,2014,11,1,20,741,594,1335,1737
0131-002,2014,11,1,21,812,447,1259,1335
0131-002,2014,11,1,22,686,381,1067,1259
0131-002,2014,11,1,23,314,252,566,1067
0131-002,2014,11,1,24,192,192,384,566
0131-002,2014,11,2,1,140,155,295,384
0131-002,2014,11,2,2,97,93,190,295
0131-002,2014,11,2,3,77,81,158,190
0131-002,2014,11,2,4,55,68,123,158
0131-002,2014,11,2,5,59,64,123,123
0131-002,2014,11,2,6,85,94,179,123
0131-002,2014,11,2,7,163,129,292,179
0131-002,2014,11,2,8,272,228,500,292
0131-002,2014,11,2,9,343,373,716,500
0131-002,2014,11,2,10,402,490,892,716
0131-002,2014,11,2,11,510,597,1107,892
0131-002,2014,11,2,12,507,597,1104,1107
0131-002,2014,11,2,13,551,640,1191,1104
0131-002,2014,11,2,14,679,625,1304,1191
0131-002,2014,11,2,15,864,696,1560,1304
0131-002,2014,11,2,16,916,703,1619,1560
0131-002,2014,11,2,17,1016,725,1741,1619
0131-002,2014,11,2,18,1097,706,1803,1741
0131-002,2014,11,2,19,915,589,1504,1803
0131-002,2014,11,2,20,905,465,1370,1504
0131-002,2014,11,2,21,663,396,1059,1370
0131-002,2014,11,2,22,500,271,771,1059
0131-002,2014,11,2,23,278,189,467,771
0131-002,2014,11,2,24,160,114,274,467
0131-002,2014,11,3,1,139,79,218,274
0131-002,2014,11,3,2,74,62,136,218
0131-002,2014,11,3,3,71,49,120,136
0131-002,2014,11,3,4,66,59,125,120
0131-002,2014,11,3,5,85,72,157,125
0131-002,2014,11,3,6,304,187,491,157
0131-002,2014,11,3,7,791,405,1196,491
0131-002,2014,11,3,8,1693,928,2621,1196
0131-002,2014,11,3,9,1472,1100,2572,2621
0131-002,2014,11,3,10,996,952,1948,2572
0131-002,2014,11,3,11,971,998,1969,1948
0131-002,2014,11,3,12,928,890,1818,1969
0131-002,2014,11,3,13,814,775,1589,1818
0131-002,2014,11,3,14,936,915,1851,1589
0131-002,2014,11,3,15,1007,1037,2044,1851
0131-002,2014,11,3,16,1001,1084,2085,2044
0131-002,2014,11,3,17,963,1046,2009,2085
0131-002,2014,11,3,18,971,1316,2287,2009
0131-002,2014,11,3,19,887,1209,2096,2287
0131-002,2014,11,3,20,691,897,1588,2096
0131-002,2014,11,3,21,495,772,1267,1588
0131-002,2014,11,3,22,414,553,967,1267
0131-002,2014,11,3,23,288,353,641,967
0131-002,2014,11,3,24,207,232,439,641
0131-002,2014,11,4,1,129,144,273,439
0131-002,2014,11,4,2,100,112,212,273
0131-002,2014,11,4,3,71,56,127,212
0131-002,2014,11,4,4,71,61,132,127
0131-002,2014,11,4,5,105,100,205,132
0131-002,2014,11,4,6,281,173,454,205
0131-002,2014,11,4,7,703,357,1060,454
0131-002,2014,11,4,8,1530,923,2453,1060
0131-002,2014,11,4,9,1425,1186,2611,2453
0131-002,2014,11,4,10,998,1074,2072,2611
0131-002,2014,11,4,11,1045,1019,2064,2072
0131-002,2014,11,4,12,975,1011,1986,2064
0131-002,2014,11,4,13,811,955,1766,1986
0131-002,2014,11,4,14,922,969,1891,1766
0131-002,2014,11,4,15,1005,1061,2066,1891
0131-002,2014,11,4,16,1002,1077,2079,2066
0131-002,2014,11,4,17,952,1168,2120,2079
0131-002,2014,11,4,18,1018,1392,2410,2120
0131-002,2014,11,4,19,873,1205,2078,2410
0131-002,2014,11,4,20,670,923,1593,2078
0131-002,2014,11,4,21,508,771,1279,1593
0131-002,2014,11,4,22,423,535,958,1279
0131-002,2014,11,4,23,286,352,638,958
0131-002,2014,11,4,24,220,204,424,638
0131-002,2014,11,5,1,142,142,284,424
0131-002,2014,11,5,2,89,89,178,284
0131-002,2014,11,5,3,59,80,139,178
0131-002,2014,11,5,4,74,83,157,139
0131-002,2014,11,5,5,99,108,207,157
0131-002,2014,11,5,6,235,177,412,207
0131-002,2014,11,5,7,677,354,1031,412
0131-002,2014,11,5,8,1541,871,2412,1031
0131-002,2014,11,5,9,1375,1165,2540,2412
0131-002,2014,11,5,10,1045,985,2030,2540
0131-002,2014,11,5,11,1029,1065,2094,2030
0131-002,2014,11,5,12,974,1072,2046,2094
0131-002,2014,11,5,13,815,883,1698,2046
0131-002,2014,11,5,14,908,991,1899,1698
0131-002,2014,11,5,15,1044,1088,2132,1899
0131-002,2014,11,5,16,986,1187,2173,2132
0131-002,2014,11,5,17,953,1182,2135,2173
0131-002,2014,11,5,18,1061,1449,2510,2135
0131-002,2014,11,5,19,933,1236,2169,2510
0131-002,2014,11,5,20,638,867,1505,2169
0131-002,2014,11,5,21,495,750,1245,1505
0131-002,2014,11,5,22,443,554,997,1245
0131-002,2014,11,5,23,322,341,663,997
0131-002,2014,11,5,24,194,219,413,663
0131-002,2014,11,6,1,156,144,300,413
0131-002,2014,11,6,2,93,114,207,300
0131-002,2014,11,6,3,73,94,167,207
0131-002,2014,11,6,4,77,81,158,167
0131-002,2014,11,6,5,107,117,224,158
0131-002,2014,11,6,6,264,176,440,224
0131-002,2014,11,6,7,677,381,1058,440
0131-002,2014,11,6,8,1575,896,2471,1058
0131-002,2014,11,6,9,1488,1224,2712,2471
0131-002,2014,11,6,10,1052,1019,2071,2712
0131-002,2014,11,6,11,1076,1051,2127,2071
0131-002,2014,11,6,12,978,1002,1980,2127
0131-002,2014,11,6,13,747,854,1601,1980
0131-002,2014,11,6,14,952,917,1869,1601
0131-002,2014,11,6,15,999,1074,2073,1869
0131-002,2014,11,6,16,1004,1036,2040,2073
0131-002,2014,11,6,17,974,1141,2115,2040
0131-002,2014,11,6,18,945,1396,2341,2115
0131-002,2014,11,6,19,926,1219,2145,2341
0131-002,2014,11,6,20,663,912,1575,2145
0131-002,2014,11,6,21,508,820,1328,1575
0131-002,2014,11,6,22,455,587,1042,1328
0131-002,2014,11,6,23,321,366,687,1042
0131-002,2014,11,6,24,215,232,447,687
0131-002,2014,11,7,1,153,141,294,447
0131-002,2014,11,7,2,116,110,226,294
0131-002,2014,11,7,3,73,87,160,226
0131-002,2014,11,7,4,79,80,159,160
0131-002,2014,11,7,5,117,101,218,159
0131-002,2014,11,7,6,272,200,472,218
0131-002,2014,11,7,7,674,368,1042,472
0131-002,2014,11,7,8,1550,906,2456,1042
0131-002,2014,11,7,9,1439,1202,2641,2456
0131-002,2014,11,7,10,1034,1012,2046,2641
0131-002,2014,11,7,11,983,1073,2056,2046
0131-002,2014,11,7,12,968,1071,2039,2056
0131-002,2014,11,7,13,785,912,1697,2039
0131-002,2014,11,7,14,964,938,1902,1697
0131-002,2014,11,7,15,1045,1188,2233,1902
0131-002,2014,11,7,16,1020,1236,2256,2233
0131-002,2014,11,7,17,999,1186,2185,2256
0131-002,2014,11,7,18,1060,1537,2597,2185
0131-002,2014,11,7,19,1002,1465,2467,2597
0131-002,2014,11,7,20,733,1074,1807,2467
0131-002,2014,11,7,21,600,823,1423,1807
0131-002,2014,11,7,22,484,638,1122,1423
0131-002,2014,11,7,23,348,385,733,1122
0131-002,2014,11,7,24,227,225,452,733
0131-002,2014,11,8,1,182,155,337,452
0131-002,2014,11,8,2,106,124,230,337
0131-002,2014,11,8,3,95,93,188,230
0131-002,2014,11,8,4,84,87,171,188
0131-002,2014,11,8,5,112,125,237,171
0131-002,2014,11,8,6,254,215,469,237
0131-002,2014,11,8,7,451,317,768,469
0131-002,2014,11,8,8,819,595,1414,768
0131-002,2014,11,8,9,866,923,1789,1414
0131-002,2014,11,8,10,853,956,1809,1789
0131-002,2014,11,8,11,939,982,1921,1809
0131-002,2014,11,8,12,860,1035,1895,1921
0131-002,2014,11,8,13,741,921,1662,1895
0131-002,2014,11,8,14,817,880,1697,1662
0131-002,2014,11,8,15,755,961,1716,1697
0131-002,2014,11,8,16,886,916,1802,1716
0131-002,2014,11,8,17,909,1027,1936,1802
0131-002,2014,11,8,18,955,1200,2155,1936
0131-002,2014,11,8,19,839,929,1768,2155
0131-002,2014,11,8,20,672,608,1280,1768
0131-002,2014,11,8,21,496,482,978,1280
0131-002,2014,11,8,22,394,347,741,978
0131-002,2014,11,8,23,240,247,487,741
0131-002,2014,11,8,24,142,169,311,487
0131-002,2014,11,9,1,102,129,231,311
0131-002,2014,11,9,2,99,72,171,231
0131-002,2014,11,9,3,80,62,142,171
0131-002,2014,11,9,4,58,54,112,142
0131-002,2014,11,9,5,55,65,120,112
0131-002,2014,11,9,6,125,113,238,120
0131-002,2014,11,9,7,247,189,436,238
0131-002,2014,11,9,8,370,284,654,436
0131-002,2014,11,9,9,424,487,911,654
0131-002,2014,11,9,10,450,507,957,911
0131-002,2014,11,9,11,537,568,1105,957
0131-002,2014,11,9,12,538,578,1116,1105
0131-002,2014,11,9,13,561,558,1119,1116
0131-002,2014,11,9,14,636,651,1287,1119
0131-002,2014,11,9,15,681,733,1414,1287
0131-002,2014,11,9,16,923,746,1669,1414
0131-002,2014,11,9,17,1086,806,1892,1669
0131-002,2014,11,9,18,1304,912,2216,1892
0131-002,2014,11,9,19,1114,741,1855,2216
0131-002,2014,11,9,20,988,532,1520,1855
0131-002,2014,11,9,21,968,471,1439,1520
0131-002,2014,11,9,22,1015,311,1326,1439
0131-002,2014,11,9,23,590,193,783,1326
0131-002,2014,11,9,24,264,125,389,783
0131-002,2014,11,10,1,107,87,194,389
0131-002,2014,11,10,2,79,64,143,194
0131-002,2014,11,10,3,59,44,103,143
0131-002,2014,11,10,4,53,56,109,103
0131-002,2014,11,10,5,111,91,202,109
0131-002,2014,11,10,6,297,180,477,202
0131-002,2014,11,10,7,807,385,1192,477
0131-002,2014,11,10,8,1741,981,2722,1192
0131-002,2014,11,10,9,1448,1162,2610,2722
0131-002,2014,11,10,10,976,980,1956,2610
0131-002,2014,11,10,11,981,1049,2030,1956
0131-002,2014,11,10,12,978,934,1912,2030
0131-002,2014,11,10,13,869,905,1774,1912
0131-002,2014,11,10,14,942,949,1891,1774
0131-002,2014,11,10,15,1074,1135,2209,1891
0131-002,2014,11,10,16,1050,1156,2206,2209
0131-002,2014,11,10,17,1004,1182,2186,2206
0131-002,2014,11,10,18,990,1387,2377,2186
0131-002,2014,11,10,19,926,1211,2137,2377
0131-002,2014,11,10,20,683,863,1546,2137
0131-002,2014,11,10,21,530,784,1314,1546
0131-002,2014,11,10,22,421,600,1021,1314
0131-002,2014,11,10,23,314,353,667,1021
0131-002,2014,11,10,24,185,205,390,667
0131-002,2014,11,11,1,141,145,286,390
0131-002,2014,11,11,2,118,110,228,286
0131-002,2014,11,11,3,92,86,178,228
0131-002,2014,11,11,4,73,88,161,178
0131-002,2014,11,11,5,122,115,237,161
0131-002,2014,11,11,6,250,204,454,237
0131-002,2014,11,11,7,701,347,1048,454
0131-002,2014,11,11,8,1530,901,2431,1048
0131-002,2014,11,11,9,1481,1211,2692,2431
0131-002,2014,11,11,10,1110,1074,2184,2692
0131-002,2014,11,11,11,1025,1083,2108,2184
0131-002,2014,11,11,12,1035,1077,2112,2108
0131-002,2014,11,11,13,827,955,1782,2112
0131-002,2014,11,11,14,989,1017,2006,1782
0131-002,2014,11,11,15,1029,1107,2136,2006
0131-002,2014,11,11,16,1018,1089,2107,2136
0131-002,2014,11,11,17,983,1182,2165,2107
0131-002,2014,11,11,18,941,1340,2281,2165
0131-002,2014,11,11,19,924,1270,2194,2281
0131-002,2014,11,11,20,709,936,1645,2194
0131-002,2014,11,11,21,534,821,1355,1645
0131-002,2014,11,11,22,470,600,1070,1355
0131-002,2014,11,11,23,348,376,724,1070
0131-002,2014,11,11,24,214,212,426,724
0131-002,2014,11,12,1,156,145,301,426
0131-002,2014,11,12,2,89,118,207,301
0131-002,2014,11,12,3,76,78,154,207
0131-002,2014,11,12,4,75,91,166,154
0131-002,2014,11,12,5,113,98,211,166
0131-002,2014,11,12,6,242,168,410,211
0131-002,2014,11,12,7,592,326,918,410
0131-002,2014,11,12,8,1558,867,2425,918
0131-002,2014,11,12,9,1402,1189,2591,2425
0131-002,2014,11,12,10,1045,1027,2072,2591
0131-002,2014,11,12,11,1021,1008,2029,2072
0131-002,2014,11,12,12,956,1014,1970,2029
0131-002,2014,11,12,13,787,856,1643,1970
0131-002,2014,11,12,14,972,984,1956,1643
0131-002,2014,11,12,15,1023,1134,2157,1956
0131-002,2014,11,12,16,990,1065,2055,2157
0131-002,2014,11,12,17,962,1125,2087,2055
0131-002,2014,11,12,18,933,1279,2212,2087
0131-002,2014,11,12,19,871,1178,2049,2212
0131-002,2014,11,12,20,638,892,1530,2049
0131-002,2014,11,12,21,499,689,1188,1530
0131-002,2014,11,12,22,403,491,894,1188
0131-002,2014,11,12,23,320,309,629,894
0131-002,2014,11,12,24,205,204,409,629
0131-002,2014,11,13,1,127,125,252,409
0131-002,2014,11,13,2,80,108,188,252
0131-002,2014,11,13,3,78,86,164,188
0131-002,2014,11,13,4,77,81,158,164
0131-002,2014,11,13,5,98,95,193,158
0131-002,2014,11,13,6,258,173,431,193
0131-002,2014,11,13,7,631,342,973,431
0131-002,2014,11,13,8,1455,867,2322,973
0131-002,2014,11,13,9,1401,1113,2514,2322
0131-002,2014,11,13,10,1077,1023,2100,2514
0131-002,2014,11,13,11,993,1043,2036,2100
0131-002,2014,11,13,12,1017,1008,2025,2036
0131-002,2014,11,13,13,773,863,1636,2025
0131-002,2014,11,13,14,943,942,1885,1636
0131-002,2014,11,13,15,1068,1050,2118,1885
0131-002,2014,11,13,16,1014,1131,2145,2118
0131-002,2014,11,13,17,938,1134,2072,2145
0131-002,2014,11,13,18,984,1309,2293,2072
0131-002,2014,11,13,19,933,1124,2057,2293
0131-002,2014,11,13,20,649,858,1507,2057
0131-002,2014,11,13,21,559,766,1325,1507
0131-002,2014,11,13,22,415,533,948,1325
0131-002,2014,11,13,23,316,333,649,948
0131-002,2014,11,13,24,212,211,423,649
0131-002,2014,11,14,1,158,133,291,423
0131-002,2014,11,14,2,98,104,202,291
0131-002,2014,11,14,3,80,73,153,202
0131-002,2014,11,14,4,76,77,153,153
0131-002,2014,11,14,5,121,102,223,153
0131-002,2014,11,14,6,280,166,446,223
0131-002,2014,11,14,7,632,383,1015,446
0131-002,2014,11,14,8,1501,875,2376,1015
0131-002,2014,11,14,9,1385,1164,2549,2376
0131-002,2014,11,14,10,1054,1040,2094,2549
0131-002,2014,11,14,11,970,1033,2003,2094
0131-002,2014,11,14,12,977,1084,2061,2003
0131-002,2014,11,14,13,843,958,1801,2061
0131-002,2014,11,14,14,982,996,1978,1801
0131-002,2014,11,14,15,1047,1216,2263,1978
0131-002,2014,11,14,16,1090,1134,2224,2263
0131-002,2014,11,14,17,1073,1296,2369,2224
0131-002,2014,11,14,18,1084,1469,2553,2369
0131-002,2014,11,14,19,1027,1450,2477,2553
0131-002,2014,11,14,20,886,1095,1981,2477
0131-002,2014,11,14,21,601,866,1467,1981
0131-002,2014,11,14,22,431,544,975,1467
0131-002,2014,11,14,23,361,393,754,975
0131-002,2014,11,14,24,208,258,466,754
0131-002,2014,11,15,1,152,164,316,466
0131-002,2014,11,15,2,108,139,247,316
0131-002,2014,11,15,3,97,102,199,247
0131-002,2014,11,15,4,79,102,181,199
0131-002,2014,11,15,5,105,102,207,181
0131-002,2014,11,15,6,218,155,373,207
0131-002,2014,11,15,7,491,288,779,373
0131-002,2014,11,15,8,856,592,1448,779
0131-002,2014,11,15,9,862,895,1757,1448
0131-002,2014,11,15,10,888,931,1819,1757
0131-002,2014,11,15,11,883,1040,1923,1819
0131-002,2014,11,15,12,913,1139,2052,1923
0131-002,2014,11,15,13,818,1083,1901,2052
0131-002,2014,11,15,14,828,1020,1848,1901
0131-002,2014,11,15,15,885,1039,1924,1848
0131-002,2014,11,15,16,962,975,1937,1924
0131-002,2014,11,15,17,1057,1089,2146,1937
0131-002,2014,11,15,18,1163,1258,2421,2146
0131-002,2014,11,15,19,1130,904,2034,2421
0131-002,2014,11,15,20,1013,654,1667,2034
0131-002,2014,11,15,21,679,455,1134,1667
0131-002,2014,11,15,22,571,377,948,1134
0131-002,2014,11,15,23,286,259,545,948
0131-002,2014,11,15,24,185,181,366,545
0131-002,2014,11,16,1,129,131,260,366
0131-002,2014,11,16,2,84,97,181,260
0131-002,2014,11,16,3,72,84,156,181
0131-002,2014,11,16,4,66,58,124,156
0131-002,2014,11,16,5,53,61,114,124
0131-002,2014,11,16,6,120,102,222,114
0131-002,2014,11,16,7,247,138,385,222
0131-002,2014,11,16,8,355,301,656,385
0131-002,2014,11,16,9,454,455,909,656
0131-002,2014,11,16,10,481,503,984,909
0131-002,2014,11,16,11,600,651,1251,984
0131-002,2014,11,16,12,510,603,1113,1251
0131-002,2014,11,16,13,601,645,1246,1113
0131-002,2014,11,16,14,652,750,1402,1246
0131-002,2014,11,16,15,804,732,1536,1402
0131-002,2014,11,16,16,1050,859,1909,1536
0131-002,2014,11,16,17,1237,851,2088,1909
0131-002,2014,11,16,18,1204,850,2054,2088
0131-002,2014,11,16,19,1332,676,2008,2054
0131-002,2014,11,16,20,1053,544,1597,2008
0131-002,2014,11,16,21,1264,421,1685,1597
0131-002,2014,11,16,22,1281,322,1603,1685
0131-002,2014,11,16,23,467,233,700,1603
0131-002,2014,11,16,24,201,144,345,700
0131-002,2014,11,17,1,122,65,187,345
0131-002,2014,11,17,2,70,64,134,187
0131-002,2014,11,17,3,59,41,100,134
0131-002,2014,11,17,4,67,53,120,100
0131-002,2014,11,17,5,112,82,194,120
0131-002,2014,11,17,6,299,160,459,194
0131-002,2014,11,17,7,757,385,1142,459
0131-002,2014,11,17,8,1637,919,2556,1142
0131-002,2014,11,17,9,1510,1114,2624,2556
0131-002,2014,11,17,10,946,997,1943,2624
0131-002,2014,11,17,11,937,1057,1994,1943
0131-002,2014,11,17,12,941,1025,1966,1994
0131-002,2014,11,17,13,831,850,1681,1966
0131-002,2014,11,17,14,984,884,1868,1681
0131-002,2014,11,17,15,1034,1089,2123,1868
0131-002,2014,11,17,16,984,1033,2017,2123
0131-002,2014,11,17,17,963,1134,2097,2017
0131-002,2014,11,17,18,912,1251,2163,2097
0131-002,2014,11,17,19,869,1125,1994,2163
0131-002,2014,11,17,20,632,885,1517,1994
0131-002,2014,11,17,21,514,815,1329,1517
0131-002,2014,11,17,22,430,534,964,1329
0131-002,2014,11,17,23,301,342,643,964
0131-002,2014,11,17,24,200,220,420,643
0131-002,2014,11,18,1,155,143,298,420
0131-002,2014,11,18,2,107,84,191,298
0131-002,2014,11,18,3,61,69,130,191
0131-002,2014,11,18,4,88,88,176,130
0131-002,2014,11,18,5,102,115,217,176
0131-002,2014,11,18,6,269,191,460,217
0131-002,2014,11,18,7,640,301,941,460
0131-002,2014,11,18,8,1493,934,2427,941
0131-002,2014,11,18,9,1355,1300,2655,2427
0131-002,2014,11,18,10,1116,1043,2159,2655
0131-002,2014,11,18,11,998,1074,2072,2159
0131-002,2014,11,18,12,1018,1065,2083,2072
0131-002,2014,11,18,13,846,886,1732,2083
0131-002,2014,11,18,14,1023,949,1972,1732
0131-002,2014,11,18,15,1086,1174,2260,1972
0131-002,2014,11,18,16,1037,1125,2162,2260
0131-002,2014,11,18,17,1065,1178,2243,2162
0131-002,2014,11,18,18,957,1403,2360,2243
0131-002,2014,11,18,19,882,1177,2059,2360
0131-002,2014,11,18,20,619,823,1442,2059
0131-002,2014,11,18,21,531,755,1286,1442
0131-002,2014,11,18,22,431,512,943,1286
0131-002,2014,11,18,23,305,335,640,943
0131-002,2014,11,18,24,210,214,424,640
0131-002,2014,11,19,1,129,117,246,424
0131-002,2014,11,19,2,107,92,199,246
0131-002,2014,11,19,3,71,93,164,199
0131-002,2014,11,19,4,76,81,157,164
0131-002,2014,11,19,5,109,102,211,157
0131-002,2014,11,19,6,261,147,408,211
0131-002,2014,11,19,7,635,367,1002,408
0131-002,2014,11,19,8,1545,898,2443,1002
0131-002,2014,11,19,9,1428,1222,2650,2443
0131-002,2014,11,19,10,1040,1025,2065,2650
0131-002,2014,11,19,11,1047,1088,2135,2065
0131-002,2014,11,19,12,947,1002,1949,2135
0131-002,2014,11,19,13,831,950,1781,1949
0131-002,2014,11,19,14,996,991,1987,1781
0131-002,2014,11,19,15,1050,1092,2142,1987
0131-002,2014,11,19,16,1011,1136,2147,2142
0131-002,2014,11,19,17,988,1201,2189,2147
0131-002,2014,11,19,18,967,1476,2443,2189
0131-002,2014,11,19,19,869,1234,2103,2443
0131-002,2014,11,19,20,663,877,1540,2103
0131-002,2014,11,19,21,532,748,1280,1540
0131-002,2014,11,19,22,456,522,978,1280
0131-002,2014,11,19,23,339,336,675,978
0131-002,2014,11,19,24,205,214,419,675
0131-002,2014,11,20,1,146,144,290,419
0131-002,2014,11,20,2,100,84,184,290
0131-002,2014,11,20,3,66,81,147,184
0131-002,2014,11,20,4,84,74,158,147
0131-002,2014,11,20,5,110,108,218,158
0131-002,2014,11,20,6,257,175,432,218
0131-002,2014,11,20,7,649,366,1015,432
0131-002,2014,11,20,8,1514,899,2413,1015
0131-002,2014,11,20,9,1450,1187,2637,2413
0131-002,2014,11,20,10,998,1068,2066,2637
0131-002,2014,11,20,11,961,1067,2028,2066
0131-002,2014,11,20,12,1068,1074,2142,2028
0131-002,2014,11,20,13,798,889,1687,2142
0131-002,2014,11,20,14,1003,958,1961,1687
0131-002,2014,11,20,15,1053,1103,2156,1961
0131-002,2014,11,20,16,1028,1182,2210,2156
0131-002,2014,11,20,17,1044,1191,2235,2210
0131-002,2014,11,20,18,1002,1349,2351,2235
0131-002,2014,11,20,19,897,1217,2114,2351
0131-002,2014,11,20,20,666,848,1514,2114
0131-002,2014,11,20,21,515,820,1335,1514
0131-002,2014,11,20,22,453,521,974,1335
0131-002,2014,11,20,23,326,352,678,974
0131-002,2014,11,20,24,201,209,410,678
0131-002,2014,11,21,1,159,157,316,410
0131-002,2014,11,21,2,97,103,200,316
0131-002,2014,11,21,3,78,83,161,200
0131-002,2014,11,21,4,90,77,167,161
0131-002,2014,11,21,5,126,116,242,167
0131-002,2014,11,21,6,280,184,464,242
0131-002,2014,11,21,7,674,343,1017,464
0131-002,2014,11,21,8,1523,865,2388,1017
0131-002,2014,11,21,9,1438,1133,2571,2388
0131-002,2014,11,21,10,1086,1087,2173,2571
0131-002,2014,11,21,11,1045,1169,2214,2173
0131-002,2014,11,21,12,1075,1110,2185,2214
0131-002,2014,11,21,13,850,1016,1866,2185
0131-002,2014,11,21,14,1041,985,2026,1866
0131-002,2014,11,21,15,1095,1176,2271,2026
0131-002,2014,11,21,16,1076,1207,2283,2271
0131-002,2014,11,21,17,975,1276,2251,2283
0131-002,2014,11,21,18,1093,1593,2686,2251
0131-002,2014,11,21,19,1040,1463,2503,2686
0131-002,2014,11,21,20,824,1137,1961,2503
0131-002,2014,11,21,21,641,855,1496,1961
0131-002,2014,11,21,22,487,576,1063,1496
0131-002,2014,11,21,23,302,386,688,1063
0131-002,2014,11,21,24,242,247,489,688
0131-002,2014,11,22,1,172,160,332,489
0131-002,2014,11,22,2,112,134,246,332
0131-002,2014,11,22,3,105,100,205,246
0131-002,2014,11,22,4,83,91,174,205
0131-002,2014,11,22,5,123,101,224,174
0131-002,2014,11,22,6,267,179,446,224
0131-002,2014,11,22,7,464,317,781,446
0131-002,2014,11,22,8,824,611,1435,781
0131-002,2014,11,22,9,895,970,1865,1435
0131-002,2014,11,22,10,839,1009,1848,1865
0131-002,2014,11,22,11,867,1131,1998,1848
0131-002,2014,11,22,12,864,1195,2059,1998
0131-002,2014,11,22,13,923,1090,2013,2059
0131-002,2014,11,22,14,901,1251,2152,2013
0131-002,2014,11,22,15,890,1243,2133,2152
0131-002,2014,11,22,16,982,1315,2297,2133
0131-002,2014,11,22,17,1107,1451,2558,2297
0131-002,2014,11,22,18,1163,1331,2494,2558
0131-002,2014,11,22,19,1306,985,2291,2494
0131-002,2014,11,22,20,1007,695,1702,2291
0131-002,2014,11,22,21,730,455,1185,1702
0131-002,2014,11,22,22,543,339,882,1185
0131-002,2014,11,22,23,278,230,508,882
0131-002,2014,11,22,24,161,167,328,508
0131-002,2014,11,23,1,107,122,229,328
0131-002,2014,11,23,2,77,74,151,229
0131-002,2014,11,23,3,69,64,133,151
0131-002,2014,11,23,4,58,50,108,133
0131-002,2014,11,23,5,52,67,119,108
0131-002,2014,11,23,6,110,91,201,119
0131-002,2014,11,23,7,220,186,406,201
0131-002,2014,11,23,8,377,282,659,406
0131-002,2014,11,23,9,361,431,792,659
0131-002,2014,11,23,10,410,506,916,792
0131-002,2014,11,23,11,546,584,1130,916
0131-002,2014,11,23,12,595,600,1195,1130
0131-002,2014,11,23,13,747,591,1338,1195
0131-002,2014,11,23,14,853,667,1520,1338
0131-002,2014,11,23,15,1123,761,1884,1520
0131-002,2014,11,23,16,1304,741,2045,1884
0131-002,2014,11,23,17,1086,765,1851,2045
0131-002,2014,11,23,18,1102,817,1919,1851
0131-002,2014,11,23,19,1003,650,1653,1919
0131-002,2014,11,23,20,1133,494,1627,1653
0131-002,2014,11,23,21,1227,463,1690,1627
0131-002,2014,11,23,22,1026,321,1347,1690
0131-002,2014,11,23,23,997,248,1245,1347
0131-002,2014,11,23,24,411,180,591,1245
0131-002,2014,11,24,1,142,106,248,591
0131-002,2014,11,24,2,74,67,141,248
0131-002,2014,11,24,3,54,54,108,141
0131-002,2014,11,24,4,83,64,147,108
0131-002,2014,11,24,5,104,73,177,147
0131-002,2014,11,24,6,286,160,446,177
0131-002,2014,11,24,7,759,426,1185,446
0131-002,2014,11,24,8,1716,902,2618,1185
0131-002,2014,11,24,9,1416,1080,2496,2618
0131-002,2014,11,24,10,945,950,1895,2496
0131-002,2014,11,24,11,981,1000,1981,1895
0131-002,2014,11,24,12,880,918,1798,1981
0131-002,2014,11,24,13,825,823,1648,1798
0131-002,2014,11,24,14,851,925,1776,1648
0131-002,2014,11,24,15,997,1007,2004,1776
0131-002,2014,11,24,16,977,1052,2029,2004
0131-002,2014,11,24,17,923,1128,2051,2029
0131-002,2014,11,24,18,923,1219,2142,2051
0131-002,2014,11,24,19,837,1095,1932,2142
0131-002,2014,11,24,20,636,807,1443,1932
0131-002,2014,11,24,21,451,788,1239,1443
0131-002,2014,11,24,22,431,541,972,1239
0131-002,2014,11,24,23,275,336,611,972
0131-002,2014,11,24,24,183,191,374,611
0131-002,2014,11,25,1,125,134,259,374
0131-002,2014,11,25,2,102,89,191,259
0131-002,2014,11,25,3,73,75,148,191
0131-002,2014,11,25,4,75,65,140,148
0131-002,2014,11,25,5,103,117,220,140
0131-002,2014,11,25,6,263,174,437,220
0131-002,2014,11,25,7,630,347,977,437
0131-002,2014,11,25,8,1527,938,2465,977
0131-002,2014,11,25,9,1336,1159,2495,2465
0131-002,2014,11,25,10,967,1025,1992,2495
0131-002,2014,11,25,11,1041,1007,2048,1992
0131-002,2014,11,25,12,1035,949,1984,2048
0131-002,2014,11,25,13,826,943,1769,1984
0131-002,2014,11,25,14,946,972,1918,1769
0131-002,2014,11,25,15,1068,1097,2165,1918
0131-002,2014,11,25,16,980,1125,2105,2165
0131-002,2014,11,25,17,985,1108,2093,2105
0131-002,2014,11,25,18,927,1317,2244,2093
0131-002,2014,11,25,19,881,1152,2033,2244
0131-002,2014,11,25,20,672,846,1518,2033
0131-002,2014,11,25,21,554,799,1353,1518
0131-002,2014,11,25,22,417,525,942,1353
0131-002,2014,11,25,23,310,373,683,942
0131-002,2014,11,25,24,187,217,404,683
0131-002,2014,11,26,1,137,124,261,404
0131-002,2014,11,26,2,106,114,220,261
0131-002,2014,11,26,3,74,94,168,220
0131-002,2014,11,26,4,85,94,179,168
0131-002,2014,11,26,5,102,110,212,179
0131-002,2014,11,26,6,279,157,436,212
0131-002,2014,11,26,7,660,389,1049,436
0131-002,2014,11,26,8,1563,931,2494,1049
0131-002,2014,11,26,9,1411,1156,2567,2494
0131-002,2014,11,26,10,1029,1049,2078,2567
0131-002,2014,11,26,11,1052,1052,2104,2078
0131-002,2014,11,26,12,1013,984,1997,2104
0131-002,2014,11,26,13,811,906,1717,1997
0131-002,2014,11,26,14,981,984,1965,1717
0131-002,2014,11,26,15,1009,1102,2111,1965
0131-002,2014,11,26,16,1040,1146,2186,2111
0131-002,2014,11,26,17,998,1150,2148,2186
0131-002,2014,11,26,18,1024,1459,2483,2148
0131-002,2014,11,26,19,944,1242,2186,2483
0131-002,2014,11,26,20,652,908,1560,2186
0131-002,2014,11,26,21,497,746,1243,1560
0131-002,2014,11,26,22,434,498,932,1243
0131-002,2014,11,26,23,305,322,627,932
0131-002,2014,11,26,24,223,229,452,627
0131-002,2014,11,27,1,149,149,298,452
0131-002,2014,11,27,2,90,98,188,298
0131-002,2014,11,27,3,77,78,155,188
0131-002,2014,11,27,4,81,76,157,155
0131-002,2014,11,27,5,103,111,214,157
0131-002,2014,11,27,6,254,179,433,214
0131-002,2014,11,27,7,679,366,1045,433
0131-002,2014,11,27,8,1574,909,2483,1045
0131-002,2014,11,27,9,1414,1225,2639,2483
0131-002,2014,11,27,10,1012,1087,2099,2639
0131-002,2014,11,27,11,1071,1118,2189,2099
0131-002,2014,11,27,12,930,1017,1947,2189
0131-002,2014,11,27,13,798,902,1700,1947
0131-002,2014,11,27,14,983,961,1944,1700
0131-002,2014,11,27,15,1092,1110,2202,1944
0131-002,2014,11,27,16,942,1122,2064,2202
0131-002,2014,11,27,17,958,1200,2158,2064
0131-002,2014,11,27,18,1004,1426,2430,2158
0131-002,2014,11,27,19,881,1261,2142,2430
0131-002,2014,11,27,20,688,901,1589,2142
0131-002,2014,11,27,21,526,817,1343,1589
0131-002,2014,11,27,22,504,559,1063,1343
0131-002,2014,11,27,23,336,339,675,1063
0131-002,2014,11,27,24,241,245,486,675
0131-002,2014,11,28,1,146,155,301,486
0131-002,2014,11,28,2,114,92,206,301
0131-002,2014,11,28,3,75,83,158,206
0131-002,2014,11,28,4,87,87,174,158
0131-002,2014,11,28,5,118,102,220,174
0131-002,2014,11,28,6,264,188,452,220
0131-002,2014,11,28,7,631,339,970,452
0131-002,2014,11,28,8,1492,883,2375,970
0131-002,2014,11,28,9,1275,1108,2383,2375
0131-002,2014,11,28,10,992,1030,2022,2383
0131-002,2014,11,28,11,958,1083,2041,2022
0131-002,2014,11,28,12,904,1014,1918,2041
0131-002,2014,11,28,13,786,970,1756,1918
0131-002,2014,11,28,14,980,970,1950,1756
0131-002,2014,11,28,15,1011,1053,2064,1950
0131-002,2014,11,28,16,978,1059,2037,2064
0131-002,2014,11,28,17,960,1186,2146,2037
0131-002,2014,11,28,18,991,1384,2375,2146
0131-002,2014,11,28,19,1009,1302,2311,2375
0131-002,2014,11,28,20,720,967,1687,2311
0131-002,2014,11,28,21,538,787,1325,1687
0131-002,2014,11,28,22,444,559,1003,1325
0131-002,2014,11,28,23,337,390,727,1003
0131-002,2014,11,28,24,213,253,466,727
0131-002,2014,11,29,1,177,166,343,466
0131-002,2014,11,29,2,120,137,257,343
0131-002,2014,11,29,3,105,120,225,257
0131-002,2014,11,29,4,88,76,164,225
0131-002,2014,11,29,5,126,96,222,164
0131-002,2014,11,29,6,229,182,411,222
0131-002,2014,11,29,7,418,305,723,411
0131-002,2014,11,29,8,840,577,1417,723
0131-002,2014,11,29,9,834,874,1708,1417
0131-002,2014,11,29,10,834,956,1790,1708
0131-002,2014,11,29,11,935,1193,2128,1790
0131-002,2014,11,29,12,929,1270,2199,2128
0131-002,2014,11,29,13,925,1200,2125,2199
0131-002,2014,11,29,14,816,1184,2000,2125
0131-002,2014,11,29,15,883,1168,2051,2000
0131-002,2014,11,29,16,989,1165,2154,2051
0131-002,2014,11,29,17,961,1264,2225,2154
0131-002,2014,11,29,18,1052,1269,2321,2225
0131-002,2014,11,29,19,937,919,1856,2321
0131-002,2014,11,29,20,793,673,1466,1856
0131-002,2014,11,29,21,634,474,1108,1466
0131-002,2014,11,29,22,470,363,833,1108
0131-002,2014,11,29,23,305,265,570,833
0131-002,2014,11,29,24,182,179,361,570
0131-002,2014,11,30,1,126,128,254,361
0131-002,2014,11,30,2,96,113,209,254
0131-002,2014,11,30,3,57,70,127,209
0131-002,2014,11,30,4,63,68,131,127
0131-002,2014,11,30,5,59,77,136,131
0131-002,2014,11,30,6,118,105,223,136
0131-002,2014,11,30,7,169,157,326,223
0131-002,2014,11,30,8,267,234,501,326
0131-002,2014,11,30,9,323,336,659,501
0131-002,2014,11,30,10,335,499,834,659
0131-002,2014,11,30,11,475,520,995,834
0131-002,2014,11,30,12,590,596,1186,995
0131-002,2014,11,30,13,679,658,1337,1186
0131-002,2014,11,30,14,754,672,1426,1337
0131-002,2014,11,30,15,926,681,1607,1426
0131-002,2014,11,30,16,1039,705,1744,1607
0131-002,2014,11,30,17,1207,728,1935,1744
0131-002,2014,11,30,18,1074,692,1766,1935
0131-002,2014,11,30,19,1245,594,1839,1766
0131-002,2014,11,30,20,1189,441,1630,1839
0131-002,2014,11,30,21,893,435,1328,1630
0131-002,2014,11,30,22,821,296,1117,1328
0131-002,2014,11,30,23,550,184,734,1117
0131-002,2014,11,30,24,238,122,360,734
0131-002,2014,12,1,1,116,84,200,360
0131-002,2014,12,1,2,73,64,137,200
0131-002,2014,12,1,3,32,38,70,137
0131-002,2014,12,1,4,92,61,153,70
0131-002,2014,12,1,5,62,80,142,153
0131-002,2014,12,1,6,155,171,326,142
0131-002,2014,12,1,7,758,375,1133,326
0131-002,2014,12,1,8,1686,882,2568,1133
0131-002,2014,12,1,9,1306,1042,2348,2568
0131-002,2014,12,1,10,761,888,1649,2348
0131-002,2014,12,1,11,822,870,1692,1649
0131-002,2014,12,1,12,812,860,1672,1692
0131-002,2014,12,1,13,610,823,1433,1672
0131-002,2014,12,1,14,649,760,1409,1433
0131-002,2014,12,1,15,862,908,1770,1409
0131-002,2014,12,1,16,824,967,1791,1770
0131-002,2014,12,1,17,756,968,1724,1791
0131-002,2014,12,1,18,807,1063,1870,1724
0131-002,2014,12,1,19,620,1011,1631,1870
0131-002,2014,12,1,20,471,751,1222,1631
0131-002,2014,12,1,21,330,695,1025,1222
0131-002,2014,12,1,22,251,416,667,1025
0131-002,2014,12,1,23,177,231,408,667
0131-002,2014,12,1,24,175,158,333,408
0131-002,2014,12,2,1,80,117,197,333
0131-002,2014,12,2,2,102,92,194,197
0131-002,2014,12,2,3,64,74,138,194
0131-002,2014,12,2,4,44,78,122,138
0131-002,2014,12,2,5,70,80,150,122
0131-002,2014,12,2,6,99,136,235,150
0131-002,2014,12,2,7,658,316,974,235
0131-002,2014,12,2,8,1441,778,2219,974
0131-002,2014,12,2,9,1195,999,2194,2219
0131-002,2014,12,2,10,842,907,1749,2194
0131-002,2014,12,2,11,863,878,1741,1749
0131-002,2014,12,2,12,726,953,1679,1741
0131-002,2014,12,2,13,662,895,1557,1679
0131-002,2014,12,2,14,711,863,1574,1557
0131-002,2014,12,2,15,770,1080,1850,1574
0131-002,2014,12,2,16,801,1067,1868,1850
0131-002,2014,12,2,17,884,1117,2001,1868
0131-002,2014,12,2,18,918,1292,2210,2001
0131-002,2014,12,2,19,699,1139,1838,2210
0131-002,2014,12,2,20,437,802,1239,1838
0131-002,2014,12,2,21,370,599,969,1239
0131-002,2014,12,2,22,161,215,376,969
0131-002,2014,12,2,23,112,102,214,376
0131-002,2014,12,2,24,35,45,80,214
0131-002,2014,12,3,1,26,34,60,80
0131-002,2014,12,3,2,12,21,33,60
0131-002,2014,12,3,3,7,16,23,33
0131-002,2014,12,3,4,2,12,14,23
0131-002,2014,12,3,5,9,22,31,14
0131-002,2014,12,3,6,42,28,70,31
0131-002,2014,12,3,7,189,74,263,70
0131-002,2014,12,3,8,458,244,702,263
0131-002,2014,12,3,9,435,421,856,702
0131-002,2014,12,3,10,555,652,1207,856
0131-002,2014,12,3,11,685,730,1415,1207
0131-002,2014,12,3,12,756,793,1549,1415
0131-002,2014,12,3,13,593,694,1287,1549
0131-002,2014,12,3,14,559,748,1307,1287
0131-002,2014,12,3,15,616,830,1446,1307
0131-002,2014,12,3,16,831,938,1769,1446
0131-002,2014,12,3,17,812,932,1744,1769
0131-002,2014,12,3,18,659,1086,1745,1744
0131-002,2014,12,3,19,662,965,1627,1745
0131-002,2014,12,3,20,466,707,1173,1627
0131-002,2014,12,3,21,268,544,812,1173
0131-002,2014,12,3,22,243,379,622,812
0131-002,2014,12,3,23,178,236,414,622
0131-002,2014,12,3,24,182,131,313,414
0131-002,2014,12,4,1,34,60,94,313
0131-002,2014,12,4,2,4,7,11,94
0131-002,2014,12,4,3,2,7,9,11
0131-002,2014,12,4,4,3,3,6,9
0131-002,2014,12,4,5,2,4,6,6
0131-002,2014,12,4,6,10,16,26,6
0131-002,2014,12,4,7,282,137,419,26
0131-002,2014,12,4,8,1566,650,2216,419
0131-002,2014,12,4,9,950,850,1800,2216
0131-002,2014,12,4,10,557,777,1334,1800
0131-002,2014,12,4,11,441,543,984,1334
0131-002,2014,12,4,12,625,729,1354,984
0131-002,2014,12,4,13,601,722,1323,1354
0131-002,2014,12,4,14,707,835,1542,1323
0131-002,2014,12,4,15,800,928,1728,1542
0131-002,2014,12,4,16,714,987,1701,1728
0131-002,2014,12,4,17,830,1032,1862,1701
0131-002,2014,12,4,18,772,1091,1863,1862
0131-002,2014,12,4,19,607,962,1569,1863
0131-002,2014,12,4,20,468,676,1144,1569
0131-002,2014,12,4,21,213,377,590,1144
0131-002,2014,12,4,22,88,164,252,590
0131-002,2014,12,4,23,68,83,151,252
0131-002,2014,12,4,24,73,66,139,151
0131-002,2014,12,5,1,27,68,95,139
0131-002,2014,12,5,2,73,85,158,95
0131-002,2014,12,5,3,55,68,123,158
0131-002,2014,12,5,4,28,78,106,123
0131-002,2014,12,5,5,5,87,92,106
0131-002,2014,12,5,6,98,104,202,92
0131-002,2014,12,5,7,595,280,875,202
0131-002,2014,12,5,8,1489,763,2252,875
0131-002,2014,12,5,9,1211,984,2195,2252
0131-002,2014,12,5,10,806,884,1690,2195
0131-002,2014,12,5,11,998,966,1964,1690
0131-002,2014,12,5,12,913,976,1889,1964
0131-002,2014,12,5,13,678,847,1525,1889
0131-002,2014,12,5,14,826,949,1775,1525
0131-002,2014,12,5,15,902,1054,1956,1775
0131-002,2014,12,5,16,914,1075,1989,1956
0131-002,2014,12,5,17,847,1127,1974,1989
0131-002,2014,12,5,18,771,1337,2108,1974
0131-002,2014,12,5,19,756,1204,1960,2108
0131-002,2014,12,5,20,600,916,1516,1960
0131-002,2014,12,5,21,341,727,1068,1516
0131-002,2014,12,5,22,274,469,743,1068
0131-002,2014,12,5,23,205,305,510,743
0131-002,2014,12,5,24,169,185,354,510
0131-002,2014,12,6,1,124,144,268,354
0131-002,2014,12,6,2,67,117,184,268
0131-002,2014,12,6,3,41,71,112,184
0131-002,2014,12,6,4,19,76,95,112
0131-002,2014,12,6,5,31,71,102,95
0131-002,2014,12,6,6,72,136,208,102
0131-002,2014,12,6,7,264,235,499,208
0131-002,2014,12,6,8,754,514,1268,499
0131-002,2014,12,6,9,658,730,1388,1268
0131-002,2014,12,6,10,673,823,1496,1388
0131-002,2014,12,6,11,618,878,1496,1496
0131-002,2014,12,6,12,558,986,1544,1496
0131-002,2014,12,6,13,574,973,1547,1544
0131-002,2014,12,6,14,524,910,1434,1547
0131-002,2014,12,6,15,603,944,1547,1434
0131-002,2014,12,6,16,820,971,1791,1547
0131-002,2014,12,6,17,776,817,1593,1791
0131-002,2014,12,6,18,828,518,1346,1593
0131-002,2014,12,6,19,680,293,973,1346
0131-002,2014,12,6,20,508,181,689,973
0131-002,2014,12,6,21,470,139,609,689
0131-002,2014,12,6,22,177,206,383,609
0131-002,2014,12,6,23,144,204,348,383
0131-002,2014,12,6,24,137,152,289,348
0131-002,2014,12,7,1,95,113,208,289
0131-002,2014,12,7,2,57,90,147,208
0131-002,2014,12,7,3,39,71,110,147
0131-002,2014,12,7,4,17,52,69,110
0131-002,2014,12,7,5,26,57,83,69
0131-002,2014,12,7,6,67,61,128,83
0131-002,2014,12,7,7,72,97,169,128
0131-002,2014,12,7,8,286,232,518,169
0131-002,2014,12,7,9,205,295,500,518
0131-002,2014,12,7,10,285,460,745,500
0131-002,2014,12,7,11,360,497,857,745
0131-002,2014,12,7,12,619,593,1212,857
0131-002,2014,12,7,13,638,602,1240,1212
0131-002,2014,12,7,14,701,597,1298,1240
0131-002,2014,12,7,15,826,627,1453,1298
0131-002,2014,12,7,16,1303,661,1964,1453
0131-002,2014,12,7,17,1226,613,1839,1964
0131-002,2014,12,7,18,1230,688,1918,1839
0131-002,2014,12,7,19,1059,489,1548,1918
0131-002,2014,12,7,20,1149,374,1523,1548
0131-002,2014,12,7,21,880,337,1217,1523
0131-002,2014,12,7,22,616,246,862,1217
0131-002,2014,12,7,23,355,190,545,862
0131-002,2014,12,7,24,194,139,333,545
0131-002,2014,12,8,1,89,84,173,333
0131-002,2014,12,8,2,72,61,133,173
0131-002,2014,12,8,3,10,41,51,133
0131-002,2014,12,8,4,38,57,95,51
0131-002,2014,12,8,5,100,66,166,95
0131-002,2014,12,8,6,198,115,313,166
0131-002,2014,12,8,7,674,281,955,313
0131-002,2014,12,8,8,1571,778,2349,955
0131-002,2014,12,8,9,1208,926,2134,2349
0131-002,2014,12,8,10,781,820,1601,2134
0131-002,2014,12,8,11,702,900,1602,1601
0131-002,2014,12,8,12,615,815,1430,1602
0131-002,2014,12,8,13,700,820,1520,1430
0131-002,2014,12,8,14,745,863,1608,1520
0131-002,2014,12,8,15,884,1017,1901,1608
0131-002,2014,12,8,16,799,960,1759,1901
0131-002,2014,12,8,17,692,1040,1732,1759
0131-002,2014,12,8,18,709,1173,1882,1732
0131-002,2014,12,8,19,677,1046,1723,1882
0131-002,2014,12,8,20,476,750,1226,1723
0131-002,2014,12,8,21,312,651,963,1226
0131-002,2014,12,8,22,369,484,853,963
0131-002,2014,12,8,23,271,286,557,853
0131-002,2014,12,8,24,155,201,356,557
0131-002,2014,12,9,1,36,101,137,356
0131-002,2014,12,9,2,103,84,187,137
0131-002,2014,12,9,3,56,74,130,187
0131-002,2014,12,9,4,13,73,86,130
0131-002,2014,12,9,5,37,83,120,86
0131-002,2014,12,9,6,120,165,285,120
0131-002,2014,12,9,7,767,313,1080,285
0131-002,2014,12,9,8,1718,857,2575,1080
0131-002,2014,12,9,9,1183,1062,2245,2575
0131-002,2014,12,9,10,762,900,1662,2245
0131-002,2014,12,9,11,960,986,1946,1662
0131-002,2014,12,9,12,1022,951,1973,1946
0131-002,2014,12,9,13,682,875,1557,1973
0131-002,2014,12,9,14,868,934,1802,1557
0131-002,2014,12,9,15,733,1043,1776,1802
0131-002,2014,12,9,16,836,1065,1901,1776
0131-002,2014,12,9,17,889,1088,1977,1901
0131-002,2014,12,9,18,841,1285,2126,1977
0131-002,2014,12,9,19,741,1105,1846,2126
0131-002,2014,12,9,20,480,796,1276,1846
0131-002,2014,12,9,21,300,705,1005,1276
0131-002,2014,12,9,22,309,474,783,1005
0131-002,2014,12,9,23,215,298,513,783
0131-002,2014,12,9,24,155,196,351,513
0131-002,2014,12,10,1,57,126,183,351
0131-002,2014,12,10,2,52,92,144,183
0131-002,2014,12,10,3,16,74,90,144
0131-002,2014,12,10,4,65,74,139,90
0131-002,2014,12,10,5,39,106,145,139
0131-002,2014,12,10,6,302,161,463,145
0131-002,2014,12,10,7,702,319,1021,463
0131-002,2014,12,10,8,1671,803,2474,1021
0131-002,2014,12,10,9,1214,1029,2243,2474
0131-002,2014,12,10,10,857,964,1821,2243
0131-002,2014,12,10,11,930,1029,1959,1821
0131-002,2014,12,10,12,903,989,1892,1959
0131-002,2014,12,10,13,848,884,1732,1892
0131-002,2014,12,10,14,907,987,1894,1732
0131-002,2014,12,10,15,816,1112,1928,1894
0131-002,2014,12,10,16,889,1030,1919,1928
0131-002,2014,12,10,17,970,1076,2046,1919
0131-002,2014,12,10,18,752,1346,2098,2046
0131-002,2014,12,10,19,617,1150,1767,2098
0131-002,2014,12,10,20,543,753,1296,1767
0131-002,2014,12,10,21,291,665,956,1296
0131-002,2014,12,10,22,271,495,766,956
0131-002,2014,12,10,23,208,298,506,766
0131-002,2014,12,10,24,200,191,391,506
0131-002,2014,12,11,1,18,161,179,391
0131-002,2014,12,11,2,0,91,91,179
0131-002,2014,12,11,3,136,68,204,91
0131-002,2014,12,11,4,68,68,136,204
0131-002,2014,12,11,5,84,83,167,136
0131-002,2014,12,11,6,438,146,584,167
0131-002,2014,12,11,7,1355,326,1681,584
0131-002,2014,12,11,8,2071,795,2866,1681
0131-002,2014,12,11,9,1677,1138,2815,2866
0131-002,2014,12,11,10,811,862,1673,2815
0131-002,2014,12,11,11,941,977,1918,1673
0131-002,2014,12,11,12,1007,984,1991,1918
0131-002,2014,12,11,13,565,868,1433,1991
0131-002,2014,12,11,14,708,954,1662,1433
0131-002,2014,12,11,15,1073,1014,2087,1662
0131-002,2014,12,11,16,794,1008,1802,2087
0131-002,2014,12,11,17,840,1078,1918,1802
0131-002,2014,12,11,18,702,1226,1928,1918
0131-002,2014,12,11,19,579,1098,1677,1928
0131-002,2014,12,11,20,473,797,1270,1677
0131-002,2014,12,11,21,237,675,912,1270
0131-002,2014,12,11,22,200,465,665,912
0131-002,2014,12,11,23,194,317,511,665
0131-002,2014,12,11,24,73,208,281,511
0131-002,2014,12,12,1,72,151,223,281
0131-002,2014,12,12,2,61,111,172,223
0131-002,2014,12,12,3,102,102,204,172
0131-002,2014,12,12,4,90,90,180,204
0131-002,2014,12,12,5,49,97,146,180
0131-002,2014,12,12,6,144,175,319,146
0131-002,2014,12,12,7,998,307,1305,319
0131-002,2014,12,12,8,2024,835,2859,1305
0131-002,2014,12,12,9,1253,1060,2313,2859
0131-002,2014,12,12,10,645,899,1544,2313
0131-002,2014,12,12,11,936,1116,2052,1544
0131-002,2014,12,12,12,917,1053,1970,2052
0131-002,2014,12,12,13,571,914,1485,1970
0131-002,2014,12,12,14,671,956,1627,1485
0131-002,2014,12,12,15,793,1208,2001,1627
0131-002,2014,12,12,16,850,1157,2007,2001
0131-002,2014,12,12,17,734,1144,1878,2007
0131-002,2014,12,12,18,551,1124,1675,1878
0131-002,2014,12,12,19,503,894,1397,1675
0131-002,2014,12,12,20,480,796,1276,1397
0131-002,2014,12,12,21,144,390,534,1276
0131-002,2014,12,12,22,103,188,291,534
0131-002,2014,12,12,23,125,245,370,291
0131-002,2014,12,12,24,58,136,194,370
0131-002,2014,12,13,1,54,97,151,194
0131-002,2014,12,13,2,46,62,108,151
0131-002,2014,12,13,3,4,9,13,108
0131-002,2014,12,13,4,4,10,14,13
0131-002,2014,12,13,5,42,69,111,14
0131-002,2014,12,13,6,80,104,184,111
0131-002,2014,12,13,7,116,159,275,184
0131-002,2014,12,13,8,768,348,1116,275
0131-002,2014,12,13,9,658,567,1225,1116
0131-002,2014,12,13,10,666,605,1271,1225
0131-002,2014,12,13,11,576,432,1008,1271
0131-002,2014,12,13,12,574,399,973,1008
0131-002,2014,12,13,13,502,368,870,973
0131-002,2014,12,13,14,518,403,921,870
0131-002,2014,12,13,15,513,501,1014,921
0131-002,2014,12,13,16,766,801,1567,1014
0131-002,2014,12,13,17,772,814,1586,1567
0131-002,2014,12,13,18,748,865,1613,1586
0131-002,2014,12,13,19,650,617,1267,1613
0131-002,2014,12,13,20,420,354,774,1267
0131-002,2014,12,13,21,390,329,719,774
0131-002,2014,12,13,22,208,271,479,719
0131-002,2014,12,13,23,136,216,352,479
0131-002,2014,12,13,24,126,119,245,352
0131-002,2014,12,14,1,100,103,203,245
0131-002,2014,12,14,2,63,87,150,203
0131-002,2014,12,14,3,28,78,106,150
0131-002,2014,12,14,4,56,66,122,106
0131-002,2014,12,14,5,30,52,82,122
0131-002,2014,12,14,6,111,91,202,82
0131-002,2014,12,14,7,110,132,242,202
0131-002,2014,12,14,8,242,195,437,242
0131-002,2014,12,14,9,219,348,567,437
0131-002,2014,12,14,10,329,446,775,567
0131-002,2014,12,14,11,316,561,877,775
0131-002,2014,12,14,12,520,607,1127,877
0131-002,2014,12,14,13,564,626,1190,1127
0131-002,2014,12,14,14,790,580,1370,1190
0131-002,2014,12,14,15,771,690,1461,1370
0131-002,2014,12,14,16,1088,737,1825,1461
0131-002,2014,12,14,17,1029,615,1644,1825
0131-002,2014,12,14,18,964,659,1623,1644
0131-002,2014,12,14,19,826,457,1283,1623
0131-002,2014,12,14,20,802,365,1167,1283
0131-002,2014,12,14,21,578,290,868,1167
0131-002,2014,12,14,22,451,247,698,868
0131-002,2014,12,14,23,231,148,379,698
0131-002,2014,12,14,24,137,114,251,379
0131-002,2014,12,15,1,126,63,189,251
0131-002,2014,12,15,2,38,50,88,189
0131-002,2014,12,15,3,0,40,40,88
0131-002,2014,12,15,4,44,58,102,40
0131-002,2014,12,15,5,32,72,104,102
0131-002,2014,12,15,6,164,152,316,104
0131-002,2014,12,15,7,820,346,1166,316
0131-002,2014,12,15,8,1540,808,2348,1166
0131-002,2014,12,15,9,1360,1054,2414,2348
0131-002,2014,12,15,10,739,920,1659,2414
0131-002,2014,12,15,11,817,1050,1867,1659
0131-002,2014,12,15,12,790,914,1704,1867
0131-002,2014,12,15,13,708,817,1525,1704
0131-002,2014,12,15,14,793,941,1734,1525
0131-002,2014,12,15,15,883,1046,1929,1734
0131-002,2014,12,15,16,1045,1096,2141,1929
0131-002,2014,12,15,17,760,1068,1828,2141
0131-002,2014,12,15,18,686,1161,1847,1828
0131-002,2014,12,15,19,572,987,1559,1847
0131-002,2014,12,15,20,435,706,1141,1559
0131-002,2014,12,15,21,312,649,961,1141
0131-002,2014,12,15,22,264,478,742,961
0131-002,2014,12,15,23,209,261,470,742
0131-002,2014,12,15,24,140,195,335,470
0131-002,2014,12,16,1,105,116,221,335
0131-002,2014,12,16,2,71,97,168,221
0131-002,2014,12,16,3,29,90,119,168
0131-002,2014,12,16,4,45,89,134,119
0131-002,2014,12,16,5,52,83,135,134
0131-002,2014,12,16,6,84,117,201,135
0131-002,2014,12,16,7,517,275,792,201
0131-002,2014,12,16,8,1576,784,2360,792
0131-002,2014,12,16,9,1278,1054,2332,2360
0131-002,2014,12,16,10,785,902,1687,2332
0131-002,2014,12,16,11,828,983,1811,1687
0131-002,2014,12,16,12,785,981,1766,1811
0131-002,2014,12,16,13,627,848,1475,1766
0131-002,2014,12,16,14,742,918,1660,1475
0131-002,2014,12,16,15,829,963,1792,1660
0131-002,2014,12,16,16,763,973,1736,1792
0131-002,2014,12,16,17,720,964,1684,1736
0131-002,2014,12,16,18,607,1088,1695,1684
0131-002,2014,12,16,19,579,1003,1582,1695
0131-002,2014,12,16,20,468,707,1175,1582
0131-002,2014,12,16,21,322,638,960,1175
0131-002,2014,12,16,22,261,436,697,960
0131-002,2014,12,16,23,131,261,392,697
0131-002,2014,12,16,24,100,185,285,392
0131-002,2014,12,17,1,50,140,190,285
0131-002,2014,12,17,2,36,74,110,190
0131-002,2014,12,17,3,50,64,114,110
0131-002,2014,12,17,4,15,73,88,114
0131-002,2014,12,17,5,84,74,158,88
0131-002,2014,12,17,6,80,140,220,158
0131-002,2014,12,17,7,753,308,1061,220
0131-002,2014,12,17,8,1624,798,2422,1061
0131-002,2014,12,17,9,1194,1019,2213,2422
0131-002,2014,12,17,10,954,898,1852,2213
0131-002,2014,12,17,11,838,913,1751,1852
0131-002,2014,12,17,12,778,907,1685,1751
0131-002,2014,12,17,13,624,857,1481,1685
0131-002,2014,12,17,14,785,951,1736,1481
0131-002,2014,12,17,15,834,1022,1856,1736
0131-002,2014,12,17,16,858,1036,1894,1856
0131-002,2014,12,17,17,713,1006,1719,1894
0131-002,2014,12,17,18,670,1213,1883,1719
0131-002,2014,12,17,19,639,1005,1644,1883
0131-002,2014,12,17,20,468,724,1192,1644
0131-002,2014,12,17,21,285,584,869,1192
0131-002,2014,12,17,22,299,456,755,869
0131-002,2014,12,17,23,238,291,529,755
0131-002,2014,12,17,24,218,217,435,529
0131-002,2014,12,18,1,104,139,243,435
0131-002,2014,12,18,2,80,85,165,243
0131-002,2014,12,18,3,22,68,90,165
0131-002,2014,12,18,4,22,73,95,90
0131-002,2014,12,18,5,34,95,129,95
0131-002,2014,12,18,6,138,138,276,129
0131-002,2014,12,18,7,786,321,1107,276
0131-002,2014,12,18,8,1628,750,2378,1107
0131-002,2014,12,18,9,1318,1057,2375,2378
0131-002,2014,12,18,10,812,882,1694,2375
0131-002,2014,12,18,11,800,914,1714,1694
0131-002,2014,12,18,12,862,1006,1868,1714
0131-002,2014,12,18,13,690,888,1578,1868
0131-002,2014,12,18,14,848,986,1834,1578
0131-002,2014,12,18,15,911,1052,1963,1834
0131-002,2014,12,18,16,883,1027,1910,1963
0131-002,2014,12,18,17,632,1085,1717,1910
0131-002,2014,12,18,18,759,1241,2000,1717
0131-002,2014,12,18,19,640,1084,1724,2000
0131-002,2014,12,18,20,430,787,1217,1724
0131-002,2014,12,18,21,385,688,1073,1217
0131-002,2014,12,18,22,358,469,827,1073
0131-002,2014,12,18,23,225,322,547,827
0131-002,2014,12,18,24,205,193,398,547
0131-002,2014,12,19,1,144,152,296,398
0131-002,2014,12,19,2,74,98,172,296
0131-002,2014,12,19,3,48,81,129,172
0131-002,2014,12,19,4,56,89,145,129
0131-002,2014,12,19,5,18,102,120,145
0131-002,2014,12,19,6,192,161,353,120
0131-002,2014,12,19,7,818,301,1119,353
0131-002,2014,12,19,8,1440,804,2244,1119
0131-002,2014,12,19,9,1295,1061,2356,2244
0131-002,2014,12,19,10,1023,946,1969,2356
0131-002,2014,12,19,11,913,998,1911,1969
0131-002,2014,12,19,12,681,990,1671,1911
0131-002,2014,12,19,13,716,954,1670,1671
0131-002,2014,12,19,14,810,1017,1827,1670
0131-002,2014,12,19,15,843,1111,1954,1827
0131-002,2014,12,19,16,1046,1122,2168,1954
0131-002,2014,12,19,17,1005,1115,2120,2168
0131-002,2014,12,19,18,812,1399,2211,2120
0131-002,2014,12,19,19,904,1379,2283,2211
0131-002,2014,12,19,20,682,936,1618,2283
0131-002,2014,12,19,21,373,703,1076,1618
0131-002,2014,12,19,22,356,535,891,1076
0131-002,2014,12,19,23,266,329,595,891
0131-002,2014,12,19,24,145,219,364,595
0131-002,2014,12,20,1,123,189,312,364
0131-002,2014,12,20,2,106,125,231,312
0131-002,2014,12,20,3,48,95,143,231
0131-002,2014,12,20,4,30,78,108,143
0131-002,2014,12,20,5,28,80,108,108
0131-002,2014,12,20,6,60,120,180,108
0131-002,2014,12,20,7,353,214,567,180
0131-002,2014,12,20,8,910,442,1352,567
0131-002,2014,12,20,9,662,727,1389,1352
0131-002,2014,12,20,10,722,806,1528,1389
0131-002,2014,12,20,11,600,841,1441,1528
0131-002,2014,12,20,12,560,984,1544,1441
0131-002,2014,12,20,13,458,890,1348,1544
0131-002,2014,12,20,14,576,937,1513,1348
0131-002,2014,12,20,15,503,937,1440,1513
0131-002,2014,12,20,16,666,934,1600,1440
0131-002,2014,12,20,17,684,1027,1711,1600
0131-002,2014,12,20,18,676,1080,1756,1711
0131-002,2014,12,20,19,590,778,1368,1756
0131-002,2014,12,20,20,331,479,810,1368
0131-002,2014,12,20,21,310,396,706,810
0131-002,2014,12,20,22,239,286,525,706
0131-002,2014,12,20,23,129,205,334,525
0131-002,2014,12,20,24,116,177,293,334
0131-002,2014,12,21,1,104,111,215,293
0131-002,2014,12,21,2,69,91,160,215
0131-002,2014,12,21,3,17,73,90,160
0131-002,2014,12,21,4,94,62,156,90
0131-002,2014,12,21,5,33,60,93,156
0131-002,2014,12,21,6,155,108,263,93
0131-002,2014,12,21,7,149,113,262,263
0131-002,2014,12,21,8,198,242,440,262
0131-002,2014,12,21,9,233,382,615,440
0131-002,2014,12,21,10,373,486,859,615
0131-002,2014,12,21,11,271,547,818,859
0131-002,2014,12,21,12,421,611,1032,818
0131-002,2014,12,21,13,491,607,1098,1032
0131-002,2014,12,21,14,880,675,1555,1098
0131-002,2014,12,21,15,716,715,1431,1555
0131-002,2014,12,21,16,873,730,1603,1431
0131-002,2014,12,21,17,832,692,1524,1603
0131-002,2014,12,21,18,697,662,1359,1524
0131-002,2014,12,21,19,592,440,1032,1359
0131-002,2014,12,21,20,456,303,759,1032
0131-002,2014,12,21,21,277,262,539,759
0131-002,2014,12,21,22,286,217,503,539
0131-002,2014,12,21,23,148,148,296,503
0131-002,2014,12,21,24,69,82,151,296
0131-002,2014,12,22,1,36,71,107,151
0131-002,2014,12,22,2,30,58,88,107
0131-002,2014,12,22,3,10,32,42,88
0131-002,2014,12,22,4,16,45,61,42
0131-002,2014,12,22,5,53,68,121,61
0131-002,2014,12,22,6,185,137,322,121
0131-002,2014,12,22,7,816,300,1116,322
0131-002,2014,12,22,8,1424,665,2089,1116
0131-002,2014,12,22,9,1009,760,1769,2089
0131-002,2014,12,22,10,568,616,1184,1769
0131-002,2014,12,22,11,536,536,1072,1184
0131-002,2014,12,22,12,580,631,1211,1072
0131-002,2014,12,22,13,492,638,1130,1211
0131-002,2014,12,22,14,718,836,1554,1130
0131-002,2014,12,22,15,771,972,1743,1554
0131-002,2014,12,22,16,772,956,1728,1743
0131-002,2014,12,22,17,753,997,1750,1728
0131-002,2014,12,22,18,681,1062,1743,1750
0131-002,2014,12,22,19,578,946,1524,1743
0131-002,2014,12,22,20,356,631,987,1524
0131-002,2014,12,22,21,329,635,964,987
0131-002,2014,12,22,22,268,382,650,964
0131-002,2014,12,22,23,183,256,439,650
0131-002,2014,12,22,24,92,178,270,439
0131-002,2014,12,23,1,82,118,200,270
0131-002,2014,12,23,2,71,88,159,200
0131-002,2014,12,23,3,32,62,94,159
0131-002,2014,12,23,4,14,72,86,94
0131-002,2014,12,23,5,53,88,141,86
0131-002,2014,12,23,6,164,149,313,141
0131-002,2014,12,23,7,649,311,960,313
0131-002,2014,12,23,8,1512,735,2247,960
0131-002,2014,12,23,9,1203,1048,2251,2247
0131-002,2014,12,23,10,789,903,1692,2251
0131-002,2014,12,23,11,901,1002,1903,1692
0131-002,2014,12,23,12,826,1102,1928,1903
0131-002,2014,12,23,13,711,887,1598,1928
0131-002,2014,12,23,14,892,1028,1920,1598
0131-002,2014,12,23,15,896,1146,2042,1920
0131-002,2014,12,23,16,1101,1147,2248,2042
0131-002,2014,12,23,17,956,1174,2130,2248
0131-002,2014,12,23,18,817,1264,2081,2130
0131-002,2014,12,23,19,633,1143,1776,2081
0131-002,2014,12,23,20,576,756,1332,1776
0131-002,2014,12,23,21,372,646,1018,1332
0131-002,2014,12,23,22,297,500,797,1018
0131-002,2014,12,23,23,291,321,612,797
0131-002,2014,12,23,24,191,209,400,612
0131-002,2014,12,24,1,108,176,284,400
0131-002,2014,12,24,2,55,106,161,284
0131-002,2014,12,24,3,65,93,158,161
0131-002,2014,12,24,4,49,93,142,158
0131-002,2014,12,24,5,47,107,154,142
0131-002,2014,12,24,6,158,165,323,154
0131-002,2014,12,24,7,503,318,821,323
0131-002,2014,12,24,8,1466,814,2280,821
0131-002,2014,12,24,9,1390,1091,2481,2280
0131-002,2014,12,24,10,1057,1035,2092,2481
0131-002,2014,12,24,11,1080,1030,2110,2092
0131-002,2014,12,24,12,849,1018,1867,2110
0131-002,2014,12,24,13,713,898,1611,1867
0131-002,2014,12,24,14,769,961,1730,1611
0131-002,2014,12,24,15,954,1159,2113,1730
0131-002,2014,12,24,16,1046,1089,2135,2113
0131-002,2014,12,24,17,1008,1187,2195,2135
0131-002,2014,12,24,18,963,1660,2623,2195
0131-002,2014,12,24,19,1003,1546,2549,2623
0131-002,2014,12,24,20,774,1049,1823,2549
0131-002,2014,12,24,21,442,698,1140,1823
0131-002,2014,12,24,22,411,494,905,1140
0131-002,2014,12,24,23,264,334,598,905
0131-002,2014,12,24,24,297,214,511,598
0131-002,2014,12,25,1,72,149,221,511
0131-002,2014,12,25,2,59,129,188,221
0131-002,2014,12,25,3,20,87,107,188
0131-002,2014,12,25,4,15,88,103,107
0131-002,2014,12,25,5,20,90,110,103
0131-002,2014,12,25,6,78,144,222,110
0131-002,2014,12,25,7,404,191,595,222
0131-002,2014,12,25,8,841,346,1187,595
0131-002,2014,12,25,9,692,515,1207,1187
0131-002,2014,12,25,10,450,634,1084,1207
0131-002,2014,12,25,11,460,712,1172,1084
0131-002,2014,12,25,12,503,616,1119,1172
0131-002,2014,12,25,13,432,639,1071,1119
0131-002,2014,12,25,14,498,782,1280,1071
0131-002,2014,12,25,15,755,787,1542,1280
0131-002,2014,12,25,16,621,798,1419,1542
0131-002,2014,12,25,17,567,734,1301,1419
0131-002,2014,12,25,18,527,822,1349,1301
0131-002,2014,12,25,19,373,633,1006,1349
0131-002,2014,12,25,20,278,430,708,1006
0131-002,2014,12,25,21,237,386,623,708
0131-002,2014,12,25,22,239,283,522,623
0131-002,2014,12,25,23,170,217,387,522
0131-002,2014,12,25,24,148,148,296,387
0131-002,2014,12,26,1,115,101,216,296
0131-002,2014,12,26,2,20,77,97,216
0131-002,2014,12,26,3,38,60,98,97
0131-002,2014,12,26,4,66,66,132,98
0131-002,2014,12,26,5,55,96,151,132
0131-002,2014,12,26,6,197,151,348,151
0131-002,2014,12,26,7,1040,322,1362,348
0131-002,2014,12,26,8,1547,762,2309,1362
0131-002,2014,12,26,9,1147,986,2133,2309
0131-002,2014,12,26,10,757,943,1700,2133
0131-002,2014,12,26,11,879,1063,1942,1700
0131-002,2014,12,26,12,1008,1012,2020,1942
0131-002,2014,12,26,13,714,918,1632,2020
0131-002,2014,12,26,14,1025,1011,2036,1632
0131-002,2014,12,26,15,906,1065,1971,2036
0131-002,2014,12,26,16,828,1074,1902,1971
0131-002,2014,12,26,17,831,1115,1946,1902
0131-002,2014,12,26,18,891,1446,2337,1946
0131-002,2014,12,26,19,683,1205,1888,2337
0131-002,2014,12,26,20,471,801,1272,1888
0131-002,2014,12,26,21,294,672,966,1272
0131-002,2014,12,26,22,280,455,735,966
0131-002,2014,12,26,23,253,316,569,735
0131-002,2014,12,26,24,311,261,572,569
0131-002,2014,12,27,1,134,163,297,572
0131-002,2014,12,27,2,103,129,232,297
0131-002,2014,12,27,3,53,97,150,232
0131-002,2014,12,27,4,55,96,151,150
0131-002,2014,12,27,5,21,86,107,151
0131-002,2014,12,27,6,130,159,289,107
0131-002,2014,12,27,7,337,241,578,289
0131-002,2014,12,27,8,839,512,1351,578
0131-002,2014,12,27,9,660,699,1359,1351
0131-002,2014,12,27,10,694,841,1535,1359
0131-002,2014,12,27,11,588,895,1483,1535
0131-002,2014,12,27,12,567,926,1493,1483
0131-002,2014,12,27,13,480,837,1317,1493
0131-002,2014,12,27,14,547,948,1495,1317
0131-002,2014,12,27,15,508,916,1424,1495
0131-002,2014,12,27,16,716,943,1659,1424
0131-002,2014,12,27,17,728,981,1709,1659
0131-002,2014,12,27,18,712,1097,1809,1709
0131-002,2014,12,27,19,620,743,1363,1809
0131-002,2014,12,27,20,323,443,766,1363
0131-002,2014,12,27,21,384,423,807,766
0131-002,2014,12,27,22,248,305,553,807
0131-002,2014,12,27,23,213,237,450,553
0131-002,2014,12,27,24,118,163,281,450
0131-002,2014,12,28,1,148,142,290,281
0131-002,2014,12,28,2,32,82,114,290
0131-002,2014,12,28,3,21,71,92,114
0131-002,2014,12,28,4,19,69,88,92
0131-002,2014,12,28,5,6,70,76,88
0131-002,2014,12,28,6,36,105,141,76
0131-002,2014,12,28,7,130,143,273,141
0131-002,2014,12,28,8,220,230,450,273
0131-002,2014,12,28,9,226,388,614,450
0131-002,2014,12,28,10,351,453,804,614
0131-002,2014,12,28,11,294,571,865,804
0131-002,2014,12,28,12,470,571,1041,865
0131-002,2014,12,28,13,528,553,1081,1041
0131-002,2014,12,28,14,568,620,1188,1081
0131-002,2014,12,28,15,594,653,1247,1188
0131-002,2014,12,28,16,859,744,1603,1247
0131-002,2014,12,28,17,837,702,1539,1603
0131-002,2014,12,28,18,667,696,1363,1539
0131-002,2014,12,28,19,636,505,1141,1363
0131-002,2014,12,28,20,377,365,742,1141
0131-002,2014,12,28,21,252,329,581,742
0131-002,2014,12,28,22,316,257,573,581
0131-002,2014,12,28,23,167,162,329,573
0131-002,2014,12,28,24,106,133,239,329
0131-002,2014,12,29,1,46,104,150,239
0131-002,2014,12,29,2,21,61,82,150
0131-002,2014,12,29,3,10,43,53,82
0131-002,2014,12,29,4,17,58,75,53
0131-002,2014,12,29,5,39,84,123,75
0131-002,2014,12,29,6,100,153,253,123
0131-002,2014,12,29,7,542,356,898,253
0131-002,2014,12,29,8,1779,863,2642,898
0131-002,2014,12,29,9,1101,1067,2168,2642
0131-002,2014,12,29,10,877,1031,1908,2168
0131-002,2014,12,29,11,922,1012,1934,1908
0131-002,2014,12,29,12,724,1045,1769,1934
0131-002,2014,12,29,13,714,952,1666,1769
0131-002,2014,12,29,14,880,996,1876,1666
0131-002,2014,12,29,15,908,1120,2028,1876
0131-002,2014,12,29,16,993,1099,2092,2028
0131-002,2014,12,29,17,822,1119,1941,2092
0131-002,2014,12,29,18,786,1334,2120,1941
0131-002,2014,12,29,19,689,1101,1790,2120
0131-002,2014,12,29,20,492,830,1322,1790
0131-002,2014,12,29,21,543,720,1263,1322
0131-002,2014,12,29,22,392,502,894,1263
0131-002,2014,12,29,23,179,294,473,894
0131-002,2014,12,29,24,195,225,420,473
0131-002,2014,12,30,1,151,158,309,420
0131-002,2014,12,30,2,54,117,171,309
0131-002,2014,12,30,3,90,90,180,171
0131-002,2014,12,30,4,35,104,139,180
0131-002,2014,12,30,5,73,109,182,139
0131-002,2014,12,30,6,264,165,429,182
0131-002,2014,12,30,7,298,288,586,429
0131-002,2014,12,30,8,1635,832,2467,586
0131-002,2014,12,30,9,769,1140,1909,2467
0131-002,2014,12,30,10,730,993,1723,1909
0131-002,2014,12,30,11,866,1042,1908,1723
0131-002,2014,12,30,12,865,1196,2061,1908
0131-002,2014,12,30,13,680,1083,1763,2061
0131-002,2014,12,30,14,866,1029,1895,1763
0131-002,2014,12,30,15,605,1125,1730,1895
0131-002,2014,12,30,16,673,1137,1810,1730
0131-002,2014,12,30,17,673,1087,1760,1810
0131-002,2014,12,30,18,930,1347,2277,1760
0131-002,2014,12,30,19,930,1236,2166,2277
0131-002,2014,12,30,20,624,794,1418,2166
0131-002,2014,12,30,21,576,700,1276,1418
0131-002,2014,12,30,22,694,538,1232,1276
0131-002,2014,12,30,23,363,411,774,1232
0131-002,2014,12,30,24,232,268,500,774
0131-002,2014,12,31,1,104,195,299,500
0131-002,2014,12,31,2,94,129,223,299
0131-002,2014,12,31,3,102,102,204,223
0131-002,2014,12,31,4,22,94,116,204
0131-002,2014,12,31,5,52,119,171,116
0131-002,2014,12,31,6,153,141,294,171
0131-002,2014,12,31,7,598,223,821,294
0131-002,2014,12,31,8,1280,612,1892,821
0131-002,2014,12,31,9,1262,898,2160,1892
0131-002,2014,12,31,10,722,767,1489,2160
0131-002,2014,12,31,11,626,800,1426,1489
0131-002,2014,12,31,12,806,865,1671,1426
0131-002,2014,12,31,13,701,828,1529,1671
0131-002,2014,12,31,14,854,936,1790,1529
0131-002,2014,12,31,15,788,982,1770,1790
0131-002,2014,12,31,16,693,1109,1802,1770
0131-002,2014,12,31,17,907,1235,2142,1802
0131-002,2014,12,31,18,821,1433,2254,2142
0131-002,2014,12,31,19,648,1115,1763,2254
0131-002,2014,12,31,20,415,766,1181,1763
0131-002,2014,12,31,21,339,555,894,1181
0131-002,2014,12,31,22,275,378,653,894
0131-002,2014,12,31,23,155,264,419,653
0131-002,2014,12,31,24,160,199,359,419
0131-002,2015,1,1,1,95,150,245,359
0131-002,2015,1,1,2,93,142,235,245
0131-002,2015,1,1,3,47,89,136,235
0131-002,2015,1,1,4,20,73,93,136
0131-002,2015,1,1,5,17,49,66,93
0131-002,2015,1,1,6,42,89,131,66
0131-002,2015,1,1,7,51,104,155,131
0131-002,2015,1,1,8,131,155,286,155
0131-002,2015,1,1,9,160,239,399,286
0131-002,2015,1,1,10,214,328,542,399
0131-002,2015,1,1,11,294,433,727,542
0131-002,2015,1,1,12,349,530,879,727
0131-002,2015,1,1,13,420,525,945,879
0131-002,2015,1,1,14,361,551,912,945
0131-002,2015,1,1,15,514,534,1048,912
0131-002,2015,1,1,16,591,598,1189,1048
0131-002,2015,1,1,17,656,576,1232,1189
0131-002,2015,1,1,18,613,531,1144,1232
0131-002,2015,1,1,19,446,471,917,1144
0131-002,2015,1,1,20,298,341,639,917
0131-002,2015,1,1,21,277,298,575,639
0131-002,2015,1,1,22,235,224,459,575
0131-002,2015,1,1,23,114,160,274,459
0131-002,2015,1,1,24,61,109,170,274
0131-002,2015,1,2,1,42,55,97,170
0131-002,2015,1,2,2,37,55,92,97
0131-002,2015,1,2,3,27,38,65,92
0131-002,2015,1,2,4,32,42,74,65
0131-002,2015,1,2,5,22,68,90,74
0131-002,2015,1,2,6,73,98,171,90
0131-002,2015,1,2,7,349,251,600,171
0131-002,2015,1,2,8,1165,616,1781,600
0131-002,2015,1,2,9,967,748,1715,1781
0131-002,2015,1,2,10,654,689,1343,1715
0131-002,2015,1,2,11,744,823,1567,1343
0131-002,2015,1,2,12,734,834,1568,1567
0131-002,2015,1,2,13,654,705,1359,1568
0131-002,2015,1,2,14,783,836,1619,1359
0131-002,2015,1,2,15,756,898,1654,1619
0131-002,2015,1,2,16,880,867,1747,1654
0131-002,2015,1,2,17,889,836,1725,1747
0131-002,2015,1,2,18,981,1005,1986,1725
0131-002,2015,1,2,19,943,955,1898,1986
0131-002,2015,1,2,20,587,652,1239,1898
0131-002,2015,1,2,21,412,480,892,1239
0131-002,2015,1,2,22,298,325,623,892
0131-002,2015,1,2,23,226,243,469,623
0131-002,2015,1,2,24,85,155,240,469
0131-002,2015,1,3,1,95,123,218,240
0131-002,2015,1,3,2,42,75,117,218
0131-002,2015,1,3,3,27,65,92,117
0131-002,2015,1,3,4,22,70,92,92
0131-002,2015,1,3,5,27,72,99,92
0131-002,2015,1,3,6,88,123,211,99
0131-002,2015,1,3,7,216,186,402,211
0131-002,2015,1,3,8,516,366,882,402
0131-002,2015,1,3,9,608,572,1180,882
0131-002,2015,1,3,10,589,670,1259,1180
0131-002,2015,1,3,11,608,754,1362,1259
0131-002,2015,1,3,12,742,757,1499,1362
0131-002,2015,1,3,13,732,725,1457,1499
0131-002,2015,1,3,14,795,779,1574,1457
0131-002,2015,1,3,15,792,861,1653,1574
0131-002,2015,1,3,16,921,859,1780,1653
0131-002,2015,1,3,17,1078,850,1928,1780
0131-002,2015,1,3,18,1123,923,2046,1928
0131-002,2015,1,3,19,940,654,1594,2046
0131-002,2015,1,3,20,466,394,860,1594
0131-002,2015,1,3,21,381,355,736,860
0131-002,2015,1,3,22,281,274,555,736
0131-002,2015,1,3,23,134,203,337,555
0131-002,2015,1,3,24,93,143,236,337
0131-002,2015,1,4,1,44,108,152,236
0131-002,2015,1,4,2,51,64,115,152
0131-002,2015,1,4,3,15,46,61,115
0131-002,2015,1,4,4,15,43,58,61
0131-002,2015,1,4,5,32,49,81,58
0131-002,2015,1,4,6,68,93,161,81
0131-002,2015,1,4,7,141,119,260,161
0131-002,2015,1,4,8,255,190,445,260
0131-002,2015,1,4,9,255,282,537,445
0131-002,2015,1,4,10,308,458,766,537
0131-002,2015,1,4,11,386,542,928,766
0131-002,2015,1,4,12,449,554,1003,928
0131-002,2015,1,4,13,560,559,1119,1003
0131-002,2015,1,4,14,611,556,1167,1119
0131-002,2015,1,4,15,773,684,1457,1167
0131-002,2015,1,4,16,964,715,1679,1457
0131-002,2015,1,4,17,1209,723,1932,1679
0131-002,2015,1,4,18,1235,728,1963,1932
0131-002,2015,1,4,19,977,497,1474,1963
0131-002,2015,1,4,20,654,365,1019,1474
0131-002,2015,1,4,21,536,363,899,1019
0131-002,2015,1,4,22,369,251,620,899
0131-002,2015,1,4,23,260,190,450,620
0131-002,2015,1,4,24,112,132,244,450
0131-002,2015,1,5,1,51,84,135,244
0131-002,2015,1,5,2,27,44,71,135
0131-002,2015,1,5,3,13,37,50,71
0131-002,2015,1,5,4,17,40,57,50
0131-002,2015,1,5,5,34,84,118,57
0131-002,2015,1,5,6,177,157,334,118
0131-002,2015,1,5,7,802,345,1147,334
0131-002,2015,1,5,8,2482,889,3371,1147
0131-002,2015,1,5,9,1822,1030,2852,3371
0131-002,2015,1,5,10,977,923,1900,2852
0131-002,2015,1,5,11,1081,1028,2109,1900
0131-002,2015,1,5,12,952,926,1878,2109
0131-002,2015,1,5,13,746,861,1607,1878
0131-002,2015,1,5,14,991,907,1898,1607
0131-002,2015,1,5,15,1061,1063,2124,1898
0131-002,2015,1,5,16,1049,1003,2052,2124
0131-002,2015,1,5,17,1098,1125,2223,2052
0131-002,2015,1,5,18,1015,1284,2299,2223
0131-002,2015,1,5,19,897,1084,1981,2299
0131-002,2015,1,5,20,652,809,1461,1981
0131-002,2015,1,5,21,478,760,1238,1461
0131-002,2015,1,5,22,403,489,892,1238
0131-002,2015,1,5,23,175,289,464,892
0131-002,2015,1,5,24,160,203,363,464
0131-002,2015,1,6,1,66,158,224,363
0131-002,2015,1,6,2,44,111,155,224
0131-002,2015,1,6,3,34,68,102,155
0131-002,2015,1,6,4,15,80,95,102
0131-002,2015,1,6,5,32,101,133,95
0131-002,2015,1,6,6,151,146,297,133
0131-002,2015,1,6,7,570,299,869,297
0131-002,2015,1,6,8,2054,805,2859,869
0131-002,2015,1,6,9,1727,1036,2763,2859
0131-002,2015,1,6,10,1001,972,1973,2763
0131-002,2015,1,6,11,1001,1000,2001,1973
0131-002,2015,1,6,12,926,907,1833,2001
0131-002,2015,1,6,13,713,874,1587,1833
0131-002,2015,1,6,14,894,953,1847,1587
0131-002,2015,1,6,15,945,1095,2040,1847
0131-002,2015,1,6,16,979,1113,2092,2040
0131-002,2015,1,6,17,950,1080,2030,2092
0131-002,2015,1,6,18,901,1232,2133,2030
0131-002,2015,1,6,19,977,1080,2057,2133
0131-002,2015,1,6,20,730,809,1539,2057
0131-002,2015,1,6,21,466,785,1251,1539
0131-002,2015,1,6,22,369,460,829,1251
0131-002,2015,1,6,23,180,293,473,829
0131-002,2015,1,6,24,163,214,377,473
0131-002,2015,1,7,1,78,140,218,377
0131-002,2015,1,7,2,44,87,131,218
0131-002,2015,1,7,3,22,86,108,131
0131-002,2015,1,7,4,17,71,88,108
0131-002,2015,1,7,5,42,69,111,88
0131-002,2015,1,7,6,119,154,273,111
0131-002,2015,1,7,7,662,294,956,273
0131-002,2015,1,7,8,2145,800,2945,956
0131-002,2015,1,7,9,1783,1130,2913,2945
0131-002,2015,1,7,10,1003,968,1971,2913
0131-002,2015,1,7,11,1037,971,2008,1971
0131-002,2015,1,7,12,906,879,1785,2008
0131-002,2015,1,7,13,822,838,1660,1785
0131-002,2015,1,7,14,962,995,1957,1660
0131-002,2015,1,7,15,1008,1118,2126,1957
0131-002,2015,1,7,16,948,1048,1996,2126
0131-002,2015,1,7,17,885,1019,1904,1996
0131-002,2015,1,7,18,1040,1289,2329,1904
0131-002,2015,1,7,19,996,1174,2170,2329
0131-002,2015,1,7,20,611,787,1398,2170
0131-002,2015,1,7,21,393,713,1106,1398
0131-002,2015,1,7,22,410,491,901,1106
0131-002,2015,1,7,23,214,305,519,901
0131-002,2015,1,7,24,177,202,379,519
0131-002,2015,1,8,1,61,135,196,379
0131-002,2015,1,8,2,32,94,126,196
0131-002,2015,1,8,3,22,69,91,126
0131-002,2015,1,8,4,32,73,105,91
0131-002,2015,1,8,5,39,72,111,105
0131-002,2015,1,8,6,136,157,293,111
0131-002,2015,1,8,7,698,328,1026,293
0131-002,2015,1,8,8,2145,831,2976,1026
0131-002,2015,1,8,9,1698,1146,2844,2976
0131-002,2015,1,8,10,994,968,1962,2844
0131-002,2015,1,8,11,1136,1044,2180,1962
0131-002,2015,1,8,12,1383,910,2293,2180
0131-002,2015,1,8,13,751,896,1647,2293
0131-002,2015,1,8,14,962,930,1892,1647
0131-002,2015,1,8,15,1187,1100,2287,1892
0131-002,2015,1,8,16,1098,1059,2157,2287
0131-002,2015,1,8,17,996,1088,2084,2157
0131-002,2015,1,8,18,998,1224,2222,2084
0131-002,2015,1,8,19,938,1141,2079,2222
0131-002,2015,1,8,20,657,824,1481,2079
0131-002,2015,1,8,21,507,799,1306,1481
0131-002,2015,1,8,22,347,478,825,1306
0131-002,2015,1,8,23,228,303,531,825
0131-002,2015,1,8,24,156,206,362,531
0131-002,2015,1,9,1,95,130,225,362
0131-002,2015,1,9,2,61,107,168,225
0131-002,2015,1,9,3,27,67,94,168
0131-002,2015,1,9,4,20,85,105,94
0131-002,2015,1,9,5,37,101,138,105
0131-002,2015,1,9,6,114,172,286,138
0131-002,2015,1,9,7,693,311,1004,286
0131-002,2015,1,9,8,2217,840,3057,1004
0131-002,2015,1,9,9,1776,1137,2913,3057
0131-002,2015,1,9,10,1165,953,2118,2913
0131-002,2015,1,9,11,1025,1078,2103,2118
0131-002,2015,1,9,12,1044,967,2011,2103
0131-002,2015,1,9,13,872,943,1815,2011
0131-002,2015,1,9,14,1013,1006,2019,1815
0131-002,2015,1,9,15,1187,1107,2294,2019
0131-002,2015,1,9,16,1134,1141,2275,2294
0131-002,2015,1,9,17,967,1120,2087,2275
0131-002,2015,1,9,18,1153,1415,2568,2087
0131-002,2015,1,9,19,1129,1379,2508,2568
0131-002,2015,1,9,20,834,1013,1847,2508
0131-002,2015,1,9,21,509,749,1258,1847
0131-002,2015,1,9,22,427,510,937,1258
0131-002,2015,1,9,23,264,375,639,937
0131-002,2015,1,9,24,206,199,405,639
0131-002,2015,1,10,1,78,133,211,405
0131-002,2015,1,10,2,73,130,203,211
0131-002,2015,1,10,3,37,91,128,203
0131-002,2015,1,10,4,25,86,111,128
0131-002,2015,1,10,5,37,110,147,111
0131-002,2015,1,10,6,112,165,277,147
0131-002,2015,1,10,7,376,256,632,277
0131-002,2015,1,10,8,904,539,1443,632
0131-002,2015,1,10,9,807,791,1598,1443
0131-002,2015,1,10,10,858,848,1706,1598
0131-002,2015,1,10,11,955,973,1928,1706
0131-002,2015,1,10,12,996,1100,2096,1928
0131-002,2015,1,10,13,1006,1008,2014,2096
0131-002,2015,1,10,14,969,961,1930,2014
0131-002,2015,1,10,15,868,903,1771,1930
0131-002,2015,1,10,16,894,935,1829,1771
0131-002,2015,1,10,17,1110,1018,2128,1829
0131-002,2015,1,10,18,1136,1143,2279,2128
0131-002,2015,1,10,19,962,797,1759,2279
0131-002,2015,1,10,20,543,522,1065,1759
0131-002,2015,1,10,21,344,401,745,1065
0131-002,2015,1,10,22,291,308,599,745
0131-002,2015,1,10,23,194,219,413,599
0131-002,2015,1,10,24,114,193,307,413
0131-002,2015,1,11,1,88,120,208,307
0131-002,2015,1,11,2,63,83,146,208
0131-002,2015,1,11,3,32,69,101,146
0131-002,2015,1,11,4,20,55,75,101
0131-002,2015,1,11,5,37,39,76,75
0131-002,2015,1,11,6,32,104,136,76
0131-002,2015,1,11,7,107,129,236,136
0131-002,2015,1,11,8,163,202,365,236
0131-002,2015,1,11,9,240,318,558,365
0131-002,2015,1,11,10,235,443,678,558
0131-002,2015,1,11,11,344,596,940,678
0131-002,2015,1,11,12,441,547,988,940
0131-002,2015,1,11,13,553,561,1114,988
0131-002,2015,1,11,14,533,530,1063,1114
0131-002,2015,1,11,15,509,637,1146,1063
0131-002,2015,1,11,16,807,695,1502,1146
0131-002,2015,1,11,17,730,676,1406,1502
0131-002,2015,1,11,18,848,627,1475,1406
0131-002,2015,1,11,19,802,509,1311,1475
0131-002,2015,1,11,20,550,421,971,1311
0131-002,2015,1,11,21,390,315,705,971
0131-002,2015,1,11,22,286,267,553,705
0131-002,2015,1,11,23,226,194,420,553
0131-002,2015,1,11,24,119,115,234,420
0131-002,2015,1,12,1,97,75,172,234
0131-002,2015,1,12,2,17,45,62,172
0131-002,2015,1,12,3,20,32,52,62
0131-002,2015,1,12,4,30,52,82,52
0131-002,2015,1,12,5,34,77,111,82
0131-002,2015,1,12,6,175,146,321,111
0131-002,2015,1,12,7,812,355,1167,321
0131-002,2015,1,12,8,2545,884,3429,1167
0131-002,2015,1,12,9,1868,1108,2976,3429
0131-002,2015,1,12,10,1054,948,2002,2976
0131-002,2015,1,12,11,1083,998,2081,2002
0131-002,2015,1,12,12,1030,957,1987,2081
0131-002,2015,1,12,13,674,857,1531,1987
0131-002,2015,1,12,14,923,928,1851,1531
0131-002,2015,1,12,15,1064,1048,2112,1851
0131-002,2015,1,12,16,1083,1114,2197,2112
0131-002,2015,1,12,17,923,1050,1973,2197
0131-002,2015,1,12,18,994,1220,2214,1973
0131-002,2015,1,12,19,868,1119,1987,2214
0131-002,2015,1,12,20,579,874,1453,1987
0131-002,2015,1,12,21,497,797,1294,1453
0131-002,2015,1,12,22,296,496,792,1294
0131-002,2015,1,12,23,218,307,525,792
0131-002,2015,1,12,24,85,186,271,525
0131-002,2015,1,13,1,88,136,224,271
0131-002,2015,1,13,2,68,99,167,224
0131-002,2015,1,13,3,34,64,98,167
0131-002,2015,1,13,4,27,79,106,98
0131-002,2015,1,13,5,32,87,119,106
0131-002,2015,1,13,6,160,158,318,119
0131-002,2015,1,13,7,691,315,1006,318
0131-002,2015,1,13,8,2123,843,2966,1006
0131-002,2015,1,13,9,1812,1152,2964,2966
0131-002,2015,1,13,10,1081,969,2050,2964
0131-002,2015,1,13,11,979,982,1961,2050
0131-002,2015,1,13,12,996,926,1922,1961
0131-002,2015,1,13,13,730,854,1584,1922
0131-002,2015,1,13,14,967,963,1930,1584
0131-002,2015,1,13,15,1059,1078,2137,1930
0131-002,2015,1,13,16,1030,1084,2114,2137
0131-002,2015,1,13,17,1008,1114,2122,2114
0131-002,2015,1,13,18,960,1231,2191,2122
0131-002,2015,1,13,19,851,1172,2023,2191
0131-002,2015,1,13,20,664,815,1479,2023
0131-002,2015,1,13,21,478,789,1267,1479
0131-002,2015,1,13,22,332,492,824,1267
0131-002,2015,1,13,23,243,279,522,824
0131-002,2015,1,13,24,158,218,376,522
0131-002,2015,1,14,1,78,126,204,376
0131-002,2015,1,14,2,47,94,141,204
0131-002,2015,1,14,3,15,73,88,141
0131-002,2015,1,14,4,20,90,110,88
0131-002,2015,1,14,5,44,87,131,110
0131-002,2015,1,14,6,129,168,297,131
0131-002,2015,1,14,7,628,328,956,297
0131-002,2015,1,14,8,2182,879,3061,956
0131-002,2015,1,14,9,1887,1157,3044,3061
0131-002,2015,1,14,10,1214,973,2187,3044
0131-002,2015,1,14,11,1078,1034,2112,2187
0131-002,2015,1,14,12,1190,946,2136,2112
0131-002,2015,1,14,13,778,830,1608,2136
0131-002,2015,1,14,14,1027,969,1996,1608
0131-002,2015,1,14,15,1156,1070,2226,1996
0131-002,2015,1,14,16,1073,1035,2108,2226
0131-002,2015,1,14,17,1078,1072,2150,2108
0131-002,2015,1,14,18,1032,1324,2356,2150
0131-002,2015,1,14,19,972,1173,2145,2356
0131-002,2015,1,14,20,584,800,1384,2145
0131-002,2015,1,14,21,407,701,1108,1384
0131-002,2015,1,14,22,366,515,881,1108
0131-002,2015,1,14,23,320,295,615,881
0131-002,2015,1,14,24,146,201,347,615
0131-002,2015,1,15,1,102,134,236,347
0131-002,2015,1,15,2,59,100,159,236
0131-002,2015,1,15,3,47,77,124,159
0131-002,2015,1,15,4,42,88,130,124
0131-002,2015,1,15,5,54,111,165,130
0131-002,2015,1,15,6,175,178,353,165
0131-002,2015,1,15,7,698,327,1025,353
0131-002,2015,1,15,8,2074,862,2936,1025
0131-002,2015,1,15,9,1812,1078,2890,2936
0131-002,2015,1,15,10,1192,1031,2223,2890
0131-002,2015,1,15,11,1115,1056,2171,2223
0131-002,2015,1,15,12,1134,976,2110,2171
0131-002,2015,1,15,13,916,921,1837,2110
0131-002,2015,1,15,14,1117,926,2043,1837
0131-002,2015,1,15,15,1180,1076,2256,2043
0131-002,2015,1,15,16,1090,1096,2186,2256
0131-002,2015,1,15,17,1081,1091,2172,2186
0131-002,2015,1,15,18,1103,1348,2451,2172
0131-002,2015,1,15,19,1064,1116,2180,2451
0131-002,2015,1,15,20,594,835,1429,2180
0131-002,2015,1,15,21,463,724,1187,1429
0131-002,2015,1,15,22,422,533,955,1187
0131-002,2015,1,15,23,277,323,600,955
0131-002,2015,1,15,24,175,227,402,600
0131-002,2015,1,16,1,85,151,236,402
0131-002,2015,1,16,2,47,104,151,236
0131-002,2015,1,16,3,20,73,93,151
0131-002,2015,1,16,4,34,93,127,93
0131-002,2015,1,16,5,27,102,129,127
0131-002,2015,1,16,6,156,171,327,129
0131-002,2015,1,16,7,623,316,939,327
0131-002,2015,1,16,8,2034,792,2826,939
0131-002,2015,1,16,9,1805,1092,2897,2826
0131-002,2015,1,16,10,1132,1002,2134,2897
0131-002,2015,1,16,11,1083,1026,2109,2134
0131-002,2015,1,16,12,948,1034,1982,2109
0131-002,2015,1,16,13,824,954,1778,1982
0131-002,2015,1,16,14,1018,1010,2028,1778
0131-002,2015,1,16,15,1127,1119,2246,2028
0131-002,2015,1,16,16,957,1088,2045,2246
0131-002,2015,1,16,17,1047,1146,2193,2045
0131-002,2015,1,16,18,1076,1312,2388,2193
0131-002,2015,1,16,19,1170,1396,2566,2388
0131-002,2015,1,16,20,800,1011,1811,2566
0131-002,2015,1,16,21,562,784,1346,1811
0131-002,2015,1,16,22,395,462,857,1346
0131-002,2015,1,16,23,240,308,548,857
0131-002,2015,1,16,24,185,188,373,548
0131-002,2015,1,17,1,126,152,278,373
0131-002,2015,1,17,2,68,120,188,278
0131-002,2015,1,17,3,27,87,114,188
0131-002,2015,1,17,4,37,74,111,114
0131-002,2015,1,17,5,44,100,144,111
0131-002,2015,1,17,6,102,160,262,144
0131-002,2015,1,17,7,291,249,540,262
0131-002,2015,1,17,8,749,509,1258,540
0131-002,2015,1,17,9,906,753,1659,1258
0131-002,2015,1,17,10,766,872,1638,1659
0131-002,2015,1,17,11,860,903,1763,1638
0131-002,2015,1,17,12,914,909,1823,1763
0131-002,2015,1,17,13,768,912,1680,1823
0131-002,2015,1,17,14,778,870,1648,1680
0131-002,2015,1,17,15,943,918,1861,1648
0131-002,2015,1,17,16,940,923,1863,1861
0131-002,2015,1,17,17,952,929,1881,1863
0131-002,2015,1,17,18,1350,1079,2429,1881
0131-002,2015,1,17,19,1052,801,1853,2429
0131-002,2015,1,17,20,543,483,1026,1853
0131-002,2015,1,17,21,371,425,796,1026
0131-002,2015,1,17,22,357,292,649,796
0131-002,2015,1,17,23,214,210,424,649
0131-002,2015,1,17,24,102,164,266,424
0131-002,2015,1,18,1,51,104,155,266
0131-002,2015,1,18,2,39,64,103,155
0131-002,2015,1,18,3,27,69,96,103
0131-002,2015,1,18,4,17,67,84,96
0131-002,2015,1,18,5,39,59,98,84
0131-002,2015,1,18,6,44,102,146,98
0131-002,2015,1,18,7,112,125,237,146
0131-002,2015,1,18,8,194,194,388,237
0131-002,2015,1,18,9,279,347,626,388
0131-002,2015,1,18,10,313,487,800,626
0131-002,2015,1,18,11,436,569,1005,800
0131-002,2015,1,18,12,468,638,1106,1005
0131-002,2015,1,18,13,502,641,1143,1106
0131-002,2015,1,18,14,703,646,1349,1143
0131-002,2015,1,18,15,732,701,1433,1349
0131-002,2015,1,18,16,909,731,1640,1433
0131-002,2015,1,18,17,1028,696,1724,1640
0131-002,2015,1,18,18,901,654,1555,1724
0131-002,2015,1,18,19,974,490,1464,1555
0131-002,2015,1,18,20,642,409,1051,1464
0131-002,2015,1,18,21,405,312,717,1051
0131-002,2015,1,18,22,303,234,537,717
0131-002,2015,1,18,23,267,157,424,537
0131-002,2015,1,18,24,95,101,196,424
0131-002,2015,1,19,1,49,69,118,196
0131-002,2015,1,19,2,20,50,70,118
0131-002,2015,1,19,3,27,41,68,70
0131-002,2015,1,19,4,10,36,46,68
0131-002,2015,1,19,5,49,78,127,46
0131-002,2015,1,19,6,180,118,298,127
0131-002,2015,1,19,7,773,296,1069,298
0131-002,2015,1,19,8,2142,834,2976,1069
0131-002,2015,1,19,9,1568,962,2530,2976
0131-002,2015,1,19,10,916,896,1812,2530
0131-002,2015,1,19,11,964,884,1848,1812
0131-002,2015,1,19,12,957,938,1895,1848
0131-002,2015,1,19,13,676,791,1467,1895
0131-002,2015,1,19,14,875,848,1723,1467
0131-002,2015,1,19,15,989,1044,2033,1723
0131-002,2015,1,19,16,1037,1052,2089,2033
0131-002,2015,1,19,17,1027,1041,2068,2089
0131-002,2015,1,19,18,974,1184,2158,2068
0131-002,2015,1,19,19,972,1080,2052,2158
0131-002,2015,1,19,20,618,846,1464,2052
0131-002,2015,1,19,21,480,728,1208,1464
0131-002,2015,1,19,22,364,500,864,1208
0131-002,2015,1,19,23,218,329,547,864
0131-002,2015,1,19,24,129,179,308,547
0131-002,2015,1,20,1,73,127,200,308
0131-002,2015,1,20,2,37,95,132,200
0131-002,2015,1,20,3,22,73,95,132
0131-002,2015,1,20,4,34,81,115,95
0131-002,2015,1,20,5,39,105,144,115
0131-002,2015,1,20,6,153,149,302,144
0131-002,2015,1,20,7,611,309,920,302
0131-002,2015,1,20,8,2090,858,2948,920
0131-002,2015,1,20,9,1776,1129,2905,2948
0131-002,2015,1,20,10,1228,992,2220,2905
0131-002,2015,1,20,11,998,974,1972,2220
0131-002,2015,1,20,12,1003,974,1977,1972
0131-002,2015,1,20,13,860,847,1707,1977
0131-002,2015,1,20,14,911,945,1856,1707
0131-002,2015,1,20,15,1030,1040,2070,1856
0131-002,2015,1,20,16,1023,1044,2067,2070
0131-002,2015,1,20,17,991,1138,2129,2067
0131-002,2015,1,20,18,998,1198,2196,2129
0131-002,2015,1,20,19,904,1201,2105,2196
0131-002,2015,1,20,20,654,853,1507,2105
0131-002,2015,1,20,21,512,811,1323,1507
0131-002,2015,1,20,22,410,542,952,1323
0131-002,2015,1,20,23,291,290,581,952
0131-002,2015,1,20,24,153,215,368,581
0131-002,2015,1,21,1,68,135,203,368
0131-002,2015,1,21,2,42,89,131,203
0131-002,2015,1,21,3,49,81,130,131
0131-002,2015,1,21,4,34,89,123,130
0131-002,2015,1,21,5,61,105,166,123
0131-002,2015,1,21,6,175,154,329,166
0131-002,2015,1,21,7,703,349,1052,329
0131-002,2015,1,21,8,2106,836,2942,1052
0131-002,2015,1,21,9,1911,1091,3002,2942
0131-002,2015,1,21,10,1107,1094,2201,3002
0131-002,2015,1,21,11,1199,1006,2205,2201
0131-002,2015,1,21,12,1010,935,1945,2205
0131-002,2015,1,21,13,843,874,1717,1945
0131-002,2015,1,21,14,1110,913,2023,1717
0131-002,2015,1,21,15,1054,1133,2187,2023
0131-002,2015,1,21,16,1127,1191,2318,2187
0131-002,2015,1,21,17,1061,1202,2263,2318
0131-002,2015,1,21,18,1003,1356,2359,2263
0131-002,2015,1,21,19,964,1188,2152,2359
0131-002,2015,1,21,20,640,813,1453,2152
0131-002,2015,1,21,21,444,700,1144,1453
0131-002,2015,1,21,22,361,501,862,1144
0131-002,2015,1,21,23,260,294,554,862
0131-002,2015,1,21,24,126,215,341,554
0131-002,2015,1,22,1,80,127,207,341
0131-002,2015,1,22,2,39,92,131,207
0131-002,2015,1,22,3,32,63,95,131
0131-002,2015,1,22,4,15,75,90,95
0131-002,2015,1,22,5,27,101,128,90
0131-002,2015,1,22,6,114,129,243,128
0131-002,2015,1,22,7,604,290,894,243
0131-002,2015,1,22,8,1960,771,2731,894
0131-002,2015,1,22,9,1773,1096,2869,2731
0131-002,2015,1,22,10,986,963,1949,2869
0131-002,2015,1,22,11,1054,977,2031,1949
0131-002,2015,1,22,12,1088,935,2023,2031
0131-002,2015,1,22,13,846,864,1710,2023
0131-002,2015,1,22,14,960,889,1849,1710
0131-002,2015,1,22,15,1054,1066,2120,1849
0131-002,2015,1,22,16,865,1055,1920,2120
0131-002,2015,1,22,17,977,1023,2000,1920
0131-002,2015,1,22,18,1001,1173,2174,2000
0131-002,2015,1,22,19,967,1057,2024,2174
0131-002,2015,1,22,20,599,854,1453,2024
0131-002,2015,1,22,21,536,786,1322,1453
0131-002,2015,1,22,22,369,529,898,1322
0131-002,2015,1,22,23,240,328,568,898
0131-002,2015,1,22,24,182,179,361,568
0131-002,2015,1,23,1,83,136,219,361
0131-002,2015,1,23,2,51,114,165,219
0131-002,2015,1,23,3,30,86,116,165
0131-002,2015,1,23,4,17,82,99,116
0131-002,2015,1,23,5,39,108,147,99
0131-002,2015,1,23,6,168,178,346,147
0131-002,2015,1,23,7,599,330,929,346
0131-002,2015,1,23,8,2139,829,2968,929
0131-002,2015,1,23,9,1819,1092,2911,2968
0131-002,2015,1,23,10,1040,1063,2103,2911
0131-002,2015,1,23,11,1013,1018,2031,2103
0131-002,2015,1,23,12,1049,1022,2071,2031
0131-002,2015,1,23,13,916,898,1814,2071
0131-002,2015,1,23,14,1015,995,2010,1814
0131-002,2015,1,23,15,1156,1063,2219,2010
0131-002,2015,1,23,16,1066,1144,2210,2219
0131-002,2015,1,23,17,921,1177,2098,2210
0131-002,2015,1,23,18,1161,1340,2501,2098
0131-002,2015,1,23,19,1187,1396,2583,2501
0131-002,2015,1,23,20,885,1025,1910,2583
0131-002,2015,1,23,21,543,809,1352,1910
0131-002,2015,1,23,22,441,512,953,1352
0131-002,2015,1,23,23,306,339,645,953
0131-002,2015,1,23,24,177,215,392,645
0131-002,2015,1,24,1,100,159,259,392
0131-002,2015,1,24,2,68,135,203,259
0131-002,2015,1,24,3,47,79,126,203
0131-002,2015,1,24,4,39,90,129,126
0131-002,2015,1,24,5,49,99,148,129
0131-002,2015,1,24,6,114,152,266,148
0131-002,2015,1,24,7,349,280,629,266
0131-002,2015,1,24,8,955,550,1505,629
0131-002,2015,1,24,9,957,801,1758,1505
0131-002,2015,1,24,10,909,927,1836,1758
0131-002,2015,1,24,11,909,1025,1934,1836
0131-002,2015,1,24,12,957,1028,1985,1934
0131-002,2015,1,24,13,868,894,1762,1985
0131-002,2015,1,24,14,962,918,1880,1762
0131-002,2015,1,24,15,906,963,1869,1880
0131-002,2015,1,24,16,1010,909,1919,1869
0131-002,2015,1,24,17,935,982,1917,1919
0131-002,2015,1,24,18,1133,1081,2214,1917
0131-002,2015,1,24,19,945,809,1754,2214
0131-002,2015,1,24,20,584,549,1133,1754
0131-002,2015,1,24,21,400,388,788,1133
0131-002,2015,1,24,22,306,323,629,788
0131-002,2015,1,24,23,148,208,356,629
0131-002,2015,1,24,24,129,174,303,356
0131-002,2015,1,25,1,68,107,175,303
0131-002,2015,1,25,2,25,75,100,175
0131-002,2015,1,25,3,32,77,109,100
0131-002,2015,1,25,4,22,69,91,109
0131-002,2015,1,25,5,32,52,84,91
0131-002,2015,1,25,6,54,85,139,84
0131-002,2015,1,25,7,100,123,223,139
0131-002,2015,1,25,8,277,255,532,223
0131-002,2015,1,25,9,301,441,742,532
0131-002,2015,1,25,10,342,487,829,742
0131-002,2015,1,25,11,439,603,1042,829
0131-002,2015,1,25,12,451,544,995,1042
0131-002,2015,1,25,13,591,612,1203,995
0131-002,2015,1,25,14,575,596,1171,1203
0131-002,2015,1,25,15,746,633,1379,1171
0131-002,2015,1,25,16,1064,629,1693,1379
0131-002,2015,1,25,17,1260,658,1918,1693
0131-002,2015,1,25,18,1287,620,1907,1918
0131-002,2015,1,25,19,1253,461,1714,1907
0131-002,2015,1,25,20,759,369,1128,1714
0131-002,2015,1,25,21,524,301,825,1128
0131-002,2015,1,25,22,274,255,529,825
0131-002,2015,1,25,23,202,182,384,529
0131-002,2015,1,25,24,168,131,299,384
0131-002,2015,1,26,1,83,94,177,299
0131-002,2015,1,26,2,34,71,105,177
0131-002,2015,1,26,3,20,42,62,105
0131-002,2015,1,26,4,15,50,65,62
0131-002,2015,1,26,5,44,69,113,65
0131-002,2015,1,26,6,192,138,330,113
0131-002,2015,1,26,7,829,296,1125,330
0131-002,2015,1,26,8,2206,794,3000,1125
0131-002,2015,1,26,9,1725,1012,2737,3000
0131-002,2015,1,26,10,945,882,1827,2737
0131-002,2015,1,26,11,928,947,1875,1827
0131-002,2015,1,26,12,826,881,1707,1875
0131-002,2015,1,26,13,773,832,1605,1707
0131-002,2015,1,26,14,877,925,1802,1605
0131-002,2015,1,26,15,1103,1019,2122,1802
0131-002,2015,1,26,16,1018,1022,2040,2122
0131-002,2015,1,26,17,938,1014,1952,2040
0131-002,2015,1,26,18,972,1144,2116,1952
0131-002,2015,1,26,19,996,1058,2054,2116
0131-002,2015,1,26,20,616,820,1436,2054
0131-002,2015,1,26,21,451,796,1247,1436
0131-002,2015,1,26,22,376,482,858,1247
0131-002,2015,1,26,23,238,324,562,858
0131-002,2015,1,26,24,131,165,296,562
0131-002,2015,1,27,1,76,144,220,296
0131-002,2015,1,27,2,34,110,144,220
0131-002,2015,1,27,3,27,63,90,144
0131-002,2015,1,27,4,54,72,126,90
0131-002,2015,1,27,5,34,82,116,126
0131-002,2015,1,27,6,117,171,288,116
0131-002,2015,1,27,7,696,287,983,288
0131-002,2015,1,27,8,2147,862,3009,983
0131-002,2015,1,27,9,1870,1111,2981,3009
0131-002,2015,1,27,10,1107,1021,2128,2981
0131-002,2015,1,27,11,1073,1009,2082,2128
0131-002,2015,1,27,12,977,941,1918,2082
0131-002,2015,1,27,13,800,818,1618,1918
0131-002,2015,1,27,14,921,998,1919,1618
0131-002,2015,1,27,15,1044,1158,2202,1919
0131-002,2015,1,27,16,923,1055,1978,2202
0131-002,2015,1,27,17,897,1125,2022,1978
0131-002,2015,1,27,18,892,1189,2081,2022
0131-002,2015,1,27,19,870,1203,2073,2081
0131-002,2015,1,27,20,615,851,1466,2073
0131-002,2015,1,27,21,460,804,1264,1466
0131-002,2015,1,27,22,362,497,859,1264
0131-002,2015,1,27,23,249,326,575,859
0131-002,2015,1,27,24,132,190,322,575
0131-002,2015,1,28,1,82,133,215,322
0131-002,2015,1,28,2,34,97,131,215
0131-002,2015,1,28,3,36,62,98,131
0131-002,2015,1,28,4,32,76,108,98
0131-002,2015,1,28,5,44,98,142,108
0131-002,2015,1,28,6,148,172,320,142
0131-002,2015,1,28,7,626,324,950,320
0131-002,2015,1,28,8,2030,843,2873,950
0131-002,2015,1,28,9,1752,1111,2863,2873
0131-002,2015,1,28,10,1052,1106,2158,2863
0131-002,2015,1,28,11,1044,1087,2131,2158
0131-002,2015,1,28,12,909,1042,1951,2131
0131-002,2015,1,28,13,780,897,1677,1951
0131-002,2015,1,28,14,1061,966,2027,1677
0131-002,2015,1,28,15,1134,1122,2256,2027
0131-002,2015,1,28,16,1100,1071,2171,2256
0131-002,2015,1,28,17,1056,1089,2145,2171
0131-002,2015,1,28,18,996,1373,2369,2145
0131-002,2015,1,28,19,986,1244,2230,2369
0131-002,2015,1,28,20,676,875,1551,2230
0131-002,2015,1,28,21,524,747,1271,1551
0131-002,2015,1,28,22,388,485,873,1271
0131-002,2015,1,28,23,252,317,569,873
0131-002,2015,1,28,24,143,233,376,569
0131-002,2015,1,29,1,73,160,233,376
0131-002,2015,1,29,2,49,116,165,233
0131-002,2015,1,29,3,37,74,111,165
0131-002,2015,1,29,4,32,71,103,111
0131-002,2015,1,29,5,47,118,165,103
0131-002,2015,1,29,6,153,187,340,165
0131-002,2015,1,29,7,652,351,1003,340
0131-002,2015,1,29,8,2087,830,2917,1003
0131-002,2015,1,29,9,1856,1135,2991,2917
0131-002,2015,1,29,10,1124,1076,2200,2991
0131-002,2015,1,29,11,1129,1077,2206,2200
0131-002,2015,1,29,12,1086,985,2071,2206
0131-002,2015,1,29,13,822,935,1757,2071
0131-002,2015,1,29,14,1052,1003,2055,1757
0131-002,2015,1,29,15,1127,1020,2147,2055
0131-002,2015,1,29,16,1059,1104,2163,2147
0131-002,2015,1,29,17,1040,1043,2083,2163
0131-002,2015,1,29,18,1052,1224,2276,2083
0131-002,2015,1,29,19,928,1182,2110,2276
0131-002,2015,1,29,20,599,808,1407,2110
0131-002,2015,1,29,21,466,813,1279,1407
0131-002,2015,1,29,22,420,516,936,1279
0131-002,2015,1,29,23,262,316,578,936
0131-002,2015,1,29,24,185,207,392,578
0131-002,2015,1,30,1,95,124,219,392
0131-002,2015,1,30,2,63,108,171,219
0131-002,2015,1,30,3,44,83,127,171
0131-002,2015,1,30,4,32,87,119,127
0131-002,2015,1,30,5,34,104,138,119
0131-002,2015,1,30,6,172,187,359,138
0131-002,2015,1,30,7,688,308,996,359
0131-002,2015,1,30,8,2125,855,2980,996
0131-002,2015,1,30,9,1759,1150,2909,2980
0131-002,2015,1,30,10,1149,1034,2183,2909
0131-002,2015,1,30,11,1185,1063,2248,2183
0131-002,2015,1,30,12,1049,1028,2077,2248
0131-002,2015,1,30,13,897,867,1764,2077
0131-002,2015,1,30,14,1032,935,1967,1764
0131-002,2015,1,30,15,1144,1133,2277,1967
0131-002,2015,1,30,16,1103,1117,2220,2277
0131-002,2015,1,30,17,1059,1110,2169,2220
0131-002,2015,1,30,18,1207,1385,2592,2169
0131-002,2015,1,30,19,1195,1353,2548,2592
0131-002,2015,1,30,20,794,1063,1857,2548
0131-002,2015,1,30,21,489,887,1376,1857
0131-002,2015,1,30,22,402,534,936,1376
0131-002,2015,1,30,23,290,323,613,936
0131-002,2015,1,30,24,164,226,390,613
0131-002,2015,1,31,1,102,193,295,390
0131-002,2015,1,31,2,70,115,185,295
0131-002,2015,1,31,3,44,105,149,185
0131-002,2015,1,31,4,32,89,121,149
0131-002,2015,1,31,5,38,111,149,121
0131-002,2015,1,31,6,106,157,263,149
0131-002,2015,1,31,7,328,271,599,263
0131-002,2015,1,31,8,921,562,1483,599
0131-002,2015,1,31,9,872,787,1659,1483
0131-002,2015,1,31,10,823,890,1713,1659
0131-002,2015,1,31,11,856,1027,1883,1713
0131-002,2015,1,31,12,933,907,1840,1883
0131-002,2015,1,31,13,841,888,1729,1840
0131-002,2015,1,31,14,889,928,1817,1729
0131-002,2015,1,31,15,918,881,1799,1817
0131-002,2015,1,31,16,951,924,1875,1799
0131-002,2015,1,31,17,898,954,1852,1875
0131-002,2015,1,31,18,1078,1135,2213,1852
0131-002,2015,1,31,19,892,693,1585,2213
0131-002,2015,1,31,20,570,451,1021,1585
0131-002,2015,1,31,21,377,420,797,1021
0131-002,2015,1,31,22,281,344,625,797
0131-002,2015,1,31,23,153,217,370,625
0131-002,2015,1,31,24,116,171,287,370
0131-002,2015,2,1,1,58,126,184,287
0131-002,2015,2,1,2,32,77,109,184
0131-002,2015,2,1,3,25,55,80,109
0131-002,2015,2,1,4,40,56,96,80
0131-002,2015,2,1,5,24,50,74,96
0131-002,2015,2,1,6,85,78,163,74
0131-002,2015,2,1,7,246,113,359,163
0131-002,2015,2,1,8,488,220,708,359
0131-002,2015,2,1,9,534,372,906,708
0131-002,2015,2,1,10,404,478,882,906
0131-002,2015,2,1,11,415,619,1034,882
0131-002,2015,2,1,12,431,536,967,1034
0131-002,2015,2,1,13,499,606,1105,967
0131-002,2015,2,1,14,538,600,1138,1105
0131-002,2015,2,1,15,672,692,1364,1138
0131-002,2015,2,1,16,810,708,1518,1364
0131-002,2015,2,1,17,956,696,1652,1518
0131-002,2015,2,1,18,692,719,1411,1652
0131-002,2015,2,1,19,712,552,1264,1411
0131-002,2015,2,1,20,470,450,920,1264
0131-002,2015,2,1,21,336,343,679,920
0131-002,2015,2,1,22,360,318,678,679
0131-002,2015,2,1,23,222,204,426,678
0131-002,2015,2,1,24,109,102,211,426
0131-002,2015,2,2,1,67,89,156,211
0131-002,2015,2,2,2,32,58,90,156
0131-002,2015,2,2,3,14,45,59,90
0131-002,2015,2,2,4,16,50,66,59
0131-002,2015,2,2,5,46,96,142,66
0131-002,2015,2,2,6,140,160,300,142
0131-002,2015,2,2,7,684,340,1024,300
0131-002,2015,2,2,8,2035,916,2951,1024
0131-002,2015,2,2,9,1617,1090,2707,2951
0131-002,2015,2,2,10,808,993,1801,2707
0131-002,2015,2,2,11,869,993,1862,1801
0131-002,2015,2,2,12,702,969,1671,1862
0131-002,2015,2,2,13,692,811,1503,1671
0131-002,2015,2,2,14,794,927,1721,1503
0131-002,2015,2,2,15,885,1150,2035,1721
0131-002,2015,2,2,16,847,1068,1915,2035
0131-002,2015,2,2,17,773,1038,1811,1915
0131-002,2015,2,2,18,763,1246,2009,1811
0131-002,2015,2,2,19,780,1110,1890,2009
0131-002,2015,2,2,20,545,865,1410,1890
0131-002,2015,2,2,21,439,843,1282,1410
0131-002,2015,2,2,22,287,571,858,1282
0131-002,2015,2,2,23,197,337,534,858
0131-002,2015,2,2,24,107,199,306,534
0131-002,2015,2,3,1,59,125,184,306
0131-002,2015,2,3,2,40,91,131,184
0131-002,2015,2,3,3,16,76,92,131
0131-002,2015,2,3,4,18,73,91,92
0131-002,2015,2,3,5,38,101,139,91
0131-002,2015,2,3,6,116,152,268,139
0131-002,2015,2,3,7,501,312,813,268
0131-002,2015,2,3,8,1861,865,2726,813
0131-002,2015,2,3,9,1574,1140,2714,2726
0131-002,2015,2,3,10,930,1054,1984,2714
0131-002,2015,2,3,11,918,1017,1935,1984
0131-002,2015,2,3,12,814,951,1765,1935
0131-002,2015,2,3,13,698,822,1520,1765
0131-002,2015,2,3,14,790,940,1730,1520
0131-002,2015,2,3,15,916,1093,2009,1730
0131-002,2015,2,3,16,804,1050,1854,2009
0131-002,2015,2,3,17,877,1095,1972,1854
0131-002,2015,2,3,18,786,1240,2026,1972
0131-002,2015,2,3,19,837,1108,1945,2026
0131-002,2015,2,3,20,576,873,1449,1945
0131-002,2015,2,3,21,409,812,1221,1449
0131-002,2015,2,3,22,313,545,858,1221
0131-002,2015,2,3,23,207,353,560,858
0131-002,2015,2,3,24,112,206,318,560
0131-002,2015,2,4,1,95,131,226,318
0131-002,2015,2,4,2,26,97,123,226
0131-002,2015,2,4,3,24,61,85,123
0131-002,2015,2,4,4,30,70,100,85
0131-002,2015,2,4,5,26,106,132,100
0131-002,2015,2,4,6,122,180,302,132
0131-002,2015,2,4,7,549,348,897,302
0131-002,2015,2,4,8,1955,881,2836,897
0131-002,2015,2,4,9,1594,1158,2752,2836
0131-002,2015,2,4,10,997,1029,2026,2752
0131-002,2015,2,4,11,888,983,1871,2026
0131-002,2015,2,4,12,808,946,1754,1871
0131-002,2015,2,4,13,718,932,1650,1754
0131-002,2015,2,4,14,898,992,1890,1650
0131-002,2015,2,4,15,940,1114,2054,1890
0131-002,2015,2,4,16,877,1106,1983,2054
0131-002,2015,2,4,17,755,1054,1809,1983
0131-002,2015,2,4,18,800,1307,2107,1809
0131-002,2015,2,4,19,765,1120,1885,2107
0131-002,2015,2,4,20,582,808,1390,1885
0131-002,2015,2,4,21,403,664,1067,1390
0131-002,2015,2,4,22,327,498,825,1067
0131-002,2015,2,4,23,193,329,522,825
0131-002,2015,2,4,24,107,183,290,522
0131-002,2015,2,5,1,73,126,199,290
0131-002,2015,2,5,2,26,82,108,199
0131-002,2015,2,5,3,12,79,91,108
0131-002,2015,2,5,4,14,87,101,91
0131-002,2015,2,5,5,42,96,138,101
0131-002,2015,2,5,6,118,163,281,138
0131-002,2015,2,5,7,521,319,840,281
0131-002,2015,2,5,8,1795,859,2654,840
0131-002,2015,2,5,9,1574,1137,2711,2654
0131-002,2015,2,5,10,959,1048,2007,2711
0131-002,2015,2,5,11,881,1042,1923,2007
0131-002,2015,2,5,12,804,961,1765,1923
0131-002,2015,2,5,13,773,898,1671,1765
0131-002,2015,2,5,14,859,929,1788,1671
0131-002,2015,2,5,15,883,1173,2056,1788
0131-002,2015,2,5,16,839,1059,1898,2056
0131-002,2015,2,5,17,965,1115,2080,1898
0131-002,2015,2,5,18,869,1305,2174,2080
0131-002,2015,2,5,19,837,1125,1962,2174
0131-002,2015,2,5,20,521,864,1385,1962
0131-002,2015,2,5,21,443,810,1253,1385
0131-002,2015,2,5,22,376,544,920,1253
0131-002,2015,2,5,23,222,376,598,920
0131-002,2015,2,5,24,116,216,332,598
0131-002,2015,2,6,1,61,176,237,332
0131-002,2015,2,6,2,32,108,140,237
0131-002,2015,2,6,3,32,93,125,140
0131-002,2015,2,6,4,30,88,118,125
0131-002,2015,2,6,5,34,105,139,118
0131-002,2015,2,6,6,144,167,311,139
0131-002,2015,2,6,7,562,321,883,311
0131-002,2015,2,6,8,1909,900,2809,883
0131-002,2015,2,6,9,1505,1185,2690,2809
0131-002,2015,2,6,10,947,1075,2022,2690
0131-002,2015,2,6,11,977,1051,2028,2022
0131-002,2015,2,6,12,843,1049,1892,2028
0131-002,2015,2,6,13,723,1040,1763,1892
0131-002,2015,2,6,14,936,1073,2009,1763
0131-002,2015,2,6,15,902,1303,2205,2009
0131-002,2015,2,6,16,920,1105,2025,2205
0131-002,2015,2,6,17,953,1132,2085,2025
0131-002,2015,2,6,18,955,1504,2459,2085
0131-002,2015,2,6,19,1038,1345,2383,2459
0131-002,2015,2,6,20,704,1025,1729,2383
0131-002,2015,2,6,21,435,785,1220,1729
0131-002,2015,2,6,22,362,552,914,1220
0131-002,2015,2,6,23,274,366,640,914
0131-002,2015,2,6,24,150,221,371,640
0131-002,2015,2,7,1,105,200,305,371
0131-002,2015,2,7,2,71,134,205,305
0131-002,2015,2,7,3,42,94,136,205
0131-002,2015,2,7,4,26,92,118,136
0131-002,2015,2,7,5,28,99,127,118
0131-002,2015,2,7,6,97,166,263,127
0131-002,2015,2,7,7,307,276,583,263
0131-002,2015,2,7,8,887,578,1465,583
0131-002,2015,2,7,9,786,806,1592,1465
0131-002,2015,2,7,10,737,944,1681,1592
0131-002,2015,2,7,11,804,977,1781,1681
0131-002,2015,2,7,12,881,964,1845,1781
0131-002,2015,2,7,13,751,924,1675,1845
0131-002,2015,2,7,14,804,963,1767,1675
0131-002,2015,2,7,15,818,968,1786,1767
0131-002,2015,2,7,16,892,926,1818,1786
0131-002,2015,2,7,17,861,1032,1893,1818
0131-002,2015,2,7,18,1023,1178,2201,1893
0131-002,2015,2,7,19,839,825,1664,2201
0131-002,2015,2,7,20,556,501,1057,1664
0131-002,2015,2,7,21,354,439,793,1057
0131-002,2015,2,7,22,256,365,621,793
0131-002,2015,2,7,23,158,216,374,621
0131-002,2015,2,7,24,103,205,308,374
0131-002,2015,2,8,1,48,98,146,308
0131-002,2015,2,8,2,38,101,139,146
0131-002,2015,2,8,3,18,55,73,139
0131-002,2015,2,8,4,59,60,119,73
0131-002,2015,2,8,5,16,58,74,119
0131-002,2015,2,8,6,116,82,198,74
0131-002,2015,2,8,7,173,158,331,198
0131-002,2015,2,8,8,382,222,604,331
0131-002,2015,2,8,9,418,366,784,604
0131-002,2015,2,8,10,373,533,906,784
0131-002,2015,2,8,11,427,532,959,906
0131-002,2015,2,8,12,441,499,940,959
0131-002,2015,2,8,13,545,569,1114,940
0131-002,2015,2,8,14,556,588,1144,1114
0131-002,2015,2,8,15,709,625,1334,1144
0131-002,2015,2,8,16,937,657,1594,1334
0131-002,2015,2,8,17,1108,654,1762,1594
0131-002,2015,2,8,18,990,696,1686,1762
0131-002,2015,2,8,19,982,523,1505,1686
0131-002,2015,2,8,20,614,392,1006,1505
0131-002,2015,2,8,21,430,331,761,1006
0131-002,2015,2,8,22,317,281,598,761
0131-002,2015,2,8,23,212,183,395,598
0131-002,2015,2,8,24,138,125,263,395
0131-002,2015,2,9,1,160,79,239,263
0131-002,2015,2,9,2,138,57,195,239
0131-002,2015,2,9,3,109,36,145,195
0131-002,2015,2,9,4,95,57,152,145
0131-002,2015,2,9,5,128,67,195,152
0131-002,2015,2,9,6,166,161,327,195
0131-002,2015,2,9,7,756,343,1099,327
0131-002,2015,2,9,8,2120,923,3043,1099
0131-002,2015,2,9,9,1671,1144,2815,3043
0131-002,2015,2,9,10,876,999,1875,2815
0131-002,2015,2,9,11,898,993,1891,1875
0131-002,2015,2,9,12,784,919,1703,1891
0131-002,2015,2,9,13,631,777,1408,1703
0131-002,2015,2,9,14,804,877,1681,1408
0131-002,2015,2,9,15,887,1045,1932,1681
0131-002,2015,2,9,16,887,1036,1923,1932
0131-002,2015,2,9,17,777,1024,1801,1923
0131-002,2015,2,9,18,741,1244,1985,1801
0131-002,2015,2,9,19,784,1010,1794,1985
0131-002,2015,2,9,20,545,822,1367,1794
0131-002,2015,2,9,21,307,765,1072,1367
0131-002,2015,2,9,22,278,464,742,1072
0131-002,2015,2,9,23,158,323,481,742
0131-002,2015,2,9,24,111,187,298,481
0131-002,2015,2,10,1,44,128,172,298
0131-002,2015,2,10,2,24,79,103,172
0131-002,2015,2,10,3,20,78,98,103
0131-002,2015,2,10,4,16,78,94,98
0131-002,2015,2,10,5,40,108,148,94
0131-002,2015,2,10,6,105,150,255,148
0131-002,2015,2,10,7,531,316,847,255
0131-002,2015,2,10,8,1809,836,2645,847
0131-002,2015,2,10,9,1466,1194,2660,2645
0131-002,2015,2,10,10,920,1031,1951,2660
0131-002,2015,2,10,11,851,1043,1894,1951
0131-002,2015,2,10,12,896,1013,1909,1894
0131-002,2015,2,10,13,682,823,1505,1909
0131-002,2015,2,10,14,853,952,1805,1505
0131-002,2015,2,10,15,947,1146,2093,1805
0131-002,2015,2,10,16,877,1161,2038,2093
0131-002,2015,2,10,17,802,1090,1892,2038
0131-002,2015,2,10,18,816,1254,2070,1892
0131-002,2015,2,10,19,833,1092,1925,2070
0131-002,2015,2,10,20,578,912,1490,1925
0131-002,2015,2,10,21,464,799,1263,1490
0131-002,2015,2,10,22,338,519,857,1263
0131-002,2015,2,10,23,207,365,572,857
0131-002,2015,2,10,24,118,187,305,572
0131-002,2015,2,11,1,56,145,201,305
0131-002,2015,2,11,2,46,99,145,201
0131-002,2015,2,11,3,26,72,98,145
0131-002,2015,2,11,4,24,70,94,98
0131-002,2015,2,11,5,44,89,133,94
0131-002,2015,2,11,6,116,131,247,133
0131-002,2015,2,11,7,602,306,908,247
0131-002,2015,2,11,8,1828,862,2690,908
0131-002,2015,2,11,9,1625,1100,2725,2690
0131-002,2015,2,11,10,940,964,1904,2725
0131-002,2015,2,11,11,892,1073,1965,1904
0131-002,2015,2,11,12,802,1030,1832,1965
0131-002,2015,2,11,13,720,911,1631,1832
0131-002,2015,2,11,14,816,1041,1857,1631
0131-002,2015,2,11,15,995,1175,2170,1857
0131-002,2015,2,11,16,936,1113,2049,2170
0131-002,2015,2,11,17,975,1147,2122,2049
0131-002,2015,2,11,18,908,1421,2329,2122
0131-002,2015,2,11,19,816,1255,2071,2329
0131-002,2015,2,11,20,564,846,1410,2071
0131-002,2015,2,11,21,435,751,1186,1410
0131-002,2015,2,11,22,354,508,862,1186
0131-002,2015,2,11,23,236,325,561,862
0131-002,2015,2,11,24,142,197,339,561
0131-002,2015,2,12,1,87,168,255,339
0131-002,2015,2,12,2,40,98,138,255
0131-002,2015,2,12,3,26,71,97,138
0131-002,2015,2,12,4,105,67,172,97
0131-002,2015,2,12,5,169,120,289,172
0131-002,2015,2,12,6,122,155,277,289
0131-002,2015,2,12,7,570,341,911,277
0131-002,2015,2,12,8,1893,914,2807,911
0131-002,2015,2,12,9,1488,1158,2646,2807
0131-002,2015,2,12,10,942,1044,1986,2646
0131-002,2015,2,12,11,900,1080,1980,1986
0131-002,2015,2,12,12,841,1046,1887,1980
0131-002,2015,2,12,13,828,986,1814,1887
0131-002,2015,2,12,14,930,980,1910,1814
0131-002,2015,2,12,15,930,1182,2112,1910
0131-002,2015,2,12,16,991,1281,2272,2112
0131-002,2015,2,12,17,1000,1153,2153,2272
0131-002,2015,2,12,18,871,1290,2161,2153
0131-002,2015,2,12,19,926,1137,2063,2161
0131-002,2015,2,12,20,661,848,1509,2063
0131-002,2015,2,12,21,470,765,1235,1509
0131-002,2015,2,12,22,446,599,1045,1235
0131-002,2015,2,12,23,266,374,640,1045
0131-002,2015,2,12,24,150,209,359,640
0131-002,2015,2,13,1,63,165,228,359
0131-002,2015,2,13,2,44,95,139,228
0131-002,2015,2,13,3,18,84,102,139
0131-002,2015,2,13,4,16,75,91,102
0131-002,2015,2,13,5,52,128,180,91
0131-002,2015,2,13,6,213,176,389,180
0131-002,2015,2,13,7,684,335,1019,389
0131-002,2015,2,13,8,1848,931,2779,1019
0131-002,2015,2,13,9,1590,1230,2820,2779
0131-002,2015,2,13,10,1083,1063,2146,2820
0131-002,2015,2,13,11,1028,1091,2119,2146
0131-002,2015,2,13,12,940,1065,2005,2119
0131-002,2015,2,13,13,763,1105,1868,2005
0131-002,2015,2,13,14,1012,1100,2112,1868
0131-002,2015,2,13,15,965,1284,2249,2112
0131-002,2015,2,13,16,1012,1190,2202,2249
0131-002,2015,2,13,17,1012,1224,2236,2202
0131-002,2015,2,13,18,1097,1539,2636,2236
0131-002,2015,2,13,19,1040,1427,2467,2636
0131-002,2015,2,13,20,708,1028,1736,2467
0131-002,2015,2,13,21,547,857,1404,1736
0131-002,2015,2,13,22,413,557,970,1404
0131-002,2015,2,13,23,395,370,765,970
0131-002,2015,2,13,24,372,244,616,765
0131-002,2015,2,14,1,331,161,492,616
0131-002,2015,2,14,2,189,113,302,492
0131-002,2015,2,14,3,36,103,139,302
0131-002,2015,2,14,4,40,93,133,139
0131-002,2015,2,14,5,50,123,173,133
0131-002,2015,2,14,6,122,160,282,173
0131-002,2015,2,14,7,372,297,669,282
0131-002,2015,2,14,8,863,611,1474,669
0131-002,2015,2,14,9,857,863,1720,1474
0131-002,2015,2,14,10,788,921,1709,1720
0131-002,2015,2,14,11,816,1018,1834,1709
0131-002,2015,2,14,12,804,1034,1838,1834
0131-002,2015,2,14,13,796,965,1761,1838
0131-002,2015,2,14,14,839,927,1766,1761
0131-002,2015,2,14,15,804,969,1773,1766
0131-002,2015,2,14,16,845,937,1782,1773
0131-002,2015,2,14,17,773,1036,1809,1782
0131-002,2015,2,14,18,858,1225,2083,1809
0131-002,2015,2,14,19,716,900,1616,2083
0131-002,2015,2,14,20,441,590,1031,1616
0131-002,2015,2,14,21,327,482,809,1031
0131-002,2015,2,14,22,333,348,681,809
0131-002,2015,2,14,23,167,268,435,681
0131-002,2015,2,14,24,122,202,324,435
0131-002,2015,2,15,1,75,144,219,324
0131-002,2015,2,15,2,38,122,160,219
0131-002,2015,2,15,3,26,81,107,160
0131-002,2015,2,15,4,14,70,84,107
0131-002,2015,2,15,5,26,70,96,84
0131-002,2015,2,15,6,61,110,171,96
0131-002,2015,2,15,7,152,168,320,171
0131-002,2015,2,15,8,301,280,581,320
0131-002,2015,2,15,9,309,433,742,581
0131-002,2015,2,15,10,301,554,855,742
0131-002,2015,2,15,11,362,652,1014,855
0131-002,2015,2,15,12,446,605,1051,1014
0131-002,2015,2,15,13,466,637,1103,1051
0131-002,2015,2,15,14,568,668,1236,1103
0131-002,2015,2,15,15,572,715,1287,1236
0131-002,2015,2,15,16,649,714,1363,1287
0131-002,2015,2,15,17,672,717,1389,1363
0131-002,2015,2,15,18,708,839,1547,1389
0131-002,2015,2,15,19,651,586,1237,1547
0131-002,2015,2,15,20,413,452,865,1237
0131-002,2015,2,15,21,297,348,645,865
0131-002,2015,2,15,22,293,298,591,645
0131-002,2015,2,15,23,150,220,370,591
0131-002,2015,2,15,24,75,156,231,370
0131-002,2015,2,16,1,50,92,142,231
0131-002,2015,2,16,2,42,61,103,142
0131-002,2015,2,16,3,18,61,79,103
0131-002,2015,2,16,4,12,59,71,79
0131-002,2015,2,16,5,20,71,91,71
0131-002,2015,2,16,6,122,125,247,91
0131-002,2015,2,16,7,535,301,836,247
0131-002,2015,2,16,8,1880,825,2705,836
0131-002,2015,2,16,9,1429,1077,2506,2705
0131-002,2015,2,16,10,796,982,1778,2506
0131-002,2015,2,16,11,802,1074,1876,1778
0131-002,2015,2,16,12,808,1090,1898,1876
0131-002,2015,2,16,13,769,912,1681,1898
0131-002,2015,2,16,14,786,1083,1869,1681
0131-002,2015,2,16,15,957,1184,2141,1869
0131-002,2015,2,16,16,949,1162,2111,2141
0131-002,2015,2,16,17,859,1127,1986,2111
0131-002,2015,2,16,18,792,1321,2113,1986
0131-002,2015,2,16,19,731,1153,1884,2113
0131-002,2015,2,16,20,584,901,1485,1884
0131-002,2015,2,16,21,456,864,1320,1485
0131-002,2015,2,16,22,317,564,881,1320
0131-002,2015,2,16,23,193,345,538,881
0131-002,2015,2,16,24,132,248,380,538
0131-002,2015,2,17,1,65,163,228,380
0131-002,2015,2,17,2,48,133,181,228
0131-002,2015,2,17,3,12,90,102,181
0131-002,2015,2,17,4,24,76,100,102
0131-002,2015,2,17,5,34,104,138,100
0131-002,2015,2,17,6,111,135,246,138
0131-002,2015,2,17,7,433,278,711,246
0131-002,2015,2,17,8,1730,756,2486,711
0131-002,2015,2,17,9,1332,1074,2406,2486
0131-002,2015,2,17,10,727,938,1665,2406
0131-002,2015,2,17,11,747,1100,1847,1665
0131-002,2015,2,17,12,784,994,1778,1847
0131-002,2015,2,17,13,696,1105,1801,1778
0131-002,2015,2,17,14,682,1281,1963,1801
0131-002,2015,2,17,15,763,1415,2178,1963
0131-002,2015,2,17,16,912,1501,2413,2178
0131-002,2015,2,17,17,773,1243,2016,2413
0131-002,2015,2,17,18,857,927,1784,2016
0131-002,2015,2,17,19,780,731,1511,1784
0131-002,2015,2,17,20,627,672,1299,1511
0131-002,2015,2,17,21,389,690,1079,1299
0131-002,2015,2,17,22,331,736,1067,1079
0131-002,2015,2,17,23,166,724,890,1067
0131-002,2015,2,17,24,116,569,685,890
0131-002,2015,2,18,1,46,461,507,685
0131-002,2015,2,18,2,28,359,387,507
0131-002,2015,2,18,3,34,372,406,387
0131-002,2015,2,18,4,24,310,334,406
0131-002,2015,2,18,5,30,628,658,334
0131-002,2015,2,18,6,26,1161,1187,658
0131-002,2015,2,18,7,59,1033,1092,1187
0131-002,2015,2,18,8,162,1321,1483,1092
0131-002,2015,2,18,9,236,1021,1257,1483
0131-002,2015,2,18,10,291,1020,1311,1257
0131-002,2015,2,18,11,547,1232,1779,1311
0131-002,2015,2,18,12,572,1198,1770,1779
0131-002,2015,2,18,13,562,1037,1599,1770
0131-002,2015,2,18,14,584,989,1573,1599
0131-002,2015,2,18,15,500,721,1221,1573
0131-002,2015,2,18,16,427,635,1062,1221
0131-002,2015,2,18,17,368,582,950,1062
0131-002,2015,2,18,18,325,533,858,950
0131-002,2015,2,18,19,191,400,591,858
0131-002,2015,2,18,20,134,274,408,591
0131-002,2015,2,18,21,107,249,356,408
0131-002,2015,2,18,22,99,191,290,356
0131-002,2015,2,18,23,79,146,225,290
0131-002,2015,2,18,24,52,106,158,225
0131-002,2015,2,19,1,34,71,105,158
0131-002,2015,2,19,2,6,51,57,105
0131-002,2015,2,19,3,14,35,49,57
0131-002,2015,2,19,4,6,28,34,49
0131-002,2015,2,19,5,16,35,51,34
0131-002,2015,2,19,6,26,74,100,51
0131-002,2015,2,19,7,331,168,499,100
0131-002,2015,2,19,8,802,354,1156,499
0131-002,2015,2,19,9,503,435,938,1156
0131-002,2015,2,19,10,201,536,737,938
0131-002,2015,2,19,11,439,841,1280,737
0131-002,2015,2,19,12,898,1202,2100,1280
0131-002,2015,2,19,13,1020,1468,2488,2100
0131-002,2015,2,19,14,1193,1471,2664,2488
0131-002,2015,2,19,15,1187,1768,2955,2664
0131-002,2015,2,19,16,1254,1840,3094,2955
0131-002,2015,2,19,17,1434,1667,3101,3094
0131-002,2015,2,19,18,1167,988,2155,3101
0131-002,2015,2,19,19,1085,735,1820,2155
0131-002,2015,2,19,20,1085,780,1865,1820
0131-002,2015,2,19,21,914,505,1419,1865
0131-002,2015,2,19,22,733,338,1071,1419
0131-002,2015,2,19,23,362,214,576,1071
0131-002,2015,2,19,24,209,128,337,576
0131-002,2015,2,20,1,140,87,227,337
0131-002,2015,2,20,2,101,66,167,227
0131-002,2015,2,20,3,40,33,73,167
0131-002,2015,2,20,4,14,36,50,73
0131-002,2015,2,20,5,22,40,62,50
0131-002,2015,2,20,6,22,59,81,62
0131-002,2015,2,20,7,57,72,129,81
0131-002,2015,2,20,8,177,109,286,129
0131-002,2015,2,20,9,116,196,312,286
0131-002,2015,2,20,10,167,317,484,312
0131-002,2015,2,20,11,429,451,880,484
0131-002,2015,2,20,12,853,563,1416,880
0131-002,2015,2,20,13,863,574,1437,1416
0131-002,2015,2,20,14,873,560,1433,1437
0131-002,2015,2,20,15,896,604,1500,1433
0131-002,2015,2,20,16,1268,586,1854,1500
0131-002,2015,2,20,17,1114,618,1732,1854
0131-002,2015,2,20,18,1052,589,1641,1732
0131-002,2015,2,20,19,1177,488,1665,1641
0131-002,2015,2,20,20,1348,407,1755,1665
0131-002,2015,2,20,21,1144,335,1479,1755
0131-002,2015,2,20,22,1002,254,1256,1479
0131-002,2015,2,20,23,1340,189,1529,1256
0131-002,2015,2,20,24,521,140,661,1529
0131-002,2015,2,21,1,523,96,619,661
0131-002,2015,2,21,2,226,69,295,619
0131-002,2015,2,21,3,67,60,127,295
0131-002,2015,2,21,4,46,54,100,127
0131-002,2015,2,21,5,18,83,101,100
0131-002,2015,2,21,6,34,92,126,101
0131-002,2015,2,21,7,81,114,195,126
0131-002,2015,2,21,8,193,208,401,195
0131-002,2015,2,21,9,272,357,629,401
0131-002,2015,2,21,10,295,439,734,629
0131-002,2015,2,21,11,466,497,963,734
0131-002,2015,2,21,12,578,536,1114,963
0131-002,2015,2,21,13,666,521,1187,1114
0131-002,2015,2,21,14,786,598,1384,1187
0131-002,2015,2,21,15,896,582,1478,1384
0131-002,2015,2,21,16,1181,615,1796,1478
0131-002,2015,2,21,17,1109,574,1683,1796
0131-002,2015,2,21,18,1164,582,1746,1683
0131-002,2015,2,21,19,1160,440,1600,1746
0131-002,2015,2,21,20,859,306,1165,1600
0131-002,2015,2,21,21,841,293,1134,1165
0131-002,2015,2,21,22,572,239,811,1134
0131-002,2015,2,21,23,297,167,464,811
0131-002,2015,2,21,24,122,141,263,464
0131-002,2015,2,22,1,65,100,165,263
0131-002,2015,2,22,2,46,78,124,165
0131-002,2015,2,22,3,32,44,76,124
0131-002,2015,2,22,4,20,39,59,76
0131-002,2015,2,22,5,8,50,58,59
0131-002,2015,2,22,6,36,54,90,58
0131-002,2015,2,22,7,54,95,149,90
0131-002,2015,2,22,8,177,152,329,149
0131-002,2015,2,22,9,177,265,442,329
0131-002,2015,2,22,10,230,339,569,442
0131-002,2015,2,22,11,250,381,631,569
0131-002,2015,2,22,12,307,430,737,631
0131-002,2015,2,22,13,374,508,882,737
0131-002,2015,2,22,14,452,511,963,882
0131-002,2015,2,22,15,590,611,1201,963
0131-002,2015,2,22,16,568,613,1181,1201
0131-002,2015,2,22,17,582,555,1137,1181
0131-002,2015,2,22,18,555,567,1122,1137
0131-002,2015,2,22,19,431,485,916,1122
0131-002,2015,2,22,20,405,363,768,916
0131-002,2015,2,22,21,303,367,670,768
0131-002,2015,2,22,22,250,261,511,670
0131-002,2015,2,22,23,219,169,388,511
0131-002,2015,2,22,24,97,133,230,388
0131-002,2015,2,23,1,77,70,147,230
0131-002,2015,2,23,2,36,54,90,147
0131-002,2015,2,23,3,24,46,70,90
0131-002,2015,2,23,4,20,41,61,70
0131-002,2015,2,23,5,36,73,109,61
0131-002,2015,2,23,6,166,154,320,109
0131-002,2015,2,23,7,666,327,993,320
0131-002,2015,2,23,8,2158,841,2999,993
0131-002,2015,2,23,9,1460,992,2452,2999
0131-002,2015,2,23,10,747,870,1617,2452
0131-002,2015,2,23,11,784,932,1716,1617
0131-002,2015,2,23,12,737,878,1615,1716
0131-002,2015,2,23,13,639,786,1425,1615
0131-002,2015,2,23,14,765,947,1712,1425
0131-002,2015,2,23,15,814,985,1799,1712
0131-002,2015,2,23,16,767,975,1742,1799
0131-002,2015,2,23,17,755,973,1728,1742
0131-002,2015,2,23,18,830,1163,1993,1728
0131-002,2015,2,23,19,786,1110,1896,1993
0131-002,2015,2,23,20,1020,808,1828,1896
0131-002,2015,2,23,21,989,769,1758,1828
0131-002,2015,2,23,22,853,521,1374,1758
0131-002,2015,2,23,23,586,314,900,1374
0131-002,2015,2,23,24,444,194,638,900
0131-002,2015,2,24,1,248,137,385,638
0131-002,2015,2,24,2,221,99,320,385
0131-002,2015,2,24,3,140,73,213,320
0131-002,2015,2,24,4,130,85,215,213
0131-002,2015,2,24,5,187,105,292,215
0131-002,2015,2,24,6,533,148,681,292
0131-002,2015,2,24,7,1134,351,1485,681
0131-002,2015,2,24,8,2902,858,3760,1485
0131-002,2015,2,24,9,2132,1111,3243,3760
0131-002,2015,2,24,10,926,1012,1938,3243
0131-002,2015,2,24,11,944,1001,1945,1938
0131-002,2015,2,24,12,859,935,1794,1945
0131-002,2015,2,24,13,680,899,1579,1794
0131-002,2015,2,24,14,822,973,1795,1579
0131-002,2015,2,24,15,963,1103,2066,1795
0131-002,2015,2,24,16,928,1072,2000,2066
0131-002,2015,2,24,17,840,1004,1844,2000
0131-002,2015,2,24,18,801,1228,2029,1844
0131-002,2015,2,24,19,835,1036,1871,2029
0131-002,2015,2,24,20,577,829,1406,1871
0131-002,2015,2,24,21,436,798,1234,1406
0131-002,2015,2,24,22,326,532,858,1234
0131-002,2015,2,24,23,207,376,583,858
0131-002,2015,2,24,24,115,216,331,583
0131-002,2015,2,25,1,274,143,417,331
0131-002,2015,2,25,2,195,103,298,417
0131-002,2015,2,25,3,111,71,182,298
0131-002,2015,2,25,4,167,77,244,182
0131-002,2015,2,25,5,179,103,282,244
0131-002,2015,2,25,6,482,182,664,282
0131-002,2015,2,25,7,1118,347,1465,664
0131-002,2015,2,25,8,2690,839,3529,1465
0131-002,2015,2,25,9,2344,1097,3441,3529
0131-002,2015,2,25,10,951,1013,1964,3441
0131-002,2015,2,25,11,865,974,1839,1964
0131-002,2015,2,25,12,869,920,1789,1839
0131-002,2015,2,25,13,708,812,1520,1789
0131-002,2015,2,25,14,816,887,1703,1520
0131-002,2015,2,25,15,910,1070,1980,1703
0131-002,2015,2,25,16,953,993,1946,1980
0131-002,2015,2,25,17,904,1052,1956,1946
0131-002,2015,2,25,18,906,1205,2111,1956
0131-002,2015,2,25,19,892,1135,2027,2111
0131-002,2015,2,25,20,592,836,1428,2027
0131-002,2015,2,25,21,462,735,1197,1428
0131-002,2015,2,25,22,354,569,923,1197
0131-002,2015,2,25,23,238,351,589,923
0131-002,2015,2,25,24,118,232,350,589
0131-002,2015,2,26,1,69,163,232,350
0131-002,2015,2,26,2,30,103,133,232
0131-002,2015,2,26,3,30,60,90,133
0131-002,2015,2,26,4,30,80,110,90
0131-002,2015,2,26,5,26,109,135,110
0131-002,2015,2,26,6,136,173,309,135
0131-002,2015,2,26,7,590,314,904,309
0131-002,2015,2,26,8,1825,890,2715,904
0131-002,2015,2,26,9,1521,1202,2723,2715
0131-002,2015,2,26,10,922,952,1874,2723
0131-002,2015,2,26,11,900,1033,1933,1874
0131-002,2015,2,26,12,883,914,1797,1933
0131-002,2015,2,26,13,621,900,1521,1797
0131-002,2015,2,26,14,855,869,1724,1521
0131-002,2015,2,26,15,918,1109,2027,1724
0131-002,2015,2,26,16,849,1089,1938,2027
0131-002,2015,2,26,17,818,1098,1916,1938
0131-002,2015,2,26,18,861,1185,2046,1916
0131-002,2015,2,26,19,882,1075,1957,2046
0131-002,2015,2,26,20,591,828,1419,1957
0131-002,2015,2,26,21,456,757,1213,1419
0131-002,2015,2,26,22,411,534,945,1213
0131-002,2015,2,26,23,244,378,622,945
0131-002,2015,2,26,24,133,242,375,622
0131-002,2015,2,27,1,287,140,427,375
0131-002,2015,2,27,2,217,97,314,427
0131-002,2015,2,27,3,128,83,211,314
0131-002,2015,2,27,4,150,72,222,211
0131-002,2015,2,27,5,187,102,289,222
0131-002,2015,2,27,6,450,160,610,289
0131-002,2015,2,27,7,1268,328,1596,610
0131-002,2015,2,27,8,3052,860,3912,1596
0131-002,2015,2,27,9,2283,1144,3427,3912
0131-002,2015,2,27,10,837,948,1785,3427
0131-002,2015,2,27,11,830,952,1782,1785
0131-002,2015,2,27,12,826,907,1733,1782
0131-002,2015,2,27,13,684,869,1553,1733
0131-002,2015,2,27,14,757,884,1641,1553
0131-002,2015,2,27,15,965,1045,2010,1641
0131-002,2015,2,27,16,806,993,1799,2010
0131-002,2015,2,27,17,824,1020,1844,1799
0131-002,2015,2,27,18,1026,1325,2351,1844
0131-002,2015,2,27,19,1039,1215,2254,2351
0131-002,2015,2,27,20,706,986,1692,2254
0131-002,2015,2,27,21,491,801,1292,1692
0131-002,2015,2,27,22,388,535,923,1292
0131-002,2015,2,27,23,334,360,694,923
0131-002,2015,2,27,24,261,241,502,694
0131-002,2015,2,28,1,380,178,558,502
0131-002,2015,2,28,2,221,122,343,558
0131-002,2015,2,28,3,152,90,242,343
0131-002,2015,2,28,4,156,99,255,242
0131-002,2015,2,28,5,226,112,338,255
0131-002,2015,2,28,6,425,168,593,338
0131-002,2015,2,28,7,806,275,1081,593
0131-002,2015,2,28,8,1596,578,2174,1081
0131-002,2015,2,28,9,1409,792,2201,2174
0131-002,2015,2,28,10,778,791,1569,2201
0131-002,2015,2,28,11,733,863,1596,1569
0131-002,2015,2,28,12,798,886,1684,1596
0131-002,2015,2,28,13,802,900,1702,1684
0131-002,2015,2,28,14,841,950,1791,1702
0131-002,2015,2,28,15,871,891,1762,1791
0131-002,2015,2,28,16,910,914,1824,1762
0131-002,2015,2,28,17,1093,986,2079,1824
0131-002,2015,2,28,18,1181,1169,2350,2079
0131-002,2015,2,28,19,1130,916,2046,2350
0131-002,2015,2,28,20,890,542,1432,2046
0131-002,2015,2,28,21,541,480,1021,1432
0131-002,2015,2,28,22,399,373,772,1021
0131-002,2015,2,28,23,195,235,430,772
0131-002,2015,2,28,24,111,178,289,430
0131-002,2015,3,1,1,62,134,196,289
0131-002,2015,3,1,2,38,80,118,196
0131-002,2015,3,1,3,22,81,103,118
0131-002,2015,3,1,4,36,63,99,103
0131-002,2015,3,1,5,21,50,71,99
0131-002,2015,3,1,6,88,80,168,71
0131-002,2015,3,1,7,162,121,283,168
0131-002,2015,3,1,8,342,234,576,283
0131-002,2015,3,1,9,364,366,730,576
0131-002,2015,3,1,10,337,465,802,730
0131-002,2015,3,1,11,394,615,1009,802
0131-002,2015,3,1,12,444,609,1053,1009
0131-002,2015,3,1,13,506,579,1085,1053
0131-002,2015,3,1,14,562,682,1244,1085
0131-002,2015,3,1,15,640,652,1292,1244
0131-002,2015,3,1,16,793,741,1534,1292
0131-002,2015,3,1,17,890,735,1625,1534
0131-002,2015,3,1,18,849,714,1563,1625
0131-002,2015,3,1,19,816,621,1437,1563
0131-002,2015,3,1,20,514,413,927,1437
0131-002,2015,3,1,21,364,362,726,927
0131-002,2015,3,1,22,305,298,603,726
0131-002,2015,3,1,23,181,222,403,603
0131-002,2015,3,1,24,106,110,216,403
0131-002,2015,3,2,1,249,84,333,216
0131-002,2015,3,2,2,139,58,197,333
0131-002,2015,3,2,3,105,40,145,197
0131-002,2015,3,2,4,103,54,157,145
0131-002,2015,3,2,5,141,81,222,157
0131-002,2015,3,2,6,164,175,339,222
0131-002,2015,3,2,7,502,380,882,339
0131-002,2015,3,2,8,1340,985,2325,882
0131-002,2015,3,2,9,1060,1112,2172,2325
0131-002,2015,3,2,10,772,882,1654,2172
0131-002,2015,3,2,11,793,935,1728,1654
0131-002,2015,3,2,12,772,899,1671,1728
0131-002,2015,3,2,13,704,823,1527,1671
0131-002,2015,3,2,14,776,933,1709,1527
0131-002,2015,3,2,15,886,1084,1970,1709
0131-002,2015,3,2,16,858,1018,1876,1970
0131-002,2015,3,2,17,807,1002,1809,1876
0131-002,2015,3,2,18,811,1174,1985,1809
0131-002,2015,3,2,19,758,1064,1822,1985
0131-002,2015,3,2,20,802,823,1625,1822
0131-002,2015,3,2,21,722,758,1480,1625
0131-002,2015,3,2,22,585,515,1100,1480
0131-002,2015,3,2,23,390,320,710,1100
0131-002,2015,3,2,24,288,184,472,710
0131-002,2015,3,3,1,234,113,347,472
0131-002,2015,3,3,2,154,83,237,347
0131-002,2015,3,3,3,110,63,173,237
0131-002,2015,3,3,4,112,78,190,173
0131-002,2015,3,3,5,147,76,223,190
0131-002,2015,3,3,6,162,148,310,223
0131-002,2015,3,3,7,424,313,737,310
0131-002,2015,3,3,8,1204,881,2085,737
0131-002,2015,3,3,9,916,1023,1939,2085
0131-002,2015,3,3,10,923,1032,1955,1939
0131-002,2015,3,3,11,898,960,1858,1955
0131-002,2015,3,3,12,878,877,1755,1858
0131-002,2015,3,3,13,681,734,1415,1755
0131-002,2015,3,3,14,838,917,1755,1415
0131-002,2015,3,3,15,955,1028,1983,1755
0131-002,2015,3,3,16,902,909,1811,1983
0131-002,2015,3,3,17,821,948,1769,1811
0131-002,2015,3,3,18,808,1042,1850,1769
0131-002,2015,3,3,19,834,1029,1863,1850
0131-002,2015,3,3,20,578,897,1475,1863
0131-002,2015,3,3,21,450,764,1214,1475
0131-002,2015,3,3,22,332,509,841,1214
0131-002,2015,3,3,23,207,313,520,841
0131-002,2015,3,3,24,116,195,311,520
0131-002,2015,3,4,1,75,128,203,311
0131-002,2015,3,4,2,32,78,110,203
0131-002,2015,3,4,3,26,67,93,110
0131-002,2015,3,4,4,24,69,93,93
0131-002,2015,3,4,5,22,92,114,93
0131-002,2015,3,4,6,114,151,265,114
0131-002,2015,3,4,7,545,332,877,265
0131-002,2015,3,4,8,1788,873,2661,877
0131-002,2015,3,4,9,1410,1152,2562,2661
0131-002,2015,3,4,10,850,952,1802,2562
0131-002,2015,3,4,11,794,961,1755,1802
0131-002,2015,3,4,12,730,944,1674,1755
0131-002,2015,3,4,13,554,807,1361,1674
0131-002,2015,3,4,14,757,906,1663,1361
0131-002,2015,3,4,15,774,1004,1778,1663
0131-002,2015,3,4,16,688,928,1616,1778
0131-002,2015,3,4,17,688,966,1654,1616
0131-002,2015,3,4,18,785,1249,2034,1654
0131-002,2015,3,4,19,854,1125,1979,2034
0131-002,2015,3,4,20,578,818,1396,1979
0131-002,2015,3,4,21,448,732,1180,1396
0131-002,2015,3,4,22,354,509,863,1180
0131-002,2015,3,4,23,237,359,596,863
0131-002,2015,3,4,24,130,203,333,596
0131-002,2015,3,5,1,242,146,388,333
0131-002,2015,3,5,2,160,105,265,388
0131-002,2015,3,5,3,119,64,183,265
0131-002,2015,3,5,4,114,59,173,183
0131-002,2015,3,5,5,172,98,270,173
0131-002,2015,3,5,6,450,156,606,270
0131-002,2015,3,5,7,1154,373,1527,606
0131-002,2015,3,5,8,2914,901,3815,1527
0131-002,2015,3,5,9,2283,1124,3407,3815
0131-002,2015,3,5,10,949,925,1874,3407
0131-002,2015,3,5,11,849,964,1813,1874
0131-002,2015,3,5,12,775,931,1706,1813
0131-002,2015,3,5,13,649,803,1452,1706
0131-002,2015,3,5,14,741,882,1623,1452
0131-002,2015,3,5,15,788,1020,1808,1623
0131-002,2015,3,5,16,730,1021,1751,1808
0131-002,2015,3,5,17,675,973,1648,1751
0131-002,2015,3,5,18,847,1242,2089,1648
0131-002,2015,3,5,19,743,1066,1809,2089
0131-002,2015,3,5,20,562,850,1412,1809
0131-002,2015,3,5,21,393,783,1176,1412
0131-002,2015,3,5,22,317,548,865,1176
0131-002,2015,3,5,23,276,351,627,865
0131-002,2015,3,5,24,207,202,409,627
0131-002,2015,3,6,1,178,156,334,409
0131-002,2015,3,6,2,79,102,181,334
0131-002,2015,3,6,3,97,64,161,181
0131-002,2015,3,6,4,22,84,106,161
0131-002,2015,3,6,5,116,113,229,106
0131-002,2015,3,6,6,459,170,629,229
0131-002,2015,3,6,7,808,326,1134,629
0131-002,2015,3,6,8,1863,904,2767,1134
0131-002,2015,3,6,9,1388,1193,2581,2767
0131-002,2015,3,6,10,966,1024,1990,2581
0131-002,2015,3,6,11,821,954,1775,1990
0131-002,2015,3,6,12,730,964,1694,1775
0131-002,2015,3,6,13,593,866,1459,1694
0131-002,2015,3,6,14,788,949,1737,1459
0131-002,2015,3,6,15,843,974,1817,1737
0131-002,2015,3,6,16,803,1138,1941,1817
0131-002,2015,3,6,17,799,1075,1874,1941
0131-002,2015,3,6,18,920,1207,2127,1874
0131-002,2015,3,6,19,936,1219,2155,2127
0131-002,2015,3,6,20,737,976,1713,2155
0131-002,2015,3,6,21,461,706,1167,1713
0131-002,2015,3,6,22,353,515,868,1167
0131-002,2015,3,6,23,287,370,657,868
0131-002,2015,3,6,24,174,285,459,657
0131-002,2015,3,7,1,136,182,318,459
0131-002,2015,3,7,2,114,120,234,318
0131-002,2015,3,7,3,32,78,110,234
0131-002,2015,3,7,4,39,101,140,110
0131-002,2015,3,7,5,32,110,142,140
0131-002,2015,3,7,6,97,164,261,142
0131-002,2015,3,7,7,496,288,784,261
0131-002,2015,3,7,8,962,570,1532,784
0131-002,2015,3,7,9,746,844,1590,1532
0131-002,2015,3,7,10,746,836,1582,1590
0131-002,2015,3,7,11,726,914,1640,1582
0131-002,2015,3,7,12,770,899,1669,1640
0131-002,2015,3,7,13,690,846,1536,1669
0131-002,2015,3,7,14,697,876,1573,1536
0131-002,2015,3,7,15,708,877,1585,1573
0131-002,2015,3,7,16,799,897,1696,1585
0131-002,2015,3,7,17,744,998,1742,1696
0131-002,2015,3,7,18,962,1110,2072,1742
0131-002,2015,3,7,19,913,824,1737,2072
0131-002,2015,3,7,20,556,557,1113,1737
0131-002,2015,3,7,21,335,444,779,1113
0131-002,2015,3,7,22,284,350,634,779
0131-002,2015,3,7,23,211,269,480,634
0131-002,2015,3,7,24,213,188,401,480
0131-002,2015,3,8,1,143,123,266,401
0131-002,2015,3,8,2,119,88,207,266
0131-002,2015,3,8,3,30,61,91,207
0131-002,2015,3,8,4,13,48,61,91
0131-002,2015,3,8,5,15,58,73,61
0131-002,2015,3,8,6,59,77,136,73
0131-002,2015,3,8,7,196,129,325,136
0131-002,2015,3,8,8,315,297,612,325
0131-002,2015,3,8,9,448,441,889,612
0131-002,2015,3,8,10,293,490,783,889
0131-002,2015,3,8,11,381,602,983,783
0131-002,2015,3,8,12,459,613,1072,983
0131-002,2015,3,8,13,435,589,1024,1072
0131-002,2015,3,8,14,521,599,1120,1024
0131-002,2015,3,8,15,585,682,1267,1120
0131-002,2015,3,8,16,658,686,1344,1267
0131-002,2015,3,8,17,704,764,1468,1344
0131-002,2015,3,8,18,646,809,1455,1468
0131-002,2015,3,8,19,666,600,1266,1455
0131-002,2015,3,8,20,445,446,891,1266
0131-002,2015,3,8,21,342,390,732,891
0131-002,2015,3,8,22,311,272,583,732
0131-002,2015,3,8,23,181,209,390,583
0131-002,2015,3,8,24,117,120,237,390
0131-002,2015,3,9,1,54,88,142,237
0131-002,2015,3,9,2,35,55,90,142
0131-002,2015,3,9,3,8,38,46,90
0131-002,2015,3,9,4,17,41,58,46
0131-002,2015,3,9,5,39,73,112,58
0131-002,2015,3,9,6,205,176,381,112
0131-002,2015,3,9,7,772,369,1141,381
0131-002,2015,3,9,8,2051,867,2918,1141
0131-002,2015,3,9,9,1501,1050,2551,2918
0131-002,2015,3,9,10,845,843,1688,2551
0131-002,2015,3,9,11,785,862,1647,1688
0131-002,2015,3,9,12,755,859,1614,1647
0131-002,2015,3,9,13,633,752,1385,1614
0131-002,2015,3,9,14,805,857,1662,1385
0131-002,2015,3,9,15,799,1009,1808,1662
0131-002,2015,3,9,16,748,950,1698,1808
0131-002,2015,3,9,17,757,946,1703,1698
0131-002,2015,3,9,18,737,1049,1786,1703
0131-002,2015,3,9,19,748,1029,1777,1786
0131-002,2015,3,9,20,843,880,1723,1777
0131-002,2015,3,9,21,869,763,1632,1723
0131-002,2015,3,9,22,781,515,1296,1632
0131-002,2015,3,9,23,538,334,872,1296
0131-002,2015,3,9,24,329,193,522,872
0131-002,2015,3,10,1,234,149,383,522
0131-002,2015,3,10,2,149,92,241,383
0131-002,2015,3,10,3,123,63,186,241
0131-002,2015,3,10,4,121,62,183,186
0131-002,2015,3,10,5,167,42,209,183
0131-002,2015,3,10,6,348,47,395,209
0131-002,2015,3,10,7,779,126,905,395
0131-002,2015,3,10,8,2053,460,2513,905
0131-002,2015,3,10,9,1524,631,2155,2513
0131-002,2015,3,10,10,924,849,1773,2155
0131-002,2015,3,10,11,921,902,1823,1773
0131-002,2015,3,10,12,868,853,1721,1823
0131-002,2015,3,10,13,680,783,1463,1721
0131-002,2015,3,10,14,830,876,1706,1463
0131-002,2015,3,10,15,959,912,1871,1706
0131-002,2015,3,10,16,915,943,1858,1871
0131-002,2015,3,10,17,830,914,1744,1858
0131-002,2015,3,10,18,804,1078,1882,1744
0131-002,2015,3,10,19,834,1094,1928,1882
0131-002,2015,3,10,20,578,738,1316,1928
0131-002,2015,3,10,21,443,759,1202,1316
0131-002,2015,3,10,22,329,522,851,1202
0131-002,2015,3,10,23,207,345,552,851
0131-002,2015,3,10,24,116,183,299,552
0131-002,2015,3,11,1,223,118,341,299
0131-002,2015,3,11,2,156,89,245,341
0131-002,2015,3,11,3,145,76,221,245
0131-002,2015,3,11,4,121,58,179,221
0131-002,2015,3,11,5,178,93,271,179
0131-002,2015,3,11,6,298,161,459,271
0131-002,2015,3,11,7,832,285,1117,459
0131-002,2015,3,11,8,2239,759,2998,1117
0131-002,2015,3,11,9,1877,977,2854,2998
0131-002,2015,3,11,10,900,911,1811,2854
0131-002,2015,3,11,11,830,854,1684,1811
0131-002,2015,3,11,12,752,844,1596,1684
0131-002,2015,3,11,13,633,716,1349,1596
0131-002,2015,3,11,14,759,828,1587,1349
0131-002,2015,3,11,15,913,916,1829,1587
0131-002,2015,3,11,16,820,952,1772,1829
0131-002,2015,3,11,17,796,999,1795,1772
0131-002,2015,3,11,18,846,1129,1975,1795
0131-002,2015,3,11,19,873,1031,1904,1975
0131-002,2015,3,11,20,585,787,1372,1904
0131-002,2015,3,11,21,455,672,1127,1372
0131-002,2015,3,11,22,354,489,843,1127
0131-002,2015,3,11,23,238,344,582,843
0131-002,2015,3,11,24,124,223,347,582
0131-002,2015,3,12,1,231,118,349,347
0131-002,2015,3,12,2,68,95,163,349
0131-002,2015,3,12,3,105,75,180,163
0131-002,2015,3,12,4,147,63,210,180
0131-002,2015,3,12,5,141,106,247,210
0131-002,2015,3,12,6,293,86,379,247
0131-002,2015,3,12,7,872,126,998,379
0131-002,2015,3,12,8,2370,455,2825,998
0131-002,2015,3,12,9,1902,760,2662,2825
0131-002,2015,3,12,10,936,816,1752,2662
0131-002,2015,3,12,11,883,925,1808,1752
0131-002,2015,3,12,12,761,835,1596,1808
0131-002,2015,3,12,13,658,778,1436,1596
0131-002,2015,3,12,14,755,839,1594,1436
0131-002,2015,3,12,15,684,946,1630,1594
0131-002,2015,3,12,16,741,959,1700,1630
0131-002,2015,3,12,17,715,959,1674,1700
0131-002,2015,3,12,18,812,1133,1945,1674
0131-002,2015,3,12,19,832,1087,1919,1945
0131-002,2015,3,12,20,538,816,1354,1919
0131-002,2015,3,12,21,434,734,1168,1354
0131-002,2015,3,12,22,353,483,836,1168
0131-002,2015,3,12,23,220,333,553,836
0131-002,2015,3,12,24,107,238,345,553
0131-002,2015,3,13,1,83,171,254,345
0131-002,2015,3,13,2,52,109,161,254
0131-002,2015,3,13,3,26,72,98,161
0131-002,2015,3,13,4,26,88,114,98
0131-002,2015,3,13,5,35,94,129,114
0131-002,2015,3,13,6,116,145,261,129
0131-002,2015,3,13,7,562,323,885,261
0131-002,2015,3,13,8,1717,876,2593,885
0131-002,2015,3,13,9,1421,1084,2505,2593
0131-002,2015,3,13,10,860,813,1673,2505
0131-002,2015,3,13,11,786,899,1685,1673
0131-002,2015,3,13,12,860,871,1731,1685
0131-002,2015,3,13,13,637,738,1375,1731
0131-002,2015,3,13,14,825,881,1706,1375
0131-002,2015,3,13,15,830,999,1829,1706
0131-002,2015,3,13,16,812,902,1714,1829
0131-002,2015,3,13,17,710,908,1618,1714
0131-002,2015,3,13,18,867,1146,2013,1618
0131-002,2015,3,13,19,997,1238,2235,2013
0131-002,2015,3,13,20,688,1003,1691,2235
0131-002,2015,3,13,21,465,785,1250,1691
0131-002,2015,3,13,22,370,538,908,1250
0131-002,2015,3,13,23,196,331,527,908
0131-002,2015,3,13,24,134,215,349,527
0131-002,2015,3,14,1,92,182,274,349
0131-002,2015,3,14,2,35,119,154,274
0131-002,2015,3,14,3,33,85,118,154
0131-002,2015,3,14,4,28,69,97,118
0131-002,2015,3,14,5,43,102,145,97
0131-002,2015,3,14,6,123,171,294,145
0131-002,2015,3,14,7,381,262,643,294
0131-002,2015,3,14,8,849,619,1468,643
0131-002,2015,3,14,9,763,806,1569,1468
0131-002,2015,3,14,10,713,871,1584,1569
0131-002,2015,3,14,11,688,945,1633,1584
0131-002,2015,3,14,12,741,883,1624,1633
0131-002,2015,3,14,13,759,881,1640,1624
0131-002,2015,3,14,14,697,848,1545,1640
0131-002,2015,3,14,15,704,867,1571,1545
0131-002,2015,3,14,16,728,889,1617,1571
0131-002,2015,3,14,17,852,1002,1854,1617
0131-002,2015,3,14,18,939,1144,2083,1854
0131-002,2015,3,14,19,942,878,1820,2083
0131-002,2015,3,14,20,668,537,1205,1820
0131-002,2015,3,14,21,403,436,839,1205
0131-002,2015,3,14,22,326,363,689,839
0131-002,2015,3,14,23,180,256,436,689
0131-002,2015,3,14,24,136,182,318,436
0131-002,2015,3,15,1,74,125,199,318
0131-002,2015,3,15,2,59,83,142,199
0131-002,2015,3,15,3,17,68,85,142
0131-002,2015,3,15,4,17,44,61,85
0131-002,2015,3,15,5,35,49,84,61
0131-002,2015,3,15,6,48,91,139,84
0131-002,2015,3,15,7,149,144,293,139
0131-002,2015,3,15,8,222,298,520,293
0131-002,2015,3,15,9,247,428,675,520
0131-002,2015,3,15,10,322,486,808,675
0131-002,2015,3,15,11,342,649,991,808
0131-002,2015,3,15,12,441,615,1056,991
0131-002,2015,3,15,13,415,630,1045,1056
0131-002,2015,3,15,14,532,592,1124,1045
0131-002,2015,3,15,15,598,694,1292,1124
0131-002,2015,3,15,16,638,710,1348,1292
0131-002,2015,3,15,17,732,762,1494,1348
0131-002,2015,3,15,18,810,850,1660,1494
0131-002,2015,3,15,19,803,648,1451,1660
0131-002,2015,3,15,20,658,496,1154,1451
0131-002,2015,3,15,21,439,422,861,1154
0131-002,2015,3,15,22,322,284,606,861
0131-002,2015,3,15,23,198,208,406,606
0131-002,2015,3,15,24,116,124,240,406
0131-002,2015,3,16,1,55,104,159,240
0131-002,2015,3,16,2,39,64,103,159
0131-002,2015,3,16,3,19,54,73,103
0131-002,2015,3,16,4,30,56,86,73
0131-002,2015,3,16,5,21,71,92,86
0131-002,2015,3,16,6,198,172,370,92
0131-002,2015,3,16,7,827,380,1207,370
0131-002,2015,3,16,8,2006,895,2901,1207
0131-002,2015,3,16,9,1554,1021,2575,2901
0131-002,2015,3,16,10,892,921,1813,2575
0131-002,2015,3,16,11,825,932,1757,1813
0131-002,2015,3,16,12,785,869,1654,1757
0131-002,2015,3,16,13,593,753,1346,1654
0131-002,2015,3,16,14,880,862,1742,1346
0131-002,2015,3,16,15,898,976,1874,1742
0131-002,2015,3,16,16,788,975,1763,1874
0131-002,2015,3,16,17,838,976,1814,1763
0131-002,2015,3,16,18,779,1172,1951,1814
0131-002,2015,3,16,19,797,1117,1914,1951
0131-002,2015,3,16,20,593,841,1434,1914
0131-002,2015,3,16,21,388,758,1146,1434
0131-002,2015,3,16,22,320,513,833,1146
0131-002,2015,3,16,23,198,354,552,833
0131-002,2015,3,16,24,127,209,336,552
0131-002,2015,3,17,1,70,132,202,336
0131-002,2015,3,17,2,32,95,127,202
0131-002,2015,3,17,3,28,71,99,127
0131-002,2015,3,17,4,33,64,97,99
0131-002,2015,3,17,5,33,101,134,97
0131-002,2015,3,17,6,154,151,305,134
0131-002,2015,3,17,7,710,376,1086,305
0131-002,2015,3,17,8,1868,834,2702,1086
0131-002,2015,3,17,9,1481,1017,2498,2702
0131-002,2015,3,17,10,900,964,1864,2498
0131-002,2015,3,17,11,905,880,1785,1864
0131-002,2015,3,17,12,728,872,1600,1785
0131-002,2015,3,17,13,604,780,1384,1600
0131-002,2015,3,17,14,812,885,1697,1384
0131-002,2015,3,17,15,849,952,1801,1697
0131-002,2015,3,17,16,883,916,1799,1801
0131-002,2015,3,17,17,783,976,1759,1799
0131-002,2015,3,17,18,839,1225,2064,1759
0131-002,2015,3,17,19,775,1085,1860,2064
0131-002,2015,3,17,20,569,855,1424,1860
0131-002,2015,3,17,21,425,745,1170,1424
0131-002,2015,3,17,22,322,537,859,1170
0131-002,2015,3,17,23,187,324,511,859
0131-002,2015,3,17,24,127,206,333,511
0131-002,2015,3,18,1,52,137,189,333
0131-002,2015,3,18,2,50,90,140,189
0131-002,2015,3,18,3,33,91,124,140
0131-002,2015,3,18,4,28,62,90,124
0131-002,2015,3,18,5,33,85,118,90
0131-002,2015,3,18,6,121,160,281,118
0131-002,2015,3,18,7,541,320,861,281
0131-002,2015,3,18,8,1625,824,2449,861
0131-002,2015,3,18,9,1357,1105,2462,2449
0131-002,2015,3,18,10,875,997,1872,2462
0131-002,2015,3,18,11,812,966,1778,1872
0131-002,2015,3,18,12,741,936,1677,1778
0131-002,2015,3,18,13,594,859,1453,1677
0131-002,2015,3,18,14,758,952,1710,1453
0131-002,2015,3,18,15,844,1020,1864,1710
0131-002,2015,3,18,16,754,1024,1778,1864
0131-002,2015,3,18,17,742,1046,1788,1778
0131-002,2015,3,18,18,816,1219,2035,1788
0131-002,2015,3,18,19,864,1186,2050,2035
0131-002,2015,3,18,20,582,874,1456,2050
0131-002,2015,3,18,21,452,686,1138,1456
0131-002,2015,3,18,22,354,514,868,1138
0131-002,2015,3,18,23,238,338,576,868
0131-002,2015,3,18,24,119,201,320,576
0131-002,2015,3,19,1,75,124,199,320
0131-002,2015,3,19,2,44,117,161,199
0131-002,2015,3,19,3,24,73,97,161
0131-002,2015,3,19,4,22,79,101,97
0131-002,2015,3,19,5,33,81,114,101
0131-002,2015,3,19,6,112,159,271,114
0131-002,2015,3,19,7,604,357,961,271
0131-002,2015,3,19,8,1766,869,2635,961
0131-002,2015,3,19,9,1441,1056,2497,2635
0131-002,2015,3,19,10,828,895,1723,2497
0131-002,2015,3,19,11,852,949,1801,1723
0131-002,2015,3,19,12,838,931,1769,1801
0131-002,2015,3,19,13,627,817,1444,1769
0131-002,2015,3,19,14,748,937,1685,1444
0131-002,2015,3,19,15,834,1129,1963,1685
0131-002,2015,3,19,16,821,981,1802,1963
0131-002,2015,3,19,17,699,839,1538,1802
0131-002,2015,3,19,18,827,1215,2042,1538
0131-002,2015,3,19,19,792,1121,1913,2042
0131-002,2015,3,19,20,563,855,1418,1913
0131-002,2015,3,19,21,434,772,1206,1418
0131-002,2015,3,19,22,384,498,882,1206
0131-002,2015,3,19,23,211,386,597,882
0131-002,2015,3,19,24,143,232,375,597
0131-002,2015,3,20,1,81,168,249,375
0131-002,2015,3,20,2,50,79,129,249
0131-002,2015,3,20,3,21,80,101,129
0131-002,2015,3,20,4,35,86,121,101
0131-002,2015,3,20,5,26,100,126,121
0131-002,2015,3,20,6,136,170,306,126
0131-002,2015,3,20,7,631,341,972,306
0131-002,2015,3,20,8,1854,840,2694,972
0131-002,2015,3,20,9,1554,1045,2599,2694
0131-002,2015,3,20,10,887,963,1850,2599
0131-002,2015,3,20,11,911,958,1869,1850
0131-002,2015,3,20,12,819,940,1759,1869
0131-002,2015,3,20,13,640,858,1498,1759
0131-002,2015,3,20,14,854,814,1668,1498
0131-002,2015,3,20,15,774,704,1478,1668
0131-002,2015,3,20,16,635,645,1280,1478
0131-002,2015,3,20,17,849,799,1648,1280
0131-002,2015,3,20,18,914,1044,1958,1648
0131-002,2015,3,20,19,909,881,1790,1958
0131-002,2015,3,20,20,743,702,1445,1790
0131-002,2015,3,20,21,512,726,1238,1445
0131-002,2015,3,20,22,426,587,1013,1238
0131-002,2015,3,20,23,267,370,637,1013
0131-002,2015,3,20,24,134,182,316,637
0131-002,2015,3,21,1,92,198,290,316
0131-002,2015,3,21,2,63,122,185,290
0131-002,2015,3,21,3,39,77,116,185
0131-002,2015,3,21,4,21,92,113,116
0131-002,2015,3,21,5,52,92,144,113
0131-002,2015,3,21,6,112,154,266,144
0131-002,2015,3,21,7,390,325,715,266
0131-002,2015,3,21,8,797,614,1411,715
0131-002,2015,3,21,9,794,865,1659,1411
0131-002,2015,3,21,10,666,881,1547,1659
0131-002,2015,3,21,11,701,783,1484,1547
0131-002,2015,3,21,12,775,937,1712,1484
0131-002,2015,3,21,13,702,846,1548,1712
0131-002,2015,3,21,14,774,789,1563,1548
0131-002,2015,3,21,15,710,829,1539,1563
0131-002,2015,3,21,16,763,918,1681,1539
0131-002,2015,3,21,17,860,810,1670,1681
0131-002,2015,3,21,18,949,1125,2074,1670
0131-002,2015,3,21,19,852,779,1631,2074
0131-002,2015,3,21,20,589,532,1121,1631
0131-002,2015,3,21,21,361,447,808,1121
0131-002,2015,3,21,22,298,352,650,808
0131-002,2015,3,21,23,185,256,441,650
0131-002,2015,3,21,24,154,183,337,441
0131-002,2015,3,22,1,75,136,211,337
0131-002,2015,3,22,2,39,103,142,211
0131-002,2015,3,22,3,28,62,90,142
0131-002,2015,3,22,4,19,76,95,90
0131-002,2015,3,22,5,22,76,98,95
0131-002,2015,3,22,6,64,87,151,98
0131-002,2015,3,22,7,160,122,282,151
0131-002,2015,3,22,8,216,264,480,282
0131-002,2015,3,22,9,244,453,697,480
0131-002,2015,3,22,10,264,486,750,697
0131-002,2015,3,22,11,432,519,951,750
0131-002,2015,3,22,12,774,542,1316,951
0131-002,2015,3,22,13,733,379,1112,1316
0131-002,2015,3,22,14,450,472,922,1112
0131-002,2015,3,22,15,523,623,1146,922
0131-002,2015,3,22,16,605,505,1110,1146
0131-002,2015,3,22,17,797,366,1163,1110
0131-002,2015,3,22,18,869,445,1314,1163
0131-002,2015,3,22,19,861,542,1403,1314
0131-002,2015,3,22,20,605,466,1071,1403
0131-002,2015,3,22,21,474,396,870,1071
0131-002,2015,3,22,22,392,293,685,870
0131-002,2015,3,22,23,194,218,412,685
0131-002,2015,3,22,24,112,130,242,412
0131-002,2015,3,23,1,59,91,150,242
0131-002,2015,3,23,2,26,44,70,150
0131-002,2015,3,23,3,15,40,55,70
0131-002,2015,3,23,4,17,45,62,55
0131-002,2015,3,23,5,81,74,155,62
0131-002,2015,3,23,6,501,168,669,155
0131-002,2015,3,23,7,1430,382,1812,669
0131-002,2015,3,23,8,2998,833,3831,1812
0131-002,2015,3,23,9,1967,905,2872,3831
0131-002,2015,3,23,10,918,813,1731,2872
0131-002,2015,3,23,11,783,836,1619,1731
0131-002,2015,3,23,12,669,872,1541,1619
0131-002,2015,3,23,13,658,743,1401,1541
0131-002,2015,3,23,14,907,798,1705,1401
0131-002,2015,3,23,15,880,1004,1884,1705
0131-002,2015,3,23,16,775,959,1734,1884
0131-002,2015,3,23,17,702,1044,1746,1734
0131-002,2015,3,23,18,702,1181,1883,1746
0131-002,2015,3,23,19,774,1044,1818,1883
0131-002,2015,3,23,20,582,887,1469,1818
0131-002,2015,3,23,21,397,768,1165,1469
0131-002,2015,3,23,22,322,484,806,1165
0131-002,2015,3,23,23,211,299,510,806
0131-002,2015,3,23,24,108,183,291,510
0131-002,2015,3,24,1,77,152,229,291
0131-002,2015,3,24,2,66,64,130,229
0131-002,2015,3,24,3,39,51,90,130
0131-002,2015,3,24,4,33,53,86,90
0131-002,2015,3,24,5,37,62,99,86
0131-002,2015,3,24,6,331,98,429,99
0131-002,2015,3,24,7,1026,306,1332,429
0131-002,2015,3,24,8,1826,795,2621,1332
0131-002,2015,3,24,9,1574,1101,2675,2621
0131-002,2015,3,24,10,976,968,1944,2675
0131-002,2015,3,24,11,858,913,1771,1944
0131-002,2015,3,24,12,770,856,1626,1771
0131-002,2015,3,24,13,626,762,1388,1626
0131-002,2015,3,24,14,803,911,1714,1388
0131-002,2015,3,24,15,860,946,1806,1714
0131-002,2015,3,24,16,812,735,1547,1806
0131-002,2015,3,24,17,699,945,1644,1547
0131-002,2015,3,24,18,816,1159,1975,1644
0131-002,2015,3,24,19,814,1117,1931,1975
0131-002,2015,3,24,20,620,859,1479,1931
0131-002,2015,3,24,21,388,753,1141,1479
0131-002,2015,3,24,22,350,567,917,1141
0131-002,2015,3,24,23,238,319,557,917
0131-002,2015,3,24,24,191,211,402,557
0131-002,2015,3,25,1,94,142,236,402
0131-002,2015,3,25,2,48,92,140,236
0131-002,2015,3,25,3,22,60,82,140
0131-002,2015,3,25,4,15,68,83,82
0131-002,2015,3,25,5,37,60,97,83
0131-002,2015,3,25,6,165,141,306,97
0131-002,2015,3,25,7,602,371,973,306
0131-002,2015,3,25,8,1874,892,2766,973
0131-002,2015,3,25,9,1541,1070,2611,2766
0131-002,2015,3,25,10,880,1001,1881,2611
0131-002,2015,3,25,11,830,909,1739,1881
0131-002,2015,3,25,12,766,873,1639,1739
0131-002,2015,3,25,13,584,769,1353,1639
0131-002,2015,3,25,14,880,875,1755,1353
0131-002,2015,3,25,15,849,1002,1851,1755
0131-002,2015,3,25,16,847,996,1843,1851
0131-002,2015,3,25,17,733,936,1669,1843
0131-002,2015,3,25,18,777,1211,1988,1669
0131-002,2015,3,25,19,889,1168,2057,1988
0131-002,2015,3,25,20,591,828,1419,2057
0131-002,2015,3,25,21,406,734,1140,1419
0131-002,2015,3,25,22,381,524,905,1140
0131-002,2015,3,25,23,216,332,548,905
0131-002,2015,3,25,24,149,249,398,548
0131-002,2015,3,26,1,94,149,243,398
0131-002,2015,3,26,2,55,108,163,243
0131-002,2015,3,26,3,32,86,118,163
0131-002,2015,3,26,4,50,70,120,118
0131-002,2015,3,26,5,39,92,131,120
0131-002,2015,3,26,6,169,170,339,131
0131-002,2015,3,26,7,673,384,1057,339
0131-002,2015,3,26,8,1700,924,2624,1057
0131-002,2015,3,26,9,1581,1092,2673,2624
0131-002,2015,3,26,10,989,912,1901,2673
0131-002,2015,3,26,11,861,938,1799,1901
0131-002,2015,3,26,12,781,929,1710,1799
0131-002,2015,3,26,13,638,791,1429,1710
0131-002,2015,3,26,14,772,854,1626,1429
0131-002,2015,3,26,15,841,972,1813,1626
0131-002,2015,3,26,16,861,892,1753,1813
0131-002,2015,3,26,17,832,965,1797,1753
0131-002,2015,3,26,18,847,1242,2089,1797
0131-002,2015,3,26,19,801,1133,1934,2089
0131-002,2015,3,26,20,675,837,1512,1934
0131-002,2015,3,26,21,392,746,1138,1512
0131-002,2015,3,26,22,351,589,940,1138
0131-002,2015,3,26,23,236,356,592,940
0131-002,2015,3,26,24,158,261,419,592
0131-002,2015,3,27,1,92,166,258,419
0131-002,2015,3,27,2,50,113,163,258
0131-002,2015,3,27,3,24,84,108,163
0131-002,2015,3,27,4,17,92,109,108
0131-002,2015,3,27,5,37,109,146,109
0131-002,2015,3,27,6,160,182,342,146
0131-002,2015,3,27,7,757,365,1122,342
0131-002,2015,3,27,8,1961,851,2812,1122
0131-002,2015,3,27,9,1878,1031,2909,2812
0131-002,2015,3,27,10,874,959,1833,2909
0131-002,2015,3,27,11,850,1007,1857,1833
0131-002,2015,3,27,12,841,980,1821,1857
0131-002,2015,3,27,13,666,884,1550,1821
0131-002,2015,3,27,14,788,943,1731,1550
0131-002,2015,3,27,15,823,1034,1857,1731
0131-002,2015,3,27,16,936,1007,1943,1857
0131-002,2015,3,27,17,834,1084,1918,1943
0131-002,2015,3,27,18,883,1407,2290,1918
0131-002,2015,3,27,19,947,1299,2246,2290
0131-002,2015,3,27,20,828,1040,1868,2246
0131-002,2015,3,27,21,432,806,1238,1868
0131-002,2015,3,27,22,393,529,922,1238
0131-002,2015,3,27,23,225,372,597,922
0131-002,2015,3,27,24,128,270,398,597
0131-002,2015,3,28,1,180,195,375,398
0131-002,2015,3,28,2,231,132,363,375
0131-002,2015,3,28,3,189,110,299,363
0131-002,2015,3,28,4,178,100,278,299
0131-002,2015,3,28,5,200,120,320,278
0131-002,2015,3,28,6,401,177,578,320
0131-002,2015,3,28,7,969,341,1310,578
0131-002,2015,3,28,8,959,601,1560,1310
0131-002,2015,3,28,9,836,851,1687,1560
0131-002,2015,3,28,10,750,899,1649,1687
0131-002,2015,3,28,11,719,1036,1755,1649
0131-002,2015,3,28,12,812,1215,2027,1755
0131-002,2015,3,28,13,746,1143,1889,2027
0131-002,2015,3,28,14,775,961,1736,1889
0131-002,2015,3,28,15,730,964,1694,1736
0131-002,2015,3,28,16,785,954,1739,1694
0131-002,2015,3,28,17,850,949,1799,1739
0131-002,2015,3,28,18,962,1188,2150,1799
0131-002,2015,3,28,19,891,937,1828,2150
0131-002,2015,3,28,20,772,621,1393,1828
0131-002,2015,3,28,21,446,481,927,1393
0131-002,2015,3,28,22,342,314,656,927
0131-002,2015,3,28,23,163,295,458,656
0131-002,2015,3,28,24,112,209,321,458
0131-002,2015,3,29,1,68,133,201,321
0131-002,2015,3,29,2,44,107,151,201
0131-002,2015,3,29,3,30,77,107,151
0131-002,2015,3,29,4,10,58,68,107
0131-002,2015,3,29,5,24,65,89,68
0131-002,2015,3,29,6,50,88,138,89
0131-002,2015,3,29,7,156,133,289,138
0131-002,2015,3,29,8,207,252,459,289
0131-002,2015,3,29,9,342,388,730,459
0131-002,2015,3,29,10,319,338,657,730
0131-002,2015,3,29,11,381,312,693,657
0131-002,2015,3,29,12,388,621,1009,693
0131-002,2015,3,29,13,439,541,980,1009
0131-002,2015,3,29,14,556,600,1156,980
0131-002,2015,3,29,15,668,622,1290,1156
0131-002,2015,3,29,16,803,592,1395,1290
0131-002,2015,3,29,17,805,516,1321,1395
0131-002,2015,3,29,18,872,830,1702,1321
0131-002,2015,3,29,19,905,696,1601,1702
0131-002,2015,3,29,20,735,485,1220,1601
0131-002,2015,3,29,21,637,420,1057,1220
0131-002,2015,3,29,22,419,253,672,1057
0131-002,2015,3,29,23,264,85,349,672
0131-002,2015,3,29,24,150,52,202,349
0131-002,2015,3,30,1,48,25,73,202
0131-002,2015,3,30,2,24,10,34,73
0131-002,2015,3,30,3,15,11,26,34
0131-002,2015,3,30,4,26,14,40,26
0131-002,2015,3,30,5,68,12,80,40
0131-002,2015,3,30,6,225,170,395,80
0131-002,2015,3,30,7,799,381,1180,395
0131-002,2015,3,30,8,2130,864,2994,1180
0131-002,2015,3,30,9,1603,963,2566,2994
0131-002,2015,3,30,10,850,867,1717,2566
0131-002,2015,3,30,11,867,884,1751,1717
0131-002,2015,3,30,12,799,870,1669,1751
0131-002,2015,3,30,13,702,748,1450,1669
0131-002,2015,3,30,14,797,830,1627,1450
0131-002,2015,3,30,15,889,990,1879,1627
0131-002,2015,3,30,16,816,967,1783,1879
0131-002,2015,3,30,17,779,1010,1789,1783
0131-002,2015,3,30,18,775,1176,1951,1789
0131-002,2015,3,30,19,920,814,1734,1951
0131-002,2015,3,30,20,686,673,1359,1734
0131-002,2015,3,30,21,457,632,1089,1359
0131-002,2015,3,30,22,335,543,878,1089
0131-002,2015,3,30,23,238,272,510,878
0131-002,2015,3,30,24,134,186,320,510
0131-002,2015,3,31,1,63,144,207,320
0131-002,2015,3,31,2,24,78,102,207
0131-002,2015,3,31,3,21,59,80,102
0131-002,2015,3,31,4,33,72,105,80
0131-002,2015,3,31,5,41,99,140,105
0131-002,2015,3,31,6,134,157,291,140
0131-002,2015,3,31,7,691,327,1018,291
0131-002,2015,3,31,8,1773,844,2617,1018
0131-002,2015,3,31,9,1422,1042,2464,2617
0131-002,2015,3,31,10,922,902,1824,2464
0131-002,2015,3,31,11,860,946,1806,1824
0131-002,2015,3,31,12,743,791,1534,1806
0131-002,2015,3,31,13,593,796,1389,1534
0131-002,2015,3,31,14,761,898,1659,1389
0131-002,2015,3,31,15,763,960,1723,1659
0131-002,2015,3,31,16,785,990,1775,1723
0131-002,2015,3,31,17,799,1062,1861,1775
0131-002,2015,3,31,18,777,1171,1948,1861
0131-002,2015,3,31,19,830,975,1805,1948
0131-002,2015,3,31,20,576,814,1390,1805
0131-002,2015,3,31,21,362,702,1064,1390
0131-002,2015,3,31,22,275,509,784,1064
0131-002,2015,3,31,23,192,348,540,784
0131-002,2015,3,31,24,134,211,345,540
0131-002,2015,4,1,1,78,142,220,345
0131-002,2015,4,1,2,45,78,123,220
0131-002,2015,4,1,3,30,95,125,123
0131-002,2015,4,1,4,43,82,125,125
0131-002,2015,4,1,5,49,97,146,125
0131-002,2015,4,1,6,128,146,274,146
0131-002,2015,4,1,7,603,335,938,274
0131-002,2015,4,1,8,1712,920,2632,938
0131-002,2015,4,1,9,1486,1163,2649,2632
0131-002,2015,4,1,10,878,938,1816,2649
0131-002,2015,4,1,11,850,941,1791,1816
0131-002,2015,4,1,12,817,882,1699,1791
0131-002,2015,4,1,13,670,747,1417,1699
0131-002,2015,4,1,14,830,915,1745,1417
0131-002,2015,4,1,15,896,1028,1924,1745
0131-002,2015,4,1,16,839,1010,1849,1924
0131-002,2015,4,1,17,787,772,1559,1849
0131-002,2015,4,1,18,844,978,1822,1559
0131-002,2015,4,1,19,900,1061,1961,1822
0131-002,2015,4,1,20,585,818,1403,1961
0131-002,2015,4,1,21,427,635,1062,1403
0131-002,2015,4,1,22,331,512,843,1062
0131-002,2015,4,1,23,225,314,539,843
0131-002,2015,4,1,24,140,217,357,539
0131-002,2015,4,2,1,86,145,231,357
0131-002,2015,4,2,2,47,103,150,231
0131-002,2015,4,2,3,36,80,116,150
0131-002,2015,4,2,4,19,67,86,116
0131-002,2015,4,2,5,51,108,159,86
0131-002,2015,4,2,6,136,177,313,159
0131-002,2015,4,2,7,644,373,1017,313
0131-002,2015,4,2,8,1860,875,2735,1017
0131-002,2015,4,2,9,1505,1031,2536,2735
0131-002,2015,4,2,10,876,926,1802,2536
0131-002,2015,4,2,11,720,1051,1771,1802
0131-002,2015,4,2,12,817,969,1786,1771
0131-002,2015,4,2,13,637,808,1445,1786
0131-002,2015,4,2,14,711,911,1622,1445
0131-002,2015,4,2,15,844,1046,1890,1622
0131-002,2015,4,2,16,867,1008,1875,1890
0131-002,2015,4,2,17,813,1044,1857,1875
0131-002,2015,4,2,18,891,1194,2085,1857
0131-002,2015,4,2,19,711,1059,1770,2085
0131-002,2015,4,2,20,542,715,1257,1770
0131-002,2015,4,2,21,332,571,903,1257
0131-002,2015,4,2,22,292,511,803,903
0131-002,2015,4,2,23,164,357,521,803
0131-002,2015,4,2,24,119,200,319,521
0131-002,2015,4,3,1,49,134,183,319
0131-002,2015,4,3,2,43,103,146,183
0131-002,2015,4,3,3,26,82,108,146
0131-002,2015,4,3,4,32,66,98,108
0131-002,2015,4,3,5,32,84,116,98
0131-002,2015,4,3,6,127,129,256,116
0131-002,2015,4,3,7,624,251,875,256
0131-002,2015,4,3,8,1741,657,2398,875
0131-002,2015,4,3,9,1399,913,2312,2398
0131-002,2015,4,3,10,867,888,1755,2312
0131-002,2015,4,3,11,765,944,1709,1755
0131-002,2015,4,3,12,718,779,1497,1709
0131-002,2015,4,3,13,642,741,1383,1497
0131-002,2015,4,3,14,833,785,1618,1383
0131-002,2015,4,3,15,917,811,1728,1618
0131-002,2015,4,3,16,904,852,1756,1728
0131-002,2015,4,3,17,809,647,1456,1756
0131-002,2015,4,3,18,883,1042,1925,1456
0131-002,2015,4,3,19,993,1203,2196,1925
0131-002,2015,4,3,20,791,991,1782,2196
0131-002,2015,4,3,21,447,552,999,1782
0131-002,2015,4,3,22,383,394,777,999
0131-002,2015,4,3,23,264,267,531,777
0131-002,2015,4,3,24,147,210,357,531
0131-002,2015,4,4,1,84,63,147,357
0131-002,2015,4,4,2,36,87,123,147
0131-002,2015,4,4,3,38,83,121,123
0131-002,2015,4,4,4,26,71,97,121
0131-002,2015,4,4,5,47,112,159,97
0131-002,2015,4,4,6,99,156,255,159
0131-002,2015,4,4,7,421,251,672,255
0131-002,2015,4,4,8,824,372,1196,672
0131-002,2015,4,4,9,739,660,1399,1196
0131-002,2015,4,4,10,765,902,1667,1399
0131-002,2015,4,4,11,748,965,1713,1667
0131-002,2015,4,4,12,820,1100,1920,1713
0131-002,2015,4,4,13,744,988,1732,1920
0131-002,2015,4,4,14,817,901,1718,1732
0131-002,2015,4,4,15,728,950,1678,1718
0131-002,2015,4,4,16,791,990,1781,1678
0131-002,2015,4,4,17,865,981,1846,1781
0131-002,2015,4,4,18,865,1094,1959,1846
0131-002,2015,4,4,19,852,794,1646,1959
0131-002,2015,4,4,20,674,460,1134,1646
0131-002,2015,4,4,21,514,273,787,1134
0131-002,2015,4,4,22,297,323,620,787
0131-002,2015,4,4,23,171,238,409,620
0131-002,2015,4,4,24,88,151,239,409
0131-002,2015,4,5,1,65,144,209,239
0131-002,2015,4,5,2,36,66,102,209
0131-002,2015,4,5,3,23,62,85,102
0131-002,2015,4,5,4,10,61,71,85
0131-002,2015,4,5,5,13,45,58,71
0131-002,2015,4,5,6,32,88,120,58
0131-002,2015,4,5,7,154,139,293,120
0131-002,2015,4,5,8,192,264,456,293
0131-002,2015,4,5,9,214,399,613,456
0131-002,2015,4,5,10,243,462,705,613
0131-002,2015,4,5,11,327,537,864,705
0131-002,2015,4,5,12,407,476,883,864
0131-002,2015,4,5,13,468,489,957,883
0131-002,2015,4,5,14,622,628,1250,957
0131-002,2015,4,5,15,744,606,1350,1250
0131-002,2015,4,5,16,933,581,1514,1350
0131-002,2015,4,5,17,1167,596,1763,1514
0131-002,2015,4,5,18,1276,665,1941,1763
0131-002,2015,4,5,19,1456,449,1905,1941
0131-002,2015,4,5,20,1230,444,1674,1905
0131-002,2015,4,5,21,842,366,1208,1674
0131-002,2015,4,5,22,830,149,979,1208
0131-002,2015,4,5,23,553,196,749,979
0131-002,2015,4,5,24,201,139,340,749
0131-002,2015,4,6,1,77,93,170,340
0131-002,2015,4,6,2,30,57,87,170
0131-002,2015,4,6,3,10,7,17,87
0131-002,2015,4,6,4,21,13,34,17
0131-002,2015,4,6,5,30,62,92,34
0131-002,2015,4,6,6,214,168,382,92
0131-002,2015,4,6,7,872,332,1204,382
0131-002,2015,4,6,8,2067,968,3035,1204
0131-002,2015,4,6,9,1581,1002,2583,3035
0131-002,2015,4,6,10,854,816,1670,2583
0131-002,2015,4,6,11,815,849,1664,1670
0131-002,2015,4,6,12,776,671,1447,1664
0131-002,2015,4,6,13,644,719,1363,1447
0131-002,2015,4,6,14,755,832,1587,1363
0131-002,2015,4,6,15,846,863,1709,1587
0131-002,2015,4,6,16,837,789,1626,1709
0131-002,2015,4,6,17,694,869,1563,1626
0131-002,2015,4,6,18,789,918,1707,1563
0131-002,2015,4,6,19,922,1076,1998,1707
0131-002,2015,4,6,20,544,790,1334,1998
0131-002,2015,4,6,21,379,492,871,1334
0131-002,2015,4,6,22,292,437,729,871
0131-002,2015,4,6,23,199,290,489,729
0131-002,2015,4,6,24,140,93,233,489
0131-002,2015,4,7,1,93,84,177,233
0131-002,2015,4,7,2,30,50,80,177
0131-002,2015,4,7,3,26,52,78,80
0131-002,2015,4,7,4,17,54,71,78
0131-002,2015,4,7,5,23,103,126,71
0131-002,2015,4,7,6,151,167,318,126
0131-002,2015,4,7,7,729,343,1072,318
0131-002,2015,4,7,8,1837,893,2730,1072
0131-002,2015,4,7,9,1430,1023,2453,2730
0131-002,2015,4,7,10,867,873,1740,2453
0131-002,2015,4,7,11,857,1023,1880,1740
0131-002,2015,4,7,12,757,938,1695,1880
0131-002,2015,4,7,13,644,868,1512,1695
0131-002,2015,4,7,14,742,943,1685,1512
0131-002,2015,4,7,15,826,1026,1852,1685
0131-002,2015,4,7,16,753,1012,1765,1852
0131-002,2015,4,7,17,753,1015,1768,1765
0131-002,2015,4,7,18,792,1230,2022,1768
0131-002,2015,4,7,19,778,1080,1858,2022
0131-002,2015,4,7,20,626,782,1408,1858
0131-002,2015,4,7,21,370,742,1112,1408
0131-002,2015,4,7,22,321,535,856,1112
0131-002,2015,4,7,23,186,374,560,856
0131-002,2015,4,7,24,110,212,322,560
0131-002,2015,4,8,1,78,150,228,322
0131-002,2015,4,8,2,41,99,140,228
0131-002,2015,4,8,3,23,63,86,140
0131-002,2015,4,8,4,28,64,92,86
0131-002,2015,4,8,5,32,100,132,92
0131-002,2015,4,8,6,132,188,320,132
0131-002,2015,4,8,7,753,369,1122,320
0131-002,2015,4,8,8,1811,820,2631,1122
0131-002,2015,4,8,9,1377,1034,2411,2631
0131-002,2015,4,8,10,872,951,1823,2411
0131-002,2015,4,8,11,794,944,1738,1823
0131-002,2015,4,8,12,737,960,1697,1738
0131-002,2015,4,8,13,670,874,1544,1697
0131-002,2015,4,8,14,798,931,1729,1544
0131-002,2015,4,8,15,828,1064,1892,1729
0131-002,2015,4,8,16,855,1079,1934,1892
0131-002,2015,4,8,17,677,1030,1707,1934
0131-002,2015,4,8,18,894,1295,2189,1707
0131-002,2015,4,8,19,874,1166,2040,2189
0131-002,2015,4,8,20,572,844,1416,2040
0131-002,2015,4,8,21,375,736,1111,1416
0131-002,2015,4,8,22,444,505,949,1111
0131-002,2015,4,8,23,409,322,731,949
0131-002,2015,4,8,24,247,216,463,731
0131-002,2015,4,9,1,210,159,369,463
0131-002,2015,4,9,2,121,109,230,369
0131-002,2015,4,9,3,84,72,156,230
0131-002,2015,4,9,4,132,85,217,156
0131-002,2015,4,9,5,164,118,282,217
0131-002,2015,4,9,6,260,176,436,282
0131-002,2015,4,9,7,1197,403,1600,436
0131-002,2015,4,9,8,2599,826,3425,1600
0131-002,2015,4,9,9,1464,1090,2554,3425
0131-002,2015,4,9,10,885,907,1792,2554
0131-002,2015,4,9,11,891,1000,1891,1792
0131-002,2015,4,9,12,841,957,1798,1891
0131-002,2015,4,9,13,677,824,1501,1798
0131-002,2015,4,9,14,757,968,1725,1501
0131-002,2015,4,9,15,911,1121,2032,1725
0131-002,2015,4,9,16,928,1125,2053,2032
0131-002,2015,4,9,17,839,1124,1963,2053
0131-002,2015,4,9,18,855,1303,2158,1963
0131-002,2015,4,9,19,839,1130,1969,2158
0131-002,2015,4,9,20,546,822,1368,1969
0131-002,2015,4,9,21,368,759,1127,1368
0131-002,2015,4,9,22,326,545,871,1127
0131-002,2015,4,9,23,186,336,522,871
0131-002,2015,4,9,24,123,201,324,522
0131-002,2015,4,10,1,305,165,470,324
0131-002,2015,4,10,2,206,89,295,470
0131-002,2015,4,10,3,130,57,187,295
0131-002,2015,4,10,4,114,67,181,187
0131-002,2015,4,10,5,151,104,255,181
0131-002,2015,4,10,6,483,183,666,255
0131-002,2015,4,10,7,1430,375,1805,666
0131-002,2015,4,10,8,2709,863,3572,1805
0131-002,2015,4,10,9,1608,1062,2670,3572
0131-002,2015,4,10,10,894,954,1848,2670
0131-002,2015,4,10,11,889,1063,1952,1848
0131-002,2015,4,10,12,820,1078,1898,1952
0131-002,2015,4,10,13,709,977,1686,1898
0131-002,2015,4,10,14,781,826,1607,1686
0131-002,2015,4,10,15,954,929,1883,1607
0131-002,2015,4,10,16,876,1089,1965,1883
0131-002,2015,4,10,17,833,1071,1904,1965
0131-002,2015,4,10,18,917,1418,2335,1904
0131-002,2015,4,10,19,976,1172,2148,2335
0131-002,2015,4,10,20,753,677,1430,2148
0131-002,2015,4,10,21,489,559,1048,1430
0131-002,2015,4,10,22,369,507,876,1048
0131-002,2015,4,10,23,374,356,730,876
0131-002,2015,4,10,24,174,235,409,730
0131-002,2015,4,11,1,345,138,483,409
0131-002,2015,4,11,2,201,113,314,483
0131-002,2015,4,11,3,186,94,280,314
0131-002,2015,4,11,4,127,86,213,280
0131-002,2015,4,11,5,182,91,273,213
0131-002,2015,4,11,6,427,160,587,273
0131-002,2015,4,11,7,939,327,1266,587
0131-002,2015,4,11,8,1446,612,2058,1266
0131-002,2015,4,11,9,920,825,1745,2058
0131-002,2015,4,11,10,679,715,1394,1745
0131-002,2015,4,11,11,740,714,1454,1394
0131-002,2015,4,11,12,807,700,1507,1454
0131-002,2015,4,11,13,694,1004,1698,1507
0131-002,2015,4,11,14,718,954,1672,1698
0131-002,2015,4,11,15,742,935,1677,1672
0131-002,2015,4,11,16,744,1025,1769,1677
0131-002,2015,4,11,17,880,879,1759,1769
0131-002,2015,4,11,18,1054,1127,2181,1759
0131-002,2015,4,11,19,1032,871,1903,2181
0131-002,2015,4,11,20,737,572,1309,1903
0131-002,2015,4,11,21,501,328,829,1309
0131-002,2015,4,11,22,447,274,721,829
0131-002,2015,4,11,23,262,233,495,721
0131-002,2015,4,11,24,162,179,341,495
0131-002,2015,4,12,1,197,123,320,341
0131-002,2015,4,12,2,171,92,263,320
0131-002,2015,4,12,3,151,64,215,263
0131-002,2015,4,12,4,132,48,180,215
0131-002,2015,4,12,5,127,75,202,180
0131-002,2015,4,12,6,197,79,276,202
0131-002,2015,4,12,7,375,168,543,276
0131-002,2015,4,12,8,577,309,886,543
0131-002,2015,4,12,9,397,449,846,886
0131-002,2015,4,12,10,358,524,882,846
0131-002,2015,4,12,11,392,554,946,882
0131-002,2015,4,12,12,433,507,940,946
0131-002,2015,4,12,13,472,533,1005,940
0131-002,2015,4,12,14,531,448,979,1005
0131-002,2015,4,12,15,548,583,1131,979
0131-002,2015,4,12,16,726,568,1294,1131
0131-002,2015,4,12,17,826,644,1470,1294
0131-002,2015,4,12,18,1000,680,1680,1470
0131-002,2015,4,12,19,989,556,1545,1680
0131-002,2015,4,12,20,913,431,1344,1545
0131-002,2015,4,12,21,735,419,1154,1344
0131-002,2015,4,12,22,562,316,878,1154
0131-002,2015,4,12,23,353,203,556,878
0131-002,2015,4,12,24,147,133,280,556
0131-002,2015,4,13,1,80,98,178,280
0131-002,2015,4,13,2,34,61,95,178
0131-002,2015,4,13,3,26,52,78,95
0131-002,2015,4,13,4,21,54,75,78
0131-002,2015,4,13,5,30,79,109,75
0131-002,2015,4,13,6,266,178,444,109
0131-002,2015,4,13,7,1022,405,1427,444
0131-002,2015,4,13,8,2084,901,2985,1427
0131-002,2015,4,13,9,1480,1022,2502,2985
0131-002,2015,4,13,10,865,911,1776,2502
0131-002,2015,4,13,11,937,987,1924,1776
0131-002,2015,4,13,12,785,863,1648,1924
0131-002,2015,4,13,13,666,827,1493,1648
0131-002,2015,4,13,14,835,837,1672,1493
0131-002,2015,4,13,15,920,963,1883,1672
0131-002,2015,4,13,16,852,925,1777,1883
0131-002,2015,4,13,17,742,810,1552,1777
0131-002,2015,4,13,18,781,1230,2011,1552
0131-002,2015,4,13,19,804,1059,1863,2011
0131-002,2015,4,13,20,540,873,1413,1863
0131-002,2015,4,13,21,379,872,1251,1413
0131-002,2015,4,13,22,297,400,697,1251
0131-002,2015,4,13,23,190,338,528,697
0131-002,2015,4,13,24,112,205,317,528
0131-002,2015,4,14,1,41,137,178,317
0131-002,2015,4,14,2,36,83,119,178
0131-002,2015,4,14,3,28,56,84,119
0131-002,2015,4,14,4,19,56,75,84
0131-002,2015,4,14,5,26,86,112,75
0131-002,2015,4,14,6,108,161,269,112
0131-002,2015,4,14,7,555,345,900,269
0131-002,2015,4,14,8,1514,919,2433,900
0131-002,2015,4,14,9,1349,1191,2540,2433
0131-002,2015,4,14,10,907,981,1888,2540
0131-002,2015,4,14,11,802,1047,1849,1888
0131-002,2015,4,14,12,763,879,1642,1849
0131-002,2015,4,14,13,594,854,1448,1642
0131-002,2015,4,14,14,779,853,1632,1448
0131-002,2015,4,14,15,757,881,1638,1632
0131-002,2015,4,14,16,844,927,1771,1638
0131-002,2015,4,14,17,692,792,1484,1771
0131-002,2015,4,14,18,783,1026,1809,1484
0131-002,2015,4,14,19,729,1007,1736,1809
0131-002,2015,4,14,20,527,801,1328,1736
0131-002,2015,4,14,21,375,755,1130,1328
0131-002,2015,4,14,22,394,496,890,1130
0131-002,2015,4,14,23,195,317,512,890
0131-002,2015,4,14,24,136,211,347,512
0131-002,2015,4,15,1,62,152,214,347
0131-002,2015,4,15,2,34,104,138,214
0131-002,2015,4,15,3,21,58,79,138
0131-002,2015,4,15,4,25,66,91,79
0131-002,2015,4,15,5,32,110,142,91
0131-002,2015,4,15,6,164,205,369,142
0131-002,2015,4,15,7,650,402,1052,369
0131-002,2015,4,15,8,1833,927,2760,1052
0131-002,2015,4,15,9,1466,1233,2699,2760
0131-002,2015,4,15,10,954,998,1952,2699
0131-002,2015,4,15,11,868,1003,1871,1952
0131-002,2015,4,15,12,841,961,1802,1871
0131-002,2015,4,15,13,666,817,1483,1802
0131-002,2015,4,15,14,750,976,1726,1483
0131-002,2015,4,15,15,861,1016,1877,1726
0131-002,2015,4,15,16,833,985,1818,1877
0131-002,2015,4,15,17,794,960,1754,1818
0131-002,2015,4,15,18,987,1236,2223,1754
0131-002,2015,4,15,19,906,1008,1914,2223
0131-002,2015,4,15,20,611,640,1251,1914
0131-002,2015,4,15,21,399,624,1023,1251
0131-002,2015,4,15,22,340,438,778,1023
0131-002,2015,4,15,23,242,354,596,778
0131-002,2015,4,15,24,119,258,377,596
0131-002,2015,4,16,1,93,157,250,377
0131-002,2015,4,16,2,60,78,138,250
0131-002,2015,4,16,3,21,69,90,138
0131-002,2015,4,16,4,36,65,101,90
0131-002,2015,4,16,5,28,93,121,101
0131-002,2015,4,16,6,175,168,343,121
0131-002,2015,4,16,7,733,355,1088,343
0131-002,2015,4,16,8,1852,807,2659,1088
0131-002,2015,4,16,9,1456,1041,2497,2659
0131-002,2015,4,16,10,950,919,1869,2497
0131-002,2015,4,16,11,839,898,1737,1869
0131-002,2015,4,16,12,716,606,1322,1737
0131-002,2015,4,16,13,642,528,1170,1322
0131-002,2015,4,16,14,842,781,1623,1170
0131-002,2015,4,16,15,744,688,1432,1623
0131-002,2015,4,16,16,828,917,1745,1432
0131-002,2015,4,16,17,742,1029,1771,1745
0131-002,2015,4,16,18,729,1092,1821,1771
0131-002,2015,4,16,19,752,1093,1845,1821
0131-002,2015,4,16,20,549,783,1332,1845
0131-002,2015,4,16,21,405,539,944,1332
0131-002,2015,4,16,22,360,367,727,944
0131-002,2015,4,16,23,208,258,466,727
0131-002,2015,4,16,24,127,208,335,466
0131-002,2015,4,17,1,80,148,228,335
0131-002,2015,4,17,2,47,55,102,228
0131-002,2015,4,17,3,30,50,80,102
0131-002,2015,4,17,4,28,60,88,80
0131-002,2015,4,17,5,32,98,130,88
0131-002,2015,4,17,6,169,161,330,130
0131-002,2015,4,17,7,687,320,1007,330
0131-002,2015,4,17,8,1852,842,2694,1007
0131-002,2015,4,17,9,1466,1040,2506,2694
0131-002,2015,4,17,10,930,900,1830,2506
0131-002,2015,4,17,11,887,959,1846,1830
0131-002,2015,4,17,12,818,962,1780,1846
0131-002,2015,4,17,13,663,848,1511,1780
0131-002,2015,4,17,14,839,801,1640,1511
0131-002,2015,4,17,15,891,918,1809,1640
0131-002,2015,4,17,16,811,1012,1823,1809
0131-002,2015,4,17,17,805,1052,1857,1823
0131-002,2015,4,17,18,924,898,1822,1857
0131-002,2015,4,17,19,995,977,1972,1822
0131-002,2015,4,17,20,715,782,1497,1972
0131-002,2015,4,17,21,516,652,1168,1497
0131-002,2015,4,17,22,400,527,927,1168
0131-002,2015,4,17,23,310,342,652,927
0131-002,2015,4,17,24,182,223,405,652
0131-002,2015,4,18,1,128,142,270,405
0131-002,2015,4,18,2,96,94,190,270
0131-002,2015,4,18,3,64,73,137,190
0131-002,2015,4,18,4,60,67,127,137
0131-002,2015,4,18,5,70,97,167,127
0131-002,2015,4,18,6,161,115,276,167
0131-002,2015,4,18,7,410,268,678,276
0131-002,2015,4,18,8,713,504,1217,678
0131-002,2015,4,18,9,799,839,1638,1217
0131-002,2015,4,18,10,836,982,1818,1638
0131-002,2015,4,18,11,817,1146,1963,1818
0131-002,2015,4,18,12,817,1202,2019,1963
0131-002,2015,4,18,13,686,1146,1832,2019
0131-002,2015,4,18,14,685,954,1639,1832
0131-002,2015,4,18,15,828,1065,1893,1639
0131-002,2015,4,18,16,739,969,1708,1893
0131-002,2015,4,18,17,933,1072,2005,1708
0131-002,2015,4,18,18,1031,1101,2132,2005
0131-002,2015,4,18,19,959,978,1937,2132
0131-002,2015,4,18,20,616,584,1200,1937
0131-002,2015,4,18,21,420,436,856,1200
0131-002,2015,4,18,22,353,331,684,856
0131-002,2015,4,18,23,208,222,430,684
0131-002,2015,4,18,24,157,148,305,430
0131-002,2015,4,19,1,92,108,200,305
0131-002,2015,4,19,2,75,72,147,200
0131-002,2015,4,19,3,46,54,100,147
0131-002,2015,4,19,4,46,47,93,100
0131-002,2015,4,19,5,50,50,100,93
0131-002,2015,4,19,6,81,71,152,100
0131-002,2015,4,19,7,165,136,301,152
0131-002,2015,4,19,8,263,254,517,301
0131-002,2015,4,19,9,306,389,695,517
0131-002,2015,4,19,10,347,399,746,695
0131-002,2015,4,19,11,449,486,935,746
0131-002,2015,4,19,12,487,470,957,935
0131-002,2015,4,19,13,450,483,933,957
0131-002,2015,4,19,14,535,479,1014,933
0131-002,2015,4,19,15,657,558,1215,1014
0131-002,2015,4,19,16,762,580,1342,1215
0131-002,2015,4,19,17,802,573,1375,1342
0131-002,2015,4,19,18,910,588,1498,1375
0131-002,2015,4,19,19,804,542,1346,1498
0131-002,2015,4,19,20,655,407,1062,1346
0131-002,2015,4,19,21,579,345,924,1062
0131-002,2015,4,19,22,499,278,777,924
0131-002,2015,4,19,23,277,182,459,777
0131-002,2015,4,19,24,172,119,291,459
0131-002,2015,4,20,1,103,68,171,291
0131-002,2015,4,20,2,58,48,106,171
0131-002,2015,4,20,3,39,38,77,106
0131-002,2015,4,20,4,46,35,81,77
0131-002,2015,4,20,5,57,62,119,81
0131-002,2015,4,20,6,176,131,307,119
0131-002,2015,4,20,7,621,328,949,307
0131-002,2015,4,20,8,1527,874,2401,949
0131-002,2015,4,20,9,1184,945,2129,2401
0131-002,2015,4,20,10,866,843,1709,2129
0131-002,2015,4,20,11,947,879,1826,1709
0131-002,2015,4,20,12,781,852,1633,1826
0131-002,2015,4,20,13,676,727,1403,1633
0131-002,2015,4,20,14,729,805,1534,1403
0131-002,2015,4,20,15,892,909,1801,1534
0131-002,2015,4,20,16,946,974,1920,1801
0131-002,2015,4,20,17,863,933,1796,1920
0131-002,2015,4,20,18,832,1050,1882,1796
0131-002,2015,4,20,19,838,979,1817,1882
0131-002,2015,4,20,20,561,757,1318,1817
0131-002,2015,4,20,21,467,695,1162,1318
0131-002,2015,4,20,22,367,467,834,1162
0131-002,2015,4,20,23,222,290,512,834
0131-002,2015,4,20,24,147,164,311,512
0131-002,2015,4,21,1,97,100,197,311
0131-002,2015,4,21,2,67,69,136,197
0131-002,2015,4,21,3,48,59,107,136
0131-002,2015,4,21,4,53,44,97,107
0131-002,2015,4,21,5,70,86,156,97
0131-002,2015,4,21,6,185,129,314,156
0131-002,2015,4,21,7,532,289,821,314
0131-002,2015,4,21,8,1352,785,2137,821
0131-002,2015,4,21,9,1206,1035,2241,2137
0131-002,2015,4,21,10,894,884,1778,2241
0131-002,2015,4,21,11,892,871,1763,1778
0131-002,2015,4,21,12,790,857,1647,1763
0131-002,2015,4,21,13,753,751,1504,1647
0131-002,2015,4,21,14,750,800,1550,1504
0131-002,2015,4,21,15,860,929,1789,1550
0131-002,2015,4,21,16,919,952,1871,1789
0131-002,2015,4,21,17,852,903,1755,1871
0131-002,2015,4,21,18,865,1095,1960,1755
0131-002,2015,4,21,19,796,1024,1820,1960
0131-002,2015,4,21,20,606,761,1367,1820
0131-002,2015,4,21,21,457,671,1128,1367
0131-002,2015,4,21,22,443,527,970,1128
0131-002,2015,4,21,23,232,258,490,970
0131-002,2015,4,21,24,189,185,374,490
0131-002,2015,4,22,1,122,113,235,374
0131-002,2015,4,22,2,75,78,153,235
0131-002,2015,4,22,3,55,62,117,153
0131-002,2015,4,22,4,49,63,112,117
0131-002,2015,4,22,5,68,82,150,112
0131-002,2015,4,22,6,164,124,288,150
0131-002,2015,4,22,7,546,287,833,288
0131-002,2015,4,22,8,1378,794,2172,833
0131-002,2015,4,22,9,1209,1017,2226,2172
0131-002,2015,4,22,10,861,842,1703,2226
0131-002,2015,4,22,11,904,858,1762,1703
0131-002,2015,4,22,12,863,882,1745,1762
0131-002,2015,4,22,13,680,729,1409,1745
0131-002,2015,4,22,14,761,763,1524,1409
0131-002,2015,4,22,15,911,854,1765,1524
0131-002,2015,4,22,16,818,910,1728,1765
0131-002,2015,4,22,17,847,948,1795,1728
0131-002,2015,4,22,18,840,1176,2016,1795
0131-002,2015,4,22,19,920,1091,2011,2016
0131-002,2015,4,22,20,600,760,1360,2011
0131-002,2015,4,22,21,428,627,1055,1360
0131-002,2015,4,22,22,408,463,871,1055
0131-002,2015,4,22,23,263,304,567,871
0131-002,2015,4,22,24,158,177,335,567
0131-002,2015,4,23,1,105,109,214,335
0131-002,2015,4,23,2,75,89,164,214
0131-002,2015,4,23,3,50,53,103,164
0131-002,2015,4,23,4,50,58,108,103
0131-002,2015,4,23,5,83,86,169,108
0131-002,2015,4,23,6,184,135,319,169
0131-002,2015,4,23,7,545,289,834,319
0131-002,2015,4,23,8,1385,826,2211,834
0131-002,2015,4,23,9,1240,1025,2265,2211
0131-002,2015,4,23,10,901,875,1776,2265
0131-002,2015,4,23,11,862,880,1742,1776
0131-002,2015,4,23,12,846,822,1668,1742
0131-002,2015,4,23,13,664,735,1399,1668
0131-002,2015,4,23,14,756,806,1562,1399
0131-002,2015,4,23,15,834,892,1726,1562
0131-002,2015,4,23,16,921,930,1851,1726
0131-002,2015,4,23,17,850,948,1798,1851
0131-002,2015,4,23,18,900,1062,1962,1798
0131-002,2015,4,23,19,879,1071,1950,1962
0131-002,2015,4,23,20,649,814,1463,1950
0131-002,2015,4,23,21,458,672,1130,1463
0131-002,2015,4,23,22,422,496,918,1130
0131-002,2015,4,23,23,282,310,592,918
0131-002,2015,4,23,24,180,185,365,592
0131-002,2015,4,24,1,111,132,243,365
0131-002,2015,4,24,2,86,77,163,243
0131-002,2015,4,24,3,60,68,128,163
0131-002,2015,4,24,4,48,49,97,128
0131-002,2015,4,24,5,79,75,154,97
0131-002,2015,4,24,6,146,126,272,154
0131-002,2015,4,24,7,599,306,905,272
0131-002,2015,4,24,8,1395,820,2215,905
0131-002,2015,4,24,9,1170,1019,2189,2215
0131-002,2015,4,24,10,833,846,1679,2189
0131-002,2015,4,24,11,867,855,1722,1679
0131-002,2015,4,24,12,860,845,1705,1722
0131-002,2015,4,24,13,660,720,1380,1705
0131-002,2015,4,24,14,739,776,1515,1380
0131-002,2015,4,24,15,849,906,1755,1515
0131-002,2015,4,24,16,929,935,1864,1755
0131-002,2015,4,24,17,918,1033,1951,1864
0131-002,2015,4,24,18,988,1250,2238,1951
0131-002,2015,4,24,19,1045,1190,2235,2238
0131-002,2015,4,24,20,747,931,1678,2235
0131-002,2015,4,24,21,544,746,1290,1678
0131-002,2015,4,24,22,430,547,977,1290
0131-002,2015,4,24,23,245,328,573,977
0131-002,2015,4,24,24,191,211,402,573
0131-002,2015,4,25,1,135,141,276,402
0131-002,2015,4,25,2,108,112,220,276
0131-002,2015,4,25,3,63,72,135,220
0131-002,2015,4,25,4,66,78,144,135
0131-002,2015,4,25,5,76,93,169,144
0131-002,2015,4,25,6,144,121,265,169
0131-002,2015,4,25,7,351,243,594,265
0131-002,2015,4,25,8,691,506,1197,594
0131-002,2015,4,25,9,779,716,1495,1197
0131-002,2015,4,25,10,823,794,1617,1495
0131-002,2015,4,25,11,944,1061,2005,1617
0131-002,2015,4,25,12,921,1024,1945,2005
0131-002,2015,4,25,13,883,1072,1955,1945
0131-002,2015,4,25,14,899,1012,1911,1955
0131-002,2015,4,25,15,935,951,1886,1911
0131-002,2015,4,25,16,1009,931,1940,1886
0131-002,2015,4,25,17,1141,1119,2260,1940
0131-002,2015,4,25,18,1118,1071,2189,2260
0131-002,2015,4,25,19,867,858,1725,2189
0131-002,2015,4,25,20,564,522,1086,1725
0131-002,2015,4,25,21,425,426,851,1086
0131-002,2015,4,25,22,303,318,621,851
0131-002,2015,4,25,23,189,225,414,621
0131-002,2015,4,25,24,144,141,285,414
0131-002,2015,4,26,1,97,105,202,285
0131-002,2015,4,26,2,74,90,164,202
0131-002,2015,4,26,3,38,50,88,164
0131-002,2015,4,26,4,49,56,105,88
0131-002,2015,4,26,5,36,41,77,105
0131-002,2015,4,26,6,58,70,128,77
0131-002,2015,4,26,7,149,119,268,128
0131-002,2015,4,26,8,224,212,436,268
0131-002,2015,4,26,9,292,313,605,436
0131-002,2015,4,26,10,319,358,677,605
0131-002,2015,4,26,11,436,461,897,677
0131-002,2015,4,26,12,459,461,920,897
0131-002,2015,4,26,13,440,454,894,920
0131-002,2015,4,26,14,433,493,926,894
0131-002,2015,4,26,15,533,544,1077,926
0131-002,2015,4,26,16,684,602,1286,1077
0131-002,2015,4,26,17,689,556,1245,1286
0131-002,2015,4,26,18,699,574,1273,1245
0131-002,2015,4,26,19,709,531,1240,1273
0131-002,2015,4,26,20,502,423,925,1240
0131-002,2015,4,26,21,384,364,748,925
0131-002,2015,4,26,22,355,293,648,748
0131-002,2015,4,26,23,237,181,418,648
0131-002,2015,4,26,24,139,122,261,418
0131-002,2015,4,27,1,77,73,150,261
0131-002,2015,4,27,2,56,37,93,150
0131-002,2015,4,27,3,43,41,84,93
0131-002,2015,4,27,4,41,42,83,84
0131-002,2015,4,27,5,47,60,107,83
0131-002,2015,4,27,6,148,115,263,107
0131-002,2015,4,27,7,597,319,916,263
0131-002,2015,4,27,8,1489,915,2404,916
0131-002,2015,4,27,9,1189,1015,2204,2404
0131-002,2015,4,27,10,845,815,1660,2204
0131-002,2015,4,27,11,788,802,1590,1660
0131-002,2015,4,27,12,711,788,1499,1590
0131-002,2015,4,27,13,635,685,1320,1499
0131-002,2015,4,27,14,737,809,1546,1320
0131-002,2015,4,27,15,830,875,1705,1546
0131-002,2015,4,27,16,806,889,1695,1705
0131-002,2015,4,27,17,805,901,1706,1695
0131-002,2015,4,27,18,870,1076,1946,1706
0131-002,2015,4,27,19,870,1016,1886,1946
0131-002,2015,4,27,20,577,775,1352,1886
0131-002,2015,4,27,21,488,695,1183,1352
0131-002,2015,4,27,22,406,548,954,1183
0131-002,2015,4,27,23,239,301,540,954
0131-002,2015,4,27,24,144,185,329,540
0131-002,2015,4,28,1,96,113,209,329
0131-002,2015,4,28,2,69,70,139,209
0131-002,2015,4,28,3,46,58,104,139
0131-002,2015,4,28,4,63,62,125,104
0131-002,2015,4,28,5,64,67,131,125
0131-002,2015,4,28,6,158,134,292,131
0131-002,2015,4,28,7,468,279,747,292
0131-002,2015,4,28,8,1305,842,2147,747
0131-002,2015,4,28,9,1131,1092,2223,2147
0131-002,2015,4,28,10,966,901,1867,2223
0131-002,2015,4,28,11,908,905,1813,1867
0131-002,2015,4,28,12,778,825,1603,1813
0131-002,2015,4,28,13,674,704,1378,1603
0131-002,2015,4,28,14,833,837,1670,1378
0131-002,2015,4,28,15,818,871,1689,1670
0131-002,2015,4,28,16,846,865,1711,1689
0131-002,2015,4,28,17,774,856,1630,1711
0131-002,2015,4,28,18,764,948,1712,1630
0131-002,2015,4,28,19,701,937,1638,1712
0131-002,2015,4,28,20,572,688,1260,1638
0131-002,2015,4,28,21,502,681,1183,1260
0131-002,2015,4,28,22,354,464,818,1183
0131-002,2015,4,28,23,204,261,465,818
0131-002,2015,4,28,24,182,193,375,465
0131-002,2015,4,29,1,99,114,213,375
0131-002,2015,4,29,2,73,80,153,213
0131-002,2015,4,29,3,77,69,146,153
0131-002,2015,4,29,4,54,50,104,146
0131-002,2015,4,29,5,60,85,145,104
0131-002,2015,4,29,6,176,131,307,145
0131-002,2015,4,29,7,560,295,855,307
0131-002,2015,4,29,8,1384,800,2184,855
0131-002,2015,4,29,9,1248,978,2226,2184
0131-002,2015,4,29,10,921,903,1824,2226
0131-002,2015,4,29,11,898,870,1768,1824
0131-002,2015,4,29,12,835,835,1670,1768
0131-002,2015,4,29,13,689,724,1413,1670
0131-002,2015,4,29,14,750,851,1601,1413
0131-002,2015,4,29,15,998,947,1945,1601
0131-002,2015,4,29,16,863,929,1792,1945
0131-002,2015,4,29,17,854,940,1794,1792
0131-002,2015,4,29,18,868,1095,1963,1794
0131-002,2015,4,29,19,896,1112,2008,1963
0131-002,2015,4,29,20,701,819,1520,2008
0131-002,2015,4,29,21,505,699,1204,1520
0131-002,2015,4,29,22,426,525,951,1204
0131-002,2015,4,29,23,281,294,575,951
0131-002,2015,4,29,24,174,186,360,575
0131-002,2015,4,30,1,114,124,238,360
0131-002,2015,4,30,2,83,92,175,238
0131-002,2015,4,30,3,54,67,121,175
0131-002,2015,4,30,4,51,57,108,121
0131-002,2015,4,30,5,61,90,151,108
0131-002,2015,4,30,6,138,139,277,151
0131-002,2015,4,30,7,508,295,803,277
0131-002,2015,4,30,8,1144,765,1909,803
0131-002,2015,4,30,9,1041,992,2033,1909
0131-002,2015,4,30,10,741,756,1497,2033
0131-002,2015,4,30,11,829,807,1636,1497
0131-002,2015,4,30,12,746,759,1505,1636
0131-002,2015,4,30,13,616,692,1308,1505
0131-002,2015,4,30,14,705,696,1401,1308
0131-002,2015,4,30,15,757,814,1571,1401
0131-002,2015,4,30,16,803,795,1598,1571
0131-002,2015,4,30,17,766,837,1603,1598
0131-002,2015,4,30,18,790,921,1711,1603
0131-002,2015,4,30,19,772,905,1677,1711
0131-002,2015,4,30,20,527,647,1174,1677
0131-002,2015,4,30,21,428,571,999,1174
0131-002,2015,4,30,22,386,440,826,999
0131-002,2015,4,30,23,239,260,499,826
0131-002,2015,4,30,24,139,147,286,499
0131-002,2015,5,1,1,84,168,252,286
0131-002,2015,5,1,2,50,100,150,252
0131-002,2015,5,1,3,50,54,104,150
0131-002,2015,5,1,4,52,43,95,104
0131-002,2015,5,1,5,50,43,93,95
0131-002,2015,5,1,6,110,104,214,93
0131-002,2015,5,1,7,456,233,689,214
0131-002,2015,5,1,8,1624,625,2249,689
0131-002,2015,5,1,9,1318,966,2284,2249
0131-002,2015,5,1,10,882,1191,2073,2284
0131-002,2015,5,1,11,877,1366,2243,2073
0131-002,2015,5,1,12,839,1207,2046,2243
0131-002,2015,5,1,13,662,1350,2012,2046
0131-002,2015,5,1,14,789,1299,2088,2012
0131-002,2015,5,1,15,870,1407,2277,2088
0131-002,2015,5,1,16,870,1490,2360,2277
0131-002,2015,5,1,17,862,1257,2119,2360
0131-002,2015,5,1,18,956,1074,2030,2119
0131-002,2015,5,1,19,1020,1084,2104,2030
0131-002,2015,5,1,20,731,856,1587,2104
0131-002,2015,5,1,21,530,699,1229,1587
0131-002,2015,5,1,22,415,537,952,1229
0131-002,2015,5,1,23,278,335,613,952
0131-002,2015,5,1,24,186,217,403,613
0131-002,2015,5,2,1,74,42,116,403
0131-002,2015,5,2,2,44,40,84,116
0131-002,2015,5,2,3,52,29,81,84
0131-002,2015,5,2,4,42,25,67,81
0131-002,2015,5,2,5,22,29,51,67
0131-002,2015,5,2,6,144,79,223,51
0131-002,2015,5,2,7,474,256,730,223
0131-002,2015,5,2,8,720,505,1225,730
0131-002,2015,5,2,9,695,778,1473,1225
0131-002,2015,5,2,10,681,888,1569,1473
0131-002,2015,5,2,11,798,1104,1902,1569
0131-002,2015,5,2,12,770,1113,1883,1902
0131-002,2015,5,2,13,800,1109,1909,1883
0131-002,2015,5,2,14,772,983,1755,1909
0131-002,2015,5,2,15,792,1008,1800,1755
0131-002,2015,5,2,16,896,950,1846,1800
0131-002,2015,5,2,17,1033,1096,2129,1846
0131-002,2015,5,2,18,1176,1086,2262,2129
0131-002,2015,5,2,19,1171,918,2089,2262
0131-002,2015,5,2,20,1073,553,1626,2089
0131-002,2015,5,2,21,707,431,1138,1626
0131-002,2015,5,2,22,516,324,840,1138
0131-002,2015,5,2,23,466,224,690,840
0131-002,2015,5,2,24,183,144,327,690
0131-002,2015,5,3,1,74,81,155,327
0131-002,2015,5,3,2,46,49,95,155
0131-002,2015,5,3,3,34,49,83,95
0131-002,2015,5,3,4,24,34,58,83
0131-002,2015,5,3,5,42,24,66,58
0131-002,2015,5,3,6,50,45,95,66
0131-002,2015,5,3,7,154,93,247,95
0131-002,2015,5,3,8,195,175,370,247
0131-002,2015,5,3,9,205,440,645,370
0131-002,2015,5,3,10,299,531,830,645
0131-002,2015,5,3,11,398,504,902,830
0131-002,2015,5,3,12,561,622,1183,902
0131-002,2015,5,3,13,532,567,1099,1183
0131-002,2015,5,3,14,557,450,1007,1099
0131-002,2015,5,3,15,907,656,1563,1007
0131-002,2015,5,3,16,1242,634,1876,1563
0131-002,2015,5,3,17,1349,963,2312,1876
0131-002,2015,5,3,18,1220,1197,2417,2312
0131-002,2015,5,3,19,1271,1083,2354,2417
0131-002,2015,5,3,20,1399,879,2278,2354
0131-002,2015,5,3,21,1084,684,1768,2278
0131-002,2015,5,3,22,1631,534,2165,1768
0131-002,2015,5,3,23,1005,192,1197,2165
0131-002,2015,5,3,24,528,256,784,1197
0131-002,2015,5,4,1,203,159,362,784
0131-002,2015,5,4,2,52,118,170,362
0131-002,2015,5,4,3,20,86,106,170
0131-002,2015,5,4,4,28,100,128,106
0131-002,2015,5,4,5,24,143,167,128
0131-002,2015,5,4,6,215,274,489,167
0131-002,2015,5,4,7,784,454,1238,489
0131-002,2015,5,4,8,1529,1193,2722,1238
0131-002,2015,5,4,9,1098,1420,2518,2722
0131-002,2015,5,4,10,776,1295,2071,2518
0131-002,2015,5,4,11,929,1241,2170,2071
0131-002,2015,5,4,12,892,1461,2353,2170
0131-002,2015,5,4,13,738,1259,1997,2353
0131-002,2015,5,4,14,830,1127,1957,1997
0131-002,2015,5,4,15,899,1234,2133,1957
0131-002,2015,5,4,16,868,1406,2274,2133
0131-002,2015,5,4,17,796,1325,2121,2274
0131-002,2015,5,4,18,1013,1510,2523,2121
0131-002,2015,5,4,19,1078,1375,2453,2523
0131-002,2015,5,4,20,979,549,1528,2453
0131-002,2015,5,4,21,667,299,966,1528
0131-002,2015,5,4,22,462,467,929,966
0131-002,2015,5,4,23,335,467,802,929
0131-002,2015,5,4,24,191,361,552,802
0131-002,2015,5,5,1,80,247,327,552
0131-002,2015,5,5,2,52,163,215,327
0131-002,2015,5,5,3,30,108,138,215
0131-002,2015,5,5,4,34,118,152,138
0131-002,2015,5,5,5,42,117,159,152
0131-002,2015,5,5,6,174,179,353,159
0131-002,2015,5,5,7,388,427,815,353
0131-002,2015,5,5,8,526,766,1292,815
0131-002,2015,5,5,9,528,904,1432,1292
0131-002,2015,5,5,10,565,574,1139,1432
0131-002,2015,5,5,11,633,795,1428,1139
0131-002,2015,5,5,12,639,749,1388,1428
0131-002,2015,5,5,13,603,841,1444,1388
0131-002,2015,5,5,14,549,890,1439,1444
0131-002,2015,5,5,15,667,1138,1805,1439
0131-002,2015,5,5,16,693,1418,2111,1805
0131-002,2015,5,5,17,754,1465,2219,2111
0131-002,2015,5,5,18,783,1529,2312,2219
0131-002,2015,5,5,19,667,918,1585,2312
0131-002,2015,5,5,20,641,224,865,1585
0131-002,2015,5,5,21,448,106,554,865
0131-002,2015,5,5,22,380,149,529,554
0131-002,2015,5,5,23,245,59,304,529
0131-002,2015,5,5,24,130,34,164,304
0131-002,2015,5,6,1,82,17,99,164
0131-002,2015,5,6,2,28,17,45,99
0131-002,2015,5,6,3,36,38,74,45
0131-002,2015,5,6,4,36,25,61,74
0131-002,2015,5,6,5,52,25,77,61
0131-002,2015,5,6,6,219,202,421,77
0131-002,2015,5,6,7,939,504,1443,421
0131-002,2015,5,6,8,2242,797,3039,1443
0131-002,2015,5,6,9,1669,998,2667,3039
0131-002,2015,5,6,10,977,872,1849,2667
0131-002,2015,5,6,11,933,864,1797,1849
0131-002,2015,5,6,12,806,858,1664,1797
0131-002,2015,5,6,13,724,726,1450,1664
0131-002,2015,5,6,14,826,807,1633,1450
0131-002,2015,5,6,15,987,900,1887,1633
0131-002,2015,5,6,16,969,920,1889,1887
0131-002,2015,5,6,17,830,944,1774,1889
0131-002,2015,5,6,18,894,1136,2030,1774
0131-002,2015,5,6,19,965,1102,2067,2030
0131-002,2015,5,6,20,701,790,1491,2067
0131-002,2015,5,6,21,392,663,1055,1491
0131-002,2015,5,6,22,345,354,699,1055
0131-002,2015,5,6,23,249,297,546,699
0131-002,2015,5,6,24,199,317,516,546
0131-002,2015,5,7,1,96,249,345,516
0131-002,2015,5,7,2,46,161,207,345
0131-002,2015,5,7,3,38,33,71,207
0131-002,2015,5,7,4,26,74,100,71
0131-002,2015,5,7,5,48,133,181,100
0131-002,2015,5,7,6,221,288,509,181
0131-002,2015,5,7,7,832,292,1124,509
0131-002,2015,5,7,8,2062,796,2858,1124
0131-002,2015,5,7,9,1592,1008,2600,2858
0131-002,2015,5,7,10,971,816,1787,2600
0131-002,2015,5,7,11,923,844,1767,1787
0131-002,2015,5,7,12,826,790,1616,1767
0131-002,2015,5,7,13,661,714,1375,1616
0131-002,2015,5,7,14,842,751,1593,1375
0131-002,2015,5,7,15,911,853,1764,1593
0131-002,2015,5,7,16,880,862,1742,1764
0131-002,2015,5,7,17,856,892,1748,1742
0131-002,2015,5,7,18,953,992,1945,1748
0131-002,2015,5,7,19,915,988,1903,1945
0131-002,2015,5,7,20,703,730,1433,1903
0131-002,2015,5,7,21,454,622,1076,1433
0131-002,2015,5,7,22,416,392,808,1076
0131-002,2015,5,7,23,237,227,464,808
0131-002,2015,5,7,24,187,65,252,464
0131-002,2015,5,8,1,88,65,153,252
0131-002,2015,5,8,2,46,13,59,153
0131-002,2015,5,8,3,34,25,59,59
0131-002,2015,5,8,4,34,24,58,59
0131-002,2015,5,8,5,34,29,63,58
0131-002,2015,5,8,6,237,192,429,63
0131-002,2015,5,8,7,862,270,1132,429
0131-002,2015,5,8,8,1967,722,2689,1132
0131-002,2015,5,8,9,1598,992,2590,2689
0131-002,2015,5,8,10,1076,1018,2094,2590
0131-002,2015,5,8,11,915,1110,2025,2094
0131-002,2015,5,8,12,971,1026,1997,2025
0131-002,2015,5,8,13,810,1035,1845,1997
0131-002,2015,5,8,14,915,1038,1953,1845
0131-002,2015,5,8,15,1005,1156,2161,1953
0131-002,2015,5,8,16,1090,1212,2302,2161
0131-002,2015,5,8,17,969,1145,2114,2302
0131-002,2015,5,8,18,1236,1162,2398,2114
0131-002,2015,5,8,19,1309,1137,2446,2398
0131-002,2015,5,8,20,981,894,1875,2446
0131-002,2015,5,8,21,697,722,1419,1875
0131-002,2015,5,8,22,567,542,1109,1419
0131-002,2015,5,8,23,341,332,673,1109
0131-002,2015,5,8,24,154,214,368,673
0131-002,2015,5,9,1,122,47,169,368
0131-002,2015,5,9,2,72,84,156,169
0131-002,2015,5,9,3,38,56,94,156
0131-002,2015,5,9,4,40,49,89,94
0131-002,2015,5,9,5,44,33,77,89
0131-002,2015,5,9,6,281,100,381,77
0131-002,2015,5,9,7,555,250,805,381
0131-002,2015,5,9,8,937,506,1443,805
0131-002,2015,5,9,9,915,747,1662,1443
0131-002,2015,5,9,10,752,841,1593,1662
0131-002,2015,5,9,11,780,1082,1862,1593
0131-002,2015,5,9,12,965,1068,2033,1862
0131-002,2015,5,9,13,792,1090,1882,2033
0131-002,2015,5,9,14,796,998,1794,1882
0131-002,2015,5,9,15,949,980,1929,1794
0131-002,2015,5,9,16,899,940,1839,1929
0131-002,2015,5,9,17,945,1108,2053,1839
0131-002,2015,5,9,18,1106,1078,2184,2053
0131-002,2015,5,9,19,1202,888,2090,2184
0131-002,2015,5,9,20,848,538,1386,2090
0131-002,2015,5,9,21,547,428,975,1386
0131-002,2015,5,9,22,426,321,747,975
0131-002,2015,5,9,23,221,224,445,747
0131-002,2015,5,9,24,118,142,260,445
0131-002,2015,5,10,1,80,58,138,260
0131-002,2015,5,10,2,50,49,99,138
0131-002,2015,5,10,3,22,38,60,99
0131-002,2015,5,10,4,30,40,70,60
0131-002,2015,5,10,5,32,15,47,70
0131-002,2015,5,10,6,110,58,168,47
0131-002,2015,5,10,7,281,106,387,168
0131-002,2015,5,10,8,372,194,566,387
0131-002,2015,5,10,9,311,376,687,566
0131-002,2015,5,10,10,319,444,763,687
0131-002,2015,5,10,11,436,482,918,763
0131-002,2015,5,10,12,484,542,1026,918
0131-002,2015,5,10,13,502,510,1012,1026
0131-002,2015,5,10,14,532,472,1004,1012
0131-002,2015,5,10,15,655,600,1255,1004
0131-002,2015,5,10,16,768,618,1386,1255
0131-002,2015,5,10,17,1057,760,1817,1386
0131-002,2015,5,10,18,1339,886,2225,1817
0131-002,2015,5,10,19,1352,807,2159,2225
0131-002,2015,5,10,20,1206,651,1857,2159
0131-002,2015,5,10,21,1132,524,1656,1857
0131-002,2015,5,10,22,951,414,1365,1656
0131-002,2015,5,10,23,510,186,696,1365
0131-002,2015,5,10,24,170,189,359,696
0131-002,2015,5,11,1,92,58,150,359
0131-002,2015,5,11,2,52,29,81,150
0131-002,2015,5,11,3,14,20,34,81
0131-002,2015,5,11,4,32,20,52,34
0131-002,2015,5,11,5,42,11,53,52
0131-002,2015,5,11,6,335,123,458,53
0131-002,2015,5,11,7,1150,324,1474,458
0131-002,2015,5,11,8,2210,894,3104,1474
0131-002,2015,5,11,9,1592,980,2572,3104
0131-002,2015,5,11,10,1005,829,1834,2572
0131-002,2015,5,11,11,935,840,1775,1834
0131-002,2015,5,11,12,836,820,1656,1775
0131-002,2015,5,11,13,699,706,1405,1656
0131-002,2015,5,11,14,772,807,1579,1405
0131-002,2015,5,11,15,957,892,1849,1579
0131-002,2015,5,11,16,957,932,1889,1849
0131-002,2015,5,11,17,752,917,1669,1889
0131-002,2015,5,11,18,828,1063,1891,1669
0131-002,2015,5,11,19,894,998,1892,1891
0131-002,2015,5,11,20,508,766,1274,1892
0131-002,2015,5,11,21,400,695,1095,1274
0131-002,2015,5,11,22,319,508,827,1095
0131-002,2015,5,11,23,215,296,511,827
0131-002,2015,5,11,24,128,174,302,511
0131-002,2015,5,12,1,48,161,209,302
0131-002,2015,5,12,2,42,92,134,209
0131-002,2015,5,12,3,18,58,76,134
0131-002,2015,5,12,4,26,108,134,76
0131-002,2015,5,12,5,38,54,92,134
0131-002,2015,5,12,6,102,215,317,92
0131-002,2015,5,12,7,665,452,1117,317
0131-002,2015,5,12,8,1849,961,2810,1117
0131-002,2015,5,12,9,1540,1232,2772,2810
0131-002,2015,5,12,10,923,1084,2007,2772
0131-002,2015,5,12,11,901,1038,1939,2007
0131-002,2015,5,12,12,798,916,1714,1939
0131-002,2015,5,12,13,679,728,1407,1714
0131-002,2015,5,12,14,864,818,1682,1407
0131-002,2015,5,12,15,838,900,1738,1682
0131-002,2015,5,12,16,806,908,1714,1738
0131-002,2015,5,12,17,802,880,1682,1714
0131-002,2015,5,12,18,927,1022,1949,1682
0131-002,2015,5,12,19,965,980,1945,1949
0131-002,2015,5,12,20,709,724,1433,1945
0131-002,2015,5,12,21,422,676,1098,1433
0131-002,2015,5,12,22,337,496,833,1098
0131-002,2015,5,12,23,215,260,475,833
0131-002,2015,5,12,24,122,189,311,475
0131-002,2015,5,13,1,74,250,324,311
0131-002,2015,5,13,2,42,159,201,324
0131-002,2015,5,13,3,22,138,160,201
0131-002,2015,5,13,4,30,118,148,160
0131-002,2015,5,13,5,44,179,223,148
0131-002,2015,5,13,6,189,329,518,223
0131-002,2015,5,13,7,872,400,1272,518
0131-002,2015,5,13,8,1934,798,2732,1272
0131-002,2015,5,13,9,1663,988,2651,2732
0131-002,2015,5,13,10,937,888,1825,2651
0131-002,2015,5,13,11,888,867,1755,1825
0131-002,2015,5,13,12,842,846,1688,1755
0131-002,2015,5,13,13,758,725,1483,1688
0131-002,2015,5,13,14,876,829,1705,1483
0131-002,2015,5,13,15,999,924,1923,1705
0131-002,2015,5,13,16,886,924,1810,1923
0131-002,2015,5,13,17,804,942,1746,1810
0131-002,2015,5,13,18,890,1116,2006,1746
0131-002,2015,5,13,19,886,1107,1993,2006
0131-002,2015,5,13,20,609,804,1413,1993
0131-002,2015,5,13,21,466,681,1147,1413
0131-002,2015,5,13,22,384,440,824,1147
0131-002,2015,5,13,23,279,299,578,824
0131-002,2015,5,13,24,193,168,361,578
0131-002,2015,5,14,1,92,113,205,361
0131-002,2015,5,14,2,66,61,127,205
0131-002,2015,5,14,3,30,25,55,127
0131-002,2015,5,14,4,44,22,66,55
0131-002,2015,5,14,5,46,38,84,66
0131-002,2015,5,14,6,193,209,402,84
0131-002,2015,5,14,7,864,294,1158,402
0131-002,2015,5,14,8,1886,780,2666,1158
0131-002,2015,5,14,9,1558,1000,2558,2666
0131-002,2015,5,14,10,913,786,1699,2558
0131-002,2015,5,14,11,939,826,1765,1699
0131-002,2015,5,14,12,764,774,1538,1765
0131-002,2015,5,14,13,625,703,1328,1538
0131-002,2015,5,14,14,933,724,1657,1328
0131-002,2015,5,14,15,945,834,1779,1657
0131-002,2015,5,14,16,953,828,1781,1779
0131-002,2015,5,14,17,911,864,1775,1781
0131-002,2015,5,14,18,1029,956,1985,1775
0131-002,2015,5,14,19,973,946,1919,1985
0131-002,2015,5,14,20,643,688,1331,1919
0131-002,2015,5,14,21,450,596,1046,1331
0131-002,2015,5,14,22,390,304,694,1046
0131-002,2015,5,14,23,287,154,441,694
0131-002,2015,5,14,24,162,131,293,441
0131-002,2015,5,15,1,118,179,297,293
0131-002,2015,5,15,2,68,65,133,297
0131-002,2015,5,15,3,42,31,73,133
0131-002,2015,5,15,4,34,27,61,73
0131-002,2015,5,15,5,42,34,76,61
0131-002,2015,5,15,6,199,148,347,76
0131-002,2015,5,15,7,842,252,1094,347
0131-002,2015,5,15,8,1972,674,2646,1094
0131-002,2015,5,15,9,1602,979,2581,2646
0131-002,2015,5,15,10,923,1104,2027,2581
0131-002,2015,5,15,11,915,1238,2153,2027
0131-002,2015,5,15,12,836,1116,1952,2153
0131-002,2015,5,15,13,730,1192,1922,1952
0131-002,2015,5,15,14,892,1168,2060,1922
0131-002,2015,5,15,15,985,1282,2267,2060
0131-002,2015,5,15,16,953,1351,2304,2267
0131-002,2015,5,15,17,995,1201,2196,2304
0131-002,2015,5,15,18,1092,1118,2210,2196
0131-002,2015,5,15,19,1255,1110,2365,2210
0131-002,2015,5,15,20,947,875,1822,2365
0131-002,2015,5,15,21,575,710,1285,1822
0131-002,2015,5,15,22,532,540,1072,1285
0131-002,2015,5,15,23,331,334,665,1072
0131-002,2015,5,15,24,231,320,551,665
0131-002,2015,5,16,1,100,233,333,551
0131-002,2015,5,16,2,64,218,282,333
0131-002,2015,5,16,3,48,149,197,282
0131-002,2015,5,16,4,36,136,172,197
0131-002,2015,5,16,5,122,163,285,172
0131-002,2015,5,16,6,207,275,482,285
0131-002,2015,5,16,7,675,547,1222,482
0131-002,2015,5,16,8,1009,506,1515,1222
0131-002,2015,5,16,9,991,762,1753,1515
0131-002,2015,5,16,10,750,864,1614,1753
0131-002,2015,5,16,11,850,1093,1943,1614
0131-002,2015,5,16,12,814,1090,1904,1943
0131-002,2015,5,16,13,762,1100,1862,1904
0131-002,2015,5,16,14,762,990,1752,1862
0131-002,2015,5,16,15,790,994,1784,1752
0131-002,2015,5,16,16,880,945,1825,1784
0131-002,2015,5,16,17,929,1102,2031,1825
0131-002,2015,5,16,18,1040,1082,2122,2031
0131-002,2015,5,16,19,1023,903,1926,2122
0131-002,2015,5,16,20,607,546,1153,1926
0131-002,2015,5,16,21,376,430,806,1153
0131-002,2015,5,16,22,376,322,698,806
0131-002,2015,5,16,23,287,224,511,698
0131-002,2015,5,16,24,142,143,285,511
0131-002,2015,5,17,1,146,70,216,285
0131-002,2015,5,17,2,166,49,215,216
0131-002,2015,5,17,3,104,44,148,215
0131-002,2015,5,17,4,50,37,87,148
0131-002,2015,5,17,5,66,20,86,87
0131-002,2015,5,17,6,78,52,130,86
0131-002,2015,5,17,7,233,100,333,130
0131-002,2015,5,17,8,333,184,517,333
0131-002,2015,5,17,9,305,408,713,517
0131-002,2015,5,17,10,414,488,902,713
0131-002,2015,5,17,11,416,493,909,902
0131-002,2015,5,17,12,472,582,1054,909
0131-002,2015,5,17,13,498,538,1036,1054
0131-002,2015,5,17,14,565,461,1026,1036
0131-002,2015,5,17,15,643,628,1271,1026
0131-002,2015,5,17,16,715,626,1341,1271
0131-002,2015,5,17,17,758,862,1620,1341
0131-002,2015,5,17,18,927,1042,1969,1620
0131-002,2015,5,17,19,1054,945,1999,1969
0131-002,2015,5,17,20,800,765,1565,1999
0131-002,2015,5,17,21,528,604,1132,1565
0131-002,2015,5,17,22,388,474,862,1132
0131-002,2015,5,17,23,317,189,506,862
0131-002,2015,5,17,24,255,222,477,506
0131-002,2015,5,18,1,150,2,152,477
0131-002,2015,5,18,2,86,17,103,152
0131-002,2015,5,18,3,44,13,57,103
0131-002,2015,5,18,4,34,11,45,57
0131-002,2015,5,18,5,66,77,143,45
0131-002,2015,5,18,6,388,198,586,143
0131-002,2015,5,18,7,1013,389,1402,586
0131-002,2015,5,18,8,2271,1044,3315,1402
0131-002,2015,5,18,9,1649,1200,2849,3315
0131-002,2015,5,18,10,890,1062,1952,2849
0131-002,2015,5,18,11,985,1040,2025,1952
0131-002,2015,5,18,12,899,1140,2039,2025
0131-002,2015,5,18,13,776,982,1758,2039
0131-002,2015,5,18,14,1254,967,2221,1758
0131-002,2015,5,18,15,1112,1063,2175,2221
0131-002,2015,5,18,16,1226,1169,2395,2175
0131-002,2015,5,18,17,1122,1121,2243,2395
0131-002,2015,5,18,18,897,1286,2183,2243
0131-002,2015,5,18,19,969,1186,2155,2183
0131-002,2015,5,18,20,645,658,1303,2155
0131-002,2015,5,18,21,468,497,965,1303
0131-002,2015,5,18,22,410,488,898,965
0131-002,2015,5,18,23,295,382,677,898
0131-002,2015,5,18,24,148,268,416,677
0131-002,2015,5,19,1,72,75,147,416
0131-002,2015,5,19,2,54,22,76,147
0131-002,2015,5,19,3,36,20,56,76
0131-002,2015,5,19,4,20,25,45,56
0131-002,2015,5,19,5,36,25,61,45
0131-002,2015,5,19,6,187,174,361,61
0131-002,2015,5,19,7,852,366,1218,361
0131-002,2015,5,19,8,1907,902,2809,1218
0131-002,2015,5,19,9,1615,1162,2777,2809
0131-002,2015,5,19,10,977,992,1969,2777
0131-002,2015,5,19,11,909,972,1881,1969
0131-002,2015,5,19,12,854,870,1724,1881
0131-002,2015,5,19,13,691,716,1407,1724
0131-002,2015,5,19,14,911,828,1739,1407
0131-002,2015,5,19,15,901,886,1787,1739
0131-002,2015,5,19,16,800,886,1686,1787
0131-002,2015,5,19,17,772,868,1640,1686
0131-002,2015,5,19,18,941,985,1926,1640
0131-002,2015,5,19,19,911,958,1869,1926
0131-002,2015,5,19,20,601,706,1307,1869
0131-002,2015,5,19,21,436,845,1281,1307
0131-002,2015,5,19,22,345,484,829,1281
0131-002,2015,5,19,23,239,288,527,829
0131-002,2015,5,19,24,146,138,284,527
0131-002,2015,5,20,1,86,215,301,284
0131-002,2015,5,20,2,62,45,107,301
0131-002,2015,5,20,3,18,49,67,107
0131-002,2015,5,20,4,36,22,58,67
0131-002,2015,5,20,5,36,45,81,58
0131-002,2015,5,20,6,199,115,314,81
0131-002,2015,5,20,7,778,302,1080,314
0131-002,2015,5,20,8,1836,1091,2927,1080
0131-002,2015,5,20,9,1544,1174,2718,2927
0131-002,2015,5,20,10,1039,925,1964,2718
0131-002,2015,5,20,11,913,866,1779,1964
0131-002,2015,5,20,12,884,852,1736,1779
0131-002,2015,5,20,13,748,726,1474,1736
0131-002,2015,5,20,14,856,818,1674,1474
0131-002,2015,5,20,15,953,912,1865,1674
0131-002,2015,5,20,16,874,922,1796,1865
0131-002,2015,5,20,17,814,1108,1922,1796
0131-002,2015,5,20,18,858,1447,2305,1922
0131-002,2015,5,20,19,973,1327,2300,2305
0131-002,2015,5,20,20,651,831,1482,2300
0131-002,2015,5,20,21,490,674,1164,1482
0131-002,2015,5,20,22,440,458,898,1164
0131-002,2015,5,20,23,253,267,520,898
0131-002,2015,5,20,24,176,193,369,520
0131-002,2015,5,21,1,88,97,185,369
0131-002,2015,5,21,2,44,50,94,185
0131-002,2015,5,21,3,42,52,94,94
0131-002,2015,5,21,4,44,27,71,94
0131-002,2015,5,21,5,40,47,87,71
0131-002,2015,5,21,6,223,104,327,87
0131-002,2015,5,21,7,876,284,1160,327
0131-002,2015,5,21,8,1991,813,2804,1160
0131-002,2015,5,21,9,1669,1206,2875,2804
0131-002,2015,5,21,10,949,958,1907,2875
0131-002,2015,5,21,11,959,604,1563,1907
0131-002,2015,5,21,12,929,916,1845,1563
0131-002,2015,5,21,13,734,734,1468,1845
0131-002,2015,5,21,14,876,893,1769,1468
0131-002,2015,5,21,15,939,1040,1979,1769
0131-002,2015,5,21,16,979,1084,2063,1979
0131-002,2015,5,21,17,818,878,1696,2063
0131-002,2015,5,21,18,953,974,1927,1696
0131-002,2015,5,21,19,921,1317,2238,1927
0131-002,2015,5,21,20,681,974,1655,2238
0131-002,2015,5,21,21,486,793,1279,1655
0131-002,2015,5,21,22,440,554,994,1279
0131-002,2015,5,21,23,265,317,582,994
0131-002,2015,5,21,24,168,142,310,582
0131-002,2015,5,22,1,120,86,206,310
0131-002,2015,5,22,2,36,52,88,206
0131-002,2015,5,22,3,40,52,92,88
0131-002,2015,5,22,4,42,49,91,92
0131-002,2015,5,22,5,44,54,98,91
0131-002,2015,5,22,6,227,100,327,98
0131-002,2015,5,22,7,848,345,1193,327
0131-002,2015,5,22,8,1956,883,2839,1193
0131-002,2015,5,22,9,1514,1168,2682,2839
0131-002,2015,5,22,10,929,895,1824,2682
0131-002,2015,5,22,11,1041,834,1875,1824
0131-002,2015,5,22,12,820,831,1651,1875
0131-002,2015,5,22,13,711,784,1495,1651
0131-002,2015,5,22,14,836,925,1761,1495
0131-002,2015,5,22,15,1019,1066,2085,1761
0131-002,2015,5,22,16,1021,1127,2148,2085
0131-002,2015,5,22,17,973,1170,2143,2148
0131-002,2015,5,22,18,1122,1632,2754,2143
0131-002,2015,5,22,19,1261,1717,2978,2754
0131-002,2015,5,22,20,1031,1222,2253,2978
0131-002,2015,5,22,21,621,924,1545,2253
0131-002,2015,5,22,22,450,565,1015,1545
0131-002,2015,5,22,23,291,349,640,1015
0131-002,2015,5,22,24,189,200,389,640
0131-002,2015,5,23,1,110,147,257,389
0131-002,2015,5,23,2,82,83,165,257
0131-002,2015,5,23,3,52,67,119,165
0131-002,2015,5,23,4,44,49,93,119
0131-002,2015,5,23,5,48,63,111,93
0131-002,2015,5,23,6,231,117,348,111
0131-002,2015,5,23,7,530,320,850,348
0131-002,2015,5,23,8,939,615,1554,850
0131-002,2015,5,23,9,899,1079,1978,1554
0131-002,2015,5,23,10,880,1127,2007,1978
0131-002,2015,5,23,11,884,1331,2215,2007
0131-002,2015,5,23,12,1090,1357,2447,2215
0131-002,2015,5,23,13,987,1336,2323,2447
0131-002,2015,5,23,14,856,1336,2192,2323
0131-002,2015,5,23,15,830,1309,2139,2192
0131-002,2015,5,23,16,874,1254,2128,2139
0131-002,2015,5,23,17,882,1315,2197,2128
0131-002,2015,5,23,18,1082,1505,2587,2197
0131-002,2015,5,23,19,1031,1216,2247,2587
0131-002,2015,5,23,20,770,691,1461,2247
0131-002,2015,5,23,21,456,442,898,1461
0131-002,2015,5,23,22,317,290,607,898
0131-002,2015,5,23,23,221,193,414,607
0131-002,2015,5,23,24,120,138,258,414
0131-002,2015,5,24,1,76,90,166,258
0131-002,2015,5,24,2,40,43,83,166
0131-002,2015,5,24,3,32,47,79,83
0131-002,2015,5,24,4,20,38,58,79
0131-002,2015,5,24,5,32,29,61,58
0131-002,2015,5,24,6,90,65,155,61
0131-002,2015,5,24,7,219,145,364,155
0131-002,2015,5,24,8,327,229,556,364
0131-002,2015,5,24,9,317,411,728,556
0131-002,2015,5,24,10,388,458,846,728
0131-002,2015,5,24,11,536,542,1078,846
0131-002,2015,5,24,12,587,588,1175,1078
0131-002,2015,5,24,13,498,500,998,1175
0131-002,2015,5,24,14,482,468,950,998
0131-002,2015,5,24,15,635,468,1103,950
0131-002,2015,5,24,16,746,579,1325,1103
0131-002,2015,5,24,17,818,634,1452,1325
0131-002,2015,5,24,18,903,720,1623,1452
0131-002,2015,5,24,19,985,634,1619,1623
0131-002,2015,5,24,20,1002,488,1490,1619
0131-002,2015,5,24,21,884,434,1318,1490
0131-002,2015,5,24,22,703,338,1041,1318
0131-002,2015,5,24,23,549,174,723,1041
0131-002,2015,5,24,24,241,113,354,723
0131-002,2015,5,25,1,80,88,168,354
0131-002,2015,5,25,2,42,49,91,168
0131-002,2015,5,25,3,28,20,48,91
0131-002,2015,5,25,4,24,33,57,48
0131-002,2015,5,25,5,42,40,82,57
0131-002,2015,5,25,6,183,79,262,82
0131-002,2015,5,25,7,448,159,607,262
0131-002,2015,5,25,8,748,342,1090,607
0131-002,2015,5,25,9,506,484,990,1090
0131-002,2015,5,25,10,536,579,1115,990
0131-002,2015,5,25,11,581,574,1155,1115
0131-002,2015,5,25,12,740,618,1358,1155
0131-002,2015,5,25,13,820,550,1370,1358
0131-002,2015,5,25,14,1031,661,1692,1370
0131-002,2015,5,25,15,1059,675,1734,1692
0131-002,2015,5,25,16,1174,741,1915,1734
0131-002,2015,5,25,17,1550,929,2479,1915
0131-002,2015,5,25,18,1321,996,2317,2479
0131-002,2015,5,25,19,1236,740,1976,2317
0131-002,2015,5,25,20,1088,561,1649,1976
0131-002,2015,5,25,21,740,415,1155,1649
0131-002,2015,5,25,22,541,267,808,1155
0131-002,2015,5,25,23,323,168,491,808
0131-002,2015,5,25,24,217,75,292,491
0131-002,2015,5,26,1,96,49,145,292
0131-002,2015,5,26,2,42,25,67,145
0131-002,2015,5,26,3,16,22,38,67
0131-002,2015,5,26,4,42,24,66,38
0131-002,2015,5,26,5,54,36,90,66
0131-002,2015,5,26,6,267,131,398,90
0131-002,2015,5,26,7,977,367,1344,398
0131-002,2015,5,26,8,2260,925,3185,1344
0131-002,2015,5,26,9,1651,1147,2798,3185
0131-002,2015,5,26,10,1015,916,1931,2798
0131-002,2015,5,26,11,903,966,1869,1931
0131-002,2015,5,26,12,909,908,1817,1869
0131-002,2015,5,26,13,667,774,1441,1817
0131-002,2015,5,26,14,945,822,1767,1441
0131-002,2015,5,26,15,1005,990,1995,1767
0131-002,2015,5,26,16,846,958,1804,1995
0131-002,2015,5,26,17,854,1047,1901,1804
0131-002,2015,5,26,18,979,1550,2529,1901
0131-002,2015,5,26,19,1208,1431,2639,2529
0131-002,2015,5,26,20,820,977,1797,2639
0131-002,2015,5,26,21,470,881,1351,1797
0131-002,2015,5,26,22,396,529,925,1351
0131-002,2015,5,26,23,241,295,536,925
0131-002,2015,5,26,24,82,133,215,536
0131-002,2015,5,27,1,90,115,205,215
0131-002,2015,5,27,2,42,58,100,205
0131-002,2015,5,27,3,30,38,68,100
0131-002,2015,5,27,4,50,38,88,68
0131-002,2015,5,27,5,40,65,105,88
0131-002,2015,5,27,6,217,109,326,105
0131-002,2015,5,27,7,804,274,1078,326
0131-002,2015,5,27,8,2046,879,2925,1078
0131-002,2015,5,27,9,1554,1156,2710,2925
0131-002,2015,5,27,10,913,1240,2153,2710
0131-002,2015,5,27,11,959,968,1927,2153
0131-002,2015,5,27,12,903,915,1818,1927
0131-002,2015,5,27,13,724,790,1514,1818
0131-002,2015,5,27,14,880,825,1705,1514
0131-002,2015,5,27,15,1015,1002,2017,1705
0131-002,2015,5,27,16,1001,1097,2098,2017
0131-002,2015,5,27,17,864,1061,1925,2098
0131-002,2015,5,27,18,923,1530,2453,1925
0131-002,2015,5,27,19,905,1332,2237,2453
0131-002,2015,5,27,20,718,1036,1754,2237
0131-002,2015,5,27,21,516,829,1345,1754
0131-002,2015,5,27,22,360,465,825,1345
0131-002,2015,5,27,23,235,350,585,825
0131-002,2015,5,27,24,136,190,326,585
0131-002,2015,5,28,1,106,108,214,326
0131-002,2015,5,28,2,42,54,96,214
0131-002,2015,5,28,3,32,54,86,96
0131-002,2015,5,28,4,28,47,75,86
0131-002,2015,5,28,5,48,59,107,75
0131-002,2015,5,28,6,209,99,308,107
0131-002,2015,5,28,7,846,300,1146,308
0131-002,2015,5,28,8,1995,895,2890,1146
0131-002,2015,5,28,9,1659,1225,2884,2890
0131-002,2015,5,28,10,979,997,1976,2884
0131-002,2015,5,28,11,1029,925,1954,1976
0131-002,2015,5,28,12,959,966,1925,1954
0131-002,2015,5,28,13,711,724,1435,1925
0131-002,2015,5,28,14,880,802,1682,1435
0131-002,2015,5,28,15,1033,941,1974,1682
0131-002,2015,5,28,16,931,975,1906,1974
0131-002,2015,5,28,17,852,1113,1965,1906
0131-002,2015,5,28,18,999,1406,2405,1965
0131-002,2015,5,28,19,872,1265,2137,2405
0131-002,2015,5,28,20,639,993,1632,2137
0131-002,2015,5,28,21,532,784,1316,1632
0131-002,2015,5,28,22,418,531,949,1316
0131-002,2015,5,28,23,265,434,699,949
0131-002,2015,5,28,24,136,256,392,699
0131-002,2015,5,29,1,80,188,268,392
0131-002,2015,5,29,2,56,115,171,268
0131-002,2015,5,29,3,20,168,188,171
0131-002,2015,5,29,4,32,129,161,188
0131-002,2015,5,29,5,54,88,142,161
0131-002,2015,5,29,6,231,243,474,142
0131-002,2015,5,29,7,868,645,1513,474
0131-002,2015,5,29,8,2096,1474,3570,1513
0131-002,2015,5,29,9,1566,1463,3029,3570
0131-002,2015,5,29,10,975,1000,1975,3029
0131-002,2015,5,29,11,965,966,1931,1975
0131-002,2015,5,29,12,917,1043,1960,1931
0131-002,2015,5,29,13,709,1186,1895,1960
0131-002,2015,5,29,14,848,883,1731,1895
0131-002,2015,5,29,15,973,1059,2032,1731
0131-002,2015,5,29,16,1031,1045,2076,2032
0131-002,2015,5,29,17,927,1134,2061,2076
0131-002,2015,5,29,18,967,1654,2621,2061
0131-002,2015,5,29,19,1120,1563,2683,2621
0131-002,2015,5,29,20,913,1088,2001,2683
0131-002,2015,5,29,21,549,806,1355,2001
0131-002,2015,5,29,22,380,522,902,1355
0131-002,2015,5,29,23,319,304,623,902
0131-002,2015,5,29,24,164,134,298,623
0131-002,2015,5,30,1,100,120,220,298
0131-002,2015,5,30,2,66,68,134,220
0131-002,2015,5,30,3,48,47,95,134
0131-002,2015,5,30,4,32,43,75,95
0131-002,2015,5,30,5,46,63,109,75
0131-002,2015,5,30,6,168,108,276,109
0131-002,2015,5,30,7,430,227,657,276
0131-002,2015,5,30,8,874,641,1515,657
0131-002,2015,5,30,9,907,831,1738,1515
0131-002,2015,5,30,10,713,865,1578,1738
0131-002,2015,5,30,11,786,1326,2112,1578
0131-002,2015,5,30,12,720,1209,1929,2112
0131-002,2015,5,30,13,579,815,1394,1929
0131-002,2015,5,30,14,631,856,1487,1394
0131-002,2015,5,30,15,707,827,1534,1487
0131-002,2015,5,30,16,722,802,1524,1534
0131-002,2015,5,30,17,907,829,1736,1524
0131-002,2015,5,30,18,1035,1008,2043,1736
0131-002,2015,5,30,19,947,711,1658,2043
0131-002,2015,5,30,20,595,529,1124,1658
0131-002,2015,5,30,21,376,359,735,1124
0131-002,2015,5,30,22,305,233,538,735
0131-002,2015,5,30,23,215,179,394,538
0131-002,2015,5,30,24,160,129,289,394
0131-002,2015,5,31,1,84,109,193,289
0131-002,2015,5,31,2,50,74,124,193
0131-002,2015,5,31,3,34,33,67,124
0131-002,2015,5,31,4,26,42,68,67
0131-002,2015,5,31,5,18,43,61,68
0131-002,2015,5,31,6,110,67,177,61
0131-002,2015,5,31,7,247,111,358,177
0131-002,2015,5,31,8,347,224,571,358
0131-002,2015,5,31,9,311,300,611,571
0131-002,2015,5,31,10,333,429,762,611
0131-002,2015,5,31,11,370,442,812,762
0131-002,2015,5,31,12,496,649,1145,812
0131-002,2015,5,31,13,416,486,902,1145
0131-002,2015,5,31,14,555,502,1057,902
0131-002,2015,5,31,15,611,595,1206,1057
0131-002,2015,5,31,16,748,575,1323,1206
0131-002,2015,5,31,17,683,685,1368,1323
0131-002,2015,5,31,18,794,691,1485,1368
0131-002,2015,5,31,19,744,508,1252,1485
0131-002,2015,5,31,20,595,395,990,1252
0131-002,2015,5,31,21,472,386,858,990
0131-002,2015,5,31,22,432,249,681,858
0131-002,2015,5,31,23,245,143,388,681
0131-002,2015,5,31,24,142,74,216,388
0131-002,2015,6,1,1,83,20,103,216
0131-002,2015,6,1,2,37,30,67,103
0131-002,2015,6,1,3,21,16,37,67
0131-002,2015,6,1,4,23,16,39,37
0131-002,2015,6,1,5,31,22,53,39
0131-002,2015,6,1,6,252,138,390,53
0131-002,2015,6,1,7,1054,274,1328,390
0131-002,2015,6,1,8,2242,693,2935,1328
0131-002,2015,6,1,9,1603,842,2445,2935
0131-002,2015,6,1,10,875,820,1695,2445
0131-002,2015,6,1,11,945,807,1752,1695
0131-002,2015,6,1,12,803,879,1682,1752
0131-002,2015,6,1,13,628,766,1394,1682
0131-002,2015,6,1,14,813,814,1627,1394
0131-002,2015,6,1,15,843,869,1712,1627
0131-002,2015,6,1,16,839,955,1794,1712
0131-002,2015,6,1,17,817,1025,1842,1794
0131-002,2015,6,1,18,935,1181,2116,1842
0131-002,2015,6,1,19,849,1174,2023,2116
0131-002,2015,6,1,20,722,748,1470,2023
0131-002,2015,6,1,21,451,596,1047,1470
0131-002,2015,6,1,22,405,362,767,1047
0131-002,2015,6,1,23,238,177,415,767
0131-002,2015,6,1,24,115,99,214,415
0131-002,2015,6,2,1,63,68,131,214
0131-002,2015,6,2,2,49,36,85,131
0131-002,2015,6,2,3,23,36,59,85
0131-002,2015,6,2,4,19,23,42,59
0131-002,2015,6,2,5,51,42,93,42
0131-002,2015,6,2,6,220,88,308,93
0131-002,2015,6,2,7,819,319,1138,308
0131-002,2015,6,2,8,1928,894,2822,1138
0131-002,2015,6,2,9,1581,1369,2950,2822
0131-002,2015,6,2,10,919,849,1768,2950
0131-002,2015,6,2,11,907,867,1774,1768
0131-002,2015,6,2,12,877,799,1676,1774
0131-002,2015,6,2,13,702,741,1443,1676
0131-002,2015,6,2,14,855,934,1789,1443
0131-002,2015,6,2,15,931,1035,1966,1789
0131-002,2015,6,2,16,965,1020,1985,1966
0131-002,2015,6,2,17,762,917,1679,1985
0131-002,2015,6,2,18,897,1215,2112,1679
0131-002,2015,6,2,19,937,1047,1984,2112
0131-002,2015,6,2,20,682,730,1412,1984
0131-002,2015,6,2,21,481,621,1102,1412
0131-002,2015,6,2,22,372,350,722,1102
0131-002,2015,6,2,23,246,194,440,722
0131-002,2015,6,2,24,147,115,262,440
0131-002,2015,6,3,1,79,74,153,262
0131-002,2015,6,3,2,57,30,87,153
0131-002,2015,6,3,3,39,42,81,87
0131-002,2015,6,3,4,27,30,57,81
0131-002,2015,6,3,5,53,34,87,57
0131-002,2015,6,3,6,248,112,360,87
0131-002,2015,6,3,7,827,288,1115,360
0131-002,2015,6,3,8,2002,985,2987,1115
0131-002,2015,6,3,9,1625,1165,2790,2987
0131-002,2015,6,3,10,1028,1082,2110,2790
0131-002,2015,6,3,11,935,917,1852,2110
0131-002,2015,6,3,12,811,884,1695,1852
0131-002,2015,6,3,13,680,758,1438,1695
0131-002,2015,6,3,14,827,822,1649,1438
0131-002,2015,6,3,15,935,957,1892,1649
0131-002,2015,6,3,16,961,1010,1971,1892
0131-002,2015,6,3,17,807,1084,1891,1971
0131-002,2015,6,3,18,931,1488,2419,1891
0131-002,2015,6,3,19,943,1146,2089,2419
0131-002,2015,6,3,20,714,741,1455,2089
0131-002,2015,6,3,21,507,575,1082,1455
0131-002,2015,6,3,22,372,314,686,1082
0131-002,2015,6,3,23,252,200,452,686
0131-002,2015,6,3,24,131,92,223,452
0131-002,2015,6,4,1,95,74,169,223
0131-002,2015,6,4,2,57,36,93,169
0131-002,2015,6,4,3,31,30,61,93
0131-002,2015,6,4,4,35,33,68,61
0131-002,2015,6,4,5,43,40,83,68
0131-002,2015,6,4,6,224,102,326,83
0131-002,2015,6,4,7,883,292,1175,326
0131-002,2015,6,4,8,1980,854,2834,1175
0131-002,2015,6,4,9,1607,1216,2823,2834
0131-002,2015,6,4,10,913,978,1891,2823
0131-002,2015,6,4,11,933,764,1697,1891
0131-002,2015,6,4,12,861,941,1802,1697
0131-002,2015,6,4,13,620,729,1349,1802
0131-002,2015,6,4,14,758,848,1606,1349
0131-002,2015,6,4,15,855,990,1845,1606
0131-002,2015,6,4,16,833,1030,1863,1845
0131-002,2015,6,4,17,885,996,1881,1863
0131-002,2015,6,4,18,937,1129,2066,1881
0131-002,2015,6,4,19,901,1051,1952,2066
0131-002,2015,6,4,20,656,716,1372,1952
0131-002,2015,6,4,21,477,606,1083,1372
0131-002,2015,6,4,22,368,295,663,1083
0131-002,2015,6,4,23,304,208,512,663
0131-002,2015,6,4,24,139,81,220,512
0131-002,2015,6,5,1,79,70,149,220
0131-002,2015,6,5,2,39,34,73,149
0131-002,2015,6,5,3,33,29,62,73
0131-002,2015,6,5,4,27,20,47,62
0131-002,2015,6,5,5,33,36,69,47
0131-002,2015,6,5,6,214,172,386,69
0131-002,2015,6,5,7,897,495,1392,386
0131-002,2015,6,5,8,2047,1178,3225,1392
0131-002,2015,6,5,9,1693,1316,3009,3225
0131-002,2015,6,5,10,869,948,1817,3009
0131-002,2015,6,5,11,853,900,1753,1817
0131-002,2015,6,5,12,799,937,1736,1753
0131-002,2015,6,5,13,684,985,1669,1736
0131-002,2015,6,5,14,774,805,1579,1669
0131-002,2015,6,5,15,921,960,1881,1579
0131-002,2015,6,5,16,899,835,1734,1881
0131-002,2015,6,5,17,841,787,1628,1734
0131-002,2015,6,5,18,1024,1262,2286,1628
0131-002,2015,6,5,19,1068,1287,2355,2286
0131-002,2015,6,5,20,841,1047,1888,2355
0131-002,2015,6,5,21,485,693,1178,1888
0131-002,2015,6,5,22,328,590,918,1178
0131-002,2015,6,5,23,302,440,742,918
0131-002,2015,6,5,24,145,304,449,742
0131-002,2015,6,6,1,83,176,259,449
0131-002,2015,6,6,2,67,115,182,259
0131-002,2015,6,6,3,55,81,136,182
0131-002,2015,6,6,4,27,90,117,136
0131-002,2015,6,6,5,63,118,181,117
0131-002,2015,6,6,6,173,194,367,181
0131-002,2015,6,6,7,499,379,878,367
0131-002,2015,6,6,8,772,526,1298,878
0131-002,2015,6,6,9,771,789,1560,1298
0131-002,2015,6,6,10,684,900,1584,1560
0131-002,2015,6,6,11,602,863,1465,1584
0131-002,2015,6,6,12,618,628,1246,1465
0131-002,2015,6,6,13,573,481,1054,1246
0131-002,2015,6,6,14,604,528,1132,1054
0131-002,2015,6,6,15,612,562,1174,1132
0131-002,2015,6,6,16,604,519,1123,1174
0131-002,2015,6,6,17,628,569,1197,1123
0131-002,2015,6,6,18,696,771,1467,1197
0131-002,2015,6,6,19,642,589,1231,1467
0131-002,2015,6,6,20,390,321,711,1231
0131-002,2015,6,6,21,296,232,528,711
0131-002,2015,6,6,22,252,160,412,528
0131-002,2015,6,6,23,191,102,293,412
0131-002,2015,6,6,24,97,64,161,293
0131-002,2015,6,7,1,67,53,120,161
0131-002,2015,6,7,2,33,34,67,120
0131-002,2015,6,7,3,45,20,65,67
0131-002,2015,6,7,4,29,20,49,65
0131-002,2015,6,7,5,19,22,41,49
0131-002,2015,6,7,6,75,39,114,41
0131-002,2015,6,7,7,202,94,296,114
0131-002,2015,6,7,8,234,149,383,296
0131-002,2015,6,7,9,240,198,438,383
0131-002,2015,6,7,10,226,248,474,438
0131-002,2015,6,7,11,282,306,588,474
0131-002,2015,6,7,12,302,244,546,588
0131-002,2015,6,7,13,312,272,584,546
0131-002,2015,6,7,14,413,316,729,584
0131-002,2015,6,7,15,453,360,813,729
0131-002,2015,6,7,16,551,358,909,813
0131-002,2015,6,7,17,885,358,1243,909
0131-002,2015,6,7,18,688,400,1088,1243
0131-002,2015,6,7,19,799,355,1154,1088
0131-002,2015,6,7,20,654,263,917,1154
0131-002,2015,6,7,21,415,227,642,917
0131-002,2015,6,7,22,388,136,524,642
0131-002,2015,6,7,23,200,94,294,524
0131-002,2015,6,7,24,133,54,187,294
0131-002,2015,6,8,1,79,39,118,187
0131-002,2015,6,8,2,37,13,50,118
0131-002,2015,6,8,3,17,6,23,50
0131-002,2015,6,8,4,23,12,35,23
0131-002,2015,6,8,5,41,30,71,35
0131-002,2015,6,8,6,252,108,360,71
0131-002,2015,6,8,7,1060,216,1276,360
0131-002,2015,6,8,8,2279,518,2797,1276
0131-002,2015,6,8,9,1651,663,2314,2797
0131-002,2015,6,8,10,849,700,1549,2314
0131-002,2015,6,8,11,865,690,1555,1549
0131-002,2015,6,8,12,885,748,1633,1555
0131-002,2015,6,8,13,688,658,1346,1633
0131-002,2015,6,8,14,801,738,1539,1346
0131-002,2015,6,8,15,887,1085,1972,1539
0131-002,2015,6,8,16,869,1119,1988,1972
0131-002,2015,6,8,17,801,1110,1911,1988
0131-002,2015,6,8,18,921,1030,1951,1911
0131-002,2015,6,8,19,879,1175,2054,1951
0131-002,2015,6,8,20,684,747,1431,2054
0131-002,2015,6,8,21,453,647,1100,1431
0131-002,2015,6,8,22,304,362,666,1100
0131-002,2015,6,8,23,220,283,503,666
0131-002,2015,6,8,24,123,167,290,503
0131-002,2015,6,9,1,101,155,256,290
0131-002,2015,6,9,2,49,104,153,256
0131-002,2015,6,9,3,37,115,152,153
0131-002,2015,6,9,4,47,75,122,152
0131-002,2015,6,9,5,35,148,183,122
0131-002,2015,6,9,6,222,237,459,183
0131-002,2015,6,9,7,817,525,1342,459
0131-002,2015,6,9,8,2012,802,2814,1342
0131-002,2015,6,9,9,1484,1024,2508,2814
0131-002,2015,6,9,10,943,934,1877,2508
0131-002,2015,6,9,11,883,888,1771,1877
0131-002,2015,6,9,12,764,897,1661,1771
0131-002,2015,6,9,13,664,647,1311,1661
0131-002,2015,6,9,14,783,591,1374,1311
0131-002,2015,6,9,15,927,693,1620,1374
0131-002,2015,6,9,16,720,754,1474,1620
0131-002,2015,6,9,17,807,828,1635,1474
0131-002,2015,6,9,18,871,1021,1892,1635
0131-002,2015,6,9,19,901,1037,1938,1892
0131-002,2015,6,9,20,654,640,1294,1938
0131-002,2015,6,9,21,509,689,1198,1294
0131-002,2015,6,9,22,358,395,753,1198
0131-002,2015,6,9,23,260,215,475,753
0131-002,2015,6,9,24,119,122,241,475
0131-002,2015,6,10,1,85,66,151,241
0131-002,2015,6,10,2,43,50,93,151
0131-002,2015,6,10,3,13,44,57,93
0131-002,2015,6,10,4,37,70,107,57
0131-002,2015,6,10,5,45,85,130,107
0131-002,2015,6,10,6,238,142,380,130
0131-002,2015,6,10,7,875,283,1158,380
0131-002,2015,6,10,8,2018,736,2754,1158
0131-002,2015,6,10,9,1530,919,2449,2754
0131-002,2015,6,10,10,961,713,1674,2449
0131-002,2015,6,10,11,851,702,1553,1674
0131-002,2015,6,10,12,879,672,1551,1553
0131-002,2015,6,10,13,682,542,1224,1551
0131-002,2015,6,10,14,742,597,1339,1224
0131-002,2015,6,10,15,905,690,1595,1339
0131-002,2015,6,10,16,853,664,1517,1595
0131-002,2015,6,10,17,817,863,1680,1517
0131-002,2015,6,10,18,919,1141,2060,1680
0131-002,2015,6,10,19,947,1057,2004,2060
0131-002,2015,6,10,20,708,767,1475,2004
0131-002,2015,6,10,21,507,610,1117,1475
0131-002,2015,6,10,22,395,299,694,1117
0131-002,2015,6,10,23,232,203,435,694
0131-002,2015,6,10,24,123,112,235,435
0131-002,2015,6,11,1,97,74,171,235
0131-002,2015,6,11,2,57,39,96,171
0131-002,2015,6,11,3,47,70,117,96
0131-002,2015,6,11,4,43,44,87,117
0131-002,2015,6,11,5,55,81,136,87
0131-002,2015,6,11,6,248,167,415,136
0131-002,2015,6,11,7,855,296,1151,415
0131-002,2015,6,11,8,1912,939,2851,1151
0131-002,2015,6,11,9,1528,1038,2566,2851
0131-002,2015,6,11,10,929,709,1638,2566
0131-002,2015,6,11,11,861,733,1594,1638
0131-002,2015,6,11,12,847,755,1602,1594
0131-002,2015,6,11,13,644,597,1241,1602
0131-002,2015,6,11,14,760,648,1408,1241
0131-002,2015,6,11,15,913,911,1824,1408
0131-002,2015,6,11,16,955,737,1692,1824
0131-002,2015,6,11,17,891,1048,1939,1692
0131-002,2015,6,11,18,917,1133,2050,1939
0131-002,2015,6,11,19,891,1194,2085,2050
0131-002,2015,6,11,20,650,893,1543,2085
0131-002,2015,6,11,21,445,757,1202,1543
0131-002,2015,6,11,22,298,637,935,1202
0131-002,2015,6,11,23,232,464,696,935
0131-002,2015,6,11,24,107,245,352,696
0131-002,2015,6,12,1,93,104,197,352
0131-002,2015,6,12,2,35,49,84,197
0131-002,2015,6,12,3,53,80,133,84
0131-002,2015,6,12,4,23,40,63,133
0131-002,2015,6,12,5,39,44,83,63
0131-002,2015,6,12,6,242,101,343,83
0131-002,2015,6,12,7,847,242,1089,343
0131-002,2015,6,12,8,1909,726,2635,1089
0131-002,2015,6,12,9,1631,921,2552,2635
0131-002,2015,6,12,10,980,788,1768,2552
0131-002,2015,6,12,11,875,730,1605,1768
0131-002,2015,6,12,12,768,748,1516,1605
0131-002,2015,6,12,13,632,659,1291,1516
0131-002,2015,6,12,14,819,737,1556,1291
0131-002,2015,6,12,15,853,771,1624,1556
0131-002,2015,6,12,16,861,767,1628,1624
0131-002,2015,6,12,17,841,910,1751,1628
0131-002,2015,6,12,18,903,1399,2302,1751
0131-002,2015,6,12,19,1012,1503,2515,2302
0131-002,2015,6,12,20,887,1290,2177,2515
0131-002,2015,6,12,21,549,794,1343,2177
0131-002,2015,6,12,22,459,611,1070,1343
0131-002,2015,6,12,23,232,272,504,1070
0131-002,2015,6,12,24,143,140,283,504
0131-002,2015,6,13,1,123,81,204,283
0131-002,2015,6,13,2,85,49,134,204
0131-002,2015,6,13,3,47,50,97,134
0131-002,2015,6,13,4,37,61,98,97
0131-002,2015,6,13,5,83,53,136,98
0131-002,2015,6,13,6,218,115,333,136
0131-002,2015,6,13,7,531,201,732,333
0131-002,2015,6,13,8,895,415,1310,732
0131-002,2015,6,13,9,783,880,1663,1310
0131-002,2015,6,13,10,774,919,1693,1663
0131-002,2015,6,13,11,658,867,1525,1693
0131-002,2015,6,13,12,606,846,1452,1525
0131-002,2015,6,13,13,583,582,1165,1452
0131-002,2015,6,13,14,624,640,1264,1165
0131-002,2015,6,13,15,714,1153,1867,1264
0131-002,2015,6,13,16,696,955,1651,1867
0131-002,2015,6,13,17,776,1133,1909,1651
0131-002,2015,6,13,18,863,1402,2265,1909
0131-002,2015,6,13,19,879,734,1613,2265
0131-002,2015,6,13,20,559,386,945,1613
0131-002,2015,6,13,21,332,230,562,945
0131-002,2015,6,13,22,278,201,479,562
0131-002,2015,6,13,23,155,116,271,479
0131-002,2015,6,13,24,103,78,181,271
0131-002,2015,6,14,1,61,50,111,181
0131-002,2015,6,14,2,41,44,85,111
0131-002,2015,6,14,3,43,30,73,85
0131-002,2015,6,14,4,19,20,39,73
0131-002,2015,6,14,5,35,27,62,39
0131-002,2015,6,14,6,75,49,124,62
0131-002,2015,6,14,7,127,83,210,124
0131-002,2015,6,14,8,171,133,304,210
0131-002,2015,6,14,9,228,262,490,304
0131-002,2015,6,14,10,266,286,552,490
0131-002,2015,6,14,11,314,333,647,552
0131-002,2015,6,14,12,310,316,626,647
0131-002,2015,6,14,13,352,457,809,626
0131-002,2015,6,14,14,431,353,784,809
0131-002,2015,6,14,15,567,386,953,784
0131-002,2015,6,14,16,575,452,1027,953
0131-002,2015,6,14,17,780,391,1171,1027
0131-002,2015,6,14,18,836,480,1316,1171
0131-002,2015,6,14,19,760,370,1130,1316
0131-002,2015,6,14,20,539,252,791,1130
0131-002,2015,6,14,21,376,252,628,791
0131-002,2015,6,14,22,344,313,657,628
0131-002,2015,6,14,23,276,160,436,657
0131-002,2015,6,14,24,151,183,334,436
0131-002,2015,6,15,1,85,50,135,334
0131-002,2015,6,15,2,39,23,62,135
0131-002,2015,6,15,3,15,20,35,62
0131-002,2015,6,15,4,11,16,27,35
0131-002,2015,6,15,5,53,46,99,27
0131-002,2015,6,15,6,332,92,424,99
0131-002,2015,6,15,7,1042,348,1390,424
0131-002,2015,6,15,8,2273,866,3139,1390
0131-002,2015,6,15,9,1693,931,2624,3139
0131-002,2015,6,15,10,947,968,1915,2624
0131-002,2015,6,15,11,941,1000,1941,1915
0131-002,2015,6,15,12,803,1195,1998,1941
0131-002,2015,6,15,13,774,958,1732,1998
0131-002,2015,6,15,14,827,938,1765,1732
0131-002,2015,6,15,15,879,863,1742,1765
0131-002,2015,6,15,16,799,761,1560,1742
0131-002,2015,6,15,17,931,1177,2108,1560
0131-002,2015,6,15,18,843,1354,2197,2108
0131-002,2015,6,15,19,913,1223,2136,2197
0131-002,2015,6,15,20,692,1067,1759,2136
0131-002,2015,6,15,21,463,1164,1627,1759
0131-002,2015,6,15,22,290,723,1013,1627
0131-002,2015,6,15,23,228,454,682,1013
0131-002,2015,6,15,24,127,234,361,682
0131-002,2015,6,16,1,87,177,264,361
0131-002,2015,6,16,2,51,138,189,264
0131-002,2015,6,16,3,37,95,132,189
0131-002,2015,6,16,4,23,68,91,132
0131-002,2015,6,16,5,47,94,141,91
0131-002,2015,6,16,6,256,177,433,141
0131-002,2015,6,16,7,891,372,1263,433
0131-002,2015,6,16,8,1925,931,2856,1263
0131-002,2015,6,16,9,1597,1180,2777,2856
0131-002,2015,6,16,10,982,972,1954,2777
0131-002,2015,6,16,11,885,951,1836,1954
0131-002,2015,6,16,12,849,846,1695,1836
0131-002,2015,6,16,13,634,795,1429,1695
0131-002,2015,6,16,14,811,801,1612,1429
0131-002,2015,6,16,15,827,780,1607,1612
0131-002,2015,6,16,16,978,669,1647,1607
0131-002,2015,6,16,17,821,903,1724,1647
0131-002,2015,6,16,18,883,1170,2053,1724
0131-002,2015,6,16,19,937,1014,1951,2053
0131-002,2015,6,16,20,702,799,1501,1951
0131-002,2015,6,16,21,467,618,1085,1501
0131-002,2015,6,16,22,354,411,765,1085
0131-002,2015,6,16,23,254,206,460,765
0131-002,2015,6,16,24,151,129,280,460
0131-002,2015,6,17,1,57,94,151,280
0131-002,2015,6,17,2,61,42,103,151
0131-002,2015,6,17,3,15,27,42,103
0131-002,2015,6,17,4,29,29,58,42
0131-002,2015,6,17,5,33,51,84,58
0131-002,2015,6,17,6,248,268,516,84
0131-002,2015,6,17,7,885,286,1171,516
0131-002,2015,6,17,8,1947,860,2807,1171
0131-002,2015,6,17,9,1651,1042,2693,2807
0131-002,2015,6,17,10,975,898,1873,2693
0131-002,2015,6,17,11,897,810,1707,1873
0131-002,2015,6,17,12,807,778,1585,1707
0131-002,2015,6,17,13,656,650,1306,1585
0131-002,2015,6,17,14,752,710,1462,1306
0131-002,2015,6,17,15,915,824,1739,1462
0131-002,2015,6,17,16,869,837,1706,1739
0131-002,2015,6,17,17,861,974,1835,1706
0131-002,2015,6,17,18,706,1314,2020,1835
0131-002,2015,6,17,19,1160,1102,2262,2020
0131-002,2015,6,17,20,734,864,1598,2262
0131-002,2015,6,17,21,419,542,961,1598
0131-002,2015,6,17,22,276,313,589,961
0131-002,2015,6,17,23,208,189,397,589
0131-002,2015,6,17,24,111,121,232,397
0131-002,2015,6,18,1,73,60,133,232
0131-002,2015,6,18,2,47,40,87,133
0131-002,2015,6,18,3,37,30,67,87
0131-002,2015,6,18,4,23,15,38,67
0131-002,2015,6,18,5,47,39,86,38
0131-002,2015,6,18,6,226,85,311,86
0131-002,2015,6,18,7,847,276,1123,311
0131-002,2015,6,18,8,1982,895,2877,1123
0131-002,2015,6,18,9,1675,1144,2819,2877
0131-002,2015,6,18,10,921,912,1833,2819
0131-002,2015,6,18,11,865,888,1753,1833
0131-002,2015,6,18,12,823,703,1526,1753
0131-002,2015,6,18,13,626,600,1226,1526
0131-002,2015,6,18,14,726,685,1411,1226
0131-002,2015,6,18,15,891,945,1836,1411
0131-002,2015,6,18,16,917,1013,1930,1836
0131-002,2015,6,18,17,863,1076,1939,1930
0131-002,2015,6,18,18,963,1421,2384,1939
0131-002,2015,6,18,19,937,1219,2156,2384
0131-002,2015,6,18,20,668,747,1415,2156
0131-002,2015,6,18,21,465,728,1193,1415
0131-002,2015,6,18,22,320,402,722,1193
0131-002,2015,6,18,23,276,239,515,722
0131-002,2015,6,18,24,175,160,335,515
0131-002,2015,6,19,1,67,81,148,335
0131-002,2015,6,19,2,53,37,90,148
0131-002,2015,6,19,3,35,36,71,90
0131-002,2015,6,19,4,33,26,59,71
0131-002,2015,6,19,5,59,53,112,59
0131-002,2015,6,19,6,244,94,338,112
0131-002,2015,6,19,7,923,262,1185,338
0131-002,2015,6,19,8,1997,764,2761,1185
0131-002,2015,6,19,9,1548,983,2531,2761
0131-002,2015,6,19,10,943,946,1889,2531
0131-002,2015,6,19,11,941,812,1753,1889
0131-002,2015,6,19,12,911,761,1672,1753
0131-002,2015,6,19,13,688,641,1329,1672
0131-002,2015,6,19,14,849,739,1588,1329
0131-002,2015,6,19,15,929,731,1660,1588
0131-002,2015,6,19,16,861,886,1747,1660
0131-002,2015,6,19,17,919,857,1776,1747
0131-002,2015,6,19,18,982,1313,2295,1776
0131-002,2015,6,19,19,1156,1383,2539,2295
0131-002,2015,6,19,20,957,1031,1988,2539
0131-002,2015,6,19,21,622,723,1345,1988
0131-002,2015,6,19,22,479,423,902,1345
0131-002,2015,6,19,23,232,222,454,902
0131-002,2015,6,19,24,169,125,294,454
0131-002,2015,6,20,1,113,97,210,294
0131-002,2015,6,20,2,87,64,151,210
0131-002,2015,6,20,3,65,46,111,151
0131-002,2015,6,20,4,35,37,72,111
0131-002,2015,6,20,5,83,47,130,72
0131-002,2015,6,20,6,248,97,345,130
0131-002,2015,6,20,7,507,242,749,345
0131-002,2015,6,20,8,799,432,1231,749
0131-002,2015,6,20,9,896,782,1678,1231
0131-002,2015,6,20,10,644,833,1477,1678
0131-002,2015,6,20,11,716,754,1470,1477
0131-002,2015,6,20,12,817,751,1568,1470
0131-002,2015,6,20,13,648,617,1265,1568
0131-002,2015,6,20,14,724,668,1392,1265
0131-002,2015,6,20,15,720,862,1582,1392
0131-002,2015,6,20,16,793,1009,1802,1582
0131-002,2015,6,20,17,881,1016,1897,1802
0131-002,2015,6,20,18,883,1071,1954,1897
0131-002,2015,6,20,19,793,977,1770,1954
0131-002,2015,6,20,20,509,664,1173,1770
0131-002,2015,6,20,21,360,360,720,1173
0131-002,2015,6,20,22,298,367,665,720
0131-002,2015,6,20,23,163,272,435,665
0131-002,2015,6,20,24,133,163,296,435
0131-002,2015,6,21,1,69,105,174,296
0131-002,2015,6,21,2,37,37,74,174
0131-002,2015,6,21,3,21,34,55,74
0131-002,2015,6,21,4,27,43,70,55
0131-002,2015,6,21,5,27,39,66,70
0131-002,2015,6,21,6,99,92,191,66
0131-002,2015,6,21,7,244,234,478,191
0131-002,2015,6,21,8,272,317,589,478
0131-002,2015,6,21,9,300,285,585,589
0131-002,2015,6,21,10,286,306,592,585
0131-002,2015,6,21,11,350,346,696,592
0131-002,2015,6,21,12,407,345,752,696
0131-002,2015,6,21,13,384,714,1098,752
0131-002,2015,6,21,14,425,757,1182,1098
0131-002,2015,6,21,15,575,828,1403,1182
0131-002,2015,6,21,16,642,894,1536,1403
0131-002,2015,6,21,17,774,795,1569,1536
0131-002,2015,6,21,18,862,904,1766,1569
0131-002,2015,6,21,19,833,780,1613,1766
0131-002,2015,6,21,20,638,526,1164,1613
0131-002,2015,6,21,21,559,577,1136,1164
0131-002,2015,6,21,22,445,381,826,1136
0131-002,2015,6,21,23,280,201,481,826
0131-002,2015,6,21,24,167,104,271,481
0131-002,2015,6,22,1,57,47,104,271
0131-002,2015,6,22,2,47,20,67,104
0131-002,2015,6,22,3,21,23,44,67
0131-002,2015,6,22,4,23,16,39,44
0131-002,2015,6,22,5,47,46,93,39
0131-002,2015,6,22,6,318,124,442,93
0131-002,2015,6,22,7,1008,389,1397,442
0131-002,2015,6,22,8,2300,1162,3462,1397
0131-002,2015,6,22,9,1681,1098,2779,3462
0131-002,2015,6,22,10,901,905,1806,2779
0131-002,2015,6,22,11,895,765,1660,1806
0131-002,2015,6,22,12,770,768,1538,1660
0131-002,2015,6,22,13,674,611,1285,1538
0131-002,2015,6,22,14,825,770,1595,1285
0131-002,2015,6,22,15,797,970,1767,1595
0131-002,2015,6,22,16,903,835,1738,1767
0131-002,2015,6,22,17,807,798,1605,1738
0131-002,2015,6,22,18,971,1122,2093,1605
0131-002,2015,6,22,19,921,1030,1951,2093
0131-002,2015,6,22,20,664,1031,1695,1951
0131-002,2015,6,22,21,399,747,1146,1695
0131-002,2015,6,22,22,354,399,753,1146
0131-002,2015,6,22,23,208,353,561,753
0131-002,2015,6,22,24,119,269,388,561
0131-002,2015,6,23,1,87,227,314,388
0131-002,2015,6,23,2,47,143,190,314
0131-002,2015,6,23,3,23,121,144,190
0131-002,2015,6,23,4,19,37,56,144
0131-002,2015,6,23,5,53,44,97,56
0131-002,2015,6,23,6,260,247,507,97
0131-002,2015,6,23,7,879,502,1381,507
0131-002,2015,6,23,8,2073,1266,3339,1381
0131-002,2015,6,23,9,1544,1492,3036,3339
0131-002,2015,6,23,10,975,1158,2133,3036
0131-002,2015,6,23,11,969,1027,1996,2133
0131-002,2015,6,23,12,859,956,1815,1996
0131-002,2015,6,23,13,666,601,1267,1815
0131-002,2015,6,23,14,861,705,1566,1267
0131-002,2015,6,23,15,929,867,1796,1566
0131-002,2015,6,23,16,770,876,1646,1796
0131-002,2015,6,23,17,861,734,1595,1646
0131-002,2015,6,23,18,837,1108,1945,1595
0131-002,2015,6,23,19,911,1091,2002,1945
0131-002,2015,6,23,20,668,753,1421,2002
0131-002,2015,6,23,21,471,604,1075,1421
0131-002,2015,6,23,22,435,382,817,1075
0131-002,2015,6,23,23,248,224,472,817
0131-002,2015,6,23,24,151,124,275,472
0131-002,2015,6,24,1,91,81,172,275
0131-002,2015,6,24,2,79,56,135,172
0131-002,2015,6,24,3,31,27,58,135
0131-002,2015,6,24,4,29,32,61,58
0131-002,2015,6,24,5,57,36,93,61
0131-002,2015,6,24,6,276,105,381,93
0131-002,2015,6,24,7,857,303,1160,381
0131-002,2015,6,24,8,1968,765,2733,1160
0131-002,2015,6,24,9,1552,985,2537,2733
0131-002,2015,6,24,10,917,716,1633,2537
0131-002,2015,6,24,11,963,733,1696,1633
0131-002,2015,6,24,12,917,698,1615,1696
0131-002,2015,6,24,13,702,580,1282,1615
0131-002,2015,6,24,14,859,645,1504,1282
0131-002,2015,6,24,15,1000,802,1802,1504
0131-002,2015,6,24,16,859,765,1624,1802
0131-002,2015,6,24,17,869,846,1715,1624
0131-002,2015,6,24,18,835,1179,2014,1715
0131-002,2015,6,24,19,965,1096,2061,2014
0131-002,2015,6,24,20,690,760,1450,2061
0131-002,2015,6,24,21,401,593,994,1450
0131-002,2015,6,24,22,352,631,983,994
0131-002,2015,6,24,23,284,454,738,983
0131-002,2015,6,24,24,149,139,288,738
0131-002,2015,6,25,1,89,77,166,288
0131-002,2015,6,25,2,49,44,93,166
0131-002,2015,6,25,3,41,29,70,93
0131-002,2015,6,25,4,31,23,54,70
0131-002,2015,6,25,5,49,51,100,54
0131-002,2015,6,25,6,242,194,436,100
0131-002,2015,6,25,7,889,329,1218,436
0131-002,2015,6,25,8,1945,781,2726,1218
0131-002,2015,6,25,9,1617,1047,2664,2726
0131-002,2015,6,25,10,957,754,1711,2664
0131-002,2015,6,25,11,925,979,1904,1711
0131-002,2015,6,25,12,847,887,1734,1904
0131-002,2015,6,25,13,668,862,1530,1734
0131-002,2015,6,25,14,887,777,1664,1530
0131-002,2015,6,25,15,980,864,1844,1664
0131-002,2015,6,25,16,959,890,1849,1844
0131-002,2015,6,25,17,825,992,1817,1849
0131-002,2015,6,25,18,909,1252,2161,1817
0131-002,2015,6,25,19,996,1014,2010,2161
0131-002,2015,6,25,20,620,753,1373,2010
0131-002,2015,6,25,21,382,698,1080,1373
0131-002,2015,6,25,22,350,524,874,1080
0131-002,2015,6,25,23,244,295,539,874
0131-002,2015,6,25,24,129,124,253,539
0131-002,2015,6,26,1,81,71,152,253
0131-002,2015,6,26,2,51,47,98,152
0131-002,2015,6,26,3,29,63,92,98
0131-002,2015,6,26,4,35,58,93,92
0131-002,2015,6,26,5,47,104,151,93
0131-002,2015,6,26,6,119,128,247,151
0131-002,2015,6,26,7,547,251,798,247
0131-002,2015,6,26,8,1850,932,2782,798
0131-002,2015,6,26,9,1609,928,2537,2782
0131-002,2015,6,26,10,795,673,1468,2537
0131-002,2015,6,26,11,853,750,1603,1468
0131-002,2015,6,26,12,857,818,1675,1603
0131-002,2015,6,26,13,662,686,1348,1675
0131-002,2015,6,26,14,837,648,1485,1348
0131-002,2015,6,26,15,887,811,1698,1485
0131-002,2015,6,26,16,913,784,1697,1698
0131-002,2015,6,26,17,827,907,1734,1697
0131-002,2015,6,26,18,1032,1409,2441,1734
0131-002,2015,6,26,19,1106,1505,2611,2441
0131-002,2015,6,26,20,907,1296,2203,2611
0131-002,2015,6,26,21,503,880,1383,2203
0131-002,2015,6,26,22,395,726,1121,1383
0131-002,2015,6,26,23,294,461,755,1121
0131-002,2015,6,26,24,179,358,537,755
0131-002,2015,6,27,1,91,241,332,537
0131-002,2015,6,27,2,69,125,194,332
0131-002,2015,6,27,3,39,53,92,194
0131-002,2015,6,27,4,47,40,87,92
0131-002,2015,6,27,5,59,60,119,87
0131-002,2015,6,27,6,240,101,341,119
0131-002,2015,6,27,7,525,262,787,341
0131-002,2015,6,27,8,819,427,1246,787
0131-002,2015,6,27,9,917,617,1534,1246
0131-002,2015,6,27,10,795,741,1536,1534
0131-002,2015,6,27,11,833,764,1597,1536
0131-002,2015,6,27,12,762,941,1703,1597
0131-002,2015,6,27,13,783,792,1575,1703
0131-002,2015,6,27,14,696,657,1353,1575
0131-002,2015,6,27,15,791,744,1535,1353
0131-002,2015,6,27,16,780,713,1493,1535
0131-002,2015,6,27,17,793,741,1534,1493
0131-002,2015,6,27,18,907,1097,2004,1534
0131-002,2015,6,27,19,815,993,1808,2004
0131-002,2015,6,27,20,549,420,969,1808
0131-002,2015,6,27,21,475,371,846,969
0131-002,2015,6,27,22,356,254,610,846
0131-002,2015,6,27,23,214,149,363,610
0131-002,2015,6,27,24,103,108,211,363
0131-002,2015,6,28,1,79,70,149,211
0131-002,2015,6,28,2,47,50,97,149
0131-002,2015,6,28,3,39,37,76,97
0131-002,2015,6,28,4,25,25,50,76
0131-002,2015,6,28,5,37,44,81,50
0131-002,2015,6,28,6,93,51,144,81
0131-002,2015,6,28,7,208,121,329,144
0131-002,2015,6,28,8,274,148,422,329
0131-002,2015,6,28,9,298,248,546,422
0131-002,2015,6,28,10,346,327,673,546
0131-002,2015,6,28,11,403,358,761,673
0131-002,2015,6,28,12,399,364,763,761
0131-002,2015,6,28,13,457,353,810,763
0131-002,2015,6,28,14,445,399,844,810
0131-002,2015,6,28,15,565,401,966,844
0131-002,2015,6,28,16,676,453,1129,966
0131-002,2015,6,28,17,778,526,1304,1129
0131-002,2015,6,28,18,1054,619,1673,1304
0131-002,2015,6,28,19,1041,444,1485,1673
0131-002,2015,6,28,20,634,292,926,1485
0131-002,2015,6,28,21,533,276,809,926
0131-002,2015,6,28,22,393,207,600,809
0131-002,2015,6,28,23,270,150,420,600
0131-002,2015,6,28,24,139,97,236,420
0131-002,2015,6,29,1,67,44,111,236
0131-002,2015,6,29,2,43,22,65,111
0131-002,2015,6,29,3,21,26,47,65
0131-002,2015,6,29,4,21,15,36,47
0131-002,2015,6,29,5,51,44,95,36
0131-002,2015,6,29,6,318,118,436,95
0131-002,2015,6,29,7,1076,509,1585,436
0131-002,2015,6,29,8,2328,1178,3506,1585
0131-002,2015,6,29,9,1707,1192,2899,3506
0131-002,2015,6,29,10,861,744,1605,2899
0131-002,2015,6,29,11,967,963,1930,1605
0131-002,2015,6,29,12,903,867,1770,1930
0131-002,2015,6,29,13,748,877,1625,1770
0131-002,2015,6,29,14,939,634,1573,1625
0131-002,2015,6,29,15,941,794,1735,1573
0131-002,2015,6,29,16,933,789,1722,1735
0131-002,2015,6,29,17,837,856,1693,1722
0131-002,2015,6,29,18,903,1209,2112,1693
0131-002,2015,6,29,19,949,1188,2137,2112
0131-002,2015,6,29,20,636,1205,1841,2137
0131-002,2015,6,29,21,437,1211,1648,1841
0131-002,2015,6,29,22,395,795,1190,1648
0131-002,2015,6,29,23,234,538,772,1190
0131-002,2015,6,29,24,145,326,471,772
0131-002,2015,6,30,1,81,208,289,471
0131-002,2015,6,30,2,49,133,182,289
0131-002,2015,6,30,3,51,109,160,182
0131-002,2015,6,30,4,41,121,162,160
0131-002,2015,6,30,5,55,111,166,162
0131-002,2015,6,30,6,270,273,543,166
0131-002,2015,6,30,7,728,437,1165,543
0131-002,2015,6,30,8,1923,1098,3021,1165
0131-002,2015,6,30,9,1579,1336,2915,3021
0131-002,2015,6,30,10,865,1065,1930,2915
0131-002,2015,6,30,11,867,989,1856,1930
0131-002,2015,6,30,12,857,901,1758,1856
0131-002,2015,6,30,13,702,698,1400,1758
0131-002,2015,6,30,14,734,753,1487,1400
0131-002,2015,6,30,15,975,824,1799,1487
0131-002,2015,6,30,16,871,772,1643,1799
0131-002,2015,6,30,17,829,818,1647,1643
0131-002,2015,6,30,18,975,1139,2114,1647
0131-002,2015,6,30,19,815,1052,1867,2114
0131-002,2015,6,30,20,682,776,1458,1867
0131-002,2015,6,30,21,441,611,1052,1458
0131-002,2015,6,30,22,370,396,766,1052
0131-002,2015,6,30,23,210,215,425,766
0131-002,2015,6,30,24,153,156,309,425
0131-002,2015,7,1,1,73,124,197,309
0131-002,2015,7,1,2,67,52,119,197
0131-002,2015,7,1,3,27,57,84,119
0131-002,2015,7,1,4,45,62,107,84
0131-002,2015,7,1,5,57,120,177,107
0131-002,2015,7,1,6,235,121,356,177
0131-002,2015,7,1,7,830,306,1136,356
0131-002,2015,7,1,8,2024,796,2820,1136
0131-002,2015,7,1,9,1555,1047,2602,2820
0131-002,2015,7,1,10,1024,845,1869,2602
0131-002,2015,7,1,11,908,1042,1950,1869
0131-002,2015,7,1,12,902,1216,2118,1950
0131-002,2015,7,1,13,705,755,1460,2118
0131-002,2015,7,1,14,836,743,1579,1460
0131-002,2015,7,1,15,896,846,1742,1579
0131-002,2015,7,1,16,944,901,1845,1742
0131-002,2015,7,1,17,836,861,1697,1845
0131-002,2015,7,1,18,798,1224,2022,1697
0131-002,2015,7,1,19,874,1110,1984,2022
0131-002,2015,7,1,20,711,788,1499,1984
0131-002,2015,7,1,21,415,653,1068,1499
0131-002,2015,7,1,22,393,401,794,1068
0131-002,2015,7,1,23,269,257,526,794
0131-002,2015,7,1,24,157,115,272,526
0131-002,2015,7,2,1,81,76,157,272
0131-002,2015,7,2,2,51,45,96,157
0131-002,2015,7,2,3,31,37,68,96
0131-002,2015,7,2,4,23,26,49,68
0131-002,2015,7,2,5,49,42,91,49
0131-002,2015,7,2,6,237,96,333,91
0131-002,2015,7,2,7,908,266,1174,333
0131-002,2015,7,2,8,1924,762,2686,1174
0131-002,2015,7,2,9,1661,1040,2701,2686
0131-002,2015,7,2,10,932,810,1742,2701
0131-002,2015,7,2,11,920,785,1705,1742
0131-002,2015,7,2,12,870,785,1655,1705
0131-002,2015,7,2,13,657,618,1275,1655
0131-002,2015,7,2,14,864,745,1609,1275
0131-002,2015,7,2,15,942,911,1853,1609
0131-002,2015,7,2,16,982,926,1908,1853
0131-002,2015,7,2,17,854,826,1680,1908
0131-002,2015,7,2,18,868,1272,2140,1680
0131-002,2015,7,2,19,852,1128,1980,2140
0131-002,2015,7,2,20,701,811,1512,1980
0131-002,2015,7,2,21,499,749,1248,1512
0131-002,2015,7,2,22,337,412,749,1248
0131-002,2015,7,2,23,247,216,463,749
0131-002,2015,7,2,24,177,129,306,463
0131-002,2015,7,3,1,93,117,210,306
0131-002,2015,7,3,2,55,59,114,210
0131-002,2015,7,3,3,21,42,63,114
0131-002,2015,7,3,4,27,30,57,63
0131-002,2015,7,3,5,65,37,102,57
0131-002,2015,7,3,6,235,99,334,102
0131-002,2015,7,3,7,818,267,1085,334
0131-002,2015,7,3,8,1973,802,2775,1085
0131-002,2015,7,3,9,1601,1045,2646,2775
0131-002,2015,7,3,10,958,758,1716,2646
0131-002,2015,7,3,11,934,804,1738,1716
0131-002,2015,7,3,12,904,708,1612,1738
0131-002,2015,7,3,13,731,708,1439,1612
0131-002,2015,7,3,14,816,702,1518,1439
0131-002,2015,7,3,15,1006,880,1886,1518
0131-002,2015,7,3,16,934,902,1836,1886
0131-002,2015,7,3,17,968,970,1938,1836
0131-002,2015,7,3,18,960,1371,2331,1938
0131-002,2015,7,3,19,1126,1420,2546,2331
0131-002,2015,7,3,20,956,1084,2040,2546
0131-002,2015,7,3,21,569,740,1309,2040
0131-002,2015,7,3,22,451,450,901,1309
0131-002,2015,7,3,23,341,292,633,901
0131-002,2015,7,3,24,157,158,315,633
0131-002,2015,7,4,1,79,108,187,315
0131-002,2015,7,4,2,61,62,123,187
0131-002,2015,7,4,3,49,48,97,123
0131-002,2015,7,4,4,25,45,70,97
0131-002,2015,7,4,5,61,49,110,70
0131-002,2015,7,4,6,231,121,352,110
0131-002,2015,7,4,7,585,253,838,352
0131-002,2015,7,4,8,878,425,1303,838
0131-002,2015,7,4,9,904,947,1851,1303
0131-002,2015,7,4,10,796,972,1768,1851
0131-002,2015,7,4,11,854,935,1789,1768
0131-002,2015,7,4,12,864,810,1674,1789
0131-002,2015,7,4,13,663,783,1446,1674
0131-002,2015,7,4,14,824,683,1507,1446
0131-002,2015,7,4,15,884,736,1620,1507
0131-002,2015,7,4,16,850,690,1540,1620
0131-002,2015,7,4,17,876,782,1658,1540
0131-002,2015,7,4,18,1011,1015,2026,1658
0131-002,2015,7,4,19,858,758,1616,2026
0131-002,2015,7,4,20,579,449,1028,1616
0131-002,2015,7,4,21,423,363,786,1028
0131-002,2015,7,4,22,295,257,552,786
0131-002,2015,7,4,23,201,167,368,552
0131-002,2015,7,4,24,139,117,256,368
0131-002,2015,7,5,1,85,62,147,256
0131-002,2015,7,5,2,47,52,99,147
0131-002,2015,7,5,3,35,39,74,99
0131-002,2015,7,5,4,37,12,49,74
0131-002,2015,7,5,5,39,37,76,49
0131-002,2015,7,5,6,115,64,179,76
0131-002,2015,7,5,7,253,98,351,179
0131-002,2015,7,5,8,251,164,415,351
0131-002,2015,7,5,9,247,247,494,415
0131-002,2015,7,5,10,337,363,700,494
0131-002,2015,7,5,11,447,413,860,700
0131-002,2015,7,5,12,497,465,962,860
0131-002,2015,7,5,13,481,394,875,962
0131-002,2015,7,5,14,591,444,1035,875
0131-002,2015,7,5,15,581,478,1059,1035
0131-002,2015,7,5,16,729,550,1279,1059
0131-002,2015,7,5,17,768,507,1275,1279
0131-002,2015,7,5,18,857,548,1405,1275
0131-002,2015,7,5,19,838,466,1304,1405
0131-002,2015,7,5,20,501,381,882,1304
0131-002,2015,7,5,21,475,325,800,882
0131-002,2015,7,5,22,359,216,575,800
0131-002,2015,7,5,23,269,148,417,575
0131-002,2015,7,5,24,147,82,229,417
0131-002,2015,7,6,1,85,40,125,229
0131-002,2015,7,6,2,53,20,73,125
0131-002,2015,7,6,3,17,18,35,73
0131-002,2015,7,6,4,21,26,47,35
0131-002,2015,7,6,5,45,40,85,47
0131-002,2015,7,6,6,299,121,420,85
0131-002,2015,7,6,7,1018,449,1467,420
0131-002,2015,7,6,8,2351,1170,3521,1467
0131-002,2015,7,6,9,1615,1145,2760,3521
0131-002,2015,7,6,10,954,824,1778,2760
0131-002,2015,7,6,11,936,864,1800,1778
0131-002,2015,7,6,12,938,818,1756,1800
0131-002,2015,7,6,13,711,744,1455,1756
0131-002,2015,7,6,14,840,702,1542,1455
0131-002,2015,7,6,15,916,882,1798,1542
0131-002,2015,7,6,16,956,812,1768,1798
0131-002,2015,7,6,17,842,827,1669,1768
0131-002,2015,7,6,18,954,1088,2042,1669
0131-002,2015,7,6,19,772,1079,1851,2042
0131-002,2015,7,6,20,675,874,1549,1851
0131-002,2015,7,6,21,459,708,1167,1549
0131-002,2015,7,6,22,365,475,840,1167
0131-002,2015,7,6,23,249,216,465,840
0131-002,2015,7,6,24,143,99,242,465
0131-002,2015,7,7,1,65,61,126,242
0131-002,2015,7,7,2,47,29,76,126
0131-002,2015,7,7,3,19,31,50,76
0131-002,2015,7,7,4,33,39,72,50
0131-002,2015,7,7,5,43,46,89,72
0131-002,2015,7,7,6,225,260,485,89
0131-002,2015,7,7,7,952,470,1422,485
0131-002,2015,7,7,8,2026,1182,3208,1422
0131-002,2015,7,7,9,1621,1414,3035,3208
0131-002,2015,7,7,10,1026,1112,2138,3035
0131-002,2015,7,7,11,952,1008,1960,2138
0131-002,2015,7,7,12,906,928,1834,1960
0131-002,2015,7,7,13,645,650,1295,1834
0131-002,2015,7,7,14,816,729,1545,1295
0131-002,2015,7,7,15,938,846,1784,1545
0131-002,2015,7,7,16,936,824,1760,1784
0131-002,2015,7,7,17,754,776,1530,1760
0131-002,2015,7,7,18,864,1135,1999,1530
0131-002,2015,7,7,19,936,1129,2065,1999
0131-002,2015,7,7,20,607,740,1347,2065
0131-002,2015,7,7,21,473,704,1177,1347
0131-002,2015,7,7,22,375,401,776,1177
0131-002,2015,7,7,23,191,199,390,776
0131-002,2015,7,7,24,127,126,253,390
0131-002,2015,7,8,1,85,80,165,253
0131-002,2015,7,8,2,55,37,92,165
0131-002,2015,7,8,3,33,39,72,92
0131-002,2015,7,8,4,17,29,46,72
0131-002,2015,7,8,5,45,40,85,46
0131-002,2015,7,8,6,201,113,314,85
0131-002,2015,7,8,7,846,304,1150,314
0131-002,2015,7,8,8,1906,780,2686,1150
0131-002,2015,7,8,9,1587,1016,2603,2686
0131-002,2015,7,8,10,958,780,1738,2603
0131-002,2015,7,8,11,940,888,1828,1738
0131-002,2015,7,8,12,814,957,1771,1828
0131-002,2015,7,8,13,637,668,1305,1771
0131-002,2015,7,8,14,824,694,1518,1305
0131-002,2015,7,8,15,896,824,1720,1518
0131-002,2015,7,8,16,914,833,1747,1720
0131-002,2015,7,8,17,701,854,1555,1747
0131-002,2015,7,8,18,914,1202,2116,1555
0131-002,2015,7,8,19,780,1103,1883,2116
0131-002,2015,7,8,20,617,774,1391,1883
0131-002,2015,7,8,21,403,623,1026,1391
0131-002,2015,7,8,22,321,516,837,1026
0131-002,2015,7,8,23,225,356,581,837
0131-002,2015,7,8,24,149,127,276,581
0131-002,2015,7,9,1,83,169,252,276
0131-002,2015,7,9,2,69,135,204,252
0131-002,2015,7,9,3,23,118,141,204
0131-002,2015,7,9,4,29,120,149,141
0131-002,2015,7,9,5,27,161,188,149
0131-002,2015,7,9,6,205,180,385,188
0131-002,2015,7,9,7,858,298,1156,385
0131-002,2015,7,9,8,2025,772,2797,1156
0131-002,2015,7,9,9,1621,1044,2665,2797
0131-002,2015,7,9,10,1000,782,1782,2665
0131-002,2015,7,9,11,842,882,1724,1782
0131-002,2015,7,9,12,814,836,1650,1724
0131-002,2015,7,9,13,673,740,1413,1650
0131-002,2015,7,9,14,830,761,1591,1413
0131-002,2015,7,9,15,906,888,1794,1591
0131-002,2015,7,9,16,872,908,1780,1794
0131-002,2015,7,9,17,758,909,1667,1780
0131-002,2015,7,9,18,890,1262,2152,1667
0131-002,2015,7,9,19,846,1071,1917,2152
0131-002,2015,7,9,20,593,782,1375,1917
0131-002,2015,7,9,21,443,724,1167,1375
0131-002,2015,7,9,22,339,468,807,1167
0131-002,2015,7,9,23,243,256,499,807
0131-002,2015,7,9,24,141,126,267,499
0131-002,2015,7,10,1,91,254,345,267
0131-002,2015,7,10,2,53,166,219,345
0131-002,2015,7,10,3,33,120,153,219
0131-002,2015,7,10,4,27,93,120,153
0131-002,2015,7,10,5,41,49,90,120
0131-002,2015,7,10,6,239,100,339,90
0131-002,2015,7,10,7,888,284,1172,339
0131-002,2015,7,10,8,2087,867,2954,1172
0131-002,2015,7,10,9,1669,986,2655,2954
0131-002,2015,7,10,10,1014,716,1730,2655
0131-002,2015,7,10,11,944,777,1721,1730
0131-002,2015,7,10,12,998,763,1761,1721
0131-002,2015,7,10,13,739,697,1436,1761
0131-002,2015,7,10,14,888,675,1563,1436
0131-002,2015,7,10,15,948,846,1794,1563
0131-002,2015,7,10,16,982,843,1825,1794
0131-002,2015,7,10,17,948,938,1886,1825
0131-002,2015,7,10,18,1008,1390,2398,1886
0131-002,2015,7,10,19,1086,1462,2548,2398
0131-002,2015,7,10,20,996,1190,2186,2548
0131-002,2015,7,10,21,641,841,1482,2186
0131-002,2015,7,10,22,425,426,851,1482
0131-002,2015,7,10,23,309,270,579,851
0131-002,2015,7,10,24,171,142,313,579
0131-002,2015,7,11,1,121,115,236,313
0131-002,2015,7,11,2,79,77,156,236
0131-002,2015,7,11,3,67,62,129,156
0131-002,2015,7,11,4,39,34,73,129
0131-002,2015,7,11,5,77,57,134,73
0131-002,2015,7,11,6,223,107,330,134
0131-002,2015,7,11,7,607,230,837,330
0131-002,2015,7,11,8,864,449,1313,837
0131-002,2015,7,11,9,922,690,1612,1313
0131-002,2015,7,11,10,782,737,1519,1612
0131-002,2015,7,11,11,786,764,1550,1519
0131-002,2015,7,11,12,798,813,1611,1550
0131-002,2015,7,11,13,731,743,1474,1611
0131-002,2015,7,11,14,697,639,1336,1474
0131-002,2015,7,11,15,800,677,1477,1336
0131-002,2015,7,11,16,828,712,1540,1477
0131-002,2015,7,11,17,908,733,1641,1540
0131-002,2015,7,11,18,1049,963,2012,1641
0131-002,2015,7,11,19,806,740,1546,2012
0131-002,2015,7,11,20,609,466,1075,1546
0131-002,2015,7,11,21,519,350,869,1075
0131-002,2015,7,11,22,321,238,559,869
0131-002,2015,7,11,23,215,164,379,559
0131-002,2015,7,11,24,79,121,200,379
0131-002,2015,7,12,1,83,64,147,200
0131-002,2015,7,12,2,65,64,129,147
0131-002,2015,7,12,3,39,31,70,129
0131-002,2015,7,12,4,27,29,56,70
0131-002,2015,7,12,5,41,23,64,56
0131-002,2015,7,12,6,69,58,127,64
0131-002,2015,7,12,7,253,110,363,127
0131-002,2015,7,12,8,321,156,477,363
0131-002,2015,7,12,9,205,248,453,477
0131-002,2015,7,12,10,251,345,596,453
0131-002,2015,7,12,11,301,386,687,596
0131-002,2015,7,12,12,397,414,811,687
0131-002,2015,7,12,13,377,374,751,811
0131-002,2015,7,12,14,409,422,831,751
0131-002,2015,7,12,15,501,440,941,831
0131-002,2015,7,12,16,531,502,1033,941
0131-002,2015,7,12,17,639,516,1155,1033
0131-002,2015,7,12,18,667,584,1251,1155
0131-002,2015,7,12,19,675,455,1130,1251
0131-002,2015,7,12,20,553,336,889,1130
0131-002,2015,7,12,21,491,300,791,889
0131-002,2015,7,12,22,315,248,563,791
0131-002,2015,7,12,23,157,182,339,563
0131-002,2015,7,12,24,109,160,269,339
0131-002,2015,7,13,1,75,39,114,269
0131-002,2015,7,13,2,33,26,59,114
0131-002,2015,7,13,3,5,26,31,59
0131-002,2015,7,13,4,11,17,28,31
0131-002,2015,7,13,5,33,33,66,28
0131-002,2015,7,13,6,201,120,321,66
0131-002,2015,7,13,7,822,479,1301,321
0131-002,2015,7,13,8,2102,1174,3276,1301
0131-002,2015,7,13,9,1555,1168,2723,3276
0131-002,2015,7,13,10,816,784,1600,2723
0131-002,2015,7,13,11,784,914,1698,1600
0131-002,2015,7,13,12,735,842,1577,1698
0131-002,2015,7,13,13,617,810,1427,1577
0131-002,2015,7,13,14,735,668,1403,1427
0131-002,2015,7,13,15,980,838,1818,1403
0131-002,2015,7,13,16,850,800,1650,1818
0131-002,2015,7,13,17,713,842,1555,1650
0131-002,2015,7,13,18,838,1148,1986,1555
0131-002,2015,7,13,19,818,1134,1952,1986
0131-002,2015,7,13,20,661,1040,1701,1952
0131-002,2015,7,13,21,497,960,1457,1701
0131-002,2015,7,13,22,325,635,960,1457
0131-002,2015,7,13,23,187,377,564,960
0131-002,2015,7,13,24,111,212,323,564
0131-002,2015,7,14,1,67,229,296,323
0131-002,2015,7,14,2,51,110,161,296
0131-002,2015,7,14,3,25,110,135,161
0131-002,2015,7,14,4,41,133,174,135
0131-002,2015,7,14,5,71,163,234,174
0131-002,2015,7,14,6,215,217,432,234
0131-002,2015,7,14,7,723,454,1177,432
0131-002,2015,7,14,8,1894,1140,3034,1177
0131-002,2015,7,14,9,1551,1375,2926,3034
0131-002,2015,7,14,10,1024,1088,2112,2926
0131-002,2015,7,14,11,984,998,1982,2112
0131-002,2015,7,14,12,850,914,1764,1982
0131-002,2015,7,14,13,675,674,1349,1764
0131-002,2015,7,14,14,824,741,1565,1349
0131-002,2015,7,14,15,1018,835,1853,1565
0131-002,2015,7,14,16,952,798,1750,1853
0131-002,2015,7,14,17,828,797,1625,1750
0131-002,2015,7,14,18,864,1137,2001,1625
0131-002,2015,7,14,19,962,1090,2052,2001
0131-002,2015,7,14,20,754,758,1512,2052
0131-002,2015,7,14,21,493,658,1151,1512
0131-002,2015,7,14,22,403,398,801,1151
0131-002,2015,7,14,23,255,283,538,801
0131-002,2015,7,14,24,167,145,312,538
0131-002,2015,7,15,1,95,55,150,312
0131-002,2015,7,15,2,47,62,109,150
0131-002,2015,7,15,3,25,37,62,109
0131-002,2015,7,15,4,35,37,72,62
0131-002,2015,7,15,5,49,67,116,72
0131-002,2015,7,15,6,193,163,356,116
0131-002,2015,7,15,7,812,300,1112,356
0131-002,2015,7,15,8,1941,732,2673,1112
0131-002,2015,7,15,9,1575,1063,2638,2673
0131-002,2015,7,15,10,1010,846,1856,2638
0131-002,2015,7,15,11,962,929,1891,1856
0131-002,2015,7,15,12,912,861,1773,1891
0131-002,2015,7,15,13,750,661,1411,1773
0131-002,2015,7,15,14,930,665,1595,1411
0131-002,2015,7,15,15,890,790,1680,1595
0131-002,2015,7,15,16,900,826,1726,1680
0131-002,2015,7,15,17,950,910,1860,1726
0131-002,2015,7,15,18,998,1290,2288,1860
0131-002,2015,7,15,19,958,1125,2083,2288
0131-002,2015,7,15,20,766,876,1642,2083
0131-002,2015,7,15,21,481,617,1098,1642
0131-002,2015,7,15,22,411,400,811,1098
0131-002,2015,7,15,23,287,208,495,811
0131-002,2015,7,15,24,157,163,320,495
0131-002,2015,7,16,1,99,82,181,320
0131-002,2015,7,16,2,51,59,110,181
0131-002,2015,7,16,3,27,37,64,110
0131-002,2015,7,16,4,35,48,83,64
0131-002,2015,7,16,5,51,52,103,83
0131-002,2015,7,16,6,241,101,342,103
0131-002,2015,7,16,7,842,286,1128,342
0131-002,2015,7,16,8,1831,727,2558,1128
0131-002,2015,7,16,9,1571,978,2549,2558
0131-002,2015,7,16,10,940,764,1704,2549
0131-002,2015,7,16,11,932,795,1727,1704
0131-002,2015,7,16,12,878,745,1623,1727
0131-002,2015,7,16,13,754,575,1329,1623
0131-002,2015,7,16,14,884,656,1540,1329
0131-002,2015,7,16,15,904,788,1692,1540
0131-002,2015,7,16,16,922,839,1761,1692
0131-002,2015,7,16,17,822,860,1682,1761
0131-002,2015,7,16,18,890,1185,2075,1682
0131-002,2015,7,16,19,912,1121,2033,2075
0131-002,2015,7,16,20,695,801,1496,2033
0131-002,2015,7,16,21,545,696,1241,1496
0131-002,2015,7,16,22,401,400,801,1241
0131-002,2015,7,16,23,333,247,580,801
0131-002,2015,7,16,24,253,132,385,580
0131-002,2015,7,17,1,105,99,204,385
0131-002,2015,7,17,2,57,51,108,204
0131-002,2015,7,17,3,33,43,76,108
0131-002,2015,7,17,4,45,29,74,76
0131-002,2015,7,17,5,45,61,106,74
0131-002,2015,7,17,6,189,102,291,106
0131-002,2015,7,17,7,748,300,1048,291
0131-002,2015,7,17,8,1747,768,2515,1048
0131-002,2015,7,17,9,1591,1066,2657,2515
0131-002,2015,7,17,10,916,757,1673,2657
0131-002,2015,7,17,11,884,765,1649,1673
0131-002,2015,7,17,12,818,670,1488,1649
0131-002,2015,7,17,13,754,665,1419,1488
0131-002,2015,7,17,14,886,714,1600,1419
0131-002,2015,7,17,15,866,892,1758,1600
0131-002,2015,7,17,16,886,948,1834,1758
0131-002,2015,7,17,17,840,989,1829,1834
0131-002,2015,7,17,18,1064,1311,2375,1829
0131-002,2015,7,17,19,1130,1307,2437,2375
0131-002,2015,7,17,20,954,873,1827,2437
0131-002,2015,7,17,21,543,665,1208,1827
0131-002,2015,7,17,22,395,409,804,1208
0131-002,2015,7,17,23,285,201,486,804
0131-002,2015,7,17,24,175,142,317,486
0131-002,2015,7,18,1,101,77,178,317
0131-002,2015,7,18,2,77,74,151,178
0131-002,2015,7,18,3,45,52,97,151
0131-002,2015,7,18,4,31,29,60,97
0131-002,2015,7,18,5,43,49,92,60
0131-002,2015,7,18,6,207,96,303,92
0131-002,2015,7,18,7,509,251,760,303
0131-002,2015,7,18,8,852,518,1370,760
0131-002,2015,7,18,9,988,765,1753,1370
0131-002,2015,7,18,10,804,658,1462,1753
0131-002,2015,7,18,11,760,739,1499,1462
0131-002,2015,7,18,12,754,780,1534,1499
0131-002,2015,7,18,13,727,727,1454,1534
0131-002,2015,7,18,14,719,690,1409,1454
0131-002,2015,7,18,15,858,692,1550,1409
0131-002,2015,7,18,16,818,664,1482,1550
0131-002,2015,7,18,17,784,765,1549,1482
0131-002,2015,7,18,18,1012,987,1999,1549
0131-002,2015,7,18,19,1053,768,1821,1999
0131-002,2015,7,18,20,675,415,1090,1821
0131-002,2015,7,18,21,461,291,752,1090
0131-002,2015,7,18,22,269,213,482,752
0131-002,2015,7,18,23,223,139,362,482
0131-002,2015,7,18,24,109,87,196,362
0131-002,2015,7,19,1,75,71,146,196
0131-002,2015,7,19,2,49,39,88,146
0131-002,2015,7,19,3,33,43,76,88
0131-002,2015,7,19,4,11,27,38,76
0131-002,2015,7,19,5,37,21,58,38
0131-002,2015,7,19,6,71,48,119,58
0131-002,2015,7,19,7,201,92,293,119
0131-002,2015,7,19,8,203,197,400,293
0131-002,2015,7,19,9,275,369,644,400
0131-002,2015,7,19,10,269,362,631,644
0131-002,2015,7,19,11,449,382,831,631
0131-002,2015,7,19,12,465,438,903,831
0131-002,2015,7,19,13,629,398,1027,903
0131-002,2015,7,19,14,601,447,1048,1027
0131-002,2015,7,19,15,577,459,1036,1048
0131-002,2015,7,19,16,681,469,1150,1036
0131-002,2015,7,19,17,852,490,1342,1150
0131-002,2015,7,19,18,904,497,1401,1342
0131-002,2015,7,19,19,774,347,1121,1401
0131-002,2015,7,19,20,613,342,955,1121
0131-002,2015,7,19,21,635,282,917,955
0131-002,2015,7,19,22,465,230,695,917
0131-002,2015,7,19,23,287,141,428,695
0131-002,2015,7,19,24,147,107,254,428
0131-002,2015,7,20,1,81,54,135,254
0131-002,2015,7,20,2,29,26,55,135
0131-002,2015,7,20,3,23,17,40,55
0131-002,2015,7,20,4,13,14,27,40
0131-002,2015,7,20,5,47,31,78,27
0131-002,2015,7,20,6,349,92,441,78
0131-002,2015,7,20,7,1026,337,1363,441
0131-002,2015,7,20,8,2228,765,2993,1363
0131-002,2015,7,20,9,1707,973,2680,2993
0131-002,2015,7,20,10,892,760,1652,2680
0131-002,2015,7,20,11,896,742,1638,1652
0131-002,2015,7,20,12,876,907,1783,1638
0131-002,2015,7,20,13,750,596,1346,1783
0131-002,2015,7,20,14,846,684,1530,1346
0131-002,2015,7,20,15,920,795,1715,1530
0131-002,2015,7,20,16,962,888,1850,1715
0131-002,2015,7,20,17,786,926,1712,1850
0131-002,2015,7,20,18,824,1353,2177,1712
0131-002,2015,7,20,19,852,1187,2039,2177
0131-002,2015,7,20,20,657,888,1545,2039
0131-002,2015,7,20,21,471,916,1387,1545
0131-002,2015,7,20,22,385,734,1119,1387
0131-002,2015,7,20,23,273,332,605,1119
0131-002,2015,7,20,24,129,151,280,605
0131-002,2015,7,21,1,53,79,132,280
0131-002,2015,7,21,2,51,33,84,132
0131-002,2015,7,21,3,33,49,82,84
0131-002,2015,7,21,4,27,70,97,82
0131-002,2015,7,21,5,53,68,121,97
0131-002,2015,7,21,6,161,133,294,121
0131-002,2015,7,21,7,641,369,1010,294
0131-002,2015,7,21,8,1908,1001,2909,1010
0131-002,2015,7,21,9,1731,995,2726,2909
0131-002,2015,7,21,10,888,989,1877,2726
0131-002,2015,7,21,11,946,1075,2021,1877
0131-002,2015,7,21,12,832,972,1804,2021
0131-002,2015,7,21,13,707,832,1539,1804
0131-002,2015,7,21,14,862,929,1791,1539
0131-002,2015,7,21,15,928,1091,2019,1791
0131-002,2015,7,21,16,896,1275,2171,2019
0131-002,2015,7,21,17,754,1306,2060,2171
0131-002,2015,7,21,18,894,1530,2424,2060
0131-002,2015,7,21,19,860,1627,2487,2424
0131-002,2015,7,21,20,645,1163,1808,2487
0131-002,2015,7,21,21,451,901,1352,1808
0131-002,2015,7,21,22,415,506,921,1352
0131-002,2015,7,21,23,241,253,494,921
0131-002,2015,7,21,24,129,157,286,494
0131-002,2015,7,22,1,67,87,154,286
0131-002,2015,7,22,2,49,58,107,154
0131-002,2015,7,22,3,31,43,74,107
0131-002,2015,7,22,4,35,39,74,74
0131-002,2015,7,22,5,39,42,81,74
0131-002,2015,7,22,6,231,83,314,81
0131-002,2015,7,22,7,824,281,1105,314
0131-002,2015,7,22,8,1954,771,2725,1105
0131-002,2015,7,22,9,1645,982,2627,2725
0131-002,2015,7,22,10,878,923,1801,2627
0131-002,2015,7,22,11,928,1078,2006,1801
0131-002,2015,7,22,12,818,835,1653,2006
0131-002,2015,7,22,13,741,813,1554,1653
0131-002,2015,7,22,14,808,774,1582,1554
0131-002,2015,7,22,15,926,779,1705,1582
0131-002,2015,7,22,16,886,799,1685,1705
0131-002,2015,7,22,17,858,888,1746,1685
0131-002,2015,7,22,18,940,1338,2278,1746
0131-002,2015,7,22,19,1014,1160,2174,2278
0131-002,2015,7,22,20,667,867,1534,2174
0131-002,2015,7,22,21,413,599,1012,1534
0131-002,2015,7,22,22,351,394,745,1012
0131-002,2015,7,22,23,263,269,532,745
0131-002,2015,7,22,24,193,148,341,532
0131-002,2015,7,23,1,105,95,200,341
0131-002,2015,7,23,2,63,62,125,200
0131-002,2015,7,23,3,33,49,82,125
0131-002,2015,7,23,4,35,26,61,82
0131-002,2015,7,23,5,53,37,90,61
0131-002,2015,7,23,6,221,71,292,90
0131-002,2015,7,23,7,780,301,1081,292
0131-002,2015,7,23,8,1883,807,2690,1081
0131-002,2015,7,23,9,1472,1040,2512,2690
0131-002,2015,7,23,10,956,938,1894,2512
0131-002,2015,7,23,11,910,805,1715,1894
0131-002,2015,7,23,12,824,807,1631,1715
0131-002,2015,7,23,13,697,642,1339,1631
0131-002,2015,7,23,14,796,724,1520,1339
0131-002,2015,7,23,15,952,824,1776,1520
0131-002,2015,7,23,16,748,852,1600,1776
0131-002,2015,7,23,17,729,863,1592,1600
0131-002,2015,7,23,18,846,1000,1846,1592
0131-002,2015,7,23,19,1026,1035,2061,1846
0131-002,2015,7,23,20,709,704,1413,2061
0131-002,2015,7,23,21,431,606,1037,1413
0131-002,2015,7,23,22,331,365,696,1037
0131-002,2015,7,23,23,221,253,474,696
0131-002,2015,7,23,24,109,105,214,474
0131-002,2015,7,24,1,61,74,135,214
0131-002,2015,7,24,2,55,61,116,135
0131-002,2015,7,24,3,23,23,46,116
0131-002,2015,7,24,4,23,27,50,46
0131-002,2015,7,24,5,43,58,101,50
0131-002,2015,7,24,6,131,64,195,101
0131-002,2015,7,24,7,551,219,770,195
0131-002,2015,7,24,8,1525,653,2178,770
0131-002,2015,7,24,9,1320,945,2265,2178
0131-002,2015,7,24,10,711,649,1360,2265
0131-002,2015,7,24,11,780,634,1414,1360
0131-002,2015,7,24,12,788,737,1525,1414
0131-002,2015,7,24,13,669,674,1343,1525
0131-002,2015,7,24,14,810,729,1539,1343
0131-002,2015,7,24,15,912,844,1756,1539
0131-002,2015,7,24,16,950,882,1832,1756
0131-002,2015,7,24,17,782,895,1677,1832
0131-002,2015,7,24,18,896,1264,2160,1677
0131-002,2015,7,24,19,984,1442,2426,2160
0131-002,2015,7,24,20,733,904,1637,2426
0131-002,2015,7,24,21,601,664,1265,1637
0131-002,2015,7,24,22,341,500,841,1265
0131-002,2015,7,24,23,295,225,520,841
0131-002,2015,7,24,24,177,149,326,520
0131-002,2015,7,25,1,89,104,193,326
0131-002,2015,7,25,2,77,61,138,193
0131-002,2015,7,25,3,49,68,117,138
0131-002,2015,7,25,4,33,104,137,117
0131-002,2015,7,25,5,41,171,212,137
0131-002,2015,7,25,6,141,111,252,212
0131-002,2015,7,25,7,455,207,662,252
0131-002,2015,7,25,8,884,419,1303,662
0131-002,2015,7,25,9,737,645,1382,1303
0131-002,2015,7,25,10,691,726,1417,1382
0131-002,2015,7,25,11,681,671,1352,1417
0131-002,2015,7,25,12,806,752,1558,1352
0131-002,2015,7,25,13,812,821,1633,1558
0131-002,2015,7,25,14,709,907,1616,1633
0131-002,2015,7,25,15,729,801,1530,1616
0131-002,2015,7,25,16,862,681,1543,1530
0131-002,2015,7,25,17,908,780,1688,1543
0131-002,2015,7,25,18,963,897,1860,1688
0131-002,2015,7,25,19,852,622,1474,1860
0131-002,2015,7,25,20,601,391,992,1474
0131-002,2015,7,25,21,487,329,816,992
0131-002,2015,7,25,22,319,248,567,816
0131-002,2015,7,25,23,175,145,320,567
0131-002,2015,7,25,24,89,98,187,320
0131-002,2015,7,26,1,69,90,159,187
0131-002,2015,7,26,2,47,40,87,159
0131-002,2015,7,26,3,53,26,79,87
0131-002,2015,7,26,4,37,52,89,79
0131-002,2015,7,26,5,37,26,63,89
0131-002,2015,7,26,6,103,37,140,63
0131-002,2015,7,26,7,257,99,356,140
0131-002,2015,7,26,8,223,161,384,356
0131-002,2015,7,26,9,251,298,549,384
0131-002,2015,7,26,10,359,338,697,549
0131-002,2015,7,26,11,359,403,762,697
0131-002,2015,7,26,12,393,381,774,762
0131-002,2015,7,26,13,437,437,874,774
0131-002,2015,7,26,14,545,546,1091,874
0131-002,2015,7,26,15,593,589,1182,1091
0131-002,2015,7,26,16,639,518,1157,1182
0131-002,2015,7,26,17,703,524,1227,1157
0131-002,2015,7,26,18,752,503,1255,1227
0131-002,2015,7,26,19,717,503,1220,1255
0131-002,2015,7,26,20,591,322,913,1220
0131-002,2015,7,26,21,551,316,867,913
0131-002,2015,7,26,22,349,244,593,867
0131-002,2015,7,26,23,277,180,457,593
0131-002,2015,7,26,24,151,92,243,457
0131-002,2015,7,27,1,65,64,129,243
0131-002,2015,7,27,2,45,26,71,129
0131-002,2015,7,27,3,25,46,71,71
0131-002,2015,7,27,4,17,20,37,71
0131-002,2015,7,27,5,31,36,67,37
0131-002,2015,7,27,6,307,139,446,67
0131-002,2015,7,27,7,938,337,1275,446
0131-002,2015,7,27,8,2131,836,2967,1275
0131-002,2015,7,27,9,1539,1116,2655,2967
0131-002,2015,7,27,10,818,942,1760,2655
0131-002,2015,7,27,11,890,835,1725,1760
0131-002,2015,7,27,12,872,832,1704,1725
0131-002,2015,7,27,13,766,771,1537,1704
0131-002,2015,7,27,14,830,733,1563,1537
0131-002,2015,7,27,15,902,836,1738,1563
0131-002,2015,7,27,16,930,895,1825,1738
0131-002,2015,7,27,17,874,1029,1903,1825
0131-002,2015,7,27,18,976,1160,2136,1903
0131-002,2015,7,27,19,872,1275,2147,2136
0131-002,2015,7,27,20,677,877,1554,2147
0131-002,2015,7,27,21,535,761,1296,1554
0131-002,2015,7,27,22,373,440,813,1296
0131-002,2015,7,27,23,233,198,431,813
0131-002,2015,7,27,24,129,126,255,431
0131-002,2015,7,28,1,93,70,163,255
0131-002,2015,7,28,2,49,46,95,163
0131-002,2015,7,28,3,33,34,67,95
0131-002,2015,7,28,4,31,33,64,67
0131-002,2015,7,28,5,55,45,100,64
0131-002,2015,7,28,6,183,96,279,100
0131-002,2015,7,28,7,838,298,1136,279
0131-002,2015,7,28,8,1863,807,2670,1136
0131-002,2015,7,28,9,1521,1216,2737,2670
0131-002,2015,7,28,10,896,984,1880,2737
0131-002,2015,7,28,11,904,844,1748,1880
0131-002,2015,7,28,12,890,802,1692,1748
0131-002,2015,7,28,13,721,611,1332,1692
0131-002,2015,7,28,14,798,717,1515,1332
0131-002,2015,7,28,15,1132,801,1933,1515
0131-002,2015,7,28,16,1162,854,2016,1933
0131-002,2015,7,28,17,1060,886,1946,2016
0131-002,2015,7,28,18,962,1221,2183,1946
0131-002,2015,7,28,19,1000,1194,2194,2183
0131-002,2015,7,28,20,731,827,1558,2194
0131-002,2015,7,28,21,485,642,1127,1558
0131-002,2015,7,28,22,351,434,785,1127
0131-002,2015,7,28,23,257,255,512,785
0131-002,2015,7,28,24,185,149,334,512
0131-002,2015,7,29,1,77,108,185,334
0131-002,2015,7,29,2,55,43,98,185
0131-002,2015,7,29,3,31,48,79,98
0131-002,2015,7,29,4,37,30,67,79
0131-002,2015,7,29,5,35,37,72,67
0131-002,2015,7,29,6,209,83,292,72
0131-002,2015,7,29,7,671,244,915,292
0131-002,2015,7,29,8,1415,687,2102,915
0131-002,2015,7,29,9,1250,813,2063,2102
0131-002,2015,7,29,10,882,646,1528,2063
0131-002,2015,7,29,11,649,673,1322,1528
0131-002,2015,7,29,12,814,655,1469,1322
0131-002,2015,7,29,13,675,764,1439,1469
0131-002,2015,7,29,14,830,904,1734,1439
0131-002,2015,7,29,15,822,978,1800,1734
0131-002,2015,7,29,16,890,923,1813,1800
0131-002,2015,7,29,17,878,795,1673,1813
0131-002,2015,7,29,18,930,1062,1992,1673
0131-002,2015,7,29,19,886,1140,2026,1992
0131-002,2015,7,29,20,675,867,1542,2026
0131-002,2015,7,29,21,495,730,1225,1542
0131-002,2015,7,29,22,357,544,901,1225
0131-002,2015,7,29,23,241,216,457,901
0131-002,2015,7,29,24,169,152,321,457
0131-002,2015,7,30,1,91,99,190,321
0131-002,2015,7,30,2,37,46,83,190
0131-002,2015,7,30,3,47,33,80,83
0131-002,2015,7,30,4,39,31,70,80
0131-002,2015,7,30,5,57,37,94,70
0131-002,2015,7,30,6,227,138,365,94
0131-002,2015,7,30,7,744,367,1111,365
0131-002,2015,7,30,8,1862,771,2633,1111
0131-002,2015,7,30,9,1438,953,2391,2633
0131-002,2015,7,30,10,886,1125,2011,2391
0131-002,2015,7,30,11,928,1308,2236,2011
0131-002,2015,7,30,12,912,1032,1944,2236
0131-002,2015,7,30,13,703,964,1667,1944
0131-002,2015,7,30,14,764,1224,1988,1667
0131-002,2015,7,30,15,928,1138,2066,1988
0131-002,2015,7,30,16,900,1082,1982,2066
0131-002,2015,7,30,17,812,1125,1937,1982
0131-002,2015,7,30,18,1020,1540,2560,1937
0131-002,2015,7,30,19,1018,1405,2423,2560
0131-002,2015,7,30,20,748,846,1594,2423
0131-002,2015,7,30,21,511,757,1268,1594
0131-002,2015,7,30,22,405,403,808,1268
0131-002,2015,7,30,23,323,244,567,808
0131-002,2015,7,30,24,137,158,295,567
0131-002,2015,7,31,1,107,83,190,295
0131-002,2015,7,31,2,61,54,115,190
0131-002,2015,7,31,3,35,49,84,115
0131-002,2015,7,31,4,33,45,78,84
0131-002,2015,7,31,5,55,58,113,78
0131-002,2015,7,31,6,197,114,311,113
0131-002,2015,7,31,7,733,278,1011,311
0131-002,2015,7,31,8,1775,671,2446,1011
0131-002,2015,7,31,9,1326,855,2181,2446
0131-002,2015,7,31,10,876,727,1603,2181
0131-002,2015,7,31,11,886,774,1660,1603
0131-002,2015,7,31,12,836,742,1578,1660
0131-002,2015,7,31,13,723,667,1390,1578
0131-002,2015,7,31,14,750,733,1483,1390
0131-002,2015,7,31,15,874,811,1685,1483
0131-002,2015,7,31,16,968,883,1851,1685
0131-002,2015,7,31,17,900,933,1833,1851
0131-002,2015,7,31,18,1000,1452,2452,1833
0131-002,2015,7,31,19,1222,1447,2669,2452
0131-002,2015,7,31,20,886,1085,1971,2669
0131-002,2015,7,31,21,555,718,1273,1971
0131-002,2015,7,31,22,373,493,866,1273
0131-002,2015,7,31,23,303,253,556,866
0131-002,2015,7,31,24,187,179,366,556
0131-002,2015,8,1,1,94,114,208,366
0131-002,2015,8,1,2,77,69,146,208
0131-002,2015,8,1,3,50,57,107,146
0131-002,2015,8,1,4,33,54,87,107
0131-002,2015,8,1,5,39,56,95,87
0131-002,2015,8,1,6,196,136,332,95
0131-002,2015,8,1,7,411,251,662,332
0131-002,2015,8,1,8,672,505,1177,662
0131-002,2015,8,1,9,636,967,1603,1177
0131-002,2015,8,1,10,653,1056,1709,1603
0131-002,2015,8,1,11,742,1352,2094,1709
0131-002,2015,8,1,12,693,1200,1893,2094
0131-002,2015,8,1,13,649,1092,1741,1893
0131-002,2015,8,1,14,621,998,1619,1741
0131-002,2015,8,1,15,676,976,1652,1619
0131-002,2015,8,1,16,691,864,1555,1652
0131-002,2015,8,1,17,680,749,1429,1555
0131-002,2015,8,1,18,836,764,1600,1429
0131-002,2015,8,1,19,771,705,1476,1600
0131-002,2015,8,1,20,699,368,1067,1476
0131-002,2015,8,1,21,457,298,755,1067
0131-002,2015,8,1,22,250,249,499,755
0131-002,2015,8,1,23,179,142,321,499
0131-002,2015,8,1,24,113,115,228,321
0131-002,2015,8,2,1,77,88,165,228
0131-002,2015,8,2,2,31,45,76,165
0131-002,2015,8,2,3,23,26,49,76
0131-002,2015,8,2,4,27,39,66,49
0131-002,2015,8,2,5,29,36,65,66
0131-002,2015,8,2,6,56,44,100,65
0131-002,2015,8,2,7,141,99,240,100
0131-002,2015,8,2,8,196,120,316,240
0131-002,2015,8,2,9,240,218,458,316
0131-002,2015,8,2,10,299,347,646,458
0131-002,2015,8,2,11,451,331,782,646
0131-002,2015,8,2,12,413,353,766,782
0131-002,2015,8,2,13,529,377,906,766
0131-002,2015,8,2,14,539,367,906,906
0131-002,2015,8,2,15,889,458,1347,906
0131-002,2015,8,2,16,1045,435,1480,1347
0131-002,2015,8,2,17,841,530,1371,1480
0131-002,2015,8,2,18,891,527,1418,1371
0131-002,2015,8,2,19,855,388,1243,1418
0131-002,2015,8,2,20,714,331,1045,1243
0131-002,2015,8,2,21,645,295,940,1045
0131-002,2015,8,2,22,461,191,652,940
0131-002,2015,8,2,23,286,148,434,652
0131-002,2015,8,2,24,103,88,191,434
0131-002,2015,8,3,1,65,54,119,191
0131-002,2015,8,3,2,37,39,76,119
0131-002,2015,8,3,3,23,23,46,76
0131-002,2015,8,3,4,25,24,49,46
0131-002,2015,8,3,5,25,23,48,49
0131-002,2015,8,3,6,200,66,266,48
0131-002,2015,8,3,7,600,248,848,266
0131-002,2015,8,3,8,1191,519,1710,848
0131-002,2015,8,3,9,1058,722,1780,1710
0131-002,2015,8,3,10,710,617,1327,1780
0131-002,2015,8,3,11,693,608,1301,1327
0131-002,2015,8,3,12,741,745,1486,1301
0131-002,2015,8,3,13,602,575,1177,1486
0131-002,2015,8,3,14,760,661,1421,1177
0131-002,2015,8,3,15,680,901,1581,1421
0131-002,2015,8,3,16,752,1124,1876,1581
0131-002,2015,8,3,17,674,961,1635,1876
0131-002,2015,8,3,18,752,1136,1888,1635
0131-002,2015,8,3,19,792,867,1659,1888
0131-002,2015,8,3,20,571,490,1061,1659
0131-002,2015,8,3,21,446,462,908,1061
0131-002,2015,8,3,22,339,262,601,908
0131-002,2015,8,3,23,255,145,400,601
0131-002,2015,8,3,24,134,120,254,400
0131-002,2015,8,4,1,44,65,109,254
0131-002,2015,8,4,2,33,32,65,109
0131-002,2015,8,4,3,18,29,47,65
0131-002,2015,8,4,4,12,24,36,47
0131-002,2015,8,4,5,40,42,82,36
0131-002,2015,8,4,6,176,79,255,82
0131-002,2015,8,4,7,463,265,728,255
0131-002,2015,8,4,8,985,499,1484,728
0131-002,2015,8,4,9,952,721,1673,1484
0131-002,2015,8,4,10,750,586,1336,1673
0131-002,2015,8,4,11,628,605,1233,1336
0131-002,2015,8,4,12,642,539,1181,1233
0131-002,2015,8,4,13,507,577,1084,1181
0131-002,2015,8,4,14,682,577,1259,1084
0131-002,2015,8,4,15,689,682,1371,1259
0131-002,2015,8,4,16,722,708,1430,1371
0131-002,2015,8,4,17,720,709,1429,1430
0131-002,2015,8,4,18,815,885,1700,1429
0131-002,2015,8,4,19,986,877,1863,1700
0131-002,2015,8,4,20,718,557,1275,1863
0131-002,2015,8,4,21,497,438,935,1275
0131-002,2015,8,4,22,343,274,617,935
0131-002,2015,8,4,23,215,185,400,617
0131-002,2015,8,4,24,141,136,277,400
0131-002,2015,8,5,1,69,90,159,277
0131-002,2015,8,5,2,25,39,64,159
0131-002,2015,8,5,3,35,35,70,64
0131-002,2015,8,5,4,18,41,59,70
0131-002,2015,8,5,5,44,47,91,59
0131-002,2015,8,5,6,155,79,234,91
0131-002,2015,8,5,7,493,245,738,234
0131-002,2015,8,5,8,1056,496,1552,738
0131-002,2015,8,5,9,997,728,1725,1552
0131-002,2015,8,5,10,689,612,1301,1725
0131-002,2015,8,5,11,704,588,1292,1301
0131-002,2015,8,5,12,674,572,1246,1292
0131-002,2015,8,5,13,598,578,1176,1246
0131-002,2015,8,5,14,647,562,1209,1176
0131-002,2015,8,5,15,824,687,1511,1209
0131-002,2015,8,5,16,744,591,1335,1511
0131-002,2015,8,5,17,645,712,1357,1335
0131-002,2015,8,5,18,836,960,1796,1357
0131-002,2015,8,5,19,868,941,1809,1796
0131-002,2015,8,5,20,575,547,1122,1809
0131-002,2015,8,5,21,387,414,801,1122
0131-002,2015,8,5,22,282,310,592,801
0131-002,2015,8,5,23,217,191,408,592
0131-002,2015,8,5,24,166,126,292,408
0131-002,2015,8,6,1,82,69,151,292
0131-002,2015,8,6,2,50,30,80,151
0131-002,2015,8,6,3,29,29,58,80
0131-002,2015,8,6,4,25,26,51,58
0131-002,2015,8,6,5,31,39,70,51
0131-002,2015,8,6,6,166,87,253,70
0131-002,2015,8,6,7,645,264,909,253
0131-002,2015,8,6,8,1294,539,1833,909
0131-002,2015,8,6,9,1144,822,1966,1833
0131-002,2015,8,6,10,796,669,1465,1966
0131-002,2015,8,6,11,800,676,1476,1465
0131-002,2015,8,6,12,733,736,1469,1476
0131-002,2015,8,6,13,640,560,1200,1469
0131-002,2015,8,6,14,725,629,1354,1200
0131-002,2015,8,6,15,811,715,1526,1354
0131-002,2015,8,6,16,817,684,1501,1526
0131-002,2015,8,6,17,820,702,1522,1501
0131-002,2015,8,6,18,874,965,1839,1522
0131-002,2015,8,6,19,826,976,1802,1839
0131-002,2015,8,6,20,586,590,1176,1802
0131-002,2015,8,6,21,402,526,928,1176
0131-002,2015,8,6,22,303,332,635,928
0131-002,2015,8,6,23,244,179,423,635
0131-002,2015,8,6,24,147,111,258,423
0131-002,2015,8,7,1,71,75,146,258
0131-002,2015,8,7,2,52,41,93,146
0131-002,2015,8,7,3,35,45,80,93
0131-002,2015,8,7,4,35,24,59,80
0131-002,2015,8,7,5,35,53,88,59
0131-002,2015,8,7,6,157,88,245,88
0131-002,2015,8,7,7,543,252,795,245
0131-002,2015,8,7,8,1302,584,1886,795
0131-002,2015,8,7,9,1169,819,1988,1886
0131-002,2015,8,7,10,786,761,1547,1988
0131-002,2015,8,7,11,828,775,1603,1547
0131-002,2015,8,7,12,739,661,1400,1603
0131-002,2015,8,7,13,630,615,1245,1400
0131-002,2015,8,7,14,704,694,1398,1245
0131-002,2015,8,7,15,813,734,1547,1398
0131-002,2015,8,7,16,840,742,1582,1547
0131-002,2015,8,7,17,748,824,1572,1582
0131-002,2015,8,7,18,1024,1145,2169,1572
0131-002,2015,8,7,19,1032,1174,2206,2169
0131-002,2015,8,7,20,739,778,1517,2206
0131-002,2015,8,7,21,590,553,1143,1517
0131-002,2015,8,7,22,354,391,745,1143
0131-002,2015,8,7,23,219,213,432,745
0131-002,2015,8,7,24,122,146,268,432
0131-002,2015,8,8,1,82,94,176,268
0131-002,2015,8,8,2,58,76,134,176
0131-002,2015,8,8,3,58,33,91,134
0131-002,2015,8,8,4,31,39,70,91
0131-002,2015,8,8,5,52,45,97,70
0131-002,2015,8,8,6,168,91,259,97
0131-002,2015,8,8,7,427,197,624,259
0131-002,2015,8,8,8,672,417,1089,624
0131-002,2015,8,8,9,758,638,1396,1089
0131-002,2015,8,8,10,611,678,1289,1396
0131-002,2015,8,8,11,668,664,1332,1289
0131-002,2015,8,8,12,645,779,1424,1332
0131-002,2015,8,8,13,605,708,1313,1424
0131-002,2015,8,8,14,547,551,1098,1313
0131-002,2015,8,8,15,645,636,1281,1098
0131-002,2015,8,8,16,634,593,1227,1281
0131-002,2015,8,8,17,691,657,1348,1227
0131-002,2015,8,8,18,800,740,1540,1348
0131-002,2015,8,8,19,720,587,1307,1540
0131-002,2015,8,8,20,505,335,840,1307
0131-002,2015,8,8,21,448,282,730,840
0131-002,2015,8,8,22,297,198,495,730
0131-002,2015,8,8,23,185,146,331,495
0131-002,2015,8,8,24,94,105,199,331
0131-002,2015,8,9,1,63,73,136,199
0131-002,2015,8,9,2,39,48,87,136
0131-002,2015,8,9,3,33,36,69,87
0131-002,2015,8,9,4,31,33,64,69
0131-002,2015,8,9,5,29,20,49,64
0131-002,2015,8,9,6,71,53,124,49
0131-002,2015,8,9,7,200,87,287,124
0131-002,2015,8,9,8,259,176,435,287
0131-002,2015,8,9,9,278,242,520,435
0131-002,2015,8,9,10,276,301,577,520
0131-002,2015,8,9,11,356,295,651,577
0131-002,2015,8,9,12,430,411,841,651
0131-002,2015,8,9,13,391,462,853,841
0131-002,2015,8,9,14,503,435,938,853
0131-002,2015,8,9,15,484,428,912,938
0131-002,2015,8,9,16,632,423,1055,912
0131-002,2015,8,9,17,592,434,1026,1055
0131-002,2015,8,9,18,725,527,1252,1026
0131-002,2015,8,9,19,649,425,1074,1252
0131-002,2015,8,9,20,531,307,838,1074
0131-002,2015,8,9,21,489,301,790,838
0131-002,2015,8,9,22,341,230,571,790
0131-002,2015,8,9,23,255,131,386,571
0131-002,2015,8,9,24,122,81,203,386
0131-002,2015,8,10,1,84,60,144,203
0131-002,2015,8,10,2,21,29,50,144
0131-002,2015,8,10,3,10,18,28,50
0131-002,2015,8,10,4,18,20,38,28
0131-002,2015,8,10,5,48,24,72,38
0131-002,2015,8,10,6,215,90,305,72
0131-002,2015,8,10,7,902,295,1197,305
0131-002,2015,8,10,8,2032,795,2827,1197
0131-002,2015,8,10,9,1517,965,2482,2827
0131-002,2015,8,10,10,862,712,1574,2482
0131-002,2015,8,10,11,828,724,1552,1574
0131-002,2015,8,10,12,849,709,1558,1552
0131-002,2015,8,10,13,735,638,1373,1558
0131-002,2015,8,10,14,763,675,1438,1373
0131-002,2015,8,10,15,866,773,1639,1438
0131-002,2015,8,10,16,773,737,1510,1639
0131-002,2015,8,10,17,824,843,1667,1510
0131-002,2015,8,10,18,908,1135,2043,1667
0131-002,2015,8,10,19,866,1108,1974,2043
0131-002,2015,8,10,20,634,786,1420,1974
0131-002,2015,8,10,21,497,737,1234,1420
0131-002,2015,8,10,22,343,413,756,1234
0131-002,2015,8,10,23,236,225,461,756
0131-002,2015,8,10,24,134,120,254,461
0131-002,2015,8,11,1,75,76,151,254
0131-002,2015,8,11,2,48,62,110,151
0131-002,2015,8,11,3,35,44,79,110
0131-002,2015,8,11,4,23,32,55,79
0131-002,2015,8,11,5,23,45,68,55
0131-002,2015,8,11,6,227,84,311,68
0131-002,2015,8,11,7,807,294,1101,311
0131-002,2015,8,11,8,1807,757,2564,1101
0131-002,2015,8,11,9,1469,1019,2488,2564
0131-002,2015,8,11,10,849,743,1592,2488
0131-002,2015,8,11,11,813,815,1628,1592
0131-002,2015,8,11,12,916,706,1622,1628
0131-002,2015,8,11,13,661,597,1258,1622
0131-002,2015,8,11,14,866,788,1654,1258
0131-002,2015,8,11,15,959,825,1784,1654
0131-002,2015,8,11,16,919,828,1747,1784
0131-002,2015,8,11,17,840,864,1704,1747
0131-002,2015,8,11,18,906,1119,2025,1704
0131-002,2015,8,11,19,997,1048,2045,2025
0131-002,2015,8,11,20,613,782,1395,2045
0131-002,2015,8,11,21,438,702,1140,1395
0131-002,2015,8,11,22,351,407,758,1140
0131-002,2015,8,11,23,252,215,467,758
0131-002,2015,8,11,24,117,123,240,467
0131-002,2015,8,12,1,54,73,127,240
0131-002,2015,8,12,2,39,56,95,127
0131-002,2015,8,12,3,25,38,63,95
0131-002,2015,8,12,4,40,48,88,63
0131-002,2015,8,12,5,40,32,72,88
0131-002,2015,8,12,6,176,93,269,72
0131-002,2015,8,12,7,703,268,971,269
0131-002,2015,8,12,8,1779,670,2449,971
0131-002,2015,8,12,9,1467,928,2395,2449
0131-002,2015,8,12,10,862,778,1640,2395
0131-002,2015,8,12,11,912,772,1684,1640
0131-002,2015,8,12,12,828,781,1609,1684
0131-002,2015,8,12,13,644,693,1337,1609
0131-002,2015,8,12,14,773,658,1431,1337
0131-002,2015,8,12,15,849,784,1633,1431
0131-002,2015,8,12,16,832,794,1626,1633
0131-002,2015,8,12,17,777,928,1705,1626
0131-002,2015,8,12,18,876,1313,2189,1705
0131-002,2015,8,12,19,929,1224,2153,2189
0131-002,2015,8,12,20,682,772,1454,2153
0131-002,2015,8,12,21,451,623,1074,1454
0131-002,2015,8,12,22,328,358,686,1074
0131-002,2015,8,12,23,223,288,511,686
0131-002,2015,8,12,24,141,140,281,511
0131-002,2015,8,13,1,73,76,149,281
0131-002,2015,8,13,2,48,60,108,149
0131-002,2015,8,13,3,27,39,66,108
0131-002,2015,8,13,4,18,39,57,66
0131-002,2015,8,13,5,40,42,82,57
0131-002,2015,8,13,6,229,88,317,82
0131-002,2015,8,13,7,773,292,1065,317
0131-002,2015,8,13,8,1887,746,2633,1065
0131-002,2015,8,13,9,1521,1034,2555,2633
0131-002,2015,8,13,10,931,822,1753,2555
0131-002,2015,8,13,11,933,830,1763,1753
0131-002,2015,8,13,12,853,795,1648,1763
0131-002,2015,8,13,13,703,650,1353,1648
0131-002,2015,8,13,14,847,717,1564,1353
0131-002,2015,8,13,15,946,888,1834,1564
0131-002,2015,8,13,16,902,906,1808,1834
0131-002,2015,8,13,17,874,907,1781,1808
0131-002,2015,8,13,18,1028,1301,2329,1781
0131-002,2015,8,13,19,1051,1287,2338,2329
0131-002,2015,8,13,20,781,916,1697,2338
0131-002,2015,8,13,21,569,711,1280,1697
0131-002,2015,8,13,22,562,483,1045,1280
0131-002,2015,8,13,23,297,240,537,1045
0131-002,2015,8,13,24,134,151,285,537
0131-002,2015,8,14,1,107,93,200,285
0131-002,2015,8,14,2,84,66,150,200
0131-002,2015,8,14,3,27,41,68,150
0131-002,2015,8,14,4,31,39,70,68
0131-002,2015,8,14,5,39,59,98,70
0131-002,2015,8,14,6,183,108,291,98
0131-002,2015,8,14,7,550,267,817,291
0131-002,2015,8,14,8,1209,639,1848,817
0131-002,2015,8,14,9,1079,879,1958,1848
0131-002,2015,8,14,10,788,855,1643,1958
0131-002,2015,8,14,11,822,1026,1848,1643
0131-002,2015,8,14,12,820,995,1815,1848
0131-002,2015,8,14,13,731,892,1623,1815
0131-002,2015,8,14,14,716,861,1577,1623
0131-002,2015,8,14,15,794,833,1627,1577
0131-002,2015,8,14,16,800,852,1652,1627
0131-002,2015,8,14,17,742,812,1554,1652
0131-002,2015,8,14,18,750,1154,1904,1554
0131-002,2015,8,14,19,720,956,1676,1904
0131-002,2015,8,14,20,680,739,1419,1676
0131-002,2015,8,14,21,501,475,976,1419
0131-002,2015,8,14,22,330,341,671,976
0131-002,2015,8,14,23,271,196,467,671
0131-002,2015,8,14,24,136,142,278,467
0131-002,2015,8,15,1,103,82,185,278
0131-002,2015,8,15,2,56,56,112,185
0131-002,2015,8,15,3,33,39,72,112
0131-002,2015,8,15,4,37,41,78,72
0131-002,2015,8,15,5,56,39,95,78
0131-002,2015,8,15,6,158,88,246,95
0131-002,2015,8,15,7,349,197,546,246
0131-002,2015,8,15,8,664,341,1005,546
0131-002,2015,8,15,9,604,535,1139,1005
0131-002,2015,8,15,10,569,581,1150,1139
0131-002,2015,8,15,11,659,708,1367,1150
0131-002,2015,8,15,12,638,800,1438,1367
0131-002,2015,8,15,13,571,767,1338,1438
0131-002,2015,8,15,14,566,590,1156,1338
0131-002,2015,8,15,15,577,536,1113,1156
0131-002,2015,8,15,16,693,584,1277,1113
0131-002,2015,8,15,17,703,606,1309,1277
0131-002,2015,8,15,18,786,849,1635,1309
0131-002,2015,8,15,19,744,655,1399,1635
0131-002,2015,8,15,20,598,440,1038,1399
0131-002,2015,8,15,21,497,368,865,1038
0131-002,2015,8,15,22,280,222,502,865
0131-002,2015,8,15,23,195,142,337,502
0131-002,2015,8,15,24,153,114,267,337
0131-002,2015,8,16,1,86,84,170,267
0131-002,2015,8,16,2,54,66,120,170
0131-002,2015,8,16,3,29,38,67,120
0131-002,2015,8,16,4,44,26,70,67
0131-002,2015,8,16,5,37,44,81,70
0131-002,2015,8,16,6,90,54,144,81
0131-002,2015,8,16,7,204,87,291,144
0131-002,2015,8,16,8,212,154,366,291
0131-002,2015,8,16,9,280,261,541,366
0131-002,2015,8,16,10,255,285,540,541
0131-002,2015,8,16,11,362,382,744,540
0131-002,2015,8,16,12,391,392,783,744
0131-002,2015,8,16,13,554,423,977,783
0131-002,2015,8,16,14,567,379,946,977
0131-002,2015,8,16,15,647,456,1103,946
0131-002,2015,8,16,16,699,495,1194,1103
0131-002,2015,8,16,17,879,594,1473,1194
0131-002,2015,8,16,18,786,598,1384,1473
0131-002,2015,8,16,19,748,586,1334,1384
0131-002,2015,8,16,20,575,298,873,1334
0131-002,2015,8,16,21,508,225,733,873
0131-002,2015,8,16,22,493,190,683,733
0131-002,2015,8,16,23,263,117,380,683
0131-002,2015,8,16,24,158,75,233,380
0131-002,2015,8,17,1,56,39,95,233
0131-002,2015,8,17,2,35,32,67,95
0131-002,2015,8,17,3,21,17,38,67
0131-002,2015,8,17,4,33,14,47,38
0131-002,2015,8,17,5,52,45,97,47
0131-002,2015,8,17,6,267,97,364,97
0131-002,2015,8,17,7,946,319,1265,364
0131-002,2015,8,17,8,2029,856,2885,1265
0131-002,2015,8,17,9,1473,1169,2642,2885
0131-002,2015,8,17,10,857,898,1755,2642
0131-002,2015,8,17,11,897,904,1801,1755
0131-002,2015,8,17,12,815,958,1773,1801
0131-002,2015,8,17,13,722,751,1473,1773
0131-002,2015,8,17,14,824,644,1468,1473
0131-002,2015,8,17,15,876,870,1746,1468
0131-002,2015,8,17,16,836,816,1652,1746
0131-002,2015,8,17,17,868,973,1841,1652
0131-002,2015,8,17,18,853,1173,2026,1841
0131-002,2015,8,17,19,864,1121,1985,2026
0131-002,2015,8,17,20,712,785,1497,1985
0131-002,2015,8,17,21,408,717,1125,1497
0131-002,2015,8,17,22,366,408,774,1125
0131-002,2015,8,17,23,196,248,444,774
0131-002,2015,8,17,24,128,124,252,444
0131-002,2015,8,18,1,67,75,142,252
0131-002,2015,8,18,2,42,50,92,142
0131-002,2015,8,18,3,23,33,56,92
0131-002,2015,8,18,4,48,33,81,56
0131-002,2015,8,18,5,46,57,103,81
0131-002,2015,8,18,6,214,100,314,103
0131-002,2015,8,18,7,746,274,1020,314
0131-002,2015,8,18,8,1874,773,2647,1020
0131-002,2015,8,18,9,1562,999,2561,2647
0131-002,2015,8,18,10,946,789,1735,2561
0131-002,2015,8,18,11,1007,809,1816,1735
0131-002,2015,8,18,12,857,778,1635,1816
0131-002,2015,8,18,13,762,682,1444,1635
0131-002,2015,8,18,14,794,746,1540,1444
0131-002,2015,8,18,15,935,877,1812,1540
0131-002,2015,8,18,16,870,891,1761,1812
0131-002,2015,8,18,17,803,897,1700,1761
0131-002,2015,8,18,18,879,1243,2122,1700
0131-002,2015,8,18,19,893,1104,1997,2122
0131-002,2015,8,18,20,748,815,1563,1997
0131-002,2015,8,18,21,478,784,1262,1563
0131-002,2015,8,18,22,392,428,820,1262
0131-002,2015,8,18,23,250,248,498,820
0131-002,2015,8,18,24,193,134,327,498
0131-002,2015,8,19,1,67,76,143,327
0131-002,2015,8,19,2,46,56,102,143
0131-002,2015,8,19,3,37,42,79,102
0131-002,2015,8,19,4,39,30,69,79
0131-002,2015,8,19,5,50,47,97,69
0131-002,2015,8,19,6,212,94,306,97
0131-002,2015,8,19,7,735,307,1042,306
0131-002,2015,8,19,8,1850,724,2574,1042
0131-002,2015,8,19,9,1581,1062,2643,2574
0131-002,2015,8,19,10,957,821,1778,2643
0131-002,2015,8,19,11,988,803,1791,1778
0131-002,2015,8,19,12,898,797,1695,1791
0131-002,2015,8,19,13,731,749,1480,1695
0131-002,2015,8,19,14,851,755,1606,1480
0131-002,2015,8,19,15,921,868,1789,1606
0131-002,2015,8,19,16,889,848,1737,1789
0131-002,2015,8,19,17,859,987,1846,1737
0131-002,2015,8,19,18,942,1275,2217,1846
0131-002,2015,8,19,19,914,1267,2181,2217
0131-002,2015,8,19,20,664,831,1495,2181
0131-002,2015,8,19,21,432,673,1105,1495
0131-002,2015,8,19,22,316,431,747,1105
0131-002,2015,8,19,23,254,231,485,747
0131-002,2015,8,19,24,162,106,268,485
0131-002,2015,8,20,1,92,79,171,268
0131-002,2015,8,20,2,46,45,91,171
0131-002,2015,8,20,3,20,38,58,91
0131-002,2015,8,20,4,29,39,68,58
0131-002,2015,8,20,5,25,38,63,68
0131-002,2015,8,20,6,208,82,290,63
0131-002,2015,8,20,7,800,331,1131,290
0131-002,2015,8,20,8,1833,709,2542,1131
0131-002,2015,8,20,9,1576,1069,2645,2542
0131-002,2015,8,20,10,986,830,1816,2645
0131-002,2015,8,20,11,887,868,1755,1816
0131-002,2015,8,20,12,895,795,1690,1755
0131-002,2015,8,20,13,678,615,1293,1690
0131-002,2015,8,20,14,845,691,1536,1293
0131-002,2015,8,20,15,902,986,1888,1536
0131-002,2015,8,20,16,918,1031,1949,1888
0131-002,2015,8,20,17,847,1447,2294,1949
0131-002,2015,8,20,18,822,1604,2426,2294
0131-002,2015,8,20,19,813,1260,2073,2426
0131-002,2015,8,20,20,590,1138,1728,2073
0131-002,2015,8,20,21,440,1017,1457,1728
0131-002,2015,8,20,22,335,709,1044,1457
0131-002,2015,8,20,23,238,511,749,1044
0131-002,2015,8,20,24,153,322,475,749
0131-002,2015,8,21,1,90,239,329,475
0131-002,2015,8,21,2,69,90,159,329
0131-002,2015,8,21,3,21,117,138,159
0131-002,2015,8,21,4,50,106,156,138
0131-002,2015,8,21,5,44,121,165,156
0131-002,2015,8,21,6,124,139,263,165
0131-002,2015,8,21,7,727,260,987,263
0131-002,2015,8,21,8,2048,612,2660,987
0131-002,2015,8,21,9,1736,849,2585,2660
0131-002,2015,8,21,10,923,808,1731,2585
0131-002,2015,8,21,11,860,900,1760,1731
0131-002,2015,8,21,12,878,828,1706,1760
0131-002,2015,8,21,13,626,754,1380,1706
0131-002,2015,8,21,14,849,778,1627,1380
0131-002,2015,8,21,15,978,784,1762,1627
0131-002,2015,8,21,16,910,797,1707,1762
0131-002,2015,8,21,17,771,818,1589,1707
0131-002,2015,8,21,18,872,1150,2022,1589
0131-002,2015,8,21,19,973,1065,2038,2022
0131-002,2015,8,21,20,843,758,1601,2038
0131-002,2015,8,21,21,594,514,1108,1601
0131-002,2015,8,21,22,400,366,766,1108
0131-002,2015,8,21,23,297,428,725,766
0131-002,2015,8,21,24,134,216,350,725
0131-002,2015,8,22,1,98,236,334,350
0131-002,2015,8,22,2,58,198,256,334
0131-002,2015,8,22,3,58,62,120,256
0131-002,2015,8,22,4,50,53,103,120
0131-002,2015,8,22,5,48,51,99,103
0131-002,2015,8,22,6,187,120,307,99
0131-002,2015,8,22,7,567,228,795,307
0131-002,2015,8,22,8,925,611,1536,795
0131-002,2015,8,22,9,836,923,1759,1536
0131-002,2015,8,22,10,765,907,1672,1759
0131-002,2015,8,22,11,876,1102,1978,1672
0131-002,2015,8,22,12,731,1008,1739,1978
0131-002,2015,8,22,13,729,778,1507,1739
0131-002,2015,8,22,14,779,642,1421,1507
0131-002,2015,8,22,15,630,664,1294,1421
0131-002,2015,8,22,16,777,751,1528,1294
0131-002,2015,8,22,17,820,949,1769,1528
0131-002,2015,8,22,18,916,1343,2259,1769
0131-002,2015,8,22,19,680,934,1614,2259
0131-002,2015,8,22,20,482,507,989,1614
0131-002,2015,8,22,21,440,346,786,989
0131-002,2015,8,22,22,276,228,504,786
0131-002,2015,8,22,23,196,175,371,504
0131-002,2015,8,22,24,111,87,198,371
0131-002,2015,8,23,1,73,72,145,198
0131-002,2015,8,23,2,37,45,82,145
0131-002,2015,8,23,3,39,39,78,82
0131-002,2015,8,23,4,23,21,44,78
0131-002,2015,8,23,5,18,39,57,44
0131-002,2015,8,23,6,82,54,136,57
0131-002,2015,8,23,7,202,87,289,136
0131-002,2015,8,23,8,236,165,401,289
0131-002,2015,8,23,9,279,252,531,401
0131-002,2015,8,23,10,266,293,559,531
0131-002,2015,8,23,11,359,338,697,559
0131-002,2015,8,23,12,410,402,812,697
0131-002,2015,8,23,13,472,442,914,812
0131-002,2015,8,23,14,535,407,942,914
0131-002,2015,8,23,15,566,442,1008,942
0131-002,2015,8,23,16,533,460,993,1008
0131-002,2015,8,23,17,520,630,1150,993
0131-002,2015,8,23,18,670,632,1302,1150
0131-002,2015,8,23,19,602,510,1112,1302
0131-002,2015,8,23,20,520,370,890,1112
0131-002,2015,8,23,21,526,344,870,890
0131-002,2015,8,23,22,330,237,567,870
0131-002,2015,8,23,23,223,158,381,567
0131-002,2015,8,23,24,128,97,225,381
0131-002,2015,8,24,1,96,54,150,225
0131-002,2015,8,24,2,27,38,65,150
0131-002,2015,8,24,3,14,17,31,65
0131-002,2015,8,24,4,18,30,48,31
0131-002,2015,8,24,5,35,23,58,48
0131-002,2015,8,24,6,305,97,402,58
0131-002,2015,8,24,7,929,332,1261,402
0131-002,2015,8,24,8,2182,882,3064,1261
0131-002,2015,8,24,9,1627,1372,2999,3064
0131-002,2015,8,24,10,849,1014,1863,2999
0131-002,2015,8,24,11,794,900,1694,1863
0131-002,2015,8,24,12,885,825,1710,1694
0131-002,2015,8,24,13,786,635,1421,1710
0131-002,2015,8,24,14,874,705,1579,1421
0131-002,2015,8,24,15,910,886,1796,1579
0131-002,2015,8,24,16,935,815,1750,1796
0131-002,2015,8,24,17,942,903,1845,1750
0131-002,2015,8,24,18,1051,1713,2764,1845
0131-002,2015,8,24,19,1074,1251,2325,2764
0131-002,2015,8,24,20,691,961,1652,2325
0131-002,2015,8,24,21,453,733,1186,1652
0131-002,2015,8,24,22,352,419,771,1186
0131-002,2015,8,24,23,233,190,423,771
0131-002,2015,8,24,24,109,151,260,423
0131-002,2015,8,25,1,75,81,156,260
0131-002,2015,8,25,2,40,53,93,156
0131-002,2015,8,25,3,46,30,76,93
0131-002,2015,8,25,4,37,18,55,76
0131-002,2015,8,25,5,29,53,82,55
0131-002,2015,8,25,6,103,70,173,82
0131-002,2015,8,25,7,547,188,735,173
0131-002,2015,8,25,8,1652,730,2382,735
0131-002,2015,8,25,9,1443,953,2396,2382
0131-002,2015,8,25,10,876,739,1615,2396
0131-002,2015,8,25,11,838,748,1586,1615
0131-002,2015,8,25,12,680,673,1353,1586
0131-002,2015,8,25,13,670,804,1474,1353
0131-002,2015,8,25,14,703,763,1466,1474
0131-002,2015,8,25,15,836,871,1707,1466
0131-002,2015,8,25,16,866,1066,1932,1707
0131-002,2015,8,25,17,697,1471,2168,1932
0131-002,2015,8,25,18,805,1407,2212,2168
0131-002,2015,8,25,19,722,1575,2297,2212
0131-002,2015,8,25,20,617,1123,1740,2297
0131-002,2015,8,25,21,411,1226,1637,1740
0131-002,2015,8,25,22,337,824,1161,1637
0131-002,2015,8,25,23,198,501,699,1161
0131-002,2015,8,25,24,103,329,432,699
0131-002,2015,8,26,1,69,249,318,432
0131-002,2015,8,26,2,42,126,168,318
0131-002,2015,8,26,3,37,112,149,168
0131-002,2015,8,26,4,21,127,148,149
0131-002,2015,8,26,5,39,111,150,148
0131-002,2015,8,26,6,162,96,258,150
0131-002,2015,8,26,7,779,376,1155,258
0131-002,2015,8,26,8,1943,885,2828,1155
0131-002,2015,8,26,9,1534,1401,2935,2828
0131-002,2015,8,26,10,978,1160,2138,2935
0131-002,2015,8,26,11,895,955,1850,2138
0131-002,2015,8,26,12,843,861,1704,1850
0131-002,2015,8,26,13,826,773,1599,1704
0131-002,2015,8,26,14,828,706,1534,1599
0131-002,2015,8,26,15,912,826,1738,1534
0131-002,2015,8,26,16,870,821,1691,1738
0131-002,2015,8,26,17,741,958,1699,1691
0131-002,2015,8,26,18,891,1294,2185,1699
0131-002,2015,8,26,19,1001,1246,2247,2185
0131-002,2015,8,26,20,678,802,1480,2247
0131-002,2015,8,26,21,434,648,1082,1480
0131-002,2015,8,26,22,343,394,737,1082
0131-002,2015,8,26,23,244,324,568,737
0131-002,2015,8,26,24,177,160,337,568
0131-002,2015,8,27,1,92,190,282,337
0131-002,2015,8,27,2,67,63,130,282
0131-002,2015,8,27,3,31,30,61,130
0131-002,2015,8,27,4,33,36,69,61
0131-002,2015,8,27,5,46,50,96,69
0131-002,2015,8,27,6,172,143,315,96
0131-002,2015,8,27,7,832,349,1181,315
0131-002,2015,8,27,8,1868,766,2634,1181
0131-002,2015,8,27,9,1644,1108,2752,2634
0131-002,2015,8,27,10,1022,1051,2073,2752
0131-002,2015,8,27,11,925,1108,2033,2073
0131-002,2015,8,27,12,864,1147,2011,2033
0131-002,2015,8,27,13,663,1038,1701,2011
0131-002,2015,8,27,14,843,1019,1862,1701
0131-002,2015,8,27,15,912,937,1849,1862
0131-002,2015,8,27,16,828,1023,1851,1849
0131-002,2015,8,27,17,803,864,1667,1851
0131-002,2015,8,27,18,885,1425,2310,1667
0131-002,2015,8,27,19,891,1063,1954,2310
0131-002,2015,8,27,20,805,825,1630,1954
0131-002,2015,8,27,21,518,760,1278,1630
0131-002,2015,8,27,22,368,624,992,1278
0131-002,2015,8,27,23,252,324,576,992
0131-002,2015,8,27,24,153,222,375,576
0131-002,2015,8,28,1,77,97,174,375
0131-002,2015,8,28,2,52,79,131,174
0131-002,2015,8,28,3,23,78,101,131
0131-002,2015,8,28,4,50,72,122,101
0131-002,2015,8,28,5,48,103,151,122
0131-002,2015,8,28,6,206,196,402,151
0131-002,2015,8,28,7,727,563,1290,402
0131-002,2015,8,28,8,1897,831,2728,1290
0131-002,2015,8,28,9,1616,1115,2731,2728
0131-002,2015,8,28,10,1011,798,1809,2731
0131-002,2015,8,28,11,864,873,1737,1809
0131-002,2015,8,28,12,859,761,1620,1737
0131-002,2015,8,28,13,674,655,1329,1620
0131-002,2015,8,28,14,879,831,1710,1329
0131-002,2015,8,28,15,923,895,1818,1710
0131-002,2015,8,28,16,849,944,1793,1818
0131-002,2015,8,28,17,902,1084,1986,1793
0131-002,2015,8,28,18,1132,1823,2955,1986
0131-002,2015,8,28,19,1100,1923,3023,2955
0131-002,2015,8,28,20,862,1139,2001,3023
0131-002,2015,8,28,21,571,810,1381,2001
0131-002,2015,8,28,22,410,544,954,1381
0131-002,2015,8,28,23,271,315,586,954
0131-002,2015,8,28,24,168,161,329,586
0131-002,2015,8,29,1,86,109,195,329
0131-002,2015,8,29,2,69,81,150,195
0131-002,2015,8,29,3,44,39,83,150
0131-002,2015,8,29,4,21,42,63,83
0131-002,2015,8,29,5,44,56,100,63
0131-002,2015,8,29,6,206,100,306,100
0131-002,2015,8,29,7,507,255,762,306
0131-002,2015,8,29,8,956,443,1399,762
0131-002,2015,8,29,9,923,742,1665,1399
0131-002,2015,8,29,10,763,740,1503,1665
0131-002,2015,8,29,11,813,828,1641,1503
0131-002,2015,8,29,12,722,836,1558,1641
0131-002,2015,8,29,13,834,830,1664,1558
0131-002,2015,8,29,14,786,728,1514,1664
0131-002,2015,8,29,15,813,742,1555,1514
0131-002,2015,8,29,16,731,763,1494,1555
0131-002,2015,8,29,17,849,885,1734,1494
0131-002,2015,8,29,18,950,1103,2053,1734
0131-002,2015,8,29,19,937,868,1805,2053
0131-002,2015,8,29,20,670,563,1233,1805
0131-002,2015,8,29,21,501,391,892,1233
0131-002,2015,8,29,22,330,227,557,892
0131-002,2015,8,29,23,195,161,356,557
0131-002,2015,8,29,24,124,143,267,356
0131-002,2015,8,30,1,118,76,194,267
0131-002,2015,8,30,2,59,51,110,194
0131-002,2015,8,30,3,50,33,83,110
0131-002,2015,8,30,4,23,27,50,83
0131-002,2015,8,30,5,35,38,73,50
0131-002,2015,8,30,6,69,51,120,73
0131-002,2015,8,30,7,246,115,361,120
0131-002,2015,8,30,8,267,161,428,361
0131-002,2015,8,30,9,307,309,616,428
0131-002,2015,8,30,10,339,318,657,616
0131-002,2015,8,30,11,410,426,836,657
0131-002,2015,8,30,12,459,423,882,836
0131-002,2015,8,30,13,470,483,953,882
0131-002,2015,8,30,14,507,487,994,953
0131-002,2015,8,30,15,560,532,1092,994
0131-002,2015,8,30,16,750,581,1331,1092
0131-002,2015,8,30,17,805,605,1410,1331
0131-002,2015,8,30,18,901,662,1563,1410
0131-002,2015,8,30,19,908,553,1461,1563
0131-002,2015,8,30,20,803,414,1217,1461
0131-002,2015,8,30,21,706,332,1038,1217
0131-002,2015,8,30,22,474,204,678,1038
0131-002,2015,8,30,23,265,127,392,678
0131-002,2015,8,30,24,151,78,229,392
0131-002,2015,8,31,1,63,54,117,229
0131-002,2015,8,31,2,33,29,62,117
0131-002,2015,8,31,3,23,14,37,62
0131-002,2015,8,31,4,18,39,57,37
0131-002,2015,8,31,5,27,45,72,57
0131-002,2015,8,31,6,263,91,354,72
0131-002,2015,8,31,7,940,306,1246,354
0131-002,2015,8,31,8,2169,828,2997,1246
0131-002,2015,8,31,9,1654,1016,2670,2997
0131-002,2015,8,31,10,883,745,1628,2670
0131-002,2015,8,31,11,889,760,1649,1628
0131-002,2015,8,31,12,779,699,1478,1649
0131-002,2015,8,31,13,708,588,1296,1478
0131-002,2015,8,31,14,912,705,1617,1296
0131-002,2015,8,31,15,946,852,1798,1617
0131-002,2015,8,31,16,866,859,1725,1798
0131-002,2015,8,31,17,817,910,1727,1725
0131-002,2015,8,31,18,883,1179,2062,1727
0131-002,2015,8,31,19,914,1144,2058,2062
0131-002,2015,8,31,20,604,789,1393,2058
0131-002,2015,8,31,21,449,733,1182,1393
0131-002,2015,8,31,22,349,413,762,1182
0131-002,2015,8,31,23,274,264,538,762
0131-002,2015,8,31,24,132,140,272,538
0131-002,2015,9,1,1,89,147,236,272
0131-002,2015,9,1,2,42,128,170,236
0131-002,2015,9,1,3,25,70,95,170
0131-002,2015,9,1,4,23,34,57,95
0131-002,2015,9,1,5,40,55,95,57
0131-002,2015,9,1,6,174,96,270,95
0131-002,2015,9,1,7,696,306,1002,270
0131-002,2015,9,1,8,1681,804,2485,1002
0131-002,2015,9,1,9,1422,1205,2627,2485
0131-002,2015,9,1,10,891,886,1777,2627
0131-002,2015,9,1,11,733,841,1574,1777
0131-002,2015,9,1,12,766,851,1617,1574
0131-002,2015,9,1,13,579,699,1278,1617
0131-002,2015,9,1,14,752,736,1488,1278
0131-002,2015,9,1,15,823,877,1700,1488
0131-002,2015,9,1,16,815,938,1753,1700
0131-002,2015,9,1,17,727,967,1694,1753
0131-002,2015,9,1,18,740,1359,2099,1694
0131-002,2015,9,1,19,773,1250,2023,2099
0131-002,2015,9,1,20,553,918,1471,2023
0131-002,2015,9,1,21,407,843,1250,1471
0131-002,2015,9,1,22,368,463,831,1250
0131-002,2015,9,1,23,222,202,424,831
0131-002,2015,9,1,24,132,131,263,424
0131-002,2015,9,2,1,79,89,168,263
0131-002,2015,9,2,2,55,65,120,168
0131-002,2015,9,2,3,22,31,53,120
0131-002,2015,9,2,4,20,29,49,53
0131-002,2015,9,2,5,23,54,77,49
0131-002,2015,9,2,6,183,99,282,77
0131-002,2015,9,2,7,691,315,1006,282
0131-002,2015,9,2,8,1772,819,2591,1006
0131-002,2015,9,2,9,1415,1208,2623,2591
0131-002,2015,9,2,10,773,931,1704,2623
0131-002,2015,9,2,11,888,836,1724,1704
0131-002,2015,9,2,12,755,820,1575,1724
0131-002,2015,9,2,13,660,693,1353,1575
0131-002,2015,9,2,14,782,775,1557,1353
0131-002,2015,9,2,15,794,897,1691,1557
0131-002,2015,9,2,16,782,930,1712,1691
0131-002,2015,9,2,17,720,914,1634,1712
0131-002,2015,9,2,18,764,1387,2151,1634
0131-002,2015,9,2,19,828,1323,2151,2151
0131-002,2015,9,2,20,604,836,1440,2151
0131-002,2015,9,2,21,385,632,1017,1440
0131-002,2015,9,2,22,293,471,764,1017
0131-002,2015,9,2,23,191,268,459,764
0131-002,2015,9,2,24,96,120,216,459
0131-002,2015,9,3,1,89,108,197,216
0131-002,2015,9,3,2,45,52,97,197
0131-002,2015,9,3,3,25,39,64,97
0131-002,2015,9,3,4,34,25,59,64
0131-002,2015,9,3,5,25,46,71,59
0131-002,2015,9,3,6,193,92,285,71
0131-002,2015,9,3,7,694,282,976,285
0131-002,2015,9,3,8,1698,807,2505,976
0131-002,2015,9,3,9,1403,1088,2491,2505
0131-002,2015,9,3,10,856,931,1787,2491
0131-002,2015,9,3,11,834,835,1669,1787
0131-002,2015,9,3,12,720,778,1498,1669
0131-002,2015,9,3,13,675,630,1305,1498
0131-002,2015,9,3,14,735,751,1486,1305
0131-002,2015,9,3,15,815,962,1777,1486
0131-002,2015,9,3,16,752,983,1735,1777
0131-002,2015,9,3,17,762,997,1759,1735
0131-002,2015,9,3,18,761,1323,2084,1759
0131-002,2015,9,3,19,755,1250,2005,2084
0131-002,2015,9,3,20,594,848,1442,2005
0131-002,2015,9,3,21,414,814,1228,1442
0131-002,2015,9,3,22,332,448,780,1228
0131-002,2015,9,3,23,252,305,557,780
0131-002,2015,9,3,24,122,153,275,557
0131-002,2015,9,4,1,75,105,180,275
0131-002,2015,9,4,2,40,57,97,180
0131-002,2015,9,4,3,29,39,68,97
0131-002,2015,9,4,4,34,42,76,68
0131-002,2015,9,4,5,43,52,95,76
0131-002,2015,9,4,6,196,115,311,95
0131-002,2015,9,4,7,663,412,1075,311
0131-002,2015,9,4,8,1652,722,2374,1075
0131-002,2015,9,4,9,1335,982,2317,2374
0131-002,2015,9,4,10,869,803,1672,2317
0131-002,2015,9,4,11,827,886,1713,1672
0131-002,2015,9,4,12,769,794,1563,1713
0131-002,2015,9,4,13,646,704,1350,1563
0131-002,2015,9,4,14,708,804,1512,1350
0131-002,2015,9,4,15,762,840,1602,1512
0131-002,2015,9,4,16,827,870,1697,1602
0131-002,2015,9,4,17,787,951,1738,1697
0131-002,2015,9,4,18,944,1486,2430,1738
0131-002,2015,9,4,19,1216,1494,2710,2430
0131-002,2015,9,4,20,803,948,1751,2710
0131-002,2015,9,4,21,593,662,1255,1751
0131-002,2015,9,4,22,353,455,808,1255
0131-002,2015,9,4,23,293,313,606,808
0131-002,2015,9,4,24,124,162,286,606
0131-002,2015,9,5,1,104,113,217,286
0131-002,2015,9,5,2,63,81,144,217
0131-002,2015,9,5,3,43,58,101,144
0131-002,2015,9,5,4,49,50,99,101
0131-002,2015,9,5,5,51,62,113,99
0131-002,2015,9,5,6,164,128,292,113
0131-002,2015,9,5,7,437,244,681,292
0131-002,2015,9,5,8,796,511,1307,681
0131-002,2015,9,5,9,803,794,1597,1307
0131-002,2015,9,5,10,721,835,1556,1597
0131-002,2015,9,5,11,703,838,1541,1556
0131-002,2015,9,5,12,692,918,1610,1541
0131-002,2015,9,5,13,662,867,1529,1610
0131-002,2015,9,5,14,674,793,1467,1529
0131-002,2015,9,5,15,663,736,1399,1467
0131-002,2015,9,5,16,836,893,1729,1399
0131-002,2015,9,5,17,863,875,1738,1729
0131-002,2015,9,5,18,1077,1038,2115,1738
0131-002,2015,9,5,19,1071,865,1936,2115
0131-002,2015,9,5,20,764,469,1233,1936
0131-002,2015,9,5,21,409,345,754,1233
0131-002,2015,9,5,22,319,292,611,754
0131-002,2015,9,5,23,173,171,344,611
0131-002,2015,9,5,24,125,110,235,344
0131-002,2015,9,6,1,66,67,133,235
0131-002,2015,9,6,2,40,71,111,133
0131-002,2015,9,6,3,32,42,74,111
0131-002,2015,9,6,4,14,25,39,74
0131-002,2015,9,6,5,37,38,75,39
0131-002,2015,9,6,6,92,68,160,75
0131-002,2015,9,6,7,191,137,328,160
0131-002,2015,9,6,8,306,247,553,328
0131-002,2015,9,6,9,268,347,615,553
0131-002,2015,9,6,10,342,406,748,615
0131-002,2015,9,6,11,411,492,903,748
0131-002,2015,9,6,12,436,413,849,903
0131-002,2015,9,6,13,472,503,975,849
0131-002,2015,9,6,14,611,485,1096,975
0131-002,2015,9,6,15,646,666,1312,1096
0131-002,2015,9,6,16,894,590,1484,1312
0131-002,2015,9,6,17,1004,745,1749,1484
0131-002,2015,9,6,18,1013,739,1752,1749
0131-002,2015,9,6,19,987,550,1537,1752
0131-002,2015,9,6,20,694,414,1108,1537
0131-002,2015,9,6,21,576,369,945,1108
0131-002,2015,9,6,22,399,261,660,945
0131-002,2015,9,6,23,220,147,367,660
0131-002,2015,9,6,24,110,79,189,367
0131-002,2015,9,7,1,69,46,115,189
0131-002,2015,9,7,2,35,26,61,115
0131-002,2015,9,7,3,17,15,32,61
0131-002,2015,9,7,4,18,29,47,32
0131-002,2015,9,7,5,37,28,65,47
0131-002,2015,9,7,6,269,105,374,65
0131-002,2015,9,7,7,817,323,1140,374
0131-002,2015,9,7,8,1885,894,2779,1140
0131-002,2015,9,7,9,1575,1107,2682,2779
0131-002,2015,9,7,10,868,809,1677,2682
0131-002,2015,9,7,11,742,688,1430,1677
0131-002,2015,9,7,12,738,830,1568,1430
0131-002,2015,9,7,13,625,598,1223,1568
0131-002,2015,9,7,14,767,749,1516,1223
0131-002,2015,9,7,15,915,904,1819,1516
0131-002,2015,9,7,16,774,912,1686,1819
0131-002,2015,9,7,17,766,931,1697,1686
0131-002,2015,9,7,18,770,1370,2140,1697
0131-002,2015,9,7,19,802,1144,1946,2140
0131-002,2015,9,7,20,617,935,1552,1946
0131-002,2015,9,7,21,376,775,1151,1552
0131-002,2015,9,7,22,293,506,799,1151
0131-002,2015,9,7,23,206,240,446,799
0131-002,2015,9,7,24,95,137,232,446
0131-002,2015,9,8,1,40,92,132,232
0131-002,2015,9,8,2,51,42,93,132
0131-002,2015,9,8,3,26,34,60,93
0131-002,2015,9,8,4,22,31,53,60
0131-002,2015,9,8,5,42,58,100,53
0131-002,2015,9,8,6,220,87,307,100
0131-002,2015,9,8,7,752,286,1038,307
0131-002,2015,9,8,8,1759,814,2573,1038
0131-002,2015,9,8,9,1323,1105,2428,2573
0131-002,2015,9,8,10,905,933,1838,2428
0131-002,2015,9,8,11,876,869,1745,1838
0131-002,2015,9,8,12,735,815,1550,1745
0131-002,2015,9,8,13,667,661,1328,1550
0131-002,2015,9,8,14,703,788,1491,1328
0131-002,2015,9,8,15,849,901,1750,1491
0131-002,2015,9,8,16,712,835,1547,1750
0131-002,2015,9,8,17,732,1020,1752,1547
0131-002,2015,9,8,18,815,1271,2086,1752
0131-002,2015,9,8,19,758,1282,2040,2086
0131-002,2015,9,8,20,633,873,1506,2040
0131-002,2015,9,8,21,446,822,1268,1506
0131-002,2015,9,8,22,278,445,723,1268
0131-002,2015,9,8,23,240,253,493,723
0131-002,2015,9,8,24,124,141,265,493
0131-002,2015,9,9,1,69,91,160,265
0131-002,2015,9,9,2,37,58,95,160
0131-002,2015,9,9,3,17,33,50,95
0131-002,2015,9,9,4,28,36,64,50
0131-002,2015,9,9,5,34,38,72,64
0131-002,2015,9,9,6,185,104,289,72
0131-002,2015,9,9,7,720,298,1018,289
0131-002,2015,9,9,8,1698,857,2555,1018
0131-002,2015,9,9,9,1437,1234,2671,2555
0131-002,2015,9,9,10,888,889,1777,2671
0131-002,2015,9,9,11,799,835,1634,1777
0131-002,2015,9,9,12,721,788,1509,1634
0131-002,2015,9,9,13,593,687,1280,1509
0131-002,2015,9,9,14,791,730,1521,1280
0131-002,2015,9,9,15,810,918,1728,1521
0131-002,2015,9,9,16,793,920,1713,1728
0131-002,2015,9,9,17,749,1009,1758,1713
0131-002,2015,9,9,18,779,1483,2262,1758
0131-002,2015,9,9,19,891,1376,2267,2262
0131-002,2015,9,9,20,662,859,1521,2267
0131-002,2015,9,9,21,409,712,1121,1521
0131-002,2015,9,9,22,309,461,770,1121
0131-002,2015,9,9,23,206,234,440,770
0131-002,2015,9,9,24,118,137,255,440
0131-002,2015,9,10,1,66,86,152,255
0131-002,2015,9,10,2,38,63,101,152
0131-002,2015,9,10,3,34,44,78,101
0131-002,2015,9,10,4,28,26,54,78
0131-002,2015,9,10,5,28,39,67,54
0131-002,2015,9,10,6,199,112,311,67
0131-002,2015,9,10,7,793,311,1104,311
0131-002,2015,9,10,8,1732,819,2551,1104
0131-002,2015,9,10,9,1395,1203,2598,2551
0131-002,2015,9,10,10,828,870,1698,2598
0131-002,2015,9,10,11,817,865,1682,1698
0131-002,2015,9,10,12,774,862,1636,1682
0131-002,2015,9,10,13,628,762,1390,1636
0131-002,2015,9,10,14,735,841,1576,1390
0131-002,2015,9,10,15,880,944,1824,1576
0131-002,2015,9,10,16,825,960,1785,1824
0131-002,2015,9,10,17,778,1073,1851,1785
0131-002,2015,9,10,18,788,1461,2249,1851
0131-002,2015,9,10,19,813,1294,2107,2249
0131-002,2015,9,10,20,631,914,1545,2107
0131-002,2015,9,10,21,466,754,1220,1545
0131-002,2015,9,10,22,370,442,812,1220
0131-002,2015,9,10,23,211,253,464,812
0131-002,2015,9,10,24,135,128,263,464
0131-002,2015,9,11,1,81,113,194,263
0131-002,2015,9,11,2,32,54,86,194
0131-002,2015,9,11,3,22,29,51,86
0131-002,2015,9,11,4,25,31,56,51
0131-002,2015,9,11,5,37,38,75,56
0131-002,2015,9,11,6,194,112,306,75
0131-002,2015,9,11,7,709,292,1001,306
0131-002,2015,9,11,8,1690,830,2520,1001
0131-002,2015,9,11,9,1411,1162,2573,2520
0131-002,2015,9,11,10,851,802,1653,2573
0131-002,2015,9,11,11,819,928,1747,1653
0131-002,2015,9,11,12,758,960,1718,1747
0131-002,2015,9,11,13,642,735,1377,1718
0131-002,2015,9,11,14,807,914,1721,1377
0131-002,2015,9,11,15,825,991,1816,1721
0131-002,2015,9,11,16,851,1086,1937,1816
0131-002,2015,9,11,17,844,1192,2036,1937
0131-002,2015,9,11,18,958,1650,2608,2036
0131-002,2015,9,11,19,915,1567,2482,2608
0131-002,2015,9,11,20,774,1091,1865,2482
0131-002,2015,9,11,21,460,699,1159,1865
0131-002,2015,9,11,22,353,418,771,1159
0131-002,2015,9,11,23,194,255,449,771
0131-002,2015,9,11,24,108,128,236,449
0131-002,2015,9,12,1,81,100,181,236
0131-002,2015,9,12,2,58,83,141,181
0131-002,2015,9,12,3,26,52,78,141
0131-002,2015,9,12,4,28,39,67,78
0131-002,2015,9,12,5,34,68,102,67
0131-002,2015,9,12,6,124,125,249,102
0131-002,2015,9,12,7,503,273,776,249
0131-002,2015,9,12,8,878,592,1470,776
0131-002,2015,9,12,9,791,1013,1804,1470
0131-002,2015,9,12,10,698,999,1697,1804
0131-002,2015,9,12,11,769,1091,1860,1697
0131-002,2015,9,12,12,827,1273,2100,1860
0131-002,2015,9,12,13,718,1108,1826,2100
0131-002,2015,9,12,14,732,952,1684,1826
0131-002,2015,9,12,15,819,875,1694,1684
0131-002,2015,9,12,16,900,802,1702,1694
0131-002,2015,9,12,17,874,946,1820,1702
0131-002,2015,9,12,18,1002,1155,2157,1820
0131-002,2015,9,12,19,970,1001,1971,2157
0131-002,2015,9,12,20,981,590,1571,1971
0131-002,2015,9,12,21,646,411,1057,1571
0131-002,2015,9,12,22,356,281,637,1057
0131-002,2015,9,12,23,183,207,390,637
0131-002,2015,9,12,24,79,113,192,390
0131-002,2015,9,13,1,60,58,118,192
0131-002,2015,9,13,2,42,47,89,118
0131-002,2015,9,13,3,22,26,48,89
0131-002,2015,9,13,4,20,29,49,48
0131-002,2015,9,13,5,32,18,50,49
0131-002,2015,9,13,6,64,75,139,50
0131-002,2015,9,13,7,211,195,406,139
0131-002,2015,9,13,8,326,329,655,406
0131-002,2015,9,13,9,347,503,850,655
0131-002,2015,9,13,10,334,640,974,850
0131-002,2015,9,13,11,404,545,949,974
0131-002,2015,9,13,12,494,439,933,949
0131-002,2015,9,13,13,606,432,1038,933
0131-002,2015,9,13,14,742,534,1276,1038
0131-002,2015,9,13,15,794,561,1355,1276
0131-002,2015,9,13,16,967,654,1621,1355
0131-002,2015,9,13,17,849,745,1594,1621
0131-002,2015,9,13,18,944,797,1741,1594
0131-002,2015,9,13,19,964,703,1667,1741
0131-002,2015,9,13,20,949,440,1389,1667
0131-002,2015,9,13,21,938,421,1359,1389
0131-002,2015,9,13,22,732,329,1061,1359
0131-002,2015,9,13,23,388,115,503,1061
0131-002,2015,9,13,24,145,100,245,503
0131-002,2015,9,14,1,74,42,116,245
0131-002,2015,9,14,2,32,23,55,116
0131-002,2015,9,14,3,25,28,53,55
0131-002,2015,9,14,4,23,28,51,53
0131-002,2015,9,14,5,26,29,55,51
0131-002,2015,9,14,6,225,87,312,55
0131-002,2015,9,14,7,840,318,1158,312
0131-002,2015,9,14,8,2002,912,2914,1158
0131-002,2015,9,14,9,1588,1141,2729,2914
0131-002,2015,9,14,10,851,912,1763,2729
0131-002,2015,9,14,11,840,841,1681,1763
0131-002,2015,9,14,12,817,894,1711,1681
0131-002,2015,9,14,13,662,780,1442,1711
0131-002,2015,9,14,14,764,812,1576,1442
0131-002,2015,9,14,15,823,991,1814,1576
0131-002,2015,9,14,16,984,910,1894,1814
0131-002,2015,9,14,17,891,1036,1927,1894
0131-002,2015,9,14,18,866,1470,2336,1927
0131-002,2015,9,14,19,888,1236,2124,2336
0131-002,2015,9,14,20,548,970,1518,2124
0131-002,2015,9,14,21,388,754,1142,1518
0131-002,2015,9,14,22,313,443,756,1142
0131-002,2015,9,14,23,183,253,436,756
0131-002,2015,9,14,24,129,144,273,436
0131-002,2015,9,15,1,57,81,138,273
0131-002,2015,9,15,2,38,54,92,138
0131-002,2015,9,15,3,20,52,72,92
0131-002,2015,9,15,4,25,28,53,72
0131-002,2015,9,15,5,37,47,84,53
0131-002,2015,9,15,6,200,100,300,84
0131-002,2015,9,15,7,717,302,1019,300
0131-002,2015,9,15,8,1796,859,2655,1019
0131-002,2015,9,15,9,1450,1165,2615,2655
0131-002,2015,9,15,10,894,952,1846,2615
0131-002,2015,9,15,11,852,883,1735,1846
0131-002,2015,9,15,12,834,819,1653,1735
0131-002,2015,9,15,13,657,759,1416,1653
0131-002,2015,9,15,14,753,860,1613,1416
0131-002,2015,9,15,15,834,909,1743,1613
0131-002,2015,9,15,16,793,1021,1814,1743
0131-002,2015,9,15,17,721,1049,1770,1814
0131-002,2015,9,15,18,860,1531,2391,1770
0131-002,2015,9,15,19,868,1245,2113,2391
0131-002,2015,9,15,20,548,859,1407,2113
0131-002,2015,9,15,21,428,778,1206,1407
0131-002,2015,9,15,22,353,490,843,1206
0131-002,2015,9,15,23,205,271,476,843
0131-002,2015,9,15,24,129,145,274,476
0131-002,2015,9,16,1,87,86,173,274
0131-002,2015,9,16,2,43,42,85,173
0131-002,2015,9,16,3,29,52,81,85
0131-002,2015,9,16,4,26,29,55,81
0131-002,2015,9,16,5,40,49,89,55
0131-002,2015,9,16,6,199,97,296,89
0131-002,2015,9,16,7,691,313,1004,296
0131-002,2015,9,16,8,1788,836,2624,1004
0131-002,2015,9,16,9,1503,1205,2708,2624
0131-002,2015,9,16,10,898,867,1765,2708
0131-002,2015,9,16,11,854,899,1753,1765
0131-002,2015,9,16,12,825,889,1714,1753
0131-002,2015,9,16,13,669,678,1347,1714
0131-002,2015,9,16,14,811,959,1770,1347
0131-002,2015,9,16,15,885,901,1786,1770
0131-002,2015,9,16,16,886,964,1850,1786
0131-002,2015,9,16,17,830,926,1756,1850
0131-002,2015,9,16,18,946,1326,2272,1756
0131-002,2015,9,16,19,888,1216,2104,2272
0131-002,2015,9,16,20,587,857,1444,2104
0131-002,2015,9,16,21,419,654,1073,1444
0131-002,2015,9,16,22,358,472,830,1073
0131-002,2015,9,16,23,194,252,446,830
0131-002,2015,9,16,24,153,136,289,446
0131-002,2015,9,17,1,63,76,139,289
0131-002,2015,9,17,2,37,47,84,139
0131-002,2015,9,17,3,38,42,80,84
0131-002,2015,9,17,4,23,52,75,80
0131-002,2015,9,17,5,38,63,101,75
0131-002,2015,9,17,6,206,104,310,101
0131-002,2015,9,17,7,813,350,1163,310
0131-002,2015,9,17,8,1767,902,2669,1163
0131-002,2015,9,17,9,1337,1121,2458,2669
0131-002,2015,9,17,10,947,878,1825,2458
0131-002,2015,9,17,11,848,914,1762,1825
0131-002,2015,9,17,12,854,786,1640,1762
0131-002,2015,9,17,13,616,696,1312,1640
0131-002,2015,9,17,14,759,796,1555,1312
0131-002,2015,9,17,15,868,953,1821,1555
0131-002,2015,9,17,16,834,972,1806,1821
0131-002,2015,9,17,17,802,1035,1837,1806
0131-002,2015,9,17,18,872,1392,2264,1837
0131-002,2015,9,17,19,924,1272,2196,2264
0131-002,2015,9,17,20,628,881,1509,2196
0131-002,2015,9,17,21,434,825,1259,1509
0131-002,2015,9,17,22,336,497,833,1259
0131-002,2015,9,17,23,203,240,443,833
0131-002,2015,9,17,24,116,158,274,443
0131-002,2015,9,18,1,66,96,162,274
0131-002,2015,9,18,2,49,44,93,162
0131-002,2015,9,18,3,29,42,71,93
0131-002,2015,9,18,4,26,41,67,71
0131-002,2015,9,18,5,37,57,94,67
0131-002,2015,9,18,6,251,131,382,94
0131-002,2015,9,18,7,770,355,1125,382
0131-002,2015,9,18,8,1785,856,2641,1125
0131-002,2015,9,18,9,1326,1090,2416,2641
0131-002,2015,9,18,10,894,935,1829,2416
0131-002,2015,9,18,11,894,926,1820,1829
0131-002,2015,9,18,12,811,851,1662,1820
0131-002,2015,9,18,13,652,720,1372,1662
0131-002,2015,9,18,14,759,859,1618,1372
0131-002,2015,9,18,15,819,916,1735,1618
0131-002,2015,9,18,16,909,978,1887,1735
0131-002,2015,9,18,17,898,1072,1970,1887
0131-002,2015,9,18,18,1057,1568,2625,1970
0131-002,2015,9,18,19,1182,1530,2712,2625
0131-002,2015,9,18,20,819,1020,1839,2712
0131-002,2015,9,18,21,555,680,1235,1839
0131-002,2015,9,18,22,370,516,886,1235
0131-002,2015,9,18,23,203,258,461,886
0131-002,2015,9,18,24,122,173,295,461
0131-002,2015,9,19,1,67,91,158,295
0131-002,2015,9,19,2,49,79,128,158
0131-002,2015,9,19,3,26,50,76,128
0131-002,2015,9,19,4,49,46,95,76
0131-002,2015,9,19,5,55,65,120,95
0131-002,2015,9,19,6,193,126,319,120
0131-002,2015,9,19,7,519,258,777,319
0131-002,2015,9,19,8,903,552,1455,777
0131-002,2015,9,19,9,810,904,1714,1455
0131-002,2015,9,19,10,811,917,1728,1714
0131-002,2015,9,19,11,730,964,1694,1728
0131-002,2015,9,19,12,810,1096,1906,1694
0131-002,2015,9,19,13,738,988,1726,1906
0131-002,2015,9,19,14,691,872,1563,1726
0131-002,2015,9,19,15,753,806,1559,1563
0131-002,2015,9,19,16,766,848,1614,1559
0131-002,2015,9,19,17,769,910,1679,1614
0131-002,2015,9,19,18,888,1096,1984,1679
0131-002,2015,9,19,19,851,933,1784,1984
0131-002,2015,9,19,20,506,530,1036,1784
0131-002,2015,9,19,21,350,353,703,1036
0131-002,2015,9,19,22,281,287,568,703
0131-002,2015,9,19,23,159,179,338,568
0131-002,2015,9,19,24,115,120,235,338
0131-002,2015,9,20,1,92,92,184,235
0131-002,2015,9,20,2,34,55,89,184
0131-002,2015,9,20,3,34,39,73,89
0131-002,2015,9,20,4,23,31,54,73
0131-002,2015,9,20,5,34,28,62,54
0131-002,2015,9,20,6,120,81,201,62
0131-002,2015,9,20,7,263,141,404,201
0131-002,2015,9,20,8,396,265,661,404
0131-002,2015,9,20,9,350,398,748,661
0131-002,2015,9,20,10,361,485,846,748
0131-002,2015,9,20,11,414,538,952,846
0131-002,2015,9,20,12,482,376,858,952
0131-002,2015,9,20,13,446,318,764,858
0131-002,2015,9,20,14,524,298,822,764
0131-002,2015,9,20,15,597,345,942,822
0131-002,2015,9,20,16,669,339,1008,942
0131-002,2015,9,20,17,674,381,1055,1008
0131-002,2015,9,20,18,706,426,1132,1055
0131-002,2015,9,20,19,648,361,1009,1132
0131-002,2015,9,20,20,402,287,689,1009
0131-002,2015,9,20,21,387,319,706,689
0131-002,2015,9,20,22,297,271,568,706
0131-002,2015,9,20,23,200,163,363,568
0131-002,2015,9,20,24,93,99,192,363
0131-002,2015,9,21,1,66,34,100,192
0131-002,2015,9,21,2,18,18,36,100
0131-002,2015,9,21,3,18,17,35,36
0131-002,2015,9,21,4,11,31,42,35
0131-002,2015,9,21,5,35,42,77,42
0131-002,2015,9,21,6,237,116,353,77
0131-002,2015,9,21,7,917,323,1240,353
0131-002,2015,9,21,8,1993,936,2929,1240
0131-002,2015,9,21,9,1384,1032,2416,2929
0131-002,2015,9,21,10,827,790,1617,2416
0131-002,2015,9,21,11,819,915,1734,1617
0131-002,2015,9,21,12,767,809,1576,1734
0131-002,2015,9,21,13,753,689,1442,1576
0131-002,2015,9,21,14,834,780,1614,1442
0131-002,2015,9,21,15,817,948,1765,1614
0131-002,2015,9,21,16,883,911,1794,1765
0131-002,2015,9,21,17,788,984,1772,1794
0131-002,2015,9,21,18,851,1420,2271,1772
0131-002,2015,9,21,19,834,1190,2024,2271
0131-002,2015,9,21,20,570,952,1522,2024
0131-002,2015,9,21,21,414,764,1178,1522
0131-002,2015,9,21,22,376,403,779,1178
0131-002,2015,9,21,23,173,302,475,779
0131-002,2015,9,21,24,104,134,238,475
0131-002,2015,9,22,1,54,97,151,238
0131-002,2015,9,22,2,47,75,122,151
0131-002,2015,9,22,3,26,42,68,122
0131-002,2015,9,22,4,23,42,65,68
0131-002,2015,9,22,5,34,46,80,65
0131-002,2015,9,22,6,243,125,368,80
0131-002,2015,9,22,7,753,356,1109,368
0131-002,2015,9,22,8,1736,893,2629,1109
0131-002,2015,9,22,9,1354,1200,2554,2629
0131-002,2015,9,22,10,987,1004,1991,2554
0131-002,2015,9,22,11,863,876,1739,1991
0131-002,2015,9,22,12,889,817,1706,1739
0131-002,2015,9,22,13,727,710,1437,1706
0131-002,2015,9,22,14,823,824,1647,1437
0131-002,2015,9,22,15,889,905,1794,1647
0131-002,2015,9,22,16,830,928,1758,1794
0131-002,2015,9,22,17,784,1034,1818,1758
0131-002,2015,9,22,18,885,1401,2286,1818
0131-002,2015,9,22,19,915,1264,2179,2286
0131-002,2015,9,22,20,652,866,1518,2179
0131-002,2015,9,22,21,445,800,1245,1518
0131-002,2015,9,22,22,376,439,815,1245
0131-002,2015,9,22,23,231,287,518,815
0131-002,2015,9,22,24,120,155,275,518
0131-002,2015,9,23,1,78,91,169,275
0131-002,2015,9,23,2,37,39,76,169
0131-002,2015,9,23,3,26,41,67,76
0131-002,2015,9,23,4,29,36,65,67
0131-002,2015,9,23,5,38,44,82,65
0131-002,2015,9,23,6,234,116,350,82
0131-002,2015,9,23,7,794,319,1113,350
0131-002,2015,9,23,8,1817,912,2729,1113
0131-002,2015,9,23,9,1410,1136,2546,2729
0131-002,2015,9,23,10,1005,975,1980,2546
0131-002,2015,9,23,11,886,996,1882,1980
0131-002,2015,9,23,12,863,912,1775,1882
0131-002,2015,9,23,13,729,773,1502,1775
0131-002,2015,9,23,14,836,883,1719,1502
0131-002,2015,9,23,15,897,1063,1960,1719
0131-002,2015,9,23,16,1000,970,1970,1960
0131-002,2015,9,23,17,905,1057,1962,1970
0131-002,2015,9,23,18,1014,1514,2528,1962
0131-002,2015,9,23,19,844,1269,2113,2528
0131-002,2015,9,23,20,619,883,1502,2113
0131-002,2015,9,23,21,419,761,1180,1502
0131-002,2015,9,23,22,342,440,782,1180
0131-002,2015,9,23,23,211,294,505,782
0131-002,2015,9,23,24,129,152,281,505
0131-002,2015,9,24,1,95,100,195,281
0131-002,2015,9,24,2,57,54,111,195
0131-002,2015,9,24,3,40,36,76,111
0131-002,2015,9,24,4,22,31,53,76
0131-002,2015,9,24,5,52,50,102,53
0131-002,2015,9,24,6,222,118,340,102
0131-002,2015,9,24,7,733,358,1091,340
0131-002,2015,9,24,8,1653,902,2555,1091
0131-002,2015,9,24,9,1450,1140,2590,2555
0131-002,2015,9,24,10,938,1001,1939,2590
0131-002,2015,9,24,11,1007,1059,2066,1939
0131-002,2015,9,24,12,848,883,1731,2066
0131-002,2015,9,24,13,732,835,1567,1731
0131-002,2015,9,24,14,794,931,1725,1567
0131-002,2015,9,24,15,915,722,1637,1725
0131-002,2015,9,24,16,878,966,1844,1637
0131-002,2015,9,24,17,694,1054,1748,1844
0131-002,2015,9,24,18,844,1426,2270,1748
0131-002,2015,9,24,19,950,1283,2233,2270
0131-002,2015,9,24,20,713,898,1611,2233
0131-002,2015,9,24,21,506,790,1296,1611
0131-002,2015,9,24,22,385,509,894,1296
0131-002,2015,9,24,23,249,306,555,894
0131-002,2015,9,24,24,150,186,336,555
0131-002,2015,9,25,1,116,107,223,336
0131-002,2015,9,25,2,35,60,95,223
0131-002,2015,9,25,3,40,38,78,95
0131-002,2015,9,25,4,32,50,82,78
0131-002,2015,9,25,5,45,62,107,82
0131-002,2015,9,25,6,162,110,272,107
0131-002,2015,9,25,7,601,324,925,272
0131-002,2015,9,25,8,1705,925,2630,925
0131-002,2015,9,25,9,1274,1097,2371,2630
0131-002,2015,9,25,10,817,868,1685,2371
0131-002,2015,9,25,11,817,927,1744,1685
0131-002,2015,9,25,12,749,906,1655,1744
0131-002,2015,9,25,13,660,728,1388,1655
0131-002,2015,9,25,14,686,886,1572,1388
0131-002,2015,9,25,15,798,954,1752,1572
0131-002,2015,9,25,16,840,1032,1872,1752
0131-002,2015,9,25,17,874,1132,2006,1872
0131-002,2015,9,25,18,1004,1609,2613,2006
0131-002,2015,9,25,19,930,1548,2478,2613
0131-002,2015,9,25,20,633,1056,1689,2478
0131-002,2015,9,25,21,373,724,1097,1689
0131-002,2015,9,25,22,315,838,1153,1097
0131-002,2015,9,25,23,231,635,866,1153
0131-002,2015,9,25,24,107,286,393,866
0131-002,2015,9,26,1,79,232,311,393
0131-002,2015,9,26,2,40,276,316,311
0131-002,2015,9,26,3,29,360,389,316
0131-002,2015,9,26,4,22,680,702,389
0131-002,2015,9,26,5,29,1071,1100,702
0131-002,2015,9,26,6,79,864,943,1100
0131-002,2015,9,26,7,115,888,1003,943
0131-002,2015,9,26,8,186,1009,1195,1003
0131-002,2015,9,26,9,261,1073,1334,1195
0131-002,2015,9,26,10,373,954,1327,1334
0131-002,2015,9,26,11,536,1059,1595,1327
0131-002,2015,9,26,12,536,773,1309,1595
0131-002,2015,9,26,13,524,495,1019,1309
0131-002,2015,9,26,14,422,445,867,1019
0131-002,2015,9,26,15,367,332,699,867
0131-002,2015,9,26,16,297,298,595,699
0131-002,2015,9,26,17,310,284,594,595
0131-002,2015,9,26,18,286,329,615,594
0131-002,2015,9,26,19,261,331,592,615
0131-002,2015,9,26,20,178,220,398,592
0131-002,2015,9,26,21,129,178,307,398
0131-002,2015,9,26,22,98,133,231,307
0131-002,2015,9,26,23,69,86,155,231
0131-002,2015,9,26,24,42,83,125,155
0131-002,2015,9,27,1,23,31,54,125
0131-002,2015,9,27,2,13,21,34,54
0131-002,2015,9,27,3,18,10,28,34
0131-002,2015,9,27,4,9,20,29,28
0131-002,2015,9,27,5,8,15,23,29
0131-002,2015,9,27,6,25,29,54,23
0131-002,2015,9,27,7,115,139,254,54
0131-002,2015,9,27,8,271,339,610,254
0131-002,2015,9,27,9,215,559,774,610
0131-002,2015,9,27,10,243,711,954,774
0131-002,2015,9,27,11,527,1150,1677,954
0131-002,2015,9,27,12,978,904,1882,1677
0131-002,2015,9,27,13,1092,437,1529,1882
0131-002,2015,9,27,14,1094,419,1513,1529
0131-002,2015,9,27,15,1189,429,1618,1513
0131-002,2015,9,27,16,1191,414,1605,1618
0131-002,2015,9,27,17,1146,432,1578,1605
0131-002,2015,9,27,18,1138,424,1562,1578
0131-002,2015,9,27,19,1049,422,1471,1562
0131-002,2015,9,27,20,769,355,1124,1471
0131-002,2015,9,27,21,767,374,1141,1124
0131-002,2015,9,27,22,883,228,1111,1141
0131-002,2015,9,27,23,422,142,564,1111
0131-002,2015,9,27,24,451,96,547,564
0131-002,2015,9,28,1,196,62,258,547
0131-002,2015,9,28,2,74,26,100,258
0131-002,2015,9,28,3,34,20,54,100
0131-002,2015,9,28,4,18,17,35,54
0131-002,2015,9,28,5,26,13,39,35
0131-002,2015,9,28,6,42,33,75,39
0131-002,2015,9,28,7,54,52,106,75
0131-002,2015,9,28,8,137,92,229,106
0131-002,2015,9,28,9,203,145,348,229
0131-002,2015,9,28,10,420,216,636,348
0131-002,2015,9,28,11,895,358,1253,636
0131-002,2015,9,28,12,1002,352,1354,1253
0131-002,2015,9,28,13,805,266,1071,1354
0131-002,2015,9,28,14,811,290,1101,1071
0131-002,2015,9,28,15,878,295,1173,1101
0131-002,2015,9,28,16,935,347,1282,1173
0131-002,2015,9,28,17,1184,326,1510,1282
0131-002,2015,9,28,18,996,305,1301,1510
0131-002,2015,9,28,19,1048,315,1363,1301
0131-002,2015,9,28,20,1024,315,1339,1363
0131-002,2015,9,28,21,737,287,1024,1339
0131-002,2015,9,28,22,689,216,905,1024
0131-002,2015,9,28,23,837,150,987,905
0131-002,2015,9,28,24,790,105,895,987
0131-002,2015,9,29,1,617,65,682,895
0131-002,2015,9,29,2,252,47,299,682
0131-002,2015,9,29,3,78,21,99,299
0131-002,2015,9,29,4,32,23,55,99
0131-002,2015,9,29,5,18,21,39,55
0131-002,2015,9,29,6,28,36,64,39
0131-002,2015,9,29,7,133,86,219,64
0131-002,2015,9,29,8,330,178,508,219
0131-002,2015,9,29,9,321,300,621,508
0131-002,2015,9,29,10,317,315,632,621
0131-002,2015,9,29,11,507,422,929,632
0131-002,2015,9,29,12,684,442,1126,929
0131-002,2015,9,29,13,771,340,1111,1126
0131-002,2015,9,29,14,655,292,947,1111
0131-002,2015,9,29,15,688,335,1023,947
0131-002,2015,9,29,16,625,329,954,1023
0131-002,2015,9,29,17,633,335,968,954
0131-002,2015,9,29,18,712,355,1067,968
0131-002,2015,9,29,19,655,305,960,1067
0131-002,2015,9,29,20,477,310,787,960
0131-002,2015,9,29,21,365,276,641,787
0131-002,2015,9,29,22,341,207,548,641
0131-002,2015,9,29,23,217,129,346,548
0131-002,2015,9,29,24,142,70,212,346
0131-002,2015,9,30,1,64,50,114,212
0131-002,2015,9,30,2,42,36,78,114
0131-002,2015,9,30,3,34,17,51,78
0131-002,2015,9,30,4,14,18,32,51
0131-002,2015,9,30,5,28,31,59,32
0131-002,2015,9,30,6,196,96,292,59
0131-002,2015,9,30,7,662,274,936,292
0131-002,2015,9,30,8,1639,867,2506,936
0131-002,2015,9,30,9,1178,946,2124,2506
0131-002,2015,9,30,10,625,772,1397,2124
0131-002,2015,9,30,11,696,711,1407,1397
0131-002,2015,9,30,12,555,748,1303,1407
0131-002,2015,9,30,13,585,579,1164,1303
0131-002,2015,9,30,14,740,680,1420,1164
0131-002,2015,9,30,15,742,769,1511,1420
0131-002,2015,9,30,16,732,619,1351,1511
0131-002,2015,9,30,17,733,699,1432,1351
0131-002,2015,9,30,18,791,807,1598,1432
0131-002,2015,9,30,19,793,1019,1812,1598
0131-002,2015,9,30,20,487,640,1127,1812
0131-002,2015,9,30,21,367,537,904,1127
0131-002,2015,9,30,22,235,287,522,904
0131-002,2015,9,30,23,157,226,383,522
0131-002,2015,9,30,24,150,120,270,383
0131-002,2015,10,1,1,69,99,168,270
0131-002,2015,10,1,2,35,51,86,168
0131-002,2015,10,1,3,35,29,64,86
0131-002,2015,10,1,4,23,57,80,64
0131-002,2015,10,1,5,43,55,98,80
0131-002,2015,10,1,6,177,103,280,98
0131-002,2015,10,1,7,675,267,942,280
0131-002,2015,10,1,8,1995,959,2954,942
0131-002,2015,10,1,9,1264,1223,2487,2954
0131-002,2015,10,1,10,844,870,1714,2487
0131-002,2015,10,1,11,934,858,1792,1714
0131-002,2015,10,1,12,714,891,1605,1792
0131-002,2015,10,1,13,577,663,1240,1605
0131-002,2015,10,1,14,762,793,1555,1240
0131-002,2015,10,1,15,824,1020,1844,1555
0131-002,2015,10,1,16,832,937,1769,1844
0131-002,2015,10,1,17,756,964,1720,1769
0131-002,2015,10,1,18,856,1269,2125,1720
0131-002,2015,10,1,19,784,1165,1949,2125
0131-002,2015,10,1,20,471,850,1321,1949
0131-002,2015,10,1,21,389,800,1189,1321
0131-002,2015,10,1,22,347,487,834,1189
0131-002,2015,10,1,23,213,246,459,834
0131-002,2015,10,1,24,87,124,211,459
0131-002,2015,10,2,1,53,85,138,211
0131-002,2015,10,2,2,51,62,113,138
0131-002,2015,10,2,3,43,45,88,113
0131-002,2015,10,2,4,17,43,60,88
0131-002,2015,10,2,5,45,57,102,60
0131-002,2015,10,2,6,243,109,352,102
0131-002,2015,10,2,7,814,344,1158,352
0131-002,2015,10,2,8,2127,1026,3153,1158
0131-002,2015,10,2,9,1613,1281,2894,3153
0131-002,2015,10,2,10,962,1048,2010,2894
0131-002,2015,10,2,11,996,1119,2115,2010
0131-002,2015,10,2,12,842,1067,1909,2115
0131-002,2015,10,2,13,734,922,1656,1909
0131-002,2015,10,2,14,880,926,1806,1656
0131-002,2015,10,2,15,1006,1156,2162,1806
0131-002,2015,10,2,16,998,1235,2233,2162
0131-002,2015,10,2,17,950,1314,2264,2233
0131-002,2015,10,2,18,1162,1881,3043,2264
0131-002,2015,10,2,19,1198,1673,2871,3043
0131-002,2015,10,2,20,856,1165,2021,2871
0131-002,2015,10,2,21,519,941,1460,2021
0131-002,2015,10,2,22,343,520,863,1460
0131-002,2015,10,2,23,197,286,483,863
0131-002,2015,10,2,24,143,196,339,483
0131-002,2015,10,3,1,97,122,219,339
0131-002,2015,10,3,2,63,62,125,219
0131-002,2015,10,3,3,43,53,96,125
0131-002,2015,10,3,4,51,55,106,96
0131-002,2015,10,3,5,45,70,115,106
0131-002,2015,10,3,6,159,120,279,115
0131-002,2015,10,3,7,553,296,849,279
0131-002,2015,10,3,8,974,555,1529,849
0131-002,2015,10,3,9,864,912,1776,1529
0131-002,2015,10,3,10,774,924,1698,1776
0131-002,2015,10,3,11,940,1181,2121,1698
0131-002,2015,10,3,12,974,1210,2184,2121
0131-002,2015,10,3,13,788,1036,1824,2184
0131-002,2015,10,3,14,822,858,1680,1824
0131-002,2015,10,3,15,780,756,1536,1680
0131-002,2015,10,3,16,784,735,1519,1536
0131-002,2015,10,3,17,782,845,1627,1519
0131-002,2015,10,3,18,972,1434,2406,1627
0131-002,2015,10,3,19,768,1017,1785,2406
0131-002,2015,10,3,20,499,567,1066,1785
0131-002,2015,10,3,21,369,406,775,1066
0131-002,2015,10,3,22,301,283,584,775
0131-002,2015,10,3,23,137,188,325,584
0131-002,2015,10,3,24,127,145,272,325
0131-002,2015,10,4,1,81,80,161,272
0131-002,2015,10,4,2,39,70,109,161
0131-002,2015,10,4,3,37,37,74,109
0131-002,2015,10,4,4,23,28,51,74
0131-002,2015,10,4,5,33,29,62,51
0131-002,2015,10,4,6,125,74,199,62
0131-002,2015,10,4,7,259,103,362,199
0131-002,2015,10,4,8,341,298,639,362
0131-002,2015,10,4,9,397,385,782,639
0131-002,2015,10,4,10,363,470,833,782
0131-002,2015,10,4,11,435,572,1007,833
0131-002,2015,10,4,12,507,536,1043,1007
0131-002,2015,10,4,13,515,509,1024,1043
0131-002,2015,10,4,14,605,567,1172,1024
0131-002,2015,10,4,15,677,597,1274,1172
0131-002,2015,10,4,16,888,518,1406,1274
0131-002,2015,10,4,17,752,536,1288,1406
0131-002,2015,10,4,18,959,827,1786,1288
0131-002,2015,10,4,19,726,709,1435,1786
0131-002,2015,10,4,20,469,516,985,1435
0131-002,2015,10,4,21,381,333,714,985
0131-002,2015,10,4,22,315,205,520,714
0131-002,2015,10,4,23,193,182,375,520
0131-002,2015,10,4,24,123,93,216,375
0131-002,2015,10,5,1,73,49,122,216
0131-002,2015,10,5,2,35,26,61,122
0131-002,2015,10,5,3,13,20,33,61
0131-002,2015,10,5,4,17,28,45,33
0131-002,2015,10,5,5,45,37,82,45
0131-002,2015,10,5,6,287,143,430,82
0131-002,2015,10,5,7,1028,414,1442,430
0131-002,2015,10,5,8,2472,1187,3659,1442
0131-002,2015,10,5,9,1571,1372,2943,3659
0131-002,2015,10,5,10,948,966,1914,2943
0131-002,2015,10,5,11,960,1019,1979,1914
0131-002,2015,10,5,12,844,1007,1851,1979
0131-002,2015,10,5,13,776,881,1657,1851
0131-002,2015,10,5,14,904,796,1700,1657
0131-002,2015,10,5,15,976,970,1946,1700
0131-002,2015,10,5,16,938,910,1848,1946
0131-002,2015,10,5,17,876,1010,1886,1848
0131-002,2015,10,5,18,986,1445,2431,1886
0131-002,2015,10,5,19,932,1142,2074,2431
0131-002,2015,10,5,20,599,984,1583,2074
0131-002,2015,10,5,21,525,912,1437,1583
0131-002,2015,10,5,22,397,570,967,1437
0131-002,2015,10,5,23,211,300,511,967
0131-002,2015,10,5,24,105,138,243,511
0131-002,2015,10,6,1,51,120,171,243
0131-002,2015,10,6,2,25,57,82,171
0131-002,2015,10,6,3,31,53,84,82
0131-002,2015,10,6,4,45,41,86,84
0131-002,2015,10,6,5,53,57,110,86
0131-002,2015,10,6,6,257,101,358,110
0131-002,2015,10,6,7,992,385,1377,358
0131-002,2015,10,6,8,2086,1109,3195,1377
0131-002,2015,10,6,9,1631,1457,3088,3195
0131-002,2015,10,6,10,1100,1080,2180,3088
0131-002,2015,10,6,11,982,1011,1993,2180
0131-002,2015,10,6,12,926,1142,2068,1993
0131-002,2015,10,6,13,774,734,1508,2068
0131-002,2015,10,6,14,878,842,1720,1508
0131-002,2015,10,6,15,1022,907,1929,1720
0131-002,2015,10,6,16,1078,974,2052,1929
0131-002,2015,10,6,17,908,1042,1950,2052
0131-002,2015,10,6,18,1060,1466,2526,1950
0131-002,2015,10,6,19,996,1285,2281,2526
0131-002,2015,10,6,20,593,984,1577,2281
0131-002,2015,10,6,21,465,858,1323,1577
0131-002,2015,10,6,22,331,512,843,1323
0131-002,2015,10,6,23,237,298,535,843
0131-002,2015,10,6,24,121,199,320,535
0131-002,2015,10,7,1,59,103,162,320
0131-002,2015,10,7,2,61,60,121,162
0131-002,2015,10,7,3,29,47,76,121
0131-002,2015,10,7,4,17,41,58,76
0131-002,2015,10,7,5,33,51,84,58
0131-002,2015,10,7,6,253,130,383,84
0131-002,2015,10,7,7,890,424,1314,383
0131-002,2015,10,7,8,2172,1048,3220,1314
0131-002,2015,10,7,9,1559,1382,2941,3220
0131-002,2015,10,7,10,1160,1115,2275,2941
0131-002,2015,10,7,11,1000,1119,2119,2275
0131-002,2015,10,7,12,902,1080,1982,2119
0131-002,2015,10,7,13,758,676,1434,1982
0131-002,2015,10,7,14,936,782,1718,1434
0131-002,2015,10,7,15,996,916,1912,1718
0131-002,2015,10,7,16,1096,794,1890,1912
0131-002,2015,10,7,17,918,878,1796,1890
0131-002,2015,10,7,18,1064,1075,2139,1796
0131-002,2015,10,7,19,936,1428,2364,2139
0131-002,2015,10,7,20,643,995,1638,2364
0131-002,2015,10,7,21,427,709,1136,1638
0131-002,2015,10,7,22,343,536,879,1136
0131-002,2015,10,7,23,231,252,483,879
0131-002,2015,10,7,24,169,163,332,483
0131-002,2015,10,8,1,101,93,194,332
0131-002,2015,10,8,2,39,64,103,194
0131-002,2015,10,8,3,35,35,70,103
0131-002,2015,10,8,4,21,53,74,70
0131-002,2015,10,8,5,51,68,119,74
0131-002,2015,10,8,6,269,145,414,119
0131-002,2015,10,8,7,906,381,1287,414
0131-002,2015,10,8,8,2177,1111,3288,1287
0131-002,2015,10,8,9,1613,1420,3033,3288
0131-002,2015,10,8,10,1104,1096,2200,3033
0131-002,2015,10,8,11,966,1113,2079,2200
0131-002,2015,10,8,12,964,1053,2017,2079
0131-002,2015,10,8,13,824,937,1761,2017
0131-002,2015,10,8,14,1006,862,1868,1761
0131-002,2015,10,8,15,1022,871,1893,1868
0131-002,2015,10,8,16,1098,952,2050,1893
0131-002,2015,10,8,17,1082,1009,2091,2050
0131-002,2015,10,8,18,1280,1348,2628,2091
0131-002,2015,10,8,19,1090,1514,2604,2628
0131-002,2015,10,8,20,810,1252,2062,2604
0131-002,2015,10,8,21,603,1015,1618,2062
0131-002,2015,10,8,22,383,640,1023,1618
0131-002,2015,10,8,23,287,310,597,1023
0131-002,2015,10,8,24,177,182,359,597
0131-002,2015,10,9,1,91,114,205,359
0131-002,2015,10,9,2,57,103,160,205
0131-002,2015,10,9,3,41,58,99,160
0131-002,2015,10,9,4,25,55,80,99
0131-002,2015,10,9,5,51,62,113,80
0131-002,2015,10,9,6,217,128,345,113
0131-002,2015,10,9,7,694,354,1048,345
0131-002,2015,10,9,8,1223,789,2012,1048
0131-002,2015,10,9,9,886,947,1833,2012
0131-002,2015,10,9,10,868,1370,2238,1833
0131-002,2015,10,9,11,984,1447,2431,2238
0131-002,2015,10,9,12,902,1652,2554,2431
0131-002,2015,10,9,13,808,1552,2360,2554
0131-002,2015,10,9,14,778,1391,2169,2360
0131-002,2015,10,9,15,892,1469,2361,2169
0131-002,2015,10,9,16,760,1498,2258,2361
0131-002,2015,10,9,17,786,1471,2257,2258
0131-002,2015,10,9,18,996,1822,2818,2257
0131-002,2015,10,9,19,934,1196,2130,2818
0131-002,2015,10,9,20,565,764,1329,2130
0131-002,2015,10,9,21,355,420,775,1329
0131-002,2015,10,9,22,301,302,603,775
0131-002,2015,10,9,23,199,207,406,603
0131-002,2015,10,9,24,77,149,226,406
0131-002,2015,10,10,1,71,70,141,226
0131-002,2015,10,10,2,49,64,113,141
0131-002,2015,10,10,3,35,51,86,113
0131-002,2015,10,10,4,31,43,74,86
0131-002,2015,10,10,5,41,47,88,74
0131-002,2015,10,10,6,153,99,252,88
0131-002,2015,10,10,7,419,250,669,252
0131-002,2015,10,10,8,685,526,1211,669
0131-002,2015,10,10,9,683,899,1582,1211
0131-002,2015,10,10,10,615,1080,1695,1582
0131-002,2015,10,10,11,716,920,1636,1695
0131-002,2015,10,10,12,617,744,1361,1636
0131-002,2015,10,10,13,742,781,1523,1361
0131-002,2015,10,10,14,647,783,1430,1523
0131-002,2015,10,10,15,692,820,1512,1430
0131-002,2015,10,10,16,798,947,1745,1512
0131-002,2015,10,10,17,906,912,1818,1745
0131-002,2015,10,10,18,924,1082,2006,1818
0131-002,2015,10,10,19,910,804,1714,2006
0131-002,2015,10,10,20,679,466,1145,1714
0131-002,2015,10,10,21,593,331,924,1145
0131-002,2015,10,10,22,325,194,519,924
0131-002,2015,10,10,23,169,170,339,519
0131-002,2015,10,10,24,105,114,219,339
0131-002,2015,10,11,1,55,84,139,219
0131-002,2015,10,11,2,31,66,97,139
0131-002,2015,10,11,3,33,41,74,97
0131-002,2015,10,11,4,29,28,57,74
0131-002,2015,10,11,5,13,26,39,57
0131-002,2015,10,11,6,97,57,154,39
0131-002,2015,10,11,7,193,109,302,154
0131-002,2015,10,11,8,291,194,485,302
0131-002,2015,10,11,9,275,325,600,485
0131-002,2015,10,11,10,381,429,810,600
0131-002,2015,10,11,11,477,547,1024,810
0131-002,2015,10,11,12,575,582,1157,1024
0131-002,2015,10,11,13,503,696,1199,1157
0131-002,2015,10,11,14,515,613,1128,1199
0131-002,2015,10,11,15,585,624,1209,1128
0131-002,2015,10,11,16,856,671,1527,1209
0131-002,2015,10,11,17,866,1207,2073,1527
0131-002,2015,10,11,18,988,831,1819,2073
0131-002,2015,10,11,19,860,543,1403,1819
0131-002,2015,10,11,20,667,358,1025,1403
0131-002,2015,10,11,21,439,298,737,1025
0131-002,2015,10,11,22,311,180,491,737
0131-002,2015,10,11,23,231,151,382,491
0131-002,2015,10,11,24,81,72,153,382
0131-002,2015,10,12,1,59,64,123,153
0131-002,2015,10,12,2,33,29,62,123
0131-002,2015,10,12,3,37,31,68,62
0131-002,2015,10,12,4,19,22,41,68
0131-002,2015,10,12,5,35,43,78,41
0131-002,2015,10,12,6,279,136,415,78
0131-002,2015,10,12,7,998,404,1402,415
0131-002,2015,10,12,8,2372,1150,3522,1402
0131-002,2015,10,12,9,1661,1202,2863,3522
0131-002,2015,10,12,10,976,972,1948,2863
0131-002,2015,10,12,11,946,1069,2015,1948
0131-002,2015,10,12,12,832,976,1808,2015
0131-002,2015,10,12,13,742,862,1604,1808
0131-002,2015,10,12,14,852,1015,1867,1604
0131-002,2015,10,12,15,1030,1111,2141,1867
0131-002,2015,10,12,16,996,999,1995,2141
0131-002,2015,10,12,17,914,1229,2143,1995
0131-002,2015,10,12,18,1080,1611,2691,2143
0131-002,2015,10,12,19,840,1403,2243,2691
0131-002,2015,10,12,20,625,928,1553,2243
0131-002,2015,10,12,21,471,862,1333,1553
0131-002,2015,10,12,22,327,576,903,1333
0131-002,2015,10,12,23,235,292,527,903
0131-002,2015,10,12,24,97,172,269,527
0131-002,2015,10,13,1,69,93,162,269
0131-002,2015,10,13,2,47,66,113,162
0131-002,2015,10,13,3,29,31,60,113
0131-002,2015,10,13,4,29,33,62,60
0131-002,2015,10,13,5,37,53,90,62
0131-002,2015,10,13,6,233,128,361,90
0131-002,2015,10,13,7,896,371,1267,361
0131-002,2015,10,13,8,2146,1125,3271,1267
0131-002,2015,10,13,9,1573,1262,2835,3271
0131-002,2015,10,13,10,1118,1125,2243,2835
0131-002,2015,10,13,11,1044,1162,2206,2243
0131-002,2015,10,13,12,940,1034,1974,2206
0131-002,2015,10,13,13,740,891,1631,1974
0131-002,2015,10,13,14,958,988,1946,1631
0131-002,2015,10,13,15,978,1235,2213,1946
0131-002,2015,10,13,16,992,1245,2237,2213
0131-002,2015,10,13,17,854,1337,2191,2237
0131-002,2015,10,13,18,1004,1677,2681,2191
0131-002,2015,10,13,19,926,1341,2267,2681
0131-002,2015,10,13,20,601,935,1536,2267
0131-002,2015,10,13,21,501,883,1384,1536
0131-002,2015,10,13,22,357,592,949,1384
0131-002,2015,10,13,23,213,321,534,949
0131-002,2015,10,13,24,133,142,275,534
0131-002,2015,10,14,1,79,93,172,275
0131-002,2015,10,14,2,43,64,107,172
0131-002,2015,10,14,3,19,49,68,107
0131-002,2015,10,14,4,35,43,78,68
0131-002,2015,10,14,5,33,57,90,78
0131-002,2015,10,14,6,221,107,328,90
0131-002,2015,10,14,7,846,348,1194,328
0131-002,2015,10,14,8,2161,1030,3191,1194
0131-002,2015,10,14,9,1527,1281,2808,3191
0131-002,2015,10,14,10,1080,1133,2213,2808
0131-002,2015,10,14,11,1120,1051,2171,2213
0131-002,2015,10,14,12,964,957,1921,2171
0131-002,2015,10,14,13,679,937,1616,1921
0131-002,2015,10,14,14,906,731,1637,1616
0131-002,2015,10,14,15,940,842,1782,1637
0131-002,2015,10,14,16,1034,706,1740,1782
0131-002,2015,10,14,17,930,788,1718,1740
0131-002,2015,10,14,18,1016,941,1957,1718
0131-002,2015,10,14,19,994,1416,2410,1957
0131-002,2015,10,14,20,639,914,1553,2410
0131-002,2015,10,14,21,477,704,1181,1553
0131-002,2015,10,14,22,347,487,834,1181
0131-002,2015,10,14,23,239,275,514,834
0131-002,2015,10,14,24,151,159,310,514
0131-002,2015,10,15,1,91,105,196,310
0131-002,2015,10,15,2,43,58,101,196
0131-002,2015,10,15,3,43,43,86,101
0131-002,2015,10,15,4,33,55,88,86
0131-002,2015,10,15,5,49,55,104,88
0131-002,2015,10,15,6,271,130,401,104
0131-002,2015,10,15,7,896,431,1327,401
0131-002,2015,10,15,8,2168,1084,3252,1327
0131-002,2015,10,15,9,1479,1372,2851,3252
0131-002,2015,10,15,10,1090,1009,2099,2851
0131-002,2015,10,15,11,974,1069,2043,2099
0131-002,2015,10,15,12,960,1005,1965,2043
0131-002,2015,10,15,13,738,881,1619,1965
0131-002,2015,10,15,14,862,1032,1894,1619
0131-002,2015,10,15,15,1006,951,1957,1894
0131-002,2015,10,15,16,936,944,1880,1957
0131-002,2015,10,15,17,858,986,1844,1880
0131-002,2015,10,15,18,1072,835,1907,1844
0131-002,2015,10,15,19,958,1372,2330,1907
0131-002,2015,10,15,20,663,1032,1695,2330
0131-002,2015,10,15,21,513,796,1309,1695
0131-002,2015,10,15,22,423,559,982,1309
0131-002,2015,10,15,23,279,250,529,982
0131-002,2015,10,15,24,123,182,305,529
0131-002,2015,10,16,1,93,85,178,305
0131-002,2015,10,16,2,41,72,113,178
0131-002,2015,10,16,3,37,55,92,113
0131-002,2015,10,16,4,15,43,58,92
0131-002,2015,10,16,5,43,76,119,58
0131-002,2015,10,16,6,261,143,404,119
0131-002,2015,10,16,7,866,375,1241,404
0131-002,2015,10,16,8,2050,1057,3107,1241
0131-002,2015,10,16,9,1509,1272,2781,3107
0131-002,2015,10,16,10,1032,1059,2091,2781
0131-002,2015,10,16,11,996,1127,2123,2091
0131-002,2015,10,16,12,908,986,1894,2123
0131-002,2015,10,16,13,852,841,1693,1894
0131-002,2015,10,16,14,862,924,1786,1693
0131-002,2015,10,16,15,1056,972,2028,1786
0131-002,2015,10,16,16,1040,1366,2406,2028
0131-002,2015,10,16,17,978,1392,2370,2406
0131-002,2015,10,16,18,1184,1318,2502,2370
0131-002,2015,10,16,19,1184,1612,2796,2502
0131-002,2015,10,16,20,756,1169,1925,2796
0131-002,2015,10,16,21,557,808,1365,1925
0131-002,2015,10,16,22,393,507,900,1365
0131-002,2015,10,16,23,281,315,596,900
0131-002,2015,10,16,24,187,174,361,596
0131-002,2015,10,17,1,123,103,226,361
0131-002,2015,10,17,2,61,72,133,226
0131-002,2015,10,17,3,67,70,137,133
0131-002,2015,10,17,4,41,53,94,137
0131-002,2015,10,17,5,51,43,94,94
0131-002,2015,10,17,6,157,126,283,94
0131-002,2015,10,17,7,591,312,903,283
0131-002,2015,10,17,8,1038,742,1780,903
0131-002,2015,10,17,9,926,1104,2030,1780
0131-002,2015,10,17,10,784,1096,1880,2030
0131-002,2015,10,17,11,930,1210,2140,1880
0131-002,2015,10,17,12,978,1331,2309,2140
0131-002,2015,10,17,13,1026,1200,2226,2309
0131-002,2015,10,17,14,932,820,1752,2226
0131-002,2015,10,17,15,864,788,1652,1752
0131-002,2015,10,17,16,958,841,1799,1652
0131-002,2015,10,17,17,946,878,1824,1799
0131-002,2015,10,17,18,1263,1258,2521,1824
0131-002,2015,10,17,19,1122,910,2032,2521
0131-002,2015,10,17,20,936,516,1452,2032
0131-002,2015,10,17,21,567,510,1077,1452
0131-002,2015,10,17,22,327,279,606,1077
0131-002,2015,10,17,23,199,196,395,606
0131-002,2015,10,17,24,99,130,229,395
0131-002,2015,10,18,1,43,85,128,229
0131-002,2015,10,18,2,49,60,109,128
0131-002,2015,10,18,3,31,41,72,109
0131-002,2015,10,18,4,15,35,50,72
0131-002,2015,10,18,5,39,29,68,50
0131-002,2015,10,18,6,107,58,165,68
0131-002,2015,10,18,7,277,165,442,165
0131-002,2015,10,18,8,429,300,729,442
0131-002,2015,10,18,9,415,402,817,729
0131-002,2015,10,18,10,461,528,989,817
0131-002,2015,10,18,11,513,621,1134,989
0131-002,2015,10,18,12,495,474,969,1134
0131-002,2015,10,18,13,521,621,1142,969
0131-002,2015,10,18,14,565,652,1217,1142
0131-002,2015,10,18,15,659,628,1287,1217
0131-002,2015,10,18,16,910,549,1459,1287
0131-002,2015,10,18,17,824,495,1319,1459
0131-002,2015,10,18,18,1010,652,1662,1319
0131-002,2015,10,18,19,928,717,1645,1662
0131-002,2015,10,18,20,800,567,1367,1645
0131-002,2015,10,18,21,569,391,960,1367
0131-002,2015,10,18,22,417,261,678,960
0131-002,2015,10,18,23,269,188,457,678
0131-002,2015,10,18,24,131,97,228,457
0131-002,2015,10,19,1,77,78,155,228
0131-002,2015,10,19,2,23,41,64,155
0131-002,2015,10,19,3,17,24,41,64
0131-002,2015,10,19,4,25,26,51,41
0131-002,2015,10,19,5,67,37,104,51
0131-002,2015,10,19,6,271,142,413,104
0131-002,2015,10,19,7,996,416,1412,413
0131-002,2015,10,19,8,2358,1121,3479,1412
0131-002,2015,10,19,9,1553,1245,2798,3479
0131-002,2015,10,19,10,936,999,1935,2798
0131-002,2015,10,19,11,964,1030,1994,1935
0131-002,2015,10,19,12,906,1034,1940,1994
0131-002,2015,10,19,13,790,833,1623,1940
0131-002,2015,10,19,14,926,901,1827,1623
0131-002,2015,10,19,15,1000,810,1810,1827
0131-002,2015,10,19,16,1018,628,1646,1810
0131-002,2015,10,19,17,886,628,1514,1646
0131-002,2015,10,19,18,1040,1239,2279,1514
0131-002,2015,10,19,19,882,1293,2175,2279
0131-002,2015,10,19,20,599,887,1486,2175
0131-002,2015,10,19,21,433,798,1231,1486
0131-002,2015,10,19,22,333,578,911,1231
0131-002,2015,10,19,23,203,286,489,911
0131-002,2015,10,19,24,97,120,217,489
0131-002,2015,10,20,1,61,93,154,217
0131-002,2015,10,20,2,41,60,101,154
0131-002,2015,10,20,3,33,35,68,101
0131-002,2015,10,20,4,19,35,54,68
0131-002,2015,10,20,5,47,64,111,54
0131-002,2015,10,20,6,255,126,381,111
0131-002,2015,10,20,7,800,398,1198,381
0131-002,2015,10,20,8,1997,1007,3004,1198
0131-002,2015,10,20,9,1531,1287,2818,3004
0131-002,2015,10,20,10,988,1113,2101,2818
0131-002,2015,10,20,11,1010,1075,2085,2101
0131-002,2015,10,20,12,924,992,1916,2085
0131-002,2015,10,20,13,780,746,1526,1916
0131-002,2015,10,20,14,892,1218,2110,1526
0131-002,2015,10,20,15,968,988,1956,2110
0131-002,2015,10,20,16,978,682,1660,1956
0131-002,2015,10,20,17,900,638,1538,1660
0131-002,2015,10,20,18,962,1324,2286,1538
0131-002,2015,10,20,19,902,1279,2181,2286
0131-002,2015,10,20,20,645,922,1567,2181
0131-002,2015,10,20,21,437,847,1284,1567
0131-002,2015,10,20,22,387,526,913,1284
0131-002,2015,10,20,23,221,310,531,913
0131-002,2015,10,20,24,89,165,254,531
0131-002,2015,10,21,1,61,97,158,254
0131-002,2015,10,21,2,29,51,80,158
0131-002,2015,10,21,3,27,39,66,80
0131-002,2015,10,21,4,31,28,59,66
0131-002,2015,10,21,5,45,57,102,59
0131-002,2015,10,21,6,247,118,365,102
0131-002,2015,10,21,7,802,369,1171,365
0131-002,2015,10,21,8,1993,1003,2996,1171
0131-002,2015,10,21,9,1593,1326,2919,2996
0131-002,2015,10,21,10,994,1024,2018,2919
0131-002,2015,10,21,11,1074,1028,2102,2018
0131-002,2015,10,21,12,952,1105,2057,2102
0131-002,2015,10,21,13,752,951,1703,2057
0131-002,2015,10,21,14,902,999,1901,1703
0131-002,2015,10,21,15,972,928,1900,1901
0131-002,2015,10,21,16,960,765,1725,1900
0131-002,2015,10,21,17,876,748,1624,1725
0131-002,2015,10,21,18,1060,1626,2686,1624
0131-002,2015,10,21,19,874,1467,2341,2686
0131-002,2015,10,21,20,661,939,1600,2341
0131-002,2015,10,21,21,423,711,1134,1600
0131-002,2015,10,21,22,369,418,787,1134
0131-002,2015,10,21,23,237,296,533,787
0131-002,2015,10,21,24,133,180,313,533
0131-002,2015,10,22,1,69,116,185,313
0131-002,2015,10,22,2,47,47,94,185
0131-002,2015,10,22,3,21,28,49,94
0131-002,2015,10,22,4,43,45,88,49
0131-002,2015,10,22,5,37,51,88,88
0131-002,2015,10,22,6,225,118,343,88
0131-002,2015,10,22,7,808,329,1137,343
0131-002,2015,10,22,8,1964,961,2925,1137
0131-002,2015,10,22,9,1557,1349,2906,2925
0131-002,2015,10,22,10,1094,1044,2138,2906
0131-002,2015,10,22,11,950,1055,2005,2138
0131-002,2015,10,22,12,936,1024,1960,2005
0131-002,2015,10,22,13,768,850,1618,1960
0131-002,2015,10,22,14,870,941,1811,1618
0131-002,2015,10,22,15,1044,1067,2111,1811
0131-002,2015,10,22,16,1040,812,1852,2111
0131-002,2015,10,22,17,900,744,1644,1852
0131-002,2015,10,22,18,968,1360,2328,1644
0131-002,2015,10,22,19,984,1407,2391,2328
0131-002,2015,10,22,20,700,715,1415,2391
0131-002,2015,10,22,21,413,551,964,1415
0131-002,2015,10,22,22,335,480,815,964
0131-002,2015,10,22,23,259,271,530,815
0131-002,2015,10,22,24,153,169,322,530
0131-002,2015,10,23,1,105,97,202,322
0131-002,2015,10,23,2,67,57,124,202
0131-002,2015,10,23,3,23,47,70,124
0131-002,2015,10,23,4,39,49,88,70
0131-002,2015,10,23,5,39,53,92,88
0131-002,2015,10,23,6,249,136,385,92
0131-002,2015,10,23,7,810,340,1150,385
0131-002,2015,10,23,8,2186,1026,3212,1150
0131-002,2015,10,23,9,1503,1353,2856,3212
0131-002,2015,10,23,10,1118,1105,2223,2856
0131-002,2015,10,23,11,1058,1105,2163,2223
0131-002,2015,10,23,12,938,1084,2022,2163
0131-002,2015,10,23,13,740,879,1619,2022
0131-002,2015,10,23,14,968,980,1948,1619
0131-002,2015,10,23,15,1086,945,2031,1948
0131-002,2015,10,23,16,1090,1330,2420,2031
0131-002,2015,10,23,17,964,1096,2060,2420
0131-002,2015,10,23,18,1128,1939,3067,2060
0131-002,2015,10,23,19,1218,1700,2918,3067
0131-002,2015,10,23,20,822,1123,1945,2918
0131-002,2015,10,23,21,517,864,1381,1945
0131-002,2015,10,23,22,425,567,992,1381
0131-002,2015,10,23,23,251,319,570,992
0131-002,2015,10,23,24,129,178,307,570
0131-002,2015,10,24,1,89,134,223,307
0131-002,2015,10,24,2,85,101,186,223
0131-002,2015,10,24,3,55,43,98,186
0131-002,2015,10,24,4,37,51,88,98
0131-002,2015,10,24,5,61,53,114,88
0131-002,2015,10,24,6,213,157,370,114
0131-002,2015,10,24,7,515,263,778,370
0131-002,2015,10,24,8,854,636,1490,778
0131-002,2015,10,24,9,826,1071,1897,1490
0131-002,2015,10,24,10,810,1198,2008,1897
0131-002,2015,10,24,11,844,1322,2166,2008
0131-002,2015,10,24,12,894,1354,2248,2166
0131-002,2015,10,24,13,864,1198,2062,2248
0131-002,2015,10,24,14,824,1036,1860,2062
0131-002,2015,10,24,15,806,1119,1925,1860
0131-002,2015,10,24,16,932,1125,2057,1925
0131-002,2015,10,24,17,910,1204,2114,2057
0131-002,2015,10,24,18,1001,1287,2288,2114
0131-002,2015,10,24,19,978,922,1900,2288
0131-002,2015,10,24,20,581,559,1140,1900
0131-002,2015,10,24,21,427,420,847,1140
0131-002,2015,10,24,22,303,306,609,847
0131-002,2015,10,24,23,173,169,342,609
0131-002,2015,10,24,24,113,120,233,342
0131-002,2015,10,25,1,81,85,166,233
0131-002,2015,10,25,2,29,64,93,166
0131-002,2015,10,25,3,29,28,57,93
0131-002,2015,10,25,4,35,47,82,57
0131-002,2015,10,25,5,39,28,67,82
0131-002,2015,10,25,6,93,60,153,67
0131-002,2015,10,25,7,227,128,355,153
0131-002,2015,10,25,8,303,269,572,355
0131-002,2015,10,25,9,327,381,708,572
0131-002,2015,10,25,10,397,570,967,708
0131-002,2015,10,25,11,431,572,1003,967
0131-002,2015,10,25,12,515,524,1039,1003
0131-002,2015,10,25,13,531,563,1094,1039
0131-002,2015,10,25,14,545,514,1059,1094
0131-002,2015,10,25,15,637,520,1157,1059
0131-002,2015,10,25,16,661,545,1206,1157
0131-002,2015,10,25,17,782,646,1428,1206
0131-002,2015,10,25,18,914,924,1838,1428
0131-002,2015,10,25,19,822,706,1528,1838
0131-002,2015,10,25,20,758,487,1245,1528
0131-002,2015,10,25,21,561,389,950,1245
0131-002,2015,10,25,22,441,248,689,950
0131-002,2015,10,25,23,233,167,400,689
0131-002,2015,10,25,24,139,91,230,400
0131-002,2015,10,26,1,45,58,103,230
0131-002,2015,10,26,2,19,33,52,103
0131-002,2015,10,26,3,31,12,43,52
0131-002,2015,10,26,4,17,39,56,43
0131-002,2015,10,26,5,53,29,82,56
0131-002,2015,10,26,6,301,136,437,82
0131-002,2015,10,26,7,1054,418,1472,437
0131-002,2015,10,26,8,2277,1156,3433,1472
0131-002,2015,10,26,9,1553,1277,2830,3433
0131-002,2015,10,26,10,1022,1119,2141,2830
0131-002,2015,10,26,11,914,1117,2031,2141
0131-002,2015,10,26,12,916,1086,2002,2031
0131-002,2015,10,26,13,685,978,1663,2002
0131-002,2015,10,26,14,838,1026,1864,1663
0131-002,2015,10,26,15,990,1152,2142,1864
0131-002,2015,10,26,16,1038,1210,2248,2142
0131-002,2015,10,26,17,912,1359,2271,2248
0131-002,2015,10,26,18,1050,1616,2666,2271
0131-002,2015,10,26,19,916,1268,2184,2666
0131-002,2015,10,26,20,641,1028,1669,2184
0131-002,2015,10,26,21,453,849,1302,1669
0131-002,2015,10,26,22,361,472,833,1302
0131-002,2015,10,26,23,195,259,454,833
0131-002,2015,10,26,24,111,124,235,454
0131-002,2015,10,27,1,69,82,151,235
0131-002,2015,10,27,2,33,58,91,151
0131-002,2015,10,27,3,19,41,60,91
0131-002,2015,10,27,4,27,39,66,60
0131-002,2015,10,27,5,37,41,78,66
0131-002,2015,10,27,6,147,107,254,78
0131-002,2015,10,27,7,597,255,852,254
0131-002,2015,10,27,8,1757,885,2642,852
0131-002,2015,10,27,9,1423,1177,2600,2642
0131-002,2015,10,27,10,886,920,1806,2600
0131-002,2015,10,27,11,1024,1017,2041,1806
0131-002,2015,10,27,12,836,922,1758,2041
0131-002,2015,10,27,13,681,827,1508,1758
0131-002,2015,10,27,14,852,883,1735,1508
0131-002,2015,10,27,15,1004,1063,2067,1735
0131-002,2015,10,27,16,900,1131,2031,2067
0131-002,2015,10,27,17,872,1152,2024,2031
0131-002,2015,10,27,18,826,1396,2222,2024
0131-002,2015,10,27,19,894,1310,2204,2222
0131-002,2015,10,27,20,543,912,1455,2204
0131-002,2015,10,27,21,459,802,1261,1455
0131-002,2015,10,27,22,341,466,807,1261
0131-002,2015,10,27,23,237,269,506,807
0131-002,2015,10,27,24,119,151,270,506
0131-002,2015,10,28,1,77,85,162,270
0131-002,2015,10,28,2,35,60,95,162
0131-002,2015,10,28,3,25,37,62,95
0131-002,2015,10,28,4,31,39,70,62
0131-002,2015,10,28,5,59,49,108,70
0131-002,2015,10,28,6,269,128,397,108
0131-002,2015,10,28,7,764,356,1120,397
0131-002,2015,10,28,8,2090,1061,3151,1120
0131-002,2015,10,28,9,1647,1349,2996,3151
0131-002,2015,10,28,10,1050,1069,2119,2996
0131-002,2015,10,28,11,1060,1102,2162,2119
0131-002,2015,10,28,12,944,1005,1949,2162
0131-002,2015,10,28,13,824,866,1690,1949
0131-002,2015,10,28,14,926,1046,1972,1690
0131-002,2015,10,28,15,968,1048,2016,1972
0131-002,2015,10,28,16,852,1109,1961,2016
0131-002,2015,10,28,17,924,1192,2116,1961
0131-002,2015,10,28,18,1000,1727,2727,2116
0131-002,2015,10,28,19,908,1403,2311,2727
0131-002,2015,10,28,20,641,932,1573,2311
0131-002,2015,10,28,21,479,773,1252,1573
0131-002,2015,10,28,22,349,441,790,1252
0131-002,2015,10,28,23,251,279,530,790
0131-002,2015,10,28,24,131,149,280,530
0131-002,2015,10,29,1,73,93,166,280
0131-002,2015,10,29,2,49,49,98,166
0131-002,2015,10,29,3,37,47,84,98
0131-002,2015,10,29,4,31,45,76,84
0131-002,2015,10,29,5,41,49,90,76
0131-002,2015,10,29,6,225,140,365,90
0131-002,2015,10,29,7,858,323,1181,365
0131-002,2015,10,29,8,2209,1053,3262,1181
0131-002,2015,10,29,9,1585,1378,2963,3262
0131-002,2015,10,29,10,978,1017,1995,2963
0131-002,2015,10,29,11,954,1115,2069,1995
0131-002,2015,10,29,12,828,961,1789,2069
0131-002,2015,10,29,13,734,914,1648,1789
0131-002,2015,10,29,14,832,947,1779,1648
0131-002,2015,10,29,15,976,1117,2093,1779
0131-002,2015,10,29,16,888,1038,1926,2093
0131-002,2015,10,29,17,914,1192,2106,1926
0131-002,2015,10,29,18,1006,1707,2713,2106
0131-002,2015,10,29,19,984,1353,2337,2713
0131-002,2015,10,29,20,615,978,1593,2337
0131-002,2015,10,29,21,463,812,1275,1593
0131-002,2015,10,29,22,365,501,866,1275
0131-002,2015,10,29,23,231,246,477,866
0131-002,2015,10,29,24,131,180,311,477
0131-002,2015,10,30,1,61,82,143,311
0131-002,2015,10,30,2,25,51,76,143
0131-002,2015,10,30,3,31,47,78,76
0131-002,2015,10,30,4,31,64,95,78
0131-002,2015,10,30,5,55,43,98,95
0131-002,2015,10,30,6,249,163,412,98
0131-002,2015,10,30,7,886,300,1186,412
0131-002,2015,10,30,8,1988,1053,3041,1186
0131-002,2015,10,30,9,1565,1360,2925,3041
0131-002,2015,10,30,10,964,999,1963,2925
0131-002,2015,10,30,11,980,1048,2028,1963
0131-002,2015,10,30,12,840,1026,1866,2028
0131-002,2015,10,30,13,768,796,1564,1866
0131-002,2015,10,30,14,900,1003,1903,1564
0131-002,2015,10,30,15,864,1134,1998,1903
0131-002,2015,10,30,16,894,1293,2187,1998
0131-002,2015,10,30,17,884,1482,2366,2187
0131-002,2015,10,30,18,1038,1832,2870,2366
0131-002,2015,10,30,19,1144,1675,2819,2870
0131-002,2015,10,30,20,764,1208,1972,2819
0131-002,2015,10,30,21,547,808,1355,1972
0131-002,2015,10,30,22,355,520,875,1355
0131-002,2015,10,30,23,275,313,588,875
0131-002,2015,10,30,24,115,180,295,588
0131-002,2015,10,31,1,107,97,204,295
0131-002,2015,10,31,2,51,103,154,204
0131-002,2015,10,31,3,43,43,86,154
0131-002,2015,10,31,4,25,64,89,86
0131-002,2015,10,31,5,33,60,93,89
0131-002,2015,10,31,6,185,109,294,93
0131-002,2015,10,31,7,561,246,807,294
0131-002,2015,10,31,8,888,630,1518,807
0131-002,2015,10,31,9,902,1144,2046,1518
0131-002,2015,10,31,10,832,1237,2069,2046
0131-002,2015,10,31,11,976,1129,2105,2069
0131-002,2015,10,31,12,1022,1125,2147,2105
0131-002,2015,10,31,13,864,1138,2002,2147
0131-002,2015,10,31,14,758,1036,1794,2002
0131-002,2015,10,31,15,1008,1001,2009,1794
0131-002,2015,10,31,16,890,1111,2001,2009
0131-002,2015,10,31,17,876,1173,2049,2001
0131-002,2015,10,31,18,1038,1380,2418,2049
0131-002,2015,10,31,19,866,1078,1944,2418
0131-002,2015,10,31,20,631,605,1236,1944
0131-002,2015,10,31,21,335,439,774,1236
0131-002,2015,10,31,22,341,254,595,774
0131-002,2015,10,31,23,199,217,416,595
0131-002,2015,10,31,24,95,124,219,416
0131-002,2015,11,1,1,56,67,123,219
0131-002,2015,11,1,2,44,49,93,123
0131-002,2015,11,1,3,35,47,82,93
0131-002,2015,11,1,4,25,36,61,82
0131-002,2015,11,1,5,28,29,57,61
0131-002,2015,11,1,6,71,52,123,57
0131-002,2015,11,1,7,188,130,318,123
0131-002,2015,11,1,8,274,203,477,318
0131-002,2015,11,1,9,329,311,640,477
0131-002,2015,11,1,10,362,416,778,640
0131-002,2015,11,1,11,412,544,956,778
0131-002,2015,11,1,12,491,485,976,956
0131-002,2015,11,1,13,557,479,1036,976
0131-002,2015,11,1,14,546,544,1090,1036
0131-002,2015,11,1,15,668,590,1258,1090
0131-002,2015,11,1,16,790,762,1552,1258
0131-002,2015,11,1,17,920,773,1693,1552
0131-002,2015,11,1,18,1030,857,1887,1693
0131-002,2015,11,1,19,823,562,1385,1887
0131-002,2015,11,1,20,612,388,1000,1385
0131-002,2015,11,1,21,514,339,853,1000
0131-002,2015,11,1,22,374,250,624,853
0131-002,2015,11,1,23,218,140,358,624
0131-002,2015,11,1,24,145,78,223,358
0131-002,2015,11,2,1,47,38,85,223
0131-002,2015,11,2,2,37,24,61,85
0131-002,2015,11,2,3,14,20,34,61
0131-002,2015,11,2,4,14,20,34,34
0131-002,2015,11,2,5,56,33,89,34
0131-002,2015,11,2,6,273,151,424,89
0131-002,2015,11,2,7,901,354,1255,424
0131-002,2015,11,2,8,2307,996,3303,1255
0131-002,2015,11,2,9,1558,1205,2763,3303
0131-002,2015,11,2,10,943,992,1935,2763
0131-002,2015,11,2,11,970,913,1883,1935
0131-002,2015,11,2,12,854,963,1817,1883
0131-002,2015,11,2,13,801,809,1610,1817
0131-002,2015,11,2,14,922,834,1756,1610
0131-002,2015,11,2,15,930,1078,2008,1756
0131-002,2015,11,2,16,928,944,1872,2008
0131-002,2015,11,2,17,916,1117,2033,1872
0131-002,2015,11,2,18,943,1505,2448,2033
0131-002,2015,11,2,19,946,1218,2164,2448
0131-002,2015,11,2,20,536,843,1379,2164
0131-002,2015,11,2,21,436,823,1259,1379
0131-002,2015,11,2,22,345,452,797,1259
0131-002,2015,11,2,23,211,282,493,797
0131-002,2015,11,2,24,100,153,253,493
0131-002,2015,11,3,1,80,88,168,253
0131-002,2015,11,3,2,30,52,82,168
0131-002,2015,11,3,3,33,45,78,82
0131-002,2015,11,3,4,23,26,49,78
0131-002,2015,11,3,5,33,44,77,49
0131-002,2015,11,3,6,229,112,341,77
0131-002,2015,11,3,7,780,304,1084,341
0131-002,2015,11,3,8,1945,978,2923,1084
0131-002,2015,11,3,9,1425,1230,2655,2923
0131-002,2015,11,3,10,1028,1033,2061,2655
0131-002,2015,11,3,11,964,974,1938,2061
0131-002,2015,11,3,12,856,999,1855,1938
0131-002,2015,11,3,13,734,816,1550,1855
0131-002,2015,11,3,14,863,856,1719,1550
0131-002,2015,11,3,15,908,1012,1920,1719
0131-002,2015,11,3,16,910,1031,1941,1920
0131-002,2015,11,3,17,839,979,1818,1941
0131-002,2015,11,3,18,971,1395,2366,1818
0131-002,2015,11,3,19,884,1177,2061,2366
0131-002,2015,11,3,20,582,843,1425,2061
0131-002,2015,11,3,21,428,755,1183,1425
0131-002,2015,11,3,22,357,522,879,1183
0131-002,2015,11,3,23,209,278,487,879
0131-002,2015,11,3,24,130,110,240,487
0131-002,2015,11,4,1,66,101,167,240
0131-002,2015,11,4,2,44,52,96,167
0131-002,2015,11,4,3,37,38,75,96
0131-002,2015,11,4,4,33,27,60,75
0131-002,2015,11,4,5,54,52,106,60
0131-002,2015,11,4,6,185,115,300,106
0131-002,2015,11,4,7,815,318,1133,300
0131-002,2015,11,4,8,1859,961,2820,1133
0131-002,2015,11,4,9,1523,1263,2786,2820
0131-002,2015,11,4,10,867,1022,1889,2786
0131-002,2015,11,4,11,911,983,1894,1889
0131-002,2015,11,4,12,873,852,1725,1894
0131-002,2015,11,4,13,670,775,1445,1725
0131-002,2015,11,4,14,841,793,1634,1445
0131-002,2015,11,4,15,953,1010,1963,1634
0131-002,2015,11,4,16,870,1062,1932,1963
0131-002,2015,11,4,17,786,1223,2009,1932
0131-002,2015,11,4,18,992,1536,2528,2009
0131-002,2015,11,4,19,958,1363,2321,2528
0131-002,2015,11,4,20,605,915,1520,2321
0131-002,2015,11,4,21,476,705,1181,1520
0131-002,2015,11,4,22,321,406,727,1181
0131-002,2015,11,4,23,211,234,445,727
0131-002,2015,11,4,24,130,178,308,445
0131-002,2015,11,5,1,82,101,183,308
0131-002,2015,11,5,2,54,69,123,183
0131-002,2015,11,5,3,47,44,91,123
0131-002,2015,11,5,4,35,44,79,91
0131-002,2015,11,5,5,52,60,112,79
0131-002,2015,11,5,6,276,103,379,112
0131-002,2015,11,5,7,790,327,1117,379
0131-002,2015,11,5,8,1990,1017,3007,1117
0131-002,2015,11,5,9,1528,1261,2789,3007
0131-002,2015,11,5,10,1064,1096,2160,2789
0131-002,2015,11,5,11,946,1006,1952,2160
0131-002,2015,11,5,12,928,902,1830,1952
0131-002,2015,11,5,13,734,770,1504,1830
0131-002,2015,11,5,14,908,917,1825,1504
0131-002,2015,11,5,15,922,972,1894,1825
0131-002,2015,11,5,16,908,927,1835,1894
0131-002,2015,11,5,17,962,911,1873,1835
0131-002,2015,11,5,18,1132,1528,2660,1873
0131-002,2015,11,5,19,1039,1184,2223,2660
0131-002,2015,11,5,20,658,936,1594,2223
0131-002,2015,11,5,21,381,823,1204,1594
0131-002,2015,11,5,22,410,451,861,1204
0131-002,2015,11,5,23,235,307,542,861
0131-002,2015,11,5,24,131,176,307,542
0131-002,2015,11,6,1,66,104,170,307
0131-002,2015,11,6,2,49,52,101,170
0131-002,2015,11,6,3,23,45,68,101
0131-002,2015,11,6,4,32,33,65,68
0131-002,2015,11,6,5,37,24,61,65
0131-002,2015,11,6,6,229,151,380,61
0131-002,2015,11,6,7,863,298,1161,380
0131-002,2015,11,6,8,1944,1024,2968,1161
0131-002,2015,11,6,9,1465,1221,2686,2968
0131-002,2015,11,6,10,1006,1058,2064,2686
0131-002,2015,11,6,11,1027,978,2005,2064
0131-002,2015,11,6,12,873,910,1783,2005
0131-002,2015,11,6,13,780,865,1645,1783
0131-002,2015,11,6,14,911,940,1851,1645
0131-002,2015,11,6,15,928,1196,2124,1851
0131-002,2015,11,6,16,1027,1082,2109,2124
0131-002,2015,11,6,17,927,1044,1971,2109
0131-002,2015,11,6,18,1077,1529,2606,1971
0131-002,2015,11,6,19,1126,1487,2613,2606
0131-002,2015,11,6,20,832,1114,1946,2613
0131-002,2015,11,6,21,581,802,1383,1946
0131-002,2015,11,6,22,369,492,861,1383
0131-002,2015,11,6,23,221,273,494,861
0131-002,2015,11,6,24,111,174,285,494
0131-002,2015,11,7,1,71,108,179,285
0131-002,2015,11,7,2,50,94,144,179
0131-002,2015,11,7,3,37,54,91,144
0131-002,2015,11,7,4,42,45,87,91
0131-002,2015,11,7,5,42,54,96,87
0131-002,2015,11,7,6,90,72,162,96
0131-002,2015,11,7,7,261,185,446,162
0131-002,2015,11,7,8,700,486,1186,446
0131-002,2015,11,7,9,657,712,1369,1186
0131-002,2015,11,7,10,673,806,1479,1369
0131-002,2015,11,7,11,794,903,1697,1479
0131-002,2015,11,7,12,689,793,1482,1697
0131-002,2015,11,7,13,670,890,1560,1482
0131-002,2015,11,7,14,627,822,1449,1560
0131-002,2015,11,7,15,734,856,1590,1449
0131-002,2015,11,7,16,866,771,1637,1590
0131-002,2015,11,7,17,983,886,1869,1637
0131-002,2015,11,7,18,983,913,1896,1869
0131-002,2015,11,7,19,870,696,1566,1896
0131-002,2015,11,7,20,507,373,880,1566
0131-002,2015,11,7,21,305,305,610,880
0131-002,2015,11,7,22,273,208,481,610
0131-002,2015,11,7,23,159,148,307,481
0131-002,2015,11,7,24,102,99,201,307
0131-002,2015,11,8,1,54,61,115,201
0131-002,2015,11,8,2,61,54,115,115
0131-002,2015,11,8,3,19,45,64,115
0131-002,2015,11,8,4,32,42,74,64
0131-002,2015,11,8,5,14,22,36,74
0131-002,2015,11,8,6,37,31,68,36
0131-002,2015,11,8,7,87,52,139,68
0131-002,2015,11,8,8,186,146,332,139
0131-002,2015,11,8,9,199,200,399,332
0131-002,2015,11,8,10,285,347,632,399
0131-002,2015,11,8,11,404,427,831,632
0131-002,2015,11,8,12,458,409,867,831
0131-002,2015,11,8,13,491,463,954,867
0131-002,2015,11,8,14,512,485,997,954
0131-002,2015,11,8,15,584,540,1124,997
0131-002,2015,11,8,16,658,681,1339,1124
0131-002,2015,11,8,17,681,601,1282,1339
0131-002,2015,11,8,18,902,580,1482,1282
0131-002,2015,11,8,19,724,404,1128,1482
0131-002,2015,11,8,20,505,262,767,1128
0131-002,2015,11,8,21,436,269,705,767
0131-002,2015,11,8,22,304,200,504,705
0131-002,2015,11,8,23,192,110,302,504
0131-002,2015,11,8,24,125,79,204,302
0131-002,2015,11,9,1,23,27,50,204
0131-002,2015,11,9,2,20,16,36,50
0131-002,2015,11,9,3,11,16,27,36
0131-002,2015,11,9,4,5,16,21,27
0131-002,2015,11,9,5,17,15,32,21
0131-002,2015,11,9,6,119,73,192,32
0131-002,2015,11,9,7,438,193,631,192
0131-002,2015,11,9,8,2292,1076,3368,631
0131-002,2015,11,9,9,1556,1241,2797,3368
0131-002,2015,11,9,10,982,1056,2038,2797
0131-002,2015,11,9,11,942,1015,1957,2038
0131-002,2015,11,9,12,885,1024,1909,1957
0131-002,2015,11,9,13,703,880,1583,1909
0131-002,2015,11,9,14,924,981,1905,1583
0131-002,2015,11,9,15,1067,1149,2216,1905
0131-002,2015,11,9,16,925,1144,2069,2216
0131-002,2015,11,9,17,907,1180,2087,2069
0131-002,2015,11,9,18,808,1346,2154,2087
0131-002,2015,11,9,19,785,1186,1971,2154
0131-002,2015,11,9,20,554,909,1463,1971
0131-002,2015,11,9,21,446,780,1226,1463
0131-002,2015,11,9,22,401,534,935,1226
0131-002,2015,11,9,23,263,351,614,935
0131-002,2015,11,9,24,183,206,389,614
0131-002,2015,11,10,1,113,151,264,389
0131-002,2015,11,10,2,81,103,184,264
0131-002,2015,11,10,3,88,71,159,184
0131-002,2015,11,10,4,67,74,141,159
0131-002,2015,11,10,5,94,135,229,141
0131-002,2015,11,10,6,290,193,483,229
0131-002,2015,11,10,7,808,412,1220,483
0131-002,2015,11,10,8,1710,924,2634,1220
0131-002,2015,11,10,9,1395,1292,2687,2634
0131-002,2015,11,10,10,1082,1119,2201,2687
0131-002,2015,11,10,11,1116,1138,2254,2201
0131-002,2015,11,10,12,1002,994,1996,2254
0131-002,2015,11,10,13,841,945,1786,1996
0131-002,2015,11,10,14,936,977,1913,1786
0131-002,2015,11,10,15,1111,1160,2271,1913
0131-002,2015,11,10,16,1076,1255,2331,2271
0131-002,2015,11,10,17,748,1258,2006,2331
0131-002,2015,11,10,18,948,1413,2361,2006
0131-002,2015,11,10,19,939,1234,2173,2361
0131-002,2015,11,10,20,673,922,1595,2173
0131-002,2015,11,10,21,560,830,1390,1595
0131-002,2015,11,10,22,474,581,1055,1390
0131-002,2015,11,10,23,332,368,700,1055
0131-002,2015,11,10,24,170,204,374,700
0131-002,2015,11,11,1,133,155,288,374
0131-002,2015,11,11,2,91,82,173,288
0131-002,2015,11,11,3,59,84,143,173
0131-002,2015,11,11,4,80,76,156,143
0131-002,2015,11,11,5,97,112,209,156
0131-002,2015,11,11,6,258,186,444,209
0131-002,2015,11,11,7,707,436,1143,444
0131-002,2015,11,11,8,1711,960,2671,1143
0131-002,2015,11,11,9,1389,1215,2604,2671
0131-002,2015,11,11,10,1047,1107,2154,2604
0131-002,2015,11,11,11,1036,1106,2142,2154
0131-002,2015,11,11,12,1019,1019,2038,2142
0131-002,2015,11,11,13,864,970,1834,2038
0131-002,2015,11,11,14,1064,1014,2078,1834
0131-002,2015,11,11,15,1060,1138,2198,2078
0131-002,2015,11,11,16,1088,1124,2212,2198
0131-002,2015,11,11,17,949,1242,2191,2212
0131-002,2015,11,11,18,1042,1559,2601,2191
0131-002,2015,11,11,19,1014,1336,2350,2601
0131-002,2015,11,11,20,668,917,1585,2350
0131-002,2015,11,11,21,553,788,1341,1585
0131-002,2015,11,11,22,479,581,1060,1341
0131-002,2015,11,11,23,342,358,700,1060
0131-002,2015,11,11,24,250,232,482,700
0131-002,2015,11,12,1,132,164,296,482
0131-002,2015,11,12,2,111,109,220,296
0131-002,2015,11,12,3,61,67,128,220
0131-002,2015,11,12,4,44,79,123,128
0131-002,2015,11,12,5,87,120,207,123
0131-002,2015,11,12,6,259,199,458,207
0131-002,2015,11,12,7,828,441,1269,458
0131-002,2015,11,12,8,1713,937,2650,1269
0131-002,2015,11,12,9,1372,1210,2582,2650
0131-002,2015,11,12,10,1141,1116,2257,2582
0131-002,2015,11,12,11,993,1081,2074,2257
0131-002,2015,11,12,12,1001,1080,2081,2074
0131-002,2015,11,12,13,796,902,1698,2081
0131-002,2015,11,12,14,1025,961,1986,1698
0131-002,2015,11,12,15,995,1130,2125,1986
0131-002,2015,11,12,16,960,1219,2179,2125
0131-002,2015,11,12,17,842,1251,2093,2179
0131-002,2015,11,12,18,1026,1448,2474,2093
0131-002,2015,11,12,19,1005,1211,2216,2474
0131-002,2015,11,12,20,705,926,1631,2216
0131-002,2015,11,12,21,558,780,1338,1631
0131-002,2015,11,12,22,438,567,1005,1338
0131-002,2015,11,12,23,326,378,704,1005
0131-002,2015,11,12,24,209,242,451,704
0131-002,2015,11,13,1,132,145,277,451
0131-002,2015,11,13,2,93,98,191,277
0131-002,2015,11,13,3,71,84,155,191
0131-002,2015,11,13,4,79,81,160,155
0131-002,2015,11,13,5,112,134,246,160
0131-002,2015,11,13,6,315,204,519,246
0131-002,2015,11,13,7,775,428,1203,519
0131-002,2015,11,13,8,1552,958,2510,1203
0131-002,2015,11,13,9,1343,1216,2559,2510
0131-002,2015,11,13,10,1081,1111,2192,2559
0131-002,2015,11,13,11,1052,1092,2144,2192
0131-002,2015,11,13,12,963,1123,2086,2144
0131-002,2015,11,13,13,875,1015,1890,2086
0131-002,2015,11,13,14,882,1094,1976,1890
0131-002,2015,11,13,15,984,1120,2104,1976
0131-002,2015,11,13,16,934,1171,2105,2104
0131-002,2015,11,13,17,942,1198,2140,2105
0131-002,2015,11,13,18,1106,1485,2591,2140
0131-002,2015,11,13,19,1122,1373,2495,2591
0131-002,2015,11,13,20,864,1005,1869,2495
0131-002,2015,11,13,21,472,868,1340,1869
0131-002,2015,11,13,22,396,528,924,1340
0131-002,2015,11,13,23,310,343,653,924
0131-002,2015,11,13,24,233,249,482,653
0131-002,2015,11,14,1,173,174,347,482
0131-002,2015,11,14,2,99,134,233,347
0131-002,2015,11,14,3,89,106,195,233
0131-002,2015,11,14,4,63,83,146,195
0131-002,2015,11,14,5,93,89,182,146
0131-002,2015,11,14,6,176,137,313,182
0131-002,2015,11,14,7,409,295,704,313
0131-002,2015,11,14,8,723,560,1283,704
0131-002,2015,11,14,9,784,907,1691,1283
0131-002,2015,11,14,10,804,983,1787,1691
0131-002,2015,11,14,11,907,1172,2079,1787
0131-002,2015,11,14,12,914,1298,2212,2079
0131-002,2015,11,14,13,864,1169,2033,2212
0131-002,2015,11,14,14,855,1084,1939,2033
0131-002,2015,11,14,15,858,1185,2043,1939
0131-002,2015,11,14,16,939,1131,2070,2043
0131-002,2015,11,14,17,1031,1207,2238,2070
0131-002,2015,11,14,18,1116,1275,2391,2238
0131-002,2015,11,14,19,1000,930,1930,2391
0131-002,2015,11,14,20,717,586,1303,1930
0131-002,2015,11,14,21,426,488,914,1303
0131-002,2015,11,14,22,283,384,667,914
0131-002,2015,11,14,23,231,248,479,667
0131-002,2015,11,14,24,162,163,325,479
0131-002,2015,11,15,1,116,136,252,325
0131-002,2015,11,15,2,101,111,212,252
0131-002,2015,11,15,3,66,93,159,212
0131-002,2015,11,15,4,63,56,119,159
0131-002,2015,11,15,5,65,65,130,119
0131-002,2015,11,15,6,105,95,200,130
0131-002,2015,11,15,7,249,197,446,200
0131-002,2015,11,15,8,340,286,626,446
0131-002,2015,11,15,9,264,475,739,626
0131-002,2015,11,15,10,324,626,950,739
0131-002,2015,11,15,11,408,672,1080,950
0131-002,2015,11,15,12,474,728,1202,1080
0131-002,2015,11,15,13,524,696,1220,1202
0131-002,2015,11,15,14,529,736,1265,1220
0131-002,2015,11,15,15,626,759,1385,1265
0131-002,2015,11,15,16,724,849,1573,1385
0131-002,2015,11,15,17,800,974,1774,1573
0131-002,2015,11,15,18,966,971,1937,1774
0131-002,2015,11,15,19,774,761,1535,1937
0131-002,2015,11,15,20,558,586,1144,1535
0131-002,2015,11,15,21,475,529,1004,1144
0131-002,2015,11,15,22,339,370,709,1004
0131-002,2015,11,15,23,205,238,443,709
0131-002,2015,11,15,24,135,154,289,443
0131-002,2015,11,16,1,103,117,220,289
0131-002,2015,11,16,2,48,54,102,220
0131-002,2015,11,16,3,52,63,115,102
0131-002,2015,11,16,4,33,59,92,115
0131-002,2015,11,16,5,67,77,144,92
0131-002,2015,11,16,6,298,183,481,144
0131-002,2015,11,16,7,797,477,1274,481
0131-002,2015,11,16,8,1770,957,2727,1274
0131-002,2015,11,16,9,1270,1215,2485,2727
0131-002,2015,11,16,10,1042,1111,2153,2485
0131-002,2015,11,16,11,963,1079,2042,2153
0131-002,2015,11,16,12,834,1029,1863,2042
0131-002,2015,11,16,13,769,899,1668,1863
0131-002,2015,11,16,14,732,997,1729,1668
0131-002,2015,11,16,15,904,1183,2087,1729
0131-002,2015,11,16,16,901,1205,2106,2087
0131-002,2015,11,16,17,1019,1180,2199,2106
0131-002,2015,11,16,18,863,1291,2154,2199
0131-002,2015,11,16,19,904,1175,2079,2154
0131-002,2015,11,16,20,683,893,1576,2079
0131-002,2015,11,16,21,476,823,1299,1576
0131-002,2015,11,16,22,403,536,939,1299
0131-002,2015,11,16,23,279,326,605,939
0131-002,2015,11,16,24,185,199,384,605
0131-002,2015,11,17,1,135,132,267,384
0131-002,2015,11,17,2,82,100,182,267
0131-002,2015,11,17,3,76,81,157,182
0131-002,2015,11,17,4,60,64,124,157
0131-002,2015,11,17,5,72,93,165,124
0131-002,2015,11,17,6,241,187,428,165
0131-002,2015,11,17,7,725,378,1103,428
0131-002,2015,11,17,8,1621,980,2601,1103
0131-002,2015,11,17,9,1403,1231,2634,2601
0131-002,2015,11,17,10,1087,1090,2177,2634
0131-002,2015,11,17,11,996,1127,2123,2177
0131-002,2015,11,17,12,827,1101,1928,2123
0131-002,2015,11,17,13,793,910,1703,1928
0131-002,2015,11,17,14,994,955,1949,1703
0131-002,2015,11,17,15,993,1111,2104,1949
0131-002,2015,11,17,16,837,1167,2004,2104
0131-002,2015,11,17,17,686,1256,1942,2004
0131-002,2015,11,17,18,689,1372,2061,1942
0131-002,2015,11,17,19,787,1208,1995,2061
0131-002,2015,11,17,20,622,943,1565,1995
0131-002,2015,11,17,21,419,854,1273,1565
0131-002,2015,11,17,22,424,575,999,1273
0131-002,2015,11,17,23,348,361,709,999
0131-002,2015,11,17,24,242,224,466,709
0131-002,2015,11,18,1,126,160,286,466
0131-002,2015,11,18,2,103,105,208,286
0131-002,2015,11,18,3,80,94,174,208
0131-002,2015,11,18,4,65,88,153,174
0131-002,2015,11,18,5,107,113,220,153
0131-002,2015,11,18,6,281,202,483,220
0131-002,2015,11,18,7,777,401,1178,483
0131-002,2015,11,18,8,1489,932,2421,1178
0131-002,2015,11,18,9,1326,1215,2541,2421
0131-002,2015,11,18,10,988,1022,2010,2541
0131-002,2015,11,18,11,1003,1077,2080,2010
0131-002,2015,11,18,12,976,1087,2063,2080
0131-002,2015,11,18,13,815,914,1729,2063
0131-002,2015,11,18,14,766,996,1762,1729
0131-002,2015,11,18,15,883,1170,2053,1762
0131-002,2015,11,18,16,911,1148,2059,2053
0131-002,2015,11,18,17,874,1244,2118,2059
0131-002,2015,11,18,18,1002,1351,2353,2118
0131-002,2015,11,18,19,907,1222,2129,2353
0131-002,2015,11,18,20,576,900,1476,2129
0131-002,2015,11,18,21,416,725,1141,1476
0131-002,2015,11,18,22,338,515,853,1141
0131-002,2015,11,18,23,207,333,540,853
0131-002,2015,11,18,24,159,226,385,540
0131-002,2015,11,19,1,100,179,279,385
0131-002,2015,11,19,2,65,99,164,279
0131-002,2015,11,19,3,63,66,129,164
0131-002,2015,11,19,4,56,85,141,129
0131-002,2015,11,19,5,111,109,220,141
0131-002,2015,11,19,6,309,192,501,220
0131-002,2015,11,19,7,793,398,1191,501
0131-002,2015,11,19,8,1574,944,2518,1191
0131-002,2015,11,19,9,1454,1235,2689,2518
0131-002,2015,11,19,10,1059,1104,2163,2689
0131-002,2015,11,19,11,1175,1067,2242,2163
0131-002,2015,11,19,12,965,1038,2003,2242
0131-002,2015,11,19,13,860,972,1832,2003
0131-002,2015,11,19,14,1000,1012,2012,1832
0131-002,2015,11,19,15,1033,1166,2199,2012
0131-002,2015,11,19,16,970,1173,2143,2199
0131-002,2015,11,19,17,1009,1191,2200,2143
0131-002,2015,11,19,18,1050,1485,2535,2200
0131-002,2015,11,19,19,968,1166,2134,2535
0131-002,2015,11,19,20,679,888,1567,2134
0131-002,2015,11,19,21,530,814,1344,1567
0131-002,2015,11,19,22,413,539,952,1344
0131-002,2015,11,19,23,263,347,610,952
0131-002,2015,11,19,24,183,279,462,610
0131-002,2015,11,20,1,132,171,303,462
0131-002,2015,11,20,2,66,106,172,303
0131-002,2015,11,20,3,52,74,126,172
0131-002,2015,11,20,4,62,85,147,126
0131-002,2015,11,20,5,107,102,209,147
0131-002,2015,11,20,6,295,184,479,209
0131-002,2015,11,20,7,798,415,1213,479
0131-002,2015,11,20,8,1624,963,2587,1213
0131-002,2015,11,20,9,1452,1213,2665,2587
0131-002,2015,11,20,10,1067,1089,2156,2665
0131-002,2015,11,20,11,1075,1153,2228,2156
0131-002,2015,11,20,12,1061,1040,2101,2228
0131-002,2015,11,20,13,877,977,1854,2101
0131-002,2015,11,20,14,1001,997,1998,1854
0131-002,2015,11,20,15,1016,1192,2208,1998
0131-002,2015,11,20,16,1107,1221,2328,2208
0131-002,2015,11,20,17,1034,1389,2423,2328
0131-002,2015,11,20,18,1166,1720,2886,2423
0131-002,2015,11,20,19,1122,1588,2710,2886
0131-002,2015,11,20,20,889,1109,1998,2710
0131-002,2015,11,20,21,619,948,1567,1998
0131-002,2015,11,20,22,517,662,1179,1567
0131-002,2015,11,20,23,367,392,759,1179
0131-002,2015,11,20,24,227,277,504,759
0131-002,2015,11,21,1,190,187,377,504
0131-002,2015,11,21,2,145,128,273,377
0131-002,2015,11,21,3,81,98,179,273
0131-002,2015,11,21,4,79,83,162,179
0131-002,2015,11,21,5,96,102,198,162
0131-002,2015,11,21,6,277,179,456,198
0131-002,2015,11,21,7,565,356,921,456
0131-002,2015,11,21,8,876,685,1561,921
0131-002,2015,11,21,9,1037,1014,2051,1561
0131-002,2015,11,21,10,873,1146,2019,2051
0131-002,2015,11,21,11,1040,1143,2183,2019
0131-002,2015,11,21,12,978,1357,2335,2183
0131-002,2015,11,21,13,1111,1234,2345,2335
0131-002,2015,11,21,14,975,1067,2042,2345
0131-002,2015,11,21,15,1031,1221,2252,2042
0131-002,2015,11,21,16,998,1219,2217,2252
0131-002,2015,11,21,17,1120,1239,2359,2217
0131-002,2015,11,21,18,1225,1350,2575,2359
0131-002,2015,11,21,19,1174,1037,2211,2575
0131-002,2015,11,21,20,1013,701,1714,2211
0131-002,2015,11,21,21,667,542,1209,1714
0131-002,2015,11,21,22,489,369,858,1209
0131-002,2015,11,21,23,251,282,533,858
0131-002,2015,11,21,24,173,237,410,533
0131-002,2015,11,22,1,147,127,274,410
0131-002,2015,11,22,2,79,122,201,274
0131-002,2015,11,22,3,65,69,134,201
0131-002,2015,11,22,4,62,67,129,134
0131-002,2015,11,22,5,68,60,128,129
0131-002,2015,11,22,6,167,103,270,128
0131-002,2015,11,22,7,293,183,476,270
0131-002,2015,11,22,8,421,304,725,476
0131-002,2015,11,22,9,477,453,930,725
0131-002,2015,11,22,10,511,603,1114,930
0131-002,2015,11,22,11,547,616,1163,1114
0131-002,2015,11,22,12,619,633,1252,1163
0131-002,2015,11,22,13,712,642,1354,1252
0131-002,2015,11,22,14,819,690,1509,1354
0131-002,2015,11,22,15,985,847,1832,1509
0131-002,2015,11,22,16,1135,823,1958,1832
0131-002,2015,11,22,17,1193,905,2098,1958
0131-002,2015,11,22,18,1106,943,2049,2098
0131-002,2015,11,22,19,1117,834,1951,2049
0131-002,2015,11,22,20,1107,614,1721,1951
0131-002,2015,11,22,21,1074,500,1574,1721
0131-002,2015,11,22,22,962,396,1358,1574
0131-002,2015,11,22,23,607,287,894,1358
0131-002,2015,11,22,24,335,148,483,894
0131-002,2015,11,23,1,58,111,169,483
0131-002,2015,11,23,2,41,84,125,169
0131-002,2015,11,23,3,39,59,98,125
0131-002,2015,11,23,4,23,66,89,98
0131-002,2015,11,23,5,87,92,179,89
0131-002,2015,11,23,6,222,155,377,179
0131-002,2015,11,23,7,733,363,1096,377
0131-002,2015,11,23,8,1466,919,2385,1096
0131-002,2015,11,23,9,1413,1187,2600,2385
0131-002,2015,11,23,10,1012,1085,2097,2600
0131-002,2015,11,23,11,952,1044,1996,2097
0131-002,2015,11,23,12,860,1010,1870,1996
0131-002,2015,11,23,13,736,844,1580,1870
0131-002,2015,11,23,14,828,900,1728,1580
0131-002,2015,11,23,15,986,1114,2100,1728
0131-002,2015,11,23,16,913,1115,2028,2100
0131-002,2015,11,23,17,963,1162,2125,2028
0131-002,2015,11,23,18,836,1318,2154,2125
0131-002,2015,11,23,19,844,1154,1998,2154
0131-002,2015,11,23,20,618,867,1485,1998
0131-002,2015,11,23,21,461,831,1292,1485
0131-002,2015,11,23,22,402,577,979,1292
0131-002,2015,11,23,23,272,359,631,979
0131-002,2015,11,23,24,195,209,404,631
0131-002,2015,11,24,1,129,141,270,404
0131-002,2015,11,24,2,71,101,172,270
0131-002,2015,11,24,3,53,89,142,172
0131-002,2015,11,24,4,58,69,127,142
0131-002,2015,11,24,5,100,95,195,127
0131-002,2015,11,24,6,230,180,410,195
0131-002,2015,11,24,7,579,420,999,410
0131-002,2015,11,24,8,1472,1016,2488,999
0131-002,2015,11,24,9,1386,1214,2600,2488
0131-002,2015,11,24,10,1017,1091,2108,2600
0131-002,2015,11,24,11,1042,1136,2178,2108
0131-002,2015,11,24,12,994,1060,2054,2178
0131-002,2015,11,24,13,866,890,1756,2054
0131-002,2015,11,24,14,1010,1059,2069,1756
0131-002,2015,11,24,15,1054,1177,2231,2069
0131-002,2015,11,24,16,1064,1097,2161,2231
0131-002,2015,11,24,17,916,1230,2146,2161
0131-002,2015,11,24,18,1026,1423,2449,2146
0131-002,2015,11,24,19,925,1267,2192,2449
0131-002,2015,11,24,20,623,876,1499,2192
0131-002,2015,11,24,21,445,805,1250,1499
0131-002,2015,11,24,22,407,620,1027,1250
0131-002,2015,11,24,23,304,362,666,1027
0131-002,2015,11,24,24,72,201,273,666
0131-002,2015,11,25,1,31,142,173,273
0131-002,2015,11,25,2,24,102,126,173
0131-002,2015,11,25,3,16,77,93,126
0131-002,2015,11,25,4,12,76,88,93
0131-002,2015,11,25,5,18,105,123,88
0131-002,2015,11,25,6,68,164,232,123
0131-002,2015,11,25,7,437,329,766,232
0131-002,2015,11,25,8,1600,953,2553,766
0131-002,2015,11,25,9,1358,1185,2543,2553
0131-002,2015,11,25,10,1018,1004,2022,2543
0131-002,2015,11,25,11,1020,1031,2051,2022
0131-002,2015,11,25,12,998,993,1991,2051
0131-002,2015,11,25,13,840,887,1727,1991
0131-002,2015,11,25,14,915,914,1829,1727
0131-002,2015,11,25,15,972,1127,2099,1829
0131-002,2015,11,25,16,1000,1135,2135,2099
0131-002,2015,11,25,17,912,1179,2091,2135
0131-002,2015,11,25,18,1022,1304,2326,2091
0131-002,2015,11,25,19,960,1142,2102,2326
0131-002,2015,11,25,20,622,837,1459,2102
0131-002,2015,11,25,21,484,755,1239,1459
0131-002,2015,11,25,22,408,558,966,1239
0131-002,2015,11,25,23,274,308,582,966
0131-002,2015,11,25,24,204,193,397,582
0131-002,2015,11,26,1,93,140,233,397
0131-002,2015,11,26,2,96,110,206,233
0131-002,2015,11,26,3,49,71,120,206
0131-002,2015,11,26,4,53,78,131,120
0131-002,2015,11,26,5,70,89,159,131
0131-002,2015,11,26,6,177,134,311,159
0131-002,2015,11,26,7,259,230,489,311
0131-002,2015,11,26,8,453,559,1012,489
0131-002,2015,11,26,9,550,749,1299,1012
0131-002,2015,11,26,10,1100,936,2036,1299
0131-002,2015,11,26,11,1084,788,1872,2036
0131-002,2015,11,26,12,983,915,1898,1872
0131-002,2015,11,26,13,828,886,1714,1898
0131-002,2015,11,26,14,1012,1000,2012,1714
0131-002,2015,11,26,15,1014,1058,2072,2012
0131-002,2015,11,26,16,965,1062,2027,2072
0131-002,2015,11,26,17,926,1035,1961,2027
0131-002,2015,11,26,18,1038,1106,2144,1961
0131-002,2015,11,26,19,986,948,1934,2144
0131-002,2015,11,26,20,692,641,1333,1934
0131-002,2015,11,26,21,544,565,1109,1333
0131-002,2015,11,26,22,426,383,809,1109
0131-002,2015,11,26,23,294,216,510,809
0131-002,2015,11,26,24,196,141,337,510
0131-002,2015,11,27,1,18,104,122,337
0131-002,2015,11,27,2,9,90,99,122
0131-002,2015,11,27,3,12,62,74,99
0131-002,2015,11,27,4,10,78,88,74
0131-002,2015,11,27,5,9,72,81,88
0131-002,2015,11,27,6,68,135,203,81
0131-002,2015,11,27,7,229,268,497,203
0131-002,2015,11,27,8,1588,811,2399,497
0131-002,2015,11,27,9,1398,900,2298,2399
0131-002,2015,11,27,10,1074,950,2024,2298
0131-002,2015,11,27,11,1064,957,2021,2024
0131-002,2015,11,27,12,1012,1067,2079,2021
0131-002,2015,11,27,13,876,933,1809,2079
0131-002,2015,11,27,14,942,1081,2023,1809
0131-002,2015,11,27,15,1000,1170,2170,2023
0131-002,2015,11,27,16,1020,1142,2162,2170
0131-002,2015,11,27,17,988,1201,2189,2162
0131-002,2015,11,27,18,1136,1405,2541,2189
0131-002,2015,11,27,19,1122,1364,2486,2541
0131-002,2015,11,27,20,876,954,1830,2486
0131-002,2015,11,27,21,546,628,1174,1830
0131-002,2015,11,27,22,456,449,905,1174
0131-002,2015,11,27,23,338,287,625,905
0131-002,2015,11,27,24,230,215,445,625
0131-002,2015,11,28,1,182,138,320,445
0131-002,2015,11,28,2,122,111,233,320
0131-002,2015,11,28,3,85,75,160,233
0131-002,2015,11,28,4,71,72,143,160
0131-002,2015,11,28,5,94,99,193,143
0131-002,2015,11,28,6,226,158,384,193
0131-002,2015,11,28,7,487,326,813,384
0131-002,2015,11,28,8,800,622,1422,813
0131-002,2015,11,28,9,910,960,1870,1422
0131-002,2015,11,28,10,838,1064,1902,1870
0131-002,2015,11,28,11,974,1158,2132,1902
0131-002,2015,11,28,12,946,1328,2274,2132
0131-002,2015,11,28,13,988,1202,2190,2274
0131-002,2015,11,28,14,915,1076,1991,2190
0131-002,2015,11,28,15,944,1203,2147,1991
0131-002,2015,11,28,16,968,1175,2143,2147
0131-002,2015,11,28,17,1076,1223,2299,2143
0131-002,2015,11,28,18,1170,1312,2482,2299
0131-002,2015,11,28,19,1087,984,2071,2482
0131-002,2015,11,28,20,865,644,1509,2071
0131-002,2015,11,28,21,546,515,1061,1509
0131-002,2015,11,28,22,386,376,762,1061
0131-002,2015,11,28,23,241,246,487,762
0131-002,2015,11,28,24,168,169,337,487
0131-002,2015,11,29,1,132,110,242,337
0131-002,2015,11,29,2,90,63,153,242
0131-002,2015,11,29,3,66,54,120,153
0131-002,2015,11,29,4,62,63,125,120
0131-002,2015,11,29,5,66,62,128,125
0131-002,2015,11,29,6,136,99,235,128
0131-002,2015,11,29,7,271,190,461,235
0131-002,2015,11,29,8,380,295,675,461
0131-002,2015,11,29,9,370,464,834,675
0131-002,2015,11,29,10,418,614,1032,834
0131-002,2015,11,29,11,478,644,1122,1032
0131-002,2015,11,29,12,546,680,1226,1122
0131-002,2015,11,29,13,618,669,1287,1226
0131-002,2015,11,29,14,674,713,1387,1287
0131-002,2015,11,29,15,806,803,1609,1387
0131-002,2015,11,29,16,930,836,1766,1609
0131-002,2015,11,29,17,996,940,1936,1766
0131-002,2015,11,29,18,1036,957,1993,1936
0131-002,2015,11,29,19,946,798,1744,1993
0131-002,2015,11,29,20,832,600,1432,1744
0131-002,2015,11,29,21,774,514,1288,1432
0131-002,2015,11,29,22,650,383,1033,1288
0131-002,2015,11,29,23,406,262,668,1033
0131-002,2015,11,29,24,235,151,386,668
0131-002,2015,11,30,1,46,77,123,386
0131-002,2015,11,30,2,15,53,68,123
0131-002,2015,11,30,3,5,43,48,68
0131-002,2015,11,30,4,10,56,66,48
0131-002,2015,11,30,5,24,78,102,66
0131-002,2015,11,30,6,135,160,295,102
0131-002,2015,11,30,7,423,406,829,295
0131-002,2015,11,30,8,1618,981,2599,829
0131-002,2015,11,30,9,1342,1133,2475,2599
0131-002,2015,11,30,10,1027,971,1998,2475
0131-002,2015,11,30,11,958,1052,2010,1998
0131-002,2015,11,30,12,847,1022,1869,2010
0131-002,2015,11,30,13,752,707,1459,1869
0131-002,2015,11,30,14,780,888,1668,1459
0131-002,2015,11,30,15,945,954,1899,1668
0131-002,2015,11,30,16,907,981,1888,1899
0131-002,2015,11,30,17,991,1044,2035,1888
0131-002,2015,11,30,18,850,1182,2032,2035
0131-002,2015,11,30,19,874,1007,1881,2032
0131-002,2015,11,30,20,650,554,1204,1881
0131-002,2015,11,30,21,468,739,1207,1204
0131-002,2015,11,30,22,424,464,888,1207
0131-002,2015,11,30,23,303,340,643,888
0131-002,2015,11,30,24,211,231,442,643
0131-002,2015,12,1,1,117,133,250,442
0131-002,2015,12,1,2,113,78,191,250
0131-002,2015,12,1,3,88,73,161,191
0131-002,2015,12,1,4,73,71,144,161
0131-002,2015,12,1,5,100,99,199,144
0131-002,2015,12,1,6,304,144,448,199
0131-002,2015,12,1,7,742,363,1105,448
0131-002,2015,12,1,8,1618,843,2461,1105
0131-002,2015,12,1,9,1314,1044,2358,2461
0131-002,2015,12,1,10,858,893,1751,2358
0131-002,2015,12,1,11,887,892,1779,1751
0131-002,2015,12,1,12,883,877,1760,1779
0131-002,2015,12,1,13,818,781,1599,1760
0131-002,2015,12,1,14,828,898,1726,1599
0131-002,2015,12,1,15,941,981,1922,1726
0131-002,2015,12,1,16,1049,1023,2072,1922
0131-002,2015,12,1,17,980,1073,2053,2072
0131-002,2015,12,1,18,1022,1184,2206,2053
0131-002,2015,12,1,19,883,998,1881,2206
0131-002,2015,12,1,20,632,809,1441,1881
0131-002,2015,12,1,21,510,687,1197,1441
0131-002,2015,12,1,22,434,520,954,1197
0131-002,2015,12,1,23,277,309,586,954
0131-002,2015,12,1,24,203,180,383,586
0131-002,2015,12,2,1,149,132,281,383
0131-002,2015,12,2,2,111,94,205,281
0131-002,2015,12,2,3,88,63,151,205
0131-002,2015,12,2,4,64,87,151,151
0131-002,2015,12,2,5,107,87,194,151
0131-002,2015,12,2,6,275,170,445,194
0131-002,2015,12,2,7,671,337,1008,445
0131-002,2015,12,2,8,1604,776,2380,1008
0131-002,2015,12,2,9,1272,852,2124,2380
0131-002,2015,12,2,10,1064,693,1757,2124
0131-002,2015,12,2,11,838,738,1576,1757
0131-002,2015,12,2,12,963,755,1718,1576
0131-002,2015,12,2,13,846,781,1627,1718
0131-002,2015,12,2,14,898,899,1797,1627
0131-002,2015,12,2,15,941,1027,1968,1797
0131-002,2015,12,2,16,998,886,1884,1968
0131-002,2015,12,2,17,967,793,1760,1884
0131-002,2015,12,2,18,962,758,1720,1760
0131-002,2015,12,2,19,815,822,1637,1720
0131-002,2015,12,2,20,588,723,1311,1637
0131-002,2015,12,2,21,489,672,1161,1311
0131-002,2015,12,2,22,433,445,878,1161
0131-002,2015,12,2,23,284,300,584,878
0131-002,2015,12,2,24,220,210,430,584
0131-002,2015,12,3,1,117,134,251,430
0131-002,2015,12,3,2,121,100,221,251
0131-002,2015,12,3,3,73,78,151,221
0131-002,2015,12,3,4,74,97,171,151
0131-002,2015,12,3,5,52,85,137,171
0131-002,2015,12,3,6,73,130,203,137
0131-002,2015,12,3,7,253,267,520,203
0131-002,2015,12,3,8,759,594,1353,520
0131-002,2015,12,3,9,941,817,1758,1353
0131-002,2015,12,3,10,1086,854,1940,1758
0131-002,2015,12,3,11,899,900,1799,1940
0131-002,2015,12,3,12,827,846,1673,1799
0131-002,2015,12,3,13,670,728,1398,1673
0131-002,2015,12,3,14,815,809,1624,1398
0131-002,2015,12,3,15,804,877,1681,1624
0131-002,2015,12,3,16,676,769,1445,1681
0131-002,2015,12,3,17,968,788,1756,1445
0131-002,2015,12,3,18,1044,672,1716,1756
0131-002,2015,12,3,19,977,636,1613,1716
0131-002,2015,12,3,20,686,501,1187,1613
0131-002,2015,12,3,21,537,382,919,1187
0131-002,2015,12,3,22,420,266,686,919
0131-002,2015,12,3,23,278,190,468,686
0131-002,2015,12,3,24,190,104,294,468
0131-002,2015,12,4,1,75,91,166,294
0131-002,2015,12,4,2,38,65,103,166
0131-002,2015,12,4,3,32,67,99,103
0131-002,2015,12,4,4,36,61,97,99
0131-002,2015,12,4,5,58,93,151,97
0131-002,2015,12,4,6,182,113,295,151
0131-002,2015,12,4,7,514,255,769,295
0131-002,2015,12,4,8,1606,528,2134,769
0131-002,2015,12,4,9,1425,560,1985,2134
0131-002,2015,12,4,10,1070,631,1701,1985
0131-002,2015,12,4,11,1070,750,1820,1701
0131-002,2015,12,4,12,1036,765,1801,1820
0131-002,2015,12,4,13,876,730,1606,1801
0131-002,2015,12,4,14,972,838,1810,1606
0131-002,2015,12,4,15,1008,943,1951,1810
0131-002,2015,12,4,16,1064,879,1943,1951
0131-002,2015,12,4,17,1011,845,1856,1943
0131-002,2015,12,4,18,1151,888,2039,1856
0131-002,2015,12,4,19,1122,819,1941,2039
0131-002,2015,12,4,20,882,650,1532,1941
0131-002,2015,12,4,21,582,560,1142,1532
0131-002,2015,12,4,22,486,412,898,1142
0131-002,2015,12,4,23,352,266,618,898
0131-002,2015,12,4,24,228,195,423,618
0131-002,2015,12,5,1,42,179,221,423
0131-002,2015,12,5,2,24,113,137,221
0131-002,2015,12,5,3,26,85,111,137
0131-002,2015,12,5,4,19,73,92,111
0131-002,2015,12,5,5,21,90,111,92
0131-002,2015,12,5,6,63,147,210,111
0131-002,2015,12,5,7,176,259,435,210
0131-002,2015,12,5,8,838,507,1345,435
0131-002,2015,12,5,9,974,787,1761,1345
0131-002,2015,12,5,10,856,880,1736,1761
0131-002,2015,12,5,11,1007,849,1856,1736
0131-002,2015,12,5,12,962,959,1921,1856
0131-002,2015,12,5,13,1050,946,1996,1921
0131-002,2015,12,5,14,945,966,1911,1996
0131-002,2015,12,5,15,988,875,1863,1911
0131-002,2015,12,5,16,983,989,1972,1863
0131-002,2015,12,5,17,1098,1098,2196,1972
0131-002,2015,12,5,18,1198,1197,2395,2196
0131-002,2015,12,5,19,1007,807,1814,2395
0131-002,2015,12,5,20,722,488,1210,1814
0131-002,2015,12,5,21,494,413,907,1210
0131-002,2015,12,5,22,379,323,702,907
0131-002,2015,12,5,23,286,256,542,702
0131-002,2015,12,5,24,198,191,389,542
0131-002,2015,12,6,1,147,136,283,389
0131-002,2015,12,6,2,111,120,231,283
0131-002,2015,12,6,3,101,95,196,231
0131-002,2015,12,6,4,68,60,128,196
0131-002,2015,12,6,5,68,67,135,128
0131-002,2015,12,6,6,140,86,226,135
0131-002,2015,12,6,7,324,144,468,226
0131-002,2015,12,6,8,334,277,611,468
0131-002,2015,12,6,9,417,446,863,611
0131-002,2015,12,6,10,424,528,952,863
0131-002,2015,12,6,11,493,542,1035,952
0131-002,2015,12,6,12,624,582,1206,1035
0131-002,2015,12,6,13,623,664,1287,1206
0131-002,2015,12,6,14,683,596,1279,1287
0131-002,2015,12,6,15,798,717,1515,1279
0131-002,2015,12,6,16,919,706,1625,1515
0131-002,2015,12,6,17,953,763,1716,1625
0131-002,2015,12,6,18,1068,771,1839,1716
0131-002,2015,12,6,19,996,550,1546,1839
0131-002,2015,12,6,20,787,441,1228,1546
0131-002,2015,12,6,21,632,368,1000,1228
0131-002,2015,12,6,22,467,337,804,1000
0131-002,2015,12,6,23,297,203,500,804
0131-002,2015,12,6,24,202,155,357,500
0131-002,2015,12,7,1,158,89,247,357
0131-002,2015,12,7,2,95,69,164,247
0131-002,2015,12,7,3,76,52,128,164
0131-002,2015,12,7,4,92,61,153,128
0131-002,2015,12,7,5,163,89,252,153
0131-002,2015,12,7,6,355,150,505,252
0131-002,2015,12,7,7,949,411,1360,505
0131-002,2015,12,7,8,1776,888,2664,1360
0131-002,2015,12,7,9,1472,1006,2478,2664
0131-002,2015,12,7,10,1040,854,1894,2478
0131-002,2015,12,7,11,966,900,1866,1894
0131-002,2015,12,7,12,975,882,1857,1866
0131-002,2015,12,7,13,882,865,1747,1857
0131-002,2015,12,7,14,1022,833,1855,1747
0131-002,2015,12,7,15,1037,1004,2041,1855
0131-002,2015,12,7,16,1128,990,2118,2041
0131-002,2015,12,7,17,1085,971,2056,2118
0131-002,2015,12,7,18,1069,1124,2193,2056
0131-002,2015,12,7,19,919,1006,1925,2193
0131-002,2015,12,7,20,704,761,1465,1925
0131-002,2015,12,7,21,588,766,1354,1465
0131-002,2015,12,7,22,494,480,974,1354
0131-002,2015,12,7,23,314,329,643,974
0131-002,2015,12,7,24,241,215,456,643
0131-002,2015,12,8,1,145,144,289,456
0131-002,2015,12,8,2,99,101,200,289
0131-002,2015,12,8,3,89,62,151,200
0131-002,2015,12,8,4,111,100,211,151
0131-002,2015,12,8,5,176,102,278,211
0131-002,2015,12,8,6,360,189,549,278
0131-002,2015,12,8,7,805,412,1217,549
0131-002,2015,12,8,8,1622,754,2376,1217
0131-002,2015,12,8,9,1411,1007,2418,2376
0131-002,2015,12,8,10,1198,928,2126,2418
0131-002,2015,12,8,11,1170,955,2125,2126
0131-002,2015,12,8,12,1044,924,1968,2125
0131-002,2015,12,8,13,848,807,1655,1968
0131-002,2015,12,8,14,997,945,1942,1655
0131-002,2015,12,8,15,1050,1078,2128,1942
0131-002,2015,12,8,16,1089,1051,2140,2128
0131-002,2015,12,8,17,1022,1066,2088,2140
0131-002,2015,12,8,18,1105,1187,2292,2088
0131-002,2015,12,8,19,937,1065,2002,2292
0131-002,2015,12,8,20,719,775,1494,2002
0131-002,2015,12,8,21,577,730,1307,1494
0131-002,2015,12,8,22,512,527,1039,1307
0131-002,2015,12,8,23,312,355,667,1039
0131-002,2015,12,8,24,242,233,475,667
0131-002,2015,12,9,1,188,157,345,475
0131-002,2015,12,9,2,122,87,209,345
0131-002,2015,12,9,3,100,80,180,209
0131-002,2015,12,9,4,128,79,207,180
0131-002,2015,12,9,5,139,127,266,207
0131-002,2015,12,9,6,368,179,547,266
0131-002,2015,12,9,7,827,376,1203,547
0131-002,2015,12,9,8,1635,799,2434,1203
0131-002,2015,12,9,9,1426,1081,2507,2434
0131-002,2015,12,9,10,1109,921,2030,2507
0131-002,2015,12,9,11,1085,935,2020,2030
0131-002,2015,12,9,12,1021,905,1926,2020
0131-002,2015,12,9,13,905,855,1760,1926
0131-002,2015,12,9,14,991,955,1946,1760
0131-002,2015,12,9,15,1096,1101,2197,1946
0131-002,2015,12,9,16,1012,1041,2053,2197
0131-002,2015,12,9,17,1083,1064,2147,2053
0131-002,2015,12,9,18,1026,1264,2290,2147
0131-002,2015,12,9,19,935,1086,2021,2290
0131-002,2015,12,9,20,683,795,1478,2021
0131-002,2015,12,9,21,608,730,1338,1478
0131-002,2015,12,9,22,463,494,957,1338
0131-002,2015,12,9,23,376,331,707,957
0131-002,2015,12,9,24,255,215,470,707
0131-002,2015,12,10,1,159,165,324,470
0131-002,2015,12,10,2,115,108,223,324
0131-002,2015,12,10,3,102,71,173,223
0131-002,2015,12,10,4,118,111,229,173
0131-002,2015,12,10,5,153,119,272,229
0131-002,2015,12,10,6,367,177,544,272
0131-002,2015,12,10,7,799,396,1195,544
0131-002,2015,12,10,8,1638,763,2401,1195
0131-002,2015,12,10,9,1332,1053,2385,2401
0131-002,2015,12,10,10,1073,867,1940,2385
0131-002,2015,12,10,11,974,736,1710,1940
0131-002,2015,12,10,12,905,659,1564,1710
0131-002,2015,12,10,13,749,674,1423,1564
0131-002,2015,12,10,14,914,703,1617,1423
0131-002,2015,12,10,15,909,1081,1990,1617
0131-002,2015,12,10,16,820,1161,1981,1990
0131-002,2015,12,10,17,947,1078,2025,1981
0131-002,2015,12,10,18,1041,1205,2246,2025
0131-002,2015,12,10,19,982,1179,2161,2246
0131-002,2015,12,10,20,689,819,1508,2161
0131-002,2015,12,10,21,540,725,1265,1508
0131-002,2015,12,10,22,435,459,894,1265
0131-002,2015,12,10,23,338,235,573,894
0131-002,2015,12,10,24,260,216,476,573
0131-002,2015,12,11,1,158,137,295,476
0131-002,2015,12,11,2,122,114,236,295
0131-002,2015,12,11,3,105,92,197,236
0131-002,2015,12,11,4,99,87,186,197
0131-002,2015,12,11,5,115,117,232,186
0131-002,2015,12,11,6,325,178,503,232
0131-002,2015,12,11,7,743,407,1150,503
0131-002,2015,12,11,8,1603,822,2425,1150
0131-002,2015,12,11,9,1349,1072,2421,2425
0131-002,2015,12,11,10,1161,932,2093,2421
0131-002,2015,12,11,11,1172,956,2128,2093
0131-002,2015,12,11,12,1123,1024,2147,2128
0131-002,2015,12,11,13,949,988,1937,2147
0131-002,2015,12,11,14,1048,1046,2094,1937
0131-002,2015,12,11,15,1184,1091,2275,2094
0131-002,2015,12,11,16,1152,1130,2282,2275
0131-002,2015,12,11,17,1035,1152,2187,2282
0131-002,2015,12,11,18,1196,1317,2513,2187
0131-002,2015,12,11,19,1289,1142,2431,2513
0131-002,2015,12,11,20,883,902,1785,2431
0131-002,2015,12,11,21,622,783,1405,1785
0131-002,2015,12,11,22,498,553,1051,1405
0131-002,2015,12,11,23,400,363,763,1051
0131-002,2015,12,11,24,243,247,490,763
0131-002,2015,12,12,1,195,185,380,490
0131-002,2015,12,12,2,139,121,260,380
0131-002,2015,12,12,3,113,104,217,260
0131-002,2015,12,12,4,107,104,211,217
0131-002,2015,12,12,5,132,110,242,211
0131-002,2015,12,12,6,289,182,471,242
0131-002,2015,12,12,7,532,365,897,471
0131-002,2015,12,12,8,900,535,1435,897
0131-002,2015,12,12,9,891,850,1741,1435
0131-002,2015,12,12,10,860,839,1699,1741
0131-002,2015,12,12,11,974,933,1907,1699
0131-002,2015,12,12,12,940,948,1888,1907
0131-002,2015,12,12,13,993,952,1945,1888
0131-002,2015,12,12,14,905,905,1810,1945
0131-002,2015,12,12,15,1045,1062,2107,1810
0131-002,2015,12,12,16,1054,1022,2076,2107
0131-002,2015,12,12,17,992,1115,2107,2076
0131-002,2015,12,12,18,997,1176,2173,2107
0131-002,2015,12,12,19,999,887,1886,2173
0131-002,2015,12,12,20,757,569,1326,1886
0131-002,2015,12,12,21,514,425,939,1326
0131-002,2015,12,12,22,377,318,695,939
0131-002,2015,12,12,23,324,285,609,695
0131-002,2015,12,12,24,224,212,436,609
0131-002,2015,12,13,1,180,146,326,436
0131-002,2015,12,13,2,112,121,233,326
0131-002,2015,12,13,3,99,100,199,233
0131-002,2015,12,13,4,97,77,174,199
0131-002,2015,12,13,5,91,78,169,174
0131-002,2015,12,13,6,154,125,279,169
0131-002,2015,12,13,7,279,169,448,279
0131-002,2015,12,13,8,363,272,635,448
0131-002,2015,12,13,9,434,403,837,635
0131-002,2015,12,13,10,449,513,962,837
0131-002,2015,12,13,11,531,563,1094,962
0131-002,2015,12,13,12,616,592,1208,1094
0131-002,2015,12,13,13,894,674,1568,1208
0131-002,2015,12,13,14,917,652,1569,1568
0131-002,2015,12,13,15,974,709,1683,1569
0131-002,2015,12,13,16,937,751,1688,1683
0131-002,2015,12,13,17,980,780,1760,1688
0131-002,2015,12,13,18,922,763,1685,1760
0131-002,2015,12,13,19,929,553,1482,1685
0131-002,2015,12,13,20,653,473,1126,1482
0131-002,2015,12,13,21,501,411,912,1126
0131-002,2015,12,13,22,452,293,745,912
0131-002,2015,12,13,23,307,203,510,745
0131-002,2015,12,13,24,189,150,339,510
0131-002,2015,12,14,1,134,104,238,339
0131-002,2015,12,14,2,86,70,156,238
0131-002,2015,12,14,3,65,45,110,156
0131-002,2015,12,14,4,76,69,145,110
0131-002,2015,12,14,5,136,101,237,145
0131-002,2015,12,14,6,367,169,536,237
0131-002,2015,12,14,7,887,418,1305,536
0131-002,2015,12,14,8,1776,851,2627,1305
0131-002,2015,12,14,9,1435,1024,2459,2627
0131-002,2015,12,14,10,1034,1020,2054,2459
0131-002,2015,12,14,11,962,1064,2026,2054
0131-002,2015,12,14,12,911,1048,1959,2026
0131-002,2015,12,14,13,817,911,1728,1959
0131-002,2015,12,14,14,976,958,1934,1728
0131-002,2015,12,14,15,912,1054,1966,1934
0131-002,2015,12,14,16,969,1075,2044,1966
0131-002,2015,12,14,17,971,1151,2122,2044
0131-002,2015,12,14,18,986,1316,2302,2122
0131-002,2015,12,14,19,835,1140,1975,2302
0131-002,2015,12,14,20,684,846,1530,1975
0131-002,2015,12,14,21,515,775,1290,1530
0131-002,2015,12,14,22,418,535,953,1290
0131-002,2015,12,14,23,298,328,626,953
0131-002,2015,12,14,24,178,204,382,626
0131-002,2015,12,15,1,145,147,292,382
0131-002,2015,12,15,2,122,94,216,292
0131-002,2015,12,15,3,102,93,195,216
0131-002,2015,12,15,4,106,84,190,195
0131-002,2015,12,15,5,123,110,233,190
0131-002,2015,12,15,6,308,171,479,233
0131-002,2015,12,15,7,758,416,1174,479
0131-002,2015,12,15,8,1610,901,2511,1174
0131-002,2015,12,15,9,1420,1183,2603,2511
0131-002,2015,12,15,10,1128,940,2068,2603
0131-002,2015,12,15,11,1179,1037,2216,2068
0131-002,2015,12,15,12,1050,960,2010,2216
0131-002,2015,12,15,13,921,903,1824,2010
0131-002,2015,12,15,14,1111,994,2105,1824
0131-002,2015,12,15,15,1074,1024,2098,2105
0131-002,2015,12,15,16,1140,1094,2234,2098
0131-002,2015,12,15,17,1052,1065,2117,2234
0131-002,2015,12,15,18,1027,1126,2153,2117
0131-002,2015,12,15,19,939,986,1925,2153
0131-002,2015,12,15,20,665,736,1401,1925
0131-002,2015,12,15,21,541,712,1253,1401
0131-002,2015,12,15,22,438,506,944,1253
0131-002,2015,12,15,23,340,321,661,944
0131-002,2015,12,15,24,230,215,445,661
0131-002,2015,12,16,1,178,192,370,445
0131-002,2015,12,16,2,101,126,227,370
0131-002,2015,12,16,3,71,75,146,227
0131-002,2015,12,16,4,90,99,189,146
0131-002,2015,12,16,5,112,117,229,189
0131-002,2015,12,16,6,103,163,266,229
0131-002,2015,12,16,7,335,394,729,266
0131-002,2015,12,16,8,1620,871,2491,729
0131-002,2015,12,16,9,1349,1152,2501,2491
0131-002,2015,12,16,10,1086,883,1969,2501
0131-002,2015,12,16,11,962,897,1859,1969
0131-002,2015,12,16,12,992,939,1931,1859
0131-002,2015,12,16,13,876,850,1726,1931
0131-002,2015,12,16,14,944,968,1912,1726
0131-002,2015,12,16,15,1018,1052,2070,1912
0131-002,2015,12,16,16,862,978,1840,2070
0131-002,2015,12,16,17,914,956,1870,1840
0131-002,2015,12,16,18,973,1114,2087,1870
0131-002,2015,12,16,19,886,981,1867,2087
0131-002,2015,12,16,20,673,670,1343,1867
0131-002,2015,12,16,21,512,598,1110,1343
0131-002,2015,12,16,22,458,427,885,1110
0131-002,2015,12,16,23,332,318,650,885
0131-002,2015,12,16,24,241,203,444,650
0131-002,2015,12,17,1,159,172,331,444
0131-002,2015,12,17,2,106,100,206,331
0131-002,2015,12,17,3,101,73,174,206
0131-002,2015,12,17,4,90,67,157,174
0131-002,2015,12,17,5,123,89,212,157
0131-002,2015,12,17,6,298,194,492,212
0131-002,2015,12,17,7,747,396,1143,492
0131-002,2015,12,17,8,1554,855,2409,1143
0131-002,2015,12,17,9,1358,1072,2430,2409
0131-002,2015,12,17,10,1084,877,1961,2430
0131-002,2015,12,17,11,1137,872,2009,1961
0131-002,2015,12,17,12,994,908,1902,2009
0131-002,2015,12,17,13,952,861,1813,1902
0131-002,2015,12,17,14,1001,918,1919,1813
0131-002,2015,12,17,15,1067,955,2022,1919
0131-002,2015,12,17,16,1078,971,2049,2022
0131-002,2015,12,17,17,1041,1027,2068,2049
0131-002,2015,12,17,18,1063,1149,2212,2068
0131-002,2015,12,17,19,917,1034,1951,2212
0131-002,2015,12,17,20,696,801,1497,1951
0131-002,2015,12,17,21,513,684,1197,1497
0131-002,2015,12,17,22,448,522,970,1197
0131-002,2015,12,17,23,329,344,673,970
0131-002,2015,12,17,24,243,247,490,673
0131-002,2015,12,18,1,172,178,350,490
0131-002,2015,12,18,2,104,105,209,350
0131-002,2015,12,18,3,99,89,188,209
0131-002,2015,12,18,4,87,93,180,188
0131-002,2015,12,18,5,128,105,233,180
0131-002,2015,12,18,6,331,193,524,233
0131-002,2015,12,18,7,712,349,1061,524
0131-002,2015,12,18,8,1658,838,2496,1061
0131-002,2015,12,18,9,1452,1022,2474,2496
0131-002,2015,12,18,10,1046,910,1956,2474
0131-002,2015,12,18,11,1147,992,2139,1956
0131-002,2015,12,18,12,1097,984,2081,2139
0131-002,2015,12,18,13,972,893,1865,2081
0131-002,2015,12,18,14,997,920,1917,1865
0131-002,2015,12,18,15,1050,981,2031,1917
0131-002,2015,12,18,16,1126,998,2124,2031
0131-002,2015,12,18,17,1031,1097,2128,2124
0131-002,2015,12,18,18,1166,1257,2423,2128
0131-002,2015,12,18,19,1060,1151,2211,2423
0131-002,2015,12,18,20,747,875,1622,2211
0131-002,2015,12,18,21,591,718,1309,1622
0131-002,2015,12,18,22,455,511,966,1309
0131-002,2015,12,18,23,408,387,795,966
0131-002,2015,12,18,24,257,235,492,795
0131-002,2015,12,19,1,187,197,384,492
0131-002,2015,12,19,2,134,140,274,384
0131-002,2015,12,19,3,92,103,195,274
0131-002,2015,12,19,4,89,95,184,195
0131-002,2015,12,19,5,103,112,215,184
0131-002,2015,12,19,6,243,139,382,215
0131-002,2015,12,19,7,481,295,776,382
0131-002,2015,12,19,8,817,481,1298,776
0131-002,2015,12,19,9,812,786,1598,1298
0131-002,2015,12,19,10,779,814,1593,1598
0131-002,2015,12,19,11,880,852,1732,1593
0131-002,2015,12,19,12,917,955,1872,1732
0131-002,2015,12,19,13,828,864,1692,1872
0131-002,2015,12,19,14,877,858,1735,1692
0131-002,2015,12,19,15,907,919,1826,1735
0131-002,2015,12,19,16,900,910,1810,1826
0131-002,2015,12,19,17,972,879,1851,1810
0131-002,2015,12,19,18,1066,946,2012,1851
0131-002,2015,12,19,19,913,705,1618,2012
0131-002,2015,12,19,20,685,469,1154,1618
0131-002,2015,12,19,21,444,425,869,1154
0131-002,2015,12,19,22,370,258,628,869
0131-002,2015,12,19,23,245,235,480,628
0131-002,2015,12,19,24,191,219,410,480
0131-002,2015,12,20,1,137,161,298,410
0131-002,2015,12,20,2,105,98,203,298
0131-002,2015,12,20,3,85,97,182,203
0131-002,2015,12,20,4,66,90,156,182
0131-002,2015,12,20,5,69,50,119,156
0131-002,2015,12,20,6,113,110,223,119
0131-002,2015,12,20,7,263,150,413,223
0131-002,2015,12,20,8,336,260,596,413
0131-002,2015,12,20,9,322,342,664,596
0131-002,2015,12,20,10,385,494,879,664
0131-002,2015,12,20,11,466,583,1049,879
0131-002,2015,12,20,12,556,609,1165,1049
0131-002,2015,12,20,13,602,613,1215,1165
0131-002,2015,12,20,14,658,588,1246,1215
0131-002,2015,12,20,15,742,662,1404,1246
0131-002,2015,12,20,16,771,701,1472,1404
0131-002,2015,12,20,17,822,709,1531,1472
0131-002,2015,12,20,18,895,712,1607,1531
0131-002,2015,12,20,19,738,507,1245,1607
0131-002,2015,12,20,20,594,457,1051,1245
0131-002,2015,12,20,21,454,393,847,1051
0131-002,2015,12,20,22,415,286,701,847
0131-002,2015,12,20,23,321,204,525,701
0131-002,2015,12,20,24,184,148,332,525
0131-002,2015,12,21,1,143,90,233,332
0131-002,2015,12,21,2,69,86,155,233
0131-002,2015,12,21,3,73,61,134,155
0131-002,2015,12,21,4,58,68,126,134
0131-002,2015,12,21,5,87,67,154,126
0131-002,2015,12,21,6,317,167,484,154
0131-002,2015,12,21,7,669,359,1028,484
0131-002,2015,12,21,8,976,855,1831,1028
0131-002,2015,12,21,9,778,1133,1911,1831
0131-002,2015,12,21,10,752,925,1677,1911
0131-002,2015,12,21,11,816,953,1769,1677
0131-002,2015,12,21,12,767,884,1651,1769
0131-002,2015,12,21,13,851,842,1693,1651
0131-002,2015,12,21,14,943,879,1822,1693
0131-002,2015,12,21,15,1029,1038,2067,1822
0131-002,2015,12,21,16,962,1020,1982,2067
0131-002,2015,12,21,17,926,988,1914,1982
0131-002,2015,12,21,18,920,1082,2002,1914
0131-002,2015,12,21,19,865,946,1811,2002
0131-002,2015,12,21,20,635,736,1371,1811
0131-002,2015,12,21,21,533,652,1185,1371
0131-002,2015,12,21,22,440,410,850,1185
0131-002,2015,12,21,23,273,251,524,850
0131-002,2015,12,21,24,203,158,361,524
0131-002,2015,12,22,1,142,142,284,361
0131-002,2015,12,22,2,105,80,185,284
0131-002,2015,12,22,3,89,61,150,185
0131-002,2015,12,22,4,74,49,123,150
0131-002,2015,12,22,5,117,89,206,123
0131-002,2015,12,22,6,287,168,455,206
0131-002,2015,12,22,7,717,364,1081,455
0131-002,2015,12,22,8,1495,727,2222,1081
0131-002,2015,12,22,9,1423,973,2396,2222
0131-002,2015,12,22,10,1082,880,1962,2396
0131-002,2015,12,22,11,1079,926,2005,1962
0131-002,2015,12,22,12,995,983,1978,2005
0131-002,2015,12,22,13,887,862,1749,1978
0131-002,2015,12,22,14,984,944,1928,1749
0131-002,2015,12,22,15,1105,1095,2200,1928
0131-002,2015,12,22,16,1026,921,1947,2200
0131-002,2015,12,22,17,1005,718,1723,1947
0131-002,2015,12,22,18,1065,762,1827,1723
0131-002,2015,12,22,19,889,721,1610,1827
0131-002,2015,12,22,20,589,617,1206,1610
0131-002,2015,12,22,21,538,501,1039,1206
0131-002,2015,12,22,22,433,386,819,1039
0131-002,2015,12,22,23,345,239,584,819
0131-002,2015,12,22,24,221,206,427,584
0131-002,2015,12,23,1,166,168,334,427
0131-002,2015,12,23,2,118,96,214,334
0131-002,2015,12,23,3,108,79,187,214
0131-002,2015,12,23,4,81,74,155,187
0131-002,2015,12,23,5,121,103,224,155
0131-002,2015,12,23,6,196,164,360,224
0131-002,2015,12,23,7,584,319,903,360
0131-002,2015,12,23,8,1399,803,2202,903
0131-002,2015,12,23,9,1222,1116,2338,2202
0131-002,2015,12,23,10,976,902,1878,2338
0131-002,2015,12,23,11,1067,916,1983,1878
0131-002,2015,12,23,12,1025,922,1947,1983
0131-002,2015,12,23,13,876,852,1728,1947
0131-002,2015,12,23,14,967,962,1929,1728
0131-002,2015,12,23,15,1096,1076,2172,1929
0131-002,2015,12,23,16,1017,1010,2027,2172
0131-002,2015,12,23,17,965,1010,1975,2027
0131-002,2015,12,23,18,997,1189,2186,1975
0131-002,2015,12,23,19,938,855,1793,2186
0131-002,2015,12,23,20,628,555,1183,1793
0131-002,2015,12,23,21,511,443,954,1183
0131-002,2015,12,23,22,428,359,787,954
0131-002,2015,12,23,23,343,329,672,787
0131-002,2015,12,23,24,226,221,447,672
0131-002,2015,12,24,1,202,182,384,447
0131-002,2015,12,24,2,120,106,226,384
0131-002,2015,12,24,3,86,95,181,226
0131-002,2015,12,24,4,83,93,176,181
0131-002,2015,12,24,5,97,103,200,176
0131-002,2015,12,24,6,280,156,436,200
0131-002,2015,12,24,7,725,341,1066,436
0131-002,2015,12,24,8,1503,699,2202,1066
0131-002,2015,12,24,9,1346,923,2269,2202
0131-002,2015,12,24,10,1008,736,1744,2269
0131-002,2015,12,24,11,1089,707,1796,1744
0131-002,2015,12,24,12,953,757,1710,1796
0131-002,2015,12,24,13,862,738,1600,1710
0131-002,2015,12,24,14,978,907,1885,1600
0131-002,2015,12,24,15,1031,981,2012,1885
0131-002,2015,12,24,16,1094,888,1982,2012
0131-002,2015,12,24,17,1030,1007,2037,1982
0131-002,2015,12,24,18,1100,1223,2323,2037
0131-002,2015,12,24,19,1185,1124,2309,2323
0131-002,2015,12,24,20,822,906,1728,2309
0131-002,2015,12,24,21,537,619,1156,1728
0131-002,2015,12,24,22,450,455,905,1156
0131-002,2015,12,24,23,349,347,696,905
0131-002,2015,12,24,24,197,230,427,696
0131-002,2015,12,25,1,175,168,343,427
0131-002,2015,12,25,2,101,105,206,343
0131-002,2015,12,25,3,79,91,170,206
0131-002,2015,12,25,4,92,89,181,170
0131-002,2015,12,25,5,115,100,215,181
0131-002,2015,12,25,6,202,104,306,215
0131-002,2015,12,25,7,386,264,650,306
0131-002,2015,12,25,8,552,401,953,650
0131-002,2015,12,25,9,539,528,1067,953
0131-002,2015,12,25,10,527,570,1097,1067
0131-002,2015,12,25,11,624,654,1278,1097
0131-002,2015,12,25,12,641,664,1305,1278
0131-002,2015,12,25,13,684,673,1357,1305
0131-002,2015,12,25,14,675,678,1353,1357
0131-002,2015,12,25,15,731,763,1494,1353
0131-002,2015,12,25,16,719,733,1452,1494
0131-002,2015,12,25,17,749,783,1532,1452
0131-002,2015,12,25,18,725,687,1412,1532
0131-002,2015,12,25,19,654,447,1101,1412
0131-002,2015,12,25,20,467,325,792,1101
0131-002,2015,12,25,21,372,265,637,792
0131-002,2015,12,25,22,310,205,515,637
0131-002,2015,12,25,23,236,217,453,515
0131-002,2015,12,25,24,155,158,313,453
0131-002,2015,12,26,1,132,115,247,313
0131-002,2015,12,26,2,87,75,162,247
0131-002,2015,12,26,3,61,69,130,162
0131-002,2015,12,26,4,70,42,112,130
0131-002,2015,12,26,5,79,111,190,112
0131-002,2015,12,26,6,181,160,341,190
0131-002,2015,12,26,7,310,330,640,341
0131-002,2015,12,26,8,858,508,1366,640
0131-002,2015,12,26,9,852,818,1670,1366
0131-002,2015,12,26,10,820,826,1646,1670
0131-002,2015,12,26,11,927,892,1819,1646
0131-002,2015,12,26,12,928,952,1880,1819
0131-002,2015,12,26,13,910,908,1818,1880
0131-002,2015,12,26,14,891,882,1773,1818
0131-002,2015,12,26,15,976,990,1966,1773
0131-002,2015,12,26,16,977,966,1943,1966
0131-002,2015,12,26,17,982,997,1979,1943
0131-002,2015,12,26,18,780,1061,1841,1979
0131-002,2015,12,26,19,709,796,1505,1841
0131-002,2015,12,26,20,549,519,1068,1505
0131-002,2015,12,26,21,393,291,684,1068
0131-002,2015,12,26,22,309,216,525,684
0131-002,2015,12,26,23,246,178,424,525
0131-002,2015,12,26,24,179,151,330,424
0131-002,2015,12,27,1,152,117,269,330
0131-002,2015,12,27,2,95,75,170,269
0131-002,2015,12,27,3,81,75,156,170
0131-002,2015,12,27,4,44,69,113,156
0131-002,2015,12,27,5,62,64,126,113
0131-002,2015,12,27,6,123,77,200,126
0131-002,2015,12,27,7,188,113,301,200
0131-002,2015,12,27,8,289,191,480,301
0131-002,2015,12,27,9,323,304,627,480
0131-002,2015,12,27,10,372,447,819,627
0131-002,2015,12,27,11,465,451,916,819
0131-002,2015,12,27,12,538,480,1018,916
0131-002,2015,12,27,13,582,535,1117,1018
0131-002,2015,12,27,14,605,474,1079,1117
0131-002,2015,12,27,15,604,628,1232,1079
0131-002,2015,12,27,16,735,701,1436,1232
0131-002,2015,12,27,17,774,679,1453,1436
0131-002,2015,12,27,18,736,650,1386,1453
0131-002,2015,12,27,19,678,396,1074,1386
0131-002,2015,12,27,20,529,396,925,1074
0131-002,2015,12,27,21,446,384,830,925
0131-002,2015,12,27,22,394,298,692,830
0131-002,2015,12,27,23,286,199,485,692
0131-002,2015,12,27,24,183,152,335,485
0131-002,2015,12,28,1,126,98,224,335
0131-002,2015,12,28,2,77,65,142,224
0131-002,2015,12,28,3,67,47,114,142
0131-002,2015,12,28,4,47,57,104,114
0131-002,2015,12,28,5,99,73,172,104
0131-002,2015,12,28,6,310,168,478,172
0131-002,2015,12,28,7,789,388,1177,478
0131-002,2015,12,28,8,1731,853,2584,1177
0131-002,2015,12,28,9,1375,1078,2453,2584
0131-002,2015,12,28,10,957,972,1929,2453
0131-002,2015,12,28,11,1036,1008,2044,1929
0131-002,2015,12,28,12,1008,966,1974,2044
0131-002,2015,12,28,13,817,876,1693,1974
0131-002,2015,12,28,14,912,918,1830,1693
0131-002,2015,12,28,15,1016,1046,2062,1830
0131-002,2015,12,28,16,1021,1048,2069,2062
0131-002,2015,12,28,17,1001,1070,2071,2069
0131-002,2015,12,28,18,987,1199,2186,2071
0131-002,2015,12,28,19,933,1043,1976,2186
0131-002,2015,12,28,20,616,791,1407,1976
0131-002,2015,12,28,21,497,714,1211,1407
0131-002,2015,12,28,22,428,494,922,1211
0131-002,2015,12,28,23,332,330,662,922
0131-002,2015,12,28,24,199,206,405,662
0131-002,2015,12,29,1,157,160,317,405
0131-002,2015,12,29,2,103,95,198,317
0131-002,2015,12,29,3,81,74,155,198
0131-002,2015,12,29,4,66,79,145,155
0131-002,2015,12,29,5,107,110,217,145
0131-002,2015,12,29,6,274,151,425,217
0131-002,2015,12,29,7,668,321,989,425
0131-002,2015,12,29,8,1545,780,2325,989
0131-002,2015,12,29,9,1364,1053,2417,2325
0131-002,2015,12,29,10,955,880,1835,2417
0131-002,2015,12,29,11,1105,944,2049,1835
0131-002,2015,12,29,12,997,1012,2009,2049
0131-002,2015,12,29,13,854,817,1671,2009
0131-002,2015,12,29,14,982,881,1863,1671
0131-002,2015,12,29,15,1107,1003,2110,1863
0131-002,2015,12,29,16,1036,921,1957,2110
0131-002,2015,12,29,17,944,978,1922,1957
0131-002,2015,12,29,18,1012,1014,2026,1922
0131-002,2015,12,29,19,950,976,1926,2026
0131-002,2015,12,29,20,635,767,1402,1926
0131-002,2015,12,29,21,489,645,1134,1402
0131-002,2015,12,29,22,415,480,895,1134
0131-002,2015,12,29,23,310,315,625,895
0131-002,2015,12,29,24,248,222,470,625
0131-002,2015,12,30,1,174,181,355,470
0131-002,2015,12,30,2,133,103,236,355
0131-002,2015,12,30,3,81,75,156,236
0131-002,2015,12,30,4,78,81,159,156
0131-002,2015,12,30,5,120,109,229,159
0131-002,2015,12,30,6,270,164,434,229
0131-002,2015,12,30,7,643,356,999,434
0131-002,2015,12,30,8,1540,837,2377,999
0131-002,2015,12,30,9,1269,1134,2403,2377
0131-002,2015,12,30,10,1027,892,1919,2403
0131-002,2015,12,30,11,1044,906,1950,1919
0131-002,2015,12,30,12,990,930,1920,1950
0131-002,2015,12,30,13,850,851,1701,1920
0131-002,2015,12,30,14,969,965,1934,1701
0131-002,2015,12,30,15,1025,994,2019,1934
0131-002,2015,12,30,16,1030,1008,2038,2019
0131-002,2015,12,30,17,967,955,1922,2038
0131-002,2015,12,30,18,985,1048,2033,1922
0131-002,2015,12,30,19,912,751,1663,2033
0131-002,2015,12,30,20,650,501,1151,1663
0131-002,2015,12,30,21,512,455,967,1151
0131-002,2015,12,30,22,443,366,809,967
0131-002,2015,12,30,23,338,271,609,809
0131-002,2015,12,30,24,234,200,434,609
0131-002,2015,12,31,1,134,155,289,434
0131-002,2015,12,31,2,103,111,214,289
0131-002,2015,12,31,3,95,70,165,214
0131-002,2015,12,31,4,58,72,130,165
0131-002,2015,12,31,5,72,88,160,130
0131-002,2015,12,31,6,146,116,262,160
0131-002,2015,12,31,7,504,237,741,262
0131-002,2015,12,31,8,1191,482,1673,741
0131-002,2015,12,31,9,1176,632,1808,1673
0131-002,2015,12,31,10,714,604,1318,1808
0131-002,2015,12,31,11,706,652,1358,1318
0131-002,2015,12,31,12,796,666,1462,1358
0131-002,2015,12,31,13,694,661,1355,1462
0131-002,2015,12,31,14,799,677,1476,1355
0131-002,2015,12,31,15,793,742,1535,1476
0131-002,2015,12,31,16,708,811,1519,1535
0131-002,2015,12,31,17,884,824,1708,1519
0131-002,2015,12,31,18,858,859,1717,1708
0131-002,2015,12,31,19,827,771,1598,1717
0131-002,2015,12,31,20,679,606,1285,1598
0131-002,2015,12,31,21,551,433,984,1285
0131-002,2015,12,31,22,417,330,747,984
0131-002,2015,12,31,23,326,288,614,747
0131-002,2015,12,31,24,223,159,382,614
0131-002,2016,6,15,1,145,138,283,382
0131-002,2016,6,15,2,76,84,160,283
0131-002,2016,6,15,3,48,63,111,160
0131-002,2016,6,15,4,58,75,133,111
0131-002,2016,6,15,5,122,122,244,133
0131-002,2016,6,15,6,347,235,582,244
0131-002,2016,6,15,7,832,505,1337,582
0131-002,2016,6,15,8,1554,1059,2613,1337
0131-002,2016,6,15,9,1430,1402,2832,2613
0131-002,2016,6,15,10,1037,1191,2228,2832
0131-002,2016,6,15,11,1107,1147,2254,2228
0131-002,2016,6,15,12,1045,1129,2174,2254
0131-002,2016,6,15,13,843,920,1763,2174
0131-002,2016,6,15,14,1066,1069,2135,1763
0131-002,2016,6,15,15,1038,1176,2214,2135
0131-002,2016,6,15,16,961,1094,2055,2214
0131-002,2016,6,15,17,964,1211,2175,2055
0131-002,2016,6,15,18,1059,1389,2448,2175
0131-002,2016,6,15,19,1075,1330,2405,2448
0131-002,2016,6,15,20,692,894,1586,2405
0131-002,2016,6,15,21,599,709,1308,1586
0131-002,2016,6,15,22,450,515,965,1308
0131-002,2016,6,15,23,353,337,690,965
0131-002,2016,6,15,24,205,204,409,690
0131-002,2016,6,16,1,164,144,308,409
0131-002,2016,6,16,2,76,88,164,308
0131-002,2016,6,16,3,61,75,136,164
0131-002,2016,6,16,4,69,77,146,136
0131-002,2016,6,16,5,118,102,220,146
0131-002,2016,6,16,6,364,233,597,220
0131-002,2016,6,16,7,813,505,1318,597
0131-002,2016,6,16,8,1575,1003,2578,1318
0131-002,2016,6,16,9,1436,1273,2709,2578
0131-002,2016,6,16,10,1161,1224,2385,2709
0131-002,2016,6,16,11,1122,1140,2262,2385
0131-002,2016,6,16,12,1027,1112,2139,2262
0131-002,2016,6,16,13,859,932,1791,2139
0131-002,2016,6,16,14,956,1071,2027,1791
0131-002,2016,6,16,15,1138,1169,2307,2027
0131-002,2016,6,16,16,1006,1110,2116,2307
0131-002,2016,6,16,17,1018,1235,2253,2116
0131-002,2016,6,16,18,996,1427,2423,2253
0131-002,2016,6,16,19,1089,1418,2507,2423
0131-002,2016,6,16,20,826,1088,1914,2507
0131-002,2016,6,16,21,674,902,1576,1914
0131-002,2016,6,16,22,530,588,1118,1576
0131-002,2016,6,16,23,404,418,822,1118
0131-002,2016,6,16,24,219,229,448,822
0131-002,2016,6,17,1,158,158,316,448
0131-002,2016,6,17,2,116,93,209,316
0131-002,2016,6,17,3,66,73,139,209
0131-002,2016,6,17,4,62,77,139,139
0131-002,2016,6,17,5,105,116,221,139
0131-002,2016,6,17,6,402,259,661,221
0131-002,2016,6,17,7,888,585,1473,661
0131-002,2016,6,17,8,1607,1063,2670,1473
0131-002,2016,6,17,9,1542,1342,2884,2670
0131-002,2016,6,17,10,1161,1163,2324,2884
0131-002,2016,6,17,11,1166,1146,2312,2324
0131-002,2016,6,17,12,1069,1167,2236,2312
0131-002,2016,6,17,13,986,1137,2123,2236
0131-002,2016,6,17,14,1105,1125,2230,2123
0131-002,2016,6,17,15,1090,1332,2422,2230
0131-002,2016,6,17,16,1135,1272,2407,2422
0131-002,2016,6,17,17,1094,1398,2492,2407
0131-002,2016,6,17,18,1232,1662,2894,2492
0131-002,2016,6,17,19,1331,1645,2976,2894
0131-002,2016,6,17,20,1104,1333,2437,2976
0131-002,2016,6,17,21,711,940,1651,2437
0131-002,2016,6,17,22,563,674,1237,1651
0131-002,2016,6,17,23,429,440,869,1237
0131-002,2016,6,17,24,243,268,511,869
0131-002,2016,6,18,1,151,191,342,511
0131-002,2016,6,18,2,127,140,267,342
0131-002,2016,6,18,3,74,87,161,267
0131-002,2016,6,18,4,97,99,196,161
0131-002,2016,6,18,5,110,109,219,196
0131-002,2016,6,18,6,339,248,587,219
0131-002,2016,6,18,7,657,426,1083,587
0131-002,2016,6,18,8,906,768,1674,1083
0131-002,2016,6,18,9,990,1084,2074,1674
0131-002,2016,6,18,10,1013,1051,2064,2074
0131-002,2016,6,18,11,964,1033,1997,2064
0131-002,2016,6,18,12,937,1081,2018,1997
0131-002,2016,6,18,13,943,988,1931,2018
0131-002,2016,6,18,14,935,942,1877,1931
0131-002,2016,6,18,15,1004,963,1967,1877
0131-002,2016,6,18,16,965,1001,1966,1967
0131-002,2016,6,18,17,988,1018,2006,1966
0131-002,2016,6,18,18,1100,1348,2448,2006
0131-002,2016,6,18,19,1037,1070,2107,2448
0131-002,2016,6,18,20,673,683,1356,2107
0131-002,2016,6,18,21,528,576,1104,1356
0131-002,2016,6,18,22,450,435,885,1104
0131-002,2016,6,18,23,319,296,615,885
0131-002,2016,6,18,24,203,205,408,615
0131-002,2016,6,19,1,109,140,249,408
0131-002,2016,6,19,2,97,99,196,249
0131-002,2016,6,19,3,69,74,143,196
0131-002,2016,6,19,4,49,52,101,143
0131-002,2016,6,19,5,73,81,154,101
0131-002,2016,6,19,6,201,140,341,154
0131-002,2016,6,19,7,328,212,540,341
0131-002,2016,6,19,8,368,296,664,540
0131-002,2016,6,19,9,429,436,865,664
0131-002,2016,6,19,10,474,515,989,865
0131-002,2016,6,19,11,544,543,1087,989
0131-002,2016,6,19,12,566,588,1154,1087
0131-002,2016,6,19,13,583,606,1189,1154
0131-002,2016,6,19,14,686,660,1346,1189
0131-002,2016,6,19,15,695,719,1414,1346
0131-002,2016,6,19,16,876,827,1703,1414
0131-002,2016,6,19,17,901,852,1753,1703
0131-002,2016,6,19,18,920,956,1876,1753
0131-002,2016,6,19,19,920,774,1694,1876
0131-002,2016,6,19,20,727,574,1301,1694
0131-002,2016,6,19,21,571,480,1051,1301
0131-002,2016,6,19,22,527,390,917,1051
0131-002,2016,6,19,23,351,272,623,917
0131-002,2016,6,19,24,217,183,400,623
0131-002,2016,6,20,1,101,93,194,400
0131-002,2016,6,20,2,64,61,125,194
0131-002,2016,6,20,3,43,40,83,125
0131-002,2016,6,20,4,64,71,135,83
0131-002,2016,6,20,5,118,110,228,135
0131-002,2016,6,20,6,451,262,713,228
0131-002,2016,6,20,7,997,580,1577,713
0131-002,2016,6,20,8,1806,1182,2988,1577
0131-002,2016,6,20,9,1470,1333,2803,2988
0131-002,2016,6,20,10,1118,1158,2276,2803
0131-002,2016,6,20,11,1071,1137,2208,2276
0131-002,2016,6,20,12,1085,1136,2221,2208
0131-002,2016,6,20,13,1000,934,1934,2221
0131-002,2016,6,20,14,1109,1072,2181,1934
0131-002,2016,6,20,15,1111,1116,2227,2181
0131-002,2016,6,20,16,1082,1129,2211,2227
0131-002,2016,6,20,17,1028,1184,2212,2211
0131-002,2016,6,20,18,1127,1452,2579,2212
0131-002,2016,6,20,19,1126,1382,2508,2579
0131-002,2016,6,20,20,799,1001,1800,2508
0131-002,2016,6,20,21,717,888,1605,1800
0131-002,2016,6,20,22,498,626,1124,1605
0131-002,2016,6,20,23,351,391,742,1124
0131-002,2016,6,20,24,176,217,393,742
0131-002,2016,6,21,1,141,148,289,393
0131-002,2016,6,21,2,79,81,160,289
0131-002,2016,6,21,3,62,76,138,160
0131-002,2016,6,21,4,73,81,154,138
0131-002,2016,6,21,5,113,98,211,154
0131-002,2016,6,21,6,371,242,613,211
0131-002,2016,6,21,7,836,517,1353,613
0131-002,2016,6,21,8,1667,1108,2775,1353
0131-002,2016,6,21,9,1408,1348,2756,2775
0131-002,2016,6,21,10,1192,1146,2338,2756
0131-002,2016,6,21,11,1135,1095,2230,2338
0131-002,2016,6,21,12,1018,1036,2054,2230
0131-002,2016,6,21,13,849,915,1764,2054
0131-002,2016,6,21,14,1056,1056,2112,1764
0131-002,2016,6,21,15,1120,1152,2272,2112
0131-002,2016,6,21,16,1082,1217,2299,2272
0131-002,2016,6,21,17,1120,1232,2352,2299
0131-002,2016,6,21,18,1072,1454,2526,2352
0131-002,2016,6,21,19,1066,1315,2381,2526
0131-002,2016,6,21,20,787,963,1750,2381
0131-002,2016,6,21,21,624,870,1494,1750
0131-002,2016,6,21,22,458,545,1003,1494
0131-002,2016,6,21,23,365,370,735,1003
0131-002,2016,6,21,24,194,216,410,735
0131-002,2016,6,22,1,145,157,302,410
0131-002,2016,6,22,2,87,93,180,302
0131-002,2016,6,22,3,67,80,147,180
0131-002,2016,6,22,4,73,82,155,147
0131-002,2016,6,22,5,101,104,205,155
0131-002,2016,6,22,6,308,237,545,205
0131-002,2016,6,22,7,803,519,1322,545
0131-002,2016,6,22,8,1615,1088,2703,1322
0131-002,2016,6,22,9,1474,1384,2858,2703
0131-002,2016,6,22,10,1104,1111,2215,2858
0131-002,2016,6,22,11,1054,1110,2164,2215
0131-002,2016,6,22,12,961,1137,2098,2164
0131-002,2016,6,22,13,840,1250,2090,2098
0131-002,2016,6,22,14,981,979,1960,2090
0131-002,2016,6,22,15,1199,1252,2451,1960
0131-002,2016,6,22,16,1041,1120,2161,2451
0131-002,2016,6,22,17,986,1166,2152,2161
0131-002,2016,6,22,18,1067,1459,2526,2152
0131-002,2016,6,22,19,1120,1318,2438,2526
0131-002,2016,6,22,20,790,917,1707,2438
0131-002,2016,6,22,21,619,685,1304,1707
0131-002,2016,6,22,22,465,511,976,1304
0131-002,2016,6,22,23,313,320,633,976
0131-002,2016,6,22,24,198,211,409,633
0131-002,2016,6,23,1,133,160,293,409
0131-002,2016,6,23,2,96,97,193,293
0131-002,2016,6,23,3,70,73,143,193
0131-002,2016,6,23,4,73,81,154,143
0131-002,2016,6,23,5,109,108,217,154
0131-002,2016,6,23,6,419,247,666,217
0131-002,2016,6,23,7,831,531,1362,666
0131-002,2016,6,23,8,1642,1088,2730,1362
0131-002,2016,6,23,9,1494,1383,2877,2730
0131-002,2016,6,23,10,1157,1110,2267,2877
0131-002,2016,6,23,11,1059,1106,2165,2267
0131-002,2016,6,23,12,1059,1093,2152,2165
0131-002,2016,6,23,13,961,988,1949,2152
0131-002,2016,6,23,14,1009,1028,2037,1949
0131-002,2016,6,23,15,1102,1178,2280,2037
0131-002,2016,6,23,16,1125,1169,2294,2280
0131-002,2016,6,23,17,1093,1213,2306,2294
0131-002,2016,6,23,18,1096,1478,2574,2306
0131-002,2016,6,23,19,1087,1330,2417,2574
0131-002,2016,6,23,20,809,1004,1813,2417
0131-002,2016,6,23,21,660,888,1548,1813
0131-002,2016,6,23,22,499,566,1065,1548
0131-002,2016,6,23,23,344,385,729,1065
0131-002,2016,6,23,24,218,221,439,729
0131-002,2016,6,24,1,134,140,274,439
0131-002,2016,6,24,2,92,88,180,274
0131-002,2016,6,24,3,80,77,157,180
0131-002,2016,6,24,4,74,88,162,157
0131-002,2016,6,24,5,85,86,171,162
0131-002,2016,6,24,6,235,199,434,171
0131-002,2016,6,24,7,646,437,1083,434
0131-002,2016,6,24,8,1233,1004,2237,1083
0131-002,2016,6,24,9,1427,1376,2803,2237
0131-002,2016,6,24,10,1009,1021,2030,2803
0131-002,2016,6,24,11,1072,1092,2164,2030
0131-002,2016,6,24,12,1020,1095,2115,2164
0131-002,2016,6,24,13,962,1001,1963,2115
0131-002,2016,6,24,14,1002,1016,2018,1963
0131-002,2016,6,24,15,1072,1158,2230,2018
0131-002,2016,6,24,16,1084,1181,2265,2230
0131-002,2016,6,24,17,991,1185,2176,2265
0131-002,2016,6,24,18,1118,1576,2694,2176
0131-002,2016,6,24,19,1290,1586,2876,2694
0131-002,2016,6,24,20,924,1165,2089,2876
0131-002,2016,6,24,21,735,841,1576,2089
0131-002,2016,6,24,22,543,597,1140,1576
0131-002,2016,6,24,23,349,402,751,1140
0131-002,2016,6,24,24,252,234,486,751
0131-002,2016,6,25,1,180,173,353,486
0131-002,2016,6,25,2,115,105,220,353
0131-002,2016,6,25,3,87,82,169,220
0131-002,2016,6,25,4,78,103,181,169
0131-002,2016,6,25,5,115,118,233,181
0131-002,2016,6,25,6,320,244,564,233
0131-002,2016,6,25,7,608,414,1022,564
0131-002,2016,6,25,8,871,657,1528,1022
0131-002,2016,6,25,9,943,940,1883,1528
0131-002,2016,6,25,10,906,1007,1913,1883
0131-002,2016,6,25,11,934,1005,1939,1913
0131-002,2016,6,25,12,1050,1023,2073,1939
0131-002,2016,6,25,13,876,963,1839,2073
0131-002,2016,6,25,14,887,971,1858,1839
0131-002,2016,6,25,15,986,997,1983,1858
0131-002,2016,6,25,16,972,1024,1996,1983
0131-002,2016,6,25,17,926,1084,2010,1996
0131-002,2016,6,25,18,1089,1252,2341,2010
0131-002,2016,6,25,19,997,1071,2068,2341
0131-002,2016,6,25,20,689,743,1432,2068
0131-002,2016,6,25,21,539,541,1080,1432
0131-002,2016,6,25,22,453,430,883,1080
0131-002,2016,6,25,23,324,342,666,883
0131-002,2016,6,25,24,200,197,397,666
0131-002,2016,6,26,1,123,130,253,397
0131-002,2016,6,26,2,98,100,198,253
0131-002,2016,6,26,3,76,92,168,198
0131-002,2016,6,26,4,55,62,117,168
0131-002,2016,6,26,5,79,79,158,117
0131-002,2016,6,26,6,176,127,303,158
0131-002,2016,6,26,7,310,215,525,303
0131-002,2016,6,26,8,330,327,657,525
0131-002,2016,6,26,9,463,472,935,657
0131-002,2016,6,26,10,496,544,1040,935
0131-002,2016,6,26,11,617,612,1229,1040
0131-002,2016,6,26,12,599,647,1246,1229
0131-002,2016,6,26,13,604,566,1170,1246
0131-002,2016,6,26,14,656,673,1329,1170
0131-002,2016,6,26,15,700,699,1399,1329
0131-002,2016,6,26,16,736,825,1561,1399
0131-002,2016,6,26,17,796,876,1672,1561
0131-002,2016,6,26,18,832,865,1697,1672
0131-002,2016,6,26,19,836,800,1636,1697
0131-002,2016,6,26,20,683,616,1299,1636
0131-002,2016,6,26,21,519,472,991,1299
0131-002,2016,6,26,22,482,397,879,991
0131-002,2016,6,26,23,316,289,605,879
0131-002,2016,6,26,24,205,160,365,605
0131-002,2016,6,27,1,119,105,224,365
0131-002,2016,6,27,2,79,69,148,224
0131-002,2016,6,27,3,43,56,99,148
0131-002,2016,6,27,4,46,57,103,99
0131-002,2016,6,27,5,113,110,223,103
0131-002,2016,6,27,6,434,253,687,223
0131-002,2016,6,27,7,988,619,1607,687
0131-002,2016,6,27,8,1847,1125,2972,1607
0131-002,2016,6,27,9,1568,1326,2894,2972
0131-002,2016,6,27,10,1104,1058,2162,2894
0131-002,2016,6,27,11,1047,1118,2165,2162
0131-002,2016,6,27,12,1064,1062,2126,2165
0131-002,2016,6,27,13,943,900,1843,2126
0131-002,2016,6,27,14,1050,985,2035,1843
0131-002,2016,6,27,15,1180,1202,2382,2035
0131-002,2016,6,27,16,1170,1146,2316,2382
0131-002,2016,6,27,17,1063,1250,2313,2316
0131-002,2016,6,27,18,1096,1454,2550,2313
0131-002,2016,6,27,19,1105,1318,2423,2550
0131-002,2016,6,27,20,785,1005,1790,2423
0131-002,2016,6,27,21,632,837,1469,1790
0131-002,2016,6,27,22,467,608,1075,1469
0131-002,2016,6,27,23,312,359,671,1075
0131-002,2016,6,27,24,200,201,401,671
0131-002,2016,6,28,1,140,141,281,401
0131-002,2016,6,28,2,85,81,166,281
0131-002,2016,6,28,3,66,69,135,166
0131-002,2016,6,28,4,65,70,135,135
0131-002,2016,6,28,5,83,90,173,135
0131-002,2016,6,28,6,397,283,680,173
0131-002,2016,6,28,7,836,554,1390,680
0131-002,2016,6,28,8,1657,1096,2753,1390
0131-002,2016,6,28,9,1511,1407,2918,2753
0131-002,2016,6,28,10,1144,1145,2289,2918
0131-002,2016,6,28,11,1130,1157,2287,2289
0131-002,2016,6,28,12,1107,1143,2250,2287
0131-002,2016,6,28,13,876,909,1785,2250
0131-002,2016,6,28,14,1058,1110,2168,1785
0131-002,2016,6,28,15,1138,1200,2338,2168
0131-002,2016,6,28,16,1080,1123,2203,2338
0131-002,2016,6,28,17,1026,1214,2240,2203
0131-002,2016,6,28,18,1054,1439,2493,2240
0131-002,2016,6,28,19,1093,1465,2558,2493
0131-002,2016,6,28,20,854,994,1848,2558
0131-002,2016,6,28,21,661,861,1522,1848
0131-002,2016,6,28,22,471,570,1041,1522
0131-002,2016,6,28,23,343,379,722,1041
0131-002,2016,6,28,24,189,207,396,722
0131-002,2016,6,29,1,143,130,273,396
0131-002,2016,6,29,2,79,105,184,273
0131-002,2016,6,29,3,60,81,141,184
0131-002,2016,6,29,4,78,94,172,141
0131-002,2016,6,29,5,118,123,241,172
0131-002,2016,6,29,6,380,270,650,241
0131-002,2016,6,29,7,883,517,1400,650
0131-002,2016,6,29,8,1623,1064,2687,1400
0131-002,2016,6,29,9,1448,1386,2834,2687
0131-002,2016,6,29,10,1122,1123,2245,2834
0131-002,2016,6,29,11,1085,1034,2119,2245
0131-002,2016,6,29,12,1056,1102,2158,2119
0131-002,2016,6,29,13,881,945,1826,2158
0131-002,2016,6,29,14,1059,1007,2066,1826
0131-002,2016,6,29,15,1116,1193,2309,2066
0131-002,2016,6,29,16,1136,1193,2329,2309
0131-002,2016,6,29,17,1042,1236,2278,2329
0131-002,2016,6,29,18,1129,1566,2695,2278
0131-002,2016,6,29,19,1096,1489,2585,2695
0131-002,2016,6,29,20,805,963,1768,2585
0131-002,2016,6,29,21,559,732,1291,1768
0131-002,2016,6,29,22,485,596,1081,1291
0131-002,2016,6,29,23,346,375,721,1081
0131-002,2016,6,29,24,218,229,447,721
0131-002,2016,6,30,1,152,153,305,447
0131-002,2016,6,30,2,109,102,211,305
0131-002,2016,6,30,3,66,84,150,211
0131-002,2016,6,30,4,69,73,142,150
0131-002,2016,6,30,5,95,88,183,142
0131-002,2016,6,30,6,360,239,599,183
0131-002,2016,6,30,7,856,480,1336,599
0131-002,2016,6,30,8,1635,1075,2710,1336
0131-002,2016,6,30,9,1524,1353,2877,2710
0131-002,2016,6,30,10,1205,1102,2307,2877
0131-002,2016,6,30,11,1056,1100,2156,2307
0131-002,2016,6,30,12,981,1066,2047,2156
0131-002,2016,6,30,13,890,909,1799,2047
0131-002,2016,6,30,14,1036,1056,2092,1799
0131-002,2016,6,30,15,1080,1123,2203,2092
0131-002,2016,6,30,16,979,1060,2039,2203
0131-002,2016,6,30,17,1024,1264,2288,2039
0131-002,2016,6,30,18,1114,1522,2636,2288
0131-002,2016,6,30,19,1087,1336,2423,2636
0131-002,2016,6,30,20,781,1052,1833,2423
0131-002,2016,6,30,21,632,877,1509,1833
0131-002,2016,6,30,22,490,612,1102,1509
0131-002,2016,6,30,23,346,383,729,1102
0131-002,2016,6,30,24,228,234,462,729
0131-002,2016,7,1,1,151,165,316,462
0131-002,2016,7,1,2,100,102,202,316
0131-002,2016,7,1,3,71,73,144,202
0131-002,2016,7,1,4,90,94,184,144
0131-002,2016,7,1,5,136,122,258,184
0131-002,2016,7,1,6,332,229,561,258
0131-002,2016,7,1,7,799,518,1317,561
0131-002,2016,7,1,8,1686,1023,2709,1317
0131-002,2016,7,1,9,1469,1325,2794,2709
0131-002,2016,7,1,10,1138,1154,2292,2794
0131-002,2016,7,1,11,1088,1178,2266,2292
0131-002,2016,7,1,12,1008,1063,2071,2266
0131-002,2016,7,1,13,916,1012,1928,2071
0131-002,2016,7,1,14,994,1073,2067,1928
0131-002,2016,7,1,15,1056,1156,2212,2067
0131-002,2016,7,1,16,1028,1187,2215,2212
0131-002,2016,7,1,17,1021,1176,2197,2215
0131-002,2016,7,1,18,1384,1623,3007,2197
0131-002,2016,7,1,19,1356,1585,2941,3007
0131-002,2016,7,1,20,1076,1050,2126,2941
0131-002,2016,7,1,21,797,797,1594,2126
0131-002,2016,7,1,22,551,589,1140,1594
0131-002,2016,7,1,23,313,307,620,1140
0131-002,2016,7,1,24,185,205,390,620
0131-002,2016,7,2,1,123,150,273,390
0131-002,2016,7,2,2,106,119,225,273
0131-002,2016,7,2,3,84,78,162,225
0131-002,2016,7,2,4,78,71,149,162
0131-002,2016,7,2,5,85,85,170,149
0131-002,2016,7,2,6,234,196,430,170
0131-002,2016,7,2,7,421,312,733,430
0131-002,2016,7,2,8,806,636,1442,733
0131-002,2016,7,2,9,842,825,1667,1442
0131-002,2016,7,2,10,820,869,1689,1667
0131-002,2016,7,2,11,824,891,1715,1689
0131-002,2016,7,2,12,936,983,1919,1715
0131-002,2016,7,2,13,919,927,1846,1919
0131-002,2016,7,2,14,839,892,1731,1846
0131-002,2016,7,2,15,902,928,1830,1731
0131-002,2016,7,2,16,880,1001,1881,1830
0131-002,2016,7,2,17,910,966,1876,1881
0131-002,2016,7,2,18,1025,1161,2186,1876
0131-002,2016,7,2,19,928,966,1894,2186
0131-002,2016,7,2,20,655,602,1257,1894
0131-002,2016,7,2,21,532,537,1069,1257
0131-002,2016,7,2,22,467,391,858,1069
0131-002,2016,7,2,23,295,298,593,858
0131-002,2016,7,2,24,176,192,368,593
0131-002,2016,7,3,1,123,122,245,368
0131-002,2016,7,3,2,107,90,197,245
0131-002,2016,7,3,3,73,78,151,197
0131-002,2016,7,3,4,55,74,129,151
0131-002,2016,7,3,5,59,59,118,129
0131-002,2016,7,3,6,134,108,242,118
0131-002,2016,7,3,7,254,185,439,242
0131-002,2016,7,3,8,317,292,609,439
0131-002,2016,7,3,9,371,383,754,609
0131-002,2016,7,3,10,423,500,923,754
0131-002,2016,7,3,11,519,597,1116,923
0131-002,2016,7,3,12,612,615,1227,1116
0131-002,2016,7,3,13,576,608,1184,1227
0131-002,2016,7,3,14,665,654,1319,1184
0131-002,2016,7,3,15,750,730,1480,1319
0131-002,2016,7,3,16,960,834,1794,1480
0131-002,2016,7,3,17,1181,833,2014,1794
0131-002,2016,7,3,18,1006,873,1879,2014
0131-002,2016,7,3,19,952,708,1660,1879
0131-002,2016,7,3,20,690,491,1181,1660
0131-002,2016,7,3,21,525,466,991,1181
0131-002,2016,7,3,22,475,374,849,991
0131-002,2016,7,3,23,381,229,610,849
0131-002,2016,7,3,24,256,144,400,610
0131-002,2016,7,4,1,116,106,222,400
0131-002,2016,7,4,2,62,67,129,222
0131-002,2016,7,4,3,45,42,87,129
0131-002,2016,7,4,4,50,41,91,87
0131-002,2016,7,4,5,76,72,148,91
0131-002,2016,7,4,6,298,196,494,148
0131-002,2016,7,4,7,700,432,1132,494
0131-002,2016,7,4,8,1719,1061,2780,1132
0131-002,2016,7,4,9,1520,1246,2766,2780
0131-002,2016,7,4,10,962,981,1943,2766
0131-002,2016,7,4,11,978,955,1933,1943
0131-002,2016,7,4,12,882,884,1766,1933
0131-002,2016,7,4,13,838,925,1763,1766
0131-002,2016,7,4,14,976,933,1909,1763
0131-002,2016,7,4,15,973,1033,2006,1909
0131-002,2016,7,4,16,991,1025,2016,2006
0131-002,2016,7,4,17,882,989,1871,2016
0131-002,2016,7,4,18,947,1159,2106,1871
0131-002,2016,7,4,19,956,1207,2163,2106
0131-002,2016,7,4,20,743,854,1597,2163
0131-002,2016,7,4,21,547,808,1355,1597
0131-002,2016,7,4,22,380,443,823,1355
0131-002,2016,7,4,23,239,312,551,823
0131-002,2016,7,4,24,151,164,315,551
0131-002,2016,7,5,1,111,146,257,315
0131-002,2016,7,5,2,63,73,136,257
0131-002,2016,7,5,3,65,65,130,136
0131-002,2016,7,5,4,63,66,129,130
0131-002,2016,7,5,5,82,79,161,129
0131-002,2016,7,5,6,242,185,427,161
0131-002,2016,7,5,7,642,397,1039,427
0131-002,2016,7,5,8,1529,1041,2570,1039
0131-002,2016,7,5,9,1439,1319,2758,2570
0131-002,2016,7,5,10,965,1023,1988,2758
0131-002,2016,7,5,11,956,985,1941,1988
0131-002,2016,7,5,12,1003,1027,2030,1941
0131-002,2016,7,5,13,799,901,1700,2030
0131-002,2016,7,5,14,965,1000,1965,1700
0131-002,2016,7,5,15,1125,1170,2295,1965
0131-002,2016,7,5,16,984,1107,2091,2295
0131-002,2016,7,5,17,1010,1079,2089,2091
0131-002,2016,7,5,18,990,1188,2178,2089
0131-002,2016,7,5,19,949,1218,2167,2178
0131-002,2016,7,5,20,775,945,1720,2167
0131-002,2016,7,5,21,620,789,1409,1720
0131-002,2016,7,5,22,455,567,1022,1409
0131-002,2016,7,5,23,311,344,655,1022
0131-002,2016,7,5,24,225,205,430,655
0131-002,2016,7,6,1,139,127,266,430
0131-002,2016,7,6,2,82,85,167,266
0131-002,2016,7,6,3,77,71,148,167
0131-002,2016,7,6,4,59,70,129,148
0131-002,2016,7,6,5,78,84,162,129
0131-002,2016,7,6,6,250,175,425,162
0131-002,2016,7,6,7,606,396,1002,425
0131-002,2016,7,6,8,1510,988,2498,1002
0131-002,2016,7,6,9,1500,1357,2857,2498
0131-002,2016,7,6,10,1158,1116,2274,2857
0131-002,2016,7,6,11,1081,1028,2109,2274
0131-002,2016,7,6,12,1002,1089,2091,2109
0131-002,2016,7,6,13,899,932,1831,2091
0131-002,2016,7,6,14,986,1038,2024,1831
0131-002,2016,7,6,15,1116,1182,2298,2024
0131-002,2016,7,6,16,1093,1181,2274,2298
0131-002,2016,7,6,17,1068,1135,2203,2274
0131-002,2016,7,6,18,1180,1480,2660,2203
0131-002,2016,7,6,19,1036,1320,2356,2660
0131-002,2016,7,6,20,782,960,1742,2356
0131-002,2016,7,6,21,568,702,1270,1742
0131-002,2016,7,6,22,510,550,1060,1270
0131-002,2016,7,6,23,320,346,666,1060
0131-002,2016,7,6,24,217,214,431,666
0131-002,2016,7,7,1,129,165,294,431
0131-002,2016,7,7,2,93,88,181,294
0131-002,2016,7,7,3,78,78,156,181
0131-002,2016,7,7,4,68,79,147,156
0131-002,2016,7,7,5,93,91,184,147
0131-002,2016,7,7,6,281,208,489,184
0131-002,2016,7,7,7,780,483,1263,489
0131-002,2016,7,7,8,1627,1057,2684,1263
0131-002,2016,7,7,9,1513,1309,2822,2684
0131-002,2016,7,7,10,1128,1101,2229,2822
0131-002,2016,7,7,11,1100,1116,2216,2229
0131-002,2016,7,7,12,1080,1118,2198,2216
0131-002,2016,7,7,13,932,953,1885,2198
0131-002,2016,7,7,14,1068,1005,2073,1885
0131-002,2016,7,7,15,1162,1193,2355,2073
0131-002,2016,7,7,16,1102,1201,2303,2355
0131-002,2016,7,7,17,1097,1224,2321,2303
0131-002,2016,7,7,18,1095,1426,2521,2321
0131-002,2016,7,7,19,1063,1311,2374,2521
0131-002,2016,7,7,20,776,1004,1780,2374
0131-002,2016,7,7,21,632,824,1456,1780
0131-002,2016,7,7,22,493,557,1050,1456
0131-002,2016,7,7,23,343,401,744,1050
0131-002,2016,7,7,24,223,226,449,744
0131-002,2016,7,8,1,171,168,339,449
0131-002,2016,7,8,2,103,95,198,339
0131-002,2016,7,8,3,71,73,144,198
0131-002,2016,7,8,4,76,67,143,144
0131-002,2016,7,8,5,124,116,240,143
0131-002,2016,7,8,6,325,224,549,240
0131-002,2016,7,8,7,850,565,1415,549
0131-002,2016,7,8,8,1683,1089,2772,1415
0131-002,2016,7,8,9,1547,1425,2972,2772
0131-002,2016,7,8,10,1125,1115,2240,2972
0131-002,2016,7,8,11,1130,1093,2223,2240
0131-002,2016,7,8,12,1081,1055,2136,2223
0131-002,2016,7,8,13,872,994,1866,2136
0131-002,2016,7,8,14,1072,1078,2150,1866
0131-002,2016,7,8,15,1099,1197,2296,2150
0131-002,2016,7,8,16,1108,1190,2298,2296
0131-002,2016,7,8,17,1116,1227,2343,2298
0131-002,2016,7,8,18,1217,1708,2925,2343
0131-002,2016,7,8,19,1384,1761,3145,2925
0131-002,2016,7,8,20,969,1237,2206,3145
0131-002,2016,7,8,21,712,955,1667,2206
0131-002,2016,7,8,22,598,611,1209,1667
0131-002,2016,7,8,23,389,387,776,1209
0131-002,2016,7,8,24,259,235,494,776
0131-002,2016,7,9,1,165,167,332,494
0131-002,2016,7,9,2,93,107,200,332
0131-002,2016,7,9,3,100,105,205,200
0131-002,2016,7,9,4,86,95,181,205
0131-002,2016,7,9,5,124,133,257,181
0131-002,2016,7,9,6,313,220,533,257
0131-002,2016,7,9,7,604,427,1031,533
0131-002,2016,7,9,8,911,708,1619,1031
0131-002,2016,7,9,9,999,1004,2003,1619
0131-002,2016,7,9,10,954,1055,2009,2003
0131-002,2016,7,9,11,1003,1115,2118,2009
0131-002,2016,7,9,12,976,1126,2102,2118
0131-002,2016,7,9,13,881,1049,1930,2102
0131-002,2016,7,9,14,834,948,1782,1930
0131-002,2016,7,9,15,881,911,1792,1782
0131-002,2016,7,9,16,930,1032,1962,1792
0131-002,2016,7,9,17,917,1025,1942,1962
0131-002,2016,7,9,18,1038,1269,2307,1942
0131-002,2016,7,9,19,994,1061,2055,2307
0131-002,2016,7,9,20,650,685,1335,2055
0131-002,2016,7,9,21,485,472,957,1335
0131-002,2016,7,9,22,464,421,885,957
0131-002,2016,7,9,23,317,290,607,885
0131-002,2016,7,9,24,186,168,354,607
0131-002,2016,7,10,1,146,145,291,354
0131-002,2016,7,10,2,80,91,171,291
0131-002,2016,7,10,3,76,79,155,171
0131-002,2016,7,10,4,63,70,133,155
0131-002,2016,7,10,5,60,61,121,133
0131-002,2016,7,10,6,181,127,308,121
0131-002,2016,7,10,7,290,236,526,308
0131-002,2016,7,10,8,373,402,775,526
0131-002,2016,7,10,9,446,483,929,775
0131-002,2016,7,10,10,471,578,1049,929
0131-002,2016,7,10,11,569,642,1211,1049
0131-002,2016,7,10,12,582,592,1174,1211
0131-002,2016,7,10,13,682,545,1227,1174
0131-002,2016,7,10,14,637,589,1226,1227
0131-002,2016,7,10,15,746,721,1467,1226
0131-002,2016,7,10,16,1026,770,1796,1467
0131-002,2016,7,10,17,1024,813,1837,1796
0131-002,2016,7,10,18,1023,885,1908,1837
0131-002,2016,7,10,19,860,746,1606,1908
0131-002,2016,7,10,20,684,551,1235,1606
0131-002,2016,7,10,21,539,486,1025,1235
0131-002,2016,7,10,22,441,384,825,1025
0131-002,2016,7,10,23,316,253,569,825
0131-002,2016,7,10,24,203,157,360,569
0131-002,2016,7,11,1,115,94,209,360
0131-002,2016,7,11,2,65,67,132,209
0131-002,2016,7,11,3,34,37,71,132
0131-002,2016,7,11,4,43,50,93,71
0131-002,2016,7,11,5,75,77,152,93
0131-002,2016,7,11,6,368,220,588,152
0131-002,2016,7,11,7,980,563,1543,588
0131-002,2016,7,11,8,1892,1144,3036,1543
0131-002,2016,7,11,9,1588,1308,2896,3036
0131-002,2016,7,11,10,1117,1087,2204,2896
0131-002,2016,7,11,11,1113,1061,2174,2204
0131-002,2016,7,11,12,1026,1056,2082,2174
0131-002,2016,7,11,13,934,977,1911,2082
0131-002,2016,7,11,14,1004,994,1998,1911
0131-002,2016,7,11,15,1086,1144,2230,1998
0131-002,2016,7,11,16,1069,1184,2253,2230
0131-002,2016,7,11,17,1026,1264,2290,2253
0131-002,2016,7,11,18,1119,1473,2592,2290
0131-002,2016,7,11,19,1085,1337,2422,2592
0131-002,2016,7,11,20,816,1009,1825,2422
0131-002,2016,7,11,21,655,904,1559,1825
0131-002,2016,7,11,22,491,592,1083,1559
0131-002,2016,7,11,23,307,356,663,1083
0131-002,2016,7,11,24,210,180,390,663
0131-002,2016,7,12,1,145,136,281,390
0131-002,2016,7,12,2,89,91,180,281
0131-002,2016,7,12,3,60,48,108,180
0131-002,2016,7,12,4,63,74,137,108
0131-002,2016,7,12,5,71,77,148,137
0131-002,2016,7,12,6,272,180,452,148
0131-002,2016,7,12,7,697,430,1127,452
0131-002,2016,7,12,8,1611,1063,2674,1127
0131-002,2016,7,12,9,1459,1274,2733,2674
0131-002,2016,7,12,10,1145,1116,2261,2733
0131-002,2016,7,12,11,1072,1084,2156,2261
0131-002,2016,7,12,12,1002,1011,2013,2156
0131-002,2016,7,12,13,830,864,1694,2013
0131-002,2016,7,12,14,989,1017,2006,1694
0131-002,2016,7,12,15,1117,1171,2288,2006
0131-002,2016,7,12,16,1082,1103,2185,2288
0131-002,2016,7,12,17,1071,1126,2197,2185
0131-002,2016,7,12,18,1093,1389,2482,2197
0131-002,2016,7,12,19,1050,1295,2345,2482
0131-002,2016,7,12,20,750,930,1680,2345
0131-002,2016,7,12,21,654,801,1455,1680
0131-002,2016,7,12,22,467,599,1066,1455
0131-002,2016,7,12,23,333,396,729,1066
0131-002,2016,7,12,24,207,216,423,729
0131-002,2016,7,13,1,129,144,273,423
0131-002,2016,7,13,2,82,90,172,273
0131-002,2016,7,13,3,63,74,137,172
0131-002,2016,7,13,4,67,62,129,137
0131-002,2016,7,13,5,98,99,197,129
0131-002,2016,7,13,6,342,244,586,197
0131-002,2016,7,13,7,872,511,1383,586
0131-002,2016,7,13,8,1658,1057,2715,1383
0131-002,2016,7,13,9,1545,1346,2891,2715
0131-002,2016,7,13,10,1129,1107,2236,2891
0131-002,2016,7,13,11,1145,1082,2227,2236
0131-002,2016,7,13,12,1002,1082,2084,2227
0131-002,2016,7,13,13,908,942,1850,2084
0131-002,2016,7,13,14,1068,1034,2102,1850
0131-002,2016,7,13,15,1159,1210,2369,2102
0131-002,2016,7,13,16,1160,1164,2324,2369
0131-002,2016,7,13,17,1082,1215,2297,2324
0131-002,2016,7,13,18,1129,1595,2724,2297
0131-002,2016,7,13,19,1138,1451,2589,2724
0131-002,2016,7,13,20,858,989,1847,2589
0131-002,2016,7,13,21,645,776,1421,1847
0131-002,2016,7,13,22,521,601,1122,1421
0131-002,2016,7,13,23,349,401,750,1122
0131-002,2016,7,13,24,220,225,445,750
0131-002,2016,7,14,1,156,157,313,445
0131-002,2016,7,14,2,95,81,176,313
0131-002,2016,7,14,3,72,73,145,176
0131-002,2016,7,14,4,78,87,165,145
0131-002,2016,7,14,5,90,102,192,165
0131-002,2016,7,14,6,367,229,596,192
0131-002,2016,7,14,7,865,515,1380,596
0131-002,2016,7,14,8,1639,1099,2738,1380
0131-002,2016,7,14,9,1563,1323,2886,2738
0131-002,2016,7,14,10,1095,1108,2203,2886
0131-002,2016,7,14,11,1125,1113,2238,2203
0131-002,2016,7,14,12,1069,1097,2166,2238
0131-002,2016,7,14,13,917,925,1842,2166
0131-002,2016,7,14,14,1143,1091,2234,1842
0131-002,2016,7,14,15,1177,1147,2324,2234
0131-002,2016,7,14,16,1110,1166,2276,2324
0131-002,2016,7,14,17,980,1250,2230,2276
0131-002,2016,7,14,18,1095,1440,2535,2230
0131-002,2016,7,14,19,1065,1376,2441,2535
0131-002,2016,7,14,20,856,1047,1903,2441
0131-002,2016,7,14,21,667,875,1542,1903
0131-002,2016,7,14,22,478,623,1101,1542
0131-002,2016,7,14,23,352,372,724,1101
0131-002,2016,7,14,24,242,203,445,724
0131-002,2016,7,15,1,149,167,316,445
0131-002,2016,7,15,2,88,102,190,316
0131-002,2016,7,15,3,67,79,146,190
0131-002,2016,7,15,4,58,62,120,146
0131-002,2016,7,15,5,89,99,188,120
0131-002,2016,7,15,6,362,238,600,188
0131-002,2016,7,15,7,852,481,1333,600
0131-002,2016,7,15,8,1618,1087,2705,1333
0131-002,2016,7,15,9,1532,1352,2884,2705
0131-002,2016,7,15,10,1137,1140,2277,2884
0131-002,2016,7,15,11,1172,1170,2342,2277
0131-002,2016,7,15,12,1137,1119,2256,2342
0131-002,2016,7,15,13,960,971,1931,2256
0131-002,2016,7,15,14,1042,1136,2178,1931
0131-002,2016,7,15,15,1156,1271,2427,2178
0131-002,2016,7,15,16,1181,1295,2476,2427
0131-002,2016,7,15,17,1143,1446,2589,2476
0131-002,2016,7,15,18,1326,1781,3107,2589
0131-002,2016,7,15,19,1300,1697,2997,3107
0131-002,2016,7,15,20,995,1192,2187,2997
0131-002,2016,7,15,21,777,921,1698,2187
0131-002,2016,7,15,22,545,608,1153,1698
0131-002,2016,7,15,23,342,387,729,1153
0131-002,2016,7,15,24,199,197,396,729
0131-002,2016,7,16,1,160,169,329,396
0131-002,2016,7,16,2,112,135,247,329
0131-002,2016,7,16,3,90,89,179,247
0131-002,2016,7,16,4,71,87,158,179
0131-002,2016,7,16,5,76,71,147,158
0131-002,2016,7,16,6,206,174,380,147
0131-002,2016,7,16,7,368,289,657,380
0131-002,2016,7,16,8,737,637,1374,657
0131-002,2016,7,16,9,799,765,1564,1374
0131-002,2016,7,16,10,816,887,1703,1564
0131-002,2016,7,16,11,863,1069,1932,1703
0131-002,2016,7,16,12,877,1078,1955,1932
0131-002,2016,7,16,13,817,989,1806,1955
0131-002,2016,7,16,14,808,870,1678,1806
0131-002,2016,7,16,15,841,873,1714,1678
0131-002,2016,7,16,16,910,848,1758,1714
0131-002,2016,7,16,17,897,921,1818,1758
0131-002,2016,7,16,18,953,1062,2015,1818
0131-002,2016,7,16,19,894,796,1690,2015
0131-002,2016,7,16,20,588,575,1163,1690
0131-002,2016,7,16,21,454,465,919,1163
0131-002,2016,7,16,22,426,335,761,919
0131-002,2016,7,16,23,259,247,506,761
0131-002,2016,7,16,24,149,152,301,506
0131-002,2016,7,17,1,129,139,268,301
0131-002,2016,7,17,2,65,87,152,268
0131-002,2016,7,17,3,64,70,134,152
0131-002,2016,7,17,4,55,55,110,134
0131-002,2016,7,17,5,62,65,127,110
0131-002,2016,7,17,6,119,102,221,127
0131-002,2016,7,17,7,246,182,428,221
0131-002,2016,7,17,8,337,287,624,428
0131-002,2016,7,17,9,425,410,835,624
0131-002,2016,7,17,10,408,459,867,835
0131-002,2016,7,17,11,541,588,1129,867
0131-002,2016,7,17,12,546,556,1102,1129
0131-002,2016,7,17,13,600,571,1171,1102
0131-002,2016,7,17,14,623,569,1192,1171
0131-002,2016,7,17,15,650,699,1349,1192
0131-002,2016,7,17,16,703,762,1465,1349
0131-002,2016,7,17,17,886,851,1737,1465
0131-002,2016,7,17,18,883,869,1752,1737
0131-002,2016,7,17,19,800,639,1439,1752
0131-002,2016,7,17,20,678,531,1209,1439
0131-002,2016,7,17,21,738,476,1214,1209
0131-002,2016,7,17,22,472,385,857,1214
0131-002,2016,7,17,23,320,232,552,857
0131-002,2016,7,17,24,181,155,336,552
0131-002,2016,7,18,1,86,86,172,336
0131-002,2016,7,18,2,43,48,91,172
0131-002,2016,7,18,3,31,33,64,91
0131-002,2016,7,18,4,49,44,93,64
0131-002,2016,7,18,5,67,58,125,93
0131-002,2016,7,18,6,310,193,503,125
0131-002,2016,7,18,7,744,437,1181,503
0131-002,2016,7,18,8,1417,994,2411,1181
0131-002,2016,7,18,9,1164,1093,2257,2411
0131-002,2016,7,18,10,810,890,1700,2257
0131-002,2016,7,18,11,857,915,1772,1700
0131-002,2016,7,18,12,843,898,1741,1772
0131-002,2016,7,18,13,679,764,1443,1741
0131-002,2016,7,18,14,834,787,1621,1443
0131-002,2016,7,18,15,1100,1146,2246,1621
0131-002,2016,7,18,16,1038,1105,2143,2246
0131-002,2016,7,18,17,978,1165,2143,2143
0131-002,2016,7,18,18,1034,1471,2505,2143
0131-002,2016,7,18,19,1067,1294,2361,2505
0131-002,2016,7,18,20,767,1072,1839,2361
0131-002,2016,7,18,21,644,932,1576,1839
0131-002,2016,7,18,22,436,614,1050,1576
0131-002,2016,7,18,23,340,410,750,1050
0131-002,2016,7,18,24,237,247,484,750
0131-002,2016,7,19,1,148,163,311,484
0131-002,2016,7,19,2,113,117,230,311
0131-002,2016,7,19,3,80,82,162,230
0131-002,2016,7,19,4,89,115,204,162
0131-002,2016,7,19,5,124,121,245,204
0131-002,2016,7,19,6,398,270,668,245
0131-002,2016,7,19,7,912,444,1356,668
0131-002,2016,7,19,8,1574,1008,2582,1356
0131-002,2016,7,19,9,1457,1290,2747,2582
0131-002,2016,7,19,10,1102,1105,2207,2747
0131-002,2016,7,19,11,1106,1129,2235,2207
0131-002,2016,7,19,12,1042,1108,2150,2235
0131-002,2016,7,19,13,994,951,1945,2150
0131-002,2016,7,19,14,994,1034,2028,1945
0131-002,2016,7,19,15,1066,1240,2306,2028
0131-002,2016,7,19,16,1145,1196,2341,2306
0131-002,2016,7,19,17,1057,1245,2302,2341
0131-002,2016,7,19,18,1118,1572,2690,2302
0131-002,2016,7,19,19,1049,1340,2389,2690
0131-002,2016,7,19,20,757,1021,1778,2389
0131-002,2016,7,19,21,629,950,1579,1778
0131-002,2016,7,19,22,508,625,1133,1579
0131-002,2016,7,19,23,365,418,783,1133
0131-002,2016,7,19,24,260,245,505,783
0131-002,2016,7,20,1,132,144,276,505
0131-002,2016,7,20,2,107,112,219,276
0131-002,2016,7,20,3,75,87,162,219
0131-002,2016,7,20,4,84,95,179,162
0131-002,2016,7,20,5,111,109,220,179
0131-002,2016,7,20,6,395,243,638,220
0131-002,2016,7,20,7,920,511,1431,638
0131-002,2016,7,20,8,1573,1053,2626,1431
0131-002,2016,7,20,9,1453,1299,2752,2626
0131-002,2016,7,20,10,1135,1117,2252,2752
0131-002,2016,7,20,11,1132,1159,2291,2252
0131-002,2016,7,20,12,1057,1144,2201,2291
0131-002,2016,7,20,13,901,1010,1911,2201
0131-002,2016,7,20,14,963,1022,1985,1911
0131-002,2016,7,20,15,1142,1167,2309,1985
0131-002,2016,7,20,16,1094,1217,2311,2309
0131-002,2016,7,20,17,1028,1196,2224,2311
0131-002,2016,7,20,18,1080,1580,2660,2224
0131-002,2016,7,20,19,1077,1442,2519,2660
0131-002,2016,7,20,20,804,1005,1809,2519
0131-002,2016,7,20,21,634,811,1445,1809
0131-002,2016,7,20,22,460,637,1097,1445
0131-002,2016,7,20,23,309,430,739,1097
0131-002,2016,7,20,24,244,245,489,739
0131-002,2016,7,21,1,170,205,375,489
0131-002,2016,7,21,2,113,121,234,375
0131-002,2016,7,21,3,73,112,185,234
0131-002,2016,7,21,4,99,90,189,185
0131-002,2016,7,21,5,106,118,224,189
0131-002,2016,7,21,6,380,251,631,224
0131-002,2016,7,21,7,926,511,1437,631
0131-002,2016,7,21,8,1620,1040,2660,1437
0131-002,2016,7,21,9,1451,1244,2695,2660
0131-002,2016,7,21,10,1126,1075,2201,2695
0131-002,2016,7,21,11,1122,1144,2266,2201
0131-002,2016,7,21,12,1030,1120,2150,2266
0131-002,2016,7,21,13,905,955,1860,2150
0131-002,2016,7,21,14,1093,1045,2138,1860
0131-002,2016,7,21,15,1156,1250,2406,2138
0131-002,2016,7,21,16,1007,1172,2179,2406
0131-002,2016,7,21,17,1062,1254,2316,2179
0131-002,2016,7,21,18,1057,1506,2563,2316
0131-002,2016,7,21,19,1097,1351,2448,2563
0131-002,2016,7,21,20,734,1083,1817,2448
0131-002,2016,7,21,21,697,911,1608,1817
0131-002,2016,7,21,22,538,659,1197,1608
0131-002,2016,7,21,23,378,427,805,1197
0131-002,2016,7,21,24,243,255,498,805
0131-002,2016,7,22,1,176,188,364,498
0131-002,2016,7,22,2,107,130,237,364
0131-002,2016,7,22,3,77,79,156,237
0131-002,2016,7,22,4,83,109,192,156
0131-002,2016,7,22,5,128,122,250,192
0131-002,2016,7,22,6,405,234,639,250
0131-002,2016,7,22,7,862,496,1358,639
0131-002,2016,7,22,8,1606,1002,2608,1358
0131-002,2016,7,22,9,1515,1287,2802,2608
0131-002,2016,7,22,10,1032,1128,2160,2802
0131-002,2016,7,22,11,1101,1161,2262,2160
0131-002,2016,7,22,12,1078,1118,2196,2262
0131-002,2016,7,22,13,900,1011,1911,2196
0131-002,2016,7,22,14,1032,1124,2156,1911
0131-002,2016,7,22,15,1070,1237,2307,2156
0131-002,2016,7,22,16,1199,1214,2413,2307
0131-002,2016,7,22,17,1297,1259,2556,2413
0131-002,2016,7,22,18,1367,1511,2878,2556
0131-002,2016,7,22,19,1284,1581,2865,2878
0131-002,2016,7,22,20,1088,1113,2201,2865
0131-002,2016,7,22,21,785,945,1730,2201
0131-002,2016,7,22,22,624,642,1266,1730
0131-002,2016,7,22,23,409,449,858,1266
0131-002,2016,7,22,24,289,292,581,858
0131-002,2016,7,23,1,223,214,437,581
0131-002,2016,7,23,2,127,138,265,437
0131-002,2016,7,23,3,129,120,249,265
0131-002,2016,7,23,4,97,118,215,249
0131-002,2016,7,23,5,147,120,267,215
0131-002,2016,7,23,6,365,249,614,267
0131-002,2016,7,23,7,655,417,1072,614
0131-002,2016,7,23,8,892,668,1560,1072
0131-002,2016,7,23,9,1018,911,1929,1560
0131-002,2016,7,23,10,1100,1147,2247,1929
0131-002,2016,7,23,11,1144,1187,2331,2247
0131-002,2016,7,23,12,1328,1197,2525,2331
0131-002,2016,7,23,13,1195,1088,2283,2525
0131-002,2016,7,23,14,1149,1160,2309,2283
0131-002,2016,7,23,15,1026,992,2018,2309
0131-002,2016,7,23,16,1189,972,2161,2018
0131-002,2016,7,23,17,1045,1078,2123,2161
0131-002,2016,7,23,18,1031,1255,2286,2123
0131-002,2016,7,23,19,920,1076,1996,2286
0131-002,2016,7,23,20,735,688,1423,1996
0131-002,2016,7,23,21,579,581,1160,1423
0131-002,2016,7,23,22,531,453,984,1160
0131-002,2016,7,23,23,341,311,652,984
0131-002,2016,7,23,24,217,242,459,652
0131-002,2016,7,24,1,150,144,294,459
0131-002,2016,7,24,2,94,123,217,294
0131-002,2016,7,24,3,87,83,170,217
0131-002,2016,7,24,4,63,65,128,170
0131-002,2016,7,24,5,82,83,165,128
0131-002,2016,7,24,6,185,149,334,165
0131-002,2016,7,24,7,365,220,585,334
0131-002,2016,7,24,8,368,328,696,585
0131-002,2016,7,24,9,453,468,921,696
0131-002,2016,7,24,10,469,555,1024,921
0131-002,2016,7,24,11,575,619,1194,1024
0131-002,2016,7,24,12,597,652,1249,1194
0131-002,2016,7,24,13,671,617,1288,1249
0131-002,2016,7,24,14,739,640,1379,1288
0131-002,2016,7,24,15,845,713,1558,1379
0131-002,2016,7,24,16,917,772,1689,1558
0131-002,2016,7,24,17,995,833,1828,1689
0131-002,2016,7,24,18,983,852,1835,1828
0131-002,2016,7,24,19,934,725,1659,1835
0131-002,2016,7,24,20,900,511,1411,1659
0131-002,2016,7,24,21,707,483,1190,1411
0131-002,2016,7,24,22,560,403,963,1190
0131-002,2016,7,24,23,346,301,647,963
0131-002,2016,7,24,24,241,193,434,647
0131-002,2016,7,25,1,145,108,253,434
0131-002,2016,7,25,2,64,84,148,253
0131-002,2016,7,25,3,69,68,137,148
0131-002,2016,7,25,4,71,85,156,137
0131-002,2016,7,25,5,116,87,203,156
0131-002,2016,7,25,6,433,232,665,203
0131-002,2016,7,25,7,1018,544,1562,665
0131-002,2016,7,25,8,1829,1065,2894,1562
0131-002,2016,7,25,9,1473,1232,2705,2894
0131-002,2016,7,25,10,1038,1039,2077,2705
0131-002,2016,7,25,11,1084,1176,2260,2077
0131-002,2016,7,25,12,1068,1105,2173,2260
0131-002,2016,7,25,13,897,967,1864,2173
0131-002,2016,7,25,14,1009,1003,2012,1864
0131-002,2016,7,25,15,1051,1424,2475,2012
0131-002,2016,7,25,16,1097,1241,2338,2475
0131-002,2016,7,25,17,1017,1228,2245,2338
0131-002,2016,7,25,18,943,1373,2316,2245
0131-002,2016,7,25,19,1126,1297,2423,2316
0131-002,2016,7,25,20,839,1088,1927,2423
0131-002,2016,7,25,21,662,983,1645,1927
0131-002,2016,7,25,22,517,650,1167,1645
0131-002,2016,7,25,23,381,430,811,1167
0131-002,2016,7,25,24,208,216,424,811
0131-002,2016,7,26,1,163,138,301,424
0131-002,2016,7,26,2,93,116,209,301
0131-002,2016,7,26,3,86,66,152,209
0131-002,2016,7,26,4,75,93,168,152
0131-002,2016,7,26,5,125,124,249,168
0131-002,2016,7,26,6,405,270,675,249
0131-002,2016,7,26,7,899,547,1446,675
0131-002,2016,7,26,8,1600,1001,2601,1446
0131-002,2016,7,26,9,1382,1295,2677,2601
0131-002,2016,7,26,10,1177,1139,2316,2677
0131-002,2016,7,26,11,1182,1124,2306,2316
0131-002,2016,7,26,12,1090,1176,2266,2306
0131-002,2016,7,26,13,953,1004,1957,2266
0131-002,2016,7,26,14,985,1053,2038,1957
0131-002,2016,7,26,15,1077,1168,2245,2038
0131-002,2016,7,26,16,1092,1249,2341,2245
0131-002,2016,7,26,17,1071,1255,2326,2341
0131-002,2016,7,26,18,1127,1412,2539,2326
0131-002,2016,7,26,19,1058,1388,2446,2539
0131-002,2016,7,26,20,744,1106,1850,2446
0131-002,2016,7,26,21,643,937,1580,1850
0131-002,2016,7,26,22,585,682,1267,1580
0131-002,2016,7,26,23,381,455,836,1267
0131-002,2016,7,26,24,227,254,481,836
0131-002,2016,7,27,1,173,168,341,481
0131-002,2016,7,27,2,98,138,236,341
0131-002,2016,7,27,3,105,102,207,236
0131-002,2016,7,27,4,75,97,172,207
0131-002,2016,7,27,5,134,112,246,172
0131-002,2016,7,27,6,399,240,639,246
0131-002,2016,7,27,7,873,521,1394,639
0131-002,2016,7,27,8,1558,996,2554,1394
0131-002,2016,7,27,9,1358,1276,2634,2554
0131-002,2016,7,27,10,1100,1132,2232,2634
0131-002,2016,7,27,11,1078,1167,2245,2232
0131-002,2016,7,27,12,1060,1072,2132,2245
0131-002,2016,7,27,13,908,989,1897,2132
0131-002,2016,7,27,14,1006,1091,2097,1897
0131-002,2016,7,27,15,1019,1186,2205,2097
0131-002,2016,7,27,16,1076,1171,2247,2205
0131-002,2016,7,27,17,1020,1173,2193,2247
0131-002,2016,7,27,18,1076,1570,2646,2193
0131-002,2016,7,27,19,1072,1433,2505,2646
0131-002,2016,7,27,20,732,1039,1771,2505
0131-002,2016,7,27,21,570,790,1360,1771
0131-002,2016,7,27,22,505,598,1103,1360
0131-002,2016,7,27,23,369,420,789,1103
0131-002,2016,7,27,24,255,231,486,789
0131-002,2016,7,28,1,171,149,320,486
0131-002,2016,7,28,2,110,100,210,320
0131-002,2016,7,28,3,98,85,183,210
0131-002,2016,7,28,4,82,105,187,183
0131-002,2016,7,28,5,134,118,252,187
0131-002,2016,7,28,6,372,226,598,252
0131-002,2016,7,28,7,838,473,1311,598
0131-002,2016,7,28,8,1504,1007,2511,1311
0131-002,2016,7,28,9,1407,1223,2630,2511
0131-002,2016,7,28,10,1087,1083,2170,2630
0131-002,2016,7,28,11,1145,1144,2289,2170
0131-002,2016,7,28,12,1058,1085,2143,2289
0131-002,2016,7,28,13,968,1012,1980,2143
0131-002,2016,7,28,14,971,996,1967,1980
0131-002,2016,7,28,15,1074,1183,2257,1967
0131-002,2016,7,28,16,1080,1167,2247,2257
0131-002,2016,7,28,17,1036,1254,2290,2247
0131-002,2016,7,28,18,1065,1492,2557,2290
0131-002,2016,7,28,19,1052,1396,2448,2557
0131-002,2016,7,28,20,808,1062,1870,2448
0131-002,2016,7,28,21,708,892,1600,1870
0131-002,2016,7,28,22,491,654,1145,1600
0131-002,2016,7,28,23,408,421,829,1145
0131-002,2016,7,28,24,219,267,486,829
0131-002,2016,7,29,1,192,181,373,486
0131-002,2016,7,29,2,103,111,214,373
0131-002,2016,7,29,3,84,85,169,214
0131-002,2016,7,29,4,70,81,151,169
0131-002,2016,7,29,5,137,111,248,151
0131-002,2016,7,29,6,379,238,617,248
0131-002,2016,7,29,7,886,492,1378,617
0131-002,2016,7,29,8,1532,997,2529,1378
0131-002,2016,7,29,9,1352,1265,2617,2529
0131-002,2016,7,29,10,972,1071,2043,2617
0131-002,2016,7,29,11,998,1078,2076,2043
0131-002,2016,7,29,12,955,1058,2013,2076
0131-002,2016,7,29,13,867,1103,1970,2013
0131-002,2016,7,29,14,960,1166,2126,1970
0131-002,2016,7,29,15,963,1227,2190,2126
0131-002,2016,7,29,16,1010,1341,2351,2190
0131-002,2016,7,29,17,1088,1298,2386,2351
0131-002,2016,7,29,18,1179,1674,2853,2386
0131-002,2016,7,29,19,1152,1541,2693,2853
0131-002,2016,7,29,20,926,1212,2138,2693
0131-002,2016,7,29,21,693,1062,1755,2138
0131-002,2016,7,29,22,632,631,1263,1755
0131-002,2016,7,29,23,337,438,775,1263
0131-002,2016,7,29,24,224,286,510,775
0131-002,2016,7,30,1,192,211,403,510
0131-002,2016,7,30,2,131,123,254,403
0131-002,2016,7,30,3,102,105,207,254
0131-002,2016,7,30,4,100,92,192,207
0131-002,2016,7,30,5,134,122,256,192
0131-002,2016,7,30,6,306,270,576,256
0131-002,2016,7,30,7,567,445,1012,576
0131-002,2016,7,30,8,789,691,1480,1012
0131-002,2016,7,30,9,860,1075,1935,1480
0131-002,2016,7,30,10,841,1473,2314,1935
0131-002,2016,7,30,11,905,1761,2666,2314
0131-002,2016,7,30,12,872,1412,2284,2666
0131-002,2016,7,30,13,876,1351,2227,2284
0131-002,2016,7,30,14,865,1210,2075,2227
0131-002,2016,7,30,15,882,1101,1983,2075
0131-002,2016,7,30,16,881,1015,1896,1983
0131-002,2016,7,30,17,858,999,1857,1896
0131-002,2016,7,30,18,880,1134,2014,1857
0131-002,2016,7,30,19,821,956,1777,2014
0131-002,2016,7,30,20,662,735,1397,1777
0131-002,2016,7,30,21,526,553,1079,1397
0131-002,2016,7,30,22,495,431,926,1079
0131-002,2016,7,30,23,339,308,647,926
0131-002,2016,7,30,24,205,209,414,647
0131-002,2016,7,31,1,141,157,298,414
0131-002,2016,7,31,2,111,122,233,298
0131-002,2016,7,31,3,65,72,137,233
0131-002,2016,7,31,4,70,67,137,137
0131-002,2016,7,31,5,90,100,190,137
0131-002,2016,7,31,6,182,169,351,190
0131-002,2016,7,31,7,356,241,597,351
0131-002,2016,7,31,8,366,328,694,597
0131-002,2016,7,31,9,415,490,905,694
0131-002,2016,7,31,10,476,578,1054,905
0131-002,2016,7,31,11,551,710,1261,1054
0131-002,2016,7,31,12,566,675,1241,1261
0131-002,2016,7,31,13,531,683,1214,1241
0131-002,2016,7,31,14,589,769,1358,1214
0131-002,2016,7,31,15,645,697,1342,1358
0131-002,2016,7,31,16,812,803,1615,1342
0131-002,2016,7,31,17,815,843,1658,1615
0131-002,2016,7,31,18,850,916,1766,1658
0131-002,2016,7,31,19,826,762,1588,1766
0131-002,2016,7,31,20,659,540,1199,1588
0131-002,2016,7,31,21,602,519,1121,1199
0131-002,2016,7,31,22,483,399,882,1121
0131-002,2016,7,31,23,385,275,660,882
0131-002,2016,7,31,24,215,193,408,660
0131-002,2016,8,1,1,157,117,274,408
0131-002,2016,8,1,2,94,75,169,274
0131-002,2016,8,1,3,61,53,114,169
0131-002,2016,8,1,4,53,60,113,114
0131-002,2016,8,1,5,107,91,198,113
0131-002,2016,8,1,6,331,231,562,198
0131-002,2016,8,1,7,731,455,1186,562
0131-002,2016,8,1,8,1185,846,2031,1186
0131-002,2016,8,1,9,1012,1019,2031,2031
0131-002,2016,8,1,10,858,905,1763,2031
0131-002,2016,8,1,11,881,941,1822,1763
0131-002,2016,8,1,12,933,988,1921,1822
0131-002,2016,8,1,13,875,879,1754,1921
0131-002,2016,8,1,14,855,946,1801,1754
0131-002,2016,8,1,15,909,992,1901,1801
0131-002,2016,8,1,16,857,951,1808,1901
0131-002,2016,8,1,17,860,1011,1871,1808
0131-002,2016,8,1,18,894,1255,2149,1871
0131-002,2016,8,1,19,1005,1147,2152,2149
0131-002,2016,8,1,20,750,776,1526,2152
0131-002,2016,8,1,21,573,675,1248,1526
0131-002,2016,8,1,22,420,453,873,1248
0131-002,2016,8,1,23,297,312,609,873
0131-002,2016,8,1,24,206,222,428,609
0131-002,2016,8,2,1,137,168,305,428
0131-002,2016,8,2,2,89,86,175,305
0131-002,2016,8,2,3,69,79,148,175
0131-002,2016,8,2,4,73,73,146,148
0131-002,2016,8,2,5,97,93,190,146
0131-002,2016,8,2,6,303,187,490,190
0131-002,2016,8,2,7,670,441,1111,490
0131-002,2016,8,2,8,1052,745,1797,1111
0131-002,2016,8,2,9,1016,1014,2030,1797
0131-002,2016,8,2,10,834,911,1745,2030
0131-002,2016,8,2,11,930,926,1856,1745
0131-002,2016,8,2,12,906,921,1827,1856
0131-002,2016,8,2,13,803,790,1593,1827
0131-002,2016,8,2,14,826,915,1741,1593
0131-002,2016,8,2,15,912,986,1898,1741
0131-002,2016,8,2,16,892,994,1886,1898
0131-002,2016,8,2,17,889,1017,1906,1886
0131-002,2016,8,2,18,1060,1284,2344,1906
0131-002,2016,8,2,19,1062,1189,2251,2344
0131-002,2016,8,2,20,845,810,1655,2251
0131-002,2016,8,2,21,611,652,1263,1655
0131-002,2016,8,2,22,415,490,905,1263
0131-002,2016,8,2,23,310,334,644,905
0131-002,2016,8,2,24,244,225,469,644
0131-002,2016,8,3,1,140,160,300,469
0131-002,2016,8,3,2,80,85,165,300
0131-002,2016,8,3,3,63,69,132,165
0131-002,2016,8,3,4,81,101,182,132
0131-002,2016,8,3,5,97,110,207,182
0131-002,2016,8,3,6,298,196,494,207
0131-002,2016,8,3,7,668,432,1100,494
0131-002,2016,8,3,8,1039,760,1799,1100
0131-002,2016,8,3,9,1013,1032,2045,1799
0131-002,2016,8,3,10,854,921,1775,2045
0131-002,2016,8,3,11,933,926,1859,1775
0131-002,2016,8,3,12,848,965,1813,1859
0131-002,2016,8,3,13,725,844,1569,1813
0131-002,2016,8,3,14,897,941,1838,1569
0131-002,2016,8,3,15,881,1005,1886,1838
0131-002,2016,8,3,16,904,944,1848,1886
0131-002,2016,8,3,17,866,1110,1976,1848
0131-002,2016,8,3,18,996,1224,2220,1976
0131-002,2016,8,3,19,1152,1178,2330,2220
0131-002,2016,8,3,20,710,860,1570,2330
0131-002,2016,8,3,21,583,648,1231,1570
0131-002,2016,8,3,22,471,476,947,1231
0131-002,2016,8,3,23,349,339,688,947
0131-002,2016,8,3,24,219,203,422,688
0131-002,2016,8,4,1,168,139,307,422
0131-002,2016,8,4,2,116,121,237,307
0131-002,2016,8,4,3,64,83,147,237
0131-002,2016,8,4,4,69,99,168,147
0131-002,2016,8,4,5,117,96,213,168
0131-002,2016,8,4,6,334,175,509,213
0131-002,2016,8,4,7,732,468,1200,509
0131-002,2016,8,4,8,1222,830,2052,1200
0131-002,2016,8,4,9,1137,1102,2239,2052
0131-002,2016,8,4,10,922,957,1879,2239
0131-002,2016,8,4,11,952,961,1913,1879
0131-002,2016,8,4,12,961,1052,2013,1913
0131-002,2016,8,4,13,781,880,1661,2013
0131-002,2016,8,4,14,914,942,1856,1661
0131-002,2016,8,4,15,951,1044,1995,1856
0131-002,2016,8,4,16,946,964,1910,1995
0131-002,2016,8,4,17,898,1061,1959,1910
0131-002,2016,8,4,18,989,1267,2256,1959
0131-002,2016,8,4,19,1001,1211,2212,2256
0131-002,2016,8,4,20,719,867,1586,2212
0131-002,2016,8,4,21,562,728,1290,1586
0131-002,2016,8,4,22,427,472,899,1290
0131-002,2016,8,4,23,308,347,655,899
0131-002,2016,8,4,24,222,232,454,655
0131-002,2016,8,5,1,134,157,291,454
0131-002,2016,8,5,2,97,103,200,291
0131-002,2016,8,5,3,67,83,150,200
0131-002,2016,8,5,4,80,89,169,150
0131-002,2016,8,5,5,115,123,238,169
0131-002,2016,8,5,6,318,198,516,238
0131-002,2016,8,5,7,683,446,1129,516
0131-002,2016,8,5,8,1213,884,2097,1129
0131-002,2016,8,5,9,1160,1082,2242,2097
0131-002,2016,8,5,10,947,951,1898,2242
0131-002,2016,8,5,11,947,1020,1967,1898
0131-002,2016,8,5,12,964,1041,2005,1967
0131-002,2016,8,5,13,827,950,1777,2005
0131-002,2016,8,5,14,885,999,1884,1777
0131-002,2016,8,5,15,1011,1074,2085,1884
0131-002,2016,8,5,16,934,1058,1992,2085
0131-002,2016,8,5,17,913,1073,1986,1992
0131-002,2016,8,5,18,1007,1404,2411,1986
0131-002,2016,8,5,19,1131,1407,2538,2411
0131-002,2016,8,5,20,842,956,1798,2538
0131-002,2016,8,5,21,649,748,1397,1798
0131-002,2016,8,5,22,537,508,1045,1397
0131-002,2016,8,5,23,332,393,725,1045
0131-002,2016,8,5,24,238,233,471,725
0131-002,2016,8,6,1,174,199,373,471
0131-002,2016,8,6,2,105,116,221,373
0131-002,2016,8,6,3,75,99,174,221
0131-002,2016,8,6,4,86,93,179,174
0131-002,2016,8,6,5,133,99,232,179
0131-002,2016,8,6,6,291,173,464,232
0131-002,2016,8,6,7,549,397,946,464
0131-002,2016,8,6,8,779,656,1435,946
0131-002,2016,8,6,9,798,787,1585,1435
0131-002,2016,8,6,10,807,850,1657,1585
0131-002,2016,8,6,11,780,939,1719,1657
0131-002,2016,8,6,12,837,993,1830,1719
0131-002,2016,8,6,13,864,943,1807,1830
0131-002,2016,8,6,14,772,929,1701,1807
0131-002,2016,8,6,15,783,902,1685,1701
0131-002,2016,8,6,16,793,902,1695,1685
0131-002,2016,8,6,17,829,1058,1887,1695
0131-002,2016,8,6,18,945,1098,2043,1887
0131-002,2016,8,6,19,884,948,1832,2043
0131-002,2016,8,6,20,661,658,1319,1832
0131-002,2016,8,6,21,528,610,1138,1319
0131-002,2016,8,6,22,555,432,987,1138
0131-002,2016,8,6,23,352,295,647,987
0131-002,2016,8,6,24,191,200,391,647
0131-002,2016,8,7,1,146,164,310,391
0131-002,2016,8,7,2,95,95,190,310
0131-002,2016,8,7,3,75,80,155,190
0131-002,2016,8,7,4,68,58,126,155
0131-002,2016,8,7,5,85,76,161,126
0131-002,2016,8,7,6,166,105,271,161
0131-002,2016,8,7,7,263,225,488,271
0131-002,2016,8,7,8,372,312,684,488
0131-002,2016,8,7,9,444,456,900,684
0131-002,2016,8,7,10,488,546,1034,900
0131-002,2016,8,7,11,529,602,1131,1034
0131-002,2016,8,7,12,571,658,1229,1131
0131-002,2016,8,7,13,549,678,1227,1229
0131-002,2016,8,7,14,658,620,1278,1227
0131-002,2016,8,7,15,685,771,1456,1278
0131-002,2016,8,7,16,719,712,1431,1456
0131-002,2016,8,7,17,741,792,1533,1431
0131-002,2016,8,7,18,836,799,1635,1533
0131-002,2016,8,7,19,803,696,1499,1635
0131-002,2016,8,7,20,669,547,1216,1499
0131-002,2016,8,7,21,522,470,992,1216
0131-002,2016,8,7,22,512,416,928,992
0131-002,2016,8,7,23,398,269,667,928
0131-002,2016,8,7,24,245,177,422,667
0131-002,2016,8,8,1,147,90,237,422
0131-002,2016,8,8,2,93,84,177,237
0131-002,2016,8,8,3,55,69,124,177
0131-002,2016,8,8,4,76,66,142,124
0131-002,2016,8,8,5,104,114,218,142
0131-002,2016,8,8,6,415,194,609,218
0131-002,2016,8,8,7,963,506,1469,609
0131-002,2016,8,8,8,1764,1052,2816,1469
0131-002,2016,8,8,9,1447,1208,2655,2816
0131-002,2016,8,8,10,1045,1027,2072,2655
0131-002,2016,8,8,11,1076,1124,2200,2072
0131-002,2016,8,8,12,1050,1109,2159,2200
0131-002,2016,8,8,13,935,1014,1949,2159
0131-002,2016,8,8,14,979,1023,2002,1949
0131-002,2016,8,8,15,1029,1147,2176,2002
0131-002,2016,8,8,16,1100,1211,2311,2176
0131-002,2016,8,8,17,1082,1224,2306,2311
0131-002,2016,8,8,18,1327,1450,2777,2306
0131-002,2016,8,8,19,1347,1376,2723,2777
0131-002,2016,8,8,20,856,1001,1857,2723
0131-002,2016,8,8,21,646,925,1571,1857
0131-002,2016,8,8,22,494,607,1101,1571
0131-002,2016,8,8,23,311,390,701,1101
0131-002,2016,8,8,24,241,223,464,701
0131-002,2016,8,9,1,145,138,283,464
0131-002,2016,8,9,2,87,125,212,283
0131-002,2016,8,9,3,79,83,162,212
0131-002,2016,8,9,4,89,98,187,162
0131-002,2016,8,9,5,141,116,257,187
0131-002,2016,8,9,6,394,232,626,257
0131-002,2016,8,9,7,858,462,1320,626
0131-002,2016,8,9,8,1577,1075,2652,1320
0131-002,2016,8,9,9,1394,1320,2714,2652
0131-002,2016,8,9,10,1102,1167,2269,2714
0131-002,2016,8,9,11,1132,1151,2283,2269
0131-002,2016,8,9,12,1097,1186,2283,2283
0131-002,2016,8,9,13,947,986,1933,2283
0131-002,2016,8,9,14,1013,1120,2133,1933
0131-002,2016,8,9,15,1057,1284,2341,2133
0131-002,2016,8,9,16,1076,1170,2246,2341
0131-002,2016,8,9,17,1126,1156,2282,2246
0131-002,2016,8,9,18,1125,1447,2572,2282
0131-002,2016,8,9,19,996,1377,2373,2572
0131-002,2016,8,9,20,801,1048,1849,2373
0131-002,2016,8,9,21,682,1016,1698,1849
0131-002,2016,8,9,22,493,591,1084,1698
0131-002,2016,8,9,23,355,431,786,1084
0131-002,2016,8,9,24,240,243,483,786
0131-002,2016,8,10,1,177,162,339,483
0131-002,2016,8,10,2,115,108,223,339
0131-002,2016,8,10,3,89,103,192,223
0131-002,2016,8,10,4,89,92,181,192
0131-002,2016,8,10,5,130,129,259,181
0131-002,2016,8,10,6,355,206,561,259
0131-002,2016,8,10,7,817,485,1302,561
0131-002,2016,8,10,8,1495,1034,2529,1302
0131-002,2016,8,10,9,1351,1286,2637,2529
0131-002,2016,8,10,10,1063,1120,2183,2637
0131-002,2016,8,10,11,1207,1098,2305,2183
0131-002,2016,8,10,12,1037,1134,2171,2305
0131-002,2016,8,10,13,943,1041,1984,2171
0131-002,2016,8,10,14,1114,1061,2175,1984
0131-002,2016,8,10,15,1125,1194,2319,2175
0131-002,2016,8,10,16,1105,1164,2269,2319
0131-002,2016,8,10,17,1013,1233,2246,2269
0131-002,2016,8,10,18,1052,1489,2541,2246
0131-002,2016,8,10,19,1122,1374,2496,2541
0131-002,2016,8,10,20,797,1048,1845,2496
0131-002,2016,8,10,21,604,876,1480,1845
0131-002,2016,8,10,22,502,584,1086,1480
0131-002,2016,8,10,23,373,378,751,1086
0131-002,2016,8,10,24,218,245,463,751
0131-002,2016,8,11,1,196,175,371,463
0131-002,2016,8,11,2,111,98,209,371
0131-002,2016,8,11,3,90,88,178,209
0131-002,2016,8,11,4,81,94,175,178
0131-002,2016,8,11,5,114,139,253,175
0131-002,2016,8,11,6,384,205,589,253
0131-002,2016,8,11,7,849,513,1362,589
0131-002,2016,8,11,8,1583,1038,2621,1362
0131-002,2016,8,11,9,1438,1337,2775,2621
0131-002,2016,8,11,10,1068,1071,2139,2775
0131-002,2016,8,11,11,1090,1117,2207,2139
0131-002,2016,8,11,12,987,1184,2171,2207
0131-002,2016,8,11,13,904,1235,2139,2171
0131-002,2016,8,11,14,1000,1125,2125,2139
0131-002,2016,8,11,15,1061,1153,2214,2125
0131-002,2016,8,11,16,1068,1193,2261,2214
0131-002,2016,8,11,17,1031,1275,2306,2261
0131-002,2016,8,11,18,1075,1427,2502,2306
0131-002,2016,8,11,19,1025,1404,2429,2502
0131-002,2016,8,11,20,831,1032,1863,2429
0131-002,2016,8,11,21,604,968,1572,1863
0131-002,2016,8,11,22,516,605,1121,1572
0131-002,2016,8,11,23,332,397,729,1121
0131-002,2016,8,11,24,242,219,461,729
0131-002,2016,8,12,1,156,177,333,461
0131-002,2016,8,12,2,123,100,223,333
0131-002,2016,8,12,3,90,92,182,223
0131-002,2016,8,12,4,97,122,219,182
0131-002,2016,8,12,5,129,123,252,219
0131-002,2016,8,12,6,379,225,604,252
0131-002,2016,8,12,7,832,473,1305,604
0131-002,2016,8,12,8,1613,996,2609,1305
0131-002,2016,8,12,9,1428,1281,2709,2609
0131-002,2016,8,12,10,1084,1148,2232,2709
0131-002,2016,8,12,11,1163,1166,2329,2232
0131-002,2016,8,12,12,1019,1170,2189,2329
0131-002,2016,8,12,13,918,1041,1959,2189
0131-002,2016,8,12,14,1037,1127,2164,1959
0131-002,2016,8,12,15,1126,1220,2346,2164
0131-002,2016,8,12,16,1078,1303,2381,2346
0131-002,2016,8,12,17,1008,1327,2335,2381
0131-002,2016,8,12,18,1076,1640,2716,2335
0131-002,2016,8,12,19,1128,1793,2921,2716
0131-002,2016,8,12,20,1016,1312,2328,2921
0131-002,2016,8,12,21,767,1109,1876,2328
0131-002,2016,8,12,22,628,730,1358,1876
0131-002,2016,8,12,23,409,445,854,1358
0131-002,2016,8,12,24,277,291,568,854
0131-002,2016,8,13,1,225,203,428,568
0131-002,2016,8,13,2,148,157,305,428
0131-002,2016,8,13,3,105,134,239,305
0131-002,2016,8,13,4,97,139,236,239
0131-002,2016,8,13,5,158,146,304,236
0131-002,2016,8,13,6,378,228,606,304
0131-002,2016,8,13,7,574,480,1054,606
0131-002,2016,8,13,8,909,705,1614,1054
0131-002,2016,8,13,9,922,1062,1984,1614
0131-002,2016,8,13,10,905,1163,2068,1984
0131-002,2016,8,13,11,936,1349,2285,2068
0131-002,2016,8,13,12,975,1161,2136,2285
0131-002,2016,8,13,13,858,1217,2075,2136
0131-002,2016,8,13,14,851,1197,2048,2075
0131-002,2016,8,13,15,986,1121,2107,2048
0131-002,2016,8,13,16,918,1117,2035,2107
0131-002,2016,8,13,17,1007,1105,2112,2035
0131-002,2016,8,13,18,1165,1317,2482,2112
0131-002,2016,8,13,19,959,1150,2109,2482
0131-002,2016,8,13,20,717,797,1514,2109
0131-002,2016,8,13,21,553,603,1156,1514
0131-002,2016,8,13,22,540,424,964,1156
0131-002,2016,8,13,23,302,357,659,964
0131-002,2016,8,13,24,188,225,413,659
0131-002,2016,8,14,1,165,147,312,413
0131-002,2016,8,14,2,96,95,191,312
0131-002,2016,8,14,3,79,83,162,191
0131-002,2016,8,14,4,63,77,140,162
0131-002,2016,8,14,5,83,87,170,140
0131-002,2016,8,14,6,182,124,306,170
0131-002,2016,8,14,7,300,206,506,306
0131-002,2016,8,14,8,370,289,659,506
0131-002,2016,8,14,9,402,416,818,659
0131-002,2016,8,14,10,510,603,1113,818
0131-002,2016,8,14,11,564,661,1225,1113
0131-002,2016,8,14,12,564,677,1241,1225
0131-002,2016,8,14,13,581,634,1215,1241
0131-002,2016,8,14,14,618,670,1288,1215
0131-002,2016,8,14,15,608,675,1283,1288
0131-002,2016,8,14,16,628,725,1353,1283
0131-002,2016,8,14,17,802,769,1571,1353
0131-002,2016,8,14,18,915,801,1716,1571
0131-002,2016,8,14,19,859,706,1565,1716
0131-002,2016,8,14,20,756,604,1360,1565
0131-002,2016,8,14,21,616,509,1125,1360
0131-002,2016,8,14,22,628,373,1001,1125
0131-002,2016,8,14,23,349,292,641,1001
0131-002,2016,8,14,24,230,178,408,641
0131-002,2016,8,15,1,159,140,299,408
0131-002,2016,8,15,2,115,106,221,299
0131-002,2016,8,15,3,71,71,142,221
0131-002,2016,8,15,4,71,70,141,142
0131-002,2016,8,15,5,100,81,181,141
0131-002,2016,8,15,6,302,158,460,181
0131-002,2016,8,15,7,542,342,884,460
0131-002,2016,8,15,8,730,500,1230,884
0131-002,2016,8,15,9,690,592,1282,1230
0131-002,2016,8,15,10,643,660,1303,1282
0131-002,2016,8,15,11,738,806,1544,1303
0131-002,2016,8,15,12,782,892,1674,1544
0131-002,2016,8,15,13,801,828,1629,1674
0131-002,2016,8,15,14,827,791,1618,1629
0131-002,2016,8,15,15,883,917,1800,1618
0131-002,2016,8,15,16,936,898,1834,1800
0131-002,2016,8,15,17,919,968,1887,1834
0131-002,2016,8,15,18,944,1218,2162,1887
0131-002,2016,8,15,19,926,923,1849,2162
0131-002,2016,8,15,20,831,636,1467,1849
0131-002,2016,8,15,21,753,569,1322,1467
0131-002,2016,8,15,22,478,417,895,1322
0131-002,2016,8,15,23,372,311,683,895
0131-002,2016,8,15,24,250,191,441,683
0131-002,2016,8,16,1,175,130,305,441
0131-002,2016,8,16,2,101,95,196,305
0131-002,2016,8,16,3,70,63,133,196
0131-002,2016,8,16,4,94,74,168,133
0131-002,2016,8,16,5,123,104,227,168
0131-002,2016,8,16,6,356,234,590,227
0131-002,2016,8,16,7,840,522,1362,590
0131-002,2016,8,16,8,1772,1036,2808,1362
0131-002,2016,8,16,9,1450,1267,2717,2808
0131-002,2016,8,16,10,1055,1108,2163,2717
0131-002,2016,8,16,11,1150,1149,2299,2163
0131-002,2016,8,16,12,1062,1047,2109,2299
0131-002,2016,8,16,13,934,1017,1951,2109
0131-002,2016,8,16,14,1061,991,2052,1951
0131-002,2016,8,16,15,1071,1195,2266,2052
0131-002,2016,8,16,16,1115,1124,2239,2266
0131-002,2016,8,16,17,1067,1217,2284,2239
0131-002,2016,8,16,18,1128,1453,2581,2284
0131-002,2016,8,16,19,1031,1336,2367,2581
0131-002,2016,8,16,20,800,997,1797,2367
0131-002,2016,8,16,21,665,991,1656,1797
0131-002,2016,8,16,22,483,662,1145,1656
0131-002,2016,8,16,23,309,416,725,1145
0131-002,2016,8,16,24,227,193,420,725
0131-002,2016,8,17,1,148,179,327,420
0131-002,2016,8,17,2,118,121,239,327
0131-002,2016,8,17,3,71,85,156,239
0131-002,2016,8,17,4,111,94,205,156
0131-002,2016,8,17,5,124,132,256,205
0131-002,2016,8,17,6,425,237,662,256
0131-002,2016,8,17,7,808,512,1320,662
0131-002,2016,8,17,8,1667,986,2653,1320
0131-002,2016,8,17,9,1378,1331,2709,2653
0131-002,2016,8,17,10,1129,1127,2256,2709
0131-002,2016,8,17,11,1007,1129,2136,2256
0131-002,2016,8,17,12,1137,1105,2242,2136
0131-002,2016,8,17,13,924,1060,1984,2242
0131-002,2016,8,17,14,1074,1035,2109,1984
0131-002,2016,8,17,15,1074,1193,2267,2109
0131-002,2016,8,17,16,1147,1123,2270,2267
0131-002,2016,8,17,17,982,1183,2165,2270
0131-002,2016,8,17,18,1046,1556,2602,2165
0131-002,2016,8,17,19,1074,1487,2561,2602
0131-002,2016,8,17,20,766,1076,1842,2561
0131-002,2016,8,17,21,632,890,1522,1842
0131-002,2016,8,17,22,462,613,1075,1522
0131-002,2016,8,17,23,360,348,708,1075
0131-002,2016,8,17,24,257,220,477,708
0131-002,2016,8,18,1,185,157,342,477
0131-002,2016,8,18,2,107,120,227,342
0131-002,2016,8,18,3,77,93,170,227
0131-002,2016,8,18,4,103,106,209,170
0131-002,2016,8,18,5,111,126,237,209
0131-002,2016,8,18,6,393,225,618,237
0131-002,2016,8,18,7,906,481,1387,618
0131-002,2016,8,18,8,1594,1056,2650,1387
0131-002,2016,8,18,9,1435,1291,2726,2650
0131-002,2016,8,18,10,1098,1124,2222,2726
0131-002,2016,8,18,11,1087,1140,2227,2222
0131-002,2016,8,18,12,1028,1200,2228,2227
0131-002,2016,8,18,13,942,989,1931,2228
0131-002,2016,8,18,14,1021,1124,2145,1931
0131-002,2016,8,18,15,1135,1157,2292,2145
0131-002,2016,8,18,16,1115,1210,2325,2292
0131-002,2016,8,18,17,1039,1200,2239,2325
0131-002,2016,8,18,18,1024,1502,2526,2239
0131-002,2016,8,18,19,1014,1357,2371,2526
0131-002,2016,8,18,20,758,1046,1804,2371
0131-002,2016,8,18,21,610,982,1592,1804
0131-002,2016,8,18,22,502,618,1120,1592
0131-002,2016,8,18,23,381,415,796,1120
0131-002,2016,8,18,24,242,229,471,796
0131-002,2016,8,19,1,174,159,333,471
0131-002,2016,8,19,2,107,114,221,333
0131-002,2016,8,19,3,88,93,181,221
0131-002,2016,8,19,4,90,114,204,181
0131-002,2016,8,19,5,154,119,273,204
0131-002,2016,8,19,6,404,232,636,273
0131-002,2016,8,19,7,821,484,1305,636
0131-002,2016,8,19,8,1645,1026,2671,1305
0131-002,2016,8,19,9,1439,1279,2718,2671
0131-002,2016,8,19,10,1138,1078,2216,2718
0131-002,2016,8,19,11,1106,1153,2259,2216
0131-002,2016,8,19,12,1047,1183,2230,2259
0131-002,2016,8,19,13,939,1090,2029,2230
0131-002,2016,8,19,14,1039,1095,2134,2029
0131-002,2016,8,19,15,1094,1231,2325,2134
0131-002,2016,8,19,16,1053,1250,2303,2325
0131-002,2016,8,19,17,1018,1357,2375,2303
0131-002,2016,8,19,18,1132,1641,2773,2375
0131-002,2016,8,19,19,1107,1649,2756,2773
0131-002,2016,8,19,20,867,1201,2068,2756
0131-002,2016,8,19,21,696,1016,1712,2068
0131-002,2016,8,19,22,563,629,1192,1712
0131-002,2016,8,19,23,384,400,784,1192
0131-002,2016,8,19,24,282,290,572,784
0131-002,2016,8,20,1,211,190,401,572
0131-002,2016,8,20,2,137,149,286,401
0131-002,2016,8,20,3,101,95,196,286
0131-002,2016,8,20,4,89,103,192,196
0131-002,2016,8,20,5,131,133,264,192
0131-002,2016,8,20,6,363,206,569,264
0131-002,2016,8,20,7,683,448,1131,569
0131-002,2016,8,20,8,942,648,1590,1131
0131-002,2016,8,20,9,957,985,1942,1590
0131-002,2016,8,20,10,887,929,1816,1942
0131-002,2016,8,20,11,908,974,1882,1816
0131-002,2016,8,20,12,1059,1063,2122,1882
0131-002,2016,8,20,13,1276,923,2199,2122
0131-002,2016,8,20,14,910,911,1821,2199
0131-002,2016,8,20,15,878,955,1833,1821
0131-002,2016,8,20,16,843,985,1828,1833
0131-002,2016,8,20,17,855,1099,1954,1828
0131-002,2016,8,20,18,924,1367,2291,1954
0131-002,2016,8,20,19,946,1151,2097,2291
0131-002,2016,8,20,20,706,705,1411,2097
0131-002,2016,8,20,21,539,562,1101,1411
0131-002,2016,8,20,22,494,398,892,1101
0131-002,2016,8,20,23,365,357,722,892
0131-002,2016,8,20,24,204,208,412,722
0131-002,2016,8,21,1,171,169,340,412
0131-002,2016,8,21,2,94,104,198,340
0131-002,2016,8,21,3,92,86,178,198
0131-002,2016,8,21,4,73,80,153,178
0131-002,2016,8,21,5,103,89,192,153
0131-002,2016,8,21,6,187,129,316,192
0131-002,2016,8,21,7,311,264,575,316
0131-002,2016,8,21,8,383,328,711,575
0131-002,2016,8,21,9,426,494,920,711
0131-002,2016,8,21,10,460,544,1004,920
0131-002,2016,8,21,11,530,614,1144,1004
0131-002,2016,8,21,12,613,699,1312,1144
0131-002,2016,8,21,13,628,705,1333,1312
0131-002,2016,8,21,14,657,713,1370,1333
0131-002,2016,8,21,15,722,819,1541,1370
0131-002,2016,8,21,16,813,830,1643,1541
0131-002,2016,8,21,17,767,815,1582,1643
0131-002,2016,8,21,18,819,940,1759,1582
0131-002,2016,8,21,19,834,739,1573,1759
0131-002,2016,8,21,20,651,555,1206,1573
0131-002,2016,8,21,21,571,497,1068,1206
0131-002,2016,8,21,22,498,421,919,1068
0131-002,2016,8,21,23,360,271,631,919
0131-002,2016,8,21,24,238,192,430,631
0131-002,2016,8,22,1,130,121,251,430
0131-002,2016,8,22,2,85,72,157,251
0131-002,2016,8,22,3,80,73,153,157
0131-002,2016,8,22,4,77,69,146,153
0131-002,2016,8,22,5,99,95,194,146
0131-002,2016,8,22,6,442,235,677,194
0131-002,2016,8,22,7,988,579,1567,677
0131-002,2016,8,22,8,1874,1100,2974,1567
0131-002,2016,8,22,9,1472,1251,2723,2974
0131-002,2016,8,22,10,1089,1006,2095,2723
0131-002,2016,8,22,11,1095,1177,2272,2095
0131-002,2016,8,22,12,1010,1080,2090,2272
0131-002,2016,8,22,13,972,954,1926,2090
0131-002,2016,8,22,14,1016,1055,2071,1926
0131-002,2016,8,22,15,1078,1156,2234,2071
0131-002,2016,8,22,16,1060,1167,2227,2234
0131-002,2016,8,22,17,966,1253,2219,2227
0131-002,2016,8,22,18,1058,1454,2512,2219
0131-002,2016,8,22,19,1049,1342,2391,2512
0131-002,2016,8,22,20,768,1052,1820,2391
0131-002,2016,8,22,21,598,1027,1625,1820
0131-002,2016,8,22,22,527,608,1135,1625
0131-002,2016,8,22,23,344,411,755,1135
0131-002,2016,8,22,24,212,226,438,755
0131-002,2016,8,23,1,150,171,321,438
0131-002,2016,8,23,2,113,90,203,321
0131-002,2016,8,23,3,85,86,171,203
0131-002,2016,8,23,4,80,100,180,171
0131-002,2016,8,23,5,110,141,251,180
0131-002,2016,8,23,6,419,217,636,251
0131-002,2016,8,23,7,899,543,1442,636
0131-002,2016,8,23,8,1663,1087,2750,1442
0131-002,2016,8,23,9,1392,1320,2712,2750
0131-002,2016,8,23,10,1201,1147,2348,2712
0131-002,2016,8,23,11,1355,1062,2417,2348
0131-002,2016,8,23,12,1269,1161,2430,2417
0131-002,2016,8,23,13,961,994,1955,2430
0131-002,2016,8,23,14,1072,1064,2136,1955
0131-002,2016,8,23,15,1102,1183,2285,2136
0131-002,2016,8,23,16,1046,1201,2247,2285
0131-002,2016,8,23,17,1039,1307,2346,2247
0131-002,2016,8,23,18,1106,1543,2649,2346
0131-002,2016,8,23,19,1044,1364,2408,2649
0131-002,2016,8,23,20,789,1021,1810,2408
0131-002,2016,8,23,21,613,1009,1622,1810
0131-002,2016,8,23,22,483,575,1058,1622
0131-002,2016,8,23,23,308,416,724,1058
0131-002,2016,8,23,24,250,216,466,724
0131-002,2016,8,24,1,163,168,331,466
0131-002,2016,8,24,2,109,105,214,331
0131-002,2016,8,24,3,94,95,189,214
0131-002,2016,8,24,4,89,108,197,189
0131-002,2016,8,24,5,113,114,227,197
0131-002,2016,8,24,6,438,223,661,227
0131-002,2016,8,24,7,884,516,1400,661
0131-002,2016,8,24,8,1658,1093,2751,1400
0131-002,2016,8,24,9,1521,1370,2891,2751
0131-002,2016,8,24,10,1152,1087,2239,2891
0131-002,2016,8,24,11,1177,1166,2343,2239
0131-002,2016,8,24,12,1126,1186,2312,2343
0131-002,2016,8,24,13,924,949,1873,2312
0131-002,2016,8,24,14,1080,1101,2181,1873
0131-002,2016,8,24,15,1143,1221,2364,2181
0131-002,2016,8,24,16,1095,1236,2331,2364
0131-002,2016,8,24,17,1048,1320,2368,2331
0131-002,2016,8,24,18,1172,1492,2664,2368
0131-002,2016,8,24,19,1064,1453,2517,2664
0131-002,2016,8,24,20,817,1023,1840,2517
0131-002,2016,8,24,21,612,883,1495,1840
0131-002,2016,8,24,22,518,587,1105,1495
0131-002,2016,8,24,23,366,417,783,1105
0131-002,2016,8,24,24,232,252,484,783
0131-002,2016,8,25,1,168,183,351,484
0131-002,2016,8,25,2,89,102,191,351
0131-002,2016,8,25,3,112,98,210,191
0131-002,2016,8,25,4,93,86,179,210
0131-002,2016,8,25,5,115,128,243,179
0131-002,2016,8,25,6,422,235,657,243
0131-002,2016,8,25,7,882,492,1374,657
0131-002,2016,8,25,8,1644,1028,2672,1374
0131-002,2016,8,25,9,1484,1302,2786,2672
0131-002,2016,8,25,10,1201,1148,2349,2786
0131-002,2016,8,25,11,1146,1106,2252,2349
0131-002,2016,8,25,12,1053,1112,2165,2252
0131-002,2016,8,25,13,921,985,1906,2165
0131-002,2016,8,25,14,981,1074,2055,1906
0131-002,2016,8,25,15,1160,1197,2357,2055
0131-002,2016,8,25,16,1108,1271,2379,2357
0131-002,2016,8,25,17,1029,1268,2297,2379
0131-002,2016,8,25,18,1074,1535,2609,2297
0131-002,2016,8,25,19,1108,1401,2509,2609
0131-002,2016,8,25,20,761,1095,1856,2509
0131-002,2016,8,25,21,606,961,1567,1856
0131-002,2016,8,25,22,448,581,1029,1567
0131-002,2016,8,25,23,354,406,760,1029
0131-002,2016,8,25,24,240,233,473,760
0131-002,2016,8,26,1,147,164,311,473
0131-002,2016,8,26,2,110,107,217,311
0131-002,2016,8,26,3,90,76,166,217
0131-002,2016,8,26,4,89,85,174,166
0131-002,2016,8,26,5,107,125,232,174
0131-002,2016,8,26,6,375,220,595,232
0131-002,2016,8,26,7,787,467,1254,595
0131-002,2016,8,26,8,1468,993,2461,1254
0131-002,2016,8,26,9,1452,1327,2779,2461
0131-002,2016,8,26,10,1097,1113,2210,2779
0131-002,2016,8,26,11,1062,1164,2226,2210
0131-002,2016,8,26,12,1069,1130,2199,2226
0131-002,2016,8,26,13,933,1057,1990,2199
0131-002,2016,8,26,14,995,1165,2160,1990
0131-002,2016,8,26,15,1022,1274,2296,2160
0131-002,2016,8,26,16,1074,1281,2355,2296
0131-002,2016,8,26,17,1102,1354,2456,2355
0131-002,2016,8,26,18,1082,1657,2739,2456
0131-002,2016,8,26,19,1177,1662,2839,2739
0131-002,2016,8,26,20,828,1242,2070,2839
0131-002,2016,8,26,21,663,955,1618,2070
0131-002,2016,8,26,22,552,611,1163,1618
0131-002,2016,8,26,23,389,456,845,1163
0131-002,2016,8,26,24,264,271,535,845
0131-002,2016,8,27,1,164,218,382,535
0131-002,2016,8,27,2,137,132,269,382
0131-002,2016,8,27,3,97,116,213,269
0131-002,2016,8,27,4,95,108,203,213
0131-002,2016,8,27,5,116,129,245,203
0131-002,2016,8,27,6,370,241,611,245
0131-002,2016,8,27,7,666,466,1132,611
0131-002,2016,8,27,8,961,801,1762,1132
0131-002,2016,8,27,9,946,1053,1999,1762
0131-002,2016,8,27,10,897,1197,2094,1999
0131-002,2016,8,27,11,938,1312,2250,2094
0131-002,2016,8,27,12,938,1287,2225,2250
0131-002,2016,8,27,13,880,1300,2180,2225
0131-002,2016,8,27,14,1077,1113,2190,2180
0131-002,2016,8,27,15,1337,1173,2510,2190
0131-002,2016,8,27,16,1149,1236,2385,2510
0131-002,2016,8,27,17,1203,1245,2448,2385
0131-002,2016,8,27,18,1179,1530,2709,2448
0131-002,2016,8,27,19,1102,1261,2363,2709
0131-002,2016,8,27,20,992,782,1774,2363
0131-002,2016,8,27,21,793,669,1462,1774
0131-002,2016,8,27,22,641,473,1114,1462
0131-002,2016,8,27,23,343,353,696,1114
0131-002,2016,8,27,24,210,222,432,696
0131-002,2016,8,28,1,136,177,313,432
0131-002,2016,8,28,2,96,115,211,313
0131-002,2016,8,28,3,82,72,154,211
0131-002,2016,8,28,4,65,87,152,154
0131-002,2016,8,28,5,70,90,160,152
0131-002,2016,8,28,6,188,164,352,160
0131-002,2016,8,28,7,341,298,639,352
0131-002,2016,8,28,8,492,461,953,639
0131-002,2016,8,28,9,439,541,980,953
0131-002,2016,8,28,10,505,511,1016,980
0131-002,2016,8,28,11,584,685,1269,1016
0131-002,2016,8,28,12,724,683,1407,1269
0131-002,2016,8,28,13,718,656,1374,1407
0131-002,2016,8,28,14,804,720,1524,1374
0131-002,2016,8,28,15,1004,811,1815,1524
0131-002,2016,8,28,16,965,910,1875,1815
0131-002,2016,8,28,17,962,936,1898,1875
0131-002,2016,8,28,18,1028,994,2022,1898
0131-002,2016,8,28,19,991,1005,1996,2022
0131-002,2016,8,28,20,894,737,1631,1996
0131-002,2016,8,28,21,795,666,1461,1631
0131-002,2016,8,28,22,903,490,1393,1461
0131-002,2016,8,28,23,758,281,1039,1393
0131-002,2016,8,28,24,481,179,660,1039
0131-002,2016,8,29,1,157,114,271,660
0131-002,2016,8,29,2,79,65,144,271
0131-002,2016,8,29,3,64,49,113,144
0131-002,2016,8,29,4,60,61,121,113
0131-002,2016,8,29,5,125,105,230,121
0131-002,2016,8,29,6,441,232,673,230
0131-002,2016,8,29,7,1005,556,1561,673
0131-002,2016,8,29,8,1794,1091,2885,1561
0131-002,2016,8,29,9,1580,1306,2886,2885
0131-002,2016,8,29,10,1059,1047,2106,2886
0131-002,2016,8,29,11,1111,1183,2294,2106
0131-002,2016,8,29,12,1103,1129,2232,2294
0131-002,2016,8,29,13,945,1024,1969,2232
0131-002,2016,8,29,14,1061,1076,2137,1969
0131-002,2016,8,29,15,1141,1237,2378,2137
0131-002,2016,8,29,16,1027,1281,2308,2378
0131-002,2016,8,29,17,1181,1266,2447,2308
0131-002,2016,8,29,18,1098,1432,2530,2447
0131-002,2016,8,29,19,1069,1477,2546,2530
0131-002,2016,8,29,20,757,1113,1870,2546
0131-002,2016,8,29,21,601,924,1525,1870
0131-002,2016,8,29,22,526,608,1134,1525
0131-002,2016,8,29,23,338,418,756,1134
0131-002,2016,8,29,24,209,203,412,756
0131-002,2016,8,30,1,159,155,314,412
0131-002,2016,8,30,2,110,102,212,314
0131-002,2016,8,30,3,89,70,159,212
0131-002,2016,8,30,4,95,101,196,159
0131-002,2016,8,30,5,127,126,253,196
0131-002,2016,8,30,6,418,239,657,253
0131-002,2016,8,30,7,884,540,1424,657
0131-002,2016,8,30,8,1676,1048,2724,1424
0131-002,2016,8,30,9,1449,1306,2755,2724
0131-002,2016,8,30,10,1130,1164,2294,2755
0131-002,2016,8,30,11,1066,1144,2210,2294
0131-002,2016,8,30,12,1125,1062,2187,2210
0131-002,2016,8,30,13,977,1042,2019,2187
0131-002,2016,8,30,14,967,1114,2081,2019
0131-002,2016,8,30,15,1133,1250,2383,2081
0131-002,2016,8,30,16,1154,1167,2321,2383
0131-002,2016,8,30,17,1000,1303,2303,2321
0131-002,2016,8,30,18,1055,1437,2492,2303
0131-002,2016,8,30,19,983,1362,2345,2492
0131-002,2016,8,30,20,769,1045,1814,2345
0131-002,2016,8,30,21,629,904,1533,1814
0131-002,2016,8,30,22,467,653,1120,1533
0131-002,2016,8,30,23,311,405,716,1120
0131-002,2016,8,30,24,227,202,429,716
0131-002,2016,8,31,1,122,148,270,429
0131-002,2016,8,31,2,86,87,173,270
0131-002,2016,8,31,3,81,94,175,173
0131-002,2016,8,31,4,67,78,145,175
0131-002,2016,8,31,5,112,107,219,145
0131-002,2016,8,31,6,283,185,468,219
0131-002,2016,8,31,7,710,425,1135,468
0131-002,2016,8,31,8,1544,981,2525,1135
0131-002,2016,8,31,9,1392,1277,2669,2525
0131-002,2016,8,31,10,1053,1038,2091,2669
0131-002,2016,8,31,11,1029,1087,2116,2091
0131-002,2016,8,31,12,929,1027,1956,2116
0131-002,2016,8,31,13,868,839,1707,1956
0131-002,2016,8,31,14,919,1009,1928,1707
0131-002,2016,8,31,15,957,1130,2087,1928
0131-002,2016,8,31,16,1043,1087,2130,2087
0131-002,2016,8,31,17,963,1103,2066,2130
0131-002,2016,8,31,18,1037,1457,2494,2066
0131-002,2016,8,31,19,1005,1366,2371,2494
0131-002,2016,8,31,20,802,1000,1802,2371
0131-002,2016,8,31,21,582,812,1394,1802
0131-002,2016,8,31,22,445,579,1024,1394
0131-002,2016,8,31,23,377,448,825,1024
0131-002,2016,8,31,24,257,248,505,825
0131-002,2016,9,1,1,189,176,365,505
0131-002,2016,9,1,2,111,111,222,365
0131-002,2016,9,1,3,66,78,144,222
0131-002,2016,9,1,4,80,91,171,144
0131-002,2016,9,1,5,133,126,259,171
0131-002,2016,9,1,6,359,199,558,259
0131-002,2016,9,1,7,824,473,1297,558
0131-002,2016,9,1,8,1646,1033,2679,1297
0131-002,2016,9,1,9,1482,1335,2817,2679
0131-002,2016,9,1,10,1139,1103,2242,2817
0131-002,2016,9,1,11,1124,1167,2291,2242
0131-002,2016,9,1,12,1130,1090,2220,2291
0131-002,2016,9,1,13,993,994,1987,2220
0131-002,2016,9,1,14,1044,1082,2126,1987
0131-002,2016,9,1,15,1096,1198,2294,2126
0131-002,2016,9,1,16,1118,1182,2300,2294
0131-002,2016,9,1,17,1023,1236,2259,2300
0131-002,2016,9,1,18,1052,1477,2529,2259
0131-002,2016,9,1,19,1088,1419,2507,2529
0131-002,2016,9,1,20,798,1079,1877,2507
0131-002,2016,9,1,21,615,936,1551,1877
0131-002,2016,9,1,22,519,653,1172,1551
0131-002,2016,9,1,23,371,437,808,1172
0131-002,2016,9,1,24,274,259,533,808
0131-002,2016,9,2,1,195,188,383,533
0131-002,2016,9,2,2,103,120,223,383
0131-002,2016,9,2,3,86,80,166,223
0131-002,2016,9,2,4,99,97,196,166
0131-002,2016,9,2,5,119,99,218,196
0131-002,2016,9,2,6,363,205,568,218
0131-002,2016,9,2,7,841,487,1328,568
0131-002,2016,9,2,8,1677,986,2663,1328
0131-002,2016,9,2,9,1456,1287,2743,2663
0131-002,2016,9,2,10,1092,1109,2201,2743
0131-002,2016,9,2,11,1163,1223,2386,2201
0131-002,2016,9,2,12,1136,1113,2249,2386
0131-002,2016,9,2,13,967,1051,2018,2249
0131-002,2016,9,2,14,1060,1173,2233,2018
0131-002,2016,9,2,15,1161,1235,2396,2233
0131-002,2016,9,2,16,1123,1293,2416,2396
0131-002,2016,9,2,17,1198,1370,2568,2416
0131-002,2016,9,2,18,1316,1694,3010,2568
0131-002,2016,9,2,19,1243,1635,2878,3010
0131-002,2016,9,2,20,889,1250,2139,2878
0131-002,2016,9,2,21,718,1034,1752,2139
0131-002,2016,9,2,22,615,720,1335,1752
0131-002,2016,9,2,23,364,488,852,1335
0131-002,2016,9,2,24,251,267,518,852
0131-002,2016,9,3,1,189,199,388,518
0131-002,2016,9,3,2,130,143,273,388
0131-002,2016,9,3,3,102,104,206,273
0131-002,2016,9,3,4,97,118,215,206
0131-002,2016,9,3,5,115,134,249,215
0131-002,2016,9,3,6,309,228,537,249
0131-002,2016,9,3,7,664,514,1178,537
0131-002,2016,9,3,8,969,732,1701,1178
0131-002,2016,9,3,9,970,1208,2178,1701
0131-002,2016,9,3,10,938,1250,2188,2178
0131-002,2016,9,3,11,1018,1264,2282,2188
0131-002,2016,9,3,12,1023,1298,2321,2282
0131-002,2016,9,3,13,1089,1212,2301,2321
0131-002,2016,9,3,14,986,1222,2208,2301
0131-002,2016,9,3,15,966,1120,2086,2208
0131-002,2016,9,3,16,1035,1078,2113,2086
0131-002,2016,9,3,17,1002,1201,2203,2113
0131-002,2016,9,3,18,1136,1520,2656,2203
0131-002,2016,9,3,19,1011,1224,2235,2656
0131-002,2016,9,3,20,768,823,1591,2235
0131-002,2016,9,3,21,800,657,1457,1591
0131-002,2016,9,3,22,607,476,1083,1457
0131-002,2016,9,3,23,338,318,656,1083
0131-002,2016,9,3,24,225,219,444,656
0131-002,2016,9,4,1,162,161,323,444
0131-002,2016,9,4,2,93,114,207,323
0131-002,2016,9,4,3,75,87,162,207
0131-002,2016,9,4,4,68,86,154,162
0131-002,2016,9,4,5,76,91,167,154
0131-002,2016,9,4,6,213,177,390,167
0131-002,2016,9,4,7,376,317,693,390
0131-002,2016,9,4,8,473,704,1177,693
0131-002,2016,9,4,9,483,811,1294,1177
0131-002,2016,9,4,10,525,686,1211,1294
0131-002,2016,9,4,11,573,690,1263,1211
0131-002,2016,9,4,12,680,736,1416,1263
0131-002,2016,9,4,13,712,738,1450,1416
0131-002,2016,9,4,14,829,796,1625,1450
0131-002,2016,9,4,15,944,872,1816,1625
0131-002,2016,9,4,16,1084,954,2038,1816
0131-002,2016,9,4,17,1157,1003,2160,2038
0131-002,2016,9,4,18,1161,1020,2181,2160
0131-002,2016,9,4,19,1172,875,2047,2181
0131-002,2016,9,4,20,1007,620,1627,2047
0131-002,2016,9,4,21,949,549,1498,1627
0131-002,2016,9,4,22,598,446,1044,1498
0131-002,2016,9,4,23,374,260,634,1044
0131-002,2016,9,4,24,253,167,420,634
0131-002,2016,9,5,1,157,117,274,420
0131-002,2016,9,5,2,89,70,159,274
0131-002,2016,9,5,3,52,71,123,159
0131-002,2016,9,5,4,83,77,160,123
0131-002,2016,9,5,5,121,85,206,160
0131-002,2016,9,5,6,428,242,670,206
0131-002,2016,9,5,7,1011,574,1585,670
0131-002,2016,9,5,8,1892,1111,3003,1585
0131-002,2016,9,5,9,1599,1299,2898,3003
0131-002,2016,9,5,10,1056,1094,2150,2898
0131-002,2016,9,5,11,1114,1176,2290,2150
0131-002,2016,9,5,12,999,1109,2108,2290
0131-002,2016,9,5,13,958,1028,1986,2108
0131-002,2016,9,5,14,1070,1137,2207,1986
0131-002,2016,9,5,15,1162,1223,2385,2207
0131-002,2016,9,5,16,1121,1274,2395,2385
0131-002,2016,9,5,17,1154,1248,2402,2395
0131-002,2016,9,5,18,1070,1565,2635,2402
0131-002,2016,9,5,19,1094,1368,2462,2635
0131-002,2016,9,5,20,833,1155,1988,2462
0131-002,2016,9,5,21,677,989,1666,1988
0131-002,2016,9,5,22,496,669,1165,1666
0131-002,2016,9,5,23,377,408,785,1165
0131-002,2016,9,5,24,198,242,440,785
0131-002,2016,9,6,1,147,144,291,440
0131-002,2016,9,6,2,110,95,205,291
0131-002,2016,9,6,3,70,86,156,205
0131-002,2016,9,6,4,80,84,164,156
0131-002,2016,9,6,5,113,118,231,164
0131-002,2016,9,6,6,411,229,640,231
0131-002,2016,9,6,7,876,526,1402,640
0131-002,2016,9,6,8,1743,1066,2809,1402
0131-002,2016,9,6,9,1535,1306,2841,2809
0131-002,2016,9,6,10,1187,1217,2404,2841
0131-002,2016,9,6,11,1107,1195,2302,2404
0131-002,2016,9,6,12,1072,1183,2255,2302
0131-002,2016,9,6,13,975,1019,1994,2255
0131-002,2016,9,6,14,1046,1065,2111,1994
0131-002,2016,9,6,15,1117,1217,2334,2111
0131-002,2016,9,6,16,1149,1224,2373,2334
0131-002,2016,9,6,17,1069,1351,2420,2373
0131-002,2016,9,6,18,1156,1545,2701,2420
0131-002,2016,9,6,19,1104,1413,2517,2701
0131-002,2016,9,6,20,783,1121,1904,2517
0131-002,2016,9,6,21,680,992,1672,1904
0131-002,2016,9,6,22,488,672,1160,1672
0131-002,2016,9,6,23,398,420,818,1160
0131-002,2016,9,6,24,247,263,510,818
0131-002,2016,9,7,1,173,164,337,510
0131-002,2016,9,7,2,107,104,211,337
0131-002,2016,9,7,3,89,86,175,211
0131-002,2016,9,7,4,86,103,189,175
0131-002,2016,9,7,5,116,144,260,189
0131-002,2016,9,7,6,377,215,592,260
0131-002,2016,9,7,7,884,538,1422,592
0131-002,2016,9,7,8,1746,1018,2764,1422
0131-002,2016,9,7,9,1455,1336,2791,2764
0131-002,2016,9,7,10,1191,1194,2385,2791
0131-002,2016,9,7,11,1203,1220,2423,2385
0131-002,2016,9,7,12,1175,1232,2407,2423
0131-002,2016,9,7,13,979,1021,2000,2407
0131-002,2016,9,7,14,1119,1112,2231,2000
0131-002,2016,9,7,15,1207,1258,2465,2231
0131-002,2016,9,7,16,1143,1269,2412,2465
0131-002,2016,9,7,17,1056,1307,2363,2412
0131-002,2016,9,7,18,1187,1715,2902,2363
0131-002,2016,9,7,19,1067,1569,2636,2902
0131-002,2016,9,7,20,764,1081,1845,2636
0131-002,2016,9,7,21,616,897,1513,1845
0131-002,2016,9,7,22,535,584,1119,1513
0131-002,2016,9,7,23,390,434,824,1119
0131-002,2016,9,7,24,246,255,501,824
0131-002,2016,9,8,1,180,212,392,501
0131-002,2016,9,8,2,105,132,237,392
0131-002,2016,9,8,3,93,122,215,237
0131-002,2016,9,8,4,82,101,183,215
0131-002,2016,9,8,5,137,121,258,183
0131-002,2016,9,8,6,389,227,616,258
0131-002,2016,9,8,7,906,482,1388,616
0131-002,2016,9,8,8,1770,1099,2869,1388
0131-002,2016,9,8,9,1557,1348,2905,2869
0131-002,2016,9,8,10,1261,1236,2497,2905
0131-002,2016,9,8,11,1176,1267,2443,2497
0131-002,2016,9,8,12,1072,1210,2282,2443
0131-002,2016,9,8,13,994,1054,2048,2282
0131-002,2016,9,8,14,1130,1033,2163,2048
0131-002,2016,9,8,15,1149,1327,2476,2163
0131-002,2016,9,8,16,1171,1364,2535,2476
0131-002,2016,9,8,17,1202,1339,2541,2535
0131-002,2016,9,8,18,1185,1622,2807,2541
0131-002,2016,9,8,19,1083,1535,2618,2807
0131-002,2016,9,8,20,797,1152,1949,2618
0131-002,2016,9,8,21,644,973,1617,1949
0131-002,2016,9,8,22,554,718,1272,1617
0131-002,2016,9,8,23,403,481,884,1272
0131-002,2016,9,8,24,260,287,547,884
0131-002,2016,9,9,1,175,182,357,547
0131-002,2016,9,9,2,96,104,200,357
0131-002,2016,9,9,3,119,83,202,200
0131-002,2016,9,9,4,90,113,203,202
0131-002,2016,9,9,5,123,135,258,203
0131-002,2016,9,9,6,386,243,629,258
0131-002,2016,9,9,7,892,519,1411,629
0131-002,2016,9,9,8,1752,1075,2827,1411
0131-002,2016,9,9,9,1574,1260,2834,2827
0131-002,2016,9,9,10,1212,1215,2427,2834
0131-002,2016,9,9,11,1181,1274,2455,2427
0131-002,2016,9,9,12,1132,1238,2370,2455
0131-002,2016,9,9,13,1013,1046,2059,2370
0131-002,2016,9,9,14,1090,1125,2215,2059
0131-002,2016,9,9,15,1222,1337,2559,2215
0131-002,2016,9,9,16,1256,1373,2629,2559
0131-002,2016,9,9,17,1183,1384,2567,2629
0131-002,2016,9,9,18,1233,1729,2962,2567
0131-002,2016,9,9,19,1281,1710,2991,2962
0131-002,2016,9,9,20,945,1274,2219,2991
0131-002,2016,9,9,21,721,1009,1730,2219
0131-002,2016,9,9,22,655,731,1386,1730
0131-002,2016,9,9,23,454,508,962,1386
0131-002,2016,9,9,24,256,289,545,962
0131-002,2016,9,10,1,230,232,462,545
0131-002,2016,9,10,2,127,144,271,462
0131-002,2016,9,10,3,104,99,203,271
0131-002,2016,9,10,4,95,101,196,203
0131-002,2016,9,10,5,143,133,276,196
0131-002,2016,9,10,6,353,235,588,276
0131-002,2016,9,10,7,684,445,1129,588
0131-002,2016,9,10,8,1105,745,1850,1129
0131-002,2016,9,10,9,1100,1101,2201,1850
0131-002,2016,9,10,10,995,1102,2097,2201
0131-002,2016,9,10,11,1021,1087,2108,2097
0131-002,2016,9,10,12,1003,1089,2092,2108
0131-002,2016,9,10,13,963,996,1959,2092
0131-002,2016,9,10,14,913,1004,1917,1959
0131-002,2016,9,10,15,887,1087,1974,1917
0131-002,2016,9,10,16,1022,1058,2080,1974
0131-002,2016,9,10,17,925,1115,2040,2080
0131-002,2016,9,10,18,1073,1402,2475,2040
0131-002,2016,9,10,19,885,1089,1974,2475
0131-002,2016,9,10,20,651,708,1359,1974
0131-002,2016,9,10,21,588,661,1249,1359
0131-002,2016,9,10,22,513,438,951,1249
0131-002,2016,9,10,23,327,349,676,951
0131-002,2016,9,10,24,210,229,439,676
0131-002,2016,9,11,1,168,177,345,439
0131-002,2016,9,11,2,132,114,246,345
0131-002,2016,9,11,3,89,99,188,246
0131-002,2016,9,11,4,80,91,171,188
0131-002,2016,9,11,5,81,73,154,171
0131-002,2016,9,11,6,224,139,363,154
0131-002,2016,9,11,7,376,277,653,363
0131-002,2016,9,11,8,545,386,931,653
0131-002,2016,9,11,9,546,548,1094,931
0131-002,2016,9,11,10,488,651,1139,1094
0131-002,2016,9,11,11,604,684,1288,1139
0131-002,2016,9,11,12,615,613,1228,1288
0131-002,2016,9,11,13,633,710,1343,1228
0131-002,2016,9,11,14,733,710,1443,1343
0131-002,2016,9,11,15,735,771,1506,1443
0131-002,2016,9,11,16,831,887,1718,1506
0131-002,2016,9,11,17,763,878,1641,1718
0131-002,2016,9,11,18,756,1009,1765,1641
0131-002,2016,9,11,19,742,776,1518,1765
0131-002,2016,9,11,20,610,640,1250,1518
0131-002,2016,9,11,21,529,518,1047,1250
0131-002,2016,9,11,22,417,385,802,1047
0131-002,2016,9,11,23,298,245,543,802
0131-002,2016,9,11,24,208,151,359,543
0131-002,2016,9,12,1,135,126,261,359
0131-002,2016,9,12,2,89,88,177,261
0131-002,2016,9,12,3,74,57,131,177
0131-002,2016,9,12,4,76,73,149,131
0131-002,2016,9,12,5,120,89,209,149
0131-002,2016,9,12,6,380,204,584,209
0131-002,2016,9,12,7,889,560,1449,584
0131-002,2016,9,12,8,1783,1080,2863,1449
0131-002,2016,9,12,9,1558,1309,2867,2863
0131-002,2016,9,12,10,1141,1241,2382,2867
0131-002,2016,9,12,11,1244,1196,2440,2382
0131-002,2016,9,12,12,1173,1253,2426,2440
0131-002,2016,9,12,13,1080,1109,2189,2426
0131-002,2016,9,12,14,1151,1180,2331,2189
0131-002,2016,9,12,15,1247,1326,2573,2331
0131-002,2016,9,12,16,1218,1296,2514,2573
0131-002,2016,9,12,17,1202,1430,2632,2514
0131-002,2016,9,12,18,1127,1620,2747,2632
0131-002,2016,9,12,19,1163,1548,2711,2747
0131-002,2016,9,12,20,839,1126,1965,2711
0131-002,2016,9,12,21,739,972,1711,1965
0131-002,2016,9,12,22,548,675,1223,1711
0131-002,2016,9,12,23,400,454,854,1223
0131-002,2016,9,12,24,236,280,516,854
0131-002,2016,9,13,1,178,167,345,516
0131-002,2016,9,13,2,128,119,247,345
0131-002,2016,9,13,3,96,94,190,247
0131-002,2016,9,13,4,86,105,191,190
0131-002,2016,9,13,5,119,123,242,191
0131-002,2016,9,13,6,334,201,535,242
0131-002,2016,9,13,7,699,452,1151,535
0131-002,2016,9,13,8,1487,998,2485,1151
0131-002,2016,9,13,9,1374,1248,2622,2485
0131-002,2016,9,13,10,1070,1162,2232,2622
0131-002,2016,9,13,11,1088,1161,2249,2232
0131-002,2016,9,13,12,1033,1154,2187,2249
0131-002,2016,9,13,13,919,1178,2097,2187
0131-002,2016,9,13,14,896,1345,2241,2097
0131-002,2016,9,13,15,1053,1348,2401,2241
0131-002,2016,9,13,16,1302,1581,2883,2401
0131-002,2016,9,13,17,1412,1689,3101,2883
0131-002,2016,9,13,18,1419,1525,2944,3101
0131-002,2016,9,13,19,1225,1405,2630,2944
0131-002,2016,9,13,20,808,1115,1923,2630
0131-002,2016,9,13,21,651,1164,1815,1923
0131-002,2016,9,13,22,509,763,1272,1815
0131-002,2016,9,13,23,378,607,985,1272
0131-002,2016,9,13,24,224,523,747,985
0131-002,2016,9,14,1,197,555,752,747
0131-002,2016,9,14,2,135,867,1002,752
0131-002,2016,9,14,3,99,633,732,1002
0131-002,2016,9,14,4,98,866,964,732
0131-002,2016,9,14,5,105,839,944,964
0131-002,2016,9,14,6,120,998,1118,944
0131-002,2016,9,14,7,233,861,1094,1118
0131-002,2016,9,14,8,395,1053,1448,1094
0131-002,2016,9,14,9,513,797,1310,1448
0131-002,2016,9,14,10,662,1047,1709,1310
0131-002,2016,9,14,11,829,1067,1896,1709
0131-002,2016,9,14,12,877,1166,2043,1896
0131-002,2016,9,14,13,852,1237,2089,2043
0131-002,2016,9,14,14,686,1023,1709,2089
0131-002,2016,9,14,15,691,1232,1923,1709
0131-002,2016,9,14,16,613,829,1442,1923
0131-002,2016,9,14,17,526,758,1284,1442
0131-002,2016,9,14,18,466,652,1118,1284
0131-002,2016,9,14,19,438,494,932,1118
0131-002,2016,9,14,20,378,393,771,932
0131-002,2016,9,14,21,275,352,627,771
0131-002,2016,9,14,22,216,245,461,627
0131-002,2016,9,14,23,148,203,351,461
0131-002,2016,9,14,24,132,137,269,351
0131-002,2016,9,15,1,87,111,198,269
0131-002,2016,9,15,2,80,63,143,198
0131-002,2016,9,15,3,50,56,106,143
0131-002,2016,9,15,4,30,38,68,106
0131-002,2016,9,15,5,35,55,90,68
0131-002,2016,9,15,6,71,121,192,90
0131-002,2016,9,15,7,217,303,520,192
0131-002,2016,9,15,8,514,559,1073,520
0131-002,2016,9,15,9,349,656,1005,1073
0131-002,2016,9,15,10,420,1069,1489,1005
0131-002,2016,9,15,11,705,1587,2292,1489
0131-002,2016,9,15,12,1046,1608,2654,2292
0131-002,2016,9,15,13,1122,1541,2663,2654
0131-002,2016,9,15,14,1231,1410,2641,2663
0131-002,2016,9,15,15,1471,1392,2863,2641
0131-002,2016,9,15,16,1301,1610,2911,2863
0131-002,2016,9,15,17,1213,1612,2825,2911
0131-002,2016,9,15,18,1516,1504,3020,2825
0131-002,2016,9,15,19,1221,1160,2381,3020
0131-002,2016,9,15,20,1058,726,1784,2381
0131-002,2016,9,15,21,1121,498,1619,1784
0131-002,2016,9,15,22,816,386,1202,1619
0131-002,2016,9,15,23,823,273,1096,1202
0131-002,2016,9,15,24,340,193,533,1096
0131-002,2016,9,16,1,255,120,375,533
0131-002,2016,9,16,2,133,81,214,375
0131-002,2016,9,16,3,75,41,116,214
0131-002,2016,9,16,4,64,45,109,116
0131-002,2016,9,16,5,81,43,124,109
0131-002,2016,9,16,6,84,86,170,124
0131-002,2016,9,16,7,137,107,244,170
0131-002,2016,9,16,8,219,200,419,244
0131-002,2016,9,16,9,322,279,601,419
0131-002,2016,9,16,10,426,394,820,601
0131-002,2016,9,16,11,706,582,1288,820
0131-002,2016,9,16,12,967,671,1638,1288
0131-002,2016,9,16,13,936,689,1625,1638
0131-002,2016,9,16,14,1025,657,1682,1625
0131-002,2016,9,16,15,993,765,1758,1682
0131-002,2016,9,16,16,1070,706,1776,1758
0131-002,2016,9,16,17,1109,697,1806,1776
0131-002,2016,9,16,18,1005,888,1893,1806
0131-002,2016,9,16,19,850,657,1507,1893
0131-002,2016,9,16,20,947,630,1577,1507
0131-002,2016,9,16,21,786,439,1225,1577
0131-002,2016,9,16,22,1010,332,1342,1225
0131-002,2016,9,16,23,717,246,963,1342
0131-002,2016,9,16,24,966,177,1143,963
0131-002,2016,9,17,1,697,125,822,1143
0131-002,2016,9,17,2,371,83,454,822
0131-002,2016,9,17,3,137,68,205,454
0131-002,2016,9,17,4,72,55,127,205
0131-002,2016,9,17,5,78,67,145,127
0131-002,2016,9,17,6,114,84,198,145
0131-002,2016,9,17,7,182,124,306,198
0131-002,2016,9,17,8,323,259,582,306
0131-002,2016,9,17,9,384,368,752,582
0131-002,2016,9,17,10,430,443,873,752
0131-002,2016,9,17,11,515,564,1079,873
0131-002,2016,9,17,12,646,680,1326,1079
0131-002,2016,9,17,13,820,705,1525,1326
0131-002,2016,9,17,14,869,689,1558,1525
0131-002,2016,9,17,15,903,781,1684,1558
0131-002,2016,9,17,16,896,761,1657,1684
0131-002,2016,9,17,17,1033,801,1834,1657
0131-002,2016,9,17,18,955,716,1671,1834
0131-002,2016,9,17,19,806,620,1426,1671
0131-002,2016,9,17,20,690,445,1135,1426
0131-002,2016,9,17,21,721,363,1084,1135
0131-002,2016,9,17,22,501,325,826,1084
0131-002,2016,9,17,23,276,255,531,826
0131-002,2016,9,17,24,179,173,352,531
0131-002,2016,9,18,1,146,134,280,352
0131-002,2016,9,18,2,98,98,196,280
0131-002,2016,9,18,3,70,87,157,196
0131-002,2016,9,18,4,60,60,120,157
0131-002,2016,9,18,5,65,70,135,120
0131-002,2016,9,18,6,130,63,193,135
0131-002,2016,9,18,7,193,116,309,193
0131-002,2016,9,18,8,309,232,541,309
0131-002,2016,9,18,9,389,369,758,541
0131-002,2016,9,18,10,413,420,833,758
0131-002,2016,9,18,11,507,538,1045,833
0131-002,2016,9,18,12,548,540,1088,1045
0131-002,2016,9,18,13,578,558,1136,1088
0131-002,2016,9,18,14,648,630,1278,1136
0131-002,2016,9,18,15,700,726,1426,1278
0131-002,2016,9,18,16,733,705,1438,1426
0131-002,2016,9,18,17,743,729,1472,1438
0131-002,2016,9,18,18,678,762,1440,1472
0131-002,2016,9,18,19,664,646,1310,1440
0131-002,2016,9,18,20,546,494,1040,1310
0131-002,2016,9,18,21,510,400,910,1040
0131-002,2016,9,18,22,477,334,811,910
0131-002,2016,9,18,23,340,232,572,811
0131-002,2016,9,18,24,216,140,356,572
0131-002,2016,9,19,1,160,120,280,356
0131-002,2016,9,19,2,89,73,162,280
0131-002,2016,9,19,3,83,69,152,162
0131-002,2016,9,19,4,62,69,131,152
0131-002,2016,9,19,5,103,88,191,131
0131-002,2016,9,19,6,440,215,655,191
0131-002,2016,9,19,7,979,513,1492,655
0131-002,2016,9,19,8,1799,1065,2864,1492
0131-002,2016,9,19,9,1562,1299,2861,2864
0131-002,2016,9,19,10,1083,1053,2136,2861
0131-002,2016,9,19,11,1100,1072,2172,2136
0131-002,2016,9,19,12,1032,1081,2113,2172
0131-002,2016,9,19,13,868,956,1824,2113
0131-002,2016,9,19,14,1046,934,1980,1824
0131-002,2016,9,19,15,1145,1119,2264,1980
0131-002,2016,9,19,16,1128,1128,2256,2264
0131-002,2016,9,19,17,1003,1184,2187,2256
0131-002,2016,9,19,18,1016,1471,2487,2187
0131-002,2016,9,19,19,1002,1324,2326,2487
0131-002,2016,9,19,20,764,1096,1860,2326
0131-002,2016,9,19,21,639,878,1517,1860
0131-002,2016,9,19,22,472,611,1083,1517
0131-002,2016,9,19,23,349,385,734,1083
0131-002,2016,9,19,24,250,216,466,734
0131-002,2016,9,20,1,146,144,290,466
0131-002,2016,9,20,2,103,101,204,290
0131-002,2016,9,20,3,81,75,156,204
0131-002,2016,9,20,4,87,90,177,156
0131-002,2016,9,20,5,152,118,270,177
0131-002,2016,9,20,6,379,230,609,270
0131-002,2016,9,20,7,809,471,1280,609
0131-002,2016,9,20,8,1765,1044,2809,1280
0131-002,2016,9,20,9,1496,1372,2868,2809
0131-002,2016,9,20,10,1124,1150,2274,2868
0131-002,2016,9,20,11,1197,1124,2321,2274
0131-002,2016,9,20,12,1045,1224,2269,2321
0131-002,2016,9,20,13,963,958,1921,2269
0131-002,2016,9,20,14,1149,1134,2283,1921
0131-002,2016,9,20,15,1175,1290,2465,2283
0131-002,2016,9,20,16,1170,1303,2473,2465
0131-002,2016,9,20,17,1105,1309,2414,2473
0131-002,2016,9,20,18,1162,1461,2623,2414
0131-002,2016,9,20,19,1054,1405,2459,2623
0131-002,2016,9,20,20,818,1089,1907,2459
0131-002,2016,9,20,21,607,971,1578,1907
0131-002,2016,9,20,22,478,664,1142,1578
0131-002,2016,9,20,23,351,404,755,1142
0131-002,2016,9,20,24,261,235,496,755
0131-002,2016,9,21,1,156,136,292,496
0131-002,2016,9,21,2,99,97,196,292
0131-002,2016,9,21,3,92,99,191,196
0131-002,2016,9,21,4,87,93,180,191
0131-002,2016,9,21,5,123,140,263,180
0131-002,2016,9,21,6,377,219,596,263
0131-002,2016,9,21,7,825,493,1318,596
0131-002,2016,9,21,8,1717,1078,2795,1318
0131-002,2016,9,21,9,1512,1353,2865,2795
0131-002,2016,9,21,10,1158,1166,2324,2865
0131-002,2016,9,21,11,1163,1172,2335,2324
0131-002,2016,9,21,12,1118,1164,2282,2335
0131-002,2016,9,21,13,912,1009,1921,2282
0131-002,2016,9,21,14,1124,1044,2168,1921
0131-002,2016,9,21,15,1100,1254,2354,2168
0131-002,2016,9,21,16,1081,1212,2293,2354
0131-002,2016,9,21,17,1176,1310,2486,2293
0131-002,2016,9,21,18,1173,1639,2812,2486
0131-002,2016,9,21,19,1132,1522,2654,2812
0131-002,2016,9,21,20,785,1072,1857,2654
0131-002,2016,9,21,21,598,845,1443,1857
0131-002,2016,9,21,22,496,572,1068,1443
0131-002,2016,9,21,23,402,414,816,1068
0131-002,2016,9,21,24,222,251,473,816
0131-002,2016,9,22,1,158,174,332,473
0131-002,2016,9,22,2,107,112,219,332
0131-002,2016,9,22,3,86,90,176,219
0131-002,2016,9,22,4,86,98,184,176
0131-002,2016,9,22,5,135,132,267,184
0131-002,2016,9,22,6,374,221,595,267
0131-002,2016,9,22,7,862,495,1357,595
0131-002,2016,9,22,8,1742,1074,2816,1357
0131-002,2016,9,22,9,1575,1325,2900,2816
0131-002,2016,9,22,10,1139,1208,2347,2900
0131-002,2016,9,22,11,1162,1246,2408,2347
0131-002,2016,9,22,12,1033,1252,2285,2408
0131-002,2016,9,22,13,989,1044,2033,2285
0131-002,2016,9,22,14,1098,1025,2123,2033
0131-002,2016,9,22,15,1157,1269,2426,2123
0131-002,2016,9,22,16,1148,1306,2454,2426
0131-002,2016,9,22,17,1042,1361,2403,2454
0131-002,2016,9,22,18,1124,1533,2657,2403
0131-002,2016,9,22,19,1134,1353,2487,2657
0131-002,2016,9,22,20,776,1080,1856,2487
0131-002,2016,9,22,21,728,866,1594,1856
0131-002,2016,9,22,22,528,623,1151,1594
0131-002,2016,9,22,23,342,473,815,1151
0131-002,2016,9,22,24,204,225,429,815
0131-002,2016,9,23,1,195,180,375,429
0131-002,2016,9,23,2,124,119,243,375
0131-002,2016,9,23,3,76,100,176,243
0131-002,2016,9,23,4,110,98,208,176
0131-002,2016,9,23,5,123,123,246,208
0131-002,2016,9,23,6,396,208,604,246
0131-002,2016,9,23,7,862,480,1342,604
0131-002,2016,9,23,8,1751,1043,2794,1342
0131-002,2016,9,23,9,1475,1366,2841,2794
0131-002,2016,9,23,10,1134,1203,2337,2841
0131-002,2016,9,23,11,1130,1161,2291,2337
0131-002,2016,9,23,12,1118,1134,2252,2291
0131-002,2016,9,23,13,959,1110,2069,2252
0131-002,2016,9,23,14,1063,1110,2173,2069
0131-002,2016,9,23,15,1183,1328,2511,2173
0131-002,2016,9,23,16,1201,1205,2406,2511
0131-002,2016,9,23,17,1185,1343,2528,2406
0131-002,2016,9,23,18,1167,1650,2817,2528
0131-002,2016,9,23,19,1255,1617,2872,2817
0131-002,2016,9,23,20,945,1206,2151,2872
0131-002,2016,9,23,21,683,940,1623,2151
0131-002,2016,9,23,22,584,659,1243,1623
0131-002,2016,9,23,23,343,428,771,1243
0131-002,2016,9,23,24,254,266,520,771
0131-002,2016,9,24,1,194,216,410,520
0131-002,2016,9,24,2,132,140,272,410
0131-002,2016,9,24,3,106,128,234,272
0131-002,2016,9,24,4,105,112,217,234
0131-002,2016,9,24,5,136,136,272,217
0131-002,2016,9,24,6,320,220,540,272
0131-002,2016,9,24,7,637,436,1073,540
0131-002,2016,9,24,8,1053,748,1801,1073
0131-002,2016,9,24,9,1076,1070,2146,1801
0131-002,2016,9,24,10,1007,1205,2212,2146
0131-002,2016,9,24,11,1042,1170,2212,2212
0131-002,2016,9,24,12,1129,1223,2352,2212
0131-002,2016,9,24,13,951,1093,2044,2352
0131-002,2016,9,24,14,973,1015,1988,2044
0131-002,2016,9,24,15,969,1072,2041,1988
0131-002,2016,9,24,16,1038,1084,2122,2041
0131-002,2016,9,24,17,1027,1191,2218,2122
0131-002,2016,9,24,18,1112,1468,2580,2218
0131-002,2016,9,24,19,1019,1257,2276,2580
0131-002,2016,9,24,20,839,758,1597,2276
0131-002,2016,9,24,21,583,555,1138,1597
0131-002,2016,9,24,22,515,444,959,1138
0131-002,2016,9,24,23,344,340,684,959
0131-002,2016,9,24,24,221,226,447,684
0131-002,2016,9,25,1,152,171,323,447
0131-002,2016,9,25,2,124,106,230,323
0131-002,2016,9,25,3,97,104,201,230
0131-002,2016,9,25,4,72,84,156,201
0131-002,2016,9,25,5,100,87,187,156
0131-002,2016,9,25,6,203,126,329,187
0131-002,2016,9,25,7,340,248,588,329
0131-002,2016,9,25,8,467,372,839,588
0131-002,2016,9,25,9,536,519,1055,839
0131-002,2016,9,25,10,560,612,1172,1055
0131-002,2016,9,25,11,570,696,1266,1172
0131-002,2016,9,25,12,665,666,1331,1266
0131-002,2016,9,25,13,676,668,1344,1331
0131-002,2016,9,25,14,680,675,1355,1344
0131-002,2016,9,25,15,783,828,1611,1355
0131-002,2016,9,25,16,845,880,1725,1611
0131-002,2016,9,25,17,926,1023,1949,1725
0131-002,2016,9,25,18,900,1111,2011,1949
0131-002,2016,9,25,19,777,899,1676,2011
0131-002,2016,9,25,20,675,621,1296,1676
0131-002,2016,9,25,21,605,568,1173,1296
0131-002,2016,9,25,22,471,397,868,1173
0131-002,2016,9,25,23,338,267,605,868
0131-002,2016,9,25,24,209,150,359,605
0131-002,2016,9,26,1,142,105,247,359
0131-002,2016,9,26,2,94,73,167,247
0131-002,2016,9,26,3,79,63,142,167
0131-002,2016,9,26,4,87,61,148,142
0131-002,2016,9,26,5,130,125,255,148
0131-002,2016,9,26,6,432,222,654,255
0131-002,2016,9,26,7,937,502,1439,654
0131-002,2016,9,26,8,1870,1146,3016,1439
0131-002,2016,9,26,9,1593,1351,2944,3016
0131-002,2016,9,26,10,1127,1106,2233,2944
0131-002,2016,9,26,11,1097,1150,2247,2233
0131-002,2016,9,26,12,1038,1145,2183,2247
0131-002,2016,9,26,13,945,962,1907,2183
0131-002,2016,9,26,14,1071,1005,2076,1907
0131-002,2016,9,26,15,1079,1245,2324,2076
0131-002,2016,9,26,16,1092,1244,2336,2324
0131-002,2016,9,26,17,1000,1249,2249,2336
0131-002,2016,9,26,18,1088,1485,2573,2249
0131-002,2016,9,26,19,1062,1443,2505,2573
0131-002,2016,9,26,20,801,1086,1887,2505
0131-002,2016,9,26,21,652,952,1604,1887
0131-002,2016,9,26,22,500,613,1113,1604
0131-002,2016,9,26,23,308,410,718,1113
0131-002,2016,9,26,24,207,211,418,718
0131-002,2016,9,27,1,143,160,303,418
0131-002,2016,9,27,2,99,105,204,303
0131-002,2016,9,27,3,87,92,179,204
0131-002,2016,9,27,4,91,87,178,179
0131-002,2016,9,27,5,115,127,242,178
0131-002,2016,9,27,6,363,208,571,242
0131-002,2016,9,27,7,742,494,1236,571
0131-002,2016,9,27,8,1701,1003,2704,1236
0131-002,2016,9,27,9,1456,1291,2747,2704
0131-002,2016,9,27,10,1147,1178,2325,2747
0131-002,2016,9,27,11,1114,1138,2252,2325
0131-002,2016,9,27,12,1018,1162,2180,2252
0131-002,2016,9,27,13,893,939,1832,2180
0131-002,2016,9,27,14,1076,1097,2173,1832
0131-002,2016,9,27,15,1080,1246,2326,2173
0131-002,2016,9,27,16,1015,1202,2217,2326
0131-002,2016,9,27,17,1080,1178,2258,2217
0131-002,2016,9,27,18,1064,1369,2433,2258
0131-002,2016,9,27,19,931,1313,2244,2433
0131-002,2016,9,27,20,736,1011,1747,2244
0131-002,2016,9,27,21,585,854,1439,1747
0131-002,2016,9,27,22,493,560,1053,1439
0131-002,2016,9,27,23,345,392,737,1053
0131-002,2016,9,27,24,214,231,445,737
0131-002,2016,9,28,1,149,173,322,445
0131-002,2016,9,28,2,100,111,211,322
0131-002,2016,9,28,3,76,70,146,211
0131-002,2016,9,28,4,79,105,184,146
0131-002,2016,9,28,5,114,126,240,184
0131-002,2016,9,28,6,415,213,628,240
0131-002,2016,9,28,7,849,484,1333,628
0131-002,2016,9,28,8,1685,1083,2768,1333
0131-002,2016,9,28,9,1521,1355,2876,2768
0131-002,2016,9,28,10,1155,1170,2325,2876
0131-002,2016,9,28,11,1101,1122,2223,2325
0131-002,2016,9,28,12,1063,1107,2170,2223
0131-002,2016,9,28,13,893,997,1890,2170
0131-002,2016,9,28,14,990,1089,2079,1890
0131-002,2016,9,28,15,1147,1205,2352,2079
0131-002,2016,9,28,16,1072,1210,2282,2352
0131-002,2016,9,28,17,1080,1226,2306,2282
0131-002,2016,9,28,18,1143,1576,2719,2306
0131-002,2016,9,28,19,1024,1445,2469,2719
0131-002,2016,9,28,20,764,1061,1825,2469
0131-002,2016,9,28,21,629,819,1448,1825
0131-002,2016,9,28,22,485,578,1063,1448
0131-002,2016,9,28,23,391,403,794,1063
0131-002,2016,9,28,24,240,263,503,794
0131-002,2016,9,29,1,162,177,339,503
0131-002,2016,9,29,2,105,108,213,339
0131-002,2016,9,29,3,108,96,204,213
0131-002,2016,9,29,4,76,94,170,204
0131-002,2016,9,29,5,124,109,233,170
0131-002,2016,9,29,6,400,199,599,233
0131-002,2016,9,29,7,821,491,1312,599
0131-002,2016,9,29,8,1710,1065,2775,1312
0131-002,2016,9,29,9,1579,1390,2969,2775
0131-002,2016,9,29,10,1183,1160,2343,2969
0131-002,2016,9,29,11,1112,1243,2355,2343
0131-002,2016,9,29,12,1080,1205,2285,2355
0131-002,2016,9,29,13,861,1038,1899,2285
0131-002,2016,9,29,14,1091,1093,2184,1899
0131-002,2016,9,29,15,1164,1353,2517,2184
0131-002,2016,9,29,16,1133,1180,2313,2517
0131-002,2016,9,29,17,1113,1287,2400,2313
0131-002,2016,9,29,18,1101,1512,2613,2400
0131-002,2016,9,29,19,1094,1414,2508,2613
0131-002,2016,9,29,20,752,1129,1881,2508
0131-002,2016,9,29,21,609,876,1485,1881
0131-002,2016,9,29,22,569,637,1206,1485
0131-002,2016,9,29,23,382,456,838,1206
0131-002,2016,9,29,24,217,274,491,838
0131-002,2016,9,30,1,162,185,347,491
0131-002,2016,9,30,2,125,121,246,347
0131-002,2016,9,30,3,104,81,185,246
0131-002,2016,9,30,4,81,111,192,185
0131-002,2016,9,30,5,124,130,254,192
0131-002,2016,9,30,6,411,248,659,254
0131-002,2016,9,30,7,836,494,1330,659
0131-002,2016,9,30,8,1727,1051,2778,1330
0131-002,2016,9,30,9,1478,1321,2799,2778
0131-002,2016,9,30,10,1187,1125,2312,2799
0131-002,2016,9,30,11,1068,1154,2222,2312
0131-002,2016,9,30,12,1085,1129,2214,2222
0131-002,2016,9,30,13,912,1056,1968,2214
0131-002,2016,9,30,14,1013,1135,2148,1968
0131-002,2016,9,30,15,1157,1294,2451,2148
0131-002,2016,9,30,16,1198,1295,2493,2451
0131-002,2016,9,30,17,1120,1360,2480,2493
0131-002,2016,9,30,18,1268,1755,3023,2480
0131-002,2016,9,30,19,1174,1739,2913,3023
0131-002,2016,9,30,20,815,1264,2079,2913
0131-002,2016,9,30,21,695,996,1691,2079
0131-002,2016,9,30,22,585,727,1312,1691
0131-002,2016,9,30,23,414,466,880,1312
0131-002,2016,9,30,24,262,269,531,880
0131-002,2016,10,1,1,210,221,431,531
0131-002,2016,10,1,2,150,158,308,431
0131-002,2016,10,1,3,119,113,232,308
0131-002,2016,10,1,4,84,119,203,232
0131-002,2016,10,1,5,124,140,264,203
0131-002,2016,10,1,6,338,221,559,264
0131-002,2016,10,1,7,612,438,1050,559
0131-002,2016,10,1,8,992,790,1782,1050
0131-002,2016,10,1,9,1078,1127,2205,1782
0131-002,2016,10,1,10,1036,1132,2168,2205
0131-002,2016,10,1,11,1045,1287,2332,2168
0131-002,2016,10,1,12,1116,1357,2473,2332
0131-002,2016,10,1,13,1013,1415,2428,2473
0131-002,2016,10,1,14,1072,1421,2493,2428
0131-002,2016,10,1,15,1041,1280,2321,2493
0131-002,2016,10,1,16,1051,1383,2434,2321
0131-002,2016,10,1,17,1080,1483,2563,2434
0131-002,2016,10,1,18,1051,1611,2662,2563
0131-002,2016,10,1,19,1068,1447,2515,2662
0131-002,2016,10,1,20,897,994,1891,2515
0131-002,2016,10,1,21,709,645,1354,1891
0131-002,2016,10,1,22,558,467,1025,1354
0131-002,2016,10,1,23,334,289,623,1025
0131-002,2016,10,1,24,206,221,427,623
0131-002,2016,10,2,1,150,180,330,427
0131-002,2016,10,2,2,94,111,205,330
0131-002,2016,10,2,3,73,85,158,205
0131-002,2016,10,2,4,69,62,131,158
0131-002,2016,10,2,5,82,77,159,131
0131-002,2016,10,2,6,127,98,225,159
0131-002,2016,10,2,7,232,184,416,225
0131-002,2016,10,2,8,355,295,650,416
0131-002,2016,10,2,9,413,455,868,650
0131-002,2016,10,2,10,474,576,1050,868
0131-002,2016,10,2,11,554,650,1204,1050
0131-002,2016,10,2,12,662,626,1288,1204
0131-002,2016,10,2,13,657,710,1367,1288
0131-002,2016,10,2,14,682,799,1481,1367
0131-002,2016,10,2,15,709,762,1471,1481
0131-002,2016,10,2,16,686,882,1568,1471
0131-002,2016,10,2,17,799,835,1634,1568
0131-002,2016,10,2,18,870,907,1777,1634
0131-002,2016,10,2,19,809,765,1574,1777
0131-002,2016,10,2,20,700,603,1303,1574
0131-002,2016,10,2,21,551,417,968,1303
0131-002,2016,10,2,22,431,351,782,968
0131-002,2016,10,2,23,329,253,582,782
0131-002,2016,10,2,24,191,172,363,582
0131-002,2016,10,3,1,140,126,266,363
0131-002,2016,10,3,2,79,95,174,266
0131-002,2016,10,3,3,74,74,148,174
0131-002,2016,10,3,4,62,65,127,148
0131-002,2016,10,3,5,78,97,175,127
0131-002,2016,10,3,6,283,146,429,175
0131-002,2016,10,3,7,455,239,694,429
0131-002,2016,10,3,8,720,447,1167,694
0131-002,2016,10,3,9,697,561,1258,1167
0131-002,2016,10,3,10,647,606,1253,1258
0131-002,2016,10,3,11,672,715,1387,1253
0131-002,2016,10,3,12,779,841,1620,1387
0131-002,2016,10,3,13,735,761,1496,1620
0131-002,2016,10,3,14,861,820,1681,1496
0131-002,2016,10,3,15,892,921,1813,1681
0131-002,2016,10,3,16,983,928,1911,1813
0131-002,2016,10,3,17,982,1123,2105,1911
0131-002,2016,10,3,18,969,1280,2249,2105
0131-002,2016,10,3,19,884,1077,1961,2249
0131-002,2016,10,3,20,754,748,1502,1961
0131-002,2016,10,3,21,637,591,1228,1502
0131-002,2016,10,3,22,455,445,900,1228
0131-002,2016,10,3,23,367,276,643,900
0131-002,2016,10,3,24,225,161,386,643
0131-002,2016,10,4,1,150,105,255,386
0131-002,2016,10,4,2,70,86,156,255
0131-002,2016,10,4,3,73,72,145,156
0131-002,2016,10,4,4,63,64,127,145
0131-002,2016,10,4,5,118,99,217,127
0131-002,2016,10,4,6,407,196,603,217
0131-002,2016,10,4,7,898,491,1389,603
0131-002,2016,10,4,8,1838,1111,2949,1389
0131-002,2016,10,4,9,1669,1386,3055,2949
0131-002,2016,10,4,10,1107,1100,2207,3055
0131-002,2016,10,4,11,1131,1192,2323,2207
0131-002,2016,10,4,12,1106,1108,2214,2323
0131-002,2016,10,4,13,975,1016,1991,2214
0131-002,2016,10,4,14,1049,1040,2089,1991
0131-002,2016,10,4,15,1183,1319,2502,2089
0131-002,2016,10,4,16,1159,1251,2410,2502
0131-002,2016,10,4,17,1046,1412,2458,2410
0131-002,2016,10,4,18,1192,1612,2804,2458
0131-002,2016,10,4,19,1242,1395,2637,2804
0131-002,2016,10,4,20,797,1092,1889,2637
0131-002,2016,10,4,21,652,889,1541,1889
0131-002,2016,10,4,22,463,651,1114,1541
0131-002,2016,10,4,23,340,454,794,1114
0131-002,2016,10,4,24,220,232,452,794
0131-002,2016,10,5,1,164,182,346,452
0131-002,2016,10,5,2,105,121,226,346
0131-002,2016,10,5,3,89,82,171,226
0131-002,2016,10,5,4,89,100,189,171
0131-002,2016,10,5,5,119,134,253,189
0131-002,2016,10,5,6,344,173,517,253
0131-002,2016,10,5,7,705,437,1142,517
0131-002,2016,10,5,8,1557,980,2537,1142
0131-002,2016,10,5,9,1514,1292,2806,2537
0131-002,2016,10,5,10,1116,1095,2211,2806
0131-002,2016,10,5,11,1098,1171,2269,2211
0131-002,2016,10,5,12,1091,1035,2126,2269
0131-002,2016,10,5,13,916,987,1903,2126
0131-002,2016,10,5,14,1057,1113,2170,1903
0131-002,2016,10,5,15,1123,1313,2436,2170
0131-002,2016,10,5,16,1112,1249,2361,2436
0131-002,2016,10,5,17,989,1239,2228,2361
0131-002,2016,10,5,18,1127,1529,2656,2228
0131-002,2016,10,5,19,1038,1398,2436,2656
0131-002,2016,10,5,20,768,1083,1851,2436
0131-002,2016,10,5,21,616,879,1495,1851
0131-002,2016,10,5,22,518,622,1140,1495
0131-002,2016,10,5,23,352,418,770,1140
0131-002,2016,10,5,24,255,266,521,770
0131-002,2016,10,6,1,195,171,366,521
0131-002,2016,10,6,2,103,112,215,366
0131-002,2016,10,6,3,90,93,183,215
0131-002,2016,10,6,4,85,95,180,183
0131-002,2016,10,6,5,112,142,254,180
0131-002,2016,10,6,6,394,188,582,254
0131-002,2016,10,6,7,844,509,1353,582
0131-002,2016,10,6,8,1757,1097,2854,1353
0131-002,2016,10,6,9,1570,1413,2983,2854
0131-002,2016,10,6,10,1156,1179,2335,2983
0131-002,2016,10,6,11,1163,1171,2334,2335
0131-002,2016,10,6,12,1109,1153,2262,2334
0131-002,2016,10,6,13,952,988,1940,2262
0131-002,2016,10,6,14,1136,1099,2235,1940
0131-002,2016,10,6,15,1157,1245,2402,2235
0131-002,2016,10,6,16,1124,1236,2360,2402
0131-002,2016,10,6,17,1087,1319,2406,2360
0131-002,2016,10,6,18,1199,1538,2737,2406
0131-002,2016,10,6,19,1114,1467,2581,2737
0131-002,2016,10,6,20,758,1047,1805,2581
0131-002,2016,10,6,21,610,949,1559,1805
0131-002,2016,10,6,22,509,605,1114,1559
0131-002,2016,10,6,23,395,426,821,1114
0131-002,2016,10,6,24,226,278,504,821
0131-002,2016,10,7,1,177,171,348,504
0131-002,2016,10,7,2,111,130,241,348
0131-002,2016,10,7,3,84,92,176,241
0131-002,2016,10,7,4,81,106,187,176
0131-002,2016,10,7,5,153,126,279,187
0131-002,2016,10,7,6,428,225,653,279
0131-002,2016,10,7,7,839,525,1364,653
0131-002,2016,10,7,8,1760,1085,2845,1364
0131-002,2016,10,7,9,1582,1387,2969,2845
0131-002,2016,10,7,10,1201,1173,2374,2969
0131-002,2016,10,7,11,1210,1242,2452,2374
0131-002,2016,10,7,12,1057,1404,2461,2452
0131-002,2016,10,7,13,1053,1131,2184,2461
0131-002,2016,10,7,14,1155,1157,2312,2184
0131-002,2016,10,7,15,1203,1317,2520,2312
0131-002,2016,10,7,16,1187,1315,2502,2520
0131-002,2016,10,7,17,1134,1527,2661,2502
0131-002,2016,10,7,18,1356,1752,3108,2661
0131-002,2016,10,7,19,1348,1718,3066,3108
0131-002,2016,10,7,20,1000,1360,2360,3066
0131-002,2016,10,7,21,790,1106,1896,2360
0131-002,2016,10,7,22,625,626,1251,1896
0131-002,2016,10,7,23,384,437,821,1251
0131-002,2016,10,7,24,240,256,496,821
0131-002,2016,10,8,1,168,160,328,496
0131-002,2016,10,8,2,140,143,283,328
0131-002,2016,10,8,3,95,108,203,283
0131-002,2016,10,8,4,103,91,194,203
0131-002,2016,10,8,5,125,124,249,194
0131-002,2016,10,8,6,313,187,500,249
0131-002,2016,10,8,7,503,312,815,500
0131-002,2016,10,8,8,827,634,1461,815
0131-002,2016,10,8,9,1033,1099,2132,1461
0131-002,2016,10,8,10,917,1049,1966,2132
0131-002,2016,10,8,11,998,1267,2265,1966
0131-002,2016,10,8,12,962,1235,2197,2265
0131-002,2016,10,8,13,1008,1156,2164,2197
0131-002,2016,10,8,14,967,1041,2008,2164
0131-002,2016,10,8,15,973,1124,2097,2008
0131-002,2016,10,8,16,1012,1092,2104,2097
0131-002,2016,10,8,17,1098,1294,2392,2104
0131-002,2016,10,8,18,1241,1613,2854,2392
0131-002,2016,10,8,19,1061,1339,2400,2854
0131-002,2016,10,8,20,962,815,1777,2400
0131-002,2016,10,8,21,653,587,1240,1777
0131-002,2016,10,8,22,446,471,917,1240
0131-002,2016,10,8,23,359,297,656,917
0131-002,2016,10,8,24,210,202,412,656
0131-002,2016,10,9,1,149,168,317,412
0131-002,2016,10,9,2,111,107,218,317
0131-002,2016,10,9,3,99,90,189,218
0131-002,2016,10,9,4,59,61,120,189
0131-002,2016,10,9,5,78,93,171,120
0131-002,2016,10,9,6,210,117,327,171
0131-002,2016,10,9,7,378,222,600,327
0131-002,2016,10,9,8,506,410,916,600
0131-002,2016,10,9,9,531,662,1193,916
0131-002,2016,10,9,10,572,661,1233,1193
0131-002,2016,10,9,11,700,726,1426,1233
0131-002,2016,10,9,12,759,747,1506,1426
0131-002,2016,10,9,13,722,693,1415,1506
0131-002,2016,10,9,14,703,744,1447,1415
0131-002,2016,10,9,15,797,840,1637,1447
0131-002,2016,10,9,16,852,956,1808,1637
0131-002,2016,10,9,17,898,1048,1946,1808
0131-002,2016,10,9,18,940,1241,2181,1946
0131-002,2016,10,9,19,909,1042,1951,2181
0131-002,2016,10,9,20,730,753,1483,1951
0131-002,2016,10,9,21,751,601,1352,1483
0131-002,2016,10,9,22,589,418,1007,1352
0131-002,2016,10,9,23,365,263,628,1007
0131-002,2016,10,9,24,226,170,396,628
0131-002,2016,10,10,1,130,109,239,396
0131-002,2016,10,10,2,80,68,148,239
0131-002,2016,10,10,3,75,52,127,148
0131-002,2016,10,10,4,67,51,118,127
0131-002,2016,10,10,5,132,94,226,118
0131-002,2016,10,10,6,418,208,626,226
0131-002,2016,10,10,7,967,521,1488,626
0131-002,2016,10,10,8,1894,1091,2985,1488
0131-002,2016,10,10,9,1578,1319,2897,2985
0131-002,2016,10,10,10,1095,1183,2278,2897
0131-002,2016,10,10,11,1057,1382,2439,2278
0131-002,2016,10,10,12,1056,1212,2268,2439
0131-002,2016,10,10,13,991,1111,2102,2268
0131-002,2016,10,10,14,1078,1103,2181,2102
0131-002,2016,10,10,15,1164,1185,2349,2181
0131-002,2016,10,10,16,1133,1231,2364,2349
0131-002,2016,10,10,17,1094,1318,2412,2364
0131-002,2016,10,10,18,1125,1606,2731,2412
0131-002,2016,10,10,19,1018,1441,2459,2731
0131-002,2016,10,10,20,791,1063,1854,2459
0131-002,2016,10,10,21,658,937,1595,1854
0131-002,2016,10,10,22,484,630,1114,1595
0131-002,2016,10,10,23,361,408,769,1114
0131-002,2016,10,10,24,225,200,425,769
0131-002,2016,10,11,1,134,165,299,425
0131-002,2016,10,11,2,97,94,191,299
0131-002,2016,10,11,3,81,78,159,191
0131-002,2016,10,11,4,79,92,171,159
0131-002,2016,10,11,5,126,138,264,171
0131-002,2016,10,11,6,352,200,552,264
0131-002,2016,10,11,7,859,459,1318,552
0131-002,2016,10,11,8,1694,1068,2762,1318
0131-002,2016,10,11,9,1536,1290,2826,2762
0131-002,2016,10,11,10,1155,1172,2327,2826
0131-002,2016,10,11,11,1150,1190,2340,2327
0131-002,2016,10,11,12,1092,1132,2224,2340
0131-002,2016,10,11,13,899,1004,1903,2224
0131-002,2016,10,11,14,1079,1122,2201,1903
0131-002,2016,10,11,15,1201,1245,2446,2201
0131-002,2016,10,11,16,1113,1313,2426,2446
0131-002,2016,10,11,17,1112,1271,2383,2426
0131-002,2016,10,11,18,1129,1625,2754,2383
0131-002,2016,10,11,19,1035,1401,2436,2754
0131-002,2016,10,11,20,785,1135,1920,2436
0131-002,2016,10,11,21,633,943,1576,1920
0131-002,2016,10,11,22,480,617,1097,1576
0131-002,2016,10,11,23,363,437,800,1097
0131-002,2016,10,11,24,231,217,448,800
0131-002,2016,10,12,1,157,165,322,448
0131-002,2016,10,12,2,88,124,212,322
0131-002,2016,10,12,3,97,90,187,212
0131-002,2016,10,12,4,88,105,193,187
0131-002,2016,10,12,5,120,127,247,193
0131-002,2016,10,12,6,398,238,636,247
0131-002,2016,10,12,7,870,484,1354,636
0131-002,2016,10,12,8,1702,1093,2795,1354
0131-002,2016,10,12,9,1502,1393,2895,2795
0131-002,2016,10,12,10,1244,1223,2467,2895
0131-002,2016,10,12,11,1169,1228,2397,2467
0131-002,2016,10,12,12,1075,1097,2172,2397
0131-002,2016,10,12,13,960,987,1947,2172
0131-002,2016,10,12,14,1091,1121,2212,1947
0131-002,2016,10,12,15,1211,1299,2510,2212
0131-002,2016,10,12,16,1123,1245,2368,2510
0131-002,2016,10,12,17,1040,1305,2345,2368
0131-002,2016,10,12,18,1169,1675,2844,2345
0131-002,2016,10,12,19,1105,1451,2556,2844
0131-002,2016,10,12,20,766,1095,1861,2556
0131-002,2016,10,12,21,594,859,1453,1861
0131-002,2016,10,12,22,512,581,1093,1453
0131-002,2016,10,12,23,339,432,771,1093
0131-002,2016,10,12,24,237,218,455,771
0131-002,2016,10,13,1,186,162,348,455
0131-002,2016,10,13,2,119,123,242,348
0131-002,2016,10,13,3,86,100,186,242
0131-002,2016,10,13,4,79,84,163,186
0131-002,2016,10,13,5,139,124,263,163
0131-002,2016,10,13,6,398,238,636,263
0131-002,2016,10,13,7,789,478,1267,636
0131-002,2016,10,13,8,1718,1077,2795,1267
0131-002,2016,10,13,9,1566,1351,2917,2795
0131-002,2016,10,13,10,1126,1235,2361,2917
0131-002,2016,10,13,11,1158,1234,2392,2361
0131-002,2016,10,13,12,1122,1121,2243,2392
0131-002,2016,10,13,13,926,1064,1990,2243
0131-002,2016,10,13,14,1100,1069,2169,1990
0131-002,2016,10,13,15,1202,1223,2425,2169
0131-002,2016,10,13,16,1138,1273,2411,2425
0131-002,2016,10,13,17,1079,1293,2372,2411
0131-002,2016,10,13,18,1092,1702,2794,2372
0131-002,2016,10,13,19,1024,1410,2434,2794
0131-002,2016,10,13,20,772,1054,1826,2434
0131-002,2016,10,13,21,626,856,1482,1826
0131-002,2016,10,13,22,493,659,1152,1482
0131-002,2016,10,13,23,351,416,767,1152
0131-002,2016,10,13,24,230,234,464,767
0131-002,2016,10,14,1,167,157,324,464
0131-002,2016,10,14,2,98,118,216,324
0131-002,2016,10,14,3,76,90,166,216
0131-002,2016,10,14,4,110,101,211,166
0131-002,2016,10,14,5,140,142,282,211
0131-002,2016,10,14,6,397,234,631,282
0131-002,2016,10,14,7,825,524,1349,631
0131-002,2016,10,14,8,1662,1059,2721,1349
0131-002,2016,10,14,9,1534,1345,2879,2721
0131-002,2016,10,14,10,1234,1183,2417,2879
0131-002,2016,10,14,11,1199,1215,2414,2417
0131-002,2016,10,14,12,1155,1242,2397,2414
0131-002,2016,10,14,13,960,1148,2108,2397
0131-002,2016,10,14,14,1104,1216,2320,2108
0131-002,2016,10,14,15,1214,1275,2489,2320
0131-002,2016,10,14,16,1215,1355,2570,2489
0131-002,2016,10,14,17,1111,1426,2537,2570
0131-002,2016,10,14,18,1318,1751,3069,2537
0131-002,2016,10,14,19,1266,1623,2889,3069
0131-002,2016,10,14,20,936,1321,2257,2889
0131-002,2016,10,14,21,743,983,1726,2257
0131-002,2016,10,14,22,555,645,1200,1726
0131-002,2016,10,14,23,393,425,818,1200
0131-002,2016,10,14,24,283,284,567,818
0131-002,2016,10,15,1,199,189,388,567
0131-002,2016,10,15,2,120,142,262,388
0131-002,2016,10,15,3,112,94,206,262
0131-002,2016,10,15,4,104,107,211,206
0131-002,2016,10,15,5,130,140,270,211
0131-002,2016,10,15,6,338,189,527,270
0131-002,2016,10,15,7,623,409,1032,527
0131-002,2016,10,15,8,1017,756,1773,1032
0131-002,2016,10,15,9,993,1093,2086,1773
0131-002,2016,10,15,10,1060,1128,2188,2086
0131-002,2016,10,15,11,1138,1321,2459,2188
0131-002,2016,10,15,12,1026,1419,2445,2459
0131-002,2016,10,15,13,1089,1266,2355,2445
0131-002,2016,10,15,14,1030,1383,2413,2355
0131-002,2016,10,15,15,1036,1264,2300,2413
0131-002,2016,10,15,16,1095,1191,2286,2300
0131-002,2016,10,15,17,1112,1323,2435,2286
0131-002,2016,10,15,18,1224,1534,2758,2435
0131-002,2016,10,15,19,1199,1232,2431,2758
0131-002,2016,10,15,20,1088,880,1968,2431
0131-002,2016,10,15,21,940,615,1555,1968
0131-002,2016,10,15,22,611,493,1104,1555
0131-002,2016,10,15,23,336,326,662,1104
0131-002,2016,10,15,24,213,253,466,662
0131-002,2016,10,16,1,167,165,332,466
0131-002,2016,10,16,2,120,106,226,332
0131-002,2016,10,16,3,84,89,173,226
0131-002,2016,10,16,4,78,73,151,173
0131-002,2016,10,16,5,91,73,164,151
0131-002,2016,10,16,6,182,119,301,164
0131-002,2016,10,16,7,304,215,519,301
0131-002,2016,10,16,8,397,331,728,519
0131-002,2016,10,16,9,488,511,999,728
0131-002,2016,10,16,10,484,628,1112,999
0131-002,2016,10,16,11,661,735,1396,1112
0131-002,2016,10,16,12,652,708,1360,1396
0131-002,2016,10,16,13,707,776,1483,1360
0131-002,2016,10,16,14,797,805,1602,1483
0131-002,2016,10,16,15,811,891,1702,1602
0131-002,2016,10,16,16,928,958,1886,1702
0131-002,2016,10,16,17,1103,1045,2148,1886
0131-002,2016,10,16,18,1062,1042,2104,2148
0131-002,2016,10,16,19,916,946,1862,2104
0131-002,2016,10,16,20,1021,646,1667,1862
0131-002,2016,10,16,21,874,515,1389,1667
0131-002,2016,10,16,22,598,376,974,1389
0131-002,2016,10,16,23,357,271,628,974
0131-002,2016,10,16,24,225,165,390,628
0131-002,2016,10,17,1,149,106,255,390
0131-002,2016,10,17,2,90,81,171,255
0131-002,2016,10,17,3,67,50,117,171
0131-002,2016,10,17,4,62,72,134,117
0131-002,2016,10,17,5,124,98,222,134
0131-002,2016,10,17,6,432,213,645,222
0131-002,2016,10,17,7,939,522,1461,645
0131-002,2016,10,17,8,1944,1105,3049,1461
0131-002,2016,10,17,9,1602,1258,2860,3049
0131-002,2016,10,17,10,1065,1140,2205,2860
0131-002,2016,10,17,11,1137,1112,2249,2205
0131-002,2016,10,17,12,1002,1091,2093,2249
0131-002,2016,10,17,13,964,949,1913,2093
0131-002,2016,10,17,14,1170,1120,2290,1913
0131-002,2016,10,17,15,1216,1200,2416,2290
0131-002,2016,10,17,16,1273,1223,2496,2416
0131-002,2016,10,17,17,1118,1317,2435,2496
0131-002,2016,10,17,18,1120,1566,2686,2435
0131-002,2016,10,17,19,997,1443,2440,2686
0131-002,2016,10,17,20,771,1019,1790,2440
0131-002,2016,10,17,21,633,954,1587,1790
0131-002,2016,10,17,22,408,659,1067,1587
0131-002,2016,10,17,23,346,403,749,1067
0131-002,2016,10,17,24,246,238,484,749
0131-002,2016,10,18,1,162,167,329,484
0131-002,2016,10,18,2,100,110,210,329
0131-002,2016,10,18,3,82,88,170,210
0131-002,2016,10,18,4,87,90,177,170
0131-002,2016,10,18,5,119,136,255,177
0131-002,2016,10,18,6,403,200,603,255
0131-002,2016,10,18,7,800,495,1295,603
0131-002,2016,10,18,8,1786,1071,2857,1295
0131-002,2016,10,18,9,1645,1379,3024,2857
0131-002,2016,10,18,10,1164,1255,2419,3024
0131-002,2016,10,18,11,1135,1185,2320,2419
0131-002,2016,10,18,12,1096,1122,2218,2320
0131-002,2016,10,18,13,970,1059,2029,2218
0131-002,2016,10,18,14,1130,1094,2224,2029
0131-002,2016,10,18,15,1210,1309,2519,2224
0131-002,2016,10,18,16,1126,1292,2418,2519
0131-002,2016,10,18,17,1076,1366,2442,2418
0131-002,2016,10,18,18,1115,1581,2696,2442
0131-002,2016,10,18,19,1075,1411,2486,2696
0131-002,2016,10,18,20,819,1049,1868,2486
0131-002,2016,10,18,21,635,940,1575,1868
0131-002,2016,10,18,22,468,676,1144,1575
0131-002,2016,10,18,23,349,425,774,1144
0131-002,2016,10,18,24,248,258,506,774
0131-002,2016,10,19,1,158,174,332,506
0131-002,2016,10,19,2,95,117,212,332
0131-002,2016,10,19,3,101,80,181,212
0131-002,2016,10,19,4,85,104,189,181
0131-002,2016,10,19,5,121,130,251,189
0131-002,2016,10,19,6,396,199,595,251
0131-002,2016,10,19,7,840,463,1303,595
0131-002,2016,10,19,8,1720,1044,2764,1303
0131-002,2016,10,19,9,1577,1361,2938,2764
0131-002,2016,10,19,10,1156,1179,2335,2938
0131-002,2016,10,19,11,1192,1206,2398,2335
0131-002,2016,10,19,12,1061,1168,2229,2398
0131-002,2016,10,19,13,939,993,1932,2229
0131-002,2016,10,19,14,1126,1116,2242,1932
0131-002,2016,10,19,15,1133,1277,2410,2242
0131-002,2016,10,19,16,1158,1339,2497,2410
0131-002,2016,10,19,17,1039,1382,2421,2497
0131-002,2016,10,19,18,1136,1750,2886,2421
0131-002,2016,10,19,19,1118,1532,2650,2886
0131-002,2016,10,19,20,809,1090,1899,2650
0131-002,2016,10,19,21,574,890,1464,1899
0131-002,2016,10,19,22,533,588,1121,1464
0131-002,2016,10,19,23,366,444,810,1121
0131-002,2016,10,19,24,253,255,508,810
0131-002,2016,10,20,1,154,164,318,508
0131-002,2016,10,20,2,106,126,232,318
0131-002,2016,10,20,3,73,93,166,232
0131-002,2016,10,20,4,96,99,195,166
0131-002,2016,10,20,5,120,147,267,195
0131-002,2016,10,20,6,400,214,614,267
0131-002,2016,10,20,7,808,452,1260,614
0131-002,2016,10,20,8,1716,1038,2754,1260
0131-002,2016,10,20,9,1579,1321,2900,2754
0131-002,2016,10,20,10,1198,1146,2344,2900
0131-002,2016,10,20,11,1133,1179,2312,2344
0131-002,2016,10,20,12,1135,1182,2317,2312
0131-002,2016,10,20,13,957,1035,1992,2317
0131-002,2016,10,20,14,1080,1097,2177,1992
0131-002,2016,10,20,15,1185,1280,2465,2177
0131-002,2016,10,20,16,1124,1299,2423,2465
0131-002,2016,10,20,17,1027,1330,2357,2423
0131-002,2016,10,20,18,1244,1685,2929,2357
0131-002,2016,10,20,19,1121,1361,2482,2929
0131-002,2016,10,20,20,838,1054,1892,2482
0131-002,2016,10,20,21,678,923,1601,1892
0131-002,2016,10,20,22,510,695,1205,1601
0131-002,2016,10,20,23,388,430,818,1205
0131-002,2016,10,20,24,251,260,511,818
0131-002,2016,10,21,1,184,180,364,511
0131-002,2016,10,21,2,128,149,277,364
0131-002,2016,10,21,3,80,94,174,277
0131-002,2016,10,21,4,108,98,206,174
0131-002,2016,10,21,5,142,135,277,206
0131-002,2016,10,21,6,415,199,614,277
0131-002,2016,10,21,7,831,475,1306,614
0131-002,2016,10,21,8,1722,1044,2766,1306
0131-002,2016,10,21,9,1569,1331,2900,2766
0131-002,2016,10,21,10,1215,1229,2444,2900
0131-002,2016,10,21,11,1145,1248,2393,2444
0131-002,2016,10,21,12,1095,1210,2305,2393
0131-002,2016,10,21,13,1051,1144,2195,2305
0131-002,2016,10,21,14,1143,1179,2322,2195
0131-002,2016,10,21,15,1206,1218,2424,2322
0131-002,2016,10,21,16,1145,1413,2558,2424
0131-002,2016,10,21,17,1137,1439,2576,2558
0131-002,2016,10,21,18,1262,1723,2985,2576
0131-002,2016,10,21,19,1296,1645,2941,2985
0131-002,2016,10,21,20,1218,1210,2428,2941
0131-002,2016,10,21,21,731,967,1698,2428
0131-002,2016,10,21,22,561,658,1219,1698
0131-002,2016,10,21,23,419,433,852,1219
0131-002,2016,10,21,24,230,258,488,852
0131-002,2016,10,22,1,187,207,394,488
0131-002,2016,10,22,2,144,146,290,394
0131-002,2016,10,22,3,94,79,173,290
0131-002,2016,10,22,4,79,110,189,173
0131-002,2016,10,22,5,130,141,271,189
0131-002,2016,10,22,6,375,210,585,271
0131-002,2016,10,22,7,664,413,1077,585
0131-002,2016,10,22,8,1001,739,1740,1077
0131-002,2016,10,22,9,1067,1097,2164,1740
0131-002,2016,10,22,10,1068,1158,2226,2164
0131-002,2016,10,22,11,1048,1220,2268,2226
0131-002,2016,10,22,12,1028,1247,2275,2268
0131-002,2016,10,22,13,1027,1182,2209,2275
0131-002,2016,10,22,14,1011,1130,2141,2209
0131-002,2016,10,22,15,1018,1170,2188,2141
0131-002,2016,10,22,16,998,1109,2107,2188
0131-002,2016,10,22,17,1125,1214,2339,2107
0131-002,2016,10,22,18,1187,1516,2703,2339
0131-002,2016,10,22,19,1078,1211,2289,2703
0131-002,2016,10,22,20,942,851,1793,2289
0131-002,2016,10,22,21,627,631,1258,1793
0131-002,2016,10,22,22,496,453,949,1258
0131-002,2016,10,22,23,320,345,665,949
0131-002,2016,10,22,24,206,231,437,665
0131-002,2016,10,23,1,144,166,310,437
0131-002,2016,10,23,2,104,109,213,310
0131-002,2016,10,23,3,94,102,196,213
0131-002,2016,10,23,4,75,51,126,196
0131-002,2016,10,23,5,95,88,183,126
0131-002,2016,10,23,6,193,121,314,183
0131-002,2016,10,23,7,350,210,560,314
0131-002,2016,10,23,8,443,344,787,560
0131-002,2016,10,23,9,536,498,1034,787
0131-002,2016,10,23,10,580,602,1182,1034
0131-002,2016,10,23,11,628,728,1356,1182
0131-002,2016,10,23,12,659,681,1340,1356
0131-002,2016,10,23,13,689,724,1413,1340
0131-002,2016,10,23,14,682,774,1456,1413
0131-002,2016,10,23,15,861,889,1750,1456
0131-002,2016,10,23,16,869,962,1831,1750
0131-002,2016,10,23,17,896,1036,1932,1831
0131-002,2016,10,23,18,1002,1087,2089,1932
0131-002,2016,10,23,19,969,858,1827,2089
0131-002,2016,10,23,20,1032,644,1676,1827
0131-002,2016,10,23,21,986,569,1555,1676
0131-002,2016,10,23,22,867,382,1249,1555
0131-002,2016,10,23,23,624,283,907,1249
0131-002,2016,10,23,24,251,175,426,907
0131-002,2016,10,24,1,147,94,241,426
0131-002,2016,10,24,2,107,75,182,241
0131-002,2016,10,24,3,75,69,144,182
0131-002,2016,10,24,4,66,74,140,144
0131-002,2016,10,24,5,143,115,258,140
0131-002,2016,10,24,6,436,218,654,258
0131-002,2016,10,24,7,942,509,1451,654
0131-002,2016,10,24,8,1924,1112,3036,1451
0131-002,2016,10,24,9,1691,1298,2989,3036
0131-002,2016,10,24,10,1102,1142,2244,2989
0131-002,2016,10,24,11,1107,1178,2285,2244
0131-002,2016,10,24,12,1107,1258,2365,2285
0131-002,2016,10,24,13,1008,1066,2074,2365
0131-002,2016,10,24,14,1090,1107,2197,2074
0131-002,2016,10,24,15,1223,1276,2499,2197
0131-002,2016,10,24,16,1222,1278,2500,2499
0131-002,2016,10,24,17,1058,1368,2426,2500
0131-002,2016,10,24,18,1150,1578,2728,2426
0131-002,2016,10,24,19,1019,1514,2533,2728
0131-002,2016,10,24,20,743,1088,1831,2533
0131-002,2016,10,24,21,631,905,1536,1831
0131-002,2016,10,24,22,521,622,1143,1536
0131-002,2016,10,24,23,348,408,756,1143
0131-002,2016,10,24,24,227,245,472,756
0131-002,2016,10,25,1,161,151,312,472
0131-002,2016,10,25,2,96,134,230,312
0131-002,2016,10,25,3,84,77,161,230
0131-002,2016,10,25,4,100,95,195,161
0131-002,2016,10,25,5,100,98,198,195
0131-002,2016,10,25,6,319,192,511,198
0131-002,2016,10,25,7,640,404,1044,511
0131-002,2016,10,25,8,1573,947,2520,1044
0131-002,2016,10,25,9,1420,1321,2741,2520
0131-002,2016,10,25,10,1152,1078,2230,2741
0131-002,2016,10,25,11,1096,1103,2199,2230
0131-002,2016,10,25,12,1062,1114,2176,2199
0131-002,2016,10,25,13,896,1002,1898,2176
0131-002,2016,10,25,14,1054,1120,2174,1898
0131-002,2016,10,25,15,1196,1210,2406,2174
0131-002,2016,10,25,16,1085,1191,2276,2406
0131-002,2016,10,25,17,1039,1225,2264,2276
0131-002,2016,10,25,18,1061,1480,2541,2264
0131-002,2016,10,25,19,993,1366,2359,2541
0131-002,2016,10,25,20,723,973,1696,2359
0131-002,2016,10,25,21,635,923,1558,1696
0131-002,2016,10,25,22,515,666,1181,1558
0131-002,2016,10,25,23,375,421,796,1181
0131-002,2016,10,25,24,261,262,523,796
0131-002,2016,10,26,1,165,192,357,523
0131-002,2016,10,26,2,91,133,224,357
0131-002,2016,10,26,3,91,84,175,224
0131-002,2016,10,26,4,73,75,148,175
0131-002,2016,10,26,5,137,125,262,148
0131-002,2016,10,26,6,374,209,583,262
0131-002,2016,10,26,7,794,456,1250,583
0131-002,2016,10,26,8,1682,999,2681,1250
0131-002,2016,10,26,9,1548,1336,2884,2681
0131-002,2016,10,26,10,1215,1165,2380,2884
0131-002,2016,10,26,11,1144,1194,2338,2380
0131-002,2016,10,26,12,1108,1106,2214,2338
0131-002,2016,10,26,13,989,991,1980,2214
0131-002,2016,10,26,14,1079,1100,2179,1980
0131-002,2016,10,26,15,1163,1267,2430,2179
0131-002,2016,10,26,16,1102,1378,2480,2430
0131-002,2016,10,26,17,1074,1269,2343,2480
0131-002,2016,10,26,18,1182,1659,2841,2343
0131-002,2016,10,26,19,1092,1465,2557,2841
0131-002,2016,10,26,20,735,1051,1786,2557
0131-002,2016,10,26,21,662,832,1494,1786
0131-002,2016,10,26,22,505,606,1111,1494
0131-002,2016,10,26,23,354,412,766,1111
0131-002,2016,10,26,24,220,281,501,766
0131-002,2016,10,27,1,164,187,351,501
0131-002,2016,10,27,2,100,106,206,351
0131-002,2016,10,27,3,94,84,178,206
0131-002,2016,10,27,4,75,99,174,178
0131-002,2016,10,27,5,122,126,248,174
0131-002,2016,10,27,6,386,203,589,248
0131-002,2016,10,27,7,834,470,1304,589
0131-002,2016,10,27,8,1694,1007,2701,1304
0131-002,2016,10,27,9,1559,1341,2900,2701
0131-002,2016,10,27,10,1140,1199,2339,2900
0131-002,2016,10,27,11,1159,1159,2318,2339
0131-002,2016,10,27,12,1116,1113,2229,2318
0131-002,2016,10,27,13,1001,969,1970,2229
0131-002,2016,10,27,14,1141,1108,2249,1970
0131-002,2016,10,27,15,1203,1228,2431,2249
0131-002,2016,10,27,16,1176,1220,2396,2431
0131-002,2016,10,27,17,1076,1330,2406,2396
0131-002,2016,10,27,18,1204,1567,2771,2406
0131-002,2016,10,27,19,1041,1424,2465,2771
0131-002,2016,10,27,20,840,1078,1918,2465
0131-002,2016,10,27,21,603,924,1527,1918
0131-002,2016,10,27,22,484,656,1140,1527
0131-002,2016,10,27,23,386,421,807,1140
0131-002,2016,10,27,24,305,302,607,807
0131-002,2016,10,28,1,206,199,405,607
0131-002,2016,10,28,2,117,110,227,405
0131-002,2016,10,28,3,99,109,208,227
0131-002,2016,10,28,4,101,112,213,208
0131-002,2016,10,28,5,120,128,248,213
0131-002,2016,10,28,6,344,188,532,248
0131-002,2016,10,28,7,703,440,1143,532
0131-002,2016,10,28,8,1590,966,2556,1143
0131-002,2016,10,28,9,1546,1325,2871,2556
0131-002,2016,10,28,10,1192,1147,2339,2871
0131-002,2016,10,28,11,1135,1172,2307,2339
0131-002,2016,10,28,12,1139,1118,2257,2307
0131-002,2016,10,28,13,999,1037,2036,2257
0131-002,2016,10,28,14,1082,1160,2242,2036
0131-002,2016,10,28,15,1102,1247,2349,2242
0131-002,2016,10,28,16,1144,1268,2412,2349
0131-002,2016,10,28,17,1065,1310,2375,2412
0131-002,2016,10,28,18,1173,1766,2939,2375
0131-002,2016,10,28,19,1088,1733,2821,2939
0131-002,2016,10,28,20,956,1228,2184,2821
0131-002,2016,10,28,21,670,1096,1766,2184
0131-002,2016,10,28,22,557,735,1292,1766
0131-002,2016,10,28,23,426,440,866,1292
0131-002,2016,10,28,24,263,291,554,866
0131-002,2016,10,29,1,219,204,423,554
0131-002,2016,10,29,2,134,148,282,423
0131-002,2016,10,29,3,90,103,193,282
0131-002,2016,10,29,4,101,111,212,193
0131-002,2016,10,29,5,100,154,254,212
0131-002,2016,10,29,6,334,202,536,254
0131-002,2016,10,29,7,593,456,1049,536
0131-002,2016,10,29,8,974,732,1706,1049
0131-002,2016,10,29,9,1033,1335,2368,1706
0131-002,2016,10,29,10,985,1192,2177,2368
0131-002,2016,10,29,11,1071,1222,2293,2177
0131-002,2016,10,29,12,1049,1240,2289,2293
0131-002,2016,10,29,13,1039,1174,2213,2289
0131-002,2016,10,29,14,960,1131,2091,2213
0131-002,2016,10,29,15,1098,1124,2222,2091
0131-002,2016,10,29,16,989,1061,2050,2222
0131-002,2016,10,29,17,1097,1177,2274,2050
0131-002,2016,10,29,18,1244,1406,2650,2274
0131-002,2016,10,29,19,1191,1228,2419,2650
0131-002,2016,10,29,20,998,756,1754,2419
0131-002,2016,10,29,21,708,557,1265,1754
0131-002,2016,10,29,22,559,380,939,1265
0131-002,2016,10,29,23,348,333,681,939
0131-002,2016,10,29,24,206,205,411,681
0131-002,2016,10,30,1,140,148,288,411
0131-002,2016,10,30,2,107,103,210,288
0131-002,2016,10,30,3,82,91,173,210
0131-002,2016,10,30,4,74,80,154,173
0131-002,2016,10,30,5,101,88,189,154
0131-002,2016,10,30,6,175,115,290,189
0131-002,2016,10,30,7,315,194,509,290
0131-002,2016,10,30,8,437,297,734,509
0131-002,2016,10,30,9,464,476,940,734
0131-002,2016,10,30,10,510,599,1109,940
0131-002,2016,10,30,11,627,717,1344,1109
0131-002,2016,10,30,12,643,729,1372,1344
0131-002,2016,10,30,13,676,682,1358,1372
0131-002,2016,10,30,14,760,763,1523,1358
0131-002,2016,10,30,15,810,855,1665,1523
0131-002,2016,10,30,16,1045,932,1977,1665
0131-002,2016,10,30,17,1132,1021,2153,1977
0131-002,2016,10,30,18,1093,1178,2271,2153
0131-002,2016,10,30,19,1225,928,2153,2271
0131-002,2016,10,30,20,1454,712,2166,2153
0131-002,2016,10,30,21,987,545,1532,2166
0131-002,2016,10,30,22,894,375,1269,1532
0131-002,2016,10,30,23,444,276,720,1269
0131-002,2016,10,30,24,259,166,425,720
0131-002,2016,10,31,1,136,106,242,425
0131-002,2016,10,31,2,108,80,188,242
0131-002,2016,10,31,3,72,68,140,188
0131-002,2016,10,31,4,61,70,131,140
0131-002,2016,10,31,5,133,103,236,131
0131-002,2016,10,31,6,432,220,652,236
0131-002,2016,10,31,7,882,541,1423,652
0131-002,2016,10,31,8,1902,1073,2975,1423
0131-002,2016,10,31,9,1646,1331,2977,2975
0131-002,2016,10,31,10,1122,1099,2221,2977
0131-002,2016,10,31,11,1094,1101,2195,2221
0131-002,2016,10,31,12,1130,1137,2267,2195
0131-002,2016,10,31,13,994,989,1983,2267
0131-002,2016,10,31,14,1029,1120,2149,1983
0131-002,2016,10,31,15,1108,1246,2354,2149
0131-002,2016,10,31,16,1131,1239,2370,2354
0131-002,2016,10,31,17,1113,1282,2395,2370
0131-002,2016,10,31,18,1116,1486,2602,2395
0131-002,2016,10,31,19,1069,1355,2424,2602
0131-002,2016,10,31,20,750,951,1701,2424
0131-002,2016,10,31,21,619,928,1547,1701
0131-002,2016,10,31,22,451,663,1114,1547
0131-002,2016,10,31,23,364,378,742,1114
0131-002,2016,10,31,24,222,246,468,742
0131-002,2016,11,1,1,143,175,318,468
0131-002,2016,11,1,2,111,110,221,318
0131-002,2016,11,1,3,76,84,160,221
0131-002,2016,11,1,4,67,72,139,160
0131-002,2016,11,1,5,121,140,261,139
0131-002,2016,11,1,6,376,188,564,261
0131-002,2016,11,1,7,801,429,1230,564
0131-002,2016,11,1,8,1667,1093,2760,1230
0131-002,2016,11,1,9,1544,1367,2911,2760
0131-002,2016,11,1,10,1179,1146,2325,2911
0131-002,2016,11,1,11,1085,1138,2223,2325
0131-002,2016,11,1,12,1110,1179,2289,2223
0131-002,2016,11,1,13,914,1009,1923,2289
0131-002,2016,11,1,14,1205,1089,2294,1923
0131-002,2016,11,1,15,1170,1253,2423,2294
0131-002,2016,11,1,16,1147,1276,2423,2423
0131-002,2016,11,1,17,1084,1444,2528,2423
0131-002,2016,11,1,18,1097,1638,2735,2528
0131-002,2016,11,1,19,1123,1361,2484,2735
0131-002,2016,11,1,20,763,1021,1784,2484
0131-002,2016,11,1,21,595,936,1531,1784
0131-002,2016,11,1,22,491,616,1107,1531
0131-002,2016,11,1,23,372,420,792,1107
0131-002,2016,11,1,24,224,234,458,792
0131-002,2016,11,2,1,128,164,292,458
0131-002,2016,11,2,2,97,131,228,292
0131-002,2016,11,2,3,75,85,160,228
0131-002,2016,11,2,4,90,85,175,160
0131-002,2016,11,2,5,125,115,240,175
0131-002,2016,11,2,6,370,205,575,240
0131-002,2016,11,2,7,806,445,1251,575
0131-002,2016,11,2,8,1703,1037,2740,1251
0131-002,2016,11,2,9,1539,1387,2926,2740
0131-002,2016,11,2,10,1169,1151,2320,2926
0131-002,2016,11,2,11,1192,1147,2339,2320
0131-002,2016,11,2,12,1027,1102,2129,2339
0131-002,2016,11,2,13,918,1005,1923,2129
0131-002,2016,11,2,14,1044,1097,2141,1923
0131-002,2016,11,2,15,1197,1269,2466,2141
0131-002,2016,11,2,16,1231,1284,2515,2466
0131-002,2016,11,2,17,1126,1269,2395,2515
0131-002,2016,11,2,18,1127,1638,2765,2395
0131-002,2016,11,2,19,1119,1463,2582,2765
0131-002,2016,11,2,20,718,981,1699,2582
0131-002,2016,11,2,21,601,814,1415,1699
0131-002,2016,11,2,22,503,635,1138,1415
0131-002,2016,11,2,23,346,396,742,1138
0131-002,2016,11,2,24,219,220,439,742
0131-002,2016,11,3,1,148,158,306,439
0131-002,2016,11,3,2,118,116,234,306
0131-002,2016,11,3,3,75,101,176,234
0131-002,2016,11,3,4,93,88,181,176
0131-002,2016,11,3,5,130,126,256,181
0131-002,2016,11,3,6,354,208,562,256
0131-002,2016,11,3,7,788,457,1245,562
0131-002,2016,11,3,8,1708,1029,2737,1245
0131-002,2016,11,3,9,1612,1360,2972,2737
0131-002,2016,11,3,10,1097,1186,2283,2972
0131-002,2016,11,3,11,1126,1193,2319,2283
0131-002,2016,11,3,12,1137,1131,2268,2319
0131-002,2016,11,3,13,995,971,1966,2268
0131-002,2016,11,3,14,1075,1150,2225,1966
0131-002,2016,11,3,15,1111,1230,2341,2225
0131-002,2016,11,3,16,1223,1294,2517,2341
0131-002,2016,11,3,17,1040,1373,2413,2517
0131-002,2016,11,3,18,1187,1650,2837,2413
0131-002,2016,11,3,19,1125,1397,2522,2837
0131-002,2016,11,3,20,827,952,1779,2522
0131-002,2016,11,3,21,623,928,1551,1779
0131-002,2016,11,3,22,522,694,1216,1551
0131-002,2016,11,3,23,360,451,811,1216
0131-002,2016,11,3,24,222,263,485,811
0131-002,2016,11,4,1,150,162,312,485
0131-002,2016,11,4,2,119,113,232,312
0131-002,2016,11,4,3,90,84,174,232
0131-002,2016,11,4,4,84,91,175,174
0131-002,2016,11,4,5,132,119,251,175
0131-002,2016,11,4,6,378,225,603,251
0131-002,2016,11,4,7,801,437,1238,603
0131-002,2016,11,4,8,1667,1034,2701,1238
0131-002,2016,11,4,9,1620,1395,3015,2701
0131-002,2016,11,4,10,1173,1181,2354,3015
0131-002,2016,11,4,11,1115,1208,2323,2354
0131-002,2016,11,4,12,1008,1207,2215,2323
0131-002,2016,11,4,13,956,1031,1987,2215
0131-002,2016,11,4,14,1076,1093,2169,1987
0131-002,2016,11,4,15,1163,1304,2467,2169
0131-002,2016,11,4,16,1169,1393,2562,2467
0131-002,2016,11,4,17,1161,1454,2615,2562
0131-002,2016,11,4,18,1247,1665,2912,2615
0131-002,2016,11,4,19,1203,1588,2791,2912
0131-002,2016,11,4,20,977,1245,2222,2791
0131-002,2016,11,4,21,807,992,1799,2222
0131-002,2016,11,4,22,569,670,1239,1799
0131-002,2016,11,4,23,398,473,871,1239
0131-002,2016,11,4,24,257,273,530,871
0131-002,2016,11,5,1,189,227,416,530
0131-002,2016,11,5,2,143,162,305,416
0131-002,2016,11,5,3,103,100,203,305
0131-002,2016,11,5,4,109,92,201,203
0131-002,2016,11,5,5,110,134,244,201
0131-002,2016,11,5,6,328,223,551,244
0131-002,2016,11,5,7,593,428,1021,551
0131-002,2016,11,5,8,989,712,1701,1021
0131-002,2016,11,5,9,1029,1119,2148,1701
0131-002,2016,11,5,10,1026,1192,2218,2148
0131-002,2016,11,5,11,1053,1262,2315,2218
0131-002,2016,11,5,12,1052,1306,2358,2315
0131-002,2016,11,5,13,954,1252,2206,2358
0131-002,2016,11,5,14,987,1185,2172,2206
0131-002,2016,11,5,15,1010,1161,2171,2172
0131-002,2016,11,5,16,1014,1102,2116,2171
0131-002,2016,11,5,17,985,1173,2158,2116
0131-002,2016,11,5,18,1195,1477,2672,2158
0131-002,2016,11,5,19,972,1172,2144,2672
0131-002,2016,11,5,20,996,774,1770,2144
0131-002,2016,11,5,21,748,555,1303,1770
0131-002,2016,11,5,22,493,459,952,1303
0131-002,2016,11,5,23,328,298,626,952
0131-002,2016,11,5,24,204,235,439,626
0131-002,2016,11,6,1,143,152,295,439
0131-002,2016,11,6,2,109,122,231,295
0131-002,2016,11,6,3,78,88,166,231
0131-002,2016,11,6,4,76,65,141,166
0131-002,2016,11,6,5,92,86,178,141
0131-002,2016,11,6,6,169,115,284,178
0131-002,2016,11,6,7,296,201,497,284
0131-002,2016,11,6,8,426,320,746,497
0131-002,2016,11,6,9,493,545,1038,746
0131-002,2016,11,6,10,575,672,1247,1038
0131-002,2016,11,6,11,595,737,1332,1247
0131-002,2016,11,6,12,692,769,1461,1332
0131-002,2016,11,6,13,670,669,1339,1461
0131-002,2016,11,6,14,751,771,1522,1339
0131-002,2016,11,6,15,920,860,1780,1522
0131-002,2016,11,6,16,912,947,1859,1780
0131-002,2016,11,6,17,1012,999,2011,1859
0131-002,2016,11,6,18,1042,1139,2181,2011
0131-002,2016,11,6,19,925,970,1895,2181
0131-002,2016,11,6,20,971,727,1698,1895
0131-002,2016,11,6,21,791,590,1381,1698
0131-002,2016,11,6,22,898,426,1324,1381
0131-002,2016,11,6,23,680,283,963,1324
0131-002,2016,11,6,24,302,184,486,963
0131-002,2016,11,7,1,160,125,285,486
0131-002,2016,11,7,2,75,79,154,285
0131-002,2016,11,7,3,67,52,119,154
0131-002,2016,11,7,4,61,50,111,119
0131-002,2016,11,7,5,129,99,228,111
0131-002,2016,11,7,6,417,233,650,228
0131-002,2016,11,7,7,896,508,1404,650
0131-002,2016,11,7,8,1883,1080,2963,1404
0131-002,2016,11,7,9,1590,1310,2900,2963
0131-002,2016,11,7,10,1128,1182,2310,2900
0131-002,2016,11,7,11,1141,1175,2316,2310
0131-002,2016,11,7,12,1055,1184,2239,2316
0131-002,2016,11,7,13,919,1056,1975,2239
0131-002,2016,11,7,14,1099,1120,2219,1975
0131-002,2016,11,7,15,1135,1263,2398,2219
0131-002,2016,11,7,16,1206,1201,2407,2398
0131-002,2016,11,7,17,1059,1243,2302,2407
0131-002,2016,11,7,18,1051,1561,2612,2302
0131-002,2016,11,7,19,998,1383,2381,2612
0131-002,2016,11,7,20,805,968,1773,2381
0131-002,2016,11,7,21,605,894,1499,1773
0131-002,2016,11,7,22,502,617,1119,1499
0131-002,2016,11,7,23,305,358,663,1119
0131-002,2016,11,7,24,185,241,426,663
0131-002,2016,11,8,1,123,165,288,426
0131-002,2016,11,8,2,93,97,190,288
0131-002,2016,11,8,3,94,82,176,190
0131-002,2016,11,8,4,85,93,178,176
0131-002,2016,11,8,5,100,130,230,178
0131-002,2016,11,8,6,350,200,550,230
0131-002,2016,11,8,7,741,483,1224,550
0131-002,2016,11,8,8,1700,1020,2720,1224
0131-002,2016,11,8,9,1589,1424,3013,2720
0131-002,2016,11,8,10,1155,1198,2353,3013
0131-002,2016,11,8,11,1209,1237,2446,2353
0131-002,2016,11,8,12,1068,1213,2281,2446
0131-002,2016,11,8,13,996,1012,2008,2281
0131-002,2016,11,8,14,1018,1071,2089,2008
0131-002,2016,11,8,15,1149,1279,2428,2089
0131-002,2016,11,8,16,1045,1274,2319,2428
0131-002,2016,11,8,17,1034,1361,2395,2319
0131-002,2016,11,8,18,1161,1641,2802,2395
0131-002,2016,11,8,19,1047,1448,2495,2802
0131-002,2016,11,8,20,782,985,1767,2495
0131-002,2016,11,8,21,664,932,1596,1767
0131-002,2016,11,8,22,532,639,1171,1596
0131-002,2016,11,8,23,359,393,752,1171
0131-002,2016,11,8,24,238,241,479,752
0131-002,2016,11,9,1,162,173,335,479
0131-002,2016,11,9,2,99,113,212,335
0131-002,2016,11,9,3,76,86,162,212
0131-002,2016,11,9,4,71,95,166,162
0131-002,2016,11,9,5,114,142,256,166
0131-002,2016,11,9,6,346,196,542,256
0131-002,2016,11,9,7,769,472,1241,542
0131-002,2016,11,9,8,1653,1064,2717,1241
0131-002,2016,11,9,9,1617,1412,3029,2717
0131-002,2016,11,9,10,1226,1211,2437,3029
0131-002,2016,11,9,11,1166,1179,2345,2437
0131-002,2016,11,9,12,1075,1134,2209,2345
0131-002,2016,11,9,13,996,996,1992,2209
0131-002,2016,11,9,14,984,1047,2031,1992
0131-002,2016,11,9,15,1085,1180,2265,2031
0131-002,2016,11,9,16,1153,1261,2414,2265
0131-002,2016,11,9,17,1078,1376,2454,2414
0131-002,2016,11,9,18,1242,1654,2896,2454
0131-002,2016,11,9,19,1102,1414,2516,2896
0131-002,2016,11,9,20,765,1071,1836,2516
0131-002,2016,11,9,21,611,826,1437,1836
0131-002,2016,11,9,22,506,613,1119,1437
0131-002,2016,11,9,23,399,413,812,1119
0131-002,2016,11,9,24,248,232,480,812
0131-002,2016,11,10,1,163,151,314,480
0131-002,2016,11,10,2,97,105,202,314
0131-002,2016,11,10,3,75,117,192,202
0131-002,2016,11,10,4,91,85,176,192
0131-002,2016,11,10,5,132,134,266,176
0131-002,2016,11,10,6,351,194,545,266
0131-002,2016,11,10,7,763,459,1222,545
0131-002,2016,11,10,8,1692,1019,2711,1222
0131-002,2016,11,10,9,1536,1366,2902,2711
0131-002,2016,11,10,10,1168,1160,2328,2902
0131-002,2016,11,10,11,1112,1161,2273,2328
0131-002,2016,11,10,12,1086,1203,2289,2273
0131-002,2016,11,10,13,979,1030,2009,2289
0131-002,2016,11,10,14,981,1063,2044,2009
0131-002,2016,11,10,15,1101,1233,2334,2044
0131-002,2016,11,10,16,1124,1268,2392,2334
0131-002,2016,11,10,17,1063,1478,2541,2392
0131-002,2016,11,10,18,1077,1502,2579,2541
0131-002,2016,11,10,19,1046,1333,2379,2579
0131-002,2016,11,10,20,790,984,1774,2379
0131-002,2016,11,10,21,626,873,1499,1774
0131-002,2016,11,10,22,505,649,1154,1499
0131-002,2016,11,10,23,374,445,819,1154
0131-002,2016,11,10,24,230,272,502,819
0131-002,2016,11,11,1,178,181,359,502
0131-002,2016,11,11,2,125,137,262,359
0131-002,2016,11,11,3,85,94,179,262
0131-002,2016,11,11,4,93,91,184,179
0131-002,2016,11,11,5,146,111,257,184
0131-002,2016,11,11,6,330,202,532,257
0131-002,2016,11,11,7,711,448,1159,532
0131-002,2016,11,11,8,1593,1054,2647,1159
0131-002,2016,11,11,9,1583,1405,2988,2647
0131-002,2016,11,11,10,1144,1190,2334,2988
0131-002,2016,11,11,11,1123,1235,2358,2334
0131-002,2016,11,11,12,1113,1242,2355,2358
0131-002,2016,11,11,13,1035,1066,2101,2355
0131-002,2016,11,11,14,1035,1149,2184,2101
0131-002,2016,11,11,15,1079,1335,2414,2184
0131-002,2016,11,11,16,1167,1376,2543,2414
0131-002,2016,11,11,17,1083,1430,2513,2543
0131-002,2016,11,11,18,1207,1696,2903,2513
0131-002,2016,11,11,19,1127,1687,2814,2903
0131-002,2016,11,11,20,932,1248,2180,2814
0131-002,2016,11,11,21,742,989,1731,2180
0131-002,2016,11,11,22,566,724,1290,1731
0131-002,2016,11,11,23,421,464,885,1290
0131-002,2016,11,11,24,319,284,603,885
0131-002,2016,11,12,1,231,239,470,603
0131-002,2016,11,12,2,134,146,280,470
0131-002,2016,11,12,3,107,115,222,280
0131-002,2016,11,12,4,100,113,213,222
0131-002,2016,11,12,5,127,131,258,213
0131-002,2016,11,12,6,323,212,535,258
0131-002,2016,11,12,7,521,426,947,535
0131-002,2016,11,12,8,874,689,1563,947
0131-002,2016,11,12,9,970,1088,2058,1563
0131-002,2016,11,12,10,1008,1143,2151,2058
0131-002,2016,11,12,11,1094,1170,2264,2151
0131-002,2016,11,12,12,1239,1130,2369,2264
0131-002,2016,11,12,13,1061,1183,2244,2369
0131-002,2016,11,12,14,949,1213,2162,2244
0131-002,2016,11,12,15,943,1230,2173,2162
0131-002,2016,11,12,16,1005,1224,2229,2173
0131-002,2016,11,12,17,1053,1390,2443,2229
0131-002,2016,11,12,18,1199,1489,2688,2443
0131-002,2016,11,12,19,1073,1313,2386,2688
0131-002,2016,11,12,20,931,800,1731,2386
0131-002,2016,11,12,21,640,577,1217,1731
0131-002,2016,11,12,22,469,497,966,1217
0131-002,2016,11,12,23,314,324,638,966
0131-002,2016,11,12,24,205,219,424,638
0131-002,2016,11,13,1,161,183,344,424
0131-002,2016,11,13,2,111,119,230,344
0131-002,2016,11,13,3,86,96,182,230
0131-002,2016,11,13,4,70,68,138,182
0131-002,2016,11,13,5,97,85,182,138
0131-002,2016,11,13,6,165,129,294,182
0131-002,2016,11,13,7,295,221,516,294
0131-002,2016,11,13,8,392,337,729,516
0131-002,2016,11,13,9,513,479,992,729
0131-002,2016,11,13,10,561,648,1209,992
0131-002,2016,11,13,11,661,700,1361,1209
0131-002,2016,11,13,12,712,642,1354,1361
0131-002,2016,11,13,13,693,693,1386,1354
0131-002,2016,11,13,14,734,757,1491,1386
0131-002,2016,11,13,15,923,931,1854,1491
0131-002,2016,11,13,16,1094,988,2082,1854
0131-002,2016,11,13,17,1080,1234,2314,2082
0131-002,2016,11,13,18,1122,1235,2357,2314
0131-002,2016,11,13,19,1014,900,1914,2357
0131-002,2016,11,13,20,1097,751,1848,1914
0131-002,2016,11,13,21,906,544,1450,1848
0131-002,2016,11,13,22,1038,416,1454,1450
0131-002,2016,11,13,23,670,285,955,1454
0131-002,2016,11,13,24,259,183,442,955
0131-002,2016,11,14,1,149,124,273,442
0131-002,2016,11,14,2,95,79,174,273
0131-002,2016,11,14,3,82,62,144,174
0131-002,2016,11,14,4,67,84,151,144
0131-002,2016,11,14,5,131,98,229,151
0131-002,2016,11,14,6,409,207,616,229
0131-002,2016,11,14,7,880,506,1386,616
0131-002,2016,11,14,8,1843,1068,2911,1386
0131-002,2016,11,14,9,1697,1356,3053,2911
0131-002,2016,11,14,10,1153,1152,2305,3053
0131-002,2016,11,14,11,1000,1231,2231,2305
0131-002,2016,11,14,12,1036,1185,2221,2231
0131-002,2016,11,14,13,1000,1077,2077,2221
0131-002,2016,11,14,14,1110,1113,2223,2077
0131-002,2016,11,14,15,1165,1244,2409,2223
0131-002,2016,11,14,16,1104,1320,2424,2409
0131-002,2016,11,14,17,1074,1328,2402,2424
0131-002,2016,11,14,18,1130,1501,2631,2402
0131-002,2016,11,14,19,1167,1302,2469,2631
0131-002,2016,11,14,20,792,1080,1872,2469
0131-002,2016,11,14,21,587,920,1507,1872
0131-002,2016,11,14,22,509,618,1127,1507
0131-002,2016,11,14,23,312,438,750,1127
0131-002,2016,11,14,24,222,273,495,750
0131-002,2016,11,15,1,152,148,300,495
0131-002,2016,11,15,2,121,129,250,300
0131-002,2016,11,15,3,87,90,177,250
0131-002,2016,11,15,4,81,102,183,177
0131-002,2016,11,15,5,150,110,260,183
0131-002,2016,11,15,6,367,216,583,260
0131-002,2016,11,15,7,777,498,1275,583
0131-002,2016,11,15,8,1635,1047,2682,1275
0131-002,2016,11,15,9,1620,1386,3006,2682
0131-002,2016,11,15,10,1144,1239,2383,3006
0131-002,2016,11,15,11,1162,1208,2370,2383
0131-002,2016,11,15,12,1102,1163,2265,2370
0131-002,2016,11,15,13,976,1065,2041,2265
0131-002,2016,11,15,14,1054,1159,2213,2041
0131-002,2016,11,15,15,1183,1246,2429,2213
0131-002,2016,11,15,16,1130,1309,2439,2429
0131-002,2016,11,15,17,1107,1354,2461,2439
0131-002,2016,11,15,18,1185,1587,2772,2461
0131-002,2016,11,15,19,1063,1320,2383,2772
0131-002,2016,11,15,20,831,1070,1901,2383
0131-002,2016,11,15,21,669,945,1614,1901
0131-002,2016,11,15,22,493,622,1115,1614
0131-002,2016,11,15,23,404,405,809,1115
0131-002,2016,11,15,24,228,248,476,809
0131-002,2016,11,16,1,182,190,372,476
0131-002,2016,11,16,2,99,119,218,372
0131-002,2016,11,16,3,95,113,208,218
0131-002,2016,11,16,4,92,100,192,208
0131-002,2016,11,16,5,131,129,260,192
0131-002,2016,11,16,6,381,206,587,260
0131-002,2016,11,16,7,775,473,1248,587
0131-002,2016,11,16,8,1716,1022,2738,1248
0131-002,2016,11,16,9,1624,1401,3025,2738
0131-002,2016,11,16,10,1136,1240,2376,3025
0131-002,2016,11,16,11,1211,1203,2414,2376
0131-002,2016,11,16,12,1114,1199,2313,2414
0131-002,2016,11,16,13,1004,1039,2043,2313
0131-002,2016,11,16,14,1104,1112,2216,2043
0131-002,2016,11,16,15,1127,1302,2429,2216
0131-002,2016,11,16,16,1135,1294,2429,2429
0131-002,2016,11,16,17,1114,1321,2435,2429
0131-002,2016,11,16,18,1129,1734,2863,2435
0131-002,2016,11,16,19,1115,1482,2597,2863
0131-002,2016,11,16,20,784,1016,1800,2597
0131-002,2016,11,16,21,612,843,1455,1800
0131-002,2016,11,16,22,495,576,1071,1455
0131-002,2016,11,16,23,371,440,811,1071
0131-002,2016,11,16,24,231,259,490,811
0131-002,2016,11,17,1,167,174,341,490
0131-002,2016,11,17,2,129,122,251,341
0131-002,2016,11,17,3,106,96,202,251
0131-002,2016,11,17,4,82,104,186,202
0131-002,2016,11,17,5,125,137,262,186
0131-002,2016,11,17,6,353,193,546,262
0131-002,2016,11,17,7,781,534,1315,546
0131-002,2016,11,17,8,1704,1046,2750,1315
0131-002,2016,11,17,9,1722,1376,3098,2750
0131-002,2016,11,17,10,1247,1238,2485,3098
0131-002,2016,11,17,11,1210,1262,2472,2485
0131-002,2016,11,17,12,1136,1213,2349,2472
0131-002,2016,11,17,13,994,1087,2081,2349
0131-002,2016,11,17,14,1136,1148,2284,2081
0131-002,2016,11,17,15,1192,1233,2425,2284
0131-002,2016,11,17,16,1215,1304,2519,2425
0131-002,2016,11,17,17,1074,1313,2387,2519
0131-002,2016,11,17,18,1086,1665,2751,2387
0131-002,2016,11,17,19,1019,1511,2530,2751
0131-002,2016,11,17,20,785,1038,1823,2530
0131-002,2016,11,17,21,684,838,1522,1823
0131-002,2016,11,17,22,531,674,1205,1522
0131-002,2016,11,17,23,384,416,800,1205
0131-002,2016,11,17,24,241,243,484,800
0131-002,2016,11,18,1,177,207,384,484
0131-002,2016,11,18,2,124,142,266,384
0131-002,2016,11,18,3,117,124,241,266
0131-002,2016,11,18,4,94,91,185,241
0131-002,2016,11,18,5,134,143,277,185
0131-002,2016,11,18,6,389,220,609,277
0131-002,2016,11,18,7,807,478,1285,609
0131-002,2016,11,18,8,1710,1046,2756,1285
0131-002,2016,11,18,9,1606,1406,3012,2756
0131-002,2016,11,18,10,1223,1267,2490,3012
0131-002,2016,11,18,11,1179,1232,2411,2490
0131-002,2016,11,18,12,1122,1276,2398,2411
0131-002,2016,11,18,13,991,1141,2132,2398
0131-002,2016,11,18,14,1089,1221,2310,2132
0131-002,2016,11,18,15,1269,1297,2566,2310
0131-002,2016,11,18,16,1178,1415,2593,2566
0131-002,2016,11,18,17,998,1470,2468,2593
0131-002,2016,11,18,18,1323,1691,3014,2468
0131-002,2016,11,18,19,1209,1787,2996,3014
0131-002,2016,11,18,20,1122,1383,2505,2996
0131-002,2016,11,18,21,1146,1096,2242,2505
0131-002,2016,11,18,22,668,787,1455,2242
0131-002,2016,11,18,23,368,511,879,1455
0131-002,2016,11,18,24,253,307,560,879
0131-002,2016,11,19,1,200,210,410,560
0131-002,2016,11,19,2,131,153,284,410
0131-002,2016,11,19,3,117,125,242,284
0131-002,2016,11,19,4,100,95,195,242
0131-002,2016,11,19,5,100,144,244,195
0131-002,2016,11,19,6,309,199,508,244
0131-002,2016,11,19,7,525,372,897,508
0131-002,2016,11,19,8,888,652,1540,897
0131-002,2016,11,19,9,1005,1032,2037,1540
0131-002,2016,11,19,10,988,1141,2129,2037
0131-002,2016,11,19,11,1077,1233,2310,2129
0131-002,2016,11,19,12,1040,1173,2213,2310
0131-002,2016,11,19,13,1068,1217,2285,2213
0131-002,2016,11,19,14,1009,1178,2187,2285
0131-002,2016,11,19,15,1038,1095,2133,2187
0131-002,2016,11,19,16,1022,1099,2121,2133
0131-002,2016,11,19,17,1056,1235,2291,2121
0131-002,2016,11,19,18,1091,1444,2535,2291
0131-002,2016,11,19,19,972,1213,2185,2535
0131-002,2016,11,19,20,740,745,1485,2185
0131-002,2016,11,19,21,510,537,1047,1485
0131-002,2016,11,19,22,459,436,895,1047
0131-002,2016,11,19,23,328,321,649,895
0131-002,2016,11,19,24,215,238,453,649
0131-002,2016,11,20,1,138,159,297,453
0131-002,2016,11,20,2,89,131,220,297
0131-002,2016,11,20,3,77,80,157,220
0131-002,2016,11,20,4,79,69,148,157
0131-002,2016,11,20,5,78,77,155,148
0131-002,2016,11,20,6,156,98,254,155
0131-002,2016,11,20,7,272,203,475,254
0131-002,2016,11,20,8,411,331,742,475
0131-002,2016,11,20,9,521,472,993,742
0131-002,2016,11,20,10,546,627,1173,993
0131-002,2016,11,20,11,588,690,1278,1173
0131-002,2016,11,20,12,667,711,1378,1278
0131-002,2016,11,20,13,708,748,1456,1378
0131-002,2016,11,20,14,815,822,1637,1456
0131-002,2016,11,20,15,908,889,1797,1637
0131-002,2016,11,20,16,905,924,1829,1797
0131-002,2016,11,20,17,1031,1108,2139,1829
0131-002,2016,11,20,18,1199,1077,2276,2139
0131-002,2016,11,20,19,1107,967,2074,2276
0131-002,2016,11,20,20,1043,657,1700,2074
0131-002,2016,11,20,21,847,532,1379,1700
0131-002,2016,11,20,22,668,385,1053,1379
0131-002,2016,11,20,23,366,277,643,1053
0131-002,2016,11,20,24,244,183,427,643
0131-002,2016,11,21,1,175,113,288,427
0131-002,2016,11,21,2,92,79,171,288
0131-002,2016,11,21,3,63,55,118,171
0131-002,2016,11,21,4,58,66,124,118
0131-002,2016,11,21,5,143,112,255,124
0131-002,2016,11,21,6,405,197,602,255
0131-002,2016,11,21,7,884,534,1418,602
0131-002,2016,11,21,8,1831,1083,2914,1418
0131-002,2016,11,21,9,1673,1361,3034,2914
0131-002,2016,11,21,10,1129,1160,2289,3034
0131-002,2016,11,21,11,1127,1149,2276,2289
0131-002,2016,11,21,12,1118,1136,2254,2276
0131-002,2016,11,21,13,945,982,1927,2254
0131-002,2016,11,21,14,1058,1077,2135,1927
0131-002,2016,11,21,15,1098,1213,2311,2135
0131-002,2016,11,21,16,1214,1191,2405,2311
0131-002,2016,11,21,17,1062,1251,2313,2405
0131-002,2016,11,21,18,1061,1518,2579,2313
0131-002,2016,11,21,19,1023,1292,2315,2579
0131-002,2016,11,21,20,758,939,1697,2315
0131-002,2016,11,21,21,634,918,1552,1697
0131-002,2016,11,21,22,494,603,1097,1552
0131-002,2016,11,21,23,312,396,708,1097
0131-002,2016,11,21,24,221,248,469,708
0131-002,2016,11,22,1,152,154,306,469
0131-002,2016,11,22,2,94,120,214,306
0131-002,2016,11,22,3,82,81,163,214
0131-002,2016,11,22,4,67,94,161,163
0131-002,2016,11,22,5,123,131,254,161
0131-002,2016,11,22,6,373,199,572,254
0131-002,2016,11,22,7,720,463,1183,572
0131-002,2016,11,22,8,1522,987,2509,1183
0131-002,2016,11,22,9,1523,1382,2905,2509
0131-002,2016,11,22,10,1127,1180,2307,2905
0131-002,2016,11,22,11,1137,1227,2364,2307
0131-002,2016,11,22,12,1026,1132,2158,2364
0131-002,2016,11,22,13,961,894,1855,2158
0131-002,2016,11,22,14,1097,1060,2157,1855
0131-002,2016,11,22,15,1100,1238,2338,2157
0131-002,2016,11,22,16,1102,1238,2340,2338
0131-002,2016,11,22,17,1096,1295,2391,2340
0131-002,2016,11,22,18,1153,1489,2642,2391
0131-002,2016,11,22,19,982,1332,2314,2642
0131-002,2016,11,22,20,749,896,1645,2314
0131-002,2016,11,22,21,589,919,1508,1645
0131-002,2016,11,22,22,548,617,1165,1508
0131-002,2016,11,22,23,353,413,766,1165
0131-002,2016,11,22,24,226,261,487,766
0131-002,2016,11,23,1,155,167,322,487
0131-002,2016,11,23,2,109,108,217,322
0131-002,2016,11,23,3,93,73,166,217
0131-002,2016,11,23,4,80,103,183,166
0131-002,2016,11,23,5,116,118,234,183
0131-002,2016,11,23,6,356,186,542,234
0131-002,2016,11,23,7,701,403,1104,542
0131-002,2016,11,23,8,1586,983,2569,1104
0131-002,2016,11,23,9,1502,1375,2877,2569
0131-002,2016,11,23,10,1139,1107,2246,2877
0131-002,2016,11,23,11,1078,1171,2249,2246
0131-002,2016,11,23,12,1039,1085,2124,2249
0131-002,2016,11,23,13,935,979,1914,2124
0131-002,2016,11,23,14,1007,1022,2029,1914
0131-002,2016,11,23,15,1132,1246,2378,2029
0131-002,2016,11,23,16,1098,1269,2367,2378
0131-002,2016,11,23,17,1048,1266,2314,2367
0131-002,2016,11,23,18,1111,1610,2721,2314
0131-002,2016,11,23,19,967,1344,2311,2721
0131-002,2016,11,23,20,747,937,1684,2311
0131-002,2016,11,23,21,636,809,1445,1684
0131-002,2016,11,23,22,510,537,1047,1445
0131-002,2016,11,23,23,326,436,762,1047
0131-002,2016,11,23,24,222,253,475,762
0131-002,2016,11,24,1,183,192,375,475
0131-002,2016,11,24,2,107,139,246,375
0131-002,2016,11,24,3,101,85,186,246
0131-002,2016,11,24,4,82,104,186,186
0131-002,2016,11,24,5,121,118,239,186
0131-002,2016,11,24,6,327,205,532,239
0131-002,2016,11,24,7,732,412,1144,532
0131-002,2016,11,24,8,1548,968,2516,1144
0131-002,2016,11,24,9,1506,1357,2863,2516
0131-002,2016,11,24,10,1155,1136,2291,2863
0131-002,2016,11,24,11,1132,1234,2366,2291
0131-002,2016,11,24,12,1054,1181,2235,2366
0131-002,2016,11,24,13,889,943,1832,2235
0131-002,2016,11,24,14,1100,1101,2201,1832
0131-002,2016,11,24,15,1106,1210,2316,2201
0131-002,2016,11,24,16,1075,1191,2266,2316
0131-002,2016,11,24,17,1012,1303,2315,2266
0131-002,2016,11,24,18,1109,1513,2622,2315
0131-002,2016,11,24,19,974,1356,2330,2622
0131-002,2016,11,24,20,788,951,1739,2330
0131-002,2016,11,24,21,607,822,1429,1739
0131-002,2016,11,24,22,539,657,1196,1429
0131-002,2016,11,24,23,397,445,842,1196
0131-002,2016,11,24,24,239,244,483,842
0131-002,2016,11,25,1,156,194,350,483
0131-002,2016,11,25,2,109,124,233,350
0131-002,2016,11,25,3,81,98,179,233
0131-002,2016,11,25,4,81,84,165,179
0131-002,2016,11,25,5,120,121,241,165
0131-002,2016,11,25,6,348,186,534,241
0131-002,2016,11,25,7,751,434,1185,534
0131-002,2016,11,25,8,1538,967,2505,1185
0131-002,2016,11,25,9,1477,1343,2820,2505
0131-002,2016,11,25,10,1102,1169,2271,2820
0131-002,2016,11,25,11,1150,1183,2333,2271
0131-002,2016,11,25,12,1042,1126,2168,2333
0131-002,2016,11,25,13,954,1020,1974,2168
0131-002,2016,11,25,14,1018,1098,2116,1974
0131-002,2016,11,25,15,1206,1279,2485,2116
0131-002,2016,11,25,16,1158,1294,2452,2485
0131-002,2016,11,25,17,1198,1444,2642,2452
0131-002,2016,11,25,18,1168,1727,2895,2642
0131-002,2016,11,25,19,1234,1672,2906,2895
0131-002,2016,11,25,20,1085,1292,2377,2906
0131-002,2016,11,25,21,932,1119,2051,2377
0131-002,2016,11,25,22,608,794,1402,2051
0131-002,2016,11,25,23,381,479,860,1402
0131-002,2016,11,25,24,291,313,604,860
0131-002,2016,11,26,1,172,221,393,604
0131-002,2016,11,26,2,131,147,278,393
0131-002,2016,11,26,3,112,118,230,278
0131-002,2016,11,26,4,98,102,200,230
0131-002,2016,11,26,5,124,139,263,200
0131-002,2016,11,26,6,297,195,492,263
0131-002,2016,11,26,7,569,352,921,492
0131-002,2016,11,26,8,880,668,1548,921
0131-002,2016,11,26,9,1051,1014,2065,1548
0131-002,2016,11,26,10,956,1024,1980,2065
0131-002,2016,11,26,11,1008,1001,2009,1980
0131-002,2016,11,26,12,1051,1058,2109,2009
0131-002,2016,11,26,13,970,1025,1995,2109
0131-002,2016,11,26,14,866,1028,1894,1995
0131-002,2016,11,26,15,905,1065,1970,1894
0131-002,2016,11,26,16,936,1098,2034,1970
0131-002,2016,11,26,17,1057,1165,2222,2034
0131-002,2016,11,26,18,1076,1329,2405,2222
0131-002,2016,11,26,19,899,999,1898,2405
0131-002,2016,11,26,20,666,658,1324,1898
0131-002,2016,11,26,21,483,560,1043,1324
0131-002,2016,11,26,22,392,369,761,1043
0131-002,2016,11,26,23,329,292,621,761
0131-002,2016,11,26,24,207,210,417,621
0131-002,2016,11,27,1,167,145,312,417
0131-002,2016,11,27,2,92,99,191,312
0131-002,2016,11,27,3,76,100,176,191
0131-002,2016,11,27,4,71,70,141,176
0131-002,2016,11,27,5,63,73,136,141
0131-002,2016,11,27,6,148,109,257,136
0131-002,2016,11,27,7,282,139,421,257
0131-002,2016,11,27,8,381,292,673,421
0131-002,2016,11,27,9,438,438,876,673
0131-002,2016,11,27,10,488,550,1038,876
0131-002,2016,11,27,11,576,614,1190,1038
0131-002,2016,11,27,12,639,680,1319,1190
0131-002,2016,11,27,13,724,674,1398,1319
0131-002,2016,11,27,14,751,674,1425,1398
0131-002,2016,11,27,15,824,871,1695,1425
0131-002,2016,11,27,16,882,1043,1925,1695
0131-002,2016,11,27,17,850,929,1779,1925
0131-002,2016,11,27,18,889,972,1861,1779
0131-002,2016,11,27,19,834,766,1600,1861
0131-002,2016,11,27,20,631,542,1173,1600
0131-002,2016,11,27,21,573,421,994,1173
0131-002,2016,11,27,22,658,341,999,994
0131-002,2016,11,27,23,342,261,603,999
0131-002,2016,11,27,24,231,184,415,603
0131-002,2016,11,28,1,135,101,236,415
0131-002,2016,11,28,2,86,67,153,236
0131-002,2016,11,28,3,74,56,130,153
0131-002,2016,11,28,4,66,62,128,130
0131-002,2016,11,28,5,160,111,271,128
0131-002,2016,11,28,6,399,213,612,271
0131-002,2016,11,28,7,786,526,1312,612
0131-002,2016,11,28,8,1491,1005,2496,1312
0131-002,2016,11,28,9,1568,1108,2676,2496
0131-002,2016,11,28,10,1030,1086,2116,2676
0131-002,2016,11,28,11,1130,1094,2224,2116
0131-002,2016,11,28,12,1026,1100,2126,2224
0131-002,2016,11,28,13,933,969,1902,2126
0131-002,2016,11,28,14,1088,1092,2180,1902
0131-002,2016,11,28,15,1151,1145,2296,2180
0131-002,2016,11,28,16,1155,1252,2407,2296
0131-002,2016,11,28,17,1038,1319,2357,2407
0131-002,2016,11,28,18,1141,1509,2650,2357
0131-002,2016,11,28,19,1012,1242,2254,2650
0131-002,2016,11,28,20,734,950,1684,2254
0131-002,2016,11,28,21,548,906,1454,1684
0131-002,2016,11,28,22,467,614,1081,1454
0131-002,2016,11,28,23,325,368,693,1081
0131-002,2016,11,28,24,203,219,422,693
0131-002,2016,11,29,1,120,148,268,422
0131-002,2016,11,29,2,96,109,205,268
0131-002,2016,11,29,3,73,85,158,205
0131-002,2016,11,29,4,74,90,164,158
0131-002,2016,11,29,5,137,115,252,164
0131-002,2016,11,29,6,349,195,544,252
0131-002,2016,11,29,7,787,456,1243,544
0131-002,2016,11,29,8,1627,1047,2674,1243
0131-002,2016,11,29,9,1427,1317,2744,2674
0131-002,2016,11,29,10,1105,1191,2296,2744
0131-002,2016,11,29,11,1139,1123,2262,2296
0131-002,2016,11,29,12,1009,1100,2109,2262
0131-002,2016,11,29,13,938,938,1876,2109
0131-002,2016,11,29,14,1021,1102,2123,1876
0131-002,2016,11,29,15,1081,1179,2260,2123
0131-002,2016,11,29,16,1053,1151,2204,2260
0131-002,2016,11,29,17,1035,1249,2284,2204
0131-002,2016,11,29,18,1126,1531,2657,2284
0131-002,2016,11,29,19,946,1212,2158,2657
0131-002,2016,11,29,20,694,963,1657,2158
0131-002,2016,11,29,21,595,876,1471,1657
0131-002,2016,11,29,22,516,591,1107,1471
0131-002,2016,11,29,23,322,434,756,1107
0131-002,2016,11,29,24,222,267,489,756
0131-002,2016,11,30,1,159,183,342,489
0131-002,2016,11,30,2,104,105,209,342
0131-002,2016,11,30,3,84,78,162,209
0131-002,2016,11,30,4,80,95,175,162
0131-002,2016,11,30,5,132,142,274,175
0131-002,2016,11,30,6,361,192,553,274
0131-002,2016,11,30,7,730,452,1182,553
0131-002,2016,11,30,8,1584,1047,2631,1182
0131-002,2016,11,30,9,1431,1310,2741,2631
0131-002,2016,11,30,10,1119,1100,2219,2741
0131-002,2016,11,30,11,1159,1177,2336,2219
0131-002,2016,11,30,12,1105,1109,2214,2336
0131-002,2016,11,30,13,958,962,1920,2214
0131-002,2016,11,30,14,1047,1100,2147,1920
0131-002,2016,11,30,15,1031,1237,2268,2147
0131-002,2016,11,30,16,1091,1151,2242,2268
0131-002,2016,11,30,17,1003,1229,2232,2242
0131-002,2016,11,30,18,1091,1549,2640,2232
0131-002,2016,11,30,19,937,1264,2201,2640
0131-002,2016,11,30,20,701,958,1659,2201
0131-002,2016,11,30,21,582,753,1335,1659
0131-002,2016,11,30,22,477,520,997,1335
0131-002,2016,11,30,23,384,391,775,997
0131-002,2016,11,30,24,210,265,475,775
0131-002,2016,12,1,1,175,184,359,475
0131-002,2016,12,1,2,113,111,224,359
0131-002,2016,12,1,3,88,94,182,224
0131-002,2016,12,1,4,86,97,183,182
0131-002,2016,12,1,5,130,139,269,183
0131-002,2016,12,1,6,355,230,585,269
0131-002,2016,12,1,7,744,452,1196,585
0131-002,2016,12,1,8,1665,1027,2692,1196
0131-002,2016,12,1,9,1479,1287,2766,2692
0131-002,2016,12,1,10,1081,1107,2188,2766
0131-002,2016,12,1,11,1091,1127,2218,2188
0131-002,2016,12,1,12,1033,1168,2201,2218
0131-002,2016,12,1,13,903,885,1788,2201
0131-002,2016,12,1,14,1014,1047,2061,1788
0131-002,2016,12,1,15,1092,1206,2298,2061
0131-002,2016,12,1,16,1031,1127,2158,2298
0131-002,2016,12,1,17,1010,1247,2257,2158
0131-002,2016,12,1,18,1083,1511,2594,2257
0131-002,2016,12,1,19,918,1294,2212,2594
0131-002,2016,12,1,20,761,895,1656,2212
0131-002,2016,12,1,21,610,896,1506,1656
0131-002,2016,12,1,22,503,549,1052,1506
0131-002,2016,12,1,23,332,372,704,1052
0131-002,2016,12,1,24,203,233,436,704
0131-002,2016,12,2,1,171,179,350,436
0131-002,2016,12,2,2,111,115,226,350
0131-002,2016,12,2,3,80,72,152,226
0131-002,2016,12,2,4,82,102,184,152
0131-002,2016,12,2,5,147,116,263,184
0131-002,2016,12,2,6,337,206,543,263
0131-002,2016,12,2,7,761,439,1200,543
0131-002,2016,12,2,8,1667,1056,2723,1200
0131-002,2016,12,2,9,1498,1329,2827,2723
0131-002,2016,12,2,10,1026,1133,2159,2827
0131-002,2016,12,2,11,1059,1154,2213,2159
0131-002,2016,12,2,12,1042,1079,2121,2213
0131-002,2016,12,2,13,883,1032,1915,2121
0131-002,2016,12,2,14,1001,1119,2120,1915
0131-002,2016,12,2,15,1093,1231,2324,2120
0131-002,2016,12,2,16,1088,1315,2403,2324
0131-002,2016,12,2,17,1030,1413,2443,2403
0131-002,2016,12,2,18,1170,1662,2832,2443
0131-002,2016,12,2,19,1182,1608,2790,2832
0131-002,2016,12,2,20,946,1140,2086,2790
0131-002,2016,12,2,21,638,900,1538,2086
0131-002,2016,12,2,22,535,690,1225,1538
0131-002,2016,12,2,23,361,429,790,1225
0131-002,2016,12,2,24,231,276,507,790
0131-002,2016,12,3,1,204,176,380,507
0131-002,2016,12,3,2,136,139,275,380
0131-002,2016,12,3,3,100,101,201,275
0131-002,2016,12,3,4,90,100,190,201
0131-002,2016,12,3,5,136,121,257,190
0131-002,2016,12,3,6,292,219,511,257
0131-002,2016,12,3,7,550,347,897,511
0131-002,2016,12,3,8,917,638,1555,897
0131-002,2016,12,3,9,970,1000,1970,1555
0131-002,2016,12,3,10,891,1046,1937,1970
0131-002,2016,12,3,11,950,1033,1983,1937
0131-002,2016,12,3,12,989,932,1921,1983
0131-002,2016,12,3,13,925,952,1877,1921
0131-002,2016,12,3,14,960,950,1910,1877
0131-002,2016,12,3,15,960,1050,2010,1910
0131-002,2016,12,3,16,943,1085,2028,2010
0131-002,2016,12,3,17,974,1216,2190,2028
0131-002,2016,12,3,18,1080,1516,2596,2190
0131-002,2016,12,3,19,893,976,1869,2596
0131-002,2016,12,3,20,644,667,1311,1869
0131-002,2016,12,3,21,459,548,1007,1311
0131-002,2016,12,3,22,384,422,806,1007
0131-002,2016,12,3,23,289,302,591,806
0131-002,2016,12,3,24,194,196,390,591
0131-002,2016,12,4,1,148,160,308,390
0131-002,2016,12,4,2,110,131,241,308
0131-002,2016,12,4,3,101,107,208,241
0131-002,2016,12,4,4,75,68,143,208
0131-002,2016,12,4,5,85,65,150,143
0131-002,2016,12,4,6,159,116,275,150
0131-002,2016,12,4,7,271,175,446,275
0131-002,2016,12,4,8,340,305,645,446
0131-002,2016,12,4,9,448,493,941,645
0131-002,2016,12,4,10,493,518,1011,941
0131-002,2016,12,4,11,567,671,1238,1011
0131-002,2016,12,4,12,659,676,1335,1238
0131-002,2016,12,4,13,629,725,1354,1335
0131-002,2016,12,4,14,724,764,1488,1354
0131-002,2016,12,4,15,799,856,1655,1488
0131-002,2016,12,4,16,862,911,1773,1655
0131-002,2016,12,4,17,825,915,1740,1773
0131-002,2016,12,4,18,911,996,1907,1740
0131-002,2016,12,4,19,799,654,1453,1907
0131-002,2016,12,4,20,618,526,1144,1453
0131-002,2016,12,4,21,533,453,986,1144
0131-002,2016,12,4,22,432,336,768,986
0131-002,2016,12,4,23,350,247,597,768
0131-002,2016,12,4,24,195,133,328,597
0131-002,2016,12,5,1,137,105,242,328
0131-002,2016,12,5,2,67,73,140,242
0131-002,2016,12,5,3,64,63,127,140
0131-002,2016,12,5,4,62,57,119,127
0131-002,2016,12,5,5,128,110,238,119
0131-002,2016,12,5,6,374,196,570,238
0131-002,2016,12,5,7,883,475,1358,570
0131-002,2016,12,5,8,1751,1046,2797,1358
0131-002,2016,12,5,9,1482,1242,2724,2797
0131-002,2016,12,5,10,1047,1038,2085,2724
0131-002,2016,12,5,11,1062,1123,2185,2085
0131-002,2016,12,5,12,1081,1090,2171,2185
0131-002,2016,12,5,13,930,992,1922,2171
0131-002,2016,12,5,14,1069,1062,2131,1922
0131-002,2016,12,5,15,1105,1107,2212,2131
0131-002,2016,12,5,16,1121,1194,2315,2212
0131-002,2016,12,5,17,1075,1097,2172,2315
0131-002,2016,12,5,18,1022,1228,2250,2172
0131-002,2016,12,5,19,937,1338,2275,2250
0131-002,2016,12,5,20,747,869,1616,2275
0131-002,2016,12,5,21,576,887,1463,1616
0131-002,2016,12,5,22,461,593,1054,1463
0131-002,2016,12,5,23,320,387,707,1054
0131-002,2016,12,5,24,188,233,421,707
0131-002,2016,12,6,1,155,174,329,421
0131-002,2016,12,6,2,98,91,189,329
0131-002,2016,12,6,3,71,92,163,189
0131-002,2016,12,6,4,85,101,186,163
0131-002,2016,12,6,5,126,120,246,186
0131-002,2016,12,6,6,334,187,521,246
0131-002,2016,12,6,7,781,462,1243,521
0131-002,2016,12,6,8,1597,1089,2686,1243
0131-002,2016,12,6,9,1440,1313,2753,2686
0131-002,2016,12,6,10,1114,1113,2227,2753
0131-002,2016,12,6,11,1109,1080,2189,2227
0131-002,2016,12,6,12,1171,1083,2254,2189
0131-002,2016,12,6,13,906,900,1806,2254
0131-002,2016,12,6,14,1034,1068,2102,1806
0131-002,2016,12,6,15,1102,1174,2276,2102
0131-002,2016,12,6,16,1091,1129,2220,2276
0131-002,2016,12,6,17,1037,1212,2249,2220
0131-002,2016,12,6,18,1073,1395,2468,2249
0131-002,2016,12,6,19,946,1261,2207,2468
0131-002,2016,12,6,20,727,894,1621,2207
0131-002,2016,12,6,21,566,849,1415,1621
0131-002,2016,12,6,22,489,618,1107,1415
0131-002,2016,12,6,23,338,386,724,1107
0131-002,2016,12,6,24,196,249,445,724
0131-002,2016,12,7,1,162,157,319,445
0131-002,2016,12,7,2,102,108,210,319
0131-002,2016,12,7,3,91,80,171,210
0131-002,2016,12,7,4,86,101,187,171
0131-002,2016,12,7,5,137,134,271,187
0131-002,2016,12,7,6,327,184,511,271
0131-002,2016,12,7,7,726,453,1179,511
0131-002,2016,12,7,8,1577,1054,2631,1179
0131-002,2016,12,7,9,1493,1279,2772,2631
0131-002,2016,12,7,10,1125,1151,2276,2772
0131-002,2016,12,7,11,1112,1123,2235,2276
0131-002,2016,12,7,12,1002,1059,2061,2235
0131-002,2016,12,7,13,916,974,1890,2061
0131-002,2016,12,7,14,1076,1053,2129,1890
0131-002,2016,12,7,15,1049,1148,2197,2129
0131-002,2016,12,7,16,1006,1209,2215,2197
0131-002,2016,12,7,17,1034,1271,2305,2215
0131-002,2016,12,7,18,1104,1498,2602,2305
0131-002,2016,12,7,19,964,1276,2240,2602
0131-002,2016,12,7,20,711,914,1625,2240
0131-002,2016,12,7,21,521,771,1292,1625
0131-002,2016,12,7,22,494,486,980,1292
0131-002,2016,12,7,23,338,407,745,980
0131-002,2016,12,7,24,243,225,468,745
0131-002,2016,12,8,1,161,164,325,468
0131-002,2016,12,8,2,98,107,205,325
0131-002,2016,12,8,3,67,91,158,205
0131-002,2016,12,8,4,85,108,193,158
0131-002,2016,12,8,5,138,118,256,193
0131-002,2016,12,8,6,303,205,508,256
0131-002,2016,12,8,7,783,437,1220,508
0131-002,2016,12,8,8,1568,1029,2597,1220
0131-002,2016,12,8,9,1422,1350,2772,2597
0131-002,2016,12,8,10,1047,1120,2167,2772
0131-002,2016,12,8,11,1090,1156,2246,2167
0131-002,2016,12,8,12,870,1219,2089,2246
0131-002,2016,12,8,13,824,947,1771,2089
0131-002,2016,12,8,14,1132,1066,2198,1771
0131-002,2016,12,8,15,1047,1232,2279,2198
0131-002,2016,12,8,16,1160,1249,2409,2279
0131-002,2016,12,8,17,1031,1315,2346,2409
0131-002,2016,12,8,18,1077,1533,2610,2346
0131-002,2016,12,8,19,930,1247,2177,2610
0131-002,2016,12,8,20,681,881,1562,2177
0131-002,2016,12,8,21,529,836,1365,1562
0131-002,2016,12,8,22,478,564,1042,1365
0131-002,2016,12,8,23,330,385,715,1042
0131-002,2016,12,8,24,221,241,462,715
0131-002,2016,12,9,1,141,156,297,462
0131-002,2016,12,9,2,113,124,237,297
0131-002,2016,12,9,3,95,96,191,237
0131-002,2016,12,9,4,67,91,158,191
0131-002,2016,12,9,5,134,125,259,158
0131-002,2016,12,9,6,347,162,509,259
0131-002,2016,12,9,7,728,462,1190,509
0131-002,2016,12,9,8,1466,1063,2529,1190
0131-002,2016,12,9,9,1453,1224,2677,2529
0131-002,2016,12,9,10,1095,1099,2194,2677
0131-002,2016,12,9,11,1034,1114,2148,2194
0131-002,2016,12,9,12,1073,1086,2159,2148
0131-002,2016,12,9,13,947,1000,1947,2159
0131-002,2016,12,9,14,978,1089,2067,1947
0131-002,2016,12,9,15,1127,1239,2366,2067
0131-002,2016,12,9,16,1037,1267,2304,2366
0131-002,2016,12,9,17,1162,1360,2522,2304
0131-002,2016,12,9,18,1147,1557,2704,2522
0131-002,2016,12,9,19,1099,1438,2537,2704
0131-002,2016,12,9,20,766,1099,1865,2537
0131-002,2016,12,9,21,569,827,1396,1865
0131-002,2016,12,9,22,463,592,1055,1396
0131-002,2016,12,9,23,380,380,760,1055
0131-002,2016,12,9,24,233,245,478,760
0131-002,2016,12,10,1,177,212,389,478
0131-002,2016,12,10,2,135,152,287,389
0131-002,2016,12,10,3,96,99,195,287
0131-002,2016,12,10,4,94,113,207,195
0131-002,2016,12,10,5,139,136,275,207
0131-002,2016,12,10,6,239,181,420,275
0131-002,2016,12,10,7,503,323,826,420
0131-002,2016,12,10,8,824,654,1478,826
0131-002,2016,12,10,9,926,960,1886,1478
0131-002,2016,12,10,10,827,936,1763,1886
0131-002,2016,12,10,11,872,1074,1946,1763
0131-002,2016,12,10,12,890,1027,1917,1946
0131-002,2016,12,10,13,849,880,1729,1917
0131-002,2016,12,10,14,915,913,1828,1729
0131-002,2016,12,10,15,903,1061,1964,1828
0131-002,2016,12,10,16,917,1103,2020,1964
0131-002,2016,12,10,17,943,1227,2170,2020
0131-002,2016,12,10,18,1006,1458,2464,2170
0131-002,2016,12,10,19,882,951,1833,2464
0131-002,2016,12,10,20,605,581,1186,1833
0131-002,2016,12,10,21,463,521,984,1186
0131-002,2016,12,10,22,381,401,782,984
0131-002,2016,12,10,23,305,270,575,782
0131-002,2016,12,10,24,198,224,422,575
0131-002,2016,12,11,1,156,171,327,422
0131-002,2016,12,11,2,124,154,278,327
0131-002,2016,12,11,3,109,98,207,278
0131-002,2016,12,11,4,82,71,153,207
0131-002,2016,12,11,5,93,83,176,153
0131-002,2016,12,11,6,136,101,237,176
0131-002,2016,12,11,7,217,189,406,237
0131-002,2016,12,11,8,355,288,643,406
0131-002,2016,12,11,9,444,439,883,643
0131-002,2016,12,11,10,433,533,966,883
0131-002,2016,12,11,11,574,590,1164,966
0131-002,2016,12,11,12,609,597,1206,1164
0131-002,2016,12,11,13,615,692,1307,1206
0131-002,2016,12,11,14,713,681,1394,1307
0131-002,2016,12,11,15,758,757,1515,1394
0131-002,2016,12,11,16,805,832,1637,1515
0131-002,2016,12,11,17,718,890,1608,1637
0131-002,2016,12,11,18,763,841,1604,1608
0131-002,2016,12,11,19,755,657,1412,1604
0131-002,2016,12,11,20,576,474,1050,1412
0131-002,2016,12,11,21,487,439,926,1050
0131-002,2016,12,11,22,412,328,740,926
0131-002,2016,12,11,23,254,230,484,740
0131-002,2016,12,11,24,205,176,381,484
0131-002,2016,12,12,1,135,112,247,381
0131-002,2016,12,12,2,78,62,140,247
0131-002,2016,12,12,3,59,42,101,140
0131-002,2016,12,12,4,56,52,108,101
0131-002,2016,12,12,5,115,92,207,108
0131-002,2016,12,12,6,387,198,585,207
0131-002,2016,12,12,7,819,468,1287,585
0131-002,2016,12,12,8,1663,1113,2776,1287
0131-002,2016,12,12,9,1483,1226,2709,2776
0131-002,2016,12,12,10,1010,1010,2020,2709
0131-002,2016,12,12,11,1064,1031,2095,2020
0131-002,2016,12,12,12,996,1037,2033,2095
0131-002,2016,12,12,13,843,951,1794,2033
0131-002,2016,12,12,14,1027,984,2011,1794
0131-002,2016,12,12,15,1077,1188,2265,2011
0131-002,2016,12,12,16,1071,1205,2276,2265
0131-002,2016,12,12,17,1075,1260,2335,2276
0131-002,2016,12,12,18,1055,1362,2417,2335
0131-002,2016,12,12,19,928,1188,2116,2417
0131-002,2016,12,12,20,704,955,1659,2116
0131-002,2016,12,12,21,582,915,1497,1659
0131-002,2016,12,12,22,488,606,1094,1497
0131-002,2016,12,12,23,333,352,685,1094
0131-002,2016,12,12,24,204,246,450,685
0131-002,2016,12,13,1,127,145,272,450
0131-002,2016,12,13,2,89,103,192,272
0131-002,2016,12,13,3,75,71,146,192
0131-002,2016,12,13,4,95,86,181,146
0131-002,2016,12,13,5,125,128,253,181
0131-002,2016,12,13,6,323,154,477,253
0131-002,2016,12,13,7,708,439,1147,477
0131-002,2016,12,13,8,1558,1056,2614,1147
0131-002,2016,12,13,9,1481,1254,2735,2614
0131-002,2016,12,13,10,1093,1084,2177,2735
0131-002,2016,12,13,11,1069,1156,2225,2177
0131-002,2016,12,13,12,1060,1036,2096,2225
0131-002,2016,12,13,13,898,951,1849,2096
0131-002,2016,12,13,14,997,1088,2085,1849
0131-002,2016,12,13,15,1092,1171,2263,2085
0131-002,2016,12,13,16,1047,1148,2195,2263
0131-002,2016,12,13,17,1059,1209,2268,2195
0131-002,2016,12,13,18,1062,1418,2480,2268
0131-002,2016,12,13,19,876,1157,2033,2480
0131-002,2016,12,13,20,712,873,1585,2033
0131-002,2016,12,13,21,556,784,1340,1585
0131-002,2016,12,13,22,399,578,977,1340
0131-002,2016,12,13,23,328,371,699,977
0131-002,2016,12,13,24,207,243,450,699
0131-002,2016,12,14,1,161,154,315,450
0131-002,2016,12,14,2,130,107,237,315
0131-002,2016,12,14,3,81,94,175,237
0131-002,2016,12,14,4,83,89,172,175
0131-002,2016,12,14,5,121,119,240,172
0131-002,2016,12,14,6,324,194,518,240
0131-002,2016,12,14,7,684,437,1121,518
0131-002,2016,12,14,8,1498,995,2493,1121
0131-002,2016,12,14,9,1410,1280,2690,2493
0131-002,2016,12,14,10,1128,1099,2227,2690
0131-002,2016,12,14,11,1015,1078,2093,2227
0131-002,2016,12,14,12,1062,1045,2107,2093
0131-002,2016,12,14,13,826,931,1757,2107
0131-002,2016,12,14,14,1000,1010,2010,1757
0131-002,2016,12,14,15,1091,1162,2253,2010
0131-002,2016,12,14,16,1006,1188,2194,2253
0131-002,2016,12,14,17,990,1242,2232,2194
0131-002,2016,12,14,18,1086,1504,2590,2232
0131-002,2016,12,14,19,898,1264,2162,2590
0131-002,2016,12,14,20,666,777,1443,2162
0131-002,2016,12,14,21,559,776,1335,1443
0131-002,2016,12,14,22,454,533,987,1335
0131-002,2016,12,14,23,308,398,706,987
0131-002,2016,12,14,24,205,258,463,706
0131-002,2016,12,15,1,160,185,345,463
0131-002,2016,12,15,2,95,99,194,345
0131-002,2016,12,15,3,85,85,170,194
0131-002,2016,12,15,4,88,89,177,170
0131-002,2016,12,15,5,114,123,237,177
0131-002,2016,12,15,6,311,188,499,237
0131-002,2016,12,15,7,687,418,1105,499
0131-002,2016,12,15,8,1501,996,2497,1105
0131-002,2016,12,15,9,1441,1274,2715,2497
0131-002,2016,12,15,10,1080,1141,2221,2715
0131-002,2016,12,15,11,1000,1036,2036,2221
0131-002,2016,12,15,12,986,1080,2066,2036
0131-002,2016,12,15,13,884,939,1823,2066
0131-002,2016,12,15,14,1051,1066,2117,1823
0131-002,2016,12,15,15,1028,1202,2230,2117
0131-002,2016,12,15,16,1063,1209,2272,2230
0131-002,2016,12,15,17,1025,1243,2268,2272
0131-002,2016,12,15,18,1085,1419,2504,2268
0131-002,2016,12,15,19,876,1243,2119,2504
0131-002,2016,12,15,20,727,893,1620,2119
0131-002,2016,12,15,21,607,824,1431,1620
0131-002,2016,12,15,22,491,574,1065,1431
0131-002,2016,12,15,23,357,391,748,1065
0131-002,2016,12,15,24,207,238,445,748
0131-002,2016,12,16,1,187,171,358,445
0131-002,2016,12,16,2,105,105,210,358
0131-002,2016,12,16,3,83,92,175,210
0131-002,2016,12,16,4,82,103,185,175
0131-002,2016,12,16,5,120,133,253,185
0131-002,2016,12,16,6,312,186,498,253
0131-002,2016,12,16,7,672,394,1066,498
0131-002,2016,12,16,8,1485,965,2450,1066
0131-002,2016,12,16,9,1351,1236,2587,2450
0131-002,2016,12,16,10,1102,1135,2237,2587
0131-002,2016,12,16,11,1017,1140,2157,2237
0131-002,2016,12,16,12,1015,1060,2075,2157
0131-002,2016,12,16,13,955,957,1912,2075
0131-002,2016,12,16,14,981,1041,2022,1912
0131-002,2016,12,16,15,1068,1271,2339,2022
0131-002,2016,12,16,16,1083,1209,2292,2339
0131-002,2016,12,16,17,1062,1275,2337,2292
0131-002,2016,12,16,18,1078,1577,2655,2337
0131-002,2016,12,16,19,1099,1382,2481,2655
0131-002,2016,12,16,20,795,1018,1813,2481
0131-002,2016,12,16,21,602,877,1479,1813
0131-002,2016,12,16,22,509,648,1157,1479
0131-002,2016,12,16,23,365,408,773,1157
0131-002,2016,12,16,24,244,275,519,773
0131-002,2016,12,17,1,181,209,390,519
0131-002,2016,12,17,2,155,149,304,390
0131-002,2016,12,17,3,88,115,203,304
0131-002,2016,12,17,4,90,105,195,203
0131-002,2016,12,17,5,128,124,252,195
0131-002,2016,12,17,6,258,182,440,252
0131-002,2016,12,17,7,483,319,802,440
0131-002,2016,12,17,8,874,593,1467,802
0131-002,2016,12,17,9,916,909,1825,1467
0131-002,2016,12,17,10,799,1005,1804,1825
0131-002,2016,12,17,11,988,1019,2007,1804
0131-002,2016,12,17,12,1081,974,2055,2007
0131-002,2016,12,17,13,1170,942,2112,2055
0131-002,2016,12,17,14,993,968,1961,2112
0131-002,2016,12,17,15,999,1039,2038,1961
0131-002,2016,12,17,16,951,1069,2020,2038
0131-002,2016,12,17,17,976,1212,2188,2020
0131-002,2016,12,17,18,1068,1367,2435,2188
0131-002,2016,12,17,19,873,958,1831,2435
0131-002,2016,12,17,20,630,606,1236,1831
0131-002,2016,12,17,21,428,538,966,1236
0131-002,2016,12,17,22,413,401,814,966
0131-002,2016,12,17,23,307,341,648,814
0131-002,2016,12,17,24,205,224,429,648
0131-002,2016,12,18,1,159,182,341,429
0131-002,2016,12,18,2,124,112,236,341
0131-002,2016,12,18,3,105,105,210,236
0131-002,2016,12,18,4,80,64,144,210
0131-002,2016,12,18,5,91,77,168,144
0131-002,2016,12,18,6,148,104,252,168
0131-002,2016,12,18,7,254,189,443,252
0131-002,2016,12,18,8,397,314,711,443
0131-002,2016,12,18,9,492,478,970,711
0131-002,2016,12,18,10,458,588,1046,970
0131-002,2016,12,18,11,571,652,1223,1046
0131-002,2016,12,18,12,640,758,1398,1223
0131-002,2016,12,18,13,639,703,1342,1398
0131-002,2016,12,18,14,743,754,1497,1342
0131-002,2016,12,18,15,785,832,1617,1497
0131-002,2016,12,18,16,843,847,1690,1617
0131-002,2016,12,18,17,827,846,1673,1690
0131-002,2016,12,18,18,991,907,1898,1673
0131-002,2016,12,18,19,793,648,1441,1898
0131-002,2016,12,18,20,580,520,1100,1441
0131-002,2016,12,18,21,506,437,943,1100
0131-002,2016,12,18,22,422,316,738,943
0131-002,2016,12,18,23,319,252,571,738
0131-002,2016,12,18,24,195,160,355,571
0131-002,2016,12,19,1,149,117,266,355
0131-002,2016,12,19,2,84,93,177,266
0131-002,2016,12,19,3,84,63,147,177
0131-002,2016,12,19,4,65,58,123,147
0131-002,2016,12,19,5,119,89,208,123
0131-002,2016,12,19,6,340,169,509,208
0131-002,2016,12,19,7,710,448,1158,509
0131-002,2016,12,19,8,1630,1058,2688,1158
0131-002,2016,12,19,9,1448,1244,2692,2688
0131-002,2016,12,19,10,1014,1003,2017,2692
0131-002,2016,12,19,11,1067,1044,2111,2017
0131-002,2016,12,19,12,1056,1028,2084,2111
0131-002,2016,12,19,13,904,870,1774,2084
0131-002,2016,12,19,14,1023,990,2013,1774
0131-002,2016,12,19,15,1057,1142,2199,2013
0131-002,2016,12,19,16,1076,1089,2165,2199
0131-002,2016,12,19,17,983,1200,2183,2165
0131-002,2016,12,19,18,1011,1316,2327,2183
0131-002,2016,12,19,19,903,1163,2066,2327
0131-002,2016,12,19,20,698,883,1581,2066
0131-002,2016,12,19,21,568,882,1450,1581
0131-002,2016,12,19,22,512,575,1087,1450
0131-002,2016,12,19,23,306,366,672,1087
0131-002,2016,12,19,24,195,215,410,672
0131-002,2016,12,20,1,158,146,304,410
0131-002,2016,12,20,2,105,105,210,304
0131-002,2016,12,20,3,85,74,159,210
0131-002,2016,12,20,4,86,88,174,159
0131-002,2016,12,20,5,117,104,221,174
0131-002,2016,12,20,6,336,189,525,221
0131-002,2016,12,20,7,732,460,1192,525
0131-002,2016,12,20,8,1581,1027,2608,1192
0131-002,2016,12,20,9,1385,1250,2635,2608
0131-002,2016,12,20,10,1042,1063,2105,2635
0131-002,2016,12,20,11,1122,1044,2166,2105
0131-002,2016,12,20,12,1064,1051,2115,2166
0131-002,2016,12,20,13,885,942,1827,2115
0131-002,2016,12,20,14,1012,1028,2040,1827
0131-002,2016,12,20,15,1089,1166,2255,2040
0131-002,2016,12,20,16,1064,1193,2257,2255
0131-002,2016,12,20,17,1032,1180,2212,2257
0131-002,2016,12,20,18,1062,1417,2479,2212
0131-002,2016,12,20,19,978,1226,2204,2479
0131-002,2016,12,20,20,717,923,1640,2204
0131-002,2016,12,20,21,570,864,1434,1640
0131-002,2016,12,20,22,489,551,1040,1434
0131-002,2016,12,20,23,332,423,755,1040
0131-002,2016,12,20,24,225,223,448,755
0131-002,2016,12,21,1,144,171,315,448
0131-002,2016,12,21,2,87,114,201,315
0131-002,2016,12,21,3,96,98,194,201
0131-002,2016,12,21,4,93,82,175,194
0131-002,2016,12,21,5,111,135,246,175
0131-002,2016,12,21,6,317,183,500,246
0131-002,2016,12,21,7,691,416,1107,500
0131-002,2016,12,21,8,1568,1022,2590,1107
0131-002,2016,12,21,9,1439,1295,2734,2590
0131-002,2016,12,21,10,1125,1160,2285,2734
0131-002,2016,12,21,11,1123,1129,2252,2285
0131-002,2016,12,21,12,1000,1060,2060,2252
0131-002,2016,12,21,13,954,918,1872,2060
0131-002,2016,12,21,14,1013,1083,2096,1872
0131-002,2016,12,21,15,1065,1170,2235,2096
0131-002,2016,12,21,16,1080,1275,2355,2235
0131-002,2016,12,21,17,1007,1266,2273,2355
0131-002,2016,12,21,18,1003,1405,2408,2273
0131-002,2016,12,21,19,967,1249,2216,2408
0131-002,2016,12,21,20,709,862,1571,2216
0131-002,2016,12,21,21,558,678,1236,1571
0131-002,2016,12,21,22,474,524,998,1236
0131-002,2016,12,21,23,325,372,697,998
0131-002,2016,12,21,24,211,247,458,697
0131-002,2016,12,22,1,174,179,353,458
0131-002,2016,12,22,2,114,123,237,353
0131-002,2016,12,22,3,92,84,176,237
0131-002,2016,12,22,4,77,84,161,176
0131-002,2016,12,22,5,113,107,220,161
0131-002,2016,12,22,6,271,147,418,220
0131-002,2016,12,22,7,589,368,957,418
0131-002,2016,12,22,8,1412,916,2328,957
0131-002,2016,12,22,9,1363,1233,2596,2328
0131-002,2016,12,22,10,1007,1037,2044,2596
0131-002,2016,12,22,11,1069,977,2046,2044
0131-002,2016,12,22,12,990,989,1979,2046
0131-002,2016,12,22,13,831,870,1701,1979
0131-002,2016,12,22,14,986,1027,2013,1701
0131-002,2016,12,22,15,999,1092,2091,2013
0131-002,2016,12,22,16,998,1063,2061,2091
0131-002,2016,12,22,17,959,1100,2059,2061
0131-002,2016,12,22,18,949,1272,2221,2059
0131-002,2016,12,22,19,840,1128,1968,2221
0131-002,2016,12,22,20,663,790,1453,1968
0131-002,2016,12,22,21,580,753,1333,1453
0131-002,2016,12,22,22,447,609,1056,1333
0131-002,2016,12,22,23,355,369,724,1056
0131-002,2016,12,22,24,231,249,480,724
0131-002,2016,12,23,1,197,194,391,480
0131-002,2016,12,23,2,112,149,261,391
0131-002,2016,12,23,3,84,91,175,261
0131-002,2016,12,23,4,87,95,182,175
0131-002,2016,12,23,5,132,112,244,182
0131-002,2016,12,23,6,230,144,374,244
0131-002,2016,12,23,7,332,428,760,374
0131-002,2016,12,23,8,1476,1014,2490,760
0131-002,2016,12,23,9,1402,1230,2632,2490
0131-002,2016,12,23,10,1098,1117,2215,2632
0131-002,2016,12,23,11,1026,1127,2153,2215
0131-002,2016,12,23,12,1044,1073,2117,2153
0131-002,2016,12,23,13,951,978,1929,2117
0131-002,2016,12,23,14,980,1065,2045,1929
0131-002,2016,12,23,15,1098,1255,2353,2045
0131-002,2016,12,23,16,1060,1238,2298,2353
0131-002,2016,12,23,17,1112,1318,2430,2298
0131-002,2016,12,23,18,1112,1567,2679,2430
0131-002,2016,12,23,19,1099,1410,2509,2679
0131-002,2016,12,23,20,780,861,1641,2509
0131-002,2016,12,23,21,586,786,1372,1641
0131-002,2016,12,23,22,486,583,1069,1372
0131-002,2016,12,23,23,372,380,752,1069
0131-002,2016,12,23,24,238,286,524,752
0131-002,2016,12,24,1,131,212,343,524
0131-002,2016,12,24,2,96,160,256,343
0131-002,2016,12,24,3,78,107,185,256
0131-002,2016,12,24,4,77,125,202,185
0131-002,2016,12,24,5,96,126,222,202
0131-002,2016,12,24,6,152,163,315,222
0131-002,2016,12,24,7,255,267,522,315
0131-002,2016,12,24,8,849,568,1417,522
0131-002,2016,12,24,9,921,835,1756,1417
0131-002,2016,12,24,10,813,798,1611,1756
0131-002,2016,12,24,11,930,880,1810,1611
0131-002,2016,12,24,12,986,867,1853,1810
0131-002,2016,12,24,13,1010,804,1814,1853
0131-002,2016,12,24,14,954,927,1881,1814
0131-002,2016,12,24,15,951,870,1821,1881
0131-002,2016,12,24,16,934,936,1870,1821
0131-002,2016,12,24,17,960,1040,2000,1870
0131-002,2016,12,24,18,1037,1185,2222,2000
0131-002,2016,12,24,19,878,844,1722,2222
0131-002,2016,12,24,20,618,495,1113,1722
0131-002,2016,12,24,21,446,413,859,1113
0131-002,2016,12,24,22,382,338,720,859
0131-002,2016,12,24,23,278,285,563,720
0131-002,2016,12,24,24,197,211,408,563
0131-002,2016,12,25,1,136,155,291,408
0131-002,2016,12,25,2,111,102,213,291
0131-002,2016,12,25,3,75,87,162,213
0131-002,2016,12,25,4,90,75,165,162
0131-002,2016,12,25,5,72,62,134,165
0131-002,2016,12,25,6,97,98,195,134
0131-002,2016,12,25,7,207,128,335,195
0131-002,2016,12,25,8,310,214,524,335
0131-002,2016,12,25,9,327,344,671,524
0131-002,2016,12,25,10,382,432,814,671
0131-002,2016,12,25,11,514,513,1027,814
0131-002,2016,12,25,12,590,562,1152,1027
0131-002,2016,12,25,13,627,560,1187,1152
0131-002,2016,12,25,14,728,663,1391,1187
0131-002,2016,12,25,15,772,740,1512,1391
0131-002,2016,12,25,16,824,759,1583,1512
0131-002,2016,12,25,17,772,773,1545,1583
0131-002,2016,12,25,18,616,806,1422,1545
0131-002,2016,12,25,19,569,564,1133,1422
0131-002,2016,12,25,20,518,480,998,1133
0131-002,2016,12,25,21,483,399,882,998
0131-002,2016,12,25,22,439,298,737,882
0131-002,2016,12,25,23,311,230,541,737
0131-002,2016,12,25,24,197,173,370,541
0131-002,2016,12,26,1,147,132,279,370
0131-002,2016,12,26,2,78,61,139,279
0131-002,2016,12,26,3,63,49,112,139
0131-002,2016,12,26,4,75,51,126,112
0131-002,2016,12,26,5,127,105,232,126
0131-002,2016,12,26,6,324,204,528,232
0131-002,2016,12,26,7,807,426,1233,528
0131-002,2016,12,26,8,1649,1023,2672,1233
0131-002,2016,12,26,9,1348,1199,2547,2672
0131-002,2016,12,26,10,924,1029,1953,2547
0131-002,2016,12,26,11,1022,1008,2030,1953
0131-002,2016,12,26,12,847,1063,1910,2030
0131-002,2016,12,26,13,874,625,1499,1910
0131-002,2016,12,26,14,1025,663,1688,1499
0131-002,2016,12,26,15,1067,791,1858,1688
0131-002,2016,12,26,16,1074,942,2016,1858
0131-002,2016,12,26,17,1029,967,1996,2016
0131-002,2016,12,26,18,1033,1130,2163,1996
0131-002,2016,12,26,19,916,1088,2004,2163
0131-002,2016,12,26,20,701,763,1464,2004
0131-002,2016,12,26,21,575,756,1331,1464
0131-002,2016,12,26,22,500,506,1006,1331
0131-002,2016,12,26,23,320,394,714,1006
0131-002,2016,12,26,24,200,232,432,714
0131-002,2016,12,27,1,108,177,285,432
0131-002,2016,12,27,2,85,93,178,285
0131-002,2016,12,27,3,61,84,145,178
0131-002,2016,12,27,4,55,107,162,145
0131-002,2016,12,27,5,101,102,203,162
0131-002,2016,12,27,6,195,180,375,203
0131-002,2016,12,27,7,365,366,731,375
0131-002,2016,12,27,8,1570,956,2526,731
0131-002,2016,12,27,9,1433,1234,2667,2526
0131-002,2016,12,27,10,1068,1069,2137,2667
0131-002,2016,12,27,11,1096,1062,2158,2137
0131-002,2016,12,27,12,1062,1014,2076,2158
0131-002,2016,12,27,13,892,903,1795,2076
0131-002,2016,12,27,14,1004,1021,2025,1795
0131-002,2016,12,27,15,1090,1143,2233,2025
0131-002,2016,12,27,16,1056,1116,2172,2233
0131-002,2016,12,27,17,1046,1098,2144,2172
0131-002,2016,12,27,18,1062,1349,2411,2144
0131-002,2016,12,27,19,927,1154,2081,2411
0131-002,2016,12,27,20,675,841,1516,2081
0131-002,2016,12,27,21,616,818,1434,1516
0131-002,2016,12,27,22,515,562,1077,1434
0131-002,2016,12,27,23,357,386,743,1077
0131-002,2016,12,27,24,209,218,427,743
0131-002,2016,12,28,1,183,192,375,427
0131-002,2016,12,28,2,117,123,240,375
0131-002,2016,12,28,3,76,79,155,240
0131-002,2016,12,28,4,76,82,158,155
0131-002,2016,12,28,5,116,135,251,158
0131-002,2016,12,28,6,314,144,458,251
0131-002,2016,12,28,7,624,373,997,458
0131-002,2016,12,28,8,1528,926,2454,997
0131-002,2016,12,28,9,1432,1192,2624,2454
0131-002,2016,12,28,10,1075,1075,2150,2624
0131-002,2016,12,28,11,1090,1032,2122,2150
0131-002,2016,12,28,12,993,1054,2047,2122
0131-002,2016,12,28,13,1037,959,1996,2047
0131-002,2016,12,28,14,1084,1104,2188,1996
0131-002,2016,12,28,15,1090,1096,2186,2188
0131-002,2016,12,28,16,1041,1183,2224,2186
0131-002,2016,12,28,17,1092,1153,2245,2224
0131-002,2016,12,28,18,1218,1448,2666,2245
0131-002,2016,12,28,19,1092,1200,2292,2666
0131-002,2016,12,28,20,725,825,1550,2292
0131-002,2016,12,28,21,595,724,1319,1550
0131-002,2016,12,28,22,506,542,1048,1319
0131-002,2016,12,28,23,359,365,724,1048
0131-002,2016,12,28,24,265,263,528,724
0131-002,2016,12,29,1,144,224,368,528
0131-002,2016,12,29,2,137,127,264,368
0131-002,2016,12,29,3,72,106,178,264
0131-002,2016,12,29,4,87,88,175,178
0131-002,2016,12,29,5,116,122,238,175
0131-002,2016,12,29,6,184,132,316,238
0131-002,2016,12,29,7,355,215,570,316
0131-002,2016,12,29,8,1456,406,1862,570
0131-002,2016,12,29,9,1402,465,1867,1862
0131-002,2016,12,29,10,1044,871,1915,1867
0131-002,2016,12,29,11,1034,872,1906,1915
0131-002,2016,12,29,12,988,782,1770,1906
0131-002,2016,12,29,13,858,783,1641,1770
0131-002,2016,12,29,14,1018,893,1911,1641
0131-002,2016,12,29,15,1014,937,1951,1911
0131-002,2016,12,29,16,1030,945,1975,1951
0131-002,2016,12,29,17,992,1026,2018,1975
0131-002,2016,12,29,18,1017,1107,2124,2018
0131-002,2016,12,29,19,858,1012,1870,2124
0131-002,2016,12,29,20,695,739,1434,1870
0131-002,2016,12,29,21,594,763,1357,1434
0131-002,2016,12,29,22,469,532,1001,1357
0131-002,2016,12,29,23,356,372,728,1001
0131-002,2016,12,29,24,219,262,481,728
0131-002,2016,12,30,1,158,191,349,481
0131-002,2016,12,30,2,142,118,260,349
0131-002,2016,12,30,3,73,85,158,260
0131-002,2016,12,30,4,84,96,180,158
0131-002,2016,12,30,5,117,109,226,180
0131-002,2016,12,30,6,265,166,431,226
0131-002,2016,12,30,7,623,328,951,431
0131-002,2016,12,30,8,1438,893,2331,951
0131-002,2016,12,30,9,1255,1173,2428,2331
0131-002,2016,12,30,10,953,982,1935,2428
0131-002,2016,12,30,11,1003,1064,2067,1935
0131-002,2016,12,30,12,1030,1066,2096,2067
0131-002,2016,12,30,13,953,909,1862,2096
0131-002,2016,12,30,14,980,1035,2015,1862
0131-002,2016,12,30,15,1083,1193,2276,2015
0131-002,2016,12,30,16,1072,1211,2283,2276
0131-002,2016,12,30,17,1087,1261,2348,2283
0131-002,2016,12,30,18,1095,1447,2542,2348
0131-002,2016,12,30,19,1099,1369,2468,2542
0131-002,2016,12,30,20,788,892,1680,2468
0131-002,2016,12,30,21,594,671,1265,1680
0131-002,2016,12,30,22,551,560,1111,1265
0131-002,2016,12,30,23,450,403,853,1111
0131-002,2016,12,30,24,272,252,524,853
0131-002,2016,12,31,1,238,209,447,524
0131-002,2016,12,31,2,164,140,304,447
0131-002,2016,12,31,3,114,108,222,304
0131-002,2016,12,31,4,113,93,206,222
0131-002,2016,12,31,5,108,115,223,206
0131-002,2016,12,31,6,205,143,348,223
0131-002,2016,12,31,7,345,266,611,348
0131-002,2016,12,31,8,862,431,1293,611
0131-002,2016,12,31,9,918,677,1595,1293
0131-002,2016,12,31,10,806,809,1615,1595
0131-002,2016,12,31,11,959,899,1858,1615
0131-002,2016,12,31,12,1034,833,1867,1858
0131-002,2016,12,31,13,1090,927,2017,1867
0131-002,2016,12,31,14,974,884,1858,2017
0131-002,2016,12,31,15,975,973,1948,1858
0131-002,2016,12,31,16,942,991,1933,1948
0131-002,2016,12,31,17,968,985,1953,1933
0131-002,2016,12,31,18,1052,1039,2091,1953
0131-002,2016,12,31,19,806,754,1560,2091
0131-002,2016,12,31,20,596,484,1080,1560
0131-002,2016,12,31,21,433,378,811,1080
0131-002,2016,12,31,22,404,379,783,811
0131-002,2016,12,31,23,259,254,513,783
0131-002,2016,12,31,24,190,202,392,513
0131-002,2017,1,1,1,157,149,306,392
0131-002,2017,1,1,2,140,134,274,306
0131-002,2017,1,1,3,87,86,173,274
0131-002,2017,1,1,4,82,62,144,173
0131-002,2017,1,1,5,109,72,181,144
0131-002,2017,1,1,6,135,86,221,181
0131-002,2017,1,1,7,180,127,307,221
0131-002,2017,1,1,8,176,147,323,307
0131-002,2017,1,1,9,262,275,537,323
0131-002,2017,1,1,10,312,334,646,537
0131-002,2017,1,1,11,401,493,894,646
0131-002,2017,1,1,12,615,562,1177,894
0131-002,2017,1,1,13,633,525,1158,1177
0131-002,2017,1,1,14,736,640,1376,1158
0131-002,2017,1,1,15,778,726,1504,1376
0131-002,2017,1,1,16,834,791,1625,1504
0131-002,2017,1,1,17,800,773,1573,1625
0131-002,2017,1,1,18,650,754,1404,1573
0131-002,2017,1,1,19,558,634,1192,1404
0131-002,2017,1,1,20,525,482,1007,1192
0131-002,2017,1,1,21,518,419,937,1007
0131-002,2017,1,1,22,412,331,743,937
0131-002,2017,1,1,23,341,218,559,743
0131-002,2017,1,1,24,208,144,352,559
0131-002,2017,1,2,1,140,103,243,352
0131-002,2017,1,2,2,81,58,139,243
0131-002,2017,1,2,3,66,44,110,139
0131-002,2017,1,2,4,52,46,98,110
0131-002,2017,1,2,5,90,80,170,98
0131-002,2017,1,2,6,278,144,422,170
0131-002,2017,1,2,7,649,441,1090,422
0131-002,2017,1,2,8,1370,946,2316,1090
0131-002,2017,1,2,9,1180,1050,2230,2316
0131-002,2017,1,2,10,812,912,1724,2230
0131-002,2017,1,2,11,844,898,1742,1724
0131-002,2017,1,2,12,862,893,1755,1742
0131-002,2017,1,2,13,740,865,1605,1755
0131-002,2017,1,2,14,886,904,1790,1605
0131-002,2017,1,2,15,904,1060,1964,1790
0131-002,2017,1,2,16,936,1003,1939,1964
0131-002,2017,1,2,17,930,980,1910,1939
0131-002,2017,1,2,18,931,1134,2065,1910
0131-002,2017,1,2,19,868,1107,1975,2065
0131-002,2017,1,2,20,587,739,1326,1975
0131-002,2017,1,2,21,519,670,1189,1326
0131-002,2017,1,2,22,417,489,906,1189
0131-002,2017,1,2,23,265,297,562,906
0131-002,2017,1,2,24,176,199,375,562
0131-002,2017,1,3,1,161,114,275,375
0131-002,2017,1,3,2,75,88,163,275
0131-002,2017,1,3,3,84,65,149,163
0131-002,2017,1,3,4,80,91,171,149
0131-002,2017,1,3,5,101,105,206,171
0131-002,2017,1,3,6,301,157,458,206
0131-002,2017,1,3,7,713,394,1107,458
0131-002,2017,1,3,8,1530,920,2450,1107
0131-002,2017,1,3,9,1318,1147,2465,2450
0131-002,2017,1,3,10,1000,1072,2072,2465
0131-002,2017,1,3,11,1058,991,2049,2072
0131-002,2017,1,3,12,991,995,1986,2049
0131-002,2017,1,3,13,837,946,1783,1986
0131-002,2017,1,3,14,961,990,1951,1783
0131-002,2017,1,3,15,971,1186,2157,1951
0131-002,2017,1,3,16,993,1146,2139,2157
0131-002,2017,1,3,17,938,1137,2075,2139
0131-002,2017,1,3,18,908,1349,2257,2075
0131-002,2017,1,3,19,911,1179,2090,2257
0131-002,2017,1,3,20,705,862,1567,2090
0131-002,2017,1,3,21,572,858,1430,1567
0131-002,2017,1,3,22,412,563,975,1430
0131-002,2017,1,3,23,284,351,635,975
0131-002,2017,1,3,24,203,235,438,635
0131-002,2017,1,4,1,155,178,333,438
0131-002,2017,1,4,2,105,94,199,333
0131-002,2017,1,4,3,73,75,148,199
0131-002,2017,1,4,4,91,81,172,148
0131-002,2017,1,4,5,121,114,235,172
0131-002,2017,1,4,6,298,161,459,235
0131-002,2017,1,4,7,715,397,1112,459
0131-002,2017,1,4,8,1520,960,2480,1112
0131-002,2017,1,4,9,1396,1195,2591,2480
0131-002,2017,1,4,10,1007,1010,2017,2591
0131-002,2017,1,4,11,1022,1051,2073,2017
0131-002,2017,1,4,12,987,1000,1987,2073
0131-002,2017,1,4,13,789,925,1714,1987
0131-002,2017,1,4,14,946,977,1923,1714
0131-002,2017,1,4,15,981,1161,2142,1923
0131-002,2017,1,4,16,967,1183,2150,2142
0131-002,2017,1,4,17,927,1097,2024,2150
0131-002,2017,1,4,18,1028,1410,2438,2024
0131-002,2017,1,4,19,1038,1266,2304,2438
0131-002,2017,1,4,20,715,857,1572,2304
0131-002,2017,1,4,21,570,711,1281,1572
0131-002,2017,1,4,22,508,601,1109,1281
0131-002,2017,1,4,23,301,304,605,1109
0131-002,2017,1,4,24,240,221,461,605
0131-002,2017,1,5,1,164,165,329,461
0131-002,2017,1,5,2,104,120,224,329
0131-002,2017,1,5,3,78,74,152,224
0131-002,2017,1,5,4,105,107,212,152
0131-002,2017,1,5,5,111,101,212,212
0131-002,2017,1,5,6,308,162,470,212
0131-002,2017,1,5,7,697,428,1125,470
0131-002,2017,1,5,8,1559,963,2522,1125
0131-002,2017,1,5,9,1400,1236,2636,2522
0131-002,2017,1,5,10,1070,1056,2126,2636
0131-002,2017,1,5,11,1076,1023,2099,2126
0131-002,2017,1,5,12,1004,1007,2011,2099
0131-002,2017,1,5,13,861,917,1778,2011
0131-002,2017,1,5,14,960,996,1956,1778
0131-002,2017,1,5,15,1012,1091,2103,1956
0131-002,2017,1,5,16,906,1144,2050,2103
0131-002,2017,1,5,17,971,1140,2111,2050
0131-002,2017,1,5,18,982,1382,2364,2111
0131-002,2017,1,5,19,950,1218,2168,2364
0131-002,2017,1,5,20,642,869,1511,2168
0131-002,2017,1,5,21,558,749,1307,1511
0131-002,2017,1,5,22,460,582,1042,1307
0131-002,2017,1,5,23,306,348,654,1042
0131-002,2017,1,5,24,211,214,425,654
0131-002,2017,1,6,1,159,212,371,425
0131-002,2017,1,6,2,99,99,198,371
0131-002,2017,1,6,3,89,77,166,198
0131-002,2017,1,6,4,85,85,170,166
0131-002,2017,1,6,5,118,109,227,170
0131-002,2017,1,6,6,326,161,487,227
0131-002,2017,1,6,7,727,419,1146,487
0131-002,2017,1,6,8,1500,1020,2520,1146
0131-002,2017,1,6,9,1409,1205,2614,2520
0131-002,2017,1,6,10,1005,1072,2077,2614
0131-002,2017,1,6,11,1053,1098,2151,2077
0131-002,2017,1,6,12,1003,1052,2055,2151
0131-002,2017,1,6,13,883,889,1772,2055
0131-002,2017,1,6,14,907,1054,1961,1772
0131-002,2017,1,6,15,1001,1115,2116,1961
0131-002,2017,1,6,16,1020,1109,2129,2116
0131-002,2017,1,6,17,1024,1221,2245,2129
0131-002,2017,1,6,18,1112,1506,2618,2245
0131-002,2017,1,6,19,1149,1452,2601,2618
0131-002,2017,1,6,20,848,1009,1857,2601
0131-002,2017,1,6,21,587,838,1425,1857
0131-002,2017,1,6,22,464,577,1041,1425
0131-002,2017,1,6,23,367,388,755,1041
0131-002,2017,1,6,24,215,284,499,755
0131-002,2017,1,7,1,193,200,393,499
0131-002,2017,1,7,2,124,131,255,393
0131-002,2017,1,7,3,92,99,191,255
0131-002,2017,1,7,4,103,83,186,191
0131-002,2017,1,7,5,111,134,245,186
0131-002,2017,1,7,6,257,167,424,245
0131-002,2017,1,7,7,536,333,869,424
0131-002,2017,1,7,8,840,576,1416,869
0131-002,2017,1,7,9,863,820,1683,1416
0131-002,2017,1,7,10,802,888,1690,1683
0131-002,2017,1,7,11,828,939,1767,1690
0131-002,2017,1,7,12,868,926,1794,1767
0131-002,2017,1,7,13,778,806,1584,1794
0131-002,2017,1,7,14,801,829,1630,1584
0131-002,2017,1,7,15,808,969,1777,1630
0131-002,2017,1,7,16,867,1014,1881,1777
0131-002,2017,1,7,17,822,1110,1932,1881
0131-002,2017,1,7,18,991,1324,2315,1932
0131-002,2017,1,7,19,872,1002,1874,2315
0131-002,2017,1,7,20,523,567,1090,1874
0131-002,2017,1,7,21,452,456,908,1090
0131-002,2017,1,7,22,425,370,795,908
0131-002,2017,1,7,23,323,263,586,795
0131-002,2017,1,7,24,223,198,421,586
0131-002,2017,1,8,1,158,156,314,421
0131-002,2017,1,8,2,105,110,215,314
0131-002,2017,1,8,3,85,98,183,215
0131-002,2017,1,8,4,71,69,140,183
0131-002,2017,1,8,5,73,88,161,140
0131-002,2017,1,8,6,151,84,235,161
0131-002,2017,1,8,7,242,168,410,235
0131-002,2017,1,8,8,339,246,585,410
0131-002,2017,1,8,9,405,403,808,585
0131-002,2017,1,8,10,380,484,864,808
0131-002,2017,1,8,11,523,569,1092,864
0131-002,2017,1,8,12,560,537,1097,1092
0131-002,2017,1,8,13,562,572,1134,1097
0131-002,2017,1,8,14,619,651,1270,1134
0131-002,2017,1,8,15,699,703,1402,1270
0131-002,2017,1,8,16,718,783,1501,1402
0131-002,2017,1,8,17,690,857,1547,1501
0131-002,2017,1,8,18,727,872,1599,1547
0131-002,2017,1,8,19,660,605,1265,1599
0131-002,2017,1,8,20,512,427,939,1265
0131-002,2017,1,8,21,460,402,862,939
0131-002,2017,1,8,22,371,330,701,862
0131-002,2017,1,8,23,284,233,517,701
0131-002,2017,1,8,24,191,152,343,517
0131-002,2017,1,9,1,121,97,218,343
0131-002,2017,1,9,2,77,80,157,218
0131-002,2017,1,9,3,55,54,109,157
0131-002,2017,1,9,4,51,59,110,109
0131-002,2017,1,9,5,104,99,203,110
0131-002,2017,1,9,6,331,161,492,203
0131-002,2017,1,9,7,781,440,1221,492
0131-002,2017,1,9,8,1566,996,2562,1221
0131-002,2017,1,9,9,1415,1194,2609,2562
0131-002,2017,1,9,10,954,990,1944,2609
0131-002,2017,1,9,11,947,1066,2013,1944
0131-002,2017,1,9,12,1031,1030,2061,2013
0131-002,2017,1,9,13,910,903,1813,2061
0131-002,2017,1,9,14,1021,955,1976,1813
0131-002,2017,1,9,15,1070,1154,2224,1976
0131-002,2017,1,9,16,1086,1092,2178,2224
0131-002,2017,1,9,17,1025,1177,2202,2178
0131-002,2017,1,9,18,1062,1336,2398,2202
0131-002,2017,1,9,19,887,1198,2085,2398
0131-002,2017,1,9,20,755,881,1636,2085
0131-002,2017,1,9,21,567,832,1399,1636
0131-002,2017,1,9,22,429,573,1002,1399
0131-002,2017,1,9,23,293,345,638,1002
0131-002,2017,1,9,24,179,216,395,638
0131-002,2017,1,10,1,142,123,265,395
0131-002,2017,1,10,2,105,96,201,265
0131-002,2017,1,10,3,65,98,163,201
0131-002,2017,1,10,4,87,73,160,163
0131-002,2017,1,10,5,114,104,218,160
0131-002,2017,1,10,6,308,167,475,218
0131-002,2017,1,10,7,729,383,1112,475
0131-002,2017,1,10,8,1465,959,2424,1112
0131-002,2017,1,10,9,1348,1287,2635,2424
0131-002,2017,1,10,10,1058,1033,2091,2635
0131-002,2017,1,10,11,1125,833,1958,2091
0131-002,2017,1,10,12,1035,1107,2142,1958
0131-002,2017,1,10,13,888,911,1799,2142
0131-002,2017,1,10,14,1014,1007,2021,1799
0131-002,2017,1,10,15,1037,1088,2125,2021
0131-002,2017,1,10,16,1053,1109,2162,2125
0131-002,2017,1,10,17,1003,1162,2165,2162
0131-002,2017,1,10,18,976,1300,2276,2165
0131-002,2017,1,10,19,879,1172,2051,2276
0131-002,2017,1,10,20,722,882,1604,2051
0131-002,2017,1,10,21,563,827,1390,1604
0131-002,2017,1,10,22,458,593,1051,1390
0131-002,2017,1,10,23,298,353,651,1051
0131-002,2017,1,10,24,196,222,418,651
0131-002,2017,1,11,1,140,156,296,418
0131-002,2017,1,11,2,114,97,211,296
0131-002,2017,1,11,3,80,77,157,211
0131-002,2017,1,11,4,85,70,155,157
0131-002,2017,1,11,5,110,102,212,155
0131-002,2017,1,11,6,310,174,484,212
0131-002,2017,1,11,7,671,409,1080,484
0131-002,2017,1,11,8,1431,979,2410,1080
0131-002,2017,1,11,9,1423,1307,2730,2410
0131-002,2017,1,11,10,1078,1031,2109,2730
0131-002,2017,1,11,11,1063,1053,2116,2109
0131-002,2017,1,11,12,1089,1038,2127,2116
0131-002,2017,1,11,13,923,885,1808,2127
0131-002,2017,1,11,14,1125,1042,2167,1808
0131-002,2017,1,11,15,1219,1156,2375,2167
0131-002,2017,1,11,16,1098,1113,2211,2375
0131-002,2017,1,11,17,1071,1203,2274,2211
0131-002,2017,1,11,18,1091,1423,2514,2274
0131-002,2017,1,11,19,991,1279,2270,2514
0131-002,2017,1,11,20,725,889,1614,2270
0131-002,2017,1,11,21,557,703,1260,1614
0131-002,2017,1,11,22,436,547,983,1260
0131-002,2017,1,11,23,331,364,695,983
0131-002,2017,1,11,24,204,243,447,695
0131-002,2017,1,12,1,128,161,289,447
0131-002,2017,1,12,2,104,87,191,289
0131-002,2017,1,12,3,67,71,138,191
0131-002,2017,1,12,4,92,84,176,138
0131-002,2017,1,12,5,82,104,186,176
0131-002,2017,1,12,6,303,173,476,186
0131-002,2017,1,12,7,567,376,943,476
0131-002,2017,1,12,8,1038,933,1971,943
0131-002,2017,1,12,9,1003,1125,2128,1971
0131-002,2017,1,12,10,663,666,1329,2128
0131-002,2017,1,12,11,543,511,1054,1329
0131-002,2017,1,12,12,544,521,1065,1054
0131-002,2017,1,12,13,474,465,939,1065
0131-002,2017,1,12,14,569,515,1084,939
0131-002,2017,1,12,15,598,531,1129,1084
0131-002,2017,1,12,16,551,595,1146,1129
0131-002,2017,1,12,17,529,726,1255,1146
0131-002,2017,1,12,18,497,961,1458,1255
0131-002,2017,1,12,19,472,997,1469,1458
0131-002,2017,1,12,20,386,779,1165,1469
0131-002,2017,1,12,21,317,722,1039,1165
0131-002,2017,1,12,22,263,560,823,1039
0131-002,2017,1,12,23,207,369,576,823
0131-002,2017,1,12,24,123,218,341,576
0131-002,2017,1,13,1,119,147,266,341
0131-002,2017,1,13,2,91,110,201,266
0131-002,2017,1,13,3,73,65,138,201
0131-002,2017,1,13,4,80,102,182,138
0131-002,2017,1,13,5,103,105,208,182
0131-002,2017,1,13,6,322,171,493,208
0131-002,2017,1,13,7,670,378,1048,493
0131-002,2017,1,13,8,1420,908,2328,1048
0131-002,2017,1,13,9,1206,1275,2481,2328
0131-002,2017,1,13,10,997,1087,2084,2481
0131-002,2017,1,13,11,1033,1118,2151,2084
0131-002,2017,1,13,12,916,1108,2024,2151
0131-002,2017,1,13,13,905,908,1813,2024
0131-002,2017,1,13,14,944,1003,1947,1813
0131-002,2017,1,13,15,1042,1108,2150,1947
0131-002,2017,1,13,16,1046,1071,2117,2150
0131-002,2017,1,13,17,1056,1166,2222,2117
0131-002,2017,1,13,18,1104,1434,2538,2222
0131-002,2017,1,13,19,1124,1337,2461,2538
0131-002,2017,1,13,20,818,975,1793,2461
0131-002,2017,1,13,21,590,830,1420,1793
0131-002,2017,1,13,22,517,534,1051,1420
0131-002,2017,1,13,23,360,342,702,1051
0131-002,2017,1,13,24,226,257,483,702
0131-002,2017,1,14,1,198,187,385,483
0131-002,2017,1,14,2,125,132,257,385
0131-002,2017,1,14,3,88,97,185,257
0131-002,2017,1,14,4,77,96,173,185
0131-002,2017,1,14,5,101,109,210,173
0131-002,2017,1,14,6,238,157,395,210
0131-002,2017,1,14,7,436,247,683,395
0131-002,2017,1,14,8,740,543,1283,683
0131-002,2017,1,14,9,842,889,1731,1283
0131-002,2017,1,14,10,825,876,1701,1731
0131-002,2017,1,14,11,789,938,1727,1701
0131-002,2017,1,14,12,837,970,1807,1727
0131-002,2017,1,14,13,951,861,1812,1807
0131-002,2017,1,14,14,719,851,1570,1812
0131-002,2017,1,14,15,735,947,1682,1570
0131-002,2017,1,14,16,975,965,1940,1682
0131-002,2017,1,14,17,1007,1112,2119,1940
0131-002,2017,1,14,18,1067,1206,2273,2119
0131-002,2017,1,14,19,844,905,1749,2273
0131-002,2017,1,14,20,563,532,1095,1749
0131-002,2017,1,14,21,429,455,884,1095
0131-002,2017,1,14,22,362,334,696,884
0131-002,2017,1,14,23,258,249,507,696
0131-002,2017,1,14,24,192,213,405,507
0131-002,2017,1,15,1,142,132,274,405
0131-002,2017,1,15,2,90,82,172,274
0131-002,2017,1,15,3,87,76,163,172
0131-002,2017,1,15,4,68,62,130,163
0131-002,2017,1,15,5,67,64,131,130
0131-002,2017,1,15,6,96,87,183,131
0131-002,2017,1,15,7,196,137,333,183
0131-002,2017,1,15,8,256,237,493,333
0131-002,2017,1,15,9,330,364,694,493
0131-002,2017,1,15,10,369,478,847,694
0131-002,2017,1,15,11,476,559,1035,847
0131-002,2017,1,15,12,548,627,1175,1035
0131-002,2017,1,15,13,611,605,1216,1175
0131-002,2017,1,15,14,699,687,1386,1216
0131-002,2017,1,15,15,798,724,1522,1386
0131-002,2017,1,15,16,917,735,1652,1522
0131-002,2017,1,15,17,872,753,1625,1652
0131-002,2017,1,15,18,786,775,1561,1625
0131-002,2017,1,15,19,720,599,1319,1561
0131-002,2017,1,15,20,576,426,1002,1319
0131-002,2017,1,15,21,471,401,872,1002
0131-002,2017,1,15,22,406,328,734,872
0131-002,2017,1,15,23,279,250,529,734
0131-002,2017,1,15,24,186,165,351,529
0131-002,2017,1,16,1,115,87,202,351
0131-002,2017,1,16,2,86,55,141,202
0131-002,2017,1,16,3,51,44,95,141
0131-002,2017,1,16,4,67,54,121,95
0131-002,2017,1,16,5,101,87,188,121
0131-002,2017,1,16,6,315,158,473,188
0131-002,2017,1,16,7,673,416,1089,473
0131-002,2017,1,16,8,1561,1037,2598,1089
0131-002,2017,1,16,9,1457,1209,2666,2598
0131-002,2017,1,16,10,951,1052,2003,2666
0131-002,2017,1,16,11,1057,1076,2133,2003
0131-002,2017,1,16,12,986,1023,2009,2133
0131-002,2017,1,16,13,1028,902,1930,2009
0131-002,2017,1,16,14,1191,1058,2249,1930
0131-002,2017,1,16,15,1251,1178,2429,2249
0131-002,2017,1,16,16,1205,1148,2353,2429
0131-002,2017,1,16,17,1161,1165,2326,2353
0131-002,2017,1,16,18,1231,1302,2533,2326
0131-002,2017,1,16,19,1077,1255,2332,2533
0131-002,2017,1,16,20,802,899,1701,2332
0131-002,2017,1,16,21,578,843,1421,1701
0131-002,2017,1,16,22,451,548,999,1421
0131-002,2017,1,16,23,266,344,610,999
0131-002,2017,1,16,24,154,222,376,610
0131-002,2017,1,17,1,132,133,265,376
0131-002,2017,1,17,2,97,93,190,265
0131-002,2017,1,17,3,76,80,156,190
0131-002,2017,1,17,4,70,93,163,156
0131-002,2017,1,17,5,107,107,214,163
0131-002,2017,1,17,6,292,156,448,214
0131-002,2017,1,17,7,623,407,1030,448
0131-002,2017,1,17,8,1468,984,2452,1030
0131-002,2017,1,17,9,1401,1256,2657,2452
0131-002,2017,1,17,10,1007,1055,2062,2657
0131-002,2017,1,17,11,1129,1059,2188,2062
0131-002,2017,1,17,12,1065,1099,2164,2188
0131-002,2017,1,17,13,1028,981,2009,2164
0131-002,2017,1,17,14,1161,1085,2246,2009
0131-002,2017,1,17,15,1202,1094,2296,2246
0131-002,2017,1,17,16,1293,1144,2437,2296
0131-002,2017,1,17,17,1185,1187,2372,2437
0131-002,2017,1,17,18,1250,1300,2550,2372
0131-002,2017,1,17,19,1069,1207,2276,2550
0131-002,2017,1,17,20,802,943,1745,2276
0131-002,2017,1,17,21,701,845,1546,1745
0131-002,2017,1,17,22,477,577,1054,1546
0131-002,2017,1,17,23,330,403,733,1054
0131-002,2017,1,17,24,185,220,405,733
0131-002,2017,1,18,1,148,143,291,405
0131-002,2017,1,18,2,103,98,201,291
0131-002,2017,1,18,3,72,75,147,201
0131-002,2017,1,18,4,80,81,161,147
0131-002,2017,1,18,5,118,109,227,161
0131-002,2017,1,18,6,283,158,441,227
0131-002,2017,1,18,7,710,405,1115,441
0131-002,2017,1,18,8,1498,973,2471,1115
0131-002,2017,1,18,9,1440,1336,2776,2471
0131-002,2017,1,18,10,1113,1086,2199,2776
0131-002,2017,1,18,11,1237,1032,2269,2199
0131-002,2017,1,18,12,1190,1054,2244,2269
0131-002,2017,1,18,13,1025,857,1882,2244
0131-002,2017,1,18,14,1096,1131,2227,1882
0131-002,2017,1,18,15,1210,1218,2428,2227
0131-002,2017,1,18,16,1181,1067,2248,2428
0131-002,2017,1,18,17,1154,1165,2319,2248
0131-002,2017,1,18,18,1211,1387,2598,2319
0131-002,2017,1,18,19,1070,1254,2324,2598
0131-002,2017,1,18,20,760,841,1601,2324
0131-002,2017,1,18,21,663,712,1375,1601
0131-002,2017,1,18,22,536,558,1094,1375
0131-002,2017,1,18,23,376,382,758,1094
0131-002,2017,1,18,24,246,253,499,758
0131-002,2017,1,19,1,186,141,327,499
0131-002,2017,1,19,2,143,113,256,327
0131-002,2017,1,19,3,81,75,156,256
0131-002,2017,1,19,4,115,84,199,156
0131-002,2017,1,19,5,127,104,231,199
0131-002,2017,1,19,6,330,171,501,231
0131-002,2017,1,19,7,773,411,1184,501
0131-002,2017,1,19,8,1538,954,2492,1184
0131-002,2017,1,19,9,1506,1216,2722,2492
0131-002,2017,1,19,10,1168,1043,2211,2722
0131-002,2017,1,19,11,1218,1078,2296,2211
0131-002,2017,1,19,12,1202,1022,2224,2296
0131-002,2017,1,19,13,1138,984,2122,2224
0131-002,2017,1,19,14,1154,999,2153,2122
0131-002,2017,1,19,15,1225,1128,2353,2153
0131-002,2017,1,19,16,1210,1198,2408,2353
0131-002,2017,1,19,17,1127,1279,2406,2408
0131-002,2017,1,19,18,1155,1421,2576,2406
0131-002,2017,1,19,19,1087,1257,2344,2576
0131-002,2017,1,19,20,752,920,1672,2344
0131-002,2017,1,19,21,659,833,1492,1672
0131-002,2017,1,19,22,518,579,1097,1492
0131-002,2017,1,19,23,387,375,762,1097
0131-002,2017,1,19,24,232,259,491,762
0131-002,2017,1,20,1,192,177,369,491
0131-002,2017,1,20,2,120,105,225,369
0131-002,2017,1,20,3,85,66,151,225
0131-002,2017,1,20,4,65,83,148,151
0131-002,2017,1,20,5,63,69,132,148
0131-002,2017,1,20,6,148,89,237,132
0131-002,2017,1,20,7,271,170,441,237
0131-002,2017,1,20,8,457,329,786,441
0131-002,2017,1,20,9,481,383,864,786
0131-002,2017,1,20,10,475,413,888,864
0131-002,2017,1,20,11,485,449,934,888
0131-002,2017,1,20,12,482,458,940,934
0131-002,2017,1,20,13,449,422,871,940
0131-002,2017,1,20,14,498,466,964,871
0131-002,2017,1,20,15,571,554,1125,964
0131-002,2017,1,20,16,524,544,1068,1125
0131-002,2017,1,20,17,525,519,1044,1068
0131-002,2017,1,20,18,543,552,1095,1044
0131-002,2017,1,20,19,563,559,1122,1095
0131-002,2017,1,20,20,405,406,811,1122
0131-002,2017,1,20,21,294,304,598,811
0131-002,2017,1,20,22,268,276,544,598
0131-002,2017,1,20,23,197,225,422,544
0131-002,2017,1,20,24,127,130,257,422
0131-002,2017,1,21,1,111,209,320,257
0131-002,2017,1,21,2,72,117,189,320
0131-002,2017,1,21,3,70,93,163,189
0131-002,2017,1,21,4,61,69,130,163
0131-002,2017,1,21,5,69,119,188,130
0131-002,2017,1,21,6,142,157,299,188
0131-002,2017,1,21,7,340,285,625,299
0131-002,2017,1,21,8,790,532,1322,625
0131-002,2017,1,21,9,852,822,1674,1322
0131-002,2017,1,21,10,814,912,1726,1674
0131-002,2017,1,21,11,808,909,1717,1726
0131-002,2017,1,21,12,852,795,1647,1717
0131-002,2017,1,21,13,864,789,1653,1647
0131-002,2017,1,21,14,760,760,1520,1653
0131-002,2017,1,21,15,772,845,1617,1520
0131-002,2017,1,21,16,921,870,1791,1617
0131-002,2017,1,21,17,914,936,1850,1791
0131-002,2017,1,21,18,1029,1111,2140,1850
0131-002,2017,1,21,19,858,736,1594,2140
0131-002,2017,1,21,20,543,511,1054,1594
0131-002,2017,1,21,21,440,389,829,1054
0131-002,2017,1,21,22,394,248,642,829
0131-002,2017,1,21,23,130,127,257,642
0131-002,2017,1,21,24,92,92,184,257
0131-002,2017,1,22,1,70,51,121,184
0131-002,2017,1,22,2,52,52,104,121
0131-002,2017,1,22,3,35,42,77,104
0131-002,2017,1,22,4,39,35,74,77
0131-002,2017,1,22,5,50,46,96,74
0131-002,2017,1,22,6,73,49,122,96
0131-002,2017,1,22,7,138,82,220,122
0131-002,2017,1,22,8,166,116,282,220
0131-002,2017,1,22,9,210,179,389,282
0131-002,2017,1,22,10,234,253,487,389
0131-002,2017,1,22,11,261,293,554,487
0131-002,2017,1,22,12,267,287,554,554
0131-002,2017,1,22,13,310,310,620,554
0131-002,2017,1,22,14,356,327,683,620
0131-002,2017,1,22,15,392,331,723,683
0131-002,2017,1,22,16,410,379,789,723
0131-002,2017,1,22,17,388,337,725,789
0131-002,2017,1,22,18,392,387,779,725
0131-002,2017,1,22,19,374,281,655,779
0131-002,2017,1,22,20,278,230,508,655
0131-002,2017,1,22,21,267,200,467,508
0131-002,2017,1,22,22,209,168,377,467
0131-002,2017,1,22,23,150,117,267,377
0131-002,2017,1,22,24,114,83,197,267
0131-002,2017,1,23,1,74,59,133,197
0131-002,2017,1,23,2,68,39,107,133
0131-002,2017,1,23,3,39,36,75,107
0131-002,2017,1,23,4,51,41,92,75
0131-002,2017,1,23,5,78,62,140,92
0131-002,2017,1,23,6,182,100,282,140
0131-002,2017,1,23,7,394,383,777,282
0131-002,2017,1,23,8,662,939,1601,777
0131-002,2017,1,23,9,642,1203,1845,1601
0131-002,2017,1,23,10,588,1032,1620,1845
0131-002,2017,1,23,11,587,873,1460,1620
0131-002,2017,1,23,12,590,536,1126,1460
0131-002,2017,1,23,13,568,515,1083,1126
0131-002,2017,1,23,14,610,571,1181,1083
0131-002,2017,1,23,15,680,593,1273,1181
0131-002,2017,1,23,16,663,600,1263,1273
0131-002,2017,1,23,17,621,563,1184,1263
0131-002,2017,1,23,18,572,610,1182,1184
0131-002,2017,1,23,19,551,559,1110,1182
0131-002,2017,1,23,20,409,436,845,1110
0131-002,2017,1,23,21,346,405,751,845
0131-002,2017,1,23,22,276,327,603,751
0131-002,2017,1,23,23,199,299,498,603
0131-002,2017,1,23,24,132,215,347,498
0131-002,2017,1,24,1,148,152,300,347
0131-002,2017,1,24,2,113,99,212,300
0131-002,2017,1,24,3,78,73,151,212
0131-002,2017,1,24,4,112,86,198,151
0131-002,2017,1,24,5,124,111,235,198
0131-002,2017,1,24,6,309,169,478,235
0131-002,2017,1,24,7,838,381,1219,478
0131-002,2017,1,24,8,1752,937,2689,1219
0131-002,2017,1,24,9,1422,1240,2662,2689
0131-002,2017,1,24,10,1097,1106,2203,2662
0131-002,2017,1,24,11,855,1131,1986,2203
0131-002,2017,1,24,12,874,999,1873,1986
0131-002,2017,1,24,13,768,839,1607,1873
0131-002,2017,1,24,14,856,983,1839,1607
0131-002,2017,1,24,15,924,958,1882,1839
0131-002,2017,1,24,16,900,1035,1935,1882
0131-002,2017,1,24,17,854,1077,1931,1935
0131-002,2017,1,24,18,789,1148,1937,1931
0131-002,2017,1,24,19,717,1048,1765,1937
0131-002,2017,1,24,20,561,766,1327,1765
0131-002,2017,1,24,21,471,695,1166,1327
0131-002,2017,1,24,22,415,551,966,1166
0131-002,2017,1,24,23,314,372,686,966
0131-002,2017,1,24,24,207,259,466,686
0131-002,2017,1,25,1,157,195,352,466
0131-002,2017,1,25,2,130,103,233,352
0131-002,2017,1,25,3,89,88,177,233
0131-002,2017,1,25,4,97,89,186,177
0131-002,2017,1,25,5,135,139,274,186
0131-002,2017,1,25,6,336,154,490,274
0131-002,2017,1,25,7,910,379,1289,490
0131-002,2017,1,25,8,1883,966,2849,1289
0131-002,2017,1,25,9,1897,1245,3142,2849
0131-002,2017,1,25,10,1561,1156,2717,3142
0131-002,2017,1,25,11,1038,1179,2217,2717
0131-002,2017,1,25,12,822,969,1791,2217
0131-002,2017,1,25,13,750,905,1655,1791
0131-002,2017,1,25,14,860,1021,1881,1655
0131-002,2017,1,25,15,909,1178,2087,1881
0131-002,2017,1,25,16,885,1173,2058,2087
0131-002,2017,1,25,17,841,1102,1943,2058
0131-002,2017,1,25,18,792,1398,2190,1943
0131-002,2017,1,25,19,733,1217,1950,2190
0131-002,2017,1,25,20,602,961,1563,1950
0131-002,2017,1,25,21,464,754,1218,1563
0131-002,2017,1,25,22,431,525,956,1218
0131-002,2017,1,25,23,324,382,706,956
0131-002,2017,1,25,24,225,270,495,706
0131-002,2017,1,26,1,150,189,339,495
0131-002,2017,1,26,2,141,129,270,339
0131-002,2017,1,26,3,97,97,194,270
0131-002,2017,1,26,4,84,95,179,194
0131-002,2017,1,26,5,146,116,262,179
0131-002,2017,1,26,6,351,155,506,262
0131-002,2017,1,26,7,753,321,1074,506
0131-002,2017,1,26,8,1895,886,2781,1074
0131-002,2017,1,26,9,1844,1198,3042,2781
0131-002,2017,1,26,10,1295,1055,2350,3042
0131-002,2017,1,26,11,749,1063,1812,2350
0131-002,2017,1,26,12,738,1086,1824,1812
0131-002,2017,1,26,13,694,1090,1784,1824
0131-002,2017,1,26,14,815,1215,2030,1784
0131-002,2017,1,26,15,778,1326,2104,2030
0131-002,2017,1,26,16,810,1377,2187,2104
0131-002,2017,1,26,17,844,1415,2259,2187
0131-002,2017,1,26,18,933,1491,2424,2259
0131-002,2017,1,26,19,922,1235,2157,2424
0131-002,2017,1,26,20,649,1056,1705,2157
0131-002,2017,1,26,21,475,821,1296,1705
0131-002,2017,1,26,22,419,614,1033,1296
0131-002,2017,1,26,23,368,451,819,1033
0131-002,2017,1,26,24,228,388,616,819
0131-002,2017,1,27,1,161,303,464,616
0131-002,2017,1,27,2,127,198,325,464
0131-002,2017,1,27,3,95,135,230,325
0131-002,2017,1,27,4,83,122,205,230
0131-002,2017,1,27,5,82,153,235,205
0131-002,2017,1,27,6,117,153,270,235
0131-002,2017,1,27,7,144,229,373,270
0131-002,2017,1,27,8,232,365,597,373
0131-002,2017,1,27,9,316,422,738,597
0131-002,2017,1,27,10,402,548,950,738
0131-002,2017,1,27,11,490,589,1079,950
0131-002,2017,1,27,12,572,567,1139,1079
0131-002,2017,1,27,13,534,625,1159,1139
0131-002,2017,1,27,14,525,592,1117,1159
0131-002,2017,1,27,15,512,457,969,1117
0131-002,2017,1,27,16,488,528,1016,969
0131-002,2017,1,27,17,442,515,957,1016
0131-002,2017,1,27,18,411,438,849,957
0131-002,2017,1,27,19,382,397,779,849
0131-002,2017,1,27,20,309,336,645,779
0131-002,2017,1,27,21,234,278,512,645
0131-002,2017,1,27,22,190,209,399,512
0131-002,2017,1,27,23,156,136,292,399
0131-002,2017,1,27,24,122,106,228,292
0131-002,2017,1,28,1,69,60,129,228
0131-002,2017,1,28,2,46,51,97,129
0131-002,2017,1,28,3,65,38,103,97
0131-002,2017,1,28,4,45,42,87,103
0131-002,2017,1,28,5,38,40,78,87
0131-002,2017,1,28,6,73,98,171,78
0131-002,2017,1,28,7,204,165,369,171
0131-002,2017,1,28,8,474,325,799,369
0131-002,2017,1,28,9,437,367,804,799
0131-002,2017,1,28,10,369,483,852,804
0131-002,2017,1,28,11,470,772,1242,852
0131-002,2017,1,28,12,731,979,1710,1242
0131-002,2017,1,28,13,715,980,1695,1710
0131-002,2017,1,28,14,767,973,1740,1695
0131-002,2017,1,28,15,730,914,1644,1740
0131-002,2017,1,28,16,855,897,1752,1644
0131-002,2017,1,28,17,871,925,1796,1752
0131-002,2017,1,28,18,728,789,1517,1796
0131-002,2017,1,28,19,719,525,1244,1517
0131-002,2017,1,28,20,633,395,1028,1244
0131-002,2017,1,28,21,503,328,831,1028
0131-002,2017,1,28,22,333,315,648,831
0131-002,2017,1,28,23,241,226,467,648
0131-002,2017,1,28,24,159,147,306,467
0131-002,2017,1,29,1,120,87,207,306
0131-002,2017,1,29,2,83,60,143,207
0131-002,2017,1,29,3,93,43,136,143
0131-002,2017,1,29,4,54,44,98,136
0131-002,2017,1,29,5,47,37,84,98
0131-002,2017,1,29,6,50,36,86,84
0131-002,2017,1,29,7,76,54,130,86
0131-002,2017,1,29,8,175,93,268,130
0131-002,2017,1,29,9,182,196,378,268
0131-002,2017,1,29,10,278,289,567,378
0131-002,2017,1,29,11,328,423,751,567
0131-002,2017,1,29,12,457,493,950,751
0131-002,2017,1,29,13,459,612,1071,950
0131-002,2017,1,29,14,522,623,1145,1071
0131-002,2017,1,29,15,558,565,1123,1145
0131-002,2017,1,29,16,622,398,1020,1123
0131-002,2017,1,29,17,717,433,1150,1020
0131-002,2017,1,29,18,714,385,1099,1150
0131-002,2017,1,29,19,698,283,981,1099
0131-002,2017,1,29,20,664,304,968,981
0131-002,2017,1,29,21,595,318,913,968
0131-002,2017,1,29,22,466,176,642,913
0131-002,2017,1,29,23,340,141,481,642
0131-002,2017,1,29,24,244,88,332,481
0131-002,2017,1,30,1,128,62,190,332
0131-002,2017,1,30,2,113,45,158,190
0131-002,2017,1,30,3,67,40,107,158
0131-002,2017,1,30,4,60,30,90,107
0131-002,2017,1,30,5,57,37,94,90
0131-002,2017,1,30,6,75,45,120,94
0131-002,2017,1,30,7,133,72,205,120
0131-002,2017,1,30,8,288,141,429,205
0131-002,2017,1,30,9,321,197,518,429
0131-002,2017,1,30,10,324,210,534,518
0131-002,2017,1,30,11,367,238,605,534
0131-002,2017,1,30,12,405,369,774,605
0131-002,2017,1,30,13,457,384,841,774
0131-002,2017,1,30,14,532,409,941,841
0131-002,2017,1,30,15,572,379,951,941
0131-002,2017,1,30,16,562,339,901,951
0131-002,2017,1,30,17,580,345,925,901
0131-002,2017,1,30,18,585,364,949,925
0131-002,2017,1,30,19,489,315,804,949
0131-002,2017,1,30,20,404,386,790,804
0131-002,2017,1,30,21,372,299,671,790
0131-002,2017,1,30,22,310,268,578,671
0131-002,2017,1,30,23,236,213,449,578
0131-002,2017,1,30,24,200,144,344,449
0131-002,2017,1,31,1,148,113,261,344
0131-002,2017,1,31,2,102,77,179,261
0131-002,2017,1,31,3,87,59,146,179
0131-002,2017,1,31,4,83,61,144,146
0131-002,2017,1,31,5,109,73,182,144
0131-002,2017,1,31,6,280,133,413,182
0131-002,2017,1,31,7,694,291,985,413
0131-002,2017,1,31,8,1759,763,2522,985
0131-002,2017,1,31,9,1518,1036,2554,2522
0131-002,2017,1,31,10,1094,784,1878,2554
0131-002,2017,1,31,11,1119,912,2031,1878
0131-002,2017,1,31,12,694,789,1483,2031
0131-002,2017,1,31,13,635,782,1417,1483
0131-002,2017,1,31,14,697,785,1482,1417
0131-002,2017,1,31,15,757,830,1587,1482
0131-002,2017,1,31,16,748,871,1619,1587
0131-002,2017,1,31,17,705,871,1576,1619
0131-002,2017,1,31,18,671,1055,1726,1576
0131-002,2017,1,31,19,671,1006,1677,1726
0131-002,2017,1,31,20,504,749,1253,1677
0131-002,2017,1,31,21,413,632,1045,1253
0131-002,2017,1,31,22,379,474,853,1045
0131-002,2017,1,31,23,262,316,578,853
0131-002,2017,1,31,24,186,208,394,578
0131-002,2017,2,1,1,149,120,269,394
0131-002,2017,2,1,2,124,113,237,269
0131-002,2017,2,1,3,74,79,153,237
0131-002,2017,2,1,4,75,75,150,153
0131-002,2017,2,1,5,129,112,241,150
0131-002,2017,2,1,6,343,160,503,241
0131-002,2017,2,1,7,792,387,1179,503
0131-002,2017,2,1,8,1653,926,2579,1179
0131-002,2017,2,1,9,1563,1174,2737,2579
0131-002,2017,2,1,10,1109,946,2055,2737
0131-002,2017,2,1,11,1052,906,1958,2055
0131-002,2017,2,1,12,946,876,1822,1958
0131-002,2017,2,1,13,699,803,1502,1822
0131-002,2017,2,1,14,566,924,1490,1502
0131-002,2017,2,1,15,762,963,1725,1490
0131-002,2017,2,1,16,943,1011,1954,1725
0131-002,2017,2,1,17,910,1042,1952,1954
0131-002,2017,2,1,18,1147,1291,2438,1952
0131-002,2017,2,1,19,1086,1175,2261,2438
0131-002,2017,2,1,20,854,837,1691,2261
0131-002,2017,2,1,21,713,701,1414,1691
0131-002,2017,2,1,22,624,486,1110,1414
0131-002,2017,2,1,23,399,366,765,1110
0131-002,2017,2,1,24,289,230,519,765
0131-002,2017,2,2,1,232,156,388,519
0131-002,2017,2,2,2,146,105,251,388
0131-002,2017,2,2,3,80,74,154,251
0131-002,2017,2,2,4,68,81,149,154
0131-002,2017,2,2,5,102,110,212,149
0131-002,2017,2,2,6,298,162,460,212
0131-002,2017,2,2,7,732,391,1123,460
0131-002,2017,2,2,8,1474,959,2433,1123
0131-002,2017,2,2,9,1398,1200,2598,2433
0131-002,2017,2,2,10,1169,1062,2231,2598
0131-002,2017,2,2,11,1307,1029,2336,2231
0131-002,2017,2,2,12,930,968,1898,2336
0131-002,2017,2,2,13,827,854,1681,1898
0131-002,2017,2,2,14,911,901,1812,1681
0131-002,2017,2,2,15,987,1030,2017,1812
0131-002,2017,2,2,16,904,1024,1928,2017
0131-002,2017,2,2,17,975,1015,1990,1928
0131-002,2017,2,2,18,1072,1193,2265,1990
0131-002,2017,2,2,19,993,1157,2150,2265
0131-002,2017,2,2,20,760,898,1658,2150
0131-002,2017,2,2,21,769,782,1551,1658
0131-002,2017,2,2,22,582,544,1126,1551
0131-002,2017,2,2,23,428,341,769,1126
0131-002,2017,2,2,24,262,214,476,769
0131-002,2017,2,3,1,229,169,398,476
0131-002,2017,2,3,2,166,109,275,398
0131-002,2017,2,3,3,117,81,198,275
0131-002,2017,2,3,4,125,88,213,198
0131-002,2017,2,3,5,179,109,288,213
0131-002,2017,2,3,6,403,162,565,288
0131-002,2017,2,3,7,784,362,1146,565
0131-002,2017,2,3,8,1441,906,2347,1146
0131-002,2017,2,3,9,1448,1165,2613,2347
0131-002,2017,2,3,10,960,1054,2014,2613
0131-002,2017,2,3,11,1137,1061,2198,2014
0131-002,2017,2,3,12,892,1021,1913,2198
0131-002,2017,2,3,13,698,851,1549,1913
0131-002,2017,2,3,14,973,959,1932,1549
0131-002,2017,2,3,15,1129,1132,2261,1932
0131-002,2017,2,3,16,1083,1057,2140,2261
0131-002,2017,2,3,17,1080,1114,2194,2140
0131-002,2017,2,3,18,1144,1428,2572,2194
0131-002,2017,2,3,19,1124,1401,2525,2572
0131-002,2017,2,3,20,923,991,1914,2525
0131-002,2017,2,3,21,719,879,1598,1914
0131-002,2017,2,3,22,649,607,1256,1598
0131-002,2017,2,3,23,461,358,819,1256
0131-002,2017,2,3,24,311,224,535,819
0131-002,2017,2,4,1,249,205,454,535
0131-002,2017,2,4,2,160,144,304,454
0131-002,2017,2,4,3,129,90,219,304
0131-002,2017,2,4,4,131,101,232,219
0131-002,2017,2,4,5,160,116,276,232
0131-002,2017,2,4,6,297,152,449,276
0131-002,2017,2,4,7,548,296,844,449
0131-002,2017,2,4,8,942,599,1541,844
0131-002,2017,2,4,9,1075,857,1932,1541
0131-002,2017,2,4,10,901,896,1797,1932
0131-002,2017,2,4,11,833,932,1765,1797
0131-002,2017,2,4,12,996,893,1889,1765
0131-002,2017,2,4,13,960,864,1824,1889
0131-002,2017,2,4,14,893,865,1758,1824
0131-002,2017,2,4,15,907,930,1837,1758
0131-002,2017,2,4,16,869,945,1814,1837
0131-002,2017,2,4,17,960,1041,2001,1814
0131-002,2017,2,4,18,1005,1189,2194,2001
0131-002,2017,2,4,19,930,863,1793,2194
0131-002,2017,2,4,20,598,545,1143,1793
0131-002,2017,2,4,21,493,427,920,1143
0131-002,2017,2,4,22,452,334,786,920
0131-002,2017,2,4,23,316,241,557,786
0131-002,2017,2,4,24,215,185,400,557
0131-002,2017,2,5,1,157,127,284,400
0131-002,2017,2,5,2,114,79,193,284
0131-002,2017,2,5,3,85,79,164,193
0131-002,2017,2,5,4,90,70,160,164
0131-002,2017,2,5,5,85,64,149,160
0131-002,2017,2,5,6,138,79,217,149
0131-002,2017,2,5,7,198,152,350,217
0131-002,2017,2,5,8,335,229,564,350
0131-002,2017,2,5,9,452,388,840,564
0131-002,2017,2,5,10,465,444,909,840
0131-002,2017,2,5,11,522,562,1084,909
0131-002,2017,2,5,12,611,547,1158,1084
0131-002,2017,2,5,13,517,477,994,1158
0131-002,2017,2,5,14,377,414,791,994
0131-002,2017,2,5,15,372,419,791,791
0131-002,2017,2,5,16,366,424,790,791
0131-002,2017,2,5,17,361,385,746,790
0131-002,2017,2,5,18,396,369,765,746
0131-002,2017,2,5,19,377,320,697,765
0131-002,2017,2,5,20,296,232,528,697
0131-002,2017,2,5,21,229,222,451,528
0131-002,2017,2,5,22,210,176,386,451
0131-002,2017,2,5,23,163,187,350,386
0131-002,2017,2,5,24,125,130,255,350
0131-002,2017,2,6,1,84,83,167,255
0131-002,2017,2,6,2,66,61,127,167
0131-002,2017,2,6,3,44,44,88,127
0131-002,2017,2,6,4,43,63,106,88
0131-002,2017,2,6,5,70,85,155,106
0131-002,2017,2,6,6,197,152,349,155
0131-002,2017,2,6,7,384,429,813,349
0131-002,2017,2,6,8,1614,1022,2636,813
0131-002,2017,2,6,9,1339,1143,2482,2636
0131-002,2017,2,6,10,1012,970,1982,2482
0131-002,2017,2,6,11,1162,1001,2163,1982
0131-002,2017,2,6,12,1058,932,1990,2163
0131-002,2017,2,6,13,988,794,1782,1990
0131-002,2017,2,6,14,1086,927,2013,1782
0131-002,2017,2,6,15,1188,1040,2228,2013
0131-002,2017,2,6,16,1136,1132,2268,2228
0131-002,2017,2,6,17,1086,1137,2223,2268
0131-002,2017,2,6,18,1097,1301,2398,2223
0131-002,2017,2,6,19,966,1190,2156,2398
0131-002,2017,2,6,20,929,905,1834,2156
0131-002,2017,2,6,21,806,802,1608,1834
0131-002,2017,2,6,22,600,593,1193,1608
0131-002,2017,2,6,23,407,352,759,1193
0131-002,2017,2,6,24,258,222,480,759
0131-002,2017,2,7,1,207,152,359,480
0131-002,2017,2,7,2,129,104,233,359
0131-002,2017,2,7,3,109,70,179,233
0131-002,2017,2,7,4,88,75,163,179
0131-002,2017,2,7,5,151,115,266,163
0131-002,2017,2,7,6,301,163,464,266
0131-002,2017,2,7,7,657,365,1022,464
0131-002,2017,2,7,8,1535,996,2531,1022
0131-002,2017,2,7,9,1416,1260,2676,2531
0131-002,2017,2,7,10,1381,1134,2515,2676
0131-002,2017,2,7,11,1002,1026,2028,2515
0131-002,2017,2,7,12,858,1013,1871,2028
0131-002,2017,2,7,13,712,874,1586,1871
0131-002,2017,2,7,14,840,1023,1863,1586
0131-002,2017,2,7,15,838,1077,1915,1863
0131-002,2017,2,7,16,858,1098,1956,1915
0131-002,2017,2,7,17,830,1090,1920,1956
0131-002,2017,2,7,18,800,1262,2062,1920
0131-002,2017,2,7,19,1172,1153,2325,2062
0131-002,2017,2,7,20,878,879,1757,2325
0131-002,2017,2,7,21,722,862,1584,1757
0131-002,2017,2,7,22,563,572,1135,1584
0131-002,2017,2,7,23,375,322,697,1135
0131-002,2017,2,7,24,239,221,460,697
0131-002,2017,2,8,1,212,188,400,460
0131-002,2017,2,8,2,125,114,239,400
0131-002,2017,2,8,3,107,86,193,239
0131-002,2017,2,8,4,122,91,213,193
0131-002,2017,2,8,5,147,122,269,213
0131-002,2017,2,8,6,331,155,486,269
0131-002,2017,2,8,7,764,421,1185,486
0131-002,2017,2,8,8,1456,974,2430,1185
0131-002,2017,2,8,9,1420,1287,2707,2430
0131-002,2017,2,8,10,1232,1078,2310,2707
0131-002,2017,2,8,11,1356,1001,2357,2310
0131-002,2017,2,8,12,1294,984,2278,2357
0131-002,2017,2,8,13,909,858,1767,2278
0131-002,2017,2,8,14,1038,1069,2107,1767
0131-002,2017,2,8,15,1098,1153,2251,2107
0131-002,2017,2,8,16,1305,1093,2398,2251
0131-002,2017,2,8,17,1310,1137,2447,2398
0131-002,2017,2,8,18,1285,1460,2745,2447
0131-002,2017,2,8,19,1169,1179,2348,2745
0131-002,2017,2,8,20,864,832,1696,2348
0131-002,2017,2,8,21,692,752,1444,1696
0131-002,2017,2,8,22,501,481,982,1444
0131-002,2017,2,8,23,355,375,730,982
0131-002,2017,2,8,24,260,222,482,730
0131-002,2017,2,9,1,184,156,340,482
0131-002,2017,2,9,2,104,113,217,340
0131-002,2017,2,9,3,84,77,161,217
0131-002,2017,2,9,4,99,77,176,161
0131-002,2017,2,9,5,139,110,249,176
0131-002,2017,2,9,6,302,161,463,249
0131-002,2017,2,9,7,724,404,1128,463
0131-002,2017,2,9,8,1512,969,2481,1128
0131-002,2017,2,9,9,1378,1215,2593,2481
0131-002,2017,2,9,10,1230,1067,2297,2593
0131-002,2017,2,9,11,1180,1089,2269,2297
0131-002,2017,2,9,12,923,968,1891,2269
0131-002,2017,2,9,13,1106,888,1994,1891
0131-002,2017,2,9,14,1236,961,2197,1994
0131-002,2017,2,9,15,1357,1099,2456,2197
0131-002,2017,2,9,16,1208,1103,2311,2456
0131-002,2017,2,9,17,1078,1130,2208,2311
0131-002,2017,2,9,18,1166,1374,2540,2208
0131-002,2017,2,9,19,1032,1141,2173,2540
0131-002,2017,2,9,20,778,806,1584,2173
0131-002,2017,2,9,21,642,787,1429,1584
0131-002,2017,2,9,22,486,545,1031,1429
0131-002,2017,2,9,23,296,357,653,1031
0131-002,2017,2,9,24,220,242,462,653
0131-002,2017,2,10,1,149,139,288,462
0131-002,2017,2,10,2,114,122,236,288
0131-002,2017,2,10,3,99,75,174,236
0131-002,2017,2,10,4,109,97,206,174
0131-002,2017,2,10,5,118,97,215,206
0131-002,2017,2,10,6,290,160,450,215
0131-002,2017,2,10,7,609,372,981,450
0131-002,2017,2,10,8,1389,929,2318,981
0131-002,2017,2,10,9,1441,1303,2744,2318
0131-002,2017,2,10,10,948,1059,2007,2744
0131-002,2017,2,10,11,1022,1074,2096,2007
0131-002,2017,2,10,12,906,985,1891,2096
0131-002,2017,2,10,13,770,920,1690,1891
0131-002,2017,2,10,14,1049,1038,2087,1690
0131-002,2017,2,10,15,1272,1180,2452,2087
0131-002,2017,2,10,16,1290,1031,2321,2452
0131-002,2017,2,10,17,1222,1188,2410,2321
0131-002,2017,2,10,18,1291,1440,2731,2410
0131-002,2017,2,10,19,1177,1367,2544,2731
0131-002,2017,2,10,20,896,930,1826,2544
0131-002,2017,2,10,21,666,821,1487,1826
0131-002,2017,2,10,22,503,546,1049,1487
0131-002,2017,2,10,23,354,384,738,1049
0131-002,2017,2,10,24,238,267,505,738
0131-002,2017,2,11,1,157,175,332,505
0131-002,2017,2,11,2,130,143,273,332
0131-002,2017,2,11,3,85,118,203,273
0131-002,2017,2,11,4,77,107,184,203
0131-002,2017,2,11,5,106,120,226,184
0131-002,2017,2,11,6,214,128,342,226
0131-002,2017,2,11,7,423,265,688,342
0131-002,2017,2,11,8,753,552,1305,688
0131-002,2017,2,11,9,819,846,1665,1305
0131-002,2017,2,11,10,803,904,1707,1665
0131-002,2017,2,11,11,846,956,1802,1707
0131-002,2017,2,11,12,1114,967,2081,1802
0131-002,2017,2,11,13,1078,875,1953,2081
0131-002,2017,2,11,14,989,824,1813,1953
0131-002,2017,2,11,15,993,966,1959,1813
0131-002,2017,2,11,16,853,970,1823,1959
0131-002,2017,2,11,17,961,999,1960,1823
0131-002,2017,2,11,18,999,1199,2198,1960
0131-002,2017,2,11,19,886,877,1763,2198
0131-002,2017,2,11,20,615,564,1179,1763
0131-002,2017,2,11,21,449,466,915,1179
0131-002,2017,2,11,22,365,397,762,915
0131-002,2017,2,11,23,267,321,588,762
0131-002,2017,2,11,24,205,205,410,588
0131-002,2017,2,12,1,163,140,303,410
0131-002,2017,2,12,2,103,103,206,303
0131-002,2017,2,12,3,79,82,161,206
0131-002,2017,2,12,4,67,56,123,161
0131-002,2017,2,12,5,69,66,135,123
0131-002,2017,2,12,6,101,85,186,135
0131-002,2017,2,12,7,194,153,347,186
0131-002,2017,2,12,8,301,263,564,347
0131-002,2017,2,12,9,384,420,804,564
0131-002,2017,2,12,10,415,477,892,804
0131-002,2017,2,12,11,633,565,1198,892
0131-002,2017,2,12,12,716,506,1222,1198
0131-002,2017,2,12,13,677,578,1255,1222
0131-002,2017,2,12,14,472,673,1145,1255
0131-002,2017,2,12,15,415,712,1127,1145
0131-002,2017,2,12,16,637,772,1409,1127
0131-002,2017,2,12,17,1000,807,1807,1409
0131-002,2017,2,12,18,852,770,1622,1807
0131-002,2017,2,12,19,771,630,1401,1622
0131-002,2017,2,12,20,556,412,968,1401
0131-002,2017,2,12,21,506,370,876,968
0131-002,2017,2,12,22,442,297,739,876
0131-002,2017,2,12,23,286,253,539,739
0131-002,2017,2,12,24,195,156,351,539
0131-002,2017,2,13,1,140,96,236,351
0131-002,2017,2,13,2,75,80,155,236
0131-002,2017,2,13,3,74,44,118,155
0131-002,2017,2,13,4,56,53,109,118
0131-002,2017,2,13,5,107,73,180,109
0131-002,2017,2,13,6,327,193,520,180
0131-002,2017,2,13,7,741,431,1172,520
0131-002,2017,2,13,8,1666,1024,2690,1172
0131-002,2017,2,13,9,1391,1229,2620,2690
0131-002,2017,2,13,10,1049,1026,2075,2620
0131-002,2017,2,13,11,1301,1017,2318,2075
0131-002,2017,2,13,12,1223,1018,2241,2318
0131-002,2017,2,13,13,1089,844,1933,2241
0131-002,2017,2,13,14,1273,967,2240,1933
0131-002,2017,2,13,15,1327,1078,2405,2240
0131-002,2017,2,13,16,1211,1076,2287,2405
0131-002,2017,2,13,17,1203,1187,2390,2287
0131-002,2017,2,13,18,1154,1325,2479,2390
0131-002,2017,2,13,19,942,1098,2040,2479
0131-002,2017,2,13,20,397,430,827,2040
0131-002,2017,2,13,21,345,397,742,827
0131-002,2017,2,13,22,249,308,557,742
0131-002,2017,2,13,23,193,212,405,557
0131-002,2017,2,13,24,122,142,264,405
0131-002,2017,2,14,1,88,113,201,264
0131-002,2017,2,14,2,62,80,142,201
0131-002,2017,2,14,3,52,73,125,142
0131-002,2017,2,14,4,55,74,129,125
0131-002,2017,2,14,5,82,102,184,129
0131-002,2017,2,14,6,160,173,333,184
0131-002,2017,2,14,7,366,364,730,333
0131-002,2017,2,14,8,1520,957,2477,730
0131-002,2017,2,14,9,1396,1236,2632,2477
0131-002,2017,2,14,10,1256,964,2220,2632
0131-002,2017,2,14,11,1080,916,1996,2220
0131-002,2017,2,14,12,990,966,1956,1996
0131-002,2017,2,14,13,808,801,1609,1956
0131-002,2017,2,14,14,965,972,1937,1609
0131-002,2017,2,14,15,958,1063,2021,1937
0131-002,2017,2,14,16,988,995,1983,2021
0131-002,2017,2,14,17,942,1133,2075,1983
0131-002,2017,2,14,18,940,1307,2247,2075
0131-002,2017,2,14,19,1092,1173,2265,2247
0131-002,2017,2,14,20,826,937,1763,2265
0131-002,2017,2,14,21,658,861,1519,1763
0131-002,2017,2,14,22,533,574,1107,1519
0131-002,2017,2,14,23,409,366,775,1107
0131-002,2017,2,14,24,268,229,497,775
0131-002,2017,2,15,1,191,166,357,497
0131-002,2017,2,15,2,152,113,265,357
0131-002,2017,2,15,3,107,87,194,265
0131-002,2017,2,15,4,104,98,202,194
0131-002,2017,2,15,5,143,100,243,202
0131-002,2017,2,15,6,306,146,452,243
0131-002,2017,2,15,7,646,418,1064,452
0131-002,2017,2,15,8,1540,1005,2545,1064
0131-002,2017,2,15,9,1441,1310,2751,2545
0131-002,2017,2,15,10,1201,1098,2299,2751
0131-002,2017,2,15,11,968,1099,2067,2299
0131-002,2017,2,15,12,1068,1018,2086,2067
0131-002,2017,2,15,13,808,881,1689,2086
0131-002,2017,2,15,14,934,1007,1941,1689
0131-002,2017,2,15,15,950,1066,2016,1941
0131-002,2017,2,15,16,1099,1142,2241,2016
0131-002,2017,2,15,17,1061,1123,2184,2241
0131-002,2017,2,15,18,1088,1438,2526,2184
0131-002,2017,2,15,19,992,1253,2245,2526
0131-002,2017,2,15,20,845,898,1743,2245
0131-002,2017,2,15,21,643,694,1337,1743
0131-002,2017,2,15,22,504,510,1014,1337
0131-002,2017,2,15,23,371,322,693,1014
0131-002,2017,2,15,24,251,248,499,693
0131-002,2017,2,16,1,184,186,370,499
0131-002,2017,2,16,2,119,128,247,370
0131-002,2017,2,16,3,100,103,203,247
0131-002,2017,2,16,4,87,82,169,203
0131-002,2017,2,16,5,131,115,246,169
0131-002,2017,2,16,6,312,156,468,246
0131-002,2017,2,16,7,705,444,1149,468
0131-002,2017,2,16,8,1586,961,2547,1149
0131-002,2017,2,16,9,1443,1294,2737,2547
0131-002,2017,2,16,10,1150,1082,2232,2737
0131-002,2017,2,16,11,1182,1073,2255,2232
0131-002,2017,2,16,12,937,1042,1979,2255
0131-002,2017,2,16,13,1026,923,1949,1979
0131-002,2017,2,16,14,1131,1012,2143,1949
0131-002,2017,2,16,15,1240,1155,2395,2143
0131-002,2017,2,16,16,1098,1142,2240,2395
0131-002,2017,2,16,17,1044,1078,2122,2240
0131-002,2017,2,16,18,1125,1324,2449,2122
0131-002,2017,2,16,19,1028,1174,2202,2449
0131-002,2017,2,16,20,743,886,1629,2202
0131-002,2017,2,16,21,621,880,1501,1629
0131-002,2017,2,16,22,483,559,1042,1501
0131-002,2017,2,16,23,306,374,680,1042
0131-002,2017,2,16,24,225,265,490,680
0131-002,2017,2,17,1,164,158,322,490
0131-002,2017,2,17,2,84,123,207,322
0131-002,2017,2,17,3,56,84,140,207
0131-002,2017,2,17,4,57,80,137,140
0131-002,2017,2,17,5,100,108,208,137
0131-002,2017,2,17,6,263,163,426,208
0131-002,2017,2,17,7,571,406,977,426
0131-002,2017,2,17,8,655,850,1505,977
0131-002,2017,2,17,9,893,1193,2086,1505
0131-002,2017,2,17,10,971,1074,2045,2086
0131-002,2017,2,17,11,908,1122,2030,2045
0131-002,2017,2,17,12,920,1074,1994,2030
0131-002,2017,2,17,13,843,967,1810,1994
0131-002,2017,2,17,14,897,963,1860,1810
0131-002,2017,2,17,15,986,1172,2158,1860
0131-002,2017,2,17,16,876,1091,1967,2158
0131-002,2017,2,17,17,939,1052,1991,1967
0131-002,2017,2,17,18,996,1414,2410,1991
0131-002,2017,2,17,19,1070,1351,2421,2410
0131-002,2017,2,17,20,805,1044,1849,2421
0131-002,2017,2,17,21,636,794,1430,1849
0131-002,2017,2,17,22,495,612,1107,1430
0131-002,2017,2,17,23,361,386,747,1107
0131-002,2017,2,17,24,258,207,465,747
0131-002,2017,2,18,1,187,200,387,465
0131-002,2017,2,18,2,137,140,277,387
0131-002,2017,2,18,3,112,102,214,277
0131-002,2017,2,18,4,75,97,172,214
0131-002,2017,2,18,5,108,136,244,172
0131-002,2017,2,18,6,216,158,374,244
0131-002,2017,2,18,7,475,298,773,374
0131-002,2017,2,18,8,815,570,1385,773
0131-002,2017,2,18,9,929,925,1854,1385
0131-002,2017,2,18,10,838,987,1825,1854
0131-002,2017,2,18,11,973,1001,1974,1825
0131-002,2017,2,18,12,878,937,1815,1974
0131-002,2017,2,18,13,841,889,1730,1815
0131-002,2017,2,18,14,797,898,1695,1730
0131-002,2017,2,18,15,821,989,1810,1695
0131-002,2017,2,18,16,885,1006,1891,1810
0131-002,2017,2,18,17,959,1079,2038,1891
0131-002,2017,2,18,18,1064,1259,2323,2038
0131-002,2017,2,18,19,869,865,1734,2323
0131-002,2017,2,18,20,601,566,1167,1734
0131-002,2017,2,18,21,461,505,966,1167
0131-002,2017,2,18,22,388,350,738,966
0131-002,2017,2,18,23,301,294,595,738
0131-002,2017,2,18,24,217,198,415,595
0131-002,2017,2,19,1,159,127,286,415
0131-002,2017,2,19,2,116,107,223,286
0131-002,2017,2,19,3,102,89,191,223
0131-002,2017,2,19,4,78,80,158,191
0131-002,2017,2,19,5,73,56,129,158
0131-002,2017,2,19,6,117,87,204,129
0131-002,2017,2,19,7,213,165,378,204
0131-002,2017,2,19,8,362,252,614,378
0131-002,2017,2,19,9,433,418,851,614
0131-002,2017,2,19,10,500,539,1039,851
0131-002,2017,2,19,11,609,592,1201,1039
0131-002,2017,2,19,12,671,665,1336,1201
0131-002,2017,2,19,13,642,656,1298,1336
0131-002,2017,2,19,14,668,732,1400,1298
0131-002,2017,2,19,15,727,818,1545,1400
0131-002,2017,2,19,16,842,836,1678,1545
0131-002,2017,2,19,17,786,861,1647,1678
0131-002,2017,2,19,18,855,845,1700,1647
0131-002,2017,2,19,19,437,475,912,1700
0131-002,2017,2,19,20,330,342,672,912
0131-002,2017,2,19,21,296,360,656,672
0131-002,2017,2,19,22,241,282,523,656
0131-002,2017,2,19,23,175,209,384,523
0131-002,2017,2,19,24,157,167,324,384
0131-002,2017,2,20,1,132,103,235,324
0131-002,2017,2,20,2,80,78,158,235
0131-002,2017,2,20,3,72,50,122,158
0131-002,2017,2,20,4,61,67,128,122
0131-002,2017,2,20,5,117,76,193,128
0131-002,2017,2,20,6,302,165,467,193
0131-002,2017,2,20,7,773,452,1225,467
0131-002,2017,2,20,8,1563,1022,2585,1225
0131-002,2017,2,20,9,1287,1185,2472,2585
0131-002,2017,2,20,10,975,1051,2026,2472
0131-002,2017,2,20,11,1022,1058,2080,2026
0131-002,2017,2,20,12,892,1045,1937,2080
0131-002,2017,2,20,13,888,882,1770,1937
0131-002,2017,2,20,14,899,1010,1909,1770
0131-002,2017,2,20,15,1050,1129,2179,1909
0131-002,2017,2,20,16,1061,1088,2149,2179
0131-002,2017,2,20,17,968,1115,2083,2149
0131-002,2017,2,20,18,1040,1305,2345,2083
0131-002,2017,2,20,19,990,1188,2178,2345
0131-002,2017,2,20,20,730,946,1676,2178
0131-002,2017,2,20,21,577,849,1426,1676
0131-002,2017,2,20,22,491,562,1053,1426
0131-002,2017,2,20,23,312,328,640,1053
0131-002,2017,2,20,24,214,217,431,640
0131-002,2017,2,21,1,136,147,283,431
0131-002,2017,2,21,2,87,113,200,283
0131-002,2017,2,21,3,61,77,138,200
0131-002,2017,2,21,4,85,78,163,138
0131-002,2017,2,21,5,117,100,217,163
0131-002,2017,2,21,6,302,176,478,217
0131-002,2017,2,21,7,701,407,1108,478
0131-002,2017,2,21,8,1506,967,2473,1108
0131-002,2017,2,21,9,1376,1284,2660,2473
0131-002,2017,2,21,10,1130,1148,2278,2660
0131-002,2017,2,21,11,1159,1128,2287,2278
0131-002,2017,2,21,12,1121,1061,2182,2287
0131-002,2017,2,21,13,903,882,1785,2182
0131-002,2017,2,21,14,1090,1038,2128,1785
0131-002,2017,2,21,15,1078,1094,2172,2128
0131-002,2017,2,21,16,1119,1123,2242,2172
0131-002,2017,2,21,17,1054,1150,2204,2242
0131-002,2017,2,21,18,1080,1388,2468,2204
0131-002,2017,2,21,19,1013,1235,2248,2468
0131-002,2017,2,21,20,775,892,1667,2248
0131-002,2017,2,21,21,593,855,1448,1667
0131-002,2017,2,21,22,520,590,1110,1448
0131-002,2017,2,21,23,320,388,708,1110
0131-002,2017,2,21,24,212,228,440,708
0131-002,2017,2,22,1,148,160,308,440
0131-002,2017,2,22,2,99,103,202,308
0131-002,2017,2,22,3,89,79,168,202
0131-002,2017,2,22,4,101,84,185,168
0131-002,2017,2,22,5,113,96,209,185
0131-002,2017,2,22,6,295,166,461,209
0131-002,2017,2,22,7,626,397,1023,461
0131-002,2017,2,22,8,1471,931,2402,1023
0131-002,2017,2,22,9,1373,1278,2651,2402
0131-002,2017,2,22,10,978,900,1878,2651
0131-002,2017,2,22,11,906,912,1818,1878
0131-002,2017,2,22,12,938,895,1833,1818
0131-002,2017,2,22,13,790,914,1704,1833
0131-002,2017,2,22,14,892,936,1828,1704
0131-002,2017,2,22,15,920,995,1915,1828
0131-002,2017,2,22,16,968,1002,1970,1915
0131-002,2017,2,22,17,984,983,1967,1970
0131-002,2017,2,22,18,1026,1257,2283,1967
0131-002,2017,2,22,19,948,1151,2099,2283
0131-002,2017,2,22,20,627,807,1434,2099
0131-002,2017,2,22,21,490,667,1157,1434
0131-002,2017,2,22,22,394,492,886,1157
0131-002,2017,2,22,23,282,333,615,886
0131-002,2017,2,22,24,185,216,401,615
0131-002,2017,2,23,1,148,165,313,401
0131-002,2017,2,23,2,97,110,207,313
0131-002,2017,2,23,3,83,72,155,207
0131-002,2017,2,23,4,56,66,122,155
0131-002,2017,2,23,5,108,96,204,122
0131-002,2017,2,23,6,279,155,434,204
0131-002,2017,2,23,7,660,396,1056,434
0131-002,2017,2,23,8,1510,973,2483,1056
0131-002,2017,2,23,9,1420,1269,2689,2483
0131-002,2017,2,23,10,1054,1126,2180,2689
0131-002,2017,2,23,11,1119,1155,2274,2180
0131-002,2017,2,23,12,990,1080,2070,2274
0131-002,2017,2,23,13,946,956,1902,2070
0131-002,2017,2,23,14,1026,1043,2069,1902
0131-002,2017,2,23,15,1123,1115,2238,2069
0131-002,2017,2,23,16,988,1095,2083,2238
0131-002,2017,2,23,17,1009,1172,2181,2083
0131-002,2017,2,23,18,1084,1333,2417,2181
0131-002,2017,2,23,19,1023,1177,2200,2417
0131-002,2017,2,23,20,686,900,1586,2200
0131-002,2017,2,23,21,584,819,1403,1586
0131-002,2017,2,23,22,485,564,1049,1403
0131-002,2017,2,23,23,314,371,685,1049
0131-002,2017,2,23,24,195,265,460,685
0131-002,2017,2,24,1,172,182,354,460
0131-002,2017,2,24,2,119,132,251,354
0131-002,2017,2,24,3,70,61,131,251
0131-002,2017,2,24,4,82,94,176,131
0131-002,2017,2,24,5,110,112,222,176
0131-002,2017,2,24,6,306,174,480,222
0131-002,2017,2,24,7,721,436,1157,480
0131-002,2017,2,24,8,1538,1020,2558,1157
0131-002,2017,2,24,9,1446,1284,2730,2558
0131-002,2017,2,24,10,1056,1130,2186,2730
0131-002,2017,2,24,11,1037,1164,2201,2186
0131-002,2017,2,24,12,1037,1052,2089,2201
0131-002,2017,2,24,13,887,931,1818,2089
0131-002,2017,2,24,14,1024,1080,2104,1818
0131-002,2017,2,24,15,1121,1129,2250,2104
0131-002,2017,2,24,16,1030,1189,2219,2250
0131-002,2017,2,24,17,1077,1217,2294,2219
0131-002,2017,2,24,18,1127,1622,2749,2294
0131-002,2017,2,24,19,1209,1468,2677,2749
0131-002,2017,2,24,20,816,1020,1836,2677
0131-002,2017,2,24,21,631,930,1561,1836
0131-002,2017,2,24,22,502,564,1066,1561
0131-002,2017,2,24,23,339,383,722,1066
0131-002,2017,2,24,24,219,255,474,722
0131-002,2017,2,25,1,184,199,383,474
0131-002,2017,2,25,2,129,143,272,383
0131-002,2017,2,25,3,87,98,185,272
0131-002,2017,2,25,4,93,107,200,185
0131-002,2017,2,25,5,101,124,225,200
0131-002,2017,2,25,6,264,166,430,225
0131-002,2017,2,25,7,484,338,822,430
0131-002,2017,2,25,8,833,584,1417,822
0131-002,2017,2,25,9,876,875,1751,1417
0131-002,2017,2,25,10,848,971,1819,1751
0131-002,2017,2,25,11,867,983,1850,1819
0131-002,2017,2,25,12,946,978,1924,1850
0131-002,2017,2,25,13,1049,935,1984,1924
0131-002,2017,2,25,14,881,885,1766,1984
0131-002,2017,2,25,15,940,1008,1948,1766
0131-002,2017,2,25,16,954,1030,1984,1948
0131-002,2017,2,25,17,911,1102,2013,1984
0131-002,2017,2,25,18,1002,1413,2415,2013
0131-002,2017,2,25,19,1024,1027,2051,2415
0131-002,2017,2,25,20,698,619,1317,2051
0131-002,2017,2,25,21,469,512,981,1317
0131-002,2017,2,25,22,398,405,803,981
0131-002,2017,2,25,23,291,315,606,803
0131-002,2017,2,25,24,188,199,387,606
0131-002,2017,2,26,1,137,149,286,387
0131-002,2017,2,26,2,102,111,213,286
0131-002,2017,2,26,3,71,61,132,213
0131-002,2017,2,26,4,54,63,117,132
0131-002,2017,2,26,5,81,63,144,117
0131-002,2017,2,26,6,113,91,204,144
0131-002,2017,2,26,7,237,160,397,204
0131-002,2017,2,26,8,335,257,592,397
0131-002,2017,2,26,9,449,439,888,592
0131-002,2017,2,26,10,455,540,995,888
0131-002,2017,2,26,11,573,634,1207,995
0131-002,2017,2,26,12,623,582,1205,1207
0131-002,2017,2,26,13,656,634,1290,1205
0131-002,2017,2,26,14,702,648,1350,1290
0131-002,2017,2,26,15,734,809,1543,1350
0131-002,2017,2,26,16,762,815,1577,1543
0131-002,2017,2,26,17,757,829,1586,1577
0131-002,2017,2,26,18,792,967,1759,1586
0131-002,2017,2,26,19,734,676,1410,1759
0131-002,2017,2,26,20,652,481,1133,1410
0131-002,2017,2,26,21,676,458,1134,1133
0131-002,2017,2,26,22,514,376,890,1134
0131-002,2017,2,26,23,304,272,576,890
0131-002,2017,2,26,24,246,179,425,576
0131-002,2017,2,27,1,146,92,238,425
0131-002,2017,2,27,2,84,65,149,238
0131-002,2017,2,27,3,67,45,112,149
0131-002,2017,2,27,4,76,63,139,112
0131-002,2017,2,27,5,129,98,227,139
0131-002,2017,2,27,6,334,197,531,227
0131-002,2017,2,27,7,864,466,1330,531
0131-002,2017,2,27,8,1706,1029,2735,1330
0131-002,2017,2,27,9,1545,1233,2778,2735
0131-002,2017,2,27,10,1091,1160,2251,2778
0131-002,2017,2,27,11,1080,1109,2189,2251
0131-002,2017,2,27,12,1085,1091,2176,2189
0131-002,2017,2,27,13,913,907,1820,2176
0131-002,2017,2,27,14,1071,1074,2145,1820
0131-002,2017,2,27,15,1111,1176,2287,2145
0131-002,2017,2,27,16,1075,1228,2303,2287
0131-002,2017,2,27,17,1096,1184,2280,2303
0131-002,2017,2,27,18,1104,1467,2571,2280
0131-002,2017,2,27,19,1006,1206,2212,2571
0131-002,2017,2,27,20,728,932,1660,2212
0131-002,2017,2,27,21,613,846,1459,1660
0131-002,2017,2,27,22,492,620,1112,1459
0131-002,2017,2,27,23,316,394,710,1112
0131-002,2017,2,27,24,208,246,454,710
0131-002,2017,2,28,1,165,173,338,454
0131-002,2017,2,28,2,110,108,218,338
0131-002,2017,2,28,3,80,71,151,218
0131-002,2017,2,28,4,92,90,182,151
0131-002,2017,2,28,5,154,119,273,182
0131-002,2017,2,28,6,318,142,460,273
0131-002,2017,2,28,7,732,421,1153,460
0131-002,2017,2,28,8,1594,1010,2604,1153
0131-002,2017,2,28,9,1453,1307,2760,2604
0131-002,2017,2,28,10,1198,1120,2318,2760
0131-002,2017,2,28,11,1078,1154,2232,2318
0131-002,2017,2,28,12,1086,1078,2164,2232
0131-002,2017,2,28,13,951,945,1896,2164
0131-002,2017,2,28,14,1067,1047,2114,1896
0131-002,2017,2,28,15,1120,1131,2251,2114
0131-002,2017,2,28,16,1108,1232,2340,2251
0131-002,2017,2,28,17,1077,1217,2294,2340
0131-002,2017,2,28,18,1128,1583,2711,2294
0131-002,2017,2,28,19,1132,1429,2561,2711
0131-002,2017,2,28,20,830,1058,1888,2561
0131-002,2017,2,28,21,677,1038,1715,1888
0131-002,2017,2,28,22,563,690,1253,1715
0131-002,2017,2,28,23,348,407,755,1253
0131-002,2017,2,28,24,212,263,475,755
0131-002,2017,3,1,1,160,202,362,475
0131-002,2017,3,1,2,120,137,257,362
0131-002,2017,3,1,3,86,97,183,257
0131-002,2017,3,1,4,92,91,183,183
0131-002,2017,3,1,5,128,110,238,183
0131-002,2017,3,1,6,272,139,411,238
0131-002,2017,3,1,7,541,326,867,411
0131-002,2017,3,1,8,908,604,1512,867
0131-002,2017,3,1,9,920,788,1708,1512
0131-002,2017,3,1,10,756,786,1542,1708
0131-002,2017,3,1,11,844,897,1741,1542
0131-002,2017,3,1,12,808,884,1692,1741
0131-002,2017,3,1,13,773,861,1634,1692
0131-002,2017,3,1,14,851,874,1725,1634
0131-002,2017,3,1,15,891,927,1818,1725
0131-002,2017,3,1,16,837,926,1763,1818
0131-002,2017,3,1,17,907,1054,1961,1763
0131-002,2017,3,1,18,964,1182,2146,1961
0131-002,2017,3,1,19,905,860,1765,2146
0131-002,2017,3,1,20,643,607,1250,1765
0131-002,2017,3,1,21,447,485,932,1250
0131-002,2017,3,1,22,244,322,566,932
0131-002,2017,3,1,23,215,252,467,566
0131-002,2017,3,1,24,169,159,328,467
0131-002,2017,3,2,1,136,136,272,328
0131-002,2017,3,2,2,90,68,158,272
0131-002,2017,3,2,3,49,65,114,158
0131-002,2017,3,2,4,56,57,113,114
0131-002,2017,3,2,5,82,89,171,113
0131-002,2017,3,2,6,282,155,437,171
0131-002,2017,3,2,7,690,434,1124,437
0131-002,2017,3,2,8,1486,1049,2535,1124
0131-002,2017,3,2,9,1469,1283,2752,2535
0131-002,2017,3,2,10,998,1062,2060,2752
0131-002,2017,3,2,11,1056,1046,2102,2060
0131-002,2017,3,2,12,983,1060,2043,2102
0131-002,2017,3,2,13,870,893,1763,2043
0131-002,2017,3,2,14,968,974,1942,1763
0131-002,2017,3,2,15,1039,1132,2171,1942
0131-002,2017,3,2,16,1029,1021,2050,2171
0131-002,2017,3,2,17,984,1119,2103,2050
0131-002,2017,3,2,18,1046,1333,2379,2103
0131-002,2017,3,2,19,983,1238,2221,2379
0131-002,2017,3,2,20,741,922,1663,2221
0131-002,2017,3,2,21,614,870,1484,1663
0131-002,2017,3,2,22,482,591,1073,1484
0131-002,2017,3,2,23,322,323,645,1073
0131-002,2017,3,2,24,196,243,439,645
0131-002,2017,3,3,1,200,184,384,439
0131-002,2017,3,3,2,111,122,233,384
0131-002,2017,3,3,3,84,67,151,233
0131-002,2017,3,3,4,73,81,154,151
0131-002,2017,3,3,5,113,116,229,154
0131-002,2017,3,3,6,299,175,474,229
0131-002,2017,3,3,7,753,395,1148,474
0131-002,2017,3,3,8,1567,994,2561,1148
0131-002,2017,3,3,9,1475,1303,2778,2561
0131-002,2017,3,3,10,1130,1151,2281,2778
0131-002,2017,3,3,11,1074,1059,2133,2281
0131-002,2017,3,3,12,1047,1065,2112,2133
0131-002,2017,3,3,13,871,897,1768,2112
0131-002,2017,3,3,14,1022,980,2002,1768
0131-002,2017,3,3,15,1058,1136,2194,2002
0131-002,2017,3,3,16,1017,1123,2140,2194
0131-002,2017,3,3,17,1047,1210,2257,2140
0131-002,2017,3,3,18,1146,1538,2684,2257
0131-002,2017,3,3,19,1190,1533,2723,2684
0131-002,2017,3,3,20,868,1055,1923,2723
0131-002,2017,3,3,21,624,886,1510,1923
0131-002,2017,3,3,22,474,595,1069,1510
0131-002,2017,3,3,23,333,411,744,1069
0131-002,2017,3,3,24,225,280,505,744
0131-002,2017,3,4,1,176,189,365,505
0131-002,2017,3,4,2,110,124,234,365
0131-002,2017,3,4,3,109,103,212,234
0131-002,2017,3,4,4,95,88,183,212
0131-002,2017,3,4,5,137,145,282,183
0131-002,2017,3,4,6,265,142,407,282
0131-002,2017,3,4,7,499,330,829,407
0131-002,2017,3,4,8,883,650,1533,829
0131-002,2017,3,4,9,985,986,1971,1533
0131-002,2017,3,4,10,899,887,1786,1971
0131-002,2017,3,4,11,879,983,1862,1786
0131-002,2017,3,4,12,926,978,1904,1862
0131-002,2017,3,4,13,928,854,1782,1904
0131-002,2017,3,4,14,866,822,1688,1782
0131-002,2017,3,4,15,902,955,1857,1688
0131-002,2017,3,4,16,867,1051,1918,1857
0131-002,2017,3,4,17,852,1105,1957,1918
0131-002,2017,3,4,18,955,1342,2297,1957
0131-002,2017,3,4,19,864,1058,1922,2297
0131-002,2017,3,4,20,566,640,1206,1922
0131-002,2017,3,4,21,463,468,931,1206
0131-002,2017,3,4,22,420,384,804,931
0131-002,2017,3,4,23,293,244,537,804
0131-002,2017,3,4,24,189,226,415,537
0131-002,2017,3,5,1,139,156,295,415
0131-002,2017,3,5,2,90,112,202,295
0131-002,2017,3,5,3,74,71,145,202
0131-002,2017,3,5,4,61,64,125,145
0131-002,2017,3,5,5,56,61,117,125
0131-002,2017,3,5,6,122,75,197,117
0131-002,2017,3,5,7,262,166,428,197
0131-002,2017,3,5,8,336,295,631,428
0131-002,2017,3,5,9,437,534,971,631
0131-002,2017,3,5,10,494,560,1054,971
0131-002,2017,3,5,11,576,660,1236,1054
0131-002,2017,3,5,12,599,691,1290,1236
0131-002,2017,3,5,13,641,666,1307,1290
0131-002,2017,3,5,14,754,627,1381,1307
0131-002,2017,3,5,15,768,719,1487,1381
0131-002,2017,3,5,16,784,826,1610,1487
0131-002,2017,3,5,17,814,912,1726,1610
0131-002,2017,3,5,18,847,984,1831,1726
0131-002,2017,3,5,19,783,746,1529,1831
0131-002,2017,3,5,20,604,508,1112,1529
0131-002,2017,3,5,21,501,447,948,1112
0131-002,2017,3,5,22,440,373,813,948
0131-002,2017,3,5,23,301,206,507,813
0131-002,2017,3,5,24,185,152,337,507
0131-002,2017,3,6,1,119,85,204,337
0131-002,2017,3,6,2,91,66,157,204
0131-002,2017,3,6,3,78,51,129,157
0131-002,2017,3,6,4,77,70,147,129
0131-002,2017,3,6,5,137,89,226,147
0131-002,2017,3,6,6,332,175,507,226
0131-002,2017,3,6,7,883,497,1380,507
0131-002,2017,3,6,8,1777,1120,2897,1380
0131-002,2017,3,6,9,1510,1315,2825,2897
0131-002,2017,3,6,10,1099,1021,2120,2825
0131-002,2017,3,6,11,1166,1025,2191,2120
0131-002,2017,3,6,12,1158,1036,2194,2191
0131-002,2017,3,6,13,991,898,1889,2194
0131-002,2017,3,6,14,1006,975,1981,1889
0131-002,2017,3,6,15,1132,1097,2229,1981
0131-002,2017,3,6,16,1016,1108,2124,2229
0131-002,2017,3,6,17,1055,1101,2156,2124
0131-002,2017,3,6,18,1095,1376,2471,2156
0131-002,2017,3,6,19,1057,1225,2282,2471
0131-002,2017,3,6,20,752,884,1636,2282
0131-002,2017,3,6,21,624,850,1474,1636
0131-002,2017,3,6,22,478,610,1088,1474
0131-002,2017,3,6,23,315,367,682,1088
0131-002,2017,3,6,24,197,199,396,682
0131-002,2017,3,7,1,151,144,295,396
0131-002,2017,3,7,2,91,95,186,295
0131-002,2017,3,7,3,71,70,141,186
0131-002,2017,3,7,4,69,72,141,141
0131-002,2017,3,7,5,111,100,211,141
0131-002,2017,3,7,6,303,174,477,211
0131-002,2017,3,7,7,685,455,1140,477
0131-002,2017,3,7,8,1493,1064,2557,1140
0131-002,2017,3,7,9,1517,1318,2835,2557
0131-002,2017,3,7,10,1149,1153,2302,2835
0131-002,2017,3,7,11,1146,1110,2256,2302
0131-002,2017,3,7,12,1150,1115,2265,2256
0131-002,2017,3,7,13,981,876,1857,2265
0131-002,2017,3,7,14,1035,957,1992,1857
0131-002,2017,3,7,15,1223,1148,2371,1992
0131-002,2017,3,7,16,1160,1078,2238,2371
0131-002,2017,3,7,17,1123,1125,2248,2238
0131-002,2017,3,7,18,1131,1327,2458,2248
0131-002,2017,3,7,19,980,1208,2188,2458
0131-002,2017,3,7,20,733,954,1687,2188
0131-002,2017,3,7,21,593,851,1444,1687
0131-002,2017,3,7,22,527,609,1136,1444
0131-002,2017,3,7,23,320,386,706,1136
0131-002,2017,3,7,24,196,219,415,706
0131-002,2017,3,8,1,145,147,292,415
0131-002,2017,3,8,2,93,117,210,292
0131-002,2017,3,8,3,80,69,149,210
0131-002,2017,3,8,4,88,79,167,149
0131-002,2017,3,8,5,104,106,210,167
0131-002,2017,3,8,6,302,168,470,210
0131-002,2017,3,8,7,726,463,1189,470
0131-002,2017,3,8,8,1476,1079,2555,1189
0131-002,2017,3,8,9,1484,1336,2820,2555
0131-002,2017,3,8,10,1121,1136,2257,2820
0131-002,2017,3,8,11,1030,1103,2133,2257
0131-002,2017,3,8,12,1085,1004,2089,2133
0131-002,2017,3,8,13,951,933,1884,2089
0131-002,2017,3,8,14,1111,950,2061,1884
0131-002,2017,3,8,15,1235,1078,2313,2061
0131-002,2017,3,8,16,1178,1115,2293,2313
0131-002,2017,3,8,17,1125,1156,2281,2293
0131-002,2017,3,8,18,1112,1499,2611,2281
0131-002,2017,3,8,19,1052,1228,2280,2611
0131-002,2017,3,8,20,718,875,1593,2280
0131-002,2017,3,8,21,606,776,1382,1593
0131-002,2017,3,8,22,491,562,1053,1382
0131-002,2017,3,8,23,306,344,650,1053
0131-002,2017,3,8,24,204,216,420,650
0131-002,2017,3,9,1,170,147,317,420
0131-002,2017,3,9,2,116,123,239,317
0131-002,2017,3,9,3,75,84,159,239
0131-002,2017,3,9,4,105,88,193,159
0131-002,2017,3,9,5,140,115,255,193
0131-002,2017,3,9,6,327,173,500,255
0131-002,2017,3,9,7,726,424,1150,500
0131-002,2017,3,9,8,1573,1092,2665,1150
0131-002,2017,3,9,9,1458,1401,2859,2665
0131-002,2017,3,9,10,1140,1119,2259,2859
0131-002,2017,3,9,11,1138,1095,2233,2259
0131-002,2017,3,9,12,1041,1024,2065,2233
0131-002,2017,3,9,13,940,945,1885,2065
0131-002,2017,3,9,14,999,954,1953,1885
0131-002,2017,3,9,15,1053,1063,2116,1953
0131-002,2017,3,9,16,1069,1164,2233,2116
0131-002,2017,3,9,17,1097,1160,2257,2233
0131-002,2017,3,9,18,1129,1398,2527,2257
0131-002,2017,3,9,19,1036,1271,2307,2527
0131-002,2017,3,9,20,823,871,1694,2307
0131-002,2017,3,9,21,602,826,1428,1694
0131-002,2017,3,9,22,526,586,1112,1428
0131-002,2017,3,9,23,331,378,709,1112
0131-002,2017,3,9,24,224,236,460,709
0131-002,2017,3,10,1,166,189,355,460
0131-002,2017,3,10,2,125,111,236,355
0131-002,2017,3,10,3,77,66,143,236
0131-002,2017,3,10,4,99,92,191,143
0131-002,2017,3,10,5,115,120,235,191
0131-002,2017,3,10,6,337,183,520,235
0131-002,2017,3,10,7,721,461,1182,520
0131-002,2017,3,10,8,1575,1080,2655,1182
0131-002,2017,3,10,9,1436,1374,2810,2655
0131-002,2017,3,10,10,1100,1190,2290,2810
0131-002,2017,3,10,11,1137,1115,2252,2290
0131-002,2017,3,10,12,988,993,1981,2252
0131-002,2017,3,10,13,921,916,1837,1981
0131-002,2017,3,10,14,988,980,1968,1837
0131-002,2017,3,10,15,1108,1144,2252,1968
0131-002,2017,3,10,16,1060,1245,2305,2252
0131-002,2017,3,10,17,1107,1226,2333,2305
0131-002,2017,3,10,18,1149,1562,2711,2333
0131-002,2017,3,10,19,1216,1520,2736,2711
0131-002,2017,3,10,20,855,1106,1961,2736
0131-002,2017,3,10,21,579,953,1532,1961
0131-002,2017,3,10,22,565,584,1149,1532
0131-002,2017,3,10,23,363,413,776,1149
0131-002,2017,3,10,24,239,260,499,776
0131-002,2017,3,11,1,190,212,402,499
0131-002,2017,3,11,2,173,160,333,402
0131-002,2017,3,11,3,109,94,203,333
0131-002,2017,3,11,4,104,91,195,203
0131-002,2017,3,11,5,125,114,239,195
0131-002,2017,3,11,6,280,185,465,239
0131-002,2017,3,11,7,526,349,875,465
0131-002,2017,3,11,8,880,662,1542,875
0131-002,2017,3,11,9,944,988,1932,1542
0131-002,2017,3,11,10,850,905,1755,1932
0131-002,2017,3,11,11,928,973,1901,1755
0131-002,2017,3,11,12,893,937,1830,1901
0131-002,2017,3,11,13,869,832,1701,1830
0131-002,2017,3,11,14,914,893,1807,1701
0131-002,2017,3,11,15,836,971,1807,1807
0131-002,2017,3,11,16,901,1012,1913,1807
0131-002,2017,3,11,17,1048,1127,2175,1913
0131-002,2017,3,11,18,1027,1394,2421,2175
0131-002,2017,3,11,19,978,1119,2097,2421
0131-002,2017,3,11,20,690,683,1373,2097
0131-002,2017,3,11,21,500,542,1042,1373
0131-002,2017,3,11,22,372,400,772,1042
0131-002,2017,3,11,23,339,281,620,772
0131-002,2017,3,11,24,197,224,421,620
0131-002,2017,3,12,1,140,161,301,421
0131-002,2017,3,12,2,102,115,217,301
0131-002,2017,3,12,3,85,74,159,217
0131-002,2017,3,12,4,70,97,167,159
0131-002,2017,3,12,5,74,64,138,167
0131-002,2017,3,12,6,123,113,236,138
0131-002,2017,3,12,7,275,190,465,236
0131-002,2017,3,12,8,355,326,681,465
0131-002,2017,3,12,9,459,457,916,681
0131-002,2017,3,12,10,463,578,1041,916
0131-002,2017,3,12,11,561,626,1187,1041
0131-002,2017,3,12,12,701,688,1389,1187
0131-002,2017,3,12,13,688,656,1344,1389
0131-002,2017,3,12,14,731,695,1426,1344
0131-002,2017,3,12,15,782,800,1582,1426
0131-002,2017,3,12,16,826,959,1785,1582
0131-002,2017,3,12,17,976,896,1872,1785
0131-002,2017,3,12,18,975,940,1915,1872
0131-002,2017,3,12,19,875,751,1626,1915
0131-002,2017,3,12,20,607,535,1142,1626
0131-002,2017,3,12,21,583,476,1059,1142
0131-002,2017,3,12,22,407,360,767,1059
0131-002,2017,3,12,23,280,256,536,767
0131-002,2017,3,12,24,208,156,364,536
0131-002,2017,3,13,1,143,95,238,364
0131-002,2017,3,13,2,67,72,139,238
0131-002,2017,3,13,3,67,57,124,139
0131-002,2017,3,13,4,62,71,133,124
0131-002,2017,3,13,5,126,98,224,133
0131-002,2017,3,13,6,374,202,576,224
0131-002,2017,3,13,7,859,475,1334,576
0131-002,2017,3,13,8,1767,1180,2947,1334
0131-002,2017,3,13,9,1484,1292,2776,2947
0131-002,2017,3,13,10,1077,1050,2127,2776
0131-002,2017,3,13,11,1026,1136,2162,2127
0131-002,2017,3,13,12,1045,1023,2068,2162
0131-002,2017,3,13,13,882,932,1814,2068
0131-002,2017,3,13,14,984,1005,1989,1814
0131-002,2017,3,13,15,1062,1126,2188,1989
0131-002,2017,3,13,16,1069,1107,2176,2188
0131-002,2017,3,13,17,1068,1219,2287,2176
0131-002,2017,3,13,18,1161,1448,2609,2287
0131-002,2017,3,13,19,1049,1316,2365,2609
0131-002,2017,3,13,20,758,1001,1759,2365
0131-002,2017,3,13,21,607,858,1465,1759
0131-002,2017,3,13,22,514,568,1082,1465
0131-002,2017,3,13,23,315,324,639,1082
0131-002,2017,3,13,24,213,198,411,639
0131-002,2017,3,14,1,156,148,304,411
0131-002,2017,3,14,2,125,109,234,304
0131-002,2017,3,14,3,77,79,156,234
0131-002,2017,3,14,4,103,89,192,156
0131-002,2017,3,14,5,162,123,285,192
0131-002,2017,3,14,6,364,185,549,285
0131-002,2017,3,14,7,771,482,1253,549
0131-002,2017,3,14,8,1627,1125,2752,1253
0131-002,2017,3,14,9,1466,1400,2866,2752
0131-002,2017,3,14,10,1247,1193,2440,2866
0131-002,2017,3,14,11,1098,1161,2259,2440
0131-002,2017,3,14,12,992,1096,2088,2259
0131-002,2017,3,14,13,935,971,1906,2088
0131-002,2017,3,14,14,1057,1005,2062,1906
0131-002,2017,3,14,15,1129,1204,2333,2062
0131-002,2017,3,14,16,1108,1139,2247,2333
0131-002,2017,3,14,17,1057,1194,2251,2247
0131-002,2017,3,14,18,1096,1468,2564,2251
0131-002,2017,3,14,19,1075,1263,2338,2564
0131-002,2017,3,14,20,771,1003,1774,2338
0131-002,2017,3,14,21,622,870,1492,1774
0131-002,2017,3,14,22,545,642,1187,1492
0131-002,2017,3,14,23,369,382,751,1187
0131-002,2017,3,14,24,211,221,432,751
0131-002,2017,3,15,1,165,171,336,432
0131-002,2017,3,15,2,107,111,218,336
0131-002,2017,3,15,3,68,81,149,218
0131-002,2017,3,15,4,85,73,158,149
0131-002,2017,3,15,5,145,136,281,158
0131-002,2017,3,15,6,307,167,474,281
0131-002,2017,3,15,7,780,490,1270,474
0131-002,2017,3,15,8,1670,1053,2723,1270
0131-002,2017,3,15,9,1391,1381,2772,2723
0131-002,2017,3,15,10,1145,1144,2289,2772
0131-002,2017,3,15,11,1132,1163,2295,2289
0131-002,2017,3,15,12,1032,1063,2095,2295
0131-002,2017,3,15,13,963,925,1888,2095
0131-002,2017,3,15,14,1044,1025,2069,1888
0131-002,2017,3,15,15,1096,1110,2206,2069
0131-002,2017,3,15,16,1117,1102,2219,2206
0131-002,2017,3,15,17,1037,1199,2236,2219
0131-002,2017,3,15,18,1111,1585,2696,2236
0131-002,2017,3,15,19,1090,1377,2467,2696
0131-002,2017,3,15,20,785,1014,1799,2467
0131-002,2017,3,15,21,642,745,1387,1799
0131-002,2017,3,15,22,523,618,1141,1387
0131-002,2017,3,15,23,321,367,688,1141
0131-002,2017,3,15,24,234,265,499,688
0131-002,2017,3,16,1,173,167,340,499
0131-002,2017,3,16,2,98,119,217,340
0131-002,2017,3,16,3,86,70,156,217
0131-002,2017,3,16,4,92,78,170,156
0131-002,2017,3,16,5,123,124,247,170
0131-002,2017,3,16,6,359,178,537,247
0131-002,2017,3,16,7,780,465,1245,537
0131-002,2017,3,16,8,1618,1094,2712,1245
0131-002,2017,3,16,9,1460,1426,2886,2712
0131-002,2017,3,16,10,1127,1157,2284,2886
0131-002,2017,3,16,11,1055,1087,2142,2284
0131-002,2017,3,16,12,1106,1028,2134,2142
0131-002,2017,3,16,13,936,855,1791,2134
0131-002,2017,3,16,14,983,920,1903,1791
0131-002,2017,3,16,15,1128,1104,2232,1903
0131-002,2017,3,16,16,1087,1045,2132,2232
0131-002,2017,3,16,17,1045,1115,2160,2132
0131-002,2017,3,16,18,1113,1425,2538,2160
0131-002,2017,3,16,19,1056,1354,2410,2538
0131-002,2017,3,16,20,793,983,1776,2410
0131-002,2017,3,16,21,642,856,1498,1776
0131-002,2017,3,16,22,518,623,1141,1498
0131-002,2017,3,16,23,367,335,702,1141
0131-002,2017,3,16,24,223,253,476,702
0131-002,2017,3,17,1,196,171,367,476
0131-002,2017,3,17,2,98,111,209,367
0131-002,2017,3,17,3,76,90,166,209
0131-002,2017,3,17,4,77,74,151,166
0131-002,2017,3,17,5,142,119,261,151
0131-002,2017,3,17,6,336,181,517,261
0131-002,2017,3,17,7,768,491,1259,517
0131-002,2017,3,17,8,1589,1054,2643,1259
0131-002,2017,3,17,9,1487,1411,2898,2643
0131-002,2017,3,17,10,1151,1166,2317,2898
0131-002,2017,3,17,11,1097,1184,2281,2317
0131-002,2017,3,17,12,1003,1072,2075,2281
0131-002,2017,3,17,13,965,933,1898,2075
0131-002,2017,3,17,14,967,1055,2022,1898
0131-002,2017,3,17,15,1093,1065,2158,2022
0131-002,2017,3,17,16,1101,986,2087,2158
0131-002,2017,3,17,17,1105,1255,2360,2087
0131-002,2017,3,17,18,1167,1624,2791,2360
0131-002,2017,3,17,19,1155,1508,2663,2791
0131-002,2017,3,17,20,927,1193,2120,2663
0131-002,2017,3,17,21,579,934,1513,2120
0131-002,2017,3,17,22,555,611,1166,1513
0131-002,2017,3,17,23,364,392,756,1166
0131-002,2017,3,17,24,248,256,504,756
0131-002,2017,3,18,1,185,188,373,504
0131-002,2017,3,18,2,169,146,315,373
0131-002,2017,3,18,3,82,113,195,315
0131-002,2017,3,18,4,99,99,198,195
0131-002,2017,3,18,5,124,123,247,198
0131-002,2017,3,18,6,306,168,474,247
0131-002,2017,3,18,7,551,394,945,474
0131-002,2017,3,18,8,929,668,1597,945
0131-002,2017,3,18,9,974,1043,2017,1597
0131-002,2017,3,18,10,916,981,1897,2017
0131-002,2017,3,18,11,999,1028,2027,1897
0131-002,2017,3,18,12,976,815,1791,2027
0131-002,2017,3,18,13,880,832,1712,1791
0131-002,2017,3,18,14,920,911,1831,1712
0131-002,2017,3,18,15,905,981,1886,1831
0131-002,2017,3,18,16,892,1094,1986,1886
0131-002,2017,3,18,17,1014,1149,2163,1986
0131-002,2017,3,18,18,1116,1439,2555,2163
0131-002,2017,3,18,19,956,1100,2056,2555
0131-002,2017,3,18,20,705,746,1451,2056
0131-002,2017,3,18,21,509,559,1068,1451
0131-002,2017,3,18,22,411,398,809,1068
0131-002,2017,3,18,23,291,307,598,809
0131-002,2017,3,18,24,210,205,415,598
0131-002,2017,3,19,1,129,166,295,415
0131-002,2017,3,19,2,101,92,193,295
0131-002,2017,3,19,3,72,88,160,193
0131-002,2017,3,19,4,52,73,125,160
0131-002,2017,3,19,5,82,70,152,125
0131-002,2017,3,19,6,127,108,235,152
0131-002,2017,3,19,7,276,176,452,235
0131-002,2017,3,19,8,413,343,756,452
0131-002,2017,3,19,9,493,550,1043,756
0131-002,2017,3,19,10,514,621,1135,1043
0131-002,2017,3,19,11,647,600,1247,1135
0131-002,2017,3,19,12,687,665,1352,1247
0131-002,2017,3,19,13,704,597,1301,1352
0131-002,2017,3,19,14,724,672,1396,1301
0131-002,2017,3,19,15,727,829,1556,1396
0131-002,2017,3,19,16,812,810,1622,1556
0131-002,2017,3,19,17,842,896,1738,1622
0131-002,2017,3,19,18,849,852,1701,1738
0131-002,2017,3,19,19,872,815,1687,1701
0131-002,2017,3,19,20,622,618,1240,1687
0131-002,2017,3,19,21,560,506,1066,1240
0131-002,2017,3,19,22,498,394,892,1066
0131-002,2017,3,19,23,353,250,603,892
0131-002,2017,3,19,24,221,142,363,603
0131-002,2017,3,20,1,169,105,274,363
0131-002,2017,3,20,2,81,80,161,274
0131-002,2017,3,20,3,67,50,117,161
0131-002,2017,3,20,4,76,56,132,117
0131-002,2017,3,20,5,139,103,242,132
0131-002,2017,3,20,6,360,196,556,242
0131-002,2017,3,20,7,898,544,1442,556
0131-002,2017,3,20,8,1774,1202,2976,1442
0131-002,2017,3,20,9,1576,1384,2960,2976
0131-002,2017,3,20,10,1132,1103,2235,2960
0131-002,2017,3,20,11,1121,1133,2254,2235
0131-002,2017,3,20,12,1124,1110,2234,2254
0131-002,2017,3,20,13,935,916,1851,2234
0131-002,2017,3,20,14,1081,1002,2083,1851
0131-002,2017,3,20,15,1073,1077,2150,2083
0131-002,2017,3,20,16,1052,1100,2152,2150
0131-002,2017,3,20,17,989,1128,2117,2152
0131-002,2017,3,20,18,1118,1425,2543,2117
0131-002,2017,3,20,19,1013,1262,2275,2543
0131-002,2017,3,20,20,754,949,1703,2275
0131-002,2017,3,20,21,618,881,1499,1703
0131-002,2017,3,20,22,516,608,1124,1499
0131-002,2017,3,20,23,333,364,697,1124
0131-002,2017,3,20,24,206,215,421,697
0131-002,2017,3,21,1,150,141,291,421
0131-002,2017,3,21,2,106,100,206,291
0131-002,2017,3,21,3,88,65,153,206
0131-002,2017,3,21,4,89,74,163,153
0131-002,2017,3,21,5,132,120,252,163
0131-002,2017,3,21,6,357,211,568,252
0131-002,2017,3,21,7,787,480,1267,568
0131-002,2017,3,21,8,1640,1141,2781,1267
0131-002,2017,3,21,9,1401,1435,2836,2781
0131-002,2017,3,21,10,1172,1147,2319,2836
0131-002,2017,3,21,11,1036,926,1962,2319
0131-002,2017,3,21,12,1039,814,1853,1962
0131-002,2017,3,21,13,945,814,1759,1853
0131-002,2017,3,21,14,1031,971,2002,1759
0131-002,2017,3,21,15,1090,1079,2169,2002
0131-002,2017,3,21,16,1054,989,2043,2169
0131-002,2017,3,21,17,1087,1055,2142,2043
0131-002,2017,3,21,18,1146,1419,2565,2142
0131-002,2017,3,21,19,1038,1283,2321,2565
0131-002,2017,3,21,20,733,1012,1745,2321
0131-002,2017,3,21,21,609,878,1487,1745
0131-002,2017,3,21,22,532,594,1126,1487
0131-002,2017,3,21,23,332,366,698,1126
0131-002,2017,3,21,24,206,230,436,698
0131-002,2017,3,22,1,163,176,339,436
0131-002,2017,3,22,2,122,93,215,339
0131-002,2017,3,22,3,80,79,159,215
0131-002,2017,3,22,4,95,96,191,159
0131-002,2017,3,22,5,140,126,266,191
0131-002,2017,3,22,6,354,185,539,266
0131-002,2017,3,22,7,820,473,1293,539
0131-002,2017,3,22,8,1665,1122,2787,1293
0131-002,2017,3,22,9,1456,1455,2911,2787
0131-002,2017,3,22,10,1178,1144,2322,2911
0131-002,2017,3,22,11,1094,970,2064,2322
0131-002,2017,3,22,12,1030,936,1966,2064
0131-002,2017,3,22,13,885,825,1710,1966
0131-002,2017,3,22,14,1011,1051,2062,1710
0131-002,2017,3,22,15,1013,1097,2110,2062
0131-002,2017,3,22,16,1063,1077,2140,2110
0131-002,2017,3,22,17,1069,1100,2169,2140
0131-002,2017,3,22,18,1180,1544,2724,2169
0131-002,2017,3,22,19,1067,1419,2486,2724
0131-002,2017,3,22,20,750,959,1709,2486
0131-002,2017,3,22,21,563,795,1358,1709
0131-002,2017,3,22,22,477,558,1035,1358
0131-002,2017,3,22,23,359,365,724,1035
0131-002,2017,3,22,24,213,230,443,724
0131-002,2017,3,23,1,167,151,318,443
0131-002,2017,3,23,2,118,130,248,318
0131-002,2017,3,23,3,108,89,197,248
0131-002,2017,3,23,4,88,85,173,197
0131-002,2017,3,23,5,141,125,266,173
0131-002,2017,3,23,6,342,173,515,266
0131-002,2017,3,23,7,795,473,1268,515
0131-002,2017,3,23,8,1602,1071,2673,1268
0131-002,2017,3,23,9,1436,1342,2778,2673
0131-002,2017,3,23,10,1122,1072,2194,2778
0131-002,2017,3,23,11,1115,993,2108,2194
0131-002,2017,3,23,12,1026,1030,2056,2108
0131-002,2017,3,23,13,852,713,1565,2056
0131-002,2017,3,23,14,999,967,1966,1565
0131-002,2017,3,23,15,1087,1119,2206,1966
0131-002,2017,3,23,16,1055,1058,2113,2206
0131-002,2017,3,23,17,1016,1042,2058,2113
0131-002,2017,3,23,18,1179,1458,2637,2058
0131-002,2017,3,23,19,1075,1301,2376,2637
0131-002,2017,3,23,20,786,937,1723,2376
0131-002,2017,3,23,21,625,833,1458,1723
0131-002,2017,3,23,22,535,562,1097,1458
0131-002,2017,3,23,23,375,351,726,1097
0131-002,2017,3,23,24,230,228,458,726
0131-002,2017,3,24,1,183,174,357,458
0131-002,2017,3,24,2,121,106,227,357
0131-002,2017,3,24,3,84,101,185,227
0131-002,2017,3,24,4,106,79,185,185
0131-002,2017,3,24,5,153,116,269,185
0131-002,2017,3,24,6,345,185,530,269
0131-002,2017,3,24,7,748,443,1191,530
0131-002,2017,3,24,8,1632,1006,2638,1191
0131-002,2017,3,24,9,1457,1256,2713,2638
0131-002,2017,3,24,10,1130,1077,2207,2713
0131-002,2017,3,24,11,1155,932,2087,2207
0131-002,2017,3,24,12,1107,833,1940,2087
0131-002,2017,3,24,13,912,821,1733,1940
0131-002,2017,3,24,14,976,1080,2056,1733
0131-002,2017,3,24,15,988,1129,2117,2056
0131-002,2017,3,24,16,1015,1085,2100,2117
0131-002,2017,3,24,17,1022,1120,2142,2100
0131-002,2017,3,24,18,1194,1566,2760,2142
0131-002,2017,3,24,19,1229,1565,2794,2760
0131-002,2017,3,24,20,878,979,1857,2794
0131-002,2017,3,24,21,653,800,1453,1857
0131-002,2017,3,24,22,540,515,1055,1453
0131-002,2017,3,24,23,365,320,685,1055
0131-002,2017,3,24,24,229,197,426,685
0131-002,2017,3,25,1,199,149,348,426
0131-002,2017,3,25,2,153,143,296,348
0131-002,2017,3,25,3,96,92,188,296
0131-002,2017,3,25,4,114,87,201,188
0131-002,2017,3,25,5,129,118,247,201
0131-002,2017,3,25,6,278,179,457,247
0131-002,2017,3,25,7,557,352,909,457
0131-002,2017,3,25,8,871,578,1449,909
0131-002,2017,3,25,9,961,946,1907,1449
0131-002,2017,3,25,10,893,944,1837,1907
0131-002,2017,3,25,11,915,967,1882,1837
0131-002,2017,3,25,12,992,866,1858,1882
0131-002,2017,3,25,13,875,844,1719,1858
0131-002,2017,3,25,14,884,886,1770,1719
0131-002,2017,3,25,15,863,928,1791,1770
0131-002,2017,3,25,16,896,936,1832,1791
0131-002,2017,3,25,17,837,1093,1930,1832
0131-002,2017,3,25,18,1025,1380,2405,1930
0131-002,2017,3,25,19,915,884,1799,2405
0131-002,2017,3,25,20,605,588,1193,1799
0131-002,2017,3,25,21,474,476,950,1193
0131-002,2017,3,25,22,411,319,730,950
0131-002,2017,3,25,23,339,252,591,730
0131-002,2017,3,25,24,195,182,377,591
0131-002,2017,3,26,1,164,131,295,377
0131-002,2017,3,26,2,105,119,224,295
0131-002,2017,3,26,3,81,70,151,224
0131-002,2017,3,26,4,66,61,127,151
0131-002,2017,3,26,5,74,89,163,127
0131-002,2017,3,26,6,159,80,239,163
0131-002,2017,3,26,7,280,188,468,239
0131-002,2017,3,26,8,444,349,793,468
0131-002,2017,3,26,9,542,431,973,793
0131-002,2017,3,26,10,508,451,959,973
0131-002,2017,3,26,11,616,648,1264,959
0131-002,2017,3,26,12,666,646,1312,1264
0131-002,2017,3,26,13,661,643,1304,1312
0131-002,2017,3,26,14,716,760,1476,1304
0131-002,2017,3,26,15,705,845,1550,1476
0131-002,2017,3,26,16,777,785,1562,1550
0131-002,2017,3,26,17,800,830,1630,1562
0131-002,2017,3,26,18,840,887,1727,1630
0131-002,2017,3,26,19,785,649,1434,1727
0131-002,2017,3,26,20,598,463,1061,1434
0131-002,2017,3,26,21,620,393,1013,1061
0131-002,2017,3,26,22,515,288,803,1013
0131-002,2017,3,26,23,306,186,492,803
0131-002,2017,3,26,24,211,149,360,492
0131-002,2017,3,27,1,151,103,254,360
0131-002,2017,3,27,2,88,53,141,254
0131-002,2017,3,27,3,85,53,138,141
0131-002,2017,3,27,4,80,49,129,138
0131-002,2017,3,27,5,142,93,235,129
0131-002,2017,3,27,6,358,165,523,235
0131-002,2017,3,27,7,811,453,1264,523
0131-002,2017,3,27,8,1485,1023,2508,1264
0131-002,2017,3,27,9,1397,1226,2623,2508
0131-002,2017,3,27,10,1030,975,2005,2623
0131-002,2017,3,27,11,1004,1014,2018,2005
0131-002,2017,3,27,12,1017,937,1954,2018
0131-002,2017,3,27,13,904,762,1666,1954
0131-002,2017,3,27,14,997,857,1854,1666
0131-002,2017,3,27,15,999,1063,2062,1854
0131-002,2017,3,27,16,990,980,1970,2062
0131-002,2017,3,27,17,955,1120,2075,1970
0131-002,2017,3,27,18,1065,1404,2469,2075
0131-002,2017,3,27,19,976,1061,2037,2469
0131-002,2017,3,27,20,795,720,1515,2037
0131-002,2017,3,27,21,658,685,1343,1515
0131-002,2017,3,27,22,561,485,1046,1343
0131-002,2017,3,27,23,341,306,647,1046
0131-002,2017,3,27,24,222,172,394,647
0131-002,2017,3,28,1,153,169,322,394
0131-002,2017,3,28,2,106,91,197,322
0131-002,2017,3,28,3,85,67,152,197
0131-002,2017,3,28,4,105,87,192,152
0131-002,2017,3,28,5,144,124,268,192
0131-002,2017,3,28,6,370,175,545,268
0131-002,2017,3,28,7,797,492,1289,545
0131-002,2017,3,28,8,1643,894,2537,1289
0131-002,2017,3,28,9,1396,999,2395,2537
0131-002,2017,3,28,10,1116,968,2084,2395
0131-002,2017,3,28,11,1055,796,1851,2084
0131-002,2017,3,28,12,1064,864,1928,1851
0131-002,2017,3,28,13,861,851,1712,1928
0131-002,2017,3,28,14,1020,1091,2111,1712
0131-002,2017,3,28,15,1029,1097,2126,2111
0131-002,2017,3,28,16,997,987,1984,2126
0131-002,2017,3,28,17,1055,1161,2216,1984
0131-002,2017,3,28,18,1096,1382,2478,2216
0131-002,2017,3,28,19,1012,1233,2245,2478
0131-002,2017,3,28,20,788,791,1579,2245
0131-002,2017,3,28,21,583,660,1243,1579
0131-002,2017,3,28,22,496,454,950,1243
0131-002,2017,3,28,23,336,279,615,950
0131-002,2017,3,28,24,207,213,420,615
0131-002,2017,3,29,1,150,140,290,420
0131-002,2017,3,29,2,111,95,206,290
0131-002,2017,3,29,3,85,103,188,206
0131-002,2017,3,29,4,109,67,176,188
0131-002,2017,3,29,5,121,104,225,176
0131-002,2017,3,29,6,341,187,528,225
0131-002,2017,3,29,7,805,434,1239,528
0131-002,2017,3,29,8,1643,838,2481,1239
0131-002,2017,3,29,9,1436,998,2434,2481
0131-002,2017,3,29,10,1122,893,2015,2434
0131-002,2017,3,29,11,1017,918,1935,2015
0131-002,2017,3,29,12,958,1052,2010,1935
0131-002,2017,3,29,13,833,921,1754,2010
0131-002,2017,3,29,14,934,1054,1988,1754
0131-002,2017,3,29,15,1037,1149,2186,1988
0131-002,2017,3,29,16,961,1147,2108,2186
0131-002,2017,3,29,17,983,1134,2117,2108
0131-002,2017,3,29,18,1053,1535,2588,2117
0131-002,2017,3,29,19,1024,1338,2362,2588
0131-002,2017,3,29,20,808,864,1672,2362
0131-002,2017,3,29,21,612,630,1242,1672
0131-002,2017,3,29,22,550,486,1036,1242
0131-002,2017,3,29,23,361,340,701,1036
0131-002,2017,3,29,24,216,250,466,701
0131-002,2017,3,30,1,202,150,352,466
0131-002,2017,3,30,2,120,135,255,352
0131-002,2017,3,30,3,77,97,174,255
0131-002,2017,3,30,4,101,79,180,174
0131-002,2017,3,30,5,143,134,277,180
0131-002,2017,3,30,6,368,199,567,277
0131-002,2017,3,30,7,800,510,1310,567
0131-002,2017,3,30,8,1646,984,2630,1310
0131-002,2017,3,30,9,1397,1018,2415,2630
0131-002,2017,3,30,10,1089,791,1880,2415
0131-002,2017,3,30,11,1066,746,1812,1880
0131-002,2017,3,30,12,961,977,1938,1812
0131-002,2017,3,30,13,962,903,1865,1938
0131-002,2017,3,30,14,941,1050,1991,1865
0131-002,2017,3,30,15,1047,1121,2168,1991
0131-002,2017,3,30,16,995,1139,2134,2168
0131-002,2017,3,30,17,1042,1169,2211,2134
0131-002,2017,3,30,18,1058,1402,2460,2211
0131-002,2017,3,30,19,985,1240,2225,2460
0131-002,2017,3,30,20,743,802,1545,2225
0131-002,2017,3,30,21,563,795,1358,1545
0131-002,2017,3,30,22,516,560,1076,1358
0131-002,2017,3,30,23,355,351,706,1076
0131-002,2017,3,30,24,223,230,453,706
0131-002,2017,3,31,1,176,194,370,453
0131-002,2017,3,31,2,120,97,217,370
0131-002,2017,3,31,3,94,81,175,217
0131-002,2017,3,31,4,101,97,198,175
0131-002,2017,3,31,5,118,109,227,198
0131-002,2017,3,31,6,339,161,500,227
0131-002,2017,3,31,7,765,433,1198,500
0131-002,2017,3,31,8,1580,863,2443,1198
0131-002,2017,3,31,9,1407,1040,2447,2443
0131-002,2017,3,31,10,1069,941,2010,2447
0131-002,2017,3,31,11,1043,906,1949,2010
0131-002,2017,3,31,12,1009,830,1839,1949
0131-002,2017,3,31,13,877,855,1732,1839
0131-002,2017,3,31,14,811,937,1748,1732
0131-002,2017,3,31,15,1040,692,1732,1748
0131-002,2017,3,31,16,1058,973,2031,1732
0131-002,2017,3,31,17,1064,1115,2179,2031
0131-002,2017,3,31,18,1180,1220,2400,2179
0131-002,2017,3,31,19,1192,1115,2307,2400
0131-002,2017,3,31,20,902,987,1889,2307
0131-002,2017,3,31,21,616,760,1376,1889
0131-002,2017,3,31,22,610,604,1214,1376
0131-002,2017,3,31,23,396,418,814,1214
0131-002,2017,3,31,24,287,256,543,814
0131-002,2017,4,1,1,234,202,436,543
0131-002,2017,4,1,2,171,138,309,436
0131-002,2017,4,1,3,118,90,208,309
0131-002,2017,4,1,4,99,99,198,208
0131-002,2017,4,1,5,104,110,214,198
0131-002,2017,4,1,6,293,174,467,214
0131-002,2017,4,1,7,578,373,951,467
0131-002,2017,4,1,8,881,623,1504,951
0131-002,2017,4,1,9,1030,994,2024,1504
0131-002,2017,4,1,10,1096,962,2058,2024
0131-002,2017,4,1,11,1043,998,2041,2058
0131-002,2017,4,1,12,1118,840,1958,2041
0131-002,2017,4,1,13,860,838,1698,1958
0131-002,2017,4,1,14,907,898,1805,1698
0131-002,2017,4,1,15,800,954,1754,1805
0131-002,2017,4,1,16,820,1015,1835,1754
0131-002,2017,4,1,17,901,1121,2022,1835
0131-002,2017,4,1,18,1020,1410,2430,2022
0131-002,2017,4,1,19,1073,992,2065,2430
0131-002,2017,4,1,20,778,667,1445,2065
0131-002,2017,4,1,21,624,518,1142,1445
0131-002,2017,4,1,22,463,358,821,1142
0131-002,2017,4,1,23,313,280,593,821
0131-002,2017,4,1,24,228,194,422,593
0131-002,2017,4,2,1,185,128,313,422
0131-002,2017,4,2,2,99,92,191,313
0131-002,2017,4,2,3,94,78,172,191
0131-002,2017,4,2,4,62,57,119,172
0131-002,2017,4,2,5,84,98,182,119
0131-002,2017,4,2,6,148,100,248,182
0131-002,2017,4,2,7,285,198,483,248
0131-002,2017,4,2,8,390,295,685,483
0131-002,2017,4,2,9,490,376,866,685
0131-002,2017,4,2,10,546,440,986,866
0131-002,2017,4,2,11,676,490,1166,986
0131-002,2017,4,2,12,694,600,1294,1166
0131-002,2017,4,2,13,676,603,1279,1294
0131-002,2017,4,2,14,724,651,1375,1279
0131-002,2017,4,2,15,758,654,1412,1375
0131-002,2017,4,2,16,784,698,1482,1412
0131-002,2017,4,2,17,892,895,1787,1482
0131-002,2017,4,2,18,952,816,1768,1787
0131-002,2017,4,2,19,916,655,1571,1768
0131-002,2017,4,2,20,854,474,1328,1571
0131-002,2017,4,2,21,780,392,1172,1328
0131-002,2017,4,2,22,604,296,900,1172
0131-002,2017,4,2,23,371,253,624,900
0131-002,2017,4,2,24,245,169,414,624
0131-002,2017,4,3,1,168,145,313,414
0131-002,2017,4,3,2,96,74,170,313
0131-002,2017,4,3,3,68,61,129,170
0131-002,2017,4,3,4,60,50,110,129
0131-002,2017,4,3,5,150,104,254,110
0131-002,2017,4,3,6,380,177,557,254
0131-002,2017,4,3,7,951,478,1429,557
0131-002,2017,4,3,8,1891,1166,3057,1429
0131-002,2017,4,3,9,1440,1208,2648,3057
0131-002,2017,4,3,10,1129,854,1983,2648
0131-002,2017,4,3,11,1092,864,1956,1983
0131-002,2017,4,3,12,983,980,1963,1956
0131-002,2017,4,3,13,879,857,1736,1963
0131-002,2017,4,3,14,937,1006,1943,1736
0131-002,2017,4,3,15,1021,1037,2058,1943
0131-002,2017,4,3,16,1040,993,2033,2058
0131-002,2017,4,3,17,982,1064,2046,2033
0131-002,2017,4,3,18,1183,1347,2530,2046
0131-002,2017,4,3,19,1066,1197,2263,2530
0131-002,2017,4,3,20,763,853,1616,2263
0131-002,2017,4,3,21,733,890,1623,1616
0131-002,2017,4,3,22,585,606,1191,1623
0131-002,2017,4,3,23,359,402,761,1191
0131-002,2017,4,3,24,230,240,470,761
0131-002,2017,4,4,1,184,159,343,470
0131-002,2017,4,4,2,105,93,198,343
0131-002,2017,4,4,3,94,64,158,198
0131-002,2017,4,4,4,80,78,158,158
0131-002,2017,4,4,5,143,103,246,158
0131-002,2017,4,4,6,376,190,566,246
0131-002,2017,4,4,7,846,496,1342,566
0131-002,2017,4,4,8,1699,1130,2829,1342
0131-002,2017,4,4,9,1451,1316,2767,2829
0131-002,2017,4,4,10,1185,1029,2214,2767
0131-002,2017,4,4,11,1137,1072,2209,2214
0131-002,2017,4,4,12,1013,980,1993,2209
0131-002,2017,4,4,13,834,938,1772,1993
0131-002,2017,4,4,14,1021,1033,2054,1772
0131-002,2017,4,4,15,1099,1104,2203,2054
0131-002,2017,4,4,16,1064,1013,2077,2203
0131-002,2017,4,4,17,929,1063,1992,2077
0131-002,2017,4,4,18,1085,1338,2423,1992
0131-002,2017,4,4,19,1138,1230,2368,2423
0131-002,2017,4,4,20,832,778,1610,2368
0131-002,2017,4,4,21,670,750,1420,1610
0131-002,2017,4,4,22,558,530,1088,1420
0131-002,2017,4,4,23,384,316,700,1088
0131-002,2017,4,4,24,271,223,494,700
0131-002,2017,4,5,1,171,160,331,494
0131-002,2017,4,5,2,116,88,204,331
0131-002,2017,4,5,3,87,80,167,204
0131-002,2017,4,5,4,99,73,172,167
0131-002,2017,4,5,5,145,107,252,172
0131-002,2017,4,5,6,351,160,511,252
0131-002,2017,4,5,7,837,479,1316,511
0131-002,2017,4,5,8,1638,1034,2672,1316
0131-002,2017,4,5,9,1455,1294,2749,2672
0131-002,2017,4,5,10,1098,1020,2118,2749
0131-002,2017,4,5,11,1056,976,2032,2118
0131-002,2017,4,5,12,959,931,1890,2032
0131-002,2017,4,5,13,930,806,1736,1890
0131-002,2017,4,5,14,957,913,1870,1736
0131-002,2017,4,5,15,984,748,1732,1870
0131-002,2017,4,5,16,1012,767,1779,1732
0131-002,2017,4,5,17,1026,809,1835,1779
0131-002,2017,4,5,18,1116,1018,2134,1835
0131-002,2017,4,5,19,913,1030,1943,2134
0131-002,2017,4,5,20,620,701,1321,1943
0131-002,2017,4,5,21,476,666,1142,1321
0131-002,2017,4,5,22,454,424,878,1142
0131-002,2017,4,5,23,324,307,631,878
0131-002,2017,4,5,24,193,185,378,631
0131-002,2017,4,6,1,135,159,294,378
0131-002,2017,4,6,2,111,89,200,294
0131-002,2017,4,6,3,56,60,116,200
0131-002,2017,4,6,4,55,78,133,116
0131-002,2017,4,6,5,124,93,217,133
0131-002,2017,4,6,6,299,140,439,217
0131-002,2017,4,6,7,720,366,1086,439
0131-002,2017,4,6,8,1456,875,2331,1086
0131-002,2017,4,6,9,1391,1074,2465,2331
0131-002,2017,4,6,10,1103,804,1907,2465
0131-002,2017,4,6,11,1041,998,2039,1907
0131-002,2017,4,6,12,1018,947,1965,2039
0131-002,2017,4,6,13,867,888,1755,1965
0131-002,2017,4,6,14,988,1042,2030,1755
0131-002,2017,4,6,15,997,1008,2005,2030
0131-002,2017,4,6,16,1080,1027,2107,2005
0131-002,2017,4,6,17,996,970,1966,2107
0131-002,2017,4,6,18,963,1327,2290,1966
0131-002,2017,4,6,19,1034,1011,2045,2290
0131-002,2017,4,6,20,791,889,1680,2045
0131-002,2017,4,6,21,661,850,1511,1680
0131-002,2017,4,6,22,532,585,1117,1511
0131-002,2017,4,6,23,317,409,726,1117
0131-002,2017,4,6,24,213,292,505,726
0131-002,2017,4,7,1,161,169,330,505
0131-002,2017,4,7,2,113,104,217,330
0131-002,2017,4,7,3,83,99,182,217
0131-002,2017,4,7,4,91,86,177,182
0131-002,2017,4,7,5,137,122,259,177
0131-002,2017,4,7,6,325,195,520,259
0131-002,2017,4,7,7,814,507,1321,520
0131-002,2017,4,7,8,1691,1046,2737,1321
0131-002,2017,4,7,9,1471,1260,2731,2737
0131-002,2017,4,7,10,1074,1104,2178,2731
0131-002,2017,4,7,11,1171,1094,2265,2178
0131-002,2017,4,7,12,1040,831,1871,2265
0131-002,2017,4,7,13,916,747,1663,1871
0131-002,2017,4,7,14,1038,1036,2074,1663
0131-002,2017,4,7,15,1085,1096,2181,2074
0131-002,2017,4,7,16,1007,1069,2076,2181
0131-002,2017,4,7,17,939,952,1891,2076
0131-002,2017,4,7,18,1057,1331,2388,1891
0131-002,2017,4,7,19,1175,1208,2383,2388
0131-002,2017,4,7,20,936,957,1893,2383
0131-002,2017,4,7,21,702,796,1498,1893
0131-002,2017,4,7,22,644,554,1198,1498
0131-002,2017,4,7,23,439,427,866,1198
0131-002,2017,4,7,24,266,279,545,866
0131-002,2017,4,8,1,216,170,386,545
0131-002,2017,4,8,2,147,123,270,386
0131-002,2017,4,8,3,117,98,215,270
0131-002,2017,4,8,4,106,93,199,215
0131-002,2017,4,8,5,134,119,253,199
0131-002,2017,4,8,6,303,183,486,253
0131-002,2017,4,8,7,603,366,969,486
0131-002,2017,4,8,8,938,695,1633,969
0131-002,2017,4,8,9,986,883,1869,1633
0131-002,2017,4,8,10,1020,718,1738,1869
0131-002,2017,4,8,11,999,763,1762,1738
0131-002,2017,4,8,12,1023,851,1874,1762
0131-002,2017,4,8,13,905,710,1615,1874
0131-002,2017,4,8,14,827,780,1607,1615
0131-002,2017,4,8,15,970,759,1729,1607
0131-002,2017,4,8,16,899,770,1669,1729
0131-002,2017,4,8,17,987,821,1808,1669
0131-002,2017,4,8,18,1090,1065,2155,1808
0131-002,2017,4,8,19,986,810,1796,2155
0131-002,2017,4,8,20,755,477,1232,1796
0131-002,2017,4,8,21,568,457,1025,1232
0131-002,2017,4,8,22,442,288,730,1025
0131-002,2017,4,8,23,296,222,518,730
0131-002,2017,4,8,24,190,174,364,518
0131-002,2017,4,9,1,180,124,304,364
0131-002,2017,4,9,2,106,92,198,304
0131-002,2017,4,9,3,89,78,167,198
0131-002,2017,4,9,4,61,72,133,167
0131-002,2017,4,9,5,83,73,156,133
0131-002,2017,4,9,6,146,90,236,156
0131-002,2017,4,9,7,322,193,515,236
0131-002,2017,4,9,8,392,322,714,515
0131-002,2017,4,9,9,496,404,900,714
0131-002,2017,4,9,10,534,446,980,900
0131-002,2017,4,9,11,622,569,1191,980
0131-002,2017,4,9,12,658,623,1281,1191
0131-002,2017,4,9,13,667,623,1290,1281
0131-002,2017,4,9,14,741,706,1447,1290
0131-002,2017,4,9,15,715,750,1465,1447
0131-002,2017,4,9,16,795,742,1537,1465
0131-002,2017,4,9,17,827,862,1689,1537
0131-002,2017,4,9,18,829,852,1681,1689
0131-002,2017,4,9,19,808,652,1460,1681
0131-002,2017,4,9,20,742,468,1210,1460
0131-002,2017,4,9,21,628,392,1020,1210
0131-002,2017,4,9,22,493,292,785,1020
0131-002,2017,4,9,23,474,220,694,785
0131-002,2017,4,9,24,210,159,369,694
0131-002,2017,4,10,1,126,92,218,369
0131-002,2017,4,10,2,96,56,152,218
0131-002,2017,4,10,3,68,35,103,152
0131-002,2017,4,10,4,58,51,109,103
0131-002,2017,4,10,5,127,98,225,109
0131-002,2017,4,10,6,394,171,565,225
0131-002,2017,4,10,7,1002,466,1468,565
0131-002,2017,4,10,8,1808,1094,2902,1468
0131-002,2017,4,10,9,1502,1217,2719,2902
0131-002,2017,4,10,10,1062,914,1976,2719
0131-002,2017,4,10,11,1127,939,2066,1976
0131-002,2017,4,10,12,1037,958,1995,2066
0131-002,2017,4,10,13,897,810,1707,1995
0131-002,2017,4,10,14,1052,932,1984,1707
0131-002,2017,4,10,15,1054,1050,2104,1984
0131-002,2017,4,10,16,1031,986,2017,2104
0131-002,2017,4,10,17,978,1092,2070,2017
0131-002,2017,4,10,18,1101,1376,2477,2070
0131-002,2017,4,10,19,1023,989,2012,2477
0131-002,2017,4,10,20,872,745,1617,2012
0131-002,2017,4,10,21,696,603,1299,1617
0131-002,2017,4,10,22,566,403,969,1299
0131-002,2017,4,10,23,369,238,607,969
0131-002,2017,4,10,24,245,122,367,607
0131-002,2017,4,11,1,170,76,246,367
0131-002,2017,4,11,2,111,42,153,246
0131-002,2017,4,11,3,97,33,130,153
0131-002,2017,4,11,4,69,47,116,130
0131-002,2017,4,11,5,144,68,212,116
0131-002,2017,4,11,6,297,85,382,212
0131-002,2017,4,11,7,742,302,1044,382
0131-002,2017,4,11,8,1560,1031,2591,1044
0131-002,2017,4,11,9,1358,1361,2719,2591
0131-002,2017,4,11,10,1064,1137,2201,2719
0131-002,2017,4,11,11,1077,1063,2140,2201
0131-002,2017,4,11,12,950,1006,1956,2140
0131-002,2017,4,11,13,803,880,1683,1956
0131-002,2017,4,11,14,893,805,1698,1683
0131-002,2017,4,11,15,907,839,1746,1698
0131-002,2017,4,11,16,927,767,1694,1746
0131-002,2017,4,11,17,893,787,1680,1694
0131-002,2017,4,11,18,910,850,1760,1680
0131-002,2017,4,11,19,881,724,1605,1760
0131-002,2017,4,11,20,778,643,1421,1605
0131-002,2017,4,11,21,603,721,1324,1421
0131-002,2017,4,11,22,554,521,1075,1324
0131-002,2017,4,11,23,374,356,730,1075
0131-002,2017,4,11,24,247,200,447,730
0131-002,2017,4,12,1,163,108,271,447
0131-002,2017,4,12,2,85,77,162,271
0131-002,2017,4,12,3,87,75,162,162
0131-002,2017,4,12,4,88,70,158,162
0131-002,2017,4,12,5,136,106,242,158
0131-002,2017,4,12,6,386,174,560,242
0131-002,2017,4,12,7,877,456,1333,560
0131-002,2017,4,12,8,1701,936,2637,1333
0131-002,2017,4,12,9,1447,1146,2593,2637
0131-002,2017,4,12,10,1142,956,2098,2593
0131-002,2017,4,12,11,1198,947,2145,2098
0131-002,2017,4,12,12,992,992,1984,2145
0131-002,2017,4,12,13,892,864,1756,1984
0131-002,2017,4,12,14,921,984,1905,1756
0131-002,2017,4,12,15,995,948,1943,1905
0131-002,2017,4,12,16,1078,957,2035,1943
0131-002,2017,4,12,17,999,972,1971,2035
0131-002,2017,4,12,18,1190,1276,2466,1971
0131-002,2017,4,12,19,1153,1184,2337,2466
0131-002,2017,4,12,20,840,782,1622,2337
0131-002,2017,4,12,21,638,648,1286,1622
0131-002,2017,4,12,22,563,455,1018,1286
0131-002,2017,4,12,23,368,324,692,1018
0131-002,2017,4,12,24,229,218,447,692
0131-002,2017,4,13,1,181,121,302,447
0131-002,2017,4,13,2,140,79,219,302
0131-002,2017,4,13,3,91,58,149,219
0131-002,2017,4,13,4,93,51,144,149
0131-002,2017,4,13,5,166,72,238,144
0131-002,2017,4,13,6,379,126,505,238
0131-002,2017,4,13,7,821,422,1243,505
0131-002,2017,4,13,8,1649,1185,2834,1243
0131-002,2017,4,13,9,1502,1375,2877,2834
0131-002,2017,4,13,10,1127,1108,2235,2877
0131-002,2017,4,13,11,1049,959,2008,2235
0131-002,2017,4,13,12,1044,864,1908,2008
0131-002,2017,4,13,13,853,801,1654,1908
0131-002,2017,4,13,14,963,959,1922,1654
0131-002,2017,4,13,15,1061,1065,2126,1922
0131-002,2017,4,13,16,1090,1118,2208,2126
0131-002,2017,4,13,17,1009,1145,2154,2208
0131-002,2017,4,13,18,1095,1602,2697,2154
0131-002,2017,4,13,19,1095,1421,2516,2697
0131-002,2017,4,13,20,854,963,1817,2516
0131-002,2017,4,13,21,691,834,1525,1817
0131-002,2017,4,13,22,558,556,1114,1525
0131-002,2017,4,13,23,351,362,713,1114
0131-002,2017,4,13,24,254,181,435,713
0131-002,2017,4,14,1,192,92,284,435
0131-002,2017,4,14,2,125,83,208,284
0131-002,2017,4,14,3,76,42,118,208
0131-002,2017,4,14,4,95,36,131,118
0131-002,2017,4,14,5,153,63,216,131
0131-002,2017,4,14,6,355,113,468,216
0131-002,2017,4,14,7,858,454,1312,468
0131-002,2017,4,14,8,1405,1117,2522,1312
0131-002,2017,4,14,9,1285,1369,2654,2522
0131-002,2017,4,14,10,1084,1108,2192,2654
0131-002,2017,4,14,11,1105,1006,2111,2192
0131-002,2017,4,14,12,976,1034,2010,2111
0131-002,2017,4,14,13,901,961,1862,2010
0131-002,2017,4,14,14,988,1056,2044,1862
0131-002,2017,4,14,15,1077,1065,2142,2044
0131-002,2017,4,14,16,1040,1124,2164,2142
0131-002,2017,4,14,17,1020,1149,2169,2164
0131-002,2017,4,14,18,1110,1692,2802,2169
0131-002,2017,4,14,19,1166,1682,2848,2802
0131-002,2017,4,14,20,862,1038,1900,2848
0131-002,2017,4,14,21,680,889,1569,1900
0131-002,2017,4,14,22,520,525,1045,1569
0131-002,2017,4,14,23,336,325,661,1045
0131-002,2017,4,14,24,265,176,441,661
0131-002,2017,4,15,1,196,128,324,441
0131-002,2017,4,15,2,138,97,235,324
0131-002,2017,4,15,3,114,60,174,235
0131-002,2017,4,15,4,104,65,169,174
0131-002,2017,4,15,5,163,101,264,169
0131-002,2017,4,15,6,327,137,464,264
0131-002,2017,4,15,7,604,361,965,464
0131-002,2017,4,15,8,938,653,1591,965
0131-002,2017,4,15,9,945,1007,1952,1591
0131-002,2017,4,15,10,938,848,1786,1952
0131-002,2017,4,15,11,1000,959,1959,1786
0131-002,2017,4,15,12,964,905,1869,1959
0131-002,2017,4,15,13,912,805,1717,1869
0131-002,2017,4,15,14,943,835,1778,1717
0131-002,2017,4,15,15,988,887,1875,1778
0131-002,2017,4,15,16,948,984,1932,1875
0131-002,2017,4,15,17,905,1083,1988,1932
0131-002,2017,4,15,18,967,1470,2437,1988
0131-002,2017,4,15,19,874,1054,1928,2437
0131-002,2017,4,15,20,641,552,1193,1928
0131-002,2017,4,15,21,538,488,1026,1193
0131-002,2017,4,15,22,442,309,751,1026
0131-002,2017,4,15,23,306,215,521,751
0131-002,2017,4,15,24,200,158,358,521
0131-002,2017,4,16,1,147,121,268,358
0131-002,2017,4,16,2,129,70,199,268
0131-002,2017,4,16,3,89,42,131,199
0131-002,2017,4,16,4,82,52,134,131
0131-002,2017,4,16,5,107,42,149,134
0131-002,2017,4,16,6,175,86,261,149
0131-002,2017,4,16,7,335,149,484,261
0131-002,2017,4,16,8,420,323,743,484
0131-002,2017,4,16,9,470,486,956,743
0131-002,2017,4,16,10,506,515,1021,956
0131-002,2017,4,16,11,653,635,1288,1021
0131-002,2017,4,16,12,720,601,1321,1288
0131-002,2017,4,16,13,676,552,1228,1321
0131-002,2017,4,16,14,718,602,1320,1228
0131-002,2017,4,16,15,854,663,1517,1320
0131-002,2017,4,16,16,845,780,1625,1517
0131-002,2017,4,16,17,852,769,1621,1625
0131-002,2017,4,16,18,810,930,1740,1621
0131-002,2017,4,16,19,846,742,1588,1740
0131-002,2017,4,16,20,675,552,1227,1588
0131-002,2017,4,16,21,570,459,1029,1227
0131-002,2017,4,16,22,504,284,788,1029
0131-002,2017,4,16,23,351,180,531,788
0131-002,2017,4,16,24,236,117,353,531
0131-002,2017,4,17,1,138,72,210,353
0131-002,2017,4,17,2,100,58,158,210
0131-002,2017,4,17,3,65,35,100,158
0131-002,2017,4,17,4,83,31,114,100
0131-002,2017,4,17,5,118,60,178,114
0131-002,2017,4,17,6,343,128,471,178
0131-002,2017,4,17,7,876,425,1301,471
0131-002,2017,4,17,8,1317,1237,2554,1301
0131-002,2017,4,17,9,1177,1356,2533,2554
0131-002,2017,4,17,10,786,852,1638,2533
0131-002,2017,4,17,11,870,880,1750,1638
0131-002,2017,4,17,12,911,801,1712,1750
0131-002,2017,4,17,13,786,710,1496,1712
0131-002,2017,4,17,14,933,742,1675,1496
0131-002,2017,4,17,15,954,819,1773,1675
0131-002,2017,4,17,16,996,1016,2012,1773
0131-002,2017,4,17,17,944,1036,1980,2012
0131-002,2017,4,17,18,969,1199,2168,1980
0131-002,2017,4,17,19,971,1312,2283,2168
0131-002,2017,4,17,20,756,916,1672,2283
0131-002,2017,4,17,21,577,791,1368,1672
0131-002,2017,4,17,22,471,515,986,1368
0131-002,2017,4,17,23,300,282,582,986
0131-002,2017,4,17,24,209,158,367,582
0131-002,2017,4,18,1,158,135,293,367
0131-002,2017,4,18,2,104,61,165,293
0131-002,2017,4,18,3,77,29,106,165
0131-002,2017,4,18,4,65,67,132,106
0131-002,2017,4,18,5,106,74,180,132
0131-002,2017,4,18,6,366,135,501,180
0131-002,2017,4,18,7,818,443,1261,501
0131-002,2017,4,18,8,1702,1221,2923,1261
0131-002,2017,4,18,9,1457,1408,2865,2923
0131-002,2017,4,18,10,1168,1072,2240,2865
0131-002,2017,4,18,11,1182,1004,2186,2240
0131-002,2017,4,18,12,1050,934,1984,2186
0131-002,2017,4,18,13,949,791,1740,1984
0131-002,2017,4,18,14,1036,1009,2045,1740
0131-002,2017,4,18,15,1042,1203,2245,2045
0131-002,2017,4,18,16,1028,1007,2035,2245
0131-002,2017,4,18,17,1019,1151,2170,2035
0131-002,2017,4,18,18,1034,1337,2371,2170
0131-002,2017,4,18,19,980,1212,2192,2371
0131-002,2017,4,18,20,712,826,1538,2192
0131-002,2017,4,18,21,585,855,1440,1538
0131-002,2017,4,18,22,499,540,1039,1440
0131-002,2017,4,18,23,294,269,563,1039
0131-002,2017,4,18,24,217,160,377,563
0131-002,2017,4,19,1,155,128,283,377
0131-002,2017,4,19,2,92,83,175,283
0131-002,2017,4,19,3,80,31,111,175
0131-002,2017,4,19,4,86,76,162,111
0131-002,2017,4,19,5,136,113,249,162
0131-002,2017,4,19,6,388,237,625,249
0131-002,2017,4,19,7,832,542,1374,625
0131-002,2017,4,19,8,1705,1608,3313,1374
0131-002,2017,4,19,9,1471,1654,3125,3313
0131-002,2017,4,19,10,1128,1242,2370,3125
0131-002,2017,4,19,11,1106,1178,2284,2370
0131-002,2017,4,19,12,1010,973,1983,2284
0131-002,2017,4,19,13,914,809,1723,1983
0131-002,2017,4,19,14,1014,955,1969,1723
0131-002,2017,4,19,15,1080,1083,2163,1969
0131-002,2017,4,19,16,1006,1020,2026,2163
0131-002,2017,4,19,17,996,1144,2140,2026
0131-002,2017,4,19,18,1140,1727,2867,2140
0131-002,2017,4,19,19,1147,1402,2549,2867
0131-002,2017,4,19,20,878,1133,2011,2549
0131-002,2017,4,19,21,624,984,1608,2011
0131-002,2017,4,19,22,516,787,1303,1608
0131-002,2017,4,19,23,383,395,778,1303
0131-002,2017,4,19,24,241,284,525,778
0131-002,2017,4,20,1,169,267,436,525
0131-002,2017,4,20,2,115,151,266,436
0131-002,2017,4,20,3,79,167,246,266
0131-002,2017,4,20,4,87,167,254,246
0131-002,2017,4,20,5,141,162,303,254
0131-002,2017,4,20,6,354,221,575,303
0131-002,2017,4,20,7,842,558,1400,575
0131-002,2017,4,20,8,1680,1353,3033,1400
0131-002,2017,4,20,9,1494,1538,3032,3033
0131-002,2017,4,20,10,1080,1108,2188,3032
0131-002,2017,4,20,11,1142,1167,2309,2188
0131-002,2017,4,20,12,1023,1059,2082,2309
0131-002,2017,4,20,13,932,889,1821,2082
0131-002,2017,4,20,14,1026,886,1912,1821
0131-002,2017,4,20,15,1097,1081,2178,1912
0131-002,2017,4,20,16,1107,1129,2236,2178
0131-002,2017,4,20,17,1029,1303,2332,2236
0131-002,2017,4,20,18,1159,1595,2754,2332
0131-002,2017,4,20,19,1015,1658,2673,2754
0131-002,2017,4,20,20,795,1084,1879,2673
0131-002,2017,4,20,21,618,1063,1681,1879
0131-002,2017,4,20,22,528,794,1322,1681
0131-002,2017,4,20,23,373,542,915,1322
0131-002,2017,4,20,24,247,271,518,915
0131-002,2017,4,21,1,183,103,286,518
0131-002,2017,4,21,2,133,99,232,286
0131-002,2017,4,21,3,91,108,199,232
0131-002,2017,4,21,4,89,94,183,199
0131-002,2017,4,21,5,141,101,242,183
0131-002,2017,4,21,6,357,185,542,242
0131-002,2017,4,21,7,880,567,1447,542
0131-002,2017,4,21,8,1629,1423,3052,1447
0131-002,2017,4,21,9,1464,1556,3020,3052
0131-002,2017,4,21,10,1125,1108,2233,3020
0131-002,2017,4,21,11,1140,1027,2167,2233
0131-002,2017,4,21,12,996,1009,2005,2167
0131-002,2017,4,21,13,901,816,1717,2005
0131-002,2017,4,21,14,1045,948,1993,1717
0131-002,2017,4,21,15,1179,1059,2238,1993
0131-002,2017,4,21,16,1155,1140,2295,2238
0131-002,2017,4,21,17,1099,1278,2377,2295
0131-002,2017,4,21,18,1244,1901,3145,2377
0131-002,2017,4,21,19,1215,1824,3039,3145
0131-002,2017,4,21,20,936,1274,2210,3039
0131-002,2017,4,21,21,692,1077,1769,2210
0131-002,2017,4,21,22,541,540,1081,1769
0131-002,2017,4,21,23,404,341,745,1081
0131-002,2017,4,21,24,235,178,413,745
0131-002,2017,4,22,1,199,144,343,413
0131-002,2017,4,22,2,142,76,218,343
0131-002,2017,4,22,3,95,65,160,218
0131-002,2017,4,22,4,104,63,167,160
0131-002,2017,4,22,5,133,65,198,167
0131-002,2017,4,22,6,326,129,455,198
0131-002,2017,4,22,7,679,310,989,455
0131-002,2017,4,22,8,988,751,1739,989
0131-002,2017,4,22,9,1037,1002,2039,1739
0131-002,2017,4,22,10,980,950,1930,2039
0131-002,2017,4,22,11,1012,891,1903,1930
0131-002,2017,4,22,12,1014,859,1873,1903
0131-002,2017,4,22,13,936,860,1796,1873
0131-002,2017,4,22,14,911,832,1743,1796
0131-002,2017,4,22,15,958,957,1915,1743
0131-002,2017,4,22,16,988,954,1942,1915
0131-002,2017,4,22,17,994,1174,2168,1942
0131-002,2017,4,22,18,1125,1562,2687,2168
0131-002,2017,4,22,19,1002,1081,2083,2687
0131-002,2017,4,22,20,667,669,1336,2083
0131-002,2017,4,22,21,552,486,1038,1336
0131-002,2017,4,22,22,430,341,771,1038
0131-002,2017,4,22,23,318,230,548,771
0131-002,2017,4,22,24,206,172,378,548
0131-002,2017,4,23,1,164,106,270,378
0131-002,2017,4,23,2,101,69,170,270
0131-002,2017,4,23,3,83,60,143,170
0131-002,2017,4,23,4,80,35,115,143
0131-002,2017,4,23,5,106,60,166,115
0131-002,2017,4,23,6,192,69,261,166
0131-002,2017,4,23,7,354,158,512,261
0131-002,2017,4,23,8,442,269,711,512
0131-002,2017,4,23,9,566,364,930,711
0131-002,2017,4,23,10,532,482,1014,930
0131-002,2017,4,23,11,697,588,1285,1014
0131-002,2017,4,23,12,721,529,1250,1285
0131-002,2017,4,23,13,675,567,1242,1250
0131-002,2017,4,23,14,707,570,1277,1242
0131-002,2017,4,23,15,762,740,1502,1277
0131-002,2017,4,23,16,881,780,1661,1502
0131-002,2017,4,23,17,767,866,1633,1661
0131-002,2017,4,23,18,877,944,1821,1633
0131-002,2017,4,23,19,872,783,1655,1821
0131-002,2017,4,23,20,682,520,1202,1655
0131-002,2017,4,23,21,613,389,1002,1202
0131-002,2017,4,23,22,494,278,772,1002
0131-002,2017,4,23,23,347,205,552,772
0131-002,2017,4,23,24,219,124,343,552
0131-002,2017,4,24,1,168,76,244,343
0131-002,2017,4,24,2,100,35,135,244
0131-002,2017,4,24,3,81,42,123,135
0131-002,2017,4,24,4,75,24,99,123
0131-002,2017,4,24,5,133,47,180,99
0131-002,2017,4,24,6,414,164,578,180
0131-002,2017,4,24,7,948,475,1423,578
0131-002,2017,4,24,8,1673,1287,2960,1423
0131-002,2017,4,24,9,1417,1380,2797,2960
0131-002,2017,4,24,10,976,981,1957,2797
0131-002,2017,4,24,11,1098,1025,2123,1957
0131-002,2017,4,24,12,1029,1000,2029,2123
0131-002,2017,4,24,13,867,841,1708,2029
0131-002,2017,4,24,14,982,927,1909,1708
0131-002,2017,4,24,15,1047,1047,2094,1909
0131-002,2017,4,24,16,1065,934,1999,2094
0131-002,2017,4,24,17,1038,1106,2144,1999
0131-002,2017,4,24,18,1103,1427,2530,2144
0131-002,2017,4,24,19,1027,1430,2457,2530
0131-002,2017,4,24,20,799,939,1738,2457
0131-002,2017,4,24,21,635,886,1521,1738
0131-002,2017,4,24,22,519,481,1000,1521
0131-002,2017,4,24,23,345,276,621,1000
0131-002,2017,4,24,24,210,181,391,621
0131-002,2017,4,25,1,175,104,279,391
0131-002,2017,4,25,2,109,76,185,279
0131-002,2017,4,25,3,103,43,146,185
0131-002,2017,4,25,4,91,45,136,146
0131-002,2017,4,25,5,153,74,227,136
0131-002,2017,4,25,6,336,138,474,227
0131-002,2017,4,25,7,890,441,1331,474
0131-002,2017,4,25,8,1628,1102,2730,1331
0131-002,2017,4,25,9,1482,1445,2927,2730
0131-002,2017,4,25,10,1094,1221,2315,2927
0131-002,2017,4,25,11,1025,1011,2036,2315
0131-002,2017,4,25,12,969,903,1872,2036
0131-002,2017,4,25,13,774,862,1636,1872
0131-002,2017,4,25,14,922,961,1883,1636
0131-002,2017,4,25,15,902,1188,2090,1883
0131-002,2017,4,25,16,978,1095,2073,2090
0131-002,2017,4,25,17,1067,1165,2232,2073
0131-002,2017,4,25,18,1032,1635,2667,2232
0131-002,2017,4,25,19,1045,1324,2369,2667
0131-002,2017,4,25,20,777,914,1691,2369
0131-002,2017,4,25,21,622,868,1490,1691
0131-002,2017,4,25,22,519,488,1007,1490
0131-002,2017,4,25,23,347,307,654,1007
0131-002,2017,4,25,24,260,164,424,654
0131-002,2017,4,26,1,187,113,300,424
0131-002,2017,4,26,2,109,43,152,300
0131-002,2017,4,26,3,80,36,116,152
0131-002,2017,4,26,4,83,47,130,116
0131-002,2017,4,26,5,147,63,210,130
0131-002,2017,4,26,6,365,131,496,210
0131-002,2017,4,26,7,743,436,1179,496
0131-002,2017,4,26,8,1363,1117,2480,1179
0131-002,2017,4,26,9,1240,1457,2697,2480
0131-002,2017,4,26,10,975,1067,2042,2697
0131-002,2017,4,26,11,994,1050,2044,2042
0131-002,2017,4,26,12,956,946,1902,2044
0131-002,2017,4,26,13,844,862,1706,1902
0131-002,2017,4,26,14,936,868,1804,1706
0131-002,2017,4,26,15,1004,1158,2162,1804
0131-002,2017,4,26,16,1052,1034,2086,2162
0131-002,2017,4,26,17,1034,1187,2221,2086
0131-002,2017,4,26,18,1040,1722,2762,2221
0131-002,2017,4,26,19,1047,1446,2493,2762
0131-002,2017,4,26,20,808,916,1724,2493
0131-002,2017,4,26,21,643,767,1410,1724
0131-002,2017,4,26,22,533,459,992,1410
0131-002,2017,4,26,23,358,294,652,992
0131-002,2017,4,26,24,271,167,438,652
0131-002,2017,4,27,1,188,122,310,438
0131-002,2017,4,27,2,128,60,188,310
0131-002,2017,4,27,3,108,61,169,188
0131-002,2017,4,27,4,102,52,154,169
0131-002,2017,4,27,5,163,78,241,154
0131-002,2017,4,27,6,412,122,534,241
0131-002,2017,4,27,7,887,436,1323,534
0131-002,2017,4,27,8,1593,1195,2788,1323
0131-002,2017,4,27,9,1317,1410,2727,2788
0131-002,2017,4,27,10,1155,1126,2281,2727
0131-002,2017,4,27,11,1030,1115,2145,2281
0131-002,2017,4,27,12,920,970,1890,2145
0131-002,2017,4,27,13,837,889,1726,1890
0131-002,2017,4,27,14,900,957,1857,1726
0131-002,2017,4,27,15,973,1058,2031,1857
0131-002,2017,4,27,16,959,1160,2119,2031
0131-002,2017,4,27,17,918,1144,2062,2119
0131-002,2017,4,27,18,1046,1558,2604,2062
0131-002,2017,4,27,19,973,1292,2265,2604
0131-002,2017,4,27,20,812,1009,1821,2265
0131-002,2017,4,27,21,660,855,1515,1821
0131-002,2017,4,27,22,568,529,1097,1515
0131-002,2017,4,27,23,339,336,675,1097
0131-002,2017,4,27,24,255,196,451,675
0131-002,2017,4,28,1,226,117,343,451
0131-002,2017,4,28,2,134,72,206,343
0131-002,2017,4,28,3,112,61,173,206
0131-002,2017,4,28,4,127,60,187,173
0131-002,2017,4,28,5,182,83,265,187
0131-002,2017,4,28,6,389,181,570,265
0131-002,2017,4,28,7,961,490,1451,570
0131-002,2017,4,28,8,1445,1194,2639,1451
0131-002,2017,4,28,9,1332,1479,2811,2639
0131-002,2017,4,28,10,1125,1084,2209,2811
0131-002,2017,4,28,11,978,1093,2071,2209
0131-002,2017,4,28,12,944,1093,2037,2071
0131-002,2017,4,28,13,842,912,1754,2037
0131-002,2017,4,28,14,927,993,1920,1754
0131-002,2017,4,28,15,991,1108,2099,1920
0131-002,2017,4,28,16,994,1149,2143,2099
0131-002,2017,4,28,17,976,1317,2293,2143
0131-002,2017,4,28,18,1040,1763,2803,2293
0131-002,2017,4,28,19,1004,1808,2812,2803
0131-002,2017,4,28,20,948,1289,2237,2812
0131-002,2017,4,28,21,688,998,1686,2237
0131-002,2017,4,28,22,582,556,1138,1686
0131-002,2017,4,28,23,383,447,830,1138
0131-002,2017,4,28,24,270,293,563,830
0131-002,2017,4,29,1,201,267,468,563
0131-002,2017,4,29,2,156,153,309,468
0131-002,2017,4,29,3,113,135,248,309
0131-002,2017,4,29,4,140,113,253,248
0131-002,2017,4,29,5,170,121,291,253
0131-002,2017,4,29,6,355,144,499,291
0131-002,2017,4,29,7,682,377,1059,499
0131-002,2017,4,29,8,960,712,1672,1059
0131-002,2017,4,29,9,1012,1111,2123,1672
0131-002,2017,4,29,10,1033,1110,2143,2123
0131-002,2017,4,29,11,968,1009,1977,2143
0131-002,2017,4,29,12,926,896,1822,1977
0131-002,2017,4,29,13,788,963,1751,1822
0131-002,2017,4,29,14,812,920,1732,1751
0131-002,2017,4,29,15,758,975,1733,1732
0131-002,2017,4,29,16,892,1090,1982,1733
0131-002,2017,4,29,17,975,1308,2283,1982
0131-002,2017,4,29,18,942,1436,2378,2283
0131-002,2017,4,29,19,868,1007,1875,2378
0131-002,2017,4,29,20,706,696,1402,1875
0131-002,2017,4,29,21,528,466,994,1402
0131-002,2017,4,29,22,426,348,774,994
0131-002,2017,4,29,23,346,203,549,774
0131-002,2017,4,29,24,202,131,333,549
0131-002,2017,4,30,1,164,112,276,333
0131-002,2017,4,30,2,121,67,188,276
0131-002,2017,4,30,3,86,56,142,188
0131-002,2017,4,30,4,80,35,115,142
0131-002,2017,4,30,5,113,52,165,115
0131-002,2017,4,30,6,196,83,279,165
0131-002,2017,4,30,7,352,155,507,279
0131-002,2017,4,30,8,477,287,764,507
0131-002,2017,4,30,9,495,445,940,764
0131-002,2017,4,30,10,599,504,1103,940
0131-002,2017,4,30,11,681,601,1282,1103
0131-002,2017,4,30,12,618,542,1160,1282
0131-002,2017,4,30,13,604,540,1144,1160
0131-002,2017,4,30,14,696,594,1290,1144
0131-002,2017,4,30,15,688,637,1325,1290
0131-002,2017,4,30,16,744,744,1488,1325
0131-002,2017,4,30,17,747,758,1505,1488
0131-002,2017,4,30,18,777,972,1749,1505
0131-002,2017,4,30,19,739,696,1435,1749
0131-002,2017,4,30,20,619,619,1238,1435
0131-002,2017,4,30,21,568,443,1011,1238
0131-002,2017,4,30,22,466,298,764,1011
0131-002,2017,4,30,23,316,205,521,764
0131-002,2017,4,30,24,238,97,335,521
0131-002,2017,5,1,1,149,75,224,335
0131-002,2017,5,1,2,103,49,152,224
0131-002,2017,5,1,3,68,37,105,152
0131-002,2017,5,1,4,74,37,111,105
0131-002,2017,5,1,5,110,34,144,111
0131-002,2017,5,1,6,209,112,321,144
0131-002,2017,5,1,7,521,263,784,321
0131-002,2017,5,1,8,1095,685,1780,784
0131-002,2017,5,1,9,946,904,1850,1780
0131-002,2017,5,1,10,824,750,1574,1850
0131-002,2017,5,1,11,828,776,1604,1574
0131-002,2017,5,1,12,807,748,1555,1604
0131-002,2017,5,1,13,731,637,1368,1555
0131-002,2017,5,1,14,760,757,1517,1368
0131-002,2017,5,1,15,746,767,1513,1517
0131-002,2017,5,1,16,794,800,1594,1513
0131-002,2017,5,1,17,795,840,1635,1594
0131-002,2017,5,1,18,798,1134,1932,1635
0131-002,2017,5,1,19,841,932,1773,1932
0131-002,2017,5,1,20,702,560,1262,1773
0131-002,2017,5,1,21,583,444,1027,1262
0131-002,2017,5,1,22,489,306,795,1027
0131-002,2017,5,1,23,351,190,541,795
0131-002,2017,5,1,24,241,103,344,541
0131-002,2017,5,2,1,154,61,215,344
0131-002,2017,5,2,2,117,54,171,215
0131-002,2017,5,2,3,93,42,135,171
0131-002,2017,5,2,4,74,47,121,135
0131-002,2017,5,2,5,155,54,209,121
0131-002,2017,5,2,6,441,152,593,209
0131-002,2017,5,2,7,903,452,1355,593
0131-002,2017,5,2,8,1480,1050,2530,1355
0131-002,2017,5,2,9,1288,1334,2622,2530
0131-002,2017,5,2,10,965,970,1935,2622
0131-002,2017,5,2,11,1030,983,2013,1935
0131-002,2017,5,2,12,988,953,1941,2013
0131-002,2017,5,2,13,917,800,1717,1941
0131-002,2017,5,2,14,959,908,1867,1717
0131-002,2017,5,2,15,933,1083,2016,1867
0131-002,2017,5,2,16,982,1116,2098,2016
0131-002,2017,5,2,17,957,1186,2143,2098
0131-002,2017,5,2,18,1069,1571,2640,2143
0131-002,2017,5,2,19,1080,1447,2527,2640
0131-002,2017,5,2,20,872,1042,1914,2527
0131-002,2017,5,2,21,686,814,1500,1914
0131-002,2017,5,2,22,545,451,996,1500
0131-002,2017,5,2,23,423,277,700,996
0131-002,2017,5,2,24,280,180,460,700
0131-002,2017,5,3,1,197,129,326,460
0131-002,2017,5,3,2,143,65,208,326
0131-002,2017,5,3,3,130,68,198,208
0131-002,2017,5,3,4,104,49,153,198
0131-002,2017,5,3,5,161,75,236,153
0131-002,2017,5,3,6,384,160,544,236
0131-002,2017,5,3,7,661,320,981,544
0131-002,2017,5,3,8,940,616,1556,981
0131-002,2017,5,3,9,872,918,1790,1556
0131-002,2017,5,3,10,845,941,1786,1790
0131-002,2017,5,3,11,889,1005,1894,1786
0131-002,2017,5,3,12,883,925,1808,1894
0131-002,2017,5,3,13,765,824,1589,1808
0131-002,2017,5,3,14,834,833,1667,1589
0131-002,2017,5,3,15,896,939,1835,1667
0131-002,2017,5,3,16,831,882,1713,1835
0131-002,2017,5,3,17,865,814,1679,1713
0131-002,2017,5,3,18,937,1261,2198,1679
0131-002,2017,5,3,19,772,962,1734,2198
0131-002,2017,5,3,20,704,637,1341,1734
0131-002,2017,5,3,21,578,461,1039,1341
0131-002,2017,5,3,22,484,326,810,1039
0131-002,2017,5,3,23,360,193,553,810
0131-002,2017,5,3,24,230,124,354,553
0131-002,2017,5,4,1,182,77,259,354
0131-002,2017,5,4,2,129,72,201,259
0131-002,2017,5,4,3,92,39,131,201
0131-002,2017,5,4,4,95,34,129,131
0131-002,2017,5,4,5,149,68,217,129
0131-002,2017,5,4,6,342,134,476,217
0131-002,2017,5,4,7,713,423,1136,476
0131-002,2017,5,4,8,1194,838,2032,1136
0131-002,2017,5,4,9,1104,1010,2114,2032
0131-002,2017,5,4,10,849,797,1646,2114
0131-002,2017,5,4,11,959,946,1905,1646
0131-002,2017,5,4,12,938,850,1788,1905
0131-002,2017,5,4,13,886,760,1646,1788
0131-002,2017,5,4,14,983,870,1853,1646
0131-002,2017,5,4,15,929,963,1892,1853
0131-002,2017,5,4,16,1004,1047,2051,1892
0131-002,2017,5,4,17,1005,1064,2069,2051
0131-002,2017,5,4,18,1142,1518,2660,2069
0131-002,2017,5,4,19,1054,1518,2572,2660
0131-002,2017,5,4,20,808,1021,1829,2572
0131-002,2017,5,4,21,672,755,1427,1829
0131-002,2017,5,4,22,510,475,985,1427
0131-002,2017,5,4,23,359,299,658,985
0131-002,2017,5,4,24,226,141,367,658
0131-002,2017,5,5,1,180,94,274,367
0131-002,2017,5,5,2,143,68,211,274
0131-002,2017,5,5,3,126,60,186,211
0131-002,2017,5,5,4,123,42,165,186
0131-002,2017,5,5,5,174,75,249,165
0131-002,2017,5,5,6,286,117,403,249
0131-002,2017,5,5,7,596,286,882,403
0131-002,2017,5,5,8,698,501,1199,882
0131-002,2017,5,5,9,792,633,1425,1199
0131-002,2017,5,5,10,791,913,1704,1425
0131-002,2017,5,5,11,936,958,1894,1704
0131-002,2017,5,5,12,957,1007,1964,1894
0131-002,2017,5,5,13,1023,826,1849,1964
0131-002,2017,5,5,14,806,757,1563,1849
0131-002,2017,5,5,15,759,791,1550,1563
0131-002,2017,5,5,16,744,830,1574,1550
0131-002,2017,5,5,17,770,901,1671,1574
0131-002,2017,5,5,18,811,1147,1958,1671
0131-002,2017,5,5,19,748,849,1597,1958
0131-002,2017,5,5,20,602,534,1136,1597
0131-002,2017,5,5,21,583,428,1011,1136
0131-002,2017,5,5,22,447,319,766,1011
0131-002,2017,5,5,23,329,213,542,766
0131-002,2017,5,5,24,224,119,343,542
0131-002,2017,5,6,1,167,75,242,343
0131-002,2017,5,6,2,101,40,141,242
0131-002,2017,5,6,3,95,44,139,141
0131-002,2017,5,6,4,99,39,138,139
0131-002,2017,5,6,5,134,44,178,138
0131-002,2017,5,6,6,306,108,414,178
0131-002,2017,5,6,7,532,233,765,414
0131-002,2017,5,6,8,650,327,977,765
0131-002,2017,5,6,9,648,578,1226,977
0131-002,2017,5,6,10,729,571,1300,1226
0131-002,2017,5,6,11,745,680,1425,1300
0131-002,2017,5,6,12,856,722,1578,1425
0131-002,2017,5,6,13,750,630,1380,1578
0131-002,2017,5,6,14,780,694,1474,1380
0131-002,2017,5,6,15,795,800,1595,1474
0131-002,2017,5,6,16,789,863,1652,1595
0131-002,2017,5,6,17,807,990,1797,1652
0131-002,2017,5,6,18,924,1169,2093,1797
0131-002,2017,5,6,19,943,804,1747,2093
0131-002,2017,5,6,20,877,496,1373,1747
0131-002,2017,5,6,21,816,418,1234,1373
0131-002,2017,5,6,22,701,308,1009,1234
0131-002,2017,5,6,23,439,225,664,1009
0131-002,2017,5,6,24,269,122,391,664
0131-002,2017,5,7,1,186,84,270,391
0131-002,2017,5,7,2,115,54,169,270
0131-002,2017,5,7,3,139,58,197,169
0131-002,2017,5,7,4,110,44,154,197
0131-002,2017,5,7,5,149,51,200,154
0131-002,2017,5,7,6,209,68,277,200
0131-002,2017,5,7,7,314,133,447,277
0131-002,2017,5,7,8,416,235,651,447
0131-002,2017,5,7,9,464,407,871,651
0131-002,2017,5,7,10,540,447,987,871
0131-002,2017,5,7,11,614,593,1207,987
0131-002,2017,5,7,12,675,541,1216,1207
0131-002,2017,5,7,13,595,578,1173,1216
0131-002,2017,5,7,14,671,593,1264,1173
0131-002,2017,5,7,15,742,743,1485,1264
0131-002,2017,5,7,16,857,704,1561,1485
0131-002,2017,5,7,17,971,857,1828,1561
0131-002,2017,5,7,18,949,901,1850,1828
0131-002,2017,5,7,19,935,638,1573,1850
0131-002,2017,5,7,20,802,529,1331,1573
0131-002,2017,5,7,21,626,411,1037,1331
0131-002,2017,5,7,22,513,352,865,1037
0131-002,2017,5,7,23,403,220,623,865
0131-002,2017,5,7,24,275,98,373,623
0131-002,2017,5,8,1,211,67,278,373
0131-002,2017,5,8,2,180,40,220,278
0131-002,2017,5,8,3,61,21,82,220
0131-002,2017,5,8,4,98,27,125,82
0131-002,2017,5,8,5,194,56,250,125
0131-002,2017,5,8,6,392,133,525,250
0131-002,2017,5,8,7,816,539,1355,525
0131-002,2017,5,8,8,1045,1132,2177,1355
0131-002,2017,5,8,9,1125,1236,2361,2177
0131-002,2017,5,8,10,965,885,1850,2361
0131-002,2017,5,8,11,1067,983,2050,1850
0131-002,2017,5,8,12,973,868,1841,2050
0131-002,2017,5,8,13,926,781,1707,1841
0131-002,2017,5,8,14,982,934,1916,1707
0131-002,2017,5,8,15,998,960,1958,1916
0131-002,2017,5,8,16,970,995,1965,1958
0131-002,2017,5,8,17,984,1129,2113,1965
0131-002,2017,5,8,18,1005,1598,2603,2113
0131-002,2017,5,8,19,990,1410,2400,2603
0131-002,2017,5,8,20,885,1035,1920,2400
0131-002,2017,5,8,21,708,868,1576,1920
0131-002,2017,5,8,22,563,506,1069,1576
0131-002,2017,5,8,23,365,268,633,1069
0131-002,2017,5,8,24,257,164,421,633
0131-002,2017,5,9,1,225,115,340,421
0131-002,2017,5,9,2,139,74,213,340
0131-002,2017,5,9,3,100,34,134,213
0131-002,2017,5,9,4,104,39,143,134
0131-002,2017,5,9,5,176,77,253,143
0131-002,2017,5,9,6,292,84,376,253
0131-002,2017,5,9,7,543,345,888,376
0131-002,2017,5,9,8,755,694,1449,888
0131-002,2017,5,9,9,800,737,1537,1449
0131-002,2017,5,9,10,825,744,1569,1537
0131-002,2017,5,9,11,958,793,1751,1569
0131-002,2017,5,9,12,967,805,1772,1751
0131-002,2017,5,9,13,837,717,1554,1772
0131-002,2017,5,9,14,968,798,1766,1554
0131-002,2017,5,9,15,939,870,1809,1766
0131-002,2017,5,9,16,879,884,1763,1809
0131-002,2017,5,9,17,718,936,1654,1763
0131-002,2017,5,9,18,698,920,1618,1654
0131-002,2017,5,9,19,752,844,1596,1618
0131-002,2017,5,9,20,596,461,1057,1596
0131-002,2017,5,9,21,498,445,943,1057
0131-002,2017,5,9,22,391,348,739,943
0131-002,2017,5,9,23,248,266,514,739
0131-002,2017,5,9,24,170,228,398,514
0131-002,2017,5,10,1,111,173,284,398
0131-002,2017,5,10,2,70,107,177,284
0131-002,2017,5,10,3,57,101,158,177
0131-002,2017,5,10,4,76,91,167,158
0131-002,2017,5,10,5,125,89,214,167
0131-002,2017,5,10,6,322,112,434,214
0131-002,2017,5,10,7,795,482,1277,434
0131-002,2017,5,10,8,1569,1226,2795,1277
0131-002,2017,5,10,9,1385,1504,2889,2795
0131-002,2017,5,10,10,951,1280,2231,2889
0131-002,2017,5,10,11,1079,1436,2515,2231
0131-002,2017,5,10,12,1002,1182,2184,2515
0131-002,2017,5,10,13,835,1000,1835,2184
0131-002,2017,5,10,14,941,932,1873,1835
0131-002,2017,5,10,15,1090,990,2080,1873
0131-002,2017,5,10,16,1087,1028,2115,2080
0131-002,2017,5,10,17,932,1116,2048,2115
0131-002,2017,5,10,18,1076,1529,2605,2048
0131-002,2017,5,10,19,1073,1365,2438,2605
0131-002,2017,5,10,20,769,1005,1774,2438
0131-002,2017,5,10,21,627,774,1401,1774
0131-002,2017,5,10,22,494,525,1019,1401
0131-002,2017,5,10,23,331,312,643,1019
0131-002,2017,5,10,24,225,167,392,643
0131-002,2017,5,11,1,146,129,275,392
0131-002,2017,5,11,2,105,68,173,275
0131-002,2017,5,11,3,83,70,153,173
0131-002,2017,5,11,4,84,56,140,153
0131-002,2017,5,11,5,129,82,211,140
0131-002,2017,5,11,6,375,160,535,211
0131-002,2017,5,11,7,684,463,1147,535
0131-002,2017,5,11,8,1430,1097,2527,1147
0131-002,2017,5,11,9,1224,1372,2596,2527
0131-002,2017,5,11,10,975,1033,2008,2596
0131-002,2017,5,11,11,1103,1003,2106,2008
0131-002,2017,5,11,12,1032,996,2028,2106
0131-002,2017,5,11,13,891,762,1653,2028
0131-002,2017,5,11,14,1022,850,1872,1653
0131-002,2017,5,11,15,1027,1005,2032,1872
0131-002,2017,5,11,16,1062,1038,2100,2032
0131-002,2017,5,11,17,1060,1106,2166,2100
0131-002,2017,5,11,18,1101,1487,2588,2166
0131-002,2017,5,11,19,1046,1266,2312,2588
0131-002,2017,5,11,20,827,922,1749,2312
0131-002,2017,5,11,21,736,837,1573,1749
0131-002,2017,5,11,22,538,508,1046,1573
0131-002,2017,5,11,23,421,345,766,1046
0131-002,2017,5,11,24,230,167,397,766
0131-002,2017,5,12,1,180,112,292,397
0131-002,2017,5,12,2,136,74,210,292
0131-002,2017,5,12,3,88,46,134,210
0131-002,2017,5,12,4,102,34,136,134
0131-002,2017,5,12,5,138,82,220,136
0131-002,2017,5,12,6,385,136,521,220
0131-002,2017,5,12,7,850,473,1323,521
0131-002,2017,5,12,8,1646,1148,2794,1323
0131-002,2017,5,12,9,1394,1351,2745,2794
0131-002,2017,5,12,10,1197,1030,2227,2745
0131-002,2017,5,12,11,1140,1021,2161,2227
0131-002,2017,5,12,12,1043,937,1980,2161
0131-002,2017,5,12,13,943,863,1806,1980
0131-002,2017,5,12,14,1040,880,1920,1806
0131-002,2017,5,12,15,1185,1109,2294,1920
0131-002,2017,5,12,16,1196,1000,2196,2294
0131-002,2017,5,12,17,1100,1118,2218,2196
0131-002,2017,5,12,18,1257,1773,3030,2218
0131-002,2017,5,12,19,1239,1534,2773,3030
0131-002,2017,5,12,20,865,1149,2014,2773
0131-002,2017,5,12,21,691,840,1531,2014
0131-002,2017,5,12,22,579,480,1059,1531
0131-002,2017,5,12,23,355,320,675,1059
0131-002,2017,5,12,24,248,206,454,675
0131-002,2017,5,13,1,193,124,317,454
0131-002,2017,5,13,2,120,105,225,317
0131-002,2017,5,13,3,134,51,185,225
0131-002,2017,5,13,4,121,65,186,185
0131-002,2017,5,13,5,139,75,214,186
0131-002,2017,5,13,6,331,143,474,214
0131-002,2017,5,13,7,665,331,996,474
0131-002,2017,5,13,8,937,619,1556,996
0131-002,2017,5,13,9,962,974,1936,1556
0131-002,2017,5,13,10,953,870,1823,1936
0131-002,2017,5,13,11,1077,812,1889,1823
0131-002,2017,5,13,12,927,824,1751,1889
0131-002,2017,5,13,13,883,739,1622,1751
0131-002,2017,5,13,14,846,776,1622,1622
0131-002,2017,5,13,15,904,798,1702,1622
0131-002,2017,5,13,16,929,925,1854,1702
0131-002,2017,5,13,17,864,1118,1982,1854
0131-002,2017,5,13,18,922,1265,2187,1982
0131-002,2017,5,13,19,860,824,1684,2187
0131-002,2017,5,13,20,597,463,1060,1684
0131-002,2017,5,13,21,512,414,926,1060
0131-002,2017,5,13,22,402,289,691,926
0131-002,2017,5,13,23,329,199,528,691
0131-002,2017,5,13,24,200,148,348,528
0131-002,2017,5,14,1,142,173,315,348
0131-002,2017,5,14,2,106,126,232,315
0131-002,2017,5,14,3,86,113,199,232
0131-002,2017,5,14,4,65,94,159,199
0131-002,2017,5,14,5,91,74,165,159
0131-002,2017,5,14,6,218,190,408,165
0131-002,2017,5,14,7,333,461,794,408
0131-002,2017,5,14,8,429,628,1057,794
0131-002,2017,5,14,9,506,765,1271,1057
0131-002,2017,5,14,10,529,889,1418,1271
0131-002,2017,5,14,11,600,590,1190,1418
0131-002,2017,5,14,12,640,456,1096,1190
0131-002,2017,5,14,13,653,480,1133,1096
0131-002,2017,5,14,14,712,534,1246,1133
0131-002,2017,5,14,15,736,591,1327,1246
0131-002,2017,5,14,16,778,701,1479,1327
0131-002,2017,5,14,17,786,776,1562,1479
0131-002,2017,5,14,18,801,906,1707,1562
0131-002,2017,5,14,19,771,625,1396,1707
0131-002,2017,5,14,20,653,411,1064,1396
0131-002,2017,5,14,21,553,364,917,1064
0131-002,2017,5,14,22,490,312,802,917
0131-002,2017,5,14,23,349,206,555,802
0131-002,2017,5,14,24,239,122,361,555
0131-002,2017,5,15,1,147,51,198,361
0131-002,2017,5,15,2,100,60,160,198
0131-002,2017,5,15,3,75,18,93,160
0131-002,2017,5,15,4,66,23,89,93
0131-002,2017,5,15,5,146,56,202,89
0131-002,2017,5,15,6,448,152,600,202
0131-002,2017,5,15,7,855,550,1405,600
0131-002,2017,5,15,8,1615,1205,2820,1405
0131-002,2017,5,15,9,1412,1370,2782,2820
0131-002,2017,5,15,10,1113,887,2000,2782
0131-002,2017,5,15,11,1153,983,2136,2000
0131-002,2017,5,15,12,1075,911,1986,2136
0131-002,2017,5,15,13,922,795,1717,1986
0131-002,2017,5,15,14,1045,896,1941,1717
0131-002,2017,5,15,15,1097,944,2041,1941
0131-002,2017,5,15,16,1040,1099,2139,2041
0131-002,2017,5,15,17,987,1045,2032,2139
0131-002,2017,5,15,18,1033,1360,2393,2032
0131-002,2017,5,15,19,1046,1224,2270,2393
0131-002,2017,5,15,20,811,923,1734,2270
0131-002,2017,5,15,21,680,844,1524,1734
0131-002,2017,5,15,22,552,512,1064,1524
0131-002,2017,5,15,23,401,280,681,1064
0131-002,2017,5,15,24,250,155,405,681
0131-002,2017,5,16,1,170,87,257,405
0131-002,2017,5,16,2,124,74,198,257
0131-002,2017,5,16,3,87,30,117,198
0131-002,2017,5,16,4,108,54,162,117
0131-002,2017,5,16,5,158,84,242,162
0131-002,2017,5,16,6,413,136,549,242
0131-002,2017,5,16,7,886,451,1337,549
0131-002,2017,5,16,8,1521,1089,2610,1337
0131-002,2017,5,16,9,1375,1381,2756,2610
0131-002,2017,5,16,10,1222,1052,2274,2756
0131-002,2017,5,16,11,1179,918,2097,2274
0131-002,2017,5,16,12,1058,1005,2063,2097
0131-002,2017,5,16,13,935,767,1702,2063
0131-002,2017,5,16,14,996,880,1876,1702
0131-002,2017,5,16,15,1181,993,2174,1876
0131-002,2017,5,16,16,1029,991,2020,2174
0131-002,2017,5,16,17,1090,1106,2196,2020
0131-002,2017,5,16,18,1151,1482,2633,2196
0131-002,2017,5,16,19,1021,1275,2296,2633
0131-002,2017,5,16,20,874,833,1707,2296
0131-002,2017,5,16,21,695,833,1528,1707
0131-002,2017,5,16,22,536,459,995,1528
0131-002,2017,5,16,23,354,301,655,995
0131-002,2017,5,16,24,250,152,402,655
0131-002,2017,5,17,1,171,98,269,402
0131-002,2017,5,17,2,107,63,170,269
0131-002,2017,5,17,3,82,44,126,170
0131-002,2017,5,17,4,102,53,155,126
0131-002,2017,5,17,5,134,80,214,155
0131-002,2017,5,17,6,420,143,563,214
0131-002,2017,5,17,7,888,414,1302,563
0131-002,2017,5,17,8,1484,1111,2595,1302
0131-002,2017,5,17,9,1380,1344,2724,2595
0131-002,2017,5,17,10,1149,965,2114,2724
0131-002,2017,5,17,11,1133,941,2074,2114
0131-002,2017,5,17,12,1034,821,1855,2074
0131-002,2017,5,17,13,916,734,1650,1855
0131-002,2017,5,17,14,1006,918,1924,1650
0131-002,2017,5,17,15,1053,1045,2098,1924
0131-002,2017,5,17,16,1047,1090,2137,2098
0131-002,2017,5,17,17,1059,1010,2069,2137
0131-002,2017,5,17,18,1091,1529,2620,2069
0131-002,2017,5,17,19,1098,1374,2472,2620
0131-002,2017,5,17,20,834,922,1756,2472
0131-002,2017,5,17,21,617,758,1375,1756
0131-002,2017,5,17,22,528,485,1013,1375
0131-002,2017,5,17,23,375,280,655,1013
0131-002,2017,5,17,24,251,181,432,655
0131-002,2017,5,18,1,182,110,292,432
0131-002,2017,5,18,2,135,75,210,292
0131-002,2017,5,18,3,80,44,124,210
0131-002,2017,5,18,4,88,51,139,124
0131-002,2017,5,18,5,172,79,251,139
0131-002,2017,5,18,6,403,138,541,251
0131-002,2017,5,18,7,826,440,1266,541
0131-002,2017,5,18,8,1286,1184,2470,1266
0131-002,2017,5,18,9,1175,1372,2547,2470
0131-002,2017,5,18,10,1118,1002,2120,2547
0131-002,2017,5,18,11,1043,1005,2048,2120
0131-002,2017,5,18,12,1008,934,1942,2048
0131-002,2017,5,18,13,1015,751,1766,1942
0131-002,2017,5,18,14,1035,1003,2038,1766
0131-002,2017,5,18,15,1045,1132,2177,2038
0131-002,2017,5,18,16,1079,960,2039,2177
0131-002,2017,5,18,17,1033,1136,2169,2039
0131-002,2017,5,18,18,1062,1431,2493,2169
0131-002,2017,5,18,19,1032,1344,2376,2493
0131-002,2017,5,18,20,832,873,1705,2376
0131-002,2017,5,18,21,651,901,1552,1705
0131-002,2017,5,18,22,547,562,1109,1552
0131-002,2017,5,18,23,414,312,726,1109
0131-002,2017,5,18,24,257,140,397,726
0131-002,2017,5,19,1,196,117,313,397
0131-002,2017,5,19,2,135,72,207,313
0131-002,2017,5,19,3,109,40,149,207
0131-002,2017,5,19,4,118,49,167,149
0131-002,2017,5,19,5,154,56,210,167
0131-002,2017,5,19,6,416,167,583,210
0131-002,2017,5,19,7,819,407,1226,583
0131-002,2017,5,19,8,1135,1156,2291,1226
0131-002,2017,5,19,9,984,1412,2396,2291
0131-002,2017,5,19,10,906,1040,1946,2396
0131-002,2017,5,19,11,1001,1085,2086,1946
0131-002,2017,5,19,12,880,941,1821,2086
0131-002,2017,5,19,13,794,894,1688,1821
0131-002,2017,5,19,14,910,951,1861,1688
0131-002,2017,5,19,15,1058,1023,2081,1861
0131-002,2017,5,19,16,1025,1120,2145,2081
0131-002,2017,5,19,17,866,1276,2142,2145
0131-002,2017,5,19,18,973,1747,2720,2142
0131-002,2017,5,19,19,1165,1627,2792,2720
0131-002,2017,5,19,20,930,1127,2057,2792
0131-002,2017,5,19,21,739,875,1614,2057
0131-002,2017,5,19,22,565,524,1089,1614
0131-002,2017,5,19,23,407,366,773,1089
0131-002,2017,5,19,24,320,209,529,773
0131-002,2017,5,20,1,255,169,424,529
0131-002,2017,5,20,2,161,82,243,424
0131-002,2017,5,20,3,117,58,175,243
0131-002,2017,5,20,4,138,51,189,175
0131-002,2017,5,20,5,190,94,284,189
0131-002,2017,5,20,6,423,152,575,284
0131-002,2017,5,20,7,645,338,983,575
0131-002,2017,5,20,8,796,614,1410,983
0131-002,2017,5,20,9,805,950,1755,1410
0131-002,2017,5,20,10,812,946,1758,1755
0131-002,2017,5,20,11,855,882,1737,1758
0131-002,2017,5,20,12,751,850,1601,1737
0131-002,2017,5,20,13,829,724,1553,1601
0131-002,2017,5,20,14,756,783,1539,1553
0131-002,2017,5,20,15,759,837,1596,1539
0131-002,2017,5,20,16,819,953,1772,1596
0131-002,2017,5,20,17,837,1094,1931,1772
0131-002,2017,5,20,18,1016,1379,2395,1931
0131-002,2017,5,20,19,932,831,1763,2395
0131-002,2017,5,20,20,668,529,1197,1763
0131-002,2017,5,20,21,484,456,940,1197
0131-002,2017,5,20,22,476,294,770,940
0131-002,2017,5,20,23,349,192,541,770
0131-002,2017,5,20,24,254,173,427,541
0131-002,2017,5,21,1,198,115,313,427
0131-002,2017,5,21,2,147,77,224,313
0131-002,2017,5,21,3,109,34,143,224
0131-002,2017,5,21,4,101,28,129,143
0131-002,2017,5,21,5,131,40,171,129
0131-002,2017,5,21,6,247,115,362,171
0131-002,2017,5,21,7,350,164,514,362
0131-002,2017,5,21,8,451,277,728,514
0131-002,2017,5,21,9,506,369,875,728
0131-002,2017,5,21,10,548,489,1037,875
0131-002,2017,5,21,11,601,609,1210,1037
0131-002,2017,5,21,12,574,536,1110,1210
0131-002,2017,5,21,13,596,557,1153,1110
0131-002,2017,5,21,14,692,614,1306,1153
0131-002,2017,5,21,15,721,704,1425,1306
0131-002,2017,5,21,16,737,687,1424,1425
0131-002,2017,5,21,17,729,760,1489,1424
0131-002,2017,5,21,18,753,839,1592,1489
0131-002,2017,5,21,19,754,602,1356,1592
0131-002,2017,5,21,20,680,466,1146,1356
0131-002,2017,5,21,21,627,397,1024,1146
0131-002,2017,5,21,22,506,320,826,1024
0131-002,2017,5,21,23,372,180,552,826
0131-002,2017,5,21,24,242,129,371,552
0131-002,2017,5,22,1,172,53,225,371
0131-002,2017,5,22,2,111,46,157,225
0131-002,2017,5,22,3,73,20,93,157
0131-002,2017,5,22,4,110,34,144,93
0131-002,2017,5,22,5,150,54,204,144
0131-002,2017,5,22,6,437,147,584,204
0131-002,2017,5,22,7,756,538,1294,584
0131-002,2017,5,22,8,1057,1245,2302,1294
0131-002,2017,5,22,9,920,1316,2236,2302
0131-002,2017,5,22,10,859,991,1850,2236
0131-002,2017,5,22,11,912,913,1825,1850
0131-002,2017,5,22,12,875,892,1767,1825
0131-002,2017,5,22,13,836,807,1643,1767
0131-002,2017,5,22,14,907,786,1693,1643
0131-002,2017,5,22,15,931,957,1888,1693
0131-002,2017,5,22,16,910,923,1833,1888
0131-002,2017,5,22,17,879,1118,1997,1833
0131-002,2017,5,22,18,817,1405,2222,1997
0131-002,2017,5,22,19,842,1353,2195,2222
0131-002,2017,5,22,20,729,1012,1741,2195
0131-002,2017,5,22,21,570,897,1467,1741
0131-002,2017,5,22,22,532,494,1026,1467
0131-002,2017,5,22,23,397,275,672,1026
0131-002,2017,5,22,24,287,153,440,672
0131-002,2017,5,23,1,193,110,303,440
0131-002,2017,5,23,2,159,70,229,303
0131-002,2017,5,23,3,120,30,150,229
0131-002,2017,5,23,4,120,42,162,150
0131-002,2017,5,23,5,155,75,230,162
0131-002,2017,5,23,6,400,124,524,230
0131-002,2017,5,23,7,707,485,1192,524
0131-002,2017,5,23,8,999,1156,2155,1192
0131-002,2017,5,23,9,971,1386,2357,2155
0131-002,2017,5,23,10,868,1139,2007,2357
0131-002,2017,5,23,11,928,974,1902,2007
0131-002,2017,5,23,12,841,963,1804,1902
0131-002,2017,5,23,13,784,713,1497,1804
0131-002,2017,5,23,14,913,969,1882,1497
0131-002,2017,5,23,15,924,922,1846,1882
0131-002,2017,5,23,16,893,1003,1896,1846
0131-002,2017,5,23,17,849,1069,1918,1896
0131-002,2017,5,23,18,889,1511,2400,1918
0131-002,2017,5,23,19,925,1282,2207,2400
0131-002,2017,5,23,20,718,824,1542,2207
0131-002,2017,5,23,21,634,784,1418,1542
0131-002,2017,5,23,22,525,485,1010,1418
0131-002,2017,5,23,23,388,303,691,1010
0131-002,2017,5,23,24,268,143,411,691
0131-002,2017,5,24,1,169,105,274,411
0131-002,2017,5,24,2,166,70,236,274
0131-002,2017,5,24,3,92,28,120,236
0131-002,2017,5,24,4,98,27,125,120
0131-002,2017,5,24,5,144,67,211,125
0131-002,2017,5,24,6,350,138,488,211
0131-002,2017,5,24,7,733,407,1140,488
0131-002,2017,5,24,8,1350,1169,2519,1140
0131-002,2017,5,24,9,1151,1410,2561,2519
0131-002,2017,5,24,10,740,969,1709,2561
0131-002,2017,5,24,11,868,937,1805,1709
0131-002,2017,5,24,12,854,863,1717,1805
0131-002,2017,5,24,13,774,704,1478,1717
0131-002,2017,5,24,14,830,781,1611,1478
0131-002,2017,5,24,15,922,939,1861,1611
0131-002,2017,5,24,16,927,1063,1990,1861
0131-002,2017,5,24,17,996,1144,2140,1990
0131-002,2017,5,24,18,1084,1559,2643,2140
0131-002,2017,5,24,19,1086,1337,2423,2643
0131-002,2017,5,24,20,802,882,1684,2423
0131-002,2017,5,24,21,622,718,1340,1684
0131-002,2017,5,24,22,490,484,974,1340
0131-002,2017,5,24,23,364,301,665,974
0131-002,2017,5,24,24,207,173,380,665
0131-002,2017,5,25,1,142,89,231,380
0131-002,2017,5,25,2,119,74,193,231
0131-002,2017,5,25,3,76,44,120,193
0131-002,2017,5,25,4,67,42,109,120
0131-002,2017,5,25,5,124,68,192,109
0131-002,2017,5,25,6,382,153,535,192
0131-002,2017,5,25,7,737,447,1184,535
0131-002,2017,5,25,8,1346,1144,2490,1184
0131-002,2017,5,25,9,1179,1464,2643,2490
0131-002,2017,5,25,10,902,1071,1973,2643
0131-002,2017,5,25,11,863,1023,1886,1973
0131-002,2017,5,25,12,696,1047,1743,1886
0131-002,2017,5,25,13,660,877,1537,1743
0131-002,2017,5,25,14,788,892,1680,1537
0131-002,2017,5,25,15,840,1019,1859,1680
0131-002,2017,5,25,16,1020,1028,2048,1859
0131-002,2017,5,25,17,904,1130,2034,2048
0131-002,2017,5,25,18,1038,1622,2660,2034
0131-002,2017,5,25,19,943,1370,2313,2660
0131-002,2017,5,25,20,731,967,1698,2313
0131-002,2017,5,25,21,542,708,1250,1698
0131-002,2017,5,25,22,432,555,987,1250
0131-002,2017,5,25,23,337,360,697,987
0131-002,2017,5,25,24,224,150,374,697
0131-002,2017,5,26,1,201,120,321,374
0131-002,2017,5,26,2,122,68,190,321
0131-002,2017,5,26,3,90,37,127,190
0131-002,2017,5,26,4,121,37,158,127
0131-002,2017,5,26,5,163,74,237,158
0131-002,2017,5,26,6,395,173,568,237
0131-002,2017,5,26,7,844,461,1305,568
0131-002,2017,5,26,8,1594,1059,2653,1305
0131-002,2017,5,26,9,1531,1474,3005,2653
0131-002,2017,5,26,10,1123,1080,2203,3005
0131-002,2017,5,26,11,1175,1101,2276,2203
0131-002,2017,5,26,12,1069,1036,2105,2276
0131-002,2017,5,26,13,913,882,1795,2105
0131-002,2017,5,26,14,1045,962,2007,1795
0131-002,2017,5,26,15,947,1005,1952,2007
0131-002,2017,5,26,16,1026,1080,2106,1952
0131-002,2017,5,26,17,1044,1127,2171,2106
0131-002,2017,5,26,18,1108,1773,2881,2171
0131-002,2017,5,26,19,1214,1778,2992,2881
0131-002,2017,5,26,20,958,1209,2167,2992
0131-002,2017,5,26,21,669,871,1540,2167
0131-002,2017,5,26,22,592,525,1117,1540
0131-002,2017,5,26,23,403,353,756,1117
0131-002,2017,5,26,24,277,202,479,756
0131-002,2017,5,27,1,224,147,371,479
0131-002,2017,5,27,2,141,94,235,371
0131-002,2017,5,27,3,126,55,181,235
0131-002,2017,5,27,4,130,58,188,181
0131-002,2017,5,27,5,165,85,250,188
0131-002,2017,5,27,6,377,148,525,250
0131-002,2017,5,27,7,655,335,990,525
0131-002,2017,5,27,8,867,617,1484,990
0131-002,2017,5,27,9,884,962,1846,1484
0131-002,2017,5,27,10,883,908,1791,1846
0131-002,2017,5,27,11,966,847,1813,1791
0131-002,2017,5,27,12,839,837,1676,1813
0131-002,2017,5,27,13,856,732,1588,1676
0131-002,2017,5,27,14,801,780,1581,1588
0131-002,2017,5,27,15,832,818,1650,1581
0131-002,2017,5,27,16,874,939,1813,1650
0131-002,2017,5,27,17,851,1106,1957,1813
0131-002,2017,5,27,18,969,1322,2291,1957
0131-002,2017,5,27,19,896,828,1724,2291
0131-002,2017,5,27,20,633,496,1129,1724
0131-002,2017,5,27,21,498,435,933,1129
0131-002,2017,5,27,22,439,292,731,933
0131-002,2017,5,27,23,339,196,535,731
0131-002,2017,5,27,24,227,161,388,535
0131-002,2017,5,28,1,170,144,314,388
0131-002,2017,5,28,2,127,102,229,314
0131-002,2017,5,28,3,98,74,172,229
0131-002,2017,5,28,4,83,61,144,172
0131-002,2017,5,28,5,111,57,168,144
0131-002,2017,5,28,6,233,153,386,168
0131-002,2017,5,28,7,342,313,655,386
0131-002,2017,5,28,8,440,453,893,655
0131-002,2017,5,28,9,506,567,1073,893
0131-002,2017,5,28,10,539,689,1228,1073
0131-002,2017,5,28,11,601,600,1201,1228
0131-002,2017,5,28,12,607,496,1103,1201
0131-002,2017,5,28,13,625,519,1144,1103
0131-002,2017,5,28,14,702,574,1276,1144
0131-002,2017,5,28,15,729,648,1377,1276
0131-002,2017,5,28,16,758,694,1452,1377
0131-002,2017,5,28,17,758,768,1526,1452
0131-002,2017,5,28,18,777,873,1650,1526
0131-002,2017,5,28,19,763,614,1377,1650
0131-002,2017,5,28,20,667,439,1106,1377
0131-002,2017,5,28,21,590,381,971,1106
0131-002,2017,5,28,22,498,316,814,971
0131-002,2017,5,28,23,361,193,554,814
0131-002,2017,5,28,24,241,126,367,554
0131-002,2017,5,29,1,160,52,212,367
0131-002,2017,5,29,2,106,53,159,212
0131-002,2017,5,29,3,74,19,93,159
0131-002,2017,5,29,4,88,29,117,93
0131-002,2017,5,29,5,148,55,203,117
0131-002,2017,5,29,6,443,150,593,203
0131-002,2017,5,29,7,806,544,1350,593
0131-002,2017,5,29,8,1336,1225,2561,1350
0131-002,2017,5,29,9,1166,1343,2509,2561
0131-002,2017,5,29,10,986,939,1925,2509
0131-002,2017,5,29,11,1033,948,1981,1925
0131-002,2017,5,29,12,975,902,1877,1981
0131-002,2017,5,29,13,879,801,1680,1877
0131-002,2017,5,29,14,976,841,1817,1680
0131-002,2017,5,29,15,1014,951,1965,1817
0131-002,2017,5,29,16,975,1011,1986,1965
0131-002,2017,5,29,17,933,1082,2015,1986
0131-002,2017,5,29,18,925,1383,2308,2015
0131-002,2017,5,29,19,944,1289,2233,2308
0131-002,2017,5,29,20,770,968,1738,2233
0131-002,2017,5,29,21,625,871,1496,1738
0131-002,2017,5,29,22,542,503,1045,1496
0131-002,2017,5,29,23,399,278,677,1045
0131-002,2017,5,29,24,269,154,423,677
0131-002,2017,5,30,1,182,99,281,423
0131-002,2017,5,30,2,142,72,214,281
0131-002,2017,5,30,3,104,30,134,214
0131-002,2017,5,30,4,114,48,162,134
0131-002,2017,5,30,5,157,80,237,162
0131-002,2017,5,30,6,407,130,537,237
0131-002,2017,5,30,7,797,468,1265,537
0131-002,2017,5,30,8,1260,1123,2383,1265
0131-002,2017,5,30,9,1173,1384,2557,2383
0131-002,2017,5,30,10,1045,1096,2141,2557
0131-002,2017,5,30,11,1054,946,2000,2141
0131-002,2017,5,30,12,950,984,1934,2000
0131-002,2017,5,30,13,860,740,1600,1934
0131-002,2017,5,30,14,955,925,1880,1600
0131-002,2017,5,30,15,1053,958,2011,1880
0131-002,2017,5,30,16,961,997,1958,2011
0131-002,2017,5,30,17,970,1088,2058,1958
0131-002,2017,5,30,18,1020,1497,2517,2058
0131-002,2017,5,30,19,973,1279,2252,2517
0131-002,2017,5,30,20,796,829,1625,2252
0131-002,2017,5,30,21,665,809,1474,1625
0131-002,2017,5,30,22,531,472,1003,1474
0131-002,2017,5,30,23,371,302,673,1003
0131-002,2017,5,30,24,259,148,407,673
0131-002,2017,5,31,1,170,102,272,407
0131-002,2017,5,31,2,137,67,204,272
0131-002,2017,5,31,3,87,36,123,204
0131-002,2017,5,31,4,100,40,140,123
0131-002,2017,5,31,5,139,74,213,140
0131-002,2017,5,31,6,385,141,526,213
0131-002,2017,5,31,7,811,411,1222,526
0131-002,2017,5,31,8,1417,1140,2557,1222
0131-002,2017,5,31,9,1266,1377,2643,2557
0131-002,2017,5,31,10,945,967,1912,2643
0131-002,2017,5,31,11,1001,939,1940,1912
0131-002,2017,5,31,12,944,842,1786,1940
0131-002,2017,5,31,13,845,719,1564,1786
0131-002,2017,5,31,14,918,850,1768,1564
0131-002,2017,5,31,15,988,992,1980,1768
0131-002,2017,5,31,16,987,1077,2064,1980
0131-002,2017,5,31,17,930,1077,2007,2064
0131-002,2017,5,31,18,903,1544,2447,2007
0131-002,2017,5,31,19,909,1356,2265,2447
0131-002,2017,5,31,20,672,902,1574,2265
0131-002,2017,5,31,21,551,738,1289,1574
0131-002,2017,5,31,22,509,485,994,1289
0131-002,2017,5,31,23,370,291,661,994
0131-002,2017,5,31,24,229,177,406,661
0131-002,2017,6,1,1,164,87,251,406
0131-002,2017,6,1,2,116,41,157,251
0131-002,2017,6,1,3,101,37,138,157
0131-002,2017,6,1,4,114,44,158,138
0131-002,2017,6,1,5,141,85,226,158
0131-002,2017,6,1,6,254,130,384,226
0131-002,2017,6,1,7,782,411,1193,384
0131-002,2017,6,1,8,1316,968,2284,1193
0131-002,2017,6,1,9,1177,1036,2213,2284
0131-002,2017,6,1,10,1010,924,1934,2213
0131-002,2017,6,1,11,953,745,1698,1934
0131-002,2017,6,1,12,852,730,1582,1698
0131-002,2017,6,1,13,838,619,1457,1582
0131-002,2017,6,1,14,912,748,1660,1457
0131-002,2017,6,1,15,942,884,1826,1660
0131-002,2017,6,1,16,1050,859,1909,1826
0131-002,2017,6,1,17,968,990,1958,1909
0131-002,2017,6,1,18,1050,1334,2384,1958
0131-002,2017,6,1,19,988,1147,2135,2384
0131-002,2017,6,1,20,782,802,1584,2135
0131-002,2017,6,1,21,596,736,1332,1584
0131-002,2017,6,1,22,529,451,980,1332
0131-002,2017,6,1,23,415,285,700,980
0131-002,2017,6,1,24,271,164,435,700
0131-002,2017,6,2,1,215,88,303,435
0131-002,2017,6,2,2,159,68,227,303
0131-002,2017,6,2,3,114,76,190,227
0131-002,2017,6,2,4,168,47,215,190
0131-002,2017,6,2,5,221,71,292,215
0131-002,2017,6,2,6,377,145,522,292
0131-002,2017,6,2,7,712,401,1113,522
0131-002,2017,6,2,8,852,997,1849,1113
0131-002,2017,6,2,9,950,1225,2175,1849
0131-002,2017,6,2,10,819,973,1792,2175
0131-002,2017,6,2,11,720,921,1641,1792
0131-002,2017,6,2,12,659,893,1552,1641
0131-002,2017,6,2,13,656,785,1441,1552
0131-002,2017,6,2,14,850,810,1660,1441
0131-002,2017,6,2,15,938,924,1862,1660
0131-002,2017,6,2,16,912,1037,1949,1862
0131-002,2017,6,2,17,964,1053,2017,1949
0131-002,2017,6,2,18,1066,1588,2654,2017
0131-002,2017,6,2,19,1095,1627,2722,2654
0131-002,2017,6,2,20,950,1056,2006,2722
0131-002,2017,6,2,21,696,787,1483,2006
0131-002,2017,6,2,22,650,528,1178,1483
0131-002,2017,6,2,23,444,277,721,1178
0131-002,2017,6,2,24,325,217,542,721
0131-002,2017,6,3,1,271,128,399,542
0131-002,2017,6,3,2,185,88,273,399
0131-002,2017,6,3,3,139,53,192,273
0131-002,2017,6,3,4,134,67,201,192
0131-002,2017,6,3,5,168,74,242,201
0131-002,2017,6,3,6,388,150,538,242
0131-002,2017,6,3,7,618,333,951,538
0131-002,2017,6,3,8,780,574,1354,951
0131-002,2017,6,3,9,851,856,1707,1354
0131-002,2017,6,3,10,831,767,1598,1707
0131-002,2017,6,3,11,907,867,1774,1598
0131-002,2017,6,3,12,878,891,1769,1774
0131-002,2017,6,3,13,839,779,1618,1769
0131-002,2017,6,3,14,805,764,1569,1618
0131-002,2017,6,3,15,730,827,1557,1569
0131-002,2017,6,3,16,678,861,1539,1557
0131-002,2017,6,3,17,786,919,1705,1539
0131-002,2017,6,3,18,954,1180,2134,1705
0131-002,2017,6,3,19,918,716,1634,2134
0131-002,2017,6,3,20,691,514,1205,1634
0131-002,2017,6,3,21,533,405,938,1205
0131-002,2017,6,3,22,501,287,788,938
0131-002,2017,6,3,23,415,227,642,788
0131-002,2017,6,3,24,257,156,413,642
0131-002,2017,6,4,1,244,99,343,413
0131-002,2017,6,4,2,149,61,210,343
0131-002,2017,6,4,3,131,42,173,210
0131-002,2017,6,4,4,189,33,222,173
0131-002,2017,6,4,5,142,70,212,222
0131-002,2017,6,4,6,202,59,261,212
0131-002,2017,6,4,7,340,131,471,261
0131-002,2017,6,4,8,418,221,639,471
0131-002,2017,6,4,9,467,317,784,639
0131-002,2017,6,4,10,535,456,991,784
0131-002,2017,6,4,11,598,496,1094,991
0131-002,2017,6,4,12,653,430,1083,1094
0131-002,2017,6,4,13,650,479,1129,1083
0131-002,2017,6,4,14,629,485,1114,1129
0131-002,2017,6,4,15,530,622,1152,1114
0131-002,2017,6,4,16,655,670,1325,1152
0131-002,2017,6,4,17,810,642,1452,1325
0131-002,2017,6,4,18,785,680,1465,1452
0131-002,2017,6,4,19,756,602,1358,1465
0131-002,2017,6,4,20,609,411,1020,1358
0131-002,2017,6,4,21,628,376,1004,1020
0131-002,2017,6,4,22,502,314,816,1004
0131-002,2017,6,4,23,384,207,591,816
0131-002,2017,6,4,24,260,94,354,591
0131-002,2017,6,5,1,166,59,225,354
0131-002,2017,6,5,2,128,33,161,225
0131-002,2017,6,5,3,87,28,115,161
0131-002,2017,6,5,4,89,42,131,115
0131-002,2017,6,5,5,175,73,248,131
0131-002,2017,6,5,6,438,148,586,248
0131-002,2017,6,5,7,862,414,1276,586
0131-002,2017,6,5,8,1228,985,2213,1276
0131-002,2017,6,5,9,1065,1073,2138,2213
0131-002,2017,6,5,10,882,908,1790,2138
0131-002,2017,6,5,11,954,816,1770,1790
0131-002,2017,6,5,12,861,842,1703,1770
0131-002,2017,6,5,13,950,716,1666,1703
0131-002,2017,6,5,14,942,824,1766,1666
0131-002,2017,6,5,15,1018,964,1982,1766
0131-002,2017,6,5,16,916,879,1795,1982
0131-002,2017,6,5,17,890,1005,1895,1795
0131-002,2017,6,5,18,969,1295,2264,1895
0131-002,2017,6,5,19,775,1194,1969,2264
0131-002,2017,6,5,20,692,885,1577,1969
0131-002,2017,6,5,21,648,665,1313,1577
0131-002,2017,6,5,22,511,407,918,1313
0131-002,2017,6,5,23,374,233,607,918
0131-002,2017,6,5,24,267,142,409,607
0131-002,2017,6,6,1,240,101,341,409
0131-002,2017,6,6,2,146,71,217,341
0131-002,2017,6,6,3,125,64,189,217
0131-002,2017,6,6,4,101,54,155,189
0131-002,2017,6,6,5,172,79,251,155
0131-002,2017,6,6,6,364,119,483,251
0131-002,2017,6,6,7,659,296,955,483
0131-002,2017,6,6,8,878,507,1385,955
0131-002,2017,6,6,9,755,676,1431,1385
0131-002,2017,6,6,10,742,602,1344,1431
0131-002,2017,6,6,11,824,690,1514,1344
0131-002,2017,6,6,12,798,608,1406,1514
0131-002,2017,6,6,13,729,657,1386,1406
0131-002,2017,6,6,14,721,647,1368,1386
0131-002,2017,6,6,15,848,716,1564,1368
0131-002,2017,6,6,16,717,687,1404,1564
0131-002,2017,6,6,17,697,816,1513,1404
0131-002,2017,6,6,18,756,1073,1829,1513
0131-002,2017,6,6,19,640,704,1344,1829
0131-002,2017,6,6,20,375,357,732,1344
0131-002,2017,6,6,21,299,347,646,732
0131-002,2017,6,6,22,245,219,464,646
0131-002,2017,6,6,23,177,110,287,464
0131-002,2017,6,6,24,119,82,201,287
0131-002,2017,6,7,1,97,53,150,201
0131-002,2017,6,7,2,52,50,102,150
0131-002,2017,6,7,3,51,19,70,102
0131-002,2017,6,7,4,46,22,68,70
0131-002,2017,6,7,5,68,61,129,68
0131-002,2017,6,7,6,219,101,320,129
0131-002,2017,6,7,7,457,385,842,320
0131-002,2017,6,7,8,1384,984,2368,842
0131-002,2017,6,7,9,1208,1222,2430,2368
0131-002,2017,6,7,10,842,859,1701,2430
0131-002,2017,6,7,11,934,821,1755,1701
0131-002,2017,6,7,12,899,776,1675,1755
0131-002,2017,6,7,13,810,697,1507,1675
0131-002,2017,6,7,14,874,767,1641,1507
0131-002,2017,6,7,15,955,904,1859,1641
0131-002,2017,6,7,16,957,853,1810,1859
0131-002,2017,6,7,17,963,870,1833,1810
0131-002,2017,6,7,18,994,1219,2213,1833
0131-002,2017,6,7,19,998,1007,2005,2213
0131-002,2017,6,7,20,737,731,1468,2005
0131-002,2017,6,7,21,586,564,1150,1468
0131-002,2017,6,7,22,500,367,867,1150
0131-002,2017,6,7,23,195,245,440,867
0131-002,2017,6,7,24,124,131,255,440
0131-002,2017,6,8,1,135,74,209,255
0131-002,2017,6,8,2,70,57,127,209
0131-002,2017,6,8,3,56,41,97,127
0131-002,2017,6,8,4,63,41,104,97
0131-002,2017,6,8,5,109,70,179,104
0131-002,2017,6,8,6,249,144,393,179
0131-002,2017,6,8,7,400,405,805,393
0131-002,2017,6,8,8,1331,1004,2335,805
0131-002,2017,6,8,9,1178,1231,2409,2335
0131-002,2017,6,8,10,956,857,1813,2409
0131-002,2017,6,8,11,908,907,1815,1813
0131-002,2017,6,8,12,774,817,1591,1815
0131-002,2017,6,8,13,749,681,1430,1591
0131-002,2017,6,8,14,850,719,1569,1430
0131-002,2017,6,8,15,891,819,1710,1569
0131-002,2017,6,8,16,1035,773,1808,1710
0131-002,2017,6,8,17,936,887,1823,1808
0131-002,2017,6,8,18,1044,1208,2252,1823
0131-002,2017,6,8,19,966,1153,2119,2252
0131-002,2017,6,8,20,756,801,1557,2119
0131-002,2017,6,8,21,569,722,1291,1557
0131-002,2017,6,8,22,480,490,970,1291
0131-002,2017,6,8,23,376,288,664,970
0131-002,2017,6,8,24,144,150,294,664
0131-002,2017,6,9,1,137,85,222,294
0131-002,2017,6,9,2,75,74,149,222
0131-002,2017,6,9,3,68,57,125,149
0131-002,2017,6,9,4,63,56,119,125
0131-002,2017,6,9,5,86,91,177,119
0131-002,2017,6,9,6,234,130,364,177
0131-002,2017,6,9,7,417,404,821,364
0131-002,2017,6,9,8,1223,1048,2271,821
0131-002,2017,6,9,9,1240,1259,2499,2271
0131-002,2017,6,9,10,971,930,1901,2499
0131-002,2017,6,9,11,948,905,1853,1901
0131-002,2017,6,9,12,864,887,1751,1853
0131-002,2017,6,9,13,784,756,1540,1751
0131-002,2017,6,9,14,948,771,1719,1540
0131-002,2017,6,9,15,942,984,1926,1719
0131-002,2017,6,9,16,969,1039,2008,1926
0131-002,2017,6,9,17,1004,1061,2065,2008
0131-002,2017,6,9,18,1087,1594,2681,2065
0131-002,2017,6,9,19,1154,1536,2690,2681
0131-002,2017,6,9,20,954,1070,2024,2690
0131-002,2017,6,9,21,730,710,1440,2024
0131-002,2017,6,9,22,632,491,1123,1440
0131-002,2017,6,9,23,334,308,642,1123
0131-002,2017,6,9,24,269,164,433,642
0131-002,2017,6,10,1,224,114,338,433
0131-002,2017,6,10,2,152,77,229,338
0131-002,2017,6,10,3,113,45,158,229
0131-002,2017,6,10,4,99,53,152,158
0131-002,2017,6,10,5,167,96,263,152
0131-002,2017,6,10,6,352,150,502,263
0131-002,2017,6,10,7,643,353,996,502
0131-002,2017,6,10,8,901,559,1460,996
0131-002,2017,6,10,9,944,831,1775,1460
0131-002,2017,6,10,10,909,827,1736,1775
0131-002,2017,6,10,11,1011,821,1832,1736
0131-002,2017,6,10,12,903,751,1654,1832
0131-002,2017,6,10,13,872,857,1729,1654
0131-002,2017,6,10,14,817,662,1479,1729
0131-002,2017,6,10,15,850,642,1492,1479
0131-002,2017,6,10,16,915,824,1739,1492
0131-002,2017,6,10,17,926,945,1871,1739
0131-002,2017,6,10,18,953,1121,2074,1871
0131-002,2017,6,10,19,874,865,1739,2074
0131-002,2017,6,10,20,654,501,1155,1739
0131-002,2017,6,10,21,557,391,948,1155
0131-002,2017,6,10,22,484,291,775,948
0131-002,2017,6,10,23,339,162,501,775
0131-002,2017,6,10,24,249,156,405,501
0131-002,2017,6,11,1,196,96,292,405
0131-002,2017,6,11,2,159,73,232,292
0131-002,2017,6,11,3,82,47,129,232
0131-002,2017,6,11,4,81,45,126,129
0131-002,2017,6,11,5,96,84,180,126
0131-002,2017,6,11,6,214,73,287,180
0131-002,2017,6,11,7,311,97,408,287
0131-002,2017,6,11,8,331,181,512,408
0131-002,2017,6,11,9,473,288,761,512
0131-002,2017,6,11,10,535,381,916,761
0131-002,2017,6,11,11,554,410,964,916
0131-002,2017,6,11,12,680,487,1167,964
0131-002,2017,6,11,13,641,562,1203,1167
0131-002,2017,6,11,14,681,521,1202,1203
0131-002,2017,6,11,15,735,584,1319,1202
0131-002,2017,6,11,16,740,642,1382,1319
0131-002,2017,6,11,17,751,622,1373,1382
0131-002,2017,6,11,18,795,709,1504,1373
0131-002,2017,6,11,19,788,576,1364,1504
0131-002,2017,6,11,20,677,436,1113,1364
0131-002,2017,6,11,21,620,354,974,1113
0131-002,2017,6,11,22,525,265,790,974
0131-002,2017,6,11,23,374,179,553,790
0131-002,2017,6,11,24,237,97,334,553
0131-002,2017,6,12,1,154,44,198,334
0131-002,2017,6,12,2,115,54,169,198
0131-002,2017,6,12,3,88,31,119,169
0131-002,2017,6,12,4,102,36,138,119
0131-002,2017,6,12,5,188,67,255,138
0131-002,2017,6,12,6,367,154,521,255
0131-002,2017,6,12,7,746,484,1230,521
0131-002,2017,6,12,8,1518,1074,2592,1230
0131-002,2017,6,12,9,1318,1167,2485,2592
0131-002,2017,6,12,10,838,927,1765,2485
0131-002,2017,6,12,11,842,813,1655,1765
0131-002,2017,6,12,12,643,771,1414,1655
0131-002,2017,6,12,13,623,653,1276,1414
0131-002,2017,6,12,14,791,850,1641,1276
0131-002,2017,6,12,15,879,854,1733,1641
0131-002,2017,6,12,16,946,945,1891,1733
0131-002,2017,6,12,17,912,994,1906,1891
0131-002,2017,6,12,18,947,1157,2104,1906
0131-002,2017,6,12,19,860,1033,1893,2104
0131-002,2017,6,12,20,731,737,1468,1893
0131-002,2017,6,12,21,636,676,1312,1468
0131-002,2017,6,12,22,499,419,918,1312
0131-002,2017,6,12,23,323,211,534,918
0131-002,2017,6,12,24,196,134,330,534
0131-002,2017,6,13,1,195,82,277,330
0131-002,2017,6,13,2,143,65,208,277
0131-002,2017,6,13,3,91,54,145,208
0131-002,2017,6,13,4,123,42,165,145
0131-002,2017,6,13,5,162,104,266,165
0131-002,2017,6,13,6,297,151,448,266
0131-002,2017,6,13,7,458,397,855,448
0131-002,2017,6,13,8,1069,1041,2110,855
0131-002,2017,6,13,9,964,1335,2299,2110
0131-002,2017,6,13,10,894,934,1828,2299
0131-002,2017,6,13,11,939,851,1790,1828
0131-002,2017,6,13,12,874,794,1668,1790
0131-002,2017,6,13,13,794,756,1550,1668
0131-002,2017,6,13,14,838,768,1606,1550
0131-002,2017,6,13,15,950,884,1834,1606
0131-002,2017,6,13,16,839,885,1724,1834
0131-002,2017,6,13,17,834,862,1696,1724
0131-002,2017,6,13,18,888,1125,2013,1696
0131-002,2017,6,13,19,806,1179,1985,2013
0131-002,2017,6,13,20,586,802,1388,1985
0131-002,2017,6,13,21,482,731,1213,1388
0131-002,2017,6,13,22,481,504,985,1213
0131-002,2017,6,13,23,346,256,602,985
0131-002,2017,6,13,24,209,194,403,602
0131-002,2017,6,14,1,139,122,261,403
0131-002,2017,6,14,2,90,59,149,261
0131-002,2017,6,14,3,58,47,105,149
0131-002,2017,6,14,4,58,62,120,105
0131-002,2017,6,14,5,112,107,219,120
0131-002,2017,6,14,6,256,147,403,219
0131-002,2017,6,14,7,426,428,854,403
0131-002,2017,6,14,8,1400,987,2387,854
0131-002,2017,6,14,9,1237,1270,2507,2387
0131-002,2017,6,14,10,894,973,1867,2507
0131-002,2017,6,14,11,968,917,1885,1867
0131-002,2017,6,14,12,922,817,1739,1885
0131-002,2017,6,14,13,828,668,1496,1739
0131-002,2017,6,14,14,896,728,1624,1496
0131-002,2017,6,14,15,972,931,1903,1624
0131-002,2017,6,14,16,972,851,1823,1903
0131-002,2017,6,14,17,946,928,1874,1823
0131-002,2017,6,14,18,948,1261,2209,1874
0131-002,2017,6,14,19,954,1171,2125,2209
0131-002,2017,6,14,20,704,756,1460,2125
0131-002,2017,6,14,21,568,631,1199,1460
0131-002,2017,6,14,22,467,451,918,1199
0131-002,2017,6,14,23,321,259,580,918
0131-002,2017,6,14,24,157,156,313,580
0131-002,2017,6,15,1,126,97,223,313
0131-002,2017,6,15,2,79,61,140,223
0131-002,2017,6,15,3,56,50,106,140
0131-002,2017,6,15,4,66,54,120,106
0131-002,2017,6,15,5,107,97,204,120
0131-002,2017,6,15,6,270,168,438,204
0131-002,2017,6,15,7,516,417,933,438
0131-002,2017,6,15,8,788,1011,1799,933
0131-002,2017,6,15,9,981,1207,2188,1799
0131-002,2017,6,15,10,885,868,1753,2188
0131-002,2017,6,15,11,898,904,1802,1753
0131-002,2017,6,15,12,807,828,1635,1802
0131-002,2017,6,15,13,794,701,1495,1635
0131-002,2017,6,15,14,881,813,1694,1495
0131-002,2017,6,15,15,916,905,1821,1694
0131-002,2017,6,15,16,1042,871,1913,1821
0131-002,2017,6,15,17,952,965,1917,1913
0131-002,2017,6,15,18,1047,1153,2200,1917
0131-002,2017,6,15,19,977,1139,2116,2200
0131-002,2017,6,15,20,769,834,1603,2116
0131-002,2017,6,15,21,582,727,1309,1603
0131-002,2017,6,15,22,454,476,930,1309
0131-002,2017,6,15,23,396,288,684,930
0131-002,2017,6,15,24,208,185,393,684
0131-002,2017,6,16,1,228,91,319,393
0131-002,2017,6,16,2,143,73,216,319
0131-002,2017,6,16,3,152,53,205,216
0131-002,2017,6,16,4,132,62,194,205
0131-002,2017,6,16,5,217,87,304,194
0131-002,2017,6,16,6,364,205,569,304
0131-002,2017,6,16,7,630,396,1026,569
0131-002,2017,6,16,8,958,970,1928,1026
0131-002,2017,6,16,9,1062,1237,2299,1928
0131-002,2017,6,16,10,948,899,1847,2299
0131-002,2017,6,16,11,850,937,1787,1847
0131-002,2017,6,16,12,885,822,1707,1787
0131-002,2017,6,16,13,720,825,1545,1707
0131-002,2017,6,16,14,899,825,1724,1545
0131-002,2017,6,16,15,940,871,1811,1724
0131-002,2017,6,16,16,940,910,1850,1811
0131-002,2017,6,16,17,984,1068,2052,1850
0131-002,2017,6,16,18,1076,1545,2621,2052
0131-002,2017,6,16,19,1124,1494,2618,2621
0131-002,2017,6,16,20,952,1004,1956,2618
0131-002,2017,6,16,21,713,797,1510,1956
0131-002,2017,6,16,22,641,485,1126,1510
0131-002,2017,6,16,23,388,288,676,1126
0131-002,2017,6,16,24,229,190,419,676
0131-002,2017,6,17,1,176,131,307,419
0131-002,2017,6,17,2,108,71,179,307
0131-002,2017,6,17,3,81,73,154,179
0131-002,2017,6,17,4,71,64,135,154
0131-002,2017,6,17,5,102,125,227,135
0131-002,2017,6,17,6,231,157,388,227
0131-002,2017,6,17,7,339,334,673,388
0131-002,2017,6,17,8,840,561,1401,673
0131-002,2017,6,17,9,898,830,1728,1401
0131-002,2017,6,17,10,870,881,1751,1728
0131-002,2017,6,17,11,959,807,1766,1751
0131-002,2017,6,17,12,890,747,1637,1766
0131-002,2017,6,17,13,856,657,1513,1637
0131-002,2017,6,17,14,811,802,1613,1513
0131-002,2017,6,17,15,790,781,1571,1613
0131-002,2017,6,17,16,796,750,1546,1571
0131-002,2017,6,17,17,856,931,1787,1546
0131-002,2017,6,17,18,954,1081,2035,1787
0131-002,2017,6,17,19,896,859,1755,2035
0131-002,2017,6,17,20,672,533,1205,1755
0131-002,2017,6,17,21,545,399,944,1205
0131-002,2017,6,17,22,305,274,579,944
0131-002,2017,6,17,23,237,216,453,579
0131-002,2017,6,17,24,149,130,279,453
0131-002,2017,6,18,1,111,91,202,279
0131-002,2017,6,18,2,98,59,157,202
0131-002,2017,6,18,3,75,31,106,157
0131-002,2017,6,18,4,45,51,96,106
0131-002,2017,6,18,5,79,71,150,96
0131-002,2017,6,18,6,143,84,227,150
0131-002,2017,6,18,7,197,119,316,227
0131-002,2017,6,18,8,241,227,468,316
0131-002,2017,6,18,9,271,361,632,468
0131-002,2017,6,18,10,307,365,672,632
0131-002,2017,6,18,11,346,516,862,672
0131-002,2017,6,18,12,394,485,879,862
0131-002,2017,6,18,13,408,477,885,879
0131-002,2017,6,18,14,415,499,914,885
0131-002,2017,6,18,15,420,550,970,914
0131-002,2017,6,18,16,458,627,1085,970
0131-002,2017,6,18,17,460,614,1074,1085
0131-002,2017,6,18,18,494,690,1184,1074
0131-002,2017,6,18,19,474,428,902,1184
0131-002,2017,6,18,20,397,410,807,902
0131-002,2017,6,18,21,374,413,787,807
0131-002,2017,6,18,22,307,261,568,787
0131-002,2017,6,18,23,214,181,395,568
0131-002,2017,6,18,24,175,96,271,395
0131-002,2017,6,19,1,118,56,174,271
0131-002,2017,6,19,2,63,48,111,174
0131-002,2017,6,19,3,54,22,76,111
0131-002,2017,6,19,4,51,31,82,76
0131-002,2017,6,19,5,105,79,184,82
0131-002,2017,6,19,6,272,153,425,184
0131-002,2017,6,19,7,451,470,921,425
0131-002,2017,6,19,8,1373,988,2361,921
0131-002,2017,6,19,9,1192,1197,2389,2361
0131-002,2017,6,19,10,860,830,1690,2389
0131-002,2017,6,19,11,898,807,1705,1690
0131-002,2017,6,19,12,752,885,1637,1705
0131-002,2017,6,19,13,786,662,1448,1637
0131-002,2017,6,19,14,866,779,1645,1448
0131-002,2017,6,19,15,948,897,1845,1645
0131-002,2017,6,19,16,931,887,1818,1845
0131-002,2017,6,19,17,901,959,1860,1818
0131-002,2017,6,19,18,958,1244,2202,1860
0131-002,2017,6,19,19,818,1235,2053,2202
0131-002,2017,6,19,20,712,836,1548,2053
0131-002,2017,6,19,21,642,753,1395,1548
0131-002,2017,6,19,22,505,417,922,1395
0131-002,2017,6,19,23,348,257,605,922
0131-002,2017,6,19,24,143,171,314,605
0131-002,2017,6,20,1,102,76,178,314
0131-002,2017,6,20,2,93,62,155,178
0131-002,2017,6,20,3,57,47,104,155
0131-002,2017,6,20,4,54,51,105,104
0131-002,2017,6,20,5,113,105,218,105
0131-002,2017,6,20,6,231,162,393,218
0131-002,2017,6,20,7,448,456,904,393
0131-002,2017,6,20,8,1020,962,1982,904
0131-002,2017,6,20,9,956,1168,2124,1982
0131-002,2017,6,20,10,908,876,1784,2124
0131-002,2017,6,20,11,906,893,1799,1784
0131-002,2017,6,20,12,854,836,1690,1799
0131-002,2017,6,20,13,796,730,1526,1690
0131-002,2017,6,20,14,851,691,1542,1526
0131-002,2017,6,20,15,968,907,1875,1542
0131-002,2017,6,20,16,846,851,1697,1875
0131-002,2017,6,20,17,818,985,1803,1697
0131-002,2017,6,20,18,848,1277,2125,1803
0131-002,2017,6,20,19,803,1211,2014,2125
0131-002,2017,6,20,20,606,782,1388,2014
0131-002,2017,6,20,21,506,791,1297,1388
0131-002,2017,6,20,22,363,428,791,1297
0131-002,2017,6,20,23,262,257,519,791
0131-002,2017,6,20,24,134,164,298,519
0131-002,2017,6,21,1,109,88,197,298
0131-002,2017,6,21,2,81,59,140,197
0131-002,2017,6,21,3,53,47,100,140
0131-002,2017,6,21,4,57,47,104,100
0131-002,2017,6,21,5,107,88,195,104
0131-002,2017,6,21,6,251,153,404,195
0131-002,2017,6,21,7,424,461,885,404
0131-002,2017,6,21,8,1392,942,2334,885
0131-002,2017,6,21,9,1222,1191,2413,2334
0131-002,2017,6,21,10,868,902,1770,2413
0131-002,2017,6,21,11,951,887,1838,1770
0131-002,2017,6,21,12,910,784,1694,1838
0131-002,2017,6,21,13,819,799,1618,1694
0131-002,2017,6,21,14,885,805,1690,1618
0131-002,2017,6,21,15,964,897,1861,1690
0131-002,2017,6,21,16,964,913,1877,1861
0131-002,2017,6,21,17,954,1061,2015,1877
0131-002,2017,6,21,18,971,1502,2473,2015
0131-002,2017,6,21,19,976,1305,2281,2473
0131-002,2017,6,21,20,720,807,1527,2281
0131-002,2017,6,21,21,577,661,1238,1527
0131-002,2017,6,21,22,484,424,908,1238
0131-002,2017,6,21,23,241,273,514,908
0131-002,2017,6,21,24,145,181,326,514
0131-002,2017,6,22,1,195,114,309,326
0131-002,2017,6,22,2,115,68,183,309
0131-002,2017,6,22,3,93,36,129,183
0131-002,2017,6,22,4,101,64,165,129
0131-002,2017,6,22,5,195,82,277,165
0131-002,2017,6,22,6,409,176,585,277
0131-002,2017,6,22,7,627,454,1081,585
0131-002,2017,6,22,8,957,974,1931,1081
0131-002,2017,6,22,9,951,1191,2142,1931
0131-002,2017,6,22,10,905,927,1832,2142
0131-002,2017,6,22,11,918,908,1826,1832
0131-002,2017,6,22,12,844,865,1709,1826
0131-002,2017,6,22,13,768,688,1456,1709
0131-002,2017,6,22,14,771,744,1515,1456
0131-002,2017,6,22,15,884,964,1848,1515
0131-002,2017,6,22,16,939,899,1838,1848
0131-002,2017,6,22,17,880,1070,1950,1838
0131-002,2017,6,22,18,905,1358,2263,1950
0131-002,2017,6,22,19,843,1201,2044,2263
0131-002,2017,6,22,20,649,833,1482,2044
0131-002,2017,6,22,21,573,730,1303,1482
0131-002,2017,6,22,22,450,504,954,1303
0131-002,2017,6,22,23,325,297,622,954
0131-002,2017,6,22,24,259,184,443,622
0131-002,2017,6,23,1,183,97,280,443
0131-002,2017,6,23,2,115,57,172,280
0131-002,2017,6,23,3,72,50,122,172
0131-002,2017,6,23,4,89,48,137,122
0131-002,2017,6,23,5,180,93,273,137
0131-002,2017,6,23,6,343,174,517,273
0131-002,2017,6,23,7,697,439,1136,517
0131-002,2017,6,23,8,984,1030,2014,1136
0131-002,2017,6,23,9,943,1228,2171,2014
0131-002,2017,6,23,10,881,902,1783,2171
0131-002,2017,6,23,11,875,904,1779,1783
0131-002,2017,6,23,12,834,848,1682,1779
0131-002,2017,6,23,13,829,741,1570,1682
0131-002,2017,6,23,14,851,891,1742,1570
0131-002,2017,6,23,15,878,1085,1963,1742
0131-002,2017,6,23,16,866,1142,2008,1963
0131-002,2017,6,23,17,854,1259,2113,2008
0131-002,2017,6,23,18,927,1626,2553,2113
0131-002,2017,6,23,19,858,1547,2405,2553
0131-002,2017,6,23,20,712,970,1682,2405
0131-002,2017,6,23,21,617,793,1410,1682
0131-002,2017,6,23,22,528,471,999,1410
0131-002,2017,6,23,23,394,294,688,999
0131-002,2017,6,23,24,273,190,463,688
0131-002,2017,6,24,1,192,142,334,463
0131-002,2017,6,24,2,145,77,222,334
0131-002,2017,6,24,3,142,61,203,222
0131-002,2017,6,24,4,113,65,178,203
0131-002,2017,6,24,5,174,96,270,178
0131-002,2017,6,24,6,336,154,490,270
0131-002,2017,6,24,7,490,324,814,490
0131-002,2017,6,24,8,686,568,1254,814
0131-002,2017,6,24,9,735,757,1492,1254
0131-002,2017,6,24,10,727,734,1461,1492
0131-002,2017,6,24,11,720,747,1467,1461
0131-002,2017,6,24,12,729,688,1417,1467
0131-002,2017,6,24,13,686,719,1405,1417
0131-002,2017,6,24,14,701,690,1391,1405
0131-002,2017,6,24,15,697,836,1533,1391
0131-002,2017,6,24,16,663,888,1551,1533
0131-002,2017,6,24,17,668,954,1622,1551
0131-002,2017,6,24,18,802,1084,1886,1622
0131-002,2017,6,24,19,720,739,1459,1886
0131-002,2017,6,24,20,598,477,1075,1459
0131-002,2017,6,24,21,436,319,755,1075
0131-002,2017,6,24,22,389,259,648,755
0131-002,2017,6,24,23,328,156,484,648
0131-002,2017,6,24,24,211,114,325,484
0131-002,2017,6,25,1,165,77,242,325
0131-002,2017,6,25,2,107,64,171,242
0131-002,2017,6,25,3,110,34,144,171
0131-002,2017,6,25,4,101,34,135,144
0131-002,2017,6,25,5,103,56,159,135
0131-002,2017,6,25,6,160,50,210,159
0131-002,2017,6,25,7,281,102,383,210
0131-002,2017,6,25,8,352,205,557,383
0131-002,2017,6,25,9,401,319,720,557
0131-002,2017,6,25,10,441,353,794,720
0131-002,2017,6,25,11,550,401,951,794
0131-002,2017,6,25,12,523,430,953,951
0131-002,2017,6,25,13,567,477,1044,953
0131-002,2017,6,25,14,595,462,1057,1044
0131-002,2017,6,25,15,607,450,1057,1057
0131-002,2017,6,25,16,634,513,1147,1057
0131-002,2017,6,25,17,657,604,1261,1147
0131-002,2017,6,25,18,663,671,1334,1261
0131-002,2017,6,25,19,664,519,1183,1334
0131-002,2017,6,25,20,561,408,969,1183
0131-002,2017,6,25,21,502,325,827,969
0131-002,2017,6,25,22,435,219,654,827
0131-002,2017,6,25,23,340,145,485,654
0131-002,2017,6,25,24,238,102,340,485
0131-002,2017,6,26,1,142,68,210,340
0131-002,2017,6,26,2,104,41,145,210
0131-002,2017,6,26,3,64,25,89,145
0131-002,2017,6,26,4,77,28,105,89
0131-002,2017,6,26,5,165,71,236,105
0131-002,2017,6,26,6,378,134,512,236
0131-002,2017,6,26,7,694,462,1156,512
0131-002,2017,6,26,8,1093,1101,2194,1156
0131-002,2017,6,26,9,974,1090,2064,2194
0131-002,2017,6,26,10,838,844,1682,2064
0131-002,2017,6,26,11,884,888,1772,1682
0131-002,2017,6,26,12,829,817,1646,1772
0131-002,2017,6,26,13,770,728,1498,1646
0131-002,2017,6,26,14,887,767,1654,1498
0131-002,2017,6,26,15,1032,837,1869,1654
0131-002,2017,6,26,16,863,939,1802,1869
0131-002,2017,6,26,17,809,908,1717,1802
0131-002,2017,6,26,18,852,1165,2017,1717
0131-002,2017,6,26,19,779,1073,1852,2017
0131-002,2017,6,26,20,674,748,1422,1852
0131-002,2017,6,26,21,543,754,1297,1422
0131-002,2017,6,26,22,410,454,864,1297
0131-002,2017,6,26,23,304,205,509,864
0131-002,2017,6,26,24,205,147,352,509
0131-002,2017,6,27,1,174,84,258,352
0131-002,2017,6,27,2,124,45,169,258
0131-002,2017,6,27,3,84,17,101,169
0131-002,2017,6,27,4,84,51,135,101
0131-002,2017,6,27,5,148,90,238,135
0131-002,2017,6,27,6,383,173,556,238
0131-002,2017,6,27,7,671,416,1087,556
0131-002,2017,6,27,8,972,1050,2022,1087
0131-002,2017,6,27,9,948,1197,2145,2022
0131-002,2017,6,27,10,922,916,1838,2145
0131-002,2017,6,27,11,872,841,1713,1838
0131-002,2017,6,27,12,835,1051,1886,1713
0131-002,2017,6,27,13,797,671,1468,1886
0131-002,2017,6,27,14,864,719,1583,1468
0131-002,2017,6,27,15,987,941,1928,1583
0131-002,2017,6,27,16,852,816,1668,1928
0131-002,2017,6,27,17,803,924,1727,1668
0131-002,2017,6,27,18,808,1164,1972,1727
0131-002,2017,6,27,19,800,1164,1964,1972
0131-002,2017,6,27,20,625,690,1315,1964
0131-002,2017,6,27,21,531,688,1219,1315
0131-002,2017,6,27,22,430,448,878,1219
0131-002,2017,6,27,23,287,242,529,878
0131-002,2017,6,27,24,218,187,405,529
0131-002,2017,6,28,1,170,87,257,405
0131-002,2017,6,28,2,119,65,184,257
0131-002,2017,6,28,3,87,41,128,184
0131-002,2017,6,28,4,98,67,165,128
0131-002,2017,6,28,5,154,76,230,165
0131-002,2017,6,28,6,348,161,509,230
0131-002,2017,6,28,7,637,447,1084,509
0131-002,2017,6,28,8,1034,1001,2035,1084
0131-002,2017,6,28,9,986,1331,2317,2035
0131-002,2017,6,28,10,919,994,1913,2317
0131-002,2017,6,28,11,904,876,1780,1913
0131-002,2017,6,28,12,919,891,1810,1780
0131-002,2017,6,28,13,820,696,1516,1810
0131-002,2017,6,28,14,870,814,1684,1516
0131-002,2017,6,28,15,940,1010,1950,1684
0131-002,2017,6,28,16,889,927,1816,1950
0131-002,2017,6,28,17,844,993,1837,1816
0131-002,2017,6,28,18,849,1366,2215,1837
0131-002,2017,6,28,19,870,1345,2215,2215
0131-002,2017,6,28,20,558,748,1306,2215
0131-002,2017,6,28,21,515,641,1156,1306
0131-002,2017,6,28,22,450,441,891,1156
0131-002,2017,6,28,23,365,261,626,891
0131-002,2017,6,28,24,199,161,360,626
0131-002,2017,6,29,1,221,105,326,360
0131-002,2017,6,29,2,142,68,210,326
0131-002,2017,6,29,3,87,54,141,210
0131-002,2017,6,29,4,84,47,131,141
0131-002,2017,6,29,5,167,99,266,131
0131-002,2017,6,29,6,365,182,547,266
0131-002,2017,6,29,7,627,428,1055,547
0131-002,2017,6,29,8,981,910,1891,1055
0131-002,2017,6,29,9,953,1136,2089,1891
0131-002,2017,6,29,10,867,924,1791,2089
0131-002,2017,6,29,11,904,804,1708,1791
0131-002,2017,6,29,12,841,805,1646,1708
0131-002,2017,6,29,13,741,717,1458,1646
0131-002,2017,6,29,14,812,779,1591,1458
0131-002,2017,6,29,15,854,884,1738,1591
0131-002,2017,6,29,16,898,913,1811,1738
0131-002,2017,6,29,17,852,976,1828,1811
0131-002,2017,6,29,18,822,1362,2184,1828
0131-002,2017,6,29,19,832,1170,2002,2184
0131-002,2017,6,29,20,593,753,1346,2002
0131-002,2017,6,29,21,547,631,1178,1346
0131-002,2017,6,29,22,465,493,958,1178
0131-002,2017,6,29,23,346,277,623,958
0131-002,2017,6,29,24,238,182,420,623
0131-002,2017,6,30,1,180,130,310,420
0131-002,2017,6,30,2,125,71,196,310
0131-002,2017,6,30,3,104,59,163,196
0131-002,2017,6,30,4,96,53,149,163
0131-002,2017,6,30,5,180,87,267,149
0131-002,2017,6,30,6,387,171,558,267
0131-002,2017,6,30,7,649,425,1074,558
0131-002,2017,6,30,8,987,931,1918,1074
0131-002,2017,6,30,9,985,1141,2126,1918
0131-002,2017,6,30,10,774,777,1551,2126
0131-002,2017,6,30,11,861,799,1660,1551
0131-002,2017,6,30,12,893,816,1709,1660
0131-002,2017,6,30,13,753,657,1410,1709
0131-002,2017,6,30,14,802,848,1650,1410
0131-002,2017,6,30,15,832,973,1805,1650
0131-002,2017,6,30,16,881,1034,1915,1805
0131-002,2017,6,30,17,806,1110,1916,1915
0131-002,2017,6,30,18,846,1626,2472,1916
0131-002,2017,6,30,19,854,1633,2487,2472
0131-002,2017,6,30,20,686,925,1611,2487
0131-002,2017,6,30,21,593,677,1270,1611
0131-002,2017,6,30,22,535,428,963,1270
0131-002,2017,6,30,23,352,294,646,963
0131-002,2017,6,30,24,269,177,446,646
0131-002,2017,9,9,1,178,194,372,446
0131-002,2017,9,9,2,147,149,296,372
0131-002,2017,9,9,3,105,114,219,296
0131-002,2017,9,9,4,99,111,210,219
0131-002,2017,9,9,5,141,130,271,210
0131-002,2017,9,9,6,316,264,580,271
0131-002,2017,9,9,7,639,553,1192,580
0131-002,2017,9,9,8,1017,893,1910,1192
0131-002,2017,9,9,9,1017,1079,2096,1910
0131-002,2017,9,9,10,966,1055,2021,2096
0131-002,2017,9,9,11,1057,1066,2123,2021
0131-002,2017,9,9,12,1158,1162,2320,2123
0131-002,2017,9,9,13,1033,1119,2152,2320
0131-002,2017,9,9,14,1110,1094,2204,2152
0131-002,2017,9,9,15,1094,1053,2147,2204
0131-002,2017,9,9,16,1018,1093,2111,2147
0131-002,2017,9,9,17,1061,1260,2321,2111
0131-002,2017,9,9,18,1125,1513,2638,2321
0131-002,2017,9,9,19,1077,1166,2243,2638
0131-002,2017,9,9,20,751,804,1555,2243
0131-002,2017,9,9,21,577,555,1132,1555
0131-002,2017,9,9,22,419,393,812,1132
0131-002,2017,9,9,23,319,303,622,812
0131-002,2017,9,9,24,212,216,428,622
0131-002,2017,9,10,1,160,185,345,428
0131-002,2017,9,10,2,104,107,211,345
0131-002,2017,9,10,3,75,82,157,211
0131-002,2017,9,10,4,60,73,133,157
0131-002,2017,9,10,5,80,91,171,133
0131-002,2017,9,10,6,184,144,328,171
0131-002,2017,9,10,7,326,258,584,328
0131-002,2017,9,10,8,437,453,890,584
0131-002,2017,9,10,9,473,527,1000,890
0131-002,2017,9,10,10,519,609,1128,1000
0131-002,2017,9,10,11,634,709,1343,1128
0131-002,2017,9,10,12,672,699,1371,1343
0131-002,2017,9,10,13,679,702,1381,1371
0131-002,2017,9,10,14,762,748,1510,1381
0131-002,2017,9,10,15,826,846,1672,1510
0131-002,2017,9,10,16,884,951,1835,1672
0131-002,2017,9,10,17,847,951,1798,1835
0131-002,2017,9,10,18,871,1081,1952,1798
0131-002,2017,9,10,19,875,908,1783,1952
0131-002,2017,9,10,20,654,726,1380,1783
0131-002,2017,9,10,21,582,530,1112,1380
0131-002,2017,9,10,22,491,372,863,1112
0131-002,2017,9,10,23,334,242,576,863
0131-002,2017,9,10,24,242,179,421,576
0131-002,2017,9,11,1,124,102,226,421
0131-002,2017,9,11,2,79,68,147,226
0131-002,2017,9,11,3,60,62,122,147
0131-002,2017,9,11,4,75,63,138,122
0131-002,2017,9,11,5,97,101,198,138
0131-002,2017,9,11,6,318,195,513,198
0131-002,2017,9,11,7,824,518,1342,513
0131-002,2017,9,11,8,1724,1201,2925,1342
0131-002,2017,9,11,9,1511,1332,2843,2925
0131-002,2017,9,11,10,1066,1032,2098,2843
0131-002,2017,9,11,11,1037,1038,2075,2098
0131-002,2017,9,11,12,940,946,1886,2075
0131-002,2017,9,11,13,928,886,1814,1886
0131-002,2017,9,11,14,1033,1007,2040,1814
0131-002,2017,9,11,15,1049,1124,2173,2040
0131-002,2017,9,11,16,1017,1156,2173,2173
0131-002,2017,9,11,17,988,1132,2120,2173
0131-002,2017,9,11,18,1066,1401,2467,2120
0131-002,2017,9,11,19,1120,1295,2415,2467
0131-002,2017,9,11,20,794,986,1780,2415
0131-002,2017,9,11,21,541,831,1372,1780
0131-002,2017,9,11,22,480,582,1062,1372
0131-002,2017,9,11,23,339,323,662,1062
0131-002,2017,9,11,24,185,207,392,662
0131-002,2017,9,12,1,164,165,329,392
0131-002,2017,9,12,2,103,95,198,329
0131-002,2017,9,12,3,79,98,177,198
0131-002,2017,9,12,4,79,98,177,177
0131-002,2017,9,12,5,123,140,263,177
0131-002,2017,9,12,6,373,240,613,263
0131-002,2017,9,12,7,894,588,1482,613
0131-002,2017,9,12,8,1753,1232,2985,1482
0131-002,2017,9,12,9,1422,1050,2472,2985
0131-002,2017,9,12,10,1068,1174,2242,2472
0131-002,2017,9,12,11,1130,1155,2285,2242
0131-002,2017,9,12,12,1067,1092,2159,2285
0131-002,2017,9,12,13,927,985,1912,2159
0131-002,2017,9,12,14,1055,1083,2138,1912
0131-002,2017,9,12,15,1076,1211,2287,2138
0131-002,2017,9,12,16,1133,1213,2346,2287
0131-002,2017,9,12,17,1040,1232,2272,2346
0131-002,2017,9,12,18,1202,1578,2780,2272
0131-002,2017,9,12,19,1120,1424,2544,2780
0131-002,2017,9,12,20,830,1056,1886,2544
0131-002,2017,9,12,21,608,904,1512,1886
0131-002,2017,9,12,22,557,581,1138,1512
0131-002,2017,9,12,23,382,368,750,1138
0131-002,2017,9,12,24,199,231,430,750
0131-002,2017,9,13,1,152,170,322,430
0131-002,2017,9,13,2,91,122,213,322
0131-002,2017,9,13,3,85,70,155,213
0131-002,2017,9,13,4,84,80,164,155
0131-002,2017,9,13,5,115,133,248,164
0131-002,2017,9,13,6,354,261,615,248
0131-002,2017,9,13,7,940,592,1532,615
0131-002,2017,9,13,8,1705,1156,2861,1532
0131-002,2017,9,13,9,1513,1446,2959,2861
0131-002,2017,9,13,10,1083,1128,2211,2959
0131-002,2017,9,13,11,1142,1166,2308,2211
0131-002,2017,9,13,12,1037,1072,2109,2308
0131-002,2017,9,13,13,840,896,1736,2109
0131-002,2017,9,13,14,1005,1046,2051,1736
0131-002,2017,9,13,15,1128,1216,2344,2051
0131-002,2017,9,13,16,1127,1251,2378,2344
0131-002,2017,9,13,17,984,1285,2269,2378
0131-002,2017,9,13,18,1163,1726,2889,2269
0131-002,2017,9,13,19,1202,1431,2633,2889
0131-002,2017,9,13,20,846,1036,1882,2633
0131-002,2017,9,13,21,596,810,1406,1882
0131-002,2017,9,13,22,514,588,1102,1406
0131-002,2017,9,13,23,396,399,795,1102
0131-002,2017,9,13,24,221,258,479,795
0131-002,2017,9,14,1,175,180,355,479
0131-002,2017,9,14,2,100,111,211,355
0131-002,2017,9,14,3,90,108,198,211
0131-002,2017,9,14,4,92,107,199,198
0131-002,2017,9,14,5,144,133,277,199
0131-002,2017,9,14,6,379,268,647,277
0131-002,2017,9,14,7,908,596,1504,647
0131-002,2017,9,14,8,1700,1237,2937,1504
0131-002,2017,9,14,9,1472,1488,2960,2937
0131-002,2017,9,14,10,1103,1146,2249,2960
0131-002,2017,9,14,11,1060,1204,2264,2249
0131-002,2017,9,14,12,1061,1194,2255,2264
0131-002,2017,9,14,13,900,991,1891,2255
0131-002,2017,9,14,14,1030,1107,2137,1891
0131-002,2017,9,14,15,1142,1312,2454,2137
0131-002,2017,9,14,16,1173,1266,2439,2454
0131-002,2017,9,14,17,1153,1350,2503,2439
0131-002,2017,9,14,18,1194,1623,2817,2503
0131-002,2017,9,14,19,1175,1445,2620,2817
0131-002,2017,9,14,20,783,1038,1821,2620
0131-002,2017,9,14,21,626,907,1533,1821
0131-002,2017,9,14,22,582,599,1181,1533
0131-002,2017,9,14,23,426,364,790,1181
0131-002,2017,9,14,24,220,238,458,790
0131-002,2017,9,15,1,153,172,325,458
0131-002,2017,9,15,2,107,98,205,325
0131-002,2017,9,15,3,72,77,149,205
0131-002,2017,9,15,4,81,99,180,149
0131-002,2017,9,15,5,135,145,280,180
0131-002,2017,9,15,6,379,259,638,280
0131-002,2017,9,15,7,880,630,1510,638
0131-002,2017,9,15,8,1749,1229,2978,1510
0131-002,2017,9,15,9,1562,1415,2977,2978
0131-002,2017,9,15,10,1203,1201,2404,2977
0131-002,2017,9,15,11,1146,1330,2476,2404
0131-002,2017,9,15,12,1072,1224,2296,2476
0131-002,2017,9,15,13,951,1066,2017,2296
0131-002,2017,9,15,14,1078,1174,2252,2017
0131-002,2017,9,15,15,1336,1308,2644,2252
0131-002,2017,9,15,16,1407,1294,2701,2644
0131-002,2017,9,15,17,1201,1550,2751,2701
0131-002,2017,9,15,18,1263,1891,3154,2751
0131-002,2017,9,15,19,1299,1807,3106,3154
0131-002,2017,9,15,20,969,1237,2206,3106
0131-002,2017,9,15,21,745,991,1736,2206
0131-002,2017,9,15,22,553,691,1244,1736
0131-002,2017,9,15,23,401,408,809,1244
0131-002,2017,9,15,24,268,308,576,809
0131-002,2017,9,16,1,208,193,401,576
0131-002,2017,9,16,2,131,147,278,401
0131-002,2017,9,16,3,113,126,239,278
0131-002,2017,9,16,4,104,117,221,239
0131-002,2017,9,16,5,146,167,313,221
0131-002,2017,9,16,6,345,243,588,313
0131-002,2017,9,16,7,661,601,1262,588
0131-002,2017,9,16,8,1023,870,1893,1262
0131-002,2017,9,16,9,1074,1140,2214,1893
0131-002,2017,9,16,10,1054,1140,2194,2214
0131-002,2017,9,16,11,1093,1146,2239,2194
0131-002,2017,9,16,12,1093,1111,2204,2239
0131-002,2017,9,16,13,1037,1027,2064,2204
0131-002,2017,9,16,14,1053,1143,2196,2064
0131-002,2017,9,16,15,1026,1116,2142,2196
0131-002,2017,9,16,16,1037,1220,2257,2142
0131-002,2017,9,16,17,1060,1291,2351,2257
0131-002,2017,9,16,18,1183,1537,2720,2351
0131-002,2017,9,16,19,1196,1177,2373,2720
0131-002,2017,9,16,20,867,830,1697,2373
0131-002,2017,9,16,21,599,574,1173,1697
0131-002,2017,9,16,22,507,468,975,1173
0131-002,2017,9,16,23,355,311,666,975
0131-002,2017,9,16,24,225,260,485,666
0131-002,2017,9,17,1,172,170,342,485
0131-002,2017,9,17,2,113,130,243,342
0131-002,2017,9,17,3,80,101,181,243
0131-002,2017,9,17,4,72,73,145,181
0131-002,2017,9,17,5,97,101,198,145
0131-002,2017,9,17,6,198,193,391,198
0131-002,2017,9,17,7,345,335,680,391
0131-002,2017,9,17,8,544,509,1053,680
0131-002,2017,9,17,9,520,648,1168,1053
0131-002,2017,9,17,10,562,651,1213,1168
0131-002,2017,9,17,11,682,774,1456,1213
0131-002,2017,9,17,12,701,727,1428,1456
0131-002,2017,9,17,13,682,812,1494,1428
0131-002,2017,9,17,14,825,839,1664,1494
0131-002,2017,9,17,15,984,918,1902,1664
0131-002,2017,9,17,16,1047,969,2016,1902
0131-002,2017,9,17,17,1040,997,2037,2016
0131-002,2017,9,17,18,1106,1149,2255,2037
0131-002,2017,9,17,19,1190,928,2118,2255
0131-002,2017,9,17,20,1108,725,1833,2118
0131-002,2017,9,17,21,944,674,1618,1833
0131-002,2017,9,17,22,666,481,1147,1618
0131-002,2017,9,17,23,377,277,654,1147
0131-002,2017,9,17,24,215,166,381,654
0131-002,2017,9,18,1,138,102,240,381
0131-002,2017,9,18,2,95,66,161,240
0131-002,2017,9,18,3,73,71,144,161
0131-002,2017,9,18,4,82,88,170,144
0131-002,2017,9,18,5,147,124,271,170
0131-002,2017,9,18,6,438,253,691,271
0131-002,2017,9,18,7,972,672,1644,691
0131-002,2017,9,18,8,1866,1345,3211,1644
0131-002,2017,9,18,9,1551,1394,2945,3211
0131-002,2017,9,18,10,1103,1179,2282,2945
0131-002,2017,9,18,11,1111,1187,2298,2282
0131-002,2017,9,18,12,1129,1114,2243,2298
0131-002,2017,9,18,13,928,973,1901,2243
0131-002,2017,9,18,14,1123,1093,2216,1901
0131-002,2017,9,18,15,1161,1214,2375,2216
0131-002,2017,9,18,16,1127,1235,2362,2375
0131-002,2017,9,18,17,1099,1324,2423,2362
0131-002,2017,9,18,18,1106,1591,2697,2423
0131-002,2017,9,18,19,1107,1414,2521,2697
0131-002,2017,9,18,20,804,1002,1806,2521
0131-002,2017,9,18,21,633,877,1510,1806
0131-002,2017,9,18,22,512,586,1098,1510
0131-002,2017,9,18,23,309,378,687,1098
0131-002,2017,9,18,24,170,208,378,687
0131-002,2017,9,19,1,138,138,276,378
0131-002,2017,9,19,2,98,101,199,276
0131-002,2017,9,19,3,71,86,157,199
0131-002,2017,9,19,4,85,113,198,157
0131-002,2017,9,19,5,136,133,269,198
0131-002,2017,9,19,6,364,273,637,269
0131-002,2017,9,19,7,901,602,1503,637
0131-002,2017,9,19,8,1765,1282,3047,1503
0131-002,2017,9,19,9,1440,1459,2899,3047
0131-002,2017,9,19,10,1123,1244,2367,2899
0131-002,2017,9,19,11,1144,1227,2371,2367
0131-002,2017,9,19,12,993,1180,2173,2371
0131-002,2017,9,19,13,952,997,1949,2173
0131-002,2017,9,19,14,1079,1104,2183,1949
0131-002,2017,9,19,15,1097,1234,2331,2183
0131-002,2017,9,19,16,1173,1239,2412,2331
0131-002,2017,9,19,17,1080,1270,2350,2412
0131-002,2017,9,19,18,1173,1638,2811,2350
0131-002,2017,9,19,19,1093,1287,2380,2811
0131-002,2017,9,19,20,812,1027,1839,2380
0131-002,2017,9,19,21,665,921,1586,1839
0131-002,2017,9,19,22,535,582,1117,1586
0131-002,2017,9,19,23,356,371,727,1117
0131-002,2017,9,19,24,186,247,433,727
0131-002,2017,9,20,1,167,163,330,433
0131-002,2017,9,20,2,87,98,185,330
0131-002,2017,9,20,3,84,79,163,185
0131-002,2017,9,20,4,81,102,183,163
0131-002,2017,9,20,5,148,139,287,183
0131-002,2017,9,20,6,389,274,663,287
0131-002,2017,9,20,7,916,644,1560,663
0131-002,2017,9,20,8,1781,1245,3026,1560
0131-002,2017,9,20,9,1492,1473,2965,3026
0131-002,2017,9,20,10,1141,1224,2365,2965
0131-002,2017,9,20,11,1177,1240,2417,2365
0131-002,2017,9,20,12,1117,1179,2296,2417
0131-002,2017,9,20,13,994,1003,1997,2296
0131-002,2017,9,20,14,1126,1202,2328,1997
0131-002,2017,9,20,15,1207,1306,2513,2328
0131-002,2017,9,20,16,1169,1237,2406,2513
0131-002,2017,9,20,17,1154,1298,2452,2406
0131-002,2017,9,20,18,1200,1766,2966,2452
0131-002,2017,9,20,19,1103,1507,2610,2966
0131-002,2017,9,20,20,836,1039,1875,2610
0131-002,2017,9,20,21,589,808,1397,1875
0131-002,2017,9,20,22,518,584,1102,1397
0131-002,2017,9,20,23,346,367,713,1102
0131-002,2017,9,20,24,230,237,467,713
0131-002,2017,9,21,1,157,191,348,467
0131-002,2017,9,21,2,105,130,235,348
0131-002,2017,9,21,3,84,100,184,235
0131-002,2017,9,21,4,82,99,181,184
0131-002,2017,9,21,5,130,115,245,181
0131-002,2017,9,21,6,339,238,577,245
0131-002,2017,9,21,7,946,601,1547,577
0131-002,2017,9,21,8,1706,1245,2951,1547
0131-002,2017,9,21,9,1533,1453,2986,2951
0131-002,2017,9,21,10,1138,1277,2415,2986
0131-002,2017,9,21,11,1161,1259,2420,2415
0131-002,2017,9,21,12,1088,1168,2256,2420
0131-002,2017,9,21,13,933,1042,1975,2256
0131-002,2017,9,21,14,1064,1138,2202,1975
0131-002,2017,9,21,15,1120,1249,2369,2202
0131-002,2017,9,21,16,1184,1288,2472,2369
0131-002,2017,9,21,17,1177,1360,2537,2472
0131-002,2017,9,21,18,1182,1639,2821,2537
0131-002,2017,9,21,19,1096,1406,2502,2821
0131-002,2017,9,21,20,849,1016,1865,2502
0131-002,2017,9,21,21,663,885,1548,1865
0131-002,2017,9,21,22,570,632,1202,1548
0131-002,2017,9,21,23,367,389,756,1202
0131-002,2017,9,21,24,231,264,495,756
0131-002,2017,9,22,1,178,180,358,495
0131-002,2017,9,22,2,116,101,217,358
0131-002,2017,9,22,3,90,90,180,217
0131-002,2017,9,22,4,89,105,194,180
0131-002,2017,9,22,5,152,146,298,194
0131-002,2017,9,22,6,408,306,714,298
0131-002,2017,9,22,7,904,659,1563,714
0131-002,2017,9,22,8,1707,1263,2970,1563
0131-002,2017,9,22,9,1509,1489,2998,2970
0131-002,2017,9,22,10,1181,1254,2435,2998
0131-002,2017,9,22,11,1183,1310,2493,2435
0131-002,2017,9,22,12,1057,1171,2228,2493
0131-002,2017,9,22,13,961,1003,1964,2228
0131-002,2017,9,22,14,1083,1169,2252,1964
0131-002,2017,9,22,15,1144,1262,2406,2252
0131-002,2017,9,22,16,1117,1283,2400,2406
0131-002,2017,9,22,17,1179,1462,2641,2400
0131-002,2017,9,22,18,1318,1832,3150,2641
0131-002,2017,9,22,19,1237,1812,3049,3150
0131-002,2017,9,22,20,968,1266,2234,3049
0131-002,2017,9,22,21,749,1000,1749,2234
0131-002,2017,9,22,22,582,623,1205,1749
0131-002,2017,9,22,23,403,423,826,1205
0131-002,2017,9,22,24,258,275,533,826
0131-002,2017,9,23,1,174,198,372,533
0131-002,2017,9,23,2,138,124,262,372
0131-002,2017,9,23,3,105,112,217,262
0131-002,2017,9,23,4,106,121,227,217
0131-002,2017,9,23,5,148,145,293,227
0131-002,2017,9,23,6,323,297,620,293
0131-002,2017,9,23,7,716,587,1303,620
0131-002,2017,9,23,8,1033,919,1952,1303
0131-002,2017,9,23,9,1124,1198,2322,1952
0131-002,2017,9,23,10,1012,1127,2139,2322
0131-002,2017,9,23,11,1078,1208,2286,2139
0131-002,2017,9,23,12,1034,1085,2119,2286
0131-002,2017,9,23,13,974,1068,2042,2119
0131-002,2017,9,23,14,980,1048,2028,2042
0131-002,2017,9,23,15,1030,1060,2090,2028
0131-002,2017,9,23,16,1034,1110,2144,2090
0131-002,2017,9,23,17,1079,1305,2384,2144
0131-002,2017,9,23,18,1256,1563,2819,2384
0131-002,2017,9,23,19,1225,1166,2391,2819
0131-002,2017,9,23,20,1030,822,1852,2391
0131-002,2017,9,23,21,637,597,1234,1852
0131-002,2017,9,23,22,467,425,892,1234
0131-002,2017,9,23,23,350,300,650,892
0131-002,2017,9,23,24,209,239,448,650
0131-002,2017,9,24,1,148,161,309,448
0131-002,2017,9,24,2,117,108,225,309
0131-002,2017,9,24,3,67,97,164,225
0131-002,2017,9,24,4,82,79,161,164
0131-002,2017,9,24,5,99,103,202,161
0131-002,2017,9,24,6,183,173,356,202
0131-002,2017,9,24,7,340,328,668,356
0131-002,2017,9,24,8,588,474,1062,668
0131-002,2017,9,24,9,535,578,1113,1062
0131-002,2017,9,24,10,563,672,1235,1113
0131-002,2017,9,24,11,700,800,1500,1235
0131-002,2017,9,24,12,710,694,1404,1500
0131-002,2017,9,24,13,695,704,1399,1404
0131-002,2017,9,24,14,775,823,1598,1399
0131-002,2017,9,24,15,833,935,1768,1598
0131-002,2017,9,24,16,939,936,1875,1768
0131-002,2017,9,24,17,851,1004,1855,1875
0131-002,2017,9,24,18,900,1108,2008,1855
0131-002,2017,9,24,19,846,922,1768,2008
0131-002,2017,9,24,20,671,647,1318,1768
0131-002,2017,9,24,21,574,518,1092,1318
0131-002,2017,9,24,22,452,419,871,1092
0131-002,2017,9,24,23,302,260,562,871
0131-002,2017,9,24,24,217,166,383,562
0131-002,2017,9,25,1,120,109,229,383
0131-002,2017,9,25,2,83,80,163,229
0131-002,2017,9,25,3,61,65,126,163
0131-002,2017,9,25,4,65,66,131,126
0131-002,2017,9,25,5,145,124,269,131
0131-002,2017,9,25,6,411,293,704,269
0131-002,2017,9,25,7,1038,632,1670,704
0131-002,2017,9,25,8,1879,1349,3228,1670
0131-002,2017,9,25,9,1618,1423,3041,3228
0131-002,2017,9,25,10,1126,1212,2338,3041
0131-002,2017,9,25,11,1159,1234,2393,2338
0131-002,2017,9,25,12,1080,1170,2250,2393
0131-002,2017,9,25,13,993,1113,2106,2250
0131-002,2017,9,25,14,1088,1189,2277,2106
0131-002,2017,9,25,15,1158,1254,2412,2277
0131-002,2017,9,25,16,1304,1237,2541,2412
0131-002,2017,9,25,17,1299,1367,2666,2541
0131-002,2017,9,25,18,1183,1708,2891,2666
0131-002,2017,9,25,19,1085,1486,2571,2891
0131-002,2017,9,25,20,806,1021,1827,2571
0131-002,2017,9,25,21,701,907,1608,1827
0131-002,2017,9,25,22,570,630,1200,1608
0131-002,2017,9,25,23,336,375,711,1200
0131-002,2017,9,25,24,193,254,447,711
0131-002,2017,9,26,1,164,154,318,447
0131-002,2017,9,26,2,105,111,216,318
0131-002,2017,9,26,3,68,88,156,216
0131-002,2017,9,26,4,78,116,194,156
0131-002,2017,9,26,5,117,150,267,194
0131-002,2017,9,26,6,379,263,642,267
0131-002,2017,9,26,7,925,635,1560,642
0131-002,2017,9,26,8,1791,1297,3088,1560
0131-002,2017,9,26,9,1480,1488,2968,3088
0131-002,2017,9,26,10,1166,1304,2470,2968
0131-002,2017,9,26,11,1125,1307,2432,2470
0131-002,2017,9,26,12,1145,1188,2333,2432
0131-002,2017,9,26,13,975,1074,2049,2333
0131-002,2017,9,26,14,1117,1174,2291,2049
0131-002,2017,9,26,15,1250,1385,2635,2291
0131-002,2017,9,26,16,1111,1326,2437,2635
0131-002,2017,9,26,17,1103,1266,2369,2437
0131-002,2017,9,26,18,1211,1690,2901,2369
0131-002,2017,9,26,19,1116,1532,2648,2901
0131-002,2017,9,26,20,789,1028,1817,2648
0131-002,2017,9,26,21,668,916,1584,1817
0131-002,2017,9,26,22,561,603,1164,1584
0131-002,2017,9,26,23,380,412,792,1164
0131-002,2017,9,26,24,223,255,478,792
0131-002,2017,9,27,1,151,181,332,478
0131-002,2017,9,27,2,103,101,204,332
0131-002,2017,9,27,3,69,91,160,204
0131-002,2017,9,27,4,94,95,189,160
0131-002,2017,9,27,5,132,146,278,189
0131-002,2017,9,27,6,322,217,539,278
0131-002,2017,9,27,7,847,587,1434,539
0131-002,2017,9,27,8,1653,1207,2860,1434
0131-002,2017,9,27,9,1424,1406,2830,2860
0131-002,2017,9,27,10,1149,1191,2340,2830
0131-002,2017,9,27,11,1218,1266,2484,2340
0131-002,2017,9,27,12,1102,1141,2243,2484
0131-002,2017,9,27,13,933,1055,1988,2243
0131-002,2017,9,27,14,1116,1155,2271,1988
0131-002,2017,9,27,15,1193,1276,2469,2271
0131-002,2017,9,27,16,1146,1347,2493,2469
0131-002,2017,9,27,17,1212,1266,2478,2493
0131-002,2017,9,27,18,1221,1686,2907,2478
0131-002,2017,9,27,19,1190,1446,2636,2907
0131-002,2017,9,27,20,824,1057,1881,2636
0131-002,2017,9,27,21,646,839,1485,1881
0131-002,2017,9,27,22,570,601,1171,1485
0131-002,2017,9,27,23,348,404,752,1171
0131-002,2017,9,27,24,235,280,515,752
0131-002,2017,9,28,1,159,208,367,515
0131-002,2017,9,28,2,99,125,224,367
0131-002,2017,9,28,3,69,91,160,224
0131-002,2017,9,28,4,89,96,185,160
0131-002,2017,9,28,5,143,140,283,185
0131-002,2017,9,28,6,372,227,599,283
0131-002,2017,9,28,7,908,626,1534,599
0131-002,2017,9,28,8,1784,1250,3034,1534
0131-002,2017,9,28,9,1518,1463,2981,3034
0131-002,2017,9,28,10,1150,1235,2385,2981
0131-002,2017,9,28,11,1190,1237,2427,2385
0131-002,2017,9,28,12,1112,1138,2250,2427
0131-002,2017,9,28,13,1023,1065,2088,2250
0131-002,2017,9,28,14,1078,1187,2265,2088
0131-002,2017,9,28,15,1211,1306,2517,2265
0131-002,2017,9,28,16,1259,1303,2562,2517
0131-002,2017,9,28,17,1185,1396,2581,2562
0131-002,2017,9,28,18,1297,1694,2991,2581
0131-002,2017,9,28,19,1174,1500,2674,2991
0131-002,2017,9,28,20,839,1054,1893,2674
0131-002,2017,9,28,21,691,950,1641,1893
0131-002,2017,9,28,22,546,657,1203,1641
0131-002,2017,9,28,23,432,417,849,1203
0131-002,2017,9,28,24,282,258,540,849
0131-002,2017,9,29,1,198,192,390,540
0131-002,2017,9,29,2,141,129,270,390
0131-002,2017,9,29,3,88,87,175,270
0131-002,2017,9,29,4,108,106,214,175
0131-002,2017,9,29,5,153,152,305,214
0131-002,2017,9,29,6,377,243,620,305
0131-002,2017,9,29,7,939,591,1530,620
0131-002,2017,9,29,8,1761,1247,3008,1530
0131-002,2017,9,29,9,1505,1450,2955,3008
0131-002,2017,9,29,10,1151,1265,2416,2955
0131-002,2017,9,29,11,1135,1279,2414,2416
0131-002,2017,9,29,12,1108,1302,2410,2414
0131-002,2017,9,29,13,1042,1162,2204,2410
0131-002,2017,9,29,14,1057,1234,2291,2204
0131-002,2017,9,29,15,1211,1284,2495,2291
0131-002,2017,9,29,16,1239,1461,2700,2495
0131-002,2017,9,29,17,1147,1441,2588,2700
0131-002,2017,9,29,18,1331,1781,3112,2588
0131-002,2017,9,29,19,1274,1664,2938,3112
0131-002,2017,9,29,20,919,1177,2096,2938
0131-002,2017,9,29,21,676,906,1582,2096
0131-002,2017,9,29,22,532,557,1089,1582
0131-002,2017,9,29,23,390,440,830,1089
0131-002,2017,9,29,24,210,292,502,830
0131-002,2017,9,30,1,193,227,420,502
0131-002,2017,9,30,2,131,135,266,420
0131-002,2017,9,30,3,106,115,221,266
0131-002,2017,9,30,4,112,118,230,221
0131-002,2017,9,30,5,144,183,327,230
0131-002,2017,9,30,6,300,278,578,327
0131-002,2017,9,30,7,681,498,1179,578
0131-002,2017,9,30,8,1039,799,1838,1179
0131-002,2017,9,30,9,992,1041,2033,1838
0131-002,2017,9,30,10,883,1129,2012,2033
0131-002,2017,9,30,11,1075,1105,2180,2012
0131-002,2017,9,30,12,997,1069,2066,2180
0131-002,2017,9,30,13,920,1031,1951,2066
0131-002,2017,9,30,14,968,1041,2009,1951
0131-002,2017,9,30,15,988,1078,2066,2009
0131-002,2017,9,30,16,976,1168,2144,2066
0131-002,2017,9,30,17,973,1162,2135,2144
0131-002,2017,9,30,18,1007,1366,2373,2135
0131-002,2017,9,30,19,961,1055,2016,2373
0131-002,2017,9,30,20,590,661,1251,2016
0131-002,2017,9,30,21,478,526,1004,1251
0131-002,2017,9,30,22,376,400,776,1004
0131-002,2017,9,30,23,300,294,594,776
0131-002,2017,9,30,24,203,230,433,594
0131-002,2017,10,1,1,132,134,266,433
0131-002,2017,10,1,2,93,108,201,266
0131-002,2017,10,1,3,82,91,173,201
0131-002,2017,10,1,4,75,90,165,173
0131-002,2017,10,1,5,94,107,201,165
0131-002,2017,10,1,6,193,154,347,201
0131-002,2017,10,1,7,374,285,659,347
0131-002,2017,10,1,8,552,464,1016,659
0131-002,2017,10,1,9,535,628,1163,1016
0131-002,2017,10,1,10,537,744,1281,1163
0131-002,2017,10,1,11,600,809,1409,1281
0131-002,2017,10,1,12,675,771,1446,1409
0131-002,2017,10,1,13,660,789,1449,1446
0131-002,2017,10,1,14,713,811,1524,1449
0131-002,2017,10,1,15,735,936,1671,1524
0131-002,2017,10,1,16,757,803,1560,1671
0131-002,2017,10,1,17,751,822,1573,1560
0131-002,2017,10,1,18,782,881,1663,1573
0131-002,2017,10,1,19,727,657,1384,1663
0131-002,2017,10,1,20,520,483,1003,1384
0131-002,2017,10,1,21,403,399,802,1003
0131-002,2017,10,1,22,313,334,647,802
0131-002,2017,10,1,23,221,212,433,647
0131-002,2017,10,1,24,136,164,300,433
0131-002,2017,10,2,1,118,109,227,300
0131-002,2017,10,2,2,70,71,141,227
0131-002,2017,10,2,3,75,68,143,141
0131-002,2017,10,2,4,53,65,118,143
0131-002,2017,10,2,5,90,81,171,118
0131-002,2017,10,2,6,172,146,318,171
0131-002,2017,10,2,7,462,338,800,318
0131-002,2017,10,2,8,768,568,1336,800
0131-002,2017,10,2,9,737,735,1472,1336
0131-002,2017,10,2,10,733,875,1608,1472
0131-002,2017,10,2,11,793,913,1706,1608
0131-002,2017,10,2,12,806,1036,1842,1706
0131-002,2017,10,2,13,848,1070,1918,1842
0131-002,2017,10,2,14,854,1283,2137,1918
0131-002,2017,10,2,15,886,1206,2092,2137
0131-002,2017,10,2,16,913,1236,2149,2092
0131-002,2017,10,2,17,930,1156,2086,2149
0131-002,2017,10,2,18,900,1302,2202,2086
0131-002,2017,10,2,19,851,967,1818,2202
0131-002,2017,10,2,20,585,617,1202,1818
0131-002,2017,10,2,21,446,519,965,1202
0131-002,2017,10,2,22,344,353,697,965
0131-002,2017,10,2,23,271,278,549,697
0131-002,2017,10,2,24,187,213,400,549
0131-002,2017,10,3,1,135,153,288,400
0131-002,2017,10,3,2,86,105,191,288
0131-002,2017,10,3,3,72,94,166,191
0131-002,2017,10,3,4,63,102,165,166
0131-002,2017,10,3,5,59,124,183,165
0131-002,2017,10,3,6,126,148,274,183
0131-002,2017,10,3,7,159,394,553,274
0131-002,2017,10,3,8,307,516,823,553
0131-002,2017,10,3,9,398,718,1116,823
0131-002,2017,10,3,10,520,908,1428,1116
0131-002,2017,10,3,11,684,1008,1692,1428
0131-002,2017,10,3,12,818,949,1767,1692
0131-002,2017,10,3,13,741,811,1552,1767
0131-002,2017,10,3,14,681,813,1494,1552
0131-002,2017,10,3,15,565,782,1347,1494
0131-002,2017,10,3,16,595,674,1269,1347
0131-002,2017,10,3,17,538,663,1201,1269
0131-002,2017,10,3,18,545,589,1134,1201
0131-002,2017,10,3,19,463,479,942,1134
0131-002,2017,10,3,20,330,344,674,942
0131-002,2017,10,3,21,282,298,580,674
0131-002,2017,10,3,22,233,227,460,580
0131-002,2017,10,3,23,153,168,321,460
0131-002,2017,10,3,24,103,98,201,321
0131-002,2017,10,4,1,81,77,158,201
0131-002,2017,10,4,2,52,42,94,158
0131-002,2017,10,4,3,39,45,84,94
0131-002,2017,10,4,4,40,38,78,84
0131-002,2017,10,4,5,37,51,88,78
0131-002,2017,10,4,6,60,108,168,88
0131-002,2017,10,4,7,221,243,464,168
0131-002,2017,10,4,8,398,412,810,464
0131-002,2017,10,4,9,375,489,864,810
0131-002,2017,10,4,10,414,611,1025,864
0131-002,2017,10,4,11,699,1030,1729,1025
0131-002,2017,10,4,12,915,1291,2206,1729
0131-002,2017,10,4,13,994,1438,2432,2206
0131-002,2017,10,4,14,1077,1511,2588,2432
0131-002,2017,10,4,15,1007,1467,2474,2588
0131-002,2017,10,4,16,1166,1419,2585,2474
0131-002,2017,10,4,17,1042,1530,2572,2585
0131-002,2017,10,4,18,1299,1217,2516,2572
0131-002,2017,10,4,19,1528,1046,2574,2516
0131-002,2017,10,4,20,1290,885,2175,2574
0131-002,2017,10,4,21,1191,510,1701,2175
0131-002,2017,10,4,22,939,355,1294,1701
0131-002,2017,10,4,23,505,256,761,1294
0131-002,2017,10,4,24,427,185,612,761
0131-002,2017,10,5,1,212,116,328,612
0131-002,2017,10,5,2,122,85,207,328
0131-002,2017,10,5,3,66,37,103,207
0131-002,2017,10,5,4,59,42,101,103
0131-002,2017,10,5,5,61,65,126,101
0131-002,2017,10,5,6,80,81,161,126
0131-002,2017,10,5,7,150,141,291,161
0131-002,2017,10,5,8,271,255,526,291
0131-002,2017,10,5,9,342,331,673,526
0131-002,2017,10,5,10,493,504,997,673
0131-002,2017,10,5,11,730,791,1521,997
0131-002,2017,10,5,12,883,957,1840,1521
0131-002,2017,10,5,13,816,945,1761,1840
0131-002,2017,10,5,14,759,1017,1776,1761
0131-002,2017,10,5,15,733,1133,1866,1776
0131-002,2017,10,5,16,799,942,1741,1866
0131-002,2017,10,5,17,974,832,1806,1741
0131-002,2017,10,5,18,1125,799,1924,1806
0131-002,2017,10,5,19,1118,615,1733,1924
0131-002,2017,10,5,20,1180,505,1685,1733
0131-002,2017,10,5,21,956,469,1425,1685
0131-002,2017,10,5,22,1217,347,1564,1425
0131-002,2017,10,5,23,870,315,1185,1564
0131-002,2017,10,5,24,1017,217,1234,1185
0131-002,2017,10,6,1,498,141,639,1234
0131-002,2017,10,6,2,311,119,430,639
0131-002,2017,10,6,3,208,76,284,430
0131-002,2017,10,6,4,82,57,139,284
0131-002,2017,10,6,5,56,79,135,139
0131-002,2017,10,6,6,106,87,193,135
0131-002,2017,10,6,7,210,160,370,193
0131-002,2017,10,6,8,404,319,723,370
0131-002,2017,10,6,9,385,406,791,723
0131-002,2017,10,6,10,511,517,1028,791
0131-002,2017,10,6,11,622,627,1249,1028
0131-002,2017,10,6,12,722,806,1528,1249
0131-002,2017,10,6,13,733,676,1409,1528
0131-002,2017,10,6,14,682,724,1406,1409
0131-002,2017,10,6,15,749,756,1505,1406
0131-002,2017,10,6,16,785,791,1576,1505
0131-002,2017,10,6,17,944,827,1771,1576
0131-002,2017,10,6,18,1165,802,1967,1771
0131-002,2017,10,6,19,1180,732,1912,1967
0131-002,2017,10,6,20,967,542,1509,1912
0131-002,2017,10,6,21,1000,429,1429,1509
0131-002,2017,10,6,22,736,406,1142,1429
0131-002,2017,10,6,23,633,256,889,1142
0131-002,2017,10,6,24,583,217,800,889
0131-002,2017,10,7,1,264,158,422,800
0131-002,2017,10,7,2,96,107,203,422
0131-002,2017,10,7,3,89,87,176,203
0131-002,2017,10,7,4,59,80,139,176
0131-002,2017,10,7,5,73,97,170,139
0131-002,2017,10,7,6,147,118,265,170
0131-002,2017,10,7,7,351,230,581,265
0131-002,2017,10,7,8,551,419,970,581
0131-002,2017,10,7,9,557,557,1114,970
0131-002,2017,10,7,10,599,622,1221,1114
0131-002,2017,10,7,11,695,662,1357,1221
0131-002,2017,10,7,12,797,722,1519,1357
0131-002,2017,10,7,13,810,796,1606,1519
0131-002,2017,10,7,14,751,786,1537,1606
0131-002,2017,10,7,15,725,872,1597,1537
0131-002,2017,10,7,16,771,877,1648,1597
0131-002,2017,10,7,17,853,902,1755,1648
0131-002,2017,10,7,18,1001,1017,2018,1755
0131-002,2017,10,7,19,961,821,1782,2018
0131-002,2017,10,7,20,848,599,1447,1782
0131-002,2017,10,7,21,600,506,1106,1447
0131-002,2017,10,7,22,389,375,764,1106
0131-002,2017,10,7,23,248,273,521,764
0131-002,2017,10,7,24,199,184,383,521
0131-002,2017,10,8,1,148,155,303,383
0131-002,2017,10,8,2,95,107,202,303
0131-002,2017,10,8,3,82,85,167,202
0131-002,2017,10,8,4,68,74,142,167
0131-002,2017,10,8,5,70,80,150,142
0131-002,2017,10,8,6,138,96,234,150
0131-002,2017,10,8,7,302,209,511,234
0131-002,2017,10,8,8,468,336,804,511
0131-002,2017,10,8,9,441,417,858,804
0131-002,2017,10,8,10,475,493,968,858
0131-002,2017,10,8,11,615,608,1223,968
0131-002,2017,10,8,12,627,631,1258,1223
0131-002,2017,10,8,13,616,720,1336,1258
0131-002,2017,10,8,14,715,719,1434,1336
0131-002,2017,10,8,15,778,798,1576,1434
0131-002,2017,10,8,16,726,898,1624,1576
0131-002,2017,10,8,17,802,875,1677,1624
0131-002,2017,10,8,18,785,998,1783,1677
0131-002,2017,10,8,19,720,798,1518,1783
0131-002,2017,10,8,20,556,571,1127,1518
0131-002,2017,10,8,21,466,478,944,1127
0131-002,2017,10,8,22,408,353,761,944
0131-002,2017,10,8,23,311,282,593,761
0131-002,2017,10,8,24,209,190,399,593
0131-002,2017,10,9,1,138,114,252,399
0131-002,2017,10,9,2,95,85,180,252
0131-002,2017,10,9,3,81,63,144,180
0131-002,2017,10,9,4,62,82,144,144
0131-002,2017,10,9,5,115,120,235,144
0131-002,2017,10,9,6,230,189,419,235
0131-002,2017,10,9,7,574,381,955,419
0131-002,2017,10,9,8,978,717,1695,955
0131-002,2017,10,9,9,768,699,1467,1695
0131-002,2017,10,9,10,761,720,1481,1467
0131-002,2017,10,9,11,773,828,1601,1481
0131-002,2017,10,9,12,726,812,1538,1601
0131-002,2017,10,9,13,683,724,1407,1538
0131-002,2017,10,9,14,816,822,1638,1407
0131-002,2017,10,9,15,846,852,1698,1638
0131-002,2017,10,9,16,905,899,1804,1698
0131-002,2017,10,9,17,817,989,1806,1804
0131-002,2017,10,9,18,935,1222,2157,1806
0131-002,2017,10,9,19,845,969,1814,2157
0131-002,2017,10,9,20,649,628,1277,1814
0131-002,2017,10,9,21,517,540,1057,1277
0131-002,2017,10,9,22,385,356,741,1057
0131-002,2017,10,9,23,277,264,541,741
0131-002,2017,10,9,24,155,177,332,541
0131-002,2017,10,10,1,144,115,259,332
0131-002,2017,10,10,2,84,61,145,259
0131-002,2017,10,10,3,73,66,139,145
0131-002,2017,10,10,4,67,82,149,139
0131-002,2017,10,10,5,127,128,255,149
0131-002,2017,10,10,6,365,242,607,255
0131-002,2017,10,10,7,931,552,1483,607
0131-002,2017,10,10,8,1828,1259,3087,1483
0131-002,2017,10,10,9,1498,1361,2859,3087
0131-002,2017,10,10,10,1044,1071,2115,2859
0131-002,2017,10,10,11,1038,1093,2131,2115
0131-002,2017,10,10,12,1030,1041,2071,2131
0131-002,2017,10,10,13,867,946,1813,2071
0131-002,2017,10,10,14,1045,1051,2096,1813
0131-002,2017,10,10,15,1067,1219,2286,2096
0131-002,2017,10,10,16,1091,1160,2251,2286
0131-002,2017,10,10,17,1031,1180,2211,2251
0131-002,2017,10,10,18,1070,1580,2650,2211
0131-002,2017,10,10,19,1063,1472,2535,2650
0131-002,2017,10,10,20,702,978,1680,2535
0131-002,2017,10,10,21,578,823,1401,1680
0131-002,2017,10,10,22,495,489,984,1401
0131-002,2017,10,10,23,293,374,667,984
0131-002,2017,10,10,24,227,196,423,667
0131-002,2017,10,11,1,162,150,312,423
0131-002,2017,10,11,2,106,97,203,312
0131-002,2017,10,11,3,69,79,148,203
0131-002,2017,10,11,4,90,94,184,148
0131-002,2017,10,11,5,131,134,265,184
0131-002,2017,10,11,6,317,197,514,265
0131-002,2017,10,11,7,726,506,1232,514
0131-002,2017,10,11,8,1603,1096,2699,1232
0131-002,2017,10,11,9,1472,1364,2836,2699
0131-002,2017,10,11,10,1091,1123,2214,2836
0131-002,2017,10,11,11,1068,1083,2151,2214
0131-002,2017,10,11,12,1071,1048,2119,2151
0131-002,2017,10,11,13,871,909,1780,2119
0131-002,2017,10,11,14,1001,1059,2060,1780
0131-002,2017,10,11,15,1109,1176,2285,2060
0131-002,2017,10,11,16,1107,1168,2275,2285
0131-002,2017,10,11,17,999,1190,2189,2275
0131-002,2017,10,11,18,1036,1505,2541,2189
0131-002,2017,10,11,19,1020,1358,2378,2541
0131-002,2017,10,11,20,766,921,1687,2378
0131-002,2017,10,11,21,541,747,1288,1687
0131-002,2017,10,11,22,455,522,977,1288
0131-002,2017,10,11,23,328,357,685,977
0131-002,2017,10,11,24,215,278,493,685
0131-002,2017,10,12,1,151,176,327,493
0131-002,2017,10,12,2,110,90,200,327
0131-002,2017,10,12,3,83,77,160,200
0131-002,2017,10,12,4,84,102,186,160
0131-002,2017,10,12,5,140,126,266,186
0131-002,2017,10,12,6,360,280,640,266
0131-002,2017,10,12,7,834,534,1368,640
0131-002,2017,10,12,8,1671,1177,2848,1368
0131-002,2017,10,12,9,1446,1375,2821,2848
0131-002,2017,10,12,10,1144,1266,2410,2821
0131-002,2017,10,12,11,1117,1133,2250,2410
0131-002,2017,10,12,12,1009,1141,2150,2250
0131-002,2017,10,12,13,885,971,1856,2150
0131-002,2017,10,12,14,1040,1116,2156,1856
0131-002,2017,10,12,15,1140,1143,2283,2156
0131-002,2017,10,12,16,1108,1174,2282,2283
0131-002,2017,10,12,17,1129,1180,2309,2282
0131-002,2017,10,12,18,1119,1546,2665,2309
0131-002,2017,10,12,19,1047,1314,2361,2665
0131-002,2017,10,12,20,722,973,1695,2361
0131-002,2017,10,12,21,602,868,1470,1695
0131-002,2017,10,12,22,498,576,1074,1470
0131-002,2017,10,12,23,335,373,708,1074
0131-002,2017,10,12,24,236,220,456,708
0131-002,2017,10,13,1,160,171,331,456
0131-002,2017,10,13,2,105,105,210,331
0131-002,2017,10,13,3,83,94,177,210
0131-002,2017,10,13,4,95,80,175,177
0131-002,2017,10,13,5,147,127,274,175
0131-002,2017,10,13,6,315,256,571,274
0131-002,2017,10,13,7,836,559,1395,571
0131-002,2017,10,13,8,1696,1166,2862,1395
0131-002,2017,10,13,9,1523,1426,2949,2862
0131-002,2017,10,13,10,1198,1161,2359,2949
0131-002,2017,10,13,11,1165,1191,2356,2359
0131-002,2017,10,13,12,1107,1221,2328,2356
0131-002,2017,10,13,13,979,1110,2089,2328
0131-002,2017,10,13,14,1099,1175,2274,2089
0131-002,2017,10,13,15,1218,1277,2495,2274
0131-002,2017,10,13,16,1227,1274,2501,2495
0131-002,2017,10,13,17,1217,1323,2540,2501
0131-002,2017,10,13,18,1174,1808,2982,2540
0131-002,2017,10,13,19,1277,1706,2983,2982
0131-002,2017,10,13,20,905,1171,2076,2983
0131-002,2017,10,13,21,690,932,1622,2076
0131-002,2017,10,13,22,486,578,1064,1622
0131-002,2017,10,13,23,346,383,729,1064
0131-002,2017,10,13,24,235,243,478,729
0131-002,2017,10,14,1,179,192,371,478
0131-002,2017,10,14,2,126,124,250,371
0131-002,2017,10,14,3,98,118,216,250
0131-002,2017,10,14,4,100,92,192,216
0131-002,2017,10,14,5,118,148,266,192
0131-002,2017,10,14,6,294,208,502,266
0131-002,2017,10,14,7,647,502,1149,502
0131-002,2017,10,14,8,923,850,1773,1149
0131-002,2017,10,14,9,997,1098,2095,1773
0131-002,2017,10,14,10,1006,1008,2014,2095
0131-002,2017,10,14,11,1047,1069,2116,2014
0131-002,2017,10,14,12,971,1028,1999,2116
0131-002,2017,10,14,13,870,951,1821,1999
0131-002,2017,10,14,14,872,1004,1876,1821
0131-002,2017,10,14,15,932,1120,2052,1876
0131-002,2017,10,14,16,936,1129,2065,2052
0131-002,2017,10,14,17,1001,1163,2164,2065
0131-002,2017,10,14,18,1242,1505,2747,2164
0131-002,2017,10,14,19,1053,1087,2140,2747
0131-002,2017,10,14,20,629,651,1280,2140
0131-002,2017,10,14,21,493,499,992,1280
0131-002,2017,10,14,22,391,393,784,992
0131-002,2017,10,14,23,306,267,573,784
0131-002,2017,10,14,24,183,217,400,573
0131-002,2017,10,15,1,152,168,320,400
0131-002,2017,10,15,2,109,120,229,320
0131-002,2017,10,15,3,86,70,156,229
0131-002,2017,10,15,4,68,66,134,156
0131-002,2017,10,15,5,77,82,159,134
0131-002,2017,10,15,6,180,138,318,159
0131-002,2017,10,15,7,317,264,581,318
0131-002,2017,10,15,8,457,402,859,581
0131-002,2017,10,15,9,504,515,1019,859
0131-002,2017,10,15,10,568,641,1209,1019
0131-002,2017,10,15,11,570,752,1322,1209
0131-002,2017,10,15,12,671,697,1368,1322
0131-002,2017,10,15,13,641,735,1376,1368
0131-002,2017,10,15,14,743,734,1477,1376
0131-002,2017,10,15,15,734,878,1612,1477
0131-002,2017,10,15,16,805,901,1706,1612
0131-002,2017,10,15,17,856,974,1830,1706
0131-002,2017,10,15,18,980,1057,2037,1830
0131-002,2017,10,15,19,869,834,1703,2037
0131-002,2017,10,15,20,639,672,1311,1703
0131-002,2017,10,15,21,533,472,1005,1311
0131-002,2017,10,15,22,450,378,828,1005
0131-002,2017,10,15,23,323,250,573,828
0131-002,2017,10,15,24,175,176,351,573
0131-002,2017,10,16,1,134,97,231,351
0131-002,2017,10,16,2,86,70,156,231
0131-002,2017,10,16,3,56,56,112,156
0131-002,2017,10,16,4,68,79,147,112
0131-002,2017,10,16,5,132,124,256,147
0131-002,2017,10,16,6,400,240,640,256
0131-002,2017,10,16,7,920,648,1568,640
0131-002,2017,10,16,8,1932,1286,3218,1568
0131-002,2017,10,16,9,1529,1387,2916,3218
0131-002,2017,10,16,10,1143,1128,2271,2916
0131-002,2017,10,16,11,1154,1208,2362,2271
0131-002,2017,10,16,12,1059,1133,2192,2362
0131-002,2017,10,16,13,937,1061,1998,2192
0131-002,2017,10,16,14,1053,1023,2076,1998
0131-002,2017,10,16,15,1091,1259,2350,2076
0131-002,2017,10,16,16,1165,1185,2350,2350
0131-002,2017,10,16,17,1100,1207,2307,2350
0131-002,2017,10,16,18,1163,1546,2709,2307
0131-002,2017,10,16,19,1107,1399,2506,2709
0131-002,2017,10,16,20,750,1000,1750,2506
0131-002,2017,10,16,21,588,857,1445,1750
0131-002,2017,10,16,22,448,589,1037,1445
0131-002,2017,10,16,23,316,365,681,1037
0131-002,2017,10,16,24,161,215,376,681
0131-002,2017,10,17,1,147,158,305,376
0131-002,2017,10,17,2,94,110,204,305
0131-002,2017,10,17,3,86,75,161,204
0131-002,2017,10,17,4,70,87,157,161
0131-002,2017,10,17,5,120,129,249,157
0131-002,2017,10,17,6,367,246,613,249
0131-002,2017,10,17,7,837,594,1431,613
0131-002,2017,10,17,8,1671,1194,2865,1431
0131-002,2017,10,17,9,1589,1427,3016,2865
0131-002,2017,10,17,10,1234,1226,2460,3016
0131-002,2017,10,17,11,1239,1241,2480,2460
0131-002,2017,10,17,12,1204,1167,2371,2480
0131-002,2017,10,17,13,1102,1018,2120,2371
0131-002,2017,10,17,14,1147,1084,2231,2120
0131-002,2017,10,17,15,1291,1261,2552,2231
0131-002,2017,10,17,16,1304,1269,2573,2552
0131-002,2017,10,17,17,1241,1400,2641,2573
0131-002,2017,10,17,18,1352,1702,3054,2641
0131-002,2017,10,17,19,1145,1509,2654,3054
0131-002,2017,10,17,20,826,923,1749,2654
0131-002,2017,10,17,21,662,873,1535,1749
0131-002,2017,10,17,22,537,597,1134,1535
0131-002,2017,10,17,23,334,388,722,1134
0131-002,2017,10,17,24,202,262,464,722
0131-002,2017,10,18,1,161,151,312,464
0131-002,2017,10,18,2,108,121,229,312
0131-002,2017,10,18,3,69,85,154,229
0131-002,2017,10,18,4,85,88,173,154
0131-002,2017,10,18,5,120,129,249,173
0131-002,2017,10,18,6,364,235,599,249
0131-002,2017,10,18,7,854,534,1388,599
0131-002,2017,10,18,8,1756,1225,2981,1388
0131-002,2017,10,18,9,1620,1472,3092,2981
0131-002,2017,10,18,10,1248,1226,2474,3092
0131-002,2017,10,18,11,1254,1163,2417,2474
0131-002,2017,10,18,12,1200,1148,2348,2417
0131-002,2017,10,18,13,974,1049,2023,2348
0131-002,2017,10,18,14,1168,1124,2292,2023
0131-002,2017,10,18,15,1262,1199,2461,2292
0131-002,2017,10,18,16,1254,1224,2478,2461
0131-002,2017,10,18,17,1170,1280,2450,2478
0131-002,2017,10,18,18,1313,1712,3025,2450
0131-002,2017,10,18,19,1117,1504,2621,3025
0131-002,2017,10,18,20,722,917,1639,2621
0131-002,2017,10,18,21,548,756,1304,1639
0131-002,2017,10,18,22,466,550,1016,1304
0131-002,2017,10,18,23,336,318,654,1016
0131-002,2017,10,18,24,209,250,459,654
0131-002,2017,10,19,1,156,172,328,459
0131-002,2017,10,19,2,86,110,196,328
0131-002,2017,10,19,3,69,77,146,196
0131-002,2017,10,19,4,81,94,175,146
0131-002,2017,10,19,5,131,136,267,175
0131-002,2017,10,19,6,335,235,570,267
0131-002,2017,10,19,7,871,541,1412,570
0131-002,2017,10,19,8,1720,1176,2896,1412
0131-002,2017,10,19,9,1552,1465,3017,2896
0131-002,2017,10,19,10,1208,1174,2382,3017
0131-002,2017,10,19,11,1264,1167,2431,2382
0131-002,2017,10,19,12,1111,1144,2255,2431
0131-002,2017,10,19,13,976,1047,2023,2255
0131-002,2017,10,19,14,1187,1108,2295,2023
0131-002,2017,10,19,15,1301,1264,2565,2295
0131-002,2017,10,19,16,1233,1235,2468,2565
0131-002,2017,10,19,17,1221,1359,2580,2468
0131-002,2017,10,19,18,1292,1635,2927,2580
0131-002,2017,10,19,19,1105,1408,2513,2927
0131-002,2017,10,19,20,790,956,1746,2513
0131-002,2017,10,19,21,638,838,1476,1746
0131-002,2017,10,19,22,490,598,1088,1476
0131-002,2017,10,19,23,342,380,722,1088
0131-002,2017,10,19,24,212,215,427,722
0131-002,2017,10,20,1,146,160,306,427
0131-002,2017,10,20,2,87,111,198,306
0131-002,2017,10,20,3,71,75,146,198
0131-002,2017,10,20,4,73,106,179,146
0131-002,2017,10,20,5,109,135,244,179
0131-002,2017,10,20,6,368,253,621,244
0131-002,2017,10,20,7,849,542,1391,621
0131-002,2017,10,20,8,1724,1191,2915,1391
0131-002,2017,10,20,9,1553,1513,3066,2915
0131-002,2017,10,20,10,1188,1172,2360,3066
0131-002,2017,10,20,11,1227,1257,2484,2360
0131-002,2017,10,20,12,1225,1185,2410,2484
0131-002,2017,10,20,13,1081,1057,2138,2410
0131-002,2017,10,20,14,1209,1188,2397,2138
0131-002,2017,10,20,15,1278,1346,2624,2397
0131-002,2017,10,20,16,1279,1330,2609,2624
0131-002,2017,10,20,17,1236,1333,2569,2609
0131-002,2017,10,20,18,1254,1862,3116,2569
0131-002,2017,10,20,19,1315,1789,3104,3116
0131-002,2017,10,20,20,934,1167,2101,3104
0131-002,2017,10,20,21,733,876,1609,2101
0131-002,2017,10,20,22,545,589,1134,1609
0131-002,2017,10,20,23,360,400,760,1134
0131-002,2017,10,20,24,230,291,521,760
0131-002,2017,10,21,1,164,200,364,521
0131-002,2017,10,21,2,112,141,253,364
0131-002,2017,10,21,3,105,119,224,253
0131-002,2017,10,21,4,77,99,176,224
0131-002,2017,10,21,5,120,147,267,176
0131-002,2017,10,21,6,307,226,533,267
0131-002,2017,10,21,7,626,510,1136,533
0131-002,2017,10,21,8,1021,799,1820,1136
0131-002,2017,10,21,9,1024,1142,2166,1820
0131-002,2017,10,21,10,1082,988,2070,2166
0131-002,2017,10,21,11,1077,1125,2202,2070
0131-002,2017,10,21,12,1077,1053,2130,2202
0131-002,2017,10,21,13,1155,1027,2182,2130
0131-002,2017,10,21,14,1080,893,1973,2182
0131-002,2017,10,21,15,1057,1028,2085,1973
0131-002,2017,10,21,16,1061,1214,2275,2085
0131-002,2017,10,21,17,1099,1197,2296,2275
0131-002,2017,10,21,18,1201,1450,2651,2296
0131-002,2017,10,21,19,1060,1173,2233,2651
0131-002,2017,10,21,20,754,731,1485,2233
0131-002,2017,10,21,21,529,555,1084,1485
0131-002,2017,10,21,22,409,429,838,1084
0131-002,2017,10,21,23,292,286,578,838
0131-002,2017,10,21,24,184,207,391,578
0131-002,2017,10,22,1,126,153,279,391
0131-002,2017,10,22,2,84,102,186,279
0131-002,2017,10,22,3,69,89,158,186
0131-002,2017,10,22,4,49,89,138,158
0131-002,2017,10,22,5,61,89,150,138
0131-002,2017,10,22,6,129,139,268,150
0131-002,2017,10,22,7,258,226,484,268
0131-002,2017,10,22,8,390,398,788,484
0131-002,2017,10,22,9,489,557,1046,788
0131-002,2017,10,22,10,531,643,1174,1046
0131-002,2017,10,22,11,694,713,1407,1174
0131-002,2017,10,22,12,767,707,1474,1407
0131-002,2017,10,22,13,740,708,1448,1474
0131-002,2017,10,22,14,824,802,1626,1448
0131-002,2017,10,22,15,878,848,1726,1626
0131-002,2017,10,22,16,873,944,1817,1726
0131-002,2017,10,22,17,932,967,1899,1817
0131-002,2017,10,22,18,913,1020,1933,1899
0131-002,2017,10,22,19,935,861,1796,1933
0131-002,2017,10,22,20,708,633,1341,1796
0131-002,2017,10,22,21,599,530,1129,1341
0131-002,2017,10,22,22,493,368,861,1129
0131-002,2017,10,22,23,340,288,628,861
0131-002,2017,10,22,24,207,158,365,628
0131-002,2017,10,23,1,116,129,245,365
0131-002,2017,10,23,2,65,67,132,245
0131-002,2017,10,23,3,61,46,107,132
0131-002,2017,10,23,4,63,65,128,107
0131-002,2017,10,23,5,125,109,234,128
0131-002,2017,10,23,6,387,269,656,234
0131-002,2017,10,23,7,909,628,1537,656
0131-002,2017,10,23,8,1680,1256,2936,1537
0131-002,2017,10,23,9,1626,1447,3073,2936
0131-002,2017,10,23,10,1122,1137,2259,3073
0131-002,2017,10,23,11,1236,1142,2378,2259
0131-002,2017,10,23,12,1102,1154,2256,2378
0131-002,2017,10,23,13,1088,991,2079,2256
0131-002,2017,10,23,14,1216,1108,2324,2079
0131-002,2017,10,23,15,1237,1247,2484,2324
0131-002,2017,10,23,16,1275,1238,2513,2484
0131-002,2017,10,23,17,1168,1305,2473,2513
0131-002,2017,10,23,18,1265,1581,2846,2473
0131-002,2017,10,23,19,1155,1387,2542,2846
0131-002,2017,10,23,20,761,1004,1765,2542
0131-002,2017,10,23,21,630,806,1436,1765
0131-002,2017,10,23,22,459,569,1028,1436
0131-002,2017,10,23,23,273,399,672,1028
0131-002,2017,10,23,24,165,217,382,672
0131-002,2017,10,24,1,124,141,265,382
0131-002,2017,10,24,2,87,105,192,265
0131-002,2017,10,24,3,69,87,156,192
0131-002,2017,10,24,4,75,95,170,156
0131-002,2017,10,24,5,112,169,281,170
0131-002,2017,10,24,6,352,254,606,281
0131-002,2017,10,24,7,783,575,1358,606
0131-002,2017,10,24,8,1651,1215,2866,1358
0131-002,2017,10,24,9,1516,1447,2963,2866
0131-002,2017,10,24,10,1156,1197,2353,2963
0131-002,2017,10,24,11,1167,1143,2310,2353
0131-002,2017,10,24,12,1191,1172,2363,2310
0131-002,2017,10,24,13,963,1005,1968,2363
0131-002,2017,10,24,14,1201,1084,2285,1968
0131-002,2017,10,24,15,1245,1263,2508,2285
0131-002,2017,10,24,16,1280,1239,2519,2508
0131-002,2017,10,24,17,1171,1268,2439,2519
0131-002,2017,10,24,18,1264,1517,2781,2439
0131-002,2017,10,24,19,1102,1383,2485,2781
0131-002,2017,10,24,20,734,921,1655,2485
0131-002,2017,10,24,21,633,852,1485,1655
0131-002,2017,10,24,22,471,574,1045,1485
0131-002,2017,10,24,23,324,351,675,1045
0131-002,2017,10,24,24,174,219,393,675
0131-002,2017,10,25,1,129,147,276,393
0131-002,2017,10,25,2,84,103,187,276
0131-002,2017,10,25,3,61,68,129,187
0131-002,2017,10,25,4,80,82,162,129
0131-002,2017,10,25,5,116,148,264,162
0131-002,2017,10,25,6,352,250,602,264
0131-002,2017,10,25,7,797,566,1363,602
0131-002,2017,10,25,8,1547,1181,2728,1363
0131-002,2017,10,25,9,1491,1395,2886,2728
0131-002,2017,10,25,10,1184,1116,2300,2886
0131-002,2017,10,25,11,1204,1210,2414,2300
0131-002,2017,10,25,12,1124,1116,2240,2414
0131-002,2017,10,25,13,1038,1010,2048,2240
0131-002,2017,10,25,14,1131,1130,2261,2048
0131-002,2017,10,25,15,1303,1286,2589,2261
0131-002,2017,10,25,16,1179,1230,2409,2589
0131-002,2017,10,25,17,1179,1237,2416,2409
0131-002,2017,10,25,18,1268,1695,2963,2416
0131-002,2017,10,25,19,1219,1459,2678,2963
0131-002,2017,10,25,20,758,948,1706,2678
0131-002,2017,10,25,21,585,735,1320,1706
0131-002,2017,10,25,22,431,536,967,1320
0131-002,2017,10,25,23,323,364,687,967
0131-002,2017,10,25,24,166,237,403,687
0131-002,2017,10,26,1,136,165,301,403
0131-002,2017,10,26,2,76,102,178,301
0131-002,2017,10,26,3,55,78,133,178
0131-002,2017,10,26,4,64,92,156,133
0131-002,2017,10,26,5,117,158,275,156
0131-002,2017,10,26,6,348,251,599,275
0131-002,2017,10,26,7,845,566,1411,599
0131-002,2017,10,26,8,1655,1175,2830,1411
0131-002,2017,10,26,9,1442,1439,2881,2830
0131-002,2017,10,26,10,1160,1115,2275,2881
0131-002,2017,10,26,11,1142,1099,2241,2275
0131-002,2017,10,26,12,1165,1112,2277,2241
0131-002,2017,10,26,13,950,1017,1967,2277
0131-002,2017,10,26,14,1090,1186,2276,1967
0131-002,2017,10,26,15,1241,1234,2475,2276
0131-002,2017,10,26,16,1153,1238,2391,2475
0131-002,2017,10,26,17,1234,1337,2571,2391
0131-002,2017,10,26,18,1337,1618,2955,2571
0131-002,2017,10,26,19,1139,1415,2554,2955
0131-002,2017,10,26,20,810,1003,1813,2554
0131-002,2017,10,26,21,653,823,1476,1813
0131-002,2017,10,26,22,528,595,1123,1476
0131-002,2017,10,26,23,378,347,725,1123
0131-002,2017,10,26,24,187,265,452,725
0131-002,2017,10,27,1,127,168,295,452
0131-002,2017,10,27,2,99,116,215,295
0131-002,2017,10,27,3,66,93,159,215
0131-002,2017,10,27,4,84,86,170,159
0131-002,2017,10,27,5,138,139,277,170
0131-002,2017,10,27,6,343,248,591,277
0131-002,2017,10,27,7,903,538,1441,591
0131-002,2017,10,27,8,1730,1235,2965,1441
0131-002,2017,10,27,9,1586,1421,3007,2965
0131-002,2017,10,27,10,1198,1207,2405,3007
0131-002,2017,10,27,11,1154,1171,2325,2405
0131-002,2017,10,27,12,1200,1219,2419,2325
0131-002,2017,10,27,13,992,1005,1997,2419
0131-002,2017,10,27,14,1144,1106,2250,1997
0131-002,2017,10,27,15,1193,1262,2455,2250
0131-002,2017,10,27,16,1233,1356,2589,2455
0131-002,2017,10,27,17,1253,1424,2677,2589
0131-002,2017,10,27,18,1382,1803,3185,2677
0131-002,2017,10,27,19,1300,1722,3022,3185
0131-002,2017,10,27,20,982,1223,2205,3022
0131-002,2017,10,27,21,685,871,1556,2205
0131-002,2017,10,27,22,509,611,1120,1556
0131-002,2017,10,27,23,351,415,766,1120
0131-002,2017,10,27,24,235,272,507,766
0131-002,2017,10,28,1,161,175,336,507
0131-002,2017,10,28,2,93,142,235,336
0131-002,2017,10,28,3,77,118,195,235
0131-002,2017,10,28,4,93,106,199,195
0131-002,2017,10,28,5,90,158,248,199
0131-002,2017,10,28,6,272,238,510,248
0131-002,2017,10,28,7,608,471,1079,510
0131-002,2017,10,28,8,921,869,1790,1079
0131-002,2017,10,28,9,1010,1159,2169,1790
0131-002,2017,10,28,10,1127,1087,2214,2169
0131-002,2017,10,28,11,1162,1081,2243,2214
0131-002,2017,10,28,12,1250,1128,2378,2243
0131-002,2017,10,28,13,1252,1024,2276,2378
0131-002,2017,10,28,14,1093,1055,2148,2276
0131-002,2017,10,28,15,1082,1106,2188,2148
0131-002,2017,10,28,16,1150,1144,2294,2188
0131-002,2017,10,28,17,1206,1267,2473,2294
0131-002,2017,10,28,18,1401,1537,2938,2473
0131-002,2017,10,28,19,1193,1171,2364,2938
0131-002,2017,10,28,20,874,759,1633,2364
0131-002,2017,10,28,21,563,554,1117,1633
0131-002,2017,10,28,22,408,410,818,1117
0131-002,2017,10,28,23,289,309,598,818
0131-002,2017,10,28,24,207,220,427,598
0131-002,2017,10,29,1,138,153,291,427
0131-002,2017,10,29,2,93,127,220,291
0131-002,2017,10,29,3,74,68,142,220
0131-002,2017,10,29,4,50,64,114,142
0131-002,2017,10,29,5,58,101,159,114
0131-002,2017,10,29,6,117,144,261,159
0131-002,2017,10,29,7,245,256,501,261
0131-002,2017,10,29,8,386,411,797,501
0131-002,2017,10,29,9,435,559,994,797
0131-002,2017,10,29,10,526,674,1200,994
0131-002,2017,10,29,11,683,754,1437,1200
0131-002,2017,10,29,12,816,713,1529,1437
0131-002,2017,10,29,13,769,729,1498,1529
0131-002,2017,10,29,14,868,813,1681,1498
0131-002,2017,10,29,15,848,920,1768,1681
0131-002,2017,10,29,16,926,954,1880,1768
0131-002,2017,10,29,17,1002,983,1985,1880
0131-002,2017,10,29,18,1103,1086,2189,1985
0131-002,2017,10,29,19,825,840,1665,2189
0131-002,2017,10,29,20,688,599,1287,1665
0131-002,2017,10,29,21,530,498,1028,1287
0131-002,2017,10,29,22,408,356,764,1028
0131-002,2017,10,29,23,287,240,527,764
0131-002,2017,10,29,24,139,167,306,527
0131-002,2017,10,30,1,109,96,205,306
0131-002,2017,10,30,2,57,70,127,205
0131-002,2017,10,30,3,39,54,93,127
0131-002,2017,10,30,4,49,67,116,93
0131-002,2017,10,30,5,101,126,227,116
0131-002,2017,10,30,6,339,260,599,227
0131-002,2017,10,30,7,858,538,1396,599
0131-002,2017,10,30,8,1593,1248,2841,1396
0131-002,2017,10,30,9,1434,1375,2809,2841
0131-002,2017,10,30,10,996,1126,2122,2809
0131-002,2017,10,30,11,1145,1175,2320,2122
0131-002,2017,10,30,12,1055,1048,2103,2320
0131-002,2017,10,30,13,1021,1031,2052,2103
0131-002,2017,10,30,14,1143,1062,2205,2052
0131-002,2017,10,30,15,1303,1188,2491,2205
0131-002,2017,10,30,16,1232,1251,2483,2491
0131-002,2017,10,30,17,1142,1328,2470,2483
0131-002,2017,10,30,18,1178,1479,2657,2470
0131-002,2017,10,30,19,1020,1404,2424,2657
0131-002,2017,10,30,20,646,950,1596,2424
0131-002,2017,10,30,21,530,883,1413,1596
0131-002,2017,10,30,22,360,552,912,1413
0131-002,2017,10,30,23,216,362,578,912
0131-002,2017,10,30,24,124,226,350,578
0131-002,2017,10,31,1,108,149,257,350
0131-002,2017,10,31,2,60,92,152,257
0131-002,2017,10,31,3,38,72,110,152
0131-002,2017,10,31,4,66,77,143,110
0131-002,2017,10,31,5,110,145,255,143
0131-002,2017,10,31,6,293,220,513,255
0131-002,2017,10,31,7,741,522,1263,513
0131-002,2017,10,31,8,1522,1208,2730,1263
0131-002,2017,10,31,9,1374,1437,2811,2730
0131-002,2017,10,31,10,1058,1189,2247,2811
0131-002,2017,10,31,11,1182,1178,2360,2247
0131-002,2017,10,31,12,1125,1126,2251,2360
0131-002,2017,10,31,13,1011,952,1963,2251
0131-002,2017,10,31,14,1180,1130,2310,1963
0131-002,2017,10,31,15,1249,1284,2533,2310
0131-002,2017,10,31,16,1211,1226,2437,2533
0131-002,2017,10,31,17,1170,1295,2465,2437
0131-002,2017,10,31,18,1186,1602,2788,2465
0131-002,2017,10,31,19,1092,1416,2508,2788
0131-002,2017,10,31,20,723,982,1705,2508
0131-002,2017,10,31,21,561,857,1418,1705
0131-002,2017,10,31,22,419,599,1018,1418
0131-002,2017,10,31,23,268,365,633,1018
0131-002,2017,10,31,24,180,228,408,633
0131-002,2017,11,1,1,105,147,252,408
0131-002,2017,11,1,2,88,120,208,252
0131-002,2017,11,1,3,75,91,166,208
0131-002,2017,11,1,4,84,112,196,166
0131-002,2017,11,1,5,111,143,254,196
0131-002,2017,11,1,6,344,237,581,254
0131-002,2017,11,1,7,889,521,1410,581
0131-002,2017,11,1,8,1726,1158,2884,1410
0131-002,2017,11,1,9,1637,1387,3024,2884
0131-002,2017,11,1,10,1128,1122,2250,3024
0131-002,2017,11,1,11,1298,1069,2367,2250
0131-002,2017,11,1,12,1142,1019,2161,2367
0131-002,2017,11,1,13,1050,951,2001,2161
0131-002,2017,11,1,14,1178,1069,2247,2001
0131-002,2017,11,1,15,1262,1189,2451,2247
0131-002,2017,11,1,16,1256,1223,2479,2451
0131-002,2017,11,1,17,1128,1302,2430,2479
0131-002,2017,11,1,18,1397,1715,3112,2430
0131-002,2017,11,1,19,1126,1463,2589,3112
0131-002,2017,11,1,20,791,921,1712,2589
0131-002,2017,11,1,21,602,761,1363,1712
0131-002,2017,11,1,22,455,552,1007,1363
0131-002,2017,11,1,23,341,356,697,1007
0131-002,2017,11,1,24,227,240,467,697
0131-002,2017,11,2,1,164,165,329,467
0131-002,2017,11,2,2,109,127,236,329
0131-002,2017,11,2,3,76,77,153,236
0131-002,2017,11,2,4,90,83,173,153
0131-002,2017,11,2,5,130,146,276,173
0131-002,2017,11,2,6,359,240,599,276
0131-002,2017,11,2,7,881,580,1461,599
0131-002,2017,11,2,8,1775,1160,2935,1461
0131-002,2017,11,2,9,1554,1400,2954,2935
0131-002,2017,11,2,10,1215,1129,2344,2954
0131-002,2017,11,2,11,1221,1137,2358,2344
0131-002,2017,11,2,12,1087,1110,2197,2358
0131-002,2017,11,2,13,1026,950,1976,2197
0131-002,2017,11,2,14,1224,1106,2330,1976
0131-002,2017,11,2,15,1310,1223,2533,2330
0131-002,2017,11,2,16,1267,1202,2469,2533
0131-002,2017,11,2,17,1293,1195,2488,2469
0131-002,2017,11,2,18,1276,1629,2905,2488
0131-002,2017,11,2,19,1126,1409,2535,2905
0131-002,2017,11,2,20,748,879,1627,2535
0131-002,2017,11,2,21,631,836,1467,1627
0131-002,2017,11,2,22,531,555,1086,1467
0131-002,2017,11,2,23,352,325,677,1086
0131-002,2017,11,2,24,193,225,418,677
0131-002,2017,11,3,1,128,148,276,418
0131-002,2017,11,3,2,88,105,193,276
0131-002,2017,11,3,3,83,84,167,193
0131-002,2017,11,3,4,76,77,153,167
0131-002,2017,11,3,5,121,110,231,153
0131-002,2017,11,3,6,342,221,563,231
0131-002,2017,11,3,7,800,522,1322,563
0131-002,2017,11,3,8,1650,1138,2788,1322
0131-002,2017,11,3,9,1592,1362,2954,2788
0131-002,2017,11,3,10,1073,1098,2171,2954
0131-002,2017,11,3,11,1106,1153,2259,2171
0131-002,2017,11,3,12,1093,1091,2184,2259
0131-002,2017,11,3,13,882,959,1841,2184
0131-002,2017,11,3,14,1070,1002,2072,1841
0131-002,2017,11,3,15,1222,1205,2427,2072
0131-002,2017,11,3,16,1267,1269,2536,2427
0131-002,2017,11,3,17,1159,1255,2414,2536
0131-002,2017,11,3,18,1232,1705,2937,2414
0131-002,2017,11,3,19,1283,1664,2947,2937
0131-002,2017,11,3,20,780,1104,1884,2947
0131-002,2017,11,3,21,625,845,1470,1884
0131-002,2017,11,3,22,439,590,1029,1470
0131-002,2017,11,3,23,356,385,741,1029
0131-002,2017,11,3,24,179,237,416,741
0131-002,2017,11,4,1,161,189,350,416
0131-002,2017,11,4,2,93,120,213,350
0131-002,2017,11,4,3,75,102,177,213
0131-002,2017,11,4,4,64,101,165,177
0131-002,2017,11,4,5,112,129,241,165
0131-002,2017,11,4,6,232,209,441,241
0131-002,2017,11,4,7,518,472,990,441
0131-002,2017,11,4,8,845,725,1570,990
0131-002,2017,11,4,9,915,1021,1936,1570
0131-002,2017,11,4,10,1009,1024,2033,1936
0131-002,2017,11,4,11,1023,1010,2033,2033
0131-002,2017,11,4,12,1054,1038,2092,2033
0131-002,2017,11,4,13,1050,967,2017,2092
0131-002,2017,11,4,14,963,957,1920,2017
0131-002,2017,11,4,15,1094,993,2087,1920
0131-002,2017,11,4,16,1111,1100,2211,2087
0131-002,2017,11,4,17,1136,1254,2390,2211
0131-002,2017,11,4,18,1137,1425,2562,2390
0131-002,2017,11,4,19,979,1032,2011,2562
0131-002,2017,11,4,20,708,668,1376,2011
0131-002,2017,11,4,21,468,490,958,1376
0131-002,2017,11,4,22,292,421,713,958
0131-002,2017,11,4,23,194,287,481,713
0131-002,2017,11,4,24,119,208,327,481
0131-002,2017,11,5,1,104,150,254,327
0131-002,2017,11,5,2,58,109,167,254
0131-002,2017,11,5,3,44,73,117,167
0131-002,2017,11,5,4,43,68,111,117
0131-002,2017,11,5,5,44,98,142,111
0131-002,2017,11,5,6,84,113,197,142
0131-002,2017,11,5,7,180,238,418,197
0131-002,2017,11,5,8,255,340,595,418
0131-002,2017,11,5,9,382,519,901,595
0131-002,2017,11,5,10,436,663,1099,901
0131-002,2017,11,5,11,608,767,1375,1099
0131-002,2017,11,5,12,675,697,1372,1375
0131-002,2017,11,5,13,746,723,1469,1372
0131-002,2017,11,5,14,848,785,1633,1469
0131-002,2017,11,5,15,845,909,1754,1633
0131-002,2017,11,5,16,964,981,1945,1754
0131-002,2017,11,5,17,1104,1024,2128,1945
0131-002,2017,11,5,18,1190,1050,2240,2128
0131-002,2017,11,5,19,1016,840,1856,2240
0131-002,2017,11,5,20,713,666,1379,1856
0131-002,2017,11,5,21,581,497,1078,1379
0131-002,2017,11,5,22,442,421,863,1078
0131-002,2017,11,5,23,306,263,569,863
0131-002,2017,11,5,24,174,179,353,569
0131-002,2017,11,6,1,91,101,192,353
0131-002,2017,11,6,2,66,51,117,192
0131-002,2017,11,6,3,60,55,115,117
0131-002,2017,11,6,4,52,51,103,115
0131-002,2017,11,6,5,102,146,248,103
0131-002,2017,11,6,6,286,261,547,248
0131-002,2017,11,6,7,845,599,1444,547
0131-002,2017,11,6,8,1638,1207,2845,1444
0131-002,2017,11,6,9,1605,1317,2922,2845
0131-002,2017,11,6,10,1072,1078,2150,2922
0131-002,2017,11,6,11,1169,1094,2263,2150
0131-002,2017,11,6,12,1130,1044,2174,2263
0131-002,2017,11,6,13,972,960,1932,2174
0131-002,2017,11,6,14,1188,1049,2237,1932
0131-002,2017,11,6,15,1322,1234,2556,2237
0131-002,2017,11,6,16,1264,1290,2554,2556
0131-002,2017,11,6,17,1159,1305,2464,2554
0131-002,2017,11,6,18,1331,1554,2885,2464
0131-002,2017,11,6,19,1180,1350,2530,2885
0131-002,2017,11,6,20,761,950,1711,2530
0131-002,2017,11,6,21,588,837,1425,1711
0131-002,2017,11,6,22,419,477,896,1425
0131-002,2017,11,6,23,312,368,680,896
0131-002,2017,11,6,24,161,236,397,680
0131-002,2017,11,7,1,140,143,283,397
0131-002,2017,11,7,2,89,91,180,283
0131-002,2017,11,7,3,45,89,134,180
0131-002,2017,11,7,4,74,81,155,134
0131-002,2017,11,7,5,119,151,270,155
0131-002,2017,11,7,6,334,236,570,270
0131-002,2017,11,7,7,797,538,1335,570
0131-002,2017,11,7,8,1753,1144,2897,1335
0131-002,2017,11,7,9,1527,1432,2959,2897
0131-002,2017,11,7,10,1144,1233,2377,2959
0131-002,2017,11,7,11,1288,1241,2529,2377
0131-002,2017,11,7,12,1229,1164,2393,2529
0131-002,2017,11,7,13,970,958,1928,2393
0131-002,2017,11,7,14,1214,1096,2310,1928
0131-002,2017,11,7,15,1355,1255,2610,2310
0131-002,2017,11,7,16,1247,1288,2535,2610
0131-002,2017,11,7,17,1220,1270,2490,2535
0131-002,2017,11,7,18,1280,1605,2885,2490
0131-002,2017,11,7,19,1162,1392,2554,2885
0131-002,2017,11,7,20,845,893,1738,2554
0131-002,2017,11,7,21,633,819,1452,1738
0131-002,2017,11,7,22,509,531,1040,1452
0131-002,2017,11,7,23,379,369,748,1040
0131-002,2017,11,7,24,206,209,415,748
0131-002,2017,11,8,1,156,149,305,415
0131-002,2017,11,8,2,82,126,208,305
0131-002,2017,11,8,3,67,84,151,208
0131-002,2017,11,8,4,82,91,173,151
0131-002,2017,11,8,5,121,136,257,173
0131-002,2017,11,8,6,391,233,624,257
0131-002,2017,11,8,7,865,534,1399,624
0131-002,2017,11,8,8,1790,1131,2921,1399
0131-002,2017,11,8,9,1630,1341,2971,2921
0131-002,2017,11,8,10,1199,1105,2304,2971
0131-002,2017,11,8,11,1182,1106,2288,2304
0131-002,2017,11,8,12,1160,998,2158,2288
0131-002,2017,11,8,13,1010,917,1927,2158
0131-002,2017,11,8,14,1133,1050,2183,1927
0131-002,2017,11,8,15,1290,1188,2478,2183
0131-002,2017,11,8,16,1220,1123,2343,2478
0131-002,2017,11,8,17,1168,1286,2454,2343
0131-002,2017,11,8,18,1307,1599,2906,2454
0131-002,2017,11,8,19,1259,1357,2616,2906
0131-002,2017,11,8,20,801,881,1682,2616
0131-002,2017,11,8,21,565,720,1285,1682
0131-002,2017,11,8,22,483,510,993,1285
0131-002,2017,11,8,23,328,384,712,993
0131-002,2017,11,8,24,179,240,419,712
0131-002,2017,11,9,1,148,147,295,419
0131-002,2017,11,9,2,58,128,186,295
0131-002,2017,11,9,3,67,87,154,186
0131-002,2017,11,9,4,65,98,163,154
0131-002,2017,11,9,5,96,128,224,163
0131-002,2017,11,9,6,318,246,564,224
0131-002,2017,11,9,7,756,543,1299,564
0131-002,2017,11,9,8,1616,1164,2780,1299
0131-002,2017,11,9,9,1475,1445,2920,2780
0131-002,2017,11,9,10,1093,1177,2270,2920
0131-002,2017,11,9,11,1298,1123,2421,2270
0131-002,2017,11,9,12,1165,1156,2321,2421
0131-002,2017,11,9,13,1063,896,1959,2321
0131-002,2017,11,9,14,1119,1095,2214,1959
0131-002,2017,11,9,15,1268,1240,2508,2214
0131-002,2017,11,9,16,1224,1186,2410,2508
0131-002,2017,11,9,17,1220,1282,2502,2410
0131-002,2017,11,9,18,1232,1660,2892,2502
0131-002,2017,11,9,19,1157,1297,2454,2892
0131-002,2017,11,9,20,730,925,1655,2454
0131-002,2017,11,9,21,615,786,1401,1655
0131-002,2017,11,9,22,466,598,1064,1401
0131-002,2017,11,9,23,326,358,684,1064
0131-002,2017,11,9,24,180,216,396,684
0131-002,2017,11,10,1,125,161,286,396
0131-002,2017,11,10,2,91,107,198,286
0131-002,2017,11,10,3,43,92,135,198
0131-002,2017,11,10,4,57,85,142,135
0131-002,2017,11,10,5,114,122,236,142
0131-002,2017,11,10,6,303,236,539,236
0131-002,2017,11,10,7,787,579,1366,539
0131-002,2017,11,10,8,1668,1169,2837,1366
0131-002,2017,11,10,9,1576,1419,2995,2837
0131-002,2017,11,10,10,1268,1232,2500,2995
0131-002,2017,11,10,11,1184,1139,2323,2500
0131-002,2017,11,10,12,1200,1179,2379,2323
0131-002,2017,11,10,13,1049,999,2048,2379
0131-002,2017,11,10,14,1146,1163,2309,2048
0131-002,2017,11,10,15,1299,1270,2569,2309
0131-002,2017,11,10,16,1243,1255,2498,2569
0131-002,2017,11,10,17,1159,1345,2504,2498
0131-002,2017,11,10,18,1197,1711,2908,2504
0131-002,2017,11,10,19,1254,1608,2862,2908
0131-002,2017,11,10,20,875,1148,2023,2862
0131-002,2017,11,10,21,549,856,1405,2023
0131-002,2017,11,10,22,394,500,894,1405
0131-002,2017,11,10,23,264,404,668,894
0131-002,2017,11,10,24,145,269,414,668
0131-002,2017,11,11,1,99,170,269,414
0131-002,2017,11,11,2,76,128,204,269
0131-002,2017,11,11,3,77,89,166,204
0131-002,2017,11,11,4,57,87,144,166
0131-002,2017,11,11,5,91,154,245,144
0131-002,2017,11,11,6,234,234,468,245
0131-002,2017,11,11,7,463,467,930,468
0131-002,2017,11,11,8,796,763,1559,930
0131-002,2017,11,11,9,940,1054,1994,1559
0131-002,2017,11,11,10,894,1074,1968,1994
0131-002,2017,11,11,11,1187,1015,2202,1968
0131-002,2017,11,11,12,1085,967,2052,2202
0131-002,2017,11,11,13,1093,1001,2094,2052
0131-002,2017,11,11,14,1048,988,2036,2094
0131-002,2017,11,11,15,1137,985,2122,2036
0131-002,2017,11,11,16,1080,1125,2205,2122
0131-002,2017,11,11,17,1058,1127,2185,2205
0131-002,2017,11,11,18,1153,1413,2566,2185
0131-002,2017,11,11,19,956,1063,2019,2566
0131-002,2017,11,11,20,602,630,1232,2019
0131-002,2017,11,11,21,406,485,891,1232
0131-002,2017,11,11,22,292,412,704,891
0131-002,2017,11,11,23,190,281,471,704
0131-002,2017,11,11,24,121,221,342,471
0131-002,2017,11,12,1,77,136,213,342
0131-002,2017,11,12,2,56,104,160,213
0131-002,2017,11,12,3,36,94,130,160
0131-002,2017,11,12,4,42,82,124,130
0131-002,2017,11,12,5,38,97,135,124
0131-002,2017,11,12,6,77,143,220,135
0131-002,2017,11,12,7,166,240,406,220
0131-002,2017,11,12,8,264,333,597,406
0131-002,2017,11,12,9,329,486,815,597
0131-002,2017,11,12,10,455,569,1024,815
0131-002,2017,11,12,11,607,632,1239,1024
0131-002,2017,11,12,12,662,665,1327,1239
0131-002,2017,11,12,13,720,680,1400,1327
0131-002,2017,11,12,14,780,756,1536,1400
0131-002,2017,11,12,15,837,837,1674,1536
0131-002,2017,11,12,16,993,992,1985,1674
0131-002,2017,11,12,17,999,1012,2011,1985
0131-002,2017,11,12,18,1154,995,2149,2011
0131-002,2017,11,12,19,1112,839,1951,2149
0131-002,2017,11,12,20,854,621,1475,1951
0131-002,2017,11,12,21,571,505,1076,1475
0131-002,2017,11,12,22,399,383,782,1076
0131-002,2017,11,12,23,251,291,542,782
0131-002,2017,11,12,24,124,157,281,542
0131-002,2017,11,13,1,74,85,159,281
0131-002,2017,11,13,2,53,70,123,159
0131-002,2017,11,13,3,39,57,96,123
0131-002,2017,11,13,4,46,60,106,96
0131-002,2017,11,13,5,94,117,211,106
0131-002,2017,11,13,6,339,266,605,211
0131-002,2017,11,13,7,824,606,1430,605
0131-002,2017,11,13,8,1650,1250,2900,1430
0131-002,2017,11,13,9,1513,1352,2865,2900
0131-002,2017,11,13,10,1038,1074,2112,2865
0131-002,2017,11,13,11,1140,1119,2259,2112
0131-002,2017,11,13,12,1089,1091,2180,2259
0131-002,2017,11,13,13,1038,966,2004,2180
0131-002,2017,11,13,14,1196,1081,2277,2004
0131-002,2017,11,13,15,1250,1218,2468,2277
0131-002,2017,11,13,16,1286,1156,2442,2468
0131-002,2017,11,13,17,1158,1222,2380,2442
0131-002,2017,11,13,18,1188,1426,2614,2380
0131-002,2017,11,13,19,1148,1362,2510,2614
0131-002,2017,11,13,20,735,920,1655,2510
0131-002,2017,11,13,21,546,809,1355,1655
0131-002,2017,11,13,22,431,515,946,1355
0131-002,2017,11,13,23,309,346,655,946
0131-002,2017,11,13,24,163,242,405,655
0131-002,2017,11,14,1,133,135,268,405
0131-002,2017,11,14,2,88,93,181,268
0131-002,2017,11,14,3,53,60,113,181
0131-002,2017,11,14,4,85,104,189,113
0131-002,2017,11,14,5,147,137,284,189
0131-002,2017,11,14,6,302,208,510,284
0131-002,2017,11,14,7,807,541,1348,510
0131-002,2017,11,14,8,1644,1209,2853,1348
0131-002,2017,11,14,9,1558,1413,2971,2853
0131-002,2017,11,14,10,1205,1158,2363,2971
0131-002,2017,11,14,11,1245,1161,2406,2363
0131-002,2017,11,14,12,1198,1133,2331,2406
0131-002,2017,11,14,13,1008,1008,2016,2331
0131-002,2017,11,14,14,1190,1184,2374,2016
0131-002,2017,11,14,15,1315,1237,2552,2374
0131-002,2017,11,14,16,1331,1229,2560,2552
0131-002,2017,11,14,17,1204,1290,2494,2560
0131-002,2017,11,14,18,1217,1572,2789,2494
0131-002,2017,11,14,19,1017,1356,2373,2789
0131-002,2017,11,14,20,663,968,1631,2373
0131-002,2017,11,14,21,549,845,1394,1631
0131-002,2017,11,14,22,446,538,984,1394
0131-002,2017,11,14,23,305,354,659,984
0131-002,2017,11,14,24,147,233,380,659
0131-002,2017,11,15,1,111,151,262,380
0131-002,2017,11,15,2,80,100,180,262
0131-002,2017,11,15,3,49,75,124,180
0131-002,2017,11,15,4,70,70,140,124
0131-002,2017,11,15,5,121,129,250,140
0131-002,2017,11,15,6,278,206,484,250
0131-002,2017,11,15,7,789,548,1337,484
0131-002,2017,11,15,8,1612,1144,2756,1337
0131-002,2017,11,15,9,1522,1464,2986,2756
0131-002,2017,11,15,10,1206,1196,2402,2986
0131-002,2017,11,15,11,1166,1221,2387,2402
0131-002,2017,11,15,12,1165,1142,2307,2387
0131-002,2017,11,15,13,1054,972,2026,2307
0131-002,2017,11,15,14,1128,1090,2218,2026
0131-002,2017,11,15,15,1290,1182,2472,2218
0131-002,2017,11,15,16,1245,1231,2476,2472
0131-002,2017,11,15,17,1109,1259,2368,2476
0131-002,2017,11,15,18,1205,1714,2919,2368
0131-002,2017,11,15,19,1044,1392,2436,2919
0131-002,2017,11,15,20,644,905,1549,2436
0131-002,2017,11,15,21,494,734,1228,1549
0131-002,2017,11,15,22,382,518,900,1228
0131-002,2017,11,15,23,264,357,621,900
0131-002,2017,11,15,24,163,245,408,621
0131-002,2017,11,16,1,106,174,280,408
0131-002,2017,11,16,2,68,92,160,280
0131-002,2017,11,16,3,47,84,131,160
0131-002,2017,11,16,4,60,81,141,131
0131-002,2017,11,16,5,104,131,235,141
0131-002,2017,11,16,6,235,215,450,235
0131-002,2017,11,16,7,711,516,1227,450
0131-002,2017,11,16,8,1483,1107,2590,1227
0131-002,2017,11,16,9,1330,1438,2768,2590
0131-002,2017,11,16,10,1074,1173,2247,2768
0131-002,2017,11,16,11,1126,1160,2286,2247
0131-002,2017,11,16,12,1083,1054,2137,2286
0131-002,2017,11,16,13,1016,1001,2017,2137
0131-002,2017,11,16,14,1174,1121,2295,2017
0131-002,2017,11,16,15,1250,1236,2486,2295
0131-002,2017,11,16,16,1216,1216,2432,2486
0131-002,2017,11,16,17,1168,1330,2498,2432
0131-002,2017,11,16,18,1110,1510,2620,2498
0131-002,2017,11,16,19,934,1409,2343,2620
0131-002,2017,11,16,20,632,957,1589,2343
0131-002,2017,11,16,21,437,824,1261,1589
0131-002,2017,11,16,22,324,545,869,1261
0131-002,2017,11,16,23,211,355,566,869
0131-002,2017,11,16,24,99,226,325,566
0131-002,2017,11,17,1,107,181,288,325
0131-002,2017,11,17,2,89,78,167,288
0131-002,2017,11,17,3,49,89,138,167
0131-002,2017,11,17,4,56,86,142,138
0131-002,2017,11,17,5,101,136,237,142
0131-002,2017,11,17,6,272,201,473,237
0131-002,2017,11,17,7,675,533,1208,473
0131-002,2017,11,17,8,1462,1105,2567,1208
0131-002,2017,11,17,9,1385,1359,2744,2567
0131-002,2017,11,17,10,1105,1130,2235,2744
0131-002,2017,11,17,11,1090,1169,2259,2235
0131-002,2017,11,17,12,1090,1119,2209,2259
0131-002,2017,11,17,13,928,1007,1935,2209
0131-002,2017,11,17,14,1052,1101,2153,1935
0131-002,2017,11,17,15,1141,1253,2394,2153
0131-002,2017,11,17,16,1120,1253,2373,2394
0131-002,2017,11,17,17,1118,1379,2497,2373
0131-002,2017,11,17,18,1181,1749,2930,2497
0131-002,2017,11,17,19,1065,1665,2730,2930
0131-002,2017,11,17,20,776,1184,1960,2730
0131-002,2017,11,17,21,533,884,1417,1960
0131-002,2017,11,17,22,342,585,927,1417
0131-002,2017,11,17,23,257,331,588,927
0131-002,2017,11,17,24,145,283,428,588
0131-002,2017,11,18,1,108,197,305,428
0131-002,2017,11,18,2,85,135,220,305
0131-002,2017,11,18,3,54,97,151,220
0131-002,2017,11,18,4,64,84,148,151
0131-002,2017,11,18,5,78,131,209,148
0131-002,2017,11,18,6,195,190,385,209
0131-002,2017,11,18,7,429,429,858,385
0131-002,2017,11,18,8,738,681,1419,858
0131-002,2017,11,18,9,823,965,1788,1419
0131-002,2017,11,18,10,822,967,1789,1788
0131-002,2017,11,18,11,866,1049,1915,1789
0131-002,2017,11,18,12,968,972,1940,1915
0131-002,2017,11,18,13,930,961,1891,1940
0131-002,2017,11,18,14,947,955,1902,1891
0131-002,2017,11,18,15,990,1135,2125,1902
0131-002,2017,11,18,16,964,1116,2080,2125
0131-002,2017,11,18,17,984,1176,2160,2080
0131-002,2017,11,18,18,879,1336,2215,2160
0131-002,2017,11,18,19,697,928,1625,2215
0131-002,2017,11,18,20,458,631,1089,1625
0131-002,2017,11,18,21,306,520,826,1089
0131-002,2017,11,18,22,224,372,596,826
0131-002,2017,11,18,23,160,259,419,596
0131-002,2017,11,18,24,93,168,261,419
0131-002,2017,11,19,1,89,139,228,261
0131-002,2017,11,19,2,76,113,189,228
0131-002,2017,11,19,3,62,64,126,189
0131-002,2017,11,19,4,70,58,128,126
0131-002,2017,11,19,5,68,75,143,128
0131-002,2017,11,19,6,89,102,191,143
0131-002,2017,11,19,7,191,182,373,191
0131-002,2017,11,19,8,334,287,621,373
0131-002,2017,11,19,9,465,477,942,621
0131-002,2017,11,19,10,449,568,1017,942
0131-002,2017,11,19,11,470,654,1124,1017
0131-002,2017,11,19,12,555,687,1242,1124
0131-002,2017,11,19,13,639,714,1353,1242
0131-002,2017,11,19,14,742,836,1578,1353
0131-002,2017,11,19,15,843,883,1726,1578
0131-002,2017,11,19,16,956,1051,2007,1726
0131-002,2017,11,19,17,925,1049,1974,2007
0131-002,2017,11,19,18,971,1021,1992,1974
0131-002,2017,11,19,19,902,775,1677,1992
0131-002,2017,11,19,20,783,608,1391,1677
0131-002,2017,11,19,21,518,464,982,1391
0131-002,2017,11,19,22,344,374,718,982
0131-002,2017,11,19,23,262,243,505,718
0131-002,2017,11,19,24,141,171,312,505
0131-002,2017,11,20,1,89,95,184,312
0131-002,2017,11,20,2,52,77,129,184
0131-002,2017,11,20,3,34,47,81,129
0131-002,2017,11,20,4,38,60,98,81
0131-002,2017,11,20,5,85,112,197,98
0131-002,2017,11,20,6,313,218,531,197
0131-002,2017,11,20,7,865,542,1407,531
0131-002,2017,11,20,8,1738,1185,2923,1407
0131-002,2017,11,20,9,1472,1298,2770,2923
0131-002,2017,11,20,10,977,1111,2088,2770
0131-002,2017,11,20,11,1067,1102,2169,2088
0131-002,2017,11,20,12,1122,1014,2136,2169
0131-002,2017,11,20,13,955,926,1881,2136
0131-002,2017,11,20,14,1229,1025,2254,1881
0131-002,2017,11,20,15,1233,1224,2457,2254
0131-002,2017,11,20,16,1152,1194,2346,2457
0131-002,2017,11,20,17,1063,1275,2338,2346
0131-002,2017,11,20,18,1098,1462,2560,2338
0131-002,2017,11,20,19,938,1383,2321,2560
0131-002,2017,11,20,20,606,943,1549,2321
0131-002,2017,11,20,21,492,851,1343,1549
0131-002,2017,11,20,22,325,494,819,1343
0131-002,2017,11,20,23,231,317,548,819
0131-002,2017,11,20,24,107,197,304,548
0131-002,2017,11,21,1,78,124,202,304
0131-002,2017,11,21,2,57,92,149,202
0131-002,2017,11,21,3,41,82,123,149
0131-002,2017,11,21,4,57,76,133,123
0131-002,2017,11,21,5,112,118,230,133
0131-002,2017,11,21,6,272,178,450,230
0131-002,2017,11,21,7,781,463,1244,450
0131-002,2017,11,21,8,1486,1034,2520,1244
0131-002,2017,11,21,9,1419,1390,2809,2520
0131-002,2017,11,21,10,1043,1164,2207,2809
0131-002,2017,11,21,11,1066,1155,2221,2207
0131-002,2017,11,21,12,1090,1049,2139,2221
0131-002,2017,11,21,13,965,981,1946,2139
0131-002,2017,11,21,14,1135,1065,2200,1946
0131-002,2017,11,21,15,1285,1176,2461,2200
0131-002,2017,11,21,16,1178,1178,2356,2461
0131-002,2017,11,21,17,1136,1277,2413,2356
0131-002,2017,11,21,18,1183,1627,2810,2413
0131-002,2017,11,21,19,1021,1382,2403,2810
0131-002,2017,11,21,20,595,899,1494,2403
0131-002,2017,11,21,21,449,836,1285,1494
0131-002,2017,11,21,22,322,552,874,1285
0131-002,2017,11,21,23,256,335,591,874
0131-002,2017,11,21,24,135,229,364,591
0131-002,2017,11,22,1,101,161,262,364
0131-002,2017,11,22,2,74,120,194,262
0131-002,2017,11,22,3,67,95,162,194
0131-002,2017,11,22,4,54,85,139,162
0131-002,2017,11,22,5,106,134,240,139
0131-002,2017,11,22,6,258,220,478,240
0131-002,2017,11,22,7,709,541,1250,478
0131-002,2017,11,22,8,1500,1144,2644,1250
0131-002,2017,11,22,9,1512,1382,2894,2644
0131-002,2017,11,22,10,1062,1172,2234,2894
0131-002,2017,11,22,11,1085,1078,2163,2234
0131-002,2017,11,22,12,1024,1076,2100,2163
0131-002,2017,11,22,13,901,979,1880,2100
0131-002,2017,11,22,14,1118,1112,2230,1880
0131-002,2017,11,22,15,1233,1169,2402,2230
0131-002,2017,11,22,16,1269,1183,2452,2402
0131-002,2017,11,22,17,1123,1221,2344,2452
0131-002,2017,11,22,18,1146,1622,2768,2344
0131-002,2017,11,22,19,1048,1351,2399,2768
0131-002,2017,11,22,20,646,837,1483,2399
0131-002,2017,11,22,21,441,715,1156,1483
0131-002,2017,11,22,22,325,509,834,1156
0131-002,2017,11,22,23,237,346,583,834
0131-002,2017,11,22,24,140,237,377,583
0131-002,2017,11,23,1,105,135,240,377
0131-002,2017,11,23,2,64,103,167,240
0131-002,2017,11,23,3,41,81,122,167
0131-002,2017,11,23,4,72,87,159,122
0131-002,2017,11,23,5,90,124,214,159
0131-002,2017,11,23,6,238,225,463,214
0131-002,2017,11,23,7,790,480,1270,463
0131-002,2017,11,23,8,1452,1073,2525,1270
0131-002,2017,11,23,9,1440,1297,2737,2525
0131-002,2017,11,23,10,979,1149,2128,2737
0131-002,2017,11,23,11,901,1036,1937,2128
0131-002,2017,11,23,12,866,1017,1883,1937
0131-002,2017,11,23,13,846,904,1750,1883
0131-002,2017,11,23,14,1041,1069,2110,1750
0131-002,2017,11,23,15,1064,1164,2228,2110
0131-002,2017,11,23,16,1049,1073,2122,2228
0131-002,2017,11,23,17,1012,1140,2152,2122
0131-002,2017,11,23,18,968,1348,2316,2152
0131-002,2017,11,23,19,831,1159,1990,2316
0131-002,2017,11,23,20,610,829,1439,1990
0131-002,2017,11,23,21,437,783,1220,1439
0131-002,2017,11,23,22,353,530,883,1220
0131-002,2017,11,23,23,258,351,609,883
0131-002,2017,11,23,24,113,207,320,609
0131-002,2017,11,24,1,81,159,240,320
0131-002,2017,11,24,2,56,94,150,240
0131-002,2017,11,24,3,50,76,126,150
0131-002,2017,11,24,4,66,82,148,126
0131-002,2017,11,24,5,44,97,141,148
0131-002,2017,11,24,6,155,181,336,141
0131-002,2017,11,24,7,431,387,818,336
0131-002,2017,11,24,8,999,923,1922,818
0131-002,2017,11,24,9,1108,1081,2189,1922
0131-002,2017,11,24,10,814,944,1758,2189
0131-002,2017,11,24,11,908,965,1873,1758
0131-002,2017,11,24,12,812,947,1759,1873
0131-002,2017,11,24,13,753,859,1612,1759
0131-002,2017,11,24,14,894,984,1878,1612
0131-002,2017,11,24,15,1024,933,1957,1878
0131-002,2017,11,24,16,968,1086,2054,1957
0131-002,2017,11,24,17,911,1191,2102,2054
0131-002,2017,11,24,18,994,1511,2505,2102
0131-002,2017,11,24,19,911,1318,2229,2505
0131-002,2017,11,24,20,569,900,1469,2229
0131-002,2017,11,24,21,399,721,1120,1469
0131-002,2017,11,24,22,272,503,775,1120
0131-002,2017,11,24,23,196,337,533,775
0131-002,2017,11,24,24,123,212,335,533
0131-002,2017,11,25,1,92,181,273,335
0131-002,2017,11,25,2,52,119,171,273
0131-002,2017,11,25,3,33,83,116,171
0131-002,2017,11,25,4,47,91,138,116
0131-002,2017,11,25,5,46,126,172,138
0131-002,2017,11,25,6,115,186,301,172
0131-002,2017,11,25,7,373,362,735,301
0131-002,2017,11,25,8,710,631,1341,735
0131-002,2017,11,25,9,782,881,1663,1341
0131-002,2017,11,25,10,839,909,1748,1663
0131-002,2017,11,25,11,877,1018,1895,1748
0131-002,2017,11,25,12,917,918,1835,1895
0131-002,2017,11,25,13,1008,874,1882,1835
0131-002,2017,11,25,14,964,973,1937,1882
0131-002,2017,11,25,15,957,1053,2010,1937
0131-002,2017,11,25,16,977,983,1960,2010
0131-002,2017,11,25,17,956,1030,1986,1960
0131-002,2017,11,25,18,997,1364,2361,1986
0131-002,2017,11,25,19,732,872,1604,2361
0131-002,2017,11,25,20,608,541,1149,1604
0131-002,2017,11,25,21,473,455,928,1149
0131-002,2017,11,25,22,348,357,705,928
0131-002,2017,11,25,23,217,273,490,705
0131-002,2017,11,25,24,169,198,367,490
0131-002,2017,11,26,1,120,131,251,367
0131-002,2017,11,26,2,81,104,185,251
0131-002,2017,11,26,3,84,62,146,185
0131-002,2017,11,26,4,47,67,114,146
0131-002,2017,11,26,5,57,85,142,114
0131-002,2017,11,26,6,96,80,176,142
0131-002,2017,11,26,7,179,162,341,176
0131-002,2017,11,26,8,267,290,557,341
0131-002,2017,11,26,9,366,401,767,557
0131-002,2017,11,26,10,411,551,962,767
0131-002,2017,11,26,11,478,632,1110,962
0131-002,2017,11,26,12,601,639,1240,1110
0131-002,2017,11,26,13,698,677,1375,1240
0131-002,2017,11,26,14,764,731,1495,1375
0131-002,2017,11,26,15,851,796,1647,1495
0131-002,2017,11,26,16,910,896,1806,1647
0131-002,2017,11,26,17,953,897,1850,1806
0131-002,2017,11,26,18,993,972,1965,1850
0131-002,2017,11,26,19,929,780,1709,1965
0131-002,2017,11,26,20,726,608,1334,1709
0131-002,2017,11,26,21,653,467,1120,1334
0131-002,2017,11,26,22,501,371,872,1120
0131-002,2017,11,26,23,302,241,543,872
0131-002,2017,11,26,24,146,170,316,543
0131-002,2017,11,27,1,91,106,197,316
0131-002,2017,11,27,2,54,60,114,197
0131-002,2017,11,27,3,34,49,83,114
0131-002,2017,11,27,4,47,56,103,83
0131-002,2017,11,27,5,93,119,212,103
0131-002,2017,11,27,6,319,207,526,212
0131-002,2017,11,27,7,826,532,1358,526
0131-002,2017,11,27,8,1708,1140,2848,1358
0131-002,2017,11,27,9,1448,1307,2755,2848
0131-002,2017,11,27,10,993,1084,2077,2755
0131-002,2017,11,27,11,1097,1100,2197,2077
0131-002,2017,11,27,12,1148,1038,2186,2197
0131-002,2017,11,27,13,972,949,1921,2186
0131-002,2017,11,27,14,1181,1017,2198,1921
0131-002,2017,11,27,15,1206,1146,2352,2198
0131-002,2017,11,27,16,1173,1133,2306,2352
0131-002,2017,11,27,17,1237,1212,2449,2306
0131-002,2017,11,27,18,1140,1487,2627,2449
0131-002,2017,11,27,19,1012,1296,2308,2627
0131-002,2017,11,27,20,639,895,1534,2308
0131-002,2017,11,27,21,532,797,1329,1534
0131-002,2017,11,27,22,386,515,901,1329
0131-002,2017,11,27,23,217,342,559,901
0131-002,2017,11,27,24,143,196,339,559
0131-002,2017,11,28,1,131,123,254,339
0131-002,2017,11,28,2,78,110,188,254
0131-002,2017,11,28,3,60,79,139,188
0131-002,2017,11,28,4,72,76,148,139
0131-002,2017,11,28,5,148,136,284,148
0131-002,2017,11,28,6,284,209,493,284
0131-002,2017,11,28,7,735,507,1242,493
0131-002,2017,11,28,8,1448,1179,2627,1242
0131-002,2017,11,28,9,1550,1315,2865,2627
0131-002,2017,11,28,10,1110,1097,2207,2865
0131-002,2017,11,28,11,1105,1104,2209,2207
0131-002,2017,11,28,12,1064,1064,2128,2209
0131-002,2017,11,28,13,1024,922,1946,2128
0131-002,2017,11,28,14,1264,1079,2343,1946
0131-002,2017,11,28,15,1298,1162,2460,2343
0131-002,2017,11,28,16,1302,1110,2412,2460
0131-002,2017,11,28,17,1217,1254,2471,2412
0131-002,2017,11,28,18,1159,1499,2658,2471
0131-002,2017,11,28,19,1079,1268,2347,2658
0131-002,2017,11,28,20,726,830,1556,2347
0131-002,2017,11,28,21,528,786,1314,1556
0131-002,2017,11,28,22,404,538,942,1314
0131-002,2017,11,28,23,256,346,602,942
0131-002,2017,11,28,24,242,209,451,602
0131-002,2017,11,29,1,133,157,290,451
0131-002,2017,11,29,2,112,90,202,290
0131-002,2017,11,29,3,85,87,172,202
0131-002,2017,11,29,4,97,85,182,172
0131-002,2017,11,29,5,113,112,225,182
0131-002,2017,11,29,6,341,223,564,225
0131-002,2017,11,29,7,808,512,1320,564
0131-002,2017,11,29,8,1612,1118,2730,1320
0131-002,2017,11,29,9,1502,1316,2818,2730
0131-002,2017,11,29,10,1132,1009,2141,2818
0131-002,2017,11,29,11,1180,1051,2231,2141
0131-002,2017,11,29,12,1112,989,2101,2231
0131-002,2017,11,29,13,984,836,1820,2101
0131-002,2017,11,29,14,1137,981,2118,1820
0131-002,2017,11,29,15,1143,989,2132,2118
0131-002,2017,11,29,16,1094,1057,2151,2132
0131-002,2017,11,29,17,1087,1192,2279,2151
0131-002,2017,11,29,18,1120,1599,2719,2279
0131-002,2017,11,29,19,932,1302,2234,2719
0131-002,2017,11,29,20,650,846,1496,2234
0131-002,2017,11,29,21,474,672,1146,1496
0131-002,2017,11,29,22,359,515,874,1146
0131-002,2017,11,29,23,288,347,635,874
0131-002,2017,11,29,24,172,195,367,635
0131-002,2017,11,30,1,114,137,251,367
0131-002,2017,11,30,2,93,91,184,251
0131-002,2017,11,30,3,72,104,176,184
0131-002,2017,11,30,4,92,98,190,176
0131-002,2017,11,30,5,108,107,215,190
0131-002,2017,11,30,6,311,226,537,215
0131-002,2017,11,30,7,779,484,1263,537
0131-002,2017,11,30,8,1495,1107,2602,1263
0131-002,2017,11,30,9,1478,1299,2777,2602
0131-002,2017,11,30,10,1063,1047,2110,2777
0131-002,2017,11,30,11,1068,1059,2127,2110
0131-002,2017,11,30,12,1026,1070,2096,2127
0131-002,2017,11,30,13,996,939,1935,2096
0131-002,2017,11,30,14,1073,1031,2104,1935
0131-002,2017,11,30,15,1148,1091,2239,2104
0131-002,2017,11,30,16,1172,1093,2265,2239
0131-002,2017,11,30,17,995,1213,2208,2265
0131-002,2017,11,30,18,1110,1429,2539,2208
0131-002,2017,11,30,19,889,1225,2114,2539
0131-002,2017,11,30,20,530,867,1397,2114
0131-002,2017,11,30,21,469,788,1257,1397
0131-002,2017,11,30,22,334,544,878,1257
0131-002,2017,11,30,23,276,337,613,878
0131-002,2017,11,30,24,170,202,372,613
0131-002,2017,12,1,1,125,140,265,372
0131-002,2017,12,1,2,96,111,207,265
0131-002,2017,12,1,3,51,76,127,207
0131-002,2017,12,1,4,57,97,154,127
0131-002,2017,12,1,5,87,113,200,154
0131-002,2017,12,1,6,249,194,443,200
0131-002,2017,12,1,7,667,486,1153,443
0131-002,2017,12,1,8,1482,1086,2568,1153
0131-002,2017,12,1,9,1319,1311,2630,2568
0131-002,2017,12,1,10,979,1064,2043,2630
0131-002,2017,12,1,11,1016,1102,2118,2043
0131-002,2017,12,1,12,1074,1085,2159,2118
0131-002,2017,12,1,13,961,950,1911,2159
0131-002,2017,12,1,14,1073,951,2024,1911
0131-002,2017,12,1,15,1263,1099,2362,2024
0131-002,2017,12,1,16,1230,1225,2455,2362
0131-002,2017,12,1,17,1201,1161,2362,2455
0131-002,2017,12,1,18,1197,1257,2454,2362
0131-002,2017,12,1,19,1172,1445,2617,2454
0131-002,2017,12,1,20,818,1073,1891,2617
0131-002,2017,12,1,21,526,738,1264,1891
0131-002,2017,12,1,22,458,503,961,1264
0131-002,2017,12,1,23,327,346,673,961
0131-002,2017,12,1,24,208,213,421,673
0131-002,2017,12,2,1,143,181,324,421
0131-002,2017,12,2,2,102,123,225,324
0131-002,2017,12,2,3,86,82,168,225
0131-002,2017,12,2,4,78,77,155,168
0131-002,2017,12,2,5,115,120,235,155
0131-002,2017,12,2,6,182,203,385,235
0131-002,2017,12,2,7,414,398,812,385
0131-002,2017,12,2,8,711,684,1395,812
0131-002,2017,12,2,9,763,869,1632,1395
0131-002,2017,12,2,10,783,951,1734,1632
0131-002,2017,12,2,11,927,966,1893,1734
0131-002,2017,12,2,12,1031,986,2017,1893
0131-002,2017,12,2,13,1089,889,1978,2017
0131-002,2017,12,2,14,1003,898,1901,1978
0131-002,2017,12,2,15,1015,978,1993,1901
0131-002,2017,12,2,16,1002,1011,2013,1993
0131-002,2017,12,2,17,1007,1094,2101,2013
0131-002,2017,12,2,18,974,1261,2235,2101
0131-002,2017,12,2,19,795,943,1738,2235
0131-002,2017,12,2,20,550,599,1149,1738
0131-002,2017,12,2,21,404,474,878,1149
0131-002,2017,12,2,22,347,363,710,878
0131-002,2017,12,2,23,222,242,464,710
0131-002,2017,12,2,24,147,205,352,464
0131-002,2017,12,3,1,118,149,267,352
0131-002,2017,12,3,2,90,116,206,267
0131-002,2017,12,3,3,51,79,130,206
0131-002,2017,12,3,4,69,67,136,130
0131-002,2017,12,3,5,61,82,143,136
0131-002,2017,12,3,6,81,113,194,143
0131-002,2017,12,3,7,190,181,371,194
0131-002,2017,12,3,8,288,288,576,371
0131-002,2017,12,3,9,362,470,832,576
0131-002,2017,12,3,10,418,584,1002,832
0131-002,2017,12,3,11,459,638,1097,1002
0131-002,2017,12,3,12,499,647,1146,1097
0131-002,2017,12,3,13,626,688,1314,1146
0131-002,2017,12,3,14,554,733,1287,1314
0131-002,2017,12,3,15,758,866,1624,1287
0131-002,2017,12,3,16,849,873,1722,1624
0131-002,2017,12,3,17,819,900,1719,1722
0131-002,2017,12,3,18,806,869,1675,1719
0131-002,2017,12,3,19,780,642,1422,1675
0131-002,2017,12,3,20,561,472,1033,1422
0131-002,2017,12,3,21,461,420,881,1033
0131-002,2017,12,3,22,353,341,694,881
0131-002,2017,12,3,23,267,238,505,694
0131-002,2017,12,3,24,180,156,336,505
0131-002,2017,12,4,1,113,99,212,336
0131-002,2017,12,4,2,84,54,138,212
0131-002,2017,12,4,3,54,54,108,138
0131-002,2017,12,4,4,72,61,133,108
0131-002,2017,12,4,5,116,115,231,133
0131-002,2017,12,4,6,357,206,563,231
0131-002,2017,12,4,7,865,547,1412,563
0131-002,2017,12,4,8,1812,1156,2968,1412
0131-002,2017,12,4,9,1604,1287,2891,2968
0131-002,2017,12,4,10,1117,1083,2200,2891
0131-002,2017,12,4,11,1117,1072,2189,2200
0131-002,2017,12,4,12,1085,978,2063,2189
0131-002,2017,12,4,13,981,917,1898,2063
0131-002,2017,12,4,14,1062,1034,2096,1898
0131-002,2017,12,4,15,1260,1164,2424,2096
0131-002,2017,12,4,16,1241,1206,2447,2424
0131-002,2017,12,4,17,1027,1213,2240,2447
0131-002,2017,12,4,18,1040,1451,2491,2240
0131-002,2017,12,4,19,963,1239,2202,2491
0131-002,2017,12,4,20,647,862,1509,2202
0131-002,2017,12,4,21,493,807,1300,1509
0131-002,2017,12,4,22,395,517,912,1300
0131-002,2017,12,4,23,243,313,556,912
0131-002,2017,12,4,24,149,189,338,556
0131-002,2017,12,5,1,110,129,239,338
0131-002,2017,12,5,2,67,98,165,239
0131-002,2017,12,5,3,57,83,140,165
0131-002,2017,12,5,4,55,75,130,140
0131-002,2017,12,5,5,103,128,231,130
0131-002,2017,12,5,6,224,202,426,231
0131-002,2017,12,5,7,667,504,1171,426
0131-002,2017,12,5,8,1392,1089,2481,1171
0131-002,2017,12,5,9,1223,1396,2619,2481
0131-002,2017,12,5,10,1019,1147,2166,2619
0131-002,2017,12,5,11,1066,1107,2173,2166
0131-002,2017,12,5,12,1025,1080,2105,2173
0131-002,2017,12,5,13,863,959,1822,2105
0131-002,2017,12,5,14,1106,1033,2139,1822
0131-002,2017,12,5,15,1160,1182,2342,2139
0131-002,2017,12,5,16,1176,1142,2318,2342
0131-002,2017,12,5,17,1129,1163,2292,2318
0131-002,2017,12,5,18,1069,1433,2502,2292
0131-002,2017,12,5,19,972,1183,2155,2502
0131-002,2017,12,5,20,639,878,1517,2155
0131-002,2017,12,5,21,484,732,1216,1517
0131-002,2017,12,5,22,374,523,897,1216
0131-002,2017,12,5,23,209,358,567,897
0131-002,2017,12,5,24,110,204,314,567
0131-002,2017,12,6,1,80,150,230,314
0131-002,2017,12,6,2,74,106,180,230
0131-002,2017,12,6,3,40,69,109,180
0131-002,2017,12,6,4,72,62,134,109
0131-002,2017,12,6,5,61,99,160,134
0131-002,2017,12,6,6,171,138,309,160
0131-002,2017,12,6,7,501,391,892,309
0131-002,2017,12,6,8,1137,811,1948,892
0131-002,2017,12,6,9,1063,1008,2071,1948
0131-002,2017,12,6,10,991,952,1943,2071
0131-002,2017,12,6,11,1048,971,2019,1943
0131-002,2017,12,6,12,967,968,1935,2019
0131-002,2017,12,6,13,900,821,1721,1935
0131-002,2017,12,6,14,1073,1001,2074,1721
0131-002,2017,12,6,15,1243,1056,2299,2074
0131-002,2017,12,6,16,1130,1140,2270,2299
0131-002,2017,12,6,17,1028,1093,2121,2270
0131-002,2017,12,6,18,1166,1422,2588,2121
0131-002,2017,12,6,19,970,1265,2235,2588
0131-002,2017,12,6,20,653,836,1489,2235
0131-002,2017,12,6,21,475,614,1089,1489
0131-002,2017,12,6,22,400,470,870,1089
0131-002,2017,12,6,23,277,307,584,870
0131-002,2017,12,6,24,185,208,393,584
0131-002,2017,12,7,1,144,136,280,393
0131-002,2017,12,7,2,118,114,232,280
0131-002,2017,12,7,3,66,74,140,232
0131-002,2017,12,7,4,71,71,142,140
0131-002,2017,12,7,5,110,120,230,142
0131-002,2017,12,7,6,288,180,468,230
0131-002,2017,12,7,7,742,425,1167,468
0131-002,2017,12,7,8,1540,1067,2607,1167
0131-002,2017,12,7,9,1540,1168,2708,2607
0131-002,2017,12,7,10,1059,1008,2067,2708
0131-002,2017,12,7,11,1160,1004,2164,2067
0131-002,2017,12,7,12,1119,1002,2121,2164
0131-002,2017,12,7,13,981,840,1821,2121
0131-002,2017,12,7,14,1123,1049,2172,1821
0131-002,2017,12,7,15,1224,1068,2292,2172
0131-002,2017,12,7,16,1193,1105,2298,2292
0131-002,2017,12,7,17,1129,1243,2372,2298
0131-002,2017,12,7,18,1197,1406,2603,2372
0131-002,2017,12,7,19,1063,1265,2328,2603
0131-002,2017,12,7,20,642,816,1458,2328
0131-002,2017,12,7,21,484,791,1275,1458
0131-002,2017,12,7,22,457,484,941,1275
0131-002,2017,12,7,23,295,335,630,941
0131-002,2017,12,7,24,168,208,376,630
0131-002,2017,12,8,1,172,168,340,376
0131-002,2017,12,8,2,95,115,210,340
0131-002,2017,12,8,3,68,82,150,210
0131-002,2017,12,8,4,68,79,147,150
0131-002,2017,12,8,5,79,129,208,147
0131-002,2017,12,8,6,275,191,466,208
0131-002,2017,12,8,7,645,441,1086,466
0131-002,2017,12,8,8,1442,1027,2469,1086
0131-002,2017,12,8,9,1331,1252,2583,2469
0131-002,2017,12,8,10,945,1064,2009,2583
0131-002,2017,12,8,11,1062,1088,2150,2009
0131-002,2017,12,8,12,986,1101,2087,2150
0131-002,2017,12,8,13,958,944,1902,2087
0131-002,2017,12,8,14,1190,1045,2235,1902
0131-002,2017,12,8,15,1257,1203,2460,2235
0131-002,2017,12,8,16,1145,1221,2366,2460
0131-002,2017,12,8,17,1153,1246,2399,2366
0131-002,2017,12,8,18,1240,1691,2931,2399
0131-002,2017,12,8,19,1160,1560,2720,2931
0131-002,2017,12,8,20,712,974,1686,2720
0131-002,2017,12,8,21,571,777,1348,1686
0131-002,2017,12,8,22,447,532,979,1348
0131-002,2017,12,8,23,319,337,656,979
0131-002,2017,12,8,24,217,247,464,656
0131-002,2017,12,9,1,194,168,362,464
0131-002,2017,12,9,2,115,130,245,362
0131-002,2017,12,9,3,89,102,191,245
0131-002,2017,12,9,4,92,92,184,191
0131-002,2017,12,9,5,113,146,259,184
0131-002,2017,12,9,6,226,198,424,259
0131-002,2017,12,9,7,494,350,844,424
0131-002,2017,12,9,8,894,575,1469,844
0131-002,2017,12,9,9,916,916,1832,1469
0131-002,2017,12,9,10,831,914,1745,1832
0131-002,2017,12,9,11,966,991,1957,1745
0131-002,2017,12,9,12,998,921,1919,1957
0131-002,2017,12,9,13,981,887,1868,1919
0131-002,2017,12,9,14,874,964,1838,1868
0131-002,2017,12,9,15,879,927,1806,1838
0131-002,2017,12,9,16,1003,1034,2037,1806
0131-002,2017,12,9,17,866,1125,1991,2037
0131-002,2017,12,9,18,1097,1393,2490,1991
0131-002,2017,12,9,19,877,900,1777,2490
0131-002,2017,12,9,20,536,594,1130,1777
0131-002,2017,12,9,21,420,380,800,1130
0131-002,2017,12,9,22,358,357,715,800
0131-002,2017,12,9,23,298,265,563,715
0131-002,2017,12,9,24,165,219,384,563
0131-002,2017,12,10,1,173,156,329,384
0131-002,2017,12,10,2,120,111,231,329
0131-002,2017,12,10,3,83,109,192,231
0131-002,2017,12,10,4,60,64,124,192
0131-002,2017,12,10,5,72,82,154,124
0131-002,2017,12,10,6,73,91,164,154
0131-002,2017,12,10,7,182,160,342,164
0131-002,2017,12,10,8,265,250,515,342
0131-002,2017,12,10,9,339,464,803,515
0131-002,2017,12,10,10,359,504,863,803
0131-002,2017,12,10,11,457,600,1057,863
0131-002,2017,12,10,12,555,626,1181,1057
0131-002,2017,12,10,13,601,599,1200,1181
0131-002,2017,12,10,14,684,656,1340,1200
0131-002,2017,12,10,15,793,768,1561,1340
0131-002,2017,12,10,16,797,838,1635,1561
0131-002,2017,12,10,17,718,762,1480,1635
0131-002,2017,12,10,18,670,696,1366,1480
0131-002,2017,12,10,19,626,567,1193,1366
0131-002,2017,12,10,20,451,419,870,1193
0131-002,2017,12,10,21,382,366,748,870
0131-002,2017,12,10,22,315,283,598,748
0131-002,2017,12,10,23,240,240,480,598
0131-002,2017,12,10,24,158,159,317,480
0131-002,2017,12,11,1,90,85,175,317
0131-002,2017,12,11,2,63,63,126,175
0131-002,2017,12,11,3,52,40,92,126
0131-002,2017,12,11,4,44,57,101,92
0131-002,2017,12,11,5,104,95,199,101
0131-002,2017,12,11,6,316,195,511,199
0131-002,2017,12,11,7,824,458,1282,511
0131-002,2017,12,11,8,1627,1034,2661,1282
0131-002,2017,12,11,9,1516,1116,2632,2661
0131-002,2017,12,11,10,1100,1022,2122,2632
0131-002,2017,12,11,11,1026,1038,2064,2122
0131-002,2017,12,11,12,986,1003,1989,2064
0131-002,2017,12,11,13,851,902,1753,1989
0131-002,2017,12,11,14,1037,986,2023,1753
0131-002,2017,12,11,15,1094,1044,2138,2023
0131-002,2017,12,11,16,1054,1128,2182,2138
0131-002,2017,12,11,17,990,1096,2086,2182
0131-002,2017,12,11,18,1014,1373,2387,2086
0131-002,2017,12,11,19,935,1130,2065,2387
0131-002,2017,12,11,20,486,817,1303,2065
0131-002,2017,12,11,21,354,713,1067,1303
0131-002,2017,12,11,22,257,428,685,1067
0131-002,2017,12,11,23,185,290,475,685
0131-002,2017,12,11,24,138,184,322,475
0131-002,2017,12,12,1,87,122,209,322
0131-002,2017,12,12,2,86,89,175,209
0131-002,2017,12,12,3,55,83,138,175
0131-002,2017,12,12,4,69,64,133,138
0131-002,2017,12,12,5,92,101,193,133
0131-002,2017,12,12,6,260,174,434,193
0131-002,2017,12,12,7,703,411,1114,434
0131-002,2017,12,12,8,1468,1002,2470,1114
0131-002,2017,12,12,9,1468,1331,2799,2470
0131-002,2017,12,12,10,993,1053,2046,2799
0131-002,2017,12,12,11,1216,1029,2245,2046
0131-002,2017,12,12,12,1095,1011,2106,2245
0131-002,2017,12,12,13,934,930,1864,2106
0131-002,2017,12,12,14,993,978,1971,1864
0131-002,2017,12,12,15,1015,1174,2189,1971
0131-002,2017,12,12,16,1016,1118,2134,2189
0131-002,2017,12,12,17,995,1187,2182,2134
0131-002,2017,12,12,18,1109,1287,2396,2182
0131-002,2017,12,12,19,764,1130,1894,2396
0131-002,2017,12,12,20,479,774,1253,1894
0131-002,2017,12,12,21,459,752,1211,1253
0131-002,2017,12,12,22,374,518,892,1211
0131-002,2017,12,12,23,237,297,534,892
0131-002,2017,12,12,24,151,202,353,534
0131-002,2017,12,13,1,142,140,282,353
0131-002,2017,12,13,2,85,104,189,282
0131-002,2017,12,13,3,66,73,139,189
0131-002,2017,12,13,4,66,79,145,139
0131-002,2017,12,13,5,98,106,204,145
0131-002,2017,12,13,6,247,186,433,204
0131-002,2017,12,13,7,709,435,1144,433
0131-002,2017,12,13,8,1553,1024,2577,1144
0131-002,2017,12,13,9,1560,1304,2864,2577
0131-002,2017,12,13,10,1127,1051,2178,2864
0131-002,2017,12,13,11,1166,1055,2221,2178
0131-002,2017,12,13,12,1123,1059,2182,2221
0131-002,2017,12,13,13,889,915,1804,2182
0131-002,2017,12,13,14,966,1032,1998,1804
0131-002,2017,12,13,15,1090,1135,2225,1998
0131-002,2017,12,13,16,1077,1116,2193,2225
0131-002,2017,12,13,17,1016,1211,2227,2193
0131-002,2017,12,13,18,1147,1545,2692,2227
0131-002,2017,12,13,19,848,1225,2073,2692
0131-002,2017,12,13,20,536,780,1316,2073
0131-002,2017,12,13,21,453,685,1138,1316
0131-002,2017,12,13,22,354,500,854,1138
0131-002,2017,12,13,23,261,341,602,854
0131-002,2017,12,13,24,165,230,395,602
0131-002,2017,12,14,1,113,162,275,395
0131-002,2017,12,14,2,80,103,183,275
0131-002,2017,12,14,3,55,72,127,183
0131-002,2017,12,14,4,72,69,141,127
0131-002,2017,12,14,5,104,105,209,141
0131-002,2017,12,14,6,259,160,419,209
0131-002,2017,12,14,7,741,447,1188,419
0131-002,2017,12,14,8,1565,1058,2623,1188
0131-002,2017,12,14,9,1543,1310,2853,2623
0131-002,2017,12,14,10,1213,1061,2274,2853
0131-002,2017,12,14,11,1290,1135,2425,2274
0131-002,2017,12,14,12,1119,1079,2198,2425
0131-002,2017,12,14,13,975,952,1927,2198
0131-002,2017,12,14,14,1001,1037,2038,1927
0131-002,2017,12,14,15,1135,1161,2296,2038
0131-002,2017,12,14,16,1059,1195,2254,2296
0131-002,2017,12,14,17,1089,1215,2304,2254
0131-002,2017,12,14,18,1068,1496,2564,2304
0131-002,2017,12,14,19,927,1293,2220,2564
0131-002,2017,12,14,20,601,809,1410,2220
0131-002,2017,12,14,21,513,722,1235,1410
0131-002,2017,12,14,22,381,535,916,1235
0131-002,2017,12,14,23,299,328,627,916
0131-002,2017,12,14,24,179,194,373,627
0131-002,2017,12,15,1,153,154,307,373
0131-002,2017,12,15,2,90,95,185,307
0131-002,2017,12,15,3,87,102,189,185
0131-002,2017,12,15,4,71,80,151,189
0131-002,2017,12,15,5,104,129,233,151
0131-002,2017,12,15,6,260,193,453,233
0131-002,2017,12,15,7,726,452,1178,453
0131-002,2017,12,15,8,1610,1048,2658,1178
0131-002,2017,12,15,9,1510,1278,2788,2658
0131-002,2017,12,15,10,1182,1054,2236,2788
0131-002,2017,12,15,11,1259,1216,2475,2236
0131-002,2017,12,15,12,1154,1065,2219,2475
0131-002,2017,12,15,13,927,994,1921,2219
0131-002,2017,12,15,14,1015,1092,2107,1921
0131-002,2017,12,15,15,1166,1217,2383,2107
0131-002,2017,12,15,16,1173,1204,2377,2383
0131-002,2017,12,15,17,1060,1339,2399,2377
0131-002,2017,12,15,18,1165,1685,2850,2399
0131-002,2017,12,15,19,1117,1544,2661,2850
0131-002,2017,12,15,20,794,969,1763,2661
0131-002,2017,12,15,21,546,826,1372,1763
0131-002,2017,12,15,22,486,512,998,1372
0131-002,2017,12,15,23,352,363,715,998
0131-002,2017,12,15,24,201,243,444,715
0131-002,2017,12,16,1,170,183,353,444
0131-002,2017,12,16,2,129,100,229,353
0131-002,2017,12,16,3,90,113,203,229
0131-002,2017,12,16,4,75,99,174,203
0131-002,2017,12,16,5,77,121,198,174
0131-002,2017,12,16,6,151,148,299,198
0131-002,2017,12,16,7,389,291,680,299
0131-002,2017,12,16,8,684,623,1307,680
0131-002,2017,12,16,9,784,868,1652,1307
0131-002,2017,12,16,10,793,890,1683,1652
0131-002,2017,12,16,11,847,920,1767,1683
0131-002,2017,12,16,12,806,978,1784,1767
0131-002,2017,12,16,13,782,915,1697,1784
0131-002,2017,12,16,14,766,848,1614,1697
0131-002,2017,12,16,15,901,1062,1963,1614
0131-002,2017,12,16,16,862,1005,1867,1963
0131-002,2017,12,16,17,887,1092,1979,1867
0131-002,2017,12,16,18,908,1211,2119,1979
0131-002,2017,12,16,19,788,845,1633,2119
0131-002,2017,12,16,20,434,538,972,1633
0131-002,2017,12,16,21,252,406,658,972
0131-002,2017,12,16,22,202,383,585,658
0131-002,2017,12,16,23,143,258,401,585
0131-002,2017,12,16,24,113,188,301,401
0131-002,2017,12,17,1,80,131,211,301
0131-002,2017,12,17,2,51,101,152,211
0131-002,2017,12,17,3,45,71,116,152
0131-002,2017,12,17,4,46,65,111,116
0131-002,2017,12,17,5,36,83,119,111
0131-002,2017,12,17,6,56,96,152,119
0131-002,2017,12,17,7,150,141,291,152
0131-002,2017,12,17,8,289,288,577,291
0131-002,2017,12,17,9,319,485,804,577
0131-002,2017,12,17,10,354,502,856,804
0131-002,2017,12,17,11,523,616,1139,856
0131-002,2017,12,17,12,652,656,1308,1139
0131-002,2017,12,17,13,604,703,1307,1308
0131-002,2017,12,17,14,650,721,1371,1307
0131-002,2017,12,17,15,659,845,1504,1371
0131-002,2017,12,17,16,735,862,1597,1504
0131-002,2017,12,17,17,731,809,1540,1597
0131-002,2017,12,17,18,792,818,1610,1540
0131-002,2017,12,17,19,603,529,1132,1610
0131-002,2017,12,17,20,350,416,766,1132
0131-002,2017,12,17,21,319,393,712,766
0131-002,2017,12,17,22,259,298,557,712
0131-002,2017,12,17,23,212,226,438,557
0131-002,2017,12,17,24,135,130,265,438
0131-002,2017,12,18,1,89,93,182,265
0131-002,2017,12,18,2,75,64,139,182
0131-002,2017,12,18,3,27,44,71,139
0131-002,2017,12,18,4,45,49,94,71
0131-002,2017,12,18,5,96,103,199,94
0131-002,2017,12,18,6,284,188,472,199
0131-002,2017,12,18,7,780,466,1246,472
0131-002,2017,12,18,8,1582,1043,2625,1246
0131-002,2017,12,18,9,1545,1224,2769,2625
0131-002,2017,12,18,10,1120,974,2094,2769
0131-002,2017,12,18,11,1048,1003,2051,2094
0131-002,2017,12,18,12,1037,1025,2062,2051
0131-002,2017,12,18,13,856,834,1690,2062
0131-002,2017,12,18,14,1089,999,2088,1690
0131-002,2017,12,18,15,1123,1179,2302,2088
0131-002,2017,12,18,16,1124,1122,2246,2302
0131-002,2017,12,18,17,1108,1142,2250,2246
0131-002,2017,12,18,18,1096,1359,2455,2250
0131-002,2017,12,18,19,987,1188,2175,2455
0131-002,2017,12,18,20,626,823,1449,2175
0131-002,2017,12,18,21,534,797,1331,1449
0131-002,2017,12,18,22,380,509,889,1331
0131-002,2017,12,18,23,270,359,629,889
0131-002,2017,12,18,24,167,199,366,629
0131-002,2017,12,19,1,132,122,254,366
0131-002,2017,12,19,2,90,72,162,254
0131-002,2017,12,19,3,56,66,122,162
0131-002,2017,12,19,4,72,71,143,122
0131-002,2017,12,19,5,130,120,250,143
0131-002,2017,12,19,6,299,180,479,250
0131-002,2017,12,19,7,676,433,1109,479
0131-002,2017,12,19,8,1592,945,2537,1109
0131-002,2017,12,19,9,1658,1100,2758,2537
0131-002,2017,12,19,10,1166,1039,2205,2758
0131-002,2017,12,19,11,1126,1064,2190,2205
0131-002,2017,12,19,12,986,1029,2015,2190
0131-002,2017,12,19,13,963,874,1837,2015
0131-002,2017,12,19,14,1068,1082,2150,1837
0131-002,2017,12,19,15,1164,1154,2318,2150
0131-002,2017,12,19,16,1147,1129,2276,2318
0131-002,2017,12,19,17,1067,1213,2280,2276
0131-002,2017,12,19,18,1003,1358,2361,2280
0131-002,2017,12,19,19,1009,1203,2212,2361
0131-002,2017,12,19,20,682,807,1489,2212
0131-002,2017,12,19,21,578,708,1286,1489
0131-002,2017,12,19,22,386,470,856,1286
0131-002,2017,12,19,23,259,304,563,856
0131-002,2017,12,19,24,153,214,367,563
0131-002,2017,12,20,1,107,139,246,367
0131-002,2017,12,20,2,78,113,191,246
0131-002,2017,12,20,3,56,74,130,191
0131-002,2017,12,20,4,63,81,144,130
0131-002,2017,12,20,5,96,120,216,144
0131-002,2017,12,20,6,248,198,446,216
0131-002,2017,12,20,7,714,445,1159,446
0131-002,2017,12,20,8,1638,1008,2646,1159
0131-002,2017,12,20,9,1501,1293,2794,2646
0131-002,2017,12,20,10,1234,1074,2308,2794
0131-002,2017,12,20,11,1190,1085,2275,2308
0131-002,2017,12,20,12,1094,1038,2132,2275
0131-002,2017,12,20,13,950,946,1896,2132
0131-002,2017,12,20,14,1123,1008,2131,1896
0131-002,2017,12,20,15,1230,1216,2446,2131
0131-002,2017,12,20,16,1127,1148,2275,2446
0131-002,2017,12,20,17,1132,1240,2372,2275
0131-002,2017,12,20,18,1125,1483,2608,2372
0131-002,2017,12,20,19,975,1251,2226,2608
0131-002,2017,12,20,20,600,805,1405,2226
0131-002,2017,12,20,21,502,576,1078,1405
0131-002,2017,12,20,22,387,396,783,1078
0131-002,2017,12,20,23,281,301,582,783
0131-002,2017,12,20,24,171,180,351,582
0131-002,2017,12,21,1,141,156,297,351
0131-002,2017,12,21,2,75,104,179,297
0131-002,2017,12,21,3,69,80,149,179
0131-002,2017,12,21,4,73,85,158,149
0131-002,2017,12,21,5,115,121,236,158
0131-002,2017,12,21,6,275,168,443,236
0131-002,2017,12,21,7,699,435,1134,443
0131-002,2017,12,21,8,1374,968,2342,1134
0131-002,2017,12,21,9,1190,1138,2328,2342
0131-002,2017,12,21,10,953,981,1934,2328
0131-002,2017,12,21,11,1037,997,2034,1934
0131-002,2017,12,21,12,1036,1018,2054,2034
0131-002,2017,12,21,13,922,906,1828,2054
0131-002,2017,12,21,14,1103,1025,2128,1828
0131-002,2017,12,21,15,1214,1167,2381,2128
0131-002,2017,12,21,16,1168,1169,2337,2381
0131-002,2017,12,21,17,1131,1220,2351,2337
0131-002,2017,12,21,18,1185,1513,2698,2351
0131-002,2017,12,21,19,1001,1227,2228,2698
0131-002,2017,12,21,20,639,847,1486,2228
0131-002,2017,12,21,21,546,760,1306,1486
0131-002,2017,12,21,22,446,511,957,1306
0131-002,2017,12,21,23,308,333,641,957
0131-002,2017,12,21,24,201,272,473,641
0131-002,2017,12,22,1,191,145,336,473
0131-002,2017,12,22,2,87,103,190,336
0131-002,2017,12,22,3,81,71,152,190
0131-002,2017,12,22,4,80,85,165,152
0131-002,2017,12,22,5,115,132,247,165
0131-002,2017,12,22,6,272,194,466,247
0131-002,2017,12,22,7,684,451,1135,466
0131-002,2017,12,22,8,1465,982,2447,1135
0131-002,2017,12,22,9,1389,1187,2576,2447
0131-002,2017,12,22,10,1121,1114,2235,2576
0131-002,2017,12,22,11,1090,1165,2255,2235
0131-002,2017,12,22,12,1068,1121,2189,2255
0131-002,2017,12,22,13,1016,994,2010,2189
0131-002,2017,12,22,14,1231,1133,2364,2010
0131-002,2017,12,22,15,1388,1235,2623,2364
0131-002,2017,12,22,16,1272,1206,2478,2623
0131-002,2017,12,22,17,1283,1375,2658,2478
0131-002,2017,12,22,18,1400,1711,3111,2658
0131-002,2017,12,22,19,1188,1523,2711,3111
0131-002,2017,12,22,20,868,1057,1925,2711
0131-002,2017,12,22,21,552,798,1350,1925
0131-002,2017,12,22,22,490,541,1031,1350
0131-002,2017,12,22,23,337,375,712,1031
0131-002,2017,12,22,24,224,278,502,712
0131-002,2017,12,23,1,187,191,378,502
0131-002,2017,12,23,2,145,158,303,378
0131-002,2017,12,23,3,107,109,216,303
0131-002,2017,12,23,4,98,107,205,216
0131-002,2017,12,23,5,114,138,252,205
0131-002,2017,12,23,6,273,188,461,252
0131-002,2017,12,23,7,531,351,882,461
0131-002,2017,12,23,8,828,649,1477,882
0131-002,2017,12,23,9,856,832,1688,1477
0131-002,2017,12,23,10,835,920,1755,1688
0131-002,2017,12,23,11,916,948,1864,1755
0131-002,2017,12,23,12,1017,914,1931,1864
0131-002,2017,12,23,13,938,858,1796,1931
0131-002,2017,12,23,14,1050,907,1957,1796
0131-002,2017,12,23,15,1039,955,1994,1957
0131-002,2017,12,23,16,1001,1017,2018,1994
0131-002,2017,12,23,17,920,1079,1999,2018
0131-002,2017,12,23,18,988,1349,2337,1999
0131-002,2017,12,23,19,885,843,1728,2337
0131-002,2017,12,23,20,560,587,1147,1728
0131-002,2017,12,23,21,438,430,868,1147
0131-002,2017,12,23,22,363,393,756,868
0131-002,2017,12,23,23,264,276,540,756
0131-002,2017,12,23,24,199,211,410,540
0131-002,2017,12,24,1,144,167,311,410
0131-002,2017,12,24,2,108,97,205,311
0131-002,2017,12,24,3,63,78,141,205
0131-002,2017,12,24,4,72,70,142,141
0131-002,2017,12,24,5,62,79,141,142
0131-002,2017,12,24,6,83,86,169,141
0131-002,2017,12,24,7,161,136,297,169
0131-002,2017,12,24,8,229,225,454,297
0131-002,2017,12,24,9,298,355,653,454
0131-002,2017,12,24,10,298,472,770,653
0131-002,2017,12,24,11,364,545,909,770
0131-002,2017,12,24,12,455,595,1050,909
0131-002,2017,12,24,13,457,543,1000,1050
0131-002,2017,12,24,14,561,630,1191,1000
0131-002,2017,12,24,15,562,681,1243,1191
0131-002,2017,12,24,16,580,732,1312,1243
0131-002,2017,12,24,17,555,654,1209,1312
0131-002,2017,12,24,18,488,579,1067,1209
0131-002,2017,12,24,19,540,480,1020,1067
0131-002,2017,12,24,20,400,366,766,1020
0131-002,2017,12,24,21,264,328,592,766
0131-002,2017,12,24,22,272,262,534,592
0131-002,2017,12,24,23,164,243,407,534
0131-002,2017,12,24,24,113,147,260,407
0131-002,2017,12,25,1,78,113,191,260
0131-002,2017,12,25,2,71,88,159,191
0131-002,2017,12,25,3,55,48,103,159
0131-002,2017,12,25,4,55,46,101,103
0131-002,2017,12,25,5,86,79,165,101
0131-002,2017,12,25,6,159,119,278,165
0131-002,2017,12,25,7,356,171,527,278
0131-002,2017,12,25,8,470,308,778,527
0131-002,2017,12,25,9,440,324,764,778
0131-002,2017,12,25,10,498,462,960,764
0131-002,2017,12,25,11,589,617,1206,960
0131-002,2017,12,25,12,555,637,1192,1206
0131-002,2017,12,25,13,684,729,1413,1192
0131-002,2017,12,25,14,800,809,1609,1413
0131-002,2017,12,25,15,900,858,1758,1609
0131-002,2017,12,25,16,828,775,1603,1758
0131-002,2017,12,25,17,778,809,1587,1603
0131-002,2017,12,25,18,717,937,1654,1587
0131-002,2017,12,25,19,585,590,1175,1654
0131-002,2017,12,25,20,492,450,942,1175
0131-002,2017,12,25,21,479,403,882,942
0131-002,2017,12,25,22,452,313,765,882
0131-002,2017,12,25,23,311,243,554,765
0131-002,2017,12,25,24,223,146,369,554
0131-002,2017,12,26,1,153,113,266,369
0131-002,2017,12,26,2,104,70,174,266
0131-002,2017,12,26,3,65,50,115,174
0131-002,2017,12,26,4,58,63,121,115
0131-002,2017,12,26,5,125,94,219,121
0131-002,2017,12,26,6,328,187,515,219
0131-002,2017,12,26,7,917,415,1332,515
0131-002,2017,12,26,8,1807,977,2784,1332
0131-002,2017,12,26,9,1633,1133,2766,2784
0131-002,2017,12,26,10,1063,964,2027,2766
0131-002,2017,12,26,11,1050,1061,2111,2027
0131-002,2017,12,26,12,978,994,1972,2111
0131-002,2017,12,26,13,967,972,1939,1972
0131-002,2017,12,26,14,1109,1082,2191,1939
0131-002,2017,12,26,15,1133,1141,2274,2191
0131-002,2017,12,26,16,1132,1126,2258,2274
0131-002,2017,12,26,17,1089,1150,2239,2258
0131-002,2017,12,26,18,1011,1374,2385,2239
0131-002,2017,12,26,19,1074,1239,2313,2385
0131-002,2017,12,26,20,687,838,1525,2313
0131-002,2017,12,26,21,491,709,1200,1525
0131-002,2017,12,26,22,370,482,852,1200
0131-002,2017,12,26,23,243,333,576,852
0131-002,2017,12,26,24,129,188,317,576
0131-002,2017,12,27,1,98,167,265,317
0131-002,2017,12,27,2,63,92,155,265
0131-002,2017,12,27,3,61,78,139,155
0131-002,2017,12,27,4,62,77,139,139
0131-002,2017,12,27,5,95,131,226,139
0131-002,2017,12,27,6,226,184,410,226
0131-002,2017,12,27,7,637,409,1046,410
0131-002,2017,12,27,8,1549,1035,2584,1046
0131-002,2017,12,27,9,1501,1222,2723,2584
0131-002,2017,12,27,10,1059,1005,2064,2723
0131-002,2017,12,27,11,1177,1019,2196,2064
0131-002,2017,12,27,12,1123,1046,2169,2196
0131-002,2017,12,27,13,920,926,1846,2169
0131-002,2017,12,27,14,1067,990,2057,1846
0131-002,2017,12,27,15,1145,1115,2260,2057
0131-002,2017,12,27,16,1201,1169,2370,2260
0131-002,2017,12,27,17,1057,1128,2185,2370
0131-002,2017,12,27,18,1135,1502,2637,2185
0131-002,2017,12,27,19,1078,1207,2285,2637
0131-002,2017,12,27,20,677,799,1476,2285
0131-002,2017,12,27,21,348,661,1009,1476
0131-002,2017,12,27,22,353,503,856,1009
0131-002,2017,12,27,23,231,336,567,856
0131-002,2017,12,27,24,138,179,317,567
0131-002,2017,12,28,1,97,147,244,317
0131-002,2017,12,28,2,90,96,186,244
0131-002,2017,12,28,3,77,72,149,186
0131-002,2017,12,28,4,62,91,153,149
0131-002,2017,12,28,5,96,115,211,153
0131-002,2017,12,28,6,264,205,469,211
0131-002,2017,12,28,7,740,427,1167,469
0131-002,2017,12,28,8,1644,1019,2663,1167
0131-002,2017,12,28,9,1522,1211,2733,2663
0131-002,2017,12,28,10,1216,1008,2224,2733
0131-002,2017,12,28,11,1259,1040,2299,2224
0131-002,2017,12,28,12,1057,1026,2083,2299
0131-002,2017,12,28,13,931,945,1876,2083
0131-002,2017,12,28,14,1123,1033,2156,1876
0131-002,2017,12,28,15,1120,1138,2258,2156
0131-002,2017,12,28,16,1156,1152,2308,2258
0131-002,2017,12,28,17,1097,1212,2309,2308
0131-002,2017,12,28,18,1098,1490,2588,2309
0131-002,2017,12,28,19,939,1185,2124,2588
0131-002,2017,12,28,20,677,795,1472,2124
0131-002,2017,12,28,21,533,755,1288,1472
0131-002,2017,12,28,22,408,541,949,1288
0131-002,2017,12,28,23,330,362,692,949
0131-002,2017,12,28,24,220,212,432,692
0131-002,2017,12,29,1,182,162,344,432
0131-002,2017,12,29,2,118,116,234,344
0131-002,2017,12,29,3,98,100,198,234
0131-002,2017,12,29,4,92,81,173,198
0131-002,2017,12,29,5,121,113,234,173
0131-002,2017,12,29,6,258,189,447,234
0131-002,2017,12,29,7,728,376,1104,447
0131-002,2017,12,29,8,1533,972,2505,1104
0131-002,2017,12,29,9,1410,1166,2576,2505
0131-002,2017,12,29,10,1106,1066,2172,2576
0131-002,2017,12,29,11,1139,1028,2167,2172
0131-002,2017,12,29,12,1121,1043,2164,2167
0131-002,2017,12,29,13,1013,991,2004,2164
0131-002,2017,12,29,14,1075,1064,2139,2004
0131-002,2017,12,29,15,1205,1225,2430,2139
0131-002,2017,12,29,16,1166,1268,2434,2430
0131-002,2017,12,29,17,1133,1406,2539,2434
0131-002,2017,12,29,18,1182,1668,2850,2539
0131-002,2017,12,29,19,964,1278,2242,2850
0131-002,2017,12,29,20,743,845,1588,2242
0131-002,2017,12,29,21,519,638,1157,1588
0131-002,2017,12,29,22,414,487,901,1157
0131-002,2017,12,29,23,333,381,714,901
0131-002,2017,12,29,24,208,225,433,714
0131-002,2017,12,30,1,189,176,365,433
0131-002,2017,12,30,2,151,129,280,365
0131-002,2017,12,30,3,95,116,211,280
0131-002,2017,12,30,4,80,103,183,211
0131-002,2017,12,30,5,107,129,236,183
0131-002,2017,12,30,6,193,180,373,236
0131-002,2017,12,30,7,415,307,722,373
0131-002,2017,12,30,8,667,495,1162,722
0131-002,2017,12,30,9,705,677,1382,1162
0131-002,2017,12,30,10,718,772,1490,1382
0131-002,2017,12,30,11,697,831,1528,1490
0131-002,2017,12,30,12,809,862,1671,1528
0131-002,2017,12,30,13,898,833,1731,1671
0131-002,2017,12,30,14,871,953,1824,1731
0131-002,2017,12,30,15,887,949,1836,1824
0131-002,2017,12,30,16,904,1003,1907,1836
0131-002,2017,12,30,17,927,1081,2008,1907
0131-002,2017,12,30,18,926,1014,1940,2008
0131-002,2017,12,30,19,793,763,1556,1940
0131-002,2017,12,30,20,493,466,959,1556
0131-002,2017,12,30,21,363,448,811,959
0131-002,2017,12,30,22,316,350,666,811
0131-002,2017,12,30,23,232,228,460,666
0131-002,2017,12,30,24,135,142,277,460
0131-002,2017,12,31,1,120,141,261,277
0131-002,2017,12,31,2,79,94,173,261
0131-002,2017,12,31,3,81,81,162,173
0131-002,2017,12,31,4,67,65,132,162
0131-002,2017,12,31,5,48,54,102,132
0131-002,2017,12,31,6,54,70,124,102
0131-002,2017,12,31,7,119,98,217,124
0131-002,2017,12,31,8,164,192,356,217
0131-002,2017,12,31,9,187,307,494,356
0131-002,2017,12,31,10,287,431,718,494
0131-002,2017,12,31,11,412,593,1005,718
0131-002,2017,12,31,12,525,622,1147,1005
0131-002,2017,12,31,13,623,630,1253,1147
0131-002,2017,12,31,14,682,641,1323,1253
0131-002,2017,12,31,15,764,772,1536,1323
0131-002,2017,12,31,16,748,789,1537,1536
0131-002,2017,12,31,17,685,736,1421,1537
0131-002,2017,12,31,18,619,756,1375,1421
0131-002,2017,12,31,19,601,608,1209,1375
0131-002,2017,12,31,20,408,437,845,1209
0131-002,2017,12,31,21,294,328,622,845
0131-002,2017,12,31,22,261,298,559,622
0131-002,2017,12,31,23,207,259,466,559
0131-002,2017,12,31,24,150,158,308,466
0131-002,2018,1,1,1,96,117,213,308
0131-002,2018,1,1,2,92,138,230,213
0131-002,2018,1,1,3,74,75,149,230
0131-002,2018,1,1,4,56,65,121,149
0131-002,2018,1,1,5,84,59,143,121
0131-002,2018,1,1,6,116,91,207,143
0131-002,2018,1,1,7,138,119,257,207
0131-002,2018,1,1,8,147,184,331,257
0131-002,2018,1,1,9,170,246,416,331
0131-002,2018,1,1,10,257,386,643,416
0131-002,2018,1,1,11,317,482,799,643
0131-002,2018,1,1,12,416,630,1046,799
0131-002,2018,1,1,13,542,640,1182,1046
0131-002,2018,1,1,14,609,694,1303,1182
0131-002,2018,1,1,15,657,747,1404,1303
0131-002,2018,1,1,16,617,735,1352,1404
0131-002,2018,1,1,17,622,752,1374,1352
0131-002,2018,1,1,18,549,774,1323,1374
0131-002,2018,1,1,19,477,644,1121,1323
0131-002,2018,1,1,20,409,473,882,1121
0131-002,2018,1,1,21,374,399,773,882
0131-002,2018,1,1,22,324,287,611,773
0131-002,2018,1,1,23,249,192,441,611
0131-002,2018,1,1,24,198,134,332,441
0131-002,2018,1,2,1,80,88,168,332
0131-002,2018,1,2,2,72,67,139,168
0131-002,2018,1,2,3,35,50,85,139
0131-002,2018,1,2,4,49,47,96,85
0131-002,2018,1,2,5,62,90,152,96
0131-002,2018,1,2,6,170,166,336,152
0131-002,2018,1,2,7,475,364,839,336
0131-002,2018,1,2,8,1167,822,1989,839
0131-002,2018,1,2,9,1030,924,1954,1989
0131-002,2018,1,2,10,691,768,1459,1954
0131-002,2018,1,2,11,722,792,1514,1459
0131-002,2018,1,2,12,709,778,1487,1514
0131-002,2018,1,2,13,623,704,1327,1487
0131-002,2018,1,2,14,765,789,1554,1327
0131-002,2018,1,2,15,843,848,1691,1554
0131-002,2018,1,2,16,774,870,1644,1691
0131-002,2018,1,2,17,784,805,1589,1644
0131-002,2018,1,2,18,831,1011,1842,1589
0131-002,2018,1,2,19,782,908,1690,1842
0131-002,2018,1,2,20,475,684,1159,1690
0131-002,2018,1,2,21,409,540,949,1159
0131-002,2018,1,2,22,331,329,660,949
0131-002,2018,1,2,23,213,244,457,660
0131-002,2018,1,2,24,132,161,293,457
0131-002,2018,1,3,1,109,105,214,293
0131-002,2018,1,3,2,83,91,174,214
0131-002,2018,1,3,3,44,67,111,174
0131-002,2018,1,3,4,48,65,113,111
0131-002,2018,1,3,5,89,99,188,113
0131-002,2018,1,3,6,195,172,367,188
0131-002,2018,1,3,7,579,344,923,367
0131-002,2018,1,3,8,1249,806,2055,923
0131-002,2018,1,3,9,1133,974,2107,2055
0131-002,2018,1,3,10,801,828,1629,2107
0131-002,2018,1,3,11,862,838,1700,1629
0131-002,2018,1,3,12,747,872,1619,1700
0131-002,2018,1,3,13,748,728,1476,1619
0131-002,2018,1,3,14,855,891,1746,1476
0131-002,2018,1,3,15,969,969,1938,1746
0131-002,2018,1,3,16,848,962,1810,1938
0131-002,2018,1,3,17,808,932,1740,1810
0131-002,2018,1,3,18,943,1189,2132,1740
0131-002,2018,1,3,19,821,1008,1829,2132
0131-002,2018,1,3,20,555,665,1220,1829
0131-002,2018,1,3,21,378,586,964,1220
0131-002,2018,1,3,22,263,414,677,964
0131-002,2018,1,3,23,198,316,514,677
0131-002,2018,1,3,24,109,185,294,514
0131-002,2018,1,4,1,94,110,204,294
0131-002,2018,1,4,2,48,65,113,204
0131-002,2018,1,4,3,45,69,114,113
0131-002,2018,1,4,4,54,58,112,114
0131-002,2018,1,4,5,63,108,171,112
0131-002,2018,1,4,6,214,174,388,171
0131-002,2018,1,4,7,528,363,891,388
0131-002,2018,1,4,8,1236,822,2058,891
0131-002,2018,1,4,9,1168,994,2162,2058
0131-002,2018,1,4,10,758,914,1672,2162
0131-002,2018,1,4,11,902,876,1778,1672
0131-002,2018,1,4,12,861,886,1747,1778
0131-002,2018,1,4,13,757,756,1513,1747
0131-002,2018,1,4,14,886,877,1763,1513
0131-002,2018,1,4,15,970,1004,1974,1763
0131-002,2018,1,4,16,854,983,1837,1974
0131-002,2018,1,4,17,880,943,1823,1837
0131-002,2018,1,4,18,842,1079,1921,1823
0131-002,2018,1,4,19,792,971,1763,1921
0131-002,2018,1,4,20,503,723,1226,1763
0131-002,2018,1,4,21,448,636,1084,1226
0131-002,2018,1,4,22,323,423,746,1084
0131-002,2018,1,4,23,229,261,490,746
0131-002,2018,1,4,24,162,186,348,490
0131-002,2018,1,5,1,127,129,256,348
0131-002,2018,1,5,2,73,81,154,256
0131-002,2018,1,5,3,36,67,103,154
0131-002,2018,1,5,4,39,76,115,103
0131-002,2018,1,5,5,69,92,161,115
0131-002,2018,1,5,6,232,163,395,161
0131-002,2018,1,5,7,597,396,993,395
0131-002,2018,1,5,8,1243,789,2032,993
0131-002,2018,1,5,9,1165,1009,2174,2032
0131-002,2018,1,5,10,855,918,1773,2174
0131-002,2018,1,5,11,934,921,1855,1773
0131-002,2018,1,5,12,834,912,1746,1855
0131-002,2018,1,5,13,762,763,1525,1746
0131-002,2018,1,5,14,844,853,1697,1525
0131-002,2018,1,5,15,998,968,1966,1697
0131-002,2018,1,5,16,932,961,1893,1966
0131-002,2018,1,5,17,947,948,1895,1893
0131-002,2018,1,5,18,946,1278,2224,1895
0131-002,2018,1,5,19,959,1260,2219,2224
0131-002,2018,1,5,20,622,822,1444,2219
0131-002,2018,1,5,21,431,655,1086,1444
0131-002,2018,1,5,22,392,479,871,1086
0131-002,2018,1,5,23,264,292,556,871
0131-002,2018,1,5,24,189,226,415,556
0131-002,2018,1,6,1,128,156,284,415
0131-002,2018,1,6,2,85,95,180,284
0131-002,2018,1,6,3,37,82,119,180
0131-002,2018,1,6,4,53,78,131,119
0131-002,2018,1,6,5,66,114,180,131
0131-002,2018,1,6,6,133,155,288,180
0131-002,2018,1,6,7,345,283,628,288
0131-002,2018,1,6,8,578,474,1052,628
0131-002,2018,1,6,9,595,597,1192,1052
0131-002,2018,1,6,10,651,715,1366,1192
0131-002,2018,1,6,11,671,771,1442,1366
0131-002,2018,1,6,12,666,691,1357,1442
0131-002,2018,1,6,13,656,641,1297,1357
0131-002,2018,1,6,14,658,684,1342,1297
0131-002,2018,1,6,15,726,723,1449,1342
0131-002,2018,1,6,16,727,765,1492,1449
0131-002,2018,1,6,17,669,749,1418,1492
0131-002,2018,1,6,18,715,925,1640,1418
0131-002,2018,1,6,19,617,649,1266,1640
0131-002,2018,1,6,20,425,480,905,1266
0131-002,2018,1,6,21,313,384,697,905
0131-002,2018,1,6,22,287,305,592,697
0131-002,2018,1,6,23,200,240,440,592
0131-002,2018,1,6,24,92,167,259,440
0131-002,2018,1,7,1,53,129,182,259
0131-002,2018,1,7,2,40,88,128,182
0131-002,2018,1,7,3,24,81,105,128
0131-002,2018,1,7,4,24,71,95,105
0131-002,2018,1,7,5,22,67,89,95
0131-002,2018,1,7,6,44,84,128,89
0131-002,2018,1,7,7,108,133,241,128
0131-002,2018,1,7,8,154,202,356,241
0131-002,2018,1,7,9,194,308,502,356
0131-002,2018,1,7,10,274,447,721,502
0131-002,2018,1,7,11,368,521,889,721
0131-002,2018,1,7,12,440,516,956,889
0131-002,2018,1,7,13,406,548,954,956
0131-002,2018,1,7,14,412,609,1021,954
0131-002,2018,1,7,15,541,609,1150,1021
0131-002,2018,1,7,16,487,634,1121,1150
0131-002,2018,1,7,17,582,595,1177,1121
0131-002,2018,1,7,18,522,626,1148,1177
0131-002,2018,1,7,19,583,484,1067,1148
0131-002,2018,1,7,20,441,376,817,1067
0131-002,2018,1,7,21,367,361,728,817
0131-002,2018,1,7,22,314,288,602,728
0131-002,2018,1,7,23,231,179,410,602
0131-002,2018,1,7,24,150,131,281,410
0131-002,2018,1,8,1,90,85,175,281
0131-002,2018,1,8,2,69,66,135,175
0131-002,2018,1,8,3,55,46,101,135
0131-002,2018,1,8,4,56,75,131,101
0131-002,2018,1,8,5,112,81,193,131
0131-002,2018,1,8,6,267,182,449,193
0131-002,2018,1,8,7,709,394,1103,449
0131-002,2018,1,8,8,1439,903,2342,1103
0131-002,2018,1,8,9,1200,1049,2249,2342
0131-002,2018,1,8,10,819,889,1708,2249
0131-002,2018,1,8,11,880,895,1775,1708
0131-002,2018,1,8,12,799,832,1631,1775
0131-002,2018,1,8,13,751,747,1498,1631
0131-002,2018,1,8,14,868,773,1641,1498
0131-002,2018,1,8,15,921,911,1832,1641
0131-002,2018,1,8,16,893,882,1775,1832
0131-002,2018,1,8,17,859,958,1817,1775
0131-002,2018,1,8,18,861,1087,1948,1817
0131-002,2018,1,8,19,794,1120,1914,1948
0131-002,2018,1,8,20,477,736,1213,1914
0131-002,2018,1,8,21,397,657,1054,1213
0131-002,2018,1,8,22,237,402,639,1054
0131-002,2018,1,8,23,178,248,426,639
0131-002,2018,1,8,24,116,128,244,426
0131-002,2018,1,9,1,114,109,223,244
0131-002,2018,1,9,2,77,65,142,223
0131-002,2018,1,9,3,60,58,118,142
0131-002,2018,1,9,4,62,64,126,118
0131-002,2018,1,9,5,77,81,158,126
0131-002,2018,1,9,6,179,140,319,158
0131-002,2018,1,9,7,456,311,767,319
0131-002,2018,1,9,8,1046,819,1865,767
0131-002,2018,1,9,9,1068,1055,2123,1865
0131-002,2018,1,9,10,825,792,1617,2123
0131-002,2018,1,9,11,952,837,1789,1617
0131-002,2018,1,9,12,875,834,1709,1789
0131-002,2018,1,9,13,796,670,1466,1709
0131-002,2018,1,9,14,960,823,1783,1466
0131-002,2018,1,9,15,1016,933,1949,1783
0131-002,2018,1,9,16,980,931,1911,1949
0131-002,2018,1,9,17,718,943,1661,1911
0131-002,2018,1,9,18,821,956,1777,1661
0131-002,2018,1,9,19,778,1083,1861,1777
0131-002,2018,1,9,20,571,676,1247,1861
0131-002,2018,1,9,21,340,537,877,1247
0131-002,2018,1,9,22,235,365,600,877
0131-002,2018,1,9,23,167,192,359,600
0131-002,2018,1,9,24,91,121,212,359
0131-002,2018,1,10,1,76,83,159,212
0131-002,2018,1,10,2,45,55,100,159
0131-002,2018,1,10,3,48,37,85,100
0131-002,2018,1,10,4,40,51,91,85
0131-002,2018,1,10,5,43,72,115,91
0131-002,2018,1,10,6,113,111,224,115
0131-002,2018,1,10,7,343,270,613,224
0131-002,2018,1,10,8,795,690,1485,613
0131-002,2018,1,10,9,762,864,1626,1485
0131-002,2018,1,10,10,533,813,1346,1626
0131-002,2018,1,10,11,680,771,1451,1346
0131-002,2018,1,10,12,811,829,1640,1451
0131-002,2018,1,10,13,810,715,1525,1640
0131-002,2018,1,10,14,860,884,1744,1525
0131-002,2018,1,10,15,1001,920,1921,1744
0131-002,2018,1,10,16,952,855,1807,1921
0131-002,2018,1,10,17,887,838,1725,1807
0131-002,2018,1,10,18,911,1215,2126,1725
0131-002,2018,1,10,19,772,1044,1816,2126
0131-002,2018,1,10,20,455,654,1109,1816
0131-002,2018,1,10,21,186,473,659,1109
0131-002,2018,1,10,22,147,333,480,659
0131-002,2018,1,10,23,102,253,355,480
0131-002,2018,1,10,24,68,138,206,355
0131-002,2018,1,11,1,45,116,161,206
0131-002,2018,1,11,2,23,52,75,161
0131-002,2018,1,11,3,31,58,89,75
0131-002,2018,1,11,4,29,61,90,89
0131-002,2018,1,11,5,45,96,141,90
0131-002,2018,1,11,6,126,160,286,141
0131-002,2018,1,11,7,426,309,735,286
0131-002,2018,1,11,8,1253,833,2086,735
0131-002,2018,1,11,9,1074,990,2064,2086
0131-002,2018,1,11,10,780,848,1628,2064
0131-002,2018,1,11,11,850,860,1710,1628
0131-002,2018,1,11,12,782,889,1671,1710
0131-002,2018,1,11,13,791,746,1537,1671
0131-002,2018,1,11,14,880,845,1725,1537
0131-002,2018,1,11,15,975,913,1888,1725
0131-002,2018,1,11,16,879,857,1736,1888
0131-002,2018,1,11,17,863,938,1801,1736
0131-002,2018,1,11,18,884,1154,2038,1801
0131-002,2018,1,11,19,697,1072,1769,2038
0131-002,2018,1,11,20,457,684,1141,1769
0131-002,2018,1,11,21,412,623,1035,1141
0131-002,2018,1,11,22,315,384,699,1035
0131-002,2018,1,11,23,174,226,400,699
0131-002,2018,1,11,24,113,155,268,400
0131-002,2018,1,12,1,92,113,205,268
0131-002,2018,1,12,2,55,81,136,205
0131-002,2018,1,12,3,33,68,101,136
0131-002,2018,1,12,4,45,66,111,101
0131-002,2018,1,12,5,57,90,147,111
0131-002,2018,1,12,6,155,155,310,147
0131-002,2018,1,12,7,483,344,827,310
0131-002,2018,1,12,8,1159,827,1986,827
0131-002,2018,1,12,9,1072,954,2026,1986
0131-002,2018,1,12,10,849,833,1682,2026
0131-002,2018,1,12,11,880,895,1775,1682
0131-002,2018,1,12,12,917,854,1771,1775
0131-002,2018,1,12,13,815,853,1668,1771
0131-002,2018,1,12,14,923,882,1805,1668
0131-002,2018,1,12,15,1058,902,1960,1805
0131-002,2018,1,12,16,1107,987,2094,1960
0131-002,2018,1,12,17,996,998,1994,2094
0131-002,2018,1,12,18,1166,1317,2483,1994
0131-002,2018,1,12,19,1054,1293,2347,2483
0131-002,2018,1,12,20,658,843,1501,2347
0131-002,2018,1,12,21,513,628,1141,1501
0131-002,2018,1,12,22,405,439,844,1141
0131-002,2018,1,12,23,217,291,508,844
0131-002,2018,1,12,24,179,225,404,508
0131-002,2018,1,13,1,84,135,219,404
0131-002,2018,1,13,2,73,100,173,219
0131-002,2018,1,13,3,49,80,129,173
0131-002,2018,1,13,4,60,84,144,129
0131-002,2018,1,13,5,61,97,158,144
0131-002,2018,1,13,6,123,152,275,158
0131-002,2018,1,13,7,212,246,458,275
0131-002,2018,1,13,8,413,448,861,458
0131-002,2018,1,13,9,512,591,1103,861
0131-002,2018,1,13,10,472,668,1140,1103
0131-002,2018,1,13,11,520,735,1255,1140
0131-002,2018,1,13,12,536,708,1244,1255
0131-002,2018,1,13,13,525,638,1163,1244
0131-002,2018,1,13,14,522,662,1184,1163
0131-002,2018,1,13,15,593,674,1267,1184
0131-002,2018,1,13,16,601,695,1296,1267
0131-002,2018,1,13,17,554,719,1273,1296
0131-002,2018,1,13,18,642,821,1463,1273
0131-002,2018,1,13,19,608,674,1282,1463
0131-002,2018,1,13,20,386,432,818,1282
0131-002,2018,1,13,21,313,364,677,818
0131-002,2018,1,13,22,231,285,516,677
0131-002,2018,1,13,23,196,224,420,516
0131-002,2018,1,13,24,130,145,275,420
0131-002,2018,1,14,1,101,115,216,275
0131-002,2018,1,14,2,65,99,164,216
0131-002,2018,1,14,3,52,60,112,164
0131-002,2018,1,14,4,35,67,102,112
0131-002,2018,1,14,5,31,70,101,102
0131-002,2018,1,14,6,60,87,147,101
0131-002,2018,1,14,7,117,106,223,147
0131-002,2018,1,14,8,135,215,350,223
0131-002,2018,1,14,9,179,325,504,350
0131-002,2018,1,14,10,223,399,622,504
0131-002,2018,1,14,11,273,495,768,622
0131-002,2018,1,14,12,367,499,866,768
0131-002,2018,1,14,13,430,527,957,866
0131-002,2018,1,14,14,507,490,997,957
0131-002,2018,1,14,15,582,591,1173,997
0131-002,2018,1,14,16,616,606,1222,1173
0131-002,2018,1,14,17,655,594,1249,1222
0131-002,2018,1,14,18,650,568,1218,1249
0131-002,2018,1,14,19,569,489,1058,1218
0131-002,2018,1,14,20,433,369,802,1058
0131-002,2018,1,14,21,352,337,689,802
0131-002,2018,1,14,22,296,269,565,689
0131-002,2018,1,14,23,249,206,455,565
0131-002,2018,1,14,24,145,119,264,455
0131-002,2018,1,15,1,91,84,175,264
0131-002,2018,1,15,2,59,51,110,175
0131-002,2018,1,15,3,48,59,107,110
0131-002,2018,1,15,4,46,56,102,107
0131-002,2018,1,15,5,125,106,231,102
0131-002,2018,1,15,6,290,190,480,231
0131-002,2018,1,15,7,713,404,1117,480
0131-002,2018,1,15,8,1443,938,2381,1117
0131-002,2018,1,15,9,1310,1021,2331,2381
0131-002,2018,1,15,10,877,871,1748,2331
0131-002,2018,1,15,11,972,937,1909,1748
0131-002,2018,1,15,12,929,887,1816,1909
0131-002,2018,1,15,13,855,790,1645,1816
0131-002,2018,1,15,14,980,820,1800,1645
0131-002,2018,1,15,15,1079,904,1983,1800
0131-002,2018,1,15,16,1039,1022,2061,1983
0131-002,2018,1,15,17,965,939,1904,2061
0131-002,2018,1,15,18,1033,1125,2158,1904
0131-002,2018,1,15,19,858,1071,1929,2158
0131-002,2018,1,15,20,576,764,1340,1929
0131-002,2018,1,15,21,468,629,1097,1340
0131-002,2018,1,15,22,327,416,743,1097
0131-002,2018,1,15,23,216,273,489,743
0131-002,2018,1,15,24,126,179,305,489
0131-002,2018,1,16,1,114,113,227,305
0131-002,2018,1,16,2,68,91,159,227
0131-002,2018,1,16,3,76,64,140,159
0131-002,2018,1,16,4,65,84,149,140
0131-002,2018,1,16,5,95,101,196,149
0131-002,2018,1,16,6,268,197,465,196
0131-002,2018,1,16,7,670,388,1058,465
0131-002,2018,1,16,8,1336,896,2232,1058
0131-002,2018,1,16,9,1210,951,2161,2232
0131-002,2018,1,16,10,928,919,1847,2161
0131-002,2018,1,16,11,952,900,1852,1847
0131-002,2018,1,16,12,903,838,1741,1852
0131-002,2018,1,16,13,788,749,1537,1741
0131-002,2018,1,16,14,899,887,1786,1537
0131-002,2018,1,16,15,999,895,1894,1786
0131-002,2018,1,16,16,934,944,1878,1894
0131-002,2018,1,16,17,893,1032,1925,1878
0131-002,2018,1,16,18,881,1207,2088,1925
0131-002,2018,1,16,19,819,1054,1873,2088
0131-002,2018,1,16,20,504,723,1227,1873
0131-002,2018,1,16,21,490,614,1104,1227
0131-002,2018,1,16,22,339,411,750,1104
0131-002,2018,1,16,23,214,284,498,750
0131-002,2018,1,16,24,145,184,329,498
0131-002,2018,1,17,1,125,137,262,329
0131-002,2018,1,17,2,72,88,160,262
0131-002,2018,1,17,3,69,85,154,160
0131-002,2018,1,17,4,63,79,142,154
0131-002,2018,1,17,5,112,98,210,142
0131-002,2018,1,17,6,241,187,428,210
0131-002,2018,1,17,7,616,405,1021,428
0131-002,2018,1,17,8,1273,936,2209,1021
0131-002,2018,1,17,9,1235,1080,2315,2209
0131-002,2018,1,17,10,980,904,1884,2315
0131-002,2018,1,17,11,948,933,1881,1884
0131-002,2018,1,17,12,895,853,1748,1881
0131-002,2018,1,17,13,790,801,1591,1748
0131-002,2018,1,17,14,944,853,1797,1591
0131-002,2018,1,17,15,1027,954,1981,1797
0131-002,2018,1,17,16,937,993,1930,1981
0131-002,2018,1,17,17,897,972,1869,1930
0131-002,2018,1,17,18,1004,1198,2202,1869
0131-002,2018,1,17,19,894,1060,1954,2202
0131-002,2018,1,17,20,625,699,1324,1954
0131-002,2018,1,17,21,436,564,1000,1324
0131-002,2018,1,17,22,353,389,742,1000
0131-002,2018,1,17,23,233,299,532,742
0131-002,2018,1,17,24,151,210,361,532
0131-002,2018,1,18,1,126,130,256,361
0131-002,2018,1,18,2,75,103,178,256
0131-002,2018,1,18,3,83,87,170,178
0131-002,2018,1,18,4,55,70,125,170
0131-002,2018,1,18,5,102,92,194,125
0131-002,2018,1,18,6,291,196,487,194
0131-002,2018,1,18,7,665,401,1066,487
0131-002,2018,1,18,8,1333,875,2208,1066
0131-002,2018,1,18,9,1193,973,2166,2208
0131-002,2018,1,18,10,890,874,1764,2166
0131-002,2018,1,18,11,1001,865,1866,1764
0131-002,2018,1,18,12,873,844,1717,1866
0131-002,2018,1,18,13,758,758,1516,1717
0131-002,2018,1,18,14,924,849,1773,1516
0131-002,2018,1,18,15,1058,975,2033,1773
0131-002,2018,1,18,16,989,943,1932,2033
0131-002,2018,1,18,17,923,955,1878,1932
0131-002,2018,1,18,18,942,1173,2115,1878
0131-002,2018,1,18,19,904,1020,1924,2115
0131-002,2018,1,18,20,564,720,1284,1924
0131-002,2018,1,18,21,430,613,1043,1284
0131-002,2018,1,18,22,389,402,791,1043
0131-002,2018,1,18,23,257,298,555,791
0131-002,2018,1,18,24,152,203,355,555
0131-002,2018,1,19,1,127,134,261,355
0131-002,2018,1,19,2,84,96,180,261
0131-002,2018,1,19,3,79,87,166,180
0131-002,2018,1,19,4,66,89,155,166
0131-002,2018,1,19,5,83,113,196,155
0131-002,2018,1,19,6,263,186,449,196
0131-002,2018,1,19,7,679,391,1070,449
0131-002,2018,1,19,8,1407,851,2258,1070
0131-002,2018,1,19,9,1267,1000,2267,2258
0131-002,2018,1,19,10,931,915,1846,2267
0131-002,2018,1,19,11,946,1005,1951,1846
0131-002,2018,1,19,12,903,929,1832,1951
0131-002,2018,1,19,13,846,813,1659,1832
0131-002,2018,1,19,14,969,884,1853,1659
0131-002,2018,1,19,15,1044,958,2002,1853
0131-002,2018,1,19,16,988,952,1940,2002
0131-002,2018,1,19,17,997,1005,2002,1940
0131-002,2018,1,19,18,1051,1313,2364,2002
0131-002,2018,1,19,19,1079,1374,2453,2364
0131-002,2018,1,19,20,712,836,1548,2453
0131-002,2018,1,19,21,505,628,1133,1548
0131-002,2018,1,19,22,422,445,867,1133
0131-002,2018,1,19,23,277,319,596,867
0131-002,2018,1,19,24,182,236,418,596
0131-002,2018,1,20,1,159,168,327,418
0131-002,2018,1,20,2,112,147,259,327
0131-002,2018,1,20,3,80,89,169,259
0131-002,2018,1,20,4,61,98,159,169
0131-002,2018,1,20,5,91,107,198,159
0131-002,2018,1,20,6,221,155,376,198
0131-002,2018,1,20,7,408,287,695,376
0131-002,2018,1,20,8,684,481,1165,695
0131-002,2018,1,20,9,645,652,1297,1165
0131-002,2018,1,20,10,712,735,1447,1297
0131-002,2018,1,20,11,729,729,1458,1447
0131-002,2018,1,20,12,769,786,1555,1458
0131-002,2018,1,20,13,736,714,1450,1555
0131-002,2018,1,20,14,721,714,1435,1450
0131-002,2018,1,20,15,722,736,1458,1435
0131-002,2018,1,20,16,791,759,1550,1458
0131-002,2018,1,20,17,817,783,1600,1550
0131-002,2018,1,20,18,828,906,1734,1600
0131-002,2018,1,20,19,673,719,1392,1734
0131-002,2018,1,20,20,481,458,939,1392
0131-002,2018,1,20,21,387,404,791,939
0131-002,2018,1,20,22,280,307,587,791
0131-002,2018,1,20,23,213,233,446,587
0131-002,2018,1,20,24,146,176,322,446
0131-002,2018,1,21,1,123,127,250,322
0131-002,2018,1,21,2,93,89,182,250
0131-002,2018,1,21,3,62,91,153,182
0131-002,2018,1,21,4,60,47,107,153
0131-002,2018,1,21,5,35,49,84,107
0131-002,2018,1,21,6,74,80,154,84
0131-002,2018,1,21,7,138,143,281,154
0131-002,2018,1,21,8,213,241,454,281
0131-002,2018,1,21,9,230,332,562,454
0131-002,2018,1,21,10,278,435,713,562
0131-002,2018,1,21,11,354,515,869,713
0131-002,2018,1,21,12,393,515,908,869
0131-002,2018,1,21,13,464,550,1014,908
0131-002,2018,1,21,14,570,573,1143,1014
0131-002,2018,1,21,15,595,620,1215,1143
0131-002,2018,1,21,16,644,656,1300,1215
0131-002,2018,1,21,17,694,659,1353,1300
0131-002,2018,1,21,18,672,623,1295,1353
0131-002,2018,1,21,19,606,470,1076,1295
0131-002,2018,1,21,20,487,375,862,1076
0131-002,2018,1,21,21,422,326,748,862
0131-002,2018,1,21,22,357,285,642,748
0131-002,2018,1,21,23,266,206,472,642
0131-002,2018,1,21,24,160,137,297,472
0131-002,2018,1,22,1,113,94,207,297
0131-002,2018,1,22,2,63,62,125,207
0131-002,2018,1,22,3,65,40,105,125
0131-002,2018,1,22,4,55,56,111,105
0131-002,2018,1,22,5,102,90,192,111
0131-002,2018,1,22,6,300,209,509,192
0131-002,2018,1,22,7,790,409,1199,509
0131-002,2018,1,22,8,1523,920,2443,1199
0131-002,2018,1,22,9,1292,937,2229,2443
0131-002,2018,1,22,10,918,904,1822,2229
0131-002,2018,1,22,11,928,890,1818,1822
0131-002,2018,1,22,12,844,853,1697,1818
0131-002,2018,1,22,13,801,755,1556,1697
0131-002,2018,1,22,14,928,886,1814,1556
0131-002,2018,1,22,15,1015,989,2004,1814
0131-002,2018,1,22,16,919,1016,1935,2004
0131-002,2018,1,22,17,851,1069,1920,1935
0131-002,2018,1,22,18,837,1205,2042,1920
0131-002,2018,1,22,19,813,1118,1931,2042
0131-002,2018,1,22,20,575,724,1299,1931
0131-002,2018,1,22,21,434,624,1058,1299
0131-002,2018,1,22,22,341,400,741,1058
0131-002,2018,1,22,23,204,255,459,741
0131-002,2018,1,22,24,150,164,314,459
0131-002,2018,1,23,1,103,110,213,314
0131-002,2018,1,23,2,64,86,150,213
0131-002,2018,1,23,3,62,56,118,150
0131-002,2018,1,23,4,51,69,120,118
0131-002,2018,1,23,5,101,90,191,120
0131-002,2018,1,23,6,236,161,397,191
0131-002,2018,1,23,7,653,325,978,397
0131-002,2018,1,23,8,1448,810,2258,978
0131-002,2018,1,23,9,1304,949,2253,2258
0131-002,2018,1,23,10,922,904,1826,2253
0131-002,2018,1,23,11,989,894,1883,1826
0131-002,2018,1,23,12,910,830,1740,1883
0131-002,2018,1,23,13,672,743,1415,1740
0131-002,2018,1,23,14,846,842,1688,1415
0131-002,2018,1,23,15,941,907,1848,1688
0131-002,2018,1,23,16,928,932,1860,1848
0131-002,2018,1,23,17,854,862,1716,1860
0131-002,2018,1,23,18,962,1061,2023,1716
0131-002,2018,1,23,19,928,1005,1933,2023
0131-002,2018,1,23,20,662,624,1286,1933
0131-002,2018,1,23,21,479,558,1037,1286
0131-002,2018,1,23,22,335,381,716,1037
0131-002,2018,1,23,23,240,293,533,716
0131-002,2018,1,23,24,126,150,276,533
0131-002,2018,1,24,1,79,121,200,276
0131-002,2018,1,24,2,65,78,143,200
0131-002,2018,1,24,3,63,82,145,143
0131-002,2018,1,24,4,40,78,118,145
0131-002,2018,1,24,5,61,79,140,118
0131-002,2018,1,24,6,187,171,358,140
0131-002,2018,1,24,7,514,321,835,358
0131-002,2018,1,24,8,1311,810,2121,835
0131-002,2018,1,24,9,1175,970,2145,2121
0131-002,2018,1,24,10,867,881,1748,2145
0131-002,2018,1,24,11,947,915,1862,1748
0131-002,2018,1,24,12,949,834,1783,1862
0131-002,2018,1,24,13,849,747,1596,1783
0131-002,2018,1,24,14,951,789,1740,1596
0131-002,2018,1,24,15,880,929,1809,1740
0131-002,2018,1,24,16,823,873,1696,1809
0131-002,2018,1,24,17,827,887,1714,1696
0131-002,2018,1,24,18,1057,1073,2130,1714
0131-002,2018,1,24,19,1025,1002,2027,2130
0131-002,2018,1,24,20,658,674,1332,2027
0131-002,2018,1,24,21,455,548,1003,1332
0131-002,2018,1,24,22,339,428,767,1003
0131-002,2018,1,24,23,244,272,516,767
0131-002,2018,1,24,24,159,179,338,516
0131-002,2018,1,25,1,105,96,201,338
0131-002,2018,1,25,2,71,81,152,201
0131-002,2018,1,25,3,49,66,115,152
0131-002,2018,1,25,4,59,74,133,115
0131-002,2018,1,25,5,91,107,198,133
0131-002,2018,1,25,6,225,163,388,198
0131-002,2018,1,25,7,577,348,925,388
0131-002,2018,1,25,8,1389,767,2156,925
0131-002,2018,1,25,9,1223,987,2210,2156
0131-002,2018,1,25,10,953,854,1807,2210
0131-002,2018,1,25,11,987,923,1910,1807
0131-002,2018,1,25,12,918,787,1705,1910
0131-002,2018,1,25,13,785,785,1570,1705
0131-002,2018,1,25,14,965,861,1826,1570
0131-002,2018,1,25,15,938,986,1924,1826
0131-002,2018,1,25,16,909,900,1809,1924
0131-002,2018,1,25,17,926,919,1845,1809
0131-002,2018,1,25,18,1036,1112,2148,1845
0131-002,2018,1,25,19,891,931,1822,2148
0131-002,2018,1,25,20,596,699,1295,1822
0131-002,2018,1,25,21,491,593,1084,1295
0131-002,2018,1,25,22,435,445,880,1084
0131-002,2018,1,25,23,251,277,528,880
0131-002,2018,1,25,24,168,173,341,528
0131-002,2018,1,26,1,127,133,260,341
0131-002,2018,1,26,2,93,86,179,260
0131-002,2018,1,26,3,51,65,116,179
0131-002,2018,1,26,4,56,73,129,116
0131-002,2018,1,26,5,93,96,189,129
0131-002,2018,1,26,6,230,170,400,189
0131-002,2018,1,26,7,569,318,887,400
0131-002,2018,1,26,8,1369,793,2162,887
0131-002,2018,1,26,9,1219,970,2189,2162
0131-002,2018,1,26,10,912,854,1766,2189
0131-002,2018,1,26,11,960,914,1874,1766
0131-002,2018,1,26,12,948,891,1839,1874
0131-002,2018,1,26,13,813,771,1584,1839
0131-002,2018,1,26,14,922,888,1810,1584
0131-002,2018,1,26,15,959,931,1890,1810
0131-002,2018,1,26,16,988,924,1912,1890
0131-002,2018,1,26,17,991,986,1977,1912
0131-002,2018,1,26,18,1149,1277,2426,1977
0131-002,2018,1,26,19,1104,1313,2417,2426
0131-002,2018,1,26,20,731,824,1555,2417
0131-002,2018,1,26,21,518,634,1152,1555
0131-002,2018,1,26,22,372,439,811,1152
0131-002,2018,1,26,23,251,334,585,811
0131-002,2018,1,26,24,162,207,369,585
0131-002,2018,1,27,1,148,133,281,369
0131-002,2018,1,27,2,98,130,228,281
0131-002,2018,1,27,3,71,79,150,228
0131-002,2018,1,27,4,61,65,126,150
0131-002,2018,1,27,5,66,104,170,126
0131-002,2018,1,27,6,168,158,326,170
0131-002,2018,1,27,7,242,255,497,326
0131-002,2018,1,27,8,566,472,1038,497
0131-002,2018,1,27,9,652,639,1291,1038
0131-002,2018,1,27,10,660,682,1342,1291
0131-002,2018,1,27,11,741,746,1487,1342
0131-002,2018,1,27,12,771,844,1615,1487
0131-002,2018,1,27,13,812,778,1590,1615
0131-002,2018,1,27,14,687,697,1384,1590
0131-002,2018,1,27,15,700,738,1438,1384
0131-002,2018,1,27,16,704,710,1414,1438
0131-002,2018,1,27,17,736,693,1429,1414
0131-002,2018,1,27,18,777,796,1573,1429
0131-002,2018,1,27,19,776,675,1451,1573
0131-002,2018,1,27,20,522,462,984,1451
0131-002,2018,1,27,21,394,377,771,984
0131-002,2018,1,27,22,301,313,614,771
0131-002,2018,1,27,23,275,224,499,614
0131-002,2018,1,27,24,133,160,293,499
0131-002,2018,1,28,1,120,144,264,293
0131-002,2018,1,28,2,75,97,172,264
0131-002,2018,1,28,3,73,78,151,172
0131-002,2018,1,28,4,51,65,116,151
0131-002,2018,1,28,5,56,70,126,116
0131-002,2018,1,28,6,78,79,157,126
0131-002,2018,1,28,7,146,133,279,157
0131-002,2018,1,28,8,251,220,471,279
0131-002,2018,1,28,9,293,311,604,471
0131-002,2018,1,28,10,377,398,775,604
0131-002,2018,1,28,11,422,506,928,775
0131-002,2018,1,28,12,438,521,959,928
0131-002,2018,1,28,13,488,492,980,959
0131-002,2018,1,28,14,547,525,1072,980
0131-002,2018,1,28,15,660,595,1255,1072
0131-002,2018,1,28,16,681,613,1294,1255
0131-002,2018,1,28,17,651,612,1263,1294
0131-002,2018,1,28,18,586,593,1179,1263
0131-002,2018,1,28,19,535,467,1002,1179
0131-002,2018,1,28,20,430,376,806,1002
0131-002,2018,1,28,21,372,344,716,806
0131-002,2018,1,28,22,385,300,685,716
0131-002,2018,1,28,23,262,192,454,685
0131-002,2018,1,28,24,142,131,273,454
0131-002,2018,1,29,1,99,82,181,273
0131-002,2018,1,29,2,63,63,126,181
0131-002,2018,1,29,3,49,48,97,126
0131-002,2018,1,29,4,31,52,83,97
0131-002,2018,1,29,5,81,94,175,83
0131-002,2018,1,29,6,268,181,449,175
0131-002,2018,1,29,7,679,417,1096,449
0131-002,2018,1,29,8,1497,905,2402,1096
0131-002,2018,1,29,9,1282,991,2273,2402
0131-002,2018,1,29,10,964,850,1814,2273
0131-002,2018,1,29,11,993,856,1849,1814
0131-002,2018,1,29,12,939,874,1813,1849
0131-002,2018,1,29,13,783,724,1507,1813
0131-002,2018,1,29,14,867,849,1716,1507
0131-002,2018,1,29,15,959,957,1916,1716
0131-002,2018,1,29,16,925,974,1899,1916
0131-002,2018,1,29,17,898,917,1815,1899
0131-002,2018,1,29,18,935,1077,2012,1815
0131-002,2018,1,29,19,888,1028,1916,2012
0131-002,2018,1,29,20,609,742,1351,1916
0131-002,2018,1,29,21,523,637,1160,1351
0131-002,2018,1,29,22,373,415,788,1160
0131-002,2018,1,29,23,273,292,565,788
0131-002,2018,1,29,24,152,192,344,565
0131-002,2018,1,30,1,124,131,255,344
0131-002,2018,1,30,2,62,81,143,255
0131-002,2018,1,30,3,61,80,141,143
0131-002,2018,1,30,4,36,76,112,141
0131-002,2018,1,30,5,86,103,189,112
0131-002,2018,1,30,6,215,186,401,189
0131-002,2018,1,30,7,606,394,1000,401
0131-002,2018,1,30,8,1326,871,2197,1000
0131-002,2018,1,30,9,1197,950,2147,2197
0131-002,2018,1,30,10,981,863,1844,2147
0131-002,2018,1,30,11,1051,893,1944,1844
0131-002,2018,1,30,12,916,849,1765,1944
0131-002,2018,1,30,13,786,750,1536,1765
0131-002,2018,1,30,14,958,863,1821,1536
0131-002,2018,1,30,15,1033,988,2021,1821
0131-002,2018,1,30,16,944,976,1920,2021
0131-002,2018,1,30,17,914,924,1838,1920
0131-002,2018,1,30,18,902,1126,2028,1838
0131-002,2018,1,30,19,846,1020,1866,2028
0131-002,2018,1,30,20,551,722,1273,1866
0131-002,2018,1,30,21,407,585,992,1273
0131-002,2018,1,30,22,332,444,776,992
0131-002,2018,1,30,23,250,283,533,776
0131-002,2018,1,30,24,138,176,314,533
0131-002,2018,1,31,1,160,116,276,314
0131-002,2018,1,31,2,86,122,208,276
0131-002,2018,1,31,3,59,77,136,208
0131-002,2018,1,31,4,71,85,156,136
0131-002,2018,1,31,5,93,98,191,156
0131-002,2018,1,31,6,230,204,434,191
0131-002,2018,1,31,7,643,384,1027,434
0131-002,2018,1,31,8,1405,838,2243,1027
0131-002,2018,1,31,9,1227,984,2211,2243
0131-002,2018,1,31,10,945,901,1846,2211
0131-002,2018,1,31,11,954,947,1901,1846
0131-002,2018,1,31,12,930,863,1793,1901
0131-002,2018,1,31,13,774,790,1564,1793
0131-002,2018,1,31,14,891,880,1771,1564
0131-002,2018,1,31,15,979,978,1957,1771
0131-002,2018,1,31,16,979,940,1919,1957
0131-002,2018,1,31,17,850,933,1783,1919
0131-002,2018,1,31,18,981,1204,2185,1783
0131-002,2018,1,31,19,872,1091,1963,2185
0131-002,2018,1,31,20,584,733,1317,1963
0131-002,2018,1,31,21,482,586,1068,1317
0131-002,2018,1,31,22,368,425,793,1068
0131-002,2018,1,31,23,276,277,553,793
0131-002,2018,1,31,24,181,209,390,553
0131-002,2018,2,1,1,143,144,287,390
0131-002,2018,2,1,2,84,87,171,287
0131-002,2018,2,1,3,68,77,145,171
0131-002,2018,2,1,4,53,90,143,145
0131-002,2018,2,1,5,85,116,201,143
0131-002,2018,2,1,6,232,194,426,201
0131-002,2018,2,1,7,633,407,1040,426
0131-002,2018,2,1,8,1336,826,2162,1040
0131-002,2018,2,1,9,1195,1030,2225,2162
0131-002,2018,2,1,10,921,866,1787,2225
0131-002,2018,2,1,11,902,922,1824,1787
0131-002,2018,2,1,12,874,859,1733,1824
0131-002,2018,2,1,13,785,808,1593,1733
0131-002,2018,2,1,14,1010,841,1851,1593
0131-002,2018,2,1,15,1026,996,2022,1851
0131-002,2018,2,1,16,1005,1014,2019,2022
0131-002,2018,2,1,17,931,930,1861,2019
0131-002,2018,2,1,18,967,1173,2140,1861
0131-002,2018,2,1,19,905,994,1899,2140
0131-002,2018,2,1,20,612,746,1358,1899
0131-002,2018,2,1,21,489,634,1123,1358
0131-002,2018,2,1,22,377,426,803,1123
0131-002,2018,2,1,23,269,319,588,803
0131-002,2018,2,1,24,159,202,361,588
0131-002,2018,2,2,1,126,151,277,361
0131-002,2018,2,2,2,59,94,153,277
0131-002,2018,2,2,3,48,83,131,153
0131-002,2018,2,2,4,60,66,126,131
0131-002,2018,2,2,5,89,107,196,126
0131-002,2018,2,2,6,259,174,433,196
0131-002,2018,2,2,7,614,377,991,433
0131-002,2018,2,2,8,1302,844,2146,991
0131-002,2018,2,2,9,1152,984,2136,2146
0131-002,2018,2,2,10,913,889,1802,2136
0131-002,2018,2,2,11,984,968,1952,1802
0131-002,2018,2,2,12,928,982,1910,1952
0131-002,2018,2,2,13,863,841,1704,1910
0131-002,2018,2,2,14,954,893,1847,1704
0131-002,2018,2,2,15,1054,1009,2063,1847
0131-002,2018,2,2,16,952,1034,1986,2063
0131-002,2018,2,2,17,1007,1028,2035,1986
0131-002,2018,2,2,18,1145,1352,2497,2035
0131-002,2018,2,2,19,1016,1282,2298,2497
0131-002,2018,2,2,20,716,895,1611,2298
0131-002,2018,2,2,21,561,612,1173,1611
0131-002,2018,2,2,22,392,480,872,1173
0131-002,2018,2,2,23,261,323,584,872
0131-002,2018,2,2,24,135,234,369,584
0131-002,2018,2,3,1,137,144,281,369
0131-002,2018,2,3,2,81,120,201,281
0131-002,2018,2,3,3,81,104,185,201
0131-002,2018,2,3,4,59,107,166,185
0131-002,2018,2,3,5,76,120,196,166
0131-002,2018,2,3,6,169,147,316,196
0131-002,2018,2,3,7,346,282,628,316
0131-002,2018,2,3,8,582,478,1060,628
0131-002,2018,2,3,9,615,635,1250,1060
0131-002,2018,2,3,10,686,762,1448,1250
0131-002,2018,2,3,11,694,767,1461,1448
0131-002,2018,2,3,12,702,815,1517,1461
0131-002,2018,2,3,13,655,707,1362,1517
0131-002,2018,2,3,14,692,699,1391,1362
0131-002,2018,2,3,15,764,744,1508,1391
0131-002,2018,2,3,16,747,773,1520,1508
0131-002,2018,2,3,17,721,781,1502,1520
0131-002,2018,2,3,18,785,891,1676,1502
0131-002,2018,2,3,19,701,745,1446,1676
0131-002,2018,2,3,20,529,477,1006,1446
0131-002,2018,2,3,21,351,394,745,1006
0131-002,2018,2,3,22,279,311,590,745
0131-002,2018,2,3,23,179,204,383,590
0131-002,2018,2,3,24,96,178,274,383
0131-002,2018,2,4,1,97,137,234,274
0131-002,2018,2,4,2,46,87,133,234
0131-002,2018,2,4,3,25,70,95,133
0131-002,2018,2,4,4,30,46,76,95
0131-002,2018,2,4,5,28,87,115,76
0131-002,2018,2,4,6,47,91,138,115
0131-002,2018,2,4,7,128,122,250,138
0131-002,2018,2,4,8,182,245,427,250
0131-002,2018,2,4,9,217,366,583,427
0131-002,2018,2,4,10,268,434,702,583
0131-002,2018,2,4,11,444,527,971,702
0131-002,2018,2,4,12,449,517,966,971
0131-002,2018,2,4,13,397,595,992,966
0131-002,2018,2,4,14,529,599,1128,992
0131-002,2018,2,4,15,608,644,1252,1128
0131-002,2018,2,4,16,662,634,1296,1252
0131-002,2018,2,4,17,675,592,1267,1296
0131-002,2018,2,4,18,616,571,1187,1267
0131-002,2018,2,4,19,620,548,1168,1187
0131-002,2018,2,4,20,456,398,854,1168
0131-002,2018,2,4,21,342,359,701,854
0131-002,2018,2,4,22,310,279,589,701
0131-002,2018,2,4,23,199,206,405,589
0131-002,2018,2,4,24,123,123,246,405
0131-002,2018,2,5,1,82,89,171,246
0131-002,2018,2,5,2,35,60,95,171
0131-002,2018,2,5,3,26,41,67,95
0131-002,2018,2,5,4,33,53,86,67
0131-002,2018,2,5,5,91,88,179,86
0131-002,2018,2,5,6,204,181,385,179
0131-002,2018,2,5,7,615,431,1046,385
0131-002,2018,2,5,8,1314,872,2186,1046
0131-002,2018,2,5,9,1185,986,2171,2186
0131-002,2018,2,5,10,854,871,1725,2171
0131-002,2018,2,5,11,908,937,1845,1725
0131-002,2018,2,5,12,930,904,1834,1845
0131-002,2018,2,5,13,800,745,1545,1834
0131-002,2018,2,5,14,942,812,1754,1545
0131-002,2018,2,5,15,969,979,1948,1754
0131-002,2018,2,5,16,942,999,1941,1948
0131-002,2018,2,5,17,841,1036,1877,1941
0131-002,2018,2,5,18,965,1129,2094,1877
0131-002,2018,2,5,19,890,960,1850,2094
0131-002,2018,2,5,20,574,759,1333,1850
0131-002,2018,2,5,21,472,634,1106,1333
0131-002,2018,2,5,22,343,427,770,1106
0131-002,2018,2,5,23,226,286,512,770
0131-002,2018,2,5,24,121,160,281,512
0131-002,2018,2,6,1,78,135,213,281
0131-002,2018,2,6,2,49,95,144,213
0131-002,2018,2,6,3,53,70,123,144
0131-002,2018,2,6,4,56,86,142,123
0131-002,2018,2,6,5,79,112,191,142
0131-002,2018,2,6,6,225,183,408,191
0131-002,2018,2,6,7,596,407,1003,408
0131-002,2018,2,6,8,1221,848,2069,1003
0131-002,2018,2,6,9,1184,983,2167,2069
0131-002,2018,2,6,10,813,906,1719,2167
0131-002,2018,2,6,11,958,952,1910,1719
0131-002,2018,2,6,12,982,833,1815,1910
0131-002,2018,2,6,13,797,790,1587,1815
0131-002,2018,2,6,14,920,900,1820,1587
0131-002,2018,2,6,15,1046,1008,2054,1820
0131-002,2018,2,6,16,992,968,1960,2054
0131-002,2018,2,6,17,906,1048,1954,1960
0131-002,2018,2,6,18,966,1116,2082,1954
0131-002,2018,2,6,19,927,1014,1941,2082
0131-002,2018,2,6,20,611,750,1361,1941
0131-002,2018,2,6,21,468,623,1091,1361
0131-002,2018,2,6,22,359,470,829,1091
0131-002,2018,2,6,23,251,323,574,829
0131-002,2018,2,6,24,128,159,287,574
0131-002,2018,2,7,1,112,120,232,287
0131-002,2018,2,7,2,50,92,142,232
0131-002,2018,2,7,3,51,81,132,142
0131-002,2018,2,7,4,55,74,129,132
0131-002,2018,2,7,5,87,117,204,129
0131-002,2018,2,7,6,200,191,391,204
0131-002,2018,2,7,7,535,392,927,391
0131-002,2018,2,7,8,1175,843,2018,927
0131-002,2018,2,7,9,1118,1015,2133,2018
0131-002,2018,2,7,10,904,905,1809,2133
0131-002,2018,2,7,11,999,928,1927,1809
0131-002,2018,2,7,12,1015,873,1888,1927
0131-002,2018,2,7,13,857,820,1677,1888
0131-002,2018,2,7,14,955,959,1914,1677
0131-002,2018,2,7,15,1043,965,2008,1914
0131-002,2018,2,7,16,999,1048,2047,2008
0131-002,2018,2,7,17,967,980,1947,2047
0131-002,2018,2,7,18,1021,1270,2291,1947
0131-002,2018,2,7,19,972,1091,2063,2291
0131-002,2018,2,7,20,665,776,1441,2063
0131-002,2018,2,7,21,497,579,1076,1441
0131-002,2018,2,7,22,387,451,838,1076
0131-002,2018,2,7,23,278,307,585,838
0131-002,2018,2,7,24,169,202,371,585
0131-002,2018,2,8,1,112,148,260,371
0131-002,2018,2,8,2,100,102,202,260
0131-002,2018,2,8,3,62,91,153,202
0131-002,2018,2,8,4,62,82,144,153
0131-002,2018,2,8,5,87,125,212,144
0131-002,2018,2,8,6,202,202,404,212
0131-002,2018,2,8,7,616,386,1002,404
0131-002,2018,2,8,8,1232,868,2100,1002
0131-002,2018,2,8,9,1178,968,2146,2100
0131-002,2018,2,8,10,936,916,1852,2146
0131-002,2018,2,8,11,1055,979,2034,1852
0131-002,2018,2,8,12,1002,887,1889,2034
0131-002,2018,2,8,13,814,837,1651,1889
0131-002,2018,2,8,14,980,932,1912,1651
0131-002,2018,2,8,15,1108,1018,2126,1912
0131-002,2018,2,8,16,1041,1012,2053,2126
0131-002,2018,2,8,17,1004,982,1986,2053
0131-002,2018,2,8,18,985,1140,2125,1986
0131-002,2018,2,8,19,905,1066,1971,2125
0131-002,2018,2,8,20,646,789,1435,1971
0131-002,2018,2,8,21,525,668,1193,1435
0131-002,2018,2,8,22,422,442,864,1193
0131-002,2018,2,8,23,312,318,630,864
0131-002,2018,2,8,24,176,191,367,630
0131-002,2018,2,9,1,121,153,274,367
0131-002,2018,2,9,2,79,82,161,274
0131-002,2018,2,9,3,59,67,126,161
0131-002,2018,2,9,4,64,75,139,126
0131-002,2018,2,9,5,98,112,210,139
0131-002,2018,2,9,6,262,190,452,210
0131-002,2018,2,9,7,638,387,1025,452
0131-002,2018,2,9,8,1363,848,2211,1025
0131-002,2018,2,9,9,1316,1014,2330,2211
0131-002,2018,2,9,10,930,949,1879,2330
0131-002,2018,2,9,11,963,942,1905,1879
0131-002,2018,2,9,12,965,980,1945,1905
0131-002,2018,2,9,13,850,876,1726,1945
0131-002,2018,2,9,14,1024,915,1939,1726
0131-002,2018,2,9,15,1148,989,2137,1939
0131-002,2018,2,9,16,1013,1030,2043,2137
0131-002,2018,2,9,17,1101,1022,2123,2043
0131-002,2018,2,9,18,1116,1262,2378,2123
0131-002,2018,2,9,19,1112,1266,2378,2378
0131-002,2018,2,9,20,755,1061,1816,2378
0131-002,2018,2,9,21,555,730,1285,1816
0131-002,2018,2,9,22,443,455,898,1285
0131-002,2018,2,9,23,319,348,667,898
0131-002,2018,2,9,24,201,238,439,667
0131-002,2018,2,10,1,163,174,337,439
0131-002,2018,2,10,2,117,134,251,337
0131-002,2018,2,10,3,81,97,178,251
0131-002,2018,2,10,4,99,119,218,178
0131-002,2018,2,10,5,113,131,244,218
0131-002,2018,2,10,6,219,179,398,244
0131-002,2018,2,10,7,390,305,695,398
0131-002,2018,2,10,8,671,560,1231,695
0131-002,2018,2,10,9,789,678,1467,1231
0131-002,2018,2,10,10,719,805,1524,1467
0131-002,2018,2,10,11,819,787,1606,1524
0131-002,2018,2,10,12,768,771,1539,1606
0131-002,2018,2,10,13,733,742,1475,1539
0131-002,2018,2,10,14,819,760,1579,1475
0131-002,2018,2,10,15,823,777,1600,1579
0131-002,2018,2,10,16,859,780,1639,1600
0131-002,2018,2,10,17,795,820,1615,1639
0131-002,2018,2,10,18,886,910,1796,1615
0131-002,2018,2,10,19,764,724,1488,1796
0131-002,2018,2,10,20,503,522,1025,1488
0131-002,2018,2,10,21,367,381,748,1025
0131-002,2018,2,10,22,313,322,635,748
0131-002,2018,2,10,23,254,239,493,635
0131-002,2018,2,10,24,172,180,352,493
0131-002,2018,2,11,1,124,123,247,352
0131-002,2018,2,11,2,64,93,157,247
0131-002,2018,2,11,3,57,67,124,157
0131-002,2018,2,11,4,44,62,106,124
0131-002,2018,2,11,5,53,66,119,106
0131-002,2018,2,11,6,64,85,149,119
0131-002,2018,2,11,7,140,159,299,149
0131-002,2018,2,11,8,235,280,515,299
0131-002,2018,2,11,9,289,423,712,515
0131-002,2018,2,11,10,371,494,865,712
0131-002,2018,2,11,11,460,587,1047,865
0131-002,2018,2,11,12,521,538,1059,1047
0131-002,2018,2,11,13,597,531,1128,1059
0131-002,2018,2,11,14,614,569,1183,1128
0131-002,2018,2,11,15,681,579,1260,1183
0131-002,2018,2,11,16,645,650,1295,1260
0131-002,2018,2,11,17,616,643,1259,1295
0131-002,2018,2,11,18,624,612,1236,1259
0131-002,2018,2,11,19,517,540,1057,1236
0131-002,2018,2,11,20,341,380,721,1057
0131-002,2018,2,11,21,296,283,579,721
0131-002,2018,2,11,22,245,242,487,579
0131-002,2018,2,11,23,140,141,281,487
0131-002,2018,2,11,24,91,100,191,281
0131-002,2018,2,12,1,71,68,139,191
0131-002,2018,2,12,2,55,43,98,139
0131-002,2018,2,12,3,30,34,64,98
0131-002,2018,2,12,4,27,40,67,64
0131-002,2018,2,12,5,49,72,121,67
0131-002,2018,2,12,6,157,183,340,121
0131-002,2018,2,12,7,477,360,837,340
0131-002,2018,2,12,8,1070,792,1862,837
0131-002,2018,2,12,9,1000,1062,2062,1862
0131-002,2018,2,12,10,929,928,1857,2062
0131-002,2018,2,12,11,866,979,1845,1857
0131-002,2018,2,12,12,997,958,1955,1845
0131-002,2018,2,12,13,844,896,1740,1955
0131-002,2018,2,12,14,977,927,1904,1740
0131-002,2018,2,12,15,1042,1012,2054,1904
0131-002,2018,2,12,16,1045,996,2041,2054
0131-002,2018,2,12,17,979,966,1945,2041
0131-002,2018,2,12,18,927,1119,2046,1945
0131-002,2018,2,12,19,899,1052,1951,2046
0131-002,2018,2,12,20,700,764,1464,1951
0131-002,2018,2,12,21,491,673,1164,1464
0131-002,2018,2,12,22,396,459,855,1164
0131-002,2018,2,12,23,248,306,554,855
0131-002,2018,2,12,24,137,180,317,554
0131-002,2018,2,13,1,63,120,183,317
0131-002,2018,2,13,2,63,69,132,183
0131-002,2018,2,13,3,59,79,138,132
0131-002,2018,2,13,4,56,82,138,138
0131-002,2018,2,13,5,84,93,177,138
0131-002,2018,2,13,6,190,160,350,177
0131-002,2018,2,13,7,518,368,886,350
0131-002,2018,2,13,8,1132,925,2057,886
0131-002,2018,2,13,9,996,1178,2174,2057
0131-002,2018,2,13,10,932,931,1863,2174
0131-002,2018,2,13,11,1049,1044,2093,1863
0131-002,2018,2,13,12,969,1022,1991,2093
0131-002,2018,2,13,13,839,913,1752,1991
0131-002,2018,2,13,14,1043,956,1999,1752
0131-002,2018,2,13,15,1139,1117,2256,1999
0131-002,2018,2,13,16,1136,1111,2247,2256
0131-002,2018,2,13,17,1058,1079,2137,2247
0131-002,2018,2,13,18,1084,1212,2296,2137
0131-002,2018,2,13,19,1032,1214,2246,2296
0131-002,2018,2,13,20,678,858,1536,2246
0131-002,2018,2,13,21,556,669,1225,1536
0131-002,2018,2,13,22,474,455,929,1225
0131-002,2018,2,13,23,319,351,670,929
0131-002,2018,2,13,24,213,210,423,670
0131-002,2018,2,14,1,161,186,347,423
0131-002,2018,2,14,2,122,120,242,347
0131-002,2018,2,14,3,82,80,162,242
0131-002,2018,2,14,4,71,88,159,162
0131-002,2018,2,14,5,84,114,198,159
0131-002,2018,2,14,6,214,167,381,198
0131-002,2018,2,14,7,524,343,867,381
0131-002,2018,2,14,8,1242,785,2027,867
0131-002,2018,2,14,9,1125,995,2120,2027
0131-002,2018,2,14,10,847,1000,1847,2120
0131-002,2018,2,14,11,957,969,1926,1847
0131-002,2018,2,14,12,896,931,1827,1926
0131-002,2018,2,14,13,907,971,1878,1827
0131-002,2018,2,14,14,1002,984,1986,1878
0131-002,2018,2,14,15,987,1014,2001,1986
0131-002,2018,2,14,16,1099,967,2066,2001
0131-002,2018,2,14,17,1148,967,2115,2066
0131-002,2018,2,14,18,1159,1033,2192,2115
0131-002,2018,2,14,19,1012,1008,2020,2192
0131-002,2018,2,14,20,673,683,1356,2020
0131-002,2018,2,14,21,458,571,1029,1356
0131-002,2018,2,14,22,390,381,771,1029
0131-002,2018,2,14,23,291,317,608,771
0131-002,2018,2,14,24,149,260,409,608
0131-002,2018,2,15,1,139,196,335,409
0131-002,2018,2,15,2,105,176,281,335
0131-002,2018,2,15,3,92,148,240,281
0131-002,2018,2,15,4,72,129,201,240
0131-002,2018,2,15,5,71,211,282,201
0131-002,2018,2,15,6,103,384,487,282
0131-002,2018,2,15,7,220,707,927,487
0131-002,2018,2,15,8,265,421,686,927
0131-002,2018,2,15,9,359,644,1003,686
0131-002,2018,2,15,10,449,839,1288,1003
0131-002,2018,2,15,11,605,725,1330,1288
0131-002,2018,2,15,12,674,705,1379,1330
0131-002,2018,2,15,13,616,633,1249,1379
0131-002,2018,2,15,14,577,606,1183,1249
0131-002,2018,2,15,15,609,575,1184,1183
0131-002,2018,2,15,16,523,560,1083,1184
0131-002,2018,2,15,17,472,477,949,1083
0131-002,2018,2,15,18,410,430,840,949
0131-002,2018,2,15,19,327,356,683,840
0131-002,2018,2,15,20,283,301,584,683
0131-002,2018,2,15,21,235,234,469,584
0131-002,2018,2,15,22,182,202,384,469
0131-002,2018,2,15,23,139,151,290,384
0131-002,2018,2,15,24,91,109,200,290
0131-002,2018,2,16,1,58,81,139,200
0131-002,2018,2,16,2,57,39,96,139
0131-002,2018,2,16,3,31,57,88,96
0131-002,2018,2,16,4,28,41,69,88
0131-002,2018,2,16,5,25,44,69,69
0131-002,2018,2,16,6,50,77,127,69
0131-002,2018,2,16,7,158,177,335,127
0131-002,2018,2,16,8,320,347,667,335
0131-002,2018,2,16,9,293,354,647,667
0131-002,2018,2,16,10,255,416,671,647
0131-002,2018,2,16,11,601,678,1279,671
0131-002,2018,2,16,12,945,808,1753,1279
0131-002,2018,2,16,13,1106,833,1939,1753
0131-002,2018,2,16,14,1110,864,1974,1939
0131-002,2018,2,16,15,905,947,1852,1974
0131-002,2018,2,16,16,986,890,1876,1852
0131-002,2018,2,16,17,893,805,1698,1876
0131-002,2018,2,16,18,892,692,1584,1698
0131-002,2018,2,16,19,978,513,1491,1584
0131-002,2018,2,16,20,843,426,1269,1491
0131-002,2018,2,16,21,959,392,1351,1269
0131-002,2018,2,16,22,527,329,856,1351
0131-002,2018,2,16,23,318,225,543,856
0131-002,2018,2,16,24,177,145,322,543
0131-002,2018,2,17,1,92,108,200,322
0131-002,2018,2,17,2,87,53,140,200
0131-002,2018,2,17,3,44,43,87,140
0131-002,2018,2,17,4,33,33,66,87
0131-002,2018,2,17,5,41,45,86,66
0131-002,2018,2,17,6,53,49,102,86
0131-002,2018,2,17,7,78,83,161,102
0131-002,2018,2,17,8,133,129,262,161
0131-002,2018,2,17,9,163,222,385,262
0131-002,2018,2,17,10,247,342,589,385
0131-002,2018,2,17,11,375,460,835,589
0131-002,2018,2,17,12,505,573,1078,835
0131-002,2018,2,17,13,546,597,1143,1078
0131-002,2018,2,17,14,645,575,1220,1143
0131-002,2018,2,17,15,667,586,1253,1220
0131-002,2018,2,17,16,814,657,1471,1253
0131-002,2018,2,17,17,859,554,1413,1471
0131-002,2018,2,17,18,845,545,1390,1413
0131-002,2018,2,17,19,795,514,1309,1390
0131-002,2018,2,17,20,814,386,1200,1309
0131-002,2018,2,17,21,903,341,1244,1200
0131-002,2018,2,17,22,509,256,765,1244
0131-002,2018,2,17,23,334,223,557,765
0131-002,2018,2,17,24,175,133,308,557
0131-002,2018,2,18,1,153,103,256,308
0131-002,2018,2,18,2,112,67,179,256
0131-002,2018,2,18,3,109,69,178,179
0131-002,2018,2,18,4,61,50,111,178
0131-002,2018,2,18,5,53,64,117,111
0131-002,2018,2,18,6,60,63,123,117
0131-002,2018,2,18,7,122,94,216,123
0131-002,2018,2,18,8,197,172,369,216
0131-002,2018,2,18,9,229,272,501,369
0131-002,2018,2,18,10,303,352,655,501
0131-002,2018,2,18,11,398,461,859,655
0131-002,2018,2,18,12,393,490,883,859
0131-002,2018,2,18,13,494,501,995,883
0131-002,2018,2,18,14,608,545,1153,995
0131-002,2018,2,18,15,557,560,1117,1153
0131-002,2018,2,18,16,627,597,1224,1117
0131-002,2018,2,18,17,588,521,1109,1224
0131-002,2018,2,18,18,571,532,1103,1109
0131-002,2018,2,18,19,473,438,911,1103
0131-002,2018,2,18,20,409,367,776,911
0131-002,2018,2,18,21,386,295,681,776
0131-002,2018,2,18,22,322,266,588,681
0131-002,2018,2,18,23,248,221,469,588
0131-002,2018,2,18,24,218,133,351,469
0131-002,2018,2,19,1,118,95,213,351
0131-002,2018,2,19,2,94,59,153,213
0131-002,2018,2,19,3,39,56,95,153
0131-002,2018,2,19,4,58,44,102,95
0131-002,2018,2,19,5,100,87,187,102
0131-002,2018,2,19,6,225,176,401,187
0131-002,2018,2,19,7,674,371,1045,401
0131-002,2018,2,19,8,1378,837,2215,1045
0131-002,2018,2,19,9,1163,890,2053,2215
0131-002,2018,2,19,10,839,813,1652,2053
0131-002,2018,2,19,11,904,806,1710,1652
0131-002,2018,2,19,12,802,783,1585,1710
0131-002,2018,2,19,13,799,711,1510,1585
0131-002,2018,2,19,14,892,842,1734,1510
0131-002,2018,2,19,15,929,903,1832,1734
0131-002,2018,2,19,16,867,863,1730,1832
0131-002,2018,2,19,17,871,850,1721,1730
0131-002,2018,2,19,18,887,1020,1907,1721
0131-002,2018,2,19,19,905,967,1872,1907
0131-002,2018,2,19,20,633,651,1284,1872
0131-002,2018,2,19,21,497,567,1064,1284
0131-002,2018,2,19,22,352,373,725,1064
0131-002,2018,2,19,23,284,256,540,725
0131-002,2018,2,19,24,138,154,292,540
0131-002,2018,2,20,1,128,98,226,292
0131-002,2018,2,20,2,83,81,164,226
0131-002,2018,2,20,3,73,74,147,164
0131-002,2018,2,20,4,65,78,143,147
0131-002,2018,2,20,5,106,98,204,143
0131-002,2018,2,20,6,247,199,446,204
0131-002,2018,2,20,7,674,418,1092,446
0131-002,2018,2,20,8,1468,863,2331,1092
0131-002,2018,2,20,9,1232,1014,2246,2331
0131-002,2018,2,20,10,975,996,1971,2246
0131-002,2018,2,20,11,969,936,1905,1971
0131-002,2018,2,20,12,989,886,1875,1905
0131-002,2018,2,20,13,867,764,1631,1875
0131-002,2018,2,20,14,970,888,1858,1631
0131-002,2018,2,20,15,1069,1008,2077,1858
0131-002,2018,2,20,16,983,946,1929,2077
0131-002,2018,2,20,17,923,998,1921,1929
0131-002,2018,2,20,18,970,1134,2104,1921
0131-002,2018,2,20,19,888,1020,1908,2104
0131-002,2018,2,20,20,617,711,1328,1908
0131-002,2018,2,20,21,456,609,1065,1328
0131-002,2018,2,20,22,372,446,818,1065
0131-002,2018,2,20,23,282,278,560,818
0131-002,2018,2,20,24,182,201,383,560
0131-002,2018,2,21,1,135,144,279,383
0131-002,2018,2,21,2,75,86,161,279
0131-002,2018,2,21,3,81,64,145,161
0131-002,2018,2,21,4,80,81,161,145
0131-002,2018,2,21,5,111,117,228,161
0131-002,2018,2,21,6,242,192,434,228
0131-002,2018,2,21,7,704,431,1135,434
0131-002,2018,2,21,8,1396,876,2272,1135
0131-002,2018,2,21,9,1341,1045,2386,2272
0131-002,2018,2,21,10,1027,961,1988,2386
0131-002,2018,2,21,11,1052,956,2008,1988
0131-002,2018,2,21,12,956,917,1873,2008
0131-002,2018,2,21,13,834,780,1614,1873
0131-002,2018,2,21,14,904,901,1805,1614
0131-002,2018,2,21,15,1040,974,2014,1805
0131-002,2018,2,21,16,1000,953,1953,2014
0131-002,2018,2,21,17,958,969,1927,1953
0131-002,2018,2,21,18,974,1229,2203,1927
0131-002,2018,2,21,19,881,1056,1937,2203
0131-002,2018,2,21,20,659,736,1395,1937
0131-002,2018,2,21,21,480,576,1056,1395
0131-002,2018,2,21,22,361,419,780,1056
0131-002,2018,2,21,23,298,301,599,780
0131-002,2018,2,21,24,179,215,394,599
0131-002,2018,2,22,1,130,134,264,394
0131-002,2018,2,22,2,82,100,182,264
0131-002,2018,2,22,3,75,77,152,182
0131-002,2018,2,22,4,73,72,145,152
0131-002,2018,2,22,5,107,116,223,145
0131-002,2018,2,22,6,289,185,474,223
0131-002,2018,2,22,7,704,408,1112,474
0131-002,2018,2,22,8,1482,857,2339,1112
0131-002,2018,2,22,9,1348,1131,2479,2339
0131-002,2018,2,22,10,1006,966,1972,2479
0131-002,2018,2,22,11,937,1014,1951,1972
0131-002,2018,2,22,12,941,902,1843,1951
0131-002,2018,2,22,13,866,808,1674,1843
0131-002,2018,2,22,14,918,949,1867,1674
0131-002,2018,2,22,15,1049,1029,2078,1867
0131-002,2018,2,22,16,1038,916,1954,2078
0131-002,2018,2,22,17,1002,960,1962,1954
0131-002,2018,2,22,18,1013,1136,2149,1962
0131-002,2018,2,22,19,928,1064,1992,2149
0131-002,2018,2,22,20,645,755,1400,1992
0131-002,2018,2,22,21,502,645,1147,1400
0131-002,2018,2,22,22,371,463,834,1147
0131-002,2018,2,22,23,267,304,571,834
0131-002,2018,2,22,24,185,215,400,571
0131-002,2018,2,23,1,145,156,301,400
0131-002,2018,2,23,2,86,96,182,301
0131-002,2018,2,23,3,60,79,139,182
0131-002,2018,2,23,4,64,81,145,139
0131-002,2018,2,23,5,116,111,227,145
0131-002,2018,2,23,6,261,209,470,227
0131-002,2018,2,23,7,659,414,1073,470
0131-002,2018,2,23,8,1388,878,2266,1073
0131-002,2018,2,23,9,1246,1109,2355,2266
0131-002,2018,2,23,10,928,916,1844,2355
0131-002,2018,2,23,11,956,931,1887,1844
0131-002,2018,2,23,12,910,898,1808,1887
0131-002,2018,2,23,13,890,837,1727,1808
0131-002,2018,2,23,14,967,956,1923,1727
0131-002,2018,2,23,15,1089,1027,2116,1923
0131-002,2018,2,23,16,1104,1022,2126,2116
0131-002,2018,2,23,17,1049,1006,2055,2126
0131-002,2018,2,23,18,1148,1407,2555,2055
0131-002,2018,2,23,19,1092,1289,2381,2555
0131-002,2018,2,23,20,697,851,1548,2381
0131-002,2018,2,23,21,505,646,1151,1548
0131-002,2018,2,23,22,364,504,868,1151
0131-002,2018,2,23,23,276,296,572,868
0131-002,2018,2,23,24,201,231,432,572
0131-002,2018,2,24,1,143,172,315,432
0131-002,2018,2,24,2,107,133,240,315
0131-002,2018,2,24,3,85,96,181,240
0131-002,2018,2,24,4,88,89,177,181
0131-002,2018,2,24,5,102,128,230,177
0131-002,2018,2,24,6,219,182,401,230
0131-002,2018,2,24,7,442,331,773,401
0131-002,2018,2,24,8,725,517,1242,773
0131-002,2018,2,24,9,758,739,1497,1242
0131-002,2018,2,24,10,747,742,1489,1497
0131-002,2018,2,24,11,830,771,1601,1489
0131-002,2018,2,24,12,800,749,1549,1601
0131-002,2018,2,24,13,753,722,1475,1549
0131-002,2018,2,24,14,831,712,1543,1475
0131-002,2018,2,24,15,819,710,1529,1543
0131-002,2018,2,24,16,819,781,1600,1529
0131-002,2018,2,24,17,823,884,1707,1600
0131-002,2018,2,24,18,929,916,1845,1707
0131-002,2018,2,24,19,771,702,1473,1845
0131-002,2018,2,24,20,559,527,1086,1473
0131-002,2018,2,24,21,413,404,817,1086
0131-002,2018,2,24,22,335,299,634,817
0131-002,2018,2,24,23,255,253,508,634
0131-002,2018,2,24,24,151,151,302,508
0131-002,2018,2,25,1,160,157,317,302
0131-002,2018,2,25,2,67,94,161,317
0131-002,2018,2,25,3,65,69,134,161
0131-002,2018,2,25,4,70,63,133,134
0131-002,2018,2,25,5,60,81,141,133
0131-002,2018,2,25,6,124,101,225,141
0131-002,2018,2,25,7,195,174,369,225
0131-002,2018,2,25,8,268,295,563,369
0131-002,2018,2,25,9,320,426,746,563
0131-002,2018,2,25,10,347,447,794,746
0131-002,2018,2,25,11,417,490,907,794
0131-002,2018,2,25,12,504,554,1058,907
0131-002,2018,2,25,13,543,536,1079,1058
0131-002,2018,2,25,14,659,620,1279,1079
0131-002,2018,2,25,15,674,607,1281,1279
0131-002,2018,2,25,16,713,636,1349,1281
0131-002,2018,2,25,17,722,673,1395,1349
0131-002,2018,2,25,18,676,641,1317,1395
0131-002,2018,2,25,19,639,536,1175,1317
0131-002,2018,2,25,20,516,417,933,1175
0131-002,2018,2,25,21,364,373,737,933
0131-002,2018,2,25,22,355,316,671,737
0131-002,2018,2,25,23,303,240,543,671
0131-002,2018,2,25,24,159,139,298,543
0131-002,2018,2,26,1,112,85,197,298
0131-002,2018,2,26,2,67,79,146,197
0131-002,2018,2,26,3,41,52,93,146
0131-002,2018,2,26,4,60,58,118,93
0131-002,2018,2,26,5,108,106,214,118
0131-002,2018,2,26,6,315,197,512,214
0131-002,2018,2,26,7,762,471,1233,512
0131-002,2018,2,26,8,1599,908,2507,1233
0131-002,2018,2,26,9,1405,991,2396,2507
0131-002,2018,2,26,10,932,948,1880,2396
0131-002,2018,2,26,11,1013,994,2007,1880
0131-002,2018,2,26,12,981,842,1823,2007
0131-002,2018,2,26,13,862,806,1668,1823
0131-002,2018,2,26,14,1010,872,1882,1668
0131-002,2018,2,26,15,1101,1019,2120,1882
0131-002,2018,2,26,16,1076,957,2033,2120
0131-002,2018,2,26,17,999,977,1976,2033
0131-002,2018,2,26,18,1049,1155,2204,1976
0131-002,2018,2,26,19,1028,1043,2071,2204
0131-002,2018,2,26,20,672,739,1411,2071
0131-002,2018,2,26,21,575,681,1256,1411
0131-002,2018,2,26,22,407,466,873,1256
0131-002,2018,2,26,23,286,280,566,873
0131-002,2018,2,26,24,147,212,359,566
0131-002,2018,2,27,1,119,128,247,359
0131-002,2018,2,27,2,75,96,171,247
0131-002,2018,2,27,3,66,81,147,171
0131-002,2018,2,27,4,71,99,170,147
0131-002,2018,2,27,5,112,113,225,170
0131-002,2018,2,27,6,304,190,494,225
0131-002,2018,2,27,7,729,439,1168,494
0131-002,2018,2,27,8,1501,901,2402,1168
0131-002,2018,2,27,9,1378,1101,2479,2402
0131-002,2018,2,27,10,990,930,1920,2479
0131-002,2018,2,27,11,1050,974,2024,1920
0131-002,2018,2,27,12,1001,878,1879,2024
0131-002,2018,2,27,13,881,851,1732,1879
0131-002,2018,2,27,14,990,971,1961,1732
0131-002,2018,2,27,15,1049,1014,2063,1961
0131-002,2018,2,27,16,1080,1012,2092,2063
0131-002,2018,2,27,17,1018,1031,2049,2092
0131-002,2018,2,27,18,1079,1192,2271,2049
0131-002,2018,2,27,19,1019,1079,2098,2271
0131-002,2018,2,27,20,717,765,1482,2098
0131-002,2018,2,27,21,531,631,1162,1482
0131-002,2018,2,27,22,402,478,880,1162
0131-002,2018,2,27,23,296,324,620,880
0131-002,2018,2,27,24,200,194,394,620
0131-002,2018,2,28,1,137,151,288,394
0131-002,2018,2,28,2,90,109,199,288
0131-002,2018,2,28,3,75,84,159,199
0131-002,2018,2,28,4,88,86,174,159
0131-002,2018,2,28,5,108,106,214,174
0131-002,2018,2,28,6,290,209,499,214
0131-002,2018,2,28,7,655,463,1118,499
0131-002,2018,2,28,8,1492,835,2327,1118
0131-002,2018,2,28,9,1339,1094,2433,2327
0131-002,2018,2,28,10,997,966,1963,2433
0131-002,2018,2,28,11,1035,1003,2038,1963
0131-002,2018,2,28,12,994,958,1952,2038
0131-002,2018,2,28,13,831,847,1678,1952
0131-002,2018,2,28,14,1010,992,2002,1678
0131-002,2018,2,28,15,1021,1016,2037,2002
0131-002,2018,2,28,16,870,1068,1938,2037
0131-002,2018,2,28,17,939,1059,1998,1938
0131-002,2018,2,28,18,1007,1444,2451,1998
0131-002,2018,2,28,19,1051,1346,2397,2451
0131-002,2018,2,28,20,731,900,1631,2397
0131-002,2018,2,28,21,473,700,1173,1631
0131-002,2018,2,28,22,379,517,896,1173
0131-002,2018,2,28,23,265,362,627,896
0131-002,2018,2,28,24,183,223,406,627
0131-002,2018,3,1,1,152,153,305,406
0131-002,2018,3,1,2,104,113,217,305
0131-002,2018,3,1,3,75,97,172,217
0131-002,2018,3,1,4,77,88,165,172
0131-002,2018,3,1,5,77,89,166,165
0131-002,2018,3,1,6,198,156,354,166
0131-002,2018,3,1,7,319,304,623,354
0131-002,2018,3,1,8,667,512,1179,623
0131-002,2018,3,1,9,625,624,1249,1179
0131-002,2018,3,1,10,611,656,1267,1249
0131-002,2018,3,1,11,636,742,1378,1267
0131-002,2018,3,1,12,652,737,1389,1378
0131-002,2018,3,1,13,661,725,1386,1389
0131-002,2018,3,1,14,689,681,1370,1386
0131-002,2018,3,1,15,751,712,1463,1370
0131-002,2018,3,1,16,767,735,1502,1463
0131-002,2018,3,1,17,769,728,1497,1502
0131-002,2018,3,1,18,784,790,1574,1497
0131-002,2018,3,1,19,636,697,1333,1574
0131-002,2018,3,1,20,482,495,977,1333
0131-002,2018,3,1,21,404,432,836,977
0131-002,2018,3,1,22,317,294,611,836
0131-002,2018,3,1,23,236,202,438,611
0131-002,2018,3,1,24,126,132,258,438
0131-002,2018,3,2,1,91,83,174,258
0131-002,2018,3,2,2,70,86,156,174
0131-002,2018,3,2,3,55,67,122,156
0131-002,2018,3,2,4,65,59,124,122
0131-002,2018,3,2,5,105,95,200,124
0131-002,2018,3,2,6,269,176,445,200
0131-002,2018,3,2,7,696,376,1072,445
0131-002,2018,3,2,8,1470,825,2295,1072
0131-002,2018,3,2,9,1285,894,2179,2295
0131-002,2018,3,2,10,903,948,1851,2179
0131-002,2018,3,2,11,985,884,1869,1851
0131-002,2018,3,2,12,947,848,1795,1869
0131-002,2018,3,2,13,887,792,1679,1795
0131-002,2018,3,2,14,943,863,1806,1679
0131-002,2018,3,2,15,1010,977,1987,1806
0131-002,2018,3,2,16,1009,978,1987,1987
0131-002,2018,3,2,17,951,1019,1970,1987
0131-002,2018,3,2,18,1012,1147,2159,1970
0131-002,2018,3,2,19,1026,1109,2135,2159
0131-002,2018,3,2,20,695,816,1511,2135
0131-002,2018,3,2,21,552,621,1173,1511
0131-002,2018,3,2,22,460,490,950,1173
0131-002,2018,3,2,23,297,309,606,950
0131-002,2018,3,2,24,194,207,401,606
0131-002,2018,3,3,1,133,155,288,401
0131-002,2018,3,3,2,95,102,197,288
0131-002,2018,3,3,3,75,97,172,197
0131-002,2018,3,3,4,93,91,184,172
0131-002,2018,3,3,5,107,124,231,184
0131-002,2018,3,3,6,202,181,383,231
0131-002,2018,3,3,7,442,331,773,383
0131-002,2018,3,3,8,686,560,1246,773
0131-002,2018,3,3,9,732,693,1425,1246
0131-002,2018,3,3,10,738,720,1458,1425
0131-002,2018,3,3,11,755,747,1502,1458
0131-002,2018,3,3,12,876,745,1621,1502
0131-002,2018,3,3,13,760,697,1457,1621
0131-002,2018,3,3,14,828,732,1560,1457
0131-002,2018,3,3,15,939,723,1662,1560
0131-002,2018,3,3,16,844,795,1639,1662
0131-002,2018,3,3,17,865,801,1666,1639
0131-002,2018,3,3,18,984,935,1919,1666
0131-002,2018,3,3,19,811,757,1568,1919
0131-002,2018,3,3,20,524,564,1088,1568
0131-002,2018,3,3,21,379,434,813,1088
0131-002,2018,3,3,22,337,340,677,813
0131-002,2018,3,3,23,241,235,476,677
0131-002,2018,3,3,24,160,149,309,476
0131-002,2018,3,4,1,128,135,263,309
0131-002,2018,3,4,2,113,104,217,263
0131-002,2018,3,4,3,50,77,127,217
0131-002,2018,3,4,4,51,60,111,127
0131-002,2018,3,4,5,72,86,158,111
0131-002,2018,3,4,6,98,97,195,158
0131-002,2018,3,4,7,182,171,353,195
0131-002,2018,3,4,8,296,308,604,353
0131-002,2018,3,4,9,342,410,752,604
0131-002,2018,3,4,10,369,492,861,752
0131-002,2018,3,4,11,522,531,1053,861
0131-002,2018,3,4,12,622,546,1168,1053
0131-002,2018,3,4,13,613,505,1118,1168
0131-002,2018,3,4,14,759,566,1325,1118
0131-002,2018,3,4,15,775,637,1412,1325
0131-002,2018,3,4,16,825,693,1518,1412
0131-002,2018,3,4,17,867,715,1582,1518
0131-002,2018,3,4,18,727,668,1395,1582
0131-002,2018,3,4,19,697,552,1249,1395
0131-002,2018,3,4,20,614,514,1128,1249
0131-002,2018,3,4,21,449,379,828,1128
0131-002,2018,3,4,22,382,294,676,828
0131-002,2018,3,4,23,288,247,535,676
0131-002,2018,3,4,24,150,121,271,535
0131-002,2018,3,5,1,120,84,204,271
0131-002,2018,3,5,2,69,63,132,204
0131-002,2018,3,5,3,40,44,84,132
0131-002,2018,3,5,4,52,53,105,84
0131-002,2018,3,5,5,104,87,191,105
0131-002,2018,3,5,6,271,196,467,191
0131-002,2018,3,5,7,725,438,1163,467
0131-002,2018,3,5,8,1470,958,2428,1163
0131-002,2018,3,5,9,1381,1039,2420,2428
0131-002,2018,3,5,10,878,906,1784,2420
0131-002,2018,3,5,11,958,936,1894,1784
0131-002,2018,3,5,12,924,872,1796,1894
0131-002,2018,3,5,13,816,734,1550,1796
0131-002,2018,3,5,14,865,818,1683,1550
0131-002,2018,3,5,15,1045,944,1989,1683
0131-002,2018,3,5,16,979,941,1920,1989
0131-002,2018,3,5,17,946,984,1930,1920
0131-002,2018,3,5,18,992,1036,2028,1930
0131-002,2018,3,5,19,975,965,1940,2028
0131-002,2018,3,5,20,638,784,1422,1940
0131-002,2018,3,5,21,497,698,1195,1422
0131-002,2018,3,5,22,385,469,854,1195
0131-002,2018,3,5,23,273,296,569,854
0131-002,2018,3,5,24,129,196,325,569
0131-002,2018,3,6,1,133,124,257,325
0131-002,2018,3,6,2,83,93,176,257
0131-002,2018,3,6,3,65,82,147,176
0131-002,2018,3,6,4,67,72,139,147
0131-002,2018,3,6,5,120,102,222,139
0131-002,2018,3,6,6,282,201,483,222
0131-002,2018,3,6,7,728,414,1142,483
0131-002,2018,3,6,8,1518,904,2422,1142
0131-002,2018,3,6,9,1406,1011,2417,2422
0131-002,2018,3,6,10,1038,949,1987,2417
0131-002,2018,3,6,11,988,920,1908,1987
0131-002,2018,3,6,12,991,841,1832,1908
0131-002,2018,3,6,13,875,775,1650,1832
0131-002,2018,3,6,14,970,931,1901,1650
0131-002,2018,3,6,15,1051,973,2024,1901
0131-002,2018,3,6,16,1061,973,2034,2024
0131-002,2018,3,6,17,1075,999,2074,2034
0131-002,2018,3,6,18,1041,1193,2234,2074
0131-002,2018,3,6,19,968,1068,2036,2234
0131-002,2018,3,6,20,726,721,1447,2036
0131-002,2018,3,6,21,582,653,1235,1447
0131-002,2018,3,6,22,431,472,903,1235
0131-002,2018,3,6,23,262,303,565,903
0131-002,2018,3,6,24,168,189,357,565
0131-002,2018,3,7,1,121,140,261,357
0131-002,2018,3,7,2,79,89,168,261
0131-002,2018,3,7,3,71,70,141,168
0131-002,2018,3,7,4,79,69,148,141
0131-002,2018,3,7,5,116,122,238,148
0131-002,2018,3,7,6,326,204,530,238
0131-002,2018,3,7,7,762,428,1190,530
0131-002,2018,3,7,8,1575,843,2418,1190
0131-002,2018,3,7,9,1377,1099,2476,2418
0131-002,2018,3,7,10,1126,970,2096,2476
0131-002,2018,3,7,11,1097,977,2074,2096
0131-002,2018,3,7,12,1019,930,1949,2074
0131-002,2018,3,7,13,890,832,1722,1949
0131-002,2018,3,7,14,1020,940,1960,1722
0131-002,2018,3,7,15,1150,1052,2202,1960
0131-002,2018,3,7,16,1168,1028,2196,2202
0131-002,2018,3,7,17,1015,1076,2091,2196
0131-002,2018,3,7,18,1067,1325,2392,2091
0131-002,2018,3,7,19,1007,1151,2158,2392
0131-002,2018,3,7,20,723,753,1476,2158
0131-002,2018,3,7,21,478,629,1107,1476
0131-002,2018,3,7,22,366,442,808,1107
0131-002,2018,3,7,23,276,317,593,808
0131-002,2018,3,7,24,172,201,373,593
0131-002,2018,3,8,1,114,155,269,373
0131-002,2018,3,8,2,74,82,156,269
0131-002,2018,3,8,3,66,66,132,156
0131-002,2018,3,8,4,61,74,135,132
0131-002,2018,3,8,5,107,115,222,135
0131-002,2018,3,8,6,259,184,443,222
0131-002,2018,3,8,7,590,374,964,443
0131-002,2018,3,8,8,1339,931,2270,964
0131-002,2018,3,8,9,1268,1124,2392,2270
0131-002,2018,3,8,10,932,922,1854,2392
0131-002,2018,3,8,11,904,869,1773,1854
0131-002,2018,3,8,12,867,794,1661,1773
0131-002,2018,3,8,13,783,748,1531,1661
0131-002,2018,3,8,14,891,879,1770,1531
0131-002,2018,3,8,15,976,896,1872,1770
0131-002,2018,3,8,16,939,967,1906,1872
0131-002,2018,3,8,17,909,896,1805,1906
0131-002,2018,3,8,18,928,1013,1941,1805
0131-002,2018,3,8,19,883,951,1834,1941
0131-002,2018,3,8,20,577,731,1308,1834
0131-002,2018,3,8,21,524,701,1225,1308
0131-002,2018,3,8,22,387,451,838,1225
0131-002,2018,3,8,23,253,304,557,838
0131-002,2018,3,8,24,155,191,346,557
0131-002,2018,3,9,1,131,113,244,346
0131-002,2018,3,9,2,88,81,169,244
0131-002,2018,3,9,3,57,81,138,169
0131-002,2018,3,9,4,61,66,127,138
0131-002,2018,3,9,5,112,132,244,127
0131-002,2018,3,9,6,244,210,454,244
0131-002,2018,3,9,7,738,429,1167,454
0131-002,2018,3,9,8,1495,885,2380,1167
0131-002,2018,3,9,9,1339,1023,2362,2380
0131-002,2018,3,9,10,1126,952,2078,2362
0131-002,2018,3,9,11,1065,950,2015,2078
0131-002,2018,3,9,12,962,945,1907,2015
0131-002,2018,3,9,13,877,862,1739,1907
0131-002,2018,3,9,14,993,908,1901,1739
0131-002,2018,3,9,15,1097,1032,2129,1901
0131-002,2018,3,9,16,1086,958,2044,2129
0131-002,2018,3,9,17,1031,990,2021,2044
0131-002,2018,3,9,18,1179,1269,2448,2021
0131-002,2018,3,9,19,1137,1275,2412,2448
0131-002,2018,3,9,20,769,869,1638,2412
0131-002,2018,3,9,21,576,711,1287,1638
0131-002,2018,3,9,22,430,478,908,1287
0131-002,2018,3,9,23,285,329,614,908
0131-002,2018,3,9,24,186,221,407,614
0131-002,2018,3,10,1,162,175,337,407
0131-002,2018,3,10,2,118,134,252,337
0131-002,2018,3,10,3,82,103,185,252
0131-002,2018,3,10,4,73,89,162,185
0131-002,2018,3,10,5,116,138,254,162
0131-002,2018,3,10,6,220,191,411,254
0131-002,2018,3,10,7,449,336,785,411
0131-002,2018,3,10,8,724,570,1294,785
0131-002,2018,3,10,9,829,754,1583,1294
0131-002,2018,3,10,10,768,778,1546,1583
0131-002,2018,3,10,11,779,779,1558,1546
0131-002,2018,3,10,12,862,760,1622,1558
0131-002,2018,3,10,13,822,687,1509,1622
0131-002,2018,3,10,14,873,746,1619,1509
0131-002,2018,3,10,15,884,764,1648,1619
0131-002,2018,3,10,16,944,843,1787,1648
0131-002,2018,3,10,17,940,752,1692,1787
0131-002,2018,3,10,18,982,942,1924,1692
0131-002,2018,3,10,19,807,743,1550,1924
0131-002,2018,3,10,20,614,559,1173,1550
0131-002,2018,3,10,21,418,441,859,1173
0131-002,2018,3,10,22,377,349,726,859
0131-002,2018,3,10,23,236,242,478,726
0131-002,2018,3,10,24,151,187,338,478
0131-002,2018,3,11,1,161,141,302,338
0131-002,2018,3,11,2,89,108,197,302
0131-002,2018,3,11,3,71,96,167,197
0131-002,2018,3,11,4,78,79,157,167
0131-002,2018,3,11,5,54,87,141,157
0131-002,2018,3,11,6,123,132,255,141
0131-002,2018,3,11,7,205,188,393,255
0131-002,2018,3,11,8,282,320,602,393
0131-002,2018,3,11,9,320,390,710,602
0131-002,2018,3,11,10,436,454,890,710
0131-002,2018,3,11,11,529,533,1062,890
0131-002,2018,3,11,12,675,550,1225,1062
0131-002,2018,3,11,13,616,555,1171,1225
0131-002,2018,3,11,14,691,555,1246,1171
0131-002,2018,3,11,15,750,640,1390,1246
0131-002,2018,3,11,16,749,666,1415,1390
0131-002,2018,3,11,17,831,712,1543,1415
0131-002,2018,3,11,18,812,750,1562,1543
0131-002,2018,3,11,19,716,582,1298,1562
0131-002,2018,3,11,20,544,514,1058,1298
0131-002,2018,3,11,21,460,401,861,1058
0131-002,2018,3,11,22,426,346,772,861
0131-002,2018,3,11,23,297,215,512,772
0131-002,2018,3,11,24,173,140,313,512
0131-002,2018,3,12,1,110,97,207,313
0131-002,2018,3,12,2,75,64,139,207
0131-002,2018,3,12,3,47,66,113,139
0131-002,2018,3,12,4,75,53,128,113
0131-002,2018,3,12,5,117,99,216,128
0131-002,2018,3,12,6,311,227,538,216
0131-002,2018,3,12,7,836,472,1308,538
0131-002,2018,3,12,8,1630,951,2581,1308
0131-002,2018,3,12,9,1465,1036,2501,2581
0131-002,2018,3,12,10,1008,902,1910,2501
0131-002,2018,3,12,11,1003,970,1973,1910
0131-002,2018,3,12,12,1019,840,1859,1973
0131-002,2018,3,12,13,904,761,1665,1859
0131-002,2018,3,12,14,1024,926,1950,1665
0131-002,2018,3,12,15,1120,971,2091,1950
0131-002,2018,3,12,16,1080,988,2068,2091
0131-002,2018,3,12,17,1045,932,1977,2068
0131-002,2018,3,12,18,1133,1152,2285,1977
0131-002,2018,3,12,19,1072,1023,2095,2285
0131-002,2018,3,12,20,710,753,1463,2095
0131-002,2018,3,12,21,594,680,1274,1463
0131-002,2018,3,12,22,422,445,867,1274
0131-002,2018,3,12,23,306,315,621,867
0131-002,2018,3,12,24,177,168,345,621
0131-002,2018,3,13,1,120,122,242,345
0131-002,2018,3,13,2,84,93,177,242
0131-002,2018,3,13,3,85,75,160,177
0131-002,2018,3,13,4,77,84,161,160
0131-002,2018,3,13,5,109,136,245,161
0131-002,2018,3,13,6,327,242,569,245
0131-002,2018,3,13,7,783,440,1223,569
0131-002,2018,3,13,8,1587,913,2500,1223
0131-002,2018,3,13,9,1464,1076,2540,2500
0131-002,2018,3,13,10,1113,1007,2120,2540
0131-002,2018,3,13,11,1091,920,2011,2120
0131-002,2018,3,13,12,1019,945,1964,2011
0131-002,2018,3,13,13,889,819,1708,1964
0131-002,2018,3,13,14,1110,929,2039,1708
0131-002,2018,3,13,15,1109,1029,2138,2039
0131-002,2018,3,13,16,1084,989,2073,2138
0131-002,2018,3,13,17,1034,1037,2071,2073
0131-002,2018,3,13,18,1182,1221,2403,2071
0131-002,2018,3,13,19,1079,1049,2128,2403
0131-002,2018,3,13,20,685,763,1448,2128
0131-002,2018,3,13,21,572,655,1227,1448
0131-002,2018,3,13,22,461,439,900,1227
0131-002,2018,3,13,23,334,311,645,900
0131-002,2018,3,13,24,205,203,408,645
0131-002,2018,3,14,1,134,148,282,408
0131-002,2018,3,14,2,81,102,183,282
0131-002,2018,3,14,3,78,85,163,183
0131-002,2018,3,14,4,76,79,155,163
0131-002,2018,3,14,5,134,133,267,155
0131-002,2018,3,14,6,332,224,556,267
0131-002,2018,3,14,7,776,438,1214,556
0131-002,2018,3,14,8,1642,953,2595,1214
0131-002,2018,3,14,9,1514,1083,2597,2595
0131-002,2018,3,14,10,1146,1042,2188,2597
0131-002,2018,3,14,11,1175,939,2114,2188
0131-002,2018,3,14,12,1040,944,1984,2114
0131-002,2018,3,14,13,886,800,1686,1984
0131-002,2018,3,14,14,980,896,1876,1686
0131-002,2018,3,14,15,1034,993,2027,1876
0131-002,2018,3,14,16,1053,940,1993,2027
0131-002,2018,3,14,17,1032,1010,2042,1993
0131-002,2018,3,14,18,1188,1268,2456,2042
0131-002,2018,3,14,19,1194,1250,2444,2456
0131-002,2018,3,14,20,746,793,1539,2444
0131-002,2018,3,14,21,541,615,1156,1539
0131-002,2018,3,14,22,477,440,917,1156
0131-002,2018,3,14,23,339,329,668,917
0131-002,2018,3,14,24,223,217,440,668
0131-002,2018,3,15,1,137,153,290,440
0131-002,2018,3,15,2,101,103,204,290
0131-002,2018,3,15,3,83,98,181,204
0131-002,2018,3,15,4,72,77,149,181
0131-002,2018,3,15,5,112,104,216,149
0131-002,2018,3,15,6,254,221,475,216
0131-002,2018,3,15,7,661,429,1090,475
0131-002,2018,3,15,8,1498,891,2389,1090
0131-002,2018,3,15,9,1402,1161,2563,2389
0131-002,2018,3,15,10,996,959,1955,2563
0131-002,2018,3,15,11,1031,846,1877,1955
0131-002,2018,3,15,12,937,860,1797,1877
0131-002,2018,3,15,13,853,810,1663,1797
0131-002,2018,3,15,14,942,900,1842,1663
0131-002,2018,3,15,15,1001,958,1959,1842
0131-002,2018,3,15,16,956,978,1934,1959
0131-002,2018,3,15,17,914,972,1886,1934
0131-002,2018,3,15,18,1017,1177,2194,1886
0131-002,2018,3,15,19,915,967,1882,2194
0131-002,2018,3,15,20,611,753,1364,1882
0131-002,2018,3,15,21,491,642,1133,1364
0131-002,2018,3,15,22,425,479,904,1133
0131-002,2018,3,15,23,292,304,596,904
0131-002,2018,3,15,24,184,206,390,596
0131-002,2018,3,16,1,144,145,289,390
0131-002,2018,3,16,2,102,106,208,289
0131-002,2018,3,16,3,52,90,142,208
0131-002,2018,3,16,4,68,73,141,142
0131-002,2018,3,16,5,121,133,254,141
0131-002,2018,3,16,6,284,248,532,254
0131-002,2018,3,16,7,734,433,1167,532
0131-002,2018,3,16,8,1518,865,2383,1167
0131-002,2018,3,16,9,1328,1036,2364,2383
0131-002,2018,3,16,10,1064,964,2028,2364
0131-002,2018,3,16,11,1065,961,2026,2028
0131-002,2018,3,16,12,992,933,1925,2026
0131-002,2018,3,16,13,906,838,1744,1925
0131-002,2018,3,16,14,971,890,1861,1744
0131-002,2018,3,16,15,1198,1000,2198,1861
0131-002,2018,3,16,16,1082,1041,2123,2198
0131-002,2018,3,16,17,1065,1040,2105,2123
0131-002,2018,3,16,18,1254,1267,2521,2105
0131-002,2018,3,16,19,1215,1321,2536,2521
0131-002,2018,3,16,20,805,884,1689,2536
0131-002,2018,3,16,21,658,687,1345,1689
0131-002,2018,3,16,22,444,544,988,1345
0131-002,2018,3,16,23,312,396,708,988
0131-002,2018,3,16,24,223,233,456,708
0131-002,2018,3,17,1,155,163,318,456
0131-002,2018,3,17,2,104,123,227,318
0131-002,2018,3,17,3,89,84,173,227
0131-002,2018,3,17,4,88,97,185,173
0131-002,2018,3,17,5,106,123,229,185
0131-002,2018,3,17,6,245,215,460,229
0131-002,2018,3,17,7,472,405,877,460
0131-002,2018,3,17,8,827,575,1402,877
0131-002,2018,3,17,9,859,734,1593,1402
0131-002,2018,3,17,10,904,763,1667,1593
0131-002,2018,3,17,11,923,829,1752,1667
0131-002,2018,3,17,12,998,795,1793,1752
0131-002,2018,3,17,13,929,780,1709,1793
0131-002,2018,3,17,14,917,732,1649,1709
0131-002,2018,3,17,15,902,748,1650,1649
0131-002,2018,3,17,16,874,793,1667,1650
0131-002,2018,3,17,17,979,830,1809,1667
0131-002,2018,3,17,18,1021,1058,2079,1809
0131-002,2018,3,17,19,849,750,1599,2079
0131-002,2018,3,17,20,582,583,1165,1599
0131-002,2018,3,17,21,425,455,880,1165
0131-002,2018,3,17,22,357,355,712,880
0131-002,2018,3,17,23,272,306,578,712
0131-002,2018,3,17,24,163,185,348,578
0131-002,2018,3,18,1,121,159,280,348
0131-002,2018,3,18,2,95,118,213,280
0131-002,2018,3,18,3,98,97,195,213
0131-002,2018,3,18,4,75,72,147,195
0131-002,2018,3,18,5,68,82,150,147
0131-002,2018,3,18,6,124,123,247,150
0131-002,2018,3,18,7,230,193,423,247
0131-002,2018,3,18,8,313,309,622,423
0131-002,2018,3,18,9,408,408,816,622
0131-002,2018,3,18,10,449,506,955,816
0131-002,2018,3,18,11,528,554,1082,955
0131-002,2018,3,18,12,597,592,1189,1082
0131-002,2018,3,18,13,591,606,1197,1189
0131-002,2018,3,18,14,658,618,1276,1197
0131-002,2018,3,18,15,732,680,1412,1276
0131-002,2018,3,18,16,784,698,1482,1412
0131-002,2018,3,18,17,761,708,1469,1482
0131-002,2018,3,18,18,800,707,1507,1469
0131-002,2018,3,18,19,725,612,1337,1507
0131-002,2018,3,18,20,565,489,1054,1337
0131-002,2018,3,18,21,454,422,876,1054
0131-002,2018,3,18,22,397,366,763,876
0131-002,2018,3,18,23,290,213,503,763
0131-002,2018,3,18,24,169,120,289,503
0131-002,2018,3,19,1,129,96,225,289
0131-002,2018,3,19,2,75,55,130,225
0131-002,2018,3,19,3,49,66,115,130
0131-002,2018,3,19,4,53,60,113,115
0131-002,2018,3,19,5,112,106,218,113
0131-002,2018,3,19,6,310,205,515,218
0131-002,2018,3,19,7,735,475,1210,515
0131-002,2018,3,19,8,1612,1015,2627,1210
0131-002,2018,3,19,9,1417,1079,2496,2627
0131-002,2018,3,19,10,992,921,1913,2496
0131-002,2018,3,19,11,936,947,1883,1913
0131-002,2018,3,19,12,946,849,1795,1883
0131-002,2018,3,19,13,821,780,1601,1795
0131-002,2018,3,19,14,926,861,1787,1601
0131-002,2018,3,19,15,989,993,1982,1787
0131-002,2018,3,19,16,1000,972,1972,1982
0131-002,2018,3,19,17,887,996,1883,1972
0131-002,2018,3,19,18,971,1193,2164,1883
0131-002,2018,3,19,19,968,1058,2026,2164
0131-002,2018,3,19,20,668,716,1384,2026
0131-002,2018,3,19,21,512,679,1191,1384
0131-002,2018,3,19,22,354,472,826,1191
0131-002,2018,3,19,23,251,300,551,826
0131-002,2018,3,19,24,150,183,333,551
0131-002,2018,3,20,1,122,125,247,333
0131-002,2018,3,20,2,92,73,165,247
0131-002,2018,3,20,3,70,83,153,165
0131-002,2018,3,20,4,83,73,156,153
0131-002,2018,3,20,5,105,113,218,156
0131-002,2018,3,20,6,291,241,532,218
0131-002,2018,3,20,7,788,442,1230,532
0131-002,2018,3,20,8,1510,949,2459,1230
0131-002,2018,3,20,9,1394,1077,2471,2459
0131-002,2018,3,20,10,1061,973,2034,2471
0131-002,2018,3,20,11,1127,1057,2184,2034
0131-002,2018,3,20,12,1055,920,1975,2184
0131-002,2018,3,20,13,960,751,1711,1975
0131-002,2018,3,20,14,1011,923,1934,1711
0131-002,2018,3,20,15,1075,1087,2162,1934
0131-002,2018,3,20,16,1045,1079,2124,2162
0131-002,2018,3,20,17,1056,1042,2098,2124
0131-002,2018,3,20,18,1093,1246,2339,2098
0131-002,2018,3,20,19,1001,1015,2016,2339
0131-002,2018,3,20,20,667,756,1423,2016
0131-002,2018,3,20,21,544,681,1225,1423
0131-002,2018,3,20,22,390,445,835,1225
0131-002,2018,3,20,23,254,287,541,835
0131-002,2018,3,20,24,177,208,385,541
0131-002,2018,3,21,1,129,112,241,385
0131-002,2018,3,21,2,81,90,171,241
0131-002,2018,3,21,3,64,72,136,171
0131-002,2018,3,21,4,74,89,163,136
0131-002,2018,3,21,5,112,103,215,163
0131-002,2018,3,21,6,299,227,526,215
0131-002,2018,3,21,7,749,402,1151,526
0131-002,2018,3,21,8,1326,965,2291,1151
0131-002,2018,3,21,9,1323,1138,2461,2291
0131-002,2018,3,21,10,991,918,1909,2461
0131-002,2018,3,21,11,1003,897,1900,1909
0131-002,2018,3,21,12,929,856,1785,1900
0131-002,2018,3,21,13,799,808,1607,1785
0131-002,2018,3,21,14,872,922,1794,1607
0131-002,2018,3,21,15,970,941,1911,1794
0131-002,2018,3,21,16,994,919,1913,1911
0131-002,2018,3,21,17,877,989,1866,1913
0131-002,2018,3,21,18,993,1248,2241,1866
0131-002,2018,3,21,19,971,1160,2131,2241
0131-002,2018,3,21,20,592,702,1294,2131
0131-002,2018,3,21,21,417,642,1059,1294
0131-002,2018,3,21,22,356,432,788,1059
0131-002,2018,3,21,23,244,277,521,788
0131-002,2018,3,21,24,151,197,348,521
0131-002,2018,3,22,1,118,114,232,348
0131-002,2018,3,22,2,91,74,165,232
0131-002,2018,3,22,3,58,69,127,165
0131-002,2018,3,22,4,65,71,136,127
0131-002,2018,3,22,5,127,107,234,136
0131-002,2018,3,22,6,294,224,518,234
0131-002,2018,3,22,7,729,408,1137,518
0131-002,2018,3,22,8,1490,921,2411,1137
0131-002,2018,3,22,9,1421,1107,2528,2411
0131-002,2018,3,22,10,1045,895,1940,2528
0131-002,2018,3,22,11,1089,939,2028,1940
0131-002,2018,3,22,12,971,882,1853,2028
0131-002,2018,3,22,13,859,805,1664,1853
0131-002,2018,3,22,14,1021,842,1863,1664
0131-002,2018,3,22,15,1129,979,2108,1863
0131-002,2018,3,22,16,1076,1038,2114,2108
0131-002,2018,3,22,17,1013,993,2006,2114
0131-002,2018,3,22,18,1117,1213,2330,2006
0131-002,2018,3,22,19,995,1095,2090,2330
0131-002,2018,3,22,20,725,722,1447,2090
0131-002,2018,3,22,21,556,660,1216,1447
0131-002,2018,3,22,22,432,499,931,1216
0131-002,2018,3,22,23,291,314,605,931
0131-002,2018,3,22,24,168,166,334,605
0131-002,2018,3,23,1,150,129,279,334
0131-002,2018,3,23,2,90,94,184,279
0131-002,2018,3,23,3,64,86,150,184
0131-002,2018,3,23,4,88,70,158,150
0131-002,2018,3,23,5,103,132,235,158
0131-002,2018,3,23,6,285,229,514,235
0131-002,2018,3,23,7,766,431,1197,514
0131-002,2018,3,23,8,1540,875,2415,1197
0131-002,2018,3,23,9,1422,1030,2452,2415
0131-002,2018,3,23,10,1123,958,2081,2452
0131-002,2018,3,23,11,1168,956,2124,2081
0131-002,2018,3,23,12,1086,932,2018,2124
0131-002,2018,3,23,13,946,854,1800,2018
0131-002,2018,3,23,14,1037,916,1953,1800
0131-002,2018,3,23,15,1162,1025,2187,1953
0131-002,2018,3,23,16,1120,982,2102,2187
0131-002,2018,3,23,17,1127,1044,2171,2102
0131-002,2018,3,23,18,1275,1414,2689,2171
0131-002,2018,3,23,19,1215,1225,2440,2689
0131-002,2018,3,23,20,836,859,1695,2440
0131-002,2018,3,23,21,619,676,1295,1695
0131-002,2018,3,23,22,467,488,955,1295
0131-002,2018,3,23,23,331,375,706,955
0131-002,2018,3,23,24,208,244,452,706
0131-002,2018,3,24,1,176,160,336,452
0131-002,2018,3,24,2,128,103,231,336
0131-002,2018,3,24,3,82,108,190,231
0131-002,2018,3,24,4,70,97,167,190
0131-002,2018,3,24,5,133,116,249,167
0131-002,2018,3,24,6,259,184,443,249
0131-002,2018,3,24,7,513,352,865,443
0131-002,2018,3,24,8,798,547,1345,865
0131-002,2018,3,24,9,869,748,1617,1345
0131-002,2018,3,24,10,816,789,1605,1617
0131-002,2018,3,24,11,908,799,1707,1605
0131-002,2018,3,24,12,1018,754,1772,1707
0131-002,2018,3,24,13,809,724,1533,1772
0131-002,2018,3,24,14,879,714,1593,1533
0131-002,2018,3,24,15,871,799,1670,1593
0131-002,2018,3,24,16,910,735,1645,1670
0131-002,2018,3,24,17,891,816,1707,1645
0131-002,2018,3,24,18,1025,919,1944,1707
0131-002,2018,3,24,19,912,680,1592,1944
0131-002,2018,3,24,20,602,539,1141,1592
0131-002,2018,3,24,21,464,471,935,1141
0131-002,2018,3,24,22,390,368,758,935
0131-002,2018,3,24,23,306,254,560,758
0131-002,2018,3,24,24,163,183,346,560
0131-002,2018,3,25,1,112,131,243,346
0131-002,2018,3,25,2,102,88,190,243
0131-002,2018,3,25,3,78,79,157,190
0131-002,2018,3,25,4,61,62,123,157
0131-002,2018,3,25,5,67,79,146,123
0131-002,2018,3,25,6,141,121,262,146
0131-002,2018,3,25,7,224,230,454,262
0131-002,2018,3,25,8,341,301,642,454
0131-002,2018,3,25,9,366,371,737,642
0131-002,2018,3,25,10,436,500,936,737
0131-002,2018,3,25,11,594,561,1155,936
0131-002,2018,3,25,12,634,548,1182,1155
0131-002,2018,3,25,13,609,557,1166,1182
0131-002,2018,3,25,14,731,581,1312,1166
0131-002,2018,3,25,15,913,657,1570,1312
0131-002,2018,3,25,16,935,645,1580,1570
0131-002,2018,3,25,17,846,725,1571,1580
0131-002,2018,3,25,18,792,765,1557,1571
0131-002,2018,3,25,19,806,605,1411,1557
0131-002,2018,3,25,20,613,485,1098,1411
0131-002,2018,3,25,21,519,448,967,1098
0131-002,2018,3,25,22,419,343,762,967
0131-002,2018,3,25,23,289,213,502,762
0131-002,2018,3,25,24,161,152,313,502
0131-002,2018,3,26,1,104,82,186,313
0131-002,2018,3,26,2,66,61,127,186
0131-002,2018,3,26,3,46,47,93,127
0131-002,2018,3,26,4,60,66,126,93
0131-002,2018,3,26,5,97,100,197,126
0131-002,2018,3,26,6,332,216,548,197
0131-002,2018,3,26,7,910,474,1384,548
0131-002,2018,3,26,8,1671,983,2654,1384
0131-002,2018,3,26,9,1561,1058,2619,2654
0131-002,2018,3,26,10,1055,912,1967,2619
0131-002,2018,3,26,11,1105,958,2063,1967
0131-002,2018,3,26,12,1040,844,1884,2063
0131-002,2018,3,26,13,879,770,1649,1884
0131-002,2018,3,26,14,1086,894,1980,1649
0131-002,2018,3,26,15,1122,982,2104,1980
0131-002,2018,3,26,16,1035,1002,2037,2104
0131-002,2018,3,26,17,1027,928,1955,2037
0131-002,2018,3,26,18,1171,1162,2333,1955
0131-002,2018,3,26,19,1161,973,2134,2333
0131-002,2018,3,26,20,727,717,1444,2134
0131-002,2018,3,26,21,581,655,1236,1444
0131-002,2018,3,26,22,481,444,925,1236
0131-002,2018,3,26,23,283,320,603,925
0131-002,2018,3,26,24,179,186,365,603
0131-002,2018,3,27,1,132,116,248,365
0131-002,2018,3,27,2,86,73,159,248
0131-002,2018,3,27,3,69,76,145,159
0131-002,2018,3,27,4,87,75,162,145
0131-002,2018,3,27,5,123,115,238,162
0131-002,2018,3,27,6,308,242,550,238
0131-002,2018,3,27,7,829,441,1270,550
0131-002,2018,3,27,8,1608,931,2539,1270
0131-002,2018,3,27,9,1495,1076,2571,2539
0131-002,2018,3,27,10,1089,990,2079,2571
0131-002,2018,3,27,11,1130,988,2118,2079
0131-002,2018,3,27,12,1029,932,1961,2118
0131-002,2018,3,27,13,914,785,1699,1961
0131-002,2018,3,27,14,1057,926,1983,1699
0131-002,2018,3,27,15,1104,1058,2162,1983
0131-002,2018,3,27,16,1066,1034,2100,2162
0131-002,2018,3,27,17,1048,992,2040,2100
0131-002,2018,3,27,18,1135,1163,2298,2040
0131-002,2018,3,27,19,1098,1006,2104,2298
0131-002,2018,3,27,20,714,742,1456,2104
0131-002,2018,3,27,21,577,656,1233,1456
0131-002,2018,3,27,22,447,486,933,1233
0131-002,2018,3,27,23,312,317,629,933
0131-002,2018,3,27,24,166,197,363,629
0131-002,2018,3,28,1,129,140,269,363
0131-002,2018,3,28,2,101,94,195,269
0131-002,2018,3,28,3,71,91,162,195
0131-002,2018,3,28,4,69,65,134,162
0131-002,2018,3,28,5,123,126,249,134
0131-002,2018,3,28,6,321,216,537,249
0131-002,2018,3,28,7,805,488,1293,537
0131-002,2018,3,28,8,1651,894,2545,1293
0131-002,2018,3,28,9,1532,1092,2624,2545
0131-002,2018,3,28,10,1139,898,2037,2624
0131-002,2018,3,28,11,1130,932,2062,2037
0131-002,2018,3,28,12,1044,911,1955,2062
0131-002,2018,3,28,13,865,795,1660,1955
0131-002,2018,3,28,14,1048,968,2016,1660
0131-002,2018,3,28,15,1195,974,2169,2016
0131-002,2018,3,28,16,1099,1056,2155,2169
0131-002,2018,3,28,17,1065,1049,2114,2155
0131-002,2018,3,28,18,1170,1291,2461,2114
0131-002,2018,3,28,19,1181,1077,2258,2461
0131-002,2018,3,28,20,765,678,1443,2258
0131-002,2018,3,28,21,548,628,1176,1443
0131-002,2018,3,28,22,460,440,900,1176
0131-002,2018,3,28,23,302,326,628,900
0131-002,2018,3,28,24,206,208,414,628
0131-002,2018,3,29,1,157,150,307,414
0131-002,2018,3,29,2,112,93,205,307
0131-002,2018,3,29,3,69,86,155,205
0131-002,2018,3,29,4,81,81,162,155
0131-002,2018,3,29,5,111,127,238,162
0131-002,2018,3,29,6,320,204,524,238
0131-002,2018,3,29,7,810,518,1328,524
0131-002,2018,3,29,8,1696,890,2586,1328
0131-002,2018,3,29,9,1512,1041,2553,2586
0131-002,2018,3,29,10,1084,945,2029,2553
0131-002,2018,3,29,11,1098,921,2019,2029
0131-002,2018,3,29,12,1072,878,1950,2019
0131-002,2018,3,29,13,856,764,1620,1950
0131-002,2018,3,29,14,982,862,1844,1620
0131-002,2018,3,29,15,1097,992,2089,1844
0131-002,2018,3,29,16,1073,966,2039,2089
0131-002,2018,3,29,17,1060,1021,2081,2039
0131-002,2018,3,29,18,1123,1137,2260,2081
0131-002,2018,3,29,19,1091,988,2079,2260
0131-002,2018,3,29,20,744,763,1507,2079
0131-002,2018,3,29,21,559,665,1224,1507
0131-002,2018,3,29,22,455,462,917,1224
0131-002,2018,3,29,23,334,341,675,917
0131-002,2018,3,29,24,195,214,409,675
0131-002,2018,3,30,1,179,152,331,409
0131-002,2018,3,30,2,120,107,227,331
0131-002,2018,3,30,3,63,87,150,227
0131-002,2018,3,30,4,92,89,181,150
0131-002,2018,3,30,5,145,121,266,181
0131-002,2018,3,30,6,302,195,497,266
0131-002,2018,3,30,7,841,427,1268,497
0131-002,2018,3,30,8,1626,864,2490,1268
0131-002,2018,3,30,9,1540,1069,2609,2490
0131-002,2018,3,30,10,1075,945,2020,2609
0131-002,2018,3,30,11,1142,1008,2150,2020
0131-002,2018,3,30,12,1020,964,1984,2150
0131-002,2018,3,30,13,964,819,1783,1984
0131-002,2018,3,30,14,1041,980,2021,1783
0131-002,2018,3,30,15,1115,984,2099,2021
0131-002,2018,3,30,16,1174,979,2153,2099
0131-002,2018,3,30,17,1112,1069,2181,2153
0131-002,2018,3,30,18,1265,1372,2637,2181
0131-002,2018,3,30,19,1371,1166,2537,2637
0131-002,2018,3,30,20,884,852,1736,2537
0131-002,2018,3,30,21,645,720,1365,1736
0131-002,2018,3,30,22,516,511,1027,1365
0131-002,2018,3,30,23,347,351,698,1027
0131-002,2018,3,30,24,233,245,478,698
0131-002,2018,3,31,1,180,176,356,478
0131-002,2018,3,31,2,160,113,273,356
0131-002,2018,3,31,3,85,57,142,273
0131-002,2018,3,31,4,85,55,140,142
0131-002,2018,3,31,5,100,70,170,140
0131-002,2018,3,31,6,287,200,487,170
0131-002,2018,3,31,7,548,378,926,487
0131-002,2018,3,31,8,805,561,1366,926
0131-002,2018,3,31,9,906,741,1647,1366
0131-002,2018,3,31,10,867,776,1643,1647
0131-002,2018,3,31,11,991,814,1805,1643
0131-002,2018,3,31,12,967,774,1741,1805
0131-002,2018,3,31,13,899,752,1651,1741
0131-002,2018,3,31,14,928,723,1651,1651
0131-002,2018,3,31,15,964,774,1738,1651
0131-002,2018,3,31,16,974,764,1738,1738
0131-002,2018,3,31,17,929,823,1752,1738
0131-002,2018,3,31,18,1123,988,2111,1752
0131-002,2018,3,31,19,1007,715,1722,2111
0131-002,2018,3,31,20,640,613,1253,1722
0131-002,2018,3,31,21,477,476,953,1253
0131-002,2018,3,31,22,414,354,768,953
0131-002,2018,3,31,23,313,285,598,768
0131-002,2018,3,31,24,212,185,397,598
0131-002,2018,4,1,1,150,144,294,397
0131-002,2018,4,1,2,105,96,201,294
0131-002,2018,4,1,3,74,31,105,201
0131-002,2018,4,1,4,71,22,93,105
0131-002,2018,4,1,5,77,45,122,93
0131-002,2018,4,1,6,145,128,273,122
0131-002,2018,4,1,7,245,182,427,273
0131-002,2018,4,1,8,370,173,543,427
0131-002,2018,4,1,9,395,392,787,543
0131-002,2018,4,1,10,493,532,1025,787
0131-002,2018,4,1,11,580,566,1146,1025
0131-002,2018,4,1,12,680,583,1263,1146
0131-002,2018,4,1,13,615,606,1221,1263
0131-002,2018,4,1,14,741,632,1373,1221
0131-002,2018,4,1,15,771,661,1432,1373
0131-002,2018,4,1,16,763,667,1430,1432
0131-002,2018,4,1,17,785,744,1529,1430
0131-002,2018,4,1,18,900,710,1610,1529
0131-002,2018,4,1,19,857,617,1474,1610
0131-002,2018,4,1,20,625,526,1151,1474
0131-002,2018,4,1,21,522,432,954,1151
0131-002,2018,4,1,22,437,321,758,954
0131-002,2018,4,1,23,324,220,544,758
0131-002,2018,4,1,24,211,129,340,544
0131-002,2018,4,2,1,136,104,240,340
0131-002,2018,4,2,2,89,71,160,240
0131-002,2018,4,2,3,61,68,129,160
0131-002,2018,4,2,4,71,58,129,129
0131-002,2018,4,2,5,120,79,199,129
0131-002,2018,4,2,6,343,252,595,199
0131-002,2018,4,2,7,988,381,1369,595
0131-002,2018,4,2,8,1793,916,2709,1369
0131-002,2018,4,2,9,1526,1066,2592,2709
0131-002,2018,4,2,10,1060,968,2028,2592
0131-002,2018,4,2,11,1147,1033,2180,2028
0131-002,2018,4,2,12,1177,1033,2210,2180
0131-002,2018,4,2,13,931,833,1764,2210
0131-002,2018,4,2,14,1092,945,2037,1764
0131-002,2018,4,2,15,1140,1094,2234,2037
0131-002,2018,4,2,16,1108,1012,2120,2234
0131-002,2018,4,2,17,1045,961,2006,2120
0131-002,2018,4,2,18,1152,1182,2334,2006
0131-002,2018,4,2,19,1101,1062,2163,2334
0131-002,2018,4,2,20,777,854,1631,2163
0131-002,2018,4,2,21,567,677,1244,1631
0131-002,2018,4,2,22,478,492,970,1244
0131-002,2018,4,2,23,282,298,580,970
0131-002,2018,4,2,24,198,222,420,580
0131-002,2018,4,3,1,138,156,294,420
0131-002,2018,4,3,2,99,106,205,294
0131-002,2018,4,3,3,59,88,147,205
0131-002,2018,4,3,4,90,76,166,147
0131-002,2018,4,3,5,126,139,265,166
0131-002,2018,4,3,6,354,211,565,265
0131-002,2018,4,3,7,858,413,1271,565
0131-002,2018,4,3,8,1651,794,2445,1271
0131-002,2018,4,3,9,1559,1122,2681,2445
0131-002,2018,4,3,10,1061,1018,2079,2681
0131-002,2018,4,3,11,1117,1057,2174,2079
0131-002,2018,4,3,12,1052,919,1971,2174
0131-002,2018,4,3,13,900,794,1694,1971
0131-002,2018,4,3,14,1018,968,1986,1694
0131-002,2018,4,3,15,1174,1130,2304,1986
0131-002,2018,4,3,16,1144,1041,2185,2304
0131-002,2018,4,3,17,1028,1034,2062,2185
0131-002,2018,4,3,18,1210,1315,2525,2062
0131-002,2018,4,3,19,1062,1046,2108,2525
0131-002,2018,4,3,20,831,785,1616,2108
0131-002,2018,4,3,21,588,756,1344,1616
0131-002,2018,4,3,22,442,517,959,1344
0131-002,2018,4,3,23,337,349,686,959
0131-002,2018,4,3,24,191,199,390,686
0131-002,2018,4,4,1,167,142,309,390
0131-002,2018,4,4,2,93,101,194,309
0131-002,2018,4,4,3,74,70,144,194
0131-002,2018,4,4,4,72,68,140,144
0131-002,2018,4,4,5,115,122,237,140
0131-002,2018,4,4,6,278,237,515,237
0131-002,2018,4,4,7,655,475,1130,515
0131-002,2018,4,4,8,1546,992,2538,1130
0131-002,2018,4,4,9,1426,1189,2615,2538
0131-002,2018,4,4,10,1055,968,2023,2615
0131-002,2018,4,4,11,1032,974,2006,2023
0131-002,2018,4,4,12,977,942,1919,2006
0131-002,2018,4,4,13,850,855,1705,1919
0131-002,2018,4,4,14,972,1007,1979,1705
0131-002,2018,4,4,15,1109,1021,2130,1979
0131-002,2018,4,4,16,1091,1053,2144,2130
0131-002,2018,4,4,17,1030,1086,2116,2144
0131-002,2018,4,4,18,1158,1201,2359,2116
0131-002,2018,4,4,19,1107,1114,2221,2359
0131-002,2018,4,4,20,712,760,1472,2221
0131-002,2018,4,4,21,493,669,1162,1472
0131-002,2018,4,4,22,378,500,878,1162
0131-002,2018,4,4,23,318,314,632,878
0131-002,2018,4,4,24,166,210,376,632
0131-002,2018,4,5,1,130,149,279,376
0131-002,2018,4,5,2,72,117,189,279
0131-002,2018,4,5,3,48,91,139,189
0131-002,2018,4,5,4,64,70,134,139
0131-002,2018,4,5,5,106,110,216,134
0131-002,2018,4,5,6,251,222,473,216
0131-002,2018,4,5,7,661,448,1109,473
0131-002,2018,4,5,8,1435,954,2389,1109
0131-002,2018,4,5,9,1394,1202,2596,2389
0131-002,2018,4,5,10,943,981,1924,2596
0131-002,2018,4,5,11,1000,992,1992,1924
0131-002,2018,4,5,12,931,938,1869,1992
0131-002,2018,4,5,13,857,836,1693,1869
0131-002,2018,4,5,14,953,908,1861,1693
0131-002,2018,4,5,15,1033,1051,2084,1861
0131-002,2018,4,5,16,915,1068,1983,2084
0131-002,2018,4,5,17,924,1074,1998,1983
0131-002,2018,4,5,18,1036,1240,2276,1998
0131-002,2018,4,5,19,966,1111,2077,2276
0131-002,2018,4,5,20,616,791,1407,2077
0131-002,2018,4,5,21,488,706,1194,1407
0131-002,2018,4,5,22,384,482,866,1194
0131-002,2018,4,5,23,265,296,561,866
0131-002,2018,4,5,24,173,218,391,561
0131-002,2018,4,6,1,125,66,191,391
0131-002,2018,4,6,2,80,59,139,191
0131-002,2018,4,6,3,61,77,138,139
0131-002,2018,4,6,4,58,73,131,138
0131-002,2018,4,6,5,92,115,207,131
0131-002,2018,4,6,6,257,214,471,207
0131-002,2018,4,6,7,777,447,1224,471
0131-002,2018,4,6,8,1449,782,2231,1224
0131-002,2018,4,6,9,1399,1087,2486,2231
0131-002,2018,4,6,10,1007,960,1967,2486
0131-002,2018,4,6,11,1069,1081,2150,1967
0131-002,2018,4,6,12,1047,937,1984,2150
0131-002,2018,4,6,13,962,881,1843,1984
0131-002,2018,4,6,14,1052,1045,2097,1843
0131-002,2018,4,6,15,1073,1098,2171,2097
0131-002,2018,4,6,16,1097,1133,2230,2171
0131-002,2018,4,6,17,1082,1119,2201,2230
0131-002,2018,4,6,18,1221,1452,2673,2201
0131-002,2018,4,6,19,1242,1389,2631,2673
0131-002,2018,4,6,20,834,922,1756,2631
0131-002,2018,4,6,21,557,742,1299,1756
0131-002,2018,4,6,22,444,529,973,1299
0131-002,2018,4,6,23,289,337,626,973
0131-002,2018,4,6,24,179,238,417,626
0131-002,2018,4,7,1,154,203,357,417
0131-002,2018,4,7,2,112,122,234,357
0131-002,2018,4,7,3,81,103,184,234
0131-002,2018,4,7,4,66,105,171,184
0131-002,2018,4,7,5,105,135,240,171
0131-002,2018,4,7,6,247,220,467,240
0131-002,2018,4,7,7,503,387,890,467
0131-002,2018,4,7,8,822,672,1494,890
0131-002,2018,4,7,9,812,811,1623,1494
0131-002,2018,4,7,10,852,854,1706,1623
0131-002,2018,4,7,11,937,924,1861,1706
0131-002,2018,4,7,12,915,895,1810,1861
0131-002,2018,4,7,13,855,788,1643,1810
0131-002,2018,4,7,14,906,765,1671,1643
0131-002,2018,4,7,15,981,832,1813,1671
0131-002,2018,4,7,16,909,830,1739,1813
0131-002,2018,4,7,17,950,857,1807,1739
0131-002,2018,4,7,18,1002,999,2001,1807
0131-002,2018,4,7,19,869,779,1648,2001
0131-002,2018,4,7,20,607,596,1203,1648
0131-002,2018,4,7,21,516,477,993,1203
0131-002,2018,4,7,22,361,334,695,993
0131-002,2018,4,7,23,265,271,536,695
0131-002,2018,4,7,24,163,189,352,536
0131-002,2018,4,8,1,120,102,222,352
0131-002,2018,4,8,2,80,99,179,222
0131-002,2018,4,8,3,58,59,117,179
0131-002,2018,4,8,4,44,45,89,117
0131-002,2018,4,8,5,62,67,129,89
0131-002,2018,4,8,6,140,133,273,129
0131-002,2018,4,8,7,218,220,438,273
0131-002,2018,4,8,8,353,253,606,438
0131-002,2018,4,8,9,385,425,810,606
0131-002,2018,4,8,10,444,526,970,810
0131-002,2018,4,8,11,543,586,1129,970
0131-002,2018,4,8,12,604,567,1171,1129
0131-002,2018,4,8,13,616,606,1222,1171
0131-002,2018,4,8,14,677,614,1291,1222
0131-002,2018,4,8,15,764,677,1441,1291
0131-002,2018,4,8,16,751,755,1506,1441
0131-002,2018,4,8,17,770,762,1532,1506
0131-002,2018,4,8,18,794,758,1552,1532
0131-002,2018,4,8,19,661,644,1305,1552
0131-002,2018,4,8,20,580,526,1106,1305
0131-002,2018,4,8,21,472,457,929,1106
0131-002,2018,4,8,22,401,327,728,929
0131-002,2018,4,8,23,307,243,550,728
0131-002,2018,4,8,24,169,149,318,550
0131-002,2018,4,9,1,109,99,208,318
0131-002,2018,4,9,2,68,72,140,208
0131-002,2018,4,9,3,52,61,113,140
0131-002,2018,4,9,4,46,62,108,113
0131-002,2018,4,9,5,131,122,253,108
0131-002,2018,4,9,6,367,224,591,253
0131-002,2018,4,9,7,925,496,1421,591
0131-002,2018,4,9,8,1707,940,2647,1421
0131-002,2018,4,9,9,1554,1094,2648,2647
0131-002,2018,4,9,10,1040,997,2037,2648
0131-002,2018,4,9,11,1089,1034,2123,2037
0131-002,2018,4,9,12,1065,980,2045,2123
0131-002,2018,4,9,13,913,815,1728,2045
0131-002,2018,4,9,14,1082,932,2014,1728
0131-002,2018,4,9,15,1112,1049,2161,2014
0131-002,2018,4,9,16,1087,973,2060,2161
0131-002,2018,4,9,17,1087,1087,2174,2060
0131-002,2018,4,9,18,1215,1184,2399,2174
0131-002,2018,4,9,19,1092,1082,2174,2399
0131-002,2018,4,9,20,798,827,1625,2174
0131-002,2018,4,9,21,521,711,1232,1625
0131-002,2018,4,9,22,430,484,914,1232
0131-002,2018,4,9,23,284,288,572,914
0131-002,2018,4,9,24,196,165,361,572
0131-002,2018,4,10,1,135,62,197,361
0131-002,2018,4,10,2,99,28,127,197
0131-002,2018,4,10,3,55,24,79,127
0131-002,2018,4,10,4,74,18,92,79
0131-002,2018,4,10,5,130,36,166,92
0131-002,2018,4,10,6,351,86,437,166
0131-002,2018,4,10,7,911,182,1093,437
0131-002,2018,4,10,8,1691,461,2152,1093
0131-002,2018,4,10,9,1517,854,2371,2152
0131-002,2018,4,10,10,1099,1085,2184,2371
0131-002,2018,4,10,11,1083,1020,2103,2184
0131-002,2018,4,10,12,1009,962,1971,2103
0131-002,2018,4,10,13,886,805,1691,1971
0131-002,2018,4,10,14,1040,952,1992,1691
0131-002,2018,4,10,15,1190,1101,2291,1992
0131-002,2018,4,10,16,1053,970,2023,2291
0131-002,2018,4,10,17,1048,1060,2108,2023
0131-002,2018,4,10,18,1149,1272,2421,2108
0131-002,2018,4,10,19,1097,1164,2261,2421
0131-002,2018,4,10,20,759,777,1536,2261
0131-002,2018,4,10,21,570,713,1283,1536
0131-002,2018,4,10,22,434,497,931,1283
0131-002,2018,4,10,23,322,302,624,931
0131-002,2018,4,10,24,172,94,266,624
0131-002,2018,4,11,1,124,145,269,266
0131-002,2018,4,11,2,102,101,203,269
0131-002,2018,4,11,3,82,84,166,203
0131-002,2018,4,11,4,77,69,146,166
0131-002,2018,4,11,5,121,128,249,146
0131-002,2018,4,11,6,334,234,568,249
0131-002,2018,4,11,7,822,497,1319,568
0131-002,2018,4,11,8,1674,972,2646,1319
0131-002,2018,4,11,9,1494,1177,2671,2646
0131-002,2018,4,11,10,1068,963,2031,2671
0131-002,2018,4,11,11,1147,984,2131,2031
0131-002,2018,4,11,12,995,957,1952,2131
0131-002,2018,4,11,13,861,851,1712,1952
0131-002,2018,4,11,14,1109,1019,2128,1712
0131-002,2018,4,11,15,1121,1030,2151,2128
0131-002,2018,4,11,16,1091,1090,2181,2151
0131-002,2018,4,11,17,1083,1102,2185,2181
0131-002,2018,4,11,18,1204,1282,2486,2185
0131-002,2018,4,11,19,1172,1153,2325,2486
0131-002,2018,4,11,20,811,695,1506,2325
0131-002,2018,4,11,21,580,694,1274,1506
0131-002,2018,4,11,22,449,494,943,1274
0131-002,2018,4,11,23,339,320,659,943
0131-002,2018,4,11,24,249,203,452,659
0131-002,2018,4,12,1,153,154,307,452
0131-002,2018,4,12,2,97,109,206,307
0131-002,2018,4,12,3,73,78,151,206
0131-002,2018,4,12,4,85,111,196,151
0131-002,2018,4,12,5,140,150,290,196
0131-002,2018,4,12,6,329,197,526,290
0131-002,2018,4,12,7,867,366,1233,526
0131-002,2018,4,12,8,1683,913,2596,1233
0131-002,2018,4,12,9,1518,1175,2693,2596
0131-002,2018,4,12,10,1110,976,2086,2693
0131-002,2018,4,12,11,1106,948,2054,2086
0131-002,2018,4,12,12,1046,989,2035,2054
0131-002,2018,4,12,13,885,806,1691,2035
0131-002,2018,4,12,14,1061,980,2041,1691
0131-002,2018,4,12,15,1106,1082,2188,2041
0131-002,2018,4,12,16,1116,1017,2133,2188
0131-002,2018,4,12,17,1140,1074,2214,2133
0131-002,2018,4,12,18,1236,1288,2524,2214
0131-002,2018,4,12,19,1137,1100,2237,2524
0131-002,2018,4,12,20,778,824,1602,2237
0131-002,2018,4,12,21,618,689,1307,1602
0131-002,2018,4,12,22,470,514,984,1307
0131-002,2018,4,12,23,355,344,699,984
0131-002,2018,4,12,24,215,243,458,699
0131-002,2018,4,13,1,149,152,301,458
0131-002,2018,4,13,2,105,120,225,301
0131-002,2018,4,13,3,68,92,160,225
0131-002,2018,4,13,4,68,83,151,160
0131-002,2018,4,13,5,144,127,271,151
0131-002,2018,4,13,6,334,224,558,271
0131-002,2018,4,13,7,883,422,1305,558
0131-002,2018,4,13,8,1670,972,2642,1305
0131-002,2018,4,13,9,1474,812,2286,2642
0131-002,2018,4,13,10,1146,1026,2172,2286
0131-002,2018,4,13,11,1183,1093,2276,2172
0131-002,2018,4,13,12,1038,1069,2107,2276
0131-002,2018,4,13,13,963,895,1858,2107
0131-002,2018,4,13,14,1104,942,2046,1858
0131-002,2018,4,13,15,1184,1017,2201,2046
0131-002,2018,4,13,16,1119,1104,2223,2201
0131-002,2018,4,13,17,1135,1140,2275,2223
0131-002,2018,4,13,18,1325,1537,2862,2275
0131-002,2018,4,13,19,1405,1223,2628,2862
0131-002,2018,4,13,20,876,652,1528,2628
0131-002,2018,4,13,21,639,571,1210,1528
0131-002,2018,4,13,22,496,473,969,1210
0131-002,2018,4,13,23,302,279,581,969
0131-002,2018,4,13,24,242,255,497,581
0131-002,2018,4,14,1,145,192,337,497
0131-002,2018,4,14,2,123,127,250,337
0131-002,2018,4,14,3,109,110,219,250
0131-002,2018,4,14,4,72,105,177,219
0131-002,2018,4,14,5,97,130,227,177
0131-002,2018,4,14,6,199,203,402,227
0131-002,2018,4,14,7,408,370,778,402
0131-002,2018,4,14,8,660,596,1256,778
0131-002,2018,4,14,9,746,751,1497,1256
0131-002,2018,4,14,10,731,788,1519,1497
0131-002,2018,4,14,11,856,840,1696,1519
0131-002,2018,4,14,12,892,806,1698,1696
0131-002,2018,4,14,13,811,746,1557,1698
0131-002,2018,4,14,14,816,720,1536,1557
0131-002,2018,4,14,15,851,777,1628,1536
0131-002,2018,4,14,16,806,771,1577,1628
0131-002,2018,4,14,17,816,814,1630,1577
0131-002,2018,4,14,18,896,968,1864,1630
0131-002,2018,4,14,19,820,723,1543,1864
0131-002,2018,4,14,20,561,586,1147,1543
0131-002,2018,4,14,21,401,450,851,1147
0131-002,2018,4,14,22,332,340,672,851
0131-002,2018,4,14,23,231,242,473,672
0131-002,2018,4,14,24,164,164,328,473
0131-002,2018,4,15,1,122,135,257,328
0131-002,2018,4,15,2,73,102,175,257
0131-002,2018,4,15,3,61,54,115,175
0131-002,2018,4,15,4,48,39,87,115
0131-002,2018,4,15,5,65,68,133,87
0131-002,2018,4,15,6,129,129,258,133
0131-002,2018,4,15,7,236,241,477,258
0131-002,2018,4,15,8,388,368,756,477
0131-002,2018,4,15,9,395,482,877,756
0131-002,2018,4,15,10,517,485,1002,877
0131-002,2018,4,15,11,620,558,1178,1002
0131-002,2018,4,15,12,665,558,1223,1178
0131-002,2018,4,15,13,671,587,1258,1223
0131-002,2018,4,15,14,746,604,1350,1258
0131-002,2018,4,15,15,812,648,1460,1350
0131-002,2018,4,15,16,821,688,1509,1460
0131-002,2018,4,15,17,922,736,1658,1509
0131-002,2018,4,15,18,904,710,1614,1658
0131-002,2018,4,15,19,851,610,1461,1614
0131-002,2018,4,15,20,658,510,1168,1461
0131-002,2018,4,15,21,527,430,957,1168
0131-002,2018,4,15,22,457,314,771,957
0131-002,2018,4,15,23,330,224,554,771
0131-002,2018,4,15,24,213,134,347,554
0131-002,2018,7,1,1,141,135,276,347
0131-002,2018,7,1,2,107,124,231,276
0131-002,2018,7,1,3,74,87,161,231
0131-002,2018,7,1,4,59,53,112,161
0131-002,2018,7,1,5,62,72,134,112
0131-002,2018,7,1,6,99,87,186,134
0131-002,2018,7,1,7,163,162,325,186
0131-002,2018,7,1,8,249,222,471,325
0131-002,2018,7,1,9,284,320,604,471
0131-002,2018,7,1,10,347,428,775,604
0131-002,2018,7,1,11,432,521,953,775
0131-002,2018,7,1,12,462,469,931,953
0131-002,2018,7,1,13,566,476,1042,931
0131-002,2018,7,1,14,557,520,1077,1042
0131-002,2018,7,1,15,652,685,1337,1077
0131-002,2018,7,1,16,649,553,1202,1337
0131-002,2018,7,1,17,636,503,1139,1202
0131-002,2018,7,1,18,728,527,1255,1139
0131-002,2018,7,1,19,696,433,1129,1255
0131-002,2018,7,1,20,538,351,889,1129
0131-002,2018,7,1,21,444,328,772,889
0131-002,2018,7,1,22,347,283,630,772
0131-002,2018,7,1,23,238,196,434,630
0131-002,2018,7,1,24,144,138,282,434
0131-002,2018,7,2,1,106,120,226,282
0131-002,2018,7,2,2,75,78,153,226
0131-002,2018,7,2,3,40,72,112,153
0131-002,2018,7,2,4,43,62,105,112
0131-002,2018,7,2,5,86,124,210,105
0131-002,2018,7,2,6,323,233,556,210
0131-002,2018,7,2,7,786,582,1368,556
0131-002,2018,7,2,8,1721,1222,2943,1368
0131-002,2018,7,2,9,1399,768,2167,2943
0131-002,2018,7,2,10,947,751,1698,2167
0131-002,2018,7,2,11,1046,727,1773,1698
0131-002,2018,7,2,12,1007,1014,2021,1773
0131-002,2018,7,2,13,841,866,1707,2021
0131-002,2018,7,2,14,967,842,1809,1707
0131-002,2018,7,2,15,1043,1168,2211,1809
0131-002,2018,7,2,16,995,1206,2201,2211
0131-002,2018,7,2,17,936,1242,2178,2201
0131-002,2018,7,2,18,1056,1483,2539,2178
0131-002,2018,7,2,19,1007,1275,2282,2539
0131-002,2018,7,2,20,672,901,1573,2282
0131-002,2018,7,2,21,490,824,1314,1573
0131-002,2018,7,2,22,375,541,916,1314
0131-002,2018,7,2,23,259,407,666,916
0131-002,2018,7,2,24,179,254,433,666
0131-002,2018,7,3,1,122,166,288,433
0131-002,2018,7,3,2,93,89,182,288
0131-002,2018,7,3,3,53,97,150,182
0131-002,2018,7,3,4,83,103,186,150
0131-002,2018,7,3,5,117,151,268,186
0131-002,2018,7,3,6,384,310,694,268
0131-002,2018,7,3,7,821,623,1444,694
0131-002,2018,7,3,8,1633,1142,2775,1444
0131-002,2018,7,3,9,1384,1243,2627,2775
0131-002,2018,7,3,10,986,1071,2057,2627
0131-002,2018,7,3,11,1067,931,1998,2057
0131-002,2018,7,3,12,969,873,1842,1998
0131-002,2018,7,3,13,805,728,1533,1842
0131-002,2018,7,3,14,963,805,1768,1533
0131-002,2018,7,3,15,1132,887,2019,1768
0131-002,2018,7,3,16,1077,824,1901,2019
0131-002,2018,7,3,17,945,853,1798,1901
0131-002,2018,7,3,18,1150,922,2072,1798
0131-002,2018,7,3,19,1085,838,1923,2072
0131-002,2018,7,3,20,715,711,1426,1923
0131-002,2018,7,3,21,589,656,1245,1426
0131-002,2018,7,3,22,493,439,932,1245
0131-002,2018,7,3,23,299,318,617,932
0131-002,2018,7,3,24,211,168,379,617
0131-002,2018,7,4,1,136,135,271,379
0131-002,2018,7,4,2,95,71,166,271
0131-002,2018,7,4,3,72,74,146,166
0131-002,2018,7,4,4,81,79,160,146
0131-002,2018,7,4,5,129,120,249,160
0131-002,2018,7,4,6,389,245,634,249
0131-002,2018,7,4,7,835,447,1282,634
0131-002,2018,7,4,8,1598,739,2337,1282
0131-002,2018,7,4,9,1461,1072,2533,2337
0131-002,2018,7,4,10,1043,1136,2179,2533
0131-002,2018,7,4,11,1074,1048,2122,2179
0131-002,2018,7,4,12,990,849,1839,2122
0131-002,2018,7,4,13,892,795,1687,1839
0131-002,2018,7,4,14,992,785,1777,1687
0131-002,2018,7,4,15,1089,898,1987,1777
0131-002,2018,7,4,16,1039,880,1919,1987
0131-002,2018,7,4,17,1048,942,1990,1919
0131-002,2018,7,4,18,1158,1104,2262,1990
0131-002,2018,7,4,19,1210,885,2095,2262
0131-002,2018,7,4,20,776,625,1401,2095
0131-002,2018,7,4,21,536,603,1139,1401
0131-002,2018,7,4,22,464,619,1083,1139
0131-002,2018,7,4,23,323,437,760,1083
0131-002,2018,7,4,24,207,240,447,760
0131-002,2018,7,5,1,121,200,321,447
0131-002,2018,7,5,2,107,152,259,321
0131-002,2018,7,5,3,79,112,191,259
0131-002,2018,7,5,4,82,117,199,191
0131-002,2018,7,5,5,109,176,285,199
0131-002,2018,7,5,6,391,315,706,285
0131-002,2018,7,5,7,842,680,1522,706
0131-002,2018,7,5,8,1637,1189,2826,1522
0131-002,2018,7,5,9,1354,1379,2733,2826
0131-002,2018,7,5,10,1019,1166,2185,2733
0131-002,2018,7,5,11,999,1254,2253,2185
0131-002,2018,7,5,12,940,1156,2096,2253
0131-002,2018,7,5,13,905,975,1880,2096
0131-002,2018,7,5,14,962,1015,1977,1880
0131-002,2018,7,5,15,1105,1241,2346,1977
0131-002,2018,7,5,16,1104,1162,2266,2346
0131-002,2018,7,5,17,979,1223,2202,2266
0131-002,2018,7,5,18,1171,1356,2527,2202
0131-002,2018,7,5,19,1135,1291,2426,2527
0131-002,2018,7,5,20,726,971,1697,2426
0131-002,2018,7,5,21,561,988,1549,1697
0131-002,2018,7,5,22,470,625,1095,1549
0131-002,2018,7,5,23,288,421,709,1095
0131-002,2018,7,5,24,186,263,449,709
0131-002,2018,7,6,1,146,181,327,449
0131-002,2018,7,6,2,93,156,249,327
0131-002,2018,7,6,3,90,87,177,249
0131-002,2018,7,6,4,81,141,222,177
0131-002,2018,7,6,5,122,136,258,222
0131-002,2018,7,6,6,414,346,760,258
0131-002,2018,7,6,7,847,605,1452,760
0131-002,2018,7,6,8,1555,974,2529,1452
0131-002,2018,7,6,9,1439,1084,2523,2529
0131-002,2018,7,6,10,1051,1064,2115,2523
0131-002,2018,7,6,11,1012,934,1946,2115
0131-002,2018,7,6,12,1018,801,1819,1946
0131-002,2018,7,6,13,858,756,1614,1819
0131-002,2018,7,6,14,1077,781,1858,1614
0131-002,2018,7,6,15,1103,787,1890,1858
0131-002,2018,7,6,16,1075,853,1928,1890
0131-002,2018,7,6,17,1106,882,1988,1928
0131-002,2018,7,6,18,1297,1024,2321,1988
0131-002,2018,7,6,19,1421,883,2304,2321
0131-002,2018,7,6,20,889,757,1646,2304
0131-002,2018,7,6,21,636,660,1296,1646
0131-002,2018,7,6,22,549,461,1010,1296
0131-002,2018,7,6,23,338,327,665,1010
0131-002,2018,7,6,24,222,251,473,665
0131-002,2018,7,7,1,181,190,371,473
0131-002,2018,7,7,2,133,161,294,371
0131-002,2018,7,7,3,88,147,235,294
0131-002,2018,7,7,4,85,108,193,235
0131-002,2018,7,7,5,110,174,284,193
0131-002,2018,7,7,6,348,311,659,284
0131-002,2018,7,7,7,576,549,1125,659
0131-002,2018,7,7,8,792,729,1521,1125
0131-002,2018,7,7,9,814,910,1724,1521
0131-002,2018,7,7,10,826,929,1755,1724
0131-002,2018,7,7,11,899,1047,1946,1755
0131-002,2018,7,7,12,941,1012,1953,1946
0131-002,2018,7,7,13,866,1059,1925,1953
0131-002,2018,7,7,14,894,1000,1894,1925
0131-002,2018,7,7,15,858,970,1828,1894
0131-002,2018,7,7,16,927,850,1777,1828
0131-002,2018,7,7,17,909,797,1706,1777
0131-002,2018,7,7,18,990,1044,2034,1706
0131-002,2018,7,7,19,882,712,1594,2034
0131-002,2018,7,7,20,665,562,1227,1594
0131-002,2018,7,7,21,565,493,1058,1227
0131-002,2018,7,7,22,498,412,910,1058
0131-002,2018,7,7,23,332,405,737,910
0131-002,2018,7,7,24,207,287,494,737
0131-002,2018,7,8,1,153,186,339,494
0131-002,2018,7,8,2,122,144,266,339
0131-002,2018,7,8,3,94,116,210,266
0131-002,2018,7,8,4,78,104,182,210
0131-002,2018,7,8,5,63,124,187,182
0131-002,2018,7,8,6,185,196,381,187
0131-002,2018,7,8,7,301,320,621,381
0131-002,2018,7,8,8,327,390,717,621
0131-002,2018,7,8,9,343,517,860,717
0131-002,2018,7,8,10,431,621,1052,860
0131-002,2018,7,8,11,560,691,1251,1052
0131-002,2018,7,8,12,584,708,1292,1251
0131-002,2018,7,8,13,602,729,1331,1292
0131-002,2018,7,8,14,665,783,1448,1331
0131-002,2018,7,8,15,729,801,1530,1448
0131-002,2018,7,8,16,803,868,1671,1530
0131-002,2018,7,8,17,766,860,1626,1671
0131-002,2018,7,8,18,890,911,1801,1626
0131-002,2018,7,8,19,850,765,1615,1801
0131-002,2018,7,8,20,676,686,1362,1615
0131-002,2018,7,8,21,598,565,1163,1362
0131-002,2018,7,8,22,470,528,998,1163
0131-002,2018,7,8,23,336,362,698,998
0131-002,2018,7,8,24,242,237,479,698
0131-002,2018,7,9,1,142,156,298,479
0131-002,2018,7,9,2,84,88,172,298
0131-002,2018,7,9,3,73,67,140,172
0131-002,2018,7,9,4,46,80,126,140
0131-002,2018,7,9,5,139,140,279,126
0131-002,2018,7,9,6,433,324,757,279
0131-002,2018,7,9,7,891,704,1595,757
0131-002,2018,7,9,8,1688,1420,3108,1595
0131-002,2018,7,9,9,1465,1273,2738,3108
0131-002,2018,7,9,10,1015,1053,2068,2738
0131-002,2018,7,9,11,1006,1057,2063,2068
0131-002,2018,7,9,12,927,949,1876,2063
0131-002,2018,7,9,13,798,795,1593,1876
0131-002,2018,7,9,14,948,789,1737,1593
0131-002,2018,7,9,15,1035,865,1900,1737
0131-002,2018,7,9,16,978,767,1745,1900
0131-002,2018,7,9,17,937,780,1717,1745
0131-002,2018,7,9,18,1028,853,1881,1717
0131-002,2018,7,9,19,1076,785,1861,1881
0131-002,2018,7,9,20,676,648,1324,1861
0131-002,2018,7,9,21,467,546,1013,1324
0131-002,2018,7,9,22,372,420,792,1013
0131-002,2018,7,9,23,262,320,582,792
0131-002,2018,7,9,24,159,174,333,582
0131-002,2018,7,10,1,124,132,256,333
0131-002,2018,7,10,2,79,99,178,256
0131-002,2018,7,10,3,58,83,141,178
0131-002,2018,7,10,4,85,108,193,141
0131-002,2018,7,10,5,122,111,233,193
0131-002,2018,7,10,6,382,237,619,233
0131-002,2018,7,10,7,845,433,1278,619
0131-002,2018,7,10,8,1602,776,2378,1278
0131-002,2018,7,10,9,1393,899,2292,2378
0131-002,2018,7,10,10,1086,848,1934,2292
0131-002,2018,7,10,11,1073,856,1929,1934
0131-002,2018,7,10,12,1030,826,1856,1929
0131-002,2018,7,10,13,893,752,1645,1856
0131-002,2018,7,10,14,1032,801,1833,1645
0131-002,2018,7,10,15,1103,941,2044,1833
0131-002,2018,7,10,16,1082,969,2051,2044
0131-002,2018,7,10,17,939,906,1845,2051
0131-002,2018,7,10,18,1215,931,2146,1845
0131-002,2018,7,10,19,1094,883,1977,2146
0131-002,2018,7,10,20,786,670,1456,1977
0131-002,2018,7,10,21,576,586,1162,1456
0131-002,2018,7,10,22,460,428,888,1162
0131-002,2018,7,10,23,304,311,615,888
0131-002,2018,7,10,24,212,186,398,615
0131-002,2018,7,11,1,119,140,259,398
0131-002,2018,7,11,2,107,92,199,259
0131-002,2018,7,11,3,75,72,147,199
0131-002,2018,7,11,4,74,80,154,147
0131-002,2018,7,11,5,131,121,252,154
0131-002,2018,7,11,6,383,228,611,252
0131-002,2018,7,11,7,846,431,1277,611
0131-002,2018,7,11,8,1545,698,2243,1277
0131-002,2018,7,11,9,1431,869,2300,2243
0131-002,2018,7,11,10,1038,791,1829,2300
0131-002,2018,7,11,11,1123,861,1984,1829
0131-002,2018,7,11,12,959,880,1839,1984
0131-002,2018,7,11,13,880,822,1702,1839
0131-002,2018,7,11,14,971,853,1824,1702
0131-002,2018,7,11,15,1010,934,1944,1824
0131-002,2018,7,11,16,1088,836,1924,1944
0131-002,2018,7,11,17,993,902,1895,1924
0131-002,2018,7,11,18,1132,1031,2163,1895
0131-002,2018,7,11,19,1173,886,2059,2163
0131-002,2018,7,11,20,784,637,1421,2059
0131-002,2018,7,11,21,557,549,1106,1421
0131-002,2018,7,11,22,466,529,995,1106
0131-002,2018,7,11,23,312,421,733,995
0131-002,2018,7,11,24,208,279,487,733
0131-002,2018,7,12,1,162,176,338,487
0131-002,2018,7,12,2,109,117,226,338
0131-002,2018,7,12,3,71,109,180,226
0131-002,2018,7,12,4,75,100,175,180
0131-002,2018,7,12,5,124,160,284,175
0131-002,2018,7,12,6,410,340,750,284
0131-002,2018,7,12,7,900,687,1587,750
0131-002,2018,7,12,8,1567,1153,2720,1587
0131-002,2018,7,12,9,1465,1412,2877,2720
0131-002,2018,7,12,10,1106,1088,2194,2877
0131-002,2018,7,12,11,1013,1310,2323,2194
0131-002,2018,7,12,12,1004,1223,2227,2323
0131-002,2018,7,12,13,783,1072,1855,2227
0131-002,2018,7,12,14,983,1027,2010,1855
0131-002,2018,7,12,15,1089,962,2051,2010
0131-002,2018,7,12,16,1069,836,1905,2051
0131-002,2018,7,12,17,1008,856,1864,1905
0131-002,2018,7,12,18,1164,1008,2172,1864
0131-002,2018,7,12,19,1125,902,2027,2172
0131-002,2018,7,12,20,782,683,1465,2027
0131-002,2018,7,12,21,637,813,1450,1465
0131-002,2018,7,12,22,516,643,1159,1450
0131-002,2018,7,12,23,366,441,807,1159
0131-002,2018,7,12,24,241,307,548,807
0131-002,2018,7,13,1,165,156,321,548
0131-002,2018,7,13,2,103,94,197,321
0131-002,2018,7,13,3,74,88,162,197
0131-002,2018,7,13,4,86,81,167,162
0131-002,2018,7,13,5,146,121,267,167
0131-002,2018,7,13,6,383,279,662,267
0131-002,2018,7,13,7,909,502,1411,662
0131-002,2018,7,13,8,1605,939,2544,1411
0131-002,2018,7,13,9,1443,1071,2514,2544
0131-002,2018,7,13,10,1105,1003,2108,2514
0131-002,2018,7,13,11,1050,994,2044,2108
0131-002,2018,7,13,12,1018,941,1959,2044
0131-002,2018,7,13,13,898,898,1796,1959
0131-002,2018,7,13,14,992,929,1921,1796
0131-002,2018,7,13,15,1071,947,2018,1921
0131-002,2018,7,13,16,1094,979,2073,2018
0131-002,2018,7,13,17,1144,967,2111,2073
0131-002,2018,7,13,18,1336,1351,2687,2111
0131-002,2018,7,13,19,1277,1243,2520,2687
0131-002,2018,7,13,20,931,883,1814,2520
0131-002,2018,7,13,21,693,751,1444,1814
0131-002,2018,7,13,22,599,493,1092,1444
0131-002,2018,7,13,23,358,355,713,1092
0131-002,2018,7,13,24,249,266,515,713
0131-002,2018,7,14,1,185,172,357,515
0131-002,2018,7,14,2,143,119,262,357
0131-002,2018,7,14,3,84,105,189,262
0131-002,2018,7,14,4,91,90,181,189
0131-002,2018,7,14,5,124,131,255,181
0131-002,2018,7,14,6,357,236,593,255
0131-002,2018,7,14,7,534,439,973,593
0131-002,2018,7,14,8,799,590,1389,973
0131-002,2018,7,14,9,885,746,1631,1389
0131-002,2018,7,14,10,902,788,1690,1631
0131-002,2018,7,14,11,970,781,1751,1690
0131-002,2018,7,14,12,968,816,1784,1751
0131-002,2018,7,14,13,807,800,1607,1784
0131-002,2018,7,14,14,927,770,1697,1607
0131-002,2018,7,14,15,894,790,1684,1697
0131-002,2018,7,14,16,917,790,1707,1684
0131-002,2018,7,14,17,917,803,1720,1707
0131-002,2018,7,14,18,991,953,1944,1720
0131-002,2018,7,14,19,902,720,1622,1944
0131-002,2018,7,14,20,627,518,1145,1622
0131-002,2018,7,14,21,596,457,1053,1145
0131-002,2018,7,14,22,494,389,883,1053
0131-002,2018,7,14,23,375,309,684,883
0131-002,2018,7,14,24,219,208,427,684
0131-002,2018,7,15,1,165,164,329,427
0131-002,2018,7,15,2,109,136,245,329
0131-002,2018,7,15,3,88,83,171,245
0131-002,2018,7,15,4,83,59,142,171
0131-002,2018,7,15,5,76,80,156,142
0131-002,2018,7,15,6,186,148,334,156
0131-002,2018,7,15,7,274,236,510,334
0131-002,2018,7,15,8,350,299,649,510
0131-002,2018,7,15,9,355,453,808,649
0131-002,2018,7,15,10,492,522,1014,808
0131-002,2018,7,15,11,539,578,1117,1014
0131-002,2018,7,15,12,612,609,1221,1117
0131-002,2018,7,15,13,620,585,1205,1221
0131-002,2018,7,15,14,719,608,1327,1205
0131-002,2018,7,15,15,727,639,1366,1327
0131-002,2018,7,15,16,790,671,1461,1366
0131-002,2018,7,15,17,817,653,1470,1461
0131-002,2018,7,15,18,855,662,1517,1470
0131-002,2018,7,15,19,852,564,1416,1517
0131-002,2018,7,15,20,652,478,1130,1416
0131-002,2018,7,15,21,575,433,1008,1130
0131-002,2018,7,15,22,483,360,843,1008
0131-002,2018,7,15,23,360,258,618,843
0131-002,2018,7,15,24,244,157,401,618
0131-002,2018,7,16,1,130,93,223,401
0131-002,2018,7,16,2,83,75,158,223
0131-002,2018,7,16,3,73,66,139,158
0131-002,2018,7,16,4,74,79,153,139
0131-002,2018,7,16,5,133,104,237,153
0131-002,2018,7,16,6,507,286,793,237
0131-002,2018,7,16,7,1021,553,1574,793
0131-002,2018,7,16,8,1790,897,2687,1574
0131-002,2018,7,16,9,1482,1011,2493,2687
0131-002,2018,7,16,10,1007,938,1945,2493
0131-002,2018,7,16,11,1053,972,2025,1945
0131-002,2018,7,16,12,981,976,1957,2025
0131-002,2018,7,16,13,887,791,1678,1957
0131-002,2018,7,16,14,971,839,1810,1678
0131-002,2018,7,16,15,1076,1007,2083,1810
0131-002,2018,7,16,16,1111,868,1979,2083
0131-002,2018,7,16,17,1026,995,2021,1979
0131-002,2018,7,16,18,1185,1254,2439,2021
0131-002,2018,7,16,19,1098,973,2071,2439
0131-002,2018,7,16,20,783,719,1502,2071
0131-002,2018,7,16,21,614,674,1288,1502
0131-002,2018,7,16,22,454,461,915,1288
0131-002,2018,7,16,23,312,293,605,915
0131-002,2018,7,16,24,166,205,371,605
0131-002,2018,7,17,1,127,136,263,371
0131-002,2018,7,17,2,98,107,205,263
0131-002,2018,7,17,3,74,82,156,205
0131-002,2018,7,17,4,80,105,185,156
0131-002,2018,7,17,5,131,118,249,185
0131-002,2018,7,17,6,419,263,682,249
0131-002,2018,7,17,7,895,515,1410,682
0131-002,2018,7,17,8,1609,934,2543,1410
0131-002,2018,7,17,9,1490,1201,2691,2543
0131-002,2018,7,17,10,1074,1009,2083,2691
0131-002,2018,7,17,11,1092,955,2047,2083
0131-002,2018,7,17,12,979,845,1824,2047
0131-002,2018,7,17,13,878,784,1662,1824
0131-002,2018,7,17,14,1002,889,1891,1662
0131-002,2018,7,17,15,1054,1023,2077,1891
0131-002,2018,7,17,16,1119,965,2084,2077
0131-002,2018,7,17,17,1034,988,2022,2084
0131-002,2018,7,17,18,1160,1228,2388,2022
0131-002,2018,7,17,19,1155,971,2126,2388
0131-002,2018,7,17,20,737,687,1424,2126
0131-002,2018,7,17,21,585,687,1272,1424
0131-002,2018,7,17,22,459,473,932,1272
0131-002,2018,7,17,23,322,289,611,932
0131-002,2018,7,17,24,213,226,439,611
0131-002,2018,7,18,1,169,144,313,439
0131-002,2018,7,18,2,98,99,197,313
0131-002,2018,7,18,3,52,77,129,197
0131-002,2018,7,18,4,84,115,199,129
0131-002,2018,7,18,5,129,146,275,199
0131-002,2018,7,18,6,439,264,703,275
0131-002,2018,7,18,7,874,534,1408,703
0131-002,2018,7,18,8,1630,877,2507,1408
0131-002,2018,7,18,9,1508,1113,2621,2507
0131-002,2018,7,18,10,1033,958,1991,2621
0131-002,2018,7,18,11,1140,904,2044,1991
0131-002,2018,7,18,12,967,916,1883,2044
0131-002,2018,7,18,13,876,803,1679,1883
0131-002,2018,7,18,14,994,895,1889,1679
0131-002,2018,7,18,15,1029,1004,2033,1889
0131-002,2018,7,18,16,1081,1010,2091,2033
0131-002,2018,7,18,17,1013,989,2002,2091
0131-002,2018,7,18,18,1198,1282,2480,2002
0131-002,2018,7,18,19,1151,1048,2199,2480
0131-002,2018,7,18,20,736,701,1437,2199
0131-002,2018,7,18,21,568,564,1132,1437
0131-002,2018,7,18,22,436,431,867,1132
0131-002,2018,7,18,23,354,312,666,867
0131-002,2018,7,18,24,216,210,426,666
0131-002,2018,7,19,1,144,144,288,426
0131-002,2018,7,19,2,107,100,207,288
0131-002,2018,7,19,3,64,83,147,207
0131-002,2018,7,19,4,74,85,159,147
0131-002,2018,7,19,5,148,119,267,159
0131-002,2018,7,19,6,429,263,692,267
0131-002,2018,7,19,7,841,493,1334,692
0131-002,2018,7,19,8,1651,931,2582,1334
0131-002,2018,7,19,9,1483,1067,2550,2582
0131-002,2018,7,19,10,1096,938,2034,2550
0131-002,2018,7,19,11,1049,940,1989,2034
0131-002,2018,7,19,12,1048,908,1956,1989
0131-002,2018,7,19,13,929,817,1746,1956
0131-002,2018,7,19,14,1053,857,1910,1746
0131-002,2018,7,19,15,1096,1019,2115,1910
0131-002,2018,7,19,16,1043,970,2013,2115
0131-002,2018,7,19,17,1011,1003,2014,2013
0131-002,2018,7,19,18,1265,1206,2471,2014
0131-002,2018,7,19,19,1166,1050,2216,2471
0131-002,2018,7,19,20,766,726,1492,2216
0131-002,2018,7,19,21,594,747,1341,1492
0131-002,2018,7,19,22,477,487,964,1341
0131-002,2018,7,19,23,367,294,661,964
0131-002,2018,7,19,24,239,184,423,661
0131-002,2018,7,20,1,172,153,325,423
0131-002,2018,7,20,2,109,112,221,325
0131-002,2018,7,20,3,77,84,161,221
0131-002,2018,7,20,4,93,86,179,161
0131-002,2018,7,20,5,132,126,258,179
0131-002,2018,7,20,6,473,286,759,258
0131-002,2018,7,20,7,885,515,1400,759
0131-002,2018,7,20,8,1666,915,2581,1400
0131-002,2018,7,20,9,1412,1076,2488,2581
0131-002,2018,7,20,10,1092,957,2049,2488
0131-002,2018,7,20,11,1144,978,2122,2049
0131-002,2018,7,20,12,952,940,1892,2122
0131-002,2018,7,20,13,922,927,1849,1892
0131-002,2018,7,20,14,1033,927,1960,1849
0131-002,2018,7,20,15,1123,1033,2156,1960
0131-002,2018,7,20,16,1083,1014,2097,2156
0131-002,2018,7,20,17,1186,960,2146,2097
0131-002,2018,7,20,18,1251,1398,2649,2146
0131-002,2018,7,20,19,1481,1275,2756,2649
0131-002,2018,7,20,20,907,825,1732,2756
0131-002,2018,7,20,21,687,757,1444,1732
0131-002,2018,7,20,22,603,508,1111,1444
0131-002,2018,7,20,23,371,330,701,1111
0131-002,2018,7,20,24,309,264,573,701
0131-002,2018,7,21,1,193,191,384,573
0131-002,2018,7,21,2,117,130,247,384
0131-002,2018,7,21,3,98,89,187,247
0131-002,2018,7,21,4,87,106,193,187
0131-002,2018,7,21,5,136,148,284,193
0131-002,2018,7,21,6,358,252,610,284
0131-002,2018,7,21,7,626,438,1064,610
0131-002,2018,7,21,8,796,605,1401,1064
0131-002,2018,7,21,9,899,737,1636,1401
0131-002,2018,7,21,10,878,749,1627,1636
0131-002,2018,7,21,11,871,826,1697,1627
0131-002,2018,7,21,12,859,828,1687,1697
0131-002,2018,7,21,13,807,740,1547,1687
0131-002,2018,7,21,14,769,748,1517,1547
0131-002,2018,7,21,15,815,723,1538,1517
0131-002,2018,7,21,16,863,756,1619,1538
0131-002,2018,7,21,17,918,799,1717,1619
0131-002,2018,7,21,18,943,848,1791,1717
0131-002,2018,7,21,19,874,742,1616,1791
0131-002,2018,7,21,20,688,553,1241,1616
0131-002,2018,7,21,21,565,485,1050,1241
0131-002,2018,7,21,22,512,398,910,1050
0131-002,2018,7,21,23,330,266,596,910
0131-002,2018,7,21,24,236,224,460,596
0131-002,2018,7,22,1,153,155,308,460
0131-002,2018,7,22,2,142,104,246,308
0131-002,2018,7,22,3,80,98,178,246
0131-002,2018,7,22,4,71,88,159,178
0131-002,2018,7,22,5,79,103,182,159
0131-002,2018,7,22,6,187,159,346,182
0131-002,2018,7,22,7,320,239,559,346
0131-002,2018,7,22,8,355,326,681,559
0131-002,2018,7,22,9,346,416,762,681
0131-002,2018,7,22,10,477,500,977,762
0131-002,2018,7,22,11,539,567,1106,977
0131-002,2018,7,22,12,585,573,1158,1106
0131-002,2018,7,22,13,603,560,1163,1158
0131-002,2018,7,22,14,672,596,1268,1163
0131-002,2018,7,22,15,719,607,1326,1268
0131-002,2018,7,22,16,725,631,1356,1326
0131-002,2018,7,22,17,833,601,1434,1356
0131-002,2018,7,22,18,763,601,1364,1434
0131-002,2018,7,22,19,777,542,1319,1364
0131-002,2018,7,22,20,587,465,1052,1319
0131-002,2018,7,22,21,571,441,1012,1052
0131-002,2018,7,22,22,446,327,773,1012
0131-002,2018,7,22,23,332,253,585,773
0131-002,2018,7,22,24,223,183,406,585
0131-002,2018,7,23,1,158,117,275,406
0131-002,2018,7,23,2,100,62,162,275
0131-002,2018,7,23,3,63,62,125,162
0131-002,2018,7,23,4,67,76,143,125
0131-002,2018,7,23,5,146,134,280,143
0131-002,2018,7,23,6,485,270,755,280
0131-002,2018,7,23,7,1067,547,1614,755
0131-002,2018,7,23,8,1786,950,2736,1614
0131-002,2018,7,23,9,1525,1034,2559,2736
0131-002,2018,7,23,10,1011,896,1907,2559
0131-002,2018,7,23,11,1083,997,2080,1907
0131-002,2018,7,23,12,998,941,1939,2080
0131-002,2018,7,23,13,950,832,1782,1939
0131-002,2018,7,23,14,1013,945,1958,1782
0131-002,2018,7,23,15,1084,1028,2112,1958
0131-002,2018,7,23,16,1146,1029,2175,2112
0131-002,2018,7,23,17,1072,999,2071,2175
0131-002,2018,7,23,18,1191,1156,2347,2071
0131-002,2018,7,23,19,1183,1059,2242,2347
0131-002,2018,7,23,20,766,787,1553,2242
0131-002,2018,7,23,21,634,695,1329,1553
0131-002,2018,7,23,22,452,460,912,1329
0131-002,2018,7,23,23,329,294,623,912
0131-002,2018,7,23,24,199,189,388,623
0131-002,2018,7,24,1,138,125,263,388
0131-002,2018,7,24,2,109,90,199,263
0131-002,2018,7,24,3,77,89,166,199
0131-002,2018,7,24,4,96,93,189,166
0131-002,2018,7,24,5,151,128,279,189
0131-002,2018,7,24,6,443,249,692,279
0131-002,2018,7,24,7,915,512,1427,692
0131-002,2018,7,24,8,1658,969,2627,1427
0131-002,2018,7,24,9,1370,1078,2448,2627
0131-002,2018,7,24,10,1118,1017,2135,2448
0131-002,2018,7,24,11,1061,1002,2063,2135
0131-002,2018,7,24,12,1001,963,1964,2063
0131-002,2018,7,24,13,901,896,1797,1964
0131-002,2018,7,24,14,1049,860,1909,1797
0131-002,2018,7,24,15,1066,1013,2079,1909
0131-002,2018,7,24,16,1049,995,2044,2079
0131-002,2018,7,24,17,1044,942,1986,2044
0131-002,2018,7,24,18,1210,1138,2348,1986
0131-002,2018,7,24,19,1173,1018,2191,2348
0131-002,2018,7,24,20,816,757,1573,2191
0131-002,2018,7,24,21,629,699,1328,1573
0131-002,2018,7,24,22,478,488,966,1328
0131-002,2018,7,24,23,318,280,598,966
0131-002,2018,7,24,24,219,202,421,598
0131-002,2018,7,25,1,139,135,274,421
0131-002,2018,7,25,2,93,95,188,274
0131-002,2018,7,25,3,62,82,144,188
0131-002,2018,7,25,4,84,93,177,144
0131-002,2018,7,25,5,151,149,300,177
0131-002,2018,7,25,6,434,270,704,300
0131-002,2018,7,25,7,853,527,1380,704
0131-002,2018,7,25,8,1617,937,2554,1380
0131-002,2018,7,25,9,1443,1066,2509,2554
0131-002,2018,7,25,10,1117,953,2070,2509
0131-002,2018,7,25,11,1054,1002,2056,2070
0131-002,2018,7,25,12,1082,919,2001,2056
0131-002,2018,7,25,13,914,841,1755,2001
0131-002,2018,7,25,14,1062,957,2019,1755
0131-002,2018,7,25,15,1076,996,2072,2019
0131-002,2018,7,25,16,1095,966,2061,2072
0131-002,2018,7,25,17,1033,986,2019,2061
0131-002,2018,7,25,18,1233,1269,2502,2019
0131-002,2018,7,25,19,1188,1044,2232,2502
0131-002,2018,7,25,20,762,681,1443,2232
0131-002,2018,7,25,21,574,610,1184,1443
0131-002,2018,7,25,22,459,506,965,1184
0131-002,2018,7,25,23,338,321,659,965
0131-002,2018,7,25,24,226,243,469,659
0131-002,2018,7,26,1,137,155,292,469
0131-002,2018,7,26,2,97,88,185,292
0131-002,2018,7,26,3,75,79,154,185
0131-002,2018,7,26,4,103,92,195,154
0131-002,2018,7,26,5,159,142,301,195
0131-002,2018,7,26,6,410,267,677,301
0131-002,2018,7,26,7,845,530,1375,677
0131-002,2018,7,26,8,1606,930,2536,1375
0131-002,2018,7,26,9,1397,1042,2439,2536
0131-002,2018,7,26,10,1030,992,2022,2439
0131-002,2018,7,26,11,1142,977,2119,2022
0131-002,2018,7,26,12,977,906,1883,2119
0131-002,2018,7,26,13,957,805,1762,1883
0131-002,2018,7,26,14,985,959,1944,1762
0131-002,2018,7,26,15,1035,967,2002,1944
0131-002,2018,7,26,16,958,1056,2014,2002
0131-002,2018,7,26,17,1077,1281,2358,2014
0131-002,2018,7,26,18,1160,1600,2760,2358
0131-002,2018,7,26,19,1132,1360,2492,2760
0131-002,2018,7,26,20,792,990,1782,2492
0131-002,2018,7,26,21,618,859,1477,1782
0131-002,2018,7,26,22,494,557,1051,1477
0131-002,2018,7,26,23,318,355,673,1051
0131-002,2018,7,26,24,226,225,451,673
0131-002,2018,7,27,1,183,163,346,451
0131-002,2018,7,27,2,93,97,190,346
0131-002,2018,7,27,3,83,83,166,190
0131-002,2018,7,27,4,114,82,196,166
0131-002,2018,7,27,5,157,153,310,196
0131-002,2018,7,27,6,425,276,701,310
0131-002,2018,7,27,7,910,584,1494,701
0131-002,2018,7,27,8,1526,1262,2788,1494
0131-002,2018,7,27,9,1380,1387,2767,2788
0131-002,2018,7,27,10,1005,1206,2211,2767
0131-002,2018,7,27,11,1085,1173,2258,2211
0131-002,2018,7,27,12,1097,1172,2269,2258
0131-002,2018,7,27,13,890,1104,1994,2269
0131-002,2018,7,27,14,997,1200,2197,1994
0131-002,2018,7,27,15,1107,1269,2376,2197
0131-002,2018,7,27,16,1077,1264,2341,2376
0131-002,2018,7,27,17,1133,1367,2500,2341
0131-002,2018,7,27,18,1326,1814,3140,2500
0131-002,2018,7,27,19,1586,1613,3199,3140
0131-002,2018,7,27,20,939,1115,2054,3199
0131-002,2018,7,27,21,656,900,1556,2054
0131-002,2018,7,27,22,581,581,1162,1556
0131-002,2018,7,27,23,384,423,807,1162
0131-002,2018,7,27,24,252,276,528,807
0131-002,2018,7,28,1,194,210,404,528
0131-002,2018,7,28,2,128,146,274,404
0131-002,2018,7,28,3,112,104,216,274
0131-002,2018,7,28,4,99,128,227,216
0131-002,2018,7,28,5,157,159,316,227
0131-002,2018,7,28,6,332,264,596,316
0131-002,2018,7,28,7,591,467,1058,596
0131-002,2018,7,28,8,775,728,1503,1058
0131-002,2018,7,28,9,852,923,1775,1503
0131-002,2018,7,28,10,851,997,1848,1775
0131-002,2018,7,28,11,924,946,1870,1848
0131-002,2018,7,28,12,913,1066,1979,1870
0131-002,2018,7,28,13,884,1001,1885,1979
0131-002,2018,7,28,14,879,982,1861,1885
0131-002,2018,7,28,15,827,901,1728,1861
0131-002,2018,7,28,16,818,1068,1886,1728
0131-002,2018,7,28,17,896,1040,1936,1886
0131-002,2018,7,28,18,934,1081,2015,1936
0131-002,2018,7,28,19,808,838,1646,2015
0131-002,2018,7,28,20,609,582,1191,1646
0131-002,2018,7,28,21,502,519,1021,1191
0131-002,2018,7,28,22,502,376,878,1021
0131-002,2018,7,28,23,301,284,585,878
0131-002,2018,7,28,24,201,201,402,585
0131-002,2018,7,29,1,147,156,303,402
0131-002,2018,7,29,2,93,111,204,303
0131-002,2018,7,29,3,79,98,177,204
0131-002,2018,7,29,4,71,67,138,177
0131-002,2018,7,29,5,93,95,188,138
0131-002,2018,7,29,6,194,141,335,188
0131-002,2018,7,29,7,271,244,515,335
0131-002,2018,7,29,8,348,344,692,515
0131-002,2018,7,29,9,376,553,929,692
0131-002,2018,7,29,10,466,637,1103,929
0131-002,2018,7,29,11,572,701,1273,1103
0131-002,2018,7,29,12,531,690,1221,1273
0131-002,2018,7,29,13,578,709,1287,1221
0131-002,2018,7,29,14,657,690,1347,1287
0131-002,2018,7,29,15,753,835,1588,1347
0131-002,2018,7,29,16,754,828,1582,1588
0131-002,2018,7,29,17,867,735,1602,1582
0131-002,2018,7,29,18,834,774,1608,1602
0131-002,2018,7,29,19,801,673,1474,1608
0131-002,2018,7,29,20,581,546,1127,1474
0131-002,2018,7,29,21,533,456,989,1127
0131-002,2018,7,29,22,479,379,858,989
0131-002,2018,7,29,23,331,294,625,858
0131-002,2018,7,29,24,227,204,431,625
0131-002,2018,7,30,1,143,118,261,431
0131-002,2018,7,30,2,68,83,151,261
0131-002,2018,7,30,3,58,74,132,151
0131-002,2018,7,30,4,83,71,154,132
0131-002,2018,7,30,5,122,113,235,154
0131-002,2018,7,30,6,404,298,702,235
0131-002,2018,7,30,7,797,603,1400,702
0131-002,2018,7,30,8,1340,1148,2488,1400
0131-002,2018,7,30,9,1180,1247,2427,2488
0131-002,2018,7,30,10,936,1017,1953,2427
0131-002,2018,7,30,11,988,1037,2025,1953
0131-002,2018,7,30,12,896,1013,1909,2025
0131-002,2018,7,30,13,797,972,1769,1909
0131-002,2018,7,30,14,894,994,1888,1769
0131-002,2018,7,30,15,988,1100,2088,1888
0131-002,2018,7,30,16,1024,1066,2090,2088
0131-002,2018,7,30,17,975,1164,2139,2090
0131-002,2018,7,30,18,1148,1394,2542,2139
0131-002,2018,7,30,19,1004,1192,2196,2542
0131-002,2018,7,30,20,733,749,1482,2196
0131-002,2018,7,30,21,433,601,1034,1482
0131-002,2018,7,30,22,372,455,827,1034
0131-002,2018,7,30,23,231,281,512,827
0131-002,2018,7,30,24,197,202,399,512
0131-002,2018,7,31,1,125,154,279,399
0131-002,2018,7,31,2,79,101,180,279
0131-002,2018,7,31,3,75,86,161,180
0131-002,2018,7,31,4,76,91,167,161
0131-002,2018,7,31,5,125,112,237,167
0131-002,2018,7,31,6,335,243,578,237
0131-002,2018,7,31,7,682,526,1208,578
0131-002,2018,7,31,8,1214,985,2199,1208
0131-002,2018,7,31,9,1137,1153,2290,2199
0131-002,2018,7,31,10,883,1007,1890,2290
0131-002,2018,7,31,11,971,1074,2045,1890
0131-002,2018,7,31,12,931,956,1887,2045
0131-002,2018,7,31,13,815,880,1695,1887
0131-002,2018,7,31,14,884,986,1870,1695
0131-002,2018,7,31,15,975,1064,2039,1870
0131-002,2018,7,31,16,883,1059,1942,2039
0131-002,2018,7,31,17,910,1169,2079,1942
0131-002,2018,7,31,18,1079,1465,2544,2079
0131-002,2018,7,31,19,1142,1205,2347,2544
0131-002,2018,7,31,20,730,865,1595,2347
0131-002,2018,7,31,21,584,640,1224,1595
0131-002,2018,7,31,22,412,474,886,1224
0131-002,2018,7,31,23,290,326,616,886
0131-002,2018,7,31,24,213,187,400,616
0131-002,2018,8,1,1,147,150,297,400
0131-002,2018,8,1,2,98,112,210,297
0131-002,2018,8,1,3,76,76,152,210
0131-002,2018,8,1,4,104,98,202,152
0131-002,2018,8,1,5,148,127,275,202
0131-002,2018,8,1,6,289,257,546,275
0131-002,2018,8,1,7,648,522,1170,546
0131-002,2018,8,1,8,1027,933,1960,1170
0131-002,2018,8,1,9,1008,1178,2186,1960
0131-002,2018,8,1,10,877,996,1873,2186
0131-002,2018,8,1,11,885,1070,1955,1873
0131-002,2018,8,1,12,911,951,1862,1955
0131-002,2018,8,1,13,839,968,1807,1862
0131-002,2018,8,1,14,857,989,1846,1807
0131-002,2018,8,1,15,907,962,1869,1846
0131-002,2018,8,1,16,891,992,1883,1869
0131-002,2018,8,1,17,932,1036,1968,1883
0131-002,2018,8,1,18,1070,1247,2317,1968
0131-002,2018,8,1,19,937,1147,2084,2317
0131-002,2018,8,1,20,693,720,1413,2084
0131-002,2018,8,1,21,526,527,1053,1413
0131-002,2018,8,1,22,417,401,818,1053
0131-002,2018,8,1,23,307,312,619,818
0131-002,2018,8,1,24,212,203,415,619
0131-002,2018,8,2,1,134,143,277,415
0131-002,2018,8,2,2,82,104,186,277
0131-002,2018,8,2,3,69,73,142,186
0131-002,2018,8,2,4,104,72,176,142
0131-002,2018,8,2,5,130,119,249,176
0131-002,2018,8,2,6,263,233,496,249
0131-002,2018,8,2,7,612,464,1076,496
0131-002,2018,8,2,8,1097,917,2014,1076
0131-002,2018,8,2,9,976,1149,2125,2014
0131-002,2018,8,2,10,858,1143,2001,2125
0131-002,2018,8,2,11,890,1098,1988,2001
0131-002,2018,8,2,12,921,976,1897,1988
0131-002,2018,8,2,13,803,959,1762,1897
0131-002,2018,8,2,14,868,956,1824,1762
0131-002,2018,8,2,15,883,1000,1883,1824
0131-002,2018,8,2,16,888,958,1846,1883
0131-002,2018,8,2,17,835,967,1802,1846
0131-002,2018,8,2,18,998,1228,2226,1802
0131-002,2018,8,2,19,1025,1017,2042,2226
0131-002,2018,8,2,20,662,730,1392,2042
0131-002,2018,8,2,21,486,608,1094,1392
0131-002,2018,8,2,22,414,428,842,1094
0131-002,2018,8,2,23,288,303,591,842
0131-002,2018,8,2,24,216,199,415,591
0131-002,2018,8,3,1,139,130,269,415
0131-002,2018,8,3,2,104,90,194,269
0131-002,2018,8,3,3,94,89,183,194
0131-002,2018,8,3,4,123,96,219,183
0131-002,2018,8,3,5,138,115,253,219
0131-002,2018,8,3,6,294,228,522,253
0131-002,2018,8,3,7,609,523,1132,522
0131-002,2018,8,3,8,977,899,1876,1132
0131-002,2018,8,3,9,1005,1156,2161,1876
0131-002,2018,8,3,10,819,940,1759,2161
0131-002,2018,8,3,11,836,985,1821,1759
0131-002,2018,8,3,12,816,999,1815,1821
0131-002,2018,8,3,13,778,920,1698,1815
0131-002,2018,8,3,14,888,978,1866,1698
0131-002,2018,8,3,15,966,1032,1998,1866
0131-002,2018,8,3,16,934,1050,1984,1998
0131-002,2018,8,3,17,892,1136,2028,1984
0131-002,2018,8,3,18,1073,1445,2518,2028
0131-002,2018,8,3,19,1121,1242,2363,2518
0131-002,2018,8,3,20,868,836,1704,2363
0131-002,2018,8,3,21,575,718,1293,1704
0131-002,2018,8,3,22,535,434,969,1293
0131-002,2018,8,3,23,335,314,649,969
0131-002,2018,8,3,24,246,226,472,649
0131-002,2018,8,4,1,165,161,326,472
0131-002,2018,8,4,2,131,107,238,326
0131-002,2018,8,4,3,72,114,186,238
0131-002,2018,8,4,4,136,77,213,186
0131-002,2018,8,4,5,143,134,277,213
0131-002,2018,8,4,6,236,216,452,277
0131-002,2018,8,4,7,426,383,809,452
0131-002,2018,8,4,8,556,560,1116,809
0131-002,2018,8,4,9,655,758,1413,1116
0131-002,2018,8,4,10,690,801,1491,1413
0131-002,2018,8,4,11,748,854,1602,1491
0131-002,2018,8,4,12,815,854,1669,1602
0131-002,2018,8,4,13,846,925,1771,1669
0131-002,2018,8,4,14,777,857,1634,1771
0131-002,2018,8,4,15,811,861,1672,1634
0131-002,2018,8,4,16,759,873,1632,1672
0131-002,2018,8,4,17,817,900,1717,1632
0131-002,2018,8,4,18,862,1050,1912,1717
0131-002,2018,8,4,19,758,763,1521,1912
0131-002,2018,8,4,20,655,537,1192,1521
0131-002,2018,8,4,21,519,461,980,1192
0131-002,2018,8,4,22,484,371,855,980
0131-002,2018,8,4,23,326,287,613,855
0131-002,2018,8,4,24,206,221,427,613
0131-002,2018,8,5,1,138,138,276,427
0131-002,2018,8,5,2,109,110,219,276
0131-002,2018,8,5,3,83,64,147,219
0131-002,2018,8,5,4,70,56,126,147
0131-002,2018,8,5,5,76,115,191,126
0131-002,2018,8,5,6,123,135,258,191
0131-002,2018,8,5,7,261,206,467,258
0131-002,2018,8,5,8,329,301,630,467
0131-002,2018,8,5,9,381,400,781,630
0131-002,2018,8,5,10,357,467,824,781
0131-002,2018,8,5,11,517,543,1060,824
0131-002,2018,8,5,12,552,553,1105,1060
0131-002,2018,8,5,13,513,603,1116,1105
0131-002,2018,8,5,14,611,595,1206,1116
0131-002,2018,8,5,15,650,666,1316,1206
0131-002,2018,8,5,16,769,676,1445,1316
0131-002,2018,8,5,17,824,614,1438,1445
0131-002,2018,8,5,18,802,643,1445,1438
0131-002,2018,8,5,19,749,524,1273,1445
0131-002,2018,8,5,20,462,442,904,1273
0131-002,2018,8,5,21,472,421,893,904
0131-002,2018,8,5,22,457,322,779,893
0131-002,2018,8,5,23,316,248,564,779
0131-002,2018,8,5,24,229,160,389,564
0131-002,2018,8,6,1,158,108,266,389
0131-002,2018,8,6,2,94,84,178,266
0131-002,2018,8,6,3,73,67,140,178
0131-002,2018,8,6,4,72,75,147,140
0131-002,2018,8,6,5,155,117,272,147
0131-002,2018,8,6,6,367,257,624,272
0131-002,2018,8,6,7,887,483,1370,624
0131-002,2018,8,6,8,1529,983,2512,1370
0131-002,2018,8,6,9,1246,1045,2291,2512
0131-002,2018,8,6,10,928,841,1769,2291
0131-002,2018,8,6,11,829,896,1725,1769
0131-002,2018,8,6,12,947,821,1768,1725
0131-002,2018,8,6,13,865,830,1695,1768
0131-002,2018,8,6,14,1001,845,1846,1695
0131-002,2018,8,6,15,947,915,1862,1846
0131-002,2018,8,6,16,958,954,1912,1862
0131-002,2018,8,6,17,820,898,1718,1912
0131-002,2018,8,6,18,1020,1064,2084,1718
0131-002,2018,8,6,19,901,959,1860,2084
0131-002,2018,8,6,20,495,676,1171,1860
0131-002,2018,8,6,21,334,619,953,1171
0131-002,2018,8,6,22,294,416,710,953
0131-002,2018,8,6,23,211,256,467,710
0131-002,2018,8,6,24,147,201,348,467
0131-002,2018,8,7,1,174,123,297,348
0131-002,2018,8,7,2,112,102,214,297
0131-002,2018,8,7,3,72,83,155,214
0131-002,2018,8,7,4,112,80,192,155
0131-002,2018,8,7,5,148,127,275,192
0131-002,2018,8,7,6,389,276,665,275
0131-002,2018,8,7,7,798,496,1294,665
0131-002,2018,8,7,8,1436,928,2364,1294
0131-002,2018,8,7,9,1254,1056,2310,2364
0131-002,2018,8,7,10,1000,972,1972,2310
0131-002,2018,8,7,11,1016,928,1944,1972
0131-002,2018,8,7,12,966,880,1846,1944
0131-002,2018,8,7,13,851,832,1683,1846
0131-002,2018,8,7,14,955,919,1874,1683
0131-002,2018,8,7,15,998,1052,2050,1874
0131-002,2018,8,7,16,975,1016,1991,2050
0131-002,2018,8,7,17,962,975,1937,1991
0131-002,2018,8,7,18,1029,1106,2135,1937
0131-002,2018,8,7,19,1038,996,2034,2135
0131-002,2018,8,7,20,680,758,1438,2034
0131-002,2018,8,7,21,543,667,1210,1438
0131-002,2018,8,7,22,435,408,843,1210
0131-002,2018,8,7,23,285,311,596,843
0131-002,2018,8,7,24,200,206,406,596
0131-002,2018,8,8,1,155,157,312,406
0131-002,2018,8,8,2,101,91,192,312
0131-002,2018,8,8,3,76,85,161,192
0131-002,2018,8,8,4,105,115,220,161
0131-002,2018,8,8,5,155,104,259,220
0131-002,2018,8,8,6,387,269,656,259
0131-002,2018,8,8,7,943,505,1448,656
0131-002,2018,8,8,8,1571,919,2490,1448
0131-002,2018,8,8,9,1284,1010,2294,2490
0131-002,2018,8,8,10,970,938,1908,2294
0131-002,2018,8,8,11,925,917,1842,1908
0131-002,2018,8,8,12,756,899,1655,1842
0131-002,2018,8,8,13,688,755,1443,1655
0131-002,2018,8,8,14,861,872,1733,1443
0131-002,2018,8,8,15,868,1004,1872,1733
0131-002,2018,8,8,16,826,1006,1832,1872
0131-002,2018,8,8,17,851,970,1821,1832
0131-002,2018,8,8,18,1011,1258,2269,1821
0131-002,2018,8,8,19,1046,996,2042,2269
0131-002,2018,8,8,20,723,703,1426,2042
0131-002,2018,8,8,21,543,591,1134,1426
0131-002,2018,8,8,22,446,438,884,1134
0131-002,2018,8,8,23,329,309,638,884
0131-002,2018,8,8,24,205,205,410,638
0131-002,2018,8,9,1,144,154,298,410
0131-002,2018,8,9,2,123,109,232,298
0131-002,2018,8,9,3,66,85,151,232
0131-002,2018,8,9,4,94,96,190,151
0131-002,2018,8,9,5,162,129,291,190
0131-002,2018,8,9,6,347,284,631,291
0131-002,2018,8,9,7,825,471,1296,631
0131-002,2018,8,9,8,1568,914,2482,1296
0131-002,2018,8,9,9,1335,1055,2390,2482
0131-002,2018,8,9,10,932,997,1929,2390
0131-002,2018,8,9,11,860,938,1798,1929
0131-002,2018,8,9,12,822,889,1711,1798
0131-002,2018,8,9,13,798,813,1611,1711
0131-002,2018,8,9,14,881,917,1798,1611
0131-002,2018,8,9,15,1035,1043,2078,1798
0131-002,2018,8,9,16,949,912,1861,2078
0131-002,2018,8,9,17,947,1003,1950,1861
0131-002,2018,8,9,18,1121,1222,2343,1950
0131-002,2018,8,9,19,1100,1114,2214,2343
0131-002,2018,8,9,20,733,751,1484,2214
0131-002,2018,8,9,21,570,644,1214,1484
0131-002,2018,8,9,22,446,445,891,1214
0131-002,2018,8,9,23,335,319,654,891
0131-002,2018,8,9,24,245,206,451,654
0131-002,2018,8,10,1,147,145,292,451
0131-002,2018,8,10,2,107,99,206,292
0131-002,2018,8,10,3,96,83,179,206
0131-002,2018,8,10,4,98,83,181,179
0131-002,2018,8,10,5,149,154,303,181
0131-002,2018,8,10,6,360,264,624,303
0131-002,2018,8,10,7,760,514,1274,624
0131-002,2018,8,10,8,1252,874,2126,1274
0131-002,2018,8,10,9,1192,1057,2249,2126
0131-002,2018,8,10,10,912,946,1858,2249
0131-002,2018,8,10,11,960,970,1930,1858
0131-002,2018,8,10,12,956,1005,1961,1930
0131-002,2018,8,10,13,834,867,1701,1961
0131-002,2018,8,10,14,942,956,1898,1701
0131-002,2018,8,10,15,1036,1102,2138,1898
0131-002,2018,8,10,16,1006,978,1984,2138
0131-002,2018,8,10,17,1012,991,2003,1984
0131-002,2018,8,10,18,1200,1316,2516,2003
0131-002,2018,8,10,19,1354,1146,2500,2516
0131-002,2018,8,10,20,794,832,1626,2500
0131-002,2018,8,10,21,625,663,1288,1626
0131-002,2018,8,10,22,595,494,1089,1288
0131-002,2018,8,10,23,367,371,738,1089
0131-002,2018,8,10,24,256,268,524,738
0131-002,2018,8,11,1,167,167,334,524
0131-002,2018,8,11,2,132,135,267,334
0131-002,2018,8,11,3,132,104,236,267
0131-002,2018,8,11,4,121,122,243,236
0131-002,2018,8,11,5,139,144,283,243
0131-002,2018,8,11,6,390,233,623,283
0131-002,2018,8,11,7,595,425,1020,623
0131-002,2018,8,11,8,843,594,1437,1020
0131-002,2018,8,11,9,826,740,1566,1437
0131-002,2018,8,11,10,833,770,1603,1566
0131-002,2018,8,11,11,823,813,1636,1603
0131-002,2018,8,11,12,822,775,1597,1636
0131-002,2018,8,11,13,739,772,1511,1597
0131-002,2018,8,11,14,623,759,1382,1511
0131-002,2018,8,11,15,678,769,1447,1382
0131-002,2018,8,11,16,741,812,1553,1447
0131-002,2018,8,11,17,751,772,1523,1553
0131-002,2018,8,11,18,766,877,1643,1523
0131-002,2018,8,11,19,782,694,1476,1643
0131-002,2018,8,11,20,643,524,1167,1476
0131-002,2018,8,11,21,494,453,947,1167
0131-002,2018,8,11,22,497,352,849,947
0131-002,2018,8,11,23,325,321,646,849
0131-002,2018,8,11,24,250,227,477,646
0131-002,2018,8,12,1,163,147,310,477
0131-002,2018,8,12,2,121,117,238,310
0131-002,2018,8,12,3,90,86,176,238
0131-002,2018,8,12,4,92,69,161,176
0131-002,2018,8,12,5,123,95,218,161
0131-002,2018,8,12,6,172,142,314,218
0131-002,2018,8,12,7,256,241,497,314
0131-002,2018,8,12,8,315,310,625,497
0131-002,2018,8,12,9,337,438,775,625
0131-002,2018,8,12,10,400,484,884,775
0131-002,2018,8,12,11,427,536,963,884
0131-002,2018,8,12,12,405,540,945,963
0131-002,2018,8,12,13,418,510,928,945
0131-002,2018,8,12,14,477,603,1080,928
0131-002,2018,8,12,15,580,611,1191,1080
0131-002,2018,8,12,16,641,643,1284,1191
0131-002,2018,8,12,17,725,621,1346,1284
0131-002,2018,8,12,18,721,620,1341,1346
0131-002,2018,8,12,19,712,542,1254,1341
0131-002,2018,8,12,20,576,470,1046,1254
0131-002,2018,8,12,21,562,406,968,1046
0131-002,2018,8,12,22,430,374,804,968
0131-002,2018,8,12,23,288,259,547,804
0131-002,2018,8,12,24,206,168,374,547
0131-002,2018,8,13,1,159,106,265,374
0131-002,2018,8,13,2,89,74,163,265
0131-002,2018,8,13,3,64,68,132,163
0131-002,2018,8,13,4,70,75,145,132
0131-002,2018,8,13,5,133,125,258,145
0131-002,2018,8,13,6,417,242,659,258
0131-002,2018,8,13,7,935,507,1442,659
0131-002,2018,8,13,8,1745,920,2665,1442
0131-002,2018,8,13,9,1406,971,2377,2665
0131-002,2018,8,13,10,864,982,1846,2377
0131-002,2018,8,13,11,906,1033,1939,1846
0131-002,2018,8,13,12,878,900,1778,1939
0131-002,2018,8,13,13,778,864,1642,1778
0131-002,2018,8,13,14,847,896,1743,1642
0131-002,2018,8,13,15,924,979,1903,1743
0131-002,2018,8,13,16,964,963,1927,1903
0131-002,2018,8,13,17,932,1016,1948,1927
0131-002,2018,8,13,18,1078,1076,2154,1948
0131-002,2018,8,13,19,1042,963,2005,2154
0131-002,2018,8,13,20,669,758,1427,2005
0131-002,2018,8,13,21,575,650,1225,1427
0131-002,2018,8,13,22,438,416,854,1225
0131-002,2018,8,13,23,268,283,551,854
0131-002,2018,8,13,24,191,178,369,551
0131-002,2018,8,14,1,125,139,264,369
0131-002,2018,8,14,2,90,104,194,264
0131-002,2018,8,14,3,68,93,161,194
0131-002,2018,8,14,4,82,100,182,161
0131-002,2018,8,14,5,144,124,268,182
0131-002,2018,8,14,6,418,259,677,268
0131-002,2018,8,14,7,850,528,1378,677
0131-002,2018,8,14,8,1580,909,2489,1378
0131-002,2018,8,14,9,1336,1073,2409,2489
0131-002,2018,8,14,10,967,929,1896,2409
0131-002,2018,8,14,11,982,1080,2062,1896
0131-002,2018,8,14,12,940,925,1865,2062
0131-002,2018,8,14,13,756,909,1665,1865
0131-002,2018,8,14,14,923,938,1861,1665
0131-002,2018,8,14,15,988,1041,2029,1861
0131-002,2018,8,14,16,1033,1125,2158,2029
0131-002,2018,8,14,17,912,1063,1975,2158
0131-002,2018,8,14,18,1187,1267,2454,1975
0131-002,2018,8,14,19,1080,1124,2204,2454
0131-002,2018,8,14,20,845,814,1659,2204
0131-002,2018,8,14,21,599,692,1291,1659
0131-002,2018,8,14,22,512,469,981,1291
0131-002,2018,8,14,23,352,297,649,981
0131-002,2018,8,14,24,223,210,433,649
0131-002,2018,8,15,1,155,166,321,433
0131-002,2018,8,15,2,105,133,238,321
0131-002,2018,8,15,3,92,107,199,238
0131-002,2018,8,15,4,96,103,199,199
0131-002,2018,8,15,5,137,151,288,199
0131-002,2018,8,15,6,347,215,562,288
0131-002,2018,8,15,7,555,410,965,562
0131-002,2018,8,15,8,768,594,1362,965
0131-002,2018,8,15,9,708,649,1357,1362
0131-002,2018,8,15,10,631,682,1313,1357
0131-002,2018,8,15,11,588,753,1341,1313
0131-002,2018,8,15,12,618,767,1385,1341
0131-002,2018,8,15,13,572,702,1274,1385
0131-002,2018,8,15,14,623,695,1318,1274
0131-002,2018,8,15,15,673,718,1391,1318
0131-002,2018,8,15,16,767,703,1470,1391
0131-002,2018,8,15,17,711,765,1476,1470
0131-002,2018,8,15,18,769,864,1633,1476
0131-002,2018,8,15,19,771,634,1405,1633
0131-002,2018,8,15,20,661,531,1192,1405
0131-002,2018,8,15,21,541,481,1022,1192
0131-002,2018,8,15,22,386,338,724,1022
0131-002,2018,8,15,23,284,252,536,724
0131-002,2018,8,15,24,171,147,318,536
0131-002,2018,8,16,1,100,120,220,318
0131-002,2018,8,16,2,86,78,164,220
0131-002,2018,8,16,3,49,73,122,164
0131-002,2018,8,16,4,80,72,152,122
0131-002,2018,8,16,5,140,107,247,152
0131-002,2018,8,16,6,418,263,681,247
0131-002,2018,8,16,7,894,473,1367,681
0131-002,2018,8,16,8,1662,953,2615,1367
0131-002,2018,8,16,9,1497,1129,2626,2615
0131-002,2018,8,16,10,894,957,1851,2626
0131-002,2018,8,16,11,884,983,1867,1851
0131-002,2018,8,16,12,800,953,1753,1867
0131-002,2018,8,16,13,766,818,1584,1753
0131-002,2018,8,16,14,986,954,1940,1584
0131-002,2018,8,16,15,1022,1031,2053,1940
0131-002,2018,8,16,16,1017,1038,2055,2053
0131-002,2018,8,16,17,1047,979,2026,2055
0131-002,2018,8,16,18,1129,1230,2359,2026
0131-002,2018,8,16,19,1149,1157,2306,2359
0131-002,2018,8,16,20,772,762,1534,2306
0131-002,2018,8,16,21,572,628,1200,1534
0131-002,2018,8,16,22,482,441,923,1200
0131-002,2018,8,16,23,320,284,604,923
0131-002,2018,8,16,24,218,190,408,604
0131-002,2018,8,17,1,139,155,294,408
0131-002,2018,8,17,2,101,109,210,294
0131-002,2018,8,17,3,80,89,169,210
0131-002,2018,8,17,4,103,112,215,169
0131-002,2018,8,17,5,145,117,262,215
0131-002,2018,8,17,6,407,263,670,262
0131-002,2018,8,17,7,865,476,1341,670
0131-002,2018,8,17,8,1652,915,2567,1341
0131-002,2018,8,17,9,1382,1132,2514,2567
0131-002,2018,8,17,10,1015,1028,2043,2514
0131-002,2018,8,17,11,936,1021,1957,2043
0131-002,2018,8,17,12,952,969,1921,1957
0131-002,2018,8,17,13,831,815,1646,1921
0131-002,2018,8,17,14,884,942,1826,1646
0131-002,2018,8,17,15,902,1045,1947,1826
0131-002,2018,8,17,16,953,1099,2052,1947
0131-002,2018,8,17,17,1106,1097,2203,2052
0131-002,2018,8,17,18,1222,1397,2619,2203
0131-002,2018,8,17,19,1255,1227,2482,2619
0131-002,2018,8,17,20,992,907,1899,2482
0131-002,2018,8,17,21,704,735,1439,1899
0131-002,2018,8,17,22,575,471,1046,1439
0131-002,2018,8,17,23,374,313,687,1046
0131-002,2018,8,17,24,217,218,435,687
0131-002,2018,8,18,1,213,186,399,435
0131-002,2018,8,18,2,123,135,258,399
0131-002,2018,8,18,3,112,111,223,258
0131-002,2018,8,18,4,100,107,207,223
0131-002,2018,8,18,5,124,144,268,207
0131-002,2018,8,18,6,359,242,601,268
0131-002,2018,8,18,7,537,426,963,601
0131-002,2018,8,18,8,774,607,1381,963
0131-002,2018,8,18,9,767,698,1465,1381
0131-002,2018,8,18,10,774,758,1532,1465
0131-002,2018,8,18,11,780,890,1670,1532
0131-002,2018,8,18,12,802,854,1656,1670
0131-002,2018,8,18,13,694,753,1447,1656
0131-002,2018,8,18,14,674,760,1434,1447
0131-002,2018,8,18,15,739,749,1488,1434
0131-002,2018,8,18,16,772,784,1556,1488
0131-002,2018,8,18,17,798,798,1596,1556
0131-002,2018,8,18,18,877,809,1686,1596
0131-002,2018,8,18,19,794,718,1512,1686
0131-002,2018,8,18,20,724,477,1201,1512
0131-002,2018,8,18,21,544,470,1014,1201
0131-002,2018,8,18,22,494,358,852,1014
0131-002,2018,8,18,23,313,265,578,852
0131-002,2018,8,18,24,221,182,403,578
0131-002,2018,8,19,1,164,153,317,403
0131-002,2018,8,19,2,133,98,231,317
0131-002,2018,8,19,3,84,72,156,231
0131-002,2018,8,19,4,92,69,161,156
0131-002,2018,8,19,5,119,79,198,161
0131-002,2018,8,19,6,158,141,299,198
0131-002,2018,8,19,7,292,237,529,299
0131-002,2018,8,19,8,340,320,660,529
0131-002,2018,8,19,9,355,425,780,660
0131-002,2018,8,19,10,454,490,944,780
0131-002,2018,8,19,11,517,548,1065,944
0131-002,2018,8,19,12,539,570,1109,1065
0131-002,2018,8,19,13,493,591,1084,1109
0131-002,2018,8,19,14,559,610,1169,1084
0131-002,2018,8,19,15,604,668,1272,1169
0131-002,2018,8,19,16,686,698,1384,1272
0131-002,2018,8,19,17,725,679,1404,1384
0131-002,2018,8,19,18,716,643,1359,1404
0131-002,2018,8,19,19,769,544,1313,1359
0131-002,2018,8,19,20,653,507,1160,1313
0131-002,2018,8,19,21,567,487,1054,1160
0131-002,2018,8,19,22,464,327,791,1054
0131-002,2018,8,19,23,348,228,576,791
0131-002,2018,8,19,24,194,146,340,576
0131-002,2018,8,20,1,137,99,236,340
0131-002,2018,8,20,2,84,74,158,236
0131-002,2018,8,20,3,50,54,104,158
0131-002,2018,8,20,4,74,60,134,104
0131-002,2018,8,20,5,151,112,263,134
0131-002,2018,8,20,6,476,262,738,263
0131-002,2018,8,20,7,957,543,1500,738
0131-002,2018,8,20,8,1848,950,2798,1500
0131-002,2018,8,20,9,1482,1042,2524,2798
0131-002,2018,8,20,10,962,931,1893,2524
0131-002,2018,8,20,11,980,986,1966,1893
0131-002,2018,8,20,12,913,895,1808,1966
0131-002,2018,8,20,13,842,813,1655,1808
0131-002,2018,8,20,14,880,905,1785,1655
0131-002,2018,8,20,15,1007,994,2001,1785
0131-002,2018,8,20,16,1042,1025,2067,2001
0131-002,2018,8,20,17,953,1043,1996,2067
0131-002,2018,8,20,18,1110,1239,2349,1996
0131-002,2018,8,20,19,1104,960,2064,2349
0131-002,2018,8,20,20,778,760,1538,2064
0131-002,2018,8,20,21,563,656,1219,1538
0131-002,2018,8,20,22,396,426,822,1219
0131-002,2018,8,20,23,301,251,552,822
0131-002,2018,8,20,24,184,190,374,552
0131-002,2018,8,21,1,137,120,257,374
0131-002,2018,8,21,2,80,69,149,257
0131-002,2018,8,21,3,72,78,150,149
0131-002,2018,8,21,4,73,91,164,150
0131-002,2018,8,21,5,170,116,286,164
0131-002,2018,8,21,6,395,280,675,286
0131-002,2018,8,21,7,825,504,1329,675
0131-002,2018,8,21,8,1723,953,2676,1329
0131-002,2018,8,21,9,1529,1149,2678,2676
0131-002,2018,8,21,10,1055,1010,2065,2678
0131-002,2018,8,21,11,996,1062,2058,2065
0131-002,2018,8,21,12,975,931,1906,2058
0131-002,2018,8,21,13,821,786,1607,1906
0131-002,2018,8,21,14,962,952,1914,1607
0131-002,2018,8,21,15,1054,988,2042,1914
0131-002,2018,8,21,16,980,965,1945,2042
0131-002,2018,8,21,17,983,995,1978,1945
0131-002,2018,8,21,18,1141,1171,2312,1978
0131-002,2018,8,21,19,1092,1010,2102,2312
0131-002,2018,8,21,20,807,757,1564,2102
0131-002,2018,8,21,21,617,668,1285,1564
0131-002,2018,8,21,22,481,479,960,1285
0131-002,2018,8,21,23,348,324,672,960
0131-002,2018,8,21,24,217,189,406,672
0131-002,2018,8,22,1,135,123,258,406
0131-002,2018,8,22,2,94,87,181,258
0131-002,2018,8,22,3,69,79,148,181
0131-002,2018,8,22,4,85,89,174,148
0131-002,2018,8,22,5,131,125,256,174
0131-002,2018,8,22,6,390,251,641,256
0131-002,2018,8,22,7,872,497,1369,641
0131-002,2018,8,22,8,1584,932,2516,1369
0131-002,2018,8,22,9,1403,1093,2496,2516
0131-002,2018,8,22,10,936,919,1855,2496
0131-002,2018,8,22,11,915,1010,1925,1855
0131-002,2018,8,22,12,896,977,1873,1925
0131-002,2018,8,22,13,719,835,1554,1873
0131-002,2018,8,22,14,913,958,1871,1554
0131-002,2018,8,22,15,951,1065,2016,1871
0131-002,2018,8,22,16,1019,1033,2052,2016
0131-002,2018,8,22,17,1014,1088,2102,2052
0131-002,2018,8,22,18,1081,1334,2415,2102
0131-002,2018,8,22,19,1137,1065,2202,2415
0131-002,2018,8,22,20,736,790,1526,2202
0131-002,2018,8,22,21,541,629,1170,1526
0131-002,2018,8,22,22,465,480,945,1170
0131-002,2018,8,22,23,302,296,598,945
0131-002,2018,8,22,24,207,236,443,598
0131-002,2018,8,23,1,133,128,261,443
0131-002,2018,8,23,2,124,105,229,261
0131-002,2018,8,23,3,74,89,163,229
0131-002,2018,8,23,4,68,89,157,163
0131-002,2018,8,23,5,105,102,207,157
0131-002,2018,8,23,6,290,214,504,207
0131-002,2018,8,23,7,704,458,1162,504
0131-002,2018,8,23,8,1606,906,2512,1162
0131-002,2018,8,23,9,1353,1083,2436,2512
0131-002,2018,8,23,10,890,916,1806,2436
0131-002,2018,8,23,11,963,859,1822,1806
0131-002,2018,8,23,12,817,848,1665,1822
0131-002,2018,8,23,13,764,751,1515,1665
0131-002,2018,8,23,14,827,842,1669,1515
0131-002,2018,8,23,15,854,891,1745,1669
0131-002,2018,8,23,16,823,946,1769,1745
0131-002,2018,8,23,17,809,795,1604,1769
0131-002,2018,8,23,18,1031,1131,2162,1604
0131-002,2018,8,23,19,1010,984,1994,2162
0131-002,2018,8,23,20,690,713,1403,1994
0131-002,2018,8,23,21,488,583,1071,1403
0131-002,2018,8,23,22,316,340,656,1071
0131-002,2018,8,23,23,203,184,387,656
0131-002,2018,8,23,24,116,155,271,387
0131-002,2018,8,24,1,132,106,238,271
0131-002,2018,8,24,2,68,73,141,238
0131-002,2018,8,24,3,50,75,125,141
0131-002,2018,8,24,4,47,72,119,125
0131-002,2018,8,24,5,77,75,152,119
0131-002,2018,8,24,6,384,146,530,152
0131-002,2018,8,24,7,812,376,1188,530
0131-002,2018,8,24,8,1452,925,2377,1188
0131-002,2018,8,24,9,1287,1053,2340,2377
0131-002,2018,8,24,10,964,858,1822,2340
0131-002,2018,8,24,11,948,853,1801,1822
0131-002,2018,8,24,12,809,836,1645,1801
0131-002,2018,8,24,13,795,805,1600,1645
0131-002,2018,8,24,14,908,872,1780,1600
0131-002,2018,8,24,15,911,925,1836,1780
0131-002,2018,8,24,16,888,894,1782,1836
0131-002,2018,8,24,17,1030,924,1954,1782
0131-002,2018,8,24,18,1121,1113,2234,1954
0131-002,2018,8,24,19,1304,1068,2372,2234
0131-002,2018,8,24,20,893,740,1633,2372
0131-002,2018,8,24,21,664,622,1286,1633
0131-002,2018,8,24,22,585,435,1020,1286
0131-002,2018,8,24,23,370,282,652,1020
0131-002,2018,8,24,24,236,265,501,652
0131-002,2018,8,25,1,185,176,361,501
0131-002,2018,8,25,2,129,138,267,361
0131-002,2018,8,25,3,104,96,200,267
0131-002,2018,8,25,4,77,102,179,200
0131-002,2018,8,25,5,118,146,264,179
0131-002,2018,8,25,6,348,274,622,264
0131-002,2018,8,25,7,527,407,934,622
0131-002,2018,8,25,8,814,599,1413,934
0131-002,2018,8,25,9,817,754,1571,1413
0131-002,2018,8,25,10,837,790,1627,1571
0131-002,2018,8,25,11,894,828,1722,1627
0131-002,2018,8,25,12,899,820,1719,1722
0131-002,2018,8,25,13,873,788,1661,1719
0131-002,2018,8,25,14,833,828,1661,1661
0131-002,2018,8,25,15,858,768,1626,1661
0131-002,2018,8,25,16,905,773,1678,1626
0131-002,2018,8,25,17,933,831,1764,1678
0131-002,2018,8,25,18,945,868,1813,1764
0131-002,2018,8,25,19,821,720,1541,1813
0131-002,2018,8,25,20,530,516,1046,1541
0131-002,2018,8,25,21,410,454,864,1046
0131-002,2018,8,25,22,395,350,745,864
0131-002,2018,8,25,23,236,254,490,745
0131-002,2018,8,25,24,166,179,345,490
0131-002,2018,8,26,1,135,160,295,345
0131-002,2018,8,26,2,118,83,201,295
0131-002,2018,8,26,3,83,97,180,201
0131-002,2018,8,26,4,73,75,148,180
0131-002,2018,8,26,5,75,93,168,148
0131-002,2018,8,26,6,173,120,293,168
0131-002,2018,8,26,7,250,249,499,293
0131-002,2018,8,26,8,282,311,593,499
0131-002,2018,8,26,9,257,384,641,593
0131-002,2018,8,26,10,356,485,841,641
0131-002,2018,8,26,11,413,587,1000,841
0131-002,2018,8,26,12,428,640,1068,1000
0131-002,2018,8,26,13,451,588,1039,1068
0131-002,2018,8,26,14,511,605,1116,1039
0131-002,2018,8,26,15,549,666,1215,1116
0131-002,2018,8,26,16,638,669,1307,1215
0131-002,2018,8,26,17,666,675,1341,1307
0131-002,2018,8,26,18,641,611,1252,1341
0131-002,2018,8,26,19,634,518,1152,1252
0131-002,2018,8,26,20,422,484,906,1152
0131-002,2018,8,26,21,402,418,820,906
0131-002,2018,8,26,22,342,320,662,820
0131-002,2018,8,26,23,219,229,448,662
0131-002,2018,8,26,24,136,153,289,448
0131-002,2018,8,27,1,86,103,189,289
0131-002,2018,8,27,2,66,71,137,189
0131-002,2018,8,27,3,65,59,124,137
0131-002,2018,8,27,4,48,64,112,124
0131-002,2018,8,27,5,87,90,177,112
0131-002,2018,8,27,6,289,217,506,177
0131-002,2018,8,27,7,733,505,1238,506
0131-002,2018,8,27,8,1518,1140,2658,1238
0131-002,2018,8,27,9,1453,1302,2755,2658
0131-002,2018,8,27,10,922,1000,1922,2755
0131-002,2018,8,27,11,1016,970,1986,1922
0131-002,2018,8,27,12,889,984,1873,1986
0131-002,2018,8,27,13,839,927,1766,1873
0131-002,2018,8,27,14,904,950,1854,1766
0131-002,2018,8,27,15,1022,1016,2038,1854
0131-002,2018,8,27,16,970,925,1895,2038
0131-002,2018,8,27,17,977,933,1910,1895
0131-002,2018,8,27,18,1189,1151,2340,1910
0131-002,2018,8,27,19,1052,943,1995,2340
0131-002,2018,8,27,20,633,700,1333,1995
0131-002,2018,8,27,21,483,570,1053,1333
0131-002,2018,8,27,22,418,412,830,1053
0131-002,2018,8,27,23,268,280,548,830
0131-002,2018,8,27,24,157,164,321,548
0131-002,2018,8,28,1,114,124,238,321
0131-002,2018,8,28,2,113,82,195,238
0131-002,2018,8,28,3,59,71,130,195
0131-002,2018,8,28,4,73,88,161,130
0131-002,2018,8,28,5,98,109,207,161
0131-002,2018,8,28,6,298,188,486,207
0131-002,2018,8,28,7,685,435,1120,486
0131-002,2018,8,28,8,1467,993,2460,1120
0131-002,2018,8,28,9,1384,1206,2590,2460
0131-002,2018,8,28,10,1015,921,1936,2590
0131-002,2018,8,28,11,1007,1001,2008,1936
0131-002,2018,8,28,12,933,928,1861,2008
0131-002,2018,8,28,13,911,799,1710,1861
0131-002,2018,8,28,14,1009,943,1952,1710
0131-002,2018,8,28,15,1086,1038,2124,1952
0131-002,2018,8,28,16,1147,987,2134,2124
0131-002,2018,8,28,17,911,937,1848,2134
0131-002,2018,8,28,18,1078,1066,2144,1848
0131-002,2018,8,28,19,1059,973,2032,2144
0131-002,2018,8,28,20,691,717,1408,2032
0131-002,2018,8,28,21,539,611,1150,1408
0131-002,2018,8,28,22,433,415,848,1150
0131-002,2018,8,28,23,281,276,557,848
0131-002,2018,8,28,24,157,188,345,557
0131-002,2018,8,29,1,134,122,256,345
0131-002,2018,8,29,2,93,112,205,256
0131-002,2018,8,29,3,76,68,144,205
0131-002,2018,8,29,4,81,88,169,144
0131-002,2018,8,29,5,130,112,242,169
0131-002,2018,8,29,6,352,227,579,242
0131-002,2018,8,29,7,779,458,1237,579
0131-002,2018,8,29,8,1591,899,2490,1237
0131-002,2018,8,29,9,1383,1129,2512,2490
0131-002,2018,8,29,10,1019,876,1895,2512
0131-002,2018,8,29,11,1064,1013,2077,1895
0131-002,2018,8,29,12,1064,961,2025,2077
0131-002,2018,8,29,13,845,843,1688,2025
0131-002,2018,8,29,14,996,946,1942,1688
0131-002,2018,8,29,15,1097,1023,2120,1942
0131-002,2018,8,29,16,1067,990,2057,2120
0131-002,2018,8,29,17,1021,1048,2069,2057
0131-002,2018,8,29,18,1235,1303,2538,2069
0131-002,2018,8,29,19,1086,950,2036,2538
0131-002,2018,8,29,20,617,642,1259,2036
0131-002,2018,8,29,21,479,578,1057,1259
0131-002,2018,8,29,22,404,417,821,1057
0131-002,2018,8,29,23,322,254,576,821
0131-002,2018,8,29,24,206,178,384,576
0131-002,2018,8,30,1,139,140,279,384
0131-002,2018,8,30,2,92,86,178,279
0131-002,2018,8,30,3,66,71,137,178
0131-002,2018,8,30,4,85,93,178,137
0131-002,2018,8,30,5,111,112,223,178
0131-002,2018,8,30,6,361,222,583,223
0131-002,2018,8,30,7,773,442,1215,583
0131-002,2018,8,30,8,1391,1129,2520,1215
0131-002,2018,8,30,9,1384,1270,2654,2520
0131-002,2018,8,30,10,999,950,1949,2654
0131-002,2018,8,30,11,933,976,1909,1949
0131-002,2018,8,30,12,817,915,1732,1909
0131-002,2018,8,30,13,713,836,1549,1732
0131-002,2018,8,30,14,916,984,1900,1549
0131-002,2018,8,30,15,947,1023,1970,1900
0131-002,2018,8,30,16,882,957,1839,1970
0131-002,2018,8,30,17,994,1105,2099,1839
0131-002,2018,8,30,18,1145,1318,2463,2099
0131-002,2018,8,30,19,856,1168,2024,2463
0131-002,2018,8,30,20,574,849,1423,2024
0131-002,2018,8,30,21,446,688,1134,1423
0131-002,2018,8,30,22,348,436,784,1134
0131-002,2018,8,30,23,258,262,520,784
0131-002,2018,8,30,24,152,190,342,520
0131-002,2018,8,31,1,167,161,328,342
0131-002,2018,8,31,2,92,98,190,328
0131-002,2018,8,31,3,67,88,155,190
0131-002,2018,8,31,4,72,72,144,155
0131-002,2018,8,31,5,125,106,231,144
0131-002,2018,8,31,6,330,222,552,231
0131-002,2018,8,31,7,748,464,1212,552
0131-002,2018,8,31,8,1455,1019,2474,1212
0131-002,2018,8,31,9,1423,1163,2586,2474
0131-002,2018,8,31,10,1044,891,1935,2586
0131-002,2018,8,31,11,1034,926,1960,1935
0131-002,2018,8,31,12,943,997,1940,1960
0131-002,2018,8,31,13,788,854,1642,1940
0131-002,2018,8,31,14,726,956,1682,1642
0131-002,2018,8,31,15,805,1022,1827,1682
0131-002,2018,8,31,16,1012,1008,2020,1827
0131-002,2018,8,31,17,1006,1089,2095,2020
0131-002,2018,8,31,18,1115,1360,2475,2095
0131-002,2018,8,31,19,1171,1205,2376,2475
0131-002,2018,8,31,20,686,905,1591,2376
0131-002,2018,8,31,21,520,663,1183,1591
0131-002,2018,8,31,22,572,478,1050,1183
0131-002,2018,8,31,23,328,359,687,1050
0131-002,2018,8,31,24,226,258,484,687
0131-002,2018,9,1,1,167,186,353,484
0131-002,2018,9,1,2,127,140,267,353
0131-002,2018,9,1,3,119,107,226,267
0131-002,2018,9,1,4,100,130,230,226
0131-002,2018,9,1,5,143,110,253,230
0131-002,2018,9,1,6,340,240,580,253
0131-002,2018,9,1,7,614,452,1066,580
0131-002,2018,9,1,8,834,614,1448,1066
0131-002,2018,9,1,9,836,747,1583,1448
0131-002,2018,9,1,10,906,784,1690,1583
0131-002,2018,9,1,11,952,803,1755,1690
0131-002,2018,9,1,12,978,879,1857,1755
0131-002,2018,9,1,13,907,805,1712,1857
0131-002,2018,9,1,14,844,851,1695,1712
0131-002,2018,9,1,15,937,813,1750,1695
0131-002,2018,9,1,16,894,815,1709,1750
0131-002,2018,9,1,17,981,860,1841,1709
0131-002,2018,9,1,18,958,910,1868,1841
0131-002,2018,9,1,19,837,750,1587,1868
0131-002,2018,9,1,20,553,599,1152,1587
0131-002,2018,9,1,21,424,450,874,1152
0131-002,2018,9,1,22,322,310,632,874
0131-002,2018,9,1,23,194,198,392,632
0131-002,2018,9,1,24,190,233,423,392
0131-002,2018,9,2,1,156,152,308,423
0131-002,2018,9,2,2,84,108,192,308
0131-002,2018,9,2,3,80,84,164,192
0131-002,2018,9,2,4,75,75,150,164
0131-002,2018,9,2,5,100,89,189,150
0131-002,2018,9,2,6,192,142,334,189
0131-002,2018,9,2,7,314,254,568,334
0131-002,2018,9,2,8,406,357,763,568
0131-002,2018,9,2,9,388,410,798,763
0131-002,2018,9,2,10,482,503,985,798
0131-002,2018,9,2,11,573,598,1171,985
0131-002,2018,9,2,12,630,605,1235,1171
0131-002,2018,9,2,13,662,575,1237,1235
0131-002,2018,9,2,14,725,643,1368,1237
0131-002,2018,9,2,15,672,725,1397,1368
0131-002,2018,9,2,16,773,765,1538,1397
0131-002,2018,9,2,17,845,781,1626,1538
0131-002,2018,9,2,18,895,764,1659,1626
0131-002,2018,9,2,19,743,666,1409,1659
0131-002,2018,9,2,20,491,564,1055,1409
0131-002,2018,9,2,21,467,487,954,1055
0131-002,2018,9,2,22,376,363,739,954
0131-002,2018,9,2,23,291,235,526,739
0131-002,2018,9,2,24,176,186,362,526
0131-002,2018,9,3,1,115,109,224,362
0131-002,2018,9,3,2,72,63,135,224
0131-002,2018,9,3,3,49,60,109,135
0131-002,2018,9,3,4,58,78,136,109
0131-002,2018,9,3,5,123,117,240,136
0131-002,2018,9,3,6,415,254,669,240
0131-002,2018,9,3,7,923,495,1418,669
0131-002,2018,9,3,8,1638,1035,2673,1418
0131-002,2018,9,3,9,1370,1155,2525,2673
0131-002,2018,9,3,10,969,909,1878,2525
0131-002,2018,9,3,11,928,913,1841,1878
0131-002,2018,9,3,12,889,844,1733,1841
0131-002,2018,9,3,13,817,837,1654,1733
0131-002,2018,9,3,14,825,879,1704,1654
0131-002,2018,9,3,15,970,1010,1980,1704
0131-002,2018,9,3,16,953,939,1892,1980
0131-002,2018,9,3,17,865,1014,1879,1892
0131-002,2018,9,3,18,892,1240,2132,1879
0131-002,2018,9,3,19,881,1099,1980,2132
0131-002,2018,9,3,20,556,859,1415,1980
0131-002,2018,9,3,21,451,679,1130,1415
0131-002,2018,9,3,22,349,432,781,1130
0131-002,2018,9,3,23,203,280,483,781
0131-002,2018,9,3,24,115,171,286,483
0131-002,2018,9,4,1,100,98,198,286
0131-002,2018,9,4,2,70,77,147,198
0131-002,2018,9,4,3,57,77,134,147
0131-002,2018,9,4,4,77,87,164,134
0131-002,2018,9,4,5,123,96,219,164
0131-002,2018,9,4,6,324,220,544,219
0131-002,2018,9,4,7,693,461,1154,544
0131-002,2018,9,4,8,1411,975,2386,1154
0131-002,2018,9,4,9,1147,1145,2292,2386
0131-002,2018,9,4,10,797,910,1707,2292
0131-002,2018,9,4,11,819,965,1784,1707
0131-002,2018,9,4,12,814,860,1674,1784
0131-002,2018,9,4,13,743,807,1550,1674
0131-002,2018,9,4,14,775,911,1686,1550
0131-002,2018,9,4,15,950,966,1916,1686
0131-002,2018,9,4,16,907,958,1865,1916
0131-002,2018,9,4,17,929,1034,1963,1865
0131-002,2018,9,4,18,1236,1179,2415,1963
0131-002,2018,9,4,19,1013,1056,2069,2415
0131-002,2018,9,4,20,733,785,1518,2069
0131-002,2018,9,4,21,515,632,1147,1518
0131-002,2018,9,4,22,377,413,790,1147
0131-002,2018,9,4,23,312,314,626,790
0131-002,2018,9,4,24,201,200,401,626
0131-002,2018,9,5,1,140,156,296,401
0131-002,2018,9,5,2,85,103,188,296
0131-002,2018,9,5,3,74,82,156,188
0131-002,2018,9,5,4,85,91,176,156
0131-002,2018,9,5,5,130,124,254,176
0131-002,2018,9,5,6,371,229,600,254
0131-002,2018,9,5,7,826,529,1355,600
0131-002,2018,9,5,8,1588,958,2546,1355
0131-002,2018,9,5,9,1393,1141,2534,2546
0131-002,2018,9,5,10,978,959,1937,2534
0131-002,2018,9,5,11,990,938,1928,1937
0131-002,2018,9,5,12,980,919,1899,1928
0131-002,2018,9,5,13,782,827,1609,1899
0131-002,2018,9,5,14,954,936,1890,1609
0131-002,2018,9,5,15,1024,1066,2090,1890
0131-002,2018,9,5,16,1043,1094,2137,2090
0131-002,2018,9,5,17,985,1109,2094,2137
0131-002,2018,9,5,18,1184,1373,2557,2094
0131-002,2018,9,5,19,1055,1067,2122,2557
0131-002,2018,9,5,20,655,779,1434,2122
0131-002,2018,9,5,21,525,586,1111,1434
0131-002,2018,9,5,22,380,431,811,1111
0131-002,2018,9,5,23,311,302,613,811
0131-002,2018,9,5,24,215,222,437,613
0131-002,2018,9,6,1,149,148,297,437
0131-002,2018,9,6,2,124,97,221,297
0131-002,2018,9,6,3,73,82,155,221
0131-002,2018,9,6,4,98,84,182,155
0131-002,2018,9,6,5,151,127,278,182
0131-002,2018,9,6,6,326,252,578,278
0131-002,2018,9,6,7,738,513,1251,578
0131-002,2018,9,6,8,1498,1049,2547,1251
0131-002,2018,9,6,9,1368,1341,2709,2547
0131-002,2018,9,6,10,944,1106,2050,2709
0131-002,2018,9,6,11,948,1106,2054,2050
0131-002,2018,9,6,12,817,1028,1845,2054
0131-002,2018,9,6,13,738,868,1606,1845
0131-002,2018,9,6,14,872,1017,1889,1606
0131-002,2018,9,6,15,900,1081,1981,1889
0131-002,2018,9,6,16,852,1067,1919,1981
0131-002,2018,9,6,17,902,1092,1994,1919
0131-002,2018,9,6,18,1272,1295,2567,1994
0131-002,2018,9,6,19,1102,1072,2174,2567
0131-002,2018,9,6,20,686,789,1475,2174
0131-002,2018,9,6,21,500,630,1130,1475
0131-002,2018,9,6,22,397,439,836,1130
0131-002,2018,9,6,23,255,301,556,836
0131-002,2018,9,6,24,185,214,399,556
0131-002,2018,9,7,1,132,151,283,399
0131-002,2018,9,7,2,98,86,184,283
0131-002,2018,9,7,3,60,86,146,184
0131-002,2018,9,7,4,66,99,165,146
0131-002,2018,9,7,5,127,107,234,165
0131-002,2018,9,7,6,326,250,576,234
0131-002,2018,9,7,7,675,479,1154,576
0131-002,2018,9,7,8,1383,999,2382,1154
0131-002,2018,9,7,9,1146,1115,2261,2382
0131-002,2018,9,7,10,851,966,1817,2261
0131-002,2018,9,7,11,858,1058,1916,1817
0131-002,2018,9,7,12,749,990,1739,1916
0131-002,2018,9,7,13,817,1067,1884,1739
0131-002,2018,9,7,14,777,1015,1792,1884
0131-002,2018,9,7,15,812,1136,1948,1792
0131-002,2018,9,7,16,845,1046,1891,1948
0131-002,2018,9,7,17,919,1117,2036,1891
0131-002,2018,9,7,18,1160,1365,2525,2036
0131-002,2018,9,7,19,1247,1297,2544,2525
0131-002,2018,9,7,20,817,944,1761,2544
0131-002,2018,9,7,21,607,693,1300,1761
0131-002,2018,9,7,22,455,486,941,1300
0131-002,2018,9,7,23,332,367,699,941
0131-002,2018,9,7,24,218,250,468,699
0131-002,2018,9,8,1,175,176,351,468
0131-002,2018,9,8,2,116,128,244,351
0131-002,2018,9,8,3,89,107,196,244
0131-002,2018,9,8,4,107,116,223,196
0131-002,2018,9,8,5,127,138,265,223
0131-002,2018,9,8,6,306,293,599,265
0131-002,2018,9,8,7,561,465,1026,599
0131-002,2018,9,8,8,847,663,1510,1026
0131-002,2018,9,8,9,985,832,1817,1510
0131-002,2018,9,8,10,1034,889,1923,1817
0131-002,2018,9,8,11,1090,919,2009,1923
0131-002,2018,9,8,12,1551,779,2330,2009
0131-002,2018,9,8,13,1177,787,1964,2330
0131-002,2018,9,8,14,1048,795,1843,1964
0131-002,2018,9,8,15,1001,817,1818,1843
0131-002,2018,9,8,16,939,899,1838,1818
0131-002,2018,9,8,17,943,856,1799,1838
0131-002,2018,9,8,18,1058,1253,2311,1799
0131-002,2018,9,8,19,1007,910,1917,2311
0131-002,2018,9,8,20,781,736,1517,1917
0131-002,2018,9,8,21,573,546,1119,1517
0131-002,2018,9,8,22,402,360,762,1119
0131-002,2018,9,8,23,294,300,594,762
0131-002,2018,9,8,24,192,231,423,594
0131-002,2018,9,9,1,195,138,333,423
0131-002,2018,9,9,2,99,115,214,333
0131-002,2018,9,9,3,86,80,166,214
0131-002,2018,9,9,4,75,82,157,166
0131-002,2018,9,9,5,88,83,171,157
0131-002,2018,9,9,6,165,166,331,171
0131-002,2018,9,9,7,318,307,625,331
0131-002,2018,9,9,8,460,447,907,625
0131-002,2018,9,9,9,502,484,986,907
0131-002,2018,9,9,10,546,510,1056,986
0131-002,2018,9,9,11,616,619,1235,1056
0131-002,2018,9,9,12,632,573,1205,1235
0131-002,2018,9,9,13,620,598,1218,1205
0131-002,2018,9,9,14,682,672,1354,1218
0131-002,2018,9,9,15,643,681,1324,1354
0131-002,2018,9,9,16,822,741,1563,1324
0131-002,2018,9,9,17,930,738,1668,1563
0131-002,2018,9,9,18,969,758,1727,1668
0131-002,2018,9,9,19,1053,687,1740,1727
0131-002,2018,9,9,20,890,635,1525,1740
0131-002,2018,9,9,21,797,516,1313,1525
0131-002,2018,9,9,22,628,395,1023,1313
0131-002,2018,9,9,23,367,261,628,1023
0131-002,2018,9,9,24,245,156,401,628
0131-002,2018,9,10,1,139,102,241,401
0131-002,2018,9,10,2,81,69,150,241
0131-002,2018,9,10,3,52,64,116,150
0131-002,2018,9,10,4,60,60,120,116
0131-002,2018,9,10,5,130,111,241,120
0131-002,2018,9,10,6,383,279,662,241
0131-002,2018,9,10,7,911,544,1455,662
0131-002,2018,9,10,8,1662,1003,2665,1455
0131-002,2018,9,10,9,1644,1152,2796,2665
0131-002,2018,9,10,10,1143,944,2087,2796
0131-002,2018,9,10,11,977,1001,1978,2087
0131-002,2018,9,10,12,932,997,1929,1978
0131-002,2018,9,10,13,702,889,1591,1929
0131-002,2018,9,10,14,751,1021,1772,1591
0131-002,2018,9,10,15,785,1101,1886,1772
0131-002,2018,9,10,16,817,1031,1848,1886
0131-002,2018,9,10,17,894,1073,1967,1848
0131-002,2018,9,10,18,1042,1256,2298,1967
0131-002,2018,9,10,19,1021,1047,2068,2298
0131-002,2018,9,10,20,696,846,1542,2068
0131-002,2018,9,10,21,520,690,1210,1542
0131-002,2018,9,10,22,413,448,861,1210
0131-002,2018,9,10,23,261,312,573,861
0131-002,2018,9,10,24,164,194,358,573
0131-002,2018,9,11,1,133,144,277,358
0131-002,2018,9,11,2,88,97,185,277
0131-002,2018,9,11,3,65,80,145,185
0131-002,2018,9,11,4,66,99,165,145
0131-002,2018,9,11,5,104,133,237,165
0131-002,2018,9,11,6,351,249,600,237
0131-002,2018,9,11,7,790,522,1312,600
0131-002,2018,9,11,8,1726,972,2698,1312
0131-002,2018,9,11,9,1459,1192,2651,2698
0131-002,2018,9,11,10,993,1023,2016,2651
0131-002,2018,9,11,11,932,1051,1983,2016
0131-002,2018,9,11,12,804,995,1799,1983
0131-002,2018,9,11,13,775,903,1678,1799
0131-002,2018,9,11,14,829,976,1805,1678
0131-002,2018,9,11,15,914,1119,2033,1805
0131-002,2018,9,11,16,859,1136,1995,2033
0131-002,2018,9,11,17,924,1112,2036,1995
0131-002,2018,9,11,18,1027,1353,2380,2036
0131-002,2018,9,11,19,1026,1076,2102,2380
0131-002,2018,9,11,20,721,810,1531,2102
0131-002,2018,9,11,21,505,630,1135,1531
0131-002,2018,9,11,22,384,459,843,1135
0131-002,2018,9,11,23,301,325,626,843
0131-002,2018,9,11,24,191,191,382,626
0131-002,2018,9,12,1,148,159,307,382
0131-002,2018,9,12,2,84,107,191,307
0131-002,2018,9,12,3,69,82,151,191
0131-002,2018,9,12,4,65,87,152,151
0131-002,2018,9,12,5,125,126,251,152
0131-002,2018,9,12,6,349,259,608,251
0131-002,2018,9,12,7,775,517,1292,608
0131-002,2018,9,12,8,1433,1004,2437,1292
0131-002,2018,9,12,9,1311,1100,2411,2437
0131-002,2018,9,12,10,980,1045,2025,2411
0131-002,2018,9,12,11,859,1040,1899,2025
0131-002,2018,9,12,12,795,969,1764,1899
0131-002,2018,9,12,13,701,867,1568,1764
0131-002,2018,9,12,14,831,986,1817,1568
0131-002,2018,9,12,15,901,1092,1993,1817
0131-002,2018,9,12,16,917,1067,1984,1993
0131-002,2018,9,12,17,884,1069,1953,1984
0131-002,2018,9,12,18,1059,1443,2502,1953
0131-002,2018,9,12,19,1074,1108,2182,2502
0131-002,2018,9,12,20,706,818,1524,2182
0131-002,2018,9,12,21,504,624,1128,1524
0131-002,2018,9,12,22,418,453,871,1128
0131-002,2018,9,12,23,266,320,586,871
0131-002,2018,9,12,24,188,192,380,586
0131-002,2018,9,13,1,156,145,301,380
0131-002,2018,9,13,2,86,110,196,301
0131-002,2018,9,13,3,70,85,155,196
0131-002,2018,9,13,4,80,101,181,155
0131-002,2018,9,13,5,120,126,246,181
0131-002,2018,9,13,6,355,254,609,246
0131-002,2018,9,13,7,732,503,1235,609
0131-002,2018,9,13,8,1506,1001,2507,1235
0131-002,2018,9,13,9,1214,1186,2400,2507
0131-002,2018,9,13,10,858,978,1836,2400
0131-002,2018,9,13,11,898,1055,1953,1836
0131-002,2018,9,13,12,890,982,1872,1953
0131-002,2018,9,13,13,693,932,1625,1872
0131-002,2018,9,13,14,828,971,1799,1625
0131-002,2018,9,13,15,929,1159,2088,1799
0131-002,2018,9,13,16,907,1135,2042,2088
0131-002,2018,9,13,17,938,1088,2026,2042
0131-002,2018,9,13,18,1045,1254,2299,2026
0131-002,2018,9,13,19,1055,1093,2148,2299
0131-002,2018,9,13,20,775,896,1671,2148
0131-002,2018,9,13,21,547,685,1232,1671
0131-002,2018,9,13,22,484,497,981,1232
0131-002,2018,9,13,23,327,299,626,981
0131-002,2018,9,13,24,200,218,418,626
0131-002,2018,9,14,1,136,152,288,418
0131-002,2018,9,14,2,108,103,211,288
0131-002,2018,9,14,3,81,80,161,211
0131-002,2018,9,14,4,68,110,178,161
0131-002,2018,9,14,5,133,130,263,178
0131-002,2018,9,14,6,339,269,608,263
0131-002,2018,9,14,7,753,475,1228,608
0131-002,2018,9,14,8,1445,1015,2460,1228
0131-002,2018,9,14,9,1257,1281,2538,2460
0131-002,2018,9,14,10,925,1023,1948,2538
0131-002,2018,9,14,11,921,1110,2031,1948
0131-002,2018,9,14,12,911,956,1867,2031
0131-002,2018,9,14,13,768,931,1699,1867
0131-002,2018,9,14,14,926,995,1921,1699
0131-002,2018,9,14,15,952,1155,2107,1921
0131-002,2018,9,14,16,969,1143,2112,2107
0131-002,2018,9,14,17,1005,1126,2131,2112
0131-002,2018,9,14,18,1135,1515,2650,2131
0131-002,2018,9,14,19,1306,1375,2681,2650
0131-002,2018,9,14,20,856,951,1807,2681
0131-002,2018,9,14,21,594,839,1433,1807
0131-002,2018,9,14,22,444,514,958,1433
0131-002,2018,9,14,23,340,320,660,958
0131-002,2018,9,14,24,239,233,472,660
0131-002,2018,9,15,1,156,160,316,472
0131-002,2018,9,15,2,101,136,237,316
0131-002,2018,9,15,3,88,110,198,237
0131-002,2018,9,15,4,96,87,183,198
0131-002,2018,9,15,5,119,144,263,183
0131-002,2018,9,15,6,297,256,553,263
0131-002,2018,9,15,7,470,402,872,553
0131-002,2018,9,15,8,740,700,1440,872
0131-002,2018,9,15,9,741,888,1629,1440
0131-002,2018,9,15,10,790,955,1745,1629
0131-002,2018,9,15,11,898,1044,1942,1745
0131-002,2018,9,15,12,848,980,1828,1942
0131-002,2018,9,15,13,830,933,1763,1828
0131-002,2018,9,15,14,805,801,1606,1763
0131-002,2018,9,15,15,830,790,1620,1606
0131-002,2018,9,15,16,879,881,1760,1620
0131-002,2018,9,15,17,885,940,1825,1760
0131-002,2018,9,15,18,978,1049,2027,1825
0131-002,2018,9,15,19,840,850,1690,2027
0131-002,2018,9,15,20,650,585,1235,1690
0131-002,2018,9,15,21,463,463,926,1235
0131-002,2018,9,15,22,312,390,702,926
0131-002,2018,9,15,23,273,264,537,702
0131-002,2018,9,15,24,190,204,394,537
0131-002,2018,9,16,1,157,147,304,394
0131-002,2018,9,16,2,127,117,244,304
0131-002,2018,9,16,3,96,82,178,244
0131-002,2018,9,16,4,83,72,155,178
0131-002,2018,9,16,5,93,87,180,155
0131-002,2018,9,16,6,187,168,355,180
0131-002,2018,9,16,7,271,270,541,355
0131-002,2018,9,16,8,376,441,817,541
0131-002,2018,9,16,9,400,543,943,817
0131-002,2018,9,16,10,426,562,988,943
0131-002,2018,9,16,11,539,625,1164,988
0131-002,2018,9,16,12,552,625,1177,1164
0131-002,2018,9,16,13,589,667,1256,1177
0131-002,2018,9,16,14,664,706,1370,1256
0131-002,2018,9,16,15,712,746,1458,1370
0131-002,2018,9,16,16,797,723,1520,1458
0131-002,2018,9,16,17,838,756,1594,1520
0131-002,2018,9,16,18,901,812,1713,1594
0131-002,2018,9,16,19,899,630,1529,1713
0131-002,2018,9,16,20,658,536,1194,1529
0131-002,2018,9,16,21,513,457,970,1194
0131-002,2018,9,16,22,387,322,709,970
0131-002,2018,9,16,23,285,239,524,709
0131-002,2018,9,16,24,196,165,361,524
0131-002,2018,9,17,1,121,99,220,361
0131-002,2018,9,17,2,83,32,115,220
0131-002,2018,9,17,3,54,51,105,115
0131-002,2018,9,17,4,72,104,176,105
0131-002,2018,9,17,5,119,136,255,176
0131-002,2018,9,17,6,403,264,667,255
0131-002,2018,9,17,7,906,549,1455,667
0131-002,2018,9,17,8,1582,1074,2656,1455
0131-002,2018,9,17,9,1291,1109,2400,2656
0131-002,2018,9,17,10,879,942,1821,2400
0131-002,2018,9,17,11,838,978,1816,1821
0131-002,2018,9,17,12,820,942,1762,1816
0131-002,2018,9,17,13,783,846,1629,1762
0131-002,2018,9,17,14,957,915,1872,1629
0131-002,2018,9,17,15,1072,1050,2122,1872
0131-002,2018,9,17,16,1021,1096,2117,2122
0131-002,2018,9,17,17,908,1146,2054,2117
0131-002,2018,9,17,18,1000,1181,2181,2054
0131-002,2018,9,17,19,986,1051,2037,2181
0131-002,2018,9,17,20,732,848,1580,2037
0131-002,2018,9,17,21,531,699,1230,1580
0131-002,2018,9,17,22,461,521,982,1230
0131-002,2018,9,17,23,310,301,611,982
0131-002,2018,9,17,24,184,207,391,611
0131-002,2018,9,18,1,139,139,278,391
0131-002,2018,9,18,2,91,96,187,278
0131-002,2018,9,18,3,72,86,158,187
0131-002,2018,9,18,4,89,94,183,158
0131-002,2018,9,18,5,123,150,273,183
0131-002,2018,9,18,6,348,252,600,273
0131-002,2018,9,18,7,745,531,1276,600
0131-002,2018,9,18,8,1584,1008,2592,1276
0131-002,2018,9,18,9,1364,1105,2469,2592
0131-002,2018,9,18,10,935,1042,1977,2469
0131-002,2018,9,18,11,1008,1096,2104,1977
0131-002,2018,9,18,12,949,989,1938,2104
0131-002,2018,9,18,13,819,868,1687,1938
0131-002,2018,9,18,14,876,1043,1919,1687
0131-002,2018,9,18,15,965,1145,2110,1919
0131-002,2018,9,18,16,931,1038,1969,2110
0131-002,2018,9,18,17,982,1069,2051,1969
0131-002,2018,9,18,18,1056,1289,2345,2051
0131-002,2018,9,18,19,1073,1103,2176,2345
0131-002,2018,9,18,20,753,834,1587,2176
0131-002,2018,9,18,21,524,729,1253,1587
0131-002,2018,9,18,22,467,476,943,1253
0131-002,2018,9,18,23,301,364,665,943
0131-002,2018,9,18,24,210,217,427,665
0131-002,2018,9,19,1,148,139,287,427
0131-002,2018,9,19,2,123,107,230,287
0131-002,2018,9,19,3,76,92,168,230
0131-002,2018,9,19,4,88,100,188,168
0131-002,2018,9,19,5,129,133,262,188
0131-002,2018,9,19,6,368,259,627,262
0131-002,2018,9,19,7,787,510,1297,627
0131-002,2018,9,19,8,1584,1015,2599,1297
0131-002,2018,9,19,9,1299,1147,2446,2599
0131-002,2018,9,19,10,919,1041,1960,2446
0131-002,2018,9,19,11,940,1195,2135,1960
0131-002,2018,9,19,12,939,1148,2087,2135
0131-002,2018,9,19,13,787,962,1749,2087
0131-002,2018,9,19,14,947,995,1942,1749
0131-002,2018,9,19,15,971,1190,2161,1942
0131-002,2018,9,19,16,977,1103,2080,2161
0131-002,2018,9,19,17,947,1233,2180,2080
0131-002,2018,9,19,18,1104,1449,2553,2180
0131-002,2018,9,19,19,1162,1195,2357,2553
0131-002,2018,9,19,20,800,813,1613,2357
0131-002,2018,9,19,21,541,699,1240,1613
0131-002,2018,9,19,22,462,496,958,1240
0131-002,2018,9,19,23,333,362,695,958
0131-002,2018,9,19,24,242,245,487,695
0131-002,2018,9,20,1,129,170,299,487
0131-002,2018,9,20,2,114,118,232,299
0131-002,2018,9,20,3,75,96,171,232
0131-002,2018,9,20,4,73,93,166,171
0131-002,2018,9,20,5,133,118,251,166
0131-002,2018,9,20,6,293,249,542,251
0131-002,2018,9,20,7,688,506,1194,542
0131-002,2018,9,20,8,1437,1074,2511,1194
0131-002,2018,9,20,9,1209,1307,2516,2511
0131-002,2018,9,20,10,961,1059,2020,2516
0131-002,2018,9,20,11,992,1129,2121,2020
0131-002,2018,9,20,12,864,1120,1984,2121
0131-002,2018,9,20,13,837,1020,1857,1984
0131-002,2018,9,20,14,953,1105,2058,1857
0131-002,2018,9,20,15,1011,1152,2163,2058
0131-002,2018,9,20,16,1060,1269,2329,2163
0131-002,2018,9,20,17,994,1170,2164,2329
0131-002,2018,9,20,18,1142,1442,2584,2164
0131-002,2018,9,20,19,1053,1164,2217,2584
0131-002,2018,9,20,20,693,808,1501,2217
0131-002,2018,9,20,21,534,669,1203,1501
0131-002,2018,9,20,22,469,484,953,1203
0131-002,2018,9,20,23,284,316,600,953
0131-002,2018,9,20,24,199,217,416,600
0131-002,2018,9,21,1,159,170,329,416
0131-002,2018,9,21,2,114,98,212,329
0131-002,2018,9,21,3,83,93,176,212
0131-002,2018,9,21,4,64,108,172,176
0131-002,2018,9,21,5,119,131,250,172
0131-002,2018,9,21,6,257,214,471,250
0131-002,2018,9,21,7,610,466,1076,471
0131-002,2018,9,21,8,1269,1129,2398,1076
0131-002,2018,9,21,9,1209,1245,2454,2398
0131-002,2018,9,21,10,773,1083,1856,2454
0131-002,2018,9,21,11,866,1133,1999,1856
0131-002,2018,9,21,12,809,1112,1921,1999
0131-002,2018,9,21,13,736,991,1727,1921
0131-002,2018,9,21,14,950,1113,2063,1727
0131-002,2018,9,21,15,913,1147,2060,2063
0131-002,2018,9,21,16,1097,1250,2347,2060
0131-002,2018,9,21,17,1028,1263,2291,2347
0131-002,2018,9,21,18,1149,1175,2324,2291
0131-002,2018,9,21,19,990,888,1878,2324
0131-002,2018,9,21,20,640,736,1376,1878
0131-002,2018,9,21,21,483,629,1112,1376
0131-002,2018,9,21,22,387,427,814,1112
0131-002,2018,9,21,23,343,355,698,814
0131-002,2018,9,21,24,207,221,428,698
0131-002,2018,9,22,1,163,197,360,428
0131-002,2018,9,22,2,120,135,255,360
0131-002,2018,9,22,3,99,98,197,255
0131-002,2018,9,22,4,97,130,227,197
0131-002,2018,9,22,5,115,171,286,227
0131-002,2018,9,22,6,210,249,459,286
0131-002,2018,9,22,7,416,350,766,459
0131-002,2018,9,22,8,626,592,1218,766
0131-002,2018,9,22,9,675,709,1384,1218
0131-002,2018,9,22,10,603,825,1428,1384
0131-002,2018,9,22,11,808,787,1595,1428
0131-002,2018,9,22,12,782,716,1498,1595
0131-002,2018,9,22,13,829,719,1548,1498
0131-002,2018,9,22,14,767,707,1474,1548
0131-002,2018,9,22,15,756,708,1464,1474
0131-002,2018,9,22,16,788,738,1526,1464
0131-002,2018,9,22,17,683,731,1414,1526
0131-002,2018,9,22,18,640,672,1312,1414
0131-002,2018,9,22,19,554,564,1118,1312
0131-002,2018,9,22,20,520,446,966,1118
0131-002,2018,9,22,21,345,432,777,966
0131-002,2018,9,22,22,271,321,592,777
0131-002,2018,9,22,23,234,278,512,592
0131-002,2018,9,22,24,160,201,361,512
0131-002,2018,9,23,1,128,144,272,361
0131-002,2018,9,23,2,109,129,238,272
0131-002,2018,9,23,3,75,94,169,238
0131-002,2018,9,23,4,64,93,157,169
0131-002,2018,9,23,5,52,133,185,157
0131-002,2018,9,23,6,121,180,301,185
0131-002,2018,9,23,7,196,273,469,301
0131-002,2018,9,23,8,223,372,595,469
0131-002,2018,9,23,9,337,499,836,595
0131-002,2018,9,23,10,452,528,980,836
0131-002,2018,9,23,11,528,555,1083,980
0131-002,2018,9,23,12,530,545,1075,1083
0131-002,2018,9,23,13,526,528,1054,1075
0131-002,2018,9,23,14,491,550,1041,1054
0131-002,2018,9,23,15,474,506,980,1041
0131-002,2018,9,23,16,491,526,1017,980
0131-002,2018,9,23,17,460,511,971,1017
0131-002,2018,9,23,18,437,442,879,971
0131-002,2018,9,23,19,373,400,773,879
0131-002,2018,9,23,20,358,330,688,773
0131-002,2018,9,23,21,286,336,622,688
0131-002,2018,9,23,22,226,242,468,622
0131-002,2018,9,23,23,141,155,296,468
0131-002,2018,9,23,24,106,131,237,296
0131-002,2018,9,24,1,86,87,173,237
0131-002,2018,9,24,2,54,60,114,173
0131-002,2018,9,24,3,46,43,89,114
0131-002,2018,9,24,4,43,50,93,89
0131-002,2018,9,24,5,33,58,91,93
0131-002,2018,9,24,6,74,103,177,91
0131-002,2018,9,24,7,219,230,449,177
0131-002,2018,9,24,8,398,399,797,449
0131-002,2018,9,24,9,352,438,790,797
0131-002,2018,9,24,10,395,595,990,790
0131-002,2018,9,24,11,639,798,1437,990
0131-002,2018,9,24,12,935,1006,1941,1437
0131-002,2018,9,24,13,913,1030,1943,1941
0131-002,2018,9,24,14,957,1136,2093,1943
0131-002,2018,9,24,15,917,997,1914,2093
0131-002,2018,9,24,16,1222,881,2103,1914
0131-002,2018,9,24,17,945,862,1807,2103
0131-002,2018,9,24,18,902,916,1818,1807
0131-002,2018,9,24,19,882,731,1613,1818
0131-002,2018,9,24,20,900,544,1444,1613
0131-002,2018,9,24,21,658,523,1181,1444
0131-002,2018,9,24,22,814,384,1198,1181
0131-002,2018,9,24,23,707,250,957,1198
0131-002,2018,9,24,24,454,145,599,957
0131-002,2018,9,25,1,253,138,391,599
0131-002,2018,9,25,2,176,73,249,391
0131-002,2018,9,25,3,96,51,147,249
0131-002,2018,9,25,4,73,37,110,147
0131-002,2018,9,25,5,49,63,112,110
0131-002,2018,9,25,6,80,63,143,112
0131-002,2018,9,25,7,165,130,295,143
0131-002,2018,9,25,8,214,245,459,295
0131-002,2018,9,25,9,245,297,542,459
0131-002,2018,9,25,10,347,379,726,542
0131-002,2018,9,25,11,442,504,946,726
0131-002,2018,9,25,12,615,569,1184,946
0131-002,2018,9,25,13,646,543,1189,1184
0131-002,2018,9,25,14,705,550,1255,1189
0131-002,2018,9,25,15,1017,624,1641,1255
0131-002,2018,9,25,16,1015,659,1674,1641
0131-002,2018,9,25,17,1020,650,1670,1674
0131-002,2018,9,25,18,1053,662,1715,1670
0131-002,2018,9,25,19,953,580,1533,1715
0131-002,2018,9,25,20,960,571,1531,1533
0131-002,2018,9,25,21,642,456,1098,1531
0131-002,2018,9,25,22,699,380,1079,1098
0131-002,2018,9,25,23,565,285,850,1079
0131-002,2018,9,25,24,458,184,642,850
0131-002,2018,9,26,1,308,118,426,642
0131-002,2018,9,26,2,263,97,360,426
0131-002,2018,9,26,3,96,81,177,360
0131-002,2018,9,26,4,80,66,146,177
0131-002,2018,9,26,5,88,72,160,146
0131-002,2018,9,26,6,122,121,243,160
0131-002,2018,9,26,7,218,202,420,243
0131-002,2018,9,26,8,359,369,728,420
0131-002,2018,9,26,9,363,387,750,728
0131-002,2018,9,26,10,413,467,880,750
0131-002,2018,9,26,11,516,539,1055,880
0131-002,2018,9,26,12,557,598,1155,1055
0131-002,2018,9,26,13,596,597,1193,1155
0131-002,2018,9,26,14,601,635,1236,1193
0131-002,2018,9,26,15,660,673,1333,1236
0131-002,2018,9,26,16,666,698,1364,1333
0131-002,2018,9,26,17,612,681,1293,1364
0131-002,2018,9,26,18,672,681,1353,1293
0131-002,2018,9,26,19,654,567,1221,1353
0131-002,2018,9,26,20,510,460,970,1221
0131-002,2018,9,26,21,467,441,908,970
0131-002,2018,9,26,22,374,324,698,908
0131-002,2018,9,26,23,267,206,473,698
0131-002,2018,9,26,24,191,144,335,473
0131-002,2018,9,27,1,133,96,229,335
0131-002,2018,9,27,2,80,60,140,229
0131-002,2018,9,27,3,66,61,127,140
0131-002,2018,9,27,4,55,79,134,127
0131-002,2018,9,27,5,109,113,222,134
0131-002,2018,9,27,6,355,228,583,222
0131-002,2018,9,27,7,720,474,1194,583
0131-002,2018,9,27,8,1462,918,2380,1194
0131-002,2018,9,27,9,1185,938,2123,2380
0131-002,2018,9,27,10,804,916,1720,2123
0131-002,2018,9,27,11,800,956,1756,1720
0131-002,2018,9,27,12,768,868,1636,1756
0131-002,2018,9,27,13,662,817,1479,1636
0131-002,2018,9,27,14,765,841,1606,1479
0131-002,2018,9,27,15,848,931,1779,1606
0131-002,2018,9,27,16,836,872,1708,1779
0131-002,2018,9,27,17,812,955,1767,1708
0131-002,2018,9,27,18,1020,1116,2136,1767
0131-002,2018,9,27,19,907,1019,1926,2136
0131-002,2018,9,27,20,635,724,1359,1926
0131-002,2018,9,27,21,463,585,1048,1359
0131-002,2018,9,27,22,359,399,758,1048
0131-002,2018,9,27,23,255,293,548,758
0131-002,2018,9,27,24,180,154,334,548
0131-002,2018,9,28,1,115,108,223,334
0131-002,2018,9,28,2,83,97,180,223
0131-002,2018,9,28,3,58,70,128,180
0131-002,2018,9,28,4,70,74,144,128
0131-002,2018,9,28,5,121,130,251,144
0131-002,2018,9,28,6,343,240,583,251
0131-002,2018,9,28,7,783,464,1247,583
0131-002,2018,9,28,8,1381,955,2336,1247
0131-002,2018,9,28,9,1210,1055,2265,2336
0131-002,2018,9,28,10,859,921,1780,2265
0131-002,2018,9,28,11,851,1026,1877,1780
0131-002,2018,9,28,12,752,998,1750,1877
0131-002,2018,9,28,13,705,880,1585,1750
0131-002,2018,9,28,14,850,956,1806,1585
0131-002,2018,9,28,15,877,1030,1907,1806
0131-002,2018,9,28,16,895,1022,1917,1907
0131-002,2018,9,28,17,852,1023,1875,1917
0131-002,2018,9,28,18,1043,1347,2390,1875
0131-002,2018,9,28,19,1121,1159,2280,2390
0131-002,2018,9,28,20,735,894,1629,2280
0131-002,2018,9,28,21,507,660,1167,1629
0131-002,2018,9,28,22,396,426,822,1167
0131-002,2018,9,28,23,270,317,587,822
0131-002,2018,9,28,24,203,193,396,587
0131-002,2018,9,29,1,178,180,358,396
0131-002,2018,9,29,2,101,127,228,358
0131-002,2018,9,29,3,106,100,206,228
0131-002,2018,9,29,4,97,96,193,206
0131-002,2018,9,29,5,123,134,257,193
0131-002,2018,9,29,6,309,221,530,257
0131-002,2018,9,29,7,560,405,965,530
0131-002,2018,9,29,8,803,625,1428,965
0131-002,2018,9,29,9,784,757,1541,1428
0131-002,2018,9,29,10,679,808,1487,1541
0131-002,2018,9,29,11,657,837,1494,1487
0131-002,2018,9,29,12,744,757,1501,1494
0131-002,2018,9,29,13,685,754,1439,1501
0131-002,2018,9,29,14,783,748,1531,1439
0131-002,2018,9,29,15,673,787,1460,1531
0131-002,2018,9,29,16,721,781,1502,1460
0131-002,2018,9,29,17,772,823,1595,1502
0131-002,2018,9,29,18,843,980,1823,1595
0131-002,2018,9,29,19,795,815,1610,1823
0131-002,2018,9,29,20,592,589,1181,1610
0131-002,2018,9,29,21,454,469,923,1181
0131-002,2018,9,29,22,330,350,680,923
0131-002,2018,9,29,23,248,261,509,680
0131-002,2018,9,29,24,177,197,374,509
0131-002,2018,9,30,1,119,129,248,374
0131-002,2018,9,30,2,97,112,209,248
0131-002,2018,9,30,3,70,66,136,209
0131-002,2018,9,30,4,69,68,137,136
0131-002,2018,9,30,5,88,101,189,137
0131-002,2018,9,30,6,194,125,319,189
0131-002,2018,9,30,7,297,237,534,319
0131-002,2018,9,30,8,333,344,677,534
0131-002,2018,9,30,9,363,428,791,677
0131-002,2018,9,30,10,420,521,941,791
0131-002,2018,9,30,11,505,586,1091,941
0131-002,2018,9,30,12,567,531,1098,1091
0131-002,2018,9,30,13,562,555,1117,1098
0131-002,2018,9,30,14,578,636,1214,1117
0131-002,2018,9,30,15,579,630,1209,1214
0131-002,2018,9,30,16,674,714,1388,1209
0131-002,2018,9,30,17,710,710,1420,1388
0131-002,2018,9,30,18,678,738,1416,1420
0131-002,2018,9,30,19,699,625,1324,1416
0131-002,2018,9,30,20,541,498,1039,1324
0131-002,2018,9,30,21,457,425,882,1039
0131-002,2018,9,30,22,376,313,689,882
0131-002,2018,9,30,23,266,203,469,689
0131-002,2018,9,30,24,168,133,301,469
0131-002,2018,10,1,1,101,99,200,301
0131-002,2018,10,1,2,56,66,122,200
0131-002,2018,10,1,3,51,40,91,122
0131-002,2018,10,1,4,38,62,100,91
0131-002,2018,10,1,5,119,109,228,100
0131-002,2018,10,1,6,393,234,627,228
0131-002,2018,10,1,7,741,554,1295,627
0131-002,2018,10,1,8,1571,1125,2696,1295
0131-002,2018,10,1,9,1294,1171,2465,2696
0131-002,2018,10,1,10,941,948,1889,2465
0131-002,2018,10,1,11,796,1014,1810,1889
0131-002,2018,10,1,12,751,911,1662,1810
0131-002,2018,10,1,13,689,842,1531,1662
0131-002,2018,10,1,14,785,988,1773,1531
0131-002,2018,10,1,15,877,980,1857,1773
0131-002,2018,10,1,16,844,927,1771,1857
0131-002,2018,10,1,17,849,1049,1898,1771
0131-002,2018,10,1,18,997,1170,2167,1898
0131-002,2018,10,1,19,1007,1153,2160,2167
0131-002,2018,10,1,20,599,816,1415,2160
0131-002,2018,10,1,21,490,606,1096,1415
0131-002,2018,10,1,22,384,409,793,1096
0131-002,2018,10,1,23,238,262,500,793
0131-002,2018,10,1,24,162,181,343,500
0131-002,2018,10,2,1,122,116,238,343
0131-002,2018,10,2,2,85,81,166,238
0131-002,2018,10,2,3,56,80,136,166
0131-002,2018,10,2,4,61,79,140,136
0131-002,2018,10,2,5,133,120,253,140
0131-002,2018,10,2,6,315,227,542,253
0131-002,2018,10,2,7,730,468,1198,542
0131-002,2018,10,2,8,1479,984,2463,1198
0131-002,2018,10,2,9,1244,1095,2339,2463
0131-002,2018,10,2,10,898,1002,1900,2339
0131-002,2018,10,2,11,909,1035,1944,1900
0131-002,2018,10,2,12,794,893,1687,1944
0131-002,2018,10,2,13,780,864,1644,1687
0131-002,2018,10,2,14,907,933,1840,1644
0131-002,2018,10,2,15,977,1065,2042,1840
0131-002,2018,10,2,16,947,1124,2071,2042
0131-002,2018,10,2,17,911,1055,1966,2071
0131-002,2018,10,2,18,1164,1359,2523,1966
0131-002,2018,10,2,19,1065,1288,2353,2523
0131-002,2018,10,2,20,792,867,1659,2353
0131-002,2018,10,2,21,556,702,1258,1659
0131-002,2018,10,2,22,439,456,895,1258
0131-002,2018,10,2,23,290,298,588,895
0131-002,2018,10,2,24,188,205,393,588
0131-002,2018,10,3,1,131,163,294,393
0131-002,2018,10,3,2,118,99,217,294
0131-002,2018,10,3,3,70,76,146,217
0131-002,2018,10,3,4,79,91,170,146
0131-002,2018,10,3,5,153,122,275,170
0131-002,2018,10,3,6,318,190,508,275
0131-002,2018,10,3,7,523,390,913,508
0131-002,2018,10,3,8,833,620,1453,913
0131-002,2018,10,3,9,689,644,1333,1453
0131-002,2018,10,3,10,650,715,1365,1333
0131-002,2018,10,3,11,680,697,1377,1365
0131-002,2018,10,3,12,724,747,1471,1377
0131-002,2018,10,3,13,595,692,1287,1471
0131-002,2018,10,3,14,623,693,1316,1287
0131-002,2018,10,3,15,679,744,1423,1316
0131-002,2018,10,3,16,709,805,1514,1423
0131-002,2018,10,3,17,734,863,1597,1514
0131-002,2018,10,3,18,837,935,1772,1597
0131-002,2018,10,3,19,757,770,1527,1772
0131-002,2018,10,3,20,517,649,1166,1527
0131-002,2018,10,3,21,396,489,885,1166
0131-002,2018,10,3,22,358,341,699,885
0131-002,2018,10,3,23,274,242,516,699
0131-002,2018,10,3,24,169,157,326,516
0131-002,2018,10,4,1,117,99,216,326
0131-002,2018,10,4,2,77,79,156,216
0131-002,2018,10,4,3,55,69,124,156
0131-002,2018,10,4,4,81,71,152,124
0131-002,2018,10,4,5,114,119,233,152
0131-002,2018,10,4,6,392,244,636,233
0131-002,2018,10,4,7,762,471,1233,636
0131-002,2018,10,4,8,1490,994,2484,1233
0131-002,2018,10,4,9,1330,1083,2413,2484
0131-002,2018,10,4,10,886,949,1835,2413
0131-002,2018,10,4,11,898,958,1856,1835
0131-002,2018,10,4,12,803,968,1771,1856
0131-002,2018,10,4,13,668,837,1505,1771
0131-002,2018,10,4,14,858,904,1762,1505
0131-002,2018,10,4,15,963,1053,2016,1762
0131-002,2018,10,4,16,913,1093,2006,2016
0131-002,2018,10,4,17,939,1132,2071,2006
0131-002,2018,10,4,18,1054,1192,2246,2071
0131-002,2018,10,4,19,1041,1142,2183,2246
0131-002,2018,10,4,20,721,851,1572,2183
0131-002,2018,10,4,21,505,627,1132,1572
0131-002,2018,10,4,22,420,450,870,1132
0131-002,2018,10,4,23,278,319,597,870
0131-002,2018,10,4,24,187,214,401,597
0131-002,2018,10,5,1,144,153,297,401
0131-002,2018,10,5,2,119,101,220,297
0131-002,2018,10,5,3,68,80,148,220
0131-002,2018,10,5,4,82,87,169,148
0131-002,2018,10,5,5,100,127,227,169
0131-002,2018,10,5,6,278,235,513,227
0131-002,2018,10,5,7,630,465,1095,513
0131-002,2018,10,5,8,1393,1004,2397,1095
0131-002,2018,10,5,9,1176,1339,2515,2397
0131-002,2018,10,5,10,765,948,1713,2515
0131-002,2018,10,5,11,777,942,1719,1713
0131-002,2018,10,5,12,752,909,1661,1719
0131-002,2018,10,5,13,656,915,1571,1661
0131-002,2018,10,5,14,765,955,1720,1571
0131-002,2018,10,5,15,886,987,1873,1720
0131-002,2018,10,5,16,836,1080,1916,1873
0131-002,2018,10,5,17,829,1066,1895,1916
0131-002,2018,10,5,18,984,1491,2475,1895
0131-002,2018,10,5,19,1127,1271,2398,2475
0131-002,2018,10,5,20,721,881,1602,2398
0131-002,2018,10,5,21,483,752,1235,1602
0131-002,2018,10,5,22,388,459,847,1235
0131-002,2018,10,5,23,253,273,526,847
0131-002,2018,10,5,24,175,175,350,526
0131-002,2018,10,6,1,144,128,272,350
0131-002,2018,10,6,2,85,113,198,272
0131-002,2018,10,6,3,76,87,163,198
0131-002,2018,10,6,4,72,69,141,163
0131-002,2018,10,6,5,67,104,171,141
0131-002,2018,10,6,6,193,146,339,171
0131-002,2018,10,6,7,253,297,550,339
0131-002,2018,10,6,8,499,498,997,550
0131-002,2018,10,6,9,544,737,1281,997
0131-002,2018,10,6,10,565,811,1376,1281
0131-002,2018,10,6,11,549,797,1346,1376
0131-002,2018,10,6,12,606,724,1330,1346
0131-002,2018,10,6,13,637,636,1273,1330
0131-002,2018,10,6,14,627,694,1321,1273
0131-002,2018,10,6,15,679,700,1379,1321
0131-002,2018,10,6,16,700,674,1374,1379
0131-002,2018,10,6,17,720,728,1448,1374
0131-002,2018,10,6,18,734,807,1541,1448
0131-002,2018,10,6,19,708,599,1307,1541
0131-002,2018,10,6,20,447,463,910,1307
0131-002,2018,10,6,21,399,386,785,910
0131-002,2018,10,6,22,297,296,593,785
0131-002,2018,10,6,23,220,222,442,593
0131-002,2018,10,6,24,177,176,353,442
0131-002,2018,10,7,1,123,150,273,353
0131-002,2018,10,7,2,117,87,204,273
0131-002,2018,10,7,3,88,77,165,204
0131-002,2018,10,7,4,92,74,166,165
0131-002,2018,10,7,5,75,83,158,166
0131-002,2018,10,7,6,175,135,310,158
0131-002,2018,10,7,7,289,235,524,310
0131-002,2018,10,7,8,442,392,834,524
0131-002,2018,10,7,9,397,528,925,834
0131-002,2018,10,7,10,462,521,983,925
0131-002,2018,10,7,11,533,587,1120,983
0131-002,2018,10,7,12,577,612,1189,1120
0131-002,2018,10,7,13,552,591,1143,1189
0131-002,2018,10,7,14,622,616,1238,1143
0131-002,2018,10,7,15,669,676,1345,1238
0131-002,2018,10,7,16,680,699,1379,1345
0131-002,2018,10,7,17,749,704,1453,1379
0131-002,2018,10,7,18,736,743,1479,1453
0131-002,2018,10,7,19,718,638,1356,1479
0131-002,2018,10,7,20,545,524,1069,1356
0131-002,2018,10,7,21,423,419,842,1069
0131-002,2018,10,7,22,390,294,684,842
0131-002,2018,10,7,23,283,214,497,684
0131-002,2018,10,7,24,176,137,313,497
0131-002,2018,10,8,1,108,87,195,313
0131-002,2018,10,8,2,68,62,130,195
0131-002,2018,10,8,3,52,60,112,130
0131-002,2018,10,8,4,68,67,135,112
0131-002,2018,10,8,5,149,105,254,135
0131-002,2018,10,8,6,352,235,587,254
0131-002,2018,10,8,7,869,504,1373,587
0131-002,2018,10,8,8,1650,916,2566,1373
0131-002,2018,10,8,9,1415,1001,2416,2566
0131-002,2018,10,8,10,974,873,1847,2416
0131-002,2018,10,8,11,934,942,1876,1847
0131-002,2018,10,8,12,873,943,1816,1876
0131-002,2018,10,8,13,761,857,1618,1816
0131-002,2018,10,8,14,856,841,1697,1618
0131-002,2018,10,8,15,842,1013,1855,1697
0131-002,2018,10,8,16,941,943,1884,1855
0131-002,2018,10,8,17,919,965,1884,1884
0131-002,2018,10,8,18,1076,1211,2287,1884
0131-002,2018,10,8,19,1072,1167,2239,2287
0131-002,2018,10,8,20,729,832,1561,2239
0131-002,2018,10,8,21,527,639,1166,1561
0131-002,2018,10,8,22,396,433,829,1166
0131-002,2018,10,8,23,305,316,621,829
0131-002,2018,10,8,24,185,189,374,621
0131-002,2018,10,9,1,120,159,279,374
0131-002,2018,10,9,2,101,110,211,279
0131-002,2018,10,9,3,76,84,160,211
0131-002,2018,10,9,4,79,100,179,160
0131-002,2018,10,9,5,120,128,248,179
0131-002,2018,10,9,6,317,198,515,248
0131-002,2018,10,9,7,509,380,889,515
0131-002,2018,10,9,8,762,635,1397,889
0131-002,2018,10,9,9,711,624,1335,1397
0131-002,2018,10,9,10,637,625,1262,1335
0131-002,2018,10,9,11,670,668,1338,1262
0131-002,2018,10,9,12,690,627,1317,1338
0131-002,2018,10,9,13,627,680,1307,1317
0131-002,2018,10,9,14,692,706,1398,1307
0131-002,2018,10,9,15,695,710,1405,1398
0131-002,2018,10,9,16,777,810,1587,1405
0131-002,2018,10,9,17,760,806,1566,1587
0131-002,2018,10,9,18,845,998,1843,1566
0131-002,2018,10,9,19,663,769,1432,1843
0131-002,2018,10,9,20,553,530,1083,1432
0131-002,2018,10,9,21,423,477,900,1083
0131-002,2018,10,9,22,318,333,651,900
0131-002,2018,10,9,23,229,206,435,651
0131-002,2018,10,9,24,137,135,272,435
0131-002,2018,10,10,1,103,129,232,272
0131-002,2018,10,10,2,57,82,139,232
0131-002,2018,10,10,3,56,60,116,139
0131-002,2018,10,10,4,68,58,126,116
0131-002,2018,10,10,5,108,115,223,126
0131-002,2018,10,10,6,382,227,609,223
0131-002,2018,10,10,7,767,494,1261,609
0131-002,2018,10,10,8,1438,998,2436,1261
0131-002,2018,10,10,9,1179,1091,2270,2436
0131-002,2018,10,10,10,908,921,1829,2270
0131-002,2018,10,10,11,907,936,1843,1829
0131-002,2018,10,10,12,798,895,1693,1843
0131-002,2018,10,10,13,709,801,1510,1693
0131-002,2018,10,10,14,851,908,1759,1510
0131-002,2018,10,10,15,920,975,1895,1759
0131-002,2018,10,10,16,890,962,1852,1895
0131-002,2018,10,10,17,893,957,1850,1852
0131-002,2018,10,10,18,977,1253,2230,1850
0131-002,2018,10,10,19,1031,1147,2178,2230
0131-002,2018,10,10,20,724,730,1454,2178
0131-002,2018,10,10,21,505,578,1083,1454
0131-002,2018,10,10,22,355,447,802,1083
0131-002,2018,10,10,23,322,293,615,802
0131-002,2018,10,10,24,158,195,353,615
0131-002,2018,10,11,1,150,133,283,353
0131-002,2018,10,11,2,94,91,185,283
0131-002,2018,10,11,3,60,71,131,185
0131-002,2018,10,11,4,70,111,181,131
0131-002,2018,10,11,5,122,124,246,181
0131-002,2018,10,11,6,323,250,573,246
0131-002,2018,10,11,7,721,490,1211,573
0131-002,2018,10,11,8,1554,947,2501,1211
0131-002,2018,10,11,9,1280,1060,2340,2501
0131-002,2018,10,11,10,935,922,1857,2340
0131-002,2018,10,11,11,972,950,1922,1857
0131-002,2018,10,11,12,841,914,1755,1922
0131-002,2018,10,11,13,710,776,1486,1755
0131-002,2018,10,11,14,795,866,1661,1486
0131-002,2018,10,11,15,866,1031,1897,1661
0131-002,2018,10,11,16,886,1019,1905,1897
0131-002,2018,10,11,17,975,1005,1980,1905
0131-002,2018,10,11,18,1113,1163,2276,1980
0131-002,2018,10,11,19,1009,1047,2056,2276
0131-002,2018,10,11,20,662,785,1447,2056
0131-002,2018,10,11,21,474,630,1104,1447
0131-002,2018,10,11,22,400,457,857,1104
0131-002,2018,10,11,23,261,288,549,857
0131-002,2018,10,11,24,172,199,371,549
0131-002,2018,10,12,1,126,114,240,371
0131-002,2018,10,12,2,86,83,169,240
0131-002,2018,10,12,3,79,83,162,169
0131-002,2018,10,12,4,81,88,169,162
0131-002,2018,10,12,5,125,122,247,169
0131-002,2018,10,12,6,333,238,571,247
0131-002,2018,10,12,7,718,501,1219,571
0131-002,2018,10,12,8,1454,896,2350,1219
0131-002,2018,10,12,9,1284,1101,2385,2350
0131-002,2018,10,12,10,873,917,1790,2385
0131-002,2018,10,12,11,891,1054,1945,1790
0131-002,2018,10,12,12,824,967,1791,1945
0131-002,2018,10,12,13,784,820,1604,1791
0131-002,2018,10,12,14,810,1007,1817,1604
0131-002,2018,10,12,15,944,1076,2020,1817
0131-002,2018,10,12,16,965,1079,2044,2020
0131-002,2018,10,12,17,886,1051,1937,2044
0131-002,2018,10,12,18,1194,1484,2678,1937
0131-002,2018,10,12,19,1212,1424,2636,2678
0131-002,2018,10,12,20,846,840,1686,2636
0131-002,2018,10,12,21,571,644,1215,1686
0131-002,2018,10,12,22,443,428,871,1215
0131-002,2018,10,12,23,306,311,617,871
0131-002,2018,10,12,24,212,222,434,617
0131-002,2018,10,13,1,136,167,303,434
0131-002,2018,10,13,2,109,113,222,303
0131-002,2018,10,13,3,80,95,175,222
0131-002,2018,10,13,4,100,126,226,175
0131-002,2018,10,13,5,149,153,302,226
0131-002,2018,10,13,6,293,220,513,302
0131-002,2018,10,13,7,513,396,909,513
0131-002,2018,10,13,8,808,629,1437,909
0131-002,2018,10,13,9,786,834,1620,1437
0131-002,2018,10,13,10,918,814,1732,1620
0131-002,2018,10,13,11,902,794,1696,1732
0131-002,2018,10,13,12,805,774,1579,1696
0131-002,2018,10,13,13,827,720,1547,1579
0131-002,2018,10,13,14,765,793,1558,1547
0131-002,2018,10,13,15,826,774,1600,1558
0131-002,2018,10,13,16,823,784,1607,1600
0131-002,2018,10,13,17,833,871,1704,1607
0131-002,2018,10,13,18,900,1030,1930,1704
0131-002,2018,10,13,19,744,799,1543,1930
0131-002,2018,10,13,20,627,574,1201,1543
0131-002,2018,10,13,21,422,436,858,1201
0131-002,2018,10,13,22,322,351,673,858
0131-002,2018,10,13,23,269,288,557,673
0131-002,2018,10,13,24,203,173,376,557
0131-002,2018,10,14,1,136,154,290,376
0131-002,2018,10,14,2,103,110,213,290
0131-002,2018,10,14,3,75,62,137,213
0131-002,2018,10,14,4,77,74,151,137
0131-002,2018,10,14,5,89,95,184,151
0131-002,2018,10,14,6,155,117,272,184
0131-002,2018,10,14,7,285,230,515,272
0131-002,2018,10,14,8,336,356,692,515
0131-002,2018,10,14,9,355,397,752,692
0131-002,2018,10,14,10,420,545,965,752
0131-002,2018,10,14,11,553,559,1112,965
0131-002,2018,10,14,12,519,555,1074,1112
0131-002,2018,10,14,13,575,541,1116,1074
0131-002,2018,10,14,14,601,568,1169,1116
0131-002,2018,10,14,15,697,661,1358,1169
0131-002,2018,10,14,16,677,691,1368,1358
0131-002,2018,10,14,17,765,769,1534,1368
0131-002,2018,10,14,18,778,777,1555,1534
0131-002,2018,10,14,19,757,695,1452,1555
0131-002,2018,10,14,20,611,546,1157,1452
0131-002,2018,10,14,21,505,442,947,1157
0131-002,2018,10,14,22,350,348,698,947
0131-002,2018,10,14,23,283,235,518,698
0131-002,2018,10,14,24,186,126,312,518
0131-002,2018,10,15,1,97,83,180,312
0131-002,2018,10,15,2,57,61,118,180
0131-002,2018,10,15,3,71,58,129,118
0131-002,2018,10,15,4,64,64,128,129
0131-002,2018,10,15,5,133,120,253,128
0131-002,2018,10,15,6,374,250,624,253
0131-002,2018,10,15,7,854,517,1371,624
0131-002,2018,10,15,8,1629,1008,2637,1371
0131-002,2018,10,15,9,1293,1065,2358,2637
0131-002,2018,10,15,10,897,933,1830,2358
0131-002,2018,10,15,11,848,966,1814,1830
0131-002,2018,10,15,12,868,895,1763,1814
0131-002,2018,10,15,13,762,826,1588,1763
0131-002,2018,10,15,14,900,956,1856,1588
0131-002,2018,10,15,15,839,1002,1841,1856
0131-002,2018,10,15,16,890,960,1850,1841
0131-002,2018,10,15,17,923,1064,1987,1850
0131-002,2018,10,15,18,1050,1252,2302,1987
0131-002,2018,10,15,19,1001,1104,2105,2302
0131-002,2018,10,15,20,661,738,1399,2105
0131-002,2018,10,15,21,483,601,1084,1399
0131-002,2018,10,15,22,384,440,824,1084
0131-002,2018,10,15,23,268,299,567,824
0131-002,2018,10,15,24,172,162,334,567
0131-002,2018,10,16,1,115,118,233,334
0131-002,2018,10,16,2,77,77,154,233
0131-002,2018,10,16,3,56,68,124,154
0131-002,2018,10,16,4,68,69,137,124
0131-002,2018,10,16,5,151,114,265,137
0131-002,2018,10,16,6,344,228,572,265
0131-002,2018,10,16,7,655,490,1145,572
0131-002,2018,10,16,8,1404,1044,2448,1145
0131-002,2018,10,16,9,1231,1123,2354,2448
0131-002,2018,10,16,10,842,921,1763,2354
0131-002,2018,10,16,11,886,976,1862,1763
0131-002,2018,10,16,12,760,913,1673,1862
0131-002,2018,10,16,13,662,821,1483,1673
0131-002,2018,10,16,14,837,936,1773,1483
0131-002,2018,10,16,15,870,1012,1882,1773
0131-002,2018,10,16,16,925,1039,1964,1882
0131-002,2018,10,16,17,860,1064,1924,1964
0131-002,2018,10,16,18,1029,1192,2221,1924
0131-002,2018,10,16,19,999,1092,2091,2221
0131-002,2018,10,16,20,644,760,1404,2091
0131-002,2018,10,16,21,474,592,1066,1404
0131-002,2018,10,16,22,363,423,786,1066
0131-002,2018,10,16,23,382,298,680,786
0131-002,2018,10,16,24,209,185,394,680
0131-002,2018,10,17,1,134,126,260,394
0131-002,2018,10,17,2,96,85,181,260
0131-002,2018,10,17,3,61,79,140,181
0131-002,2018,10,17,4,70,84,154,140
0131-002,2018,10,17,5,117,110,227,154
0131-002,2018,10,17,6,353,224,577,227
0131-002,2018,10,17,7,747,496,1243,577
0131-002,2018,10,17,8,1375,1001,2376,1243
0131-002,2018,10,17,9,1273,1076,2349,2376
0131-002,2018,10,17,10,906,885,1791,2349
0131-002,2018,10,17,11,884,993,1877,1791
0131-002,2018,10,17,12,811,974,1785,1877
0131-002,2018,10,17,13,771,810,1581,1785
0131-002,2018,10,17,14,860,941,1801,1581
0131-002,2018,10,17,15,843,1037,1880,1801
0131-002,2018,10,17,16,913,909,1822,1880
0131-002,2018,10,17,17,906,1083,1989,1822
0131-002,2018,10,17,18,1114,1382,2496,1989
0131-002,2018,10,17,19,1061,1174,2235,2496
0131-002,2018,10,17,20,675,754,1429,2235
0131-002,2018,10,17,21,432,589,1021,1429
0131-002,2018,10,17,22,380,450,830,1021
0131-002,2018,10,17,23,298,294,592,830
0131-002,2018,10,17,24,182,196,378,592
0131-002,2018,10,18,1,150,135,285,378
0131-002,2018,10,18,2,87,95,182,285
0131-002,2018,10,18,3,64,91,155,182
0131-002,2018,10,18,4,65,84,149,155
0131-002,2018,10,18,5,139,130,269,149
0131-002,2018,10,18,6,381,248,629,269
0131-002,2018,10,18,7,722,461,1183,629
0131-002,2018,10,18,8,1445,972,2417,1183
0131-002,2018,10,18,9,1286,1103,2389,2417
0131-002,2018,10,18,10,908,967,1875,2389
0131-002,2018,10,18,11,892,1018,1910,1875
0131-002,2018,10,18,12,828,1033,1861,1910
0131-002,2018,10,18,13,739,899,1638,1861
0131-002,2018,10,18,14,860,938,1798,1638
0131-002,2018,10,18,15,958,1019,1977,1798
0131-002,2018,10,18,16,894,1029,1923,1977
0131-002,2018,10,18,17,955,1237,2192,1923
0131-002,2018,10,18,18,1186,1372,2558,2192
0131-002,2018,10,18,19,1055,1181,2236,2558
0131-002,2018,10,18,20,679,764,1443,2236
0131-002,2018,10,18,21,487,619,1106,1443
0131-002,2018,10,18,22,384,406,790,1106
0131-002,2018,10,18,23,269,305,574,790
0131-002,2018,10,18,24,187,176,363,574
0131-002,2018,10,19,1,122,135,257,363
0131-002,2018,10,19,2,87,85,172,257
0131-002,2018,10,19,3,76,99,175,172
0131-002,2018,10,19,4,79,82,161,175
0131-002,2018,10,19,5,125,113,238,161
0131-002,2018,10,19,6,372,245,617,238
0131-002,2018,10,19,7,753,476,1229,617
0131-002,2018,10,19,8,1410,975,2385,1229
0131-002,2018,10,19,9,1309,1125,2434,2385
0131-002,2018,10,19,10,979,937,1916,2434
0131-002,2018,10,19,11,956,1010,1966,1916
0131-002,2018,10,19,12,853,1002,1855,1966
0131-002,2018,10,19,13,727,897,1624,1855
0131-002,2018,10,19,14,864,955,1819,1624
0131-002,2018,10,19,15,969,1149,2118,1819
0131-002,2018,10,19,16,1009,1111,2120,2118
0131-002,2018,10,19,17,898,1166,2064,2120
0131-002,2018,10,19,18,1158,1456,2614,2064
0131-002,2018,10,19,19,1166,1304,2470,2614
0131-002,2018,10,19,20,853,927,1780,2470
0131-002,2018,10,19,21,589,688,1277,1780
0131-002,2018,10,19,22,455,437,892,1277
0131-002,2018,10,19,23,271,339,610,892
0131-002,2018,10,19,24,218,191,409,610
0131-002,2018,10,20,1,158,172,330,409
0131-002,2018,10,20,2,127,123,250,330
0131-002,2018,10,20,3,100,110,210,250
0131-002,2018,10,20,4,76,92,168,210
0131-002,2018,10,20,5,121,120,241,168
0131-002,2018,10,20,6,297,224,521,241
0131-002,2018,10,20,7,475,387,862,521
0131-002,2018,10,20,8,685,636,1321,862
0131-002,2018,10,20,9,720,765,1485,1321
0131-002,2018,10,20,10,796,799,1595,1485
0131-002,2018,10,20,11,845,830,1675,1595
0131-002,2018,10,20,12,823,789,1612,1675
0131-002,2018,10,20,13,825,763,1588,1612
0131-002,2018,10,20,14,800,694,1494,1588
0131-002,2018,10,20,15,796,724,1520,1494
0131-002,2018,10,20,16,785,809,1594,1520
0131-002,2018,10,20,17,872,912,1784,1594
0131-002,2018,10,20,18,950,989,1939,1784
0131-002,2018,10,20,19,801,813,1614,1939
0131-002,2018,10,20,20,677,575,1252,1614
0131-002,2018,10,20,21,465,467,932,1252
0131-002,2018,10,20,22,347,347,694,932
0131-002,2018,10,20,23,274,229,503,694
0131-002,2018,10,20,24,192,188,380,503
0131-002,2018,10,21,1,122,138,260,380
0131-002,2018,10,21,2,93,92,185,260
0131-002,2018,10,21,3,75,71,146,185
0131-002,2018,10,21,4,86,66,152,146
0131-002,2018,10,21,5,86,85,171,152
0131-002,2018,10,21,6,171,130,301,171
0131-002,2018,10,21,7,266,214,480,301
0131-002,2018,10,21,8,311,332,643,480
0131-002,2018,10,21,9,355,448,803,643
0131-002,2018,10,21,10,451,548,999,803
0131-002,2018,10,21,11,554,623,1177,999
0131-002,2018,10,21,12,560,602,1162,1177
0131-002,2018,10,21,13,568,574,1142,1162
0131-002,2018,10,21,14,685,658,1343,1142
0131-002,2018,10,21,15,655,651,1306,1343
0131-002,2018,10,21,16,801,724,1525,1306
0131-002,2018,10,21,17,794,725,1519,1525
0131-002,2018,10,21,18,825,761,1586,1519
0131-002,2018,10,21,19,659,733,1392,1586
0131-002,2018,10,21,20,651,572,1223,1392
0131-002,2018,10,21,21,508,473,981,1223
0131-002,2018,10,21,22,488,328,816,981
0131-002,2018,10,21,23,527,220,747,816
0131-002,2018,10,21,24,194,140,334,747
0131-002,2018,10,22,1,133,100,233,334
0131-002,2018,10,22,2,67,56,123,233
0131-002,2018,10,22,3,49,62,111,123
0131-002,2018,10,22,4,64,62,126,111
0131-002,2018,10,22,5,143,124,267,126
0131-002,2018,10,22,6,446,243,689,267
0131-002,2018,10,22,7,825,496,1321,689
0131-002,2018,10,22,8,1527,1013,2540,1321
0131-002,2018,10,22,9,1273,1069,2342,2540
0131-002,2018,10,22,10,843,932,1775,2342
0131-002,2018,10,22,11,849,939,1788,1775
0131-002,2018,10,22,12,788,875,1663,1788
0131-002,2018,10,22,13,739,816,1555,1663
0131-002,2018,10,22,14,857,896,1753,1555
0131-002,2018,10,22,15,876,1002,1878,1753
0131-002,2018,10,22,16,883,1030,1913,1878
0131-002,2018,10,22,17,905,1050,1955,1913
0131-002,2018,10,22,18,1072,1311,2383,1955
0131-002,2018,10,22,19,989,1026,2015,2383
0131-002,2018,10,22,20,631,712,1343,2015
0131-002,2018,10,22,21,481,634,1115,1343
0131-002,2018,10,22,22,339,423,762,1115
0131-002,2018,10,22,23,260,289,549,762
0131-002,2018,10,22,24,186,172,358,549
0131-002,2018,10,23,1,146,112,258,358
0131-002,2018,10,23,2,80,83,163,258
0131-002,2018,10,23,3,56,80,136,163
0131-002,2018,10,23,4,81,87,168,136
0131-002,2018,10,23,5,105,153,258,168
0131-002,2018,10,23,6,373,239,612,258
0131-002,2018,10,23,7,709,451,1160,612
0131-002,2018,10,23,8,1450,956,2406,1160
0131-002,2018,10,23,9,1210,1176,2386,2406
0131-002,2018,10,23,10,936,957,1893,2386
0131-002,2018,10,23,11,835,1022,1857,1893
0131-002,2018,10,23,12,798,888,1686,1857
0131-002,2018,10,23,13,742,833,1575,1686
0131-002,2018,10,23,14,866,1014,1880,1575
0131-002,2018,10,23,15,984,1121,2105,1880
0131-002,2018,10,23,16,864,994,1858,2105
0131-002,2018,10,23,17,925,961,1886,1858
0131-002,2018,10,23,18,1020,1291,2311,1886
0131-002,2018,10,23,19,977,1096,2073,2311
0131-002,2018,10,23,20,578,758,1336,2073
0131-002,2018,10,23,21,515,658,1173,1336
0131-002,2018,10,23,22,416,420,836,1173
0131-002,2018,10,23,23,314,297,611,836
0131-002,2018,10,23,24,179,161,340,611
0131-002,2018,10,24,1,133,158,291,340
0131-002,2018,10,24,2,86,81,167,291
0131-002,2018,10,24,3,76,76,152,167
0131-002,2018,10,24,4,81,91,172,152
0131-002,2018,10,24,5,109,124,233,172
0131-002,2018,10,24,6,345,258,603,233
0131-002,2018,10,24,7,710,494,1204,603
0131-002,2018,10,24,8,1422,911,2333,1204
0131-002,2018,10,24,9,1346,1085,2431,2333
0131-002,2018,10,24,10,862,996,1858,2431
0131-002,2018,10,24,11,864,1038,1902,1858
0131-002,2018,10,24,12,861,953,1814,1902
0131-002,2018,10,24,13,714,832,1546,1814
0131-002,2018,10,24,14,859,896,1755,1546
0131-002,2018,10,24,15,902,995,1897,1755
0131-002,2018,10,24,16,842,1080,1922,1897
0131-002,2018,10,24,17,916,1053,1969,1922
0131-002,2018,10,24,18,1043,1355,2398,1969
0131-002,2018,10,24,19,1046,1132,2178,2398
0131-002,2018,10,24,20,688,695,1383,2178
0131-002,2018,10,24,21,486,578,1064,1383
0131-002,2018,10,24,22,391,406,797,1064
0131-002,2018,10,24,23,281,286,567,797
0131-002,2018,10,24,24,207,167,374,567
0131-002,2018,10,25,1,137,131,268,374
0131-002,2018,10,25,2,97,95,192,268
0131-002,2018,10,25,3,59,62,121,192
0131-002,2018,10,25,4,77,103,180,121
0131-002,2018,10,25,5,141,138,279,180
0131-002,2018,10,25,6,336,241,577,279
0131-002,2018,10,25,7,712,469,1181,577
0131-002,2018,10,25,8,1380,900,2280,1181
0131-002,2018,10,25,9,1318,1105,2423,2280
0131-002,2018,10,25,10,931,977,1908,2423
0131-002,2018,10,25,11,919,1013,1932,1908
0131-002,2018,10,25,12,828,940,1768,1932
0131-002,2018,10,25,13,768,889,1657,1768
0131-002,2018,10,25,14,823,974,1797,1657
0131-002,2018,10,25,15,930,1078,2008,1797
0131-002,2018,10,25,16,851,1070,1921,2008
0131-002,2018,10,25,17,861,1083,1944,1921
0131-002,2018,10,25,18,1100,1292,2392,1944
0131-002,2018,10,25,19,885,1225,2110,2392
0131-002,2018,10,25,20,702,770,1472,2110
0131-002,2018,10,25,21,512,593,1105,1472
0131-002,2018,10,25,22,430,458,888,1105
0131-002,2018,10,25,23,268,302,570,888
0131-002,2018,10,25,24,209,201,410,570
0131-002,2018,10,26,1,133,145,278,410
0131-002,2018,10,26,2,96,88,184,278
0131-002,2018,10,26,3,65,83,148,184
0131-002,2018,10,26,4,82,98,180,148
0131-002,2018,10,26,5,123,118,241,180
0131-002,2018,10,26,6,330,227,557,241
0131-002,2018,10,26,7,630,445,1075,557
0131-002,2018,10,26,8,1411,956,2367,1075
0131-002,2018,10,26,9,1271,1126,2397,2367
0131-002,2018,10,26,10,877,1027,1904,2397
0131-002,2018,10,26,11,926,1106,2032,1904
0131-002,2018,10,26,12,826,1033,1859,2032
0131-002,2018,10,26,13,727,921,1648,1859
0131-002,2018,10,26,14,801,977,1778,1648
0131-002,2018,10,26,15,903,1092,1995,1778
0131-002,2018,10,26,16,862,1126,1988,1995
0131-002,2018,10,26,17,947,1132,2079,1988
0131-002,2018,10,26,18,1063,1420,2483,2079
0131-002,2018,10,26,19,1098,1282,2380,2483
0131-002,2018,10,26,20,719,815,1534,2380
0131-002,2018,10,26,21,531,668,1199,1534
0131-002,2018,10,26,22,404,415,819,1199
0131-002,2018,10,26,23,294,320,614,819
0131-002,2018,10,26,24,218,200,418,614
0131-002,2018,10,27,1,136,186,322,418
0131-002,2018,10,27,2,89,132,221,322
0131-002,2018,10,27,3,79,91,170,221
0131-002,2018,10,27,4,85,93,178,170
0131-002,2018,10,27,5,141,120,261,178
0131-002,2018,10,27,6,276,203,479,261
0131-002,2018,10,27,7,464,386,850,479
0131-002,2018,10,27,8,675,596,1271,850
0131-002,2018,10,27,9,778,863,1641,1271
0131-002,2018,10,27,10,812,904,1716,1641
0131-002,2018,10,27,11,856,919,1775,1716
0131-002,2018,10,27,12,841,836,1677,1775
0131-002,2018,10,27,13,859,787,1646,1677
0131-002,2018,10,27,14,813,747,1560,1646
0131-002,2018,10,27,15,817,757,1574,1560
0131-002,2018,10,27,16,835,801,1636,1574
0131-002,2018,10,27,17,875,812,1687,1636
0131-002,2018,10,27,18,884,935,1819,1687
0131-002,2018,10,27,19,865,754,1619,1819
0131-002,2018,10,27,20,599,517,1116,1619
0131-002,2018,10,27,21,398,422,820,1116
0131-002,2018,10,27,22,343,326,669,820
0131-002,2018,10,27,23,235,241,476,669
0131-002,2018,10,27,24,191,177,368,476
0131-002,2018,10,28,1,136,118,254,368
0131-002,2018,10,28,2,104,106,210,254
0131-002,2018,10,28,3,62,71,133,210
0131-002,2018,10,28,4,64,70,134,133
0131-002,2018,10,28,5,63,66,129,134
0131-002,2018,10,28,6,153,136,289,129
0131-002,2018,10,28,7,240,180,420,289
0131-002,2018,10,28,8,299,328,627,420
0131-002,2018,10,28,9,352,400,752,627
0131-002,2018,10,28,10,401,544,945,752
0131-002,2018,10,28,11,557,567,1124,945
0131-002,2018,10,28,12,500,559,1059,1124
0131-002,2018,10,28,13,549,606,1155,1059
0131-002,2018,10,28,14,652,697,1349,1155
0131-002,2018,10,28,15,679,750,1429,1349
0131-002,2018,10,28,16,793,719,1512,1429
0131-002,2018,10,28,17,770,672,1442,1512
0131-002,2018,10,28,18,819,670,1489,1442
0131-002,2018,10,28,19,815,562,1377,1489
0131-002,2018,10,28,20,637,453,1090,1377
0131-002,2018,10,28,21,488,387,875,1090
0131-002,2018,10,28,22,405,311,716,875
0131-002,2018,10,28,23,305,204,509,716
0131-002,2018,10,28,24,179,134,313,509
0131-002,2018,10,29,1,104,79,183,313
0131-002,2018,10,29,2,76,48,124,183
0131-002,2018,10,29,3,48,51,99,124
0131-002,2018,10,29,4,65,60,125,99
0131-002,2018,10,29,5,139,129,268,125
0131-002,2018,10,29,6,429,240,669,268
0131-002,2018,10,29,7,827,480,1307,669
0131-002,2018,10,29,8,1534,1039,2573,1307
0131-002,2018,10,29,9,1258,1114,2372,2573
0131-002,2018,10,29,10,842,936,1778,2372
0131-002,2018,10,29,11,886,927,1813,1778
0131-002,2018,10,29,12,834,892,1726,1813
0131-002,2018,10,29,13,689,840,1529,1726
0131-002,2018,10,29,14,841,896,1737,1529
0131-002,2018,10,29,15,938,1019,1957,1737
0131-002,2018,10,29,16,864,912,1776,1957
0131-002,2018,10,29,17,928,997,1925,1776
0131-002,2018,10,29,18,1091,1296,2387,1925
0131-002,2018,10,29,19,972,1078,2050,2387
0131-002,2018,10,29,20,684,724,1408,2050
0131-002,2018,10,29,21,517,594,1111,1408
0131-002,2018,10,29,22,413,434,847,1111
0131-002,2018,10,29,23,265,264,529,847
0131-002,2018,10,29,24,141,161,302,529
0131-002,2018,10,30,1,114,119,233,302
0131-002,2018,10,30,2,85,68,153,233
0131-002,2018,10,30,3,60,70,130,153
0131-002,2018,10,30,4,51,96,147,130
0131-002,2018,10,30,5,133,116,249,147
0131-002,2018,10,30,6,373,234,607,249
0131-002,2018,10,30,7,719,468,1187,607
0131-002,2018,10,30,8,1441,933,2374,1187
0131-002,2018,10,30,9,1246,1163,2409,2374
0131-002,2018,10,30,10,892,984,1876,2409
0131-002,2018,10,30,11,899,993,1892,1876
0131-002,2018,10,30,12,808,879,1687,1892
0131-002,2018,10,30,13,698,797,1495,1687
0131-002,2018,10,30,14,837,904,1741,1495
0131-002,2018,10,30,15,885,1025,1910,1741
0131-002,2018,10,30,16,859,976,1835,1910
0131-002,2018,10,30,17,943,960,1903,1835
0131-002,2018,10,30,18,1083,1285,2368,1903
0131-002,2018,10,30,19,989,1021,2010,2368
0131-002,2018,10,30,20,683,748,1431,2010
0131-002,2018,10,30,21,503,635,1138,1431
0131-002,2018,10,30,22,385,474,859,1138
0131-002,2018,10,30,23,277,285,562,859
0131-002,2018,10,30,24,204,171,375,562
0131-002,2018,10,31,1,117,125,242,375
0131-002,2018,10,31,2,87,90,177,242
0131-002,2018,10,31,3,65,64,129,177
0131-002,2018,10,31,4,73,97,170,129
0131-002,2018,10,31,5,133,139,272,170
0131-002,2018,10,31,6,363,220,583,272
0131-002,2018,10,31,7,709,461,1170,583
0131-002,2018,10,31,8,1408,918,2326,1170
0131-002,2018,10,31,9,1229,1043,2272,2326
0131-002,2018,10,31,10,782,939,1721,2272
0131-002,2018,10,31,11,805,906,1711,1721
0131-002,2018,10,31,12,790,905,1695,1711
0131-002,2018,10,31,13,716,780,1496,1695
0131-002,2018,10,31,14,833,914,1747,1496
0131-002,2018,10,31,15,919,939,1858,1747
0131-002,2018,10,31,16,851,982,1833,1858
0131-002,2018,10,31,17,860,984,1844,1833
0131-002,2018,10,31,18,1177,1277,2454,1844
0131-002,2018,10,31,19,1040,1106,2146,2454
0131-002,2018,10,31,20,687,727,1414,2146
0131-002,2018,10,31,21,415,568,983,1414
0131-002,2018,10,31,22,434,421,855,983
0131-002,2018,10,31,23,278,286,564,855
0131-002,2018,10,31,24,190,192,382,564
0131-002,2018,11,1,1,134,151,285,382
0131-002,2018,11,1,2,91,89,180,285
0131-002,2018,11,1,3,73,75,148,180
0131-002,2018,11,1,4,64,80,144,148
0131-002,2018,11,1,5,161,134,295,144
0131-002,2018,11,1,6,359,229,588,295
0131-002,2018,11,1,7,769,445,1214,588
0131-002,2018,11,1,8,1561,952,2513,1214
0131-002,2018,11,1,9,1369,1075,2444,2513
0131-002,2018,11,1,10,884,963,1847,2444
0131-002,2018,11,1,11,926,947,1873,1847
0131-002,2018,11,1,12,899,949,1848,1873
0131-002,2018,11,1,13,818,837,1655,1848
0131-002,2018,11,1,14,874,896,1770,1655
0131-002,2018,11,1,15,996,987,1983,1770
0131-002,2018,11,1,16,988,968,1956,1983
0131-002,2018,11,1,17,1017,1023,2040,1956
0131-002,2018,11,1,18,1267,1347,2614,2040
0131-002,2018,11,1,19,1047,1205,2252,2614
0131-002,2018,11,1,20,740,750,1490,2252
0131-002,2018,11,1,21,515,609,1124,1490
0131-002,2018,11,1,22,463,437,900,1124
0131-002,2018,11,1,23,317,272,589,900
0131-002,2018,11,1,24,203,204,407,589
0131-002,2018,11,2,1,138,131,269,407
0131-002,2018,11,2,2,84,83,167,269
0131-002,2018,11,2,3,75,82,157,167
0131-002,2018,11,2,4,62,83,145,157
0131-002,2018,11,2,5,129,130,259,145
0131-002,2018,11,2,6,370,231,601,259
0131-002,2018,11,2,7,778,464,1242,601
0131-002,2018,11,2,8,1591,948,2539,1242
0131-002,2018,11,2,9,1467,1095,2562,2539
0131-002,2018,11,2,10,947,986,1933,2562
0131-002,2018,11,2,11,874,984,1858,1933
0131-002,2018,11,2,12,839,910,1749,1858
0131-002,2018,11,2,13,758,882,1640,1749
0131-002,2018,11,2,14,889,929,1818,1640
0131-002,2018,11,2,15,916,973,1889,1818
0131-002,2018,11,2,16,1064,979,2043,1889
0131-002,2018,11,2,17,1055,1148,2203,2043
0131-002,2018,11,2,18,1306,1466,2772,2203
0131-002,2018,11,2,19,1298,1314,2612,2772
0131-002,2018,11,2,20,1221,925,2146,2612
0131-002,2018,11,2,21,637,678,1315,2146
0131-002,2018,11,2,22,478,440,918,1315
0131-002,2018,11,2,23,344,321,665,918
0131-002,2018,11,2,24,236,208,444,665
0131-002,2018,11,3,1,165,164,329,444
0131-002,2018,11,3,2,111,107,218,329
0131-002,2018,11,3,3,81,95,176,218
0131-002,2018,11,3,4,107,98,205,176
0131-002,2018,11,3,5,132,138,270,205
0131-002,2018,11,3,6,317,205,522,270
0131-002,2018,11,3,7,504,394,898,522
0131-002,2018,11,3,8,733,616,1349,898
0131-002,2018,11,3,9,774,766,1540,1349
0131-002,2018,11,3,10,928,844,1772,1540
0131-002,2018,11,3,11,940,929,1869,1772
0131-002,2018,11,3,12,894,828,1722,1869
0131-002,2018,11,3,13,832,722,1554,1722
0131-002,2018,11,3,14,812,773,1585,1554
0131-002,2018,11,3,15,836,770,1606,1585
0131-002,2018,11,3,16,837,807,1644,1606
0131-002,2018,11,3,17,932,814,1746,1644
0131-002,2018,11,3,18,953,980,1933,1746
0131-002,2018,11,3,19,939,884,1823,1933
0131-002,2018,11,3,20,657,574,1231,1823
0131-002,2018,11,3,21,484,446,930,1231
0131-002,2018,11,3,22,407,306,713,930
0131-002,2018,11,3,23,284,248,532,713
0131-002,2018,11,3,24,205,174,379,532
0131-002,2018,11,4,1,150,138,288,379
0131-002,2018,11,4,2,89,88,177,288
0131-002,2018,11,4,3,95,88,183,177
0131-002,2018,11,4,4,81,55,136,183
0131-002,2018,11,4,5,105,88,193,136
0131-002,2018,11,4,6,196,118,314,193
0131-002,2018,11,4,7,248,164,412,314
0131-002,2018,11,4,8,342,297,639,412
0131-002,2018,11,4,9,388,477,865,639
0131-002,2018,11,4,10,416,542,958,865
0131-002,2018,11,4,11,578,655,1233,958
0131-002,2018,11,4,12,555,582,1137,1233
0131-002,2018,11,4,13,603,573,1176,1137
0131-002,2018,11,4,14,688,664,1352,1176
0131-002,2018,11,4,15,667,670,1337,1352
0131-002,2018,11,4,16,808,787,1595,1337
0131-002,2018,11,4,17,898,790,1688,1595
0131-002,2018,11,4,18,990,776,1766,1688
0131-002,2018,11,4,19,1037,767,1804,1766
0131-002,2018,11,4,20,801,561,1362,1804
0131-002,2018,11,4,21,624,423,1047,1362
0131-002,2018,11,4,22,458,361,819,1047
0131-002,2018,11,4,23,306,219,525,819
0131-002,2018,11,4,24,209,139,348,525
0131-002,2018,11,5,1,113,93,206,348
0131-002,2018,11,5,2,80,57,137,206
0131-002,2018,11,5,3,67,61,128,137
0131-002,2018,11,5,4,58,66,124,128
0131-002,2018,11,5,5,154,125,279,124
0131-002,2018,11,5,6,429,234,663,279
0131-002,2018,11,5,7,921,506,1427,663
0131-002,2018,11,5,8,1728,980,2708,1427
0131-002,2018,11,5,9,1455,1096,2551,2708
0131-002,2018,11,5,10,925,905,1830,2551
0131-002,2018,11,5,11,932,918,1850,1830
0131-002,2018,11,5,12,967,874,1841,1850
0131-002,2018,11,5,13,790,782,1572,1841
0131-002,2018,11,5,14,977,872,1849,1572
0131-002,2018,11,5,15,1080,970,2050,1849
0131-002,2018,11,5,16,945,970,1915,2050
0131-002,2018,11,5,17,896,1019,1915,1915
0131-002,2018,11,5,18,1182,1282,2464,1915
0131-002,2018,11,5,19,980,1112,2092,2464
0131-002,2018,11,5,20,688,750,1438,2092
0131-002,2018,11,5,21,515,609,1124,1438
0131-002,2018,11,5,22,430,418,848,1124
0131-002,2018,11,5,23,286,284,570,848
0131-002,2018,11,5,24,154,177,331,570
0131-002,2018,11,6,1,131,120,251,331
0131-002,2018,11,6,2,77,102,179,251
0131-002,2018,11,6,3,63,70,133,179
0131-002,2018,11,6,4,72,85,157,133
0131-002,2018,11,6,5,155,113,268,157
0131-002,2018,11,6,6,403,220,623,268
0131-002,2018,11,6,7,744,450,1194,623
0131-002,2018,11,6,8,1605,959,2564,1194
0131-002,2018,11,6,9,1429,1151,2580,2564
0131-002,2018,11,6,10,1005,1018,2023,2580
0131-002,2018,11,6,11,974,993,1967,2023
0131-002,2018,11,6,12,918,904,1822,1967
0131-002,2018,11,6,13,835,852,1687,1822
0131-002,2018,11,6,14,965,892,1857,1687
0131-002,2018,11,6,15,1017,994,2011,1857
0131-002,2018,11,6,16,985,945,1930,2011
0131-002,2018,11,6,17,945,1001,1946,1930
0131-002,2018,11,6,18,1139,1293,2432,1946
0131-002,2018,11,6,19,1095,1117,2212,2432
0131-002,2018,11,6,20,721,729,1450,2212
0131-002,2018,11,6,21,601,600,1201,1450
0131-002,2018,11,6,22,423,412,835,1201
0131-002,2018,11,6,23,275,285,560,835
0131-002,2018,11,6,24,158,163,321,560
0131-002,2018,11,7,1,127,150,277,321
0131-002,2018,11,7,2,95,105,200,277
0131-002,2018,11,7,3,85,72,157,200
0131-002,2018,11,7,4,90,88,178,157
0131-002,2018,11,7,5,123,111,234,178
0131-002,2018,11,7,6,350,245,595,234
0131-002,2018,11,7,7,798,482,1280,595
0131-002,2018,11,7,8,1513,987,2500,1280
0131-002,2018,11,7,9,1423,1163,2586,2500
0131-002,2018,11,7,10,1002,1002,2004,2586
0131-002,2018,11,7,11,960,978,1938,2004
0131-002,2018,11,7,12,886,968,1854,1938
0131-002,2018,11,7,13,790,833,1623,1854
0131-002,2018,11,7,14,972,952,1924,1623
0131-002,2018,11,7,15,980,1064,2044,1924
0131-002,2018,11,7,16,942,1011,1953,2044
0131-002,2018,11,7,17,848,1062,1910,1953
0131-002,2018,11,7,18,970,1420,2390,1910
0131-002,2018,11,7,19,844,1128,1972,2390
0131-002,2018,11,7,20,505,717,1222,1972
0131-002,2018,11,7,21,321,548,869,1222
0131-002,2018,11,7,22,289,439,728,869
0131-002,2018,11,7,23,226,297,523,728
0131-002,2018,11,7,24,121,200,321,523
0131-002,2018,11,8,1,88,115,203,321
0131-002,2018,11,8,2,42,74,116,203
0131-002,2018,11,8,3,39,72,111,116
0131-002,2018,11,8,4,41,73,114,111
0131-002,2018,11,8,5,102,119,221,114
0131-002,2018,11,8,6,248,193,441,221
0131-002,2018,11,8,7,561,406,967,441
0131-002,2018,11,8,8,1231,1041,2272,967
0131-002,2018,11,8,9,1204,1249,2453,2272
0131-002,2018,11,8,10,966,1066,2032,2453
0131-002,2018,11,8,11,912,1002,1914,2032
0131-002,2018,11,8,12,828,893,1721,1914
0131-002,2018,11,8,13,743,900,1643,1721
0131-002,2018,11,8,14,912,892,1804,1643
0131-002,2018,11,8,15,964,1072,2036,1804
0131-002,2018,11,8,16,940,1022,1962,2036
0131-002,2018,11,8,17,871,1017,1888,1962
0131-002,2018,11,8,18,1028,1281,2309,1888
0131-002,2018,11,8,19,894,1156,2050,2309
0131-002,2018,11,8,20,542,775,1317,2050
0131-002,2018,11,8,21,354,691,1045,1317
0131-002,2018,11,8,22,286,447,733,1045
0131-002,2018,11,8,23,211,273,484,733
0131-002,2018,11,8,24,114,159,273,484
0131-002,2018,11,9,1,66,119,185,273
0131-002,2018,11,9,2,42,74,116,185
0131-002,2018,11,9,3,37,82,119,116
0131-002,2018,11,9,4,43,89,132,119
0131-002,2018,11,9,5,91,92,183,132
0131-002,2018,11,9,6,333,215,548,183
0131-002,2018,11,9,7,637,454,1091,548
0131-002,2018,11,9,8,1382,924,2306,1091
0131-002,2018,11,9,9,1262,1081,2343,2306
0131-002,2018,11,9,10,929,972,1901,2343
0131-002,2018,11,9,11,863,1049,1912,1901
0131-002,2018,11,9,12,771,929,1700,1912
0131-002,2018,11,9,13,696,879,1575,1700
0131-002,2018,11,9,14,852,883,1735,1575
0131-002,2018,11,9,15,949,1098,2047,1735
0131-002,2018,11,9,16,939,1076,2015,2047
0131-002,2018,11,9,17,894,1143,2037,2015
0131-002,2018,11,9,18,1085,1381,2466,2037
0131-002,2018,11,9,19,944,1214,2158,2466
0131-002,2018,11,9,20,578,897,1475,2158
0131-002,2018,11,9,21,386,613,999,1475
0131-002,2018,11,9,22,283,462,745,999
0131-002,2018,11,9,23,196,315,511,745
0131-002,2018,11,9,24,106,204,310,511
0131-002,2018,11,10,1,95,168,263,310
0131-002,2018,11,10,2,69,115,184,263
0131-002,2018,11,10,3,50,95,145,184
0131-002,2018,11,10,4,45,103,148,145
0131-002,2018,11,10,5,83,140,223,148
0131-002,2018,11,10,6,266,206,472,223
0131-002,2018,11,10,7,394,387,781,472
0131-002,2018,11,10,8,598,587,1185,781
0131-002,2018,11,10,9,661,750,1411,1185
0131-002,2018,11,10,10,664,843,1507,1411
0131-002,2018,11,10,11,678,820,1498,1507
0131-002,2018,11,10,12,726,822,1548,1498
0131-002,2018,11,10,13,651,771,1422,1548
0131-002,2018,11,10,14,604,754,1358,1422
0131-002,2018,11,10,15,677,796,1473,1358
0131-002,2018,11,10,16,710,828,1538,1473
0131-002,2018,11,10,17,749,884,1633,1538
0131-002,2018,11,10,18,715,1042,1757,1633
0131-002,2018,11,10,19,563,788,1351,1757
0131-002,2018,11,10,20,394,583,977,1351
0131-002,2018,11,10,21,297,424,721,977
0131-002,2018,11,10,22,240,342,582,721
0131-002,2018,11,10,23,145,262,407,582
0131-002,2018,11,10,24,62,181,243,407
0131-002,2018,11,11,1,54,126,180,243
0131-002,2018,11,11,2,34,94,128,180
0131-002,2018,11,11,3,43,86,129,128
0131-002,2018,11,11,4,27,68,95,129
0131-002,2018,11,11,5,42,77,119,95
0131-002,2018,11,11,6,101,133,234,119
0131-002,2018,11,11,7,154,203,357,234
0131-002,2018,11,11,8,181,316,497,357
0131-002,2018,11,11,9,256,410,666,497
0131-002,2018,11,11,10,263,513,776,666
0131-002,2018,11,11,11,307,562,869,776
0131-002,2018,11,11,12,385,596,981,869
0131-002,2018,11,11,13,371,564,935,981
0131-002,2018,11,11,14,462,618,1080,935
0131-002,2018,11,11,15,512,674,1186,1080
0131-002,2018,11,11,16,593,726,1319,1186
0131-002,2018,11,11,17,740,756,1496,1319
0131-002,2018,11,11,18,834,783,1617,1496
0131-002,2018,11,11,19,776,657,1433,1617
0131-002,2018,11,11,20,560,502,1062,1433
0131-002,2018,11,11,21,472,411,883,1062
0131-002,2018,11,11,22,307,341,648,883
0131-002,2018,11,11,23,164,227,391,648
0131-002,2018,11,11,24,122,150,272,391
0131-002,2018,11,12,1,75,91,166,272
0131-002,2018,11,12,2,30,58,88,166
0131-002,2018,11,12,3,43,42,85,88
0131-002,2018,11,12,4,43,67,110,85
0131-002,2018,11,12,5,117,102,219,110
0131-002,2018,11,12,6,372,223,595,219
0131-002,2018,11,12,7,760,468,1228,595
0131-002,2018,11,12,8,1542,947,2489,1228
0131-002,2018,11,12,9,1311,1031,2342,2489
0131-002,2018,11,12,10,980,874,1854,2342
0131-002,2018,11,12,11,828,967,1795,1854
0131-002,2018,11,12,12,813,883,1696,1795
0131-002,2018,11,12,13,782,792,1574,1696
0131-002,2018,11,12,14,807,923,1730,1574
0131-002,2018,11,12,15,974,958,1932,1730
0131-002,2018,11,12,16,829,987,1816,1932
0131-002,2018,11,12,17,885,976,1861,1816
0131-002,2018,11,12,18,1058,1372,2430,1861
0131-002,2018,11,12,19,845,1075,1920,2430
0131-002,2018,11,12,20,554,773,1327,1920
0131-002,2018,11,12,21,350,660,1010,1327
0131-002,2018,11,12,22,320,435,755,1010
0131-002,2018,11,12,23,139,269,408,755
0131-002,2018,11,12,24,149,178,327,408
0131-002,2018,11,13,1,83,124,207,327
0131-002,2018,11,13,2,59,76,135,207
0131-002,2018,11,13,3,40,72,112,135
0131-002,2018,11,13,4,59,88,147,112
0131-002,2018,11,13,5,124,148,272,147
0131-002,2018,11,13,6,370,215,585,272
0131-002,2018,11,13,7,717,479,1196,585
0131-002,2018,11,13,8,1480,947,2427,1196
0131-002,2018,11,13,9,1290,1103,2393,2427
0131-002,2018,11,13,10,963,933,1896,2393
0131-002,2018,11,13,11,868,1100,1968,1896
0131-002,2018,11,13,12,848,859,1707,1968
0131-002,2018,11,13,13,788,777,1565,1707
0131-002,2018,11,13,14,814,916,1730,1565
0131-002,2018,11,13,15,861,1069,1930,1730
0131-002,2018,11,13,16,911,1006,1917,1930
0131-002,2018,11,13,17,874,1071,1945,1917
0131-002,2018,11,13,18,939,1321,2260,1945
0131-002,2018,11,13,19,813,1032,1845,2260
0131-002,2018,11,13,20,536,734,1270,1845
0131-002,2018,11,13,21,351,644,995,1270
0131-002,2018,11,13,22,312,447,759,995
0131-002,2018,11,13,23,196,256,452,759
0131-002,2018,11,13,24,99,195,294,452
0131-002,2018,11,14,1,75,121,196,294
0131-002,2018,11,14,2,69,84,153,196
0131-002,2018,11,14,3,37,75,112,153
0131-002,2018,11,14,4,67,83,150,112
0131-002,2018,11,14,5,131,123,254,150
0131-002,2018,11,14,6,326,223,549,254
0131-002,2018,11,14,7,686,475,1161,549
0131-002,2018,11,14,8,1411,940,2351,1161
0131-002,2018,11,14,9,1301,1220,2521,2351
0131-002,2018,11,14,10,977,960,1937,2521
0131-002,2018,11,14,11,997,940,1937,1937
0131-002,2018,11,14,12,831,903,1734,1937
0131-002,2018,11,14,13,682,831,1513,1734
0131-002,2018,11,14,14,863,941,1804,1513
0131-002,2018,11,14,15,928,1018,1946,1804
0131-002,2018,11,14,16,971,1011,1982,1946
0131-002,2018,11,14,17,956,1089,2045,1982
0131-002,2018,11,14,18,980,1403,2383,2045
0131-002,2018,11,14,19,802,1084,1886,2383
0131-002,2018,11,14,20,515,706,1221,1886
0131-002,2018,11,14,21,337,582,919,1221
0131-002,2018,11,14,22,316,406,722,919
0131-002,2018,11,14,23,216,302,518,722
0131-002,2018,11,14,24,131,210,341,518
0131-002,2018,11,15,1,69,116,185,341
0131-002,2018,11,15,2,67,103,170,185
0131-002,2018,11,15,3,47,80,127,170
0131-002,2018,11,15,4,59,85,144,127
0131-002,2018,11,15,5,105,124,229,144
0131-002,2018,11,15,6,376,222,598,229
0131-002,2018,11,15,7,729,505,1234,598
0131-002,2018,11,15,8,1386,957,2343,1234
0131-002,2018,11,15,9,1295,1091,2386,2343
0131-002,2018,11,15,10,972,979,1951,2386
0131-002,2018,11,15,11,895,989,1884,1951
0131-002,2018,11,15,12,884,894,1778,1884
0131-002,2018,11,15,13,743,806,1549,1778
0131-002,2018,11,15,14,832,882,1714,1549
0131-002,2018,11,15,15,882,1059,1941,1714
0131-002,2018,11,15,16,985,978,1963,1941
0131-002,2018,11,15,17,905,1037,1942,1963
0131-002,2018,11,15,18,1010,1261,2271,1942
0131-002,2018,11,15,19,855,1107,1962,2271
0131-002,2018,11,15,20,596,774,1370,1962
0131-002,2018,11,15,21,377,579,956,1370
0131-002,2018,11,15,22,282,468,750,956
0131-002,2018,11,15,23,213,330,543,750
0131-002,2018,11,15,24,108,177,285,543
0131-002,2018,11,16,1,68,147,215,285
0131-002,2018,11,16,2,53,99,152,215
0131-002,2018,11,16,3,48,98,146,152
0131-002,2018,11,16,4,64,97,161,146
0131-002,2018,11,16,5,139,140,279,161
0131-002,2018,11,16,6,358,249,607,279
0131-002,2018,11,16,7,707,448,1155,607
0131-002,2018,11,16,8,1402,976,2378,1155
0131-002,2018,11,16,9,1323,1072,2395,2378
0131-002,2018,11,16,10,952,1030,1982,2395
0131-002,2018,11,16,11,965,980,1945,1982
0131-002,2018,11,16,12,872,958,1830,1945
0131-002,2018,11,16,13,758,893,1651,1830
0131-002,2018,11,16,14,820,869,1689,1651
0131-002,2018,11,16,15,936,1020,1956,1689
0131-002,2018,11,16,16,955,1125,2080,1956
0131-002,2018,11,16,17,998,1147,2145,2080
0131-002,2018,11,16,18,1068,1577,2645,2145
0131-002,2018,11,16,19,1009,1359,2368,2645
0131-002,2018,11,16,20,607,965,1572,2368
0131-002,2018,11,16,21,442,672,1114,1572
0131-002,2018,11,16,22,307,496,803,1114
0131-002,2018,11,16,23,245,307,552,803
0131-002,2018,11,16,24,124,187,311,552
0131-002,2018,11,17,1,93,140,233,311
0131-002,2018,11,17,2,79,110,189,233
0131-002,2018,11,17,3,73,95,168,189
0131-002,2018,11,17,4,62,98,160,168
0131-002,2018,11,17,5,93,118,211,160
0131-002,2018,11,17,6,279,211,490,211
0131-002,2018,11,17,7,458,364,822,490
0131-002,2018,11,17,8,694,628,1322,822
0131-002,2018,11,17,9,729,799,1528,1322
0131-002,2018,11,17,10,805,838,1643,1528
0131-002,2018,11,17,11,772,879,1651,1643
0131-002,2018,11,17,12,657,837,1494,1651
0131-002,2018,11,17,13,723,808,1531,1494
0131-002,2018,11,17,14,754,847,1601,1531
0131-002,2018,11,17,15,763,895,1658,1601
0131-002,2018,11,17,16,700,845,1545,1658
0131-002,2018,11,17,17,704,893,1597,1545
0131-002,2018,11,17,18,809,1072,1881,1597
0131-002,2018,11,17,19,635,801,1436,1881
0131-002,2018,11,17,20,469,525,994,1436
0131-002,2018,11,17,21,291,417,708,994
0131-002,2018,11,17,22,209,353,562,708
0131-002,2018,11,17,23,193,233,426,562
0131-002,2018,11,17,24,89,167,256,426
0131-002,2018,11,18,1,77,140,217,256
0131-002,2018,11,18,2,43,96,139,217
0131-002,2018,11,18,3,29,79,108,139
0131-002,2018,11,18,4,30,85,115,108
0131-002,2018,11,18,5,51,84,135,115
0131-002,2018,11,18,6,122,138,260,135
0131-002,2018,11,18,7,159,205,364,260
0131-002,2018,11,18,8,237,313,550,364
0131-002,2018,11,18,9,268,437,705,550
0131-002,2018,11,18,10,316,516,832,705
0131-002,2018,11,18,11,339,595,934,832
0131-002,2018,11,18,12,378,569,947,934
0131-002,2018,11,18,13,394,598,992,947
0131-002,2018,11,18,14,499,662,1161,992
0131-002,2018,11,18,15,483,712,1195,1161
0131-002,2018,11,18,16,645,774,1419,1195
0131-002,2018,11,18,17,813,812,1625,1419
0131-002,2018,11,18,18,863,828,1691,1625
0131-002,2018,11,18,19,810,655,1465,1691
0131-002,2018,11,18,20,759,592,1351,1465
0131-002,2018,11,18,21,630,457,1087,1351
0131-002,2018,11,18,22,511,347,858,1087
0131-002,2018,11,18,23,365,202,567,858
0131-002,2018,11,18,24,122,128,250,567
0131-002,2018,11,19,1,74,100,174,250
0131-002,2018,11,19,2,41,61,102,174
0131-002,2018,11,19,3,45,54,99,102
0131-002,2018,11,19,4,59,51,110,99
0131-002,2018,11,19,5,122,104,226,110
0131-002,2018,11,19,6,410,242,652,226
0131-002,2018,11,19,7,797,503,1300,652
0131-002,2018,11,19,8,1602,978,2580,1300
0131-002,2018,11,19,9,1309,1064,2373,2580
0131-002,2018,11,19,10,851,971,1822,2373
0131-002,2018,11,19,11,867,972,1839,1822
0131-002,2018,11,19,12,836,896,1732,1839
0131-002,2018,11,19,13,733,754,1487,1732
0131-002,2018,11,19,14,898,864,1762,1487
0131-002,2018,11,19,15,895,948,1843,1762
0131-002,2018,11,19,16,899,999,1898,1843
0131-002,2018,11,19,17,988,1073,2061,1898
0131-002,2018,11,19,18,969,1353,2322,2061
0131-002,2018,11,19,19,815,1037,1852,2322
0131-002,2018,11,19,20,571,704,1275,1852
0131-002,2018,11,19,21,360,634,994,1275
0131-002,2018,11,19,22,278,421,699,994
0131-002,2018,11,19,23,207,243,450,699
0131-002,2018,11,19,24,140,167,307,450
0131-002,2018,11,20,1,85,121,206,307
0131-002,2018,11,20,2,57,92,149,206
0131-002,2018,11,20,3,42,68,110,149
0131-002,2018,11,20,4,66,74,140,110
0131-002,2018,11,20,5,104,107,211,140
0131-002,2018,11,20,6,359,203,562,211
0131-002,2018,11,20,7,717,441,1158,562
0131-002,2018,11,20,8,1396,1014,2410,1158
0131-002,2018,11,20,9,1380,1148,2528,2410
0131-002,2018,11,20,10,1003,957,1960,2528
0131-002,2018,11,20,11,913,1042,1955,1960
0131-002,2018,11,20,12,852,868,1720,1955
0131-002,2018,11,20,13,771,771,1542,1720
0131-002,2018,11,20,14,832,864,1696,1542
0131-002,2018,11,20,15,948,895,1843,1696
0131-002,2018,11,20,16,893,917,1810,1843
0131-002,2018,11,20,17,958,945,1903,1810
0131-002,2018,11,20,18,985,1103,2088,1903
0131-002,2018,11,20,19,760,1037,1797,2088
0131-002,2018,11,20,20,521,679,1200,1797
0131-002,2018,11,20,21,387,615,1002,1200
0131-002,2018,11,20,22,296,432,728,1002
0131-002,2018,11,20,23,201,271,472,728
0131-002,2018,11,20,24,140,155,295,472
0131-002,2018,11,21,1,74,128,202,295
0131-002,2018,11,21,2,63,69,132,202
0131-002,2018,11,21,3,50,85,135,132
0131-002,2018,11,21,4,54,75,129,135
0131-002,2018,11,21,5,151,116,267,129
0131-002,2018,11,21,6,348,228,576,267
0131-002,2018,11,21,7,705,444,1149,576
0131-002,2018,11,21,8,1332,1082,2414,1149
0131-002,2018,11,21,9,1274,1288,2562,2414
0131-002,2018,11,21,10,913,998,1911,2562
0131-002,2018,11,21,11,936,920,1856,1911
0131-002,2018,11,21,12,751,874,1625,1856
0131-002,2018,11,21,13,696,861,1557,1625
0131-002,2018,11,21,14,815,930,1745,1557
0131-002,2018,11,21,15,889,1053,1942,1745
0131-002,2018,11,21,16,909,916,1825,1942
0131-002,2018,11,21,17,739,1072,1811,1825
0131-002,2018,11,21,18,915,1387,2302,1811
0131-002,2018,11,21,19,754,1005,1759,2302
0131-002,2018,11,21,20,464,694,1158,1759
0131-002,2018,11,21,21,309,496,805,1158
0131-002,2018,11,21,22,242,375,617,805
0131-002,2018,11,21,23,204,264,468,617
0131-002,2018,11,21,24,110,182,292,468
0131-002,2018,11,22,1,68,125,193,292
0131-002,2018,11,22,2,63,69,132,193
0131-002,2018,11,22,3,41,68,109,132
0131-002,2018,11,22,4,51,81,132,109
0131-002,2018,11,22,5,84,123,207,132
0131-002,2018,11,22,6,291,199,490,207
0131-002,2018,11,22,7,668,441,1109,490
0131-002,2018,11,22,8,1263,959,2222,1109
0131-002,2018,11,22,9,1273,1093,2366,2222
0131-002,2018,11,22,10,937,980,1917,2366
0131-002,2018,11,22,11,928,999,1927,1917
0131-002,2018,11,22,12,830,962,1792,1927
0131-002,2018,11,22,13,744,809,1553,1792
0131-002,2018,11,22,14,825,907,1732,1553
0131-002,2018,11,22,15,878,1080,1958,1732
0131-002,2018,11,22,16,900,1052,1952,1958
0131-002,2018,11,22,17,963,912,1875,1952
0131-002,2018,11,22,18,964,1353,2317,1875
0131-002,2018,11,22,19,830,1087,1917,2317
0131-002,2018,11,22,20,529,748,1277,1917
0131-002,2018,11,22,21,369,619,988,1277
0131-002,2018,11,22,22,285,433,718,988
0131-002,2018,11,22,23,191,275,466,718
0131-002,2018,11,22,24,126,200,326,466
0131-002,2018,11,23,1,72,136,208,326
0131-002,2018,11,23,2,54,94,148,208
0131-002,2018,11,23,3,48,85,133,148
0131-002,2018,11,23,4,67,85,152,133
0131-002,2018,11,23,5,121,117,238,152
0131-002,2018,11,23,6,338,231,569,238
0131-002,2018,11,23,7,636,444,1080,569
0131-002,2018,11,23,8,1266,891,2157,1080
0131-002,2018,11,23,9,1239,1052,2291,2157
0131-002,2018,11,23,10,939,1018,1957,2291
0131-002,2018,11,23,11,911,1019,1930,1957
0131-002,2018,11,23,12,834,967,1801,1930
0131-002,2018,11,23,13,750,796,1546,1801
0131-002,2018,11,23,14,868,894,1762,1546
0131-002,2018,11,23,15,929,842,1771,1762
0131-002,2018,11,23,16,911,749,1660,1771
0131-002,2018,11,23,17,998,791,1789,1660
0131-002,2018,11,23,18,1117,1457,2574,1789
0131-002,2018,11,23,19,1046,1325,2371,2574
0131-002,2018,11,23,20,619,808,1427,2371
0131-002,2018,11,23,21,490,626,1116,1427
0131-002,2018,11,23,22,344,482,826,1116
0131-002,2018,11,23,23,209,335,544,826
0131-002,2018,11,23,24,150,223,373,544
0131-002,2018,11,24,1,80,150,230,373
0131-002,2018,11,24,2,81,112,193,230
0131-002,2018,11,24,3,61,90,151,193
0131-002,2018,11,24,4,61,93,154,151
0131-002,2018,11,24,5,81,130,211,154
0131-002,2018,11,24,6,234,188,422,211
0131-002,2018,11,24,7,360,316,676,422
0131-002,2018,11,24,8,536,575,1111,676
0131-002,2018,11,24,9,547,791,1338,1111
0131-002,2018,11,24,10,644,821,1465,1338
0131-002,2018,11,24,11,640,893,1533,1465
0131-002,2018,11,24,12,648,769,1417,1533
0131-002,2018,11,24,13,640,770,1410,1417
0131-002,2018,11,24,14,623,729,1352,1410
0131-002,2018,11,24,15,675,674,1349,1352
0131-002,2018,11,24,16,705,669,1374,1349
0131-002,2018,11,24,17,699,735,1434,1374
0131-002,2018,11,24,18,634,895,1529,1434
0131-002,2018,11,24,19,566,663,1229,1529
0131-002,2018,11,24,20,350,487,837,1229
0131-002,2018,11,24,21,270,428,698,837
0131-002,2018,11,24,22,204,311,515,698
0131-002,2018,11,24,23,145,249,394,515
0131-002,2018,11,24,24,79,190,269,394
0131-002,2018,11,25,1,67,119,186,269
0131-002,2018,11,25,2,50,101,151,186
0131-002,2018,11,25,3,36,70,106,151
0131-002,2018,11,25,4,26,71,97,106
0131-002,2018,11,25,5,42,92,134,97
0131-002,2018,11,25,6,105,129,234,134
0131-002,2018,11,25,7,164,200,364,234
0131-002,2018,11,25,8,222,290,512,364
0131-002,2018,11,25,9,254,416,670,512
0131-002,2018,11,25,10,300,518,818,670
0131-002,2018,11,25,11,354,586,940,818
0131-002,2018,11,25,12,414,555,969,940
0131-002,2018,11,25,13,422,588,1010,969
0131-002,2018,11,25,14,500,614,1114,1010
0131-002,2018,11,25,15,509,672,1181,1114
0131-002,2018,11,25,16,602,746,1348,1181
0131-002,2018,11,25,17,711,762,1473,1348
0131-002,2018,11,25,18,761,779,1540,1473
0131-002,2018,11,25,19,684,616,1300,1540
0131-002,2018,11,25,20,580,478,1058,1300
0131-002,2018,11,25,21,484,387,871,1058
0131-002,2018,11,25,22,404,296,700,871
0131-002,2018,11,25,23,286,172,458,700
0131-002,2018,11,25,24,126,108,234,458
0131-002,2018,11,26,1,79,100,179,234
0131-002,2018,11,26,2,47,72,119,179
0131-002,2018,11,26,3,25,42,67,119
0131-002,2018,11,26,4,48,60,108,67
0131-002,2018,11,26,5,116,100,216,108
0131-002,2018,11,26,6,375,223,598,216
0131-002,2018,11,26,7,748,458,1206,598
0131-002,2018,11,26,8,1519,936,2455,1206
0131-002,2018,11,26,9,1312,996,2308,2455
0131-002,2018,11,26,10,853,844,1697,2308
0131-002,2018,11,26,11,837,809,1646,1697
0131-002,2018,11,26,12,823,696,1519,1646
0131-002,2018,11,26,13,702,736,1438,1519
0131-002,2018,11,26,14,745,895,1640,1438
0131-002,2018,11,26,15,921,882,1803,1640
0131-002,2018,11,26,16,883,893,1776,1803
0131-002,2018,11,26,17,848,898,1746,1776
0131-002,2018,11,26,18,986,1183,2169,1746
0131-002,2018,11,26,19,799,1029,1828,2169
0131-002,2018,11,26,20,543,613,1156,1828
0131-002,2018,11,26,21,369,506,875,1156
0131-002,2018,11,26,22,280,375,655,875
0131-002,2018,11,26,23,194,218,412,655
0131-002,2018,11,26,24,112,186,298,412
0131-002,2018,11,27,1,69,103,172,298
0131-002,2018,11,27,2,64,76,140,172
0131-002,2018,11,27,3,66,67,133,140
0131-002,2018,11,27,4,59,71,130,133
0131-002,2018,11,27,5,123,124,247,130
0131-002,2018,11,27,6,310,230,540,247
0131-002,2018,11,27,7,783,467,1250,540
0131-002,2018,11,27,8,1418,980,2398,1250
0131-002,2018,11,27,9,1261,1105,2366,2398
0131-002,2018,11,27,10,954,862,1816,2366
0131-002,2018,11,27,11,933,878,1811,1816
0131-002,2018,11,27,12,807,675,1482,1811
0131-002,2018,11,27,13,712,592,1304,1482
0131-002,2018,11,27,14,803,672,1475,1304
0131-002,2018,11,27,15,917,925,1842,1475
0131-002,2018,11,27,16,864,772,1636,1842
0131-002,2018,11,27,17,792,881,1673,1636
0131-002,2018,11,27,18,998,1022,2020,1673
0131-002,2018,11,27,19,745,921,1666,2020
0131-002,2018,11,27,20,539,449,988,1666
0131-002,2018,11,27,21,414,502,916,988
0131-002,2018,11,27,22,261,343,604,916
0131-002,2018,11,27,23,236,244,480,604
0131-002,2018,11,27,24,117,118,235,480
0131-002,2018,11,28,1,52,67,119,235
0131-002,2018,11,28,2,74,66,140,119
0131-002,2018,11,28,3,54,57,111,140
0131-002,2018,11,28,4,62,67,129,111
0131-002,2018,11,28,5,150,76,226,129
0131-002,2018,11,28,6,359,173,532,226
0131-002,2018,11,28,7,695,450,1145,532
0131-002,2018,11,28,8,1352,885,2237,1145
0131-002,2018,11,28,9,1288,1058,2346,2237
0131-002,2018,11,28,10,907,741,1648,2346
0131-002,2018,11,28,11,947,753,1700,1648
0131-002,2018,11,28,12,855,660,1515,1700
0131-002,2018,11,28,13,704,578,1282,1515
0131-002,2018,11,28,14,831,778,1609,1282
0131-002,2018,11,28,15,929,673,1602,1609
0131-002,2018,11,28,16,814,693,1507,1602
0131-002,2018,11,28,17,810,675,1485,1507
0131-002,2018,11,28,18,1007,1176,2183,1485
0131-002,2018,11,28,19,808,986,1794,2183
0131-002,2018,11,28,20,515,589,1104,1794
0131-002,2018,11,28,21,358,366,724,1104
0131-002,2018,11,28,22,272,330,602,724
0131-002,2018,11,28,23,231,263,494,602
0131-002,2018,11,28,24,127,146,273,494
0131-002,2018,11,29,1,97,126,223,273
0131-002,2018,11,29,2,68,96,164,223
0131-002,2018,11,29,3,52,76,128,164
0131-002,2018,11,29,4,66,94,160,128
0131-002,2018,11,29,5,137,120,257,160
0131-002,2018,11,29,6,351,238,589,257
0131-002,2018,11,29,7,738,470,1208,589
0131-002,2018,11,29,8,1410,936,2346,1208
0131-002,2018,11,29,9,1352,1041,2393,2346
0131-002,2018,11,29,10,936,958,1894,2393
0131-002,2018,11,29,11,899,867,1766,1894
0131-002,2018,11,29,12,803,657,1460,1766
0131-002,2018,11,29,13,694,614,1308,1460
0131-002,2018,11,29,14,783,653,1436,1308
0131-002,2018,11,29,15,913,685,1598,1436
0131-002,2018,11,29,16,878,774,1652,1598
0131-002,2018,11,29,17,906,790,1696,1652
0131-002,2018,11,29,18,932,1150,2082,1696
0131-002,2018,11,29,19,878,1148,2026,2082
0131-002,2018,11,29,20,569,708,1277,2026
0131-002,2018,11,29,21,410,504,914,1277
0131-002,2018,11,29,22,312,386,698,914
0131-002,2018,11,29,23,207,301,508,698
0131-002,2018,11,29,24,139,207,346,508
0131-002,2018,11,30,1,101,152,253,346
0131-002,2018,11,30,2,68,77,145,253
0131-002,2018,11,30,3,53,52,105,145
0131-002,2018,11,30,4,74,63,137,105
0131-002,2018,11,30,5,139,80,219,137
0131-002,2018,11,30,6,338,220,558,219
0131-002,2018,11,30,7,712,446,1158,558
0131-002,2018,11,30,8,1401,925,2326,1158
0131-002,2018,11,30,9,1258,1115,2373,2326
0131-002,2018,11,30,10,940,990,1930,2373
0131-002,2018,11,30,11,882,969,1851,1930
0131-002,2018,11,30,12,805,915,1720,1851
0131-002,2018,11,30,13,713,759,1472,1720
0131-002,2018,11,30,14,785,819,1604,1472
0131-002,2018,11,30,15,936,952,1888,1604
0131-002,2018,11,30,16,875,938,1813,1888
0131-002,2018,11,30,17,922,1092,2014,1813
0131-002,2018,11,30,18,1082,1608,2690,2014
0131-002,2018,11,30,19,949,1310,2259,2690
0131-002,2018,11,30,20,623,828,1451,2259
0131-002,2018,11,30,21,462,641,1103,1451
0131-002,2018,11,30,22,351,441,792,1103
0131-002,2018,11,30,23,273,301,574,792
0131-002,2018,11,30,24,132,209,341,574
0131-002,2018,12,1,1,113,164,277,341
0131-002,2018,12,1,2,72,124,196,277
0131-002,2018,12,1,3,59,72,131,196
0131-002,2018,12,1,4,54,73,127,131
0131-002,2018,12,1,5,122,109,231,127
0131-002,2018,12,1,6,289,169,458,231
0131-002,2018,12,1,7,469,360,829,458
0131-002,2018,12,1,8,651,539,1190,829
0131-002,2018,12,1,9,653,698,1351,1190
0131-002,2018,12,1,10,765,745,1510,1351
0131-002,2018,12,1,11,797,810,1607,1510
0131-002,2018,12,1,12,788,752,1540,1607
0131-002,2018,12,1,13,672,756,1428,1540
0131-002,2018,12,1,14,678,710,1388,1428
0131-002,2018,12,1,15,689,684,1373,1388
0131-002,2018,12,1,16,717,780,1497,1373
0131-002,2018,12,1,17,700,860,1560,1497
0131-002,2018,12,1,18,785,987,1772,1560
0131-002,2018,12,1,19,653,738,1391,1772
0131-002,2018,12,1,20,398,471,869,1391
0131-002,2018,12,1,21,252,385,637,869
0131-002,2018,12,1,22,230,332,562,637
0131-002,2018,12,1,23,178,192,370,562
0131-002,2018,12,1,24,123,147,270,370
0131-002,2018,12,2,1,69,105,174,270
0131-002,2018,12,2,2,58,60,118,174
0131-002,2018,12,2,3,36,50,86,118
0131-002,2018,12,2,4,31,46,77,86
0131-002,2018,12,2,5,54,49,103,77
0131-002,2018,12,2,6,101,48,149,103
0131-002,2018,12,2,7,181,155,336,149
0131-002,2018,12,2,8,207,268,475,336
0131-002,2018,12,2,9,241,394,635,475
0131-002,2018,12,2,10,285,519,804,635
0131-002,2018,12,2,11,368,578,946,804
0131-002,2018,12,2,12,451,541,992,946
0131-002,2018,12,2,13,450,577,1027,992
0131-002,2018,12,2,14,502,565,1067,1027
0131-002,2018,12,2,15,535,633,1168,1067
0131-002,2018,12,2,16,558,719,1277,1168
0131-002,2018,12,2,17,609,711,1320,1277
0131-002,2018,12,2,18,659,730,1389,1320
0131-002,2018,12,2,19,559,576,1135,1389
0131-002,2018,12,2,20,401,364,765,1135
0131-002,2018,12,2,21,339,317,656,765
0131-002,2018,12,2,22,297,245,542,656
0131-002,2018,12,2,23,206,141,347,542
0131-002,2018,12,2,24,131,88,219,347
0131-002,2018,12,3,1,73,42,115,219
0131-002,2018,12,3,2,52,28,80,115
0131-002,2018,12,3,3,61,52,113,80
0131-002,2018,12,3,4,41,39,80,113
0131-002,2018,12,3,5,103,53,156,80
0131-002,2018,12,3,6,272,219,491,156
0131-002,2018,12,3,7,628,478,1106,491
0131-002,2018,12,3,8,1336,1072,2408,1106
0131-002,2018,12,3,9,1272,1157,2429,2408
0131-002,2018,12,3,10,895,899,1794,2429
0131-002,2018,12,3,11,866,935,1801,1794
0131-002,2018,12,3,12,800,808,1608,1801
0131-002,2018,12,3,13,697,777,1474,1608
0131-002,2018,12,3,14,745,876,1621,1474
0131-002,2018,12,3,15,856,997,1853,1621
0131-002,2018,12,3,16,811,986,1797,1853
0131-002,2018,12,3,17,700,1069,1769,1797
0131-002,2018,12,3,18,738,1289,2027,1769
0131-002,2018,12,3,19,694,1087,1781,2027
0131-002,2018,12,3,20,468,613,1081,1781
0131-002,2018,12,3,21,332,585,917,1081
0131-002,2018,12,3,22,244,381,625,917
0131-002,2018,12,3,23,176,275,451,625
0131-002,2018,12,3,24,93,162,255,451
0131-002,2018,12,4,1,71,133,204,255
0131-002,2018,12,4,2,54,80,134,204
0131-002,2018,12,4,3,47,67,114,134
0131-002,2018,12,4,4,61,82,143,114
0131-002,2018,12,4,5,111,108,219,143
0131-002,2018,12,4,6,272,190,462,219
0131-002,2018,12,4,7,554,436,990,462
0131-002,2018,12,4,8,1363,940,2303,990
0131-002,2018,12,4,9,1262,1154,2416,2303
0131-002,2018,12,4,10,938,912,1850,2416
0131-002,2018,12,4,11,860,924,1784,1850
0131-002,2018,12,4,12,790,834,1624,1784
0131-002,2018,12,4,13,714,804,1518,1624
0131-002,2018,12,4,14,813,920,1733,1518
0131-002,2018,12,4,15,920,1014,1934,1733
0131-002,2018,12,4,16,852,1012,1864,1934
0131-002,2018,12,4,17,788,1032,1820,1864
0131-002,2018,12,4,18,901,1334,2235,1820
0131-002,2018,12,4,19,747,1056,1803,2235
0131-002,2018,12,4,20,502,648,1150,1803
0131-002,2018,12,4,21,341,552,893,1150
0131-002,2018,12,4,22,255,392,647,893
0131-002,2018,12,4,23,188,286,474,647
0131-002,2018,12,4,24,99,188,287,474
0131-002,2018,12,5,1,87,129,216,287
0131-002,2018,12,5,2,56,119,175,216
0131-002,2018,12,5,3,52,76,128,175
0131-002,2018,12,5,4,54,27,81,128
0131-002,2018,12,5,5,136,121,257,81
0131-002,2018,12,5,6,306,200,506,257
0131-002,2018,12,5,7,648,430,1078,506
0131-002,2018,12,5,8,1390,808,2198,1078
0131-002,2018,12,5,9,1251,1150,2401,2198
0131-002,2018,12,5,10,981,925,1906,2401
0131-002,2018,12,5,11,855,912,1767,1906
0131-002,2018,12,5,12,780,859,1639,1767
0131-002,2018,12,5,13,731,830,1561,1639
0131-002,2018,12,5,14,881,965,1846,1561
0131-002,2018,12,5,15,983,1030,2013,1846
0131-002,2018,12,5,16,892,1039,1931,2013
0131-002,2018,12,5,17,876,996,1872,1931
0131-002,2018,12,5,18,1064,1378,2442,1872
0131-002,2018,12,5,19,800,1024,1824,2442
0131-002,2018,12,5,20,537,684,1221,1824
0131-002,2018,12,5,21,350,519,869,1221
0131-002,2018,12,5,22,266,403,669,869
0131-002,2018,12,5,23,200,298,498,669
0131-002,2018,12,5,24,151,177,328,498
0131-002,2018,12,6,1,94,141,235,328
0131-002,2018,12,6,2,83,87,170,235
0131-002,2018,12,6,3,64,78,142,170
0131-002,2018,12,6,4,46,88,134,142
0131-002,2018,12,6,5,130,115,245,134
0131-002,2018,12,6,6,272,193,465,245
0131-002,2018,12,6,7,599,454,1053,465
0131-002,2018,12,6,8,1251,834,2085,1053
0131-002,2018,12,6,9,1106,1093,2199,2085
0131-002,2018,12,6,10,799,936,1735,2199
0131-002,2018,12,6,11,810,976,1786,1735
0131-002,2018,12,6,12,786,858,1644,1786
0131-002,2018,12,6,13,730,796,1526,1644
0131-002,2018,12,6,14,860,901,1761,1526
0131-002,2018,12,6,15,949,818,1767,1761
0131-002,2018,12,6,16,898,872,1770,1767
0131-002,2018,12,6,17,907,1042,1949,1770
0131-002,2018,12,6,18,1020,1286,2306,1949
0131-002,2018,12,6,19,836,1028,1864,2306
0131-002,2018,12,6,20,536,736,1272,1864
0131-002,2018,12,6,21,328,547,875,1272
0131-002,2018,12,6,22,254,418,672,875
0131-002,2018,12,6,23,213,211,424,672
0131-002,2018,12,6,24,125,123,248,424
0131-002,2018,12,7,1,106,94,200,248
0131-002,2018,12,7,2,66,60,126,200
0131-002,2018,12,7,3,57,56,113,126
0131-002,2018,12,7,4,58,54,112,113
0131-002,2018,12,7,5,128,112,240,112
0131-002,2018,12,7,6,247,203,450,240
0131-002,2018,12,7,7,566,430,996,450
0131-002,2018,12,7,8,1244,919,2163,996
0131-002,2018,12,7,9,1136,1126,2262,2163
0131-002,2018,12,7,10,811,940,1751,2262
0131-002,2018,12,7,11,765,987,1752,1751
0131-002,2018,12,7,12,810,929,1739,1752
0131-002,2018,12,7,13,749,613,1362,1739
0131-002,2018,12,7,14,810,691,1501,1362
0131-002,2018,12,7,15,934,759,1693,1501
0131-002,2018,12,7,16,917,755,1672,1693
0131-002,2018,12,7,17,916,831,1747,1672
0131-002,2018,12,7,18,1135,1100,2235,1747
0131-002,2018,12,7,19,928,932,1860,2235
0131-002,2018,12,7,20,564,614,1178,1860
0131-002,2018,12,7,21,390,579,969,1178
0131-002,2018,12,7,22,306,432,738,969
0131-002,2018,12,7,23,163,317,480,738
0131-002,2018,12,7,24,86,210,296,480
0131-002,2018,12,8,1,62,158,220,296
0131-002,2018,12,8,2,24,107,131,220
0131-002,2018,12,8,3,34,89,123,131
0131-002,2018,12,8,4,36,91,127,123
0131-002,2018,12,8,5,56,100,156,127
0131-002,2018,12,8,6,135,159,294,156
0131-002,2018,12,8,7,414,338,752,294
0131-002,2018,12,8,8,594,557,1151,752
0131-002,2018,12,8,9,600,744,1344,1151
0131-002,2018,12,8,10,704,783,1487,1344
0131-002,2018,12,8,11,718,852,1570,1487
0131-002,2018,12,8,12,718,760,1478,1570
0131-002,2018,12,8,13,656,763,1419,1478
0131-002,2018,12,8,14,650,720,1370,1419
0131-002,2018,12,8,15,682,679,1361,1370
0131-002,2018,12,8,16,711,724,1435,1361
0131-002,2018,12,8,17,700,798,1498,1435
0131-002,2018,12,8,18,710,941,1651,1498
0131-002,2018,12,8,19,610,700,1310,1651
0131-002,2018,12,8,20,374,479,853,1310
0131-002,2018,12,8,21,261,406,667,853
0131-002,2018,12,8,22,217,322,539,667
0131-002,2018,12,8,23,122,252,374,539
0131-002,2018,12,8,24,91,164,255,374
0131-002,2018,12,9,1,61,166,227,255
0131-002,2018,12,9,2,42,111,153,227
0131-002,2018,12,9,3,24,75,99,153
0131-002,2018,12,9,4,16,69,85,99
0131-002,2018,12,9,5,27,60,87,85
0131-002,2018,12,9,6,48,87,135,87
0131-002,2018,12,9,7,86,158,244,135
0131-002,2018,12,9,8,103,226,329,244
0131-002,2018,12,9,9,147,360,507,329
0131-002,2018,12,9,10,178,393,571,507
0131-002,2018,12,9,11,239,535,774,571
0131-002,2018,12,9,12,380,530,910,774
0131-002,2018,12,9,13,337,520,857,910
0131-002,2018,12,9,14,394,544,938,857
0131-002,2018,12,9,15,469,612,1081,938
0131-002,2018,12,9,16,519,642,1161,1081
0131-002,2018,12,9,17,522,618,1140,1161
0131-002,2018,12,9,18,514,636,1150,1140
0131-002,2018,12,9,19,436,516,952,1150
0131-002,2018,12,9,20,307,411,718,952
0131-002,2018,12,9,21,228,365,593,718
0131-002,2018,12,9,22,202,251,453,593
0131-002,2018,12,9,23,145,175,320,453
0131-002,2018,12,9,24,73,124,197,320
0131-002,2018,12,10,1,48,67,115,197
0131-002,2018,12,10,2,17,27,44,115
0131-002,2018,12,10,3,4,40,44,44
0131-002,2018,12,10,4,11,46,57,44
0131-002,2018,12,10,5,76,83,159,57
0131-002,2018,12,10,6,223,181,404,159
0131-002,2018,12,10,7,538,449,987,404
0131-002,2018,12,10,8,1251,944,2195,987
0131-002,2018,12,10,9,1059,1048,2107,2195
0131-002,2018,12,10,10,588,851,1439,2107
0131-002,2018,12,10,11,735,866,1601,1439
0131-002,2018,12,10,12,841,832,1673,1601
0131-002,2018,12,10,13,780,675,1455,1673
0131-002,2018,12,10,14,864,697,1561,1455
0131-002,2018,12,10,15,914,850,1764,1561
0131-002,2018,12,10,16,886,956,1842,1764
0131-002,2018,12,10,17,881,919,1800,1842
0131-002,2018,12,10,18,1005,1113,2118,1800
0131-002,2018,12,10,19,860,962,1822,2118
0131-002,2018,12,10,20,577,674,1251,1822
0131-002,2018,12,10,21,341,531,872,1251
0131-002,2018,12,10,22,250,407,657,872
0131-002,2018,12,10,23,132,293,425,657
0131-002,2018,12,10,24,71,165,236,425
0131-002,2018,12,11,1,43,90,133,236
0131-002,2018,12,11,2,44,69,113,133
0131-002,2018,12,11,3,23,75,98,113
0131-002,2018,12,11,4,22,80,102,98
0131-002,2018,12,11,5,86,119,205,102
0131-002,2018,12,11,6,191,179,370,205
0131-002,2018,12,11,7,482,383,865,370
0131-002,2018,12,11,8,1105,816,1921,865
0131-002,2018,12,11,9,1003,1021,2024,1921
0131-002,2018,12,11,10,728,826,1554,2024
0131-002,2018,12,11,11,847,943,1790,1554
0131-002,2018,12,11,12,852,838,1690,1790
0131-002,2018,12,11,13,771,731,1502,1690
0131-002,2018,12,11,14,841,908,1749,1502
0131-002,2018,12,11,15,941,879,1820,1749
0131-002,2018,12,11,16,914,870,1784,1820
0131-002,2018,12,11,17,874,909,1783,1784
0131-002,2018,12,11,18,930,1104,2034,1783
0131-002,2018,12,11,19,852,948,1800,2034
0131-002,2018,12,11,20,548,630,1178,1800
0131-002,2018,12,11,21,593,540,1133,1178
0131-002,2018,12,11,22,284,400,684,1133
0131-002,2018,12,11,23,217,274,491,684
0131-002,2018,12,11,24,136,171,307,491
0131-002,2018,12,12,1,79,128,207,307
0131-002,2018,12,12,2,54,77,131,207
0131-002,2018,12,12,3,18,84,102,131
0131-002,2018,12,12,4,26,90,116,102
0131-002,2018,12,12,5,72,117,189,116
0131-002,2018,12,12,6,173,188,361,189
0131-002,2018,12,12,7,479,430,909,361
0131-002,2018,12,12,8,1130,928,2058,909
0131-002,2018,12,12,9,974,1115,2089,2058
0131-002,2018,12,12,10,653,928,1581,2089
0131-002,2018,12,12,11,917,969,1886,1581
0131-002,2018,12,12,12,829,786,1615,1886
0131-002,2018,12,12,13,762,751,1513,1615
0131-002,2018,12,12,14,800,895,1695,1513
0131-002,2018,12,12,15,890,901,1791,1695
0131-002,2018,12,12,16,915,858,1773,1791
0131-002,2018,12,12,17,973,1068,2041,1773
0131-002,2018,12,12,18,1072,1294,2366,2041
0131-002,2018,12,12,19,938,977,1915,2366
0131-002,2018,12,12,20,542,691,1233,1915
0131-002,2018,12,12,21,384,502,886,1233
0131-002,2018,12,12,22,267,400,667,886
0131-002,2018,12,12,23,145,310,455,667
0131-002,2018,12,12,24,101,195,296,455
0131-002,2018,12,13,1,64,124,188,296
0131-002,2018,12,13,2,36,88,124,188
0131-002,2018,12,13,3,28,79,107,124
0131-002,2018,12,13,4,19,86,105,107
0131-002,2018,12,13,5,71,112,183,105
0131-002,2018,12,13,6,175,209,384,183
0131-002,2018,12,13,7,668,462,1130,384
0131-002,2018,12,13,8,1330,885,2215,1130
0131-002,2018,12,13,9,1229,1067,2296,2215
0131-002,2018,12,13,10,868,947,1815,2296
0131-002,2018,12,13,11,854,922,1776,1815
0131-002,2018,12,13,12,794,758,1552,1776
0131-002,2018,12,13,13,712,705,1417,1552
0131-002,2018,12,13,14,822,777,1599,1417
0131-002,2018,12,13,15,931,752,1683,1599
0131-002,2018,12,13,16,888,823,1711,1683
0131-002,2018,12,13,17,906,916,1822,1711
0131-002,2018,12,13,18,976,1218,2194,1822
0131-002,2018,12,13,19,857,1088,1945,2194
0131-002,2018,12,13,20,552,722,1274,1945
0131-002,2018,12,13,21,369,526,895,1274
0131-002,2018,12,13,22,283,402,685,895
0131-002,2018,12,13,23,101,177,278,685
0131-002,2018,12,13,24,97,127,224,278
0131-002,2018,12,14,1,47,109,156,224
0131-002,2018,12,14,2,34,89,123,156
0131-002,2018,12,14,3,14,86,100,123
0131-002,2018,12,14,4,27,86,113,100
0131-002,2018,12,14,5,63,87,150,113
0131-002,2018,12,14,6,162,202,364,150
0131-002,2018,12,14,7,532,441,973,364
0131-002,2018,12,14,8,1170,915,2085,973
0131-002,2018,12,14,9,1121,1118,2239,2085
0131-002,2018,12,14,10,882,906,1788,2239
0131-002,2018,12,14,11,870,890,1760,1788
0131-002,2018,12,14,12,858,870,1728,1760
0131-002,2018,12,14,13,787,676,1463,1728
0131-002,2018,12,14,14,832,760,1592,1463
0131-002,2018,12,14,15,972,808,1780,1592
0131-002,2018,12,14,16,986,840,1826,1780
0131-002,2018,12,14,17,948,886,1834,1826
0131-002,2018,12,14,18,1112,1174,2286,1834
0131-002,2018,12,14,19,960,966,1926,2286
0131-002,2018,12,14,20,614,658,1272,1926
0131-002,2018,12,14,21,441,580,1021,1272
0131-002,2018,12,14,22,324,450,774,1021
0131-002,2018,12,14,23,150,297,447,774
0131-002,2018,12,14,24,92,215,307,447
0131-002,2018,12,15,1,62,129,191,307
0131-002,2018,12,15,2,58,141,199,191
0131-002,2018,12,15,3,36,79,115,199
0131-002,2018,12,15,4,23,90,113,115
0131-002,2018,12,15,5,57,100,157,113
0131-002,2018,12,15,6,125,157,282,157
0131-002,2018,12,15,7,237,263,500,282
0131-002,2018,12,15,8,408,504,912,500
0131-002,2018,12,15,9,409,670,1079,912
0131-002,2018,12,15,10,430,722,1152,1079
0131-002,2018,12,15,11,514,822,1336,1152
0131-002,2018,12,15,12,741,780,1521,1336
0131-002,2018,12,15,13,692,663,1355,1521
0131-002,2018,12,15,14,612,717,1329,1355
0131-002,2018,12,15,15,664,493,1157,1329
0131-002,2018,12,15,16,747,629,1376,1157
0131-002,2018,12,15,17,753,796,1549,1376
0131-002,2018,12,15,18,708,898,1606,1549
0131-002,2018,12,15,19,657,638,1295,1606
0131-002,2018,12,15,20,464,456,920,1295
0131-002,2018,12,15,21,225,378,603,920
0131-002,2018,12,15,22,192,329,521,603
0131-002,2018,12,15,23,106,237,343,521
0131-002,2018,12,15,24,82,203,285,343
0131-002,2018,12,16,1,52,145,197,285
0131-002,2018,12,16,2,37,117,154,197
0131-002,2018,12,16,3,33,86,119,154
0131-002,2018,12,16,4,34,87,121,119
0131-002,2018,12,16,5,27,76,103,121
0131-002,2018,12,16,6,41,106,147,103
0131-002,2018,12,16,7,83,168,251,147
0131-002,2018,12,16,8,127,270,397,251
0131-002,2018,12,16,9,141,368,509,397
0131-002,2018,12,16,10,163,470,633,509
0131-002,2018,12,16,11,267,530,797,633
0131-002,2018,12,16,12,311,530,841,797
0131-002,2018,12,16,13,374,550,924,841
0131-002,2018,12,16,14,391,606,997,924
0131-002,2018,12,16,15,473,689,1162,997
0131-002,2018,12,16,16,545,696,1241,1162
0131-002,2018,12,16,17,588,664,1252,1241
0131-002,2018,12,16,18,577,664,1241,1252
0131-002,2018,12,16,19,456,486,942,1241
0131-002,2018,12,16,20,359,436,795,942
0131-002,2018,12,16,21,306,351,657,795
0131-002,2018,12,16,22,242,238,480,657
0131-002,2018,12,16,23,178,190,368,480
0131-002,2018,12,16,24,133,111,244,368
0131-002,2018,12,17,1,79,72,151,244
0131-002,2018,12,17,2,68,60,128,151
0131-002,2018,12,17,3,53,71,124,128
0131-002,2018,12,17,4,57,73,130,124
0131-002,2018,12,17,5,156,104,260,130
0131-002,2018,12,17,6,350,228,578,260
0131-002,2018,12,17,7,760,476,1236,578
0131-002,2018,12,17,8,1498,865,2363,1236
0131-002,2018,12,17,9,1365,926,2291,2363
0131-002,2018,12,17,10,911,949,1860,2291
0131-002,2018,12,17,11,885,858,1743,1860
0131-002,2018,12,17,12,857,842,1699,1743
0131-002,2018,12,17,13,768,649,1417,1699
0131-002,2018,12,17,14,895,489,1384,1417
0131-002,2018,12,17,15,860,577,1437,1384
0131-002,2018,12,17,16,955,820,1775,1437
0131-002,2018,12,17,17,892,924,1816,1775
0131-002,2018,12,17,18,963,1241,2204,1816
0131-002,2018,12,17,19,793,1048,1841,2204
0131-002,2018,12,17,20,545,707,1252,1841
0131-002,2018,12,17,21,396,579,975,1252
0131-002,2018,12,17,22,321,425,746,975
0131-002,2018,12,17,23,237,275,512,746
0131-002,2018,12,17,24,162,162,324,512
0131-002,2018,12,18,1,87,125,212,324
0131-002,2018,12,18,2,81,90,171,212
0131-002,2018,12,18,3,92,61,153,171
0131-002,2018,12,18,4,77,85,162,153
0131-002,2018,12,18,5,127,117,244,162
0131-002,2018,12,18,6,265,195,460,244
0131-002,2018,12,18,7,565,453,1018,460
0131-002,2018,12,18,8,1237,931,2168,1018
0131-002,2018,12,18,9,1378,1032,2410,2168
0131-002,2018,12,18,10,842,852,1694,2410
0131-002,2018,12,18,11,895,884,1779,1694
0131-002,2018,12,18,12,859,850,1709,1779
0131-002,2018,12,18,13,766,843,1609,1709
0131-002,2018,12,18,14,827,892,1719,1609
0131-002,2018,12,18,15,935,899,1834,1719
0131-002,2018,12,18,16,909,964,1873,1834
0131-002,2018,12,18,17,901,988,1889,1873
0131-002,2018,12,18,18,988,1164,2152,1889
0131-002,2018,12,18,19,825,1075,1900,2152
0131-002,2018,12,18,20,575,674,1249,1900
0131-002,2018,12,18,21,406,610,1016,1249
0131-002,2018,12,18,22,346,440,786,1016
0131-002,2018,12,18,23,259,289,548,786
0131-002,2018,12,18,24,143,178,321,548
0131-002,2018,12,19,1,120,127,247,321
0131-002,2018,12,19,2,81,105,186,247
0131-002,2018,12,19,3,73,86,159,186
0131-002,2018,12,19,4,96,92,188,159
0131-002,2018,12,19,5,162,111,273,188
0131-002,2018,12,19,6,366,215,581,273
0131-002,2018,12,19,7,654,454,1108,581
0131-002,2018,12,19,8,1318,914,2232,1108
0131-002,2018,12,19,9,1369,1037,2406,2232
0131-002,2018,12,19,10,896,838,1734,2406
0131-002,2018,12,19,11,948,866,1814,1734
0131-002,2018,12,19,12,896,880,1776,1814
0131-002,2018,12,19,13,801,818,1619,1776
0131-002,2018,12,19,14,854,858,1712,1619
0131-002,2018,12,19,15,934,932,1866,1712
0131-002,2018,12,19,16,910,908,1818,1866
0131-002,2018,12,19,17,944,962,1906,1818
0131-002,2018,12,19,18,1016,1088,2104,1906
0131-002,2018,12,19,19,842,948,1790,2104
0131-002,2018,12,19,20,590,688,1278,1790
0131-002,2018,12,19,21,443,592,1035,1278
0131-002,2018,12,19,22,348,434,782,1035
0131-002,2018,12,19,23,261,278,539,782
0131-002,2018,12,19,24,147,167,314,539
0131-002,2018,12,20,1,132,140,272,314
0131-002,2018,12,20,2,94,92,186,272
0131-002,2018,12,20,3,62,75,137,186
0131-002,2018,12,20,4,76,103,179,137
0131-002,2018,12,20,5,195,124,319,179
0131-002,2018,12,20,6,354,196,550,319
0131-002,2018,12,20,7,742,455,1197,550
0131-002,2018,12,20,8,1399,898,2297,1197
0131-002,2018,12,20,9,1360,1042,2402,2297
0131-002,2018,12,20,10,950,825,1775,2402
0131-002,2018,12,20,11,1001,848,1849,1775
0131-002,2018,12,20,12,934,910,1844,1849
0131-002,2018,12,20,13,836,794,1630,1844
0131-002,2018,12,20,14,882,825,1707,1630
0131-002,2018,12,20,15,933,964,1897,1707
0131-002,2018,12,20,16,910,853,1763,1897
0131-002,2018,12,20,17,986,936,1922,1763
0131-002,2018,12,20,18,1044,1013,2057,1922
0131-002,2018,12,20,19,859,821,1680,2057
0131-002,2018,12,20,20,606,701,1307,1680
0131-002,2018,12,20,21,480,574,1054,1307
0131-002,2018,12,20,22,349,429,778,1054
0131-002,2018,12,20,23,275,284,559,778
0131-002,2018,12,20,24,177,183,360,559
0131-002,2018,12,21,1,132,167,299,360
0131-002,2018,12,21,2,87,99,186,299
0131-002,2018,12,21,3,68,96,164,186
0131-002,2018,12,21,4,72,94,166,164
0131-002,2018,12,21,5,97,113,210,166
0131-002,2018,12,21,6,191,217,408,210
0131-002,2018,12,21,7,497,452,949,408
0131-002,2018,12,21,8,1095,911,2006,949
0131-002,2018,12,21,9,1106,1109,2215,2006
0131-002,2018,12,21,10,954,873,1827,2215
0131-002,2018,12,21,11,976,793,1769,1827
0131-002,2018,12,21,12,906,812,1718,1769
0131-002,2018,12,21,13,825,739,1564,1718
0131-002,2018,12,21,14,854,829,1683,1564
0131-002,2018,12,21,15,1009,856,1865,1683
0131-002,2018,12,21,16,1054,926,1980,1865
0131-002,2018,12,21,17,981,941,1922,1980
0131-002,2018,12,21,18,1088,1247,2335,1922
0131-002,2018,12,21,19,991,1000,1991,2335
0131-002,2018,12,21,20,663,703,1366,1991
0131-002,2018,12,21,21,492,581,1073,1366
0131-002,2018,12,21,22,341,469,810,1073
0131-002,2018,12,21,23,289,329,618,810
0131-002,2018,12,21,24,187,242,429,618
0131-002,2018,12,22,1,142,179,321,429
0131-002,2018,12,22,2,132,142,274,321
0131-002,2018,12,22,3,72,104,176,274
0131-002,2018,12,22,4,86,113,199,176
0131-002,2018,12,22,5,135,116,251,199
0131-002,2018,12,22,6,277,188,465,251
0131-002,2018,12,22,7,456,335,791,465
0131-002,2018,12,22,8,663,496,1159,791
0131-002,2018,12,22,9,649,671,1320,1159
0131-002,2018,12,22,10,703,722,1425,1320
0131-002,2018,12,22,11,773,805,1578,1425
0131-002,2018,12,22,12,761,740,1501,1578
0131-002,2018,12,22,13,682,687,1369,1501
0131-002,2018,12,22,14,725,694,1419,1369
0131-002,2018,12,22,15,698,739,1437,1419
0131-002,2018,12,22,16,771,746,1517,1437
0131-002,2018,12,22,17,755,735,1490,1517
0131-002,2018,12,22,18,831,922,1753,1490
0131-002,2018,12,22,19,682,670,1352,1753
0131-002,2018,12,22,20,405,480,885,1352
0131-002,2018,12,22,21,330,399,729,885
0131-002,2018,12,22,22,242,319,561,729
0131-002,2018,12,22,23,183,241,424,561
0131-002,2018,12,22,24,140,156,296,424
0131-002,2018,12,23,1,103,133,236,296
0131-002,2018,12,23,2,79,108,187,236
0131-002,2018,12,23,3,62,82,144,187
0131-002,2018,12,23,4,44,60,104,144
0131-002,2018,12,23,5,46,70,116,104
0131-002,2018,12,23,6,83,81,164,116
0131-002,2018,12,23,7,165,171,336,164
0131-002,2018,12,23,8,201,247,448,336
0131-002,2018,12,23,9,228,351,579,448
0131-002,2018,12,23,10,271,515,786,579
0131-002,2018,12,23,11,361,534,895,786
0131-002,2018,12,23,12,376,512,888,895
0131-002,2018,12,23,13,353,535,888,888
0131-002,2018,12,23,14,371,495,866,888
0131-002,2018,12,23,15,394,561,955,866
0131-002,2018,12,23,16,575,367,942,955
0131-002,2018,12,23,17,577,389,966,942
0131-002,2018,12,23,18,558,350,908,966
0131-002,2018,12,23,19,529,270,799,908
0131-002,2018,12,23,20,356,255,611,799
0131-002,2018,12,23,21,330,213,543,611
0131-002,2018,12,23,22,242,138,380,543
0131-002,2018,12,23,23,176,122,298,380
0131-002,2018,12,23,24,117,70,187,298
0131-002,2018,12,24,1,60,49,109,187
0131-002,2018,12,24,2,58,44,102,109
0131-002,2018,12,24,3,28,38,66,102
0131-002,2018,12,24,4,27,26,53,66
0131-002,2018,12,24,5,68,53,121,53
0131-002,2018,12,24,6,150,102,252,121
0131-002,2018,12,24,7,359,245,604,252
0131-002,2018,12,24,8,805,640,1445,604
0131-002,2018,12,24,9,660,916,1576,1445
0131-002,2018,12,24,10,438,684,1122,1576
0131-002,2018,12,24,11,669,809,1478,1122
0131-002,2018,12,24,12,690,557,1247,1478
0131-002,2018,12,24,13,637,378,1015,1247
0131-002,2018,12,24,14,671,465,1136,1015
0131-002,2018,12,24,15,732,569,1301,1136
0131-002,2018,12,24,16,733,625,1358,1301
0131-002,2018,12,24,17,725,728,1453,1358
0131-002,2018,12,24,18,853,912,1765,1453
0131-002,2018,12,24,19,756,813,1569,1765
0131-002,2018,12,24,20,493,596,1089,1569
0131-002,2018,12,24,21,343,481,824,1089
0131-002,2018,12,24,22,198,261,459,824
0131-002,2018,12,24,23,144,268,412,459
0131-002,2018,12,24,24,59,139,198,412
0131-002,2018,12,25,1,48,84,132,198
0131-002,2018,12,25,2,31,67,98,132
0131-002,2018,12,25,3,22,71,93,98
0131-002,2018,12,25,4,25,60,85,93
0131-002,2018,12,25,5,43,84,127,85
0131-002,2018,12,25,6,92,116,208,127
0131-002,2018,12,25,7,143,238,381,208
0131-002,2018,12,25,8,215,352,567,381
0131-002,2018,12,25,9,173,455,628,567
0131-002,2018,12,25,10,213,498,711,628
0131-002,2018,12,25,11,304,567,871,711
0131-002,2018,12,25,12,334,286,620,871
0131-002,2018,12,25,13,366,325,691,620
0131-002,2018,12,25,14,451,359,810,691
0131-002,2018,12,25,15,443,413,856,810
0131-002,2018,12,25,16,467,368,835,856
0131-002,2018,12,25,17,489,362,851,835
0131-002,2018,12,25,18,509,372,881,851
0131-002,2018,12,25,19,397,241,638,881
0131-002,2018,12,25,20,287,212,499,638
0131-002,2018,12,25,21,274,218,492,499
0131-002,2018,12,25,22,239,217,456,492
0131-002,2018,12,25,23,167,202,369,456
0131-002,2018,12,25,24,108,120,228,369
0131-002,2018,12,26,1,69,82,151,228
0131-002,2018,12,26,2,40,70,110,151
0131-002,2018,12,26,3,42,57,99,110
0131-002,2018,12,26,4,61,68,129,99
0131-002,2018,12,26,5,145,91,236,129
0131-002,2018,12,26,6,320,201,521,236
0131-002,2018,12,26,7,625,442,1067,521
0131-002,2018,12,26,8,1223,889,2112,1067
0131-002,2018,12,26,9,1085,1008,2093,2112
0131-002,2018,12,26,10,797,818,1615,2093
0131-002,2018,12,26,11,735,785,1520,1615
0131-002,2018,12,26,12,730,702,1432,1520
0131-002,2018,12,26,13,664,785,1449,1432
0131-002,2018,12,26,14,729,859,1588,1449
0131-002,2018,12,26,15,772,826,1598,1588
0131-002,2018,12,26,16,779,832,1611,1598
0131-002,2018,12,26,17,729,885,1614,1611
0131-002,2018,12,26,18,821,870,1691,1614
0131-002,2018,12,26,19,742,723,1465,1691
0131-002,2018,12,26,20,449,503,952,1465
0131-002,2018,12,26,21,313,405,718,952
0131-002,2018,12,26,22,277,267,544,718
0131-002,2018,12,26,23,193,170,363,544
0131-002,2018,12,26,24,121,112,233,363
0131-002,2018,12,27,1,72,94,166,233
0131-002,2018,12,27,2,39,62,101,166
0131-002,2018,12,27,3,29,91,120,101
0131-002,2018,12,27,4,23,75,98,120
0131-002,2018,12,27,5,63,98,161,98
0131-002,2018,12,27,6,161,199,360,161
0131-002,2018,12,27,7,344,396,740,360
0131-002,2018,12,27,8,919,691,1610,740
0131-002,2018,12,27,9,734,742,1476,1610
0131-002,2018,12,27,10,477,694,1171,1476
0131-002,2018,12,27,11,479,813,1292,1171
0131-002,2018,12,27,12,592,609,1201,1292
0131-002,2018,12,27,13,607,394,1001,1201
0131-002,2018,12,27,14,724,508,1232,1001
0131-002,2018,12,27,15,741,605,1346,1232
0131-002,2018,12,27,16,735,550,1285,1346
0131-002,2018,12,27,17,688,587,1275,1285
0131-002,2018,12,27,18,696,740,1436,1275
0131-002,2018,12,27,19,485,639,1124,1436
0131-002,2018,12,27,20,305,429,734,1124
0131-002,2018,12,27,21,240,349,589,734
0131-002,2018,12,27,22,200,246,446,589
0131-002,2018,12,27,23,126,198,324,446
0131-002,2018,12,27,24,87,117,204,324
0131-002,2018,12,28,1,52,90,142,204
0131-002,2018,12,28,2,35,67,102,142
0131-002,2018,12,28,3,21,48,69,102
0131-002,2018,12,28,4,19,56,75,69
0131-002,2018,12,28,5,55,61,116,75
0131-002,2018,12,28,6,149,87,236,116
0131-002,2018,12,28,7,322,246,568,236
0131-002,2018,12,28,8,827,666,1493,568
0131-002,2018,12,28,9,741,673,1414,1493
0131-002,2018,12,28,10,474,587,1061,1414
0131-002,2018,12,28,11,434,606,1040,1061
0131-002,2018,12,28,12,447,565,1012,1040
0131-002,2018,12,28,13,499,572,1071,1012
0131-002,2018,12,28,14,633,590,1223,1071
0131-002,2018,12,28,15,671,626,1297,1223
0131-002,2018,12,28,16,638,664,1302,1297
0131-002,2018,12,28,17,632,704,1336,1302
0131-002,2018,12,28,18,621,908,1529,1336
0131-002,2018,12,28,19,550,768,1318,1529
0131-002,2018,12,28,20,364,471,835,1318
0131-002,2018,12,28,21,204,333,537,835
0131-002,2018,12,28,22,185,277,462,537
0131-002,2018,12,28,23,120,193,313,462
0131-002,2018,12,28,24,82,129,211,313
0131-002,2018,12,29,1,53,94,147,211
0131-002,2018,12,29,2,39,70,109,147
0131-002,2018,12,29,3,23,67,90,109
0131-002,2018,12,29,4,21,58,79,90
0131-002,2018,12,29,5,40,75,115,79
0131-002,2018,12,29,6,94,83,177,115
0131-002,2018,12,29,7,162,198,360,177
0131-002,2018,12,29,8,246,337,583,360
0131-002,2018,12,29,9,285,413,698,583
0131-002,2018,12,29,10,281,457,738,698
0131-002,2018,12,29,11,338,493,831,738
0131-002,2018,12,29,12,415,458,873,831
0131-002,2018,12,29,13,466,448,914,873
0131-002,2018,12,29,14,445,400,845,914
0131-002,2018,12,29,15,516,462,978,845
0131-002,2018,12,29,16,479,453,932,978
0131-002,2018,12,29,17,519,454,973,932
0131-002,2018,12,29,18,436,517,953,973
0131-002,2018,12,29,19,326,398,724,953
0131-002,2018,12,29,20,236,258,494,724
0131-002,2018,12,29,21,152,211,363,494
0131-002,2018,12,29,22,134,184,318,363
0131-002,2018,12,29,23,75,137,212,318
0131-002,2018,12,29,24,52,102,154,212
0131-002,2018,12,30,1,44,64,108,154
0131-002,2018,12,30,2,31,74,105,108
0131-002,2018,12,30,3,19,34,53,105
0131-002,2018,12,30,4,21,35,56,53
0131-002,2018,12,30,5,29,42,71,56
0131-002,2018,12,30,6,35,40,75,71
0131-002,2018,12,30,7,67,78,145,75
0131-002,2018,12,30,8,72,131,203,145
0131-002,2018,12,30,9,83,193,276,203
0131-002,2018,12,30,10,133,250,383,276
0131-002,2018,12,30,11,174,344,518,383
0131-002,2018,12,30,12,220,303,523,518
0131-002,2018,12,30,13,286,302,588,523
0131-002,2018,12,30,14,305,335,640,588
0131-002,2018,12,30,15,348,343,691,640
0131-002,2018,12,30,16,379,356,735,691
0131-002,2018,12,30,17,432,382,814,735
0131-002,2018,12,30,18,349,389,738,814
0131-002,2018,12,30,19,289,303,592,738
0131-002,2018,12,30,20,205,249,454,592
0131-002,2018,12,30,21,138,215,353,454
0131-002,2018,12,30,22,125,154,279,353
0131-002,2018,12,30,23,95,112,207,279
0131-002,2018,12,30,24,45,68,113,207
0131-002,2018,12,31,1,23,45,68,113
0131-002,2018,12,31,2,11,31,42,68
0131-002,2018,12,31,3,16,31,47,42
0131-002,2018,12,31,4,13,25,38,47
0131-002,2018,12,31,5,23,48,71,38
0131-002,2018,12,31,6,81,80,161,71
0131-002,2018,12,31,7,185,165,350,161
0131-002,2018,12,31,8,539,376,915,350
0131-002,2018,12,31,9,448,464,912,915
0131-002,2018,12,31,10,347,423,770,912
0131-002,2018,12,31,11,381,488,869,770
0131-002,2018,12,31,12,456,515,971,869
0131-002,2018,12,31,13,419,467,886,971
0131-002,2018,12,31,14,558,446,1004,886
0131-002,2018,12,31,15,664,511,1175,1004
0131-002,2018,12,31,16,635,518,1153,1175
0131-002,2018,12,31,17,625,597,1222,1153
0131-002,2018,12,31,18,607,629,1236,1222
0131-002,2018,12,31,19,458,547,1005,1236
0131-002,2018,12,31,20,265,361,626,1005
0131-002,2018,12,31,21,176,300,476,626
0131-002,2018,12,31,22,127,222,349,476
0131-002,2018,12,31,23,78,190,268,349
0131-002,2018,12,31,24,46,126,172,268
