ID,Year,M,D,H,1,2,sum,sump
0130-001,2011,1,1,1,378,359,737,0
0130-001,2011,1,1,2,351,378,729,737
0130-001,2011,1,1,3,245,223,468,729
0130-001,2011,1,1,4,194,164,358,468
0130-001,2011,1,1,5,158,156,314,358
0130-001,2011,1,1,6,199,180,379,314
0130-001,2011,1,1,7,297,258,555,379
0130-001,2011,1,1,8,356,335,691,555
0130-001,2011,1,1,9,490,437,927,691
0130-001,2011,1,1,10,600,535,1135,927
0130-001,2011,1,1,11,777,705,1482,1135
0130-001,2011,1,1,12,910,897,1807,1482
0130-001,2011,1,1,13,1066,1095,2161,1807
0130-001,2011,1,1,14,984,956,1940,2161
0130-001,2011,1,1,15,1097,1159,2256,1940
0130-001,2011,1,1,16,1081,1076,2157,2256
0130-001,2011,1,1,17,1319,1228,2547,2157
0130-001,2011,1,1,18,1239,1280,2519,2547
0130-001,2011,1,1,19,892,979,1871,2519
0130-001,2011,1,1,20,613,693,1306,1871
0130-001,2011,1,1,21,654,759,1413,1306
0130-001,2011,1,1,22,537,605,1142,1413
0130-001,2011,1,1,23,406,430,836,1142
0130-001,2011,1,1,24,286,313,599,836
0130-001,2011,1,2,1,230,246,476,599
0130-001,2011,1,2,2,162,169,331,476
0130-001,2011,1,2,3,108,130,238,331
0130-001,2011,1,2,4,80,79,159,238
0130-001,2011,1,2,5,78,106,184,159
0130-001,2011,1,2,6,105,141,246,184
0130-001,2011,1,2,7,209,217,426,246
0130-001,2011,1,2,8,256,269,525,426
0130-001,2011,1,2,9,460,489,949,525
0130-001,2011,1,2,10,607,581,1188,949
0130-001,2011,1,2,11,669,791,1460,1188
0130-001,2011,1,2,12,720,799,1519,1460
0130-001,2011,1,2,13,971,1101,2072,1519
0130-001,2011,1,2,14,1161,1274,2435,2072
0130-001,2011,1,2,15,1222,1349,2571,2435
0130-001,2011,1,2,16,1282,1303,2585,2571
0130-001,2011,1,2,17,1128,1179,2307,2585
0130-001,2011,1,2,18,1117,1177,2294,2307
0130-001,2011,1,2,19,933,1009,1942,2294
0130-001,2011,1,2,20,937,950,1887,1942
0130-001,2011,1,2,21,766,874,1640,1887
0130-001,2011,1,2,22,624,657,1281,1640
0130-001,2011,1,2,23,361,406,767,1281
0130-001,2011,1,2,24,308,322,630,767
0130-001,2011,1,3,1,209,199,408,630
0130-001,2011,1,3,2,139,152,291,408
0130-001,2011,1,3,3,93,111,204,291
0130-001,2011,1,3,4,81,92,173,204
0130-001,2011,1,3,5,102,104,206,173
0130-001,2011,1,3,6,237,241,478,206
0130-001,2011,1,3,7,630,674,1304,478
0130-001,2011,1,3,8,1499,1546,3045,1304
0130-001,2011,1,3,9,1726,1772,3498,3045
0130-001,2011,1,3,10,1317,1300,2617,3498
0130-001,2011,1,3,11,1290,1315,2605,2617
0130-001,2011,1,3,12,1100,1256,2356,2605
0130-001,2011,1,3,13,1089,1177,2266,2356
0130-001,2011,1,3,14,1262,1359,2621,2266
0130-001,2011,1,3,15,1396,1547,2943,2621
0130-001,2011,1,3,16,1427,1510,2937,2943
0130-001,2011,1,3,17,1343,1520,2863,2937
0130-001,2011,1,3,18,1411,1527,2938,2863
0130-001,2011,1,3,19,1428,1647,3075,2938
0130-001,2011,1,3,20,1120,1245,2365,3075
0130-001,2011,1,3,21,834,887,1721,2365
0130-001,2011,1,3,22,715,867,1582,1721
0130-001,2011,1,3,23,533,551,1084,1582
0130-001,2011,1,3,24,368,440,808,1084
0130-001,2011,1,4,1,255,267,522,808
0130-001,2011,1,4,2,168,153,321,522
0130-001,2011,1,4,3,110,142,252,321
0130-001,2011,1,4,4,98,116,214,252
0130-001,2011,1,4,5,115,126,241,214
0130-001,2011,1,4,6,230,255,485,241
0130-001,2011,1,4,7,562,594,1156,485
0130-001,2011,1,4,8,1476,1581,3057,1156
0130-001,2011,1,4,9,1768,1767,3535,3057
0130-001,2011,1,4,10,1391,1424,2815,3535
0130-001,2011,1,4,11,1197,1336,2533,2815
0130-001,2011,1,4,12,1122,1219,2341,2533
0130-001,2011,1,4,13,1065,1082,2147,2341
0130-001,2011,1,4,14,1262,1278,2540,2147
0130-001,2011,1,4,15,1352,1351,2703,2540
0130-001,2011,1,4,16,1382,1459,2841,2703
0130-001,2011,1,4,17,1356,1421,2777,2841
0130-001,2011,1,4,18,1356,1489,2845,2777
0130-001,2011,1,4,19,1357,1560,2917,2845
0130-001,2011,1,4,20,1095,1245,2340,2917
0130-001,2011,1,4,21,858,986,1844,2340
0130-001,2011,1,4,22,799,879,1678,1844
0130-001,2011,1,4,23,589,642,1231,1678
0130-001,2011,1,4,24,347,376,723,1231
0130-001,2011,1,5,1,287,307,594,723
0130-001,2011,1,5,2,161,187,348,594
0130-001,2011,1,5,3,120,140,260,348
0130-001,2011,1,5,4,98,120,218,260
0130-001,2011,1,5,5,115,133,248,218
0130-001,2011,1,5,6,196,209,405,248
0130-001,2011,1,5,7,518,583,1101,405
0130-001,2011,1,5,8,1225,1284,2509,1101
0130-001,2011,1,5,9,1489,1558,3047,2509
0130-001,2011,1,5,10,1173,1136,2309,3047
0130-001,2011,1,5,11,1244,1319,2563,2309
0130-001,2011,1,5,12,1231,1398,2629,2563
0130-001,2011,1,5,13,1119,1239,2358,2629
0130-001,2011,1,5,14,1235,1327,2562,2358
0130-001,2011,1,5,15,1341,1490,2831,2562
0130-001,2011,1,5,16,1334,1467,2801,2831
0130-001,2011,1,5,17,1275,1372,2647,2801
0130-001,2011,1,5,18,1322,1518,2840,2647
0130-001,2011,1,5,19,1352,1667,3019,2840
0130-001,2011,1,5,20,1007,1113,2120,3019
0130-001,2011,1,5,21,798,849,1647,2120
0130-001,2011,1,5,22,737,776,1513,1647
0130-001,2011,1,5,23,499,533,1032,1513
0130-001,2011,1,5,24,332,413,745,1032
0130-001,2011,1,6,1,237,746,983,745
0130-001,2011,1,6,2,147,490,637,983
0130-001,2011,1,6,3,123,144,267,637
0130-001,2011,1,6,4,96,109,205,267
0130-001,2011,1,6,5,103,117,220,205
0130-001,2011,1,6,6,165,217,382,220
0130-001,2011,1,6,7,476,585,1061,382
0130-001,2011,1,6,8,1271,1581,2852,1061
0130-001,2011,1,6,9,1334,1655,2989,2852
0130-001,2011,1,6,10,1027,1281,2308,2989
0130-001,2011,1,6,11,1052,1281,2333,2308
0130-001,2011,1,6,12,1112,1224,2336,2333
0130-001,2011,1,6,13,1044,1099,2143,2336
0130-001,2011,1,6,14,1304,1289,2593,2143
0130-001,2011,1,6,15,1349,1470,2819,2593
0130-001,2011,1,6,16,1373,1408,2781,2819
0130-001,2011,1,6,17,1301,1099,2400,2781
0130-001,2011,1,6,18,1375,1325,2700,2400
0130-001,2011,1,6,19,1456,1508,2964,2700
0130-001,2011,1,6,20,974,1113,2087,2964
0130-001,2011,1,6,21,900,1020,1920,2087
0130-001,2011,1,6,22,803,961,1764,1920
0130-001,2011,1,6,23,550,621,1171,1764
0130-001,2011,1,6,24,370,449,819,1171
0130-001,2011,1,7,1,269,281,550,819
0130-001,2011,1,7,2,186,193,379,550
0130-001,2011,1,7,3,137,141,278,379
0130-001,2011,1,7,4,134,131,265,278
0130-001,2011,1,7,5,152,142,294,265
0130-001,2011,1,7,6,238,230,468,294
0130-001,2011,1,7,7,551,600,1151,468
0130-001,2011,1,7,8,1446,1526,2972,1151
0130-001,2011,1,7,9,1736,1739,3475,2972
0130-001,2011,1,7,10,1318,1383,2701,3475
0130-001,2011,1,7,11,1159,1369,2528,2701
0130-001,2011,1,7,12,1225,1367,2592,2528
0130-001,2011,1,7,13,1111,1131,2242,2592
0130-001,2011,1,7,14,1236,1123,2359,2242
0130-001,2011,1,7,15,1436,1245,2681,2359
0130-001,2011,1,7,16,1360,1394,2754,2681
0130-001,2011,1,7,17,1366,1311,2677,2754
0130-001,2011,1,7,18,1432,1242,2674,2677
0130-001,2011,1,7,19,1436,1585,3021,2674
0130-001,2011,1,7,20,1191,1245,2436,3021
0130-001,2011,1,7,21,972,1106,2078,2436
0130-001,2011,1,7,22,903,950,1853,2078
0130-001,2011,1,7,23,697,680,1377,1853
0130-001,2011,1,7,24,521,508,1029,1377
0130-001,2011,1,8,1,369,369,738,1029
0130-001,2011,1,8,2,262,263,525,738
0130-001,2011,1,8,3,228,214,442,525
0130-001,2011,1,8,4,208,151,359,442
0130-001,2011,1,8,5,186,155,341,359
0130-001,2011,1,8,6,254,230,484,341
0130-001,2011,1,8,7,428,427,855,484
0130-001,2011,1,8,8,934,958,1892,855
0130-001,2011,1,8,9,1244,1281,2525,1892
0130-001,2011,1,8,10,1376,1295,2671,2525
0130-001,2011,1,8,11,1263,1400,2663,2671
0130-001,2011,1,8,12,1225,1411,2636,2663
0130-001,2011,1,8,13,1346,1231,2577,2636
0130-001,2011,1,8,14,1392,1208,2600,2577
0130-001,2011,1,8,15,1461,1311,2772,2600
0130-001,2011,1,8,16,1459,1297,2756,2772
0130-001,2011,1,8,17,1520,1283,2803,2756
0130-001,2011,1,8,18,1460,1294,2754,2803
0130-001,2011,1,8,19,1286,1049,2335,2754
0130-001,2011,1,8,20,1048,836,1884,2335
0130-001,2011,1,8,21,855,779,1634,1884
0130-001,2011,1,8,22,702,681,1383,1634
0130-001,2011,1,8,23,576,562,1138,1383
0130-001,2011,1,8,24,349,540,889,1138
0130-001,2011,1,9,1,277,617,894,889
0130-001,2011,1,9,2,198,283,481,894
0130-001,2011,1,9,3,162,166,328,481
0130-001,2011,1,9,4,122,154,276,328
0130-001,2011,1,9,5,112,131,243,276
0130-001,2011,1,9,6,125,144,269,243
0130-001,2011,1,9,7,214,230,444,269
0130-001,2011,1,9,8,345,438,783,444
0130-001,2011,1,9,9,518,651,1169,783
0130-001,2011,1,9,10,599,601,1200,1169
0130-001,2011,1,9,11,782,769,1551,1200
0130-001,2011,1,9,12,854,625,1479,1551
0130-001,2011,1,9,13,967,828,1795,1479
0130-001,2011,1,9,14,1086,940,2026,1795
0130-001,2011,1,9,15,1147,1040,2187,2026
0130-001,2011,1,9,16,1334,1240,2574,2187
0130-001,2011,1,9,17,1288,1196,2484,2574
0130-001,2011,1,9,18,1201,1071,2272,2484
0130-001,2011,1,9,19,1048,1159,2207,2272
0130-001,2011,1,9,20,806,828,1634,2207
0130-001,2011,1,9,21,680,740,1420,1634
0130-001,2011,1,9,22,611,648,1259,1420
0130-001,2011,1,9,23,383,416,799,1259
0130-001,2011,1,9,24,314,348,662,799
0130-001,2011,1,10,1,213,228,441,662
0130-001,2011,1,10,2,115,141,256,441
0130-001,2011,1,10,3,80,90,170,256
0130-001,2011,1,10,4,81,75,156,170
0130-001,2011,1,10,5,103,106,209,156
0130-001,2011,1,10,6,172,200,372,209
0130-001,2011,1,10,7,582,692,1274,372
0130-001,2011,1,10,8,1371,1331,2702,1274
0130-001,2011,1,10,9,1581,1657,3238,2702
0130-001,2011,1,10,10,1246,1411,2657,3238
0130-001,2011,1,10,11,1133,1288,2421,2657
0130-001,2011,1,10,12,1196,1264,2460,2421
0130-001,2011,1,10,13,1043,1095,2138,2460
0130-001,2011,1,10,14,1376,1119,2495,2138
0130-001,2011,1,10,15,1453,1265,2718,2495
0130-001,2011,1,10,16,1515,1187,2702,2718
0130-001,2011,1,10,17,1303,1068,2371,2702
0130-001,2011,1,10,18,1378,1127,2505,2371
0130-001,2011,1,10,19,1540,1258,2798,2505
0130-001,2011,1,10,20,1078,999,2077,2798
0130-001,2011,1,10,21,939,995,1934,2077
0130-001,2011,1,10,22,796,934,1730,1934
0130-001,2011,1,10,23,518,629,1147,1730
0130-001,2011,1,10,24,357,439,796,1147
0130-001,2011,1,11,1,248,250,498,796
0130-001,2011,1,11,2,149,164,313,498
0130-001,2011,1,11,3,145,125,270,313
0130-001,2011,1,11,4,110,113,223,270
0130-001,2011,1,11,5,116,138,254,223
0130-001,2011,1,11,6,171,207,378,254
0130-001,2011,1,11,7,471,606,1077,378
0130-001,2011,1,11,8,1236,1346,2582,1077
0130-001,2011,1,11,9,1462,1633,3095,2582
0130-001,2011,1,11,10,1275,1447,2722,3095
0130-001,2011,1,11,11,1303,1410,2713,2722
0130-001,2011,1,11,12,1290,1276,2566,2713
0130-001,2011,1,11,13,1175,955,2130,2566
0130-001,2011,1,11,14,1334,1101,2435,2130
0130-001,2011,1,11,15,1417,1199,2616,2435
0130-001,2011,1,11,16,1454,1351,2805,2616
0130-001,2011,1,11,17,1371,1143,2514,2805
0130-001,2011,1,11,18,1397,1292,2689,2514
0130-001,2011,1,11,19,1398,1447,2845,2689
0130-001,2011,1,11,20,1024,954,1978,2845
0130-001,2011,1,11,21,937,791,1728,1978
0130-001,2011,1,11,22,937,788,1725,1728
0130-001,2011,1,11,23,612,573,1185,1725
0130-001,2011,1,11,24,354,370,724,1185
0130-001,2011,1,12,1,195,248,443,724
0130-001,2011,1,12,2,123,146,269,443
0130-001,2011,1,12,3,106,117,223,269
0130-001,2011,1,12,4,84,95,179,223
0130-001,2011,1,12,5,93,115,208,179
0130-001,2011,1,12,6,189,209,398,208
0130-001,2011,1,12,7,483,512,995,398
0130-001,2011,1,12,8,1025,1181,2206,995
0130-001,2011,1,12,9,886,711,1597,2206
0130-001,2011,1,12,10,727,659,1386,1597
0130-001,2011,1,12,11,725,774,1499,1386
0130-001,2011,1,12,12,1218,1239,2457,1499
0130-001,2011,1,12,13,1057,1132,2189,2457
0130-001,2011,1,12,14,1146,1303,2449,2189
0130-001,2011,1,12,15,1214,1335,2549,2449
0130-001,2011,1,12,16,1301,1225,2526,2549
0130-001,2011,1,12,17,1159,1024,2183,2526
0130-001,2011,1,12,18,1285,965,2250,2183
0130-001,2011,1,12,19,1432,1187,2619,2250
0130-001,2011,1,12,20,1101,1235,2336,2619
0130-001,2011,1,12,21,860,909,1769,2336
0130-001,2011,1,12,22,808,933,1741,1769
0130-001,2011,1,12,23,608,625,1233,1741
0130-001,2011,1,12,24,386,448,834,1233
0130-001,2011,1,13,1,306,341,647,834
0130-001,2011,1,13,2,235,198,433,647
0130-001,2011,1,13,3,175,135,310,433
0130-001,2011,1,13,4,141,131,272,310
0130-001,2011,1,13,5,134,120,254,272
0130-001,2011,1,13,6,196,226,422,254
0130-001,2011,1,13,7,478,585,1063,422
0130-001,2011,1,13,8,1310,1417,2727,1063
0130-001,2011,1,13,9,1638,1624,3262,2727
0130-001,2011,1,13,10,1451,1506,2957,3262
0130-001,2011,1,13,11,1189,1258,2447,2957
0130-001,2011,1,13,12,1168,1309,2477,2447
0130-001,2011,1,13,13,1040,872,1912,2477
0130-001,2011,1,13,14,1213,994,2207,1912
0130-001,2011,1,13,15,1424,1157,2581,2207
0130-001,2011,1,13,16,1390,1014,2404,2581
0130-001,2011,1,13,17,1294,939,2233,2404
0130-001,2011,1,13,18,1400,905,2305,2233
0130-001,2011,1,13,19,1356,1101,2457,2305
0130-001,2011,1,13,20,1086,985,2071,2457
0130-001,2011,1,13,21,955,694,1649,2071
0130-001,2011,1,13,22,866,1004,1870,1649
0130-001,2011,1,13,23,617,683,1300,1870
0130-001,2011,1,13,24,416,445,861,1300
0130-001,2011,1,14,1,305,323,628,861
0130-001,2011,1,14,2,192,218,410,628
0130-001,2011,1,14,3,134,144,278,410
0130-001,2011,1,14,4,109,124,233,278
0130-001,2011,1,14,5,115,149,264,233
0130-001,2011,1,14,6,196,218,414,264
0130-001,2011,1,14,7,497,574,1071,414
0130-001,2011,1,14,8,1253,1323,2576,1071
0130-001,2011,1,14,9,1359,1638,2997,2576
0130-001,2011,1,14,10,1155,1284,2439,2997
0130-001,2011,1,14,11,1192,1167,2359,2439
0130-001,2011,1,14,12,1234,1131,2365,2359
0130-001,2011,1,14,13,1143,937,2080,2365
0130-001,2011,1,14,14,1193,1027,2220,2080
0130-001,2011,1,14,15,1388,1231,2619,2220
0130-001,2011,1,14,16,1443,1130,2573,2619
0130-001,2011,1,14,17,1374,1123,2497,2573
0130-001,2011,1,14,18,1489,1166,2655,2497
0130-001,2011,1,14,19,1736,1385,3121,2655
0130-001,2011,1,14,20,1416,1134,2550,3121
0130-001,2011,1,14,21,1154,761,1915,2550
0130-001,2011,1,14,22,962,593,1555,1915
0130-001,2011,1,14,23,702,474,1176,1555
0130-001,2011,1,14,24,464,506,970,1176
0130-001,2011,1,15,1,336,501,837,970
0130-001,2011,1,15,2,203,310,513,837
0130-001,2011,1,15,3,175,336,511,513
0130-001,2011,1,15,4,133,150,283,511
0130-001,2011,1,15,5,132,154,286,283
0130-001,2011,1,15,6,207,216,423,286
0130-001,2011,1,15,7,417,452,869,423
0130-001,2011,1,15,8,892,975,1867,869
0130-001,2011,1,15,9,1287,1254,2541,1867
0130-001,2011,1,15,10,1279,959,2238,2541
0130-001,2011,1,15,11,1308,1169,2477,2238
0130-001,2011,1,15,12,1412,1250,2662,2477
0130-001,2011,1,15,13,1302,996,2298,2662
0130-001,2011,1,15,14,1438,1266,2704,2298
0130-001,2011,1,15,15,1445,1231,2676,2704
0130-001,2011,1,15,16,1387,1630,3017,2676
0130-001,2011,1,15,17,1499,1034,2533,3017
0130-001,2011,1,15,18,1496,1197,2693,2533
0130-001,2011,1,15,19,1576,1401,2977,2693
0130-001,2011,1,15,20,1207,1054,2261,2977
0130-001,2011,1,15,21,1027,867,1894,2261
0130-001,2011,1,15,22,862,766,1628,1894
0130-001,2011,1,15,23,557,491,1048,1628
0130-001,2011,1,15,24,420,387,807,1048
0130-001,2011,1,16,1,296,275,571,807
0130-001,2011,1,16,2,226,203,429,571
0130-001,2011,1,16,3,157,162,319,429
0130-001,2011,1,16,4,159,136,295,319
0130-001,2011,1,16,5,123,117,240,295
0130-001,2011,1,16,6,144,132,276,240
0130-001,2011,1,16,7,275,247,522,276
0130-001,2011,1,16,8,366,320,686,522
0130-001,2011,1,16,9,584,540,1124,686
0130-001,2011,1,16,10,614,596,1210,1124
0130-001,2011,1,16,11,835,740,1575,1210
0130-001,2011,1,16,12,938,690,1628,1575
0130-001,2011,1,16,13,1120,778,1898,1628
0130-001,2011,1,16,14,1176,825,2001,1898
0130-001,2011,1,16,15,1146,907,2053,2001
0130-001,2011,1,16,16,1206,916,2122,2053
0130-001,2011,1,16,17,1298,1117,2415,2122
0130-001,2011,1,16,18,1257,1036,2293,2415
0130-001,2011,1,16,19,1074,747,1821,2293
0130-001,2011,1,16,20,873,805,1678,1821
0130-001,2011,1,16,21,856,763,1619,1678
0130-001,2011,1,16,22,722,652,1374,1619
0130-001,2011,1,16,23,466,424,890,1374
0130-001,2011,1,16,24,356,290,646,890
0130-001,2011,1,17,1,212,195,407,646
0130-001,2011,1,17,2,171,121,292,407
0130-001,2011,1,17,3,105,78,183,292
0130-001,2011,1,17,4,86,83,169,183
0130-001,2011,1,17,5,120,72,192,169
0130-001,2011,1,17,6,221,109,330,192
0130-001,2011,1,17,7,613,255,868,330
0130-001,2011,1,17,8,1504,648,2152,868
0130-001,2011,1,17,9,1745,830,2575,2152
0130-001,2011,1,17,10,1332,867,2199,2575
0130-001,2011,1,17,11,1400,1789,3189,2199
0130-001,2011,1,17,12,1446,1813,3259,3189
0130-001,2011,1,17,13,1338,1180,2518,3259
0130-001,2011,1,17,14,1551,1332,2883,2518
0130-001,2011,1,17,15,1572,1386,2958,2883
0130-001,2011,1,17,16,1512,1203,2715,2958
0130-001,2011,1,17,17,1497,1355,2852,2715
0130-001,2011,1,17,18,1422,1456,2878,2852
0130-001,2011,1,17,19,1465,1646,3111,2878
0130-001,2011,1,17,20,1154,1286,2440,3111
0130-001,2011,1,17,21,1107,1247,2354,2440
0130-001,2011,1,17,22,937,969,1906,2354
0130-001,2011,1,17,23,684,1086,1770,1906
0130-001,2011,1,17,24,448,687,1135,1770
0130-001,2011,1,18,1,338,239,577,1135
0130-001,2011,1,18,2,202,176,378,577
0130-001,2011,1,18,3,162,168,330,378
0130-001,2011,1,18,4,141,259,400,330
0130-001,2011,1,18,5,139,221,360,400
0130-001,2011,1,18,6,218,253,471,360
0130-001,2011,1,18,7,569,601,1170,471
0130-001,2011,1,18,8,1570,1591,3161,1170
0130-001,2011,1,18,9,1815,1568,3383,3161
0130-001,2011,1,18,10,1431,1455,2886,3383
0130-001,2011,1,18,11,1564,1584,3148,2886
0130-001,2011,1,18,12,1490,1323,2813,3148
0130-001,2011,1,18,13,1354,1205,2559,2813
0130-001,2011,1,18,14,1472,1307,2779,2559
0130-001,2011,1,18,15,1541,1351,2892,2779
0130-001,2011,1,18,16,1415,1525,2940,2892
0130-001,2011,1,18,17,1369,1351,2720,2940
0130-001,2011,1,18,18,1363,1419,2782,2720
0130-001,2011,1,18,19,1468,1657,3125,2782
0130-001,2011,1,18,20,1105,1121,2226,3125
0130-001,2011,1,18,21,999,1094,2093,2226
0130-001,2011,1,18,22,838,1088,1926,2093
0130-001,2011,1,18,23,648,1413,2061,1926
0130-001,2011,1,18,24,455,891,1346,2061
0130-001,2011,1,19,1,344,368,712,1346
0130-001,2011,1,19,2,192,224,416,712
0130-001,2011,1,19,3,166,194,360,416
0130-001,2011,1,19,4,139,171,310,360
0130-001,2011,1,19,5,155,180,335,310
0130-001,2011,1,19,6,234,250,484,335
0130-001,2011,1,19,7,578,651,1229,484
0130-001,2011,1,19,8,1152,1208,2360,1229
0130-001,2011,1,19,9,1590,1664,3254,2360
0130-001,2011,1,19,10,1284,1244,2528,3254
0130-001,2011,1,19,11,1387,1471,2858,2528
0130-001,2011,1,19,12,1389,1578,2967,2858
0130-001,2011,1,19,13,1210,1340,2550,2967
0130-001,2011,1,19,14,1297,1394,2691,2550
0130-001,2011,1,19,15,1457,1619,3076,2691
0130-001,2011,1,19,16,1378,1516,2894,3076
0130-001,2011,1,19,17,1085,1168,2253,2894
0130-001,2011,1,19,18,1375,1579,2954,2253
0130-001,2011,1,19,19,1509,1861,3370,2954
0130-001,2011,1,19,20,1121,1240,2361,3370
0130-001,2011,1,19,21,927,987,1914,2361
0130-001,2011,1,19,22,828,872,1700,1914
0130-001,2011,1,19,23,690,738,1428,1700
0130-001,2011,1,19,24,459,571,1030,1428
0130-001,2011,1,20,1,324,1020,1344,1030
0130-001,2011,1,20,2,227,757,984,1344
0130-001,2011,1,20,3,170,200,370,984
0130-001,2011,1,20,4,150,171,321,370
0130-001,2011,1,20,5,144,164,308,321
0130-001,2011,1,20,6,234,308,542,308
0130-001,2011,1,20,7,595,732,1327,542
0130-001,2011,1,20,8,1426,1774,3200,1327
0130-001,2011,1,20,9,1729,2146,3875,3200
0130-001,2011,1,20,10,1455,1815,3270,3875
0130-001,2011,1,20,11,1437,1750,3187,3270
0130-001,2011,1,20,12,1323,1457,2780,3187
0130-001,2011,1,20,13,1110,1169,2279,2780
0130-001,2011,1,20,14,1324,1309,2633,2279
0130-001,2011,1,20,15,1444,1574,3018,2633
0130-001,2011,1,20,16,1442,1479,2921,3018
0130-001,2011,1,20,17,1335,1128,2463,2921
0130-001,2011,1,20,18,1369,1320,2689,2463
0130-001,2011,1,20,19,1611,1669,3280,2689
0130-001,2011,1,20,20,1115,1275,2390,3280
0130-001,2011,1,20,21,946,1073,2019,2390
0130-001,2011,1,20,22,879,1052,1931,2019
0130-001,2011,1,20,23,768,868,1636,1931
0130-001,2011,1,20,24,556,675,1231,1636
0130-001,2011,1,21,1,366,383,749,1231
0130-001,2011,1,21,2,253,263,516,749
0130-001,2011,1,21,3,158,163,321,516
0130-001,2011,1,21,4,134,132,266,321
0130-001,2011,1,21,5,159,149,308,266
0130-001,2011,1,21,6,264,256,520,308
0130-001,2011,1,21,7,608,663,1271,520
0130-001,2011,1,21,8,1534,1619,3153,1271
0130-001,2011,1,21,9,1751,1755,3506,3153
0130-001,2011,1,21,10,1464,1537,3001,3506
0130-001,2011,1,21,11,1481,1750,3231,3001
0130-001,2011,1,21,12,1453,1622,3075,3231
0130-001,2011,1,21,13,1349,1374,2723,3075
0130-001,2011,1,21,14,1533,1393,2926,2723
0130-001,2011,1,21,15,1628,1412,3040,2926
0130-001,2011,1,21,16,1709,1752,3461,3040
0130-001,2011,1,21,17,1589,1526,3115,3461
0130-001,2011,1,21,18,1597,1386,2983,3115
0130-001,2011,1,21,19,1676,1850,3526,2983
0130-001,2011,1,21,20,1283,1342,2625,3526
0130-001,2011,1,21,21,1000,1138,2138,2625
0130-001,2011,1,21,22,1014,1067,2081,2138
0130-001,2011,1,21,23,843,823,1666,2081
0130-001,2011,1,21,24,606,591,1197,1666
0130-001,2011,1,22,1,436,436,872,1197
0130-001,2011,1,22,2,321,323,644,872
0130-001,2011,1,22,3,243,229,472,644
0130-001,2011,1,22,4,209,152,361,472
0130-001,2011,1,22,5,208,174,382,361
0130-001,2011,1,22,6,263,239,502,382
0130-001,2011,1,22,7,467,466,933,502
0130-001,2011,1,22,8,916,940,1856,933
0130-001,2011,1,22,9,1335,1375,2710,1856
0130-001,2011,1,22,10,1332,1254,2586,2710
0130-001,2011,1,22,11,1431,1587,3018,2586
0130-001,2011,1,22,12,1599,1842,3441,3018
0130-001,2011,1,22,13,1413,1293,2706,3441
0130-001,2011,1,22,14,1554,1349,2903,2706
0130-001,2011,1,22,15,1684,1512,3196,2903
0130-001,2011,1,22,16,1665,1481,3146,3196
0130-001,2011,1,22,17,1628,1375,3003,3146
0130-001,2011,1,22,18,1675,1485,3160,3003
0130-001,2011,1,22,19,1426,1164,2590,3160
0130-001,2011,1,22,20,1078,860,1938,2590
0130-001,2011,1,22,21,890,811,1701,1938
0130-001,2011,1,22,22,777,754,1531,1701
0130-001,2011,1,22,23,594,580,1174,1531
0130-001,2011,1,22,24,451,698,1149,1174
0130-001,2011,1,23,1,350,780,1130,1149
0130-001,2011,1,23,2,240,344,584,1130
0130-001,2011,1,23,3,205,211,416,584
0130-001,2011,1,23,4,158,200,358,416
0130-001,2011,1,23,5,151,177,328,358
0130-001,2011,1,23,6,194,224,418,328
0130-001,2011,1,23,7,297,320,617,418
0130-001,2011,1,23,8,449,571,1020,617
0130-001,2011,1,23,9,679,854,1533,1020
0130-001,2011,1,23,10,763,766,1529,1533
0130-001,2011,1,23,11,842,829,1671,1529
0130-001,2011,1,23,12,815,597,1412,1671
0130-001,2011,1,23,13,975,835,1810,1412
0130-001,2011,1,23,14,1107,959,2066,1810
0130-001,2011,1,23,15,1320,1197,2517,2066
0130-001,2011,1,23,16,1395,1297,2692,2517
0130-001,2011,1,23,17,755,702,1457,2692
0130-001,2011,1,23,18,424,379,803,1457
0130-001,2011,1,23,19,366,405,771,803
0130-001,2011,1,23,20,655,673,1328,771
0130-001,2011,1,23,21,563,613,1176,1328
0130-001,2011,1,23,22,446,474,920,1176
0130-001,2011,1,23,23,342,372,714,920
0130-001,2011,1,23,24,223,248,471,714
0130-001,2011,1,24,1,155,166,321,471
0130-001,2011,1,24,2,109,134,243,321
0130-001,2011,1,24,3,73,83,156,243
0130-001,2011,1,24,4,72,67,139,156
0130-001,2011,1,24,5,86,89,175,139
0130-001,2011,1,24,6,167,195,362,175
0130-001,2011,1,24,7,410,488,898,362
0130-001,2011,1,24,8,1504,648,2152,898
0130-001,2011,1,24,9,1745,830,2575,2152
0130-001,2011,1,24,10,1332,867,2199,2575
0130-001,2011,1,24,11,1400,1789,3189,2199
0130-001,2011,1,24,12,1137,1202,2339,3189
0130-001,2011,1,24,13,1072,1126,2198,2339
0130-001,2011,1,24,14,1234,1004,2238,2198
0130-001,2011,1,24,15,1481,1290,2771,2238
0130-001,2011,1,24,16,1499,1175,2674,2771
0130-001,2011,1,24,17,1363,1118,2481,2674
0130-001,2011,1,24,18,1501,1228,2729,2481
0130-001,2011,1,24,19,1562,1276,2838,2729
0130-001,2011,1,24,20,1179,1093,2272,2838
0130-001,2011,1,24,21,950,1007,1957,2272
0130-001,2011,1,24,22,865,1015,1880,1957
0130-001,2011,1,24,23,588,714,1302,1880
0130-001,2011,1,24,24,369,454,823,1302
0130-001,2011,1,25,1,294,297,591,823
0130-001,2011,1,25,2,164,181,345,591
0130-001,2011,1,25,3,120,104,224,345
0130-001,2011,1,25,4,126,130,256,224
0130-001,2011,1,25,5,128,153,281,256
0130-001,2011,1,25,6,226,274,500,281
0130-001,2011,1,25,7,555,715,1270,500
0130-001,2011,1,25,8,1347,1467,2814,1270
0130-001,2011,1,25,9,1562,1745,3307,2814
0130-001,2011,1,25,10,1344,1526,2870,3307
0130-001,2011,1,25,11,1473,1594,3067,2870
0130-001,2011,1,25,12,1420,1405,2825,3067
0130-001,2011,1,25,13,1343,1092,2435,2825
0130-001,2011,1,25,14,1492,1232,2724,2435
0130-001,2011,1,25,15,1690,1430,3120,2724
0130-001,2011,1,25,16,1592,1480,3072,3120
0130-001,2011,1,25,17,1504,1254,2758,3072
0130-001,2011,1,25,18,1616,1495,3111,2758
0130-001,2011,1,25,19,1725,1786,3511,3111
0130-001,2011,1,25,20,1362,1269,2631,3511
0130-001,2011,1,25,21,1180,997,2177,2631
0130-001,2011,1,25,22,1137,957,2094,2177
0130-001,2011,1,25,23,738,691,1429,2094
0130-001,2011,1,25,24,412,431,843,1429
0130-001,2011,1,26,1,281,358,639,843
0130-001,2011,1,26,2,252,300,552,639
0130-001,2011,1,26,3,158,175,333,552
0130-001,2011,1,26,4,125,142,267,333
0130-001,2011,1,26,5,158,196,354,267
0130-001,2011,1,26,6,236,261,497,354
0130-001,2011,1,26,7,575,610,1185,497
0130-001,2011,1,26,8,1436,1655,3091,1185
0130-001,2011,1,26,9,1630,1309,2939,3091
0130-001,2011,1,26,10,1477,1339,2816,2939
0130-001,2011,1,26,11,1494,1595,3089,2816
0130-001,2011,1,26,12,1493,1519,3012,3089
0130-001,2011,1,26,13,1361,1458,2819,3012
0130-001,2011,1,26,14,1572,1788,3360,2819
0130-001,2011,1,26,15,1675,1842,3517,3360
0130-001,2011,1,26,16,1731,1630,3361,3517
0130-001,2011,1,26,17,1615,1427,3042,3361
0130-001,2011,1,26,18,1672,1256,2928,3042
0130-001,2011,1,26,19,1881,1560,3441,2928
0130-001,2011,1,26,20,1429,1603,3032,3441
0130-001,2011,1,26,21,1191,1259,2450,3032
0130-001,2011,1,26,22,1072,1238,2310,2450
0130-001,2011,1,26,23,723,744,1467,2310
0130-001,2011,1,26,24,539,626,1165,1467
0130-001,2011,1,27,1,313,349,662,1165
0130-001,2011,1,27,2,191,161,352,662
0130-001,2011,1,27,3,196,152,348,352
0130-001,2011,1,27,4,126,118,244,348
0130-001,2011,1,27,5,165,148,313,244
0130-001,2011,1,27,6,245,283,528,313
0130-001,2011,1,27,7,549,672,1221,528
0130-001,2011,1,27,8,1469,1589,3058,1221
0130-001,2011,1,27,9,1648,1634,3282,3058
0130-001,2011,1,27,10,1420,1474,2894,3282
0130-001,2011,1,27,11,1461,1546,3007,2894
0130-001,2011,1,27,12,1528,1713,3241,3007
0130-001,2011,1,27,13,1387,1163,2550,3241
0130-001,2011,1,27,14,1648,1351,2999,2550
0130-001,2011,1,27,15,1682,1367,3049,2999
0130-001,2011,1,27,16,1488,1086,2574,3049
0130-001,2011,1,27,17,1540,1118,2658,2574
0130-001,2011,1,27,18,1764,1141,2905,2658
0130-001,2011,1,27,19,1788,1452,3240,2905
0130-001,2011,1,27,20,1376,1249,2625,3240
0130-001,2011,1,27,21,1251,910,2161,2625
0130-001,2011,1,27,22,1109,1286,2395,2161
0130-001,2011,1,27,23,816,904,1720,2395
0130-001,2011,1,27,24,531,569,1100,1720
0130-001,2011,1,28,1,367,389,756,1100
0130-001,2011,1,28,2,249,283,532,756
0130-001,2011,1,28,3,157,169,326,532
0130-001,2011,1,28,4,149,170,319,326
0130-001,2011,1,28,5,171,222,393,319
0130-001,2011,1,28,6,260,290,550,393
0130-001,2011,1,28,7,546,631,1177,550
0130-001,2011,1,28,8,1454,1536,2990,1177
0130-001,2011,1,28,9,1749,2109,3858,2990
0130-001,2011,1,28,10,1553,1727,3280,3858
0130-001,2011,1,28,11,1549,1517,3066,3280
0130-001,2011,1,28,12,1672,1533,3205,3066
0130-001,2011,1,28,13,1541,1264,2805,3205
0130-001,2011,1,28,14,1701,1465,3166,2805
0130-001,2011,1,28,15,1747,1550,3297,3166
0130-001,2011,1,28,16,1617,1267,2884,3297
0130-001,2011,1,28,17,1635,1337,2972,2884
0130-001,2011,1,28,18,1539,1206,2745,2972
0130-001,2011,1,28,19,1522,1215,2737,2745
0130-001,2011,1,28,20,1362,1091,2453,2737
0130-001,2011,1,28,21,1230,812,2042,2453
0130-001,2011,1,28,22,1007,621,1628,2042
0130-001,2011,1,28,23,764,516,1280,1628
0130-001,2011,1,28,24,631,689,1320,1280
0130-001,2011,1,29,1,418,624,1042,1320
0130-001,2011,1,29,2,262,401,663,1042
0130-001,2011,1,29,3,203,390,593,663
0130-001,2011,1,29,4,199,225,424,593
0130-001,2011,1,29,5,213,249,462,424
0130-001,2011,1,29,6,250,261,511,462
0130-001,2011,1,29,7,457,496,953,511
0130-001,2011,1,29,8,945,1033,1978,953
0130-001,2011,1,29,9,1311,1278,2589,1978
0130-001,2011,1,29,10,1341,1006,2347,2589
0130-001,2011,1,29,11,1507,1347,2854,2347
0130-001,2011,1,29,12,1620,1435,3055,2854
0130-001,2011,1,29,13,1531,1172,2703,3055
0130-001,2011,1,29,14,1524,1342,2866,2703
0130-001,2011,1,29,15,1492,1272,2764,2866
0130-001,2011,1,29,16,1479,1739,3218,2764
0130-001,2011,1,29,17,1450,1001,2451,3218
0130-001,2011,1,29,18,1542,1234,2776,2451
0130-001,2011,1,29,19,1413,1257,2670,2776
0130-001,2011,1,29,20,1061,927,1988,2670
0130-001,2011,1,29,21,934,789,1723,1988
0130-001,2011,1,29,22,846,752,1598,1723
0130-001,2011,1,29,23,651,574,1225,1598
0130-001,2011,1,29,24,484,446,930,1225
0130-001,2011,1,30,1,315,293,608,930
0130-001,2011,1,30,2,248,223,471,608
0130-001,2011,1,30,3,163,169,332,471
0130-001,2011,1,30,4,175,150,325,332
0130-001,2011,1,30,5,155,148,303,325
0130-001,2011,1,30,6,176,162,338,303
0130-001,2011,1,30,7,280,252,532,338
0130-001,2011,1,30,8,470,411,881,532
0130-001,2011,1,30,9,729,675,1404,881
0130-001,2011,1,30,10,813,790,1603,1404
0130-001,2011,1,30,11,1032,915,1947,1603
0130-001,2011,1,30,12,990,729,1719,1947
0130-001,2011,1,30,13,1195,831,2026,1719
0130-001,2011,1,30,14,1364,957,2321,2026
0130-001,2011,1,30,15,1304,1033,2337,2321
0130-001,2011,1,30,16,1277,970,2247,2337
0130-001,2011,1,30,17,1251,1077,2328,2247
0130-001,2011,1,30,18,1214,1001,2215,2328
0130-001,2011,1,30,19,1162,809,1971,2215
0130-001,2011,1,30,20,887,818,1705,1971
0130-001,2011,1,30,21,830,740,1570,1705
0130-001,2011,1,30,22,732,662,1394,1570
0130-001,2011,1,30,23,488,445,933,1394
0130-001,2011,1,30,24,394,321,715,933
0130-001,2011,1,31,1,252,232,484,715
0130-001,2011,1,31,2,128,91,219,484
0130-001,2011,1,31,3,113,84,197,219
0130-001,2011,1,31,4,122,118,240,197
0130-001,2011,1,31,5,146,88,234,240
0130-001,2011,1,31,6,248,123,371,234
0130-001,2011,1,31,7,618,258,876,371
0130-001,2011,1,31,8,1454,627,2081,876
0130-001,2011,1,31,9,1683,801,2484,2081
0130-001,2011,1,31,10,1461,951,2412,2484
0130-001,2011,1,31,11,1562,1997,3559,2412
0130-001,2011,1,31,12,1608,2017,3625,3559
0130-001,2011,1,31,13,1528,1348,2876,3625
0130-001,2011,1,31,14,1767,1518,3285,2876
0130-001,2011,1,31,15,1869,1648,3517,3285
0130-001,2011,1,31,16,1843,1467,3310,3517
0130-001,2011,1,31,17,1770,1603,3373,3310
0130-001,2011,1,31,18,1761,1804,3565,3373
0130-001,2011,1,31,19,1903,2139,4042,3565
0130-001,2011,1,31,20,1515,1689,3204,4042
0130-001,2011,1,31,21,1288,1451,2739,3204
0130-001,2011,1,31,22,1133,1172,2305,2739
0130-001,2011,1,31,23,801,1272,2073,2305
0130-001,2011,1,31,24,598,918,1516,2073
0130-001,2011,2,1,1,378,440,818,1516
0130-001,2011,2,1,2,263,302,565,818
0130-001,2011,2,1,3,200,216,416,565
0130-001,2011,2,1,4,148,204,352,416
0130-001,2011,2,1,5,163,199,362,352
0130-001,2011,2,1,6,255,272,527,362
0130-001,2011,2,1,7,511,655,1166,527
0130-001,2011,2,1,8,1460,1986,3446,1166
0130-001,2011,2,1,9,1653,1968,3621,3446
0130-001,2011,2,1,10,1505,1982,3487,3621
0130-001,2011,2,1,11,1660,1824,3484,3487
0130-001,2011,2,1,12,1776,1444,3220,3484
0130-001,2011,2,1,13,1739,1114,2853,3220
0130-001,2011,2,1,14,1883,1158,3041,2853
0130-001,2011,2,1,15,1866,1564,3430,3041
0130-001,2011,2,1,16,1843,1726,3569,3430
0130-001,2011,2,1,17,1806,1282,3088,3569
0130-001,2011,2,1,18,1676,1576,3252,3088
0130-001,2011,2,1,19,1725,1387,3112,3252
0130-001,2011,2,1,20,1550,1345,2895,3112
0130-001,2011,2,1,21,1497,827,2324,2895
0130-001,2011,2,1,22,1413,653,2066,2324
0130-001,2011,2,1,23,1207,589,1796,2066
0130-001,2011,2,1,24,1062,374,1436,1796
0130-001,2011,2,2,1,915,282,1197,1436
0130-001,2011,2,2,2,815,149,964,1197
0130-001,2011,2,2,3,847,337,1184,964
0130-001,2011,2,2,4,766,257,1023,1184
0130-001,2011,2,2,5,868,346,1214,1023
0130-001,2011,2,2,6,864,401,1265,1214
0130-001,2011,2,2,7,965,667,1632,1265
0130-001,2011,2,2,8,923,643,1566,1632
0130-001,2011,2,2,9,1129,704,1833,1566
0130-001,2011,2,2,10,1153,794,1947,1833
0130-001,2011,2,2,11,1412,982,2394,1947
0130-001,2011,2,2,12,1539,1236,2775,2394
0130-001,2011,2,2,13,1537,1546,3083,2775
0130-001,2011,2,2,14,1555,1362,2917,3083
0130-001,2011,2,2,15,1536,1537,3073,2917
0130-001,2011,2,2,16,1806,1994,3800,3073
0130-001,2011,2,2,17,1725,1666,3391,3800
0130-001,2011,2,2,18,1428,1109,2537,3391
0130-001,2011,2,2,19,1215,950,2165,2537
0130-001,2011,2,2,20,929,808,1737,2165
0130-001,2011,2,2,21,712,669,1381,1737
0130-001,2011,2,2,22,620,479,1099,1381
0130-001,2011,2,2,23,460,464,924,1099
0130-001,2011,2,2,24,304,427,731,924
0130-001,2011,2,3,1,194,227,421,731
0130-001,2011,2,3,2,121,101,222,421
0130-001,2011,2,3,3,95,126,221,222
0130-001,2011,2,3,4,68,94,162,221
0130-001,2011,2,3,5,58,102,160,162
0130-001,2011,2,3,6,137,167,304,160
0130-001,2011,2,3,7,351,368,719,304
0130-001,2011,2,3,8,676,630,1306,719
0130-001,2011,2,3,9,741,617,1358,1306
0130-001,2011,2,3,10,671,592,1263,1358
0130-001,2011,2,3,11,1185,950,2135,1263
0130-001,2011,2,3,12,1747,1343,3090,2135
0130-001,2011,2,3,13,1569,1310,2879,3090
0130-001,2011,2,3,14,1494,1207,2701,2879
0130-001,2011,2,3,15,1475,1495,2970,2701
0130-001,2011,2,3,16,1554,1649,3203,2970
0130-001,2011,2,3,17,1562,1449,3011,3203
0130-001,2011,2,3,18,1500,1105,2605,3011
0130-001,2011,2,3,19,1538,1230,2768,2605
0130-001,2011,2,3,20,1582,1120,2702,2768
0130-001,2011,2,3,21,1635,1355,2990,2702
0130-001,2011,2,3,22,1378,1087,2465,2990
0130-001,2011,2,3,23,928,666,1594,2465
0130-001,2011,2,3,24,578,563,1141,1594
0130-001,2011,2,4,1,332,429,761,1141
0130-001,2011,2,4,2,202,654,856,761
0130-001,2011,2,4,3,143,155,298,856
0130-001,2011,2,4,4,108,134,242,298
0130-001,2011,2,4,5,97,81,178,242
0130-001,2011,2,4,6,120,165,285,178
0130-001,2011,2,4,7,200,172,372,285
0130-001,2011,2,4,8,261,228,489,372
0130-001,2011,2,4,9,419,389,808,489
0130-001,2011,2,4,10,556,567,1123,808
0130-001,2011,2,4,11,955,958,1913,1123
0130-001,2011,2,4,12,1259,1212,2471,1913
0130-001,2011,2,4,13,1477,1398,2875,2471
0130-001,2011,2,4,14,1491,1456,2947,2875
0130-001,2011,2,4,15,1540,1887,3427,2947
0130-001,2011,2,4,16,1396,1753,3149,3427
0130-001,2011,2,4,17,1425,1874,3299,3149
0130-001,2011,2,4,18,1426,1507,2933,3299
0130-001,2011,2,4,19,1306,1284,2590,2933
0130-001,2011,2,4,20,1255,1313,2568,2590
0130-001,2011,2,4,21,1292,1388,2680,2568
0130-001,2011,2,4,22,902,874,1776,2680
0130-001,2011,2,4,23,720,843,1563,1776
0130-001,2011,2,4,24,616,647,1263,1563
0130-001,2011,2,5,1,844,965,1809,1263
0130-001,2011,2,5,2,536,662,1198,1809
0130-001,2011,2,5,3,403,538,941,1198
0130-001,2011,2,5,4,144,166,310,941
0130-001,2011,2,5,5,127,170,297,310
0130-001,2011,2,5,6,188,214,402,297
0130-001,2011,2,5,7,272,257,529,402
0130-001,2011,2,5,8,458,637,1095,529
0130-001,2011,2,5,9,708,797,1505,1095
0130-001,2011,2,5,10,962,1138,2100,1505
0130-001,2011,2,5,11,1267,1476,2743,2100
0130-001,2011,2,5,12,1472,1574,3046,2743
0130-001,2011,2,5,13,1210,1304,2514,3046
0130-001,2011,2,5,14,1435,1730,3165,2514
0130-001,2011,2,5,15,1488,1805,3293,3165
0130-001,2011,2,5,16,1437,1810,3247,3293
0130-001,2011,2,5,17,1308,1723,3031,3247
0130-001,2011,2,5,18,1247,1556,2803,3031
0130-001,2011,2,5,19,1299,1486,2785,2803
0130-001,2011,2,5,20,1173,1304,2477,2785
0130-001,2011,2,5,21,1148,1243,2391,2477
0130-001,2011,2,5,22,1108,1251,2359,2391
0130-001,2011,2,5,23,1102,1398,2500,2359
0130-001,2011,2,5,24,776,985,1761,2500
0130-001,2011,2,6,1,424,461,885,1761
0130-001,2011,2,6,2,274,282,556,885
0130-001,2011,2,6,3,190,207,397,556
0130-001,2011,2,6,4,162,166,328,397
0130-001,2011,2,6,5,143,138,281,328
0130-001,2011,2,6,6,161,179,340,281
0130-001,2011,2,6,7,255,276,531,340
0130-001,2011,2,6,8,396,428,824,531
0130-001,2011,2,6,9,584,632,1216,824
0130-001,2011,2,6,10,655,753,1408,1216
0130-001,2011,2,6,11,831,954,1785,1408
0130-001,2011,2,6,12,796,796,1592,1785
0130-001,2011,2,6,13,1161,1243,2404,1592
0130-001,2011,2,6,14,1274,1107,2381,2404
0130-001,2011,2,6,15,1347,1403,2750,2381
0130-001,2011,2,6,16,1425,1359,2784,2750
0130-001,2011,2,6,17,1441,1235,2676,2784
0130-001,2011,2,6,18,1247,1077,2324,2676
0130-001,2011,2,6,19,1041,1030,2071,2324
0130-001,2011,2,6,20,815,837,1652,2071
0130-001,2011,2,6,21,731,718,1449,1652
0130-001,2011,2,6,22,653,715,1368,1449
0130-001,2011,2,6,23,480,708,1188,1368
0130-001,2011,2,6,24,362,383,745,1188
0130-001,2011,2,7,1,225,241,466,745
0130-001,2011,2,7,2,171,221,392,466
0130-001,2011,2,7,3,109,142,251,392
0130-001,2011,2,7,4,100,143,243,251
0130-001,2011,2,7,5,136,155,291,243
0130-001,2011,2,7,6,237,289,526,291
0130-001,2011,2,7,7,678,872,1550,526
0130-001,2011,2,7,8,1657,1937,3594,1550
0130-001,2011,2,7,9,1768,1715,3483,3594
0130-001,2011,2,7,10,1392,1451,2843,3483
0130-001,2011,2,7,11,1500,1334,2834,2843
0130-001,2011,2,7,12,1535,1302,2837,2834
0130-001,2011,2,7,13,1333,1501,2834,2837
0130-001,2011,2,7,14,1569,1609,3178,2834
0130-001,2011,2,7,15,1669,1850,3519,3178
0130-001,2011,2,7,16,1648,1789,3437,3519
0130-001,2011,2,7,17,1599,1519,3118,3437
0130-001,2011,2,7,18,1673,1708,3381,3118
0130-001,2011,2,7,19,1808,1932,3740,3381
0130-001,2011,2,7,20,1339,1544,2883,3740
0130-001,2011,2,7,21,1161,1353,2514,2883
0130-001,2011,2,7,22,986,1134,2120,2514
0130-001,2011,2,7,23,731,804,1535,2120
0130-001,2011,2,7,24,502,580,1082,1535
0130-001,2011,2,8,1,322,317,639,1082
0130-001,2011,2,8,2,213,233,446,639
0130-001,2011,2,8,3,160,241,401,446
0130-001,2011,2,8,4,151,180,331,401
0130-001,2011,2,8,5,159,198,357,331
0130-001,2011,2,8,6,234,299,533,357
0130-001,2011,2,8,7,596,823,1419,533
0130-001,2011,2,8,8,1619,1682,3301,1419
0130-001,2011,2,8,9,1796,1948,3744,3301
0130-001,2011,2,8,10,1505,1481,2986,3744
0130-001,2011,2,8,11,1487,1464,2951,2986
0130-001,2011,2,8,12,1470,1370,2840,2951
0130-001,2011,2,8,13,1422,1568,2990,2840
0130-001,2011,2,8,14,1636,1993,3629,2990
0130-001,2011,2,8,15,1656,2031,3687,3629
0130-001,2011,2,8,16,1696,2014,3710,3687
0130-001,2011,2,8,17,1598,1899,3497,3710
0130-001,2011,2,8,18,1764,1779,3543,3497
0130-001,2011,2,8,19,1746,1855,3601,3543
0130-001,2011,2,8,20,1374,1202,2576,3601
0130-001,2011,2,8,21,1246,1096,2342,2576
0130-001,2011,2,8,22,1112,1248,2360,2342
0130-001,2011,2,8,23,730,944,1674,2360
0130-001,2011,2,8,24,507,515,1022,1674
0130-001,2011,2,9,1,324,434,758,1022
0130-001,2011,2,9,2,221,306,527,758
0130-001,2011,2,9,3,186,210,396,527
0130-001,2011,2,9,4,145,196,341,396
0130-001,2011,2,9,5,169,165,334,341
0130-001,2011,2,9,6,263,266,529,334
0130-001,2011,2,9,7,559,703,1262,529
0130-001,2011,2,9,8,1583,1584,3167,1262
0130-001,2011,2,9,9,1788,2351,4139,3167
0130-001,2011,2,9,10,1492,1675,3167,4139
0130-001,2011,2,9,11,1533,1525,3058,3167
0130-001,2011,2,9,12,1452,1419,2871,3058
0130-001,2011,2,9,13,1352,1285,2637,2871
0130-001,2011,2,9,14,1549,1677,3226,2637
0130-001,2011,2,9,15,1605,1928,3533,3226
0130-001,2011,2,9,16,1683,1707,3390,3533
0130-001,2011,2,9,17,1525,1677,3202,3390
0130-001,2011,2,9,18,1748,1874,3622,3202
0130-001,2011,2,9,19,1844,2029,3873,3622
0130-001,2011,2,9,20,1372,1384,2756,3873
0130-001,2011,2,9,21,1152,1096,2248,2756
0130-001,2011,2,9,22,1061,966,2027,2248
0130-001,2011,2,9,23,742,704,1446,2027
0130-001,2011,2,9,24,504,520,1024,1446
0130-001,2011,2,10,1,384,497,881,1024
0130-001,2011,2,10,2,209,346,555,881
0130-001,2011,2,10,3,169,256,425,555
0130-001,2011,2,10,4,148,382,530,425
0130-001,2011,2,10,5,154,470,624,530
0130-001,2011,2,10,6,251,1126,1377,624
0130-001,2011,2,10,7,614,1096,1710,1377
0130-001,2011,2,10,8,1633,1944,3577,1710
0130-001,2011,2,10,9,1935,2697,4632,3577
0130-001,2011,2,10,10,1550,2013,3563,4632
0130-001,2011,2,10,11,1720,1841,3561,3563
0130-001,2011,2,10,12,1568,1595,3163,3561
0130-001,2011,2,10,13,1458,1710,3168,3163
0130-001,2011,2,10,14,1641,1712,3353,3168
0130-001,2011,2,10,15,1711,1878,3589,3353
0130-001,2011,2,10,16,1730,1462,3192,3589
0130-001,2011,2,10,17,1632,1244,2876,3192
0130-001,2011,2,10,18,1721,1882,3603,2876
0130-001,2011,2,10,19,1835,1993,3828,3603
0130-001,2011,2,10,20,1370,1515,2885,3828
0130-001,2011,2,10,21,1213,1517,2730,2885
0130-001,2011,2,10,22,1151,1312,2463,2730
0130-001,2011,2,10,23,731,905,1636,2463
0130-001,2011,2,10,24,523,584,1107,1636
0130-001,2011,2,11,1,353,327,680,1107
0130-001,2011,2,11,2,244,190,434,680
0130-001,2011,2,11,3,183,114,297,434
0130-001,2011,2,11,4,164,100,264,297
0130-001,2011,2,11,5,196,113,309,264
0130-001,2011,2,11,6,257,167,424,309
0130-001,2011,2,11,7,626,584,1210,424
0130-001,2011,2,11,8,1591,1505,3096,1210
0130-001,2011,2,11,9,1879,1392,3271,3096
0130-001,2011,2,11,10,1580,1264,2844,3271
0130-001,2011,2,11,11,1466,1791,3257,2844
0130-001,2011,2,11,12,1586,1416,3002,3257
0130-001,2011,2,11,13,1427,1253,2680,3002
0130-001,2011,2,11,14,1608,1312,2920,2680
0130-001,2011,2,11,15,1713,1596,3309,2920
0130-001,2011,2,11,16,1781,1917,3698,3309
0130-001,2011,2,11,17,1681,1675,3356,3698
0130-001,2011,2,11,18,1783,1616,3399,3356
0130-001,2011,2,11,19,1864,1826,3690,3399
0130-001,2011,2,11,20,1512,1402,2914,3690
0130-001,2011,2,11,21,1324,1349,2673,2914
0130-001,2011,2,11,22,1173,1264,2437,2673
0130-001,2011,2,11,23,877,1058,1935,2437
0130-001,2011,2,11,24,609,661,1270,1935
0130-001,2011,2,12,1,421,315,736,1270
0130-001,2011,2,12,2,320,244,564,736
0130-001,2011,2,12,3,257,169,426,564
0130-001,2011,2,12,4,202,151,353,426
0130-001,2011,2,12,5,216,133,349,353
0130-001,2011,2,12,6,253,141,394,349
0130-001,2011,2,12,7,498,413,911,394
0130-001,2011,2,12,8,964,863,1827,911
0130-001,2011,2,12,9,1333,1067,2400,1827
0130-001,2011,2,12,10,1388,985,2373,2400
0130-001,2011,2,12,11,1436,1234,2670,2373
0130-001,2011,2,12,12,1588,1368,2956,2670
0130-001,2011,2,12,13,1695,1383,3078,2956
0130-001,2011,2,12,14,1737,1604,3341,3078
0130-001,2011,2,12,15,1807,1472,3279,3341
0130-001,2011,2,12,16,1744,1398,3142,3279
0130-001,2011,2,12,17,1713,1566,3279,3142
0130-001,2011,2,12,18,1750,1391,3141,3279
0130-001,2011,2,12,19,1687,1281,2968,3141
0130-001,2011,2,12,20,1230,1361,2591,2968
0130-001,2011,2,12,21,977,1058,2035,2591
0130-001,2011,2,12,22,830,739,1569,2035
0130-001,2011,2,12,23,798,489,1287,1569
0130-001,2011,2,12,24,495,318,813,1287
0130-001,2011,2,13,1,406,290,696,813
0130-001,2011,2,13,2,269,183,452,696
0130-001,2011,2,13,3,242,179,421,452
0130-001,2011,2,13,4,178,130,308,421
0130-001,2011,2,13,5,149,281,430,308
0130-001,2011,2,13,6,186,428,614,430
0130-001,2011,2,13,7,337,270,607,614
0130-001,2011,2,13,8,487,417,904,607
0130-001,2011,2,13,9,778,563,1341,904
0130-001,2011,2,13,10,836,550,1386,1341
0130-001,2011,2,13,11,974,720,1694,1386
0130-001,2011,2,13,12,950,776,1726,1694
0130-001,2011,2,13,13,1275,1378,2653,1726
0130-001,2011,2,13,14,1362,1308,2670,2653
0130-001,2011,2,13,15,1395,1503,2898,2670
0130-001,2011,2,13,16,1495,1227,2722,2898
0130-001,2011,2,13,17,1613,1490,3103,2722
0130-001,2011,2,13,18,1527,1568,3095,3103
0130-001,2011,2,13,19,1326,1462,2788,3095
0130-001,2011,2,13,20,1043,871,1914,2788
0130-001,2011,2,13,21,936,851,1787,1914
0130-001,2011,2,13,22,774,821,1595,1787
0130-001,2011,2,13,23,523,605,1128,1595
0130-001,2011,2,13,24,317,423,740,1128
0130-001,2011,2,14,1,211,170,381,740
0130-001,2011,2,14,2,178,106,284,381
0130-001,2011,2,14,3,141,93,234,284
0130-001,2011,2,14,4,127,80,207,234
0130-001,2011,2,14,5,161,79,240,207
0130-001,2011,2,14,6,267,147,414,240
0130-001,2011,2,14,7,695,617,1312,414
0130-001,2011,2,14,8,1639,1378,3017,1312
0130-001,2011,2,14,9,1875,1351,3226,3017
0130-001,2011,2,14,10,1482,1076,2558,3226
0130-001,2011,2,14,11,1326,1616,2942,2558
0130-001,2011,2,14,12,1481,1518,2999,2942
0130-001,2011,2,14,13,1424,1543,2967,2999
0130-001,2011,2,14,14,1570,1839,3409,2967
0130-001,2011,2,14,15,1695,1740,3435,3409
0130-001,2011,2,14,16,1741,1736,3477,3435
0130-001,2011,2,14,17,1609,1730,3339,3477
0130-001,2011,2,14,18,1658,1685,3343,3339
0130-001,2011,2,14,19,1792,1893,3685,3343
0130-001,2011,2,14,20,1459,1603,3062,3685
0130-001,2011,2,14,21,1263,1413,2676,3062
0130-001,2011,2,14,22,1093,1084,2177,2676
0130-001,2011,2,14,23,709,767,1476,2177
0130-001,2011,2,14,24,502,520,1022,1476
0130-001,2011,2,15,1,315,326,641,1022
0130-001,2011,2,15,2,211,466,677,641
0130-001,2011,2,15,3,134,117,251,677
0130-001,2011,2,15,4,150,101,251,251
0130-001,2011,2,15,5,183,90,273,251
0130-001,2011,2,15,6,229,159,388,273
0130-001,2011,2,15,7,647,581,1228,388
0130-001,2011,2,15,8,1613,1419,3032,1228
0130-001,2011,2,15,9,1873,1407,3280,3032
0130-001,2011,2,15,10,1175,1148,2323,3280
0130-001,2011,2,15,11,1392,1551,2943,2323
0130-001,2011,2,15,12,1471,1402,2873,2943
0130-001,2011,2,15,13,1420,1359,2779,2873
0130-001,2011,2,15,14,1594,1357,2951,2779
0130-001,2011,2,15,15,1682,1404,3086,2951
0130-001,2011,2,15,16,1700,1481,3181,3086
0130-001,2011,2,15,17,1590,1261,2851,3181
0130-001,2011,2,15,18,1737,1419,3156,2851
0130-001,2011,2,15,19,1845,1470,3315,3156
0130-001,2011,2,15,20,1413,1357,2770,3315
0130-001,2011,2,15,21,1238,899,2137,2770
0130-001,2011,2,15,22,1044,737,1781,2137
0130-001,2011,2,15,23,535,626,1161,1781
0130-001,2011,2,15,24,342,550,892,1161
0130-001,2011,2,16,1,247,278,525,892
0130-001,2011,2,16,2,222,121,343,525
0130-001,2011,2,16,3,162,138,300,343
0130-001,2011,2,16,4,122,112,234,300
0130-001,2011,2,16,5,166,94,260,234
0130-001,2011,2,16,6,285,179,464,260
0130-001,2011,2,16,7,634,1138,1772,464
0130-001,2011,2,16,8,1600,1622,3222,1772
0130-001,2011,2,16,9,1867,1241,3108,3222
0130-001,2011,2,16,10,984,1125,2109,3108
0130-001,2011,2,16,11,1101,1308,2409,2109
0130-001,2011,2,16,12,1427,1285,2712,2409
0130-001,2011,2,16,13,1396,1212,2608,2712
0130-001,2011,2,16,14,1552,1396,2948,2608
0130-001,2011,2,16,15,1633,1712,3345,2948
0130-001,2011,2,16,16,1649,1530,3179,3345
0130-001,2011,2,16,17,1599,1358,2957,3179
0130-001,2011,2,16,18,1752,1294,3046,2957
0130-001,2011,2,16,19,1854,1452,3306,3046
0130-001,2011,2,16,20,1368,1056,2424,3306
0130-001,2011,2,16,21,1240,1054,2294,2424
0130-001,2011,2,16,22,1080,858,1938,2294
0130-001,2011,2,16,23,789,669,1458,1938
0130-001,2011,2,16,24,496,554,1050,1458
0130-001,2011,2,17,1,345,423,768,1050
0130-001,2011,2,17,2,242,227,469,768
0130-001,2011,2,17,3,164,220,384,469
0130-001,2011,2,17,4,145,182,327,384
0130-001,2011,2,17,5,146,155,301,327
0130-001,2011,2,17,6,225,241,466,301
0130-001,2011,2,17,7,604,688,1292,466
0130-001,2011,2,17,8,1342,1564,2906,1292
0130-001,2011,2,17,9,1709,1846,3555,2906
0130-001,2011,2,17,10,1466,1478,2944,3555
0130-001,2011,2,17,11,1455,1329,2784,2944
0130-001,2011,2,17,12,1413,1337,2750,2784
0130-001,2011,2,17,13,1306,1285,2591,2750
0130-001,2011,2,17,14,1531,1395,2926,2591
0130-001,2011,2,17,15,1649,1331,2980,2926
0130-001,2011,2,17,16,1572,1689,3261,2980
0130-001,2011,2,17,17,1567,1719,3286,3261
0130-001,2011,2,17,18,1565,1495,3060,3286
0130-001,2011,2,17,19,1515,1681,3196,3060
0130-001,2011,2,17,20,1272,1273,2545,3196
0130-001,2011,2,17,21,1152,1099,2251,2545
0130-001,2011,2,17,22,1062,970,2032,2251
0130-001,2011,2,17,23,727,778,1505,2032
0130-001,2011,2,17,24,479,557,1036,1505
0130-001,2011,2,18,1,341,563,904,1036
0130-001,2011,2,18,2,228,199,427,904
0130-001,2011,2,18,3,181,130,311,427
0130-001,2011,2,18,4,158,174,332,311
0130-001,2011,2,18,5,164,351,515,332
0130-001,2011,2,18,6,274,293,567,515
0130-001,2011,2,18,7,591,679,1270,567
0130-001,2011,2,18,8,1530,1486,3016,1270
0130-001,2011,2,18,9,1765,1325,3090,3016
0130-001,2011,2,18,10,1493,1095,2588,3090
0130-001,2011,2,18,11,1560,1321,2881,2588
0130-001,2011,2,18,12,1574,1375,2949,2881
0130-001,2011,2,18,13,1364,1517,2881,2949
0130-001,2011,2,18,14,1567,1989,3556,2881
0130-001,2011,2,18,15,1705,2123,3828,3556
0130-001,2011,2,18,16,1703,2092,3795,3828
0130-001,2011,2,18,17,1603,1980,3583,3795
0130-001,2011,2,18,18,1757,2095,3852,3583
0130-001,2011,2,18,19,1728,1859,3587,3852
0130-001,2011,2,18,20,1477,1558,3035,3587
0130-001,2011,2,18,21,1283,1649,2932,3035
0130-001,2011,2,18,22,1073,960,2033,2932
0130-001,2011,2,18,23,865,645,1510,2033
0130-001,2011,2,18,24,556,416,972,1510
0130-001,2011,2,19,1,330,327,657,972
0130-001,2011,2,19,2,190,265,455,657
0130-001,2011,2,19,3,125,163,288,455
0130-001,2011,2,19,4,198,131,329,288
0130-001,2011,2,19,5,204,133,337,329
0130-001,2011,2,19,6,296,253,549,337
0130-001,2011,2,19,7,535,949,1484,549
0130-001,2011,2,19,8,1004,1300,2304,1484
0130-001,2011,2,19,9,1423,1612,3035,2304
0130-001,2011,2,19,10,1430,1207,2637,3035
0130-001,2011,2,19,11,1407,1619,3026,2637
0130-001,2011,2,19,12,1642,1847,3489,3026
0130-001,2011,2,19,13,1690,1785,3475,3489
0130-001,2011,2,19,14,1864,1750,3614,3475
0130-001,2011,2,19,15,1880,1505,3385,3614
0130-001,2011,2,19,16,1841,1404,3245,3385
0130-001,2011,2,19,17,1638,1279,2917,3245
0130-001,2011,2,19,18,1672,1738,3410,2917
0130-001,2011,2,19,19,1635,1767,3402,3410
0130-001,2011,2,19,20,1295,1497,2792,3402
0130-001,2011,2,19,21,1179,1449,2628,2792
0130-001,2011,2,19,22,924,1350,2274,2628
0130-001,2011,2,19,23,760,554,1314,2274
0130-001,2011,2,19,24,485,355,840,1314
0130-001,2011,2,20,1,349,317,666,840
0130-001,2011,2,20,2,253,196,449,666
0130-001,2011,2,20,3,189,153,342,449
0130-001,2011,2,20,4,152,138,290,342
0130-001,2011,2,20,5,150,104,254,290
0130-001,2011,2,20,6,188,815,1003,254
0130-001,2011,2,20,7,325,306,631,1003
0130-001,2011,2,20,8,564,546,1110,631
0130-001,2011,2,20,9,819,601,1420,1110
0130-001,2011,2,20,10,820,565,1385,1420
0130-001,2011,2,20,11,1052,1117,2169,1385
0130-001,2011,2,20,12,1220,1272,2492,2169
0130-001,2011,2,20,13,1126,1144,2270,2492
0130-001,2011,2,20,14,1207,1380,2587,2270
0130-001,2011,2,20,15,1299,1645,2944,2587
0130-001,2011,2,20,16,1373,1759,3132,2944
0130-001,2011,2,20,17,1560,1907,3467,3132
0130-001,2011,2,20,18,1513,1802,3315,3467
0130-001,2011,2,20,19,1370,1547,2917,3315
0130-001,2011,2,20,20,986,871,1857,2917
0130-001,2011,2,20,21,771,1076,1847,1857
0130-001,2011,2,20,22,643,911,1554,1847
0130-001,2011,2,20,23,456,493,949,1554
0130-001,2011,2,20,24,301,285,586,949
0130-001,2011,2,21,1,224,214,438,586
0130-001,2011,2,21,2,127,100,227,438
0130-001,2011,2,21,3,112,88,200,227
0130-001,2011,2,21,4,85,63,148,200
0130-001,2011,2,21,5,158,86,244,148
0130-001,2011,2,21,6,262,171,433,244
0130-001,2011,2,21,7,550,723,1273,433
0130-001,2011,2,21,8,1274,1398,2672,1273
0130-001,2011,2,21,9,1718,1321,3039,2672
0130-001,2011,2,21,10,1508,1118,2626,3039
0130-001,2011,2,21,11,1568,1253,2821,2626
0130-001,2011,2,21,12,1538,2000,3538,2821
0130-001,2011,2,21,13,1467,1649,3116,3538
0130-001,2011,2,21,14,1718,1980,3698,3116
0130-001,2011,2,21,15,1780,2060,3840,3698
0130-001,2011,2,21,16,1831,2050,3881,3840
0130-001,2011,2,21,17,1693,2047,3740,3881
0130-001,2011,2,21,18,1706,1955,3661,3740
0130-001,2011,2,21,19,1809,1728,3537,3661
0130-001,2011,2,21,20,1357,1341,2698,3537
0130-001,2011,2,21,21,1152,792,1944,2698
0130-001,2011,2,21,22,981,694,1675,1944
0130-001,2011,2,21,23,723,532,1255,1675
0130-001,2011,2,21,24,475,327,802,1255
0130-001,2011,2,22,1,309,223,532,802
0130-001,2011,2,22,2,216,154,370,532
0130-001,2011,2,22,3,159,92,251,370
0130-001,2011,2,22,4,141,102,243,251
0130-001,2011,2,22,5,162,102,264,243
0130-001,2011,2,22,6,243,145,388,264
0130-001,2011,2,22,7,620,638,1258,388
0130-001,2011,2,22,8,1511,1503,3014,1258
0130-001,2011,2,22,9,1824,1518,3342,3014
0130-001,2011,2,22,10,1489,1186,2675,3342
0130-001,2011,2,22,11,1601,1167,2768,2675
0130-001,2011,2,22,12,1542,1240,2782,2768
0130-001,2011,2,22,13,1465,1677,3142,2782
0130-001,2011,2,22,14,1638,1969,3607,3142
0130-001,2011,2,22,15,1649,1969,3618,3607
0130-001,2011,2,22,16,1702,2056,3758,3618
0130-001,2011,2,22,17,1601,1670,3271,3758
0130-001,2011,2,22,18,1721,1924,3645,3271
0130-001,2011,2,22,19,1543,1781,3324,3645
0130-001,2011,2,22,20,1178,1347,2525,3324
0130-001,2011,2,22,21,1133,878,2011,2525
0130-001,2011,2,22,22,1134,726,1860,2011
0130-001,2011,2,22,23,766,613,1379,1860
0130-001,2011,2,22,24,524,347,871,1379
0130-001,2011,2,23,1,313,280,593,871
0130-001,2011,2,23,2,217,194,411,593
0130-001,2011,2,23,3,187,131,318,411
0130-001,2011,2,23,4,140,108,248,318
0130-001,2011,2,23,5,163,93,256,248
0130-001,2011,2,23,6,239,188,427,256
0130-001,2011,2,23,7,591,600,1191,427
0130-001,2011,2,23,8,1540,1481,3021,1191
0130-001,2011,2,23,9,1468,1494,2962,3021
0130-001,2011,2,23,10,1462,1182,2644,2962
0130-001,2011,2,23,11,1551,1191,2742,2644
0130-001,2011,2,23,12,1497,1575,3072,2742
0130-001,2011,2,23,13,1418,1641,3059,3072
0130-001,2011,2,23,14,1640,1958,3598,3059
0130-001,2011,2,23,15,1662,1886,3548,3598
0130-001,2011,2,23,16,1680,1731,3411,3548
0130-001,2011,2,23,17,1562,1776,3338,3411
0130-001,2011,2,23,18,1771,1939,3710,3338
0130-001,2011,2,23,19,1920,1216,3136,3710
0130-001,2011,2,23,20,1498,1019,2517,3136
0130-001,2011,2,23,21,1178,748,1926,2517
0130-001,2011,2,23,22,1107,767,1874,1926
0130-001,2011,2,23,23,774,600,1374,1874
0130-001,2011,2,23,24,561,408,969,1374
0130-001,2011,2,24,1,332,265,597,969
0130-001,2011,2,24,2,232,175,407,597
0130-001,2011,2,24,3,158,155,313,407
0130-001,2011,2,24,4,136,121,257,313
0130-001,2011,2,24,5,163,102,265,257
0130-001,2011,2,24,6,239,176,415,265
0130-001,2011,2,24,7,572,653,1225,415
0130-001,2011,2,24,8,1469,1428,2897,1225
0130-001,2011,2,24,9,1714,1321,3035,2897
0130-001,2011,2,24,10,1624,1193,2817,3035
0130-001,2011,2,24,11,1633,1313,2946,2817
0130-001,2011,2,24,12,1532,1681,3213,2946
0130-001,2011,2,24,13,1475,1633,3108,3213
0130-001,2011,2,24,14,1650,1817,3467,3108
0130-001,2011,2,24,15,1608,1817,3425,3467
0130-001,2011,2,24,16,1786,2033,3819,3425
0130-001,2011,2,24,17,1746,1886,3632,3819
0130-001,2011,2,24,18,1842,1974,3816,3632
0130-001,2011,2,24,19,1884,2152,4036,3816
0130-001,2011,2,24,20,1472,1887,3359,4036
0130-001,2011,2,24,21,1350,1740,3090,3359
0130-001,2011,2,24,22,1194,2095,3289,3090
0130-001,2011,2,24,23,822,1010,1832,3289
0130-001,2011,2,24,24,565,491,1056,1832
0130-001,2011,2,25,1,422,258,680,1056
0130-001,2011,2,25,2,223,162,385,680
0130-001,2011,2,25,3,157,129,286,385
0130-001,2011,2,25,4,145,105,250,286
0130-001,2011,2,25,5,198,104,302,250
0130-001,2011,2,25,6,224,167,391,302
0130-001,2011,2,25,7,604,633,1237,391
0130-001,2011,2,25,8,1564,1402,2966,1237
0130-001,2011,2,25,9,1738,1288,3026,2966
0130-001,2011,2,25,10,1598,1247,2845,3026
0130-001,2011,2,25,11,1667,1194,2861,2845
0130-001,2011,2,25,12,1634,1400,3034,2861
0130-001,2011,2,25,13,1488,1612,3100,3034
0130-001,2011,2,25,14,1653,1978,3631,3100
0130-001,2011,2,25,15,1752,2223,3975,3631
0130-001,2011,2,25,16,1804,2182,3986,3975
0130-001,2011,2,25,17,1722,1921,3643,3986
0130-001,2011,2,25,18,1881,1990,3871,3643
0130-001,2011,2,25,19,1752,1931,3683,3871
0130-001,2011,2,25,20,1349,1367,2716,3683
0130-001,2011,2,25,21,1531,1264,2795,2716
0130-001,2011,2,25,22,1258,833,2091,2795
0130-001,2011,2,25,23,910,670,1580,2091
0130-001,2011,2,25,24,632,505,1137,1580
0130-001,2011,2,26,1,446,337,783,1137
0130-001,2011,2,26,2,328,253,581,783
0130-001,2011,2,26,3,235,618,853,581
0130-001,2011,2,26,4,204,187,391,853
0130-001,2011,2,26,5,222,401,623,391
0130-001,2011,2,26,6,277,376,653,623
0130-001,2011,2,26,7,514,708,1222,653
0130-001,2011,2,26,8,1076,1481,2557,1222
0130-001,2011,2,26,9,1353,1193,2546,2557
0130-001,2011,2,26,10,1524,1107,2631,2546
0130-001,2011,2,26,11,1653,1132,2785,2631
0130-001,2011,2,26,12,1878,1376,3254,2785
0130-001,2011,2,26,13,1980,1477,3457,3254
0130-001,2011,2,26,14,1980,2391,4371,3457
0130-001,2011,2,26,15,1954,2381,4335,4371
0130-001,2011,2,26,16,1956,2405,4361,4335
0130-001,2011,2,26,17,1987,2166,4153,4361
0130-001,2011,2,26,18,1980,1791,3771,4153
0130-001,2011,2,26,19,1837,1346,3183,3771
0130-001,2011,2,26,20,1500,1421,2921,3183
0130-001,2011,2,26,21,1306,1140,2446,2921
0130-001,2011,2,26,22,1054,1298,2352,2446
0130-001,2011,2,26,23,733,894,1627,2352
0130-001,2011,2,26,24,529,461,990,1627
0130-001,2011,2,27,1,378,304,682,990
0130-001,2011,2,27,2,261,190,451,682
0130-001,2011,2,27,3,216,166,382,451
0130-001,2011,2,27,4,165,134,299,382
0130-001,2011,2,27,5,150,193,343,299
0130-001,2011,2,27,6,187,622,809,343
0130-001,2011,2,27,7,331,288,619,809
0130-001,2011,2,27,8,526,482,1008,619
0130-001,2011,2,27,9,799,582,1381,1008
0130-001,2011,2,27,10,828,558,1386,1381
0130-001,2011,2,27,11,1013,919,1932,1386
0130-001,2011,2,27,12,1085,1024,2109,1932
0130-001,2011,2,27,13,1201,1261,2462,2109
0130-001,2011,2,27,14,1285,1344,2629,2462
0130-001,2011,2,27,15,1347,1574,2921,2629
0130-001,2011,2,27,16,1434,1493,2927,2921
0130-001,2011,2,27,17,1587,1699,3286,2927
0130-001,2011,2,27,18,1520,1685,3205,3286
0130-001,2011,2,27,19,1348,1505,2853,3205
0130-001,2011,2,27,20,1015,871,1886,2853
0130-001,2011,2,27,21,854,964,1818,1886
0130-001,2011,2,27,22,709,866,1575,1818
0130-001,2011,2,27,23,490,549,1039,1575
0130-001,2011,2,27,24,309,354,663,1039
0130-001,2011,2,28,1,218,192,410,663
0130-001,2011,2,28,2,153,103,256,410
0130-001,2011,2,28,3,127,91,218,256
0130-001,2011,2,28,4,106,72,178,218
0130-001,2011,2,28,5,160,83,243,178
0130-001,2011,2,28,6,265,159,424,243
0130-001,2011,2,28,7,623,670,1293,424
0130-001,2011,2,28,8,1457,1388,2845,1293
0130-001,2011,2,28,9,1797,1336,3133,2845
0130-001,2011,2,28,10,1495,1097,2592,3133
0130-001,2011,2,28,11,1447,1435,2882,2592
0130-001,2011,2,28,12,1510,1759,3269,2882
0130-001,2011,2,28,13,1446,1596,3042,3269
0130-001,2011,2,28,14,1644,1910,3554,3042
0130-001,2011,2,28,15,1738,1900,3638,3554
0130-001,2011,2,28,16,1786,1893,3679,3638
0130-001,2011,2,28,17,1651,1889,3540,3679
0130-001,2011,2,28,18,1682,1820,3502,3540
0130-001,2011,2,28,19,1801,1811,3612,3502
0130-001,2011,2,28,20,1408,1472,2880,3612
0130-001,2011,2,28,21,1208,1103,2311,2880
0130-001,2011,2,28,22,1037,889,1926,2311
0130-001,2011,2,28,23,716,650,1366,1926
0130-001,2011,2,28,24,489,424,913,1366
0130-001,2011,3,1,1,443,321,764,913
0130-001,2011,3,1,2,340,291,631,764
0130-001,2011,3,1,3,272,268,540,631
0130-001,2011,3,1,4,181,162,343,540
0130-001,2011,3,1,5,216,329,545,343
0130-001,2011,3,1,6,270,318,588,545
0130-001,2011,3,1,7,444,292,736,588
0130-001,2011,3,1,8,858,636,1494,736
0130-001,2011,3,1,9,989,1007,1996,1494
0130-001,2011,3,1,10,1028,1042,2070,1996
0130-001,2011,3,1,11,1192,1073,2265,2070
0130-001,2011,3,1,12,1379,1368,2747,2265
0130-001,2011,3,1,13,1434,1419,2853,2747
0130-001,2011,3,1,14,1603,1691,3294,2853
0130-001,2011,3,1,15,1632,1641,3273,3294
0130-001,2011,3,1,16,1704,1813,3517,3273
0130-001,2011,3,1,17,1588,1651,3239,3517
0130-001,2011,3,1,18,1651,2103,3754,3239
0130-001,2011,3,1,19,1316,1576,2892,3754
0130-001,2011,3,1,20,1045,1438,2483,2892
0130-001,2011,3,1,21,940,1189,2129,2483
0130-001,2011,3,1,22,783,819,1602,2129
0130-001,2011,3,1,23,501,428,929,1602
0130-001,2011,3,1,24,329,286,615,929
0130-001,2011,3,2,1,221,196,417,615
0130-001,2011,3,2,2,152,123,275,417
0130-001,2011,3,2,3,113,107,220,275
0130-001,2011,3,2,4,91,89,180,220
0130-001,2011,3,2,5,159,247,406,180
0130-001,2011,3,2,6,234,268,502,406
0130-001,2011,3,2,7,658,447,1105,502
0130-001,2011,3,2,8,1667,1167,2834,1105
0130-001,2011,3,2,9,1847,1801,3648,2834
0130-001,2011,3,2,10,1410,1724,3134,3648
0130-001,2011,3,2,11,1189,1002,2191,3134
0130-001,2011,3,2,12,1186,1220,2406,2191
0130-001,2011,3,2,13,1113,1147,2260,2406
0130-001,2011,3,2,14,1304,1362,2666,2260
0130-001,2011,3,2,15,1345,1370,2715,2666
0130-001,2011,3,2,16,1351,1384,2735,2715
0130-001,2011,3,2,17,1395,1453,2848,2735
0130-001,2011,3,2,18,1381,1843,3224,2848
0130-001,2011,3,2,19,1607,2152,3759,3224
0130-001,2011,3,2,20,1433,1753,3186,3759
0130-001,2011,3,2,21,1216,1407,2623,3186
0130-001,2011,3,2,22,1087,1025,2112,2623
0130-001,2011,3,2,23,790,749,1539,2112
0130-001,2011,3,2,24,470,420,890,1539
0130-001,2011,3,3,1,341,280,621,890
0130-001,2011,3,3,2,237,186,423,621
0130-001,2011,3,3,3,149,120,269,423
0130-001,2011,3,3,4,130,125,255,269
0130-001,2011,3,3,5,160,261,421,255
0130-001,2011,3,3,6,260,309,569,421
0130-001,2011,3,3,7,636,421,1057,569
0130-001,2011,3,3,8,1699,1224,2923,1057
0130-001,2011,3,3,9,1915,1897,3812,2923
0130-001,2011,3,3,10,1564,1604,3168,3812
0130-001,2011,3,3,11,1511,1458,2969,3168
0130-001,2011,3,3,12,1436,1480,2916,2969
0130-001,2011,3,3,13,1374,1356,2730,2916
0130-001,2011,3,3,14,1530,1430,2960,2730
0130-001,2011,3,3,15,1580,1604,3184,2960
0130-001,2011,3,3,16,1743,1839,3582,3184
0130-001,2011,3,3,17,1593,1710,3303,3582
0130-001,2011,3,3,18,1725,2031,3756,3303
0130-001,2011,3,3,19,1902,2550,4452,3756
0130-001,2011,3,3,20,1398,1642,3040,4452
0130-001,2011,3,3,21,1255,1594,2849,3040
0130-001,2011,3,3,22,1135,1166,2301,2849
0130-001,2011,3,3,23,817,762,1579,2301
0130-001,2011,3,3,24,526,453,979,1579
0130-001,2011,3,4,1,375,334,709,979
0130-001,2011,3,4,2,239,182,421,709
0130-001,2011,3,4,3,181,182,363,421
0130-001,2011,3,4,4,133,148,281,363
0130-001,2011,3,4,5,159,214,373,281
0130-001,2011,3,4,6,282,347,629,373
0130-001,2011,3,4,7,677,428,1105,629
0130-001,2011,3,4,8,1781,1253,3034,1105
0130-001,2011,3,4,9,1854,1802,3656,3034
0130-001,2011,3,4,10,1486,1374,2860,3656
0130-001,2011,3,4,11,1597,1712,3309,2860
0130-001,2011,3,4,12,1566,1602,3168,3309
0130-001,2011,3,4,13,1407,1517,2924,3168
0130-001,2011,3,4,14,1627,1604,3231,2924
0130-001,2011,3,4,15,1657,1599,3256,3231
0130-001,2011,3,4,16,1741,1878,3619,3256
0130-001,2011,3,4,17,1729,1818,3547,3619
0130-001,2011,3,4,18,1904,2251,4155,3547
0130-001,2011,3,4,19,1982,2394,4376,4155
0130-001,2011,3,4,20,1566,2187,3753,4376
0130-001,2011,3,4,21,1218,1484,2702,3753
0130-001,2011,3,4,22,1217,1212,2429,2702
0130-001,2011,3,4,23,880,730,1610,2429
0130-001,2011,3,4,24,563,436,999,1610
0130-001,2011,3,5,1,445,369,814,999
0130-001,2011,3,5,2,302,281,583,814
0130-001,2011,3,5,3,212,176,388,583
0130-001,2011,3,5,4,170,163,333,388
0130-001,2011,3,5,5,196,235,431,333
0130-001,2011,3,5,6,272,303,575,431
0130-001,2011,3,5,7,547,419,966,575
0130-001,2011,3,5,8,1443,1140,2583,966
0130-001,2011,3,5,9,1484,1489,2973,2583
0130-001,2011,3,5,10,1357,1487,2844,2973
0130-001,2011,3,5,11,1468,1731,3199,2844
0130-001,2011,3,5,12,1487,1623,3110,3199
0130-001,2011,3,5,13,1699,2268,3967,3110
0130-001,2011,3,5,14,1708,2106,3814,3967
0130-001,2011,3,5,15,1721,2086,3807,3814
0130-001,2011,3,5,16,1730,1878,3608,3807
0130-001,2011,3,5,17,1685,1721,3406,3608
0130-001,2011,3,5,18,1772,1910,3682,3406
0130-001,2011,3,5,19,1678,1685,3363,3682
0130-001,2011,3,5,20,1350,1403,2753,3363
0130-001,2011,3,5,21,1087,1035,2122,2753
0130-001,2011,3,5,22,967,764,1731,2122
0130-001,2011,3,5,23,717,571,1288,1731
0130-001,2011,3,5,24,534,399,933,1288
0130-001,2011,3,6,1,388,322,710,933
0130-001,2011,3,6,2,247,228,475,710
0130-001,2011,3,6,3,197,152,349,475
0130-001,2011,3,6,4,145,121,266,349
0130-001,2011,3,6,5,147,166,313,266
0130-001,2011,3,6,6,173,200,373,313
0130-001,2011,3,6,7,354,329,683,373
0130-001,2011,3,6,8,535,538,1073,683
0130-001,2011,3,6,9,774,1003,1777,1073
0130-001,2011,3,6,10,869,985,1854,1777
0130-001,2011,3,6,11,1129,1366,2495,1854
0130-001,2011,3,6,12,1123,1358,2481,2495
0130-001,2011,3,6,13,1221,1141,2362,2481
0130-001,2011,3,6,14,1401,1178,2579,2362
0130-001,2011,3,6,15,1381,1079,2460,2579
0130-001,2011,3,6,16,1203,995,2198,2460
0130-001,2011,3,6,17,1244,996,2240,2198
0130-001,2011,3,6,18,1210,926,2136,2240
0130-001,2011,3,6,19,1122,681,1803,2136
0130-001,2011,3,6,20,921,722,1643,1803
0130-001,2011,3,6,21,816,647,1463,1643
0130-001,2011,3,6,22,706,477,1183,1463
0130-001,2011,3,6,23,539,393,932,1183
0130-001,2011,3,6,24,356,267,623,932
0130-001,2011,3,7,1,243,187,430,623
0130-001,2011,3,7,2,157,122,279,430
0130-001,2011,3,7,3,99,109,208,279
0130-001,2011,3,7,4,120,113,233,208
0130-001,2011,3,7,5,125,170,295,233
0130-001,2011,3,7,6,262,272,534,295
0130-001,2011,3,7,7,731,463,1194,534
0130-001,2011,3,7,8,1622,1109,2731,1194
0130-001,2011,3,7,9,1805,1769,3574,2731
0130-001,2011,3,7,10,1530,1579,3109,3574
0130-001,2011,3,7,11,1535,1448,2983,3109
0130-001,2011,3,7,12,1474,1433,2907,2983
0130-001,2011,3,7,13,1378,1385,2763,2907
0130-001,2011,3,7,14,1579,1567,3146,2763
0130-001,2011,3,7,15,1673,1713,3386,3146
0130-001,2011,3,7,16,1760,1818,3578,3386
0130-001,2011,3,7,17,1615,1677,3292,3578
0130-001,2011,3,7,18,1884,2318,4202,3292
0130-001,2011,3,7,19,1815,2323,4138,4202
0130-001,2011,3,7,20,1410,1805,3215,4138
0130-001,2011,3,7,21,1301,1652,2953,3215
0130-001,2011,3,7,22,1158,1306,2464,2953
0130-001,2011,3,7,23,798,738,1536,2464
0130-001,2011,3,7,24,523,474,997,1536
0130-001,2011,3,8,1,345,302,647,997
0130-001,2011,3,8,2,223,181,404,647
0130-001,2011,3,8,3,144,132,276,404
0130-001,2011,3,8,4,135,124,259,276
0130-001,2011,3,8,5,154,224,378,259
0130-001,2011,3,8,6,279,324,603,378
0130-001,2011,3,8,7,682,494,1176,603
0130-001,2011,3,8,8,1743,1256,2999,1176
0130-001,2011,3,8,9,1809,1714,3523,2999
0130-001,2011,3,8,10,1586,1520,3106,3523
0130-001,2011,3,8,11,1579,1510,3089,3106
0130-001,2011,3,8,12,1500,1438,2938,3089
0130-001,2011,3,8,13,1259,1276,2535,2938
0130-001,2011,3,8,14,1442,1412,2854,2535
0130-001,2011,3,8,15,1588,1697,3285,2854
0130-001,2011,3,8,16,1498,1521,3019,3285
0130-001,2011,3,8,17,1452,1568,3020,3019
0130-001,2011,3,8,18,1527,1854,3381,3020
0130-001,2011,3,8,19,1707,2178,3885,3381
0130-001,2011,3,8,20,1477,1817,3294,3885
0130-001,2011,3,8,21,1317,1635,2952,3294
0130-001,2011,3,8,22,1234,1299,2533,2952
0130-001,2011,3,8,23,801,681,1482,2533
0130-001,2011,3,8,24,504,394,898,1482
0130-001,2011,3,9,1,367,298,665,898
0130-001,2011,3,9,2,230,220,450,665
0130-001,2011,3,9,3,150,147,297,450
0130-001,2011,3,9,4,136,141,277,297
0130-001,2011,3,9,5,161,261,422,277
0130-001,2011,3,9,6,263,264,527,422
0130-001,2011,3,9,7,691,490,1181,527
0130-001,2011,3,9,8,1668,1209,2877,1181
0130-001,2011,3,9,9,1710,1639,3349,2877
0130-001,2011,3,9,10,1496,1588,3084,3349
0130-001,2011,3,9,11,1500,1510,3010,3084
0130-001,2011,3,9,12,1429,1368,2797,3010
0130-001,2011,3,9,13,1091,1168,2259,2797
0130-001,2011,3,9,14,1362,1330,2692,2259
0130-001,2011,3,9,15,1570,1619,3189,2692
0130-001,2011,3,9,16,1528,1555,3083,3189
0130-001,2011,3,9,17,1382,1506,2888,3083
0130-001,2011,3,9,18,1595,2108,3703,2888
0130-001,2011,3,9,19,1754,2427,4181,3703
0130-001,2011,3,9,20,1461,1736,3197,4181
0130-001,2011,3,9,21,1233,1342,2575,3197
0130-001,2011,3,9,22,1138,1119,2257,2575
0130-001,2011,3,9,23,773,651,1424,2257
0130-001,2011,3,9,24,484,415,899,1424
0130-001,2011,3,10,1,364,311,675,899
0130-001,2011,3,10,2,215,182,397,675
0130-001,2011,3,10,3,152,136,288,397
0130-001,2011,3,10,4,138,149,287,288
0130-001,2011,3,10,5,152,248,400,287
0130-001,2011,3,10,6,259,328,587,400
0130-001,2011,3,10,7,689,507,1196,587
0130-001,2011,3,10,8,1735,1338,3073,1196
0130-001,2011,3,10,9,1836,1631,3467,3073
0130-001,2011,3,10,10,1572,1634,3206,3467
0130-001,2011,3,10,11,1493,1404,2897,3206
0130-001,2011,3,10,12,1448,1515,2963,2897
0130-001,2011,3,10,13,1299,1357,2656,2963
0130-001,2011,3,10,14,1503,1557,3060,2656
0130-001,2011,3,10,15,1630,1680,3310,3060
0130-001,2011,3,10,16,1719,1652,3371,3310
0130-001,2011,3,10,17,1627,1703,3330,3371
0130-001,2011,3,10,18,1615,2126,3741,3330
0130-001,2011,3,10,19,1708,2178,3886,3741
0130-001,2011,3,10,20,1429,1838,3267,3886
0130-001,2011,3,10,21,1225,1486,2711,3267
0130-001,2011,3,10,22,1143,1218,2361,2711
0130-001,2011,3,10,23,787,650,1437,2361
0130-001,2011,3,10,24,544,444,988,1437
0130-001,2011,3,11,1,387,314,701,988
0130-001,2011,3,11,2,262,211,473,701
0130-001,2011,3,11,3,167,148,315,473
0130-001,2011,3,11,4,147,135,282,315
0130-001,2011,3,11,5,200,313,513,282
0130-001,2011,3,11,6,274,301,575,513
0130-001,2011,3,11,7,693,486,1179,575
0130-001,2011,3,11,8,1806,1311,3117,1179
0130-001,2011,3,11,9,1949,1827,3776,3117
0130-001,2011,3,11,10,1583,1584,3167,3776
0130-001,2011,3,11,11,1519,1498,3017,3167
0130-001,2011,3,11,12,1560,1611,3171,3017
0130-001,2011,3,11,13,1395,1467,2862,3171
0130-001,2011,3,11,14,1548,1649,3197,2862
0130-001,2011,3,11,15,1705,1680,3385,3197
0130-001,2011,3,11,16,1753,1772,3525,3385
0130-001,2011,3,11,17,1717,1887,3604,3525
0130-001,2011,3,11,18,1846,2211,4057,3604
0130-001,2011,3,11,19,2046,2413,4459,4057
0130-001,2011,3,11,20,1566,2118,3684,4459
0130-001,2011,3,11,21,1209,1475,2684,3684
0130-001,2011,3,11,22,1203,1252,2455,2684
0130-001,2011,3,11,23,857,663,1520,2455
0130-001,2011,3,11,24,611,494,1105,1520
0130-001,2011,3,12,1,444,351,795,1105
0130-001,2011,3,12,2,299,238,537,795
0130-001,2011,3,12,3,237,219,456,537
0130-001,2011,3,12,4,213,193,406,456
0130-001,2011,3,12,5,176,206,382,406
0130-001,2011,3,12,6,288,315,603,382
0130-001,2011,3,12,7,557,441,998,603
0130-001,2011,3,12,8,1112,1033,2145,998
0130-001,2011,3,12,9,1411,1429,2840,2145
0130-001,2011,3,12,10,1433,1589,3022,2840
0130-001,2011,3,12,11,1607,1945,3552,3022
0130-001,2011,3,12,12,1686,2124,3810,3552
0130-001,2011,3,12,13,1802,2260,4062,3810
0130-001,2011,3,12,14,1845,2271,4116,4062
0130-001,2011,3,12,15,1769,2115,3884,4116
0130-001,2011,3,12,16,1805,2112,3917,3884
0130-001,2011,3,12,17,1847,1947,3794,3917
0130-001,2011,3,12,18,1760,1792,3552,3794
0130-001,2011,3,12,19,1581,1578,3159,3552
0130-001,2011,3,12,20,1297,1330,2627,3159
0130-001,2011,3,12,21,964,829,1793,2627
0130-001,2011,3,12,22,943,753,1696,1793
0130-001,2011,3,12,23,629,490,1119,1696
0130-001,2011,3,12,24,438,349,787,1119
0130-001,2011,3,13,1,353,301,654,787
0130-001,2011,3,13,2,278,605,883,654
0130-001,2011,3,13,3,221,206,427,883
0130-001,2011,3,13,4,173,156,329,427
0130-001,2011,3,13,5,152,78,230,329
0130-001,2011,3,13,6,200,201,401,230
0130-001,2011,3,13,7,387,458,845,401
0130-001,2011,3,13,8,584,530,1114,845
0130-001,2011,3,13,9,847,694,1541,1114
0130-001,2011,3,13,10,892,620,1512,1541
0130-001,2011,3,13,11,1062,902,1964,1512
0130-001,2011,3,13,12,1015,1027,2042,1964
0130-001,2011,3,13,13,1042,1171,2213,2042
0130-001,2011,3,13,14,1227,1341,2568,2213
0130-001,2011,3,13,15,1313,1243,2556,2568
0130-001,2011,3,13,16,1404,1453,2857,2556
0130-001,2011,3,13,17,1348,1430,2778,2857
0130-001,2011,3,13,18,1275,1277,2552,2778
0130-001,2011,3,13,19,1238,1266,2504,2552
0130-001,2011,3,13,20,1060,1196,2256,2504
0130-001,2011,3,13,21,881,1057,1938,2256
0130-001,2011,3,13,22,764,873,1637,1938
0130-001,2011,3,13,23,523,853,1376,1637
0130-001,2011,3,13,24,390,591,981,1376
0130-001,2011,3,14,1,266,240,506,981
0130-001,2011,3,14,2,167,231,398,506
0130-001,2011,3,14,3,121,391,512,398
0130-001,2011,3,14,4,124,222,346,512
0130-001,2011,3,14,5,127,68,195,346
0130-001,2011,3,14,6,266,146,412,195
0130-001,2011,3,14,7,762,500,1262,412
0130-001,2011,3,14,8,1830,1615,3445,1262
0130-001,2011,3,14,9,1904,1952,3856,3445
0130-001,2011,3,14,10,1547,1507,3054,3856
0130-001,2011,3,14,11,1508,1240,2748,3054
0130-001,2011,3,14,12,1511,1442,2953,2748
0130-001,2011,3,14,13,1388,1217,2605,2953
0130-001,2011,3,14,14,1488,1445,2933,2605
0130-001,2011,3,14,15,1624,1838,3462,2933
0130-001,2011,3,14,16,1745,1629,3374,3462
0130-001,2011,3,14,17,1631,1441,3072,3374
0130-001,2011,3,14,18,1759,1268,3027,3072
0130-001,2011,3,14,19,1826,1409,3235,3027
0130-001,2011,3,14,20,1501,1229,2730,3235
0130-001,2011,3,14,21,1304,1278,2582,2730
0130-001,2011,3,14,22,1133,897,2030,2582
0130-001,2011,3,14,23,777,963,1740,2030
0130-001,2011,3,14,24,520,537,1057,1740
0130-001,2011,3,15,1,351,256,607,1057
0130-001,2011,3,15,2,197,258,455,607
0130-001,2011,3,15,3,164,676,840,455
0130-001,2011,3,15,4,117,144,261,840
0130-001,2011,3,15,5,148,172,320,261
0130-001,2011,3,15,6,271,346,617,320
0130-001,2011,3,15,7,745,574,1319,617
0130-001,2011,3,15,8,1829,1185,3014,1319
0130-001,2011,3,15,9,1894,1363,3257,3014
0130-001,2011,3,15,10,1577,927,2504,3257
0130-001,2011,3,15,11,1400,1357,2757,2504
0130-001,2011,3,15,12,1163,1417,2580,2757
0130-001,2011,3,15,13,1070,1163,2233,2580
0130-001,2011,3,15,14,1243,1292,2535,2233
0130-001,2011,3,15,15,1280,1528,2808,2535
0130-001,2011,3,15,16,1278,1653,2931,2808
0130-001,2011,3,15,17,1259,1435,2694,2931
0130-001,2011,3,15,18,1360,1151,2511,2694
0130-001,2011,3,15,19,1443,1137,2580,2511
0130-001,2011,3,15,20,1178,996,2174,2580
0130-001,2011,3,15,21,980,796,1776,2174
0130-001,2011,3,15,22,919,836,1755,1776
0130-001,2011,3,15,23,629,484,1113,1755
0130-001,2011,3,15,24,427,517,944,1113
0130-001,2011,3,16,1,261,212,473,944
0130-001,2011,3,16,2,173,165,338,473
0130-001,2011,3,16,3,128,126,254,338
0130-001,2011,3,16,4,107,111,218,254
0130-001,2011,3,16,5,138,224,362,218
0130-001,2011,3,16,6,187,188,375,362
0130-001,2011,3,16,7,574,407,981,375
0130-001,2011,3,16,8,1663,1205,2868,981
0130-001,2011,3,16,9,1854,1777,3631,2868
0130-001,2011,3,16,10,1527,1621,3148,3631
0130-001,2011,3,16,11,1501,1511,3012,3148
0130-001,2011,3,16,12,1459,1397,2856,3012
0130-001,2011,3,16,13,1356,1452,2808,2856
0130-001,2011,3,16,14,1498,1462,2960,2808
0130-001,2011,3,16,15,1607,1657,3264,2960
0130-001,2011,3,16,16,1664,1693,3357,3264
0130-001,2011,3,16,17,1598,1742,3340,3357
0130-001,2011,3,16,18,1837,2428,4265,3340
0130-001,2011,3,16,19,1582,2189,3771,4265
0130-001,2011,3,16,20,1176,1398,2574,3771
0130-001,2011,3,16,21,939,1022,1961,2574
0130-001,2011,3,16,22,901,886,1787,1961
0130-001,2011,3,16,23,651,548,1199,1787
0130-001,2011,3,16,24,384,330,714,1199
0130-001,2011,3,17,1,312,266,578,714
0130-001,2011,3,17,2,166,141,307,578
0130-001,2011,3,17,3,133,120,253,307
0130-001,2011,3,17,4,108,116,224,253
0130-001,2011,3,17,5,109,178,287,224
0130-001,2011,3,17,6,250,317,567,287
0130-001,2011,3,17,7,620,456,1076,567
0130-001,2011,3,17,8,1766,1362,3128,1076
0130-001,2011,3,17,9,1877,1667,3544,3128
0130-001,2011,3,17,10,1316,1368,2684,3544
0130-001,2011,3,17,11,1234,1161,2395,2684
0130-001,2011,3,17,12,1143,1196,2339,2395
0130-001,2011,3,17,13,1078,1126,2204,2339
0130-001,2011,3,17,14,1220,1264,2484,2204
0130-001,2011,3,17,15,1247,1286,2533,2484
0130-001,2011,3,17,16,1320,1269,2589,2533
0130-001,2011,3,17,17,1274,1334,2608,2589
0130-001,2011,3,17,18,1413,1860,3273,2608
0130-001,2011,3,17,19,1513,1929,3442,3273
0130-001,2011,3,17,20,1160,1492,2652,3442
0130-001,2011,3,17,21,990,1201,2191,2652
0130-001,2011,3,17,22,893,952,1845,2191
0130-001,2011,3,17,23,670,554,1224,1845
0130-001,2011,3,17,24,407,333,740,1224
0130-001,2011,3,18,1,287,233,520,740
0130-001,2011,3,18,2,195,157,352,520
0130-001,2011,3,18,3,158,140,298,352
0130-001,2011,3,18,4,150,138,288,298
0130-001,2011,3,18,5,158,247,405,288
0130-001,2011,3,18,6,273,300,573,405
0130-001,2011,3,18,7,730,512,1242,573
0130-001,2011,3,18,8,1769,1284,3053,1242
0130-001,2011,3,18,9,1834,1720,3554,3053
0130-001,2011,3,18,10,1542,1543,3085,3554
0130-001,2011,3,18,11,1335,1316,2651,3085
0130-001,2011,3,18,12,1125,1162,2287,2651
0130-001,2011,3,18,13,1104,1161,2265,2287
0130-001,2011,3,18,14,1307,1392,2699,2265
0130-001,2011,3,18,15,1278,1260,2538,2699
0130-001,2011,3,18,16,1314,1328,2642,2538
0130-001,2011,3,18,17,1319,1450,2769,2642
0130-001,2011,3,18,18,1437,1722,3159,2769
0130-001,2011,3,18,19,1626,1918,3544,3159
0130-001,2011,3,18,20,1345,1819,3164,3544
0130-001,2011,3,18,21,1005,1226,2231,3164
0130-001,2011,3,18,22,921,959,1880,2231
0130-001,2011,3,18,23,702,543,1245,1880
0130-001,2011,3,18,24,529,428,957,1245
0130-001,2011,3,19,1,436,344,780,957
0130-001,2011,3,19,2,321,255,576,780
0130-001,2011,3,19,3,249,230,479,576
0130-001,2011,3,19,4,175,159,334,479
0130-001,2011,3,19,5,220,257,477,334
0130-001,2011,3,19,6,293,320,613,477
0130-001,2011,3,19,7,601,476,1077,613
0130-001,2011,3,19,8,1383,1285,2668,1077
0130-001,2011,3,19,9,1581,1601,3182,2668
0130-001,2011,3,19,10,1518,1683,3201,3182
0130-001,2011,3,19,11,1540,1864,3404,3201
0130-001,2011,3,19,12,1574,1983,3557,3404
0130-001,2011,3,19,13,1768,2217,3985,3557
0130-001,2011,3,19,14,1829,2252,4081,3985
0130-001,2011,3,19,15,1791,2141,3932,4081
0130-001,2011,3,19,16,1722,2015,3737,3932
0130-001,2011,3,19,17,1845,1945,3790,3737
0130-001,2011,3,19,18,1911,1946,3857,3790
0130-001,2011,3,19,19,1685,1681,3366,3857
0130-001,2011,3,19,20,1392,1427,2819,3366
0130-001,2011,3,19,21,1052,904,1956,2819
0130-001,2011,3,19,22,788,630,1418,1956
0130-001,2011,3,19,23,592,462,1054,1418
0130-001,2011,3,19,24,403,321,724,1054
0130-001,2011,3,20,1,295,248,543,724
0130-001,2011,3,20,2,230,182,412,543
0130-001,2011,3,20,3,195,186,381,412
0130-001,2011,3,20,4,134,109,243,381
0130-001,2011,3,20,5,123,122,245,243
0130-001,2011,3,20,6,166,202,368,245
0130-001,2011,3,20,7,305,260,565,368
0130-001,2011,3,20,8,488,442,930,565
0130-001,2011,3,20,9,849,1092,1941,930
0130-001,2011,3,20,10,830,920,1750,1941
0130-001,2011,3,20,11,1065,1404,2469,1750
0130-001,2011,3,20,12,1159,1442,2601,2469
0130-001,2011,3,20,13,1326,1420,2746,2601
0130-001,2011,3,20,14,1289,1182,2471,2746
0130-001,2011,3,20,15,1452,1197,2649,2471
0130-001,2011,3,20,16,1404,1111,2515,2649
0130-001,2011,3,20,17,1426,1168,2594,2515
0130-001,2011,3,20,18,1496,1112,2608,2594
0130-001,2011,3,20,19,1306,910,2216,2608
0130-001,2011,3,20,20,1062,801,1863,2216
0130-001,2011,3,20,21,905,701,1606,1863
0130-001,2011,3,20,22,789,559,1348,1606
0130-001,2011,3,20,23,492,370,862,1348
0130-001,2011,3,20,24,307,241,548,862
0130-001,2011,3,21,1,178,133,311,548
0130-001,2011,3,21,2,119,112,231,311
0130-001,2011,3,21,3,78,73,151,231
0130-001,2011,3,21,4,97,103,200,151
0130-001,2011,3,21,5,132,197,329,200
0130-001,2011,3,21,6,228,269,497,329
0130-001,2011,3,21,7,687,450,1137,497
0130-001,2011,3,21,8,1489,1054,2543,1137
0130-001,2011,3,21,9,1512,1473,2985,2543
0130-001,2011,3,21,10,1181,1225,2406,2985
0130-001,2011,3,21,11,1195,1170,2365,2406
0130-001,2011,3,21,12,1190,1256,2446,2365
0130-001,2011,3,21,13,1124,1050,2174,2446
0130-001,2011,3,21,14,1306,1316,2622,2174
0130-001,2011,3,21,15,1361,1343,2704,2622
0130-001,2011,3,21,16,1399,1481,2880,2704
0130-001,2011,3,21,17,1384,1502,2886,2880
0130-001,2011,3,21,18,1511,1999,3510,2886
0130-001,2011,3,21,19,1682,2137,3819,3510
0130-001,2011,3,21,20,1361,1665,3026,3819
0130-001,2011,3,21,21,1208,1510,2718,3026
0130-001,2011,3,21,22,979,1074,2053,2718
0130-001,2011,3,21,23,621,477,1098,2053
0130-001,2011,3,21,24,390,294,684,1098
0130-001,2011,3,22,1,283,241,524,684
0130-001,2011,3,22,2,169,147,316,524
0130-001,2011,3,22,3,147,131,278,316
0130-001,2011,3,22,4,110,108,218,278
0130-001,2011,3,22,5,129,174,303,218
0130-001,2011,3,22,6,213,239,452,303
0130-001,2011,3,22,7,606,393,999,452
0130-001,2011,3,22,8,1394,975,2369,999
0130-001,2011,3,22,9,1540,1419,2959,2369
0130-001,2011,3,22,10,1561,1577,3138,2959
0130-001,2011,3,22,11,1590,1494,3084,3138
0130-001,2011,3,22,12,1462,1431,2893,3084
0130-001,2011,3,22,13,1171,1157,2328,2893
0130-001,2011,3,22,14,1257,1287,2544,2328
0130-001,2011,3,22,15,1299,1302,2601,2544
0130-001,2011,3,22,16,1478,1485,2963,2601
0130-001,2011,3,22,17,1344,1444,2788,2963
0130-001,2011,3,22,18,1656,2107,3763,2788
0130-001,2011,3,22,19,1548,2214,3762,3763
0130-001,2011,3,22,20,1463,1896,3359,3762
0130-001,2011,3,22,21,1279,1525,2804,3359
0130-001,2011,3,22,22,1145,1163,2308,2804
0130-001,2011,3,22,23,788,649,1437,2308
0130-001,2011,3,22,24,500,391,891,1437
0130-001,2011,3,23,1,320,262,582,891
0130-001,2011,3,23,2,195,155,350,582
0130-001,2011,3,23,3,157,145,302,350
0130-001,2011,3,23,4,135,126,261,302
0130-001,2011,3,23,5,145,214,359,261
0130-001,2011,3,23,6,257,325,582,359
0130-001,2011,3,23,7,726,541,1267,582
0130-001,2011,3,23,8,1727,1275,3002,1267
0130-001,2011,3,23,9,1823,1703,3526,3002
0130-001,2011,3,23,10,1576,1523,3099,3526
0130-001,2011,3,23,11,1531,1479,3010,3099
0130-001,2011,3,23,12,1436,1411,2847,3010
0130-001,2011,3,23,13,1100,1178,2278,2847
0130-001,2011,3,23,14,1200,1272,2472,2278
0130-001,2011,3,23,15,1331,1360,2691,2472
0130-001,2011,3,23,16,1283,1196,2479,2691
0130-001,2011,3,23,17,1266,1313,2579,2479
0130-001,2011,3,23,18,1394,1807,3201,2579
0130-001,2011,3,23,19,1778,2389,4167,3201
0130-001,2011,3,23,20,1538,1913,3451,4167
0130-001,2011,3,23,21,1223,1383,2606,3451
0130-001,2011,3,23,22,1217,1071,2288,2606
0130-001,2011,3,23,23,842,697,1539,2288
0130-001,2011,3,23,24,524,413,937,1539
0130-001,2011,3,24,1,365,361,726,937
0130-001,2011,3,24,2,230,193,423,726
0130-001,2011,3,24,3,167,168,335,423
0130-001,2011,3,24,4,144,176,320,335
0130-001,2011,3,24,5,152,230,382,320
0130-001,2011,3,24,6,271,322,593,382
0130-001,2011,3,24,7,611,437,1048,593
0130-001,2011,3,24,8,1569,1124,2693,1048
0130-001,2011,3,24,9,1845,1672,3517,2693
0130-001,2011,3,24,10,1530,1510,3040,3517
0130-001,2011,3,24,11,1560,1580,3140,3040
0130-001,2011,3,24,12,1423,1363,2786,3140
0130-001,2011,3,24,13,1360,1432,2792,2786
0130-001,2011,3,24,14,1507,1558,3065,2792
0130-001,2011,3,24,15,1547,1591,3138,3065
0130-001,2011,3,24,16,1597,1564,3161,3138
0130-001,2011,3,24,17,1492,1618,3110,3161
0130-001,2011,3,24,18,1409,1518,2927,3110
0130-001,2011,3,24,19,1454,1415,2869,2927
0130-001,2011,3,24,20,1381,1746,3127,2869
0130-001,2011,3,24,21,1169,1508,2677,3127
0130-001,2011,3,24,22,1024,1120,2144,2677
0130-001,2011,3,24,23,771,746,1517,2144
0130-001,2011,3,24,24,482,369,851,1517
0130-001,2011,3,25,1,352,280,632,851
0130-001,2011,3,25,2,215,175,390,632
0130-001,2011,3,25,3,177,158,335,390
0130-001,2011,3,25,4,134,134,268,335
0130-001,2011,3,25,5,162,231,393,268
0130-001,2011,3,25,6,265,278,543,393
0130-001,2011,3,25,7,624,463,1087,543
0130-001,2011,3,25,8,1715,1182,2897,1087
0130-001,2011,3,25,9,1554,1484,3038,2897
0130-001,2011,3,25,10,1163,1246,2409,3038
0130-001,2011,3,25,11,1263,1221,2484,2409
0130-001,2011,3,25,12,1195,1214,2409,2484
0130-001,2011,3,25,13,1106,1243,2349,2409
0130-001,2011,3,25,14,1179,1237,2416,2349
0130-001,2011,3,25,15,1275,1338,2613,2416
0130-001,2011,3,25,16,1317,1409,2726,2613
0130-001,2011,3,25,17,1389,1427,2816,2726
0130-001,2011,3,25,18,1508,1848,3356,2816
0130-001,2011,3,25,19,1495,1836,3331,3356
0130-001,2011,3,25,20,1306,1720,3026,3331
0130-001,2011,3,25,21,1042,1309,2351,3026
0130-001,2011,3,25,22,926,880,1806,2351
0130-001,2011,3,25,23,651,469,1120,1806
0130-001,2011,3,25,24,496,360,856,1120
0130-001,2011,3,26,1,371,287,658,856
0130-001,2011,3,26,2,282,227,509,658
0130-001,2011,3,26,3,216,213,429,509
0130-001,2011,3,26,4,156,147,303,429
0130-001,2011,3,26,5,171,196,367,303
0130-001,2011,3,26,6,216,227,443,367
0130-001,2011,3,26,7,470,415,885,443
0130-001,2011,3,26,8,1039,807,1846,885
0130-001,2011,3,26,9,1430,1300,2730,1846
0130-001,2011,3,26,10,1547,1624,3171,2730
0130-001,2011,3,26,11,1687,1912,3599,3171
0130-001,2011,3,26,12,1763,2199,3962,3599
0130-001,2011,3,26,13,1845,2687,4532,3962
0130-001,2011,3,26,14,1687,1993,3680,4532
0130-001,2011,3,26,15,1435,1562,2997,3680
0130-001,2011,3,26,16,1454,1616,3070,2997
0130-001,2011,3,26,17,1493,1411,2904,3070
0130-001,2011,3,26,18,1533,1427,2960,2904
0130-001,2011,3,26,19,1358,1475,2833,2960
0130-001,2011,3,26,20,1160,1040,2200,2833
0130-001,2011,3,26,21,1240,1091,2331,2200
0130-001,2011,3,26,22,800,659,1459,2331
0130-001,2011,3,26,23,573,421,994,1459
0130-001,2011,3,26,24,413,333,746,994
0130-001,2011,3,27,1,284,239,523,746
0130-001,2011,3,27,2,225,205,430,523
0130-001,2011,3,27,3,185,158,343,430
0130-001,2011,3,27,4,112,76,188,343
0130-001,2011,3,27,5,164,184,348,188
0130-001,2011,3,27,6,185,218,403,348
0130-001,2011,3,27,7,315,242,557,403
0130-001,2011,3,27,8,585,523,1108,557
0130-001,2011,3,27,9,752,895,1647,1108
0130-001,2011,3,27,10,856,933,1789,1647
0130-001,2011,3,27,11,928,1160,2088,1789
0130-001,2011,3,27,12,894,1107,2001,2088
0130-001,2011,3,27,13,1014,1208,2222,2001
0130-001,2011,3,27,14,1160,1232,2392,2222
0130-001,2011,3,27,15,1106,1203,2309,2392
0130-001,2011,3,27,16,1308,1167,2475,2309
0130-001,2011,3,27,17,1299,1098,2397,2475
0130-001,2011,3,27,18,1242,1208,2450,2397
0130-001,2011,3,27,19,1188,1068,2256,2450
0130-001,2011,3,27,20,954,804,1758,2256
0130-001,2011,3,27,21,893,708,1601,1758
0130-001,2011,3,27,22,736,509,1245,1601
0130-001,2011,3,27,23,467,350,817,1245
0130-001,2011,3,27,24,302,199,501,817
0130-001,2011,3,28,1,211,150,361,501
0130-001,2011,3,28,2,145,116,261,361
0130-001,2011,3,28,3,95,82,177,261
0130-001,2011,3,28,4,86,69,155,177
0130-001,2011,3,28,5,104,144,248,155
0130-001,2011,3,28,6,216,245,461,248
0130-001,2011,3,28,7,645,440,1085,461
0130-001,2011,3,28,8,1644,1088,2732,1085
0130-001,2011,3,28,9,1855,1709,3564,2732
0130-001,2011,3,28,10,1485,1532,3017,3564
0130-001,2011,3,28,11,1252,1217,2469,3017
0130-001,2011,3,28,12,1177,1172,2349,2469
0130-001,2011,3,28,13,1106,1174,2280,2349
0130-001,2011,3,28,14,1151,1088,2239,2280
0130-001,2011,3,28,15,1529,1463,2992,2239
0130-001,2011,3,28,16,1213,1186,2399,2992
0130-001,2011,3,28,17,1270,1347,2617,2399
0130-001,2011,3,28,18,1438,1760,3198,2617
0130-001,2011,3,28,19,1509,1981,3490,3198
0130-001,2011,3,28,20,1141,1416,2557,3490
0130-001,2011,3,28,21,991,1330,2321,2557
0130-001,2011,3,28,22,885,922,1807,2321
0130-001,2011,3,28,23,625,517,1142,1807
0130-001,2011,3,28,24,376,271,647,1142
0130-001,2011,3,29,1,262,239,501,647
0130-001,2011,3,29,2,174,156,330,501
0130-001,2011,3,29,3,127,118,245,330
0130-001,2011,3,29,4,133,141,274,245
0130-001,2011,3,29,5,174,213,387,274
0130-001,2011,3,29,6,237,274,511,387
0130-001,2011,3,29,7,727,476,1203,511
0130-001,2011,3,29,8,1644,1122,2766,1203
0130-001,2011,3,29,9,1800,1654,3454,2766
0130-001,2011,3,29,10,1690,1718,3408,3454
0130-001,2011,3,29,11,1512,1481,2993,3408
0130-001,2011,3,29,12,1186,1226,2412,2993
0130-001,2011,3,29,13,1049,1104,2153,2412
0130-001,2011,3,29,14,1469,1350,2819,2153
0130-001,2011,3,29,15,1676,1750,3426,2819
0130-001,2011,3,29,16,1675,1611,3286,3426
0130-001,2011,3,29,17,1677,1762,3439,3286
0130-001,2011,3,29,18,1794,2195,3989,3439
0130-001,2011,3,29,19,1880,2732,4612,3989
0130-001,2011,3,29,20,1135,1378,2513,4612
0130-001,2011,3,29,21,969,1135,2104,2513
0130-001,2011,3,29,22,908,976,1884,2104
0130-001,2011,3,29,23,652,522,1174,1884
0130-001,2011,3,29,24,439,327,766,1174
0130-001,2011,3,30,1,297,259,556,766
0130-001,2011,3,30,2,181,158,339,556
0130-001,2011,3,30,3,135,117,252,339
0130-001,2011,3,30,4,118,109,227,252
0130-001,2011,3,30,5,122,158,280,227
0130-001,2011,3,30,6,234,272,506,280
0130-001,2011,3,30,7,662,417,1079,506
0130-001,2011,3,30,8,1713,1177,2890,1079
0130-001,2011,3,30,9,1788,1658,3446,2890
0130-001,2011,3,30,10,1454,1549,3003,3446
0130-001,2011,3,30,11,1668,1576,3244,3003
0130-001,2011,3,30,12,1487,1501,2988,3244
0130-001,2011,3,30,13,1343,1423,2766,2988
0130-001,2011,3,30,14,1596,1574,3170,2766
0130-001,2011,3,30,15,1621,1590,3211,3170
0130-001,2011,3,30,16,1725,1732,3457,3211
0130-001,2011,3,30,17,1646,1733,3379,3457
0130-001,2011,3,30,18,1879,2417,4296,3379
0130-001,2011,3,30,19,1981,2499,4480,4296
0130-001,2011,3,30,20,1487,1914,3401,4480
0130-001,2011,3,30,21,1101,1272,2373,3401
0130-001,2011,3,30,22,921,867,1788,2373
0130-001,2011,3,30,23,651,491,1142,1788
0130-001,2011,3,30,24,465,376,841,1142
0130-001,2011,3,31,1,307,234,541,841
0130-001,2011,3,31,2,194,154,348,541
0130-001,2011,3,31,3,144,136,280,348
0130-001,2011,3,31,4,138,157,295,280
0130-001,2011,3,31,5,162,220,382,295
0130-001,2011,3,31,6,236,276,512,382
0130-001,2011,3,31,7,730,497,1227,512
0130-001,2011,3,31,8,1647,1118,2765,1227
0130-001,2011,3,31,9,1791,1662,3453,2765
0130-001,2011,3,31,10,1340,1373,2713,3453
0130-001,2011,3,31,11,1393,1351,2744,2713
0130-001,2011,3,31,12,1535,1681,3216,2744
0130-001,2011,3,31,13,1339,1371,2710,3216
0130-001,2011,3,31,14,1548,1502,3050,2710
0130-001,2011,3,31,15,1719,1747,3466,3050
0130-001,2011,3,31,16,1700,1629,3329,3466
0130-001,2011,3,31,17,1626,1717,3343,3329
0130-001,2011,3,31,18,1863,2365,4228,3343
0130-001,2011,3,31,19,1934,2912,4846,4228
0130-001,2011,3,31,20,1385,1737,3122,4846
0130-001,2011,3,31,21,935,1001,1936,3122
0130-001,2011,3,31,22,963,951,1914,1936
0130-001,2011,3,31,23,729,591,1320,1914
0130-001,2011,3,31,24,479,388,867,1320
0130-001,2011,4,1,1,402,341,743,867
0130-001,2011,4,1,2,230,182,412,743
0130-001,2011,4,1,3,176,166,342,412
0130-001,2011,4,1,4,149,158,307,342
0130-001,2011,4,1,5,162,226,388,307
0130-001,2011,4,1,6,278,318,596,388
0130-001,2011,4,1,7,798,538,1336,596
0130-001,2011,4,1,8,1906,1328,3234,1336
0130-001,2011,4,1,9,1810,1746,3556,3234
0130-001,2011,4,1,10,1459,1434,2893,3556
0130-001,2011,4,1,11,1490,1530,3020,2893
0130-001,2011,4,1,12,1398,1426,2824,3020
0130-001,2011,4,1,13,1268,1393,2661,2824
0130-001,2011,4,1,14,1230,1329,2559,2661
0130-001,2011,4,1,15,1833,1847,3680,2559
0130-001,2011,4,1,16,1762,1919,3681,3680
0130-001,2011,4,1,17,1714,1797,3511,3681
0130-001,2011,4,1,18,1797,2182,3979,3511
0130-001,2011,4,1,19,1921,2381,4302,3979
0130-001,2011,4,1,20,1568,1963,3531,4302
0130-001,2011,4,1,21,1306,1671,2977,3531
0130-001,2011,4,1,22,1186,1292,2478,2977
0130-001,2011,4,1,23,905,795,1700,2478
0130-001,2011,4,1,24,712,595,1307,1700
0130-001,2011,4,2,1,532,455,987,1307
0130-001,2011,4,2,2,368,325,693,987
0130-001,2011,4,2,3,259,241,500,693
0130-001,2011,4,2,4,235,244,479,500
0130-001,2011,4,2,5,184,190,374,479
0130-001,2011,4,2,6,346,393,739,374
0130-001,2011,4,2,7,791,623,1414,739
0130-001,2011,4,2,8,1602,1413,3015,1414
0130-001,2011,4,2,9,1788,1624,3412,3015
0130-001,2011,4,2,10,1582,1580,3162,3412
0130-001,2011,4,2,11,1565,1866,3431,3162
0130-001,2011,4,2,12,1535,1993,3528,3431
0130-001,2011,4,2,13,1625,2207,3832,3528
0130-001,2011,4,2,14,1802,2217,4019,3832
0130-001,2011,4,2,15,1815,2076,3891,4019
0130-001,2011,4,2,16,1775,2091,3866,3891
0130-001,2011,4,2,17,1825,1950,3775,3866
0130-001,2011,4,2,18,2096,2207,4303,3775
0130-001,2011,4,2,19,1952,2052,4004,4303
0130-001,2011,4,2,20,1424,1649,3073,4004
0130-001,2011,4,2,21,1229,1064,2293,3073
0130-001,2011,4,2,22,1116,926,2042,2293
0130-001,2011,4,2,23,790,693,1483,2042
0130-001,2011,4,2,24,565,455,1020,1483
0130-001,2011,4,3,1,426,339,765,1020
0130-001,2011,4,3,2,284,242,526,765
0130-001,2011,4,3,3,259,226,485,526
0130-001,2011,4,3,4,202,167,369,485
0130-001,2011,4,3,5,174,160,334,369
0130-001,2011,4,3,6,227,251,478,334
0130-001,2011,4,3,7,485,447,932,478
0130-001,2011,4,3,8,600,618,1218,932
0130-001,2011,4,3,9,808,893,1701,1218
0130-001,2011,4,3,10,1019,1230,2249,1701
0130-001,2011,4,3,11,1115,1363,2478,2249
0130-001,2011,4,3,12,1041,1285,2326,2478
0130-001,2011,4,3,13,1203,1193,2396,2326
0130-001,2011,4,3,14,1463,1267,2730,2396
0130-001,2011,4,3,15,1883,1644,3527,2730
0130-001,2011,4,3,16,1643,1218,2861,3527
0130-001,2011,4,3,17,1572,1142,2714,2861
0130-001,2011,4,3,18,1625,1228,2853,2714
0130-001,2011,4,3,19,1587,1045,2632,2853
0130-001,2011,4,3,20,1411,1022,2433,2632
0130-001,2011,4,3,21,1454,1211,2665,2433
0130-001,2011,4,3,22,1359,968,2327,2665
0130-001,2011,4,3,23,938,680,1618,2327
0130-001,2011,4,3,24,493,393,886,1618
0130-001,2011,4,4,1,316,294,610,886
0130-001,2011,4,4,2,180,160,340,610
0130-001,2011,4,4,3,143,147,290,340
0130-001,2011,4,4,4,130,114,244,290
0130-001,2011,4,4,5,138,219,357,244
0130-001,2011,4,4,6,279,317,596,357
0130-001,2011,4,4,7,1138,699,1837,596
0130-001,2011,4,4,8,2168,1557,3725,1837
0130-001,2011,4,4,9,2167,2149,4316,3725
0130-001,2011,4,4,10,1663,1632,3295,4316
0130-001,2011,4,4,11,1661,1562,3223,3295
0130-001,2011,4,4,12,1569,1587,3156,3223
0130-001,2011,4,4,13,1389,1377,2766,3156
0130-001,2011,4,4,14,1591,1574,3165,2766
0130-001,2011,4,4,15,1814,1747,3561,3165
0130-001,2011,4,4,16,1403,1489,2892,3561
0130-001,2011,4,4,17,1207,1290,2497,2892
0130-001,2011,4,4,18,1655,2056,3711,2497
0130-001,2011,4,4,19,1686,2133,3819,3711
0130-001,2011,4,4,20,1503,1854,3357,3819
0130-001,2011,4,4,21,1002,1421,2423,3357
0130-001,2011,4,4,22,1175,1240,2415,2423
0130-001,2011,4,4,23,896,783,1679,2415
0130-001,2011,4,4,24,603,589,1192,1679
0130-001,2011,4,5,1,386,280,666,1192
0130-001,2011,4,5,2,253,217,470,666
0130-001,2011,4,5,3,167,165,332,470
0130-001,2011,4,5,4,152,136,288,332
0130-001,2011,4,5,5,163,248,411,288
0130-001,2011,4,5,6,272,321,593,411
0130-001,2011,4,5,7,673,442,1115,593
0130-001,2011,4,5,8,1489,1103,2592,1115
0130-001,2011,4,5,9,1631,1660,3291,2592
0130-001,2011,4,5,10,1682,1705,3387,3291
0130-001,2011,4,5,11,1534,1381,2915,3387
0130-001,2011,4,5,12,1516,1504,3020,2915
0130-001,2011,4,5,13,1418,1403,2821,3020
0130-001,2011,4,5,14,1727,1822,3549,2821
0130-001,2011,4,5,15,1738,1748,3486,3549
0130-001,2011,4,5,16,1718,1828,3546,3486
0130-001,2011,4,5,17,1676,1742,3418,3546
0130-001,2011,4,5,18,1698,2162,3860,3418
0130-001,2011,4,5,19,1775,2126,3901,3860
0130-001,2011,4,5,20,1444,1987,3431,3901
0130-001,2011,4,5,21,1140,1441,2581,3431
0130-001,2011,4,5,22,1074,1124,2198,2581
0130-001,2011,4,5,23,752,642,1394,2198
0130-001,2011,4,5,24,551,478,1029,1394
0130-001,2011,4,6,1,371,328,699,1029
0130-001,2011,4,6,2,226,182,408,699
0130-001,2011,4,6,3,167,158,325,408
0130-001,2011,4,6,4,150,147,297,325
0130-001,2011,4,6,5,174,270,444,297
0130-001,2011,4,6,6,257,295,552,444
0130-001,2011,4,6,7,688,467,1155,552
0130-001,2011,4,6,8,1560,1092,2652,1155
0130-001,2011,4,6,9,1767,1723,3490,2652
0130-001,2011,4,6,10,1669,2041,3710,3490
0130-001,2011,4,6,11,1649,1390,3039,3710
0130-001,2011,4,6,12,1513,1556,3069,3039
0130-001,2011,4,6,13,1435,1479,2914,3069
0130-001,2011,4,6,14,1593,1664,3257,2914
0130-001,2011,4,6,15,1780,1813,3593,3257
0130-001,2011,4,6,16,1804,1848,3652,3593
0130-001,2011,4,6,17,1689,1759,3448,3652
0130-001,2011,4,6,18,1821,2430,4251,3448
0130-001,2011,4,6,19,1742,2333,4075,4251
0130-001,2011,4,6,20,1411,1726,3137,4075
0130-001,2011,4,6,21,1145,1325,2470,3137
0130-001,2011,4,6,22,1218,1149,2367,2470
0130-001,2011,4,6,23,888,842,1730,2367
0130-001,2011,4,6,24,650,580,1230,1730
0130-001,2011,4,7,1,447,367,814,1230
0130-001,2011,4,7,2,283,222,505,814
0130-001,2011,4,7,3,223,179,402,505
0130-001,2011,4,7,4,175,168,343,402
0130-001,2011,4,7,5,159,259,418,343
0130-001,2011,4,7,6,244,290,534,418
0130-001,2011,4,7,7,888,587,1475,534
0130-001,2011,4,7,8,1992,1435,3427,1475
0130-001,2011,4,7,9,1923,1905,3828,3427
0130-001,2011,4,7,10,1605,1646,3251,3828
0130-001,2011,4,7,11,1668,1610,3278,3251
0130-001,2011,4,7,12,1476,1521,2997,3278
0130-001,2011,4,7,13,1360,1342,2702,2997
0130-001,2011,4,7,14,1603,1499,3102,2702
0130-001,2011,4,7,15,1589,1613,3202,3102
0130-001,2011,4,7,16,1574,1661,3235,3202
0130-001,2011,4,7,17,1542,1655,3197,3235
0130-001,2011,4,7,18,1621,1909,3530,3197
0130-001,2011,4,7,19,1647,2208,3855,3530
0130-001,2011,4,7,20,1251,1469,2720,3855
0130-001,2011,4,7,21,1094,1390,2484,2720
0130-001,2011,4,7,22,1165,1197,2362,2484
0130-001,2011,4,7,23,879,819,1698,2362
0130-001,2011,4,7,24,580,499,1079,1698
0130-001,2011,4,8,1,452,402,854,1079
0130-001,2011,4,8,2,246,188,434,854
0130-001,2011,4,8,3,174,174,348,434
0130-001,2011,4,8,4,164,182,346,348
0130-001,2011,4,8,5,163,220,383,346
0130-001,2011,4,8,6,292,359,651,383
0130-001,2011,4,8,7,971,614,1585,651
0130-001,2011,4,8,8,2096,1474,3570,1585
0130-001,2011,4,8,9,2065,2008,4073,3570
0130-001,2011,4,8,10,1755,1623,3378,4073
0130-001,2011,4,8,11,1716,1839,3555,3378
0130-001,2011,4,8,12,1601,1637,3238,3555
0130-001,2011,4,8,13,1431,1543,2974,3238
0130-001,2011,4,8,14,1729,1705,3434,2974
0130-001,2011,4,8,15,1285,1240,2525,3434
0130-001,2011,4,8,16,1448,1562,3010,2525
0130-001,2011,4,8,17,1388,1460,2848,3010
0130-001,2011,4,8,18,1483,1753,3236,2848
0130-001,2011,4,8,19,1460,1764,3224,3236
0130-001,2011,4,8,20,1418,1980,3398,3224
0130-001,2011,4,8,21,1135,1383,2518,3398
0130-001,2011,4,8,22,1126,1122,2248,2518
0130-001,2011,4,8,23,951,789,1740,2248
0130-001,2011,4,8,24,666,516,1182,1740
0130-001,2011,4,9,1,503,417,920,1182
0130-001,2011,4,9,2,347,323,670,920
0130-001,2011,4,9,3,252,209,461,670
0130-001,2011,4,9,4,182,175,357,461
0130-001,2011,4,9,5,190,228,418,357
0130-001,2011,4,9,6,289,322,611,418
0130-001,2011,4,9,7,592,454,1046,611
0130-001,2011,4,9,8,1052,831,1883,1046
0130-001,2011,4,9,9,1616,1621,3237,1883
0130-001,2011,4,9,10,1573,1723,3296,3237
0130-001,2011,4,9,11,1583,1866,3449,3296
0130-001,2011,4,9,12,1386,1513,2899,3449
0130-001,2011,4,9,13,1460,1949,3409,2899
0130-001,2011,4,9,14,1259,1553,2812,3409
0130-001,2011,4,9,15,1131,1371,2502,2812
0130-001,2011,4,9,16,1635,1775,3410,2502
0130-001,2011,4,9,17,1386,1415,2801,3410
0130-001,2011,4,9,18,1908,2056,3964,2801
0130-001,2011,4,9,19,1814,1822,3636,3964
0130-001,2011,4,9,20,1512,1571,3083,3636
0130-001,2011,4,9,21,1262,1201,2463,3083
0130-001,2011,4,9,22,1184,935,2119,2463
0130-001,2011,4,9,23,901,718,1619,2119
0130-001,2011,4,9,24,647,483,1130,1619
0130-001,2011,4,10,1,442,367,809,1130
0130-001,2011,4,10,2,292,269,561,809
0130-001,2011,4,10,3,229,176,405,561
0130-001,2011,4,10,4,213,177,390,405
0130-001,2011,4,10,5,221,249,470,390
0130-001,2011,4,10,6,235,272,507,470
0130-001,2011,4,10,7,533,495,1028,507
0130-001,2011,4,10,8,687,690,1377,1028
0130-001,2011,4,10,9,826,1071,1897,1377
0130-001,2011,4,10,10,953,1080,2033,1897
0130-001,2011,4,10,11,1091,1320,2411,2033
0130-001,2011,4,10,12,1051,1271,2322,2411
0130-001,2011,4,10,13,1212,1133,2345,2322
0130-001,2011,4,10,14,1747,1469,3216,2345
0130-001,2011,4,10,15,1782,1392,3174,3216
0130-001,2011,4,10,16,1760,1456,3216,3174
0130-001,2011,4,10,17,1941,1554,3495,3216
0130-001,2011,4,10,18,1560,1194,2754,3495
0130-001,2011,4,10,19,1559,947,2506,2754
0130-001,2011,4,10,20,1396,1094,2490,2506
0130-001,2011,4,10,21,1274,1010,2284,2490
0130-001,2011,4,10,22,1094,739,1833,2284
0130-001,2011,4,10,23,1185,864,2049,1833
0130-001,2011,4,10,24,922,690,1612,2049
0130-001,2011,4,11,1,314,241,555,1612
0130-001,2011,4,11,2,190,147,337,555
0130-001,2011,4,11,3,122,134,256,337
0130-001,2011,4,11,4,118,111,229,256
0130-001,2011,4,11,5,136,185,321,229
0130-001,2011,4,11,6,328,340,668,321
0130-001,2011,4,11,7,1163,737,1900,668
0130-001,2011,4,11,8,2094,1432,3526,1900
0130-001,2011,4,11,9,2079,2037,4116,3526
0130-001,2011,4,11,10,1708,1763,3471,4116
0130-001,2011,4,11,11,1682,1587,3269,3471
0130-001,2011,4,11,12,1594,1550,3144,3269
0130-001,2011,4,11,13,1430,1438,2868,3144
0130-001,2011,4,11,14,1769,1756,3525,2868
0130-001,2011,4,11,15,1598,1636,3234,3525
0130-001,2011,4,11,16,1664,1719,3383,3234
0130-001,2011,4,11,17,1733,1799,3532,3383
0130-001,2011,4,11,18,1752,2155,3907,3532
0130-001,2011,4,11,19,1818,2327,4145,3907
0130-001,2011,4,11,20,1467,1878,3345,4145
0130-001,2011,4,11,21,1201,1525,2726,3345
0130-001,2011,4,11,22,1190,1342,2532,2726
0130-001,2011,4,11,23,895,828,1723,2532
0130-001,2011,4,11,24,536,486,1022,1723
0130-001,2011,4,12,1,377,330,707,1022
0130-001,2011,4,12,2,236,192,428,707
0130-001,2011,4,12,3,168,154,322,428
0130-001,2011,4,12,4,154,141,295,322
0130-001,2011,4,12,5,148,215,363,295
0130-001,2011,4,12,6,296,344,640,363
0130-001,2011,4,12,7,679,491,1170,640
0130-001,2011,4,12,8,1449,1044,2493,1170
0130-001,2011,4,12,9,1838,1742,3580,2493
0130-001,2011,4,12,10,1746,1674,3420,3580
0130-001,2011,4,12,11,1705,1630,3335,3420
0130-001,2011,4,12,12,1536,1472,3008,3335
0130-001,2011,4,12,13,1373,1391,2764,3008
0130-001,2011,4,12,14,1718,1682,3400,2764
0130-001,2011,4,12,15,1712,1829,3541,3400
0130-001,2011,4,12,16,1657,1682,3339,3541
0130-001,2011,4,12,17,1651,1783,3434,3339
0130-001,2011,4,12,18,1702,2067,3769,3434
0130-001,2011,4,12,19,1798,2294,4092,3769
0130-001,2011,4,12,20,1281,1576,2857,4092
0130-001,2011,4,12,21,1223,1518,2741,2857
0130-001,2011,4,12,22,1227,1292,2519,2741
0130-001,2011,4,12,23,934,795,1729,2519
0130-001,2011,4,12,24,618,483,1101,1729
0130-001,2011,4,13,1,413,336,749,1101
0130-001,2011,4,13,2,256,244,500,749
0130-001,2011,4,13,3,187,184,371,500
0130-001,2011,4,13,4,177,184,361,371
0130-001,2011,4,13,5,177,287,464,361
0130-001,2011,4,13,6,302,304,606,464
0130-001,2011,4,13,7,1010,716,1726,606
0130-001,2011,4,13,8,1993,1444,3437,1726
0130-001,2011,4,13,9,1880,1802,3682,3437
0130-001,2011,4,13,10,1707,1812,3519,3682
0130-001,2011,4,13,11,1715,1726,3441,3519
0130-001,2011,4,13,12,1543,1477,3020,3441
0130-001,2011,4,13,13,1347,1442,2789,3020
0130-001,2011,4,13,14,1445,1411,2856,2789
0130-001,2011,4,13,15,1335,1376,2711,2856
0130-001,2011,4,13,16,1464,1490,2954,2711
0130-001,2011,4,13,17,1478,1611,3089,2954
0130-001,2011,4,13,18,1770,2339,4109,3089
0130-001,2011,4,13,19,1841,2547,4388,4109
0130-001,2011,4,13,20,1498,1780,3278,4388
0130-001,2011,4,13,21,1224,1332,2556,3278
0130-001,2011,4,13,22,1271,1250,2521,2556
0130-001,2011,4,13,23,968,815,1783,2521
0130-001,2011,4,13,24,605,519,1124,1783
0130-001,2011,4,14,1,444,379,823,1124
0130-001,2011,4,14,2,283,239,522,823
0130-001,2011,4,14,3,184,165,349,522
0130-001,2011,4,14,4,164,177,341,349
0130-001,2011,4,14,5,171,279,450,341
0130-001,2011,4,14,6,277,351,628,450
0130-001,2011,4,14,7,1032,759,1791,628
0130-001,2011,4,14,8,2137,1648,3785,1791
0130-001,2011,4,14,9,1901,1688,3589,3785
0130-001,2011,4,14,10,1673,1739,3412,3589
0130-001,2011,4,14,11,1633,1536,3169,3412
0130-001,2011,4,14,12,1456,1524,2980,3169
0130-001,2011,4,14,13,1248,1304,2552,2980
0130-001,2011,4,14,14,1565,1622,3187,2552
0130-001,2011,4,14,15,1462,1507,2969,3187
0130-001,2011,4,14,16,1528,1468,2996,2969
0130-001,2011,4,14,17,1582,1656,3238,2996
0130-001,2011,4,14,18,1698,2236,3934,3238
0130-001,2011,4,14,19,1759,2243,4002,3934
0130-001,2011,4,14,20,1425,1833,3258,4002
0130-001,2011,4,14,21,1194,1448,2642,3258
0130-001,2011,4,14,22,1268,1351,2619,2642
0130-001,2011,4,14,23,1020,843,1863,2619
0130-001,2011,4,14,24,633,517,1150,1863
0130-001,2011,4,15,1,420,341,761,1150
0130-001,2011,4,15,2,227,183,410,761
0130-001,2011,4,15,3,195,173,368,410
0130-001,2011,4,15,4,142,131,273,368
0130-001,2011,4,15,5,173,271,444,273
0130-001,2011,4,15,6,311,342,653,444
0130-001,2011,4,15,7,1050,736,1786,653
0130-001,2011,4,15,8,2110,1532,3642,1786
0130-001,2011,4,15,9,2001,1876,3877,3642
0130-001,2011,4,15,10,1603,1604,3207,3877
0130-001,2011,4,15,11,1704,1680,3384,3207
0130-001,2011,4,15,12,1616,1668,3284,3384
0130-001,2011,4,15,13,1337,1406,2743,3284
0130-001,2011,4,15,14,1404,1496,2900,2743
0130-001,2011,4,15,15,1158,1141,2299,2900
0130-001,2011,4,15,16,1269,1283,2552,2299
0130-001,2011,4,15,17,1274,1400,2674,2552
0130-001,2011,4,15,18,1834,2197,4031,2674
0130-001,2011,4,15,19,1943,2292,4235,4031
0130-001,2011,4,15,20,1534,2075,3609,4235
0130-001,2011,4,15,21,1303,1590,2893,3609
0130-001,2011,4,15,22,1273,1325,2598,2893
0130-001,2011,4,15,23,1021,790,1811,2598
0130-001,2011,4,15,24,744,601,1345,1811
0130-001,2011,4,16,1,499,394,893,1345
0130-001,2011,4,16,2,348,277,625,893
0130-001,2011,4,16,3,292,270,562,625
0130-001,2011,4,16,4,226,205,431,562
0130-001,2011,4,16,5,222,260,482,431
0130-001,2011,4,16,6,345,377,722,482
0130-001,2011,4,16,7,809,640,1449,722
0130-001,2011,4,16,8,1646,1529,3175,1449
0130-001,2011,4,16,9,1803,1826,3629,3175
0130-001,2011,4,16,10,1650,1829,3479,3629
0130-001,2011,4,16,11,1573,1904,3477,3479
0130-001,2011,4,16,12,1574,1983,3557,3477
0130-001,2011,4,16,13,1575,1975,3550,3557
0130-001,2011,4,16,14,1173,1444,2617,3550
0130-001,2011,4,16,15,1167,1395,2562,2617
0130-001,2011,4,16,16,1393,1630,3023,2562
0130-001,2011,4,16,17,1755,1850,3605,3023
0130-001,2011,4,16,18,1949,1985,3934,3605
0130-001,2011,4,16,19,1982,1978,3960,3934
0130-001,2011,4,16,20,1503,1541,3044,3960
0130-001,2011,4,16,21,1267,1089,2356,3044
0130-001,2011,4,16,22,1190,950,2140,2356
0130-001,2011,4,16,23,919,716,1635,2140
0130-001,2011,4,16,24,620,494,1114,1635
0130-001,2011,4,17,1,413,348,761,1114
0130-001,2011,4,17,2,341,270,611,761
0130-001,2011,4,17,3,247,235,482,611
0130-001,2011,4,17,4,209,170,379,482
0130-001,2011,4,17,5,184,183,367,379
0130-001,2011,4,17,6,250,303,553,367
0130-001,2011,4,17,7,578,492,1070,553
0130-001,2011,4,17,8,744,673,1417,1070
0130-001,2011,4,17,9,987,1269,2256,1417
0130-001,2011,4,17,10,1121,1243,2364,2256
0130-001,2011,4,17,11,1220,1608,2828,2364
0130-001,2011,4,17,12,1114,1386,2500,2828
0130-001,2011,4,17,13,1114,1193,2307,2500
0130-001,2011,4,17,14,1345,1233,2578,2307
0130-001,2011,4,17,15,1255,1034,2289,2578
0130-001,2011,4,17,16,1270,1005,2275,2289
0130-001,2011,4,17,17,1392,1140,2532,2275
0130-001,2011,4,17,18,1300,967,2267,2532
0130-001,2011,4,17,19,1367,952,2319,2267
0130-001,2011,4,17,20,1127,850,1977,2319
0130-001,2011,4,17,21,1211,938,2149,1977
0130-001,2011,4,17,22,970,687,1657,2149
0130-001,2011,4,17,23,741,558,1299,1657
0130-001,2011,4,17,24,434,340,774,1299
0130-001,2011,4,18,1,264,197,461,774
0130-001,2011,4,18,2,176,166,342,461
0130-001,2011,4,18,3,128,119,247,342
0130-001,2011,4,18,4,93,98,191,247
0130-001,2011,4,18,5,139,208,347,191
0130-001,2011,4,18,6,290,341,631,347
0130-001,2011,4,18,7,1044,684,1728,631
0130-001,2011,4,18,8,1996,1413,3409,1728
0130-001,2011,4,18,9,1852,1804,3656,3409
0130-001,2011,4,18,10,1568,1626,3194,3656
0130-001,2011,4,18,11,1631,1597,3228,3194
0130-001,2011,4,18,12,1575,1663,3238,3228
0130-001,2011,4,18,13,1416,1322,2738,3238
0130-001,2011,4,18,14,1642,1655,3297,2738
0130-001,2011,4,18,15,1741,1718,3459,3297
0130-001,2011,4,18,16,1706,1806,3512,3459
0130-001,2011,4,18,17,1614,1752,3366,3512
0130-001,2011,4,18,18,1650,2183,3833,3366
0130-001,2011,4,18,19,1760,2236,3996,3833
0130-001,2011,4,18,20,1417,1733,3150,3996
0130-001,2011,4,18,21,1145,1431,2576,3150
0130-001,2011,4,18,22,1147,1258,2405,2576
0130-001,2011,4,18,23,865,665,1530,2405
0130-001,2011,4,18,24,570,429,999,1530
0130-001,2011,4,19,1,402,342,744,999
0130-001,2011,4,19,2,203,176,379,744
0130-001,2011,4,19,3,184,164,348,379
0130-001,2011,4,19,4,134,132,266,348
0130-001,2011,4,19,5,186,251,437,266
0130-001,2011,4,19,6,324,363,687,437
0130-001,2011,4,19,7,1066,692,1758,687
0130-001,2011,4,19,8,1983,1387,3370,1758
0130-001,2011,4,19,9,1970,1815,3785,3370
0130-001,2011,4,19,10,1699,1717,3416,3785
0130-001,2011,4,19,11,1654,1554,3208,3416
0130-001,2011,4,19,12,1489,1457,2946,3208
0130-001,2011,4,19,13,1411,1394,2805,2946
0130-001,2011,4,19,14,1607,1646,3253,2805
0130-001,2011,4,19,15,1720,1724,3444,3253
0130-001,2011,4,19,16,1648,1656,3304,3444
0130-001,2011,4,19,17,1587,1705,3292,3304
0130-001,2011,4,19,18,1758,2237,3995,3292
0130-001,2011,4,19,19,1670,2389,4059,3995
0130-001,2011,4,19,20,1368,1773,3141,4059
0130-001,2011,4,19,21,1246,1485,2731,3141
0130-001,2011,4,19,22,1181,1199,2380,2731
0130-001,2011,4,19,23,1019,839,1858,2380
0130-001,2011,4,19,24,639,499,1138,1858
0130-001,2011,4,20,1,399,327,726,1138
0130-001,2011,4,20,2,258,205,463,726
0130-001,2011,4,20,3,169,156,325,463
0130-001,2011,4,20,4,155,145,300,325
0130-001,2011,4,20,5,175,258,433,300
0130-001,2011,4,20,6,360,455,815,433
0130-001,2011,4,20,7,1055,786,1841,815
0130-001,2011,4,20,8,2151,1588,3739,1841
0130-001,2011,4,20,9,2028,1895,3923,3739
0130-001,2011,4,20,10,1710,1653,3363,3923
0130-001,2011,4,20,11,1702,1644,3346,3363
0130-001,2011,4,20,12,1567,1540,3107,3346
0130-001,2011,4,20,13,1335,1429,2764,3107
0130-001,2011,4,20,14,1653,1752,3405,2764
0130-001,2011,4,20,15,1725,1763,3488,3405
0130-001,2011,4,20,16,1759,1639,3398,3488
0130-001,2011,4,20,17,1618,1678,3296,3398
0130-001,2011,4,20,18,1771,2295,4066,3296
0130-001,2011,4,20,19,1825,2452,4277,4066
0130-001,2011,4,20,20,1410,1754,3164,4277
0130-001,2011,4,20,21,1220,1380,2600,3164
0130-001,2011,4,20,22,1195,1052,2247,2600
0130-001,2011,4,20,23,971,804,1775,2247
0130-001,2011,4,20,24,658,518,1176,1775
0130-001,2011,4,21,1,437,432,869,1176
0130-001,2011,4,21,2,273,229,502,869
0130-001,2011,4,21,3,203,204,407,502
0130-001,2011,4,21,4,153,187,340,407
0130-001,2011,4,21,5,208,315,523,340
0130-001,2011,4,21,6,343,407,750,523
0130-001,2011,4,21,7,1039,743,1782,750
0130-001,2011,4,21,8,2058,1474,3532,1782
0130-001,2011,4,21,9,2020,1830,3850,3532
0130-001,2011,4,21,10,1719,1696,3415,3850
0130-001,2011,4,21,11,1647,1668,3315,3415
0130-001,2011,4,21,12,1666,1596,3262,3315
0130-001,2011,4,21,13,1368,1440,2808,3262
0130-001,2011,4,21,14,1579,1633,3212,2808
0130-001,2011,4,21,15,1723,1772,3495,3212
0130-001,2011,4,21,16,1761,1725,3486,3495
0130-001,2011,4,21,17,1622,1759,3381,3486
0130-001,2011,4,21,18,1693,1824,3517,3381
0130-001,2011,4,21,19,1719,1673,3392,3517
0130-001,2011,4,21,20,1416,1791,3207,3392
0130-001,2011,4,21,21,1211,1563,2774,3207
0130-001,2011,4,21,22,1190,1301,2491,2774
0130-001,2011,4,21,23,952,921,1873,2491
0130-001,2011,4,21,24,660,505,1165,1873
0130-001,2011,4,22,1,465,370,835,1165
0130-001,2011,4,22,2,293,239,532,835
0130-001,2011,4,22,3,182,163,345,532
0130-001,2011,4,22,4,169,170,339,345
0130-001,2011,4,22,5,209,297,506,339
0130-001,2011,4,22,6,292,307,599,506
0130-001,2011,4,22,7,842,624,1466,599
0130-001,2011,4,22,8,2129,1467,3596,1466
0130-001,2011,4,22,9,2033,1942,3975,3596
0130-001,2011,4,22,10,1609,1723,3332,3975
0130-001,2011,4,22,11,1582,1529,3111,3332
0130-001,2011,4,22,12,1467,1491,2958,3111
0130-001,2011,4,22,13,1318,1481,2799,2958
0130-001,2011,4,22,14,1563,1640,3203,2799
0130-001,2011,4,22,15,1701,1785,3486,3203
0130-001,2011,4,22,16,1586,1697,3283,3486
0130-001,2011,4,22,17,1541,1583,3124,3283
0130-001,2011,4,22,18,1779,2180,3959,3124
0130-001,2011,4,22,19,1915,2352,4267,3959
0130-001,2011,4,22,20,1420,1870,3290,4267
0130-001,2011,4,22,21,1168,1467,2635,3290
0130-001,2011,4,22,22,1170,1111,2281,2635
0130-001,2011,4,22,23,864,622,1486,2281
0130-001,2011,4,22,24,711,516,1227,1486
0130-001,2011,4,23,1,522,403,925,1227
0130-001,2011,4,23,2,331,267,598,925
0130-001,2011,4,23,3,266,262,528,598
0130-001,2011,4,23,4,206,194,400,528
0130-001,2011,4,23,5,221,254,475,400
0130-001,2011,4,23,6,317,333,650,475
0130-001,2011,4,23,7,772,681,1453,650
0130-001,2011,4,23,8,1393,1081,2474,1453
0130-001,2011,4,23,9,1502,1366,2868,2474
0130-001,2011,4,23,10,1610,1690,3300,2868
0130-001,2011,4,23,11,1487,1686,3173,3300
0130-001,2011,4,23,12,1757,2192,3949,3173
0130-001,2011,4,23,13,1587,2312,3899,3949
0130-001,2011,4,23,14,1667,1970,3637,3899
0130-001,2011,4,23,15,1643,1788,3431,3637
0130-001,2011,4,23,16,1856,2062,3918,3431
0130-001,2011,4,23,17,1788,1690,3478,3918
0130-001,2011,4,23,18,1956,1821,3777,3478
0130-001,2011,4,23,19,1768,1920,3688,3777
0130-001,2011,4,23,20,1395,1251,2646,3688
0130-001,2011,4,23,21,1315,1157,2472,2646
0130-001,2011,4,23,22,1064,876,1940,2472
0130-001,2011,4,23,23,897,659,1556,1940
0130-001,2011,4,23,24,587,473,1060,1556
0130-001,2011,4,24,1,410,345,755,1060
0130-001,2011,4,24,2,280,255,535,755
0130-001,2011,4,24,3,221,188,409,535
0130-001,2011,4,24,4,174,118,292,409
0130-001,2011,4,24,5,189,212,401,292
0130-001,2011,4,24,6,279,329,608,401
0130-001,2011,4,24,7,605,465,1070,608
0130-001,2011,4,24,8,744,665,1409,1070
0130-001,2011,4,24,9,906,1079,1985,1409
0130-001,2011,4,24,10,984,1072,2056,1985
0130-001,2011,4,24,11,1102,1378,2480,2056
0130-001,2011,4,24,12,1134,1405,2539,2480
0130-001,2011,4,24,13,1091,1300,2391,2539
0130-001,2011,4,24,14,1432,1520,2952,2391
0130-001,2011,4,24,15,1816,1976,3792,2952
0130-001,2011,4,24,16,1666,1487,3153,3792
0130-001,2011,4,24,17,1530,1293,2823,3153
0130-001,2011,4,24,18,1567,1524,3091,2823
0130-001,2011,4,24,19,1590,1430,3020,3091
0130-001,2011,4,24,20,1708,1439,3147,3020
0130-001,2011,4,24,21,1454,1152,2606,3147
0130-001,2011,4,24,22,1141,789,1930,2606
0130-001,2011,4,24,23,818,613,1431,1930
0130-001,2011,4,24,24,536,352,888,1431
0130-001,2011,4,25,1,299,212,511,888
0130-001,2011,4,25,2,164,131,295,511
0130-001,2011,4,25,3,144,125,269,295
0130-001,2011,4,25,4,125,101,226,269
0130-001,2011,4,25,5,152,210,362,226
0130-001,2011,4,25,6,351,397,748,362
0130-001,2011,4,25,7,1233,841,2074,748
0130-001,2011,4,25,8,2113,1398,3511,2074
0130-001,2011,4,25,9,2096,1931,4027,3511
0130-001,2011,4,25,10,1801,1858,3659,4027
0130-001,2011,4,25,11,1652,1606,3258,3659
0130-001,2011,4,25,12,1557,1551,3108,3258
0130-001,2011,4,25,13,1355,1438,2793,3108
0130-001,2011,4,25,14,1637,1548,3185,2793
0130-001,2011,4,25,15,1707,1633,3340,3185
0130-001,2011,4,25,16,1778,1738,3516,3340
0130-001,2011,4,25,17,1684,1785,3469,3516
0130-001,2011,4,25,18,1789,2190,3979,3469
0130-001,2011,4,25,19,1863,2445,4308,3979
0130-001,2011,4,25,20,1434,1779,3213,4308
0130-001,2011,4,25,21,1189,1596,2785,3213
0130-001,2011,4,25,22,1192,1241,2433,2785
0130-001,2011,4,25,23,822,679,1501,2433
0130-001,2011,4,25,24,550,397,947,1501
0130-001,2011,4,26,1,377,343,720,947
0130-001,2011,4,26,2,262,235,497,720
0130-001,2011,4,26,3,171,159,330,497
0130-001,2011,4,26,4,151,160,311,330
0130-001,2011,4,26,5,151,185,336,311
0130-001,2011,4,26,6,275,317,592,336
0130-001,2011,4,26,7,985,645,1630,592
0130-001,2011,4,26,8,2000,1365,3365,1630
0130-001,2011,4,26,9,2064,1896,3960,3365
0130-001,2011,4,26,10,1690,1718,3408,3960
0130-001,2011,4,26,11,1619,1586,3205,3408
0130-001,2011,4,26,12,1509,1559,3068,3205
0130-001,2011,4,26,13,1330,1400,2730,3068
0130-001,2011,4,26,14,1580,1452,3032,2730
0130-001,2011,4,26,15,1630,1702,3332,3032
0130-001,2011,4,26,16,1711,1646,3357,3332
0130-001,2011,4,26,17,1503,1579,3082,3357
0130-001,2011,4,26,18,1597,1954,3551,3082
0130-001,2011,4,26,19,1631,2370,4001,3551
0130-001,2011,4,26,20,1390,1688,3078,4001
0130-001,2011,4,26,21,1140,1336,2476,3078
0130-001,2011,4,26,22,1141,1227,2368,2476
0130-001,2011,4,26,23,827,662,1489,2368
0130-001,2011,4,26,24,559,417,976,1489
0130-001,2011,4,27,1,414,361,775,976
0130-001,2011,4,27,2,234,204,438,775
0130-001,2011,4,27,3,195,169,364,438
0130-001,2011,4,27,4,154,142,296,364
0130-001,2011,4,27,5,183,236,419,296
0130-001,2011,4,27,6,292,339,631,419
0130-001,2011,4,27,7,1005,634,1639,631
0130-001,2011,4,27,8,1984,1363,3347,1639
0130-001,2011,4,27,9,1955,1813,3768,3347
0130-001,2011,4,27,10,1762,1877,3639,3768
0130-001,2011,4,27,11,1697,1603,3300,3639
0130-001,2011,4,27,12,1616,1631,3247,3300
0130-001,2011,4,27,13,1324,1403,2727,3247
0130-001,2011,4,27,14,1664,1641,3305,2727
0130-001,2011,4,27,15,1609,1578,3187,3305
0130-001,2011,4,27,16,1776,1783,3559,3187
0130-001,2011,4,27,17,1678,1767,3445,3559
0130-001,2011,4,27,18,1707,2196,3903,3445
0130-001,2011,4,27,19,1752,2210,3962,3903
0130-001,2011,4,27,20,1473,1896,3369,3962
0130-001,2011,4,27,21,1278,1477,2755,3369
0130-001,2011,4,27,22,1178,1108,2286,2755
0130-001,2011,4,27,23,934,704,1638,2286
0130-001,2011,4,27,24,630,509,1139,1638
0130-001,2011,4,28,1,437,332,769,1139
0130-001,2011,4,28,2,315,250,565,769
0130-001,2011,4,28,3,180,169,349,565
0130-001,2011,4,28,4,173,197,370,349
0130-001,2011,4,28,5,188,255,443,370
0130-001,2011,4,28,6,317,371,688,443
0130-001,2011,4,28,7,1020,694,1714,688
0130-001,2011,4,28,8,2230,1513,3743,1714
0130-001,2011,4,28,9,2081,1931,4012,3743
0130-001,2011,4,28,10,1880,1926,3806,4012
0130-001,2011,4,28,11,1744,1692,3436,3806
0130-001,2011,4,28,12,1519,1664,3183,3436
0130-001,2011,4,28,13,1360,1393,2753,3183
0130-001,2011,4,28,14,1628,1580,3208,2753
0130-001,2011,4,28,15,1704,1732,3436,3208
0130-001,2011,4,28,16,1654,1585,3239,3436
0130-001,2011,4,28,17,1638,1730,3368,3239
0130-001,2011,4,28,18,1773,2251,4024,3368
0130-001,2011,4,28,19,1762,2653,4415,4024
0130-001,2011,4,28,20,1415,1775,3190,4415
0130-001,2011,4,28,21,1259,1347,2606,3190
0130-001,2011,4,28,22,1262,1247,2509,2606
0130-001,2011,4,28,23,953,773,1726,2509
0130-001,2011,4,28,24,634,514,1148,1726
0130-001,2011,4,29,1,446,383,829,1148
0130-001,2011,4,29,2,284,241,525,829
0130-001,2011,4,29,3,193,177,370,525
0130-001,2011,4,29,4,171,164,335,370
0130-001,2011,4,29,5,184,227,411,335
0130-001,2011,4,29,6,356,427,783,411
0130-001,2011,4,29,7,1102,781,1883,783
0130-001,2011,4,29,8,2009,1252,3261,1883
0130-001,2011,4,29,9,2161,2159,4320,3261
0130-001,2011,4,29,10,1819,1814,3633,4320
0130-001,2011,4,29,11,1677,1659,3336,3633
0130-001,2011,4,29,12,1634,1737,3371,3336
0130-001,2011,4,29,13,1384,1498,2882,3371
0130-001,2011,4,29,14,1713,1897,3610,2882
0130-001,2011,4,29,15,1760,1920,3680,3610
0130-001,2011,4,29,16,1783,1936,3719,3680
0130-001,2011,4,29,17,1743,2095,3838,3719
0130-001,2011,4,29,18,1824,2282,4106,3838
0130-001,2011,4,29,19,1898,2302,4200,4106
0130-001,2011,4,29,20,1581,1807,3388,4200
0130-001,2011,4,29,21,1336,1363,2699,3388
0130-001,2011,4,29,22,1255,1234,2489,2699
0130-001,2011,4,29,23,939,731,1670,2489
0130-001,2011,4,29,24,787,633,1420,1670
0130-001,2011,4,30,1,522,441,963,1420
0130-001,2011,4,30,2,359,313,672,963
0130-001,2011,4,30,3,273,238,511,672
0130-001,2011,4,30,4,213,200,413,511
0130-001,2011,4,30,5,235,261,496,413
0130-001,2011,4,30,6,237,289,526,496
0130-001,2011,4,30,7,575,471,1046,526
0130-001,2011,4,30,8,1467,1308,2775,1046
0130-001,2011,4,30,9,1790,1867,3657,2775
0130-001,2011,4,30,10,1425,1608,3033,3657
0130-001,2011,4,30,11,1413,1569,2982,3033
0130-001,2011,4,30,12,1576,1872,3448,2982
0130-001,2011,4,30,13,1646,1999,3645,3448
0130-001,2011,4,30,14,1551,1926,3477,3645
0130-001,2011,4,30,15,1677,1994,3671,3477
0130-001,2011,4,30,16,1756,2008,3764,3671
0130-001,2011,4,30,17,1654,1575,3229,3764
0130-001,2011,4,30,18,1876,1711,3587,3229
0130-001,2011,4,30,19,1673,1771,3444,3587
0130-001,2011,4,30,20,1201,1091,2292,3444
0130-001,2011,4,30,21,1063,896,1959,2292
0130-001,2011,4,30,22,919,808,1727,1959
0130-001,2011,4,30,23,686,608,1294,1727
0130-001,2011,4,30,24,522,405,927,1294
0130-001,2011,5,1,1,375,316,691,927
0130-001,2011,5,1,2,285,260,545,691
0130-001,2011,5,1,3,199,170,369,545
0130-001,2011,5,1,4,182,124,306,369
0130-001,2011,5,1,5,176,198,374,306
0130-001,2011,5,1,6,244,288,532,374
0130-001,2011,5,1,7,493,379,872,532
0130-001,2011,5,1,8,665,595,1260,872
0130-001,2011,5,1,9,868,1034,1902,1260
0130-001,2011,5,1,10,980,1068,2048,1902
0130-001,2011,5,1,11,1149,1437,2586,2048
0130-001,2011,5,1,12,1151,1427,2578,2586
0130-001,2011,5,1,13,1133,1351,2484,2578
0130-001,2011,5,1,14,1424,1512,2936,2484
0130-001,2011,5,1,15,1368,1489,2857,2936
0130-001,2011,5,1,16,1629,1454,3083,2857
0130-001,2011,5,1,17,1933,1634,3567,3083
0130-001,2011,5,1,18,1949,1896,3845,3567
0130-001,2011,5,1,19,1980,1781,3761,3845
0130-001,2011,5,1,20,1615,1361,2976,3761
0130-001,2011,5,1,21,1277,1012,2289,2976
0130-001,2011,5,1,22,1116,772,1888,2289
0130-001,2011,5,1,23,772,579,1351,1888
0130-001,2011,5,1,24,545,358,903,1351
0130-001,2011,5,2,1,329,234,563,903
0130-001,2011,5,2,2,217,174,391,563
0130-001,2011,5,2,3,148,129,277,391
0130-001,2011,5,2,4,132,107,239,277
0130-001,2011,5,2,5,148,205,353,239
0130-001,2011,5,2,6,366,414,780,353
0130-001,2011,5,2,7,1215,829,2044,780
0130-001,2011,5,2,8,2296,1520,3816,2044
0130-001,2011,5,2,9,2090,1926,4016,3816
0130-001,2011,5,2,10,1662,1715,3377,4016
0130-001,2011,5,2,11,1702,1655,3357,3377
0130-001,2011,5,2,12,1576,1570,3146,3357
0130-001,2011,5,2,13,1423,1511,2934,3146
0130-001,2011,5,2,14,1746,1652,3398,2934
0130-001,2011,5,2,15,1710,1636,3346,3398
0130-001,2011,5,2,16,1726,1688,3414,3346
0130-001,2011,5,2,17,1696,1798,3494,3414
0130-001,2011,5,2,18,1756,2150,3906,3494
0130-001,2011,5,2,19,1670,2192,3862,3906
0130-001,2011,5,2,20,1195,1483,2678,3862
0130-001,2011,5,2,21,943,1266,2209,2678
0130-001,2011,5,2,22,924,962,1886,2209
0130-001,2011,5,2,23,704,582,1286,1886
0130-001,2011,5,2,24,544,393,937,1286
0130-001,2011,5,3,1,410,374,784,937
0130-001,2011,5,3,2,199,179,378,784
0130-001,2011,5,3,3,183,171,354,378
0130-001,2011,5,3,4,156,166,322,354
0130-001,2011,5,3,5,169,208,377,322
0130-001,2011,5,3,6,307,354,661,377
0130-001,2011,5,3,7,1039,681,1720,661
0130-001,2011,5,3,8,2081,1421,3502,1720
0130-001,2011,5,3,9,2063,1896,3959,3502
0130-001,2011,5,3,10,1594,1621,3215,3959
0130-001,2011,5,3,11,1778,1742,3520,3215
0130-001,2011,5,3,12,1475,1524,2999,3520
0130-001,2011,5,3,13,1304,1373,2677,2999
0130-001,2011,5,3,14,1319,1213,2532,2677
0130-001,2011,5,3,15,1453,1518,2971,2532
0130-001,2011,5,3,16,1224,1178,2402,2971
0130-001,2011,5,3,17,1362,1431,2793,2402
0130-001,2011,5,3,18,1546,1892,3438,2793
0130-001,2011,5,3,19,1589,2309,3898,3438
0130-001,2011,5,3,20,1283,1559,2842,3898
0130-001,2011,5,3,21,1085,1272,2357,2842
0130-001,2011,5,3,22,1116,1201,2317,2357
0130-001,2011,5,3,23,921,738,1659,2317
0130-001,2011,5,3,24,615,459,1074,1659
0130-001,2011,5,4,1,367,321,688,1074
0130-001,2011,5,4,2,278,243,521,688
0130-001,2011,5,4,3,179,156,335,521
0130-001,2011,5,4,4,178,165,343,335
0130-001,2011,5,4,5,160,207,367,343
0130-001,2011,5,4,6,356,414,770,367
0130-001,2011,5,4,7,944,596,1540,770
0130-001,2011,5,4,8,1795,1234,3029,1540
0130-001,2011,5,4,9,1980,1837,3817,3029
0130-001,2011,5,4,10,1340,1428,2768,3817
0130-001,2011,5,4,11,1583,1496,3079,2768
0130-001,2011,5,4,12,1284,1296,2580,3079
0130-001,2011,5,4,13,1281,1358,2639,2580
0130-001,2011,5,4,14,1681,1658,3339,2639
0130-001,2011,5,4,15,1584,1554,3138,3339
0130-001,2011,5,4,16,1402,1408,2810,3138
0130-001,2011,5,4,17,1396,1471,2867,2810
0130-001,2011,5,4,18,1691,2176,3867,2867
0130-001,2011,5,4,19,1280,1615,2895,3867
0130-001,2011,5,4,20,1612,2075,3687,2895
0130-001,2011,5,4,21,1263,1460,2723,3687
0130-001,2011,5,4,22,1179,1109,2288,2723
0130-001,2011,5,4,23,1038,783,1821,2288
0130-001,2011,5,4,24,731,591,1322,1821
0130-001,2011,5,5,1,530,315,845,1322
0130-001,2011,5,5,2,404,207,611,845
0130-001,2011,5,5,3,286,143,429,611
0130-001,2011,5,5,4,239,160,399,429
0130-001,2011,5,5,5,173,230,403,399
0130-001,2011,5,5,6,343,390,733,403
0130-001,2011,5,5,7,756,620,1376,733
0130-001,2011,5,5,8,1204,806,2010,1376
0130-001,2011,5,5,9,1151,1719,2870,2010
0130-001,2011,5,5,10,1274,2175,3449,2870
0130-001,2011,5,5,11,1311,2085,3396,3449
0130-001,2011,5,5,12,1279,1824,3103,3396
0130-001,2011,5,5,13,1180,1623,2803,3103
0130-001,2011,5,5,14,1354,1358,2712,2803
0130-001,2011,5,5,15,1438,1193,2631,2712
0130-001,2011,5,5,16,1557,1044,2601,2631
0130-001,2011,5,5,17,1636,1126,2762,2601
0130-001,2011,5,5,18,1355,1300,2655,2762
0130-001,2011,5,5,19,1212,1207,2419,2655
0130-001,2011,5,5,20,1103,1416,2519,2419
0130-001,2011,5,5,21,1177,1152,2329,2519
0130-001,2011,5,5,22,960,567,1527,2329
0130-001,2011,5,5,23,841,390,1231,1527
0130-001,2011,5,5,24,509,242,751,1231
0130-001,2011,5,6,1,311,131,442,751
0130-001,2011,5,6,2,187,111,298,442
0130-001,2011,5,6,3,160,85,245,298
0130-001,2011,5,6,4,144,158,302,245
0130-001,2011,5,6,5,152,259,411,302
0130-001,2011,5,6,6,311,428,739,411
0130-001,2011,5,6,7,1034,948,1982,739
0130-001,2011,5,6,8,1949,2138,4087,1982
0130-001,2011,5,6,9,1566,2564,4130,4087
0130-001,2011,5,6,10,1338,2231,3569,4130
0130-001,2011,5,6,11,1489,2094,3583,3569
0130-001,2011,5,6,12,1546,1530,3076,3583
0130-001,2011,5,6,13,1205,1172,2377,3076
0130-001,2011,5,6,14,1724,1242,2966,2377
0130-001,2011,5,6,15,1577,1335,2912,2966
0130-001,2011,5,6,16,1688,2068,3756,2912
0130-001,2011,5,6,17,1870,1701,3571,3756
0130-001,2011,5,6,18,1604,1632,3236,3571
0130-001,2011,5,6,19,1735,1745,3480,3236
0130-001,2011,5,6,20,1285,1387,2672,3480
0130-001,2011,5,6,21,1014,1143,2157,2672
0130-001,2011,5,6,22,1052,986,2038,2157
0130-001,2011,5,6,23,869,608,1477,2038
0130-001,2011,5,6,24,591,361,952,1477
0130-001,2011,5,7,1,476,219,695,952
0130-001,2011,5,7,2,314,158,472,695
0130-001,2011,5,7,3,278,91,369,472
0130-001,2011,5,7,4,212,96,308,369
0130-001,2011,5,7,5,224,111,335,308
0130-001,2011,5,7,6,299,221,520,335
0130-001,2011,5,7,7,699,381,1080,520
0130-001,2011,5,7,8,1388,911,2299,1080
0130-001,2011,5,7,9,1475,1149,2624,2299
0130-001,2011,5,7,10,1472,1364,2836,2624
0130-001,2011,5,7,11,1547,1568,3115,2836
0130-001,2011,5,7,12,1503,1707,3210,3115
0130-001,2011,5,7,13,1635,1707,3342,3210
0130-001,2011,5,7,14,1375,1736,3111,3342
0130-001,2011,5,7,15,1519,1658,3177,3111
0130-001,2011,5,7,16,1500,2001,3501,3177
0130-001,2011,5,7,17,1430,2533,3963,3501
0130-001,2011,5,7,18,1452,2627,4079,3963
0130-001,2011,5,7,19,1295,2361,3656,4079
0130-001,2011,5,7,20,1387,1693,3080,3656
0130-001,2011,5,7,21,1313,1440,2753,3080
0130-001,2011,5,7,22,1022,1478,2500,2753
0130-001,2011,5,7,23,793,1402,2195,2500
0130-001,2011,5,7,24,546,1233,1779,2195
0130-001,2011,5,8,1,371,535,906,1779
0130-001,2011,5,8,2,247,146,393,906
0130-001,2011,5,8,3,186,82,268,393
0130-001,2011,5,8,4,175,91,266,268
0130-001,2011,5,8,5,156,108,264,266
0130-001,2011,5,8,6,203,117,320,264
0130-001,2011,5,8,7,455,251,706,320
0130-001,2011,5,8,8,587,448,1035,706
0130-001,2011,5,8,9,692,629,1321,1035
0130-001,2011,5,8,10,840,806,1646,1321
0130-001,2011,5,8,11,1047,1068,2115,1646
0130-001,2011,5,8,12,1639,1289,2928,2115
0130-001,2011,5,8,13,1585,1277,2862,2928
0130-001,2011,5,8,14,1103,1164,2267,2862
0130-001,2011,5,8,15,1063,1117,2180,2267
0130-001,2011,5,8,16,1207,1178,2385,2180
0130-001,2011,5,8,17,1218,1204,2422,2385
0130-001,2011,5,8,18,1079,1164,2243,2422
0130-001,2011,5,8,19,1152,1059,2211,2243
0130-001,2011,5,8,20,1222,1021,2243,2211
0130-001,2011,5,8,21,852,663,1515,2243
0130-001,2011,5,8,22,831,637,1468,1515
0130-001,2011,5,8,23,1073,367,1440,1468
0130-001,2011,5,8,24,964,248,1212,1440
0130-001,2011,5,9,1,903,152,1055,1212
0130-001,2011,5,9,2,680,73,753,1055
0130-001,2011,5,9,3,171,64,235,753
0130-001,2011,5,9,4,142,64,206,235
0130-001,2011,5,9,5,171,114,285,206
0130-001,2011,5,9,6,327,224,551,285
0130-001,2011,5,9,7,1053,480,1533,551
0130-001,2011,5,9,8,2071,1146,3217,1533
0130-001,2011,5,9,9,1882,1289,3171,3217
0130-001,2011,5,9,10,1669,1187,2856,3171
0130-001,2011,5,9,11,1699,1393,3092,2856
0130-001,2011,5,9,12,1689,1184,2873,3092
0130-001,2011,5,9,13,1556,1082,2638,2873
0130-001,2011,5,9,14,1666,1408,3074,2638
0130-001,2011,5,9,15,1784,1402,3186,3074
0130-001,2011,5,9,16,1748,1425,3173,3186
0130-001,2011,5,9,17,1676,1416,3092,3173
0130-001,2011,5,9,18,1732,1544,3276,3092
0130-001,2011,5,9,19,1857,1705,3562,3276
0130-001,2011,5,9,20,1537,1204,2741,3562
0130-001,2011,5,9,21,1126,972,2098,2741
0130-001,2011,5,9,22,1078,881,1959,2098
0130-001,2011,5,9,23,823,501,1324,1959
0130-001,2011,5,9,24,571,251,822,1324
0130-001,2011,5,10,1,430,253,683,822
0130-001,2011,5,10,2,320,317,637,683
0130-001,2011,5,10,3,267,262,529,637
0130-001,2011,5,10,4,200,239,439,529
0130-001,2011,5,10,5,197,245,442,439
0130-001,2011,5,10,6,253,291,544,442
0130-001,2011,5,10,7,553,565,1118,544
0130-001,2011,5,10,8,1081,960,2041,1118
0130-001,2011,5,10,9,1103,1347,2450,2041
0130-001,2011,5,10,10,1192,1617,2809,2450
0130-001,2011,5,10,11,1163,1611,2774,2809
0130-001,2011,5,10,12,1218,1771,2989,2774
0130-001,2011,5,10,13,1230,1812,3042,2989
0130-001,2011,5,10,14,1462,1881,3343,3042
0130-001,2011,5,10,15,1623,1864,3487,3343
0130-001,2011,5,10,16,1666,1887,3553,3487
0130-001,2011,5,10,17,1381,1687,3068,3553
0130-001,2011,5,10,18,1594,1847,3441,3068
0130-001,2011,5,10,19,1787,1757,3544,3441
0130-001,2011,5,10,20,1207,1373,2580,3544
0130-001,2011,5,10,21,926,1152,2078,2580
0130-001,2011,5,10,22,904,838,1742,2078
0130-001,2011,5,10,23,687,669,1356,1742
0130-001,2011,5,10,24,448,428,876,1356
0130-001,2011,5,11,1,313,306,619,876
0130-001,2011,5,11,2,203,189,392,619
0130-001,2011,5,11,3,134,210,344,392
0130-001,2011,5,11,4,124,126,250,344
0130-001,2011,5,11,5,133,169,302,250
0130-001,2011,5,11,6,255,326,581,302
0130-001,2011,5,11,7,939,826,1765,581
0130-001,2011,5,11,8,1828,2181,4009,1765
0130-001,2011,5,11,9,2192,2457,4649,4009
0130-001,2011,5,11,10,1712,2289,4001,4649
0130-001,2011,5,11,11,1685,2106,3791,4001
0130-001,2011,5,11,12,1597,2068,3665,3791
0130-001,2011,5,11,13,1401,1844,3245,3665
0130-001,2011,5,11,14,1587,2274,3861,3245
0130-001,2011,5,11,15,1760,2335,4095,3861
0130-001,2011,5,11,16,1703,2463,4166,4095
0130-001,2011,5,11,17,1629,2111,3740,4166
0130-001,2011,5,11,18,1636,2486,4122,3740
0130-001,2011,5,11,19,1785,2277,4062,4122
0130-001,2011,5,11,20,1452,1600,3052,4062
0130-001,2011,5,11,21,1162,1931,3093,3052
0130-001,2011,5,11,22,1175,1707,2882,3093
0130-001,2011,5,11,23,904,1027,1931,2882
0130-001,2011,5,11,24,592,579,1171,1931
0130-001,2011,5,12,1,390,230,620,1171
0130-001,2011,5,12,2,307,172,479,620
0130-001,2011,5,12,3,187,99,286,479
0130-001,2011,5,12,4,152,91,243,286
0130-001,2011,5,12,5,194,213,407,243
0130-001,2011,5,12,6,326,419,745,407
0130-001,2011,5,12,7,1020,849,1869,745
0130-001,2011,5,12,8,1978,2111,4089,1869
0130-001,2011,5,12,9,1920,2561,4481,4089
0130-001,2011,5,12,10,1820,2274,4094,4481
0130-001,2011,5,12,11,1632,2155,3787,4094
0130-001,2011,5,12,12,1623,2196,3819,3787
0130-001,2011,5,12,13,1399,1876,3275,3819
0130-001,2011,5,12,14,1669,1983,3652,3275
0130-001,2011,5,12,15,1729,1707,3436,3652
0130-001,2011,5,12,16,1778,1361,3139,3436
0130-001,2011,5,12,17,1729,1416,3145,3139
0130-001,2011,5,12,18,1706,1608,3314,3145
0130-001,2011,5,12,19,1830,1986,3816,3314
0130-001,2011,5,12,20,1481,1605,3086,3816
0130-001,2011,5,12,21,1267,1280,2547,3086
0130-001,2011,5,12,22,1178,1018,2196,2547
0130-001,2011,5,12,23,970,565,1535,2196
0130-001,2011,5,12,24,700,338,1038,1535
0130-001,2011,5,13,1,420,192,612,1038
0130-001,2011,5,13,2,304,181,485,612
0130-001,2011,5,13,3,224,134,358,485
0130-001,2011,5,13,4,172,91,263,358
0130-001,2011,5,13,5,200,117,317,263
0130-001,2011,5,13,6,334,187,521,317
0130-001,2011,5,13,7,1148,463,1611,521
0130-001,2011,5,13,8,1998,1364,3362,1611
0130-001,2011,5,13,9,2092,1515,3607,3362
0130-001,2011,5,13,10,1814,1326,3140,3607
0130-001,2011,5,13,11,1671,1268,2939,3140
0130-001,2011,5,13,12,1624,1277,2901,2939
0130-001,2011,5,13,13,1467,1132,2599,2901
0130-001,2011,5,13,14,1626,1294,2920,2599
0130-001,2011,5,13,15,1834,1416,3250,2920
0130-001,2011,5,13,16,1782,1492,3274,3250
0130-001,2011,5,13,17,1791,1382,3173,3274
0130-001,2011,5,13,18,1910,1696,3606,3173
0130-001,2011,5,13,19,1943,1960,3903,3606
0130-001,2011,5,13,20,1639,1585,3224,3903
0130-001,2011,5,13,21,1363,1178,2541,3224
0130-001,2011,5,13,22,1297,1068,2365,2541
0130-001,2011,5,13,23,1054,692,1746,2365
0130-001,2011,5,13,24,753,416,1169,1746
0130-001,2011,5,14,1,519,323,842,1169
0130-001,2011,5,14,2,382,201,583,842
0130-001,2011,5,14,3,281,146,427,583
0130-001,2011,5,14,4,245,114,359,427
0130-001,2011,5,14,5,238,143,381,359
0130-001,2011,5,14,6,378,242,620,381
0130-001,2011,5,14,7,844,440,1284,620
0130-001,2011,5,14,8,1526,858,2384,1284
0130-001,2011,5,14,9,1530,1268,2798,2384
0130-001,2011,5,14,10,1648,1446,3094,2798
0130-001,2011,5,14,11,1728,1582,3310,3094
0130-001,2011,5,14,12,1633,1736,3369,3310
0130-001,2011,5,14,13,1491,1886,3377,3369
0130-001,2011,5,14,14,1670,1698,3368,3377
0130-001,2011,5,14,15,1725,1483,3208,3368
0130-001,2011,5,14,16,1781,1603,3384,3208
0130-001,2011,5,14,17,1886,1605,3491,3384
0130-001,2011,5,14,18,2012,1623,3635,3491
0130-001,2011,5,14,19,1880,1611,3491,3635
0130-001,2011,5,14,20,1562,1082,2644,3491
0130-001,2011,5,14,21,1307,890,2197,2644
0130-001,2011,5,14,22,1188,736,1924,2197
0130-001,2011,5,14,23,910,480,1390,1924
0130-001,2011,5,14,24,614,361,975,1390
0130-001,2011,5,15,1,463,219,682,975
0130-001,2011,5,15,2,319,169,488,682
0130-001,2011,5,15,3,235,82,317,488
0130-001,2011,5,15,4,211,94,305,317
0130-001,2011,5,15,5,198,96,294,305
0130-001,2011,5,15,6,301,187,488,294
0130-001,2011,5,15,7,550,297,847,488
0130-001,2011,5,15,8,762,460,1222,847
0130-001,2011,5,15,9,861,579,1440,1222
0130-001,2011,5,15,10,1160,829,1989,1440
0130-001,2011,5,15,11,1106,998,2104,1989
0130-001,2011,5,15,12,1064,1222,2286,2104
0130-001,2011,5,15,13,1626,1065,2691,2286
0130-001,2011,5,15,14,1838,1155,2993,2691
0130-001,2011,5,15,15,1873,916,2789,2993
0130-001,2011,5,15,16,1787,1076,2863,2789
0130-001,2011,5,15,17,1444,1255,2699,2863
0130-001,2011,5,15,18,1477,1172,2649,2699
0130-001,2011,5,15,19,1356,995,2351,2649
0130-001,2011,5,15,20,1559,887,2446,2351
0130-001,2011,5,15,21,1566,701,2267,2446
0130-001,2011,5,15,22,1210,620,1830,2267
0130-001,2011,5,15,23,838,367,1205,1830
0130-001,2011,5,15,24,574,248,822,1205
0130-001,2011,5,16,1,345,169,514,822
0130-001,2011,5,16,2,193,91,284,514
0130-001,2011,5,16,3,147,50,197,284
0130-001,2011,5,16,4,124,53,177,197
0130-001,2011,5,16,5,125,94,219,177
0130-001,2011,5,16,6,330,216,546,219
0130-001,2011,5,16,7,1024,562,1586,546
0130-001,2011,5,16,8,1737,1274,3011,1586
0130-001,2011,5,16,9,1791,1524,3315,3011
0130-001,2011,5,16,10,1488,1309,2797,3315
0130-001,2011,5,16,11,1421,1245,2666,2797
0130-001,2011,5,16,12,1266,1210,2476,2666
0130-001,2011,5,16,13,1209,1021,2230,2476
0130-001,2011,5,16,14,1516,1193,2709,2230
0130-001,2011,5,16,15,1459,1387,2846,2709
0130-001,2011,5,16,16,1600,1483,3083,2846
0130-001,2011,5,16,17,1701,1355,3056,3083
0130-001,2011,5,16,18,1723,1597,3320,3056
0130-001,2011,5,16,19,1791,1810,3601,3320
0130-001,2011,5,16,20,1365,1312,2677,3601
0130-001,2011,5,16,21,1115,1216,2331,2677
0130-001,2011,5,16,22,996,913,1909,2331
0130-001,2011,5,16,23,619,594,1213,1909
0130-001,2011,5,16,24,510,285,795,1213
0130-001,2011,5,17,1,384,178,562,795
0130-001,2011,5,17,2,276,134,410,562
0130-001,2011,5,17,3,142,82,224,410
0130-001,2011,5,17,4,180,64,244,224
0130-001,2011,5,17,5,185,117,302,244
0130-001,2011,5,17,6,325,187,512,302
0130-001,2011,5,17,7,792,495,1287,512
0130-001,2011,5,17,8,1603,1193,2796,1287
0130-001,2011,5,17,9,1227,1521,2748,2796
0130-001,2011,5,17,10,1102,1358,2460,2748
0130-001,2011,5,17,11,1018,1248,2266,2460
0130-001,2011,5,17,12,1153,1193,2346,2266
0130-001,2011,5,17,13,1155,1137,2292,2346
0130-001,2011,5,17,14,1606,1233,2839,2292
0130-001,2011,5,17,15,1875,1257,3132,2839
0130-001,2011,5,17,16,1793,1274,3067,3132
0130-001,2011,5,17,17,1908,1434,3342,3067
0130-001,2011,5,17,18,2096,1687,3783,3342
0130-001,2011,5,17,19,2006,1707,3713,3783
0130-001,2011,5,17,20,1396,1309,2705,3713
0130-001,2011,5,17,21,1230,1262,2492,2705
0130-001,2011,5,17,22,1204,977,2181,2492
0130-001,2011,5,17,23,930,553,1483,2181
0130-001,2011,5,17,24,613,288,901,1483
0130-001,2011,5,18,1,407,189,596,901
0130-001,2011,5,18,2,257,149,406,596
0130-001,2011,5,18,3,197,85,282,406
0130-001,2011,5,18,4,187,102,289,282
0130-001,2011,5,18,5,183,131,314,289
0130-001,2011,5,18,6,452,175,627,314
0130-001,2011,5,18,7,1117,477,1594,627
0130-001,2011,5,18,8,2044,1344,3388,1594
0130-001,2011,5,18,9,1594,1480,3074,3388
0130-001,2011,5,18,10,1573,1300,2873,3074
0130-001,2011,5,18,11,1251,1195,2446,2873
0130-001,2011,5,18,12,1012,1117,2129,2446
0130-001,2011,5,18,13,1022,1082,2104,2129
0130-001,2011,5,18,14,1119,1277,2396,2104
0130-001,2011,5,18,15,1255,1335,2590,2396
0130-001,2011,5,18,16,1430,1242,2672,2590
0130-001,2011,5,18,17,1457,1315,2772,2672
0130-001,2011,5,18,18,1467,1509,2976,2772
0130-001,2011,5,18,19,1690,1928,3618,2976
0130-001,2011,5,18,20,1485,1402,2887,3618
0130-001,2011,5,18,21,1400,1068,2468,2887
0130-001,2011,5,18,22,1107,928,2035,2468
0130-001,2011,5,18,23,900,562,1462,2035
0130-001,2011,5,18,24,473,312,785,1462
0130-001,2011,5,19,1,472,224,696,785
0130-001,2011,5,19,2,262,126,388,696
0130-001,2011,5,19,3,173,120,293,388
0130-001,2011,5,19,4,128,79,207,293
0130-001,2011,5,19,5,149,134,283,207
0130-001,2011,5,19,6,423,219,642,283
0130-001,2011,5,19,7,1310,472,1782,642
0130-001,2011,5,19,8,2303,1274,3577,1782
0130-001,2011,5,19,9,1729,1475,3204,3577
0130-001,2011,5,19,10,1177,1338,2515,3204
0130-001,2011,5,19,11,1296,1286,2582,2515
0130-001,2011,5,19,12,1226,1175,2401,2582
0130-001,2011,5,19,13,1060,1251,2311,2401
0130-001,2011,5,19,14,1275,1405,2680,2311
0130-001,2011,5,19,15,1201,1318,2519,2680
0130-001,2011,5,19,16,1025,1379,2404,2519
0130-001,2011,5,19,17,1229,1318,2547,2404
0130-001,2011,5,19,18,1849,1605,3454,2547
0130-001,2011,5,19,19,1817,1697,3514,3454
0130-001,2011,5,19,20,1078,1280,2358,3514
0130-001,2011,5,19,21,946,1100,2046,2358
0130-001,2011,5,19,22,1099,945,2044,2046
0130-001,2011,5,19,23,844,565,1409,2044
0130-001,2011,5,19,24,737,408,1145,1409
0130-001,2011,5,20,1,432,204,636,1145
0130-001,2011,5,20,2,215,137,352,636
0130-001,2011,5,20,3,163,108,271,352
0130-001,2011,5,20,4,167,105,272,271
0130-001,2011,5,20,5,175,108,283,272
0130-001,2011,5,20,6,270,230,500,283
0130-001,2011,5,20,7,719,498,1217,500
0130-001,2011,5,20,8,1820,1198,3018,1217
0130-001,2011,5,20,9,1651,1434,3085,3018
0130-001,2011,5,20,10,1251,1257,2508,3085
0130-001,2011,5,20,11,1262,1303,2565,2508
0130-001,2011,5,20,12,1443,2047,3490,2565
0130-001,2011,5,20,13,1452,1983,3435,3490
0130-001,2011,5,20,14,1408,1321,2729,3435
0130-001,2011,5,20,15,1657,1239,2896,2729
0130-001,2011,5,20,16,1255,1411,2666,2896
0130-001,2011,5,20,17,1492,2414,3906,2666
0130-001,2011,5,20,18,1411,2745,4156,3906
0130-001,2011,5,20,19,1396,2111,3507,4156
0130-001,2011,5,20,20,945,1262,2207,3507
0130-001,2011,5,20,21,823,1123,1946,2207
0130-001,2011,5,20,22,867,960,1827,1946
0130-001,2011,5,20,23,1007,623,1630,1827
0130-001,2011,5,20,24,528,280,808,1630
0130-001,2011,5,21,1,341,277,618,808
0130-001,2011,5,21,2,251,201,452,618
0130-001,2011,5,21,3,178,259,437,452
0130-001,2011,5,21,4,187,283,470,437
0130-001,2011,5,21,5,186,335,521,470
0130-001,2011,5,21,6,217,448,665,521
0130-001,2011,5,21,7,527,524,1051,665
0130-001,2011,5,21,8,941,980,1921,1051
0130-001,2011,5,21,9,1056,1289,2345,1921
0130-001,2011,5,21,10,981,1198,2179,2345
0130-001,2011,5,21,11,931,1379,2310,2179
0130-001,2011,5,21,12,1025,1463,2488,2310
0130-001,2011,5,21,13,1326,1608,2934,2488
0130-001,2011,5,21,14,1459,1591,3050,2934
0130-001,2011,5,21,15,1525,1632,3157,3050
0130-001,2011,5,21,16,1735,1498,3233,3157
0130-001,2011,5,21,17,1433,1629,3062,3233
0130-001,2011,5,21,18,965,1588,2553,3062
0130-001,2011,5,21,19,1041,2191,3232,2553
0130-001,2011,5,21,20,1207,2155,3362,3232
0130-001,2011,5,21,21,978,1489,2467,3362
0130-001,2011,5,21,22,921,1335,2256,2467
0130-001,2011,5,21,23,721,870,1591,2256
0130-001,2011,5,21,24,441,559,1000,1591
0130-001,2011,5,22,1,376,524,900,1000
0130-001,2011,5,22,2,260,283,543,900
0130-001,2011,5,22,3,248,201,449,543
0130-001,2011,5,22,4,170,140,310,449
0130-001,2011,5,22,5,157,120,277,310
0130-001,2011,5,22,6,251,181,432,277
0130-001,2011,5,22,7,542,550,1092,432
0130-001,2011,5,22,8,565,826,1391,1092
0130-001,2011,5,22,9,723,1170,1893,1391
0130-001,2011,5,22,10,666,820,1486,1893
0130-001,2011,5,22,11,871,1036,1907,1486
0130-001,2011,5,22,12,907,1155,2062,1907
0130-001,2011,5,22,13,957,1155,2112,2062
0130-001,2011,5,22,14,1216,1146,2362,2112
0130-001,2011,5,22,15,1128,1108,2236,2362
0130-001,2011,5,22,16,1062,1059,2121,2236
0130-001,2011,5,22,17,1300,1073,2373,2121
0130-001,2011,5,22,18,1357,1134,2491,2373
0130-001,2011,5,22,19,1552,1033,2585,2491
0130-001,2011,5,22,20,1052,838,1890,2585
0130-001,2011,5,22,21,1239,713,1952,1890
0130-001,2011,5,22,22,1207,556,1763,1952
0130-001,2011,5,22,23,639,399,1038,1763
0130-001,2011,5,22,24,520,251,771,1038
0130-001,2011,5,23,1,250,126,376,771
0130-001,2011,5,23,2,193,88,281,376
0130-001,2011,5,23,3,145,73,218,281
0130-001,2011,5,23,4,115,53,168,218
0130-001,2011,5,23,5,153,155,308,168
0130-001,2011,5,23,6,255,227,482,308
0130-001,2011,5,23,7,747,515,1262,482
0130-001,2011,5,23,8,1297,1175,2472,1262
0130-001,2011,5,23,9,1319,1495,2814,2472
0130-001,2011,5,23,10,1237,1251,2488,2814
0130-001,2011,5,23,11,1102,1227,2329,2488
0130-001,2011,5,23,12,1014,1053,2067,2329
0130-001,2011,5,23,13,1024,1143,2167,2067
0130-001,2011,5,23,14,1461,1225,2686,2167
0130-001,2011,5,23,15,1343,1355,2698,2686
0130-001,2011,5,23,16,1147,1265,2412,2698
0130-001,2011,5,23,17,1101,1347,2448,2412
0130-001,2011,5,23,18,1177,1608,2785,2448
0130-001,2011,5,23,19,1214,1759,2973,2785
0130-001,2011,5,23,20,978,1347,2325,2973
0130-001,2011,5,23,21,849,1091,1940,2325
0130-001,2011,5,23,22,884,1012,1896,1940
0130-001,2011,5,23,23,665,538,1203,1896
0130-001,2011,5,23,24,461,332,793,1203
0130-001,2011,5,24,1,279,312,591,793
0130-001,2011,5,24,2,224,143,367,591
0130-001,2011,5,24,3,171,123,294,367
0130-001,2011,5,24,4,166,82,248,294
0130-001,2011,5,24,5,168,128,296,248
0130-001,2011,5,24,6,402,227,629,296
0130-001,2011,5,24,7,1158,591,1749,629
0130-001,2011,5,24,8,1818,1239,3057,1749
0130-001,2011,5,24,9,1756,1486,3242,3057
0130-001,2011,5,24,10,1406,1364,2770,3242
0130-001,2011,5,24,11,1603,1111,2714,2770
0130-001,2011,5,24,12,1438,1198,2636,2714
0130-001,2011,5,24,13,1207,1070,2277,2636
0130-001,2011,5,24,14,1568,1341,2909,2277
0130-001,2011,5,24,15,1526,1306,2832,2909
0130-001,2011,5,24,16,1456,1350,2806,2832
0130-001,2011,5,24,17,1640,1216,2856,2806
0130-001,2011,5,24,18,1673,1527,3200,2856
0130-001,2011,5,24,19,1458,1760,3218,3200
0130-001,2011,5,24,20,1044,1242,2286,3218
0130-001,2011,5,24,21,970,1222,2192,2286
0130-001,2011,5,24,22,905,1041,1946,2192
0130-001,2011,5,24,23,678,585,1263,1946
0130-001,2011,5,24,24,481,285,766,1263
0130-001,2011,5,25,1,323,187,510,766
0130-001,2011,5,25,2,225,128,353,510
0130-001,2011,5,25,3,163,137,300,353
0130-001,2011,5,25,4,114,94,208,300
0130-001,2011,5,25,5,148,155,303,208
0130-001,2011,5,25,6,315,210,525,303
0130-001,2011,5,25,7,796,501,1297,525
0130-001,2011,5,25,8,1620,1233,2853,1297
0130-001,2011,5,25,9,1447,1541,2988,2853
0130-001,2011,5,25,10,1248,1291,2539,2988
0130-001,2011,5,25,11,1087,1193,2280,2539
0130-001,2011,5,25,12,983,1137,2120,2280
0130-001,2011,5,25,13,922,1027,1949,2120
0130-001,2011,5,25,14,1032,1297,2329,1949
0130-001,2011,5,25,15,1117,1230,2347,2329
0130-001,2011,5,25,16,1143,1306,2449,2347
0130-001,2011,5,25,17,1116,1405,2521,2449
0130-001,2011,5,25,18,1305,1553,2858,2521
0130-001,2011,5,25,19,1266,1837,3103,2858
0130-001,2011,5,25,20,1035,1379,2414,3103
0130-001,2011,5,25,21,809,1059,1868,2414
0130-001,2011,5,25,22,840,937,1777,1868
0130-001,2011,5,25,23,603,591,1194,1777
0130-001,2011,5,25,24,478,300,778,1194
0130-001,2011,5,26,1,286,166,452,778
0130-001,2011,5,26,2,195,149,344,452
0130-001,2011,5,26,3,162,105,267,344
0130-001,2011,5,26,4,130,73,203,267
0130-001,2011,5,26,5,141,88,229,203
0130-001,2011,5,26,6,319,187,506,229
0130-001,2011,5,26,7,825,463,1288,506
0130-001,2011,5,26,8,1594,1219,2813,1288
0130-001,2011,5,26,9,1409,1480,2889,2813
0130-001,2011,5,26,10,1336,1233,2569,2889
0130-001,2011,5,26,11,1015,1289,2304,2569
0130-001,2011,5,26,12,1319,1629,2948,2304
0130-001,2011,5,26,13,910,1769,2679,2948
0130-001,2011,5,26,14,1177,1181,2358,2679
0130-001,2011,5,26,15,1501,1318,2819,2358
0130-001,2011,5,26,16,1484,1303,2787,2819
0130-001,2011,5,26,17,1426,1335,2761,2787
0130-001,2011,5,26,18,1396,1556,2952,2761
0130-001,2011,5,26,19,1465,1751,3216,2952
0130-001,2011,5,26,20,1160,1158,2318,3216
0130-001,2011,5,26,21,977,1079,2056,2318
0130-001,2011,5,26,22,1016,998,2014,2056
0130-001,2011,5,26,23,737,521,1258,2014
0130-001,2011,5,26,24,666,323,989,1258
0130-001,2011,5,27,1,329,187,516,989
0130-001,2011,5,27,2,263,163,426,516
0130-001,2011,5,27,3,198,126,324,426
0130-001,2011,5,27,4,150,73,223,324
0130-001,2011,5,27,5,234,96,330,223
0130-001,2011,5,27,6,368,253,621,330
0130-001,2011,5,27,7,754,469,1223,621
0130-001,2011,5,27,8,1471,1210,2681,1223
0130-001,2011,5,27,9,1304,1469,2773,2681
0130-001,2011,5,27,10,1067,1370,2437,2773
0130-001,2011,5,27,11,1158,1300,2458,2437
0130-001,2011,5,27,12,1078,1312,2390,2458
0130-001,2011,5,27,13,946,1195,2141,2390
0130-001,2011,5,27,14,1371,1309,2680,2141
0130-001,2011,5,27,15,1297,1283,2580,2680
0130-001,2011,5,27,16,1090,1332,2422,2580
0130-001,2011,5,27,17,1102,1515,2617,2422
0130-001,2011,5,27,18,1249,1626,2875,2617
0130-001,2011,5,27,19,1177,1795,2972,2875
0130-001,2011,5,27,20,1371,1672,3043,2972
0130-001,2011,5,27,21,1177,1268,2445,3043
0130-001,2011,5,27,22,1237,966,2203,2445
0130-001,2011,5,27,23,953,640,1593,2203
0130-001,2011,5,27,24,759,448,1207,1593
0130-001,2011,5,28,1,513,291,804,1207
0130-001,2011,5,28,2,360,160,520,804
0130-001,2011,5,28,3,278,149,427,520
0130-001,2011,5,28,4,250,131,381,427
0130-001,2011,5,28,5,225,201,426,381
0130-001,2011,5,28,6,391,265,656,426
0130-001,2011,5,28,7,937,413,1350,656
0130-001,2011,5,28,8,1639,786,2425,1350
0130-001,2011,5,28,9,1568,1158,2726,2425
0130-001,2011,5,28,10,1537,1387,2924,2726
0130-001,2011,5,28,11,1502,1806,3308,2924
0130-001,2011,5,28,12,1505,2231,3736,3308
0130-001,2011,5,28,13,1693,2245,3938,3736
0130-001,2011,5,28,14,1571,2238,3809,3938
0130-001,2011,5,28,15,1520,1672,3192,3809
0130-001,2011,5,28,16,1651,1576,3227,3192
0130-001,2011,5,28,17,1585,1573,3158,3227
0130-001,2011,5,28,18,1816,1594,3410,3158
0130-001,2011,5,28,19,1520,1605,3125,3410
0130-001,2011,5,28,20,1145,1466,2611,3125
0130-001,2011,5,28,21,1055,1088,2143,2611
0130-001,2011,5,28,22,1037,1190,2227,2143
0130-001,2011,5,28,23,823,899,1722,2227
0130-001,2011,5,28,24,645,442,1087,1722
0130-001,2011,5,29,1,464,300,764,1087
0130-001,2011,5,29,2,275,181,456,764
0130-001,2011,5,29,3,283,131,414,456
0130-001,2011,5,29,4,193,131,324,414
0130-001,2011,5,29,5,189,73,262,324
0130-001,2011,5,29,6,276,160,436,262
0130-001,2011,5,29,7,562,268,830,436
0130-001,2011,5,29,8,706,480,1186,830
0130-001,2011,5,29,9,859,713,1572,1186
0130-001,2011,5,29,10,1069,1079,2148,1572
0130-001,2011,5,29,11,1114,1312,2426,2148
0130-001,2011,5,29,12,1218,1310,2528,2426
0130-001,2011,5,29,13,1120,1318,2438,2528
0130-001,2011,5,29,14,1334,1082,2416,2438
0130-001,2011,5,29,15,1444,1018,2462,2416
0130-001,2011,5,29,16,1830,1021,2851,2462
0130-001,2011,5,29,17,1789,925,2714,2851
0130-001,2011,5,29,18,1644,1076,2720,2714
0130-001,2011,5,29,19,1941,951,2892,2720
0130-001,2011,5,29,20,1342,788,2130,2892
0130-001,2011,5,29,21,1189,774,1963,2130
0130-001,2011,5,29,22,1080,626,1706,1963
0130-001,2011,5,29,23,710,384,1094,1706
0130-001,2011,5,29,24,483,207,690,1094
0130-001,2011,5,30,1,284,128,412,690
0130-001,2011,5,30,2,180,99,279,412
0130-001,2011,5,30,3,101,56,157,279
0130-001,2011,5,30,4,91,62,153,157
0130-001,2011,5,30,5,161,88,249,153
0130-001,2011,5,30,6,331,274,605,249
0130-001,2011,5,30,7,836,559,1395,605
0130-001,2011,5,30,8,1492,1184,2676,1395
0130-001,2011,5,30,9,1415,1608,3023,2676
0130-001,2011,5,30,10,1230,1315,2545,3023
0130-001,2011,5,30,11,1355,1367,2722,2545
0130-001,2011,5,30,12,1433,1195,2628,2722
0130-001,2011,5,30,13,1218,1073,2291,2628
0130-001,2011,5,30,14,1514,1233,2747,2291
0130-001,2011,5,30,15,1688,1329,3017,2747
0130-001,2011,5,30,16,1775,1396,3171,3017
0130-001,2011,5,30,17,1684,1329,3013,3171
0130-001,2011,5,30,18,1714,1588,3302,3013
0130-001,2011,5,30,19,1717,1699,3416,3302
0130-001,2011,5,30,20,1391,1172,2563,3416
0130-001,2011,5,30,21,1051,1181,2232,2563
0130-001,2011,5,30,22,1160,1044,2204,2232
0130-001,2011,5,30,23,949,518,1467,2204
0130-001,2011,5,30,24,460,306,766,1467
0130-001,2011,5,31,1,284,184,468,766
0130-001,2011,5,31,2,192,99,291,468
0130-001,2011,5,31,3,126,99,225,291
0130-001,2011,5,31,4,107,102,209,225
0130-001,2011,5,31,5,143,117,260,209
0130-001,2011,5,31,6,364,280,644,260
0130-001,2011,5,31,7,1156,759,1915,644
0130-001,2011,5,31,8,2519,1097,3616,1915
0130-001,2011,5,31,9,2011,1585,3596,3616
0130-001,2011,5,31,10,1359,1291,2650,3596
0130-001,2011,5,31,11,1333,1265,2598,2650
0130-001,2011,5,31,12,1338,1114,2452,2598
0130-001,2011,5,31,13,965,1132,2097,2452
0130-001,2011,5,31,14,1214,1306,2520,2097
0130-001,2011,5,31,15,1121,1309,2430,2520
0130-001,2011,5,31,16,1264,1283,2547,2430
0130-001,2011,5,31,17,1110,1207,2317,2547
0130-001,2011,5,31,18,1240,1414,2654,2317
0130-001,2011,5,31,19,1394,1852,3246,2654
0130-001,2011,5,31,20,1102,1280,2382,3246
0130-001,2011,5,31,21,966,1233,2199,2382
0130-001,2011,5,31,22,937,1012,1949,2199
0130-001,2011,5,31,23,854,553,1407,1949
0130-001,2011,5,31,24,472,309,781,1407
0130-001,2011,6,1,1,334,296,630,781
0130-001,2011,6,1,2,242,195,437,630
0130-001,2011,6,1,3,179,170,349,437
0130-001,2011,6,1,4,171,168,339,349
0130-001,2011,6,1,5,135,209,344,339
0130-001,2011,6,1,6,232,266,498,344
0130-001,2011,6,1,7,660,448,1108,498
0130-001,2011,6,1,8,1238,866,2104,1108
0130-001,2011,6,1,9,1416,1392,2808,2104
0130-001,2011,6,1,10,1198,1465,2663,2808
0130-001,2011,6,1,11,1265,1066,2331,2663
0130-001,2011,6,1,12,1137,1170,2307,2331
0130-001,2011,6,1,13,988,1019,2007,2307
0130-001,2011,6,1,14,1282,1339,2621,2007
0130-001,2011,6,1,15,1192,1214,2406,2621
0130-001,2011,6,1,16,1234,1265,2499,2406
0130-001,2011,6,1,17,1146,1193,2339,2499
0130-001,2011,6,1,18,1182,1577,2759,2339
0130-001,2011,6,1,19,1246,1659,2905,2759
0130-001,2011,6,1,20,1029,1259,2288,2905
0130-001,2011,6,1,21,861,996,1857,2288
0130-001,2011,6,1,22,827,780,1607,1857
0130-001,2011,6,1,23,647,614,1261,1607
0130-001,2011,6,1,24,458,409,867,1261
0130-001,2011,6,2,1,374,307,681,867
0130-001,2011,6,2,2,213,167,380,681
0130-001,2011,6,2,3,156,125,281,380
0130-001,2011,6,2,4,130,125,255,281
0130-001,2011,6,2,5,141,230,371,255
0130-001,2011,6,2,6,279,331,610,371
0130-001,2011,6,2,7,721,478,1199,610
0130-001,2011,6,2,8,1432,1032,2464,1199
0130-001,2011,6,2,9,1595,1581,3176,2464
0130-001,2011,6,2,10,1457,1494,2951,3176
0130-001,2011,6,2,11,1329,1282,2611,2951
0130-001,2011,6,2,12,1178,1214,2392,2611
0130-001,2011,6,2,13,920,909,1829,2392
0130-001,2011,6,2,14,1734,1621,3355,1829
0130-001,2011,6,2,15,1819,1846,3665,3355
0130-001,2011,6,2,16,1788,1887,3675,3665
0130-001,2011,6,2,17,1777,1908,3685,3675
0130-001,2011,6,2,18,1842,2169,4011,3685
0130-001,2011,6,2,19,1901,2552,4453,4011
0130-001,2011,6,2,20,1603,1882,3485,4453
0130-001,2011,6,2,21,1280,1626,2906,3485
0130-001,2011,6,2,22,1226,1259,2485,2906
0130-001,2011,6,2,23,881,822,1703,2485
0130-001,2011,6,2,24,569,489,1058,1703
0130-001,2011,6,3,1,337,300,637,1058
0130-001,2011,6,3,2,215,165,380,637
0130-001,2011,6,3,3,177,178,355,380
0130-001,2011,6,3,4,179,199,378,355
0130-001,2011,6,3,5,184,247,431,378
0130-001,2011,6,3,6,411,505,916,431
0130-001,2011,6,3,7,1159,734,1893,916
0130-001,2011,6,3,8,2025,1432,3457,1893
0130-001,2011,6,3,9,1570,1527,3097,3457
0130-001,2011,6,3,10,1218,1127,2345,3097
0130-001,2011,6,3,11,1465,1570,3035,2345
0130-001,2011,6,3,12,1451,1484,2935,3035
0130-001,2011,6,3,13,1363,1469,2832,2935
0130-001,2011,6,3,14,1041,1027,2068,2832
0130-001,2011,6,3,15,793,766,1559,2068
0130-001,2011,6,3,16,989,1067,2056,1559
0130-001,2011,6,3,17,1338,1408,2746,2056
0130-001,2011,6,3,18,1123,1328,2451,2746
0130-001,2011,6,3,19,1776,2146,3922,2451
0130-001,2011,6,3,20,1754,2438,4192,3922
0130-001,2011,6,3,21,1433,1747,3180,4192
0130-001,2011,6,3,22,1436,1430,2866,3180
0130-001,2011,6,3,23,1158,960,2118,2866
0130-001,2011,6,3,24,767,593,1360,2118
0130-001,2011,6,4,1,525,435,960,1360
0130-001,2011,6,4,2,384,356,740,960
0130-001,2011,6,4,3,321,266,587,740
0130-001,2011,6,4,4,246,235,481,587
0130-001,2011,6,4,5,260,311,571,481
0130-001,2011,6,4,6,440,488,928,571
0130-001,2011,6,4,7,899,689,1588,928
0130-001,2011,6,4,8,1735,1371,3106,1588
0130-001,2011,6,4,9,1919,1926,3845,3106
0130-001,2011,6,4,10,1551,1699,3250,3845
0130-001,2011,6,4,11,1646,1940,3586,3250
0130-001,2011,6,4,12,1610,1757,3367,3586
0130-001,2011,6,4,13,1631,2177,3808,3367
0130-001,2011,6,4,14,1693,2087,3780,3808
0130-001,2011,6,4,15,1812,2198,4010,3780
0130-001,2011,6,4,16,1828,1985,3813,4010
0130-001,2011,6,4,17,1884,1924,3808,3813
0130-001,2011,6,4,18,2165,2336,4501,3808
0130-001,2011,6,4,19,2030,2039,4069,4501
0130-001,2011,6,4,20,1544,1604,3148,4069
0130-001,2011,6,4,21,1338,1274,2612,3148
0130-001,2011,6,4,22,1161,918,2079,2612
0130-001,2011,6,4,23,899,716,1615,2079
0130-001,2011,6,4,24,673,502,1175,1615
0130-001,2011,6,5,1,459,380,839,1175
0130-001,2011,6,5,2,335,308,643,839
0130-001,2011,6,5,3,221,170,391,643
0130-001,2011,6,5,4,188,156,344,391
0130-001,2011,6,5,5,226,254,480,344
0130-001,2011,6,5,6,295,340,635,480
0130-001,2011,6,5,7,556,517,1073,635
0130-001,2011,6,5,8,758,761,1519,1073
0130-001,2011,6,5,9,874,1132,2006,1519
0130-001,2011,6,5,10,987,1118,2105,2006
0130-001,2011,6,5,11,1080,1306,2386,2105
0130-001,2011,6,5,12,1096,1325,2421,2386
0130-001,2011,6,5,13,991,927,1918,2421
0130-001,2011,6,5,14,1234,1039,2273,1918
0130-001,2011,6,5,15,1006,787,1793,2273
0130-001,2011,6,5,16,1389,1149,2538,1793
0130-001,2011,6,5,17,1386,1110,2496,2538
0130-001,2011,6,5,18,1864,1417,3281,2496
0130-001,2011,6,5,19,1899,1161,3060,3281
0130-001,2011,6,5,20,1676,1314,2990,3060
0130-001,2011,6,5,21,1384,1097,2481,2990
0130-001,2011,6,5,22,1208,815,2023,2481
0130-001,2011,6,5,23,1034,754,1788,2023
0130-001,2011,6,5,24,650,487,1137,1788
0130-001,2011,6,6,1,386,297,683,1137
0130-001,2011,6,6,2,248,192,440,683
0130-001,2011,6,6,3,219,240,459,440
0130-001,2011,6,6,4,165,154,319,459
0130-001,2011,6,6,5,152,206,358,319
0130-001,2011,6,6,6,365,378,743,358
0130-001,2011,6,6,7,605,384,989,743
0130-001,2011,6,6,8,998,683,1681,989
0130-001,2011,6,6,9,1051,1030,2081,1681
0130-001,2011,6,6,10,1262,1302,2564,2081
0130-001,2011,6,6,11,1354,1278,2632,2564
0130-001,2011,6,6,12,1797,1749,3546,2632
0130-001,2011,6,6,13,1434,1442,2876,3546
0130-001,2011,6,6,14,1022,1014,2036,2876
0130-001,2011,6,6,15,1182,1210,2392,2036
0130-001,2011,6,6,16,1087,1123,2210,2392
0130-001,2011,6,6,17,875,909,1784,2210
0130-001,2011,6,6,18,832,1024,1856,1784
0130-001,2011,6,6,19,1216,1557,2773,1856
0130-001,2011,6,6,20,1211,1551,2762,2773
0130-001,2011,6,6,21,1110,1409,2519,2762
0130-001,2011,6,6,22,1137,1282,2419,2519
0130-001,2011,6,6,23,837,774,1611,2419
0130-001,2011,6,6,24,572,519,1091,1611
0130-001,2011,6,7,1,340,298,638,1091
0130-001,2011,6,7,2,221,179,400,638
0130-001,2011,6,7,3,117,107,224,400
0130-001,2011,6,7,4,134,123,257,224
0130-001,2011,6,7,5,171,248,419,257
0130-001,2011,6,7,6,341,396,737,419
0130-001,2011,6,7,7,1233,893,2126,737
0130-001,2011,6,7,8,2146,1556,3702,2126
0130-001,2011,6,7,9,1842,1746,3588,3702
0130-001,2011,6,7,10,1404,1346,2750,3588
0130-001,2011,6,7,11,1787,1709,3496,2750
0130-001,2011,6,7,12,1685,1615,3300,3496
0130-001,2011,6,7,13,1493,1513,3006,3300
0130-001,2011,6,7,14,1769,1732,3501,3006
0130-001,2011,6,7,15,1891,2008,3899,3501
0130-001,2011,6,7,16,1887,1916,3803,3899
0130-001,2011,6,7,17,1603,1731,3334,3803
0130-001,2011,6,7,18,1516,1841,3357,3334
0130-001,2011,6,7,19,1188,1515,2703,3357
0130-001,2011,6,7,20,1357,1669,3026,2703
0130-001,2011,6,7,21,1414,1755,3169,3026
0130-001,2011,6,7,22,1474,1552,3026,3169
0130-001,2011,6,7,23,1057,899,1956,3026
0130-001,2011,6,7,24,680,532,1212,1956
0130-001,2011,6,8,1,398,324,722,1212
0130-001,2011,6,8,2,289,276,565,722
0130-001,2011,6,8,3,186,183,369,565
0130-001,2011,6,8,4,145,151,296,369
0130-001,2011,6,8,5,147,238,385,296
0130-001,2011,6,8,6,328,330,658,385
0130-001,2011,6,8,7,1043,740,1783,658
0130-001,2011,6,8,8,2010,1466,3476,1783
0130-001,2011,6,8,9,1823,1747,3570,3476
0130-001,2011,6,8,10,1728,1835,3563,3570
0130-001,2011,6,8,11,1322,1331,2653,3563
0130-001,2011,6,8,12,1364,1305,2669,2653
0130-001,2011,6,8,13,1218,1303,2521,2669
0130-001,2011,6,8,14,1915,1869,3784,2521
0130-001,2011,6,8,15,1737,1791,3528,3784
0130-001,2011,6,8,16,1621,1649,3270,3528
0130-001,2011,6,8,17,1548,1686,3234,3270
0130-001,2011,6,8,18,1723,2278,4001,3234
0130-001,2011,6,8,19,1864,2567,4431,4001
0130-001,2011,6,8,20,1363,1620,2983,4431
0130-001,2011,6,8,21,1189,1294,2483,2983
0130-001,2011,6,8,22,1061,1044,2105,2483
0130-001,2011,6,8,23,841,707,1548,2105
0130-001,2011,6,8,24,689,591,1280,1548
0130-001,2011,6,9,1,553,471,1024,1280
0130-001,2011,6,9,2,298,252,550,1024
0130-001,2011,6,9,3,191,172,363,550
0130-001,2011,6,9,4,198,213,411,363
0130-001,2011,6,9,5,215,351,566,411
0130-001,2011,6,9,6,386,488,874,566
0130-001,2011,6,9,7,1007,740,1747,874
0130-001,2011,6,9,8,2131,1654,3785,1747
0130-001,2011,6,9,9,1837,1631,3468,3785
0130-001,2011,6,9,10,1631,1696,3327,3468
0130-001,2011,6,9,11,1631,1535,3166,3327
0130-001,2011,6,9,12,1335,1397,2732,3166
0130-001,2011,6,9,13,1392,1455,2847,2732
0130-001,2011,6,9,14,1422,1474,2896,2847
0130-001,2011,6,9,15,1547,1594,3141,2896
0130-001,2011,6,9,16,1620,1556,3176,3141
0130-001,2011,6,9,17,1275,1335,2610,3176
0130-001,2011,6,9,18,1350,1767,3117,2610
0130-001,2011,6,9,19,1281,1633,2914,3117
0130-001,2011,6,9,20,1137,1463,2600,2914
0130-001,2011,6,9,21,913,1107,2020,2600
0130-001,2011,6,9,22,972,1036,2008,2020
0130-001,2011,6,9,23,733,606,1339,2008
0130-001,2011,6,9,24,659,538,1197,1339
0130-001,2011,6,10,1,427,347,774,1197
0130-001,2011,6,10,2,252,204,456,774
0130-001,2011,6,10,3,213,189,402,456
0130-001,2011,6,10,4,131,120,251,402
0130-001,2011,6,10,5,220,343,563,251
0130-001,2011,6,10,6,425,467,892,563
0130-001,2011,6,10,7,853,598,1451,892
0130-001,2011,6,10,8,1672,1213,2885,1451
0130-001,2011,6,10,9,1491,1397,2888,2885
0130-001,2011,6,10,10,1373,1374,2747,2888
0130-001,2011,6,10,11,1323,1304,2627,2747
0130-001,2011,6,10,12,1293,1335,2628,2627
0130-001,2011,6,10,13,1283,1350,2633,2628
0130-001,2011,6,10,14,1549,1649,3198,2633
0130-001,2011,6,10,15,1478,1457,2935,3198
0130-001,2011,6,10,16,1677,1695,3372,2935
0130-001,2011,6,10,17,1823,2018,3841,3372
0130-001,2011,6,10,18,1775,2116,3891,3841
0130-001,2011,6,10,19,1690,1992,3682,3891
0130-001,2011,6,10,20,1245,1684,2929,3682
0130-001,2011,6,10,21,1157,1412,2569,2929
0130-001,2011,6,10,22,960,1000,1960,2569
0130-001,2011,6,10,23,840,650,1490,1960
0130-001,2011,6,10,24,562,455,1017,1490
0130-001,2011,6,11,1,427,337,764,1017
0130-001,2011,6,11,2,288,229,517,764
0130-001,2011,6,11,3,224,207,431,517
0130-001,2011,6,11,4,179,163,342,431
0130-001,2011,6,11,5,229,268,497,342
0130-001,2011,6,11,6,332,362,694,497
0130-001,2011,6,11,7,771,610,1381,694
0130-001,2011,6,11,8,1244,1155,2399,1381
0130-001,2011,6,11,9,1089,1103,2192,2399
0130-001,2011,6,11,10,1469,1629,3098,2192
0130-001,2011,6,11,11,1529,1850,3379,3098
0130-001,2011,6,11,12,1491,1878,3369,3379
0130-001,2011,6,11,13,1553,1938,3491,3369
0130-001,2011,6,11,14,1535,1890,3425,3491
0130-001,2011,6,11,15,1353,1618,2971,3425
0130-001,2011,6,11,16,1330,1556,2886,2971
0130-001,2011,6,11,17,1654,1756,3410,2886
0130-001,2011,6,11,18,1570,1599,3169,3410
0130-001,2011,6,11,19,1080,1078,2158,3169
0130-001,2011,6,11,20,1218,1248,2466,2158
0130-001,2011,6,11,21,1141,982,2123,2466
0130-001,2011,6,11,22,1092,871,1963,2123
0130-001,2011,6,11,23,966,753,1719,1963
0130-001,2011,6,11,24,705,562,1267,1719
0130-001,2011,6,12,1,521,439,960,1267
0130-001,2011,6,12,2,352,279,631,960
0130-001,2011,6,12,3,251,239,490,631
0130-001,2011,6,12,4,217,177,394,490
0130-001,2011,6,12,5,237,234,471,394
0130-001,2011,6,12,6,338,410,748,471
0130-001,2011,6,12,7,487,415,902,748
0130-001,2011,6,12,8,603,546,1149,902
0130-001,2011,6,12,9,760,977,1737,1149
0130-001,2011,6,12,10,843,935,1778,1737
0130-001,2011,6,12,11,980,1293,2273,1778
0130-001,2011,6,12,12,1003,1247,2250,2273
0130-001,2011,6,12,13,976,1045,2021,2250
0130-001,2011,6,12,14,1117,1025,2142,2021
0130-001,2011,6,12,15,1186,977,2163,2142
0130-001,2011,6,12,16,1502,1189,2691,2163
0130-001,2011,6,12,17,1637,1341,2978,2691
0130-001,2011,6,12,18,1847,1372,3219,2978
0130-001,2011,6,12,19,1452,1012,2464,3219
0130-001,2011,6,12,20,1146,864,2010,2464
0130-001,2011,6,12,21,1191,922,2113,2010
0130-001,2011,6,12,22,1109,786,1895,2113
0130-001,2011,6,12,23,857,645,1502,1895
0130-001,2011,6,12,24,501,393,894,1502
0130-001,2011,6,13,1,304,227,531,894
0130-001,2011,6,13,2,134,126,260,531
0130-001,2011,6,13,3,105,98,203,260
0130-001,2011,6,13,4,123,130,253,203
0130-001,2011,6,13,5,167,248,415,253
0130-001,2011,6,13,6,224,264,488,415
0130-001,2011,6,13,7,1292,846,2138,488
0130-001,2011,6,13,8,2128,1516,3644,2138
0130-001,2011,6,13,9,1843,1795,3638,3644
0130-001,2011,6,13,10,1421,1474,2895,3638
0130-001,2011,6,13,11,1705,1670,3375,2895
0130-001,2011,6,13,12,1637,1728,3365,3375
0130-001,2011,6,13,13,1250,1168,2418,3365
0130-001,2011,6,13,14,1397,1408,2805,2418
0130-001,2011,6,13,15,1546,1524,3070,2805
0130-001,2011,6,13,16,1439,1523,2962,3070
0130-001,2011,6,13,17,1358,1475,2833,2962
0130-001,2011,6,13,18,1348,1783,3131,2833
0130-001,2011,6,13,19,1537,1942,3479,3131
0130-001,2011,6,13,20,1050,1284,2334,3479
0130-001,2011,6,13,21,874,1092,1966,2334
0130-001,2011,6,13,22,922,1012,1934,1966
0130-001,2011,6,13,23,556,428,984,1934
0130-001,2011,6,13,24,386,290,676,984
0130-001,2011,6,14,1,278,237,515,676
0130-001,2011,6,14,2,131,114,245,515
0130-001,2011,6,14,3,113,101,214,245
0130-001,2011,6,14,4,83,82,165,214
0130-001,2011,6,14,5,123,166,289,165
0130-001,2011,6,14,6,319,357,676,289
0130-001,2011,6,14,7,785,510,1295,676
0130-001,2011,6,14,8,1651,1155,2806,1295
0130-001,2011,6,14,9,1950,1808,3758,2806
0130-001,2011,6,14,10,1650,1667,3317,3758
0130-001,2011,6,14,11,1572,1478,3050,3317
0130-001,2011,6,14,12,1331,1302,2633,3050
0130-001,2011,6,14,13,1374,1357,2731,2633
0130-001,2011,6,14,14,1591,1629,3220,2731
0130-001,2011,6,14,15,1516,1520,3036,3220
0130-001,2011,6,14,16,1568,1575,3143,3036
0130-001,2011,6,14,17,1367,1468,2835,3143
0130-001,2011,6,14,18,1506,1905,3411,2835
0130-001,2011,6,14,19,1332,1905,3237,3411
0130-001,2011,6,14,20,1074,1391,2465,3237
0130-001,2011,6,14,21,816,973,1789,2465
0130-001,2011,6,14,22,702,713,1415,1789
0130-001,2011,6,14,23,520,429,949,1415
0130-001,2011,6,14,24,439,342,781,949
0130-001,2011,6,15,1,258,211,469,781
0130-001,2011,6,15,2,124,99,223,469
0130-001,2011,6,15,3,113,104,217,223
0130-001,2011,6,15,4,100,94,194,217
0130-001,2011,6,15,5,97,142,239,194
0130-001,2011,6,15,6,205,259,464,239
0130-001,2011,6,15,7,461,344,805,464
0130-001,2011,6,15,8,611,451,1062,805
0130-001,2011,6,15,9,684,640,1324,1062
0130-001,2011,6,15,10,950,918,1868,1324
0130-001,2011,6,15,11,1018,984,2002,1868
0130-001,2011,6,15,12,1039,1021,2060,2002
0130-001,2011,6,15,13,969,1038,2007,2060
0130-001,2011,6,15,14,1432,1518,2950,2007
0130-001,2011,6,15,15,1889,1942,3831,2950
0130-001,2011,6,15,16,1395,1300,2695,3831
0130-001,2011,6,15,17,1353,1403,2756,2695
0130-001,2011,6,15,18,1388,1799,3187,2756
0130-001,2011,6,15,19,1466,1957,3423,3187
0130-001,2011,6,15,20,906,1128,2034,3423
0130-001,2011,6,15,21,652,738,1390,2034
0130-001,2011,6,15,22,774,681,1455,1390
0130-001,2011,6,15,23,719,595,1314,1455
0130-001,2011,6,15,24,403,318,721,1314
0130-001,2011,6,16,1,289,286,575,721
0130-001,2011,6,16,2,196,165,361,575
0130-001,2011,6,16,3,102,102,204,361
0130-001,2011,6,16,4,106,130,236,204
0130-001,2011,6,16,5,151,228,379,236
0130-001,2011,6,16,6,235,280,515,379
0130-001,2011,6,16,7,715,512,1227,515
0130-001,2011,6,16,8,876,628,1504,1227
0130-001,2011,6,16,9,1276,1156,2432,1504
0130-001,2011,6,16,10,1374,1356,2730,2432
0130-001,2011,6,16,11,1807,1830,3637,2730
0130-001,2011,6,16,12,1773,1699,3472,3637
0130-001,2011,6,16,13,1610,1695,3305,3472
0130-001,2011,6,16,14,1737,1796,3533,3305
0130-001,2011,6,16,15,1830,1884,3714,3533
0130-001,2011,6,16,16,1185,1160,2345,3714
0130-001,2011,6,16,17,1656,1796,3452,2345
0130-001,2011,6,16,18,1601,1724,3325,3452
0130-001,2011,6,16,19,1481,1442,2923,3325
0130-001,2011,6,16,20,1303,1648,2951,2923
0130-001,2011,6,16,21,1194,1541,2735,2951
0130-001,2011,6,16,22,1007,1101,2108,2735
0130-001,2011,6,16,23,761,737,1498,2108
0130-001,2011,6,16,24,552,422,974,1498
0130-001,2011,6,17,1,335,266,601,974
0130-001,2011,6,17,2,241,196,437,601
0130-001,2011,6,17,3,136,121,257,437
0130-001,2011,6,17,4,105,106,211,257
0130-001,2011,6,17,5,216,307,523,211
0130-001,2011,6,17,6,440,461,901,523
0130-001,2011,6,17,7,1111,824,1935,901
0130-001,2011,6,17,8,1971,1367,3338,1935
0130-001,2011,6,17,9,1480,1413,2893,3338
0130-001,2011,6,17,10,1833,1953,3786,2893
0130-001,2011,6,17,11,1788,1728,3516,3786
0130-001,2011,6,17,12,1726,1753,3479,3516
0130-001,2011,6,17,13,1372,1541,2913,3479
0130-001,2011,6,17,14,1727,1811,3538,2913
0130-001,2011,6,17,15,1850,1941,3791,3538
0130-001,2011,6,17,16,1425,1524,2949,3791
0130-001,2011,6,17,17,1066,1096,2162,2949
0130-001,2011,6,17,18,1247,1529,2776,2162
0130-001,2011,6,17,19,1203,1478,2681,2776
0130-001,2011,6,17,20,962,1267,2229,2681
0130-001,2011,6,17,21,712,894,1606,2229
0130-001,2011,6,17,22,595,566,1161,1606
0130-001,2011,6,17,23,715,515,1230,1161
0130-001,2011,6,17,24,447,325,772,1230
0130-001,2011,6,18,1,320,247,567,772
0130-001,2011,6,18,2,257,207,464,567
0130-001,2011,6,18,3,108,107,215,464
0130-001,2011,6,18,4,120,114,234,215
0130-001,2011,6,18,5,133,153,286,234
0130-001,2011,6,18,6,208,219,427,286
0130-001,2011,6,18,7,463,409,872,427
0130-001,2011,6,18,8,954,741,1695,872
0130-001,2011,6,18,9,1449,1318,2767,1695
0130-001,2011,6,18,10,1237,1298,2535,2767
0130-001,2011,6,18,11,1044,1184,2228,2535
0130-001,2011,6,18,12,1132,1412,2544,2228
0130-001,2011,6,18,13,1412,2046,3458,2544
0130-001,2011,6,18,14,1457,1721,3178,3458
0130-001,2011,6,18,15,1586,1739,3325,3178
0130-001,2011,6,18,16,1583,1758,3341,3325
0130-001,2011,6,18,17,1461,1381,2842,3341
0130-001,2011,6,18,18,1463,1363,2826,2842
0130-001,2011,6,18,19,1267,1376,2643,2826
0130-001,2011,6,18,20,979,878,1857,2643
0130-001,2011,6,18,21,970,853,1823,1857
0130-001,2011,6,18,22,855,703,1558,1823
0130-001,2011,6,18,23,664,488,1152,1558
0130-001,2011,6,18,24,446,359,805,1152
0130-001,2011,6,19,1,354,298,652,805
0130-001,2011,6,19,2,240,219,459,652
0130-001,2011,6,19,3,209,178,387,459
0130-001,2011,6,19,4,176,120,296,387
0130-001,2011,6,19,5,148,166,314,296
0130-001,2011,6,19,6,324,381,705,314
0130-001,2011,6,19,7,342,263,605,705
0130-001,2011,6,19,8,522,467,989,605
0130-001,2011,6,19,9,742,884,1626,989
0130-001,2011,6,19,10,885,965,1850,1626
0130-001,2011,6,19,11,1092,1365,2457,1850
0130-001,2011,6,19,12,965,1195,2160,2457
0130-001,2011,6,19,13,972,1158,2130,2160
0130-001,2011,6,19,14,1268,1347,2615,2130
0130-001,2011,6,19,15,1281,1383,2664,2615
0130-001,2011,6,19,16,1303,1173,2476,2664
0130-001,2011,6,19,17,1135,959,2094,2476
0130-001,2011,6,19,18,1254,1219,2473,2094
0130-001,2011,6,19,19,984,885,1869,2473
0130-001,2011,6,19,20,746,628,1374,1869
0130-001,2011,6,19,21,590,468,1058,1374
0130-001,2011,6,19,22,530,367,897,1058
0130-001,2011,6,19,23,525,394,919,897
0130-001,2011,6,19,24,269,177,446,919
0130-001,2011,6,20,1,247,176,423,446
0130-001,2011,6,20,2,220,175,395,423
0130-001,2011,6,20,3,193,167,360,395
0130-001,2011,6,20,4,179,145,324,360
0130-001,2011,6,20,5,194,268,462,324
0130-001,2011,6,20,6,358,406,764,462
0130-001,2011,6,20,7,1419,968,2387,764
0130-001,2011,6,20,8,1639,1085,2724,2387
0130-001,2011,6,20,9,1118,1031,2149,2724
0130-001,2011,6,20,10,1337,1379,2716,2149
0130-001,2011,6,20,11,1082,1052,2134,2716
0130-001,2011,6,20,12,1665,1658,3323,2134
0130-001,2011,6,20,13,1811,1922,3733,3323
0130-001,2011,6,20,14,1556,1473,3029,3733
0130-001,2011,6,20,15,1201,1150,2351,3029
0130-001,2011,6,20,16,1678,1640,3318,2351
0130-001,2011,6,20,17,1948,2095,4043,3318
0130-001,2011,6,20,18,1793,2173,3966,4043
0130-001,2011,6,20,19,1219,1600,2819,3966
0130-001,2011,6,20,20,912,1132,2044,2819
0130-001,2011,6,20,21,909,1219,2128,2044
0130-001,2011,6,20,22,819,852,1671,2128
0130-001,2011,6,20,23,766,632,1398,1671
0130-001,2011,6,20,24,695,501,1196,1398
0130-001,2011,6,21,1,395,360,755,1196
0130-001,2011,6,21,2,175,157,332,755
0130-001,2011,6,21,3,178,167,345,332
0130-001,2011,6,21,4,194,206,400,345
0130-001,2011,6,21,5,209,257,466,400
0130-001,2011,6,21,6,580,669,1249,466
0130-001,2011,6,21,7,1523,998,2521,1249
0130-001,2011,6,21,8,2212,1527,3739,2521
0130-001,2011,6,21,9,2190,2012,4202,3739
0130-001,2011,6,21,10,1806,1836,3642,4202
0130-001,2011,6,21,11,2011,1970,3981,3642
0130-001,2011,6,21,12,1693,1750,3443,3981
0130-001,2011,6,21,13,1446,1478,2924,3443
0130-001,2011,6,21,14,1394,1366,2760,2924
0130-001,2011,6,21,15,1568,1637,3205,2760
0130-001,2011,6,21,16,1734,1668,3402,3205
0130-001,2011,6,21,17,1755,1844,3599,3402
0130-001,2011,6,21,18,1323,1621,2944,3599
0130-001,2011,6,21,19,1532,2200,3732,2944
0130-001,2011,6,21,20,1272,1544,2816,3732
0130-001,2011,6,21,21,1327,1555,2882,2816
0130-001,2011,6,21,22,1258,1353,2611,2882
0130-001,2011,6,21,23,825,661,1486,2611
0130-001,2011,6,21,24,459,342,801,1486
0130-001,2011,6,22,1,313,274,587,801
0130-001,2011,6,22,2,253,221,474,587
0130-001,2011,6,22,3,235,205,440,474
0130-001,2011,6,22,4,239,221,460,440
0130-001,2011,6,22,5,121,157,278,460
0130-001,2011,6,22,6,381,443,824,278
0130-001,2011,6,22,7,992,626,1618,824
0130-001,2011,6,22,8,2014,1403,3417,1618
0130-001,2011,6,22,9,1818,1686,3504,3417
0130-001,2011,6,22,10,1037,1105,2142,3504
0130-001,2011,6,22,11,1127,1064,2191,2142
0130-001,2011,6,22,12,1314,1327,2641,2191
0130-001,2011,6,22,13,1553,1645,3198,2641
0130-001,2011,6,22,14,1473,1454,2927,3198
0130-001,2011,6,22,15,1705,1673,3378,2927
0130-001,2011,6,22,16,1675,1681,3356,3378
0130-001,2011,6,22,17,1529,1609,3138,3356
0130-001,2011,6,22,18,1837,2337,4174,3138
0130-001,2011,6,22,19,1450,1829,3279,4174
0130-001,2011,6,22,20,1213,1561,2774,3279
0130-001,2011,6,22,21,984,1136,2120,2774
0130-001,2011,6,22,22,1145,1078,2223,2120
0130-001,2011,6,22,23,966,728,1694,2223
0130-001,2011,6,22,24,603,488,1091,1694
0130-001,2011,6,23,1,560,428,988,1091
0130-001,2011,6,23,2,279,221,500,988
0130-001,2011,6,23,3,216,203,419,500
0130-001,2011,6,23,4,188,214,402,419
0130-001,2011,6,23,5,184,249,433,402
0130-001,2011,6,23,6,277,324,601,433
0130-001,2011,6,23,7,802,548,1350,601
0130-001,2011,6,23,8,1590,1088,2678,1350
0130-001,2011,6,23,9,1586,1455,3041,2678
0130-001,2011,6,23,10,1143,1171,2314,3041
0130-001,2011,6,23,11,816,792,1608,2314
0130-001,2011,6,23,12,866,950,1816,1608
0130-001,2011,6,23,13,798,819,1617,1816
0130-001,2011,6,23,14,726,705,1431,1617
0130-001,2011,6,23,15,942,959,1901,1431
0130-001,2011,6,23,16,786,753,1539,1901
0130-001,2011,6,23,17,979,1034,2013,1539
0130-001,2011,6,23,18,962,1222,2184,2013
0130-001,2011,6,23,19,932,1403,2335,2184
0130-001,2011,6,23,20,637,798,1435,2335
0130-001,2011,6,23,21,662,710,1372,1435
0130-001,2011,6,23,22,703,695,1398,1372
0130-001,2011,6,23,23,617,501,1118,1398
0130-001,2011,6,23,24,363,295,658,1118
0130-001,2011,6,24,1,306,244,550,658
0130-001,2011,6,24,2,170,139,309,550
0130-001,2011,6,24,3,169,151,320,309
0130-001,2011,6,24,4,158,160,318,320
0130-001,2011,6,24,5,129,184,313,318
0130-001,2011,6,24,6,321,337,658,313
0130-001,2011,6,24,7,801,593,1394,658
0130-001,2011,6,24,8,966,667,1633,1394
0130-001,2011,6,24,9,1070,1023,2093,1633
0130-001,2011,6,24,10,962,1031,1993,2093
0130-001,2011,6,24,11,1111,1074,2185,1993
0130-001,2011,6,24,12,980,997,1977,2185
0130-001,2011,6,24,13,1064,1195,2259,1977
0130-001,2011,6,24,14,983,1031,2014,2259
0130-001,2011,6,24,15,1046,1099,2145,2014
0130-001,2011,6,24,16,1283,1372,2655,2145
0130-001,2011,6,24,17,974,1002,1976,2655
0130-001,2011,6,24,18,935,1147,2082,1976
0130-001,2011,6,24,19,644,792,1436,2082
0130-001,2011,6,24,20,924,1219,2143,1436
0130-001,2011,6,24,21,813,1022,1835,2143
0130-001,2011,6,24,22,905,861,1766,1835
0130-001,2011,6,24,23,1013,730,1743,1766
0130-001,2011,6,24,24,584,425,1009,1743
0130-001,2011,6,25,1,456,352,808,1009
0130-001,2011,6,25,2,321,259,580,808
0130-001,2011,6,25,3,232,229,461,580
0130-001,2011,6,25,4,184,173,357,461
0130-001,2011,6,25,5,206,238,444,357
0130-001,2011,6,25,6,260,274,534,444
0130-001,2011,6,25,7,602,531,1133,534
0130-001,2011,6,25,8,1067,829,1896,1133
0130-001,2011,6,25,9,1463,1330,2793,1896
0130-001,2011,6,25,10,1463,1537,3000,2793
0130-001,2011,6,25,11,1732,1964,3696,3000
0130-001,2011,6,25,12,1722,2149,3871,3696
0130-001,2011,6,25,13,1530,2203,3733,3871
0130-001,2011,6,25,14,1556,1839,3395,3733
0130-001,2011,6,25,15,1558,1696,3254,3395
0130-001,2011,6,25,16,1494,1660,3154,3254
0130-001,2011,6,25,17,1538,1455,2993,3154
0130-001,2011,6,25,18,1741,1645,3386,2993
0130-001,2011,6,25,19,1389,1509,2898,3386
0130-001,2011,6,25,20,1314,1177,2491,2898
0130-001,2011,6,25,21,909,801,1710,2491
0130-001,2011,6,25,22,945,778,1723,1710
0130-001,2011,6,25,23,1147,843,1990,1723
0130-001,2011,6,25,24,692,557,1249,1990
0130-001,2011,6,26,1,366,307,673,1249
0130-001,2011,6,26,2,300,274,574,673
0130-001,2011,6,26,3,264,226,490,574
0130-001,2011,6,26,4,203,139,342,490
0130-001,2011,6,26,5,142,160,302,342
0130-001,2011,6,26,6,214,252,466,302
0130-001,2011,6,26,7,355,274,629,466
0130-001,2011,6,26,8,486,435,921,629
0130-001,2011,6,26,9,551,656,1207,921
0130-001,2011,6,26,10,482,526,1008,1207
0130-001,2011,6,26,11,866,1082,1948,1008
0130-001,2011,6,26,12,789,977,1766,1948
0130-001,2011,6,26,13,807,960,1767,1766
0130-001,2011,6,26,14,1147,1216,2363,1767
0130-001,2011,6,26,15,1233,1341,2574,2363
0130-001,2011,6,26,16,1563,1397,2960,2574
0130-001,2011,6,26,17,1177,995,2172,2960
0130-001,2011,6,26,18,1424,1384,2808,2172
0130-001,2011,6,26,19,1351,1215,2566,2808
0130-001,2011,6,26,20,1150,969,2119,2566
0130-001,2011,6,26,21,945,749,1694,2119
0130-001,2011,6,26,22,870,603,1473,1694
0130-001,2011,6,26,23,589,441,1030,1473
0130-001,2011,6,26,24,388,256,644,1030
0130-001,2011,6,27,1,256,181,437,644
0130-001,2011,6,27,2,184,147,331,437
0130-001,2011,6,27,3,149,129,278,331
0130-001,2011,6,27,4,137,111,248,278
0130-001,2011,6,27,5,173,239,412,248
0130-001,2011,6,27,6,444,503,947,412
0130-001,2011,6,27,7,1028,702,1730,947
0130-001,2011,6,27,8,1204,796,2000,1730
0130-001,2011,6,27,9,1807,1678,3485,2000
0130-001,2011,6,27,10,903,933,1836,3485
0130-001,2011,6,27,11,879,855,1734,1836
0130-001,2011,6,27,12,764,760,1524,1734
0130-001,2011,6,27,13,1251,1329,2580,1524
0130-001,2011,6,27,14,1249,1183,2432,2580
0130-001,2011,6,27,15,1669,1597,3266,2432
0130-001,2011,6,27,16,1239,1210,2449,3266
0130-001,2011,6,27,17,1242,1317,2559,2449
0130-001,2011,6,27,18,1410,1728,3138,2559
0130-001,2011,6,27,19,1821,2381,4202,3138
0130-001,2011,6,27,20,1002,1243,2245,4202
0130-001,2011,6,27,21,1025,1376,2401,2245
0130-001,2011,6,27,22,1025,1067,2092,2401
0130-001,2011,6,27,23,771,638,1409,2092
0130-001,2011,6,27,24,813,587,1400,1409
0130-001,2011,6,28,1,410,373,783,1400
0130-001,2011,6,28,2,351,315,666,783
0130-001,2011,6,28,3,188,175,363,666
0130-001,2011,6,28,4,277,293,570,363
0130-001,2011,6,28,5,252,310,562,570
0130-001,2011,6,28,6,306,354,660,562
0130-001,2011,6,28,7,1260,825,2085,660
0130-001,2011,6,28,8,1686,1151,2837,2085
0130-001,2011,6,28,9,1574,1446,3020,2837
0130-001,2011,6,28,10,1651,1680,3331,3020
0130-001,2011,6,28,11,1818,1780,3598,3331
0130-001,2011,6,28,12,1407,1455,2862,3598
0130-001,2011,6,28,13,1519,1600,3119,2862
0130-001,2011,6,28,14,1198,1102,2300,3119
0130-001,2011,6,28,15,1589,1660,3249,2300
0130-001,2011,6,28,16,1747,1680,3427,3249
0130-001,2011,6,28,17,1770,1860,3630,3427
0130-001,2011,6,28,18,1204,1473,2677,3630
0130-001,2011,6,28,19,1818,2615,4433,2677
0130-001,2011,6,28,20,1877,2278,4155,4433
0130-001,2011,6,28,21,1909,2267,4176,4155
0130-001,2011,6,28,22,1862,2001,3863,4176
0130-001,2011,6,28,23,1097,877,1974,3863
0130-001,2011,6,28,24,728,542,1270,1974
0130-001,2011,6,29,1,715,625,1340,1270
0130-001,2011,6,29,2,288,250,538,1340
0130-001,2011,6,29,3,220,190,410,538
0130-001,2011,6,29,4,139,129,268,410
0130-001,2011,6,29,5,250,324,574,268
0130-001,2011,6,29,6,366,425,791,574
0130-001,2011,6,29,7,1251,789,2040,791
0130-001,2011,6,29,8,2723,1887,4610,2040
0130-001,2011,6,29,9,2525,2340,4865,4610
0130-001,2011,6,29,10,2247,2370,4617,4865
0130-001,2011,6,29,11,2006,1895,3901,4617
0130-001,2011,6,29,12,1493,1508,3001,3901
0130-001,2011,6,29,13,1645,1744,3389,3001
0130-001,2011,6,29,14,1719,1696,3415,3389
0130-001,2011,6,29,15,2092,2051,4143,3415
0130-001,2011,6,29,16,1809,1818,3627,4143
0130-001,2011,6,29,17,1076,1133,2209,3627
0130-001,2011,6,29,18,1535,1975,3510,2209
0130-001,2011,6,29,19,1415,1786,3201,3510
0130-001,2011,6,29,20,1195,1538,2733,3201
0130-001,2011,6,29,21,733,848,1581,2733
0130-001,2011,6,29,22,1063,1001,2064,1581
0130-001,2011,6,29,23,632,477,1109,2064
0130-001,2011,6,29,24,199,161,360,1109
0130-001,2011,6,30,1,306,234,540,360
0130-001,2011,6,30,2,145,116,261,540
0130-001,2011,6,30,3,242,227,469,261
0130-001,2011,6,30,4,184,209,393,469
0130-001,2011,6,30,5,196,267,463,393
0130-001,2011,6,30,6,270,316,586,463
0130-001,2011,6,30,7,965,658,1623,586
0130-001,2011,6,30,8,1720,1168,2888,1623
0130-001,2011,6,30,9,1665,1545,3210,2888
0130-001,2011,6,30,10,1589,1628,3217,3210
0130-001,2011,6,30,11,1744,1691,3435,3217
0130-001,2011,6,30,12,1517,1662,3179,3435
0130-001,2011,6,30,13,1448,1483,2931,3179
0130-001,2011,6,30,14,1579,1534,3113,2931
0130-001,2011,6,30,15,1836,1866,3702,3113
0130-001,2011,6,30,16,1947,1890,3837,3702
0130-001,2011,6,30,17,1681,1774,3455,3837
0130-001,2011,6,30,18,1658,2107,3765,3455
0130-001,2011,6,30,19,1827,2727,4554,3765
0130-001,2011,6,30,20,1415,1774,3189,4554
0130-001,2011,6,30,21,1508,1612,3120,3189
0130-001,2011,6,30,22,1473,1455,2928,3120
0130-001,2011,6,30,23,1179,956,2135,2928
0130-001,2011,6,30,24,620,503,1123,2135
0130-001,2011,7,1,1,574,497,1071,1123
0130-001,2011,7,1,2,413,352,765,1071
0130-001,2011,7,1,3,321,270,591,765
0130-001,2011,7,1,4,220,247,467,591
0130-001,2011,7,1,5,324,477,801,467
0130-001,2011,7,1,6,477,494,971,801
0130-001,2011,7,1,7,1526,1027,2553,971
0130-001,2011,7,1,8,1878,1443,3321,2553
0130-001,2011,7,1,9,1008,909,1917,3321
0130-001,2011,7,1,10,1138,1151,2289,1917
0130-001,2011,7,1,11,1093,997,2090,2289
0130-001,2011,7,1,12,1486,1537,3023,2090
0130-001,2011,7,1,13,1341,1395,2736,3023
0130-001,2011,7,1,14,1172,1266,2438,2736
0130-001,2011,7,1,15,1052,1061,2113,2438
0130-001,2011,7,1,16,1141,1243,2384,2113
0130-001,2011,7,1,17,1603,1680,3283,2384
0130-001,2011,7,1,18,1237,1502,2739,3283
0130-001,2011,7,1,19,1749,2140,3889,2739
0130-001,2011,7,1,20,1290,1614,2904,3889
0130-001,2011,7,1,21,1365,1746,3111,2904
0130-001,2011,7,1,22,1153,1257,2410,3111
0130-001,2011,7,1,23,1297,1139,2436,2410
0130-001,2011,7,1,24,884,738,1622,2436
0130-001,2011,7,2,1,590,504,1094,1622
0130-001,2011,7,2,2,425,375,800,1094
0130-001,2011,7,2,3,322,300,622,800
0130-001,2011,7,2,4,229,239,468,622
0130-001,2011,7,2,5,279,288,567,468
0130-001,2011,7,2,6,438,497,935,567
0130-001,2011,7,2,7,1305,1028,2333,935
0130-001,2011,7,2,8,2016,1778,3794,2333
0130-001,2011,7,2,9,2173,1975,4148,3794
0130-001,2011,7,2,10,1695,1693,3388,4148
0130-001,2011,7,2,11,1773,2114,3887,3388
0130-001,2011,7,2,12,1854,2406,4260,3887
0130-001,2011,7,2,13,2352,3196,5548,4260
0130-001,2011,7,2,14,2697,3291,5988,5548
0130-001,2011,7,2,15,2697,3114,5811,5988
0130-001,2011,7,2,16,2638,3107,5745,5811
0130-001,2011,7,2,17,2066,2208,4274,5745
0130-001,2011,7,2,18,1899,2000,3899,4274
0130-001,2011,7,2,19,1737,1827,3564,3899
0130-001,2011,7,2,20,1535,1778,3313,3564
0130-001,2011,7,2,21,1406,1216,2622,3313
0130-001,2011,7,2,22,1427,1184,2611,2622
0130-001,2011,7,2,23,1264,1111,2375,2611
0130-001,2011,7,2,24,775,625,1400,2375
0130-001,2011,7,3,1,584,464,1048,1400
0130-001,2011,7,3,2,387,330,717,1048
0130-001,2011,7,3,3,315,275,590,717
0130-001,2011,7,3,4,238,196,434,590
0130-001,2011,7,3,5,191,176,367,434
0130-001,2011,7,3,6,262,289,551,367
0130-001,2011,7,3,7,523,482,1005,551
0130-001,2011,7,3,8,692,713,1405,1005
0130-001,2011,7,3,9,775,858,1633,1405
0130-001,2011,7,3,10,965,1165,2130,1633
0130-001,2011,7,3,11,1060,1273,2333,2130
0130-001,2011,7,3,12,992,1225,2217,2333
0130-001,2011,7,3,13,1076,1067,2143,2217
0130-001,2011,7,3,14,977,846,1823,2143
0130-001,2011,7,3,15,1356,1186,2542,1823
0130-001,2011,7,3,16,1530,1135,2665,2542
0130-001,2011,7,3,17,1576,1166,2742,2665
0130-001,2011,7,3,18,1412,1067,2479,2742
0130-001,2011,7,3,19,1454,957,2411,2479
0130-001,2011,7,3,20,1074,778,1852,2411
0130-001,2011,7,3,21,956,796,1752,1852
0130-001,2011,7,3,22,1001,713,1714,1752
0130-001,2011,7,3,23,662,480,1142,1714
0130-001,2011,7,3,24,506,405,911,1142
0130-001,2011,7,4,1,293,274,567,911
0130-001,2011,7,4,2,232,208,440,567
0130-001,2011,7,4,3,170,175,345,440
0130-001,2011,7,4,4,143,127,270,345
0130-001,2011,7,4,5,149,235,384,270
0130-001,2011,7,4,6,373,425,798,384
0130-001,2011,7,4,7,1305,802,2107,798
0130-001,2011,7,4,8,2054,1475,3529,2107
0130-001,2011,7,4,9,1953,1937,3890,3529
0130-001,2011,7,4,10,1633,1603,3236,3890
0130-001,2011,7,4,11,1650,1552,3202,3236
0130-001,2011,7,4,12,1552,1570,3122,3202
0130-001,2011,7,4,13,1576,1563,3139,3122
0130-001,2011,7,4,14,2113,2092,4205,3139
0130-001,2011,7,4,15,1877,1807,3684,4205
0130-001,2011,7,4,16,1937,2056,3993,3684
0130-001,2011,7,4,17,2009,2147,4156,3993
0130-001,2011,7,4,18,2554,3172,5726,4156
0130-001,2011,7,4,19,2986,3779,6765,5726
0130-001,2011,7,4,20,2361,2912,5273,6765
0130-001,2011,7,4,21,2259,3204,5463,5273
0130-001,2011,7,4,22,1972,2080,4052,5463
0130-001,2011,7,4,23,1579,1379,2958,4052
0130-001,2011,7,4,24,957,936,1893,2958
0130-001,2011,7,5,1,652,474,1126,1893
0130-001,2011,7,5,2,417,358,775,1126
0130-001,2011,7,5,3,351,346,697,775
0130-001,2011,7,5,4,274,244,518,697
0130-001,2011,7,5,5,334,508,842,518
0130-001,2011,7,5,6,702,826,1528,842
0130-001,2011,7,5,7,2054,1348,3402,1528
0130-001,2011,7,5,8,3056,2282,5338,3402
0130-001,2011,7,5,9,2907,2934,5841,5338
0130-001,2011,7,5,10,1818,1842,3660,5841
0130-001,2011,7,5,11,1829,1647,3476,3660
0130-001,2011,7,5,12,1563,1552,3115,3476
0130-001,2011,7,5,13,917,906,1823,3115
0130-001,2011,7,5,14,1015,1070,2085,1823
0130-001,2011,7,5,15,1189,1195,2384,2085
0130-001,2011,7,5,16,1001,1064,2065,2384
0130-001,2011,7,5,17,862,897,1759,2065
0130-001,2011,7,5,18,1224,1558,2782,1759
0130-001,2011,7,5,19,1953,2339,4292,2782
0130-001,2011,7,5,20,1786,2457,4243,4292
0130-001,2011,7,5,21,1165,1473,2638,4243
0130-001,2011,7,5,22,724,759,1483,2638
0130-001,2011,7,5,23,534,458,992,1483
0130-001,2011,7,5,24,390,339,729,992
0130-001,2011,7,6,1,349,310,659,729
0130-001,2011,7,6,2,187,151,338,659
0130-001,2011,7,6,3,193,184,377,338
0130-001,2011,7,6,4,194,191,385,377
0130-001,2011,7,6,5,169,262,431,385
0130-001,2011,7,6,6,306,351,657,431
0130-001,2011,7,6,7,884,599,1483,657
0130-001,2011,7,6,8,1325,928,2253,1483
0130-001,2011,7,6,9,1156,1129,2285,2253
0130-001,2011,7,6,10,1225,1497,2722,2285
0130-001,2011,7,6,11,1081,912,1993,2722
0130-001,2011,7,6,12,1198,1233,2431,1993
0130-001,2011,7,6,13,1340,1381,2721,2431
0130-001,2011,7,6,14,1210,1264,2474,2721
0130-001,2011,7,6,15,928,947,1875,2474
0130-001,2011,7,6,16,649,665,1314,1875
0130-001,2011,7,6,17,1114,1159,2273,1314
0130-001,2011,7,6,18,1967,2631,4598,2273
0130-001,2011,7,6,19,1391,1863,3254,4598
0130-001,2011,7,6,20,1034,1266,2300,3254
0130-001,2011,7,6,21,731,846,1577,2300
0130-001,2011,7,6,22,652,616,1268,1577
0130-001,2011,7,6,23,667,632,1299,1268
0130-001,2011,7,6,24,432,387,819,1299
0130-001,2011,7,7,1,235,194,429,819
0130-001,2011,7,7,2,184,143,327,429
0130-001,2011,7,7,3,160,129,289,327
0130-001,2011,7,7,4,121,118,239,289
0130-001,2011,7,7,5,151,246,397,239
0130-001,2011,7,7,6,226,268,494,397
0130-001,2011,7,7,7,575,381,956,494
0130-001,2011,7,7,8,1353,975,2328,956
0130-001,2011,7,7,9,1568,1553,3121,2328
0130-001,2011,7,7,10,1410,1446,2856,3121
0130-001,2011,7,7,11,1392,1345,2737,2856
0130-001,2011,7,7,12,1348,1389,2737,2737
0130-001,2011,7,7,13,1249,1233,2482,2737
0130-001,2011,7,7,14,1443,1350,2793,2482
0130-001,2011,7,7,15,1672,1720,3392,2793
0130-001,2011,7,7,16,1627,1717,3344,3392
0130-001,2011,7,7,17,1494,1604,3098,3344
0130-001,2011,7,7,18,1461,1720,3181,3098
0130-001,2011,7,7,19,1502,1993,3495,3181
0130-001,2011,7,7,20,1209,1421,2630,3495
0130-001,2011,7,7,21,1133,1440,2573,2630
0130-001,2011,7,7,22,983,1010,1993,2573
0130-001,2011,7,7,23,924,862,1786,1993
0130-001,2011,7,7,24,570,492,1062,1786
0130-001,2011,7,8,1,438,390,828,1062
0130-001,2011,7,8,2,267,205,472,828
0130-001,2011,7,8,3,213,214,427,472
0130-001,2011,7,8,4,199,221,420,427
0130-001,2011,7,8,5,238,319,557,420
0130-001,2011,7,8,6,351,431,782,557
0130-001,2011,7,8,7,1165,738,1903,782
0130-001,2011,7,8,8,2387,1696,4083,1903
0130-001,2011,7,8,9,2236,2173,4409,4083
0130-001,2011,7,8,10,1804,1669,3473,4409
0130-001,2011,7,8,11,2232,2393,4625,3473
0130-001,2011,7,8,12,1914,1958,3872,4625
0130-001,2011,7,8,13,1318,1422,2740,3872
0130-001,2011,7,8,14,1573,1552,3125,2740
0130-001,2011,7,8,15,1541,1487,3028,3125
0130-001,2011,7,8,16,1614,1741,3355,3028
0130-001,2011,7,8,17,1568,1650,3218,3355
0130-001,2011,7,8,18,1793,2119,3912,3218
0130-001,2011,7,8,19,1815,2193,4008,3912
0130-001,2011,7,8,20,1771,2453,4224,4008
0130-001,2011,7,8,21,1684,2051,3735,4224
0130-001,2011,7,8,22,1654,1647,3301,3735
0130-001,2011,7,8,23,1145,950,2095,3301
0130-001,2011,7,8,24,749,580,1329,2095
0130-001,2011,7,9,1,537,446,983,1329
0130-001,2011,7,9,2,402,373,775,983
0130-001,2011,7,9,3,313,260,573,775
0130-001,2011,7,9,4,322,310,632,573
0130-001,2011,7,9,5,198,238,436,632
0130-001,2011,7,9,6,316,352,668,436
0130-001,2011,7,9,7,697,534,1231,668
0130-001,2011,7,9,8,1401,1106,2507,1231
0130-001,2011,7,9,9,1547,1552,3099,2507
0130-001,2011,7,9,10,1637,1793,3430,3099
0130-001,2011,7,9,11,1761,2078,3839,3430
0130-001,2011,7,9,12,1464,1600,3064,3839
0130-001,2011,7,9,13,1484,1982,3466,3064
0130-001,2011,7,9,14,1501,1850,3351,3466
0130-001,2011,7,9,15,1686,2044,3730,3351
0130-001,2011,7,9,16,1358,1475,2833,3730
0130-001,2011,7,9,17,1243,1269,2512,2833
0130-001,2011,7,9,18,1606,1731,3337,2512
0130-001,2011,7,9,19,1417,1424,2841,3337
0130-001,2011,7,9,20,1184,1230,2414,2841
0130-001,2011,7,9,21,924,881,1805,2414
0130-001,2011,7,9,22,753,595,1348,1805
0130-001,2011,7,9,23,453,362,815,1348
0130-001,2011,7,9,24,381,286,667,815
0130-001,2011,7,10,1,283,235,518,667
0130-001,2011,7,10,2,188,173,361,518
0130-001,2011,7,10,3,202,155,357,361
0130-001,2011,7,10,4,160,134,294,357
0130-001,2011,7,10,5,172,193,365,294
0130-001,2011,7,10,6,234,270,504,365
0130-001,2011,7,10,7,387,360,747,504
0130-001,2011,7,10,8,432,434,866,747
0130-001,2011,7,10,9,564,731,1295,866
0130-001,2011,7,10,10,796,903,1699,1295
0130-001,2011,7,10,11,852,1010,1862,1699
0130-001,2011,7,10,12,731,884,1615,1862
0130-001,2011,7,10,13,877,820,1697,1615
0130-001,2011,7,10,14,887,746,1633,1697
0130-001,2011,7,10,15,997,780,1777,1633
0130-001,2011,7,10,16,1129,935,2064,1777
0130-001,2011,7,10,17,1038,831,1869,2064
0130-001,2011,7,10,18,1233,945,2178,1869
0130-001,2011,7,10,19,1557,960,2517,2178
0130-001,2011,7,10,20,1279,1004,2283,2517
0130-001,2011,7,10,21,921,731,1652,2283
0130-001,2011,7,10,22,790,534,1324,1652
0130-001,2011,7,10,23,569,416,985,1324
0130-001,2011,7,10,24,431,322,753,985
0130-001,2011,7,11,1,292,224,516,753
0130-001,2011,7,11,2,166,129,295,516
0130-001,2011,7,11,3,145,160,305,295
0130-001,2011,7,11,4,103,96,199,305
0130-001,2011,7,11,5,152,206,358,199
0130-001,2011,7,11,6,355,369,724,358
0130-001,2011,7,11,7,1187,753,1940,724
0130-001,2011,7,11,8,1821,1261,3082,1940
0130-001,2011,7,11,9,1767,1732,3499,3082
0130-001,2011,7,11,10,1556,1607,3163,3499
0130-001,2011,7,11,11,1532,1445,2977,3163
0130-001,2011,7,11,12,1497,1457,2954,2977
0130-001,2011,7,11,13,1255,1261,2516,2954
0130-001,2011,7,11,14,1285,1276,2561,2516
0130-001,2011,7,11,15,1330,1363,2693,2561
0130-001,2011,7,11,16,1443,1491,2934,2693
0130-001,2011,7,11,17,966,1004,1970,2934
0130-001,2011,7,11,18,1205,1483,2688,1970
0130-001,2011,7,11,19,1553,1961,3514,2688
0130-001,2011,7,11,20,1279,1639,2918,3514
0130-001,2011,7,11,21,954,1212,2166,2918
0130-001,2011,7,11,22,951,1073,2024,2166
0130-001,2011,7,11,23,685,634,1319,2024
0130-001,2011,7,11,24,405,367,772,1319
0130-001,2011,7,12,1,319,280,599,772
0130-001,2011,7,12,2,213,173,386,599
0130-001,2011,7,12,3,158,145,303,386
0130-001,2011,7,12,4,142,131,273,303
0130-001,2011,7,12,5,121,175,296,273
0130-001,2011,7,12,6,292,339,631,296
0130-001,2011,7,12,7,1031,748,1779,631
0130-001,2011,7,12,8,1669,1204,2873,1779
0130-001,2011,7,12,9,1813,1740,3553,2873
0130-001,2011,7,12,10,1469,1409,2878,3553
0130-001,2011,7,12,11,1333,1276,2609,2878
0130-001,2011,7,12,12,902,864,1766,2609
0130-001,2011,7,12,13,1210,1227,2437,1766
0130-001,2011,7,12,14,965,945,1910,2437
0130-001,2011,7,12,15,980,1048,2028,1910
0130-001,2011,7,12,16,990,1007,1997,2028
0130-001,2011,7,12,17,984,1063,2047,1997
0130-001,2011,7,12,18,1161,1410,2571,2047
0130-001,2011,7,12,19,1643,2072,3715,2571
0130-001,2011,7,12,20,1209,1487,2696,3715
0130-001,2011,7,12,21,932,1156,2088,2696
0130-001,2011,7,12,22,909,957,1866,2088
0130-001,2011,7,12,23,506,431,937,1866
0130-001,2011,7,12,24,423,331,754,937
0130-001,2011,7,13,1,286,234,520,754
0130-001,2011,7,13,2,268,257,525,520
0130-001,2011,7,13,3,173,170,343,525
0130-001,2011,7,13,4,137,142,279,343
0130-001,2011,7,13,5,161,262,423,279
0130-001,2011,7,13,6,288,289,577,423
0130-001,2011,7,13,7,1159,823,1982,577
0130-001,2011,7,13,8,1412,1025,2437,1982
0130-001,2011,7,13,9,1374,1317,2691,2437
0130-001,2011,7,13,10,1147,1216,2363,2691
0130-001,2011,7,13,11,1570,1579,3149,2363
0130-001,2011,7,13,12,1290,1234,2524,3149
0130-001,2011,7,13,13,1040,1114,2154,2524
0130-001,2011,7,13,14,1304,1273,2577,2154
0130-001,2011,7,13,15,1163,1198,2361,2577
0130-001,2011,7,13,16,1139,1161,2300,2361
0130-001,2011,7,13,17,1683,1860,3543,2300
0130-001,2011,7,13,18,1446,1913,3359,3543
0130-001,2011,7,13,19,1630,2233,3863,3359
0130-001,2011,7,13,20,1547,1839,3386,3863
0130-001,2011,7,13,21,1242,1351,2593,3386
0130-001,2011,7,13,22,1284,1263,2547,2593
0130-001,2011,7,13,23,876,738,1614,2547
0130-001,2011,7,13,24,688,592,1280,1614
0130-001,2011,7,14,1,278,256,534,1280
0130-001,2011,7,14,2,223,182,405,534
0130-001,2011,7,14,3,182,167,349,405
0130-001,2011,7,14,4,140,156,296,349
0130-001,2011,7,14,5,140,220,360,296
0130-001,2011,7,14,6,275,326,601,360
0130-001,2011,7,14,7,775,540,1315,601
0130-001,2011,7,14,8,1392,1000,2392,1315
0130-001,2011,7,14,9,1380,1317,2697,2392
0130-001,2011,7,14,10,1622,1628,3250,2697
0130-001,2011,7,14,11,1428,1414,2842,3250
0130-001,2011,7,14,12,1028,1034,2062,2842
0130-001,2011,7,14,13,1100,1150,2250,2062
0130-001,2011,7,14,14,1403,1454,2857,2250
0130-001,2011,7,14,15,1097,1132,2229,2857
0130-001,2011,7,14,16,1716,1648,3364,2229
0130-001,2011,7,14,17,1621,1698,3319,3364
0130-001,2011,7,14,18,1752,2298,4050,3319
0130-001,2011,7,14,19,1791,2296,4087,4050
0130-001,2011,7,14,20,1358,1747,3105,4087
0130-001,2011,7,14,21,1129,1368,2497,3105
0130-001,2011,7,14,22,1225,1305,2530,2497
0130-001,2011,7,14,23,906,749,1655,2530
0130-001,2011,7,14,24,584,477,1061,1655
0130-001,2011,7,15,1,381,312,693,1061
0130-001,2011,7,15,2,252,205,457,693
0130-001,2011,7,15,3,184,163,347,457
0130-001,2011,7,15,4,155,143,298,347
0130-001,2011,7,15,5,149,232,381,298
0130-001,2011,7,15,6,351,385,736,381
0130-001,2011,7,15,7,1069,749,1818,736
0130-001,2011,7,15,8,1287,936,2223,1818
0130-001,2011,7,15,9,1345,1261,2606,2223
0130-001,2011,7,15,10,1658,1660,3318,2606
0130-001,2011,7,15,11,1713,1687,3400,3318
0130-001,2011,7,15,12,1165,1202,2367,3400
0130-001,2011,7,15,13,1370,1440,2810,2367
0130-001,2011,7,15,14,1762,1877,3639,2810
0130-001,2011,7,15,15,1370,1350,2720,3639
0130-001,2011,7,15,16,1002,1013,2015,2720
0130-001,2011,7,15,17,1091,1198,2289,2015
0130-001,2011,7,15,18,1798,2166,3964,2289
0130-001,2011,7,15,19,1672,1972,3644,3964
0130-001,2011,7,15,20,1284,1737,3021,3644
0130-001,2011,7,15,21,861,1051,1912,3021
0130-001,2011,7,15,22,736,768,1504,1912
0130-001,2011,7,15,23,596,462,1058,1504
0130-001,2011,7,15,24,446,360,806,1058
0130-001,2011,7,16,1,319,253,572,806
0130-001,2011,7,16,2,306,244,550,572
0130-001,2011,7,16,3,214,198,412,550
0130-001,2011,7,16,4,190,173,363,412
0130-001,2011,7,16,5,217,256,473,363
0130-001,2011,7,16,6,354,387,741,473
0130-001,2011,7,16,7,859,680,1539,741
0130-001,2011,7,16,8,1866,1734,3600,1539
0130-001,2011,7,16,9,2232,2257,4489,3600
0130-001,2011,7,16,10,1822,2021,3843,4489
0130-001,2011,7,16,11,1704,2062,3766,3843
0130-001,2011,7,16,12,1568,1976,3544,3766
0130-001,2011,7,16,13,1532,1920,3452,3544
0130-001,2011,7,16,14,1487,1832,3319,3452
0130-001,2011,7,16,15,1559,1865,3424,3319
0130-001,2011,7,16,16,1768,2068,3836,3424
0130-001,2011,7,16,17,2086,2200,4286,3836
0130-001,2011,7,16,18,1851,1886,3737,4286
0130-001,2011,7,16,19,1919,1916,3835,3737
0130-001,2011,7,16,20,1726,1770,3496,3835
0130-001,2011,7,16,21,1919,1650,3569,3496
0130-001,2011,7,16,22,2036,1625,3661,3569
0130-001,2011,7,16,23,1337,1043,2380,3661
0130-001,2011,7,16,24,936,746,1682,2380
0130-001,2011,7,17,1,721,607,1328,1682
0130-001,2011,7,17,2,524,416,940,1328
0130-001,2011,7,17,3,292,277,569,940
0130-001,2011,7,17,4,303,247,550,569
0130-001,2011,7,17,5,267,265,532,550
0130-001,2011,7,17,6,474,574,1048,532
0130-001,2011,7,17,7,742,632,1374,1048
0130-001,2011,7,17,8,774,700,1474,1374
0130-001,2011,7,17,9,1041,1338,2379,1474
0130-001,2011,7,17,10,1282,1422,2704,2379
0130-001,2011,7,17,11,1177,1525,2702,2704
0130-001,2011,7,17,12,1209,1504,2713,2702
0130-001,2011,7,17,13,1172,1257,2429,2713
0130-001,2011,7,17,14,1239,1136,2375,2429
0130-001,2011,7,17,15,1325,1093,2418,2375
0130-001,2011,7,17,16,1417,1143,2560,2418
0130-001,2011,7,17,17,1161,951,2112,2560
0130-001,2011,7,17,18,914,680,1594,2112
0130-001,2011,7,17,19,789,551,1340,1594
0130-001,2011,7,17,20,760,575,1335,1340
0130-001,2011,7,17,21,899,697,1596,1335
0130-001,2011,7,17,22,566,402,968,1596
0130-001,2011,7,17,23,351,265,616,968
0130-001,2011,7,17,24,372,292,664,616
0130-001,2011,7,18,1,216,161,377,664
0130-001,2011,7,18,2,161,154,315,377
0130-001,2011,7,18,3,118,110,228,315
0130-001,2011,7,18,4,83,88,171,228
0130-001,2011,7,18,5,111,166,277,171
0130-001,2011,7,18,6,234,275,509,277
0130-001,2011,7,18,7,1012,662,1674,509
0130-001,2011,7,18,8,1304,923,2227,1674
0130-001,2011,7,18,9,1360,1350,2710,2227
0130-001,2011,7,18,10,984,1020,2004,2710
0130-001,2011,7,18,11,1151,1129,2280,2004
0130-001,2011,7,18,12,895,947,1842,2280
0130-001,2011,7,18,13,705,659,1364,1842
0130-001,2011,7,18,14,685,692,1377,1364
0130-001,2011,7,18,15,851,840,1691,1377
0130-001,2011,7,18,16,625,662,1287,1691
0130-001,2011,7,18,17,792,861,1653,1287
0130-001,2011,7,18,18,829,1097,1926,1653
0130-001,2011,7,18,19,1087,1354,2441,1926
0130-001,2011,7,18,20,628,769,1397,2441
0130-001,2011,7,18,21,712,888,1600,1397
0130-001,2011,7,18,22,1033,1133,2166,1600
0130-001,2011,7,18,23,790,608,1398,2166
0130-001,2011,7,18,24,456,344,800,1398
0130-001,2011,7,19,1,334,285,619,800
0130-001,2011,7,19,2,239,208,447,619
0130-001,2011,7,19,3,157,140,297,447
0130-001,2011,7,19,4,163,161,324,297
0130-001,2011,7,19,5,185,249,434,324
0130-001,2011,7,19,6,420,470,890,434
0130-001,2011,7,19,7,1225,795,2020,890
0130-001,2011,7,19,8,2000,1415,3415,2020
0130-001,2011,7,19,9,816,753,1569,3415
0130-001,2011,7,19,10,998,1010,2008,1569
0130-001,2011,7,19,11,1133,1066,2199,2008
0130-001,2011,7,19,12,846,828,1674,2199
0130-001,2011,7,19,13,968,956,1924,1674
0130-001,2011,7,19,14,780,801,1581,1924
0130-001,2011,7,19,15,1069,1073,2142,1581
0130-001,2011,7,19,16,914,918,1832,2142
0130-001,2011,7,19,17,1097,1179,2276,1832
0130-001,2011,7,19,18,998,1272,2270,2276
0130-001,2011,7,19,19,1117,1572,2689,2270
0130-001,2011,7,19,20,882,1143,2025,2689
0130-001,2011,7,19,21,989,1179,2168,2025
0130-001,2011,7,19,22,1198,1216,2414,2168
0130-001,2011,7,19,23,912,751,1663,2414
0130-001,2011,7,19,24,640,500,1140,1663
0130-001,2011,7,20,1,410,336,746,1140
0130-001,2011,7,20,2,268,213,481,746
0130-001,2011,7,20,3,193,178,371,481
0130-001,2011,7,20,4,133,124,257,371
0130-001,2011,7,20,5,161,238,399,257
0130-001,2011,7,20,6,429,542,971,399
0130-001,2011,7,20,7,1201,895,2096,971
0130-001,2011,7,20,8,1908,1430,3338,2096
0130-001,2011,7,20,9,1830,1681,3511,3338
0130-001,2011,7,20,10,1476,1427,2903,3511
0130-001,2011,7,20,11,1055,1020,2075,2903
0130-001,2011,7,20,12,1073,1055,2128,2075
0130-001,2011,7,20,13,768,822,1590,2128
0130-001,2011,7,20,14,954,1012,1966,1590
0130-001,2011,7,20,15,917,938,1855,1966
0130-001,2011,7,20,16,1074,1002,2076,1855
0130-001,2011,7,20,17,655,679,1334,2076
0130-001,2011,7,20,18,873,1132,2005,1334
0130-001,2011,7,20,19,1192,1603,2795,2005
0130-001,2011,7,20,20,1130,1406,2536,2795
0130-001,2011,7,20,21,965,1091,2056,2536
0130-001,2011,7,20,22,683,602,1285,2056
0130-001,2011,7,20,23,590,488,1078,1285
0130-001,2011,7,20,24,396,313,709,1078
0130-001,2011,7,21,1,321,318,639,709
0130-001,2011,7,21,2,262,221,483,639
0130-001,2011,7,21,3,203,205,408,483
0130-001,2011,7,21,4,158,194,352,408
0130-001,2011,7,21,5,129,194,323,352
0130-001,2011,7,21,6,324,385,709,323
0130-001,2011,7,21,7,975,698,1673,709
0130-001,2011,7,21,8,1430,1025,2455,1673
0130-001,2011,7,21,9,1192,1081,2273,2455
0130-001,2011,7,21,10,1835,1810,3645,2273
0130-001,2011,7,21,11,1464,1484,2948,3645
0130-001,2011,7,21,12,709,679,1388,2948
0130-001,2011,7,21,13,652,687,1339,1388
0130-001,2011,7,21,14,754,780,1534,1339
0130-001,2011,7,21,15,930,956,1886,1534
0130-001,2011,7,21,16,930,912,1842,1886
0130-001,2011,7,21,17,643,698,1341,1842
0130-001,2011,7,21,18,582,628,1210,1341
0130-001,2011,7,21,19,1165,1133,2298,1210
0130-001,2011,7,21,20,1297,1640,2937,2298
0130-001,2011,7,21,21,1074,1386,2460,2937
0130-001,2011,7,21,22,1205,1318,2523,2460
0130-001,2011,7,21,23,948,917,1865,2523
0130-001,2011,7,21,24,683,523,1206,1865
0130-001,2011,7,22,1,411,328,739,1206
0130-001,2011,7,22,2,286,234,520,739
0130-001,2011,7,22,3,178,160,338,520
0130-001,2011,7,22,4,163,166,329,338
0130-001,2011,7,22,5,179,256,435,329
0130-001,2011,7,22,6,344,362,706,435
0130-001,2011,7,22,7,1161,861,2022,706
0130-001,2011,7,22,8,1517,1046,2563,2022
0130-001,2011,7,22,9,1657,1583,3240,2563
0130-001,2011,7,22,10,1227,1314,2541,3240
0130-001,2011,7,22,11,1333,1290,2623,2541
0130-001,2011,7,22,12,1445,1468,2913,2623
0130-001,2011,7,22,13,1246,1401,2647,2913
0130-001,2011,7,22,14,1535,1610,3145,2647
0130-001,2011,7,22,15,1592,1672,3264,3145
0130-001,2011,7,22,16,1457,1558,3015,3264
0130-001,2011,7,22,17,1395,1433,2828,3015
0130-001,2011,7,22,18,1714,2101,3815,2828
0130-001,2011,7,22,19,1440,1770,3210,3815
0130-001,2011,7,22,20,1001,1317,2318,3210
0130-001,2011,7,22,21,975,1225,2200,2318
0130-001,2011,7,22,22,923,877,1800,2200
0130-001,2011,7,22,23,753,542,1295,1800
0130-001,2011,7,22,24,549,399,948,1295
0130-001,2011,7,23,1,450,349,799,948
0130-001,2011,7,23,2,360,292,652,799
0130-001,2011,7,23,3,256,252,508,652
0130-001,2011,7,23,4,217,206,423,508
0130-001,2011,7,23,5,208,239,447,423
0130-001,2011,7,23,6,354,372,726,447
0130-001,2011,7,23,7,928,819,1747,726
0130-001,2011,7,23,8,1559,1212,2771,1747
0130-001,2011,7,23,9,1353,1230,2583,2771
0130-001,2011,7,23,10,1639,1720,3359,2583
0130-001,2011,7,23,11,1476,1673,3149,3359
0130-001,2011,7,23,12,1563,1950,3513,3149
0130-001,2011,7,23,13,1475,2121,3596,3513
0130-001,2011,7,23,14,1711,2021,3732,3596
0130-001,2011,7,23,15,1538,1675,3213,3732
0130-001,2011,7,23,16,1601,1780,3381,3213
0130-001,2011,7,23,17,1647,1556,3203,3381
0130-001,2011,7,23,18,1834,1729,3563,3203
0130-001,2011,7,23,19,1756,1908,3664,3563
0130-001,2011,7,23,20,1309,1174,2483,3664
0130-001,2011,7,23,21,1105,974,2079,2483
0130-001,2011,7,23,22,826,680,1506,2079
0130-001,2011,7,23,23,834,613,1447,1506
0130-001,2011,7,23,24,575,464,1039,1447
0130-001,2011,7,24,1,416,351,767,1039
0130-001,2011,7,24,2,280,256,536,767
0130-001,2011,7,24,3,209,178,387,536
0130-001,2011,7,24,4,199,136,335,387
0130-001,2011,7,24,5,198,223,421,335
0130-001,2011,7,24,6,229,270,499,421
0130-001,2011,7,24,7,429,331,760,499
0130-001,2011,7,24,8,539,482,1021,760
0130-001,2011,7,24,9,620,738,1358,1021
0130-001,2011,7,24,10,771,840,1611,1358
0130-001,2011,7,24,11,933,1166,2099,1611
0130-001,2011,7,24,12,957,1186,2143,2099
0130-001,2011,7,24,13,1102,1314,2416,2143
0130-001,2011,7,24,14,1345,1428,2773,2416
0130-001,2011,7,24,15,1586,1698,3284,2773
0130-001,2011,7,24,16,1825,1648,3473,3284
0130-001,2011,7,24,17,1347,1138,2485,3473
0130-001,2011,7,24,18,1496,1455,2951,2485
0130-001,2011,7,24,19,1404,1263,2667,2951
0130-001,2011,7,24,20,1141,962,2103,2667
0130-001,2011,7,24,21,1067,846,1913,2103
0130-001,2011,7,24,22,1085,751,1836,1913
0130-001,2011,7,24,23,659,495,1154,1836
0130-001,2011,7,24,24,488,321,809,1154
0130-001,2011,7,25,1,271,193,464,809
0130-001,2011,7,25,2,184,147,331,464
0130-001,2011,7,25,3,124,107,231,331
0130-001,2011,7,25,4,142,114,256,231
0130-001,2011,7,25,5,137,190,327,256
0130-001,2011,7,25,6,362,410,772,327
0130-001,2011,7,25,7,1249,852,2101,772
0130-001,2011,7,25,8,1931,1294,3225,2101
0130-001,2011,7,25,9,1544,1422,2966,3225
0130-001,2011,7,25,10,1448,1494,2942,2966
0130-001,2011,7,25,11,1340,1302,2642,2942
0130-001,2011,7,25,12,1343,1338,2681,2642
0130-001,2011,7,25,13,1338,1421,2759,2681
0130-001,2011,7,25,14,1509,1427,2936,2759
0130-001,2011,7,25,15,1481,1417,2898,2936
0130-001,2011,7,25,16,1607,1571,3178,2898
0130-001,2011,7,25,17,1332,1412,2744,3178
0130-001,2011,7,25,18,1475,1804,3279,2744
0130-001,2011,7,25,19,1811,2354,4165,3279
0130-001,2011,7,25,20,1407,1747,3154,4165
0130-001,2011,7,25,21,1276,1713,2989,3154
0130-001,2011,7,25,22,1115,1161,2276,2989
0130-001,2011,7,25,23,891,736,1627,2276
0130-001,2011,7,25,24,552,399,951,1627
0130-001,2011,7,26,1,362,307,669,951
0130-001,2011,7,26,2,270,234,504,669
0130-001,2011,7,26,3,184,163,347,504
0130-001,2011,7,26,4,149,147,296,347
0130-001,2011,7,26,5,167,224,391,296
0130-001,2011,7,26,6,381,428,809,391
0130-001,2011,7,26,7,1063,691,1754,809
0130-001,2011,7,26,8,1439,1007,2446,1754
0130-001,2011,7,26,9,892,823,1715,2446
0130-001,2011,7,26,10,1074,1085,2159,1715
0130-001,2011,7,26,11,841,790,1631,2159
0130-001,2011,7,26,12,1159,1135,2294,1631
0130-001,2011,7,26,13,885,876,1761,2294
0130-001,2011,7,26,14,1091,1117,2208,1761
0130-001,2011,7,26,15,1234,1239,2473,2208
0130-001,2011,7,26,16,1156,1163,2319,2473
0130-001,2011,7,26,17,1419,1523,2942,2319
0130-001,2011,7,26,18,1133,1442,2575,2942
0130-001,2011,7,26,19,1592,2286,3878,2575
0130-001,2011,7,26,20,1139,1478,2617,3878
0130-001,2011,7,26,21,1159,1383,2542,2617
0130-001,2011,7,26,22,1133,1151,2284,2542
0130-001,2011,7,26,23,702,578,1280,2284
0130-001,2011,7,26,24,428,334,762,1280
0130-001,2011,7,27,1,416,342,758,762
0130-001,2011,7,27,2,239,190,429,758
0130-001,2011,7,27,3,149,139,288,429
0130-001,2011,7,27,4,100,93,193,288
0130-001,2011,7,27,5,152,224,376,193
0130-001,2011,7,27,6,229,289,518,376
0130-001,2011,7,27,7,906,677,1583,518
0130-001,2011,7,27,8,1628,1222,2850,1583
0130-001,2011,7,27,9,1381,1291,2672,2850
0130-001,2011,7,27,10,1151,1114,2265,2672
0130-001,2011,7,27,11,1081,1045,2126,2265
0130-001,2011,7,27,12,1266,1245,2511,2126
0130-001,2011,7,27,13,1073,1148,2221,2511
0130-001,2011,7,27,14,1302,1381,2683,2221
0130-001,2011,7,27,15,1132,1156,2288,2683
0130-001,2011,7,27,16,674,628,1302,2288
0130-001,2011,7,27,17,1179,1224,2403,1302
0130-001,2011,7,27,18,1230,1594,2824,2403
0130-001,2011,7,27,19,1330,1763,3093,2824
0130-001,2011,7,27,20,969,1205,2174,3093
0130-001,2011,7,27,21,910,1030,1940,2174
0130-001,2011,7,27,22,989,870,1859,1940
0130-001,2011,7,27,23,829,687,1516,1859
0130-001,2011,7,27,24,431,340,771,1516
0130-001,2011,7,28,1,324,321,645,771
0130-001,2011,7,28,2,209,176,385,645
0130-001,2011,7,28,3,151,152,303,385
0130-001,2011,7,28,4,152,187,339,303
0130-001,2011,7,28,5,127,193,320,339
0130-001,2011,7,28,6,280,333,613,320
0130-001,2011,7,28,7,905,647,1552,613
0130-001,2011,7,28,8,1639,1174,2813,1552
0130-001,2011,7,28,9,1622,1469,3091,2813
0130-001,2011,7,28,10,1376,1358,2734,3091
0130-001,2011,7,28,11,1514,1534,3048,2734
0130-001,2011,7,28,12,1413,1355,2768,3048
0130-001,2011,7,28,13,957,1008,1965,2768
0130-001,2011,7,28,14,1030,1066,2096,1965
0130-001,2011,7,28,15,1746,1809,3555,2096
0130-001,2011,7,28,16,1742,1717,3459,3555
0130-001,2011,7,28,17,1368,1484,2852,3459
0130-001,2011,7,28,18,884,953,1837,2852
0130-001,2011,7,28,19,1493,1454,2947,1837
0130-001,2011,7,28,20,1454,1813,3267,2947
0130-001,2011,7,28,21,1251,1614,2865,3267
0130-001,2011,7,28,22,1139,1246,2385,2865
0130-001,2011,7,28,23,953,921,1874,2385
0130-001,2011,7,28,24,632,485,1117,1874
0130-001,2011,7,29,1,390,312,702,1117
0130-001,2011,7,29,2,268,220,488,702
0130-001,2011,7,29,3,203,181,384,488
0130-001,2011,7,29,4,154,155,309,384
0130-001,2011,7,29,5,172,244,416,309
0130-001,2011,7,29,6,298,313,611,416
0130-001,2011,7,29,7,856,634,1490,611
0130-001,2011,7,29,8,1735,1212,2947,1490
0130-001,2011,7,29,9,1640,1567,3207,2947
0130-001,2011,7,29,10,1597,1711,3308,3207
0130-001,2011,7,29,11,1601,1547,3148,3308
0130-001,2011,7,29,12,1609,1636,3245,3148
0130-001,2011,7,29,13,1358,1526,2884,3245
0130-001,2011,7,29,14,1579,1658,3237,2884
0130-001,2011,7,29,15,1740,1826,3566,3237
0130-001,2011,7,29,16,1737,1859,3596,3566
0130-001,2011,7,29,17,1678,1723,3401,3596
0130-001,2011,7,29,18,1658,2004,3662,3401
0130-001,2011,7,29,19,1592,1957,3549,3662
0130-001,2011,7,29,20,1370,1803,3173,3549
0130-001,2011,7,29,21,1371,1722,3093,3173
0130-001,2011,7,29,22,1293,1228,2521,3093
0130-001,2011,7,29,23,977,705,1682,2521
0130-001,2011,7,29,24,683,497,1180,1682
0130-001,2011,7,30,1,526,406,932,1180
0130-001,2011,7,30,2,264,213,477,932
0130-001,2011,7,30,3,234,231,465,477
0130-001,2011,7,30,4,216,205,421,465
0130-001,2011,7,30,5,223,256,479,421
0130-001,2011,7,30,6,319,336,655,479
0130-001,2011,7,30,7,807,712,1519,655
0130-001,2011,7,30,8,1296,1007,2303,1519
0130-001,2011,7,30,9,1430,1300,2730,2303
0130-001,2011,7,30,10,1460,1534,2994,2730
0130-001,2011,7,30,11,1491,1691,3182,2994
0130-001,2011,7,30,12,1401,1747,3148,3182
0130-001,2011,7,30,13,1381,1987,3368,3148
0130-001,2011,7,30,14,1293,1527,2820,3368
0130-001,2011,7,30,15,1501,1633,3134,2820
0130-001,2011,7,30,16,1570,1773,3343,3134
0130-001,2011,7,30,17,1215,1150,2365,3343
0130-001,2011,7,30,18,1487,1386,2873,2365
0130-001,2011,7,30,19,1504,1633,3137,2873
0130-001,2011,7,30,20,1043,936,1979,3137
0130-001,2011,7,30,21,1084,954,2038,1979
0130-001,2011,7,30,22,1100,906,2006,2038
0130-001,2011,7,30,23,813,598,1411,2006
0130-001,2011,7,30,24,539,434,973,1411
0130-001,2011,7,31,1,396,334,730,973
0130-001,2011,7,31,2,280,256,536,730
0130-001,2011,7,31,3,194,167,361,536
0130-001,2011,7,31,4,190,129,319,361
0130-001,2011,7,31,5,161,181,342,319
0130-001,2011,7,31,6,235,279,514,342
0130-001,2011,7,31,7,552,425,977,514
0130-001,2011,7,31,8,674,603,1277,977
0130-001,2011,7,31,9,947,1127,2074,1277
0130-001,2011,7,31,10,951,1037,1988,2074
0130-001,2011,7,31,11,1125,1407,2532,1988
0130-001,2011,7,31,12,877,1087,1964,2532
0130-001,2011,7,31,13,1020,1215,2235,1964
0130-001,2011,7,31,14,1135,1205,2340,2235
0130-001,2011,7,31,15,1202,1309,2511,2340
0130-001,2011,7,31,16,1636,1460,3096,2511
0130-001,2011,7,31,17,1782,1517,3299,3096
0130-001,2011,7,31,18,1792,1727,3519,3299
0130-001,2011,7,31,19,1720,1549,3269,3519
0130-001,2011,7,31,20,1353,1139,2492,3269
0130-001,2011,7,31,21,1269,1007,2276,2492
0130-001,2011,7,31,22,1010,698,1708,2276
0130-001,2011,7,31,23,683,513,1196,1708
0130-001,2011,7,31,24,515,339,854,1196
0130-001,2011,8,1,1,282,262,544,854
0130-001,2011,8,1,2,185,166,351,544
0130-001,2011,8,1,3,166,170,336,351
0130-001,2011,8,1,4,137,121,258,336
0130-001,2011,8,1,5,133,209,342,258
0130-001,2011,8,1,6,252,286,538,342
0130-001,2011,8,1,7,923,567,1490,538
0130-001,2011,8,1,8,1618,1161,2779,1490
0130-001,2011,8,1,9,1511,1499,3010,2779
0130-001,2011,8,1,10,1455,1427,2882,3010
0130-001,2011,8,1,11,1493,1404,2897,2882
0130-001,2011,8,1,12,1493,1511,3004,2897
0130-001,2011,8,1,13,1433,1421,2854,3004
0130-001,2011,8,1,14,1486,1472,2958,2854
0130-001,2011,8,1,15,1632,1573,3205,2958
0130-001,2011,8,1,16,1658,1760,3418,3205
0130-001,2011,8,1,17,1784,1919,3703,3418
0130-001,2011,8,1,18,1666,2071,3737,3703
0130-001,2011,8,1,19,1794,2262,4056,3737
0130-001,2011,8,1,20,1384,1708,3092,4056
0130-001,2011,8,1,21,1060,1502,2562,3092
0130-001,2011,8,1,22,1048,1105,2153,2562
0130-001,2011,8,1,23,814,712,1526,2153
0130-001,2011,8,1,24,519,508,1027,1526
0130-001,2011,8,2,1,349,253,602,1027
0130-001,2011,8,2,2,223,191,414,602
0130-001,2011,8,2,3,199,198,397,414
0130-001,2011,8,2,4,100,89,189,397
0130-001,2011,8,2,5,161,247,408,189
0130-001,2011,8,2,6,285,336,621,408
0130-001,2011,8,2,7,892,587,1479,621
0130-001,2011,8,2,8,1194,885,2079,1479
0130-001,2011,8,2,9,667,680,1347,2079
0130-001,2011,8,2,10,733,742,1475,1347
0130-001,2011,8,2,11,819,738,1557,1475
0130-001,2011,8,2,12,695,691,1386,1557
0130-001,2011,8,2,13,843,834,1677,1386
0130-001,2011,8,2,14,909,959,1868,1677
0130-001,2011,8,2,15,859,864,1723,1868
0130-001,2011,8,2,16,1172,1248,2420,1723
0130-001,2011,8,2,17,1632,1700,3332,2420
0130-001,2011,8,2,18,869,1106,1975,3332
0130-001,2011,8,2,19,628,753,1381,1975
0130-001,2011,8,2,20,692,953,1645,1381
0130-001,2011,8,2,21,1213,1535,2748,1645
0130-001,2011,8,2,22,1210,1266,2476,2748
0130-001,2011,8,2,23,811,694,1505,2476
0130-001,2011,8,2,24,500,434,934,1505
0130-001,2011,8,3,1,396,352,748,934
0130-001,2011,8,3,2,260,211,471,748
0130-001,2011,8,3,3,178,169,347,471
0130-001,2011,8,3,4,145,142,287,347
0130-001,2011,8,3,5,172,267,439,287
0130-001,2011,8,3,6,324,372,696,439
0130-001,2011,8,3,7,877,596,1473,696
0130-001,2011,8,3,8,1696,1202,2898,1473
0130-001,2011,8,3,9,1570,1530,3100,2898
0130-001,2011,8,3,10,1478,1780,3258,3100
0130-001,2011,8,3,11,1520,1282,2802,3258
0130-001,2011,8,3,12,1476,1519,2995,2802
0130-001,2011,8,3,13,1314,1355,2669,2995
0130-001,2011,8,3,14,1392,1455,2847,2669
0130-001,2011,8,3,15,1282,1308,2590,2847
0130-001,2011,8,3,16,1276,1308,2584,2590
0130-001,2011,8,3,17,528,551,1079,2584
0130-001,2011,8,3,18,372,497,869,1079
0130-001,2011,8,3,19,775,1038,1813,869
0130-001,2011,8,3,20,1363,1666,3029,1813
0130-001,2011,8,3,21,1340,1550,2890,3029
0130-001,2011,8,3,22,906,856,1762,2890
0130-001,2011,8,3,23,816,775,1591,1762
0130-001,2011,8,3,24,556,497,1053,1591
0130-001,2011,8,4,1,367,301,668,1053
0130-001,2011,8,4,2,220,172,392,668
0130-001,2011,8,4,3,185,149,334,392
0130-001,2011,8,4,4,169,161,330,334
0130-001,2011,8,4,5,172,280,452,330
0130-001,2011,8,4,6,319,380,699,452
0130-001,2011,8,4,7,1001,662,1663,699
0130-001,2011,8,4,8,1722,1242,2964,1663
0130-001,2011,8,4,9,1647,1632,3279,2964
0130-001,2011,8,4,10,1404,1440,2844,3279
0130-001,2011,8,4,11,1559,1505,3064,2844
0130-001,2011,8,4,12,1415,1460,2875,3064
0130-001,2011,8,4,13,1308,1291,2599,2875
0130-001,2011,8,4,14,798,748,1546,2599
0130-001,2011,8,4,15,1070,1087,2157,1546
0130-001,2011,8,4,16,1494,1577,3071,2157
0130-001,2011,8,4,17,1333,1431,2764,3071
0130-001,2011,8,4,18,1734,2071,3805,2764
0130-001,2011,8,4,19,1618,2145,3763,3805
0130-001,2011,8,4,20,1341,1576,2917,3763
0130-001,2011,8,4,21,1166,1481,2647,2917
0130-001,2011,8,4,22,1052,1082,2134,2647
0130-001,2011,8,4,23,849,792,1641,2134
0130-001,2011,8,4,24,570,492,1062,1641
0130-001,2011,8,5,1,410,366,776,1062
0130-001,2011,8,5,2,288,221,509,776
0130-001,2011,8,5,3,179,181,360,509
0130-001,2011,8,5,4,147,163,310,360
0130-001,2011,8,5,5,178,241,419,310
0130-001,2011,8,5,6,339,417,756,419
0130-001,2011,8,5,7,1037,656,1693,756
0130-001,2011,8,5,8,1963,1397,3360,1693
0130-001,2011,8,5,9,1699,1651,3350,3360
0130-001,2011,8,5,10,1622,1501,3123,3350
0130-001,2011,8,5,11,1589,1681,3270,3123
0130-001,2011,8,5,12,1502,1537,3039,3270
0130-001,2011,8,5,13,942,1016,1958,3039
0130-001,2011,8,5,14,769,759,1528,1958
0130-001,2011,8,5,15,915,884,1799,1528
0130-001,2011,8,5,16,655,706,1361,1799
0130-001,2011,8,5,17,738,777,1515,1361
0130-001,2011,8,5,18,975,1153,2128,1515
0130-001,2011,8,5,19,956,1154,2110,2128
0130-001,2011,8,5,20,1112,1553,2665,2110
0130-001,2011,8,5,21,811,989,1800,2665
0130-001,2011,8,5,22,1028,1025,2053,1800
0130-001,2011,8,5,23,508,423,931,2053
0130-001,2011,8,5,24,634,492,1126,931
0130-001,2011,8,6,1,462,384,846,1126
0130-001,2011,8,6,2,271,253,524,846
0130-001,2011,8,6,3,198,166,364,524
0130-001,2011,8,6,4,178,172,350,364
0130-001,2011,8,6,5,154,185,339,350
0130-001,2011,8,6,6,260,289,549,339
0130-001,2011,8,6,7,432,333,765,549
0130-001,2011,8,6,8,1060,838,1898,765
0130-001,2011,8,6,9,1093,1096,2189,1898
0130-001,2011,8,6,10,1022,1120,2142,2189
0130-001,2011,8,6,11,957,1130,2087,2142
0130-001,2011,8,6,12,1194,1304,2498,2087
0130-001,2011,8,6,13,1330,1780,3110,2498
0130-001,2011,8,6,14,1314,1621,2935,3110
0130-001,2011,8,6,15,1243,1508,2751,2935
0130-001,2011,8,6,16,945,1027,1972,2751
0130-001,2011,8,6,17,814,833,1647,1972
0130-001,2011,8,6,18,705,760,1465,1647
0130-001,2011,8,6,19,759,762,1521,1465
0130-001,2011,8,6,20,807,838,1645,1521
0130-001,2011,8,6,21,844,805,1649,1645
0130-001,2011,8,6,22,608,482,1090,1649
0130-001,2011,8,6,23,421,336,757,1090
0130-001,2011,8,6,24,312,232,544,757
0130-001,2011,8,7,1,253,211,464,544
0130-001,2011,8,7,2,205,188,393,464
0130-001,2011,8,7,3,134,104,238,393
0130-001,2011,8,7,4,104,88,192,238
0130-001,2011,8,7,5,113,127,240,192
0130-001,2011,8,7,6,235,274,509,240
0130-001,2011,8,7,7,288,268,556,509
0130-001,2011,8,7,8,370,372,742,556
0130-001,2011,8,7,9,490,637,1127,742
0130-001,2011,8,7,10,431,488,919,1127
0130-001,2011,8,7,11,894,1070,1964,919
0130-001,2011,8,7,12,895,1068,1963,1964
0130-001,2011,8,7,13,984,920,1904,1963
0130-001,2011,8,7,14,724,610,1334,1904
0130-001,2011,8,7,15,756,592,1348,1334
0130-001,2011,8,7,16,1145,948,2093,1348
0130-001,2011,8,7,17,841,674,1515,2093
0130-001,2011,8,7,18,933,715,1648,1515
0130-001,2011,8,7,19,983,596,1579,1648
0130-001,2011,8,7,20,984,772,1756,1579
0130-001,2011,8,7,21,1164,942,2106,1756
0130-001,2011,8,7,22,1037,700,1737,2106
0130-001,2011,8,7,23,549,402,951,1737
0130-001,2011,8,7,24,360,270,630,951
0130-001,2011,8,8,1,274,211,485,630
0130-001,2011,8,8,2,191,149,340,485
0130-001,2011,8,8,3,129,142,271,340
0130-001,2011,8,8,4,124,118,242,271
0130-001,2011,8,8,5,137,187,324,242
0130-001,2011,8,8,6,295,306,601,324
0130-001,2011,8,8,7,1070,679,1749,601
0130-001,2011,8,8,8,1818,1260,3078,1749
0130-001,2011,8,8,9,1717,1683,3400,3078
0130-001,2011,8,8,10,1655,1709,3364,3400
0130-001,2011,8,8,11,1501,1415,2916,3364
0130-001,2011,8,8,12,1553,1511,3064,2916
0130-001,2011,8,8,13,1293,1299,2592,3064
0130-001,2011,8,8,14,1494,1484,2978,2592
0130-001,2011,8,8,15,1720,1762,3482,2978
0130-001,2011,8,8,16,1585,1637,3222,3482
0130-001,2011,8,8,17,1499,1556,3055,3222
0130-001,2011,8,8,18,1529,1880,3409,3055
0130-001,2011,8,8,19,1687,2135,3822,3409
0130-001,2011,8,8,20,1176,1505,2681,3822
0130-001,2011,8,8,21,1139,1446,2585,2681
0130-001,2011,8,8,22,968,1093,2061,2585
0130-001,2011,8,8,23,780,721,1501,2061
0130-001,2011,8,8,24,510,462,972,1501
0130-001,2011,8,9,1,357,313,670,972
0130-001,2011,8,9,2,244,199,443,670
0130-001,2011,8,9,3,187,172,359,443
0130-001,2011,8,9,4,166,152,318,359
0130-001,2011,8,9,5,136,196,332,318
0130-001,2011,8,9,6,355,413,768,332
0130-001,2011,8,9,7,1100,796,1896,768
0130-001,2011,8,9,8,1936,1413,3349,1896
0130-001,2011,8,9,9,1561,1479,3040,3349
0130-001,2011,8,9,10,1595,1530,3125,3040
0130-001,2011,8,9,11,1493,1427,2920,3125
0130-001,2011,8,9,12,1437,1377,2814,2920
0130-001,2011,8,9,13,1224,1240,2464,2814
0130-001,2011,8,9,14,1304,1278,2582,2464
0130-001,2011,8,9,15,1278,1366,2644,2582
0130-001,2011,8,9,16,1735,1762,3497,2644
0130-001,2011,8,9,17,1522,1643,3165,3497
0130-001,2011,8,9,18,1425,1731,3156,3165
0130-001,2011,8,9,19,1681,2121,3802,3156
0130-001,2011,8,9,20,1143,1407,2550,3802
0130-001,2011,8,9,21,1120,1391,2511,2550
0130-001,2011,8,9,22,1106,1166,2272,2511
0130-001,2011,8,9,23,683,582,1265,2272
0130-001,2011,8,9,24,610,477,1087,1265
0130-001,2011,8,10,1,396,322,718,1087
0130-001,2011,8,10,2,268,257,525,718
0130-001,2011,8,10,3,194,191,385,525
0130-001,2011,8,10,4,149,155,304,385
0130-001,2011,8,10,5,190,306,496,304
0130-001,2011,8,10,6,351,352,703,496
0130-001,2011,8,10,7,1030,731,1761,703
0130-001,2011,8,10,8,1705,1237,2942,1761
0130-001,2011,8,10,9,1642,1573,3215,2942
0130-001,2011,8,10,10,1297,1377,2674,3215
0130-001,2011,8,10,11,1415,1425,2840,2674
0130-001,2011,8,10,12,1363,1305,2668,2840
0130-001,2011,8,10,13,1258,1347,2605,2668
0130-001,2011,8,10,14,1417,1384,2801,2605
0130-001,2011,8,10,15,1519,1567,3086,2801
0130-001,2011,8,10,16,1205,1227,2432,3086
0130-001,2011,8,10,17,1699,1851,3550,2432
0130-001,2011,8,10,18,1698,2244,3942,3550
0130-001,2011,8,10,19,1717,2387,4104,3942
0130-001,2011,8,10,20,1384,1645,3029,4104
0130-001,2011,8,10,21,1222,1330,2552,3029
0130-001,2011,8,10,22,1115,1097,2212,2552
0130-001,2011,8,10,23,902,759,1661,2212
0130-001,2011,8,10,24,562,483,1045,1661
0130-001,2011,8,11,1,367,315,682,1045
0130-001,2011,8,11,2,283,241,524,682
0130-001,2011,8,11,3,217,196,413,524
0130-001,2011,8,11,4,170,184,354,413
0130-001,2011,8,11,5,203,331,534,354
0130-001,2011,8,11,6,363,461,824,534
0130-001,2011,8,11,7,1179,867,2046,824
0130-001,2011,8,11,8,1743,1363,3106,2046
0130-001,2011,8,11,9,1589,1412,3001,3106
0130-001,2011,8,11,10,1720,1774,3494,3001
0130-001,2011,8,11,11,1672,1573,3245,3494
0130-001,2011,8,11,12,1483,1552,3035,3245
0130-001,2011,8,11,13,969,1013,1982,3035
0130-001,2011,8,11,14,1371,1421,2792,1982
0130-001,2011,8,11,15,945,974,1919,2792
0130-001,2011,8,11,16,990,953,1943,1919
0130-001,2011,8,11,17,1481,1552,3033,1943
0130-001,2011,8,11,18,1070,1410,2480,3033
0130-001,2011,8,11,19,1237,1576,2813,2480
0130-001,2011,8,11,20,1388,1773,3161,2813
0130-001,2011,8,11,21,1091,1323,2414,3161
0130-001,2011,8,11,22,1204,1282,2486,2414
0130-001,2011,8,11,23,903,748,1651,2486
0130-001,2011,8,11,24,628,513,1141,1651
0130-001,2011,8,12,1,411,334,745,1141
0130-001,2011,8,12,2,274,221,495,745
0130-001,2011,8,12,3,188,167,355,495
0130-001,2011,8,12,4,145,134,279,355
0130-001,2011,8,12,5,166,259,425,279
0130-001,2011,8,12,6,380,417,797,425
0130-001,2011,8,12,7,1025,718,1743,797
0130-001,2011,8,12,8,1795,1323,3118,1743
0130-001,2011,8,12,9,1639,1537,3176,3118
0130-001,2011,8,12,10,1764,1741,3505,3176
0130-001,2011,8,12,11,1612,1589,3201,3505
0130-001,2011,8,12,12,1647,1701,3348,3201
0130-001,2011,8,12,13,1350,1421,2771,3348
0130-001,2011,8,12,14,1583,1686,3269,2771
0130-001,2011,8,12,15,1749,1723,3472,3269
0130-001,2011,8,12,16,1112,1123,2235,3472
0130-001,2011,8,12,17,881,968,1849,2235
0130-001,2011,8,12,18,569,682,1251,1849
0130-001,2011,8,12,19,1215,1433,2648,1251
0130-001,2011,8,12,20,1117,1511,2628,2648
0130-001,2011,8,12,21,1008,1230,2238,2628
0130-001,2011,8,12,22,1264,1317,2581,2238
0130-001,2011,8,12,23,869,674,1543,2581
0130-001,2011,8,12,24,665,539,1204,1543
0130-001,2011,8,13,1,450,316,766,1204
0130-001,2011,8,13,2,307,234,541,766
0130-001,2011,8,13,3,256,190,446,541
0130-001,2011,8,13,4,194,169,363,446
0130-001,2011,8,13,5,188,208,396,363
0130-001,2011,8,13,6,259,292,551,396
0130-001,2011,8,13,7,643,544,1187,551
0130-001,2011,8,13,8,1040,876,1916,1187
0130-001,2011,8,13,9,876,1297,2173,1916
0130-001,2011,8,13,10,1215,1458,2673,2173
0130-001,2011,8,13,11,1494,1642,3136,2673
0130-001,2011,8,13,12,1381,1615,2996,3136
0130-001,2011,8,13,13,1195,1820,3015,2996
0130-001,2011,8,13,14,1183,1766,2949,3015
0130-001,2011,8,13,15,1419,1674,3093,2949
0130-001,2011,8,13,16,1023,1528,2551,3093
0130-001,2011,8,13,17,1557,1698,3255,2551
0130-001,2011,8,13,18,1511,1804,3315,3255
0130-001,2011,8,13,19,1422,1484,2906,3315
0130-001,2011,8,13,20,1184,1282,2466,2906
0130-001,2011,8,13,21,1067,1647,2714,2466
0130-001,2011,8,13,22,1074,1483,2557,2714
0130-001,2011,8,13,23,769,647,1416,2557
0130-001,2011,8,13,24,531,384,915,1416
0130-001,2011,8,14,1,370,282,652,915
0130-001,2011,8,14,2,288,173,461,652
0130-001,2011,8,14,3,221,147,368,461
0130-001,2011,8,14,4,181,86,267,368
0130-001,2011,8,14,5,133,107,240,267
0130-001,2011,8,14,6,202,152,354,240
0130-001,2011,8,14,7,467,330,797,354
0130-001,2011,8,14,8,554,458,1012,797
0130-001,2011,8,14,9,652,700,1352,1012
0130-001,2011,8,14,10,846,903,1749,1352
0130-001,2011,8,14,11,945,1094,2039,1749
0130-001,2011,8,14,12,956,1154,2110,2039
0130-001,2011,8,14,13,888,1255,2143,2110
0130-001,2011,8,14,14,1115,1197,2312,2143
0130-001,2011,8,14,15,1312,1184,2496,2312
0130-001,2011,8,14,16,1492,1163,2655,2496
0130-001,2011,8,14,17,1535,1245,2780,2655
0130-001,2011,8,14,18,1528,1153,2681,2780
0130-001,2011,8,14,19,1671,1096,2767,2681
0130-001,2011,8,14,20,1304,1013,2317,2767
0130-001,2011,8,14,21,999,796,1795,2317
0130-001,2011,8,14,22,851,628,1479,1795
0130-001,2011,8,14,23,530,403,933,1479
0130-001,2011,8,14,24,238,306,544,933
0130-001,2011,8,15,1,227,249,476,544
0130-001,2011,8,15,2,202,152,354,476
0130-001,2011,8,15,3,125,106,231,354
0130-001,2011,8,15,4,81,86,167,231
0130-001,2011,8,15,5,81,121,202,167
0130-001,2011,8,15,6,140,202,342,202
0130-001,2011,8,15,7,413,388,801,342
0130-001,2011,8,15,8,742,560,1302,801
0130-001,2011,8,15,9,446,710,1156,1302
0130-001,2011,8,15,10,772,819,1591,1156
0130-001,2011,8,15,11,733,906,1639,1591
0130-001,2011,8,15,12,771,959,1730,1639
0130-001,2011,8,15,13,736,997,1733,1730
0130-001,2011,8,15,14,887,1020,1907,1733
0130-001,2011,8,15,15,355,968,1323,1907
0130-001,2011,8,15,16,744,1020,1764,1323
0130-001,2011,8,15,17,1021,1016,2037,1764
0130-001,2011,8,15,18,846,1189,2035,2037
0130-001,2011,8,15,19,706,1139,1845,2035
0130-001,2011,8,15,20,665,979,1644,1845
0130-001,2011,8,15,21,449,859,1308,1644
0130-001,2011,8,15,22,605,703,1308,1308
0130-001,2011,8,15,23,453,450,903,1308
0130-001,2011,8,15,24,231,283,514,903
0130-001,2011,8,16,1,155,184,339,514
0130-001,2011,8,16,2,147,107,254,339
0130-001,2011,8,16,3,67,83,150,254
0130-001,2011,8,16,4,45,93,138,150
0130-001,2011,8,16,5,50,131,181,138
0130-001,2011,8,16,6,178,267,445,181
0130-001,2011,8,16,7,990,610,1600,445
0130-001,2011,8,16,8,1515,1085,2600,1600
0130-001,2011,8,16,9,1346,1266,2612,2600
0130-001,2011,8,16,10,1322,1302,2624,2612
0130-001,2011,8,16,11,1344,1273,2617,2624
0130-001,2011,8,16,12,1282,1242,2524,2617
0130-001,2011,8,16,13,1161,1161,2322,2524
0130-001,2011,8,16,14,1193,1198,2391,2322
0130-001,2011,8,16,15,1262,1302,2564,2391
0130-001,2011,8,16,16,1260,1273,2533,2564
0130-001,2011,8,16,17,1223,1317,2540,2533
0130-001,2011,8,16,18,1158,1442,2600,2540
0130-001,2011,8,16,19,1217,1627,2844,2600
0130-001,2011,8,16,20,1073,1359,2432,2844
0130-001,2011,8,16,21,1000,1216,2216,2432
0130-001,2011,8,16,22,1013,1052,2065,2216
0130-001,2011,8,16,23,820,599,1419,2065
0130-001,2011,8,16,24,584,414,998,1419
0130-001,2011,8,17,1,351,285,636,998
0130-001,2011,8,17,2,247,235,482,636
0130-001,2011,8,17,3,125,124,249,482
0130-001,2011,8,17,4,107,113,220,249
0130-001,2011,8,17,5,129,209,338,220
0130-001,2011,8,17,6,223,224,447,338
0130-001,2011,8,17,7,910,646,1556,447
0130-001,2011,8,17,8,1821,1337,3158,1556
0130-001,2011,8,17,9,1691,1621,3312,3158
0130-001,2011,8,17,10,1565,1662,3227,3312
0130-001,2011,8,17,11,1499,1509,3008,3227
0130-001,2011,8,17,12,1460,1397,2857,3008
0130-001,2011,8,17,13,1403,1501,2904,2857
0130-001,2011,8,17,14,1561,1526,3087,2904
0130-001,2011,8,17,15,1568,1618,3186,3087
0130-001,2011,8,17,16,1691,1720,3411,3186
0130-001,2011,8,17,17,1541,1681,3222,3411
0130-001,2011,8,17,18,1574,2081,3655,3222
0130-001,2011,8,17,19,1555,2128,3683,3655
0130-001,2011,8,17,20,1194,1419,2613,3683
0130-001,2011,8,17,21,1064,1159,2223,2613
0130-001,2011,8,17,22,1038,1022,2060,2223
0130-001,2011,8,17,23,772,650,1422,2060
0130-001,2011,8,17,24,444,381,825,1422
0130-001,2011,8,18,1,369,315,684,825
0130-001,2011,8,18,2,267,226,493,684
0130-001,2011,8,18,3,179,161,340,493
0130-001,2011,8,18,4,149,160,309,340
0130-001,2011,8,18,5,178,289,467,309
0130-001,2011,8,18,6,295,373,668,467
0130-001,2011,8,18,7,1070,787,1857,668
0130-001,2011,8,18,8,1946,1520,3466,1857
0130-001,2011,8,18,9,1791,1591,3382,3466
0130-001,2011,8,18,10,1735,1804,3539,3382
0130-001,2011,8,18,11,1695,1594,3289,3539
0130-001,2011,8,18,12,1614,1690,3304,3289
0130-001,2011,8,18,13,1365,1425,2790,3304
0130-001,2011,8,18,14,1532,1588,3120,2790
0130-001,2011,8,18,15,837,862,1699,3120
0130-001,2011,8,18,16,810,778,1588,1699
0130-001,2011,8,18,17,1100,1153,2253,1588
0130-001,2011,8,18,18,1302,1714,3016,2253
0130-001,2011,8,18,19,1592,2009,3601,3016
0130-001,2011,8,18,20,1004,1291,2295,3601
0130-001,2011,8,18,21,760,923,1683,2295
0130-001,2011,8,18,22,848,903,1751,1683
0130-001,2011,8,18,23,677,560,1237,1751
0130-001,2011,8,18,24,614,503,1117,1237
0130-001,2011,8,19,1,298,242,540,1117
0130-001,2011,8,19,2,234,190,424,540
0130-001,2011,8,19,3,149,133,282,424
0130-001,2011,8,19,4,140,129,269,282
0130-001,2011,8,19,5,163,256,419,269
0130-001,2011,8,19,6,321,354,675,419
0130-001,2011,8,19,7,746,523,1269,675
0130-001,2011,8,19,8,1655,1202,2857,1269
0130-001,2011,8,19,9,1829,1735,3564,2857
0130-001,2011,8,19,10,1797,1800,3597,3564
0130-001,2011,8,19,11,1695,1672,3367,3597
0130-001,2011,8,19,12,1683,1737,3420,3367
0130-001,2011,8,19,13,1395,1468,2863,3420
0130-001,2011,8,19,14,1597,1702,3299,2863
0130-001,2011,8,19,15,1699,1675,3374,3299
0130-001,2011,8,19,16,1139,1153,2292,3374
0130-001,2011,8,19,17,1103,1213,2316,2292
0130-001,2011,8,19,18,1632,1930,3562,2316
0130-001,2011,8,19,19,1505,1776,3281,3562
0130-001,2011,8,19,20,1156,1563,2719,3281
0130-001,2011,8,19,21,1179,1439,2618,2719
0130-001,2011,8,19,22,1063,1106,2169,2618
0130-001,2011,8,19,23,956,741,1697,2169
0130-001,2011,8,19,24,644,521,1165,1697
0130-001,2011,8,20,1,490,388,878,1165
0130-001,2011,8,20,2,303,241,544,878
0130-001,2011,8,20,3,265,246,511,544
0130-001,2011,8,20,4,209,191,400,511
0130-001,2011,8,20,5,203,238,441,400
0130-001,2011,8,20,6,362,395,757,441
0130-001,2011,8,20,7,805,638,1443,757
0130-001,2011,8,20,8,1464,1361,2825,1443
0130-001,2011,8,20,9,1702,1723,3425,2825
0130-001,2011,8,20,10,1622,1800,3422,3425
0130-001,2011,8,20,11,1601,1937,3538,3422
0130-001,2011,8,20,12,1571,1980,3551,3538
0130-001,2011,8,20,13,1483,1860,3343,3551
0130-001,2011,8,20,14,1552,1911,3463,3343
0130-001,2011,8,20,15,1538,1839,3377,3463
0130-001,2011,8,20,16,1756,2030,3786,3377
0130-001,2011,8,20,17,1855,1978,3833,3786
0130-001,2011,8,20,18,1815,1850,3665,3833
0130-001,2011,8,20,19,1610,1607,3217,3665
0130-001,2011,8,20,20,1374,1409,2783,3217
0130-001,2011,8,20,21,1147,986,2133,2783
0130-001,2011,8,20,22,1102,881,1983,2133
0130-001,2011,8,20,23,792,617,1409,1983
0130-001,2011,8,20,24,587,468,1055,1409
0130-001,2011,8,21,1,402,339,741,1055
0130-001,2011,8,21,2,300,238,538,741
0130-001,2011,8,21,3,242,231,473,538
0130-001,2011,8,21,4,194,158,352,473
0130-001,2011,8,21,5,181,179,360,352
0130-001,2011,8,21,6,330,399,729,360
0130-001,2011,8,21,7,592,504,1096,729
0130-001,2011,8,21,8,879,795,1674,1096
0130-001,2011,8,21,9,1176,1490,2666,1674
0130-001,2011,8,21,10,993,1102,2095,2666
0130-001,2011,8,21,11,974,1284,2258,2095
0130-001,2011,8,21,12,969,1205,2174,2258
0130-001,2011,8,21,13,1102,1181,2283,2174
0130-001,2011,8,21,14,1231,1130,2361,2283
0130-001,2011,8,21,15,1194,984,2178,2361
0130-001,2011,8,21,16,965,764,1729,2178
0130-001,2011,8,21,17,1147,939,2086,1729
0130-001,2011,8,21,18,983,731,1714,2086
0130-001,2011,8,21,19,1156,807,1963,1714
0130-001,2011,8,21,20,1274,983,2257,1963
0130-001,2011,8,21,21,646,501,1147,2257
0130-001,2011,8,21,22,623,443,1066,1147
0130-001,2011,8,21,23,662,500,1162,1066
0130-001,2011,8,21,24,452,355,807,1162
0130-001,2011,8,22,1,246,185,431,807
0130-001,2011,8,22,2,154,145,299,431
0130-001,2011,8,22,3,143,134,277,299
0130-001,2011,8,22,4,116,122,238,277
0130-001,2011,8,22,5,179,268,447,238
0130-001,2011,8,22,6,370,435,805,447
0130-001,2011,8,22,7,1158,759,1917,805
0130-001,2011,8,22,8,1282,909,2191,1917
0130-001,2011,8,22,9,1861,1836,3697,2191
0130-001,2011,8,22,10,1658,1720,3378,3697
0130-001,2011,8,22,11,1655,1621,3276,3378
0130-001,2011,8,22,12,1650,1741,3391,3276
0130-001,2011,8,22,13,1409,1315,2724,3391
0130-001,2011,8,22,14,1691,1704,3395,2724
0130-001,2011,8,22,15,1699,1676,3375,3395
0130-001,2011,8,22,16,1210,1281,2491,3375
0130-001,2011,8,22,17,1008,1096,2104,2491
0130-001,2011,8,22,18,1504,1967,3471,2104
0130-001,2011,8,22,19,1469,1866,3335,3471
0130-001,2011,8,22,20,1464,1791,3255,3335
0130-001,2011,8,22,21,1198,1499,2697,3255
0130-001,2011,8,22,22,1111,1219,2330,2697
0130-001,2011,8,22,23,856,659,1515,2330
0130-001,2011,8,22,24,549,414,963,1515
0130-001,2011,8,23,1,349,297,646,963
0130-001,2011,8,23,2,231,199,430,646
0130-001,2011,8,23,3,190,170,360,430
0130-001,2011,8,23,4,173,170,343,360
0130-001,2011,8,23,5,149,202,351,343
0130-001,2011,8,23,6,340,381,721,351
0130-001,2011,8,23,7,1204,782,1986,721
0130-001,2011,8,23,8,1588,1111,2699,1986
0130-001,2011,8,23,9,1808,1691,3499,2699
0130-001,2011,8,23,10,1601,1618,3219,3499
0130-001,2011,8,23,11,1752,1647,3399,3219
0130-001,2011,8,23,12,1683,1647,3330,3399
0130-001,2011,8,23,13,1305,1290,2595,3330
0130-001,2011,8,23,14,1556,1594,3150,2595
0130-001,2011,8,23,15,1618,1622,3240,3150
0130-001,2011,8,23,16,1389,1395,2784,3240
0130-001,2011,8,23,17,1169,1257,2426,2784
0130-001,2011,8,23,18,1691,2152,3843,2426
0130-001,2011,8,23,19,1690,2389,4079,3843
0130-001,2011,8,23,20,1463,1896,3359,4079
0130-001,2011,8,23,21,1231,1468,2699,3359
0130-001,2011,8,23,22,1150,1168,2318,2699
0130-001,2011,8,23,23,905,746,1651,2318
0130-001,2011,8,23,24,595,465,1060,1651
0130-001,2011,8,24,1,396,325,721,1060
0130-001,2011,8,24,2,277,220,497,721
0130-001,2011,8,24,3,209,194,403,497
0130-001,2011,8,24,4,199,187,386,403
0130-001,2011,8,24,5,167,246,413,386
0130-001,2011,8,24,6,340,431,771,413
0130-001,2011,8,24,7,1318,984,2302,771
0130-001,2011,8,24,8,1927,1442,3369,2302
0130-001,2011,8,24,9,1541,1440,2981,3369
0130-001,2011,8,24,10,1660,1579,3239,2981
0130-001,2011,8,24,11,1610,1556,3166,3239
0130-001,2011,8,24,12,1472,1446,2918,3166
0130-001,2011,8,24,13,1356,1451,2807,2918
0130-001,2011,8,24,14,1337,1417,2754,2807
0130-001,2011,8,24,15,1422,1454,2876,2754
0130-001,2011,8,24,16,813,759,1572,2876
0130-001,2011,8,24,17,921,956,1877,1572
0130-001,2011,8,24,18,1060,1373,2433,1877
0130-001,2011,8,24,19,733,986,1719,2433
0130-001,2011,8,24,20,873,1085,1958,1719
0130-001,2011,8,24,21,658,744,1402,1958
0130-001,2011,8,24,22,582,513,1095,1402
0130-001,2011,8,24,23,498,413,911,1095
0130-001,2011,8,24,24,274,216,490,911
0130-001,2011,8,25,1,206,205,411,490
0130-001,2011,8,25,2,203,172,375,411
0130-001,2011,8,25,3,139,139,278,375
0130-001,2011,8,25,4,122,151,273,278
0130-001,2011,8,25,5,83,125,208,273
0130-001,2011,8,25,6,211,250,461,208
0130-001,2011,8,25,7,1127,807,1934,461
0130-001,2011,8,25,8,1719,1231,2950,1934
0130-001,2011,8,25,9,1862,1711,3573,2950
0130-001,2011,8,25,10,1698,1676,3374,3573
0130-001,2011,8,25,11,1723,1747,3470,3374
0130-001,2011,8,25,12,1586,1520,3106,3470
0130-001,2011,8,25,13,768,808,1576,3106
0130-001,2011,8,25,14,1038,1074,2112,1576
0130-001,2011,8,25,15,1049,1081,2130,2112
0130-001,2011,8,25,16,801,784,1585,2130
0130-001,2011,8,25,17,1228,1333,2561,1585
0130-001,2011,8,25,18,1658,1786,3444,2561
0130-001,2011,8,25,19,1713,1666,3379,3444
0130-001,2011,8,25,20,1425,1779,3204,3379
0130-001,2011,8,25,21,1219,1573,2792,3204
0130-001,2011,8,25,22,1165,1273,2438,2792
0130-001,2011,8,25,23,936,906,1842,2438
0130-001,2011,8,25,24,638,488,1126,1842
0130-001,2011,8,26,1,420,334,754,1126
0130-001,2011,8,26,2,331,270,601,754
0130-001,2011,8,26,3,221,198,419,601
0130-001,2011,8,26,4,173,175,348,419
0130-001,2011,8,26,5,199,283,482,348
0130-001,2011,8,26,6,420,441,861,482
0130-001,2011,8,26,7,1255,930,2185,861
0130-001,2011,8,26,8,1818,1272,3090,2185
0130-001,2011,8,26,9,1666,1592,3258,3090
0130-001,2011,8,26,10,1758,1858,3616,3258
0130-001,2011,8,26,11,1577,1526,3103,3616
0130-001,2011,8,26,12,1640,1666,3306,3103
0130-001,2011,8,26,13,1365,1534,2899,3306
0130-001,2011,8,26,14,1630,1711,3341,2899
0130-001,2011,8,26,15,1293,1356,2649,3341
0130-001,2011,8,26,16,1323,1417,2740,2649
0130-001,2011,8,26,17,810,833,1643,2740
0130-001,2011,8,26,18,589,721,1310,1643
0130-001,2011,8,26,19,1315,1615,2930,1310
0130-001,2011,8,26,20,947,1246,2193,2930
0130-001,2011,8,26,21,610,766,1376,2193
0130-001,2011,8,26,22,536,510,1046,1376
0130-001,2011,8,26,23,444,321,765,1046
0130-001,2011,8,26,24,453,331,784,765
0130-001,2011,8,27,1,362,280,642,784
0130-001,2011,8,27,2,178,143,321,642
0130-001,2011,8,27,3,160,158,318,321
0130-001,2011,8,27,4,140,133,273,318
0130-001,2011,8,27,5,129,149,278,273
0130-001,2011,8,27,6,216,227,443,278
0130-001,2011,8,27,7,477,421,898,443
0130-001,2011,8,27,8,739,575,1314,898
0130-001,2011,8,27,9,1120,1019,2139,1314
0130-001,2011,8,27,10,1443,1516,2959,2139
0130-001,2011,8,27,11,1332,1511,2843,2959
0130-001,2011,8,27,12,1078,1345,2423,2843
0130-001,2011,8,27,13,1445,2112,3557,2423
0130-001,2011,8,27,14,1111,1312,2423,3557
0130-001,2011,8,27,15,1141,1243,2384,2423
0130-001,2011,8,27,16,751,834,1585,2384
0130-001,2011,8,27,17,444,421,865,1585
0130-001,2011,8,27,18,537,501,1038,865
0130-001,2011,8,27,19,721,784,1505,1038
0130-001,2011,8,27,20,367,330,697,1505
0130-001,2011,8,27,21,656,578,1234,697
0130-001,2011,8,27,22,617,510,1127,1234
0130-001,2011,8,27,23,446,328,774,1127
0130-001,2011,8,27,24,447,360,807,774
0130-001,2011,8,28,1,313,264,577,807
0130-001,2011,8,28,2,185,169,354,577
0130-001,2011,8,28,3,118,101,219,354
0130-001,2011,8,28,4,113,78,191,219
0130-001,2011,8,28,5,106,119,225,191
0130-001,2011,8,28,6,147,173,320,225
0130-001,2011,8,28,7,307,238,545,320
0130-001,2011,8,28,8,396,355,751,545
0130-001,2011,8,28,9,500,595,1095,751
0130-001,2011,8,28,10,494,537,1031,1095
0130-001,2011,8,28,11,459,574,1033,1031
0130-001,2011,8,28,12,713,884,1597,1033
0130-001,2011,8,28,13,895,1071,1966,1597
0130-001,2011,8,28,14,795,844,1639,1966
0130-001,2011,8,28,15,360,393,753,1639
0130-001,2011,8,28,16,551,492,1043,753
0130-001,2011,8,28,17,602,510,1112,1043
0130-001,2011,8,28,18,533,518,1051,1112
0130-001,2011,8,28,19,596,537,1133,1051
0130-001,2011,8,28,20,587,495,1082,1133
0130-001,2011,8,28,21,533,423,956,1082
0130-001,2011,8,28,22,396,275,671,956
0130-001,2011,8,28,23,634,476,1110,671
0130-001,2011,8,28,24,524,346,870,1110
0130-001,2011,8,29,1,354,252,606,870
0130-001,2011,8,29,2,137,111,248,606
0130-001,2011,8,29,3,78,68,146,248
0130-001,2011,8,29,4,65,53,118,146
0130-001,2011,8,29,5,68,95,163,118
0130-001,2011,8,29,6,206,234,440,163
0130-001,2011,8,29,7,574,391,965,440
0130-001,2011,8,29,8,885,587,1472,965
0130-001,2011,8,29,9,892,823,1715,1472
0130-001,2011,8,29,10,1225,1264,2489,1715
0130-001,2011,8,29,11,1463,1422,2885,2489
0130-001,2011,8,29,12,1114,1111,2225,2885
0130-001,2011,8,29,13,482,512,994,2225
0130-001,2011,8,29,14,662,626,1288,994
0130-001,2011,8,29,15,662,634,1296,1288
0130-001,2011,8,29,16,354,348,702,1296
0130-001,2011,8,29,17,1207,1279,2486,702
0130-001,2011,8,29,18,1640,2008,3648,2486
0130-001,2011,8,29,19,1748,2302,4050,3648
0130-001,2011,8,29,20,1299,1612,2911,4050
0130-001,2011,8,29,21,1076,1443,2519,2911
0130-001,2011,8,29,22,968,1008,1976,2519
0130-001,2011,8,29,23,804,664,1468,1976
0130-001,2011,8,29,24,531,384,915,1468
0130-001,2011,8,30,1,406,370,776,915
0130-001,2011,8,30,2,250,224,474,776
0130-001,2011,8,30,3,149,139,288,474
0130-001,2011,8,30,4,161,172,333,288
0130-001,2011,8,30,5,181,223,404,333
0130-001,2011,8,30,6,358,414,772,404
0130-001,2011,8,30,7,1332,873,2205,772
0130-001,2011,8,30,8,1901,1314,3215,2205
0130-001,2011,8,30,9,1541,1417,2958,3215
0130-001,2011,8,30,10,1639,1666,3305,2958
0130-001,2011,8,30,11,1443,1413,2856,3305
0130-001,2011,8,30,12,822,849,1671,2856
0130-001,2011,8,30,13,411,434,845,1671
0130-001,2011,8,30,14,360,333,693,845
0130-001,2011,8,30,15,416,435,851,693
0130-001,2011,8,30,16,503,485,988,851
0130-001,2011,8,30,17,396,417,813,988
0130-001,2011,8,30,18,1094,1338,2432,813
0130-001,2011,8,30,19,1386,1992,3378,2432
0130-001,2011,8,30,20,804,975,1779,3378
0130-001,2011,8,30,21,831,974,1805,1779
0130-001,2011,8,30,22,1132,1216,2348,1805
0130-001,2011,8,30,23,910,728,1638,2348
0130-001,2011,8,30,24,552,413,965,1638
0130-001,2011,8,31,1,403,352,755,965
0130-001,2011,8,31,2,249,217,466,755
0130-001,2011,8,31,3,184,158,342,466
0130-001,2011,8,31,4,161,151,312,342
0130-001,2011,8,31,5,154,198,352,312
0130-001,2011,8,31,6,373,434,807,352
0130-001,2011,8,31,7,1305,823,2128,807
0130-001,2011,8,31,8,1826,1273,3099,2128
0130-001,2011,8,31,9,1827,1695,3522,3099
0130-001,2011,8,31,10,1588,1693,3281,3522
0130-001,2011,8,31,11,1475,1392,2867,3281
0130-001,2011,8,31,12,1063,1073,2136,2867
0130-001,2011,8,31,13,1366,1448,2814,2136
0130-001,2011,8,31,14,1422,1403,2825,2814
0130-001,2011,8,31,15,1179,1158,2337,2825
0130-001,2011,8,31,16,1463,1469,2932,2337
0130-001,2011,8,31,17,1261,1329,2590,2932
0130-001,2011,8,31,18,1455,1845,3300,2590
0130-001,2011,8,31,19,1399,1765,3164,3300
0130-001,2011,8,31,20,1399,1801,3200,3164
0130-001,2011,8,31,21,1261,1458,2719,3200
0130-001,2011,8,31,22,1228,1156,2384,2719
0130-001,2011,8,31,23,912,687,1599,2384
0130-001,2011,8,31,24,634,513,1147,1599
0130-001,2011,9,1,1,482,441,923,1147
0130-001,2011,9,1,2,250,213,463,923
0130-001,2011,9,1,3,211,172,383,463
0130-001,2011,9,1,4,184,184,368,383
0130-001,2011,9,1,5,176,241,417,368
0130-001,2011,9,1,6,406,406,812,417
0130-001,2011,9,1,7,1401,957,2358,812
0130-001,2011,9,1,8,1684,1192,2876,2358
0130-001,2011,9,1,9,1768,1658,3426,2876
0130-001,2011,9,1,10,1624,1680,3304,3426
0130-001,2011,9,1,11,1763,1676,3439,3304
0130-001,2011,9,1,12,1499,1475,2974,3439
0130-001,2011,9,1,13,1172,1139,2311,2974
0130-001,2011,9,1,14,1363,1370,2733,2311
0130-001,2011,9,1,15,1582,1671,3253,2733
0130-001,2011,9,1,16,1366,1406,2772,3253
0130-001,2011,9,1,17,683,756,1439,2772
0130-001,2011,9,1,18,1189,1532,2721,1439
0130-001,2011,9,1,19,1103,1366,2469,2721
0130-001,2011,9,1,20,721,843,1564,2469
0130-001,2011,9,1,21,623,829,1452,1564
0130-001,2011,9,1,22,650,706,1356,1452
0130-001,2011,9,1,23,849,771,1620,1356
0130-001,2011,9,1,24,348,295,643,1620
0130-001,2011,9,2,1,199,173,372,643
0130-001,2011,9,2,2,163,140,303,372
0130-001,2011,9,2,3,137,116,253,303
0130-001,2011,9,2,4,131,147,278,253
0130-001,2011,9,2,5,163,241,404,278
0130-001,2011,9,2,6,372,385,757,404
0130-001,2011,9,2,7,1234,831,2065,757
0130-001,2011,9,2,8,918,695,1613,2065
0130-001,2011,9,2,9,1027,924,1951,1613
0130-001,2011,9,2,10,1699,1719,3418,1951
0130-001,2011,9,2,11,1740,1607,3347,3418
0130-001,2011,9,2,12,1520,1573,3093,3347
0130-001,2011,9,2,13,1395,1451,2846,3093
0130-001,2011,9,2,14,1230,1329,2559,2846
0130-001,2011,9,2,15,1457,1468,2925,2559
0130-001,2011,9,2,16,823,897,1720,2925
0130-001,2011,9,2,17,643,674,1317,1720
0130-001,2011,9,2,18,1249,1517,2766,1317
0130-001,2011,9,2,19,1749,2144,3893,2766
0130-001,2011,9,2,20,1491,1866,3357,3893
0130-001,2011,9,2,21,1129,1443,2572,3357
0130-001,2011,9,2,22,1174,1279,2453,2572
0130-001,2011,9,2,23,1016,894,1910,2453
0130-001,2011,9,2,24,638,533,1171,1910
0130-001,2011,9,3,1,447,384,831,1171
0130-001,2011,9,3,2,352,312,664,831
0130-001,2011,9,3,3,285,265,550,664
0130-001,2011,9,3,4,224,232,456,550
0130-001,2011,9,3,5,149,154,303,456
0130-001,2011,9,3,6,388,441,829,303
0130-001,2011,9,3,7,1078,849,1927,829
0130-001,2011,9,3,8,1819,1628,3447,1927
0130-001,2011,9,3,9,1807,1642,3449,3447
0130-001,2011,9,3,10,1508,1505,3013,3449
0130-001,2011,9,3,11,1614,1924,3538,3013
0130-001,2011,9,3,12,1512,1964,3476,3538
0130-001,2011,9,3,13,1628,2187,3815,3476
0130-001,2011,9,3,14,1439,1770,3209,3815
0130-001,2011,9,3,15,1621,1854,3475,3209
0130-001,2011,9,3,16,1650,1944,3594,3475
0130-001,2011,9,3,17,1514,1618,3132,3594
0130-001,2011,9,3,18,1696,1786,3482,3132
0130-001,2011,9,3,19,1567,1647,3214,3482
0130-001,2011,9,3,20,1445,1673,3118,3214
0130-001,2011,9,3,21,1246,1079,2325,3118
0130-001,2011,9,3,22,1148,953,2101,2325
0130-001,2011,9,3,23,805,706,1511,2101
0130-001,2011,9,3,24,577,465,1042,1511
0130-001,2011,9,4,1,416,331,747,1042
0130-001,2011,9,4,2,316,270,586,747
0130-001,2011,9,4,3,224,196,420,586
0130-001,2011,9,4,4,184,152,336,420
0130-001,2011,9,4,5,161,149,310,336
0130-001,2011,9,4,6,313,346,659,310
0130-001,2011,9,4,7,625,575,1200,659
0130-001,2011,9,4,8,843,867,1710,1200
0130-001,2011,9,4,9,888,983,1871,1710
0130-001,2011,9,4,10,989,1194,2183,1871
0130-001,2011,9,4,11,1209,1478,2687,2183
0130-001,2011,9,4,12,1204,1486,2690,2687
0130-001,2011,9,4,13,1363,1351,2714,2690
0130-001,2011,9,4,14,1777,1536,3313,2714
0130-001,2011,9,4,15,1508,1317,2825,3313
0130-001,2011,9,4,16,1148,851,1999,2825
0130-001,2011,9,4,17,1379,1002,2381,1999
0130-001,2011,9,4,18,1433,1084,2517,2381
0130-001,2011,9,4,19,1625,1070,2695,2517
0130-001,2011,9,4,20,1243,900,2143,2695
0130-001,2011,9,4,21,1159,966,2125,2143
0130-001,2011,9,4,22,997,712,1709,2125
0130-001,2011,9,4,23,744,541,1285,1709
0130-001,2011,9,4,24,494,393,887,1285
0130-001,2011,9,5,1,293,274,567,887
0130-001,2011,9,5,2,152,136,288,567
0130-001,2011,9,5,3,127,133,260,288
0130-001,2011,9,5,4,131,116,247,260
0130-001,2011,9,5,5,158,250,408,247
0130-001,2011,9,5,6,416,471,887,408
0130-001,2011,9,5,7,1464,900,2364,887
0130-001,2011,9,5,8,1758,1263,3021,2364
0130-001,2011,9,5,9,1746,1732,3478,3021
0130-001,2011,9,5,10,1760,1728,3488,3478
0130-001,2011,9,5,11,1804,1698,3502,3488
0130-001,2011,9,5,12,1591,1609,3200,3502
0130-001,2011,9,5,13,1450,1437,2887,3200
0130-001,2011,9,5,14,1650,1633,3283,2887
0130-001,2011,9,5,15,1803,1758,3561,3283
0130-001,2011,9,5,16,1676,1754,3430,3561
0130-001,2011,9,5,17,1181,1263,2444,3430
0130-001,2011,9,5,18,1074,1335,2409,2444
0130-001,2011,9,5,19,895,1133,2028,2409
0130-001,2011,9,5,20,882,1088,1970,2028
0130-001,2011,9,5,21,772,1096,1868,1970
0130-001,2011,9,5,22,945,997,1942,1868
0130-001,2011,9,5,23,887,775,1662,1942
0130-001,2011,9,5,24,381,373,754,1662
0130-001,2011,9,6,1,385,280,665,754
0130-001,2011,9,6,2,211,181,392,665
0130-001,2011,9,6,3,193,191,384,392
0130-001,2011,9,6,4,160,143,303,384
0130-001,2011,9,6,5,147,224,371,303
0130-001,2011,9,6,6,340,402,742,371
0130-001,2011,9,6,7,1351,887,2238,742
0130-001,2011,9,6,8,1695,1255,2950,2238
0130-001,2011,9,6,9,1526,1553,3079,2950
0130-001,2011,9,6,10,1601,1624,3225,3079
0130-001,2011,9,6,11,1609,1448,3057,3225
0130-001,2011,9,6,12,1388,1377,2765,3057
0130-001,2011,9,6,13,1363,1348,2711,2765
0130-001,2011,9,6,14,1669,1762,3431,2711
0130-001,2011,9,6,15,1680,1690,3370,3431
0130-001,2011,9,6,16,1540,1639,3179,3370
0130-001,2011,9,6,17,1632,1698,3330,3179
0130-001,2011,9,6,18,1698,2138,3836,3330
0130-001,2011,9,6,19,1699,2065,3764,3836
0130-001,2011,9,6,20,1541,2121,3662,3764
0130-001,2011,9,6,21,1320,1669,2989,3662
0130-001,2011,9,6,22,1231,1290,2521,2989
0130-001,2011,9,6,23,1019,869,1888,2521
0130-001,2011,9,6,24,580,504,1084,1888
0130-001,2011,9,7,1,429,380,809,1084
0130-001,2011,9,7,2,270,220,490,809
0130-001,2011,9,7,3,205,193,398,490
0130-001,2011,9,7,4,131,129,260,398
0130-001,2011,9,7,5,179,279,458,260
0130-001,2011,9,7,6,367,421,788,458
0130-001,2011,9,7,7,1318,895,2213,788
0130-001,2011,9,7,8,1793,1257,3050,2213
0130-001,2011,9,7,9,1874,1847,3721,3050
0130-001,2011,9,7,10,1786,2184,3970,3721
0130-001,2011,9,7,11,1797,1516,3313,3970
0130-001,2011,9,7,12,1647,1695,3342,3313
0130-001,2011,9,7,13,1505,1552,3057,3342
0130-001,2011,9,7,14,1651,1726,3377,3057
0130-001,2011,9,7,15,1863,1898,3761,3377
0130-001,2011,9,7,16,1622,1662,3284,3761
0130-001,2011,9,7,17,1061,1105,2166,3284
0130-001,2011,9,7,18,1783,2350,4133,2166
0130-001,2011,9,7,19,1699,2275,3974,4133
0130-001,2011,9,7,20,1512,1850,3362,3974
0130-001,2011,9,7,21,1284,1486,2770,3362
0130-001,2011,9,7,22,1251,1181,2432,2770
0130-001,2011,9,7,23,1023,971,1994,2432
0130-001,2011,9,7,24,647,578,1225,1994
0130-001,2011,9,8,1,391,322,713,1225
0130-001,2011,9,8,2,259,203,462,713
0130-001,2011,9,8,3,151,121,272,462
0130-001,2011,9,8,4,160,155,315,272
0130-001,2011,9,8,5,167,271,438,315
0130-001,2011,9,8,6,304,362,666,438
0130-001,2011,9,8,7,1239,820,2059,666
0130-001,2011,9,8,8,1755,1264,3019,2059
0130-001,2011,9,8,9,1683,1668,3351,3019
0130-001,2011,9,8,10,1553,1592,3145,3351
0130-001,2011,9,8,11,1702,1643,3345,3145
0130-001,2011,9,8,12,1669,1720,3389,3345
0130-001,2011,9,8,13,1496,1476,2972,3389
0130-001,2011,9,8,14,1729,1618,3347,2972
0130-001,2011,9,8,15,1822,1863,3685,3347
0130-001,2011,9,8,16,1788,1886,3674,3685
0130-001,2011,9,8,17,1698,1822,3520,3674
0130-001,2011,9,8,18,1835,2154,3989,3520
0130-001,2011,9,8,19,1607,2155,3762,3989
0130-001,2011,9,8,20,1192,1401,2593,3762
0130-001,2011,9,8,21,1363,1732,3095,2593
0130-001,2011,9,8,22,1294,1330,2624,3095
0130-001,2011,9,8,23,1055,984,2039,2624
0130-001,2011,9,8,24,677,584,1261,2039
0130-001,2011,9,9,1,497,443,940,1261
0130-001,2011,9,9,2,286,220,506,940
0130-001,2011,9,9,3,217,217,434,506
0130-001,2011,9,9,4,193,214,407,434
0130-001,2011,9,9,5,191,259,450,407
0130-001,2011,9,9,6,393,483,876,450
0130-001,2011,9,9,7,1215,769,1984,876
0130-001,2011,9,9,8,1901,1338,3239,1984
0130-001,2011,9,9,9,1829,1778,3607,3239
0130-001,2011,9,9,10,1702,1574,3276,3607
0130-001,2011,9,9,11,1923,2062,3985,3276
0130-001,2011,9,9,12,1734,1773,3507,3985
0130-001,2011,9,9,13,1606,1732,3338,3507
0130-001,2011,9,9,14,1676,1654,3330,3338
0130-001,2011,9,9,15,1750,1690,3440,3330
0130-001,2011,9,9,16,1824,1968,3792,3440
0130-001,2011,9,9,17,1728,1818,3546,3792
0130-001,2011,9,9,18,1687,1994,3681,3546
0130-001,2011,9,9,19,1637,1976,3613,3681
0130-001,2011,9,9,20,1481,2068,3549,3613
0130-001,2011,9,9,21,1076,1311,2387,3549
0130-001,2011,9,9,22,1100,1097,2197,2387
0130-001,2011,9,9,23,979,813,1792,2197
0130-001,2011,9,9,24,638,495,1133,1792
0130-001,2011,9,10,1,456,393,849,1133
0130-001,2011,9,10,2,280,280,560,849
0130-001,2011,9,10,3,234,169,403,560
0130-001,2011,9,10,4,198,143,341,403
0130-001,2011,9,10,5,227,113,340,341
0130-001,2011,9,10,6,300,232,532,340
0130-001,2011,9,10,7,641,593,1234,532
0130-001,2011,9,10,8,960,1007,1967,1234
0130-001,2011,9,10,9,1115,1200,2315,1967
0130-001,2011,9,10,10,1145,1151,2296,2315
0130-001,2011,9,10,11,1395,1132,2527,2296
0130-001,2011,9,10,12,1296,1153,2449,2527
0130-001,2011,9,10,13,1287,1088,2375,2449
0130-001,2011,9,10,14,1427,1038,2465,2375
0130-001,2011,9,10,15,1397,1111,2508,2465
0130-001,2011,9,10,16,1433,1013,2446,2508
0130-001,2011,9,10,17,1323,795,2118,2446
0130-001,2011,9,10,18,1459,808,2267,2118
0130-001,2011,9,10,19,1240,679,1919,2267
0130-001,2011,9,10,20,1031,482,1513,1919
0130-001,2011,9,10,21,771,399,1170,1513
0130-001,2011,9,10,22,823,333,1156,1170
0130-001,2011,9,10,23,602,304,906,1156
0130-001,2011,9,10,24,441,231,672,906
0130-001,2011,9,11,1,348,458,806,672
0130-001,2011,9,11,2,249,306,555,806
0130-001,2011,9,11,3,193,398,591,555
0130-001,2011,9,11,4,136,301,437,591
0130-001,2011,9,11,5,133,449,582,437
0130-001,2011,9,11,6,184,613,797,582
0130-001,2011,9,11,7,321,1300,1621,797
0130-001,2011,9,11,8,399,2388,2787,1621
0130-001,2011,9,11,9,613,3201,3814,2787
0130-001,2011,9,11,10,997,3245,4242,3814
0130-001,2011,9,11,11,1582,3533,5115,4242
0130-001,2011,9,11,12,1647,3493,5140,5115
0130-001,2011,9,11,13,1658,3525,5183,5140
0130-001,2011,9,11,14,1340,3064,4404,5183
0130-001,2011,9,11,15,1192,2972,4164,4404
0130-001,2011,9,11,16,1163,2457,3620,4164
0130-001,2011,9,11,17,1069,2280,3349,3620
0130-001,2011,9,11,18,1049,1592,2641,3349
0130-001,2011,9,11,19,910,1109,2019,2641
0130-001,2011,9,11,20,667,1085,1752,2019
0130-001,2011,9,11,21,679,1030,1709,1752
0130-001,2011,9,11,22,617,598,1215,1709
0130-001,2011,9,11,23,453,482,935,1215
0130-001,2011,9,11,24,288,366,654,935
0130-001,2011,9,12,1,220,238,458,654
0130-001,2011,9,12,2,172,118,290,458
0130-001,2011,9,12,3,101,101,202,290
0130-001,2011,9,12,4,103,145,248,202
0130-001,2011,9,12,5,101,134,235,248
0130-001,2011,9,12,6,160,265,425,235
0130-001,2011,9,12,7,488,602,1090,425
0130-001,2011,9,12,8,977,1293,2270,1090
0130-001,2011,9,12,9,728,1281,2009,2270
0130-001,2011,9,12,10,902,1356,2258,2009
0130-001,2011,9,12,11,1688,2029,3717,2258
0130-001,2011,9,12,12,1684,2221,3905,3717
0130-001,2011,9,12,13,1663,2356,4019,3905
0130-001,2011,9,12,14,1394,2137,3531,4019
0130-001,2011,9,12,15,1293,2221,3514,3531
0130-001,2011,9,12,16,1472,2340,3812,3514
0130-001,2011,9,12,17,1600,2285,3885,3812
0130-001,2011,9,12,18,1614,2101,3715,3885
0130-001,2011,9,12,19,1567,1690,3257,3715
0130-001,2011,9,12,20,1237,1329,2566,3257
0130-001,2011,9,12,21,1312,905,2217,2566
0130-001,2011,9,12,22,1493,574,2067,2217
0130-001,2011,9,12,23,1282,518,1800,2067
0130-001,2011,9,12,24,744,337,1081,1800
0130-001,2011,9,13,1,1002,190,1192,1081
0130-001,2011,9,13,2,1720,114,1834,1192
0130-001,2011,9,13,3,1309,106,1415,1834
0130-001,2011,9,13,4,1205,106,1311,1415
0130-001,2011,9,13,5,869,101,970,1311
0130-001,2011,9,13,6,1058,78,1136,970
0130-001,2011,9,13,7,1607,158,1765,1136
0130-001,2011,9,13,8,1377,270,1647,1765
0130-001,2011,9,13,9,1558,381,1939,1647
0130-001,2011,9,13,10,1651,521,2172,1939
0130-001,2011,9,13,11,1535,957,2492,2172
0130-001,2011,9,13,12,1209,993,2202,2492
0130-001,2011,9,13,13,1774,1088,2862,2202
0130-001,2011,9,13,14,1906,1061,2967,2862
0130-001,2011,9,13,15,1807,1233,3040,2967
0130-001,2011,9,13,16,1491,1264,2755,3040
0130-001,2011,9,13,17,1455,1153,2608,2755
0130-001,2011,9,13,18,1639,1081,2720,2608
0130-001,2011,9,13,19,1552,1121,2673,2720
0130-001,2011,9,13,20,1345,960,2305,2673
0130-001,2011,9,13,21,1189,846,2035,2305
0130-001,2011,9,13,22,899,582,1481,2035
0130-001,2011,9,13,23,1163,470,1633,1481
0130-001,2011,9,13,24,1345,306,1651,1633
0130-001,2011,9,14,1,987,802,1789,1651
0130-001,2011,9,14,2,474,452,926,1789
0130-001,2011,9,14,3,193,190,383,926
0130-001,2011,9,14,4,163,170,333,383
0130-001,2011,9,14,5,140,227,367,333
0130-001,2011,9,14,6,285,286,571,367
0130-001,2011,9,14,7,1013,720,1733,571
0130-001,2011,9,14,8,2044,1496,3540,1733
0130-001,2011,9,14,9,1651,1583,3234,3540
0130-001,2011,9,14,10,1520,1614,3134,3234
0130-001,2011,9,14,11,1511,1520,3031,3134
0130-001,2011,9,14,12,1504,1440,2944,3031
0130-001,2011,9,14,13,1437,1538,2975,2944
0130-001,2011,9,14,14,1686,1647,3333,2975
0130-001,2011,9,14,15,1756,1811,3567,3333
0130-001,2011,9,14,16,1527,1555,3082,3567
0130-001,2011,9,14,17,1887,2034,3921,3082
0130-001,2011,9,14,18,992,1312,2304,3921
0130-001,2011,9,14,19,879,1216,2095,2304
0130-001,2011,9,14,20,723,859,1582,2095
0130-001,2011,9,14,21,670,730,1400,1582
0130-001,2011,9,14,22,596,587,1183,1400
0130-001,2011,9,14,23,416,351,767,1183
0130-001,2011,9,14,24,340,293,633,767
0130-001,2011,9,15,1,235,202,437,633
0130-001,2011,9,15,2,246,208,454,437
0130-001,2011,9,15,3,175,157,332,454
0130-001,2011,9,15,4,149,160,309,332
0130-001,2011,9,15,5,157,256,413,309
0130-001,2011,9,15,6,369,467,836,413
0130-001,2011,9,15,7,1318,969,2287,836
0130-001,2011,9,15,8,1933,1511,3444,2287
0130-001,2011,9,15,9,1762,1565,3327,3444
0130-001,2011,9,15,10,1811,1883,3694,3327
0130-001,2011,9,15,11,1722,1621,3343,3694
0130-001,2011,9,15,12,1509,1579,3088,3343
0130-001,2011,9,15,13,1368,1428,2796,3088
0130-001,2011,9,15,14,1582,1639,3221,2796
0130-001,2011,9,15,15,1479,1526,3005,3221
0130-001,2011,9,15,16,1455,1399,2854,3005
0130-001,2011,9,15,17,1583,1657,3240,2854
0130-001,2011,9,15,18,1491,1964,3455,3240
0130-001,2011,9,15,19,1625,2043,3668,3455
0130-001,2011,9,15,20,1345,1731,3076,3668
0130-001,2011,9,15,21,1138,1381,2519,3076
0130-001,2011,9,15,22,1088,1161,2249,2519
0130-001,2011,9,15,23,864,715,1579,2249
0130-001,2011,9,15,24,592,483,1075,1579
0130-001,2011,9,16,1,425,346,771,1075
0130-001,2011,9,16,2,250,203,453,771
0130-001,2011,9,16,3,198,176,374,453
0130-001,2011,9,16,4,160,147,307,374
0130-001,2011,9,16,5,178,279,457,307
0130-001,2011,9,16,6,385,423,808,457
0130-001,2011,9,16,7,1287,902,2189,808
0130-001,2011,9,16,8,1961,1442,3403,2189
0130-001,2011,9,16,9,1881,1765,3646,3403
0130-001,2011,9,16,10,1804,1806,3610,3646
0130-001,2011,9,16,11,1704,1680,3384,3610
0130-001,2011,9,16,12,1512,1561,3073,3384
0130-001,2011,9,16,13,1469,1547,3016,3073
0130-001,2011,9,16,14,1684,1794,3478,3016
0130-001,2011,9,16,15,1773,1749,3522,3478
0130-001,2011,9,16,16,1717,1735,3452,3522
0130-001,2011,9,16,17,1657,1821,3478,3452
0130-001,2011,9,16,18,1767,2089,3856,3478
0130-001,2011,9,16,19,1607,1896,3503,3856
0130-001,2011,9,16,20,1469,1988,3457,3503
0130-001,2011,9,16,21,1063,1297,2360,3457
0130-001,2011,9,16,22,1191,1240,2431,2360
0130-001,2011,9,16,23,927,718,1645,2431
0130-001,2011,9,16,24,710,574,1284,1645
0130-001,2011,9,17,1,429,339,768,1284
0130-001,2011,9,17,2,331,264,595,768
0130-001,2011,9,17,3,277,257,534,595
0130-001,2011,9,17,4,220,199,419,534
0130-001,2011,9,17,5,217,256,473,419
0130-001,2011,9,17,6,348,380,728,473
0130-001,2011,9,17,7,987,782,1769,728
0130-001,2011,9,17,8,1804,1702,3506,1769
0130-001,2011,9,17,9,1774,1797,3571,3506
0130-001,2011,9,17,10,1493,1655,3148,3571
0130-001,2011,9,17,11,1583,1916,3499,3148
0130-001,2011,9,17,12,1576,1986,3562,3499
0130-001,2011,9,17,13,1493,1872,3365,3562
0130-001,2011,9,17,14,1690,2054,3744,3365
0130-001,2011,9,17,15,1645,1967,3612,3744
0130-001,2011,9,17,16,1545,1807,3352,3612
0130-001,2011,9,17,17,1624,1713,3337,3352
0130-001,2011,9,17,18,1767,1800,3567,3337
0130-001,2011,9,17,19,1573,1570,3143,3567
0130-001,2011,9,17,20,1261,1294,2555,3143
0130-001,2011,9,17,21,1022,879,1901,2555
0130-001,2011,9,17,22,935,748,1683,1901
0130-001,2011,9,17,23,691,539,1230,1683
0130-001,2011,9,17,24,504,403,907,1230
0130-001,2011,9,18,1,358,303,661,907
0130-001,2011,9,18,2,271,216,487,661
0130-001,2011,9,18,3,181,173,354,487
0130-001,2011,9,18,4,169,137,306,354
0130-001,2011,9,18,5,184,181,365,306
0130-001,2011,9,18,6,265,322,587,365
0130-001,2011,9,18,7,512,435,947,587
0130-001,2011,9,18,8,667,605,1272,947
0130-001,2011,9,18,9,786,1010,1796,1272
0130-001,2011,9,18,10,906,1005,1911,1796
0130-001,2011,9,18,11,977,1265,2242,1911
0130-001,2011,9,18,12,979,1219,2198,2242
0130-001,2011,9,18,13,1037,1111,2148,2198
0130-001,2011,9,18,14,1179,1082,2261,2148
0130-001,2011,9,18,15,1267,1045,2312,2261
0130-001,2011,9,18,16,1424,1127,2551,2312
0130-001,2011,9,18,17,1435,1195,2630,2551
0130-001,2011,9,18,18,1361,1013,2374,2630
0130-001,2011,9,18,19,1341,935,2276,2374
0130-001,2011,9,18,20,1078,813,1891,2276
0130-001,2011,9,18,21,992,769,1761,1891
0130-001,2011,9,18,22,852,605,1457,1761
0130-001,2011,9,18,23,486,367,853,1457
0130-001,2011,9,18,24,354,279,633,853
0130-001,2011,9,19,1,231,173,404,633
0130-001,2011,9,19,2,114,107,221,404
0130-001,2011,9,19,3,100,93,193,221
0130-001,2011,9,19,4,77,81,158,193
0130-001,2011,9,19,5,103,154,257,158
0130-001,2011,9,19,6,275,324,599,257
0130-001,2011,9,19,7,1027,673,1700,599
0130-001,2011,9,19,8,1406,995,2401,1700
0130-001,2011,9,19,9,1573,1534,3107,2401
0130-001,2011,9,19,10,1437,1491,2928,3107
0130-001,2011,9,19,11,1522,1491,3013,2928
0130-001,2011,9,19,12,1353,1428,2781,3013
0130-001,2011,9,19,13,1281,1195,2476,2781
0130-001,2011,9,19,14,1388,1399,2787,2476
0130-001,2011,9,19,15,1576,1555,3131,2787
0130-001,2011,9,19,16,1487,1574,3061,3131
0130-001,2011,9,19,17,1448,1573,3021,3061
0130-001,2011,9,19,18,1547,2045,3592,3021
0130-001,2011,9,19,19,1614,2060,3674,3592
0130-001,2011,9,19,20,1174,1437,2611,3674
0130-001,2011,9,19,21,928,1159,2087,2611
0130-001,2011,9,19,22,892,979,1871,2087
0130-001,2011,9,19,23,778,598,1376,1871
0130-001,2011,9,19,24,417,315,732,1376
0130-001,2011,9,20,1,267,227,494,732
0130-001,2011,9,20,2,193,169,362,494
0130-001,2011,9,20,3,118,106,224,362
0130-001,2011,9,20,4,131,129,260,224
0130-001,2011,9,20,5,131,176,307,260
0130-001,2011,9,20,6,286,321,607,307
0130-001,2011,9,20,7,1184,769,1953,607
0130-001,2011,9,20,8,1632,1141,2773,1953
0130-001,2011,9,20,9,1699,1567,3266,2773
0130-001,2011,9,20,10,1719,1762,3481,3266
0130-001,2011,9,20,11,1662,1561,3223,3481
0130-001,2011,9,20,12,1522,1490,3012,3223
0130-001,2011,9,20,13,1359,1343,2702,3012
0130-001,2011,9,20,14,1522,1559,3081,2702
0130-001,2011,9,20,15,1535,1540,3075,3081
0130-001,2011,9,20,16,1607,1615,3222,3075
0130-001,2011,9,20,17,1570,1686,3256,3222
0130-001,2011,9,20,18,1658,2086,3744,3256
0130-001,2011,9,20,19,1377,1970,3347,3744
0130-001,2011,9,20,20,1355,1755,3110,3347
0130-001,2011,9,20,21,1166,1391,2557,3110
0130-001,2011,9,20,22,1184,1202,2386,2557
0130-001,2011,9,20,23,786,647,1433,2386
0130-001,2011,9,20,24,562,439,1001,1433
0130-001,2011,9,21,1,304,250,554,1001
0130-001,2011,9,21,2,256,203,459,554
0130-001,2011,9,21,3,175,161,336,459
0130-001,2011,9,21,4,170,158,328,336
0130-001,2011,9,21,5,175,257,432,328
0130-001,2011,9,21,6,342,432,774,432
0130-001,2011,9,21,7,1210,903,2113,774
0130-001,2011,9,21,8,1770,1308,3078,2113
0130-001,2011,9,21,9,1817,1720,3537,3078
0130-001,2011,9,21,10,1732,1675,3407,3537
0130-001,2011,9,21,11,1621,1567,3188,3407
0130-001,2011,9,21,12,1586,1558,3144,3188
0130-001,2011,9,21,13,1350,1445,2795,3144
0130-001,2011,9,21,14,1624,1722,3346,2795
0130-001,2011,9,21,15,1734,1771,3505,3346
0130-001,2011,9,21,16,1650,1538,3188,3505
0130-001,2011,9,21,17,1574,1633,3207,3188
0130-001,2011,9,21,18,1624,2104,3728,3207
0130-001,2011,9,21,19,1681,2239,3920,3728
0130-001,2011,9,21,20,1399,1740,3139,3920
0130-001,2011,9,21,21,1260,1425,2685,3139
0130-001,2011,9,21,22,1215,1069,2284,2685
0130-001,2011,9,21,23,864,716,1580,2284
0130-001,2011,9,21,24,590,465,1055,1580
0130-001,2011,9,22,1,395,390,785,1055
0130-001,2011,9,22,2,289,244,533,785
0130-001,2011,9,22,3,194,194,388,533
0130-001,2011,9,22,4,143,176,319,388
0130-001,2011,9,22,5,169,256,425,319
0130-001,2011,9,22,6,235,280,515,425
0130-001,2011,9,22,7,1225,877,2102,515
0130-001,2011,9,22,8,1820,1322,3142,2102
0130-001,2011,9,22,9,1832,1660,3492,3142
0130-001,2011,9,22,10,1509,1490,2999,3492
0130-001,2011,9,22,11,1552,1573,3125,2999
0130-001,2011,9,22,12,1527,1463,2990,3125
0130-001,2011,9,22,13,1257,1323,2580,2990
0130-001,2011,9,22,14,1675,1707,3382,2580
0130-001,2011,9,22,15,1647,1695,3342,3382
0130-001,2011,9,22,16,1205,1181,2386,3342
0130-001,2011,9,22,17,402,435,837,2386
0130-001,2011,9,22,18,677,730,1407,837
0130-001,2011,9,22,19,677,659,1336,1407
0130-001,2011,9,22,20,534,676,1210,1336
0130-001,2011,9,22,21,1004,1296,2300,1210
0130-001,2011,9,22,22,444,486,930,2300
0130-001,2011,9,22,23,515,498,1013,930
0130-001,2011,9,22,24,226,173,399,1013
0130-001,2011,9,23,1,208,167,375,399
0130-001,2011,9,23,2,127,104,231,375
0130-001,2011,9,23,3,89,81,170,231
0130-001,2011,9,23,4,83,83,166,170
0130-001,2011,9,23,5,124,176,300,166
0130-001,2011,9,23,6,270,283,553,300
0130-001,2011,9,23,7,1096,813,1909,553
0130-001,2011,9,23,8,1835,1281,3116,1909
0130-001,2011,9,23,9,1811,1731,3542,3116
0130-001,2011,9,23,10,1747,1845,3592,3542
0130-001,2011,9,23,11,1553,1501,3054,3592
0130-001,2011,9,23,12,986,1002,1988,3054
0130-001,2011,9,23,13,518,582,1100,1988
0130-001,2011,9,23,14,513,539,1052,1100
0130-001,2011,9,23,15,805,846,1651,1052
0130-001,2011,9,23,16,1052,1127,2179,1651
0130-001,2011,9,23,17,957,984,1941,2179
0130-001,2011,9,23,18,951,1166,2117,1941
0130-001,2011,9,23,19,724,891,1615,2117
0130-001,2011,9,23,20,969,1276,2245,1615
0130-001,2011,9,23,21,1130,1419,2549,2245
0130-001,2011,9,23,22,1169,1111,2280,2549
0130-001,2011,9,23,23,962,694,1656,2280
0130-001,2011,9,23,24,556,405,961,1656
0130-001,2011,9,24,1,495,384,879,961
0130-001,2011,9,24,2,369,298,667,879
0130-001,2011,9,24,3,247,244,491,667
0130-001,2011,9,24,4,209,198,407,491
0130-001,2011,9,24,5,214,246,460,407
0130-001,2011,9,24,6,286,301,587,460
0130-001,2011,9,24,7,775,683,1458,587
0130-001,2011,9,24,8,1205,936,2141,1458
0130-001,2011,9,24,9,1064,968,2032,2141
0130-001,2011,9,24,10,1219,1279,2498,2032
0130-001,2011,9,24,11,1639,1859,3498,2498
0130-001,2011,9,24,12,1832,2293,4125,3498
0130-001,2011,9,24,13,1430,2083,3513,4125
0130-001,2011,9,24,14,1427,1686,3113,3513
0130-001,2011,9,24,15,1401,1526,2927,3113
0130-001,2011,9,24,16,1415,1573,2988,2927
0130-001,2011,9,24,17,1419,1341,2760,2988
0130-001,2011,9,24,18,1655,1541,3196,2760
0130-001,2011,9,24,19,1516,1647,3163,3196
0130-001,2011,9,24,20,1329,1191,2520,3163
0130-001,2011,9,24,21,1102,971,2073,2520
0130-001,2011,9,24,22,1078,887,1965,2073
0130-001,2011,9,24,23,705,518,1223,1965
0130-001,2011,9,24,24,564,453,1017,1223
0130-001,2011,9,25,1,431,362,793,1017
0130-001,2011,9,25,2,304,277,581,793
0130-001,2011,9,25,3,234,199,433,581
0130-001,2011,9,25,4,187,127,314,433
0130-001,2011,9,25,5,203,227,430,314
0130-001,2011,9,25,6,224,264,488,430
0130-001,2011,9,25,7,570,439,1009,488
0130-001,2011,9,25,8,742,664,1406,1009
0130-001,2011,9,25,9,849,1012,1861,1406
0130-001,2011,9,25,10,677,738,1415,1861
0130-001,2011,9,25,11,924,1156,2080,1415
0130-001,2011,9,25,12,1005,1245,2250,2080
0130-001,2011,9,25,13,918,1094,2012,2250
0130-001,2011,9,25,14,1315,1397,2712,2012
0130-001,2011,9,25,15,1437,1563,3000,2712
0130-001,2011,9,25,16,1600,1427,3027,3000
0130-001,2011,9,25,17,1734,1466,3200,3027
0130-001,2011,9,25,18,1675,1603,3278,3200
0130-001,2011,9,25,19,1730,1576,3306,3278
0130-001,2011,9,25,20,1345,1133,2478,3306
0130-001,2011,9,25,21,1123,891,2014,2478
0130-001,2011,9,25,22,968,669,1637,2014
0130-001,2011,9,25,23,574,431,1005,1637
0130-001,2011,9,25,24,453,300,753,1005
0130-001,2011,9,26,1,238,170,408,753
0130-001,2011,9,26,2,172,137,309,408
0130-001,2011,9,26,3,133,114,247,309
0130-001,2011,9,26,4,98,80,178,247
0130-001,2011,9,26,5,147,203,350,178
0130-001,2011,9,26,6,375,425,800,350
0130-001,2011,9,26,7,950,647,1597,800
0130-001,2011,9,26,8,1594,1056,2650,1597
0130-001,2011,9,26,9,1854,1734,3588,2650
0130-001,2011,9,26,10,1530,1577,3107,3588
0130-001,2011,9,26,11,1586,1541,3127,3107
0130-001,2011,9,26,12,1535,1529,3064,3127
0130-001,2011,9,26,13,1239,1314,2553,3064
0130-001,2011,9,26,14,1632,1544,3176,2553
0130-001,2011,9,26,15,1228,1176,2404,3176
0130-001,2011,9,26,16,1267,1240,2507,2404
0130-001,2011,9,26,17,1082,1148,2230,2507
0130-001,2011,9,26,18,1425,1720,3145,2230
0130-001,2011,9,26,19,855,1121,1976,3145
0130-001,2011,9,26,20,646,802,1448,1976
0130-001,2011,9,26,21,589,790,1379,1448
0130-001,2011,9,26,22,578,603,1181,1379
0130-001,2011,9,26,23,541,447,988,1181
0130-001,2011,9,26,24,328,238,566,988
0130-001,2011,9,27,1,209,191,400,566
0130-001,2011,9,27,2,113,101,214,400
0130-001,2011,9,27,3,129,121,250,214
0130-001,2011,9,27,4,111,118,229,250
0130-001,2011,9,27,5,107,133,240,229
0130-001,2011,9,27,6,354,408,762,240
0130-001,2011,9,27,7,1183,775,1958,762
0130-001,2011,9,27,8,1227,838,2065,1958
0130-001,2011,9,27,9,1577,1450,3027,2065
0130-001,2011,9,27,10,1491,1516,3007,3027
0130-001,2011,9,27,11,1663,1628,3291,3007
0130-001,2011,9,27,12,1517,1568,3085,3291
0130-001,2011,9,27,13,1278,1345,2623,3085
0130-001,2011,9,27,14,1675,1540,3215,2623
0130-001,2011,9,27,15,1508,1574,3082,3215
0130-001,2011,9,27,16,1552,1493,3045,3082
0130-001,2011,9,27,17,1559,1639,3198,3045
0130-001,2011,9,27,18,1494,1829,3323,3198
0130-001,2011,9,27,19,1701,2481,4182,3323
0130-001,2011,9,27,20,1419,1722,3141,4182
0130-001,2011,9,27,21,1166,1366,2532,3141
0130-001,2011,9,27,22,1151,1239,2390,2532
0130-001,2011,9,27,23,885,709,1594,2390
0130-001,2011,9,27,24,580,432,1012,1594
0130-001,2011,9,28,1,405,354,759,1012
0130-001,2011,9,28,2,238,206,444,759
0130-001,2011,9,28,3,196,170,366,444
0130-001,2011,9,28,4,158,147,305,366
0130-001,2011,9,28,5,152,196,348,305
0130-001,2011,9,28,6,354,411,765,348
0130-001,2011,9,28,7,1272,802,2074,765
0130-001,2011,9,28,8,1437,987,2424,2074
0130-001,2011,9,28,9,1526,1415,2941,2424
0130-001,2011,9,28,10,1755,1898,3653,2941
0130-001,2011,9,28,11,1655,1563,3218,3653
0130-001,2011,9,28,12,1618,1633,3251,3218
0130-001,2011,9,28,13,1359,1440,2799,3251
0130-001,2011,9,28,14,1610,1589,3199,2799
0130-001,2011,9,28,15,1660,1628,3288,3199
0130-001,2011,9,28,16,1696,1702,3398,3288
0130-001,2011,9,28,17,1615,1701,3316,3398
0130-001,2011,9,28,18,1684,2146,3830,3316
0130-001,2011,9,28,19,1619,2042,3661,3830
0130-001,2011,9,28,20,1281,1648,2929,3661
0130-001,2011,9,28,21,1174,1356,2530,2929
0130-001,2011,9,28,22,1230,1158,2388,2530
0130-001,2011,9,28,23,933,703,1636,2388
0130-001,2011,9,28,24,658,531,1189,1636
0130-001,2011,9,29,1,438,334,772,1189
0130-001,2011,9,29,2,235,188,423,772
0130-001,2011,9,29,3,188,176,364,423
0130-001,2011,9,29,4,145,167,312,364
0130-001,2011,9,29,5,157,213,370,312
0130-001,2011,9,29,6,334,391,725,370
0130-001,2011,9,29,7,1165,793,1958,725
0130-001,2011,9,29,8,1902,1309,3211,1958
0130-001,2011,9,29,9,1603,1487,3090,3211
0130-001,2011,9,29,10,1665,1705,3370,3090
0130-001,2011,9,29,11,1491,1446,2937,3370
0130-001,2011,9,29,12,1437,1574,3011,2937
0130-001,2011,9,29,13,1227,1257,2484,3011
0130-001,2011,9,29,14,1553,1508,3061,2484
0130-001,2011,9,29,15,1541,1568,3109,3061
0130-001,2011,9,29,16,1545,1481,3026,3109
0130-001,2011,9,29,17,1464,1547,3011,3026
0130-001,2011,9,29,18,1628,2068,3696,3011
0130-001,2011,9,29,19,1600,2385,3985,3696
0130-001,2011,9,29,20,1282,1609,2891,3985
0130-001,2011,9,29,21,1174,1257,2431,2891
0130-001,2011,9,29,22,1165,1151,2316,2431
0130-001,2011,9,29,23,816,662,1478,2316
0130-001,2011,9,29,24,622,503,1125,1478
0130-001,2011,9,30,1,459,395,854,1125
0130-001,2011,9,30,2,247,209,456,854
0130-001,2011,9,30,3,175,160,335,456
0130-001,2011,9,30,4,188,179,367,335
0130-001,2011,9,30,5,175,216,391,367
0130-001,2011,9,30,6,337,405,742,391
0130-001,2011,9,30,7,1239,879,2118,742
0130-001,2011,9,30,8,1812,1143,2955,2118
0130-001,2011,9,30,9,1735,1734,3469,2955
0130-001,2011,9,30,10,1709,1704,3413,3469
0130-001,2011,9,30,11,1734,1716,3450,3413
0130-001,2011,9,30,12,1591,1691,3282,3450
0130-001,2011,9,30,13,1451,1571,3022,3282
0130-001,2011,9,30,14,1643,1821,3464,3022
0130-001,2011,9,30,15,1723,1880,3603,3464
0130-001,2011,9,30,16,1750,1901,3651,3603
0130-001,2011,9,30,17,1651,1985,3636,3651
0130-001,2011,9,30,18,1693,2092,3785,3636
0130-001,2011,9,30,19,1683,2041,3724,3785
0130-001,2011,9,30,20,1389,1588,2977,3724
0130-001,2011,9,30,21,1231,1257,2488,2977
0130-001,2011,9,30,22,1228,1207,2435,2488
0130-001,2011,9,30,23,1030,802,1832,2435
0130-001,2011,9,30,24,718,578,1296,1832
0130-001,2011,10,1,1,759,405,1164,1296
0130-001,2011,10,1,2,509,266,775,1164
0130-001,2011,10,1,3,301,114,415,775
0130-001,2011,10,1,4,218,69,287,415
0130-001,2011,10,1,5,213,39,252,287
0130-001,2011,10,1,6,194,121,315,252
0130-001,2011,10,1,7,525,114,639,315
0130-001,2011,10,1,8,816,76,892,639
0130-001,2011,10,1,9,835,729,1564,892
0130-001,2011,10,1,10,720,1236,1956,1564
0130-001,2011,10,1,11,776,1751,2527,1956
0130-001,2011,10,1,12,926,2528,3454,2527
0130-001,2011,10,1,13,985,1681,2666,3454
0130-001,2011,10,1,14,1996,2148,4144,2666
0130-001,2011,10,1,15,2117,3023,5140,4144
0130-001,2011,10,1,16,2131,2653,4784,5140
0130-001,2011,10,1,17,2349,1804,4153,4784
0130-001,2011,10,1,18,2351,1867,4218,4153
0130-001,2011,10,1,19,1894,1580,3474,4218
0130-001,2011,10,1,20,1825,948,2773,3474
0130-001,2011,10,1,21,1583,641,2224,2773
0130-001,2011,10,1,22,1450,718,2168,2224
0130-001,2011,10,1,23,1049,515,1564,2168
0130-001,2011,10,1,24,698,365,1063,1564
0130-001,2011,10,2,1,518,138,656,1063
0130-001,2011,10,2,2,396,162,558,656
0130-001,2011,10,2,3,266,103,369,558
0130-001,2011,10,2,4,156,107,263,369
0130-001,2011,10,2,5,98,112,210,263
0130-001,2011,10,2,6,222,73,295,210
0130-001,2011,10,2,7,374,165,539,295
0130-001,2011,10,2,8,745,719,1464,539
0130-001,2011,10,2,9,872,1000,1872,1464
0130-001,2011,10,2,10,826,959,1785,1872
0130-001,2011,10,2,11,1105,1360,2465,1785
0130-001,2011,10,2,12,1056,1306,2362,2465
0130-001,2011,10,2,13,1168,1250,2418,2362
0130-001,2011,10,2,14,1504,1435,2939,2418
0130-001,2011,10,2,15,1593,1547,3140,2939
0130-001,2011,10,2,16,1870,1502,3372,3140
0130-001,2011,10,2,17,1428,1144,2572,3372
0130-001,2011,10,2,18,1360,1198,2558,2572
0130-001,2011,10,2,19,1468,1188,2656,2558
0130-001,2011,10,2,20,1492,1161,2653,2656
0130-001,2011,10,2,21,1176,960,2136,2653
0130-001,2011,10,2,22,993,698,1691,2136
0130-001,2011,10,2,23,424,531,955,1691
0130-001,2011,10,2,24,280,331,611,955
0130-001,2011,10,3,1,287,245,532,611
0130-001,2011,10,3,2,190,163,353,532
0130-001,2011,10,3,3,135,129,264,353
0130-001,2011,10,3,4,93,79,172,264
0130-001,2011,10,3,5,140,208,348,172
0130-001,2011,10,3,6,366,417,783,348
0130-001,2011,10,3,7,1113,716,1829,783
0130-001,2011,10,3,8,1539,1065,2604,1829
0130-001,2011,10,3,9,1535,1466,3001,2604
0130-001,2011,10,3,10,1606,1614,3220,3001
0130-001,2011,10,3,11,1596,1526,3122,3220
0130-001,2011,10,3,12,1562,1569,3131,3122
0130-001,2011,10,3,13,1340,1368,2708,3131
0130-001,2011,10,3,14,1588,1537,3125,2708
0130-001,2011,10,3,15,1475,1439,2914,3125
0130-001,2011,10,3,16,1459,1497,2956,2914
0130-001,2011,10,3,17,1371,1462,2833,2956
0130-001,2011,10,3,18,1569,1918,3487,2833
0130-001,2011,10,3,19,1245,1597,2842,3487
0130-001,2011,10,3,20,1199,1483,2682,2842
0130-001,2011,10,3,21,921,1288,2209,2682
0130-001,2011,10,3,22,849,894,1743,2209
0130-001,2011,10,3,23,709,608,1317,1743
0130-001,2011,10,3,24,487,439,926,1317
0130-001,2011,10,4,1,283,226,509,926
0130-001,2011,10,4,2,185,161,346,509
0130-001,2011,10,4,3,155,151,306,346
0130-001,2011,10,4,4,127,123,250,306
0130-001,2011,10,4,5,131,185,316,250
0130-001,2011,10,4,6,343,400,743,316
0130-001,2011,10,4,7,1262,829,2091,743
0130-001,2011,10,4,8,1345,964,2309,2091
0130-001,2011,10,4,9,1410,1365,2775,2309
0130-001,2011,10,4,10,1578,1603,3181,2775
0130-001,2011,10,4,11,1641,1540,3181,3181
0130-001,2011,10,4,12,1478,1497,2975,3181
0130-001,2011,10,4,13,1288,1315,2603,2975
0130-001,2011,10,4,14,1586,1568,3154,2603
0130-001,2011,10,4,15,1614,1651,3265,3154
0130-001,2011,10,4,16,1588,1615,3203,3265
0130-001,2011,10,4,17,1583,1656,3239,3203
0130-001,2011,10,4,18,1552,1943,3495,3239
0130-001,2011,10,4,19,1878,2465,4343,3495
0130-001,2011,10,4,20,1377,1786,3163,4343
0130-001,2011,10,4,21,1175,1435,2610,3163
0130-001,2011,10,4,22,1129,1198,2327,2610
0130-001,2011,10,4,23,866,716,1582,2327
0130-001,2011,10,4,24,571,460,1031,1582
0130-001,2011,10,5,1,169,148,317,1031
0130-001,2011,10,5,2,114,100,214,317
0130-001,2011,10,5,3,83,92,175,214
0130-001,2011,10,5,4,78,78,156,175
0130-001,2011,10,5,5,76,107,183,156
0130-001,2011,10,5,6,174,194,368,183
0130-001,2011,10,5,7,588,369,957,368
0130-001,2011,10,5,8,670,489,1159,957
0130-001,2011,10,5,9,684,670,1354,1159
0130-001,2011,10,5,10,850,867,1717,1354
0130-001,2011,10,5,11,1001,956,1957,1717
0130-001,2011,10,5,12,2112,2070,4182,1957
0130-001,2011,10,5,13,1797,1872,3669,4182
0130-001,2011,10,5,14,2439,2611,5050,3669
0130-001,2011,10,5,15,2191,2210,4401,5050
0130-001,2011,10,5,16,2534,2571,5105,4401
0130-001,2011,10,5,17,2349,2461,4810,5105
0130-001,2011,10,5,18,2374,3123,5497,4810
0130-001,2011,10,5,19,2543,3378,5921,5497
0130-001,2011,10,5,20,1872,2501,4373,5921
0130-001,2011,10,5,21,1627,1982,3609,4373
0130-001,2011,10,5,22,1162,1145,2307,3609
0130-001,2011,10,5,23,610,535,1145,2307
0130-001,2011,10,5,24,435,369,804,1145
0130-001,2011,10,6,1,371,340,711,804
0130-001,2011,10,6,2,357,304,661,711
0130-001,2011,10,6,3,222,182,404,661
0130-001,2011,10,6,4,162,162,324,404
0130-001,2011,10,6,5,204,278,482,324
0130-001,2011,10,6,6,391,391,782,482
0130-001,2011,10,6,7,898,614,1512,782
0130-001,2011,10,6,8,2730,1952,4682,1512
0130-001,2011,10,6,9,1738,1621,3359,4682
0130-001,2011,10,6,10,2177,2220,4397,3359
0130-001,2011,10,6,11,1742,1645,3387,4397
0130-001,2011,10,6,12,2235,2199,4434,3387
0130-001,2011,10,6,13,1717,1669,3386,4434
0130-001,2011,10,6,14,1487,1494,2981,3386
0130-001,2011,10,6,15,1667,1790,3457,2981
0130-001,2011,10,6,16,1069,1100,2169,3457
0130-001,2011,10,6,17,1450,1605,3055,2169
0130-001,2011,10,6,18,1489,1920,3409,3055
0130-001,2011,10,6,19,1594,1973,3567,3409
0130-001,2011,10,6,20,1624,1898,3522,3567
0130-001,2011,10,6,21,1413,1878,3291,3522
0130-001,2011,10,6,22,1013,1103,2116,3291
0130-001,2011,10,6,23,746,676,1422,2116
0130-001,2011,10,6,24,441,374,815,1422
0130-001,2011,10,7,1,317,275,592,815
0130-001,2011,10,7,2,263,225,488,592
0130-001,2011,10,7,3,98,83,181,488
0130-001,2011,10,7,4,78,87,165,181
0130-001,2011,10,7,5,109,162,271,165
0130-001,2011,10,7,6,177,183,360,271
0130-001,2011,10,7,7,559,376,935,360
0130-001,2011,10,7,8,776,588,1364,935
0130-001,2011,10,7,9,690,624,1314,1364
0130-001,2011,10,7,10,1387,1402,2789,1314
0130-001,2011,10,7,11,1542,1407,2949,2789
0130-001,2011,10,7,12,2001,2070,4071,2949
0130-001,2011,10,7,13,1864,1938,3802,4071
0130-001,2011,10,7,14,2373,2570,4943,3802
0130-001,2011,10,7,15,1760,1776,3536,4943
0130-001,2011,10,7,16,2204,2401,4605,3536
0130-001,2011,10,7,17,1856,1948,3804,4605
0130-001,2011,10,7,18,1011,1227,2238,3804
0130-001,2011,10,7,19,1915,2374,4289,2238
0130-001,2011,10,7,20,1703,2134,3837,4289
0130-001,2011,10,7,21,1742,2227,3969,3837
0130-001,2011,10,7,22,1771,1929,3700,3969
0130-001,2011,10,7,23,1022,900,1922,3700
0130-001,2011,10,7,24,889,742,1631,1922
0130-001,2011,10,8,1,1031,889,1920,1631
0130-001,2011,10,8,2,861,763,1624,1920
0130-001,2011,10,8,3,463,432,895,1624
0130-001,2011,10,8,4,358,377,735,895
0130-001,2011,10,8,5,213,225,438,735
0130-001,2011,10,8,6,368,421,789,438
0130-001,2011,10,8,7,869,687,1556,789
0130-001,2011,10,8,8,1512,1335,2847,1556
0130-001,2011,10,8,9,1689,1540,3229,2847
0130-001,2011,10,8,10,1622,1622,3244,3229
0130-001,2011,10,8,11,1689,2017,3706,3244
0130-001,2011,10,8,12,1737,2216,3953,3706
0130-001,2011,10,8,13,1670,2224,3894,3953
0130-001,2011,10,8,14,1774,2228,4002,3894
0130-001,2011,10,8,15,1765,2070,3835,4002
0130-001,2011,10,8,16,1486,1749,3235,3835
0130-001,2011,10,8,17,1368,1462,2830,3235
0130-001,2011,10,8,18,1049,1108,2157,2830
0130-001,2011,10,8,19,664,700,1364,2157
0130-001,2011,10,8,20,915,1060,1975,1364
0130-001,2011,10,8,21,1596,1382,2978,1975
0130-001,2011,10,8,22,1116,928,2044,2978
0130-001,2011,10,8,23,1060,936,1996,2044
0130-001,2011,10,8,24,895,720,1615,1996
0130-001,2011,10,9,1,443,352,795,1615
0130-001,2011,10,9,2,432,368,800,795
0130-001,2011,10,9,3,263,233,496,800
0130-001,2011,10,9,4,181,153,334,496
0130-001,2011,10,9,5,213,197,410,334
0130-001,2011,10,9,6,286,317,603,410
0130-001,2011,10,9,7,604,555,1159,603
0130-001,2011,10,9,8,748,774,1522,1159
0130-001,2011,10,9,9,895,988,1883,1522
0130-001,2011,10,9,10,975,1180,2155,1883
0130-001,2011,10,9,11,1286,1564,2850,2155
0130-001,2011,10,9,12,1108,1368,2476,2850
0130-001,2011,10,9,13,1419,1407,2826,2476
0130-001,2011,10,9,14,1693,1473,3166,2826
0130-001,2011,10,9,15,1749,1531,3280,3166
0130-001,2011,10,9,16,2139,1576,3715,3280
0130-001,2011,10,9,17,1123,821,1944,3715
0130-001,2011,10,9,18,1046,793,1839,1944
0130-001,2011,10,9,19,1206,801,2007,1839
0130-001,2011,10,9,20,1638,1189,2827,2007
0130-001,2011,10,9,21,1230,1029,2259,2827
0130-001,2011,10,9,22,1018,727,1745,2259
0130-001,2011,10,9,23,696,510,1206,1745
0130-001,2011,10,9,24,456,368,824,1206
0130-001,2011,10,10,1,349,329,678,824
0130-001,2011,10,10,2,218,197,415,678
0130-001,2011,10,10,3,144,150,294,415
0130-001,2011,10,10,4,93,83,176,294
0130-001,2011,10,10,5,141,225,366,176
0130-001,2011,10,10,6,378,432,810,366
0130-001,2011,10,10,7,1329,821,2150,810
0130-001,2011,10,10,8,1571,1133,2704,2150
0130-001,2011,10,10,9,1305,1293,2598,2704
0130-001,2011,10,10,10,1767,1737,3504,2598
0130-001,2011,10,10,11,1693,1596,3289,3504
0130-001,2011,10,10,12,1674,1693,3367,3289
0130-001,2011,10,10,13,1509,1494,3003,3367
0130-001,2011,10,10,14,1633,1615,3248,3003
0130-001,2011,10,10,15,1790,1767,3557,3248
0130-001,2011,10,10,16,1720,1823,3543,3557
0130-001,2011,10,10,17,1720,1840,3560,3543
0130-001,2011,10,10,18,1792,2197,3989,3560
0130-001,2011,10,10,19,1683,2134,3817,3989
0130-001,2011,10,10,20,1787,2208,3995,3817
0130-001,2011,10,10,21,1286,1830,3116,3995
0130-001,2011,10,10,22,1152,1219,2371,3116
0130-001,2011,10,10,23,907,793,1700,2371
0130-001,2011,10,10,24,664,653,1317,1700
0130-001,2011,10,11,1,368,271,639,1317
0130-001,2011,10,11,2,263,227,490,639
0130-001,2011,10,11,3,188,188,376,490
0130-001,2011,10,11,4,150,134,284,376
0130-001,2011,10,11,5,160,244,404,284
0130-001,2011,10,11,6,352,415,767,404
0130-001,2011,10,11,7,1406,926,2332,767
0130-001,2011,10,11,8,1531,1137,2668,2332
0130-001,2011,10,11,9,1329,1359,2688,2668
0130-001,2011,10,11,10,1748,1774,3522,2688
0130-001,2011,10,11,11,1710,1541,3251,3522
0130-001,2011,10,11,12,1522,1512,3034,3251
0130-001,2011,10,11,13,1368,1359,2727,3034
0130-001,2011,10,11,14,1589,1681,3270,2727
0130-001,2011,10,11,15,1804,1815,3619,3270
0130-001,2011,10,11,16,1710,1820,3530,3619
0130-001,2011,10,11,17,1693,1764,3457,3530
0130-001,2011,10,11,18,1693,2157,3850,3457
0130-001,2011,10,11,19,2135,2573,4708,3850
0130-001,2011,10,11,20,1414,1944,3358,4708
0130-001,2011,10,11,21,1249,1579,2828,3358
0130-001,2011,10,11,22,1170,1226,2396,2828
0130-001,2011,10,11,23,895,763,1658,2396
0130-001,2011,10,11,24,593,512,1105,1658
0130-001,2011,10,12,1,368,329,697,1105
0130-001,2011,10,12,2,263,218,481,697
0130-001,2011,10,12,3,181,177,358,481
0130-001,2011,10,12,4,144,144,288,358
0130-001,2011,10,12,5,197,305,502,288
0130-001,2011,10,12,6,385,443,828,502
0130-001,2011,10,12,7,1206,821,2027,828
0130-001,2011,10,12,8,1351,951,2302,2027
0130-001,2011,10,12,9,1425,1391,2816,2302
0130-001,2011,10,12,10,1774,2167,3941,2816
0130-001,2011,10,12,11,1787,1509,3296,3941
0130-001,2011,10,12,12,1556,1599,3155,3296
0130-001,2011,10,12,13,1359,1397,2756,3155
0130-001,2011,10,12,14,1596,1670,3266,2756
0130-001,2011,10,12,15,1729,1767,3496,3266
0130-001,2011,10,12,16,1741,1787,3528,3496
0130-001,2011,10,12,17,1663,1737,3400,3528
0130-001,2011,10,12,18,2388,3229,5617,3400
0130-001,2011,10,12,19,1815,2426,4241,5617
0130-001,2011,10,12,20,1310,1599,2909,4241
0130-001,2011,10,12,21,1257,1455,2712,2909
0130-001,2011,10,12,22,1217,1151,2368,2712
0130-001,2011,10,12,23,999,951,1950,2368
0130-001,2011,10,12,24,608,547,1155,1950
0130-001,2011,10,13,1,415,342,757,1155
0130-001,2011,10,13,2,286,227,513,757
0130-001,2011,10,13,3,190,153,343,513
0130-001,2011,10,13,4,160,153,313,343
0130-001,2011,10,13,5,177,286,463,313
0130-001,2011,10,13,6,361,432,793,463
0130-001,2011,10,13,7,1278,848,2126,793
0130-001,2011,10,13,8,1419,1022,2441,2126
0130-001,2011,10,13,9,1230,1219,2449,2441
0130-001,2011,10,13,10,1761,1897,3658,2449
0130-001,2011,10,13,11,1726,1670,3396,3658
0130-001,2011,10,13,12,1559,1614,3173,3396
0130-001,2011,10,13,13,1335,1321,2656,3173
0130-001,2011,10,13,14,1693,1584,3277,2656
0130-001,2011,10,13,15,1764,1787,3551,3277
0130-001,2011,10,13,16,1531,1622,3153,3551
0130-001,2011,10,13,17,1761,1901,3662,3153
0130-001,2011,10,13,18,1729,2040,3769,3662
0130-001,2011,10,13,19,1748,2239,3987,3769
0130-001,2011,10,13,20,1378,1615,2993,3987
0130-001,2011,10,13,21,1254,1589,2843,2993
0130-001,2011,10,13,22,1206,1242,2448,2843
0130-001,2011,10,13,23,884,824,1708,2448
0130-001,2011,10,13,24,664,577,1241,1708
0130-001,2011,10,14,1,425,378,803,1241
0130-001,2011,10,14,2,281,218,499,803
0130-001,2011,10,14,3,233,233,466,499
0130-001,2011,10,14,4,190,213,403,466
0130-001,2011,10,14,5,165,225,390,403
0130-001,2011,10,14,6,406,499,905,390
0130-001,2011,10,14,7,1174,748,1922,905
0130-001,2011,10,14,8,1406,993,2399,1922
0130-001,2011,10,14,9,1217,1183,2400,2399
0130-001,2011,10,14,10,1638,1518,3156,2400
0130-001,2011,10,14,11,1717,1840,3557,3156
0130-001,2011,10,14,12,1615,1652,3267,3557
0130-001,2011,10,14,13,1407,1522,2929,3267
0130-001,2011,10,14,14,1658,1638,3296,2929
0130-001,2011,10,14,15,1808,1764,3572,3296
0130-001,2011,10,14,16,1809,2017,3826,3572
0130-001,2011,10,14,17,1729,1823,3552,3826
0130-001,2011,10,14,18,1816,2081,3897,3552
0130-001,2011,10,14,19,1473,1777,3250,3897
0130-001,2011,10,14,20,1407,1964,3371,3250
0130-001,2011,10,14,21,1254,1529,2783,3371
0130-001,2011,10,14,22,1159,1159,2318,2783
0130-001,2011,10,14,23,1003,839,1842,2318
0130-001,2011,10,14,24,690,541,1231,1842
0130-001,2011,10,15,1,488,408,896,1231
0130-001,2011,10,15,2,358,339,697,896
0130-001,2011,10,15,3,271,227,498,697
0130-001,2011,10,15,4,256,248,504,498
0130-001,2011,10,15,5,237,286,523,504
0130-001,2011,10,15,6,342,385,727,523
0130-001,2011,10,15,7,928,718,1646,727
0130-001,2011,10,15,8,1643,1301,2944,1646
0130-001,2011,10,15,9,1652,1658,3310,2944
0130-001,2011,10,15,10,1646,1808,3454,3310
0130-001,2011,10,15,11,1540,1815,3355,3454
0130-001,2011,10,15,12,1556,1701,3257,3355
0130-001,2011,10,15,13,1633,2180,3813,3257
0130-001,2011,10,15,14,1768,2192,3960,3813
0130-001,2011,10,15,15,1720,2086,3806,3960
0130-001,2011,10,15,16,1705,1851,3556,3806
0130-001,2011,10,15,17,1614,1646,3260,3556
0130-001,2011,10,15,18,748,810,1558,3260
0130-001,2011,10,15,19,763,767,1530,1558
0130-001,2011,10,15,20,1305,1359,2664,1530
0130-001,2011,10,15,21,1305,1242,2547,2664
0130-001,2011,10,15,22,1257,999,2256,2547
0130-001,2011,10,15,23,982,785,1767,2256
0130-001,2011,10,15,24,555,421,976,1767
0130-001,2011,10,16,1,396,330,726,976
0130-001,2011,10,16,2,271,248,519,726
0130-001,2011,10,16,3,248,197,445,519
0130-001,2011,10,16,4,190,160,350,445
0130-001,2011,10,16,5,197,225,422,350
0130-001,2011,10,16,6,237,274,511,422
0130-001,2011,10,16,7,482,451,933,511
0130-001,2011,10,16,8,738,743,1481,933
0130-001,2011,10,16,9,926,1199,2125,1481
0130-001,2011,10,16,10,1041,1180,2221,2125
0130-001,2011,10,16,11,1226,1413,2639,2221
0130-001,2011,10,16,12,1189,1412,2601,2639
0130-001,2011,10,16,13,1321,1237,2558,2601
0130-001,2011,10,16,14,1584,1368,2952,2558
0130-001,2011,10,16,15,1582,1262,2844,2952
0130-001,2011,10,16,16,1589,1348,2937,2844
0130-001,2011,10,16,17,712,570,1282,2937
0130-001,2011,10,16,18,712,550,1262,1282
0130-001,2011,10,16,19,700,432,1132,1262
0130-001,2011,10,16,20,1237,973,2210,1132
0130-001,2011,10,16,21,1226,975,2201,2210
0130-001,2011,10,16,22,1080,733,1813,2201
0130-001,2011,10,16,23,727,535,1262,1813
0130-001,2011,10,16,24,482,361,843,1262
0130-001,2011,10,17,1,291,227,518,843
0130-001,2011,10,17,2,208,165,373,518
0130-001,2011,10,17,3,153,170,323,373
0130-001,2011,10,17,4,122,121,243,323
0130-001,2011,10,17,5,177,237,414,243
0130-001,2011,10,17,6,377,389,766,414
0130-001,2011,10,17,7,1335,852,2187,766
0130-001,2011,10,17,8,1450,999,2449,2187
0130-001,2011,10,17,9,1518,1493,3011,2449
0130-001,2011,10,17,10,1680,1787,3467,3011
0130-001,2011,10,17,11,1689,1596,3285,3467
0130-001,2011,10,17,12,1556,1512,3068,3285
0130-001,2011,10,17,13,1425,1435,2860,3068
0130-001,2011,10,17,14,1614,1599,3213,2860
0130-001,2011,10,17,15,1686,1764,3450,3213
0130-001,2011,10,17,16,1683,1741,3424,3450
0130-001,2011,10,17,17,1685,1774,3459,3424
0130-001,2011,10,17,18,1683,2046,3729,3459
0130-001,2011,10,17,19,1670,2058,3728,3729
0130-001,2011,10,17,20,1371,1756,3127,3728
0130-001,2011,10,17,21,1230,1565,2795,3127
0130-001,2011,10,17,22,1080,1219,2299,2795
0130-001,2011,10,17,23,861,801,1662,2299
0130-001,2011,10,17,24,597,547,1144,1662
0130-001,2011,10,18,1,415,361,776,1144
0130-001,2011,10,18,2,248,208,456,776
0130-001,2011,10,18,3,190,177,367,456
0130-001,2011,10,18,4,150,141,291,367
0130-001,2011,10,18,5,165,237,402,291
0130-001,2011,10,18,6,368,432,800,402
0130-001,2011,10,18,7,1936,1406,3342,800
0130-001,2011,10,18,8,3010,2160,5170,3342
0130-001,2011,10,18,9,1596,1512,3108,5170
0130-001,2011,10,18,10,1815,1741,3556,3108
0130-001,2011,10,18,11,1808,1729,3537,3556
0130-001,2011,10,18,12,1607,1541,3148,3537
0130-001,2011,10,18,13,1406,1425,2831,3148
0130-001,2011,10,18,14,1646,1615,3261,2831
0130-001,2011,10,18,15,1749,1871,3620,3261
0130-001,2011,10,18,16,1748,1777,3525,3620
0130-001,2011,10,18,17,1614,1741,3355,3525
0130-001,2011,10,18,18,1784,2158,3942,3355
0130-001,2011,10,18,19,1540,1964,3504,3942
0130-001,2011,10,18,20,1305,1607,2912,3504
0130-001,2011,10,18,21,1267,1576,2843,2912
0130-001,2011,10,18,22,1170,1230,2400,2843
0130-001,2011,10,18,23,908,774,1682,2400
0130-001,2011,10,18,24,530,415,945,1682
0130-001,2011,10,19,1,389,322,711,945
0130-001,2011,10,19,2,271,256,527,711
0130-001,2011,10,19,3,218,218,436,527
0130-001,2011,10,19,4,129,134,263,436
0130-001,2011,10,19,5,177,286,463,263
0130-001,2011,10,19,6,482,488,970,463
0130-001,2011,10,19,7,1756,1249,3005,970
0130-001,2011,10,19,8,2170,1658,3828,3005
0130-001,2011,10,19,9,2109,2023,4132,3828
0130-001,2011,10,19,10,1737,1845,3582,4132
0130-001,2011,10,19,11,1774,1787,3561,3582
0130-001,2011,10,19,12,1571,1509,3080,3561
0130-001,2011,10,19,13,1341,1438,2779,3080
0130-001,2011,10,19,14,1596,1559,3155,2779
0130-001,2011,10,19,15,1787,1845,3632,3155
0130-001,2011,10,19,16,1726,1756,3482,3632
0130-001,2011,10,19,17,1607,1749,3356,3482
0130-001,2011,10,19,18,1674,2213,3887,3356
0130-001,2011,10,19,19,1774,2353,4127,3887
0130-001,2011,10,19,20,1397,1663,3060,4127
0130-001,2011,10,19,21,1242,1351,2593,3060
0130-001,2011,10,19,22,1133,1116,2249,2593
0130-001,2011,10,19,23,889,755,1644,2249
0130-001,2011,10,19,24,644,555,1199,1644
0130-001,2011,10,20,1,436,377,813,1199
0130-001,2011,10,20,2,291,248,539,813
0130-001,2011,10,20,3,218,197,415,539
0130-001,2011,10,20,4,190,208,398,415
0130-001,2011,10,20,5,153,255,408,398
0130-001,2011,10,20,6,421,535,956,408
0130-001,2011,10,20,7,1286,951,2237,956
0130-001,2011,10,20,8,2298,1854,4152,2237
0130-001,2011,10,20,9,1972,1749,3721,4152
0130-001,2011,10,20,10,1774,1845,3619,3721
0130-001,2011,10,20,11,1774,1670,3444,3619
0130-001,2011,10,20,12,1584,1663,3247,3444
0130-001,2011,10,20,13,1351,1414,2765,3247
0130-001,2011,10,20,14,1518,1576,3094,2765
0130-001,2011,10,20,15,1717,1774,3491,3094
0130-001,2011,10,20,16,1845,1777,3622,3491
0130-001,2011,10,20,17,1540,1614,3154,3622
0130-001,2011,10,20,18,1658,2129,3787,3154
0130-001,2011,10,20,19,1705,2119,3824,3787
0130-001,2011,10,20,20,1435,1845,3280,3824
0130-001,2011,10,20,21,1262,1531,2793,3280
0130-001,2011,10,20,22,1152,1230,2382,2793
0130-001,2011,10,20,23,988,821,1809,2382
0130-001,2011,10,20,24,597,492,1089,1809
0130-001,2011,10,21,1,385,317,702,1089
0130-001,2011,10,21,2,274,225,499,702
0130-001,2011,10,21,3,225,200,425,499
0130-001,2011,10,21,4,153,144,297,425
0130-001,2011,10,21,5,177,274,451,297
0130-001,2011,10,21,6,389,432,821,451
0130-001,2011,10,21,7,1217,857,2074,821
0130-001,2011,10,21,8,2263,1720,3983,2074
0130-001,2011,10,21,9,1936,1815,3751,3983
0130-001,2011,10,21,10,1741,1748,3489,3751
0130-001,2011,10,21,11,1787,1767,3554,3489
0130-001,2011,10,21,12,1729,1787,3516,3554
0130-001,2011,10,21,13,1425,1503,2928,3516
0130-001,2011,10,21,14,1749,1868,3617,2928
0130-001,2011,10,21,15,1797,1774,3571,3617
0130-001,2011,10,21,16,1674,1693,3367,3571
0130-001,2011,10,21,17,1764,1937,3701,3367
0130-001,2011,10,21,18,1726,2015,3741,3701
0130-001,2011,10,21,19,1756,2019,3775,3741
0130-001,2011,10,21,20,1414,1913,3327,3775
0130-001,2011,10,21,21,1286,1576,2862,3327
0130-001,2011,10,21,22,1174,1226,2400,2862
0130-001,2011,10,21,23,955,743,1698,2400
0130-001,2011,10,21,24,681,550,1231,1698
0130-001,2011,10,22,1,547,436,983,1231
0130-001,2011,10,22,2,361,291,652,983
0130-001,2011,10,22,3,255,237,492,652
0130-001,2011,10,22,4,213,197,410,492
0130-001,2011,10,22,5,190,227,417,410
0130-001,2011,10,22,6,342,377,719,417
0130-001,2011,10,22,7,801,640,1441,719
0130-001,2011,10,22,8,1407,1310,2717,1441
0130-001,2011,10,22,9,1710,1737,3447,2717
0130-001,2011,10,22,10,1726,1985,3711,3447
0130-001,2011,10,22,11,1726,2066,3792,3711
0130-001,2011,10,22,12,1681,2070,3751,3792
0130-001,2011,10,22,13,1599,2005,3604,3751
0130-001,2011,10,22,14,1689,2067,3756,3604
0130-001,2011,10,22,15,1681,2005,3686,3756
0130-001,2011,10,22,16,1715,2040,3755,3686
0130-001,2011,10,22,17,1503,1584,3087,3755
0130-001,2011,10,22,18,915,936,1851,3087
0130-001,2011,10,22,19,839,839,1678,1851
0130-001,2011,10,22,20,1324,1360,2684,1678
0130-001,2011,10,22,21,1196,1029,2225,2684
0130-001,2011,10,22,22,1046,839,1885,2225
0130-001,2011,10,22,23,821,644,1465,1885
0130-001,2011,10,22,24,593,479,1072,1465
0130-001,2011,10,23,1,397,339,736,1072
0130-001,2011,10,23,2,281,225,506,736
0130-001,2011,10,23,3,244,233,477,506
0130-001,2011,10,23,4,200,165,365,477
0130-001,2011,10,23,5,177,177,354,365
0130-001,2011,10,23,6,330,406,736,354
0130-001,2011,10,23,7,566,482,1048,736
0130-001,2011,10,23,8,748,681,1429,1048
0130-001,2011,10,23,9,897,1159,2056,1429
0130-001,2011,10,23,10,955,1060,2015,2056
0130-001,2011,10,23,11,1206,1482,2688,2015
0130-001,2011,10,23,12,1196,1486,2682,2688
0130-001,2011,10,23,13,1226,1315,2541,2682
0130-001,2011,10,23,14,1414,1301,2715,2541
0130-001,2011,10,23,15,1683,1473,3156,2715
0130-001,2011,10,23,16,1127,895,2022,3156
0130-001,2011,10,23,17,585,479,1064,2022
0130-001,2011,10,23,18,690,519,1209,1064
0130-001,2011,10,23,19,733,512,1245,1209
0130-001,2011,10,23,20,877,664,1541,1245
0130-001,2011,10,23,21,1541,1199,2740,1541
0130-001,2011,10,23,22,1622,1152,2774,2740
0130-001,2011,10,23,23,872,659,1531,2774
0130-001,2011,10,23,24,519,408,927,1531
0130-001,2011,10,24,1,299,227,526,927
0130-001,2011,10,24,2,208,197,405,526
0130-001,2011,10,24,3,153,144,297,405
0130-001,2011,10,24,4,129,141,270,297
0130-001,2011,10,24,5,150,225,375,270
0130-001,2011,10,24,6,397,473,870,375
0130-001,2011,10,24,7,1305,857,2162,870
0130-001,2011,10,24,8,1737,1230,2967,2162
0130-001,2011,10,24,9,1445,1407,2852,2967
0130-001,2011,10,24,10,1701,1764,3465,2852
0130-001,2011,10,24,11,1727,1797,3524,3465
0130-001,2011,10,24,12,1589,1681,3270,3524
0130-001,2011,10,24,13,1445,1351,2796,3270
0130-001,2011,10,24,14,1683,1701,3384,2796
0130-001,2011,10,24,15,1720,1701,3421,3384
0130-001,2011,10,24,16,1737,1840,3577,3421
0130-001,2011,10,24,17,1614,1749,3363,3577
0130-001,2011,10,24,18,1681,2149,3830,3363
0130-001,2011,10,24,19,1705,2139,3844,3830
0130-001,2011,10,24,20,1310,1599,2909,3844
0130-001,2011,10,24,21,1217,1522,2739,2909
0130-001,2011,10,24,22,1060,1163,2223,2739
0130-001,2011,10,24,23,801,616,1417,2223
0130-001,2011,10,24,24,560,425,985,1417
0130-001,2011,10,25,1,358,305,663,985
0130-001,2011,10,25,2,248,218,466,663
0130-001,2011,10,25,3,153,141,294,466
0130-001,2011,10,25,4,160,160,320,294
0130-001,2011,10,25,5,190,256,446,320
0130-001,2011,10,25,6,377,421,798,446
0130-001,2011,10,25,7,1237,805,2042,798
0130-001,2011,10,25,8,2092,1541,3633,2042
0130-001,2011,10,25,9,1720,1589,3309,3633
0130-001,2011,10,25,10,1840,1860,3700,3309
0130-001,2011,10,25,11,1764,1658,3422,3700
0130-001,2011,10,25,12,1529,1494,3023,3422
0130-001,2011,10,25,13,1445,1427,2872,3023
0130-001,2011,10,25,14,1622,1663,3285,2872
0130-001,2011,10,25,15,1777,1784,3561,3285
0130-001,2011,10,25,16,1305,1315,2620,3561
0130-001,2011,10,25,17,1689,1815,3504,2620
0130-001,2011,10,25,18,1767,2249,4016,3504
0130-001,2011,10,25,19,1683,2314,3997,4016
0130-001,2011,10,25,20,1414,1835,3249,3997
0130-001,2011,10,25,21,1249,1486,2735,3249
0130-001,2011,10,25,22,1113,1133,2246,2735
0130-001,2011,10,25,23,889,733,1622,2246
0130-001,2011,10,25,24,570,451,1021,1622
0130-001,2011,10,26,1,456,378,834,1021
0130-001,2011,10,26,2,317,255,572,834
0130-001,2011,10,26,3,170,160,330,572
0130-001,2011,10,26,4,165,153,318,330
0130-001,2011,10,26,5,181,263,444,318
0130-001,2011,10,26,6,408,519,927,444
0130-001,2011,10,26,7,1199,897,2096,927
0130-001,2011,10,26,8,2271,1756,4027,2096
0130-001,2011,10,26,9,1518,1419,2937,4027
0130-001,2011,10,26,10,1820,1764,3584,2937
0130-001,2011,10,26,11,1737,1681,3418,3584
0130-001,2011,10,26,12,1565,1540,3105,3418
0130-001,2011,10,26,13,1425,1529,2954,3105
0130-001,2011,10,26,14,1559,1652,3211,2954
0130-001,2011,10,26,15,1717,1756,3473,3211
0130-001,2011,10,26,16,1493,1391,2884,3473
0130-001,2011,10,26,17,1729,1797,3526,2884
0130-001,2011,10,26,18,1670,2162,3832,3526
0130-001,2011,10,26,19,1741,2244,3985,3832
0130-001,2011,10,26,20,1189,1481,2670,3985
0130-001,2011,10,26,21,1321,1494,2815,2670
0130-001,2011,10,26,22,1159,1022,2181,2815
0130-001,2011,10,26,23,852,707,1559,2181
0130-001,2011,10,26,24,633,504,1137,1559
0130-001,2011,10,27,1,408,408,816,1137
0130-001,2011,10,27,2,339,286,625,816
0130-001,2011,10,27,3,330,339,669,625
0130-001,2011,10,27,4,294,361,655,669
0130-001,2011,10,27,5,322,488,810,655
0130-001,2011,10,27,6,690,821,1511,810
0130-001,2011,10,27,7,2937,2106,5043,1511
0130-001,2011,10,27,8,4400,3124,7524,5043
0130-001,2011,10,27,9,2256,2048,4304,7524
0130-001,2011,10,27,10,1797,1777,3574,4304
0130-001,2011,10,27,11,1882,1907,3789,3574
0130-001,2011,10,27,12,1596,1531,3127,3789
0130-001,2011,10,27,13,1360,1435,2795,3127
0130-001,2011,10,27,14,1599,1658,3257,2795
0130-001,2011,10,27,15,1301,1341,2642,3257
0130-001,2011,10,27,16,755,738,1493,2642
0130-001,2011,10,27,17,1493,1622,3115,1493
0130-001,2011,10,27,18,1638,1767,3405,3115
0130-001,2011,10,27,19,1815,1767,3582,3405
0130-001,2011,10,27,20,1465,1854,3319,3582
0130-001,2011,10,27,21,1152,1493,2645,3319
0130-001,2011,10,27,22,1206,1321,2527,2645
0130-001,2011,10,27,23,926,897,1823,2527
0130-001,2011,10,27,24,616,479,1095,1823
0130-001,2011,10,28,1,421,339,760,1095
0130-001,2011,10,28,2,281,233,514,760
0130-001,2011,10,28,3,237,218,455,514
0130-001,2011,10,28,4,170,170,340,455
0130-001,2011,10,28,5,208,294,502,340
0130-001,2011,10,28,6,389,408,797,502
0130-001,2011,10,28,7,1116,829,1945,797
0130-001,2011,10,28,8,2149,1559,3708,1945
0130-001,2011,10,28,9,1717,1643,3360,3708
0130-001,2011,10,28,10,1784,1913,3697,3360
0130-001,2011,10,28,11,1741,1683,3424,3697
0130-001,2011,10,28,12,1627,1652,3279,3424
0130-001,2011,10,28,13,1438,1615,3053,3279
0130-001,2011,10,28,14,1638,1720,3358,3053
0130-001,2011,10,28,15,1784,1871,3655,3358
0130-001,2011,10,28,16,1737,1860,3597,3655
0130-001,2011,10,28,17,1305,1341,2646,3597
0130-001,2011,10,28,18,1840,2224,4064,2646
0130-001,2011,10,28,19,1854,2217,4071,4064
0130-001,2011,10,28,20,1450,1907,3357,4071
0130-001,2011,10,28,21,1305,1638,2943,3357
0130-001,2011,10,28,22,1257,1196,2453,2943
0130-001,2011,10,28,23,1009,727,1736,2453
0130-001,2011,10,28,24,738,541,1279,1736
0130-001,2011,10,29,1,504,396,900,1279
0130-001,2011,10,29,2,378,305,683,900
0130-001,2011,10,29,3,244,244,488,683
0130-001,2011,10,29,4,227,218,445,488
0130-001,2011,10,29,5,208,237,445,445
0130-001,2011,10,29,6,396,415,811,445
0130-001,2011,10,29,7,743,659,1402,811
0130-001,2011,10,29,8,1565,1217,2782,1402
0130-001,2011,10,29,9,1450,1321,2771,2782
0130-001,2011,10,29,10,1792,1888,3680,2771
0130-001,2011,10,29,11,1584,1797,3381,3680
0130-001,2011,10,29,12,1596,1992,3588,3381
0130-001,2011,10,29,13,1840,2576,4416,3588
0130-001,2011,10,29,14,1784,2109,3893,4416
0130-001,2011,10,29,15,1820,1981,3801,3893
0130-001,2011,10,29,16,1908,2162,4070,3801
0130-001,2011,10,29,17,1907,1804,3711,4070
0130-001,2011,10,29,18,1899,1835,3734,3711
0130-001,2011,10,29,19,1784,1937,3721,3734
0130-001,2011,10,29,20,1627,1462,3089,3721
0130-001,2011,10,29,21,1391,1226,2617,3089
0130-001,2011,10,29,22,1242,1022,2264,2617
0130-001,2011,10,29,23,785,585,1370,2264
0130-001,2011,10,29,24,566,456,1022,1370
0130-001,2011,10,30,1,396,330,726,1022
0130-001,2011,10,30,2,281,256,537,726
0130-001,2011,10,30,3,244,213,457,537
0130-001,2011,10,30,4,190,134,324,457
0130-001,2011,10,30,5,197,225,422,324
0130-001,2011,10,30,6,255,299,554,422
0130-001,2011,10,30,7,492,385,877,554
0130-001,2011,10,30,8,707,633,1340,877
0130-001,2011,10,30,9,821,975,1796,1340
0130-001,2011,10,30,10,988,1077,2065,1796
0130-001,2011,10,30,11,1123,1406,2529,2065
0130-001,2011,10,30,12,1103,1368,2471,2529
0130-001,2011,10,30,13,1226,1462,2688,2471
0130-001,2011,10,30,14,1445,1540,2985,2688
0130-001,2011,10,30,15,1615,1658,3273,2985
0130-001,2011,10,30,16,1738,1627,3365,3273
0130-001,2011,10,30,17,936,793,1729,3365
0130-001,2011,10,30,18,1003,975,1978,1729
0130-001,2011,10,30,19,1217,1097,2314,1978
0130-001,2011,10,30,20,1746,1494,3240,2314
0130-001,2011,10,30,21,1638,1301,2939,3240
0130-001,2011,10,30,22,1615,1123,2738,2939
0130-001,2011,10,30,23,1080,810,1890,2738
0130-001,2011,10,30,24,608,406,1014,1890
0130-001,2011,10,31,1,281,200,481,1014
0130-001,2011,10,31,2,200,165,365,481
0130-001,2011,10,31,3,153,134,287,365
0130-001,2011,10,31,4,109,93,202,287
0130-001,2011,10,31,5,129,181,310,202
0130-001,2011,10,31,6,322,361,683,310
0130-001,2011,10,31,7,1273,872,2145,683
0130-001,2011,10,31,8,2151,1494,3645,2145
0130-001,2011,10,31,9,1717,1584,3301,3645
0130-001,2011,10,31,10,1767,1823,3590,3301
0130-001,2011,10,31,11,1749,1705,3454,3590
0130-001,2011,10,31,12,1584,1579,3163,3454
0130-001,2011,10,31,13,1368,1450,2818,3163
0130-001,2011,10,31,14,1652,1565,3217,2818
0130-001,2011,10,31,15,1784,1710,3494,3217
0130-001,2011,10,31,16,1607,1571,3178,3494
0130-001,2011,10,31,17,1614,1710,3324,3178
0130-001,2011,10,31,18,1741,2134,3875,3324
0130-001,2011,10,31,19,1851,2333,4184,3875
0130-001,2011,10,31,20,1335,1658,2993,4184
0130-001,2011,10,31,21,1163,1565,2728,2993
0130-001,2011,10,31,22,1163,1217,2380,2728
0130-001,2011,10,31,23,869,720,1589,2380
0130-001,2011,10,31,24,566,408,974,1589
0130-001,2011,11,1,1,432,317,749,974
0130-001,2011,11,1,2,291,255,546,749
0130-001,2011,11,1,3,218,218,436,546
0130-001,2011,11,1,4,181,165,346,436
0130-001,2011,11,1,5,213,322,535,346
0130-001,2011,11,1,6,377,443,820,535
0130-001,2011,11,1,7,1174,774,1948,820
0130-001,2011,11,1,8,1985,1559,3544,1948
0130-001,2011,11,1,9,1315,1341,2656,3544
0130-001,2011,11,1,10,1717,1741,3458,2656
0130-001,2011,11,1,11,1689,1522,3211,3458
0130-001,2011,11,1,12,1627,1615,3242,3211
0130-001,2011,11,1,13,1305,1293,2598,3242
0130-001,2011,11,1,14,1614,1701,3315,2598
0130-001,2011,11,1,15,1741,1749,3490,3315
0130-001,2011,11,1,16,1658,1767,3425,3490
0130-001,2011,11,1,17,1638,1705,3343,3425
0130-001,2011,11,1,18,1627,2001,3628,3343
0130-001,2011,11,1,19,1705,2007,3712,3628
0130-001,2011,11,1,20,1293,1784,3077,3712
0130-001,2011,11,1,21,1170,1481,2651,3077
0130-001,2011,11,1,22,1127,1180,2307,2651
0130-001,2011,11,1,23,857,733,1590,2307
0130-001,2011,11,1,24,616,541,1157,1590
0130-001,2011,11,2,1,368,329,697,1157
0130-001,2011,11,2,2,291,237,528,697
0130-001,2011,11,2,3,208,197,405,528
0130-001,2011,11,2,4,141,141,282,405
0130-001,2011,11,2,5,144,225,369,282
0130-001,2011,11,2,6,349,397,746,369
0130-001,2011,11,2,7,1092,743,1835,746
0130-001,2011,11,2,8,2222,1643,3865,1835
0130-001,2011,11,2,9,2193,2142,4335,3865
0130-001,2011,11,2,10,1627,1992,3619,4335
0130-001,2011,11,2,11,1815,1531,3346,3619
0130-001,2011,11,2,12,1540,1584,3124,3346
0130-001,2011,11,2,13,1341,1382,2723,3124
0130-001,2011,11,2,14,1556,1627,3183,2723
0130-001,2011,11,2,15,1622,1652,3274,3183
0130-001,2011,11,2,16,1729,1774,3503,3274
0130-001,2011,11,2,17,1643,1710,3353,3503
0130-001,2011,11,2,18,1681,2213,3894,3353
0130-001,2011,11,2,19,1717,2213,3930,3894
0130-001,2011,11,2,20,1242,1522,2764,3930
0130-001,2011,11,2,21,1211,1406,2617,2764
0130-001,2011,11,2,22,1217,1151,2368,2617
0130-001,2011,11,2,23,951,907,1858,2368
0130-001,2011,11,2,24,613,550,1163,1858
0130-001,2011,11,3,1,456,378,834,1163
0130-001,2011,11,3,2,233,188,421,834
0130-001,2011,11,3,3,197,160,357,421
0130-001,2011,11,3,4,177,170,347,357
0130-001,2011,11,3,5,181,294,475,347
0130-001,2011,11,3,6,378,451,829,475
0130-001,2011,11,3,7,1097,727,1824,829
0130-001,2011,11,3,8,2261,1705,3966,1824
0130-001,2011,11,3,9,1878,1860,3738,3966
0130-001,2011,11,3,10,1705,1749,3454,3738
0130-001,2011,11,3,11,1674,1615,3289,3454
0130-001,2011,11,3,12,1445,1493,2938,3289
0130-001,2011,11,3,13,1293,1278,2571,2938
0130-001,2011,11,3,14,1643,1540,3183,2571
0130-001,2011,11,3,15,1670,1693,3363,3183
0130-001,2011,11,3,16,1701,1792,3493,3363
0130-001,2011,11,3,17,1652,1777,3429,3493
0130-001,2011,11,3,18,1741,2052,3793,3429
0130-001,2011,11,3,19,1652,2117,3769,3793
0130-001,2011,11,3,20,1267,1493,2760,3769
0130-001,2011,11,3,21,1180,1503,2683,2760
0130-001,2011,11,3,22,1152,1183,2335,2683
0130-001,2011,11,3,23,872,814,1686,2335
0130-001,2011,11,3,24,676,585,1261,1686
0130-001,2011,11,4,1,368,330,698,1261
0130-001,2011,11,4,2,271,208,479,698
0130-001,2011,11,4,3,213,213,426,479
0130-001,2011,11,4,4,181,200,381,426
0130-001,2011,11,4,5,218,294,512,381
0130-001,2011,11,4,6,385,473,858,512
0130-001,2011,11,4,7,1127,718,1845,858
0130-001,2011,11,4,8,2212,1638,3850,1845
0130-001,2011,11,4,9,2040,1972,4012,3850
0130-001,2011,11,4,10,1741,1614,3355,4012
0130-001,2011,11,4,11,1726,1851,3577,3355
0130-001,2011,11,4,12,1607,1643,3250,3577
0130-001,2011,11,4,13,1406,1512,2918,3250
0130-001,2011,11,4,14,1565,1541,3106,2918
0130-001,2011,11,4,15,1748,1689,3437,3106
0130-001,2011,11,4,16,1774,1913,3687,3437
0130-001,2011,11,4,17,1701,1787,3488,3687
0130-001,2011,11,4,18,1720,1977,3697,3488
0130-001,2011,11,4,19,1427,1726,3153,3697
0130-001,2011,11,4,20,1438,1979,3417,3153
0130-001,2011,11,4,21,1183,1445,2628,3417
0130-001,2011,11,4,22,1278,1273,2551,2628
0130-001,2011,11,4,23,982,814,1796,2551
0130-001,2011,11,4,24,712,555,1267,1796
0130-001,2011,11,5,1,443,368,811,1267
0130-001,2011,11,5,2,352,330,682,811
0130-001,2011,11,5,3,256,218,474,682
0130-001,2011,11,5,4,200,197,397,474
0130-001,2011,11,5,5,225,271,496,397
0130-001,2011,11,5,6,286,317,603,496
0130-001,2011,11,5,7,727,560,1287,603
0130-001,2011,11,5,8,1494,1183,2677,1287
0130-001,2011,11,5,9,1970,2079,4049,2677
0130-001,2011,11,5,10,1854,2031,3885,4049
0130-001,2011,11,5,11,1599,1888,3487,3885
0130-001,2011,11,5,12,1615,1767,3382,3487
0130-001,2011,11,5,13,1729,2206,3935,3382
0130-001,2011,11,5,14,1764,2173,3937,3935
0130-001,2011,11,5,15,1749,2126,3875,3937
0130-001,2011,11,5,16,1633,1774,3407,3875
0130-001,2011,11,5,17,681,696,1377,3407
0130-001,2011,11,5,18,848,915,1763,1377
0130-001,2011,11,5,19,1103,1108,2211,1763
0130-001,2011,11,5,20,1414,1473,2887,2211
0130-001,2011,11,5,21,1249,1189,2438,2887
0130-001,2011,11,5,22,1018,805,1823,2438
0130-001,2011,11,5,23,774,616,1390,1823
0130-001,2011,11,5,24,555,421,976,1390
0130-001,2011,11,6,1,451,378,829,976
0130-001,2011,11,6,2,281,256,537,829
0130-001,2011,11,6,3,227,181,408,537
0130-001,2011,11,6,4,181,153,334,408
0130-001,2011,11,6,5,170,190,360,334
0130-001,2011,11,6,6,218,255,473,360
0130-001,2011,11,6,7,443,408,851,473
0130-001,2011,11,6,8,613,616,1229,851
0130-001,2011,11,6,9,801,1041,1842,1229
0130-001,2011,11,6,10,955,1085,2040,1842
0130-001,2011,11,6,11,1065,1286,2351,2040
0130-001,2011,11,6,12,1103,1335,2438,2351
0130-001,2011,11,6,13,1391,1305,2696,2438
0130-001,2011,11,6,14,1540,1293,2833,2696
0130-001,2011,11,6,15,2966,2316,5282,2833
0130-001,2011,11,6,16,3372,2806,6178,5282
0130-001,2011,11,6,17,2986,2390,5376,6178
0130-001,2011,11,6,18,2652,2031,4683,5376
0130-001,2011,11,6,19,1242,757,1999,4683
0130-001,2011,11,6,20,1705,1341,3046,1999
0130-001,2011,11,6,21,1748,1388,3136,3046
0130-001,2011,11,6,22,1670,1127,2797,3136
0130-001,2011,11,6,23,1031,757,1788,2797
0130-001,2011,11,6,24,653,492,1145,1788
0130-001,2011,11,7,1,322,248,570,1145
0130-001,2011,11,7,2,177,141,318,570
0130-001,2011,11,7,3,165,181,346,318
0130-001,2011,11,7,4,121,114,235,346
0130-001,2011,11,7,5,177,237,414,235
0130-001,2011,11,7,6,352,368,720,414
0130-001,2011,11,7,7,1137,727,1864,720
0130-001,2011,11,7,8,2009,1455,3464,1864
0130-001,2011,11,7,9,1152,1133,2285,3464
0130-001,2011,11,7,10,1726,1784,3510,2285
0130-001,2011,11,7,11,1674,1579,3253,3510
0130-001,2011,11,7,12,1576,1531,3107,3253
0130-001,2011,11,7,13,1378,1388,2766,3107
0130-001,2011,11,7,14,1681,1670,3351,2766
0130-001,2011,11,7,15,1787,1835,3622,3351
0130-001,2011,11,7,16,1556,1607,3163,3622
0130-001,2011,11,7,17,1503,1559,3062,3163
0130-001,2011,11,7,18,1681,2032,3713,3062
0130-001,2011,11,7,19,1633,2024,3657,3713
0130-001,2011,11,7,20,1371,1756,3127,3657
0130-001,2011,11,7,21,1080,1371,2451,3127
0130-001,2011,11,7,22,1144,1286,2430,2451
0130-001,2011,11,7,23,861,801,1662,2430
0130-001,2011,11,7,24,560,510,1070,1662
0130-001,2011,11,8,1,352,311,663,1070
0130-001,2011,11,8,2,263,218,481,663
0130-001,2011,11,8,3,188,177,365,481
0130-001,2011,11,8,4,160,150,310,365
0130-001,2011,11,8,5,181,263,444,310
0130-001,2011,11,8,6,352,408,760,444
0130-001,2011,11,8,7,1108,805,1913,760
0130-001,2011,11,8,8,2179,1646,3825,1913
0130-001,2011,11,8,9,1465,1391,2856,3825
0130-001,2011,11,8,10,1797,1726,3523,2856
0130-001,2011,11,8,11,1681,1607,3288,3523
0130-001,2011,11,8,12,1683,1615,3298,3288
0130-001,2011,11,8,13,1341,1360,2701,3298
0130-001,2011,11,8,14,1614,1579,3193,2701
0130-001,2011,11,8,15,1683,1804,3487,3193
0130-001,2011,11,8,16,1701,1726,3427,3487
0130-001,2011,11,8,17,1729,1871,3600,3427
0130-001,2011,11,8,18,1710,2028,3738,3600
0130-001,2011,11,8,19,1627,2027,3654,3738
0130-001,2011,11,8,20,1427,1756,3183,3654
0130-001,2011,11,8,21,1257,1565,2822,3183
0130-001,2011,11,8,22,1183,1249,2432,2822
0130-001,2011,11,8,23,907,774,1681,2432
0130-001,2011,11,8,24,547,432,979,1681
0130-001,2011,11,9,1,339,274,613,979
0130-001,2011,11,9,2,244,233,477,613
0130-001,2011,11,9,3,248,248,496,477
0130-001,2011,11,9,4,150,153,303,496
0130-001,2011,11,9,5,188,299,487,303
0130-001,2011,11,9,6,349,352,701,487
0130-001,2011,11,9,7,1189,848,2037,701
0130-001,2011,11,9,8,2152,1646,3798,2037
0130-001,2011,11,9,9,1787,1717,3504,3798
0130-001,2011,11,9,10,1767,1878,3645,3504
0130-001,2011,11,9,11,1438,1450,2888,3645
0130-001,2011,11,9,12,1622,1556,3178,2888
0130-001,2011,11,9,13,1414,1518,2932,3178
0130-001,2011,11,9,14,1540,1503,3043,2932
0130-001,2011,11,9,15,1787,1845,3632,3043
0130-001,2011,11,9,16,1830,1868,3698,3632
0130-001,2011,11,9,17,1556,1693,3249,3698
0130-001,2011,11,9,18,1576,2086,3662,3249
0130-001,2011,11,9,19,1681,2209,3890,3662
0130-001,2011,11,9,20,1351,1607,2958,3890
0130-001,2011,11,9,21,1180,1285,2465,2958
0130-001,2011,11,9,22,1163,1151,2314,2465
0130-001,2011,11,9,23,895,755,1650,2314
0130-001,2011,11,9,24,585,504,1089,1650
0130-001,2011,11,10,1,406,349,755,1089
0130-001,2011,11,10,2,311,263,574,755
0130-001,2011,11,10,3,233,213,446,574
0130-001,2011,11,10,4,170,188,358,446
0130-001,2011,11,10,5,188,299,487,358
0130-001,2011,11,10,6,385,488,873,487
0130-001,2011,11,10,7,1103,814,1917,873
0130-001,2011,11,10,8,1928,1548,3476,1917
0130-001,2011,11,10,9,1391,1242,2633,3476
0130-001,2011,11,10,10,1937,2043,3980,2633
0130-001,2011,11,10,11,1741,1643,3384,3980
0130-001,2011,11,10,12,1607,1683,3290,3384
0130-001,2011,11,10,13,1324,1388,2712,3290
0130-001,2011,11,10,14,1710,1774,3484,2712
0130-001,2011,11,10,15,1324,1368,2692,3484
0130-001,2011,11,10,16,897,869,1766,2692
0130-001,2011,11,10,17,1614,1689,3303,1766
0130-001,2011,11,10,18,1797,2299,4096,3303
0130-001,2011,11,10,19,1823,2294,4117,4096
0130-001,2011,11,10,20,1406,1804,3210,4117
0130-001,2011,11,10,21,1230,1494,2724,3210
0130-001,2011,11,10,22,1257,1341,2598,2724
0130-001,2011,11,10,23,964,801,1765,2598
0130-001,2011,11,10,24,651,535,1186,1765
0130-001,2011,11,11,1,406,330,736,1186
0130-001,2011,11,11,2,291,237,528,736
0130-001,2011,11,11,3,227,208,435,528
0130-001,2011,11,11,4,165,153,318,435
0130-001,2011,11,11,5,165,256,421,318
0130-001,2011,11,11,6,342,378,720,421
0130-001,2011,11,11,7,1056,743,1799,720
0130-001,2011,11,11,8,2125,1622,3747,1799
0130-001,2011,11,11,9,1576,1481,3057,3747
0130-001,2011,11,11,10,1820,1823,3643,3057
0130-001,2011,11,11,11,1717,1693,3410,3643
0130-001,2011,11,11,12,1599,1652,3251,3410
0130-001,2011,11,11,13,1518,1596,3114,3251
0130-001,2011,11,11,14,1701,1815,3516,3114
0130-001,2011,11,11,15,1683,1663,3346,3516
0130-001,2011,11,11,16,895,907,1802,3346
0130-001,2011,11,11,17,841,926,1767,1802
0130-001,2011,11,11,18,1840,2177,4017,1767
0130-001,2011,11,11,19,1907,2183,4090,4017
0130-001,2011,11,11,20,1481,2005,3486,4090
0130-001,2011,11,11,21,1301,1584,2885,3486
0130-001,2011,11,11,22,1267,1321,2588,2885
0130-001,2011,11,11,23,1031,805,1836,2588
0130-001,2011,11,11,24,700,570,1270,1836
0130-001,2011,11,12,1,488,389,877,1270
0130-001,2011,11,12,2,389,311,700,877
0130-001,2011,11,12,3,294,274,568,700
0130-001,2011,11,12,4,255,233,488,568
0130-001,2011,11,12,5,200,237,437,488
0130-001,2011,11,12,6,396,432,828,437
0130-001,2011,11,12,7,951,755,1706,828
0130-001,2011,11,12,8,1509,1406,2915,1706
0130-001,2011,11,12,9,1615,1638,3253,2915
0130-001,2011,11,12,10,1614,1787,3401,3253
0130-001,2011,11,12,11,1798,2139,3937,3401
0130-001,2011,11,12,12,1701,2142,3843,3937
0130-001,2011,11,12,13,1689,2122,3811,3843
0130-001,2011,11,12,14,1737,2137,3874,3811
0130-001,2011,11,12,15,1741,2086,3827,3874
0130-001,2011,11,12,16,1791,2149,3940,3827
0130-001,2011,11,12,17,1272,1376,2648,3940
0130-001,2011,11,12,18,1077,1236,2313,2648
0130-001,2011,11,12,19,1237,1274,2511,2313
0130-001,2011,11,12,20,1546,1574,3120,2511
0130-001,2011,11,12,21,1382,1342,2724,3120
0130-001,2011,11,12,22,1086,937,2023,2724
0130-001,2011,11,12,23,794,700,1494,2023
0130-001,2011,11,12,24,566,478,1044,1494
0130-001,2011,11,13,1,377,317,694,1044
0130-001,2011,11,13,2,339,271,610,694
0130-001,2011,11,13,3,237,227,464,610
0130-001,2011,11,13,4,200,165,365,464
0130-001,2011,11,13,5,197,197,394,365
0130-001,2011,11,13,6,255,311,566,394
0130-001,2011,11,13,7,550,473,1023,566
0130-001,2011,11,13,8,727,659,1386,1023
0130-001,2011,11,13,9,993,1278,2271,1386
0130-001,2011,11,13,10,1133,1257,2390,2271
0130-001,2011,11,13,11,1219,1614,2833,2390
0130-001,2011,11,13,12,1257,1565,2822,2833
0130-001,2011,11,13,13,1717,1754,3471,2822
0130-001,2011,11,13,14,1814,1743,3557,3471
0130-001,2011,11,13,15,2425,1979,4404,3557
0130-001,2011,11,13,16,2550,2199,4749,4404
0130-001,2011,11,13,17,2545,1997,4542,4749
0130-001,2011,11,13,18,2314,1768,4082,4542
0130-001,2011,11,13,19,1488,1006,2494,4082
0130-001,2011,11,13,20,1691,1178,2869,2494
0130-001,2011,11,13,21,1739,1135,2874,2869
0130-001,2011,11,13,22,1692,966,2658,2874
0130-001,2011,11,13,23,1292,640,1932,2658
0130-001,2011,11,13,24,652,434,1086,1932
0130-001,2011,11,14,1,396,294,690,1086
0130-001,2011,11,14,2,225,213,438,690
0130-001,2011,11,14,3,150,141,291,438
0130-001,2011,11,14,4,134,144,278,291
0130-001,2011,11,14,5,170,255,425,278
0130-001,2011,11,14,6,378,445,823,425
0130-001,2011,11,14,7,1183,781,1964,823
0130-001,2011,11,14,8,2234,1658,3892,1964
0130-001,2011,11,14,9,1720,1681,3401,3892
0130-001,2011,11,14,10,1787,1854,3641,3401
0130-001,2011,11,14,11,1797,1764,3561,3641
0130-001,2011,11,14,12,1559,1646,3205,3561
0130-001,2011,11,14,13,1486,1388,2874,3205
0130-001,2011,11,14,14,1774,1787,3561,2874
0130-001,2011,11,14,15,1571,1548,3119,3561
0130-001,2011,11,14,16,1556,1646,3202,3119
0130-001,2011,11,14,17,1729,1882,3611,3202
0130-001,2011,11,14,18,1764,2240,4004,3611
0130-001,2011,11,14,19,1774,2237,4011,4004
0130-001,2011,11,14,20,1391,1705,3096,4011
0130-001,2011,11,14,21,1230,1540,2770,3096
0130-001,2011,11,14,22,1116,1226,2342,2770
0130-001,2011,11,14,23,1159,895,2054,2342
0130-001,2011,11,14,24,696,525,1221,2054
0130-001,2011,11,15,1,350,290,640,1221
0130-001,2011,11,15,2,231,200,431,640
0130-001,2011,11,15,3,178,153,331,431
0130-001,2011,11,15,4,140,139,279,331
0130-001,2011,11,15,5,166,229,395,279
0130-001,2011,11,15,6,321,367,688,395
0130-001,2011,11,15,7,1066,738,1804,688
0130-001,2011,11,15,8,2218,1628,3846,1804
0130-001,2011,11,15,9,1792,1714,3506,3846
0130-001,2011,11,15,10,1733,1727,3460,3506
0130-001,2011,11,15,11,1645,1587,3232,3460
0130-001,2011,11,15,12,1609,1590,3199,3232
0130-001,2011,11,15,13,1373,1377,2750,3199
0130-001,2011,11,15,14,1622,1554,3176,2750
0130-001,2011,11,15,15,1698,1714,3412,3176
0130-001,2011,11,15,16,1685,1765,3450,3412
0130-001,2011,11,15,17,1735,1867,3602,3450
0130-001,2011,11,15,18,1706,2106,3812,3602
0130-001,2011,11,15,19,1663,2160,3823,3812
0130-001,2011,11,15,20,1366,1683,3049,3823
0130-001,2011,11,15,21,1218,1505,2723,3049
0130-001,2011,11,15,22,1136,1205,2341,2723
0130-001,2011,11,15,23,872,751,1623,2341
0130-001,2011,11,15,24,553,434,987,1623
0130-001,2011,11,16,1,366,297,663,987
0130-001,2011,11,16,2,246,225,471,663
0130-001,2011,11,16,3,213,207,420,471
0130-001,2011,11,16,4,145,142,287,420
0130-001,2011,11,16,5,173,254,427,287
0130-001,2011,11,16,6,319,335,654,427
0130-001,2011,11,16,7,1059,744,1803,654
0130-001,2011,11,16,8,2160,1589,3749,1803
0130-001,2011,11,16,9,1940,1850,3790,3749
0130-001,2011,11,16,10,1751,1815,3566,3790
0130-001,2011,11,16,11,1538,1504,3042,3566
0130-001,2011,11,16,12,1587,1550,3137,3042
0130-001,2011,11,16,13,1401,1453,2854,3137
0130-001,2011,11,16,14,1560,1543,3103,2854
0130-001,2011,11,16,15,1724,1783,3507,3103
0130-001,2011,11,16,16,1743,1829,3572,3507
0130-001,2011,11,16,17,1610,1786,3396,3572
0130-001,2011,11,16,18,1622,2124,3746,3396
0130-001,2011,11,16,19,1677,2258,3935,3746
0130-001,2011,11,16,20,1325,1592,2917,3935
0130-001,2011,11,16,21,1175,1329,2504,2917
0130-001,2011,11,16,22,1131,1125,2256,2504
0130-001,2011,11,16,23,856,741,1597,2256
0130-001,2011,11,16,24,584,475,1059,1597
0130-001,2011,11,17,1,373,326,699,1059
0130-001,2011,11,17,2,270,244,514,699
0130-001,2011,11,17,3,203,182,385,514
0130-001,2011,11,17,4,156,163,319,385
0130-001,2011,11,17,5,159,248,407,319
0130-001,2011,11,17,6,360,402,762,407
0130-001,2011,11,17,7,1030,725,1755,762
0130-001,2011,11,17,8,2061,1572,3633,1755
0130-001,2011,11,17,9,1753,1595,3348,3633
0130-001,2011,11,17,10,1825,1848,3673,3348
0130-001,2011,11,17,11,1686,1621,3307,3673
0130-001,2011,11,17,12,1575,1633,3208,3307
0130-001,2011,11,17,13,1338,1394,2732,3208
0130-001,2011,11,17,14,1677,1680,3357,2732
0130-001,2011,11,17,15,1554,1546,3100,3357
0130-001,2011,11,17,16,1342,1302,2644,3100
0130-001,2011,11,17,17,1631,1759,3390,2644
0130-001,2011,11,17,18,1770,2235,4005,3390
0130-001,2011,11,17,19,1723,2283,4006,4005
0130-001,2011,11,17,20,1350,1668,3018,4006
0130-001,2011,11,17,21,1231,1507,2738,3018
0130-001,2011,11,17,22,1205,1272,2477,2738
0130-001,2011,11,17,23,914,764,1678,2477
0130-001,2011,11,17,24,620,504,1124,1678
0130-001,2011,11,18,1,389,321,710,1124
0130-001,2011,11,18,2,277,237,514,710
0130-001,2011,11,18,3,213,193,406,514
0130-001,2011,11,18,4,160,170,330,406
0130-001,2011,11,18,5,176,237,413,330
0130-001,2011,11,18,6,351,370,721,413
0130-001,2011,11,18,7,1057,709,1766,721
0130-001,2011,11,18,8,2177,1624,3801,1766
0130-001,2011,11,18,9,1869,1772,3641,3801
0130-001,2011,11,18,10,1734,1732,3466,3641
0130-001,2011,11,18,11,1743,1694,3437,3466
0130-001,2011,11,18,12,1618,1632,3250,3437
0130-001,2011,11,18,13,1494,1578,3072,3250
0130-001,2011,11,18,14,1778,1791,3569,3072
0130-001,2011,11,18,15,1630,1666,3296,3569
0130-001,2011,11,18,16,1399,1433,2832,3296
0130-001,2011,11,18,17,1321,1525,2846,2832
0130-001,2011,11,18,18,1825,2256,4081,2846
0130-001,2011,11,18,19,1884,2199,4083,4081
0130-001,2011,11,18,20,1488,2000,3488,4083
0130-001,2011,11,18,21,1316,1598,2914,3488
0130-001,2011,11,18,22,1237,1328,2565,2914
0130-001,2011,11,18,23,979,848,1827,2565
0130-001,2011,11,18,24,702,583,1285,1827
0130-001,2011,11,19,1,488,405,893,1285
0130-001,2011,11,19,2,367,306,673,893
0130-001,2011,11,19,3,295,261,556,673
0130-001,2011,11,19,4,230,226,456,556
0130-001,2011,11,19,5,212,251,463,456
0130-001,2011,11,19,6,360,395,755,463
0130-001,2011,11,19,7,852,663,1515,755
0130-001,2011,11,19,8,1387,1258,2645,1515
0130-001,2011,11,19,9,1526,1594,3120,2645
0130-001,2011,11,19,10,1600,1786,3386,3120
0130-001,2011,11,19,11,1724,2102,3826,3386
0130-001,2011,11,19,12,1763,2195,3958,3826
0130-001,2011,11,19,13,1716,2158,3874,3958
0130-001,2011,11,19,14,1729,2198,3927,3874
0130-001,2011,11,19,15,1781,2324,4105,3927
0130-001,2011,11,19,16,1897,2159,4056,4105
0130-001,2011,11,19,17,1862,2055,3917,4056
0130-001,2011,11,19,18,1306,1557,2863,3917
0130-001,2011,11,19,19,1371,1441,2812,2863
0130-001,2011,11,19,20,1677,1675,3352,2812
0130-001,2011,11,19,21,1516,1496,3012,3352
0130-001,2011,11,19,22,1155,1069,2224,3012
0130-001,2011,11,19,23,815,785,1600,2224
0130-001,2011,11,19,24,576,535,1111,1600
0130-001,2011,11,20,1,375,331,706,1111
0130-001,2011,11,20,2,255,260,515,706
0130-001,2011,11,20,3,255,204,459,515
0130-001,2011,11,20,4,182,167,349,459
0130-001,2011,11,20,5,176,143,319,349
0130-001,2011,11,20,6,244,255,499,319
0130-001,2011,11,20,7,494,425,919,499
0130-001,2011,11,20,8,670,678,1348,919
0130-001,2011,11,20,9,928,896,1824,1348
0130-001,2011,11,20,10,1009,1036,2045,1824
0130-001,2011,11,20,11,1179,1323,2502,2045
0130-001,2011,11,20,12,1452,1397,2849,2502
0130-001,2011,11,20,13,1584,1553,3137,2849
0130-001,2011,11,20,14,1993,1542,3535,3137
0130-001,2011,11,20,15,1884,1642,3526,3535
0130-001,2011,11,20,16,1728,1592,3320,3526
0130-001,2011,11,20,17,2104,1604,3708,3320
0130-001,2011,11,20,18,1977,1505,3482,3708
0130-001,2011,11,20,19,1735,1254,2989,3482
0130-001,2011,11,20,20,1677,1014,2691,2989
0130-001,2011,11,20,21,1730,882,2612,2691
0130-001,2011,11,20,22,1713,804,2517,2612
0130-001,2011,11,20,23,1554,524,2078,2517
0130-001,2011,11,20,24,651,376,1027,2078
0130-001,2011,11,21,1,300,217,517,1027
0130-001,2011,11,21,2,147,146,293,517
0130-001,2011,11,21,3,158,89,247,293
0130-001,2011,11,21,4,99,122,221,247
0130-001,2011,11,21,5,141,180,321,221
0130-001,2011,11,21,6,288,331,619,321
0130-001,2011,11,21,7,1120,700,1820,619
0130-001,2011,11,21,8,2345,1689,4034,1820
0130-001,2011,11,21,9,2143,2091,4234,4034
0130-001,2011,11,21,10,1604,1701,3305,4234
0130-001,2011,11,21,11,1579,1574,3153,3305
0130-001,2011,11,21,12,1518,1586,3104,3153
0130-001,2011,11,21,13,1422,1399,2821,3104
0130-001,2011,11,21,14,1680,1474,3154,2821
0130-001,2011,11,21,15,1765,1525,3290,3154
0130-001,2011,11,21,16,1682,1815,3497,3290
0130-001,2011,11,21,17,1816,1846,3662,3497
0130-001,2011,11,21,18,1734,2204,3938,3662
0130-001,2011,11,21,19,1725,2276,4001,3938
0130-001,2011,11,21,20,1308,1643,2951,4001
0130-001,2011,11,21,21,1187,1514,2701,2951
0130-001,2011,11,21,22,1077,1223,2300,2701
0130-001,2011,11,21,23,858,727,1585,2300
0130-001,2011,11,21,24,536,426,962,1585
0130-001,2011,11,22,1,347,268,615,962
0130-001,2011,11,22,2,198,182,380,615
0130-001,2011,11,22,3,168,128,296,380
0130-001,2011,11,22,4,120,127,247,296
0130-001,2011,11,22,5,150,194,344,247
0130-001,2011,11,22,6,289,325,614,344
0130-001,2011,11,22,7,1024,670,1694,614
0130-001,2011,11,22,8,2257,1610,3867,1694
0130-001,2011,11,22,9,2118,2037,4155,3867
0130-001,2011,11,22,10,1669,1727,3396,4155
0130-001,2011,11,22,11,1608,1566,3174,3396
0130-001,2011,11,22,12,1535,1565,3100,3174
0130-001,2011,11,22,13,1405,1393,2798,3100
0130-001,2011,11,22,14,1630,1529,3159,2798
0130-001,2011,11,22,15,1713,1623,3336,3159
0130-001,2011,11,22,16,1669,1803,3472,3336
0130-001,2011,11,22,17,1740,1863,3603,3472
0130-001,2011,11,22,18,1701,2183,3884,3603
0130-001,2011,11,22,19,1699,2292,3991,3884
0130-001,2011,11,22,20,1304,1610,2914,3991
0130-001,2011,11,22,21,1178,1444,2622,2914
0130-001,2011,11,22,22,1088,1161,2249,2622
0130-001,2011,11,22,23,837,727,1564,2249
0130-001,2011,11,22,24,559,436,995,1564
0130-001,2011,11,23,1,393,319,712,995
0130-001,2011,11,23,2,248,217,465,712
0130-001,2011,11,23,3,178,166,344,465
0130-001,2011,11,23,4,140,131,271,344
0130-001,2011,11,23,5,158,208,366,271
0130-001,2011,11,23,6,289,318,607,366
0130-001,2011,11,23,7,928,639,1567,607
0130-001,2011,11,23,8,2168,1531,3699,1567
0130-001,2011,11,23,9,2092,1983,4075,3699
0130-001,2011,11,23,10,1734,1752,3486,4075
0130-001,2011,11,23,11,1637,1558,3195,3486
0130-001,2011,11,23,12,1551,1544,3095,3195
0130-001,2011,11,23,13,1387,1387,2774,3095
0130-001,2011,11,23,14,1579,1583,3162,2774
0130-001,2011,11,23,15,1661,1720,3381,3162
0130-001,2011,11,23,16,1656,1790,3446,3381
0130-001,2011,11,23,17,1663,1879,3542,3446
0130-001,2011,11,23,18,1667,2161,3828,3542
0130-001,2011,11,23,19,1672,2307,3979,3828
0130-001,2011,11,23,20,1299,1576,2875,3979
0130-001,2011,11,23,21,1169,1373,2542,2875
0130-001,2011,11,23,22,1098,1098,2196,2542
0130-001,2011,11,23,23,816,727,1543,2196
0130-001,2011,11,23,24,582,446,1028,1543
0130-001,2011,11,24,1,340,302,642,1028
0130-001,2011,11,24,2,229,225,454,642
0130-001,2011,11,24,3,172,151,323,454
0130-001,2011,11,24,4,141,137,278,323
0130-001,2011,11,24,5,130,197,327,278
0130-001,2011,11,24,6,335,315,650,327
0130-001,2011,11,24,7,957,635,1592,650
0130-001,2011,11,24,8,2193,1595,3788,1592
0130-001,2011,11,24,9,2114,1948,4062,3788
0130-001,2011,11,24,10,1713,1652,3365,4062
0130-001,2011,11,24,11,1631,1598,3229,3365
0130-001,2011,11,24,12,1542,1582,3124,3229
0130-001,2011,11,24,13,1352,1400,2752,3124
0130-001,2011,11,24,14,1644,1586,3230,2752
0130-001,2011,11,24,15,1783,1723,3506,3230
0130-001,2011,11,24,16,1787,1735,3522,3506
0130-001,2011,11,24,17,1648,1829,3477,3522
0130-001,2011,11,24,18,1742,2171,3913,3477
0130-001,2011,11,24,19,1623,2271,3894,3913
0130-001,2011,11,24,20,1293,1531,2824,3894
0130-001,2011,11,24,21,1231,1520,2751,2824
0130-001,2011,11,24,22,1152,1203,2355,2751
0130-001,2011,11,24,23,864,727,1591,2355
0130-001,2011,11,24,24,588,472,1060,1591
0130-001,2011,11,25,1,372,311,683,1060
0130-001,2011,11,25,2,263,236,499,683
0130-001,2011,11,25,3,198,177,375,499
0130-001,2011,11,25,4,155,186,341,375
0130-001,2011,11,25,5,186,217,403,341
0130-001,2011,11,25,6,359,361,720,403
0130-001,2011,11,25,7,1057,675,1732,720
0130-001,2011,11,25,8,2228,1625,3853,1732
0130-001,2011,11,25,9,2162,2062,4224,3853
0130-001,2011,11,25,10,1647,1640,3287,4224
0130-001,2011,11,25,11,1768,1694,3462,3287
0130-001,2011,11,25,12,1637,1611,3248,3462
0130-001,2011,11,25,13,1469,1559,3028,3248
0130-001,2011,11,25,14,1854,1766,3620,3028
0130-001,2011,11,25,15,1577,1669,3246,3620
0130-001,2011,11,25,16,1903,1958,3861,3246
0130-001,2011,11,25,17,1801,2124,3925,3861
0130-001,2011,11,25,18,1809,2335,4144,3925
0130-001,2011,11,25,19,1861,2214,4075,4144
0130-001,2011,11,25,20,1495,1994,3489,4075
0130-001,2011,11,25,21,1330,1612,2942,3489
0130-001,2011,11,25,22,1207,1334,2541,2942
0130-001,2011,11,25,23,926,890,1816,2541
0130-001,2011,11,25,24,703,595,1298,1816
0130-001,2011,11,26,1,488,420,908,1298
0130-001,2011,11,26,2,344,301,645,908
0130-001,2011,11,26,3,296,248,544,645
0130-001,2011,11,26,4,205,218,423,544
0130-001,2011,11,26,5,223,264,487,423
0130-001,2011,11,26,6,324,357,681,487
0130-001,2011,11,26,7,753,570,1323,681
0130-001,2011,11,26,8,1264,1110,2374,1323
0130-001,2011,11,26,9,1437,1549,2986,2374
0130-001,2011,11,26,10,1586,1784,3370,2986
0130-001,2011,11,26,11,1650,2065,3715,3370
0130-001,2011,11,26,12,1825,2247,4072,3715
0130-001,2011,11,26,13,1742,2193,3935,4072
0130-001,2011,11,26,14,1721,2258,3979,3935
0130-001,2011,11,26,15,1821,2562,4383,3979
0130-001,2011,11,26,16,2003,2169,4172,4383
0130-001,2011,11,26,17,2159,2458,4617,4172
0130-001,2011,11,26,18,1837,2323,4160,4617
0130-001,2011,11,26,19,1918,2057,3975,4160
0130-001,2011,11,26,20,1860,1809,3669,3975
0130-001,2011,11,26,21,1388,1577,2965,3669
0130-001,2011,11,26,22,1093,1164,2257,2965
0130-001,2011,11,26,23,790,916,1706,2257
0130-001,2011,11,26,24,559,590,1149,1706
0130-001,2011,11,27,1,459,322,781,1149
0130-001,2011,11,27,2,283,297,580,781
0130-001,2011,11,27,3,218,206,424,580
0130-001,2011,11,27,4,199,159,358,424
0130-001,2011,11,27,5,198,175,373,358
0130-001,2011,11,27,6,216,258,474,373
0130-001,2011,11,27,7,440,396,836,474
0130-001,2011,11,27,8,588,564,1152,836
0130-001,2011,11,27,9,840,911,1751,1152
0130-001,2011,11,27,10,908,983,1891,1751
0130-001,2011,11,27,11,1043,1190,2233,1891
0130-001,2011,11,27,12,1422,1403,2825,2233
0130-001,2011,11,27,13,1758,1426,3184,2825
0130-001,2011,11,27,14,1918,1375,3293,3184
0130-001,2011,11,27,15,1759,1464,3223,3293
0130-001,2011,11,27,16,1758,1479,3237,3223
0130-001,2011,11,27,17,1707,1439,3146,3237
0130-001,2011,11,27,18,1981,1441,3422,3146
0130-001,2011,11,27,19,1966,1192,3158,3422
0130-001,2011,11,27,20,1882,992,2874,3158
0130-001,2011,11,27,21,1856,851,2707,2874
0130-001,2011,11,27,22,1862,756,2618,2707
0130-001,2011,11,27,23,1564,489,2053,2618
0130-001,2011,11,27,24,652,376,1028,2053
0130-001,2011,11,28,1,310,209,519,1028
0130-001,2011,11,28,2,201,174,375,519
0130-001,2011,11,28,3,141,99,240,375
0130-001,2011,11,28,4,114,133,247,240
0130-001,2011,11,28,5,118,201,319,247
0130-001,2011,11,28,6,307,324,631,319
0130-001,2011,11,28,7,1177,721,1898,631
0130-001,2011,11,28,8,2288,1697,3985,1898
0130-001,2011,11,28,9,2128,2139,4267,3985
0130-001,2011,11,28,10,1652,1645,3297,4267
0130-001,2011,11,28,11,1731,1660,3391,3297
0130-001,2011,11,28,12,1638,1580,3218,3391
0130-001,2011,11,28,13,1451,1472,2923,3218
0130-001,2011,11,28,14,1681,1522,3203,2923
0130-001,2011,11,28,15,1794,1811,3605,3203
0130-001,2011,11,28,16,1812,1818,3630,3605
0130-001,2011,11,28,17,1597,1884,3481,3630
0130-001,2011,11,28,18,1721,2097,3818,3481
0130-001,2011,11,28,19,1702,2196,3898,3818
0130-001,2011,11,28,20,1293,1576,2869,3898
0130-001,2011,11,28,21,1172,1500,2672,2869
0130-001,2011,11,28,22,1053,1119,2172,2672
0130-001,2011,11,28,23,848,796,1644,2172
0130-001,2011,11,28,24,565,457,1022,1644
0130-001,2011,11,29,1,337,314,651,1022
0130-001,2011,11,29,2,262,204,466,651
0130-001,2011,11,29,3,181,195,376,466
0130-001,2011,11,29,4,156,160,316,376
0130-001,2011,11,29,5,158,221,379,316
0130-001,2011,11,29,6,321,315,636,379
0130-001,2011,11,29,7,1007,684,1691,636
0130-001,2011,11,29,8,2215,1601,3816,1691
0130-001,2011,11,29,9,2136,2060,4196,3816
0130-001,2011,11,29,10,1699,1765,3464,4196
0130-001,2011,11,29,11,1759,1600,3359,3464
0130-001,2011,11,29,12,1593,1582,3175,3359
0130-001,2011,11,29,13,1459,1398,2857,3175
0130-001,2011,11,29,14,1582,1619,3201,2857
0130-001,2011,11,29,15,1731,1747,3478,3201
0130-001,2011,11,29,16,1714,1736,3450,3478
0130-001,2011,11,29,17,1624,1781,3405,3450
0130-001,2011,11,29,18,1667,2165,3832,3405
0130-001,2011,11,29,19,1637,2195,3832,3832
0130-001,2011,11,29,20,1292,1584,2876,3832
0130-001,2011,11,29,21,1113,1474,2587,2876
0130-001,2011,11,29,22,1154,1205,2359,2587
0130-001,2011,11,29,23,892,754,1646,2359
0130-001,2011,11,29,24,602,513,1115,1646
0130-001,2011,11,30,1,389,337,726,1115
0130-001,2011,11,30,2,258,222,480,726
0130-001,2011,11,30,3,169,187,356,480
0130-001,2011,11,30,4,149,149,298,356
0130-001,2011,11,30,5,158,222,380,298
0130-001,2011,11,30,6,264,292,556,380
0130-001,2011,11,30,7,882,552,1434,556
0130-001,2011,11,30,8,2043,1489,3532,1434
0130-001,2011,11,30,9,2044,1995,4039,3532
0130-001,2011,11,30,10,1580,1607,3187,4039
0130-001,2011,11,30,11,1598,1522,3120,3187
0130-001,2011,11,30,12,1494,1465,2959,3120
0130-001,2011,11,30,13,1283,1336,2619,2959
0130-001,2011,11,30,14,1470,1573,3043,2619
0130-001,2011,11,30,15,1662,1676,3338,3043
0130-001,2011,11,30,16,1636,1645,3281,3338
0130-001,2011,11,30,17,1531,1602,3133,3281
0130-001,2011,11,30,18,1541,2027,3568,3133
0130-001,2011,11,30,19,1633,2178,3811,3568
0130-001,2011,11,30,20,1231,1644,2875,3811
0130-001,2011,11,30,21,1132,1379,2511,2875
0130-001,2011,11,30,22,1113,1095,2208,2511
0130-001,2011,11,30,23,882,773,1655,2208
0130-001,2011,11,30,24,582,492,1074,1655
0130-001,2011,12,1,1,388,354,742,1074
0130-001,2011,12,1,2,275,233,508,742
0130-001,2011,12,1,3,196,159,355,508
0130-001,2011,12,1,4,163,162,325,355
0130-001,2011,12,1,5,171,233,404,325
0130-001,2011,12,1,6,318,318,636,404
0130-001,2011,12,1,7,929,634,1563,636
0130-001,2011,12,1,8,2228,1576,3804,1563
0130-001,2011,12,1,9,2124,1979,4103,3804
0130-001,2011,12,1,10,1662,1718,3380,4103
0130-001,2011,12,1,11,1667,1573,3240,3380
0130-001,2011,12,1,12,1580,1554,3134,3240
0130-001,2011,12,1,13,1412,1372,2784,3134
0130-001,2011,12,1,14,1662,1670,3332,2784
0130-001,2011,12,1,15,1638,1758,3396,3332
0130-001,2011,12,1,16,1730,1779,3509,3396
0130-001,2011,12,1,17,1616,1786,3402,3509
0130-001,2011,12,1,18,1594,2053,3647,3402
0130-001,2011,12,1,19,1719,2126,3845,3647
0130-001,2011,12,1,20,1252,1463,2715,3845
0130-001,2011,12,1,21,1088,1447,2535,2715
0130-001,2011,12,1,22,1073,1165,2238,2535
0130-001,2011,12,1,23,856,775,1631,2238
0130-001,2011,12,1,24,593,502,1095,1631
0130-001,2011,12,2,1,394,340,734,1095
0130-001,2011,12,2,2,284,242,526,734
0130-001,2011,12,2,3,240,201,441,526
0130-001,2011,12,2,4,155,174,329,441
0130-001,2011,12,2,5,160,235,395,329
0130-001,2011,12,2,6,302,312,614,395
0130-001,2011,12,2,7,966,649,1615,614
0130-001,2011,12,2,8,2112,1598,3710,1615
0130-001,2011,12,2,9,2251,2025,4276,3710
0130-001,2011,12,2,10,1660,1678,3338,4276
0130-001,2011,12,2,11,1680,1531,3211,3338
0130-001,2011,12,2,12,1539,1591,3130,3211
0130-001,2011,12,2,13,1390,1445,2835,3130
0130-001,2011,12,2,14,1592,1719,3311,2835
0130-001,2011,12,2,15,1780,1793,3573,3311
0130-001,2011,12,2,16,1702,1853,3555,3573
0130-001,2011,12,2,17,1766,1851,3617,3555
0130-001,2011,12,2,18,1789,2172,3961,3617
0130-001,2011,12,2,19,1848,2290,4138,3961
0130-001,2011,12,2,20,1455,1821,3276,4138
0130-001,2011,12,2,21,1198,1532,2730,3276
0130-001,2011,12,2,22,1166,1270,2436,2730
0130-001,2011,12,2,23,959,842,1801,2436
0130-001,2011,12,2,24,706,589,1295,1801
0130-001,2011,12,3,1,535,457,992,1295
0130-001,2011,12,3,2,346,305,651,992
0130-001,2011,12,3,3,246,228,474,651
0130-001,2011,12,3,4,194,201,395,474
0130-001,2011,12,3,5,198,204,402,395
0130-001,2011,12,3,6,269,305,574,402
0130-001,2011,12,3,7,572,450,1022,574
0130-001,2011,12,3,8,1344,1185,2529,1022
0130-001,2011,12,3,9,1796,1631,3427,2529
0130-001,2011,12,3,10,1537,1535,3072,3427
0130-001,2011,12,3,11,1533,1827,3360,3072
0130-001,2011,12,3,12,1602,2079,3681,3360
0130-001,2011,12,3,13,1642,2230,3872,3681
0130-001,2011,12,3,14,1740,2140,3880,3872
0130-001,2011,12,3,15,1811,2071,3882,3880
0130-001,2011,12,3,16,1817,2140,3957,3882
0130-001,2011,12,3,17,1911,2041,3952,3957
0130-001,2011,12,3,18,2109,2220,4329,3952
0130-001,2011,12,3,19,1855,1950,3805,4329
0130-001,2011,12,3,20,1270,1470,2740,3805
0130-001,2011,12,3,21,1166,1009,2175,2740
0130-001,2011,12,3,22,1079,895,1974,2175
0130-001,2011,12,3,23,739,648,1387,1974
0130-001,2011,12,3,24,555,446,1001,1387
0130-001,2011,12,4,1,476,378,854,1001
0130-001,2011,12,4,2,340,289,629,854
0130-001,2011,12,4,3,272,237,509,629
0130-001,2011,12,4,4,217,179,396,509
0130-001,2011,12,4,5,175,160,335,396
0130-001,2011,12,4,6,215,237,452,335
0130-001,2011,12,4,7,387,356,743,452
0130-001,2011,12,4,8,560,576,1136,743
0130-001,2011,12,4,9,739,816,1555,1136
0130-001,2011,12,4,10,891,1075,1966,1555
0130-001,2011,12,4,11,1032,1261,2293,1966
0130-001,2011,12,4,12,1028,1268,2296,2293
0130-001,2011,12,4,13,1405,1393,2798,2296
0130-001,2011,12,4,14,1634,1414,3048,2798
0130-001,2011,12,4,15,1756,1533,3289,3048
0130-001,2011,12,4,16,2008,1488,3496,3289
0130-001,2011,12,4,17,1945,1412,3357,3496
0130-001,2011,12,4,18,1929,1457,3386,3357
0130-001,2011,12,4,19,1869,1230,3099,3386
0130-001,2011,12,4,20,1329,962,2291,3099
0130-001,2011,12,4,21,1058,881,1939,2291
0130-001,2011,12,4,22,962,685,1647,1939
0130-001,2011,12,4,23,664,481,1145,1647
0130-001,2011,12,4,24,455,362,817,1145
0130-001,2011,12,5,1,253,235,488,817
0130-001,2011,12,5,2,179,159,338,488
0130-001,2011,12,5,3,113,116,229,338
0130-001,2011,12,5,4,112,98,210,229
0130-001,2011,12,5,5,131,207,338,210
0130-001,2011,12,5,6,283,321,604,338
0130-001,2011,12,5,7,1113,683,1796,604
0130-001,2011,12,5,8,2310,1658,3968,1796
0130-001,2011,12,5,9,2129,2111,4240,3968
0130-001,2011,12,5,10,1663,1631,3294,4240
0130-001,2011,12,5,11,1656,1557,3213,3294
0130-001,2011,12,5,12,1539,1556,3095,3213
0130-001,2011,12,5,13,1411,1398,2809,3095
0130-001,2011,12,5,14,1678,1660,3338,2809
0130-001,2011,12,5,15,1812,1745,3557,3338
0130-001,2011,12,5,16,1683,1785,3468,3557
0130-001,2011,12,5,17,1711,1828,3539,3468
0130-001,2011,12,5,18,1717,2132,3849,3539
0130-001,2011,12,5,19,1728,2186,3914,3849
0130-001,2011,12,5,20,1304,1608,2912,3914
0130-001,2011,12,5,21,1115,1581,2696,2912
0130-001,2011,12,5,22,1076,1135,2211,2696
0130-001,2011,12,5,23,803,701,1504,2211
0130-001,2011,12,5,24,511,499,1010,1504
0130-001,2011,12,6,1,352,255,607,1010
0130-001,2011,12,6,2,248,212,460,607
0130-001,2011,12,6,3,185,182,367,460
0130-001,2011,12,6,4,154,137,291,367
0130-001,2011,12,6,5,144,219,363,291
0130-001,2011,12,6,6,276,325,601,363
0130-001,2011,12,6,7,1000,656,1656,601
0130-001,2011,12,6,8,2201,1629,3830,1656
0130-001,2011,12,6,9,2086,2122,4208,3830
0130-001,2011,12,6,10,1721,1744,3465,4208
0130-001,2011,12,6,11,1784,1605,3389,3465
0130-001,2011,12,6,12,1616,1603,3219,3389
0130-001,2011,12,6,13,1373,1358,2731,3219
0130-001,2011,12,6,14,1556,1641,3197,2731
0130-001,2011,12,6,15,1737,1746,3483,3197
0130-001,2011,12,6,16,1718,1827,3545,3483
0130-001,2011,12,6,17,1656,1721,3377,3545
0130-001,2011,12,6,18,1625,2069,3694,3377
0130-001,2011,12,6,19,1683,2015,3698,3694
0130-001,2011,12,6,20,1203,1655,2858,3698
0130-001,2011,12,6,21,1159,1465,2624,2858
0130-001,2011,12,6,22,1093,1143,2236,2624
0130-001,2011,12,6,23,813,693,1506,2236
0130-001,2011,12,6,24,571,495,1066,1506
0130-001,2011,12,7,1,345,305,650,1066
0130-001,2011,12,7,2,277,223,500,650
0130-001,2011,12,7,3,194,183,377,500
0130-001,2011,12,7,4,173,169,342,377
0130-001,2011,12,7,5,149,231,380,342
0130-001,2011,12,7,6,283,324,607,380
0130-001,2011,12,7,7,964,654,1618,607
0130-001,2011,12,7,8,2254,1577,3831,1618
0130-001,2011,12,7,9,2101,2048,4149,3831
0130-001,2011,12,7,10,1385,1693,3078,4149
0130-001,2011,12,7,11,1796,1513,3309,3078
0130-001,2011,12,7,12,1517,1560,3077,3309
0130-001,2011,12,7,13,1347,1388,2735,3077
0130-001,2011,12,7,14,1583,1653,3236,2735
0130-001,2011,12,7,15,1687,1718,3405,3236
0130-001,2011,12,7,16,1707,1748,3455,3405
0130-001,2011,12,7,17,1706,1776,3482,3455
0130-001,2011,12,7,18,1654,2207,3861,3482
0130-001,2011,12,7,19,1688,2260,3948,3861
0130-001,2011,12,7,20,1306,1597,2903,3948
0130-001,2011,12,7,21,1193,1380,2573,2903
0130-001,2011,12,7,22,1185,1117,2302,2573
0130-001,2011,12,7,23,784,743,1527,2302
0130-001,2011,12,7,24,557,497,1054,1527
0130-001,2011,12,8,1,400,328,728,1054
0130-001,2011,12,8,2,283,221,504,728
0130-001,2011,12,8,3,214,171,385,504
0130-001,2011,12,8,4,148,142,290,385
0130-001,2011,12,8,5,145,236,381,290
0130-001,2011,12,8,6,269,319,588,381
0130-001,2011,12,8,7,973,643,1616,588
0130-001,2011,12,8,8,2261,1628,3889,1616
0130-001,2011,12,8,9,2060,2040,4100,3889
0130-001,2011,12,8,10,1621,1662,3283,4100
0130-001,2011,12,8,11,1645,1587,3232,3283
0130-001,2011,12,8,12,1584,1632,3216,3232
0130-001,2011,12,8,13,1402,1383,2785,3216
0130-001,2011,12,8,14,1711,1599,3310,2785
0130-001,2011,12,8,15,1695,1720,3415,3310
0130-001,2011,12,8,16,1707,1801,3508,3415
0130-001,2011,12,8,17,1632,1751,3383,3508
0130-001,2011,12,8,18,1761,2073,3834,3383
0130-001,2011,12,8,19,1584,2123,3707,3834
0130-001,2011,12,8,20,1257,1476,2733,3707
0130-001,2011,12,8,21,1148,1458,2606,2733
0130-001,2011,12,8,22,1121,1151,2272,2606
0130-001,2011,12,8,23,848,790,1638,2272
0130-001,2011,12,8,24,571,491,1062,1638
0130-001,2011,12,9,1,378,336,714,1062
0130-001,2011,12,9,2,284,216,500,714
0130-001,2011,12,9,3,199,199,398,500
0130-001,2011,12,9,4,149,165,314,398
0130-001,2011,12,9,5,165,222,387,314
0130-001,2011,12,9,6,275,338,613,387
0130-001,2011,12,9,7,946,598,1544,613
0130-001,2011,12,9,8,2247,1580,3827,1544
0130-001,2011,12,9,9,2067,2009,4076,3827
0130-001,2011,12,9,10,1737,1606,3343,4076
0130-001,2011,12,9,11,1609,1724,3333,3343
0130-001,2011,12,9,12,1558,1593,3151,3333
0130-001,2011,12,9,13,1361,1467,2828,3151
0130-001,2011,12,9,14,1689,1665,3354,2828
0130-001,2011,12,9,15,1827,1762,3589,3354
0130-001,2011,12,9,16,1747,1884,3631,3589
0130-001,2011,12,9,17,1671,1757,3428,3631
0130-001,2011,12,9,18,1821,2152,3973,3428
0130-001,2011,12,9,19,1869,2257,4126,3973
0130-001,2011,12,9,20,1333,1861,3194,4126
0130-001,2011,12,9,21,1223,1490,2713,3194
0130-001,2011,12,9,22,1192,1187,2379,2713
0130-001,2011,12,9,23,988,819,1807,2379
0130-001,2011,12,9,24,750,580,1330,1807
0130-001,2011,12,10,1,542,449,991,1330
0130-001,2011,12,10,2,334,310,644,991
0130-001,2011,12,10,3,267,221,488,644
0130-001,2011,12,10,4,208,199,407,488
0130-001,2011,12,10,5,205,245,450,407
0130-001,2011,12,10,6,289,321,610,450
0130-001,2011,12,10,7,645,494,1139,610
0130-001,2011,12,10,8,1122,886,2008,1139
0130-001,2011,12,10,9,1377,1381,2758,2008
0130-001,2011,12,10,10,1472,1612,3084,2758
0130-001,2011,12,10,11,1524,1796,3320,3084
0130-001,2011,12,10,12,1669,1821,3490,3320
0130-001,2011,12,10,13,1546,2063,3609,3490
0130-001,2011,12,10,14,1632,2012,3644,3609
0130-001,2011,12,10,15,1712,2075,3787,3644
0130-001,2011,12,10,16,1840,1997,3837,3787
0130-001,2011,12,10,17,1967,2008,3975,3837
0130-001,2011,12,10,18,1908,2056,3964,3975
0130-001,2011,12,10,19,1761,1768,3529,3964
0130-001,2011,12,10,20,1215,1262,2477,3529
0130-001,2011,12,10,21,1091,1038,2129,2477
0130-001,2011,12,10,22,1074,848,1922,2129
0130-001,2011,12,10,23,789,628,1417,1922
0130-001,2011,12,10,24,669,499,1168,1417
0130-001,2011,12,11,1,484,401,885,1168
0130-001,2011,12,11,2,346,318,664,885
0130-001,2011,12,11,3,272,209,481,664
0130-001,2011,12,11,4,212,176,388,481
0130-001,2011,12,11,5,154,173,327,388
0130-001,2011,12,11,6,188,217,405,327
0130-001,2011,12,11,7,374,347,721,405
0130-001,2011,12,11,8,535,537,1072,721
0130-001,2011,12,11,9,643,833,1476,1072
0130-001,2011,12,11,10,747,846,1593,1476
0130-001,2011,12,11,11,990,1197,2187,1593
0130-001,2011,12,11,12,1126,1361,2487,2187
0130-001,2011,12,11,13,1495,1397,2892,2487
0130-001,2011,12,11,14,1787,1502,3289,2892
0130-001,2011,12,11,15,1932,1509,3441,3289
0130-001,2011,12,11,16,1860,1538,3398,3441
0130-001,2011,12,11,17,1810,1449,3259,3398
0130-001,2011,12,11,18,1855,1419,3274,3259
0130-001,2011,12,11,19,1834,1113,2947,3274
0130-001,2011,12,11,20,1205,944,2149,2947
0130-001,2011,12,11,21,1087,861,1948,2149
0130-001,2011,12,11,22,1039,701,1740,1948
0130-001,2011,12,11,23,693,505,1198,1740
0130-001,2011,12,11,24,484,362,846,1198
0130-001,2011,12,12,1,313,240,553,846
0130-001,2011,12,12,2,216,167,383,553
0130-001,2011,12,12,3,128,140,268,383
0130-001,2011,12,12,4,108,101,209,268
0130-001,2011,12,12,5,143,194,337,209
0130-001,2011,12,12,6,310,321,631,337
0130-001,2011,12,12,7,1071,678,1749,631
0130-001,2011,12,12,8,2307,1577,3884,1749
0130-001,2011,12,12,9,2154,2110,4264,3884
0130-001,2011,12,12,10,1606,1657,3263,4264
0130-001,2011,12,12,11,1633,1540,3173,3263
0130-001,2011,12,12,12,1581,1537,3118,3173
0130-001,2011,12,12,13,1393,1400,2793,3118
0130-001,2011,12,12,14,1691,1678,3369,2793
0130-001,2011,12,12,15,1725,1766,3491,3369
0130-001,2011,12,12,16,1742,1799,3541,3491
0130-001,2011,12,12,17,1693,1757,3450,3541
0130-001,2011,12,12,18,1723,2119,3842,3450
0130-001,2011,12,12,19,1687,2159,3846,3842
0130-001,2011,12,12,20,1222,1564,2786,3846
0130-001,2011,12,12,21,1151,1461,2612,2786
0130-001,2011,12,12,22,1059,1194,2253,2612
0130-001,2011,12,12,23,791,731,1522,2253
0130-001,2011,12,12,24,543,492,1035,1522
0130-001,2011,12,13,1,338,295,633,1035
0130-001,2011,12,13,2,260,211,471,633
0130-001,2011,12,13,3,191,175,366,471
0130-001,2011,12,13,4,152,139,291,366
0130-001,2011,12,13,5,149,216,365,291
0130-001,2011,12,13,6,274,318,592,365
0130-001,2011,12,13,7,917,663,1580,592
0130-001,2011,12,13,8,2236,1611,3847,1580
0130-001,2011,12,13,9,2143,2030,4173,3847
0130-001,2011,12,13,10,1730,1658,3388,4173
0130-001,2011,12,13,11,1652,1579,3231,3388
0130-001,2011,12,13,12,1500,1437,2937,3231
0130-001,2011,12,13,13,1397,1415,2812,2937
0130-001,2011,12,13,14,1650,1615,3265,2812
0130-001,2011,12,13,15,1744,1863,3607,3265
0130-001,2011,12,13,16,1724,1750,3474,3607
0130-001,2011,12,13,17,1629,1759,3388,3474
0130-001,2011,12,13,18,1762,2139,3901,3388
0130-001,2011,12,13,19,1667,2126,3793,3901
0130-001,2011,12,13,20,1270,1562,2832,3793
0130-001,2011,12,13,21,1179,1463,2642,2832
0130-001,2011,12,13,22,1141,1201,2342,2642
0130-001,2011,12,13,23,821,698,1519,2342
0130-001,2011,12,13,24,626,489,1115,1519
0130-001,2011,12,14,1,377,306,683,1115
0130-001,2011,12,14,2,272,259,531,683
0130-001,2011,12,14,3,191,187,378,531
0130-001,2011,12,14,4,147,152,299,378
0130-001,2011,12,14,5,138,223,361,299
0130-001,2011,12,14,6,294,295,589,361
0130-001,2011,12,14,7,910,645,1555,589
0130-001,2011,12,14,8,2221,1609,3830,1555
0130-001,2011,12,14,9,2142,2052,4194,3830
0130-001,2011,12,14,10,1563,1659,3222,4194
0130-001,2011,12,14,11,1612,1622,3234,3222
0130-001,2011,12,14,12,1584,1516,3100,3234
0130-001,2011,12,14,13,1353,1448,2801,3100
0130-001,2011,12,14,14,1663,1623,3286,2801
0130-001,2011,12,14,15,1698,1750,3448,3286
0130-001,2011,12,14,16,1723,1753,3476,3448
0130-001,2011,12,14,17,1630,1776,3406,3476
0130-001,2011,12,14,18,1631,2155,3786,3406
0130-001,2011,12,14,19,1656,2291,3947,3786
0130-001,2011,12,14,20,1291,1534,2825,3947
0130-001,2011,12,14,21,1193,1298,2491,2825
0130-001,2011,12,14,22,1135,1116,2251,2491
0130-001,2011,12,14,23,888,747,1635,2251
0130-001,2011,12,14,24,573,491,1064,1635
0130-001,2011,12,15,1,413,352,765,1064
0130-001,2011,12,15,2,327,276,603,765
0130-001,2011,12,15,3,209,187,396,603
0130-001,2011,12,15,4,149,160,309,396
0130-001,2011,12,15,5,134,218,352,309
0130-001,2011,12,15,6,253,320,573,352
0130-001,2011,12,15,7,912,670,1582,573
0130-001,2011,12,15,8,2087,1609,3696,1582
0130-001,2011,12,15,9,2284,2028,4312,3696
0130-001,2011,12,15,10,1631,1695,3326,4312
0130-001,2011,12,15,11,1625,1528,3153,3326
0130-001,2011,12,15,12,1563,1635,3198,3153
0130-001,2011,12,15,13,1400,1462,2862,3198
0130-001,2011,12,15,14,1644,1703,3347,2862
0130-001,2011,12,15,15,1705,1757,3462,3347
0130-001,2011,12,15,16,1756,1687,3443,3462
0130-001,2011,12,15,17,1695,1774,3469,3443
0130-001,2011,12,15,18,1663,2189,3852,3469
0130-001,2011,12,15,19,1766,2251,4017,3852
0130-001,2011,12,15,20,1234,1587,2821,4017
0130-001,2011,12,15,21,1167,1415,2582,2821
0130-001,2011,12,15,22,1119,1192,2311,2582
0130-001,2011,12,15,23,917,757,1674,2311
0130-001,2011,12,15,24,658,537,1195,1674
0130-001,2011,12,16,1,455,369,824,1195
0130-001,2011,12,16,2,312,251,563,824
0130-001,2011,12,16,3,216,191,407,563
0130-001,2011,12,16,4,178,163,341,407
0130-001,2011,12,16,5,137,214,351,341
0130-001,2011,12,16,6,277,304,581,351
0130-001,2011,12,16,7,867,607,1474,581
0130-001,2011,12,16,8,2177,1580,3757,1474
0130-001,2011,12,16,9,2185,2048,4233,3757
0130-001,2011,12,16,10,1656,1657,3313,4233
0130-001,2011,12,16,11,1658,1634,3292,3313
0130-001,2011,12,16,12,1526,1575,3101,3292
0130-001,2011,12,16,13,1439,1513,2952,3101
0130-001,2011,12,16,14,1633,1739,3372,2952
0130-001,2011,12,16,15,1832,1805,3637,3372
0130-001,2011,12,16,16,1747,1765,3512,3637
0130-001,2011,12,16,17,1723,1893,3616,3512
0130-001,2011,12,16,18,1821,2181,4002,3616
0130-001,2011,12,16,19,1803,2126,3929,4002
0130-001,2011,12,16,20,1374,1858,3232,3929
0130-001,2011,12,16,21,1183,1443,2626,3232
0130-001,2011,12,16,22,1203,1252,2455,2626
0130-001,2011,12,16,23,980,758,1738,2455
0130-001,2011,12,16,24,707,571,1278,1738
0130-001,2011,12,17,1,526,415,941,1278
0130-001,2011,12,17,2,397,315,712,941
0130-001,2011,12,17,3,286,264,550,712
0130-001,2011,12,17,4,223,202,425,550
0130-001,2011,12,17,5,209,244,453,425
0130-001,2011,12,17,6,286,312,598,453
0130-001,2011,12,17,7,612,484,1096,598
0130-001,2011,12,17,8,1314,1220,2534,1096
0130-001,2011,12,17,9,1557,1576,3133,2534
0130-001,2011,12,17,10,1375,1524,2899,3133
0130-001,2011,12,17,11,1529,1850,3379,2899
0130-001,2011,12,17,12,1644,2071,3715,3379
0130-001,2011,12,17,13,1733,2173,3906,3715
0130-001,2011,12,17,14,1750,2154,3904,3906
0130-001,2011,12,17,15,1798,2149,3947,3904
0130-001,2011,12,17,16,1802,2108,3910,3947
0130-001,2011,12,17,17,1918,2021,3939,3910
0130-001,2011,12,17,18,2094,2132,4226,3939
0130-001,2011,12,17,19,1997,1992,3989,4226
0130-001,2011,12,17,20,1413,1448,2861,3989
0130-001,2011,12,17,21,1142,981,2123,2861
0130-001,2011,12,17,22,1135,906,2041,2123
0130-001,2011,12,17,23,819,638,1457,2041
0130-001,2011,12,17,24,624,497,1121,1457
0130-001,2011,12,18,1,476,400,876,1121
0130-001,2011,12,18,2,368,291,659,876
0130-001,2011,12,18,3,255,242,497,659
0130-001,2011,12,18,4,249,202,451,497
0130-001,2011,12,18,5,190,188,378,451
0130-001,2011,12,18,6,208,252,460,378
0130-001,2011,12,18,7,382,325,707,460
0130-001,2011,12,18,8,554,501,1055,707
0130-001,2011,12,18,9,677,870,1547,1055
0130-001,2011,12,18,10,833,923,1756,1547
0130-001,2011,12,18,11,969,1277,2246,1756
0130-001,2011,12,18,12,1087,1352,2439,2246
0130-001,2011,12,18,13,1295,1386,2681,2439
0130-001,2011,12,18,14,1584,1452,3036,2681
0130-001,2011,12,18,15,1759,1449,3208,3036
0130-001,2011,12,18,16,1933,1529,3462,3208
0130-001,2011,12,18,17,1773,1452,3225,3462
0130-001,2011,12,18,18,1862,1384,3246,3225
0130-001,2011,12,18,19,1689,1176,2865,3246
0130-001,2011,12,18,20,1183,892,2075,2865
0130-001,2011,12,18,21,1098,850,1948,2075
0130-001,2011,12,18,22,962,681,1643,1948
0130-001,2011,12,18,23,649,488,1137,1643
0130-001,2011,12,18,24,478,374,852,1137
0130-001,2011,12,19,1,302,225,527,852
0130-001,2011,12,19,2,151,142,293,527
0130-001,2011,12,19,3,122,113,235,293
0130-001,2011,12,19,4,116,122,238,235
0130-001,2011,12,19,5,139,207,346,238
0130-001,2011,12,19,6,279,328,607,346
0130-001,2011,12,19,7,1044,683,1727,607
0130-001,2011,12,19,8,2279,1613,3892,1727
0130-001,2011,12,19,9,2114,2059,4173,3892
0130-001,2011,12,19,10,1555,1612,3167,4173
0130-001,2011,12,19,11,1576,1543,3119,3167
0130-001,2011,12,19,12,1515,1599,3114,3119
0130-001,2011,12,19,13,1454,1357,2811,3114
0130-001,2011,12,19,14,1618,1630,3248,2811
0130-001,2011,12,19,15,1815,1790,3605,3248
0130-001,2011,12,19,16,1734,1835,3569,3605
0130-001,2011,12,19,17,1632,1771,3403,3569
0130-001,2011,12,19,18,1621,2144,3765,3403
0130-001,2011,12,19,19,1685,2140,3825,3765
0130-001,2011,12,19,20,1257,1537,2794,3825
0130-001,2011,12,19,21,1175,1468,2643,2794
0130-001,2011,12,19,22,1068,1171,2239,2643
0130-001,2011,12,19,23,827,635,1462,2239
0130-001,2011,12,19,24,536,403,939,1462
0130-001,2011,12,20,1,351,298,649,939
0130-001,2011,12,20,2,250,216,466,649
0130-001,2011,12,20,3,188,167,355,466
0130-001,2011,12,20,4,150,147,297,355
0130-001,2011,12,20,5,148,199,347,297
0130-001,2011,12,20,6,261,292,553,347
0130-001,2011,12,20,7,941,610,1551,553
0130-001,2011,12,20,8,2223,1554,3777,1551
0130-001,2011,12,20,9,2185,2013,4198,3777
0130-001,2011,12,20,10,1679,1696,3375,4198
0130-001,2011,12,20,11,1668,1567,3235,3375
0130-001,2011,12,20,12,1556,1522,3078,3235
0130-001,2011,12,20,13,1427,1409,2836,3078
0130-001,2011,12,20,14,1593,1631,3224,2836
0130-001,2011,12,20,15,1771,1775,3546,3224
0130-001,2011,12,20,16,1788,1796,3584,3546
0130-001,2011,12,20,17,1621,1741,3362,3584
0130-001,2011,12,20,18,1666,2119,3785,3362
0130-001,2011,12,20,19,1597,2284,3881,3785
0130-001,2011,12,20,20,1262,1635,2897,3881
0130-001,2011,12,20,21,1153,1374,2527,2897
0130-001,2011,12,20,22,1144,1161,2305,2527
0130-001,2011,12,20,23,881,725,1606,2305
0130-001,2011,12,20,24,673,525,1198,1606
0130-001,2011,12,21,1,430,352,782,1198
0130-001,2011,12,21,2,297,235,532,782
0130-001,2011,12,21,3,206,190,396,532
0130-001,2011,12,21,4,171,159,330,396
0130-001,2011,12,21,5,147,216,363,330
0130-001,2011,12,21,6,255,322,577,363
0130-001,2011,12,21,7,851,634,1485,577
0130-001,2011,12,21,8,2166,1599,3765,1485
0130-001,2011,12,21,9,2104,1965,4069,3765
0130-001,2011,12,21,10,1692,1635,3327,4069
0130-001,2011,12,21,11,1638,1582,3220,3327
0130-001,2011,12,21,12,1632,1603,3235,3220
0130-001,2011,12,21,13,1382,1479,2861,3235
0130-001,2011,12,21,14,1621,1718,3339,2861
0130-001,2011,12,21,15,1760,1798,3558,3339
0130-001,2011,12,21,16,1838,1712,3550,3558
0130-001,2011,12,21,17,1691,1753,3444,3550
0130-001,2011,12,21,18,1664,2156,3820,3444
0130-001,2011,12,21,19,1649,2215,3864,3820
0130-001,2011,12,21,20,1314,1634,2948,3864
0130-001,2011,12,21,21,1162,1314,2476,2948
0130-001,2011,12,21,22,1229,1081,2310,2476
0130-001,2011,12,21,23,925,765,1690,2310
0130-001,2011,12,21,24,657,517,1174,1690
0130-001,2011,12,22,1,398,393,791,1174
0130-001,2011,12,22,2,308,258,566,791
0130-001,2011,12,22,3,203,203,406,566
0130-001,2011,12,22,4,146,178,324,406
0130-001,2011,12,22,5,147,222,369,324
0130-001,2011,12,22,6,259,307,566,369
0130-001,2011,12,22,7,862,616,1478,566
0130-001,2011,12,22,8,2112,1512,3624,1478
0130-001,2011,12,22,9,2124,1924,4048,3624
0130-001,2011,12,22,10,1634,1612,3246,4048
0130-001,2011,12,22,11,1569,1589,3158,3246
0130-001,2011,12,22,12,1589,1522,3111,3158
0130-001,2011,12,22,13,1333,1403,2736,3111
0130-001,2011,12,22,14,1576,1629,3205,2736
0130-001,2011,12,22,15,1734,1783,3517,3205
0130-001,2011,12,22,16,1775,1738,3513,3517
0130-001,2011,12,22,17,1623,1760,3383,3513
0130-001,2011,12,22,18,1842,1984,3826,3383
0130-001,2011,12,22,19,1841,1791,3632,3826
0130-001,2011,12,22,20,1294,1636,2930,3632
0130-001,2011,12,22,21,1176,1517,2693,2930
0130-001,2011,12,22,22,1161,1269,2430,2693
0130-001,2011,12,22,23,908,878,1786,2430
0130-001,2011,12,22,24,703,537,1240,1786
0130-001,2011,12,23,1,456,362,818,1240
0130-001,2011,12,23,2,306,249,555,818
0130-001,2011,12,23,3,201,179,380,555
0130-001,2011,12,23,4,185,185,370,380
0130-001,2011,12,23,5,169,240,409,370
0130-001,2011,12,23,6,270,283,553,409
0130-001,2011,12,23,7,814,603,1417,553
0130-001,2011,12,23,8,2167,1493,3660,1417
0130-001,2011,12,23,9,2122,2026,4148,3660
0130-001,2011,12,23,10,1584,1696,3280,4148
0130-001,2011,12,23,11,1619,1564,3183,3280
0130-001,2011,12,23,12,1589,1614,3203,3183
0130-001,2011,12,23,13,1397,1569,2966,3203
0130-001,2011,12,23,14,1672,1754,3426,2966
0130-001,2011,12,23,15,1817,1906,3723,3426
0130-001,2011,12,23,16,1762,1885,3647,3723
0130-001,2011,12,23,17,1738,1785,3523,3647
0130-001,2011,12,23,18,1833,2246,4079,3523
0130-001,2011,12,23,19,1824,2240,4064,4079
0130-001,2011,12,23,20,1444,1901,3345,4064
0130-001,2011,12,23,21,1300,1632,2932,3345
0130-001,2011,12,23,22,1323,1256,2579,2932
0130-001,2011,12,23,23,1123,808,1931,2579
0130-001,2011,12,23,24,783,568,1351,1931
0130-001,2011,12,24,1,490,378,868,1351
0130-001,2011,12,24,2,338,272,610,868
0130-001,2011,12,24,3,232,228,460,610
0130-001,2011,12,24,4,187,176,363,460
0130-001,2011,12,24,5,158,181,339,363
0130-001,2011,12,24,6,228,239,467,339
0130-001,2011,12,24,7,413,364,777,467
0130-001,2011,12,24,8,714,554,1268,777
0130-001,2011,12,24,9,900,818,1718,1268
0130-001,2011,12,24,10,969,1017,1986,1718
0130-001,2011,12,24,11,1110,1258,2368,1986
0130-001,2011,12,24,12,1258,1569,2827,2368
0130-001,2011,12,24,13,1214,1768,2982,2827
0130-001,2011,12,24,14,1439,1700,3139,2982
0130-001,2011,12,24,15,1625,1768,3393,3139
0130-001,2011,12,24,16,1578,1753,3331,3393
0130-001,2011,12,24,17,1738,1642,3380,3331
0130-001,2011,12,24,18,1600,1489,3089,3380
0130-001,2011,12,24,19,1327,1441,2768,3089
0130-001,2011,12,24,20,1049,940,1989,2768
0130-001,2011,12,24,21,840,739,1579,1989
0130-001,2011,12,24,22,835,687,1522,1579
0130-001,2011,12,24,23,688,505,1193,1522
0130-001,2011,12,24,24,526,423,949,1193
0130-001,2011,12,25,1,367,308,675,949
0130-001,2011,12,25,2,259,235,494,675
0130-001,2011,12,25,3,227,193,420,494
0130-001,2011,12,25,4,201,136,337,420
0130-001,2011,12,25,5,151,169,320,337
0130-001,2011,12,25,6,176,207,383,320
0130-001,2011,12,25,7,279,214,493,383
0130-001,2011,12,25,8,384,343,727,493
0130-001,2011,12,25,9,474,564,1038,727
0130-001,2011,12,25,10,662,721,1383,1038
0130-001,2011,12,25,11,813,1016,1829,1383
0130-001,2011,12,25,12,890,1102,1992,1829
0130-001,2011,12,25,13,1025,1221,2246,1992
0130-001,2011,12,25,14,1287,1366,2653,2246
0130-001,2011,12,25,15,1358,1477,2835,2653
0130-001,2011,12,25,16,1583,1412,2995,2835
0130-001,2011,12,25,17,1624,1372,2996,2995
0130-001,2011,12,25,18,1391,1352,2743,2996
0130-001,2011,12,25,19,1226,1102,2328,2743
0130-001,2011,12,25,20,1000,842,1842,2328
0130-001,2011,12,25,21,981,777,1758,1842
0130-001,2011,12,25,22,918,634,1552,1758
0130-001,2011,12,25,23,640,479,1119,1552
0130-001,2011,12,25,24,489,321,810,1119
0130-001,2011,12,26,1,343,243,586,810
0130-001,2011,12,26,2,187,149,336,586
0130-001,2011,12,26,3,152,131,283,336
0130-001,2011,12,26,4,131,105,236,283
0130-001,2011,12,26,5,138,190,328,236
0130-001,2011,12,26,6,283,320,603,328
0130-001,2011,12,26,7,926,631,1557,603
0130-001,2011,12,26,8,2186,1446,3632,1557
0130-001,2011,12,26,9,2153,1983,4136,3632
0130-001,2011,12,26,10,1543,1591,3134,4136
0130-001,2011,12,26,11,1582,1537,3119,3134
0130-001,2011,12,26,12,1587,1580,3167,3119
0130-001,2011,12,26,13,1366,1449,2815,3167
0130-001,2011,12,26,14,1733,1638,3371,2815
0130-001,2011,12,26,15,1857,1776,3633,3371
0130-001,2011,12,26,16,1752,1712,3464,3633
0130-001,2011,12,26,17,1654,1753,3407,3464
0130-001,2011,12,26,18,1641,2008,3649,3407
0130-001,2011,12,26,19,1684,2210,3894,3649
0130-001,2011,12,26,20,1252,1553,2805,3894
0130-001,2011,12,26,21,1080,1449,2529,2805
0130-001,2011,12,26,22,1104,1149,2253,2529
0130-001,2011,12,26,23,843,696,1539,2253
0130-001,2011,12,26,24,640,461,1101,1539
0130-001,2011,12,27,1,364,331,695,1101
0130-001,2011,12,27,2,244,218,462,695
0130-001,2011,12,27,3,178,165,343,462
0130-001,2011,12,27,4,162,171,333,343
0130-001,2011,12,27,5,166,203,369,333
0130-001,2011,12,27,6,250,288,538,369
0130-001,2011,12,27,7,874,572,1446,538
0130-001,2011,12,27,8,2115,1443,3558,1446
0130-001,2011,12,27,9,2162,1986,4148,3558
0130-001,2011,12,27,10,1675,1702,3377,4148
0130-001,2011,12,27,11,1667,1632,3299,3377
0130-001,2011,12,27,12,1637,1691,3328,3299
0130-001,2011,12,27,13,1383,1455,2838,3328
0130-001,2011,12,27,14,1648,1514,3162,2838
0130-001,2011,12,27,15,1675,1748,3423,3162
0130-001,2011,12,27,16,1764,1696,3460,3423
0130-001,2011,12,27,17,1651,1734,3385,3460
0130-001,2011,12,27,18,1593,1949,3542,3385
0130-001,2011,12,27,19,1554,2258,3812,3542
0130-001,2011,12,27,20,1286,1561,2847,3812
0130-001,2011,12,27,21,1151,1348,2499,2847
0130-001,2011,12,27,22,1096,1178,2274,2499
0130-001,2011,12,27,23,877,701,1578,2274
0130-001,2011,12,27,24,721,537,1258,1578
0130-001,2011,12,28,1,435,379,814,1258
0130-001,2011,12,28,2,302,262,564,814
0130-001,2011,12,28,3,234,202,436,564
0130-001,2011,12,28,4,177,163,340,436
0130-001,2011,12,28,5,183,236,419,340
0130-001,2011,12,28,6,277,321,598,419
0130-001,2011,12,28,7,824,519,1343,598
0130-001,2011,12,28,8,2133,1465,3598,1343
0130-001,2011,12,28,9,2124,1969,4093,3598
0130-001,2011,12,28,10,1533,1633,3166,4093
0130-001,2011,12,28,11,1562,1475,3037,3166
0130-001,2011,12,28,12,1528,1542,3070,3037
0130-001,2011,12,28,13,1372,1453,2825,3070
0130-001,2011,12,28,14,1685,1661,3346,2825
0130-001,2011,12,28,15,1799,1764,3563,3346
0130-001,2011,12,28,16,1822,1829,3651,3563
0130-001,2011,12,28,17,1696,1785,3481,3651
0130-001,2011,12,28,18,1600,2058,3658,3481
0130-001,2011,12,28,19,1708,2154,3862,3658
0130-001,2011,12,28,20,1239,1594,2833,3862
0130-001,2011,12,28,21,1135,1311,2446,2833
0130-001,2011,12,28,22,1141,1073,2214,2446
0130-001,2011,12,28,23,918,691,1609,2214
0130-001,2011,12,28,24,643,519,1162,1609
0130-001,2011,12,29,1,470,357,827,1162
0130-001,2011,12,29,2,342,271,613,827
0130-001,2011,12,29,3,209,196,405,613
0130-001,2011,12,29,4,161,183,344,405
0130-001,2011,12,29,5,170,230,400,344
0130-001,2011,12,29,6,255,298,553,400
0130-001,2011,12,29,7,826,562,1388,553
0130-001,2011,12,29,8,2067,1402,3469,1388
0130-001,2011,12,29,9,2088,1937,4025,3469
0130-001,2011,12,29,10,1566,1604,3170,4025
0130-001,2011,12,29,11,1651,1601,3252,3170
0130-001,2011,12,29,12,1525,1670,3195,3252
0130-001,2011,12,29,13,1435,1469,2904,3195
0130-001,2011,12,29,14,1704,1653,3357,2904
0130-001,2011,12,29,15,1788,1817,3605,3357
0130-001,2011,12,29,16,1811,1735,3546,3605
0130-001,2011,12,29,17,1672,1765,3437,3546
0130-001,2011,12,29,18,1719,2182,3901,3437
0130-001,2011,12,29,19,1517,2284,3801,3901
0130-001,2011,12,29,20,1265,1586,2851,3801
0130-001,2011,12,29,21,1205,1289,2494,2851
0130-001,2011,12,29,22,1119,1105,2224,2494
0130-001,2011,12,29,23,933,756,1689,2224
0130-001,2011,12,29,24,729,590,1319,1689
0130-001,2011,12,30,1,485,416,901,1319
0130-001,2011,12,30,2,350,296,646,901
0130-001,2011,12,30,3,275,251,526,646
0130-001,2011,12,30,4,203,194,397,526
0130-001,2011,12,30,5,181,223,404,397
0130-001,2011,12,30,6,276,331,607,404
0130-001,2011,12,30,7,772,547,1319,607
0130-001,2011,12,30,8,2108,1313,3421,1319
0130-001,2011,12,30,9,1841,1839,3680,3421
0130-001,2011,12,30,10,1546,1541,3087,3680
0130-001,2011,12,30,11,1625,1607,3232,3087
0130-001,2011,12,30,12,1607,1708,3315,3232
0130-001,2011,12,30,13,1485,1607,3092,3315
0130-001,2011,12,30,14,1646,1822,3468,3092
0130-001,2011,12,30,15,1847,2014,3861,3468
0130-001,2011,12,30,16,1879,2040,3919,3861
0130-001,2011,12,30,17,1824,2192,4016,3919
0130-001,2011,12,30,18,1839,2300,4139,4016
0130-001,2011,12,30,19,1718,2083,3801,4139
0130-001,2011,12,30,20,1373,1569,2942,3801
0130-001,2011,12,30,21,1205,1229,2434,2942
0130-001,2011,12,30,22,1089,1070,2159,2434
0130-001,2011,12,30,23,963,749,1712,2159
0130-001,2011,12,30,24,698,561,1259,1712
0130-001,2011,12,31,1,562,474,1036,1259
0130-001,2011,12,31,2,399,347,746,1036
0130-001,2011,12,31,3,322,280,602,746
0130-001,2011,12,31,4,239,224,463,602
0130-001,2011,12,31,5,222,246,468,463
0130-001,2011,12,31,6,252,307,559,468
0130-001,2011,12,31,7,485,397,882,559
0130-001,2011,12,31,8,818,729,1547,882
0130-001,2011,12,31,9,1029,1073,2102,1547
0130-001,2011,12,31,10,1141,1287,2428,2102
0130-001,2011,12,31,11,1379,1531,2910,2428
0130-001,2011,12,31,12,1481,1759,3240,2910
0130-001,2011,12,31,13,1508,1831,3339,3240
0130-001,2011,12,31,14,1574,1954,3528,3339
0130-001,2011,12,31,15,1627,1934,3561,3528
0130-001,2011,12,31,16,1659,1897,3556,3561
0130-001,2011,12,31,17,1898,1807,3705,3556
0130-001,2011,12,31,18,1845,1682,3527,3705
0130-001,2011,12,31,19,1409,1491,2900,3527
0130-001,2011,12,31,20,1116,1013,2129,2900
0130-001,2011,12,31,21,947,798,1745,2129
0130-001,2011,12,31,22,893,785,1678,1745
0130-001,2011,12,31,23,685,607,1292,1678
0130-001,2011,12,31,24,532,412,944,1292
0130-001,2012,1,1,1,418,362,780,944
0130-001,2012,1,1,2,373,349,722,780
0130-001,2012,1,1,3,248,230,478,722
0130-001,2012,1,1,4,173,176,349,478
0130-001,2012,1,1,5,169,172,341,349
0130-001,2012,1,1,6,191,237,428,341
0130-001,2012,1,1,7,309,241,550,428
0130-001,2012,1,1,8,347,313,660,550
0130-001,2012,1,1,9,470,497,967,660
0130-001,2012,1,1,10,596,641,1237,967
0130-001,2012,1,1,11,891,851,1742,1237
0130-001,2012,1,1,12,884,984,1868,1742
0130-001,2012,1,1,13,1078,1064,2142,1868
0130-001,2012,1,1,14,1455,1240,2695,2142
0130-001,2012,1,1,15,1670,1424,3094,2695
0130-001,2012,1,1,16,1748,1259,3007,3094
0130-001,2012,1,1,17,1638,1339,2977,3007
0130-001,2012,1,1,18,1760,1307,3067,2977
0130-001,2012,1,1,19,1669,1068,2737,3067
0130-001,2012,1,1,20,1305,861,2166,2737
0130-001,2012,1,1,21,1383,729,2112,2166
0130-001,2012,1,1,22,922,584,1506,2112
0130-001,2012,1,1,23,544,395,939,1506
0130-001,2012,1,1,24,365,268,633,939
0130-001,2012,1,2,1,253,214,467,633
0130-001,2012,1,2,2,173,143,316,467
0130-001,2012,1,2,3,123,107,230,316
0130-001,2012,1,2,4,94,80,174,230
0130-001,2012,1,2,5,114,131,245,174
0130-001,2012,1,2,6,200,282,482,245
0130-001,2012,1,2,7,862,543,1405,482
0130-001,2012,1,2,8,2100,1333,3433,1405
0130-001,2012,1,2,9,1757,1756,3513,3433
0130-001,2012,1,2,10,1363,1383,2746,3513
0130-001,2012,1,2,11,1474,1378,2852,2746
0130-001,2012,1,2,12,1392,1467,2859,2852
0130-001,2012,1,2,13,1281,1427,2708,2859
0130-001,2012,1,2,14,1618,1593,3211,2708
0130-001,2012,1,2,15,1578,1693,3271,3211
0130-001,2012,1,2,16,1687,1673,3360,3271
0130-001,2012,1,2,17,1659,1676,3335,3360
0130-001,2012,1,2,18,1584,1886,3470,3335
0130-001,2012,1,2,19,1586,2118,3704,3470
0130-001,2012,1,2,20,1303,1394,2697,3704
0130-001,2012,1,2,21,1137,1241,2378,2697
0130-001,2012,1,2,22,960,963,1923,2378
0130-001,2012,1,2,23,693,573,1266,1923
0130-001,2012,1,2,24,524,394,918,1266
0130-001,2012,1,3,1,300,250,550,918
0130-001,2012,1,3,2,223,193,416,550
0130-001,2012,1,3,3,164,158,322,416
0130-001,2012,1,3,4,147,148,295,322
0130-001,2012,1,3,5,131,214,345,295
0130-001,2012,1,3,6,238,317,555,345
0130-001,2012,1,3,7,858,573,1431,555
0130-001,2012,1,3,8,2232,1375,3607,1431
0130-001,2012,1,3,9,2047,1878,3925,3607
0130-001,2012,1,3,10,1539,1539,3078,3925
0130-001,2012,1,3,11,1569,1517,3086,3078
0130-001,2012,1,3,12,1525,1538,3063,3086
0130-001,2012,1,3,13,1336,1397,2733,3063
0130-001,2012,1,3,14,1480,1569,3049,2733
0130-001,2012,1,3,15,1718,1670,3388,3049
0130-001,2012,1,3,16,1687,1706,3393,3388
0130-001,2012,1,3,17,1528,1638,3166,3393
0130-001,2012,1,3,18,1544,1884,3428,3166
0130-001,2012,1,3,19,1567,2096,3663,3428
0130-001,2012,1,3,20,1229,1509,2738,3663
0130-001,2012,1,3,21,1110,1371,2481,2738
0130-001,2012,1,3,22,958,991,1949,2481
0130-001,2012,1,3,23,748,624,1372,1949
0130-001,2012,1,3,24,499,440,939,1372
0130-001,2012,1,4,1,323,284,607,939
0130-001,2012,1,4,2,217,192,409,607
0130-001,2012,1,4,3,174,132,306,409
0130-001,2012,1,4,4,130,135,265,306
0130-001,2012,1,4,5,150,194,344,265
0130-001,2012,1,4,6,214,300,514,344
0130-001,2012,1,4,7,821,541,1362,514
0130-001,2012,1,4,8,2189,1341,3530,1362
0130-001,2012,1,4,9,1893,1837,3730,3530
0130-001,2012,1,4,10,1504,1436,2940,3730
0130-001,2012,1,4,11,1497,1372,2869,2940
0130-001,2012,1,4,12,1482,1470,2952,2869
0130-001,2012,1,4,13,1263,1312,2575,2952
0130-001,2012,1,4,14,1550,1572,3122,2575
0130-001,2012,1,4,15,1612,1705,3317,3122
0130-001,2012,1,4,16,1624,1639,3263,3317
0130-001,2012,1,4,17,1597,1568,3165,3263
0130-001,2012,1,4,18,1598,1946,3544,3165
0130-001,2012,1,4,19,1630,2250,3880,3544
0130-001,2012,1,4,20,1227,1617,2844,3880
0130-001,2012,1,4,21,1100,1249,2349,2844
0130-001,2012,1,4,22,1010,1035,2045,2349
0130-001,2012,1,4,23,847,674,1521,2045
0130-001,2012,1,4,24,524,479,1003,1521
0130-001,2012,1,5,1,324,316,640,1003
0130-001,2012,1,5,2,229,207,436,640
0130-001,2012,1,5,3,167,150,317,436
0130-001,2012,1,5,4,149,170,319,317
0130-001,2012,1,5,5,147,195,342,319
0130-001,2012,1,5,6,231,304,535,342
0130-001,2012,1,5,7,893,598,1491,535
0130-001,2012,1,5,8,2210,1390,3600,1491
0130-001,2012,1,5,9,2041,1863,3904,3600
0130-001,2012,1,5,10,1517,1578,3095,3904
0130-001,2012,1,5,11,1462,1462,2924,3095
0130-001,2012,1,5,12,1499,1456,2955,2924
0130-001,2012,1,5,13,1325,1330,2655,2955
0130-001,2012,1,5,14,1622,1677,3299,2655
0130-001,2012,1,5,15,1670,1663,3333,3299
0130-001,2012,1,5,16,1729,1550,3279,3333
0130-001,2012,1,5,17,1560,1701,3261,3279
0130-001,2012,1,5,18,1655,2006,3661,3261
0130-001,2012,1,5,19,1638,2214,3852,3661
0130-001,2012,1,5,20,1298,1630,2928,3852
0130-001,2012,1,5,21,1114,1393,2507,2928
0130-001,2012,1,5,22,1129,1122,2251,2507
0130-001,2012,1,5,23,815,731,1546,2251
0130-001,2012,1,5,24,554,453,1007,1546
0130-001,2012,1,6,1,359,311,670,1007
0130-001,2012,1,6,2,260,237,497,670
0130-001,2012,1,6,3,194,167,361,497
0130-001,2012,1,6,4,169,171,340,361
0130-001,2012,1,6,5,143,216,359,340
0130-001,2012,1,6,6,257,302,559,359
0130-001,2012,1,6,7,846,589,1435,559
0130-001,2012,1,6,8,2128,1354,3482,1435
0130-001,2012,1,6,9,2152,1918,4070,3482
0130-001,2012,1,6,10,1593,1649,3242,4070
0130-001,2012,1,6,11,1601,1619,3220,3242
0130-001,2012,1,6,12,1601,1593,3194,3220
0130-001,2012,1,6,13,1496,1469,2965,3194
0130-001,2012,1,6,14,1656,1719,3375,2965
0130-001,2012,1,6,15,1705,1744,3449,3375
0130-001,2012,1,6,16,1805,1720,3525,3449
0130-001,2012,1,6,17,1719,1776,3495,3525
0130-001,2012,1,6,18,1806,2138,3944,3495
0130-001,2012,1,6,19,1724,2181,3905,3944
0130-001,2012,1,6,20,1539,1884,3423,3905
0130-001,2012,1,6,21,1186,1524,2710,3423
0130-001,2012,1,6,22,1149,1105,2254,2710
0130-001,2012,1,6,23,924,742,1666,2254
0130-001,2012,1,6,24,654,605,1259,1666
0130-001,2012,1,7,1,433,396,829,1259
0130-001,2012,1,7,2,355,280,635,829
0130-001,2012,1,7,3,242,242,484,635
0130-001,2012,1,7,4,177,189,366,484
0130-001,2012,1,7,5,189,202,391,366
0130-001,2012,1,7,6,277,362,639,391
0130-001,2012,1,7,7,615,450,1065,639
0130-001,2012,1,7,8,1162,913,2075,1065
0130-001,2012,1,7,9,1306,1354,2660,2075
0130-001,2012,1,7,10,1374,1484,2858,2660
0130-001,2012,1,7,11,1453,1657,3110,2858
0130-001,2012,1,7,12,1526,1900,3426,3110
0130-001,2012,1,7,13,1490,1898,3388,3426
0130-001,2012,1,7,14,1588,1895,3483,3388
0130-001,2012,1,7,15,1730,1968,3698,3483
0130-001,2012,1,7,16,1705,2046,3751,3698
0130-001,2012,1,7,17,1882,2016,3898,3751
0130-001,2012,1,7,18,1974,2039,4013,3898
0130-001,2012,1,7,19,1708,1978,3686,4013
0130-001,2012,1,7,20,1271,1379,2650,3686
0130-001,2012,1,7,21,1156,932,2088,2650
0130-001,2012,1,7,22,1025,837,1862,2088
0130-001,2012,1,7,23,798,586,1384,1862
0130-001,2012,1,7,24,559,395,954,1384
0130-001,2012,1,8,1,403,324,727,954
0130-001,2012,1,8,2,286,251,537,727
0130-001,2012,1,8,3,222,194,416,537
0130-001,2012,1,8,4,178,156,334,416
0130-001,2012,1,8,5,155,144,299,334
0130-001,2012,1,8,6,188,244,432,299
0130-001,2012,1,8,7,340,327,667,432
0130-001,2012,1,8,8,481,416,897,667
0130-001,2012,1,8,9,652,771,1423,897
0130-001,2012,1,8,10,783,860,1643,1423
0130-001,2012,1,8,11,911,1177,2088,1643
0130-001,2012,1,8,12,960,1211,2171,2088
0130-001,2012,1,8,13,1104,1354,2458,2171
0130-001,2012,1,8,14,1268,1438,2706,2458
0130-001,2012,1,8,15,1410,1424,2834,2706
0130-001,2012,1,8,16,1695,1362,3057,2834
0130-001,2012,1,8,17,1875,1379,3254,3057
0130-001,2012,1,8,18,1886,1391,3277,3254
0130-001,2012,1,8,19,1361,1019,2380,3277
0130-001,2012,1,8,20,1044,846,1890,2380
0130-001,2012,1,8,21,1012,814,1826,1890
0130-001,2012,1,8,22,925,692,1617,1826
0130-001,2012,1,8,23,643,456,1099,1617
0130-001,2012,1,8,24,442,320,762,1099
0130-001,2012,1,9,1,271,204,475,762
0130-001,2012,1,9,2,184,164,348,475
0130-001,2012,1,9,3,123,102,225,348
0130-001,2012,1,9,4,102,131,233,225
0130-001,2012,1,9,5,110,175,285,233
0130-001,2012,1,9,6,253,345,598,285
0130-001,2012,1,9,7,1059,630,1689,598
0130-001,2012,1,9,8,2264,1501,3765,1689
0130-001,2012,1,9,9,2189,1974,4163,3765
0130-001,2012,1,9,10,1617,1528,3145,4163
0130-001,2012,1,9,11,1611,1592,3203,3145
0130-001,2012,1,9,12,1588,1579,3167,3203
0130-001,2012,1,9,13,1401,1431,2832,3167
0130-001,2012,1,9,14,1837,1674,3511,2832
0130-001,2012,1,9,15,1710,1710,3420,3511
0130-001,2012,1,9,16,1749,1672,3421,3420
0130-001,2012,1,9,17,1664,1916,3580,3421
0130-001,2012,1,9,18,1619,1956,3575,3580
0130-001,2012,1,9,19,1700,2132,3832,3575
0130-001,2012,1,9,20,1347,1589,2936,3832
0130-001,2012,1,9,21,1083,1463,2546,2936
0130-001,2012,1,9,22,1000,1165,2165,2546
0130-001,2012,1,9,23,697,656,1353,2165
0130-001,2012,1,9,24,513,466,979,1353
0130-001,2012,1,10,1,368,295,663,979
0130-001,2012,1,10,2,253,224,477,663
0130-001,2012,1,10,3,155,136,291,477
0130-001,2012,1,10,4,118,126,244,291
0130-001,2012,1,10,5,147,197,344,244
0130-001,2012,1,10,6,283,327,610,344
0130-001,2012,1,10,7,878,647,1525,610
0130-001,2012,1,10,8,2164,1341,3505,1525
0130-001,2012,1,10,9,2165,1819,3984,3505
0130-001,2012,1,10,10,1629,1716,3345,3984
0130-001,2012,1,10,11,1671,1518,3189,3345
0130-001,2012,1,10,12,1618,1582,3200,3189
0130-001,2012,1,10,13,1296,1425,2721,3200
0130-001,2012,1,10,14,1667,1676,3343,2721
0130-001,2012,1,10,15,1670,1716,3386,3343
0130-001,2012,1,10,16,1722,1718,3440,3386
0130-001,2012,1,10,17,1614,1741,3355,3440
0130-001,2012,1,10,18,1668,2017,3685,3355
0130-001,2012,1,10,19,1634,2156,3790,3685
0130-001,2012,1,10,20,1321,1655,2976,3790
0130-001,2012,1,10,21,1134,1465,2599,2976
0130-001,2012,1,10,22,1074,1175,2249,2599
0130-001,2012,1,10,23,842,703,1545,2249
0130-001,2012,1,10,24,582,516,1098,1545
0130-001,2012,1,11,1,395,311,706,1098
0130-001,2012,1,11,2,250,235,485,706
0130-001,2012,1,11,3,193,180,373,485
0130-001,2012,1,11,4,148,153,301,373
0130-001,2012,1,11,5,147,209,356,301
0130-001,2012,1,11,6,260,341,601,356
0130-001,2012,1,11,7,868,613,1481,601
0130-001,2012,1,11,8,2218,1388,3606,1481
0130-001,2012,1,11,9,2025,1884,3909,3606
0130-001,2012,1,11,10,1580,1595,3175,3909
0130-001,2012,1,11,11,1673,1624,3297,3175
0130-001,2012,1,11,12,1612,1576,3188,3297
0130-001,2012,1,11,13,1380,1475,2855,3188
0130-001,2012,1,11,14,1667,1561,3228,2855
0130-001,2012,1,11,15,1762,1731,3493,3228
0130-001,2012,1,11,16,1716,1703,3419,3493
0130-001,2012,1,11,17,1582,1807,3389,3419
0130-001,2012,1,11,18,1570,2052,3622,3389
0130-001,2012,1,11,19,1348,2136,3484,3622
0130-001,2012,1,11,20,1552,1668,3220,3484
0130-001,2012,1,11,21,1154,1362,2516,3220
0130-001,2012,1,11,22,1050,1096,2146,2516
0130-001,2012,1,11,23,816,708,1524,2146
0130-001,2012,1,11,24,576,499,1075,1524
0130-001,2012,1,12,1,397,341,738,1075
0130-001,2012,1,12,2,270,240,510,738
0130-001,2012,1,12,3,171,148,319,510
0130-001,2012,1,12,4,149,151,300,319
0130-001,2012,1,12,5,155,185,340,300
0130-001,2012,1,12,6,217,335,552,340
0130-001,2012,1,12,7,870,609,1479,552
0130-001,2012,1,12,8,2167,1390,3557,1479
0130-001,2012,1,12,9,2091,1903,3994,3557
0130-001,2012,1,12,10,1686,1575,3261,3994
0130-001,2012,1,12,11,1609,1492,3101,3261
0130-001,2012,1,12,12,1600,1556,3156,3101
0130-001,2012,1,12,13,1413,1416,2829,3156
0130-001,2012,1,12,14,1646,1678,3324,2829
0130-001,2012,1,12,15,1726,1701,3427,3324
0130-001,2012,1,12,16,1730,1768,3498,3427
0130-001,2012,1,12,17,1595,1751,3346,3498
0130-001,2012,1,12,18,1595,1962,3557,3346
0130-001,2012,1,12,19,1666,2171,3837,3557
0130-001,2012,1,12,20,1274,1595,2869,3837
0130-001,2012,1,12,21,1147,1410,2557,2869
0130-001,2012,1,12,22,1065,1157,2222,2557
0130-001,2012,1,12,23,828,715,1543,2222
0130-001,2012,1,12,24,602,523,1125,1543
0130-001,2012,1,13,1,392,355,747,1125
0130-001,2012,1,13,2,301,263,564,747
0130-001,2012,1,13,3,217,180,397,564
0130-001,2012,1,13,4,143,178,321,397
0130-001,2012,1,13,5,150,206,356,321
0130-001,2012,1,13,6,262,311,573,356
0130-001,2012,1,13,7,876,611,1487,573
0130-001,2012,1,13,8,2180,1417,3597,1487
0130-001,2012,1,13,9,2155,1864,4019,3597
0130-001,2012,1,13,10,1552,1677,3229,4019
0130-001,2012,1,13,11,1695,1609,3304,3229
0130-001,2012,1,13,12,1595,1655,3250,3304
0130-001,2012,1,13,13,1414,1557,2971,3250
0130-001,2012,1,13,14,1746,1841,3587,2971
0130-001,2012,1,13,15,1799,1727,3526,3587
0130-001,2012,1,13,16,1774,1842,3616,3526
0130-001,2012,1,13,17,1812,1804,3616,3616
0130-001,2012,1,13,18,1781,2170,3951,3616
0130-001,2012,1,13,19,1859,2239,4098,3951
0130-001,2012,1,13,20,1551,1875,3426,4098
0130-001,2012,1,13,21,1232,1551,2783,3426
0130-001,2012,1,13,22,1164,1094,2258,2783
0130-001,2012,1,13,23,922,799,1721,2258
0130-001,2012,1,13,24,644,570,1214,1721
0130-001,2012,1,14,1,484,436,920,1214
0130-001,2012,1,14,2,315,308,623,920
0130-001,2012,1,14,3,242,237,479,623
0130-001,2012,1,14,4,203,198,401,479
0130-001,2012,1,14,5,198,236,434,401
0130-001,2012,1,14,6,268,359,627,434
0130-001,2012,1,14,7,624,493,1117,627
0130-001,2012,1,14,8,1159,864,2023,1117
0130-001,2012,1,14,9,1346,1436,2782,2023
0130-001,2012,1,14,10,1379,1582,2961,2782
0130-001,2012,1,14,11,1588,1750,3338,2961
0130-001,2012,1,14,12,1485,1858,3343,3338
0130-001,2012,1,14,13,1567,1880,3447,3343
0130-001,2012,1,14,14,1636,1923,3559,3447
0130-001,2012,1,14,15,1685,2027,3712,3559
0130-001,2012,1,14,16,1683,1795,3478,3712
0130-001,2012,1,14,17,1956,1758,3714,3478
0130-001,2012,1,14,18,1891,1888,3779,3714
0130-001,2012,1,14,19,1852,1754,3606,3779
0130-001,2012,1,14,20,1275,1220,2495,3606
0130-001,2012,1,14,21,1163,949,2112,2495
0130-001,2012,1,14,22,1081,816,1897,2112
0130-001,2012,1,14,23,828,597,1425,1897
0130-001,2012,1,14,24,600,461,1061,1425
0130-001,2012,1,15,1,415,331,746,1061
0130-001,2012,1,15,2,284,243,527,746
0130-001,2012,1,15,3,248,189,437,527
0130-001,2012,1,15,4,183,170,353,437
0130-001,2012,1,15,5,165,158,323,353
0130-001,2012,1,15,6,216,229,445,323
0130-001,2012,1,15,7,428,361,789,445
0130-001,2012,1,15,8,561,544,1105,789
0130-001,2012,1,15,9,689,829,1518,1105
0130-001,2012,1,15,10,822,948,1770,1518
0130-001,2012,1,15,11,1029,1177,2206,1770
0130-001,2012,1,15,12,1012,1225,2237,2206
0130-001,2012,1,15,13,1114,1372,2486,2237
0130-001,2012,1,15,14,1292,1392,2684,2486
0130-001,2012,1,15,15,1535,1406,2941,2684
0130-001,2012,1,15,16,1591,1486,3077,2941
0130-001,2012,1,15,17,1720,1425,3145,3077
0130-001,2012,1,15,18,1579,1478,3057,3145
0130-001,2012,1,15,19,1413,1112,2525,3057
0130-001,2012,1,15,20,1065,964,2029,2525
0130-001,2012,1,15,21,978,838,1816,2029
0130-001,2012,1,15,22,943,686,1629,1816
0130-001,2012,1,15,23,674,499,1173,1629
0130-001,2012,1,15,24,423,339,762,1173
0130-001,2012,1,16,1,261,228,489,762
0130-001,2012,1,16,2,184,145,329,489
0130-001,2012,1,16,3,135,121,256,329
0130-001,2012,1,16,4,126,121,247,256
0130-001,2012,1,16,5,132,221,353,247
0130-001,2012,1,16,6,272,333,605,353
0130-001,2012,1,16,7,1004,700,1704,605
0130-001,2012,1,16,8,2276,1447,3723,1704
0130-001,2012,1,16,9,2209,1967,4176,3723
0130-001,2012,1,16,10,1659,1630,3289,4176
0130-001,2012,1,16,11,1662,1589,3251,3289
0130-001,2012,1,16,12,1670,1639,3309,3251
0130-001,2012,1,16,13,1470,1470,2940,3309
0130-001,2012,1,16,14,1656,1734,3390,2940
0130-001,2012,1,16,15,1851,1827,3678,3390
0130-001,2012,1,16,16,1716,1863,3579,3678
0130-001,2012,1,16,17,1654,1731,3385,3579
0130-001,2012,1,16,18,1700,2124,3824,3385
0130-001,2012,1,16,19,1766,2234,4000,3824
0130-001,2012,1,16,20,1321,1666,2987,4000
0130-001,2012,1,16,21,1216,1487,2703,2987
0130-001,2012,1,16,22,1051,1158,2209,2703
0130-001,2012,1,16,23,810,678,1488,2209
0130-001,2012,1,16,24,543,499,1042,1488
0130-001,2012,1,17,1,377,314,691,1042
0130-001,2012,1,17,2,239,206,445,691
0130-001,2012,1,17,3,174,157,331,445
0130-001,2012,1,17,4,132,176,308,331
0130-001,2012,1,17,5,156,235,391,308
0130-001,2012,1,17,6,279,340,619,391
0130-001,2012,1,17,7,946,661,1607,619
0130-001,2012,1,17,8,2188,1457,3645,1607
0130-001,2012,1,17,9,2253,1907,4160,3645
0130-001,2012,1,17,10,1732,1798,3530,4160
0130-001,2012,1,17,11,1773,1659,3432,3530
0130-001,2012,1,17,12,1673,1594,3267,3432
0130-001,2012,1,17,13,1473,1461,2934,3267
0130-001,2012,1,17,14,1727,1701,3428,2934
0130-001,2012,1,17,15,1854,1912,3766,3428
0130-001,2012,1,17,16,1735,1944,3679,3766
0130-001,2012,1,17,17,1741,1901,3642,3679
0130-001,2012,1,17,18,1687,2062,3749,3642
0130-001,2012,1,17,19,1686,2284,3970,3749
0130-001,2012,1,17,20,1309,1655,2964,3970
0130-001,2012,1,17,21,1268,1422,2690,2964
0130-001,2012,1,17,22,1123,1259,2382,2690
0130-001,2012,1,17,23,834,751,1585,2382
0130-001,2012,1,17,24,596,485,1081,1585
0130-001,2012,1,18,1,375,339,714,1081
0130-001,2012,1,18,2,228,232,460,714
0130-001,2012,1,18,3,188,166,354,460
0130-001,2012,1,18,4,156,154,310,354
0130-001,2012,1,18,5,163,223,386,310
0130-001,2012,1,18,6,253,325,578,386
0130-001,2012,1,18,7,906,620,1526,578
0130-001,2012,1,18,8,2195,1488,3683,1526
0130-001,2012,1,18,9,2167,1901,4068,3683
0130-001,2012,1,18,10,1680,1659,3339,4068
0130-001,2012,1,18,11,1700,1674,3374,3339
0130-001,2012,1,18,12,1687,1634,3321,3374
0130-001,2012,1,18,13,1584,1539,3123,3321
0130-001,2012,1,18,14,1719,1751,3470,3123
0130-001,2012,1,18,15,1897,1838,3735,3470
0130-001,2012,1,18,16,1965,1844,3809,3735
0130-001,2012,1,18,17,1790,1911,3701,3809
0130-001,2012,1,18,18,1633,2154,3787,3701
0130-001,2012,1,18,19,1737,2327,4064,3787
0130-001,2012,1,18,20,1402,1769,3171,4064
0130-001,2012,1,18,21,1279,1417,2696,3171
0130-001,2012,1,18,22,1176,1159,2335,2696
0130-001,2012,1,18,23,880,728,1608,2335
0130-001,2012,1,18,24,617,506,1123,1608
0130-001,2012,1,19,1,398,365,763,1123
0130-001,2012,1,19,2,260,249,509,763
0130-001,2012,1,19,3,207,190,397,509
0130-001,2012,1,19,4,181,172,353,397
0130-001,2012,1,19,5,163,221,384,353
0130-001,2012,1,19,6,290,346,636,384
0130-001,2012,1,19,7,859,658,1517,636
0130-001,2012,1,19,8,2050,1357,3407,1517
0130-001,2012,1,19,9,2074,1877,3951,3407
0130-001,2012,1,19,10,1850,1725,3575,3951
0130-001,2012,1,19,11,1788,1730,3518,3575
0130-001,2012,1,19,12,1654,1682,3336,3518
0130-001,2012,1,19,13,1563,1506,3069,3336
0130-001,2012,1,19,14,1736,1794,3530,3069
0130-001,2012,1,19,15,1685,1823,3508,3530
0130-001,2012,1,19,16,1965,1733,3698,3508
0130-001,2012,1,19,17,1702,1924,3626,3698
0130-001,2012,1,19,18,1742,2043,3785,3626
0130-001,2012,1,19,19,1717,2149,3866,3785
0130-001,2012,1,19,20,1366,1857,3223,3866
0130-001,2012,1,19,21,1254,1454,2708,3223
0130-001,2012,1,19,22,1159,1249,2408,2708
0130-001,2012,1,19,23,903,773,1676,2408
0130-001,2012,1,19,24,637,514,1151,1676
0130-001,2012,1,20,1,448,392,840,1151
0130-001,2012,1,20,2,278,235,513,840
0130-001,2012,1,20,3,248,198,446,513
0130-001,2012,1,20,4,201,183,384,446
0130-001,2012,1,20,5,181,240,421,384
0130-001,2012,1,20,6,265,333,598,421
0130-001,2012,1,20,7,879,557,1436,598
0130-001,2012,1,20,8,2147,1367,3514,1436
0130-001,2012,1,20,9,2178,1890,4068,3514
0130-001,2012,1,20,10,1661,1761,3422,4068
0130-001,2012,1,20,11,1823,1971,3794,3422
0130-001,2012,1,20,12,1765,1834,3599,3794
0130-001,2012,1,20,13,1608,1738,3346,3599
0130-001,2012,1,20,14,1863,1987,3850,3346
0130-001,2012,1,20,15,1890,2110,4000,3850
0130-001,2012,1,20,16,1880,2299,4179,4000
0130-001,2012,1,20,17,1713,2436,4149,4179
0130-001,2012,1,20,18,1766,2415,4181,4149
0130-001,2012,1,20,19,1641,2348,3989,4181
0130-001,2012,1,20,20,1367,2239,3606,3989
0130-001,2012,1,20,21,1165,1908,3073,3606
0130-001,2012,1,20,22,1067,1715,2782,3073
0130-001,2012,1,20,23,926,972,1898,2782
0130-001,2012,1,20,24,597,639,1236,1898
0130-001,2012,1,21,1,457,403,860,1236
0130-001,2012,1,21,2,313,296,609,860
0130-001,2012,1,21,3,274,250,524,609
0130-001,2012,1,21,4,195,220,415,524
0130-001,2012,1,21,5,225,300,525,415
0130-001,2012,1,21,6,255,443,698,525
0130-001,2012,1,21,7,489,791,1280,698
0130-001,2012,1,21,8,719,1416,2135,1280
0130-001,2012,1,21,9,997,1869,2866,2135
0130-001,2012,1,21,10,1094,2005,3099,2866
0130-001,2012,1,21,11,1309,2181,3490,3099
0130-001,2012,1,21,12,1388,2206,3594,3490
0130-001,2012,1,21,13,1433,2178,3611,3594
0130-001,2012,1,21,14,1497,2169,3666,3611
0130-001,2012,1,21,15,1508,2221,3729,3666
0130-001,2012,1,21,16,1470,2041,3511,3729
0130-001,2012,1,21,17,1439,1993,3432,3511
0130-001,2012,1,21,18,1462,1902,3364,3432
0130-001,2012,1,21,19,1238,1655,2893,3364
0130-001,2012,1,21,20,979,1111,2090,2893
0130-001,2012,1,21,21,829,904,1733,2090
0130-001,2012,1,21,22,814,762,1576,1733
0130-001,2012,1,21,23,615,541,1156,1576
0130-001,2012,1,21,24,436,443,879,1156
0130-001,2012,1,22,1,348,303,651,879
0130-001,2012,1,22,2,217,261,478,651
0130-001,2012,1,22,3,210,200,410,478
0130-001,2012,1,22,4,166,178,344,410
0130-001,2012,1,22,5,165,216,381,344
0130-001,2012,1,22,6,174,328,502,381
0130-001,2012,1,22,7,284,413,697,502
0130-001,2012,1,22,8,326,664,990,697
0130-001,2012,1,22,9,581,1177,1758,990
0130-001,2012,1,22,10,922,1395,2317,1758
0130-001,2012,1,22,11,1156,1467,2623,2317
0130-001,2012,1,22,12,1271,1531,2802,2623
0130-001,2012,1,22,13,1302,1580,2882,2802
0130-001,2012,1,22,14,1191,1500,2691,2882
0130-001,2012,1,22,15,1173,1356,2529,2691
0130-001,2012,1,22,16,1186,1308,2494,2529
0130-001,2012,1,22,17,1042,1248,2290,2494
0130-001,2012,1,22,18,1082,1154,2236,2290
0130-001,2012,1,22,19,960,920,1880,2236
0130-001,2012,1,22,20,704,682,1386,1880
0130-001,2012,1,22,21,722,743,1465,1386
0130-001,2012,1,22,22,596,523,1119,1465
0130-001,2012,1,22,23,474,416,890,1119
0130-001,2012,1,22,24,304,287,591,890
0130-001,2012,1,23,1,240,187,427,591
0130-001,2012,1,23,2,133,119,252,427
0130-001,2012,1,23,3,117,85,202,252
0130-001,2012,1,23,4,91,65,156,202
0130-001,2012,1,23,5,59,86,145,156
0130-001,2012,1,23,6,141,167,308,145
0130-001,2012,1,23,7,416,306,722,308
0130-001,2012,1,23,8,870,613,1483,722
0130-001,2012,1,23,9,807,676,1483,1483
0130-001,2012,1,23,10,581,785,1366,1483
0130-001,2012,1,23,11,1494,1259,2753,1366
0130-001,2012,1,23,12,1727,1695,3422,2753
0130-001,2012,1,23,13,1619,1849,3468,3422
0130-001,2012,1,23,14,2095,2061,4156,3468
0130-001,2012,1,23,15,2023,2147,4170,4156
0130-001,2012,1,23,16,2058,2230,4288,4170
0130-001,2012,1,23,17,2091,2053,4144,4288
0130-001,2012,1,23,18,2241,1929,4170,4144
0130-001,2012,1,23,19,2049,1700,3749,4170
0130-001,2012,1,23,20,1971,1410,3381,3749
0130-001,2012,1,23,21,2041,1081,3122,3381
0130-001,2012,1,23,22,1674,684,2358,3122
0130-001,2012,1,23,23,1991,512,2503,2358
0130-001,2012,1,23,24,1430,351,1781,2503
0130-001,2012,1,24,1,1449,218,1667,1781
0130-001,2012,1,24,2,1185,167,1352,1667
0130-001,2012,1,24,3,720,107,827,1352
0130-001,2012,1,24,4,416,89,505,827
0130-001,2012,1,24,5,245,89,334,505
0130-001,2012,1,24,6,205,137,342,334
0130-001,2012,1,24,7,285,147,432,342
0130-001,2012,1,24,8,342,234,576,432
0130-001,2012,1,24,9,834,370,1204,576
0130-001,2012,1,24,10,1032,502,1534,1204
0130-001,2012,1,24,11,1634,752,2386,1534
0130-001,2012,1,24,12,1747,1041,2788,2386
0130-001,2012,1,24,13,1900,1094,2994,2788
0130-001,2012,1,24,14,2144,1400,3544,2994
0130-001,2012,1,24,15,2156,1722,3878,3544
0130-001,2012,1,24,16,2070,1614,3684,3878
0130-001,2012,1,24,17,1866,1248,3114,3684
0130-001,2012,1,24,18,1716,1171,2887,3114
0130-001,2012,1,24,19,2119,969,3088,2887
0130-001,2012,1,24,20,1887,810,2697,3088
0130-001,2012,1,24,21,1906,811,2717,2697
0130-001,2012,1,24,22,1422,587,2009,2717
0130-001,2012,1,24,23,1622,444,2066,2009
0130-001,2012,1,24,24,1156,314,1470,2066
0130-001,2012,1,25,1,684,198,882,1470
0130-001,2012,1,25,2,340,137,477,882
0130-001,2012,1,25,3,168,109,277,477
0130-001,2012,1,25,4,132,92,224,277
0130-001,2012,1,25,5,110,115,225,224
0130-001,2012,1,25,6,192,222,414,225
0130-001,2012,1,25,7,603,426,1029,414
0130-001,2012,1,25,8,1431,956,2387,1029
0130-001,2012,1,25,9,1543,1429,2972,2387
0130-001,2012,1,25,10,1175,1177,2352,2972
0130-001,2012,1,25,11,1335,1362,2697,2352
0130-001,2012,1,25,12,1426,1364,2790,2697
0130-001,2012,1,25,13,1702,1371,3073,2790
0130-001,2012,1,25,14,1848,1512,3360,3073
0130-001,2012,1,25,15,1733,1517,3250,3360
0130-001,2012,1,25,16,2028,1538,3566,3250
0130-001,2012,1,25,17,1749,1436,3185,3566
0130-001,2012,1,25,18,2026,1702,3728,3185
0130-001,2012,1,25,19,1999,1862,3861,3728
0130-001,2012,1,25,20,1931,1285,3216,3861
0130-001,2012,1,25,21,1178,1044,2222,3216
0130-001,2012,1,25,22,1002,843,1845,2222
0130-001,2012,1,25,23,683,534,1217,1845
0130-001,2012,1,25,24,481,407,888,1217
0130-001,2012,1,26,1,312,252,564,888
0130-001,2012,1,26,2,215,193,408,564
0130-001,2012,1,26,3,143,143,286,408
0130-001,2012,1,26,4,136,134,270,286
0130-001,2012,1,26,5,148,166,314,270
0130-001,2012,1,26,6,277,304,581,314
0130-001,2012,1,26,7,912,593,1505,581
0130-001,2012,1,26,8,2204,1364,3568,1505
0130-001,2012,1,26,9,1909,1841,3750,3568
0130-001,2012,1,26,10,1626,1593,3219,3750
0130-001,2012,1,26,11,1603,1572,3175,3219
0130-001,2012,1,26,12,1574,1575,3149,3175
0130-001,2012,1,26,13,1374,1506,2880,3149
0130-001,2012,1,26,14,1641,1706,3347,2880
0130-001,2012,1,26,15,1803,1754,3557,3347
0130-001,2012,1,26,16,1654,1691,3345,3557
0130-001,2012,1,26,17,1650,1644,3294,3345
0130-001,2012,1,26,18,1565,1953,3518,3294
0130-001,2012,1,26,19,1637,2093,3730,3518
0130-001,2012,1,26,20,1239,1582,2821,3730
0130-001,2012,1,26,21,1018,1342,2360,2821
0130-001,2012,1,26,22,954,1052,2006,2360
0130-001,2012,1,26,23,760,635,1395,2006
0130-001,2012,1,26,24,534,431,965,1395
0130-001,2012,1,27,1,342,296,638,965
0130-001,2012,1,27,2,250,230,480,638
0130-001,2012,1,27,3,179,139,318,480
0130-001,2012,1,27,4,139,156,295,318
0130-001,2012,1,27,5,158,207,365,295
0130-001,2012,1,27,6,250,295,545,365
0130-001,2012,1,27,7,873,588,1461,545
0130-001,2012,1,27,8,2102,1333,3435,1461
0130-001,2012,1,27,9,2075,1849,3924,3435
0130-001,2012,1,27,10,1523,1600,3123,3924
0130-001,2012,1,27,11,1682,1578,3260,3123
0130-001,2012,1,27,12,1501,1639,3140,3260
0130-001,2012,1,27,13,1328,1496,2824,3140
0130-001,2012,1,27,14,1693,1654,3347,2824
0130-001,2012,1,27,15,1723,1660,3383,3347
0130-001,2012,1,27,16,1722,1763,3485,3383
0130-001,2012,1,27,17,1607,1628,3235,3485
0130-001,2012,1,27,18,1824,2104,3928,3235
0130-001,2012,1,27,19,1810,2106,3916,3928
0130-001,2012,1,27,20,1385,1888,3273,3916
0130-001,2012,1,27,21,1100,1554,2654,3273
0130-001,2012,1,27,22,1046,1162,2208,2654
0130-001,2012,1,27,23,882,734,1616,2208
0130-001,2012,1,27,24,646,530,1176,1616
0130-001,2012,1,28,1,458,386,844,1176
0130-001,2012,1,28,2,335,275,610,844
0130-001,2012,1,28,3,251,220,471,610
0130-001,2012,1,28,4,204,195,399,471
0130-001,2012,1,28,5,177,227,404,399
0130-001,2012,1,28,6,308,321,629,404
0130-001,2012,1,28,7,616,489,1105,629
0130-001,2012,1,28,8,1207,849,2056,1105
0130-001,2012,1,28,9,1362,1368,2730,2056
0130-001,2012,1,28,10,1449,1540,2989,2730
0130-001,2012,1,28,11,1447,1588,3035,2989
0130-001,2012,1,28,12,1401,1613,3014,3035
0130-001,2012,1,28,13,1446,1767,3213,3014
0130-001,2012,1,28,14,1531,1769,3300,3213
0130-001,2012,1,28,15,1635,1709,3344,3300
0130-001,2012,1,28,16,1598,1638,3236,3344
0130-001,2012,1,28,17,1701,1699,3400,3236
0130-001,2012,1,28,18,2006,1863,3869,3400
0130-001,2012,1,28,19,1650,1554,3204,3869
0130-001,2012,1,28,20,1156,1054,2210,3204
0130-001,2012,1,28,21,987,880,1867,2210
0130-001,2012,1,28,22,889,783,1672,1867
0130-001,2012,1,28,23,717,530,1247,1672
0130-001,2012,1,28,24,541,415,956,1247
0130-001,2012,1,29,1,370,324,694,956
0130-001,2012,1,29,2,262,219,481,694
0130-001,2012,1,29,3,226,173,399,481
0130-001,2012,1,29,4,154,134,288,399
0130-001,2012,1,29,5,158,144,302,288
0130-001,2012,1,29,6,194,243,437,302
0130-001,2012,1,29,7,376,324,700,437
0130-001,2012,1,29,8,521,475,996,700
0130-001,2012,1,29,9,630,792,1422,996
0130-001,2012,1,29,10,828,935,1763,1422
0130-001,2012,1,29,11,920,1102,2022,1763
0130-001,2012,1,29,12,905,1052,1957,2022
0130-001,2012,1,29,13,1110,1269,2379,1957
0130-001,2012,1,29,14,1193,1292,2485,2379
0130-001,2012,1,29,15,1335,1433,2768,2485
0130-001,2012,1,29,16,1423,1392,2815,2768
0130-001,2012,1,29,17,1597,1284,2881,2815
0130-001,2012,1,29,18,1559,1351,2910,2881
0130-001,2012,1,29,19,1347,1014,2361,2910
0130-001,2012,1,29,20,953,763,1716,2361
0130-001,2012,1,29,21,860,788,1648,1716
0130-001,2012,1,29,22,841,615,1456,1648
0130-001,2012,1,29,23,621,431,1052,1456
0130-001,2012,1,29,24,410,323,733,1052
0130-001,2012,1,30,1,262,209,471,733
0130-001,2012,1,30,2,179,154,333,471
0130-001,2012,1,30,3,123,105,228,333
0130-001,2012,1,30,4,98,106,204,228
0130-001,2012,1,30,5,112,153,265,204
0130-001,2012,1,30,6,227,314,541,265
0130-001,2012,1,30,7,961,587,1548,541
0130-001,2012,1,30,8,2182,1417,3599,1548
0130-001,2012,1,30,9,1973,1865,3838,3599
0130-001,2012,1,30,10,1490,1456,2946,3838
0130-001,2012,1,30,11,1543,1485,3028,2946
0130-001,2012,1,30,12,1490,1523,3013,3028
0130-001,2012,1,30,13,1341,1429,2770,3013
0130-001,2012,1,30,14,1728,1634,3362,2770
0130-001,2012,1,30,15,1644,1702,3346,3362
0130-001,2012,1,30,16,1718,1673,3391,3346
0130-001,2012,1,30,17,1662,1796,3458,3391
0130-001,2012,1,30,18,1602,1921,3523,3458
0130-001,2012,1,30,19,1643,2125,3768,3523
0130-001,2012,1,30,20,1325,1492,2817,3768
0130-001,2012,1,30,21,1110,1352,2462,2817
0130-001,2012,1,30,22,980,1064,2044,2462
0130-001,2012,1,30,23,695,615,1310,2044
0130-001,2012,1,30,24,519,430,949,1310
0130-001,2012,1,31,1,334,273,607,949
0130-001,2012,1,31,2,238,209,447,607
0130-001,2012,1,31,3,160,147,307,447
0130-001,2012,1,31,4,133,137,270,307
0130-001,2012,1,31,5,139,206,345,270
0130-001,2012,1,31,6,261,322,583,345
0130-001,2012,1,31,7,868,610,1478,583
0130-001,2012,1,31,8,2198,1358,3556,1478
0130-001,2012,1,31,9,2106,1849,3955,3556
0130-001,2012,1,31,10,1584,1628,3212,3955
0130-001,2012,1,31,11,1620,1518,3138,3212
0130-001,2012,1,31,12,1572,1560,3132,3138
0130-001,2012,1,31,13,1316,1411,2727,3132
0130-001,2012,1,31,14,1574,1623,3197,2727
0130-001,2012,1,31,15,1694,1693,3387,3197
0130-001,2012,1,31,16,1705,1712,3417,3387
0130-001,2012,1,31,17,1571,1690,3261,3417
0130-001,2012,1,31,18,1606,1951,3557,3261
0130-001,2012,1,31,19,1601,2126,3727,3557
0130-001,2012,1,31,20,1275,1582,2857,3727
0130-001,2012,1,31,21,1122,1418,2540,2857
0130-001,2012,1,31,22,1016,1083,2099,2540
0130-001,2012,1,31,23,795,664,1459,2099
0130-001,2012,1,31,24,541,478,1019,1459
0130-001,2012,2,1,1,527,261,788,1019
0130-001,2012,2,1,2,306,183,489,788
0130-001,2012,2,1,3,187,139,326,489
0130-001,2012,2,1,4,147,129,276,326
0130-001,2012,2,1,5,141,166,307,276
0130-001,2012,2,1,6,233,266,499,307
0130-001,2012,2,1,7,740,507,1247,499
0130-001,2012,2,1,8,1713,1140,2853,1247
0130-001,2012,2,1,9,1692,1595,3287,2853
0130-001,2012,2,1,10,1361,1361,2722,3287
0130-001,2012,2,1,11,1453,1410,2863,2722
0130-001,2012,2,1,12,1458,1425,2883,2863
0130-001,2012,2,1,13,1523,1383,2906,2883
0130-001,2012,2,1,14,1717,1562,3279,2906
0130-001,2012,2,1,15,1694,1625,3319,3279
0130-001,2012,2,1,16,1841,1617,3458,3319
0130-001,2012,2,1,17,1691,1548,3239,3458
0130-001,2012,2,1,18,1838,1848,3686,3239
0130-001,2012,2,1,19,1826,2009,3835,3686
0130-001,2012,2,1,20,1605,1451,3056,3835
0130-001,2012,2,1,21,1144,1166,2310,3056
0130-001,2012,2,1,22,1034,956,1990,2310
0130-001,2012,2,1,23,769,611,1380,1990
0130-001,2012,2,1,24,523,448,971,1380
0130-001,2012,2,2,1,331,282,613,971
0130-001,2012,2,2,2,230,201,431,613
0130-001,2012,2,2,3,167,157,324,431
0130-001,2012,2,2,4,144,148,292,324
0130-001,2012,2,2,5,151,187,338,292
0130-001,2012,2,2,6,276,313,589,338
0130-001,2012,2,2,7,969,640,1609,589
0130-001,2012,2,2,8,2228,1461,3689,1609
0130-001,2012,2,2,9,1983,1901,3884,3689
0130-001,2012,2,2,10,1653,1644,3297,3884
0130-001,2012,2,2,11,1612,1571,3183,3297
0130-001,2012,2,2,12,1552,1551,3103,3183
0130-001,2012,2,2,13,1367,1458,2825,3103
0130-001,2012,2,2,14,1655,1694,3349,2825
0130-001,2012,2,2,15,1759,1734,3493,3349
0130-001,2012,2,2,16,1687,1695,3382,3493
0130-001,2012,2,2,17,1635,1701,3336,3382
0130-001,2012,2,2,18,1628,2014,3642,3336
0130-001,2012,2,2,19,1665,2189,3854,3642
0130-001,2012,2,2,20,1288,1626,2914,3854
0130-001,2012,2,2,21,1082,1421,2503,2914
0130-001,2012,2,2,22,1057,1124,2181,2503
0130-001,2012,2,2,23,814,698,1512,2181
0130-001,2012,2,2,24,561,463,1024,1512
0130-001,2012,2,3,1,362,313,675,1024
0130-001,2012,2,3,2,260,238,498,675
0130-001,2012,2,3,3,191,157,348,498
0130-001,2012,2,3,4,154,164,318,348
0130-001,2012,2,3,5,156,218,374,318
0130-001,2012,2,3,6,267,304,571,374
0130-001,2012,2,3,7,899,611,1510,571
0130-001,2012,2,3,8,2143,1430,3573,1510
0130-001,2012,2,3,9,2118,1908,4026,3573
0130-001,2012,2,3,10,1594,1672,3266,4026
0130-001,2012,2,3,11,1696,1629,3325,3266
0130-001,2012,2,3,12,1570,1652,3222,3325
0130-001,2012,2,3,13,1403,1505,2908,3222
0130-001,2012,2,3,14,1674,1676,3350,2908
0130-001,2012,2,3,15,1734,1718,3452,3350
0130-001,2012,2,3,16,1735,1782,3517,3452
0130-001,2012,2,3,17,1654,1739,3393,3517
0130-001,2012,2,3,18,1836,2149,3985,3393
0130-001,2012,2,3,19,1818,2195,4013,3985
0130-001,2012,2,3,20,1454,1906,3360,4013
0130-001,2012,2,3,21,1161,1579,2740,3360
0130-001,2012,2,3,22,1114,1194,2308,2740
0130-001,2012,2,3,23,921,770,1691,2308
0130-001,2012,2,3,24,667,561,1228,1691
0130-001,2012,2,4,1,461,401,862,1228
0130-001,2012,2,4,2,349,286,635,862
0130-001,2012,2,4,3,248,228,476,635
0130-001,2012,2,4,4,201,196,397,476
0130-001,2012,2,4,5,185,232,417,397
0130-001,2012,2,4,6,307,339,646,417
0130-001,2012,2,4,7,659,511,1170,646
0130-001,2012,2,4,8,1242,927,2169,1170
0130-001,2012,2,4,9,1386,1453,2839,2169
0130-001,2012,2,4,10,1480,1617,3097,2839
0130-001,2012,2,4,11,1493,1738,3231,3097
0130-001,2012,2,4,12,1484,1846,3330,3231
0130-001,2012,2,4,13,1491,1926,3417,3330
0130-001,2012,2,4,14,1584,1961,3545,3417
0130-001,2012,2,4,15,1692,1914,3606,3545
0130-001,2012,2,4,16,1678,1862,3540,3606
0130-001,2012,2,4,17,1805,1878,3683,3540
0130-001,2012,2,4,18,1984,1956,3940,3683
0130-001,2012,2,4,19,1751,1775,3526,3940
0130-001,2012,2,4,20,1275,1257,2532,3526
0130-001,2012,2,4,21,1092,951,2043,2532
0130-001,2012,2,4,22,993,842,1835,2043
0130-001,2012,2,4,23,765,579,1344,1835
0130-001,2012,2,4,24,564,421,985,1344
0130-001,2012,2,5,1,382,328,710,985
0130-001,2012,2,5,2,280,233,513,710
0130-001,2012,2,5,3,229,183,412,513
0130-001,2012,2,5,4,168,144,312,412
0130-001,2012,2,5,5,161,147,308,312
0130-001,2012,2,5,6,198,244,442,308
0130-001,2012,2,5,7,396,356,752,442
0130-001,2012,2,5,8,549,510,1059,752
0130-001,2012,2,5,9,676,837,1513,1059
0130-001,2012,2,5,10,859,967,1826,1513
0130-001,2012,2,5,11,971,1185,2156,1826
0130-001,2012,2,5,12,975,1188,2163,2156
0130-001,2012,2,5,13,1147,1349,2496,2163
0130-001,2012,2,5,14,1339,1359,2698,2496
0130-001,2012,2,5,15,1490,1430,2920,2698
0130-001,2012,2,5,16,1596,1396,2992,2920
0130-001,2012,2,5,17,1707,1339,3046,2992
0130-001,2012,2,5,18,1728,1403,3131,3046
0130-001,2012,2,5,19,1488,1101,2589,3131
0130-001,2012,2,5,20,1205,854,2059,2589
0130-001,2012,2,5,21,1088,864,1952,2059
0130-001,2012,2,5,22,1030,680,1710,1952
0130-001,2012,2,5,23,696,461,1157,1710
0130-001,2012,2,5,24,455,332,787,1157
0130-001,2012,2,6,1,278,222,500,787
0130-001,2012,2,6,2,170,146,316,500
0130-001,2012,2,6,3,128,105,233,316
0130-001,2012,2,6,4,103,99,202,233
0130-001,2012,2,6,5,127,164,291,202
0130-001,2012,2,6,6,262,314,576,291
0130-001,2012,2,6,7,1065,658,1723,576
0130-001,2012,2,6,8,2209,1592,3801,1723
0130-001,2012,2,6,9,2015,1864,3879,3801
0130-001,2012,2,6,10,1572,1580,3152,3879
0130-001,2012,2,6,11,1608,1525,3133,3152
0130-001,2012,2,6,12,1523,1520,3043,3133
0130-001,2012,2,6,13,1368,1433,2801,3043
0130-001,2012,2,6,14,1659,1630,3289,2801
0130-001,2012,2,6,15,1677,1765,3442,3289
0130-001,2012,2,6,16,1712,1731,3443,3442
0130-001,2012,2,6,17,1687,1725,3412,3443
0130-001,2012,2,6,18,1650,2005,3655,3412
0130-001,2012,2,6,19,1665,2224,3889,3655
0130-001,2012,2,6,20,1359,1578,2937,3889
0130-001,2012,2,6,21,1159,1446,2605,2937
0130-001,2012,2,6,22,1065,1131,2196,2605
0130-001,2012,2,6,23,756,664,1420,2196
0130-001,2012,2,6,24,522,427,949,1420
0130-001,2012,2,7,1,336,295,631,949
0130-001,2012,2,7,2,223,212,435,631
0130-001,2012,2,7,3,170,161,331,435
0130-001,2012,2,7,4,148,146,294,331
0130-001,2012,2,7,5,145,220,365,294
0130-001,2012,2,7,6,275,322,597,365
0130-001,2012,2,7,7,1006,654,1660,597
0130-001,2012,2,7,8,2273,1572,3845,1660
0130-001,2012,2,7,9,2088,1929,4017,3845
0130-001,2012,2,7,10,1683,1639,3322,4017
0130-001,2012,2,7,11,1682,1569,3251,3322
0130-001,2012,2,7,12,1550,1557,3107,3251
0130-001,2012,2,7,13,1391,1430,2821,3107
0130-001,2012,2,7,14,1565,1613,3178,2821
0130-001,2012,2,7,15,1737,1703,3440,3178
0130-001,2012,2,7,16,1700,1789,3489,3440
0130-001,2012,2,7,17,1631,1757,3388,3489
0130-001,2012,2,7,18,1653,2039,3692,3388
0130-001,2012,2,7,19,1664,2204,3868,3692
0130-001,2012,2,7,20,1303,1623,2926,3868
0130-001,2012,2,7,21,1161,1493,2654,2926
0130-001,2012,2,7,22,1063,1174,2237,2654
0130-001,2012,2,7,23,811,706,1517,2237
0130-001,2012,2,7,24,571,500,1071,1517
0130-001,2012,2,8,1,370,324,694,1071
0130-001,2012,2,8,2,271,229,500,694
0130-001,2012,2,8,3,206,169,375,500
0130-001,2012,2,8,4,162,166,328,375
0130-001,2012,2,8,5,172,216,388,328
0130-001,2012,2,8,6,273,309,582,388
0130-001,2012,2,8,7,877,588,1465,582
0130-001,2012,2,8,8,1995,1323,3318,1465
0130-001,2012,2,8,9,1841,1761,3602,3318
0130-001,2012,2,8,10,1546,1544,3090,3602
0130-001,2012,2,8,11,1571,1457,3028,3090
0130-001,2012,2,8,12,1490,1485,2975,3028
0130-001,2012,2,8,13,1343,1394,2737,2975
0130-001,2012,2,8,14,1586,1611,3197,2737
0130-001,2012,2,8,15,1655,1732,3387,3197
0130-001,2012,2,8,16,1654,1695,3349,3387
0130-001,2012,2,8,17,1633,1659,3292,3349
0130-001,2012,2,8,18,1650,1993,3643,3292
0130-001,2012,2,8,19,1652,2156,3808,3643
0130-001,2012,2,8,20,1278,1616,2894,3808
0130-001,2012,2,8,21,1109,1287,2396,2894
0130-001,2012,2,8,22,1066,1068,2134,2396
0130-001,2012,2,8,23,854,687,1541,2134
0130-001,2012,2,8,24,565,488,1053,1541
0130-001,2012,2,9,1,350,311,661,1053
0130-001,2012,2,9,2,245,209,454,661
0130-001,2012,2,9,3,191,170,361,454
0130-001,2012,2,9,4,151,161,312,361
0130-001,2012,2,9,5,153,208,361,312
0130-001,2012,2,9,6,275,322,597,361
0130-001,2012,2,9,7,1026,686,1712,597
0130-001,2012,2,9,8,2251,1557,3808,1712
0130-001,2012,2,9,9,2056,1960,4016,3808
0130-001,2012,2,9,10,1680,1695,3375,4016
0130-001,2012,2,9,11,1621,1569,3190,3375
0130-001,2012,2,9,12,1529,1527,3056,3190
0130-001,2012,2,9,13,1360,1409,2769,3056
0130-001,2012,2,9,14,1668,1682,3350,2769
0130-001,2012,2,9,15,1715,1713,3428,3350
0130-001,2012,2,9,16,1720,1699,3419,3428
0130-001,2012,2,9,17,1620,1758,3378,3419
0130-001,2012,2,9,18,1691,2075,3766,3378
0130-001,2012,2,9,19,1692,2285,3977,3766
0130-001,2012,2,9,20,1337,1669,3006,3977
0130-001,2012,2,9,21,1146,1499,2645,3006
0130-001,2012,2,9,22,1160,1195,2355,2645
0130-001,2012,2,9,23,868,760,1628,2355
0130-001,2012,2,9,24,588,495,1083,1628
0130-001,2012,2,10,1,382,330,712,1083
0130-001,2012,2,10,2,270,245,515,712
0130-001,2012,2,10,3,203,175,378,515
0130-001,2012,2,10,4,169,171,340,378
0130-001,2012,2,10,5,154,228,382,340
0130-001,2012,2,10,6,284,312,596,382
0130-001,2012,2,10,7,924,633,1557,596
0130-001,2012,2,10,8,2184,1526,3710,1557
0130-001,2012,2,10,9,2160,1966,4126,3710
0130-001,2012,2,10,10,1665,1744,3409,4126
0130-001,2012,2,10,11,1709,1679,3388,3409
0130-001,2012,2,10,12,1638,1665,3303,3388
0130-001,2012,2,10,13,1478,1513,2991,3303
0130-001,2012,2,10,14,1654,1698,3352,2991
0130-001,2012,2,10,15,1745,1775,3520,3352
0130-001,2012,2,10,16,1748,1801,3549,3520
0130-001,2012,2,10,17,1700,1849,3549,3549
0130-001,2012,2,10,18,1847,2194,4041,3549
0130-001,2012,2,10,19,1826,2283,4109,4041
0130-001,2012,2,10,20,1522,1924,3446,4109
0130-001,2012,2,10,21,1222,1603,2825,3446
0130-001,2012,2,10,22,1181,1226,2407,2825
0130-001,2012,2,10,23,959,805,1764,2407
0130-001,2012,2,10,24,687,591,1278,1764
0130-001,2012,2,11,1,464,415,879,1278
0130-001,2012,2,11,2,362,296,658,879
0130-001,2012,2,11,3,245,236,481,658
0130-001,2012,2,11,4,198,197,395,481
0130-001,2012,2,11,5,192,236,428,395
0130-001,2012,2,11,6,306,357,663,428
0130-001,2012,2,11,7,702,532,1234,663
0130-001,2012,2,11,8,1277,1005,2282,1234
0130-001,2012,2,11,9,1409,1537,2946,2282
0130-001,2012,2,11,10,1510,1694,3204,2946
0130-001,2012,2,11,11,1539,1888,3427,3204
0130-001,2012,2,11,12,1567,2079,3646,3427
0130-001,2012,2,11,13,1535,2084,3619,3646
0130-001,2012,2,11,14,1637,2152,3789,3619
0130-001,2012,2,11,15,1749,2118,3867,3789
0130-001,2012,2,11,16,1757,2086,3843,3867
0130-001,2012,2,11,17,1908,2056,3964,3843
0130-001,2012,2,11,18,1962,2049,4011,3964
0130-001,2012,2,11,19,1852,1996,3848,4011
0130-001,2012,2,11,20,1393,1459,2852,3848
0130-001,2012,2,11,21,1196,1022,2218,2852
0130-001,2012,2,11,22,1096,900,1996,2218
0130-001,2012,2,11,23,812,627,1439,1996
0130-001,2012,2,11,24,586,426,1012,1439
0130-001,2012,2,12,1,394,331,725,1012
0130-001,2012,2,12,2,297,247,544,725
0130-001,2012,2,12,3,232,192,424,544
0130-001,2012,2,12,4,181,153,334,424
0130-001,2012,2,12,5,163,149,312,334
0130-001,2012,2,12,6,202,244,446,312
0130-001,2012,2,12,7,415,387,802,446
0130-001,2012,2,12,8,577,545,1122,802
0130-001,2012,2,12,9,722,881,1603,1122
0130-001,2012,2,12,10,890,999,1889,1603
0130-001,2012,2,12,11,1021,1268,2289,1889
0130-001,2012,2,12,12,1044,1324,2368,2289
0130-001,2012,2,12,13,1184,1428,2612,2368
0130-001,2012,2,12,14,1485,1426,2911,2612
0130-001,2012,2,12,15,1644,1426,3070,2911
0130-001,2012,2,12,16,1769,1400,3169,3070
0130-001,2012,2,12,17,1816,1393,3209,3169
0130-001,2012,2,12,18,1897,1455,3352,3209
0130-001,2012,2,12,19,1629,1187,2816,3352
0130-001,2012,2,12,20,1456,944,2400,2816
0130-001,2012,2,12,21,1315,940,2255,2400
0130-001,2012,2,12,22,1218,745,1963,2255
0130-001,2012,2,12,23,771,491,1262,1963
0130-001,2012,2,12,24,500,341,841,1262
0130-001,2012,2,13,1,290,223,513,841
0130-001,2012,2,13,2,181,160,341,513
0130-001,2012,2,13,3,129,107,236,341
0130-001,2012,2,13,4,107,131,238,236
0130-001,2012,2,13,5,131,194,325,238
0130-001,2012,2,13,6,287,351,638,325
0130-001,2012,2,13,7,1173,712,1885,638
0130-001,2012,2,13,8,2334,1636,3970,1885
0130-001,2012,2,13,9,2151,2005,4156,3970
0130-001,2012,2,13,10,1688,1650,3338,4156
0130-001,2012,2,13,11,1688,1607,3295,3338
0130-001,2012,2,13,12,1606,1575,3181,3295
0130-001,2012,2,13,13,1416,1437,2853,3181
0130-001,2012,2,13,14,1762,1665,3427,2853
0130-001,2012,2,13,15,1737,1745,3482,3427
0130-001,2012,2,13,16,1713,1754,3467,3482
0130-001,2012,2,13,17,1672,1870,3542,3467
0130-001,2012,2,13,18,1651,2045,3696,3542
0130-001,2012,2,13,19,1690,2180,3870,3696
0130-001,2012,2,13,20,1356,1665,3021,3870
0130-001,2012,2,13,21,1120,1555,2675,3021
0130-001,2012,2,13,22,1086,1224,2310,2675
0130-001,2012,2,13,23,772,713,1485,2310
0130-001,2012,2,13,24,542,473,1015,1485
0130-001,2012,2,14,1,368,313,681,1015
0130-001,2012,2,14,2,248,215,463,681
0130-001,2012,2,14,3,170,144,314,463
0130-001,2012,2,14,4,123,134,257,314
0130-001,2012,2,14,5,157,216,373,257
0130-001,2012,2,14,6,297,333,630,373
0130-001,2012,2,14,7,964,675,1639,630
0130-001,2012,2,14,8,2131,1536,3667,1639
0130-001,2012,2,14,9,2108,1861,3969,3667
0130-001,2012,2,14,10,1704,1726,3430,3969
0130-001,2012,2,14,11,1702,1609,3311,3430
0130-001,2012,2,14,12,1557,1547,3104,3311
0130-001,2012,2,14,13,1336,1406,2742,3104
0130-001,2012,2,14,14,1697,1636,3333,2742
0130-001,2012,2,14,15,1682,1685,3367,3333
0130-001,2012,2,14,16,1683,1738,3421,3367
0130-001,2012,2,14,17,1621,1758,3379,3421
0130-001,2012,2,14,18,1668,2061,3729,3379
0130-001,2012,2,14,19,1653,2215,3868,3729
0130-001,2012,2,14,20,1341,1720,3061,3868
0130-001,2012,2,14,21,1171,1535,2706,3061
0130-001,2012,2,14,22,1131,1254,2385,2706
0130-001,2012,2,14,23,880,738,1618,2385
0130-001,2012,2,14,24,597,497,1094,1618
0130-001,2012,2,15,1,400,314,714,1094
0130-001,2012,2,15,2,254,237,491,714
0130-001,2012,2,15,3,188,178,366,491
0130-001,2012,2,15,4,150,150,300,366
0130-001,2012,2,15,5,159,216,375,300
0130-001,2012,2,15,6,281,339,620,375
0130-001,2012,2,15,7,1001,674,1675,620
0130-001,2012,2,15,8,2293,1579,3872,1675
0130-001,2012,2,15,9,2060,1936,3996,3872
0130-001,2012,2,15,10,1675,1667,3342,3996
0130-001,2012,2,15,11,1705,1627,3332,3342
0130-001,2012,2,15,12,1614,1571,3185,3332
0130-001,2012,2,15,13,1390,1463,2853,3185
0130-001,2012,2,15,14,1659,1607,3266,2853
0130-001,2012,2,15,15,1768,1704,3472,3266
0130-001,2012,2,15,16,1691,1723,3414,3472
0130-001,2012,2,15,17,1607,1796,3403,3414
0130-001,2012,2,15,18,1671,2103,3774,3403
0130-001,2012,2,15,19,1592,2253,3845,3774
0130-001,2012,2,15,20,1460,1808,3268,3845
0130-001,2012,2,15,21,1174,1455,2629,3268
0130-001,2012,2,15,22,1157,1174,2331,2629
0130-001,2012,2,15,23,857,764,1621,2331
0130-001,2012,2,15,24,605,497,1102,1621
0130-001,2012,2,16,1,405,350,755,1102
0130-001,2012,2,16,2,266,246,512,755
0130-001,2012,2,16,3,189,159,348,512
0130-001,2012,2,16,4,154,154,308,348
0130-001,2012,2,16,5,161,213,374,308
0130-001,2012,2,16,6,268,349,617,374
0130-001,2012,2,16,7,984,673,1657,617
0130-001,2012,2,16,8,2200,1562,3762,1657
0130-001,2012,2,16,9,2114,1952,4066,3762
0130-001,2012,2,16,10,1738,1705,3443,4066
0130-001,2012,2,16,11,1693,1580,3273,3443
0130-001,2012,2,16,12,1626,1571,3197,3273
0130-001,2012,2,16,13,1398,1435,2833,3197
0130-001,2012,2,16,14,1676,1699,3375,2833
0130-001,2012,2,16,15,1750,1729,3479,3375
0130-001,2012,2,16,16,1695,1769,3464,3479
0130-001,2012,2,16,17,1658,1797,3455,3464
0130-001,2012,2,16,18,1633,2077,3710,3455
0130-001,2012,2,16,19,1736,2267,4003,3710
0130-001,2012,2,16,20,1347,1722,3069,4003
0130-001,2012,2,16,21,1198,1523,2721,3069
0130-001,2012,2,16,22,1139,1252,2391,2721
0130-001,2012,2,16,23,894,769,1663,2391
0130-001,2012,2,16,24,622,532,1154,1663
0130-001,2012,2,17,1,407,351,758,1154
0130-001,2012,2,17,2,288,258,546,758
0130-001,2012,2,17,3,218,191,409,546
0130-001,2012,2,17,4,151,169,320,409
0130-001,2012,2,17,5,157,218,375,320
0130-001,2012,2,17,6,281,303,584,375
0130-001,2012,2,17,7,915,616,1531,584
0130-001,2012,2,17,8,2208,1543,3751,1531
0130-001,2012,2,17,9,2127,1910,4037,3751
0130-001,2012,2,17,10,1622,1725,3347,4037
0130-001,2012,2,17,11,1722,1674,3396,3347
0130-001,2012,2,17,12,1587,1684,3271,3396
0130-001,2012,2,17,13,1426,1556,2982,3271
0130-001,2012,2,17,14,1674,1763,3437,2982
0130-001,2012,2,17,15,1783,1788,3571,3437
0130-001,2012,2,17,16,1753,1829,3582,3571
0130-001,2012,2,17,17,1762,1831,3593,3582
0130-001,2012,2,17,18,1737,2156,3893,3593
0130-001,2012,2,17,19,1842,2240,4082,3893
0130-001,2012,2,17,20,1522,1916,3438,4082
0130-001,2012,2,17,21,1211,1613,2824,3438
0130-001,2012,2,17,22,1195,1182,2377,2824
0130-001,2012,2,17,23,924,805,1729,2377
0130-001,2012,2,17,24,644,563,1207,1729
0130-001,2012,2,18,1,473,415,888,1207
0130-001,2012,2,18,2,339,305,644,888
0130-001,2012,2,18,3,243,239,482,644
0130-001,2012,2,18,4,215,192,407,482
0130-001,2012,2,18,5,194,246,440,407
0130-001,2012,2,18,6,273,342,615,440
0130-001,2012,2,18,7,615,498,1113,615
0130-001,2012,2,18,8,1225,941,2166,1113
0130-001,2012,2,18,9,1443,1506,2949,2166
0130-001,2012,2,18,10,1470,1622,3092,2949
0130-001,2012,2,18,11,1604,1849,3453,3092
0130-001,2012,2,18,12,1578,2001,3579,3453
0130-001,2012,2,18,13,1600,2049,3649,3579
0130-001,2012,2,18,14,1676,2057,3733,3649
0130-001,2012,2,18,15,1760,1817,3577,3733
0130-001,2012,2,18,16,1699,1895,3594,3577
0130-001,2012,2,18,17,1820,1834,3654,3594
0130-001,2012,2,18,18,1964,1876,3840,3654
0130-001,2012,2,18,19,1740,1808,3548,3840
0130-001,2012,2,18,20,1290,1249,2539,3548
0130-001,2012,2,18,21,1166,1043,2209,2539
0130-001,2012,2,18,22,1056,852,1908,2209
0130-001,2012,2,18,23,828,608,1436,1908
0130-001,2012,2,18,24,607,486,1093,1436
0130-001,2012,2,19,1,419,343,762,1093
0130-001,2012,2,19,2,282,254,536,762
0130-001,2012,2,19,3,247,171,418,536
0130-001,2012,2,19,4,190,180,370,418
0130-001,2012,2,19,5,185,170,355,370
0130-001,2012,2,19,6,232,261,493,355
0130-001,2012,2,19,7,438,373,811,493
0130-001,2012,2,19,8,569,577,1146,811
0130-001,2012,2,19,9,737,858,1595,1146
0130-001,2012,2,19,10,844,953,1797,1595
0130-001,2012,2,19,11,1064,1234,2298,1797
0130-001,2012,2,19,12,1056,1253,2309,2298
0130-001,2012,2,19,13,1214,1387,2601,2309
0130-001,2012,2,19,14,1351,1410,2761,2601
0130-001,2012,2,19,15,1555,1418,2973,2761
0130-001,2012,2,19,16,1738,1471,3209,2973
0130-001,2012,2,19,17,1794,1449,3243,3209
0130-001,2012,2,19,18,1777,1475,3252,3243
0130-001,2012,2,19,19,1612,1150,2762,3252
0130-001,2012,2,19,20,1139,986,2125,2762
0130-001,2012,2,19,21,1030,950,1980,2125
0130-001,2012,2,19,22,931,691,1622,1980
0130-001,2012,2,19,23,672,495,1167,1622
0130-001,2012,2,19,24,427,326,753,1167
0130-001,2012,2,20,1,275,232,507,753
0130-001,2012,2,20,2,187,142,329,507
0130-001,2012,2,20,3,144,114,258,329
0130-001,2012,2,20,4,111,117,228,258
0130-001,2012,2,20,5,138,228,366,228
0130-001,2012,2,20,6,309,339,648,366
0130-001,2012,2,20,7,1127,755,1882,648
0130-001,2012,2,20,8,2336,1637,3973,1882
0130-001,2012,2,20,9,2222,2014,4236,3973
0130-001,2012,2,20,10,1695,1694,3389,4236
0130-001,2012,2,20,11,1667,1671,3338,3389
0130-001,2012,2,20,12,1658,1644,3302,3338
0130-001,2012,2,20,13,1485,1449,2934,3302
0130-001,2012,2,20,14,1701,1705,3406,2934
0130-001,2012,2,20,15,1794,1787,3581,3406
0130-001,2012,2,20,16,1755,1859,3614,3581
0130-001,2012,2,20,17,1666,1765,3431,3614
0130-001,2012,2,20,18,1682,2151,3833,3431
0130-001,2012,2,20,19,1787,2279,4066,3833
0130-001,2012,2,20,20,1402,1730,3132,4066
0130-001,2012,2,20,21,1218,1526,2744,3132
0130-001,2012,2,20,22,1110,1228,2338,2744
0130-001,2012,2,20,23,827,719,1546,2338
0130-001,2012,2,20,24,531,497,1028,1546
0130-001,2012,2,21,1,371,287,658,1028
0130-001,2012,2,21,2,221,209,430,658
0130-001,2012,2,21,3,181,159,340,430
0130-001,2012,2,21,4,132,165,297,340
0130-001,2012,2,21,5,162,233,395,297
0130-001,2012,2,21,6,299,343,642,395
0130-001,2012,2,21,7,1059,699,1758,642
0130-001,2012,2,21,8,2223,1683,3906,1758
0130-001,2012,2,21,9,2158,1966,4124,3906
0130-001,2012,2,21,10,1814,1781,3595,4124
0130-001,2012,2,21,11,1774,1660,3434,3595
0130-001,2012,2,21,12,1647,1598,3245,3434
0130-001,2012,2,21,13,1483,1459,2942,3245
0130-001,2012,2,21,14,1668,1724,3392,2942
0130-001,2012,2,21,15,1832,1841,3673,3392
0130-001,2012,2,21,16,1734,1913,3647,3673
0130-001,2012,2,21,17,1701,1895,3596,3647
0130-001,2012,2,21,18,1739,2136,3875,3596
0130-001,2012,2,21,19,1731,2286,4017,3875
0130-001,2012,2,21,20,1302,1669,2971,4017
0130-001,2012,2,21,21,1236,1540,2776,2971
0130-001,2012,2,21,22,1142,1268,2410,2776
0130-001,2012,2,21,23,840,770,1610,2410
0130-001,2012,2,21,24,561,473,1034,1610
0130-001,2012,2,22,1,396,328,724,1034
0130-001,2012,2,22,2,228,232,460,724
0130-001,2012,2,22,3,190,168,358,460
0130-001,2012,2,22,4,148,149,297,358
0130-001,2012,2,22,5,169,223,392,297
0130-001,2012,2,22,6,295,329,624,392
0130-001,2012,2,22,7,1017,667,1684,624
0130-001,2012,2,22,8,2306,1644,3950,1684
0130-001,2012,2,22,9,2107,1960,4067,3950
0130-001,2012,2,22,10,1670,1752,3422,4067
0130-001,2012,2,22,11,1725,1630,3355,3422
0130-001,2012,2,22,12,1652,1569,3221,3355
0130-001,2012,2,22,13,1538,1515,3053,3221
0130-001,2012,2,22,14,1679,1697,3376,3053
0130-001,2012,2,22,15,1838,1749,3587,3376
0130-001,2012,2,22,16,1828,1816,3644,3587
0130-001,2012,2,22,17,1721,1868,3589,3644
0130-001,2012,2,22,18,1785,2212,3997,3589
0130-001,2012,2,22,19,1760,2391,4151,3997
0130-001,2012,2,22,20,1422,1813,3235,4151
0130-001,2012,2,22,21,1260,1456,2716,3235
0130-001,2012,2,22,22,1225,1189,2414,2716
0130-001,2012,2,22,23,903,740,1643,2414
0130-001,2012,2,22,24,592,505,1097,1643
0130-001,2012,2,23,1,406,342,748,1097
0130-001,2012,2,23,2,255,240,495,748
0130-001,2012,2,23,3,195,169,364,495
0130-001,2012,2,23,4,164,161,325,364
0130-001,2012,2,23,5,162,221,383,325
0130-001,2012,2,23,6,289,348,637,383
0130-001,2012,2,23,7,1032,704,1736,637
0130-001,2012,2,23,8,2213,1685,3898,1736
0130-001,2012,2,23,9,2108,1967,4075,3898
0130-001,2012,2,23,10,1756,1729,3485,4075
0130-001,2012,2,23,11,1735,1612,3347,3485
0130-001,2012,2,23,12,1618,1562,3180,3347
0130-001,2012,2,23,13,1389,1411,2800,3180
0130-001,2012,2,23,14,1682,1697,3379,2800
0130-001,2012,2,23,15,1761,1723,3484,3379
0130-001,2012,2,23,16,1704,1787,3491,3484
0130-001,2012,2,23,17,1684,1831,3515,3491
0130-001,2012,2,23,18,1657,2149,3806,3515
0130-001,2012,2,23,19,1775,2317,4092,3806
0130-001,2012,2,23,20,1379,1736,3115,4092
0130-001,2012,2,23,21,1191,1558,2749,3115
0130-001,2012,2,23,22,1149,1284,2433,2749
0130-001,2012,2,23,23,927,777,1704,2433
0130-001,2012,2,23,24,618,526,1144,1704
0130-001,2012,2,24,1,404,355,759,1144
0130-001,2012,2,24,2,274,256,530,759
0130-001,2012,2,24,3,218,190,408,530
0130-001,2012,2,24,4,154,161,315,408
0130-001,2012,2,24,5,165,227,392,315
0130-001,2012,2,24,6,294,310,604,392
0130-001,2012,2,24,7,995,651,1646,604
0130-001,2012,2,24,8,2243,1635,3878,1646
0130-001,2012,2,24,9,2134,1928,4062,3878
0130-001,2012,2,24,10,1683,1744,3427,4062
0130-001,2012,2,24,11,1729,1716,3445,3427
0130-001,2012,2,24,12,1568,1691,3259,3445
0130-001,2012,2,24,13,1405,1525,2930,3259
0130-001,2012,2,24,14,1643,1737,3380,2930
0130-001,2012,2,24,15,1764,1782,3546,3380
0130-001,2012,2,24,16,1753,1778,3531,3546
0130-001,2012,2,24,17,1718,1830,3548,3531
0130-001,2012,2,24,18,1800,2180,3980,3548
0130-001,2012,2,24,19,1833,2262,4095,3980
0130-001,2012,2,24,20,1503,1991,3494,4095
0130-001,2012,2,24,21,1226,1613,2839,3494
0130-001,2012,2,24,22,1193,1246,2439,2839
0130-001,2012,2,24,23,940,812,1752,2439
0130-001,2012,2,24,24,667,564,1231,1752
0130-001,2012,2,25,1,481,422,903,1231
0130-001,2012,2,25,2,336,305,641,903
0130-001,2012,2,25,3,249,234,483,641
0130-001,2012,2,25,4,209,191,400,483
0130-001,2012,2,25,5,194,248,442,400
0130-001,2012,2,25,6,299,345,644,442
0130-001,2012,2,25,7,685,560,1245,644
0130-001,2012,2,25,8,1290,1020,2310,1245
0130-001,2012,2,25,9,1480,1565,3045,2310
0130-001,2012,2,25,10,1519,1687,3206,3045
0130-001,2012,2,25,11,1627,1945,3572,3206
0130-001,2012,2,25,12,1628,2114,3742,3572
0130-001,2012,2,25,13,1635,2176,3811,3742
0130-001,2012,2,25,14,1680,2156,3836,3811
0130-001,2012,2,25,15,1759,2012,3771,3836
0130-001,2012,2,25,16,1758,1977,3735,3771
0130-001,2012,2,25,17,1880,1944,3824,3735
0130-001,2012,2,25,18,1976,1970,3946,3824
0130-001,2012,2,25,19,1867,1868,3735,3946
0130-001,2012,2,25,20,1395,1316,2711,3735
0130-001,2012,2,25,21,1167,1082,2249,2711
0130-001,2012,2,25,22,1059,872,1931,2249
0130-001,2012,2,25,23,810,644,1454,1931
0130-001,2012,2,25,24,595,486,1081,1454
0130-001,2012,2,26,1,410,336,746,1081
0130-001,2012,2,26,2,291,244,535,746
0130-001,2012,2,26,3,237,181,418,535
0130-001,2012,2,26,4,181,166,347,418
0130-001,2012,2,26,5,185,170,355,347
0130-001,2012,2,26,6,227,260,487,355
0130-001,2012,2,26,7,461,406,867,487
0130-001,2012,2,26,8,620,593,1213,867
0130-001,2012,2,26,9,758,904,1662,1213
0130-001,2012,2,26,10,934,1013,1947,1662
0130-001,2012,2,26,11,1110,1292,2402,1947
0130-001,2012,2,26,12,1063,1318,2381,2402
0130-001,2012,2,26,13,1245,1417,2662,2381
0130-001,2012,2,26,14,1438,1423,2861,2662
0130-001,2012,2,26,15,1631,1405,3036,2861
0130-001,2012,2,26,16,1837,1454,3291,3036
0130-001,2012,2,26,17,1806,1427,3233,3291
0130-001,2012,2,26,18,1894,1447,3341,3233
0130-001,2012,2,26,19,1776,1206,2982,3341
0130-001,2012,2,26,20,1377,1017,2394,2982
0130-001,2012,2,26,21,1217,948,2165,2394
0130-001,2012,2,26,22,1072,708,1780,2165
0130-001,2012,2,26,23,711,505,1216,1780
0130-001,2012,2,26,24,484,330,814,1216
0130-001,2012,2,27,1,289,231,520,814
0130-001,2012,2,27,2,177,146,323,520
0130-001,2012,2,27,3,138,108,246,323
0130-001,2012,2,27,4,111,118,229,246
0130-001,2012,2,27,5,139,212,351,229
0130-001,2012,2,27,6,317,343,660,351
0130-001,2012,2,27,7,1198,764,1962,660
0130-001,2012,2,27,8,2327,1744,4071,1962
0130-001,2012,2,27,9,2248,1993,4241,4071
0130-001,2012,2,27,10,1738,1736,3474,4241
0130-001,2012,2,27,11,1704,1671,3375,3474
0130-001,2012,2,27,12,1656,1608,3264,3375
0130-001,2012,2,27,13,1470,1444,2914,3264
0130-001,2012,2,27,14,1701,1686,3387,2914
0130-001,2012,2,27,15,1785,1812,3597,3387
0130-001,2012,2,27,16,1746,1824,3570,3597
0130-001,2012,2,27,17,1691,1770,3461,3570
0130-001,2012,2,27,18,1699,2138,3837,3461
0130-001,2012,2,27,19,1765,2304,4069,3837
0130-001,2012,2,27,20,1409,1746,3155,4069
0130-001,2012,2,27,21,1199,1589,2788,3155
0130-001,2012,2,27,22,1140,1264,2404,2788
0130-001,2012,2,27,23,823,737,1560,2404
0130-001,2012,2,27,24,526,479,1005,1560
0130-001,2012,2,28,1,372,314,686,1005
0130-001,2012,2,28,2,222,220,442,686
0130-001,2012,2,28,3,179,161,340,442
0130-001,2012,2,28,4,140,155,295,340
0130-001,2012,2,28,5,161,229,390,295
0130-001,2012,2,28,6,305,335,640,390
0130-001,2012,2,28,7,1106,717,1823,640
0130-001,2012,2,28,8,2268,1726,3994,1823
0130-001,2012,2,28,9,2144,1973,4117,3994
0130-001,2012,2,28,10,1820,1760,3580,4117
0130-001,2012,2,28,11,1785,1640,3425,3580
0130-001,2012,2,28,12,1611,1587,3198,3425
0130-001,2012,2,28,13,1465,1461,2926,3198
0130-001,2012,2,28,14,1659,1690,3349,2926
0130-001,2012,2,28,15,1794,1789,3583,3349
0130-001,2012,2,28,16,1724,1893,3617,3583
0130-001,2012,2,28,17,1717,1886,3603,3617
0130-001,2012,2,28,18,1751,2165,3916,3603
0130-001,2012,2,28,19,1746,2299,4045,3916
0130-001,2012,2,28,20,1339,1703,3042,4045
0130-001,2012,2,28,21,1224,1577,2801,3042
0130-001,2012,2,28,22,1155,1313,2468,2801
0130-001,2012,2,28,23,857,779,1636,2468
0130-001,2012,2,28,24,602,517,1119,1636
0130-001,2012,2,29,1,407,346,753,1119
0130-001,2012,2,29,2,277,249,526,753
0130-001,2012,2,29,3,214,187,401,526
0130-001,2012,2,29,4,171,173,344,401
0130-001,2012,2,29,5,182,230,412,344
0130-001,2012,2,29,6,314,323,637,412
0130-001,2012,2,29,7,975,651,1626,637
0130-001,2012,2,29,8,2054,1475,3529,1626
0130-001,2012,2,29,9,1948,1822,3770,3529
0130-001,2012,2,29,10,1629,1702,3331,3770
0130-001,2012,2,29,11,1685,1586,3271,3331
0130-001,2012,2,29,12,1575,1535,3110,3271
0130-001,2012,2,29,13,1481,1495,2976,3110
0130-001,2012,2,29,14,1651,1674,3325,2976
0130-001,2012,2,29,15,1768,1754,3522,3325
0130-001,2012,2,29,16,1756,1784,3540,3522
0130-001,2012,2,29,17,1695,1809,3504,3540
0130-001,2012,2,29,18,1743,2126,3869,3504
0130-001,2012,2,29,19,1717,2227,3944,3869
0130-001,2012,2,29,20,1376,1714,3090,3944
0130-001,2012,2,29,21,1189,1390,2579,3090
0130-001,2012,2,29,22,1174,1145,2319,2579
0130-001,2012,2,29,23,882,720,1602,2319
0130-001,2012,2,29,24,599,501,1100,1602
0130-001,2012,3,1,1,407,333,740,1100
0130-001,2012,3,1,2,244,234,478,740
0130-001,2012,3,1,3,200,178,378,478
0130-001,2012,3,1,4,174,167,341,378
0130-001,2012,3,1,5,163,229,392,341
0130-001,2012,3,1,6,310,346,656,392
0130-001,2012,3,1,7,1080,734,1814,656
0130-001,2012,3,1,8,2226,1808,4034,1814
0130-001,2012,3,1,9,2102,1982,4084,4034
0130-001,2012,3,1,10,1774,1753,3527,4084
0130-001,2012,3,1,11,1777,1644,3421,3527
0130-001,2012,3,1,12,1610,1552,3162,3421
0130-001,2012,3,1,13,1379,1386,2765,3162
0130-001,2012,3,1,14,1687,1694,3381,2765
0130-001,2012,3,1,15,1771,1716,3487,3381
0130-001,2012,3,1,16,1713,1805,3518,3487
0130-001,2012,3,1,17,1709,1864,3573,3518
0130-001,2012,3,1,18,1681,2221,3902,3573
0130-001,2012,3,1,19,1813,2366,4179,3902
0130-001,2012,3,1,20,1411,1750,3161,4179
0130-001,2012,3,1,21,1183,1593,2776,3161
0130-001,2012,3,1,22,1158,1316,2474,2776
0130-001,2012,3,1,23,959,785,1744,2474
0130-001,2012,3,1,24,614,520,1134,1744
0130-001,2012,3,2,1,400,359,759,1134
0130-001,2012,3,2,2,259,253,512,759
0130-001,2012,3,2,3,218,189,407,512
0130-001,2012,3,2,4,156,153,309,407
0130-001,2012,3,2,5,173,236,409,309
0130-001,2012,3,2,6,306,316,622,409
0130-001,2012,3,2,7,1075,686,1761,622
0130-001,2012,3,2,8,2277,1726,4003,1761
0130-001,2012,3,2,9,2140,1945,4085,4003
0130-001,2012,3,2,10,1743,1762,3505,4085
0130-001,2012,3,2,11,1736,1757,3493,3505
0130-001,2012,3,2,12,1548,1697,3245,3493
0130-001,2012,3,2,13,1383,1494,2877,3245
0130-001,2012,3,2,14,1611,1711,3322,2877
0130-001,2012,3,2,15,1744,1775,3519,3322
0130-001,2012,3,2,16,1752,1727,3479,3519
0130-001,2012,3,2,17,1673,1829,3502,3479
0130-001,2012,3,2,18,1862,2203,4065,3502
0130-001,2012,3,2,19,1823,2283,4106,4065
0130-001,2012,3,2,20,1484,2065,3549,4106
0130-001,2012,3,2,21,1241,1612,2853,3549
0130-001,2012,3,2,22,1190,1310,2500,2853
0130-001,2012,3,2,23,955,818,1773,2500
0130-001,2012,3,2,24,690,564,1254,1773
0130-001,2012,3,3,1,488,429,917,1254
0130-001,2012,3,3,2,333,305,638,917
0130-001,2012,3,3,3,254,229,483,638
0130-001,2012,3,3,4,203,189,392,483
0130-001,2012,3,3,5,193,250,443,392
0130-001,2012,3,3,6,324,347,671,443
0130-001,2012,3,3,7,755,622,1377,671
0130-001,2012,3,3,8,1354,1098,2452,1377
0130-001,2012,3,3,9,1517,1623,3140,2452
0130-001,2012,3,3,10,1567,1751,3318,3140
0130-001,2012,3,3,11,1649,2041,3690,3318
0130-001,2012,3,3,12,1678,2227,3905,3690
0130-001,2012,3,3,13,1670,2302,3972,3905
0130-001,2012,3,3,14,1683,2255,3938,3972
0130-001,2012,3,3,15,1758,2206,3964,3938
0130-001,2012,3,3,16,1816,2059,3875,3964
0130-001,2012,3,3,17,1939,2054,3993,3875
0130-001,2012,3,3,18,1988,2064,4052,3993
0130-001,2012,3,3,19,1994,1927,3921,4052
0130-001,2012,3,3,20,1499,1383,2882,3921
0130-001,2012,3,3,21,1168,1120,2288,2882
0130-001,2012,3,3,22,1062,891,1953,2288
0130-001,2012,3,3,23,791,680,1471,1953
0130-001,2012,3,3,24,583,485,1068,1471
0130-001,2012,3,4,1,401,328,729,1068
0130-001,2012,3,4,2,300,234,534,729
0130-001,2012,3,4,3,226,191,417,534
0130-001,2012,3,4,4,172,151,323,417
0130-001,2012,3,4,5,184,169,353,323
0130-001,2012,3,4,6,222,258,480,353
0130-001,2012,3,4,7,484,438,922,480
0130-001,2012,3,4,8,670,608,1278,922
0130-001,2012,3,4,9,778,949,1727,1278
0130-001,2012,3,4,10,1024,1073,2097,1727
0130-001,2012,3,4,11,1156,1349,2505,2097
0130-001,2012,3,4,12,1070,1382,2452,2505
0130-001,2012,3,4,13,1275,1446,2721,2452
0130-001,2012,3,4,14,1525,1436,2961,2721
0130-001,2012,3,4,15,1707,1392,3099,2961
0130-001,2012,3,4,16,1936,1437,3373,3099
0130-001,2012,3,4,17,1817,1404,3221,3373
0130-001,2012,3,4,18,2011,1419,3430,3221
0130-001,2012,3,4,19,1939,1262,3201,3430
0130-001,2012,3,4,20,1615,1048,2663,3201
0130-001,2012,3,4,21,1403,945,2348,2663
0130-001,2012,3,4,22,1212,724,1936,2348
0130-001,2012,3,4,23,750,515,1265,1936
0130-001,2012,3,4,24,540,334,874,1265
0130-001,2012,3,5,1,302,229,531,874
0130-001,2012,3,5,2,167,149,316,531
0130-001,2012,3,5,3,132,102,234,316
0130-001,2012,3,5,4,111,118,229,234
0130-001,2012,3,5,5,140,196,336,229
0130-001,2012,3,5,6,324,346,670,336
0130-001,2012,3,5,7,1268,773,2041,670
0130-001,2012,3,5,8,2318,1851,4169,2041
0130-001,2012,3,5,9,2273,1972,4245,4169
0130-001,2012,3,5,10,1781,1777,3558,4245
0130-001,2012,3,5,11,1741,1671,3412,3558
0130-001,2012,3,5,12,1654,1572,3226,3412
0130-001,2012,3,5,13,1455,1439,2894,3226
0130-001,2012,3,5,14,1700,1667,3367,2894
0130-001,2012,3,5,15,1776,1837,3613,3367
0130-001,2012,3,5,16,1736,1789,3525,3613
0130-001,2012,3,5,17,1715,1774,3489,3525
0130-001,2012,3,5,18,1716,2124,3840,3489
0130-001,2012,3,5,19,1743,2329,4072,3840
0130-001,2012,3,5,20,1415,1762,3177,4072
0130-001,2012,3,5,21,1180,1651,2831,3177
0130-001,2012,3,5,22,1169,1299,2468,2831
0130-001,2012,3,5,23,818,755,1573,2468
0130-001,2012,3,5,24,520,460,980,1573
0130-001,2012,3,6,1,372,340,712,980
0130-001,2012,3,6,2,223,231,454,712
0130-001,2012,3,6,3,176,163,339,454
0130-001,2012,3,6,4,148,144,292,339
0130-001,2012,3,6,5,159,225,384,292
0130-001,2012,3,6,6,311,326,637,384
0130-001,2012,3,6,7,1153,734,1887,637
0130-001,2012,3,6,8,2313,1768,4081,1887
0130-001,2012,3,6,9,2129,1980,4109,4081
0130-001,2012,3,6,10,1826,1739,3565,4109
0130-001,2012,3,6,11,1795,1620,3415,3565
0130-001,2012,3,6,12,1574,1576,3150,3415
0130-001,2012,3,6,13,1446,1463,2909,3150
0130-001,2012,3,6,14,1649,1656,3305,2909
0130-001,2012,3,6,15,1755,1736,3491,3305
0130-001,2012,3,6,16,1713,1872,3585,3491
0130-001,2012,3,6,17,1733,1876,3609,3585
0130-001,2012,3,6,18,1762,2193,3955,3609
0130-001,2012,3,6,19,1760,2312,4072,3955
0130-001,2012,3,6,20,1376,1737,3113,4072
0130-001,2012,3,6,21,1212,1614,2826,3113
0130-001,2012,3,6,22,1168,1357,2525,2826
0130-001,2012,3,6,23,874,787,1661,2525
0130-001,2012,3,6,24,642,560,1202,1661
0130-001,2012,3,7,1,417,363,780,1202
0130-001,2012,3,7,2,325,265,590,780
0130-001,2012,3,7,3,237,205,442,590
0130-001,2012,3,7,4,194,196,390,442
0130-001,2012,3,7,5,194,237,431,390
0130-001,2012,3,7,6,332,317,649,431
0130-001,2012,3,7,7,932,634,1566,649
0130-001,2012,3,7,8,1801,1305,3106,1566
0130-001,2012,3,7,9,1788,1684,3472,3106
0130-001,2012,3,7,10,1588,1651,3239,3472
0130-001,2012,3,7,11,1644,1541,3185,3239
0130-001,2012,3,7,12,1498,1500,2998,3185
0130-001,2012,3,7,13,1423,1475,2898,2998
0130-001,2012,3,7,14,1622,1650,3272,2898
0130-001,2012,3,7,15,1697,1759,3456,3272
0130-001,2012,3,7,16,1684,1751,3435,3456
0130-001,2012,3,7,17,1669,1750,3419,3435
0130-001,2012,3,7,18,1701,2039,3740,3419
0130-001,2012,3,7,19,1673,2062,3735,3740
0130-001,2012,3,7,20,1329,1614,2943,3735
0130-001,2012,3,7,21,1118,1324,2442,2943
0130-001,2012,3,7,22,1122,1100,2222,2442
0130-001,2012,3,7,23,860,700,1560,2222
0130-001,2012,3,7,24,606,496,1102,1560
0130-001,2012,3,8,1,376,306,682,1102
0130-001,2012,3,8,2,260,210,470,682
0130-001,2012,3,8,3,214,189,403,470
0130-001,2012,3,8,4,152,152,304,403
0130-001,2012,3,8,5,159,220,379,304
0130-001,2012,3,8,6,318,339,657,379
0130-001,2012,3,8,7,1159,773,1932,657
0130-001,2012,3,8,8,2292,1724,4016,1932
0130-001,2012,3,8,9,2070,2056,4126,4016
0130-001,2012,3,8,10,1843,1812,3655,4126
0130-001,2012,3,8,11,1780,1675,3455,3655
0130-001,2012,3,8,12,1559,1598,3157,3455
0130-001,2012,3,8,13,1394,1488,2882,3157
0130-001,2012,3,8,14,1714,1686,3400,2882
0130-001,2012,3,8,15,1760,1762,3522,3400
0130-001,2012,3,8,16,1710,1848,3558,3522
0130-001,2012,3,8,17,1680,1814,3494,3558
0130-001,2012,3,8,18,1726,2144,3870,3494
0130-001,2012,3,8,19,1746,2355,4101,3870
0130-001,2012,3,8,20,1375,1707,3082,4101
0130-001,2012,3,8,21,1178,1604,2782,3082
0130-001,2012,3,8,22,1191,1268,2459,2782
0130-001,2012,3,8,23,920,788,1708,2459
0130-001,2012,3,8,24,622,536,1158,1708
0130-001,2012,3,9,1,404,349,753,1158
0130-001,2012,3,9,2,280,252,532,753
0130-001,2012,3,9,3,211,183,394,532
0130-001,2012,3,9,4,169,171,340,394
0130-001,2012,3,9,5,164,240,404,340
0130-001,2012,3,9,6,310,322,632,404
0130-001,2012,3,9,7,1001,676,1677,632
0130-001,2012,3,9,8,2240,1697,3937,1677
0130-001,2012,3,9,9,2168,2014,4182,3937
0130-001,2012,3,9,10,1736,1839,3575,4182
0130-001,2012,3,9,11,1817,1738,3555,3575
0130-001,2012,3,9,12,1675,1736,3411,3555
0130-001,2012,3,9,13,1459,1556,3015,3411
0130-001,2012,3,9,14,1652,1677,3329,3015
0130-001,2012,3,9,15,1784,1806,3590,3329
0130-001,2012,3,9,16,1690,1882,3572,3590
0130-001,2012,3,9,17,1680,1921,3601,3572
0130-001,2012,3,9,18,1887,2250,4137,3601
0130-001,2012,3,9,19,1928,2385,4313,4137
0130-001,2012,3,9,20,1505,1963,3468,4313
0130-001,2012,3,9,21,1258,1682,2940,3468
0130-001,2012,3,9,22,1213,1347,2560,2940
0130-001,2012,3,9,23,993,867,1860,2560
0130-001,2012,3,9,24,720,577,1297,1860
0130-001,2012,3,10,1,494,434,928,1297
0130-001,2012,3,10,2,369,312,681,928
0130-001,2012,3,10,3,248,229,477,681
0130-001,2012,3,10,4,219,204,423,477
0130-001,2012,3,10,5,195,270,465,423
0130-001,2012,3,10,6,335,352,687,465
0130-001,2012,3,10,7,789,614,1403,687
0130-001,2012,3,10,8,1391,1096,2487,1403
0130-001,2012,3,10,9,1512,1720,3232,2487
0130-001,2012,3,10,10,1646,1903,3549,3232
0130-001,2012,3,10,11,1624,2118,3742,3549
0130-001,2012,3,10,12,1607,2257,3864,3742
0130-001,2012,3,10,13,1579,2270,3849,3864
0130-001,2012,3,10,14,1685,2408,4093,3849
0130-001,2012,3,10,15,1768,2267,4035,4093
0130-001,2012,3,10,16,1808,2125,3933,4035
0130-001,2012,3,10,17,1934,2095,4029,3933
0130-001,2012,3,10,18,1950,2059,4009,4029
0130-001,2012,3,10,19,1995,2013,4008,4009
0130-001,2012,3,10,20,1515,1538,3053,4008
0130-001,2012,3,10,21,1235,1111,2346,3053
0130-001,2012,3,10,22,1166,963,2129,2346
0130-001,2012,3,10,23,826,668,1494,2129
0130-001,2012,3,10,24,613,457,1070,1494
0130-001,2012,3,11,1,384,337,721,1070
0130-001,2012,3,11,2,308,242,550,721
0130-001,2012,3,11,3,241,189,430,550
0130-001,2012,3,11,4,183,149,332,430
0130-001,2012,3,11,5,171,153,324,332
0130-001,2012,3,11,6,215,244,459,324
0130-001,2012,3,11,7,490,446,936,459
0130-001,2012,3,11,8,672,673,1345,936
0130-001,2012,3,11,9,792,991,1783,1345
0130-001,2012,3,11,10,996,1138,2134,1783
0130-001,2012,3,11,11,1130,1358,2488,2134
0130-001,2012,3,11,12,1128,1437,2565,2488
0130-001,2012,3,11,13,1264,1502,2766,2565
0130-001,2012,3,11,14,1702,1413,3115,2766
0130-001,2012,3,11,15,1878,1428,3306,3115
0130-001,2012,3,11,16,1843,1438,3281,3306
0130-001,2012,3,11,17,1756,1407,3163,3281
0130-001,2012,3,11,18,1908,1518,3426,3163
0130-001,2012,3,11,19,1896,1354,3250,3426
0130-001,2012,3,11,20,1867,1042,2909,3250
0130-001,2012,3,11,21,1618,1066,2684,2909
0130-001,2012,3,11,22,1511,798,2309,2684
0130-001,2012,3,11,23,898,526,1424,2309
0130-001,2012,3,11,24,558,361,919,1424
0130-001,2012,3,12,1,308,241,549,919
0130-001,2012,3,12,2,178,155,333,549
0130-001,2012,3,12,3,135,111,246,333
0130-001,2012,3,12,4,111,131,242,246
0130-001,2012,3,12,5,151,212,363,242
0130-001,2012,3,12,6,321,356,677,363
0130-001,2012,3,12,7,1286,794,2080,677
0130-001,2012,3,12,8,2403,1770,4173,2080
0130-001,2012,3,12,9,2112,2035,4147,4173
0130-001,2012,3,12,10,1758,1772,3530,4147
0130-001,2012,3,12,11,1765,1622,3387,3530
0130-001,2012,3,12,12,1624,1570,3194,3387
0130-001,2012,3,12,13,1430,1443,2873,3194
0130-001,2012,3,12,14,1687,1656,3343,2873
0130-001,2012,3,12,15,1764,1779,3543,3343
0130-001,2012,3,12,16,1677,1836,3513,3543
0130-001,2012,3,12,17,1679,1823,3502,3513
0130-001,2012,3,12,18,1683,2134,3817,3502
0130-001,2012,3,12,19,1680,2228,3908,3817
0130-001,2012,3,12,20,1365,1741,3106,3908
0130-001,2012,3,12,21,1156,1647,2803,3106
0130-001,2012,3,12,22,1171,1283,2454,2803
0130-001,2012,3,12,23,846,769,1615,2454
0130-001,2012,3,12,24,571,480,1051,1615
0130-001,2012,3,13,1,367,330,697,1051
0130-001,2012,3,13,2,243,206,449,697
0130-001,2012,3,13,3,185,152,337,449
0130-001,2012,3,13,4,128,141,269,337
0130-001,2012,3,13,5,166,235,401,269
0130-001,2012,3,13,6,310,339,649,401
0130-001,2012,3,13,7,1050,702,1752,649
0130-001,2012,3,13,8,2098,1730,3828,1752
0130-001,2012,3,13,9,2051,1903,3954,3828
0130-001,2012,3,13,10,1779,1735,3514,3954
0130-001,2012,3,13,11,1733,1699,3432,3514
0130-001,2012,3,13,12,1495,1512,3007,3432
0130-001,2012,3,13,13,1375,1386,2761,3007
0130-001,2012,3,13,14,1727,1595,3322,2761
0130-001,2012,3,13,15,1694,1654,3348,3322
0130-001,2012,3,13,16,1644,1757,3401,3348
0130-001,2012,3,13,17,1628,1774,3402,3401
0130-001,2012,3,13,18,1668,2105,3773,3402
0130-001,2012,3,13,19,1672,2274,3946,3773
0130-001,2012,3,13,20,1360,1784,3144,3946
0130-001,2012,3,13,21,1208,1605,2813,3144
0130-001,2012,3,13,22,1187,1333,2520,2813
0130-001,2012,3,13,23,918,773,1691,2520
0130-001,2012,3,13,24,612,477,1089,1691
0130-001,2012,3,14,1,405,317,722,1089
0130-001,2012,3,14,2,257,239,496,722
0130-001,2012,3,14,3,183,175,358,496
0130-001,2012,3,14,4,152,146,298,358
0130-001,2012,3,14,5,170,223,393,298
0130-001,2012,3,14,6,302,336,638,393
0130-001,2012,3,14,7,1134,735,1869,638
0130-001,2012,3,14,8,2368,1770,4138,1869
0130-001,2012,3,14,9,2095,1988,4083,4138
0130-001,2012,3,14,10,1769,1739,3508,4083
0130-001,2012,3,14,11,1737,1630,3367,3508
0130-001,2012,3,14,12,1615,1566,3181,3367
0130-001,2012,3,14,13,1400,1451,2851,3181
0130-001,2012,3,14,14,1650,1652,3302,2851
0130-001,2012,3,14,15,1774,1676,3450,3302
0130-001,2012,3,14,16,1666,1743,3409,3450
0130-001,2012,3,14,17,1631,1785,3416,3409
0130-001,2012,3,14,18,1772,2153,3925,3416
0130-001,2012,3,14,19,1836,2369,4205,3925
0130-001,2012,3,14,20,1367,1948,3315,4205
0130-001,2012,3,14,21,1193,1548,2741,3315
0130-001,2012,3,14,22,1264,1252,2516,2741
0130-001,2012,3,14,23,898,820,1718,2516
0130-001,2012,3,14,24,634,494,1128,1718
0130-001,2012,3,15,1,413,358,771,1128
0130-001,2012,3,15,2,261,251,512,771
0130-001,2012,3,15,3,206,169,375,512
0130-001,2012,3,15,4,158,157,315,375
0130-001,2012,3,15,5,167,240,407,315
0130-001,2012,3,15,6,319,362,681,407
0130-001,2012,3,15,7,1098,736,1834,681
0130-001,2012,3,15,8,2233,1733,3966,1834
0130-001,2012,3,15,9,2137,2001,4138,3966
0130-001,2012,3,15,10,1789,1835,3624,4138
0130-001,2012,3,15,11,1776,1668,3444,3624
0130-001,2012,3,15,12,1651,1585,3236,3444
0130-001,2012,3,15,13,1382,1454,2836,3236
0130-001,2012,3,15,14,1706,1720,3426,2836
0130-001,2012,3,15,15,1773,1757,3530,3426
0130-001,2012,3,15,16,1660,1769,3429,3530
0130-001,2012,3,15,17,1721,1842,3563,3429
0130-001,2012,3,15,18,1671,2191,3862,3563
0130-001,2012,3,15,19,1805,2363,4168,3862
0130-001,2012,3,15,20,1419,1848,3267,4168
0130-001,2012,3,15,21,1249,1635,2884,3267
0130-001,2012,3,15,22,1212,1346,2558,2884
0130-001,2012,3,15,23,960,823,1783,2558
0130-001,2012,3,15,24,641,541,1182,1783
0130-001,2012,3,16,1,422,346,768,1182
0130-001,2012,3,16,2,275,252,527,768
0130-001,2012,3,16,3,218,201,419,527
0130-001,2012,3,16,4,159,160,319,419
0130-001,2012,3,16,5,164,230,394,319
0130-001,2012,3,16,6,300,294,594,394
0130-001,2012,3,16,7,954,621,1575,594
0130-001,2012,3,16,8,2235,1668,3903,1575
0130-001,2012,3,16,9,2098,1956,4054,3903
0130-001,2012,3,16,10,1692,1772,3464,4054
0130-001,2012,3,16,11,1749,1738,3487,3464
0130-001,2012,3,16,12,1579,1713,3292,3487
0130-001,2012,3,16,13,1438,1555,2993,3292
0130-001,2012,3,16,14,1601,1684,3285,2993
0130-001,2012,3,16,15,1766,1848,3614,3285
0130-001,2012,3,16,16,1732,1816,3548,3614
0130-001,2012,3,16,17,1712,1858,3570,3548
0130-001,2012,3,16,18,1693,2142,3835,3570
0130-001,2012,3,16,19,1824,2240,4064,3835
0130-001,2012,3,16,20,1492,1956,3448,4064
0130-001,2012,3,16,21,1190,1675,2865,3448
0130-001,2012,3,16,22,1226,1269,2495,2865
0130-001,2012,3,16,23,925,811,1736,2495
0130-001,2012,3,16,24,644,556,1200,1736
0130-001,2012,3,17,1,462,394,856,1200
0130-001,2012,3,17,2,363,302,665,856
0130-001,2012,3,17,3,244,240,484,665
0130-001,2012,3,17,4,227,185,412,484
0130-001,2012,3,17,5,190,256,446,412
0130-001,2012,3,17,6,278,325,603,446
0130-001,2012,3,17,7,606,502,1108,603
0130-001,2012,3,17,8,1291,1018,2309,1108
0130-001,2012,3,17,9,1539,1576,3115,2309
0130-001,2012,3,17,10,1561,1661,3222,3115
0130-001,2012,3,17,11,1619,1948,3567,3222
0130-001,2012,3,17,12,1670,2143,3813,3567
0130-001,2012,3,17,13,1633,2217,3850,3813
0130-001,2012,3,17,14,1716,2191,3907,3850
0130-001,2012,3,17,15,1835,1607,3442,3907
0130-001,2012,3,17,16,1714,1995,3709,3442
0130-001,2012,3,17,17,1683,1910,3593,3709
0130-001,2012,3,17,18,2036,1863,3899,3593
0130-001,2012,3,17,19,1627,1861,3488,3899
0130-001,2012,3,17,20,1305,1277,2582,3488
0130-001,2012,3,17,21,1169,1137,2306,2582
0130-001,2012,3,17,22,1030,887,1917,2306
0130-001,2012,3,17,23,827,619,1446,1917
0130-001,2012,3,17,24,614,511,1125,1446
0130-001,2012,3,18,1,422,355,777,1125
0130-001,2012,3,18,2,280,265,545,777
0130-001,2012,3,18,3,245,152,397,545
0130-001,2012,3,18,4,196,190,386,397
0130-001,2012,3,18,5,205,182,387,386
0130-001,2012,3,18,6,247,293,540,387
0130-001,2012,3,18,7,447,385,832,540
0130-001,2012,3,18,8,577,609,1186,832
0130-001,2012,3,18,9,784,886,1670,1186
0130-001,2012,3,18,10,866,958,1824,1670
0130-001,2012,3,18,11,1099,1291,2390,1824
0130-001,2012,3,18,12,1100,1280,2380,2390
0130-001,2012,3,18,13,1314,1402,2716,2380
0130-001,2012,3,18,14,1409,1427,2836,2716
0130-001,2012,3,18,15,1575,1429,3004,2836
0130-001,2012,3,18,16,1884,1455,3339,3004
0130-001,2012,3,18,17,1868,1472,3340,3339
0130-001,2012,3,18,18,1975,1472,3447,3340
0130-001,2012,3,18,19,1810,1187,2997,3447
0130-001,2012,3,18,20,1213,1008,2221,2997
0130-001,2012,3,18,21,1082,1062,2144,2221
0130-001,2012,3,18,22,918,696,1614,2144
0130-001,2012,3,18,23,669,490,1159,1614
0130-001,2012,3,18,24,431,312,743,1159
0130-001,2012,3,19,1,289,236,525,743
0130-001,2012,3,19,2,189,138,327,525
0130-001,2012,3,19,3,152,106,258,327
0130-001,2012,3,19,4,96,113,209,258
0130-001,2012,3,19,5,143,234,377,209
0130-001,2012,3,19,6,346,345,691,377
0130-001,2012,3,19,7,1250,810,2060,691
0130-001,2012,3,19,8,2395,1826,4221,2060
0130-001,2012,3,19,9,2234,2060,4294,4221
0130-001,2012,3,19,10,1730,1758,3488,4294
0130-001,2012,3,19,11,1672,1753,3425,3488
0130-001,2012,3,19,12,1646,1649,3295,3425
0130-001,2012,3,19,13,1499,1427,2926,3295
0130-001,2012,3,19,14,1746,1675,3421,2926
0130-001,2012,3,19,15,1736,1746,3482,3421
0130-001,2012,3,19,16,1793,1855,3648,3482
0130-001,2012,3,19,17,1678,1799,3477,3648
0130-001,2012,3,19,18,1663,2178,3841,3477
0130-001,2012,3,19,19,1807,2324,4131,3841
0130-001,2012,3,19,20,1482,1794,3276,4131
0130-001,2012,3,19,21,1220,1565,2785,3276
0130-001,2012,3,19,22,1168,1298,2466,2785
0130-001,2012,3,19,23,843,760,1603,2466
0130-001,2012,3,19,24,519,494,1013,1603
0130-001,2012,3,20,1,364,259,623,1013
0130-001,2012,3,20,2,203,211,414,623
0130-001,2012,3,20,3,188,161,349,414
0130-001,2012,3,20,4,132,154,286,349
0130-001,2012,3,20,5,168,231,399,286
0130-001,2012,3,20,6,319,346,665,399
0130-001,2012,3,20,7,1171,736,1907,665
0130-001,2012,3,20,8,2257,1908,4165,1907
0130-001,2012,3,20,9,2063,2025,4088,4165
0130-001,2012,3,20,10,1895,1763,3658,4088
0130-001,2012,3,20,11,1775,1661,3436,3658
0130-001,2012,3,20,12,1620,1601,3221,3436
0130-001,2012,3,20,13,1492,1457,2949,3221
0130-001,2012,3,20,14,1609,1747,3356,2949
0130-001,2012,3,20,15,1810,1770,3580,3356
0130-001,2012,3,20,16,1733,1882,3615,3580
0130-001,2012,3,20,17,1661,1889,3550,3615
0130-001,2012,3,20,18,1791,2210,4001,3550
0130-001,2012,3,20,19,1776,2288,4064,4001
0130-001,2012,3,20,20,1294,1683,2977,4064
0130-001,2012,3,20,21,1203,1658,2861,2977
0130-001,2012,3,20,22,1160,1276,2436,2861
0130-001,2012,3,20,23,845,789,1634,2436
0130-001,2012,3,20,24,526,461,987,1634
0130-001,2012,3,21,1,416,317,733,987
0130-001,2012,3,21,2,228,232,460,733
0130-001,2012,3,21,3,191,169,360,460
0130-001,2012,3,21,4,139,143,282,360
0130-001,2012,3,21,5,174,222,396,282
0130-001,2012,3,21,6,336,333,669,396
0130-001,2012,3,21,7,1128,714,1842,669
0130-001,2012,3,21,8,2416,1800,4216,1842
0130-001,2012,3,21,9,2046,2018,4064,4216
0130-001,2012,3,21,10,1660,1845,3505,4064
0130-001,2012,3,21,11,1749,1585,3334,3505
0130-001,2012,3,21,12,1616,1504,3120,3334
0130-001,2012,3,21,13,1491,1491,2982,3120
0130-001,2012,3,21,14,1639,1643,3282,2982
0130-001,2012,3,21,15,1778,1660,3438,3282
0130-001,2012,3,21,16,1690,1787,3477,3438
0130-001,2012,3,21,17,1652,1825,3477,3477
0130-001,2012,3,21,18,1936,2270,4206,3477
0130-001,2012,3,21,19,1782,2455,4237,4206
0130-001,2012,3,21,20,1441,1856,3297,4237
0130-001,2012,3,21,21,1240,1494,2734,3297
0130-001,2012,3,21,22,1273,1218,2491,2734
0130-001,2012,3,21,23,926,751,1677,2491
0130-001,2012,3,21,24,567,504,1071,1677
0130-001,2012,3,22,1,407,311,718,1071
0130-001,2012,3,22,2,210,229,439,718
0130-001,2012,3,22,3,188,188,376,439
0130-001,2012,3,22,4,185,176,361,376
0130-001,2012,3,22,5,156,219,375,361
0130-001,2012,3,22,6,303,322,625,375
0130-001,2012,3,22,7,1093,745,1838,625
0130-001,2012,3,22,8,2261,1832,4093,1838
0130-001,2012,3,22,9,2056,1968,4024,4093
0130-001,2012,3,22,10,1763,1691,3454,4024
0130-001,2012,3,22,11,1757,1607,3364,3454
0130-001,2012,3,22,12,1553,1499,3052,3364
0130-001,2012,3,22,13,1406,1384,2790,3052
0130-001,2012,3,22,14,1677,1681,3358,2790
0130-001,2012,3,22,15,1763,1686,3449,3358
0130-001,2012,3,22,16,1722,1806,3528,3449
0130-001,2012,3,22,17,1654,1867,3521,3528
0130-001,2012,3,22,18,1677,2261,3938,3521
0130-001,2012,3,22,19,1796,2372,4168,3938
0130-001,2012,3,22,20,1361,1641,3002,4168
0130-001,2012,3,22,21,1156,1591,2747,3002
0130-001,2012,3,22,22,1103,1241,2344,2747
0130-001,2012,3,22,23,967,765,1732,2344
0130-001,2012,3,22,24,574,503,1077,1732
0130-001,2012,3,23,1,417,353,770,1077
0130-001,2012,3,23,2,262,246,508,770
0130-001,2012,3,23,3,222,203,425,508
0130-001,2012,3,23,4,140,149,289,425
0130-001,2012,3,23,5,164,229,393,289
0130-001,2012,3,23,6,292,303,595,393
0130-001,2012,3,23,7,983,630,1613,595
0130-001,2012,3,23,8,2273,1684,3957,1613
0130-001,2012,3,23,9,2049,1904,3953,3957
0130-001,2012,3,23,10,1676,1745,3421,3953
0130-001,2012,3,23,11,1654,1712,3366,3421
0130-001,2012,3,23,12,1506,1657,3163,3366
0130-001,2012,3,23,13,1376,1498,2874,3163
0130-001,2012,3,23,14,1594,1671,3265,2874
0130-001,2012,3,23,15,1742,1701,3443,3265
0130-001,2012,3,23,16,1719,1726,3445,3443
0130-001,2012,3,23,17,1628,1798,3426,3445
0130-001,2012,3,23,18,1868,2155,4023,3426
0130-001,2012,3,23,19,1702,2250,3952,4023
0130-001,2012,3,23,20,1436,1934,3370,3952
0130-001,2012,3,23,21,1196,1563,2759,3370
0130-001,2012,3,23,22,1132,1287,2419,2759
0130-001,2012,3,23,23,907,775,1682,2419
0130-001,2012,3,23,24,687,573,1260,1682
0130-001,2012,3,24,1,486,412,898,1260
0130-001,2012,3,24,2,320,317,637,898
0130-001,2012,3,24,3,230,214,444,637
0130-001,2012,3,24,4,210,192,402,444
0130-001,2012,3,24,5,181,243,424,402
0130-001,2012,3,24,6,325,335,660,424
0130-001,2012,3,24,7,714,590,1304,660
0130-001,2012,3,24,8,1301,1059,2360,1304
0130-001,2012,3,24,9,1483,1574,3057,2360
0130-001,2012,3,24,10,1531,1710,3241,3057
0130-001,2012,3,24,11,1662,2013,3675,3241
0130-001,2012,3,24,12,1776,2215,3991,3675
0130-001,2012,3,24,13,1822,2273,4095,3991
0130-001,2012,3,24,14,1755,2230,3985,4095
0130-001,2012,3,24,15,1814,2180,3994,3985
0130-001,2012,3,24,16,1904,2041,3945,3994
0130-001,2012,3,24,17,1909,2060,3969,3945
0130-001,2012,3,24,18,1941,2149,4090,3969
0130-001,2012,3,24,19,1950,1965,3915,4090
0130-001,2012,3,24,20,1462,1448,2910,3915
0130-001,2012,3,24,21,1154,1094,2248,2910
0130-001,2012,3,24,22,1028,850,1878,2248
0130-001,2012,3,24,23,788,671,1459,1878
0130-001,2012,3,24,24,560,491,1051,1459
0130-001,2012,3,25,1,405,329,734,1051
0130-001,2012,3,25,2,319,234,553,734
0130-001,2012,3,25,3,227,184,411,553
0130-001,2012,3,25,4,155,159,314,411
0130-001,2012,3,25,5,185,184,369,314
0130-001,2012,3,25,6,223,250,473,369
0130-001,2012,3,25,7,467,435,902,473
0130-001,2012,3,25,8,688,618,1306,902
0130-001,2012,3,25,9,775,925,1700,1306
0130-001,2012,3,25,10,957,1024,1981,1700
0130-001,2012,3,25,11,1147,1368,2515,1981
0130-001,2012,3,25,12,1129,1443,2572,2515
0130-001,2012,3,25,13,1287,1448,2735,2572
0130-001,2012,3,25,14,1475,1414,2889,2735
0130-001,2012,3,25,15,1613,1421,3034,2889
0130-001,2012,3,25,16,1932,1473,3405,3034
0130-001,2012,3,25,17,1810,1430,3240,3405
0130-001,2012,3,25,18,2027,1394,3421,3240
0130-001,2012,3,25,19,1892,1220,3112,3421
0130-001,2012,3,25,20,1474,1013,2487,3112
0130-001,2012,3,25,21,1206,933,2139,2487
0130-001,2012,3,25,22,950,689,1639,2139
0130-001,2012,3,25,23,692,503,1195,1639
0130-001,2012,3,25,24,482,309,791,1195
0130-001,2012,3,26,1,284,218,502,791
0130-001,2012,3,26,2,169,140,309,502
0130-001,2012,3,26,3,124,94,218,309
0130-001,2012,3,26,4,115,129,244,218
0130-001,2012,3,26,5,142,198,340,244
0130-001,2012,3,26,6,338,358,696,340
0130-001,2012,3,26,7,1316,772,2088,696
0130-001,2012,3,26,8,2421,1824,4245,2088
0130-001,2012,3,26,9,2292,2072,4364,4245
0130-001,2012,3,26,10,1756,1749,3505,4364
0130-001,2012,3,26,11,1766,1710,3476,3505
0130-001,2012,3,26,12,1673,1599,3272,3476
0130-001,2012,3,26,13,1518,1471,2989,3272
0130-001,2012,3,26,14,1750,1689,3439,2989
0130-001,2012,3,26,15,1812,1905,3717,3439
0130-001,2012,3,26,16,1748,1827,3575,3717
0130-001,2012,3,26,17,1706,1780,3486,3575
0130-001,2012,3,26,18,1761,2133,3894,3486
0130-001,2012,3,26,19,1735,2339,4074,3894
0130-001,2012,3,26,20,1410,1695,3105,4074
0130-001,2012,3,26,21,1176,1634,2810,3105
0130-001,2012,3,26,22,1122,1278,2400,2810
0130-001,2012,3,26,23,774,756,1530,2400
0130-001,2012,3,26,24,492,448,940,1530
0130-001,2012,3,27,1,350,330,680,940
0130-001,2012,3,27,2,221,224,445,680
0130-001,2012,3,27,3,172,158,330,445
0130-001,2012,3,27,4,150,149,299,330
0130-001,2012,3,27,5,166,220,386,299
0130-001,2012,3,27,6,326,329,655,386
0130-001,2012,3,27,7,1198,753,1951,655
0130-001,2012,3,27,8,2240,1789,4029,1951
0130-001,2012,3,27,9,2133,1961,4094,4029
0130-001,2012,3,27,10,1876,1680,3556,4094
0130-001,2012,3,27,11,1778,1606,3384,3556
0130-001,2012,3,27,12,1569,1589,3158,3384
0130-001,2012,3,27,13,1452,1508,2960,3158
0130-001,2012,3,27,14,1647,1628,3275,2960
0130-001,2012,3,27,15,1761,1686,3447,3275
0130-001,2012,3,27,16,1788,1967,3755,3447
0130-001,2012,3,27,17,1746,1827,3573,3755
0130-001,2012,3,27,18,1740,2198,3938,3573
0130-001,2012,3,27,19,1777,2307,4084,3938
0130-001,2012,3,27,20,1333,1674,3007,4084
0130-001,2012,3,27,21,1176,1555,2731,3007
0130-001,2012,3,27,22,1140,1386,2526,2731
0130-001,2012,3,27,23,886,798,1684,2526
0130-001,2012,3,27,24,587,520,1107,1684
0130-001,2012,3,28,1,362,327,689,1107
0130-001,2012,3,28,2,252,225,477,689
0130-001,2012,3,28,3,187,173,360,477
0130-001,2012,3,28,4,154,181,335,360
0130-001,2012,3,28,5,167,241,408,335
0130-001,2012,3,28,6,350,361,711,408
0130-001,2012,3,28,7,1203,766,1969,711
0130-001,2012,3,28,8,2335,1737,4072,1969
0130-001,2012,3,28,9,2170,2011,4181,4072
0130-001,2012,3,28,10,1708,1779,3487,4181
0130-001,2012,3,28,11,1782,1585,3367,3487
0130-001,2012,3,28,12,1499,1375,2874,3367
0130-001,2012,3,28,13,1418,1416,2834,2874
0130-001,2012,3,28,14,1649,1738,3387,2834
0130-001,2012,3,28,15,1787,1783,3570,3387
0130-001,2012,3,28,16,1721,1729,3450,3570
0130-001,2012,3,28,17,1688,1758,3446,3450
0130-001,2012,3,28,18,1780,2221,4001,3446
0130-001,2012,3,28,19,1869,2390,4259,4001
0130-001,2012,3,28,20,1408,1864,3272,4259
0130-001,2012,3,28,21,1158,1557,2715,3272
0130-001,2012,3,28,22,1218,1321,2539,2715
0130-001,2012,3,28,23,923,791,1714,2539
0130-001,2012,3,28,24,650,600,1250,1714
0130-001,2012,3,29,1,414,353,767,1250
0130-001,2012,3,29,2,275,236,511,767
0130-001,2012,3,29,3,247,231,478,511
0130-001,2012,3,29,4,152,146,298,478
0130-001,2012,3,29,5,188,233,421,298
0130-001,2012,3,29,6,336,356,692,421
0130-001,2012,3,29,7,1132,754,1886,692
0130-001,2012,3,29,8,2303,1664,3967,1886
0130-001,2012,3,29,9,2040,2059,4099,3967
0130-001,2012,3,29,10,1921,1822,3743,4099
0130-001,2012,3,29,11,1762,1663,3425,3743
0130-001,2012,3,29,12,1528,1558,3086,3425
0130-001,2012,3,29,13,1435,1492,2927,3086
0130-001,2012,3,29,14,1741,1706,3447,2927
0130-001,2012,3,29,15,1743,1771,3514,3447
0130-001,2012,3,29,16,1726,1841,3567,3514
0130-001,2012,3,29,17,1714,1866,3580,3567
0130-001,2012,3,29,18,1753,2153,3906,3580
0130-001,2012,3,29,19,1815,2408,4223,3906
0130-001,2012,3,29,20,1426,1754,3180,4223
0130-001,2012,3,29,21,1206,1632,2838,3180
0130-001,2012,3,29,22,1182,1312,2494,2838
0130-001,2012,3,29,23,927,788,1715,2494
0130-001,2012,3,29,24,686,555,1241,1715
0130-001,2012,3,30,1,428,340,768,1241
0130-001,2012,3,30,2,288,257,545,768
0130-001,2012,3,30,3,213,199,412,545
0130-001,2012,3,30,4,178,170,348,412
0130-001,2012,3,30,5,164,231,395,348
0130-001,2012,3,30,6,309,285,594,395
0130-001,2012,3,30,7,924,612,1536,594
0130-001,2012,3,30,8,2197,1653,3850,1536
0130-001,2012,3,30,9,2147,2008,4155,3850
0130-001,2012,3,30,10,1709,1798,3507,4155
0130-001,2012,3,30,11,1844,1764,3608,3507
0130-001,2012,3,30,12,1652,1769,3421,3608
0130-001,2012,3,30,13,1499,1612,3111,3421
0130-001,2012,3,30,14,1608,1696,3304,3111
0130-001,2012,3,30,15,1839,1752,3591,3304
0130-001,2012,3,30,16,1762,1899,3661,3591
0130-001,2012,3,30,17,1752,1974,3726,3661
0130-001,2012,3,30,18,1728,2229,3957,3726
0130-001,2012,3,30,19,1881,2397,4278,3957
0130-001,2012,3,30,20,1499,1941,3440,4278
0130-001,2012,3,30,21,1257,1620,2877,3440
0130-001,2012,3,30,22,1173,1281,2454,2877
0130-001,2012,3,30,23,998,892,1890,2454
0130-001,2012,3,30,24,733,571,1304,1890
0130-001,2012,3,31,1,503,449,952,1304
0130-001,2012,3,31,2,360,305,665,952
0130-001,2012,3,31,3,237,223,460,665
0130-001,2012,3,31,4,221,216,437,460
0130-001,2012,3,31,5,202,261,463,437
0130-001,2012,3,31,6,330,337,667,463
0130-001,2012,3,31,7,798,585,1383,667
0130-001,2012,3,31,8,1394,1100,2494,1383
0130-001,2012,3,31,9,1516,1708,3224,2494
0130-001,2012,3,31,10,1632,1930,3562,3224
0130-001,2012,3,31,11,1716,2137,3853,3562
0130-001,2012,3,31,12,1662,2301,3963,3853
0130-001,2012,3,31,13,1622,2322,3944,3963
0130-001,2012,3,31,14,1811,2286,4097,3944
0130-001,2012,3,31,15,1835,2256,4091,4097
0130-001,2012,3,31,16,1846,2135,3981,4091
0130-001,2012,3,31,17,1988,2069,4057,3981
0130-001,2012,3,31,18,1965,2041,4006,4057
0130-001,2012,3,31,19,2012,1919,3931,4006
0130-001,2012,3,31,20,1559,1531,3090,3931
0130-001,2012,3,31,21,1186,1060,2246,3090
0130-001,2012,3,31,22,1077,960,2037,2246
0130-001,2012,3,31,23,797,598,1395,2037
0130-001,2012,3,31,24,591,455,1046,1395
0130-001,2012,4,1,1,354,309,663,1046
0130-001,2012,4,1,2,297,222,519,663
0130-001,2012,4,1,3,234,190,424,519
0130-001,2012,4,1,4,168,139,307,424
0130-001,2012,4,1,5,182,156,338,307
0130-001,2012,4,1,6,208,253,461,338
0130-001,2012,4,1,7,459,439,898,461
0130-001,2012,4,1,8,632,636,1268,898
0130-001,2012,4,1,9,793,960,1753,1268
0130-001,2012,4,1,10,971,1135,2106,1753
0130-001,2012,4,1,11,1130,1317,2447,2106
0130-001,2012,4,1,12,1170,1511,2681,2447
0130-001,2012,4,1,13,1263,1488,2751,2681
0130-001,2012,4,1,14,1717,1355,3072,2751
0130-001,2012,4,1,15,1896,1463,3359,3072
0130-001,2012,4,1,16,1865,1553,3418,3359
0130-001,2012,4,1,17,1787,1462,3249,3418
0130-001,2012,4,1,18,1811,1623,3434,3249
0130-001,2012,4,1,19,1806,1417,3223,3434
0130-001,2012,4,1,20,1797,985,2782,3223
0130-001,2012,4,1,21,1583,1157,2740,2782
0130-001,2012,4,1,22,1454,793,2247,2740
0130-001,2012,4,1,23,795,499,1294,2247
0130-001,2012,4,1,24,506,358,864,1294
0130-001,2012,4,2,1,288,223,511,864
0130-001,2012,4,2,2,172,159,331,511
0130-001,2012,4,2,3,145,107,252,331
0130-001,2012,4,2,4,107,131,238,252
0130-001,2012,4,2,5,167,216,383,238
0130-001,2012,4,2,6,314,372,686,383
0130-001,2012,4,2,7,1275,779,2054,686
0130-001,2012,4,2,8,2376,1732,4108,2054
0130-001,2012,4,2,9,2125,1979,4104,4108
0130-001,2012,4,2,10,1750,1778,3528,4104
0130-001,2012,4,2,11,1749,1652,3401,3528
0130-001,2012,4,2,12,1611,1564,3175,3401
0130-001,2012,4,2,13,1447,1395,2842,3175
0130-001,2012,4,2,14,1675,1632,3307,2842
0130-001,2012,4,2,15,1799,1802,3601,3307
0130-001,2012,4,2,16,1706,1829,3535,3601
0130-001,2012,4,2,17,1693,1776,3469,3535
0130-001,2012,4,2,18,1610,2041,3651,3469
0130-001,2012,4,2,19,1594,2207,3801,3651
0130-001,2012,4,2,20,1313,1650,2963,3801
0130-001,2012,4,2,21,1108,1589,2697,2963
0130-001,2012,4,2,22,1176,1257,2433,2697
0130-001,2012,4,2,23,819,742,1561,2433
0130-001,2012,4,2,24,543,477,1020,1561
0130-001,2012,4,3,1,374,330,704,1020
0130-001,2012,4,3,2,220,200,420,704
0130-001,2012,4,3,3,188,145,333,420
0130-001,2012,4,3,4,124,153,277,333
0130-001,2012,4,3,5,166,222,388,277
0130-001,2012,4,3,6,268,323,591,388
0130-001,2012,4,3,7,940,609,1549,591
0130-001,2012,4,3,8,2056,1667,3723,1549
0130-001,2012,4,3,9,2030,1868,3898,3723
0130-001,2012,4,3,10,1761,1655,3416,3898
0130-001,2012,4,3,11,1605,1650,3255,3416
0130-001,2012,4,3,12,1446,1405,2851,3255
0130-001,2012,4,3,13,1335,1298,2633,2851
0130-001,2012,4,3,14,1609,1549,3158,2633
0130-001,2012,4,3,15,1692,1603,3295,3158
0130-001,2012,4,3,16,1575,1685,3260,3295
0130-001,2012,4,3,17,1599,1783,3382,3260
0130-001,2012,4,3,18,1653,2026,3679,3382
0130-001,2012,4,3,19,1710,2214,3924,3679
0130-001,2012,4,3,20,1314,1721,3035,3924
0130-001,2012,4,3,21,1163,1545,2708,3035
0130-001,2012,4,3,22,1115,1353,2468,2708
0130-001,2012,4,3,23,837,759,1596,2468
0130-001,2012,4,3,24,557,441,998,1596
0130-001,2012,4,4,1,379,302,681,998
0130-001,2012,4,4,2,262,234,496,681
0130-001,2012,4,4,3,180,198,378,496
0130-001,2012,4,4,4,150,137,287,378
0130-001,2012,4,4,5,164,207,371,287
0130-001,2012,4,4,6,283,325,608,371
0130-001,2012,4,4,7,1080,721,1801,608
0130-001,2012,4,4,8,2395,1712,4107,1801
0130-001,2012,4,4,9,2081,2019,4100,4107
0130-001,2012,4,4,10,1780,1696,3476,4100
0130-001,2012,4,4,11,1723,1644,3367,3476
0130-001,2012,4,4,12,1737,1568,3305,3367
0130-001,2012,4,4,13,1440,1463,2903,3305
0130-001,2012,4,4,14,1630,1683,3313,2903
0130-001,2012,4,4,15,1814,1721,3535,3313
0130-001,2012,4,4,16,1666,1795,3461,3535
0130-001,2012,4,4,17,1678,1821,3499,3461
0130-001,2012,4,4,18,1806,2032,3838,3499
0130-001,2012,4,4,19,1844,2362,4206,3838
0130-001,2012,4,4,20,1324,1946,3270,4206
0130-001,2012,4,4,21,1146,1532,2678,3270
0130-001,2012,4,4,22,1213,1226,2439,2678
0130-001,2012,4,4,23,891,826,1717,2439
0130-001,2012,4,4,24,602,491,1093,1717
0130-001,2012,4,5,1,407,354,761,1093
0130-001,2012,4,5,2,278,239,517,761
0130-001,2012,4,5,3,211,167,378,517
0130-001,2012,4,5,4,162,157,319,378
0130-001,2012,4,5,5,169,239,408,319
0130-001,2012,4,5,6,317,369,686,408
0130-001,2012,4,5,7,1066,723,1789,686
0130-001,2012,4,5,8,2191,1783,3974,1789
0130-001,2012,4,5,9,2147,1996,4143,3974
0130-001,2012,4,5,10,1784,1815,3599,4143
0130-001,2012,4,5,11,1797,1681,3478,3599
0130-001,2012,4,5,12,1667,1604,3271,3478
0130-001,2012,4,5,13,1352,1388,2740,3271
0130-001,2012,4,5,14,1697,1706,3403,2740
0130-001,2012,4,5,15,1779,1745,3524,3403
0130-001,2012,4,5,16,1704,1804,3508,3524
0130-001,2012,4,5,17,1764,1860,3624,3508
0130-001,2012,4,5,18,1685,2180,3865,3624
0130-001,2012,4,5,19,1830,2359,4189,3865
0130-001,2012,4,5,20,1461,1859,3320,4189
0130-001,2012,4,5,21,1209,1594,2803,3320
0130-001,2012,4,5,22,1212,1390,2602,2803
0130-001,2012,4,5,23,950,804,1754,2602
0130-001,2012,4,5,24,653,536,1189,1754
0130-001,2012,4,6,1,383,365,748,1189
0130-001,2012,4,6,2,256,260,516,748
0130-001,2012,4,6,3,214,175,389,516
0130-001,2012,4,6,4,171,156,327,389
0130-001,2012,4,6,5,182,242,424,327
0130-001,2012,4,6,6,320,329,649,424
0130-001,2012,4,6,7,1166,742,1908,649
0130-001,2012,4,6,8,2280,1767,4047,1908
0130-001,2012,4,6,9,2231,1986,4217,4047
0130-001,2012,4,6,10,1810,1778,3588,4217
0130-001,2012,4,6,11,1818,1801,3619,3588
0130-001,2012,4,6,12,1590,1737,3327,3619
0130-001,2012,4,6,13,1389,1489,2878,3327
0130-001,2012,4,6,14,1627,1751,3378,2878
0130-001,2012,4,6,15,1745,1849,3594,3378
0130-001,2012,4,6,16,1785,1727,3512,3594
0130-001,2012,4,6,17,1717,1860,3577,3512
0130-001,2012,4,6,18,1856,2250,4106,3577
0130-001,2012,4,6,19,1943,2316,4259,4106
0130-001,2012,4,6,20,1531,2196,3727,4259
0130-001,2012,4,6,21,1285,1660,2945,3727
0130-001,2012,4,6,22,1248,1333,2581,2945
0130-001,2012,4,6,23,1002,860,1862,2581
0130-001,2012,4,6,24,692,555,1247,1862
0130-001,2012,4,7,1,489,446,935,1247
0130-001,2012,4,7,2,345,292,637,935
0130-001,2012,4,7,3,277,244,521,637
0130-001,2012,4,7,4,195,185,380,521
0130-001,2012,4,7,5,205,257,462,380
0130-001,2012,4,7,6,322,358,680,462
0130-001,2012,4,7,7,796,653,1449,680
0130-001,2012,4,7,8,1407,1136,2543,1449
0130-001,2012,4,7,9,1551,1672,3223,2543
0130-001,2012,4,7,10,1602,1792,3394,3223
0130-001,2012,4,7,11,1636,2068,3704,3394
0130-001,2012,4,7,12,1579,2238,3817,3704
0130-001,2012,4,7,13,1518,2331,3849,3817
0130-001,2012,4,7,14,1610,2280,3890,3849
0130-001,2012,4,7,15,1702,2232,3934,3890
0130-001,2012,4,7,16,1728,2077,3805,3934
0130-001,2012,4,7,17,1969,2047,4016,3805
0130-001,2012,4,7,18,2034,1979,4013,4016
0130-001,2012,4,7,19,2037,1889,3926,4013
0130-001,2012,4,7,20,1535,1317,2852,3926
0130-001,2012,4,7,21,1182,1146,2328,2852
0130-001,2012,4,7,22,1096,931,2027,2328
0130-001,2012,4,7,23,794,688,1482,2027
0130-001,2012,4,7,24,605,478,1083,1482
0130-001,2012,4,8,1,397,326,723,1083
0130-001,2012,4,8,2,280,233,513,723
0130-001,2012,4,8,3,224,197,421,513
0130-001,2012,4,8,4,188,142,330,421
0130-001,2012,4,8,5,182,154,336,330
0130-001,2012,4,8,6,221,266,487,336
0130-001,2012,4,8,7,501,441,942,487
0130-001,2012,4,8,8,651,598,1249,942
0130-001,2012,4,8,9,781,972,1753,1249
0130-001,2012,4,8,10,1091,1121,2212,1753
0130-001,2012,4,8,11,1164,1329,2493,2212
0130-001,2012,4,8,12,1011,1320,2331,2493
0130-001,2012,4,8,13,1262,1443,2705,2331
0130-001,2012,4,8,14,1575,1458,3033,2705
0130-001,2012,4,8,15,1801,1362,3163,3033
0130-001,2012,4,8,16,1939,1400,3339,3163
0130-001,2012,4,8,17,1824,1378,3202,3339
0130-001,2012,4,8,18,1994,1444,3438,3202
0130-001,2012,4,8,19,1985,1304,3289,3438
0130-001,2012,4,8,20,1756,1082,2838,3289
0130-001,2012,4,8,21,1600,956,2556,2838
0130-001,2012,4,8,22,1474,758,2232,2556
0130-001,2012,4,8,23,808,526,1334,2232
0130-001,2012,4,8,24,598,359,957,1334
0130-001,2012,4,9,1,319,240,559,957
0130-001,2012,4,9,2,165,158,323,559
0130-001,2012,4,9,3,139,110,249,323
0130-001,2012,4,9,4,106,107,213,249
0130-001,2012,4,9,5,138,193,331,213
0130-001,2012,4,9,6,309,333,642,331
0130-001,2012,4,9,7,1219,774,1993,642
0130-001,2012,4,9,8,2215,1878,4093,1993
0130-001,2012,4,9,9,2253,1871,4124,4093
0130-001,2012,4,9,10,1806,1805,3611,4124
0130-001,2012,4,9,11,1715,1631,3346,3611
0130-001,2012,4,9,12,1635,1544,3179,3346
0130-001,2012,4,9,13,1392,1406,2798,3179
0130-001,2012,4,9,14,1649,1645,3294,2798
0130-001,2012,4,9,15,1740,1768,3508,3294
0130-001,2012,4,9,16,1723,1751,3474,3508
0130-001,2012,4,9,17,1724,1768,3492,3474
0130-001,2012,4,9,18,1670,2114,3784,3492
0130-001,2012,4,9,19,1750,2318,4068,3784
0130-001,2012,4,9,20,1419,1829,3248,4068
0130-001,2012,4,9,21,1184,1668,2852,3248
0130-001,2012,4,9,22,1215,1320,2535,2852
0130-001,2012,4,9,23,862,753,1615,2535
0130-001,2012,4,9,24,548,471,1019,1615
0130-001,2012,4,10,1,393,349,742,1019
0130-001,2012,4,10,2,225,238,463,742
0130-001,2012,4,10,3,180,168,348,463
0130-001,2012,4,10,4,146,139,285,348
0130-001,2012,4,10,5,151,229,380,285
0130-001,2012,4,10,6,295,323,618,380
0130-001,2012,4,10,7,1108,715,1823,618
0130-001,2012,4,10,8,2385,1746,4131,1823
0130-001,2012,4,10,9,2124,1999,4123,4131
0130-001,2012,4,10,10,1775,1798,3573,4123
0130-001,2012,4,10,11,1812,1633,3445,3573
0130-001,2012,4,10,12,1579,1562,3141,3445
0130-001,2012,4,10,13,1439,1418,2857,3141
0130-001,2012,4,10,14,1651,1683,3334,2857
0130-001,2012,4,10,15,1749,1785,3534,3334
0130-001,2012,4,10,16,1637,1776,3413,3534
0130-001,2012,4,10,17,1720,1924,3644,3413
0130-001,2012,4,10,18,1783,2187,3970,3644
0130-001,2012,4,10,19,1742,2317,4059,3970
0130-001,2012,4,10,20,1419,1799,3218,4059
0130-001,2012,4,10,21,1247,1673,2920,3218
0130-001,2012,4,10,22,1195,1328,2523,2920
0130-001,2012,4,10,23,861,775,1636,2523
0130-001,2012,4,10,24,697,599,1296,1636
0130-001,2012,4,11,1,471,398,869,1296
0130-001,2012,4,11,2,398,305,703,869
0130-001,2012,4,11,3,286,236,522,703
0130-001,2012,4,11,4,233,211,444,522
0130-001,2012,4,11,5,221,233,454,444
0130-001,2012,4,11,6,314,273,587,454
0130-001,2012,4,11,7,660,501,1161,587
0130-001,2012,4,11,8,1266,872,2138,1161
0130-001,2012,4,11,9,1405,1356,2761,2138
0130-001,2012,4,11,10,1467,1522,2989,2761
0130-001,2012,4,11,11,1506,1497,3003,2989
0130-001,2012,4,11,12,1496,1625,3121,3003
0130-001,2012,4,11,13,1428,1534,2962,3121
0130-001,2012,4,11,14,1595,1562,3157,2962
0130-001,2012,4,11,15,1607,1734,3341,3157
0130-001,2012,4,11,16,1646,1773,3419,3341
0130-001,2012,4,11,17,1650,1741,3391,3419
0130-001,2012,4,11,18,1621,1857,3478,3391
0130-001,2012,4,11,19,1476,1734,3210,3478
0130-001,2012,4,11,20,1250,1364,2614,3210
0130-001,2012,4,11,21,1078,1091,2169,2614
0130-001,2012,4,11,22,1026,879,1905,2169
0130-001,2012,4,11,23,796,608,1404,1905
0130-001,2012,4,11,24,561,392,953,1404
0130-001,2012,4,12,1,338,259,597,953
0130-001,2012,4,12,2,245,183,428,597
0130-001,2012,4,12,3,181,146,327,428
0130-001,2012,4,12,4,151,158,309,327
0130-001,2012,4,12,5,129,207,336,309
0130-001,2012,4,12,6,300,322,622,336
0130-001,2012,4,12,7,1186,792,1978,622
0130-001,2012,4,12,8,2280,1783,4063,1978
0130-001,2012,4,12,9,2099,2052,4151,4063
0130-001,2012,4,12,10,1764,1801,3565,4151
0130-001,2012,4,12,11,1798,1686,3484,3565
0130-001,2012,4,12,12,1589,1637,3226,3484
0130-001,2012,4,12,13,1353,1483,2836,3226
0130-001,2012,4,12,14,1686,1665,3351,2836
0130-001,2012,4,12,15,1777,1753,3530,3351
0130-001,2012,4,12,16,1694,1854,3548,3530
0130-001,2012,4,12,17,1645,1761,3406,3548
0130-001,2012,4,12,18,1699,2135,3834,3406
0130-001,2012,4,12,19,1677,2302,3979,3834
0130-001,2012,4,12,20,1323,1660,2983,3979
0130-001,2012,4,12,21,1149,1576,2725,2983
0130-001,2012,4,12,22,1199,1224,2423,2725
0130-001,2012,4,12,23,912,788,1700,2423
0130-001,2012,4,12,24,557,516,1073,1700
0130-001,2012,4,13,1,379,358,737,1073
0130-001,2012,4,13,2,272,246,518,737
0130-001,2012,4,13,3,209,166,375,518
0130-001,2012,4,13,4,159,172,331,375
0130-001,2012,4,13,5,164,248,412,331
0130-001,2012,4,13,6,311,358,669,412
0130-001,2012,4,13,7,1077,739,1816,669
0130-001,2012,4,13,8,2283,1741,4024,1816
0130-001,2012,4,13,9,2189,2020,4209,4024
0130-001,2012,4,13,10,1763,1879,3642,4209
0130-001,2012,4,13,11,1790,1711,3501,3642
0130-001,2012,4,13,12,1698,1702,3400,3501
0130-001,2012,4,13,13,1419,1499,2918,3400
0130-001,2012,4,13,14,1696,1658,3354,2918
0130-001,2012,4,13,15,1729,1859,3588,3354
0130-001,2012,4,13,16,1618,1865,3483,3588
0130-001,2012,4,13,17,1607,1867,3474,3483
0130-001,2012,4,13,18,2046,2271,4317,3474
0130-001,2012,4,13,19,1975,2373,4348,4317
0130-001,2012,4,13,20,1510,1984,3494,4348
0130-001,2012,4,13,21,1259,1744,3003,3494
0130-001,2012,4,13,22,1252,1413,2665,3003
0130-001,2012,4,13,23,987,842,1829,2665
0130-001,2012,4,13,24,706,582,1288,1829
0130-001,2012,4,14,1,485,419,904,1288
0130-001,2012,4,14,2,377,319,696,904
0130-001,2012,4,14,3,259,235,494,696
0130-001,2012,4,14,4,217,191,408,494
0130-001,2012,4,14,5,187,278,465,408
0130-001,2012,4,14,6,339,367,706,465
0130-001,2012,4,14,7,779,642,1421,706
0130-001,2012,4,14,8,1387,1092,2479,1421
0130-001,2012,4,14,9,1507,1731,3238,2479
0130-001,2012,4,14,10,1659,1875,3534,3238
0130-001,2012,4,14,11,1531,2098,3629,3534
0130-001,2012,4,14,12,1551,2213,3764,3629
0130-001,2012,4,14,13,1536,2217,3753,3764
0130-001,2012,4,14,14,1558,2530,4088,3753
0130-001,2012,4,14,15,1700,2278,3978,4088
0130-001,2012,4,14,16,1769,2115,3884,3978
0130-001,2012,4,14,17,1879,2120,3999,3884
0130-001,2012,4,14,18,1935,2077,4012,3999
0130-001,2012,4,14,19,1978,2107,4085,4012
0130-001,2012,4,14,20,1471,1545,3016,4085
0130-001,2012,4,14,21,1283,1162,2445,3016
0130-001,2012,4,14,22,1254,965,2219,2445
0130-001,2012,4,14,23,855,738,1593,2219
0130-001,2012,4,14,24,634,458,1092,1593
0130-001,2012,4,15,1,413,364,777,1092
0130-001,2012,4,15,2,318,261,579,777
0130-001,2012,4,15,3,247,188,435,579
0130-001,2012,4,15,4,197,159,356,435
0130-001,2012,4,15,5,160,149,309,356
0130-001,2012,4,15,6,221,234,455,309
0130-001,2012,4,15,7,521,453,974,455
0130-001,2012,4,15,8,712,709,1421,974
0130-001,2012,4,15,9,791,1022,1813,1421
0130-001,2012,4,15,10,1021,1141,2162,1813
0130-001,2012,4,15,11,1129,1398,2527,2162
0130-001,2012,4,15,12,1086,1363,2449,2527
0130-001,2012,4,15,13,1265,1516,2781,2449
0130-001,2012,4,15,14,1686,1470,3156,2781
0130-001,2012,4,15,15,1860,1393,3253,3156
0130-001,2012,4,15,16,1820,1322,3142,3253
0130-001,2012,4,15,17,1725,1352,3077,3142
0130-001,2012,4,15,18,2005,1412,3417,3077
0130-001,2012,4,15,19,1986,1291,3277,3417
0130-001,2012,4,15,20,1937,1099,3036,3277
0130-001,2012,4,15,21,1652,974,2626,3036
0130-001,2012,4,15,22,1567,803,2370,2626
0130-001,2012,4,15,23,1000,553,1553,2370
0130-001,2012,4,15,24,609,364,973,1553
0130-001,2012,4,16,1,328,258,586,973
0130-001,2012,4,16,2,184,151,335,586
0130-001,2012,4,16,3,124,114,238,335
0130-001,2012,4,16,4,114,130,244,238
0130-001,2012,4,16,5,134,207,341,244
0130-001,2012,4,16,6,327,339,666,341
0130-001,2012,4,16,7,1297,808,2105,666
0130-001,2012,4,16,8,2429,1807,4236,2105
0130-001,2012,4,16,9,2098,2091,4189,4236
0130-001,2012,4,16,10,1766,1766,3532,4189
0130-001,2012,4,16,11,1780,1592,3372,3532
0130-001,2012,4,16,12,1636,1575,3211,3372
0130-001,2012,4,16,13,1413,1490,2903,3211
0130-001,2012,4,16,14,1698,1680,3378,2903
0130-001,2012,4,16,15,1729,1755,3484,3378
0130-001,2012,4,16,16,1648,1842,3490,3484
0130-001,2012,4,16,17,1665,1869,3534,3490
0130-001,2012,4,16,18,1756,2227,3983,3534
0130-001,2012,4,16,19,1766,2249,4015,3983
0130-001,2012,4,16,20,1417,1832,3249,4015
0130-001,2012,4,16,21,1203,1705,2908,3249
0130-001,2012,4,16,22,1165,1308,2473,2908
0130-001,2012,4,16,23,873,796,1669,2473
0130-001,2012,4,16,24,598,482,1080,1669
0130-001,2012,4,17,1,359,329,688,1080
0130-001,2012,4,17,2,266,211,477,688
0130-001,2012,4,17,3,181,158,339,477
0130-001,2012,4,17,4,131,129,260,339
0130-001,2012,4,17,5,165,248,413,260
0130-001,2012,4,17,6,351,354,705,413
0130-001,2012,4,17,7,1159,794,1953,705
0130-001,2012,4,17,8,2140,1792,3932,1953
0130-001,2012,4,17,9,2071,1937,4008,3932
0130-001,2012,4,17,10,1796,1814,3610,4008
0130-001,2012,4,17,11,1860,1748,3608,3610
0130-001,2012,4,17,12,1544,1618,3162,3608
0130-001,2012,4,17,13,1415,1473,2888,3162
0130-001,2012,4,17,14,1844,1640,3484,2888
0130-001,2012,4,17,15,1696,1705,3401,3484
0130-001,2012,4,17,16,1712,1829,3541,3401
0130-001,2012,4,17,17,1656,1765,3421,3541
0130-001,2012,4,17,18,1682,2184,3866,3421
0130-001,2012,4,17,19,1634,2334,3968,3866
0130-001,2012,4,17,20,1405,1846,3251,3968
0130-001,2012,4,17,21,1252,1665,2917,3251
0130-001,2012,4,17,22,1259,1312,2571,2917
0130-001,2012,4,17,23,999,786,1785,2571
0130-001,2012,4,17,24,667,513,1180,1785
0130-001,2012,4,18,1,430,331,761,1180
0130-001,2012,4,18,2,252,244,496,761
0130-001,2012,4,18,3,186,151,337,496
0130-001,2012,4,18,4,153,155,308,337
0130-001,2012,4,18,5,175,238,413,308
0130-001,2012,4,18,6,320,346,666,413
0130-001,2012,4,18,7,1188,749,1937,666
0130-001,2012,4,18,8,2341,1827,4168,1937
0130-001,2012,4,18,9,2109,1956,4065,4168
0130-001,2012,4,18,10,1758,1782,3540,4065
0130-001,2012,4,18,11,1751,1615,3366,3540
0130-001,2012,4,18,12,1492,1564,3056,3366
0130-001,2012,4,18,13,1360,1438,2798,3056
0130-001,2012,4,18,14,1670,1621,3291,2798
0130-001,2012,4,18,15,1733,1631,3364,3291
0130-001,2012,4,18,16,1666,1691,3357,3364
0130-001,2012,4,18,17,1584,1749,3333,3357
0130-001,2012,4,18,18,1738,2274,4012,3333
0130-001,2012,4,18,19,1828,2375,4203,4012
0130-001,2012,4,18,20,1410,1949,3359,4203
0130-001,2012,4,18,21,1239,1563,2802,3359
0130-001,2012,4,18,22,1314,1278,2592,2802
0130-001,2012,4,18,23,904,813,1717,2592
0130-001,2012,4,18,24,665,497,1162,1717
0130-001,2012,4,19,1,419,361,780,1162
0130-001,2012,4,19,2,244,262,506,780
0130-001,2012,4,19,3,201,171,372,506
0130-001,2012,4,19,4,153,157,310,372
0130-001,2012,4,19,5,164,241,405,310
0130-001,2012,4,19,6,321,355,676,405
0130-001,2012,4,19,7,1130,749,1879,676
0130-001,2012,4,19,8,2274,1682,3956,1879
0130-001,2012,4,19,9,2127,2006,4133,3956
0130-001,2012,4,19,10,1793,1854,3647,4133
0130-001,2012,4,19,11,1754,1654,3408,3647
0130-001,2012,4,19,12,1635,1566,3201,3408
0130-001,2012,4,19,13,1411,1520,2931,3201
0130-001,2012,4,19,14,1715,1734,3449,2931
0130-001,2012,4,19,15,1766,1769,3535,3449
0130-001,2012,4,19,16,1615,1734,3349,3535
0130-001,2012,4,19,17,1677,1823,3500,3349
0130-001,2012,4,19,18,1657,2201,3858,3500
0130-001,2012,4,19,19,1779,2367,4146,3858
0130-001,2012,4,19,20,1377,1836,3213,4146
0130-001,2012,4,19,21,1288,1676,2964,3213
0130-001,2012,4,19,22,1211,1301,2512,2964
0130-001,2012,4,19,23,970,842,1812,2512
0130-001,2012,4,19,24,628,546,1174,1812
0130-001,2012,4,20,1,425,401,826,1174
0130-001,2012,4,20,2,270,242,512,826
0130-001,2012,4,20,3,210,203,413,512
0130-001,2012,4,20,4,178,191,369,413
0130-001,2012,4,20,5,181,257,438,369
0130-001,2012,4,20,6,344,369,713,438
0130-001,2012,4,20,7,1155,747,1902,713
0130-001,2012,4,20,8,2231,1689,3920,1902
0130-001,2012,4,20,9,2191,1985,4176,3920
0130-001,2012,4,20,10,1723,1897,3620,4176
0130-001,2012,4,20,11,1748,1655,3403,3620
0130-001,2012,4,20,12,1567,1641,3208,3403
0130-001,2012,4,20,13,1409,1562,2971,3208
0130-001,2012,4,20,14,1806,1703,3509,2971
0130-001,2012,4,20,15,1675,1834,3509,3509
0130-001,2012,4,20,16,1621,1779,3400,3509
0130-001,2012,4,20,17,1659,1838,3497,3400
0130-001,2012,4,20,18,1846,2364,4210,3497
0130-001,2012,4,20,19,1946,2405,4351,4210
0130-001,2012,4,20,20,1580,2196,3776,4351
0130-001,2012,4,20,21,1354,1839,3193,3776
0130-001,2012,4,20,22,1311,1389,2700,3193
0130-001,2012,4,20,23,1029,1043,2072,2700
0130-001,2012,4,20,24,775,656,1431,2072
0130-001,2012,4,21,1,476,443,919,1431
0130-001,2012,4,21,2,381,329,710,919
0130-001,2012,4,21,3,271,238,509,710
0130-001,2012,4,21,4,234,202,436,509
0130-001,2012,4,21,5,234,286,520,436
0130-001,2012,4,21,6,339,391,730,520
0130-001,2012,4,21,7,735,641,1376,730
0130-001,2012,4,21,8,1375,1031,2406,1376
0130-001,2012,4,21,9,1438,1651,3089,2406
0130-001,2012,4,21,10,1528,1603,3131,3089
0130-001,2012,4,21,11,1551,1810,3361,3131
0130-001,2012,4,21,12,1475,1864,3339,3361
0130-001,2012,4,21,13,1592,1865,3457,3339
0130-001,2012,4,21,14,1589,1880,3469,3457
0130-001,2012,4,21,15,1763,1754,3517,3469
0130-001,2012,4,21,16,1713,1622,3335,3517
0130-001,2012,4,21,17,1761,1714,3475,3335
0130-001,2012,4,21,18,1891,1834,3725,3475
0130-001,2012,4,21,19,1647,1729,3376,3725
0130-001,2012,4,21,20,1218,1240,2458,3376
0130-001,2012,4,21,21,1057,984,2041,2458
0130-001,2012,4,21,22,956,828,1784,2041
0130-001,2012,4,21,23,722,580,1302,1784
0130-001,2012,4,21,24,576,405,981,1302
0130-001,2012,4,22,1,378,362,740,981
0130-001,2012,4,22,2,266,227,493,740
0130-001,2012,4,22,3,223,183,406,493
0130-001,2012,4,22,4,171,134,305,406
0130-001,2012,4,22,5,163,160,323,305
0130-001,2012,4,22,6,155,209,364,323
0130-001,2012,4,22,7,396,319,715,364
0130-001,2012,4,22,8,528,608,1136,715
0130-001,2012,4,22,9,738,931,1669,1136
0130-001,2012,4,22,10,880,942,1822,1669
0130-001,2012,4,22,11,1051,1148,2199,1822
0130-001,2012,4,22,12,1083,1204,2287,2199
0130-001,2012,4,22,13,1127,1351,2478,2287
0130-001,2012,4,22,14,1409,1414,2823,2478
0130-001,2012,4,22,15,1426,1425,2851,2823
0130-001,2012,4,22,16,1656,1341,2997,2851
0130-001,2012,4,22,17,1825,1416,3241,2997
0130-001,2012,4,22,18,1680,1290,2970,3241
0130-001,2012,4,22,19,1505,1107,2612,2970
0130-001,2012,4,22,20,1130,947,2077,2612
0130-001,2012,4,22,21,1029,891,1920,2077
0130-001,2012,4,22,22,900,675,1575,1920
0130-001,2012,4,22,23,654,483,1137,1575
0130-001,2012,4,22,24,505,328,833,1137
0130-001,2012,4,23,1,253,231,484,833
0130-001,2012,4,23,2,176,166,342,484
0130-001,2012,4,23,3,129,116,245,342
0130-001,2012,4,23,4,116,123,239,245
0130-001,2012,4,23,5,135,233,368,239
0130-001,2012,4,23,6,328,371,699,368
0130-001,2012,4,23,7,1323,809,2132,699
0130-001,2012,4,23,8,2404,1737,4141,2132
0130-001,2012,4,23,9,2305,2030,4335,4141
0130-001,2012,4,23,10,1677,1659,3336,4335
0130-001,2012,4,23,11,1615,1636,3251,3336
0130-001,2012,4,23,12,1610,1652,3262,3251
0130-001,2012,4,23,13,1411,1618,3029,3262
0130-001,2012,4,23,14,1867,1886,3753,3029
0130-001,2012,4,23,15,1691,1801,3492,3753
0130-001,2012,4,23,16,1715,1729,3444,3492
0130-001,2012,4,23,17,1626,1842,3468,3444
0130-001,2012,4,23,18,1750,2157,3907,3468
0130-001,2012,4,23,19,1751,2398,4149,3907
0130-001,2012,4,23,20,1355,1829,3184,4149
0130-001,2012,4,23,21,1252,1692,2944,3184
0130-001,2012,4,23,22,1170,1291,2461,2944
0130-001,2012,4,23,23,864,862,1726,2461
0130-001,2012,4,23,24,609,519,1128,1726
0130-001,2012,4,24,1,359,338,697,1128
0130-001,2012,4,24,2,257,245,502,697
0130-001,2012,4,24,3,207,165,372,502
0130-001,2012,4,24,4,162,159,321,372
0130-001,2012,4,24,5,148,257,405,321
0130-001,2012,4,24,6,333,338,671,405
0130-001,2012,4,24,7,1230,807,2037,671
0130-001,2012,4,24,8,2175,1740,3915,2037
0130-001,2012,4,24,9,2143,1919,4062,3915
0130-001,2012,4,24,10,1773,1757,3530,4062
0130-001,2012,4,24,11,1813,1614,3427,3530
0130-001,2012,4,24,12,1559,1584,3143,3427
0130-001,2012,4,24,13,1372,1485,2857,3143
0130-001,2012,4,24,14,1874,1887,3761,2857
0130-001,2012,4,24,15,1684,1793,3477,3761
0130-001,2012,4,24,16,1730,1797,3527,3477
0130-001,2012,4,24,17,1663,1808,3471,3527
0130-001,2012,4,24,18,1697,2162,3859,3471
0130-001,2012,4,24,19,1683,2205,3888,3859
0130-001,2012,4,24,20,1478,1852,3330,3888
0130-001,2012,4,24,21,1239,1770,3009,3330
0130-001,2012,4,24,22,1190,1358,2548,3009
0130-001,2012,4,24,23,947,852,1799,2548
0130-001,2012,4,24,24,611,513,1124,1799
0130-001,2012,4,25,1,389,343,732,1124
0130-001,2012,4,25,2,236,211,447,732
0130-001,2012,4,25,3,210,169,379,447
0130-001,2012,4,25,4,151,170,321,379
0130-001,2012,4,25,5,174,228,402,321
0130-001,2012,4,25,6,341,336,677,402
0130-001,2012,4,25,7,1099,673,1772,677
0130-001,2012,4,25,8,2201,1592,3793,1772
0130-001,2012,4,25,9,2195,1952,4147,3793
0130-001,2012,4,25,10,1648,1777,3425,4147
0130-001,2012,4,25,11,1707,1575,3282,3425
0130-001,2012,4,25,12,1531,1489,3020,3282
0130-001,2012,4,25,13,1381,1440,2821,3020
0130-001,2012,4,25,14,1758,1835,3593,2821
0130-001,2012,4,25,15,1677,1679,3356,3593
0130-001,2012,4,25,16,1618,1682,3300,3356
0130-001,2012,4,25,17,1590,1677,3267,3300
0130-001,2012,4,25,18,1668,2167,3835,3267
0130-001,2012,4,25,19,1571,2439,4010,3835
0130-001,2012,4,25,20,1314,1674,2988,4010
0130-001,2012,4,25,21,1139,1529,2668,2988
0130-001,2012,4,25,22,1173,1108,2281,2668
0130-001,2012,4,25,23,900,790,1690,2281
0130-001,2012,4,25,24,604,491,1095,1690
0130-001,2012,4,26,1,410,328,738,1095
0130-001,2012,4,26,2,318,253,571,738
0130-001,2012,4,26,3,210,192,402,571
0130-001,2012,4,26,4,168,171,339,402
0130-001,2012,4,26,5,165,233,398,339
0130-001,2012,4,26,6,344,371,715,398
0130-001,2012,4,26,7,1226,760,1986,715
0130-001,2012,4,26,8,2285,1682,3967,1986
0130-001,2012,4,26,9,2040,1974,4014,3967
0130-001,2012,4,26,10,1807,1860,3667,4014
0130-001,2012,4,26,11,1792,1671,3463,3667
0130-001,2012,4,26,12,1647,1678,3325,3463
0130-001,2012,4,26,13,1463,1491,2954,3325
0130-001,2012,4,26,14,1862,1821,3683,2954
0130-001,2012,4,26,15,1502,1654,3156,3683
0130-001,2012,4,26,16,1811,1858,3669,3156
0130-001,2012,4,26,17,1782,1948,3730,3669
0130-001,2012,4,26,18,1707,2188,3895,3730
0130-001,2012,4,26,19,1788,2363,4151,3895
0130-001,2012,4,26,20,1411,1911,3322,4151
0130-001,2012,4,26,21,1224,1695,2919,3322
0130-001,2012,4,26,22,1256,1400,2656,2919
0130-001,2012,4,26,23,1005,900,1905,2656
0130-001,2012,4,26,24,661,554,1215,1905
0130-001,2012,4,27,1,463,391,854,1215
0130-001,2012,4,27,2,335,288,623,854
0130-001,2012,4,27,3,214,193,407,623
0130-001,2012,4,27,4,180,193,373,407
0130-001,2012,4,27,5,181,286,467,373
0130-001,2012,4,27,6,362,363,725,467
0130-001,2012,4,27,7,1248,794,2042,725
0130-001,2012,4,27,8,2345,1774,4119,2042
0130-001,2012,4,27,9,2159,2017,4176,4119
0130-001,2012,4,27,10,1967,1739,3706,4176
0130-001,2012,4,27,11,1780,1717,3497,3706
0130-001,2012,4,27,12,1662,1646,3308,3497
0130-001,2012,4,27,13,1406,1629,3035,3308
0130-001,2012,4,27,14,1812,1921,3733,3035
0130-001,2012,4,27,15,1778,1786,3564,3733
0130-001,2012,4,27,16,1726,1879,3605,3564
0130-001,2012,4,27,17,1815,2011,3826,3605
0130-001,2012,4,27,18,1774,2316,4090,3826
0130-001,2012,4,27,19,1896,2401,4297,4090
0130-001,2012,4,27,20,1551,2247,3798,4297
0130-001,2012,4,27,21,1390,1756,3146,3798
0130-001,2012,4,27,22,1247,1346,2593,3146
0130-001,2012,4,27,23,1014,883,1897,2593
0130-001,2012,4,27,24,805,620,1425,1897
0130-001,2012,4,28,1,493,427,920,1425
0130-001,2012,4,28,2,354,310,664,920
0130-001,2012,4,28,3,254,232,486,664
0130-001,2012,4,28,4,212,219,431,486
0130-001,2012,4,28,5,223,276,499,431
0130-001,2012,4,28,6,386,353,739,499
0130-001,2012,4,28,7,917,753,1670,739
0130-001,2012,4,28,8,1599,1123,2722,1670
0130-001,2012,4,28,9,1632,1743,3375,2722
0130-001,2012,4,28,10,1710,1925,3635,3375
0130-001,2012,4,28,11,1665,1981,3646,3635
0130-001,2012,4,28,12,1554,2198,3752,3646
0130-001,2012,4,28,13,1507,2133,3640,3752
0130-001,2012,4,28,14,1609,2056,3665,3640
0130-001,2012,4,28,15,1584,1974,3558,3665
0130-001,2012,4,28,16,1576,1968,3544,3558
0130-001,2012,4,28,17,1642,1933,3575,3544
0130-001,2012,4,28,18,1731,2148,3879,3575
0130-001,2012,4,28,19,1643,2055,3698,3879
0130-001,2012,4,28,20,1380,1470,2850,3698
0130-001,2012,4,28,21,1244,1173,2417,2850
0130-001,2012,4,28,22,1139,1005,2144,2417
0130-001,2012,4,28,23,828,688,1516,2144
0130-001,2012,4,28,24,628,502,1130,1516
0130-001,2012,4,29,1,399,344,743,1130
0130-001,2012,4,29,2,316,235,551,743
0130-001,2012,4,29,3,233,198,431,551
0130-001,2012,4,29,4,203,177,380,431
0130-001,2012,4,29,5,178,184,362,380
0130-001,2012,4,29,6,308,278,586,362
0130-001,2012,4,29,7,656,490,1146,586
0130-001,2012,4,29,8,836,687,1523,1146
0130-001,2012,4,29,9,892,1021,1913,1523
0130-001,2012,4,29,10,1116,1136,2252,1913
0130-001,2012,4,29,11,1114,1280,2394,2252
0130-001,2012,4,29,12,1071,1229,2300,2394
0130-001,2012,4,29,13,1141,1336,2477,2300
0130-001,2012,4,29,14,1352,1318,2670,2477
0130-001,2012,4,29,15,1488,1398,2886,2670
0130-001,2012,4,29,16,1803,1407,3210,2886
0130-001,2012,4,29,17,1853,1370,3223,3210
0130-001,2012,4,29,18,1799,1527,3326,3223
0130-001,2012,4,29,19,1873,1320,3193,3326
0130-001,2012,4,29,20,1604,1093,2697,3193
0130-001,2012,4,29,21,1376,1006,2382,2697
0130-001,2012,4,29,22,1237,849,2086,2382
0130-001,2012,4,29,23,760,496,1256,2086
0130-001,2012,4,29,24,548,374,922,1256
0130-001,2012,4,30,1,306,258,564,922
0130-001,2012,4,30,2,170,176,346,564
0130-001,2012,4,30,3,140,111,251,346
0130-001,2012,4,30,4,123,139,262,251
0130-001,2012,4,30,5,140,238,378,262
0130-001,2012,4,30,6,360,374,734,378
0130-001,2012,4,30,7,1323,797,2120,734
0130-001,2012,4,30,8,2426,1707,4133,2120
0130-001,2012,4,30,9,2079,2083,4162,4133
0130-001,2012,4,30,10,1726,1862,3588,4162
0130-001,2012,4,30,11,1734,1741,3475,3588
0130-001,2012,4,30,12,1692,1654,3346,3475
0130-001,2012,4,30,13,1438,1565,3003,3346
0130-001,2012,4,30,14,1679,1704,3383,3003
0130-001,2012,4,30,15,1902,1776,3678,3383
0130-001,2012,4,30,16,1832,1870,3702,3678
0130-001,2012,4,30,17,1772,1973,3745,3702
0130-001,2012,4,30,18,1756,2171,3927,3745
0130-001,2012,4,30,19,1789,2288,4077,3927
0130-001,2012,4,30,20,1567,1934,3501,4077
0130-001,2012,4,30,21,1337,1795,3132,3501
0130-001,2012,4,30,22,1219,1409,2628,3132
0130-001,2012,4,30,23,987,917,1904,2628
0130-001,2012,4,30,24,692,587,1279,1904
0130-001,2012,5,1,1,495,424,919,1279
0130-001,2012,5,1,2,334,308,642,919
0130-001,2012,5,1,3,275,235,510,642
0130-001,2012,5,1,4,192,183,375,510
0130-001,2012,5,1,5,221,250,471,375
0130-001,2012,5,1,6,333,341,674,471
0130-001,2012,5,1,7,894,627,1521,674
0130-001,2012,5,1,8,1811,1443,3254,1521
0130-001,2012,5,1,9,1785,1768,3553,3254
0130-001,2012,5,1,10,1545,1681,3226,3553
0130-001,2012,5,1,11,1735,1687,3422,3226
0130-001,2012,5,1,12,1676,1540,3216,3422
0130-001,2012,5,1,13,1689,1495,3184,3216
0130-001,2012,5,1,14,1578,1660,3238,3184
0130-001,2012,5,1,15,1604,1656,3260,3238
0130-001,2012,5,1,16,1680,1575,3255,3260
0130-001,2012,5,1,17,1611,1748,3359,3255
0130-001,2012,5,1,18,1706,2158,3864,3359
0130-001,2012,5,1,19,1597,1911,3508,3864
0130-001,2012,5,1,20,1230,1337,2567,3508
0130-001,2012,5,1,21,1180,1228,2408,2567
0130-001,2012,5,1,22,1091,986,2077,2408
0130-001,2012,5,1,23,799,665,1464,2077
0130-001,2012,5,1,24,557,424,981,1464
0130-001,2012,5,2,1,334,270,604,981
0130-001,2012,5,2,2,215,210,425,604
0130-001,2012,5,2,3,188,154,342,425
0130-001,2012,5,2,4,166,163,329,342
0130-001,2012,5,2,5,158,253,411,329
0130-001,2012,5,2,6,379,382,761,411
0130-001,2012,5,2,7,1243,772,2015,761
0130-001,2012,5,2,8,2360,1749,4109,2015
0130-001,2012,5,2,9,2165,1996,4161,4109
0130-001,2012,5,2,10,1690,1791,3481,4161
0130-001,2012,5,2,11,1691,1622,3313,3481
0130-001,2012,5,2,12,1701,1683,3384,3313
0130-001,2012,5,2,13,1526,1460,2986,3384
0130-001,2012,5,2,14,1683,1638,3321,2986
0130-001,2012,5,2,15,1770,1815,3585,3321
0130-001,2012,5,2,16,1797,1832,3629,3585
0130-001,2012,5,2,17,1703,1878,3581,3629
0130-001,2012,5,2,18,1778,2102,3880,3581
0130-001,2012,5,2,19,1711,2297,4008,3880
0130-001,2012,5,2,20,1393,1946,3339,4008
0130-001,2012,5,2,21,1319,1716,3035,3339
0130-001,2012,5,2,22,1229,1301,2530,3035
0130-001,2012,5,2,23,909,822,1731,2530
0130-001,2012,5,2,24,597,548,1145,1731
0130-001,2012,5,3,1,418,356,774,1145
0130-001,2012,5,3,2,284,252,536,774
0130-001,2012,5,3,3,201,203,404,536
0130-001,2012,5,3,4,162,182,344,404
0130-001,2012,5,3,5,188,238,426,344
0130-001,2012,5,3,6,396,437,833,426
0130-001,2012,5,3,7,1194,797,1991,833
0130-001,2012,5,3,8,2346,1727,4073,1991
0130-001,2012,5,3,9,2057,2029,4086,4073
0130-001,2012,5,3,10,1786,1865,3651,4086
0130-001,2012,5,3,11,1767,1656,3423,3651
0130-001,2012,5,3,12,1665,1647,3312,3423
0130-001,2012,5,3,13,1537,1496,3033,3312
0130-001,2012,5,3,14,1663,1661,3324,3033
0130-001,2012,5,3,15,1772,1796,3568,3324
0130-001,2012,5,3,16,1822,1764,3586,3568
0130-001,2012,5,3,17,1699,1895,3594,3586
0130-001,2012,5,3,18,1762,2185,3947,3594
0130-001,2012,5,3,19,1820,2380,4200,3947
0130-001,2012,5,3,20,1437,1906,3343,4200
0130-001,2012,5,3,21,1343,1744,3087,3343
0130-001,2012,5,3,22,1203,1390,2593,3087
0130-001,2012,5,3,23,1069,864,1933,2593
0130-001,2012,5,3,24,655,591,1246,1933
0130-001,2012,5,4,1,428,350,778,1246
0130-001,2012,5,4,2,305,235,540,778
0130-001,2012,5,4,3,196,189,385,540
0130-001,2012,5,4,4,138,173,311,385
0130-001,2012,5,4,5,187,256,443,311
0130-001,2012,5,4,6,381,436,817,443
0130-001,2012,5,4,7,1271,812,2083,817
0130-001,2012,5,4,8,2317,1752,4069,2083
0130-001,2012,5,4,9,2107,1983,4090,4069
0130-001,2012,5,4,10,1673,1835,3508,4090
0130-001,2012,5,4,11,1742,1686,3428,3508
0130-001,2012,5,4,12,1703,1677,3380,3428
0130-001,2012,5,4,13,1534,1640,3174,3380
0130-001,2012,5,4,14,1759,1746,3505,3174
0130-001,2012,5,4,15,1778,1832,3610,3505
0130-001,2012,5,4,16,1821,1936,3757,3610
0130-001,2012,5,4,17,1808,2030,3838,3757
0130-001,2012,5,4,18,1847,2286,4133,3838
0130-001,2012,5,4,19,1967,2392,4359,4133
0130-001,2012,5,4,20,1680,2358,4038,4359
0130-001,2012,5,4,21,1488,2166,3654,4038
0130-001,2012,5,4,22,1371,1956,3327,3654
0130-001,2012,5,4,23,1160,1559,2719,3327
0130-001,2012,5,4,24,805,1342,2147,2719
0130-001,2012,5,5,1,516,1021,1537,2147
0130-001,2012,5,5,2,343,566,909,1537
0130-001,2012,5,5,3,286,272,558,909
0130-001,2012,5,5,4,250,191,441,558
0130-001,2012,5,5,5,223,249,472,441
0130-001,2012,5,5,6,403,418,821,472
0130-001,2012,5,5,7,793,632,1425,821
0130-001,2012,5,5,8,1111,1034,2145,1425
0130-001,2012,5,5,9,1230,1697,2927,2145
0130-001,2012,5,5,10,1320,2092,3412,2927
0130-001,2012,5,5,11,1355,2257,3612,3412
0130-001,2012,5,5,12,1440,1922,3362,3612
0130-001,2012,5,5,13,1307,2169,3476,3362
0130-001,2012,5,5,14,1421,2074,3495,3476
0130-001,2012,5,5,15,1522,1987,3509,3495
0130-001,2012,5,5,16,1600,2019,3619,3509
0130-001,2012,5,5,17,1670,2043,3713,3619
0130-001,2012,5,5,18,1775,2022,3797,3713
0130-001,2012,5,5,19,1622,1732,3354,3797
0130-001,2012,5,5,20,1410,1360,2770,3354
0130-001,2012,5,5,21,1213,1138,2351,2770
0130-001,2012,5,5,22,1104,1061,2165,2351
0130-001,2012,5,5,23,856,683,1539,2165
0130-001,2012,5,5,24,546,475,1021,1539
0130-001,2012,5,6,1,369,305,674,1021
0130-001,2012,5,6,2,244,204,448,674
0130-001,2012,5,6,3,191,143,334,448
0130-001,2012,5,6,4,168,136,304,334
0130-001,2012,5,6,5,143,143,286,304
0130-001,2012,5,6,6,276,268,544,286
0130-001,2012,5,6,7,560,488,1048,544
0130-001,2012,5,6,8,714,641,1355,1048
0130-001,2012,5,6,9,764,889,1653,1355
0130-001,2012,5,6,10,1027,1015,2042,1653
0130-001,2012,5,6,11,1474,1261,2735,2042
0130-001,2012,5,6,12,1843,1306,3149,2735
0130-001,2012,5,6,13,1717,1288,3005,3149
0130-001,2012,5,6,14,1753,1296,3049,3005
0130-001,2012,5,6,15,1661,1351,3012,3049
0130-001,2012,5,6,16,1784,1452,3236,3012
0130-001,2012,5,6,17,2009,1471,3480,3236
0130-001,2012,5,6,18,1977,1496,3473,3480
0130-001,2012,5,6,19,1953,1417,3370,3473
0130-001,2012,5,6,20,1855,1192,3047,3370
0130-001,2012,5,6,21,1843,1175,3018,3047
0130-001,2012,5,6,22,1792,1063,2855,3018
0130-001,2012,5,6,23,1624,568,2192,2855
0130-001,2012,5,6,24,1117,372,1489,2192
0130-001,2012,5,7,1,484,234,718,1489
0130-001,2012,5,7,2,240,180,420,718
0130-001,2012,5,7,3,140,120,260,420
0130-001,2012,5,7,4,107,131,238,260
0130-001,2012,5,7,5,146,223,369,238
0130-001,2012,5,7,6,398,401,799,369
0130-001,2012,5,7,7,1438,871,2309,799
0130-001,2012,5,7,8,2369,1763,4132,2309
0130-001,2012,5,7,9,2080,2006,4086,4132
0130-001,2012,5,7,10,1723,1892,3615,4086
0130-001,2012,5,7,11,1749,1691,3440,3615
0130-001,2012,5,7,12,1710,1607,3317,3440
0130-001,2012,5,7,13,1563,1477,3040,3317
0130-001,2012,5,7,14,1726,1689,3415,3040
0130-001,2012,5,7,15,1861,1766,3627,3415
0130-001,2012,5,7,16,1807,1870,3677,3627
0130-001,2012,5,7,17,1752,1945,3697,3677
0130-001,2012,5,7,18,1807,2309,4116,3697
0130-001,2012,5,7,19,1888,2359,4247,4116
0130-001,2012,5,7,20,1516,1927,3443,4247
0130-001,2012,5,7,21,1362,1801,3163,3443
0130-001,2012,5,7,22,1336,1499,2835,3163
0130-001,2012,5,7,23,985,863,1848,2835
0130-001,2012,5,7,24,627,522,1149,1848
0130-001,2012,5,8,1,429,351,780,1149
0130-001,2012,5,8,2,244,251,495,780
0130-001,2012,5,8,3,210,168,378,495
0130-001,2012,5,8,4,164,168,332,378
0130-001,2012,5,8,5,182,246,428,332
0130-001,2012,5,8,6,394,427,821,428
0130-001,2012,5,8,7,1278,816,2094,821
0130-001,2012,5,8,8,2332,1726,4058,2094
0130-001,2012,5,8,9,2069,2079,4148,4058
0130-001,2012,5,8,10,1779,1889,3668,4148
0130-001,2012,5,8,11,1729,1770,3499,3668
0130-001,2012,5,8,12,1793,1704,3497,3499
0130-001,2012,5,8,13,1647,1524,3171,3497
0130-001,2012,5,8,14,1683,1654,3337,3171
0130-001,2012,5,8,15,1850,1780,3630,3337
0130-001,2012,5,8,16,1750,1818,3568,3630
0130-001,2012,5,8,17,1720,1917,3637,3568
0130-001,2012,5,8,18,2006,2227,4233,3637
0130-001,2012,5,8,19,1934,2458,4392,4233
0130-001,2012,5,8,20,1682,1967,3649,4392
0130-001,2012,5,8,21,1332,1734,3066,3649
0130-001,2012,5,8,22,1282,1446,2728,3066
0130-001,2012,5,8,23,958,821,1779,2728
0130-001,2012,5,8,24,571,573,1144,1779
0130-001,2012,5,9,1,375,277,652,1144
0130-001,2012,5,9,2,243,214,457,652
0130-001,2012,5,9,3,164,168,332,457
0130-001,2012,5,9,4,180,166,346,332
0130-001,2012,5,9,5,180,226,406,346
0130-001,2012,5,9,6,402,403,805,406
0130-001,2012,5,9,7,1203,849,2052,805
0130-001,2012,5,9,8,2284,1674,3958,2052
0130-001,2012,5,9,9,2124,2079,4203,3958
0130-001,2012,5,9,10,1780,1808,3588,4203
0130-001,2012,5,9,11,1761,1690,3451,3588
0130-001,2012,5,9,12,1679,1651,3330,3451
0130-001,2012,5,9,13,1564,1438,3002,3330
0130-001,2012,5,9,14,1634,1587,3221,3002
0130-001,2012,5,9,15,1712,1716,3428,3221
0130-001,2012,5,9,16,1715,1792,3507,3428
0130-001,2012,5,9,17,1712,1831,3543,3507
0130-001,2012,5,9,18,1935,2234,4169,3543
0130-001,2012,5,9,19,1822,2350,4172,4169
0130-001,2012,5,9,20,1405,1917,3322,4172
0130-001,2012,5,9,21,1294,1610,2904,3322
0130-001,2012,5,9,22,1175,1336,2511,2904
0130-001,2012,5,9,23,1004,776,1780,2511
0130-001,2012,5,9,24,623,563,1186,1780
0130-001,2012,5,10,1,464,398,862,1186
0130-001,2012,5,10,2,285,240,525,862
0130-001,2012,5,10,3,183,192,375,525
0130-001,2012,5,10,4,204,169,373,375
0130-001,2012,5,10,5,166,240,406,373
0130-001,2012,5,10,6,366,409,775,406
0130-001,2012,5,10,7,1279,792,2071,775
0130-001,2012,5,10,8,2363,1730,4093,2071
0130-001,2012,5,10,9,2001,2037,4038,4093
0130-001,2012,5,10,10,1858,1813,3671,4038
0130-001,2012,5,10,11,1767,1689,3456,3671
0130-001,2012,5,10,12,1626,1631,3257,3456
0130-001,2012,5,10,13,1511,1497,3008,3257
0130-001,2012,5,10,14,1675,1611,3286,3008
0130-001,2012,5,10,15,1739,1731,3470,3286
0130-001,2012,5,10,16,1734,1817,3551,3470
0130-001,2012,5,10,17,1734,1821,3555,3551
0130-001,2012,5,10,18,1985,2230,4215,3555
0130-001,2012,5,10,19,1894,2391,4285,4215
0130-001,2012,5,10,20,1426,1878,3304,4285
0130-001,2012,5,10,21,1306,1638,2944,3304
0130-001,2012,5,10,22,1160,1348,2508,2944
0130-001,2012,5,10,23,971,783,1754,2508
0130-001,2012,5,10,24,665,593,1258,1754
0130-001,2012,5,11,1,466,373,839,1258
0130-001,2012,5,11,2,271,255,526,839
0130-001,2012,5,11,3,202,187,389,526
0130-001,2012,5,11,4,190,197,387,389
0130-001,2012,5,11,5,206,271,477,387
0130-001,2012,5,11,6,375,403,778,477
0130-001,2012,5,11,7,1267,858,2125,778
0130-001,2012,5,11,8,2356,1686,4042,2125
0130-001,2012,5,11,9,1980,2083,4063,4042
0130-001,2012,5,11,10,1799,1820,3619,4063
0130-001,2012,5,11,11,1774,1714,3488,3619
0130-001,2012,5,11,12,1650,1662,3312,3488
0130-001,2012,5,11,13,1631,1615,3246,3312
0130-001,2012,5,11,14,1687,1852,3539,3246
0130-001,2012,5,11,15,1758,1827,3585,3539
0130-001,2012,5,11,16,1798,1954,3752,3585
0130-001,2012,5,11,17,1652,1956,3608,3752
0130-001,2012,5,11,18,2092,2331,4423,3608
0130-001,2012,5,11,19,2115,2418,4533,4423
0130-001,2012,5,11,20,1705,2125,3830,4533
0130-001,2012,5,11,21,1342,1737,3079,3830
0130-001,2012,5,11,22,1265,1394,2659,3079
0130-001,2012,5,11,23,1114,878,1992,2659
0130-001,2012,5,11,24,781,593,1374,1992
0130-001,2012,5,12,1,452,450,902,1374
0130-001,2012,5,12,2,335,321,656,902
0130-001,2012,5,12,3,271,246,517,656
0130-001,2012,5,12,4,224,229,453,517
0130-001,2012,5,12,5,239,270,509,453
0130-001,2012,5,12,6,389,445,834,509
0130-001,2012,5,12,7,929,724,1653,834
0130-001,2012,5,12,8,1506,1227,2733,1653
0130-001,2012,5,12,9,1650,1813,3463,2733
0130-001,2012,5,12,10,1809,1839,3648,3463
0130-001,2012,5,12,11,1633,1891,3524,3648
0130-001,2012,5,12,12,1587,2103,3690,3524
0130-001,2012,5,12,13,1621,2184,3805,3690
0130-001,2012,5,12,14,1646,2135,3781,3805
0130-001,2012,5,12,15,1706,1987,3693,3781
0130-001,2012,5,12,16,1667,1850,3517,3693
0130-001,2012,5,12,17,1725,1875,3600,3517
0130-001,2012,5,12,18,1926,2077,4003,3600
0130-001,2012,5,12,19,1855,2159,4014,4003
0130-001,2012,5,12,20,1503,1612,3115,4014
0130-001,2012,5,12,21,1257,1207,2464,3115
0130-001,2012,5,12,22,1140,959,2099,2464
0130-001,2012,5,12,23,889,681,1570,2099
0130-001,2012,5,12,24,637,472,1109,1570
0130-001,2012,5,13,1,398,359,757,1109
0130-001,2012,5,13,2,305,233,538,757
0130-001,2012,5,13,3,275,213,488,538
0130-001,2012,5,13,4,179,171,350,488
0130-001,2012,5,13,5,202,166,368,350
0130-001,2012,5,13,6,272,330,602,368
0130-001,2012,5,13,7,580,494,1074,602
0130-001,2012,5,13,8,715,654,1369,1074
0130-001,2012,5,13,9,779,971,1750,1369
0130-001,2012,5,13,10,970,1088,2058,1750
0130-001,2012,5,13,11,1107,1240,2347,2058
0130-001,2012,5,13,12,1079,1189,2268,2347
0130-001,2012,5,13,13,1464,1318,2782,2268
0130-001,2012,5,13,14,1664,1368,3032,2782
0130-001,2012,5,13,15,1892,1373,3265,3032
0130-001,2012,5,13,16,1792,1325,3117,3265
0130-001,2012,5,13,17,1832,1385,3217,3117
0130-001,2012,5,13,18,1911,1440,3351,3217
0130-001,2012,5,13,19,1714,1324,3038,3351
0130-001,2012,5,13,20,1364,1187,2551,3038
0130-001,2012,5,13,21,1208,1035,2243,2551
0130-001,2012,5,13,22,1086,805,1891,2243
0130-001,2012,5,13,23,793,573,1366,1891
0130-001,2012,5,13,24,475,378,853,1366
0130-001,2012,5,14,1,318,242,560,853
0130-001,2012,5,14,2,192,186,378,560
0130-001,2012,5,14,3,145,145,290,378
0130-001,2012,5,14,4,140,126,266,290
0130-001,2012,5,14,5,113,192,305,266
0130-001,2012,5,14,6,410,396,806,305
0130-001,2012,5,14,7,1336,820,2156,806
0130-001,2012,5,14,8,2370,1728,4098,2156
0130-001,2012,5,14,9,2120,2061,4181,4098
0130-001,2012,5,14,10,1632,1712,3344,4181
0130-001,2012,5,14,11,1665,1696,3361,3344
0130-001,2012,5,14,12,1622,1563,3185,3361
0130-001,2012,5,14,13,1387,1436,2823,3185
0130-001,2012,5,14,14,1674,1712,3386,2823
0130-001,2012,5,14,15,1733,1689,3422,3386
0130-001,2012,5,14,16,1638,1641,3279,3422
0130-001,2012,5,14,17,1649,1784,3433,3279
0130-001,2012,5,14,18,1692,2093,3785,3433
0130-001,2012,5,14,19,1709,2290,3999,3785
0130-001,2012,5,14,20,1340,1692,3032,3999
0130-001,2012,5,14,21,1168,1596,2764,3032
0130-001,2012,5,14,22,1103,1227,2330,2764
0130-001,2012,5,14,23,866,736,1602,2330
0130-001,2012,5,14,24,536,433,969,1602
0130-001,2012,5,15,1,361,314,675,969
0130-001,2012,5,15,2,241,216,457,675
0130-001,2012,5,15,3,180,145,325,457
0130-001,2012,5,15,4,170,164,334,325
0130-001,2012,5,15,5,170,236,406,334
0130-001,2012,5,15,6,397,400,797,406
0130-001,2012,5,15,7,1203,794,1997,797
0130-001,2012,5,15,8,2343,1659,4002,1997
0130-001,2012,5,15,9,2206,2022,4228,4002
0130-001,2012,5,15,10,1736,1799,3535,4228
0130-001,2012,5,15,11,1781,1796,3577,3535
0130-001,2012,5,15,12,1597,1521,3118,3577
0130-001,2012,5,15,13,1419,1520,2939,3118
0130-001,2012,5,15,14,1786,1726,3512,2939
0130-001,2012,5,15,15,1835,1816,3651,3512
0130-001,2012,5,15,16,1678,1863,3541,3651
0130-001,2012,5,15,17,1695,1956,3651,3541
0130-001,2012,5,15,18,1900,2132,4032,3651
0130-001,2012,5,15,19,1788,2291,4079,4032
0130-001,2012,5,15,20,1450,1837,3287,4079
0130-001,2012,5,15,21,1215,1706,2921,3287
0130-001,2012,5,15,22,1214,1319,2533,2921
0130-001,2012,5,15,23,939,789,1728,2533
0130-001,2012,5,15,24,629,557,1186,1728
0130-001,2012,5,16,1,404,379,783,1186
0130-001,2012,5,16,2,282,252,534,783
0130-001,2012,5,16,3,207,173,380,534
0130-001,2012,5,16,4,162,185,347,380
0130-001,2012,5,16,5,167,226,393,347
0130-001,2012,5,16,6,398,395,793,393
0130-001,2012,5,16,7,1317,808,2125,793
0130-001,2012,5,16,8,2343,1731,4074,2125
0130-001,2012,5,16,9,2127,2062,4189,4074
0130-001,2012,5,16,10,1711,1769,3480,4189
0130-001,2012,5,16,11,1743,1598,3341,3480
0130-001,2012,5,16,12,1599,1598,3197,3341
0130-001,2012,5,16,13,1449,1467,2916,3197
0130-001,2012,5,16,14,1682,1720,3402,2916
0130-001,2012,5,16,15,1783,1713,3496,3402
0130-001,2012,5,16,16,1721,1795,3516,3496
0130-001,2012,5,16,17,1716,1819,3535,3516
0130-001,2012,5,16,18,1735,2223,3958,3535
0130-001,2012,5,16,19,1876,2417,4293,3958
0130-001,2012,5,16,20,1434,1954,3388,4293
0130-001,2012,5,16,21,1259,1563,2822,3388
0130-001,2012,5,16,22,1134,1326,2460,2822
0130-001,2012,5,16,23,949,775,1724,2460
0130-001,2012,5,16,24,591,528,1119,1724
0130-001,2012,5,17,1,435,386,821,1119
0130-001,2012,5,17,2,271,277,548,821
0130-001,2012,5,17,3,211,183,394,548
0130-001,2012,5,17,4,163,178,341,394
0130-001,2012,5,17,5,169,224,393,341
0130-001,2012,5,17,6,413,453,866,393
0130-001,2012,5,17,7,1203,812,2015,866
0130-001,2012,5,17,8,2381,1677,4058,2015
0130-001,2012,5,17,9,2194,2097,4291,4058
0130-001,2012,5,17,10,1824,1913,3737,4291
0130-001,2012,5,17,11,1774,1645,3419,3737
0130-001,2012,5,17,12,1482,1653,3135,3419
0130-001,2012,5,17,13,1417,1534,2951,3135
0130-001,2012,5,17,14,1758,1628,3386,2951
0130-001,2012,5,17,15,1730,1646,3376,3386
0130-001,2012,5,17,16,1743,1742,3485,3376
0130-001,2012,5,17,17,1699,1819,3518,3485
0130-001,2012,5,17,18,1765,2228,3993,3518
0130-001,2012,5,17,19,1824,2311,4135,3993
0130-001,2012,5,17,20,1422,1826,3248,4135
0130-001,2012,5,17,21,1201,1611,2812,3248
0130-001,2012,5,17,22,1127,1279,2406,2812
0130-001,2012,5,17,23,937,848,1785,2406
0130-001,2012,5,17,24,647,573,1220,1785
0130-001,2012,5,18,1,453,382,835,1220
0130-001,2012,5,18,2,314,303,617,835
0130-001,2012,5,18,3,196,195,391,617
0130-001,2012,5,18,4,173,200,373,391
0130-001,2012,5,18,5,182,233,415,373
0130-001,2012,5,18,6,435,466,901,415
0130-001,2012,5,18,7,1256,830,2086,901
0130-001,2012,5,18,8,2364,1675,4039,2086
0130-001,2012,5,18,9,2039,1996,4035,4039
0130-001,2012,5,18,10,1738,1780,3518,4035
0130-001,2012,5,18,11,1822,1684,3506,3518
0130-001,2012,5,18,12,1577,1630,3207,3506
0130-001,2012,5,18,13,1442,1526,2968,3207
0130-001,2012,5,18,14,1730,1756,3486,2968
0130-001,2012,5,18,15,1772,1815,3587,3486
0130-001,2012,5,18,16,1687,1779,3466,3587
0130-001,2012,5,18,17,1878,1905,3783,3466
0130-001,2012,5,18,18,2060,2267,4327,3783
0130-001,2012,5,18,19,2127,2401,4528,4327
0130-001,2012,5,18,20,1694,2187,3881,4528
0130-001,2012,5,18,21,1349,1785,3134,3881
0130-001,2012,5,18,22,1287,1450,2737,3134
0130-001,2012,5,18,23,1018,890,1908,2737
0130-001,2012,5,18,24,776,614,1390,1908
0130-001,2012,5,19,1,509,474,983,1390
0130-001,2012,5,19,2,351,342,693,983
0130-001,2012,5,19,3,271,228,499,693
0130-001,2012,5,19,4,219,208,427,499
0130-001,2012,5,19,5,232,263,495,427
0130-001,2012,5,19,6,440,460,900,495
0130-001,2012,5,19,7,939,743,1682,900
0130-001,2012,5,19,8,1537,1168,2705,1682
0130-001,2012,5,19,9,1629,1725,3354,2705
0130-001,2012,5,19,10,1564,1808,3372,3354
0130-001,2012,5,19,11,1658,1857,3515,3372
0130-001,2012,5,19,12,1581,2056,3637,3515
0130-001,2012,5,19,13,1507,2085,3592,3637
0130-001,2012,5,19,14,1572,2076,3648,3592
0130-001,2012,5,19,15,1601,1851,3452,3648
0130-001,2012,5,19,16,1647,1722,3369,3452
0130-001,2012,5,19,17,1796,1740,3536,3369
0130-001,2012,5,19,18,1943,1879,3822,3536
0130-001,2012,5,19,19,1771,1868,3639,3822
0130-001,2012,5,19,20,1403,1424,2827,3639
0130-001,2012,5,19,21,1181,1148,2329,2827
0130-001,2012,5,19,22,1024,991,2015,2329
0130-001,2012,5,19,23,887,719,1606,2015
0130-001,2012,5,19,24,628,499,1127,1606
0130-001,2012,5,20,1,426,406,832,1127
0130-001,2012,5,20,2,302,243,545,832
0130-001,2012,5,20,3,230,188,418,545
0130-001,2012,5,20,4,209,169,378,418
0130-001,2012,5,20,5,194,180,374,378
0130-001,2012,5,20,6,283,288,571,374
0130-001,2012,5,20,7,616,510,1126,571
0130-001,2012,5,20,8,845,724,1569,1126
0130-001,2012,5,20,9,1000,961,1961,1569
0130-001,2012,5,20,10,962,1059,2021,1961
0130-001,2012,5,20,11,1074,1259,2333,2021
0130-001,2012,5,20,12,1160,1381,2541,2333
0130-001,2012,5,20,13,1273,1374,2647,2541
0130-001,2012,5,20,14,1302,1324,2626,2647
0130-001,2012,5,20,15,1428,1365,2793,2626
0130-001,2012,5,20,16,1621,1409,3030,2793
0130-001,2012,5,20,17,1883,1410,3293,3030
0130-001,2012,5,20,18,1796,1465,3261,3293
0130-001,2012,5,20,19,1510,1335,2845,3261
0130-001,2012,5,20,20,1191,1141,2332,2845
0130-001,2012,5,20,21,1118,1058,2176,2332
0130-001,2012,5,20,22,1121,913,2034,2176
0130-001,2012,5,20,23,729,547,1276,2034
0130-001,2012,5,20,24,494,396,890,1276
0130-001,2012,5,21,1,306,261,567,890
0130-001,2012,5,21,2,190,177,367,567
0130-001,2012,5,21,3,144,112,256,367
0130-001,2012,5,21,4,116,126,242,256
0130-001,2012,5,21,5,140,216,356,242
0130-001,2012,5,21,6,414,414,828,356
0130-001,2012,5,21,7,1403,874,2277,828
0130-001,2012,5,21,8,2339,1741,4080,2277
0130-001,2012,5,21,9,2191,2071,4262,4080
0130-001,2012,5,21,10,1696,1702,3398,4262
0130-001,2012,5,21,11,1683,1670,3353,3398
0130-001,2012,5,21,12,1602,1689,3291,3353
0130-001,2012,5,21,13,1450,1448,2898,3291
0130-001,2012,5,21,14,1589,1569,3158,2898
0130-001,2012,5,21,15,1680,1734,3414,3158
0130-001,2012,5,21,16,1705,1749,3454,3414
0130-001,2012,5,21,17,1647,1825,3472,3454
0130-001,2012,5,21,18,1755,2134,3889,3472
0130-001,2012,5,21,19,1405,2172,3577,3889
0130-001,2012,5,21,20,1563,1875,3438,3577
0130-001,2012,5,21,21,1273,1734,3007,3438
0130-001,2012,5,21,22,1136,1355,2491,3007
0130-001,2012,5,21,23,942,812,1754,2491
0130-001,2012,5,21,24,533,494,1027,1754
0130-001,2012,5,22,1,399,334,733,1027
0130-001,2012,5,22,2,234,239,473,733
0130-001,2012,5,22,3,188,188,376,473
0130-001,2012,5,22,4,176,160,336,376
0130-001,2012,5,22,5,169,242,411,336
0130-001,2012,5,22,6,417,418,835,411
0130-001,2012,5,22,7,1338,860,2198,835
0130-001,2012,5,22,8,2307,1750,4057,2198
0130-001,2012,5,22,9,2105,2026,4131,4057
0130-001,2012,5,22,10,1694,1908,3602,4131
0130-001,2012,5,22,11,1768,1656,3424,3602
0130-001,2012,5,22,12,1563,1574,3137,3424
0130-001,2012,5,22,13,1412,1476,2888,3137
0130-001,2012,5,22,14,1549,1618,3167,2888
0130-001,2012,5,22,15,1763,1731,3494,3167
0130-001,2012,5,22,16,1777,1849,3626,3494
0130-001,2012,5,22,17,1677,1858,3535,3626
0130-001,2012,5,22,18,1677,2145,3822,3535
0130-001,2012,5,22,19,1764,2329,4093,3822
0130-001,2012,5,22,20,1505,1836,3341,4093
0130-001,2012,5,22,21,1280,1721,3001,3341
0130-001,2012,5,22,22,1244,1399,2643,3001
0130-001,2012,5,22,23,1059,827,1886,2643
0130-001,2012,5,22,24,625,520,1145,1886
0130-001,2012,5,23,1,416,336,752,1145
0130-001,2012,5,23,2,283,266,549,752
0130-001,2012,5,23,3,186,192,378,549
0130-001,2012,5,23,4,174,168,342,378
0130-001,2012,5,23,5,185,226,411,342
0130-001,2012,5,23,6,379,448,827,411
0130-001,2012,5,23,7,1269,814,2083,827
0130-001,2012,5,23,8,2345,1659,4004,2083
0130-001,2012,5,23,9,2115,2167,4282,4004
0130-001,2012,5,23,10,1748,1877,3625,4282
0130-001,2012,5,23,11,1801,1695,3496,3625
0130-001,2012,5,23,12,1638,1737,3375,3496
0130-001,2012,5,23,13,1327,1508,2835,3375
0130-001,2012,5,23,14,1635,1636,3271,2835
0130-001,2012,5,23,15,1749,1675,3424,3271
0130-001,2012,5,23,16,1808,1709,3517,3424
0130-001,2012,5,23,17,1715,1859,3574,3517
0130-001,2012,5,23,18,1745,2221,3966,3574
0130-001,2012,5,23,19,1854,2410,4264,3966
0130-001,2012,5,23,20,1394,1902,3296,4264
0130-001,2012,5,23,21,1306,1582,2888,3296
0130-001,2012,5,23,22,1226,1232,2458,2888
0130-001,2012,5,23,23,967,809,1776,2458
0130-001,2012,5,23,24,662,575,1237,1776
0130-001,2012,5,24,1,442,389,831,1237
0130-001,2012,5,24,2,279,255,534,831
0130-001,2012,5,24,3,196,168,364,534
0130-001,2012,5,24,4,192,184,376,364
0130-001,2012,5,24,5,181,262,443,376
0130-001,2012,5,24,6,401,415,816,443
0130-001,2012,5,24,7,1311,885,2196,816
0130-001,2012,5,24,8,2328,1649,3977,2196
0130-001,2012,5,24,9,2133,2053,4186,3977
0130-001,2012,5,24,10,1864,1881,3745,4186
0130-001,2012,5,24,11,1739,1659,3398,3745
0130-001,2012,5,24,12,1577,1621,3198,3398
0130-001,2012,5,24,13,1408,1454,2862,3198
0130-001,2012,5,24,14,1589,1609,3198,2862
0130-001,2012,5,24,15,1756,1684,3440,3198
0130-001,2012,5,24,16,1764,1802,3566,3440
0130-001,2012,5,24,17,1701,1898,3599,3566
0130-001,2012,5,24,18,1718,2163,3881,3599
0130-001,2012,5,24,19,1776,2384,4160,3881
0130-001,2012,5,24,20,1419,1762,3181,4160
0130-001,2012,5,24,21,1275,1726,3001,3181
0130-001,2012,5,24,22,1194,1289,2483,3001
0130-001,2012,5,24,23,984,813,1797,2483
0130-001,2012,5,24,24,670,586,1256,1797
0130-001,2012,5,25,1,468,372,840,1256
0130-001,2012,5,25,2,264,268,532,840
0130-001,2012,5,25,3,212,168,380,532
0130-001,2012,5,25,4,168,168,336,380
0130-001,2012,5,25,5,207,262,469,336
0130-001,2012,5,25,6,402,445,847,469
0130-001,2012,5,25,7,1248,818,2066,847
0130-001,2012,5,25,8,2141,1706,3847,2066
0130-001,2012,5,25,9,2130,2056,4186,3847
0130-001,2012,5,25,10,1911,1797,3708,4186
0130-001,2012,5,25,11,1747,1750,3497,3708
0130-001,2012,5,25,12,1598,1762,3360,3497
0130-001,2012,5,25,13,1479,1697,3176,3360
0130-001,2012,5,25,14,1667,1812,3479,3176
0130-001,2012,5,25,15,1833,1826,3659,3479
0130-001,2012,5,25,16,1787,1953,3740,3659
0130-001,2012,5,25,17,1809,1972,3781,3740
0130-001,2012,5,25,18,2056,2282,4338,3781
0130-001,2012,5,25,19,1974,2404,4378,4338
0130-001,2012,5,25,20,1726,2337,4063,4378
0130-001,2012,5,25,21,1403,2250,3653,4063
0130-001,2012,5,25,22,1319,1975,3294,3653
0130-001,2012,5,25,23,1160,1307,2467,3294
0130-001,2012,5,25,24,784,988,1772,2467
0130-001,2012,5,26,1,518,638,1156,1772
0130-001,2012,5,26,2,394,347,741,1156
0130-001,2012,5,26,3,301,282,583,741
0130-001,2012,5,26,4,226,227,453,583
0130-001,2012,5,26,5,247,284,531,453
0130-001,2012,5,26,6,442,476,918,531
0130-001,2012,5,26,7,917,767,1684,918
0130-001,2012,5,26,8,1394,1258,2652,1684
0130-001,2012,5,26,9,1578,1523,3101,2652
0130-001,2012,5,26,10,1453,1818,3271,3101
0130-001,2012,5,26,11,1714,1169,2883,3271
0130-001,2012,5,26,12,1717,1780,3497,2883
0130-001,2012,5,26,13,1598,2295,3893,3497
0130-001,2012,5,26,14,1612,2205,3817,3893
0130-001,2012,5,26,15,1638,2073,3711,3817
0130-001,2012,5,26,16,1624,1792,3416,3711
0130-001,2012,5,26,17,1689,2334,4023,3416
0130-001,2012,5,26,18,1797,2212,4009,4023
0130-001,2012,5,26,19,1861,2322,4183,4009
0130-001,2012,5,26,20,1337,2282,3619,4183
0130-001,2012,5,26,21,1108,1973,3081,3619
0130-001,2012,5,26,22,1075,1837,2912,3081
0130-001,2012,5,26,23,888,1241,2129,2912
0130-001,2012,5,26,24,557,563,1120,2129
0130-001,2012,5,27,1,391,366,757,1120
0130-001,2012,5,27,2,269,233,502,757
0130-001,2012,5,27,3,220,204,424,502
0130-001,2012,5,27,4,190,168,358,424
0130-001,2012,5,27,5,198,146,344,358
0130-001,2012,5,27,6,310,312,622,344
0130-001,2012,5,27,7,529,529,1058,622
0130-001,2012,5,27,8,727,658,1385,1058
0130-001,2012,5,27,9,814,925,1739,1385
0130-001,2012,5,27,10,956,1062,2018,1739
0130-001,2012,5,27,11,1088,806,1894,2018
0130-001,2012,5,27,12,1023,1207,2230,1894
0130-001,2012,5,27,13,1272,1464,2736,2230
0130-001,2012,5,27,14,1221,1489,2710,2736
0130-001,2012,5,27,15,1370,1458,2828,2710
0130-001,2012,5,27,16,1484,1437,2921,2828
0130-001,2012,5,27,17,1736,1440,3176,2921
0130-001,2012,5,27,18,1794,1467,3261,3176
0130-001,2012,5,27,19,1788,1272,3060,3261
0130-001,2012,5,27,20,1698,1095,2793,3060
0130-001,2012,5,27,21,1453,1061,2514,2793
0130-001,2012,5,27,22,1342,852,2194,2514
0130-001,2012,5,27,23,994,665,1659,2194
0130-001,2012,5,27,24,694,425,1119,1659
0130-001,2012,5,28,1,455,306,761,1119
0130-001,2012,5,28,2,261,193,454,761
0130-001,2012,5,28,3,200,149,349,454
0130-001,2012,5,28,4,165,127,292,349
0130-001,2012,5,28,5,161,203,364,292
0130-001,2012,5,28,6,358,363,721,364
0130-001,2012,5,28,7,715,544,1259,721
0130-001,2012,5,28,8,1049,806,1855,1259
0130-001,2012,5,28,9,1074,1039,2113,1855
0130-001,2012,5,28,10,1309,1193,2502,2113
0130-001,2012,5,28,11,1578,1312,2890,2502
0130-001,2012,5,28,12,1821,1282,3103,2890
0130-001,2012,5,28,13,1847,1358,3205,3103
0130-001,2012,5,28,14,1924,1388,3312,3205
0130-001,2012,5,28,15,1886,1438,3324,3312
0130-001,2012,5,28,16,1960,1398,3358,3324
0130-001,2012,5,28,17,1975,1389,3364,3358
0130-001,2012,5,28,18,1994,1551,3545,3364
0130-001,2012,5,28,19,1986,1318,3304,3545
0130-001,2012,5,28,20,1661,1115,2776,3304
0130-001,2012,5,28,21,1205,1060,2265,2776
0130-001,2012,5,28,22,1135,822,1957,2265
0130-001,2012,5,28,23,821,550,1371,1957
0130-001,2012,5,28,24,514,366,880,1371
0130-001,2012,5,29,1,345,239,584,880
0130-001,2012,5,29,2,180,157,337,584
0130-001,2012,5,29,3,154,112,266,337
0130-001,2012,5,29,4,151,156,307,266
0130-001,2012,5,29,5,173,220,393,307
0130-001,2012,5,29,6,439,430,869,393
0130-001,2012,5,29,7,1463,871,2334,869
0130-001,2012,5,29,8,2334,1771,4105,2334
0130-001,2012,5,29,9,2178,2072,4250,4105
0130-001,2012,5,29,10,1711,1760,3471,4250
0130-001,2012,5,29,11,1666,1700,3366,3471
0130-001,2012,5,29,12,1661,1589,3250,3366
0130-001,2012,5,29,13,1379,1454,2833,3250
0130-001,2012,5,29,14,1643,1675,3318,2833
0130-001,2012,5,29,15,1822,1787,3609,3318
0130-001,2012,5,29,16,1824,1862,3686,3609
0130-001,2012,5,29,17,1711,1849,3560,3686
0130-001,2012,5,29,18,1618,2108,3726,3560
0130-001,2012,5,29,19,1797,2298,4095,3726
0130-001,2012,5,29,20,1384,1783,3167,4095
0130-001,2012,5,29,21,1208,1613,2821,3167
0130-001,2012,5,29,22,1152,1322,2474,2821
0130-001,2012,5,29,23,944,817,1761,2474
0130-001,2012,5,29,24,576,499,1075,1761
0130-001,2012,5,30,1,403,326,729,1075
0130-001,2012,5,30,2,254,236,490,729
0130-001,2012,5,30,3,186,189,375,490
0130-001,2012,5,30,4,172,176,348,375
0130-001,2012,5,30,5,170,238,408,348
0130-001,2012,5,30,6,394,421,815,408
0130-001,2012,5,30,7,1215,792,2007,815
0130-001,2012,5,30,8,2265,1673,3938,2007
0130-001,2012,5,30,9,2156,2043,4199,3938
0130-001,2012,5,30,10,1654,1782,3436,4199
0130-001,2012,5,30,11,1761,1664,3425,3436
0130-001,2012,5,30,12,1586,1586,3172,3425
0130-001,2012,5,30,13,1425,1451,2876,3172
0130-001,2012,5,30,14,1656,1645,3301,2876
0130-001,2012,5,30,15,1775,1723,3498,3301
0130-001,2012,5,30,16,1758,1765,3523,3498
0130-001,2012,5,30,17,1606,1783,3389,3523
0130-001,2012,5,30,18,1737,2150,3887,3389
0130-001,2012,5,30,19,1776,2340,4116,3887
0130-001,2012,5,30,20,1377,1819,3196,4116
0130-001,2012,5,30,21,1213,1532,2745,3196
0130-001,2012,5,30,22,1203,1228,2431,2745
0130-001,2012,5,30,23,988,819,1807,2431
0130-001,2012,5,30,24,621,555,1176,1807
0130-001,2012,5,31,1,440,375,815,1176
0130-001,2012,5,31,2,270,234,504,815
0130-001,2012,5,31,3,203,186,389,504
0130-001,2012,5,31,4,175,173,348,389
0130-001,2012,5,31,5,165,233,398,348
0130-001,2012,5,31,6,408,406,814,398
0130-001,2012,5,31,7,1204,765,1969,814
0130-001,2012,5,31,8,2269,1700,3969,1969
0130-001,2012,5,31,9,2207,2039,4246,3969
0130-001,2012,5,31,10,1530,1583,3113,4246
0130-001,2012,5,31,11,1744,1697,3441,3113
0130-001,2012,5,31,12,1565,1569,3134,3441
0130-001,2012,5,31,13,1426,1398,2824,3134
0130-001,2012,5,31,14,1722,1681,3403,2824
0130-001,2012,5,31,15,1788,1761,3549,3403
0130-001,2012,5,31,16,1762,1837,3599,3549
0130-001,2012,5,31,17,1715,1880,3595,3599
0130-001,2012,5,31,18,1742,2153,3895,3595
0130-001,2012,5,31,19,1808,2340,4148,3895
0130-001,2012,5,31,20,1425,1797,3222,4148
0130-001,2012,5,31,21,1205,1721,2926,3222
0130-001,2012,5,31,22,1215,1439,2654,2926
0130-001,2012,5,31,23,1012,871,1883,2654
0130-001,2012,5,31,24,641,544,1185,1883
0130-001,2012,6,1,1,458,393,851,1185
0130-001,2012,6,1,2,329,266,595,851
0130-001,2012,6,1,3,224,220,444,595
0130-001,2012,6,1,4,166,192,358,444
0130-001,2012,6,1,5,176,243,419,358
0130-001,2012,6,1,6,420,417,837,419
0130-001,2012,6,1,7,1240,818,2058,837
0130-001,2012,6,1,8,2273,1733,4006,2058
0130-001,2012,6,1,9,2200,2002,4202,4006
0130-001,2012,6,1,10,1647,1726,3373,4202
0130-001,2012,6,1,11,1766,1730,3496,3373
0130-001,2012,6,1,12,1656,1588,3244,3496
0130-001,2012,6,1,13,1437,1502,2939,3244
0130-001,2012,6,1,14,1683,1729,3412,2939
0130-001,2012,6,1,15,1752,1767,3519,3412
0130-001,2012,6,1,16,1790,1905,3695,3519
0130-001,2012,6,1,17,1808,1908,3716,3695
0130-001,2012,6,1,18,1913,2135,4048,3716
0130-001,2012,6,1,19,1960,2346,4306,4048
0130-001,2012,6,1,20,1603,2144,3747,4306
0130-001,2012,6,1,21,1295,1794,3089,3747
0130-001,2012,6,1,22,1322,1453,2775,3089
0130-001,2012,6,1,23,1139,944,2083,2775
0130-001,2012,6,1,24,869,648,1517,2083
0130-001,2012,6,2,1,506,453,959,1517
0130-001,2012,6,2,2,351,302,653,959
0130-001,2012,6,2,3,241,248,489,653
0130-001,2012,6,2,4,232,218,450,489
0130-001,2012,6,2,5,252,255,507,450
0130-001,2012,6,2,6,422,424,846,507
0130-001,2012,6,2,7,845,665,1510,846
0130-001,2012,6,2,8,1512,1146,2658,1510
0130-001,2012,6,2,9,1671,1768,3439,2658
0130-001,2012,6,2,10,1619,1884,3503,3439
0130-001,2012,6,2,11,1575,2013,3588,3503
0130-001,2012,6,2,12,1727,2188,3915,3588
0130-001,2012,6,2,13,1771,2166,3937,3915
0130-001,2012,6,2,14,1686,2211,3897,3937
0130-001,2012,6,2,15,1716,1998,3714,3897
0130-001,2012,6,2,16,1798,1844,3642,3714
0130-001,2012,6,2,17,1927,1819,3746,3642
0130-001,2012,6,2,18,1987,1937,3924,3746
0130-001,2012,6,2,19,1942,1937,3879,3924
0130-001,2012,6,2,20,1396,1428,2824,3879
0130-001,2012,6,2,21,1199,1199,2398,2824
0130-001,2012,6,2,22,1125,1033,2158,2398
0130-001,2012,6,2,23,861,694,1555,2158
0130-001,2012,6,2,24,620,525,1145,1555
0130-001,2012,6,3,1,414,354,768,1145
0130-001,2012,6,3,2,315,270,585,768
0130-001,2012,6,3,3,217,215,432,585
0130-001,2012,6,3,4,193,148,341,432
0130-001,2012,6,3,5,215,166,381,341
0130-001,2012,6,3,6,334,315,649,381
0130-001,2012,6,3,7,593,515,1108,649
0130-001,2012,6,3,8,708,664,1372,1108
0130-001,2012,6,3,9,819,941,1760,1372
0130-001,2012,6,3,10,970,1028,1998,1760
0130-001,2012,6,3,11,1165,1275,2440,1998
0130-001,2012,6,3,12,1053,1224,2277,2440
0130-001,2012,6,3,13,1111,1265,2376,2277
0130-001,2012,6,3,14,1315,1284,2599,2376
0130-001,2012,6,3,15,1405,1257,2662,2599
0130-001,2012,6,3,16,1587,1306,2893,2662
0130-001,2012,6,3,17,1869,1320,3189,2893
0130-001,2012,6,3,18,1900,1425,3325,3189
0130-001,2012,6,3,19,1815,1339,3154,3325
0130-001,2012,6,3,20,1247,1095,2342,3154
0130-001,2012,6,3,21,1091,1131,2222,2342
0130-001,2012,6,3,22,1156,899,2055,2222
0130-001,2012,6,3,23,900,686,1586,2055
0130-001,2012,6,3,24,585,450,1035,1586
0130-001,2012,6,4,1,323,286,609,1035
0130-001,2012,6,4,2,194,158,352,609
0130-001,2012,6,4,3,140,126,266,352
0130-001,2012,6,4,4,131,133,264,266
0130-001,2012,6,4,5,141,230,371,264
0130-001,2012,6,4,6,444,423,867,371
0130-001,2012,6,4,7,1429,821,2250,867
0130-001,2012,6,4,8,2363,1772,4135,2250
0130-001,2012,6,4,9,2182,2072,4254,4135
0130-001,2012,6,4,10,1668,1719,3387,4254
0130-001,2012,6,4,11,1646,1644,3290,3387
0130-001,2012,6,4,12,1528,1531,3059,3290
0130-001,2012,6,4,13,1401,1413,2814,3059
0130-001,2012,6,4,14,1615,1592,3207,2814
0130-001,2012,6,4,15,1695,1695,3390,3207
0130-001,2012,6,4,16,1665,1777,3442,3390
0130-001,2012,6,4,17,1602,1792,3394,3442
0130-001,2012,6,4,18,1684,2046,3730,3394
0130-001,2012,6,4,19,1818,2277,4095,3730
0130-001,2012,6,4,20,1432,1733,3165,4095
0130-001,2012,6,4,21,1197,1673,2870,3165
0130-001,2012,6,4,22,1172,1331,2503,2870
0130-001,2012,6,4,23,926,823,1749,2503
0130-001,2012,6,4,24,577,488,1065,1749
0130-001,2012,6,5,1,395,289,684,1065
0130-001,2012,6,5,2,267,237,504,684
0130-001,2012,6,5,3,192,170,362,504
0130-001,2012,6,5,4,158,164,322,362
0130-001,2012,6,5,5,157,238,395,322
0130-001,2012,6,5,6,397,439,836,395
0130-001,2012,6,5,7,1265,763,2028,836
0130-001,2012,6,5,8,2269,1697,3966,2028
0130-001,2012,6,5,9,2124,2047,4171,3966
0130-001,2012,6,5,10,1750,1875,3625,4171
0130-001,2012,6,5,11,1746,1694,3440,3625
0130-001,2012,6,5,12,1581,1616,3197,3440
0130-001,2012,6,5,13,1395,1389,2784,3197
0130-001,2012,6,5,14,1702,1720,3422,2784
0130-001,2012,6,5,15,1765,1725,3490,3422
0130-001,2012,6,5,16,1766,1770,3536,3490
0130-001,2012,6,5,17,1801,1910,3711,3536
0130-001,2012,6,5,18,1841,2152,3993,3711
0130-001,2012,6,5,19,1886,2321,4207,3993
0130-001,2012,6,5,20,1583,2092,3675,4207
0130-001,2012,6,5,21,1401,1905,3306,3675
0130-001,2012,6,5,22,1249,1468,2717,3306
0130-001,2012,6,5,23,1025,978,2003,2717
0130-001,2012,6,5,24,715,622,1337,2003
0130-001,2012,6,6,1,525,433,958,1337
0130-001,2012,6,6,2,365,338,703,958
0130-001,2012,6,6,3,288,250,538,703
0130-001,2012,6,6,4,205,215,420,538
0130-001,2012,6,6,5,223,259,482,420
0130-001,2012,6,6,6,401,411,812,482
0130-001,2012,6,6,7,871,578,1449,812
0130-001,2012,6,6,8,1356,998,2354,1449
0130-001,2012,6,6,9,1345,1309,2654,2354
0130-001,2012,6,6,10,1236,1324,2560,2654
0130-001,2012,6,6,11,1403,1403,2806,2560
0130-001,2012,6,6,12,1282,1466,2748,2806
0130-001,2012,6,6,13,1229,1381,2610,2748
0130-001,2012,6,6,14,1374,1378,2752,2610
0130-001,2012,6,6,15,1485,1470,2955,2752
0130-001,2012,6,6,16,1461,1438,2899,2955
0130-001,2012,6,6,17,1463,1384,2847,2899
0130-001,2012,6,6,18,1551,1800,3351,2847
0130-001,2012,6,6,19,1484,1633,3117,3351
0130-001,2012,6,6,20,1306,1280,2586,3117
0130-001,2012,6,6,21,1029,1157,2186,2586
0130-001,2012,6,6,22,1052,911,1963,2186
0130-001,2012,6,6,23,809,616,1425,1963
0130-001,2012,6,6,24,511,383,894,1425
0130-001,2012,6,7,1,334,273,607,894
0130-001,2012,6,7,2,211,183,394,607
0130-001,2012,6,7,3,139,134,273,394
0130-001,2012,6,7,4,153,140,293,273
0130-001,2012,6,7,5,140,219,359,293
0130-001,2012,6,7,6,383,378,761,359
0130-001,2012,6,7,7,1286,838,2124,761
0130-001,2012,6,7,8,2336,1750,4086,2124
0130-001,2012,6,7,9,2189,2077,4266,4086
0130-001,2012,6,7,10,1700,1832,3532,4266
0130-001,2012,6,7,11,1724,1666,3390,3532
0130-001,2012,6,7,12,1595,1643,3238,3390
0130-001,2012,6,7,13,1421,1454,2875,3238
0130-001,2012,6,7,14,1683,1651,3334,2875
0130-001,2012,6,7,15,1845,1753,3598,3334
0130-001,2012,6,7,16,1748,1730,3478,3598
0130-001,2012,6,7,17,1741,1864,3605,3478
0130-001,2012,6,7,18,1872,2161,4033,3605
0130-001,2012,6,7,19,1932,2287,4219,4033
0130-001,2012,6,7,20,1476,1876,3352,4219
0130-001,2012,6,7,21,1219,1729,2948,3352
0130-001,2012,6,7,22,1154,1329,2483,2948
0130-001,2012,6,7,23,958,857,1815,2483
0130-001,2012,6,7,24,667,541,1208,1815
0130-001,2012,6,8,1,443,379,822,1208
0130-001,2012,6,8,2,276,255,531,822
0130-001,2012,6,8,3,210,180,390,531
0130-001,2012,6,8,4,183,181,364,390
0130-001,2012,6,8,5,173,254,427,364
0130-001,2012,6,8,6,410,423,833,427
0130-001,2012,6,8,7,1186,773,1959,833
0130-001,2012,6,8,8,2073,1699,3772,1959
0130-001,2012,6,8,9,2215,1982,4197,3772
0130-001,2012,6,8,10,1793,1783,3576,4197
0130-001,2012,6,8,11,1745,1694,3439,3576
0130-001,2012,6,8,12,1713,1702,3415,3439
0130-001,2012,6,8,13,1431,1562,2993,3415
0130-001,2012,6,8,14,1705,1735,3440,2993
0130-001,2012,6,8,15,1792,1863,3655,3440
0130-001,2012,6,8,16,1762,1872,3634,3655
0130-001,2012,6,8,17,1758,1881,3639,3634
0130-001,2012,6,8,18,1954,1846,3800,3639
0130-001,2012,6,8,19,2037,2343,4380,3800
0130-001,2012,6,8,20,1537,2182,3719,4380
0130-001,2012,6,8,21,1222,1789,3011,3719
0130-001,2012,6,8,22,1375,1455,2830,3011
0130-001,2012,6,8,23,1011,950,1961,2830
0130-001,2012,6,8,24,760,614,1374,1961
0130-001,2012,6,9,1,550,456,1006,1374
0130-001,2012,6,9,2,352,338,690,1006
0130-001,2012,6,9,3,273,227,500,690
0130-001,2012,6,9,4,250,209,459,500
0130-001,2012,6,9,5,218,273,491,459
0130-001,2012,6,9,6,419,423,842,491
0130-001,2012,6,9,7,858,727,1585,842
0130-001,2012,6,9,8,1399,1165,2564,1585
0130-001,2012,6,9,9,1623,1646,3269,2564
0130-001,2012,6,9,10,1601,1801,3402,3269
0130-001,2012,6,9,11,1560,2013,3573,3402
0130-001,2012,6,9,12,1611,2189,3800,3573
0130-001,2012,6,9,13,1605,2179,3784,3800
0130-001,2012,6,9,14,1630,2008,3638,3784
0130-001,2012,6,9,15,1788,1935,3723,3638
0130-001,2012,6,9,16,1727,1896,3623,3723
0130-001,2012,6,9,17,1762,1918,3680,3623
0130-001,2012,6,9,18,1952,2067,4019,3680
0130-001,2012,6,9,19,1801,2091,3892,4019
0130-001,2012,6,9,20,1403,1544,2947,3892
0130-001,2012,6,9,21,1217,1174,2391,2947
0130-001,2012,6,9,22,1127,1019,2146,2391
0130-001,2012,6,9,23,901,732,1633,2146
0130-001,2012,6,9,24,622,540,1162,1633
0130-001,2012,6,10,1,467,407,874,1162
0130-001,2012,6,10,2,309,265,574,874
0130-001,2012,6,10,3,274,225,499,574
0130-001,2012,6,10,4,198,184,382,499
0130-001,2012,6,10,5,218,195,413,382
0130-001,2012,6,10,6,320,305,625,413
0130-001,2012,6,10,7,513,502,1015,625
0130-001,2012,6,10,8,674,611,1285,1015
0130-001,2012,6,10,9,842,904,1746,1285
0130-001,2012,6,10,10,953,997,1950,1746
0130-001,2012,6,10,11,1067,1215,2282,1950
0130-001,2012,6,10,12,1153,1218,2371,2282
0130-001,2012,6,10,13,1241,1340,2581,2371
0130-001,2012,6,10,14,1497,1345,2842,2581
0130-001,2012,6,10,15,1728,1304,3032,2842
0130-001,2012,6,10,16,1837,1349,3186,3032
0130-001,2012,6,10,17,1861,1299,3160,3186
0130-001,2012,6,10,18,1847,1342,3189,3160
0130-001,2012,6,10,19,1790,1204,2994,3189
0130-001,2012,6,10,20,1234,1123,2357,2994
0130-001,2012,6,10,21,1213,1048,2261,2357
0130-001,2012,6,10,22,1114,875,1989,2261
0130-001,2012,6,10,23,717,578,1295,1989
0130-001,2012,6,10,24,511,379,890,1295
0130-001,2012,6,11,1,325,252,577,890
0130-001,2012,6,11,2,203,155,358,577
0130-001,2012,6,11,3,145,130,275,358
0130-001,2012,6,11,4,122,130,252,275
0130-001,2012,6,11,5,169,225,394,252
0130-001,2012,6,11,6,438,435,873,394
0130-001,2012,6,11,7,1381,843,2224,873
0130-001,2012,6,11,8,2348,1769,4117,2224
0130-001,2012,6,11,9,2198,2007,4205,4117
0130-001,2012,6,11,10,1651,1771,3422,4205
0130-001,2012,6,11,11,1732,1576,3308,3422
0130-001,2012,6,11,12,1613,1613,3226,3308
0130-001,2012,6,11,13,1366,1473,2839,3226
0130-001,2012,6,11,14,1693,1649,3342,2839
0130-001,2012,6,11,15,1781,1793,3574,3342
0130-001,2012,6,11,16,1779,1863,3642,3574
0130-001,2012,6,11,17,1678,1842,3520,3642
0130-001,2012,6,11,18,1704,2139,3843,3520
0130-001,2012,6,11,19,1788,2256,4044,3843
0130-001,2012,6,11,20,1399,1843,3242,4044
0130-001,2012,6,11,21,1190,1791,2981,3242
0130-001,2012,6,11,22,1228,1369,2597,2981
0130-001,2012,6,11,23,910,757,1667,2597
0130-001,2012,6,11,24,572,472,1044,1667
0130-001,2012,6,12,1,431,317,748,1044
0130-001,2012,6,12,2,249,230,479,748
0130-001,2012,6,12,3,202,155,357,479
0130-001,2012,6,12,4,177,184,361,357
0130-001,2012,6,12,5,186,237,423,361
0130-001,2012,6,12,6,436,458,894,423
0130-001,2012,6,12,7,1240,757,1997,894
0130-001,2012,6,12,8,2316,1702,4018,1997
0130-001,2012,6,12,9,2129,2001,4130,4018
0130-001,2012,6,12,10,1853,1871,3724,4130
0130-001,2012,6,12,11,1739,1723,3462,3724
0130-001,2012,6,12,12,1652,1642,3294,3462
0130-001,2012,6,12,13,1402,1444,2846,3294
0130-001,2012,6,12,14,1683,1681,3364,2846
0130-001,2012,6,12,15,1790,1747,3537,3364
0130-001,2012,6,12,16,1644,1796,3440,3537
0130-001,2012,6,12,17,1673,1859,3532,3440
0130-001,2012,6,12,18,1761,2150,3911,3532
0130-001,2012,6,12,19,1796,2309,4105,3911
0130-001,2012,6,12,20,1420,1852,3272,4105
0130-001,2012,6,12,21,1188,1677,2865,3272
0130-001,2012,6,12,22,1197,1237,2434,2865
0130-001,2012,6,12,23,891,822,1713,2434
0130-001,2012,6,12,24,623,491,1114,1713
0130-001,2012,6,13,1,405,366,771,1114
0130-001,2012,6,13,2,246,222,468,771
0130-001,2012,6,13,3,195,170,365,468
0130-001,2012,6,13,4,165,153,318,365
0130-001,2012,6,13,5,187,250,437,318
0130-001,2012,6,13,6,428,436,864,437
0130-001,2012,6,13,7,1198,774,1972,864
0130-001,2012,6,13,8,2303,1705,4008,1972
0130-001,2012,6,13,9,2124,2056,4180,4008
0130-001,2012,6,13,10,1790,1762,3552,4180
0130-001,2012,6,13,11,1713,1617,3330,3552
0130-001,2012,6,13,12,1550,1726,3276,3330
0130-001,2012,6,13,13,1306,1454,2760,3276
0130-001,2012,6,13,14,1543,1610,3153,2760
0130-001,2012,6,13,15,1799,1785,3584,3153
0130-001,2012,6,13,16,1756,1750,3506,3584
0130-001,2012,6,13,17,1661,1836,3497,3506
0130-001,2012,6,13,18,1778,2138,3916,3497
0130-001,2012,6,13,19,1824,2378,4202,3916
0130-001,2012,6,13,20,1461,1810,3271,4202
0130-001,2012,6,13,21,1258,1669,2927,3271
0130-001,2012,6,13,22,1204,1307,2511,2927
0130-001,2012,6,13,23,954,800,1754,2511
0130-001,2012,6,13,24,647,502,1149,1754
0130-001,2012,6,14,1,439,375,814,1149
0130-001,2012,6,14,2,258,242,500,814
0130-001,2012,6,14,3,213,211,424,500
0130-001,2012,6,14,4,159,148,307,424
0130-001,2012,6,14,5,199,257,456,307
0130-001,2012,6,14,6,426,435,861,456
0130-001,2012,6,14,7,1267,798,2065,861
0130-001,2012,6,14,8,2313,1689,4002,2065
0130-001,2012,6,14,9,2139,2092,4231,4002
0130-001,2012,6,14,10,1790,1936,3726,4231
0130-001,2012,6,14,11,1712,1595,3307,3726
0130-001,2012,6,14,12,1544,1642,3186,3307
0130-001,2012,6,14,13,1388,1563,2951,3186
0130-001,2012,6,14,14,1651,1584,3235,2951
0130-001,2012,6,14,15,1771,1784,3555,3235
0130-001,2012,6,14,16,1677,1762,3439,3555
0130-001,2012,6,14,17,1705,1865,3570,3439
0130-001,2012,6,14,18,1768,2156,3924,3570
0130-001,2012,6,14,19,1738,2253,3991,3924
0130-001,2012,6,14,20,1470,1933,3403,3991
0130-001,2012,6,14,21,1224,1701,2925,3403
0130-001,2012,6,14,22,1338,1330,2668,2925
0130-001,2012,6,14,23,997,879,1876,2668
0130-001,2012,6,14,24,671,567,1238,1876
0130-001,2012,6,15,1,437,399,836,1238
0130-001,2012,6,15,2,310,238,548,836
0130-001,2012,6,15,3,211,220,431,548
0130-001,2012,6,15,4,185,170,355,431
0130-001,2012,6,15,5,196,261,457,355
0130-001,2012,6,15,6,452,442,894,457
0130-001,2012,6,15,7,1226,767,1993,894
0130-001,2012,6,15,8,2325,1651,3976,1993
0130-001,2012,6,15,9,2125,2041,4166,3976
0130-001,2012,6,15,10,1720,1737,3457,4166
0130-001,2012,6,15,11,1723,1731,3454,3457
0130-001,2012,6,15,12,1585,1702,3287,3454
0130-001,2012,6,15,13,1407,1412,2819,3287
0130-001,2012,6,15,14,1620,1719,3339,2819
0130-001,2012,6,15,15,1809,1743,3552,3339
0130-001,2012,6,15,16,1697,1894,3591,3552
0130-001,2012,6,15,17,1842,1827,3669,3591
0130-001,2012,6,15,18,1861,2230,4091,3669
0130-001,2012,6,15,19,1963,2355,4318,4091
0130-001,2012,6,15,20,1614,2067,3681,4318
0130-001,2012,6,15,21,1328,1804,3132,3681
0130-001,2012,6,15,22,1370,1480,2850,3132
0130-001,2012,6,15,23,1015,940,1955,2850
0130-001,2012,6,15,24,701,630,1331,1955
0130-001,2012,6,16,1,519,458,977,1331
0130-001,2012,6,16,2,343,338,681,977
0130-001,2012,6,16,3,255,243,498,681
0130-001,2012,6,16,4,259,211,470,498
0130-001,2012,6,16,5,247,292,539,470
0130-001,2012,6,16,6,454,434,888,539
0130-001,2012,6,16,7,908,707,1615,888
0130-001,2012,6,16,8,1546,1171,2717,1615
0130-001,2012,6,16,9,1712,1780,3492,2717
0130-001,2012,6,16,10,1715,1792,3507,3492
0130-001,2012,6,16,11,1609,1961,3570,3507
0130-001,2012,6,16,12,1589,2190,3779,3570
0130-001,2012,6,16,13,1631,2225,3856,3779
0130-001,2012,6,16,14,1683,2178,3861,3856
0130-001,2012,6,16,15,1774,2053,3827,3861
0130-001,2012,6,16,16,1713,2000,3713,3827
0130-001,2012,6,16,17,1871,1943,3814,3713
0130-001,2012,6,16,18,2021,2175,4196,3814
0130-001,2012,6,16,19,1880,2101,3981,4196
0130-001,2012,6,16,20,1441,1585,3026,3981
0130-001,2012,6,16,21,1194,1199,2393,3026
0130-001,2012,6,16,22,1161,1042,2203,2393
0130-001,2012,6,16,23,833,762,1595,2203
0130-001,2012,6,16,24,626,508,1134,1595
0130-001,2012,6,17,1,435,354,789,1134
0130-001,2012,6,17,2,313,264,577,789
0130-001,2012,6,17,3,246,208,454,577
0130-001,2012,6,17,4,212,151,363,454
0130-001,2012,6,17,5,230,190,420,363
0130-001,2012,6,17,6,344,325,669,420
0130-001,2012,6,17,7,557,487,1044,669
0130-001,2012,6,17,8,693,656,1349,1044
0130-001,2012,6,17,9,867,940,1807,1349
0130-001,2012,6,17,10,966,1153,2119,1807
0130-001,2012,6,17,11,1137,1396,2533,2119
0130-001,2012,6,17,12,1502,1377,2879,2533
0130-001,2012,6,17,13,1453,1412,2865,2879
0130-001,2012,6,17,14,1607,1370,2977,2865
0130-001,2012,6,17,15,1822,1429,3251,2977
0130-001,2012,6,17,16,1848,1351,3199,3251
0130-001,2012,6,17,17,1767,1368,3135,3199
0130-001,2012,6,17,18,1945,1348,3293,3135
0130-001,2012,6,17,19,1956,1331,3287,3293
0130-001,2012,6,17,20,1594,1122,2716,3287
0130-001,2012,6,17,21,1182,1112,2294,2716
0130-001,2012,6,17,22,1130,903,2033,2294
0130-001,2012,6,17,23,818,615,1433,2033
0130-001,2012,6,17,24,534,387,921,1433
0130-001,2012,6,18,1,293,258,551,921
0130-001,2012,6,18,2,214,162,376,551
0130-001,2012,6,18,3,139,125,264,376
0130-001,2012,6,18,4,136,126,262,264
0130-001,2012,6,18,5,184,227,411,262
0130-001,2012,6,18,6,410,444,854,411
0130-001,2012,6,18,7,1428,871,2299,854
0130-001,2012,6,18,8,2350,1787,4137,2299
0130-001,2012,6,18,9,1975,2040,4015,4137
0130-001,2012,6,18,10,1855,1709,3564,4015
0130-001,2012,6,18,11,1702,1566,3268,3564
0130-001,2012,6,18,12,1580,1594,3174,3268
0130-001,2012,6,18,13,1431,1696,3127,3174
0130-001,2012,6,18,14,1681,1869,3550,3127
0130-001,2012,6,18,15,1804,1894,3698,3550
0130-001,2012,6,18,16,1773,1914,3687,3698
0130-001,2012,6,18,17,1730,1902,3632,3687
0130-001,2012,6,18,18,1767,2151,3918,3632
0130-001,2012,6,18,19,1812,2274,4086,3918
0130-001,2012,6,18,20,1436,1776,3212,4086
0130-001,2012,6,18,21,1199,1584,2783,3212
0130-001,2012,6,18,22,1227,1291,2518,2783
0130-001,2012,6,18,23,837,842,1679,2518
0130-001,2012,6,18,24,571,488,1059,1679
0130-001,2012,6,19,1,404,334,738,1059
0130-001,2012,6,19,2,266,217,483,738
0130-001,2012,6,19,3,198,182,380,483
0130-001,2012,6,19,4,171,162,333,380
0130-001,2012,6,19,5,204,239,443,333
0130-001,2012,6,19,6,390,420,810,443
0130-001,2012,6,19,7,1247,804,2051,810
0130-001,2012,6,19,8,2290,1689,3979,2051
0130-001,2012,6,19,9,2149,2068,4217,3979
0130-001,2012,6,19,10,1801,1837,3638,4217
0130-001,2012,6,19,11,1685,1647,3332,3638
0130-001,2012,6,19,12,1567,1632,3199,3332
0130-001,2012,6,19,13,1390,1423,2813,3199
0130-001,2012,6,19,14,1737,1657,3394,2813
0130-001,2012,6,19,15,1800,1760,3560,3394
0130-001,2012,6,19,16,1673,1775,3448,3560
0130-001,2012,6,19,17,1624,1846,3470,3448
0130-001,2012,6,19,18,1742,2067,3809,3470
0130-001,2012,6,19,19,1699,2305,4004,3809
0130-001,2012,6,19,20,1428,1836,3264,4004
0130-001,2012,6,19,21,1245,1741,2986,3264
0130-001,2012,6,19,22,1245,1351,2596,2986
0130-001,2012,6,19,23,973,831,1804,2596
0130-001,2012,6,19,24,643,555,1198,1804
0130-001,2012,6,20,1,373,331,704,1198
0130-001,2012,6,20,2,264,255,519,704
0130-001,2012,6,20,3,210,184,394,519
0130-001,2012,6,20,4,147,179,326,394
0130-001,2012,6,20,5,200,264,464,326
0130-001,2012,6,20,6,419,427,846,464
0130-001,2012,6,20,7,1221,763,1984,846
0130-001,2012,6,20,8,2333,1682,4015,1984
0130-001,2012,6,20,9,2105,1977,4082,4015
0130-001,2012,6,20,10,1792,1822,3614,4082
0130-001,2012,6,20,11,1773,1633,3406,3614
0130-001,2012,6,20,12,1616,1611,3227,3406
0130-001,2012,6,20,13,1326,1489,2815,3227
0130-001,2012,6,20,14,1567,1699,3266,2815
0130-001,2012,6,20,15,1733,1766,3499,3266
0130-001,2012,6,20,16,1747,1753,3500,3499
0130-001,2012,6,20,17,1725,1840,3565,3500
0130-001,2012,6,20,18,1787,2078,3865,3565
0130-001,2012,6,20,19,1852,2317,4169,3865
0130-001,2012,6,20,20,1491,1977,3468,4169
0130-001,2012,6,20,21,1157,1634,2791,3468
0130-001,2012,6,20,22,1302,1330,2632,2791
0130-001,2012,6,20,23,970,843,1813,2632
0130-001,2012,6,20,24,681,527,1208,1813
0130-001,2012,6,21,1,409,378,787,1208
0130-001,2012,6,21,2,271,258,529,787
0130-001,2012,6,21,3,203,173,376,529
0130-001,2012,6,21,4,161,160,321,376
0130-001,2012,6,21,5,182,279,461,321
0130-001,2012,6,21,6,420,435,855,461
0130-001,2012,6,21,7,1293,815,2108,855
0130-001,2012,6,21,8,2293,1708,4001,2108
0130-001,2012,6,21,9,2147,1982,4129,4001
0130-001,2012,6,21,10,1750,1757,3507,4129
0130-001,2012,6,21,11,1762,1624,3386,3507
0130-001,2012,6,21,12,1541,1559,3100,3386
0130-001,2012,6,21,13,1338,1445,2783,3100
0130-001,2012,6,21,14,1296,1587,2883,2783
0130-001,2012,6,21,15,1684,1689,3373,2883
0130-001,2012,6,21,16,1704,1765,3469,3373
0130-001,2012,6,21,17,1646,1898,3544,3469
0130-001,2012,6,21,18,1695,2168,3863,3544
0130-001,2012,6,21,19,1736,2328,4064,3863
0130-001,2012,6,21,20,1438,1795,3233,4064
0130-001,2012,6,21,21,1261,1733,2994,3233
0130-001,2012,6,21,22,1220,1406,2626,2994
0130-001,2012,6,21,23,1006,878,1884,2626
0130-001,2012,6,21,24,681,526,1207,1884
0130-001,2012,6,22,1,418,390,808,1207
0130-001,2012,6,22,2,290,280,570,808
0130-001,2012,6,22,3,223,177,400,570
0130-001,2012,6,22,4,188,165,353,400
0130-001,2012,6,22,5,218,260,478,353
0130-001,2012,6,22,6,432,467,899,478
0130-001,2012,6,22,7,1196,761,1957,899
0130-001,2012,6,22,8,2322,1661,3983,1957
0130-001,2012,6,22,9,2145,2077,4222,3983
0130-001,2012,6,22,10,1693,1796,3489,4222
0130-001,2012,6,22,11,1758,1726,3484,3489
0130-001,2012,6,22,12,1632,1670,3302,3484
0130-001,2012,6,22,13,1406,1499,2905,3302
0130-001,2012,6,22,14,1676,1717,3393,2905
0130-001,2012,6,22,15,1770,1759,3529,3393
0130-001,2012,6,22,16,1772,1882,3654,3529
0130-001,2012,6,22,17,1789,1895,3684,3654
0130-001,2012,6,22,18,1987,2176,4163,3684
0130-001,2012,6,22,19,2019,2337,4356,4163
0130-001,2012,6,22,20,1594,2305,3899,4356
0130-001,2012,6,22,21,1292,1997,3289,3899
0130-001,2012,6,22,22,1281,1432,2713,3289
0130-001,2012,6,22,23,1047,952,1999,2713
0130-001,2012,6,22,24,818,624,1442,1999
0130-001,2012,6,23,1,546,458,1004,1442
0130-001,2012,6,23,2,354,335,689,1004
0130-001,2012,6,23,3,312,247,559,689
0130-001,2012,6,23,4,212,233,445,559
0130-001,2012,6,23,5,273,292,565,445
0130-001,2012,6,23,6,450,457,907,565
0130-001,2012,6,23,7,892,698,1590,907
0130-001,2012,6,23,8,1417,1133,2550,1590
0130-001,2012,6,23,9,1653,1603,3256,2550
0130-001,2012,6,23,10,1643,1804,3447,3256
0130-001,2012,6,23,11,1649,1964,3613,3447
0130-001,2012,6,23,12,1669,2069,3738,3613
0130-001,2012,6,23,13,1587,2036,3623,3738
0130-001,2012,6,23,14,1603,2016,3619,3623
0130-001,2012,6,23,15,1718,1914,3632,3619
0130-001,2012,6,23,16,1629,2019,3648,3632
0130-001,2012,6,23,17,1714,2034,3748,3648
0130-001,2012,6,23,18,1744,2063,3807,3748
0130-001,2012,6,23,19,1942,1965,3907,3807
0130-001,2012,6,23,20,1370,1521,2891,3907
0130-001,2012,6,23,21,1250,1187,2437,2891
0130-001,2012,6,23,22,1229,1050,2279,2437
0130-001,2012,6,23,23,908,708,1616,2279
0130-001,2012,6,23,24,614,525,1139,1616
0130-001,2012,6,24,1,443,383,826,1139
0130-001,2012,6,24,2,315,237,552,826
0130-001,2012,6,24,3,251,209,460,552
0130-001,2012,6,24,4,198,185,383,460
0130-001,2012,6,24,5,213,208,421,383
0130-001,2012,6,24,6,312,279,591,421
0130-001,2012,6,24,7,574,499,1073,591
0130-001,2012,6,24,8,728,662,1390,1073
0130-001,2012,6,24,9,818,938,1756,1390
0130-001,2012,6,24,10,905,1038,1943,1756
0130-001,2012,6,24,11,1120,1295,2415,1943
0130-001,2012,6,24,12,1116,1281,2397,2415
0130-001,2012,6,24,13,1238,1299,2537,2397
0130-001,2012,6,24,14,1418,1418,2836,2537
0130-001,2012,6,24,15,1420,1306,2726,2836
0130-001,2012,6,24,16,1721,1282,3003,2726
0130-001,2012,6,24,17,1869,1379,3248,3003
0130-001,2012,6,24,18,1885,1426,3311,3248
0130-001,2012,6,24,19,1806,1314,3120,3311
0130-001,2012,6,24,20,1480,1106,2586,3120
0130-001,2012,6,24,21,1413,1041,2454,2586
0130-001,2012,6,24,22,1119,887,2006,2454
0130-001,2012,6,24,23,759,588,1347,2006
0130-001,2012,6,24,24,499,378,877,1347
0130-001,2012,6,25,1,318,269,587,877
0130-001,2012,6,25,2,195,154,349,587
0130-001,2012,6,25,3,132,120,252,349
0130-001,2012,6,25,4,131,134,265,252
0130-001,2012,6,25,5,174,231,405,265
0130-001,2012,6,25,6,447,438,885,405
0130-001,2012,6,25,7,1429,848,2277,885
0130-001,2012,6,25,8,2330,1751,4081,2277
0130-001,2012,6,25,9,2141,2050,4191,4081
0130-001,2012,6,25,10,1689,1768,3457,4191
0130-001,2012,6,25,11,1644,1671,3315,3457
0130-001,2012,6,25,12,1591,1734,3325,3315
0130-001,2012,6,25,13,1389,1545,2934,3325
0130-001,2012,6,25,14,1566,1685,3251,2934
0130-001,2012,6,25,15,1755,1845,3600,3251
0130-001,2012,6,25,16,1748,1826,3574,3600
0130-001,2012,6,25,17,1770,1874,3644,3574
0130-001,2012,6,25,18,1761,2092,3853,3644
0130-001,2012,6,25,19,1877,2289,4166,3853
0130-001,2012,6,25,20,1472,1917,3389,4166
0130-001,2012,6,25,21,1318,1699,3017,3389
0130-001,2012,6,25,22,1191,1390,2581,3017
0130-001,2012,6,25,23,888,852,1740,2581
0130-001,2012,6,25,24,612,512,1124,1740
0130-001,2012,6,26,1,352,318,670,1124
0130-001,2012,6,26,2,240,223,463,670
0130-001,2012,6,26,3,174,176,350,463
0130-001,2012,6,26,4,181,195,376,350
0130-001,2012,6,26,5,196,256,452,376
0130-001,2012,6,26,6,431,442,873,452
0130-001,2012,6,26,7,1275,789,2064,873
0130-001,2012,6,26,8,2309,1749,4058,2064
0130-001,2012,6,26,9,2178,2049,4227,4058
0130-001,2012,6,26,10,1731,1755,3486,4227
0130-001,2012,6,26,11,1719,1645,3364,3486
0130-001,2012,6,26,12,1600,1637,3237,3364
0130-001,2012,6,26,13,1320,1449,2769,3237
0130-001,2012,6,26,14,1638,1622,3260,2769
0130-001,2012,6,26,15,1673,1702,3375,3260
0130-001,2012,6,26,16,1756,1681,3437,3375
0130-001,2012,6,26,17,1651,1771,3422,3437
0130-001,2012,6,26,18,1708,2102,3810,3422
0130-001,2012,6,26,19,1794,2274,4068,3810
0130-001,2012,6,26,20,1455,1781,3236,4068
0130-001,2012,6,26,21,1232,1687,2919,3236
0130-001,2012,6,26,22,1257,1344,2601,2919
0130-001,2012,6,26,23,970,850,1820,2601
0130-001,2012,6,26,24,650,560,1210,1820
0130-001,2012,6,27,1,450,369,819,1210
0130-001,2012,6,27,2,279,246,525,819
0130-001,2012,6,27,3,215,187,402,525
0130-001,2012,6,27,4,178,187,365,402
0130-001,2012,6,27,5,195,259,454,365
0130-001,2012,6,27,6,435,424,859,454
0130-001,2012,6,27,7,1215,747,1962,859
0130-001,2012,6,27,8,2308,1667,3975,1962
0130-001,2012,6,27,9,1987,2013,4000,3975
0130-001,2012,6,27,10,1678,1693,3371,4000
0130-001,2012,6,27,11,1714,1653,3367,3371
0130-001,2012,6,27,12,1620,1815,3435,3367
0130-001,2012,6,27,13,1506,1653,3159,3435
0130-001,2012,6,27,14,1609,1650,3259,3159
0130-001,2012,6,27,15,1742,1787,3529,3259
0130-001,2012,6,27,16,1658,1735,3393,3529
0130-001,2012,6,27,17,1701,1724,3425,3393
0130-001,2012,6,27,18,1784,2065,3849,3425
0130-001,2012,6,27,19,1857,2390,4247,3849
0130-001,2012,6,27,20,1526,1866,3392,4247
0130-001,2012,6,27,21,1319,1683,3002,3392
0130-001,2012,6,27,22,1243,1232,2475,3002
0130-001,2012,6,27,23,983,924,1907,2475
0130-001,2012,6,27,24,634,518,1152,1907
0130-001,2012,6,28,1,447,374,821,1152
0130-001,2012,6,28,2,282,277,559,821
0130-001,2012,6,28,3,199,184,383,559
0130-001,2012,6,28,4,185,162,347,383
0130-001,2012,6,28,5,199,270,469,347
0130-001,2012,6,28,6,472,444,916,469
0130-001,2012,6,28,7,1226,785,2011,916
0130-001,2012,6,28,8,2282,1656,3938,2011
0130-001,2012,6,28,9,2133,2015,4148,3938
0130-001,2012,6,28,10,1710,1848,3558,4148
0130-001,2012,6,28,11,1675,1661,3336,3558
0130-001,2012,6,28,12,1629,1599,3228,3336
0130-001,2012,6,28,13,1407,1471,2878,3228
0130-001,2012,6,28,14,1653,1677,3330,2878
0130-001,2012,6,28,15,1763,1682,3445,3330
0130-001,2012,6,28,16,1726,1790,3516,3445
0130-001,2012,6,28,17,1682,1885,3567,3516
0130-001,2012,6,28,18,1698,2086,3784,3567
0130-001,2012,6,28,19,1847,2307,4154,3784
0130-001,2012,6,28,20,1478,1807,3285,4154
0130-001,2012,6,28,21,1385,1728,3113,3285
0130-001,2012,6,28,22,1275,1350,2625,3113
0130-001,2012,6,28,23,1001,886,1887,2625
0130-001,2012,6,28,24,646,566,1212,1887
0130-001,2012,6,29,1,448,403,851,1212
0130-001,2012,6,29,2,275,232,507,851
0130-001,2012,6,29,3,226,214,440,507
0130-001,2012,6,29,4,166,189,355,440
0130-001,2012,6,29,5,195,265,460,355
0130-001,2012,6,29,6,414,449,863,460
0130-001,2012,6,29,7,1190,751,1941,863
0130-001,2012,6,29,8,2348,1696,4044,1941
0130-001,2012,6,29,9,2092,2028,4120,4044
0130-001,2012,6,29,10,1699,1771,3470,4120
0130-001,2012,6,29,11,1785,1753,3538,3470
0130-001,2012,6,29,12,1684,1686,3370,3538
0130-001,2012,6,29,13,1475,1566,3041,3370
0130-001,2012,6,29,14,1627,1750,3377,3041
0130-001,2012,6,29,15,1688,1721,3409,3377
0130-001,2012,6,29,16,1849,1810,3659,3409
0130-001,2012,6,29,17,1836,1868,3704,3659
0130-001,2012,6,29,18,1833,2208,4041,3704
0130-001,2012,6,29,19,1977,2419,4396,4041
0130-001,2012,6,29,20,1661,2131,3792,4396
0130-001,2012,6,29,21,1317,1800,3117,3792
0130-001,2012,6,29,22,1302,1364,2666,3117
0130-001,2012,6,29,23,1024,928,1952,2666
0130-001,2012,6,29,24,800,665,1465,1952
0130-001,2012,6,30,1,550,437,987,1465
0130-001,2012,6,30,2,338,323,661,987
0130-001,2012,6,30,3,266,254,520,661
0130-001,2012,6,30,4,216,213,429,520
0130-001,2012,6,30,5,224,252,476,429
0130-001,2012,6,30,6,347,374,721,476
0130-001,2012,6,30,7,635,524,1159,721
0130-001,2012,6,30,8,1247,961,2208,1159
0130-001,2012,6,30,9,1485,1442,2927,2208
0130-001,2012,6,30,10,1397,1579,2976,2927
0130-001,2012,6,30,11,1435,1753,3188,2976
0130-001,2012,6,30,12,1554,1768,3322,3188
0130-001,2012,6,30,13,1630,1854,3484,3322
0130-001,2012,6,30,14,1540,1883,3423,3484
0130-001,2012,6,30,15,1594,1891,3485,3423
0130-001,2012,6,30,16,1600,1874,3474,3485
0130-001,2012,6,30,17,1873,1937,3810,3474
0130-001,2012,6,30,18,1916,1965,3881,3810
0130-001,2012,6,30,19,1647,1744,3391,3881
0130-001,2012,6,30,20,1251,1271,2522,3391
0130-001,2012,6,30,21,1125,1068,2193,2522
0130-001,2012,6,30,22,1072,886,1958,2193
0130-001,2012,6,30,23,751,650,1401,1958
0130-001,2012,6,30,24,563,496,1059,1401
0130-001,2012,7,1,1,402,376,778,1059
0130-001,2012,7,1,2,318,247,565,778
0130-001,2012,7,1,3,256,191,447,565
0130-001,2012,7,1,4,194,164,358,447
0130-001,2012,7,1,5,195,177,372,358
0130-001,2012,7,1,6,307,293,600,372
0130-001,2012,7,1,7,475,438,913,600
0130-001,2012,7,1,8,711,546,1257,913
0130-001,2012,7,1,9,758,930,1688,1257
0130-001,2012,7,1,10,937,1127,2064,1688
0130-001,2012,7,1,11,1092,1245,2337,2064
0130-001,2012,7,1,12,1152,1199,2351,2337
0130-001,2012,7,1,13,1195,1342,2537,2351
0130-001,2012,7,1,14,1447,1369,2816,2537
0130-001,2012,7,1,15,1477,1417,2894,2816
0130-001,2012,7,1,16,1559,1450,3009,2894
0130-001,2012,7,1,17,1694,1379,3073,3009
0130-001,2012,7,1,18,1716,1424,3140,3073
0130-001,2012,7,1,19,1635,1312,2947,3140
0130-001,2012,7,1,20,1186,1062,2248,2947
0130-001,2012,7,1,21,1149,1047,2196,2248
0130-001,2012,7,1,22,1069,854,1923,2196
0130-001,2012,7,1,23,709,540,1249,1923
0130-001,2012,7,1,24,583,417,1000,1249
0130-001,2012,7,2,1,299,263,562,1000
0130-001,2012,7,2,2,190,177,367,562
0130-001,2012,7,2,3,157,138,295,367
0130-001,2012,7,2,4,142,137,279,295
0130-001,2012,7,2,5,169,266,435,279
0130-001,2012,7,2,6,438,424,862,435
0130-001,2012,7,2,7,1422,832,2254,862
0130-001,2012,7,2,8,2313,1788,4101,2254
0130-001,2012,7,2,9,2129,2004,4133,4101
0130-001,2012,7,2,10,1693,1719,3412,4133
0130-001,2012,7,2,11,1731,1616,3347,3412
0130-001,2012,7,2,12,1573,1480,3053,3347
0130-001,2012,7,2,13,1419,1525,2944,3053
0130-001,2012,7,2,14,1634,1690,3324,2944
0130-001,2012,7,2,15,1719,1756,3475,3324
0130-001,2012,7,2,16,1775,1847,3622,3475
0130-001,2012,7,2,17,1647,1761,3408,3622
0130-001,2012,7,2,18,1736,2057,3793,3408
0130-001,2012,7,2,19,1804,2290,4094,3793
0130-001,2012,7,2,20,1405,1792,3197,4094
0130-001,2012,7,2,21,1189,1690,2879,3197
0130-001,2012,7,2,22,1119,1308,2427,2879
0130-001,2012,7,2,23,845,797,1642,2427
0130-001,2012,7,2,24,616,520,1136,1642
0130-001,2012,7,3,1,367,326,693,1136
0130-001,2012,7,3,2,234,205,439,693
0130-001,2012,7,3,3,175,179,354,439
0130-001,2012,7,3,4,170,157,327,354
0130-001,2012,7,3,5,188,237,425,327
0130-001,2012,7,3,6,381,464,845,425
0130-001,2012,7,3,7,1273,804,2077,845
0130-001,2012,7,3,8,2300,1698,3998,2077
0130-001,2012,7,3,9,2076,2026,4102,3998
0130-001,2012,7,3,10,1685,1760,3445,4102
0130-001,2012,7,3,11,1691,1643,3334,3445
0130-001,2012,7,3,12,1528,1543,3071,3334
0130-001,2012,7,3,13,1336,1454,2790,3071
0130-001,2012,7,3,14,1717,1713,3430,2790
0130-001,2012,7,3,15,1755,1820,3575,3430
0130-001,2012,7,3,16,1731,1674,3405,3575
0130-001,2012,7,3,17,1571,1718,3289,3405
0130-001,2012,7,3,18,1663,2093,3756,3289
0130-001,2012,7,3,19,1715,2235,3950,3756
0130-001,2012,7,3,20,1391,1767,3158,3950
0130-001,2012,7,3,21,1181,1644,2825,3158
0130-001,2012,7,3,22,1152,1269,2421,2825
0130-001,2012,7,3,23,853,725,1578,2421
0130-001,2012,7,3,24,642,510,1152,1578
0130-001,2012,7,4,1,402,335,737,1152
0130-001,2012,7,4,2,261,211,472,737
0130-001,2012,7,4,3,205,191,396,472
0130-001,2012,7,4,4,145,141,286,396
0130-001,2012,7,4,5,198,244,442,286
0130-001,2012,7,4,6,409,428,837,442
0130-001,2012,7,4,7,1285,779,2064,837
0130-001,2012,7,4,8,2340,1704,4044,2064
0130-001,2012,7,4,9,2119,2025,4144,4044
0130-001,2012,7,4,10,1738,1762,3500,4144
0130-001,2012,7,4,11,1656,1646,3302,3500
0130-001,2012,7,4,12,1591,1576,3167,3302
0130-001,2012,7,4,13,1373,1444,2817,3167
0130-001,2012,7,4,14,1728,1669,3397,2817
0130-001,2012,7,4,15,1688,1767,3455,3397
0130-001,2012,7,4,16,1708,1784,3492,3455
0130-001,2012,7,4,17,1695,1847,3542,3492
0130-001,2012,7,4,18,1735,2158,3893,3542
0130-001,2012,7,4,19,1850,2395,4245,3893
0130-001,2012,7,4,20,1377,2140,3517,4245
0130-001,2012,7,4,21,1240,1524,2764,3517
0130-001,2012,7,4,22,1206,1227,2433,2764
0130-001,2012,7,4,23,884,779,1663,2433
0130-001,2012,7,4,24,613,526,1139,1663
0130-001,2012,7,5,1,403,336,739,1139
0130-001,2012,7,5,2,298,238,536,739
0130-001,2012,7,5,3,204,202,406,536
0130-001,2012,7,5,4,171,168,339,406
0130-001,2012,7,5,5,197,243,440,339
0130-001,2012,7,5,6,385,381,766,440
0130-001,2012,7,5,7,1172,777,1949,766
0130-001,2012,7,5,8,2191,1614,3805,1949
0130-001,2012,7,5,9,2105,1955,4060,3805
0130-001,2012,7,5,10,1707,1705,3412,4060
0130-001,2012,7,5,11,1669,1519,3188,3412
0130-001,2012,7,5,12,1529,1562,3091,3188
0130-001,2012,7,5,13,1310,1510,2820,3091
0130-001,2012,7,5,14,1656,1633,3289,2820
0130-001,2012,7,5,15,1693,1682,3375,3289
0130-001,2012,7,5,16,1573,1641,3214,3375
0130-001,2012,7,5,17,1533,1630,3163,3214
0130-001,2012,7,5,18,1620,1982,3602,3163
0130-001,2012,7,5,19,1711,2286,3997,3602
0130-001,2012,7,5,20,1348,1632,2980,3997
0130-001,2012,7,5,21,1110,1492,2602,2980
0130-001,2012,7,5,22,1109,1184,2293,2602
0130-001,2012,7,5,23,823,751,1574,2293
0130-001,2012,7,5,24,593,532,1125,1574
0130-001,2012,7,6,1,385,346,731,1125
0130-001,2012,7,6,2,263,219,482,731
0130-001,2012,7,6,3,233,187,420,482
0130-001,2012,7,6,4,158,158,316,420
0130-001,2012,7,6,5,157,200,357,316
0130-001,2012,7,6,6,297,340,637,357
0130-001,2012,7,6,7,1005,628,1633,637
0130-001,2012,7,6,8,2160,1621,3781,1633
0130-001,2012,7,6,9,2033,1963,3996,3781
0130-001,2012,7,6,10,1431,1663,3094,3996
0130-001,2012,7,6,11,1668,1511,3179,3094
0130-001,2012,7,6,12,1465,1575,3040,3179
0130-001,2012,7,6,13,1327,1472,2799,3040
0130-001,2012,7,6,14,1710,1643,3353,2799
0130-001,2012,7,6,15,1641,1750,3391,3353
0130-001,2012,7,6,16,1682,1833,3515,3391
0130-001,2012,7,6,17,1651,1802,3453,3515
0130-001,2012,7,6,18,1767,2033,3800,3453
0130-001,2012,7,6,19,1882,2274,4156,3800
0130-001,2012,7,6,20,1456,2075,3531,4156
0130-001,2012,7,6,21,1234,1618,2852,3531
0130-001,2012,7,6,22,1169,1176,2345,2852
0130-001,2012,7,6,23,944,838,1782,2345
0130-001,2012,7,6,24,660,575,1235,1782
0130-001,2012,7,7,1,491,407,898,1235
0130-001,2012,7,7,2,356,288,644,898
0130-001,2012,7,7,3,277,260,537,644
0130-001,2012,7,7,4,216,208,424,537
0130-001,2012,7,7,5,237,276,513,424
0130-001,2012,7,7,6,418,434,852,513
0130-001,2012,7,7,7,802,672,1474,852
0130-001,2012,7,7,8,1423,1083,2506,1474
0130-001,2012,7,7,9,1529,1556,3085,2506
0130-001,2012,7,7,10,1678,1725,3403,3085
0130-001,2012,7,7,11,1630,1913,3543,3403
0130-001,2012,7,7,12,1640,1916,3556,3543
0130-001,2012,7,7,13,1577,2063,3640,3556
0130-001,2012,7,7,14,1593,2034,3627,3640
0130-001,2012,7,7,15,1577,1968,3545,3627
0130-001,2012,7,7,16,1736,2043,3779,3545
0130-001,2012,7,7,17,1959,1947,3906,3779
0130-001,2012,7,7,18,2009,1957,3966,3906
0130-001,2012,7,7,19,1776,2050,3826,3966
0130-001,2012,7,7,20,1409,1406,2815,3826
0130-001,2012,7,7,21,1300,1211,2511,2815
0130-001,2012,7,7,22,1158,1075,2233,2511
0130-001,2012,7,7,23,885,822,1707,2233
0130-001,2012,7,7,24,679,525,1204,1707
0130-001,2012,7,8,1,432,364,796,1204
0130-001,2012,7,8,2,324,273,597,796
0130-001,2012,7,8,3,240,208,448,597
0130-001,2012,7,8,4,216,175,391,448
0130-001,2012,7,8,5,192,173,365,391
0130-001,2012,7,8,6,325,337,662,365
0130-001,2012,7,8,7,575,477,1052,662
0130-001,2012,7,8,8,796,673,1469,1052
0130-001,2012,7,8,9,853,930,1783,1469
0130-001,2012,7,8,10,903,1063,1966,1783
0130-001,2012,7,8,11,1143,1291,2434,1966
0130-001,2012,7,8,12,1165,1298,2463,2434
0130-001,2012,7,8,13,1205,1384,2589,2463
0130-001,2012,7,8,14,1398,1275,2673,2589
0130-001,2012,7,8,15,1490,1312,2802,2673
0130-001,2012,7,8,16,1762,1291,3053,2802
0130-001,2012,7,8,17,1811,1343,3154,3053
0130-001,2012,7,8,18,1858,1337,3195,3154
0130-001,2012,7,8,19,1837,1314,3151,3195
0130-001,2012,7,8,20,1415,1176,2591,3151
0130-001,2012,7,8,21,1216,1022,2238,2591
0130-001,2012,7,8,22,1097,830,1927,2238
0130-001,2012,7,8,23,709,593,1302,1927
0130-001,2012,7,8,24,475,360,835,1302
0130-001,2012,7,9,1,283,246,529,835
0130-001,2012,7,9,2,185,143,328,529
0130-001,2012,7,9,3,164,131,295,328
0130-001,2012,7,9,4,126,132,258,295
0130-001,2012,7,9,5,191,258,449,258
0130-001,2012,7,9,6,457,448,905,449
0130-001,2012,7,9,7,1417,866,2283,905
0130-001,2012,7,9,8,2326,1772,4098,2283
0130-001,2012,7,9,9,2179,1970,4149,4098
0130-001,2012,7,9,10,1692,1738,3430,4149
0130-001,2012,7,9,11,1748,1609,3357,3430
0130-001,2012,7,9,12,1591,1630,3221,3357
0130-001,2012,7,9,13,1327,1449,2776,3221
0130-001,2012,7,9,14,1707,1654,3361,2776
0130-001,2012,7,9,15,1706,1774,3480,3361
0130-001,2012,7,9,16,1818,1841,3659,3480
0130-001,2012,7,9,17,1676,1842,3518,3659
0130-001,2012,7,9,18,1758,2075,3833,3518
0130-001,2012,7,9,19,1790,2344,4134,3833
0130-001,2012,7,9,20,1504,1846,3350,4134
0130-001,2012,7,9,21,1325,1869,3194,3350
0130-001,2012,7,9,22,1228,1425,2653,3194
0130-001,2012,7,9,23,874,823,1697,2653
0130-001,2012,7,9,24,587,540,1127,1697
0130-001,2012,7,10,1,395,316,711,1127
0130-001,2012,7,10,2,221,202,423,711
0130-001,2012,7,10,3,196,195,391,423
0130-001,2012,7,10,4,163,154,317,391
0130-001,2012,7,10,5,192,262,454,317
0130-001,2012,7,10,6,445,442,887,454
0130-001,2012,7,10,7,1299,766,2065,887
0130-001,2012,7,10,8,2316,1693,4009,2065
0130-001,2012,7,10,9,2167,2022,4189,4009
0130-001,2012,7,10,10,1789,1784,3573,4189
0130-001,2012,7,10,11,1717,1627,3344,3573
0130-001,2012,7,10,12,1650,1613,3263,3344
0130-001,2012,7,10,13,1467,1620,3087,3263
0130-001,2012,7,10,14,1765,1745,3510,3087
0130-001,2012,7,10,15,1727,1744,3471,3510
0130-001,2012,7,10,16,1714,1733,3447,3471
0130-001,2012,7,10,17,1724,1908,3632,3447
0130-001,2012,7,10,18,1691,2148,3839,3632
0130-001,2012,7,10,19,1734,2293,4027,3839
0130-001,2012,7,10,20,1383,1886,3269,4027
0130-001,2012,7,10,21,1228,1688,2916,3269
0130-001,2012,7,10,22,1242,1282,2524,2916
0130-001,2012,7,10,23,890,803,1693,2524
0130-001,2012,7,10,24,628,498,1126,1693
0130-001,2012,7,11,1,394,322,716,1126
0130-001,2012,7,11,2,265,243,508,716
0130-001,2012,7,11,3,190,183,373,508
0130-001,2012,7,11,4,134,159,293,373
0130-001,2012,7,11,5,166,217,383,293
0130-001,2012,7,11,6,331,349,680,383
0130-001,2012,7,11,7,1025,706,1731,680
0130-001,2012,7,11,8,2231,1584,3815,1731
0130-001,2012,7,11,9,2049,1954,4003,3815
0130-001,2012,7,11,10,1741,1689,3430,4003
0130-001,2012,7,11,11,1637,1635,3272,3430
0130-001,2012,7,11,12,1566,1515,3081,3272
0130-001,2012,7,11,13,1350,1446,2796,3081
0130-001,2012,7,11,14,1598,1640,3238,2796
0130-001,2012,7,11,15,1698,1679,3377,3238
0130-001,2012,7,11,16,1693,1742,3435,3377
0130-001,2012,7,11,17,1633,1678,3311,3435
0130-001,2012,7,11,18,1648,2034,3682,3311
0130-001,2012,7,11,19,1784,2357,4141,3682
0130-001,2012,7,11,20,1380,1775,3155,4141
0130-001,2012,7,11,21,1243,1548,2791,3155
0130-001,2012,7,11,22,1166,1233,2399,2791
0130-001,2012,7,11,23,874,788,1662,2399
0130-001,2012,7,11,24,629,495,1124,1662
0130-001,2012,7,12,1,439,379,818,1124
0130-001,2012,7,12,2,276,272,548,818
0130-001,2012,7,12,3,215,203,418,548
0130-001,2012,7,12,4,170,166,336,418
0130-001,2012,7,12,5,194,247,441,336
0130-001,2012,7,12,6,414,456,870,441
0130-001,2012,7,12,7,1173,776,1949,870
0130-001,2012,7,12,8,2340,1669,4009,1949
0130-001,2012,7,12,9,2072,1954,4026,4009
0130-001,2012,7,12,10,1724,1805,3529,4026
0130-001,2012,7,12,11,1690,1660,3350,3529
0130-001,2012,7,12,12,1604,1623,3227,3350
0130-001,2012,7,12,13,1400,1454,2854,3227
0130-001,2012,7,12,14,1641,1623,3264,2854
0130-001,2012,7,12,15,1822,1724,3546,3264
0130-001,2012,7,12,16,1793,1789,3582,3546
0130-001,2012,7,12,17,1734,1872,3606,3582
0130-001,2012,7,12,18,1769,2195,3964,3606
0130-001,2012,7,12,19,1770,2338,4108,3964
0130-001,2012,7,12,20,1465,1829,3294,4108
0130-001,2012,7,12,21,1267,1691,2958,3294
0130-001,2012,7,12,22,1196,1328,2524,2958
0130-001,2012,7,12,23,898,787,1685,2524
0130-001,2012,7,12,24,641,539,1180,1685
0130-001,2012,7,13,1,440,365,805,1180
0130-001,2012,7,13,2,311,258,569,805
0130-001,2012,7,13,3,217,220,437,569
0130-001,2012,7,13,4,167,192,359,437
0130-001,2012,7,13,5,180,219,399,359
0130-001,2012,7,13,6,357,403,760,399
0130-001,2012,7,13,7,1137,766,1903,760
0130-001,2012,7,13,8,2310,1696,4006,1903
0130-001,2012,7,13,9,1848,2050,3898,4006
0130-001,2012,7,13,10,1798,1837,3635,3898
0130-001,2012,7,13,11,1704,1705,3409,3635
0130-001,2012,7,13,12,1585,1677,3262,3409
0130-001,2012,7,13,13,1437,1533,2970,3262
0130-001,2012,7,13,14,1708,1779,3487,2970
0130-001,2012,7,13,15,1766,1793,3559,3487
0130-001,2012,7,13,16,1743,1737,3480,3559
0130-001,2012,7,13,17,1808,1925,3733,3480
0130-001,2012,7,13,18,1968,2253,4221,3733
0130-001,2012,7,13,19,2058,2323,4381,4221
0130-001,2012,7,13,20,1549,2128,3677,4381
0130-001,2012,7,13,21,1402,1680,3082,3677
0130-001,2012,7,13,22,1334,1221,2555,3082
0130-001,2012,7,13,23,1014,920,1934,2555
0130-001,2012,7,13,24,760,656,1416,1934
0130-001,2012,7,14,1,476,451,927,1416
0130-001,2012,7,14,2,374,342,716,927
0130-001,2012,7,14,3,267,233,500,716
0130-001,2012,7,14,4,215,209,424,500
0130-001,2012,7,14,5,235,274,509,424
0130-001,2012,7,14,6,365,409,774,509
0130-001,2012,7,14,7,742,637,1379,774
0130-001,2012,7,14,8,1430,1162,2592,1379
0130-001,2012,7,14,9,1552,1715,3267,2592
0130-001,2012,7,14,10,1543,1728,3271,3267
0130-001,2012,7,14,11,1525,1799,3324,3271
0130-001,2012,7,14,12,1590,1999,3589,3324
0130-001,2012,7,14,13,1471,1972,3443,3589
0130-001,2012,7,14,14,1647,1962,3609,3443
0130-001,2012,7,14,15,1651,1822,3473,3609
0130-001,2012,7,14,16,1692,1876,3568,3473
0130-001,2012,7,14,17,1780,1908,3688,3568
0130-001,2012,7,14,18,1838,1879,3717,3688
0130-001,2012,7,14,19,1827,1840,3667,3717
0130-001,2012,7,14,20,1477,1316,2793,3667
0130-001,2012,7,14,21,1196,1014,2210,2793
0130-001,2012,7,14,22,1096,908,2004,2210
0130-001,2012,7,14,23,774,610,1384,2004
0130-001,2012,7,14,24,570,496,1066,1384
0130-001,2012,7,15,1,409,338,747,1066
0130-001,2012,7,15,2,265,281,546,747
0130-001,2012,7,15,3,215,185,400,546
0130-001,2012,7,15,4,180,158,338,400
0130-001,2012,7,15,5,176,146,322,338
0130-001,2012,7,15,6,202,251,453,322
0130-001,2012,7,15,7,376,365,741,453
0130-001,2012,7,15,8,596,670,1266,741
0130-001,2012,7,15,9,811,904,1715,1266
0130-001,2012,7,15,10,806,979,1785,1715
0130-001,2012,7,15,11,997,1263,2260,1785
0130-001,2012,7,15,12,1039,1213,2252,2260
0130-001,2012,7,15,13,1176,1427,2603,2252
0130-001,2012,7,15,14,1339,1332,2671,2603
0130-001,2012,7,15,15,1419,1410,2829,2671
0130-001,2012,7,15,16,1877,1432,3309,2829
0130-001,2012,7,15,17,1807,1348,3155,3309
0130-001,2012,7,15,18,2007,1374,3381,3155
0130-001,2012,7,15,19,1774,1229,3003,3381
0130-001,2012,7,15,20,1238,1016,2254,3003
0130-001,2012,7,15,21,1256,921,2177,2254
0130-001,2012,7,15,22,1031,787,1818,2177
0130-001,2012,7,15,23,663,532,1195,1818
0130-001,2012,7,15,24,492,355,847,1195
0130-001,2012,7,16,1,286,226,512,847
0130-001,2012,7,16,2,210,168,378,512
0130-001,2012,7,16,3,142,117,259,378
0130-001,2012,7,16,4,139,137,276,259
0130-001,2012,7,16,5,145,227,372,276
0130-001,2012,7,16,6,390,452,842,372
0130-001,2012,7,16,7,1341,810,2151,842
0130-001,2012,7,16,8,2372,1761,4133,2151
0130-001,2012,7,16,9,2185,2041,4226,4133
0130-001,2012,7,16,10,1647,1676,3323,4226
0130-001,2012,7,16,11,1673,1621,3294,3323
0130-001,2012,7,16,12,1660,1634,3294,3294
0130-001,2012,7,16,13,1453,1525,2978,3294
0130-001,2012,7,16,14,1688,1772,3460,2978
0130-001,2012,7,16,15,1819,1725,3544,3460
0130-001,2012,7,16,16,1768,1882,3650,3544
0130-001,2012,7,16,17,1703,1870,3573,3650
0130-001,2012,7,16,18,1827,2170,3997,3573
0130-001,2012,7,16,19,1862,2289,4151,3997
0130-001,2012,7,16,20,1458,1803,3261,4151
0130-001,2012,7,16,21,1259,1693,2952,3261
0130-001,2012,7,16,22,1231,1359,2590,2952
0130-001,2012,7,16,23,847,838,1685,2590
0130-001,2012,7,16,24,611,522,1133,1685
0130-001,2012,7,17,1,410,339,749,1133
0130-001,2012,7,17,2,261,205,466,749
0130-001,2012,7,17,3,182,196,378,466
0130-001,2012,7,17,4,171,170,341,378
0130-001,2012,7,17,5,171,246,417,341
0130-001,2012,7,17,6,400,437,837,417
0130-001,2012,7,17,7,1213,787,2000,837
0130-001,2012,7,17,8,2307,1652,3959,2000
0130-001,2012,7,17,9,2120,1966,4086,3959
0130-001,2012,7,17,10,1754,1935,3689,4086
0130-001,2012,7,17,11,1771,1774,3545,3689
0130-001,2012,7,17,12,1698,1642,3340,3545
0130-001,2012,7,17,13,1472,1482,2954,3340
0130-001,2012,7,17,14,1700,1684,3384,2954
0130-001,2012,7,17,15,1817,1656,3473,3384
0130-001,2012,7,17,16,1756,1781,3537,3473
0130-001,2012,7,17,17,1624,1845,3469,3537
0130-001,2012,7,17,18,1675,2106,3781,3469
0130-001,2012,7,17,19,1758,2275,4033,3781
0130-001,2012,7,17,20,1402,1758,3160,4033
0130-001,2012,7,17,21,1312,1629,2941,3160
0130-001,2012,7,17,22,1151,1279,2430,2941
0130-001,2012,7,17,23,838,762,1600,2430
0130-001,2012,7,17,24,615,545,1160,1600
0130-001,2012,7,18,1,388,374,762,1160
0130-001,2012,7,18,2,236,230,466,762
0130-001,2012,7,18,3,204,140,344,466
0130-001,2012,7,18,4,175,174,349,344
0130-001,2012,7,18,5,217,241,458,349
0130-001,2012,7,18,6,339,430,769,458
0130-001,2012,7,18,7,1061,705,1766,769
0130-001,2012,7,18,8,2230,1598,3828,1766
0130-001,2012,7,18,9,2162,1997,4159,3828
0130-001,2012,7,18,10,1681,1685,3366,4159
0130-001,2012,7,18,11,1684,1642,3326,3366
0130-001,2012,7,18,12,1609,1556,3165,3326
0130-001,2012,7,18,13,1345,1384,2729,3165
0130-001,2012,7,18,14,1681,1618,3299,2729
0130-001,2012,7,18,15,1750,1706,3456,3299
0130-001,2012,7,18,16,1672,1659,3331,3456
0130-001,2012,7,18,17,1570,1772,3342,3331
0130-001,2012,7,18,18,1692,2145,3837,3342
0130-001,2012,7,18,19,1860,2379,4239,3837
0130-001,2012,7,18,20,1449,1987,3436,4239
0130-001,2012,7,18,21,1305,1553,2858,3436
0130-001,2012,7,18,22,1181,1224,2405,2858
0130-001,2012,7,18,23,851,736,1587,2405
0130-001,2012,7,18,24,632,516,1148,1587
0130-001,2012,7,19,1,399,374,773,1148
0130-001,2012,7,19,2,251,239,490,773
0130-001,2012,7,19,3,192,162,354,490
0130-001,2012,7,19,4,163,151,314,354
0130-001,2012,7,19,5,158,189,347,314
0130-001,2012,7,19,6,266,346,612,347
0130-001,2012,7,19,7,1007,648,1655,612
0130-001,2012,7,19,8,2153,1528,3681,1655
0130-001,2012,7,19,9,2109,1960,4069,3681
0130-001,2012,7,19,10,1529,1672,3201,4069
0130-001,2012,7,19,11,1515,1473,2988,3201
0130-001,2012,7,19,12,1533,1551,3084,2988
0130-001,2012,7,19,13,1318,1367,2685,3084
0130-001,2012,7,19,14,1614,1558,3172,2685
0130-001,2012,7,19,15,1705,1624,3329,3172
0130-001,2012,7,19,16,1590,1560,3150,3329
0130-001,2012,7,19,17,1553,1732,3285,3150
0130-001,2012,7,19,18,1532,1990,3522,3285
0130-001,2012,7,19,19,1700,2311,4011,3522
0130-001,2012,7,19,20,1383,1751,3134,4011
0130-001,2012,7,19,21,1193,1588,2781,3134
0130-001,2012,7,19,22,1173,1229,2402,2781
0130-001,2012,7,19,23,886,833,1719,2402
0130-001,2012,7,19,24,651,568,1219,1719
0130-001,2012,7,20,1,415,367,782,1219
0130-001,2012,7,20,2,322,277,599,782
0130-001,2012,7,20,3,207,185,392,599
0130-001,2012,7,20,4,197,203,400,392
0130-001,2012,7,20,5,199,252,451,400
0130-001,2012,7,20,6,412,435,847,451
0130-001,2012,7,20,7,1161,778,1939,847
0130-001,2012,7,20,8,2319,1625,3944,1939
0130-001,2012,7,20,9,2021,2026,4047,3944
0130-001,2012,7,20,10,1682,1787,3469,4047
0130-001,2012,7,20,11,1663,1574,3237,3469
0130-001,2012,7,20,12,1627,1749,3376,3237
0130-001,2012,7,20,13,1498,1777,3275,3376
0130-001,2012,7,20,14,1689,1809,3498,3275
0130-001,2012,7,20,15,1762,1903,3665,3498
0130-001,2012,7,20,16,1665,1899,3564,3665
0130-001,2012,7,20,17,1701,1917,3618,3564
0130-001,2012,7,20,18,2101,2300,4401,3618
0130-001,2012,7,20,19,2032,2356,4388,4401
0130-001,2012,7,20,20,1662,2241,3903,4388
0130-001,2012,7,20,21,1373,1731,3104,3903
0130-001,2012,7,20,22,1317,1362,2679,3104
0130-001,2012,7,20,23,1010,887,1897,2679
0130-001,2012,7,20,24,724,662,1386,1897
0130-001,2012,7,21,1,563,448,1011,1386
0130-001,2012,7,21,2,389,341,730,1011
0130-001,2012,7,21,3,324,259,583,730
0130-001,2012,7,21,4,235,240,475,583
0130-001,2012,7,21,5,247,295,542,475
0130-001,2012,7,21,6,423,474,897,542
0130-001,2012,7,21,7,874,736,1610,897
0130-001,2012,7,21,8,1432,1131,2563,1610
0130-001,2012,7,21,9,1626,1635,3261,2563
0130-001,2012,7,21,10,1557,1648,3205,3261
0130-001,2012,7,21,11,1581,1829,3410,3205
0130-001,2012,7,21,12,1555,2023,3578,3410
0130-001,2012,7,21,13,1464,2086,3550,3578
0130-001,2012,7,21,14,1586,2080,3666,3550
0130-001,2012,7,21,15,1516,2017,3533,3666
0130-001,2012,7,21,16,1632,1959,3591,3533
0130-001,2012,7,21,17,1634,1785,3419,3591
0130-001,2012,7,21,18,1803,1935,3738,3419
0130-001,2012,7,21,19,1706,1955,3661,3738
0130-001,2012,7,21,20,1485,1451,2936,3661
0130-001,2012,7,21,21,1305,1180,2485,2936
0130-001,2012,7,21,22,1311,1080,2391,2485
0130-001,2012,7,21,23,835,689,1524,2391
0130-001,2012,7,21,24,625,541,1166,1524
0130-001,2012,7,22,1,445,378,823,1166
0130-001,2012,7,22,2,302,261,563,823
0130-001,2012,7,22,3,244,208,452,563
0130-001,2012,7,22,4,194,186,380,452
0130-001,2012,7,22,5,205,173,378,380
0130-001,2012,7,22,6,301,319,620,378
0130-001,2012,7,22,7,493,470,963,620
0130-001,2012,7,22,8,649,680,1329,963
0130-001,2012,7,22,9,753,899,1652,1329
0130-001,2012,7,22,10,876,963,1839,1652
0130-001,2012,7,22,11,1075,1099,2174,1839
0130-001,2012,7,22,12,1006,1195,2201,2174
0130-001,2012,7,22,13,1225,1451,2676,2201
0130-001,2012,7,22,14,1481,1298,2779,2676
0130-001,2012,7,22,15,1480,1319,2799,2779
0130-001,2012,7,22,16,1685,1430,3115,2799
0130-001,2012,7,22,17,1659,1342,3001,3115
0130-001,2012,7,22,18,1556,1486,3042,3001
0130-001,2012,7,22,19,1464,1200,2664,3042
0130-001,2012,7,22,20,1284,1091,2375,2664
0130-001,2012,7,22,21,1264,1019,2283,2375
0130-001,2012,7,22,22,1129,821,1950,2283
0130-001,2012,7,22,23,700,519,1219,1950
0130-001,2012,7,22,24,507,373,880,1219
0130-001,2012,7,23,1,291,233,524,880
0130-001,2012,7,23,2,204,145,349,524
0130-001,2012,7,23,3,143,109,252,349
0130-001,2012,7,23,4,125,130,255,252
0130-001,2012,7,23,5,160,221,381,255
0130-001,2012,7,23,6,399,453,852,381
0130-001,2012,7,23,7,1421,829,2250,852
0130-001,2012,7,23,8,2355,1626,3981,2250
0130-001,2012,7,23,9,2037,1969,4006,3981
0130-001,2012,7,23,10,1652,1762,3414,4006
0130-001,2012,7,23,11,1693,1746,3439,3414
0130-001,2012,7,23,12,1562,1831,3393,3439
0130-001,2012,7,23,13,1484,1837,3321,3393
0130-001,2012,7,23,14,1644,1906,3550,3321
0130-001,2012,7,23,15,1800,1826,3626,3550
0130-001,2012,7,23,16,1747,1834,3581,3626
0130-001,2012,7,23,17,1681,1857,3538,3581
0130-001,2012,7,23,18,1654,2093,3747,3538
0130-001,2012,7,23,19,1888,2258,4146,3747
0130-001,2012,7,23,20,1464,1833,3297,4146
0130-001,2012,7,23,21,1332,1702,3034,3297
0130-001,2012,7,23,22,1173,1350,2523,3034
0130-001,2012,7,23,23,883,722,1605,2523
0130-001,2012,7,23,24,562,499,1061,1605
0130-001,2012,7,24,1,437,329,766,1061
0130-001,2012,7,24,2,260,216,476,766
0130-001,2012,7,24,3,213,171,384,476
0130-001,2012,7,24,4,148,165,313,384
0130-001,2012,7,24,5,179,232,411,313
0130-001,2012,7,24,6,363,447,810,411
0130-001,2012,7,24,7,1206,804,2010,810
0130-001,2012,7,24,8,2295,1600,3895,2010
0130-001,2012,7,24,9,2113,1981,4094,3895
0130-001,2012,7,24,10,1771,1901,3672,4094
0130-001,2012,7,24,11,1659,1666,3325,3672
0130-001,2012,7,24,12,1599,1669,3268,3325
0130-001,2012,7,24,13,1411,1748,3159,3268
0130-001,2012,7,24,14,1595,1721,3316,3159
0130-001,2012,7,24,15,1697,1649,3346,3316
0130-001,2012,7,24,16,1669,1754,3423,3346
0130-001,2012,7,24,17,1642,1878,3520,3423
0130-001,2012,7,24,18,1735,2188,3923,3520
0130-001,2012,7,24,19,1853,2322,4175,3923
0130-001,2012,7,24,20,1615,2161,3776,4175
0130-001,2012,7,24,21,1327,1786,3113,3776
0130-001,2012,7,24,22,1257,1361,2618,3113
0130-001,2012,7,24,23,931,865,1796,2618
0130-001,2012,7,24,24,649,552,1201,1796
0130-001,2012,7,25,1,418,357,775,1201
0130-001,2012,7,25,2,266,267,533,775
0130-001,2012,7,25,3,201,191,392,533
0130-001,2012,7,25,4,182,177,359,392
0130-001,2012,7,25,5,182,251,433,359
0130-001,2012,7,25,6,407,479,886,433
0130-001,2012,7,25,7,1207,795,2002,886
0130-001,2012,7,25,8,2129,1542,3671,2002
0130-001,2012,7,25,9,2101,1960,4061,3671
0130-001,2012,7,25,10,1720,1830,3550,4061
0130-001,2012,7,25,11,1691,1683,3374,3550
0130-001,2012,7,25,12,1591,1624,3215,3374
0130-001,2012,7,25,13,1490,1482,2972,3215
0130-001,2012,7,25,14,1656,1683,3339,2972
0130-001,2012,7,25,15,1728,1746,3474,3339
0130-001,2012,7,25,16,1699,1755,3454,3474
0130-001,2012,7,25,17,1643,1800,3443,3454
0130-001,2012,7,25,18,1720,2079,3799,3443
0130-001,2012,7,25,19,1835,2134,3969,3799
0130-001,2012,7,25,20,1538,2102,3640,3969
0130-001,2012,7,25,21,1322,1705,3027,3640
0130-001,2012,7,25,22,1268,1294,2562,3027
0130-001,2012,7,25,23,970,838,1808,2562
0130-001,2012,7,25,24,684,560,1244,1808
0130-001,2012,7,26,1,442,419,861,1244
0130-001,2012,7,26,2,281,304,585,861
0130-001,2012,7,26,3,252,199,451,585
0130-001,2012,7,26,4,184,185,369,451
0130-001,2012,7,26,5,188,254,442,369
0130-001,2012,7,26,6,400,480,880,442
0130-001,2012,7,26,7,1241,814,2055,880
0130-001,2012,7,26,8,2246,1558,3804,2055
0130-001,2012,7,26,9,2119,1995,4114,3804
0130-001,2012,7,26,10,1742,1792,3534,4114
0130-001,2012,7,26,11,1810,1674,3484,3534
0130-001,2012,7,26,12,1537,1649,3186,3484
0130-001,2012,7,26,13,1544,1518,3062,3186
0130-001,2012,7,26,14,1623,1631,3254,3062
0130-001,2012,7,26,15,1718,1704,3422,3254
0130-001,2012,7,26,16,1707,1783,3490,3422
0130-001,2012,7,26,17,1666,1814,3480,3490
0130-001,2012,7,26,18,1746,2076,3822,3480
0130-001,2012,7,26,19,1819,2327,4146,3822
0130-001,2012,7,26,20,1540,1829,3369,4146
0130-001,2012,7,26,21,1354,1720,3074,3369
0130-001,2012,7,26,22,1240,1426,2666,3074
0130-001,2012,7,26,23,964,826,1790,2666
0130-001,2012,7,26,24,602,531,1133,1790
0130-001,2012,7,27,1,462,355,817,1133
0130-001,2012,7,27,2,277,252,529,817
0130-001,2012,7,27,3,209,198,407,529
0130-001,2012,7,27,4,187,192,379,407
0130-001,2012,7,27,5,207,261,468,379
0130-001,2012,7,27,6,401,472,873,468
0130-001,2012,7,27,7,1233,800,2033,873
0130-001,2012,7,27,8,2287,1542,3829,2033
0130-001,2012,7,27,9,1996,1938,3934,3829
0130-001,2012,7,27,10,1739,1759,3498,3934
0130-001,2012,7,27,11,1689,1744,3433,3498
0130-001,2012,7,27,12,1577,1669,3246,3433
0130-001,2012,7,27,13,1494,1530,3024,3246
0130-001,2012,7,27,14,1596,1719,3315,3024
0130-001,2012,7,27,15,1782,1780,3562,3315
0130-001,2012,7,27,16,1763,1841,3604,3562
0130-001,2012,7,27,17,1689,1899,3588,3604
0130-001,2012,7,27,18,2064,2225,4289,3588
0130-001,2012,7,27,19,1948,2346,4294,4289
0130-001,2012,7,27,20,1671,2294,3965,4294
0130-001,2012,7,27,21,1421,1728,3149,3965
0130-001,2012,7,27,22,1430,1385,2815,3149
0130-001,2012,7,27,23,1078,872,1950,2815
0130-001,2012,7,27,24,758,665,1423,1950
0130-001,2012,7,28,1,489,435,924,1423
0130-001,2012,7,28,2,323,322,645,924
0130-001,2012,7,28,3,305,233,538,645
0130-001,2012,7,28,4,238,234,472,538
0130-001,2012,7,28,5,266,299,565,472
0130-001,2012,7,28,6,428,507,935,565
0130-001,2012,7,28,7,857,688,1545,935
0130-001,2012,7,28,8,1329,1113,2442,1545
0130-001,2012,7,28,9,1582,1711,3293,2442
0130-001,2012,7,28,10,1563,1998,3561,3293
0130-001,2012,7,28,11,1511,1998,3509,3561
0130-001,2012,7,28,12,1462,2232,3694,3509
0130-001,2012,7,28,13,1427,2196,3623,3694
0130-001,2012,7,28,14,1456,2172,3628,3623
0130-001,2012,7,28,15,1514,2106,3620,3628
0130-001,2012,7,28,16,1452,2187,3639,3620
0130-001,2012,7,28,17,1569,2112,3681,3639
0130-001,2012,7,28,18,1701,2000,3701,3681
0130-001,2012,7,28,19,1694,1970,3664,3701
0130-001,2012,7,28,20,1342,1458,2800,3664
0130-001,2012,7,28,21,1268,1150,2418,2800
0130-001,2012,7,28,22,1276,1072,2348,2418
0130-001,2012,7,28,23,806,687,1493,2348
0130-001,2012,7,28,24,520,446,966,1493
0130-001,2012,7,29,1,380,327,707,966
0130-001,2012,7,29,2,279,280,559,707
0130-001,2012,7,29,3,229,186,415,559
0130-001,2012,7,29,4,197,156,353,415
0130-001,2012,7,29,5,194,144,338,353
0130-001,2012,7,29,6,312,290,602,338
0130-001,2012,7,29,7,528,486,1014,602
0130-001,2012,7,29,8,724,625,1349,1014
0130-001,2012,7,29,9,756,923,1679,1349
0130-001,2012,7,29,10,897,1014,1911,1679
0130-001,2012,7,29,11,971,1098,2069,1911
0130-001,2012,7,29,12,996,1156,2152,2069
0130-001,2012,7,29,13,1061,1211,2272,2152
0130-001,2012,7,29,14,1180,1302,2482,2272
0130-001,2012,7,29,15,1315,1259,2574,2482
0130-001,2012,7,29,16,1396,1347,2743,2574
0130-001,2012,7,29,17,1441,1193,2634,2743
0130-001,2012,7,29,18,1818,1321,3139,2634
0130-001,2012,7,29,19,1489,1202,2691,3139
0130-001,2012,7,29,20,1290,1110,2400,2691
0130-001,2012,7,29,21,1216,1042,2258,2400
0130-001,2012,7,29,22,1277,871,2148,2258
0130-001,2012,7,29,23,860,640,1500,2148
0130-001,2012,7,29,24,494,381,875,1500
0130-001,2012,7,30,1,332,293,625,875
0130-001,2012,7,30,2,208,181,389,625
0130-001,2012,7,30,3,138,116,254,389
0130-001,2012,7,30,4,136,135,271,254
0130-001,2012,7,30,5,178,236,414,271
0130-001,2012,7,30,6,382,435,817,414
0130-001,2012,7,30,7,1124,786,1910,817
0130-001,2012,7,30,8,2031,1483,3514,1910
0130-001,2012,7,30,9,1892,1887,3779,3514
0130-001,2012,7,30,10,1662,1705,3367,3779
0130-001,2012,7,30,11,1632,1688,3320,3367
0130-001,2012,7,30,12,1579,1660,3239,3320
0130-001,2012,7,30,13,1456,1549,3005,3239
0130-001,2012,7,30,14,1676,1725,3401,3005
0130-001,2012,7,30,15,1726,1775,3501,3401
0130-001,2012,7,30,16,1723,1703,3426,3501
0130-001,2012,7,30,17,1711,1619,3330,3426
0130-001,2012,7,30,18,1706,1917,3623,3330
0130-001,2012,7,30,19,1797,2114,3911,3623
0130-001,2012,7,30,20,1503,1695,3198,3911
0130-001,2012,7,30,21,1341,1475,2816,3198
0130-001,2012,7,30,22,1089,1096,2185,2816
0130-001,2012,7,30,23,843,781,1624,2185
0130-001,2012,7,30,24,562,473,1035,1624
0130-001,2012,7,31,1,379,316,695,1035
0130-001,2012,7,31,2,257,232,489,695
0130-001,2012,7,31,3,193,173,366,489
0130-001,2012,7,31,4,159,164,323,366
0130-001,2012,7,31,5,190,258,448,323
0130-001,2012,7,31,6,346,412,758,448
0130-001,2012,7,31,7,983,739,1722,758
0130-001,2012,7,31,8,1890,1446,3336,1722
0130-001,2012,7,31,9,1798,1751,3549,3336
0130-001,2012,7,31,10,1558,1626,3184,3549
0130-001,2012,7,31,11,1639,1544,3183,3184
0130-001,2012,7,31,12,1545,1628,3173,3183
0130-001,2012,7,31,13,1447,1480,2927,3173
0130-001,2012,7,31,14,1593,1653,3246,2927
0130-001,2012,7,31,15,1655,1671,3326,3246
0130-001,2012,7,31,16,1678,1753,3431,3326
0130-001,2012,7,31,17,1669,1729,3398,3431
0130-001,2012,7,31,18,1748,1972,3720,3398
0130-001,2012,7,31,19,1834,2269,4103,3720
0130-001,2012,7,31,20,1568,1767,3335,4103
0130-001,2012,7,31,21,1315,1424,2739,3335
0130-001,2012,7,31,22,1148,1167,2315,2739
0130-001,2012,7,31,23,908,785,1693,2315
0130-001,2012,7,31,24,633,510,1143,1693
0130-001,2012,8,1,1,442,371,813,1143
0130-001,2012,8,1,2,282,259,541,813
0130-001,2012,8,1,3,212,187,399,541
0130-001,2012,8,1,4,152,210,362,399
0130-001,2012,8,1,5,203,262,465,362
0130-001,2012,8,1,6,368,441,809,465
0130-001,2012,8,1,7,994,752,1746,809
0130-001,2012,8,1,8,1760,1358,3118,1746
0130-001,2012,8,1,9,1794,1687,3481,3118
0130-001,2012,8,1,10,1574,1640,3214,3481
0130-001,2012,8,1,11,1567,1780,3347,3214
0130-001,2012,8,1,12,1547,1764,3311,3347
0130-001,2012,8,1,13,1397,1688,3085,3311
0130-001,2012,8,1,14,1482,1937,3419,3085
0130-001,2012,8,1,15,1586,1949,3535,3419
0130-001,2012,8,1,16,1574,2047,3621,3535
0130-001,2012,8,1,17,1662,2069,3731,3621
0130-001,2012,8,1,18,1786,2186,3972,3731
0130-001,2012,8,1,19,1858,2250,4108,3972
0130-001,2012,8,1,20,1493,1787,3280,4108
0130-001,2012,8,1,21,1266,1334,2600,3280
0130-001,2012,8,1,22,1111,1034,2145,2600
0130-001,2012,8,1,23,883,698,1581,2145
0130-001,2012,8,1,24,592,507,1099,1581
0130-001,2012,8,2,1,412,325,737,1099
0130-001,2012,8,2,2,267,211,478,737
0130-001,2012,8,2,3,192,159,351,478
0130-001,2012,8,2,4,156,171,327,351
0130-001,2012,8,2,5,157,231,388,327
0130-001,2012,8,2,6,356,387,743,388
0130-001,2012,8,2,7,951,709,1660,743
0130-001,2012,8,2,8,1691,1301,2992,1660
0130-001,2012,8,2,9,1714,1683,3397,2992
0130-001,2012,8,2,10,1502,1630,3132,3397
0130-001,2012,8,2,11,1527,1670,3197,3132
0130-001,2012,8,2,12,1462,1780,3242,3197
0130-001,2012,8,2,13,1369,1775,3144,3242
0130-001,2012,8,2,14,1432,1860,3292,3144
0130-001,2012,8,2,15,1565,1918,3483,3292
0130-001,2012,8,2,16,1556,1971,3527,3483
0130-001,2012,8,2,17,1623,1881,3504,3527
0130-001,2012,8,2,18,1709,2097,3806,3504
0130-001,2012,8,2,19,1795,2066,3861,3806
0130-001,2012,8,2,20,1485,1527,3012,3861
0130-001,2012,8,2,21,1194,1326,2520,3012
0130-001,2012,8,2,22,1103,1050,2153,2520
0130-001,2012,8,2,23,863,732,1595,2153
0130-001,2012,8,2,24,568,468,1036,1595
0130-001,2012,8,3,1,412,339,751,1036
0130-001,2012,8,3,2,249,212,461,751
0130-001,2012,8,3,3,205,167,372,461
0130-001,2012,8,3,4,158,148,306,372
0130-001,2012,8,3,5,183,227,410,306
0130-001,2012,8,3,6,364,372,736,410
0130-001,2012,8,3,7,964,644,1608,736
0130-001,2012,8,3,8,1719,1249,2968,1608
0130-001,2012,8,3,9,1639,1612,3251,2968
0130-001,2012,8,3,10,1490,1587,3077,3251
0130-001,2012,8,3,11,1452,1555,3007,3077
0130-001,2012,8,3,12,1427,1691,3118,3007
0130-001,2012,8,3,13,1384,1541,2925,3118
0130-001,2012,8,3,14,1485,1664,3149,2925
0130-001,2012,8,3,15,1572,1732,3304,3149
0130-001,2012,8,3,16,1672,1680,3352,3304
0130-001,2012,8,3,17,1587,1732,3319,3352
0130-001,2012,8,3,18,1812,1885,3697,3319
0130-001,2012,8,3,19,1878,2168,4046,3697
0130-001,2012,8,3,20,1626,1645,3271,4046
0130-001,2012,8,3,21,1422,1424,2846,3271
0130-001,2012,8,3,22,1349,1107,2456,2846
0130-001,2012,8,3,23,925,738,1663,2456
0130-001,2012,8,3,24,617,533,1150,1663
0130-001,2012,8,4,1,464,390,854,1150
0130-001,2012,8,4,2,332,256,588,854
0130-001,2012,8,4,3,231,208,439,588
0130-001,2012,8,4,4,174,187,361,439
0130-001,2012,8,4,5,223,206,429,361
0130-001,2012,8,4,6,315,400,715,429
0130-001,2012,8,4,7,712,605,1317,715
0130-001,2012,8,4,8,1089,869,1958,1317
0130-001,2012,8,4,9,1117,1291,2408,1958
0130-001,2012,8,4,10,1224,1760,2984,2408
0130-001,2012,8,4,11,1322,1793,3115,2984
0130-001,2012,8,4,12,1296,1971,3267,3115
0130-001,2012,8,4,13,1329,1898,3227,3267
0130-001,2012,8,4,14,1501,1895,3396,3227
0130-001,2012,8,4,15,1508,1623,3131,3396
0130-001,2012,8,4,16,1625,1439,3064,3131
0130-001,2012,8,4,17,1689,1469,3158,3064
0130-001,2012,8,4,18,1875,1629,3504,3158
0130-001,2012,8,4,19,1803,1409,3212,3504
0130-001,2012,8,4,20,1599,1195,2794,3212
0130-001,2012,8,4,21,1450,1018,2468,2794
0130-001,2012,8,4,22,1317,929,2246,2468
0130-001,2012,8,4,23,894,636,1530,2246
0130-001,2012,8,4,24,608,427,1035,1530
0130-001,2012,8,5,1,353,333,686,1035
0130-001,2012,8,5,2,263,219,482,686
0130-001,2012,8,5,3,214,172,386,482
0130-001,2012,8,5,4,177,135,312,386
0130-001,2012,8,5,5,193,147,340,312
0130-001,2012,8,5,6,270,256,526,340
0130-001,2012,8,5,7,509,434,943,526
0130-001,2012,8,5,8,688,545,1233,943
0130-001,2012,8,5,9,676,770,1446,1233
0130-001,2012,8,5,10,793,857,1650,1446
0130-001,2012,8,5,11,858,1052,1910,1650
0130-001,2012,8,5,12,952,999,1951,1910
0130-001,2012,8,5,13,1136,1145,2281,1951
0130-001,2012,8,5,14,1290,1208,2498,2281
0130-001,2012,8,5,15,1530,1243,2773,2498
0130-001,2012,8,5,16,1715,1264,2979,2773
0130-001,2012,8,5,17,1636,1216,2852,2979
0130-001,2012,8,5,18,1793,1324,3117,2852
0130-001,2012,8,5,19,1848,1362,3210,3117
0130-001,2012,8,5,20,1644,1179,2823,3210
0130-001,2012,8,5,21,1400,1065,2465,2823
0130-001,2012,8,5,22,1362,884,2246,2465
0130-001,2012,8,5,23,841,546,1387,2246
0130-001,2012,8,5,24,530,393,923,1387
0130-001,2012,8,6,1,358,259,617,923
0130-001,2012,8,6,2,169,154,323,617
0130-001,2012,8,6,3,163,111,274,323
0130-001,2012,8,6,4,129,159,288,274
0130-001,2012,8,6,5,164,236,400,288
0130-001,2012,8,6,6,415,404,819,400
0130-001,2012,8,6,7,1304,841,2145,819
0130-001,2012,8,6,8,2277,1553,3830,2145
0130-001,2012,8,6,9,2021,1886,3907,3830
0130-001,2012,8,6,10,1686,1712,3398,3907
0130-001,2012,8,6,11,1654,1629,3283,3398
0130-001,2012,8,6,12,1503,1615,3118,3283
0130-001,2012,8,6,13,1402,1453,2855,3118
0130-001,2012,8,6,14,1578,1596,3174,2855
0130-001,2012,8,6,15,1710,1656,3366,3174
0130-001,2012,8,6,16,1712,1711,3423,3366
0130-001,2012,8,6,17,1661,1700,3361,3423
0130-001,2012,8,6,18,1753,2014,3767,3361
0130-001,2012,8,6,19,1811,2255,4066,3767
0130-001,2012,8,6,20,1458,1816,3274,4066
0130-001,2012,8,6,21,1262,1691,2953,3274
0130-001,2012,8,6,22,1068,1202,2270,2953
0130-001,2012,8,6,23,856,692,1548,2270
0130-001,2012,8,6,24,540,487,1027,1548
0130-001,2012,8,7,1,389,300,689,1027
0130-001,2012,8,7,2,250,215,465,689
0130-001,2012,8,7,3,198,158,356,465
0130-001,2012,8,7,4,147,166,313,356
0130-001,2012,8,7,5,183,263,446,313
0130-001,2012,8,7,6,390,431,821,446
0130-001,2012,8,7,7,1171,800,1971,821
0130-001,2012,8,7,8,2261,1450,3711,1971
0130-001,2012,8,7,9,1943,1861,3804,3711
0130-001,2012,8,7,10,1682,1754,3436,3804
0130-001,2012,8,7,11,1672,1660,3332,3436
0130-001,2012,8,7,12,1638,1591,3229,3332
0130-001,2012,8,7,13,1447,1514,2961,3229
0130-001,2012,8,7,14,1548,1733,3281,2961
0130-001,2012,8,7,15,1659,1792,3451,3281
0130-001,2012,8,7,16,1658,1753,3411,3451
0130-001,2012,8,7,17,1593,1718,3311,3411
0130-001,2012,8,7,18,1775,1992,3767,3311
0130-001,2012,8,7,19,1818,2222,4040,3767
0130-001,2012,8,7,20,1477,1894,3371,4040
0130-001,2012,8,7,21,1292,1689,2981,3371
0130-001,2012,8,7,22,1134,1171,2305,2981
0130-001,2012,8,7,23,887,754,1641,2305
0130-001,2012,8,7,24,569,521,1090,1641
0130-001,2012,8,8,1,412,325,737,1090
0130-001,2012,8,8,2,252,228,480,737
0130-001,2012,8,8,3,184,145,329,480
0130-001,2012,8,8,4,161,176,337,329
0130-001,2012,8,8,5,163,230,393,337
0130-001,2012,8,8,6,367,433,800,393
0130-001,2012,8,8,7,1153,766,1919,800
0130-001,2012,8,8,8,2233,1449,3682,1919
0130-001,2012,8,8,9,1988,1879,3867,3682
0130-001,2012,8,8,10,1655,1674,3329,3867
0130-001,2012,8,8,11,1675,1591,3266,3329
0130-001,2012,8,8,12,1550,1555,3105,3266
0130-001,2012,8,8,13,1354,1400,2754,3105
0130-001,2012,8,8,14,1536,1502,3038,2754
0130-001,2012,8,8,15,1732,1684,3416,3038
0130-001,2012,8,8,16,1671,1675,3346,3416
0130-001,2012,8,8,17,1640,1724,3364,3346
0130-001,2012,8,8,18,1716,2074,3790,3364
0130-001,2012,8,8,19,1823,2309,4132,3790
0130-001,2012,8,8,20,1447,1859,3306,4132
0130-001,2012,8,8,21,1322,1490,2812,3306
0130-001,2012,8,8,22,1126,1188,2314,2812
0130-001,2012,8,8,23,851,734,1585,2314
0130-001,2012,8,8,24,577,491,1068,1585
0130-001,2012,8,9,1,406,302,708,1068
0130-001,2012,8,9,2,279,223,502,708
0130-001,2012,8,9,3,184,203,387,502
0130-001,2012,8,9,4,149,166,315,387
0130-001,2012,8,9,5,183,246,429,315
0130-001,2012,8,9,6,376,400,776,429
0130-001,2012,8,9,7,1179,795,1974,776
0130-001,2012,8,9,8,2198,1475,3673,1974
0130-001,2012,8,9,9,2034,1862,3896,3673
0130-001,2012,8,9,10,1713,1783,3496,3896
0130-001,2012,8,9,11,1744,1696,3440,3496
0130-001,2012,8,9,12,1493,1577,3070,3440
0130-001,2012,8,9,13,1374,1459,2833,3070
0130-001,2012,8,9,14,1587,1491,3078,2833
0130-001,2012,8,9,15,1784,1738,3522,3078
0130-001,2012,8,9,16,1717,1636,3353,3522
0130-001,2012,8,9,17,1598,1724,3322,3353
0130-001,2012,8,9,18,1690,2078,3768,3322
0130-001,2012,8,9,19,1747,2244,3991,3768
0130-001,2012,8,9,20,1392,1800,3192,3991
0130-001,2012,8,9,21,1263,1525,2788,3192
0130-001,2012,8,9,22,1066,1192,2258,2788
0130-001,2012,8,9,23,854,717,1571,2258
0130-001,2012,8,9,24,587,494,1081,1571
0130-001,2012,8,10,1,404,344,748,1081
0130-001,2012,8,10,2,247,232,479,748
0130-001,2012,8,10,3,201,171,372,479
0130-001,2012,8,10,4,183,170,353,372
0130-001,2012,8,10,5,194,281,475,353
0130-001,2012,8,10,6,357,459,816,475
0130-001,2012,8,10,7,1162,683,1845,816
0130-001,2012,8,10,8,2091,1462,3553,1845
0130-001,2012,8,10,9,2022,1790,3812,3553
0130-001,2012,8,10,10,1650,1692,3342,3812
0130-001,2012,8,10,11,1676,1685,3361,3342
0130-001,2012,8,10,12,1589,1574,3163,3361
0130-001,2012,8,10,13,1472,1486,2958,3163
0130-001,2012,8,10,14,1636,1702,3338,2958
0130-001,2012,8,10,15,1749,1846,3595,3338
0130-001,2012,8,10,16,1739,1835,3574,3595
0130-001,2012,8,10,17,1722,1889,3611,3574
0130-001,2012,8,10,18,1779,2212,3991,3611
0130-001,2012,8,10,19,1988,2422,4410,3991
0130-001,2012,8,10,20,1667,2090,3757,4410
0130-001,2012,8,10,21,1300,1682,2982,3757
0130-001,2012,8,10,22,1231,1280,2511,2982
0130-001,2012,8,10,23,902,842,1744,2511
0130-001,2012,8,10,24,675,619,1294,1744
0130-001,2012,8,11,1,485,410,895,1294
0130-001,2012,8,11,2,358,312,670,895
0130-001,2012,8,11,3,263,235,498,670
0130-001,2012,8,11,4,265,259,524,498
0130-001,2012,8,11,5,195,263,458,524
0130-001,2012,8,11,6,381,409,790,458
0130-001,2012,8,11,7,880,725,1605,790
0130-001,2012,8,11,8,1345,1016,2361,1605
0130-001,2012,8,11,9,1395,1457,2852,2361
0130-001,2012,8,11,10,1454,1627,3081,2852
0130-001,2012,8,11,11,1562,1816,3378,3081
0130-001,2012,8,11,12,1406,1938,3344,3378
0130-001,2012,8,11,13,1468,1982,3450,3344
0130-001,2012,8,11,14,1514,2038,3552,3450
0130-001,2012,8,11,15,1591,1974,3565,3552
0130-001,2012,8,11,16,1582,1876,3458,3565
0130-001,2012,8,11,17,1587,1661,3248,3458
0130-001,2012,8,11,18,1685,1878,3563,3248
0130-001,2012,8,11,19,1522,1839,3361,3563
0130-001,2012,8,11,20,1337,1363,2700,3361
0130-001,2012,8,11,21,1227,1098,2325,2700
0130-001,2012,8,11,22,1193,985,2178,2325
0130-001,2012,8,11,23,773,609,1382,2178
0130-001,2012,8,11,24,554,419,973,1382
0130-001,2012,8,12,1,398,347,745,973
0130-001,2012,8,12,2,315,238,553,745
0130-001,2012,8,12,3,232,217,449,553
0130-001,2012,8,12,4,209,176,385,449
0130-001,2012,8,12,5,193,174,367,385
0130-001,2012,8,12,6,271,275,546,367
0130-001,2012,8,12,7,548,467,1015,546
0130-001,2012,8,12,8,603,543,1146,1015
0130-001,2012,8,12,9,701,814,1515,1146
0130-001,2012,8,12,10,912,945,1857,1515
0130-001,2012,8,12,11,1028,1117,2145,1857
0130-001,2012,8,12,12,987,1148,2135,2145
0130-001,2012,8,12,13,1075,1184,2259,2135
0130-001,2012,8,12,14,1228,1263,2491,2259
0130-001,2012,8,12,15,1380,1234,2614,2491
0130-001,2012,8,12,16,1439,1261,2700,2614
0130-001,2012,8,12,17,1535,1243,2778,2700
0130-001,2012,8,12,18,1570,1225,2795,2778
0130-001,2012,8,12,19,1587,1072,2659,2795
0130-001,2012,8,12,20,1416,958,2374,2659
0130-001,2012,8,12,21,1174,864,2038,2374
0130-001,2012,8,12,22,1121,696,1817,2038
0130-001,2012,8,12,23,626,475,1101,1817
0130-001,2012,8,12,24,470,331,801,1101
0130-001,2012,8,13,1,294,184,478,801
0130-001,2012,8,13,2,181,155,336,478
0130-001,2012,8,13,3,136,116,252,336
0130-001,2012,8,13,4,120,128,248,252
0130-001,2012,8,13,5,143,227,370,248
0130-001,2012,8,13,6,341,386,727,370
0130-001,2012,8,13,7,1220,719,1939,727
0130-001,2012,8,13,8,2086,1467,3553,1939
0130-001,2012,8,13,9,2068,1814,3882,3553
0130-001,2012,8,13,10,1641,1688,3329,3882
0130-001,2012,8,13,11,1746,1715,3461,3329
0130-001,2012,8,13,12,1622,1657,3279,3461
0130-001,2012,8,13,13,1515,1556,3071,3279
0130-001,2012,8,13,14,1670,1710,3380,3071
0130-001,2012,8,13,15,1810,1810,3620,3380
0130-001,2012,8,13,16,1759,1719,3478,3620
0130-001,2012,8,13,17,1723,1770,3493,3478
0130-001,2012,8,13,18,1773,2066,3839,3493
0130-001,2012,8,13,19,1861,2248,4109,3839
0130-001,2012,8,13,20,1449,1849,3298,4109
0130-001,2012,8,13,21,1253,1669,2922,3298
0130-001,2012,8,13,22,1120,1221,2341,2922
0130-001,2012,8,13,23,835,741,1576,2341
0130-001,2012,8,13,24,585,506,1091,1576
0130-001,2012,8,14,1,399,323,722,1091
0130-001,2012,8,14,2,244,202,446,722
0130-001,2012,8,14,3,187,180,367,446
0130-001,2012,8,14,4,169,171,340,367
0130-001,2012,8,14,5,171,213,384,340
0130-001,2012,8,14,6,403,383,786,384
0130-001,2012,8,14,7,1198,759,1957,786
0130-001,2012,8,14,8,2186,1511,3697,1957
0130-001,2012,8,14,9,1984,1833,3817,3697
0130-001,2012,8,14,10,1706,1746,3452,3817
0130-001,2012,8,14,11,1777,1770,3547,3452
0130-001,2012,8,14,12,1602,1573,3175,3547
0130-001,2012,8,14,13,1523,1511,3034,3175
0130-001,2012,8,14,14,1662,1704,3366,3034
0130-001,2012,8,14,15,1801,1819,3620,3366
0130-001,2012,8,14,16,1793,1877,3670,3620
0130-001,2012,8,14,17,1754,1887,3641,3670
0130-001,2012,8,14,18,1797,2269,4066,3641
0130-001,2012,8,14,19,1891,2405,4296,4066
0130-001,2012,8,14,20,1552,2217,3769,4296
0130-001,2012,8,14,21,1303,1722,3025,3769
0130-001,2012,8,14,22,1183,1314,2497,3025
0130-001,2012,8,14,23,951,820,1771,2497
0130-001,2012,8,14,24,653,603,1256,1771
0130-001,2012,8,15,1,475,394,869,1256
0130-001,2012,8,15,2,341,303,644,869
0130-001,2012,8,15,3,251,215,466,644
0130-001,2012,8,15,4,195,188,383,466
0130-001,2012,8,15,5,211,249,460,383
0130-001,2012,8,15,6,273,323,596,460
0130-001,2012,8,15,7,717,486,1203,596
0130-001,2012,8,15,8,1200,814,2014,1203
0130-001,2012,8,15,9,1152,1106,2258,2014
0130-001,2012,8,15,10,1179,1251,2430,2258
0130-001,2012,8,15,11,1226,1303,2529,2430
0130-001,2012,8,15,12,1266,1386,2652,2529
0130-001,2012,8,15,13,1299,1379,2678,2652
0130-001,2012,8,15,14,1264,1421,2685,2678
0130-001,2012,8,15,15,1314,1468,2782,2685
0130-001,2012,8,15,16,1342,1315,2657,2782
0130-001,2012,8,15,17,1491,1347,2838,2657
0130-001,2012,8,15,18,1575,1507,3082,2838
0130-001,2012,8,15,19,1373,1305,2678,3082
0130-001,2012,8,15,20,1117,962,2079,2678
0130-001,2012,8,15,21,944,930,1874,2079
0130-001,2012,8,15,22,836,636,1472,1874
0130-001,2012,8,15,23,626,475,1101,1472
0130-001,2012,8,15,24,375,326,701,1101
0130-001,2012,8,16,1,294,226,520,701
0130-001,2012,8,16,2,188,174,362,520
0130-001,2012,8,16,3,141,129,270,362
0130-001,2012,8,16,4,145,146,291,270
0130-001,2012,8,16,5,158,199,357,291
0130-001,2012,8,16,6,311,357,668,357
0130-001,2012,8,16,7,1106,706,1812,668
0130-001,2012,8,16,8,2192,1618,3810,1812
0130-001,2012,8,16,9,2132,1827,3959,3810
0130-001,2012,8,16,10,1638,1694,3332,3959
0130-001,2012,8,16,11,1671,1534,3205,3332
0130-001,2012,8,16,12,1657,1511,3168,3205
0130-001,2012,8,16,13,1473,1460,2933,3168
0130-001,2012,8,16,14,1686,1660,3346,2933
0130-001,2012,8,16,15,1738,1809,3547,3346
0130-001,2012,8,16,16,1779,1773,3552,3547
0130-001,2012,8,16,17,1622,1777,3399,3552
0130-001,2012,8,16,18,1693,1996,3689,3399
0130-001,2012,8,16,19,1797,2186,3983,3689
0130-001,2012,8,16,20,1386,1790,3176,3983
0130-001,2012,8,16,21,1173,1655,2828,3176
0130-001,2012,8,16,22,1042,1227,2269,2828
0130-001,2012,8,16,23,820,774,1594,2269
0130-001,2012,8,16,24,597,497,1094,1594
0130-001,2012,8,17,1,401,340,741,1094
0130-001,2012,8,17,2,275,175,450,741
0130-001,2012,8,17,3,197,189,386,450
0130-001,2012,8,17,4,164,188,352,386
0130-001,2012,8,17,5,191,256,447,352
0130-001,2012,8,17,6,385,417,802,447
0130-001,2012,8,17,7,1245,772,2017,802
0130-001,2012,8,17,8,2189,1614,3803,2017
0130-001,2012,8,17,9,2071,1854,3925,3803
0130-001,2012,8,17,10,1770,1788,3558,3925
0130-001,2012,8,17,11,1706,1681,3387,3558
0130-001,2012,8,17,12,1613,1685,3298,3387
0130-001,2012,8,17,13,1502,1511,3013,3298
0130-001,2012,8,17,14,1691,1683,3374,3013
0130-001,2012,8,17,15,1743,1857,3600,3374
0130-001,2012,8,17,16,1758,1847,3605,3600
0130-001,2012,8,17,17,1728,1783,3511,3605
0130-001,2012,8,17,18,1837,2161,3998,3511
0130-001,2012,8,17,19,1989,2322,4311,3998
0130-001,2012,8,17,20,1606,2195,3801,4311
0130-001,2012,8,17,21,1464,1746,3210,3801
0130-001,2012,8,17,22,1286,1311,2597,3210
0130-001,2012,8,17,23,982,812,1794,2597
0130-001,2012,8,17,24,687,578,1265,1794
0130-001,2012,8,18,1,538,432,970,1265
0130-001,2012,8,18,2,369,382,751,970
0130-001,2012,8,18,3,246,224,470,751
0130-001,2012,8,18,4,198,206,404,470
0130-001,2012,8,18,5,219,301,520,404
0130-001,2012,8,18,6,358,388,746,520
0130-001,2012,8,18,7,839,663,1502,746
0130-001,2012,8,18,8,1418,1043,2461,1502
0130-001,2012,8,18,9,1523,1517,3040,2461
0130-001,2012,8,18,10,1535,1590,3125,3040
0130-001,2012,8,18,11,1532,1691,3223,3125
0130-001,2012,8,18,12,1540,1855,3395,3223
0130-001,2012,8,18,13,1480,1924,3404,3395
0130-001,2012,8,18,14,1568,1943,3511,3404
0130-001,2012,8,18,15,1576,1903,3479,3511
0130-001,2012,8,18,16,1601,1868,3469,3479
0130-001,2012,8,18,17,1594,1761,3355,3469
0130-001,2012,8,18,18,1773,1918,3691,3355
0130-001,2012,8,18,19,1623,1818,3441,3691
0130-001,2012,8,18,20,1343,1305,2648,3441
0130-001,2012,8,18,21,1216,1107,2323,2648
0130-001,2012,8,18,22,1191,979,2170,2323
0130-001,2012,8,18,23,788,716,1504,2170
0130-001,2012,8,18,24,552,478,1030,1504
0130-001,2012,8,19,1,387,323,710,1030
0130-001,2012,8,19,2,300,261,561,710
0130-001,2012,8,19,3,254,189,443,561
0130-001,2012,8,19,4,195,178,373,443
0130-001,2012,8,19,5,188,165,353,373
0130-001,2012,8,19,6,253,313,566,353
0130-001,2012,8,19,7,513,429,942,566
0130-001,2012,8,19,8,670,564,1234,942
0130-001,2012,8,19,9,788,882,1670,1234
0130-001,2012,8,19,10,870,1004,1874,1670
0130-001,2012,8,19,11,1046,1078,2124,1874
0130-001,2012,8,19,12,984,1165,2149,2124
0130-001,2012,8,19,13,1141,1254,2395,2149
0130-001,2012,8,19,14,1311,1381,2692,2395
0130-001,2012,8,19,15,1399,1350,2749,2692
0130-001,2012,8,19,16,1524,1297,2821,2749
0130-001,2012,8,19,17,1583,1329,2912,2821
0130-001,2012,8,19,18,1668,1491,3159,2912
0130-001,2012,8,19,19,1517,1263,2780,3159
0130-001,2012,8,19,20,1297,1128,2425,2780
0130-001,2012,8,19,21,1138,971,2109,2425
0130-001,2012,8,19,22,1140,791,1931,2109
0130-001,2012,8,19,23,706,549,1255,1931
0130-001,2012,8,19,24,512,334,846,1255
0130-001,2012,8,20,1,286,251,537,846
0130-001,2012,8,20,2,201,176,377,537
0130-001,2012,8,20,3,135,124,259,377
0130-001,2012,8,20,4,121,110,231,259
0130-001,2012,8,20,5,164,206,370,231
0130-001,2012,8,20,6,342,401,743,370
0130-001,2012,8,20,7,1460,814,2274,743
0130-001,2012,8,20,8,2107,1740,3847,2274
0130-001,2012,8,20,9,2172,1859,4031,3847
0130-001,2012,8,20,10,1654,1713,3367,4031
0130-001,2012,8,20,11,1725,1711,3436,3367
0130-001,2012,8,20,12,1526,1559,3085,3436
0130-001,2012,8,20,13,1449,1445,2894,3085
0130-001,2012,8,20,14,1592,1496,3088,2894
0130-001,2012,8,20,15,1703,1694,3397,3088
0130-001,2012,8,20,16,1667,1685,3352,3397
0130-001,2012,8,20,17,1589,1742,3331,3352
0130-001,2012,8,20,18,1641,2001,3642,3331
0130-001,2012,8,20,19,1790,2305,4095,3642
0130-001,2012,8,20,20,1398,1760,3158,4095
0130-001,2012,8,20,21,1200,1656,2856,3158
0130-001,2012,8,20,22,1088,1154,2242,2856
0130-001,2012,8,20,23,772,666,1438,2242
0130-001,2012,8,20,24,527,443,970,1438
0130-001,2012,8,21,1,376,305,681,970
0130-001,2012,8,21,2,269,242,511,681
0130-001,2012,8,21,3,211,171,382,511
0130-001,2012,8,21,4,162,171,333,382
0130-001,2012,8,21,5,194,211,405,333
0130-001,2012,8,21,6,317,349,666,405
0130-001,2012,8,21,7,1188,708,1896,666
0130-001,2012,8,21,8,2158,1705,3863,1896
0130-001,2012,8,21,9,2141,1860,4001,3863
0130-001,2012,8,21,10,1741,1739,3480,4001
0130-001,2012,8,21,11,1708,1644,3352,3480
0130-001,2012,8,21,12,1579,1549,3128,3352
0130-001,2012,8,21,13,1436,1357,2793,3128
0130-001,2012,8,21,14,1547,1629,3176,2793
0130-001,2012,8,21,15,1718,1716,3434,3176
0130-001,2012,8,21,16,1701,1692,3393,3434
0130-001,2012,8,21,17,1594,1705,3299,3393
0130-001,2012,8,21,18,1761,2060,3821,3299
0130-001,2012,8,21,19,1669,2242,3911,3821
0130-001,2012,8,21,20,1378,1909,3287,3911
0130-001,2012,8,21,21,1287,1640,2927,3287
0130-001,2012,8,21,22,1160,1247,2407,2927
0130-001,2012,8,21,23,889,754,1643,2407
0130-001,2012,8,21,24,577,486,1063,1643
0130-001,2012,8,22,1,400,310,710,1063
0130-001,2012,8,22,2,257,225,482,710
0130-001,2012,8,22,3,181,178,359,482
0130-001,2012,8,22,4,176,162,338,359
0130-001,2012,8,22,5,145,217,362,338
0130-001,2012,8,22,6,321,347,668,362
0130-001,2012,8,22,7,1077,651,1728,668
0130-001,2012,8,22,8,2069,1694,3763,1728
0130-001,2012,8,22,9,2159,1863,4022,3763
0130-001,2012,8,22,10,1716,1637,3353,4022
0130-001,2012,8,22,11,1638,1521,3159,3353
0130-001,2012,8,22,12,1499,1422,2921,3159
0130-001,2012,8,22,13,1341,1349,2690,2921
0130-001,2012,8,22,14,1553,1515,3068,2690
0130-001,2012,8,22,15,1470,1533,3003,3068
0130-001,2012,8,22,16,1695,1745,3440,3003
0130-001,2012,8,22,17,1585,1636,3221,3440
0130-001,2012,8,22,18,1633,2111,3744,3221
0130-001,2012,8,22,19,1795,2402,4197,3744
0130-001,2012,8,22,20,1367,1719,3086,4197
0130-001,2012,8,22,21,1212,1403,2615,3086
0130-001,2012,8,22,22,1135,1139,2274,2615
0130-001,2012,8,22,23,923,778,1701,2274
0130-001,2012,8,22,24,576,456,1032,1701
0130-001,2012,8,23,1,413,335,748,1032
0130-001,2012,8,23,2,288,256,544,748
0130-001,2012,8,23,3,189,180,369,544
0130-001,2012,8,23,4,177,184,361,369
0130-001,2012,8,23,5,187,230,417,361
0130-001,2012,8,23,6,364,374,738,417
0130-001,2012,8,23,7,1215,741,1956,738
0130-001,2012,8,23,8,2196,1674,3870,1956
0130-001,2012,8,23,9,2154,1885,4039,3870
0130-001,2012,8,23,10,1615,1686,3301,4039
0130-001,2012,8,23,11,1666,1678,3344,3301
0130-001,2012,8,23,12,1566,1546,3112,3344
0130-001,2012,8,23,13,1349,1433,2782,3112
0130-001,2012,8,23,14,1594,1548,3142,2782
0130-001,2012,8,23,15,1648,1674,3322,3142
0130-001,2012,8,23,16,1698,1685,3383,3322
0130-001,2012,8,23,17,1705,1739,3444,3383
0130-001,2012,8,23,18,1685,2118,3803,3444
0130-001,2012,8,23,19,1778,2348,4126,3803
0130-001,2012,8,23,20,1419,1792,3211,4126
0130-001,2012,8,23,21,1230,1638,2868,3211
0130-001,2012,8,23,22,1171,1209,2380,2868
0130-001,2012,8,23,23,853,775,1628,2380
0130-001,2012,8,23,24,591,509,1100,1628
0130-001,2012,8,24,1,450,380,830,1100
0130-001,2012,8,24,2,298,258,556,830
0130-001,2012,8,24,3,203,207,410,556
0130-001,2012,8,24,4,183,171,354,410
0130-001,2012,8,24,5,179,255,434,354
0130-001,2012,8,24,6,343,345,688,434
0130-001,2012,8,24,7,1141,697,1838,688
0130-001,2012,8,24,8,2192,1744,3936,1838
0130-001,2012,8,24,9,2182,1903,4085,3936
0130-001,2012,8,24,10,1676,1724,3400,4085
0130-001,2012,8,24,11,1730,1604,3334,3400
0130-001,2012,8,24,12,1578,1662,3240,3334
0130-001,2012,8,24,13,1431,1451,2882,3240
0130-001,2012,8,24,14,1596,1620,3216,2882
0130-001,2012,8,24,15,1792,1834,3626,3216
0130-001,2012,8,24,16,1669,1888,3557,3626
0130-001,2012,8,24,17,1808,1901,3709,3557
0130-001,2012,8,24,18,1923,2075,3998,3709
0130-001,2012,8,24,19,1931,2214,4145,3998
0130-001,2012,8,24,20,1526,2223,3749,4145
0130-001,2012,8,24,21,1234,1596,2830,3749
0130-001,2012,8,24,22,1165,1259,2424,2830
0130-001,2012,8,24,23,903,819,1722,2424
0130-001,2012,8,24,24,648,534,1182,1722
0130-001,2012,8,25,1,477,414,891,1182
0130-001,2012,8,25,2,329,303,632,891
0130-001,2012,8,25,3,264,235,499,632
0130-001,2012,8,25,4,212,215,427,499
0130-001,2012,8,25,5,224,264,488,427
0130-001,2012,8,25,6,349,369,718,488
0130-001,2012,8,25,7,744,671,1415,718
0130-001,2012,8,25,8,1415,1042,2457,1415
0130-001,2012,8,25,9,1617,1562,3179,2457
0130-001,2012,8,25,10,1607,1803,3410,3179
0130-001,2012,8,25,11,1689,1918,3607,3410
0130-001,2012,8,25,12,1621,1993,3614,3607
0130-001,2012,8,25,13,1752,2071,3823,3614
0130-001,2012,8,25,14,1776,1963,3739,3823
0130-001,2012,8,25,15,1668,1811,3479,3739
0130-001,2012,8,25,16,1692,1971,3663,3479
0130-001,2012,8,25,17,1833,2054,3887,3663
0130-001,2012,8,25,18,1964,2165,4129,3887
0130-001,2012,8,25,19,1720,2160,3880,4129
0130-001,2012,8,25,20,1398,1494,2892,3880
0130-001,2012,8,25,21,1186,1179,2365,2892
0130-001,2012,8,25,22,1140,996,2136,2365
0130-001,2012,8,25,23,820,669,1489,2136
0130-001,2012,8,25,24,641,483,1124,1489
0130-001,2012,8,26,1,448,367,815,1124
0130-001,2012,8,26,2,322,277,599,815
0130-001,2012,8,26,3,298,216,514,599
0130-001,2012,8,26,4,192,173,365,514
0130-001,2012,8,26,5,200,154,354,365
0130-001,2012,8,26,6,269,262,531,354
0130-001,2012,8,26,7,540,439,979,531
0130-001,2012,8,26,8,760,582,1342,979
0130-001,2012,8,26,9,1042,935,1977,1342
0130-001,2012,8,26,10,920,980,1900,1977
0130-001,2012,8,26,11,1042,1251,2293,1900
0130-001,2012,8,26,12,1196,1370,2566,2293
0130-001,2012,8,26,13,1443,1426,2869,2566
0130-001,2012,8,26,14,1487,1399,2886,2869
0130-001,2012,8,26,15,1549,1557,3106,2886
0130-001,2012,8,26,16,1639,1554,3193,3106
0130-001,2012,8,26,17,1748,1547,3295,3193
0130-001,2012,8,26,18,1798,1524,3322,3295
0130-001,2012,8,26,19,1811,1369,3180,3322
0130-001,2012,8,26,20,1507,1270,2777,3180
0130-001,2012,8,26,21,1302,1135,2437,2777
0130-001,2012,8,26,22,1174,916,2090,2437
0130-001,2012,8,26,23,786,557,1343,2090
0130-001,2012,8,26,24,537,373,910,1343
0130-001,2012,8,27,1,318,249,567,910
0130-001,2012,8,27,2,185,179,364,567
0130-001,2012,8,27,3,125,104,229,364
0130-001,2012,8,27,4,124,145,269,229
0130-001,2012,8,27,5,174,269,443,269
0130-001,2012,8,27,6,410,425,835,443
0130-001,2012,8,27,7,1478,867,2345,835
0130-001,2012,8,27,8,2205,1802,4007,2345
0130-001,2012,8,27,9,2292,1917,4209,4007
0130-001,2012,8,27,10,1856,1763,3619,4209
0130-001,2012,8,27,11,1787,1690,3477,3619
0130-001,2012,8,27,12,1609,1589,3198,3477
0130-001,2012,8,27,13,1453,1497,2950,3198
0130-001,2012,8,27,14,1755,1663,3418,2950
0130-001,2012,8,27,15,1797,1893,3690,3418
0130-001,2012,8,27,16,1894,1858,3752,3690
0130-001,2012,8,27,17,1795,1888,3683,3752
0130-001,2012,8,27,18,1820,2213,4033,3683
0130-001,2012,8,27,19,1897,2396,4293,4033
0130-001,2012,8,27,20,1583,1924,3507,4293
0130-001,2012,8,27,21,1297,1809,3106,3507
0130-001,2012,8,27,22,1145,1293,2438,3106
0130-001,2012,8,27,23,805,763,1568,2438
0130-001,2012,8,27,24,550,481,1031,1568
0130-001,2012,8,28,1,365,320,685,1031
0130-001,2012,8,28,2,231,214,445,685
0130-001,2012,8,28,3,169,149,318,445
0130-001,2012,8,28,4,160,152,312,318
0130-001,2012,8,28,5,160,195,355,312
0130-001,2012,8,28,6,292,311,603,355
0130-001,2012,8,28,7,1082,636,1718,603
0130-001,2012,8,28,8,2116,1461,3577,1718
0130-001,2012,8,28,9,1902,1581,3483,3577
0130-001,2012,8,28,10,1322,1316,2638,3483
0130-001,2012,8,28,11,1136,1148,2284,2638
0130-001,2012,8,28,12,984,981,1965,2284
0130-001,2012,8,28,13,859,891,1750,1965
0130-001,2012,8,28,14,1030,989,2019,1750
0130-001,2012,8,28,15,1068,1132,2200,2019
0130-001,2012,8,28,16,1147,1220,2367,2200
0130-001,2012,8,28,17,1086,1184,2270,2367
0130-001,2012,8,28,18,1253,1710,2963,2270
0130-001,2012,8,28,19,1443,2022,3465,2963
0130-001,2012,8,28,20,1068,1381,2449,3465
0130-001,2012,8,28,21,815,1204,2019,2449
0130-001,2012,8,28,22,742,826,1568,2019
0130-001,2012,8,28,23,464,521,985,1568
0130-001,2012,8,28,24,373,326,699,985
0130-001,2012,8,29,1,233,247,480,699
0130-001,2012,8,29,2,196,145,341,480
0130-001,2012,8,29,3,148,125,273,341
0130-001,2012,8,29,4,118,121,239,273
0130-001,2012,8,29,5,139,216,355,239
0130-001,2012,8,29,6,361,374,735,355
0130-001,2012,8,29,7,1231,655,1886,735
0130-001,2012,8,29,8,2250,1695,3945,1886
0130-001,2012,8,29,9,2243,1894,4137,3945
0130-001,2012,8,29,10,1700,1822,3522,4137
0130-001,2012,8,29,11,1800,1711,3511,3522
0130-001,2012,8,29,12,1688,1704,3392,3511
0130-001,2012,8,29,13,1462,1539,3001,3392
0130-001,2012,8,29,14,1519,1731,3250,3001
0130-001,2012,8,29,15,1841,1817,3658,3250
0130-001,2012,8,29,16,1817,1742,3559,3658
0130-001,2012,8,29,17,1713,1830,3543,3559
0130-001,2012,8,29,18,1817,2298,4115,3543
0130-001,2012,8,29,19,1855,2360,4215,4115
0130-001,2012,8,29,20,1546,2152,3698,4215
0130-001,2012,8,29,21,1216,1571,2787,3698
0130-001,2012,8,29,22,1211,1232,2443,2787
0130-001,2012,8,29,23,896,830,1726,2443
0130-001,2012,8,29,24,653,511,1164,1726
0130-001,2012,8,30,1,465,377,842,1164
0130-001,2012,8,30,2,283,252,535,842
0130-001,2012,8,30,3,220,204,424,535
0130-001,2012,8,30,4,179,173,352,424
0130-001,2012,8,30,5,196,240,436,352
0130-001,2012,8,30,6,323,357,680,436
0130-001,2012,8,30,7,1085,678,1763,680
0130-001,2012,8,30,8,2068,1648,3716,1763
0130-001,2012,8,30,9,2019,1828,3847,3716
0130-001,2012,8,30,10,1786,1670,3456,3847
0130-001,2012,8,30,11,1640,1454,3094,3456
0130-001,2012,8,30,12,1368,1446,2814,3094
0130-001,2012,8,30,13,1277,1381,2658,2814
0130-001,2012,8,30,14,1406,1356,2762,2658
0130-001,2012,8,30,15,1511,1463,2974,2762
0130-001,2012,8,30,16,1383,1526,2909,2974
0130-001,2012,8,30,17,1415,1523,2938,2909
0130-001,2012,8,30,18,1554,1972,3526,2938
0130-001,2012,8,30,19,1611,2211,3822,3526
0130-001,2012,8,30,20,1246,1556,2802,3822
0130-001,2012,8,30,21,991,1531,2522,2802
0130-001,2012,8,30,22,973,1069,2042,2522
0130-001,2012,8,30,23,786,677,1463,2042
0130-001,2012,8,30,24,517,460,977,1463
0130-001,2012,8,31,1,356,306,662,977
0130-001,2012,8,31,2,244,223,467,662
0130-001,2012,8,31,3,199,172,371,467
0130-001,2012,8,31,4,176,158,334,371
0130-001,2012,8,31,5,194,218,412,334
0130-001,2012,8,31,6,352,380,732,412
0130-001,2012,8,31,7,1247,746,1993,732
0130-001,2012,8,31,8,2236,1703,3939,1993
0130-001,2012,8,31,9,2211,1888,4099,3939
0130-001,2012,8,31,10,1692,1840,3532,4099
0130-001,2012,8,31,11,1910,1757,3667,3532
0130-001,2012,8,31,12,1668,1720,3388,3667
0130-001,2012,8,31,13,1514,1612,3126,3388
0130-001,2012,8,31,14,1712,1852,3564,3126
0130-001,2012,8,31,15,1879,1889,3768,3564
0130-001,2012,8,31,16,1766,1829,3595,3768
0130-001,2012,8,31,17,1834,1984,3818,3595
0130-001,2012,8,31,18,1908,2277,4185,3818
0130-001,2012,8,31,19,2015,2309,4324,4185
0130-001,2012,8,31,20,1670,2293,3963,4324
0130-001,2012,8,31,21,1403,1817,3220,3963
0130-001,2012,8,31,22,1312,1323,2635,3220
0130-001,2012,8,31,23,970,979,1949,2635
0130-001,2012,8,31,24,705,673,1378,1949
0130-001,2012,9,1,1,593,496,1089,1378
0130-001,2012,9,1,2,391,374,765,1089
0130-001,2012,9,1,3,327,258,585,765
0130-001,2012,9,1,4,261,258,519,585
0130-001,2012,9,1,5,240,308,548,519
0130-001,2012,9,1,6,405,436,841,548
0130-001,2012,9,1,7,949,712,1661,841
0130-001,2012,9,1,8,1540,1113,2653,1661
0130-001,2012,9,1,9,1717,1668,3385,2653
0130-001,2012,9,1,10,1724,1790,3514,3385
0130-001,2012,9,1,11,1669,1965,3634,3514
0130-001,2012,9,1,12,1647,2016,3663,3634
0130-001,2012,9,1,13,1714,2209,3923,3663
0130-001,2012,9,1,14,1746,2178,3924,3923
0130-001,2012,9,1,15,1736,2229,3965,3924
0130-001,2012,9,1,16,1772,2066,3838,3965
0130-001,2012,9,1,17,1828,2198,4026,3838
0130-001,2012,9,1,18,1937,2100,4037,4026
0130-001,2012,9,1,19,1814,1986,3800,4037
0130-001,2012,9,1,20,1403,1499,2902,3800
0130-001,2012,9,1,21,1255,1202,2457,2902
0130-001,2012,9,1,22,1126,1007,2133,2457
0130-001,2012,9,1,23,850,706,1556,2133
0130-001,2012,9,1,24,592,473,1065,1556
0130-001,2012,9,2,1,422,336,758,1065
0130-001,2012,9,2,2,294,233,527,758
0130-001,2012,9,2,3,240,211,451,527
0130-001,2012,9,2,4,201,166,367,451
0130-001,2012,9,2,5,151,143,294,367
0130-001,2012,9,2,6,260,257,517,294
0130-001,2012,9,2,7,528,474,1002,517
0130-001,2012,9,2,8,793,625,1418,1002
0130-001,2012,9,2,9,818,911,1729,1418
0130-001,2012,9,2,10,945,1056,2001,1729
0130-001,2012,9,2,11,1107,1186,2293,2001
0130-001,2012,9,2,12,1073,1311,2384,2293
0130-001,2012,9,2,13,1204,1338,2542,2384
0130-001,2012,9,2,14,1450,1420,2870,2542
0130-001,2012,9,2,15,1580,1440,3020,2870
0130-001,2012,9,2,16,1875,1405,3280,3020
0130-001,2012,9,2,17,1934,1523,3457,3280
0130-001,2012,9,2,18,1933,1605,3538,3457
0130-001,2012,9,2,19,1972,1408,3380,3538
0130-001,2012,9,2,20,1635,1122,2757,3380
0130-001,2012,9,2,21,1386,989,2375,2757
0130-001,2012,9,2,22,1317,778,2095,2375
0130-001,2012,9,2,23,770,538,1308,2095
0130-001,2012,9,2,24,580,353,933,1308
0130-001,2012,9,3,1,312,242,554,933
0130-001,2012,9,3,2,193,163,356,554
0130-001,2012,9,3,3,152,135,287,356
0130-001,2012,9,3,4,132,117,249,287
0130-001,2012,9,3,5,168,235,403,249
0130-001,2012,9,3,6,387,432,819,403
0130-001,2012,9,3,7,1461,896,2357,819
0130-001,2012,9,3,8,2252,1871,4123,2357
0130-001,2012,9,3,9,2303,1981,4284,4123
0130-001,2012,9,3,10,1802,1797,3599,4284
0130-001,2012,9,3,11,1854,1693,3547,3599
0130-001,2012,9,3,12,1565,1571,3136,3547
0130-001,2012,9,3,13,1462,1533,2995,3136
0130-001,2012,9,3,14,1703,1628,3331,2995
0130-001,2012,9,3,15,1795,1756,3551,3331
0130-001,2012,9,3,16,1783,1828,3611,3551
0130-001,2012,9,3,17,1624,1688,3312,3611
0130-001,2012,9,3,18,1809,2068,3877,3312
0130-001,2012,9,3,19,1828,2404,4232,3877
0130-001,2012,9,3,20,1476,1932,3408,4232
0130-001,2012,9,3,21,1215,1686,2901,3408
0130-001,2012,9,3,22,1082,1189,2271,2901
0130-001,2012,9,3,23,810,779,1589,2271
0130-001,2012,9,3,24,577,461,1038,1589
0130-001,2012,9,4,1,379,334,713,1038
0130-001,2012,9,4,2,268,218,486,713
0130-001,2012,9,4,3,174,174,348,486
0130-001,2012,9,4,4,177,169,346,348
0130-001,2012,9,4,5,165,252,417,346
0130-001,2012,9,4,6,404,422,826,417
0130-001,2012,9,4,7,1349,851,2200,826
0130-001,2012,9,4,8,2293,1774,4067,2200
0130-001,2012,9,4,9,2102,1820,3922,4067
0130-001,2012,9,4,10,1781,1754,3535,3922
0130-001,2012,9,4,11,1637,1661,3298,3535
0130-001,2012,9,4,12,1451,1442,2893,3298
0130-001,2012,9,4,13,1364,1376,2740,2893
0130-001,2012,9,4,14,1594,1553,3147,2740
0130-001,2012,9,4,15,1597,1621,3218,3147
0130-001,2012,9,4,16,1623,1605,3228,3218
0130-001,2012,9,4,17,1578,1797,3375,3228
0130-001,2012,9,4,18,1690,2075,3765,3375
0130-001,2012,9,4,19,1631,2240,3871,3765
0130-001,2012,9,4,20,1288,1559,2847,3871
0130-001,2012,9,4,21,1149,1633,2782,2847
0130-001,2012,9,4,22,1026,1100,2126,2782
0130-001,2012,9,4,23,776,701,1477,2126
0130-001,2012,9,4,24,511,444,955,1477
0130-001,2012,9,5,1,364,320,684,955
0130-001,2012,9,5,2,228,232,460,684
0130-001,2012,9,5,3,176,165,341,460
0130-001,2012,9,5,4,144,144,288,341
0130-001,2012,9,5,5,168,226,394,288
0130-001,2012,9,5,6,348,370,718,394
0130-001,2012,9,5,7,1188,724,1912,718
0130-001,2012,9,5,8,2205,1729,3934,1912
0130-001,2012,9,5,9,2210,1927,4137,3934
0130-001,2012,9,5,10,1762,1832,3594,4137
0130-001,2012,9,5,11,1752,1620,3372,3594
0130-001,2012,9,5,12,1672,1577,3249,3372
0130-001,2012,9,5,13,1431,1440,2871,3249
0130-001,2012,9,5,14,1695,1711,3406,2871
0130-001,2012,9,5,15,1741,1694,3435,3406
0130-001,2012,9,5,16,1731,1737,3468,3435
0130-001,2012,9,5,17,1712,1751,3463,3468
0130-001,2012,9,5,18,1752,2391,4143,3463
0130-001,2012,9,5,19,1877,2377,4254,4143
0130-001,2012,9,5,20,1439,1941,3380,4254
0130-001,2012,9,5,21,1274,1645,2919,3380
0130-001,2012,9,5,22,1234,1229,2463,2919
0130-001,2012,9,5,23,969,806,1775,2463
0130-001,2012,9,5,24,650,515,1165,1775
0130-001,2012,9,6,1,431,362,793,1165
0130-001,2012,9,6,2,296,245,541,793
0130-001,2012,9,6,3,194,209,403,541
0130-001,2012,9,6,4,183,185,368,403
0130-001,2012,9,6,5,176,263,439,368
0130-001,2012,9,6,6,378,414,792,439
0130-001,2012,9,6,7,1317,838,2155,792
0130-001,2012,9,6,8,2252,1788,4040,2155
0130-001,2012,9,6,9,2230,1932,4162,4040
0130-001,2012,9,6,10,1878,1834,3712,4162
0130-001,2012,9,6,11,1707,1696,3403,3712
0130-001,2012,9,6,12,1697,1617,3314,3403
0130-001,2012,9,6,13,1390,1525,2915,3314
0130-001,2012,9,6,14,1720,1670,3390,2915
0130-001,2012,9,6,15,1777,1777,3554,3390
0130-001,2012,9,6,16,1794,1836,3630,3554
0130-001,2012,9,6,17,1751,1801,3552,3630
0130-001,2012,9,6,18,1834,2196,4030,3552
0130-001,2012,9,6,19,1861,2417,4278,4030
0130-001,2012,9,6,20,1472,1876,3348,4278
0130-001,2012,9,6,21,1258,1707,2965,3348
0130-001,2012,9,6,22,1239,1297,2536,2965
0130-001,2012,9,6,23,885,832,1717,2536
0130-001,2012,9,6,24,670,558,1228,1717
0130-001,2012,9,7,1,436,367,803,1228
0130-001,2012,9,7,2,256,247,503,803
0130-001,2012,9,7,3,205,213,418,503
0130-001,2012,9,7,4,179,167,346,418
0130-001,2012,9,7,5,209,256,465,346
0130-001,2012,9,7,6,398,427,825,465
0130-001,2012,9,7,7,1291,811,2102,825
0130-001,2012,9,7,8,2229,1756,3985,2102
0130-001,2012,9,7,9,2166,1927,4093,3985
0130-001,2012,9,7,10,1737,1796,3533,4093
0130-001,2012,9,7,11,1730,1744,3474,3533
0130-001,2012,9,7,12,1615,1580,3195,3474
0130-001,2012,9,7,13,1378,1466,2844,3195
0130-001,2012,9,7,14,1722,1644,3366,2844
0130-001,2012,9,7,15,1756,1817,3573,3366
0130-001,2012,9,7,16,1676,1877,3553,3573
0130-001,2012,9,7,17,1943,1751,3694,3553
0130-001,2012,9,7,18,2112,2167,4279,3694
0130-001,2012,9,7,19,1984,2348,4332,4279
0130-001,2012,9,7,20,1716,2251,3967,4332
0130-001,2012,9,7,21,1327,1774,3101,3967
0130-001,2012,9,7,22,1325,1322,2647,3101
0130-001,2012,9,7,23,946,1016,1962,2647
0130-001,2012,9,7,24,708,758,1466,1962
0130-001,2012,9,8,1,488,442,930,1466
0130-001,2012,9,8,2,330,291,621,930
0130-001,2012,9,8,3,265,279,544,621
0130-001,2012,9,8,4,228,214,442,544
0130-001,2012,9,8,5,217,242,459,442
0130-001,2012,9,8,6,319,411,730,459
0130-001,2012,9,8,7,755,651,1406,730
0130-001,2012,9,8,8,1498,1223,2721,1406
0130-001,2012,9,8,9,1571,1695,3266,2721
0130-001,2012,9,8,10,1542,1804,3346,3266
0130-001,2012,9,8,11,1618,1967,3585,3346
0130-001,2012,9,8,12,1654,2196,3850,3585
0130-001,2012,9,8,13,1653,2226,3879,3850
0130-001,2012,9,8,14,1839,2078,3917,3879
0130-001,2012,9,8,15,1697,2010,3707,3917
0130-001,2012,9,8,16,1729,1878,3607,3707
0130-001,2012,9,8,17,1813,1824,3637,3607
0130-001,2012,9,8,18,1914,1894,3808,3637
0130-001,2012,9,8,19,1852,1856,3708,3808
0130-001,2012,9,8,20,1460,1381,2841,3708
0130-001,2012,9,8,21,1184,1072,2256,2841
0130-001,2012,9,8,22,1083,960,2043,2256
0130-001,2012,9,8,23,778,714,1492,2043
0130-001,2012,9,8,24,566,463,1029,1492
0130-001,2012,9,9,1,383,348,731,1029
0130-001,2012,9,9,2,314,253,567,731
0130-001,2012,9,9,3,205,172,377,567
0130-001,2012,9,9,4,193,158,351,377
0130-001,2012,9,9,5,185,152,337,351
0130-001,2012,9,9,6,283,288,571,337
0130-001,2012,9,9,7,522,504,1026,571
0130-001,2012,9,9,8,702,755,1457,1026
0130-001,2012,9,9,9,808,963,1771,1457
0130-001,2012,9,9,10,922,1003,1925,1771
0130-001,2012,9,9,11,1080,1186,2266,1925
0130-001,2012,9,9,12,1131,1279,2410,2266
0130-001,2012,9,9,13,1226,1404,2630,2410
0130-001,2012,9,9,14,1522,1399,2921,2630
0130-001,2012,9,9,15,1616,1392,3008,2921
0130-001,2012,9,9,16,1861,1416,3277,3008
0130-001,2012,9,9,17,1915,1346,3261,3277
0130-001,2012,9,9,18,1953,1478,3431,3261
0130-001,2012,9,9,19,1924,1333,3257,3431
0130-001,2012,9,9,20,1669,1177,2846,3257
0130-001,2012,9,9,21,1354,957,2311,2846
0130-001,2012,9,9,22,1187,816,2003,2311
0130-001,2012,9,9,23,727,533,1260,2003
0130-001,2012,9,9,24,459,324,783,1260
0130-001,2012,9,10,1,290,226,516,783
0130-001,2012,9,10,2,167,158,325,516
0130-001,2012,9,10,3,126,109,235,325
0130-001,2012,9,10,4,115,139,254,235
0130-001,2012,9,10,5,150,198,348,254
0130-001,2012,9,10,6,381,412,793,348
0130-001,2012,9,10,7,1410,830,2240,793
0130-001,2012,9,10,8,2285,1800,4085,2240
0130-001,2012,9,10,9,2232,1903,4135,4085
0130-001,2012,9,10,10,1793,1801,3594,4135
0130-001,2012,9,10,11,1685,1685,3370,3594
0130-001,2012,9,10,12,1655,1580,3235,3370
0130-001,2012,9,10,13,1529,1519,3048,3235
0130-001,2012,9,10,14,1816,1655,3471,3048
0130-001,2012,9,10,15,1777,1780,3557,3471
0130-001,2012,9,10,16,1885,1801,3686,3557
0130-001,2012,9,10,17,1701,1842,3543,3686
0130-001,2012,9,10,18,1808,2136,3944,3543
0130-001,2012,9,10,19,1838,1906,3744,3944
0130-001,2012,9,10,20,1462,2237,3699,3744
0130-001,2012,9,10,21,1284,1647,2931,3699
0130-001,2012,9,10,22,1189,1259,2448,2931
0130-001,2012,9,10,23,886,831,1717,2448
0130-001,2012,9,10,24,536,496,1032,1717
0130-001,2012,9,11,1,378,324,702,1032
0130-001,2012,9,11,2,253,241,494,702
0130-001,2012,9,11,3,183,183,366,494
0130-001,2012,9,11,4,196,182,378,366
0130-001,2012,9,11,5,180,264,444,378
0130-001,2012,9,11,6,358,409,767,444
0130-001,2012,9,11,7,1376,830,2206,767
0130-001,2012,9,11,8,2197,1806,4003,2206
0130-001,2012,9,11,9,2215,1912,4127,4003
0130-001,2012,9,11,10,1843,1832,3675,4127
0130-001,2012,9,11,11,1738,1642,3380,3675
0130-001,2012,9,11,12,1654,1541,3195,3380
0130-001,2012,9,11,13,1407,1525,2932,3195
0130-001,2012,9,11,14,1735,1694,3429,2932
0130-001,2012,9,11,15,1732,1764,3496,3429
0130-001,2012,9,11,16,1720,1811,3531,3496
0130-001,2012,9,11,17,1729,1842,3571,3531
0130-001,2012,9,11,18,1712,2224,3936,3571
0130-001,2012,9,11,19,1800,2367,4167,3936
0130-001,2012,9,11,20,1462,1860,3322,4167
0130-001,2012,9,11,21,1281,1681,2962,3322
0130-001,2012,9,11,22,1294,1321,2615,2962
0130-001,2012,9,11,23,873,843,1716,2615
0130-001,2012,9,11,24,563,460,1023,1716
0130-001,2012,9,12,1,432,336,768,1023
0130-001,2012,9,12,2,224,237,461,768
0130-001,2012,9,12,3,206,178,384,461
0130-001,2012,9,12,4,159,179,338,384
0130-001,2012,9,12,5,204,244,448,338
0130-001,2012,9,12,6,357,394,751,448
0130-001,2012,9,12,7,1283,827,2110,751
0130-001,2012,9,12,8,2294,1775,4069,2110
0130-001,2012,9,12,9,2203,1976,4179,4069
0130-001,2012,9,12,10,1745,1849,3594,4179
0130-001,2012,9,12,11,1748,1670,3418,3594
0130-001,2012,9,12,12,1638,1769,3407,3418
0130-001,2012,9,12,13,1435,1894,3329,3407
0130-001,2012,9,12,14,1632,1915,3547,3329
0130-001,2012,9,12,15,1694,1908,3602,3547
0130-001,2012,9,12,16,1816,1800,3616,3602
0130-001,2012,9,12,17,1777,1914,3691,3616
0130-001,2012,9,12,18,1802,2254,4056,3691
0130-001,2012,9,12,19,1799,2341,4140,4056
0130-001,2012,9,12,20,1412,1934,3346,4140
0130-001,2012,9,12,21,1260,1525,2785,3346
0130-001,2012,9,12,22,1165,1162,2327,2785
0130-001,2012,9,12,23,887,795,1682,2327
0130-001,2012,9,12,24,596,546,1142,1682
0130-001,2012,9,13,1,438,369,807,1142
0130-001,2012,9,13,2,259,241,500,807
0130-001,2012,9,13,3,186,180,366,500
0130-001,2012,9,13,4,156,170,326,366
0130-001,2012,9,13,5,163,242,405,326
0130-001,2012,9,13,6,362,405,767,405
0130-001,2012,9,13,7,1224,835,2059,767
0130-001,2012,9,13,8,2201,1737,3938,2059
0130-001,2012,9,13,9,2239,1972,4211,3938
0130-001,2012,9,13,10,1724,1802,3526,4211
0130-001,2012,9,13,11,1681,1630,3311,3526
0130-001,2012,9,13,12,1591,1511,3102,3311
0130-001,2012,9,13,13,1335,1511,2846,3102
0130-001,2012,9,13,14,1616,1617,3233,2846
0130-001,2012,9,13,15,1725,1620,3345,3233
0130-001,2012,9,13,16,1588,1651,3239,3345
0130-001,2012,9,13,17,1601,1786,3387,3239
0130-001,2012,9,13,18,1713,2055,3768,3387
0130-001,2012,9,13,19,1721,2367,4088,3768
0130-001,2012,9,13,20,1411,1689,3100,4088
0130-001,2012,9,13,21,1113,1578,2691,3100
0130-001,2012,9,13,22,1133,1246,2379,2691
0130-001,2012,9,13,23,923,808,1731,2379
0130-001,2012,9,13,24,629,477,1106,1731
0130-001,2012,9,14,1,444,349,793,1106
0130-001,2012,9,14,2,252,239,491,793
0130-001,2012,9,14,3,226,197,423,491
0130-001,2012,9,14,4,166,188,354,423
0130-001,2012,9,14,5,181,234,415,354
0130-001,2012,9,14,6,329,361,690,415
0130-001,2012,9,14,7,1187,803,1990,690
0130-001,2012,9,14,8,2173,1566,3739,1990
0130-001,2012,9,14,9,2192,1928,4120,3739
0130-001,2012,9,14,10,1764,1738,3502,4120
0130-001,2012,9,14,11,1780,1785,3565,3502
0130-001,2012,9,14,12,1563,1623,3186,3565
0130-001,2012,9,14,13,1530,1519,3049,3186
0130-001,2012,9,14,14,1704,1726,3430,3049
0130-001,2012,9,14,15,1841,1805,3646,3430
0130-001,2012,9,14,16,1842,1820,3662,3646
0130-001,2012,9,14,17,1839,1986,3825,3662
0130-001,2012,9,14,18,1925,2336,4261,3825
0130-001,2012,9,14,19,1926,2558,4484,4261
0130-001,2012,9,14,20,1677,2117,3794,4484
0130-001,2012,9,14,21,1285,1747,3032,3794
0130-001,2012,9,14,22,1247,1405,2652,3032
0130-001,2012,9,14,23,1010,909,1919,2652
0130-001,2012,9,14,24,634,571,1205,1919
0130-001,2012,9,15,1,550,428,978,1205
0130-001,2012,9,15,2,362,286,648,978
0130-001,2012,9,15,3,286,261,547,648
0130-001,2012,9,15,4,237,244,481,547
0130-001,2012,9,15,5,250,315,565,481
0130-001,2012,9,15,6,408,433,841,565
0130-001,2012,9,15,7,875,764,1639,841
0130-001,2012,9,15,8,1713,1230,2943,1639
0130-001,2012,9,15,9,1746,1965,3711,2943
0130-001,2012,9,15,10,1740,2186,3926,3711
0130-001,2012,9,15,11,1705,2259,3964,3926
0130-001,2012,9,15,12,1668,2419,4087,3964
0130-001,2012,9,15,13,1656,2395,4051,4087
0130-001,2012,9,15,14,1725,2402,4127,4051
0130-001,2012,9,15,15,1739,2389,4128,4127
0130-001,2012,9,15,16,1946,2407,4353,4128
0130-001,2012,9,15,17,1912,2311,4223,4353
0130-001,2012,9,15,18,2083,2345,4428,4223
0130-001,2012,9,15,19,1952,2167,4119,4428
0130-001,2012,9,15,20,1743,1613,3356,4119
0130-001,2012,9,15,21,1666,1323,2989,3356
0130-001,2012,9,15,22,1392,1056,2448,2989
0130-001,2012,9,15,23,937,760,1697,2448
0130-001,2012,9,15,24,663,554,1217,1697
0130-001,2012,9,16,1,455,399,854,1217
0130-001,2012,9,16,2,308,263,571,854
0130-001,2012,9,16,3,233,199,432,571
0130-001,2012,9,16,4,204,166,370,432
0130-001,2012,9,16,5,231,207,438,370
0130-001,2012,9,16,6,283,339,622,438
0130-001,2012,9,16,7,572,596,1168,622
0130-001,2012,9,16,8,837,826,1663,1168
0130-001,2012,9,16,9,863,1050,1913,1663
0130-001,2012,9,16,10,988,1123,2111,1913
0130-001,2012,9,16,11,1094,1313,2407,2111
0130-001,2012,9,16,12,1303,1278,2581,2407
0130-001,2012,9,16,13,1755,1439,3194,2581
0130-001,2012,9,16,14,1833,1429,3262,3194
0130-001,2012,9,16,15,1912,1542,3454,3262
0130-001,2012,9,16,16,2013,1462,3475,3454
0130-001,2012,9,16,17,1950,1393,3343,3475
0130-001,2012,9,16,18,2037,1403,3440,3343
0130-001,2012,9,16,19,1980,1260,3240,3440
0130-001,2012,9,16,20,1947,996,2943,3240
0130-001,2012,9,16,21,1730,954,2684,2943
0130-001,2012,9,16,22,1260,751,2011,2684
0130-001,2012,9,16,23,864,484,1348,2011
0130-001,2012,9,16,24,516,370,886,1348
0130-001,2012,9,17,1,303,227,530,886
0130-001,2012,9,17,2,206,198,404,530
0130-001,2012,9,17,3,156,128,284,404
0130-001,2012,9,17,4,121,115,236,284
0130-001,2012,9,17,5,142,214,356,236
0130-001,2012,9,17,6,289,319,608,356
0130-001,2012,9,17,7,1183,720,1903,608
0130-001,2012,9,17,8,2165,1556,3721,1903
0130-001,2012,9,17,9,2267,1858,4125,3721
0130-001,2012,9,17,10,1712,1573,3285,4125
0130-001,2012,9,17,11,1486,1516,3002,3285
0130-001,2012,9,17,12,1361,1378,2739,3002
0130-001,2012,9,17,13,1226,1281,2507,2739
0130-001,2012,9,17,14,1575,1629,3204,2507
0130-001,2012,9,17,15,1439,1513,2952,3204
0130-001,2012,9,17,16,1426,1447,2873,2952
0130-001,2012,9,17,17,1368,1476,2844,2873
0130-001,2012,9,17,18,1509,1951,3460,2844
0130-001,2012,9,17,19,1594,2253,3847,3460
0130-001,2012,9,17,20,1277,1531,2808,3847
0130-001,2012,9,17,21,1075,1398,2473,2808
0130-001,2012,9,17,22,901,1150,2051,2473
0130-001,2012,9,17,23,732,677,1409,2051
0130-001,2012,9,17,24,485,463,948,1409
0130-001,2012,9,18,1,365,285,650,948
0130-001,2012,9,18,2,208,189,397,650
0130-001,2012,9,18,3,164,149,313,397
0130-001,2012,9,18,4,134,169,303,313
0130-001,2012,9,18,5,157,230,387,303
0130-001,2012,9,18,6,296,351,647,387
0130-001,2012,9,18,7,1152,713,1865,647
0130-001,2012,9,18,8,2274,1643,3917,1865
0130-001,2012,9,18,9,2289,1937,4226,3917
0130-001,2012,9,18,10,1808,1763,3571,4226
0130-001,2012,9,18,11,1800,1731,3531,3571
0130-001,2012,9,18,12,1616,1558,3174,3531
0130-001,2012,9,18,13,1459,1527,2986,3174
0130-001,2012,9,18,14,1740,1769,3509,2986
0130-001,2012,9,18,15,1841,1721,3562,3509
0130-001,2012,9,18,16,1773,1779,3552,3562
0130-001,2012,9,18,17,1723,1862,3585,3552
0130-001,2012,9,18,18,1836,2309,4145,3585
0130-001,2012,9,18,19,1836,2513,4349,4145
0130-001,2012,9,18,20,1449,1765,3214,4349
0130-001,2012,9,18,21,1271,1667,2938,3214
0130-001,2012,9,18,22,1188,1368,2556,2938
0130-001,2012,9,18,23,940,834,1774,2556
0130-001,2012,9,18,24,653,528,1181,1774
0130-001,2012,9,19,1,440,330,770,1181
0130-001,2012,9,19,2,287,258,545,770
0130-001,2012,9,19,3,203,224,427,545
0130-001,2012,9,19,4,173,203,376,427
0130-001,2012,9,19,5,169,245,414,376
0130-001,2012,9,19,6,331,396,727,414
0130-001,2012,9,19,7,1191,820,2011,727
0130-001,2012,9,19,8,2233,1633,3866,2011
0130-001,2012,9,19,9,2252,1949,4201,3866
0130-001,2012,9,19,10,1852,1775,3627,4201
0130-001,2012,9,19,11,1811,1724,3535,3627
0130-001,2012,9,19,12,1700,1604,3304,3535
0130-001,2012,9,19,13,1552,1488,3040,3304
0130-001,2012,9,19,14,1768,1717,3485,3040
0130-001,2012,9,19,15,1797,1735,3532,3485
0130-001,2012,9,19,16,1779,1840,3619,3532
0130-001,2012,9,19,17,1770,1904,3674,3619
0130-001,2012,9,19,18,1814,2342,4156,3674
0130-001,2012,9,19,19,1798,2539,4337,4156
0130-001,2012,9,19,20,1492,2049,3541,4337
0130-001,2012,9,19,21,1299,1582,2881,3541
0130-001,2012,9,19,22,1271,1322,2593,2881
0130-001,2012,9,19,23,944,817,1761,2593
0130-001,2012,9,19,24,691,582,1273,1761
0130-001,2012,9,20,1,419,378,797,1273
0130-001,2012,9,20,2,239,251,490,797
0130-001,2012,9,20,3,228,210,438,490
0130-001,2012,9,20,4,175,195,370,438
0130-001,2012,9,20,5,168,261,429,370
0130-001,2012,9,20,6,364,381,745,429
0130-001,2012,9,20,7,1216,837,2053,745
0130-001,2012,9,20,8,2202,1647,3849,2053
0130-001,2012,9,20,9,2311,1921,4232,3849
0130-001,2012,9,20,10,1800,1745,3545,4232
0130-001,2012,9,20,11,1820,1671,3491,3545
0130-001,2012,9,20,12,1645,1725,3370,3491
0130-001,2012,9,20,13,1539,1474,3013,3370
0130-001,2012,9,20,14,1740,1718,3458,3013
0130-001,2012,9,20,15,1865,1771,3636,3458
0130-001,2012,9,20,16,1866,1626,3492,3636
0130-001,2012,9,20,17,1756,2091,3847,3492
0130-001,2012,9,20,18,1773,1849,3622,3847
0130-001,2012,9,20,19,1818,2490,4308,3622
0130-001,2012,9,20,20,1502,1958,3460,4308
0130-001,2012,9,20,21,1262,1634,2896,3460
0130-001,2012,9,20,22,1242,1336,2578,2896
0130-001,2012,9,20,23,911,901,1812,2578
0130-001,2012,9,20,24,661,530,1191,1812
0130-001,2012,9,21,1,447,400,847,1191
0130-001,2012,9,21,2,288,233,521,847
0130-001,2012,9,21,3,201,221,422,521
0130-001,2012,9,21,4,208,200,408,422
0130-001,2012,9,21,5,202,271,473,408
0130-001,2012,9,21,6,376,412,788,473
0130-001,2012,9,21,7,1247,826,2073,788
0130-001,2012,9,21,8,2284,1615,3899,2073
0130-001,2012,9,21,9,2247,1964,4211,3899
0130-001,2012,9,21,10,1810,1845,3655,4211
0130-001,2012,9,21,11,1743,1868,3611,3655
0130-001,2012,9,21,12,1797,1650,3447,3611
0130-001,2012,9,21,13,1505,1564,3069,3447
0130-001,2012,9,21,14,1674,1766,3440,3069
0130-001,2012,9,21,15,1869,1827,3696,3440
0130-001,2012,9,21,16,1840,1948,3788,3696
0130-001,2012,9,21,17,1877,2005,3882,3788
0130-001,2012,9,21,18,1896,2446,4342,3882
0130-001,2012,9,21,19,2048,2533,4581,4342
0130-001,2012,9,21,20,1664,2256,3920,4581
0130-001,2012,9,21,21,1401,1755,3156,3920
0130-001,2012,9,21,22,1227,1387,2614,3156
0130-001,2012,9,21,23,1084,940,2024,2614
0130-001,2012,9,21,24,737,612,1349,2024
0130-001,2012,9,22,1,530,448,978,1349
0130-001,2012,9,22,2,381,312,693,978
0130-001,2012,9,22,3,283,273,556,693
0130-001,2012,9,22,4,236,235,471,556
0130-001,2012,9,22,5,253,303,556,471
0130-001,2012,9,22,6,385,433,818,556
0130-001,2012,9,22,7,896,733,1629,818
0130-001,2012,9,22,8,1609,1214,2823,1629
0130-001,2012,9,22,9,1727,1768,3495,2823
0130-001,2012,9,22,10,1784,1962,3746,3495
0130-001,2012,9,22,11,1679,2171,3850,3746
0130-001,2012,9,22,12,1658,2152,3810,3850
0130-001,2012,9,22,13,1688,2185,3873,3810
0130-001,2012,9,22,14,1734,2012,3746,3873
0130-001,2012,9,22,15,1705,1846,3551,3746
0130-001,2012,9,22,16,1861,1801,3662,3551
0130-001,2012,9,22,17,1902,1751,3653,3662
0130-001,2012,9,22,18,1908,2130,4038,3653
0130-001,2012,9,22,19,1926,1858,3784,4038
0130-001,2012,9,22,20,1516,1427,2943,3784
0130-001,2012,9,22,21,1255,1197,2452,2943
0130-001,2012,9,22,22,1112,1042,2154,2452
0130-001,2012,9,22,23,864,709,1573,2154
0130-001,2012,9,22,24,551,496,1047,1573
0130-001,2012,9,23,1,422,335,757,1047
0130-001,2012,9,23,2,290,276,566,757
0130-001,2012,9,23,3,243,202,445,566
0130-001,2012,9,23,4,199,184,383,445
0130-001,2012,9,23,5,170,171,341,383
0130-001,2012,9,23,6,253,288,541,341
0130-001,2012,9,23,7,561,495,1056,541
0130-001,2012,9,23,8,866,706,1572,1056
0130-001,2012,9,23,9,894,975,1869,1572
0130-001,2012,9,23,10,1047,1183,2230,1869
0130-001,2012,9,23,11,1117,1345,2462,2230
0130-001,2012,9,23,12,1172,1242,2414,2462
0130-001,2012,9,23,13,1259,1422,2681,2414
0130-001,2012,9,23,14,1428,1401,2829,2681
0130-001,2012,9,23,15,1651,1555,3206,2829
0130-001,2012,9,23,16,1603,1520,3123,3206
0130-001,2012,9,23,17,1666,1465,3131,3123
0130-001,2012,9,23,18,1615,1618,3233,3131
0130-001,2012,9,23,19,1681,1516,3197,3233
0130-001,2012,9,23,20,1359,1216,2575,3197
0130-001,2012,9,23,21,1135,1031,2166,2575
0130-001,2012,9,23,22,1038,860,1898,2166
0130-001,2012,9,23,23,691,530,1221,1898
0130-001,2012,9,23,24,507,338,845,1221
0130-001,2012,9,24,1,307,300,607,845
0130-001,2012,9,24,2,197,192,389,607
0130-001,2012,9,24,3,142,124,266,389
0130-001,2012,9,24,4,123,146,269,266
0130-001,2012,9,24,5,172,228,400,269
0130-001,2012,9,24,6,358,412,770,400
0130-001,2012,9,24,7,1366,869,2235,770
0130-001,2012,9,24,8,2259,1780,4039,2235
0130-001,2012,9,24,9,2336,2021,4357,4039
0130-001,2012,9,24,10,1969,1732,3701,4357
0130-001,2012,9,24,11,1799,1887,3686,3701
0130-001,2012,9,24,12,1733,1689,3422,3686
0130-001,2012,9,24,13,1510,1694,3204,3422
0130-001,2012,9,24,14,1681,1727,3408,3204
0130-001,2012,9,24,15,1930,1851,3781,3408
0130-001,2012,9,24,16,1832,1885,3717,3781
0130-001,2012,9,24,17,1909,1926,3835,3717
0130-001,2012,9,24,18,1872,2328,4200,3835
0130-001,2012,9,24,19,1914,2387,4301,4200
0130-001,2012,9,24,20,1277,1531,2808,4301
0130-001,2012,9,24,21,1075,1398,2473,2808
0130-001,2012,9,24,22,901,1150,2051,2473
0130-001,2012,9,24,23,732,677,1409,2051
0130-001,2012,9,24,24,485,463,948,1409
0130-001,2012,9,25,1,707,280,987,948
0130-001,2012,9,25,2,390,196,586,987
0130-001,2012,9,25,3,223,152,375,586
0130-001,2012,9,25,4,161,150,311,375
0130-001,2012,9,25,5,151,190,341,311
0130-001,2012,9,25,6,253,303,556,341
0130-001,2012,9,25,7,880,580,1460,556
0130-001,2012,9,25,8,1706,1266,2972,1460
0130-001,2012,9,25,9,1726,1585,3311,2972
0130-001,2012,9,25,10,1502,1589,3091,3311
0130-001,2012,9,25,11,1623,1588,3211,3091
0130-001,2012,9,25,12,1618,1548,3166,3211
0130-001,2012,9,25,13,1533,1504,3037,3166
0130-001,2012,9,25,14,1745,1664,3409,3037
0130-001,2012,9,25,15,1846,1680,3526,3409
0130-001,2012,9,25,16,1956,1651,3607,3526
0130-001,2012,9,25,17,1399,1516,2915,3607
0130-001,2012,9,25,18,1838,2087,3925,2915
0130-001,2012,9,25,19,1890,2514,4404,3925
0130-001,2012,9,25,20,1483,2133,3616,4404
0130-001,2012,9,25,21,1308,1764,3072,3616
0130-001,2012,9,25,22,1256,1322,2578,3072
0130-001,2012,9,25,23,991,930,1921,2578
0130-001,2012,9,25,24,683,576,1259,1921
0130-001,2012,9,26,1,427,383,810,1259
0130-001,2012,9,26,2,277,252,529,810
0130-001,2012,9,26,3,227,217,444,529
0130-001,2012,9,26,4,176,199,375,444
0130-001,2012,9,26,5,196,267,463,375
0130-001,2012,9,26,6,359,410,769,463
0130-001,2012,9,26,7,1261,848,2109,769
0130-001,2012,9,26,8,2246,1784,4030,2109
0130-001,2012,9,26,9,2231,2033,4264,4030
0130-001,2012,9,26,10,1818,1927,3745,4264
0130-001,2012,9,26,11,1864,1836,3700,3745
0130-001,2012,9,26,12,1746,1740,3486,3700
0130-001,2012,9,26,13,1557,1618,3175,3486
0130-001,2012,9,26,14,1768,1828,3596,3175
0130-001,2012,9,26,15,1881,1966,3847,3596
0130-001,2012,9,26,16,1942,1804,3746,3847
0130-001,2012,9,26,17,1900,2176,4076,3746
0130-001,2012,9,26,18,1874,2382,4256,4076
0130-001,2012,9,26,19,1989,2507,4496,4256
0130-001,2012,9,26,20,1483,2128,3611,4496
0130-001,2012,9,26,21,1312,1642,2954,3611
0130-001,2012,9,26,22,1288,1388,2676,2954
0130-001,2012,9,26,23,1037,896,1933,2676
0130-001,2012,9,26,24,688,589,1277,1933
0130-001,2012,9,27,1,450,402,852,1277
0130-001,2012,9,27,2,280,282,562,852
0130-001,2012,9,27,3,204,215,419,562
0130-001,2012,9,27,4,173,219,392,419
0130-001,2012,9,27,5,179,271,450,392
0130-001,2012,9,27,6,319,424,743,450
0130-001,2012,9,27,7,1272,803,2075,743
0130-001,2012,9,27,8,2255,1763,4018,2075
0130-001,2012,9,27,9,2234,2077,4311,4018
0130-001,2012,9,27,10,1828,1850,3678,4311
0130-001,2012,9,27,11,1878,1842,3720,3678
0130-001,2012,9,27,12,1818,1812,3630,3720
0130-001,2012,9,27,13,1664,1712,3376,3630
0130-001,2012,9,27,14,1943,1932,3875,3376
0130-001,2012,9,27,15,2037,2011,4048,3875
0130-001,2012,9,27,16,1856,2100,3956,4048
0130-001,2012,9,27,17,1942,2145,4087,3956
0130-001,2012,9,27,18,1897,2510,4407,4087
0130-001,2012,9,27,19,1898,2560,4458,4407
0130-001,2012,9,27,20,1548,2084,3632,4458
0130-001,2012,9,27,21,1416,1768,3184,3632
0130-001,2012,9,27,22,1311,1465,2776,3184
0130-001,2012,9,27,23,1036,973,2009,2776
0130-001,2012,9,27,24,683,639,1322,2009
0130-001,2012,9,28,1,503,396,899,1322
0130-001,2012,9,28,2,338,295,633,899
0130-001,2012,9,28,3,239,221,460,633
0130-001,2012,9,28,4,195,224,419,460
0130-001,2012,9,28,5,218,277,495,419
0130-001,2012,9,28,6,388,352,740,495
0130-001,2012,9,28,7,1179,797,1976,740
0130-001,2012,9,28,8,2280,1731,4011,1976
0130-001,2012,9,28,9,2131,2017,4148,4011
0130-001,2012,9,28,10,1815,1896,3711,4148
0130-001,2012,9,28,11,1886,1930,3816,3711
0130-001,2012,9,28,12,1849,1954,3803,3816
0130-001,2012,9,28,13,1659,1920,3579,3803
0130-001,2012,9,28,14,1806,2191,3997,3579
0130-001,2012,9,28,15,1833,2345,4178,3997
0130-001,2012,9,28,16,1833,2227,4060,4178
0130-001,2012,9,28,17,1727,2505,4232,4060
0130-001,2012,9,28,18,1827,2662,4489,4232
0130-001,2012,9,28,19,1798,2408,4206,4489
0130-001,2012,9,28,20,1523,2314,3837,4206
0130-001,2012,9,28,21,1269,2001,3270,3837
0130-001,2012,9,28,22,1140,1848,2988,3270
0130-001,2012,9,28,23,883,2315,3198,2988
0130-001,2012,9,28,24,699,1827,2526,3198
0130-001,2012,9,29,1,431,1622,2053,2526
0130-001,2012,9,29,2,323,1615,1938,2053
0130-001,2012,9,29,3,272,1475,1747,1938
0130-001,2012,9,29,4,215,1631,1846,1747
0130-001,2012,9,29,5,200,1664,1864,1846
0130-001,2012,9,29,6,227,1640,1867,1864
0130-001,2012,9,29,7,495,1793,2288,1867
0130-001,2012,9,29,8,673,2036,2709,2288
0130-001,2012,9,29,9,869,2126,2995,2709
0130-001,2012,9,29,10,1187,2284,3471,2995
0130-001,2012,9,29,11,1495,2310,3805,3471
0130-001,2012,9,29,12,1521,2134,3655,3805
0130-001,2012,9,29,13,1438,2158,3596,3655
0130-001,2012,9,29,14,1303,2322,3625,3596
0130-001,2012,9,29,15,1182,2457,3639,3625
0130-001,2012,9,29,16,1134,2367,3501,3639
0130-001,2012,9,29,17,1118,2264,3382,3501
0130-001,2012,9,29,18,1094,2449,3543,3382
0130-001,2012,9,29,19,1047,2076,3123,3543
0130-001,2012,9,29,20,869,1491,2360,3123
0130-001,2012,9,29,21,728,1270,1998,2360
0130-001,2012,9,29,22,657,963,1620,1998
0130-001,2012,9,29,23,501,530,1031,1620
0130-001,2012,9,29,24,330,343,673,1031
0130-001,2012,9,30,1,238,235,473,673
0130-001,2012,9,30,2,155,172,327,473
0130-001,2012,9,30,3,148,120,268,327
0130-001,2012,9,30,4,84,107,191,268
0130-001,2012,9,30,5,93,94,187,191
0130-001,2012,9,30,6,165,205,370,187
0130-001,2012,9,30,7,499,531,1030,370
0130-001,2012,9,30,8,927,1096,2023,1030
0130-001,2012,9,30,9,844,1096,1940,2023
0130-001,2012,9,30,10,846,1336,2182,1940
0130-001,2012,9,30,11,1620,1692,3312,2182
0130-001,2012,9,30,12,1901,2036,3937,3312
0130-001,2012,9,30,13,1994,2137,4131,3937
0130-001,2012,9,30,14,2170,2142,4312,4131
0130-001,2012,9,30,15,2189,2308,4497,4312
0130-001,2012,9,30,16,2189,2340,4529,4497
0130-001,2012,9,30,17,2126,2358,4484,4529
0130-001,2012,9,30,18,2264,2488,4752,4484
0130-001,2012,9,30,19,2139,2206,4345,4752
0130-001,2012,9,30,20,1297,1914,3211,4345
0130-001,2012,9,30,21,1229,1985,3214,3211
0130-001,2012,9,30,22,1012,1380,2392,3214
0130-001,2012,9,30,23,752,817,1569,2392
0130-001,2012,9,30,24,576,480,1056,1569
0130-001,2012,10,1,1,474,288,762,1056
0130-001,2012,10,1,2,372,221,593,762
0130-001,2012,10,1,3,217,113,330,593
0130-001,2012,10,1,4,153,108,261,330
0130-001,2012,10,1,5,156,116,272,261
0130-001,2012,10,1,6,190,166,356,272
0130-001,2012,10,1,7,336,204,540,356
0130-001,2012,10,1,8,448,342,790,540
0130-001,2012,10,1,9,587,573,1160,790
0130-001,2012,10,1,10,846,766,1612,1160
0130-001,2012,10,1,11,1209,1070,2279,1612
0130-001,2012,10,1,12,1308,1128,2436,2279
0130-001,2012,10,1,13,1432,1351,2783,2436
0130-001,2012,10,1,14,1514,1449,2963,2783
0130-001,2012,10,1,15,1591,1484,3075,2963
0130-001,2012,10,1,16,1613,1453,3066,3075
0130-001,2012,10,1,17,1870,1322,3192,3066
0130-001,2012,10,1,18,1793,1204,2997,3192
0130-001,2012,10,1,19,1934,1231,3165,2997
0130-001,2012,10,1,20,1776,981,2757,3165
0130-001,2012,10,1,21,1645,963,2608,2757
0130-001,2012,10,1,22,1652,751,2403,2608
0130-001,2012,10,1,23,1650,589,2239,2403
0130-001,2012,10,1,24,1370,393,1763,2239
0130-001,2012,10,2,1,1049,275,1324,1763
0130-001,2012,10,2,2,571,202,773,1324
0130-001,2012,10,2,3,282,156,438,773
0130-001,2012,10,2,4,188,130,318,438
0130-001,2012,10,2,5,145,149,294,318
0130-001,2012,10,2,6,210,255,465,294
0130-001,2012,10,2,7,609,446,1055,465
0130-001,2012,10,2,8,1137,889,2026,1055
0130-001,2012,10,2,9,1164,1233,2397,2026
0130-001,2012,10,2,10,1195,1415,2610,2397
0130-001,2012,10,2,11,1446,1446,2892,2610
0130-001,2012,10,2,12,1620,1537,3157,2892
0130-001,2012,10,2,13,1607,1480,3087,3157
0130-001,2012,10,2,14,1750,1559,3309,3087
0130-001,2012,10,2,15,1852,1639,3491,3309
0130-001,2012,10,2,16,2139,1523,3662,3491
0130-001,2012,10,2,17,2138,1574,3712,3662
0130-001,2012,10,2,18,1976,1695,3671,3712
0130-001,2012,10,2,19,2156,1554,3710,3671
0130-001,2012,10,2,20,1813,1336,3149,3710
0130-001,2012,10,2,21,1549,1096,2645,3149
0130-001,2012,10,2,22,1382,891,2273,2645
0130-001,2012,10,2,23,1110,641,1751,2273
0130-001,2012,10,2,24,661,482,1143,1751
0130-001,2012,10,3,1,422,377,799,1143
0130-001,2012,10,3,2,318,245,563,799
0130-001,2012,10,3,3,230,208,438,563
0130-001,2012,10,3,4,179,183,362,438
0130-001,2012,10,3,5,174,201,375,362
0130-001,2012,10,3,6,234,283,517,375
0130-001,2012,10,3,7,685,460,1145,517
0130-001,2012,10,3,8,1056,681,1737,1145
0130-001,2012,10,3,9,955,932,1887,1737
0130-001,2012,10,3,10,1079,1114,2193,1887
0130-001,2012,10,3,11,1230,1281,2511,2193
0130-001,2012,10,3,12,1240,1347,2587,2511
0130-001,2012,10,3,13,1346,1340,2686,2587
0130-001,2012,10,3,14,1343,1450,2793,2686
0130-001,2012,10,3,15,1458,1445,2903,2793
0130-001,2012,10,3,16,1487,1450,2937,2903
0130-001,2012,10,3,17,1488,1473,2961,2937
0130-001,2012,10,3,18,1632,1635,3267,2961
0130-001,2012,10,3,19,1510,1532,3042,3267
0130-001,2012,10,3,20,1297,1226,2523,3042
0130-001,2012,10,3,21,1072,1005,2077,2523
0130-001,2012,10,3,22,1015,841,1856,2077
0130-001,2012,10,3,23,694,550,1244,1856
0130-001,2012,10,3,24,506,411,917,1244
0130-001,2012,10,4,1,290,255,545,917
0130-001,2012,10,4,2,209,200,409,545
0130-001,2012,10,4,3,146,120,266,409
0130-001,2012,10,4,4,133,148,281,266
0130-001,2012,10,4,5,169,233,402,281
0130-001,2012,10,4,6,331,370,701,402
0130-001,2012,10,4,7,1292,783,2075,701
0130-001,2012,10,4,8,2298,1803,4101,2075
0130-001,2012,10,4,9,2162,1988,4150,4101
0130-001,2012,10,4,10,1647,1723,3370,4150
0130-001,2012,10,4,11,1642,1620,3262,3370
0130-001,2012,10,4,12,1517,1561,3078,3262
0130-001,2012,10,4,13,1356,1422,2778,3078
0130-001,2012,10,4,14,1644,1598,3242,2778
0130-001,2012,10,4,15,1817,1723,3540,3242
0130-001,2012,10,4,16,1725,1760,3485,3540
0130-001,2012,10,4,17,1689,1861,3550,3485
0130-001,2012,10,4,18,1733,2232,3965,3550
0130-001,2012,10,4,19,1772,2418,4190,3965
0130-001,2012,10,4,20,1288,1679,2967,4190
0130-001,2012,10,4,21,1164,1558,2722,2967
0130-001,2012,10,4,22,1112,1168,2280,2722
0130-001,2012,10,4,23,779,789,1568,2280
0130-001,2012,10,4,24,559,491,1050,1568
0130-001,2012,10,5,1,410,317,727,1050
0130-001,2012,10,5,2,243,263,506,727
0130-001,2012,10,5,3,187,188,375,506
0130-001,2012,10,5,4,167,171,338,375
0130-001,2012,10,5,5,155,233,388,338
0130-001,2012,10,5,6,318,375,693,388
0130-001,2012,10,5,7,1148,806,1954,693
0130-001,2012,10,5,8,2273,1800,4073,1954
0130-001,2012,10,5,9,2133,1975,4108,4073
0130-001,2012,10,5,10,1694,1731,3425,4108
0130-001,2012,10,5,11,1713,1710,3423,3425
0130-001,2012,10,5,12,1645,1734,3379,3423
0130-001,2012,10,5,13,1405,1593,2998,3379
0130-001,2012,10,5,14,1685,1699,3384,2998
0130-001,2012,10,5,15,1769,1808,3577,3384
0130-001,2012,10,5,16,1691,1921,3612,3577
0130-001,2012,10,5,17,1779,1938,3717,3612
0130-001,2012,10,5,18,1873,2386,4259,3717
0130-001,2012,10,5,19,1983,2402,4385,4259
0130-001,2012,10,5,20,1539,1918,3457,4385
0130-001,2012,10,5,21,1247,1654,2901,3457
0130-001,2012,10,5,22,1138,1358,2496,2901
0130-001,2012,10,5,23,968,867,1835,2496
0130-001,2012,10,5,24,689,650,1339,1835
0130-001,2012,10,6,1,478,404,882,1339
0130-001,2012,10,6,2,382,332,714,882
0130-001,2012,10,6,3,255,271,526,714
0130-001,2012,10,6,4,197,212,409,526
0130-001,2012,10,6,5,206,259,465,409
0130-001,2012,10,6,6,374,384,758,465
0130-001,2012,10,6,7,818,679,1497,758
0130-001,2012,10,6,8,1656,1142,2798,1497
0130-001,2012,10,6,9,1691,1718,3409,2798
0130-001,2012,10,6,10,1636,1795,3431,3409
0130-001,2012,10,6,11,1748,1856,3604,3431
0130-001,2012,10,6,12,1619,2181,3800,3604
0130-001,2012,10,6,13,1643,2149,3792,3800
0130-001,2012,10,6,14,1766,1872,3638,3792
0130-001,2012,10,6,15,1716,1876,3592,3638
0130-001,2012,10,6,16,1730,1726,3456,3592
0130-001,2012,10,6,17,1781,1732,3513,3456
0130-001,2012,10,6,18,1866,2169,4035,3513
0130-001,2012,10,6,19,1694,2052,3746,4035
0130-001,2012,10,6,20,1351,1440,2791,3746
0130-001,2012,10,6,21,1120,1115,2235,2791
0130-001,2012,10,6,22,1097,933,2030,2235
0130-001,2012,10,6,23,892,690,1582,2030
0130-001,2012,10,6,24,587,560,1147,1582
0130-001,2012,10,7,1,431,383,814,1147
0130-001,2012,10,7,2,299,317,616,814
0130-001,2012,10,7,3,226,208,434,616
0130-001,2012,10,7,4,183,168,351,434
0130-001,2012,10,7,5,208,175,383,351
0130-001,2012,10,7,6,259,275,534,383
0130-001,2012,10,7,7,520,453,973,534
0130-001,2012,10,7,8,820,750,1570,973
0130-001,2012,10,7,9,881,1001,1882,1570
0130-001,2012,10,7,10,974,1090,2064,1882
0130-001,2012,10,7,11,1078,1318,2396,2064
0130-001,2012,10,7,12,1200,1271,2471,2396
0130-001,2012,10,7,13,1200,1326,2526,2471
0130-001,2012,10,7,14,1371,1293,2664,2526
0130-001,2012,10,7,15,1478,1519,2997,2664
0130-001,2012,10,7,16,1546,1480,3026,2997
0130-001,2012,10,7,17,1546,1579,3125,3026
0130-001,2012,10,7,18,1657,1552,3209,3125
0130-001,2012,10,7,19,1605,1547,3152,3209
0130-001,2012,10,7,20,1250,1122,2372,3152
0130-001,2012,10,7,21,1059,966,2025,2372
0130-001,2012,10,7,22,1020,735,1755,2025
0130-001,2012,10,7,23,643,553,1196,1755
0130-001,2012,10,7,24,521,358,879,1196
0130-001,2012,10,8,1,264,250,514,879
0130-001,2012,10,8,2,182,174,356,514
0130-001,2012,10,8,3,126,117,243,356
0130-001,2012,10,8,4,89,125,214,243
0130-001,2012,10,8,5,159,228,387,214
0130-001,2012,10,8,6,334,366,700,387
0130-001,2012,10,8,7,1351,844,2195,700
0130-001,2012,10,8,8,2276,1792,4068,2195
0130-001,2012,10,8,9,2164,2057,4221,4068
0130-001,2012,10,8,10,1672,1718,3390,4221
0130-001,2012,10,8,11,1783,1706,3489,3390
0130-001,2012,10,8,12,1597,1557,3154,3489
0130-001,2012,10,8,13,1448,1422,2870,3154
0130-001,2012,10,8,14,1596,1604,3200,2870
0130-001,2012,10,8,15,1771,1779,3550,3200
0130-001,2012,10,8,16,1803,1909,3712,3550
0130-001,2012,10,8,17,1649,1910,3559,3712
0130-001,2012,10,8,18,1827,2150,3977,3559
0130-001,2012,10,8,19,1870,2369,4239,3977
0130-001,2012,10,8,20,1382,1780,3162,4239
0130-001,2012,10,8,21,1198,1595,2793,3162
0130-001,2012,10,8,22,1144,1306,2450,2793
0130-001,2012,10,8,23,830,822,1652,2450
0130-001,2012,10,8,24,534,510,1044,1652
0130-001,2012,10,9,1,348,322,670,1044
0130-001,2012,10,9,2,234,261,495,670
0130-001,2012,10,9,3,170,165,335,495
0130-001,2012,10,9,4,145,159,304,335
0130-001,2012,10,9,5,173,235,408,304
0130-001,2012,10,9,6,321,400,721,408
0130-001,2012,10,9,7,1221,801,2022,721
0130-001,2012,10,9,8,2251,1744,3995,2022
0130-001,2012,10,9,9,2078,1994,4072,3995
0130-001,2012,10,9,10,1789,1811,3600,4072
0130-001,2012,10,9,11,1803,1772,3575,3600
0130-001,2012,10,9,12,1564,1552,3116,3575
0130-001,2012,10,9,13,1451,1423,2874,3116
0130-001,2012,10,9,14,1648,1643,3291,2874
0130-001,2012,10,9,15,1763,1794,3557,3291
0130-001,2012,10,9,16,1661,1858,3519,3557
0130-001,2012,10,9,17,1638,1897,3535,3519
0130-001,2012,10,9,18,1764,2200,3964,3535
0130-001,2012,10,9,19,1768,2428,4196,3964
0130-001,2012,10,9,20,1346,1756,3102,4196
0130-001,2012,10,9,21,1281,1567,2848,3102
0130-001,2012,10,9,22,1146,1295,2441,2848
0130-001,2012,10,9,23,828,820,1648,2441
0130-001,2012,10,9,24,574,489,1063,1648
0130-001,2012,10,10,1,375,318,693,1063
0130-001,2012,10,10,2,246,241,487,693
0130-001,2012,10,10,3,174,171,345,487
0130-001,2012,10,10,4,184,173,357,345
0130-001,2012,10,10,5,184,209,393,357
0130-001,2012,10,10,6,292,340,632,393
0130-001,2012,10,10,7,1132,767,1899,632
0130-001,2012,10,10,8,2138,1734,3872,1899
0130-001,2012,10,10,9,2118,1975,4093,3872
0130-001,2012,10,10,10,1817,1768,3585,4093
0130-001,2012,10,10,11,1721,1745,3466,3585
0130-001,2012,10,10,12,1660,1605,3265,3466
0130-001,2012,10,10,13,1426,1487,2913,3265
0130-001,2012,10,10,14,1614,1607,3221,2913
0130-001,2012,10,10,15,1725,1781,3506,3221
0130-001,2012,10,10,16,1732,1809,3541,3506
0130-001,2012,10,10,17,1673,1838,3511,3541
0130-001,2012,10,10,18,1836,2350,4186,3511
0130-001,2012,10,10,19,1952,2474,4426,4186
0130-001,2012,10,10,20,1394,1801,3195,4426
0130-001,2012,10,10,21,1222,1577,2799,3195
0130-001,2012,10,10,22,1245,1183,2428,2799
0130-001,2012,10,10,23,880,801,1681,2428
0130-001,2012,10,10,24,596,561,1157,1681
0130-001,2012,10,11,1,409,347,756,1157
0130-001,2012,10,11,2,260,263,523,756
0130-001,2012,10,11,3,198,195,393,523
0130-001,2012,10,11,4,162,162,324,393
0130-001,2012,10,11,5,176,250,426,324
0130-001,2012,10,11,6,299,333,632,426
0130-001,2012,10,11,7,1176,792,1968,632
0130-001,2012,10,11,8,2247,1736,3983,1968
0130-001,2012,10,11,9,2202,2007,4209,3983
0130-001,2012,10,11,10,1748,1709,3457,4209
0130-001,2012,10,11,11,1783,1763,3546,3457
0130-001,2012,10,11,12,1539,1655,3194,3546
0130-001,2012,10,11,13,1448,1506,2954,3194
0130-001,2012,10,11,14,1654,1667,3321,2954
0130-001,2012,10,11,15,1775,1735,3510,3321
0130-001,2012,10,11,16,1709,1845,3554,3510
0130-001,2012,10,11,17,1725,1981,3706,3554
0130-001,2012,10,11,18,1795,2280,4075,3706
0130-001,2012,10,11,19,1807,2424,4231,4075
0130-001,2012,10,11,20,1297,1826,3123,4231
0130-001,2012,10,11,21,1225,1637,2862,3123
0130-001,2012,10,11,22,1167,1248,2415,2862
0130-001,2012,10,11,23,876,832,1708,2415
0130-001,2012,10,11,24,671,538,1209,1708
0130-001,2012,10,12,1,391,358,749,1209
0130-001,2012,10,12,2,239,234,473,749
0130-001,2012,10,12,3,175,171,346,473
0130-001,2012,10,12,4,164,186,350,346
0130-001,2012,10,12,5,178,225,403,350
0130-001,2012,10,12,6,313,360,673,403
0130-001,2012,10,12,7,1159,790,1949,673
0130-001,2012,10,12,8,2310,1742,4052,1949
0130-001,2012,10,12,9,2131,2053,4184,4052
0130-001,2012,10,12,10,1833,1782,3615,4184
0130-001,2012,10,12,11,1783,1731,3514,3615
0130-001,2012,10,12,12,1663,1672,3335,3514
0130-001,2012,10,12,13,1491,1475,2966,3335
0130-001,2012,10,12,14,1675,1706,3381,2966
0130-001,2012,10,12,15,1827,1927,3754,3381
0130-001,2012,10,12,16,1807,1888,3695,3754
0130-001,2012,10,12,17,1863,2058,3921,3695
0130-001,2012,10,12,18,2067,2377,4444,3921
0130-001,2012,10,12,19,2038,2512,4550,4444
0130-001,2012,10,12,20,1637,1999,3636,4550
0130-001,2012,10,12,21,1337,1628,2965,3636
0130-001,2012,10,12,22,1250,1421,2671,2965
0130-001,2012,10,12,23,984,953,1937,2671
0130-001,2012,10,12,24,739,635,1374,1937
0130-001,2012,10,13,1,485,445,930,1374
0130-001,2012,10,13,2,322,333,655,930
0130-001,2012,10,13,3,287,247,534,655
0130-001,2012,10,13,4,220,232,452,534
0130-001,2012,10,13,5,228,274,502,452
0130-001,2012,10,13,6,351,388,739,502
0130-001,2012,10,13,7,802,640,1442,739
0130-001,2012,10,13,8,1605,1113,2718,1442
0130-001,2012,10,13,9,1711,1853,3564,2718
0130-001,2012,10,13,10,1822,1979,3801,3564
0130-001,2012,10,13,11,1673,2095,3768,3801
0130-001,2012,10,13,12,1632,2238,3870,3768
0130-001,2012,10,13,13,2020,2490,4510,3870
0130-001,2012,10,13,14,1825,2323,4148,4510
0130-001,2012,10,13,15,1990,2223,4213,4148
0130-001,2012,10,13,16,1841,2174,4015,4213
0130-001,2012,10,13,17,1871,2128,3999,4015
0130-001,2012,10,13,18,1841,2291,4132,3999
0130-001,2012,10,13,19,1868,2149,4017,4132
0130-001,2012,10,13,20,1549,1479,3028,4017
0130-001,2012,10,13,21,1239,1198,2437,3028
0130-001,2012,10,13,22,1087,990,2077,2437
0130-001,2012,10,13,23,796,729,1525,2077
0130-001,2012,10,13,24,579,463,1042,1525
0130-001,2012,10,14,1,379,345,724,1042
0130-001,2012,10,14,2,286,272,558,724
0130-001,2012,10,14,3,236,179,415,558
0130-001,2012,10,14,4,185,164,349,415
0130-001,2012,10,14,5,187,157,344,349
0130-001,2012,10,14,6,250,289,539,344
0130-001,2012,10,14,7,536,437,973,539
0130-001,2012,10,14,8,789,751,1540,973
0130-001,2012,10,14,9,917,1046,1963,1540
0130-001,2012,10,14,10,997,1161,2158,1963
0130-001,2012,10,14,11,1200,1328,2528,2158
0130-001,2012,10,14,12,1161,1397,2558,2528
0130-001,2012,10,14,13,1289,1349,2638,2558
0130-001,2012,10,14,14,1547,1371,2918,2638
0130-001,2012,10,14,15,1572,1596,3168,2918
0130-001,2012,10,14,16,1745,1581,3326,3168
0130-001,2012,10,14,17,1824,1563,3387,3326
0130-001,2012,10,14,18,1758,1734,3492,3387
0130-001,2012,10,14,19,1786,1566,3352,3492
0130-001,2012,10,14,20,1525,1198,2723,3352
0130-001,2012,10,14,21,1266,1058,2324,2723
0130-001,2012,10,14,22,1137,878,2015,2324
0130-001,2012,10,14,23,772,556,1328,2015
0130-001,2012,10,14,24,490,402,892,1328
0130-001,2012,10,15,1,285,226,511,892
0130-001,2012,10,15,2,173,192,365,511
0130-001,2012,10,15,3,126,111,237,365
0130-001,2012,10,15,4,122,114,236,237
0130-001,2012,10,15,5,139,222,361,236
0130-001,2012,10,15,6,330,381,711,361
0130-001,2012,10,15,7,1336,844,2180,711
0130-001,2012,10,15,8,2386,1766,4152,2180
0130-001,2012,10,15,9,2129,2043,4172,4152
0130-001,2012,10,15,10,1715,1791,3506,4172
0130-001,2012,10,15,11,1772,1671,3443,3506
0130-001,2012,10,15,12,1613,1600,3213,3443
0130-001,2012,10,15,13,1459,1523,2982,3213
0130-001,2012,10,15,14,1773,1693,3466,2982
0130-001,2012,10,15,15,1808,1808,3616,3466
0130-001,2012,10,15,16,1696,1829,3525,3616
0130-001,2012,10,15,17,1699,1807,3506,3525
0130-001,2012,10,15,18,1758,2224,3982,3506
0130-001,2012,10,15,19,1850,2359,4209,3982
0130-001,2012,10,15,20,1513,1854,3367,4209
0130-001,2012,10,15,21,1175,1651,2826,3367
0130-001,2012,10,15,22,1088,1295,2383,2826
0130-001,2012,10,15,23,826,826,1652,2383
0130-001,2012,10,15,24,554,477,1031,1652
0130-001,2012,10,16,1,363,351,714,1031
0130-001,2012,10,16,2,234,229,463,714
0130-001,2012,10,16,3,177,158,335,463
0130-001,2012,10,16,4,142,179,321,335
0130-001,2012,10,16,5,184,223,407,321
0130-001,2012,10,16,6,335,395,730,407
0130-001,2012,10,16,7,1249,759,2008,730
0130-001,2012,10,16,8,2262,1734,3996,2008
0130-001,2012,10,16,9,2172,2080,4252,3996
0130-001,2012,10,16,10,1652,1796,3448,4252
0130-001,2012,10,16,11,1749,1568,3317,3448
0130-001,2012,10,16,12,1604,1580,3184,3317
0130-001,2012,10,16,13,1420,1406,2826,3184
0130-001,2012,10,16,14,1617,1597,3214,2826
0130-001,2012,10,16,15,1751,1751,3502,3214
0130-001,2012,10,16,16,1679,1655,3334,3502
0130-001,2012,10,16,17,1615,2010,3625,3334
0130-001,2012,10,16,18,1758,2201,3959,3625
0130-001,2012,10,16,19,1731,2345,4076,3959
0130-001,2012,10,16,20,1360,1684,3044,4076
0130-001,2012,10,16,21,1182,1526,2708,3044
0130-001,2012,10,16,22,1138,1321,2459,2708
0130-001,2012,10,16,23,865,841,1706,2459
0130-001,2012,10,16,24,534,492,1026,1706
0130-001,2012,10,17,1,405,348,753,1026
0130-001,2012,10,17,2,264,239,503,753
0130-001,2012,10,17,3,169,173,342,503
0130-001,2012,10,17,4,154,132,286,342
0130-001,2012,10,17,5,137,207,344,286
0130-001,2012,10,17,6,313,360,673,344
0130-001,2012,10,17,7,1031,678,1709,673
0130-001,2012,10,17,8,2165,1612,3777,1709
0130-001,2012,10,17,9,2079,2049,4128,3777
0130-001,2012,10,17,10,1673,1728,3401,4128
0130-001,2012,10,17,11,1674,1649,3323,3401
0130-001,2012,10,17,12,1565,1613,3178,3323
0130-001,2012,10,17,13,1439,1474,2913,3178
0130-001,2012,10,17,14,1669,1779,3448,2913
0130-001,2012,10,17,15,1723,1698,3421,3448
0130-001,2012,10,17,16,1728,1864,3592,3421
0130-001,2012,10,17,17,1809,1830,3639,3592
0130-001,2012,10,17,18,1794,2295,4089,3639
0130-001,2012,10,17,19,1819,2414,4233,4089
0130-001,2012,10,17,20,1251,1738,2989,4233
0130-001,2012,10,17,21,1172,1519,2691,2989
0130-001,2012,10,17,22,1060,1131,2191,2691
0130-001,2012,10,17,23,910,801,1711,2191
0130-001,2012,10,17,24,576,473,1049,1711
0130-001,2012,10,18,1,405,334,739,1049
0130-001,2012,10,18,2,223,214,437,739
0130-001,2012,10,18,3,188,181,369,437
0130-001,2012,10,18,4,160,157,317,369
0130-001,2012,10,18,5,151,196,347,317
0130-001,2012,10,18,6,311,375,686,347
0130-001,2012,10,18,7,1169,754,1923,686
0130-001,2012,10,18,8,2229,1758,3987,1923
0130-001,2012,10,18,9,2107,2077,4184,3987
0130-001,2012,10,18,10,1725,1718,3443,4184
0130-001,2012,10,18,11,1760,1706,3466,3443
0130-001,2012,10,18,12,1522,1657,3179,3466
0130-001,2012,10,18,13,1465,1390,2855,3179
0130-001,2012,10,18,14,1678,1627,3305,2855
0130-001,2012,10,18,15,1717,1763,3480,3305
0130-001,2012,10,18,16,1737,1787,3524,3480
0130-001,2012,10,18,17,1667,1909,3576,3524
0130-001,2012,10,18,18,1758,2246,4004,3576
0130-001,2012,10,18,19,1790,2400,4190,4004
0130-001,2012,10,18,20,1378,1750,3128,4190
0130-001,2012,10,18,21,1205,1563,2768,3128
0130-001,2012,10,18,22,1086,1270,2356,2768
0130-001,2012,10,18,23,918,820,1738,2356
0130-001,2012,10,18,24,559,533,1092,1738
0130-001,2012,10,19,1,388,370,758,1092
0130-001,2012,10,19,2,255,228,483,758
0130-001,2012,10,19,3,194,183,377,483
0130-001,2012,10,19,4,183,175,358,377
0130-001,2012,10,19,5,150,229,379,358
0130-001,2012,10,19,6,343,381,724,379
0130-001,2012,10,19,7,1162,738,1900,724
0130-001,2012,10,19,8,2295,1701,3996,1900
0130-001,2012,10,19,9,2015,2045,4060,3996
0130-001,2012,10,19,10,1641,1679,3320,4060
0130-001,2012,10,19,11,1747,1743,3490,3320
0130-001,2012,10,19,12,1571,1581,3152,3490
0130-001,2012,10,19,13,1417,1478,2895,3152
0130-001,2012,10,19,14,1663,1623,3286,2895
0130-001,2012,10,19,15,1757,1742,3499,3286
0130-001,2012,10,19,16,1784,1889,3673,3499
0130-001,2012,10,19,17,1723,1957,3680,3673
0130-001,2012,10,19,18,1896,2308,4204,3680
0130-001,2012,10,19,19,1935,2483,4418,4204
0130-001,2012,10,19,20,1509,2019,3528,4418
0130-001,2012,10,19,21,1291,1567,2858,3528
0130-001,2012,10,19,22,1207,1313,2520,2858
0130-001,2012,10,19,23,967,931,1898,2520
0130-001,2012,10,19,24,645,572,1217,1898
0130-001,2012,10,20,1,479,384,863,1217
0130-001,2012,10,20,2,301,275,576,863
0130-001,2012,10,20,3,253,222,475,576
0130-001,2012,10,20,4,249,242,491,475
0130-001,2012,10,20,5,223,300,523,491
0130-001,2012,10,20,6,321,410,731,523
0130-001,2012,10,20,7,850,641,1491,731
0130-001,2012,10,20,8,1533,1215,2748,1491
0130-001,2012,10,20,9,1651,1858,3509,2748
0130-001,2012,10,20,10,1676,1847,3523,3509
0130-001,2012,10,20,11,1685,1935,3620,3523
0130-001,2012,10,20,12,1833,2328,4161,3620
0130-001,2012,10,20,13,1640,2454,4094,4161
0130-001,2012,10,20,14,1740,2388,4128,4094
0130-001,2012,10,20,15,1872,2349,4221,4128
0130-001,2012,10,20,16,1870,2334,4204,4221
0130-001,2012,10,20,17,1900,2331,4231,4204
0130-001,2012,10,20,18,1885,2476,4361,4231
0130-001,2012,10,20,19,1861,2261,4122,4361
0130-001,2012,10,20,20,1414,1558,2972,4122
0130-001,2012,10,20,21,1236,1174,2410,2972
0130-001,2012,10,20,22,1096,1010,2106,2410
0130-001,2012,10,20,23,746,683,1429,2106
0130-001,2012,10,20,24,551,507,1058,1429
0130-001,2012,10,21,1,425,345,770,1058
0130-001,2012,10,21,2,279,295,574,770
0130-001,2012,10,21,3,241,194,435,574
0130-001,2012,10,21,4,196,190,386,435
0130-001,2012,10,21,5,187,165,352,386
0130-001,2012,10,21,6,243,280,523,352
0130-001,2012,10,21,7,525,431,956,523
0130-001,2012,10,21,8,749,701,1450,956
0130-001,2012,10,21,9,951,1097,2048,1450
0130-001,2012,10,21,10,1061,1173,2234,2048
0130-001,2012,10,21,11,1146,1357,2503,2234
0130-001,2012,10,21,12,1233,1364,2597,2503
0130-001,2012,10,21,13,1317,1468,2785,2597
0130-001,2012,10,21,14,1608,1394,3002,2785
0130-001,2012,10,21,15,1733,1497,3230,3002
0130-001,2012,10,21,16,1848,1535,3383,3230
0130-001,2012,10,21,17,1840,1604,3444,3383
0130-001,2012,10,21,18,1763,1712,3475,3444
0130-001,2012,10,21,19,1890,1579,3469,3475
0130-001,2012,10,21,20,1621,1176,2797,3469
0130-001,2012,10,21,21,1478,1105,2583,2797
0130-001,2012,10,21,22,1467,916,2383,2583
0130-001,2012,10,21,23,920,588,1508,2383
0130-001,2012,10,21,24,550,388,938,1508
0130-001,2012,10,22,1,297,288,585,938
0130-001,2012,10,22,2,189,183,372,585
0130-001,2012,10,22,3,136,134,270,372
0130-001,2012,10,22,4,135,135,270,270
0130-001,2012,10,22,5,157,194,351,270
0130-001,2012,10,22,6,298,344,642,351
0130-001,2012,10,22,7,1128,747,1875,642
0130-001,2012,10,22,8,2141,1726,3867,1875
0130-001,2012,10,22,9,2136,2043,4179,3867
0130-001,2012,10,22,10,1574,1644,3218,4179
0130-001,2012,10,22,11,1618,1640,3258,3218
0130-001,2012,10,22,12,1463,1445,2908,3258
0130-001,2012,10,22,13,1327,1292,2619,2908
0130-001,2012,10,22,14,1429,1473,2902,2619
0130-001,2012,10,22,15,1578,1572,3150,2902
0130-001,2012,10,22,16,1623,1719,3342,3150
0130-001,2012,10,22,17,1535,1745,3280,3342
0130-001,2012,10,22,18,1686,2056,3742,3280
0130-001,2012,10,22,19,1714,2253,3967,3742
0130-001,2012,10,22,20,1339,1711,3050,3967
0130-001,2012,10,22,21,1150,1465,2615,3050
0130-001,2012,10,22,22,1000,1225,2225,2615
0130-001,2012,10,22,23,781,716,1497,2225
0130-001,2012,10,22,24,508,491,999,1497
0130-001,2012,10,23,1,331,265,596,999
0130-001,2012,10,23,2,191,217,408,596
0130-001,2012,10,23,3,169,147,316,408
0130-001,2012,10,23,4,127,132,259,316
0130-001,2012,10,23,5,138,215,353,259
0130-001,2012,10,23,6,287,356,643,353
0130-001,2012,10,23,7,1084,743,1827,643
0130-001,2012,10,23,8,2238,1726,3964,1827
0130-001,2012,10,23,9,2204,2093,4297,3964
0130-001,2012,10,23,10,1688,1728,3416,4297
0130-001,2012,10,23,11,1821,1889,3710,3416
0130-001,2012,10,23,12,1564,1730,3294,3710
0130-001,2012,10,23,13,1446,1513,2959,3294
0130-001,2012,10,23,14,1680,1629,3309,2959
0130-001,2012,10,23,15,1867,1853,3720,3309
0130-001,2012,10,23,16,1829,1846,3675,3720
0130-001,2012,10,23,17,1712,1849,3561,3675
0130-001,2012,10,23,18,1768,2248,4016,3561
0130-001,2012,10,23,19,1774,2355,4129,4016
0130-001,2012,10,23,20,1371,1748,3119,4129
0130-001,2012,10,23,21,1201,1558,2759,3119
0130-001,2012,10,23,22,1146,1246,2392,2759
0130-001,2012,10,23,23,902,788,1690,2392
0130-001,2012,10,23,24,558,502,1060,1690
0130-001,2012,10,24,1,345,322,667,1060
0130-001,2012,10,24,2,238,227,465,667
0130-001,2012,10,24,3,177,169,346,465
0130-001,2012,10,24,4,165,164,329,346
0130-001,2012,10,24,5,167,240,407,329
0130-001,2012,10,24,6,323,357,680,407
0130-001,2012,10,24,7,1153,758,1911,680
0130-001,2012,10,24,8,2261,1670,3931,1911
0130-001,2012,10,24,9,2158,2123,4281,3931
0130-001,2012,10,24,10,1759,1786,3545,4281
0130-001,2012,10,24,11,1718,1688,3406,3545
0130-001,2012,10,24,12,1615,1595,3210,3406
0130-001,2012,10,24,13,1474,1484,2958,3210
0130-001,2012,10,24,14,1668,1612,3280,2958
0130-001,2012,10,24,15,1725,1746,3471,3280
0130-001,2012,10,24,16,1781,1835,3616,3471
0130-001,2012,10,24,17,1710,1894,3604,3616
0130-001,2012,10,24,18,1841,2384,4225,3604
0130-001,2012,10,24,19,1789,2413,4202,4225
0130-001,2012,10,24,20,1436,1781,3217,4202
0130-001,2012,10,24,21,1215,1515,2730,3217
0130-001,2012,10,24,22,1182,1243,2425,2730
0130-001,2012,10,24,23,891,744,1635,2425
0130-001,2012,10,24,24,629,540,1169,1635
0130-001,2012,10,25,1,404,349,753,1169
0130-001,2012,10,25,2,250,230,480,753
0130-001,2012,10,25,3,171,204,375,480
0130-001,2012,10,25,4,158,158,316,375
0130-001,2012,10,25,5,169,217,386,316
0130-001,2012,10,25,6,343,357,700,386
0130-001,2012,10,25,7,1151,729,1880,700
0130-001,2012,10,25,8,2352,1699,4051,1880
0130-001,2012,10,25,9,2199,2118,4317,4051
0130-001,2012,10,25,10,1730,1775,3505,4317
0130-001,2012,10,25,11,1763,1672,3435,3505
0130-001,2012,10,25,12,1614,1657,3271,3435
0130-001,2012,10,25,13,1453,1520,2973,3271
0130-001,2012,10,25,14,1780,1770,3550,2973
0130-001,2012,10,25,15,1797,1797,3594,3550
0130-001,2012,10,25,16,1727,1855,3582,3594
0130-001,2012,10,25,17,1816,1884,3700,3582
0130-001,2012,10,25,18,1706,2242,3948,3700
0130-001,2012,10,25,19,1717,2417,4134,3948
0130-001,2012,10,25,20,1365,1704,3069,4134
0130-001,2012,10,25,21,1249,1552,2801,3069
0130-001,2012,10,25,22,1165,1305,2470,2801
0130-001,2012,10,25,23,933,820,1753,2470
0130-001,2012,10,25,24,632,537,1169,1753
0130-001,2012,10,26,1,422,396,818,1169
0130-001,2012,10,26,2,278,241,519,818
0130-001,2012,10,26,3,236,187,423,519
0130-001,2012,10,26,4,166,181,347,423
0130-001,2012,10,26,5,180,247,427,347
0130-001,2012,10,26,6,351,377,728,427
0130-001,2012,10,26,7,1131,757,1888,728
0130-001,2012,10,26,8,2288,1670,3958,1888
0130-001,2012,10,26,9,2166,1997,4163,3958
0130-001,2012,10,26,10,1791,1711,3502,4163
0130-001,2012,10,26,11,1801,1711,3512,3502
0130-001,2012,10,26,12,1628,1754,3382,3512
0130-001,2012,10,26,13,1442,1521,2963,3382
0130-001,2012,10,26,14,1637,1785,3422,2963
0130-001,2012,10,26,15,1842,1896,3738,3422
0130-001,2012,10,26,16,1828,1940,3768,3738
0130-001,2012,10,26,17,1848,1950,3798,3768
0130-001,2012,10,26,18,1822,2300,4122,3798
0130-001,2012,10,26,19,2004,2441,4445,4122
0130-001,2012,10,26,20,1575,2130,3705,4445
0130-001,2012,10,26,21,1259,1759,3018,3705
0130-001,2012,10,26,22,1187,1379,2566,3018
0130-001,2012,10,26,23,977,905,1882,2566
0130-001,2012,10,26,24,708,598,1306,1882
0130-001,2012,10,27,1,482,506,988,1306
0130-001,2012,10,27,2,351,344,695,988
0130-001,2012,10,27,3,278,216,494,695
0130-001,2012,10,27,4,244,217,461,494
0130-001,2012,10,27,5,215,267,482,461
0130-001,2012,10,27,6,310,371,681,482
0130-001,2012,10,27,7,672,509,1181,681
0130-001,2012,10,27,8,1205,1019,2224,1181
0130-001,2012,10,27,9,1540,1577,3117,2224
0130-001,2012,10,27,10,1616,1704,3320,3117
0130-001,2012,10,27,11,1616,1915,3531,3320
0130-001,2012,10,27,12,1448,2127,3575,3531
0130-001,2012,10,27,13,1509,2162,3671,3575
0130-001,2012,10,27,14,1725,2176,3901,3671
0130-001,2012,10,27,15,1801,2223,4024,3901
0130-001,2012,10,27,16,1846,2122,3968,4024
0130-001,2012,10,27,17,1844,2112,3956,3968
0130-001,2012,10,27,18,1837,2150,3987,3956
0130-001,2012,10,27,19,1808,1948,3756,3987
0130-001,2012,10,27,20,1331,1238,2569,3756
0130-001,2012,10,27,21,1193,1128,2321,2569
0130-001,2012,10,27,22,961,945,1906,2321
0130-001,2012,10,27,23,766,662,1428,1906
0130-001,2012,10,27,24,508,456,964,1428
0130-001,2012,10,28,1,354,320,674,964
0130-001,2012,10,28,2,247,239,486,674
0130-001,2012,10,28,3,238,199,437,486
0130-001,2012,10,28,4,164,144,308,437
0130-001,2012,10,28,5,197,171,368,308
0130-001,2012,10,28,6,270,269,539,368
0130-001,2012,10,28,7,451,398,849,539
0130-001,2012,10,28,8,692,700,1392,849
0130-001,2012,10,28,9,877,1008,1885,1392
0130-001,2012,10,28,10,1014,1164,2178,1885
0130-001,2012,10,28,11,1090,1294,2384,2178
0130-001,2012,10,28,12,1138,1447,2585,2384
0130-001,2012,10,28,13,1359,1387,2746,2585
0130-001,2012,10,28,14,1495,1451,2946,2746
0130-001,2012,10,28,15,1696,1480,3176,2946
0130-001,2012,10,28,16,1683,1602,3285,3176
0130-001,2012,10,28,17,1742,1777,3519,3285
0130-001,2012,10,28,18,1865,1616,3481,3519
0130-001,2012,10,28,19,1827,1447,3274,3481
0130-001,2012,10,28,20,1523,1152,2675,3274
0130-001,2012,10,28,21,1431,1034,2465,2675
0130-001,2012,10,28,22,1316,828,2144,2465
0130-001,2012,10,28,23,803,601,1404,2144
0130-001,2012,10,28,24,524,398,922,1404
0130-001,2012,10,29,1,265,271,536,922
0130-001,2012,10,29,2,193,158,351,536
0130-001,2012,10,29,3,133,125,258,351
0130-001,2012,10,29,4,124,122,246,258
0130-001,2012,10,29,5,147,202,349,246
0130-001,2012,10,29,6,344,412,756,349
0130-001,2012,10,29,7,1237,854,2091,756
0130-001,2012,10,29,8,2298,1740,4038,2091
0130-001,2012,10,29,9,2228,2087,4315,4038
0130-001,2012,10,29,10,1688,1727,3415,4315
0130-001,2012,10,29,11,1728,1686,3414,3415
0130-001,2012,10,29,12,1622,1617,3239,3414
0130-001,2012,10,29,13,1496,1542,3038,3239
0130-001,2012,10,29,14,1791,1810,3601,3038
0130-001,2012,10,29,15,1848,1793,3641,3601
0130-001,2012,10,29,16,1804,1899,3703,3641
0130-001,2012,10,29,17,1723,1829,3552,3703
0130-001,2012,10,29,18,1738,2233,3971,3552
0130-001,2012,10,29,19,1832,2382,4214,3971
0130-001,2012,10,29,20,1355,1648,3003,4214
0130-001,2012,10,29,21,1145,1553,2698,3003
0130-001,2012,10,29,22,1032,1229,2261,2698
0130-001,2012,10,29,23,861,816,1677,2261
0130-001,2012,10,29,24,520,480,1000,1677
0130-001,2012,10,30,1,344,336,680,1000
0130-001,2012,10,30,2,216,203,419,680
0130-001,2012,10,30,3,153,148,301,419
0130-001,2012,10,30,4,156,180,336,301
0130-001,2012,10,30,5,165,241,406,336
0130-001,2012,10,30,6,348,414,762,406
0130-001,2012,10,30,7,1090,715,1805,762
0130-001,2012,10,30,8,2288,1702,3990,1805
0130-001,2012,10,30,9,2223,2090,4313,3990
0130-001,2012,10,30,10,1777,1749,3526,4313
0130-001,2012,10,30,11,1694,1758,3452,3526
0130-001,2012,10,30,12,1568,1611,3179,3452
0130-001,2012,10,30,13,1446,1554,3000,3179
0130-001,2012,10,30,14,1711,1750,3461,3000
0130-001,2012,10,30,15,1796,1731,3527,3461
0130-001,2012,10,30,16,1789,1838,3627,3527
0130-001,2012,10,30,17,1689,1864,3553,3627
0130-001,2012,10,30,18,1786,2325,4111,3553
0130-001,2012,10,30,19,1784,2289,4073,4111
0130-001,2012,10,30,20,1398,1701,3099,4073
0130-001,2012,10,30,21,1162,1592,2754,3099
0130-001,2012,10,30,22,1181,1244,2425,2754
0130-001,2012,10,30,23,833,804,1637,2425
0130-001,2012,10,30,24,582,499,1081,1637
0130-001,2012,10,31,1,335,348,683,1081
0130-001,2012,10,31,2,244,230,474,683
0130-001,2012,10,31,3,182,176,358,474
0130-001,2012,10,31,4,135,145,280,358
0130-001,2012,10,31,5,167,209,376,280
0130-001,2012,10,31,6,318,388,706,376
0130-001,2012,10,31,7,1063,695,1758,706
0130-001,2012,10,31,8,2258,1654,3912,1758
0130-001,2012,10,31,9,2060,2093,4153,3912
0130-001,2012,10,31,10,1779,1768,3547,4153
0130-001,2012,10,31,11,1728,1674,3402,3547
0130-001,2012,10,31,12,1596,1678,3274,3402
0130-001,2012,10,31,13,1430,1504,2934,3274
0130-001,2012,10,31,14,1684,1668,3352,2934
0130-001,2012,10,31,15,1789,1777,3566,3352
0130-001,2012,10,31,16,1733,1822,3555,3566
0130-001,2012,10,31,17,1648,1877,3525,3555
0130-001,2012,10,31,18,1890,2345,4235,3525
0130-001,2012,10,31,19,1740,2321,4061,4235
0130-001,2012,10,31,20,1343,1754,3097,4061
0130-001,2012,10,31,21,1178,1412,2590,3097
0130-001,2012,10,31,22,1163,1212,2375,2590
0130-001,2012,10,31,23,910,769,1679,2375
0130-001,2012,10,31,24,709,545,1254,1679
0130-001,2012,11,1,1,422,339,761,1254
0130-001,2012,11,1,2,238,233,471,761
0130-001,2012,11,1,3,209,169,378,471
0130-001,2012,11,1,4,144,159,303,378
0130-001,2012,11,1,5,178,246,424,303
0130-001,2012,11,1,6,317,369,686,424
0130-001,2012,11,1,7,1107,711,1818,686
0130-001,2012,11,1,8,2142,1559,3701,1818
0130-001,2012,11,1,9,2231,2132,4363,3701
0130-001,2012,11,1,10,1707,1759,3466,4363
0130-001,2012,11,1,11,1743,1631,3374,3466
0130-001,2012,11,1,12,1604,1641,3245,3374
0130-001,2012,11,1,13,1376,1465,2841,3245
0130-001,2012,11,1,14,1684,1717,3401,2841
0130-001,2012,11,1,15,1748,1786,3534,3401
0130-001,2012,11,1,16,1779,1833,3612,3534
0130-001,2012,11,1,17,1696,1840,3536,3612
0130-001,2012,11,1,18,1791,2249,4040,3536
0130-001,2012,11,1,19,1765,2410,4175,4040
0130-001,2012,11,1,20,1302,1706,3008,4175
0130-001,2012,11,1,21,1183,1564,2747,3008
0130-001,2012,11,1,22,1106,1227,2333,2747
0130-001,2012,11,1,23,821,758,1579,2333
0130-001,2012,11,1,24,613,484,1097,1579
0130-001,2012,11,2,1,382,347,729,1097
0130-001,2012,11,2,2,251,246,497,729
0130-001,2012,11,2,3,198,172,370,497
0130-001,2012,11,2,4,136,157,293,370
0130-001,2012,11,2,5,151,237,388,293
0130-001,2012,11,2,6,315,332,647,388
0130-001,2012,11,2,7,1046,695,1741,647
0130-001,2012,11,2,8,2219,1651,3870,1741
0130-001,2012,11,2,9,2198,1995,4193,3870
0130-001,2012,11,2,10,1782,1736,3518,4193
0130-001,2012,11,2,11,1694,1624,3318,3518
0130-001,2012,11,2,12,1576,1723,3299,3318
0130-001,2012,11,2,13,1338,1554,2892,3299
0130-001,2012,11,2,14,1699,1709,3408,2892
0130-001,2012,11,2,15,1737,1837,3574,3408
0130-001,2012,11,2,16,1848,1891,3739,3574
0130-001,2012,11,2,17,1806,1923,3729,3739
0130-001,2012,11,2,18,1898,2426,4324,3729
0130-001,2012,11,2,19,2000,2531,4531,4324
0130-001,2012,11,2,20,1558,1961,3519,4531
0130-001,2012,11,2,21,1318,1676,2994,3519
0130-001,2012,11,2,22,1174,1304,2478,2994
0130-001,2012,11,2,23,972,927,1899,2478
0130-001,2012,11,2,24,681,595,1276,1899
0130-001,2012,11,3,1,487,443,930,1276
0130-001,2012,11,3,2,356,294,650,930
0130-001,2012,11,3,3,253,240,493,650
0130-001,2012,11,3,4,212,212,424,493
0130-001,2012,11,3,5,197,257,454,424
0130-001,2012,11,3,6,323,368,691,454
0130-001,2012,11,3,7,770,597,1367,691
0130-001,2012,11,3,8,1406,1148,2554,1367
0130-001,2012,11,3,9,1624,1796,3420,2554
0130-001,2012,11,3,10,1689,1887,3576,3420
0130-001,2012,11,3,11,1688,2137,3825,3576
0130-001,2012,11,3,12,1661,2359,4020,3825
0130-001,2012,11,3,13,1618,2359,3977,4020
0130-001,2012,11,3,14,1758,2414,4172,3977
0130-001,2012,11,3,15,1797,2339,4136,4172
0130-001,2012,11,3,16,1886,2247,4133,4136
0130-001,2012,11,3,17,1806,2173,3979,4133
0130-001,2012,11,3,18,1745,2332,4077,3979
0130-001,2012,11,3,19,1759,2147,3906,4077
0130-001,2012,11,3,20,1730,1398,3128,3906
0130-001,2012,11,3,21,1318,1166,2484,3128
0130-001,2012,11,3,22,1215,1001,2216,2484
0130-001,2012,11,3,23,809,688,1497,2216
0130-001,2012,11,3,24,522,481,1003,1497
0130-001,2012,11,4,1,393,321,714,1003
0130-001,2012,11,4,2,288,277,565,714
0130-001,2012,11,4,3,239,179,418,565
0130-001,2012,11,4,4,180,162,342,418
0130-001,2012,11,4,5,166,160,326,342
0130-001,2012,11,4,6,220,253,473,326
0130-001,2012,11,4,7,448,332,780,473
0130-001,2012,11,4,8,689,620,1309,780
0130-001,2012,11,4,9,918,888,1806,1309
0130-001,2012,11,4,10,1055,1070,2125,1806
0130-001,2012,11,4,11,1158,1304,2462,2125
0130-001,2012,11,4,12,1162,1428,2590,2462
0130-001,2012,11,4,13,1327,1437,2764,2590
0130-001,2012,11,4,14,1514,1406,2920,2764
0130-001,2012,11,4,15,1629,1684,3313,2920
0130-001,2012,11,4,16,1764,1604,3368,3313
0130-001,2012,11,4,17,1844,1566,3410,3368
0130-001,2012,11,4,18,1731,1478,3209,3410
0130-001,2012,11,4,19,1679,1187,2866,3209
0130-001,2012,11,4,20,1540,1036,2576,2866
0130-001,2012,11,4,21,1287,876,2163,2576
0130-001,2012,11,4,22,1049,743,1792,2163
0130-001,2012,11,4,23,636,490,1126,1792
0130-001,2012,11,4,24,442,359,801,1126
0130-001,2012,11,5,1,211,226,437,801
0130-001,2012,11,5,2,161,132,293,437
0130-001,2012,11,5,3,119,106,225,293
0130-001,2012,11,5,4,102,102,204,225
0130-001,2012,11,5,5,141,193,334,204
0130-001,2012,11,5,6,295,384,679,334
0130-001,2012,11,5,7,1160,725,1885,679
0130-001,2012,11,5,8,2216,1725,3941,1885
0130-001,2012,11,5,9,2210,2068,4278,3941
0130-001,2012,11,5,10,1676,1663,3339,4278
0130-001,2012,11,5,11,1670,1699,3369,3339
0130-001,2012,11,5,12,1579,1595,3174,3369
0130-001,2012,11,5,13,1398,1414,2812,3174
0130-001,2012,11,5,14,1660,1663,3323,2812
0130-001,2012,11,5,15,1710,1762,3472,3323
0130-001,2012,11,5,16,1747,1956,3703,3472
0130-001,2012,11,5,17,1654,1794,3448,3703
0130-001,2012,11,5,18,1727,2244,3971,3448
0130-001,2012,11,5,19,1716,2189,3905,3971
0130-001,2012,11,5,20,1343,1597,2940,3905
0130-001,2012,11,5,21,1139,1529,2668,2940
0130-001,2012,11,5,22,1045,1206,2251,2668
0130-001,2012,11,5,23,870,753,1623,2251
0130-001,2012,11,5,24,522,448,970,1623
0130-001,2012,11,6,1,322,317,639,970
0130-001,2012,11,6,2,242,214,456,639
0130-001,2012,11,6,3,143,151,294,456
0130-001,2012,11,6,4,143,168,311,294
0130-001,2012,11,6,5,154,218,372,311
0130-001,2012,11,6,6,327,357,684,372
0130-001,2012,11,6,7,1069,693,1762,684
0130-001,2012,11,6,8,2191,1659,3850,1762
0130-001,2012,11,6,9,2129,2044,4173,3850
0130-001,2012,11,6,10,1743,1739,3482,4173
0130-001,2012,11,6,11,1733,1577,3310,3482
0130-001,2012,11,6,12,1629,1598,3227,3310
0130-001,2012,11,6,13,1376,1420,2796,3227
0130-001,2012,11,6,14,1663,1624,3287,2796
0130-001,2012,11,6,15,1679,1754,3433,3287
0130-001,2012,11,6,16,1631,1840,3471,3433
0130-001,2012,11,6,17,1574,1780,3354,3471
0130-001,2012,11,6,18,1683,2113,3796,3354
0130-001,2012,11,6,19,1636,2208,3844,3796
0130-001,2012,11,6,20,1278,1605,2883,3844
0130-001,2012,11,6,21,1174,1585,2759,2883
0130-001,2012,11,6,22,1131,1183,2314,2759
0130-001,2012,11,6,23,857,759,1616,2314
0130-001,2012,11,6,24,575,513,1088,1616
0130-001,2012,11,7,1,371,346,717,1088
0130-001,2012,11,7,2,214,181,395,717
0130-001,2012,11,7,3,152,176,328,395
0130-001,2012,11,7,4,168,180,348,328
0130-001,2012,11,7,5,149,192,341,348
0130-001,2012,11,7,6,288,339,627,341
0130-001,2012,11,7,7,1082,672,1754,627
0130-001,2012,11,7,8,2252,1679,3931,1754
0130-001,2012,11,7,9,2075,2037,4112,3931
0130-001,2012,11,7,10,1654,1785,3439,4112
0130-001,2012,11,7,11,1752,1663,3415,3439
0130-001,2012,11,7,12,1723,1589,3312,3415
0130-001,2012,11,7,13,1428,1450,2878,3312
0130-001,2012,11,7,14,1748,1686,3434,2878
0130-001,2012,11,7,15,1687,1749,3436,3434
0130-001,2012,11,7,16,1870,1800,3670,3436
0130-001,2012,11,7,17,1723,1972,3695,3670
0130-001,2012,11,7,18,1727,2305,4032,3695
0130-001,2012,11,7,19,1740,2463,4203,4032
0130-001,2012,11,7,20,1334,1686,3020,4203
0130-001,2012,11,7,21,1182,1499,2681,3020
0130-001,2012,11,7,22,1155,1212,2367,2681
0130-001,2012,11,7,23,882,842,1724,2367
0130-001,2012,11,7,24,554,503,1057,1724
0130-001,2012,11,8,1,379,332,711,1057
0130-001,2012,11,8,2,247,253,500,711
0130-001,2012,11,8,3,170,176,346,500
0130-001,2012,11,8,4,169,156,325,346
0130-001,2012,11,8,5,161,221,382,325
0130-001,2012,11,8,6,309,383,692,382
0130-001,2012,11,8,7,1093,766,1859,692
0130-001,2012,11,8,8,2271,1726,3997,1859
0130-001,2012,11,8,9,2198,1988,4186,3997
0130-001,2012,11,8,10,1873,1879,3752,4186
0130-001,2012,11,8,11,1687,1676,3363,3752
0130-001,2012,11,8,12,1612,1554,3166,3363
0130-001,2012,11,8,13,1384,1506,2890,3166
0130-001,2012,11,8,14,1669,1687,3356,2890
0130-001,2012,11,8,15,1748,1852,3600,3356
0130-001,2012,11,8,16,1857,1781,3638,3600
0130-001,2012,11,8,17,1773,1948,3721,3638
0130-001,2012,11,8,18,1887,2233,4120,3721
0130-001,2012,11,8,19,1778,2331,4109,4120
0130-001,2012,11,8,20,1382,1724,3106,4109
0130-001,2012,11,8,21,1217,1606,2823,3106
0130-001,2012,11,8,22,1097,1297,2394,2823
0130-001,2012,11,8,23,868,817,1685,2394
0130-001,2012,11,8,24,596,514,1110,1685
0130-001,2012,11,9,1,371,342,713,1110
0130-001,2012,11,9,2,242,241,483,713
0130-001,2012,11,9,3,176,183,359,483
0130-001,2012,11,9,4,158,178,336,359
0130-001,2012,11,9,5,185,206,391,336
0130-001,2012,11,9,6,301,360,661,391
0130-001,2012,11,9,7,1057,698,1755,661
0130-001,2012,11,9,8,2114,1601,3715,1755
0130-001,2012,11,9,9,2144,2028,4172,3715
0130-001,2012,11,9,10,1733,1721,3454,4172
0130-001,2012,11,9,11,1727,1661,3388,3454
0130-001,2012,11,9,12,1614,1613,3227,3388
0130-001,2012,11,9,13,1397,1496,2893,3227
0130-001,2012,11,9,14,1720,1682,3402,2893
0130-001,2012,11,9,15,1733,1743,3476,3402
0130-001,2012,11,9,16,1903,1958,3861,3476
0130-001,2012,11,9,17,1789,1930,3719,3861
0130-001,2012,11,9,18,1833,2367,4200,3719
0130-001,2012,11,9,19,1924,2344,4268,4200
0130-001,2012,11,9,20,1546,1990,3536,4268
0130-001,2012,11,9,21,1343,1689,3032,3536
0130-001,2012,11,9,22,1192,1388,2580,3032
0130-001,2012,11,9,23,958,910,1868,2580
0130-001,2012,11,9,24,700,611,1311,1868
0130-001,2012,11,10,1,508,440,948,1311
0130-001,2012,11,10,2,366,315,681,948
0130-001,2012,11,10,3,290,223,513,681
0130-001,2012,11,10,4,235,228,463,513
0130-001,2012,11,10,5,212,268,480,463
0130-001,2012,11,10,6,324,403,727,480
0130-001,2012,11,10,7,770,598,1368,727
0130-001,2012,11,10,8,1431,1104,2535,1368
0130-001,2012,11,10,9,1617,1705,3322,2535
0130-001,2012,11,10,10,1731,1939,3670,3322
0130-001,2012,11,10,11,1746,2072,3818,3670
0130-001,2012,11,10,12,1800,2248,4048,3818
0130-001,2012,11,10,13,1759,2355,4114,4048
0130-001,2012,11,10,14,1807,2351,4158,4114
0130-001,2012,11,10,15,1886,2344,4230,4158
0130-001,2012,11,10,16,1963,2339,4302,4230
0130-001,2012,11,10,17,2060,2340,4400,4302
0130-001,2012,11,10,18,1999,2387,4386,4400
0130-001,2012,11,10,19,1907,2241,4148,4386
0130-001,2012,11,10,20,1565,1572,3137,4148
0130-001,2012,11,10,21,1363,1230,2593,3137
0130-001,2012,11,10,22,1205,969,2174,2593
0130-001,2012,11,10,23,854,697,1551,2174
0130-001,2012,11,10,24,602,469,1071,1551
0130-001,2012,11,11,1,393,354,747,1071
0130-001,2012,11,11,2,321,267,588,747
0130-001,2012,11,11,3,235,179,414,588
0130-001,2012,11,11,4,207,162,369,414
0130-001,2012,11,11,5,192,150,342,369
0130-001,2012,11,11,6,181,234,415,342
0130-001,2012,11,11,7,371,336,707,415
0130-001,2012,11,11,8,559,551,1110,707
0130-001,2012,11,11,9,777,941,1718,1110
0130-001,2012,11,11,10,829,988,1817,1718
0130-001,2012,11,11,11,1130,1230,2360,1817
0130-001,2012,11,11,12,1202,1409,2611,2360
0130-001,2012,11,11,13,1339,1520,2859,2611
0130-001,2012,11,11,14,1619,1658,3277,2859
0130-001,2012,11,11,15,1809,1675,3484,3277
0130-001,2012,11,11,16,2047,1635,3682,3484
0130-001,2012,11,11,17,1803,1595,3398,3682
0130-001,2012,11,11,18,1713,1500,3213,3398
0130-001,2012,11,11,19,1686,1216,2902,3213
0130-001,2012,11,11,20,1595,1131,2726,2902
0130-001,2012,11,11,21,1313,1019,2332,2726
0130-001,2012,11,11,22,1122,772,1894,2332
0130-001,2012,11,11,23,677,515,1192,1894
0130-001,2012,11,11,24,454,369,823,1192
0130-001,2012,11,12,1,279,205,484,823
0130-001,2012,11,12,2,175,174,349,484
0130-001,2012,11,12,3,129,104,233,349
0130-001,2012,11,12,4,112,114,226,233
0130-001,2012,11,12,5,141,227,368,226
0130-001,2012,11,12,6,322,367,689,368
0130-001,2012,11,12,7,1184,754,1938,689
0130-001,2012,11,12,8,2200,1686,3886,1938
0130-001,2012,11,12,9,2205,2037,4242,3886
0130-001,2012,11,12,10,1752,1825,3577,4242
0130-001,2012,11,12,11,1721,1682,3403,3577
0130-001,2012,11,12,12,1693,1590,3283,3403
0130-001,2012,11,12,13,1427,1528,2955,3283
0130-001,2012,11,12,14,1711,1667,3378,2955
0130-001,2012,11,12,15,1787,1818,3605,3378
0130-001,2012,11,12,16,1790,1911,3701,3605
0130-001,2012,11,12,17,1761,1861,3622,3701
0130-001,2012,11,12,18,1704,2187,3891,3622
0130-001,2012,11,12,19,1718,2228,3946,3891
0130-001,2012,11,12,20,1311,1640,2951,3946
0130-001,2012,11,12,21,1115,1552,2667,2951
0130-001,2012,11,12,22,1089,1189,2278,2667
0130-001,2012,11,12,23,767,764,1531,2278
0130-001,2012,11,12,24,480,504,984,1531
0130-001,2012,11,13,1,357,296,653,984
0130-001,2012,11,13,2,220,198,418,653
0130-001,2012,11,13,3,169,169,338,418
0130-001,2012,11,13,4,140,162,302,338
0130-001,2012,11,13,5,146,249,395,302
0130-001,2012,11,13,6,306,345,651,395
0130-001,2012,11,13,7,1057,682,1739,651
0130-001,2012,11,13,8,2031,1612,3643,1739
0130-001,2012,11,13,9,2192,2085,4277,3643
0130-001,2012,11,13,10,1716,1763,3479,4277
0130-001,2012,11,13,11,1709,1723,3432,3479
0130-001,2012,11,13,12,1589,1514,3103,3432
0130-001,2012,11,13,13,1410,1431,2841,3103
0130-001,2012,11,13,14,1588,1617,3205,2841
0130-001,2012,11,13,15,1568,1700,3268,3205
0130-001,2012,11,13,16,1660,1762,3422,3268
0130-001,2012,11,13,17,1697,1781,3478,3422
0130-001,2012,11,13,18,1680,2160,3840,3478
0130-001,2012,11,13,19,1649,2266,3915,3840
0130-001,2012,11,13,20,1228,1570,2798,3915
0130-001,2012,11,13,21,1172,1512,2684,2798
0130-001,2012,11,13,22,1063,1162,2225,2684
0130-001,2012,11,13,23,777,761,1538,2225
0130-001,2012,11,13,24,520,492,1012,1538
0130-001,2012,11,14,1,382,296,678,1012
0130-001,2012,11,14,2,232,201,433,678
0130-001,2012,11,14,3,183,175,358,433
0130-001,2012,11,14,4,120,162,282,358
0130-001,2012,11,14,5,161,213,374,282
0130-001,2012,11,14,6,298,329,627,374
0130-001,2012,11,14,7,1061,673,1734,627
0130-001,2012,11,14,8,2208,1623,3831,1734
0130-001,2012,11,14,9,2178,2117,4295,3831
0130-001,2012,11,14,10,1833,1763,3596,4295
0130-001,2012,11,14,11,1783,1560,3343,3596
0130-001,2012,11,14,12,1533,1633,3166,3343
0130-001,2012,11,14,13,1474,1442,2916,3166
0130-001,2012,11,14,14,1757,1685,3442,2916
0130-001,2012,11,14,15,1828,1892,3720,3442
0130-001,2012,11,14,16,1862,1913,3775,3720
0130-001,2012,11,14,17,1780,2031,3811,3775
0130-001,2012,11,14,18,1848,2368,4216,3811
0130-001,2012,11,14,19,1772,2502,4274,4216
0130-001,2012,11,14,20,1400,1650,3050,4274
0130-001,2012,11,14,21,1185,1495,2680,3050
0130-001,2012,11,14,22,1104,1218,2322,2680
0130-001,2012,11,14,23,855,762,1617,2322
0130-001,2012,11,14,24,583,552,1135,1617
0130-001,2012,11,15,1,411,323,734,1135
0130-001,2012,11,15,2,247,233,480,734
0130-001,2012,11,15,3,184,191,375,480
0130-001,2012,11,15,4,155,147,302,375
0130-001,2012,11,15,5,151,253,404,302
0130-001,2012,11,15,6,300,335,635,404
0130-001,2012,11,15,7,1060,715,1775,635
0130-001,2012,11,15,8,2212,1656,3868,1775
0130-001,2012,11,15,9,2166,2015,4181,3868
0130-001,2012,11,15,10,1678,1788,3466,4181
0130-001,2012,11,15,11,1754,1699,3453,3466
0130-001,2012,11,15,12,1637,1558,3195,3453
0130-001,2012,11,15,13,1424,1501,2925,3195
0130-001,2012,11,15,14,1814,1692,3506,2925
0130-001,2012,11,15,15,1769,1775,3544,3506
0130-001,2012,11,15,16,1857,1927,3784,3544
0130-001,2012,11,15,17,1778,1977,3755,3784
0130-001,2012,11,15,18,1776,2345,4121,3755
0130-001,2012,11,15,19,1729,2375,4104,4121
0130-001,2012,11,15,20,1370,1739,3109,4104
0130-001,2012,11,15,21,1184,1555,2739,3109
0130-001,2012,11,15,22,1146,1216,2362,2739
0130-001,2012,11,15,23,905,856,1761,2362
0130-001,2012,11,15,24,639,525,1164,1761
0130-001,2012,11,16,1,439,368,807,1164
0130-001,2012,11,16,2,258,256,514,807
0130-001,2012,11,16,3,181,168,349,514
0130-001,2012,11,16,4,171,192,363,349
0130-001,2012,11,16,5,184,235,419,363
0130-001,2012,11,16,6,292,354,646,419
0130-001,2012,11,16,7,1044,710,1754,646
0130-001,2012,11,16,8,2259,1623,3882,1754
0130-001,2012,11,16,9,2122,2077,4199,3882
0130-001,2012,11,16,10,1779,1828,3607,4199
0130-001,2012,11,16,11,1832,1680,3512,3607
0130-001,2012,11,16,12,1690,1702,3392,3512
0130-001,2012,11,16,13,1495,1617,3112,3392
0130-001,2012,11,16,14,1721,1807,3528,3112
0130-001,2012,11,16,15,1876,1922,3798,3528
0130-001,2012,11,16,16,1916,1907,3823,3798
0130-001,2012,11,16,17,1888,2020,3908,3823
0130-001,2012,11,16,18,1960,2350,4310,3908
0130-001,2012,11,16,19,1860,2452,4312,4310
0130-001,2012,11,16,20,1547,2031,3578,4312
0130-001,2012,11,16,21,1286,1801,3087,3578
0130-001,2012,11,16,22,1245,1323,2568,3087
0130-001,2012,11,16,23,932,880,1812,2568
0130-001,2012,11,16,24,669,619,1288,1812
0130-001,2012,11,17,1,518,418,936,1288
0130-001,2012,11,17,2,340,308,648,936
0130-001,2012,11,17,3,234,231,465,648
0130-001,2012,11,17,4,191,223,414,465
0130-001,2012,11,17,5,222,234,456,414
0130-001,2012,11,17,6,307,360,667,456
0130-001,2012,11,17,7,656,563,1219,667
0130-001,2012,11,17,8,1364,981,2345,1219
0130-001,2012,11,17,9,1547,1588,3135,2345
0130-001,2012,11,17,10,1727,1864,3591,3135
0130-001,2012,11,17,11,1750,2073,3823,3591
0130-001,2012,11,17,12,1860,2356,4216,3823
0130-001,2012,11,17,13,1784,2353,4137,4216
0130-001,2012,11,17,14,1841,2349,4190,4137
0130-001,2012,11,17,15,1934,2346,4280,4190
0130-001,2012,11,17,16,1996,2413,4409,4280
0130-001,2012,11,17,17,1991,2402,4393,4409
0130-001,2012,11,17,18,1993,2452,4445,4393
0130-001,2012,11,17,19,1965,2328,4293,4445
0130-001,2012,11,17,20,1443,1926,3369,4293
0130-001,2012,11,17,21,1284,1428,2712,3369
0130-001,2012,11,17,22,1066,1209,2275,2712
0130-001,2012,11,17,23,779,692,1471,2275
0130-001,2012,11,17,24,536,478,1014,1471
0130-001,2012,11,18,1,393,329,722,1014
0130-001,2012,11,18,2,279,239,518,722
0130-001,2012,11,18,3,238,206,444,518
0130-001,2012,11,18,4,167,161,328,444
0130-001,2012,11,18,5,173,144,317,328
0130-001,2012,11,18,6,234,243,477,317
0130-001,2012,11,18,7,449,381,830,477
0130-001,2012,11,18,8,697,651,1348,830
0130-001,2012,11,18,9,996,926,1922,1348
0130-001,2012,11,18,10,1069,1150,2219,1922
0130-001,2012,11,18,11,1145,1354,2499,2219
0130-001,2012,11,18,12,1229,1411,2640,2499
0130-001,2012,11,18,13,1439,1419,2858,2640
0130-001,2012,11,18,14,1718,1469,3187,2858
0130-001,2012,11,18,15,1890,1717,3607,3187
0130-001,2012,11,18,16,2007,1805,3812,3607
0130-001,2012,11,18,17,1683,1716,3399,3812
0130-001,2012,11,18,18,1658,1699,3357,3399
0130-001,2012,11,18,19,1733,1379,3112,3357
0130-001,2012,11,18,20,1712,1146,2858,3112
0130-001,2012,11,18,21,1742,995,2737,2858
0130-001,2012,11,18,22,1713,855,2568,2737
0130-001,2012,11,18,23,1237,603,1840,2568
0130-001,2012,11,18,24,627,407,1034,1840
0130-001,2012,11,19,1,322,239,561,1034
0130-001,2012,11,19,2,179,174,353,561
0130-001,2012,11,19,3,128,105,233,353
0130-001,2012,11,19,4,98,110,208,233
0130-001,2012,11,19,5,153,207,360,208
0130-001,2012,11,19,6,294,344,638,360
0130-001,2012,11,19,7,1162,742,1904,638
0130-001,2012,11,19,8,2065,1699,3764,1904
0130-001,2012,11,19,9,2246,2053,4299,3764
0130-001,2012,11,19,10,1695,1827,3522,4299
0130-001,2012,11,19,11,1767,1639,3406,3522
0130-001,2012,11,19,12,1635,1580,3215,3406
0130-001,2012,11,19,13,1516,1530,3046,3215
0130-001,2012,11,19,14,1769,1670,3439,3046
0130-001,2012,11,19,15,1768,1814,3582,3439
0130-001,2012,11,19,16,1878,1936,3814,3582
0130-001,2012,11,19,17,1761,1996,3757,3814
0130-001,2012,11,19,18,1829,2282,4111,3757
0130-001,2012,11,19,19,1761,2289,4050,4111
0130-001,2012,11,19,20,1331,1639,2970,4050
0130-001,2012,11,19,21,1157,1549,2706,2970
0130-001,2012,11,19,22,1132,1249,2381,2706
0130-001,2012,11,19,23,759,762,1521,2381
0130-001,2012,11,19,24,532,465,997,1521
0130-001,2012,11,20,1,348,315,663,997
0130-001,2012,11,20,2,220,187,407,663
0130-001,2012,11,20,3,144,173,317,407
0130-001,2012,11,20,4,125,159,284,317
0130-001,2012,11,20,5,153,195,348,284
0130-001,2012,11,20,6,271,379,650,348
0130-001,2012,11,20,7,1062,679,1741,650
0130-001,2012,11,20,8,2244,1680,3924,1741
0130-001,2012,11,20,9,2144,2080,4224,3924
0130-001,2012,11,20,10,1777,1751,3528,4224
0130-001,2012,11,20,11,1657,1627,3284,3528
0130-001,2012,11,20,12,1731,1493,3224,3284
0130-001,2012,11,20,13,1350,1528,2878,3224
0130-001,2012,11,20,14,1792,1639,3431,2878
0130-001,2012,11,20,15,1838,1822,3660,3431
0130-001,2012,11,20,16,1794,1930,3724,3660
0130-001,2012,11,20,17,1719,1949,3668,3724
0130-001,2012,11,20,18,1796,2330,4126,3668
0130-001,2012,11,20,19,1720,2395,4115,4126
0130-001,2012,11,20,20,1309,1726,3035,4115
0130-001,2012,11,20,21,1243,1537,2780,3035
0130-001,2012,11,20,22,1198,1305,2503,2780
0130-001,2012,11,20,23,779,794,1573,2503
0130-001,2012,11,20,24,576,481,1057,1573
0130-001,2012,11,21,1,389,348,737,1057
0130-001,2012,11,21,2,213,188,401,737
0130-001,2012,11,21,3,170,165,335,401
0130-001,2012,11,21,4,156,149,305,335
0130-001,2012,11,21,5,167,210,377,305
0130-001,2012,11,21,6,316,357,673,377
0130-001,2012,11,21,7,1088,649,1737,673
0130-001,2012,11,21,8,2216,1617,3833,1737
0130-001,2012,11,21,9,2171,2124,4295,3833
0130-001,2012,11,21,10,1746,1869,3615,4295
0130-001,2012,11,21,11,1758,1611,3369,3615
0130-001,2012,11,21,12,1687,1749,3436,3369
0130-001,2012,11,21,13,1442,1526,2968,3436
0130-001,2012,11,21,14,1653,1680,3333,2968
0130-001,2012,11,21,15,1745,1725,3470,3333
0130-001,2012,11,21,16,1858,1890,3748,3470
0130-001,2012,11,21,17,1749,1975,3724,3748
0130-001,2012,11,21,18,1778,2285,4063,3724
0130-001,2012,11,21,19,1737,2468,4205,4063
0130-001,2012,11,21,20,1348,1735,3083,4205
0130-001,2012,11,21,21,1153,1489,2642,3083
0130-001,2012,11,21,22,1152,1201,2353,2642
0130-001,2012,11,21,23,881,781,1662,2353
0130-001,2012,11,21,24,619,486,1105,1662
0130-001,2012,11,22,1,396,331,727,1105
0130-001,2012,11,22,2,237,235,472,727
0130-001,2012,11,22,3,194,182,376,472
0130-001,2012,11,22,4,153,166,319,376
0130-001,2012,11,22,5,179,222,401,319
0130-001,2012,11,22,6,291,354,645,401
0130-001,2012,11,22,7,1111,741,1852,645
0130-001,2012,11,22,8,2229,1748,3977,1852
0130-001,2012,11,22,9,2217,2197,4414,3977
0130-001,2012,11,22,10,1963,1855,3818,4414
0130-001,2012,11,22,11,1863,1638,3501,3818
0130-001,2012,11,22,12,1666,1684,3350,3501
0130-001,2012,11,22,13,1394,1744,3138,3350
0130-001,2012,11,22,14,1640,1716,3356,3138
0130-001,2012,11,22,15,1769,1763,3532,3356
0130-001,2012,11,22,16,1778,1830,3608,3532
0130-001,2012,11,22,17,1735,1948,3683,3608
0130-001,2012,11,22,18,1856,2240,4096,3683
0130-001,2012,11,22,19,1713,2432,4145,4096
0130-001,2012,11,22,20,1261,1621,2882,4145
0130-001,2012,11,22,21,1161,1599,2760,2882
0130-001,2012,11,22,22,1152,1162,2314,2760
0130-001,2012,11,22,23,903,778,1681,2314
0130-001,2012,11,22,24,618,526,1144,1681
0130-001,2012,11,23,1,377,321,698,1144
0130-001,2012,11,23,2,243,229,472,698
0130-001,2012,11,23,3,211,201,412,472
0130-001,2012,11,23,4,161,174,335,412
0130-001,2012,11,23,5,170,248,418,335
0130-001,2012,11,23,6,292,326,618,418
0130-001,2012,11,23,7,1091,701,1792,618
0130-001,2012,11,23,8,2180,1636,3816,1792
0130-001,2012,11,23,9,2156,2106,4262,3816
0130-001,2012,11,23,10,1777,1773,3550,4262
0130-001,2012,11,23,11,1770,1747,3517,3550
0130-001,2012,11,23,12,1657,1731,3388,3517
0130-001,2012,11,23,13,1461,1503,2964,3388
0130-001,2012,11,23,14,1754,1780,3534,2964
0130-001,2012,11,23,15,1891,1874,3765,3534
0130-001,2012,11,23,16,1884,2035,3919,3765
0130-001,2012,11,23,17,1889,2051,3940,3919
0130-001,2012,11,23,18,1934,2413,4347,3940
0130-001,2012,11,23,19,1910,2520,4430,4347
0130-001,2012,11,23,20,1525,1994,3519,4430
0130-001,2012,11,23,21,1275,1739,3014,3519
0130-001,2012,11,23,22,1211,1432,2643,3014
0130-001,2012,11,23,23,935,951,1886,2643
0130-001,2012,11,23,24,657,657,1314,1886
0130-001,2012,11,24,1,497,407,904,1314
0130-001,2012,11,24,2,357,297,654,904
0130-001,2012,11,24,3,255,238,493,654
0130-001,2012,11,24,4,230,217,447,493
0130-001,2012,11,24,5,224,280,504,447
0130-001,2012,11,24,6,321,366,687,504
0130-001,2012,11,24,7,773,572,1345,687
0130-001,2012,11,24,8,1356,1020,2376,1345
0130-001,2012,11,24,9,1578,1749,3327,2376
0130-001,2012,11,24,10,1657,1960,3617,3327
0130-001,2012,11,24,11,1739,2142,3881,3617
0130-001,2012,11,24,12,1755,2411,4166,3881
0130-001,2012,11,24,13,1744,2429,4173,4166
0130-001,2012,11,24,14,1752,2415,4167,4173
0130-001,2012,11,24,15,1928,2436,4364,4167
0130-001,2012,11,24,16,1980,2470,4450,4364
0130-001,2012,11,24,17,2011,2480,4491,4450
0130-001,2012,11,24,18,2011,2459,4470,4491
0130-001,2012,11,24,19,2075,2457,4532,4470
0130-001,2012,11,24,20,1595,2050,3645,4532
0130-001,2012,11,24,21,1325,1786,3111,3645
0130-001,2012,11,24,22,1196,1375,2571,3111
0130-001,2012,11,24,23,795,734,1529,2571
0130-001,2012,11,24,24,565,463,1028,1529
0130-001,2012,11,25,1,442,332,774,1028
0130-001,2012,11,25,2,285,229,514,774
0130-001,2012,11,25,3,207,187,394,514
0130-001,2012,11,25,4,181,153,334,394
0130-001,2012,11,25,5,174,146,320,334
0130-001,2012,11,25,6,245,291,536,320
0130-001,2012,11,25,7,501,405,906,536
0130-001,2012,11,25,8,714,603,1317,906
0130-001,2012,11,25,9,822,950,1772,1317
0130-001,2012,11,25,10,984,1142,2126,1772
0130-001,2012,11,25,11,1288,1292,2580,2126
0130-001,2012,11,25,12,1370,1431,2801,2580
0130-001,2012,11,25,13,1512,1532,3044,2801
0130-001,2012,11,25,14,1897,1465,3362,3044
0130-001,2012,11,25,15,2122,1550,3672,3362
0130-001,2012,11,25,16,2006,1563,3569,3672
0130-001,2012,11,25,17,1983,1522,3505,3569
0130-001,2012,11,25,18,1981,1655,3636,3505
0130-001,2012,11,25,19,1878,1308,3186,3636
0130-001,2012,11,25,20,1959,1045,3004,3186
0130-001,2012,11,25,21,1908,992,2900,3004
0130-001,2012,11,25,22,1825,794,2619,2900
0130-001,2012,11,25,23,1546,553,2099,2619
0130-001,2012,11,25,24,1401,440,1841,2099
0130-001,2012,11,26,1,491,237,728,1841
0130-001,2012,11,26,2,209,154,363,728
0130-001,2012,11,26,3,113,121,234,363
0130-001,2012,11,26,4,120,128,248,234
0130-001,2012,11,26,5,118,177,295,248
0130-001,2012,11,26,6,298,373,671,295
0130-001,2012,11,26,7,1134,678,1812,671
0130-001,2012,11,26,8,2137,1651,3788,1812
0130-001,2012,11,26,9,2250,2077,4327,3788
0130-001,2012,11,26,10,1707,1762,3469,4327
0130-001,2012,11,26,11,1746,1665,3411,3469
0130-001,2012,11,26,12,1730,1499,3229,3411
0130-001,2012,11,26,13,1408,1547,2955,3229
0130-001,2012,11,26,14,1727,1689,3416,2955
0130-001,2012,11,26,15,1819,1820,3639,3416
0130-001,2012,11,26,16,1800,1872,3672,3639
0130-001,2012,11,26,17,1724,1784,3508,3672
0130-001,2012,11,26,18,1773,2273,4046,3508
0130-001,2012,11,26,19,1695,2322,4017,4046
0130-001,2012,11,26,20,1276,1583,2859,4017
0130-001,2012,11,26,21,1121,1502,2623,2859
0130-001,2012,11,26,22,1092,1160,2252,2623
0130-001,2012,11,26,23,760,772,1532,2252
0130-001,2012,11,26,24,533,457,990,1532
0130-001,2012,11,27,1,325,232,557,990
0130-001,2012,11,27,2,194,204,398,557
0130-001,2012,11,27,3,184,166,350,398
0130-001,2012,11,27,4,142,162,304,350
0130-001,2012,11,27,5,142,191,333,304
0130-001,2012,11,27,6,271,342,613,333
0130-001,2012,11,27,7,1055,720,1775,613
0130-001,2012,11,27,8,2228,1640,3868,1775
0130-001,2012,11,27,9,2170,2053,4223,3868
0130-001,2012,11,27,10,1679,1754,3433,4223
0130-001,2012,11,27,11,1734,1681,3415,3433
0130-001,2012,11,27,12,1590,1528,3118,3415
0130-001,2012,11,27,13,1314,1464,2778,3118
0130-001,2012,11,27,14,1651,1635,3286,2778
0130-001,2012,11,27,15,1778,1795,3573,3286
0130-001,2012,11,27,16,1797,1849,3646,3573
0130-001,2012,11,27,17,1666,1876,3542,3646
0130-001,2012,11,27,18,1901,2296,4197,3542
0130-001,2012,11,27,19,1671,2335,4006,4197
0130-001,2012,11,27,20,1307,1599,2906,4006
0130-001,2012,11,27,21,1191,1498,2689,2906
0130-001,2012,11,27,22,1098,1204,2302,2689
0130-001,2012,11,27,23,852,804,1656,2302
0130-001,2012,11,27,24,546,483,1029,1656
0130-001,2012,11,28,1,383,344,727,1029
0130-001,2012,11,28,2,225,214,439,727
0130-001,2012,11,28,3,165,173,338,439
0130-001,2012,11,28,4,140,171,311,338
0130-001,2012,11,28,5,170,198,368,311
0130-001,2012,11,28,6,295,369,664,368
0130-001,2012,11,28,7,1066,660,1726,664
0130-001,2012,11,28,8,2209,1640,3849,1726
0130-001,2012,11,28,9,2075,2072,4147,3849
0130-001,2012,11,28,10,1736,1757,3493,4147
0130-001,2012,11,28,11,1820,1708,3528,3493
0130-001,2012,11,28,12,1619,1519,3138,3528
0130-001,2012,11,28,13,1322,1384,2706,3138
0130-001,2012,11,28,14,1571,1711,3282,2706
0130-001,2012,11,28,15,1710,1760,3470,3282
0130-001,2012,11,28,16,1838,1840,3678,3470
0130-001,2012,11,28,17,1717,1788,3505,3678
0130-001,2012,11,28,18,1703,2295,3998,3505
0130-001,2012,11,28,19,1719,2376,4095,3998
0130-001,2012,11,28,20,1286,1605,2891,4095
0130-001,2012,11,28,21,1123,1397,2520,2891
0130-001,2012,11,28,22,1151,1208,2359,2520
0130-001,2012,11,28,23,845,772,1617,2359
0130-001,2012,11,28,24,631,494,1125,1617
0130-001,2012,11,29,1,353,328,681,1125
0130-001,2012,11,29,2,260,247,507,681
0130-001,2012,11,29,3,192,182,374,507
0130-001,2012,11,29,4,141,153,294,374
0130-001,2012,11,29,5,160,215,375,294
0130-001,2012,11,29,6,303,370,673,375
0130-001,2012,11,29,7,1071,656,1727,673
0130-001,2012,11,29,8,2164,1535,3699,1727
0130-001,2012,11,29,9,2261,2023,4284,3699
0130-001,2012,11,29,10,1791,1845,3636,4284
0130-001,2012,11,29,11,1767,1728,3495,3636
0130-001,2012,11,29,12,1679,1627,3306,3495
0130-001,2012,11,29,13,1366,1485,2851,3306
0130-001,2012,11,29,14,1641,1732,3373,2851
0130-001,2012,11,29,15,1823,1796,3619,3373
0130-001,2012,11,29,16,1850,1833,3683,3619
0130-001,2012,11,29,17,1734,1843,3577,3683
0130-001,2012,11,29,18,1838,2288,4126,3577
0130-001,2012,11,29,19,1646,2254,3900,4126
0130-001,2012,11,29,20,1343,1686,3029,3900
0130-001,2012,11,29,21,1146,1498,2644,3029
0130-001,2012,11,29,22,1132,1235,2367,2644
0130-001,2012,11,29,23,882,756,1638,2367
0130-001,2012,11,29,24,555,497,1052,1638
0130-001,2012,11,30,1,390,351,741,1052
0130-001,2012,11,30,2,284,232,516,741
0130-001,2012,11,30,3,209,187,396,516
0130-001,2012,11,30,4,145,186,331,396
0130-001,2012,11,30,5,170,238,408,331
0130-001,2012,11,30,6,322,345,667,408
0130-001,2012,11,30,7,1024,678,1702,667
0130-001,2012,11,30,8,2235,1592,3827,1702
0130-001,2012,11,30,9,2217,2031,4248,3827
0130-001,2012,11,30,10,1670,1673,3343,4248
0130-001,2012,11,30,11,1712,1749,3461,3343
0130-001,2012,11,30,12,1608,1673,3281,3461
0130-001,2012,11,30,13,1507,1537,3044,3281
0130-001,2012,11,30,14,1700,1803,3503,3044
0130-001,2012,11,30,15,1859,1764,3623,3503
0130-001,2012,11,30,16,1835,1929,3764,3623
0130-001,2012,11,30,17,1819,1890,3709,3764
0130-001,2012,11,30,18,1891,2396,4287,3709
0130-001,2012,11,30,19,1875,2475,4350,4287
0130-001,2012,11,30,20,1458,1861,3319,4350
0130-001,2012,11,30,21,1327,1584,2911,3319
0130-001,2012,11,30,22,1151,1282,2433,2911
0130-001,2012,11,30,23,901,882,1783,2433
0130-001,2012,11,30,24,710,633,1343,1783
0130-001,2012,12,1,1,498,407,905,1343
0130-001,2012,12,1,2,353,334,687,905
0130-001,2012,12,1,3,256,234,490,687
0130-001,2012,12,1,4,181,220,401,490
0130-001,2012,12,1,5,198,246,444,401
0130-001,2012,12,1,6,289,366,655,444
0130-001,2012,12,1,7,739,564,1303,655
0130-001,2012,12,1,8,1267,1031,2298,1303
0130-001,2012,12,1,9,1512,1584,3096,2298
0130-001,2012,12,1,10,1617,1739,3356,3096
0130-001,2012,12,1,11,1633,2028,3661,3356
0130-001,2012,12,1,12,1711,2200,3911,3661
0130-001,2012,12,1,13,1674,2483,4157,3911
0130-001,2012,12,1,14,1831,2300,4131,4157
0130-001,2012,12,1,15,1862,2324,4186,4131
0130-001,2012,12,1,16,1845,2200,4045,4186
0130-001,2012,12,1,17,1906,2229,4135,4045
0130-001,2012,12,1,18,1837,2353,4190,4135
0130-001,2012,12,1,19,1772,2114,3886,4190
0130-001,2012,12,1,20,1282,1537,2819,3886
0130-001,2012,12,1,21,1162,1062,2224,2819
0130-001,2012,12,1,22,1026,923,1949,2224
0130-001,2012,12,1,23,719,623,1342,1949
0130-001,2012,12,1,24,567,487,1054,1342
0130-001,2012,12,2,1,440,346,786,1054
0130-001,2012,12,2,2,275,285,560,786
0130-001,2012,12,2,3,227,185,412,560
0130-001,2012,12,2,4,180,149,329,412
0130-001,2012,12,2,5,146,136,282,329
0130-001,2012,12,2,6,209,255,464,282
0130-001,2012,12,2,7,465,370,835,464
0130-001,2012,12,2,8,635,546,1181,835
0130-001,2012,12,2,9,829,893,1722,1181
0130-001,2012,12,2,10,916,1113,2029,1722
0130-001,2012,12,2,11,1040,1281,2321,2029
0130-001,2012,12,2,12,1312,1359,2671,2321
0130-001,2012,12,2,13,1478,1629,3107,2671
0130-001,2012,12,2,14,1725,1549,3274,3107
0130-001,2012,12,2,15,1765,1572,3337,3274
0130-001,2012,12,2,16,2076,1525,3601,3337
0130-001,2012,12,2,17,1968,1487,3455,3601
0130-001,2012,12,2,18,2013,1697,3710,3455
0130-001,2012,12,2,19,1987,1329,3316,3710
0130-001,2012,12,2,20,1689,1022,2711,3316
0130-001,2012,12,2,21,1515,923,2438,2711
0130-001,2012,12,2,22,1165,754,1919,2438
0130-001,2012,12,2,23,712,500,1212,1919
0130-001,2012,12,2,24,454,342,796,1212
0130-001,2012,12,3,1,246,241,487,796
0130-001,2012,12,3,2,173,161,334,487
0130-001,2012,12,3,3,116,95,211,334
0130-001,2012,12,3,4,105,122,227,211
0130-001,2012,12,3,5,139,175,314,227
0130-001,2012,12,3,6,333,332,665,314
0130-001,2012,12,3,7,1206,785,1991,665
0130-001,2012,12,3,8,2205,1672,3877,1991
0130-001,2012,12,3,9,2221,2033,4254,3877
0130-001,2012,12,3,10,1643,1664,3307,4254
0130-001,2012,12,3,11,1752,1676,3428,3307
0130-001,2012,12,3,12,1614,1601,3215,3428
0130-001,2012,12,3,13,1454,1477,2931,3215
0130-001,2012,12,3,14,1645,1666,3311,2931
0130-001,2012,12,3,15,1753,1810,3563,3311
0130-001,2012,12,3,16,1685,1823,3508,3563
0130-001,2012,12,3,17,1633,1816,3449,3508
0130-001,2012,12,3,18,1642,2100,3742,3449
0130-001,2012,12,3,19,1626,2099,3725,3742
0130-001,2012,12,3,20,1253,1593,2846,3725
0130-001,2012,12,3,21,1146,1510,2656,2846
0130-001,2012,12,3,22,999,1142,2141,2656
0130-001,2012,12,3,23,764,671,1435,2141
0130-001,2012,12,3,24,491,418,909,1435
0130-001,2012,12,4,1,300,255,555,909
0130-001,2012,12,4,2,181,176,357,555
0130-001,2012,12,4,3,151,143,294,357
0130-001,2012,12,4,4,118,137,255,294
0130-001,2012,12,4,5,121,164,285,255
0130-001,2012,12,4,6,228,300,528,285
0130-001,2012,12,4,7,834,638,1472,528
0130-001,2012,12,4,8,1898,1472,3370,1472
0130-001,2012,12,4,9,1573,1949,3522,3370
0130-001,2012,12,4,10,1594,1527,3121,3522
0130-001,2012,12,4,11,1848,1454,3302,3121
0130-001,2012,12,4,12,1750,1458,3208,3302
0130-001,2012,12,4,13,1437,1441,2878,3208
0130-001,2012,12,4,14,1695,1588,3283,2878
0130-001,2012,12,4,15,1804,1805,3609,3283
0130-001,2012,12,4,16,1828,1826,3654,3609
0130-001,2012,12,4,17,1749,1833,3582,3654
0130-001,2012,12,4,18,1715,2222,3937,3582
0130-001,2012,12,4,19,1683,2166,3849,3937
0130-001,2012,12,4,20,1324,1621,2945,3849
0130-001,2012,12,4,21,1110,1498,2608,2945
0130-001,2012,12,4,22,996,1207,2203,2608
0130-001,2012,12,4,23,813,800,1613,2203
0130-001,2012,12,4,24,500,456,956,1613
0130-001,2012,12,5,1,364,289,653,956
0130-001,2012,12,5,2,227,197,424,653
0130-001,2012,12,5,3,179,177,356,424
0130-001,2012,12,5,4,155,149,304,356
0130-001,2012,12,5,5,141,209,350,304
0130-001,2012,12,5,6,283,315,598,350
0130-001,2012,12,5,7,973,661,1634,598
0130-001,2012,12,5,8,2159,1530,3689,1634
0130-001,2012,12,5,9,2133,2007,4140,3689
0130-001,2012,12,5,10,1696,1706,3402,4140
0130-001,2012,12,5,11,1713,1668,3381,3402
0130-001,2012,12,5,12,1640,1618,3258,3381
0130-001,2012,12,5,13,1507,1494,3001,3258
0130-001,2012,12,5,14,1616,1568,3184,3001
0130-001,2012,12,5,15,1145,1107,2252,3184
0130-001,2012,12,5,16,1186,1214,2400,2252
0130-001,2012,12,5,17,1098,1472,2570,2400
0130-001,2012,12,5,18,1259,1604,2863,2570
0130-001,2012,12,5,19,1141,1620,2761,2863
0130-001,2012,12,5,20,792,1102,1894,2761
0130-001,2012,12,5,21,609,895,1504,1894
0130-001,2012,12,5,22,505,656,1161,1504
0130-001,2012,12,5,23,413,397,810,1161
0130-001,2012,12,5,24,268,232,500,810
0130-001,2012,12,6,1,191,188,379,500
0130-001,2012,12,6,2,125,141,266,379
0130-001,2012,12,6,3,81,78,159,266
0130-001,2012,12,6,4,96,97,193,159
0130-001,2012,12,6,5,105,133,238,193
0130-001,2012,12,6,6,186,239,425,238
0130-001,2012,12,6,7,721,439,1160,425
0130-001,2012,12,6,8,1604,1168,2772,1160
0130-001,2012,12,6,9,1393,1442,2835,2772
0130-001,2012,12,6,10,1184,1239,2423,2835
0130-001,2012,12,6,11,1226,1243,2469,2423
0130-001,2012,12,6,12,1310,1226,2536,2469
0130-001,2012,12,6,13,1127,1229,2356,2536
0130-001,2012,12,6,14,1491,1434,2925,2356
0130-001,2012,12,6,15,1491,1549,3040,2925
0130-001,2012,12,6,16,1578,1641,3219,3040
0130-001,2012,12,6,17,1513,1600,3113,3219
0130-001,2012,12,6,18,1243,1396,2639,3113
0130-001,2012,12,6,19,1199,1294,2493,2639
0130-001,2012,12,6,20,942,1458,2400,2493
0130-001,2012,12,6,21,834,1081,1915,2400
0130-001,2012,12,6,22,710,828,1538,1915
0130-001,2012,12,6,23,527,499,1026,1538
0130-001,2012,12,6,24,387,313,700,1026
0130-001,2012,12,7,1,269,276,545,700
0130-001,2012,12,7,2,169,166,335,545
0130-001,2012,12,7,3,121,129,250,335
0130-001,2012,12,7,4,119,117,236,250
0130-001,2012,12,7,5,123,165,288,236
0130-001,2012,12,7,6,224,274,498,288
0130-001,2012,12,7,7,859,540,1399,498
0130-001,2012,12,7,8,1835,1378,3213,1399
0130-001,2012,12,7,9,1782,1736,3518,3213
0130-001,2012,12,7,10,1374,1427,2801,3518
0130-001,2012,12,7,11,1216,1221,2437,2801
0130-001,2012,12,7,12,1058,951,2009,2437
0130-001,2012,12,7,13,953,1162,2115,2009
0130-001,2012,12,7,14,1182,1244,2426,2115
0130-001,2012,12,7,15,1341,1326,2667,2426
0130-001,2012,12,7,16,1381,1494,2875,2667
0130-001,2012,12,7,17,1423,1564,2987,2875
0130-001,2012,12,7,18,1536,1947,3483,2987
0130-001,2012,12,7,19,1423,1950,3373,3483
0130-001,2012,12,7,20,1070,1351,2421,3373
0130-001,2012,12,7,21,901,1168,2069,2421
0130-001,2012,12,7,22,806,878,1684,2069
0130-001,2012,12,7,23,609,517,1126,1684
0130-001,2012,12,7,24,454,412,866,1126
0130-001,2012,12,8,1,355,295,650,866
0130-001,2012,12,8,2,253,213,466,650
0130-001,2012,12,8,3,196,173,369,466
0130-001,2012,12,8,4,144,165,309,369
0130-001,2012,12,8,5,149,171,320,309
0130-001,2012,12,8,6,205,272,477,320
0130-001,2012,12,8,7,433,382,815,477
0130-001,2012,12,8,8,963,715,1678,815
0130-001,2012,12,8,9,1118,1217,2335,1678
0130-001,2012,12,8,10,1201,1291,2492,2335
0130-001,2012,12,8,11,1230,1505,2735,2492
0130-001,2012,12,8,12,1373,1690,3063,2735
0130-001,2012,12,8,13,1416,1769,3185,3063
0130-001,2012,12,8,14,1444,1676,3120,3185
0130-001,2012,12,8,15,1570,1648,3218,3120
0130-001,2012,12,8,16,1740,1610,3350,3218
0130-001,2012,12,8,17,1686,1681,3367,3350
0130-001,2012,12,8,18,1635,1888,3523,3367
0130-001,2012,12,8,19,1485,1493,2978,3523
0130-001,2012,12,8,20,1031,895,1926,2978
0130-001,2012,12,8,21,944,824,1768,1926
0130-001,2012,12,8,22,893,736,1629,1768
0130-001,2012,12,8,23,651,510,1161,1629
0130-001,2012,12,8,24,478,390,868,1161
0130-001,2012,12,9,1,357,303,660,868
0130-001,2012,12,9,2,278,245,523,660
0130-001,2012,12,9,3,217,187,404,523
0130-001,2012,12,9,4,138,133,271,404
0130-001,2012,12,9,5,152,113,265,271
0130-001,2012,12,9,6,173,198,371,265
0130-001,2012,12,9,7,307,258,565,371
0130-001,2012,12,9,8,459,432,891,565
0130-001,2012,12,9,9,668,664,1332,891
0130-001,2012,12,9,10,740,851,1591,1332
0130-001,2012,12,9,11,974,1112,2086,1591
0130-001,2012,12,9,12,919,1310,2229,2086
0130-001,2012,12,9,13,1086,1501,2587,2229
0130-001,2012,12,9,14,1432,1382,2814,2587
0130-001,2012,12,9,15,1570,1437,3007,2814
0130-001,2012,12,9,16,1546,1431,2977,3007
0130-001,2012,12,9,17,1581,1312,2893,2977
0130-001,2012,12,9,18,1438,1419,2857,2893
0130-001,2012,12,9,19,1530,1028,2558,2857
0130-001,2012,12,9,20,1023,848,1871,2558
0130-001,2012,12,9,21,905,765,1670,1871
0130-001,2012,12,9,22,740,552,1292,1670
0130-001,2012,12,9,23,492,384,876,1292
0130-001,2012,12,9,24,390,286,676,876
0130-001,2012,12,10,1,247,196,443,676
0130-001,2012,12,10,2,120,140,260,443
0130-001,2012,12,10,3,114,91,205,260
0130-001,2012,12,10,4,106,108,214,205
0130-001,2012,12,10,5,115,161,276,214
0130-001,2012,12,10,6,275,310,585,276
0130-001,2012,12,10,7,1029,625,1654,585
0130-001,2012,12,10,8,2045,1539,3584,1654
0130-001,2012,12,10,9,2222,1804,4026,3584
0130-001,2012,12,10,10,1591,1757,3348,4026
0130-001,2012,12,10,11,1660,1647,3307,3348
0130-001,2012,12,10,12,1578,1664,3242,3307
0130-001,2012,12,10,13,1542,1476,3018,3242
0130-001,2012,12,10,14,1785,1727,3512,3018
0130-001,2012,12,10,15,1832,1830,3662,3512
0130-001,2012,12,10,16,1818,1904,3722,3662
0130-001,2012,12,10,17,1726,1844,3570,3722
0130-001,2012,12,10,18,1684,2197,3881,3570
0130-001,2012,12,10,19,1704,2202,3906,3881
0130-001,2012,12,10,20,1311,1618,2929,3906
0130-001,2012,12,10,21,1124,1504,2628,2929
0130-001,2012,12,10,22,1022,1120,2142,2628
0130-001,2012,12,10,23,739,754,1493,2142
0130-001,2012,12,10,24,495,418,913,1493
0130-001,2012,12,11,1,325,303,628,913
0130-001,2012,12,11,2,226,186,412,628
0130-001,2012,12,11,3,159,163,322,412
0130-001,2012,12,11,4,158,164,322,322
0130-001,2012,12,11,5,135,181,316,322
0130-001,2012,12,11,6,240,280,520,316
0130-001,2012,12,11,7,931,617,1548,520
0130-001,2012,12,11,8,1955,1507,3462,1548
0130-001,2012,12,11,9,2136,1894,4030,3462
0130-001,2012,12,11,10,1803,1678,3481,4030
0130-001,2012,12,11,11,1669,1651,3320,3481
0130-001,2012,12,11,12,1624,1606,3230,3320
0130-001,2012,12,11,13,1437,1511,2948,3230
0130-001,2012,12,11,14,1812,1730,3542,2948
0130-001,2012,12,11,15,1826,1805,3631,3542
0130-001,2012,12,11,16,1863,1850,3713,3631
0130-001,2012,12,11,17,1696,1818,3514,3713
0130-001,2012,12,11,18,1679,2192,3871,3514
0130-001,2012,12,11,19,1587,2197,3784,3871
0130-001,2012,12,11,20,1296,1607,2903,3784
0130-001,2012,12,11,21,1118,1456,2574,2903
0130-001,2012,12,11,22,1030,1186,2216,2574
0130-001,2012,12,11,23,809,703,1512,2216
0130-001,2012,12,11,24,553,494,1047,1512
0130-001,2012,12,12,1,319,286,605,1047
0130-001,2012,12,12,2,264,223,487,605
0130-001,2012,12,12,3,162,165,327,487
0130-001,2012,12,12,4,127,145,272,327
0130-001,2012,12,12,5,154,193,347,272
0130-001,2012,12,12,6,234,301,535,347
0130-001,2012,12,12,7,964,640,1604,535
0130-001,2012,12,12,8,2048,1517,3565,1604
0130-001,2012,12,12,9,2212,1884,4096,3565
0130-001,2012,12,12,10,1690,1695,3385,4096
0130-001,2012,12,12,11,1625,1685,3310,3385
0130-001,2012,12,12,12,1666,1567,3233,3310
0130-001,2012,12,12,13,1451,1535,2986,3233
0130-001,2012,12,12,14,1717,1712,3429,2986
0130-001,2012,12,12,15,1710,1763,3473,3429
0130-001,2012,12,12,16,1865,1799,3664,3473
0130-001,2012,12,12,17,1696,1902,3598,3664
0130-001,2012,12,12,18,1691,2219,3910,3598
0130-001,2012,12,12,19,1689,2299,3988,3910
0130-001,2012,12,12,20,1358,1726,3084,3988
0130-001,2012,12,12,21,1150,1395,2545,3084
0130-001,2012,12,12,22,1111,1146,2257,2545
0130-001,2012,12,12,23,790,784,1574,2257
0130-001,2012,12,12,24,586,471,1057,1574
0130-001,2012,12,13,1,402,329,731,1057
0130-001,2012,12,13,2,264,244,508,731
0130-001,2012,12,13,3,170,196,366,508
0130-001,2012,12,13,4,151,159,310,366
0130-001,2012,12,13,5,131,196,327,310
0130-001,2012,12,13,6,263,294,557,327
0130-001,2012,12,13,7,937,627,1564,557
0130-001,2012,12,13,8,1972,1551,3523,1564
0130-001,2012,12,13,9,2200,1958,4158,3523
0130-001,2012,12,13,10,1760,1744,3504,4158
0130-001,2012,12,13,11,1730,1661,3391,3504
0130-001,2012,12,13,12,1609,1584,3193,3391
0130-001,2012,12,13,13,1407,1490,2897,3193
0130-001,2012,12,13,14,1710,1674,3384,2897
0130-001,2012,12,13,15,1791,1868,3659,3384
0130-001,2012,12,13,16,1834,1819,3653,3659
0130-001,2012,12,13,17,1724,1855,3579,3653
0130-001,2012,12,13,18,1805,2156,3961,3579
0130-001,2012,12,13,19,1590,2286,3876,3961
0130-001,2012,12,13,20,1266,1695,2961,3876
0130-001,2012,12,13,21,1212,1561,2773,2961
0130-001,2012,12,13,22,1143,1141,2284,2773
0130-001,2012,12,13,23,881,755,1636,2284
0130-001,2012,12,13,24,630,501,1131,1636
0130-001,2012,12,14,1,415,342,757,1131
0130-001,2012,12,14,2,256,254,510,757
0130-001,2012,12,14,3,192,172,364,510
0130-001,2012,12,14,4,149,166,315,364
0130-001,2012,12,14,5,154,211,365,315
0130-001,2012,12,14,6,301,337,638,365
0130-001,2012,12,14,7,809,545,1354,638
0130-001,2012,12,14,8,1786,1138,2924,1354
0130-001,2012,12,14,9,1939,1519,3458,2924
0130-001,2012,12,14,10,1681,1737,3418,3458
0130-001,2012,12,14,11,1429,1531,2960,3418
0130-001,2012,12,14,12,1385,1510,2895,2960
0130-001,2012,12,14,13,1250,1374,2624,2895
0130-001,2012,12,14,14,1508,1629,3137,2624
0130-001,2012,12,14,15,1644,1689,3333,3137
0130-001,2012,12,14,16,1721,1753,3474,3333
0130-001,2012,12,14,17,1736,1725,3461,3474
0130-001,2012,12,14,18,1621,2161,3782,3461
0130-001,2012,12,14,19,1705,2324,4029,3782
0130-001,2012,12,14,20,1316,1631,2947,4029
0130-001,2012,12,14,21,1048,1432,2480,2947
0130-001,2012,12,14,22,1068,1091,2159,2480
0130-001,2012,12,14,23,888,746,1634,2159
0130-001,2012,12,14,24,617,533,1150,1634
0130-001,2012,12,15,1,485,426,911,1150
0130-001,2012,12,15,2,373,305,678,911
0130-001,2012,12,15,3,269,216,485,678
0130-001,2012,12,15,4,189,185,374,485
0130-001,2012,12,15,5,193,208,401,374
0130-001,2012,12,15,6,274,316,590,401
0130-001,2012,12,15,7,609,449,1058,590
0130-001,2012,12,15,8,1141,821,1962,1058
0130-001,2012,12,15,9,1333,1346,2679,1962
0130-001,2012,12,15,10,1471,1570,3041,2679
0130-001,2012,12,15,11,1519,1841,3360,3041
0130-001,2012,12,15,12,1636,2041,3677,3360
0130-001,2012,12,15,13,1593,2295,3888,3677
0130-001,2012,12,15,14,1789,2176,3965,3888
0130-001,2012,12,15,15,1702,2155,3857,3965
0130-001,2012,12,15,16,1964,2048,4012,3857
0130-001,2012,12,15,17,1855,2074,3929,4012
0130-001,2012,12,15,18,1947,2336,4283,3929
0130-001,2012,12,15,19,1789,2084,3873,4283
0130-001,2012,12,15,20,1334,1286,2620,3873
0130-001,2012,12,15,21,1140,1038,2178,2620
0130-001,2012,12,15,22,1014,857,1871,2178
0130-001,2012,12,15,23,756,611,1367,1871
0130-001,2012,12,15,24,619,483,1102,1367
0130-001,2012,12,16,1,457,403,860,1102
0130-001,2012,12,16,2,301,268,569,860
0130-001,2012,12,16,3,261,223,484,569
0130-001,2012,12,16,4,201,158,359,484
0130-001,2012,12,16,5,176,159,335,359
0130-001,2012,12,16,6,191,229,420,335
0130-001,2012,12,16,7,408,294,702,420
0130-001,2012,12,16,8,554,485,1039,702
0130-001,2012,12,16,9,708,799,1507,1039
0130-001,2012,12,16,10,798,917,1715,1507
0130-001,2012,12,16,11,999,1229,2228,1715
0130-001,2012,12,16,12,1066,1483,2549,2228
0130-001,2012,12,16,13,1331,1445,2776,2549
0130-001,2012,12,16,14,1511,1531,3042,2776
0130-001,2012,12,16,15,1634,1531,3165,3042
0130-001,2012,12,16,16,1743,1554,3297,3165
0130-001,2012,12,16,17,1695,1461,3156,3297
0130-001,2012,12,16,18,1670,1522,3192,3156
0130-001,2012,12,16,19,1548,1301,2849,3192
0130-001,2012,12,16,20,1161,984,2145,2849
0130-001,2012,12,16,21,1004,846,1850,2145
0130-001,2012,12,16,22,824,659,1483,1850
0130-001,2012,12,16,23,641,489,1130,1483
0130-001,2012,12,16,24,410,336,746,1130
0130-001,2012,12,17,1,292,230,522,746
0130-001,2012,12,17,2,164,139,303,522
0130-001,2012,12,17,3,116,113,229,303
0130-001,2012,12,17,4,110,121,231,229
0130-001,2012,12,17,5,129,162,291,231
0130-001,2012,12,17,6,285,323,608,291
0130-001,2012,12,17,7,1073,658,1731,608
0130-001,2012,12,17,8,2108,1567,3675,1731
0130-001,2012,12,17,9,2127,1920,4047,3675
0130-001,2012,12,17,10,1660,1647,3307,4047
0130-001,2012,12,17,11,1658,1627,3285,3307
0130-001,2012,12,17,12,1560,1615,3175,3285
0130-001,2012,12,17,13,1366,1509,2875,3175
0130-001,2012,12,17,14,1756,1836,3592,2875
0130-001,2012,12,17,15,1906,1912,3818,3592
0130-001,2012,12,17,16,1855,1937,3792,3818
0130-001,2012,12,17,17,1691,1854,3545,3792
0130-001,2012,12,17,18,1770,2203,3973,3545
0130-001,2012,12,17,19,1653,2234,3887,3973
0130-001,2012,12,17,20,1251,1628,2879,3887
0130-001,2012,12,17,21,1105,1486,2591,2879
0130-001,2012,12,17,22,1043,1157,2200,2591
0130-001,2012,12,17,23,827,697,1524,2200
0130-001,2012,12,17,24,477,453,930,1524
0130-001,2012,12,18,1,385,301,686,930
0130-001,2012,12,18,2,247,243,490,686
0130-001,2012,12,18,3,178,167,345,490
0130-001,2012,12,18,4,126,180,306,345
0130-001,2012,12,18,5,181,191,372,306
0130-001,2012,12,18,6,272,324,596,372
0130-001,2012,12,18,7,982,641,1623,596
0130-001,2012,12,18,8,2054,1491,3545,1623
0130-001,2012,12,18,9,2052,1989,4041,3545
0130-001,2012,12,18,10,1777,1786,3563,4041
0130-001,2012,12,18,11,1732,1677,3409,3563
0130-001,2012,12,18,12,1679,1637,3316,3409
0130-001,2012,12,18,13,1394,1454,2848,3316
0130-001,2012,12,18,14,1834,1731,3565,2848
0130-001,2012,12,18,15,1857,1848,3705,3565
0130-001,2012,12,18,16,1844,1865,3709,3705
0130-001,2012,12,18,17,1752,1888,3640,3709
0130-001,2012,12,18,18,1747,2263,4010,3640
0130-001,2012,12,18,19,1597,2423,4020,4010
0130-001,2012,12,18,20,1386,1716,3102,4020
0130-001,2012,12,18,21,1249,1498,2747,3102
0130-001,2012,12,18,22,1190,1274,2464,2747
0130-001,2012,12,18,23,979,813,1792,2464
0130-001,2012,12,18,24,713,557,1270,1792
0130-001,2012,12,19,1,487,396,883,1270
0130-001,2012,12,19,2,390,346,736,883
0130-001,2012,12,19,3,283,215,498,736
0130-001,2012,12,19,4,205,211,416,498
0130-001,2012,12,19,5,224,261,485,416
0130-001,2012,12,19,6,247,263,510,485
0130-001,2012,12,19,7,644,470,1114,510
0130-001,2012,12,19,8,1150,811,1961,1114
0130-001,2012,12,19,9,1464,1274,2738,1961
0130-001,2012,12,19,10,1551,1419,2970,2738
0130-001,2012,12,19,11,1518,1574,3092,2970
0130-001,2012,12,19,12,1563,1753,3316,3092
0130-001,2012,12,19,13,1461,1635,3096,3316
0130-001,2012,12,19,14,1564,1770,3334,3096
0130-001,2012,12,19,15,1762,1836,3598,3334
0130-001,2012,12,19,16,1836,1855,3691,3598
0130-001,2012,12,19,17,1688,1830,3518,3691
0130-001,2012,12,19,18,1690,1924,3614,3518
0130-001,2012,12,19,19,1438,1639,3077,3614
0130-001,2012,12,19,20,1095,1115,2210,3077
0130-001,2012,12,19,21,1019,936,1955,2210
0130-001,2012,12,19,22,886,816,1702,1955
0130-001,2012,12,19,23,721,562,1283,1702
0130-001,2012,12,19,24,449,362,811,1283
0130-001,2012,12,20,1,335,263,598,811
0130-001,2012,12,20,2,204,186,390,598
0130-001,2012,12,20,3,146,144,290,390
0130-001,2012,12,20,4,126,138,264,290
0130-001,2012,12,20,5,135,178,313,264
0130-001,2012,12,20,6,260,325,585,313
0130-001,2012,12,20,7,1024,662,1686,585
0130-001,2012,12,20,8,2140,1520,3660,1686
0130-001,2012,12,20,9,2141,1990,4131,3660
0130-001,2012,12,20,10,1680,1733,3413,4131
0130-001,2012,12,20,11,1703,1646,3349,3413
0130-001,2012,12,20,12,1570,1622,3192,3349
0130-001,2012,12,20,13,1384,1567,2951,3192
0130-001,2012,12,20,14,1744,1670,3414,2951
0130-001,2012,12,20,15,1863,1848,3711,3414
0130-001,2012,12,20,16,1817,1844,3661,3711
0130-001,2012,12,20,17,1795,1869,3664,3661
0130-001,2012,12,20,18,1795,2210,4005,3664
0130-001,2012,12,20,19,1592,2407,3999,4005
0130-001,2012,12,20,20,1251,1549,2800,3999
0130-001,2012,12,20,21,1141,1472,2613,2800
0130-001,2012,12,20,22,1201,1168,2369,2613
0130-001,2012,12,20,23,847,794,1641,2369
0130-001,2012,12,20,24,646,506,1152,1641
0130-001,2012,12,21,1,445,398,843,1152
0130-001,2012,12,21,2,299,223,522,843
0130-001,2012,12,21,3,204,208,412,522
0130-001,2012,12,21,4,158,175,333,412
0130-001,2012,12,21,5,182,221,403,333
0130-001,2012,12,21,6,303,339,642,403
0130-001,2012,12,21,7,996,617,1613,642
0130-001,2012,12,21,8,2049,1525,3574,1613
0130-001,2012,12,21,9,2030,1942,3972,3574
0130-001,2012,12,21,10,1721,1640,3361,3972
0130-001,2012,12,21,11,1718,1740,3458,3361
0130-001,2012,12,21,12,1523,1509,3032,3458
0130-001,2012,12,21,13,1322,1385,2707,3032
0130-001,2012,12,21,14,1615,1573,3188,2707
0130-001,2012,12,21,15,1622,1665,3287,3188
0130-001,2012,12,21,16,1637,1494,3131,3287
0130-001,2012,12,21,17,1660,1826,3486,3131
0130-001,2012,12,21,18,1756,2239,3995,3486
0130-001,2012,12,21,19,1698,2296,3994,3995
0130-001,2012,12,21,20,1353,1780,3133,3994
0130-001,2012,12,21,21,1158,1444,2602,3133
0130-001,2012,12,21,22,1102,1162,2264,2602
0130-001,2012,12,21,23,953,781,1734,2264
0130-001,2012,12,21,24,677,529,1206,1734
0130-001,2012,12,22,1,475,469,944,1206
0130-001,2012,12,22,2,338,336,674,944
0130-001,2012,12,22,3,286,230,516,674
0130-001,2012,12,22,4,219,209,428,516
0130-001,2012,12,22,5,209,216,425,428
0130-001,2012,12,22,6,254,318,572,425
0130-001,2012,12,22,7,603,464,1067,572
0130-001,2012,12,22,8,1195,832,2027,1067
0130-001,2012,12,22,9,1360,1375,2735,2027
0130-001,2012,12,22,10,1460,1550,3010,2735
0130-001,2012,12,22,11,1527,1714,3241,3010
0130-001,2012,12,22,12,1584,1890,3474,3241
0130-001,2012,12,22,13,1573,2121,3694,3474
0130-001,2012,12,22,14,1719,2018,3737,3694
0130-001,2012,12,22,15,1764,2036,3800,3737
0130-001,2012,12,22,16,1777,2048,3825,3800
0130-001,2012,12,22,17,1773,2018,3791,3825
0130-001,2012,12,22,18,1934,2185,4119,3791
0130-001,2012,12,22,19,1648,1922,3570,4119
0130-001,2012,12,22,20,1217,1258,2475,3570
0130-001,2012,12,22,21,1007,946,1953,2475
0130-001,2012,12,22,22,937,821,1758,1953
0130-001,2012,12,22,23,749,627,1376,1758
0130-001,2012,12,22,24,536,417,953,1376
0130-001,2012,12,23,1,431,369,800,953
0130-001,2012,12,23,2,290,257,547,800
0130-001,2012,12,23,3,250,201,451,547
0130-001,2012,12,23,4,181,165,346,451
0130-001,2012,12,23,5,146,137,283,346
0130-001,2012,12,23,6,177,213,390,283
0130-001,2012,12,23,7,290,266,556,390
0130-001,2012,12,23,8,450,481,931,556
0130-001,2012,12,23,9,659,733,1392,931
0130-001,2012,12,23,10,758,874,1632,1392
0130-001,2012,12,23,11,832,1075,1907,1632
0130-001,2012,12,23,12,920,1252,2172,1907
0130-001,2012,12,23,13,1096,1270,2366,2172
0130-001,2012,12,23,14,1190,1245,2435,2366
0130-001,2012,12,23,15,1371,1465,2836,2435
0130-001,2012,12,23,16,1581,1396,2977,2836
0130-001,2012,12,23,17,1642,1429,3071,2977
0130-001,2012,12,23,18,1559,1289,2848,3071
0130-001,2012,12,23,19,1418,1064,2482,2848
0130-001,2012,12,23,20,1062,888,1950,2482
0130-001,2012,12,23,21,938,717,1655,1950
0130-001,2012,12,23,22,764,601,1365,1655
0130-001,2012,12,23,23,568,390,958,1365
0130-001,2012,12,23,24,415,314,729,958
0130-001,2012,12,24,1,229,186,415,729
0130-001,2012,12,24,2,161,150,311,415
0130-001,2012,12,24,3,127,92,219,311
0130-001,2012,12,24,4,113,119,232,219
0130-001,2012,12,24,5,124,166,290,232
0130-001,2012,12,24,6,245,288,533,290
0130-001,2012,12,24,7,881,549,1430,533
0130-001,2012,12,24,8,2147,1433,3580,1430
0130-001,2012,12,24,9,1671,1854,3525,3580
0130-001,2012,12,24,10,1620,1540,3160,3525
0130-001,2012,12,24,11,1645,1690,3335,3160
0130-001,2012,12,24,12,1645,1653,3298,3335
0130-001,2012,12,24,13,1484,1497,2981,3298
0130-001,2012,12,24,14,1761,1759,3520,2981
0130-001,2012,12,24,15,1944,1890,3834,3520
0130-001,2012,12,24,16,1948,1919,3867,3834
0130-001,2012,12,24,17,1831,1968,3799,3867
0130-001,2012,12,24,18,1889,2374,4263,3799
0130-001,2012,12,24,19,1831,2437,4268,4263
0130-001,2012,12,24,20,1476,1803,3279,4268
0130-001,2012,12,24,21,1193,1397,2590,3279
0130-001,2012,12,24,22,1046,1087,2133,2590
0130-001,2012,12,24,23,950,754,1704,2133
0130-001,2012,12,24,24,609,540,1149,1704
0130-001,2012,12,25,1,452,386,838,1149
0130-001,2012,12,25,2,309,258,567,838
0130-001,2012,12,25,3,225,183,408,567
0130-001,2012,12,25,4,201,189,390,408
0130-001,2012,12,25,5,183,198,381,390
0130-001,2012,12,25,6,249,231,480,381
0130-001,2012,12,25,7,438,329,767,480
0130-001,2012,12,25,8,700,458,1158,767
0130-001,2012,12,25,9,722,730,1452,1158
0130-001,2012,12,25,10,772,776,1548,1452
0130-001,2012,12,25,11,933,982,1915,1548
0130-001,2012,12,25,12,956,1148,2104,1915
0130-001,2012,12,25,13,1081,1313,2394,2104
0130-001,2012,12,25,14,1296,1468,2764,2394
0130-001,2012,12,25,15,1330,1501,2831,2764
0130-001,2012,12,25,16,1469,1454,2923,2831
0130-001,2012,12,25,17,1419,1342,2761,2923
0130-001,2012,12,25,18,1435,1486,2921,2761
0130-001,2012,12,25,19,1208,1141,2349,2921
0130-001,2012,12,25,20,1065,968,2033,2349
0130-001,2012,12,25,21,960,778,1738,2033
0130-001,2012,12,25,22,847,622,1469,1738
0130-001,2012,12,25,23,617,486,1103,1469
0130-001,2012,12,25,24,439,323,762,1103
0130-001,2012,12,26,1,289,210,499,762
0130-001,2012,12,26,2,182,180,362,499
0130-001,2012,12,26,3,127,125,252,362
0130-001,2012,12,26,4,125,129,254,252
0130-001,2012,12,26,5,117,163,280,254
0130-001,2012,12,26,6,223,292,515,280
0130-001,2012,12,26,7,988,580,1568,515
0130-001,2012,12,26,8,2123,1477,3600,1568
0130-001,2012,12,26,9,2135,1900,4035,3600
0130-001,2012,12,26,10,1594,1574,3168,4035
0130-001,2012,12,26,11,1651,1646,3297,3168
0130-001,2012,12,26,12,1664,1541,3205,3297
0130-001,2012,12,26,13,1551,1510,3061,3205
0130-001,2012,12,26,14,1704,1731,3435,3061
0130-001,2012,12,26,15,1793,1834,3627,3435
0130-001,2012,12,26,16,1806,1931,3737,3627
0130-001,2012,12,26,17,1751,1842,3593,3737
0130-001,2012,12,26,18,1780,2264,4044,3593
0130-001,2012,12,26,19,1665,2341,4006,4044
0130-001,2012,12,26,20,1222,1643,2865,4006
0130-001,2012,12,26,21,1204,1376,2580,2865
0130-001,2012,12,26,22,1143,1156,2299,2580
0130-001,2012,12,26,23,840,757,1597,2299
0130-001,2012,12,26,24,629,537,1166,1597
0130-001,2012,12,27,1,400,343,743,1166
0130-001,2012,12,27,2,292,245,537,743
0130-001,2012,12,27,3,190,179,369,537
0130-001,2012,12,27,4,147,171,318,369
0130-001,2012,12,27,5,172,208,380,318
0130-001,2012,12,27,6,262,305,567,380
0130-001,2012,12,27,7,888,580,1468,567
0130-001,2012,12,27,8,2100,1459,3559,1468
0130-001,2012,12,27,9,2113,1943,4056,3559
0130-001,2012,12,27,10,1669,1702,3371,4056
0130-001,2012,12,27,11,1820,1719,3539,3371
0130-001,2012,12,27,12,1622,1723,3345,3539
0130-001,2012,12,27,13,1459,1517,2976,3345
0130-001,2012,12,27,14,1785,1748,3533,2976
0130-001,2012,12,27,15,1865,1853,3718,3533
0130-001,2012,12,27,16,1833,1913,3746,3718
0130-001,2012,12,27,17,1771,1863,3634,3746
0130-001,2012,12,27,18,1685,2200,3885,3634
0130-001,2012,12,27,19,1573,2292,3865,3885
0130-001,2012,12,27,20,1285,1631,2916,3865
0130-001,2012,12,27,21,1159,1437,2596,2916
0130-001,2012,12,27,22,1165,1143,2308,2596
0130-001,2012,12,27,23,925,821,1746,2308
0130-001,2012,12,27,24,611,515,1126,1746
0130-001,2012,12,28,1,447,412,859,1126
0130-001,2012,12,28,2,299,278,577,859
0130-001,2012,12,28,3,200,184,384,577
0130-001,2012,12,28,4,158,160,318,384
0130-001,2012,12,28,5,165,201,366,318
0130-001,2012,12,28,6,283,313,596,366
0130-001,2012,12,28,7,919,564,1483,596
0130-001,2012,12,28,8,1983,1329,3312,1483
0130-001,2012,12,28,9,1960,1673,3633,3312
0130-001,2012,12,28,10,1420,1583,3003,3633
0130-001,2012,12,28,11,1550,1515,3065,3003
0130-001,2012,12,28,12,1433,1502,2935,3065
0130-001,2012,12,28,13,1312,1430,2742,2935
0130-001,2012,12,28,14,1493,1616,3109,2742
0130-001,2012,12,28,15,1641,1694,3335,3109
0130-001,2012,12,28,16,1655,1754,3409,3335
0130-001,2012,12,28,17,1645,1867,3512,3409
0130-001,2012,12,28,18,1663,2190,3853,3512
0130-001,2012,12,28,19,1664,2316,3980,3853
0130-001,2012,12,28,20,1265,1556,2821,3980
0130-001,2012,12,28,21,1114,1332,2446,2821
0130-001,2012,12,28,22,1064,1089,2153,2446
0130-001,2012,12,28,23,832,791,1623,2153
0130-001,2012,12,28,24,647,600,1247,1623
0130-001,2012,12,29,1,522,467,989,1247
0130-001,2012,12,29,2,436,314,750,989
0130-001,2012,12,29,3,250,252,502,750
0130-001,2012,12,29,4,223,203,426,502
0130-001,2012,12,29,5,211,227,438,426
0130-001,2012,12,29,6,261,318,579,438
0130-001,2012,12,29,7,579,428,1007,579
0130-001,2012,12,29,8,1090,816,1906,1007
0130-001,2012,12,29,9,1288,1318,2606,1906
0130-001,2012,12,29,10,1385,1455,2840,2606
0130-001,2012,12,29,11,1535,1588,3123,2840
0130-001,2012,12,29,12,1480,1754,3234,3123
0130-001,2012,12,29,13,1454,1813,3267,3234
0130-001,2012,12,29,14,1639,1828,3467,3267
0130-001,2012,12,29,15,1631,2025,3656,3467
0130-001,2012,12,29,16,1744,1979,3723,3656
0130-001,2012,12,29,17,1666,2063,3729,3723
0130-001,2012,12,29,18,1791,2085,3876,3729
0130-001,2012,12,29,19,1544,1682,3226,3876
0130-001,2012,12,29,20,1107,1147,2254,3226
0130-001,2012,12,29,21,843,838,1681,2254
0130-001,2012,12,29,22,874,661,1535,1681
0130-001,2012,12,29,23,560,523,1083,1535
0130-001,2012,12,29,24,450,358,808,1083
0130-001,2012,12,30,1,324,288,612,808
0130-001,2012,12,30,2,251,222,473,612
0130-001,2012,12,30,3,186,164,350,473
0130-001,2012,12,30,4,153,114,267,350
0130-001,2012,12,30,5,116,94,210,267
0130-001,2012,12,30,6,128,156,284,210
0130-001,2012,12,30,7,256,228,484,284
0130-001,2012,12,30,8,389,323,712,484
0130-001,2012,12,30,9,479,493,972,712
0130-001,2012,12,30,10,592,618,1210,972
0130-001,2012,12,30,11,725,912,1637,1210
0130-001,2012,12,30,12,767,974,1741,1637
0130-001,2012,12,30,13,855,1126,1981,1741
0130-001,2012,12,30,14,1062,1180,2242,1981
0130-001,2012,12,30,15,1159,1248,2407,2242
0130-001,2012,12,30,16,1515,1248,2763,2407
0130-001,2012,12,30,17,1361,1440,2801,2763
0130-001,2012,12,30,18,1337,1590,2927,2801
0130-001,2012,12,30,19,1239,1066,2305,2927
0130-001,2012,12,30,20,953,772,1725,2305
0130-001,2012,12,30,21,746,690,1436,1725
0130-001,2012,12,30,22,681,560,1241,1436
0130-001,2012,12,30,23,503,421,924,1241
0130-001,2012,12,30,24,350,281,631,924
0130-001,2012,12,31,1,248,237,485,631
0130-001,2012,12,31,2,177,153,330,485
0130-001,2012,12,31,3,140,102,242,330
0130-001,2012,12,31,4,124,110,234,242
0130-001,2012,12,31,5,110,165,275,234
0130-001,2012,12,31,6,217,252,469,275
0130-001,2012,12,31,7,674,471,1145,469
0130-001,2012,12,31,8,1612,1104,2716,1145
0130-001,2012,12,31,9,1590,1598,3188,2716
0130-001,2012,12,31,10,1358,1386,2744,3188
0130-001,2012,12,31,11,1534,1596,3130,2744
0130-001,2012,12,31,12,1538,1776,3314,3130
0130-001,2012,12,31,13,1494,1680,3174,3314
0130-001,2012,12,31,14,1676,1839,3515,3174
0130-001,2012,12,31,15,1762,2024,3786,3515
0130-001,2012,12,31,16,1925,1971,3896,3786
0130-001,2012,12,31,17,1903,1925,3828,3896
0130-001,2012,12,31,18,1826,2063,3889,3828
0130-001,2012,12,31,19,1630,1822,3452,3889
0130-001,2012,12,31,20,1356,1380,2736,3452
0130-001,2012,12,31,21,1065,1009,2074,2736
0130-001,2012,12,31,22,905,908,1813,2074
0130-001,2012,12,31,23,766,735,1501,1813
0130-001,2012,12,31,24,549,514,1063,1501
0130-001,2013,1,1,1,446,384,830,1063
0130-001,2013,1,1,2,424,361,785,830
0130-001,2013,1,1,3,307,213,520,785
0130-001,2013,1,1,4,196,189,385,520
0130-001,2013,1,1,5,157,151,308,385
0130-001,2013,1,1,6,191,229,420,308
0130-001,2013,1,1,7,310,273,583,420
0130-001,2013,1,1,8,333,303,636,583
0130-001,2013,1,1,9,348,448,796,636
0130-001,2013,1,1,10,430,464,894,796
0130-001,2013,1,1,11,695,692,1387,894
0130-001,2013,1,1,12,841,902,1743,1387
0130-001,2013,1,1,13,1016,1116,2132,1743
0130-001,2013,1,1,14,1058,1195,2253,2132
0130-001,2013,1,1,15,1104,1203,2307,2253
0130-001,2013,1,1,16,1175,1134,2309,2307
0130-001,2013,1,1,17,1218,1121,2339,2309
0130-001,2013,1,1,18,1149,1023,2172,2339
0130-001,2013,1,1,19,999,841,1840,2172
0130-001,2013,1,1,20,766,730,1496,1840
0130-001,2013,1,1,21,703,640,1343,1496
0130-001,2013,1,1,22,569,512,1081,1343
0130-001,2013,1,1,23,472,336,808,1081
0130-001,2013,1,1,24,279,207,486,808
0130-001,2013,1,2,1,230,156,386,486
0130-001,2013,1,2,2,153,121,274,386
0130-001,2013,1,2,3,103,90,193,274
0130-001,2013,1,2,4,98,67,165,193
0130-001,2013,1,2,5,95,94,189,165
0130-001,2013,1,2,6,190,248,438,189
0130-001,2013,1,2,7,706,433,1139,438
0130-001,2013,1,2,8,1308,816,2124,1139
0130-001,2013,1,2,9,1183,1083,2266,2124
0130-001,2013,1,2,10,1355,1060,2415,2266
0130-001,2013,1,2,11,1284,1195,2479,2415
0130-001,2013,1,2,12,1203,1226,2429,2479
0130-001,2013,1,2,13,1194,1209,2403,2429
0130-001,2013,1,2,14,1343,1445,2788,2403
0130-001,2013,1,2,15,1546,1605,3151,2788
0130-001,2013,1,2,16,1479,1559,3038,3151
0130-001,2013,1,2,17,1423,1549,2972,3038
0130-001,2013,1,2,18,1496,1834,3330,2972
0130-001,2013,1,2,19,1511,1931,3442,3330
0130-001,2013,1,2,20,1168,1529,2697,3442
0130-001,2013,1,2,21,943,1089,2032,2697
0130-001,2013,1,2,22,874,895,1769,2032
0130-001,2013,1,2,23,637,562,1199,1769
0130-001,2013,1,2,24,451,351,802,1199
0130-001,2013,1,3,1,315,251,566,802
0130-001,2013,1,3,2,208,161,369,566
0130-001,2013,1,3,3,137,131,268,369
0130-001,2013,1,3,4,113,134,247,268
0130-001,2013,1,3,5,136,170,306,247
0130-001,2013,1,3,6,216,258,474,306
0130-001,2013,1,3,7,853,559,1412,474
0130-001,2013,1,3,8,1907,1300,3207,1412
0130-001,2013,1,3,9,1954,1738,3692,3207
0130-001,2013,1,3,10,1420,1402,2822,3692
0130-001,2013,1,3,11,1519,1549,3068,2822
0130-001,2013,1,3,12,1451,1448,2899,3068
0130-001,2013,1,3,13,1375,1373,2748,2899
0130-001,2013,1,3,14,1512,1529,3041,2748
0130-001,2013,1,3,15,1697,1537,3234,3041
0130-001,2013,1,3,16,1603,1483,3086,3234
0130-001,2013,1,3,17,1629,1745,3374,3086
0130-001,2013,1,3,18,1582,1974,3556,3374
0130-001,2013,1,3,19,1543,2059,3602,3556
0130-001,2013,1,3,20,1261,1505,2766,3602
0130-001,2013,1,3,21,973,1328,2301,2766
0130-001,2013,1,3,22,923,1047,1970,2301
0130-001,2013,1,3,23,698,662,1360,1970
0130-001,2013,1,3,24,489,402,891,1360
0130-001,2013,1,4,1,354,296,650,891
0130-001,2013,1,4,2,221,176,397,650
0130-001,2013,1,4,3,171,167,338,397
0130-001,2013,1,4,4,143,144,287,338
0130-001,2013,1,4,5,136,177,313,287
0130-001,2013,1,4,6,237,275,512,313
0130-001,2013,1,4,7,877,557,1434,512
0130-001,2013,1,4,8,2003,1318,3321,1434
0130-001,2013,1,4,9,2003,1756,3759,3321
0130-001,2013,1,4,10,1537,1485,3022,3759
0130-001,2013,1,4,11,1560,1655,3215,3022
0130-001,2013,1,4,12,1524,1691,3215,3215
0130-001,2013,1,4,13,1398,1527,2925,3215
0130-001,2013,1,4,14,1622,1710,3332,2925
0130-001,2013,1,4,15,1842,1756,3598,3332
0130-001,2013,1,4,16,1816,1826,3642,3598
0130-001,2013,1,4,17,1698,1760,3458,3642
0130-001,2013,1,4,18,1767,2154,3921,3458
0130-001,2013,1,4,19,1709,2251,3960,3921
0130-001,2013,1,4,20,1415,1907,3322,3960
0130-001,2013,1,4,21,1201,1457,2658,3322
0130-001,2013,1,4,22,1069,1171,2240,2658
0130-001,2013,1,4,23,829,786,1615,2240
0130-001,2013,1,4,24,590,514,1104,1615
0130-001,2013,1,5,1,416,389,805,1104
0130-001,2013,1,5,2,300,257,557,805
0130-001,2013,1,5,3,225,189,414,557
0130-001,2013,1,5,4,178,185,363,414
0130-001,2013,1,5,5,179,240,419,363
0130-001,2013,1,5,6,271,298,569,419
0130-001,2013,1,5,7,584,455,1039,569
0130-001,2013,1,5,8,1159,755,1914,1039
0130-001,2013,1,5,9,1350,1254,2604,1914
0130-001,2013,1,5,10,1365,1494,2859,2604
0130-001,2013,1,5,11,1420,1568,2988,2859
0130-001,2013,1,5,12,1517,1639,3156,2988
0130-001,2013,1,5,13,1553,1733,3286,3156
0130-001,2013,1,5,14,1569,1881,3450,3286
0130-001,2013,1,5,15,1624,1926,3550,3450
0130-001,2013,1,5,16,1621,1891,3512,3550
0130-001,2013,1,5,17,1686,1798,3484,3512
0130-001,2013,1,5,18,1777,2114,3891,3484
0130-001,2013,1,5,19,1565,1751,3316,3891
0130-001,2013,1,5,20,1189,1113,2302,3316
0130-001,2013,1,5,21,1014,905,1919,2302
0130-001,2013,1,5,22,865,791,1656,1919
0130-001,2013,1,5,23,710,571,1281,1656
0130-001,2013,1,5,24,424,423,847,1281
0130-001,2013,1,6,1,359,294,653,847
0130-001,2013,1,6,2,285,232,517,653
0130-001,2013,1,6,3,201,179,380,517
0130-001,2013,1,6,4,177,141,318,380
0130-001,2013,1,6,5,171,137,308,318
0130-001,2013,1,6,6,182,243,425,308
0130-001,2013,1,6,7,341,279,620,425
0130-001,2013,1,6,8,447,398,845,620
0130-001,2013,1,6,9,684,705,1389,845
0130-001,2013,1,6,10,736,873,1609,1389
0130-001,2013,1,6,11,945,1114,2059,1609
0130-001,2013,1,6,12,974,1152,2126,2059
0130-001,2013,1,6,13,1112,1307,2419,2126
0130-001,2013,1,6,14,1266,1544,2810,2419
0130-001,2013,1,6,15,1358,1452,2810,2810
0130-001,2013,1,6,16,1493,1425,2918,2810
0130-001,2013,1,6,17,1570,1426,2996,2918
0130-001,2013,1,6,18,1556,1356,2912,2996
0130-001,2013,1,6,19,1437,1042,2479,2912
0130-001,2013,1,6,20,1075,862,1937,2479
0130-001,2013,1,6,21,894,739,1633,1937
0130-001,2013,1,6,22,815,642,1457,1633
0130-001,2013,1,6,23,541,390,931,1457
0130-001,2013,1,6,24,363,307,670,931
0130-001,2013,1,7,1,263,222,485,670
0130-001,2013,1,7,2,143,141,284,485
0130-001,2013,1,7,3,129,96,225,284
0130-001,2013,1,7,4,86,123,209,225
0130-001,2013,1,7,5,118,179,297,209
0130-001,2013,1,7,6,291,332,623,297
0130-001,2013,1,7,7,1079,650,1729,623
0130-001,2013,1,7,8,2124,1484,3608,1729
0130-001,2013,1,7,9,1962,1767,3729,3608
0130-001,2013,1,7,10,1527,1623,3150,3729
0130-001,2013,1,7,11,1721,1680,3401,3150
0130-001,2013,1,7,12,1592,1601,3193,3401
0130-001,2013,1,7,13,1512,1529,3041,3193
0130-001,2013,1,7,14,1682,1731,3413,3041
0130-001,2013,1,7,15,1789,1844,3633,3413
0130-001,2013,1,7,16,1812,1797,3609,3633
0130-001,2013,1,7,17,1663,1712,3375,3609
0130-001,2013,1,7,18,1675,2099,3774,3375
0130-001,2013,1,7,19,1648,2163,3811,3774
0130-001,2013,1,7,20,1231,1486,2717,3811
0130-001,2013,1,7,21,1075,1427,2502,2717
0130-001,2013,1,7,22,894,1158,2052,2502
0130-001,2013,1,7,23,673,609,1282,2052
0130-001,2013,1,7,24,491,405,896,1282
0130-001,2013,1,8,1,290,266,556,896
0130-001,2013,1,8,2,197,170,367,556
0130-001,2013,1,8,3,166,145,311,367
0130-001,2013,1,8,4,123,133,256,311
0130-001,2013,1,8,5,142,201,343,256
0130-001,2013,1,8,6,246,302,548,343
0130-001,2013,1,8,7,1005,599,1604,548
0130-001,2013,1,8,8,2010,1409,3419,1604
0130-001,2013,1,8,9,1994,1866,3860,3419
0130-001,2013,1,8,10,1425,1564,2989,3860
0130-001,2013,1,8,11,1561,1449,3010,2989
0130-001,2013,1,8,12,1550,1492,3042,3010
0130-001,2013,1,8,13,1460,1508,2968,3042
0130-001,2013,1,8,14,1578,1634,3212,2968
0130-001,2013,1,8,15,1755,1789,3544,3212
0130-001,2013,1,8,16,1743,1712,3455,3544
0130-001,2013,1,8,17,1537,1809,3346,3455
0130-001,2013,1,8,18,1716,2083,3799,3346
0130-001,2013,1,8,19,1594,2146,3740,3799
0130-001,2013,1,8,20,1275,1556,2831,3740
0130-001,2013,1,8,21,1118,1443,2561,2831
0130-001,2013,1,8,22,1037,1176,2213,2561
0130-001,2013,1,8,23,716,617,1333,2213
0130-001,2013,1,8,24,483,423,906,1333
0130-001,2013,1,9,1,320,296,616,906
0130-001,2013,1,9,2,213,190,403,616
0130-001,2013,1,9,3,175,164,339,403
0130-001,2013,1,9,4,132,146,278,339
0130-001,2013,1,9,5,151,193,344,278
0130-001,2013,1,9,6,265,301,566,344
0130-001,2013,1,9,7,836,582,1418,566
0130-001,2013,1,9,8,2011,1376,3387,1418
0130-001,2013,1,9,9,1998,1864,3862,3387
0130-001,2013,1,9,10,1623,1559,3182,3862
0130-001,2013,1,9,11,1630,1574,3204,3182
0130-001,2013,1,9,12,1588,1505,3093,3204
0130-001,2013,1,9,13,1412,1402,2814,3093
0130-001,2013,1,9,14,1694,1675,3369,2814
0130-001,2013,1,9,15,1781,1655,3436,3369
0130-001,2013,1,9,16,1682,1779,3461,3436
0130-001,2013,1,9,17,1602,1735,3337,3461
0130-001,2013,1,9,18,1678,2152,3830,3337
0130-001,2013,1,9,19,1669,2294,3963,3830
0130-001,2013,1,9,20,1253,1613,2866,3963
0130-001,2013,1,9,21,1137,1355,2492,2866
0130-001,2013,1,9,22,1053,1053,2106,2492
0130-001,2013,1,9,23,758,695,1453,2106
0130-001,2013,1,9,24,514,472,986,1453
0130-001,2013,1,10,1,338,318,656,986
0130-001,2013,1,10,2,224,212,436,656
0130-001,2013,1,10,3,176,173,349,436
0130-001,2013,1,10,4,136,145,281,349
0130-001,2013,1,10,5,155,196,351,281
0130-001,2013,1,10,6,264,308,572,351
0130-001,2013,1,10,7,883,511,1394,572
0130-001,2013,1,10,8,2007,1387,3394,1394
0130-001,2013,1,10,9,2080,1847,3927,3394
0130-001,2013,1,10,10,1618,1529,3147,3927
0130-001,2013,1,10,11,1685,1625,3310,3147
0130-001,2013,1,10,12,1547,1556,3103,3310
0130-001,2013,1,10,13,1426,1438,2864,3103
0130-001,2013,1,10,14,1612,1623,3235,2864
0130-001,2013,1,10,15,1714,1709,3423,3235
0130-001,2013,1,10,16,1674,1721,3395,3423
0130-001,2013,1,10,17,1588,1752,3340,3395
0130-001,2013,1,10,18,1680,2129,3809,3340
0130-001,2013,1,10,19,1583,2171,3754,3809
0130-001,2013,1,10,20,1307,1559,2866,3754
0130-001,2013,1,10,21,1140,1368,2508,2866
0130-001,2013,1,10,22,1054,1208,2262,2508
0130-001,2013,1,10,23,761,710,1471,2262
0130-001,2013,1,10,24,538,490,1028,1471
0130-001,2013,1,11,1,338,323,661,1028
0130-001,2013,1,11,2,224,208,432,661
0130-001,2013,1,11,3,166,154,320,432
0130-001,2013,1,11,4,122,152,274,320
0130-001,2013,1,11,5,135,216,351,274
0130-001,2013,1,11,6,279,315,594,351
0130-001,2013,1,11,7,940,574,1514,594
0130-001,2013,1,11,8,2060,1361,3421,1514
0130-001,2013,1,11,9,2015,1851,3866,3421
0130-001,2013,1,11,10,1677,1629,3306,3866
0130-001,2013,1,11,11,1694,1696,3390,3306
0130-001,2013,1,11,12,1624,1572,3196,3390
0130-001,2013,1,11,13,1443,1619,3062,3196
0130-001,2013,1,11,14,1625,1742,3367,3062
0130-001,2013,1,11,15,1787,1783,3570,3367
0130-001,2013,1,11,16,1793,1800,3593,3570
0130-001,2013,1,11,17,1671,1852,3523,3593
0130-001,2013,1,11,18,1883,2188,4071,3523
0130-001,2013,1,11,19,1806,2367,4173,4071
0130-001,2013,1,11,20,1367,1858,3225,4173
0130-001,2013,1,11,21,1182,1471,2653,3225
0130-001,2013,1,11,22,1075,1254,2329,2653
0130-001,2013,1,11,23,888,724,1612,2329
0130-001,2013,1,11,24,610,523,1133,1612
0130-001,2013,1,12,1,461,404,865,1133
0130-001,2013,1,12,2,325,268,593,865
0130-001,2013,1,12,3,254,227,481,593
0130-001,2013,1,12,4,212,211,423,481
0130-001,2013,1,12,5,177,252,429,423
0130-001,2013,1,12,6,298,327,625,429
0130-001,2013,1,12,7,626,471,1097,625
0130-001,2013,1,12,8,1176,845,2021,1097
0130-001,2013,1,12,9,1363,1400,2763,2021
0130-001,2013,1,12,10,1398,1538,2936,2763
0130-001,2013,1,12,11,1510,1606,3116,2936
0130-001,2013,1,12,12,1501,1775,3276,3116
0130-001,2013,1,12,13,1408,1726,3134,3276
0130-001,2013,1,12,14,1582,1959,3541,3134
0130-001,2013,1,12,15,1608,1927,3535,3541
0130-001,2013,1,12,16,1718,1911,3629,3535
0130-001,2013,1,12,17,1854,1815,3669,3629
0130-001,2013,1,12,18,1869,2072,3941,3669
0130-001,2013,1,12,19,1686,1913,3599,3941
0130-001,2013,1,12,20,1223,1280,2503,3599
0130-001,2013,1,12,21,1035,903,1938,2503
0130-001,2013,1,12,22,991,820,1811,1938
0130-001,2013,1,12,23,705,592,1297,1811
0130-001,2013,1,12,24,519,429,948,1297
0130-001,2013,1,13,1,372,312,684,948
0130-001,2013,1,13,2,255,219,474,684
0130-001,2013,1,13,3,227,188,415,474
0130-001,2013,1,13,4,184,155,339,415
0130-001,2013,1,13,5,146,141,287,339
0130-001,2013,1,13,6,177,230,407,287
0130-001,2013,1,13,7,318,304,622,407
0130-001,2013,1,13,8,520,466,986,622
0130-001,2013,1,13,9,671,779,1450,986
0130-001,2013,1,13,10,781,966,1747,1450
0130-001,2013,1,13,11,952,1346,2298,1747
0130-001,2013,1,13,12,1009,1274,2283,2298
0130-001,2013,1,13,13,1268,1327,2595,2283
0130-001,2013,1,13,14,1293,1442,2735,2595
0130-001,2013,1,13,15,1393,1452,2845,2735
0130-001,2013,1,13,16,1530,1432,2962,2845
0130-001,2013,1,13,17,1690,1363,3053,2962
0130-001,2013,1,13,18,1627,1334,2961,3053
0130-001,2013,1,13,19,1556,1172,2728,2961
0130-001,2013,1,13,20,1176,913,2089,2728
0130-001,2013,1,13,21,992,741,1733,2089
0130-001,2013,1,13,22,787,643,1430,1733
0130-001,2013,1,13,23,570,446,1016,1430
0130-001,2013,1,13,24,399,309,708,1016
0130-001,2013,1,14,1,253,202,455,708
0130-001,2013,1,14,2,163,142,305,455
0130-001,2013,1,14,3,108,110,218,305
0130-001,2013,1,14,4,115,109,224,218
0130-001,2013,1,14,5,140,182,322,224
0130-001,2013,1,14,6,282,314,596,322
0130-001,2013,1,14,7,1100,646,1746,596
0130-001,2013,1,14,8,2049,1467,3516,1746
0130-001,2013,1,14,9,2086,1882,3968,3516
0130-001,2013,1,14,10,1562,1615,3177,3968
0130-001,2013,1,14,11,1618,1624,3242,3177
0130-001,2013,1,14,12,1599,1622,3221,3242
0130-001,2013,1,14,13,1403,1482,2885,3221
0130-001,2013,1,14,14,1657,1634,3291,2885
0130-001,2013,1,14,15,1801,1808,3609,3291
0130-001,2013,1,14,16,1797,1721,3518,3609
0130-001,2013,1,14,17,1545,1767,3312,3518
0130-001,2013,1,14,18,1677,2066,3743,3312
0130-001,2013,1,14,19,1720,2209,3929,3743
0130-001,2013,1,14,20,1242,1619,2861,3929
0130-001,2013,1,14,21,1138,1447,2585,2861
0130-001,2013,1,14,22,965,1184,2149,2585
0130-001,2013,1,14,23,743,675,1418,2149
0130-001,2013,1,14,24,473,423,896,1418
0130-001,2013,1,15,1,325,302,627,896
0130-001,2013,1,15,2,202,181,383,627
0130-001,2013,1,15,3,178,158,336,383
0130-001,2013,1,15,4,125,139,264,336
0130-001,2013,1,15,5,148,195,343,264
0130-001,2013,1,15,6,256,286,542,343
0130-001,2013,1,15,7,950,604,1554,542
0130-001,2013,1,15,8,2056,1366,3422,1554
0130-001,2013,1,15,9,1795,1908,3703,3422
0130-001,2013,1,15,10,1731,1599,3330,3703
0130-001,2013,1,15,11,1610,1645,3255,3330
0130-001,2013,1,15,12,1489,1522,3011,3255
0130-001,2013,1,15,13,1419,1469,2888,3011
0130-001,2013,1,15,14,1667,1715,3382,2888
0130-001,2013,1,15,15,1739,1765,3504,3382
0130-001,2013,1,15,16,1704,1787,3491,3504
0130-001,2013,1,15,17,1622,1728,3350,3491
0130-001,2013,1,15,18,1705,2123,3828,3350
0130-001,2013,1,15,19,1681,2309,3990,3828
0130-001,2013,1,15,20,1291,1584,2875,3990
0130-001,2013,1,15,21,1152,1493,2645,2875
0130-001,2013,1,15,22,1062,1149,2211,2645
0130-001,2013,1,15,23,757,665,1422,2211
0130-001,2013,1,15,24,494,466,960,1422
0130-001,2013,1,16,1,358,312,670,960
0130-001,2013,1,16,2,228,206,434,670
0130-001,2013,1,16,3,183,135,318,434
0130-001,2013,1,16,4,142,136,278,318
0130-001,2013,1,16,5,155,213,368,278
0130-001,2013,1,16,6,287,284,571,368
0130-001,2013,1,16,7,915,570,1485,571
0130-001,2013,1,16,8,2120,1378,3498,1485
0130-001,2013,1,16,9,2086,1940,4026,3498
0130-001,2013,1,16,10,1657,1666,3323,4026
0130-001,2013,1,16,11,1745,1598,3343,3323
0130-001,2013,1,16,12,1514,1546,3060,3343
0130-001,2013,1,16,13,1347,1357,2704,3060
0130-001,2013,1,16,14,1583,1634,3217,2704
0130-001,2013,1,16,15,1607,1716,3323,3217
0130-001,2013,1,16,16,1703,1683,3386,3323
0130-001,2013,1,16,17,1566,1718,3284,3386
0130-001,2013,1,16,18,1562,2011,3573,3284
0130-001,2013,1,16,19,1593,2252,3845,3573
0130-001,2013,1,16,20,1271,1561,2832,3845
0130-001,2013,1,16,21,1074,1350,2424,2832
0130-001,2013,1,16,22,1026,1060,2086,2424
0130-001,2013,1,16,23,747,637,1384,2086
0130-001,2013,1,16,24,503,489,992,1384
0130-001,2013,1,17,1,353,286,639,992
0130-001,2013,1,17,2,216,221,437,639
0130-001,2013,1,17,3,148,137,285,437
0130-001,2013,1,17,4,144,128,272,285
0130-001,2013,1,17,5,140,193,333,272
0130-001,2013,1,17,6,231,281,512,333
0130-001,2013,1,17,7,889,530,1419,512
0130-001,2013,1,17,8,2121,1359,3480,1419
0130-001,2013,1,17,9,1908,1869,3777,3480
0130-001,2013,1,17,10,1547,1535,3082,3777
0130-001,2013,1,17,11,1640,1482,3122,3082
0130-001,2013,1,17,12,1510,1548,3058,3122
0130-001,2013,1,17,13,1363,1434,2797,3058
0130-001,2013,1,17,14,1594,1594,3188,2797
0130-001,2013,1,17,15,1650,1700,3350,3188
0130-001,2013,1,17,16,1621,1731,3352,3350
0130-001,2013,1,17,17,1615,1730,3345,3352
0130-001,2013,1,17,18,1645,1988,3633,3345
0130-001,2013,1,17,19,1614,2149,3763,3633
0130-001,2013,1,17,20,1163,1581,2744,3763
0130-001,2013,1,17,21,1084,1415,2499,2744
0130-001,2013,1,17,22,1010,1079,2089,2499
0130-001,2013,1,17,23,808,702,1510,2089
0130-001,2013,1,17,24,531,471,1002,1510
0130-001,2013,1,18,1,419,331,750,1002
0130-001,2013,1,18,2,248,199,447,750
0130-001,2013,1,18,3,154,181,335,447
0130-001,2013,1,18,4,151,146,297,335
0130-001,2013,1,18,5,142,193,335,297
0130-001,2013,1,18,6,253,307,560,335
0130-001,2013,1,18,7,881,564,1445,560
0130-001,2013,1,18,8,2049,1329,3378,1445
0130-001,2013,1,18,9,1941,1867,3808,3378
0130-001,2013,1,18,10,1619,1601,3220,3808
0130-001,2013,1,18,11,1659,1701,3360,3220
0130-001,2013,1,18,12,1556,1592,3148,3360
0130-001,2013,1,18,13,1467,1465,2932,3148
0130-001,2013,1,18,14,1646,1707,3353,2932
0130-001,2013,1,18,15,1728,1752,3480,3353
0130-001,2013,1,18,16,1777,1746,3523,3480
0130-001,2013,1,18,17,1653,1851,3504,3523
0130-001,2013,1,18,18,1819,2195,4014,3504
0130-001,2013,1,18,19,1888,2451,4339,4014
0130-001,2013,1,18,20,1408,1846,3254,4339
0130-001,2013,1,18,21,1206,1480,2686,3254
0130-001,2013,1,18,22,1071,1240,2311,2686
0130-001,2013,1,18,23,892,728,1620,2311
0130-001,2013,1,18,24,626,508,1134,1620
0130-001,2013,1,19,1,462,411,873,1134
0130-001,2013,1,19,2,363,298,661,873
0130-001,2013,1,19,3,261,223,484,661
0130-001,2013,1,19,4,175,198,373,484
0130-001,2013,1,19,5,175,209,384,373
0130-001,2013,1,19,6,273,294,567,384
0130-001,2013,1,19,7,588,499,1087,567
0130-001,2013,1,19,8,1194,845,2039,1087
0130-001,2013,1,19,9,1370,1418,2788,2039
0130-001,2013,1,19,10,1389,1553,2942,2788
0130-001,2013,1,19,11,1513,1716,3229,2942
0130-001,2013,1,19,12,1582,1854,3436,3229
0130-001,2013,1,19,13,1562,1939,3501,3436
0130-001,2013,1,19,14,1579,1999,3578,3501
0130-001,2013,1,19,15,1665,1832,3497,3578
0130-001,2013,1,19,16,1697,1909,3606,3497
0130-001,2013,1,19,17,1767,1871,3638,3606
0130-001,2013,1,19,18,1876,2060,3936,3638
0130-001,2013,1,19,19,1750,1845,3595,3936
0130-001,2013,1,19,20,1299,1150,2449,3595
0130-001,2013,1,19,21,989,981,1970,2449
0130-001,2013,1,19,22,976,867,1843,1970
0130-001,2013,1,19,23,719,630,1349,1843
0130-001,2013,1,19,24,504,438,942,1349
0130-001,2013,1,20,1,378,331,709,942
0130-001,2013,1,20,2,287,252,539,709
0130-001,2013,1,20,3,224,189,413,539
0130-001,2013,1,20,4,169,135,304,413
0130-001,2013,1,20,5,169,152,321,304
0130-001,2013,1,20,6,190,212,402,321
0130-001,2013,1,20,7,376,351,727,402
0130-001,2013,1,20,8,520,457,977,727
0130-001,2013,1,20,9,670,761,1431,977
0130-001,2013,1,20,10,795,943,1738,1431
0130-001,2013,1,20,11,961,1146,2107,1738
0130-001,2013,1,20,12,965,1247,2212,2107
0130-001,2013,1,20,13,1229,1384,2613,2212
0130-001,2013,1,20,14,1380,1437,2817,2613
0130-001,2013,1,20,15,1384,1474,2858,2817
0130-001,2013,1,20,16,1582,1482,3064,2858
0130-001,2013,1,20,17,1571,1446,3017,3064
0130-001,2013,1,20,18,1678,1395,3073,3017
0130-001,2013,1,20,19,1505,1201,2706,3073
0130-001,2013,1,20,20,1124,949,2073,2706
0130-001,2013,1,20,21,939,757,1696,2073
0130-001,2013,1,20,22,892,699,1591,1696
0130-001,2013,1,20,23,664,482,1146,1591
0130-001,2013,1,20,24,456,377,833,1146
0130-001,2013,1,21,1,247,245,492,833
0130-001,2013,1,21,2,159,137,296,492
0130-001,2013,1,21,3,132,110,242,296
0130-001,2013,1,21,4,102,115,217,242
0130-001,2013,1,21,5,129,181,310,217
0130-001,2013,1,21,6,246,311,557,310
0130-001,2013,1,21,7,964,583,1547,557
0130-001,2013,1,21,8,2060,1404,3464,1547
0130-001,2013,1,21,9,1868,1753,3621,3464
0130-001,2013,1,21,10,1447,1598,3045,3621
0130-001,2013,1,21,11,1497,1453,2950,3045
0130-001,2013,1,21,12,1487,1436,2923,2950
0130-001,2013,1,21,13,1346,1358,2704,2923
0130-001,2013,1,21,14,1505,1576,3081,2704
0130-001,2013,1,21,15,1611,1597,3208,3081
0130-001,2013,1,21,16,1645,1568,3213,3208
0130-001,2013,1,21,17,1445,1567,3012,3213
0130-001,2013,1,21,18,1508,1960,3468,3012
0130-001,2013,1,21,19,1617,2176,3793,3468
0130-001,2013,1,21,20,1115,1421,2536,3793
0130-001,2013,1,21,21,1015,1368,2383,2536
0130-001,2013,1,21,22,887,1089,1976,2383
0130-001,2013,1,21,23,691,637,1328,1976
0130-001,2013,1,21,24,465,384,849,1328
0130-001,2013,1,22,1,309,273,582,849
0130-001,2013,1,22,2,224,189,413,582
0130-001,2013,1,22,3,164,157,321,413
0130-001,2013,1,22,4,114,131,245,321
0130-001,2013,1,22,5,152,166,318,245
0130-001,2013,1,22,6,243,292,535,318
0130-001,2013,1,22,7,851,547,1398,535
0130-001,2013,1,22,8,1998,1293,3291,1398
0130-001,2013,1,22,9,1891,1811,3702,3291
0130-001,2013,1,22,10,1605,1613,3218,3702
0130-001,2013,1,22,11,1586,1506,3092,3218
0130-001,2013,1,22,12,1556,1471,3027,3092
0130-001,2013,1,22,13,1305,1449,2754,3027
0130-001,2013,1,22,14,1641,1753,3394,2754
0130-001,2013,1,22,15,1659,1688,3347,3394
0130-001,2013,1,22,16,1591,1594,3185,3347
0130-001,2013,1,22,17,1489,1720,3209,3185
0130-001,2013,1,22,18,1611,1937,3548,3209
0130-001,2013,1,22,19,1622,2220,3842,3548
0130-001,2013,1,22,20,1226,1547,2773,3842
0130-001,2013,1,22,21,1064,1480,2544,2773
0130-001,2013,1,22,22,988,1128,2116,2544
0130-001,2013,1,22,23,708,720,1428,2116
0130-001,2013,1,22,24,525,419,944,1428
0130-001,2013,1,23,1,361,301,662,944
0130-001,2013,1,23,2,224,204,428,662
0130-001,2013,1,23,3,178,177,355,428
0130-001,2013,1,23,4,160,165,325,355
0130-001,2013,1,23,5,139,187,326,325
0130-001,2013,1,23,6,257,300,557,326
0130-001,2013,1,23,7,887,617,1504,557
0130-001,2013,1,23,8,2011,1268,3279,1504
0130-001,2013,1,23,9,1966,1771,3737,3279
0130-001,2013,1,23,10,1602,1679,3281,3737
0130-001,2013,1,23,11,1693,1524,3217,3281
0130-001,2013,1,23,12,1600,1587,3187,3217
0130-001,2013,1,23,13,1399,1416,2815,3187
0130-001,2013,1,23,14,1630,1613,3243,2815
0130-001,2013,1,23,15,1673,1708,3381,3243
0130-001,2013,1,23,16,1645,1678,3323,3381
0130-001,2013,1,23,17,1544,1708,3252,3323
0130-001,2013,1,23,18,1647,2067,3714,3252
0130-001,2013,1,23,19,1636,2276,3912,3714
0130-001,2013,1,23,20,1186,1524,2710,3912
0130-001,2013,1,23,21,1107,1489,2596,2710
0130-001,2013,1,23,22,1007,1091,2098,2596
0130-001,2013,1,23,23,739,668,1407,2098
0130-001,2013,1,23,24,564,467,1031,1407
0130-001,2013,1,24,1,362,311,673,1031
0130-001,2013,1,24,2,220,186,406,673
0130-001,2013,1,24,3,172,171,343,406
0130-001,2013,1,24,4,146,143,289,343
0130-001,2013,1,24,5,156,204,360,289
0130-001,2013,1,24,6,246,294,540,360
0130-001,2013,1,24,7,888,599,1487,540
0130-001,2013,1,24,8,2079,1366,3445,1487
0130-001,2013,1,24,9,1940,1783,3723,3445
0130-001,2013,1,24,10,1612,1590,3202,3723
0130-001,2013,1,24,11,1683,1498,3181,3202
0130-001,2013,1,24,12,1523,1560,3083,3181
0130-001,2013,1,24,13,1315,1357,2672,3083
0130-001,2013,1,24,14,1499,1619,3118,2672
0130-001,2013,1,24,15,1628,1637,3265,3118
0130-001,2013,1,24,16,1719,1657,3376,3265
0130-001,2013,1,24,17,1519,1695,3214,3376
0130-001,2013,1,24,18,1661,2000,3661,3214
0130-001,2013,1,24,19,1705,2178,3883,3661
0130-001,2013,1,24,20,1228,1563,2791,3883
0130-001,2013,1,24,21,1129,1568,2697,2791
0130-001,2013,1,24,22,1025,1244,2269,2697
0130-001,2013,1,24,23,802,696,1498,2269
0130-001,2013,1,24,24,535,465,1000,1498
0130-001,2013,1,25,1,384,327,711,1000
0130-001,2013,1,25,2,221,210,431,711
0130-001,2013,1,25,3,155,175,330,431
0130-001,2013,1,25,4,142,134,276,330
0130-001,2013,1,25,5,165,186,351,276
0130-001,2013,1,25,6,248,303,551,351
0130-001,2013,1,25,7,846,531,1377,551
0130-001,2013,1,25,8,2141,1329,3470,1377
0130-001,2013,1,25,9,1886,1791,3677,3470
0130-001,2013,1,25,10,1539,1646,3185,3677
0130-001,2013,1,25,11,1700,1532,3232,3185
0130-001,2013,1,25,12,1491,1589,3080,3232
0130-001,2013,1,25,13,1406,1483,2889,3080
0130-001,2013,1,25,14,1658,1718,3376,2889
0130-001,2013,1,25,15,1696,1789,3485,3376
0130-001,2013,1,25,16,1768,1733,3501,3485
0130-001,2013,1,25,17,1608,1779,3387,3501
0130-001,2013,1,25,18,1805,2255,4060,3387
0130-001,2013,1,25,19,1934,2453,4387,4060
0130-001,2013,1,25,20,1428,1925,3353,4387
0130-001,2013,1,25,21,1263,1450,2713,3353
0130-001,2013,1,25,22,1136,1164,2300,2713
0130-001,2013,1,25,23,904,774,1678,2300
0130-001,2013,1,25,24,604,534,1138,1678
0130-001,2013,1,26,1,440,380,820,1138
0130-001,2013,1,26,2,359,309,668,820
0130-001,2013,1,26,3,237,225,462,668
0130-001,2013,1,26,4,206,187,393,462
0130-001,2013,1,26,5,206,223,429,393
0130-001,2013,1,26,6,278,338,616,429
0130-001,2013,1,26,7,614,473,1087,616
0130-001,2013,1,26,8,1121,773,1894,1087
0130-001,2013,1,26,9,1304,1407,2711,1894
0130-001,2013,1,26,10,1405,1495,2900,2711
0130-001,2013,1,26,11,1479,1662,3141,2900
0130-001,2013,1,26,12,1552,1822,3374,3141
0130-001,2013,1,26,13,1514,2025,3539,3374
0130-001,2013,1,26,14,1647,1943,3590,3539
0130-001,2013,1,26,15,1677,1895,3572,3590
0130-001,2013,1,26,16,1676,1830,3506,3572
0130-001,2013,1,26,17,1695,1706,3401,3506
0130-001,2013,1,26,18,1773,2060,3833,3401
0130-001,2013,1,26,19,1647,1858,3505,3833
0130-001,2013,1,26,20,1292,1194,2486,3505
0130-001,2013,1,26,21,1068,999,2067,2486
0130-001,2013,1,26,22,1015,805,1820,2067
0130-001,2013,1,26,23,732,625,1357,1820
0130-001,2013,1,26,24,517,443,960,1357
0130-001,2013,1,27,1,405,343,748,960
0130-001,2013,1,27,2,281,234,515,748
0130-001,2013,1,27,3,216,189,405,515
0130-001,2013,1,27,4,170,163,333,405
0130-001,2013,1,27,5,172,163,335,333
0130-001,2013,1,27,6,181,212,393,335
0130-001,2013,1,27,7,373,289,662,393
0130-001,2013,1,27,8,465,449,914,662
0130-001,2013,1,27,9,725,785,1510,914
0130-001,2013,1,27,10,741,911,1652,1510
0130-001,2013,1,27,11,1039,1278,2317,1652
0130-001,2013,1,27,12,986,1176,2162,2317
0130-001,2013,1,27,13,1114,1398,2512,2162
0130-001,2013,1,27,14,1221,1354,2575,2512
0130-001,2013,1,27,15,1419,1363,2782,2575
0130-001,2013,1,27,16,1478,1399,2877,2782
0130-001,2013,1,27,17,1504,1288,2792,2877
0130-001,2013,1,27,18,1552,1421,2973,2792
0130-001,2013,1,27,19,1416,1034,2450,2973
0130-001,2013,1,27,20,1037,886,1923,2450
0130-001,2013,1,27,21,896,746,1642,1923
0130-001,2013,1,27,22,821,660,1481,1642
0130-001,2013,1,27,23,592,463,1055,1481
0130-001,2013,1,27,24,421,312,733,1055
0130-001,2013,1,28,1,265,253,518,733
0130-001,2013,1,28,2,163,141,304,518
0130-001,2013,1,28,3,110,93,203,304
0130-001,2013,1,28,4,88,117,205,203
0130-001,2013,1,28,5,132,180,312,205
0130-001,2013,1,28,6,271,297,568,312
0130-001,2013,1,28,7,1017,597,1614,568
0130-001,2013,1,28,8,2145,1379,3524,1614
0130-001,2013,1,28,9,1914,1838,3752,3524
0130-001,2013,1,28,10,1601,1621,3222,3752
0130-001,2013,1,28,11,1611,1550,3161,3222
0130-001,2013,1,28,12,1549,1513,3062,3161
0130-001,2013,1,28,13,1364,1418,2782,3062
0130-001,2013,1,28,14,1646,1691,3337,2782
0130-001,2013,1,28,15,1757,1757,3514,3337
0130-001,2013,1,28,16,1763,1733,3496,3514
0130-001,2013,1,28,17,1588,1754,3342,3496
0130-001,2013,1,28,18,1662,2022,3684,3342
0130-001,2013,1,28,19,1683,2209,3892,3684
0130-001,2013,1,28,20,1162,1544,2706,3892
0130-001,2013,1,28,21,1070,1487,2557,2706
0130-001,2013,1,28,22,954,1133,2087,2557
0130-001,2013,1,28,23,701,647,1348,2087
0130-001,2013,1,28,24,467,437,904,1348
0130-001,2013,1,29,1,321,266,587,904
0130-001,2013,1,29,2,199,205,404,587
0130-001,2013,1,29,3,155,157,312,404
0130-001,2013,1,29,4,105,162,267,312
0130-001,2013,1,29,5,164,216,380,267
0130-001,2013,1,29,6,285,302,587,380
0130-001,2013,1,29,7,908,595,1503,587
0130-001,2013,1,29,8,2186,1328,3514,1503
0130-001,2013,1,29,9,1932,1888,3820,3514
0130-001,2013,1,29,10,1675,1590,3265,3820
0130-001,2013,1,29,11,1701,1667,3368,3265
0130-001,2013,1,29,12,1625,1541,3166,3368
0130-001,2013,1,29,13,1360,1491,2851,3166
0130-001,2013,1,29,14,1655,1679,3334,2851
0130-001,2013,1,29,15,1713,1776,3489,3334
0130-001,2013,1,29,16,1733,1682,3415,3489
0130-001,2013,1,29,17,1522,1769,3291,3415
0130-001,2013,1,29,18,1661,2112,3773,3291
0130-001,2013,1,29,19,1661,2222,3883,3773
0130-001,2013,1,29,20,1245,1545,2790,3883
0130-001,2013,1,29,21,1154,1519,2673,2790
0130-001,2013,1,29,22,1062,1155,2217,2673
0130-001,2013,1,29,23,779,671,1450,2217
0130-001,2013,1,29,24,523,457,980,1450
0130-001,2013,1,30,1,377,303,680,980
0130-001,2013,1,30,2,214,213,427,680
0130-001,2013,1,30,3,164,171,335,427
0130-001,2013,1,30,4,146,158,304,335
0130-001,2013,1,30,5,165,205,370,304
0130-001,2013,1,30,6,257,296,553,370
0130-001,2013,1,30,7,880,577,1457,553
0130-001,2013,1,30,8,2064,1339,3403,1457
0130-001,2013,1,30,9,2022,1889,3911,3403
0130-001,2013,1,30,10,1693,1646,3339,3911
0130-001,2013,1,30,11,1675,1650,3325,3339
0130-001,2013,1,30,12,1688,1603,3291,3325
0130-001,2013,1,30,13,1453,1456,2909,3291
0130-001,2013,1,30,14,1696,1704,3400,2909
0130-001,2013,1,30,15,1725,1738,3463,3400
0130-001,2013,1,30,16,1736,1719,3455,3463
0130-001,2013,1,30,17,1657,1732,3389,3455
0130-001,2013,1,30,18,1717,2202,3919,3389
0130-001,2013,1,30,19,1750,2353,4103,3919
0130-001,2013,1,30,20,1295,1675,2970,4103
0130-001,2013,1,30,21,1130,1411,2541,2970
0130-001,2013,1,30,22,1097,1119,2216,2541
0130-001,2013,1,30,23,744,681,1425,2216
0130-001,2013,1,30,24,570,509,1079,1425
0130-001,2013,1,31,1,408,357,765,1079
0130-001,2013,1,31,2,243,209,452,765
0130-001,2013,1,31,3,204,190,394,452
0130-001,2013,1,31,4,147,174,321,394
0130-001,2013,1,31,5,164,203,367,321
0130-001,2013,1,31,6,276,311,587,367
0130-001,2013,1,31,7,896,620,1516,587
0130-001,2013,1,31,8,2151,1352,3503,1516
0130-001,2013,1,31,9,1990,1907,3897,3503
0130-001,2013,1,31,10,1719,1665,3384,3897
0130-001,2013,1,31,11,1576,1571,3147,3384
0130-001,2013,1,31,12,1569,1582,3151,3147
0130-001,2013,1,31,13,1356,1446,2802,3151
0130-001,2013,1,31,14,1661,1664,3325,2802
0130-001,2013,1,31,15,1761,1798,3559,3325
0130-001,2013,1,31,16,1751,1541,3292,3559
0130-001,2013,1,31,17,1624,1779,3403,3292
0130-001,2013,1,31,18,1695,2183,3878,3403
0130-001,2013,1,31,19,1698,2207,3905,3878
0130-001,2013,1,31,20,1288,1673,2961,3905
0130-001,2013,1,31,21,1191,1549,2740,2961
0130-001,2013,1,31,22,1060,1163,2223,2740
0130-001,2013,1,31,23,863,765,1628,2223
0130-001,2013,1,31,24,565,519,1084,1628
0130-001,2013,2,1,1,406,382,788,1084
0130-001,2013,2,1,2,259,228,487,788
0130-001,2013,2,1,3,179,157,336,487
0130-001,2013,2,1,4,147,151,298,336
0130-001,2013,2,1,5,159,198,357,298
0130-001,2013,2,1,6,262,307,569,357
0130-001,2013,2,1,7,852,524,1376,569
0130-001,2013,2,1,8,2000,1313,3313,1376
0130-001,2013,2,1,9,2094,1914,4008,3313
0130-001,2013,2,1,10,1574,1600,3174,4008
0130-001,2013,2,1,11,1547,1562,3109,3174
0130-001,2013,2,1,12,1511,1554,3065,3109
0130-001,2013,2,1,13,1334,1407,2741,3065
0130-001,2013,2,1,14,1487,1564,3051,2741
0130-001,2013,2,1,15,1626,1667,3293,3051
0130-001,2013,2,1,16,1696,1701,3397,3293
0130-001,2013,2,1,17,1586,1723,3309,3397
0130-001,2013,2,1,18,1763,2126,3889,3309
0130-001,2013,2,1,19,1794,2376,4170,3889
0130-001,2013,2,1,20,1413,1795,3208,4170
0130-001,2013,2,1,21,1186,1464,2650,3208
0130-001,2013,2,1,22,1051,1131,2182,2650
0130-001,2013,2,1,23,891,761,1652,2182
0130-001,2013,2,1,24,615,536,1151,1652
0130-001,2013,2,2,1,419,382,801,1151
0130-001,2013,2,2,2,345,273,618,801
0130-001,2013,2,2,3,255,202,457,618
0130-001,2013,2,2,4,203,204,407,457
0130-001,2013,2,2,5,200,240,440,407
0130-001,2013,2,2,6,256,350,606,440
0130-001,2013,2,2,7,641,462,1103,606
0130-001,2013,2,2,8,1179,894,2073,1103
0130-001,2013,2,2,9,1479,1475,2954,2073
0130-001,2013,2,2,10,1577,1675,3252,2954
0130-001,2013,2,2,11,1609,1777,3386,3252
0130-001,2013,2,2,12,1690,1820,3510,3386
0130-001,2013,2,2,13,1633,1883,3516,3510
0130-001,2013,2,2,14,1746,2007,3753,3516
0130-001,2013,2,2,15,1727,2050,3777,3753
0130-001,2013,2,2,16,1770,1920,3690,3777
0130-001,2013,2,2,17,1997,1787,3784,3690
0130-001,2013,2,2,18,1953,2080,4033,3784
0130-001,2013,2,2,19,1857,1902,3759,4033
0130-001,2013,2,2,20,1401,1289,2690,3759
0130-001,2013,2,2,21,1060,1047,2107,2690
0130-001,2013,2,2,22,1044,944,1988,2107
0130-001,2013,2,2,23,783,616,1399,1988
0130-001,2013,2,2,24,527,518,1045,1399
0130-001,2013,2,3,1,400,331,731,1045
0130-001,2013,2,3,2,290,253,543,731
0130-001,2013,2,3,3,254,224,478,543
0130-001,2013,2,3,4,194,166,360,478
0130-001,2013,2,3,5,162,144,306,360
0130-001,2013,2,3,6,203,214,417,306
0130-001,2013,2,3,7,418,313,731,417
0130-001,2013,2,3,8,526,495,1021,731
0130-001,2013,2,3,9,755,831,1586,1021
0130-001,2013,2,3,10,834,943,1777,1586
0130-001,2013,2,3,11,995,1206,2201,1777
0130-001,2013,2,3,12,1009,1174,2183,2201
0130-001,2013,2,3,13,1120,1374,2494,2183
0130-001,2013,2,3,14,1342,1471,2813,2494
0130-001,2013,2,3,15,1511,1518,3029,2813
0130-001,2013,2,3,16,1496,1489,2985,3029
0130-001,2013,2,3,17,1595,1468,3063,2985
0130-001,2013,2,3,18,1468,1426,2894,3063
0130-001,2013,2,3,19,1422,1178,2600,2894
0130-001,2013,2,3,20,1076,947,2023,2600
0130-001,2013,2,3,21,870,772,1642,2023
0130-001,2013,2,3,22,830,666,1496,1642
0130-001,2013,2,3,23,585,442,1027,1496
0130-001,2013,2,3,24,346,295,641,1027
0130-001,2013,2,4,1,256,198,454,641
0130-001,2013,2,4,2,161,106,267,454
0130-001,2013,2,4,3,97,93,190,267
0130-001,2013,2,4,4,85,102,187,190
0130-001,2013,2,4,5,113,125,238,187
0130-001,2013,2,4,6,240,287,527,238
0130-001,2013,2,4,7,861,545,1406,527
0130-001,2013,2,4,8,1629,1160,2789,1406
0130-001,2013,2,4,9,1809,1503,3312,2789
0130-001,2013,2,4,10,1405,1489,2894,3312
0130-001,2013,2,4,11,1458,1412,2870,2894
0130-001,2013,2,4,12,1442,1410,2852,2870
0130-001,2013,2,4,13,1290,1269,2559,2852
0130-001,2013,2,4,14,1558,1617,3175,2559
0130-001,2013,2,4,15,1658,1687,3345,3175
0130-001,2013,2,4,16,1741,1765,3506,3345
0130-001,2013,2,4,17,1687,1637,3324,3506
0130-001,2013,2,4,18,1656,2027,3683,3324
0130-001,2013,2,4,19,1604,2115,3719,3683
0130-001,2013,2,4,20,1257,1569,2826,3719
0130-001,2013,2,4,21,1071,1494,2565,2826
0130-001,2013,2,4,22,950,1137,2087,2565
0130-001,2013,2,4,23,697,774,1471,2087
0130-001,2013,2,4,24,496,458,954,1471
0130-001,2013,2,5,1,323,284,607,954
0130-001,2013,2,5,2,196,190,386,607
0130-001,2013,2,5,3,163,163,326,386
0130-001,2013,2,5,4,133,139,272,326
0130-001,2013,2,5,5,163,204,367,272
0130-001,2013,2,5,6,266,324,590,367
0130-001,2013,2,5,7,934,585,1519,590
0130-001,2013,2,5,8,2098,1445,3543,1519
0130-001,2013,2,5,9,2120,1896,4016,3543
0130-001,2013,2,5,10,1692,1660,3352,4016
0130-001,2013,2,5,11,1747,1692,3439,3352
0130-001,2013,2,5,12,1698,1691,3389,3439
0130-001,2013,2,5,13,1474,1474,2948,3389
0130-001,2013,2,5,14,1683,1687,3370,2948
0130-001,2013,2,5,15,1815,1900,3715,3370
0130-001,2013,2,5,16,1893,1880,3773,3715
0130-001,2013,2,5,17,1707,1747,3454,3773
0130-001,2013,2,5,18,1645,2073,3718,3454
0130-001,2013,2,5,19,1660,2175,3835,3718
0130-001,2013,2,5,20,1189,1631,2820,3835
0130-001,2013,2,5,21,1138,1417,2555,2820
0130-001,2013,2,5,22,1002,1132,2134,2555
0130-001,2013,2,5,23,780,716,1496,2134
0130-001,2013,2,5,24,505,435,940,1496
0130-001,2013,2,6,1,306,283,589,940
0130-001,2013,2,6,2,244,215,459,589
0130-001,2013,2,6,3,163,141,304,459
0130-001,2013,2,6,4,145,150,295,304
0130-001,2013,2,6,5,136,192,328,295
0130-001,2013,2,6,6,234,286,520,328
0130-001,2013,2,6,7,879,521,1400,520
0130-001,2013,2,6,8,1928,1319,3247,1400
0130-001,2013,2,6,9,1958,1682,3640,3247
0130-001,2013,2,6,10,1522,1602,3124,3640
0130-001,2013,2,6,11,1519,1613,3132,3124
0130-001,2013,2,6,12,1594,1590,3184,3132
0130-001,2013,2,6,13,1476,1405,2881,3184
0130-001,2013,2,6,14,1658,1736,3394,2881
0130-001,2013,2,6,15,1692,1749,3441,3394
0130-001,2013,2,6,16,1869,1885,3754,3441
0130-001,2013,2,6,17,1744,1839,3583,3754
0130-001,2013,2,6,18,1731,2195,3926,3583
0130-001,2013,2,6,19,1589,2296,3885,3926
0130-001,2013,2,6,20,1423,1817,3240,3885
0130-001,2013,2,6,21,1200,1448,2648,3240
0130-001,2013,2,6,22,1176,1126,2302,2648
0130-001,2013,2,6,23,861,787,1648,2302
0130-001,2013,2,6,24,641,484,1125,1648
0130-001,2013,2,7,1,385,374,759,1125
0130-001,2013,2,7,2,258,210,468,759
0130-001,2013,2,7,3,194,155,349,468
0130-001,2013,2,7,4,116,153,269,349
0130-001,2013,2,7,5,155,233,388,269
0130-001,2013,2,7,6,239,282,521,388
0130-001,2013,2,7,7,867,523,1390,521
0130-001,2013,2,7,8,1943,1313,3256,1390
0130-001,2013,2,7,9,2051,1815,3866,3256
0130-001,2013,2,7,10,1871,1778,3649,3866
0130-001,2013,2,7,11,1792,1969,3761,3649
0130-001,2013,2,7,12,1769,1727,3496,3761
0130-001,2013,2,7,13,1689,1810,3499,3496
0130-001,2013,2,7,14,1864,1921,3785,3499
0130-001,2013,2,7,15,1971,2009,3980,3785
0130-001,2013,2,7,16,1954,1861,3815,3980
0130-001,2013,2,7,17,1842,1933,3775,3815
0130-001,2013,2,7,18,1805,2249,4054,3775
0130-001,2013,2,7,19,1792,2311,4103,4054
0130-001,2013,2,7,20,1492,1945,3437,4103
0130-001,2013,2,7,21,1266,1719,2985,3437
0130-001,2013,2,7,22,1137,1204,2341,2985
0130-001,2013,2,7,23,958,837,1795,2341
0130-001,2013,2,7,24,622,516,1138,1795
0130-001,2013,2,8,1,399,376,775,1138
0130-001,2013,2,8,2,226,218,444,775
0130-001,2013,2,8,3,155,173,328,444
0130-001,2013,2,8,4,131,147,278,328
0130-001,2013,2,8,5,134,192,326,278
0130-001,2013,2,8,6,248,297,545,326
0130-001,2013,2,8,7,822,509,1331,545
0130-001,2013,2,8,8,2198,1328,3526,1331
0130-001,2013,2,8,9,1978,1868,3846,3526
0130-001,2013,2,8,10,1537,1600,3137,3846
0130-001,2013,2,8,11,1664,1781,3445,3137
0130-001,2013,2,8,12,1730,1937,3667,3445
0130-001,2013,2,8,13,1663,1972,3635,3667
0130-001,2013,2,8,14,1736,2191,3927,3635
0130-001,2013,2,8,15,1841,2464,4305,3927
0130-001,2013,2,8,16,1831,2223,4054,4305
0130-001,2013,2,8,17,1800,2409,4209,4054
0130-001,2013,2,8,18,1735,2576,4311,4209
0130-001,2013,2,8,19,1614,2491,4105,4311
0130-001,2013,2,8,20,1285,2501,3786,4105
0130-001,2013,2,8,21,1141,2391,3532,3786
0130-001,2013,2,8,22,959,2359,3318,3532
0130-001,2013,2,8,23,815,1776,2591,3318
0130-001,2013,2,8,24,552,1033,1585,2591
0130-001,2013,2,9,1,424,728,1152,1585
0130-001,2013,2,9,2,271,511,782,1152
0130-001,2013,2,9,3,244,418,662,782
0130-001,2013,2,9,4,201,331,532,662
0130-001,2013,2,9,5,160,585,745,532
0130-001,2013,2,9,6,202,1036,1238,745
0130-001,2013,2,9,7,368,1258,1626,1238
0130-001,2013,2,9,8,490,1370,1860,1626
0130-001,2013,2,9,9,727,1874,2601,1860
0130-001,2013,2,9,10,1041,2008,3049,2601
0130-001,2013,2,9,11,1379,2025,3404,3049
0130-001,2013,2,9,12,1529,1782,3311,3404
0130-001,2013,2,9,13,1347,1522,2869,3311
0130-001,2013,2,9,14,1311,1462,2773,2869
0130-001,2013,2,9,15,1220,1345,2565,2773
0130-001,2013,2,9,16,1266,1128,2394,2565
0130-001,2013,2,9,17,1216,1094,2310,2394
0130-001,2013,2,9,18,1140,1004,2144,2310
0130-001,2013,2,9,19,981,869,1850,2144
0130-001,2013,2,9,20,787,823,1610,1850
0130-001,2013,2,9,21,659,694,1353,1610
0130-001,2013,2,9,22,585,611,1196,1353
0130-001,2013,2,9,23,482,418,900,1196
0130-001,2013,2,9,24,347,278,625,900
0130-001,2013,2,10,1,242,203,445,625
0130-001,2013,2,10,2,142,130,272,445
0130-001,2013,2,10,3,96,91,187,272
0130-001,2013,2,10,4,97,90,187,187
0130-001,2013,2,10,5,97,88,185,187
0130-001,2013,2,10,6,121,191,312,185
0130-001,2013,2,10,7,378,290,668,312
0130-001,2013,2,10,8,828,592,1420,668
0130-001,2013,2,10,9,842,747,1589,1420
0130-001,2013,2,10,10,667,698,1365,1589
0130-001,2013,2,10,11,1229,1163,2392,1365
0130-001,2013,2,10,12,1785,1508,3293,2392
0130-001,2013,2,10,13,2017,1646,3663,3293
0130-001,2013,2,10,14,2287,1888,4175,3663
0130-001,2013,2,10,15,2121,1911,4032,4175
0130-001,2013,2,10,16,2346,1852,4198,4032
0130-001,2013,2,10,17,2201,1855,4056,4198
0130-001,2013,2,10,18,2112,1433,3545,4056
0130-001,2013,2,10,19,1775,1049,2824,3545
0130-001,2013,2,10,20,1252,882,2134,2824
0130-001,2013,2,10,21,856,790,1646,2134
0130-001,2013,2,10,22,734,752,1486,1646
0130-001,2013,2,10,23,561,511,1072,1486
0130-001,2013,2,10,24,549,378,927,1072
0130-001,2013,2,11,1,457,233,690,927
0130-001,2013,2,11,2,397,168,565,690
0130-001,2013,2,11,3,221,112,333,565
0130-001,2013,2,11,4,138,102,240,333
0130-001,2013,2,11,5,113,93,206,240
0130-001,2013,2,11,6,146,162,308,206
0130-001,2013,2,11,7,253,156,409,308
0130-001,2013,2,11,8,325,248,573,409
0130-001,2013,2,11,9,461,432,893,573
0130-001,2013,2,11,10,678,577,1255,893
0130-001,2013,2,11,11,1009,835,1844,1255
0130-001,2013,2,11,12,1514,1133,2647,1844
0130-001,2013,2,11,13,1689,1250,2939,2647
0130-001,2013,2,11,14,1856,1349,3205,2939
0130-001,2013,2,11,15,1780,1363,3143,3205
0130-001,2013,2,11,16,1677,1409,3086,3143
0130-001,2013,2,11,17,1696,1266,2962,3086
0130-001,2013,2,11,18,1639,1248,2887,2962
0130-001,2013,2,11,19,1594,1166,2760,2887
0130-001,2013,2,11,20,1713,861,2574,2760
0130-001,2013,2,11,21,1588,821,2409,2574
0130-001,2013,2,11,22,1481,717,2198,2409
0130-001,2013,2,11,23,1156,502,1658,2198
0130-001,2013,2,11,24,779,336,1115,1658
0130-001,2013,2,12,1,487,227,714,1115
0130-001,2013,2,12,2,267,160,427,714
0130-001,2013,2,12,3,137,115,252,427
0130-001,2013,2,12,4,119,77,196,252
0130-001,2013,2,12,5,126,99,225,196
0130-001,2013,2,12,6,202,254,456,225
0130-001,2013,2,12,7,634,443,1077,456
0130-001,2013,2,12,8,1557,1091,2648,1077
0130-001,2013,2,12,9,1673,1688,3361,2648
0130-001,2013,2,12,10,1396,1480,2876,3361
0130-001,2013,2,12,11,1404,1578,2982,2876
0130-001,2013,2,12,12,1496,1571,3067,2982
0130-001,2013,2,12,13,1539,1434,2973,3067
0130-001,2013,2,12,14,1752,1766,3518,2973
0130-001,2013,2,12,15,1868,1786,3654,3518
0130-001,2013,2,12,16,1844,1678,3522,3654
0130-001,2013,2,12,17,1896,1753,3649,3522
0130-001,2013,2,12,18,1893,1995,3888,3649
0130-001,2013,2,12,19,1777,1807,3584,3888
0130-001,2013,2,12,20,1346,1287,2633,3584
0130-001,2013,2,12,21,1122,1051,2173,2633
0130-001,2013,2,12,22,913,918,1831,2173
0130-001,2013,2,12,23,693,594,1287,1831
0130-001,2013,2,12,24,480,361,841,1287
0130-001,2013,2,13,1,347,262,609,841
0130-001,2013,2,13,2,218,198,416,609
0130-001,2013,2,13,3,134,122,256,416
0130-001,2013,2,13,4,127,126,253,256
0130-001,2013,2,13,5,148,186,334,253
0130-001,2013,2,13,6,288,308,596,334
0130-001,2013,2,13,7,879,576,1455,596
0130-001,2013,2,13,8,2098,1347,3445,1455
0130-001,2013,2,13,9,2004,1947,3951,3445
0130-001,2013,2,13,10,1720,1652,3372,3951
0130-001,2013,2,13,11,1666,1808,3474,3372
0130-001,2013,2,13,12,1580,1589,3169,3474
0130-001,2013,2,13,13,1533,1449,2982,3169
0130-001,2013,2,13,14,1673,1663,3336,2982
0130-001,2013,2,13,15,1768,1778,3546,3336
0130-001,2013,2,13,16,1772,1766,3538,3546
0130-001,2013,2,13,17,1630,1718,3348,3538
0130-001,2013,2,13,18,1697,2190,3887,3348
0130-001,2013,2,13,19,1764,2325,4089,3887
0130-001,2013,2,13,20,1289,1556,2845,4089
0130-001,2013,2,13,21,1130,1402,2532,2845
0130-001,2013,2,13,22,1127,1163,2290,2532
0130-001,2013,2,13,23,792,760,1552,2290
0130-001,2013,2,13,24,519,439,958,1552
0130-001,2013,2,14,1,356,282,638,958
0130-001,2013,2,14,2,245,211,456,638
0130-001,2013,2,14,3,168,156,324,456
0130-001,2013,2,14,4,138,159,297,324
0130-001,2013,2,14,5,162,182,344,297
0130-001,2013,2,14,6,260,332,592,344
0130-001,2013,2,14,7,916,620,1536,592
0130-001,2013,2,14,8,2189,1381,3570,1536
0130-001,2013,2,14,9,2061,1976,4037,3570
0130-001,2013,2,14,10,1723,1747,3470,4037
0130-001,2013,2,14,11,1811,1809,3620,3470
0130-001,2013,2,14,12,1553,1603,3156,3620
0130-001,2013,2,14,13,1448,1585,3033,3156
0130-001,2013,2,14,14,1742,1637,3379,3033
0130-001,2013,2,14,15,1796,1829,3625,3379
0130-001,2013,2,14,16,1815,1746,3561,3625
0130-001,2013,2,14,17,1734,1773,3507,3561
0130-001,2013,2,14,18,1684,2154,3838,3507
0130-001,2013,2,14,19,1650,2234,3884,3838
0130-001,2013,2,14,20,1333,1657,2990,3884
0130-001,2013,2,14,21,1113,1449,2562,2990
0130-001,2013,2,14,22,1040,1160,2200,2562
0130-001,2013,2,14,23,829,729,1558,2200
0130-001,2013,2,14,24,595,509,1104,1558
0130-001,2013,2,15,1,397,336,733,1104
0130-001,2013,2,15,2,270,253,523,733
0130-001,2013,2,15,3,164,161,325,523
0130-001,2013,2,15,4,159,145,304,325
0130-001,2013,2,15,5,147,200,347,304
0130-001,2013,2,15,6,271,291,562,347
0130-001,2013,2,15,7,953,578,1531,562
0130-001,2013,2,15,8,2144,1426,3570,1531
0130-001,2013,2,15,9,2095,1961,4056,3570
0130-001,2013,2,15,10,1713,1607,3320,4056
0130-001,2013,2,15,11,1661,1678,3339,3320
0130-001,2013,2,15,12,1590,1637,3227,3339
0130-001,2013,2,15,13,1364,1601,2965,3227
0130-001,2013,2,15,14,1729,1756,3485,2965
0130-001,2013,2,15,15,1825,1807,3632,3485
0130-001,2013,2,15,16,1878,1857,3735,3632
0130-001,2013,2,15,17,1701,1817,3518,3735
0130-001,2013,2,15,18,1821,2266,4087,3518
0130-001,2013,2,15,19,1904,2435,4339,4087
0130-001,2013,2,15,20,1511,1912,3423,4339
0130-001,2013,2,15,21,1199,1529,2728,3423
0130-001,2013,2,15,22,1135,1215,2350,2728
0130-001,2013,2,15,23,880,845,1725,2350
0130-001,2013,2,15,24,627,543,1170,1725
0130-001,2013,2,16,1,441,396,837,1170
0130-001,2013,2,16,2,313,243,556,837
0130-001,2013,2,16,3,248,206,454,556
0130-001,2013,2,16,4,197,196,393,454
0130-001,2013,2,16,5,183,219,402,393
0130-001,2013,2,16,6,260,329,589,402
0130-001,2013,2,16,7,678,458,1136,589
0130-001,2013,2,16,8,1276,944,2220,1136
0130-001,2013,2,16,9,1385,1471,2856,2220
0130-001,2013,2,16,10,1534,1596,3130,2856
0130-001,2013,2,16,11,1591,1720,3311,3130
0130-001,2013,2,16,12,1564,1878,3442,3311
0130-001,2013,2,16,13,1598,1930,3528,3442
0130-001,2013,2,16,14,1832,2055,3887,3528
0130-001,2013,2,16,15,1687,2047,3734,3887
0130-001,2013,2,16,16,1728,1894,3622,3734
0130-001,2013,2,16,17,1793,1812,3605,3622
0130-001,2013,2,16,18,1863,2293,4156,3605
0130-001,2013,2,16,19,1725,1918,3643,4156
0130-001,2013,2,16,20,1295,1207,2502,3643
0130-001,2013,2,16,21,1028,962,1990,2502
0130-001,2013,2,16,22,1011,849,1860,1990
0130-001,2013,2,16,23,696,630,1326,1860
0130-001,2013,2,16,24,527,474,1001,1326
0130-001,2013,2,17,1,382,318,700,1001
0130-001,2013,2,17,2,308,240,548,700
0130-001,2013,2,17,3,214,201,415,548
0130-001,2013,2,17,4,186,122,308,415
0130-001,2013,2,17,5,163,159,322,308
0130-001,2013,2,17,6,174,252,426,322
0130-001,2013,2,17,7,398,347,745,426
0130-001,2013,2,17,8,587,498,1085,745
0130-001,2013,2,17,9,787,817,1604,1085
0130-001,2013,2,17,10,810,996,1806,1604
0130-001,2013,2,17,11,1017,1233,2250,1806
0130-001,2013,2,17,12,1041,1275,2316,2250
0130-001,2013,2,17,13,1132,1319,2451,2316
0130-001,2013,2,17,14,1424,1406,2830,2451
0130-001,2013,2,17,15,1379,1483,2862,2830
0130-001,2013,2,17,16,1569,1439,3008,2862
0130-001,2013,2,17,17,1535,1458,2993,3008
0130-001,2013,2,17,18,1578,1473,3051,2993
0130-001,2013,2,17,19,1409,1168,2577,3051
0130-001,2013,2,17,20,1057,937,1994,2577
0130-001,2013,2,17,21,890,779,1669,1994
0130-001,2013,2,17,22,888,725,1613,1669
0130-001,2013,2,17,23,592,450,1042,1613
0130-001,2013,2,17,24,398,331,729,1042
0130-001,2013,2,18,1,275,216,491,729
0130-001,2013,2,18,2,176,124,300,491
0130-001,2013,2,18,3,102,112,214,300
0130-001,2013,2,18,4,107,115,222,214
0130-001,2013,2,18,5,121,189,310,222
0130-001,2013,2,18,6,272,316,588,310
0130-001,2013,2,18,7,1040,648,1688,588
0130-001,2013,2,18,8,2216,1543,3759,1688
0130-001,2013,2,18,9,2013,1980,3993,3759
0130-001,2013,2,18,10,1668,1649,3317,3993
0130-001,2013,2,18,11,1695,1685,3380,3317
0130-001,2013,2,18,12,1551,1602,3153,3380
0130-001,2013,2,18,13,1391,1504,2895,3153
0130-001,2013,2,18,14,1643,1460,3103,2895
0130-001,2013,2,18,15,1802,1969,3771,3103
0130-001,2013,2,18,16,1865,1757,3622,3771
0130-001,2013,2,18,17,1667,1682,3349,3622
0130-001,2013,2,18,18,1710,2088,3798,3349
0130-001,2013,2,18,19,1671,2190,3861,3798
0130-001,2013,2,18,20,1274,1682,2956,3861
0130-001,2013,2,18,21,1200,1444,2644,2956
0130-001,2013,2,18,22,998,1180,2178,2644
0130-001,2013,2,18,23,679,757,1436,2178
0130-001,2013,2,18,24,489,445,934,1436
0130-001,2013,2,19,1,310,314,624,934
0130-001,2013,2,19,2,213,200,413,624
0130-001,2013,2,19,3,172,145,317,413
0130-001,2013,2,19,4,130,141,271,317
0130-001,2013,2,19,5,160,208,368,271
0130-001,2013,2,19,6,266,316,582,368
0130-001,2013,2,19,7,925,583,1508,582
0130-001,2013,2,19,8,2176,1441,3617,1508
0130-001,2013,2,19,9,2013,1991,4004,3617
0130-001,2013,2,19,10,1688,1671,3359,4004
0130-001,2013,2,19,11,1664,1707,3371,3359
0130-001,2013,2,19,12,1648,1551,3199,3371
0130-001,2013,2,19,13,1480,1437,2917,3199
0130-001,2013,2,19,14,1649,1739,3388,2917
0130-001,2013,2,19,15,1700,1738,3438,3388
0130-001,2013,2,19,16,1753,1701,3454,3438
0130-001,2013,2,19,17,1589,1753,3342,3454
0130-001,2013,2,19,18,1624,2022,3646,3342
0130-001,2013,2,19,19,1678,2162,3840,3646
0130-001,2013,2,19,20,1327,1674,3001,3840
0130-001,2013,2,19,21,1173,1466,2639,3001
0130-001,2013,2,19,22,1070,1213,2283,2639
0130-001,2013,2,19,23,774,687,1461,2283
0130-001,2013,2,19,24,513,460,973,1461
0130-001,2013,2,20,1,344,339,683,973
0130-001,2013,2,20,2,249,226,475,683
0130-001,2013,2,20,3,161,171,332,475
0130-001,2013,2,20,4,155,130,285,332
0130-001,2013,2,20,5,145,194,339,285
0130-001,2013,2,20,6,282,323,605,339
0130-001,2013,2,20,7,991,601,1592,605
0130-001,2013,2,20,8,2207,1464,3671,1592
0130-001,2013,2,20,9,2019,1961,3980,3671
0130-001,2013,2,20,10,1735,1671,3406,3980
0130-001,2013,2,20,11,1849,1612,3461,3406
0130-001,2013,2,20,12,1610,1668,3278,3461
0130-001,2013,2,20,13,1396,1547,2943,3278
0130-001,2013,2,20,14,1554,1745,3299,2943
0130-001,2013,2,20,15,1783,1767,3550,3299
0130-001,2013,2,20,16,1856,1784,3640,3550
0130-001,2013,2,20,17,1687,1860,3547,3640
0130-001,2013,2,20,18,1745,2251,3996,3547
0130-001,2013,2,20,19,1813,2364,4177,3996
0130-001,2013,2,20,20,1404,1656,3060,4177
0130-001,2013,2,20,21,1176,1442,2618,3060
0130-001,2013,2,20,22,1057,1120,2177,2618
0130-001,2013,2,20,23,845,727,1572,2177
0130-001,2013,2,20,24,536,466,1002,1572
0130-001,2013,2,21,1,387,329,716,1002
0130-001,2013,2,21,2,217,228,445,716
0130-001,2013,2,21,3,171,158,329,445
0130-001,2013,2,21,4,131,140,271,329
0130-001,2013,2,21,5,147,193,340,271
0130-001,2013,2,21,6,274,339,613,340
0130-001,2013,2,21,7,923,585,1508,613
0130-001,2013,2,21,8,2198,1410,3608,1508
0130-001,2013,2,21,9,2007,1990,3997,3608
0130-001,2013,2,21,10,1781,1656,3437,3997
0130-001,2013,2,21,11,1711,1688,3399,3437
0130-001,2013,2,21,12,1639,1637,3276,3399
0130-001,2013,2,21,13,1514,1532,3046,3276
0130-001,2013,2,21,14,1586,1867,3453,3046
0130-001,2013,2,21,15,1926,1698,3624,3453
0130-001,2013,2,21,16,1879,1728,3607,3624
0130-001,2013,2,21,17,1669,1776,3445,3607
0130-001,2013,2,21,18,1715,2132,3847,3445
0130-001,2013,2,21,19,1699,2270,3969,3847
0130-001,2013,2,21,20,1343,1710,3053,3969
0130-001,2013,2,21,21,1234,1445,2679,3053
0130-001,2013,2,21,22,1110,1204,2314,2679
0130-001,2013,2,21,23,854,788,1642,2314
0130-001,2013,2,21,24,526,495,1021,1642
0130-001,2013,2,22,1,379,355,734,1021
0130-001,2013,2,22,2,275,212,487,734
0130-001,2013,2,22,3,183,169,352,487
0130-001,2013,2,22,4,171,170,341,352
0130-001,2013,2,22,5,160,220,380,341
0130-001,2013,2,22,6,303,335,638,380
0130-001,2013,2,22,7,867,543,1410,638
0130-001,2013,2,22,8,1985,1399,3384,1410
0130-001,2013,2,22,9,2093,1907,4000,3384
0130-001,2013,2,22,10,1700,1666,3366,4000
0130-001,2013,2,22,11,1682,1715,3397,3366
0130-001,2013,2,22,12,1544,1637,3181,3397
0130-001,2013,2,22,13,1477,1629,3106,3181
0130-001,2013,2,22,14,1764,1835,3599,3106
0130-001,2013,2,22,15,1730,1949,3679,3599
0130-001,2013,2,22,16,1833,1779,3612,3679
0130-001,2013,2,22,17,1703,1771,3474,3612
0130-001,2013,2,22,18,1865,2222,4087,3474
0130-001,2013,2,22,19,1973,2493,4466,4087
0130-001,2013,2,22,20,1544,1861,3405,4466
0130-001,2013,2,22,21,1220,1511,2731,3405
0130-001,2013,2,22,22,1083,1240,2323,2731
0130-001,2013,2,22,23,886,814,1700,2323
0130-001,2013,2,22,24,669,568,1237,1700
0130-001,2013,2,23,1,494,392,886,1237
0130-001,2013,2,23,2,360,313,673,886
0130-001,2013,2,23,3,267,236,503,673
0130-001,2013,2,23,4,185,195,380,503
0130-001,2013,2,23,5,168,251,419,380
0130-001,2013,2,23,6,311,314,625,419
0130-001,2013,2,23,7,695,503,1198,625
0130-001,2013,2,23,8,1287,950,2237,1198
0130-001,2013,2,23,9,1437,1491,2928,2237
0130-001,2013,2,23,10,1547,1661,3208,2928
0130-001,2013,2,23,11,1623,1889,3512,3208
0130-001,2013,2,23,12,1608,2049,3657,3512
0130-001,2013,2,23,13,1565,2309,3874,3657
0130-001,2013,2,23,14,1771,2117,3888,3874
0130-001,2013,2,23,15,1809,2099,3908,3888
0130-001,2013,2,23,16,1908,1877,3785,3908
0130-001,2013,2,23,17,1989,1989,3978,3785
0130-001,2013,2,23,18,1976,2196,4172,3978
0130-001,2013,2,23,19,1864,1960,3824,4172
0130-001,2013,2,23,20,1391,1353,2744,3824
0130-001,2013,2,23,21,1176,992,2168,2744
0130-001,2013,2,23,22,1022,950,1972,2168
0130-001,2013,2,23,23,792,668,1460,1972
0130-001,2013,2,23,24,520,490,1010,1460
0130-001,2013,2,24,1,395,309,704,1010
0130-001,2013,2,24,2,302,231,533,704
0130-001,2013,2,24,3,221,191,412,533
0130-001,2013,2,24,4,200,158,358,412
0130-001,2013,2,24,5,145,135,280,358
0130-001,2013,2,24,6,224,237,461,280
0130-001,2013,2,24,7,394,346,740,461
0130-001,2013,2,24,8,630,520,1150,740
0130-001,2013,2,24,9,797,840,1637,1150
0130-001,2013,2,24,10,972,1086,2058,1637
0130-001,2013,2,24,11,1043,1324,2367,2058
0130-001,2013,2,24,12,1023,1514,2537,2367
0130-001,2013,2,24,13,1335,1452,2787,2537
0130-001,2013,2,24,14,1385,1479,2864,2787
0130-001,2013,2,24,15,1517,1478,2995,2864
0130-001,2013,2,24,16,1591,1479,3070,2995
0130-001,2013,2,24,17,1759,1612,3371,3070
0130-001,2013,2,24,18,1736,1576,3312,3371
0130-001,2013,2,24,19,1564,1298,2862,3312
0130-001,2013,2,24,20,1172,995,2167,2862
0130-001,2013,2,24,21,972,821,1793,2167
0130-001,2013,2,24,22,914,758,1672,1793
0130-001,2013,2,24,23,613,490,1103,1672
0130-001,2013,2,24,24,398,333,731,1103
0130-001,2013,2,25,1,275,221,496,731
0130-001,2013,2,25,2,172,158,330,496
0130-001,2013,2,25,3,121,104,225,330
0130-001,2013,2,25,4,114,108,222,225
0130-001,2013,2,25,5,134,196,330,222
0130-001,2013,2,25,6,327,334,661,330
0130-001,2013,2,25,7,1114,664,1778,661
0130-001,2013,2,25,8,2223,1520,3743,1778
0130-001,2013,2,25,9,2094,1956,4050,3743
0130-001,2013,2,25,10,1620,1614,3234,4050
0130-001,2013,2,25,11,1690,1636,3326,3234
0130-001,2013,2,25,12,1471,1535,3006,3326
0130-001,2013,2,25,13,1480,1482,2962,3006
0130-001,2013,2,25,14,1703,1756,3459,2962
0130-001,2013,2,25,15,1774,1761,3535,3459
0130-001,2013,2,25,16,1888,1833,3721,3535
0130-001,2013,2,25,17,1691,1761,3452,3721
0130-001,2013,2,25,18,1695,2178,3873,3452
0130-001,2013,2,25,19,1736,2343,4079,3873
0130-001,2013,2,25,20,1313,1620,2933,4079
0130-001,2013,2,25,21,1161,1493,2654,2933
0130-001,2013,2,25,22,1073,1179,2252,2654
0130-001,2013,2,25,23,781,724,1505,2252
0130-001,2013,2,25,24,516,420,936,1505
0130-001,2013,2,26,1,352,314,666,936
0130-001,2013,2,26,2,232,185,417,666
0130-001,2013,2,26,3,172,166,338,417
0130-001,2013,2,26,4,148,129,277,338
0130-001,2013,2,26,5,136,239,375,277
0130-001,2013,2,26,6,305,298,603,375
0130-001,2013,2,26,7,1015,644,1659,603
0130-001,2013,2,26,8,2173,1438,3611,1659
0130-001,2013,2,26,9,2093,1826,3919,3611
0130-001,2013,2,26,10,1781,1626,3407,3919
0130-001,2013,2,26,11,1728,1691,3419,3407
0130-001,2013,2,26,12,1618,1639,3257,3419
0130-001,2013,2,26,13,1448,1510,2958,3257
0130-001,2013,2,26,14,1738,1762,3500,2958
0130-001,2013,2,26,15,1799,1829,3628,3500
0130-001,2013,2,26,16,1746,1731,3477,3628
0130-001,2013,2,26,17,1619,1813,3432,3477
0130-001,2013,2,26,18,1672,2080,3752,3432
0130-001,2013,2,26,19,1654,2340,3994,3752
0130-001,2013,2,26,20,1370,1685,3055,3994
0130-001,2013,2,26,21,1204,1502,2706,3055
0130-001,2013,2,26,22,1106,1230,2336,2706
0130-001,2013,2,26,23,787,713,1500,2336
0130-001,2013,2,26,24,555,519,1074,1500
0130-001,2013,2,27,1,401,303,704,1074
0130-001,2013,2,27,2,234,219,453,704
0130-001,2013,2,27,3,191,195,386,453
0130-001,2013,2,27,4,151,157,308,386
0130-001,2013,2,27,5,152,212,364,308
0130-001,2013,2,27,6,275,335,610,364
0130-001,2013,2,27,7,1017,584,1601,610
0130-001,2013,2,27,8,2158,1462,3620,1601
0130-001,2013,2,27,9,2059,1977,4036,3620
0130-001,2013,2,27,10,1764,1661,3425,4036
0130-001,2013,2,27,11,1713,1689,3402,3425
0130-001,2013,2,27,12,1677,1660,3337,3402
0130-001,2013,2,27,13,1520,1583,3103,3337
0130-001,2013,2,27,14,1678,1710,3388,3103
0130-001,2013,2,27,15,1811,1824,3635,3388
0130-001,2013,2,27,16,1854,1899,3753,3635
0130-001,2013,2,27,17,1732,1841,3573,3753
0130-001,2013,2,27,18,1756,2245,4001,3573
0130-001,2013,2,27,19,1801,2443,4244,4001
0130-001,2013,2,27,20,1518,1813,3331,4244
0130-001,2013,2,27,21,1284,1531,2815,3331
0130-001,2013,2,27,22,1220,1230,2450,2815
0130-001,2013,2,27,23,953,813,1766,2450
0130-001,2013,2,27,24,538,502,1040,1766
0130-001,2013,2,28,1,409,369,778,1040
0130-001,2013,2,28,2,273,233,506,778
0130-001,2013,2,28,3,188,198,386,506
0130-001,2013,2,28,4,170,170,340,386
0130-001,2013,2,28,5,176,207,383,340
0130-001,2013,2,28,6,299,321,620,383
0130-001,2013,2,28,7,991,603,1594,620
0130-001,2013,2,28,8,2175,1443,3618,1594
0130-001,2013,2,28,9,2038,1969,4007,3618
0130-001,2013,2,28,10,1806,1744,3550,4007
0130-001,2013,2,28,11,1918,1778,3696,3550
0130-001,2013,2,28,12,1676,1758,3434,3696
0130-001,2013,2,28,13,1469,1640,3109,3434
0130-001,2013,2,28,14,1774,1908,3682,3109
0130-001,2013,2,28,15,1848,1908,3756,3682
0130-001,2013,2,28,16,1850,1874,3724,3756
0130-001,2013,2,28,17,1763,1880,3643,3724
0130-001,2013,2,28,18,1902,2368,4270,3643
0130-001,2013,2,28,19,1903,2484,4387,4270
0130-001,2013,2,28,20,1488,1987,3475,4387
0130-001,2013,2,28,21,1289,1791,3080,3475
0130-001,2013,2,28,22,1272,1397,2669,3080
0130-001,2013,2,28,23,1007,923,1930,2669
0130-001,2013,2,28,24,735,624,1359,1930
0130-001,2013,3,1,1,541,447,988,1359
0130-001,2013,3,1,2,354,311,665,988
0130-001,2013,3,1,3,283,245,528,665
0130-001,2013,3,1,4,195,207,402,528
0130-001,2013,3,1,5,176,207,383,402
0130-001,2013,3,1,6,304,312,616,383
0130-001,2013,3,1,7,655,476,1131,616
0130-001,2013,3,1,8,1239,834,2073,1131
0130-001,2013,3,1,9,1286,1277,2563,2073
0130-001,2013,3,1,10,1308,1488,2796,2563
0130-001,2013,3,1,11,1379,2163,3542,2796
0130-001,2013,3,1,12,1319,2151,3470,3542
0130-001,2013,3,1,13,1381,2226,3607,3470
0130-001,2013,3,1,14,1426,2146,3572,3607
0130-001,2013,3,1,15,1519,2487,4006,3572
0130-001,2013,3,1,16,1472,2628,4100,4006
0130-001,2013,3,1,17,1688,2620,4308,4100
0130-001,2013,3,1,18,1695,2443,4138,4308
0130-001,2013,3,1,19,1649,2337,3986,4138
0130-001,2013,3,1,20,1316,2177,3493,3986
0130-001,2013,3,1,21,1117,1589,2706,3493
0130-001,2013,3,1,22,1022,1068,2090,2706
0130-001,2013,3,1,23,761,571,1332,2090
0130-001,2013,3,1,24,502,426,928,1332
0130-001,2013,3,2,1,355,305,660,928
0130-001,2013,3,2,2,261,225,486,660
0130-001,2013,3,2,3,183,156,339,486
0130-001,2013,3,2,4,152,158,310,339
0130-001,2013,3,2,5,145,204,349,310
0130-001,2013,3,2,6,268,281,549,349
0130-001,2013,3,2,7,618,459,1077,549
0130-001,2013,3,2,8,1072,753,1825,1077
0130-001,2013,3,2,9,1125,1282,2407,1825
0130-001,2013,3,2,10,1264,1403,2667,2407
0130-001,2013,3,2,11,1388,1675,3063,2667
0130-001,2013,3,2,12,1547,1854,3401,3063
0130-001,2013,3,2,13,1461,1973,3434,3401
0130-001,2013,3,2,14,1637,2069,3706,3434
0130-001,2013,3,2,15,1689,2177,3866,3706
0130-001,2013,3,2,16,1735,2159,3894,3866
0130-001,2013,3,2,17,1989,2020,4009,3894
0130-001,2013,3,2,18,2025,2132,4157,4009
0130-001,2013,3,2,19,1989,1888,3877,4157
0130-001,2013,3,2,20,1888,1405,3293,3877
0130-001,2013,3,2,21,1480,971,2451,3293
0130-001,2013,3,2,22,1432,908,2340,2451
0130-001,2013,3,2,23,969,642,1611,2340
0130-001,2013,3,2,24,627,417,1044,1611
0130-001,2013,3,3,1,385,296,681,1044
0130-001,2013,3,3,2,245,211,456,681
0130-001,2013,3,3,3,229,164,393,456
0130-001,2013,3,3,4,179,146,325,393
0130-001,2013,3,3,5,159,132,291,325
0130-001,2013,3,3,6,193,216,409,291
0130-001,2013,3,3,7,382,312,694,409
0130-001,2013,3,3,8,626,489,1115,694
0130-001,2013,3,3,9,684,790,1474,1115
0130-001,2013,3,3,10,779,984,1763,1474
0130-001,2013,3,3,11,1036,1235,2271,1763
0130-001,2013,3,3,12,1231,1370,2601,2271
0130-001,2013,3,3,13,1443,1471,2914,2601
0130-001,2013,3,3,14,1693,1675,3368,2914
0130-001,2013,3,3,15,1971,1655,3626,3368
0130-001,2013,3,3,16,2005,1692,3697,3626
0130-001,2013,3,3,17,1977,1659,3636,3697
0130-001,2013,3,3,18,1916,1646,3562,3636
0130-001,2013,3,3,19,2026,1477,3503,3562
0130-001,2013,3,3,20,1577,1243,2820,3503
0130-001,2013,3,3,21,1192,1020,2212,2820
0130-001,2013,3,3,22,1104,811,1915,2212
0130-001,2013,3,3,23,696,442,1138,1915
0130-001,2013,3,3,24,450,337,787,1138
0130-001,2013,3,4,1,259,226,485,787
0130-001,2013,3,4,2,160,136,296,485
0130-001,2013,3,4,3,114,100,214,296
0130-001,2013,3,4,4,111,129,240,214
0130-001,2013,3,4,5,128,191,319,240
0130-001,2013,3,4,6,305,327,632,319
0130-001,2013,3,4,7,1213,731,1944,632
0130-001,2013,3,4,8,1860,1766,3626,1944
0130-001,2013,3,4,9,2297,1972,4269,3626
0130-001,2013,3,4,10,1874,1685,3559,4269
0130-001,2013,3,4,11,1678,1742,3420,3559
0130-001,2013,3,4,12,1560,1762,3322,3420
0130-001,2013,3,4,13,1574,1582,3156,3322
0130-001,2013,3,4,14,1831,1856,3687,3156
0130-001,2013,3,4,15,1889,1900,3789,3687
0130-001,2013,3,4,16,1875,1947,3822,3789
0130-001,2013,3,4,17,1778,1813,3591,3822
0130-001,2013,3,4,18,1757,2248,4005,3591
0130-001,2013,3,4,19,1764,2283,4047,4005
0130-001,2013,3,4,20,1397,1701,3098,4047
0130-001,2013,3,4,21,1256,1500,2756,3098
0130-001,2013,3,4,22,1081,1213,2294,2756
0130-001,2013,3,4,23,774,739,1513,2294
0130-001,2013,3,4,24,497,461,958,1513
0130-001,2013,3,5,1,361,292,653,958
0130-001,2013,3,5,2,238,193,431,653
0130-001,2013,3,5,3,157,165,322,431
0130-001,2013,3,5,4,115,146,261,322
0130-001,2013,3,5,5,148,209,357,261
0130-001,2013,3,5,6,292,312,604,357
0130-001,2013,3,5,7,1073,638,1711,604
0130-001,2013,3,5,8,2194,1734,3928,1711
0130-001,2013,3,5,9,2286,2020,4306,3928
0130-001,2013,3,5,10,1741,1653,3394,4306
0130-001,2013,3,5,11,1647,1703,3350,3394
0130-001,2013,3,5,12,1618,1596,3214,3350
0130-001,2013,3,5,13,1432,1464,2896,3214
0130-001,2013,3,5,14,1703,1717,3420,2896
0130-001,2013,3,5,15,1816,1815,3631,3420
0130-001,2013,3,5,16,1709,1807,3516,3631
0130-001,2013,3,5,17,1702,1776,3478,3516
0130-001,2013,3,5,18,1698,2165,3863,3478
0130-001,2013,3,5,19,1779,2401,4180,3863
0130-001,2013,3,5,20,1331,1800,3131,4180
0130-001,2013,3,5,21,1251,1574,2825,3131
0130-001,2013,3,5,22,1150,1331,2481,2825
0130-001,2013,3,5,23,807,763,1570,2481
0130-001,2013,3,5,24,544,512,1056,1570
0130-001,2013,3,6,1,403,307,710,1056
0130-001,2013,3,6,2,213,208,421,710
0130-001,2013,3,6,3,167,170,337,421
0130-001,2013,3,6,4,143,149,292,337
0130-001,2013,3,6,5,158,203,361,292
0130-001,2013,3,6,6,317,317,634,361
0130-001,2013,3,6,7,1059,624,1683,634
0130-001,2013,3,6,8,2219,1729,3948,1683
0130-001,2013,3,6,9,2250,1920,4170,3948
0130-001,2013,3,6,10,1640,1579,3219,4170
0130-001,2013,3,6,11,1693,1604,3297,3219
0130-001,2013,3,6,12,1594,1560,3154,3297
0130-001,2013,3,6,13,1417,1445,2862,3154
0130-001,2013,3,6,14,1600,1634,3234,2862
0130-001,2013,3,6,15,1786,1733,3519,3234
0130-001,2013,3,6,16,1663,1806,3469,3519
0130-001,2013,3,6,17,1675,1805,3480,3469
0130-001,2013,3,6,18,1709,2230,3939,3480
0130-001,2013,3,6,19,1727,2507,4234,3939
0130-001,2013,3,6,20,1376,1766,3142,4234
0130-001,2013,3,6,21,1219,1484,2703,3142
0130-001,2013,3,6,22,1152,1180,2332,2703
0130-001,2013,3,6,23,845,781,1626,2332
0130-001,2013,3,6,24,546,475,1021,1626
0130-001,2013,3,7,1,395,344,739,1021
0130-001,2013,3,7,2,233,239,472,739
0130-001,2013,3,7,3,196,189,385,472
0130-001,2013,3,7,4,142,168,310,385
0130-001,2013,3,7,5,166,203,369,310
0130-001,2013,3,7,6,301,327,628,369
0130-001,2013,3,7,7,1067,618,1685,628
0130-001,2013,3,7,8,2072,1691,3763,1685
0130-001,2013,3,7,9,2162,2011,4173,3763
0130-001,2013,3,7,10,1712,1603,3315,4173
0130-001,2013,3,7,11,1689,1645,3334,3315
0130-001,2013,3,7,12,1594,1549,3143,3334
0130-001,2013,3,7,13,1291,1462,2753,3143
0130-001,2013,3,7,14,1656,1571,3227,2753
0130-001,2013,3,7,15,1760,1684,3444,3227
0130-001,2013,3,7,16,1698,1758,3456,3444
0130-001,2013,3,7,17,1616,1756,3372,3456
0130-001,2013,3,7,18,1759,2109,3868,3372
0130-001,2013,3,7,19,1763,2340,4103,3868
0130-001,2013,3,7,20,1336,1620,2956,4103
0130-001,2013,3,7,21,1151,1557,2708,2956
0130-001,2013,3,7,22,1151,1302,2453,2708
0130-001,2013,3,7,23,892,800,1692,2453
0130-001,2013,3,7,24,592,508,1100,1692
0130-001,2013,3,8,1,375,350,725,1100
0130-001,2013,3,8,2,221,237,458,725
0130-001,2013,3,8,3,156,173,329,458
0130-001,2013,3,8,4,166,154,320,329
0130-001,2013,3,8,5,154,204,358,320
0130-001,2013,3,8,6,295,320,615,358
0130-001,2013,3,8,7,1105,652,1757,615
0130-001,2013,3,8,8,2181,1705,3886,1757
0130-001,2013,3,8,9,2209,1999,4208,3886
0130-001,2013,3,8,10,1658,1693,3351,4208
0130-001,2013,3,8,11,1742,1746,3488,3351
0130-001,2013,3,8,12,1618,1626,3244,3488
0130-001,2013,3,8,13,1454,1451,2905,3244
0130-001,2013,3,8,14,1693,1734,3427,2905
0130-001,2013,3,8,15,1795,1815,3610,3427
0130-001,2013,3,8,16,1821,1828,3649,3610
0130-001,2013,3,8,17,1721,1824,3545,3649
0130-001,2013,3,8,18,1782,2302,4084,3545
0130-001,2013,3,8,19,1960,2526,4486,4084
0130-001,2013,3,8,20,1557,2032,3589,4486
0130-001,2013,3,8,21,1348,1643,2991,3589
0130-001,2013,3,8,22,1250,1329,2579,2991
0130-001,2013,3,8,23,967,874,1841,2579
0130-001,2013,3,8,24,713,592,1305,1841
0130-001,2013,3,9,1,512,474,986,1305
0130-001,2013,3,9,2,394,309,703,986
0130-001,2013,3,9,3,257,226,483,703
0130-001,2013,3,9,4,216,212,428,483
0130-001,2013,3,9,5,199,256,455,428
0130-001,2013,3,9,6,317,343,660,455
0130-001,2013,3,9,7,770,585,1355,660
0130-001,2013,3,9,8,1422,1081,2503,1355
0130-001,2013,3,9,9,1532,1655,3187,2503
0130-001,2013,3,9,10,1606,1733,3339,3187
0130-001,2013,3,9,11,1606,1739,3345,3339
0130-001,2013,3,9,12,1662,1852,3514,3345
0130-001,2013,3,9,13,1515,2032,3547,3514
0130-001,2013,3,9,14,1683,2043,3726,3547
0130-001,2013,3,9,15,1712,1980,3692,3726
0130-001,2013,3,9,16,1638,1887,3525,3692
0130-001,2013,3,9,17,1780,1852,3632,3525
0130-001,2013,3,9,18,1975,2149,4124,3632
0130-001,2013,3,9,19,1900,2036,3936,4124
0130-001,2013,3,9,20,1369,1399,2768,3936
0130-001,2013,3,9,21,1179,1170,2349,2768
0130-001,2013,3,9,22,1167,962,2129,2349
0130-001,2013,3,9,23,879,688,1567,2129
0130-001,2013,3,9,24,575,489,1064,1567
0130-001,2013,3,10,1,444,356,800,1064
0130-001,2013,3,10,2,291,245,536,800
0130-001,2013,3,10,3,241,198,439,536
0130-001,2013,3,10,4,179,155,334,439
0130-001,2013,3,10,5,186,185,371,334
0130-001,2013,3,10,6,220,257,477,371
0130-001,2013,3,10,7,487,404,891,477
0130-001,2013,3,10,8,762,645,1407,891
0130-001,2013,3,10,9,1022,951,1973,1407
0130-001,2013,3,10,10,950,1023,1973,1973
0130-001,2013,3,10,11,1181,1427,2608,1973
0130-001,2013,3,10,12,1193,1608,2801,2608
0130-001,2013,3,10,13,1266,1517,2783,2801
0130-001,2013,3,10,14,1412,1577,2989,2783
0130-001,2013,3,10,15,1568,1617,3185,2989
0130-001,2013,3,10,16,1619,1531,3150,3185
0130-001,2013,3,10,17,1672,1560,3232,3150
0130-001,2013,3,10,18,1798,1597,3395,3232
0130-001,2013,3,10,19,1736,1450,3186,3395
0130-001,2013,3,10,20,1331,1091,2422,3186
0130-001,2013,3,10,21,1132,981,2113,2422
0130-001,2013,3,10,22,1014,748,1762,2113
0130-001,2013,3,10,23,675,507,1182,1762
0130-001,2013,3,10,24,442,352,794,1182
0130-001,2013,3,11,1,265,197,462,794
0130-001,2013,3,11,2,156,149,305,462
0130-001,2013,3,11,3,113,95,208,305
0130-001,2013,3,11,4,120,123,243,208
0130-001,2013,3,11,5,117,216,333,243
0130-001,2013,3,11,6,328,305,633,333
0130-001,2013,3,11,7,1269,729,1998,633
0130-001,2013,3,11,8,2237,1863,4100,1998
0130-001,2013,3,11,9,2235,2030,4265,4100
0130-001,2013,3,11,10,1666,1666,3332,4265
0130-001,2013,3,11,11,1717,1660,3377,3332
0130-001,2013,3,11,12,1678,1536,3214,3377
0130-001,2013,3,11,13,1477,1466,2943,3214
0130-001,2013,3,11,14,1740,1638,3378,2943
0130-001,2013,3,11,15,1808,1875,3683,3378
0130-001,2013,3,11,16,1726,1790,3516,3683
0130-001,2013,3,11,17,1700,1801,3501,3516
0130-001,2013,3,11,18,1709,2205,3914,3501
0130-001,2013,3,11,19,1813,2377,4190,3914
0130-001,2013,3,11,20,1343,1771,3114,4190
0130-001,2013,3,11,21,1156,1683,2839,3114
0130-001,2013,3,11,22,1198,1317,2515,2839
0130-001,2013,3,11,23,850,728,1578,2515
0130-001,2013,3,11,24,511,465,976,1578
0130-001,2013,3,12,1,335,292,627,976
0130-001,2013,3,12,2,221,186,407,627
0130-001,2013,3,12,3,176,171,347,407
0130-001,2013,3,12,4,155,165,320,347
0130-001,2013,3,12,5,151,189,340,320
0130-001,2013,3,12,6,325,323,648,340
0130-001,2013,3,12,7,1165,661,1826,648
0130-001,2013,3,12,8,2229,1808,4037,1826
0130-001,2013,3,12,9,2237,2037,4274,4037
0130-001,2013,3,12,10,1798,1666,3464,4274
0130-001,2013,3,12,11,1636,1612,3248,3464
0130-001,2013,3,12,12,1587,1591,3178,3248
0130-001,2013,3,12,13,1384,1441,2825,3178
0130-001,2013,3,12,14,1678,1615,3293,2825
0130-001,2013,3,12,15,1792,1825,3617,3293
0130-001,2013,3,12,16,1696,1852,3548,3617
0130-001,2013,3,12,17,1620,1837,3457,3548
0130-001,2013,3,12,18,1587,2135,3722,3457
0130-001,2013,3,12,19,1649,2404,4053,3722
0130-001,2013,3,12,20,1304,1651,2955,4053
0130-001,2013,3,12,21,1168,1565,2733,2955
0130-001,2013,3,12,22,1194,1234,2428,2733
0130-001,2013,3,12,23,841,744,1585,2428
0130-001,2013,3,12,24,548,475,1023,1585
0130-001,2013,3,13,1,394,336,730,1023
0130-001,2013,3,13,2,188,188,376,730
0130-001,2013,3,13,3,150,150,300,376
0130-001,2013,3,13,4,148,127,275,300
0130-001,2013,3,13,5,157,202,359,275
0130-001,2013,3,13,6,270,272,542,359
0130-001,2013,3,13,7,986,594,1580,542
0130-001,2013,3,13,8,2102,1741,3843,1580
0130-001,2013,3,13,9,2178,2032,4210,3843
0130-001,2013,3,13,10,1756,1652,3408,4210
0130-001,2013,3,13,11,1712,1693,3405,3408
0130-001,2013,3,13,12,1655,1599,3254,3405
0130-001,2013,3,13,13,1445,1443,2888,3254
0130-001,2013,3,13,14,1689,1626,3315,2888
0130-001,2013,3,13,15,1742,1818,3560,3315
0130-001,2013,3,13,16,1744,1769,3513,3560
0130-001,2013,3,13,17,1659,1894,3553,3513
0130-001,2013,3,13,18,1732,2241,3973,3553
0130-001,2013,3,13,19,1757,2466,4223,3973
0130-001,2013,3,13,20,1427,1665,3092,4223
0130-001,2013,3,13,21,1263,1548,2811,3092
0130-001,2013,3,13,22,1235,1258,2493,2811
0130-001,2013,3,13,23,902,786,1688,2493
0130-001,2013,3,13,24,600,512,1112,1688
0130-001,2013,3,14,1,382,341,723,1112
0130-001,2013,3,14,2,257,235,492,723
0130-001,2013,3,14,3,187,201,388,492
0130-001,2013,3,14,4,156,153,309,388
0130-001,2013,3,14,5,153,203,356,309
0130-001,2013,3,14,6,329,334,663,356
0130-001,2013,3,14,7,1110,676,1786,663
0130-001,2013,3,14,8,2203,1781,3984,1786
0130-001,2013,3,14,9,2218,2070,4288,3984
0130-001,2013,3,14,10,1911,1675,3586,4288
0130-001,2013,3,14,11,1827,1723,3550,3586
0130-001,2013,3,14,12,1646,1711,3357,3550
0130-001,2013,3,14,13,1391,1465,2856,3357
0130-001,2013,3,14,14,1727,1698,3425,2856
0130-001,2013,3,14,15,1740,1770,3510,3425
0130-001,2013,3,14,16,1782,1708,3490,3510
0130-001,2013,3,14,17,1655,1789,3444,3490
0130-001,2013,3,14,18,1754,2223,3977,3444
0130-001,2013,3,14,19,1829,2553,4382,3977
0130-001,2013,3,14,20,1385,1836,3221,4382
0130-001,2013,3,14,21,1340,1704,3044,3221
0130-001,2013,3,14,22,1243,1312,2555,3044
0130-001,2013,3,14,23,984,821,1805,2555
0130-001,2013,3,14,24,602,571,1173,1805
0130-001,2013,3,15,1,475,369,844,1173
0130-001,2013,3,15,2,270,211,481,844
0130-001,2013,3,15,3,184,198,382,481
0130-001,2013,3,15,4,174,165,339,382
0130-001,2013,3,15,5,159,230,389,339
0130-001,2013,3,15,6,327,318,645,389
0130-001,2013,3,15,7,1162,696,1858,645
0130-001,2013,3,15,8,2197,1784,3981,1858
0130-001,2013,3,15,9,2179,2044,4223,3981
0130-001,2013,3,15,10,1782,1724,3506,4223
0130-001,2013,3,15,11,1675,1674,3349,3506
0130-001,2013,3,15,12,1601,1715,3316,3349
0130-001,2013,3,15,13,1417,1596,3013,3316
0130-001,2013,3,15,14,1707,1704,3411,3013
0130-001,2013,3,15,15,1789,1750,3539,3411
0130-001,2013,3,15,16,1783,1845,3628,3539
0130-001,2013,3,15,17,1725,1869,3594,3628
0130-001,2013,3,15,18,1920,2294,4214,3594
0130-001,2013,3,15,19,2028,2599,4627,4214
0130-001,2013,3,15,20,1537,2007,3544,4627
0130-001,2013,3,15,21,1338,1626,2964,3544
0130-001,2013,3,15,22,1241,1268,2509,2964
0130-001,2013,3,15,23,970,852,1822,2509
0130-001,2013,3,15,24,679,606,1285,1822
0130-001,2013,3,16,1,534,466,1000,1285
0130-001,2013,3,16,2,340,297,637,1000
0130-001,2013,3,16,3,250,205,455,637
0130-001,2013,3,16,4,194,209,403,455
0130-001,2013,3,16,5,201,249,450,403
0130-001,2013,3,16,6,317,322,639,450
0130-001,2013,3,16,7,777,587,1364,639
0130-001,2013,3,16,8,1431,1099,2530,1364
0130-001,2013,3,16,9,1572,1735,3307,2530
0130-001,2013,3,16,10,1699,1793,3492,3307
0130-001,2013,3,16,11,1648,1910,3558,3492
0130-001,2013,3,16,12,1706,2142,3848,3558
0130-001,2013,3,16,13,1773,2210,3983,3848
0130-001,2013,3,16,14,1893,1987,3880,3983
0130-001,2013,3,16,15,1841,1925,3766,3880
0130-001,2013,3,16,16,1810,1923,3733,3766
0130-001,2013,3,16,17,1886,1977,3863,3733
0130-001,2013,3,16,18,1956,2231,4187,3863
0130-001,2013,3,16,19,1842,2196,4038,4187
0130-001,2013,3,16,20,1455,1397,2852,4038
0130-001,2013,3,16,21,1193,1137,2330,2852
0130-001,2013,3,16,22,1183,988,2171,2330
0130-001,2013,3,16,23,819,647,1466,2171
0130-001,2013,3,16,24,577,458,1035,1466
0130-001,2013,3,17,1,408,361,769,1035
0130-001,2013,3,17,2,310,244,554,769
0130-001,2013,3,17,3,254,219,473,554
0130-001,2013,3,17,4,189,163,352,473
0130-001,2013,3,17,5,192,162,354,352
0130-001,2013,3,17,6,240,236,476,354
0130-001,2013,3,17,7,475,391,866,476
0130-001,2013,3,17,8,703,597,1300,866
0130-001,2013,3,17,9,822,945,1767,1300
0130-001,2013,3,17,10,948,1038,1986,1767
0130-001,2013,3,17,11,1142,1312,2454,1986
0130-001,2013,3,17,12,983,1272,2255,2454
0130-001,2013,3,17,13,1261,1460,2721,2255
0130-001,2013,3,17,14,1469,1458,2927,2721
0130-001,2013,3,17,15,1536,1438,2974,2927
0130-001,2013,3,17,16,1649,1552,3201,2974
0130-001,2013,3,17,17,1817,1559,3376,3201
0130-001,2013,3,17,18,1863,1561,3424,3376
0130-001,2013,3,17,19,1659,1435,3094,3424
0130-001,2013,3,17,20,1251,1076,2327,3094
0130-001,2013,3,17,21,1092,908,2000,2327
0130-001,2013,3,17,22,883,702,1585,2000
0130-001,2013,3,17,23,614,451,1065,1585
0130-001,2013,3,17,24,426,331,757,1065
0130-001,2013,3,18,1,272,230,502,757
0130-001,2013,3,18,2,164,130,294,502
0130-001,2013,3,18,3,113,114,227,294
0130-001,2013,3,18,4,105,120,225,227
0130-001,2013,3,18,5,128,194,322,225
0130-001,2013,3,18,6,332,329,661,322
0130-001,2013,3,18,7,1214,692,1906,661
0130-001,2013,3,18,8,2154,1880,4034,1906
0130-001,2013,3,18,9,2290,2040,4330,4034
0130-001,2013,3,18,10,1674,1721,3395,4330
0130-001,2013,3,18,11,1770,1656,3426,3395
0130-001,2013,3,18,12,1658,1619,3277,3426
0130-001,2013,3,18,13,1446,1421,2867,3277
0130-001,2013,3,18,14,1661,1700,3361,2867
0130-001,2013,3,18,15,1779,1759,3538,3361
0130-001,2013,3,18,16,1840,1781,3621,3538
0130-001,2013,3,18,17,1687,1765,3452,3621
0130-001,2013,3,18,18,1678,2213,3891,3452
0130-001,2013,3,18,19,1741,2495,4236,3891
0130-001,2013,3,18,20,1389,1723,3112,4236
0130-001,2013,3,18,21,1204,1576,2780,3112
0130-001,2013,3,18,22,1099,1264,2363,2780
0130-001,2013,3,18,23,863,778,1641,2363
0130-001,2013,3,18,24,542,467,1009,1641
0130-001,2013,3,19,1,360,294,654,1009
0130-001,2013,3,19,2,230,204,434,654
0130-001,2013,3,19,3,178,175,353,434
0130-001,2013,3,19,4,143,144,287,353
0130-001,2013,3,19,5,164,218,382,287
0130-001,2013,3,19,6,317,340,657,382
0130-001,2013,3,19,7,1226,686,1912,657
0130-001,2013,3,19,8,2178,1787,3965,1912
0130-001,2013,3,19,9,2296,1991,4287,3965
0130-001,2013,3,19,10,1731,1738,3469,4287
0130-001,2013,3,19,11,1713,1730,3443,3469
0130-001,2013,3,19,12,1571,1601,3172,3443
0130-001,2013,3,19,13,1416,1530,2946,3172
0130-001,2013,3,19,14,1744,1604,3348,2946
0130-001,2013,3,19,15,1796,1688,3484,3348
0130-001,2013,3,19,16,1772,1810,3582,3484
0130-001,2013,3,19,17,1701,1838,3539,3582
0130-001,2013,3,19,18,1713,2262,3975,3539
0130-001,2013,3,19,19,1727,2425,4152,3975
0130-001,2013,3,19,20,1368,1677,3045,4152
0130-001,2013,3,19,21,1252,1538,2790,3045
0130-001,2013,3,19,22,1223,1254,2477,2790
0130-001,2013,3,19,23,855,798,1653,2477
0130-001,2013,3,19,24,600,515,1115,1653
0130-001,2013,3,20,1,379,328,707,1115
0130-001,2013,3,20,2,228,228,456,707
0130-001,2013,3,20,3,178,157,335,456
0130-001,2013,3,20,4,177,161,338,335
0130-001,2013,3,20,5,161,197,358,338
0130-001,2013,3,20,6,337,339,676,358
0130-001,2013,3,20,7,1088,667,1755,676
0130-001,2013,3,20,8,2008,1707,3715,1755
0130-001,2013,3,20,9,2206,2036,4242,3715
0130-001,2013,3,20,10,1741,1662,3403,4242
0130-001,2013,3,20,11,1726,1625,3351,3403
0130-001,2013,3,20,12,1617,1624,3241,3351
0130-001,2013,3,20,13,1422,1519,2941,3241
0130-001,2013,3,20,14,1765,1741,3506,2941
0130-001,2013,3,20,15,1756,1719,3475,3506
0130-001,2013,3,20,16,1721,1850,3571,3475
0130-001,2013,3,20,17,1709,1737,3446,3571
0130-001,2013,3,20,18,1717,2267,3984,3446
0130-001,2013,3,20,19,1773,2538,4311,3984
0130-001,2013,3,20,20,1418,1707,3125,4311
0130-001,2013,3,20,21,1215,1640,2855,3125
0130-001,2013,3,20,22,1260,1233,2493,2855
0130-001,2013,3,20,23,899,752,1651,2493
0130-001,2013,3,20,24,612,464,1076,1651
0130-001,2013,3,21,1,409,324,733,1076
0130-001,2013,3,21,2,229,241,470,733
0130-001,2013,3,21,3,189,172,361,470
0130-001,2013,3,21,4,150,176,326,361
0130-001,2013,3,21,5,161,195,356,326
0130-001,2013,3,21,6,341,342,683,356
0130-001,2013,3,21,7,1206,706,1912,683
0130-001,2013,3,21,8,2193,1830,4023,1912
0130-001,2013,3,21,9,2148,1933,4081,4023
0130-001,2013,3,21,10,1694,1722,3416,4081
0130-001,2013,3,21,11,1771,1598,3369,3416
0130-001,2013,3,21,12,1636,1575,3211,3369
0130-001,2013,3,21,13,1382,1401,2783,3211
0130-001,2013,3,21,14,1755,1710,3465,2783
0130-001,2013,3,21,15,1743,1777,3520,3465
0130-001,2013,3,21,16,1686,1815,3501,3520
0130-001,2013,3,21,17,1628,1856,3484,3501
0130-001,2013,3,21,18,1759,2244,4003,3484
0130-001,2013,3,21,19,1797,2496,4293,4003
0130-001,2013,3,21,20,1414,1802,3216,4293
0130-001,2013,3,21,21,1252,1648,2900,3216
0130-001,2013,3,21,22,1255,1251,2506,2900
0130-001,2013,3,21,23,907,769,1676,2506
0130-001,2013,3,21,24,588,505,1093,1676
0130-001,2013,3,22,1,448,332,780,1093
0130-001,2013,3,22,2,240,211,451,780
0130-001,2013,3,22,3,181,180,361,451
0130-001,2013,3,22,4,160,149,309,361
0130-001,2013,3,22,5,162,223,385,309
0130-001,2013,3,22,6,325,353,678,385
0130-001,2013,3,22,7,1201,711,1912,678
0130-001,2013,3,22,8,2246,1791,4037,1912
0130-001,2013,3,22,9,2198,1997,4195,4037
0130-001,2013,3,22,10,1644,1700,3344,4195
0130-001,2013,3,22,11,1751,1732,3483,3344
0130-001,2013,3,22,12,1564,1608,3172,3483
0130-001,2013,3,22,13,1429,1479,2908,3172
0130-001,2013,3,22,14,1730,1776,3506,2908
0130-001,2013,3,22,15,1833,1845,3678,3506
0130-001,2013,3,22,16,1816,1855,3671,3678
0130-001,2013,3,22,17,1815,1898,3713,3671
0130-001,2013,3,22,18,1865,2346,4211,3713
0130-001,2013,3,22,19,1976,2657,4633,4211
0130-001,2013,3,22,20,1483,1994,3477,4633
0130-001,2013,3,22,21,1266,1700,2966,3477
0130-001,2013,3,22,22,1232,1242,2474,2966
0130-001,2013,3,22,23,931,897,1828,2474
0130-001,2013,3,22,24,713,581,1294,1828
0130-001,2013,3,23,1,548,441,989,1294
0130-001,2013,3,23,2,297,268,565,989
0130-001,2013,3,23,3,262,227,489,565
0130-001,2013,3,23,4,209,221,430,489
0130-001,2013,3,23,5,185,241,426,430
0130-001,2013,3,23,6,317,359,676,426
0130-001,2013,3,23,7,844,584,1428,676
0130-001,2013,3,23,8,1421,1135,2556,1428
0130-001,2013,3,23,9,1551,1815,3366,2556
0130-001,2013,3,23,10,1693,1850,3543,3366
0130-001,2013,3,23,11,1668,1946,3614,3543
0130-001,2013,3,23,12,1545,2116,3661,3614
0130-001,2013,3,23,13,1545,2189,3734,3661
0130-001,2013,3,23,14,1799,2174,3973,3734
0130-001,2013,3,23,15,1914,1998,3912,3973
0130-001,2013,3,23,16,1779,1946,3725,3912
0130-001,2013,3,23,17,2008,1956,3964,3725
0130-001,2013,3,23,18,2028,2295,4323,3964
0130-001,2013,3,23,19,1839,2040,3879,4323
0130-001,2013,3,23,20,1429,1378,2807,3879
0130-001,2013,3,23,21,1142,1164,2306,2807
0130-001,2013,3,23,22,1127,965,2092,2306
0130-001,2013,3,23,23,804,692,1496,2092
0130-001,2013,3,23,24,586,480,1066,1496
0130-001,2013,3,24,1,417,381,798,1066
0130-001,2013,3,24,2,277,272,549,798
0130-001,2013,3,24,3,244,184,428,549
0130-001,2013,3,24,4,184,169,353,428
0130-001,2013,3,24,5,199,162,361,353
0130-001,2013,3,24,6,221,262,483,361
0130-001,2013,3,24,7,510,374,884,483
0130-001,2013,3,24,8,741,634,1375,884
0130-001,2013,3,24,9,837,964,1801,1375
0130-001,2013,3,24,10,978,1076,2054,1801
0130-001,2013,3,24,11,1216,1427,2643,2054
0130-001,2013,3,24,12,1109,1412,2521,2643
0130-001,2013,3,24,13,1253,1588,2841,2521
0130-001,2013,3,24,14,1636,1505,3141,2841
0130-001,2013,3,24,15,1586,1573,3159,3141
0130-001,2013,3,24,16,1730,1535,3265,3159
0130-001,2013,3,24,17,1863,1583,3446,3265
0130-001,2013,3,24,18,1748,1565,3313,3446
0130-001,2013,3,24,19,1786,1452,3238,3313
0130-001,2013,3,24,20,1315,1048,2363,3238
0130-001,2013,3,24,21,1180,1006,2186,2363
0130-001,2013,3,24,22,967,774,1741,2186
0130-001,2013,3,24,23,673,481,1154,1741
0130-001,2013,3,24,24,446,339,785,1154
0130-001,2013,3,25,1,258,210,468,785
0130-001,2013,3,25,2,156,162,318,468
0130-001,2013,3,25,3,131,119,250,318
0130-001,2013,3,25,4,108,113,221,250
0130-001,2013,3,25,5,159,184,343,221
0130-001,2013,3,25,6,329,375,704,343
0130-001,2013,3,25,7,1357,791,2148,704
0130-001,2013,3,25,8,2242,1879,4121,2148
0130-001,2013,3,25,9,2240,2038,4278,4121
0130-001,2013,3,25,10,1755,1730,3485,4278
0130-001,2013,3,25,11,1733,1728,3461,3485
0130-001,2013,3,25,12,1550,1686,3236,3461
0130-001,2013,3,25,13,1429,1507,2936,3236
0130-001,2013,3,25,14,1774,1656,3430,2936
0130-001,2013,3,25,15,1791,1826,3617,3430
0130-001,2013,3,25,16,1840,1904,3744,3617
0130-001,2013,3,25,17,1614,1766,3380,3744
0130-001,2013,3,25,18,1724,2227,3951,3380
0130-001,2013,3,25,19,1718,2427,4145,3951
0130-001,2013,3,25,20,1438,1794,3232,4145
0130-001,2013,3,25,21,1179,1640,2819,3232
0130-001,2013,3,25,22,1151,1243,2394,2819
0130-001,2013,3,25,23,762,684,1446,2394
0130-001,2013,3,25,24,558,505,1063,1446
0130-001,2013,3,26,1,345,308,653,1063
0130-001,2013,3,26,2,216,199,415,653
0130-001,2013,3,26,3,159,155,314,415
0130-001,2013,3,26,4,155,157,312,314
0130-001,2013,3,26,5,167,209,376,312
0130-001,2013,3,26,6,311,352,663,376
0130-001,2013,3,26,7,1273,758,2031,663
0130-001,2013,3,26,8,2196,1777,3973,2031
0130-001,2013,3,26,9,2212,2042,4254,3973
0130-001,2013,3,26,10,1730,1830,3560,4254
0130-001,2013,3,26,11,1776,1750,3526,3560
0130-001,2013,3,26,12,1643,1569,3212,3526
0130-001,2013,3,26,13,1415,1454,2869,3212
0130-001,2013,3,26,14,1792,1695,3487,2869
0130-001,2013,3,26,15,1762,1838,3600,3487
0130-001,2013,3,26,16,1706,1803,3509,3600
0130-001,2013,3,26,17,1696,1847,3543,3509
0130-001,2013,3,26,18,1748,2284,4032,3543
0130-001,2013,3,26,19,1715,2473,4188,4032
0130-001,2013,3,26,20,1444,1773,3217,4188
0130-001,2013,3,26,21,1256,1545,2801,3217
0130-001,2013,3,26,22,1167,1201,2368,2801
0130-001,2013,3,26,23,914,830,1744,2368
0130-001,2013,3,26,24,535,501,1036,1744
0130-001,2013,3,27,1,388,326,714,1036
0130-001,2013,3,27,2,247,230,477,714
0130-001,2013,3,27,3,185,188,373,477
0130-001,2013,3,27,4,143,163,306,373
0130-001,2013,3,27,5,175,217,392,306
0130-001,2013,3,27,6,312,342,654,392
0130-001,2013,3,27,7,1234,700,1934,654
0130-001,2013,3,27,8,2218,1763,3981,1934
0130-001,2013,3,27,9,2131,2030,4161,3981
0130-001,2013,3,27,10,1815,1763,3578,4161
0130-001,2013,3,27,11,1690,1672,3362,3578
0130-001,2013,3,27,12,1637,1558,3195,3362
0130-001,2013,3,27,13,1393,1320,2713,3195
0130-001,2013,3,27,14,1720,1675,3395,2713
0130-001,2013,3,27,15,1757,1821,3578,3395
0130-001,2013,3,27,16,1820,1848,3668,3578
0130-001,2013,3,27,17,1727,1886,3613,3668
0130-001,2013,3,27,18,1728,2266,3994,3613
0130-001,2013,3,27,19,1823,2629,4452,3994
0130-001,2013,3,27,20,1499,1769,3268,4452
0130-001,2013,3,27,21,1225,1543,2768,3268
0130-001,2013,3,27,22,1191,1274,2465,2768
0130-001,2013,3,27,23,889,715,1604,2465
0130-001,2013,3,27,24,609,526,1135,1604
0130-001,2013,3,28,1,433,352,785,1135
0130-001,2013,3,28,2,238,238,476,785
0130-001,2013,3,28,3,186,168,354,476
0130-001,2013,3,28,4,162,160,322,354
0130-001,2013,3,28,5,173,214,387,322
0130-001,2013,3,28,6,316,362,678,387
0130-001,2013,3,28,7,1221,703,1924,678
0130-001,2013,3,28,8,2198,1752,3950,1924
0130-001,2013,3,28,9,2190,2044,4234,3950
0130-001,2013,3,28,10,1809,1775,3584,4234
0130-001,2013,3,28,11,1721,1634,3355,3584
0130-001,2013,3,28,12,1547,1576,3123,3355
0130-001,2013,3,28,13,1392,1487,2879,3123
0130-001,2013,3,28,14,1772,1670,3442,2879
0130-001,2013,3,28,15,1769,1818,3587,3442
0130-001,2013,3,28,16,1865,1830,3695,3587
0130-001,2013,3,28,17,1752,1881,3633,3695
0130-001,2013,3,28,18,1739,2212,3951,3633
0130-001,2013,3,28,19,1752,2479,4231,3951
0130-001,2013,3,28,20,1320,1746,3066,4231
0130-001,2013,3,28,21,1253,1632,2885,3066
0130-001,2013,3,28,22,1233,1289,2522,2885
0130-001,2013,3,28,23,921,741,1662,2522
0130-001,2013,3,28,24,589,510,1099,1662
0130-001,2013,3,29,1,401,320,721,1099
0130-001,2013,3,29,2,253,243,496,721
0130-001,2013,3,29,3,186,180,366,496
0130-001,2013,3,29,4,162,166,328,366
0130-001,2013,3,29,5,177,200,377,328
0130-001,2013,3,29,6,332,344,676,377
0130-001,2013,3,29,7,1180,729,1909,676
0130-001,2013,3,29,8,2202,1717,3919,1909
0130-001,2013,3,29,9,2196,2014,4210,3919
0130-001,2013,3,29,10,1724,1752,3476,4210
0130-001,2013,3,29,11,1724,1640,3364,3476
0130-001,2013,3,29,12,1662,1693,3355,3364
0130-001,2013,3,29,13,1389,1510,2899,3355
0130-001,2013,3,29,14,1771,1632,3403,2899
0130-001,2013,3,29,15,1727,1854,3581,3403
0130-001,2013,3,29,16,1852,1974,3826,3581
0130-001,2013,3,29,17,1835,1877,3712,3826
0130-001,2013,3,29,18,1866,2347,4213,3712
0130-001,2013,3,29,19,1982,2636,4618,4213
0130-001,2013,3,29,20,1609,2086,3695,4618
0130-001,2013,3,29,21,1300,1693,2993,3695
0130-001,2013,3,29,22,1241,1363,2604,2993
0130-001,2013,3,29,23,940,856,1796,2604
0130-001,2013,3,29,24,754,595,1349,1796
0130-001,2013,3,30,1,505,449,954,1349
0130-001,2013,3,30,2,365,328,693,954
0130-001,2013,3,30,3,297,239,536,693
0130-001,2013,3,30,4,220,209,429,536
0130-001,2013,3,30,5,219,253,472,429
0130-001,2013,3,30,6,288,352,640,472
0130-001,2013,3,30,7,761,530,1291,640
0130-001,2013,3,30,8,1428,1081,2509,1291
0130-001,2013,3,30,9,1575,1742,3317,2509
0130-001,2013,3,30,10,1695,1880,3575,3317
0130-001,2013,3,30,11,1713,2084,3797,3575
0130-001,2013,3,30,12,1676,2368,4044,3797
0130-001,2013,3,30,13,1963,2418,4381,4044
0130-001,2013,3,30,14,1898,2310,4208,4381
0130-001,2013,3,30,15,1817,2163,3980,4208
0130-001,2013,3,30,16,1885,2099,3984,3980
0130-001,2013,3,30,17,1858,2127,3985,3984
0130-001,2013,3,30,18,1884,2345,4229,3985
0130-001,2013,3,30,19,1841,2237,4078,4229
0130-001,2013,3,30,20,1400,1413,2813,4078
0130-001,2013,3,30,21,1185,1114,2299,2813
0130-001,2013,3,30,22,1078,918,1996,2299
0130-001,2013,3,30,23,730,662,1392,1996
0130-001,2013,3,30,24,535,437,972,1392
0130-001,2013,3,31,1,362,326,688,972
0130-001,2013,3,31,2,283,270,553,688
0130-001,2013,3,31,3,225,179,404,553
0130-001,2013,3,31,4,196,160,356,404
0130-001,2013,3,31,5,193,146,339,356
0130-001,2013,3,31,6,227,232,459,339
0130-001,2013,3,31,7,520,376,896,459
0130-001,2013,3,31,8,715,626,1341,896
0130-001,2013,3,31,9,1066,878,1944,1341
0130-001,2013,3,31,10,1209,1085,2294,1944
0130-001,2013,3,31,11,1166,1274,2440,2294
0130-001,2013,3,31,12,1074,1445,2519,2440
0130-001,2013,3,31,13,1321,1708,3029,2519
0130-001,2013,3,31,14,1518,1680,3198,3029
0130-001,2013,3,31,15,1609,1604,3213,3198
0130-001,2013,3,31,16,1824,1550,3374,3213
0130-001,2013,3,31,17,1821,1575,3396,3374
0130-001,2013,3,31,18,1905,1637,3542,3396
0130-001,2013,3,31,19,1804,1426,3230,3542
0130-001,2013,3,31,20,1440,1173,2613,3230
0130-001,2013,3,31,21,1216,1107,2323,2613
0130-001,2013,3,31,22,1020,746,1766,2323
0130-001,2013,3,31,23,705,544,1249,1766
0130-001,2013,3,31,24,510,390,900,1249
0130-001,2013,4,1,1,265,195,460,900
0130-001,2013,4,1,2,166,154,320,460
0130-001,2013,4,1,3,128,112,240,320
0130-001,2013,4,1,4,106,139,245,240
0130-001,2013,4,1,5,159,192,351,245
0130-001,2013,4,1,6,344,347,691,351
0130-001,2013,4,1,7,1317,805,2122,691
0130-001,2013,4,1,8,2213,1794,4007,2122
0130-001,2013,4,1,9,2117,2058,4175,4007
0130-001,2013,4,1,10,1622,1647,3269,4175
0130-001,2013,4,1,11,1774,1586,3360,3269
0130-001,2013,4,1,12,1687,1613,3300,3360
0130-001,2013,4,1,13,1422,1430,2852,3300
0130-001,2013,4,1,14,1716,1687,3403,2852
0130-001,2013,4,1,15,1823,1829,3652,3403
0130-001,2013,4,1,16,1693,1797,3490,3652
0130-001,2013,4,1,17,1705,1792,3497,3490
0130-001,2013,4,1,18,1679,2193,3872,3497
0130-001,2013,4,1,19,1783,2380,4163,3872
0130-001,2013,4,1,20,1432,1722,3154,4163
0130-001,2013,4,1,21,1170,1583,2753,3154
0130-001,2013,4,1,22,1151,1301,2452,2753
0130-001,2013,4,1,23,836,798,1634,2452
0130-001,2013,4,1,24,542,437,979,1634
0130-001,2013,4,2,1,369,331,700,979
0130-001,2013,4,2,2,214,213,427,700
0130-001,2013,4,2,3,171,149,320,427
0130-001,2013,4,2,4,144,130,274,320
0130-001,2013,4,2,5,152,198,350,274
0130-001,2013,4,2,6,298,323,621,350
0130-001,2013,4,2,7,1113,674,1787,621
0130-001,2013,4,2,8,1934,1676,3610,1787
0130-001,2013,4,2,9,2090,2024,4114,3610
0130-001,2013,4,2,10,1815,1739,3554,4114
0130-001,2013,4,2,11,1607,1689,3296,3554
0130-001,2013,4,2,12,1526,1493,3019,3296
0130-001,2013,4,2,13,1420,1368,2788,3019
0130-001,2013,4,2,14,1609,1654,3263,2788
0130-001,2013,4,2,15,1646,1688,3334,3263
0130-001,2013,4,2,16,1732,1687,3419,3334
0130-001,2013,4,2,17,1633,1770,3403,3419
0130-001,2013,4,2,18,1648,2135,3783,3403
0130-001,2013,4,2,19,1788,2309,4097,3783
0130-001,2013,4,2,20,1293,1603,2896,4097
0130-001,2013,4,2,21,1220,1612,2832,2896
0130-001,2013,4,2,22,1103,1281,2384,2832
0130-001,2013,4,2,23,833,811,1644,2384
0130-001,2013,4,2,24,570,461,1031,1644
0130-001,2013,4,3,1,372,315,687,1031
0130-001,2013,4,3,2,232,226,458,687
0130-001,2013,4,3,3,170,172,342,458
0130-001,2013,4,3,4,147,156,303,342
0130-001,2013,4,3,5,149,217,366,303
0130-001,2013,4,3,6,301,339,640,366
0130-001,2013,4,3,7,1245,718,1963,640
0130-001,2013,4,3,8,2242,1746,3988,1963
0130-001,2013,4,3,9,2208,2085,4293,3988
0130-001,2013,4,3,10,1763,1731,3494,4293
0130-001,2013,4,3,11,1700,1671,3371,3494
0130-001,2013,4,3,12,1558,1606,3164,3371
0130-001,2013,4,3,13,1356,1398,2754,3164
0130-001,2013,4,3,14,1728,1598,3326,2754
0130-001,2013,4,3,15,1680,1786,3466,3326
0130-001,2013,4,3,16,1768,1825,3593,3466
0130-001,2013,4,3,17,1693,1794,3487,3593
0130-001,2013,4,3,18,1708,2284,3992,3487
0130-001,2013,4,3,19,1837,2590,4427,3992
0130-001,2013,4,3,20,1431,1828,3259,4427
0130-001,2013,4,3,21,1208,1544,2752,3259
0130-001,2013,4,3,22,1276,1275,2551,2752
0130-001,2013,4,3,23,948,798,1746,2551
0130-001,2013,4,3,24,618,507,1125,1746
0130-001,2013,4,4,1,417,332,749,1125
0130-001,2013,4,4,2,240,226,466,749
0130-001,2013,4,4,3,175,201,376,466
0130-001,2013,4,4,4,160,155,315,376
0130-001,2013,4,4,5,151,203,354,315
0130-001,2013,4,4,6,287,358,645,354
0130-001,2013,4,4,7,1191,728,1919,645
0130-001,2013,4,4,8,2217,1726,3943,1919
0130-001,2013,4,4,9,2238,2039,4277,3943
0130-001,2013,4,4,10,1691,1782,3473,4277
0130-001,2013,4,4,11,1789,1585,3374,3473
0130-001,2013,4,4,12,1669,1571,3240,3374
0130-001,2013,4,4,13,1348,1482,2830,3240
0130-001,2013,4,4,14,1671,1612,3283,2830
0130-001,2013,4,4,15,1755,1727,3482,3283
0130-001,2013,4,4,16,1790,1689,3479,3482
0130-001,2013,4,4,17,1592,1776,3368,3479
0130-001,2013,4,4,18,1710,2263,3973,3368
0130-001,2013,4,4,19,1777,2455,4232,3973
0130-001,2013,4,4,20,1350,1751,3101,4232
0130-001,2013,4,4,21,1228,1627,2855,3101
0130-001,2013,4,4,22,1207,1301,2508,2855
0130-001,2013,4,4,23,913,828,1741,2508
0130-001,2013,4,4,24,631,508,1139,1741
0130-001,2013,4,5,1,422,355,777,1139
0130-001,2013,4,5,2,276,212,488,777
0130-001,2013,4,5,3,177,186,363,488
0130-001,2013,4,5,4,175,171,346,363
0130-001,2013,4,5,5,164,205,369,346
0130-001,2013,4,5,6,343,373,716,369
0130-001,2013,4,5,7,1222,725,1947,716
0130-001,2013,4,5,8,2234,1741,3975,1947
0130-001,2013,4,5,9,2134,2078,4212,3975
0130-001,2013,4,5,10,1721,1802,3523,4212
0130-001,2013,4,5,11,1816,1662,3478,3523
0130-001,2013,4,5,12,1564,1599,3163,3478
0130-001,2013,4,5,13,1486,1537,3023,3163
0130-001,2013,4,5,14,1755,1726,3481,3023
0130-001,2013,4,5,15,1885,1830,3715,3481
0130-001,2013,4,5,16,1823,1984,3807,3715
0130-001,2013,4,5,17,2051,1888,3939,3807
0130-001,2013,4,5,18,1940,2394,4334,3939
0130-001,2013,4,5,19,2027,2625,4652,4334
0130-001,2013,4,5,20,1661,2086,3747,4652
0130-001,2013,4,5,21,1443,1732,3175,3747
0130-001,2013,4,5,22,1337,1442,2779,3175
0130-001,2013,4,5,23,1003,916,1919,2779
0130-001,2013,4,5,24,737,639,1376,1919
0130-001,2013,4,6,1,510,431,941,1376
0130-001,2013,4,6,2,381,328,709,941
0130-001,2013,4,6,3,262,263,525,709
0130-001,2013,4,6,4,232,204,436,525
0130-001,2013,4,6,5,224,240,464,436
0130-001,2013,4,6,6,281,307,588,464
0130-001,2013,4,6,7,662,457,1119,588
0130-001,2013,4,6,8,1111,987,2098,1119
0130-001,2013,4,6,9,1408,1558,2966,2098
0130-001,2013,4,6,10,1425,1709,3134,2966
0130-001,2013,4,6,11,1521,1860,3381,3134
0130-001,2013,4,6,12,1589,2145,3734,3381
0130-001,2013,4,6,13,1559,2410,3969,3734
0130-001,2013,4,6,14,1652,2303,3955,3969
0130-001,2013,4,6,15,1735,2152,3887,3955
0130-001,2013,4,6,16,1754,1907,3661,3887
0130-001,2013,4,6,17,1711,1986,3697,3661
0130-001,2013,4,6,18,1891,2129,4020,3697
0130-001,2013,4,6,19,1802,1838,3640,4020
0130-001,2013,4,6,20,1259,1211,2470,3640
0130-001,2013,4,6,21,1081,1014,2095,2470
0130-001,2013,4,6,22,928,804,1732,2095
0130-001,2013,4,6,23,702,567,1269,1732
0130-001,2013,4,6,24,483,434,917,1269
0130-001,2013,4,7,1,356,326,682,917
0130-001,2013,4,7,2,271,241,512,682
0130-001,2013,4,7,3,205,166,371,512
0130-001,2013,4,7,4,185,134,319,371
0130-001,2013,4,7,5,163,128,291,319
0130-001,2013,4,7,6,193,235,428,291
0130-001,2013,4,7,7,444,352,796,428
0130-001,2013,4,7,8,589,545,1134,796
0130-001,2013,4,7,9,753,859,1612,1134
0130-001,2013,4,7,10,898,1038,1936,1612
0130-001,2013,4,7,11,1035,1356,2391,1936
0130-001,2013,4,7,12,1115,1333,2448,2391
0130-001,2013,4,7,13,1246,1499,2745,2448
0130-001,2013,4,7,14,1493,1486,2979,2745
0130-001,2013,4,7,15,1677,1634,3311,2979
0130-001,2013,4,7,16,1840,1546,3386,3311
0130-001,2013,4,7,17,1980,1544,3524,3386
0130-001,2013,4,7,18,1914,1536,3450,3524
0130-001,2013,4,7,19,2037,1308,3345,3450
0130-001,2013,4,7,20,1706,1184,2890,3345
0130-001,2013,4,7,21,1385,902,2287,2890
0130-001,2013,4,7,22,1132,796,1928,2287
0130-001,2013,4,7,23,684,517,1201,1928
0130-001,2013,4,7,24,430,355,785,1201
0130-001,2013,4,8,1,296,224,520,785
0130-001,2013,4,8,2,177,131,308,520
0130-001,2013,4,8,3,111,118,229,308
0130-001,2013,4,8,4,112,115,227,229
0130-001,2013,4,8,5,159,196,355,227
0130-001,2013,4,8,6,299,347,646,355
0130-001,2013,4,8,7,1348,816,2164,646
0130-001,2013,4,8,8,2170,1811,3981,2164
0130-001,2013,4,8,9,2217,2071,4288,3981
0130-001,2013,4,8,10,1746,1742,3488,4288
0130-001,2013,4,8,11,1755,1650,3405,3488
0130-001,2013,4,8,12,1592,1559,3151,3405
0130-001,2013,4,8,13,1419,1404,2823,3151
0130-001,2013,4,8,14,1711,1718,3429,2823
0130-001,2013,4,8,15,1805,1800,3605,3429
0130-001,2013,4,8,16,1778,1759,3537,3605
0130-001,2013,4,8,17,1595,1776,3371,3537
0130-001,2013,4,8,18,1641,2261,3902,3371
0130-001,2013,4,8,19,1853,2352,4205,3902
0130-001,2013,4,8,20,1286,1710,2996,4205
0130-001,2013,4,8,21,1236,1602,2838,2996
0130-001,2013,4,8,22,1131,1273,2404,2838
0130-001,2013,4,8,23,860,699,1559,2404
0130-001,2013,4,8,24,516,474,990,1559
0130-001,2013,4,9,1,354,326,680,990
0130-001,2013,4,9,2,197,217,414,680
0130-001,2013,4,9,3,155,155,310,414
0130-001,2013,4,9,4,130,130,260,310
0130-001,2013,4,9,5,161,207,368,260
0130-001,2013,4,9,6,314,339,653,368
0130-001,2013,4,9,7,1267,789,2056,653
0130-001,2013,4,9,8,2224,1772,3996,2056
0130-001,2013,4,9,9,2227,2050,4277,3996
0130-001,2013,4,9,10,1737,1765,3502,4277
0130-001,2013,4,9,11,1701,1586,3287,3502
0130-001,2013,4,9,12,1555,1512,3067,3287
0130-001,2013,4,9,13,1432,1433,2865,3067
0130-001,2013,4,9,14,1653,1650,3303,2865
0130-001,2013,4,9,15,1736,1768,3504,3303
0130-001,2013,4,9,16,1719,1755,3474,3504
0130-001,2013,4,9,17,1699,1927,3626,3474
0130-001,2013,4,9,18,1759,2304,4063,3626
0130-001,2013,4,9,19,1736,2502,4238,4063
0130-001,2013,4,9,20,1491,1765,3256,4238
0130-001,2013,4,9,21,1283,1582,2865,3256
0130-001,2013,4,9,22,1203,1296,2499,2865
0130-001,2013,4,9,23,888,817,1705,2499
0130-001,2013,4,9,24,561,465,1026,1705
0130-001,2013,4,10,1,347,311,658,1026
0130-001,2013,4,10,2,221,230,451,658
0130-001,2013,4,10,3,168,149,317,451
0130-001,2013,4,10,4,146,136,282,317
0130-001,2013,4,10,5,160,194,354,282
0130-001,2013,4,10,6,298,325,623,354
0130-001,2013,4,10,7,1173,767,1940,623
0130-001,2013,4,10,8,2210,1798,4008,1940
0130-001,2013,4,10,9,2224,2060,4284,4008
0130-001,2013,4,10,10,1706,1814,3520,4284
0130-001,2013,4,10,11,1720,1717,3437,3520
0130-001,2013,4,10,12,1626,1592,3218,3437
0130-001,2013,4,10,13,1407,1465,2872,3218
0130-001,2013,4,10,14,1681,1644,3325,2872
0130-001,2013,4,10,15,1775,1757,3532,3325
0130-001,2013,4,10,16,1736,1761,3497,3532
0130-001,2013,4,10,17,1650,1791,3441,3497
0130-001,2013,4,10,18,1765,2287,4052,3441
0130-001,2013,4,10,19,1871,2582,4453,4052
0130-001,2013,4,10,20,1490,1853,3343,4453
0130-001,2013,4,10,21,1230,1508,2738,3343
0130-001,2013,4,10,22,1266,1221,2487,2738
0130-001,2013,4,10,23,865,802,1667,2487
0130-001,2013,4,10,24,599,494,1093,1667
0130-001,2013,4,11,1,432,356,788,1093
0130-001,2013,4,11,2,234,234,468,788
0130-001,2013,4,11,3,171,155,326,468
0130-001,2013,4,11,4,164,168,332,326
0130-001,2013,4,11,5,146,205,351,332
0130-001,2013,4,11,6,306,338,644,351
0130-001,2013,4,11,7,1197,768,1965,644
0130-001,2013,4,11,8,2234,1720,3954,1965
0130-001,2013,4,11,9,2181,2020,4201,3954
0130-001,2013,4,11,10,1789,1748,3537,4201
0130-001,2013,4,11,11,1725,1613,3338,3537
0130-001,2013,4,11,12,1664,1632,3296,3338
0130-001,2013,4,11,13,1426,1452,2878,3296
0130-001,2013,4,11,14,1638,1664,3302,2878
0130-001,2013,4,11,15,1691,1745,3436,3302
0130-001,2013,4,11,16,1706,1812,3518,3436
0130-001,2013,4,11,17,1647,1908,3555,3518
0130-001,2013,4,11,18,1717,2239,3956,3555
0130-001,2013,4,11,19,1776,2440,4216,3956
0130-001,2013,4,11,20,1473,1759,3232,4216
0130-001,2013,4,11,21,1202,1611,2813,3232
0130-001,2013,4,11,22,1216,1277,2493,2813
0130-001,2013,4,11,23,938,811,1749,2493
0130-001,2013,4,11,24,596,477,1073,1749
0130-001,2013,4,12,1,407,334,741,1073
0130-001,2013,4,12,2,256,230,486,741
0130-001,2013,4,12,3,187,201,388,486
0130-001,2013,4,12,4,150,179,329,388
0130-001,2013,4,12,5,163,203,366,329
0130-001,2013,4,12,6,328,365,693,366
0130-001,2013,4,12,7,1253,716,1969,693
0130-001,2013,4,12,8,2212,1712,3924,1969
0130-001,2013,4,12,9,2185,2027,4212,3924
0130-001,2013,4,12,10,1768,1718,3486,4212
0130-001,2013,4,12,11,1695,1636,3331,3486
0130-001,2013,4,12,12,1677,1716,3393,3331
0130-001,2013,4,12,13,1502,1582,3084,3393
0130-001,2013,4,12,14,1720,1663,3383,3084
0130-001,2013,4,12,15,1806,1817,3623,3383
0130-001,2013,4,12,16,1823,1875,3698,3623
0130-001,2013,4,12,17,1664,2009,3673,3698
0130-001,2013,4,12,18,1961,2341,4302,3673
0130-001,2013,4,12,19,1999,2688,4687,4302
0130-001,2013,4,12,20,1684,2091,3775,4687
0130-001,2013,4,12,21,1401,1758,3159,3775
0130-001,2013,4,12,22,1308,1393,2701,3159
0130-001,2013,4,12,23,982,869,1851,2701
0130-001,2013,4,12,24,733,628,1361,1851
0130-001,2013,4,13,1,499,420,919,1361
0130-001,2013,4,13,2,317,324,641,919
0130-001,2013,4,13,3,245,191,436,641
0130-001,2013,4,13,4,195,209,404,436
0130-001,2013,4,13,5,218,264,482,404
0130-001,2013,4,13,6,364,386,750,482
0130-001,2013,4,13,7,911,674,1585,750
0130-001,2013,4,13,8,1416,1118,2534,1585
0130-001,2013,4,13,9,1633,1752,3385,2534
0130-001,2013,4,13,10,1658,2082,3740,3385
0130-001,2013,4,13,11,1679,2188,3867,3740
0130-001,2013,4,13,12,1532,2350,3882,3867
0130-001,2013,4,13,13,1526,2444,3970,3882
0130-001,2013,4,13,14,1775,2388,4163,3970
0130-001,2013,4,13,15,1831,2441,4272,4163
0130-001,2013,4,13,16,1998,2501,4499,4272
0130-001,2013,4,13,17,1930,2287,4217,4499
0130-001,2013,4,13,18,2054,2527,4581,4217
0130-001,2013,4,13,19,1874,2450,4324,4581
0130-001,2013,4,13,20,1576,1664,3240,4324
0130-001,2013,4,13,21,1328,1235,2563,3240
0130-001,2013,4,13,22,1413,1004,2417,2563
0130-001,2013,4,13,23,854,712,1566,2417
0130-001,2013,4,13,24,628,512,1140,1566
0130-001,2013,4,14,1,465,408,873,1140
0130-001,2013,4,14,2,320,264,584,873
0130-001,2013,4,14,3,247,225,472,584
0130-001,2013,4,14,4,179,156,335,472
0130-001,2013,4,14,5,189,183,372,335
0130-001,2013,4,14,6,220,239,459,372
0130-001,2013,4,14,7,414,362,776,459
0130-001,2013,4,14,8,649,620,1269,776
0130-001,2013,4,14,9,793,913,1706,1269
0130-001,2013,4,14,10,906,1043,1949,1706
0130-001,2013,4,14,11,1076,1319,2395,1949
0130-001,2013,4,14,12,1081,1183,2264,2395
0130-001,2013,4,14,13,1334,1453,2787,2264
0130-001,2013,4,14,14,1462,1526,2988,2787
0130-001,2013,4,14,15,1600,1547,3147,2988
0130-001,2013,4,14,16,1789,1493,3282,3147
0130-001,2013,4,14,17,1866,1567,3433,3282
0130-001,2013,4,14,18,2020,1516,3536,3433
0130-001,2013,4,14,19,1990,1315,3305,3536
0130-001,2013,4,14,20,1697,1145,2842,3305
0130-001,2013,4,14,21,1513,941,2454,2842
0130-001,2013,4,14,22,1228,785,2013,2454
0130-001,2013,4,14,23,715,541,1256,2013
0130-001,2013,4,14,24,475,329,804,1256
0130-001,2013,4,15,1,317,234,551,804
0130-001,2013,4,15,2,168,161,329,551
0130-001,2013,4,15,3,139,135,274,329
0130-001,2013,4,15,4,112,114,226,274
0130-001,2013,4,15,5,138,187,325,226
0130-001,2013,4,15,6,319,392,711,325
0130-001,2013,4,15,7,1342,799,2141,711
0130-001,2013,4,15,8,2225,1824,4049,2141
0130-001,2013,4,15,9,2264,2083,4347,4049
0130-001,2013,4,15,10,1718,1719,3437,4347
0130-001,2013,4,15,11,1673,1692,3365,3437
0130-001,2013,4,15,12,1610,1580,3190,3365
0130-001,2013,4,15,13,1422,1495,2917,3190
0130-001,2013,4,15,14,1685,1651,3336,2917
0130-001,2013,4,15,15,1741,1731,3472,3336
0130-001,2013,4,15,16,1837,1766,3603,3472
0130-001,2013,4,15,17,1737,1844,3581,3603
0130-001,2013,4,15,18,1698,2225,3923,3581
0130-001,2013,4,15,19,1754,2340,4094,3923
0130-001,2013,4,15,20,1331,1650,2981,4094
0130-001,2013,4,15,21,1177,1608,2785,2981
0130-001,2013,4,15,22,1133,1278,2411,2785
0130-001,2013,4,15,23,839,807,1646,2411
0130-001,2013,4,15,24,561,472,1033,1646
0130-001,2013,4,16,1,377,318,695,1033
0130-001,2013,4,16,2,228,200,428,695
0130-001,2013,4,16,3,178,175,353,428
0130-001,2013,4,16,4,129,141,270,353
0130-001,2013,4,16,5,146,211,357,270
0130-001,2013,4,16,6,318,362,680,357
0130-001,2013,4,16,7,1251,727,1978,680
0130-001,2013,4,16,8,2231,1810,4041,1978
0130-001,2013,4,16,9,2186,2041,4227,4041
0130-001,2013,4,16,10,1716,1742,3458,4227
0130-001,2013,4,16,11,1849,1745,3594,3458
0130-001,2013,4,16,12,1739,1614,3353,3594
0130-001,2013,4,16,13,1400,1479,2879,3353
0130-001,2013,4,16,14,1673,1700,3373,2879
0130-001,2013,4,16,15,1844,1689,3533,3373
0130-001,2013,4,16,16,1704,1816,3520,3533
0130-001,2013,4,16,17,1701,1905,3606,3520
0130-001,2013,4,16,18,1795,2291,4086,3606
0130-001,2013,4,16,19,1758,2429,4187,4086
0130-001,2013,4,16,20,1319,1686,3005,4187
0130-001,2013,4,16,21,1275,1587,2862,3005
0130-001,2013,4,16,22,1242,1348,2590,2862
0130-001,2013,4,16,23,929,820,1749,2590
0130-001,2013,4,16,24,585,536,1121,1749
0130-001,2013,4,17,1,413,306,719,1121
0130-001,2013,4,17,2,254,230,484,719
0130-001,2013,4,17,3,163,171,334,484
0130-001,2013,4,17,4,154,156,310,334
0130-001,2013,4,17,5,179,217,396,310
0130-001,2013,4,17,6,313,353,666,396
0130-001,2013,4,17,7,1149,722,1871,666
0130-001,2013,4,17,8,2192,1718,3910,1871
0130-001,2013,4,17,9,2181,2001,4182,3910
0130-001,2013,4,17,10,1764,1706,3470,4182
0130-001,2013,4,17,11,1650,1651,3301,3470
0130-001,2013,4,17,12,1639,1742,3381,3301
0130-001,2013,4,17,13,1418,1538,2956,3381
0130-001,2013,4,17,14,1662,1609,3271,2956
0130-001,2013,4,17,15,1721,1730,3451,3271
0130-001,2013,4,17,16,1763,1757,3520,3451
0130-001,2013,4,17,17,1669,1796,3465,3520
0130-001,2013,4,17,18,1770,2387,4157,3465
0130-001,2013,4,17,19,1929,2712,4641,4157
0130-001,2013,4,17,20,1492,1887,3379,4641
0130-001,2013,4,17,21,1315,1581,2896,3379
0130-001,2013,4,17,22,1208,1229,2437,2896
0130-001,2013,4,17,23,910,820,1730,2437
0130-001,2013,4,17,24,624,547,1171,1730
0130-001,2013,4,18,1,430,327,757,1171
0130-001,2013,4,18,2,228,265,493,757
0130-001,2013,4,18,3,176,170,346,493
0130-001,2013,4,18,4,143,161,304,346
0130-001,2013,4,18,5,176,204,380,304
0130-001,2013,4,18,6,318,379,697,380
0130-001,2013,4,18,7,1191,736,1927,697
0130-001,2013,4,18,8,2207,1768,3975,1927
0130-001,2013,4,18,9,2189,2014,4203,3975
0130-001,2013,4,18,10,1777,1742,3519,4203
0130-001,2013,4,18,11,1694,1651,3345,3519
0130-001,2013,4,18,12,1629,1569,3198,3345
0130-001,2013,4,18,13,1411,1442,2853,3198
0130-001,2013,4,18,14,1823,1604,3427,2853
0130-001,2013,4,18,15,1767,1683,3450,3427
0130-001,2013,4,18,16,1658,1814,3472,3450
0130-001,2013,4,18,17,1683,1928,3611,3472
0130-001,2013,4,18,18,1792,2326,4118,3611
0130-001,2013,4,18,19,1788,2547,4335,4118
0130-001,2013,4,18,20,1491,1690,3181,4335
0130-001,2013,4,18,21,1244,1651,2895,3181
0130-001,2013,4,18,22,1234,1270,2504,2895
0130-001,2013,4,18,23,936,856,1792,2504
0130-001,2013,4,18,24,636,516,1152,1792
0130-001,2013,4,19,1,420,342,762,1152
0130-001,2013,4,19,2,255,243,498,762
0130-001,2013,4,19,3,189,171,360,498
0130-001,2013,4,19,4,149,156,305,360
0130-001,2013,4,19,5,186,227,413,305
0130-001,2013,4,19,6,349,383,732,413
0130-001,2013,4,19,7,1208,756,1964,732
0130-001,2013,4,19,8,2199,1757,3956,1964
0130-001,2013,4,19,9,2226,2004,4230,3956
0130-001,2013,4,19,10,1846,1797,3643,4230
0130-001,2013,4,19,11,1850,1655,3505,3643
0130-001,2013,4,19,12,1647,1627,3274,3505
0130-001,2013,4,19,13,1394,1494,2888,3274
0130-001,2013,4,19,14,1636,1747,3383,2888
0130-001,2013,4,19,15,1812,1852,3664,3383
0130-001,2013,4,19,16,1851,1951,3802,3664
0130-001,2013,4,19,17,1817,1995,3812,3802
0130-001,2013,4,19,18,1927,2414,4341,3812
0130-001,2013,4,19,19,1937,2635,4572,4341
0130-001,2013,4,19,20,1720,2005,3725,4572
0130-001,2013,4,19,21,1385,1773,3158,3725
0130-001,2013,4,19,22,1331,1340,2671,3158
0130-001,2013,4,19,23,1001,919,1920,2671
0130-001,2013,4,19,24,704,607,1311,1920
0130-001,2013,4,20,1,505,415,920,1311
0130-001,2013,4,20,2,354,316,670,920
0130-001,2013,4,20,3,289,251,540,670
0130-001,2013,4,20,4,232,205,437,540
0130-001,2013,4,20,5,241,262,503,437
0130-001,2013,4,20,6,342,371,713,503
0130-001,2013,4,20,7,728,533,1261,713
0130-001,2013,4,20,8,1229,1097,2326,1261
0130-001,2013,4,20,9,1453,1681,3134,2326
0130-001,2013,4,20,10,1587,1786,3373,3134
0130-001,2013,4,20,11,1609,2081,3690,3373
0130-001,2013,4,20,12,1647,2293,3940,3690
0130-001,2013,4,20,13,1506,2397,3903,3940
0130-001,2013,4,20,14,1616,2352,3968,3903
0130-001,2013,4,20,15,1673,2352,4025,3968
0130-001,2013,4,20,16,1788,2282,4070,4025
0130-001,2013,4,20,17,1808,1904,3712,4070
0130-001,2013,4,20,18,1923,2538,4461,3712
0130-001,2013,4,20,19,1781,2275,4056,4461
0130-001,2013,4,20,20,1380,1529,2909,4056
0130-001,2013,4,20,21,1197,1137,2334,2909
0130-001,2013,4,20,22,1035,909,1944,2334
0130-001,2013,4,20,23,764,595,1359,1944
0130-001,2013,4,20,24,575,488,1063,1359
0130-001,2013,4,21,1,386,341,727,1063
0130-001,2013,4,21,2,280,279,559,727
0130-001,2013,4,21,3,257,180,437,559
0130-001,2013,4,21,4,185,179,364,437
0130-001,2013,4,21,5,184,158,342,364
0130-001,2013,4,21,6,241,289,530,342
0130-001,2013,4,21,7,588,428,1016,530
0130-001,2013,4,21,8,751,648,1399,1016
0130-001,2013,4,21,9,1001,1067,2068,1399
0130-001,2013,4,21,10,999,1083,2082,2068
0130-001,2013,4,21,11,1149,1397,2546,2082
0130-001,2013,4,21,12,1238,1471,2709,2546
0130-001,2013,4,21,13,1419,1573,2992,2709
0130-001,2013,4,21,14,1474,1517,2991,2992
0130-001,2013,4,21,15,1575,1640,3215,2991
0130-001,2013,4,21,16,1671,1584,3255,3215
0130-001,2013,4,21,17,1750,1545,3295,3255
0130-001,2013,4,21,18,1774,1704,3478,3295
0130-001,2013,4,21,19,1876,1388,3264,3478
0130-001,2013,4,21,20,1504,1208,2712,3264
0130-001,2013,4,21,21,1336,1084,2420,2712
0130-001,2013,4,21,22,1211,859,2070,2420
0130-001,2013,4,21,23,758,596,1354,2070
0130-001,2013,4,21,24,470,377,847,1354
0130-001,2013,4,22,1,282,237,519,847
0130-001,2013,4,22,2,181,146,327,519
0130-001,2013,4,22,3,121,118,239,327
0130-001,2013,4,22,4,111,132,243,239
0130-001,2013,4,22,5,172,202,374,243
0130-001,2013,4,22,6,378,404,782,374
0130-001,2013,4,22,7,1442,830,2272,782
0130-001,2013,4,22,8,2221,1830,4051,2272
0130-001,2013,4,22,9,2255,2048,4303,4051
0130-001,2013,4,22,10,1780,1795,3575,4303
0130-001,2013,4,22,11,1613,1660,3273,3575
0130-001,2013,4,22,12,1666,1562,3228,3273
0130-001,2013,4,22,13,1369,1419,2788,3228
0130-001,2013,4,22,14,1740,1676,3416,2788
0130-001,2013,4,22,15,1685,1705,3390,3416
0130-001,2013,4,22,16,1800,1806,3606,3390
0130-001,2013,4,22,17,1647,1835,3482,3606
0130-001,2013,4,22,18,1756,2289,4045,3482
0130-001,2013,4,22,19,1827,2466,4293,4045
0130-001,2013,4,22,20,1387,1789,3176,4293
0130-001,2013,4,22,21,1210,1650,2860,3176
0130-001,2013,4,22,22,1146,1328,2474,2860
0130-001,2013,4,22,23,889,800,1689,2474
0130-001,2013,4,22,24,604,515,1119,1689
0130-001,2013,4,23,1,385,289,674,1119
0130-001,2013,4,23,2,249,221,470,674
0130-001,2013,4,23,3,170,167,337,470
0130-001,2013,4,23,4,137,164,301,337
0130-001,2013,4,23,5,168,196,364,301
0130-001,2013,4,23,6,335,362,697,364
0130-001,2013,4,23,7,1235,694,1929,697
0130-001,2013,4,23,8,2242,1800,4042,1929
0130-001,2013,4,23,9,2251,2076,4327,4042
0130-001,2013,4,23,10,1710,1802,3512,4327
0130-001,2013,4,23,11,1674,1750,3424,3512
0130-001,2013,4,23,12,1696,1583,3279,3424
0130-001,2013,4,23,13,1438,1467,2905,3279
0130-001,2013,4,23,14,1646,1717,3363,2905
0130-001,2013,4,23,15,1671,1706,3377,3363
0130-001,2013,4,23,16,1695,1691,3386,3377
0130-001,2013,4,23,17,1646,1739,3385,3386
0130-001,2013,4,23,18,1659,2155,3814,3385
0130-001,2013,4,23,19,1660,2286,3946,3814
0130-001,2013,4,23,20,1282,1556,2838,3946
0130-001,2013,4,23,21,1207,1510,2717,2838
0130-001,2013,4,23,22,1119,1289,2408,2717
0130-001,2013,4,23,23,839,736,1575,2408
0130-001,2013,4,23,24,537,537,1074,1575
0130-001,2013,4,24,1,345,329,674,1074
0130-001,2013,4,24,2,260,214,474,674
0130-001,2013,4,24,3,172,168,340,474
0130-001,2013,4,24,4,154,154,308,340
0130-001,2013,4,24,5,159,208,367,308
0130-001,2013,4,24,6,314,351,665,367
0130-001,2013,4,24,7,1124,660,1784,665
0130-001,2013,4,24,8,2160,1713,3873,1784
0130-001,2013,4,24,9,2234,2070,4304,3873
0130-001,2013,4,24,10,1797,1794,3591,4304
0130-001,2013,4,24,11,1785,1721,3506,3591
0130-001,2013,4,24,12,1685,1600,3285,3506
0130-001,2013,4,24,13,1422,1425,2847,3285
0130-001,2013,4,24,14,1642,1660,3302,2847
0130-001,2013,4,24,15,1802,1778,3580,3302
0130-001,2013,4,24,16,1830,1733,3563,3580
0130-001,2013,4,24,17,1688,1764,3452,3563
0130-001,2013,4,24,18,1836,2223,4059,3452
0130-001,2013,4,24,19,1834,2610,4444,4059
0130-001,2013,4,24,20,1423,1791,3214,4444
0130-001,2013,4,24,21,1268,1660,2928,3214
0130-001,2013,4,24,22,1195,1294,2489,2928
0130-001,2013,4,24,23,883,797,1680,2489
0130-001,2013,4,24,24,631,555,1186,1680
0130-001,2013,4,25,1,454,357,811,1186
0130-001,2013,4,25,2,267,233,500,811
0130-001,2013,4,25,3,183,194,377,500
0130-001,2013,4,25,4,171,175,346,377
0130-001,2013,4,25,5,170,232,402,346
0130-001,2013,4,25,6,320,351,671,402
0130-001,2013,4,25,7,1249,735,1984,671
0130-001,2013,4,25,8,2182,1733,3915,1984
0130-001,2013,4,25,9,2210,2082,4292,3915
0130-001,2013,4,25,10,1698,1765,3463,4292
0130-001,2013,4,25,11,1765,1662,3427,3463
0130-001,2013,4,25,12,1589,1585,3174,3427
0130-001,2013,4,25,13,1417,1504,2921,3174
0130-001,2013,4,25,14,1636,1681,3317,2921
0130-001,2013,4,25,15,1729,1709,3438,3317
0130-001,2013,4,25,16,1777,1819,3596,3438
0130-001,2013,4,25,17,1647,1831,3478,3596
0130-001,2013,4,25,18,1725,2178,3903,3478
0130-001,2013,4,25,19,1792,2475,4267,3903
0130-001,2013,4,25,20,1379,1715,3094,4267
0130-001,2013,4,25,21,1212,1591,2803,3094
0130-001,2013,4,25,22,1190,1344,2534,2803
0130-001,2013,4,25,23,932,755,1687,2534
0130-001,2013,4,25,24,668,537,1205,1687
0130-001,2013,4,26,1,425,364,789,1205
0130-001,2013,4,26,2,283,236,519,789
0130-001,2013,4,26,3,197,201,398,519
0130-001,2013,4,26,4,140,180,320,398
0130-001,2013,4,26,5,206,234,440,320
0130-001,2013,4,26,6,382,396,778,440
0130-001,2013,4,26,7,1292,761,2053,778
0130-001,2013,4,26,8,2257,1763,4020,2053
0130-001,2013,4,26,9,2222,2131,4353,4020
0130-001,2013,4,26,10,1743,1821,3564,4353
0130-001,2013,4,26,11,1754,1623,3377,3564
0130-001,2013,4,26,12,1659,1657,3316,3377
0130-001,2013,4,26,13,1373,1470,2843,3316
0130-001,2013,4,26,14,1683,1654,3337,2843
0130-001,2013,4,26,15,1827,1793,3620,3337
0130-001,2013,4,26,16,1843,1906,3749,3620
0130-001,2013,4,26,17,1740,2000,3740,3749
0130-001,2013,4,26,18,1857,2440,4297,3740
0130-001,2013,4,26,19,1996,2677,4673,4297
0130-001,2013,4,26,20,1645,2048,3693,4673
0130-001,2013,4,26,21,1330,1696,3026,3693
0130-001,2013,4,26,22,1236,1415,2651,3026
0130-001,2013,4,26,23,1041,882,1923,2651
0130-001,2013,4,26,24,803,676,1479,1923
0130-001,2013,4,27,1,525,454,979,1479
0130-001,2013,4,27,2,351,278,629,979
0130-001,2013,4,27,3,256,238,494,629
0130-001,2013,4,27,4,245,213,458,494
0130-001,2013,4,27,5,247,277,524,458
0130-001,2013,4,27,6,381,375,756,524
0130-001,2013,4,27,7,915,655,1570,756
0130-001,2013,4,27,8,1531,1181,2712,1570
0130-001,2013,4,27,9,1659,1823,3482,2712
0130-001,2013,4,27,10,1717,1973,3690,3482
0130-001,2013,4,27,11,1673,2049,3722,3690
0130-001,2013,4,27,12,1729,2170,3899,3722
0130-001,2013,4,27,13,1702,2480,4182,3899
0130-001,2013,4,27,14,1768,2217,3985,4182
0130-001,2013,4,27,15,1773,2174,3947,3985
0130-001,2013,4,27,16,1821,2137,3958,3947
0130-001,2013,4,27,17,1717,2149,3866,3958
0130-001,2013,4,27,18,1887,2322,4209,3866
0130-001,2013,4,27,19,1775,2190,3965,4209
0130-001,2013,4,27,20,1399,1456,2855,3965
0130-001,2013,4,27,21,1164,1144,2308,2855
0130-001,2013,4,27,22,1118,962,2080,2308
0130-001,2013,4,27,23,815,712,1527,2080
0130-001,2013,4,27,24,572,475,1047,1527
0130-001,2013,4,28,1,430,339,769,1047
0130-001,2013,4,28,2,299,268,567,769
0130-001,2013,4,28,3,245,210,455,567
0130-001,2013,4,28,4,183,159,342,455
0130-001,2013,4,28,5,194,138,332,342
0130-001,2013,4,28,6,283,259,542,332
0130-001,2013,4,28,7,613,431,1044,542
0130-001,2013,4,28,8,858,674,1532,1044
0130-001,2013,4,28,9,953,963,1916,1532
0130-001,2013,4,28,10,966,1109,2075,1916
0130-001,2013,4,28,11,1091,1356,2447,2075
0130-001,2013,4,28,12,1129,1356,2485,2447
0130-001,2013,4,28,13,1257,1411,2668,2485
0130-001,2013,4,28,14,1357,1302,2659,2668
0130-001,2013,4,28,15,1518,1416,2934,2659
0130-001,2013,4,28,16,1721,1430,3151,2934
0130-001,2013,4,28,17,1819,1621,3440,3151
0130-001,2013,4,28,18,2029,1621,3650,3440
0130-001,2013,4,28,19,1929,1442,3371,3650
0130-001,2013,4,28,20,1793,1293,3086,3371
0130-001,2013,4,28,21,1591,1107,2698,3086
0130-001,2013,4,28,22,1279,853,2132,2698
0130-001,2013,4,28,23,774,534,1308,2132
0130-001,2013,4,28,24,530,430,960,1308
0130-001,2013,4,29,1,313,257,570,960
0130-001,2013,4,29,2,182,162,344,570
0130-001,2013,4,29,3,125,112,237,344
0130-001,2013,4,29,4,109,123,232,237
0130-001,2013,4,29,5,153,192,345,232
0130-001,2013,4,29,6,324,383,707,345
0130-001,2013,4,29,7,1222,748,1970,707
0130-001,2013,4,29,8,2060,1769,3829,1970
0130-001,2013,4,29,9,2242,2063,4305,3829
0130-001,2013,4,29,10,1718,1748,3466,4305
0130-001,2013,4,29,11,1554,1656,3210,3466
0130-001,2013,4,29,12,1575,1547,3122,3210
0130-001,2013,4,29,13,1460,1388,2848,3122
0130-001,2013,4,29,14,1710,1716,3426,2848
0130-001,2013,4,29,15,1741,1852,3593,3426
0130-001,2013,4,29,16,1748,1779,3527,3593
0130-001,2013,4,29,17,1663,1782,3445,3527
0130-001,2013,4,29,18,1643,2114,3757,3445
0130-001,2013,4,29,19,1849,2304,4153,3757
0130-001,2013,4,29,20,1364,1763,3127,4153
0130-001,2013,4,29,21,1229,1630,2859,3127
0130-001,2013,4,29,22,1213,1396,2609,2859
0130-001,2013,4,29,23,913,824,1737,2609
0130-001,2013,4,29,24,586,484,1070,1737
0130-001,2013,4,30,1,369,317,686,1070
0130-001,2013,4,30,2,237,240,477,686
0130-001,2013,4,30,3,180,150,330,477
0130-001,2013,4,30,4,164,170,334,330
0130-001,2013,4,30,5,186,223,409,334
0130-001,2013,4,30,6,368,393,761,409
0130-001,2013,4,30,7,1343,755,2098,761
0130-001,2013,4,30,8,2223,1769,3992,2098
0130-001,2013,4,30,9,2245,2076,4321,3992
0130-001,2013,4,30,10,1846,1736,3582,4321
0130-001,2013,4,30,11,1764,1728,3492,3582
0130-001,2013,4,30,12,1673,1636,3309,3492
0130-001,2013,4,30,13,1480,1435,2915,3309
0130-001,2013,4,30,14,1758,1788,3546,2915
0130-001,2013,4,30,15,1823,1797,3620,3546
0130-001,2013,4,30,16,1820,1821,3641,3620
0130-001,2013,4,30,17,1755,1919,3674,3641
0130-001,2013,4,30,18,1791,2344,4135,3674
0130-001,2013,4,30,19,1862,2629,4491,4135
0130-001,2013,4,30,20,1532,2096,3628,4491
0130-001,2013,4,30,21,1385,1818,3203,3628
0130-001,2013,4,30,22,1244,1347,2591,3203
0130-001,2013,4,30,23,1036,903,1939,2591
0130-001,2013,4,30,24,718,667,1385,1939
0130-001,2013,5,1,1,466,428,894,1385
0130-001,2013,5,1,2,342,314,656,894
0130-001,2013,5,1,3,238,205,443,656
0130-001,2013,5,1,4,191,196,387,443
0130-001,2013,5,1,5,225,230,455,387
0130-001,2013,5,1,6,349,352,701,455
0130-001,2013,5,1,7,988,650,1638,701
0130-001,2013,5,1,8,1725,1394,3119,1638
0130-001,2013,5,1,9,1693,1680,3373,3119
0130-001,2013,5,1,10,1592,1584,3176,3373
0130-001,2013,5,1,11,1650,1534,3184,3176
0130-001,2013,5,1,12,1513,1460,2973,3184
0130-001,2013,5,1,13,1434,1515,2949,2973
0130-001,2013,5,1,14,1563,1726,3289,2949
0130-001,2013,5,1,15,1614,1805,3419,3289
0130-001,2013,5,1,16,1657,1817,3474,3419
0130-001,2013,5,1,17,1683,1792,3475,3474
0130-001,2013,5,1,18,1754,2068,3822,3475
0130-001,2013,5,1,19,1662,1925,3587,3822
0130-001,2013,5,1,20,1325,1452,2777,3587
0130-001,2013,5,1,21,1191,1109,2300,2777
0130-001,2013,5,1,22,1112,954,2066,2300
0130-001,2013,5,1,23,803,616,1419,2066
0130-001,2013,5,1,24,543,443,986,1419
0130-001,2013,5,2,1,348,288,636,986
0130-001,2013,5,2,2,229,182,411,636
0130-001,2013,5,2,3,144,156,300,411
0130-001,2013,5,2,4,137,142,279,300
0130-001,2013,5,2,5,181,220,401,279
0130-001,2013,5,2,6,365,399,764,401
0130-001,2013,5,2,7,1367,813,2180,764
0130-001,2013,5,2,8,2175,1796,3971,2180
0130-001,2013,5,2,9,2301,2082,4383,3971
0130-001,2013,5,2,10,1816,1797,3613,4383
0130-001,2013,5,2,11,1898,1655,3553,3613
0130-001,2013,5,2,12,1664,1607,3271,3553
0130-001,2013,5,2,13,1568,1467,3035,3271
0130-001,2013,5,2,14,1654,1679,3333,3035
0130-001,2013,5,2,15,1788,1783,3571,3333
0130-001,2013,5,2,16,1774,1791,3565,3571
0130-001,2013,5,2,17,1745,1920,3665,3565
0130-001,2013,5,2,18,1689,2371,4060,3665
0130-001,2013,5,2,19,1819,2495,4314,4060
0130-001,2013,5,2,20,1403,1780,3183,4314
0130-001,2013,5,2,21,1252,1679,2931,3183
0130-001,2013,5,2,22,1112,1296,2408,2931
0130-001,2013,5,2,23,897,853,1750,2408
0130-001,2013,5,2,24,651,525,1176,1750
0130-001,2013,5,3,1,429,368,797,1176
0130-001,2013,5,3,2,241,207,448,797
0130-001,2013,5,3,3,197,196,393,448
0130-001,2013,5,3,4,147,165,312,393
0130-001,2013,5,3,5,178,209,387,312
0130-001,2013,5,3,6,345,384,729,387
0130-001,2013,5,3,7,1313,776,2089,729
0130-001,2013,5,3,8,2247,1812,4059,2089
0130-001,2013,5,3,9,2223,2074,4297,4059
0130-001,2013,5,3,10,1662,1734,3396,4297
0130-001,2013,5,3,11,1752,1690,3442,3396
0130-001,2013,5,3,12,1655,1748,3403,3442
0130-001,2013,5,3,13,1593,1481,3074,3403
0130-001,2013,5,3,14,1734,1733,3467,3074
0130-001,2013,5,3,15,1825,1851,3676,3467
0130-001,2013,5,3,16,1952,1932,3884,3676
0130-001,2013,5,3,17,1766,1937,3703,3884
0130-001,2013,5,3,18,1871,2569,4440,3703
0130-001,2013,5,3,19,2027,2718,4745,4440
0130-001,2013,5,3,20,1627,2210,3837,4745
0130-001,2013,5,3,21,1362,1970,3332,3837
0130-001,2013,5,3,22,1236,1650,2886,3332
0130-001,2013,5,3,23,980,1186,2166,2886
0130-001,2013,5,3,24,690,672,1362,2166
0130-001,2013,5,4,1,473,429,902,1362
0130-001,2013,5,4,2,350,309,659,902
0130-001,2013,5,4,3,250,239,489,659
0130-001,2013,5,4,4,216,193,409,489
0130-001,2013,5,4,5,231,287,518,409
0130-001,2013,5,4,6,396,447,843,518
0130-001,2013,5,4,7,1010,621,1631,843
0130-001,2013,5,4,8,1409,1109,2518,1631
0130-001,2013,5,4,9,1577,1757,3334,2518
0130-001,2013,5,4,10,1735,1926,3661,3334
0130-001,2013,5,4,11,1713,2217,3930,3661
0130-001,2013,5,4,12,1687,2410,4097,3930
0130-001,2013,5,4,13,1654,2560,4214,4097
0130-001,2013,5,4,14,1786,2495,4281,4214
0130-001,2013,5,4,15,1889,2400,4289,4281
0130-001,2013,5,4,16,1874,2455,4329,4289
0130-001,2013,5,4,17,2021,2374,4395,4329
0130-001,2013,5,4,18,2045,2492,4537,4395
0130-001,2013,5,4,19,2061,2336,4397,4537
0130-001,2013,5,4,20,1543,1727,3270,4397
0130-001,2013,5,4,21,1296,1393,2689,3270
0130-001,2013,5,4,22,1164,1236,2400,2689
0130-001,2013,5,4,23,859,697,1556,2400
0130-001,2013,5,4,24,604,503,1107,1556
0130-001,2013,5,5,1,383,349,732,1107
0130-001,2013,5,5,2,276,211,487,732
0130-001,2013,5,5,3,217,190,407,487
0130-001,2013,5,5,4,181,143,324,407
0130-001,2013,5,5,5,182,168,350,324
0130-001,2013,5,5,6,263,269,532,350
0130-001,2013,5,5,7,560,435,995,532
0130-001,2013,5,5,8,665,673,1338,995
0130-001,2013,5,5,9,836,929,1765,1338
0130-001,2013,5,5,10,998,1261,2259,1765
0130-001,2013,5,5,11,1195,1466,2661,2259
0130-001,2013,5,5,12,1361,1383,2744,2661
0130-001,2013,5,5,13,1341,1447,2788,2744
0130-001,2013,5,5,14,1461,1423,2884,2788
0130-001,2013,5,5,15,1647,1543,3190,2884
0130-001,2013,5,5,16,1949,1501,3450,3190
0130-001,2013,5,5,17,2016,1658,3674,3450
0130-001,2013,5,5,18,1977,1657,3634,3674
0130-001,2013,5,5,19,1886,1398,3284,3634
0130-001,2013,5,5,20,1768,1344,3112,3284
0130-001,2013,5,5,21,1665,1166,2831,3112
0130-001,2013,5,5,22,1442,967,2409,2831
0130-001,2013,5,5,23,950,641,1591,2409
0130-001,2013,5,5,24,552,402,954,1591
0130-001,2013,5,6,1,297,235,532,954
0130-001,2013,5,6,2,189,151,340,532
0130-001,2013,5,6,3,129,122,251,340
0130-001,2013,5,6,4,121,123,244,251
0130-001,2013,5,6,5,171,217,388,244
0130-001,2013,5,6,6,407,396,803,388
0130-001,2013,5,6,7,1481,908,2389,803
0130-001,2013,5,6,8,2213,1861,4074,2389
0130-001,2013,5,6,9,2239,2080,4319,4074
0130-001,2013,5,6,10,1724,1784,3508,4319
0130-001,2013,5,6,11,1672,1664,3336,3508
0130-001,2013,5,6,12,1666,1512,3178,3336
0130-001,2013,5,6,13,1701,1441,3142,3178
0130-001,2013,5,6,14,1729,1798,3527,3142
0130-001,2013,5,6,15,1794,1800,3594,3527
0130-001,2013,5,6,16,1773,1784,3557,3594
0130-001,2013,5,6,17,1673,1935,3608,3557
0130-001,2013,5,6,18,1765,2350,4115,3608
0130-001,2013,5,6,19,1799,2484,4283,4115
0130-001,2013,5,6,20,1453,1893,3346,4283
0130-001,2013,5,6,21,1302,1765,3067,3346
0130-001,2013,5,6,22,1107,1371,2478,3067
0130-001,2013,5,6,23,882,792,1674,2478
0130-001,2013,5,6,24,529,511,1040,1674
0130-001,2013,5,7,1,368,304,672,1040
0130-001,2013,5,7,2,214,223,437,672
0130-001,2013,5,7,3,173,168,341,437
0130-001,2013,5,7,4,146,145,291,341
0130-001,2013,5,7,5,186,223,409,291
0130-001,2013,5,7,6,384,398,782,409
0130-001,2013,5,7,7,1397,820,2217,782
0130-001,2013,5,7,8,2194,1813,4007,2217
0130-001,2013,5,7,9,2274,2042,4316,4007
0130-001,2013,5,7,10,1755,1732,3487,4316
0130-001,2013,5,7,11,1868,1730,3598,3487
0130-001,2013,5,7,12,1700,1612,3312,3598
0130-001,2013,5,7,13,1546,1403,2949,3312
0130-001,2013,5,7,14,1758,1609,3367,2949
0130-001,2013,5,7,15,1421,1490,2911,3367
0130-001,2013,5,7,16,1813,1953,3766,2911
0130-001,2013,5,7,17,1880,1890,3770,3766
0130-001,2013,5,7,18,1823,2473,4296,3770
0130-001,2013,5,7,19,1870,2587,4457,4296
0130-001,2013,5,7,20,1528,1869,3397,4457
0130-001,2013,5,7,21,1409,1806,3215,3397
0130-001,2013,5,7,22,1285,1450,2735,3215
0130-001,2013,5,7,23,967,859,1826,2735
0130-001,2013,5,7,24,625,550,1175,1826
0130-001,2013,5,8,1,376,351,727,1175
0130-001,2013,5,8,2,238,208,446,727
0130-001,2013,5,8,3,181,181,362,446
0130-001,2013,5,8,4,163,177,340,362
0130-001,2013,5,8,5,182,208,390,340
0130-001,2013,5,8,6,402,420,822,390
0130-001,2013,5,8,7,1321,816,2137,822
0130-001,2013,5,8,8,2240,1775,4015,2137
0130-001,2013,5,8,9,2219,2075,4294,4015
0130-001,2013,5,8,10,1851,1767,3618,4294
0130-001,2013,5,8,11,1879,1710,3589,3618
0130-001,2013,5,8,12,1774,1632,3406,3589
0130-001,2013,5,8,13,1679,1550,3229,3406
0130-001,2013,5,8,14,1791,1715,3506,3229
0130-001,2013,5,8,15,1888,1905,3793,3506
0130-001,2013,5,8,16,1792,1936,3728,3793
0130-001,2013,5,8,17,1854,1934,3788,3728
0130-001,2013,5,8,18,1973,2569,4542,3788
0130-001,2013,5,8,19,2026,2718,4744,4542
0130-001,2013,5,8,20,1633,2102,3735,4744
0130-001,2013,5,8,21,1428,1785,3213,3735
0130-001,2013,5,8,22,1329,1472,2801,3213
0130-001,2013,5,8,23,995,935,1930,2801
0130-001,2013,5,8,24,582,512,1094,1930
0130-001,2013,5,9,1,371,325,696,1094
0130-001,2013,5,9,2,235,233,468,696
0130-001,2013,5,9,3,186,164,350,468
0130-001,2013,5,9,4,145,156,301,350
0130-001,2013,5,9,5,157,228,385,301
0130-001,2013,5,9,6,389,404,793,385
0130-001,2013,5,9,7,1316,823,2139,793
0130-001,2013,5,9,8,2220,1774,3994,2139
0130-001,2013,5,9,9,2225,2125,4350,3994
0130-001,2013,5,9,10,1889,1791,3680,4350
0130-001,2013,5,9,11,1824,1659,3483,3680
0130-001,2013,5,9,12,1664,1601,3265,3483
0130-001,2013,5,9,13,1495,1406,2901,3265
0130-001,2013,5,9,14,1760,1667,3427,2901
0130-001,2013,5,9,15,1727,1778,3505,3427
0130-001,2013,5,9,16,1836,1812,3648,3505
0130-001,2013,5,9,17,1641,1791,3432,3648
0130-001,2013,5,9,18,1784,2287,4071,3432
0130-001,2013,5,9,19,1716,1958,3674,4071
0130-001,2013,5,9,20,1349,1989,3338,3674
0130-001,2013,5,9,21,1222,1635,2857,3338
0130-001,2013,5,9,22,1153,1347,2500,2857
0130-001,2013,5,9,23,945,822,1767,2500
0130-001,2013,5,9,24,645,506,1151,1767
0130-001,2013,5,10,1,410,337,747,1151
0130-001,2013,5,10,2,272,249,521,747
0130-001,2013,5,10,3,172,192,364,521
0130-001,2013,5,10,4,167,153,320,364
0130-001,2013,5,10,5,158,196,354,320
0130-001,2013,5,10,6,314,328,642,354
0130-001,2013,5,10,7,1021,648,1669,642
0130-001,2013,5,10,8,2095,1619,3714,1669
0130-001,2013,5,10,9,2149,2017,4166,3714
0130-001,2013,5,10,10,1704,1731,3435,4166
0130-001,2013,5,10,11,1664,1765,3429,3435
0130-001,2013,5,10,12,1750,1789,3539,3429
0130-001,2013,5,10,13,1635,1507,3142,3539
0130-001,2013,5,10,14,1772,1710,3482,3142
0130-001,2013,5,10,15,1746,1969,3715,3482
0130-001,2013,5,10,16,1848,2009,3857,3715
0130-001,2013,5,10,17,1758,1870,3628,3857
0130-001,2013,5,10,18,1849,2566,4415,3628
0130-001,2013,5,10,19,2018,2590,4608,4415
0130-001,2013,5,10,20,1467,1921,3388,4608
0130-001,2013,5,10,21,1394,1771,3165,3388
0130-001,2013,5,10,22,1314,1427,2741,3165
0130-001,2013,5,10,23,1267,896,2163,2741
0130-001,2013,5,10,24,726,602,1328,2163
0130-001,2013,5,11,1,483,469,952,1328
0130-001,2013,5,11,2,373,326,699,952
0130-001,2013,5,11,3,272,236,508,699
0130-001,2013,5,11,4,245,202,447,508
0130-001,2013,5,11,5,229,262,491,447
0130-001,2013,5,11,6,446,431,877,491
0130-001,2013,5,11,7,929,688,1617,877
0130-001,2013,5,11,8,1494,1178,2672,1617
0130-001,2013,5,11,9,1703,1815,3518,2672
0130-001,2013,5,11,10,1785,2117,3902,3518
0130-001,2013,5,11,11,1690,2288,3978,3902
0130-001,2013,5,11,12,1736,2366,4102,3978
0130-001,2013,5,11,13,1779,2539,4318,4102
0130-001,2013,5,11,14,1794,2400,4194,4318
0130-001,2013,5,11,15,1850,2293,4143,4194
0130-001,2013,5,11,16,1863,2150,4013,4143
0130-001,2013,5,11,17,1842,2199,4041,4013
0130-001,2013,5,11,18,1970,2431,4401,4041
0130-001,2013,5,11,19,1923,2331,4254,4401
0130-001,2013,5,11,20,1548,1696,3244,4254
0130-001,2013,5,11,21,1310,1284,2594,3244
0130-001,2013,5,11,22,1197,1118,2315,2594
0130-001,2013,5,11,23,841,796,1637,2315
0130-001,2013,5,11,24,599,480,1079,1637
0130-001,2013,5,12,1,435,403,838,1079
0130-001,2013,5,12,2,313,271,584,838
0130-001,2013,5,12,3,258,235,493,584
0130-001,2013,5,12,4,223,146,369,493
0130-001,2013,5,12,5,220,159,379,369
0130-001,2013,5,12,6,333,314,647,379
0130-001,2013,5,12,7,625,479,1104,647
0130-001,2013,5,12,8,766,607,1373,1104
0130-001,2013,5,12,9,879,921,1800,1373
0130-001,2013,5,12,10,1092,1135,2227,1800
0130-001,2013,5,12,11,1187,1294,2481,2227
0130-001,2013,5,12,12,1183,1404,2587,2481
0130-001,2013,5,12,13,1280,1305,2585,2587
0130-001,2013,5,12,14,1464,1455,2919,2585
0130-001,2013,5,12,15,1591,1524,3115,2919
0130-001,2013,5,12,16,1717,1430,3147,3115
0130-001,2013,5,12,17,1835,1547,3382,3147
0130-001,2013,5,12,18,1944,1633,3577,3382
0130-001,2013,5,12,19,1995,1468,3463,3577
0130-001,2013,5,12,20,1692,1271,2963,3463
0130-001,2013,5,12,21,1476,1094,2570,2963
0130-001,2013,5,12,22,1192,901,2093,2570
0130-001,2013,5,12,23,779,582,1361,2093
0130-001,2013,5,12,24,499,375,874,1361
0130-001,2013,5,13,1,300,252,552,874
0130-001,2013,5,13,2,174,186,360,552
0130-001,2013,5,13,3,130,115,245,360
0130-001,2013,5,13,4,128,122,250,245
0130-001,2013,5,13,5,151,208,359,250
0130-001,2013,5,13,6,440,422,862,359
0130-001,2013,5,13,7,1443,856,2299,862
0130-001,2013,5,13,8,2222,1868,4090,2299
0130-001,2013,5,13,9,2291,2136,4427,4090
0130-001,2013,5,13,10,1757,1798,3555,4427
0130-001,2013,5,13,11,1767,1777,3544,3555
0130-001,2013,5,13,12,1729,1611,3340,3544
0130-001,2013,5,13,13,1613,1552,3165,3340
0130-001,2013,5,13,14,1808,1699,3507,3165
0130-001,2013,5,13,15,1858,1790,3648,3507
0130-001,2013,5,13,16,1813,1858,3671,3648
0130-001,2013,5,13,17,1738,1865,3603,3671
0130-001,2013,5,13,18,1803,2404,4207,3603
0130-001,2013,5,13,19,1810,2479,4289,4207
0130-001,2013,5,13,20,1485,1904,3389,4289
0130-001,2013,5,13,21,1270,1775,3045,3389
0130-001,2013,5,13,22,1221,1455,2676,3045
0130-001,2013,5,13,23,906,780,1686,2676
0130-001,2013,5,13,24,561,512,1073,1686
0130-001,2013,5,14,1,401,326,727,1073
0130-001,2013,5,14,2,252,231,483,727
0130-001,2013,5,14,3,181,169,350,483
0130-001,2013,5,14,4,144,160,304,350
0130-001,2013,5,14,5,174,190,364,304
0130-001,2013,5,14,6,408,422,830,364
0130-001,2013,5,14,7,1319,799,2118,830
0130-001,2013,5,14,8,2230,1778,4008,2118
0130-001,2013,5,14,9,2243,2100,4343,4008
0130-001,2013,5,14,10,1740,1810,3550,4343
0130-001,2013,5,14,11,1734,1730,3464,3550
0130-001,2013,5,14,12,1655,1593,3248,3464
0130-001,2013,5,14,13,1660,1434,3094,3248
0130-001,2013,5,14,14,1851,1754,3605,3094
0130-001,2013,5,14,15,1767,1960,3727,3605
0130-001,2013,5,14,16,1858,1950,3808,3727
0130-001,2013,5,14,17,1753,1969,3722,3808
0130-001,2013,5,14,18,1823,2386,4209,3722
0130-001,2013,5,14,19,1842,2468,4310,4209
0130-001,2013,5,14,20,1458,1832,3290,4310
0130-001,2013,5,14,21,1356,1792,3148,3290
0130-001,2013,5,14,22,1185,1426,2611,3148
0130-001,2013,5,14,23,949,882,1831,2611
0130-001,2013,5,14,24,658,536,1194,1831
0130-001,2013,5,15,1,438,369,807,1194
0130-001,2013,5,15,2,266,225,491,807
0130-001,2013,5,15,3,179,195,374,491
0130-001,2013,5,15,4,175,172,347,374
0130-001,2013,5,15,5,186,239,425,347
0130-001,2013,5,15,6,441,427,868,425
0130-001,2013,5,15,7,1345,851,2196,868
0130-001,2013,5,15,8,2199,1791,3990,2196
0130-001,2013,5,15,9,2258,2081,4339,3990
0130-001,2013,5,15,10,1757,1762,3519,4339
0130-001,2013,5,15,11,1808,1684,3492,3519
0130-001,2013,5,15,12,1726,1651,3377,3492
0130-001,2013,5,15,13,1666,1535,3201,3377
0130-001,2013,5,15,14,1705,1687,3392,3201
0130-001,2013,5,15,15,1865,1848,3713,3392
0130-001,2013,5,15,16,1869,1940,3809,3713
0130-001,2013,5,15,17,1771,1875,3646,3809
0130-001,2013,5,15,18,1759,2483,4242,3646
0130-001,2013,5,15,19,1904,2623,4527,4242
0130-001,2013,5,15,20,1526,1950,3476,4527
0130-001,2013,5,15,21,1330,1652,2982,3476
0130-001,2013,5,15,22,1289,1372,2661,2982
0130-001,2013,5,15,23,994,980,1974,2661
0130-001,2013,5,15,24,613,626,1239,1974
0130-001,2013,5,16,1,488,383,871,1239
0130-001,2013,5,16,2,299,285,584,871
0130-001,2013,5,16,3,221,227,448,584
0130-001,2013,5,16,4,175,205,380,448
0130-001,2013,5,16,5,191,243,434,380
0130-001,2013,5,16,6,437,450,887,434
0130-001,2013,5,16,7,1358,816,2174,887
0130-001,2013,5,16,8,2214,1730,3944,2174
0130-001,2013,5,16,9,2207,2051,4258,3944
0130-001,2013,5,16,10,1843,1827,3670,4258
0130-001,2013,5,16,11,1830,1859,3689,3670
0130-001,2013,5,16,12,1779,1698,3477,3689
0130-001,2013,5,16,13,1573,1534,3107,3477
0130-001,2013,5,16,14,1750,1731,3481,3107
0130-001,2013,5,16,15,1907,1632,3539,3481
0130-001,2013,5,16,16,1870,2050,3920,3539
0130-001,2013,5,16,17,1892,2006,3898,3920
0130-001,2013,5,16,18,1980,2451,4431,3898
0130-001,2013,5,16,19,1992,2697,4689,4431
0130-001,2013,5,16,20,1675,2496,4171,4689
0130-001,2013,5,16,21,1515,2253,3768,4171
0130-001,2013,5,16,22,1337,1929,3266,3768
0130-001,2013,5,16,23,1106,1679,2785,3266
0130-001,2013,5,16,24,767,1556,2323,2785
0130-001,2013,5,17,1,523,1201,1724,2323
0130-001,2013,5,17,2,395,528,923,1724
0130-001,2013,5,17,3,298,267,565,923
0130-001,2013,5,17,4,254,262,516,565
0130-001,2013,5,17,5,240,287,527,516
0130-001,2013,5,17,6,459,448,907,527
0130-001,2013,5,17,7,947,728,1675,907
0130-001,2013,5,17,8,1593,1296,2889,1675
0130-001,2013,5,17,9,1460,1866,3326,2889
0130-001,2013,5,17,10,1445,2155,3600,3326
0130-001,2013,5,17,11,1476,2201,3677,3600
0130-001,2013,5,17,12,1403,2178,3581,3677
0130-001,2013,5,17,13,1286,2212,3498,3581
0130-001,2013,5,17,14,1331,2209,3540,3498
0130-001,2013,5,17,15,1421,2047,3468,3540
0130-001,2013,5,17,16,1386,2111,3497,3468
0130-001,2013,5,17,17,1428,2375,3803,3497
0130-001,2013,5,17,18,1701,2513,4214,3803
0130-001,2013,5,17,19,1652,2475,4127,4214
0130-001,2013,5,17,20,1385,1629,3014,4127
0130-001,2013,5,17,21,1115,1354,2469,3014
0130-001,2013,5,17,22,1077,1064,2141,2469
0130-001,2013,5,17,23,824,756,1580,2141
0130-001,2013,5,17,24,562,481,1043,1580
0130-001,2013,5,18,1,395,339,734,1043
0130-001,2013,5,18,2,265,249,514,734
0130-001,2013,5,18,3,220,196,416,514
0130-001,2013,5,18,4,170,175,345,416
0130-001,2013,5,18,5,203,219,422,345
0130-001,2013,5,18,6,398,383,781,422
0130-001,2013,5,18,7,937,626,1563,781
0130-001,2013,5,18,8,1205,1001,2206,1563
0130-001,2013,5,18,9,1262,1380,2642,2206
0130-001,2013,5,18,10,1367,1618,2985,2642
0130-001,2013,5,18,11,1454,1657,3111,2985
0130-001,2013,5,18,12,1478,1711,3189,3111
0130-001,2013,5,18,13,1458,1673,3131,3189
0130-001,2013,5,18,14,1546,1587,3133,3131
0130-001,2013,5,18,15,1588,1542,3130,3133
0130-001,2013,5,18,16,1663,1602,3265,3130
0130-001,2013,5,18,17,1778,1651,3429,3265
0130-001,2013,5,18,18,2028,1938,3966,3429
0130-001,2013,5,18,19,2000,1632,3632,3966
0130-001,2013,5,18,20,1702,1265,2967,3632
0130-001,2013,5,18,21,1468,1063,2531,2967
0130-001,2013,5,18,22,1543,924,2467,2531
0130-001,2013,5,18,23,1127,656,1783,2467
0130-001,2013,5,18,24,845,430,1275,1783
0130-001,2013,5,19,1,541,340,881,1275
0130-001,2013,5,19,2,322,238,560,881
0130-001,2013,5,19,3,213,177,390,560
0130-001,2013,5,19,4,162,138,300,390
0130-001,2013,5,19,5,153,120,273,300
0130-001,2013,5,19,6,238,249,487,273
0130-001,2013,5,19,7,422,358,780,487
0130-001,2013,5,19,8,524,517,1041,780
0130-001,2013,5,19,9,748,857,1605,1041
0130-001,2013,5,19,10,900,1028,1928,1605
0130-001,2013,5,19,11,1203,1198,2401,1928
0130-001,2013,5,19,12,1432,1315,2747,2401
0130-001,2013,5,19,13,1601,1330,2931,2747
0130-001,2013,5,19,14,1840,1415,3255,2931
0130-001,2013,5,19,15,1754,1516,3270,3255
0130-001,2013,5,19,16,1977,1504,3481,3270
0130-001,2013,5,19,17,1979,1456,3435,3481
0130-001,2013,5,19,18,1878,1449,3327,3435
0130-001,2013,5,19,19,1863,1357,3220,3327
0130-001,2013,5,19,20,1354,1096,2450,3220
0130-001,2013,5,19,21,1247,1050,2297,2450
0130-001,2013,5,19,22,1061,777,1838,2297
0130-001,2013,5,19,23,714,546,1260,1838
0130-001,2013,5,19,24,488,372,860,1260
0130-001,2013,5,20,1,333,230,563,860
0130-001,2013,5,20,2,205,157,362,563
0130-001,2013,5,20,3,116,108,224,362
0130-001,2013,5,20,4,114,123,237,224
0130-001,2013,5,20,5,167,205,372,237
0130-001,2013,5,20,6,430,424,854,372
0130-001,2013,5,20,7,1493,870,2363,854
0130-001,2013,5,20,8,2246,1827,4073,2363
0130-001,2013,5,20,9,2218,2062,4280,4073
0130-001,2013,5,20,10,1743,1735,3478,4280
0130-001,2013,5,20,11,1730,1744,3474,3478
0130-001,2013,5,20,12,1531,1531,3062,3474
0130-001,2013,5,20,13,1568,1424,2992,3062
0130-001,2013,5,20,14,1866,1754,3620,2992
0130-001,2013,5,20,15,1796,1863,3659,3620
0130-001,2013,5,20,16,1772,1823,3595,3659
0130-001,2013,5,20,17,1748,1915,3663,3595
0130-001,2013,5,20,18,1842,2214,4056,3663
0130-001,2013,5,20,19,1832,2593,4425,4056
0130-001,2013,5,20,20,1448,1859,3307,4425
0130-001,2013,5,20,21,1348,1808,3156,3307
0130-001,2013,5,20,22,1197,1409,2606,3156
0130-001,2013,5,20,23,940,840,1780,2606
0130-001,2013,5,20,24,597,540,1137,1780
0130-001,2013,5,21,1,402,344,746,1137
0130-001,2013,5,21,2,273,244,517,746
0130-001,2013,5,21,3,166,148,314,517
0130-001,2013,5,21,4,149,163,312,314
0130-001,2013,5,21,5,190,204,394,312
0130-001,2013,5,21,6,412,417,829,394
0130-001,2013,5,21,7,1323,787,2110,829
0130-001,2013,5,21,8,2251,1809,4060,2110
0130-001,2013,5,21,9,2276,2022,4298,4060
0130-001,2013,5,21,10,1967,1733,3700,4298
0130-001,2013,5,21,11,1788,1743,3531,3700
0130-001,2013,5,21,12,1669,1525,3194,3531
0130-001,2013,5,21,13,1483,1477,2960,3194
0130-001,2013,5,21,14,1883,1931,3814,2960
0130-001,2013,5,21,15,1805,1893,3698,3814
0130-001,2013,5,21,16,1841,1845,3686,3698
0130-001,2013,5,21,17,1682,1868,3550,3686
0130-001,2013,5,21,18,1711,2297,4008,3550
0130-001,2013,5,21,19,1736,2600,4336,4008
0130-001,2013,5,21,20,1459,1861,3320,4336
0130-001,2013,5,21,21,1336,1751,3087,3320
0130-001,2013,5,21,22,1249,1364,2613,3087
0130-001,2013,5,21,23,946,865,1811,2613
0130-001,2013,5,21,24,635,603,1238,1811
0130-001,2013,5,22,1,381,328,709,1238
0130-001,2013,5,22,2,248,212,460,709
0130-001,2013,5,22,3,211,179,390,460
0130-001,2013,5,22,4,148,153,301,390
0130-001,2013,5,22,5,174,206,380,301
0130-001,2013,5,22,6,446,394,840,380
0130-001,2013,5,22,7,1414,810,2224,840
0130-001,2013,5,22,8,2244,1771,4015,2224
0130-001,2013,5,22,9,2234,2158,4392,4015
0130-001,2013,5,22,10,1904,1769,3673,4392
0130-001,2013,5,22,11,1732,1673,3405,3673
0130-001,2013,5,22,12,1697,1655,3352,3405
0130-001,2013,5,22,13,1435,1521,2956,3352
0130-001,2013,5,22,14,1911,1742,3653,2956
0130-001,2013,5,22,15,1764,1820,3584,3653
0130-001,2013,5,22,16,1781,1821,3602,3584
0130-001,2013,5,22,17,1742,1896,3638,3602
0130-001,2013,5,22,18,1814,2384,4198,3638
0130-001,2013,5,22,19,1813,2697,4510,4198
0130-001,2013,5,22,20,1441,1897,3338,4510
0130-001,2013,5,22,21,1312,1644,2956,3338
0130-001,2013,5,22,22,1272,1328,2600,2956
0130-001,2013,5,22,23,990,924,1914,2600
0130-001,2013,5,22,24,638,506,1144,1914
0130-001,2013,5,23,1,461,368,829,1144
0130-001,2013,5,23,2,323,261,584,829
0130-001,2013,5,23,3,196,216,412,584
0130-001,2013,5,23,4,163,169,332,412
0130-001,2013,5,23,5,199,223,422,332
0130-001,2013,5,23,6,417,393,810,422
0130-001,2013,5,23,7,1350,792,2142,810
0130-001,2013,5,23,8,2153,1774,3927,2142
0130-001,2013,5,23,9,2230,2091,4321,3927
0130-001,2013,5,23,10,1898,1725,3623,4321
0130-001,2013,5,23,11,1775,1653,3428,3623
0130-001,2013,5,23,12,1612,1568,3180,3428
0130-001,2013,5,23,13,1427,1483,2910,3180
0130-001,2013,5,23,14,1801,1827,3628,2910
0130-001,2013,5,23,15,1794,1663,3457,3628
0130-001,2013,5,23,16,1697,1716,3413,3457
0130-001,2013,5,23,17,1607,1791,3398,3413
0130-001,2013,5,23,18,1784,2302,4086,3398
0130-001,2013,5,23,19,1799,2609,4408,4086
0130-001,2013,5,23,20,1452,1868,3320,4408
0130-001,2013,5,23,21,1331,1707,3038,3320
0130-001,2013,5,23,22,1288,1375,2663,3038
0130-001,2013,5,23,23,969,934,1903,2663
0130-001,2013,5,23,24,673,589,1262,1903
0130-001,2013,5,24,1,449,368,817,1262
0130-001,2013,5,24,2,284,262,546,817
0130-001,2013,5,24,3,191,194,385,546
0130-001,2013,5,24,4,174,166,340,385
0130-001,2013,5,24,5,202,242,444,340
0130-001,2013,5,24,6,424,404,828,444
0130-001,2013,5,24,7,1361,773,2134,828
0130-001,2013,5,24,8,2180,1708,3888,2134
0130-001,2013,5,24,9,2290,2098,4388,3888
0130-001,2013,5,24,10,1852,1694,3546,4388
0130-001,2013,5,24,11,1773,1799,3572,3546
0130-001,2013,5,24,12,1621,1693,3314,3572
0130-001,2013,5,24,13,1508,1584,3092,3314
0130-001,2013,5,24,14,1899,1907,3806,3092
0130-001,2013,5,24,15,1891,1847,3738,3806
0130-001,2013,5,24,16,1848,1911,3759,3738
0130-001,2013,5,24,17,1785,1951,3736,3759
0130-001,2013,5,24,18,1990,2431,4421,3736
0130-001,2013,5,24,19,2047,2737,4784,4421
0130-001,2013,5,24,20,1692,2138,3830,4784
0130-001,2013,5,24,21,1388,1808,3196,3830
0130-001,2013,5,24,22,1405,1433,2838,3196
0130-001,2013,5,24,23,1061,973,2034,2838
0130-001,2013,5,24,24,713,642,1355,2034
0130-001,2013,5,25,1,496,425,921,1355
0130-001,2013,5,25,2,373,333,706,921
0130-001,2013,5,25,3,269,259,528,706
0130-001,2013,5,25,4,227,215,442,528
0130-001,2013,5,25,5,275,275,550,442
0130-001,2013,5,25,6,483,436,919,550
0130-001,2013,5,25,7,1007,666,1673,919
0130-001,2013,5,25,8,1534,1183,2717,1673
0130-001,2013,5,25,9,1782,1783,3565,2717
0130-001,2013,5,25,10,1774,1990,3764,3565
0130-001,2013,5,25,11,1731,2166,3897,3764
0130-001,2013,5,25,12,1716,2153,3869,3897
0130-001,2013,5,25,13,1690,2403,4093,3869
0130-001,2013,5,25,14,1755,2350,4105,4093
0130-001,2013,5,25,15,1803,2071,3874,4105
0130-001,2013,5,25,16,1842,1813,3655,3874
0130-001,2013,5,25,17,1786,1839,3625,3655
0130-001,2013,5,25,18,1986,2156,4142,3625
0130-001,2013,5,25,19,1838,2143,3981,4142
0130-001,2013,5,25,20,1543,1590,3133,3981
0130-001,2013,5,25,21,1279,1325,2604,3133
0130-001,2013,5,25,22,1168,1110,2278,2604
0130-001,2013,5,25,23,839,703,1542,2278
0130-001,2013,5,25,24,591,539,1130,1542
0130-001,2013,5,26,1,449,418,867,1130
0130-001,2013,5,26,2,338,285,623,867
0130-001,2013,5,26,3,254,224,478,623
0130-001,2013,5,26,4,205,168,373,478
0130-001,2013,5,26,5,216,162,378,373
0130-001,2013,5,26,6,391,333,724,378
0130-001,2013,5,26,7,687,486,1173,724
0130-001,2013,5,26,8,843,727,1570,1173
0130-001,2013,5,26,9,876,958,1834,1570
0130-001,2013,5,26,10,955,1150,2105,1834
0130-001,2013,5,26,11,1171,1365,2536,2105
0130-001,2013,5,26,12,1182,1395,2577,2536
0130-001,2013,5,26,13,1431,1402,2833,2577
0130-001,2013,5,26,14,1515,1436,2951,2833
0130-001,2013,5,26,15,1641,1437,3078,2951
0130-001,2013,5,26,16,1615,1462,3077,3078
0130-001,2013,5,26,17,1724,1515,3239,3077
0130-001,2013,5,26,18,1733,1586,3319,3239
0130-001,2013,5,26,19,1719,1434,3153,3319
0130-001,2013,5,26,20,1393,1264,2657,3153
0130-001,2013,5,26,21,1193,1043,2236,2657
0130-001,2013,5,26,22,1044,836,1880,2236
0130-001,2013,5,26,23,707,612,1319,1880
0130-001,2013,5,26,24,465,379,844,1319
0130-001,2013,5,27,1,255,258,513,844
0130-001,2013,5,27,2,201,159,360,513
0130-001,2013,5,27,3,137,126,263,360
0130-001,2013,5,27,4,129,130,259,263
0130-001,2013,5,27,5,143,192,335,259
0130-001,2013,5,27,6,417,405,822,335
0130-001,2013,5,27,7,1333,832,2165,822
0130-001,2013,5,27,8,2119,1772,3891,2165
0130-001,2013,5,27,9,2155,2024,4179,3891
0130-001,2013,5,27,10,1916,1699,3615,4179
0130-001,2013,5,27,11,1672,1751,3423,3615
0130-001,2013,5,27,12,1557,1583,3140,3423
0130-001,2013,5,27,13,1448,1383,2831,3140
0130-001,2013,5,27,14,1742,1769,3511,2831
0130-001,2013,5,27,15,1759,1685,3444,3511
0130-001,2013,5,27,16,1649,1694,3343,3444
0130-001,2013,5,27,17,1574,1681,3255,3343
0130-001,2013,5,27,18,1718,2120,3838,3255
0130-001,2013,5,27,19,1751,2193,3944,3838
0130-001,2013,5,27,20,1306,1767,3073,3944
0130-001,2013,5,27,21,1172,1687,2859,3073
0130-001,2013,5,27,22,1099,1162,2261,2859
0130-001,2013,5,27,23,814,774,1588,2261
0130-001,2013,5,27,24,505,503,1008,1588
0130-001,2013,5,28,1,361,329,690,1008
0130-001,2013,5,28,2,225,187,412,690
0130-001,2013,5,28,3,154,146,300,412
0130-001,2013,5,28,4,140,167,307,300
0130-001,2013,5,28,5,153,172,325,307
0130-001,2013,5,28,6,344,353,697,325
0130-001,2013,5,28,7,1177,657,1834,697
0130-001,2013,5,28,8,2174,1736,3910,1834
0130-001,2013,5,28,9,2140,2052,4192,3910
0130-001,2013,5,28,10,1702,1655,3357,4192
0130-001,2013,5,28,11,1644,1682,3326,3357
0130-001,2013,5,28,12,1577,1531,3108,3326
0130-001,2013,5,28,13,1475,1477,2952,3108
0130-001,2013,5,28,14,1354,1558,2912,2952
0130-001,2013,5,28,15,1832,1721,3553,2912
0130-001,2013,5,28,16,1601,1727,3328,3553
0130-001,2013,5,28,17,1601,1761,3362,3328
0130-001,2013,5,28,18,1710,2145,3855,3362
0130-001,2013,5,28,19,1722,2410,4132,3855
0130-001,2013,5,28,20,1272,1703,2975,4132
0130-001,2013,5,28,21,1243,1646,2889,2975
0130-001,2013,5,28,22,1189,1195,2384,2889
0130-001,2013,5,28,23,855,758,1613,2384
0130-001,2013,5,28,24,584,538,1122,1613
0130-001,2013,5,29,1,393,325,718,1122
0130-001,2013,5,29,2,214,203,417,718
0130-001,2013,5,29,3,198,187,385,417
0130-001,2013,5,29,4,156,168,324,385
0130-001,2013,5,29,5,179,242,421,324
0130-001,2013,5,29,6,424,398,822,421
0130-001,2013,5,29,7,1282,759,2041,822
0130-001,2013,5,29,8,2222,1767,3989,2041
0130-001,2013,5,29,9,2126,2071,4197,3989
0130-001,2013,5,29,10,1653,1684,3337,4197
0130-001,2013,5,29,11,1805,1698,3503,3337
0130-001,2013,5,29,12,1549,1573,3122,3503
0130-001,2013,5,29,13,1319,1375,2694,3122
0130-001,2013,5,29,14,1656,1621,3277,2694
0130-001,2013,5,29,15,1807,1825,3632,3277
0130-001,2013,5,29,16,1735,1815,3550,3632
0130-001,2013,5,29,17,1570,1798,3368,3550
0130-001,2013,5,29,18,1733,2231,3964,3368
0130-001,2013,5,29,19,1760,2547,4307,3964
0130-001,2013,5,29,20,1389,1782,3171,4307
0130-001,2013,5,29,21,1209,1554,2763,3171
0130-001,2013,5,29,22,1249,1159,2408,2763
0130-001,2013,5,29,23,942,757,1699,2408
0130-001,2013,5,29,24,646,531,1177,1699
0130-001,2013,5,30,1,445,369,814,1177
0130-001,2013,5,30,2,277,241,518,814
0130-001,2013,5,30,3,200,217,417,518
0130-001,2013,5,30,4,158,172,330,417
0130-001,2013,5,30,5,214,236,450,330
0130-001,2013,5,30,6,462,442,904,450
0130-001,2013,5,30,7,1358,748,2106,904
0130-001,2013,5,30,8,2164,1792,3956,2106
0130-001,2013,5,30,9,2249,2040,4289,3956
0130-001,2013,5,30,10,1724,1673,3397,4289
0130-001,2013,5,30,11,1832,1677,3509,3397
0130-001,2013,5,30,12,1529,1605,3134,3509
0130-001,2013,5,30,13,1469,1556,3025,3134
0130-001,2013,5,30,14,1540,1676,3216,3025
0130-001,2013,5,30,15,1736,1775,3511,3216
0130-001,2013,5,30,16,1637,1789,3426,3511
0130-001,2013,5,30,17,1736,1816,3552,3426
0130-001,2013,5,30,18,1750,2251,4001,3552
0130-001,2013,5,30,19,1580,2454,4034,4001
0130-001,2013,5,30,20,1458,1880,3338,4034
0130-001,2013,5,30,21,1299,1794,3093,3338
0130-001,2013,5,30,22,1257,1406,2663,3093
0130-001,2013,5,30,23,980,936,1916,2663
0130-001,2013,5,30,24,695,569,1264,1916
0130-001,2013,5,31,1,467,406,873,1264
0130-001,2013,5,31,2,278,264,542,873
0130-001,2013,5,31,3,225,193,418,542
0130-001,2013,5,31,4,174,191,365,418
0130-001,2013,5,31,5,189,241,430,365
0130-001,2013,5,31,6,489,435,924,430
0130-001,2013,5,31,7,1369,817,2186,924
0130-001,2013,5,31,8,2184,1745,3929,2186
0130-001,2013,5,31,9,2176,2038,4214,3929
0130-001,2013,5,31,10,1587,1694,3281,4214
0130-001,2013,5,31,11,1626,1732,3358,3281
0130-001,2013,5,31,12,1583,1673,3256,3358
0130-001,2013,5,31,13,1455,1581,3036,3256
0130-001,2013,5,31,14,1637,1693,3330,3036
0130-001,2013,5,31,15,1843,1786,3629,3330
0130-001,2013,5,31,16,1819,1843,3662,3629
0130-001,2013,5,31,17,1827,1929,3756,3662
0130-001,2013,5,31,18,1926,2412,4338,3756
0130-001,2013,5,31,19,1991,2653,4644,4338
0130-001,2013,5,31,20,1583,2090,3673,4644
0130-001,2013,5,31,21,1374,1819,3193,3673
0130-001,2013,5,31,22,1313,1409,2722,3193
0130-001,2013,5,31,23,1072,1003,2075,2722
0130-001,2013,5,31,24,744,651,1395,2075
0130-001,2013,6,1,1,527,452,979,1395
0130-001,2013,6,1,2,376,291,667,979
0130-001,2013,6,1,3,283,247,530,667
0130-001,2013,6,1,4,237,231,468,530
0130-001,2013,6,1,5,274,270,544,468
0130-001,2013,6,1,6,479,462,941,544
0130-001,2013,6,1,7,977,693,1670,941
0130-001,2013,6,1,8,1489,1206,2695,1670
0130-001,2013,6,1,9,1598,1769,3367,2695
0130-001,2013,6,1,10,1604,1890,3494,3367
0130-001,2013,6,1,11,1655,2026,3681,3494
0130-001,2013,6,1,12,1658,2054,3712,3681
0130-001,2013,6,1,13,1630,2309,3939,3712
0130-001,2013,6,1,14,1656,2213,3869,3939
0130-001,2013,6,1,15,1628,1774,3402,3869
0130-001,2013,6,1,16,1695,1704,3399,3402
0130-001,2013,6,1,17,1784,1719,3503,3399
0130-001,2013,6,1,18,1972,2141,4113,3503
0130-001,2013,6,1,19,1756,2062,3818,4113
0130-001,2013,6,1,20,1531,1578,3109,3818
0130-001,2013,6,1,21,1298,1167,2465,3109
0130-001,2013,6,1,22,1186,1096,2282,2465
0130-001,2013,6,1,23,858,782,1640,2282
0130-001,2013,6,1,24,638,519,1157,1640
0130-001,2013,6,2,1,361,352,713,1157
0130-001,2013,6,2,2,301,231,532,713
0130-001,2013,6,2,3,245,229,474,532
0130-001,2013,6,2,4,201,163,364,474
0130-001,2013,6,2,5,206,177,383,364
0130-001,2013,6,2,6,353,315,668,383
0130-001,2013,6,2,7,645,505,1150,668
0130-001,2013,6,2,8,828,703,1531,1150
0130-001,2013,6,2,9,1003,991,1994,1531
0130-001,2013,6,2,10,923,1079,2002,1994
0130-001,2013,6,2,11,1140,1290,2430,2002
0130-001,2013,6,2,12,1078,1408,2486,2430
0130-001,2013,6,2,13,1262,1426,2688,2486
0130-001,2013,6,2,14,1378,1421,2799,2688
0130-001,2013,6,2,15,1445,1558,3003,2799
0130-001,2013,6,2,16,1609,1527,3136,3003
0130-001,2013,6,2,17,1718,1514,3232,3136
0130-001,2013,6,2,18,1761,1489,3250,3232
0130-001,2013,6,2,19,1710,1437,3147,3250
0130-001,2013,6,2,20,1400,1253,2653,3147
0130-001,2013,6,2,21,1193,1081,2274,2653
0130-001,2013,6,2,22,1119,967,2086,2274
0130-001,2013,6,2,23,715,568,1283,2086
0130-001,2013,6,2,24,489,387,876,1283
0130-001,2013,6,3,1,275,232,507,876
0130-001,2013,6,3,2,183,153,336,507
0130-001,2013,6,3,3,145,127,272,336
0130-001,2013,6,3,4,125,148,273,272
0130-001,2013,6,3,5,155,239,394,273
0130-001,2013,6,3,6,521,415,936,394
0130-001,2013,6,3,7,1519,840,2359,936
0130-001,2013,6,3,8,2098,1892,3990,2359
0130-001,2013,6,3,9,2302,2033,4335,3990
0130-001,2013,6,3,10,1725,1801,3526,4335
0130-001,2013,6,3,11,1874,1666,3540,3526
0130-001,2013,6,3,12,1648,1609,3257,3540
0130-001,2013,6,3,13,1484,1442,2926,3257
0130-001,2013,6,3,14,1633,1706,3339,2926
0130-001,2013,6,3,15,1780,1520,3300,3339
0130-001,2013,6,3,16,1727,1518,3245,3300
0130-001,2013,6,3,17,1712,1432,3144,3245
0130-001,2013,6,3,18,1700,1661,3361,3144
0130-001,2013,6,3,19,1761,2019,3780,3361
0130-001,2013,6,3,20,1403,2084,3487,3780
0130-001,2013,6,3,21,1249,1722,2971,3487
0130-001,2013,6,3,22,1184,1375,2559,2971
0130-001,2013,6,3,23,884,794,1678,2559
0130-001,2013,6,3,24,569,515,1084,1678
0130-001,2013,6,4,1,346,347,693,1084
0130-001,2013,6,4,2,229,214,443,693
0130-001,2013,6,4,3,157,157,314,443
0130-001,2013,6,4,4,147,163,310,314
0130-001,2013,6,4,5,192,238,430,310
0130-001,2013,6,4,6,427,424,851,430
0130-001,2013,6,4,7,1409,785,2194,851
0130-001,2013,6,4,8,2130,1811,3941,2194
0130-001,2013,6,4,9,2088,1982,4070,3941
0130-001,2013,6,4,10,1848,1741,3589,4070
0130-001,2013,6,4,11,1757,1674,3431,3589
0130-001,2013,6,4,12,1582,1740,3322,3431
0130-001,2013,6,4,13,1422,1563,2985,3322
0130-001,2013,6,4,14,1714,1680,3394,2985
0130-001,2013,6,4,15,1800,1790,3590,3394
0130-001,2013,6,4,16,1731,1896,3627,3590
0130-001,2013,6,4,17,1691,1877,3568,3627
0130-001,2013,6,4,18,1730,2215,3945,3568
0130-001,2013,6,4,19,1764,2296,4060,3945
0130-001,2013,6,4,20,1454,1985,3439,4060
0130-001,2013,6,4,21,1293,1724,3017,3439
0130-001,2013,6,4,22,1208,1322,2530,3017
0130-001,2013,6,4,23,946,835,1781,2530
0130-001,2013,6,4,24,626,499,1125,1781
0130-001,2013,6,5,1,368,361,729,1125
0130-001,2013,6,5,2,297,241,538,729
0130-001,2013,6,5,3,190,187,377,538
0130-001,2013,6,5,4,161,142,303,377
0130-001,2013,6,5,5,198,276,474,303
0130-001,2013,6,5,6,452,440,892,474
0130-001,2013,6,5,7,1408,776,2184,892
0130-001,2013,6,5,8,2098,1801,3899,2184
0130-001,2013,6,5,9,2177,2022,4199,3899
0130-001,2013,6,5,10,1724,1728,3452,4199
0130-001,2013,6,5,11,1753,1778,3531,3452
0130-001,2013,6,5,12,1607,1568,3175,3531
0130-001,2013,6,5,13,1445,1466,2911,3175
0130-001,2013,6,5,14,1639,1714,3353,2911
0130-001,2013,6,5,15,1873,1707,3580,3353
0130-001,2013,6,5,16,1737,1943,3680,3580
0130-001,2013,6,5,17,1780,1945,3725,3680
0130-001,2013,6,5,18,1886,2378,4264,3725
0130-001,2013,6,5,19,1876,2638,4514,4264
0130-001,2013,6,5,20,1586,2141,3727,4514
0130-001,2013,6,5,21,1391,1766,3157,3727
0130-001,2013,6,5,22,1285,1450,2735,3157
0130-001,2013,6,5,23,1041,963,2004,2735
0130-001,2013,6,5,24,728,617,1345,2004
0130-001,2013,6,6,1,480,435,915,1345
0130-001,2013,6,6,2,352,315,667,915
0130-001,2013,6,6,3,270,232,502,667
0130-001,2013,6,6,4,228,222,450,502
0130-001,2013,6,6,5,239,258,497,450
0130-001,2013,6,6,6,509,437,946,497
0130-001,2013,6,6,7,1016,697,1713,946
0130-001,2013,6,6,8,1546,1066,2612,1713
0130-001,2013,6,6,9,1395,1432,2827,2612
0130-001,2013,6,6,10,1330,1585,2915,2827
0130-001,2013,6,6,11,1405,1905,3310,2915
0130-001,2013,6,6,12,1413,2001,3414,3310
0130-001,2013,6,6,13,1296,2029,3325,3414
0130-001,2013,6,6,14,1373,1826,3199,3325
0130-001,2013,6,6,15,1402,1526,2928,3199
0130-001,2013,6,6,16,1383,1436,2819,2928
0130-001,2013,6,6,17,1484,1505,2989,2819
0130-001,2013,6,6,18,1703,1838,3541,2989
0130-001,2013,6,6,19,1609,1757,3366,3541
0130-001,2013,6,6,20,1307,1373,2680,3366
0130-001,2013,6,6,21,1163,1180,2343,2680
0130-001,2013,6,6,22,1036,969,2005,2343
0130-001,2013,6,6,23,800,621,1421,2005
0130-001,2013,6,6,24,512,451,963,1421
0130-001,2013,6,7,1,319,279,598,963
0130-001,2013,6,7,2,204,202,406,598
0130-001,2013,6,7,3,150,172,322,406
0130-001,2013,6,7,4,134,135,269,322
0130-001,2013,6,7,5,182,250,432,269
0130-001,2013,6,7,6,446,421,867,432
0130-001,2013,6,7,7,1457,789,2246,867
0130-001,2013,6,7,8,2182,1780,3962,2246
0130-001,2013,6,7,9,1954,2038,3992,3962
0130-001,2013,6,7,10,1688,1681,3369,3992
0130-001,2013,6,7,11,1839,1843,3682,3369
0130-001,2013,6,7,12,1625,1670,3295,3682
0130-001,2013,6,7,13,1446,1570,3016,3295
0130-001,2013,6,7,14,1734,1832,3566,3016
0130-001,2013,6,7,15,1798,1927,3725,3566
0130-001,2013,6,7,16,1883,1832,3715,3725
0130-001,2013,6,7,17,1853,1939,3792,3715
0130-001,2013,6,7,18,1891,2246,4137,3792
0130-001,2013,6,7,19,1991,2460,4451,4137
0130-001,2013,6,7,20,1599,1961,3560,4451
0130-001,2013,6,7,21,1359,1686,3045,3560
0130-001,2013,6,7,22,1234,1468,2702,3045
0130-001,2013,6,7,23,1051,956,2007,2702
0130-001,2013,6,7,24,689,650,1339,2007
0130-001,2013,6,8,1,486,399,885,1339
0130-001,2013,6,8,2,324,312,636,885
0130-001,2013,6,8,3,246,229,475,636
0130-001,2013,6,8,4,208,182,390,475
0130-001,2013,6,8,5,267,273,540,390
0130-001,2013,6,8,6,473,448,921,540
0130-001,2013,6,8,7,997,719,1716,921
0130-001,2013,6,8,8,1468,1183,2651,1716
0130-001,2013,6,8,9,1655,1774,3429,2651
0130-001,2013,6,8,10,1610,1902,3512,3429
0130-001,2013,6,8,11,1566,1839,3405,3512
0130-001,2013,6,8,12,1631,2144,3775,3405
0130-001,2013,6,8,13,1576,2227,3803,3775
0130-001,2013,6,8,14,1596,2183,3779,3803
0130-001,2013,6,8,15,1612,1868,3480,3779
0130-001,2013,6,8,16,1720,1751,3471,3480
0130-001,2013,6,8,17,1864,1736,3600,3471
0130-001,2013,6,8,18,1938,1992,3930,3600
0130-001,2013,6,8,19,1753,1993,3746,3930
0130-001,2013,6,8,20,1425,1370,2795,3746
0130-001,2013,6,8,21,1285,1239,2524,2795
0130-001,2013,6,8,22,1140,997,2137,2524
0130-001,2013,6,8,23,853,733,1586,2137
0130-001,2013,6,8,24,581,520,1101,1586
0130-001,2013,6,9,1,423,370,793,1101
0130-001,2013,6,9,2,311,267,578,793
0130-001,2013,6,9,3,257,225,482,578
0130-001,2013,6,9,4,215,176,391,482
0130-001,2013,6,9,5,212,186,398,391
0130-001,2013,6,9,6,396,305,701,398
0130-001,2013,6,9,7,650,459,1109,701
0130-001,2013,6,9,8,782,646,1428,1109
0130-001,2013,6,9,9,884,911,1795,1428
0130-001,2013,6,9,10,931,1109,2040,1795
0130-001,2013,6,9,11,1119,1269,2388,2040
0130-001,2013,6,9,12,1092,1244,2336,2388
0130-001,2013,6,9,13,1252,1291,2543,2336
0130-001,2013,6,9,14,1383,1358,2741,2543
0130-001,2013,6,9,15,1512,1351,2863,2741
0130-001,2013,6,9,16,1523,1478,3001,2863
0130-001,2013,6,9,17,1689,1530,3219,3001
0130-001,2013,6,9,18,1856,1429,3285,3219
0130-001,2013,6,9,19,1680,1443,3123,3285
0130-001,2013,6,9,20,1414,1185,2599,3123
0130-001,2013,6,9,21,1215,1046,2261,2599
0130-001,2013,6,9,22,1031,880,1911,2261
0130-001,2013,6,9,23,765,605,1370,1911
0130-001,2013,6,9,24,488,405,893,1370
0130-001,2013,6,10,1,288,226,514,893
0130-001,2013,6,10,2,189,167,356,514
0130-001,2013,6,10,3,155,128,283,356
0130-001,2013,6,10,4,131,136,267,283
0130-001,2013,6,10,5,150,231,381,267
0130-001,2013,6,10,6,517,476,993,381
0130-001,2013,6,10,7,1534,911,2445,993
0130-001,2013,6,10,8,2214,1897,4111,2445
0130-001,2013,6,10,9,2160,2039,4199,4111
0130-001,2013,6,10,10,1753,1686,3439,4199
0130-001,2013,6,10,11,1760,1829,3589,3439
0130-001,2013,6,10,12,1584,1701,3285,3589
0130-001,2013,6,10,13,1436,1550,2986,3285
0130-001,2013,6,10,14,1700,1815,3515,2986
0130-001,2013,6,10,15,1817,1833,3650,3515
0130-001,2013,6,10,16,1743,1888,3631,3650
0130-001,2013,6,10,17,1762,1810,3572,3631
0130-001,2013,6,10,18,1803,2227,4030,3572
0130-001,2013,6,10,19,1836,2461,4297,4030
0130-001,2013,6,10,20,1477,1907,3384,4297
0130-001,2013,6,10,21,1302,1796,3098,3384
0130-001,2013,6,10,22,1296,1437,2733,3098
0130-001,2013,6,10,23,955,879,1834,2733
0130-001,2013,6,10,24,535,521,1056,1834
0130-001,2013,6,11,1,409,323,732,1056
0130-001,2013,6,11,2,246,237,483,732
0130-001,2013,6,11,3,189,191,380,483
0130-001,2013,6,11,4,155,160,315,380
0130-001,2013,6,11,5,201,256,457,315
0130-001,2013,6,11,6,444,459,903,457
0130-001,2013,6,11,7,1449,813,2262,903
0130-001,2013,6,11,8,2094,1784,3878,2262
0130-001,2013,6,11,9,2262,2024,4286,3878
0130-001,2013,6,11,10,1889,1820,3709,4286
0130-001,2013,6,11,11,1857,1870,3727,3709
0130-001,2013,6,11,12,1588,1706,3294,3727
0130-001,2013,6,11,13,1462,1543,3005,3294
0130-001,2013,6,11,14,1825,1904,3729,3005
0130-001,2013,6,11,15,1719,1862,3581,3729
0130-001,2013,6,11,16,1746,1882,3628,3581
0130-001,2013,6,11,17,1730,1902,3632,3628
0130-001,2013,6,11,18,1836,2259,4095,3632
0130-001,2013,6,11,19,1736,2506,4242,4095
0130-001,2013,6,11,20,1423,1914,3337,4242
0130-001,2013,6,11,21,1253,1595,2848,3337
0130-001,2013,6,11,22,1082,1215,2297,2848
0130-001,2013,6,11,23,890,825,1715,2297
0130-001,2013,6,11,24,566,476,1042,1715
0130-001,2013,6,12,1,388,330,718,1042
0130-001,2013,6,12,2,236,212,448,718
0130-001,2013,6,12,3,182,160,342,448
0130-001,2013,6,12,4,135,161,296,342
0130-001,2013,6,12,5,176,206,382,296
0130-001,2013,6,12,6,381,362,743,382
0130-001,2013,6,12,7,1194,690,1884,743
0130-001,2013,6,12,8,1961,1757,3718,1884
0130-001,2013,6,12,9,2202,1948,4150,3718
0130-001,2013,6,12,10,1684,1673,3357,4150
0130-001,2013,6,12,11,1658,1673,3331,3357
0130-001,2013,6,12,12,1584,1628,3212,3331
0130-001,2013,6,12,13,1509,1479,2988,3212
0130-001,2013,6,12,14,1624,1634,3258,2988
0130-001,2013,6,12,15,1781,1742,3523,3258
0130-001,2013,6,12,16,1780,1730,3510,3523
0130-001,2013,6,12,17,1594,1836,3430,3510
0130-001,2013,6,12,18,1741,2201,3942,3430
0130-001,2013,6,12,19,1842,2514,4356,3942
0130-001,2013,6,12,20,1392,1802,3194,4356
0130-001,2013,6,12,21,1299,1613,2912,3194
0130-001,2013,6,12,22,1227,1250,2477,2912
0130-001,2013,6,12,23,952,827,1779,2477
0130-001,2013,6,12,24,610,499,1109,1779
0130-001,2013,6,13,1,409,363,772,1109
0130-001,2013,6,13,2,253,231,484,772
0130-001,2013,6,13,3,188,201,389,484
0130-001,2013,6,13,4,169,175,344,389
0130-001,2013,6,13,5,208,255,463,344
0130-001,2013,6,13,6,464,435,899,463
0130-001,2013,6,13,7,1421,780,2201,899
0130-001,2013,6,13,8,2130,1801,3931,2201
0130-001,2013,6,13,9,2261,2084,4345,3931
0130-001,2013,6,13,10,1774,1758,3532,4345
0130-001,2013,6,13,11,1782,1721,3503,3532
0130-001,2013,6,13,12,1579,1737,3316,3503
0130-001,2013,6,13,13,1390,1550,2940,3316
0130-001,2013,6,13,14,1628,1548,3176,2940
0130-001,2013,6,13,15,1757,1859,3616,3176
0130-001,2013,6,13,16,1795,1819,3614,3616
0130-001,2013,6,13,17,1741,1916,3657,3614
0130-001,2013,6,13,18,1837,2214,4051,3657
0130-001,2013,6,13,19,1772,2554,4326,4051
0130-001,2013,6,13,20,1437,1866,3303,4326
0130-001,2013,6,13,21,1288,1688,2976,3303
0130-001,2013,6,13,22,1235,1333,2568,2976
0130-001,2013,6,13,23,1071,906,1977,2568
0130-001,2013,6,13,24,622,551,1173,1977
0130-001,2013,6,14,1,434,383,817,1173
0130-001,2013,6,14,2,286,239,525,817
0130-001,2013,6,14,3,193,211,404,525
0130-001,2013,6,14,4,153,177,330,404
0130-001,2013,6,14,5,203,233,436,330
0130-001,2013,6,14,6,473,443,916,436
0130-001,2013,6,14,7,1348,868,2216,916
0130-001,2013,6,14,8,2172,1754,3926,2216
0130-001,2013,6,14,9,2191,1977,4168,3926
0130-001,2013,6,14,10,1701,1754,3455,4168
0130-001,2013,6,14,11,1731,1675,3406,3455
0130-001,2013,6,14,12,1607,1876,3483,3406
0130-001,2013,6,14,13,1397,1604,3001,3483
0130-001,2013,6,14,14,1809,1665,3474,3001
0130-001,2013,6,14,15,1829,1796,3625,3474
0130-001,2013,6,14,16,1849,1857,3706,3625
0130-001,2013,6,14,17,1889,1979,3868,3706
0130-001,2013,6,14,18,1938,2389,4327,3868
0130-001,2013,6,14,19,1915,2697,4612,4327
0130-001,2013,6,14,20,1674,2365,4039,4612
0130-001,2013,6,14,21,1413,2004,3417,4039
0130-001,2013,6,14,22,1309,1499,2808,3417
0130-001,2013,6,14,23,1069,998,2067,2808
0130-001,2013,6,14,24,702,620,1322,2067
0130-001,2013,6,15,1,531,438,969,1322
0130-001,2013,6,15,2,335,304,639,969
0130-001,2013,6,15,3,297,265,562,639
0130-001,2013,6,15,4,252,237,489,562
0130-001,2013,6,15,5,254,291,545,489
0130-001,2013,6,15,6,497,465,962,545
0130-001,2013,6,15,7,1007,775,1782,962
0130-001,2013,6,15,8,1461,1155,2616,1782
0130-001,2013,6,15,9,1638,1754,3392,2616
0130-001,2013,6,15,10,1681,1888,3569,3392
0130-001,2013,6,15,11,1648,2002,3650,3569
0130-001,2013,6,15,12,1643,2097,3740,3650
0130-001,2013,6,15,13,1621,2324,3945,3740
0130-001,2013,6,15,14,1633,2144,3777,3945
0130-001,2013,6,15,15,1656,2067,3723,3777
0130-001,2013,6,15,16,1757,1992,3749,3723
0130-001,2013,6,15,17,1739,2010,3749,3749
0130-001,2013,6,15,18,1982,2305,4287,3749
0130-001,2013,6,15,19,1873,2252,4125,4287
0130-001,2013,6,15,20,1428,1539,2967,4125
0130-001,2013,6,15,21,1199,1342,2541,2967
0130-001,2013,6,15,22,1216,1114,2330,2541
0130-001,2013,6,15,23,949,730,1679,2330
0130-001,2013,6,15,24,603,528,1131,1679
0130-001,2013,6,16,1,469,393,862,1131
0130-001,2013,6,16,2,324,297,621,862
0130-001,2013,6,16,3,246,216,462,621
0130-001,2013,6,16,4,215,191,406,462
0130-001,2013,6,16,5,240,189,429,406
0130-001,2013,6,16,6,374,349,723,429
0130-001,2013,6,16,7,648,512,1160,723
0130-001,2013,6,16,8,857,739,1596,1160
0130-001,2013,6,16,9,912,953,1865,1596
0130-001,2013,6,16,10,959,1125,2084,1865
0130-001,2013,6,16,11,1150,1243,2393,2084
0130-001,2013,6,16,12,1139,1333,2472,2393
0130-001,2013,6,16,13,1183,1485,2668,2472
0130-001,2013,6,16,14,1387,1450,2837,2668
0130-001,2013,6,16,15,1563,1473,3036,2837
0130-001,2013,6,16,16,1917,1402,3319,3036
0130-001,2013,6,16,17,1882,1484,3366,3319
0130-001,2013,6,16,18,1883,1618,3501,3366
0130-001,2013,6,16,19,1835,1546,3381,3501
0130-001,2013,6,16,20,1393,1283,2676,3381
0130-001,2013,6,16,21,1335,1222,2557,2676
0130-001,2013,6,16,22,1121,955,2076,2557
0130-001,2013,6,16,23,838,630,1468,2076
0130-001,2013,6,16,24,529,423,952,1468
0130-001,2013,6,17,1,290,254,544,952
0130-001,2013,6,17,2,192,187,379,544
0130-001,2013,6,17,3,133,128,261,379
0130-001,2013,6,17,4,138,145,283,261
0130-001,2013,6,17,5,197,221,418,283
0130-001,2013,6,17,6,472,436,908,418
0130-001,2013,6,17,7,1454,960,2414,908
0130-001,2013,6,17,8,2199,1878,4077,2414
0130-001,2013,6,17,9,2164,1969,4133,4077
0130-001,2013,6,17,10,1727,1824,3551,4133
0130-001,2013,6,17,11,1689,1665,3354,3551
0130-001,2013,6,17,12,1725,1679,3404,3354
0130-001,2013,6,17,13,1444,1564,3008,3404
0130-001,2013,6,17,14,1744,1829,3573,3008
0130-001,2013,6,17,15,1791,1906,3697,3573
0130-001,2013,6,17,16,1862,1911,3773,3697
0130-001,2013,6,17,17,1775,1909,3684,3773
0130-001,2013,6,17,18,1775,2253,4028,3684
0130-001,2013,6,17,19,1841,2460,4301,4028
0130-001,2013,6,17,20,1487,1812,3299,4301
0130-001,2013,6,17,21,1273,1753,3026,3299
0130-001,2013,6,17,22,1181,1345,2526,3026
0130-001,2013,6,17,23,818,825,1643,2526
0130-001,2013,6,17,24,586,511,1097,1643
0130-001,2013,6,18,1,382,352,734,1097
0130-001,2013,6,18,2,226,221,447,734
0130-001,2013,6,18,3,185,173,358,447
0130-001,2013,6,18,4,148,164,312,358
0130-001,2013,6,18,5,162,214,376,312
0130-001,2013,6,18,6,329,334,663,376
0130-001,2013,6,18,7,1165,703,1868,663
0130-001,2013,6,18,8,2042,1673,3715,1868
0130-001,2013,6,18,9,2124,1921,4045,3715
0130-001,2013,6,18,10,1636,1669,3305,4045
0130-001,2013,6,18,11,1635,1566,3201,3305
0130-001,2013,6,18,12,1565,1513,3078,3201
0130-001,2013,6,18,13,1298,1433,2731,3078
0130-001,2013,6,18,14,1578,1590,3168,2731
0130-001,2013,6,18,15,1607,1642,3249,3168
0130-001,2013,6,18,16,1601,1568,3169,3249
0130-001,2013,6,18,17,1568,1721,3289,3169
0130-001,2013,6,18,18,1656,2044,3700,3289
0130-001,2013,6,18,19,1676,2284,3960,3700
0130-001,2013,6,18,20,1325,1634,2959,3960
0130-001,2013,6,18,21,1243,1678,2921,2959
0130-001,2013,6,18,22,965,1101,2066,2921
0130-001,2013,6,18,23,829,707,1536,2066
0130-001,2013,6,18,24,583,510,1093,1536
0130-001,2013,6,19,1,350,295,645,1093
0130-001,2013,6,19,2,232,196,428,645
0130-001,2013,6,19,3,154,165,319,428
0130-001,2013,6,19,4,144,145,289,319
0130-001,2013,6,19,5,157,224,381,289
0130-001,2013,6,19,6,402,422,824,381
0130-001,2013,6,19,7,1291,748,2039,824
0130-001,2013,6,19,8,2179,1736,3915,2039
0130-001,2013,6,19,9,2137,1974,4111,3915
0130-001,2013,6,19,10,1688,1733,3421,4111
0130-001,2013,6,19,11,1748,1690,3438,3421
0130-001,2013,6,19,12,1631,1534,3165,3438
0130-001,2013,6,19,13,1426,1486,2912,3165
0130-001,2013,6,19,14,1709,1765,3474,2912
0130-001,2013,6,19,15,1797,1813,3610,3474
0130-001,2013,6,19,16,1784,1829,3613,3610
0130-001,2013,6,19,17,1785,1781,3566,3613
0130-001,2013,6,19,18,1764,2315,4079,3566
0130-001,2013,6,19,19,1818,2528,4346,4079
0130-001,2013,6,19,20,1506,1906,3412,4346
0130-001,2013,6,19,21,1373,1635,3008,3412
0130-001,2013,6,19,22,1228,1292,2520,3008
0130-001,2013,6,19,23,966,874,1840,2520
0130-001,2013,6,19,24,685,573,1258,1840
0130-001,2013,6,20,1,442,385,827,1258
0130-001,2013,6,20,2,265,230,495,827
0130-001,2013,6,20,3,169,199,368,495
0130-001,2013,6,20,4,179,160,339,368
0130-001,2013,6,20,5,246,251,497,339
0130-001,2013,6,20,6,411,434,845,497
0130-001,2013,6,20,7,1340,838,2178,845
0130-001,2013,6,20,8,2106,1723,3829,2178
0130-001,2013,6,20,9,2252,2040,4292,3829
0130-001,2013,6,20,10,1715,1766,3481,4292
0130-001,2013,6,20,11,1746,1672,3418,3481
0130-001,2013,6,20,12,1612,1678,3290,3418
0130-001,2013,6,20,13,1389,1440,2829,3290
0130-001,2013,6,20,14,1735,1674,3409,2829
0130-001,2013,6,20,15,1687,1703,3390,3409
0130-001,2013,6,20,16,1721,1803,3524,3390
0130-001,2013,6,20,17,1750,1865,3615,3524
0130-001,2013,6,20,18,1761,2195,3956,3615
0130-001,2013,6,20,19,1833,2426,4259,3956
0130-001,2013,6,20,20,1462,1934,3396,4259
0130-001,2013,6,20,21,1358,1734,3092,3396
0130-001,2013,6,20,22,1259,1450,2709,3092
0130-001,2013,6,20,23,992,909,1901,2709
0130-001,2013,6,20,24,684,590,1274,1901
0130-001,2013,6,21,1,400,358,758,1274
0130-001,2013,6,21,2,299,267,566,758
0130-001,2013,6,21,3,205,195,400,566
0130-001,2013,6,21,4,196,202,398,400
0130-001,2013,6,21,5,227,272,499,398
0130-001,2013,6,21,6,451,437,888,499
0130-001,2013,6,21,7,1370,778,2148,888
0130-001,2013,6,21,8,2160,1793,3953,2148
0130-001,2013,6,21,9,2199,2019,4218,3953
0130-001,2013,6,21,10,1712,1782,3494,4218
0130-001,2013,6,21,11,1752,1650,3402,3494
0130-001,2013,6,21,12,1701,1707,3408,3402
0130-001,2013,6,21,13,1480,1727,3207,3408
0130-001,2013,6,21,14,1741,1807,3548,3207
0130-001,2013,6,21,15,1755,1845,3600,3548
0130-001,2013,6,21,16,1939,1831,3770,3600
0130-001,2013,6,21,17,1899,1846,3745,3770
0130-001,2013,6,21,18,2000,2354,4354,3745
0130-001,2013,6,21,19,1975,2219,4194,4354
0130-001,2013,6,21,20,1722,2455,4177,4194
0130-001,2013,6,21,21,1429,1880,3309,4177
0130-001,2013,6,21,22,1464,1481,2945,3309
0130-001,2013,6,21,23,1047,1028,2075,2945
0130-001,2013,6,21,24,769,689,1458,2075
0130-001,2013,6,22,1,571,475,1046,1458
0130-001,2013,6,22,2,380,311,691,1046
0130-001,2013,6,22,3,298,263,561,691
0130-001,2013,6,22,4,243,222,465,561
0130-001,2013,6,22,5,310,307,617,465
0130-001,2013,6,22,6,477,427,904,617
0130-001,2013,6,22,7,974,690,1664,904
0130-001,2013,6,22,8,1545,1140,2685,1664
0130-001,2013,6,22,9,1586,1679,3265,2685
0130-001,2013,6,22,10,1582,1857,3439,3265
0130-001,2013,6,22,11,1662,1894,3556,3439
0130-001,2013,6,22,12,1669,2163,3832,3556
0130-001,2013,6,22,13,1582,2297,3879,3832
0130-001,2013,6,22,14,1657,2165,3822,3879
0130-001,2013,6,22,15,1647,1939,3586,3822
0130-001,2013,6,22,16,1730,1996,3726,3586
0130-001,2013,6,22,17,1772,1994,3766,3726
0130-001,2013,6,22,18,1908,2221,4129,3766
0130-001,2013,6,22,19,1783,2160,3943,4129
0130-001,2013,6,22,20,1381,1638,3019,3943
0130-001,2013,6,22,21,1205,1338,2543,3019
0130-001,2013,6,22,22,1148,1032,2180,2543
0130-001,2013,6,22,23,848,772,1620,2180
0130-001,2013,6,22,24,577,536,1113,1620
0130-001,2013,6,23,1,463,346,809,1113
0130-001,2013,6,23,2,331,280,611,809
0130-001,2013,6,23,3,265,238,503,611
0130-001,2013,6,23,4,223,190,413,503
0130-001,2013,6,23,5,222,192,414,413
0130-001,2013,6,23,6,383,341,724,414
0130-001,2013,6,23,7,575,455,1030,724
0130-001,2013,6,23,8,713,666,1379,1030
0130-001,2013,6,23,9,884,955,1839,1379
0130-001,2013,6,23,10,976,1050,2026,1839
0130-001,2013,6,23,11,1133,1239,2372,2026
0130-001,2013,6,23,12,1043,1253,2296,2372
0130-001,2013,6,23,13,1265,1368,2633,2296
0130-001,2013,6,23,14,1404,1429,2833,2633
0130-001,2013,6,23,15,1476,1367,2843,2833
0130-001,2013,6,23,16,1606,1471,3077,2843
0130-001,2013,6,23,17,1769,1436,3205,3077
0130-001,2013,6,23,18,1758,1572,3330,3205
0130-001,2013,6,23,19,1792,1346,3138,3330
0130-001,2013,6,23,20,1352,1190,2542,3138
0130-001,2013,6,23,21,1246,1093,2339,2542
0130-001,2013,6,23,22,1089,959,2048,2339
0130-001,2013,6,23,23,676,601,1277,2048
0130-001,2013,6,23,24,515,415,930,1277
0130-001,2013,6,24,1,292,251,543,930
0130-001,2013,6,24,2,177,153,330,543
0130-001,2013,6,24,3,131,123,254,330
0130-001,2013,6,24,4,117,138,255,254
0130-001,2013,6,24,5,205,229,434,255
0130-001,2013,6,24,6,438,448,886,434
0130-001,2013,6,24,7,1491,904,2395,886
0130-001,2013,6,24,8,2130,1847,3977,2395
0130-001,2013,6,24,9,2183,2050,4233,3977
0130-001,2013,6,24,10,1717,1786,3503,4233
0130-001,2013,6,24,11,1683,1646,3329,3503
0130-001,2013,6,24,12,1661,1573,3234,3329
0130-001,2013,6,24,13,1473,1580,3053,3234
0130-001,2013,6,24,14,1655,1748,3403,3053
0130-001,2013,6,24,15,1773,1861,3634,3403
0130-001,2013,6,24,16,1805,1818,3623,3634
0130-001,2013,6,24,17,1690,1882,3572,3623
0130-001,2013,6,24,18,1790,2231,4021,3572
0130-001,2013,6,24,19,1806,2400,4206,4021
0130-001,2013,6,24,20,1495,1841,3336,4206
0130-001,2013,6,24,21,1267,1757,3024,3336
0130-001,2013,6,24,22,1240,1495,2735,3024
0130-001,2013,6,24,23,929,858,1787,2735
0130-001,2013,6,24,24,615,540,1155,1787
0130-001,2013,6,25,1,377,349,726,1155
0130-001,2013,6,25,2,261,254,515,726
0130-001,2013,6,25,3,201,181,382,515
0130-001,2013,6,25,4,141,181,322,382
0130-001,2013,6,25,5,201,240,441,322
0130-001,2013,6,25,6,435,418,853,441
0130-001,2013,6,25,7,1394,820,2214,853
0130-001,2013,6,25,8,2119,1788,3907,2214
0130-001,2013,6,25,9,2153,2006,4159,3907
0130-001,2013,6,25,10,1743,1778,3521,4159
0130-001,2013,6,25,11,1685,1670,3355,3521
0130-001,2013,6,25,12,1614,1736,3350,3355
0130-001,2013,6,25,13,1390,1471,2861,3350
0130-001,2013,6,25,14,1687,1640,3327,2861
0130-001,2013,6,25,15,1714,1762,3476,3327
0130-001,2013,6,25,16,1775,1798,3573,3476
0130-001,2013,6,25,17,1679,1862,3541,3573
0130-001,2013,6,25,18,1772,2229,4001,3541
0130-001,2013,6,25,19,1762,2264,4026,4001
0130-001,2013,6,25,20,1463,1848,3311,4026
0130-001,2013,6,25,21,1200,1686,2886,3311
0130-001,2013,6,25,22,1117,1220,2337,2886
0130-001,2013,6,25,23,864,897,1761,2337
0130-001,2013,6,25,24,591,502,1093,1761
0130-001,2013,6,26,1,384,321,705,1093
0130-001,2013,6,26,2,234,246,480,705
0130-001,2013,6,26,3,184,169,353,480
0130-001,2013,6,26,4,145,168,313,353
0130-001,2013,6,26,5,216,232,448,313
0130-001,2013,6,26,6,423,425,848,448
0130-001,2013,6,26,7,1310,796,2106,848
0130-001,2013,6,26,8,2147,1742,3889,2106
0130-001,2013,6,26,9,2216,1975,4191,3889
0130-001,2013,6,26,10,1696,1722,3418,4191
0130-001,2013,6,26,11,1717,1678,3395,3418
0130-001,2013,6,26,12,1669,1625,3294,3395
0130-001,2013,6,26,13,1430,1458,2888,3294
0130-001,2013,6,26,14,1727,1687,3414,2888
0130-001,2013,6,26,15,1700,1748,3448,3414
0130-001,2013,6,26,16,1751,1816,3567,3448
0130-001,2013,6,26,17,1666,1742,3408,3567
0130-001,2013,6,26,18,1796,2181,3977,3408
0130-001,2013,6,26,19,1846,2380,4226,3977
0130-001,2013,6,26,20,1432,1957,3389,4226
0130-001,2013,6,26,21,1341,1703,3044,3389
0130-001,2013,6,26,22,1289,1586,2875,3044
0130-001,2013,6,26,23,962,908,1870,2875
0130-001,2013,6,26,24,679,574,1253,1870
0130-001,2013,6,27,1,454,356,810,1253
0130-001,2013,6,27,2,265,257,522,810
0130-001,2013,6,27,3,180,156,336,522
0130-001,2013,6,27,4,166,200,366,336
0130-001,2013,6,27,5,228,254,482,366
0130-001,2013,6,27,6,454,438,892,482
0130-001,2013,6,27,7,1355,825,2180,892
0130-001,2013,6,27,8,2121,1801,3922,2180
0130-001,2013,6,27,9,2183,2017,4200,3922
0130-001,2013,6,27,10,1799,1745,3544,4200
0130-001,2013,6,27,11,1794,1760,3554,3544
0130-001,2013,6,27,12,1675,1572,3247,3554
0130-001,2013,6,27,13,1375,1552,2927,3247
0130-001,2013,6,27,14,1716,1727,3443,2927
0130-001,2013,6,27,15,1748,1776,3524,3443
0130-001,2013,6,27,16,1720,1782,3502,3524
0130-001,2013,6,27,17,1743,1913,3656,3502
0130-001,2013,6,27,18,1690,2223,3913,3656
0130-001,2013,6,27,19,1748,2413,4161,3913
0130-001,2013,6,27,20,1460,1819,3279,4161
0130-001,2013,6,27,21,1234,1729,2963,3279
0130-001,2013,6,27,22,1228,1393,2621,2963
0130-001,2013,6,27,23,932,838,1770,2621
0130-001,2013,6,27,24,665,572,1237,1770
0130-001,2013,6,28,1,462,352,814,1237
0130-001,2013,6,28,2,282,274,556,814
0130-001,2013,6,28,3,196,216,412,556
0130-001,2013,6,28,4,165,178,343,412
0130-001,2013,6,28,5,216,250,466,343
0130-001,2013,6,28,6,461,402,863,466
0130-001,2013,6,28,7,1344,824,2168,863
0130-001,2013,6,28,8,2135,1788,3923,2168
0130-001,2013,6,28,9,2095,1956,4051,3923
0130-001,2013,6,28,10,1790,1677,3467,4051
0130-001,2013,6,28,11,1781,1803,3584,3467
0130-001,2013,6,28,12,1659,1740,3399,3584
0130-001,2013,6,28,13,1503,1600,3103,3399
0130-001,2013,6,28,14,1721,1788,3509,3103
0130-001,2013,6,28,15,1782,1839,3621,3509
0130-001,2013,6,28,16,1922,1982,3904,3621
0130-001,2013,6,28,17,1808,1856,3664,3904
0130-001,2013,6,28,18,1872,2341,4213,3664
0130-001,2013,6,28,19,1967,2599,4566,4213
0130-001,2013,6,28,20,1588,2032,3620,4566
0130-001,2013,6,28,21,1457,1872,3329,3620
0130-001,2013,6,28,22,1322,1456,2778,3329
0130-001,2013,6,28,23,1115,994,2109,2778
0130-001,2013,6,28,24,759,685,1444,2109
0130-001,2013,6,29,1,477,510,987,1444
0130-001,2013,6,29,2,356,317,673,987
0130-001,2013,6,29,3,283,246,529,673
0130-001,2013,6,29,4,224,233,457,529
0130-001,2013,6,29,5,289,309,598,457
0130-001,2013,6,29,6,485,462,947,598
0130-001,2013,6,29,7,972,675,1647,947
0130-001,2013,6,29,8,1504,1164,2668,1647
0130-001,2013,6,29,9,1571,1660,3231,2668
0130-001,2013,6,29,10,1686,1819,3505,3231
0130-001,2013,6,29,11,1608,1971,3579,3505
0130-001,2013,6,29,12,1587,2018,3605,3579
0130-001,2013,6,29,13,1498,2247,3745,3605
0130-001,2013,6,29,14,1623,2099,3722,3745
0130-001,2013,6,29,15,1629,2006,3635,3722
0130-001,2013,6,29,16,1769,1948,3717,3635
0130-001,2013,6,29,17,1735,1803,3538,3717
0130-001,2013,6,29,18,1878,2062,3940,3538
0130-001,2013,6,29,19,1728,1927,3655,3940
0130-001,2013,6,29,20,1405,1503,2908,3655
0130-001,2013,6,29,21,1283,1333,2616,2908
0130-001,2013,6,29,22,1156,1068,2224,2616
0130-001,2013,6,29,23,906,779,1685,2224
0130-001,2013,6,29,24,595,538,1133,1685
0130-001,2013,6,30,1,466,370,836,1133
0130-001,2013,6,30,2,328,289,617,836
0130-001,2013,6,30,3,256,227,483,617
0130-001,2013,6,30,4,219,191,410,483
0130-001,2013,6,30,5,231,191,422,410
0130-001,2013,6,30,6,379,345,724,422
0130-001,2013,6,30,7,612,484,1096,724
0130-001,2013,6,30,8,785,703,1488,1096
0130-001,2013,6,30,9,898,954,1852,1488
0130-001,2013,6,30,10,968,1088,2056,1852
0130-001,2013,6,30,11,1142,1241,2383,2056
0130-001,2013,6,30,12,1091,1293,2384,2383
0130-001,2013,6,30,13,1224,1427,2651,2384
0130-001,2013,6,30,14,1396,1440,2836,2651
0130-001,2013,6,30,15,1520,1420,2940,2836
0130-001,2013,6,30,16,1762,1437,3199,2940
0130-001,2013,6,30,17,1826,1460,3286,3199
0130-001,2013,6,30,18,1821,1595,3416,3286
0130-001,2013,6,30,19,1814,1446,3260,3416
0130-001,2013,6,30,20,1373,1237,2610,3260
0130-001,2013,6,30,21,1291,1158,2449,2610
0130-001,2013,6,30,22,1105,957,2062,2449
0130-001,2013,6,30,23,757,616,1373,2062
0130-001,2013,6,30,24,522,419,941,1373
0130-001,2013,7,1,1,310,261,571,941
0130-001,2013,7,1,2,218,147,365,571
0130-001,2013,7,1,3,136,121,257,365
0130-001,2013,7,1,4,131,134,265,257
0130-001,2013,7,1,5,200,227,427,265
0130-001,2013,7,1,6,478,441,919,427
0130-001,2013,7,1,7,1542,904,2446,919
0130-001,2013,7,1,8,2202,1830,4032,2446
0130-001,2013,7,1,9,2165,2067,4232,4032
0130-001,2013,7,1,10,1747,1795,3542,4232
0130-001,2013,7,1,11,1779,1621,3400,3542
0130-001,2013,7,1,12,1590,1686,3276,3400
0130-001,2013,7,1,13,1476,1617,3093,3276
0130-001,2013,7,1,14,1769,1652,3421,3093
0130-001,2013,7,1,15,1811,1818,3629,3421
0130-001,2013,7,1,16,1798,1899,3697,3629
0130-001,2013,7,1,17,1688,1922,3610,3697
0130-001,2013,7,1,18,1788,2210,3998,3610
0130-001,2013,7,1,19,1878,2256,4134,3998
0130-001,2013,7,1,20,1547,1832,3379,4134
0130-001,2013,7,1,21,1326,1800,3126,3379
0130-001,2013,7,1,22,1165,1439,2604,3126
0130-001,2013,7,1,23,883,914,1797,2604
0130-001,2013,7,1,24,606,522,1128,1797
0130-001,2013,7,2,1,390,352,742,1128
0130-001,2013,7,2,2,265,243,508,742
0130-001,2013,7,2,3,198,194,392,508
0130-001,2013,7,2,4,127,152,279,392
0130-001,2013,7,2,5,183,244,427,279
0130-001,2013,7,2,6,324,385,709,427
0130-001,2013,7,2,7,1243,668,1911,709
0130-001,2013,7,2,8,2133,1741,3874,1911
0130-001,2013,7,2,9,2164,1960,4124,3874
0130-001,2013,7,2,10,1581,1652,3233,4124
0130-001,2013,7,2,11,1624,1668,3292,3233
0130-001,2013,7,2,12,1592,1616,3208,3292
0130-001,2013,7,2,13,1423,1496,2919,3208
0130-001,2013,7,2,14,1660,1588,3248,2919
0130-001,2013,7,2,15,1694,1678,3372,3248
0130-001,2013,7,2,16,1721,1742,3463,3372
0130-001,2013,7,2,17,1585,1777,3362,3463
0130-001,2013,7,2,18,1650,2116,3766,3362
0130-001,2013,7,2,19,1721,2210,3931,3766
0130-001,2013,7,2,20,1320,1756,3076,3931
0130-001,2013,7,2,21,1244,1639,2883,3076
0130-001,2013,7,2,22,1042,1218,2260,2883
0130-001,2013,7,2,23,861,741,1602,2260
0130-001,2013,7,2,24,494,458,952,1602
0130-001,2013,7,3,1,337,312,649,952
0130-001,2013,7,3,2,245,203,448,649
0130-001,2013,7,3,3,185,149,334,448
0130-001,2013,7,3,4,141,150,291,334
0130-001,2013,7,3,5,186,220,406,291
0130-001,2013,7,3,6,376,351,727,406
0130-001,2013,7,3,7,1226,725,1951,727
0130-001,2013,7,3,8,2172,1756,3928,1951
0130-001,2013,7,3,9,2091,1946,4037,3928
0130-001,2013,7,3,10,1691,1754,3445,4037
0130-001,2013,7,3,11,1732,1668,3400,3445
0130-001,2013,7,3,12,1636,1594,3230,3400
0130-001,2013,7,3,13,1386,1444,2830,3230
0130-001,2013,7,3,14,1667,1618,3285,2830
0130-001,2013,7,3,15,1767,1724,3491,3285
0130-001,2013,7,3,16,1740,1841,3581,3491
0130-001,2013,7,3,17,1689,1793,3482,3581
0130-001,2013,7,3,18,1791,2276,4067,3482
0130-001,2013,7,3,19,1860,2520,4380,4067
0130-001,2013,7,3,20,1431,1926,3357,4380
0130-001,2013,7,3,21,1304,1631,2935,3357
0130-001,2013,7,3,22,1184,1266,2450,2935
0130-001,2013,7,3,23,970,863,1833,2450
0130-001,2013,7,3,24,609,549,1158,1833
0130-001,2013,7,4,1,392,340,732,1158
0130-001,2013,7,4,2,260,262,522,732
0130-001,2013,7,4,3,189,191,380,522
0130-001,2013,7,4,4,160,185,345,380
0130-001,2013,7,4,5,223,265,488,345
0130-001,2013,7,4,6,419,393,812,488
0130-001,2013,7,4,7,1309,788,2097,812
0130-001,2013,7,4,8,2195,1755,3950,2097
0130-001,2013,7,4,9,2160,1968,4128,3950
0130-001,2013,7,4,10,1726,1654,3380,4128
0130-001,2013,7,4,11,1739,1564,3303,3380
0130-001,2013,7,4,12,1649,1550,3199,3303
0130-001,2013,7,4,13,1376,1503,2879,3199
0130-001,2013,7,4,14,1596,1694,3290,2879
0130-001,2013,7,4,15,1687,1753,3440,3290
0130-001,2013,7,4,16,1733,1738,3471,3440
0130-001,2013,7,4,17,1600,1774,3374,3471
0130-001,2013,7,4,18,1634,2177,3811,3374
0130-001,2013,7,4,19,1738,2370,4108,3811
0130-001,2013,7,4,20,1343,1670,3013,4108
0130-001,2013,7,4,21,1186,1681,2867,3013
0130-001,2013,7,4,22,1111,1233,2344,2867
0130-001,2013,7,4,23,875,812,1687,2344
0130-001,2013,7,4,24,607,489,1096,1687
0130-001,2013,7,5,1,351,343,694,1096
0130-001,2013,7,5,2,243,238,481,694
0130-001,2013,7,5,3,177,176,353,481
0130-001,2013,7,5,4,154,183,337,353
0130-001,2013,7,5,5,165,207,372,337
0130-001,2013,7,5,6,323,329,652,372
0130-001,2013,7,5,7,1121,663,1784,652
0130-001,2013,7,5,8,2096,1668,3764,1784
0130-001,2013,7,5,9,2198,1937,4135,3764
0130-001,2013,7,5,10,1592,1771,3363,4135
0130-001,2013,7,5,11,1770,1769,3539,3363
0130-001,2013,7,5,12,1621,1612,3233,3539
0130-001,2013,7,5,13,1499,1461,2960,3233
0130-001,2013,7,5,14,1650,1779,3429,2960
0130-001,2013,7,5,15,1811,1801,3612,3429
0130-001,2013,7,5,16,1809,1756,3565,3612
0130-001,2013,7,5,17,1786,1915,3701,3565
0130-001,2013,7,5,18,1899,2246,4145,3701
0130-001,2013,7,5,19,1914,2655,4569,4145
0130-001,2013,7,5,20,1663,1991,3654,4569
0130-001,2013,7,5,21,1352,1870,3222,3654
0130-001,2013,7,5,22,1256,1364,2620,3222
0130-001,2013,7,5,23,992,985,1977,2620
0130-001,2013,7,5,24,742,659,1401,1977
0130-001,2013,7,6,1,533,419,952,1401
0130-001,2013,7,6,2,390,334,724,952
0130-001,2013,7,6,3,289,259,548,724
0130-001,2013,7,6,4,225,209,434,548
0130-001,2013,7,6,5,293,301,594,434
0130-001,2013,7,6,6,489,435,924,594
0130-001,2013,7,6,7,977,655,1632,924
0130-001,2013,7,6,8,1437,1036,2473,1632
0130-001,2013,7,6,9,1561,1623,3184,2473
0130-001,2013,7,6,10,1562,1809,3371,3184
0130-001,2013,7,6,11,1646,1722,3368,3371
0130-001,2013,7,6,12,1559,1990,3549,3368
0130-001,2013,7,6,13,1550,2082,3632,3549
0130-001,2013,7,6,14,1557,1901,3458,3632
0130-001,2013,7,6,15,1655,2039,3694,3458
0130-001,2013,7,6,16,1707,1877,3584,3694
0130-001,2013,7,6,17,1719,1794,3513,3584
0130-001,2013,7,6,18,1875,2166,4041,3513
0130-001,2013,7,6,19,1795,1966,3761,4041
0130-001,2013,7,6,20,1478,1437,2915,3761
0130-001,2013,7,6,21,1280,1272,2552,2915
0130-001,2013,7,6,22,1184,1105,2289,2552
0130-001,2013,7,6,23,873,806,1679,2289
0130-001,2013,7,6,24,623,524,1147,1679
0130-001,2013,7,7,1,409,384,793,1147
0130-001,2013,7,7,2,314,266,580,793
0130-001,2013,7,7,3,224,222,446,580
0130-001,2013,7,7,4,219,191,410,446
0130-001,2013,7,7,5,219,174,393,410
0130-001,2013,7,7,6,348,326,674,393
0130-001,2013,7,7,7,556,463,1019,674
0130-001,2013,7,7,8,670,577,1247,1019
0130-001,2013,7,7,9,798,834,1632,1247
0130-001,2013,7,7,10,892,1017,1909,1632
0130-001,2013,7,7,11,1005,1238,2243,1909
0130-001,2013,7,7,12,1085,1312,2397,2243
0130-001,2013,7,7,13,1165,1484,2649,2397
0130-001,2013,7,7,14,1357,1446,2803,2649
0130-001,2013,7,7,15,1514,1505,3019,2803
0130-001,2013,7,7,16,1516,1470,2986,3019
0130-001,2013,7,7,17,1658,1386,3044,2986
0130-001,2013,7,7,18,1748,1509,3257,3044
0130-001,2013,7,7,19,1717,1235,2952,3257
0130-001,2013,7,7,20,1293,1064,2357,2952
0130-001,2013,7,7,21,1145,1035,2180,2357
0130-001,2013,7,7,22,1054,843,1897,2180
0130-001,2013,7,7,23,680,560,1240,1897
0130-001,2013,7,7,24,463,356,819,1240
0130-001,2013,7,8,1,261,242,503,819
0130-001,2013,7,8,2,166,148,314,503
0130-001,2013,7,8,3,132,117,249,314
0130-001,2013,7,8,4,123,130,253,249
0130-001,2013,7,8,5,163,232,395,253
0130-001,2013,7,8,6,415,397,812,395
0130-001,2013,7,8,7,1358,811,2169,812
0130-001,2013,7,8,8,2191,1797,3988,2169
0130-001,2013,7,8,9,2160,1940,4100,3988
0130-001,2013,7,8,10,1633,1697,3330,4100
0130-001,2013,7,8,11,1633,1567,3200,3330
0130-001,2013,7,8,12,1463,1508,2971,3200
0130-001,2013,7,8,13,1335,1438,2773,2971
0130-001,2013,7,8,14,1572,1561,3133,2773
0130-001,2013,7,8,15,1709,1698,3407,3133
0130-001,2013,7,8,16,1633,1687,3320,3407
0130-001,2013,7,8,17,1506,1710,3216,3320
0130-001,2013,7,8,18,1616,2099,3715,3216
0130-001,2013,7,8,19,1720,2334,4054,3715
0130-001,2013,7,8,20,1301,1590,2891,4054
0130-001,2013,7,8,21,1085,1607,2692,2891
0130-001,2013,7,8,22,1082,1225,2307,2692
0130-001,2013,7,8,23,803,690,1493,2307
0130-001,2013,7,8,24,494,422,916,1493
0130-001,2013,7,9,1,325,314,639,916
0130-001,2013,7,9,2,240,206,446,639
0130-001,2013,7,9,3,158,155,313,446
0130-001,2013,7,9,4,127,150,277,313
0130-001,2013,7,9,5,183,225,408,277
0130-001,2013,7,9,6,399,426,825,408
0130-001,2013,7,9,7,1190,731,1921,825
0130-001,2013,7,9,8,2170,1722,3892,1921
0130-001,2013,7,9,9,2163,1934,4097,3892
0130-001,2013,7,9,10,1675,1645,3320,4097
0130-001,2013,7,9,11,1735,1587,3322,3320
0130-001,2013,7,9,12,1525,1703,3228,3322
0130-001,2013,7,9,13,1339,1615,2954,3228
0130-001,2013,7,9,14,1748,1714,3462,2954
0130-001,2013,7,9,15,1814,1832,3646,3462
0130-001,2013,7,9,16,1759,2057,3816,3646
0130-001,2013,7,9,17,1687,2017,3704,3816
0130-001,2013,7,9,18,1779,2168,3947,3704
0130-001,2013,7,9,19,1834,2492,4326,3947
0130-001,2013,7,9,20,1374,1792,3166,4326
0130-001,2013,7,9,21,1191,1746,2937,3166
0130-001,2013,7,9,22,1182,1300,2482,2937
0130-001,2013,7,9,23,911,855,1766,2482
0130-001,2013,7,9,24,576,506,1082,1766
0130-001,2013,7,10,1,389,358,747,1082
0130-001,2013,7,10,2,244,223,467,747
0130-001,2013,7,10,3,173,199,372,467
0130-001,2013,7,10,4,171,180,351,372
0130-001,2013,7,10,5,212,283,495,351
0130-001,2013,7,10,6,412,415,827,495
0130-001,2013,7,10,7,1253,760,2013,827
0130-001,2013,7,10,8,2225,1654,3879,2013
0130-001,2013,7,10,9,2198,2012,4210,3879
0130-001,2013,7,10,10,1655,1724,3379,4210
0130-001,2013,7,10,11,1735,1664,3399,3379
0130-001,2013,7,10,12,1527,1651,3178,3399
0130-001,2013,7,10,13,1394,1537,2931,3178
0130-001,2013,7,10,14,1703,1685,3388,2931
0130-001,2013,7,10,15,1774,1721,3495,3388
0130-001,2013,7,10,16,1777,1875,3652,3495
0130-001,2013,7,10,17,1679,1820,3499,3652
0130-001,2013,7,10,18,1827,2273,4100,3499
0130-001,2013,7,10,19,1874,2640,4514,4100
0130-001,2013,7,10,20,1439,1912,3351,4514
0130-001,2013,7,10,21,1290,1647,2937,3351
0130-001,2013,7,10,22,1230,1318,2548,2937
0130-001,2013,7,10,23,978,788,1766,2548
0130-001,2013,7,10,24,613,519,1132,1766
0130-001,2013,7,11,1,440,360,800,1132
0130-001,2013,7,11,2,264,269,533,800
0130-001,2013,7,11,3,220,207,427,533
0130-001,2013,7,11,4,169,187,356,427
0130-001,2013,7,11,5,221,254,475,356
0130-001,2013,7,11,6,376,421,797,475
0130-001,2013,7,11,7,1269,774,2043,797
0130-001,2013,7,11,8,2175,1728,3903,2043
0130-001,2013,7,11,9,2236,2021,4257,3903
0130-001,2013,7,11,10,1757,1695,3452,4257
0130-001,2013,7,11,11,1698,1646,3344,3452
0130-001,2013,7,11,12,1588,1568,3156,3344
0130-001,2013,7,11,13,1417,1611,3028,3156
0130-001,2013,7,11,14,1704,1664,3368,3028
0130-001,2013,7,11,15,1793,1781,3574,3368
0130-001,2013,7,11,16,1738,1822,3560,3574
0130-001,2013,7,11,17,1637,1881,3518,3560
0130-001,2013,7,11,18,1792,2189,3981,3518
0130-001,2013,7,11,19,1820,2526,4346,3981
0130-001,2013,7,11,20,1410,1796,3206,4346
0130-001,2013,7,11,21,1259,1694,2953,3206
0130-001,2013,7,11,22,1184,1260,2444,2953
0130-001,2013,7,11,23,919,847,1766,2444
0130-001,2013,7,11,24,640,599,1239,1766
0130-001,2013,7,12,1,394,343,737,1239
0130-001,2013,7,12,2,263,238,501,737
0130-001,2013,7,12,3,223,222,445,501
0130-001,2013,7,12,4,161,189,350,445
0130-001,2013,7,12,5,205,257,462,350
0130-001,2013,7,12,6,435,402,837,462
0130-001,2013,7,12,7,1243,842,2085,837
0130-001,2013,7,12,8,2184,1749,3933,2085
0130-001,2013,7,12,9,2243,2136,4379,3933
0130-001,2013,7,12,10,1834,1762,3596,4379
0130-001,2013,7,12,11,1704,1737,3441,3596
0130-001,2013,7,12,12,1653,1695,3348,3441
0130-001,2013,7,12,13,1457,1515,2972,3348
0130-001,2013,7,12,14,1684,1783,3467,2972
0130-001,2013,7,12,15,1813,1961,3774,3467
0130-001,2013,7,12,16,1850,1999,3849,3774
0130-001,2013,7,12,17,1800,1950,3750,3849
0130-001,2013,7,12,18,1923,2440,4363,3750
0130-001,2013,7,12,19,2099,2681,4780,4363
0130-001,2013,7,12,20,1611,2256,3867,4780
0130-001,2013,7,12,21,1413,1740,3153,3867
0130-001,2013,7,12,22,1270,1345,2615,3153
0130-001,2013,7,12,23,976,912,1888,2615
0130-001,2013,7,12,24,698,577,1275,1888
0130-001,2013,7,13,1,496,410,906,1275
0130-001,2013,7,13,2,362,324,686,906
0130-001,2013,7,13,3,285,263,548,686
0130-001,2013,7,13,4,206,255,461,548
0130-001,2013,7,13,5,266,299,565,461
0130-001,2013,7,13,6,417,394,811,565
0130-001,2013,7,13,7,894,586,1480,811
0130-001,2013,7,13,8,1444,1158,2602,1480
0130-001,2013,7,13,9,1565,1736,3301,2602
0130-001,2013,7,13,10,1633,1795,3428,3301
0130-001,2013,7,13,11,1660,1906,3566,3428
0130-001,2013,7,13,12,1699,1918,3617,3566
0130-001,2013,7,13,13,1676,2224,3900,3617
0130-001,2013,7,13,14,1629,2172,3801,3900
0130-001,2013,7,13,15,1635,2153,3788,3801
0130-001,2013,7,13,16,1624,1957,3581,3788
0130-001,2013,7,13,17,1807,2011,3818,3581
0130-001,2013,7,13,18,1988,2277,4265,3818
0130-001,2013,7,13,19,1823,2244,4067,4265
0130-001,2013,7,13,20,1358,1413,2771,4067
0130-001,2013,7,13,21,1288,1227,2515,2771
0130-001,2013,7,13,22,1110,1060,2170,2515
0130-001,2013,7,13,23,813,733,1546,2170
0130-001,2013,7,13,24,600,483,1083,1546
0130-001,2013,7,14,1,416,384,800,1083
0130-001,2013,7,14,2,330,276,606,800
0130-001,2013,7,14,3,246,188,434,606
0130-001,2013,7,14,4,192,167,359,434
0130-001,2013,7,14,5,182,178,360,359
0130-001,2013,7,14,6,278,241,519,360
0130-001,2013,7,14,7,502,434,936,519
0130-001,2013,7,14,8,657,698,1355,936
0130-001,2013,7,14,9,839,970,1809,1355
0130-001,2013,7,14,10,860,1004,1864,1809
0130-001,2013,7,14,11,1087,1240,2327,1864
0130-001,2013,7,14,12,1082,1294,2376,2327
0130-001,2013,7,14,13,1160,1298,2458,2376
0130-001,2013,7,14,14,1227,1226,2453,2458
0130-001,2013,7,14,15,1367,1269,2636,2453
0130-001,2013,7,14,16,1627,1278,2905,2636
0130-001,2013,7,14,17,1823,1274,3097,2905
0130-001,2013,7,14,18,1619,1307,2926,3097
0130-001,2013,7,14,19,1760,1144,2904,2926
0130-001,2013,7,14,20,1349,1072,2421,2904
0130-001,2013,7,14,21,1195,917,2112,2421
0130-001,2013,7,14,22,901,677,1578,2112
0130-001,2013,7,14,23,626,493,1119,1578
0130-001,2013,7,14,24,396,348,744,1119
0130-001,2013,7,15,1,258,267,525,744
0130-001,2013,7,15,2,204,166,370,525
0130-001,2013,7,15,3,140,132,272,370
0130-001,2013,7,15,4,121,133,254,272
0130-001,2013,7,15,5,178,211,389,254
0130-001,2013,7,15,6,394,401,795,389
0130-001,2013,7,15,7,1398,773,2171,795
0130-001,2013,7,15,8,2178,1807,3985,2171
0130-001,2013,7,15,9,2152,2064,4216,3985
0130-001,2013,7,15,10,1712,1666,3378,4216
0130-001,2013,7,15,11,1685,1685,3370,3378
0130-001,2013,7,15,12,1615,1516,3131,3370
0130-001,2013,7,15,13,1433,1560,2993,3131
0130-001,2013,7,15,14,1778,1662,3440,2993
0130-001,2013,7,15,15,1817,1779,3596,3440
0130-001,2013,7,15,16,1810,1848,3658,3596
0130-001,2013,7,15,17,1683,1787,3470,3658
0130-001,2013,7,15,18,1713,2231,3944,3470
0130-001,2013,7,15,19,1864,2492,4356,3944
0130-001,2013,7,15,20,1399,1874,3273,4356
0130-001,2013,7,15,21,1243,1758,3001,3273
0130-001,2013,7,15,22,1230,1251,2481,3001
0130-001,2013,7,15,23,846,779,1625,2481
0130-001,2013,7,15,24,578,526,1104,1625
0130-001,2013,7,16,1,368,334,702,1104
0130-001,2013,7,16,2,214,225,439,702
0130-001,2013,7,16,3,190,181,371,439
0130-001,2013,7,16,4,157,188,345,371
0130-001,2013,7,16,5,188,243,431,345
0130-001,2013,7,16,6,428,411,839,431
0130-001,2013,7,16,7,1302,782,2084,839
0130-001,2013,7,16,8,2164,1715,3879,2084
0130-001,2013,7,16,9,2228,2005,4233,3879
0130-001,2013,7,16,10,1687,1675,3362,4233
0130-001,2013,7,16,11,1801,1738,3539,3362
0130-001,2013,7,16,12,1593,1566,3159,3539
0130-001,2013,7,16,13,1407,1512,2919,3159
0130-001,2013,7,16,14,1701,1639,3340,2919
0130-001,2013,7,16,15,1817,1786,3603,3340
0130-001,2013,7,16,16,1764,1812,3576,3603
0130-001,2013,7,16,17,1743,1824,3567,3576
0130-001,2013,7,16,18,1749,2257,4006,3567
0130-001,2013,7,16,19,1855,2487,4342,4006
0130-001,2013,7,16,20,1445,1929,3374,4342
0130-001,2013,7,16,21,1304,1715,3019,3374
0130-001,2013,7,16,22,1197,1303,2500,3019
0130-001,2013,7,16,23,944,871,1815,2500
0130-001,2013,7,16,24,610,486,1096,1815
0130-001,2013,7,17,1,397,338,735,1096
0130-001,2013,7,17,2,251,242,493,735
0130-001,2013,7,17,3,189,171,360,493
0130-001,2013,7,17,4,167,167,334,360
0130-001,2013,7,17,5,151,216,367,334
0130-001,2013,7,17,6,338,339,677,367
0130-001,2013,7,17,7,1099,668,1767,677
0130-001,2013,7,17,8,2063,1712,3775,1767
0130-001,2013,7,17,9,2008,1909,3917,3775
0130-001,2013,7,17,10,1609,1586,3195,3917
0130-001,2013,7,17,11,1657,1625,3282,3195
0130-001,2013,7,17,12,1586,1625,3211,3282
0130-001,2013,7,17,13,1341,1384,2725,3211
0130-001,2013,7,17,14,1695,1656,3351,2725
0130-001,2013,7,17,15,1776,1710,3486,3351
0130-001,2013,7,17,16,1655,1749,3404,3486
0130-001,2013,7,17,17,1618,1724,3342,3404
0130-001,2013,7,17,18,1678,2212,3890,3342
0130-001,2013,7,17,19,1741,2543,4284,3890
0130-001,2013,7,17,20,1407,1770,3177,4284
0130-001,2013,7,17,21,1177,1411,2588,3177
0130-001,2013,7,17,22,1224,1220,2444,2588
0130-001,2013,7,17,23,842,737,1579,2444
0130-001,2013,7,17,24,614,501,1115,1579
0130-001,2013,7,18,1,395,375,770,1115
0130-001,2013,7,18,2,294,243,537,770
0130-001,2013,7,18,3,180,187,367,537
0130-001,2013,7,18,4,179,189,368,367
0130-001,2013,7,18,5,203,242,445,368
0130-001,2013,7,18,6,393,391,784,445
0130-001,2013,7,18,7,1219,748,1967,784
0130-001,2013,7,18,8,2211,1703,3914,1967
0130-001,2013,7,18,9,2134,2044,4178,3914
0130-001,2013,7,18,10,1652,1678,3330,4178
0130-001,2013,7,18,11,1736,1712,3448,3330
0130-001,2013,7,18,12,1633,1674,3307,3448
0130-001,2013,7,18,13,1507,1646,3153,3307
0130-001,2013,7,18,14,1686,1888,3574,3153
0130-001,2013,7,18,15,1799,1793,3592,3574
0130-001,2013,7,18,16,1734,1785,3519,3592
0130-001,2013,7,18,17,1749,1769,3518,3519
0130-001,2013,7,18,18,1752,2189,3941,3518
0130-001,2013,7,18,19,1929,2461,4390,3941
0130-001,2013,7,18,20,1440,1836,3276,4390
0130-001,2013,7,18,21,1285,1749,3034,3276
0130-001,2013,7,18,22,1278,1383,2661,3034
0130-001,2013,7,18,23,950,859,1809,2661
0130-001,2013,7,18,24,591,526,1117,1809
0130-001,2013,7,19,1,443,367,810,1117
0130-001,2013,7,19,2,268,243,511,810
0130-001,2013,7,19,3,215,181,396,511
0130-001,2013,7,19,4,166,197,363,396
0130-001,2013,7,19,5,206,236,442,363
0130-001,2013,7,19,6,439,432,871,442
0130-001,2013,7,19,7,1323,821,2144,871
0130-001,2013,7,19,8,2202,1688,3890,2144
0130-001,2013,7,19,9,2085,2048,4133,3890
0130-001,2013,7,19,10,1639,1796,3435,4133
0130-001,2013,7,19,11,1782,1746,3528,3435
0130-001,2013,7,19,12,1657,1717,3374,3528
0130-001,2013,7,19,13,1555,1588,3143,3374
0130-001,2013,7,19,14,1720,1794,3514,3143
0130-001,2013,7,19,15,1880,1799,3679,3514
0130-001,2013,7,19,16,1774,1856,3630,3679
0130-001,2013,7,19,17,1817,1875,3692,3630
0130-001,2013,7,19,18,2023,2380,4403,3692
0130-001,2013,7,19,19,2064,2610,4674,4403
0130-001,2013,7,19,20,1699,2169,3868,4674
0130-001,2013,7,19,21,1459,1782,3241,3868
0130-001,2013,7,19,22,1313,1406,2719,3241
0130-001,2013,7,19,23,1066,987,2053,2719
0130-001,2013,7,19,24,775,612,1387,2053
0130-001,2013,7,20,1,522,446,968,1387
0130-001,2013,7,20,2,371,324,695,968
0130-001,2013,7,20,3,296,246,542,695
0130-001,2013,7,20,4,249,246,495,542
0130-001,2013,7,20,5,268,272,540,495
0130-001,2013,7,20,6,462,447,909,540
0130-001,2013,7,20,7,1010,714,1724,909
0130-001,2013,7,20,8,1544,1226,2770,1724
0130-001,2013,7,20,9,1571,1691,3262,2770
0130-001,2013,7,20,10,1618,1853,3471,3262
0130-001,2013,7,20,11,1631,1908,3539,3471
0130-001,2013,7,20,12,1570,2103,3673,3539
0130-001,2013,7,20,13,1481,2284,3765,3673
0130-001,2013,7,20,14,1617,2157,3774,3765
0130-001,2013,7,20,15,1516,2165,3681,3774
0130-001,2013,7,20,16,1680,1913,3593,3681
0130-001,2013,7,20,17,1766,1896,3662,3593
0130-001,2013,7,20,18,1994,2093,4087,3662
0130-001,2013,7,20,19,1852,1966,3818,4087
0130-001,2013,7,20,20,1553,1411,2964,3818
0130-001,2013,7,20,21,1414,1234,2648,2964
0130-001,2013,7,20,22,1098,1054,2152,2648
0130-001,2013,7,20,23,866,760,1626,2152
0130-001,2013,7,20,24,570,473,1043,1626
0130-001,2013,7,21,1,386,350,736,1043
0130-001,2013,7,21,2,309,270,579,736
0130-001,2013,7,21,3,227,179,406,579
0130-001,2013,7,21,4,187,168,355,406
0130-001,2013,7,21,5,211,192,403,355
0130-001,2013,7,21,6,384,295,679,403
0130-001,2013,7,21,7,618,487,1105,679
0130-001,2013,7,21,8,682,793,1475,1105
0130-001,2013,7,21,9,874,1111,1985,1475
0130-001,2013,7,21,10,930,1133,2063,1985
0130-001,2013,7,21,11,1169,1336,2505,2063
0130-001,2013,7,21,12,1110,1290,2400,2505
0130-001,2013,7,21,13,1338,1450,2788,2400
0130-001,2013,7,21,14,1361,1437,2798,2788
0130-001,2013,7,21,15,1425,1509,2934,2798
0130-001,2013,7,21,16,1559,1514,3073,2934
0130-001,2013,7,21,17,1786,1485,3271,3073
0130-001,2013,7,21,18,1873,1525,3398,3271
0130-001,2013,7,21,19,1629,1424,3053,3398
0130-001,2013,7,21,20,1504,1300,2804,3053
0130-001,2013,7,21,21,1362,1027,2389,2804
0130-001,2013,7,21,22,1030,814,1844,2389
0130-001,2013,7,21,23,774,601,1375,1844
0130-001,2013,7,21,24,482,368,850,1375
0130-001,2013,7,22,1,303,241,544,850
0130-001,2013,7,22,2,193,159,352,544
0130-001,2013,7,22,3,126,140,266,352
0130-001,2013,7,22,4,125,132,257,266
0130-001,2013,7,22,5,151,207,358,257
0130-001,2013,7,22,6,379,387,766,358
0130-001,2013,7,22,7,1299,786,2085,766
0130-001,2013,7,22,8,2229,1652,3881,2085
0130-001,2013,7,22,9,2089,2089,4178,3881
0130-001,2013,7,22,10,1721,1705,3426,4178
0130-001,2013,7,22,11,1752,1672,3424,3426
0130-001,2013,7,22,12,1609,1642,3251,3424
0130-001,2013,7,22,13,1452,1434,2886,3251
0130-001,2013,7,22,14,1736,1754,3490,2886
0130-001,2013,7,22,15,1782,1803,3585,3490
0130-001,2013,7,22,16,1827,1920,3747,3585
0130-001,2013,7,22,17,1778,1777,3555,3747
0130-001,2013,7,22,18,1704,2235,3939,3555
0130-001,2013,7,22,19,1782,2458,4240,3939
0130-001,2013,7,22,20,1385,1790,3175,4240
0130-001,2013,7,22,21,1252,1676,2928,3175
0130-001,2013,7,22,22,1148,1273,2421,2928
0130-001,2013,7,22,23,908,767,1675,2421
0130-001,2013,7,22,24,565,488,1053,1675
0130-001,2013,7,23,1,368,331,699,1053
0130-001,2013,7,23,2,242,201,443,699
0130-001,2013,7,23,3,192,211,403,443
0130-001,2013,7,23,4,159,178,337,403
0130-001,2013,7,23,5,189,247,436,337
0130-001,2013,7,23,6,383,412,795,436
0130-001,2013,7,23,7,1293,769,2062,795
0130-001,2013,7,23,8,2084,1589,3673,2062
0130-001,2013,7,23,9,2107,2005,4112,3673
0130-001,2013,7,23,10,1589,1612,3201,4112
0130-001,2013,7,23,11,1598,1615,3213,3201
0130-001,2013,7,23,12,1468,1514,2982,3213
0130-001,2013,7,23,13,1364,1332,2696,2982
0130-001,2013,7,23,14,1555,1572,3127,2696
0130-001,2013,7,23,15,1681,1655,3336,3127
0130-001,2013,7,23,16,1716,1757,3473,3336
0130-001,2013,7,23,17,1496,1733,3229,3473
0130-001,2013,7,23,18,1649,2012,3661,3229
0130-001,2013,7,23,19,1780,2330,4110,3661
0130-001,2013,7,23,20,1328,1709,3037,4110
0130-001,2013,7,23,21,1196,1615,2811,3037
0130-001,2013,7,23,22,1103,1257,2360,2811
0130-001,2013,7,23,23,886,777,1663,2360
0130-001,2013,7,23,24,560,479,1039,1663
0130-001,2013,7,24,1,390,341,731,1039
0130-001,2013,7,24,2,257,216,473,731
0130-001,2013,7,24,3,182,177,359,473
0130-001,2013,7,24,4,174,175,349,359
0130-001,2013,7,24,5,174,217,391,349
0130-001,2013,7,24,6,308,340,648,391
0130-001,2013,7,24,7,1105,638,1743,648
0130-001,2013,7,24,8,2106,1509,3615,1743
0130-001,2013,7,24,9,2119,2043,4162,3615
0130-001,2013,7,24,10,1675,1689,3364,4162
0130-001,2013,7,24,11,1760,1766,3526,3364
0130-001,2013,7,24,12,1606,1661,3267,3526
0130-001,2013,7,24,13,1500,1471,2971,3267
0130-001,2013,7,24,14,1724,1664,3388,2971
0130-001,2013,7,24,15,1883,1789,3672,3388
0130-001,2013,7,24,16,1699,1850,3549,3672
0130-001,2013,7,24,17,1663,1868,3531,3549
0130-001,2013,7,24,18,1728,2200,3928,3531
0130-001,2013,7,24,19,1839,2491,4330,3928
0130-001,2013,7,24,20,1413,1886,3299,4330
0130-001,2013,7,24,21,1276,1636,2912,3299
0130-001,2013,7,24,22,1208,1176,2384,2912
0130-001,2013,7,24,23,869,845,1714,2384
0130-001,2013,7,24,24,640,555,1195,1714
0130-001,2013,7,25,1,423,371,794,1195
0130-001,2013,7,25,2,252,222,474,794
0130-001,2013,7,25,3,203,203,406,474
0130-001,2013,7,25,4,157,179,336,406
0130-001,2013,7,25,5,203,244,447,336
0130-001,2013,7,25,6,425,405,830,447
0130-001,2013,7,25,7,1338,786,2124,830
0130-001,2013,7,25,8,2141,1550,3691,2124
0130-001,2013,7,25,9,2221,2015,4236,3691
0130-001,2013,7,25,10,1829,1724,3553,4236
0130-001,2013,7,25,11,1830,1782,3612,3553
0130-001,2013,7,25,12,1677,1672,3349,3612
0130-001,2013,7,25,13,1527,1556,3083,3349
0130-001,2013,7,25,14,1714,1850,3564,3083
0130-001,2013,7,25,15,1831,1857,3688,3564
0130-001,2013,7,25,16,1779,1866,3645,3688
0130-001,2013,7,25,17,1743,1837,3580,3645
0130-001,2013,7,25,18,1832,2249,4081,3580
0130-001,2013,7,25,19,1846,2593,4439,4081
0130-001,2013,7,25,20,1515,2014,3529,4439
0130-001,2013,7,25,21,1338,1727,3065,3529
0130-001,2013,7,25,22,1280,1304,2584,3065
0130-001,2013,7,25,23,882,781,1663,2584
0130-001,2013,7,25,24,676,538,1214,1663
0130-001,2013,7,26,1,396,379,775,1214
0130-001,2013,7,26,2,283,285,568,775
0130-001,2013,7,26,3,191,187,378,568
0130-001,2013,7,26,4,192,212,404,378
0130-001,2013,7,26,5,227,279,506,404
0130-001,2013,7,26,6,398,408,806,506
0130-001,2013,7,26,7,1305,763,2068,806
0130-001,2013,7,26,8,2164,1577,3741,2068
0130-001,2013,7,26,9,2133,1946,4079,3741
0130-001,2013,7,26,10,1796,1684,3480,4079
0130-001,2013,7,26,11,1793,1671,3464,3480
0130-001,2013,7,26,12,1719,1784,3503,3464
0130-001,2013,7,26,13,1539,1689,3228,3503
0130-001,2013,7,26,14,1697,1777,3474,3228
0130-001,2013,7,26,15,1912,1893,3805,3474
0130-001,2013,7,26,16,1806,1922,3728,3805
0130-001,2013,7,26,17,1757,1973,3730,3728
0130-001,2013,7,26,18,1896,2368,4264,3730
0130-001,2013,7,26,19,1979,2672,4651,4264
0130-001,2013,7,26,20,1692,2580,4272,4651
0130-001,2013,7,26,21,1463,1924,3387,4272
0130-001,2013,7,26,22,1425,1535,2960,3387
0130-001,2013,7,26,23,1044,1001,2045,2960
0130-001,2013,7,26,24,694,614,1308,2045
0130-001,2013,7,27,1,468,444,912,1308
0130-001,2013,7,27,2,371,315,686,912
0130-001,2013,7,27,3,311,249,560,686
0130-001,2013,7,27,4,237,256,493,560
0130-001,2013,7,27,5,270,296,566,493
0130-001,2013,7,27,6,504,430,934,566
0130-001,2013,7,27,7,967,706,1673,934
0130-001,2013,7,27,8,1438,1163,2601,1673
0130-001,2013,7,27,9,1651,1743,3394,2601
0130-001,2013,7,27,10,1602,2017,3619,3394
0130-001,2013,7,27,11,1611,2088,3699,3619
0130-001,2013,7,27,12,1651,2303,3954,3699
0130-001,2013,7,27,13,1672,2467,4139,3954
0130-001,2013,7,27,14,1920,2413,4333,4139
0130-001,2013,7,27,15,1609,2442,4051,4333
0130-001,2013,7,27,16,1626,2363,3989,4051
0130-001,2013,7,27,17,1675,2271,3946,3989
0130-001,2013,7,27,18,1889,2407,4296,3946
0130-001,2013,7,27,19,1635,2293,3928,4296
0130-001,2013,7,27,20,1434,1482,2916,3928
0130-001,2013,7,27,21,1312,1175,2487,2916
0130-001,2013,7,27,22,1085,1038,2123,2487
0130-001,2013,7,27,23,866,707,1573,2123
0130-001,2013,7,27,24,544,487,1031,1573
0130-001,2013,7,28,1,389,335,724,1031
0130-001,2013,7,28,2,296,236,532,724
0130-001,2013,7,28,3,236,191,427,532
0130-001,2013,7,28,4,186,168,354,427
0130-001,2013,7,28,5,181,148,329,354
0130-001,2013,7,28,6,256,307,563,329
0130-001,2013,7,28,7,512,411,923,563
0130-001,2013,7,28,8,659,583,1242,923
0130-001,2013,7,28,9,737,813,1550,1242
0130-001,2013,7,28,10,914,917,1831,1550
0130-001,2013,7,28,11,982,1128,2110,1831
0130-001,2013,7,28,12,988,1123,2111,2110
0130-001,2013,7,28,13,1152,1204,2356,2111
0130-001,2013,7,28,14,1738,1378,3116,2356
0130-001,2013,7,28,15,1433,1752,3185,3116
0130-001,2013,7,28,16,1366,1536,2902,3185
0130-001,2013,7,28,17,1423,1394,2817,2902
0130-001,2013,7,28,18,1459,1388,2847,2817
0130-001,2013,7,28,19,1535,1251,2786,2847
0130-001,2013,7,28,20,1334,1054,2388,2786
0130-001,2013,7,28,21,1278,910,2188,2388
0130-001,2013,7,28,22,850,762,1612,2188
0130-001,2013,7,28,23,706,600,1306,1612
0130-001,2013,7,28,24,419,340,759,1306
0130-001,2013,7,29,1,275,232,507,759
0130-001,2013,7,29,2,189,173,362,507
0130-001,2013,7,29,3,135,124,259,362
0130-001,2013,7,29,4,132,159,291,259
0130-001,2013,7,29,5,176,204,380,291
0130-001,2013,7,29,6,376,382,758,380
0130-001,2013,7,29,7,1121,720,1841,758
0130-001,2013,7,29,8,2025,1567,3592,1841
0130-001,2013,7,29,9,2025,1945,3970,3592
0130-001,2013,7,29,10,1736,1720,3456,3970
0130-001,2013,7,29,11,1755,1780,3535,3456
0130-001,2013,7,29,12,1735,1796,3531,3535
0130-001,2013,7,29,13,1498,1746,3244,3531
0130-001,2013,7,29,14,1721,1851,3572,3244
0130-001,2013,7,29,15,1841,1828,3669,3572
0130-001,2013,7,29,16,1823,1881,3704,3669
0130-001,2013,7,29,17,1734,1820,3554,3704
0130-001,2013,7,29,18,1862,2125,3987,3554
0130-001,2013,7,29,19,1863,2496,4359,3987
0130-001,2013,7,29,20,1488,1730,3218,4359
0130-001,2013,7,29,21,1265,1488,2753,3218
0130-001,2013,7,29,22,1095,1225,2320,2753
0130-001,2013,7,29,23,871,731,1602,2320
0130-001,2013,7,29,24,533,455,988,1602
0130-001,2013,7,30,1,412,312,724,988
0130-001,2013,7,30,2,269,235,504,724
0130-001,2013,7,30,3,182,178,360,504
0130-001,2013,7,30,4,153,183,336,360
0130-001,2013,7,30,5,209,263,472,336
0130-001,2013,7,30,6,415,408,823,472
0130-001,2013,7,30,7,1100,714,1814,823
0130-001,2013,7,30,8,1935,1539,3474,1814
0130-001,2013,7,30,9,1957,1885,3842,3474
0130-001,2013,7,30,10,1806,1606,3412,3842
0130-001,2013,7,30,11,1731,1775,3506,3412
0130-001,2013,7,30,12,1638,1671,3309,3506
0130-001,2013,7,30,13,1514,1567,3081,3309
0130-001,2013,7,30,14,1651,1783,3434,3081
0130-001,2013,7,30,15,1800,1813,3613,3434
0130-001,2013,7,30,16,1746,1870,3616,3613
0130-001,2013,7,30,17,1818,1949,3767,3616
0130-001,2013,7,30,18,1780,2068,3848,3767
0130-001,2013,7,30,19,1907,2456,4363,3848
0130-001,2013,7,30,20,1447,1675,3122,4363
0130-001,2013,7,30,21,1350,1472,2822,3122
0130-001,2013,7,30,22,1119,1170,2289,2822
0130-001,2013,7,30,23,830,766,1596,2289
0130-001,2013,7,30,24,581,515,1096,1596
0130-001,2013,7,31,1,386,328,714,1096
0130-001,2013,7,31,2,257,210,467,714
0130-001,2013,7,31,3,177,185,362,467
0130-001,2013,7,31,4,168,185,353,362
0130-001,2013,7,31,5,194,225,419,353
0130-001,2013,7,31,6,335,304,639,419
0130-001,2013,7,31,7,886,651,1537,639
0130-001,2013,7,31,8,1724,1393,3117,1537
0130-001,2013,7,31,9,1942,1815,3757,3117
0130-001,2013,7,31,10,1781,1628,3409,3757
0130-001,2013,7,31,11,1730,1847,3577,3409
0130-001,2013,7,31,12,1683,1842,3525,3577
0130-001,2013,7,31,13,1606,1637,3243,3525
0130-001,2013,7,31,14,1683,1958,3641,3243
0130-001,2013,7,31,15,1851,1947,3798,3641
0130-001,2013,7,31,16,1842,1924,3766,3798
0130-001,2013,7,31,17,1804,1912,3716,3766
0130-001,2013,7,31,18,1908,2135,4043,3716
0130-001,2013,7,31,19,1907,2473,4380,4043
0130-001,2013,7,31,20,1538,1897,3435,4380
0130-001,2013,7,31,21,1400,1482,2882,3435
0130-001,2013,7,31,22,1172,1189,2361,2882
0130-001,2013,7,31,23,984,759,1743,2361
0130-001,2013,7,31,24,662,526,1188,1743
0130-001,2013,8,1,1,398,354,752,1188
0130-001,2013,8,1,2,285,249,534,752
0130-001,2013,8,1,3,226,191,417,534
0130-001,2013,8,1,4,159,180,339,417
0130-001,2013,8,1,5,202,259,461,339
0130-001,2013,8,1,6,438,393,831,461
0130-001,2013,8,1,7,1048,699,1747,831
0130-001,2013,8,1,8,1788,1491,3279,1747
0130-001,2013,8,1,9,1936,1838,3774,3279
0130-001,2013,8,1,10,1694,1704,3398,3774
0130-001,2013,8,1,11,1711,2014,3725,3398
0130-001,2013,8,1,12,1496,2099,3595,3725
0130-001,2013,8,1,13,1411,2185,3596,3595
0130-001,2013,8,1,14,1454,2199,3653,3596
0130-001,2013,8,1,15,1686,2257,3943,3653
0130-001,2013,8,1,16,1705,2181,3886,3943
0130-001,2013,8,1,17,1675,2367,4042,3886
0130-001,2013,8,1,18,1802,2488,4290,4042
0130-001,2013,8,1,19,1827,2501,4328,4290
0130-001,2013,8,1,20,1443,1690,3133,4328
0130-001,2013,8,1,21,1276,1379,2655,3133
0130-001,2013,8,1,22,1117,1179,2296,2655
0130-001,2013,8,1,23,832,723,1555,2296
0130-001,2013,8,1,24,614,449,1063,1555
0130-001,2013,8,2,1,422,350,772,1063
0130-001,2013,8,2,2,214,227,441,772
0130-001,2013,8,2,3,174,166,340,441
0130-001,2013,8,2,4,153,187,340,340
0130-001,2013,8,2,5,196,237,433,340
0130-001,2013,8,2,6,363,324,687,433
0130-001,2013,8,2,7,937,565,1502,687
0130-001,2013,8,2,8,1697,1392,3089,1502
0130-001,2013,8,2,9,1882,1725,3607,3089
0130-001,2013,8,2,10,1576,1557,3133,3607
0130-001,2013,8,2,11,1602,1737,3339,3133
0130-001,2013,8,2,12,1480,1739,3219,3339
0130-001,2013,8,2,13,1389,1782,3171,3219
0130-001,2013,8,2,14,1600,1969,3569,3171
0130-001,2013,8,2,15,1632,2037,3669,3569
0130-001,2013,8,2,16,1851,1903,3754,3669
0130-001,2013,8,2,17,1769,1913,3682,3754
0130-001,2013,8,2,18,1947,2315,4262,3682
0130-001,2013,8,2,19,1862,2674,4536,4262
0130-001,2013,8,2,20,1697,1873,3570,4536
0130-001,2013,8,2,21,1381,1377,2758,3570
0130-001,2013,8,2,22,1096,1164,2260,2758
0130-001,2013,8,2,23,925,745,1670,2260
0130-001,2013,8,2,24,605,502,1107,1670
0130-001,2013,8,3,1,457,372,829,1107
0130-001,2013,8,3,2,293,273,566,829
0130-001,2013,8,3,3,213,200,413,566
0130-001,2013,8,3,4,185,180,365,413
0130-001,2013,8,3,5,218,230,448,365
0130-001,2013,8,3,6,412,370,782,448
0130-001,2013,8,3,7,797,574,1371,782
0130-001,2013,8,3,8,1152,973,2125,1371
0130-001,2013,8,3,9,1204,1534,2738,2125
0130-001,2013,8,3,10,1371,1812,3183,2738
0130-001,2013,8,3,11,1356,2063,3419,3183
0130-001,2013,8,3,12,1528,2248,3776,3419
0130-001,2013,8,3,13,1517,2250,3767,3776
0130-001,2013,8,3,14,1510,2169,3679,3767
0130-001,2013,8,3,15,1514,1999,3513,3679
0130-001,2013,8,3,16,1620,1677,3297,3513
0130-001,2013,8,3,17,1603,1535,3138,3297
0130-001,2013,8,3,18,1930,1891,3821,3138
0130-001,2013,8,3,19,1922,1802,3724,3821
0130-001,2013,8,3,20,1807,1420,3227,3724
0130-001,2013,8,3,21,1578,1039,2617,3227
0130-001,2013,8,3,22,1386,970,2356,2617
0130-001,2013,8,3,23,1012,624,1636,2356
0130-001,2013,8,3,24,638,509,1147,1636
0130-001,2013,8,4,1,408,366,774,1147
0130-001,2013,8,4,2,270,248,518,774
0130-001,2013,8,4,3,213,173,386,518
0130-001,2013,8,4,4,171,177,348,386
0130-001,2013,8,4,5,187,147,334,348
0130-001,2013,8,4,6,323,247,570,334
0130-001,2013,8,4,7,513,403,916,570
0130-001,2013,8,4,8,685,586,1271,916
0130-001,2013,8,4,9,769,786,1555,1271
0130-001,2013,8,4,10,854,935,1789,1555
0130-001,2013,8,4,11,963,1104,2067,1789
0130-001,2013,8,4,12,1119,1141,2260,2067
0130-001,2013,8,4,13,1253,1330,2583,2260
0130-001,2013,8,4,14,1385,1354,2739,2583
0130-001,2013,8,4,15,1658,1261,2919,2739
0130-001,2013,8,4,16,1813,1380,3193,2919
0130-001,2013,8,4,17,1844,1499,3343,3193
0130-001,2013,8,4,18,1901,1454,3355,3343
0130-001,2013,8,4,19,1901,1307,3208,3355
0130-001,2013,8,4,20,1805,1097,2902,3208
0130-001,2013,8,4,21,1757,1034,2791,2902
0130-001,2013,8,4,22,1327,856,2183,2791
0130-001,2013,8,4,23,875,584,1459,2183
0130-001,2013,8,4,24,525,397,922,1459
0130-001,2013,8,5,1,299,244,543,922
0130-001,2013,8,5,2,212,168,380,543
0130-001,2013,8,5,3,106,110,216,380
0130-001,2013,8,5,4,103,131,234,216
0130-001,2013,8,5,5,179,221,400,234
0130-001,2013,8,5,6,428,363,791,400
0130-001,2013,8,5,7,1306,778,2084,791
0130-001,2013,8,5,8,2202,1578,3780,2084
0130-001,2013,8,5,9,1897,1909,3806,3780
0130-001,2013,8,5,10,1708,1716,3424,3806
0130-001,2013,8,5,11,1762,1729,3491,3424
0130-001,2013,8,5,12,1625,1640,3265,3491
0130-001,2013,8,5,13,1444,1572,3016,3265
0130-001,2013,8,5,14,1610,1754,3364,3016
0130-001,2013,8,5,15,1775,1782,3557,3364
0130-001,2013,8,5,16,1860,1790,3650,3557
0130-001,2013,8,5,17,1802,1755,3557,3650
0130-001,2013,8,5,18,1806,2100,3906,3557
0130-001,2013,8,5,19,1858,2342,4200,3906
0130-001,2013,8,5,20,1441,1688,3129,4200
0130-001,2013,8,5,21,1275,1624,2899,3129
0130-001,2013,8,5,22,1122,1240,2362,2899
0130-001,2013,8,5,23,780,666,1446,2362
0130-001,2013,8,5,24,561,524,1085,1446
0130-001,2013,8,6,1,355,335,690,1085
0130-001,2013,8,6,2,241,213,454,690
0130-001,2013,8,6,3,170,198,368,454
0130-001,2013,8,6,4,134,168,302,368
0130-001,2013,8,6,5,226,225,451,302
0130-001,2013,8,6,6,372,370,742,451
0130-001,2013,8,6,7,1304,708,2012,742
0130-001,2013,8,6,8,2136,1561,3697,2012
0130-001,2013,8,6,9,1914,1845,3759,3697
0130-001,2013,8,6,10,1729,1627,3356,3759
0130-001,2013,8,6,11,1709,1742,3451,3356
0130-001,2013,8,6,12,1668,1643,3311,3451
0130-001,2013,8,6,13,1485,1505,2990,3311
0130-001,2013,8,6,14,1599,1742,3341,2990
0130-001,2013,8,6,15,1780,1741,3521,3341
0130-001,2013,8,6,16,1691,1636,3327,3521
0130-001,2013,8,6,17,1719,1695,3414,3327
0130-001,2013,8,6,18,1669,2193,3862,3414
0130-001,2013,8,6,19,1786,2412,4198,3862
0130-001,2013,8,6,20,1372,1647,3019,4198
0130-001,2013,8,6,21,1233,1603,2836,3019
0130-001,2013,8,6,22,1086,1165,2251,2836
0130-001,2013,8,6,23,878,748,1626,2251
0130-001,2013,8,6,24,554,522,1076,1626
0130-001,2013,8,7,1,380,325,705,1076
0130-001,2013,8,7,2,210,213,423,705
0130-001,2013,8,7,3,171,157,328,423
0130-001,2013,8,7,4,168,191,359,328
0130-001,2013,8,7,5,188,217,405,359
0130-001,2013,8,7,6,408,353,761,405
0130-001,2013,8,7,7,1219,760,1979,761
0130-001,2013,8,7,8,2161,1516,3677,1979
0130-001,2013,8,7,9,2028,1953,3981,3677
0130-001,2013,8,7,10,1772,1653,3425,3981
0130-001,2013,8,7,11,1695,1759,3454,3425
0130-001,2013,8,7,12,1680,1709,3389,3454
0130-001,2013,8,7,13,1349,1475,2824,3389
0130-001,2013,8,7,14,1713,1664,3377,2824
0130-001,2013,8,7,15,1723,1741,3464,3377
0130-001,2013,8,7,16,1744,1748,3492,3464
0130-001,2013,8,7,17,1699,1728,3427,3492
0130-001,2013,8,7,18,1830,2212,4042,3427
0130-001,2013,8,7,19,1878,2547,4425,4042
0130-001,2013,8,7,20,1506,1877,3383,4425
0130-001,2013,8,7,21,1318,1596,2914,3383
0130-001,2013,8,7,22,1204,1219,2423,2914
0130-001,2013,8,7,23,984,764,1748,2423
0130-001,2013,8,7,24,656,515,1171,1748
0130-001,2013,8,8,1,391,327,718,1171
0130-001,2013,8,8,2,232,244,476,718
0130-001,2013,8,8,3,172,185,357,476
0130-001,2013,8,8,4,183,187,370,357
0130-001,2013,8,8,5,188,214,402,370
0130-001,2013,8,8,6,430,366,796,402
0130-001,2013,8,8,7,1240,738,1978,796
0130-001,2013,8,8,8,2124,1543,3667,1978
0130-001,2013,8,8,9,2084,1910,3994,3667
0130-001,2013,8,8,10,1787,1679,3466,3994
0130-001,2013,8,8,11,1719,1794,3513,3466
0130-001,2013,8,8,12,1637,1582,3219,3513
0130-001,2013,8,8,13,1479,1493,2972,3219
0130-001,2013,8,8,14,1583,1698,3281,2972
0130-001,2013,8,8,15,1758,1696,3454,3281
0130-001,2013,8,8,16,1691,1707,3398,3454
0130-001,2013,8,8,17,1645,1778,3423,3398
0130-001,2013,8,8,18,1778,2197,3975,3423
0130-001,2013,8,8,19,1783,2436,4219,3975
0130-001,2013,8,8,20,1517,1828,3345,4219
0130-001,2013,8,8,21,1327,1765,3092,3345
0130-001,2013,8,8,22,1251,1296,2547,3092
0130-001,2013,8,8,23,944,794,1738,2547
0130-001,2013,8,8,24,593,535,1128,1738
0130-001,2013,8,9,1,425,360,785,1128
0130-001,2013,8,9,2,258,204,462,785
0130-001,2013,8,9,3,170,182,352,462
0130-001,2013,8,9,4,173,184,357,352
0130-001,2013,8,9,5,192,240,432,357
0130-001,2013,8,9,6,394,397,791,432
0130-001,2013,8,9,7,1262,716,1978,791
0130-001,2013,8,9,8,2106,1507,3613,1978
0130-001,2013,8,9,9,2099,1963,4062,3613
0130-001,2013,8,9,10,1762,1650,3412,4062
0130-001,2013,8,9,11,1694,1701,3395,3412
0130-001,2013,8,9,12,1624,1639,3263,3395
0130-001,2013,8,9,13,1493,1571,3064,3263
0130-001,2013,8,9,14,1672,1734,3406,3064
0130-001,2013,8,9,15,1787,1838,3625,3406
0130-001,2013,8,9,16,1870,1839,3709,3625
0130-001,2013,8,9,17,1762,1922,3684,3709
0130-001,2013,8,9,18,1970,2242,4212,3684
0130-001,2013,8,9,19,2055,2616,4671,4212
0130-001,2013,8,9,20,1707,2197,3904,4671
0130-001,2013,8,9,21,1402,1792,3194,3904
0130-001,2013,8,9,22,1276,1384,2660,3194
0130-001,2013,8,9,23,1017,897,1914,2660
0130-001,2013,8,9,24,660,642,1302,1914
0130-001,2013,8,10,1,454,413,867,1302
0130-001,2013,8,10,2,371,296,667,867
0130-001,2013,8,10,3,246,248,494,667
0130-001,2013,8,10,4,230,230,460,494
0130-001,2013,8,10,5,279,267,546,460
0130-001,2013,8,10,6,448,424,872,546
0130-001,2013,8,10,7,961,647,1608,872
0130-001,2013,8,10,8,1429,1075,2504,1608
0130-001,2013,8,10,9,1482,1544,3026,2504
0130-001,2013,8,10,10,1566,1686,3252,3026
0130-001,2013,8,10,11,1518,1865,3383,3252
0130-001,2013,8,10,12,1540,1952,3492,3383
0130-001,2013,8,10,13,1537,2087,3624,3492
0130-001,2013,8,10,14,1627,2032,3659,3624
0130-001,2013,8,10,15,1584,1910,3494,3659
0130-001,2013,8,10,16,1655,1967,3622,3494
0130-001,2013,8,10,17,1649,1964,3613,3622
0130-001,2013,8,10,18,1765,2180,3945,3613
0130-001,2013,8,10,19,1759,1999,3758,3945
0130-001,2013,8,10,20,1455,1345,2800,3758
0130-001,2013,8,10,21,1341,1256,2597,2800
0130-001,2013,8,10,22,1090,1042,2132,2597
0130-001,2013,8,10,23,876,706,1582,2132
0130-001,2013,8,10,24,572,520,1092,1582
0130-001,2013,8,11,1,430,376,806,1092
0130-001,2013,8,11,2,308,269,577,806
0130-001,2013,8,11,3,231,223,454,577
0130-001,2013,8,11,4,188,147,335,454
0130-001,2013,8,11,5,188,177,365,335
0130-001,2013,8,11,6,352,280,632,365
0130-001,2013,8,11,7,556,446,1002,632
0130-001,2013,8,11,8,701,660,1361,1002
0130-001,2013,8,11,9,816,905,1721,1361
0130-001,2013,8,11,10,961,1077,2038,1721
0130-001,2013,8,11,11,1115,1246,2361,2038
0130-001,2013,8,11,12,1098,1283,2381,2361
0130-001,2013,8,11,13,1200,1336,2536,2381
0130-001,2013,8,11,14,1384,1406,2790,2536
0130-001,2013,8,11,15,1388,1389,2777,2790
0130-001,2013,8,11,16,1511,1341,2852,2777
0130-001,2013,8,11,17,1644,1373,3017,2852
0130-001,2013,8,11,18,1687,1486,3173,3017
0130-001,2013,8,11,19,1520,1400,2920,3173
0130-001,2013,8,11,20,1376,1211,2587,2920
0130-001,2013,8,11,21,1457,1133,2590,2587
0130-001,2013,8,11,22,1008,875,1883,2590
0130-001,2013,8,11,23,713,623,1336,1883
0130-001,2013,8,11,24,444,408,852,1336
0130-001,2013,8,12,1,283,269,552,852
0130-001,2013,8,12,2,183,160,343,552
0130-001,2013,8,12,3,141,137,278,343
0130-001,2013,8,12,4,124,156,280,278
0130-001,2013,8,12,5,185,206,391,280
0130-001,2013,8,12,6,446,406,852,391
0130-001,2013,8,12,7,1474,843,2317,852
0130-001,2013,8,12,8,2192,1710,3902,2317
0130-001,2013,8,12,9,2146,1951,4097,3902
0130-001,2013,8,12,10,1791,1749,3540,4097
0130-001,2013,8,12,11,1745,1822,3567,3540
0130-001,2013,8,12,12,1749,1735,3484,3567
0130-001,2013,8,12,13,1439,1570,3009,3484
0130-001,2013,8,12,14,1735,1678,3413,3009
0130-001,2013,8,12,15,1831,1712,3543,3413
0130-001,2013,8,12,16,1769,1847,3616,3543
0130-001,2013,8,12,17,1756,1826,3582,3616
0130-001,2013,8,12,18,1822,2180,4002,3582
0130-001,2013,8,12,19,1897,2523,4420,4002
0130-001,2013,8,12,20,1528,1891,3419,4420
0130-001,2013,8,12,21,1275,1765,3040,3419
0130-001,2013,8,12,22,1183,1341,2524,3040
0130-001,2013,8,12,23,872,747,1619,2524
0130-001,2013,8,12,24,572,454,1026,1619
0130-001,2013,8,13,1,335,316,651,1026
0130-001,2013,8,13,2,238,211,449,651
0130-001,2013,8,13,3,169,169,338,449
0130-001,2013,8,13,4,159,185,344,338
0130-001,2013,8,13,5,199,255,454,344
0130-001,2013,8,13,6,393,400,793,454
0130-001,2013,8,13,7,1315,775,2090,793
0130-001,2013,8,13,8,2128,1595,3723,2090
0130-001,2013,8,13,9,2126,1928,4054,3723
0130-001,2013,8,13,10,1783,1753,3536,4054
0130-001,2013,8,13,11,1786,1834,3620,3536
0130-001,2013,8,13,12,1604,1719,3323,3620
0130-001,2013,8,13,13,1493,1583,3076,3323
0130-001,2013,8,13,14,1692,1700,3392,3076
0130-001,2013,8,13,15,1789,1787,3576,3392
0130-001,2013,8,13,16,1824,1861,3685,3576
0130-001,2013,8,13,17,1698,1895,3593,3685
0130-001,2013,8,13,18,1852,2097,3949,3593
0130-001,2013,8,13,19,1834,2494,4328,3949
0130-001,2013,8,13,20,1566,1904,3470,4328
0130-001,2013,8,13,21,1286,1692,2978,3470
0130-001,2013,8,13,22,1190,1233,2423,2978
0130-001,2013,8,13,23,869,751,1620,2423
0130-001,2013,8,13,24,573,502,1075,1620
0130-001,2013,8,14,1,387,349,736,1075
0130-001,2013,8,14,2,247,246,493,736
0130-001,2013,8,14,3,173,184,357,493
0130-001,2013,8,14,4,189,177,366,357
0130-001,2013,8,14,5,195,227,422,366
0130-001,2013,8,14,6,431,426,857,422
0130-001,2013,8,14,7,1339,801,2140,857
0130-001,2013,8,14,8,2129,1595,3724,2140
0130-001,2013,8,14,9,2149,1904,4053,3724
0130-001,2013,8,14,10,1872,1762,3634,4053
0130-001,2013,8,14,11,1735,1743,3478,3634
0130-001,2013,8,14,12,1612,1680,3292,3478
0130-001,2013,8,14,13,1449,1573,3022,3292
0130-001,2013,8,14,14,1654,1726,3380,3022
0130-001,2013,8,14,15,1844,1831,3675,3380
0130-001,2013,8,14,16,1840,1854,3694,3675
0130-001,2013,8,14,17,1806,1893,3699,3694
0130-001,2013,8,14,18,1960,2296,4256,3699
0130-001,2013,8,14,19,2004,2659,4663,4256
0130-001,2013,8,14,20,1639,2235,3874,4663
0130-001,2013,8,14,21,1416,1755,3171,3874
0130-001,2013,8,14,22,1207,1371,2578,3171
0130-001,2013,8,14,23,1047,862,1909,2578
0130-001,2013,8,14,24,712,557,1269,1909
0130-001,2013,8,15,1,504,452,956,1269
0130-001,2013,8,15,2,339,289,628,956
0130-001,2013,8,15,3,276,231,507,628
0130-001,2013,8,15,4,229,255,484,507
0130-001,2013,8,15,5,230,262,492,484
0130-001,2013,8,15,6,427,393,820,492
0130-001,2013,8,15,7,944,645,1589,820
0130-001,2013,8,15,8,1487,1008,2495,1589
0130-001,2013,8,15,9,1368,1432,2800,2495
0130-001,2013,8,15,10,1341,1548,2889,2800
0130-001,2013,8,15,11,1360,1915,3275,2889
0130-001,2013,8,15,12,1290,2027,3317,3275
0130-001,2013,8,15,13,1201,2087,3288,3317
0130-001,2013,8,15,14,1315,1858,3173,3288
0130-001,2013,8,15,15,1333,1633,2966,3173
0130-001,2013,8,15,16,1480,1435,2915,2966
0130-001,2013,8,15,17,1612,1529,3141,2915
0130-001,2013,8,15,18,1697,1832,3529,3141
0130-001,2013,8,15,19,1602,1734,3336,3529
0130-001,2013,8,15,20,1496,1419,2915,3336
0130-001,2013,8,15,21,1209,1271,2480,2915
0130-001,2013,8,15,22,1079,900,1979,2480
0130-001,2013,8,15,23,832,578,1410,1979
0130-001,2013,8,15,24,509,404,913,1410
0130-001,2013,8,16,1,310,260,570,913
0130-001,2013,8,16,2,227,201,428,570
0130-001,2013,8,16,3,153,146,299,428
0130-001,2013,8,16,4,191,193,384,299
0130-001,2013,8,16,5,187,231,418,384
0130-001,2013,8,16,6,405,423,828,418
0130-001,2013,8,16,7,1326,751,2077,828
0130-001,2013,8,16,8,2181,1698,3879,2077
0130-001,2013,8,16,9,2027,1830,3857,3879
0130-001,2013,8,16,10,1688,1861,3549,3857
0130-001,2013,8,16,11,1704,1809,3513,3549
0130-001,2013,8,16,12,1714,1775,3489,3513
0130-001,2013,8,16,13,1541,1533,3074,3489
0130-001,2013,8,16,14,1690,1712,3402,3074
0130-001,2013,8,16,15,1760,1755,3515,3402
0130-001,2013,8,16,16,1871,1786,3657,3515
0130-001,2013,8,16,17,1791,1965,3756,3657
0130-001,2013,8,16,18,1866,2161,4027,3756
0130-001,2013,8,16,19,1885,2451,4336,4027
0130-001,2013,8,16,20,1615,1921,3536,4336
0130-001,2013,8,16,21,1526,1656,3182,3536
0130-001,2013,8,16,22,1185,1324,2509,3182
0130-001,2013,8,16,23,954,879,1833,2509
0130-001,2013,8,16,24,613,580,1193,1833
0130-001,2013,8,17,1,493,446,939,1193
0130-001,2013,8,17,2,308,280,588,939
0130-001,2013,8,17,3,228,213,441,588
0130-001,2013,8,17,4,208,218,426,441
0130-001,2013,8,17,5,212,297,509,426
0130-001,2013,8,17,6,464,367,831,509
0130-001,2013,8,17,7,982,656,1638,831
0130-001,2013,8,17,8,1483,1106,2589,1638
0130-001,2013,8,17,9,1535,1548,3083,2589
0130-001,2013,8,17,10,1520,1770,3290,3083
0130-001,2013,8,17,11,1594,1860,3454,3290
0130-001,2013,8,17,12,1628,1955,3583,3454
0130-001,2013,8,17,13,1502,1949,3451,3583
0130-001,2013,8,17,14,1642,1912,3554,3451
0130-001,2013,8,17,15,1595,1848,3443,3554
0130-001,2013,8,17,16,1574,1672,3246,3443
0130-001,2013,8,17,17,1759,1769,3528,3246
0130-001,2013,8,17,18,1959,2075,4034,3528
0130-001,2013,8,17,19,1775,1891,3666,4034
0130-001,2013,8,17,20,1530,1311,2841,3666
0130-001,2013,8,17,21,1384,1161,2545,2841
0130-001,2013,8,17,22,1076,980,2056,2545
0130-001,2013,8,17,23,828,665,1493,2056
0130-001,2013,8,17,24,567,487,1054,1493
0130-001,2013,8,18,1,404,349,753,1054
0130-001,2013,8,18,2,287,258,545,753
0130-001,2013,8,18,3,217,198,415,545
0130-001,2013,8,18,4,180,175,355,415
0130-001,2013,8,18,5,188,146,334,355
0130-001,2013,8,18,6,325,327,652,334
0130-001,2013,8,18,7,567,429,996,652
0130-001,2013,8,18,8,672,664,1336,996
0130-001,2013,8,18,9,844,964,1808,1336
0130-001,2013,8,18,10,887,1058,1945,1808
0130-001,2013,8,18,11,1116,1219,2335,1945
0130-001,2013,8,18,12,1123,1253,2376,2335
0130-001,2013,8,18,13,1332,1376,2708,2376
0130-001,2013,8,18,14,1448,1414,2862,2708
0130-001,2013,8,18,15,1500,1338,2838,2862
0130-001,2013,8,18,16,1708,1425,3133,2838
0130-001,2013,8,18,17,1815,1374,3189,3133
0130-001,2013,8,18,18,1825,1442,3267,3189
0130-001,2013,8,18,19,1742,1364,3106,3267
0130-001,2013,8,18,20,1481,1211,2692,3106
0130-001,2013,8,18,21,1407,1073,2480,2692
0130-001,2013,8,18,22,1077,833,1910,2480
0130-001,2013,8,18,23,708,596,1304,1910
0130-001,2013,8,18,24,511,371,882,1304
0130-001,2013,8,19,1,247,226,473,882
0130-001,2013,8,19,2,202,185,387,473
0130-001,2013,8,19,3,131,124,255,387
0130-001,2013,8,19,4,112,137,249,255
0130-001,2013,8,19,5,173,208,381,249
0130-001,2013,8,19,6,442,450,892,381
0130-001,2013,8,19,7,1684,968,2652,892
0130-001,2013,8,19,8,2107,1854,3961,2652
0130-001,2013,8,19,9,2176,1906,4082,3961
0130-001,2013,8,19,10,1810,1790,3600,4082
0130-001,2013,8,19,11,1771,1749,3520,3600
0130-001,2013,8,19,12,1732,1720,3452,3520
0130-001,2013,8,19,13,1434,1656,3090,3452
0130-001,2013,8,19,14,1779,1731,3510,3090
0130-001,2013,8,19,15,1865,1765,3630,3510
0130-001,2013,8,19,16,1837,1829,3666,3630
0130-001,2013,8,19,17,1752,1844,3596,3666
0130-001,2013,8,19,18,1830,2216,4046,3596
0130-001,2013,8,19,19,1857,2444,4301,4046
0130-001,2013,8,19,20,1442,1802,3244,4301
0130-001,2013,8,19,21,1240,1733,2973,3244
0130-001,2013,8,19,22,1129,1263,2392,2973
0130-001,2013,8,19,23,817,740,1557,2392
0130-001,2013,8,19,24,564,482,1046,1557
0130-001,2013,8,20,1,392,362,754,1046
0130-001,2013,8,20,2,238,234,472,754
0130-001,2013,8,20,3,147,147,294,472
0130-001,2013,8,20,4,158,187,345,294
0130-001,2013,8,20,5,195,240,435,345
0130-001,2013,8,20,6,434,415,849,435
0130-001,2013,8,20,7,1355,795,2150,849
0130-001,2013,8,20,8,2177,1821,3998,2150
0130-001,2013,8,20,9,2195,1926,4121,3998
0130-001,2013,8,20,10,1728,1711,3439,4121
0130-001,2013,8,20,11,1768,1725,3493,3439
0130-001,2013,8,20,12,1691,1722,3413,3493
0130-001,2013,8,20,13,1444,1549,2993,3413
0130-001,2013,8,20,14,1618,1680,3298,2993
0130-001,2013,8,20,15,1724,1773,3497,3298
0130-001,2013,8,20,16,1923,1811,3734,3497
0130-001,2013,8,20,17,1670,1882,3552,3734
0130-001,2013,8,20,18,1772,2108,3880,3552
0130-001,2013,8,20,19,1861,2474,4335,3880
0130-001,2013,8,20,20,1503,2025,3528,4335
0130-001,2013,8,20,21,1315,1713,3028,3528
0130-001,2013,8,20,22,1234,1318,2552,3028
0130-001,2013,8,20,23,883,811,1694,2552
0130-001,2013,8,20,24,595,516,1111,1694
0130-001,2013,8,21,1,396,333,729,1111
0130-001,2013,8,21,2,280,236,516,729
0130-001,2013,8,21,3,189,206,395,516
0130-001,2013,8,21,4,137,179,316,395
0130-001,2013,8,21,5,176,213,389,316
0130-001,2013,8,21,6,412,413,825,389
0130-001,2013,8,21,7,1310,849,2159,825
0130-001,2013,8,21,8,2203,1778,3981,2159
0130-001,2013,8,21,9,2189,1920,4109,3981
0130-001,2013,8,21,10,1764,1711,3475,4109
0130-001,2013,8,21,11,1743,1657,3400,3475
0130-001,2013,8,21,12,1579,1585,3164,3400
0130-001,2013,8,21,13,1419,1504,2923,3164
0130-001,2013,8,21,14,1720,1714,3434,2923
0130-001,2013,8,21,15,1504,1573,3077,3434
0130-001,2013,8,21,16,1696,1787,3483,3077
0130-001,2013,8,21,17,1706,1855,3561,3483
0130-001,2013,8,21,18,1801,2248,4049,3561
0130-001,2013,8,21,19,1942,2625,4567,4049
0130-001,2013,8,21,20,1494,1992,3486,4567
0130-001,2013,8,21,21,1292,1640,2932,3486
0130-001,2013,8,21,22,1259,1225,2484,2932
0130-001,2013,8,21,23,883,847,1730,2484
0130-001,2013,8,21,24,601,546,1147,1730
0130-001,2013,8,22,1,409,395,804,1147
0130-001,2013,8,22,2,252,236,488,804
0130-001,2013,8,22,3,196,173,369,488
0130-001,2013,8,22,4,162,175,337,369
0130-001,2013,8,22,5,196,243,439,337
0130-001,2013,8,22,6,399,401,800,439
0130-001,2013,8,22,7,1318,799,2117,800
0130-001,2013,8,22,8,2169,1807,3976,2117
0130-001,2013,8,22,9,2091,2016,4107,3976
0130-001,2013,8,22,10,1776,1694,3470,4107
0130-001,2013,8,22,11,1779,1676,3455,3470
0130-001,2013,8,22,12,1571,1719,3290,3455
0130-001,2013,8,22,13,1410,1516,2926,3290
0130-001,2013,8,22,14,1683,1772,3455,2926
0130-001,2013,8,22,15,1698,1717,3415,3455
0130-001,2013,8,22,16,1821,1829,3650,3415
0130-001,2013,8,22,17,1649,1851,3500,3650
0130-001,2013,8,22,18,1797,2115,3912,3500
0130-001,2013,8,22,19,1887,2408,4295,3912
0130-001,2013,8,22,20,1443,1788,3231,4295
0130-001,2013,8,22,21,1267,1761,3028,3231
0130-001,2013,8,22,22,1186,1298,2484,3028
0130-001,2013,8,22,23,959,780,1739,2484
0130-001,2013,8,22,24,608,512,1120,1739
0130-001,2013,8,23,1,396,357,753,1120
0130-001,2013,8,23,2,273,237,510,753
0130-001,2013,8,23,3,181,200,381,510
0130-001,2013,8,23,4,161,216,377,381
0130-001,2013,8,23,5,178,212,390,377
0130-001,2013,8,23,6,359,360,719,390
0130-001,2013,8,23,7,1166,696,1862,719
0130-001,2013,8,23,8,2123,1777,3900,1862
0130-001,2013,8,23,9,2147,1965,4112,3900
0130-001,2013,8,23,10,1683,1653,3336,4112
0130-001,2013,8,23,11,1677,1733,3410,3336
0130-001,2013,8,23,12,1591,1704,3295,3410
0130-001,2013,8,23,13,1511,1613,3124,3295
0130-001,2013,8,23,14,1722,1818,3540,3124
0130-001,2013,8,23,15,1841,1805,3646,3540
0130-001,2013,8,23,16,1813,1909,3722,3646
0130-001,2013,8,23,17,1788,1913,3701,3722
0130-001,2013,8,23,18,1908,2170,4078,3701
0130-001,2013,8,23,19,1946,2579,4525,4078
0130-001,2013,8,23,20,1566,2175,3741,4525
0130-001,2013,8,23,21,1339,1855,3194,3741
0130-001,2013,8,23,22,1278,1324,2602,3194
0130-001,2013,8,23,23,926,835,1761,2602
0130-001,2013,8,23,24,676,602,1278,1761
0130-001,2013,8,24,1,504,403,907,1278
0130-001,2013,8,24,2,348,287,635,907
0130-001,2013,8,24,3,255,245,500,635
0130-001,2013,8,24,4,223,223,446,500
0130-001,2013,8,24,5,268,261,529,446
0130-001,2013,8,24,6,453,436,889,529
0130-001,2013,8,24,7,941,665,1606,889
0130-001,2013,8,24,8,1544,1230,2774,1606
0130-001,2013,8,24,9,1538,1714,3252,2774
0130-001,2013,8,24,10,1699,1797,3496,3252
0130-001,2013,8,24,11,1635,1782,3417,3496
0130-001,2013,8,24,12,1649,1984,3633,3417
0130-001,2013,8,24,13,1607,2176,3783,3633
0130-001,2013,8,24,14,1667,2144,3811,3783
0130-001,2013,8,24,15,1743,1980,3723,3811
0130-001,2013,8,24,16,1719,1983,3702,3723
0130-001,2013,8,24,17,1754,2012,3766,3702
0130-001,2013,8,24,18,1943,2304,4247,3766
0130-001,2013,8,24,19,1814,2114,3928,4247
0130-001,2013,8,24,20,1535,1489,3024,3928
0130-001,2013,8,24,21,1385,1370,2755,3024
0130-001,2013,8,24,22,1172,1037,2209,2755
0130-001,2013,8,24,23,906,725,1631,2209
0130-001,2013,8,24,24,597,493,1090,1631
0130-001,2013,8,25,1,469,410,879,1090
0130-001,2013,8,25,2,300,262,562,879
0130-001,2013,8,25,3,247,215,462,562
0130-001,2013,8,25,4,222,181,403,462
0130-001,2013,8,25,5,204,193,397,403
0130-001,2013,8,25,6,316,311,627,397
0130-001,2013,8,25,7,637,504,1141,627
0130-001,2013,8,25,8,743,643,1386,1141
0130-001,2013,8,25,9,917,984,1901,1386
0130-001,2013,8,25,10,1001,1068,2069,1901
0130-001,2013,8,25,11,1083,1208,2291,2069
0130-001,2013,8,25,12,1155,1302,2457,2291
0130-001,2013,8,25,13,1318,1465,2783,2457
0130-001,2013,8,25,14,1442,1453,2895,2783
0130-001,2013,8,25,15,1624,1474,3098,2895
0130-001,2013,8,25,16,1784,1511,3295,3098
0130-001,2013,8,25,17,1894,1487,3381,3295
0130-001,2013,8,25,18,1887,1569,3456,3381
0130-001,2013,8,25,19,1810,1529,3339,3456
0130-001,2013,8,25,20,1627,1257,2884,3339
0130-001,2013,8,25,21,1537,1116,2653,2884
0130-001,2013,8,25,22,1088,915,2003,2653
0130-001,2013,8,25,23,747,628,1375,2003
0130-001,2013,8,25,24,464,378,842,1375
0130-001,2013,8,26,1,274,283,557,842
0130-001,2013,8,26,2,191,179,370,557
0130-001,2013,8,26,3,139,131,270,370
0130-001,2013,8,26,4,123,168,291,270
0130-001,2013,8,26,5,201,216,417,291
0130-001,2013,8,26,6,430,417,847,417
0130-001,2013,8,26,7,1550,915,2465,847
0130-001,2013,8,26,8,2119,1912,4031,2465
0130-001,2013,8,26,9,2285,2000,4285,4031
0130-001,2013,8,26,10,1773,1726,3499,4285
0130-001,2013,8,26,11,1707,1796,3503,3499
0130-001,2013,8,26,12,1770,1593,3363,3503
0130-001,2013,8,26,13,1539,1604,3143,3363
0130-001,2013,8,26,14,1844,1752,3596,3143
0130-001,2013,8,26,15,1873,1912,3785,3596
0130-001,2013,8,26,16,1815,1871,3686,3785
0130-001,2013,8,26,17,1465,1942,3407,3686
0130-001,2013,8,26,18,1919,2222,4141,3407
0130-001,2013,8,26,19,1866,2514,4380,4141
0130-001,2013,8,26,20,1474,1955,3429,4380
0130-001,2013,8,26,21,1306,1870,3176,3429
0130-001,2013,8,26,22,1206,1275,2481,3176
0130-001,2013,8,26,23,870,780,1650,2481
0130-001,2013,8,26,24,582,473,1055,1650
0130-001,2013,8,27,1,381,361,742,1055
0130-001,2013,8,27,2,212,227,439,742
0130-001,2013,8,27,3,175,179,354,439
0130-001,2013,8,27,4,165,178,343,354
0130-001,2013,8,27,5,189,242,431,343
0130-001,2013,8,27,6,418,420,838,431
0130-001,2013,8,27,7,1421,834,2255,838
0130-001,2013,8,27,8,2148,1836,3984,2255
0130-001,2013,8,27,9,2188,1988,4176,3984
0130-001,2013,8,27,10,1800,1769,3569,4176
0130-001,2013,8,27,11,1757,1746,3503,3569
0130-001,2013,8,27,12,1704,1670,3374,3503
0130-001,2013,8,27,13,1495,1489,2984,3374
0130-001,2013,8,27,14,1725,1763,3488,2984
0130-001,2013,8,27,15,1776,1760,3536,3488
0130-001,2013,8,27,16,1880,1891,3771,3536
0130-001,2013,8,27,17,1726,1843,3569,3771
0130-001,2013,8,27,18,1816,2251,4067,3569
0130-001,2013,8,27,19,1787,2449,4236,4067
0130-001,2013,8,27,20,1537,1878,3415,4236
0130-001,2013,8,27,21,1342,1729,3071,3415
0130-001,2013,8,27,22,1136,1256,2392,3071
0130-001,2013,8,27,23,858,804,1662,2392
0130-001,2013,8,27,24,607,493,1100,1662
0130-001,2013,8,28,1,386,341,727,1100
0130-001,2013,8,28,2,252,228,480,727
0130-001,2013,8,28,3,176,180,356,480
0130-001,2013,8,28,4,184,173,357,356
0130-001,2013,8,28,5,208,253,461,357
0130-001,2013,8,28,6,396,403,799,461
0130-001,2013,8,28,7,1374,852,2226,799
0130-001,2013,8,28,8,2199,1842,4041,2226
0130-001,2013,8,28,9,2085,1978,4063,4041
0130-001,2013,8,28,10,1747,1759,3506,4063
0130-001,2013,8,28,11,1506,1622,3128,3506
0130-001,2013,8,28,12,1692,1698,3390,3128
0130-001,2013,8,28,13,1413,1487,2900,3390
0130-001,2013,8,28,14,1741,1709,3450,2900
0130-001,2013,8,28,15,1810,1810,3620,3450
0130-001,2013,8,28,16,1829,1870,3699,3620
0130-001,2013,8,28,17,1689,1776,3465,3699
0130-001,2013,8,28,18,1897,2255,4152,3465
0130-001,2013,8,28,19,1824,2626,4450,4152
0130-001,2013,8,28,20,1572,1935,3507,4450
0130-001,2013,8,28,21,1334,1693,3027,3507
0130-001,2013,8,28,22,1118,1304,2422,3027
0130-001,2013,8,28,23,967,828,1795,2422
0130-001,2013,8,28,24,638,489,1127,1795
0130-001,2013,8,29,1,415,346,761,1127
0130-001,2013,8,29,2,267,243,510,761
0130-001,2013,8,29,3,210,211,421,510
0130-001,2013,8,29,4,165,190,355,421
0130-001,2013,8,29,5,165,228,393,355
0130-001,2013,8,29,6,352,336,688,393
0130-001,2013,8,29,7,1223,783,2006,688
0130-001,2013,8,29,8,2138,1709,3847,2006
0130-001,2013,8,29,9,2240,1988,4228,3847
0130-001,2013,8,29,10,1792,1795,3587,4228
0130-001,2013,8,29,11,1733,1778,3511,3587
0130-001,2013,8,29,12,1585,1576,3161,3511
0130-001,2013,8,29,13,1259,1430,2689,3161
0130-001,2013,8,29,14,1577,1609,3186,2689
0130-001,2013,8,29,15,1618,1556,3174,3186
0130-001,2013,8,29,16,1608,1717,3325,3174
0130-001,2013,8,29,17,1620,1817,3437,3325
0130-001,2013,8,29,18,1642,2220,3862,3437
0130-001,2013,8,29,19,1746,2422,4168,3862
0130-001,2013,8,29,20,1345,1724,3069,4168
0130-001,2013,8,29,21,1192,1601,2793,3069
0130-001,2013,8,29,22,1154,1193,2347,2793
0130-001,2013,8,29,23,878,794,1672,2347
0130-001,2013,8,29,24,674,487,1161,1672
0130-001,2013,8,30,1,446,363,809,1161
0130-001,2013,8,30,2,268,280,548,809
0130-001,2013,8,30,3,194,196,390,548
0130-001,2013,8,30,4,179,184,363,390
0130-001,2013,8,30,5,192,217,409,363
0130-001,2013,8,30,6,367,357,724,409
0130-001,2013,8,30,7,1296,804,2100,724
0130-001,2013,8,30,8,2189,1736,3925,2100
0130-001,2013,8,30,9,2237,2012,4249,3925
0130-001,2013,8,30,10,1730,1744,3474,4249
0130-001,2013,8,30,11,1704,1801,3505,3474
0130-001,2013,8,30,12,1726,1684,3410,3505
0130-001,2013,8,30,13,1468,1618,3086,3410
0130-001,2013,8,30,14,1755,1696,3451,3086
0130-001,2013,8,30,15,1923,1948,3871,3451
0130-001,2013,8,30,16,1840,1955,3795,3871
0130-001,2013,8,30,17,1929,1874,3803,3795
0130-001,2013,8,30,18,1869,2419,4288,3803
0130-001,2013,8,30,19,2052,2674,4726,4288
0130-001,2013,8,30,20,1734,2202,3936,4726
0130-001,2013,8,30,21,1498,1883,3381,3936
0130-001,2013,8,30,22,1291,1462,2753,3381
0130-001,2013,8,30,23,1044,893,1937,2753
0130-001,2013,8,30,24,763,674,1437,1937
0130-001,2013,8,31,1,528,442,970,1437
0130-001,2013,8,31,2,356,355,711,970
0130-001,2013,8,31,3,301,254,555,711
0130-001,2013,8,31,4,246,258,504,555
0130-001,2013,8,31,5,266,275,541,504
0130-001,2013,8,31,6,453,431,884,541
0130-001,2013,8,31,7,1007,790,1797,884
0130-001,2013,8,31,8,1569,1289,2858,1797
0130-001,2013,8,31,9,1649,1829,3478,2858
0130-001,2013,8,31,10,1679,2116,3795,3478
0130-001,2013,8,31,11,1685,2248,3933,3795
0130-001,2013,8,31,12,1669,2300,3969,3933
0130-001,2013,8,31,13,1537,2433,3970,3969
0130-001,2013,8,31,14,1694,2381,4075,3970
0130-001,2013,8,31,15,1651,2438,4089,4075
0130-001,2013,8,31,16,1957,2423,4380,4089
0130-001,2013,8,31,17,1879,2447,4326,4380
0130-001,2013,8,31,18,2068,2572,4640,4326
0130-001,2013,8,31,19,2142,2574,4716,4640
0130-001,2013,8,31,20,1878,2096,3974,4716
0130-001,2013,8,31,21,1559,1453,3012,3974
0130-001,2013,8,31,22,1266,1042,2308,3012
0130-001,2013,8,31,23,885,748,1633,2308
0130-001,2013,8,31,24,622,542,1164,1633
0130-001,2013,9,1,1,419,396,815,1164
0130-001,2013,9,1,2,294,253,547,815
0130-001,2013,9,1,3,249,208,457,547
0130-001,2013,9,1,4,218,187,405,457
0130-001,2013,9,1,5,224,177,401,405
0130-001,2013,9,1,6,330,355,685,401
0130-001,2013,9,1,7,706,586,1292,685
0130-001,2013,9,1,8,795,847,1642,1292
0130-001,2013,9,1,9,936,1174,2110,1642
0130-001,2013,9,1,10,1003,1337,2340,2110
0130-001,2013,9,1,11,1077,1475,2552,2340
0130-001,2013,9,1,12,1330,1445,2775,2552
0130-001,2013,9,1,13,1326,1553,2879,2775
0130-001,2013,9,1,14,1733,1593,3326,2879
0130-001,2013,9,1,15,1978,1536,3514,3326
0130-001,2013,9,1,16,1894,1556,3450,3514
0130-001,2013,9,1,17,1823,1485,3308,3450
0130-001,2013,9,1,18,2134,1705,3839,3308
0130-001,2013,9,1,19,1887,1454,3341,3839
0130-001,2013,9,1,20,1785,1312,3097,3341
0130-001,2013,9,1,21,1840,1099,2939,3097
0130-001,2013,9,1,22,1783,936,2719,2939
0130-001,2013,9,1,23,1397,658,2055,2719
0130-001,2013,9,1,24,738,425,1163,2055
0130-001,2013,9,2,1,349,242,591,1163
0130-001,2013,9,2,2,181,149,330,591
0130-001,2013,9,2,3,133,115,248,330
0130-001,2013,9,2,4,117,142,259,248
0130-001,2013,9,2,5,164,225,389,259
0130-001,2013,9,2,6,426,447,873,389
0130-001,2013,9,2,7,1489,910,2399,873
0130-001,2013,9,2,8,2136,1879,4015,2399
0130-001,2013,9,2,9,2269,2059,4328,4015
0130-001,2013,9,2,10,1751,1828,3579,4328
0130-001,2013,9,2,11,1750,1781,3531,3579
0130-001,2013,9,2,12,1669,1837,3506,3531
0130-001,2013,9,2,13,1519,1811,3330,3506
0130-001,2013,9,2,14,1767,1692,3459,3330
0130-001,2013,9,2,15,1820,1768,3588,3459
0130-001,2013,9,2,16,1809,1852,3661,3588
0130-001,2013,9,2,17,1742,1924,3666,3661
0130-001,2013,9,2,18,1775,2230,4005,3666
0130-001,2013,9,2,19,1831,2550,4381,4005
0130-001,2013,9,2,20,1531,1856,3387,4381
0130-001,2013,9,2,21,1275,1817,3092,3387
0130-001,2013,9,2,22,1163,1285,2448,3092
0130-001,2013,9,2,23,807,756,1563,2448
0130-001,2013,9,2,24,517,423,940,1563
0130-001,2013,9,3,1,354,325,679,940
0130-001,2013,9,3,2,244,221,465,679
0130-001,2013,9,3,3,214,166,380,465
0130-001,2013,9,3,4,140,175,315,380
0130-001,2013,9,3,5,184,228,412,315
0130-001,2013,9,3,6,342,404,746,412
0130-001,2013,9,3,7,1445,833,2278,746
0130-001,2013,9,3,8,2125,1776,3901,2278
0130-001,2013,9,3,9,2273,2032,4305,3901
0130-001,2013,9,3,10,1813,1806,3619,4305
0130-001,2013,9,3,11,1708,1693,3401,3619
0130-001,2013,9,3,12,1639,1589,3228,3401
0130-001,2013,9,3,13,1477,1451,2928,3228
0130-001,2013,9,3,14,1745,1635,3380,2928
0130-001,2013,9,3,15,1825,1777,3602,3380
0130-001,2013,9,3,16,1827,1851,3678,3602
0130-001,2013,9,3,17,1751,1946,3697,3678
0130-001,2013,9,3,18,1833,2346,4179,3697
0130-001,2013,9,3,19,1818,2487,4305,4179
0130-001,2013,9,3,20,1548,1987,3535,4305
0130-001,2013,9,3,21,1322,1787,3109,3535
0130-001,2013,9,3,22,1162,1280,2442,3109
0130-001,2013,9,3,23,882,729,1611,2442
0130-001,2013,9,3,24,593,502,1095,1611
0130-001,2013,9,4,1,379,343,722,1095
0130-001,2013,9,4,2,229,202,431,722
0130-001,2013,9,4,3,201,196,397,431
0130-001,2013,9,4,4,162,205,367,397
0130-001,2013,9,4,5,180,232,412,367
0130-001,2013,9,4,6,400,441,841,412
0130-001,2013,9,4,7,1356,809,2165,841
0130-001,2013,9,4,8,2156,1778,3934,2165
0130-001,2013,9,4,9,2201,2050,4251,3934
0130-001,2013,9,4,10,1828,1761,3589,4251
0130-001,2013,9,4,11,1803,1706,3509,3589
0130-001,2013,9,4,12,1658,1637,3295,3509
0130-001,2013,9,4,13,1450,1469,2919,3295
0130-001,2013,9,4,14,1684,1734,3418,2919
0130-001,2013,9,4,15,1842,1809,3651,3418
0130-001,2013,9,4,16,1787,1866,3653,3651
0130-001,2013,9,4,17,1800,1840,3640,3653
0130-001,2013,9,4,18,1767,2343,4110,3640
0130-001,2013,9,4,19,2026,2623,4649,4110
0130-001,2013,9,4,20,1489,2083,3572,4649
0130-001,2013,9,4,21,1286,1707,2993,3572
0130-001,2013,9,4,22,1310,1280,2590,2993
0130-001,2013,9,4,23,924,819,1743,2590
0130-001,2013,9,4,24,644,519,1163,1743
0130-001,2013,9,5,1,394,348,742,1163
0130-001,2013,9,5,2,262,219,481,742
0130-001,2013,9,5,3,196,183,379,481
0130-001,2013,9,5,4,161,187,348,379
0130-001,2013,9,5,5,168,235,403,348
0130-001,2013,9,5,6,383,419,802,403
0130-001,2013,9,5,7,1363,814,2177,802
0130-001,2013,9,5,8,2188,1752,3940,2177
0130-001,2013,9,5,9,2195,2036,4231,3940
0130-001,2013,9,5,10,1813,1784,3597,4231
0130-001,2013,9,5,11,1788,1732,3520,3597
0130-001,2013,9,5,12,1723,1659,3382,3520
0130-001,2013,9,5,13,1424,1491,2915,3382
0130-001,2013,9,5,14,1726,1731,3457,2915
0130-001,2013,9,5,15,1759,1760,3519,3457
0130-001,2013,9,5,16,1801,1803,3604,3519
0130-001,2013,9,5,17,1706,1897,3603,3604
0130-001,2013,9,5,18,1806,2273,4079,3603
0130-001,2013,9,5,19,1901,2443,4344,4079
0130-001,2013,9,5,20,1517,1886,3403,4344
0130-001,2013,9,5,21,1258,1733,2991,3403
0130-001,2013,9,5,22,1264,1407,2671,2991
0130-001,2013,9,5,23,928,845,1773,2671
0130-001,2013,9,5,24,595,512,1107,1773
0130-001,2013,9,6,1,384,366,750,1107
0130-001,2013,9,6,2,272,255,527,750
0130-001,2013,9,6,3,188,171,359,527
0130-001,2013,9,6,4,157,189,346,359
0130-001,2013,9,6,5,194,248,442,346
0130-001,2013,9,6,6,359,408,767,442
0130-001,2013,9,6,7,1295,816,2111,767
0130-001,2013,9,6,8,2168,1751,3919,2111
0130-001,2013,9,6,9,2337,2042,4379,3919
0130-001,2013,9,6,10,1876,1858,3734,4379
0130-001,2013,9,6,11,1827,1725,3552,3734
0130-001,2013,9,6,12,1743,1674,3417,3552
0130-001,2013,9,6,13,1400,1675,3075,3417
0130-001,2013,9,6,14,1719,1795,3514,3075
0130-001,2013,9,6,15,1856,1837,3693,3514
0130-001,2013,9,6,16,1755,1917,3672,3693
0130-001,2013,9,6,17,1871,1977,3848,3672
0130-001,2013,9,6,18,1933,2409,4342,3848
0130-001,2013,9,6,19,1957,2634,4591,4342
0130-001,2013,9,6,20,1610,2234,3844,4591
0130-001,2013,9,6,21,1426,1923,3349,3844
0130-001,2013,9,6,22,1294,1400,2694,3349
0130-001,2013,9,6,23,933,931,1864,2694
0130-001,2013,9,6,24,731,626,1357,1864
0130-001,2013,9,7,1,471,434,905,1357
0130-001,2013,9,7,2,331,281,612,905
0130-001,2013,9,7,3,266,227,493,612
0130-001,2013,9,7,4,228,230,458,493
0130-001,2013,9,7,5,253,264,517,458
0130-001,2013,9,7,6,387,445,832,517
0130-001,2013,9,7,7,1001,690,1691,832
0130-001,2013,9,7,8,1538,1337,2875,1691
0130-001,2013,9,7,9,1669,1916,3585,2875
0130-001,2013,9,7,10,1723,2165,3888,3585
0130-001,2013,9,7,11,1666,2301,3967,3888
0130-001,2013,9,7,12,1780,2331,4111,3967
0130-001,2013,9,7,13,1608,2509,4117,4111
0130-001,2013,9,7,14,1742,2345,4087,4117
0130-001,2013,9,7,15,1964,2187,4151,4087
0130-001,2013,9,7,16,2014,2078,4092,4151
0130-001,2013,9,7,17,1932,1810,3742,4092
0130-001,2013,9,7,18,1970,2194,4164,3742
0130-001,2013,9,7,19,2001,2006,4007,4164
0130-001,2013,9,7,20,1872,1437,3309,4007
0130-001,2013,9,7,21,1562,1332,2894,3309
0130-001,2013,9,7,22,1318,1123,2441,2894
0130-001,2013,9,7,23,834,711,1545,2441
0130-001,2013,9,7,24,550,521,1071,1545
0130-001,2013,9,8,1,426,388,814,1071
0130-001,2013,9,8,2,323,252,575,814
0130-001,2013,9,8,3,250,202,452,575
0130-001,2013,9,8,4,184,163,347,452
0130-001,2013,9,8,5,194,194,388,347
0130-001,2013,9,8,6,309,316,625,388
0130-001,2013,9,8,7,627,607,1234,625
0130-001,2013,9,8,8,826,842,1668,1234
0130-001,2013,9,8,9,936,1088,2024,1668
0130-001,2013,9,8,10,1064,1158,2222,2024
0130-001,2013,9,8,11,1158,1288,2446,2222
0130-001,2013,9,8,12,1373,1342,2715,2446
0130-001,2013,9,8,13,1401,1469,2870,2715
0130-001,2013,9,8,14,1654,1458,3112,2870
0130-001,2013,9,8,15,1812,1544,3356,3112
0130-001,2013,9,8,16,2036,1528,3564,3356
0130-001,2013,9,8,17,2000,1544,3544,3564
0130-001,2013,9,8,18,1985,1712,3697,3544
0130-001,2013,9,8,19,1910,1488,3398,3697
0130-001,2013,9,8,20,1717,1235,2952,3398
0130-001,2013,9,8,21,1565,1028,2593,2952
0130-001,2013,9,8,22,1105,828,1933,2593
0130-001,2013,9,8,23,702,597,1299,1933
0130-001,2013,9,8,24,427,382,809,1299
0130-001,2013,9,9,1,262,225,487,809
0130-001,2013,9,9,2,177,160,337,487
0130-001,2013,9,9,3,134,126,260,337
0130-001,2013,9,9,4,126,165,291,260
0130-001,2013,9,9,5,178,202,380,291
0130-001,2013,9,9,6,384,431,815,380
0130-001,2013,9,9,7,1470,870,2340,815
0130-001,2013,9,9,8,2197,1801,3998,2340
0130-001,2013,9,9,9,2195,2092,4287,3998
0130-001,2013,9,9,10,1821,1824,3645,4287
0130-001,2013,9,9,11,1769,1730,3499,3645
0130-001,2013,9,9,12,1641,1661,3302,3499
0130-001,2013,9,9,13,1525,1479,3004,3302
0130-001,2013,9,9,14,1804,1756,3560,3004
0130-001,2013,9,9,15,1905,1839,3744,3560
0130-001,2013,9,9,16,1748,1916,3664,3744
0130-001,2013,9,9,17,1846,1929,3775,3664
0130-001,2013,9,9,18,1840,2231,4071,3775
0130-001,2013,9,9,19,1889,2504,4393,4071
0130-001,2013,9,9,20,1493,1925,3418,4393
0130-001,2013,9,9,21,1251,1814,3065,3418
0130-001,2013,9,9,22,1221,1333,2554,3065
0130-001,2013,9,9,23,892,791,1683,2554
0130-001,2013,9,9,24,589,519,1108,1683
0130-001,2013,9,10,1,353,311,664,1108
0130-001,2013,9,10,2,222,208,430,664
0130-001,2013,9,10,3,153,178,331,430
0130-001,2013,9,10,4,152,196,348,331
0130-001,2013,9,10,5,191,227,418,348
0130-001,2013,9,10,6,376,413,789,418
0130-001,2013,9,10,7,1347,768,2115,789
0130-001,2013,9,10,8,2204,1767,3971,2115
0130-001,2013,9,10,9,2191,2075,4266,3971
0130-001,2013,9,10,10,1843,1802,3645,4266
0130-001,2013,9,10,11,1890,1765,3655,3645
0130-001,2013,9,10,12,1638,1707,3345,3655
0130-001,2013,9,10,13,1528,1540,3068,3345
0130-001,2013,9,10,14,1822,1756,3578,3068
0130-001,2013,9,10,15,1914,1818,3732,3578
0130-001,2013,9,10,16,1876,1893,3769,3732
0130-001,2013,9,10,17,1775,1966,3741,3769
0130-001,2013,9,10,18,1766,2259,4025,3741
0130-001,2013,9,10,19,1805,2430,4235,4025
0130-001,2013,9,10,20,1511,1928,3439,4235
0130-001,2013,9,10,21,1331,1754,3085,3439
0130-001,2013,9,10,22,1108,1277,2385,3085
0130-001,2013,9,10,23,884,776,1660,2385
0130-001,2013,9,10,24,598,529,1127,1660
0130-001,2013,9,11,1,387,316,703,1127
0130-001,2013,9,11,2,238,226,464,703
0130-001,2013,9,11,3,189,170,359,464
0130-001,2013,9,11,4,164,172,336,359
0130-001,2013,9,11,5,184,231,415,336
0130-001,2013,9,11,6,313,368,681,415
0130-001,2013,9,11,7,1166,688,1854,681
0130-001,2013,9,11,8,2127,1687,3814,1854
0130-001,2013,9,11,9,2219,2067,4286,3814
0130-001,2013,9,11,10,1767,1780,3547,4286
0130-001,2013,9,11,11,1808,1713,3521,3547
0130-001,2013,9,11,12,1772,1749,3521,3521
0130-001,2013,9,11,13,1609,1609,3218,3521
0130-001,2013,9,11,14,1824,1768,3592,3218
0130-001,2013,9,11,15,1797,1853,3650,3592
0130-001,2013,9,11,16,1952,1907,3859,3650
0130-001,2013,9,11,17,1805,1977,3782,3859
0130-001,2013,9,11,18,1832,2303,4135,3782
0130-001,2013,9,11,19,1895,2563,4458,4135
0130-001,2013,9,11,20,1546,1944,3490,4458
0130-001,2013,9,11,21,1264,1688,2952,3490
0130-001,2013,9,11,22,1269,1284,2553,2952
0130-001,2013,9,11,23,1018,830,1848,2553
0130-001,2013,9,11,24,677,609,1286,1848
0130-001,2013,9,12,1,422,357,779,1286
0130-001,2013,9,12,2,307,275,582,779
0130-001,2013,9,12,3,236,186,422,582
0130-001,2013,9,12,4,146,211,357,422
0130-001,2013,9,12,5,209,253,462,357
0130-001,2013,9,12,6,354,391,745,462
0130-001,2013,9,12,7,1301,789,2090,745
0130-001,2013,9,12,8,2112,1729,3841,2090
0130-001,2013,9,12,9,2222,2104,4326,3841
0130-001,2013,9,12,10,1770,1791,3561,4326
0130-001,2013,9,12,11,1845,1814,3659,3561
0130-001,2013,9,12,12,1719,1684,3403,3659
0130-001,2013,9,12,13,1482,1563,3045,3403
0130-001,2013,9,12,14,1813,1768,3581,3045
0130-001,2013,9,12,15,1892,1792,3684,3581
0130-001,2013,9,12,16,1803,1883,3686,3684
0130-001,2013,9,12,17,1908,2025,3933,3686
0130-001,2013,9,12,18,1861,2277,4138,3933
0130-001,2013,9,12,19,1884,2446,4330,4138
0130-001,2013,9,12,20,1538,1937,3475,4330
0130-001,2013,9,12,21,1332,1808,3140,3475
0130-001,2013,9,12,22,1235,1300,2535,3140
0130-001,2013,9,12,23,930,832,1762,2535
0130-001,2013,9,12,24,674,557,1231,1762
0130-001,2013,9,13,1,435,369,804,1231
0130-001,2013,9,13,2,261,286,547,804
0130-001,2013,9,13,3,217,196,413,547
0130-001,2013,9,13,4,168,210,378,413
0130-001,2013,9,13,5,159,231,390,378
0130-001,2013,9,13,6,297,348,645,390
0130-001,2013,9,13,7,1161,677,1838,645
0130-001,2013,9,13,8,2180,1755,3935,1838
0130-001,2013,9,13,9,2247,2090,4337,3935
0130-001,2013,9,13,10,1808,1815,3623,4337
0130-001,2013,9,13,11,1872,1908,3780,3623
0130-001,2013,9,13,12,1751,1778,3529,3780
0130-001,2013,9,13,13,1467,1638,3105,3529
0130-001,2013,9,13,14,1865,1847,3712,3105
0130-001,2013,9,13,15,1935,1927,3862,3712
0130-001,2013,9,13,16,1901,1976,3877,3862
0130-001,2013,9,13,17,1930,1957,3887,3877
0130-001,2013,9,13,18,1879,2385,4264,3887
0130-001,2013,9,13,19,1999,2662,4661,4264
0130-001,2013,9,13,20,1604,2194,3798,4661
0130-001,2013,9,13,21,1412,1737,3149,3798
0130-001,2013,9,13,22,1303,1373,2676,3149
0130-001,2013,9,13,23,1036,925,1961,2676
0130-001,2013,9,13,24,732,636,1368,1961
0130-001,2013,9,14,1,536,435,971,1368
0130-001,2013,9,14,2,338,337,675,971
0130-001,2013,9,14,3,310,234,544,675
0130-001,2013,9,14,4,218,259,477,544
0130-001,2013,9,14,5,248,239,487,477
0130-001,2013,9,14,6,306,317,623,487
0130-001,2013,9,14,7,741,575,1316,623
0130-001,2013,9,14,8,1361,1116,2477,1316
0130-001,2013,9,14,9,1530,1640,3170,2477
0130-001,2013,9,14,10,1655,1814,3469,3170
0130-001,2013,9,14,11,1640,1710,3350,3469
0130-001,2013,9,14,12,1605,1957,3562,3350
0130-001,2013,9,14,13,1778,1998,3776,3562
0130-001,2013,9,14,14,1548,1956,3504,3776
0130-001,2013,9,14,15,1665,1824,3489,3504
0130-001,2013,9,14,16,1724,1913,3637,3489
0130-001,2013,9,14,17,1891,1869,3760,3637
0130-001,2013,9,14,18,1958,2023,3981,3760
0130-001,2013,9,14,19,1909,1998,3907,3981
0130-001,2013,9,14,20,1518,1508,3026,3907
0130-001,2013,9,14,21,1323,1195,2518,3026
0130-001,2013,9,14,22,1197,1044,2241,2518
0130-001,2013,9,14,23,864,697,1561,2241
0130-001,2013,9,14,24,600,493,1093,1561
0130-001,2013,9,15,1,435,361,796,1093
0130-001,2013,9,15,2,336,246,582,796
0130-001,2013,9,15,3,285,226,511,582
0130-001,2013,9,15,4,214,180,394,511
0130-001,2013,9,15,5,210,194,404,394
0130-001,2013,9,15,6,270,333,603,404
0130-001,2013,9,15,7,702,472,1174,603
0130-001,2013,9,15,8,899,750,1649,1174
0130-001,2013,9,15,9,1011,974,1985,1649
0130-001,2013,9,15,10,1101,1166,2267,1985
0130-001,2013,9,15,11,1259,1390,2649,2267
0130-001,2013,9,15,12,1207,1406,2613,2649
0130-001,2013,9,15,13,1322,1585,2907,2613
0130-001,2013,9,15,14,1513,1580,3093,2907
0130-001,2013,9,15,15,1561,1662,3223,3093
0130-001,2013,9,15,16,1694,1614,3308,3223
0130-001,2013,9,15,17,1641,1646,3287,3308
0130-001,2013,9,15,18,1734,1736,3470,3287
0130-001,2013,9,15,19,1813,1521,3334,3470
0130-001,2013,9,15,20,1333,1401,2734,3334
0130-001,2013,9,15,21,1245,1104,2349,2734
0130-001,2013,9,15,22,1085,822,1907,2349
0130-001,2013,9,15,23,707,610,1317,1907
0130-001,2013,9,15,24,498,440,938,1317
0130-001,2013,9,16,1,297,242,539,938
0130-001,2013,9,16,2,176,170,346,539
0130-001,2013,9,16,3,148,134,282,346
0130-001,2013,9,16,4,146,170,316,282
0130-001,2013,9,16,5,177,233,410,316
0130-001,2013,9,16,6,383,404,787,410
0130-001,2013,9,16,7,1477,884,2361,787
0130-001,2013,9,16,8,2159,1782,3941,2361
0130-001,2013,9,16,9,2176,2030,4206,3941
0130-001,2013,9,16,10,1910,1904,3814,4206
0130-001,2013,9,16,11,1873,1981,3854,3814
0130-001,2013,9,16,12,1905,1804,3709,3854
0130-001,2013,9,16,13,1690,1763,3453,3709
0130-001,2013,9,16,14,1965,1975,3940,3453
0130-001,2013,9,16,15,1955,2045,4000,3940
0130-001,2013,9,16,16,1915,2065,3980,4000
0130-001,2013,9,16,17,2008,2131,4139,3980
0130-001,2013,9,16,18,1965,2447,4412,4139
0130-001,2013,9,16,19,1963,2617,4580,4412
0130-001,2013,9,16,20,1625,2209,3834,4580
0130-001,2013,9,16,21,1461,1889,3350,3834
0130-001,2013,9,16,22,1279,1432,2711,3350
0130-001,2013,9,16,23,986,906,1892,2711
0130-001,2013,9,16,24,699,652,1351,1892
0130-001,2013,9,17,1,400,376,776,1351
0130-001,2013,9,17,2,287,283,570,776
0130-001,2013,9,17,3,227,212,439,570
0130-001,2013,9,17,4,181,209,390,439
0130-001,2013,9,17,5,212,250,462,390
0130-001,2013,9,17,6,390,407,797,462
0130-001,2013,9,17,7,1280,739,2019,797
0130-001,2013,9,17,8,2068,1745,3813,2019
0130-001,2013,9,17,9,2231,2036,4267,3813
0130-001,2013,9,17,10,1878,1866,3744,4267
0130-001,2013,9,17,11,1977,2072,4049,3744
0130-001,2013,9,17,12,1903,1958,3861,4049
0130-001,2013,9,17,13,1667,1806,3473,3861
0130-001,2013,9,17,14,1886,2110,3996,3473
0130-001,2013,9,17,15,1919,2329,4248,3996
0130-001,2013,9,17,16,1992,2409,4401,4248
0130-001,2013,9,17,17,1769,2507,4276,4401
0130-001,2013,9,17,18,1900,2730,4630,4276
0130-001,2013,9,17,19,1780,2596,4376,4630
0130-001,2013,9,17,20,1492,2451,3943,4376
0130-001,2013,9,17,21,1269,2378,3647,3943
0130-001,2013,9,17,22,1109,2497,3606,3647
0130-001,2013,9,17,23,907,2228,3135,3606
0130-001,2013,9,17,24,675,1585,2260,3135
0130-001,2013,9,18,1,435,1353,1788,2260
0130-001,2013,9,18,2,352,1016,1368,1788
0130-001,2013,9,18,3,274,937,1211,1368
0130-001,2013,9,18,4,213,1036,1249,1211
0130-001,2013,9,18,5,219,1376,1595,1249
0130-001,2013,9,18,6,323,1628,1951,1595
0130-001,2013,9,18,7,517,1856,2373,1951
0130-001,2013,9,18,8,695,1894,2589,2373
0130-001,2013,9,18,9,992,2010,3002,2589
0130-001,2013,9,18,10,1249,2148,3397,3002
0130-001,2013,9,18,11,1492,2265,3757,3397
0130-001,2013,9,18,12,1618,2355,3973,3757
0130-001,2013,9,18,13,1453,2487,3940,3973
0130-001,2013,9,18,14,1328,2531,3859,3940
0130-001,2013,9,18,15,1284,1997,3281,3859
0130-001,2013,9,18,16,1185,1361,2546,3281
0130-001,2013,9,18,17,1150,1348,2498,2546
0130-001,2013,9,18,18,1048,1289,2337,2498
0130-001,2013,9,18,19,1009,1127,2136,2337
0130-001,2013,9,18,20,880,995,1875,2136
0130-001,2013,9,18,21,777,873,1650,1875
0130-001,2013,9,18,22,690,682,1372,1650
0130-001,2013,9,18,23,527,526,1053,1372
0130-001,2013,9,18,24,358,343,701,1053
0130-001,2013,9,19,1,250,206,456,701
0130-001,2013,9,19,2,182,172,354,456
0130-001,2013,9,19,3,134,117,251,354
0130-001,2013,9,19,4,107,86,193,251
0130-001,2013,9,19,5,119,114,233,193
0130-001,2013,9,19,6,195,228,423,233
0130-001,2013,9,19,7,566,497,1063,423
0130-001,2013,9,19,8,1023,894,1917,1063
0130-001,2013,9,19,9,852,1077,1929,1917
0130-001,2013,9,19,10,877,1281,2158,1929
0130-001,2013,9,19,11,1797,1829,3626,2158
0130-001,2013,9,19,12,1755,2071,3826,3626
0130-001,2013,9,19,13,1887,2105,3992,3826
0130-001,2013,9,19,14,1868,2282,4150,3992
0130-001,2013,9,19,15,2030,2563,4593,4150
0130-001,2013,9,19,16,2233,2584,4817,4593
0130-001,2013,9,19,17,2251,2525,4776,4817
0130-001,2013,9,19,18,2249,2374,4623,4776
0130-001,2013,9,19,19,2020,2308,4328,4623
0130-001,2013,9,19,20,1938,1494,3432,4328
0130-001,2013,9,19,21,1544,1049,2593,3432
0130-001,2013,9,19,22,1176,830,2006,2593
0130-001,2013,9,19,23,913,564,1477,2006
0130-001,2013,9,19,24,780,440,1220,1477
0130-001,2013,9,20,1,611,248,859,1220
0130-001,2013,9,20,2,317,205,522,859
0130-001,2013,9,20,3,221,148,369,522
0130-001,2013,9,20,4,172,135,307,369
0130-001,2013,9,20,5,157,132,289,307
0130-001,2013,9,20,6,181,185,366,289
0130-001,2013,9,20,7,341,241,582,366
0130-001,2013,9,20,8,426,337,763,582
0130-001,2013,9,20,9,603,544,1147,763
0130-001,2013,9,20,10,810,699,1509,1147
0130-001,2013,9,20,11,1069,979,2048,1509
0130-001,2013,9,20,12,1413,1164,2577,2048
0130-001,2013,9,20,13,1529,1172,2701,2577
0130-001,2013,9,20,14,1654,1194,2848,2701
0130-001,2013,9,20,15,1830,1224,3054,2848
0130-001,2013,9,20,16,1807,1164,2971,3054
0130-001,2013,9,20,17,2129,1205,3334,2971
0130-001,2013,9,20,18,2058,1164,3222,3334
0130-001,2013,9,20,19,1773,1101,2874,3222
0130-001,2013,9,20,20,1729,995,2724,2874
0130-001,2013,9,20,21,1402,875,2277,2724
0130-001,2013,9,20,22,1677,746,2423,2277
0130-001,2013,9,20,23,1495,601,2096,2423
0130-001,2013,9,20,24,1414,380,1794,2096
0130-001,2013,9,21,1,1075,295,1370,1794
0130-001,2013,9,21,2,749,208,957,1370
0130-001,2013,9,21,3,413,169,582,957
0130-001,2013,9,21,4,239,132,371,582
0130-001,2013,9,21,5,207,137,344,371
0130-001,2013,9,21,6,259,235,494,344
0130-001,2013,9,21,7,515,341,856,494
0130-001,2013,9,21,8,726,532,1258,856
0130-001,2013,9,21,9,884,848,1732,1258
0130-001,2013,9,21,10,1154,1060,2214,1732
0130-001,2013,9,21,11,1363,1264,2627,2214
0130-001,2013,9,21,12,1654,1382,3036,2627
0130-001,2013,9,21,13,1765,1317,3082,3036
0130-001,2013,9,21,14,1838,1388,3226,3082
0130-001,2013,9,21,15,1898,1415,3313,3226
0130-001,2013,9,21,16,1936,1315,3251,3313
0130-001,2013,9,21,17,2075,1376,3451,3251
0130-001,2013,9,21,18,1863,1379,3242,3451
0130-001,2013,9,21,19,1958,1328,3286,3242
0130-001,2013,9,21,20,1916,1052,2968,3286
0130-001,2013,9,21,21,1690,950,2640,2968
0130-001,2013,9,21,22,1583,800,2383,2640
0130-001,2013,9,21,23,1141,603,1744,2383
0130-001,2013,9,21,24,778,391,1169,1744
0130-001,2013,9,22,1,558,339,897,1169
0130-001,2013,9,22,2,352,247,599,897
0130-001,2013,9,22,3,270,206,476,599
0130-001,2013,9,22,4,215,146,361,476
0130-001,2013,9,22,5,166,140,306,361
0130-001,2013,9,22,6,229,230,459,306
0130-001,2013,9,22,7,446,321,767,459
0130-001,2013,9,22,8,658,496,1154,767
0130-001,2013,9,22,9,811,629,1440,1154
0130-001,2013,9,22,10,907,870,1777,1440
0130-001,2013,9,22,11,1078,1004,2082,1777
0130-001,2013,9,22,12,1071,1071,2142,2082
0130-001,2013,9,22,13,1210,1229,2439,2142
0130-001,2013,9,22,14,1334,1308,2642,2439
0130-001,2013,9,22,15,1361,1321,2682,2642
0130-001,2013,9,22,16,1351,1324,2675,2682
0130-001,2013,9,22,17,1275,1410,2685,2675
0130-001,2013,9,22,18,1319,1398,2717,2685
0130-001,2013,9,22,19,1290,1274,2564,2717
0130-001,2013,9,22,20,1058,1091,2149,2564
0130-001,2013,9,22,21,1014,930,1944,2149
0130-001,2013,9,22,22,813,708,1521,1944
0130-001,2013,9,22,23,608,486,1094,1521
0130-001,2013,9,22,24,432,350,782,1094
0130-001,2013,9,23,1,292,229,521,782
0130-001,2013,9,23,2,187,183,370,521
0130-001,2013,9,23,3,143,119,262,370
0130-001,2013,9,23,4,154,154,308,262
0130-001,2013,9,23,5,181,206,387,308
0130-001,2013,9,23,6,380,388,768,387
0130-001,2013,9,23,7,1439,823,2262,768
0130-001,2013,9,23,8,2205,1834,4039,2262
0130-001,2013,9,23,9,2264,2094,4358,4039
0130-001,2013,9,23,10,1692,1778,3470,4358
0130-001,2013,9,23,11,1793,1728,3521,3470
0130-001,2013,9,23,12,1611,1630,3241,3521
0130-001,2013,9,23,13,1521,1434,2955,3241
0130-001,2013,9,23,14,1687,1689,3376,2955
0130-001,2013,9,23,15,1813,1753,3566,3376
0130-001,2013,9,23,16,1763,1812,3575,3566
0130-001,2013,9,23,17,1744,1896,3640,3575
0130-001,2013,9,23,18,1802,2203,4005,3640
0130-001,2013,9,23,19,1838,2508,4346,4005
0130-001,2013,9,23,20,1454,1899,3353,4346
0130-001,2013,9,23,21,1254,1620,2874,3353
0130-001,2013,9,23,22,1176,1263,2439,2874
0130-001,2013,9,23,23,824,775,1599,2439
0130-001,2013,9,23,24,574,464,1038,1599
0130-001,2013,9,24,1,350,302,652,1038
0130-001,2013,9,24,2,253,234,487,652
0130-001,2013,9,24,3,167,176,343,487
0130-001,2013,9,24,4,179,191,370,343
0130-001,2013,9,24,5,187,237,424,370
0130-001,2013,9,24,6,392,392,784,424
0130-001,2013,9,24,7,1282,798,2080,784
0130-001,2013,9,24,8,2215,1769,3984,2080
0130-001,2013,9,24,9,2165,2031,4196,3984
0130-001,2013,9,24,10,1729,1751,3480,4196
0130-001,2013,9,24,11,1686,1740,3426,3480
0130-001,2013,9,24,12,1582,1581,3163,3426
0130-001,2013,9,24,13,1395,1473,2868,3163
0130-001,2013,9,24,14,1635,1658,3293,2868
0130-001,2013,9,24,15,1730,1689,3419,3293
0130-001,2013,9,24,16,1750,1719,3469,3419
0130-001,2013,9,24,17,1654,1895,3549,3469
0130-001,2013,9,24,18,1698,2080,3778,3549
0130-001,2013,9,24,19,1718,2391,4109,3778
0130-001,2013,9,24,20,1349,1741,3090,4109
0130-001,2013,9,24,21,1195,1590,2785,3090
0130-001,2013,9,24,22,1152,1253,2405,2785
0130-001,2013,9,24,23,855,748,1603,2405
0130-001,2013,9,24,24,591,512,1103,1603
0130-001,2013,9,25,1,349,335,684,1103
0130-001,2013,9,25,2,253,227,480,684
0130-001,2013,9,25,3,183,197,380,480
0130-001,2013,9,25,4,181,175,356,380
0130-001,2013,9,25,5,198,211,409,356
0130-001,2013,9,25,6,396,379,775,409
0130-001,2013,9,25,7,1215,728,1943,775
0130-001,2013,9,25,8,2233,1758,3991,1943
0130-001,2013,9,25,9,2222,2073,4295,3991
0130-001,2013,9,25,10,1861,1775,3636,4295
0130-001,2013,9,25,11,1806,1740,3546,3636
0130-001,2013,9,25,12,1620,1599,3219,3546
0130-001,2013,9,25,13,1522,1486,3008,3219
0130-001,2013,9,25,14,1681,1677,3358,3008
0130-001,2013,9,25,15,1866,1898,3764,3358
0130-001,2013,9,25,16,1832,1852,3684,3764
0130-001,2013,9,25,17,1748,1943,3691,3684
0130-001,2013,9,25,18,1897,2352,4249,3691
0130-001,2013,9,25,19,1818,2581,4399,4249
0130-001,2013,9,25,20,1530,2073,3603,4399
0130-001,2013,9,25,21,1250,1575,2825,3603
0130-001,2013,9,25,22,1242,1210,2452,2825
0130-001,2013,9,25,23,996,832,1828,2452
0130-001,2013,9,25,24,614,506,1120,1828
0130-001,2013,9,26,1,405,390,795,1120
0130-001,2013,9,26,2,304,265,569,795
0130-001,2013,9,26,3,218,221,439,569
0130-001,2013,9,26,4,182,187,369,439
0130-001,2013,9,26,5,195,256,451,369
0130-001,2013,9,26,6,388,392,780,451
0130-001,2013,9,26,7,1317,797,2114,780
0130-001,2013,9,26,8,2169,1748,3917,2114
0130-001,2013,9,26,9,2179,2092,4271,3917
0130-001,2013,9,26,10,1863,1806,3669,4271
0130-001,2013,9,26,11,1849,1795,3644,3669
0130-001,2013,9,26,12,1672,1697,3369,3644
0130-001,2013,9,26,13,1458,1505,2963,3369
0130-001,2013,9,26,14,1752,1771,3523,2963
0130-001,2013,9,26,15,1885,1797,3682,3523
0130-001,2013,9,26,16,1914,1827,3741,3682
0130-001,2013,9,26,17,1741,1918,3659,3741
0130-001,2013,9,26,18,1790,2379,4169,3659
0130-001,2013,9,26,19,1843,2512,4355,4169
0130-001,2013,9,26,20,1399,2002,3401,4355
0130-001,2013,9,26,21,1259,1677,2936,3401
0130-001,2013,9,26,22,1150,1307,2457,2936
0130-001,2013,9,26,23,930,816,1746,2457
0130-001,2013,9,26,24,629,525,1154,1746
0130-001,2013,9,27,1,407,381,788,1154
0130-001,2013,9,27,2,259,258,517,788
0130-001,2013,9,27,3,211,208,419,517
0130-001,2013,9,27,4,174,203,377,419
0130-001,2013,9,27,5,218,236,454,377
0130-001,2013,9,27,6,400,412,812,454
0130-001,2013,9,27,7,1248,781,2029,812
0130-001,2013,9,27,8,2149,1730,3879,2029
0130-001,2013,9,27,9,2274,2049,4323,3879
0130-001,2013,9,27,10,1851,1762,3613,4323
0130-001,2013,9,27,11,1758,1776,3534,3613
0130-001,2013,9,27,12,1668,1671,3339,3534
0130-001,2013,9,27,13,1463,1475,2938,3339
0130-001,2013,9,27,14,1734,1736,3470,2938
0130-001,2013,9,27,15,1856,1823,3679,3470
0130-001,2013,9,27,16,1858,1906,3764,3679
0130-001,2013,9,27,17,1880,1944,3824,3764
0130-001,2013,9,27,18,1995,2462,4457,3824
0130-001,2013,9,27,19,1979,2523,4502,4457
0130-001,2013,9,27,20,1564,2344,3908,4502
0130-001,2013,9,27,21,1369,1700,3069,3908
0130-001,2013,9,27,22,1171,1286,2457,3069
0130-001,2013,9,27,23,973,908,1881,2457
0130-001,2013,9,27,24,681,602,1283,1881
0130-001,2013,9,28,1,511,468,979,1283
0130-001,2013,9,28,2,375,326,701,979
0130-001,2013,9,28,3,269,279,548,701
0130-001,2013,9,28,4,263,258,521,548
0130-001,2013,9,28,5,244,287,531,521
0130-001,2013,9,28,6,386,438,824,531
0130-001,2013,9,28,7,968,687,1655,824
0130-001,2013,9,28,8,1628,1221,2849,1655
0130-001,2013,9,28,9,1945,1842,3787,2849
0130-001,2013,9,28,10,1811,1898,3709,3787
0130-001,2013,9,28,11,1695,1836,3531,3709
0130-001,2013,9,28,12,1757,2035,3792,3531
0130-001,2013,9,28,13,1805,1926,3731,3792
0130-001,2013,9,28,14,1731,1868,3599,3731
0130-001,2013,9,28,15,1831,1839,3670,3599
0130-001,2013,9,28,16,1790,1870,3660,3670
0130-001,2013,9,28,17,1897,1841,3738,3660
0130-001,2013,9,28,18,1991,2239,4230,3738
0130-001,2013,9,28,19,1896,1904,3800,4230
0130-001,2013,9,28,20,1443,1485,2928,3800
0130-001,2013,9,28,21,1280,1149,2429,2928
0130-001,2013,9,28,22,1020,891,1911,2429
0130-001,2013,9,28,23,797,674,1471,1911
0130-001,2013,9,28,24,542,464,1006,1471
0130-001,2013,9,29,1,409,345,754,1006
0130-001,2013,9,29,2,283,272,555,754
0130-001,2013,9,29,3,230,212,442,555
0130-001,2013,9,29,4,217,179,396,442
0130-001,2013,9,29,5,202,179,381,396
0130-001,2013,9,29,6,252,266,518,381
0130-001,2013,9,29,7,444,356,800,518
0130-001,2013,9,29,8,631,547,1178,800
0130-001,2013,9,29,9,774,821,1595,1178
0130-001,2013,9,29,10,899,1002,1901,1595
0130-001,2013,9,29,11,1024,1202,2226,1901
0130-001,2013,9,29,12,1075,1307,2382,2226
0130-001,2013,9,29,13,1188,1395,2583,2382
0130-001,2013,9,29,14,1319,1413,2732,2583
0130-001,2013,9,29,15,1448,1461,2909,2732
0130-001,2013,9,29,16,1553,1440,2993,2909
0130-001,2013,9,29,17,1500,1521,3021,2993
0130-001,2013,9,29,18,1551,1448,2999,3021
0130-001,2013,9,29,19,1569,1236,2805,2999
0130-001,2013,9,29,20,1235,1072,2307,2805
0130-001,2013,9,29,21,1086,847,1933,2307
0130-001,2013,9,29,22,870,754,1624,1933
0130-001,2013,9,29,23,640,523,1163,1624
0130-001,2013,9,29,24,427,337,764,1163
0130-001,2013,9,30,1,280,235,515,764
0130-001,2013,9,30,2,186,176,362,515
0130-001,2013,9,30,3,148,126,274,362
0130-001,2013,9,30,4,136,145,281,274
0130-001,2013,9,30,5,168,211,379,281
0130-001,2013,9,30,6,380,392,772,379
0130-001,2013,9,30,7,1475,828,2303,772
0130-001,2013,9,30,8,2208,1869,4077,2303
0130-001,2013,9,30,9,2283,2074,4357,4077
0130-001,2013,9,30,10,1768,1750,3518,4357
0130-001,2013,9,30,11,1793,1725,3518,3518
0130-001,2013,9,30,12,1596,1645,3241,3518
0130-001,2013,9,30,13,1537,1464,3001,3241
0130-001,2013,9,30,14,1754,1699,3453,3001
0130-001,2013,9,30,15,1851,1825,3676,3453
0130-001,2013,9,30,16,1799,1866,3665,3676
0130-001,2013,9,30,17,1776,1950,3726,3665
0130-001,2013,9,30,18,1803,2235,4038,3726
0130-001,2013,9,30,19,1834,2491,4325,4038
0130-001,2013,9,30,20,1404,1882,3286,4325
0130-001,2013,9,30,21,1235,1641,2876,3286
0130-001,2013,9,30,22,1151,1293,2444,2876
0130-001,2013,9,30,23,807,758,1565,2444
0130-001,2013,9,30,24,553,460,1013,1565
0130-001,2013,10,1,1,369,340,709,1013
0130-001,2013,10,1,2,253,238,491,709
0130-001,2013,10,1,3,179,205,384,491
0130-001,2013,10,1,4,172,187,359,384
0130-001,2013,10,1,5,195,242,437,359
0130-001,2013,10,1,6,403,375,778,437
0130-001,2013,10,1,7,1258,781,2039,778
0130-001,2013,10,1,8,2176,1781,3957,2039
0130-001,2013,10,1,9,2199,2044,4243,3957
0130-001,2013,10,1,10,1746,1700,3446,4243
0130-001,2013,10,1,11,1842,1811,3653,3446
0130-001,2013,10,1,12,1662,1556,3218,3653
0130-001,2013,10,1,13,1453,1521,2974,3218
0130-001,2013,10,1,14,1709,1702,3411,2974
0130-001,2013,10,1,15,1763,1810,3573,3411
0130-001,2013,10,1,16,1799,1777,3576,3573
0130-001,2013,10,1,17,1646,1798,3444,3576
0130-001,2013,10,1,18,1752,2347,4099,3444
0130-001,2013,10,1,19,1757,2455,4212,4099
0130-001,2013,10,1,20,1437,1937,3374,4212
0130-001,2013,10,1,21,1215,1637,2852,3374
0130-001,2013,10,1,22,1135,1248,2383,2852
0130-001,2013,10,1,23,913,805,1718,2383
0130-001,2013,10,1,24,641,498,1139,1718
0130-001,2013,10,2,1,381,307,688,1139
0130-001,2013,10,2,2,246,249,495,688
0130-001,2013,10,2,3,197,187,384,495
0130-001,2013,10,2,4,169,194,363,384
0130-001,2013,10,2,5,176,225,401,363
0130-001,2013,10,2,6,359,382,741,401
0130-001,2013,10,2,7,1256,745,2001,741
0130-001,2013,10,2,8,2247,1800,4047,2001
0130-001,2013,10,2,9,2165,2015,4180,4047
0130-001,2013,10,2,10,1854,1792,3646,4180
0130-001,2013,10,2,11,1902,1659,3561,3646
0130-001,2013,10,2,12,1577,1638,3215,3561
0130-001,2013,10,2,13,1460,1480,2940,3215
0130-001,2013,10,2,14,1721,1674,3395,2940
0130-001,2013,10,2,15,1798,1836,3634,3395
0130-001,2013,10,2,16,1905,1828,3733,3634
0130-001,2013,10,2,17,1852,1917,3769,3733
0130-001,2013,10,2,18,1785,2340,4125,3769
0130-001,2013,10,2,19,2057,2611,4668,4125
0130-001,2013,10,2,20,1684,2340,4024,4668
0130-001,2013,10,2,21,1425,1675,3100,4024
0130-001,2013,10,2,22,1271,1330,2601,3100
0130-001,2013,10,2,23,928,867,1795,2601
0130-001,2013,10,2,24,610,563,1173,1795
0130-001,2013,10,3,1,520,451,971,1173
0130-001,2013,10,3,2,379,281,660,971
0130-001,2013,10,3,3,271,240,511,660
0130-001,2013,10,3,4,244,232,476,511
0130-001,2013,10,3,5,248,235,483,476
0130-001,2013,10,3,6,382,399,781,483
0130-001,2013,10,3,7,943,608,1551,781
0130-001,2013,10,3,8,1644,1098,2742,1551
0130-001,2013,10,3,9,1413,1341,2754,2742
0130-001,2013,10,3,10,1430,1427,2857,2754
0130-001,2013,10,3,11,1502,1734,3236,2857
0130-001,2013,10,3,12,1380,1894,3274,3236
0130-001,2013,10,3,13,1245,1672,2917,3274
0130-001,2013,10,3,14,1385,1625,3010,2917
0130-001,2013,10,3,15,1551,1525,3076,3010
0130-001,2013,10,3,16,1578,1454,3032,3076
0130-001,2013,10,3,17,1618,1627,3245,3032
0130-001,2013,10,3,18,1777,2068,3845,3245
0130-001,2013,10,3,19,1827,1926,3753,3845
0130-001,2013,10,3,20,1468,1429,2897,3753
0130-001,2013,10,3,21,1179,1046,2225,2897
0130-001,2013,10,3,22,1004,908,1912,2225
0130-001,2013,10,3,23,671,540,1211,1912
0130-001,2013,10,3,24,481,374,855,1211
0130-001,2013,10,4,1,289,268,557,855
0130-001,2013,10,4,2,188,195,383,557
0130-001,2013,10,4,3,158,165,323,383
0130-001,2013,10,4,4,144,157,301,323
0130-001,2013,10,4,5,165,205,370,301
0130-001,2013,10,4,6,363,327,690,370
0130-001,2013,10,4,7,1296,797,2093,690
0130-001,2013,10,4,8,2191,1737,3928,2093
0130-001,2013,10,4,9,2112,2069,4181,3928
0130-001,2013,10,4,10,1777,1724,3501,4181
0130-001,2013,10,4,11,1843,1799,3642,3501
0130-001,2013,10,4,12,1703,1737,3440,3642
0130-001,2013,10,4,13,1537,1653,3190,3440
0130-001,2013,10,4,14,1725,1863,3588,3190
0130-001,2013,10,4,15,1979,1860,3839,3588
0130-001,2013,10,4,16,1789,1984,3773,3839
0130-001,2013,10,4,17,1933,2046,3979,3773
0130-001,2013,10,4,18,1894,2375,4269,3979
0130-001,2013,10,4,19,1869,2358,4227,4269
0130-001,2013,10,4,20,1541,2198,3739,4227
0130-001,2013,10,4,21,1298,1564,2862,3739
0130-001,2013,10,4,22,1277,1330,2607,2862
0130-001,2013,10,4,23,985,925,1910,2607
0130-001,2013,10,4,24,691,551,1242,1910
0130-001,2013,10,5,1,465,433,898,1242
0130-001,2013,10,5,2,361,312,673,898
0130-001,2013,10,5,3,248,245,493,673
0130-001,2013,10,5,4,225,214,439,493
0130-001,2013,10,5,5,231,239,470,439
0130-001,2013,10,5,6,379,385,764,470
0130-001,2013,10,5,7,896,667,1563,764
0130-001,2013,10,5,8,1589,1193,2782,1563
0130-001,2013,10,5,9,1640,1771,3411,2782
0130-001,2013,10,5,10,1704,1905,3609,3411
0130-001,2013,10,5,11,1769,1973,3742,3609
0130-001,2013,10,5,12,1752,2241,3993,3742
0130-001,2013,10,5,13,1874,2475,4349,3993
0130-001,2013,10,5,14,2004,1980,3984,4349
0130-001,2013,10,5,15,1991,1784,3775,3984
0130-001,2013,10,5,16,1930,1715,3645,3775
0130-001,2013,10,5,17,1926,1941,3867,3645
0130-001,2013,10,5,18,2013,2142,4155,3867
0130-001,2013,10,5,19,1927,1945,3872,4155
0130-001,2013,10,5,20,1500,1426,2926,3872
0130-001,2013,10,5,21,1326,1120,2446,2926
0130-001,2013,10,5,22,1222,1033,2255,2446
0130-001,2013,10,5,23,864,715,1579,2255
0130-001,2013,10,5,24,561,503,1064,1579
0130-001,2013,10,6,1,442,394,836,1064
0130-001,2013,10,6,2,337,260,597,836
0130-001,2013,10,6,3,241,226,467,597
0130-001,2013,10,6,4,204,173,377,467
0130-001,2013,10,6,5,190,163,353,377
0130-001,2013,10,6,6,291,263,554,353
0130-001,2013,10,6,7,588,505,1093,554
0130-001,2013,10,6,8,832,799,1631,1093
0130-001,2013,10,6,9,1031,1165,2196,1631
0130-001,2013,10,6,10,1053,1163,2216,2196
0130-001,2013,10,6,11,1112,1318,2430,2216
0130-001,2013,10,6,12,1314,1397,2711,2430
0130-001,2013,10,6,13,1516,1356,2872,2711
0130-001,2013,10,6,14,1475,1415,2890,2872
0130-001,2013,10,6,15,1601,1491,3092,2890
0130-001,2013,10,6,16,1785,1446,3231,3092
0130-001,2013,10,6,17,1862,1632,3494,3231
0130-001,2013,10,6,18,1969,1767,3736,3494
0130-001,2013,10,6,19,1906,1519,3425,3736
0130-001,2013,10,6,20,1663,1217,2880,3425
0130-001,2013,10,6,21,1332,964,2296,2880
0130-001,2013,10,6,22,1094,761,1855,2296
0130-001,2013,10,6,23,725,536,1261,1855
0130-001,2013,10,6,24,499,326,825,1261
0130-001,2013,10,7,1,268,241,509,825
0130-001,2013,10,7,2,184,169,353,509
0130-001,2013,10,7,3,152,133,285,353
0130-001,2013,10,7,4,117,136,253,285
0130-001,2013,10,7,5,155,215,370,253
0130-001,2013,10,7,6,379,396,775,370
0130-001,2013,10,7,7,1510,832,2342,775
0130-001,2013,10,7,8,2211,1904,4115,2342
0130-001,2013,10,7,9,2301,2054,4355,4115
0130-001,2013,10,7,10,1844,1721,3565,4355
0130-001,2013,10,7,11,1793,1721,3514,3565
0130-001,2013,10,7,12,1580,1659,3239,3514
0130-001,2013,10,7,13,1553,1494,3047,3239
0130-001,2013,10,7,14,1820,1708,3528,3047
0130-001,2013,10,7,15,1888,1897,3785,3528
0130-001,2013,10,7,16,1834,1920,3754,3785
0130-001,2013,10,7,17,1808,2004,3812,3754
0130-001,2013,10,7,18,1804,2266,4070,3812
0130-001,2013,10,7,19,1829,2473,4302,4070
0130-001,2013,10,7,20,1353,1864,3217,4302
0130-001,2013,10,7,21,1216,1662,2878,3217
0130-001,2013,10,7,22,1125,1323,2448,2878
0130-001,2013,10,7,23,789,741,1530,2448
0130-001,2013,10,7,24,532,455,987,1530
0130-001,2013,10,8,1,366,298,664,987
0130-001,2013,10,8,2,247,202,449,664
0130-001,2013,10,8,3,179,182,361,449
0130-001,2013,10,8,4,168,199,367,361
0130-001,2013,10,8,5,171,207,378,367
0130-001,2013,10,8,6,332,340,672,378
0130-001,2013,10,8,7,1117,674,1791,672
0130-001,2013,10,8,8,2087,1694,3781,1791
0130-001,2013,10,8,9,2138,2059,4197,3781
0130-001,2013,10,8,10,2027,1678,3705,4197
0130-001,2013,10,8,11,1692,1811,3503,3705
0130-001,2013,10,8,12,1644,1635,3279,3503
0130-001,2013,10,8,13,1477,1582,3059,3279
0130-001,2013,10,8,14,1744,1820,3564,3059
0130-001,2013,10,8,15,1846,1760,3606,3564
0130-001,2013,10,8,16,1768,1826,3594,3606
0130-001,2013,10,8,17,1640,1843,3483,3594
0130-001,2013,10,8,18,1804,2281,4085,3483
0130-001,2013,10,8,19,1777,2482,4259,4085
0130-001,2013,10,8,20,1376,1893,3269,4259
0130-001,2013,10,8,21,1249,1571,2820,3269
0130-001,2013,10,8,22,1173,1310,2483,2820
0130-001,2013,10,8,23,855,818,1673,2483
0130-001,2013,10,8,24,621,540,1161,1673
0130-001,2013,10,9,1,445,417,862,1161
0130-001,2013,10,9,2,328,284,612,862
0130-001,2013,10,9,3,286,245,531,612
0130-001,2013,10,9,4,195,207,402,531
0130-001,2013,10,9,5,215,231,446,402
0130-001,2013,10,9,6,386,348,734,446
0130-001,2013,10,9,7,870,596,1466,734
0130-001,2013,10,9,8,1576,1050,2626,1466
0130-001,2013,10,9,9,1398,1377,2775,2626
0130-001,2013,10,9,10,1461,1317,2778,2775
0130-001,2013,10,9,11,1423,1527,2950,2778
0130-001,2013,10,9,12,1379,1740,3119,2950
0130-001,2013,10,9,13,1469,1602,3071,3119
0130-001,2013,10,9,14,1440,1643,3083,3071
0130-001,2013,10,9,15,1573,1534,3107,3083
0130-001,2013,10,9,16,1450,1616,3066,3107
0130-001,2013,10,9,17,1612,1633,3245,3066
0130-001,2013,10,9,18,1821,2014,3835,3245
0130-001,2013,10,9,19,1724,1864,3588,3835
0130-001,2013,10,9,20,1283,1409,2692,3588
0130-001,2013,10,9,21,1133,985,2118,2692
0130-001,2013,10,9,22,977,945,1922,2118
0130-001,2013,10,9,23,710,576,1286,1922
0130-001,2013,10,9,24,479,390,869,1286
0130-001,2013,10,10,1,310,304,614,869
0130-001,2013,10,10,2,224,206,430,614
0130-001,2013,10,10,3,176,162,338,430
0130-001,2013,10,10,4,122,147,269,338
0130-001,2013,10,10,5,160,214,374,269
0130-001,2013,10,10,6,377,349,726,374
0130-001,2013,10,10,7,1331,812,2143,726
0130-001,2013,10,10,8,2218,1867,4085,2143
0130-001,2013,10,10,9,2270,2106,4376,4085
0130-001,2013,10,10,10,1969,1685,3654,4376
0130-001,2013,10,10,11,1807,1785,3592,3654
0130-001,2013,10,10,12,1684,1654,3338,3592
0130-001,2013,10,10,13,1512,1532,3044,3338
0130-001,2013,10,10,14,1728,1743,3471,3044
0130-001,2013,10,10,15,1926,1804,3730,3471
0130-001,2013,10,10,16,1765,1919,3684,3730
0130-001,2013,10,10,17,1789,1951,3740,3684
0130-001,2013,10,10,18,1852,2320,4172,3740
0130-001,2013,10,10,19,1779,2473,4252,4172
0130-001,2013,10,10,20,1467,1958,3425,4252
0130-001,2013,10,10,21,1294,1638,2932,3425
0130-001,2013,10,10,22,1157,1357,2514,2932
0130-001,2013,10,10,23,899,852,1751,2514
0130-001,2013,10,10,24,573,523,1096,1751
0130-001,2013,10,11,1,418,370,788,1096
0130-001,2013,10,11,2,247,237,484,788
0130-001,2013,10,11,3,228,181,409,484
0130-001,2013,10,11,4,191,187,378,409
0130-001,2013,10,11,5,212,258,470,378
0130-001,2013,10,11,6,400,393,793,470
0130-001,2013,10,11,7,1316,757,2073,793
0130-001,2013,10,11,8,2189,1765,3954,2073
0130-001,2013,10,11,9,2233,2171,4404,3954
0130-001,2013,10,11,10,2102,1740,3842,4404
0130-001,2013,10,11,11,1790,1948,3738,3842
0130-001,2013,10,11,12,1639,1791,3430,3738
0130-001,2013,10,11,13,1496,1605,3101,3430
0130-001,2013,10,11,14,1796,1901,3697,3101
0130-001,2013,10,11,15,1917,1931,3848,3697
0130-001,2013,10,11,16,1879,1965,3844,3848
0130-001,2013,10,11,17,1824,2031,3855,3844
0130-001,2013,10,11,18,1929,2398,4327,3855
0130-001,2013,10,11,19,1937,2567,4504,4327
0130-001,2013,10,11,20,1582,2176,3758,4504
0130-001,2013,10,11,21,1336,1704,3040,3758
0130-001,2013,10,11,22,1201,1319,2520,3040
0130-001,2013,10,11,23,962,842,1804,2520
0130-001,2013,10,11,24,659,572,1231,1804
0130-001,2013,10,12,1,458,424,882,1231
0130-001,2013,10,12,2,335,301,636,882
0130-001,2013,10,12,3,256,228,484,636
0130-001,2013,10,12,4,220,232,452,484
0130-001,2013,10,12,5,255,270,525,452
0130-001,2013,10,12,6,414,392,806,525
0130-001,2013,10,12,7,962,710,1672,806
0130-001,2013,10,12,8,1690,1233,2923,1672
0130-001,2013,10,12,9,1707,1832,3539,2923
0130-001,2013,10,12,10,1912,1884,3796,3539
0130-001,2013,10,12,11,1769,2166,3935,3796
0130-001,2013,10,12,12,1792,2291,4083,3935
0130-001,2013,10,12,13,1883,2369,4252,4083
0130-001,2013,10,12,14,1943,2096,4039,4252
0130-001,2013,10,12,15,1907,1914,3821,4039
0130-001,2013,10,12,16,1907,1964,3871,3821
0130-001,2013,10,12,17,2057,1929,3986,3871
0130-001,2013,10,12,18,2011,2179,4190,3986
0130-001,2013,10,12,19,1983,2129,4112,4190
0130-001,2013,10,12,20,1594,1383,2977,4112
0130-001,2013,10,12,21,1292,1122,2414,2977
0130-001,2013,10,12,22,1057,985,2042,2414
0130-001,2013,10,12,23,788,704,1492,2042
0130-001,2013,10,12,24,568,536,1104,1492
0130-001,2013,10,13,1,375,372,747,1104
0130-001,2013,10,13,2,362,263,625,747
0130-001,2013,10,13,3,238,179,417,625
0130-001,2013,10,13,4,194,165,359,417
0130-001,2013,10,13,5,190,190,380,359
0130-001,2013,10,13,6,293,298,591,380
0130-001,2013,10,13,7,571,500,1071,591
0130-001,2013,10,13,8,799,666,1465,1071
0130-001,2013,10,13,9,944,997,1941,1465
0130-001,2013,10,13,10,1074,1168,2242,1941
0130-001,2013,10,13,11,1184,1397,2581,2242
0130-001,2013,10,13,12,1137,1384,2521,2581
0130-001,2013,10,13,13,1386,1349,2735,2521
0130-001,2013,10,13,14,1542,1440,2982,2735
0130-001,2013,10,13,15,1627,1381,3008,2982
0130-001,2013,10,13,16,1794,1493,3287,3008
0130-001,2013,10,13,17,1876,1622,3498,3287
0130-001,2013,10,13,18,2033,1693,3726,3498
0130-001,2013,10,13,19,1878,1529,3407,3726
0130-001,2013,10,13,20,1573,1285,2858,3407
0130-001,2013,10,13,21,1461,1045,2506,2858
0130-001,2013,10,13,22,1149,880,2029,2506
0130-001,2013,10,13,23,735,539,1274,2029
0130-001,2013,10,13,24,427,370,797,1274
0130-001,2013,10,14,1,300,236,536,797
0130-001,2013,10,14,2,174,152,326,536
0130-001,2013,10,14,3,123,131,254,326
0130-001,2013,10,14,4,107,141,248,254
0130-001,2013,10,14,5,174,222,396,248
0130-001,2013,10,14,6,413,405,818,396
0130-001,2013,10,14,7,1450,855,2305,818
0130-001,2013,10,14,8,2205,1870,4075,2305
0130-001,2013,10,14,9,2272,2088,4360,4075
0130-001,2013,10,14,10,1855,1666,3521,4360
0130-001,2013,10,14,11,1823,1798,3621,3521
0130-001,2013,10,14,12,1684,1759,3443,3621
0130-001,2013,10,14,13,1564,1561,3125,3443
0130-001,2013,10,14,14,1719,1767,3486,3125
0130-001,2013,10,14,15,1887,1923,3810,3486
0130-001,2013,10,14,16,1783,1826,3609,3810
0130-001,2013,10,14,17,1795,1924,3719,3609
0130-001,2013,10,14,18,1794,2348,4142,3719
0130-001,2013,10,14,19,1872,2455,4327,4142
0130-001,2013,10,14,20,1357,1830,3187,4327
0130-001,2013,10,14,21,1202,1648,2850,3187
0130-001,2013,10,14,22,1123,1267,2390,2850
0130-001,2013,10,14,23,785,794,1579,2390
0130-001,2013,10,14,24,542,486,1028,1579
0130-001,2013,10,15,1,331,318,649,1028
0130-001,2013,10,15,2,211,192,403,649
0130-001,2013,10,15,3,175,159,334,403
0130-001,2013,10,15,4,179,159,338,334
0130-001,2013,10,15,5,166,221,387,338
0130-001,2013,10,15,6,382,393,775,387
0130-001,2013,10,15,7,1316,802,2118,775
0130-001,2013,10,15,8,2180,1756,3936,2118
0130-001,2013,10,15,9,2199,2084,4283,3936
0130-001,2013,10,15,10,1792,1733,3525,4283
0130-001,2013,10,15,11,1820,1726,3546,3525
0130-001,2013,10,15,12,1718,1674,3392,3546
0130-001,2013,10,15,13,1545,1528,3073,3392
0130-001,2013,10,15,14,1728,1861,3589,3073
0130-001,2013,10,15,15,1844,1906,3750,3589
0130-001,2013,10,15,16,1803,1910,3713,3750
0130-001,2013,10,15,17,1728,1945,3673,3713
0130-001,2013,10,15,18,1773,2377,4150,3673
0130-001,2013,10,15,19,1734,2566,4300,4150
0130-001,2013,10,15,20,1303,1787,3090,4300
0130-001,2013,10,15,21,1139,1427,2566,3090
0130-001,2013,10,15,22,1001,1200,2201,2566
0130-001,2013,10,15,23,1242,753,1995,2201
0130-001,2013,10,15,24,603,444,1047,1995
0130-001,2013,10,16,1,374,362,736,1047
0130-001,2013,10,16,2,248,196,444,736
0130-001,2013,10,16,3,165,181,346,444
0130-001,2013,10,16,4,143,141,284,346
0130-001,2013,10,16,5,166,217,383,284
0130-001,2013,10,16,6,367,362,729,383
0130-001,2013,10,16,7,1264,761,2025,729
0130-001,2013,10,16,8,2173,1817,3990,2025
0130-001,2013,10,16,9,2202,2084,4286,3990
0130-001,2013,10,16,10,1917,1720,3637,4286
0130-001,2013,10,16,11,1824,1718,3542,3637
0130-001,2013,10,16,12,1650,1608,3258,3542
0130-001,2013,10,16,13,1484,1416,2900,3258
0130-001,2013,10,16,14,1717,1749,3466,2900
0130-001,2013,10,16,15,1815,1875,3690,3466
0130-001,2013,10,16,16,1826,1891,3717,3690
0130-001,2013,10,16,17,1797,1950,3747,3717
0130-001,2013,10,16,18,1907,2374,4281,3747
0130-001,2013,10,16,19,1821,2543,4364,4281
0130-001,2013,10,16,20,1443,2000,3443,4364
0130-001,2013,10,16,21,1262,1538,2800,3443
0130-001,2013,10,16,22,1198,1286,2484,2800
0130-001,2013,10,16,23,865,775,1640,2484
0130-001,2013,10,16,24,541,471,1012,1640
0130-001,2013,10,17,1,360,341,701,1012
0130-001,2013,10,17,2,265,257,522,701
0130-001,2013,10,17,3,189,190,379,522
0130-001,2013,10,17,4,166,163,329,379
0130-001,2013,10,17,5,192,218,410,329
0130-001,2013,10,17,6,381,391,772,410
0130-001,2013,10,17,7,1305,743,2048,772
0130-001,2013,10,17,8,2180,1771,3951,2048
0130-001,2013,10,17,9,1981,2098,4079,3951
0130-001,2013,10,17,10,1991,1706,3697,4079
0130-001,2013,10,17,11,1771,1780,3551,3697
0130-001,2013,10,17,12,1660,1666,3326,3551
0130-001,2013,10,17,13,1545,1501,3046,3326
0130-001,2013,10,17,14,1676,1708,3384,3046
0130-001,2013,10,17,15,1822,1810,3632,3384
0130-001,2013,10,17,16,1724,1865,3589,3632
0130-001,2013,10,17,17,1776,1919,3695,3589
0130-001,2013,10,17,18,1877,2294,4171,3695
0130-001,2013,10,17,19,1826,2461,4287,4171
0130-001,2013,10,17,20,1373,1780,3153,4287
0130-001,2013,10,17,21,1197,1593,2790,3153
0130-001,2013,10,17,22,1209,1299,2508,2790
0130-001,2013,10,17,23,836,840,1676,2508
0130-001,2013,10,17,24,565,495,1060,1676
0130-001,2013,10,18,1,388,358,746,1060
0130-001,2013,10,18,2,251,229,480,746
0130-001,2013,10,18,3,183,171,354,480
0130-001,2013,10,18,4,148,167,315,354
0130-001,2013,10,18,5,157,219,376,315
0130-001,2013,10,18,6,376,391,767,376
0130-001,2013,10,18,7,1318,773,2091,767
0130-001,2013,10,18,8,2156,1783,3939,2091
0130-001,2013,10,18,9,2218,2049,4267,3939
0130-001,2013,10,18,10,1812,1730,3542,4267
0130-001,2013,10,18,11,1784,1761,3545,3542
0130-001,2013,10,18,12,1684,1680,3364,3545
0130-001,2013,10,18,13,1715,1583,3298,3364
0130-001,2013,10,18,14,1785,1842,3627,3298
0130-001,2013,10,18,15,1948,1902,3850,3627
0130-001,2013,10,18,16,1849,1932,3781,3850
0130-001,2013,10,18,17,1740,2015,3755,3781
0130-001,2013,10,18,18,1912,2572,4484,3755
0130-001,2013,10,18,19,2026,2636,4662,4484
0130-001,2013,10,18,20,1556,2109,3665,4662
0130-001,2013,10,18,21,1300,1611,2911,3665
0130-001,2013,10,18,22,1201,1328,2529,2911
0130-001,2013,10,18,23,930,822,1752,2529
0130-001,2013,10,18,24,648,559,1207,1752
0130-001,2013,10,19,1,503,460,963,1207
0130-001,2013,10,19,2,352,309,661,963
0130-001,2013,10,19,3,246,244,490,661
0130-001,2013,10,19,4,262,218,480,490
0130-001,2013,10,19,5,233,274,507,480
0130-001,2013,10,19,6,392,440,832,507
0130-001,2013,10,19,7,937,680,1617,832
0130-001,2013,10,19,8,1622,1208,2830,1617
0130-001,2013,10,19,9,1803,1742,3545,2830
0130-001,2013,10,19,10,1826,1895,3721,3545
0130-001,2013,10,19,11,1789,1948,3737,3721
0130-001,2013,10,19,12,1658,1979,3637,3737
0130-001,2013,10,19,13,1693,2355,4048,3637
0130-001,2013,10,19,14,1881,2163,4044,4048
0130-001,2013,10,19,15,1798,1926,3724,4044
0130-001,2013,10,19,16,1966,1948,3914,3724
0130-001,2013,10,19,17,1904,1945,3849,3914
0130-001,2013,10,19,18,1918,2272,4190,3849
0130-001,2013,10,19,19,1904,2103,4007,4190
0130-001,2013,10,19,20,1735,1413,3148,4007
0130-001,2013,10,19,21,1299,1175,2474,3148
0130-001,2013,10,19,22,1097,984,2081,2474
0130-001,2013,10,19,23,816,638,1454,2081
0130-001,2013,10,19,24,529,496,1025,1454
0130-001,2013,10,20,1,401,338,739,1025
0130-001,2013,10,20,2,303,267,570,739
0130-001,2013,10,20,3,230,205,435,570
0130-001,2013,10,20,4,221,182,403,435
0130-001,2013,10,20,5,175,163,338,403
0130-001,2013,10,20,6,293,297,590,338
0130-001,2013,10,20,7,515,431,946,590
0130-001,2013,10,20,8,773,706,1479,946
0130-001,2013,10,20,9,966,1007,1973,1479
0130-001,2013,10,20,10,1025,1108,2133,1973
0130-001,2013,10,20,11,1208,1257,2465,2133
0130-001,2013,10,20,12,1245,1356,2601,2465
0130-001,2013,10,20,13,1270,1358,2628,2601
0130-001,2013,10,20,14,1488,1479,2967,2628
0130-001,2013,10,20,15,1745,1511,3256,2967
0130-001,2013,10,20,16,1833,1721,3554,3256
0130-001,2013,10,20,17,1938,1657,3595,3554
0130-001,2013,10,20,18,2001,1821,3822,3595
0130-001,2013,10,20,19,1900,1619,3519,3822
0130-001,2013,10,20,20,1807,1215,3022,3519
0130-001,2013,10,20,21,1671,991,2662,3022
0130-001,2013,10,20,22,1380,901,2281,2662
0130-001,2013,10,20,23,793,531,1324,2281
0130-001,2013,10,20,24,515,368,883,1324
0130-001,2013,10,21,1,266,224,490,883
0130-001,2013,10,21,2,188,167,355,490
0130-001,2013,10,21,3,133,145,278,355
0130-001,2013,10,21,4,118,141,259,278
0130-001,2013,10,21,5,169,207,376,259
0130-001,2013,10,21,6,415,398,813,376
0130-001,2013,10,21,7,1419,825,2244,813
0130-001,2013,10,21,8,2052,1800,3852,2244
0130-001,2013,10,21,9,2288,2057,4345,3852
0130-001,2013,10,21,10,1712,1657,3369,4345
0130-001,2013,10,21,11,1878,1747,3625,3369
0130-001,2013,10,21,12,1649,1671,3320,3625
0130-001,2013,10,21,13,1499,1501,3000,3320
0130-001,2013,10,21,14,1819,1769,3588,3000
0130-001,2013,10,21,15,1801,1819,3620,3588
0130-001,2013,10,21,16,1813,1868,3681,3620
0130-001,2013,10,21,17,1806,1920,3726,3681
0130-001,2013,10,21,18,1829,2366,4195,3726
0130-001,2013,10,21,19,1768,2444,4212,4195
0130-001,2013,10,21,20,1423,1936,3359,4212
0130-001,2013,10,21,21,1221,1680,2901,3359
0130-001,2013,10,21,22,1059,1226,2285,2901
0130-001,2013,10,21,23,830,785,1615,2285
0130-001,2013,10,21,24,489,463,952,1615
0130-001,2013,10,22,1,367,338,705,952
0130-001,2013,10,22,2,203,212,415,705
0130-001,2013,10,22,3,176,147,323,415
0130-001,2013,10,22,4,160,180,340,323
0130-001,2013,10,22,5,173,223,396,340
0130-001,2013,10,22,6,402,403,805,396
0130-001,2013,10,22,7,1317,792,2109,805
0130-001,2013,10,22,8,2149,1829,3978,2109
0130-001,2013,10,22,9,2195,2122,4317,3978
0130-001,2013,10,22,10,1893,1726,3619,4317
0130-001,2013,10,22,11,1816,1783,3599,3619
0130-001,2013,10,22,12,1714,1682,3396,3599
0130-001,2013,10,22,13,1458,1577,3035,3396
0130-001,2013,10,22,14,1776,1739,3515,3035
0130-001,2013,10,22,15,1835,1830,3665,3515
0130-001,2013,10,22,16,1850,1879,3729,3665
0130-001,2013,10,22,17,1769,1959,3728,3729
0130-001,2013,10,22,18,1814,2383,4197,3728
0130-001,2013,10,22,19,1821,2466,4287,4197
0130-001,2013,10,22,20,1425,1874,3299,4287
0130-001,2013,10,22,21,1266,1684,2950,3299
0130-001,2013,10,22,22,1170,1311,2481,2950
0130-001,2013,10,22,23,908,794,1702,2481
0130-001,2013,10,22,24,557,505,1062,1702
0130-001,2013,10,23,1,342,344,686,1062
0130-001,2013,10,23,2,298,245,543,686
0130-001,2013,10,23,3,186,198,384,543
0130-001,2013,10,23,4,160,165,325,384
0130-001,2013,10,23,5,181,245,426,325
0130-001,2013,10,23,6,388,401,789,426
0130-001,2013,10,23,7,1345,719,2064,789
0130-001,2013,10,23,8,2144,1817,3961,2064
0130-001,2013,10,23,9,2184,2129,4313,3961
0130-001,2013,10,23,10,1903,1775,3678,4313
0130-001,2013,10,23,11,1783,1717,3500,3678
0130-001,2013,10,23,12,1586,1647,3233,3500
0130-001,2013,10,23,13,1401,1509,2910,3233
0130-001,2013,10,23,14,1740,1741,3481,2910
0130-001,2013,10,23,15,1873,1817,3690,3481
0130-001,2013,10,23,16,1761,1855,3616,3690
0130-001,2013,10,23,17,1792,1902,3694,3616
0130-001,2013,10,23,18,1849,2396,4245,3694
0130-001,2013,10,23,19,1896,2608,4504,4245
0130-001,2013,10,23,20,1429,1941,3370,4504
0130-001,2013,10,23,21,1214,1551,2765,3370
0130-001,2013,10,23,22,1154,1228,2382,2765
0130-001,2013,10,23,23,931,819,1750,2382
0130-001,2013,10,23,24,593,538,1131,1750
0130-001,2013,10,24,1,382,330,712,1131
0130-001,2013,10,24,2,257,225,482,712
0130-001,2013,10,24,3,186,198,384,482
0130-001,2013,10,24,4,170,189,359,384
0130-001,2013,10,24,5,185,216,401,359
0130-001,2013,10,24,6,356,399,755,401
0130-001,2013,10,24,7,1281,749,2030,755
0130-001,2013,10,24,8,2097,1810,3907,2030
0130-001,2013,10,24,9,2245,2062,4307,3907
0130-001,2013,10,24,10,1794,1685,3479,4307
0130-001,2013,10,24,11,1863,1776,3639,3479
0130-001,2013,10,24,12,1640,1682,3322,3639
0130-001,2013,10,24,13,1462,1489,2951,3322
0130-001,2013,10,24,14,1779,1735,3514,2951
0130-001,2013,10,24,15,1894,1874,3768,3514
0130-001,2013,10,24,16,1832,1881,3713,3768
0130-001,2013,10,24,17,1733,1946,3679,3713
0130-001,2013,10,24,18,1800,2373,4173,3679
0130-001,2013,10,24,19,1741,2500,4241,4173
0130-001,2013,10,24,20,1418,1902,3320,4241
0130-001,2013,10,24,21,1255,1583,2838,3320
0130-001,2013,10,24,22,1177,1286,2463,2838
0130-001,2013,10,24,23,908,785,1693,2463
0130-001,2013,10,24,24,560,507,1067,1693
0130-001,2013,10,25,1,403,366,769,1067
0130-001,2013,10,25,2,238,261,499,769
0130-001,2013,10,25,3,204,181,385,499
0130-001,2013,10,25,4,149,169,318,385
0130-001,2013,10,25,5,182,247,429,318
0130-001,2013,10,25,6,391,386,777,429
0130-001,2013,10,25,7,1216,727,1943,777
0130-001,2013,10,25,8,2159,1793,3952,1943
0130-001,2013,10,25,9,2179,2094,4273,3952
0130-001,2013,10,25,10,1852,1774,3626,4273
0130-001,2013,10,25,11,1830,1980,3810,3626
0130-001,2013,10,25,12,1884,1788,3672,3810
0130-001,2013,10,25,13,1681,1673,3354,3672
0130-001,2013,10,25,14,1846,1920,3766,3354
0130-001,2013,10,25,15,1926,1941,3867,3766
0130-001,2013,10,25,16,1827,2079,3906,3867
0130-001,2013,10,25,17,1993,2097,4090,3906
0130-001,2013,10,25,18,1973,2437,4410,4090
0130-001,2013,10,25,19,1977,2568,4545,4410
0130-001,2013,10,25,20,1594,2118,3712,4545
0130-001,2013,10,25,21,1422,1675,3097,3712
0130-001,2013,10,25,22,1293,1317,2610,3097
0130-001,2013,10,25,23,941,869,1810,2610
0130-001,2013,10,25,24,663,629,1292,1810
0130-001,2013,10,26,1,477,426,903,1292
0130-001,2013,10,26,2,333,319,652,903
0130-001,2013,10,26,3,269,252,521,652
0130-001,2013,10,26,4,219,217,436,521
0130-001,2013,10,26,5,255,283,538,436
0130-001,2013,10,26,6,396,395,791,538
0130-001,2013,10,26,7,930,674,1604,791
0130-001,2013,10,26,8,1607,1172,2779,1604
0130-001,2013,10,26,9,1725,1779,3504,2779
0130-001,2013,10,26,10,1870,1945,3815,3504
0130-001,2013,10,26,11,1657,2258,3915,3815
0130-001,2013,10,26,12,1925,2436,4361,3915
0130-001,2013,10,26,13,1926,2394,4320,4361
0130-001,2013,10,26,14,1924,2218,4142,4320
0130-001,2013,10,26,15,1930,1888,3818,4142
0130-001,2013,10,26,16,1963,1917,3880,3818
0130-001,2013,10,26,17,1883,2103,3986,3880
0130-001,2013,10,26,18,2015,2341,4356,3986
0130-001,2013,10,26,19,1970,2113,4083,4356
0130-001,2013,10,26,20,1554,1390,2944,4083
0130-001,2013,10,26,21,1247,1143,2390,2944
0130-001,2013,10,26,22,1018,1019,2037,2390
0130-001,2013,10,26,23,828,693,1521,2037
0130-001,2013,10,26,24,567,481,1048,1521
0130-001,2013,10,27,1,404,354,758,1048
0130-001,2013,10,27,2,308,263,571,758
0130-001,2013,10,27,3,222,198,420,571
0130-001,2013,10,27,4,192,166,358,420
0130-001,2013,10,27,5,192,179,371,358
0130-001,2013,10,27,6,286,275,561,371
0130-001,2013,10,27,7,558,450,1008,561
0130-001,2013,10,27,8,759,742,1501,1008
0130-001,2013,10,27,9,885,979,1864,1501
0130-001,2013,10,27,10,1063,1117,2180,1864
0130-001,2013,10,27,11,1213,1371,2584,2180
0130-001,2013,10,27,12,1367,1288,2655,2584
0130-001,2013,10,27,13,1361,1343,2704,2655
0130-001,2013,10,27,14,1573,1605,3178,2704
0130-001,2013,10,27,15,1732,1591,3323,3178
0130-001,2013,10,27,16,1831,1639,3470,3323
0130-001,2013,10,27,17,1981,1780,3761,3470
0130-001,2013,10,27,18,1942,1927,3869,3761
0130-001,2013,10,27,19,1901,1630,3531,3869
0130-001,2013,10,27,20,1771,1224,2995,3531
0130-001,2013,10,27,21,1730,1011,2741,2995
0130-001,2013,10,27,22,1500,850,2350,2741
0130-001,2013,10,27,23,909,552,1461,2350
0130-001,2013,10,27,24,513,380,893,1461
0130-001,2013,10,28,1,268,269,537,893
0130-001,2013,10,28,2,168,154,322,537
0130-001,2013,10,28,3,129,127,256,322
0130-001,2013,10,28,4,115,127,242,256
0130-001,2013,10,28,5,160,197,357,242
0130-001,2013,10,28,6,409,360,769,357
0130-001,2013,10,28,7,1400,800,2200,769
0130-001,2013,10,28,8,2227,1699,3926,2200
0130-001,2013,10,28,9,2084,2248,4332,3926
0130-001,2013,10,28,10,1780,1741,3521,4332
0130-001,2013,10,28,11,1853,1745,3598,3521
0130-001,2013,10,28,12,1702,1757,3459,3598
0130-001,2013,10,28,13,1600,1613,3213,3459
0130-001,2013,10,28,14,1858,1823,3681,3213
0130-001,2013,10,28,15,2011,1780,3791,3681
0130-001,2013,10,28,16,1903,2032,3935,3791
0130-001,2013,10,28,17,1786,1984,3770,3935
0130-001,2013,10,28,18,1790,2362,4152,3770
0130-001,2013,10,28,19,1756,2460,4216,4152
0130-001,2013,10,28,20,1360,1878,3238,4216
0130-001,2013,10,28,21,1209,1669,2878,3238
0130-001,2013,10,28,22,1111,1220,2331,2878
0130-001,2013,10,28,23,814,763,1577,2331
0130-001,2013,10,28,24,520,422,942,1577
0130-001,2013,10,29,1,334,290,624,942
0130-001,2013,10,29,2,212,225,437,624
0130-001,2013,10,29,3,169,164,333,437
0130-001,2013,10,29,4,151,161,312,333
0130-001,2013,10,29,5,193,248,441,312
0130-001,2013,10,29,6,383,356,739,441
0130-001,2013,10,29,7,1265,685,1950,739
0130-001,2013,10,29,8,2168,1844,4012,1950
0130-001,2013,10,29,9,2144,2120,4264,4012
0130-001,2013,10,29,10,1779,1688,3467,4264
0130-001,2013,10,29,11,1901,1898,3799,3467
0130-001,2013,10,29,12,1725,1679,3404,3799
0130-001,2013,10,29,13,1504,1558,3062,3404
0130-001,2013,10,29,14,1835,1794,3629,3062
0130-001,2013,10,29,15,1773,1827,3600,3629
0130-001,2013,10,29,16,1873,1889,3762,3600
0130-001,2013,10,29,17,1773,1970,3743,3762
0130-001,2013,10,29,18,1859,2326,4185,3743
0130-001,2013,10,29,19,1639,2423,4062,4185
0130-001,2013,10,29,20,1342,1832,3174,4062
0130-001,2013,10,29,21,1235,1609,2844,3174
0130-001,2013,10,29,22,1114,1242,2356,2844
0130-001,2013,10,29,23,895,758,1653,2356
0130-001,2013,10,29,24,578,477,1055,1653
0130-001,2013,10,30,1,364,316,680,1055
0130-001,2013,10,30,2,228,220,448,680
0130-001,2013,10,30,3,190,181,371,448
0130-001,2013,10,30,4,137,163,300,371
0130-001,2013,10,30,5,180,228,408,300
0130-001,2013,10,30,6,389,355,744,408
0130-001,2013,10,30,7,1245,706,1951,744
0130-001,2013,10,30,8,2148,1793,3941,1951
0130-001,2013,10,30,9,2157,2103,4260,3941
0130-001,2013,10,30,10,1797,1713,3510,4260
0130-001,2013,10,30,11,1867,1796,3663,3510
0130-001,2013,10,30,12,1667,1689,3356,3663
0130-001,2013,10,30,13,1482,1476,2958,3356
0130-001,2013,10,30,14,1791,1780,3571,2958
0130-001,2013,10,30,15,1925,1920,3845,3571
0130-001,2013,10,30,16,1846,1961,3807,3845
0130-001,2013,10,30,17,1797,2062,3859,3807
0130-001,2013,10,30,18,1911,2359,4270,3859
0130-001,2013,10,30,19,1829,2555,4384,4270
0130-001,2013,10,30,20,1432,1824,3256,4384
0130-001,2013,10,30,21,1235,1530,2765,3256
0130-001,2013,10,30,22,1203,1205,2408,2765
0130-001,2013,10,30,23,851,804,1655,2408
0130-001,2013,10,30,24,560,456,1016,1655
0130-001,2013,10,31,1,391,363,754,1016
0130-001,2013,10,31,2,251,209,460,754
0130-001,2013,10,31,3,161,159,320,460
0130-001,2013,10,31,4,148,197,345,320
0130-001,2013,10,31,5,197,230,427,345
0130-001,2013,10,31,6,381,371,752,427
0130-001,2013,10,31,7,1287,721,2008,752
0130-001,2013,10,31,8,2127,1806,3933,2008
0130-001,2013,10,31,9,2127,2055,4182,3933
0130-001,2013,10,31,10,1567,1587,3154,4182
0130-001,2013,10,31,11,1929,1718,3647,3154
0130-001,2013,10,31,12,1640,1638,3278,3647
0130-001,2013,10,31,13,1480,1492,2972,3278
0130-001,2013,10,31,14,1556,1711,3267,2972
0130-001,2013,10,31,15,1502,1740,3242,3267
0130-001,2013,10,31,16,1648,1795,3443,3242
0130-001,2013,10,31,17,1840,1861,3701,3443
0130-001,2013,10,31,18,1736,2336,4072,3701
0130-001,2013,10,31,19,1780,2569,4349,4072
0130-001,2013,10,31,20,1350,1798,3148,4349
0130-001,2013,10,31,21,1270,1705,2975,3148
0130-001,2013,10,31,22,1215,1259,2474,2975
0130-001,2013,10,31,23,907,816,1723,2474
0130-001,2013,10,31,24,625,559,1184,1723
0130-001,2013,11,1,1,407,383,790,1184
0130-001,2013,11,1,2,290,274,564,790
0130-001,2013,11,1,3,184,227,411,564
0130-001,2013,11,1,4,189,183,372,411
0130-001,2013,11,1,5,181,245,426,372
0130-001,2013,11,1,6,377,388,765,426
0130-001,2013,11,1,7,1241,713,1954,765
0130-001,2013,11,1,8,2198,1766,3964,1954
0130-001,2013,11,1,9,2137,2029,4166,3964
0130-001,2013,11,1,10,1747,1777,3524,4166
0130-001,2013,11,1,11,1858,1870,3728,3524
0130-001,2013,11,1,12,1758,1740,3498,3728
0130-001,2013,11,1,13,1558,1663,3221,3498
0130-001,2013,11,1,14,1776,1719,3495,3221
0130-001,2013,11,1,15,1863,1924,3787,3495
0130-001,2013,11,1,16,1943,2018,3961,3787
0130-001,2013,11,1,17,1858,1965,3823,3961
0130-001,2013,11,1,18,1982,2445,4427,3823
0130-001,2013,11,1,19,1916,2581,4497,4427
0130-001,2013,11,1,20,1563,2103,3666,4497
0130-001,2013,11,1,21,1313,1750,3063,3666
0130-001,2013,11,1,22,1219,1357,2576,3063
0130-001,2013,11,1,23,964,943,1907,2576
0130-001,2013,11,1,24,697,586,1283,1907
0130-001,2013,11,2,1,480,426,906,1283
0130-001,2013,11,2,2,362,317,679,906
0130-001,2013,11,2,3,243,235,478,679
0130-001,2013,11,2,4,223,229,452,478
0130-001,2013,11,2,5,254,296,550,452
0130-001,2013,11,2,6,382,367,749,550
0130-001,2013,11,2,7,864,627,1491,749
0130-001,2013,11,2,8,1486,1128,2614,1491
0130-001,2013,11,2,9,1613,1607,3220,2614
0130-001,2013,11,2,10,1680,1828,3508,3220
0130-001,2013,11,2,11,1781,2116,3897,3508
0130-001,2013,11,2,12,1691,2073,3764,3897
0130-001,2013,11,2,13,1652,2158,3810,3764
0130-001,2013,11,2,14,1499,2033,3532,3810
0130-001,2013,11,2,15,1761,1997,3758,3532
0130-001,2013,11,2,16,1827,2034,3861,3758
0130-001,2013,11,2,17,1843,1948,3791,3861
0130-001,2013,11,2,18,1860,2173,4033,3791
0130-001,2013,11,2,19,1848,2044,3892,4033
0130-001,2013,11,2,20,1651,1284,2935,3892
0130-001,2013,11,2,21,1325,1136,2461,2935
0130-001,2013,11,2,22,1141,979,2120,2461
0130-001,2013,11,2,23,796,627,1423,2120
0130-001,2013,11,2,24,490,444,934,1423
0130-001,2013,11,3,1,387,305,692,934
0130-001,2013,11,3,2,267,275,542,692
0130-001,2013,11,3,3,212,165,377,542
0130-001,2013,11,3,4,186,164,350,377
0130-001,2013,11,3,5,188,164,352,350
0130-001,2013,11,3,6,260,304,564,352
0130-001,2013,11,3,7,485,409,894,564
0130-001,2013,11,3,8,791,681,1472,894
0130-001,2013,11,3,9,897,958,1855,1472
0130-001,2013,11,3,10,1047,1055,2102,1855
0130-001,2013,11,3,11,1209,1369,2578,2102
0130-001,2013,11,3,12,1245,1386,2631,2578
0130-001,2013,11,3,13,1323,1455,2778,2631
0130-001,2013,11,3,14,1534,1465,2999,2778
0130-001,2013,11,3,15,1839,1667,3506,2999
0130-001,2013,11,3,16,2059,1622,3681,3506
0130-001,2013,11,3,17,1886,1572,3458,3681
0130-001,2013,11,3,18,1884,1740,3624,3458
0130-001,2013,11,3,19,1837,1430,3267,3624
0130-001,2013,11,3,20,1787,1071,2858,3267
0130-001,2013,11,3,21,1773,1057,2830,2858
0130-001,2013,11,3,22,1562,795,2357,2830
0130-001,2013,11,3,23,1053,539,1592,2357
0130-001,2013,11,3,24,543,422,965,1592
0130-001,2013,11,4,1,283,263,546,965
0130-001,2013,11,4,2,175,175,350,546
0130-001,2013,11,4,3,112,130,242,350
0130-001,2013,11,4,4,131,122,253,242
0130-001,2013,11,4,5,179,198,377,253
0130-001,2013,11,4,6,364,368,732,377
0130-001,2013,11,4,7,1269,791,2060,732
0130-001,2013,11,4,8,2167,1759,3926,2060
0130-001,2013,11,4,9,2098,2047,4145,3926
0130-001,2013,11,4,10,1741,1793,3534,4145
0130-001,2013,11,4,11,1819,1699,3518,3534
0130-001,2013,11,4,12,1730,1679,3409,3518
0130-001,2013,11,4,13,1570,1604,3174,3409
0130-001,2013,11,4,14,1890,1801,3691,3174
0130-001,2013,11,4,15,1788,1788,3576,3691
0130-001,2013,11,4,16,1837,1916,3753,3576
0130-001,2013,11,4,17,1795,1975,3770,3753
0130-001,2013,11,4,18,1774,2276,4050,3770
0130-001,2013,11,4,19,1777,2523,4300,4050
0130-001,2013,11,4,20,1349,1718,3067,4300
0130-001,2013,11,4,21,1168,1676,2844,3067
0130-001,2013,11,4,22,1042,1278,2320,2844
0130-001,2013,11,4,23,817,756,1573,2320
0130-001,2013,11,4,24,532,472,1004,1573
0130-001,2013,11,5,1,349,340,689,1004
0130-001,2013,11,5,2,223,223,446,689
0130-001,2013,11,5,3,165,162,327,446
0130-001,2013,11,5,4,146,174,320,327
0130-001,2013,11,5,5,186,213,399,320
0130-001,2013,11,5,6,322,333,655,399
0130-001,2013,11,5,7,1197,746,1943,655
0130-001,2013,11,5,8,2006,1722,3728,1943
0130-001,2013,11,5,9,2193,2067,4260,3728
0130-001,2013,11,5,10,1883,1821,3704,4260
0130-001,2013,11,5,11,1845,1654,3499,3704
0130-001,2013,11,5,12,1718,1625,3343,3499
0130-001,2013,11,5,13,1415,1508,2923,3343
0130-001,2013,11,5,14,1874,1879,3753,2923
0130-001,2013,11,5,15,1868,1883,3751,3753
0130-001,2013,11,5,16,1832,1888,3720,3751
0130-001,2013,11,5,17,1836,2000,3836,3720
0130-001,2013,11,5,18,1796,2286,4082,3836
0130-001,2013,11,5,19,1752,2468,4220,4082
0130-001,2013,11,5,20,1454,1759,3213,4220
0130-001,2013,11,5,21,1253,1627,2880,3213
0130-001,2013,11,5,22,1082,1268,2350,2880
0130-001,2013,11,5,23,857,789,1646,2350
0130-001,2013,11,5,24,581,487,1068,1646
0130-001,2013,11,6,1,384,362,746,1068
0130-001,2013,11,6,2,269,277,546,746
0130-001,2013,11,6,3,193,165,358,546
0130-001,2013,11,6,4,158,145,303,358
0130-001,2013,11,6,5,181,215,396,303
0130-001,2013,11,6,6,356,383,739,396
0130-001,2013,11,6,7,1233,788,2021,739
0130-001,2013,11,6,8,2148,1694,3842,2021
0130-001,2013,11,6,9,2195,2062,4257,3842
0130-001,2013,11,6,10,1731,1793,3524,4257
0130-001,2013,11,6,11,1852,1698,3550,3524
0130-001,2013,11,6,12,1699,1650,3349,3550
0130-001,2013,11,6,13,1467,1579,3046,3349
0130-001,2013,11,6,14,1728,1795,3523,3046
0130-001,2013,11,6,15,1800,1792,3592,3523
0130-001,2013,11,6,16,1780,1878,3658,3592
0130-001,2013,11,6,17,1725,1890,3615,3658
0130-001,2013,11,6,18,1879,2335,4214,3615
0130-001,2013,11,6,19,1757,2503,4260,4214
0130-001,2013,11,6,20,1413,1739,3152,4260
0130-001,2013,11,6,21,1262,1537,2799,3152
0130-001,2013,11,6,22,1112,1148,2260,2799
0130-001,2013,11,6,23,828,766,1594,2260
0130-001,2013,11,6,24,590,512,1102,1594
0130-001,2013,11,7,1,342,343,685,1102
0130-001,2013,11,7,2,224,219,443,685
0130-001,2013,11,7,3,193,164,357,443
0130-001,2013,11,7,4,146,165,311,357
0130-001,2013,11,7,5,166,230,396,311
0130-001,2013,11,7,6,365,371,736,396
0130-001,2013,11,7,7,1206,768,1974,736
0130-001,2013,11,7,8,2141,1712,3853,1974
0130-001,2013,11,7,9,2049,2080,4129,3853
0130-001,2013,11,7,10,2003,1833,3836,4129
0130-001,2013,11,7,11,1834,1663,3497,3836
0130-001,2013,11,7,12,1665,1567,3232,3497
0130-001,2013,11,7,13,1441,1502,2943,3232
0130-001,2013,11,7,14,1717,1766,3483,2943
0130-001,2013,11,7,15,1757,1817,3574,3483
0130-001,2013,11,7,16,1837,1904,3741,3574
0130-001,2013,11,7,17,1786,1897,3683,3741
0130-001,2013,11,7,18,1815,2372,4187,3683
0130-001,2013,11,7,19,1757,2516,4273,4187
0130-001,2013,11,7,20,1358,1724,3082,4273
0130-001,2013,11,7,21,1243,1623,2866,3082
0130-001,2013,11,7,22,1118,1255,2373,2866
0130-001,2013,11,7,23,909,724,1633,2373
0130-001,2013,11,7,24,587,554,1141,1633
0130-001,2013,11,8,1,359,321,680,1141
0130-001,2013,11,8,2,264,212,476,680
0130-001,2013,11,8,3,173,183,356,476
0130-001,2013,11,8,4,168,170,338,356
0130-001,2013,11,8,5,187,228,415,338
0130-001,2013,11,8,6,356,355,711,415
0130-001,2013,11,8,7,1190,725,1915,711
0130-001,2013,11,8,8,2122,1695,3817,1915
0130-001,2013,11,8,9,2191,2102,4293,3817
0130-001,2013,11,8,10,1816,1747,3563,4293
0130-001,2013,11,8,11,1859,1716,3575,3563
0130-001,2013,11,8,12,1773,1735,3508,3575
0130-001,2013,11,8,13,1400,1647,3047,3508
0130-001,2013,11,8,14,1760,1824,3584,3047
0130-001,2013,11,8,15,1887,1851,3738,3584
0130-001,2013,11,8,16,1842,1991,3833,3738
0130-001,2013,11,8,17,1894,2026,3920,3833
0130-001,2013,11,8,18,1934,2432,4366,3920
0130-001,2013,11,8,19,1935,2588,4523,4366
0130-001,2013,11,8,20,1581,2030,3611,4523
0130-001,2013,11,8,21,1393,1774,3167,3611
0130-001,2013,11,8,22,1274,1392,2666,3167
0130-001,2013,11,8,23,1002,839,1841,2666
0130-001,2013,11,8,24,707,649,1356,1841
0130-001,2013,11,9,1,481,407,888,1356
0130-001,2013,11,9,2,345,324,669,888
0130-001,2013,11,9,3,261,233,494,669
0130-001,2013,11,9,4,230,231,461,494
0130-001,2013,11,9,5,236,253,489,461
0130-001,2013,11,9,6,378,420,798,489
0130-001,2013,11,9,7,837,641,1478,798
0130-001,2013,11,9,8,1522,1199,2721,1478
0130-001,2013,11,9,9,1712,1716,3428,2721
0130-001,2013,11,9,10,1785,1842,3627,3428
0130-001,2013,11,9,11,1697,1933,3630,3627
0130-001,2013,11,9,12,1758,2062,3820,3630
0130-001,2013,11,9,13,1612,2398,4010,3820
0130-001,2013,11,9,14,1908,2259,4167,4010
0130-001,2013,11,9,15,1848,2081,3929,4167
0130-001,2013,11,9,16,1934,2029,3963,3929
0130-001,2013,11,9,17,1926,2058,3984,3963
0130-001,2013,11,9,18,1837,2216,4053,3984
0130-001,2013,11,9,19,1764,1985,3749,4053
0130-001,2013,11,9,20,1634,1250,2884,3749
0130-001,2013,11,9,21,1399,1115,2514,2884
0130-001,2013,11,9,22,1166,935,2101,2514
0130-001,2013,11,9,23,755,669,1424,2101
0130-001,2013,11,9,24,546,421,967,1424
0130-001,2013,11,10,1,413,356,769,967
0130-001,2013,11,10,2,274,264,538,769
0130-001,2013,11,10,3,214,209,423,538
0130-001,2013,11,10,4,192,134,326,423
0130-001,2013,11,10,5,184,163,347,326
0130-001,2013,11,10,6,249,279,528,347
0130-001,2013,11,10,7,469,368,837,528
0130-001,2013,11,10,8,659,613,1272,837
0130-001,2013,11,10,9,914,901,1815,1272
0130-001,2013,11,10,10,1074,1109,2183,1815
0130-001,2013,11,10,11,1225,1356,2581,2183
0130-001,2013,11,10,12,1259,1461,2720,2581
0130-001,2013,11,10,13,1402,1499,2901,2720
0130-001,2013,11,10,14,1805,1510,3315,2901
0130-001,2013,11,10,15,1967,1611,3578,3315
0130-001,2013,11,10,16,1875,1653,3528,3578
0130-001,2013,11,10,17,1799,1619,3418,3528
0130-001,2013,11,10,18,1763,1619,3382,3418
0130-001,2013,11,10,19,1934,1362,3296,3382
0130-001,2013,11,10,20,1973,1337,3310,3296
0130-001,2013,11,10,21,1821,1108,2929,3310
0130-001,2013,11,10,22,1609,885,2494,2929
0130-001,2013,11,10,23,1091,559,1650,2494
0130-001,2013,11,10,24,590,385,975,1650
0130-001,2013,11,11,1,286,214,500,975
0130-001,2013,11,11,2,185,163,348,500
0130-001,2013,11,11,3,120,127,247,348
0130-001,2013,11,11,4,129,147,276,247
0130-001,2013,11,11,5,159,183,342,276
0130-001,2013,11,11,6,369,396,765,342
0130-001,2013,11,11,7,1361,828,2189,765
0130-001,2013,11,11,8,2154,1725,3879,2189
0130-001,2013,11,11,9,2213,2158,4371,3879
0130-001,2013,11,11,10,1816,1702,3518,4371
0130-001,2013,11,11,11,1832,1788,3620,3518
0130-001,2013,11,11,12,1815,1731,3546,3620
0130-001,2013,11,11,13,1606,1518,3124,3546
0130-001,2013,11,11,14,1782,1781,3563,3124
0130-001,2013,11,11,15,1911,1863,3774,3563
0130-001,2013,11,11,16,1776,1973,3749,3774
0130-001,2013,11,11,17,1796,2045,3841,3749
0130-001,2013,11,11,18,1847,2314,4161,3841
0130-001,2013,11,11,19,1827,2457,4284,4161
0130-001,2013,11,11,20,1405,1808,3213,4284
0130-001,2013,11,11,21,1224,1714,2938,3213
0130-001,2013,11,11,22,1160,1317,2477,2938
0130-001,2013,11,11,23,834,789,1623,2477
0130-001,2013,11,11,24,571,502,1073,1623
0130-001,2013,11,12,1,329,333,662,1073
0130-001,2013,11,12,2,214,232,446,662
0130-001,2013,11,12,3,186,183,369,446
0130-001,2013,11,12,4,133,144,277,369
0130-001,2013,11,12,5,180,224,404,277
0130-001,2013,11,12,6,307,367,674,404
0130-001,2013,11,12,7,1235,716,1951,674
0130-001,2013,11,12,8,2087,1684,3771,1951
0130-001,2013,11,12,9,2181,2093,4274,3771
0130-001,2013,11,12,10,1804,1749,3553,4274
0130-001,2013,11,12,11,1824,1760,3584,3553
0130-001,2013,11,12,12,1692,1620,3312,3584
0130-001,2013,11,12,13,1470,1537,3007,3312
0130-001,2013,11,12,14,1844,1772,3616,3007
0130-001,2013,11,12,15,1872,1895,3767,3616
0130-001,2013,11,12,16,1883,1849,3732,3767
0130-001,2013,11,12,17,1721,1954,3675,3732
0130-001,2013,11,12,18,1757,2373,4130,3675
0130-001,2013,11,12,19,1696,2461,4157,4130
0130-001,2013,11,12,20,1356,1732,3088,4157
0130-001,2013,11,12,21,1243,1633,2876,3088
0130-001,2013,11,12,22,1129,1251,2380,2876
0130-001,2013,11,12,23,818,780,1598,2380
0130-001,2013,11,12,24,544,471,1015,1598
0130-001,2013,11,13,1,398,290,688,1015
0130-001,2013,11,13,2,219,235,454,688
0130-001,2013,11,13,3,164,173,337,454
0130-001,2013,11,13,4,158,149,307,337
0130-001,2013,11,13,5,185,223,408,307
0130-001,2013,11,13,6,357,365,722,408
0130-001,2013,11,13,7,1201,753,1954,722
0130-001,2013,11,13,8,2151,1676,3827,1954
0130-001,2013,11,13,9,2121,2142,4263,3827
0130-001,2013,11,13,10,1971,1819,3790,4263
0130-001,2013,11,13,11,1830,1681,3511,3790
0130-001,2013,11,13,12,1701,1633,3334,3511
0130-001,2013,11,13,13,1489,1545,3034,3334
0130-001,2013,11,13,14,1806,1752,3558,3034
0130-001,2013,11,13,15,1818,1796,3614,3558
0130-001,2013,11,13,16,1859,1911,3770,3614
0130-001,2013,11,13,17,1782,1979,3761,3770
0130-001,2013,11,13,18,1837,2377,4214,3761
0130-001,2013,11,13,19,1738,2463,4201,4214
0130-001,2013,11,13,20,1356,1872,3228,4201
0130-001,2013,11,13,21,1251,1566,2817,3228
0130-001,2013,11,13,22,1144,1225,2369,2817
0130-001,2013,11,13,23,861,769,1630,2369
0130-001,2013,11,13,24,579,493,1072,1630
0130-001,2013,11,14,1,410,348,758,1072
0130-001,2013,11,14,2,234,240,474,758
0130-001,2013,11,14,3,171,188,359,474
0130-001,2013,11,14,4,139,154,293,359
0130-001,2013,11,14,5,160,213,373,293
0130-001,2013,11,14,6,324,346,670,373
0130-001,2013,11,14,7,1162,751,1913,670
0130-001,2013,11,14,8,2150,1680,3830,1913
0130-001,2013,11,14,9,2192,2115,4307,3830
0130-001,2013,11,14,10,1872,1799,3671,4307
0130-001,2013,11,14,11,1881,1750,3631,3671
0130-001,2013,11,14,12,1757,1694,3451,3631
0130-001,2013,11,14,13,1514,1543,3057,3451
0130-001,2013,11,14,14,1760,1753,3513,3057
0130-001,2013,11,14,15,1839,1821,3660,3513
0130-001,2013,11,14,16,1816,1929,3745,3660
0130-001,2013,11,14,17,1814,2026,3840,3745
0130-001,2013,11,14,18,1875,2304,4179,3840
0130-001,2013,11,14,19,1760,2381,4141,4179
0130-001,2013,11,14,20,1375,1825,3200,4141
0130-001,2013,11,14,21,1157,1612,2769,3200
0130-001,2013,11,14,22,1221,1208,2429,2769
0130-001,2013,11,14,23,881,799,1680,2429
0130-001,2013,11,14,24,561,538,1099,1680
0130-001,2013,11,15,1,415,366,781,1099
0130-001,2013,11,15,2,258,274,532,781
0130-001,2013,11,15,3,213,189,402,532
0130-001,2013,11,15,4,155,187,342,402
0130-001,2013,11,15,5,166,215,381,342
0130-001,2013,11,15,6,389,361,750,381
0130-001,2013,11,15,7,1148,729,1877,750
0130-001,2013,11,15,8,2124,1639,3763,1877
0130-001,2013,11,15,9,2165,2120,4285,3763
0130-001,2013,11,15,10,1921,1836,3757,4285
0130-001,2013,11,15,11,1915,1766,3681,3757
0130-001,2013,11,15,12,1797,1739,3536,3681
0130-001,2013,11,15,13,1649,1634,3283,3536
0130-001,2013,11,15,14,1836,1907,3743,3283
0130-001,2013,11,15,15,1824,1885,3709,3743
0130-001,2013,11,15,16,1877,2045,3922,3709
0130-001,2013,11,15,17,1930,2040,3970,3922
0130-001,2013,11,15,18,1929,2475,4404,3970
0130-001,2013,11,15,19,1818,2585,4403,4404
0130-001,2013,11,15,20,1708,2229,3937,4403
0130-001,2013,11,15,21,1383,1756,3139,3937
0130-001,2013,11,15,22,1159,1338,2497,3139
0130-001,2013,11,15,23,935,920,1855,2497
0130-001,2013,11,15,24,717,591,1308,1855
0130-001,2013,11,16,1,480,404,884,1308
0130-001,2013,11,16,2,368,298,666,884
0130-001,2013,11,16,3,271,242,513,666
0130-001,2013,11,16,4,211,215,426,513
0130-001,2013,11,16,5,243,272,515,426
0130-001,2013,11,16,6,359,385,744,515
0130-001,2013,11,16,7,856,595,1451,744
0130-001,2013,11,16,8,1484,1071,2555,1451
0130-001,2013,11,16,9,1873,1761,3634,2555
0130-001,2013,11,16,10,1783,1934,3717,3634
0130-001,2013,11,16,11,1832,2026,3858,3717
0130-001,2013,11,16,12,1761,2323,4084,3858
0130-001,2013,11,16,13,1769,2470,4239,4084
0130-001,2013,11,16,14,1897,2356,4253,4239
0130-001,2013,11,16,15,1930,2306,4236,4253
0130-001,2013,11,16,16,1948,2235,4183,4236
0130-001,2013,11,16,17,2013,2223,4236,4183
0130-001,2013,11,16,18,1979,2364,4343,4236
0130-001,2013,11,16,19,1913,2118,4031,4343
0130-001,2013,11,16,20,1778,1519,3297,4031
0130-001,2013,11,16,21,1519,1167,2686,3297
0130-001,2013,11,16,22,1250,987,2237,2686
0130-001,2013,11,16,23,823,682,1505,2237
0130-001,2013,11,16,24,561,449,1010,1505
0130-001,2013,11,17,1,401,340,741,1010
0130-001,2013,11,17,2,303,277,580,741
0130-001,2013,11,17,3,210,182,392,580
0130-001,2013,11,17,4,191,174,365,392
0130-001,2013,11,17,5,169,165,334,365
0130-001,2013,11,17,6,272,243,515,334
0130-001,2013,11,17,7,517,407,924,515
0130-001,2013,11,17,8,752,619,1371,924
0130-001,2013,11,17,9,956,922,1878,1371
0130-001,2013,11,17,10,1124,1131,2255,1878
0130-001,2013,11,17,11,1221,1451,2672,2255
0130-001,2013,11,17,12,1372,1692,3064,2672
0130-001,2013,11,17,13,1430,1653,3083,3064
0130-001,2013,11,17,14,1733,1648,3381,3083
0130-001,2013,11,17,15,1975,1717,3692,3381
0130-001,2013,11,17,16,1861,1733,3594,3692
0130-001,2013,11,17,17,1811,1671,3482,3594
0130-001,2013,11,17,18,1784,1639,3423,3482
0130-001,2013,11,17,19,1746,1385,3131,3423
0130-001,2013,11,17,20,1704,1186,2890,3131
0130-001,2013,11,17,21,1614,995,2609,2890
0130-001,2013,11,17,22,1653,814,2467,2609
0130-001,2013,11,17,23,1128,594,1722,2467
0130-001,2013,11,17,24,616,374,990,1722
0130-001,2013,11,18,1,289,230,519,990
0130-001,2013,11,18,2,185,162,347,519
0130-001,2013,11,18,3,141,127,268,347
0130-001,2013,11,18,4,118,129,247,268
0130-001,2013,11,18,5,151,180,331,247
0130-001,2013,11,18,6,354,362,716,331
0130-001,2013,11,18,7,1309,780,2089,716
0130-001,2013,11,18,8,2075,1703,3778,2089
0130-001,2013,11,18,9,2223,2069,4292,3778
0130-001,2013,11,18,10,1821,1712,3533,4292
0130-001,2013,11,18,11,1705,1716,3421,3533
0130-001,2013,11,18,12,1677,1689,3366,3421
0130-001,2013,11,18,13,1493,1527,3020,3366
0130-001,2013,11,18,14,1710,1780,3490,3020
0130-001,2013,11,18,15,1780,1803,3583,3490
0130-001,2013,11,18,16,1830,1838,3668,3583
0130-001,2013,11,18,17,1704,1899,3603,3668
0130-001,2013,11,18,18,1798,2191,3989,3603
0130-001,2013,11,18,19,1706,2313,4019,3989
0130-001,2013,11,18,20,1282,1776,3058,4019
0130-001,2013,11,18,21,1100,1588,2688,3058
0130-001,2013,11,18,22,1065,1173,2238,2688
0130-001,2013,11,18,23,711,749,1460,2238
0130-001,2013,11,18,24,473,391,864,1460
0130-001,2013,11,19,1,309,275,584,864
0130-001,2013,11,19,2,216,198,414,584
0130-001,2013,11,19,3,141,171,312,414
0130-001,2013,11,19,4,137,167,304,312
0130-001,2013,11,19,5,171,198,369,304
0130-001,2013,11,19,6,308,346,654,369
0130-001,2013,11,19,7,1202,689,1891,654
0130-001,2013,11,19,8,2143,1622,3765,1891
0130-001,2013,11,19,9,2126,2054,4180,3765
0130-001,2013,11,19,10,1753,1674,3427,4180
0130-001,2013,11,19,11,1758,1596,3354,3427
0130-001,2013,11,19,12,1638,1626,3264,3354
0130-001,2013,11,19,13,1384,1548,2932,3264
0130-001,2013,11,19,14,1703,1708,3411,2932
0130-001,2013,11,19,15,1847,1829,3676,3411
0130-001,2013,11,19,16,1802,1899,3701,3676
0130-001,2013,11,19,17,1732,1865,3597,3701
0130-001,2013,11,19,18,1748,2303,4051,3597
0130-001,2013,11,19,19,1634,2368,4002,4051
0130-001,2013,11,19,20,1266,1654,2920,4002
0130-001,2013,11,19,21,1249,1632,2881,2920
0130-001,2013,11,19,22,1099,1222,2321,2881
0130-001,2013,11,19,23,839,758,1597,2321
0130-001,2013,11,19,24,610,495,1105,1597
0130-001,2013,11,20,1,383,308,691,1105
0130-001,2013,11,20,2,236,256,492,691
0130-001,2013,11,20,3,184,160,344,492
0130-001,2013,11,20,4,156,155,311,344
0130-001,2013,11,20,5,164,206,370,311
0130-001,2013,11,20,6,333,312,645,370
0130-001,2013,11,20,7,1184,697,1881,645
0130-001,2013,11,20,8,2157,1620,3777,1881
0130-001,2013,11,20,9,2146,2053,4199,3777
0130-001,2013,11,20,10,1756,1724,3480,4199
0130-001,2013,11,20,11,1749,1616,3365,3480
0130-001,2013,11,20,12,1752,1714,3466,3365
0130-001,2013,11,20,13,1471,1395,2866,3466
0130-001,2013,11,20,14,1747,1871,3618,2866
0130-001,2013,11,20,15,1867,1877,3744,3618
0130-001,2013,11,20,16,1885,1841,3726,3744
0130-001,2013,11,20,17,1767,2007,3774,3726
0130-001,2013,11,20,18,1862,2390,4252,3774
0130-001,2013,11,20,19,1781,2495,4276,4252
0130-001,2013,11,20,20,1349,1778,3127,4276
0130-001,2013,11,20,21,1201,1552,2753,3127
0130-001,2013,11,20,22,1150,1178,2328,2753
0130-001,2013,11,20,23,869,765,1634,2328
0130-001,2013,11,20,24,556,462,1018,1634
0130-001,2013,11,21,1,356,330,686,1018
0130-001,2013,11,21,2,258,245,503,686
0130-001,2013,11,21,3,204,177,381,503
0130-001,2013,11,21,4,140,169,309,381
0130-001,2013,11,21,5,172,213,385,309
0130-001,2013,11,21,6,363,352,715,385
0130-001,2013,11,21,7,1198,696,1894,715
0130-001,2013,11,21,8,2151,1648,3799,1894
0130-001,2013,11,21,9,2169,2064,4233,3799
0130-001,2013,11,21,10,1817,1768,3585,4233
0130-001,2013,11,21,11,1884,1767,3651,3585
0130-001,2013,11,21,12,1672,1742,3414,3651
0130-001,2013,11,21,13,1518,1512,3030,3414
0130-001,2013,11,21,14,1743,1779,3522,3030
0130-001,2013,11,21,15,1867,1804,3671,3522
0130-001,2013,11,21,16,1790,1836,3626,3671
0130-001,2013,11,21,17,1767,1980,3747,3626
0130-001,2013,11,21,18,1816,2378,4194,3747
0130-001,2013,11,21,19,1712,2454,4166,4194
0130-001,2013,11,21,20,1338,1723,3061,4166
0130-001,2013,11,21,21,1271,1583,2854,3061
0130-001,2013,11,21,22,1154,1254,2408,2854
0130-001,2013,11,21,23,803,813,1616,2408
0130-001,2013,11,21,24,590,505,1095,1616
0130-001,2013,11,22,1,384,312,696,1095
0130-001,2013,11,22,2,221,250,471,696
0130-001,2013,11,22,3,171,182,353,471
0130-001,2013,11,22,4,183,179,362,353
0130-001,2013,11,22,5,173,226,399,362
0130-001,2013,11,22,6,367,362,729,399
0130-001,2013,11,22,7,1186,685,1871,729
0130-001,2013,11,22,8,2161,1628,3789,1871
0130-001,2013,11,22,9,2216,2091,4307,3789
0130-001,2013,11,22,10,1840,1686,3526,4307
0130-001,2013,11,22,11,1866,1806,3672,3526
0130-001,2013,11,22,12,1747,1731,3478,3672
0130-001,2013,11,22,13,1548,1653,3201,3478
0130-001,2013,11,22,14,1837,1890,3727,3201
0130-001,2013,11,22,15,1906,1981,3887,3727
0130-001,2013,11,22,16,1816,2055,3871,3887
0130-001,2013,11,22,17,2004,2091,4095,3871
0130-001,2013,11,22,18,1902,2481,4383,4095
0130-001,2013,11,22,19,1915,2582,4497,4383
0130-001,2013,11,22,20,1500,2232,3732,4497
0130-001,2013,11,22,21,1370,1714,3084,3732
0130-001,2013,11,22,22,1193,1364,2557,3084
0130-001,2013,11,22,23,990,943,1933,2557
0130-001,2013,11,22,24,693,592,1285,1933
0130-001,2013,11,23,1,445,424,869,1285
0130-001,2013,11,23,2,333,293,626,869
0130-001,2013,11,23,3,249,247,496,626
0130-001,2013,11,23,4,233,225,458,496
0130-001,2013,11,23,5,220,262,482,458
0130-001,2013,11,23,6,415,375,790,482
0130-001,2013,11,23,7,879,610,1489,790
0130-001,2013,11,23,8,1376,1108,2484,1489
0130-001,2013,11,23,9,1645,1711,3356,2484
0130-001,2013,11,23,10,1744,1898,3642,3356
0130-001,2013,11,23,11,1829,2039,3868,3642
0130-001,2013,11,23,12,1855,2249,4104,3868
0130-001,2013,11,23,13,1713,2338,4051,4104
0130-001,2013,11,23,14,1780,2319,4099,4051
0130-001,2013,11,23,15,1912,2191,4103,4099
0130-001,2013,11,23,16,1901,2205,4106,4103
0130-001,2013,11,23,17,2015,2191,4206,4106
0130-001,2013,11,23,18,1952,2334,4286,4206
0130-001,2013,11,23,19,1930,2038,3968,4286
0130-001,2013,11,23,20,1607,1411,3018,3968
0130-001,2013,11,23,21,1257,1124,2381,3018
0130-001,2013,11,23,22,1079,902,1981,2381
0130-001,2013,11,23,23,743,678,1421,1981
0130-001,2013,11,23,24,569,455,1024,1421
0130-001,2013,11,24,1,394,284,678,1024
0130-001,2013,11,24,2,307,259,566,678
0130-001,2013,11,24,3,238,201,439,566
0130-001,2013,11,24,4,198,152,350,439
0130-001,2013,11,24,5,166,148,314,350
0130-001,2013,11,24,6,232,247,479,314
0130-001,2013,11,24,7,494,417,911,479
0130-001,2013,11,24,8,691,594,1285,911
0130-001,2013,11,24,9,899,861,1760,1285
0130-001,2013,11,24,10,1067,1009,2076,1760
0130-001,2013,11,24,11,1217,1293,2510,2076
0130-001,2013,11,24,12,1264,1373,2637,2510
0130-001,2013,11,24,13,1506,1512,3018,2637
0130-001,2013,11,24,14,1769,1492,3261,3018
0130-001,2013,11,24,15,1949,1612,3561,3261
0130-001,2013,11,24,16,1741,1692,3433,3561
0130-001,2013,11,24,17,1733,1771,3504,3433
0130-001,2013,11,24,18,1647,1547,3194,3504
0130-001,2013,11,24,19,1644,1349,2993,3194
0130-001,2013,11,24,20,1597,1074,2671,2993
0130-001,2013,11,24,21,1739,882,2621,2671
0130-001,2013,11,24,22,1714,751,2465,2621
0130-001,2013,11,24,23,1258,507,1765,2465
0130-001,2013,11,24,24,625,343,968,1765
0130-001,2013,11,25,1,307,187,494,968
0130-001,2013,11,25,2,184,156,340,494
0130-001,2013,11,25,3,103,132,235,340
0130-001,2013,11,25,4,129,138,267,235
0130-001,2013,11,25,5,143,183,326,267
0130-001,2013,11,25,6,330,356,686,326
0130-001,2013,11,25,7,1280,752,2032,686
0130-001,2013,11,25,8,2099,1717,3816,2032
0130-001,2013,11,25,9,2231,2101,4332,3816
0130-001,2013,11,25,10,1744,1762,3506,4332
0130-001,2013,11,25,11,1804,1716,3520,3506
0130-001,2013,11,25,12,1659,1606,3265,3520
0130-001,2013,11,25,13,1507,1566,3073,3265
0130-001,2013,11,25,14,1749,1760,3509,3073
0130-001,2013,11,25,15,1896,1932,3828,3509
0130-001,2013,11,25,16,1788,1864,3652,3828
0130-001,2013,11,25,17,1782,1925,3707,3652
0130-001,2013,11,25,18,1809,2283,4092,3707
0130-001,2013,11,25,19,1722,2306,4028,4092
0130-001,2013,11,25,20,1332,1746,3078,4028
0130-001,2013,11,25,21,1179,1584,2763,3078
0130-001,2013,11,25,22,1107,1278,2385,2763
0130-001,2013,11,25,23,821,818,1639,2385
0130-001,2013,11,25,24,512,417,929,1639
0130-001,2013,11,26,1,315,321,636,929
0130-001,2013,11,26,2,238,226,464,636
0130-001,2013,11,26,3,183,160,343,464
0130-001,2013,11,26,4,131,163,294,343
0130-001,2013,11,26,5,169,232,401,294
0130-001,2013,11,26,6,358,355,713,401
0130-001,2013,11,26,7,1129,669,1798,713
0130-001,2013,11,26,8,2189,1610,3799,1798
0130-001,2013,11,26,9,2138,2139,4277,3799
0130-001,2013,11,26,10,1788,1716,3504,4277
0130-001,2013,11,26,11,1801,1831,3632,3504
0130-001,2013,11,26,12,1653,1837,3490,3632
0130-001,2013,11,26,13,1477,1636,3113,3490
0130-001,2013,11,26,14,1723,1717,3440,3113
0130-001,2013,11,26,15,1871,1856,3727,3440
0130-001,2013,11,26,16,1801,1906,3707,3727
0130-001,2013,11,26,17,1794,1926,3720,3707
0130-001,2013,11,26,18,1833,2285,4118,3720
0130-001,2013,11,26,19,1659,2388,4047,4118
0130-001,2013,11,26,20,1250,1651,2901,4047
0130-001,2013,11,26,21,1185,1604,2789,2901
0130-001,2013,11,26,22,1166,1223,2389,2789
0130-001,2013,11,26,23,856,775,1631,2389
0130-001,2013,11,26,24,569,481,1050,1631
0130-001,2013,11,27,1,353,298,651,1050
0130-001,2013,11,27,2,233,233,466,651
0130-001,2013,11,27,3,184,180,364,466
0130-001,2013,11,27,4,147,172,319,364
0130-001,2013,11,27,5,164,200,364,319
0130-001,2013,11,27,6,316,335,651,364
0130-001,2013,11,27,7,1058,619,1677,651
0130-001,2013,11,27,8,2124,1630,3754,1677
0130-001,2013,11,27,9,2044,2098,4142,3754
0130-001,2013,11,27,10,1785,1714,3499,4142
0130-001,2013,11,27,11,1737,1719,3456,3499
0130-001,2013,11,27,12,1627,1555,3182,3456
0130-001,2013,11,27,13,1403,1529,2932,3182
0130-001,2013,11,27,14,1703,1730,3433,2932
0130-001,2013,11,27,15,1814,1778,3592,3433
0130-001,2013,11,27,16,1688,1884,3572,3592
0130-001,2013,11,27,17,1685,1743,3428,3572
0130-001,2013,11,27,18,1713,2217,3930,3428
0130-001,2013,11,27,19,1523,2367,3890,3930
0130-001,2013,11,27,20,1126,1449,2575,3890
0130-001,2013,11,27,21,1075,1207,2282,2575
0130-001,2013,11,27,22,955,1075,2030,2282
0130-001,2013,11,27,23,654,619,1273,2030
0130-001,2013,11,27,24,445,324,769,1273
0130-001,2013,11,28,1,289,264,553,769
0130-001,2013,11,28,2,195,184,379,553
0130-001,2013,11,28,3,128,155,283,379
0130-001,2013,11,28,4,119,108,227,283
0130-001,2013,11,28,5,134,198,332,227
0130-001,2013,11,28,6,285,281,566,332
0130-001,2013,11,28,7,961,536,1497,566
0130-001,2013,11,28,8,1602,1295,2897,1497
0130-001,2013,11,28,9,1619,1615,3234,2897
0130-001,2013,11,28,10,1595,1441,3036,3234
0130-001,2013,11,28,11,1513,1547,3060,3036
0130-001,2013,11,28,12,1505,1480,2985,3060
0130-001,2013,11,28,13,1325,1452,2777,2985
0130-001,2013,11,28,14,1669,1547,3216,2777
0130-001,2013,11,28,15,1796,1745,3541,3216
0130-001,2013,11,28,16,1734,1787,3521,3541
0130-001,2013,11,28,17,1739,1849,3588,3521
0130-001,2013,11,28,18,1722,2144,3866,3588
0130-001,2013,11,28,19,1622,2086,3708,3866
0130-001,2013,11,28,20,1172,1527,2699,3708
0130-001,2013,11,28,21,1096,1431,2527,2699
0130-001,2013,11,28,22,1057,1092,2149,2527
0130-001,2013,11,28,23,775,739,1514,2149
0130-001,2013,11,28,24,527,444,971,1514
0130-001,2013,11,29,1,333,306,639,971
0130-001,2013,11,29,2,207,206,413,639
0130-001,2013,11,29,3,146,191,337,413
0130-001,2013,11,29,4,146,150,296,337
0130-001,2013,11,29,5,171,211,382,296
0130-001,2013,11,29,6,332,343,675,382
0130-001,2013,11,29,7,1030,605,1635,675
0130-001,2013,11,29,8,1721,1391,3112,1635
0130-001,2013,11,29,9,2038,1784,3822,3112
0130-001,2013,11,29,10,1919,1653,3572,3822
0130-001,2013,11,29,11,1815,1728,3543,3572
0130-001,2013,11,29,12,1719,1766,3485,3543
0130-001,2013,11,29,13,1519,1606,3125,3485
0130-001,2013,11,29,14,1773,1799,3572,3125
0130-001,2013,11,29,15,1836,1858,3694,3572
0130-001,2013,11,29,16,1823,1934,3757,3694
0130-001,2013,11,29,17,1861,2036,3897,3757
0130-001,2013,11,29,18,1905,2330,4235,3897
0130-001,2013,11,29,19,1811,2442,4253,4235
0130-001,2013,11,29,20,1448,1966,3414,4253
0130-001,2013,11,29,21,1224,1563,2787,3414
0130-001,2013,11,29,22,1094,1302,2396,2787
0130-001,2013,11,29,23,926,849,1775,2396
0130-001,2013,11,29,24,688,564,1252,1775
0130-001,2013,11,30,1,514,410,924,1252
0130-001,2013,11,30,2,369,331,700,924
0130-001,2013,11,30,3,239,233,472,700
0130-001,2013,11,30,4,222,232,454,472
0130-001,2013,11,30,5,252,259,511,454
0130-001,2013,11,30,6,333,341,674,511
0130-001,2013,11,30,7,809,584,1393,674
0130-001,2013,11,30,8,1374,971,2345,1393
0130-001,2013,11,30,9,1574,1681,3255,2345
0130-001,2013,11,30,10,1620,1768,3388,3255
0130-001,2013,11,30,11,1694,1929,3623,3388
0130-001,2013,11,30,12,1758,2114,3872,3623
0130-001,2013,11,30,13,1790,2236,4026,3872
0130-001,2013,11,30,14,1830,1985,3815,4026
0130-001,2013,11,30,15,1916,1902,3818,3815
0130-001,2013,11,30,16,1945,2015,3960,3818
0130-001,2013,11,30,17,1931,2137,4068,3960
0130-001,2013,11,30,18,1912,2262,4174,4068
0130-001,2013,11,30,19,1916,1844,3760,4174
0130-001,2013,11,30,20,1538,1266,2804,3760
0130-001,2013,11,30,21,1164,1054,2218,2804
0130-001,2013,11,30,22,1034,922,1956,2218
0130-001,2013,11,30,23,760,672,1432,1956
0130-001,2013,11,30,24,558,446,1004,1432
0130-001,2013,12,1,1,433,382,815,1004
0130-001,2013,12,1,2,344,304,648,815
0130-001,2013,12,1,3,249,214,463,648
0130-001,2013,12,1,4,177,158,335,463
0130-001,2013,12,1,5,171,167,338,335
0130-001,2013,12,1,6,255,261,516,338
0130-001,2013,12,1,7,521,393,914,516
0130-001,2013,12,1,8,691,636,1327,914
0130-001,2013,12,1,9,827,964,1791,1327
0130-001,2013,12,1,10,1014,1077,2091,1791
0130-001,2013,12,1,11,1180,1352,2532,2091
0130-001,2013,12,1,12,1302,1509,2811,2532
0130-001,2013,12,1,13,1453,1732,3185,2811
0130-001,2013,12,1,14,1754,1635,3389,3185
0130-001,2013,12,1,15,1846,1636,3482,3389
0130-001,2013,12,1,16,1972,1687,3659,3482
0130-001,2013,12,1,17,1845,1735,3580,3659
0130-001,2013,12,1,18,1852,1654,3506,3580
0130-001,2013,12,1,19,1710,1343,3053,3506
0130-001,2013,12,1,20,1707,1085,2792,3053
0130-001,2013,12,1,21,1284,886,2170,2792
0130-001,2013,12,1,22,1126,772,1898,2170
0130-001,2013,12,1,23,652,503,1155,1898
0130-001,2013,12,1,24,425,342,767,1155
0130-001,2013,12,2,1,290,232,522,767
0130-001,2013,12,2,2,148,159,307,522
0130-001,2013,12,2,3,137,127,264,307
0130-001,2013,12,2,4,125,124,249,264
0130-001,2013,12,2,5,155,225,380,249
0130-001,2013,12,2,6,330,338,668,380
0130-001,2013,12,2,7,1314,740,2054,668
0130-001,2013,12,2,8,2121,1677,3798,2054
0130-001,2013,12,2,9,2189,2081,4270,3798
0130-001,2013,12,2,10,1815,1583,3398,4270
0130-001,2013,12,2,11,1737,1813,3550,3398
0130-001,2013,12,2,12,1659,1641,3300,3550
0130-001,2013,12,2,13,1586,1504,3090,3300
0130-001,2013,12,2,14,1717,1754,3471,3090
0130-001,2013,12,2,15,1914,1850,3764,3471
0130-001,2013,12,2,16,1815,1907,3722,3764
0130-001,2013,12,2,17,1677,1918,3595,3722
0130-001,2013,12,2,18,1787,2268,4055,3595
0130-001,2013,12,2,19,1671,2266,3937,4055
0130-001,2013,12,2,20,1306,1706,3012,3937
0130-001,2013,12,2,21,1113,1517,2630,3012
0130-001,2013,12,2,22,1054,1235,2289,2630
0130-001,2013,12,2,23,814,720,1534,2289
0130-001,2013,12,2,24,483,452,935,1534
0130-001,2013,12,3,1,317,320,637,935
0130-001,2013,12,3,2,216,249,465,637
0130-001,2013,12,3,3,166,166,332,465
0130-001,2013,12,3,4,146,153,299,332
0130-001,2013,12,3,5,162,202,364,299
0130-001,2013,12,3,6,318,352,670,364
0130-001,2013,12,3,7,1161,681,1842,670
0130-001,2013,12,3,8,2129,1700,3829,1842
0130-001,2013,12,3,9,2158,2103,4261,3829
0130-001,2013,12,3,10,1844,1689,3533,4261
0130-001,2013,12,3,11,1874,1771,3645,3533
0130-001,2013,12,3,12,1686,1667,3353,3645
0130-001,2013,12,3,13,1425,1448,2873,3353
0130-001,2013,12,3,14,1817,1852,3669,2873
0130-001,2013,12,3,15,1837,1890,3727,3669
0130-001,2013,12,3,16,1904,1925,3829,3727
0130-001,2013,12,3,17,1784,1962,3746,3829
0130-001,2013,12,3,18,1805,2350,4155,3746
0130-001,2013,12,3,19,1659,2342,4001,4155
0130-001,2013,12,3,20,1294,1722,3016,4001
0130-001,2013,12,3,21,1189,1561,2750,3016
0130-001,2013,12,3,22,1092,1214,2306,2750
0130-001,2013,12,3,23,809,758,1567,2306
0130-001,2013,12,3,24,526,524,1050,1567
0130-001,2013,12,4,1,375,327,702,1050
0130-001,2013,12,4,2,228,238,466,702
0130-001,2013,12,4,3,174,189,363,466
0130-001,2013,12,4,4,149,157,306,363
0130-001,2013,12,4,5,179,229,408,306
0130-001,2013,12,4,6,325,311,636,408
0130-001,2013,12,4,7,1182,687,1869,636
0130-001,2013,12,4,8,2059,1641,3700,1869
0130-001,2013,12,4,9,2240,2084,4324,3700
0130-001,2013,12,4,10,1787,1722,3509,4324
0130-001,2013,12,4,11,1854,1694,3548,3509
0130-001,2013,12,4,12,1622,1631,3253,3548
0130-001,2013,12,4,13,1548,1572,3120,3253
0130-001,2013,12,4,14,1731,1712,3443,3120
0130-001,2013,12,4,15,1817,1805,3622,3443
0130-001,2013,12,4,16,1847,1962,3809,3622
0130-001,2013,12,4,17,1707,1937,3644,3809
0130-001,2013,12,4,18,1787,2346,4133,3644
0130-001,2013,12,4,19,1708,2475,4183,4133
0130-001,2013,12,4,20,1261,1813,3074,4183
0130-001,2013,12,4,21,1129,1446,2575,3074
0130-001,2013,12,4,22,1117,1095,2212,2575
0130-001,2013,12,4,23,862,771,1633,2212
0130-001,2013,12,4,24,581,472,1053,1633
0130-001,2013,12,5,1,403,369,772,1053
0130-001,2013,12,5,2,259,239,498,772
0130-001,2013,12,5,3,170,191,361,498
0130-001,2013,12,5,4,142,158,300,361
0130-001,2013,12,5,5,154,207,361,300
0130-001,2013,12,5,6,312,334,646,361
0130-001,2013,12,5,7,1181,679,1860,646
0130-001,2013,12,5,8,2021,1643,3664,1860
0130-001,2013,12,5,9,2213,2015,4228,3664
0130-001,2013,12,5,10,1794,1654,3448,4228
0130-001,2013,12,5,11,1775,1643,3418,3448
0130-001,2013,12,5,12,1619,1662,3281,3418
0130-001,2013,12,5,13,1526,1492,3018,3281
0130-001,2013,12,5,14,1791,1699,3490,3018
0130-001,2013,12,5,15,1760,1818,3578,3490
0130-001,2013,12,5,16,1754,1808,3562,3578
0130-001,2013,12,5,17,1879,1874,3753,3562
0130-001,2013,12,5,18,1893,2330,4223,3753
0130-001,2013,12,5,19,1812,2456,4268,4223
0130-001,2013,12,5,20,1367,1931,3298,4268
0130-001,2013,12,5,21,1137,1667,2804,3298
0130-001,2013,12,5,22,1120,1272,2392,2804
0130-001,2013,12,5,23,867,808,1675,2392
0130-001,2013,12,5,24,589,528,1117,1675
0130-001,2013,12,6,1,386,318,704,1117
0130-001,2013,12,6,2,278,250,528,704
0130-001,2013,12,6,3,191,200,391,528
0130-001,2013,12,6,4,170,166,336,391
0130-001,2013,12,6,5,169,211,380,336
0130-001,2013,12,6,6,325,346,671,380
0130-001,2013,12,6,7,1195,683,1878,671
0130-001,2013,12,6,8,2095,1623,3718,1878
0130-001,2013,12,6,9,2158,2068,4226,3718
0130-001,2013,12,6,10,1776,1630,3406,4226
0130-001,2013,12,6,11,1850,1733,3583,3406
0130-001,2013,12,6,12,1633,1697,3330,3583
0130-001,2013,12,6,13,1540,1520,3060,3330
0130-001,2013,12,6,14,1748,1856,3604,3060
0130-001,2013,12,6,15,1876,1951,3827,3604
0130-001,2013,12,6,16,1863,1927,3790,3827
0130-001,2013,12,6,17,1917,1942,3859,3790
0130-001,2013,12,6,18,1921,2433,4354,3859
0130-001,2013,12,6,19,1890,2520,4410,4354
0130-001,2013,12,6,20,1539,2053,3592,4410
0130-001,2013,12,6,21,1256,1592,2848,3592
0130-001,2013,12,6,22,1243,1312,2555,2848
0130-001,2013,12,6,23,958,879,1837,2555
0130-001,2013,12,6,24,658,589,1247,1837
0130-001,2013,12,7,1,499,427,926,1247
0130-001,2013,12,7,2,341,306,647,926
0130-001,2013,12,7,3,289,256,545,647
0130-001,2013,12,7,4,172,198,370,545
0130-001,2013,12,7,5,201,253,454,370
0130-001,2013,12,7,6,343,340,683,454
0130-001,2013,12,7,7,804,631,1435,683
0130-001,2013,12,7,8,1383,994,2377,1435
0130-001,2013,12,7,9,1519,1528,3047,2377
0130-001,2013,12,7,10,1653,1797,3450,3047
0130-001,2013,12,7,11,1647,1763,3410,3450
0130-001,2013,12,7,12,1710,2060,3770,3410
0130-001,2013,12,7,13,1659,1986,3645,3770
0130-001,2013,12,7,14,1806,1873,3679,3645
0130-001,2013,12,7,15,1736,1889,3625,3679
0130-001,2013,12,7,16,1820,1872,3692,3625
0130-001,2013,12,7,17,1913,1872,3785,3692
0130-001,2013,12,7,18,1981,2223,4204,3785
0130-001,2013,12,7,19,1666,1927,3593,4204
0130-001,2013,12,7,20,1302,1206,2508,3593
0130-001,2013,12,7,21,1111,1033,2144,2508
0130-001,2013,12,7,22,1077,899,1976,2144
0130-001,2013,12,7,23,803,677,1480,1976
0130-001,2013,12,7,24,594,474,1068,1480
0130-001,2013,12,8,1,446,418,864,1068
0130-001,2013,12,8,2,321,289,610,864
0130-001,2013,12,8,3,257,215,472,610
0130-001,2013,12,8,4,215,178,393,472
0130-001,2013,12,8,5,185,166,351,393
0130-001,2013,12,8,6,231,221,452,351
0130-001,2013,12,8,7,481,393,874,452
0130-001,2013,12,8,8,693,517,1210,874
0130-001,2013,12,8,9,822,882,1704,1210
0130-001,2013,12,8,10,941,1001,1942,1704
0130-001,2013,12,8,11,1178,1201,2379,1942
0130-001,2013,12,8,12,1231,1362,2593,2379
0130-001,2013,12,8,13,1364,1433,2797,2593
0130-001,2013,12,8,14,1566,1612,3178,2797
0130-001,2013,12,8,15,1653,1536,3189,3178
0130-001,2013,12,8,16,1596,1535,3131,3189
0130-001,2013,12,8,17,1809,1615,3424,3131
0130-001,2013,12,8,18,1711,1581,3292,3424
0130-001,2013,12,8,19,1704,1306,3010,3292
0130-001,2013,12,8,20,1313,1059,2372,3010
0130-001,2013,12,8,21,1074,854,1928,2372
0130-001,2013,12,8,22,896,753,1649,1928
0130-001,2013,12,8,23,601,509,1110,1649
0130-001,2013,12,8,24,449,324,773,1110
0130-001,2013,12,9,1,284,250,534,773
0130-001,2013,12,9,2,177,143,320,534
0130-001,2013,12,9,3,130,116,246,320
0130-001,2013,12,9,4,116,133,249,246
0130-001,2013,12,9,5,147,195,342,249
0130-001,2013,12,9,6,321,326,647,342
0130-001,2013,12,9,7,1223,722,1945,647
0130-001,2013,12,9,8,1997,1653,3650,1945
0130-001,2013,12,9,9,2130,2075,4205,3650
0130-001,2013,12,9,10,1695,1590,3285,4205
0130-001,2013,12,9,11,1621,1689,3310,3285
0130-001,2013,12,9,12,1593,1617,3210,3310
0130-001,2013,12,9,13,1472,1430,2902,3210
0130-001,2013,12,9,14,1635,1681,3316,2902
0130-001,2013,12,9,15,1701,1692,3393,3316
0130-001,2013,12,9,16,1663,1754,3417,3393
0130-001,2013,12,9,17,1680,1760,3440,3417
0130-001,2013,12,9,18,1632,2151,3783,3440
0130-001,2013,12,9,19,1609,1904,3513,3783
0130-001,2013,12,9,20,1224,1850,3074,3513
0130-001,2013,12,9,21,1100,1548,2648,3074
0130-001,2013,12,9,22,1038,1203,2241,2648
0130-001,2013,12,9,23,757,755,1512,2241
0130-001,2013,12,9,24,477,422,899,1512
0130-001,2013,12,10,1,321,304,625,899
0130-001,2013,12,10,2,212,184,396,625
0130-001,2013,12,10,3,137,152,289,396
0130-001,2013,12,10,4,118,142,260,289
0130-001,2013,12,10,5,181,224,405,260
0130-001,2013,12,10,6,287,310,597,405
0130-001,2013,12,10,7,1189,662,1851,597
0130-001,2013,12,10,8,2130,1682,3812,1851
0130-001,2013,12,10,9,2146,1995,4141,3812
0130-001,2013,12,10,10,1834,1657,3491,4141
0130-001,2013,12,10,11,1708,1749,3457,3491
0130-001,2013,12,10,12,1678,1587,3265,3457
0130-001,2013,12,10,13,1455,1526,2981,3265
0130-001,2013,12,10,14,1742,1824,3566,2981
0130-001,2013,12,10,15,1898,1823,3721,3566
0130-001,2013,12,10,16,1808,1803,3611,3721
0130-001,2013,12,10,17,1732,1983,3715,3611
0130-001,2013,12,10,18,1741,2309,4050,3715
0130-001,2013,12,10,19,1636,2356,3992,4050
0130-001,2013,12,10,20,1346,1712,3058,3992
0130-001,2013,12,10,21,1185,1514,2699,3058
0130-001,2013,12,10,22,1072,1325,2397,2699
0130-001,2013,12,10,23,870,758,1628,2397
0130-001,2013,12,10,24,572,503,1075,1628
0130-001,2013,12,11,1,419,360,779,1075
0130-001,2013,12,11,2,272,246,518,779
0130-001,2013,12,11,3,204,197,401,518
0130-001,2013,12,11,4,153,161,314,401
0130-001,2013,12,11,5,184,200,384,314
0130-001,2013,12,11,6,293,314,607,384
0130-001,2013,12,11,7,1045,629,1674,607
0130-001,2013,12,11,8,1822,1466,3288,1674
0130-001,2013,12,11,9,1861,1894,3755,3288
0130-001,2013,12,11,10,1638,1514,3152,3755
0130-001,2013,12,11,11,1627,1561,3188,3152
0130-001,2013,12,11,12,1595,1578,3173,3188
0130-001,2013,12,11,13,1412,1420,2832,3173
0130-001,2013,12,11,14,1626,1646,3272,2832
0130-001,2013,12,11,15,1714,1704,3418,3272
0130-001,2013,12,11,16,1555,1706,3261,3418
0130-001,2013,12,11,17,1387,1789,3176,3261
0130-001,2013,12,11,18,1400,1785,3185,3176
0130-001,2013,12,11,19,1367,2010,3377,3185
0130-001,2013,12,11,20,1126,1655,2781,3377
0130-001,2013,12,11,21,807,1140,1947,2781
0130-001,2013,12,11,22,706,817,1523,1947
0130-001,2013,12,11,23,578,486,1064,1523
0130-001,2013,12,11,24,366,315,681,1064
0130-001,2013,12,12,1,246,238,484,681
0130-001,2013,12,12,2,183,181,364,484
0130-001,2013,12,12,3,125,122,247,364
0130-001,2013,12,12,4,101,130,231,247
0130-001,2013,12,12,5,140,169,309,231
0130-001,2013,12,12,6,251,273,524,309
0130-001,2013,12,12,7,912,558,1470,524
0130-001,2013,12,12,8,1610,1359,2969,1470
0130-001,2013,12,12,9,1589,1723,3312,2969
0130-001,2013,12,12,10,1678,1435,3113,3312
0130-001,2013,12,12,11,1560,1424,2984,3113
0130-001,2013,12,12,12,1590,1399,2989,2984
0130-001,2013,12,12,13,1368,1360,2728,2989
0130-001,2013,12,12,14,1664,1593,3257,2728
0130-001,2013,12,12,15,1619,1609,3228,3257
0130-001,2013,12,12,16,1651,1517,3168,3228
0130-001,2013,12,12,17,1572,1542,3114,3168
0130-001,2013,12,12,18,1519,1876,3395,3114
0130-001,2013,12,12,19,1473,1925,3398,3395
0130-001,2013,12,12,20,1023,1289,2312,3398
0130-001,2013,12,12,21,900,1211,2111,2312
0130-001,2013,12,12,22,936,909,1845,2111
0130-001,2013,12,12,23,710,585,1295,1845
0130-001,2013,12,12,24,447,422,869,1295
0130-001,2013,12,13,1,386,287,673,869
0130-001,2013,12,13,2,187,195,382,673
0130-001,2013,12,13,3,154,135,289,382
0130-001,2013,12,13,4,144,173,317,289
0130-001,2013,12,13,5,168,177,345,317
0130-001,2013,12,13,6,258,270,528,345
0130-001,2013,12,13,7,961,567,1528,528
0130-001,2013,12,13,8,2032,1484,3516,1528
0130-001,2013,12,13,9,1924,1874,3798,3516
0130-001,2013,12,13,10,1619,1527,3146,3798
0130-001,2013,12,13,11,1702,1607,3309,3146
0130-001,2013,12,13,12,1553,1693,3246,3309
0130-001,2013,12,13,13,1489,1401,2890,3246
0130-001,2013,12,13,14,1736,1778,3514,2890
0130-001,2013,12,13,15,1815,1837,3652,3514
0130-001,2013,12,13,16,1843,1846,3689,3652
0130-001,2013,12,13,17,1805,1947,3752,3689
0130-001,2013,12,13,18,1858,2293,4151,3752
0130-001,2013,12,13,19,1881,2413,4294,4151
0130-001,2013,12,13,20,1428,1838,3266,4294
0130-001,2013,12,13,21,1198,1500,2698,3266
0130-001,2013,12,13,22,1151,1139,2290,2698
0130-001,2013,12,13,23,928,747,1675,2290
0130-001,2013,12,13,24,647,607,1254,1675
0130-001,2013,12,14,1,438,408,846,1254
0130-001,2013,12,14,2,362,311,673,846
0130-001,2013,12,14,3,278,240,518,673
0130-001,2013,12,14,4,202,215,417,518
0130-001,2013,12,14,5,165,201,366,417
0130-001,2013,12,14,6,299,333,632,366
0130-001,2013,12,14,7,618,456,1074,632
0130-001,2013,12,14,8,1218,838,2056,1074
0130-001,2013,12,14,9,1366,1392,2758,2056
0130-001,2013,12,14,10,1456,1549,3005,2758
0130-001,2013,12,14,11,1539,1748,3287,3005
0130-001,2013,12,14,12,1847,1887,3734,3287
0130-001,2013,12,14,13,1742,2125,3867,3734
0130-001,2013,12,14,14,1739,2018,3757,3867
0130-001,2013,12,14,15,1781,1907,3688,3757
0130-001,2013,12,14,16,1886,1769,3655,3688
0130-001,2013,12,14,17,1985,1875,3860,3655
0130-001,2013,12,14,18,1904,2037,3941,3860
0130-001,2013,12,14,19,1743,1786,3529,3941
0130-001,2013,12,14,20,1177,1155,2332,3529
0130-001,2013,12,14,21,1006,976,1982,2332
0130-001,2013,12,14,22,946,937,1883,1982
0130-001,2013,12,14,23,807,741,1548,1883
0130-001,2013,12,14,24,599,492,1091,1548
0130-001,2013,12,15,1,464,424,888,1091
0130-001,2013,12,15,2,370,300,670,888
0130-001,2013,12,15,3,253,225,478,670
0130-001,2013,12,15,4,222,186,408,478
0130-001,2013,12,15,5,191,170,361,408
0130-001,2013,12,15,6,228,244,472,361
0130-001,2013,12,15,7,402,336,738,472
0130-001,2013,12,15,8,614,520,1134,738
0130-001,2013,12,15,9,782,830,1612,1134
0130-001,2013,12,15,10,896,994,1890,1612
0130-001,2013,12,15,11,1033,1249,2282,1890
0130-001,2013,12,15,12,1124,1411,2535,2282
0130-001,2013,12,15,13,1263,1498,2761,2535
0130-001,2013,12,15,14,1479,1617,3096,2761
0130-001,2013,12,15,15,1608,1599,3207,3096
0130-001,2013,12,15,16,1746,1637,3383,3207
0130-001,2013,12,15,17,1790,1561,3351,3383
0130-001,2013,12,15,18,1788,1563,3351,3351
0130-001,2013,12,15,19,1592,1219,2811,3351
0130-001,2013,12,15,20,1140,987,2127,2811
0130-001,2013,12,15,21,974,785,1759,2127
0130-001,2013,12,15,22,870,764,1634,1759
0130-001,2013,12,15,23,643,465,1108,1634
0130-001,2013,12,15,24,437,358,795,1108
0130-001,2013,12,16,1,310,272,582,795
0130-001,2013,12,16,2,170,176,346,582
0130-001,2013,12,16,3,126,111,237,346
0130-001,2013,12,16,4,130,130,260,237
0130-001,2013,12,16,5,137,179,316,260
0130-001,2013,12,16,6,331,339,670,316
0130-001,2013,12,16,7,1301,689,1990,670
0130-001,2013,12,16,8,2052,1686,3738,1990
0130-001,2013,12,16,9,2246,2037,4283,3738
0130-001,2013,12,16,10,1692,1625,3317,4283
0130-001,2013,12,16,11,1795,1706,3501,3317
0130-001,2013,12,16,12,1685,1578,3263,3501
0130-001,2013,12,16,13,1482,1495,2977,3263
0130-001,2013,12,16,14,1778,1760,3538,2977
0130-001,2013,12,16,15,1870,1855,3725,3538
0130-001,2013,12,16,16,1849,1961,3810,3725
0130-001,2013,12,16,17,1739,1922,3661,3810
0130-001,2013,12,16,18,1761,2140,3901,3661
0130-001,2013,12,16,19,1669,2385,4054,3901
0130-001,2013,12,16,20,1334,1681,3015,4054
0130-001,2013,12,16,21,1124,1461,2585,3015
0130-001,2013,12,16,22,1032,1191,2223,2585
0130-001,2013,12,16,23,778,731,1509,2223
0130-001,2013,12,16,24,540,479,1019,1509
0130-001,2013,12,17,1,332,315,647,1019
0130-001,2013,12,17,2,210,197,407,647
0130-001,2013,12,17,3,162,176,338,407
0130-001,2013,12,17,4,128,171,299,338
0130-001,2013,12,17,5,165,208,373,299
0130-001,2013,12,17,6,326,321,647,373
0130-001,2013,12,17,7,1153,652,1805,647
0130-001,2013,12,17,8,1979,1698,3677,1805
0130-001,2013,12,17,9,2176,2028,4204,3677
0130-001,2013,12,17,10,1734,1661,3395,4204
0130-001,2013,12,17,11,1853,1727,3580,3395
0130-001,2013,12,17,12,1662,1677,3339,3580
0130-001,2013,12,17,13,1461,1463,2924,3339
0130-001,2013,12,17,14,1738,1723,3461,2924
0130-001,2013,12,17,15,1840,1878,3718,3461
0130-001,2013,12,17,16,1872,1935,3807,3718
0130-001,2013,12,17,17,1739,1867,3606,3807
0130-001,2013,12,17,18,1805,2208,4013,3606
0130-001,2013,12,17,19,1587,2250,3837,4013
0130-001,2013,12,17,20,1300,1767,3067,3837
0130-001,2013,12,17,21,1186,1517,2703,3067
0130-001,2013,12,17,22,1084,1190,2274,2703
0130-001,2013,12,17,23,826,745,1571,2274
0130-001,2013,12,17,24,524,508,1032,1571
0130-001,2013,12,18,1,410,345,755,1032
0130-001,2013,12,18,2,241,232,473,755
0130-001,2013,12,18,3,161,183,344,473
0130-001,2013,12,18,4,147,146,293,344
0130-001,2013,12,18,5,171,220,391,293
0130-001,2013,12,18,6,308,349,657,391
0130-001,2013,12,18,7,1137,659,1796,657
0130-001,2013,12,18,8,2026,1649,3675,1796
0130-001,2013,12,18,9,2182,2013,4195,3675
0130-001,2013,12,18,10,1766,1665,3431,4195
0130-001,2013,12,18,11,1796,1781,3577,3431
0130-001,2013,12,18,12,1594,1683,3277,3577
0130-001,2013,12,18,13,1505,1485,2990,3277
0130-001,2013,12,18,14,1755,1744,3499,2990
0130-001,2013,12,18,15,1924,1900,3824,3499
0130-001,2013,12,18,16,1834,1952,3786,3824
0130-001,2013,12,18,17,1802,1923,3725,3786
0130-001,2013,12,18,18,1817,2369,4186,3725
0130-001,2013,12,18,19,1735,2482,4217,4186
0130-001,2013,12,18,20,1342,1792,3134,4217
0130-001,2013,12,18,21,1278,1557,2835,3134
0130-001,2013,12,18,22,1183,1214,2397,2835
0130-001,2013,12,18,23,952,722,1674,2397
0130-001,2013,12,18,24,632,486,1118,1674
0130-001,2013,12,19,1,461,398,859,1118
0130-001,2013,12,19,2,287,266,553,859
0130-001,2013,12,19,3,186,213,399,553
0130-001,2013,12,19,4,159,180,339,399
0130-001,2013,12,19,5,148,213,361,339
0130-001,2013,12,19,6,293,331,624,361
0130-001,2013,12,19,7,1071,613,1684,624
0130-001,2013,12,19,8,1877,1455,3332,1684
0130-001,2013,12,19,9,1813,1684,3497,3332
0130-001,2013,12,19,10,852,822,1674,3497
0130-001,2013,12,19,11,814,766,1580,1674
0130-001,2013,12,19,12,1042,1129,2171,1580
0130-001,2013,12,19,13,1127,1243,2370,2171
0130-001,2013,12,19,14,1278,1643,2921,2370
0130-001,2013,12,19,15,1433,1803,3236,2921
0130-001,2013,12,19,16,1503,1735,3238,3236
0130-001,2013,12,19,17,1453,1652,3105,3238
0130-001,2013,12,19,18,1274,1351,2625,3105
0130-001,2013,12,19,19,1115,1014,2129,2625
0130-001,2013,12,19,20,1059,1032,2091,2129
0130-001,2013,12,19,21,767,678,1445,2091
0130-001,2013,12,19,22,673,694,1367,1445
0130-001,2013,12,19,23,564,566,1130,1367
0130-001,2013,12,19,24,320,282,602,1130
0130-001,2013,12,20,1,246,182,428,602
0130-001,2013,12,20,2,129,172,301,428
0130-001,2013,12,20,3,108,108,216,301
0130-001,2013,12,20,4,110,101,211,216
0130-001,2013,12,20,5,112,151,263,211
0130-001,2013,12,20,6,230,277,507,263
0130-001,2013,12,20,7,746,445,1191,507
0130-001,2013,12,20,8,1295,1063,2358,1191
0130-001,2013,12,20,9,1091,1265,2356,2358
0130-001,2013,12,20,10,1378,1042,2420,2356
0130-001,2013,12,20,11,1405,1292,2697,2420
0130-001,2013,12,20,12,1302,1439,2741,2697
0130-001,2013,12,20,13,1240,1334,2574,2741
0130-001,2013,12,20,14,1516,1593,3109,2574
0130-001,2013,12,20,15,1637,1623,3260,3109
0130-001,2013,12,20,16,1665,1704,3369,3260
0130-001,2013,12,20,17,1605,1750,3355,3369
0130-001,2013,12,20,18,1747,2022,3769,3355
0130-001,2013,12,20,19,1562,1929,3491,3769
0130-001,2013,12,20,20,1204,1718,2922,3491
0130-001,2013,12,20,21,1075,1270,2345,2922
0130-001,2013,12,20,22,1043,985,2028,2345
0130-001,2013,12,20,23,866,692,1558,2028
0130-001,2013,12,20,24,592,507,1099,1558
0130-001,2013,12,21,1,443,398,841,1099
0130-001,2013,12,21,2,367,337,704,841
0130-001,2013,12,21,3,279,233,512,704
0130-001,2013,12,21,4,214,196,410,512
0130-001,2013,12,21,5,192,261,453,410
0130-001,2013,12,21,6,302,349,651,453
0130-001,2013,12,21,7,647,478,1125,651
0130-001,2013,12,21,8,1209,816,2025,1125
0130-001,2013,12,21,9,1354,1330,2684,2025
0130-001,2013,12,21,10,1360,1545,2905,2684
0130-001,2013,12,21,11,1555,1727,3282,2905
0130-001,2013,12,21,12,1645,1912,3557,3282
0130-001,2013,12,21,13,1601,2059,3660,3557
0130-001,2013,12,21,14,1788,2043,3831,3660
0130-001,2013,12,21,15,1867,1811,3678,3831
0130-001,2013,12,21,16,1742,1899,3641,3678
0130-001,2013,12,21,17,1931,1890,3821,3641
0130-001,2013,12,21,18,1868,1989,3857,3821
0130-001,2013,12,21,19,1749,1788,3537,3857
0130-001,2013,12,21,20,1324,1095,2419,3537
0130-001,2013,12,21,21,1041,968,2009,2419
0130-001,2013,12,21,22,1009,916,1925,2009
0130-001,2013,12,21,23,827,674,1501,1925
0130-001,2013,12,21,24,612,468,1080,1501
0130-001,2013,12,22,1,490,404,894,1080
0130-001,2013,12,22,2,370,323,693,894
0130-001,2013,12,22,3,256,227,483,693
0130-001,2013,12,22,4,216,176,392,483
0130-001,2013,12,22,5,183,181,364,392
0130-001,2013,12,22,6,229,246,475,364
0130-001,2013,12,22,7,415,358,773,475
0130-001,2013,12,22,8,572,446,1018,773
0130-001,2013,12,22,9,734,709,1443,1018
0130-001,2013,12,22,10,829,1016,1845,1443
0130-001,2013,12,22,11,1033,1179,2212,1845
0130-001,2013,12,22,12,1147,1308,2455,2212
0130-001,2013,12,22,13,1306,1395,2701,2455
0130-001,2013,12,22,14,1556,1534,3090,2701
0130-001,2013,12,22,15,1727,1525,3252,3090
0130-001,2013,12,22,16,1698,1538,3236,3252
0130-001,2013,12,22,17,1769,1628,3397,3236
0130-001,2013,12,22,18,1568,1398,2966,3397
0130-001,2013,12,22,19,1524,1198,2722,2966
0130-001,2013,12,22,20,1109,909,2018,2722
0130-001,2013,12,22,21,958,805,1763,2018
0130-001,2013,12,22,22,832,687,1519,1763
0130-001,2013,12,22,23,596,472,1068,1519
0130-001,2013,12,22,24,361,321,682,1068
0130-001,2013,12,23,1,274,232,506,682
0130-001,2013,12,23,2,181,153,334,506
0130-001,2013,12,23,3,108,119,227,334
0130-001,2013,12,23,4,117,133,250,227
0130-001,2013,12,23,5,139,204,343,250
0130-001,2013,12,23,6,336,361,697,343
0130-001,2013,12,23,7,1264,708,1972,697
0130-001,2013,12,23,8,1996,1648,3644,1972
0130-001,2013,12,23,9,2185,1958,4143,3644
0130-001,2013,12,23,10,1650,1631,3281,4143
0130-001,2013,12,23,11,1785,1826,3611,3281
0130-001,2013,12,23,12,1729,1720,3449,3611
0130-001,2013,12,23,13,1572,1622,3194,3449
0130-001,2013,12,23,14,1851,1853,3704,3194
0130-001,2013,12,23,15,1784,1871,3655,3704
0130-001,2013,12,23,16,1750,1933,3683,3655
0130-001,2013,12,23,17,1848,1911,3759,3683
0130-001,2013,12,23,18,1756,2262,4018,3759
0130-001,2013,12,23,19,1631,2402,4033,4018
0130-001,2013,12,23,20,1303,1847,3150,4033
0130-001,2013,12,23,21,1174,1498,2672,3150
0130-001,2013,12,23,22,1157,1190,2347,2672
0130-001,2013,12,23,23,878,780,1658,2347
0130-001,2013,12,23,24,580,479,1059,1658
0130-001,2013,12,24,1,422,359,781,1059
0130-001,2013,12,24,2,281,219,500,781
0130-001,2013,12,24,3,160,174,334,500
0130-001,2013,12,24,4,164,172,336,334
0130-001,2013,12,24,5,181,233,414,336
0130-001,2013,12,24,6,351,353,704,414
0130-001,2013,12,24,7,1080,655,1735,704
0130-001,2013,12,24,8,1922,1548,3470,1735
0130-001,2013,12,24,9,2108,1927,4035,3470
0130-001,2013,12,24,10,1793,1613,3406,4035
0130-001,2013,12,24,11,1852,1819,3671,3406
0130-001,2013,12,24,12,1788,1789,3577,3671
0130-001,2013,12,24,13,1565,1650,3215,3577
0130-001,2013,12,24,14,1892,1869,3761,3215
0130-001,2013,12,24,15,1856,1906,3762,3761
0130-001,2013,12,24,16,1832,1929,3761,3762
0130-001,2013,12,24,17,1841,1982,3823,3761
0130-001,2013,12,24,18,1886,2372,4258,3823
0130-001,2013,12,24,19,1873,2466,4339,4258
0130-001,2013,12,24,20,1574,2240,3814,4339
0130-001,2013,12,24,21,1358,1656,3014,3814
0130-001,2013,12,24,22,1185,1271,2456,3014
0130-001,2013,12,24,23,987,722,1709,2456
0130-001,2013,12,24,24,625,571,1196,1709
0130-001,2013,12,25,1,480,414,894,1196
0130-001,2013,12,25,2,334,327,661,894
0130-001,2013,12,25,3,273,211,484,661
0130-001,2013,12,25,4,258,215,473,484
0130-001,2013,12,25,5,240,246,486,473
0130-001,2013,12,25,6,299,296,595,486
0130-001,2013,12,25,7,610,423,1033,595
0130-001,2013,12,25,8,900,670,1570,1033
0130-001,2013,12,25,9,869,904,1773,1570
0130-001,2013,12,25,10,1028,965,1993,1773
0130-001,2013,12,25,11,1231,1336,2567,1993
0130-001,2013,12,25,12,1171,1388,2559,2567
0130-001,2013,12,25,13,1282,1563,2845,2559
0130-001,2013,12,25,14,1467,1738,3205,2845
0130-001,2013,12,25,15,1521,1576,3097,3205
0130-001,2013,12,25,16,1563,1546,3109,3097
0130-001,2013,12,25,17,1576,1560,3136,3109
0130-001,2013,12,25,18,1558,1662,3220,3136
0130-001,2013,12,25,19,1389,1344,2733,3220
0130-001,2013,12,25,20,1110,1004,2114,2733
0130-001,2013,12,25,21,1069,865,1934,2114
0130-001,2013,12,25,22,989,706,1695,1934
0130-001,2013,12,25,23,721,528,1249,1695
0130-001,2013,12,25,24,457,369,826,1249
0130-001,2013,12,26,1,321,278,599,826
0130-001,2013,12,26,2,205,191,396,599
0130-001,2013,12,26,3,130,132,262,396
0130-001,2013,12,26,4,132,144,276,262
0130-001,2013,12,26,5,171,217,388,276
0130-001,2013,12,26,6,337,327,664,388
0130-001,2013,12,26,7,1217,650,1867,664
0130-001,2013,12,26,8,2040,1614,3654,1867
0130-001,2013,12,26,9,2024,1939,3963,3654
0130-001,2013,12,26,10,1722,1677,3399,3963
0130-001,2013,12,26,11,1857,1653,3510,3399
0130-001,2013,12,26,12,1620,1722,3342,3510
0130-001,2013,12,26,13,1595,1583,3178,3342
0130-001,2013,12,26,14,1733,1766,3499,3178
0130-001,2013,12,26,15,1775,1821,3596,3499
0130-001,2013,12,26,16,1713,1834,3547,3596
0130-001,2013,12,26,17,1564,1862,3426,3547
0130-001,2013,12,26,18,1638,2170,3808,3426
0130-001,2013,12,26,19,1528,2191,3719,3808
0130-001,2013,12,26,20,1140,1486,2626,3719
0130-001,2013,12,26,21,1034,1363,2397,2626
0130-001,2013,12,26,22,988,1113,2101,2397
0130-001,2013,12,26,23,788,684,1472,2101
0130-001,2013,12,26,24,557,444,1001,1472
0130-001,2013,12,27,1,417,332,749,1001
0130-001,2013,12,27,2,295,246,541,749
0130-001,2013,12,27,3,185,189,374,541
0130-001,2013,12,27,4,148,165,313,374
0130-001,2013,12,27,5,179,214,393,313
0130-001,2013,12,27,6,309,343,652,393
0130-001,2013,12,27,7,1020,608,1628,652
0130-001,2013,12,27,8,1987,1557,3544,1628
0130-001,2013,12,27,9,1926,1880,3806,3544
0130-001,2013,12,27,10,1651,1598,3249,3806
0130-001,2013,12,27,11,1754,1695,3449,3249
0130-001,2013,12,27,12,1691,1758,3449,3449
0130-001,2013,12,27,13,1501,1577,3078,3449
0130-001,2013,12,27,14,1791,1856,3647,3078
0130-001,2013,12,27,15,1836,1838,3674,3647
0130-001,2013,12,27,16,1789,1875,3664,3674
0130-001,2013,12,27,17,1856,1926,3782,3664
0130-001,2013,12,27,18,1815,2307,4122,3782
0130-001,2013,12,27,19,1822,2299,4121,4122
0130-001,2013,12,27,20,1411,1903,3314,4121
0130-001,2013,12,27,21,1212,1453,2665,3314
0130-001,2013,12,27,22,1246,1253,2499,2665
0130-001,2013,12,27,23,998,797,1795,2499
0130-001,2013,12,27,24,729,643,1372,1795
0130-001,2013,12,28,1,563,483,1046,1372
0130-001,2013,12,28,2,386,319,705,1046
0130-001,2013,12,28,3,263,263,526,705
0130-001,2013,12,28,4,232,216,448,526
0130-001,2013,12,28,5,228,277,505,448
0130-001,2013,12,28,6,275,334,609,505
0130-001,2013,12,28,7,658,498,1156,609
0130-001,2013,12,28,8,1248,868,2116,1156
0130-001,2013,12,28,9,1346,1314,2660,2116
0130-001,2013,12,28,10,1446,1567,3013,2660
0130-001,2013,12,28,11,1628,1766,3394,3013
0130-001,2013,12,28,12,1682,1829,3511,3394
0130-001,2013,12,28,13,1713,1898,3611,3511
0130-001,2013,12,28,14,1848,1915,3763,3611
0130-001,2013,12,28,15,1738,1855,3593,3763
0130-001,2013,12,28,16,1785,1848,3633,3593
0130-001,2013,12,28,17,1801,1713,3514,3633
0130-001,2013,12,28,18,1883,2085,3968,3514
0130-001,2013,12,28,19,1705,1732,3437,3968
0130-001,2013,12,28,20,1106,1052,2158,3437
0130-001,2013,12,28,21,927,932,1859,2158
0130-001,2013,12,28,22,958,801,1759,1859
0130-001,2013,12,28,23,690,640,1330,1759
0130-001,2013,12,28,24,517,448,965,1330
0130-001,2013,12,29,1,386,337,723,965
0130-001,2013,12,29,2,310,248,558,723
0130-001,2013,12,29,3,257,237,494,558
0130-001,2013,12,29,4,208,159,367,494
0130-001,2013,12,29,5,204,181,385,367
0130-001,2013,12,29,6,201,205,406,385
0130-001,2013,12,29,7,406,330,736,406
0130-001,2013,12,29,8,542,474,1016,736
0130-001,2013,12,29,9,690,713,1403,1016
0130-001,2013,12,29,10,834,962,1796,1403
0130-001,2013,12,29,11,981,1190,2171,1796
0130-001,2013,12,29,12,1010,1305,2315,2171
0130-001,2013,12,29,13,1133,1401,2534,2315
0130-001,2013,12,29,14,1426,1409,2835,2534
0130-001,2013,12,29,15,1552,1477,3029,2835
0130-001,2013,12,29,16,1645,1437,3082,3029
0130-001,2013,12,29,17,1768,1518,3286,3082
0130-001,2013,12,29,18,1699,1391,3090,3286
0130-001,2013,12,29,19,1475,1151,2626,3090
0130-001,2013,12,29,20,1073,933,2006,2626
0130-001,2013,12,29,21,928,814,1742,2006
0130-001,2013,12,29,22,841,666,1507,1742
0130-001,2013,12,29,23,617,456,1073,1507
0130-001,2013,12,29,24,409,348,757,1073
0130-001,2013,12,30,1,291,252,543,757
0130-001,2013,12,30,2,171,159,330,543
0130-001,2013,12,30,3,145,124,269,330
0130-001,2013,12,30,4,128,128,256,269
0130-001,2013,12,30,5,155,196,351,256
0130-001,2013,12,30,6,325,294,619,351
0130-001,2013,12,30,7,1131,622,1753,619
0130-001,2013,12,30,8,2059,1590,3649,1753
0130-001,2013,12,30,9,2038,1855,3893,3649
0130-001,2013,12,30,10,1654,1608,3262,3893
0130-001,2013,12,30,11,1738,1726,3464,3262
0130-001,2013,12,30,12,1780,1687,3467,3464
0130-001,2013,12,30,13,1556,1763,3319,3467
0130-001,2013,12,30,14,1762,1814,3576,3319
0130-001,2013,12,30,15,1987,1917,3904,3576
0130-001,2013,12,30,16,1871,1915,3786,3904
0130-001,2013,12,30,17,1772,1866,3638,3786
0130-001,2013,12,30,18,1752,2325,4077,3638
0130-001,2013,12,30,19,1632,2407,4039,4077
0130-001,2013,12,30,20,1320,1513,2833,4039
0130-001,2013,12,30,21,1154,1400,2554,2833
0130-001,2013,12,30,22,1068,1098,2166,2554
0130-001,2013,12,30,23,866,741,1607,2166
0130-001,2013,12,30,24,607,549,1156,1607
0130-001,2013,12,31,1,489,397,886,1156
0130-001,2013,12,31,2,336,292,628,886
0130-001,2013,12,31,3,195,198,393,628
0130-001,2013,12,31,4,189,204,393,393
0130-001,2013,12,31,5,210,236,446,393
0130-001,2013,12,31,6,300,330,630,446
0130-001,2013,12,31,7,941,570,1511,630
0130-001,2013,12,31,8,2008,1445,3453,1511
0130-001,2013,12,31,9,1833,1828,3661,3453
0130-001,2013,12,31,10,1671,1487,3158,3661
0130-001,2013,12,31,11,1757,1709,3466,3158
0130-001,2013,12,31,12,1747,1859,3606,3466
0130-001,2013,12,31,13,1658,1771,3429,3606
0130-001,2013,12,31,14,1808,1964,3772,3429
0130-001,2013,12,31,15,1840,2127,3967,3772
0130-001,2013,12,31,16,1856,2123,3979,3967
0130-001,2013,12,31,17,1964,2279,4243,3979
0130-001,2013,12,31,18,1967,2394,4361,4243
0130-001,2013,12,31,19,1759,2293,4052,4361
0130-001,2013,12,31,20,1476,1455,2931,4052
0130-001,2013,12,31,21,1190,1217,2407,2931
0130-001,2013,12,31,22,1000,1001,2001,2407
0130-001,2013,12,31,23,858,770,1628,2001
0130-001,2013,12,31,24,606,537,1143,1628
0130-001,2014,1,1,1,546,436,982,1143
0130-001,2014,1,1,2,498,410,908,982
0130-001,2014,1,1,3,312,317,629,908
0130-001,2014,1,1,4,245,224,469,629
0130-001,2014,1,1,5,234,224,458,469
0130-001,2014,1,1,6,242,282,524,458
0130-001,2014,1,1,7,413,308,721,524
0130-001,2014,1,1,8,479,439,918,721
0130-001,2014,1,1,9,512,631,1143,918
0130-001,2014,1,1,10,686,757,1443,1143
0130-001,2014,1,1,11,886,997,1883,1443
0130-001,2014,1,1,12,1107,1181,2288,1883
0130-001,2014,1,1,13,1165,1286,2451,2288
0130-001,2014,1,1,14,1216,1345,2561,2451
0130-001,2014,1,1,15,1360,1436,2796,2561
0130-001,2014,1,1,16,1496,1353,2849,2796
0130-001,2014,1,1,17,1547,1333,2880,2849
0130-001,2014,1,1,18,1583,1417,3000,2880
0130-001,2014,1,1,19,1243,1165,2408,3000
0130-001,2014,1,1,20,1053,940,1993,2408
0130-001,2014,1,1,21,936,853,1789,1993
0130-001,2014,1,1,22,829,650,1479,1789
0130-001,2014,1,1,23,586,440,1026,1479
0130-001,2014,1,1,24,383,301,684,1026
0130-001,2014,1,2,1,270,236,506,684
0130-001,2014,1,2,2,163,134,297,506
0130-001,2014,1,2,3,103,116,219,297
0130-001,2014,1,2,4,122,92,214,219
0130-001,2014,1,2,5,124,132,256,214
0130-001,2014,1,2,6,304,340,644,256
0130-001,2014,1,2,7,1109,647,1756,644
0130-001,2014,1,2,8,2082,1558,3640,1756
0130-001,2014,1,2,9,1684,1822,3506,3640
0130-001,2014,1,2,10,1631,1457,3088,3506
0130-001,2014,1,2,11,1626,1667,3293,3088
0130-001,2014,1,2,12,1626,1588,3214,3293
0130-001,2014,1,2,13,1403,1543,2946,3214
0130-001,2014,1,2,14,1658,1683,3341,2946
0130-001,2014,1,2,15,1768,1783,3551,3341
0130-001,2014,1,2,16,1838,1740,3578,3551
0130-001,2014,1,2,17,1607,1796,3403,3578
0130-001,2014,1,2,18,1784,2142,3926,3403
0130-001,2014,1,2,19,1672,2227,3899,3926
0130-001,2014,1,2,20,1272,1524,2796,3899
0130-001,2014,1,2,21,1117,1396,2513,2796
0130-001,2014,1,2,22,929,991,1920,2513
0130-001,2014,1,2,23,746,645,1391,1920
0130-001,2014,1,2,24,481,385,866,1391
0130-001,2014,1,3,1,351,330,681,866
0130-001,2014,1,3,2,223,199,422,681
0130-001,2014,1,3,3,157,155,312,422
0130-001,2014,1,3,4,139,178,317,312
0130-001,2014,1,3,5,167,207,374,317
0130-001,2014,1,3,6,356,364,720,374
0130-001,2014,1,3,7,1120,642,1762,720
0130-001,2014,1,3,8,2049,1474,3523,1762
0130-001,2014,1,3,9,1800,1823,3623,3523
0130-001,2014,1,3,10,1672,1512,3184,3623
0130-001,2014,1,3,11,1675,1756,3431,3184
0130-001,2014,1,3,12,1598,1618,3216,3431
0130-001,2014,1,3,13,1410,1541,2951,3216
0130-001,2014,1,3,14,1735,1739,3474,2951
0130-001,2014,1,3,15,1848,1772,3620,3474
0130-001,2014,1,3,16,1870,1856,3726,3620
0130-001,2014,1,3,17,1722,1880,3602,3726
0130-001,2014,1,3,18,1788,2254,4042,3602
0130-001,2014,1,3,19,1923,2396,4319,4042
0130-001,2014,1,3,20,1387,1795,3182,4319
0130-001,2014,1,3,21,1181,1488,2669,3182
0130-001,2014,1,3,22,1006,1089,2095,2669
0130-001,2014,1,3,23,895,816,1711,2095
0130-001,2014,1,3,24,599,507,1106,1711
0130-001,2014,1,4,1,423,369,792,1106
0130-001,2014,1,4,2,299,274,573,792
0130-001,2014,1,4,3,229,229,458,573
0130-001,2014,1,4,4,187,184,371,458
0130-001,2014,1,4,5,210,246,456,371
0130-001,2014,1,4,6,315,365,680,456
0130-001,2014,1,4,7,723,545,1268,680
0130-001,2014,1,4,8,1271,894,2165,1268
0130-001,2014,1,4,9,1322,1378,2700,2165
0130-001,2014,1,4,10,1481,1530,3011,2700
0130-001,2014,1,4,11,1636,1609,3245,3011
0130-001,2014,1,4,12,1528,1695,3223,3245
0130-001,2014,1,4,13,1463,1626,3089,3223
0130-001,2014,1,4,14,1569,1812,3381,3089
0130-001,2014,1,4,15,1692,1785,3477,3381
0130-001,2014,1,4,16,1671,1802,3473,3477
0130-001,2014,1,4,17,1726,1715,3441,3473
0130-001,2014,1,4,18,1880,1999,3879,3441
0130-001,2014,1,4,19,1696,1660,3356,3879
0130-001,2014,1,4,20,1275,1117,2392,3356
0130-001,2014,1,4,21,970,978,1948,2392
0130-001,2014,1,4,22,947,814,1761,1948
0130-001,2014,1,4,23,684,557,1241,1761
0130-001,2014,1,4,24,490,390,880,1241
0130-001,2014,1,5,1,368,337,705,880
0130-001,2014,1,5,2,272,259,531,705
0130-001,2014,1,5,3,203,188,391,531
0130-001,2014,1,5,4,194,158,352,391
0130-001,2014,1,5,5,192,180,372,352
0130-001,2014,1,5,6,210,235,445,372
0130-001,2014,1,5,7,429,352,781,445
0130-001,2014,1,5,8,589,481,1070,781
0130-001,2014,1,5,9,695,758,1453,1070
0130-001,2014,1,5,10,824,910,1734,1453
0130-001,2014,1,5,11,986,1097,2083,1734
0130-001,2014,1,5,12,1027,1246,2273,2083
0130-001,2014,1,5,13,1152,1436,2588,2273
0130-001,2014,1,5,14,1416,1521,2937,2588
0130-001,2014,1,5,15,1550,1439,2989,2937
0130-001,2014,1,5,16,1605,1545,3150,2989
0130-001,2014,1,5,17,1669,1427,3096,3150
0130-001,2014,1,5,18,1725,1476,3201,3096
0130-001,2014,1,5,19,1517,1173,2690,3201
0130-001,2014,1,5,20,1147,977,2124,2690
0130-001,2014,1,5,21,979,806,1785,2124
0130-001,2014,1,5,22,896,656,1552,1785
0130-001,2014,1,5,23,608,470,1078,1552
0130-001,2014,1,5,24,405,312,717,1078
0130-001,2014,1,6,1,247,232,479,717
0130-001,2014,1,6,2,162,153,315,479
0130-001,2014,1,6,3,124,109,233,315
0130-001,2014,1,6,4,103,120,223,233
0130-001,2014,1,6,5,146,187,333,223
0130-001,2014,1,6,6,361,333,694,333
0130-001,2014,1,6,7,1299,710,2009,694
0130-001,2014,1,6,8,2064,1552,3616,2009
0130-001,2014,1,6,9,1985,1872,3857,3616
0130-001,2014,1,6,10,1829,1675,3504,3857
0130-001,2014,1,6,11,1701,1694,3395,3504
0130-001,2014,1,6,12,1482,1622,3104,3395
0130-001,2014,1,6,13,1558,1513,3071,3104
0130-001,2014,1,6,14,1784,1754,3538,3071
0130-001,2014,1,6,15,1825,1811,3636,3538
0130-001,2014,1,6,16,1849,1811,3660,3636
0130-001,2014,1,6,17,1741,1862,3603,3660
0130-001,2014,1,6,18,1671,2233,3904,3603
0130-001,2014,1,6,19,1780,2220,4000,3904
0130-001,2014,1,6,20,1267,1565,2832,4000
0130-001,2014,1,6,21,1111,1494,2605,2832
0130-001,2014,1,6,22,956,1151,2107,2605
0130-001,2014,1,6,23,723,716,1439,2107
0130-001,2014,1,6,24,482,426,908,1439
0130-001,2014,1,7,1,307,302,609,908
0130-001,2014,1,7,2,194,189,383,609
0130-001,2014,1,7,3,136,160,296,383
0130-001,2014,1,7,4,142,174,316,296
0130-001,2014,1,7,5,151,201,352,316
0130-001,2014,1,7,6,274,342,616,352
0130-001,2014,1,7,7,1147,657,1804,616
0130-001,2014,1,7,8,2031,1529,3560,1804
0130-001,2014,1,7,9,1934,1920,3854,3560
0130-001,2014,1,7,10,1724,1663,3387,3854
0130-001,2014,1,7,11,1779,1706,3485,3387
0130-001,2014,1,7,12,1723,1602,3325,3485
0130-001,2014,1,7,13,1460,1513,2973,3325
0130-001,2014,1,7,14,1809,1776,3585,2973
0130-001,2014,1,7,15,1821,1780,3601,3585
0130-001,2014,1,7,16,1804,1868,3672,3601
0130-001,2014,1,7,17,1646,1805,3451,3672
0130-001,2014,1,7,18,1764,2107,3871,3451
0130-001,2014,1,7,19,1720,2253,3973,3871
0130-001,2014,1,7,20,1256,1560,2816,3973
0130-001,2014,1,7,21,1071,1559,2630,2816
0130-001,2014,1,7,22,993,1194,2187,2630
0130-001,2014,1,7,23,749,713,1462,2187
0130-001,2014,1,7,24,498,418,916,1462
0130-001,2014,1,8,1,329,275,604,916
0130-001,2014,1,8,2,222,231,453,604
0130-001,2014,1,8,3,180,164,344,453
0130-001,2014,1,8,4,128,171,299,344
0130-001,2014,1,8,5,146,204,350,299
0130-001,2014,1,8,6,313,353,666,350
0130-001,2014,1,8,7,1159,611,1770,666
0130-001,2014,1,8,8,2040,1544,3584,1770
0130-001,2014,1,8,9,1835,1926,3761,3584
0130-001,2014,1,8,10,1743,1562,3305,3761
0130-001,2014,1,8,11,1771,1612,3383,3305
0130-001,2014,1,8,12,1708,1508,3216,3383
0130-001,2014,1,8,13,1382,1447,2829,3216
0130-001,2014,1,8,14,1685,1717,3402,2829
0130-001,2014,1,8,15,1769,1769,3538,3402
0130-001,2014,1,8,16,1774,1746,3520,3538
0130-001,2014,1,8,17,1600,1751,3351,3520
0130-001,2014,1,8,18,1741,2178,3919,3351
0130-001,2014,1,8,19,1650,2268,3918,3919
0130-001,2014,1,8,20,1308,1553,2861,3918
0130-001,2014,1,8,21,1121,1430,2551,2861
0130-001,2014,1,8,22,1011,1009,2020,2551
0130-001,2014,1,8,23,742,686,1428,2020
0130-001,2014,1,8,24,493,443,936,1428
0130-001,2014,1,9,1,341,314,655,936
0130-001,2014,1,9,2,221,189,410,655
0130-001,2014,1,9,3,149,143,292,410
0130-001,2014,1,9,4,143,133,276,292
0130-001,2014,1,9,5,138,195,333,276
0130-001,2014,1,9,6,281,325,606,333
0130-001,2014,1,9,7,1087,625,1712,606
0130-001,2014,1,9,8,2031,1469,3500,1712
0130-001,2014,1,9,9,1905,1827,3732,3500
0130-001,2014,1,9,10,1766,1532,3298,3732
0130-001,2014,1,9,11,1723,1599,3322,3298
0130-001,2014,1,9,12,1578,1600,3178,3322
0130-001,2014,1,9,13,1370,1379,2749,3178
0130-001,2014,1,9,14,1659,1675,3334,2749
0130-001,2014,1,9,15,1689,1813,3502,3334
0130-001,2014,1,9,16,1463,1510,2973,3502
0130-001,2014,1,9,17,1694,1611,3305,2973
0130-001,2014,1,9,18,1646,2080,3726,3305
0130-001,2014,1,9,19,1728,2220,3948,3726
0130-001,2014,1,9,20,1288,1561,2849,3948
0130-001,2014,1,9,21,1125,1575,2700,2849
0130-001,2014,1,9,22,1085,1109,2194,2700
0130-001,2014,1,9,23,792,645,1437,2194
0130-001,2014,1,9,24,504,455,959,1437
0130-001,2014,1,10,1,362,313,675,959
0130-001,2014,1,10,2,227,200,427,675
0130-001,2014,1,10,3,160,155,315,427
0130-001,2014,1,10,4,151,180,331,315
0130-001,2014,1,10,5,142,192,334,331
0130-001,2014,1,10,6,277,323,600,334
0130-001,2014,1,10,7,1065,605,1670,600
0130-001,2014,1,10,8,2002,1446,3448,1670
0130-001,2014,1,10,9,1927,1808,3735,3448
0130-001,2014,1,10,10,1656,1569,3225,3735
0130-001,2014,1,10,11,1738,1685,3423,3225
0130-001,2014,1,10,12,1581,1644,3225,3423
0130-001,2014,1,10,13,1405,1523,2928,3225
0130-001,2014,1,10,14,1821,1761,3582,2928
0130-001,2014,1,10,15,1820,1848,3668,3582
0130-001,2014,1,10,16,1881,1892,3773,3668
0130-001,2014,1,10,17,1723,1848,3571,3773
0130-001,2014,1,10,18,1838,2262,4100,3571
0130-001,2014,1,10,19,1923,2491,4414,4100
0130-001,2014,1,10,20,1426,1793,3219,4414
0130-001,2014,1,10,21,1233,1533,2766,3219
0130-001,2014,1,10,22,1062,1158,2220,2766
0130-001,2014,1,10,23,863,776,1639,2220
0130-001,2014,1,10,24,632,558,1190,1639
0130-001,2014,1,11,1,495,391,886,1190
0130-001,2014,1,11,2,313,318,631,886
0130-001,2014,1,11,3,244,237,481,631
0130-001,2014,1,11,4,213,205,418,481
0130-001,2014,1,11,5,186,267,453,418
0130-001,2014,1,11,6,306,361,667,453
0130-001,2014,1,11,7,723,506,1229,667
0130-001,2014,1,11,8,1241,879,2120,1229
0130-001,2014,1,11,9,1414,1348,2762,2120
0130-001,2014,1,11,10,1533,1514,3047,2762
0130-001,2014,1,11,11,1618,1729,3347,3047
0130-001,2014,1,11,12,1704,1879,3583,3347
0130-001,2014,1,11,13,1725,2187,3912,3583
0130-001,2014,1,11,14,1699,1862,3561,3912
0130-001,2014,1,11,15,1743,1884,3627,3561
0130-001,2014,1,11,16,1836,1851,3687,3627
0130-001,2014,1,11,17,1833,1865,3698,3687
0130-001,2014,1,11,18,2011,2150,4161,3698
0130-001,2014,1,11,19,1730,1715,3445,4161
0130-001,2014,1,11,20,1279,1163,2442,3445
0130-001,2014,1,11,21,1040,1047,2087,2442
0130-001,2014,1,11,22,1042,840,1882,2087
0130-001,2014,1,11,23,712,586,1298,1882
0130-001,2014,1,11,24,534,428,962,1298
0130-001,2014,1,12,1,398,350,748,962
0130-001,2014,1,12,2,314,246,560,748
0130-001,2014,1,12,3,250,213,463,560
0130-001,2014,1,12,4,204,146,350,463
0130-001,2014,1,12,5,153,163,316,350
0130-001,2014,1,12,6,212,266,478,316
0130-001,2014,1,12,7,397,284,681,478
0130-001,2014,1,12,8,525,471,996,681
0130-001,2014,1,12,9,709,742,1451,996
0130-001,2014,1,12,10,857,894,1751,1451
0130-001,2014,1,12,11,976,1203,2179,1751
0130-001,2014,1,12,12,1104,1272,2376,2179
0130-001,2014,1,12,13,1285,1384,2669,2376
0130-001,2014,1,12,14,1440,1476,2916,2669
0130-001,2014,1,12,15,1531,1466,2997,2916
0130-001,2014,1,12,16,1618,1519,3137,2997
0130-001,2014,1,12,17,1655,1422,3077,3137
0130-001,2014,1,12,18,1640,1465,3105,3077
0130-001,2014,1,12,19,1545,1221,2766,3105
0130-001,2014,1,12,20,1145,900,2045,2766
0130-001,2014,1,12,21,933,811,1744,2045
0130-001,2014,1,12,22,864,710,1574,1744
0130-001,2014,1,12,23,547,457,1004,1574
0130-001,2014,1,12,24,384,297,681,1004
0130-001,2014,1,13,1,278,227,505,681
0130-001,2014,1,13,2,155,153,308,505
0130-001,2014,1,13,3,117,114,231,308
0130-001,2014,1,13,4,113,127,240,231
0130-001,2014,1,13,5,145,189,334,240
0130-001,2014,1,13,6,350,372,722,334
0130-001,2014,1,13,7,1225,671,1896,722
0130-001,2014,1,13,8,2042,1520,3562,1896
0130-001,2014,1,13,9,1920,1856,3776,3562
0130-001,2014,1,13,10,1857,1723,3580,3776
0130-001,2014,1,13,11,1716,1666,3382,3580
0130-001,2014,1,13,12,1647,1626,3273,3382
0130-001,2014,1,13,13,1434,1468,2902,3273
0130-001,2014,1,13,14,1736,1788,3524,2902
0130-001,2014,1,13,15,1857,1808,3665,3524
0130-001,2014,1,13,16,1785,1853,3638,3665
0130-001,2014,1,13,17,1622,1726,3348,3638
0130-001,2014,1,13,18,1743,2191,3934,3348
0130-001,2014,1,13,19,1678,2367,4045,3934
0130-001,2014,1,13,20,1317,1608,2925,4045
0130-001,2014,1,13,21,1127,1554,2681,2925
0130-001,2014,1,13,22,963,1105,2068,2681
0130-001,2014,1,13,23,767,691,1458,2068
0130-001,2014,1,13,24,436,434,870,1458
0130-001,2014,1,14,1,334,293,627,870
0130-001,2014,1,14,2,205,193,398,627
0130-001,2014,1,14,3,131,149,280,398
0130-001,2014,1,14,4,152,178,330,280
0130-001,2014,1,14,5,168,208,376,330
0130-001,2014,1,14,6,278,321,599,376
0130-001,2014,1,14,7,1097,650,1747,599
0130-001,2014,1,14,8,2039,1477,3516,1747
0130-001,2014,1,14,9,1965,1866,3831,3516
0130-001,2014,1,14,10,1790,1681,3471,3831
0130-001,2014,1,14,11,1697,1646,3343,3471
0130-001,2014,1,14,12,1626,1541,3167,3343
0130-001,2014,1,14,13,1454,1480,2934,3167
0130-001,2014,1,14,14,1713,1657,3370,2934
0130-001,2014,1,14,15,1821,1795,3616,3370
0130-001,2014,1,14,16,1756,1785,3541,3616
0130-001,2014,1,14,17,1626,1787,3413,3541
0130-001,2014,1,14,18,1615,2143,3758,3413
0130-001,2014,1,14,19,1629,2186,3815,3758
0130-001,2014,1,14,20,1327,1602,2929,3815
0130-001,2014,1,14,21,1106,1541,2647,2929
0130-001,2014,1,14,22,1070,1090,2160,2647
0130-001,2014,1,14,23,742,711,1453,2160
0130-001,2014,1,14,24,487,498,985,1453
0130-001,2014,1,15,1,331,289,620,985
0130-001,2014,1,15,2,260,234,494,620
0130-001,2014,1,15,3,166,168,334,494
0130-001,2014,1,15,4,148,159,307,334
0130-001,2014,1,15,5,153,214,367,307
0130-001,2014,1,15,6,305,336,641,367
0130-001,2014,1,15,7,1075,618,1693,641
0130-001,2014,1,15,8,2087,1472,3559,1693
0130-001,2014,1,15,9,2055,1908,3963,3559
0130-001,2014,1,15,10,1750,1674,3424,3963
0130-001,2014,1,15,11,1709,1714,3423,3424
0130-001,2014,1,15,12,1740,1582,3322,3423
0130-001,2014,1,15,13,1421,1453,2874,3322
0130-001,2014,1,15,14,1743,1745,3488,2874
0130-001,2014,1,15,15,1804,1869,3673,3488
0130-001,2014,1,15,16,1806,1789,3595,3673
0130-001,2014,1,15,17,1683,1764,3447,3595
0130-001,2014,1,15,18,1798,2340,4138,3447
0130-001,2014,1,15,19,1684,2546,4230,4138
0130-001,2014,1,15,20,1400,1667,3067,4230
0130-001,2014,1,15,21,1183,1560,2743,3067
0130-001,2014,1,15,22,1114,1130,2244,2743
0130-001,2014,1,15,23,811,700,1511,2244
0130-001,2014,1,15,24,518,489,1007,1511
0130-001,2014,1,16,1,360,295,655,1007
0130-001,2014,1,16,2,240,203,443,655
0130-001,2014,1,16,3,166,167,333,443
0130-001,2014,1,16,4,156,176,332,333
0130-001,2014,1,16,5,178,224,402,332
0130-001,2014,1,16,6,314,335,649,402
0130-001,2014,1,16,7,1074,642,1716,649
0130-001,2014,1,16,8,2078,1443,3521,1716
0130-001,2014,1,16,9,1936,1902,3838,3521
0130-001,2014,1,16,10,1798,1689,3487,3838
0130-001,2014,1,16,11,1726,1669,3395,3487
0130-001,2014,1,16,12,1746,1606,3352,3395
0130-001,2014,1,16,13,1454,1549,3003,3352
0130-001,2014,1,16,14,1687,1795,3482,3003
0130-001,2014,1,16,15,1818,1772,3590,3482
0130-001,2014,1,16,16,1820,1759,3579,3590
0130-001,2014,1,16,17,1690,1818,3508,3579
0130-001,2014,1,16,18,1663,2215,3878,3508
0130-001,2014,1,16,19,1692,2276,3968,3878
0130-001,2014,1,16,20,1243,1639,2882,3968
0130-001,2014,1,16,21,1169,1545,2714,2882
0130-001,2014,1,16,22,1054,1167,2221,2714
0130-001,2014,1,16,23,789,753,1542,2221
0130-001,2014,1,16,24,572,491,1063,1542
0130-001,2014,1,17,1,345,348,693,1063
0130-001,2014,1,17,2,222,183,405,693
0130-001,2014,1,17,3,176,173,349,405
0130-001,2014,1,17,4,158,156,314,349
0130-001,2014,1,17,5,166,254,420,314
0130-001,2014,1,17,6,319,336,655,420
0130-001,2014,1,17,7,1081,631,1712,655
0130-001,2014,1,17,8,2078,1442,3520,1712
0130-001,2014,1,17,9,1954,1898,3852,3520
0130-001,2014,1,17,10,1754,1686,3440,3852
0130-001,2014,1,17,11,1753,1678,3431,3440
0130-001,2014,1,17,12,1655,1660,3315,3431
0130-001,2014,1,17,13,1483,1578,3061,3315
0130-001,2014,1,17,14,1702,1749,3451,3061
0130-001,2014,1,17,15,1843,1745,3588,3451
0130-001,2014,1,17,16,1718,1872,3590,3588
0130-001,2014,1,17,17,1774,1820,3594,3590
0130-001,2014,1,17,18,1946,2392,4338,3594
0130-001,2014,1,17,19,1909,2550,4459,4338
0130-001,2014,1,17,20,1514,1846,3360,4459
0130-001,2014,1,17,21,1197,1545,2742,3360
0130-001,2014,1,17,22,1137,1160,2297,2742
0130-001,2014,1,17,23,928,833,1761,2297
0130-001,2014,1,17,24,595,506,1101,1761
0130-001,2014,1,18,1,488,414,902,1101
0130-001,2014,1,18,2,306,312,618,902
0130-001,2014,1,18,3,245,199,444,618
0130-001,2014,1,18,4,242,227,469,444
0130-001,2014,1,18,5,194,271,465,469
0130-001,2014,1,18,6,345,328,673,465
0130-001,2014,1,18,7,723,524,1247,673
0130-001,2014,1,18,8,1318,963,2281,1247
0130-001,2014,1,18,9,1575,1569,3144,2281
0130-001,2014,1,18,10,1641,1586,3227,3144
0130-001,2014,1,18,11,1577,1659,3236,3227
0130-001,2014,1,18,12,1737,1749,3486,3236
0130-001,2014,1,18,13,1598,1937,3535,3486
0130-001,2014,1,18,14,1579,1918,3497,3535
0130-001,2014,1,18,15,1729,1886,3615,3497
0130-001,2014,1,18,16,1749,1811,3560,3615
0130-001,2014,1,18,17,1796,1699,3495,3560
0130-001,2014,1,18,18,1918,2094,4012,3495
0130-001,2014,1,18,19,1824,1854,3678,4012
0130-001,2014,1,18,20,1327,1144,2471,3678
0130-001,2014,1,18,21,1002,977,1979,2471
0130-001,2014,1,18,22,966,792,1758,1979
0130-001,2014,1,18,23,704,618,1322,1758
0130-001,2014,1,18,24,523,420,943,1322
0130-001,2014,1,19,1,399,348,747,943
0130-001,2014,1,19,2,270,238,508,747
0130-001,2014,1,19,3,216,188,404,508
0130-001,2014,1,19,4,174,167,341,404
0130-001,2014,1,19,5,160,159,319,341
0130-001,2014,1,19,6,222,251,473,319
0130-001,2014,1,19,7,411,340,751,473
0130-001,2014,1,19,8,623,534,1157,751
0130-001,2014,1,19,9,726,837,1563,1157
0130-001,2014,1,19,10,867,1028,1895,1563
0130-001,2014,1,19,11,1100,1298,2398,1895
0130-001,2014,1,19,12,1067,1306,2373,2398
0130-001,2014,1,19,13,1268,1457,2725,2373
0130-001,2014,1,19,14,1416,1451,2867,2725
0130-001,2014,1,19,15,1572,1502,3074,2867
0130-001,2014,1,19,16,1563,1571,3134,3074
0130-001,2014,1,19,17,1628,1468,3096,3134
0130-001,2014,1,19,18,1735,1577,3312,3096
0130-001,2014,1,19,19,1597,1265,2862,3312
0130-001,2014,1,19,20,1199,999,2198,2862
0130-001,2014,1,19,21,969,831,1800,2198
0130-001,2014,1,19,22,901,713,1614,1800
0130-001,2014,1,19,23,620,469,1089,1614
0130-001,2014,1,19,24,436,361,797,1089
0130-001,2014,1,20,1,246,223,469,797
0130-001,2014,1,20,2,153,156,309,469
0130-001,2014,1,20,3,108,121,229,309
0130-001,2014,1,20,4,106,120,226,229
0130-001,2014,1,20,5,120,184,304,226
0130-001,2014,1,20,6,289,323,612,304
0130-001,2014,1,20,7,1170,637,1807,612
0130-001,2014,1,20,8,1732,1266,2998,1807
0130-001,2014,1,20,9,1860,1654,3514,2998
0130-001,2014,1,20,10,1611,1491,3102,3514
0130-001,2014,1,20,11,1558,1488,3046,3102
0130-001,2014,1,20,12,1643,1523,3166,3046
0130-001,2014,1,20,13,1374,1475,2849,3166
0130-001,2014,1,20,14,1668,1634,3302,2849
0130-001,2014,1,20,15,1818,1779,3597,3302
0130-001,2014,1,20,16,1749,1739,3488,3597
0130-001,2014,1,20,17,1562,1672,3234,3488
0130-001,2014,1,20,18,1477,1984,3461,3234
0130-001,2014,1,20,19,1653,2069,3722,3461
0130-001,2014,1,20,20,1160,1488,2648,3722
0130-001,2014,1,20,21,911,1313,2224,2648
0130-001,2014,1,20,22,806,892,1698,2224
0130-001,2014,1,20,23,608,562,1170,1698
0130-001,2014,1,20,24,399,354,753,1170
0130-001,2014,1,21,1,247,256,503,753
0130-001,2014,1,21,2,155,157,312,503
0130-001,2014,1,21,3,130,109,239,312
0130-001,2014,1,21,4,129,142,271,239
0130-001,2014,1,21,5,128,184,312,271
0130-001,2014,1,21,6,241,315,556,312
0130-001,2014,1,21,7,949,526,1475,556
0130-001,2014,1,21,8,1621,1245,2866,1475
0130-001,2014,1,21,9,1712,1607,3319,2866
0130-001,2014,1,21,10,1652,1565,3217,3319
0130-001,2014,1,21,11,1599,1519,3118,3217
0130-001,2014,1,21,12,1582,1532,3114,3118
0130-001,2014,1,21,13,1437,1392,2829,3114
0130-001,2014,1,21,14,1562,1643,3205,2829
0130-001,2014,1,21,15,1803,1727,3530,3205
0130-001,2014,1,21,16,1704,1650,3354,3530
0130-001,2014,1,21,17,1596,1678,3274,3354
0130-001,2014,1,21,18,1574,1998,3572,3274
0130-001,2014,1,21,19,1540,2139,3679,3572
0130-001,2014,1,21,20,1192,1544,2736,3679
0130-001,2014,1,21,21,1149,1407,2556,2736
0130-001,2014,1,21,22,984,1040,2024,2556
0130-001,2014,1,21,23,771,688,1459,2024
0130-001,2014,1,21,24,448,428,876,1459
0130-001,2014,1,22,1,336,284,620,876
0130-001,2014,1,22,2,217,212,429,620
0130-001,2014,1,22,3,159,152,311,429
0130-001,2014,1,22,4,163,138,301,311
0130-001,2014,1,22,5,168,225,393,301
0130-001,2014,1,22,6,289,324,613,393
0130-001,2014,1,22,7,1052,634,1686,613
0130-001,2014,1,22,8,2071,1445,3516,1686
0130-001,2014,1,22,9,1982,1786,3768,3516
0130-001,2014,1,22,10,1740,1640,3380,3768
0130-001,2014,1,22,11,1771,1598,3369,3380
0130-001,2014,1,22,12,1667,1636,3303,3369
0130-001,2014,1,22,13,1447,1508,2955,3303
0130-001,2014,1,22,14,1747,1677,3424,2955
0130-001,2014,1,22,15,1904,1824,3728,3424
0130-001,2014,1,22,16,1811,1834,3645,3728
0130-001,2014,1,22,17,1680,1830,3510,3645
0130-001,2014,1,22,18,1755,2300,4055,3510
0130-001,2014,1,22,19,1737,2423,4160,4055
0130-001,2014,1,22,20,1357,1725,3082,4160
0130-001,2014,1,22,21,1146,1363,2509,3082
0130-001,2014,1,22,22,1144,1063,2207,2509
0130-001,2014,1,22,23,833,737,1570,2207
0130-001,2014,1,22,24,585,521,1106,1570
0130-001,2014,1,23,1,334,314,648,1106
0130-001,2014,1,23,2,231,240,471,648
0130-001,2014,1,23,3,158,151,309,471
0130-001,2014,1,23,4,142,161,303,309
0130-001,2014,1,23,5,180,217,397,303
0130-001,2014,1,23,6,312,351,663,397
0130-001,2014,1,23,7,1087,653,1740,663
0130-001,2014,1,23,8,2069,1408,3477,1740
0130-001,2014,1,23,9,1960,1832,3792,3477
0130-001,2014,1,23,10,1803,1674,3477,3792
0130-001,2014,1,23,11,1797,1661,3458,3477
0130-001,2014,1,23,12,1708,1732,3440,3458
0130-001,2014,1,23,13,1494,1554,3048,3440
0130-001,2014,1,23,14,1775,1771,3546,3048
0130-001,2014,1,23,15,1842,1837,3679,3546
0130-001,2014,1,23,16,1886,1812,3698,3679
0130-001,2014,1,23,17,1678,1837,3515,3698
0130-001,2014,1,23,18,1751,2257,4008,3515
0130-001,2014,1,23,19,1675,2341,4016,4008
0130-001,2014,1,23,20,1348,1663,3011,4016
0130-001,2014,1,23,21,1182,1595,2777,3011
0130-001,2014,1,23,22,1110,1184,2294,2777
0130-001,2014,1,23,23,828,669,1497,2294
0130-001,2014,1,23,24,557,528,1085,1497
0130-001,2014,1,24,1,379,351,730,1085
0130-001,2014,1,24,2,264,214,478,730
0130-001,2014,1,24,3,154,175,329,478
0130-001,2014,1,24,4,146,167,313,329
0130-001,2014,1,24,5,160,223,383,313
0130-001,2014,1,24,6,307,353,660,383
0130-001,2014,1,24,7,1071,661,1732,660
0130-001,2014,1,24,8,2092,1474,3566,1732
0130-001,2014,1,24,9,2060,1820,3880,3566
0130-001,2014,1,24,10,1811,1743,3554,3880
0130-001,2014,1,24,11,1763,1838,3601,3554
0130-001,2014,1,24,12,1765,1755,3520,3601
0130-001,2014,1,24,13,1542,1651,3193,3520
0130-001,2014,1,24,14,1818,1788,3606,3193
0130-001,2014,1,24,15,1912,1930,3842,3606
0130-001,2014,1,24,16,1808,1850,3658,3842
0130-001,2014,1,24,17,1878,1953,3831,3658
0130-001,2014,1,24,18,1896,2306,4202,3831
0130-001,2014,1,24,19,1920,2524,4444,4202
0130-001,2014,1,24,20,1518,2028,3546,4444
0130-001,2014,1,24,21,1225,1647,2872,3546
0130-001,2014,1,24,22,1141,1207,2348,2872
0130-001,2014,1,24,23,927,799,1726,2348
0130-001,2014,1,24,24,653,518,1171,1726
0130-001,2014,1,25,1,467,424,891,1171
0130-001,2014,1,25,2,339,284,623,891
0130-001,2014,1,25,3,269,224,493,623
0130-001,2014,1,25,4,233,201,434,493
0130-001,2014,1,25,5,226,289,515,434
0130-001,2014,1,25,6,357,381,738,515
0130-001,2014,1,25,7,654,510,1164,738
0130-001,2014,1,25,8,1309,901,2210,1164
0130-001,2014,1,25,9,1497,1482,2979,2210
0130-001,2014,1,25,10,1563,1668,3231,2979
0130-001,2014,1,25,11,1679,1773,3452,3231
0130-001,2014,1,25,12,1725,1772,3497,3452
0130-001,2014,1,25,13,1645,1766,3411,3497
0130-001,2014,1,25,14,1754,1824,3578,3411
0130-001,2014,1,25,15,1848,1971,3819,3578
0130-001,2014,1,25,16,1777,1765,3542,3819
0130-001,2014,1,25,17,1733,1723,3456,3542
0130-001,2014,1,25,18,1784,2040,3824,3456
0130-001,2014,1,25,19,1674,1775,3449,3824
0130-001,2014,1,25,20,1325,1102,2427,3449
0130-001,2014,1,25,21,1072,970,2042,2427
0130-001,2014,1,25,22,955,846,1801,2042
0130-001,2014,1,25,23,796,564,1360,1801
0130-001,2014,1,25,24,512,444,956,1360
0130-001,2014,1,26,1,394,311,705,956
0130-001,2014,1,26,2,276,237,513,705
0130-001,2014,1,26,3,249,198,447,513
0130-001,2014,1,26,4,166,175,341,447
0130-001,2014,1,26,5,157,148,305,341
0130-001,2014,1,26,6,222,250,472,305
0130-001,2014,1,26,7,415,365,780,472
0130-001,2014,1,26,8,664,561,1225,780
0130-001,2014,1,26,9,862,943,1805,1225
0130-001,2014,1,26,10,927,1002,1929,1805
0130-001,2014,1,26,11,1168,1264,2432,1929
0130-001,2014,1,26,12,1057,1231,2288,2432
0130-001,2014,1,26,13,1398,1506,2904,2288
0130-001,2014,1,26,14,1421,1468,2889,2904
0130-001,2014,1,26,15,1531,1516,3047,2889
0130-001,2014,1,26,16,1599,1540,3139,3047
0130-001,2014,1,26,17,1573,1463,3036,3139
0130-001,2014,1,26,18,1607,1616,3223,3036
0130-001,2014,1,26,19,1422,1243,2665,3223
0130-001,2014,1,26,20,1034,900,1934,2665
0130-001,2014,1,26,21,950,743,1693,1934
0130-001,2014,1,26,22,840,717,1557,1693
0130-001,2014,1,26,23,564,464,1028,1557
0130-001,2014,1,26,24,366,316,682,1028
0130-001,2014,1,27,1,285,255,540,682
0130-001,2014,1,27,2,161,150,311,540
0130-001,2014,1,27,3,94,107,201,311
0130-001,2014,1,27,4,109,125,234,201
0130-001,2014,1,27,5,144,188,332,234
0130-001,2014,1,27,6,340,341,681,332
0130-001,2014,1,27,7,1191,716,1907,681
0130-001,2014,1,27,8,2095,1510,3605,1907
0130-001,2014,1,27,9,2002,1883,3885,3605
0130-001,2014,1,27,10,1764,1665,3429,3885
0130-001,2014,1,27,11,1891,1784,3675,3429
0130-001,2014,1,27,12,1779,1813,3592,3675
0130-001,2014,1,27,13,1725,1720,3445,3592
0130-001,2014,1,27,14,1917,1870,3787,3445
0130-001,2014,1,27,15,1883,1955,3838,3787
0130-001,2014,1,27,16,1888,1950,3838,3838
0130-001,2014,1,27,17,1758,1881,3639,3838
0130-001,2014,1,27,18,1766,2332,4098,3639
0130-001,2014,1,27,19,1862,2375,4237,4098
0130-001,2014,1,27,20,1432,1791,3223,4237
0130-001,2014,1,27,21,1233,1683,2916,3223
0130-001,2014,1,27,22,1075,1225,2300,2916
0130-001,2014,1,27,23,843,761,1604,2300
0130-001,2014,1,27,24,532,525,1057,1604
0130-001,2014,1,28,1,363,338,701,1057
0130-001,2014,1,28,2,249,186,435,701
0130-001,2014,1,28,3,155,179,334,435
0130-001,2014,1,28,4,155,186,341,334
0130-001,2014,1,28,5,180,214,394,341
0130-001,2014,1,28,6,322,339,661,394
0130-001,2014,1,28,7,1069,623,1692,661
0130-001,2014,1,28,8,2062,1440,3502,1692
0130-001,2014,1,28,9,2093,1887,3980,3502
0130-001,2014,1,28,10,1840,1774,3614,3980
0130-001,2014,1,28,11,1907,1892,3799,3614
0130-001,2014,1,28,12,1847,1767,3614,3799
0130-001,2014,1,28,13,1543,1709,3252,3614
0130-001,2014,1,28,14,1905,1967,3872,3252
0130-001,2014,1,28,15,1917,1936,3853,3872
0130-001,2014,1,28,16,1903,1991,3894,3853
0130-001,2014,1,28,17,1813,2031,3844,3894
0130-001,2014,1,28,18,1949,2323,4272,3844
0130-001,2014,1,28,19,1842,2421,4263,4272
0130-001,2014,1,28,20,1532,2084,3616,4263
0130-001,2014,1,28,21,1323,1728,3051,3616
0130-001,2014,1,28,22,1180,1286,2466,3051
0130-001,2014,1,28,23,916,816,1732,2466
0130-001,2014,1,28,24,609,543,1152,1732
0130-001,2014,1,29,1,402,385,787,1152
0130-001,2014,1,29,2,274,260,534,787
0130-001,2014,1,29,3,176,170,346,534
0130-001,2014,1,29,4,185,190,375,346
0130-001,2014,1,29,5,180,243,423,375
0130-001,2014,1,29,6,316,304,620,423
0130-001,2014,1,29,7,993,550,1543,620
0130-001,2014,1,29,8,2067,1324,3391,1543
0130-001,2014,1,29,9,1957,1913,3870,3391
0130-001,2014,1,29,10,1734,1851,3585,3870
0130-001,2014,1,29,11,1844,2013,3857,3585
0130-001,2014,1,29,12,1851,1987,3838,3857
0130-001,2014,1,29,13,1750,2090,3840,3838
0130-001,2014,1,29,14,1719,2323,4042,3840
0130-001,2014,1,29,15,1845,2307,4152,4042
0130-001,2014,1,29,16,1737,2628,4365,4152
0130-001,2014,1,29,17,1851,2648,4499,4365
0130-001,2014,1,29,18,1795,2621,4416,4499
0130-001,2014,1,29,19,1606,2556,4162,4416
0130-001,2014,1,29,20,1317,2383,3700,4162
0130-001,2014,1,29,21,1164,2430,3594,3700
0130-001,2014,1,29,22,1012,2322,3334,3594
0130-001,2014,1,29,23,845,1824,2669,3334
0130-001,2014,1,29,24,545,1239,1784,2669
0130-001,2014,1,30,1,410,703,1113,1784
0130-001,2014,1,30,2,276,659,935,1113
0130-001,2014,1,30,3,198,618,816,935
0130-001,2014,1,30,4,190,610,800,816
0130-001,2014,1,30,5,185,908,1093,800
0130-001,2014,1,30,6,246,1519,1765,1093
0130-001,2014,1,30,7,373,1430,1803,1765
0130-001,2014,1,30,8,513,1543,2056,1803
0130-001,2014,1,30,9,720,1616,2336,2056
0130-001,2014,1,30,10,1082,1835,2917,2336
0130-001,2014,1,30,11,1448,1975,3423,2917
0130-001,2014,1,30,12,1707,2024,3731,3423
0130-001,2014,1,30,13,1524,1826,3350,3731
0130-001,2014,1,30,14,1397,1525,2922,3350
0130-001,2014,1,30,15,1435,1524,2959,2922
0130-001,2014,1,30,16,1247,1355,2602,2959
0130-001,2014,1,30,17,1193,1200,2393,2602
0130-001,2014,1,30,18,1119,1069,2188,2393
0130-001,2014,1,30,19,886,886,1772,2188
0130-001,2014,1,30,20,781,824,1605,1772
0130-001,2014,1,30,21,621,740,1361,1605
0130-001,2014,1,30,22,598,538,1136,1361
0130-001,2014,1,30,23,461,392,853,1136
0130-001,2014,1,30,24,337,266,603,853
0130-001,2014,1,31,1,235,199,434,603
0130-001,2014,1,31,2,145,151,296,434
0130-001,2014,1,31,3,116,114,230,296
0130-001,2014,1,31,4,94,75,169,230
0130-001,2014,1,31,5,96,93,189,169
0130-001,2014,1,31,6,140,173,313,189
0130-001,2014,1,31,7,478,369,847,313
0130-001,2014,1,31,8,927,684,1611,847
0130-001,2014,1,31,9,814,761,1575,1611
0130-001,2014,1,31,10,745,825,1570,1575
0130-001,2014,1,31,11,1457,1288,2745,1570
0130-001,2014,1,31,12,1852,1660,3512,2745
0130-001,2014,1,31,13,1766,1912,3678,3512
0130-001,2014,1,31,14,2092,1998,4090,3678
0130-001,2014,1,31,15,2145,2004,4149,4090
0130-001,2014,1,31,16,2237,2159,4396,4149
0130-001,2014,1,31,17,2162,2374,4536,4396
0130-001,2014,1,31,18,2066,2327,4393,4536
0130-001,2014,1,31,19,1960,2058,4018,4393
0130-001,2014,1,31,20,1681,1292,2973,4018
0130-001,2014,1,31,21,1129,907,2036,2973
0130-001,2014,1,31,22,955,768,1723,2036
0130-001,2014,1,31,23,746,506,1252,1723
0130-001,2014,1,31,24,571,377,948,1252
0130-001,2014,2,1,1,510,272,782,948
0130-001,2014,2,1,2,328,145,473,782
0130-001,2014,2,1,3,206,126,332,473
0130-001,2014,2,1,4,150,105,255,332
0130-001,2014,2,1,5,127,111,238,255
0130-001,2014,2,1,6,146,163,309,238
0130-001,2014,2,1,7,264,173,437,309
0130-001,2014,2,1,8,343,274,617,437
0130-001,2014,2,1,9,467,456,923,617
0130-001,2014,2,1,10,627,591,1218,923
0130-001,2014,2,1,11,1207,864,2071,1218
0130-001,2014,2,1,12,1689,1183,2872,2071
0130-001,2014,2,1,13,1829,1264,3093,2872
0130-001,2014,2,1,14,1910,1269,3179,3093
0130-001,2014,2,1,15,2041,1386,3427,3179
0130-001,2014,2,1,16,2026,1382,3408,3427
0130-001,2014,2,1,17,1837,1201,3038,3408
0130-001,2014,2,1,18,2079,1048,3127,3038
0130-001,2014,2,1,19,2048,977,3025,3127
0130-001,2014,2,1,20,1966,763,2729,3025
0130-001,2014,2,1,21,1683,681,2364,2729
0130-001,2014,2,1,22,1728,698,2426,2364
0130-001,2014,2,1,23,1257,444,1701,2426
0130-001,2014,2,1,24,981,312,1293,1701
0130-001,2014,2,2,1,796,268,1064,1293
0130-001,2014,2,2,2,660,177,837,1064
0130-001,2014,2,2,3,366,146,512,837
0130-001,2014,2,2,4,166,97,263,512
0130-001,2014,2,2,5,149,110,259,263
0130-001,2014,2,2,6,155,156,311,259
0130-001,2014,2,2,7,283,231,514,311
0130-001,2014,2,2,8,433,315,748,514
0130-001,2014,2,2,9,605,566,1171,748
0130-001,2014,2,2,10,829,729,1558,1171
0130-001,2014,2,2,11,1020,967,1987,1558
0130-001,2014,2,2,12,1234,1025,2259,1987
0130-001,2014,2,2,13,1507,1317,2824,2259
0130-001,2014,2,2,14,1765,1419,3184,2824
0130-001,2014,2,2,15,1777,1361,3138,3184
0130-001,2014,2,2,16,1813,1418,3231,3138
0130-001,2014,2,2,17,1848,1401,3249,3231
0130-001,2014,2,2,18,1608,1272,2880,3249
0130-001,2014,2,2,19,1332,998,2330,2880
0130-001,2014,2,2,20,1079,867,1946,2330
0130-001,2014,2,2,21,894,687,1581,1946
0130-001,2014,2,2,22,853,692,1545,1581
0130-001,2014,2,2,23,577,461,1038,1545
0130-001,2014,2,2,24,460,315,775,1038
0130-001,2014,2,3,1,268,232,500,775
0130-001,2014,2,3,2,160,142,302,500
0130-001,2014,2,3,3,145,106,251,302
0130-001,2014,2,3,4,114,120,234,251
0130-001,2014,2,3,5,168,189,357,234
0130-001,2014,2,3,6,337,298,635,357
0130-001,2014,2,3,7,1132,621,1753,635
0130-001,2014,2,3,8,2093,1538,3631,1753
0130-001,2014,2,3,9,1882,1905,3787,3631
0130-001,2014,2,3,10,1586,1573,3159,3787
0130-001,2014,2,3,11,1531,1549,3080,3159
0130-001,2014,2,3,12,1509,1557,3066,3080
0130-001,2014,2,3,13,1489,1468,2957,3066
0130-001,2014,2,3,14,1682,1720,3402,2957
0130-001,2014,2,3,15,1770,1829,3599,3402
0130-001,2014,2,3,16,1751,1881,3632,3599
0130-001,2014,2,3,17,1638,1758,3396,3632
0130-001,2014,2,3,18,1777,2120,3897,3396
0130-001,2014,2,3,19,1773,2102,3875,3897
0130-001,2014,2,3,20,1335,1589,2924,3875
0130-001,2014,2,3,21,1057,1339,2396,2924
0130-001,2014,2,3,22,978,974,1952,2396
0130-001,2014,2,3,23,733,647,1380,1952
0130-001,2014,2,3,24,464,453,917,1380
0130-001,2014,2,4,1,306,302,608,917
0130-001,2014,2,4,2,226,198,424,608
0130-001,2014,2,4,3,138,133,271,424
0130-001,2014,2,4,4,138,144,282,271
0130-001,2014,2,4,5,135,182,317,282
0130-001,2014,2,4,6,279,276,555,317
0130-001,2014,2,4,7,1117,686,1803,555
0130-001,2014,2,4,8,2073,1563,3636,1803
0130-001,2014,2,4,9,2107,1938,4045,3636
0130-001,2014,2,4,10,1754,1659,3413,4045
0130-001,2014,2,4,11,1638,1567,3205,3413
0130-001,2014,2,4,12,1523,1631,3154,3205
0130-001,2014,2,4,13,1469,1478,2947,3154
0130-001,2014,2,4,14,1689,1648,3337,2947
0130-001,2014,2,4,15,1782,1735,3517,3337
0130-001,2014,2,4,16,1783,1664,3447,3517
0130-001,2014,2,4,17,1550,1701,3251,3447
0130-001,2014,2,4,18,1750,2199,3949,3251
0130-001,2014,2,4,19,1649,2233,3882,3949
0130-001,2014,2,4,20,1287,1608,2895,3882
0130-001,2014,2,4,21,1117,1518,2635,2895
0130-001,2014,2,4,22,1046,1206,2252,2635
0130-001,2014,2,4,23,760,704,1464,2252
0130-001,2014,2,4,24,475,442,917,1464
0130-001,2014,2,5,1,346,305,651,917
0130-001,2014,2,5,2,203,192,395,651
0130-001,2014,2,5,3,142,154,296,395
0130-001,2014,2,5,4,121,120,241,296
0130-001,2014,2,5,5,168,206,374,241
0130-001,2014,2,5,6,309,298,607,374
0130-001,2014,2,5,7,1091,650,1741,607
0130-001,2014,2,5,8,2181,1568,3749,1741
0130-001,2014,2,5,9,2057,1938,3995,3749
0130-001,2014,2,5,10,1746,1652,3398,3995
0130-001,2014,2,5,11,1676,1620,3296,3398
0130-001,2014,2,5,12,1539,1582,3121,3296
0130-001,2014,2,5,13,1426,1343,2769,3121
0130-001,2014,2,5,14,1577,1613,3190,2769
0130-001,2014,2,5,15,1833,1704,3537,3190
0130-001,2014,2,5,16,1756,1791,3547,3537
0130-001,2014,2,5,17,1627,1741,3368,3547
0130-001,2014,2,5,18,1700,2292,3992,3368
0130-001,2014,2,5,19,1692,2343,4035,3992
0130-001,2014,2,5,20,1324,1642,2966,4035
0130-001,2014,2,5,21,1169,1500,2669,2966
0130-001,2014,2,5,22,1064,1138,2202,2669
0130-001,2014,2,5,23,798,665,1463,2202
0130-001,2014,2,5,24,526,486,1012,1463
0130-001,2014,2,6,1,365,342,707,1012
0130-001,2014,2,6,2,227,217,444,707
0130-001,2014,2,6,3,168,164,332,444
0130-001,2014,2,6,4,166,161,327,332
0130-001,2014,2,6,5,150,223,373,327
0130-001,2014,2,6,6,297,311,608,373
0130-001,2014,2,6,7,1131,646,1777,608
0130-001,2014,2,6,8,2085,1536,3621,1777
0130-001,2014,2,6,9,2137,1975,4112,3621
0130-001,2014,2,6,10,1685,1683,3368,4112
0130-001,2014,2,6,11,1706,1609,3315,3368
0130-001,2014,2,6,12,1550,1490,3040,3315
0130-001,2014,2,6,13,1525,1464,2989,3040
0130-001,2014,2,6,14,1772,1670,3442,2989
0130-001,2014,2,6,15,1831,1758,3589,3442
0130-001,2014,2,6,16,1800,1809,3609,3589
0130-001,2014,2,6,17,1636,1778,3414,3609
0130-001,2014,2,6,18,1771,2203,3974,3414
0130-001,2014,2,6,19,1657,2370,4027,3974
0130-001,2014,2,6,20,1289,1630,2919,4027
0130-001,2014,2,6,21,1144,1510,2654,2919
0130-001,2014,2,6,22,1075,1202,2277,2654
0130-001,2014,2,6,23,764,740,1504,2277
0130-001,2014,2,6,24,558,474,1032,1504
0130-001,2014,2,7,1,368,325,693,1032
0130-001,2014,2,7,2,224,196,420,693
0130-001,2014,2,7,3,164,189,353,420
0130-001,2014,2,7,4,143,168,311,353
0130-001,2014,2,7,5,153,208,361,311
0130-001,2014,2,7,6,280,310,590,361
0130-001,2014,2,7,7,1139,625,1764,590
0130-001,2014,2,7,8,2089,1647,3736,1764
0130-001,2014,2,7,9,2143,1987,4130,3736
0130-001,2014,2,7,10,1734,1661,3395,4130
0130-001,2014,2,7,11,1780,1747,3527,3395
0130-001,2014,2,7,12,1518,1654,3172,3527
0130-001,2014,2,7,13,1596,1575,3171,3172
0130-001,2014,2,7,14,1727,1673,3400,3171
0130-001,2014,2,7,15,1793,1822,3615,3400
0130-001,2014,2,7,16,1830,1848,3678,3615
0130-001,2014,2,7,17,1749,1864,3613,3678
0130-001,2014,2,7,18,1884,2376,4260,3613
0130-001,2014,2,7,19,1946,2348,4294,4260
0130-001,2014,2,7,20,1497,1849,3346,4294
0130-001,2014,2,7,21,1178,1559,2737,3346
0130-001,2014,2,7,22,1087,1229,2316,2737
0130-001,2014,2,7,23,808,776,1584,2316
0130-001,2014,2,7,24,583,540,1123,1584
0130-001,2014,2,8,1,457,391,848,1123
0130-001,2014,2,8,2,329,293,622,848
0130-001,2014,2,8,3,216,213,429,622
0130-001,2014,2,8,4,215,220,435,429
0130-001,2014,2,8,5,197,267,464,435
0130-001,2014,2,8,6,330,317,647,464
0130-001,2014,2,8,7,705,517,1222,647
0130-001,2014,2,8,8,1331,892,2223,1222
0130-001,2014,2,8,9,1441,1413,2854,2223
0130-001,2014,2,8,10,1641,1639,3280,2854
0130-001,2014,2,8,11,1652,1732,3384,3280
0130-001,2014,2,8,12,1609,1739,3348,3384
0130-001,2014,2,8,13,1645,1802,3447,3348
0130-001,2014,2,8,14,1688,1815,3503,3447
0130-001,2014,2,8,15,1583,1800,3383,3503
0130-001,2014,2,8,16,1718,1721,3439,3383
0130-001,2014,2,8,17,1700,1753,3453,3439
0130-001,2014,2,8,18,1734,2028,3762,3453
0130-001,2014,2,8,19,1598,1762,3360,3762
0130-001,2014,2,8,20,1187,1089,2276,3360
0130-001,2014,2,8,21,992,869,1861,2276
0130-001,2014,2,8,22,904,762,1666,1861
0130-001,2014,2,8,23,689,523,1212,1666
0130-001,2014,2,8,24,513,435,948,1212
0130-001,2014,2,9,1,353,288,641,948
0130-001,2014,2,9,2,274,225,499,641
0130-001,2014,2,9,3,207,187,394,499
0130-001,2014,2,9,4,161,160,321,394
0130-001,2014,2,9,5,188,149,337,321
0130-001,2014,2,9,6,227,227,454,337
0130-001,2014,2,9,7,398,330,728,454
0130-001,2014,2,9,8,587,442,1029,728
0130-001,2014,2,9,9,630,762,1392,1029
0130-001,2014,2,9,10,803,872,1675,1392
0130-001,2014,2,9,11,1002,1070,2072,1675
0130-001,2014,2,9,12,939,1284,2223,2072
0130-001,2014,2,9,13,1281,1356,2637,2223
0130-001,2014,2,9,14,1344,1338,2682,2637
0130-001,2014,2,9,15,1429,1423,2852,2682
0130-001,2014,2,9,16,1400,1379,2779,2852
0130-001,2014,2,9,17,1447,1402,2849,2779
0130-001,2014,2,9,18,1396,1425,2821,2849
0130-001,2014,2,9,19,1328,1141,2469,2821
0130-001,2014,2,9,20,1105,920,2025,2469
0130-001,2014,2,9,21,845,716,1561,2025
0130-001,2014,2,9,22,774,623,1397,1561
0130-001,2014,2,9,23,516,352,868,1397
0130-001,2014,2,9,24,388,323,711,868
0130-001,2014,2,10,1,222,182,404,711
0130-001,2014,2,10,2,178,148,326,404
0130-001,2014,2,10,3,94,100,194,326
0130-001,2014,2,10,4,105,116,221,194
0130-001,2014,2,10,5,116,176,292,221
0130-001,2014,2,10,6,305,289,594,292
0130-001,2014,2,10,7,1235,654,1889,594
0130-001,2014,2,10,8,1886,1265,3151,1889
0130-001,2014,2,10,9,2164,1655,3819,3151
0130-001,2014,2,10,10,1611,1720,3331,3819
0130-001,2014,2,10,11,1708,1613,3321,3331
0130-001,2014,2,10,12,1578,1567,3145,3321
0130-001,2014,2,10,13,1460,1217,2677,3145
0130-001,2014,2,10,14,1770,1291,3061,2677
0130-001,2014,2,10,15,1786,1439,3225,3061
0130-001,2014,2,10,16,1711,1493,3204,3225
0130-001,2014,2,10,17,1668,1740,3408,3204
0130-001,2014,2,10,18,1712,2167,3879,3408
0130-001,2014,2,10,19,1700,2232,3932,3879
0130-001,2014,2,10,20,1311,1663,2974,3932
0130-001,2014,2,10,21,1104,1433,2537,2974
0130-001,2014,2,10,22,1007,1219,2226,2537
0130-001,2014,2,10,23,740,670,1410,2226
0130-001,2014,2,10,24,455,427,882,1410
0130-001,2014,2,11,1,304,295,599,882
0130-001,2014,2,11,2,231,205,436,599
0130-001,2014,2,11,3,168,166,334,436
0130-001,2014,2,11,4,132,171,303,334
0130-001,2014,2,11,5,172,230,402,303
0130-001,2014,2,11,6,337,312,649,402
0130-001,2014,2,11,7,1163,683,1846,649
0130-001,2014,2,11,8,2128,1596,3724,1846
0130-001,2014,2,11,9,2126,1986,4112,3724
0130-001,2014,2,11,10,1770,1672,3442,4112
0130-001,2014,2,11,11,1798,1695,3493,3442
0130-001,2014,2,11,12,1649,1571,3220,3493
0130-001,2014,2,11,13,1446,1454,2900,3220
0130-001,2014,2,11,14,1755,1759,3514,2900
0130-001,2014,2,11,15,1857,1796,3653,3514
0130-001,2014,2,11,16,1737,1841,3578,3653
0130-001,2014,2,11,17,1645,1916,3561,3578
0130-001,2014,2,11,18,1830,2247,4077,3561
0130-001,2014,2,11,19,1701,2303,4004,4077
0130-001,2014,2,11,20,1286,1672,2958,4004
0130-001,2014,2,11,21,1197,1546,2743,2958
0130-001,2014,2,11,22,1096,1217,2313,2743
0130-001,2014,2,11,23,734,670,1404,2313
0130-001,2014,2,11,24,547,498,1045,1404
0130-001,2014,2,12,1,320,305,625,1045
0130-001,2014,2,12,2,240,224,464,625
0130-001,2014,2,12,3,171,159,330,464
0130-001,2014,2,12,4,152,159,311,330
0130-001,2014,2,12,5,145,191,336,311
0130-001,2014,2,12,6,361,341,702,336
0130-001,2014,2,12,7,1137,681,1818,702
0130-001,2014,2,12,8,2116,1596,3712,1818
0130-001,2014,2,12,9,2073,2012,4085,3712
0130-001,2014,2,12,10,1800,1650,3450,4085
0130-001,2014,2,12,11,1673,1698,3371,3450
0130-001,2014,2,12,12,1642,1573,3215,3371
0130-001,2014,2,12,13,1471,1495,2966,3215
0130-001,2014,2,12,14,1699,1730,3429,2966
0130-001,2014,2,12,15,1905,1787,3692,3429
0130-001,2014,2,12,16,1793,1795,3588,3692
0130-001,2014,2,12,17,1552,1779,3331,3588
0130-001,2014,2,12,18,1847,2351,4198,3331
0130-001,2014,2,12,19,1691,2431,4122,4198
0130-001,2014,2,12,20,1361,1569,2930,4122
0130-001,2014,2,12,21,1169,1451,2620,2930
0130-001,2014,2,12,22,1072,1121,2193,2620
0130-001,2014,2,12,23,778,721,1499,2193
0130-001,2014,2,12,24,517,492,1009,1499
0130-001,2014,2,13,1,340,350,690,1009
0130-001,2014,2,13,2,230,251,481,690
0130-001,2014,2,13,3,168,158,326,481
0130-001,2014,2,13,4,169,176,345,326
0130-001,2014,2,13,5,159,214,373,345
0130-001,2014,2,13,6,323,345,668,373
0130-001,2014,2,13,7,1135,663,1798,668
0130-001,2014,2,13,8,2083,1545,3628,1798
0130-001,2014,2,13,9,2143,1981,4124,3628
0130-001,2014,2,13,10,1864,1800,3664,4124
0130-001,2014,2,13,11,1876,2112,3988,3664
0130-001,2014,2,13,12,1648,1984,3632,3988
0130-001,2014,2,13,13,1542,1789,3331,3632
0130-001,2014,2,13,14,1838,1999,3837,3331
0130-001,2014,2,13,15,1917,1807,3724,3837
0130-001,2014,2,13,16,1790,1794,3584,3724
0130-001,2014,2,13,17,1773,1870,3643,3584
0130-001,2014,2,13,18,1878,2305,4183,3643
0130-001,2014,2,13,19,1787,2378,4165,4183
0130-001,2014,2,13,20,1329,1726,3055,4165
0130-001,2014,2,13,21,1186,1492,2678,3055
0130-001,2014,2,13,22,1143,1248,2391,2678
0130-001,2014,2,13,23,801,751,1552,2391
0130-001,2014,2,13,24,484,477,961,1552
0130-001,2014,2,14,1,338,367,705,961
0130-001,2014,2,14,2,252,209,461,705
0130-001,2014,2,14,3,161,157,318,461
0130-001,2014,2,14,4,159,161,320,318
0130-001,2014,2,14,5,172,223,395,320
0130-001,2014,2,14,6,327,329,656,395
0130-001,2014,2,14,7,1127,661,1788,656
0130-001,2014,2,14,8,2183,1548,3731,1788
0130-001,2014,2,14,9,2148,2004,4152,3731
0130-001,2014,2,14,10,1805,1722,3527,4152
0130-001,2014,2,14,11,1839,1769,3608,3527
0130-001,2014,2,14,12,1587,1696,3283,3608
0130-001,2014,2,14,13,1487,1640,3127,3283
0130-001,2014,2,14,14,1877,1829,3706,3127
0130-001,2014,2,14,15,1872,1806,3678,3706
0130-001,2014,2,14,16,1847,1836,3683,3678
0130-001,2014,2,14,17,1745,1933,3678,3683
0130-001,2014,2,14,18,1944,2329,4273,3678
0130-001,2014,2,14,19,1883,2469,4352,4273
0130-001,2014,2,14,20,1536,1978,3514,4352
0130-001,2014,2,14,21,1252,1615,2867,3514
0130-001,2014,2,14,22,1119,1444,2563,2867
0130-001,2014,2,14,23,902,1095,1997,2563
0130-001,2014,2,14,24,670,579,1249,1997
0130-001,2014,2,15,1,429,393,822,1249
0130-001,2014,2,15,2,304,299,603,822
0130-001,2014,2,15,3,244,249,493,603
0130-001,2014,2,15,4,219,188,407,493
0130-001,2014,2,15,5,227,272,499,407
0130-001,2014,2,15,6,352,338,690,499
0130-001,2014,2,15,7,738,540,1278,690
0130-001,2014,2,15,8,1368,1011,2379,1278
0130-001,2014,2,15,9,1410,1415,2825,2379
0130-001,2014,2,15,10,1601,1670,3271,2825
0130-001,2014,2,15,11,1640,1696,3336,3271
0130-001,2014,2,15,12,1626,1932,3558,3336
0130-001,2014,2,15,13,1595,1936,3531,3558
0130-001,2014,2,15,14,1686,1911,3597,3531
0130-001,2014,2,15,15,1707,1792,3499,3597
0130-001,2014,2,15,16,1775,1725,3500,3499
0130-001,2014,2,15,17,1795,1811,3606,3500
0130-001,2014,2,15,18,1984,2119,4103,3606
0130-001,2014,2,15,19,1811,1743,3554,4103
0130-001,2014,2,15,20,1306,1308,2614,3554
0130-001,2014,2,15,21,1056,1013,2069,2614
0130-001,2014,2,15,22,1033,869,1902,2069
0130-001,2014,2,15,23,752,663,1415,1902
0130-001,2014,2,15,24,496,414,910,1415
0130-001,2014,2,16,1,369,315,684,910
0130-001,2014,2,16,2,315,275,590,684
0130-001,2014,2,16,3,221,196,417,590
0130-001,2014,2,16,4,152,151,303,417
0130-001,2014,2,16,5,179,166,345,303
0130-001,2014,2,16,6,227,226,453,345
0130-001,2014,2,16,7,435,355,790,453
0130-001,2014,2,16,8,623,543,1166,790
0130-001,2014,2,16,9,733,887,1620,1166
0130-001,2014,2,16,10,914,1038,1952,1620
0130-001,2014,2,16,11,1120,1222,2342,1952
0130-001,2014,2,16,12,1121,1317,2438,2342
0130-001,2014,2,16,13,1299,1402,2701,2438
0130-001,2014,2,16,14,1428,1545,2973,2701
0130-001,2014,2,16,15,1566,1403,2969,2973
0130-001,2014,2,16,16,1512,1461,2973,2969
0130-001,2014,2,16,17,1623,1493,3116,2973
0130-001,2014,2,16,18,1680,1510,3190,3116
0130-001,2014,2,16,19,1559,1235,2794,3190
0130-001,2014,2,16,20,1142,954,2096,2794
0130-001,2014,2,16,21,915,754,1669,2096
0130-001,2014,2,16,22,903,791,1694,1669
0130-001,2014,2,16,23,629,523,1152,1694
0130-001,2014,2,16,24,389,343,732,1152
0130-001,2014,2,17,1,251,234,485,732
0130-001,2014,2,17,2,174,144,318,485
0130-001,2014,2,17,3,114,114,228,318
0130-001,2014,2,17,4,119,133,252,228
0130-001,2014,2,17,5,134,218,352,252
0130-001,2014,2,17,6,384,346,730,352
0130-001,2014,2,17,7,1339,720,2059,730
0130-001,2014,2,17,8,2194,1645,3839,2059
0130-001,2014,2,17,9,2027,1955,3982,3839
0130-001,2014,2,17,10,1752,1631,3383,3982
0130-001,2014,2,17,11,1726,1756,3482,3383
0130-001,2014,2,17,12,1678,1531,3209,3482
0130-001,2014,2,17,13,1432,1431,2863,3209
0130-001,2014,2,17,14,1792,1760,3552,2863
0130-001,2014,2,17,15,1846,1805,3651,3552
0130-001,2014,2,17,16,1734,1836,3570,3651
0130-001,2014,2,17,17,1693,1832,3525,3570
0130-001,2014,2,17,18,1735,2228,3963,3525
0130-001,2014,2,17,19,1730,2203,3933,3963
0130-001,2014,2,17,20,1304,1726,3030,3933
0130-001,2014,2,17,21,1055,1427,2482,3030
0130-001,2014,2,17,22,1053,1187,2240,2482
0130-001,2014,2,17,23,684,690,1374,2240
0130-001,2014,2,17,24,470,413,883,1374
0130-001,2014,2,18,1,322,317,639,883
0130-001,2014,2,18,2,202,204,406,639
0130-001,2014,2,18,3,163,157,320,406
0130-001,2014,2,18,4,141,175,316,320
0130-001,2014,2,18,5,164,212,376,316
0130-001,2014,2,18,6,319,322,641,376
0130-001,2014,2,18,7,1218,686,1904,641
0130-001,2014,2,18,8,2099,1591,3690,1904
0130-001,2014,2,18,9,2101,1979,4080,3690
0130-001,2014,2,18,10,1797,1678,3475,4080
0130-001,2014,2,18,11,1786,1701,3487,3475
0130-001,2014,2,18,12,1642,1628,3270,3487
0130-001,2014,2,18,13,1469,1490,2959,3270
0130-001,2014,2,18,14,1780,1770,3550,2959
0130-001,2014,2,18,15,1894,1865,3759,3550
0130-001,2014,2,18,16,1799,1811,3610,3759
0130-001,2014,2,18,17,1626,1772,3398,3610
0130-001,2014,2,18,18,1678,2226,3904,3398
0130-001,2014,2,18,19,1703,2216,3919,3904
0130-001,2014,2,18,20,1334,1755,3089,3919
0130-001,2014,2,18,21,1233,1530,2763,3089
0130-001,2014,2,18,22,1069,1186,2255,2763
0130-001,2014,2,18,23,758,718,1476,2255
0130-001,2014,2,18,24,516,452,968,1476
0130-001,2014,2,19,1,344,307,651,968
0130-001,2014,2,19,2,203,211,414,651
0130-001,2014,2,19,3,158,176,334,414
0130-001,2014,2,19,4,134,158,292,334
0130-001,2014,2,19,5,155,229,384,292
0130-001,2014,2,19,6,316,332,648,384
0130-001,2014,2,19,7,1205,664,1869,648
0130-001,2014,2,19,8,2171,1539,3710,1869
0130-001,2014,2,19,9,1991,1947,3938,3710
0130-001,2014,2,19,10,1771,1716,3487,3938
0130-001,2014,2,19,11,1750,1656,3406,3487
0130-001,2014,2,19,12,1647,1638,3285,3406
0130-001,2014,2,19,13,1529,1476,3005,3285
0130-001,2014,2,19,14,1776,1730,3506,3005
0130-001,2014,2,19,15,1772,1805,3577,3506
0130-001,2014,2,19,16,1846,1826,3672,3577
0130-001,2014,2,19,17,1669,1786,3455,3672
0130-001,2014,2,19,18,1758,2291,4049,3455
0130-001,2014,2,19,19,1808,2457,4265,4049
0130-001,2014,2,19,20,1433,1776,3209,4265
0130-001,2014,2,19,21,1209,1451,2660,3209
0130-001,2014,2,19,22,1138,1163,2301,2660
0130-001,2014,2,19,23,811,681,1492,2301
0130-001,2014,2,19,24,529,461,990,1492
0130-001,2014,2,20,1,351,302,653,990
0130-001,2014,2,20,2,234,222,456,653
0130-001,2014,2,20,3,159,155,314,456
0130-001,2014,2,20,4,149,170,319,314
0130-001,2014,2,20,5,160,201,361,319
0130-001,2014,2,20,6,317,303,620,361
0130-001,2014,2,20,7,1183,686,1869,620
0130-001,2014,2,20,8,2123,1476,3599,1869
0130-001,2014,2,20,9,2018,1944,3962,3599
0130-001,2014,2,20,10,1775,1688,3463,3962
0130-001,2014,2,20,11,1732,1793,3525,3463
0130-001,2014,2,20,12,1619,1643,3262,3525
0130-001,2014,2,20,13,1554,1475,3029,3262
0130-001,2014,2,20,14,1775,1734,3509,3029
0130-001,2014,2,20,15,1845,1746,3591,3509
0130-001,2014,2,20,16,1748,1850,3598,3591
0130-001,2014,2,20,17,1603,1815,3418,3598
0130-001,2014,2,20,18,1762,2276,4038,3418
0130-001,2014,2,20,19,1813,2317,4130,4038
0130-001,2014,2,20,20,1415,1680,3095,4130
0130-001,2014,2,20,21,1193,1507,2700,3095
0130-001,2014,2,20,22,1150,1225,2375,2700
0130-001,2014,2,20,23,806,709,1515,2375
0130-001,2014,2,20,24,557,498,1055,1515
0130-001,2014,2,21,1,365,357,722,1055
0130-001,2014,2,21,2,243,234,477,722
0130-001,2014,2,21,3,164,171,335,477
0130-001,2014,2,21,4,115,146,261,335
0130-001,2014,2,21,5,196,233,429,261
0130-001,2014,2,21,6,338,342,680,429
0130-001,2014,2,21,7,1199,620,1819,680
0130-001,2014,2,21,8,2121,1528,3649,1819
0130-001,2014,2,21,9,2027,1935,3962,3649
0130-001,2014,2,21,10,1724,1669,3393,3962
0130-001,2014,2,21,11,1753,1732,3485,3393
0130-001,2014,2,21,12,1682,1689,3371,3485
0130-001,2014,2,21,13,1554,1648,3202,3371
0130-001,2014,2,21,14,1820,1906,3726,3202
0130-001,2014,2,21,15,1745,1671,3416,3726
0130-001,2014,2,21,16,1868,1873,3741,3416
0130-001,2014,2,21,17,1834,1885,3719,3741
0130-001,2014,2,21,18,1901,2369,4270,3719
0130-001,2014,2,21,19,2012,2553,4565,4270
0130-001,2014,2,21,20,1581,2006,3587,4565
0130-001,2014,2,21,21,1303,1600,2903,3587
0130-001,2014,2,21,22,1209,1275,2484,2903
0130-001,2014,2,21,23,940,795,1735,2484
0130-001,2014,2,21,24,664,605,1269,1735
0130-001,2014,2,22,1,461,411,872,1269
0130-001,2014,2,22,2,318,262,580,872
0130-001,2014,2,22,3,252,223,475,580
0130-001,2014,2,22,4,182,200,382,475
0130-001,2014,2,22,5,175,251,426,382
0130-001,2014,2,22,6,325,368,693,426
0130-001,2014,2,22,7,742,504,1246,693
0130-001,2014,2,22,8,1379,1010,2389,1246
0130-001,2014,2,22,9,1523,1594,3117,2389
0130-001,2014,2,22,10,1659,1779,3438,3117
0130-001,2014,2,22,11,1732,1924,3656,3438
0130-001,2014,2,22,12,1749,2128,3877,3656
0130-001,2014,2,22,13,1777,2209,3986,3877
0130-001,2014,2,22,14,1896,2159,4055,3986
0130-001,2014,2,22,15,1860,1978,3838,4055
0130-001,2014,2,22,16,1969,1992,3961,3838
0130-001,2014,2,22,17,1928,1896,3824,3961
0130-001,2014,2,22,18,2022,2231,4253,3824
0130-001,2014,2,22,19,2007,1948,3955,4253
0130-001,2014,2,22,20,1485,1356,2841,3955
0130-001,2014,2,22,21,1198,1104,2302,2841
0130-001,2014,2,22,22,1150,906,2056,2302
0130-001,2014,2,22,23,881,633,1514,2056
0130-001,2014,2,22,24,562,449,1011,1514
0130-001,2014,2,23,1,374,342,716,1011
0130-001,2014,2,23,2,262,276,538,716
0130-001,2014,2,23,3,222,201,423,538
0130-001,2014,2,23,4,140,152,292,423
0130-001,2014,2,23,5,157,146,303,292
0130-001,2014,2,23,6,220,225,445,303
0130-001,2014,2,23,7,463,335,798,445
0130-001,2014,2,23,8,629,540,1169,798
0130-001,2014,2,23,9,723,900,1623,1169
0130-001,2014,2,23,10,926,981,1907,1623
0130-001,2014,2,23,11,1050,1211,2261,1907
0130-001,2014,2,23,12,1078,1339,2417,2261
0130-001,2014,2,23,13,1244,1371,2615,2417
0130-001,2014,2,23,14,1423,1307,2730,2615
0130-001,2014,2,23,15,1441,1363,2804,2730
0130-001,2014,2,23,16,1633,1421,3054,2804
0130-001,2014,2,23,17,1698,1438,3136,3054
0130-001,2014,2,23,18,1647,1535,3182,3136
0130-001,2014,2,23,19,1614,1285,2899,3182
0130-001,2014,2,23,20,1206,1050,2256,2899
0130-001,2014,2,23,21,1041,877,1918,2256
0130-001,2014,2,23,22,954,730,1684,1918
0130-001,2014,2,23,23,608,499,1107,1684
0130-001,2014,2,23,24,380,349,729,1107
0130-001,2014,2,24,1,234,225,459,729
0130-001,2014,2,24,2,176,138,314,459
0130-001,2014,2,24,3,123,115,238,314
0130-001,2014,2,24,4,103,122,225,238
0130-001,2014,2,24,5,141,192,333,225
0130-001,2014,2,24,6,326,362,688,333
0130-001,2014,2,24,7,1307,698,2005,688
0130-001,2014,2,24,8,2161,1470,3631,2005
0130-001,2014,2,24,9,2034,1897,3931,3631
0130-001,2014,2,24,10,1651,1758,3409,3931
0130-001,2014,2,24,11,1841,1655,3496,3409
0130-001,2014,2,24,12,1746,1668,3414,3496
0130-001,2014,2,24,13,1529,1560,3089,3414
0130-001,2014,2,24,14,1810,1824,3634,3089
0130-001,2014,2,24,15,1785,1810,3595,3634
0130-001,2014,2,24,16,1895,1886,3781,3595
0130-001,2014,2,24,17,1684,1809,3493,3781
0130-001,2014,2,24,18,1811,2244,4055,3493
0130-001,2014,2,24,19,1734,2430,4164,4055
0130-001,2014,2,24,20,1392,1783,3175,4164
0130-001,2014,2,24,21,1151,1608,2759,3175
0130-001,2014,2,24,22,1037,1233,2270,2759
0130-001,2014,2,24,23,782,730,1512,2270
0130-001,2014,2,24,24,484,515,999,1512
0130-001,2014,2,25,1,308,300,608,999
0130-001,2014,2,25,2,220,192,412,608
0130-001,2014,2,25,3,151,160,311,412
0130-001,2014,2,25,4,123,142,265,311
0130-001,2014,2,25,5,167,235,402,265
0130-001,2014,2,25,6,315,306,621,402
0130-001,2014,2,25,7,1176,643,1819,621
0130-001,2014,2,25,8,2104,1496,3600,1819
0130-001,2014,2,25,9,2102,1931,4033,3600
0130-001,2014,2,25,10,1918,1735,3653,4033
0130-001,2014,2,25,11,1755,1662,3417,3653
0130-001,2014,2,25,12,1726,1654,3380,3417
0130-001,2014,2,25,13,1517,1591,3108,3380
0130-001,2014,2,25,14,1760,1784,3544,3108
0130-001,2014,2,25,15,1779,1829,3608,3544
0130-001,2014,2,25,16,1861,1888,3749,3608
0130-001,2014,2,25,17,1769,1826,3595,3749
0130-001,2014,2,25,18,1826,2324,4150,3595
0130-001,2014,2,25,19,1751,2406,4157,4150
0130-001,2014,2,25,20,1439,1788,3227,4157
0130-001,2014,2,25,21,1166,1599,2765,3227
0130-001,2014,2,25,22,1140,1254,2394,2765
0130-001,2014,2,25,23,887,747,1634,2394
0130-001,2014,2,25,24,551,509,1060,1634
0130-001,2014,2,26,1,385,324,709,1060
0130-001,2014,2,26,2,230,240,470,709
0130-001,2014,2,26,3,192,178,370,470
0130-001,2014,2,26,4,146,158,304,370
0130-001,2014,2,26,5,192,238,430,304
0130-001,2014,2,26,6,348,325,673,430
0130-001,2014,2,26,7,1121,648,1769,673
0130-001,2014,2,26,8,2120,1429,3549,1769
0130-001,2014,2,26,9,2052,1972,4024,3549
0130-001,2014,2,26,10,1832,1657,3489,4024
0130-001,2014,2,26,11,1878,1699,3577,3489
0130-001,2014,2,26,12,1753,1719,3472,3577
0130-001,2014,2,26,13,1549,1607,3156,3472
0130-001,2014,2,26,14,1792,1863,3655,3156
0130-001,2014,2,26,15,1887,1782,3669,3655
0130-001,2014,2,26,16,1787,1752,3539,3669
0130-001,2014,2,26,17,1663,1809,3472,3539
0130-001,2014,2,26,18,1759,2308,4067,3472
0130-001,2014,2,26,19,1836,2518,4354,4067
0130-001,2014,2,26,20,1414,1915,3329,4354
0130-001,2014,2,26,21,1180,1523,2703,3329
0130-001,2014,2,26,22,1132,1193,2325,2703
0130-001,2014,2,26,23,835,746,1581,2325
0130-001,2014,2,26,24,576,488,1064,1581
0130-001,2014,2,27,1,361,349,710,1064
0130-001,2014,2,27,2,282,278,560,710
0130-001,2014,2,27,3,175,183,358,560
0130-001,2014,2,27,4,155,163,318,358
0130-001,2014,2,27,5,178,226,404,318
0130-001,2014,2,27,6,303,310,613,404
0130-001,2014,2,27,7,1140,669,1809,613
0130-001,2014,2,27,8,2131,1442,3573,1809
0130-001,2014,2,27,9,2120,1966,4086,3573
0130-001,2014,2,27,10,1807,1683,3490,4086
0130-001,2014,2,27,11,1763,1668,3431,3490
0130-001,2014,2,27,12,1756,1711,3467,3431
0130-001,2014,2,27,13,1491,1529,3020,3467
0130-001,2014,2,27,14,1788,1748,3536,3020
0130-001,2014,2,27,15,1875,1804,3679,3536
0130-001,2014,2,27,16,1809,1806,3615,3679
0130-001,2014,2,27,17,1691,1858,3549,3615
0130-001,2014,2,27,18,1749,2227,3976,3549
0130-001,2014,2,27,19,1765,2459,4224,3976
0130-001,2014,2,27,20,1417,1783,3200,4224
0130-001,2014,2,27,21,1237,1634,2871,3200
0130-001,2014,2,27,22,1130,1360,2490,2871
0130-001,2014,2,27,23,941,885,1826,2490
0130-001,2014,2,27,24,665,655,1320,1826
0130-001,2014,2,28,1,406,434,840,1320
0130-001,2014,2,28,2,264,268,532,840
0130-001,2014,2,28,3,177,193,370,532
0130-001,2014,2,28,4,159,160,319,370
0130-001,2014,2,28,5,198,222,420,319
0130-001,2014,2,28,6,329,337,666,420
0130-001,2014,2,28,7,1163,637,1800,666
0130-001,2014,2,28,8,2118,1452,3570,1800
0130-001,2014,2,28,9,2031,1904,3935,3570
0130-001,2014,2,28,10,1815,1767,3582,3935
0130-001,2014,2,28,11,1785,1840,3625,3582
0130-001,2014,2,28,12,1784,1690,3474,3625
0130-001,2014,2,28,13,1587,1719,3306,3474
0130-001,2014,2,28,14,1762,1808,3570,3306
0130-001,2014,2,28,15,1908,1943,3851,3570
0130-001,2014,2,28,16,1881,1991,3872,3851
0130-001,2014,2,28,17,1791,1892,3683,3872
0130-001,2014,2,28,18,1963,2360,4323,3683
0130-001,2014,2,28,19,1955,2556,4511,4323
0130-001,2014,2,28,20,1664,2073,3737,4511
0130-001,2014,2,28,21,1388,1650,3038,3737
0130-001,2014,2,28,22,1182,1337,2519,3038
0130-001,2014,2,28,23,1002,939,1941,2519
0130-001,2014,2,28,24,732,653,1385,1941
0130-001,2014,3,1,1,526,444,970,1385
0130-001,2014,3,1,2,386,342,728,970
0130-001,2014,3,1,3,282,249,531,728
0130-001,2014,3,1,4,218,206,424,531
0130-001,2014,3,1,5,224,248,472,424
0130-001,2014,3,1,6,349,346,695,472
0130-001,2014,3,1,7,739,486,1225,695
0130-001,2014,3,1,8,1211,921,2132,1225
0130-001,2014,3,1,9,1313,1194,2507,2132
0130-001,2014,3,1,10,1497,1562,3059,2507
0130-001,2014,3,1,11,1531,1746,3277,3059
0130-001,2014,3,1,12,1643,1977,3620,3277
0130-001,2014,3,1,13,1470,2324,3794,3620
0130-001,2014,3,1,14,1829,2105,3934,3794
0130-001,2014,3,1,15,1854,2126,3980,3934
0130-001,2014,3,1,16,1923,2003,3926,3980
0130-001,2014,3,1,17,1976,1876,3852,3926
0130-001,2014,3,1,18,1899,2129,4028,3852
0130-001,2014,3,1,19,1936,1889,3825,4028
0130-001,2014,3,1,20,1646,1257,2903,3825
0130-001,2014,3,1,21,1293,1055,2348,2903
0130-001,2014,3,1,22,1074,883,1957,2348
0130-001,2014,3,1,23,778,580,1358,1957
0130-001,2014,3,1,24,584,511,1095,1358
0130-001,2014,3,2,1,403,334,737,1095
0130-001,2014,3,2,2,257,256,513,737
0130-001,2014,3,2,3,237,207,444,513
0130-001,2014,3,2,4,172,163,335,444
0130-001,2014,3,2,5,167,127,294,335
0130-001,2014,3,2,6,223,220,443,294
0130-001,2014,3,2,7,484,331,815,443
0130-001,2014,3,2,8,619,519,1138,815
0130-001,2014,3,2,9,817,925,1742,1138
0130-001,2014,3,2,10,919,1060,1979,1742
0130-001,2014,3,2,11,1136,1254,2390,1979
0130-001,2014,3,2,12,1248,1384,2632,2390
0130-001,2014,3,2,13,1328,1753,3081,2632
0130-001,2014,3,2,14,1629,1677,3306,3081
0130-001,2014,3,2,15,1831,1754,3585,3306
0130-001,2014,3,2,16,2000,1753,3753,3585
0130-001,2014,3,2,17,1923,1647,3570,3753
0130-001,2014,3,2,18,1913,1734,3647,3570
0130-001,2014,3,2,19,1867,1451,3318,3647
0130-001,2014,3,2,20,1815,1194,3009,3318
0130-001,2014,3,2,21,1635,987,2622,3009
0130-001,2014,3,2,22,1407,764,2171,2622
0130-001,2014,3,2,23,850,557,1407,2171
0130-001,2014,3,2,24,457,357,814,1407
0130-001,2014,3,3,1,285,228,513,814
0130-001,2014,3,3,2,155,140,295,513
0130-001,2014,3,3,3,118,104,222,295
0130-001,2014,3,3,4,109,121,230,222
0130-001,2014,3,3,5,147,194,341,230
0130-001,2014,3,3,6,389,342,731,341
0130-001,2014,3,3,7,1360,711,2071,731
0130-001,2014,3,3,8,2154,1752,3906,2071
0130-001,2014,3,3,9,2292,2019,4311,3906
0130-001,2014,3,3,10,1884,1828,3712,4311
0130-001,2014,3,3,11,1774,1684,3458,3712
0130-001,2014,3,3,12,1702,1693,3395,3458
0130-001,2014,3,3,13,1508,1583,3091,3395
0130-001,2014,3,3,14,1800,1801,3601,3091
0130-001,2014,3,3,15,1861,1889,3750,3601
0130-001,2014,3,3,16,1863,1953,3816,3750
0130-001,2014,3,3,17,1843,1793,3636,3816
0130-001,2014,3,3,18,1803,2312,4115,3636
0130-001,2014,3,3,19,1782,2368,4150,4115
0130-001,2014,3,3,20,1511,1791,3302,4150
0130-001,2014,3,3,21,1215,1664,2879,3302
0130-001,2014,3,3,22,1070,1194,2264,2879
0130-001,2014,3,3,23,815,785,1600,2264
0130-001,2014,3,3,24,538,508,1046,1600
0130-001,2014,3,4,1,319,312,631,1046
0130-001,2014,3,4,2,217,210,427,631
0130-001,2014,3,4,3,137,150,287,427
0130-001,2014,3,4,4,141,154,295,287
0130-001,2014,3,4,5,181,209,390,295
0130-001,2014,3,4,6,307,327,634,390
0130-001,2014,3,4,7,1258,685,1943,634
0130-001,2014,3,4,8,2110,1631,3741,1943
0130-001,2014,3,4,9,2224,1998,4222,3741
0130-001,2014,3,4,10,1899,1661,3560,4222
0130-001,2014,3,4,11,1730,1676,3406,3560
0130-001,2014,3,4,12,1645,1551,3196,3406
0130-001,2014,3,4,13,1426,1451,2877,3196
0130-001,2014,3,4,14,1708,1674,3382,2877
0130-001,2014,3,4,15,1816,1761,3577,3382
0130-001,2014,3,4,16,1791,1821,3612,3577
0130-001,2014,3,4,17,1715,1850,3565,3612
0130-001,2014,3,4,18,1736,2273,4009,3565
0130-001,2014,3,4,19,1750,2435,4185,4009
0130-001,2014,3,4,20,1423,1778,3201,4185
0130-001,2014,3,4,21,1211,1622,2833,3201
0130-001,2014,3,4,22,1123,1306,2429,2833
0130-001,2014,3,4,23,836,785,1621,2429
0130-001,2014,3,4,24,534,496,1030,1621
0130-001,2014,3,5,1,354,304,658,1030
0130-001,2014,3,5,2,221,196,417,658
0130-001,2014,3,5,3,158,181,339,417
0130-001,2014,3,5,4,139,149,288,339
0130-001,2014,3,5,5,170,192,362,288
0130-001,2014,3,5,6,309,319,628,362
0130-001,2014,3,5,7,1185,679,1864,628
0130-001,2014,3,5,8,2089,1650,3739,1864
0130-001,2014,3,5,9,2275,2016,4291,3739
0130-001,2014,3,5,10,1836,1647,3483,4291
0130-001,2014,3,5,11,1787,1642,3429,3483
0130-001,2014,3,5,12,1704,1563,3267,3429
0130-001,2014,3,5,13,1421,1476,2897,3267
0130-001,2014,3,5,14,1726,1691,3417,2897
0130-001,2014,3,5,15,1822,1773,3595,3417
0130-001,2014,3,5,16,1823,1891,3714,3595
0130-001,2014,3,5,17,1691,1765,3456,3714
0130-001,2014,3,5,18,1751,2380,4131,3456
0130-001,2014,3,5,19,1843,2494,4337,4131
0130-001,2014,3,5,20,1448,1832,3280,4337
0130-001,2014,3,5,21,1164,1492,2656,3280
0130-001,2014,3,5,22,1132,1273,2405,2656
0130-001,2014,3,5,23,887,773,1660,2405
0130-001,2014,3,5,24,509,505,1014,1660
0130-001,2014,3,6,1,363,348,711,1014
0130-001,2014,3,6,2,230,220,450,711
0130-001,2014,3,6,3,175,179,354,450
0130-001,2014,3,6,4,130,171,301,354
0130-001,2014,3,6,5,171,218,389,301
0130-001,2014,3,6,6,321,288,609,389
0130-001,2014,3,6,7,1183,714,1897,609
0130-001,2014,3,6,8,2183,1647,3830,1897
0130-001,2014,3,6,9,2236,1959,4195,3830
0130-001,2014,3,6,10,1772,1724,3496,4195
0130-001,2014,3,6,11,1747,1622,3369,3496
0130-001,2014,3,6,12,1584,1577,3161,3369
0130-001,2014,3,6,13,1363,1385,2748,3161
0130-001,2014,3,6,14,1706,1712,3418,2748
0130-001,2014,3,6,15,1807,1733,3540,3418
0130-001,2014,3,6,16,1848,1796,3644,3540
0130-001,2014,3,6,17,1650,1801,3451,3644
0130-001,2014,3,6,18,1675,2233,3908,3451
0130-001,2014,3,6,19,1749,2423,4172,3908
0130-001,2014,3,6,20,1392,1745,3137,4172
0130-001,2014,3,6,21,1155,1553,2708,3137
0130-001,2014,3,6,22,1201,1282,2483,2708
0130-001,2014,3,6,23,810,831,1641,2483
0130-001,2014,3,6,24,593,528,1121,1641
0130-001,2014,3,7,1,362,338,700,1121
0130-001,2014,3,7,2,239,239,478,700
0130-001,2014,3,7,3,157,170,327,478
0130-001,2014,3,7,4,153,159,312,327
0130-001,2014,3,7,5,167,229,396,312
0130-001,2014,3,7,6,321,329,650,396
0130-001,2014,3,7,7,1216,683,1899,650
0130-001,2014,3,7,8,2105,1668,3773,1899
0130-001,2014,3,7,9,2239,1986,4225,3773
0130-001,2014,3,7,10,1797,1694,3491,4225
0130-001,2014,3,7,11,1778,1689,3467,3491
0130-001,2014,3,7,12,1600,1601,3201,3467
0130-001,2014,3,7,13,1422,1446,2868,3201
0130-001,2014,3,7,14,1749,1644,3393,2868
0130-001,2014,3,7,15,1816,1770,3586,3393
0130-001,2014,3,7,16,1797,1877,3674,3586
0130-001,2014,3,7,17,1864,1889,3753,3674
0130-001,2014,3,7,18,1813,2357,4170,3753
0130-001,2014,3,7,19,2004,2599,4603,4170
0130-001,2014,3,7,20,1553,2025,3578,4603
0130-001,2014,3,7,21,1300,1647,2947,3578
0130-001,2014,3,7,22,1212,1274,2486,2947
0130-001,2014,3,7,23,999,824,1823,2486
0130-001,2014,3,7,24,681,588,1269,1823
0130-001,2014,3,8,1,489,386,875,1269
0130-001,2014,3,8,2,312,298,610,875
0130-001,2014,3,8,3,241,220,461,610
0130-001,2014,3,8,4,231,222,453,461
0130-001,2014,3,8,5,212,237,449,453
0130-001,2014,3,8,6,339,347,686,449
0130-001,2014,3,8,7,853,557,1410,686
0130-001,2014,3,8,8,1450,972,2422,1410
0130-001,2014,3,8,9,1622,1659,3281,2422
0130-001,2014,3,8,10,1651,1801,3452,3281
0130-001,2014,3,8,11,1668,1863,3531,3452
0130-001,2014,3,8,12,1684,1874,3558,3531
0130-001,2014,3,8,13,1706,2029,3735,3558
0130-001,2014,3,8,14,1880,1755,3635,3735
0130-001,2014,3,8,15,1725,1946,3671,3635
0130-001,2014,3,8,16,1782,1808,3590,3671
0130-001,2014,3,8,17,1819,1794,3613,3590
0130-001,2014,3,8,18,1975,2266,4241,3613
0130-001,2014,3,8,19,1829,1960,3789,4241
0130-001,2014,3,8,20,1437,1321,2758,3789
0130-001,2014,3,8,21,1082,1124,2206,2758
0130-001,2014,3,8,22,1092,882,1974,2206
0130-001,2014,3,8,23,901,661,1562,1974
0130-001,2014,3,8,24,525,448,973,1562
0130-001,2014,3,9,1,435,344,779,973
0130-001,2014,3,9,2,292,269,561,779
0130-001,2014,3,9,3,225,155,380,561
0130-001,2014,3,9,4,206,106,312,380
0130-001,2014,3,9,5,160,109,269,312
0130-001,2014,3,9,6,227,180,407,269
0130-001,2014,3,9,7,399,267,666,407
0130-001,2014,3,9,8,610,461,1071,666
0130-001,2014,3,9,9,749,755,1504,1071
0130-001,2014,3,9,10,820,1020,1840,1504
0130-001,2014,3,9,11,1060,1250,2310,1840
0130-001,2014,3,9,12,1088,1304,2392,2310
0130-001,2014,3,9,13,1287,1446,2733,2392
0130-001,2014,3,9,14,1438,1383,2821,2733
0130-001,2014,3,9,15,1474,1412,2886,2821
0130-001,2014,3,9,16,1573,1440,3013,2886
0130-001,2014,3,9,17,1660,1512,3172,3013
0130-001,2014,3,9,18,1560,1455,3015,3172
0130-001,2014,3,9,19,1517,1131,2648,3015
0130-001,2014,3,9,20,1205,1002,2207,2648
0130-001,2014,3,9,21,1068,907,1975,2207
0130-001,2014,3,9,22,879,705,1584,1975
0130-001,2014,3,9,23,611,511,1122,1584
0130-001,2014,3,9,24,428,320,748,1122
0130-001,2014,3,10,1,223,212,435,748
0130-001,2014,3,10,2,171,151,322,435
0130-001,2014,3,10,3,94,95,189,322
0130-001,2014,3,10,4,115,111,226,189
0130-001,2014,3,10,5,147,180,327,226
0130-001,2014,3,10,6,348,316,664,327
0130-001,2014,3,10,7,1353,776,2129,664
0130-001,2014,3,10,8,2201,1764,3965,2129
0130-001,2014,3,10,9,2232,2019,4251,3965
0130-001,2014,3,10,10,1759,1633,3392,4251
0130-001,2014,3,10,11,1853,1551,3404,3392
0130-001,2014,3,10,12,1689,1517,3206,3404
0130-001,2014,3,10,13,1490,1473,2963,3206
0130-001,2014,3,10,14,1703,1773,3476,2963
0130-001,2014,3,10,15,1787,1756,3543,3476
0130-001,2014,3,10,16,1784,1833,3617,3543
0130-001,2014,3,10,17,1777,1865,3642,3617
0130-001,2014,3,10,18,1770,2296,4066,3642
0130-001,2014,3,10,19,1827,2507,4334,4066
0130-001,2014,3,10,20,1363,1908,3271,4334
0130-001,2014,3,10,21,1205,1655,2860,3271
0130-001,2014,3,10,22,1120,1305,2425,2860
0130-001,2014,3,10,23,857,753,1610,2425
0130-001,2014,3,10,24,517,497,1014,1610
0130-001,2014,3,11,1,340,336,676,1014
0130-001,2014,3,11,2,229,189,418,676
0130-001,2014,3,11,3,145,178,323,418
0130-001,2014,3,11,4,131,152,283,323
0130-001,2014,3,11,5,167,209,376,283
0130-001,2014,3,11,6,334,369,703,376
0130-001,2014,3,11,7,1266,657,1923,703
0130-001,2014,3,11,8,2250,1724,3974,1923
0130-001,2014,3,11,9,2276,2046,4322,3974
0130-001,2014,3,11,10,1817,1740,3557,4322
0130-001,2014,3,11,11,1783,1659,3442,3557
0130-001,2014,3,11,12,1654,1593,3247,3442
0130-001,2014,3,11,13,1490,1467,2957,3247
0130-001,2014,3,11,14,1678,1632,3310,2957
0130-001,2014,3,11,15,1785,1867,3652,3310
0130-001,2014,3,11,16,1876,1876,3752,3652
0130-001,2014,3,11,17,1668,1873,3541,3752
0130-001,2014,3,11,18,1749,2294,4043,3541
0130-001,2014,3,11,19,1718,2438,4156,4043
0130-001,2014,3,11,20,1358,1844,3202,4156
0130-001,2014,3,11,21,1242,1648,2890,3202
0130-001,2014,3,11,22,1165,1324,2489,2890
0130-001,2014,3,11,23,814,803,1617,2489
0130-001,2014,3,11,24,586,526,1112,1617
0130-001,2014,3,12,1,401,348,749,1112
0130-001,2014,3,12,2,255,229,484,749
0130-001,2014,3,12,3,145,186,331,484
0130-001,2014,3,12,4,140,129,269,331
0130-001,2014,3,12,5,166,222,388,269
0130-001,2014,3,12,6,359,344,703,388
0130-001,2014,3,12,7,1138,669,1807,703
0130-001,2014,3,12,8,2188,1705,3893,1807
0130-001,2014,3,12,9,2224,2067,4291,3893
0130-001,2014,3,12,10,1816,1644,3460,4291
0130-001,2014,3,12,11,1723,1700,3423,3460
0130-001,2014,3,12,12,1649,1499,3148,3423
0130-001,2014,3,12,13,1421,1336,2757,3148
0130-001,2014,3,12,14,1651,1716,3367,2757
0130-001,2014,3,12,15,1689,1780,3469,3367
0130-001,2014,3,12,16,1706,1740,3446,3469
0130-001,2014,3,12,17,1681,1809,3490,3446
0130-001,2014,3,12,18,1799,2152,3951,3490
0130-001,2014,3,12,19,1703,2422,4125,3951
0130-001,2014,3,12,20,1390,1847,3237,4125
0130-001,2014,3,12,21,1117,1413,2530,3237
0130-001,2014,3,12,22,1096,1144,2240,2530
0130-001,2014,3,12,23,819,790,1609,2240
0130-001,2014,3,12,24,594,453,1047,1609
0130-001,2014,3,13,1,387,339,726,1047
0130-001,2014,3,13,2,222,234,456,726
0130-001,2014,3,13,3,176,191,367,456
0130-001,2014,3,13,4,138,156,294,367
0130-001,2014,3,13,5,171,218,389,294
0130-001,2014,3,13,6,325,344,669,389
0130-001,2014,3,13,7,1126,676,1802,669
0130-001,2014,3,13,8,2155,1690,3845,1802
0130-001,2014,3,13,9,2226,2035,4261,3845
0130-001,2014,3,13,10,1811,1735,3546,4261
0130-001,2014,3,13,11,1838,1674,3512,3546
0130-001,2014,3,13,12,1628,1676,3304,3512
0130-001,2014,3,13,13,1487,1545,3032,3304
0130-001,2014,3,13,14,1730,1662,3392,3032
0130-001,2014,3,13,15,1835,1780,3615,3392
0130-001,2014,3,13,16,1758,1906,3664,3615
0130-001,2014,3,13,17,1682,1828,3510,3664
0130-001,2014,3,13,18,1747,2237,3984,3510
0130-001,2014,3,13,19,1753,2233,3986,3984
0130-001,2014,3,13,20,1328,1321,2649,3986
0130-001,2014,3,13,21,1169,1393,2562,2649
0130-001,2014,3,13,22,1247,1157,2404,2562
0130-001,2014,3,13,23,882,716,1598,2404
0130-001,2014,3,13,24,598,509,1107,1598
0130-001,2014,3,14,1,389,331,720,1107
0130-001,2014,3,14,2,241,233,474,720
0130-001,2014,3,14,3,174,169,343,474
0130-001,2014,3,14,4,125,154,279,343
0130-001,2014,3,14,5,179,211,390,279
0130-001,2014,3,14,6,332,330,662,390
0130-001,2014,3,14,7,1185,627,1812,662
0130-001,2014,3,14,8,2134,1675,3809,1812
0130-001,2014,3,14,9,2207,2017,4224,3809
0130-001,2014,3,14,10,1844,1717,3561,4224
0130-001,2014,3,14,11,1897,1769,3666,3561
0130-001,2014,3,14,12,1696,1704,3400,3666
0130-001,2014,3,14,13,1469,1594,3063,3400
0130-001,2014,3,14,14,1767,1862,3629,3063
0130-001,2014,3,14,15,1562,1613,3175,3629
0130-001,2014,3,14,16,1849,1932,3781,3175
0130-001,2014,3,14,17,1856,1968,3824,3781
0130-001,2014,3,14,18,2064,2440,4504,3824
0130-001,2014,3,14,19,1942,2673,4615,4504
0130-001,2014,3,14,20,1636,2262,3898,4615
0130-001,2014,3,14,21,1358,1773,3131,3898
0130-001,2014,3,14,22,1282,1372,2654,3131
0130-001,2014,3,14,23,1025,887,1912,2654
0130-001,2014,3,14,24,683,637,1320,1912
0130-001,2014,3,15,1,512,443,955,1320
0130-001,2014,3,15,2,316,302,618,955
0130-001,2014,3,15,3,277,236,513,618
0130-001,2014,3,15,4,207,210,417,513
0130-001,2014,3,15,5,212,246,458,417
0130-001,2014,3,15,6,354,365,719,458
0130-001,2014,3,15,7,868,604,1472,719
0130-001,2014,3,15,8,1477,1096,2573,1472
0130-001,2014,3,15,9,1656,1675,3331,2573
0130-001,2014,3,15,10,1713,1736,3449,3331
0130-001,2014,3,15,11,1727,1818,3545,3449
0130-001,2014,3,15,12,1762,1909,3671,3545
0130-001,2014,3,15,13,1706,1970,3676,3671
0130-001,2014,3,15,14,1836,1935,3771,3676
0130-001,2014,3,15,15,1775,1909,3684,3771
0130-001,2014,3,15,16,1857,1892,3749,3684
0130-001,2014,3,15,17,2001,2048,4049,3749
0130-001,2014,3,15,18,2075,2201,4276,4049
0130-001,2014,3,15,19,1937,1982,3919,4276
0130-001,2014,3,15,20,1458,1471,2929,3919
0130-001,2014,3,15,21,1199,1181,2380,2929
0130-001,2014,3,15,22,1104,960,2064,2380
0130-001,2014,3,15,23,833,646,1479,2064
0130-001,2014,3,15,24,523,512,1035,1479
0130-001,2014,3,16,1,450,379,829,1035
0130-001,2014,3,16,2,310,303,613,829
0130-001,2014,3,16,3,221,225,446,613
0130-001,2014,3,16,4,185,157,342,446
0130-001,2014,3,16,5,182,149,331,342
0130-001,2014,3,16,6,268,234,502,331
0130-001,2014,3,16,7,512,387,899,502
0130-001,2014,3,16,8,711,596,1307,899
0130-001,2014,3,16,9,813,881,1694,1307
0130-001,2014,3,16,10,1040,1077,2117,1694
0130-001,2014,3,16,11,1156,1320,2476,2117
0130-001,2014,3,16,12,1211,1332,2543,2476
0130-001,2014,3,16,13,1333,1444,2777,2543
0130-001,2014,3,16,14,1496,1460,2956,2777
0130-001,2014,3,16,15,1703,1364,3067,2956
0130-001,2014,3,16,16,1637,1654,3291,3067
0130-001,2014,3,16,17,1633,1644,3277,3291
0130-001,2014,3,16,18,1738,1744,3482,3277
0130-001,2014,3,16,19,1877,1415,3292,3482
0130-001,2014,3,16,20,1419,1258,2677,3292
0130-001,2014,3,16,21,1134,1026,2160,2677
0130-001,2014,3,16,22,1016,798,1814,2160
0130-001,2014,3,16,23,667,576,1243,1814
0130-001,2014,3,16,24,465,371,836,1243
0130-001,2014,3,17,1,291,234,525,836
0130-001,2014,3,17,2,197,155,352,525
0130-001,2014,3,17,3,131,123,254,352
0130-001,2014,3,17,4,107,114,221,254
0130-001,2014,3,17,5,179,190,369,221
0130-001,2014,3,17,6,382,371,753,369
0130-001,2014,3,17,7,1407,808,2215,753
0130-001,2014,3,17,8,2134,1757,3891,2215
0130-001,2014,3,17,9,2331,2058,4389,3891
0130-001,2014,3,17,10,1774,1715,3489,4389
0130-001,2014,3,17,11,1780,1682,3462,3489
0130-001,2014,3,17,12,1627,1512,3139,3462
0130-001,2014,3,17,13,1448,1262,2710,3139
0130-001,2014,3,17,14,1694,1474,3168,2710
0130-001,2014,3,17,15,1940,1658,3598,3168
0130-001,2014,3,17,16,1820,1832,3652,3598
0130-001,2014,3,17,17,1757,1971,3728,3652
0130-001,2014,3,17,18,1768,2294,4062,3728
0130-001,2014,3,17,19,1724,2425,4149,4062
0130-001,2014,3,17,20,1352,1749,3101,4149
0130-001,2014,3,17,21,1130,1657,2787,3101
0130-001,2014,3,17,22,1124,1301,2425,2787
0130-001,2014,3,17,23,730,772,1502,2425
0130-001,2014,3,17,24,529,512,1041,1502
0130-001,2014,3,18,1,377,332,709,1041
0130-001,2014,3,18,2,197,197,394,709
0130-001,2014,3,18,3,147,195,342,394
0130-001,2014,3,18,4,132,135,267,342
0130-001,2014,3,18,5,169,224,393,267
0130-001,2014,3,18,6,330,324,654,393
0130-001,2014,3,18,7,1233,689,1922,654
0130-001,2014,3,18,8,2128,1713,3841,1922
0130-001,2014,3,18,9,2231,2021,4252,3841
0130-001,2014,3,18,10,1766,1739,3505,4252
0130-001,2014,3,18,11,1823,1740,3563,3505
0130-001,2014,3,18,12,1771,1621,3392,3563
0130-001,2014,3,18,13,1519,1454,2973,3392
0130-001,2014,3,18,14,1697,1705,3402,2973
0130-001,2014,3,18,15,1799,1772,3571,3402
0130-001,2014,3,18,16,1787,1767,3554,3571
0130-001,2014,3,18,17,1689,1881,3570,3554
0130-001,2014,3,18,18,1747,2292,4039,3570
0130-001,2014,3,18,19,1818,2461,4279,4039
0130-001,2014,3,18,20,1413,1828,3241,4279
0130-001,2014,3,18,21,1313,1667,2980,3241
0130-001,2014,3,18,22,1265,1349,2614,2980
0130-001,2014,3,18,23,856,817,1673,2614
0130-001,2014,3,18,24,514,485,999,1673
0130-001,2014,3,19,1,400,358,758,999
0130-001,2014,3,19,2,234,217,451,758
0130-001,2014,3,19,3,182,206,388,451
0130-001,2014,3,19,4,134,150,284,388
0130-001,2014,3,19,5,181,236,417,284
0130-001,2014,3,19,6,410,349,759,417
0130-001,2014,3,19,7,1250,748,1998,759
0130-001,2014,3,19,8,2174,1711,3885,1998
0130-001,2014,3,19,9,2198,2055,4253,3885
0130-001,2014,3,19,10,1821,1676,3497,4253
0130-001,2014,3,19,11,1798,1587,3385,3497
0130-001,2014,3,19,12,1649,1613,3262,3385
0130-001,2014,3,19,13,1468,1460,2928,3262
0130-001,2014,3,19,14,1692,1721,3413,2928
0130-001,2014,3,19,15,1886,1799,3685,3413
0130-001,2014,3,19,16,1760,1810,3570,3685
0130-001,2014,3,19,17,1669,1799,3468,3570
0130-001,2014,3,19,18,1733,2339,4072,3468
0130-001,2014,3,19,19,1728,2475,4203,4072
0130-001,2014,3,19,20,1355,1799,3154,4203
0130-001,2014,3,19,21,1161,1555,2716,3154
0130-001,2014,3,19,22,1172,1177,2349,2716
0130-001,2014,3,19,23,894,839,1733,2349
0130-001,2014,3,19,24,537,484,1021,1733
0130-001,2014,3,20,1,387,364,751,1021
0130-001,2014,3,20,2,256,244,500,751
0130-001,2014,3,20,3,184,204,388,500
0130-001,2014,3,20,4,144,176,320,388
0130-001,2014,3,20,5,158,212,370,320
0130-001,2014,3,20,6,368,377,745,370
0130-001,2014,3,20,7,1243,678,1921,745
0130-001,2014,3,20,8,2106,1688,3794,1921
0130-001,2014,3,20,9,2210,2011,4221,3794
0130-001,2014,3,20,10,1861,1768,3629,4221
0130-001,2014,3,20,11,1817,1759,3576,3629
0130-001,2014,3,20,12,1673,1611,3284,3576
0130-001,2014,3,20,13,1492,1479,2971,3284
0130-001,2014,3,20,14,1724,1721,3445,2971
0130-001,2014,3,20,15,1836,1803,3639,3445
0130-001,2014,3,20,16,1786,1836,3622,3639
0130-001,2014,3,20,17,1707,1807,3514,3622
0130-001,2014,3,20,18,1816,2324,4140,3514
0130-001,2014,3,20,19,1851,2516,4367,4140
0130-001,2014,3,20,20,1419,1659,3078,4367
0130-001,2014,3,20,21,1194,1152,2346,3078
0130-001,2014,3,20,22,1150,1090,2240,2346
0130-001,2014,3,20,23,875,588,1463,2240
0130-001,2014,3,20,24,559,404,963,1463
0130-001,2014,3,21,1,378,276,654,963
0130-001,2014,3,21,2,271,227,498,654
0130-001,2014,3,21,3,197,161,358,498
0130-001,2014,3,21,4,116,140,256,358
0130-001,2014,3,21,5,165,237,402,256
0130-001,2014,3,21,6,358,334,692,402
0130-001,2014,3,21,7,1256,685,1941,692
0130-001,2014,3,21,8,2165,1717,3882,1941
0130-001,2014,3,21,9,2187,2032,4219,3882
0130-001,2014,3,21,10,1898,1766,3664,4219
0130-001,2014,3,21,11,1893,1790,3683,3664
0130-001,2014,3,21,12,1702,1682,3384,3683
0130-001,2014,3,21,13,1516,1524,3040,3384
0130-001,2014,3,21,14,1635,1772,3407,3040
0130-001,2014,3,21,15,1930,1769,3699,3407
0130-001,2014,3,21,16,1775,1965,3740,3699
0130-001,2014,3,21,17,1856,2062,3918,3740
0130-001,2014,3,21,18,1817,2419,4236,3918
0130-001,2014,3,21,19,1939,2652,4591,4236
0130-001,2014,3,21,20,1647,2115,3762,4591
0130-001,2014,3,21,21,1234,1671,2905,3762
0130-001,2014,3,21,22,1330,1371,2701,2905
0130-001,2014,3,21,23,935,924,1859,2701
0130-001,2014,3,21,24,692,590,1282,1859
0130-001,2014,3,22,1,476,400,876,1282
0130-001,2014,3,22,2,346,327,673,876
0130-001,2014,3,22,3,246,205,451,673
0130-001,2014,3,22,4,220,202,422,451
0130-001,2014,3,22,5,244,285,529,422
0130-001,2014,3,22,6,363,352,715,529
0130-001,2014,3,22,7,905,618,1523,715
0130-001,2014,3,22,8,1544,1058,2602,1523
0130-001,2014,3,22,9,1652,1706,3358,2602
0130-001,2014,3,22,10,1670,1792,3462,3358
0130-001,2014,3,22,11,1652,1855,3507,3462
0130-001,2014,3,22,12,1666,2009,3675,3507
0130-001,2014,3,22,13,1710,2068,3778,3675
0130-001,2014,3,22,14,1815,1758,3573,3778
0130-001,2014,3,22,15,1759,1614,3373,3573
0130-001,2014,3,22,16,1755,1761,3516,3373
0130-001,2014,3,22,17,1816,1871,3687,3516
0130-001,2014,3,22,18,2015,2172,4187,3687
0130-001,2014,3,22,19,1958,1986,3944,4187
0130-001,2014,3,22,20,1446,1371,2817,3944
0130-001,2014,3,22,21,1234,1130,2364,2817
0130-001,2014,3,22,22,1087,943,2030,2364
0130-001,2014,3,22,23,748,713,1461,2030
0130-001,2014,3,22,24,610,437,1047,1461
0130-001,2014,3,23,1,428,351,779,1047
0130-001,2014,3,23,2,320,240,560,779
0130-001,2014,3,23,3,261,190,451,560
0130-001,2014,3,23,4,186,175,361,451
0130-001,2014,3,23,5,168,171,339,361
0130-001,2014,3,23,6,251,253,504,339
0130-001,2014,3,23,7,532,387,919,504
0130-001,2014,3,23,8,705,624,1329,919
0130-001,2014,3,23,9,880,942,1822,1329
0130-001,2014,3,23,10,992,1019,2011,1822
0130-001,2014,3,23,11,1191,1382,2573,2011
0130-001,2014,3,23,12,1202,1329,2531,2573
0130-001,2014,3,23,13,1279,1258,2537,2531
0130-001,2014,3,23,14,1420,1441,2861,2537
0130-001,2014,3,23,15,1485,1482,2967,2861
0130-001,2014,3,23,16,1641,1505,3146,2967
0130-001,2014,3,23,17,1749,1530,3279,3146
0130-001,2014,3,23,18,1847,1625,3472,3279
0130-001,2014,3,23,19,1782,1411,3193,3472
0130-001,2014,3,23,20,1345,1134,2479,3193
0130-001,2014,3,23,21,1184,997,2181,2479
0130-001,2014,3,23,22,958,740,1698,2181
0130-001,2014,3,23,23,569,506,1075,1698
0130-001,2014,3,23,24,454,353,807,1075
0130-001,2014,3,24,1,237,225,462,807
0130-001,2014,3,24,2,175,142,317,462
0130-001,2014,3,24,3,127,107,234,317
0130-001,2014,3,24,4,106,123,229,234
0130-001,2014,3,24,5,154,207,361,229
0130-001,2014,3,24,6,389,351,740,361
0130-001,2014,3,24,7,1427,810,2237,740
0130-001,2014,3,24,8,2181,1796,3977,2237
0130-001,2014,3,24,9,2254,2070,4324,3977
0130-001,2014,3,24,10,1825,1772,3597,4324
0130-001,2014,3,24,11,1799,1758,3557,3597
0130-001,2014,3,24,12,1698,1667,3365,3557
0130-001,2014,3,24,13,1458,1441,2899,3365
0130-001,2014,3,24,14,1747,1764,3511,2899
0130-001,2014,3,24,15,1873,1841,3714,3511
0130-001,2014,3,24,16,1765,1926,3691,3714
0130-001,2014,3,24,17,1851,1972,3823,3691
0130-001,2014,3,24,18,1750,2300,4050,3823
0130-001,2014,3,24,19,1806,2453,4259,4050
0130-001,2014,3,24,20,1405,1910,3315,4259
0130-001,2014,3,24,21,1214,1639,2853,3315
0130-001,2014,3,24,22,1148,1277,2425,2853
0130-001,2014,3,24,23,823,768,1591,2425
0130-001,2014,3,24,24,514,461,975,1591
0130-001,2014,3,25,1,343,278,621,975
0130-001,2014,3,25,2,222,184,406,621
0130-001,2014,3,25,3,149,156,305,406
0130-001,2014,3,25,4,145,154,299,305
0130-001,2014,3,25,5,162,228,390,299
0130-001,2014,3,25,6,365,385,750,390
0130-001,2014,3,25,7,1269,741,2010,750
0130-001,2014,3,25,8,2118,1730,3848,2010
0130-001,2014,3,25,9,2242,1987,4229,3848
0130-001,2014,3,25,10,1882,1700,3582,4229
0130-001,2014,3,25,11,1749,1743,3492,3582
0130-001,2014,3,25,12,1561,1647,3208,3492
0130-001,2014,3,25,13,1538,1505,3043,3208
0130-001,2014,3,25,14,1650,1740,3390,3043
0130-001,2014,3,25,15,1881,1750,3631,3390
0130-001,2014,3,25,16,1726,1774,3500,3631
0130-001,2014,3,25,17,1709,1879,3588,3500
0130-001,2014,3,25,18,1751,2342,4093,3588
0130-001,2014,3,25,19,1772,2432,4204,4093
0130-001,2014,3,25,20,1376,1795,3171,4204
0130-001,2014,3,25,21,1197,1634,2831,3171
0130-001,2014,3,25,22,1225,1309,2534,2831
0130-001,2014,3,25,23,759,819,1578,2534
0130-001,2014,3,25,24,594,506,1100,1578
0130-001,2014,3,26,1,395,347,742,1100
0130-001,2014,3,26,2,258,211,469,742
0130-001,2014,3,26,3,173,172,345,469
0130-001,2014,3,26,4,147,152,299,345
0130-001,2014,3,26,5,156,226,382,299
0130-001,2014,3,26,6,343,338,681,382
0130-001,2014,3,26,7,1237,722,1959,681
0130-001,2014,3,26,8,2112,1703,3815,1959
0130-001,2014,3,26,9,2213,2042,4255,3815
0130-001,2014,3,26,10,1840,1746,3586,4255
0130-001,2014,3,26,11,1759,1700,3459,3586
0130-001,2014,3,26,12,1632,1654,3286,3459
0130-001,2014,3,26,13,1475,1415,2890,3286
0130-001,2014,3,26,14,1753,1455,3208,2890
0130-001,2014,3,26,15,1856,1524,3380,3208
0130-001,2014,3,26,16,1794,1494,3288,3380
0130-001,2014,3,26,17,1713,1660,3373,3288
0130-001,2014,3,26,18,1813,2137,3950,3373
0130-001,2014,3,26,19,1794,2300,4094,3950
0130-001,2014,3,26,20,1532,1846,3378,4094
0130-001,2014,3,26,21,1241,1596,2837,3378
0130-001,2014,3,26,22,1203,1238,2441,2837
0130-001,2014,3,26,23,928,780,1708,2441
0130-001,2014,3,26,24,646,566,1212,1708
0130-001,2014,3,27,1,397,382,779,1212
0130-001,2014,3,27,2,274,205,479,779
0130-001,2014,3,27,3,167,189,356,479
0130-001,2014,3,27,4,162,167,329,356
0130-001,2014,3,27,5,181,248,429,329
0130-001,2014,3,27,6,371,380,751,429
0130-001,2014,3,27,7,1385,714,2099,751
0130-001,2014,3,27,8,2186,1758,3944,2099
0130-001,2014,3,27,9,2146,2055,4201,3944
0130-001,2014,3,27,10,1940,1722,3662,4201
0130-001,2014,3,27,11,1750,1822,3572,3662
0130-001,2014,3,27,12,1606,1627,3233,3572
0130-001,2014,3,27,13,1532,1546,3078,3233
0130-001,2014,3,27,14,1724,1624,3348,3078
0130-001,2014,3,27,15,1780,1631,3411,3348
0130-001,2014,3,27,16,1798,1780,3578,3411
0130-001,2014,3,27,17,1707,1933,3640,3578
0130-001,2014,3,27,18,1781,2335,4116,3640
0130-001,2014,3,27,19,1802,2522,4324,4116
0130-001,2014,3,27,20,1445,1880,3325,4324
0130-001,2014,3,27,21,1184,1622,2806,3325
0130-001,2014,3,27,22,1216,1381,2597,2806
0130-001,2014,3,27,23,892,806,1698,2597
0130-001,2014,3,27,24,574,527,1101,1698
0130-001,2014,3,28,1,426,354,780,1101
0130-001,2014,3,28,2,274,250,524,780
0130-001,2014,3,28,3,171,192,363,524
0130-001,2014,3,28,4,177,178,355,363
0130-001,2014,3,28,5,174,254,428,355
0130-001,2014,3,28,6,381,361,742,428
0130-001,2014,3,28,7,1294,729,2023,742
0130-001,2014,3,28,8,2164,1742,3906,2023
0130-001,2014,3,28,9,2204,2067,4271,3906
0130-001,2014,3,28,10,1857,1710,3567,4271
0130-001,2014,3,28,11,1855,1851,3706,3567
0130-001,2014,3,28,12,1689,1648,3337,3706
0130-001,2014,3,28,13,1521,1617,3138,3337
0130-001,2014,3,28,14,1852,1769,3621,3138
0130-001,2014,3,28,15,1888,1823,3711,3621
0130-001,2014,3,28,16,1837,1937,3774,3711
0130-001,2014,3,28,17,1814,2021,3835,3774
0130-001,2014,3,28,18,1958,2454,4412,3835
0130-001,2014,3,28,19,2029,2641,4670,4412
0130-001,2014,3,28,20,1582,2215,3797,4670
0130-001,2014,3,28,21,1325,1667,2992,3797
0130-001,2014,3,28,22,1263,1367,2630,2992
0130-001,2014,3,28,23,981,878,1859,2630
0130-001,2014,3,28,24,745,598,1343,1859
0130-001,2014,3,29,1,530,516,1046,1343
0130-001,2014,3,29,2,384,313,697,1046
0130-001,2014,3,29,3,263,255,518,697
0130-001,2014,3,29,4,229,220,449,518
0130-001,2014,3,29,5,232,274,506,449
0130-001,2014,3,29,6,374,383,757,506
0130-001,2014,3,29,7,867,627,1494,757
0130-001,2014,3,29,8,1466,1087,2553,1494
0130-001,2014,3,29,9,1576,1717,3293,2553
0130-001,2014,3,29,10,1781,1773,3554,3293
0130-001,2014,3,29,11,1796,1947,3743,3554
0130-001,2014,3,29,12,1721,2158,3879,3743
0130-001,2014,3,29,13,1634,2193,3827,3879
0130-001,2014,3,29,14,1788,1910,3698,3827
0130-001,2014,3,29,15,1823,1939,3762,3698
0130-001,2014,3,29,16,1818,1870,3688,3762
0130-001,2014,3,29,17,1892,1916,3808,3688
0130-001,2014,3,29,18,2032,2135,4167,3808
0130-001,2014,3,29,19,1837,1720,3557,4167
0130-001,2014,3,29,20,1348,1292,2640,3557
0130-001,2014,3,29,21,1182,1123,2305,2640
0130-001,2014,3,29,22,1036,907,1943,2305
0130-001,2014,3,29,23,803,664,1467,1943
0130-001,2014,3,29,24,511,467,978,1467
0130-001,2014,3,30,1,405,355,760,978
0130-001,2014,3,30,2,305,251,556,760
0130-001,2014,3,30,3,233,195,428,556
0130-001,2014,3,30,4,191,151,342,428
0130-001,2014,3,30,5,166,158,324,342
0130-001,2014,3,30,6,257,170,427,324
0130-001,2014,3,30,7,537,277,814,427
0130-001,2014,3,30,8,784,451,1235,814
0130-001,2014,3,30,9,847,843,1690,1235
0130-001,2014,3,30,10,1020,1053,2073,1690
0130-001,2014,3,30,11,1155,1155,2310,2073
0130-001,2014,3,30,12,1222,1197,2419,2310
0130-001,2014,3,30,13,1454,1182,2636,2419
0130-001,2014,3,30,14,1459,1267,2726,2636
0130-001,2014,3,30,15,1615,1322,2937,2726
0130-001,2014,3,30,16,1730,1403,3133,2937
0130-001,2014,3,30,17,1808,1398,3206,3133
0130-001,2014,3,30,18,1786,1501,3287,3206
0130-001,2014,3,30,19,1873,1358,3231,3287
0130-001,2014,3,30,20,1541,1218,2759,3231
0130-001,2014,3,30,21,1420,984,2404,2759
0130-001,2014,3,30,22,1105,880,1985,2404
0130-001,2014,3,30,23,685,522,1207,1985
0130-001,2014,3,30,24,449,350,799,1207
0130-001,2014,3,31,1,279,236,515,799
0130-001,2014,3,31,2,183,152,335,515
0130-001,2014,3,31,3,132,127,259,335
0130-001,2014,3,31,4,143,120,263,259
0130-001,2014,3,31,5,161,210,371,263
0130-001,2014,3,31,6,392,389,781,371
0130-001,2014,3,31,7,1469,867,2336,781
0130-001,2014,3,31,8,2225,1764,3989,2336
0130-001,2014,3,31,9,2229,2051,4280,3989
0130-001,2014,3,31,10,1784,1707,3491,4280
0130-001,2014,3,31,11,1739,1704,3443,3491
0130-001,2014,3,31,12,1609,1617,3226,3443
0130-001,2014,3,31,13,1460,1457,2917,3226
0130-001,2014,3,31,14,1693,1781,3474,2917
0130-001,2014,3,31,15,1958,1777,3735,3474
0130-001,2014,3,31,16,1766,1912,3678,3735
0130-001,2014,3,31,17,1732,1924,3656,3678
0130-001,2014,3,31,18,1829,2359,4188,3656
0130-001,2014,3,31,19,1774,2464,4238,4188
0130-001,2014,3,31,20,1430,1834,3264,4238
0130-001,2014,3,31,21,1193,1648,2841,3264
0130-001,2014,3,31,22,1169,1323,2492,2841
0130-001,2014,3,31,23,821,782,1603,2492
0130-001,2014,3,31,24,583,553,1136,1603
0130-001,2014,4,1,1,352,343,695,1136
0130-001,2014,4,1,2,259,241,500,695
0130-001,2014,4,1,3,174,214,388,500
0130-001,2014,4,1,4,146,149,295,388
0130-001,2014,4,1,5,194,249,443,295
0130-001,2014,4,1,6,370,393,763,443
0130-001,2014,4,1,7,1310,778,2088,763
0130-001,2014,4,1,8,2148,1751,3899,2088
0130-001,2014,4,1,9,2180,2020,4200,3899
0130-001,2014,4,1,10,1863,1747,3610,4200
0130-001,2014,4,1,11,1868,1708,3576,3610
0130-001,2014,4,1,12,1776,1589,3365,3576
0130-001,2014,4,1,13,1683,1486,3169,3365
0130-001,2014,4,1,14,1629,1759,3388,3169
0130-001,2014,4,1,15,1751,1778,3529,3388
0130-001,2014,4,1,16,1728,1775,3503,3529
0130-001,2014,4,1,17,1682,1836,3518,3503
0130-001,2014,4,1,18,1810,2453,4263,3518
0130-001,2014,4,1,19,1804,2550,4354,4263
0130-001,2014,4,1,20,1342,1844,3186,4354
0130-001,2014,4,1,21,1204,1644,2848,3186
0130-001,2014,4,1,22,1294,1300,2594,2848
0130-001,2014,4,1,23,769,798,1567,2594
0130-001,2014,4,1,24,592,512,1104,1567
0130-001,2014,4,2,1,381,381,762,1104
0130-001,2014,4,2,2,201,191,392,762
0130-001,2014,4,2,3,169,176,345,392
0130-001,2014,4,2,4,128,174,302,345
0130-001,2014,4,2,5,183,220,403,302
0130-001,2014,4,2,6,379,351,730,403
0130-001,2014,4,2,7,1352,816,2168,730
0130-001,2014,4,2,8,2115,1745,3860,2168
0130-001,2014,4,2,9,2200,1991,4191,3860
0130-001,2014,4,2,10,1919,1690,3609,4191
0130-001,2014,4,2,11,1768,1716,3484,3609
0130-001,2014,4,2,12,1681,1622,3303,3484
0130-001,2014,4,2,13,1535,1405,2940,3303
0130-001,2014,4,2,14,1761,1709,3470,2940
0130-001,2014,4,2,15,1787,1753,3540,3470
0130-001,2014,4,2,16,1790,1869,3659,3540
0130-001,2014,4,2,17,1711,1850,3561,3659
0130-001,2014,4,2,18,1860,2474,4334,3561
0130-001,2014,4,2,19,1762,2604,4366,4334
0130-001,2014,4,2,20,1501,1996,3497,4366
0130-001,2014,4,2,21,1196,1585,2781,3497
0130-001,2014,4,2,22,1231,1326,2557,2781
0130-001,2014,4,2,23,880,784,1664,2557
0130-001,2014,4,2,24,551,526,1077,1664
0130-001,2014,4,3,1,380,348,728,1077
0130-001,2014,4,3,2,249,243,492,728
0130-001,2014,4,3,3,171,164,335,492
0130-001,2014,4,3,4,120,169,289,335
0130-001,2014,4,3,5,182,227,409,289
0130-001,2014,4,3,6,365,385,750,409
0130-001,2014,4,3,7,1342,787,2129,750
0130-001,2014,4,3,8,2170,1742,3912,2129
0130-001,2014,4,3,9,2178,2032,4210,3912
0130-001,2014,4,3,10,1851,1711,3562,4210
0130-001,2014,4,3,11,1784,1710,3494,3562
0130-001,2014,4,3,12,1665,1633,3298,3494
0130-001,2014,4,3,13,1627,1508,3135,3298
0130-001,2014,4,3,14,1681,1657,3338,3135
0130-001,2014,4,3,15,1802,1818,3620,3338
0130-001,2014,4,3,16,1761,1963,3724,3620
0130-001,2014,4,3,17,1695,1900,3595,3724
0130-001,2014,4,3,18,1811,2359,4170,3595
0130-001,2014,4,3,19,1682,2425,4107,4170
0130-001,2014,4,3,20,1354,1763,3117,4107
0130-001,2014,4,3,21,1195,1598,2793,3117
0130-001,2014,4,3,22,1244,1341,2585,2793
0130-001,2014,4,3,23,862,790,1652,2585
0130-001,2014,4,3,24,549,468,1017,1652
0130-001,2014,4,4,1,384,376,760,1017
0130-001,2014,4,4,2,254,218,472,760
0130-001,2014,4,4,3,181,193,374,472
0130-001,2014,4,4,4,142,159,301,374
0130-001,2014,4,4,5,178,228,406,301
0130-001,2014,4,4,6,359,359,718,406
0130-001,2014,4,4,7,1387,804,2191,718
0130-001,2014,4,4,8,2147,1742,3889,2191
0130-001,2014,4,4,9,2252,2023,4275,3889
0130-001,2014,4,4,10,1834,1686,3520,4275
0130-001,2014,4,4,11,1783,1743,3526,3520
0130-001,2014,4,4,12,1725,1697,3422,3526
0130-001,2014,4,4,13,1618,1686,3304,3422
0130-001,2014,4,4,14,1693,1801,3494,3304
0130-001,2014,4,4,15,1883,1824,3707,3494
0130-001,2014,4,4,16,1820,1944,3764,3707
0130-001,2014,4,4,17,1849,1955,3804,3764
0130-001,2014,4,4,18,2029,2554,4583,3804
0130-001,2014,4,4,19,2029,2668,4697,4583
0130-001,2014,4,4,20,1763,2311,4074,4697
0130-001,2014,4,4,21,1281,1722,3003,4074
0130-001,2014,4,4,22,1279,1607,2886,3003
0130-001,2014,4,4,23,953,891,1844,2886
0130-001,2014,4,4,24,662,581,1243,1844
0130-001,2014,4,5,1,477,412,889,1243
0130-001,2014,4,5,2,346,322,668,889
0130-001,2014,4,5,3,234,219,453,668
0130-001,2014,4,5,4,225,198,423,453
0130-001,2014,4,5,5,199,290,489,423
0130-001,2014,4,5,6,407,406,813,489
0130-001,2014,4,5,7,944,679,1623,813
0130-001,2014,4,5,8,1494,1177,2671,1623
0130-001,2014,4,5,9,1720,1873,3593,2671
0130-001,2014,4,5,10,1772,2062,3834,3593
0130-001,2014,4,5,11,1649,2246,3895,3834
0130-001,2014,4,5,12,1635,2447,4082,3895
0130-001,2014,4,5,13,1725,2453,4178,4082
0130-001,2014,4,5,14,1783,2349,4132,4178
0130-001,2014,4,5,15,1824,2221,4045,4132
0130-001,2014,4,5,16,1835,2214,4049,4045
0130-001,2014,4,5,17,1910,2035,3945,4049
0130-001,2014,4,5,18,2021,1988,4009,3945
0130-001,2014,4,5,19,1961,1870,3831,4009
0130-001,2014,4,5,20,1547,1316,2863,3831
0130-001,2014,4,5,21,1271,1179,2450,2863
0130-001,2014,4,5,22,1127,885,2012,2450
0130-001,2014,4,5,23,804,650,1454,2012
0130-001,2014,4,5,24,544,452,996,1454
0130-001,2014,4,6,1,369,360,729,996
0130-001,2014,4,6,2,277,226,503,729
0130-001,2014,4,6,3,196,178,374,503
0130-001,2014,4,6,4,160,134,294,374
0130-001,2014,4,6,5,135,152,287,294
0130-001,2014,4,6,6,253,255,508,287
0130-001,2014,4,6,7,549,429,978,508
0130-001,2014,4,6,8,706,767,1473,978
0130-001,2014,4,6,9,912,1148,2060,1473
0130-001,2014,4,6,10,1066,1313,2379,2060
0130-001,2014,4,6,11,1278,1592,2870,2379
0130-001,2014,4,6,12,1201,1403,2604,2870
0130-001,2014,4,6,13,1558,1481,3039,2604
0130-001,2014,4,6,14,1598,1567,3165,3039
0130-001,2014,4,6,15,1778,1493,3271,3165
0130-001,2014,4,6,16,1964,1568,3532,3271
0130-001,2014,4,6,17,1941,1566,3507,3532
0130-001,2014,4,6,18,1962,1480,3442,3507
0130-001,2014,4,6,19,1884,1474,3358,3442
0130-001,2014,4,6,20,1891,1153,3044,3358
0130-001,2014,4,6,21,1635,995,2630,3044
0130-001,2014,4,6,22,1560,887,2447,2630
0130-001,2014,4,6,23,1007,518,1525,2447
0130-001,2014,4,6,24,587,371,958,1525
0130-001,2014,4,7,1,277,226,503,958
0130-001,2014,4,7,2,186,160,346,503
0130-001,2014,4,7,3,131,97,228,346
0130-001,2014,4,7,4,117,127,244,228
0130-001,2014,4,7,5,179,217,396,244
0130-001,2014,4,7,6,453,389,842,396
0130-001,2014,4,7,7,1514,869,2383,842
0130-001,2014,4,7,8,2194,1796,3990,2383
0130-001,2014,4,7,9,2238,2086,4324,3990
0130-001,2014,4,7,10,1810,1682,3492,4324
0130-001,2014,4,7,11,1808,1679,3487,3492
0130-001,2014,4,7,12,1758,1605,3363,3487
0130-001,2014,4,7,13,1668,1591,3259,3363
0130-001,2014,4,7,14,1764,1793,3557,3259
0130-001,2014,4,7,15,1806,1798,3604,3557
0130-001,2014,4,7,16,1817,1781,3598,3604
0130-001,2014,4,7,17,1714,1848,3562,3598
0130-001,2014,4,7,18,1777,2485,4262,3562
0130-001,2014,4,7,19,1736,2448,4184,4262
0130-001,2014,4,7,20,1447,1868,3315,4184
0130-001,2014,4,7,21,1276,1696,2972,3315
0130-001,2014,4,7,22,1163,1355,2518,2972
0130-001,2014,4,7,23,854,788,1642,2518
0130-001,2014,4,7,24,508,486,994,1642
0130-001,2014,4,8,1,356,341,697,994
0130-001,2014,4,8,2,218,211,429,697
0130-001,2014,4,8,3,146,182,328,429
0130-001,2014,4,8,4,147,169,316,328
0130-001,2014,4,8,5,189,222,411,316
0130-001,2014,4,8,6,351,378,729,411
0130-001,2014,4,8,7,1428,790,2218,729
0130-001,2014,4,8,8,2161,1768,3929,2218
0130-001,2014,4,8,9,2255,2029,4284,3929
0130-001,2014,4,8,10,1908,1777,3685,4284
0130-001,2014,4,8,11,1831,1737,3568,3685
0130-001,2014,4,8,12,1835,1697,3532,3568
0130-001,2014,4,8,13,1692,1520,3212,3532
0130-001,2014,4,8,14,1697,1735,3432,3212
0130-001,2014,4,8,15,1837,1753,3590,3432
0130-001,2014,4,8,16,1773,1840,3613,3590
0130-001,2014,4,8,17,1719,1888,3607,3613
0130-001,2014,4,8,18,1733,2425,4158,3607
0130-001,2014,4,8,19,1796,2480,4276,4158
0130-001,2014,4,8,20,1428,1824,3252,4276
0130-001,2014,4,8,21,1209,1637,2846,3252
0130-001,2014,4,8,22,1165,1341,2506,2846
0130-001,2014,4,8,23,877,808,1685,2506
0130-001,2014,4,8,24,569,506,1075,1685
0130-001,2014,4,9,1,378,364,742,1075
0130-001,2014,4,9,2,246,233,479,742
0130-001,2014,4,9,3,171,156,327,479
0130-001,2014,4,9,4,153,159,312,327
0130-001,2014,4,9,5,176,234,410,312
0130-001,2014,4,9,6,374,382,756,410
0130-001,2014,4,9,7,1389,762,2151,756
0130-001,2014,4,9,8,2122,1745,3867,2151
0130-001,2014,4,9,9,2213,2048,4261,3867
0130-001,2014,4,9,10,1871,1657,3528,4261
0130-001,2014,4,9,11,1768,1619,3387,3528
0130-001,2014,4,9,12,1717,1627,3344,3387
0130-001,2014,4,9,13,1592,1423,3015,3344
0130-001,2014,4,9,14,1717,1724,3441,3015
0130-001,2014,4,9,15,1791,1788,3579,3441
0130-001,2014,4,9,16,1722,1839,3561,3579
0130-001,2014,4,9,17,1655,1893,3548,3561
0130-001,2014,4,9,18,1836,2537,4373,3548
0130-001,2014,4,9,19,1770,2630,4400,4373
0130-001,2014,4,9,20,1487,1854,3341,4400
0130-001,2014,4,9,21,1254,1533,2787,3341
0130-001,2014,4,9,22,1196,1284,2480,2787
0130-001,2014,4,9,23,911,803,1714,2480
0130-001,2014,4,9,24,584,492,1076,1714
0130-001,2014,4,10,1,436,370,806,1076
0130-001,2014,4,10,2,226,215,441,806
0130-001,2014,4,10,3,168,187,355,441
0130-001,2014,4,10,4,142,154,296,355
0130-001,2014,4,10,5,194,233,427,296
0130-001,2014,4,10,6,402,393,795,427
0130-001,2014,4,10,7,1387,769,2156,795
0130-001,2014,4,10,8,2144,1733,3877,2156
0130-001,2014,4,10,9,2217,2015,4232,3877
0130-001,2014,4,10,10,1882,1663,3545,4232
0130-001,2014,4,10,11,1755,1653,3408,3545
0130-001,2014,4,10,12,1719,1617,3336,3408
0130-001,2014,4,10,13,1611,1508,3119,3336
0130-001,2014,4,10,14,1669,1785,3454,3119
0130-001,2014,4,10,15,1842,1738,3580,3454
0130-001,2014,4,10,16,1764,1698,3462,3580
0130-001,2014,4,10,17,1693,1886,3579,3462
0130-001,2014,4,10,18,1745,2428,4173,3579
0130-001,2014,4,10,19,1718,2538,4256,4173
0130-001,2014,4,10,20,1399,1808,3207,4256
0130-001,2014,4,10,21,1214,1602,2816,3207
0130-001,2014,4,10,22,1239,1281,2520,2816
0130-001,2014,4,10,23,925,762,1687,2520
0130-001,2014,4,10,24,635,554,1189,1687
0130-001,2014,4,11,1,443,400,843,1189
0130-001,2014,4,11,2,288,265,553,843
0130-001,2014,4,11,3,215,214,429,553
0130-001,2014,4,11,4,163,168,331,429
0130-001,2014,4,11,5,187,260,447,331
0130-001,2014,4,11,6,403,413,816,447
0130-001,2014,4,11,7,1408,738,2146,816
0130-001,2014,4,11,8,2144,1730,3874,2146
0130-001,2014,4,11,9,2247,2034,4281,3874
0130-001,2014,4,11,10,1858,1662,3520,4281
0130-001,2014,4,11,11,1833,1761,3594,3520
0130-001,2014,4,11,12,1710,1699,3409,3594
0130-001,2014,4,11,13,1664,1683,3347,3409
0130-001,2014,4,11,14,1737,1788,3525,3347
0130-001,2014,4,11,15,1896,1831,3727,3525
0130-001,2014,4,11,16,1844,1934,3778,3727
0130-001,2014,4,11,17,1827,1905,3732,3778
0130-001,2014,4,11,18,1825,2420,4245,3732
0130-001,2014,4,11,19,1987,2636,4623,4245
0130-001,2014,4,11,20,1672,2121,3793,4623
0130-001,2014,4,11,21,1298,1650,2948,3793
0130-001,2014,4,11,22,1260,1361,2621,2948
0130-001,2014,4,11,23,975,920,1895,2621
0130-001,2014,4,11,24,700,603,1303,1895
0130-001,2014,4,12,1,485,420,905,1303
0130-001,2014,4,12,2,315,289,604,905
0130-001,2014,4,12,3,258,246,504,604
0130-001,2014,4,12,4,228,234,462,504
0130-001,2014,4,12,5,240,278,518,462
0130-001,2014,4,12,6,409,370,779,518
0130-001,2014,4,12,7,972,678,1650,779
0130-001,2014,4,12,8,1533,1110,2643,1650
0130-001,2014,4,12,9,1642,1819,3461,2643
0130-001,2014,4,12,10,1672,1845,3517,3461
0130-001,2014,4,12,11,1680,2029,3709,3517
0130-001,2014,4,12,12,1655,2250,3905,3709
0130-001,2014,4,12,13,1558,2376,3934,3905
0130-001,2014,4,12,14,1718,2217,3935,3934
0130-001,2014,4,12,15,1688,1921,3609,3935
0130-001,2014,4,12,16,1740,1823,3563,3609
0130-001,2014,4,12,17,1925,1872,3797,3563
0130-001,2014,4,12,18,2097,2121,4218,3797
0130-001,2014,4,12,19,1939,1981,3920,4218
0130-001,2014,4,12,20,1469,1429,2898,3920
0130-001,2014,4,12,21,1342,1192,2534,2898
0130-001,2014,4,12,22,1218,998,2216,2534
0130-001,2014,4,12,23,899,691,1590,2216
0130-001,2014,4,12,24,617,538,1155,1590
0130-001,2014,4,13,1,449,393,842,1155
0130-001,2014,4,13,2,327,285,612,842
0130-001,2014,4,13,3,243,202,445,612
0130-001,2014,4,13,4,189,150,339,445
0130-001,2014,4,13,5,197,162,359,339
0130-001,2014,4,13,6,254,261,515,359
0130-001,2014,4,13,7,581,420,1001,515
0130-001,2014,4,13,8,680,682,1362,1001
0130-001,2014,4,13,9,867,965,1832,1362
0130-001,2014,4,13,10,1012,1003,2015,1832
0130-001,2014,4,13,11,1122,1176,2298,2015
0130-001,2014,4,13,12,1199,1345,2544,2298
0130-001,2014,4,13,13,1326,1385,2711,2544
0130-001,2014,4,13,14,1516,1498,3014,2711
0130-001,2014,4,13,15,1557,1389,2946,3014
0130-001,2014,4,13,16,1771,1471,3242,2946
0130-001,2014,4,13,17,1910,1490,3400,3242
0130-001,2014,4,13,18,1998,1627,3625,3400
0130-001,2014,4,13,19,1801,1519,3320,3625
0130-001,2014,4,13,20,1719,1168,2887,3320
0130-001,2014,4,13,21,1331,981,2312,2887
0130-001,2014,4,13,22,1186,842,2028,2312
0130-001,2014,4,13,23,692,540,1232,2028
0130-001,2014,4,13,24,444,344,788,1232
0130-001,2014,4,14,1,276,257,533,788
0130-001,2014,4,14,2,196,143,339,533
0130-001,2014,4,14,3,122,113,235,339
0130-001,2014,4,14,4,113,129,242,235
0130-001,2014,4,14,5,161,220,381,242
0130-001,2014,4,14,6,425,377,802,381
0130-001,2014,4,14,7,1602,887,2489,802
0130-001,2014,4,14,8,2145,1781,3926,2489
0130-001,2014,4,14,9,2164,1985,4149,3926
0130-001,2014,4,14,10,1795,1678,3473,4149
0130-001,2014,4,14,11,1821,1572,3393,3473
0130-001,2014,4,14,12,1711,1743,3454,3393
0130-001,2014,4,14,13,1657,1468,3125,3454
0130-001,2014,4,14,14,1709,1759,3468,3125
0130-001,2014,4,14,15,1747,1822,3569,3468
0130-001,2014,4,14,16,1796,1759,3555,3569
0130-001,2014,4,14,17,1693,1891,3584,3555
0130-001,2014,4,14,18,1602,2261,3863,3584
0130-001,2014,4,14,19,1911,2512,4423,3863
0130-001,2014,4,14,20,1463,1871,3334,4423
0130-001,2014,4,14,21,1220,1737,2957,3334
0130-001,2014,4,14,22,1172,1326,2498,2957
0130-001,2014,4,14,23,824,796,1620,2498
0130-001,2014,4,14,24,558,543,1101,1620
0130-001,2014,4,15,1,365,320,685,1101
0130-001,2014,4,15,2,240,235,475,685
0130-001,2014,4,15,3,137,168,305,475
0130-001,2014,4,15,4,140,156,296,305
0130-001,2014,4,15,5,190,253,443,296
0130-001,2014,4,15,6,333,382,715,443
0130-001,2014,4,15,7,1482,786,2268,715
0130-001,2014,4,15,8,2134,1769,3903,2268
0130-001,2014,4,15,9,2187,1952,4139,3903
0130-001,2014,4,15,10,1958,1763,3721,4139
0130-001,2014,4,15,11,1829,1657,3486,3721
0130-001,2014,4,15,12,1634,1676,3310,3486
0130-001,2014,4,15,13,1451,1459,2910,3310
0130-001,2014,4,15,14,1797,1621,3418,2910
0130-001,2014,4,15,15,1774,1904,3678,3418
0130-001,2014,4,15,16,1761,1826,3587,3678
0130-001,2014,4,15,17,1745,1847,3592,3587
0130-001,2014,4,15,18,1830,2365,4195,3592
0130-001,2014,4,15,19,1817,2488,4305,4195
0130-001,2014,4,15,20,1424,1752,3176,4305
0130-001,2014,4,15,21,1217,1733,2950,3176
0130-001,2014,4,15,22,1163,1354,2517,2950
0130-001,2014,4,15,23,855,779,1634,2517
0130-001,2014,4,15,24,550,498,1048,1634
0130-001,2014,4,16,1,378,352,730,1048
0130-001,2014,4,16,2,280,260,540,730
0130-001,2014,4,16,3,184,169,353,540
0130-001,2014,4,16,4,133,152,285,353
0130-001,2014,4,16,5,194,236,430,285
0130-001,2014,4,16,6,376,406,782,430
0130-001,2014,4,16,7,1386,802,2188,782
0130-001,2014,4,16,8,2187,1711,3898,2188
0130-001,2014,4,16,9,2257,1985,4242,3898
0130-001,2014,4,16,10,1980,1799,3779,4242
0130-001,2014,4,16,11,1813,1616,3429,3779
0130-001,2014,4,16,12,1691,1665,3356,3429
0130-001,2014,4,16,13,1487,1488,2975,3356
0130-001,2014,4,16,14,1699,1624,3323,2975
0130-001,2014,4,16,15,1749,1793,3542,3323
0130-001,2014,4,16,16,1730,1774,3504,3542
0130-001,2014,4,16,17,1700,1825,3525,3504
0130-001,2014,4,16,18,1752,2348,4100,3525
0130-001,2014,4,16,19,1777,2463,4240,4100
0130-001,2014,4,16,20,1435,1940,3375,4240
0130-001,2014,4,16,21,1181,1578,2759,3375
0130-001,2014,4,16,22,1284,1264,2548,2759
0130-001,2014,4,16,23,859,835,1694,2548
0130-001,2014,4,16,24,594,545,1139,1694
0130-001,2014,4,17,1,401,342,743,1139
0130-001,2014,4,17,2,261,227,488,743
0130-001,2014,4,17,3,186,171,357,488
0130-001,2014,4,17,4,143,179,322,357
0130-001,2014,4,17,5,192,224,416,322
0130-001,2014,4,17,6,371,410,781,416
0130-001,2014,4,17,7,1358,767,2125,781
0130-001,2014,4,17,8,2163,1678,3841,2125
0130-001,2014,4,17,9,2139,1934,4073,3841
0130-001,2014,4,17,10,1847,1711,3558,4073
0130-001,2014,4,17,11,1777,1657,3434,3558
0130-001,2014,4,17,12,1609,1570,3179,3434
0130-001,2014,4,17,13,1435,1489,2924,3179
0130-001,2014,4,17,14,1823,1690,3513,2924
0130-001,2014,4,17,15,1701,1704,3405,3513
0130-001,2014,4,17,16,1658,1688,3346,3405
0130-001,2014,4,17,17,1598,1732,3330,3346
0130-001,2014,4,17,18,1728,2288,4016,3330
0130-001,2014,4,17,19,1685,2442,4127,4016
0130-001,2014,4,17,20,1318,1694,3012,4127
0130-001,2014,4,17,21,1138,1593,2731,3012
0130-001,2014,4,17,22,1213,1168,2381,2731
0130-001,2014,4,17,23,848,854,1702,2381
0130-001,2014,4,17,24,548,491,1039,1702
0130-001,2014,4,18,1,379,345,724,1039
0130-001,2014,4,18,2,243,209,452,724
0130-001,2014,4,18,3,147,174,321,452
0130-001,2014,4,18,4,162,166,328,321
0130-001,2014,4,18,5,194,262,456,328
0130-001,2014,4,18,6,382,384,766,456
0130-001,2014,4,18,7,1360,799,2159,766
0130-001,2014,4,18,8,2165,1673,3838,2159
0130-001,2014,4,18,9,2071,1950,4021,3838
0130-001,2014,4,18,10,1710,1715,3425,4021
0130-001,2014,4,18,11,1803,1730,3533,3425
0130-001,2014,4,18,12,1710,1688,3398,3533
0130-001,2014,4,18,13,1471,1549,3020,3398
0130-001,2014,4,18,14,1860,1749,3609,3020
0130-001,2014,4,18,15,1873,1771,3644,3609
0130-001,2014,4,18,16,1784,1875,3659,3644
0130-001,2014,4,18,17,1708,1858,3566,3659
0130-001,2014,4,18,18,1908,2282,4190,3566
0130-001,2014,4,18,19,1957,2488,4445,4190
0130-001,2014,4,18,20,1709,1954,3663,4445
0130-001,2014,4,18,21,1312,1797,3109,3663
0130-001,2014,4,18,22,1279,1360,2639,3109
0130-001,2014,4,18,23,1013,926,1939,2639
0130-001,2014,4,18,24,703,608,1311,1939
0130-001,2014,4,19,1,507,450,957,1311
0130-001,2014,4,19,2,364,331,695,957
0130-001,2014,4,19,3,245,234,479,695
0130-001,2014,4,19,4,204,199,403,479
0130-001,2014,4,19,5,248,280,528,403
0130-001,2014,4,19,6,375,412,787,528
0130-001,2014,4,19,7,943,647,1590,787
0130-001,2014,4,19,8,1457,1131,2588,1590
0130-001,2014,4,19,9,1574,1822,3396,2588
0130-001,2014,4,19,10,1663,1860,3523,3396
0130-001,2014,4,19,11,1592,1894,3486,3523
0130-001,2014,4,19,12,1622,2063,3685,3486
0130-001,2014,4,19,13,1653,1995,3648,3685
0130-001,2014,4,19,14,1710,1932,3642,3648
0130-001,2014,4,19,15,1656,1724,3380,3642
0130-001,2014,4,19,16,1819,1793,3612,3380
0130-001,2014,4,19,17,1855,1800,3655,3612
0130-001,2014,4,19,18,1941,2106,4047,3655
0130-001,2014,4,19,19,1858,1882,3740,4047
0130-001,2014,4,19,20,1416,1334,2750,3740
0130-001,2014,4,19,21,1219,1130,2349,2750
0130-001,2014,4,19,22,1098,900,1998,2349
0130-001,2014,4,19,23,780,682,1462,1998
0130-001,2014,4,19,24,587,474,1061,1462
0130-001,2014,4,20,1,404,365,769,1061
0130-001,2014,4,20,2,283,249,532,769
0130-001,2014,4,20,3,233,202,435,532
0130-001,2014,4,20,4,197,172,369,435
0130-001,2014,4,20,5,187,176,363,369
0130-001,2014,4,20,6,297,282,579,363
0130-001,2014,4,20,7,585,460,1045,579
0130-001,2014,4,20,8,721,735,1456,1045
0130-001,2014,4,20,9,978,1126,2104,1456
0130-001,2014,4,20,10,1006,1122,2128,2104
0130-001,2014,4,20,11,1175,1209,2384,2128
0130-001,2014,4,20,12,1264,1285,2549,2384
0130-001,2014,4,20,13,1269,1422,2691,2549
0130-001,2014,4,20,14,1424,1414,2838,2691
0130-001,2014,4,20,15,1447,1527,2974,2838
0130-001,2014,4,20,16,1665,1532,3197,2974
0130-001,2014,4,20,17,1883,1566,3449,3197
0130-001,2014,4,20,18,1895,1574,3469,3449
0130-001,2014,4,20,19,1742,1521,3263,3469
0130-001,2014,4,20,20,1459,1263,2722,3263
0130-001,2014,4,20,21,1338,1043,2381,2722
0130-001,2014,4,20,22,1016,818,1834,2381
0130-001,2014,4,20,23,719,553,1272,1834
0130-001,2014,4,20,24,455,340,795,1272
0130-001,2014,4,21,1,295,217,512,795
0130-001,2014,4,21,2,175,161,336,512
0130-001,2014,4,21,3,119,120,239,336
0130-001,2014,4,21,4,121,132,253,239
0130-001,2014,4,21,5,172,201,373,253
0130-001,2014,4,21,6,419,398,817,373
0130-001,2014,4,21,7,1532,844,2376,817
0130-001,2014,4,21,8,2180,1761,3941,2376
0130-001,2014,4,21,9,2262,2025,4287,3941
0130-001,2014,4,21,10,1948,1739,3687,4287
0130-001,2014,4,21,11,1822,1672,3494,3687
0130-001,2014,4,21,12,1709,1709,3418,3494
0130-001,2014,4,21,13,1520,1598,3118,3418
0130-001,2014,4,21,14,1836,1852,3688,3118
0130-001,2014,4,21,15,1828,1859,3687,3688
0130-001,2014,4,21,16,1778,1864,3642,3687
0130-001,2014,4,21,17,1721,1904,3625,3642
0130-001,2014,4,21,18,1750,2364,4114,3625
0130-001,2014,4,21,19,1669,2522,4191,4114
0130-001,2014,4,21,20,1438,1770,3208,4191
0130-001,2014,4,21,21,1160,1719,2879,3208
0130-001,2014,4,21,22,1116,1247,2363,2879
0130-001,2014,4,21,23,778,769,1547,2363
0130-001,2014,4,21,24,537,480,1017,1547
0130-001,2014,4,22,1,375,356,731,1017
0130-001,2014,4,22,2,220,224,444,731
0130-001,2014,4,22,3,186,159,345,444
0130-001,2014,4,22,4,124,152,276,345
0130-001,2014,4,22,5,186,219,405,276
0130-001,2014,4,22,6,413,366,779,405
0130-001,2014,4,22,7,1421,792,2213,779
0130-001,2014,4,22,8,2154,1703,3857,2213
0130-001,2014,4,22,9,2203,1994,4197,3857
0130-001,2014,4,22,10,1911,1696,3607,4197
0130-001,2014,4,22,11,1748,1716,3464,3607
0130-001,2014,4,22,12,1648,1606,3254,3464
0130-001,2014,4,22,13,1461,1509,2970,3254
0130-001,2014,4,22,14,1846,1833,3679,2970
0130-001,2014,4,22,15,1735,1752,3487,3679
0130-001,2014,4,22,16,1754,1793,3547,3487
0130-001,2014,4,22,17,1772,1762,3534,3547
0130-001,2014,4,22,18,1741,2276,4017,3534
0130-001,2014,4,22,19,1713,2467,4180,4017
0130-001,2014,4,22,20,1413,1723,3136,4180
0130-001,2014,4,22,21,1190,1630,2820,3136
0130-001,2014,4,22,22,1103,1342,2445,2820
0130-001,2014,4,22,23,810,770,1580,2445
0130-001,2014,4,22,24,582,527,1109,1580
0130-001,2014,4,23,1,397,360,757,1109
0130-001,2014,4,23,2,248,223,471,757
0130-001,2014,4,23,3,173,167,340,471
0130-001,2014,4,23,4,138,155,293,340
0130-001,2014,4,23,5,161,227,388,293
0130-001,2014,4,23,6,383,371,754,388
0130-001,2014,4,23,7,1408,770,2178,754
0130-001,2014,4,23,8,2169,1694,3863,2178
0130-001,2014,4,23,9,2220,1957,4177,3863
0130-001,2014,4,23,10,1865,1743,3608,4177
0130-001,2014,4,23,11,1863,1727,3590,3608
0130-001,2014,4,23,12,1719,1563,3282,3590
0130-001,2014,4,23,13,1520,1549,3069,3282
0130-001,2014,4,23,14,1804,1803,3607,3069
0130-001,2014,4,23,15,1804,1674,3478,3607
0130-001,2014,4,23,16,1766,1795,3561,3478
0130-001,2014,4,23,17,1740,1853,3593,3561
0130-001,2014,4,23,18,1736,2347,4083,3593
0130-001,2014,4,23,19,1751,2660,4411,4083
0130-001,2014,4,23,20,1458,1908,3366,4411
0130-001,2014,4,23,21,1300,1646,2946,3366
0130-001,2014,4,23,22,1240,1232,2472,2946
0130-001,2014,4,23,23,873,827,1700,2472
0130-001,2014,4,23,24,621,541,1162,1700
0130-001,2014,4,24,1,382,338,720,1162
0130-001,2014,4,24,2,255,241,496,720
0130-001,2014,4,24,3,200,174,374,496
0130-001,2014,4,24,4,151,177,328,374
0130-001,2014,4,24,5,185,225,410,328
0130-001,2014,4,24,6,399,376,775,410
0130-001,2014,4,24,7,1445,779,2224,775
0130-001,2014,4,24,8,2112,1760,3872,2224
0130-001,2014,4,24,9,2180,1983,4163,3872
0130-001,2014,4,24,10,1862,1700,3562,4163
0130-001,2014,4,24,11,1790,1732,3522,3562
0130-001,2014,4,24,12,1624,1592,3216,3522
0130-001,2014,4,24,13,1420,1494,2914,3216
0130-001,2014,4,24,14,1876,1780,3656,2914
0130-001,2014,4,24,15,1850,1766,3616,3656
0130-001,2014,4,24,16,1785,1807,3592,3616
0130-001,2014,4,24,17,1709,1851,3560,3592
0130-001,2014,4,24,18,1728,2337,4065,3560
0130-001,2014,4,24,19,1826,2552,4378,4065
0130-001,2014,4,24,20,1424,1794,3218,4378
0130-001,2014,4,24,21,1189,1622,2811,3218
0130-001,2014,4,24,22,1111,1326,2437,2811
0130-001,2014,4,24,23,954,822,1776,2437
0130-001,2014,4,24,24,620,543,1163,1776
0130-001,2014,4,25,1,399,372,771,1163
0130-001,2014,4,25,2,264,257,521,771
0130-001,2014,4,25,3,178,170,348,521
0130-001,2014,4,25,4,160,168,328,348
0130-001,2014,4,25,5,197,229,426,328
0130-001,2014,4,25,6,396,425,821,426
0130-001,2014,4,25,7,1465,798,2263,821
0130-001,2014,4,25,8,2159,1724,3883,2263
0130-001,2014,4,25,9,2209,1952,4161,3883
0130-001,2014,4,25,10,1953,1745,3698,4161
0130-001,2014,4,25,11,1855,1742,3597,3698
0130-001,2014,4,25,12,1725,1620,3345,3597
0130-001,2014,4,25,13,1589,1583,3172,3345
0130-001,2014,4,25,14,1893,2010,3903,3172
0130-001,2014,4,25,15,1860,1747,3607,3903
0130-001,2014,4,25,16,1871,1857,3728,3607
0130-001,2014,4,25,17,1725,1950,3675,3728
0130-001,2014,4,25,18,2014,2426,4440,3675
0130-001,2014,4,25,19,1907,2633,4540,4440
0130-001,2014,4,25,20,1631,2209,3840,4540
0130-001,2014,4,25,21,1331,1795,3126,3840
0130-001,2014,4,25,22,1243,1331,2574,3126
0130-001,2014,4,25,23,1020,913,1933,2574
0130-001,2014,4,25,24,670,611,1281,1933
0130-001,2014,4,26,1,529,417,946,1281
0130-001,2014,4,26,2,378,357,735,946
0130-001,2014,4,26,3,282,249,531,735
0130-001,2014,4,26,4,206,219,425,531
0130-001,2014,4,26,5,236,297,533,425
0130-001,2014,4,26,6,406,418,824,533
0130-001,2014,4,26,7,1031,648,1679,824
0130-001,2014,4,26,8,1544,1162,2706,1679
0130-001,2014,4,26,9,1845,1695,3540,2706
0130-001,2014,4,26,10,1783,1762,3545,3540
0130-001,2014,4,26,11,1731,1837,3568,3545
0130-001,2014,4,26,12,1755,1943,3698,3568
0130-001,2014,4,26,13,1649,2100,3749,3698
0130-001,2014,4,26,14,1783,1938,3721,3749
0130-001,2014,4,26,15,1740,1825,3565,3721
0130-001,2014,4,26,16,1874,1786,3660,3565
0130-001,2014,4,26,17,1897,1874,3771,3660
0130-001,2014,4,26,18,2029,2143,4172,3771
0130-001,2014,4,26,19,1833,2050,3883,4172
0130-001,2014,4,26,20,1532,1406,2938,3883
0130-001,2014,4,26,21,1191,1214,2405,2938
0130-001,2014,4,26,22,1157,1034,2191,2405
0130-001,2014,4,26,23,789,677,1466,2191
0130-001,2014,4,26,24,557,497,1054,1466
0130-001,2014,4,27,1,418,360,778,1054
0130-001,2014,4,27,2,317,299,616,778
0130-001,2014,4,27,3,272,215,487,616
0130-001,2014,4,27,4,216,196,412,487
0130-001,2014,4,27,5,191,162,353,412
0130-001,2014,4,27,6,219,251,470,353
0130-001,2014,4,27,7,476,338,814,470
0130-001,2014,4,27,8,606,538,1144,814
0130-001,2014,4,27,9,798,823,1621,1144
0130-001,2014,4,27,10,980,1004,1984,1621
0130-001,2014,4,27,11,1087,1171,2258,1984
0130-001,2014,4,27,12,1099,1227,2326,2258
0130-001,2014,4,27,13,1265,1327,2592,2326
0130-001,2014,4,27,14,1406,1318,2724,2592
0130-001,2014,4,27,15,1517,1469,2986,2724
0130-001,2014,4,27,16,1675,1449,3124,2986
0130-001,2014,4,27,17,1665,1465,3130,3124
0130-001,2014,4,27,18,1664,1514,3178,3130
0130-001,2014,4,27,19,1468,1315,2783,3178
0130-001,2014,4,27,20,1297,1089,2386,2783
0130-001,2014,4,27,21,1100,958,2058,2386
0130-001,2014,4,27,22,913,790,1703,2058
0130-001,2014,4,27,23,611,487,1098,1703
0130-001,2014,4,27,24,372,328,700,1098
0130-001,2014,4,28,1,276,234,510,700
0130-001,2014,4,28,2,185,158,343,510
0130-001,2014,4,28,3,112,120,232,343
0130-001,2014,4,28,4,96,127,223,232
0130-001,2014,4,28,5,135,189,324,223
0130-001,2014,4,28,6,381,347,728,324
0130-001,2014,4,28,7,1345,752,2097,728
0130-001,2014,4,28,8,2019,1698,3717,2097
0130-001,2014,4,28,9,2126,1990,4116,3717
0130-001,2014,4,28,10,1883,1695,3578,4116
0130-001,2014,4,28,11,1678,1686,3364,3578
0130-001,2014,4,28,12,1690,1567,3257,3364
0130-001,2014,4,28,13,1450,1594,3044,3257
0130-001,2014,4,28,14,1884,1809,3693,3044
0130-001,2014,4,28,15,1771,1768,3539,3693
0130-001,2014,4,28,16,1749,1808,3557,3539
0130-001,2014,4,28,17,1661,1812,3473,3557
0130-001,2014,4,28,18,1707,2227,3934,3473
0130-001,2014,4,28,19,1771,2532,4303,3934
0130-001,2014,4,28,20,1385,1679,3064,4303
0130-001,2014,4,28,21,1115,1588,2703,3064
0130-001,2014,4,28,22,1067,1307,2374,2703
0130-001,2014,4,28,23,834,825,1659,2374
0130-001,2014,4,28,24,502,501,1003,1659
0130-001,2014,4,29,1,339,312,651,1003
0130-001,2014,4,29,2,228,228,456,651
0130-001,2014,4,29,3,164,153,317,456
0130-001,2014,4,29,4,145,173,318,317
0130-001,2014,4,29,5,193,226,419,318
0130-001,2014,4,29,6,305,347,652,419
0130-001,2014,4,29,7,1246,691,1937,652
0130-001,2014,4,29,8,2061,1679,3740,1937
0130-001,2014,4,29,9,2122,1979,4101,3740
0130-001,2014,4,29,10,2033,1684,3717,4101
0130-001,2014,4,29,11,1786,1758,3544,3717
0130-001,2014,4,29,12,1700,1751,3451,3544
0130-001,2014,4,29,13,1486,1652,3138,3451
0130-001,2014,4,29,14,1844,1875,3719,3138
0130-001,2014,4,29,15,1863,1825,3688,3719
0130-001,2014,4,29,16,1892,1873,3765,3688
0130-001,2014,4,29,17,1717,1810,3527,3765
0130-001,2014,4,29,18,1681,2225,3906,3527
0130-001,2014,4,29,19,1771,2392,4163,3906
0130-001,2014,4,29,20,1391,1814,3205,4163
0130-001,2014,4,29,21,1162,1739,2901,3205
0130-001,2014,4,29,22,1129,1359,2488,2901
0130-001,2014,4,29,23,845,812,1657,2488
0130-001,2014,4,29,24,634,555,1189,1657
0130-001,2014,4,30,1,377,337,714,1189
0130-001,2014,4,30,2,261,248,509,714
0130-001,2014,4,30,3,194,185,379,509
0130-001,2014,4,30,4,167,175,342,379
0130-001,2014,4,30,5,197,246,443,342
0130-001,2014,4,30,6,440,413,853,443
0130-001,2014,4,30,7,1481,811,2292,853
0130-001,2014,4,30,8,2166,1803,3969,2292
0130-001,2014,4,30,9,2133,1966,4099,3969
0130-001,2014,4,30,10,1894,1749,3643,4099
0130-001,2014,4,30,11,1875,1753,3628,3643
0130-001,2014,4,30,12,1761,1703,3464,3628
0130-001,2014,4,30,13,1462,1456,2918,3464
0130-001,2014,4,30,14,1800,1864,3664,2918
0130-001,2014,4,30,15,1896,1840,3736,3664
0130-001,2014,4,30,16,1813,1895,3708,3736
0130-001,2014,4,30,17,1744,1937,3681,3708
0130-001,2014,4,30,18,1977,2353,4330,3681
0130-001,2014,4,30,19,1932,2700,4632,4330
0130-001,2014,4,30,20,1599,2243,3842,4632
0130-001,2014,4,30,21,1313,1739,3052,3842
0130-001,2014,4,30,22,1220,1356,2576,3052
0130-001,2014,4,30,23,990,877,1867,2576
0130-001,2014,4,30,24,650,608,1258,1867
0130-001,2014,5,1,1,527,413,940,1258
0130-001,2014,5,1,2,313,306,619,940
0130-001,2014,5,1,3,258,214,472,619
0130-001,2014,5,1,4,207,183,390,472
0130-001,2014,5,1,5,200,269,469,390
0130-001,2014,5,1,6,379,373,752,469
0130-001,2014,5,1,7,1123,609,1732,752
0130-001,2014,5,1,8,1891,1445,3336,1732
0130-001,2014,5,1,9,1890,1751,3641,3336
0130-001,2014,5,1,10,1751,1653,3404,3641
0130-001,2014,5,1,11,1745,1760,3505,3404
0130-001,2014,5,1,12,1663,1633,3296,3505
0130-001,2014,5,1,13,1532,1628,3160,3296
0130-001,2014,5,1,14,1613,1734,3347,3160
0130-001,2014,5,1,15,1734,1777,3511,3347
0130-001,2014,5,1,16,1684,1802,3486,3511
0130-001,2014,5,1,17,1662,1595,3257,3486
0130-001,2014,5,1,18,1783,2344,4127,3257
0130-001,2014,5,1,19,1684,1987,3671,4127
0130-001,2014,5,1,20,1347,1564,2911,3671
0130-001,2014,5,1,21,1128,1329,2457,2911
0130-001,2014,5,1,22,1035,1000,2035,2457
0130-001,2014,5,1,23,845,722,1567,2035
0130-001,2014,5,1,24,587,481,1068,1567
0130-001,2014,5,2,1,336,283,619,1068
0130-001,2014,5,2,2,228,216,444,619
0130-001,2014,5,2,3,159,167,326,444
0130-001,2014,5,2,4,138,155,293,326
0130-001,2014,5,2,5,172,227,399,293
0130-001,2014,5,2,6,433,397,830,399
0130-001,2014,5,2,7,1353,748,2101,830
0130-001,2014,5,2,8,2135,1730,3865,2101
0130-001,2014,5,2,9,1885,1890,3775,3865
0130-001,2014,5,2,10,1781,1788,3569,3775
0130-001,2014,5,2,11,1906,1878,3784,3569
0130-001,2014,5,2,12,1707,1786,3493,3784
0130-001,2014,5,2,13,1499,1703,3202,3493
0130-001,2014,5,2,14,1884,1875,3759,3202
0130-001,2014,5,2,15,1904,1952,3856,3759
0130-001,2014,5,2,16,1948,1884,3832,3856
0130-001,2014,5,2,17,2014,2019,4033,3832
0130-001,2014,5,2,18,1860,2195,4055,4033
0130-001,2014,5,2,19,1938,2298,4236,4055
0130-001,2014,5,2,20,1594,1893,3487,4236
0130-001,2014,5,2,21,1278,1895,3173,3487
0130-001,2014,5,2,22,1142,1470,2612,3173
0130-001,2014,5,2,23,950,1198,2148,2612
0130-001,2014,5,2,24,609,677,1286,2148
0130-001,2014,5,3,1,476,383,859,1286
0130-001,2014,5,3,2,326,292,618,859
0130-001,2014,5,3,3,254,217,471,618
0130-001,2014,5,3,4,223,193,416,471
0130-001,2014,5,3,5,195,281,476,416
0130-001,2014,5,3,6,431,393,824,476
0130-001,2014,5,3,7,1025,671,1696,824
0130-001,2014,5,3,8,1482,1172,2654,1696
0130-001,2014,5,3,9,1590,1905,3495,2654
0130-001,2014,5,3,10,1640,2168,3808,3495
0130-001,2014,5,3,11,1784,2395,4179,3808
0130-001,2014,5,3,12,1700,2423,4123,4179
0130-001,2014,5,3,13,1603,2281,3884,4123
0130-001,2014,5,3,14,1753,2378,4131,3884
0130-001,2014,5,3,15,1619,2475,4094,4131
0130-001,2014,5,3,16,1751,2369,4120,4094
0130-001,2014,5,3,17,1656,2424,4080,4120
0130-001,2014,5,3,18,1788,2721,4509,4080
0130-001,2014,5,3,19,1757,2617,4374,4509
0130-001,2014,5,3,20,1500,2342,3842,4374
0130-001,2014,5,3,21,1227,2248,3475,3842
0130-001,2014,5,3,22,1186,2004,3190,3475
0130-001,2014,5,3,23,836,1662,2498,3190
0130-001,2014,5,3,24,510,758,1268,2498
0130-001,2014,5,4,1,374,347,721,1268
0130-001,2014,5,4,2,274,245,519,721
0130-001,2014,5,4,3,256,210,466,519
0130-001,2014,5,4,4,174,147,321,466
0130-001,2014,5,4,5,176,161,337,321
0130-001,2014,5,4,6,302,302,604,337
0130-001,2014,5,4,7,544,456,1000,604
0130-001,2014,5,4,8,747,696,1443,1000
0130-001,2014,5,4,9,917,1026,1943,1443
0130-001,2014,5,4,10,986,1551,2537,1943
0130-001,2014,5,4,11,1178,1768,2946,2537
0130-001,2014,5,4,12,1198,1929,3127,2946
0130-001,2014,5,4,13,1179,2078,3257,3127
0130-001,2014,5,4,14,1318,2030,3348,3257
0130-001,2014,5,4,15,1364,1980,3344,3348
0130-001,2014,5,4,16,1683,1982,3665,3344
0130-001,2014,5,4,17,1755,1969,3724,3665
0130-001,2014,5,4,18,1982,2008,3990,3724
0130-001,2014,5,4,19,1858,1611,3469,3990
0130-001,2014,5,4,20,1622,1282,2904,3469
0130-001,2014,5,4,21,1750,1115,2865,2904
0130-001,2014,5,4,22,1411,856,2267,2865
0130-001,2014,5,4,23,1182,579,1761,2267
0130-001,2014,5,4,24,805,368,1173,1761
0130-001,2014,5,5,1,414,294,708,1173
0130-001,2014,5,5,2,214,170,384,708
0130-001,2014,5,5,3,168,127,295,384
0130-001,2014,5,5,4,130,136,266,295
0130-001,2014,5,5,5,150,182,332,266
0130-001,2014,5,5,6,284,286,570,332
0130-001,2014,5,5,7,690,466,1156,570
0130-001,2014,5,5,8,900,642,1542,1156
0130-001,2014,5,5,9,956,950,1906,1542
0130-001,2014,5,5,10,1197,1244,2441,1906
0130-001,2014,5,5,11,1356,1533,2889,2441
0130-001,2014,5,5,12,1516,1537,3053,2889
0130-001,2014,5,5,13,1525,1511,3036,3053
0130-001,2014,5,5,14,1661,1477,3138,3036
0130-001,2014,5,5,15,1809,1455,3264,3138
0130-001,2014,5,5,16,1843,1535,3378,3264
0130-001,2014,5,5,17,1843,1402,3245,3378
0130-001,2014,5,5,18,1828,1637,3465,3245
0130-001,2014,5,5,19,1802,1450,3252,3465
0130-001,2014,5,5,20,1781,1141,2922,3252
0130-001,2014,5,5,21,1949,986,2935,2922
0130-001,2014,5,5,22,2048,836,2884,2935
0130-001,2014,5,5,23,1640,655,2295,2884
0130-001,2014,5,5,24,1403,493,1896,2295
0130-001,2014,5,6,1,1294,327,1621,1896
0130-001,2014,5,6,2,1507,232,1739,1621
0130-001,2014,5,6,3,710,169,879,1739
0130-001,2014,5,6,4,217,168,385,879
0130-001,2014,5,6,5,178,217,395,385
0130-001,2014,5,6,6,368,289,657,395
0130-001,2014,5,6,7,781,512,1293,657
0130-001,2014,5,6,8,1099,730,1829,1293
0130-001,2014,5,6,9,1182,1009,2191,1829
0130-001,2014,5,6,10,1391,1164,2555,2191
0130-001,2014,5,6,11,1711,1322,3033,2555
0130-001,2014,5,6,12,1848,1372,3220,3033
0130-001,2014,5,6,13,1838,1412,3250,3220
0130-001,2014,5,6,14,1889,1582,3471,3250
0130-001,2014,5,6,15,1950,1646,3596,3471
0130-001,2014,5,6,16,1877,1516,3393,3596
0130-001,2014,5,6,17,2102,1677,3779,3393
0130-001,2014,5,6,18,1927,1788,3715,3779
0130-001,2014,5,6,19,1733,1579,3312,3715
0130-001,2014,5,6,20,1300,1324,2624,3312
0130-001,2014,5,6,21,1139,1223,2362,2624
0130-001,2014,5,6,22,992,909,1901,2362
0130-001,2014,5,6,23,700,575,1275,1901
0130-001,2014,5,6,24,484,385,869,1275
0130-001,2014,5,7,1,336,257,593,869
0130-001,2014,5,7,2,180,152,332,593
0130-001,2014,5,7,3,127,123,250,332
0130-001,2014,5,7,4,97,122,219,250
0130-001,2014,5,7,5,161,201,362,219
0130-001,2014,5,7,6,447,384,831,362
0130-001,2014,5,7,7,1510,819,2329,831
0130-001,2014,5,7,8,2134,1802,3936,2329
0130-001,2014,5,7,9,2196,1993,4189,3936
0130-001,2014,5,7,10,1719,1798,3517,4189
0130-001,2014,5,7,11,1840,1770,3610,3517
0130-001,2014,5,7,12,1706,1639,3345,3610
0130-001,2014,5,7,13,1476,1515,2991,3345
0130-001,2014,5,7,14,1775,1692,3467,2991
0130-001,2014,5,7,15,1835,1817,3652,3467
0130-001,2014,5,7,16,1848,1821,3669,3652
0130-001,2014,5,7,17,1780,1967,3747,3669
0130-001,2014,5,7,18,1773,2314,4087,3747
0130-001,2014,5,7,19,1951,2596,4547,4087
0130-001,2014,5,7,20,1510,1916,3426,4547
0130-001,2014,5,7,21,1298,1781,3079,3426
0130-001,2014,5,7,22,1225,1390,2615,3079
0130-001,2014,5,7,23,873,901,1774,2615
0130-001,2014,5,7,24,550,528,1078,1774
0130-001,2014,5,8,1,353,353,706,1078
0130-001,2014,5,8,2,228,221,449,706
0130-001,2014,5,8,3,175,162,337,449
0130-001,2014,5,8,4,143,157,300,337
0130-001,2014,5,8,5,172,236,408,300
0130-001,2014,5,8,6,359,357,716,408
0130-001,2014,5,8,7,1394,784,2178,716
0130-001,2014,5,8,8,2094,1794,3888,2178
0130-001,2014,5,8,9,2160,2061,4221,3888
0130-001,2014,5,8,10,1980,1767,3747,4221
0130-001,2014,5,8,11,1934,1728,3662,3747
0130-001,2014,5,8,12,1798,1748,3546,3662
0130-001,2014,5,8,13,1595,1577,3172,3546
0130-001,2014,5,8,14,1809,1772,3581,3172
0130-001,2014,5,8,15,1874,1766,3640,3581
0130-001,2014,5,8,16,1782,1662,3444,3640
0130-001,2014,5,8,17,1855,1628,3483,3444
0130-001,2014,5,8,18,1896,1905,3801,3483
0130-001,2014,5,8,19,1999,2265,4264,3801
0130-001,2014,5,8,20,1527,1671,3198,4264
0130-001,2014,5,8,21,1353,1897,3250,3198
0130-001,2014,5,8,22,1243,1517,2760,3250
0130-001,2014,5,8,23,884,971,1855,2760
0130-001,2014,5,8,24,523,503,1026,1855
0130-001,2014,5,9,1,327,361,688,1026
0130-001,2014,5,9,2,242,213,455,688
0130-001,2014,5,9,3,180,156,336,455
0130-001,2014,5,9,4,126,156,282,336
0130-001,2014,5,9,5,177,227,404,282
0130-001,2014,5,9,6,418,432,850,404
0130-001,2014,5,9,7,1427,829,2256,850
0130-001,2014,5,9,8,2221,1756,3977,2256
0130-001,2014,5,9,9,2138,2018,4156,3977
0130-001,2014,5,9,10,2075,1778,3853,4156
0130-001,2014,5,9,11,1887,1659,3546,3853
0130-001,2014,5,9,12,1748,1734,3482,3546
0130-001,2014,5,9,13,1530,1667,3197,3482
0130-001,2014,5,9,14,1771,1818,3589,3197
0130-001,2014,5,9,15,1817,1846,3663,3589
0130-001,2014,5,9,16,1983,1843,3826,3663
0130-001,2014,5,9,17,1849,2022,3871,3826
0130-001,2014,5,9,18,1892,2389,4281,3871
0130-001,2014,5,9,19,1874,2671,4545,4281
0130-001,2014,5,9,20,1592,2026,3618,4545
0130-001,2014,5,9,21,1392,1945,3337,3618
0130-001,2014,5,9,22,1251,1441,2692,3337
0130-001,2014,5,9,23,1014,946,1960,2692
0130-001,2014,5,9,24,701,647,1348,1960
0130-001,2014,5,10,1,512,468,980,1348
0130-001,2014,5,10,2,338,333,671,980
0130-001,2014,5,10,3,277,233,510,671
0130-001,2014,5,10,4,235,255,490,510
0130-001,2014,5,10,5,225,285,510,490
0130-001,2014,5,10,6,425,453,878,510
0130-001,2014,5,10,7,1024,680,1704,878
0130-001,2014,5,10,8,1594,1114,2708,1704
0130-001,2014,5,10,9,1692,1719,3411,2708
0130-001,2014,5,10,10,1672,1828,3500,3411
0130-001,2014,5,10,11,1810,1915,3725,3500
0130-001,2014,5,10,12,1685,2221,3906,3725
0130-001,2014,5,10,13,1636,1969,3605,3906
0130-001,2014,5,10,14,1904,1729,3633,3605
0130-001,2014,5,10,15,1813,1826,3639,3633
0130-001,2014,5,10,16,1724,1825,3549,3639
0130-001,2014,5,10,17,1847,1694,3541,3549
0130-001,2014,5,10,18,1906,2226,4132,3541
0130-001,2014,5,10,19,1846,2028,3874,4132
0130-001,2014,5,10,20,1504,1427,2931,3874
0130-001,2014,5,10,21,1265,1284,2549,2931
0130-001,2014,5,10,22,1164,1036,2200,2549
0130-001,2014,5,10,23,869,719,1588,2200
0130-001,2014,5,10,24,591,530,1121,1588
0130-001,2014,5,11,1,460,367,827,1121
0130-001,2014,5,11,2,315,280,595,827
0130-001,2014,5,11,3,268,211,479,595
0130-001,2014,5,11,4,195,163,358,479
0130-001,2014,5,11,5,191,167,358,358
0130-001,2014,5,11,6,325,271,596,358
0130-001,2014,5,11,7,651,447,1098,596
0130-001,2014,5,11,8,771,619,1390,1098
0130-001,2014,5,11,9,800,883,1683,1390
0130-001,2014,5,11,10,1006,1065,2071,1683
0130-001,2014,5,11,11,1209,1290,2499,2071
0130-001,2014,5,11,12,1183,1359,2542,2499
0130-001,2014,5,11,13,1356,1377,2733,2542
0130-001,2014,5,11,14,1484,1340,2824,2733
0130-001,2014,5,11,15,1485,1421,2906,2824
0130-001,2014,5,11,16,1613,1545,3158,2906
0130-001,2014,5,11,17,1676,1408,3084,3158
0130-001,2014,5,11,18,1665,1549,3214,3084
0130-001,2014,5,11,19,1608,1420,3028,3214
0130-001,2014,5,11,20,1204,1072,2276,3028
0130-001,2014,5,11,21,1100,964,2064,2276
0130-001,2014,5,11,22,908,745,1653,2064
0130-001,2014,5,11,23,596,494,1090,1653
0130-001,2014,5,11,24,394,355,749,1090
0130-001,2014,5,12,1,263,228,491,749
0130-001,2014,5,12,2,151,145,296,491
0130-001,2014,5,12,3,116,101,217,296
0130-001,2014,5,12,4,94,106,200,217
0130-001,2014,5,12,5,144,201,345,200
0130-001,2014,5,12,6,393,382,775,345
0130-001,2014,5,12,7,1413,800,2213,775
0130-001,2014,5,12,8,2119,1830,3949,2213
0130-001,2014,5,12,9,2280,2006,4286,3949
0130-001,2014,5,12,10,1793,1749,3542,4286
0130-001,2014,5,12,11,1802,1634,3436,3542
0130-001,2014,5,12,12,1674,1503,3177,3436
0130-001,2014,5,12,13,1527,1412,2939,3177
0130-001,2014,5,12,14,1798,1543,3341,2939
0130-001,2014,5,12,15,1857,1672,3529,3341
0130-001,2014,5,12,16,1821,1622,3443,3529
0130-001,2014,5,12,17,1798,1732,3530,3443
0130-001,2014,5,12,18,1793,2245,4038,3530
0130-001,2014,5,12,19,1781,2403,4184,4038
0130-001,2014,5,12,20,1502,1849,3351,4184
0130-001,2014,5,12,21,1277,1786,3063,3351
0130-001,2014,5,12,22,1200,1400,2600,3063
0130-001,2014,5,12,23,848,789,1637,2600
0130-001,2014,5,12,24,558,491,1049,1637
0130-001,2014,5,13,1,352,322,674,1049
0130-001,2014,5,13,2,240,224,464,674
0130-001,2014,5,13,3,196,146,342,464
0130-001,2014,5,13,4,137,158,295,342
0130-001,2014,5,13,5,181,183,364,295
0130-001,2014,5,13,6,419,391,810,364
0130-001,2014,5,13,7,1481,808,2289,810
0130-001,2014,5,13,8,2137,1730,3867,2289
0130-001,2014,5,13,9,2276,1934,4210,3867
0130-001,2014,5,13,10,1789,1763,3552,4210
0130-001,2014,5,13,11,1852,1713,3565,3552
0130-001,2014,5,13,12,1638,1615,3253,3565
0130-001,2014,5,13,13,1466,1501,2967,3253
0130-001,2014,5,13,14,1744,1753,3497,2967
0130-001,2014,5,13,15,1865,1848,3713,3497
0130-001,2014,5,13,16,1826,1893,3719,3713
0130-001,2014,5,13,17,1763,1857,3620,3719
0130-001,2014,5,13,18,1772,2288,4060,3620
0130-001,2014,5,13,19,1849,2509,4358,4060
0130-001,2014,5,13,20,1417,1846,3263,4358
0130-001,2014,5,13,21,1223,1741,2964,3263
0130-001,2014,5,13,22,1183,1449,2632,2964
0130-001,2014,5,13,23,891,864,1755,2632
0130-001,2014,5,13,24,584,527,1111,1755
0130-001,2014,5,14,1,410,362,772,1111
0130-001,2014,5,14,2,250,242,492,772
0130-001,2014,5,14,3,162,191,353,492
0130-001,2014,5,14,4,148,164,312,353
0130-001,2014,5,14,5,163,209,372,312
0130-001,2014,5,14,6,427,402,829,372
0130-001,2014,5,14,7,1411,811,2222,829
0130-001,2014,5,14,8,2188,1664,3852,2222
0130-001,2014,5,14,9,2099,1994,4093,3852
0130-001,2014,5,14,10,1813,1799,3612,4093
0130-001,2014,5,14,11,1856,1722,3578,3612
0130-001,2014,5,14,12,1762,1683,3445,3578
0130-001,2014,5,14,13,1486,1478,2964,3445
0130-001,2014,5,14,14,1728,1736,3464,2964
0130-001,2014,5,14,15,1879,1740,3619,3464
0130-001,2014,5,14,16,1741,1840,3581,3619
0130-001,2014,5,14,17,1746,1831,3577,3581
0130-001,2014,5,14,18,1756,2318,4074,3577
0130-001,2014,5,14,19,1741,2646,4387,4074
0130-001,2014,5,14,20,1464,1964,3428,4387
0130-001,2014,5,14,21,1296,1732,3028,3428
0130-001,2014,5,14,22,1214,1318,2532,3028
0130-001,2014,5,14,23,976,841,1817,2532
0130-001,2014,5,14,24,622,532,1154,1817
0130-001,2014,5,15,1,431,407,838,1154
0130-001,2014,5,15,2,279,238,517,838
0130-001,2014,5,15,3,184,166,350,517
0130-001,2014,5,15,4,152,193,345,350
0130-001,2014,5,15,5,186,229,415,345
0130-001,2014,5,15,6,432,419,851,415
0130-001,2014,5,15,7,1461,788,2249,851
0130-001,2014,5,15,8,2141,1713,3854,2249
0130-001,2014,5,15,9,2181,1981,4162,3854
0130-001,2014,5,15,10,1844,1755,3599,4162
0130-001,2014,5,15,11,1770,1712,3482,3599
0130-001,2014,5,15,12,1653,1648,3301,3482
0130-001,2014,5,15,13,1448,1423,2871,3301
0130-001,2014,5,15,14,1717,1755,3472,2871
0130-001,2014,5,15,15,1854,1737,3591,3472
0130-001,2014,5,15,16,1846,1795,3641,3591
0130-001,2014,5,15,17,1787,1880,3667,3641
0130-001,2014,5,15,18,1780,2322,4102,3667
0130-001,2014,5,15,19,1815,2551,4366,4102
0130-001,2014,5,15,20,1494,1878,3372,4366
0130-001,2014,5,15,21,1239,1711,2950,3372
0130-001,2014,5,15,22,1208,1353,2561,2950
0130-001,2014,5,15,23,939,912,1851,2561
0130-001,2014,5,15,24,661,552,1213,1851
0130-001,2014,5,16,1,440,385,825,1213
0130-001,2014,5,16,2,266,281,547,825
0130-001,2014,5,16,3,196,194,390,547
0130-001,2014,5,16,4,146,152,298,390
0130-001,2014,5,16,5,172,235,407,298
0130-001,2014,5,16,6,476,443,919,407
0130-001,2014,5,16,7,1466,751,2217,919
0130-001,2014,5,16,8,2205,1739,3944,2217
0130-001,2014,5,16,9,2137,2020,4157,3944
0130-001,2014,5,16,10,1859,1774,3633,4157
0130-001,2014,5,16,11,1797,1738,3535,3633
0130-001,2014,5,16,12,1578,1662,3240,3535
0130-001,2014,5,16,13,1514,1572,3086,3240
0130-001,2014,5,16,14,1736,1723,3459,3086
0130-001,2014,5,16,15,1826,1865,3691,3459
0130-001,2014,5,16,16,1811,1875,3686,3691
0130-001,2014,5,16,17,1730,2006,3736,3686
0130-001,2014,5,16,18,1994,2348,4342,3736
0130-001,2014,5,16,19,1904,2649,4553,4342
0130-001,2014,5,16,20,1681,2122,3803,4553
0130-001,2014,5,16,21,1400,1832,3232,3803
0130-001,2014,5,16,22,1292,1422,2714,3232
0130-001,2014,5,16,23,1046,874,1920,2714
0130-001,2014,5,16,24,741,650,1391,1920
0130-001,2014,5,17,1,461,482,943,1391
0130-001,2014,5,17,2,386,358,744,943
0130-001,2014,5,17,3,260,231,491,744
0130-001,2014,5,17,4,231,251,482,491
0130-001,2014,5,17,5,231,288,519,482
0130-001,2014,5,17,6,452,460,912,519
0130-001,2014,5,17,7,1043,665,1708,912
0130-001,2014,5,17,8,1675,1117,2792,1708
0130-001,2014,5,17,9,1786,1772,3558,2792
0130-001,2014,5,17,10,1720,1773,3493,3558
0130-001,2014,5,17,11,1650,1957,3607,3493
0130-001,2014,5,17,12,1696,2050,3746,3607
0130-001,2014,5,17,13,1685,1983,3668,3746
0130-001,2014,5,17,14,1716,1762,3478,3668
0130-001,2014,5,17,15,1848,1765,3613,3478
0130-001,2014,5,17,16,1760,1813,3573,3613
0130-001,2014,5,17,17,1838,1759,3597,3573
0130-001,2014,5,17,18,1954,2101,4055,3597
0130-001,2014,5,17,19,1915,1967,3882,4055
0130-001,2014,5,17,20,1569,1410,2979,3882
0130-001,2014,5,17,21,1280,1350,2630,2979
0130-001,2014,5,17,22,1122,1033,2155,2630
0130-001,2014,5,17,23,820,788,1608,2155
0130-001,2014,5,17,24,606,512,1118,1608
0130-001,2014,5,18,1,446,368,814,1118
0130-001,2014,5,18,2,319,268,587,814
0130-001,2014,5,18,3,255,227,482,587
0130-001,2014,5,18,4,214,175,389,482
0130-001,2014,5,18,5,230,182,412,389
0130-001,2014,5,18,6,326,307,633,412
0130-001,2014,5,18,7,617,419,1036,633
0130-001,2014,5,18,8,822,632,1454,1036
0130-001,2014,5,18,9,898,933,1831,1454
0130-001,2014,5,18,10,1055,1139,2194,1831
0130-001,2014,5,18,11,1189,1423,2612,2194
0130-001,2014,5,18,12,1173,1414,2587,2612
0130-001,2014,5,18,13,1294,1527,2821,2587
0130-001,2014,5,18,14,1481,1398,2879,2821
0130-001,2014,5,18,15,1566,1492,3058,2879
0130-001,2014,5,18,16,1715,1510,3225,3058
0130-001,2014,5,18,17,1718,1515,3233,3225
0130-001,2014,5,18,18,1859,1683,3542,3233
0130-001,2014,5,18,19,1743,1484,3227,3542
0130-001,2014,5,18,20,1386,1265,2651,3227
0130-001,2014,5,18,21,1185,1064,2249,2651
0130-001,2014,5,18,22,1092,953,2045,2249
0130-001,2014,5,18,23,803,612,1415,2045
0130-001,2014,5,18,24,458,359,817,1415
0130-001,2014,5,19,1,315,251,566,817
0130-001,2014,5,19,2,175,157,332,566
0130-001,2014,5,19,3,112,110,222,332
0130-001,2014,5,19,4,105,118,223,222
0130-001,2014,5,19,5,166,190,356,223
0130-001,2014,5,19,6,485,474,959,356
0130-001,2014,5,19,7,1627,875,2502,959
0130-001,2014,5,19,8,2126,1701,3827,2502
0130-001,2014,5,19,9,2170,1983,4153,3827
0130-001,2014,5,19,10,1833,1765,3598,4153
0130-001,2014,5,19,11,1814,1682,3496,3598
0130-001,2014,5,19,12,1693,1655,3348,3496
0130-001,2014,5,19,13,1507,1540,3047,3348
0130-001,2014,5,19,14,1817,1752,3569,3047
0130-001,2014,5,19,15,1841,1822,3663,3569
0130-001,2014,5,19,16,1794,1898,3692,3663
0130-001,2014,5,19,17,1674,1897,3571,3692
0130-001,2014,5,19,18,1794,2170,3964,3571
0130-001,2014,5,19,19,1761,2494,4255,3964
0130-001,2014,5,19,20,1451,1865,3316,4255
0130-001,2014,5,19,21,1142,1648,2790,3316
0130-001,2014,5,19,22,1095,1376,2471,2790
0130-001,2014,5,19,23,781,792,1573,2471
0130-001,2014,5,19,24,579,484,1063,1573
0130-001,2014,5,20,1,342,341,683,1063
0130-001,2014,5,20,2,242,236,478,683
0130-001,2014,5,20,3,173,164,337,478
0130-001,2014,5,20,4,140,162,302,337
0130-001,2014,5,20,5,179,237,416,302
0130-001,2014,5,20,6,472,403,875,416
0130-001,2014,5,20,7,1443,788,2231,875
0130-001,2014,5,20,8,2110,1779,3889,2231
0130-001,2014,5,20,9,2145,2014,4159,3889
0130-001,2014,5,20,10,1841,1716,3557,4159
0130-001,2014,5,20,11,1814,1703,3517,3557
0130-001,2014,5,20,12,1712,1594,3306,3517
0130-001,2014,5,20,13,1406,1496,2902,3306
0130-001,2014,5,20,14,1774,1700,3474,2902
0130-001,2014,5,20,15,1804,1706,3510,3474
0130-001,2014,5,20,16,1753,1796,3549,3510
0130-001,2014,5,20,17,1784,1843,3627,3549
0130-001,2014,5,20,18,1779,2331,4110,3627
0130-001,2014,5,20,19,1735,2490,4225,4110
0130-001,2014,5,20,20,1445,1811,3256,4225
0130-001,2014,5,20,21,1294,1752,3046,3256
0130-001,2014,5,20,22,1172,1429,2601,3046
0130-001,2014,5,20,23,912,846,1758,2601
0130-001,2014,5,20,24,638,518,1156,1758
0130-001,2014,5,21,1,401,375,776,1156
0130-001,2014,5,21,2,261,241,502,776
0130-001,2014,5,21,3,202,167,369,502
0130-001,2014,5,21,4,140,170,310,369
0130-001,2014,5,21,5,165,220,385,310
0130-001,2014,5,21,6,440,439,879,385
0130-001,2014,5,21,7,1502,774,2276,879
0130-001,2014,5,21,8,2127,1704,3831,2276
0130-001,2014,5,21,9,2156,1974,4130,3831
0130-001,2014,5,21,10,1777,1742,3519,4130
0130-001,2014,5,21,11,1844,1702,3546,3519
0130-001,2014,5,21,12,1735,1644,3379,3546
0130-001,2014,5,21,13,1399,1489,2888,3379
0130-001,2014,5,21,14,1814,1688,3502,2888
0130-001,2014,5,21,15,1808,1811,3619,3502
0130-001,2014,5,21,16,1782,1738,3520,3619
0130-001,2014,5,21,17,1767,1939,3706,3520
0130-001,2014,5,21,18,1872,2329,4201,3706
0130-001,2014,5,21,19,1893,2623,4516,4201
0130-001,2014,5,21,20,1498,1997,3495,4516
0130-001,2014,5,21,21,1346,1720,3066,3495
0130-001,2014,5,21,22,1218,1362,2580,3066
0130-001,2014,5,21,23,944,859,1803,2580
0130-001,2014,5,21,24,623,550,1173,1803
0130-001,2014,5,22,1,414,360,774,1173
0130-001,2014,5,22,2,276,307,583,774
0130-001,2014,5,22,3,193,197,390,583
0130-001,2014,5,22,4,136,180,316,390
0130-001,2014,5,22,5,209,258,467,316
0130-001,2014,5,22,6,446,395,841,467
0130-001,2014,5,22,7,1491,844,2335,841
0130-001,2014,5,22,8,2110,1750,3860,2335
0130-001,2014,5,22,9,2199,2028,4227,3860
0130-001,2014,5,22,10,1930,1752,3682,4227
0130-001,2014,5,22,11,1859,1639,3498,3682
0130-001,2014,5,22,12,1660,1659,3319,3498
0130-001,2014,5,22,13,1486,1516,3002,3319
0130-001,2014,5,22,14,1732,1618,3350,3002
0130-001,2014,5,22,15,1821,1801,3622,3350
0130-001,2014,5,22,16,1817,1812,3629,3622
0130-001,2014,5,22,17,1790,1924,3714,3629
0130-001,2014,5,22,18,1819,2280,4099,3714
0130-001,2014,5,22,19,1802,2428,4230,4099
0130-001,2014,5,22,20,1412,1828,3240,4230
0130-001,2014,5,22,21,1216,1783,2999,3240
0130-001,2014,5,22,22,1230,1380,2610,2999
0130-001,2014,5,22,23,927,879,1806,2610
0130-001,2014,5,22,24,637,527,1164,1806
0130-001,2014,5,23,1,375,396,771,1164
0130-001,2014,5,23,2,309,257,566,771
0130-001,2014,5,23,3,196,179,375,566
0130-001,2014,5,23,4,158,175,333,375
0130-001,2014,5,23,5,192,239,431,333
0130-001,2014,5,23,6,431,446,877,431
0130-001,2014,5,23,7,1509,802,2311,877
0130-001,2014,5,23,8,2124,1726,3850,2311
0130-001,2014,5,23,9,2141,1952,4093,3850
0130-001,2014,5,23,10,1792,1719,3511,4093
0130-001,2014,5,23,11,1810,1721,3531,3511
0130-001,2014,5,23,12,1673,1711,3384,3531
0130-001,2014,5,23,13,1582,1560,3142,3384
0130-001,2014,5,23,14,1732,1738,3470,3142
0130-001,2014,5,23,15,1784,1764,3548,3470
0130-001,2014,5,23,16,1819,1772,3591,3548
0130-001,2014,5,23,17,1855,2017,3872,3591
0130-001,2014,5,23,18,1876,2328,4204,3872
0130-001,2014,5,23,19,1961,2622,4583,4204
0130-001,2014,5,23,20,1706,2163,3869,4583
0130-001,2014,5,23,21,1341,1849,3190,3869
0130-001,2014,5,23,22,1314,1425,2739,3190
0130-001,2014,5,23,23,1038,933,1971,2739
0130-001,2014,5,23,24,728,584,1312,1971
0130-001,2014,5,24,1,508,423,931,1312
0130-001,2014,5,24,2,391,306,697,931
0130-001,2014,5,24,3,273,264,537,697
0130-001,2014,5,24,4,236,201,437,537
0130-001,2014,5,24,5,252,287,539,437
0130-001,2014,5,24,6,467,450,917,539
0130-001,2014,5,24,7,1108,678,1786,917
0130-001,2014,5,24,8,1555,1145,2700,1786
0130-001,2014,5,24,9,1714,1776,3490,2700
0130-001,2014,5,24,10,1822,1847,3669,3490
0130-001,2014,5,24,11,1857,1855,3712,3669
0130-001,2014,5,24,12,1712,1845,3557,3712
0130-001,2014,5,24,13,1637,2095,3732,3557
0130-001,2014,5,24,14,1707,1777,3484,3732
0130-001,2014,5,24,15,1674,1748,3422,3484
0130-001,2014,5,24,16,1824,1788,3612,3422
0130-001,2014,5,24,17,1833,1807,3640,3612
0130-001,2014,5,24,18,2000,2083,4083,3640
0130-001,2014,5,24,19,1913,2014,3927,4083
0130-001,2014,5,24,20,1467,1482,2949,3927
0130-001,2014,5,24,21,1181,1191,2372,2949
0130-001,2014,5,24,22,1050,1053,2103,2372
0130-001,2014,5,24,23,889,679,1568,2103
0130-001,2014,5,24,24,590,468,1058,1568
0130-001,2014,5,25,1,440,392,832,1058
0130-001,2014,5,25,2,357,292,649,832
0130-001,2014,5,25,3,259,202,461,649
0130-001,2014,5,25,4,235,189,424,461
0130-001,2014,5,25,5,206,163,369,424
0130-001,2014,5,25,6,299,316,615,369
0130-001,2014,5,25,7,637,439,1076,615
0130-001,2014,5,25,8,779,665,1444,1076
0130-001,2014,5,25,9,922,1030,1952,1444
0130-001,2014,5,25,10,923,1068,1991,1952
0130-001,2014,5,25,11,1225,1255,2480,1991
0130-001,2014,5,25,12,1209,1287,2496,2480
0130-001,2014,5,25,13,1276,1532,2808,2496
0130-001,2014,5,25,14,1471,1326,2797,2808
0130-001,2014,5,25,15,1566,1519,3085,2797
0130-001,2014,5,25,16,1657,1444,3101,3085
0130-001,2014,5,25,17,1775,1444,3219,3101
0130-001,2014,5,25,18,1746,1527,3273,3219
0130-001,2014,5,25,19,1588,1314,2902,3273
0130-001,2014,5,25,20,1323,1128,2451,2902
0130-001,2014,5,25,21,1104,891,1995,2451
0130-001,2014,5,25,22,868,758,1626,1995
0130-001,2014,5,25,23,623,488,1111,1626
0130-001,2014,5,25,24,425,345,770,1111
0130-001,2014,5,26,1,256,222,478,770
0130-001,2014,5,26,2,180,137,317,478
0130-001,2014,5,26,3,118,96,214,317
0130-001,2014,5,26,4,118,111,229,214
0130-001,2014,5,26,5,168,132,300,229
0130-001,2014,5,26,6,448,317,765,300
0130-001,2014,5,26,7,1623,896,2519,765
0130-001,2014,5,26,8,2102,1757,3859,2519
0130-001,2014,5,26,9,2237,1990,4227,3859
0130-001,2014,5,26,10,1790,1722,3512,4227
0130-001,2014,5,26,11,1784,1730,3514,3512
0130-001,2014,5,26,12,1725,1694,3419,3514
0130-001,2014,5,26,13,1490,1550,3040,3419
0130-001,2014,5,26,14,1781,1626,3407,3040
0130-001,2014,5,26,15,1865,1654,3519,3407
0130-001,2014,5,26,16,1869,1672,3541,3519
0130-001,2014,5,26,17,1692,1700,3392,3541
0130-001,2014,5,26,18,1795,1974,3769,3392
0130-001,2014,5,26,19,1826,2315,4141,3769
0130-001,2014,5,26,20,1504,1801,3305,4141
0130-001,2014,5,26,21,1290,1609,2899,3305
0130-001,2014,5,26,22,1206,1260,2466,2899
0130-001,2014,5,26,23,871,808,1679,2466
0130-001,2014,5,26,24,585,405,990,1679
0130-001,2014,5,27,1,378,283,661,990
0130-001,2014,5,27,2,257,172,429,661
0130-001,2014,5,27,3,189,110,299,429
0130-001,2014,5,27,4,132,122,254,299
0130-001,2014,5,27,5,187,172,359,254
0130-001,2014,5,27,6,458,433,891,359
0130-001,2014,5,27,7,1575,826,2401,891
0130-001,2014,5,27,8,2081,1727,3808,2401
0130-001,2014,5,27,9,2217,1925,4142,3808
0130-001,2014,5,27,10,1943,1772,3715,4142
0130-001,2014,5,27,11,1764,1685,3449,3715
0130-001,2014,5,27,12,1604,1620,3224,3449
0130-001,2014,5,27,13,1524,1494,3018,3224
0130-001,2014,5,27,14,1708,1684,3392,3018
0130-001,2014,5,27,15,1925,1871,3796,3392
0130-001,2014,5,27,16,1793,1818,3611,3796
0130-001,2014,5,27,17,1816,1927,3743,3611
0130-001,2014,5,27,18,1832,2317,4149,3743
0130-001,2014,5,27,19,1830,2480,4310,4149
0130-001,2014,5,27,20,1514,1827,3341,4310
0130-001,2014,5,27,21,1240,1799,3039,3341
0130-001,2014,5,27,22,1196,1670,2866,3039
0130-001,2014,5,27,23,900,857,1757,2866
0130-001,2014,5,27,24,607,539,1146,1757
0130-001,2014,5,28,1,353,351,704,1146
0130-001,2014,5,28,2,258,259,517,704
0130-001,2014,5,28,3,184,199,383,517
0130-001,2014,5,28,4,174,176,350,383
0130-001,2014,5,28,5,194,222,416,350
0130-001,2014,5,28,6,467,462,929,416
0130-001,2014,5,28,7,1516,803,2319,929
0130-001,2014,5,28,8,2061,1738,3799,2319
0130-001,2014,5,28,9,2210,2029,4239,3799
0130-001,2014,5,28,10,1937,1753,3690,4239
0130-001,2014,5,28,11,1684,1797,3481,3690
0130-001,2014,5,28,12,1803,1610,3413,3481
0130-001,2014,5,28,13,1436,1479,2915,3413
0130-001,2014,5,28,14,1779,1689,3468,2915
0130-001,2014,5,28,15,1803,1864,3667,3468
0130-001,2014,5,28,16,1732,1786,3518,3667
0130-001,2014,5,28,17,1764,1888,3652,3518
0130-001,2014,5,28,18,1842,2298,4140,3652
0130-001,2014,5,28,19,1895,2629,4524,4140
0130-001,2014,5,28,20,1532,2052,3584,4524
0130-001,2014,5,28,21,1307,1582,2889,3584
0130-001,2014,5,28,22,1156,1349,2505,2889
0130-001,2014,5,28,23,931,882,1813,2505
0130-001,2014,5,28,24,616,554,1170,1813
0130-001,2014,5,29,1,394,378,772,1170
0130-001,2014,5,29,2,277,236,513,772
0130-001,2014,5,29,3,180,170,350,513
0130-001,2014,5,29,4,159,175,334,350
0130-001,2014,5,29,5,184,234,418,334
0130-001,2014,5,29,6,470,449,919,418
0130-001,2014,5,29,7,1542,825,2367,919
0130-001,2014,5,29,8,2094,1700,3794,2367
0130-001,2014,5,29,9,2192,2036,4228,3794
0130-001,2014,5,29,10,1924,1767,3691,4228
0130-001,2014,5,29,11,1922,1865,3787,3691
0130-001,2014,5,29,12,1758,1656,3414,3787
0130-001,2014,5,29,13,1494,1556,3050,3414
0130-001,2014,5,29,14,1740,1653,3393,3050
0130-001,2014,5,29,15,1827,1721,3548,3393
0130-001,2014,5,29,16,1815,1892,3707,3548
0130-001,2014,5,29,17,1719,1884,3603,3707
0130-001,2014,5,29,18,1826,2264,4090,3603
0130-001,2014,5,29,19,1829,2564,4393,4090
0130-001,2014,5,29,20,1486,2069,3555,4393
0130-001,2014,5,29,21,1344,1823,3167,3555
0130-001,2014,5,29,22,1272,1419,2691,3167
0130-001,2014,5,29,23,1001,915,1916,2691
0130-001,2014,5,29,24,712,572,1284,1916
0130-001,2014,5,30,1,447,378,825,1284
0130-001,2014,5,30,2,271,249,520,825
0130-001,2014,5,30,3,193,217,410,520
0130-001,2014,5,30,4,169,191,360,410
0130-001,2014,5,30,5,226,253,479,360
0130-001,2014,5,30,6,519,473,992,479
0130-001,2014,5,30,7,1533,765,2298,992
0130-001,2014,5,30,8,2111,1726,3837,2298
0130-001,2014,5,30,9,2176,2025,4201,3837
0130-001,2014,5,30,10,1763,1789,3552,4201
0130-001,2014,5,30,11,1839,1820,3659,3552
0130-001,2014,5,30,12,1668,1680,3348,3659
0130-001,2014,5,30,13,1451,1649,3100,3348
0130-001,2014,5,30,14,1753,1767,3520,3100
0130-001,2014,5,30,15,1874,1867,3741,3520
0130-001,2014,5,30,16,1869,1918,3787,3741
0130-001,2014,5,30,17,1839,1957,3796,3787
0130-001,2014,5,30,18,1989,2365,4354,3796
0130-001,2014,5,30,19,1931,2572,4503,4354
0130-001,2014,5,30,20,1742,2203,3945,4503
0130-001,2014,5,30,21,1451,1877,3328,3945
0130-001,2014,5,30,22,1277,1465,2742,3328
0130-001,2014,5,30,23,1105,978,2083,2742
0130-001,2014,5,30,24,697,652,1349,2083
0130-001,2014,5,31,1,565,460,1025,1349
0130-001,2014,5,31,2,411,377,788,1025
0130-001,2014,5,31,3,285,257,542,788
0130-001,2014,5,31,4,206,232,438,542
0130-001,2014,5,31,5,314,312,626,438
0130-001,2014,5,31,6,504,490,994,626
0130-001,2014,5,31,7,1085,666,1751,994
0130-001,2014,5,31,8,1571,1129,2700,1751
0130-001,2014,5,31,9,1681,1725,3406,2700
0130-001,2014,5,31,10,1685,1948,3633,3406
0130-001,2014,5,31,11,1686,2020,3706,3633
0130-001,2014,5,31,12,1723,1990,3713,3706
0130-001,2014,5,31,13,1799,2039,3838,3713
0130-001,2014,5,31,14,1857,1829,3686,3838
0130-001,2014,5,31,15,1898,1785,3683,3686
0130-001,2014,5,31,16,1891,1830,3721,3683
0130-001,2014,5,31,17,1869,1869,3738,3721
0130-001,2014,5,31,18,1931,2136,4067,3738
0130-001,2014,5,31,19,1950,1991,3941,4067
0130-001,2014,5,31,20,1570,1511,3081,3941
0130-001,2014,5,31,21,1309,1329,2638,3081
0130-001,2014,5,31,22,1228,1019,2247,2638
0130-001,2014,5,31,23,984,798,1782,2247
0130-001,2014,5,31,24,611,539,1150,1782
0130-001,2014,6,1,1,450,365,815,1150
0130-001,2014,6,1,2,316,289,605,815
0130-001,2014,6,1,3,256,204,460,605
0130-001,2014,6,1,4,207,167,374,460
0130-001,2014,6,1,5,249,185,434,374
0130-001,2014,6,1,6,382,361,743,434
0130-001,2014,6,1,7,624,487,1111,743
0130-001,2014,6,1,8,752,666,1418,1111
0130-001,2014,6,1,9,986,916,1902,1418
0130-001,2014,6,1,10,1065,1151,2216,1902
0130-001,2014,6,1,11,1188,1362,2550,2216
0130-001,2014,6,1,12,1263,1485,2748,2550
0130-001,2014,6,1,13,1331,1546,2877,2748
0130-001,2014,6,1,14,1480,1536,3016,2877
0130-001,2014,6,1,15,1565,1654,3219,3016
0130-001,2014,6,1,16,1755,1693,3448,3219
0130-001,2014,6,1,17,1797,1589,3386,3448
0130-001,2014,6,1,18,1876,1635,3511,3386
0130-001,2014,6,1,19,1790,1469,3259,3511
0130-001,2014,6,1,20,1383,1233,2616,3259
0130-001,2014,6,1,21,1288,1157,2445,2616
0130-001,2014,6,1,22,1203,867,2070,2445
0130-001,2014,6,1,23,730,564,1294,2070
0130-001,2014,6,1,24,487,369,856,1294
0130-001,2014,6,2,1,300,250,550,856
0130-001,2014,6,2,2,204,180,384,550
0130-001,2014,6,2,3,127,117,244,384
0130-001,2014,6,2,4,131,168,299,244
0130-001,2014,6,2,5,200,207,407,299
0130-001,2014,6,2,6,525,409,934,407
0130-001,2014,6,2,7,1646,917,2563,934
0130-001,2014,6,2,8,2099,1813,3912,2563
0130-001,2014,6,2,9,2080,1997,4077,3912
0130-001,2014,6,2,10,1884,1678,3562,4077
0130-001,2014,6,2,11,1812,1778,3590,3562
0130-001,2014,6,2,12,1677,1732,3409,3590
0130-001,2014,6,2,13,1490,1561,3051,3409
0130-001,2014,6,2,14,1746,1500,3246,3051
0130-001,2014,6,2,15,1872,1486,3358,3246
0130-001,2014,6,2,16,1841,1446,3287,3358
0130-001,2014,6,2,17,1788,1504,3292,3287
0130-001,2014,6,2,18,1760,1658,3418,3292
0130-001,2014,6,2,19,1805,1992,3797,3418
0130-001,2014,6,2,20,1423,1510,2933,3797
0130-001,2014,6,2,21,1160,1413,2573,2933
0130-001,2014,6,2,22,1145,1050,2195,2573
0130-001,2014,6,2,23,880,560,1440,2195
0130-001,2014,6,2,24,547,352,899,1440
0130-001,2014,6,3,1,376,266,642,899
0130-001,2014,6,3,2,238,172,410,642
0130-001,2014,6,3,3,173,118,291,410
0130-001,2014,6,3,4,135,123,258,291
0130-001,2014,6,3,5,186,150,336,258
0130-001,2014,6,3,6,348,272,620,336
0130-001,2014,6,3,7,1247,652,1899,620
0130-001,2014,6,3,8,1977,1372,3349,1899
0130-001,2014,6,3,9,2098,1734,3832,3349
0130-001,2014,6,3,10,1772,1554,3326,3832
0130-001,2014,6,3,11,1656,1512,3168,3326
0130-001,2014,6,3,12,1687,1400,3087,3168
0130-001,2014,6,3,13,1465,1331,2796,3087
0130-001,2014,6,3,14,1814,1751,3565,2796
0130-001,2014,6,3,15,1850,1775,3625,3565
0130-001,2014,6,3,16,1741,1531,3272,3625
0130-001,2014,6,3,17,1735,1687,3422,3272
0130-001,2014,6,3,18,1858,1880,3738,3422
0130-001,2014,6,3,19,1824,2049,3873,3738
0130-001,2014,6,3,20,1426,1580,3006,3873
0130-001,2014,6,3,21,1317,1416,2733,3006
0130-001,2014,6,3,22,1250,1139,2389,2733
0130-001,2014,6,3,23,962,682,1644,2389
0130-001,2014,6,3,24,699,473,1172,1644
0130-001,2014,6,4,1,486,328,814,1172
0130-001,2014,6,4,2,371,210,581,814
0130-001,2014,6,4,3,238,169,407,581
0130-001,2014,6,4,4,228,156,384,407
0130-001,2014,6,4,5,290,203,493,384
0130-001,2014,6,4,6,423,306,729,493
0130-001,2014,6,4,7,990,726,1716,729
0130-001,2014,6,4,8,1606,1604,3210,1716
0130-001,2014,6,4,9,1674,1854,3528,3210
0130-001,2014,6,4,10,1771,1630,3401,3528
0130-001,2014,6,4,11,1695,1642,3337,3401
0130-001,2014,6,4,12,1652,1480,3132,3337
0130-001,2014,6,4,13,1462,1383,2845,3132
0130-001,2014,6,4,14,1688,1522,3210,2845
0130-001,2014,6,4,15,1668,1680,3348,3210
0130-001,2014,6,4,16,1671,1658,3329,3348
0130-001,2014,6,4,17,1773,1768,3541,3329
0130-001,2014,6,4,18,1802,2181,3983,3541
0130-001,2014,6,4,19,1696,1568,3264,3983
0130-001,2014,6,4,20,1381,1309,2690,3264
0130-001,2014,6,4,21,1213,1026,2239,2690
0130-001,2014,6,4,22,1090,803,1893,2239
0130-001,2014,6,4,23,873,515,1388,1893
0130-001,2014,6,4,24,538,357,895,1388
0130-001,2014,6,5,1,381,227,608,895
0130-001,2014,6,5,2,223,122,345,608
0130-001,2014,6,5,3,187,107,294,345
0130-001,2014,6,5,4,178,175,353,294
0130-001,2014,6,5,5,243,211,454,353
0130-001,2014,6,5,6,501,389,890,454
0130-001,2014,6,5,7,1498,794,2292,890
0130-001,2014,6,5,8,2043,1608,3651,2292
0130-001,2014,6,5,9,2108,1883,3991,3651
0130-001,2014,6,5,10,1905,1728,3633,3991
0130-001,2014,6,5,11,1800,1550,3350,3633
0130-001,2014,6,5,12,1803,1405,3208,3350
0130-001,2014,6,5,13,1558,1298,2856,3208
0130-001,2014,6,5,14,1808,1419,3227,2856
0130-001,2014,6,5,15,1908,1586,3494,3227
0130-001,2014,6,5,16,1893,1565,3458,3494
0130-001,2014,6,5,17,1936,1640,3576,3458
0130-001,2014,6,5,18,1946,1929,3875,3576
0130-001,2014,6,5,19,2007,2434,4441,3875
0130-001,2014,6,5,20,1557,2029,3586,4441
0130-001,2014,6,5,21,1223,1678,2901,3586
0130-001,2014,6,5,22,1249,1420,2669,2901
0130-001,2014,6,5,23,1015,826,1841,2669
0130-001,2014,6,5,24,698,486,1184,1841
0130-001,2014,6,6,1,500,348,848,1184
0130-001,2014,6,6,2,326,253,579,848
0130-001,2014,6,6,3,250,206,456,579
0130-001,2014,6,6,4,215,207,422,456
0130-001,2014,6,6,5,254,242,496,422
0130-001,2014,6,6,6,485,453,938,496
0130-001,2014,6,6,7,1038,747,1785,938
0130-001,2014,6,6,8,1585,1102,2687,1785
0130-001,2014,6,6,9,1493,1488,2981,2687
0130-001,2014,6,6,10,1489,1748,3237,2981
0130-001,2014,6,6,11,1475,1755,3230,3237
0130-001,2014,6,6,12,1533,1871,3404,3230
0130-001,2014,6,6,13,1359,1920,3279,3404
0130-001,2014,6,6,14,1415,2201,3616,3279
0130-001,2014,6,6,15,1503,2195,3698,3616
0130-001,2014,6,6,16,1490,2141,3631,3698
0130-001,2014,6,6,17,1621,2129,3750,3631
0130-001,2014,6,6,18,1873,2202,4075,3750
0130-001,2014,6,6,19,1722,1858,3580,4075
0130-001,2014,6,6,20,1592,1440,3032,3580
0130-001,2014,6,6,21,1192,1299,2491,3032
0130-001,2014,6,6,22,1145,1042,2187,2491
0130-001,2014,6,6,23,890,680,1570,2187
0130-001,2014,6,6,24,561,503,1064,1570
0130-001,2014,6,7,1,362,325,687,1064
0130-001,2014,6,7,2,291,264,555,687
0130-001,2014,6,7,3,208,203,411,555
0130-001,2014,6,7,4,186,185,371,411
0130-001,2014,6,7,5,193,257,450,371
0130-001,2014,6,7,6,476,387,863,450
0130-001,2014,6,7,7,902,604,1506,863
0130-001,2014,6,7,8,1260,967,2227,1506
0130-001,2014,6,7,9,1336,1472,2808,2227
0130-001,2014,6,7,10,1524,1650,3174,2808
0130-001,2014,6,7,11,1492,1742,3234,3174
0130-001,2014,6,7,12,1519,1661,3180,3234
0130-001,2014,6,7,13,1552,1654,3206,3180
0130-001,2014,6,7,14,1670,1734,3404,3206
0130-001,2014,6,7,15,1685,1705,3390,3404
0130-001,2014,6,7,16,1886,1737,3623,3390
0130-001,2014,6,7,17,1953,1676,3629,3623
0130-001,2014,6,7,18,1931,1825,3756,3629
0130-001,2014,6,7,19,2003,1733,3736,3756
0130-001,2014,6,7,20,1799,1412,3211,3736
0130-001,2014,6,7,21,1653,1222,2875,3211
0130-001,2014,6,7,22,1433,1035,2468,2875
0130-001,2014,6,7,23,1054,697,1751,2468
0130-001,2014,6,7,24,604,508,1112,1751
0130-001,2014,6,8,1,425,403,828,1112
0130-001,2014,6,8,2,317,262,579,828
0130-001,2014,6,8,3,218,174,392,579
0130-001,2014,6,8,4,169,157,326,392
0130-001,2014,6,8,5,189,178,367,326
0130-001,2014,6,8,6,358,308,666,367
0130-001,2014,6,8,7,682,432,1114,666
0130-001,2014,6,8,8,702,573,1275,1114
0130-001,2014,6,8,9,839,827,1666,1275
0130-001,2014,6,8,10,945,1041,1986,1666
0130-001,2014,6,8,11,1183,1247,2430,1986
0130-001,2014,6,8,12,1426,1230,2656,2430
0130-001,2014,6,8,13,1566,1331,2897,2656
0130-001,2014,6,8,14,1772,1482,3254,2897
0130-001,2014,6,8,15,1901,1469,3370,3254
0130-001,2014,6,8,16,1891,1528,3419,3370
0130-001,2014,6,8,17,1857,1548,3405,3419
0130-001,2014,6,8,18,1905,1558,3463,3405
0130-001,2014,6,8,19,1903,1409,3312,3463
0130-001,2014,6,8,20,1501,1225,2726,3312
0130-001,2014,6,8,21,1232,1041,2273,2726
0130-001,2014,6,8,22,1014,867,1881,2273
0130-001,2014,6,8,23,678,577,1255,1881
0130-001,2014,6,8,24,473,397,870,1255
0130-001,2014,6,9,1,305,257,562,870
0130-001,2014,6,9,2,195,165,360,562
0130-001,2014,6,9,3,129,123,252,360
0130-001,2014,6,9,4,136,176,312,252
0130-001,2014,6,9,5,197,204,401,312
0130-001,2014,6,9,6,540,457,997,401
0130-001,2014,6,9,7,1658,895,2553,997
0130-001,2014,6,9,8,2133,1797,3930,2553
0130-001,2014,6,9,9,2056,2013,4069,3930
0130-001,2014,6,9,10,1835,1675,3510,4069
0130-001,2014,6,9,11,1813,1796,3609,3510
0130-001,2014,6,9,12,1709,1691,3400,3609
0130-001,2014,6,9,13,1510,1585,3095,3400
0130-001,2014,6,9,14,1773,1623,3396,3095
0130-001,2014,6,9,15,1849,1659,3508,3396
0130-001,2014,6,9,16,1801,1672,3473,3508
0130-001,2014,6,9,17,1798,1726,3524,3473
0130-001,2014,6,9,18,1801,1985,3786,3524
0130-001,2014,6,9,19,1819,2255,4074,3786
0130-001,2014,6,9,20,1435,1688,3123,4074
0130-001,2014,6,9,21,1183,1577,2760,3123
0130-001,2014,6,9,22,1175,1179,2354,2760
0130-001,2014,6,9,23,874,676,1550,2354
0130-001,2014,6,9,24,561,446,1007,1550
0130-001,2014,6,10,1,347,385,732,1007
0130-001,2014,6,10,2,235,246,481,732
0130-001,2014,6,10,3,197,182,379,481
0130-001,2014,6,10,4,125,193,318,379
0130-001,2014,6,10,5,219,208,427,318
0130-001,2014,6,10,6,504,444,948,427
0130-001,2014,6,10,7,1536,813,2349,948
0130-001,2014,6,10,8,2140,1768,3908,2349
0130-001,2014,6,10,9,2134,2067,4201,3908
0130-001,2014,6,10,10,2077,1747,3824,4201
0130-001,2014,6,10,11,1822,1798,3620,3824
0130-001,2014,6,10,12,1732,1693,3425,3620
0130-001,2014,6,10,13,1548,1523,3071,3425
0130-001,2014,6,10,14,1741,1775,3516,3071
0130-001,2014,6,10,15,1887,1845,3732,3516
0130-001,2014,6,10,16,1895,1825,3720,3732
0130-001,2014,6,10,17,1653,1837,3490,3720
0130-001,2014,6,10,18,1833,2267,4100,3490
0130-001,2014,6,10,19,1713,2376,4089,4100
0130-001,2014,6,10,20,1437,1654,3091,4089
0130-001,2014,6,10,21,1307,1374,2681,3091
0130-001,2014,6,10,22,1114,1070,2184,2681
0130-001,2014,6,10,23,944,681,1625,2184
0130-001,2014,6,10,24,609,375,984,1625
0130-001,2014,6,11,1,386,258,644,984
0130-001,2014,6,11,2,254,171,425,644
0130-001,2014,6,11,3,200,133,333,425
0130-001,2014,6,11,4,159,132,291,333
0130-001,2014,6,11,5,213,153,366,291
0130-001,2014,6,11,6,477,307,784,366
0130-001,2014,6,11,7,1407,849,2256,784
0130-001,2014,6,11,8,2153,1618,3771,2256
0130-001,2014,6,11,9,2153,1849,4002,3771
0130-001,2014,6,11,10,1858,1687,3545,4002
0130-001,2014,6,11,11,1818,1726,3544,3545
0130-001,2014,6,11,12,1696,1540,3236,3544
0130-001,2014,6,11,13,1479,1446,2925,3236
0130-001,2014,6,11,14,1732,1586,3318,2925
0130-001,2014,6,11,15,1843,1708,3551,3318
0130-001,2014,6,11,16,1844,1750,3594,3551
0130-001,2014,6,11,17,1844,1806,3650,3594
0130-001,2014,6,11,18,1831,2064,3895,3650
0130-001,2014,6,11,19,1872,2214,4086,3895
0130-001,2014,6,11,20,1516,1895,3411,4086
0130-001,2014,6,11,21,1342,1409,2751,3411
0130-001,2014,6,11,22,1244,1130,2374,2751
0130-001,2014,6,11,23,984,641,1625,2374
0130-001,2014,6,11,24,610,434,1044,1625
0130-001,2014,6,12,1,394,278,672,1044
0130-001,2014,6,12,2,259,185,444,672
0130-001,2014,6,12,3,190,126,316,444
0130-001,2014,6,12,4,179,151,330,316
0130-001,2014,6,12,5,225,168,393,330
0130-001,2014,6,12,6,489,450,939,393
0130-001,2014,6,12,7,1515,806,2321,939
0130-001,2014,6,12,8,2169,1711,3880,2321
0130-001,2014,6,12,9,2194,2036,4230,3880
0130-001,2014,6,12,10,1909,1707,3616,4230
0130-001,2014,6,12,11,1782,1781,3563,3616
0130-001,2014,6,12,12,1615,1682,3297,3563
0130-001,2014,6,12,13,1532,1519,3051,3297
0130-001,2014,6,12,14,1761,1654,3415,3051
0130-001,2014,6,12,15,1752,1605,3357,3415
0130-001,2014,6,12,16,1727,1756,3483,3357
0130-001,2014,6,12,17,1790,2077,3867,3483
0130-001,2014,6,12,18,1875,2448,4323,3867
0130-001,2014,6,12,19,1924,2465,4389,4323
0130-001,2014,6,12,20,1497,1754,3251,4389
0130-001,2014,6,12,21,1319,1531,2850,3251
0130-001,2014,6,12,22,1217,1116,2333,2850
0130-001,2014,6,12,23,1062,691,1753,2333
0130-001,2014,6,12,24,661,420,1081,1753
0130-001,2014,6,13,1,442,289,731,1081
0130-001,2014,6,13,2,278,179,457,731
0130-001,2014,6,13,3,167,149,316,457
0130-001,2014,6,13,4,173,135,308,316
0130-001,2014,6,13,5,193,178,371,308
0130-001,2014,6,13,6,500,384,884,371
0130-001,2014,6,13,7,1433,677,2110,884
0130-001,2014,6,13,8,2072,1739,3811,2110
0130-001,2014,6,13,9,2172,1967,4139,3811
0130-001,2014,6,13,10,1911,1732,3643,4139
0130-001,2014,6,13,11,1857,1685,3542,3643
0130-001,2014,6,13,12,1761,1622,3383,3542
0130-001,2014,6,13,13,1612,1609,3221,3383
0130-001,2014,6,13,14,1779,1487,3266,3221
0130-001,2014,6,13,15,1842,1835,3677,3266
0130-001,2014,6,13,16,1859,1885,3744,3677
0130-001,2014,6,13,17,1875,2021,3896,3744
0130-001,2014,6,13,18,2026,2312,4338,3896
0130-001,2014,6,13,19,2013,2426,4439,4338
0130-001,2014,6,13,20,1726,2036,3762,4439
0130-001,2014,6,13,21,1392,1607,2999,3762
0130-001,2014,6,13,22,1389,1162,2551,2999
0130-001,2014,6,13,23,1124,709,1833,2551
0130-001,2014,6,13,24,777,516,1293,1833
0130-001,2014,6,14,1,555,309,864,1293
0130-001,2014,6,14,2,376,207,583,864
0130-001,2014,6,14,3,275,197,472,583
0130-001,2014,6,14,4,216,175,391,472
0130-001,2014,6,14,5,279,220,499,391
0130-001,2014,6,14,6,525,422,947,499
0130-001,2014,6,14,7,1090,612,1702,947
0130-001,2014,6,14,8,1578,1133,2711,1702
0130-001,2014,6,14,9,1704,1748,3452,2711
0130-001,2014,6,14,10,1719,1783,3502,3452
0130-001,2014,6,14,11,1715,1818,3533,3502
0130-001,2014,6,14,12,1677,2002,3679,3533
0130-001,2014,6,14,13,1595,2083,3678,3679
0130-001,2014,6,14,14,1748,1902,3650,3678
0130-001,2014,6,14,15,1824,1904,3728,3650
0130-001,2014,6,14,16,1845,1831,3676,3728
0130-001,2014,6,14,17,1873,1875,3748,3676
0130-001,2014,6,14,18,2078,2173,4251,3748
0130-001,2014,6,14,19,1937,2147,4084,4251
0130-001,2014,6,14,20,1539,1617,3156,4084
0130-001,2014,6,14,21,1360,1359,2719,3156
0130-001,2014,6,14,22,1293,1145,2438,2719
0130-001,2014,6,14,23,997,809,1806,2438
0130-001,2014,6,14,24,639,517,1156,1806
0130-001,2014,6,15,1,444,389,833,1156
0130-001,2014,6,15,2,324,274,598,833
0130-001,2014,6,15,3,247,191,438,598
0130-001,2014,6,15,4,202,152,354,438
0130-001,2014,6,15,5,224,167,391,354
0130-001,2014,6,15,6,359,301,660,391
0130-001,2014,6,15,7,600,464,1064,660
0130-001,2014,6,15,8,801,642,1443,1064
0130-001,2014,6,15,9,945,952,1897,1443
0130-001,2014,6,15,10,1036,1114,2150,1897
0130-001,2014,6,15,11,1097,1352,2449,2150
0130-001,2014,6,15,12,1014,1282,2296,2449
0130-001,2014,6,15,13,1329,1426,2755,2296
0130-001,2014,6,15,14,1379,1537,2916,2755
0130-001,2014,6,15,15,1501,1575,3076,2916
0130-001,2014,6,15,16,1608,1567,3175,3076
0130-001,2014,6,15,17,1697,1581,3278,3175
0130-001,2014,6,15,18,1887,1591,3478,3278
0130-001,2014,6,15,19,1793,1459,3252,3478
0130-001,2014,6,15,20,1442,1287,2729,3252
0130-001,2014,6,15,21,1295,1226,2521,2729
0130-001,2014,6,15,22,1096,934,2030,2521
0130-001,2014,6,15,23,784,626,1410,2030
0130-001,2014,6,15,24,516,413,929,1410
0130-001,2014,6,16,1,309,263,572,929
0130-001,2014,6,16,2,186,150,336,572
0130-001,2014,6,16,3,130,129,259,336
0130-001,2014,6,16,4,141,184,325,259
0130-001,2014,6,16,5,193,200,393,325
0130-001,2014,6,16,6,554,504,1058,393
0130-001,2014,6,16,7,1670,872,2542,1058
0130-001,2014,6,16,8,2166,1781,3947,2542
0130-001,2014,6,16,9,2031,2029,4060,3947
0130-001,2014,6,16,10,1785,1672,3457,4060
0130-001,2014,6,16,11,1813,1814,3627,3457
0130-001,2014,6,16,12,1740,1649,3389,3627
0130-001,2014,6,16,13,1530,1609,3139,3389
0130-001,2014,6,16,14,1800,1745,3545,3139
0130-001,2014,6,16,15,1825,1831,3656,3545
0130-001,2014,6,16,16,1761,1898,3659,3656
0130-001,2014,6,16,17,1808,1948,3756,3659
0130-001,2014,6,16,18,1841,2311,4152,3756
0130-001,2014,6,16,19,1833,2517,4350,4152
0130-001,2014,6,16,20,1446,1865,3311,4350
0130-001,2014,6,16,21,1206,1740,2946,3311
0130-001,2014,6,16,22,1205,1308,2513,2946
0130-001,2014,6,16,23,867,791,1658,2513
0130-001,2014,6,16,24,574,540,1114,1658
0130-001,2014,6,17,1,369,389,758,1114
0130-001,2014,6,17,2,267,233,500,758
0130-001,2014,6,17,3,155,178,333,500
0130-001,2014,6,17,4,164,180,344,333
0130-001,2014,6,17,5,202,230,432,344
0130-001,2014,6,17,6,489,412,901,432
0130-001,2014,6,17,7,1461,829,2290,901
0130-001,2014,6,17,8,2082,1677,3759,2290
0130-001,2014,6,17,9,2176,2020,4196,3759
0130-001,2014,6,17,10,1996,1778,3774,4196
0130-001,2014,6,17,11,1840,1758,3598,3774
0130-001,2014,6,17,12,1606,1674,3280,3598
0130-001,2014,6,17,13,1498,1461,2959,3280
0130-001,2014,6,17,14,1778,1765,3543,2959
0130-001,2014,6,17,15,1846,1792,3638,3543
0130-001,2014,6,17,16,1778,1801,3579,3638
0130-001,2014,6,17,17,1733,1853,3586,3579
0130-001,2014,6,17,18,1887,2285,4172,3586
0130-001,2014,6,17,19,1752,2486,4238,4172
0130-001,2014,6,17,20,1445,1876,3321,4238
0130-001,2014,6,17,21,1229,1694,2923,3321
0130-001,2014,6,17,22,1203,1373,2576,2923
0130-001,2014,6,17,23,912,832,1744,2576
0130-001,2014,6,17,24,629,539,1168,1744
0130-001,2014,6,18,1,384,339,723,1168
0130-001,2014,6,18,2,240,198,438,723
0130-001,2014,6,18,3,179,172,351,438
0130-001,2014,6,18,4,134,208,342,351
0130-001,2014,6,18,5,205,239,444,342
0130-001,2014,6,18,6,484,441,925,444
0130-001,2014,6,18,7,1799,972,2771,925
0130-001,2014,6,18,8,2077,1631,3708,2771
0130-001,2014,6,18,9,1731,1844,3575,3708
0130-001,2014,6,18,10,2090,1744,3834,3575
0130-001,2014,6,18,11,1851,1811,3662,3834
0130-001,2014,6,18,12,1629,1601,3230,3662
0130-001,2014,6,18,13,1445,1510,2955,3230
0130-001,2014,6,18,14,1757,1651,3408,2955
0130-001,2014,6,18,15,1752,1735,3487,3408
0130-001,2014,6,18,16,1791,1842,3633,3487
0130-001,2014,6,18,17,1845,1843,3688,3633
0130-001,2014,6,18,18,1792,2394,4186,3688
0130-001,2014,6,18,19,1852,2563,4415,4186
0130-001,2014,6,18,20,1533,2004,3537,4415
0130-001,2014,6,18,21,1278,1694,2972,3537
0130-001,2014,6,18,22,1246,1300,2546,2972
0130-001,2014,6,18,23,936,850,1786,2546
0130-001,2014,6,18,24,662,606,1268,1786
0130-001,2014,6,19,1,407,374,781,1268
0130-001,2014,6,19,2,281,260,541,781
0130-001,2014,6,19,3,167,166,333,541
0130-001,2014,6,19,4,169,188,357,333
0130-001,2014,6,19,5,206,239,445,357
0130-001,2014,6,19,6,503,450,953,445
0130-001,2014,6,19,7,1442,803,2245,953
0130-001,2014,6,19,8,2139,1739,3878,2245
0130-001,2014,6,19,9,2084,2018,4102,3878
0130-001,2014,6,19,10,1863,1693,3556,4102
0130-001,2014,6,19,11,1758,1794,3552,3556
0130-001,2014,6,19,12,1617,1609,3226,3552
0130-001,2014,6,19,13,1482,1531,3013,3226
0130-001,2014,6,19,14,1792,1715,3507,3013
0130-001,2014,6,19,15,1879,1568,3447,3507
0130-001,2014,6,19,16,1775,1815,3590,3447
0130-001,2014,6,19,17,1750,1961,3711,3590
0130-001,2014,6,19,18,1901,2248,4149,3711
0130-001,2014,6,19,19,1758,2536,4294,4149
0130-001,2014,6,19,20,1465,1882,3347,4294
0130-001,2014,6,19,21,1298,1735,3033,3347
0130-001,2014,6,19,22,1207,1314,2521,3033
0130-001,2014,6,19,23,978,825,1803,2521
0130-001,2014,6,19,24,627,528,1155,1803
0130-001,2014,6,20,1,398,352,750,1155
0130-001,2014,6,20,2,246,264,510,750
0130-001,2014,6,20,3,216,198,414,510
0130-001,2014,6,20,4,180,234,414,414
0130-001,2014,6,20,5,208,245,453,414
0130-001,2014,6,20,6,463,437,900,453
0130-001,2014,6,20,7,1472,774,2246,900
0130-001,2014,6,20,8,2128,1677,3805,2246
0130-001,2014,6,20,9,2119,2065,4184,3805
0130-001,2014,6,20,10,1870,1711,3581,4184
0130-001,2014,6,20,11,1814,1837,3651,3581
0130-001,2014,6,20,12,1765,1681,3446,3651
0130-001,2014,6,20,13,1561,1585,3146,3446
0130-001,2014,6,20,14,1863,1791,3654,3146
0130-001,2014,6,20,15,1863,1862,3725,3654
0130-001,2014,6,20,16,1877,1992,3869,3725
0130-001,2014,6,20,17,1911,2059,3970,3869
0130-001,2014,6,20,18,1984,2412,4396,3970
0130-001,2014,6,20,19,2026,2579,4605,4396
0130-001,2014,6,20,20,1709,1793,3502,4605
0130-001,2014,6,20,21,1407,1859,3266,3502
0130-001,2014,6,20,22,1416,1354,2770,3266
0130-001,2014,6,20,23,1108,804,1912,2770
0130-001,2014,6,20,24,657,416,1073,1912
0130-001,2014,6,21,1,498,368,866,1073
0130-001,2014,6,21,2,332,260,592,866
0130-001,2014,6,21,3,297,195,492,592
0130-001,2014,6,21,4,227,155,382,492
0130-001,2014,6,21,5,233,206,439,382
0130-001,2014,6,21,6,490,436,926,439
0130-001,2014,6,21,7,1015,658,1673,926
0130-001,2014,6,21,8,1507,1157,2664,1673
0130-001,2014,6,21,9,1763,1639,3402,2664
0130-001,2014,6,21,10,1695,1790,3485,3402
0130-001,2014,6,21,11,1658,1892,3550,3485
0130-001,2014,6,21,12,1717,1945,3662,3550
0130-001,2014,6,21,13,1869,1940,3809,3662
0130-001,2014,6,21,14,1845,1849,3694,3809
0130-001,2014,6,21,15,1867,1796,3663,3694
0130-001,2014,6,21,16,1816,1810,3626,3663
0130-001,2014,6,21,17,1808,1702,3510,3626
0130-001,2014,6,21,18,2021,2202,4223,3510
0130-001,2014,6,21,19,1946,2051,3997,4223
0130-001,2014,6,21,20,1455,1567,3022,3997
0130-001,2014,6,21,21,1298,1073,2371,3022
0130-001,2014,6,21,22,1156,870,2026,2371
0130-001,2014,6,21,23,862,586,1448,2026
0130-001,2014,6,21,24,751,441,1192,1448
0130-001,2014,6,22,1,455,321,776,1192
0130-001,2014,6,22,2,325,209,534,776
0130-001,2014,6,22,3,240,177,417,534
0130-001,2014,6,22,4,218,115,333,417
0130-001,2014,6,22,5,235,150,385,333
0130-001,2014,6,22,6,339,304,643,385
0130-001,2014,6,22,7,679,435,1114,643
0130-001,2014,6,22,8,793,659,1452,1114
0130-001,2014,6,22,9,899,969,1868,1452
0130-001,2014,6,22,10,1061,1170,2231,1868
0130-001,2014,6,22,11,1200,1358,2558,2231
0130-001,2014,6,22,12,1164,1360,2524,2558
0130-001,2014,6,22,13,1307,1400,2707,2524
0130-001,2014,6,22,14,1527,1477,3004,2707
0130-001,2014,6,22,15,1500,1539,3039,3004
0130-001,2014,6,22,16,1722,1575,3297,3039
0130-001,2014,6,22,17,1886,1552,3438,3297
0130-001,2014,6,22,18,1875,1594,3469,3438
0130-001,2014,6,22,19,1920,1458,3378,3469
0130-001,2014,6,22,20,1477,1247,2724,3378
0130-001,2014,6,22,21,1259,1153,2412,2724
0130-001,2014,6,22,22,1056,922,1978,2412
0130-001,2014,6,22,23,717,603,1320,1978
0130-001,2014,6,22,24,463,397,860,1320
0130-001,2014,6,23,1,273,266,539,860
0130-001,2014,6,23,2,181,171,352,539
0130-001,2014,6,23,3,102,140,242,352
0130-001,2014,6,23,4,146,199,345,242
0130-001,2014,6,23,5,201,233,434,345
0130-001,2014,6,23,6,519,408,927,434
0130-001,2014,6,23,7,1698,877,2575,927
0130-001,2014,6,23,8,2121,1778,3899,2575
0130-001,2014,6,23,9,2069,2029,4098,3899
0130-001,2014,6,23,10,1841,1660,3501,4098
0130-001,2014,6,23,11,1742,1845,3587,3501
0130-001,2014,6,23,12,1687,1746,3433,3587
0130-001,2014,6,23,13,1484,1495,2979,3433
0130-001,2014,6,23,14,1754,1754,3508,2979
0130-001,2014,6,23,15,1842,1803,3645,3508
0130-001,2014,6,23,16,1751,1875,3626,3645
0130-001,2014,6,23,17,1790,1962,3752,3626
0130-001,2014,6,23,18,1928,2332,4260,3752
0130-001,2014,6,23,19,1849,2472,4321,4260
0130-001,2014,6,23,20,1463,1879,3342,4321
0130-001,2014,6,23,21,1287,1753,3040,3342
0130-001,2014,6,23,22,1217,1447,2664,3040
0130-001,2014,6,23,23,873,813,1686,2664
0130-001,2014,6,23,24,547,460,1007,1686
0130-001,2014,6,24,1,376,355,731,1007
0130-001,2014,6,24,2,244,247,491,731
0130-001,2014,6,24,3,168,195,363,491
0130-001,2014,6,24,4,131,166,297,363
0130-001,2014,6,24,5,212,220,432,297
0130-001,2014,6,24,6,520,420,940,432
0130-001,2014,6,24,7,1480,784,2264,940
0130-001,2014,6,24,8,2173,1716,3889,2264
0130-001,2014,6,24,9,2187,2029,4216,3889
0130-001,2014,6,24,10,1877,1772,3649,4216
0130-001,2014,6,24,11,1806,1883,3689,3649
0130-001,2014,6,24,12,1649,1686,3335,3689
0130-001,2014,6,24,13,1549,1498,3047,3335
0130-001,2014,6,24,14,1809,1658,3467,3047
0130-001,2014,6,24,15,1885,1847,3732,3467
0130-001,2014,6,24,16,1849,1863,3712,3732
0130-001,2014,6,24,17,1698,1911,3609,3712
0130-001,2014,6,24,18,1894,2359,4253,3609
0130-001,2014,6,24,19,1908,2480,4388,4253
0130-001,2014,6,24,20,1408,1886,3294,4388
0130-001,2014,6,24,21,1315,1729,3044,3294
0130-001,2014,6,24,22,1285,1483,2768,3044
0130-001,2014,6,24,23,930,848,1778,2768
0130-001,2014,6,24,24,620,540,1160,1778
0130-001,2014,6,25,1,364,351,715,1160
0130-001,2014,6,25,2,263,249,512,715
0130-001,2014,6,25,3,183,186,369,512
0130-001,2014,6,25,4,173,197,370,369
0130-001,2014,6,25,5,216,229,445,370
0130-001,2014,6,25,6,452,434,886,445
0130-001,2014,6,25,7,1434,727,2161,886
0130-001,2014,6,25,8,2150,1713,3863,2161
0130-001,2014,6,25,9,2099,2037,4136,3863
0130-001,2014,6,25,10,1898,1612,3510,4136
0130-001,2014,6,25,11,1805,1787,3592,3510
0130-001,2014,6,25,12,1636,1680,3316,3592
0130-001,2014,6,25,13,1551,1553,3104,3316
0130-001,2014,6,25,14,1681,1771,3452,3104
0130-001,2014,6,25,15,1827,1807,3634,3452
0130-001,2014,6,25,16,1805,1894,3699,3634
0130-001,2014,6,25,17,1763,1920,3683,3699
0130-001,2014,6,25,18,1822,2394,4216,3683
0130-001,2014,6,25,19,1821,2605,4426,4216
0130-001,2014,6,25,20,1469,1972,3441,4426
0130-001,2014,6,25,21,1295,1634,2929,3441
0130-001,2014,6,25,22,1333,1287,2620,2929
0130-001,2014,6,25,23,1019,856,1875,2620
0130-001,2014,6,25,24,638,534,1172,1875
0130-001,2014,6,26,1,423,356,779,1172
0130-001,2014,6,26,2,284,255,539,779
0130-001,2014,6,26,3,219,228,447,539
0130-001,2014,6,26,4,170,222,392,447
0130-001,2014,6,26,5,219,234,453,392
0130-001,2014,6,26,6,507,422,929,453
0130-001,2014,6,26,7,1496,773,2269,929
0130-001,2014,6,26,8,2165,1764,3929,2269
0130-001,2014,6,26,9,2109,2064,4173,3929
0130-001,2014,6,26,10,1839,1664,3503,4173
0130-001,2014,6,26,11,1842,1822,3664,3503
0130-001,2014,6,26,12,1623,1681,3304,3664
0130-001,2014,6,26,13,1547,1544,3091,3304
0130-001,2014,6,26,14,1731,1713,3444,3091
0130-001,2014,6,26,15,1871,1817,3688,3444
0130-001,2014,6,26,16,1737,1779,3516,3688
0130-001,2014,6,26,17,1819,2013,3832,3516
0130-001,2014,6,26,18,1893,2277,4170,3832
0130-001,2014,6,26,19,1775,2497,4272,4170
0130-001,2014,6,26,20,1450,1816,3266,4272
0130-001,2014,6,26,21,1239,1753,2992,3266
0130-001,2014,6,26,22,1276,1435,2711,2992
0130-001,2014,6,26,23,1026,889,1915,2711
0130-001,2014,6,26,24,643,547,1190,1915
0130-001,2014,6,27,1,425,358,783,1190
0130-001,2014,6,27,2,255,255,510,783
0130-001,2014,6,27,3,213,194,407,510
0130-001,2014,6,27,4,179,220,399,407
0130-001,2014,6,27,5,253,246,499,399
0130-001,2014,6,27,6,496,453,949,499
0130-001,2014,6,27,7,1429,771,2200,949
0130-001,2014,6,27,8,2104,1741,3845,2200
0130-001,2014,6,27,9,2138,2018,4156,3845
0130-001,2014,6,27,10,1779,1653,3432,4156
0130-001,2014,6,27,11,1835,1864,3699,3432
0130-001,2014,6,27,12,1694,1773,3467,3699
0130-001,2014,6,27,13,1539,1674,3213,3467
0130-001,2014,6,27,14,1816,1700,3516,3213
0130-001,2014,6,27,15,1833,1799,3632,3516
0130-001,2014,6,27,16,1825,1933,3758,3632
0130-001,2014,6,27,17,1870,2041,3911,3758
0130-001,2014,6,27,18,1956,2353,4309,3911
0130-001,2014,6,27,19,1977,2623,4600,4309
0130-001,2014,6,27,20,1741,2279,4020,4600
0130-001,2014,6,27,21,1437,1847,3284,4020
0130-001,2014,6,27,22,1366,1430,2796,3284
0130-001,2014,6,27,23,1127,931,2058,2796
0130-001,2014,6,27,24,750,618,1368,2058
0130-001,2014,6,28,1,548,446,994,1368
0130-001,2014,6,28,2,363,342,705,994
0130-001,2014,6,28,3,273,240,513,705
0130-001,2014,6,28,4,275,245,520,513
0130-001,2014,6,28,5,240,295,535,520
0130-001,2014,6,28,6,530,424,954,535
0130-001,2014,6,28,7,1025,696,1721,954
0130-001,2014,6,28,8,1502,1098,2600,1721
0130-001,2014,6,28,9,1623,1660,3283,2600
0130-001,2014,6,28,10,1756,1894,3650,3283
0130-001,2014,6,28,11,1665,1857,3522,3650
0130-001,2014,6,28,12,1773,1897,3670,3522
0130-001,2014,6,28,13,1722,1875,3597,3670
0130-001,2014,6,28,14,1748,1995,3743,3597
0130-001,2014,6,28,15,1693,2072,3765,3743
0130-001,2014,6,28,16,1804,1888,3692,3765
0130-001,2014,6,28,17,1860,1905,3765,3692
0130-001,2014,6,28,18,1996,2182,4178,3765
0130-001,2014,6,28,19,1973,1982,3955,4178
0130-001,2014,6,28,20,1574,1559,3133,3955
0130-001,2014,6,28,21,1310,1317,2627,3133
0130-001,2014,6,28,22,1300,1088,2388,2627
0130-001,2014,6,28,23,940,730,1670,2388
0130-001,2014,6,28,24,610,533,1143,1670
0130-001,2014,6,29,1,428,465,893,1143
0130-001,2014,6,29,2,365,284,649,893
0130-001,2014,6,29,3,255,206,461,649
0130-001,2014,6,29,4,208,151,359,461
0130-001,2014,6,29,5,257,207,464,359
0130-001,2014,6,29,6,368,325,693,464
0130-001,2014,6,29,7,618,458,1076,693
0130-001,2014,6,29,8,771,714,1485,1076
0130-001,2014,6,29,9,935,983,1918,1485
0130-001,2014,6,29,10,979,1222,2201,1918
0130-001,2014,6,29,11,1151,1316,2467,2201
0130-001,2014,6,29,12,1153,1444,2597,2467
0130-001,2014,6,29,13,1339,1475,2814,2597
0130-001,2014,6,29,14,1433,1571,3004,2814
0130-001,2014,6,29,15,1585,1613,3198,3004
0130-001,2014,6,29,16,1743,1511,3254,3198
0130-001,2014,6,29,17,1867,1629,3496,3254
0130-001,2014,6,29,18,2008,1598,3606,3496
0130-001,2014,6,29,19,1984,1387,3371,3606
0130-001,2014,6,29,20,1424,1280,2704,3371
0130-001,2014,6,29,21,1218,1101,2319,2704
0130-001,2014,6,29,22,1132,854,1986,2319
0130-001,2014,6,29,23,771,587,1358,1986
0130-001,2014,6,29,24,491,404,895,1358
0130-001,2014,6,30,1,314,262,576,895
0130-001,2014,6,30,2,201,195,396,576
0130-001,2014,6,30,3,137,115,252,396
0130-001,2014,6,30,4,137,143,280,252
0130-001,2014,6,30,5,229,242,471,280
0130-001,2014,6,30,6,560,476,1036,471
0130-001,2014,6,30,7,1606,866,2472,1036
0130-001,2014,6,30,8,2106,1807,3913,2472
0130-001,2014,6,30,9,2052,2033,4085,3913
0130-001,2014,6,30,10,1751,1661,3412,4085
0130-001,2014,6,30,11,1806,1742,3548,3412
0130-001,2014,6,30,12,1692,1690,3382,3548
0130-001,2014,6,30,13,1593,1582,3175,3382
0130-001,2014,6,30,14,1918,1720,3638,3175
0130-001,2014,6,30,15,1833,1786,3619,3638
0130-001,2014,6,30,16,1799,1896,3695,3619
0130-001,2014,6,30,17,1797,1919,3716,3695
0130-001,2014,6,30,18,1776,2311,4087,3716
0130-001,2014,6,30,19,1870,2471,4341,4087
0130-001,2014,6,30,20,1485,1907,3392,4341
0130-001,2014,6,30,21,1267,1804,3071,3392
0130-001,2014,6,30,22,1228,1404,2632,3071
0130-001,2014,6,30,23,952,829,1781,2632
0130-001,2014,6,30,24,594,492,1086,1781
0130-001,2014,7,1,1,390,358,748,1086
0130-001,2014,7,1,2,275,245,520,748
0130-001,2014,7,1,3,188,194,382,520
0130-001,2014,7,1,4,176,193,369,382
0130-001,2014,7,1,5,190,231,421,369
0130-001,2014,7,1,6,475,444,919,421
0130-001,2014,7,1,7,1541,778,2319,919
0130-001,2014,7,1,8,2103,1707,3810,2319
0130-001,2014,7,1,9,2150,2019,4169,3810
0130-001,2014,7,1,10,1760,1721,3481,4169
0130-001,2014,7,1,11,1784,1647,3431,3481
0130-001,2014,7,1,12,1645,1627,3272,3431
0130-001,2014,7,1,13,1485,1519,3004,3272
0130-001,2014,7,1,14,1713,1697,3410,3004
0130-001,2014,7,1,15,1899,1733,3632,3410
0130-001,2014,7,1,16,1706,1738,3444,3632
0130-001,2014,7,1,17,1738,1852,3590,3444
0130-001,2014,7,1,18,1741,2254,3995,3590
0130-001,2014,7,1,19,1768,2438,4206,3995
0130-001,2014,7,1,20,1440,1869,3309,4206
0130-001,2014,7,1,21,1255,1653,2908,3309
0130-001,2014,7,1,22,1220,1373,2593,2908
0130-001,2014,7,1,23,933,846,1779,2593
0130-001,2014,7,1,24,540,524,1064,1779
0130-001,2014,7,2,1,394,387,781,1064
0130-001,2014,7,2,2,259,215,474,781
0130-001,2014,7,2,3,177,200,377,474
0130-001,2014,7,2,4,152,180,332,377
0130-001,2014,7,2,5,204,220,424,332
0130-001,2014,7,2,6,458,459,917,424
0130-001,2014,7,2,7,1513,738,2251,917
0130-001,2014,7,2,8,2022,1766,3788,2251
0130-001,2014,7,2,9,2198,1949,4147,3788
0130-001,2014,7,2,10,1786,1656,3442,4147
0130-001,2014,7,2,11,1803,1735,3538,3442
0130-001,2014,7,2,12,1686,1675,3361,3538
0130-001,2014,7,2,13,1506,1543,3049,3361
0130-001,2014,7,2,14,1796,1696,3492,3049
0130-001,2014,7,2,15,1904,1815,3719,3492
0130-001,2014,7,2,16,1724,1766,3490,3719
0130-001,2014,7,2,17,1673,1834,3507,3490
0130-001,2014,7,2,18,1836,2378,4214,3507
0130-001,2014,7,2,19,1819,2546,4365,4214
0130-001,2014,7,2,20,1410,1901,3311,4365
0130-001,2014,7,2,21,1235,1482,2717,3311
0130-001,2014,7,2,22,1203,1036,2239,2717
0130-001,2014,7,2,23,894,601,1495,2239
0130-001,2014,7,2,24,551,361,912,1495
0130-001,2014,7,3,1,394,268,662,912
0130-001,2014,7,3,2,254,218,472,662
0130-001,2014,7,3,3,170,197,367,472
0130-001,2014,7,3,4,144,172,316,367
0130-001,2014,7,3,5,173,217,390,316
0130-001,2014,7,3,6,406,364,770,390
0130-001,2014,7,3,7,1361,654,2015,770
0130-001,2014,7,3,8,2152,1649,3801,2015
0130-001,2014,7,3,9,2113,1990,4103,3801
0130-001,2014,7,3,10,1831,1585,3416,4103
0130-001,2014,7,3,11,1778,1739,3517,3416
0130-001,2014,7,3,12,1674,1691,3365,3517
0130-001,2014,7,3,13,1474,1399,2873,3365
0130-001,2014,7,3,14,1734,1376,3110,2873
0130-001,2014,7,3,15,1814,1514,3328,3110
0130-001,2014,7,3,16,1780,1557,3337,3328
0130-001,2014,7,3,17,1765,1598,3363,3337
0130-001,2014,7,3,18,1764,1803,3567,3363
0130-001,2014,7,3,19,1760,2056,3816,3567
0130-001,2014,7,3,20,1365,1456,2821,3816
0130-001,2014,7,3,21,1259,1386,2645,2821
0130-001,2014,7,3,22,1185,1102,2287,2645
0130-001,2014,7,3,23,892,603,1495,2287
0130-001,2014,7,3,24,589,404,993,1495
0130-001,2014,7,4,1,410,262,672,993
0130-001,2014,7,4,2,277,166,443,672
0130-001,2014,7,4,3,196,152,348,443
0130-001,2014,7,4,4,145,139,284,348
0130-001,2014,7,4,5,200,176,376,284
0130-001,2014,7,4,6,491,329,820,376
0130-001,2014,7,4,7,1519,752,2271,820
0130-001,2014,7,4,8,2117,1624,3741,2271
0130-001,2014,7,4,9,2209,1919,4128,3741
0130-001,2014,7,4,10,1727,1638,3365,4128
0130-001,2014,7,4,11,1840,1829,3669,3365
0130-001,2014,7,4,12,1657,1770,3427,3669
0130-001,2014,7,4,13,1542,1691,3233,3427
0130-001,2014,7,4,14,1815,1759,3574,3233
0130-001,2014,7,4,15,1886,1828,3714,3574
0130-001,2014,7,4,16,1849,1898,3747,3714
0130-001,2014,7,4,17,1798,1721,3519,3747
0130-001,2014,7,4,18,1989,2203,4192,3519
0130-001,2014,7,4,19,2016,2352,4368,4192
0130-001,2014,7,4,20,1784,1976,3760,4368
0130-001,2014,7,4,21,1389,1429,2818,3760
0130-001,2014,7,4,22,1424,1165,2589,2818
0130-001,2014,7,4,23,1122,692,1814,2589
0130-001,2014,7,4,24,712,503,1215,1814
0130-001,2014,7,5,1,500,363,863,1215
0130-001,2014,7,5,2,375,225,600,863
0130-001,2014,7,5,3,282,199,481,600
0130-001,2014,7,5,4,224,190,414,481
0130-001,2014,7,5,5,281,223,504,414
0130-001,2014,7,5,6,550,371,921,504
0130-001,2014,7,5,7,1024,546,1570,921
0130-001,2014,7,5,8,1516,998,2514,1570
0130-001,2014,7,5,9,1665,1465,3130,2514
0130-001,2014,7,5,10,1743,1770,3513,3130
0130-001,2014,7,5,11,1613,1815,3428,3513
0130-001,2014,7,5,12,1759,1943,3702,3428
0130-001,2014,7,5,13,1693,1943,3636,3702
0130-001,2014,7,5,14,1738,1864,3602,3636
0130-001,2014,7,5,15,1760,1845,3605,3602
0130-001,2014,7,5,16,1821,1904,3725,3605
0130-001,2014,7,5,17,1883,1936,3819,3725
0130-001,2014,7,5,18,2033,2280,4313,3819
0130-001,2014,7,5,19,1890,1941,3831,4313
0130-001,2014,7,5,20,1503,1442,2945,3831
0130-001,2014,7,5,21,1240,1176,2416,2945
0130-001,2014,7,5,22,1242,905,2147,2416
0130-001,2014,7,5,23,887,667,1554,2147
0130-001,2014,7,5,24,559,467,1026,1554
0130-001,2014,7,6,1,475,332,807,1026
0130-001,2014,7,6,2,299,242,541,807
0130-001,2014,7,6,3,227,199,426,541
0130-001,2014,7,6,4,263,130,393,426
0130-001,2014,7,6,5,206,135,341,393
0130-001,2014,7,6,6,342,301,643,341
0130-001,2014,7,6,7,581,445,1026,643
0130-001,2014,7,6,8,705,638,1343,1026
0130-001,2014,7,6,9,890,973,1863,1343
0130-001,2014,7,6,10,983,1079,2062,1863
0130-001,2014,7,6,11,1078,1311,2389,2062
0130-001,2014,7,6,12,1202,1185,2387,2389
0130-001,2014,7,6,13,1300,1244,2544,2387
0130-001,2014,7,6,14,1477,1246,2723,2544
0130-001,2014,7,6,15,1635,1204,2839,2723
0130-001,2014,7,6,16,1790,1259,3049,2839
0130-001,2014,7,6,17,1882,1214,3096,3049
0130-001,2014,7,6,18,1932,1149,3081,3096
0130-001,2014,7,6,19,1945,1076,3021,3081
0130-001,2014,7,6,20,1385,992,2377,3021
0130-001,2014,7,6,21,1188,876,2064,2377
0130-001,2014,7,6,22,1088,699,1787,2064
0130-001,2014,7,6,23,781,420,1201,1787
0130-001,2014,7,6,24,487,278,765,1201
0130-001,2014,7,7,1,283,171,454,765
0130-001,2014,7,7,2,192,135,327,454
0130-001,2014,7,7,3,124,80,204,327
0130-001,2014,7,7,4,134,101,235,204
0130-001,2014,7,7,5,199,131,330,235
0130-001,2014,7,7,6,508,343,851,330
0130-001,2014,7,7,7,1649,674,2323,851
0130-001,2014,7,7,8,2142,1587,3729,2323
0130-001,2014,7,7,9,2021,1760,3781,3729
0130-001,2014,7,7,10,1682,1385,3067,3781
0130-001,2014,7,7,11,1879,1421,3300,3067
0130-001,2014,7,7,12,1739,1498,3237,3300
0130-001,2014,7,7,13,1496,1436,2932,3237
0130-001,2014,7,7,14,1766,1640,3406,2932
0130-001,2014,7,7,15,1885,1731,3616,3406
0130-001,2014,7,7,16,1770,1948,3718,3616
0130-001,2014,7,7,17,1734,2004,3738,3718
0130-001,2014,7,7,18,1817,2346,4163,3738
0130-001,2014,7,7,19,1891,2543,4434,4163
0130-001,2014,7,7,20,1471,1846,3317,4434
0130-001,2014,7,7,21,1217,1670,2887,3317
0130-001,2014,7,7,22,1169,1302,2471,2887
0130-001,2014,7,7,23,875,766,1641,2471
0130-001,2014,7,7,24,578,446,1024,1641
0130-001,2014,7,8,1,359,285,644,1024
0130-001,2014,7,8,2,236,195,431,644
0130-001,2014,7,8,3,179,170,349,431
0130-001,2014,7,8,4,142,176,318,349
0130-001,2014,7,8,5,192,188,380,318
0130-001,2014,7,8,6,478,434,912,380
0130-001,2014,7,8,7,1479,703,2182,912
0130-001,2014,7,8,8,2128,1698,3826,2182
0130-001,2014,7,8,9,2049,1999,4048,3826
0130-001,2014,7,8,10,1904,1695,3599,4048
0130-001,2014,7,8,11,1826,1800,3626,3599
0130-001,2014,7,8,12,1634,1680,3314,3626
0130-001,2014,7,8,13,1526,1605,3131,3314
0130-001,2014,7,8,14,1814,1762,3576,3131
0130-001,2014,7,8,15,1841,1827,3668,3576
0130-001,2014,7,8,16,1818,1787,3605,3668
0130-001,2014,7,8,17,1729,2030,3759,3605
0130-001,2014,7,8,18,1839,2228,4067,3759
0130-001,2014,7,8,19,1813,2523,4336,4067
0130-001,2014,7,8,20,1471,1860,3331,4336
0130-001,2014,7,8,21,1332,1751,3083,3331
0130-001,2014,7,8,22,1186,1336,2522,3083
0130-001,2014,7,8,23,929,605,1534,2522
0130-001,2014,7,8,24,563,390,953,1534
0130-001,2014,7,9,1,333,232,565,953
0130-001,2014,7,9,2,256,159,415,565
0130-001,2014,7,9,3,173,112,285,415
0130-001,2014,7,9,4,142,132,274,285
0130-001,2014,7,9,5,199,155,354,274
0130-001,2014,7,9,6,495,442,937,354
0130-001,2014,7,9,7,1486,777,2263,937
0130-001,2014,7,9,8,2113,1738,3851,2263
0130-001,2014,7,9,9,2148,1944,4092,3851
0130-001,2014,7,9,10,1851,1710,3561,4092
0130-001,2014,7,9,11,1760,1729,3489,3561
0130-001,2014,7,9,12,1685,1694,3379,3489
0130-001,2014,7,9,13,1508,1501,3009,3379
0130-001,2014,7,9,14,1686,1680,3366,3009
0130-001,2014,7,9,15,1852,1824,3676,3366
0130-001,2014,7,9,16,1753,1790,3543,3676
0130-001,2014,7,9,17,1709,1856,3565,3543
0130-001,2014,7,9,18,1803,1849,3652,3565
0130-001,2014,7,9,19,1849,2094,3943,3652
0130-001,2014,7,9,20,1365,1419,2784,3943
0130-001,2014,7,9,21,1273,1240,2513,2784
0130-001,2014,7,9,22,1244,985,2229,2513
0130-001,2014,7,9,23,872,550,1422,2229
0130-001,2014,7,9,24,608,375,983,1422
0130-001,2014,7,10,1,424,277,701,983
0130-001,2014,7,10,2,251,173,424,701
0130-001,2014,7,10,3,194,113,307,424
0130-001,2014,7,10,4,140,114,254,307
0130-001,2014,7,10,5,185,175,360,254
0130-001,2014,7,10,6,435,410,845,360
0130-001,2014,7,10,7,1511,754,2265,845
0130-001,2014,7,10,8,2075,1689,3764,2265
0130-001,2014,7,10,9,2171,1986,4157,3764
0130-001,2014,7,10,10,1789,1641,3430,4157
0130-001,2014,7,10,11,1732,1724,3456,3430
0130-001,2014,7,10,12,1564,1678,3242,3456
0130-001,2014,7,10,13,1503,1484,2987,3242
0130-001,2014,7,10,14,1672,1505,3177,2987
0130-001,2014,7,10,15,1831,1690,3521,3177
0130-001,2014,7,10,16,1785,1678,3463,3521
0130-001,2014,7,10,17,1754,1794,3548,3463
0130-001,2014,7,10,18,1863,1924,3787,3548
0130-001,2014,7,10,19,1803,2151,3954,3787
0130-001,2014,7,10,20,1503,1567,3070,3954
0130-001,2014,7,10,21,1321,1304,2625,3070
0130-001,2014,7,10,22,1258,1089,2347,2625
0130-001,2014,7,10,23,1004,660,1664,2347
0130-001,2014,7,10,24,625,431,1056,1664
0130-001,2014,7,11,1,435,270,705,1056
0130-001,2014,7,11,2,263,184,447,705
0130-001,2014,7,11,3,217,133,350,447
0130-001,2014,7,11,4,171,146,317,350
0130-001,2014,7,11,5,233,175,408,317
0130-001,2014,7,11,6,577,410,987,408
0130-001,2014,7,11,7,1580,734,2314,987
0130-001,2014,7,11,8,2112,1508,3620,2314
0130-001,2014,7,11,9,2156,1820,3976,3620
0130-001,2014,7,11,10,1820,1622,3442,3976
0130-001,2014,7,11,11,1837,1794,3631,3442
0130-001,2014,7,11,12,1833,1768,3601,3631
0130-001,2014,7,11,13,1620,1708,3328,3601
0130-001,2014,7,11,14,1734,1818,3552,3328
0130-001,2014,7,11,15,1900,1857,3757,3552
0130-001,2014,7,11,16,1879,1862,3741,3757
0130-001,2014,7,11,17,1861,2078,3939,3741
0130-001,2014,7,11,18,2026,2410,4436,3939
0130-001,2014,7,11,19,1958,2616,4574,4436
0130-001,2014,7,11,20,1719,2263,3982,4574
0130-001,2014,7,11,21,1570,1837,3407,3982
0130-001,2014,7,11,22,1380,1303,2683,3407
0130-001,2014,7,11,23,1069,841,1910,2683
0130-001,2014,7,11,24,759,600,1359,1910
0130-001,2014,7,12,1,519,432,951,1359
0130-001,2014,7,12,2,380,293,673,951
0130-001,2014,7,12,3,302,218,520,673
0130-001,2014,7,12,4,223,256,479,520
0130-001,2014,7,12,5,288,235,523,479
0130-001,2014,7,12,6,524,431,955,523
0130-001,2014,7,12,7,1020,671,1691,955
0130-001,2014,7,12,8,1477,1151,2628,1691
0130-001,2014,7,12,9,1690,1576,3266,2628
0130-001,2014,7,12,10,1729,1760,3489,3266
0130-001,2014,7,12,11,1728,1845,3573,3489
0130-001,2014,7,12,12,1803,1946,3749,3573
0130-001,2014,7,12,13,1748,2013,3761,3749
0130-001,2014,7,12,14,1724,1918,3642,3761
0130-001,2014,7,12,15,1717,1848,3565,3642
0130-001,2014,7,12,16,1805,1879,3684,3565
0130-001,2014,7,12,17,1872,1988,3860,3684
0130-001,2014,7,12,18,1979,2173,4152,3860
0130-001,2014,7,12,19,1754,1969,3723,4152
0130-001,2014,7,12,20,1404,1373,2777,3723
0130-001,2014,7,12,21,1411,1203,2614,2777
0130-001,2014,7,12,22,1207,1006,2213,2614
0130-001,2014,7,12,23,898,661,1559,2213
0130-001,2014,7,12,24,585,503,1088,1559
0130-001,2014,7,13,1,438,283,721,1088
0130-001,2014,7,13,2,324,189,513,721
0130-001,2014,7,13,3,234,154,388,513
0130-001,2014,7,13,4,195,128,323,388
0130-001,2014,7,13,5,189,137,326,323
0130-001,2014,7,13,6,316,221,537,326
0130-001,2014,7,13,7,588,349,937,537
0130-001,2014,7,13,8,689,582,1271,937
0130-001,2014,7,13,9,809,724,1533,1271
0130-001,2014,7,13,10,939,916,1855,1533
0130-001,2014,7,13,11,1096,934,2030,1855
0130-001,2014,7,13,12,1203,1046,2249,2030
0130-001,2014,7,13,13,1233,1030,2263,2249
0130-001,2014,7,13,14,1374,1068,2442,2263
0130-001,2014,7,13,15,1459,1108,2567,2442
0130-001,2014,7,13,16,1641,1109,2750,2567
0130-001,2014,7,13,17,1687,1185,2872,2750
0130-001,2014,7,13,18,1825,1110,2935,2872
0130-001,2014,7,13,19,1727,1171,2898,2935
0130-001,2014,7,13,20,1457,949,2406,2898
0130-001,2014,7,13,21,1432,862,2294,2406
0130-001,2014,7,13,22,1123,727,1850,2294
0130-001,2014,7,13,23,748,413,1161,1850
0130-001,2014,7,13,24,470,308,778,1161
0130-001,2014,7,14,1,304,158,462,778
0130-001,2014,7,14,2,162,121,283,462
0130-001,2014,7,14,3,153,76,229,283
0130-001,2014,7,14,4,141,83,224,229
0130-001,2014,7,14,5,216,155,371,224
0130-001,2014,7,14,6,506,370,876,371
0130-001,2014,7,14,7,1664,698,2362,876
0130-001,2014,7,14,8,2100,1709,3809,2362
0130-001,2014,7,14,9,2160,1851,4011,3809
0130-001,2014,7,14,10,1773,1450,3223,4011
0130-001,2014,7,14,11,1780,1663,3443,3223
0130-001,2014,7,14,12,1653,1672,3325,3443
0130-001,2014,7,14,13,1503,1561,3064,3325
0130-001,2014,7,14,14,1763,1686,3449,3064
0130-001,2014,7,14,15,1818,1844,3662,3449
0130-001,2014,7,14,16,1815,1877,3692,3662
0130-001,2014,7,14,17,1716,1965,3681,3692
0130-001,2014,7,14,18,1849,2271,4120,3681
0130-001,2014,7,14,19,1813,2466,4279,4120
0130-001,2014,7,14,20,1420,1781,3201,4279
0130-001,2014,7,14,21,1240,1638,2878,3201
0130-001,2014,7,14,22,1190,1350,2540,2878
0130-001,2014,7,14,23,918,728,1646,2540
0130-001,2014,7,14,24,516,438,954,1646
0130-001,2014,7,15,1,387,357,744,954
0130-001,2014,7,15,2,226,188,414,744
0130-001,2014,7,15,3,169,187,356,414
0130-001,2014,7,15,4,169,241,410,356
0130-001,2014,7,15,5,210,225,435,410
0130-001,2014,7,15,6,467,402,869,435
0130-001,2014,7,15,7,1494,749,2243,869
0130-001,2014,7,15,8,2158,1763,3921,2243
0130-001,2014,7,15,9,2109,1978,4087,3921
0130-001,2014,7,15,10,1758,1690,3448,4087
0130-001,2014,7,15,11,1750,1691,3441,3448
0130-001,2014,7,15,12,1693,1719,3412,3441
0130-001,2014,7,15,13,1517,1488,3005,3412
0130-001,2014,7,15,14,1778,1785,3563,3005
0130-001,2014,7,15,15,1847,1822,3669,3563
0130-001,2014,7,15,16,1826,1869,3695,3669
0130-001,2014,7,15,17,1701,1962,3663,3695
0130-001,2014,7,15,18,1864,2282,4146,3663
0130-001,2014,7,15,19,1764,2540,4304,4146
0130-001,2014,7,15,20,1457,1879,3336,4304
0130-001,2014,7,15,21,1277,1689,2966,3336
0130-001,2014,7,15,22,1184,1338,2522,2966
0130-001,2014,7,15,23,910,850,1760,2522
0130-001,2014,7,15,24,637,519,1156,1760
0130-001,2014,7,16,1,398,363,761,1156
0130-001,2014,7,16,2,246,252,498,761
0130-001,2014,7,16,3,201,180,381,498
0130-001,2014,7,16,4,146,185,331,381
0130-001,2014,7,16,5,186,225,411,331
0130-001,2014,7,16,6,504,425,929,411
0130-001,2014,7,16,7,1469,816,2285,929
0130-001,2014,7,16,8,1970,1711,3681,2285
0130-001,2014,7,16,9,2194,1940,4134,3681
0130-001,2014,7,16,10,1766,1765,3531,4134
0130-001,2014,7,16,11,1827,1723,3550,3531
0130-001,2014,7,16,12,1720,1714,3434,3550
0130-001,2014,7,16,13,1512,1459,2971,3434
0130-001,2014,7,16,14,1736,1663,3399,2971
0130-001,2014,7,16,15,1706,1833,3539,3399
0130-001,2014,7,16,16,1785,1814,3599,3539
0130-001,2014,7,16,17,1841,1878,3719,3599
0130-001,2014,7,16,18,1909,2258,4167,3719
0130-001,2014,7,16,19,1935,2626,4561,4167
0130-001,2014,7,16,20,1496,1999,3495,4561
0130-001,2014,7,16,21,1267,1728,2995,3495
0130-001,2014,7,16,22,1298,1343,2641,2995
0130-001,2014,7,16,23,1023,773,1796,2641
0130-001,2014,7,16,24,646,565,1211,1796
0130-001,2014,7,17,1,424,385,809,1211
0130-001,2014,7,17,2,258,286,544,809
0130-001,2014,7,17,3,207,190,397,544
0130-001,2014,7,17,4,167,193,360,397
0130-001,2014,7,17,5,190,210,400,360
0130-001,2014,7,17,6,483,455,938,400
0130-001,2014,7,17,7,1393,854,2247,938
0130-001,2014,7,17,8,2121,1729,3850,2247
0130-001,2014,7,17,9,2048,1983,4031,3850
0130-001,2014,7,17,10,1809,1697,3506,4031
0130-001,2014,7,17,11,1816,1709,3525,3506
0130-001,2014,7,17,12,1716,1665,3381,3525
0130-001,2014,7,17,13,1483,1568,3051,3381
0130-001,2014,7,17,14,1804,1634,3438,3051
0130-001,2014,7,17,15,1834,1867,3701,3438
0130-001,2014,7,17,16,1724,1798,3522,3701
0130-001,2014,7,17,17,1713,1991,3704,3522
0130-001,2014,7,17,18,1839,2278,4117,3704
0130-001,2014,7,17,19,1861,2509,4370,4117
0130-001,2014,7,17,20,1357,1710,3067,4370
0130-001,2014,7,17,21,1266,1699,2965,3067
0130-001,2014,7,17,22,1246,1340,2586,2965
0130-001,2014,7,17,23,930,776,1706,2586
0130-001,2014,7,17,24,620,500,1120,1706
0130-001,2014,7,18,1,432,269,701,1120
0130-001,2014,7,18,2,272,195,467,701
0130-001,2014,7,18,3,202,135,337,467
0130-001,2014,7,18,4,166,134,300,337
0130-001,2014,7,18,5,159,168,327,300
0130-001,2014,7,18,6,285,287,572,327
0130-001,2014,7,18,7,1140,751,1891,572
0130-001,2014,7,18,8,2043,1679,3722,1891
0130-001,2014,7,18,9,2050,1972,4022,3722
0130-001,2014,7,18,10,1837,1670,3507,4022
0130-001,2014,7,18,11,1767,1820,3587,3507
0130-001,2014,7,18,12,1646,1763,3409,3587
0130-001,2014,7,18,13,1575,1627,3202,3409
0130-001,2014,7,18,14,1780,1738,3518,3202
0130-001,2014,7,18,15,1882,1873,3755,3518
0130-001,2014,7,18,16,1925,1929,3854,3755
0130-001,2014,7,18,17,1929,1987,3916,3854
0130-001,2014,7,18,18,1921,2376,4297,3916
0130-001,2014,7,18,19,2067,2679,4746,4297
0130-001,2014,7,18,20,1686,2210,3896,4746
0130-001,2014,7,18,21,1586,1896,3482,3896
0130-001,2014,7,18,22,1297,1506,2803,3482
0130-001,2014,7,18,23,1093,919,2012,2803
0130-001,2014,7,18,24,687,635,1322,2012
0130-001,2014,7,19,1,517,483,1000,1322
0130-001,2014,7,19,2,401,339,740,1000
0130-001,2014,7,19,3,294,270,564,740
0130-001,2014,7,19,4,217,230,447,564
0130-001,2014,7,19,5,257,266,523,447
0130-001,2014,7,19,6,484,426,910,523
0130-001,2014,7,19,7,966,691,1657,910
0130-001,2014,7,19,8,1535,1113,2648,1657
0130-001,2014,7,19,9,1819,1502,3321,2648
0130-001,2014,7,19,10,1692,1723,3415,3321
0130-001,2014,7,19,11,1795,1748,3543,3415
0130-001,2014,7,19,12,1684,1977,3661,3543
0130-001,2014,7,19,13,1643,1935,3578,3661
0130-001,2014,7,19,14,1647,1437,3084,3578
0130-001,2014,7,19,15,1652,1643,3295,3084
0130-001,2014,7,19,16,1778,1286,3064,3295
0130-001,2014,7,19,17,1440,1395,2835,3064
0130-001,2014,7,19,18,1432,1407,2839,2835
0130-001,2014,7,19,19,1412,1299,2711,2839
0130-001,2014,7,19,20,1332,1397,2729,2711
0130-001,2014,7,19,21,1272,1215,2487,2729
0130-001,2014,7,19,22,1207,1012,2219,2487
0130-001,2014,7,19,23,885,711,1596,2219
0130-001,2014,7,19,24,594,512,1106,1596
0130-001,2014,7,20,1,425,433,858,1106
0130-001,2014,7,20,2,338,266,604,858
0130-001,2014,7,20,3,248,183,431,604
0130-001,2014,7,20,4,195,173,368,431
0130-001,2014,7,20,5,214,174,388,368
0130-001,2014,7,20,6,354,309,663,388
0130-001,2014,7,20,7,574,432,1006,663
0130-001,2014,7,20,8,697,638,1335,1006
0130-001,2014,7,20,9,838,1024,1862,1335
0130-001,2014,7,20,10,876,1135,2011,1862
0130-001,2014,7,20,11,1258,1383,2641,2011
0130-001,2014,7,20,12,1173,1362,2535,2641
0130-001,2014,7,20,13,1489,1587,3076,2535
0130-001,2014,7,20,14,1395,1441,2836,3076
0130-001,2014,7,20,15,1457,1602,3059,2836
0130-001,2014,7,20,16,1645,1565,3210,3059
0130-001,2014,7,20,17,1815,1568,3383,3210
0130-001,2014,7,20,18,1937,1605,3542,3383
0130-001,2014,7,20,19,1801,1376,3177,3542
0130-001,2014,7,20,20,1530,1326,2856,3177
0130-001,2014,7,20,21,1505,1144,2649,2856
0130-001,2014,7,20,22,1144,919,2063,2649
0130-001,2014,7,20,23,820,650,1470,2063
0130-001,2014,7,20,24,483,402,885,1470
0130-001,2014,7,21,1,324,240,564,885
0130-001,2014,7,21,2,185,178,363,564
0130-001,2014,7,21,3,127,125,252,363
0130-001,2014,7,21,4,128,171,299,252
0130-001,2014,7,21,5,196,202,398,299
0130-001,2014,7,21,6,495,448,943,398
0130-001,2014,7,21,7,1610,1010,2620,943
0130-001,2014,7,21,8,2080,1685,3765,2620
0130-001,2014,7,21,9,2151,1962,4113,3765
0130-001,2014,7,21,10,1784,1726,3510,4113
0130-001,2014,7,21,11,1790,1607,3397,3510
0130-001,2014,7,21,12,1727,1598,3325,3397
0130-001,2014,7,21,13,1518,1577,3095,3325
0130-001,2014,7,21,14,1759,1802,3561,3095
0130-001,2014,7,21,15,1823,1741,3564,3561
0130-001,2014,7,21,16,1723,1884,3607,3564
0130-001,2014,7,21,17,1663,1938,3601,3607
0130-001,2014,7,21,18,1776,2284,4060,3601
0130-001,2014,7,21,19,1822,2561,4383,4060
0130-001,2014,7,21,20,1437,1866,3303,4383
0130-001,2014,7,21,21,1326,1733,3059,3303
0130-001,2014,7,21,22,1151,1266,2417,3059
0130-001,2014,7,21,23,850,792,1642,2417
0130-001,2014,7,21,24,516,552,1068,1642
0130-001,2014,7,22,1,407,319,726,1068
0130-001,2014,7,22,2,231,257,488,726
0130-001,2014,7,22,3,159,194,353,488
0130-001,2014,7,22,4,164,177,341,353
0130-001,2014,7,22,5,187,216,403,341
0130-001,2014,7,22,6,467,420,887,403
0130-001,2014,7,22,7,1455,800,2255,887
0130-001,2014,7,22,8,2058,1620,3678,2255
0130-001,2014,7,22,9,2099,1975,4074,3678
0130-001,2014,7,22,10,1842,1824,3666,4074
0130-001,2014,7,22,11,1799,1731,3530,3666
0130-001,2014,7,22,12,1714,1711,3425,3530
0130-001,2014,7,22,13,1477,1540,3017,3425
0130-001,2014,7,22,14,1731,1691,3422,3017
0130-001,2014,7,22,15,1856,1815,3671,3422
0130-001,2014,7,22,16,1852,1883,3735,3671
0130-001,2014,7,22,17,1613,1920,3533,3735
0130-001,2014,7,22,18,1832,2264,4096,3533
0130-001,2014,7,22,19,1844,2524,4368,4096
0130-001,2014,7,22,20,1418,1843,3261,4368
0130-001,2014,7,22,21,1269,1704,2973,3261
0130-001,2014,7,22,22,1120,1320,2440,2973
0130-001,2014,7,22,23,873,818,1691,2440
0130-001,2014,7,22,24,601,524,1125,1691
0130-001,2014,7,23,1,406,390,796,1125
0130-001,2014,7,23,2,239,266,505,796
0130-001,2014,7,23,3,173,194,367,505
0130-001,2014,7,23,4,150,193,343,367
0130-001,2014,7,23,5,203,224,427,343
0130-001,2014,7,23,6,376,376,752,427
0130-001,2014,7,23,7,1244,680,1924,752
0130-001,2014,7,23,8,2002,1524,3526,1924
0130-001,2014,7,23,9,1968,1816,3784,3526
0130-001,2014,7,23,10,1619,1715,3334,3784
0130-001,2014,7,23,11,1608,1612,3220,3334
0130-001,2014,7,23,12,1549,1568,3117,3220
0130-001,2014,7,23,13,1290,1499,2789,3117
0130-001,2014,7,23,14,1692,1687,3379,2789
0130-001,2014,7,23,15,1774,1773,3547,3379
0130-001,2014,7,23,16,1801,1702,3503,3547
0130-001,2014,7,23,17,1587,1772,3359,3503
0130-001,2014,7,23,18,1653,2152,3805,3359
0130-001,2014,7,23,19,1792,2440,4232,3805
0130-001,2014,7,23,20,1367,1811,3178,4232
0130-001,2014,7,23,21,1185,1545,2730,3178
0130-001,2014,7,23,22,1155,1184,2339,2730
0130-001,2014,7,23,23,844,701,1545,2339
0130-001,2014,7,23,24,569,496,1065,1545
0130-001,2014,7,24,1,445,338,783,1065
0130-001,2014,7,24,2,247,271,518,783
0130-001,2014,7,24,3,213,195,408,518
0130-001,2014,7,24,4,148,190,338,408
0130-001,2014,7,24,5,199,203,402,338
0130-001,2014,7,24,6,354,391,745,402
0130-001,2014,7,24,7,1201,680,1881,745
0130-001,2014,7,24,8,1994,1511,3505,1881
0130-001,2014,7,24,9,2039,1890,3929,3505
0130-001,2014,7,24,10,1786,1770,3556,3929
0130-001,2014,7,24,11,1811,1780,3591,3556
0130-001,2014,7,24,12,1640,1675,3315,3591
0130-001,2014,7,24,13,1504,1570,3074,3315
0130-001,2014,7,24,14,1685,1726,3411,3074
0130-001,2014,7,24,15,1823,1785,3608,3411
0130-001,2014,7,24,16,1846,1831,3677,3608
0130-001,2014,7,24,17,1830,1942,3772,3677
0130-001,2014,7,24,18,1812,2185,3997,3772
0130-001,2014,7,24,19,1785,2502,4287,3997
0130-001,2014,7,24,20,1487,1815,3302,4287
0130-001,2014,7,24,21,1260,1782,3042,3302
0130-001,2014,7,24,22,1202,1338,2540,3042
0130-001,2014,7,24,23,991,843,1834,2540
0130-001,2014,7,24,24,618,538,1156,1834
0130-001,2014,7,25,1,453,360,813,1156
0130-001,2014,7,25,2,278,266,544,813
0130-001,2014,7,25,3,188,188,376,544
0130-001,2014,7,25,4,156,208,364,376
0130-001,2014,7,25,5,189,227,416,364
0130-001,2014,7,25,6,411,414,825,416
0130-001,2014,7,25,7,1353,677,2030,825
0130-001,2014,7,25,8,2139,1553,3692,2030
0130-001,2014,7,25,9,2005,1983,3988,3692
0130-001,2014,7,25,10,1766,1758,3524,3988
0130-001,2014,7,25,11,1853,1735,3588,3524
0130-001,2014,7,25,12,1788,1791,3579,3588
0130-001,2014,7,25,13,1522,1614,3136,3579
0130-001,2014,7,25,14,1757,1791,3548,3136
0130-001,2014,7,25,15,1838,1821,3659,3548
0130-001,2014,7,25,16,1827,1873,3700,3659
0130-001,2014,7,25,17,1791,1942,3733,3700
0130-001,2014,7,25,18,1900,2343,4243,3733
0130-001,2014,7,25,19,1997,2557,4554,4243
0130-001,2014,7,25,20,1689,2350,4039,4554
0130-001,2014,7,25,21,1475,2120,3595,4039
0130-001,2014,7,25,22,1330,1400,2730,3595
0130-001,2014,7,25,23,994,814,1808,2730
0130-001,2014,7,25,24,709,614,1323,1808
0130-001,2014,7,26,1,505,397,902,1323
0130-001,2014,7,26,2,370,316,686,902
0130-001,2014,7,26,3,263,224,487,686
0130-001,2014,7,26,4,220,263,483,487
0130-001,2014,7,26,5,232,250,482,483
0130-001,2014,7,26,6,399,404,803,482
0130-001,2014,7,26,7,912,629,1541,803
0130-001,2014,7,26,8,1463,1021,2484,1541
0130-001,2014,7,26,9,1533,1480,3013,2484
0130-001,2014,7,26,10,1670,1799,3469,3013
0130-001,2014,7,26,11,1698,1827,3525,3469
0130-001,2014,7,26,12,1675,1966,3641,3525
0130-001,2014,7,26,13,1680,2038,3718,3641
0130-001,2014,7,26,14,1701,1884,3585,3718
0130-001,2014,7,26,15,1710,1854,3564,3585
0130-001,2014,7,26,16,1787,1826,3613,3564
0130-001,2014,7,26,17,1837,1890,3727,3613
0130-001,2014,7,26,18,2041,2076,4117,3727
0130-001,2014,7,26,19,1735,1932,3667,4117
0130-001,2014,7,26,20,1462,1413,2875,3667
0130-001,2014,7,26,21,1416,1324,2740,2875
0130-001,2014,7,26,22,1194,1020,2214,2740
0130-001,2014,7,26,23,859,687,1546,2214
0130-001,2014,7,26,24,630,509,1139,1546
0130-001,2014,7,27,1,452,359,811,1139
0130-001,2014,7,27,2,310,292,602,811
0130-001,2014,7,27,3,249,205,454,602
0130-001,2014,7,27,4,169,169,338,454
0130-001,2014,7,27,5,206,193,399,338
0130-001,2014,7,27,6,319,293,612,399
0130-001,2014,7,27,7,641,430,1071,612
0130-001,2014,7,27,8,719,610,1329,1071
0130-001,2014,7,27,9,867,870,1737,1329
0130-001,2014,7,27,10,915,1013,1928,1737
0130-001,2014,7,27,11,1059,1159,2218,1928
0130-001,2014,7,27,12,1128,1316,2444,2218
0130-001,2014,7,27,13,1137,1466,2603,2444
0130-001,2014,7,27,14,1342,1272,2614,2603
0130-001,2014,7,27,15,1416,1445,2861,2614
0130-001,2014,7,27,16,1540,1412,2952,2861
0130-001,2014,7,27,17,1606,1478,3084,2952
0130-001,2014,7,27,18,1650,1569,3219,3084
0130-001,2014,7,27,19,1481,1343,2824,3219
0130-001,2014,7,27,20,1277,1183,2460,2824
0130-001,2014,7,27,21,1368,1123,2491,2460
0130-001,2014,7,27,22,1076,935,2011,2491
0130-001,2014,7,27,23,754,607,1361,2011
0130-001,2014,7,27,24,487,469,956,1361
0130-001,2014,7,28,1,334,256,590,956
0130-001,2014,7,28,2,179,179,358,590
0130-001,2014,7,28,3,131,126,257,358
0130-001,2014,7,28,4,127,160,287,257
0130-001,2014,7,28,5,197,217,414,287
0130-001,2014,7,28,6,483,447,930,414
0130-001,2014,7,28,7,1553,825,2378,930
0130-001,2014,7,28,8,2054,1631,3685,2378
0130-001,2014,7,28,9,2008,1862,3870,3685
0130-001,2014,7,28,10,1794,1652,3446,3870
0130-001,2014,7,28,11,1799,1828,3627,3446
0130-001,2014,7,28,12,1801,1783,3584,3627
0130-001,2014,7,28,13,1533,1674,3207,3584
0130-001,2014,7,28,14,1755,1738,3493,3207
0130-001,2014,7,28,15,1828,1859,3687,3493
0130-001,2014,7,28,16,1860,1863,3723,3687
0130-001,2014,7,28,17,1813,1955,3768,3723
0130-001,2014,7,28,18,1845,2205,4050,3768
0130-001,2014,7,28,19,1853,2486,4339,4050
0130-001,2014,7,28,20,1451,1809,3260,4339
0130-001,2014,7,28,21,1284,1700,2984,3260
0130-001,2014,7,28,22,1091,1261,2352,2984
0130-001,2014,7,28,23,899,774,1673,2352
0130-001,2014,7,28,24,532,492,1024,1673
0130-001,2014,7,29,1,350,327,677,1024
0130-001,2014,7,29,2,245,219,464,677
0130-001,2014,7,29,3,180,181,361,464
0130-001,2014,7,29,4,157,224,381,361
0130-001,2014,7,29,5,214,219,433,381
0130-001,2014,7,29,6,412,392,804,433
0130-001,2014,7,29,7,1301,722,2023,804
0130-001,2014,7,29,8,1909,1505,3414,2023
0130-001,2014,7,29,9,2126,1888,4014,3414
0130-001,2014,7,29,10,1753,1671,3424,4014
0130-001,2014,7,29,11,1710,1776,3486,3424
0130-001,2014,7,29,12,1732,1777,3509,3486
0130-001,2014,7,29,13,1477,1533,3010,3509
0130-001,2014,7,29,14,1713,1730,3443,3010
0130-001,2014,7,29,15,1866,1879,3745,3443
0130-001,2014,7,29,16,1818,1838,3656,3745
0130-001,2014,7,29,17,1801,1740,3541,3656
0130-001,2014,7,29,18,1816,2173,3989,3541
0130-001,2014,7,29,19,1823,2443,4266,3989
0130-001,2014,7,29,20,1501,1816,3317,4266
0130-001,2014,7,29,21,1274,1705,2979,3317
0130-001,2014,7,29,22,1177,1308,2485,2979
0130-001,2014,7,29,23,911,766,1677,2485
0130-001,2014,7,29,24,565,519,1084,1677
0130-001,2014,7,30,1,427,415,842,1084
0130-001,2014,7,30,2,269,245,514,842
0130-001,2014,7,30,3,179,203,382,514
0130-001,2014,7,30,4,172,216,388,382
0130-001,2014,7,30,5,202,234,436,388
0130-001,2014,7,30,6,449,431,880,436
0130-001,2014,7,30,7,1357,801,2158,880
0130-001,2014,7,30,8,2086,1522,3608,2158
0130-001,2014,7,30,9,1907,1880,3787,3608
0130-001,2014,7,30,10,1699,1710,3409,3787
0130-001,2014,7,30,11,1761,1752,3513,3409
0130-001,2014,7,30,12,1677,1880,3557,3513
0130-001,2014,7,30,13,1472,1575,3047,3557
0130-001,2014,7,30,14,1712,1751,3463,3047
0130-001,2014,7,30,15,1735,1765,3500,3463
0130-001,2014,7,30,16,1893,1862,3755,3500
0130-001,2014,7,30,17,1759,1824,3583,3755
0130-001,2014,7,30,18,1845,2279,4124,3583
0130-001,2014,7,30,19,1888,2545,4433,4124
0130-001,2014,7,30,20,1531,2003,3534,4433
0130-001,2014,7,30,21,1361,1637,2998,3534
0130-001,2014,7,30,22,1215,1226,2441,2998
0130-001,2014,7,30,23,947,736,1683,2441
0130-001,2014,7,30,24,625,567,1192,1683
0130-001,2014,7,31,1,421,345,766,1192
0130-001,2014,7,31,2,267,271,538,766
0130-001,2014,7,31,3,210,186,396,538
0130-001,2014,7,31,4,166,194,360,396
0130-001,2014,7,31,5,205,232,437,360
0130-001,2014,7,31,6,423,376,799,437
0130-001,2014,7,31,7,1389,814,2203,799
0130-001,2014,7,31,8,2030,1486,3516,2203
0130-001,2014,7,31,9,1926,1865,3791,3516
0130-001,2014,7,31,10,1707,1700,3407,3791
0130-001,2014,7,31,11,1809,1758,3567,3407
0130-001,2014,7,31,12,1711,1745,3456,3567
0130-001,2014,7,31,13,1451,1786,3237,3456
0130-001,2014,7,31,14,1682,1765,3447,3237
0130-001,2014,7,31,15,1672,1806,3478,3447
0130-001,2014,7,31,16,1832,1941,3773,3478
0130-001,2014,7,31,17,1732,1866,3598,3773
0130-001,2014,7,31,18,1877,2121,3998,3598
0130-001,2014,7,31,19,1928,2466,4394,3998
0130-001,2014,7,31,20,1530,1775,3305,4394
0130-001,2014,7,31,21,1307,1796,3103,3305
0130-001,2014,7,31,22,1241,1230,2471,3103
0130-001,2014,7,31,23,957,855,1812,2471
0130-001,2014,7,31,24,621,531,1152,1812
0130-001,2014,8,1,1,427,398,825,1152
0130-001,2014,8,1,2,260,282,542,825
0130-001,2014,8,1,3,241,194,435,542
0130-001,2014,8,1,4,192,224,416,435
0130-001,2014,8,1,5,203,220,423,416
0130-001,2014,8,1,6,456,400,856,423
0130-001,2014,8,1,7,1361,777,2138,856
0130-001,2014,8,1,8,2025,1380,3405,2138
0130-001,2014,8,1,9,1858,1822,3680,3405
0130-001,2014,8,1,10,1610,1607,3217,3680
0130-001,2014,8,1,11,1682,1740,3422,3217
0130-001,2014,8,1,12,1689,1887,3576,3422
0130-001,2014,8,1,13,1445,1813,3258,3576
0130-001,2014,8,1,14,1590,1867,3457,3258
0130-001,2014,8,1,15,1758,1972,3730,3457
0130-001,2014,8,1,16,1885,1925,3810,3730
0130-001,2014,8,1,17,1750,1973,3723,3810
0130-001,2014,8,1,18,1996,2251,4247,3723
0130-001,2014,8,1,19,1970,2522,4492,4247
0130-001,2014,8,1,20,1714,2018,3732,4492
0130-001,2014,8,1,21,1535,1637,3172,3732
0130-001,2014,8,1,22,1207,1218,2425,3172
0130-001,2014,8,1,23,939,781,1720,2425
0130-001,2014,8,1,24,624,588,1212,1720
0130-001,2014,8,2,1,486,399,885,1212
0130-001,2014,8,2,2,312,309,621,885
0130-001,2014,8,2,3,250,213,463,621
0130-001,2014,8,2,4,203,219,422,463
0130-001,2014,8,2,5,251,210,461,422
0130-001,2014,8,2,6,441,331,772,461
0130-001,2014,8,2,7,927,648,1575,772
0130-001,2014,8,2,8,1279,1002,2281,1575
0130-001,2014,8,2,9,1393,1452,2845,2281
0130-001,2014,8,2,10,1451,1656,3107,2845
0130-001,2014,8,2,11,1562,1882,3444,3107
0130-001,2014,8,2,12,1629,1922,3551,3444
0130-001,2014,8,2,13,1570,2005,3575,3551
0130-001,2014,8,2,14,1640,1867,3507,3575
0130-001,2014,8,2,15,1755,1723,3478,3507
0130-001,2014,8,2,16,1774,1698,3472,3478
0130-001,2014,8,2,17,1877,1698,3575,3472
0130-001,2014,8,2,18,1985,1824,3809,3575
0130-001,2014,8,2,19,1885,1541,3426,3809
0130-001,2014,8,2,20,1581,1292,2873,3426
0130-001,2014,8,2,21,1530,1092,2622,2873
0130-001,2014,8,2,22,1120,909,2029,2622
0130-001,2014,8,2,23,729,636,1365,2029
0130-001,2014,8,2,24,492,469,961,1365
0130-001,2014,8,3,1,371,293,664,961
0130-001,2014,8,3,2,237,193,430,664
0130-001,2014,8,3,3,198,163,361,430
0130-001,2014,8,3,4,167,134,301,361
0130-001,2014,8,3,5,146,139,285,301
0130-001,2014,8,3,6,221,223,444,285
0130-001,2014,8,3,7,421,329,750,444
0130-001,2014,8,3,8,653,482,1135,750
0130-001,2014,8,3,9,769,746,1515,1135
0130-001,2014,8,3,10,839,916,1755,1515
0130-001,2014,8,3,11,1068,1193,2261,1755
0130-001,2014,8,3,12,1058,1268,2326,2261
0130-001,2014,8,3,13,1252,1443,2695,2326
0130-001,2014,8,3,14,1369,1434,2803,2695
0130-001,2014,8,3,15,1598,1538,3136,2803
0130-001,2014,8,3,16,1872,1486,3358,3136
0130-001,2014,8,3,17,1840,1377,3217,3358
0130-001,2014,8,3,18,1781,1447,3228,3217
0130-001,2014,8,3,19,1843,1207,3050,3228
0130-001,2014,8,3,20,1728,1112,2840,3050
0130-001,2014,8,3,21,1638,960,2598,2840
0130-001,2014,8,3,22,1189,775,1964,2598
0130-001,2014,8,3,23,760,546,1306,1964
0130-001,2014,8,3,24,442,395,837,1306
0130-001,2014,8,4,1,319,249,568,837
0130-001,2014,8,4,2,190,183,373,568
0130-001,2014,8,4,3,154,130,284,373
0130-001,2014,8,4,4,122,170,292,284
0130-001,2014,8,4,5,159,185,344,292
0130-001,2014,8,4,6,377,344,721,344
0130-001,2014,8,4,7,1126,670,1796,721
0130-001,2014,8,4,8,1722,1408,3130,1796
0130-001,2014,8,4,9,1761,1798,3559,3130
0130-001,2014,8,4,10,1634,1673,3307,3559
0130-001,2014,8,4,11,1677,1744,3421,3307
0130-001,2014,8,4,12,1686,1757,3443,3421
0130-001,2014,8,4,13,1570,1709,3279,3443
0130-001,2014,8,4,14,1726,1850,3576,3279
0130-001,2014,8,4,15,1740,1820,3560,3576
0130-001,2014,8,4,16,1850,1693,3543,3560
0130-001,2014,8,4,17,1784,1755,3539,3543
0130-001,2014,8,4,18,1923,2100,4023,3539
0130-001,2014,8,4,19,1837,2162,3999,4023
0130-001,2014,8,4,20,1424,1522,2946,3999
0130-001,2014,8,4,21,1091,1323,2414,2946
0130-001,2014,8,4,22,1032,1059,2091,2414
0130-001,2014,8,4,23,844,654,1498,2091
0130-001,2014,8,4,24,530,490,1020,1498
0130-001,2014,8,5,1,361,299,660,1020
0130-001,2014,8,5,2,232,200,432,660
0130-001,2014,8,5,3,187,167,354,432
0130-001,2014,8,5,4,153,182,335,354
0130-001,2014,8,5,5,184,210,394,335
0130-001,2014,8,5,6,399,361,760,394
0130-001,2014,8,5,7,1095,733,1828,760
0130-001,2014,8,5,8,1764,1406,3170,1828
0130-001,2014,8,5,9,1846,1770,3616,3170
0130-001,2014,8,5,10,1606,1672,3278,3616
0130-001,2014,8,5,11,1735,1700,3435,3278
0130-001,2014,8,5,12,1657,1682,3339,3435
0130-001,2014,8,5,13,1514,1650,3164,3339
0130-001,2014,8,5,14,1682,1713,3395,3164
0130-001,2014,8,5,15,1753,1789,3542,3395
0130-001,2014,8,5,16,1804,1827,3631,3542
0130-001,2014,8,5,17,1771,1769,3540,3631
0130-001,2014,8,5,18,1830,2162,3992,3540
0130-001,2014,8,5,19,1911,2256,4167,3992
0130-001,2014,8,5,20,1485,1706,3191,4167
0130-001,2014,8,5,21,1296,1427,2723,3191
0130-001,2014,8,5,22,1090,1069,2159,2723
0130-001,2014,8,5,23,936,746,1682,2159
0130-001,2014,8,5,24,585,541,1126,1682
0130-001,2014,8,6,1,421,345,766,1126
0130-001,2014,8,6,2,238,208,446,766
0130-001,2014,8,6,3,191,171,362,446
0130-001,2014,8,6,4,150,189,339,362
0130-001,2014,8,6,5,193,235,428,339
0130-001,2014,8,6,6,416,385,801,428
0130-001,2014,8,6,7,1165,712,1877,801
0130-001,2014,8,6,8,1814,1428,3242,1877
0130-001,2014,8,6,9,1913,1835,3748,3242
0130-001,2014,8,6,10,1734,1721,3455,3748
0130-001,2014,8,6,11,1735,1612,3347,3455
0130-001,2014,8,6,12,1666,1753,3419,3347
0130-001,2014,8,6,13,1574,1611,3185,3419
0130-001,2014,8,6,14,1717,1783,3500,3185
0130-001,2014,8,6,15,1824,1880,3704,3500
0130-001,2014,8,6,16,1801,1864,3665,3704
0130-001,2014,8,6,17,1827,1920,3747,3665
0130-001,2014,8,6,18,1764,2147,3911,3747
0130-001,2014,8,6,19,1854,2318,4172,3911
0130-001,2014,8,6,20,1544,1666,3210,4172
0130-001,2014,8,6,21,1214,1278,2492,3210
0130-001,2014,8,6,22,1040,1035,2075,2492
0130-001,2014,8,6,23,773,616,1389,2075
0130-001,2014,8,6,24,503,440,943,1389
0130-001,2014,8,7,1,363,293,656,943
0130-001,2014,8,7,2,230,180,410,656
0130-001,2014,8,7,3,170,170,340,410
0130-001,2014,8,7,4,150,163,313,340
0130-001,2014,8,7,5,166,200,366,313
0130-001,2014,8,7,6,322,330,652,366
0130-001,2014,8,7,7,1028,648,1676,652
0130-001,2014,8,7,8,1796,1385,3181,1676
0130-001,2014,8,7,9,1834,1743,3577,3181
0130-001,2014,8,7,10,1844,1593,3437,3577
0130-001,2014,8,7,11,1691,1739,3430,3437
0130-001,2014,8,7,12,1668,1759,3427,3430
0130-001,2014,8,7,13,1490,1595,3085,3427
0130-001,2014,8,7,14,1667,1727,3394,3085
0130-001,2014,8,7,15,1764,1817,3581,3394
0130-001,2014,8,7,16,1771,1812,3583,3581
0130-001,2014,8,7,17,1691,1748,3439,3583
0130-001,2014,8,7,18,1795,2097,3892,3439
0130-001,2014,8,7,19,1802,2345,4147,3892
0130-001,2014,8,7,20,1398,1610,3008,4147
0130-001,2014,8,7,21,1201,1445,2646,3008
0130-001,2014,8,7,22,1069,1175,2244,2646
0130-001,2014,8,7,23,878,721,1599,2244
0130-001,2014,8,7,24,577,465,1042,1599
0130-001,2014,8,8,1,368,339,707,1042
0130-001,2014,8,8,2,272,235,507,707
0130-001,2014,8,8,3,228,186,414,507
0130-001,2014,8,8,4,171,200,371,414
0130-001,2014,8,8,5,155,218,373,371
0130-001,2014,8,8,6,412,379,791,373
0130-001,2014,8,8,7,1193,744,1937,791
0130-001,2014,8,8,8,1909,1425,3334,1937
0130-001,2014,8,8,9,1944,1852,3796,3334
0130-001,2014,8,8,10,1731,1710,3441,3796
0130-001,2014,8,8,11,1830,1703,3533,3441
0130-001,2014,8,8,12,1670,1794,3464,3533
0130-001,2014,8,8,13,1505,1608,3113,3464
0130-001,2014,8,8,14,1658,1819,3477,3113
0130-001,2014,8,8,15,1919,1871,3790,3477
0130-001,2014,8,8,16,1869,1944,3813,3790
0130-001,2014,8,8,17,1943,1934,3877,3813
0130-001,2014,8,8,18,1942,2292,4234,3877
0130-001,2014,8,8,19,1962,2480,4442,4234
0130-001,2014,8,8,20,1586,1974,3560,4442
0130-001,2014,8,8,21,1456,1618,3074,3560
0130-001,2014,8,8,22,1177,1277,2454,3074
0130-001,2014,8,8,23,968,806,1774,2454
0130-001,2014,8,8,24,627,549,1176,1774
0130-001,2014,8,9,1,477,408,885,1176
0130-001,2014,8,9,2,355,269,624,885
0130-001,2014,8,9,3,243,235,478,624
0130-001,2014,8,9,4,246,229,475,478
0130-001,2014,8,9,5,260,268,528,475
0130-001,2014,8,9,6,441,409,850,528
0130-001,2014,8,9,7,908,694,1602,850
0130-001,2014,8,9,8,1386,977,2363,1602
0130-001,2014,8,9,9,1420,1540,2960,2363
0130-001,2014,8,9,10,1689,1705,3394,2960
0130-001,2014,8,9,11,1613,1770,3383,3394
0130-001,2014,8,9,12,1694,1972,3666,3383
0130-001,2014,8,9,13,1545,2038,3583,3666
0130-001,2014,8,9,14,1574,1812,3386,3583
0130-001,2014,8,9,15,1603,1815,3418,3386
0130-001,2014,8,9,16,1683,1704,3387,3418
0130-001,2014,8,9,17,1633,1727,3360,3387
0130-001,2014,8,9,18,1912,2126,4038,3360
0130-001,2014,8,9,19,1791,1808,3599,4038
0130-001,2014,8,9,20,1435,1371,2806,3599
0130-001,2014,8,9,21,1371,1164,2535,2806
0130-001,2014,8,9,22,1086,889,1975,2535
0130-001,2014,8,9,23,845,759,1604,1975
0130-001,2014,8,9,24,549,504,1053,1604
0130-001,2014,8,10,1,434,343,777,1053
0130-001,2014,8,10,2,353,266,619,777
0130-001,2014,8,10,3,250,214,464,619
0130-001,2014,8,10,4,180,161,341,464
0130-001,2014,8,10,5,208,178,386,341
0130-001,2014,8,10,6,293,295,588,386
0130-001,2014,8,10,7,634,411,1045,588
0130-001,2014,8,10,8,764,587,1351,1045
0130-001,2014,8,10,9,839,871,1710,1351
0130-001,2014,8,10,10,961,1056,2017,1710
0130-001,2014,8,10,11,1087,1177,2264,2017
0130-001,2014,8,10,12,1111,1185,2296,2264
0130-001,2014,8,10,13,1236,1471,2707,2296
0130-001,2014,8,10,14,1425,1345,2770,2707
0130-001,2014,8,10,15,1524,1382,2906,2770
0130-001,2014,8,10,16,1532,1492,3024,2906
0130-001,2014,8,10,17,1674,1443,3117,3024
0130-001,2014,8,10,18,1768,1527,3295,3117
0130-001,2014,8,10,19,1663,1336,2999,3295
0130-001,2014,8,10,20,1492,1036,2528,2999
0130-001,2014,8,10,21,1397,991,2388,2528
0130-001,2014,8,10,22,930,726,1656,2388
0130-001,2014,8,10,23,624,551,1175,1656
0130-001,2014,8,10,24,431,332,763,1175
0130-001,2014,8,11,1,272,233,505,763
0130-001,2014,8,11,2,180,168,348,505
0130-001,2014,8,11,3,118,116,234,348
0130-001,2014,8,11,4,117,169,286,234
0130-001,2014,8,11,5,182,200,382,286
0130-001,2014,8,11,6,458,401,859,382
0130-001,2014,8,11,7,1554,860,2414,859
0130-001,2014,8,11,8,1925,1655,3580,2414
0130-001,2014,8,11,9,1978,1826,3804,3580
0130-001,2014,8,11,10,1836,1660,3496,3804
0130-001,2014,8,11,11,1746,1747,3493,3496
0130-001,2014,8,11,12,1756,1674,3430,3493
0130-001,2014,8,11,13,1500,1568,3068,3430
0130-001,2014,8,11,14,1806,1818,3624,3068
0130-001,2014,8,11,15,1847,1830,3677,3624
0130-001,2014,8,11,16,1929,1966,3895,3677
0130-001,2014,8,11,17,1786,1933,3719,3895
0130-001,2014,8,11,18,1807,2236,4043,3719
0130-001,2014,8,11,19,1865,2480,4345,4043
0130-001,2014,8,11,20,1540,1961,3501,4345
0130-001,2014,8,11,21,1315,1745,3060,3501
0130-001,2014,8,11,22,1125,1302,2427,3060
0130-001,2014,8,11,23,864,803,1667,2427
0130-001,2014,8,11,24,544,451,995,1667
0130-001,2014,8,12,1,366,354,720,995
0130-001,2014,8,12,2,222,233,455,720
0130-001,2014,8,12,3,169,171,340,455
0130-001,2014,8,12,4,154,182,336,340
0130-001,2014,8,12,5,183,236,419,336
0130-001,2014,8,12,6,435,384,819,419
0130-001,2014,8,12,7,1395,842,2237,819
0130-001,2014,8,12,8,1858,1549,3407,2237
0130-001,2014,8,12,9,1995,1838,3833,3407
0130-001,2014,8,12,10,1835,1739,3574,3833
0130-001,2014,8,12,11,1819,1745,3564,3574
0130-001,2014,8,12,12,1671,1725,3396,3564
0130-001,2014,8,12,13,1518,1580,3098,3396
0130-001,2014,8,12,14,1696,1774,3470,3098
0130-001,2014,8,12,15,1882,1925,3807,3470
0130-001,2014,8,12,16,1846,1895,3741,3807
0130-001,2014,8,12,17,1809,1866,3675,3741
0130-001,2014,8,12,18,1818,2240,4058,3675
0130-001,2014,8,12,19,1803,2486,4289,4058
0130-001,2014,8,12,20,1492,1890,3382,4289
0130-001,2014,8,12,21,1290,1729,3019,3382
0130-001,2014,8,12,22,1143,1289,2432,3019
0130-001,2014,8,12,23,898,800,1698,2432
0130-001,2014,8,12,24,588,525,1113,1698
0130-001,2014,8,13,1,398,351,749,1113
0130-001,2014,8,13,2,243,248,491,749
0130-001,2014,8,13,3,201,154,355,491
0130-001,2014,8,13,4,157,194,351,355
0130-001,2014,8,13,5,192,184,376,351
0130-001,2014,8,13,6,425,436,861,376
0130-001,2014,8,13,7,1404,815,2219,861
0130-001,2014,8,13,8,1888,1591,3479,2219
0130-001,2014,8,13,9,1927,1866,3793,3479
0130-001,2014,8,13,10,1875,1700,3575,3793
0130-001,2014,8,13,11,1800,1728,3528,3575
0130-001,2014,8,13,12,1751,1876,3627,3528
0130-001,2014,8,13,13,1509,1829,3338,3627
0130-001,2014,8,13,14,1753,1872,3625,3338
0130-001,2014,8,13,15,1799,1894,3693,3625
0130-001,2014,8,13,16,1828,1895,3723,3693
0130-001,2014,8,13,17,1760,1859,3619,3723
0130-001,2014,8,13,18,1846,2196,4042,3619
0130-001,2014,8,13,19,1907,2401,4308,4042
0130-001,2014,8,13,20,1398,1889,3287,4308
0130-001,2014,8,13,21,1334,1632,2966,3287
0130-001,2014,8,13,22,1156,1226,2382,2966
0130-001,2014,8,13,23,942,742,1684,2382
0130-001,2014,8,13,24,514,506,1020,1684
0130-001,2014,8,14,1,377,316,693,1020
0130-001,2014,8,14,2,269,263,532,693
0130-001,2014,8,14,3,208,197,405,532
0130-001,2014,8,14,4,164,215,379,405
0130-001,2014,8,14,5,205,247,452,379
0130-001,2014,8,14,6,427,379,806,452
0130-001,2014,8,14,7,1337,772,2109,806
0130-001,2014,8,14,8,1914,1577,3491,2109
0130-001,2014,8,14,9,1912,1844,3756,3491
0130-001,2014,8,14,10,1691,1695,3386,3756
0130-001,2014,8,14,11,1810,1705,3515,3386
0130-001,2014,8,14,12,1724,1736,3460,3515
0130-001,2014,8,14,13,1492,1700,3192,3460
0130-001,2014,8,14,14,1725,1819,3544,3192
0130-001,2014,8,14,15,1847,1909,3756,3544
0130-001,2014,8,14,16,1850,1867,3717,3756
0130-001,2014,8,14,17,1796,1996,3792,3717
0130-001,2014,8,14,18,1937,2261,4198,3792
0130-001,2014,8,14,19,1949,2466,4415,4198
0130-001,2014,8,14,20,1620,2135,3755,4415
0130-001,2014,8,14,21,1463,1879,3342,3755
0130-001,2014,8,14,22,1271,1327,2598,3342
0130-001,2014,8,14,23,1025,793,1818,2598
0130-001,2014,8,14,24,648,593,1241,1818
0130-001,2014,8,15,1,478,416,894,1241
0130-001,2014,8,15,2,341,321,662,894
0130-001,2014,8,15,3,273,252,525,662
0130-001,2014,8,15,4,231,227,458,525
0130-001,2014,8,15,5,243,264,507,458
0130-001,2014,8,15,6,440,379,819,507
0130-001,2014,8,15,7,1068,667,1735,819
0130-001,2014,8,15,8,1497,1030,2527,1735
0130-001,2014,8,15,9,1315,1466,2781,2527
0130-001,2014,8,15,10,1467,1742,3209,2781
0130-001,2014,8,15,11,1448,2081,3529,3209
0130-001,2014,8,15,12,1550,2234,3784,3529
0130-001,2014,8,15,13,1326,2168,3494,3784
0130-001,2014,8,15,14,1389,2160,3549,3494
0130-001,2014,8,15,15,1447,2245,3692,3549
0130-001,2014,8,15,16,1618,2232,3850,3692
0130-001,2014,8,15,17,1561,2032,3593,3850
0130-001,2014,8,15,18,1788,2011,3799,3593
0130-001,2014,8,15,19,1789,1878,3667,3799
0130-001,2014,8,15,20,1477,1474,2951,3667
0130-001,2014,8,15,21,1336,1284,2620,2951
0130-001,2014,8,15,22,1185,990,2175,2620
0130-001,2014,8,15,23,841,642,1483,2175
0130-001,2014,8,15,24,559,508,1067,1483
0130-001,2014,8,16,1,403,403,806,1067
0130-001,2014,8,16,2,305,285,590,806
0130-001,2014,8,16,3,220,180,400,590
0130-001,2014,8,16,4,190,225,415,400
0130-001,2014,8,16,5,197,239,436,415
0130-001,2014,8,16,6,448,358,806,436
0130-001,2014,8,16,7,940,598,1538,806
0130-001,2014,8,16,8,1286,944,2230,1538
0130-001,2014,8,16,9,1302,1281,2583,2230
0130-001,2014,8,16,10,1419,1538,2957,2583
0130-001,2014,8,16,11,1380,1518,2898,2957
0130-001,2014,8,16,12,1591,1701,3292,2898
0130-001,2014,8,16,13,1517,1730,3247,3292
0130-001,2014,8,16,14,1546,1701,3247,3247
0130-001,2014,8,16,15,1641,1768,3409,3247
0130-001,2014,8,16,16,1745,1928,3673,3409
0130-001,2014,8,16,17,1981,2185,4166,3673
0130-001,2014,8,16,18,1885,2343,4228,4166
0130-001,2014,8,16,19,1918,1844,3762,4228
0130-001,2014,8,16,20,1866,1400,3266,3762
0130-001,2014,8,16,21,1681,1261,2942,3266
0130-001,2014,8,16,22,1504,956,2460,2942
0130-001,2014,8,16,23,1043,694,1737,2460
0130-001,2014,8,16,24,563,519,1082,1737
0130-001,2014,8,17,1,456,396,852,1082
0130-001,2014,8,17,2,311,254,565,852
0130-001,2014,8,17,3,235,228,463,565
0130-001,2014,8,17,4,184,151,335,463
0130-001,2014,8,17,5,194,162,356,335
0130-001,2014,8,17,6,308,279,587,356
0130-001,2014,8,17,7,541,436,977,587
0130-001,2014,8,17,8,679,600,1279,977
0130-001,2014,8,17,9,834,928,1762,1279
0130-001,2014,8,17,10,879,1014,1893,1762
0130-001,2014,8,17,11,1055,1236,2291,1893
0130-001,2014,8,17,12,1255,1408,2663,2291
0130-001,2014,8,17,13,1459,1585,3044,2663
0130-001,2014,8,17,14,1570,1444,3014,3044
0130-001,2014,8,17,15,1768,1490,3258,3014
0130-001,2014,8,17,16,1940,1553,3493,3258
0130-001,2014,8,17,17,1822,1435,3257,3493
0130-001,2014,8,17,18,1840,1438,3278,3257
0130-001,2014,8,17,19,1825,1350,3175,3278
0130-001,2014,8,17,20,1577,1096,2673,3175
0130-001,2014,8,17,21,1560,1005,2565,2673
0130-001,2014,8,17,22,994,724,1718,2565
0130-001,2014,8,17,23,731,517,1248,1718
0130-001,2014,8,17,24,412,389,801,1248
0130-001,2014,8,18,1,293,222,515,801
0130-001,2014,8,18,2,165,150,315,515
0130-001,2014,8,18,3,121,112,233,315
0130-001,2014,8,18,4,126,154,280,233
0130-001,2014,8,18,5,162,182,344,280
0130-001,2014,8,18,6,435,363,798,344
0130-001,2014,8,18,7,1536,838,2374,798
0130-001,2014,8,18,8,1845,1799,3644,2374
0130-001,2014,8,18,9,2016,1857,3873,3644
0130-001,2014,8,18,10,1689,1740,3429,3873
0130-001,2014,8,18,11,1700,1696,3396,3429
0130-001,2014,8,18,12,1655,1678,3333,3396
0130-001,2014,8,18,13,1472,1527,2999,3333
0130-001,2014,8,18,14,1775,1758,3533,2999
0130-001,2014,8,18,15,1841,1899,3740,3533
0130-001,2014,8,18,16,1873,1836,3709,3740
0130-001,2014,8,18,17,1697,1783,3480,3709
0130-001,2014,8,18,18,1727,2165,3892,3480
0130-001,2014,8,18,19,1722,2397,4119,3892
0130-001,2014,8,18,20,1395,1680,3075,4119
0130-001,2014,8,18,21,1146,1612,2758,3075
0130-001,2014,8,18,22,1075,1185,2260,2758
0130-001,2014,8,18,23,747,668,1415,2260
0130-001,2014,8,18,24,483,449,932,1415
0130-001,2014,8,19,1,323,311,634,932
0130-001,2014,8,19,2,217,194,411,634
0130-001,2014,8,19,3,176,145,321,411
0130-001,2014,8,19,4,140,182,322,321
0130-001,2014,8,19,5,180,203,383,322
0130-001,2014,8,19,6,351,353,704,383
0130-001,2014,8,19,7,1353,732,2085,704
0130-001,2014,8,19,8,1883,1642,3525,2085
0130-001,2014,8,19,9,2034,1980,4014,3525
0130-001,2014,8,19,10,1718,1701,3419,4014
0130-001,2014,8,19,11,1746,1723,3469,3419
0130-001,2014,8,19,12,1733,1678,3411,3469
0130-001,2014,8,19,13,1521,1495,3016,3411
0130-001,2014,8,19,14,1803,1714,3517,3016
0130-001,2014,8,19,15,1747,1777,3524,3517
0130-001,2014,8,19,16,1816,1854,3670,3524
0130-001,2014,8,19,17,1810,1871,3681,3670
0130-001,2014,8,19,18,1851,2096,3947,3681
0130-001,2014,8,19,19,1764,2458,4222,3947
0130-001,2014,8,19,20,1362,1852,3214,4222
0130-001,2014,8,19,21,1281,1760,3041,3214
0130-001,2014,8,19,22,1157,1278,2435,3041
0130-001,2014,8,19,23,904,769,1673,2435
0130-001,2014,8,19,24,557,527,1084,1673
0130-001,2014,8,20,1,390,367,757,1084
0130-001,2014,8,20,2,308,291,599,757
0130-001,2014,8,20,3,203,174,377,599
0130-001,2014,8,20,4,154,202,356,377
0130-001,2014,8,20,5,189,235,424,356
0130-001,2014,8,20,6,455,412,867,424
0130-001,2014,8,20,7,1454,789,2243,867
0130-001,2014,8,20,8,2081,1707,3788,2243
0130-001,2014,8,20,9,2046,1915,3961,3788
0130-001,2014,8,20,10,1799,1792,3591,3961
0130-001,2014,8,20,11,1827,1685,3512,3591
0130-001,2014,8,20,12,1799,1618,3417,3512
0130-001,2014,8,20,13,1481,1617,3098,3417
0130-001,2014,8,20,14,1721,1748,3469,3098
0130-001,2014,8,20,15,1425,1659,3084,3469
0130-001,2014,8,20,16,1997,1889,3886,3084
0130-001,2014,8,20,17,1739,1878,3617,3886
0130-001,2014,8,20,18,1868,2291,4159,3617
0130-001,2014,8,20,19,1801,2493,4294,4159
0130-001,2014,8,20,20,1517,2054,3571,4294
0130-001,2014,8,20,21,1258,1629,2887,3571
0130-001,2014,8,20,22,1222,1237,2459,2887
0130-001,2014,8,20,23,887,830,1717,2459
0130-001,2014,8,20,24,653,501,1154,1717
0130-001,2014,8,21,1,384,372,756,1154
0130-001,2014,8,21,2,254,244,498,756
0130-001,2014,8,21,3,206,180,386,498
0130-001,2014,8,21,4,153,193,346,386
0130-001,2014,8,21,5,188,199,387,346
0130-001,2014,8,21,6,319,354,673,387
0130-001,2014,8,21,7,1245,697,1942,673
0130-001,2014,8,21,8,1979,1692,3671,1942
0130-001,2014,8,21,9,2079,1948,4027,3671
0130-001,2014,8,21,10,1714,1655,3369,4027
0130-001,2014,8,21,11,1533,1499,3032,3369
0130-001,2014,8,21,12,1554,1537,3091,3032
0130-001,2014,8,21,13,1280,1486,2766,3091
0130-001,2014,8,21,14,1558,1743,3301,2766
0130-001,2014,8,21,15,1714,1764,3478,3301
0130-001,2014,8,21,16,1674,1735,3409,3478
0130-001,2014,8,21,17,1801,1789,3590,3409
0130-001,2014,8,21,18,1769,2061,3830,3590
0130-001,2014,8,21,19,1761,2332,4093,3830
0130-001,2014,8,21,20,1386,1772,3158,4093
0130-001,2014,8,21,21,1148,1614,2762,3158
0130-001,2014,8,21,22,1111,1291,2402,2762
0130-001,2014,8,21,23,861,750,1611,2402
0130-001,2014,8,21,24,569,525,1094,1611
0130-001,2014,8,22,1,383,348,731,1094
0130-001,2014,8,22,2,278,261,539,731
0130-001,2014,8,22,3,209,193,402,539
0130-001,2014,8,22,4,170,191,361,402
0130-001,2014,8,22,5,198,233,431,361
0130-001,2014,8,22,6,435,416,851,431
0130-001,2014,8,22,7,1453,754,2207,851
0130-001,2014,8,22,8,2101,1757,3858,2207
0130-001,2014,8,22,9,2094,1993,4087,3858
0130-001,2014,8,22,10,1846,1639,3485,4087
0130-001,2014,8,22,11,1797,1754,3551,3485
0130-001,2014,8,22,12,1782,1853,3635,3551
0130-001,2014,8,22,13,1562,1836,3398,3635
0130-001,2014,8,22,14,1809,1900,3709,3398
0130-001,2014,8,22,15,1931,1989,3920,3709
0130-001,2014,8,22,16,1852,2064,3916,3920
0130-001,2014,8,22,17,1870,2279,4149,3916
0130-001,2014,8,22,18,1904,2528,4432,4149
0130-001,2014,8,22,19,2009,2582,4591,4432
0130-001,2014,8,22,20,1738,2320,4058,4591
0130-001,2014,8,22,21,1548,1868,3416,4058
0130-001,2014,8,22,22,1305,1384,2689,3416
0130-001,2014,8,22,23,1024,918,1942,2689
0130-001,2014,8,22,24,737,707,1444,1942
0130-001,2014,8,23,1,525,493,1018,1444
0130-001,2014,8,23,2,381,369,750,1018
0130-001,2014,8,23,3,287,247,534,750
0130-001,2014,8,23,4,231,250,481,534
0130-001,2014,8,23,5,244,282,526,481
0130-001,2014,8,23,6,500,445,945,526
0130-001,2014,8,23,7,1079,747,1826,945
0130-001,2014,8,23,8,1588,1288,2876,1826
0130-001,2014,8,23,9,1641,1855,3496,2876
0130-001,2014,8,23,10,1703,2096,3799,3496
0130-001,2014,8,23,11,1704,2094,3798,3799
0130-001,2014,8,23,12,1723,2177,3900,3798
0130-001,2014,8,23,13,1646,2287,3933,3900
0130-001,2014,8,23,14,1708,2086,3794,3933
0130-001,2014,8,23,15,1787,2005,3792,3794
0130-001,2014,8,23,16,1963,1844,3807,3792
0130-001,2014,8,23,17,1965,1913,3878,3807
0130-001,2014,8,23,18,1680,2137,3817,3878
0130-001,2014,8,23,19,1951,2125,4076,3817
0130-001,2014,8,23,20,1818,1561,3379,4076
0130-001,2014,8,23,21,1658,1332,2990,3379
0130-001,2014,8,23,22,1318,1014,2332,2990
0130-001,2014,8,23,23,951,784,1735,2332
0130-001,2014,8,23,24,595,539,1134,1735
0130-001,2014,8,24,1,452,405,857,1134
0130-001,2014,8,24,2,335,278,613,857
0130-001,2014,8,24,3,247,233,480,613
0130-001,2014,8,24,4,191,174,365,480
0130-001,2014,8,24,5,213,169,382,365
0130-001,2014,8,24,6,335,346,681,382
0130-001,2014,8,24,7,731,571,1302,681
0130-001,2014,8,24,8,932,858,1790,1302
0130-001,2014,8,24,9,961,1083,2044,1790
0130-001,2014,8,24,10,996,1124,2120,2044
0130-001,2014,8,24,11,1230,1247,2477,2120
0130-001,2014,8,24,12,1338,1247,2585,2477
0130-001,2014,8,24,13,1570,1411,2981,2585
0130-001,2014,8,24,14,1944,1438,3382,2981
0130-001,2014,8,24,15,1888,1547,3435,3382
0130-001,2014,8,24,16,1873,1434,3307,3435
0130-001,2014,8,24,17,2087,1525,3612,3307
0130-001,2014,8,24,18,2165,1562,3727,3612
0130-001,2014,8,24,19,1986,1486,3472,3727
0130-001,2014,8,24,20,1873,1207,3080,3472
0130-001,2014,8,24,21,1943,1106,3049,3080
0130-001,2014,8,24,22,1521,829,2350,3049
0130-001,2014,8,24,23,905,634,1539,2350
0130-001,2014,8,24,24,560,398,958,1539
0130-001,2014,8,25,1,302,278,580,958
0130-001,2014,8,25,2,170,162,332,580
0130-001,2014,8,25,3,119,117,236,332
0130-001,2014,8,25,4,112,150,262,236
0130-001,2014,8,25,5,193,198,391,262
0130-001,2014,8,25,6,417,378,795,391
0130-001,2014,8,25,7,1439,784,2223,795
0130-001,2014,8,25,8,2009,1774,3783,2223
0130-001,2014,8,25,9,2043,1961,4004,3783
0130-001,2014,8,25,10,1728,1711,3439,4004
0130-001,2014,8,25,11,1797,1710,3507,3439
0130-001,2014,8,25,12,1688,1664,3352,3507
0130-001,2014,8,25,13,1449,1622,3071,3352
0130-001,2014,8,25,14,1762,1769,3531,3071
0130-001,2014,8,25,15,1767,1828,3595,3531
0130-001,2014,8,25,16,1945,1839,3784,3595
0130-001,2014,8,25,17,1820,1910,3730,3784
0130-001,2014,8,25,18,1784,2237,4021,3730
0130-001,2014,8,25,19,1815,2452,4267,4021
0130-001,2014,8,25,20,1425,1951,3376,4267
0130-001,2014,8,25,21,1263,1686,2949,3376
0130-001,2014,8,25,22,1108,1315,2423,2949
0130-001,2014,8,25,23,868,750,1618,2423
0130-001,2014,8,25,24,522,504,1026,1618
0130-001,2014,8,26,1,379,369,748,1026
0130-001,2014,8,26,2,214,217,431,748
0130-001,2014,8,26,3,161,149,310,431
0130-001,2014,8,26,4,152,215,367,310
0130-001,2014,8,26,5,213,233,446,367
0130-001,2014,8,26,6,422,423,845,446
0130-001,2014,8,26,7,1454,812,2266,845
0130-001,2014,8,26,8,2104,1787,3891,2266
0130-001,2014,8,26,9,2169,2001,4170,3891
0130-001,2014,8,26,10,1946,1744,3690,4170
0130-001,2014,8,26,11,1785,1713,3498,3690
0130-001,2014,8,26,12,1666,1642,3308,3498
0130-001,2014,8,26,13,1493,1504,2997,3308
0130-001,2014,8,26,14,1806,1750,3556,2997
0130-001,2014,8,26,15,1900,1874,3774,3556
0130-001,2014,8,26,16,1805,1901,3706,3774
0130-001,2014,8,26,17,1806,1968,3774,3706
0130-001,2014,8,26,18,1858,2275,4133,3774
0130-001,2014,8,26,19,1843,2542,4385,4133
0130-001,2014,8,26,20,1543,2009,3552,4385
0130-001,2014,8,26,21,1308,1777,3085,3552
0130-001,2014,8,26,22,1192,1437,2629,3085
0130-001,2014,8,26,23,968,820,1788,2629
0130-001,2014,8,26,24,593,521,1114,1788
0130-001,2014,8,27,1,376,363,739,1114
0130-001,2014,8,27,2,279,263,542,739
0130-001,2014,8,27,3,214,174,388,542
0130-001,2014,8,27,4,145,211,356,388
0130-001,2014,8,27,5,205,231,436,356
0130-001,2014,8,27,6,469,447,916,436
0130-001,2014,8,27,7,1511,823,2334,916
0130-001,2014,8,27,8,2076,1769,3845,2334
0130-001,2014,8,27,9,2142,1940,4082,3845
0130-001,2014,8,27,10,1942,1832,3774,4082
0130-001,2014,8,27,11,1861,1819,3680,3774
0130-001,2014,8,27,12,1798,1714,3512,3680
0130-001,2014,8,27,13,1589,1586,3175,3512
0130-001,2014,8,27,14,1785,1832,3617,3175
0130-001,2014,8,27,15,1848,1899,3747,3617
0130-001,2014,8,27,16,1803,2000,3803,3747
0130-001,2014,8,27,17,1785,1917,3702,3803
0130-001,2014,8,27,18,1887,2338,4225,3702
0130-001,2014,8,27,19,1840,2612,4452,4225
0130-001,2014,8,27,20,1563,2040,3603,4452
0130-001,2014,8,27,21,1371,1724,3095,3603
0130-001,2014,8,27,22,1278,1315,2593,3095
0130-001,2014,8,27,23,933,827,1760,2593
0130-001,2014,8,27,24,657,515,1172,1760
0130-001,2014,8,28,1,413,399,812,1172
0130-001,2014,8,28,2,282,274,556,812
0130-001,2014,8,28,3,185,146,331,556
0130-001,2014,8,28,4,156,228,384,331
0130-001,2014,8,28,5,224,220,444,384
0130-001,2014,8,28,6,435,447,882,444
0130-001,2014,8,28,7,1502,831,2333,882
0130-001,2014,8,28,8,2121,1780,3901,2333
0130-001,2014,8,28,9,1858,2019,3877,3901
0130-001,2014,8,28,10,2064,1727,3791,3877
0130-001,2014,8,28,11,1764,1780,3544,3791
0130-001,2014,8,28,12,1673,1780,3453,3544
0130-001,2014,8,28,13,1546,1624,3170,3453
0130-001,2014,8,28,14,1757,1709,3466,3170
0130-001,2014,8,28,15,1947,1876,3823,3466
0130-001,2014,8,28,16,1807,1948,3755,3823
0130-001,2014,8,28,17,1959,1985,3944,3755
0130-001,2014,8,28,18,1895,2342,4237,3944
0130-001,2014,8,28,19,1813,2618,4431,4237
0130-001,2014,8,28,20,1559,2020,3579,4431
0130-001,2014,8,28,21,1296,1782,3078,3579
0130-001,2014,8,28,22,1222,1375,2597,3078
0130-001,2014,8,28,23,986,843,1829,2597
0130-001,2014,8,28,24,653,537,1190,1829
0130-001,2014,8,29,1,465,395,860,1190
0130-001,2014,8,29,2,302,280,582,860
0130-001,2014,8,29,3,204,208,412,582
0130-001,2014,8,29,4,166,234,400,412
0130-001,2014,8,29,5,211,241,452,400
0130-001,2014,8,29,6,482,418,900,452
0130-001,2014,8,29,7,1507,839,2346,900
0130-001,2014,8,29,8,2096,1793,3889,2346
0130-001,2014,8,29,9,2205,1990,4195,3889
0130-001,2014,8,29,10,1759,1745,3504,4195
0130-001,2014,8,29,11,1836,1777,3613,3504
0130-001,2014,8,29,12,1757,1677,3434,3613
0130-001,2014,8,29,13,1613,1719,3332,3434
0130-001,2014,8,29,14,1791,1839,3630,3332
0130-001,2014,8,29,15,1871,1920,3791,3630
0130-001,2014,8,29,16,1944,1998,3942,3791
0130-001,2014,8,29,17,1946,2085,4031,3942
0130-001,2014,8,29,18,1908,2448,4356,4031
0130-001,2014,8,29,19,1954,2776,4730,4356
0130-001,2014,8,29,20,1611,2309,3920,4730
0130-001,2014,8,29,21,1487,1880,3367,3920
0130-001,2014,8,29,22,1360,1446,2806,3367
0130-001,2014,8,29,23,1020,895,1915,2806
0130-001,2014,8,29,24,706,637,1343,1915
0130-001,2014,8,30,1,530,497,1027,1343
0130-001,2014,8,30,2,359,311,670,1027
0130-001,2014,8,30,3,272,254,526,670
0130-001,2014,8,30,4,238,262,500,526
0130-001,2014,8,30,5,273,285,558,500
0130-001,2014,8,30,6,502,454,956,558
0130-001,2014,8,30,7,1104,821,1925,956
0130-001,2014,8,30,8,1681,1285,2966,1925
0130-001,2014,8,30,9,1785,1810,3595,2966
0130-001,2014,8,30,10,1731,2066,3797,3595
0130-001,2014,8,30,11,1831,2189,4020,3797
0130-001,2014,8,30,12,1772,2268,4040,4020
0130-001,2014,8,30,13,1856,2284,4140,4040
0130-001,2014,8,30,14,2023,2161,4184,4140
0130-001,2014,8,30,15,1985,2036,4021,4184
0130-001,2014,8,30,16,2130,1921,4051,4021
0130-001,2014,8,30,17,1936,2037,3973,4051
0130-001,2014,8,30,18,1980,2206,4186,3973
0130-001,2014,8,30,19,1994,2031,4025,4186
0130-001,2014,8,30,20,1846,1545,3391,4025
0130-001,2014,8,30,21,1665,1367,3032,3391
0130-001,2014,8,30,22,1307,975,2282,3032
0130-001,2014,8,30,23,889,833,1722,2282
0130-001,2014,8,30,24,615,556,1171,1722
0130-001,2014,8,31,1,467,403,870,1171
0130-001,2014,8,31,2,328,308,636,870
0130-001,2014,8,31,3,252,240,492,636
0130-001,2014,8,31,4,187,165,352,492
0130-001,2014,8,31,5,247,202,449,352
0130-001,2014,8,31,6,353,334,687,449
0130-001,2014,8,31,7,782,537,1319,687
0130-001,2014,8,31,8,944,846,1790,1319
0130-001,2014,8,31,9,1060,1137,2197,1790
0130-001,2014,8,31,10,1116,1259,2375,2197
0130-001,2014,8,31,11,1307,1378,2685,2375
0130-001,2014,8,31,12,1231,1530,2761,2685
0130-001,2014,8,31,13,1496,1665,3161,2761
0130-001,2014,8,31,14,1814,1688,3502,3161
0130-001,2014,8,31,15,2012,1764,3776,3502
0130-001,2014,8,31,16,1939,1785,3724,3776
0130-001,2014,8,31,17,2023,1700,3723,3724
0130-001,2014,8,31,18,2005,1646,3651,3723
0130-001,2014,8,31,19,1988,1546,3534,3651
0130-001,2014,8,31,20,1765,1361,3126,3534
0130-001,2014,8,31,21,1672,1148,2820,3126
0130-001,2014,8,31,22,1149,1008,2157,2820
0130-001,2014,8,31,23,779,642,1421,2157
0130-001,2014,8,31,24,472,474,946,1421
0130-001,2014,9,1,1,299,244,543,946
0130-001,2014,9,1,2,171,172,343,543
0130-001,2014,9,1,3,135,147,282,343
0130-001,2014,9,1,4,116,166,282,282
0130-001,2014,9,1,5,199,212,411,282
0130-001,2014,9,1,6,517,444,961,411
0130-001,2014,9,1,7,1626,883,2509,961
0130-001,2014,9,1,8,2112,1892,4004,2509
0130-001,2014,9,1,9,2113,1988,4101,4004
0130-001,2014,9,1,10,1797,1824,3621,4101
0130-001,2014,9,1,11,1951,1827,3778,3621
0130-001,2014,9,1,12,1776,1698,3474,3778
0130-001,2014,9,1,13,1557,1574,3131,3474
0130-001,2014,9,1,14,1846,1769,3615,3131
0130-001,2014,9,1,15,1923,1908,3831,3615
0130-001,2014,9,1,16,1932,1971,3903,3831
0130-001,2014,9,1,17,1836,2136,3972,3903
0130-001,2014,9,1,18,1907,2378,4285,3972
0130-001,2014,9,1,19,1807,2514,4321,4285
0130-001,2014,9,1,20,1556,2022,3578,4321
0130-001,2014,9,1,21,1310,1812,3122,3578
0130-001,2014,9,1,22,1204,1402,2606,3122
0130-001,2014,9,1,23,889,866,1755,2606
0130-001,2014,9,1,24,598,553,1151,1755
0130-001,2014,9,2,1,420,382,802,1151
0130-001,2014,9,2,2,245,279,524,802
0130-001,2014,9,2,3,200,178,378,524
0130-001,2014,9,2,4,142,205,347,378
0130-001,2014,9,2,5,214,225,439,347
0130-001,2014,9,2,6,464,436,900,439
0130-001,2014,9,2,7,1495,808,2303,900
0130-001,2014,9,2,8,2079,1792,3871,2303
0130-001,2014,9,2,9,2169,2012,4181,3871
0130-001,2014,9,2,10,1990,1762,3752,4181
0130-001,2014,9,2,11,1848,1842,3690,3752
0130-001,2014,9,2,12,1917,1728,3645,3690
0130-001,2014,9,2,13,1617,1596,3213,3645
0130-001,2014,9,2,14,1888,1874,3762,3213
0130-001,2014,9,2,15,1871,2010,3881,3762
0130-001,2014,9,2,16,1840,2054,3894,3881
0130-001,2014,9,2,17,1806,2057,3863,3894
0130-001,2014,9,2,18,1927,2305,4232,3863
0130-001,2014,9,2,19,1857,2554,4411,4232
0130-001,2014,9,2,20,1520,2039,3559,4411
0130-001,2014,9,2,21,1317,1847,3164,3559
0130-001,2014,9,2,22,1195,1330,2525,3164
0130-001,2014,9,2,23,937,812,1749,2525
0130-001,2014,9,2,24,581,561,1142,1749
0130-001,2014,9,3,1,406,349,755,1142
0130-001,2014,9,3,2,250,253,503,755
0130-001,2014,9,3,3,151,186,337,503
0130-001,2014,9,3,4,166,183,349,337
0130-001,2014,9,3,5,184,201,385,349
0130-001,2014,9,3,6,344,387,731,385
0130-001,2014,9,3,7,1275,673,1948,731
0130-001,2014,9,3,8,2026,1721,3747,1948
0130-001,2014,9,3,9,1992,1948,3940,3747
0130-001,2014,9,3,10,1777,1748,3525,3940
0130-001,2014,9,3,11,1832,1855,3687,3525
0130-001,2014,9,3,12,1848,1797,3645,3687
0130-001,2014,9,3,13,1610,1639,3249,3645
0130-001,2014,9,3,14,1892,1808,3700,3249
0130-001,2014,9,3,15,1888,1846,3734,3700
0130-001,2014,9,3,16,1841,1939,3780,3734
0130-001,2014,9,3,17,1831,2080,3911,3780
0130-001,2014,9,3,18,1872,2382,4254,3911
0130-001,2014,9,3,19,1846,2615,4461,4254
0130-001,2014,9,3,20,1531,2014,3545,4461
0130-001,2014,9,3,21,1356,1649,3005,3545
0130-001,2014,9,3,22,1312,1357,2669,3005
0130-001,2014,9,3,23,1010,877,1887,2669
0130-001,2014,9,3,24,631,583,1214,1887
0130-001,2014,9,4,1,454,388,842,1214
0130-001,2014,9,4,2,267,296,563,842
0130-001,2014,9,4,3,210,194,404,563
0130-001,2014,9,4,4,169,211,380,404
0130-001,2014,9,4,5,216,239,455,380
0130-001,2014,9,4,6,416,415,831,455
0130-001,2014,9,4,7,1428,808,2236,831
0130-001,2014,9,4,8,2150,1800,3950,2236
0130-001,2014,9,4,9,2143,2086,4229,3950
0130-001,2014,9,4,10,1955,1844,3799,4229
0130-001,2014,9,4,11,1921,1912,3833,3799
0130-001,2014,9,4,12,1932,1882,3814,3833
0130-001,2014,9,4,13,1718,1670,3388,3814
0130-001,2014,9,4,14,1946,1873,3819,3388
0130-001,2014,9,4,15,1957,2029,3986,3819
0130-001,2014,9,4,16,1869,2087,3956,3986
0130-001,2014,9,4,17,1915,2224,4139,3956
0130-001,2014,9,4,18,1913,2432,4345,4139
0130-001,2014,9,4,19,1989,2679,4668,4345
0130-001,2014,9,4,20,1701,2343,4044,4668
0130-001,2014,9,4,21,1462,1945,3407,4044
0130-001,2014,9,4,22,1349,1453,2802,3407
0130-001,2014,9,4,23,1104,943,2047,2802
0130-001,2014,9,4,24,664,584,1248,2047
0130-001,2014,9,5,1,464,429,893,1248
0130-001,2014,9,5,2,274,295,569,893
0130-001,2014,9,5,3,221,240,461,569
0130-001,2014,9,5,4,177,213,390,461
0130-001,2014,9,5,5,222,261,483,390
0130-001,2014,9,5,6,436,419,855,483
0130-001,2014,9,5,7,1464,805,2269,855
0130-001,2014,9,5,8,2109,1797,3906,2269
0130-001,2014,9,5,9,2231,2039,4270,3906
0130-001,2014,9,5,10,1904,1845,3749,4270
0130-001,2014,9,5,11,1939,2011,3950,3749
0130-001,2014,9,5,12,1986,2053,4039,3950
0130-001,2014,9,5,13,1813,1931,3744,4039
0130-001,2014,9,5,14,1850,2043,3893,3744
0130-001,2014,9,5,15,2040,2202,4242,3893
0130-001,2014,9,5,16,1929,2232,4161,4242
0130-001,2014,9,5,17,1997,2322,4319,4161
0130-001,2014,9,5,18,1959,2764,4723,4319
0130-001,2014,9,5,19,1857,2605,4462,4723
0130-001,2014,9,5,20,1678,2420,4098,4462
0130-001,2014,9,5,21,1381,1909,3290,4098
0130-001,2014,9,5,22,1268,1330,2598,3290
0130-001,2014,9,5,23,1034,908,1942,2598
0130-001,2014,9,5,24,703,742,1445,1942
0130-001,2014,9,6,1,492,539,1031,1445
0130-001,2014,9,6,2,365,406,771,1031
0130-001,2014,9,6,3,278,316,594,771
0130-001,2014,9,6,4,227,330,557,594
0130-001,2014,9,6,5,255,326,581,557
0130-001,2014,9,6,6,388,597,985,581
0130-001,2014,9,6,7,825,1475,2300,985
0130-001,2014,9,6,8,1105,1930,3035,2300
0130-001,2014,9,6,9,1257,2483,3740,3035
0130-001,2014,9,6,10,1317,2247,3564,3740
0130-001,2014,9,6,11,1566,2086,3652,3564
0130-001,2014,9,6,12,1669,1883,3552,3652
0130-001,2014,9,6,13,1642,1777,3419,3552
0130-001,2014,9,6,14,1657,1824,3481,3419
0130-001,2014,9,6,15,1625,1794,3419,3481
0130-001,2014,9,6,16,1757,1759,3516,3419
0130-001,2014,9,6,17,1727,1765,3492,3516
0130-001,2014,9,6,18,1680,1726,3406,3492
0130-001,2014,9,6,19,1645,1654,3299,3406
0130-001,2014,9,6,20,1282,1342,2624,3299
0130-001,2014,9,6,21,1099,1074,2173,2624
0130-001,2014,9,6,22,901,835,1736,2173
0130-001,2014,9,6,23,794,679,1473,1736
0130-001,2014,9,6,24,535,521,1056,1473
0130-001,2014,9,7,1,370,381,751,1056
0130-001,2014,9,7,2,276,260,536,751
0130-001,2014,9,7,3,218,217,435,536
0130-001,2014,9,7,4,151,186,337,435
0130-001,2014,9,7,5,184,226,410,337
0130-001,2014,9,7,6,221,375,596,410
0130-001,2014,9,7,7,391,584,975,596
0130-001,2014,9,7,8,572,992,1564,975
0130-001,2014,9,7,9,787,1313,2100,1564
0130-001,2014,9,7,10,1170,1634,2804,2100
0130-001,2014,9,7,11,1350,1694,3044,2804
0130-001,2014,9,7,12,1404,1832,3236,3044
0130-001,2014,9,7,13,1401,1705,3106,3236
0130-001,2014,9,7,14,1351,1540,2891,3106
0130-001,2014,9,7,15,1308,1481,2789,2891
0130-001,2014,9,7,16,1336,1430,2766,2789
0130-001,2014,9,7,17,1267,1330,2597,2766
0130-001,2014,9,7,18,1257,1182,2439,2597
0130-001,2014,9,7,19,1109,958,2067,2439
0130-001,2014,9,7,20,944,896,1840,2067
0130-001,2014,9,7,21,765,844,1609,1840
0130-001,2014,9,7,22,638,615,1253,1609
0130-001,2014,9,7,23,466,481,947,1253
0130-001,2014,9,7,24,353,330,683,947
0130-001,2014,9,8,1,275,234,509,683
0130-001,2014,9,8,2,215,162,377,509
0130-001,2014,9,8,3,140,105,245,377
0130-001,2014,9,8,4,81,91,172,245
0130-001,2014,9,8,5,113,112,225,172
0130-001,2014,9,8,6,215,208,423,225
0130-001,2014,9,8,7,599,428,1027,423
0130-001,2014,9,8,8,1058,922,1980,1027
0130-001,2014,9,8,9,843,924,1767,1980
0130-001,2014,9,8,10,965,1072,2037,1767
0130-001,2014,9,8,11,1690,1630,3320,2037
0130-001,2014,9,8,12,2015,2165,4180,3320
0130-001,2014,9,8,13,1970,2167,4137,4180
0130-001,2014,9,8,14,2280,2273,4553,4137
0130-001,2014,9,8,15,2237,2321,4558,4553
0130-001,2014,9,8,16,2291,2456,4747,4558
0130-001,2014,9,8,17,2175,2456,4631,4747
0130-001,2014,9,8,18,2142,2149,4291,4631
0130-001,2014,9,8,19,2160,1767,3927,4291
0130-001,2014,9,8,20,2202,1172,3374,3927
0130-001,2014,9,8,21,2034,947,2981,3374
0130-001,2014,9,8,22,2062,825,2887,2981
0130-001,2014,9,8,23,2120,641,2761,2887
0130-001,2014,9,8,24,1423,433,1856,2761
0130-001,2014,9,9,1,1282,287,1569,1856
0130-001,2014,9,9,2,951,195,1146,1569
0130-001,2014,9,9,3,686,168,854,1146
0130-001,2014,9,9,4,321,116,437,854
0130-001,2014,9,9,5,199,117,316,437
0130-001,2014,9,9,6,204,176,380,316
0130-001,2014,9,9,7,388,232,620,380
0130-001,2014,9,9,8,536,358,894,620
0130-001,2014,9,9,9,771,457,1228,894
0130-001,2014,9,9,10,1094,696,1790,1228
0130-001,2014,9,9,11,1512,979,2491,1790
0130-001,2014,9,9,12,1827,1277,3104,2491
0130-001,2014,9,9,13,2024,1285,3309,3104
0130-001,2014,9,9,14,1908,1271,3179,3309
0130-001,2014,9,9,15,1979,1418,3397,3179
0130-001,2014,9,9,16,2044,1343,3387,3397
0130-001,2014,9,9,17,2198,1341,3539,3387
0130-001,2014,9,9,18,2135,1280,3415,3539
0130-001,2014,9,9,19,2164,1240,3404,3415
0130-001,2014,9,9,20,2020,1097,3117,3404
0130-001,2014,9,9,21,1941,911,2852,3117
0130-001,2014,9,9,22,1943,785,2728,2852
0130-001,2014,9,9,23,1571,616,2187,2728
0130-001,2014,9,9,24,1884,416,2300,2187
0130-001,2014,9,10,1,1117,326,1443,2300
0130-001,2014,9,10,2,910,261,1171,1443
0130-001,2014,9,10,3,650,179,829,1171
0130-001,2014,9,10,4,198,112,310,829
0130-001,2014,9,10,5,171,141,312,310
0130-001,2014,9,10,6,263,234,497,312
0130-001,2014,9,10,7,650,414,1064,497
0130-001,2014,9,10,8,1151,763,1914,1064
0130-001,2014,9,10,9,1106,1029,2135,1914
0130-001,2014,9,10,10,1243,1160,2403,2135
0130-001,2014,9,10,11,1373,1394,2767,2403
0130-001,2014,9,10,12,1486,1554,3040,2767
0130-001,2014,9,10,13,1559,1490,3049,3040
0130-001,2014,9,10,14,1627,1573,3200,3049
0130-001,2014,9,10,15,1689,1636,3325,3200
0130-001,2014,9,10,16,1763,1564,3327,3325
0130-001,2014,9,10,17,1861,1603,3464,3327
0130-001,2014,9,10,18,1740,1663,3403,3464
0130-001,2014,9,10,19,1697,1661,3358,3403
0130-001,2014,9,10,20,1490,1364,2854,3358
0130-001,2014,9,10,21,1236,1175,2411,2854
0130-001,2014,9,10,22,1102,822,1924,2411
0130-001,2014,9,10,23,748,547,1295,1924
0130-001,2014,9,10,24,508,398,906,1295
0130-001,2014,9,11,1,339,301,640,906
0130-001,2014,9,11,2,224,188,412,640
0130-001,2014,9,11,3,148,132,280,412
0130-001,2014,9,11,4,156,158,314,280
0130-001,2014,9,11,5,180,194,374,314
0130-001,2014,9,11,6,424,432,856,374
0130-001,2014,9,11,7,1415,825,2240,856
0130-001,2014,9,11,8,2169,1780,3949,2240
0130-001,2014,9,11,9,2093,1986,4079,3949
0130-001,2014,9,11,10,1772,1699,3471,4079
0130-001,2014,9,11,11,1709,1760,3469,3471
0130-001,2014,9,11,12,1635,1619,3254,3469
0130-001,2014,9,11,13,1503,1546,3049,3254
0130-001,2014,9,11,14,1740,1678,3418,3049
0130-001,2014,9,11,15,1863,1845,3708,3418
0130-001,2014,9,11,16,1820,1850,3670,3708
0130-001,2014,9,11,17,1764,1930,3694,3670
0130-001,2014,9,11,18,1844,2236,4080,3694
0130-001,2014,9,11,19,1785,2457,4242,4080
0130-001,2014,9,11,20,1396,1846,3242,4242
0130-001,2014,9,11,21,1240,1585,2825,3242
0130-001,2014,9,11,22,1158,1184,2342,2825
0130-001,2014,9,11,23,820,735,1555,2342
0130-001,2014,9,11,24,548,475,1023,1555
0130-001,2014,9,12,1,406,321,727,1023
0130-001,2014,9,12,2,235,243,478,727
0130-001,2014,9,12,3,192,183,375,478
0130-001,2014,9,12,4,131,163,294,375
0130-001,2014,9,12,5,192,237,429,294
0130-001,2014,9,12,6,391,394,785,429
0130-001,2014,9,12,7,1485,781,2266,785
0130-001,2014,9,12,8,2104,1777,3881,2266
0130-001,2014,9,12,9,2158,2020,4178,3881
0130-001,2014,9,12,10,1773,1760,3533,4178
0130-001,2014,9,12,11,1787,1733,3520,3533
0130-001,2014,9,12,12,1780,1744,3524,3520
0130-001,2014,9,12,13,1525,1593,3118,3524
0130-001,2014,9,12,14,1817,1792,3609,3118
0130-001,2014,9,12,15,1970,1883,3853,3609
0130-001,2014,9,12,16,1912,1958,3870,3853
0130-001,2014,9,12,17,1926,1970,3896,3870
0130-001,2014,9,12,18,1922,2445,4367,3896
0130-001,2014,9,12,19,1865,2643,4508,4367
0130-001,2014,9,12,20,1648,2125,3773,4508
0130-001,2014,9,12,21,1346,1787,3133,3773
0130-001,2014,9,12,22,1203,1302,2505,3133
0130-001,2014,9,12,23,962,832,1794,2505
0130-001,2014,9,12,24,636,589,1225,1794
0130-001,2014,9,13,1,471,429,900,1225
0130-001,2014,9,13,2,354,301,655,900
0130-001,2014,9,13,3,260,242,502,655
0130-001,2014,9,13,4,220,229,449,502
0130-001,2014,9,13,5,255,274,529,449
0130-001,2014,9,13,6,423,424,847,529
0130-001,2014,9,13,7,1024,745,1769,847
0130-001,2014,9,13,8,1635,1123,2758,1769
0130-001,2014,9,13,9,1686,1711,3397,2758
0130-001,2014,9,13,10,1787,1757,3544,3397
0130-001,2014,9,13,11,1756,1814,3570,3544
0130-001,2014,9,13,12,1669,1872,3541,3570
0130-001,2014,9,13,13,1588,1969,3557,3541
0130-001,2014,9,13,14,1801,1802,3603,3557
0130-001,2014,9,13,15,1708,1921,3629,3603
0130-001,2014,9,13,16,1809,1823,3632,3629
0130-001,2014,9,13,17,1867,1854,3721,3632
0130-001,2014,9,13,18,2008,2171,4179,3721
0130-001,2014,9,13,19,2064,1986,4050,4179
0130-001,2014,9,13,20,1506,1518,3024,4050
0130-001,2014,9,13,21,1196,1149,2345,3024
0130-001,2014,9,13,22,1132,884,2016,2345
0130-001,2014,9,13,23,826,675,1501,2016
0130-001,2014,9,13,24,573,492,1065,1501
0130-001,2014,9,14,1,396,353,749,1065
0130-001,2014,9,14,2,333,289,622,749
0130-001,2014,9,14,3,211,205,416,622
0130-001,2014,9,14,4,189,160,349,416
0130-001,2014,9,14,5,221,186,407,349
0130-001,2014,9,14,6,293,299,592,407
0130-001,2014,9,14,7,661,436,1097,592
0130-001,2014,9,14,8,846,687,1533,1097
0130-001,2014,9,14,9,886,956,1842,1533
0130-001,2014,9,14,10,986,1033,2019,1842
0130-001,2014,9,14,11,1198,1312,2510,2019
0130-001,2014,9,14,12,1201,1261,2462,2510
0130-001,2014,9,14,13,1243,1438,2681,2462
0130-001,2014,9,14,14,1484,1487,2971,2681
0130-001,2014,9,14,15,1544,1431,2975,2971
0130-001,2014,9,14,16,1585,1476,3061,2975
0130-001,2014,9,14,17,1666,1508,3174,3061
0130-001,2014,9,14,18,1711,1580,3291,3174
0130-001,2014,9,14,19,1455,1403,2858,3291
0130-001,2014,9,14,20,1188,1155,2343,2858
0130-001,2014,9,14,21,1104,953,2057,2343
0130-001,2014,9,14,22,834,751,1585,2057
0130-001,2014,9,14,23,622,568,1190,1585
0130-001,2014,9,14,24,423,325,748,1190
0130-001,2014,9,15,1,258,252,510,748
0130-001,2014,9,15,2,176,167,343,510
0130-001,2014,9,15,3,128,132,260,343
0130-001,2014,9,15,4,134,155,289,260
0130-001,2014,9,15,5,179,216,395,289
0130-001,2014,9,15,6,462,452,914,395
0130-001,2014,9,15,7,1609,891,2500,914
0130-001,2014,9,15,8,2104,1873,3977,2500
0130-001,2014,9,15,9,2208,2020,4228,3977
0130-001,2014,9,15,10,1936,1740,3676,4228
0130-001,2014,9,15,11,1853,1760,3613,3676
0130-001,2014,9,15,12,1748,1665,3413,3613
0130-001,2014,9,15,13,1586,1556,3142,3413
0130-001,2014,9,15,14,1907,1954,3861,3142
0130-001,2014,9,15,15,1883,1882,3765,3861
0130-001,2014,9,15,16,1869,1912,3781,3765
0130-001,2014,9,15,17,1813,1955,3768,3781
0130-001,2014,9,15,18,1752,2402,4154,3768
0130-001,2014,9,15,19,1861,2693,4554,4154
0130-001,2014,9,15,20,1462,1911,3373,4554
0130-001,2014,9,15,21,1231,1714,2945,3373
0130-001,2014,9,15,22,1188,1270,2458,2945
0130-001,2014,9,15,23,844,797,1641,2458
0130-001,2014,9,15,24,540,517,1057,1641
0130-001,2014,9,16,1,369,337,706,1057
0130-001,2014,9,16,2,237,231,468,706
0130-001,2014,9,16,3,193,154,347,468
0130-001,2014,9,16,4,159,205,364,347
0130-001,2014,9,16,5,200,233,433,364
0130-001,2014,9,16,6,395,402,797,433
0130-001,2014,9,16,7,1501,826,2327,797
0130-001,2014,9,16,8,2096,1785,3881,2327
0130-001,2014,9,16,9,2119,2028,4147,3881
0130-001,2014,9,16,10,1979,1770,3749,4147
0130-001,2014,9,16,11,1874,1802,3676,3749
0130-001,2014,9,16,12,1658,1704,3362,3676
0130-001,2014,9,16,13,1569,1581,3150,3362
0130-001,2014,9,16,14,1891,1872,3763,3150
0130-001,2014,9,16,15,1818,1851,3669,3763
0130-001,2014,9,16,16,1835,1803,3638,3669
0130-001,2014,9,16,17,1832,1968,3800,3638
0130-001,2014,9,16,18,1860,2396,4256,3800
0130-001,2014,9,16,19,1802,2605,4407,4256
0130-001,2014,9,16,20,1479,1934,3413,4407
0130-001,2014,9,16,21,1308,1709,3017,3413
0130-001,2014,9,16,22,1205,1378,2583,3017
0130-001,2014,9,16,23,883,797,1680,2583
0130-001,2014,9,16,24,578,604,1182,1680
0130-001,2014,9,17,1,409,334,743,1182
0130-001,2014,9,17,2,229,216,445,743
0130-001,2014,9,17,3,174,187,361,445
0130-001,2014,9,17,4,144,223,367,361
0130-001,2014,9,17,5,200,218,418,367
0130-001,2014,9,17,6,434,443,877,418
0130-001,2014,9,17,7,1496,872,2368,877
0130-001,2014,9,17,8,2107,1772,3879,2368
0130-001,2014,9,17,9,2133,2105,4238,3879
0130-001,2014,9,17,10,1802,1766,3568,4238
0130-001,2014,9,17,11,1835,1729,3564,3568
0130-001,2014,9,17,12,1751,1707,3458,3564
0130-001,2014,9,17,13,1522,1501,3023,3458
0130-001,2014,9,17,14,1776,1710,3486,3023
0130-001,2014,9,17,15,1828,1801,3629,3486
0130-001,2014,9,17,16,1900,1866,3766,3629
0130-001,2014,9,17,17,1776,1895,3671,3766
0130-001,2014,9,17,18,1917,2352,4269,3671
0130-001,2014,9,17,19,1845,2651,4496,4269
0130-001,2014,9,17,20,1503,2036,3539,4496
0130-001,2014,9,17,21,1270,1605,2875,3539
0130-001,2014,9,17,22,1196,1250,2446,2875
0130-001,2014,9,17,23,889,796,1685,2446
0130-001,2014,9,17,24,603,506,1109,1685
0130-001,2014,9,18,1,461,347,808,1109
0130-001,2014,9,18,2,271,262,533,808
0130-001,2014,9,18,3,198,173,371,533
0130-001,2014,9,18,4,164,220,384,371
0130-001,2014,9,18,5,205,236,441,384
0130-001,2014,9,18,6,429,447,876,441
0130-001,2014,9,18,7,1470,836,2306,876
0130-001,2014,9,18,8,2106,1835,3941,2306
0130-001,2014,9,18,9,2193,2013,4206,3941
0130-001,2014,9,18,10,1875,1772,3647,4206
0130-001,2014,9,18,11,1828,1729,3557,3647
0130-001,2014,9,18,12,1684,1585,3269,3557
0130-001,2014,9,18,13,1441,1547,2988,3269
0130-001,2014,9,18,14,1809,1737,3546,2988
0130-001,2014,9,18,15,1889,1796,3685,3546
0130-001,2014,9,18,16,1545,1717,3262,3685
0130-001,2014,9,18,17,1893,2061,3954,3262
0130-001,2014,9,18,18,1806,2349,4155,3954
0130-001,2014,9,18,19,1829,2533,4362,4155
0130-001,2014,9,18,20,1459,1929,3388,4362
0130-001,2014,9,18,21,1225,1732,2957,3388
0130-001,2014,9,18,22,1265,1297,2562,2957
0130-001,2014,9,18,23,918,845,1763,2562
0130-001,2014,9,18,24,612,533,1145,1763
0130-001,2014,9,19,1,422,357,779,1145
0130-001,2014,9,19,2,255,279,534,779
0130-001,2014,9,19,3,205,198,403,534
0130-001,2014,9,19,4,159,193,352,403
0130-001,2014,9,19,5,205,215,420,352
0130-001,2014,9,19,6,465,451,916,420
0130-001,2014,9,19,7,1501,843,2344,916
0130-001,2014,9,19,8,2069,1848,3917,2344
0130-001,2014,9,19,9,2190,2059,4249,3917
0130-001,2014,9,19,10,1830,1717,3547,4249
0130-001,2014,9,19,11,1849,1755,3604,3547
0130-001,2014,9,19,12,1758,1695,3453,3604
0130-001,2014,9,19,13,1455,1584,3039,3453
0130-001,2014,9,19,14,1727,1796,3523,3039
0130-001,2014,9,19,15,1924,1869,3793,3523
0130-001,2014,9,19,16,1906,1929,3835,3793
0130-001,2014,9,19,17,1852,2081,3933,3835
0130-001,2014,9,19,18,1976,2375,4351,3933
0130-001,2014,9,19,19,1983,2684,4667,4351
0130-001,2014,9,19,20,1669,2241,3910,4667
0130-001,2014,9,19,21,1460,1806,3266,3910
0130-001,2014,9,19,22,1346,1354,2700,3266
0130-001,2014,9,19,23,1038,875,1913,2700
0130-001,2014,9,19,24,692,622,1314,1913
0130-001,2014,9,20,1,510,438,948,1314
0130-001,2014,9,20,2,354,329,683,948
0130-001,2014,9,20,3,251,245,496,683
0130-001,2014,9,20,4,191,205,396,496
0130-001,2014,9,20,5,221,262,483,396
0130-001,2014,9,20,6,425,420,845,483
0130-001,2014,9,20,7,1041,744,1785,845
0130-001,2014,9,20,8,1621,1209,2830,1785
0130-001,2014,9,20,9,1837,1784,3621,2830
0130-001,2014,9,20,10,1716,1867,3583,3621
0130-001,2014,9,20,11,1812,2019,3831,3583
0130-001,2014,9,20,12,1847,2206,4053,3831
0130-001,2014,9,20,13,1820,2189,4009,4053
0130-001,2014,9,20,14,1820,1865,3685,4009
0130-001,2014,9,20,15,1844,1891,3735,3685
0130-001,2014,9,20,16,1906,1879,3785,3735
0130-001,2014,9,20,17,2004,1837,3841,3785
0130-001,2014,9,20,18,1997,2123,4120,3841
0130-001,2014,9,20,19,1945,2074,4019,4120
0130-001,2014,9,20,20,1714,1525,3239,4019
0130-001,2014,9,20,21,1336,1156,2492,3239
0130-001,2014,9,20,22,1117,958,2075,2492
0130-001,2014,9,20,23,837,696,1533,2075
0130-001,2014,9,20,24,592,510,1102,1533
0130-001,2014,9,21,1,447,358,805,1102
0130-001,2014,9,21,2,333,256,589,805
0130-001,2014,9,21,3,264,223,487,589
0130-001,2014,9,21,4,182,158,340,487
0130-001,2014,9,21,5,202,187,389,340
0130-001,2014,9,21,6,298,298,596,389
0130-001,2014,9,21,7,644,491,1135,596
0130-001,2014,9,21,8,782,673,1455,1135
0130-001,2014,9,21,9,901,909,1810,1455
0130-001,2014,9,21,10,1049,1162,2211,1810
0130-001,2014,9,21,11,1195,1402,2597,2211
0130-001,2014,9,21,12,1180,1505,2685,2597
0130-001,2014,9,21,13,1407,1522,2929,2685
0130-001,2014,9,21,14,1469,1470,2939,2929
0130-001,2014,9,21,15,1616,1597,3213,2939
0130-001,2014,9,21,16,1659,1575,3234,3213
0130-001,2014,9,21,17,1858,1652,3510,3234
0130-001,2014,9,21,18,1966,1609,3575,3510
0130-001,2014,9,21,19,1901,1493,3394,3575
0130-001,2014,9,21,20,1453,1324,2777,3394
0130-001,2014,9,21,21,1340,1113,2453,2777
0130-001,2014,9,21,22,1069,824,1893,2453
0130-001,2014,9,21,23,737,553,1290,1893
0130-001,2014,9,21,24,424,380,804,1290
0130-001,2014,9,22,1,302,268,570,804
0130-001,2014,9,22,2,164,143,307,570
0130-001,2014,9,22,3,133,113,246,307
0130-001,2014,9,22,4,119,132,251,246
0130-001,2014,9,22,5,190,206,396,251
0130-001,2014,9,22,6,448,418,866,396
0130-001,2014,9,22,7,1648,812,2460,866
0130-001,2014,9,22,8,2075,2020,4095,2460
0130-001,2014,9,22,9,2180,2208,4388,4095
0130-001,2014,9,22,10,1732,2047,3779,4388
0130-001,2014,9,22,11,1831,1748,3579,3779
0130-001,2014,9,22,12,1711,1740,3451,3579
0130-001,2014,9,22,13,1595,1592,3187,3451
0130-001,2014,9,22,14,1832,1728,3560,3187
0130-001,2014,9,22,15,1888,1848,3736,3560
0130-001,2014,9,22,16,1852,1899,3751,3736
0130-001,2014,9,22,17,1802,2014,3816,3751
0130-001,2014,9,22,18,1890,2256,4146,3816
0130-001,2014,9,22,19,1898,2505,4403,4146
0130-001,2014,9,22,20,1482,1991,3473,4403
0130-001,2014,9,22,21,1261,1702,2963,3473
0130-001,2014,9,22,22,1118,1333,2451,2963
0130-001,2014,9,22,23,866,804,1670,2451
0130-001,2014,9,22,24,571,491,1062,1670
0130-001,2014,9,23,1,389,315,704,1062
0130-001,2014,9,23,2,216,237,453,704
0130-001,2014,9,23,3,161,160,321,453
0130-001,2014,9,23,4,147,186,333,321
0130-001,2014,9,23,5,190,238,428,333
0130-001,2014,9,23,6,438,418,856,428
0130-001,2014,9,23,7,1539,799,2338,856
0130-001,2014,9,23,8,2054,1822,3876,2338
0130-001,2014,9,23,9,2195,2052,4247,3876
0130-001,2014,9,23,10,1933,1844,3777,4247
0130-001,2014,9,23,11,1932,1804,3736,3777
0130-001,2014,9,23,12,1716,1669,3385,3736
0130-001,2014,9,23,13,1570,1644,3214,3385
0130-001,2014,9,23,14,1845,1852,3697,3214
0130-001,2014,9,23,15,1909,1829,3738,3697
0130-001,2014,9,23,16,1818,1874,3692,3738
0130-001,2014,9,23,17,1852,1948,3800,3692
0130-001,2014,9,23,18,1840,2331,4171,3800
0130-001,2014,9,23,19,1823,2470,4293,4171
0130-001,2014,9,23,20,1454,2060,3514,4293
0130-001,2014,9,23,21,1302,1757,3059,3514
0130-001,2014,9,23,22,1203,1369,2572,3059
0130-001,2014,9,23,23,937,781,1718,2572
0130-001,2014,9,23,24,526,519,1045,1718
0130-001,2014,9,24,1,372,331,703,1045
0130-001,2014,9,24,2,237,235,472,703
0130-001,2014,9,24,3,164,160,324,472
0130-001,2014,9,24,4,144,171,315,324
0130-001,2014,9,24,5,176,200,376,315
0130-001,2014,9,24,6,311,330,641,376
0130-001,2014,9,24,7,1233,644,1877,641
0130-001,2014,9,24,8,2005,1753,3758,1877
0130-001,2014,9,24,9,2058,2056,4114,3758
0130-001,2014,9,24,10,1694,1715,3409,4114
0130-001,2014,9,24,11,1637,1582,3219,3409
0130-001,2014,9,24,12,1555,1615,3170,3219
0130-001,2014,9,24,13,1398,1398,2796,3170
0130-001,2014,9,24,14,1688,1643,3331,2796
0130-001,2014,9,24,15,1778,1783,3561,3331
0130-001,2014,9,24,16,1775,1711,3486,3561
0130-001,2014,9,24,17,1757,1865,3622,3486
0130-001,2014,9,24,18,1796,2356,4152,3622
0130-001,2014,9,24,19,1868,2591,4459,4152
0130-001,2014,9,24,20,1384,1867,3251,4459
0130-001,2014,9,24,21,1221,1497,2718,3251
0130-001,2014,9,24,22,1220,1263,2483,2718
0130-001,2014,9,24,23,957,792,1749,2483
0130-001,2014,9,24,24,607,498,1105,1749
0130-001,2014,9,25,1,430,345,775,1105
0130-001,2014,9,25,2,252,253,505,775
0130-001,2014,9,25,3,163,168,331,505
0130-001,2014,9,25,4,173,171,344,331
0130-001,2014,9,25,5,202,247,449,344
0130-001,2014,9,25,6,413,403,816,449
0130-001,2014,9,25,7,1461,771,2232,816
0130-001,2014,9,25,8,2131,1775,3906,2232
0130-001,2014,9,25,9,2121,2129,4250,3906
0130-001,2014,9,25,10,1821,1715,3536,4250
0130-001,2014,9,25,11,1924,1747,3671,3536
0130-001,2014,9,25,12,1640,1690,3330,3671
0130-001,2014,9,25,13,1794,1612,3406,3330
0130-001,2014,9,25,14,1871,1812,3683,3406
0130-001,2014,9,25,15,1841,1794,3635,3683
0130-001,2014,9,25,16,1868,1877,3745,3635
0130-001,2014,9,25,17,1839,2000,3839,3745
0130-001,2014,9,25,18,1885,2467,4352,3839
0130-001,2014,9,25,19,1834,2659,4493,4352
0130-001,2014,9,25,20,1530,2036,3566,4493
0130-001,2014,9,25,21,1282,1699,2981,3566
0130-001,2014,9,25,22,1286,1358,2644,2981
0130-001,2014,9,25,23,943,912,1855,2644
0130-001,2014,9,25,24,629,542,1171,1855
0130-001,2014,9,26,1,424,411,835,1171
0130-001,2014,9,26,2,281,285,566,835
0130-001,2014,9,26,3,198,193,391,566
0130-001,2014,9,26,4,179,194,373,391
0130-001,2014,9,26,5,218,244,462,373
0130-001,2014,9,26,6,430,389,819,462
0130-001,2014,9,26,7,1474,795,2269,819
0130-001,2014,9,26,8,2156,1830,3986,2269
0130-001,2014,9,26,9,2109,2133,4242,3986
0130-001,2014,9,26,10,1859,1875,3734,4242
0130-001,2014,9,26,11,1894,1967,3861,3734
0130-001,2014,9,26,12,1808,1935,3743,3861
0130-001,2014,9,26,13,1622,1825,3447,3743
0130-001,2014,9,26,14,1844,1887,3731,3447
0130-001,2014,9,26,15,1849,1937,3786,3731
0130-001,2014,9,26,16,1940,1973,3913,3786
0130-001,2014,9,26,17,1896,2110,4006,3913
0130-001,2014,9,26,18,1953,2442,4395,4006
0130-001,2014,9,26,19,1863,2525,4388,4395
0130-001,2014,9,26,20,1653,2226,3879,4388
0130-001,2014,9,26,21,1409,1740,3149,3879
0130-001,2014,9,26,22,1248,1314,2562,3149
0130-001,2014,9,26,23,1040,895,1935,2562
0130-001,2014,9,26,24,637,610,1247,1935
0130-001,2014,9,27,1,504,416,920,1247
0130-001,2014,9,27,2,373,307,680,920
0130-001,2014,9,27,3,281,247,528,680
0130-001,2014,9,27,4,219,254,473,528
0130-001,2014,9,27,5,231,243,474,473
0130-001,2014,9,27,6,447,450,897,474
0130-001,2014,9,27,7,1057,711,1768,897
0130-001,2014,9,27,8,1576,1151,2727,1768
0130-001,2014,9,27,9,1770,1714,3484,2727
0130-001,2014,9,27,10,1840,1868,3708,3484
0130-001,2014,9,27,11,1779,2104,3883,3708
0130-001,2014,9,27,12,1745,2446,4191,3883
0130-001,2014,9,27,13,1718,2279,3997,4191
0130-001,2014,9,27,14,1721,2058,3779,3997
0130-001,2014,9,27,15,1818,2039,3857,3779
0130-001,2014,9,27,16,1974,2004,3978,3857
0130-001,2014,9,27,17,1965,1927,3892,3978
0130-001,2014,9,27,18,1991,2243,4234,3892
0130-001,2014,9,27,19,2002,2069,4071,4234
0130-001,2014,9,27,20,1540,1543,3083,4071
0130-001,2014,9,27,21,1331,1199,2530,3083
0130-001,2014,9,27,22,1158,949,2107,2530
0130-001,2014,9,27,23,861,696,1557,2107
0130-001,2014,9,27,24,595,467,1062,1557
0130-001,2014,9,28,1,434,387,821,1062
0130-001,2014,9,28,2,330,292,622,821
0130-001,2014,9,28,3,245,212,457,622
0130-001,2014,9,28,4,206,192,398,457
0130-001,2014,9,28,5,229,194,423,398
0130-001,2014,9,28,6,301,302,603,423
0130-001,2014,9,28,7,604,420,1024,603
0130-001,2014,9,28,8,793,705,1498,1024
0130-001,2014,9,28,9,905,970,1875,1498
0130-001,2014,9,28,10,1123,1148,2271,1875
0130-001,2014,9,28,11,1257,1337,2594,2271
0130-001,2014,9,28,12,1111,1347,2458,2594
0130-001,2014,9,28,13,1330,1418,2748,2458
0130-001,2014,9,28,14,1406,1355,2761,2748
0130-001,2014,9,28,15,1505,1486,2991,2761
0130-001,2014,9,28,16,1692,1436,3128,2991
0130-001,2014,9,28,17,1743,1532,3275,3128
0130-001,2014,9,28,18,1899,1598,3497,3275
0130-001,2014,9,28,19,1884,1464,3348,3497
0130-001,2014,9,28,20,1496,1227,2723,3348
0130-001,2014,9,28,21,1251,1020,2271,2723
0130-001,2014,9,28,22,965,761,1726,2271
0130-001,2014,9,28,23,700,591,1291,1726
0130-001,2014,9,28,24,448,355,803,1291
0130-001,2014,9,29,1,260,248,508,803
0130-001,2014,9,29,2,155,159,314,508
0130-001,2014,9,29,3,139,117,256,314
0130-001,2014,9,29,4,131,167,298,256
0130-001,2014,9,29,5,193,213,406,298
0130-001,2014,9,29,6,431,417,848,406
0130-001,2014,9,29,7,1426,773,2199,848
0130-001,2014,9,29,8,2040,1804,3844,2199
0130-001,2014,9,29,9,2079,1995,4074,3844
0130-001,2014,9,29,10,1693,1724,3417,4074
0130-001,2014,9,29,11,1763,1659,3422,3417
0130-001,2014,9,29,12,1670,1595,3265,3422
0130-001,2014,9,29,13,1455,1568,3023,3265
0130-001,2014,9,29,14,1711,1736,3447,3023
0130-001,2014,9,29,15,1814,1890,3704,3447
0130-001,2014,9,29,16,1785,1828,3613,3704
0130-001,2014,9,29,17,1765,1959,3724,3613
0130-001,2014,9,29,18,1842,2205,4047,3724
0130-001,2014,9,29,19,1797,2450,4247,4047
0130-001,2014,9,29,20,1399,1755,3154,4247
0130-001,2014,9,29,21,1220,1704,2924,3154
0130-001,2014,9,29,22,1101,1296,2397,2924
0130-001,2014,9,29,23,867,750,1617,2397
0130-001,2014,9,29,24,521,497,1018,1617
0130-001,2014,9,30,1,385,360,745,1018
0130-001,2014,9,30,2,257,211,468,745
0130-001,2014,9,30,3,199,189,388,468
0130-001,2014,9,30,4,151,177,328,388
0130-001,2014,9,30,5,215,239,454,328
0130-001,2014,9,30,6,417,419,836,454
0130-001,2014,9,30,7,1421,766,2187,836
0130-001,2014,9,30,8,2150,1844,3994,2187
0130-001,2014,9,30,9,2170,2222,4392,3994
0130-001,2014,9,30,10,1937,2092,4029,4392
0130-001,2014,9,30,11,1898,1963,3861,4029
0130-001,2014,9,30,12,1679,1684,3363,3861
0130-001,2014,9,30,13,1576,1631,3207,3363
0130-001,2014,9,30,14,1906,1859,3765,3207
0130-001,2014,9,30,15,1882,1886,3768,3765
0130-001,2014,9,30,16,1803,1929,3732,3768
0130-001,2014,9,30,17,1875,2004,3879,3732
0130-001,2014,9,30,18,1848,2281,4129,3879
0130-001,2014,9,30,19,1768,2560,4328,4129
0130-001,2014,9,30,20,1442,1906,3348,4328
0130-001,2014,9,30,21,1250,1736,2986,3348
0130-001,2014,9,30,22,1242,1263,2505,2986
0130-001,2014,9,30,23,1021,844,1865,2505
0130-001,2014,9,30,24,648,591,1239,1865
0130-001,2014,10,1,1,412,379,791,1239
0130-001,2014,10,1,2,256,274,530,791
0130-001,2014,10,1,3,189,185,374,530
0130-001,2014,10,1,4,184,181,365,374
0130-001,2014,10,1,5,202,266,468,365
0130-001,2014,10,1,6,441,435,876,468
0130-001,2014,10,1,7,1516,803,2319,876
0130-001,2014,10,1,8,2117,1819,3936,2319
0130-001,2014,10,1,9,2125,2133,4258,3936
0130-001,2014,10,1,10,1921,1850,3771,4258
0130-001,2014,10,1,11,1858,1839,3697,3771
0130-001,2014,10,1,12,1758,1760,3518,3697
0130-001,2014,10,1,13,1539,1640,3179,3518
0130-001,2014,10,1,14,1821,1836,3657,3179
0130-001,2014,10,1,15,1883,1801,3684,3657
0130-001,2014,10,1,16,1890,1870,3760,3684
0130-001,2014,10,1,17,1762,1964,3726,3760
0130-001,2014,10,1,18,1907,2468,4375,3726
0130-001,2014,10,1,19,1844,2651,4495,4375
0130-001,2014,10,1,20,1479,1963,3442,4495
0130-001,2014,10,1,21,1311,1593,2904,3442
0130-001,2014,10,1,22,1235,1222,2457,2904
0130-001,2014,10,1,23,917,819,1736,2457
0130-001,2014,10,1,24,579,522,1101,1736
0130-001,2014,10,2,1,410,376,786,1101
0130-001,2014,10,2,2,281,249,530,786
0130-001,2014,10,2,3,195,192,387,530
0130-001,2014,10,2,4,146,189,335,387
0130-001,2014,10,2,5,176,213,389,335
0130-001,2014,10,2,6,410,407,817,389
0130-001,2014,10,2,7,1439,770,2209,817
0130-001,2014,10,2,8,2143,1819,3962,2209
0130-001,2014,10,2,9,2104,2047,4151,3962
0130-001,2014,10,2,10,1829,1770,3599,4151
0130-001,2014,10,2,11,1825,1826,3651,3599
0130-001,2014,10,2,12,1658,1703,3361,3651
0130-001,2014,10,2,13,1618,1647,3265,3361
0130-001,2014,10,2,14,1907,1793,3700,3265
0130-001,2014,10,2,15,1932,1926,3858,3700
0130-001,2014,10,2,16,1892,1911,3803,3858
0130-001,2014,10,2,17,1855,1976,3831,3803
0130-001,2014,10,2,18,1925,2460,4385,3831
0130-001,2014,10,2,19,1902,2581,4483,4385
0130-001,2014,10,2,20,1591,2155,3746,4483
0130-001,2014,10,2,21,1362,1783,3145,3746
0130-001,2014,10,2,22,1243,1324,2567,3145
0130-001,2014,10,2,23,1017,950,1967,2567
0130-001,2014,10,2,24,698,648,1346,1967
0130-001,2014,10,3,1,487,435,922,1346
0130-001,2014,10,3,2,316,323,639,922
0130-001,2014,10,3,3,257,217,474,639
0130-001,2014,10,3,4,186,213,399,474
0130-001,2014,10,3,5,245,265,510,399
0130-001,2014,10,3,6,418,456,874,510
0130-001,2014,10,3,7,1020,632,1652,874
0130-001,2014,10,3,8,1545,1078,2623,1652
0130-001,2014,10,3,9,1471,1545,3016,2623
0130-001,2014,10,3,10,1586,1904,3490,3016
0130-001,2014,10,3,11,1727,2269,3996,3490
0130-001,2014,10,3,12,1526,2499,4025,3996
0130-001,2014,10,3,13,1387,2471,3858,4025
0130-001,2014,10,3,14,1496,2646,4142,3858
0130-001,2014,10,3,15,1671,2635,4306,4142
0130-001,2014,10,3,16,1690,2505,4195,4306
0130-001,2014,10,3,17,1744,2432,4176,4195
0130-001,2014,10,3,18,1878,2336,4214,4176
0130-001,2014,10,3,19,1817,2154,3971,4214
0130-001,2014,10,3,20,1509,1476,2985,3971
0130-001,2014,10,3,21,1206,1108,2314,2985
0130-001,2014,10,3,22,1124,840,1964,2314
0130-001,2014,10,3,23,847,644,1491,1964
0130-001,2014,10,3,24,553,452,1005,1491
0130-001,2014,10,4,1,390,338,728,1005
0130-001,2014,10,4,2,265,223,488,728
0130-001,2014,10,4,3,214,185,399,488
0130-001,2014,10,4,4,187,185,372,399
0130-001,2014,10,4,5,190,241,431,372
0130-001,2014,10,4,6,358,365,723,431
0130-001,2014,10,4,7,856,595,1451,723
0130-001,2014,10,4,8,1301,929,2230,1451
0130-001,2014,10,4,9,1400,1500,2900,2230
0130-001,2014,10,4,10,1574,1453,3027,2900
0130-001,2014,10,4,11,1596,1854,3450,3027
0130-001,2014,10,4,12,1598,1806,3404,3450
0130-001,2014,10,4,13,1679,1964,3643,3404
0130-001,2014,10,4,14,1803,1723,3526,3643
0130-001,2014,10,4,15,1783,1661,3444,3526
0130-001,2014,10,4,16,1891,1806,3697,3444
0130-001,2014,10,4,17,1918,1680,3598,3697
0130-001,2014,10,4,18,2019,2041,4060,3598
0130-001,2014,10,4,19,1904,1750,3654,4060
0130-001,2014,10,4,20,1804,1340,3144,3654
0130-001,2014,10,4,21,1579,1058,2637,3144
0130-001,2014,10,4,22,1430,935,2365,2637
0130-001,2014,10,4,23,880,683,1563,2365
0130-001,2014,10,4,24,587,530,1117,1563
0130-001,2014,10,5,1,396,375,771,1117
0130-001,2014,10,5,2,282,277,559,771
0130-001,2014,10,5,3,249,208,457,559
0130-001,2014,10,5,4,191,182,373,457
0130-001,2014,10,5,5,179,143,322,373
0130-001,2014,10,5,6,257,262,519,322
0130-001,2014,10,5,7,528,422,950,519
0130-001,2014,10,5,8,710,636,1346,950
0130-001,2014,10,5,9,935,942,1877,1346
0130-001,2014,10,5,10,981,1076,2057,1877
0130-001,2014,10,5,11,1219,1364,2583,2057
0130-001,2014,10,5,12,1236,1431,2667,2583
0130-001,2014,10,5,13,1634,1475,3109,2667
0130-001,2014,10,5,14,1998,1473,3471,3109
0130-001,2014,10,5,15,2047,1589,3636,3471
0130-001,2014,10,5,16,2047,1623,3670,3636
0130-001,2014,10,5,17,2028,1619,3647,3670
0130-001,2014,10,5,18,1991,1754,3745,3647
0130-001,2014,10,5,19,2005,1545,3550,3745
0130-001,2014,10,5,20,1679,1278,2957,3550
0130-001,2014,10,5,21,1423,1052,2475,2957
0130-001,2014,10,5,22,1102,780,1882,2475
0130-001,2014,10,5,23,774,548,1322,1882
0130-001,2014,10,5,24,446,363,809,1322
0130-001,2014,10,6,1,287,239,526,809
0130-001,2014,10,6,2,190,154,344,526
0130-001,2014,10,6,3,135,123,258,344
0130-001,2014,10,6,4,107,149,256,258
0130-001,2014,10,6,5,194,224,418,256
0130-001,2014,10,6,6,448,431,879,418
0130-001,2014,10,6,7,1549,876,2425,879
0130-001,2014,10,6,8,2089,1865,3954,2425
0130-001,2014,10,6,9,2173,2043,4216,3954
0130-001,2014,10,6,10,1861,1676,3537,4216
0130-001,2014,10,6,11,1831,1820,3651,3537
0130-001,2014,10,6,12,1785,1773,3558,3651
0130-001,2014,10,6,13,1635,1563,3198,3558
0130-001,2014,10,6,14,1797,1755,3552,3198
0130-001,2014,10,6,15,1969,1928,3897,3552
0130-001,2014,10,6,16,1894,1930,3824,3897
0130-001,2014,10,6,17,1794,2071,3865,3824
0130-001,2014,10,6,18,1913,2375,4288,3865
0130-001,2014,10,6,19,1787,2498,4285,4288
0130-001,2014,10,6,20,1399,1917,3316,4285
0130-001,2014,10,6,21,1258,1717,2975,3316
0130-001,2014,10,6,22,1080,1266,2346,2975
0130-001,2014,10,6,23,805,813,1618,2346
0130-001,2014,10,6,24,533,483,1016,1618
0130-001,2014,10,7,1,348,334,682,1016
0130-001,2014,10,7,2,235,224,459,682
0130-001,2014,10,7,3,184,173,357,459
0130-001,2014,10,7,4,147,158,305,357
0130-001,2014,10,7,5,203,239,442,305
0130-001,2014,10,7,6,404,408,812,442
0130-001,2014,10,7,7,1496,835,2331,812
0130-001,2014,10,7,8,2081,1777,3858,2331
0130-001,2014,10,7,9,2177,2047,4224,3858
0130-001,2014,10,7,10,1944,1773,3717,4224
0130-001,2014,10,7,11,1897,1809,3706,3717
0130-001,2014,10,7,12,1627,1741,3368,3706
0130-001,2014,10,7,13,1426,1581,3007,3368
0130-001,2014,10,7,14,1764,1821,3585,3007
0130-001,2014,10,7,15,1659,1894,3553,3585
0130-001,2014,10,7,16,1913,1881,3794,3553
0130-001,2014,10,7,17,1848,2026,3874,3794
0130-001,2014,10,7,18,1912,2417,4329,3874
0130-001,2014,10,7,19,1788,2438,4226,4329
0130-001,2014,10,7,20,1363,1905,3268,4226
0130-001,2014,10,7,21,1205,1761,2966,3268
0130-001,2014,10,7,22,1167,1400,2567,2966
0130-001,2014,10,7,23,894,834,1728,2567
0130-001,2014,10,7,24,588,484,1072,1728
0130-001,2014,10,8,1,389,357,746,1072
0130-001,2014,10,8,2,238,242,480,746
0130-001,2014,10,8,3,172,147,319,480
0130-001,2014,10,8,4,155,161,316,319
0130-001,2014,10,8,5,205,230,435,316
0130-001,2014,10,8,6,406,388,794,435
0130-001,2014,10,8,7,1498,839,2337,794
0130-001,2014,10,8,8,2072,1780,3852,2337
0130-001,2014,10,8,9,2237,2047,4284,3852
0130-001,2014,10,8,10,1884,1819,3703,4284
0130-001,2014,10,8,11,1941,1823,3764,3703
0130-001,2014,10,8,12,1761,1697,3458,3764
0130-001,2014,10,8,13,1521,1601,3122,3458
0130-001,2014,10,8,14,1921,1756,3677,3122
0130-001,2014,10,8,15,1919,1970,3889,3677
0130-001,2014,10,8,16,1891,1986,3877,3889
0130-001,2014,10,8,17,1937,2003,3940,3877
0130-001,2014,10,8,18,1910,2460,4370,3940
0130-001,2014,10,8,19,1837,2675,4512,4370
0130-001,2014,10,8,20,1536,2178,3714,4512
0130-001,2014,10,8,21,1377,1748,3125,3714
0130-001,2014,10,8,22,1291,1320,2611,3125
0130-001,2014,10,8,23,973,854,1827,2611
0130-001,2014,10,8,24,635,609,1244,1827
0130-001,2014,10,9,1,508,400,908,1244
0130-001,2014,10,9,2,368,268,636,908
0130-001,2014,10,9,3,249,237,486,636
0130-001,2014,10,9,4,232,218,450,486
0130-001,2014,10,9,5,217,282,499,450
0130-001,2014,10,9,6,447,398,845,499
0130-001,2014,10,9,7,1033,633,1666,845
0130-001,2014,10,9,8,1733,1115,2848,1666
0130-001,2014,10,9,9,1559,1377,2936,2848
0130-001,2014,10,9,10,1528,1457,2985,2936
0130-001,2014,10,9,11,1581,1700,3281,2985
0130-001,2014,10,9,12,1475,1908,3383,3281
0130-001,2014,10,9,13,1289,1582,2871,3383
0130-001,2014,10,9,14,1505,1636,3141,2871
0130-001,2014,10,9,15,1568,1634,3202,3141
0130-001,2014,10,9,16,1554,1609,3163,3202
0130-001,2014,10,9,17,1615,1691,3306,3163
0130-001,2014,10,9,18,1766,2115,3881,3306
0130-001,2014,10,9,19,1579,2093,3672,3881
0130-001,2014,10,9,20,1412,1484,2896,3672
0130-001,2014,10,9,21,1126,1118,2244,2896
0130-001,2014,10,9,22,1008,866,1874,2244
0130-001,2014,10,9,23,819,633,1452,1874
0130-001,2014,10,9,24,447,423,870,1452
0130-001,2014,10,10,1,307,272,579,870
0130-001,2014,10,10,2,210,196,406,579
0130-001,2014,10,10,3,170,167,337,406
0130-001,2014,10,10,4,139,164,303,337
0130-001,2014,10,10,5,203,232,435,303
0130-001,2014,10,10,6,408,389,797,435
0130-001,2014,10,10,7,1366,780,2146,797
0130-001,2014,10,10,8,2145,1761,3906,2146
0130-001,2014,10,10,9,1961,1977,3938,3906
0130-001,2014,10,10,10,1871,1772,3643,3938
0130-001,2014,10,10,11,1881,1828,3709,3643
0130-001,2014,10,10,12,1799,1748,3547,3709
0130-001,2014,10,10,13,1555,1642,3197,3547
0130-001,2014,10,10,14,1839,1903,3742,3197
0130-001,2014,10,10,15,1989,1994,3983,3742
0130-001,2014,10,10,16,1943,1953,3896,3983
0130-001,2014,10,10,17,1871,2201,4072,3896
0130-001,2014,10,10,18,2011,2409,4420,4072
0130-001,2014,10,10,19,1962,2638,4600,4420
0130-001,2014,10,10,20,1525,2201,3726,4600
0130-001,2014,10,10,21,1342,1666,3008,3726
0130-001,2014,10,10,22,1229,1221,2450,3008
0130-001,2014,10,10,23,1326,904,2230,2450
0130-001,2014,10,10,24,706,606,1312,2230
0130-001,2014,10,11,1,499,445,944,1312
0130-001,2014,10,11,2,318,281,599,944
0130-001,2014,10,11,3,266,218,484,599
0130-001,2014,10,11,4,220,218,438,484
0130-001,2014,10,11,5,218,275,493,438
0130-001,2014,10,11,6,426,407,833,493
0130-001,2014,10,11,7,973,690,1663,833
0130-001,2014,10,11,8,1527,1168,2695,1663
0130-001,2014,10,11,9,1624,1923,3547,2695
0130-001,2014,10,11,10,1755,1863,3618,3547
0130-001,2014,10,11,11,1917,2207,4124,3618
0130-001,2014,10,11,12,1930,2333,4263,4124
0130-001,2014,10,11,13,1825,2149,3974,4263
0130-001,2014,10,11,14,1848,1932,3780,3974
0130-001,2014,10,11,15,1837,1961,3798,3780
0130-001,2014,10,11,16,1997,1870,3867,3798
0130-001,2014,10,11,17,1950,1933,3883,3867
0130-001,2014,10,11,18,1954,2201,4155,3883
0130-001,2014,10,11,19,1916,2027,3943,4155
0130-001,2014,10,11,20,1785,1500,3285,3943
0130-001,2014,10,11,21,1430,1147,2577,3285
0130-001,2014,10,11,22,1309,920,2229,2577
0130-001,2014,10,11,23,916,701,1617,2229
0130-001,2014,10,11,24,554,499,1053,1617
0130-001,2014,10,12,1,394,344,738,1053
0130-001,2014,10,12,2,277,232,509,738
0130-001,2014,10,12,3,237,208,445,509
0130-001,2014,10,12,4,216,204,420,445
0130-001,2014,10,12,5,200,182,382,420
0130-001,2014,10,12,6,352,305,657,382
0130-001,2014,10,12,7,594,439,1033,657
0130-001,2014,10,12,8,771,675,1446,1033
0130-001,2014,10,12,9,912,1041,1953,1446
0130-001,2014,10,12,10,1079,1216,2295,1953
0130-001,2014,10,12,11,1278,1470,2748,2295
0130-001,2014,10,12,12,1241,1374,2615,2748
0130-001,2014,10,12,13,1383,1360,2743,2615
0130-001,2014,10,12,14,1538,1393,2931,2743
0130-001,2014,10,12,15,1879,1516,3395,2931
0130-001,2014,10,12,16,2051,1462,3513,3395
0130-001,2014,10,12,17,2129,1552,3681,3513
0130-001,2014,10,12,18,1890,1699,3589,3681
0130-001,2014,10,12,19,1897,1466,3363,3589
0130-001,2014,10,12,20,1726,1177,2903,3363
0130-001,2014,10,12,21,1744,1018,2762,2903
0130-001,2014,10,12,22,1180,746,1926,2762
0130-001,2014,10,12,23,832,590,1422,1926
0130-001,2014,10,12,24,477,372,849,1422
0130-001,2014,10,13,1,302,249,551,849
0130-001,2014,10,13,2,172,173,345,551
0130-001,2014,10,13,3,141,141,282,345
0130-001,2014,10,13,4,108,150,258,282
0130-001,2014,10,13,5,184,209,393,258
0130-001,2014,10,13,6,495,426,921,393
0130-001,2014,10,13,7,1561,837,2398,921
0130-001,2014,10,13,8,2141,1865,4006,2398
0130-001,2014,10,13,9,2180,2014,4194,4006
0130-001,2014,10,13,10,1930,1791,3721,4194
0130-001,2014,10,13,11,1834,1839,3673,3721
0130-001,2014,10,13,12,1693,1716,3409,3673
0130-001,2014,10,13,13,1570,1533,3103,3409
0130-001,2014,10,13,14,1816,1753,3569,3103
0130-001,2014,10,13,15,1951,1935,3886,3569
0130-001,2014,10,13,16,1859,1896,3755,3886
0130-001,2014,10,13,17,1767,2021,3788,3755
0130-001,2014,10,13,18,1871,2334,4205,3788
0130-001,2014,10,13,19,1901,2452,4353,4205
0130-001,2014,10,13,20,1421,1922,3343,4353
0130-001,2014,10,13,21,1240,1743,2983,3343
0130-001,2014,10,13,22,1114,1306,2420,2983
0130-001,2014,10,13,23,816,836,1652,2420
0130-001,2014,10,13,24,506,496,1002,1652
0130-001,2014,10,14,1,328,327,655,1002
0130-001,2014,10,14,2,226,178,404,655
0130-001,2014,10,14,3,176,190,366,404
0130-001,2014,10,14,4,175,172,347,366
0130-001,2014,10,14,5,191,257,448,347
0130-001,2014,10,14,6,435,375,810,448
0130-001,2014,10,14,7,1499,797,2296,810
0130-001,2014,10,14,8,2080,1792,3872,2296
0130-001,2014,10,14,9,2207,1998,4205,3872
0130-001,2014,10,14,10,1961,1855,3816,4205
0130-001,2014,10,14,11,1870,1849,3719,3816
0130-001,2014,10,14,12,1671,1814,3485,3719
0130-001,2014,10,14,13,1627,1617,3244,3485
0130-001,2014,10,14,14,1857,1776,3633,3244
0130-001,2014,10,14,15,1855,1841,3696,3633
0130-001,2014,10,14,16,1943,1816,3759,3696
0130-001,2014,10,14,17,1843,2001,3844,3759
0130-001,2014,10,14,18,1866,2326,4192,3844
0130-001,2014,10,14,19,1680,2509,4189,4192
0130-001,2014,10,14,20,1403,1849,3252,4189
0130-001,2014,10,14,21,1201,1664,2865,3252
0130-001,2014,10,14,22,1130,1256,2386,2865
0130-001,2014,10,14,23,859,784,1643,2386
0130-001,2014,10,14,24,532,504,1036,1643
0130-001,2014,10,15,1,361,321,682,1036
0130-001,2014,10,15,2,250,233,483,682
0130-001,2014,10,15,3,158,198,356,483
0130-001,2014,10,15,4,156,152,308,356
0130-001,2014,10,15,5,188,229,417,308
0130-001,2014,10,15,6,460,382,842,417
0130-001,2014,10,15,7,1422,789,2211,842
0130-001,2014,10,15,8,2052,1776,3828,2211
0130-001,2014,10,15,9,2175,2022,4197,3828
0130-001,2014,10,15,10,1994,1883,3877,4197
0130-001,2014,10,15,11,1848,1842,3690,3877
0130-001,2014,10,15,12,1751,1722,3473,3690
0130-001,2014,10,15,13,1564,1559,3123,3473
0130-001,2014,10,15,14,1860,1773,3633,3123
0130-001,2014,10,15,15,1951,1881,3832,3633
0130-001,2014,10,15,16,1889,1903,3792,3832
0130-001,2014,10,15,17,1912,2085,3997,3792
0130-001,2014,10,15,18,1907,2415,4322,3997
0130-001,2014,10,15,19,1864,2587,4451,4322
0130-001,2014,10,15,20,1461,2012,3473,4451
0130-001,2014,10,15,21,1267,1626,2893,3473
0130-001,2014,10,15,22,1174,1254,2428,2893
0130-001,2014,10,15,23,887,780,1667,2428
0130-001,2014,10,15,24,608,485,1093,1667
0130-001,2014,10,16,1,390,384,774,1093
0130-001,2014,10,16,2,257,276,533,774
0130-001,2014,10,16,3,169,170,339,533
0130-001,2014,10,16,4,162,168,330,339
0130-001,2014,10,16,5,191,234,425,330
0130-001,2014,10,16,6,427,379,806,425
0130-001,2014,10,16,7,1350,765,2115,806
0130-001,2014,10,16,8,2056,1770,3826,2115
0130-001,2014,10,16,9,2202,2037,4239,3826
0130-001,2014,10,16,10,2001,1748,3749,4239
0130-001,2014,10,16,11,1869,1842,3711,3749
0130-001,2014,10,16,12,1737,1719,3456,3711
0130-001,2014,10,16,13,1598,1625,3223,3456
0130-001,2014,10,16,14,1778,1776,3554,3223
0130-001,2014,10,16,15,1921,1988,3909,3554
0130-001,2014,10,16,16,1888,1972,3860,3909
0130-001,2014,10,16,17,1837,2057,3894,3860
0130-001,2014,10,16,18,1959,2446,4405,3894
0130-001,2014,10,16,19,1883,2356,4239,4405
0130-001,2014,10,16,20,1398,2104,3502,4239
0130-001,2014,10,16,21,1309,1696,3005,3502
0130-001,2014,10,16,22,1194,1346,2540,3005
0130-001,2014,10,16,23,929,794,1723,2540
0130-001,2014,10,16,24,596,528,1124,1723
0130-001,2014,10,17,1,373,334,707,1124
0130-001,2014,10,17,2,247,248,495,707
0130-001,2014,10,17,3,187,172,359,495
0130-001,2014,10,17,4,164,198,362,359
0130-001,2014,10,17,5,192,233,425,362
0130-001,2014,10,17,6,405,376,781,425
0130-001,2014,10,17,7,1391,771,2162,781
0130-001,2014,10,17,8,2046,1799,3845,2162
0130-001,2014,10,17,9,2148,2096,4244,3845
0130-001,2014,10,17,10,1942,1896,3838,4244
0130-001,2014,10,17,11,1829,1796,3625,3838
0130-001,2014,10,17,12,1839,1897,3736,3625
0130-001,2014,10,17,13,1638,1712,3350,3736
0130-001,2014,10,17,14,1844,1860,3704,3350
0130-001,2014,10,17,15,1959,2001,3960,3704
0130-001,2014,10,17,16,1980,2051,4031,3960
0130-001,2014,10,17,17,1937,2079,4016,4031
0130-001,2014,10,17,18,1994,2440,4434,4016
0130-001,2014,10,17,19,1956,2555,4511,4434
0130-001,2014,10,17,20,1696,2266,3962,4511
0130-001,2014,10,17,21,1442,1802,3244,3962
0130-001,2014,10,17,22,1288,1335,2623,3244
0130-001,2014,10,17,23,1020,900,1920,2623
0130-001,2014,10,17,24,657,585,1242,1920
0130-001,2014,10,18,1,458,411,869,1242
0130-001,2014,10,18,2,385,346,731,869
0130-001,2014,10,18,3,234,242,476,731
0130-001,2014,10,18,4,203,209,412,476
0130-001,2014,10,18,5,248,287,535,412
0130-001,2014,10,18,6,423,425,848,535
0130-001,2014,10,18,7,1039,690,1729,848
0130-001,2014,10,18,8,1771,1246,3017,1729
0130-001,2014,10,18,9,1971,1868,3839,3017
0130-001,2014,10,18,10,1837,2145,3982,3839
0130-001,2014,10,18,11,1787,2427,4214,3982
0130-001,2014,10,18,12,1813,2402,4215,4214
0130-001,2014,10,18,13,1801,2610,4411,4215
0130-001,2014,10,18,14,1884,2299,4183,4411
0130-001,2014,10,18,15,1947,2057,4004,4183
0130-001,2014,10,18,16,2057,1988,4045,4004
0130-001,2014,10,18,17,1996,2148,4144,4045
0130-001,2014,10,18,18,1922,2418,4340,4144
0130-001,2014,10,18,19,1913,2134,4047,4340
0130-001,2014,10,18,20,1856,1479,3335,4047
0130-001,2014,10,18,21,1397,1152,2549,3335
0130-001,2014,10,18,22,1336,920,2256,2549
0130-001,2014,10,18,23,853,640,1493,2256
0130-001,2014,10,18,24,599,504,1103,1493
0130-001,2014,10,19,1,368,347,715,1103
0130-001,2014,10,19,2,323,270,593,715
0130-001,2014,10,19,3,231,207,438,593
0130-001,2014,10,19,4,169,166,335,438
0130-001,2014,10,19,5,176,201,377,335
0130-001,2014,10,19,6,304,270,574,377
0130-001,2014,10,19,7,600,498,1098,574
0130-001,2014,10,19,8,896,736,1632,1098
0130-001,2014,10,19,9,1034,996,2030,1632
0130-001,2014,10,19,10,1150,1245,2395,2030
0130-001,2014,10,19,11,1354,1438,2792,2395
0130-001,2014,10,19,12,1206,1602,2808,2792
0130-001,2014,10,19,13,1433,1596,3029,2808
0130-001,2014,10,19,14,1708,1560,3268,3029
0130-001,2014,10,19,15,1814,1665,3479,3268
0130-001,2014,10,19,16,1897,1669,3566,3479
0130-001,2014,10,19,17,1959,1735,3694,3566
0130-001,2014,10,19,18,1998,1651,3649,3694
0130-001,2014,10,19,19,2022,1532,3554,3649
0130-001,2014,10,19,20,1797,1229,3026,3554
0130-001,2014,10,19,21,1573,1062,2635,3026
0130-001,2014,10,19,22,1335,802,2137,2635
0130-001,2014,10,19,23,797,568,1365,2137
0130-001,2014,10,19,24,440,372,812,1365
0130-001,2014,10,20,1,279,233,512,812
0130-001,2014,10,20,2,223,172,395,512
0130-001,2014,10,20,3,114,97,211,395
0130-001,2014,10,20,4,125,80,205,211
0130-001,2014,10,20,5,149,116,265,205
0130-001,2014,10,20,6,398,245,643,265
0130-001,2014,10,20,7,1350,604,1954,643
0130-001,2014,10,20,8,1903,1705,3608,1954
0130-001,2014,10,20,9,2085,2061,4146,3608
0130-001,2014,10,20,10,1689,1584,3273,4146
0130-001,2014,10,20,11,1631,1684,3315,3273
0130-001,2014,10,20,12,1622,1589,3211,3315
0130-001,2014,10,20,13,1447,1455,2902,3211
0130-001,2014,10,20,14,1636,1735,3371,2902
0130-001,2014,10,20,15,1773,1803,3576,3371
0130-001,2014,10,20,16,1759,1803,3562,3576
0130-001,2014,10,20,17,1666,1876,3542,3562
0130-001,2014,10,20,18,1252,2247,3499,3542
0130-001,2014,10,20,19,1391,2305,3696,3499
0130-001,2014,10,20,20,940,1766,2706,3696
0130-001,2014,10,20,21,893,1493,2386,2706
0130-001,2014,10,20,22,777,1226,2003,2386
0130-001,2014,10,20,23,612,742,1354,2003
0130-001,2014,10,20,24,458,441,899,1354
0130-001,2014,10,21,1,393,278,671,899
0130-001,2014,10,21,2,220,179,399,671
0130-001,2014,10,21,3,161,134,295,399
0130-001,2014,10,21,4,162,133,295,295
0130-001,2014,10,21,5,186,188,374,295
0130-001,2014,10,21,6,356,290,646,374
0130-001,2014,10,21,7,1252,631,1883,646
0130-001,2014,10,21,8,2057,1714,3771,1883
0130-001,2014,10,21,9,2040,1988,4028,3771
0130-001,2014,10,21,10,1732,1680,3412,4028
0130-001,2014,10,21,11,1781,1731,3512,3412
0130-001,2014,10,21,12,1515,1632,3147,3512
0130-001,2014,10,21,13,1523,1513,3036,3147
0130-001,2014,10,21,14,1794,1627,3421,3036
0130-001,2014,10,21,15,1877,1708,3585,3421
0130-001,2014,10,21,16,1786,1613,3399,3585
0130-001,2014,10,21,17,1883,1839,3722,3399
0130-001,2014,10,21,18,1841,2108,3949,3722
0130-001,2014,10,21,19,1592,2219,3811,3949
0130-001,2014,10,21,20,1411,1599,3010,3811
0130-001,2014,10,21,21,1119,787,1906,3010
0130-001,2014,10,21,22,1202,581,1783,1906
0130-001,2014,10,21,23,836,365,1201,1783
0130-001,2014,10,21,24,514,169,683,1201
0130-001,2014,10,22,1,360,137,497,683
0130-001,2014,10,22,2,278,81,359,497
0130-001,2014,10,22,3,201,67,268,359
0130-001,2014,10,22,4,172,69,241,268
0130-001,2014,10,22,5,194,82,276,241
0130-001,2014,10,22,6,406,173,579,276
0130-001,2014,10,22,7,1450,660,2110,579
0130-001,2014,10,22,8,2349,1594,3943,2110
0130-001,2014,10,22,9,2416,2006,4422,3943
0130-001,2014,10,22,10,1860,1803,3663,4422
0130-001,2014,10,22,11,2102,1742,3844,3663
0130-001,2014,10,22,12,2019,1733,3752,3844
0130-001,2014,10,22,13,1760,1610,3370,3752
0130-001,2014,10,22,14,2000,1805,3805,3370
0130-001,2014,10,22,15,2025,1929,3954,3805
0130-001,2014,10,22,16,1663,1939,3602,3954
0130-001,2014,10,22,17,1614,2073,3687,3602
0130-001,2014,10,22,18,1901,2414,4315,3687
0130-001,2014,10,22,19,2029,2585,4614,4315
0130-001,2014,10,22,20,1399,2082,3481,4614
0130-001,2014,10,22,21,1218,1550,2768,3481
0130-001,2014,10,22,22,1125,1252,2377,2768
0130-001,2014,10,22,23,830,770,1600,2377
0130-001,2014,10,22,24,624,509,1133,1600
0130-001,2014,10,23,1,414,356,770,1133
0130-001,2014,10,23,2,285,255,540,770
0130-001,2014,10,23,3,223,186,409,540
0130-001,2014,10,23,4,155,178,333,409
0130-001,2014,10,23,5,217,237,454,333
0130-001,2014,10,23,6,506,378,884,454
0130-001,2014,10,23,7,1327,727,2054,884
0130-001,2014,10,23,8,2222,1846,4068,2054
0130-001,2014,10,23,9,1975,2111,4086,4068
0130-001,2014,10,23,10,1984,1787,3771,4086
0130-001,2014,10,23,11,1982,1765,3747,3771
0130-001,2014,10,23,12,1703,1781,3484,3747
0130-001,2014,10,23,13,1546,1775,3321,3484
0130-001,2014,10,23,14,2024,1901,3925,3321
0130-001,2014,10,23,15,1975,1811,3786,3925
0130-001,2014,10,23,16,1849,1895,3744,3786
0130-001,2014,10,23,17,2258,2223,4481,3744
0130-001,2014,10,23,18,2307,2359,4666,4481
0130-001,2014,10,23,19,1874,2507,4381,4666
0130-001,2014,10,23,20,1360,1929,3289,4381
0130-001,2014,10,23,21,1138,1616,2754,3289
0130-001,2014,10,23,22,1243,1359,2602,2754
0130-001,2014,10,23,23,975,875,1850,2602
0130-001,2014,10,23,24,585,539,1124,1850
0130-001,2014,10,24,1,382,351,733,1124
0130-001,2014,10,24,2,266,234,500,733
0130-001,2014,10,24,3,199,213,412,500
0130-001,2014,10,24,4,215,185,400,412
0130-001,2014,10,24,5,201,263,464,400
0130-001,2014,10,24,6,485,376,861,464
0130-001,2014,10,24,7,1322,779,2101,861
0130-001,2014,10,24,8,2059,1787,3846,2101
0130-001,2014,10,24,9,2279,2115,4394,3846
0130-001,2014,10,24,10,1573,1799,3372,4394
0130-001,2014,10,24,11,1854,1763,3617,3372
0130-001,2014,10,24,12,1570,1828,3398,3617
0130-001,2014,10,24,13,1446,1696,3142,3398
0130-001,2014,10,24,14,1573,1876,3449,3142
0130-001,2014,10,24,15,1686,1798,3484,3449
0130-001,2014,10,24,16,1811,1501,3312,3484
0130-001,2014,10,24,17,1648,1454,3102,3312
0130-001,2014,10,24,18,1693,2034,3727,3102
0130-001,2014,10,24,19,1647,2172,3819,3727
0130-001,2014,10,24,20,1350,2172,3522,3819
0130-001,2014,10,24,21,1243,1742,2985,3522
0130-001,2014,10,24,22,1020,1283,2303,2985
0130-001,2014,10,24,23,1006,846,1852,2303
0130-001,2014,10,24,24,620,628,1248,1852
0130-001,2014,10,25,1,464,442,906,1248
0130-001,2014,10,25,2,325,295,620,906
0130-001,2014,10,25,3,217,243,460,620
0130-001,2014,10,25,4,197,219,416,460
0130-001,2014,10,25,5,209,280,489,416
0130-001,2014,10,25,6,367,413,780,489
0130-001,2014,10,25,7,984,682,1666,780
0130-001,2014,10,25,8,1829,1150,2979,1666
0130-001,2014,10,25,9,1738,1801,3539,2979
0130-001,2014,10,25,10,1597,1885,3482,3539
0130-001,2014,10,25,11,1788,1995,3783,3482
0130-001,2014,10,25,12,1660,2357,4017,3783
0130-001,2014,10,25,13,1583,2373,3956,4017
0130-001,2014,10,25,14,1427,2194,3621,3956
0130-001,2014,10,25,15,1532,1976,3508,3621
0130-001,2014,10,25,16,1884,1821,3705,3508
0130-001,2014,10,25,17,2097,2000,4097,3705
0130-001,2014,10,25,18,2236,2184,4420,4097
0130-001,2014,10,25,19,1771,2070,3841,4420
0130-001,2014,10,25,20,1450,1314,2764,3841
0130-001,2014,10,25,21,1158,968,2126,2764
0130-001,2014,10,25,22,1101,713,1814,2126
0130-001,2014,10,25,23,756,619,1375,1814
0130-001,2014,10,25,24,507,480,987,1375
0130-001,2014,10,26,1,316,329,645,987
0130-001,2014,10,26,2,310,247,557,645
0130-001,2014,10,26,3,205,176,381,557
0130-001,2014,10,26,4,200,144,344,381
0130-001,2014,10,26,5,205,147,352,344
0130-001,2014,10,26,6,258,263,521,352
0130-001,2014,10,26,7,495,401,896,521
0130-001,2014,10,26,8,694,750,1444,896
0130-001,2014,10,26,9,907,979,1886,1444
0130-001,2014,10,26,10,879,926,1805,1886
0130-001,2014,10,26,11,1113,1414,2527,1805
0130-001,2014,10,26,12,1144,1266,2410,2527
0130-001,2014,10,26,13,1129,1346,2475,2410
0130-001,2014,10,26,14,1167,1398,2565,2475
0130-001,2014,10,26,15,1373,1489,2862,2565
0130-001,2014,10,26,16,1419,1538,2957,2862
0130-001,2014,10,26,17,1511,1599,3110,2957
0130-001,2014,10,26,18,1505,1686,3191,3110
0130-001,2014,10,26,19,1592,1286,2878,3191
0130-001,2014,10,26,20,1424,1076,2500,2878
0130-001,2014,10,26,21,1241,956,2197,2500
0130-001,2014,10,26,22,1031,784,1815,2197
0130-001,2014,10,26,23,661,565,1226,1815
0130-001,2014,10,26,24,414,345,759,1226
0130-001,2014,10,27,1,234,237,471,759
0130-001,2014,10,27,2,188,176,364,471
0130-001,2014,10,27,3,103,139,242,364
0130-001,2014,10,27,4,141,153,294,242
0130-001,2014,10,27,5,188,186,374,294
0130-001,2014,10,27,6,430,349,779,374
0130-001,2014,10,27,7,1454,840,2294,779
0130-001,2014,10,27,8,1837,1868,3705,2294
0130-001,2014,10,27,9,2594,2032,4626,3705
0130-001,2014,10,27,10,1742,1650,3392,4626
0130-001,2014,10,27,11,1620,1894,3514,3392
0130-001,2014,10,27,12,1612,1692,3304,3514
0130-001,2014,10,27,13,1433,1583,3016,3304
0130-001,2014,10,27,14,1538,1686,3224,3016
0130-001,2014,10,27,15,1788,1843,3631,3224
0130-001,2014,10,27,16,1722,1894,3616,3631
0130-001,2014,10,27,17,1690,2115,3805,3616
0130-001,2014,10,27,18,1644,2363,4007,3805
0130-001,2014,10,27,19,1600,2069,3669,4007
0130-001,2014,10,27,20,1204,1517,2721,3669
0130-001,2014,10,27,21,1039,1315,2354,2721
0130-001,2014,10,27,22,975,1357,2332,2354
0130-001,2014,10,27,23,728,710,1438,2332
0130-001,2014,10,27,24,479,461,940,1438
0130-001,2014,10,28,1,306,321,627,940
0130-001,2014,10,28,2,239,232,471,627
0130-001,2014,10,28,3,168,172,340,471
0130-001,2014,10,28,4,139,188,327,340
0130-001,2014,10,28,5,227,256,483,327
0130-001,2014,10,28,6,444,361,805,483
0130-001,2014,10,28,7,1330,806,2136,805
0130-001,2014,10,28,8,2037,1786,3823,2136
0130-001,2014,10,28,9,2781,2096,4877,3823
0130-001,2014,10,28,10,1915,1821,3736,4877
0130-001,2014,10,28,11,1460,1127,2587,3736
0130-001,2014,10,28,12,1654,1187,2841,2587
0130-001,2014,10,28,13,1340,1578,2918,2841
0130-001,2014,10,28,14,1714,1739,3453,2918
0130-001,2014,10,28,15,1526,1831,3357,3453
0130-001,2014,10,28,16,1563,1869,3432,3357
0130-001,2014,10,28,17,1484,1998,3482,3432
0130-001,2014,10,28,18,1573,2410,3983,3482
0130-001,2014,10,28,19,1539,2476,4015,3983
0130-001,2014,10,28,20,1205,1595,2800,4015
0130-001,2014,10,28,21,1055,1645,2700,2800
0130-001,2014,10,28,22,1062,1341,2403,2700
0130-001,2014,10,28,23,740,743,1483,2403
0130-001,2014,10,28,24,506,484,990,1483
0130-001,2014,10,29,1,302,331,633,990
0130-001,2014,10,29,2,215,242,457,633
0130-001,2014,10,29,3,164,172,336,457
0130-001,2014,10,29,4,120,177,297,336
0130-001,2014,10,29,5,181,256,437,297
0130-001,2014,10,29,6,403,394,797,437
0130-001,2014,10,29,7,1294,740,2034,797
0130-001,2014,10,29,8,2466,1803,4269,2034
0130-001,2014,10,29,9,2736,2118,4854,4269
0130-001,2014,10,29,10,2074,1788,3862,4854
0130-001,2014,10,29,11,1843,1826,3669,3862
0130-001,2014,10,29,12,1671,1724,3395,3669
0130-001,2014,10,29,13,1495,1577,3072,3395
0130-001,2014,10,29,14,1645,1804,3449,3072
0130-001,2014,10,29,15,1671,1796,3467,3449
0130-001,2014,10,29,16,1656,1845,3501,3467
0130-001,2014,10,29,17,1666,2066,3732,3501
0130-001,2014,10,29,18,1668,2493,4161,3732
0130-001,2014,10,29,19,1469,2589,4058,4161
0130-001,2014,10,29,20,1267,1987,3254,4058
0130-001,2014,10,29,21,1003,1589,2592,3254
0130-001,2014,10,29,22,1023,1253,2276,2592
0130-001,2014,10,29,23,789,788,1577,2276
0130-001,2014,10,29,24,464,526,990,1577
0130-001,2014,10,30,1,336,379,715,990
0130-001,2014,10,30,2,228,239,467,715
0130-001,2014,10,30,3,146,189,335,467
0130-001,2014,10,30,4,162,199,361,335
0130-001,2014,10,30,5,173,248,421,361
0130-001,2014,10,30,6,418,375,793,421
0130-001,2014,10,30,7,1175,780,1955,793
0130-001,2014,10,30,8,2070,1761,3831,1955
0130-001,2014,10,30,9,2123,2132,4255,3831
0130-001,2014,10,30,10,1597,1813,3410,4255
0130-001,2014,10,30,11,1551,1756,3307,3410
0130-001,2014,10,30,12,1414,1711,3125,3307
0130-001,2014,10,30,13,1338,1569,2907,3125
0130-001,2014,10,30,14,1597,1776,3373,2907
0130-001,2014,10,30,15,1705,1835,3540,3373
0130-001,2014,10,30,16,1679,1855,3534,3540
0130-001,2014,10,30,17,1717,2102,3819,3534
0130-001,2014,10,30,18,1803,2383,4186,3819
0130-001,2014,10,30,19,1486,2462,3948,4186
0130-001,2014,10,30,20,1194,1897,3091,3948
0130-001,2014,10,30,21,1093,1628,2721,3091
0130-001,2014,10,30,22,1066,1336,2402,2721
0130-001,2014,10,30,23,729,804,1533,2402
0130-001,2014,10,30,24,442,538,980,1533
0130-001,2014,10,31,1,380,383,763,980
0130-001,2014,10,31,2,269,258,527,763
0130-001,2014,10,31,3,165,195,360,527
0130-001,2014,10,31,4,131,164,295,360
0130-001,2014,10,31,5,172,256,428,295
0130-001,2014,10,31,6,325,298,623,428
0130-001,2014,10,31,7,1135,660,1795,623
0130-001,2014,10,31,8,1671,1632,3303,1795
0130-001,2014,10,31,9,1827,2040,3867,3303
0130-001,2014,10,31,10,1670,1790,3460,3867
0130-001,2014,10,31,11,1439,1853,3292,3460
0130-001,2014,10,31,12,1354,1353,2707,3292
0130-001,2014,10,31,13,1342,1229,2571,2707
0130-001,2014,10,31,14,1773,1232,3005,2571
0130-001,2014,10,31,15,1802,1584,3386,3005
0130-001,2014,10,31,16,1839,1744,3583,3386
0130-001,2014,10,31,17,1917,1842,3759,3583
0130-001,2014,10,31,18,1714,2183,3897,3759
0130-001,2014,10,31,19,1538,2399,3937,3897
0130-001,2014,10,31,20,1582,2097,3679,3937
0130-001,2014,10,31,21,1026,1675,2701,3679
0130-001,2014,10,31,22,949,1308,2257,2701
0130-001,2014,10,31,23,739,861,1600,2257
0130-001,2014,10,31,24,511,571,1082,1600
0130-001,2014,11,1,1,658,426,1084,1082
0130-001,2014,11,1,2,422,300,722,1084
0130-001,2014,11,1,3,271,259,530,722
0130-001,2014,11,1,4,229,205,434,530
0130-001,2014,11,1,5,239,279,518,434
0130-001,2014,11,1,6,389,319,708,518
0130-001,2014,11,1,7,936,584,1520,708
0130-001,2014,11,1,8,1721,1062,2783,1520
0130-001,2014,11,1,9,1781,1629,3410,2783
0130-001,2014,11,1,10,2081,1883,3964,3410
0130-001,2014,11,1,11,2027,2302,4329,3964
0130-001,2014,11,1,12,2152,2312,4464,4329
0130-001,2014,11,1,13,2194,2136,4330,4464
0130-001,2014,11,1,14,2057,2090,4147,4330
0130-001,2014,11,1,15,2134,2085,4219,4147
0130-001,2014,11,1,16,2030,1950,3980,4219
0130-001,2014,11,1,17,2189,1993,4182,3980
0130-001,2014,11,1,18,1965,2235,4200,4182
0130-001,2014,11,1,19,2112,2012,4124,4200
0130-001,2014,11,1,20,1625,1457,3082,4124
0130-001,2014,11,1,21,1454,1083,2537,3082
0130-001,2014,11,1,22,1441,978,2419,2537
0130-001,2014,11,1,23,804,709,1513,2419
0130-001,2014,11,1,24,547,505,1052,1513
0130-001,2014,11,2,1,417,352,769,1052
0130-001,2014,11,2,2,293,278,571,769
0130-001,2014,11,2,3,260,190,450,571
0130-001,2014,11,2,4,195,177,372,450
0130-001,2014,11,2,5,179,177,356,372
0130-001,2014,11,2,6,375,244,619,356
0130-001,2014,11,2,7,487,382,869,619
0130-001,2014,11,2,8,620,600,1220,869
0130-001,2014,11,2,9,873,901,1774,1220
0130-001,2014,11,2,10,1058,1065,2123,1774
0130-001,2014,11,2,11,1254,1390,2644,2123
0130-001,2014,11,2,12,1234,1428,2662,2644
0130-001,2014,11,2,13,1511,1519,3030,2662
0130-001,2014,11,2,14,1641,1617,3258,3030
0130-001,2014,11,2,15,2034,1596,3630,3258
0130-001,2014,11,2,16,2034,1696,3730,3630
0130-001,2014,11,2,17,2027,1669,3696,3730
0130-001,2014,11,2,18,2423,1590,4013,3696
0130-001,2014,11,2,19,2412,1373,3785,4013
0130-001,2014,11,2,20,1874,1130,3004,3785
0130-001,2014,11,2,21,1650,906,2556,3004
0130-001,2014,11,2,22,1207,792,1999,2556
0130-001,2014,11,2,23,680,466,1146,1999
0130-001,2014,11,2,24,391,329,720,1146
0130-001,2014,11,3,1,318,191,509,720
0130-001,2014,11,3,2,213,129,342,509
0130-001,2014,11,3,3,139,116,255,342
0130-001,2014,11,3,4,131,114,245,255
0130-001,2014,11,3,5,171,223,394,245
0130-001,2014,11,3,6,507,377,884,394
0130-001,2014,11,3,7,1794,876,2670,884
0130-001,2014,11,3,8,2397,1838,4235,2670
0130-001,2014,11,3,9,2749,2052,4801,4235
0130-001,2014,11,3,10,2148,1753,3901,4801
0130-001,2014,11,3,11,2412,1741,4153,3901
0130-001,2014,11,3,12,2041,1676,3717,4153
0130-001,2014,11,3,13,1756,1497,3253,3717
0130-001,2014,11,3,14,2043,1781,3824,3253
0130-001,2014,11,3,15,2303,1910,4213,3824
0130-001,2014,11,3,16,1916,1931,3847,4213
0130-001,2014,11,3,17,1792,2063,3855,3847
0130-001,2014,11,3,18,1836,2418,4254,3855
0130-001,2014,11,3,19,1814,2234,4048,4254
0130-001,2014,11,3,20,1323,1830,3153,4048
0130-001,2014,11,3,21,1123,1623,2746,3153
0130-001,2014,11,3,22,1300,1247,2547,2746
0130-001,2014,11,3,23,706,737,1443,2547
0130-001,2014,11,3,24,455,459,914,1443
0130-001,2014,11,4,1,308,327,635,914
0130-001,2014,11,4,2,200,214,414,635
0130-001,2014,11,4,3,144,181,325,414
0130-001,2014,11,4,4,126,158,284,325
0130-001,2014,11,4,5,175,245,420,284
0130-001,2014,11,4,6,448,349,797,420
0130-001,2014,11,4,7,1914,755,2669,797
0130-001,2014,11,4,8,2857,1831,4688,2669
0130-001,2014,11,4,9,2708,2102,4810,4688
0130-001,2014,11,4,10,2206,1738,3944,4810
0130-001,2014,11,4,11,1832,1710,3542,3944
0130-001,2014,11,4,12,1536,1683,3219,3542
0130-001,2014,11,4,13,1385,1601,2986,3219
0130-001,2014,11,4,14,1729,1795,3524,2986
0130-001,2014,11,4,15,1763,1795,3558,3524
0130-001,2014,11,4,16,1596,1836,3432,3558
0130-001,2014,11,4,17,1723,2008,3731,3432
0130-001,2014,11,4,18,1876,2440,4316,3731
0130-001,2014,11,4,19,1678,2381,4059,4316
0130-001,2014,11,4,20,1441,1885,3326,4059
0130-001,2014,11,4,21,1109,1608,2717,3326
0130-001,2014,11,4,22,1107,1298,2405,2717
0130-001,2014,11,4,23,822,768,1590,2405
0130-001,2014,11,4,24,571,498,1069,1590
0130-001,2014,11,5,1,304,359,663,1069
0130-001,2014,11,5,2,195,219,414,663
0130-001,2014,11,5,3,137,180,317,414
0130-001,2014,11,5,4,144,166,310,317
0130-001,2014,11,5,5,169,221,390,310
0130-001,2014,11,5,6,455,383,838,390
0130-001,2014,11,5,7,1549,766,2315,838
0130-001,2014,11,5,8,2228,1814,4042,2315
0130-001,2014,11,5,9,2473,2023,4496,4042
0130-001,2014,11,5,10,1958,1707,3665,4496
0130-001,2014,11,5,11,2181,1763,3944,3665
0130-001,2014,11,5,12,2166,1776,3942,3944
0130-001,2014,11,5,13,1781,1527,3308,3942
0130-001,2014,11,5,14,2181,1822,4003,3308
0130-001,2014,11,5,15,1970,1892,3862,4003
0130-001,2014,11,5,16,1938,1954,3892,3862
0130-001,2014,11,5,17,1703,1976,3679,3892
0130-001,2014,11,5,18,2050,2475,4525,3679
0130-001,2014,11,5,19,1745,2536,4281,4525
0130-001,2014,11,5,20,1365,1901,3266,4281
0130-001,2014,11,5,21,1227,1563,2790,3266
0130-001,2014,11,5,22,1189,1257,2446,2790
0130-001,2014,11,5,23,847,782,1629,2446
0130-001,2014,11,5,24,520,537,1057,1629
0130-001,2014,11,6,1,377,383,760,1057
0130-001,2014,11,6,2,264,235,499,760
0130-001,2014,11,6,3,193,183,376,499
0130-001,2014,11,6,4,166,204,370,376
0130-001,2014,11,6,5,169,238,407,370
0130-001,2014,11,6,6,453,383,836,407
0130-001,2014,11,6,7,1592,743,2335,836
0130-001,2014,11,6,8,2226,1800,4026,2335
0130-001,2014,11,6,9,2403,2062,4465,4026
0130-001,2014,11,6,10,1932,1743,3675,4465
0130-001,2014,11,6,11,1999,1748,3747,3675
0130-001,2014,11,6,12,2483,1752,4235,3747
0130-001,2014,11,6,13,1470,1525,2995,4235
0130-001,2014,11,6,14,1818,1789,3607,2995
0130-001,2014,11,6,15,1888,1791,3679,3607
0130-001,2014,11,6,16,1736,1835,3571,3679
0130-001,2014,11,6,17,1710,2087,3797,3571
0130-001,2014,11,6,18,1939,2364,4303,3797
0130-001,2014,11,6,19,1814,2465,4279,4303
0130-001,2014,11,6,20,1543,1784,3327,4279
0130-001,2014,11,6,21,1225,1646,2871,3327
0130-001,2014,11,6,22,1165,1354,2519,2871
0130-001,2014,11,6,23,742,783,1525,2519
0130-001,2014,11,6,24,564,546,1110,1525
0130-001,2014,11,7,1,402,331,733,1110
0130-001,2014,11,7,2,271,240,511,733
0130-001,2014,11,7,3,171,181,352,511
0130-001,2014,11,7,4,150,190,340,352
0130-001,2014,11,7,5,186,242,428,340
0130-001,2014,11,7,6,429,383,812,428
0130-001,2014,11,7,7,1496,783,2279,812
0130-001,2014,11,7,8,2067,1803,3870,2279
0130-001,2014,11,7,9,3152,2081,5233,3870
0130-001,2014,11,7,10,2225,1785,4010,5233
0130-001,2014,11,7,11,2301,1833,4134,4010
0130-001,2014,11,7,12,1763,1755,3518,4134
0130-001,2014,11,7,13,1699,1633,3332,3518
0130-001,2014,11,7,14,1856,1796,3652,3332
0130-001,2014,11,7,15,1958,1960,3918,3652
0130-001,2014,11,7,16,1883,1929,3812,3918
0130-001,2014,11,7,17,1858,2154,4012,3812
0130-001,2014,11,7,18,2019,2495,4514,4012
0130-001,2014,11,7,19,2007,2597,4604,4514
0130-001,2014,11,7,20,1472,2063,3535,4604
0130-001,2014,11,7,21,1469,1665,3134,3535
0130-001,2014,11,7,22,1283,1345,2628,3134
0130-001,2014,11,7,23,1014,858,1872,2628
0130-001,2014,11,7,24,660,555,1215,1872
0130-001,2014,11,8,1,448,395,843,1215
0130-001,2014,11,8,2,317,327,644,843
0130-001,2014,11,8,3,246,219,465,644
0130-001,2014,11,8,4,240,216,456,465
0130-001,2014,11,8,5,246,277,523,456
0130-001,2014,11,8,6,464,443,907,523
0130-001,2014,11,8,7,942,678,1620,907
0130-001,2014,11,8,8,1569,1248,2817,1620
0130-001,2014,11,8,9,1810,1766,3576,2817
0130-001,2014,11,8,10,1847,1867,3714,3576
0130-001,2014,11,8,11,1910,2164,4074,3714
0130-001,2014,11,8,12,1772,2179,3951,4074
0130-001,2014,11,8,13,1678,2028,3706,3951
0130-001,2014,11,8,14,1732,2049,3781,3706
0130-001,2014,11,8,15,1790,1920,3710,3781
0130-001,2014,11,8,16,1819,1916,3735,3710
0130-001,2014,11,8,17,2005,1966,3971,3735
0130-001,2014,11,8,18,2034,2257,4291,3971
0130-001,2014,11,8,19,1943,2010,3953,4291
0130-001,2014,11,8,20,1405,1348,2753,3953
0130-001,2014,11,8,21,1187,1178,2365,2753
0130-001,2014,11,8,22,1073,928,2001,2365
0130-001,2014,11,8,23,767,665,1432,2001
0130-001,2014,11,8,24,444,445,889,1432
0130-001,2014,11,9,1,349,342,691,889
0130-001,2014,11,9,2,331,237,568,691
0130-001,2014,11,9,3,235,206,441,568
0130-001,2014,11,9,4,191,161,352,441
0130-001,2014,11,9,5,197,180,377,352
0130-001,2014,11,9,6,275,273,548,377
0130-001,2014,11,9,7,522,447,969,548
0130-001,2014,11,9,8,815,680,1495,969
0130-001,2014,11,9,9,996,1000,1996,1495
0130-001,2014,11,9,10,1167,1141,2308,1996
0130-001,2014,11,9,11,1231,1257,2488,2308
0130-001,2014,11,9,12,1129,1348,2477,2488
0130-001,2014,11,9,13,1243,1300,2543,2477
0130-001,2014,11,9,14,1392,1550,2942,2543
0130-001,2014,11,9,15,1503,1564,3067,2942
0130-001,2014,11,9,16,1729,1659,3388,3067
0130-001,2014,11,9,17,1967,1759,3726,3388
0130-001,2014,11,9,18,1848,1683,3531,3726
0130-001,2014,11,9,19,1963,1476,3439,3531
0130-001,2014,11,9,20,1672,1169,2841,3439
0130-001,2014,11,9,21,1609,977,2586,2841
0130-001,2014,11,9,22,1489,770,2259,2586
0130-001,2014,11,9,23,876,527,1403,2259
0130-001,2014,11,9,24,469,324,793,1403
0130-001,2014,11,10,1,271,244,515,793
0130-001,2014,11,10,2,168,152,320,515
0130-001,2014,11,10,3,122,120,242,320
0130-001,2014,11,10,4,91,135,226,242
0130-001,2014,11,10,5,153,208,361,226
0130-001,2014,11,10,6,469,379,848,361
0130-001,2014,11,10,7,1680,879,2559,848
0130-001,2014,11,10,8,2703,1889,4592,2559
0130-001,2014,11,10,9,2555,2094,4649,4592
0130-001,2014,11,10,10,2059,1737,3796,4649
0130-001,2014,11,10,11,2030,1826,3856,3796
0130-001,2014,11,10,12,1640,1706,3346,3856
0130-001,2014,11,10,13,1529,1627,3156,3346
0130-001,2014,11,10,14,1549,1931,3480,3156
0130-001,2014,11,10,15,1727,1954,3681,3480
0130-001,2014,11,10,16,2008,1968,3976,3681
0130-001,2014,11,10,17,1796,2115,3911,3976
0130-001,2014,11,10,18,1749,2466,4215,3911
0130-001,2014,11,10,19,1739,2501,4240,4215
0130-001,2014,11,10,20,1434,1858,3292,4240
0130-001,2014,11,10,21,1234,1753,2987,3292
0130-001,2014,11,10,22,1242,1345,2587,2987
0130-001,2014,11,10,23,1113,775,1888,2587
0130-001,2014,11,10,24,562,489,1051,1888
0130-001,2014,11,11,1,373,353,726,1051
0130-001,2014,11,11,2,277,207,484,726
0130-001,2014,11,11,3,202,164,366,484
0130-001,2014,11,11,4,119,169,288,366
0130-001,2014,11,11,5,179,241,420,288
0130-001,2014,11,11,6,435,401,836,420
0130-001,2014,11,11,7,1636,795,2431,836
0130-001,2014,11,11,8,2116,1817,3933,2431
0130-001,2014,11,11,9,2311,2041,4352,3933
0130-001,2014,11,11,10,2047,1904,3951,4352
0130-001,2014,11,11,11,1729,1766,3495,3951
0130-001,2014,11,11,12,1703,1705,3408,3495
0130-001,2014,11,11,13,1494,1655,3149,3408
0130-001,2014,11,11,14,1716,1791,3507,3149
0130-001,2014,11,11,15,1876,1965,3841,3507
0130-001,2014,11,11,16,2025,1922,3947,3841
0130-001,2014,11,11,17,2159,2148,4307,3947
0130-001,2014,11,11,18,2123,2432,4555,4307
0130-001,2014,11,11,19,2001,2512,4513,4555
0130-001,2014,11,11,20,1781,1863,3644,4513
0130-001,2014,11,11,21,1342,1703,3045,3644
0130-001,2014,11,11,22,1621,1413,3034,3045
0130-001,2014,11,11,23,1189,776,1965,3034
0130-001,2014,11,11,24,793,541,1334,1965
0130-001,2014,11,12,1,420,380,800,1334
0130-001,2014,11,12,2,302,210,512,800
0130-001,2014,11,12,3,206,185,391,512
0130-001,2014,11,12,4,155,178,333,391
0130-001,2014,11,12,5,208,227,435,333
0130-001,2014,11,12,6,358,356,714,435
0130-001,2014,11,12,7,1376,749,2125,714
0130-001,2014,11,12,8,2214,1808,4022,2125
0130-001,2014,11,12,9,2136,2059,4195,4022
0130-001,2014,11,12,10,1754,1823,3577,4195
0130-001,2014,11,12,11,1734,1796,3530,3577
0130-001,2014,11,12,12,1725,1728,3453,3530
0130-001,2014,11,12,13,1545,1682,3227,3453
0130-001,2014,11,12,14,1899,1825,3724,3227
0130-001,2014,11,12,15,1807,1955,3762,3724
0130-001,2014,11,12,16,1881,1950,3831,3762
0130-001,2014,11,12,17,2434,1971,4405,3831
0130-001,2014,11,12,18,2288,2381,4669,4405
0130-001,2014,11,12,19,1985,2398,4383,4669
0130-001,2014,11,12,20,1420,1853,3273,4383
0130-001,2014,11,12,21,1240,1497,2737,3273
0130-001,2014,11,12,22,1116,1210,2326,2737
0130-001,2014,11,12,23,931,727,1658,2326
0130-001,2014,11,12,24,493,511,1004,1658
0130-001,2014,11,13,1,355,313,668,1004
0130-001,2014,11,13,2,202,233,435,668
0130-001,2014,11,13,3,173,186,359,435
0130-001,2014,11,13,4,202,164,366,359
0130-001,2014,11,13,5,169,248,417,366
0130-001,2014,11,13,6,406,362,768,417
0130-001,2014,11,13,7,1512,836,2348,768
0130-001,2014,11,13,8,2054,1683,3737,2348
0130-001,2014,11,13,9,2199,2062,4261,3737
0130-001,2014,11,13,10,2192,1811,4003,4261
0130-001,2014,11,13,11,2123,1746,3869,4003
0130-001,2014,11,13,12,1948,1759,3707,3869
0130-001,2014,11,13,13,1603,1579,3182,3707
0130-001,2014,11,13,14,1994,1833,3827,3182
0130-001,2014,11,13,15,2210,1846,4056,3827
0130-001,2014,11,13,16,2017,1969,3986,4056
0130-001,2014,11,13,17,1967,2139,4106,3986
0130-001,2014,11,13,18,1852,2393,4245,4106
0130-001,2014,11,13,19,1816,2455,4271,4245
0130-001,2014,11,13,20,1380,1854,3234,4271
0130-001,2014,11,13,21,1356,1621,2977,3234
0130-001,2014,11,13,22,1109,1265,2374,2977
0130-001,2014,11,13,23,889,724,1613,2374
0130-001,2014,11,13,24,538,477,1015,1613
0130-001,2014,11,14,1,391,341,732,1015
0130-001,2014,11,14,2,289,236,525,732
0130-001,2014,11,14,3,171,163,334,525
0130-001,2014,11,14,4,150,187,337,334
0130-001,2014,11,14,5,226,240,466,337
0130-001,2014,11,14,6,448,403,851,466
0130-001,2014,11,14,7,1511,782,2293,851
0130-001,2014,11,14,8,2112,1706,3818,2293
0130-001,2014,11,14,9,2201,2058,4259,3818
0130-001,2014,11,14,10,1947,1802,3749,4259
0130-001,2014,11,14,11,2157,1852,4009,3749
0130-001,2014,11,14,12,2152,1823,3975,4009
0130-001,2014,11,14,13,1928,1623,3551,3975
0130-001,2014,11,14,14,2116,1839,3955,3551
0130-001,2014,11,14,15,1887,1974,3861,3955
0130-001,2014,11,14,16,2130,2020,4150,3861
0130-001,2014,11,14,17,2226,2209,4435,4150
0130-001,2014,11,14,18,2194,2442,4636,4435
0130-001,2014,11,14,19,2099,2516,4615,4636
0130-001,2014,11,14,20,1761,2229,3990,4615
0130-001,2014,11,14,21,1325,1879,3204,3990
0130-001,2014,11,14,22,1234,1342,2576,3204
0130-001,2014,11,14,23,929,815,1744,2576
0130-001,2014,11,14,24,676,604,1280,1744
0130-001,2014,11,15,1,433,401,834,1280
0130-001,2014,11,15,2,364,334,698,834
0130-001,2014,11,15,3,224,259,483,698
0130-001,2014,11,15,4,202,210,412,483
0130-001,2014,11,15,5,206,286,492,412
0130-001,2014,11,15,6,417,362,779,492
0130-001,2014,11,15,7,991,658,1649,779
0130-001,2014,11,15,8,1609,1202,2811,1649
0130-001,2014,11,15,9,1932,1791,3723,2811
0130-001,2014,11,15,10,2047,1995,4042,3723
0130-001,2014,11,15,11,2014,2363,4377,4042
0130-001,2014,11,15,12,2087,2302,4389,4377
0130-001,2014,11,15,13,1870,2319,4189,4389
0130-001,2014,11,15,14,2007,2206,4213,4189
0130-001,2014,11,15,15,2201,2189,4390,4213
0130-001,2014,11,15,16,2302,2115,4417,4390
0130-001,2014,11,15,17,2246,2140,4386,4417
0130-001,2014,11,15,18,2186,2321,4507,4386
0130-001,2014,11,15,19,2190,2024,4214,4507
0130-001,2014,11,15,20,1730,1448,3178,4214
0130-001,2014,11,15,21,1363,1122,2485,3178
0130-001,2014,11,15,22,1193,960,2153,2485
0130-001,2014,11,15,23,716,633,1349,2153
0130-001,2014,11,15,24,487,452,939,1349
0130-001,2014,11,16,1,351,377,728,939
0130-001,2014,11,16,2,262,269,531,728
0130-001,2014,11,16,3,215,196,411,531
0130-001,2014,11,16,4,148,141,289,411
0130-001,2014,11,16,5,169,167,336,289
0130-001,2014,11,16,6,282,269,551,336
0130-001,2014,11,16,7,526,425,951,551
0130-001,2014,11,16,8,755,693,1448,951
0130-001,2014,11,16,9,971,984,1955,1448
0130-001,2014,11,16,10,1423,1137,2560,1955
0130-001,2014,11,16,11,1483,1370,2853,2560
0130-001,2014,11,16,12,1133,1401,2534,2853
0130-001,2014,11,16,13,1570,1572,3142,2534
0130-001,2014,11,16,14,1614,1747,3361,3142
0130-001,2014,11,16,15,1789,1731,3520,3361
0130-001,2014,11,16,16,1985,1877,3862,3520
0130-001,2014,11,16,17,2068,1794,3862,3862
0130-001,2014,11,16,18,1952,1772,3724,3862
0130-001,2014,11,16,19,2082,1489,3571,3724
0130-001,2014,11,16,20,1894,1200,3094,3571
0130-001,2014,11,16,21,1923,990,2913,3094
0130-001,2014,11,16,22,1570,798,2368,2913
0130-001,2014,11,16,23,807,543,1350,2368
0130-001,2014,11,16,24,453,343,796,1350
0130-001,2014,11,17,1,248,206,454,796
0130-001,2014,11,17,2,188,149,337,454
0130-001,2014,11,17,3,131,115,246,337
0130-001,2014,11,17,4,146,134,280,246
0130-001,2014,11,17,5,144,213,357,280
0130-001,2014,11,17,6,437,360,797,357
0130-001,2014,11,17,7,1618,830,2448,797
0130-001,2014,11,17,8,2072,1792,3864,2448
0130-001,2014,11,17,9,2283,2025,4308,3864
0130-001,2014,11,17,10,1792,1735,3527,4308
0130-001,2014,11,17,11,1803,1769,3572,3527
0130-001,2014,11,17,12,1848,1703,3551,3572
0130-001,2014,11,17,13,1514,1576,3090,3551
0130-001,2014,11,17,14,1838,1845,3683,3090
0130-001,2014,11,17,15,1856,1963,3819,3683
0130-001,2014,11,17,16,1747,1892,3639,3819
0130-001,2014,11,17,17,1956,2045,4001,3639
0130-001,2014,11,17,18,1878,2305,4183,4001
0130-001,2014,11,17,19,1796,2354,4150,4183
0130-001,2014,11,17,20,1381,1804,3185,4150
0130-001,2014,11,17,21,1272,1605,2877,3185
0130-001,2014,11,17,22,1074,1323,2397,2877
0130-001,2014,11,17,23,816,730,1546,2397
0130-001,2014,11,17,24,495,480,975,1546
0130-001,2014,11,18,1,300,311,611,975
0130-001,2014,11,18,2,191,206,397,611
0130-001,2014,11,18,3,124,137,261,397
0130-001,2014,11,18,4,122,147,269,261
0130-001,2014,11,18,5,168,226,394,269
0130-001,2014,11,18,6,417,375,792,394
0130-001,2014,11,18,7,1580,734,2314,792
0130-001,2014,11,18,8,2170,1779,3949,2314
0130-001,2014,11,18,9,2272,2145,4417,3949
0130-001,2014,11,18,10,2206,1794,4000,4417
0130-001,2014,11,18,11,1974,1803,3777,4000
0130-001,2014,11,18,12,1729,1739,3468,3777
0130-001,2014,11,18,13,1492,1510,3002,3468
0130-001,2014,11,18,14,1827,1798,3625,3002
0130-001,2014,11,18,15,1798,1910,3708,3625
0130-001,2014,11,18,16,1867,1930,3797,3708
0130-001,2014,11,18,17,1967,2100,4067,3797
0130-001,2014,11,18,18,1983,2352,4335,4067
0130-001,2014,11,18,19,1741,2492,4233,4335
0130-001,2014,11,18,20,1478,1829,3307,4233
0130-001,2014,11,18,21,1232,1649,2881,3307
0130-001,2014,11,18,22,1173,1296,2469,2881
0130-001,2014,11,18,23,905,766,1671,2469
0130-001,2014,11,18,24,504,478,982,1671
0130-001,2014,11,19,1,371,324,695,982
0130-001,2014,11,19,2,233,215,448,695
0130-001,2014,11,19,3,189,172,361,448
0130-001,2014,11,19,4,169,161,330,361
0130-001,2014,11,19,5,159,217,376,330
0130-001,2014,11,19,6,420,350,770,376
0130-001,2014,11,19,7,1451,769,2220,770
0130-001,2014,11,19,8,2125,1751,3876,2220
0130-001,2014,11,19,9,2192,2091,4283,3876
0130-001,2014,11,19,10,2261,1793,4054,4283
0130-001,2014,11,19,11,1996,1822,3818,4054
0130-001,2014,11,19,12,1796,1730,3526,3818
0130-001,2014,11,19,13,1545,1654,3199,3526
0130-001,2014,11,19,14,1810,1989,3799,3199
0130-001,2014,11,19,15,1914,1976,3890,3799
0130-001,2014,11,19,16,1868,1928,3796,3890
0130-001,2014,11,19,17,1870,2075,3945,3796
0130-001,2014,11,19,18,2123,2478,4601,3945
0130-001,2014,11,19,19,1767,2578,4345,4601
0130-001,2014,11,19,20,1378,1861,3239,4345
0130-001,2014,11,19,21,1252,1587,2839,3239
0130-001,2014,11,19,22,1300,1278,2578,2839
0130-001,2014,11,19,23,933,762,1695,2578
0130-001,2014,11,19,24,586,537,1123,1695
0130-001,2014,11,20,1,411,342,753,1123
0130-001,2014,11,20,2,279,221,500,753
0130-001,2014,11,20,3,173,189,362,500
0130-001,2014,11,20,4,139,163,302,362
0130-001,2014,11,20,5,191,227,418,302
0130-001,2014,11,20,6,426,362,788,418
0130-001,2014,11,20,7,1511,753,2264,788
0130-001,2014,11,20,8,2292,1808,4100,2264
0130-001,2014,11,20,9,2365,2083,4448,4100
0130-001,2014,11,20,10,2148,1825,3973,4448
0130-001,2014,11,20,11,1907,1852,3759,3973
0130-001,2014,11,20,12,1932,1861,3793,3759
0130-001,2014,11,20,13,1570,1638,3208,3793
0130-001,2014,11,20,14,1972,1807,3779,3208
0130-001,2014,11,20,15,1878,1911,3789,3779
0130-001,2014,11,20,16,1868,1956,3824,3789
0130-001,2014,11,20,17,1772,2096,3868,3824
0130-001,2014,11,20,18,1899,2435,4334,3868
0130-001,2014,11,20,19,2105,2504,4609,4334
0130-001,2014,11,20,20,1452,1804,3256,4609
0130-001,2014,11,20,21,1389,1687,3076,3256
0130-001,2014,11,20,22,1280,1272,2552,3076
0130-001,2014,11,20,23,1027,803,1830,2552
0130-001,2014,11,20,24,633,529,1162,1830
0130-001,2014,11,21,1,477,363,840,1162
0130-001,2014,11,21,2,266,235,501,840
0130-001,2014,11,21,3,273,192,465,501
0130-001,2014,11,21,4,166,177,343,465
0130-001,2014,11,21,5,248,239,487,343
0130-001,2014,11,21,6,482,370,852,487
0130-001,2014,11,21,7,1614,754,2368,852
0130-001,2014,11,21,8,2250,1716,3966,2368
0130-001,2014,11,21,9,2540,2045,4585,3966
0130-001,2014,11,21,10,2179,1876,4055,4585
0130-001,2014,11,21,11,2223,1853,4076,4055
0130-001,2014,11,21,12,2116,1874,3990,4076
0130-001,2014,11,21,13,1923,1823,3746,3990
0130-001,2014,11,21,14,2117,1881,3998,3746
0130-001,2014,11,21,15,1943,2001,3944,3998
0130-001,2014,11,21,16,2063,2070,4133,3944
0130-001,2014,11,21,17,1836,2234,4070,4133
0130-001,2014,11,21,18,1925,2526,4451,4070
0130-001,2014,11,21,19,1981,2595,4576,4451
0130-001,2014,11,21,20,1496,2144,3640,4576
0130-001,2014,11,21,21,1262,1822,3084,3640
0130-001,2014,11,21,22,1231,1343,2574,3084
0130-001,2014,11,21,23,885,862,1747,2574
0130-001,2014,11,21,24,604,622,1226,1747
0130-001,2014,11,22,1,429,435,864,1226
0130-001,2014,11,22,2,375,331,706,864
0130-001,2014,11,22,3,260,237,497,706
0130-001,2014,11,22,4,177,233,410,497
0130-001,2014,11,22,5,213,284,497,410
0130-001,2014,11,22,6,358,399,757,497
0130-001,2014,11,22,7,947,665,1612,757
0130-001,2014,11,22,8,1540,1189,2729,1612
0130-001,2014,11,22,9,1685,1734,3419,2729
0130-001,2014,11,22,10,1758,1962,3720,3419
0130-001,2014,11,22,11,1890,2164,4054,3720
0130-001,2014,11,22,12,1701,2337,4038,4054
0130-001,2014,11,22,13,1665,2410,4075,4038
0130-001,2014,11,22,14,2014,2338,4352,4075
0130-001,2014,11,22,15,2010,2324,4334,4352
0130-001,2014,11,22,16,2208,2405,4613,4334
0130-001,2014,11,22,17,2008,2400,4408,4613
0130-001,2014,11,22,18,1996,2454,4450,4408
0130-001,2014,11,22,19,1876,2276,4152,4450
0130-001,2014,11,22,20,1936,1829,3765,4152
0130-001,2014,11,22,21,1254,1230,2484,3765
0130-001,2014,11,22,22,1116,892,2008,2484
0130-001,2014,11,22,23,787,646,1433,2008
0130-001,2014,11,22,24,475,475,950,1433
0130-001,2014,11,23,1,348,314,662,950
0130-001,2014,11,23,2,266,215,481,662
0130-001,2014,11,23,3,224,191,415,481
0130-001,2014,11,23,4,140,165,305,415
0130-001,2014,11,23,5,159,174,333,305
0130-001,2014,11,23,6,231,224,455,333
0130-001,2014,11,23,7,484,421,905,455
0130-001,2014,11,23,8,602,598,1200,905
0130-001,2014,11,23,9,818,897,1715,1200
0130-001,2014,11,23,10,984,1118,2102,1715
0130-001,2014,11,23,11,1178,1329,2507,2102
0130-001,2014,11,23,12,1074,1322,2396,2507
0130-001,2014,11,23,13,1460,1407,2867,2396
0130-001,2014,11,23,14,1692,1552,3244,2867
0130-001,2014,11,23,15,1862,1620,3482,3244
0130-001,2014,11,23,16,1870,1622,3492,3482
0130-001,2014,11,23,17,1460,1553,3013,3492
0130-001,2014,11,23,18,1607,1588,3195,3013
0130-001,2014,11,23,19,1625,1356,2981,3195
0130-001,2014,11,23,20,1953,1108,3061,2981
0130-001,2014,11,23,21,1738,957,2695,3061
0130-001,2014,11,23,22,1456,806,2262,2695
0130-001,2014,11,23,23,847,551,1398,2262
0130-001,2014,11,23,24,458,400,858,1398
0130-001,2014,11,24,1,213,248,461,858
0130-001,2014,11,24,2,113,153,266,461
0130-001,2014,11,24,3,102,126,228,266
0130-001,2014,11,24,4,84,141,225,228
0130-001,2014,11,24,5,100,201,301,225
0130-001,2014,11,24,6,229,370,599,301
0130-001,2014,11,24,7,1458,816,2274,599
0130-001,2014,11,24,8,2130,1766,3896,2274
0130-001,2014,11,24,9,2353,2020,4373,3896
0130-001,2014,11,24,10,1787,1726,3513,4373
0130-001,2014,11,24,11,1710,1749,3459,3513
0130-001,2014,11,24,12,1576,1755,3331,3459
0130-001,2014,11,24,13,1374,1572,2946,3331
0130-001,2014,11,24,14,1670,1834,3504,2946
0130-001,2014,11,24,15,1769,1833,3602,3504
0130-001,2014,11,24,16,1785,1882,3667,3602
0130-001,2014,11,24,17,1621,1956,3577,3667
0130-001,2014,11,24,18,1685,2317,4002,3577
0130-001,2014,11,24,19,1569,2339,3908,4002
0130-001,2014,11,24,20,1127,1636,2763,3908
0130-001,2014,11,24,21,1123,1642,2765,2763
0130-001,2014,11,24,22,976,1174,2150,2765
0130-001,2014,11,24,23,755,761,1516,2150
0130-001,2014,11,24,24,438,509,947,1516
0130-001,2014,11,25,1,333,298,631,947
0130-001,2014,11,25,2,228,202,430,631
0130-001,2014,11,25,3,142,162,304,430
0130-001,2014,11,25,4,110,168,278,304
0130-001,2014,11,25,5,166,232,398,278
0130-001,2014,11,25,6,360,339,699,398
0130-001,2014,11,25,7,1372,724,2096,699
0130-001,2014,11,25,8,2025,1740,3765,2096
0130-001,2014,11,25,9,2130,2091,4221,3765
0130-001,2014,11,25,10,1658,1794,3452,4221
0130-001,2014,11,25,11,1876,1735,3611,3452
0130-001,2014,11,25,12,1792,1616,3408,3611
0130-001,2014,11,25,13,1445,1689,3134,3408
0130-001,2014,11,25,14,1663,1820,3483,3134
0130-001,2014,11,25,15,1965,1946,3911,3483
0130-001,2014,11,25,16,1850,1993,3843,3911
0130-001,2014,11,25,17,1729,2014,3743,3843
0130-001,2014,11,25,18,1790,2379,4169,3743
0130-001,2014,11,25,19,1598,2400,3998,4169
0130-001,2014,11,25,20,1247,1794,3041,3998
0130-001,2014,11,25,21,1178,1728,2906,3041
0130-001,2014,11,25,22,1107,1240,2347,2906
0130-001,2014,11,25,23,809,752,1561,2347
0130-001,2014,11,25,24,484,564,1048,1561
0130-001,2014,11,26,1,382,327,709,1048
0130-001,2014,11,26,2,189,245,434,709
0130-001,2014,11,26,3,168,188,356,434
0130-001,2014,11,26,4,162,179,341,356
0130-001,2014,11,26,5,168,261,429,341
0130-001,2014,11,26,6,388,346,734,429
0130-001,2014,11,26,7,1360,739,2099,734
0130-001,2014,11,26,8,2101,1732,3833,2099
0130-001,2014,11,26,9,2184,2099,4283,3833
0130-001,2014,11,26,10,2037,1716,3753,4283
0130-001,2014,11,26,11,1921,1751,3672,3753
0130-001,2014,11,26,12,1674,1790,3464,3672
0130-001,2014,11,26,13,1438,1685,3123,3464
0130-001,2014,11,26,14,1827,2077,3904,3123
0130-001,2014,11,26,15,1950,1886,3836,3904
0130-001,2014,11,26,16,1916,2044,3960,3836
0130-001,2014,11,26,17,1677,1917,3594,3960
0130-001,2014,11,26,18,1740,2437,4177,3594
0130-001,2014,11,26,19,1550,2620,4170,4177
0130-001,2014,11,26,20,1138,1918,3056,4170
0130-001,2014,11,26,21,1079,1621,2700,3056
0130-001,2014,11,26,22,1031,1152,2183,2700
0130-001,2014,11,26,23,735,731,1466,2183
0130-001,2014,11,26,24,475,552,1027,1466
0130-001,2014,11,27,1,164,367,531,1027
0130-001,2014,11,27,2,151,230,381,531
0130-001,2014,11,27,3,113,202,315,381
0130-001,2014,11,27,4,100,197,297,315
0130-001,2014,11,27,5,120,232,352,297
0130-001,2014,11,27,6,312,352,664,352
0130-001,2014,11,27,7,1226,720,1946,664
0130-001,2014,11,27,8,1935,1750,3685,1946
0130-001,2014,11,27,9,2013,2032,4045,3685
0130-001,2014,11,27,10,1902,1817,3719,4045
0130-001,2014,11,27,11,1872,1841,3713,3719
0130-001,2014,11,27,12,1549,1703,3252,3713
0130-001,2014,11,27,13,1367,1609,2976,3252
0130-001,2014,11,27,14,1739,1710,3449,2976
0130-001,2014,11,27,15,1781,1908,3689,3449
0130-001,2014,11,27,16,1703,1967,3670,3689
0130-001,2014,11,27,17,1676,2020,3696,3670
0130-001,2014,11,27,18,1719,2470,4189,3696
0130-001,2014,11,27,19,1616,2458,4074,4189
0130-001,2014,11,27,20,1340,1893,3233,4074
0130-001,2014,11,27,21,1042,1635,2677,3233
0130-001,2014,11,27,22,753,1275,2028,2677
0130-001,2014,11,27,23,620,826,1446,2028
0130-001,2014,11,27,24,449,574,1023,1446
0130-001,2014,11,28,1,260,388,648,1023
0130-001,2014,11,28,2,177,245,422,648
0130-001,2014,11,28,3,117,180,297,422
0130-001,2014,11,28,4,110,206,316,297
0130-001,2014,11,28,5,119,248,367,316
0130-001,2014,11,28,6,182,362,544,367
0130-001,2014,11,28,7,406,661,1067,544
0130-001,2014,11,28,8,591,1668,2259,1067
0130-001,2014,11,28,9,1218,2046,3264,2259
0130-001,2014,11,28,10,1821,1747,3568,3264
0130-001,2014,11,28,11,1863,1882,3745,3568
0130-001,2014,11,28,12,1763,1795,3558,3745
0130-001,2014,11,28,13,1560,1806,3366,3558
0130-001,2014,11,28,14,1963,1847,3810,3366
0130-001,2014,11,28,15,2014,1850,3864,3810
0130-001,2014,11,28,16,1714,1873,3587,3864
0130-001,2014,11,28,17,1714,2082,3796,3587
0130-001,2014,11,28,18,1825,2334,4159,3796
0130-001,2014,11,28,19,1839,2413,4252,4159
0130-001,2014,11,28,20,1314,1882,3196,4252
0130-001,2014,11,28,21,1082,1595,2677,3196
0130-001,2014,11,28,22,1016,1246,2262,2677
0130-001,2014,11,28,23,900,842,1742,2262
0130-001,2014,11,28,24,602,576,1178,1742
0130-001,2014,11,29,1,458,434,892,1178
0130-001,2014,11,29,2,333,322,655,892
0130-001,2014,11,29,3,233,236,469,655
0130-001,2014,11,29,4,253,235,488,469
0130-001,2014,11,29,5,222,230,452,488
0130-001,2014,11,29,6,397,383,780,452
0130-001,2014,11,29,7,853,608,1461,780
0130-001,2014,11,29,8,1396,1055,2451,1461
0130-001,2014,11,29,9,1550,1643,3193,2451
0130-001,2014,11,29,10,1705,1860,3565,3193
0130-001,2014,11,29,11,1814,2228,4042,3565
0130-001,2014,11,29,12,1747,2401,4148,4042
0130-001,2014,11,29,13,1699,2432,4131,4148
0130-001,2014,11,29,14,1752,2442,4194,4131
0130-001,2014,11,29,15,1847,2387,4234,4194
0130-001,2014,11,29,16,1876,2323,4199,4234
0130-001,2014,11,29,17,1860,2258,4118,4199
0130-001,2014,11,29,18,1923,2280,4203,4118
0130-001,2014,11,29,19,1914,2164,4078,4203
0130-001,2014,11,29,20,1649,1533,3182,4078
0130-001,2014,11,29,21,1079,1171,2250,3182
0130-001,2014,11,29,22,1004,926,1930,2250
0130-001,2014,11,29,23,718,707,1425,1930
0130-001,2014,11,29,24,486,454,940,1425
0130-001,2014,11,30,1,248,344,592,940
0130-001,2014,11,30,2,217,284,501,592
0130-001,2014,11,30,3,151,217,368,501
0130-001,2014,11,30,4,137,180,317,368
0130-001,2014,11,30,5,110,164,274,317
0130-001,2014,11,30,6,150,264,414,274
0130-001,2014,11,30,7,402,359,761,414
0130-001,2014,11,30,8,609,541,1150,761
0130-001,2014,11,30,9,831,851,1682,1150
0130-001,2014,11,30,10,929,1062,1991,1682
0130-001,2014,11,30,11,1127,1319,2446,1991
0130-001,2014,11,30,12,1383,1535,2918,2446
0130-001,2014,11,30,13,1509,1739,3248,2918
0130-001,2014,11,30,14,1730,1667,3397,3248
0130-001,2014,11,30,15,1983,1620,3603,3397
0130-001,2014,11,30,16,2040,1559,3599,3603
0130-001,2014,11,30,17,1985,1576,3561,3599
0130-001,2014,11,30,18,1990,1400,3390,3561
0130-001,2014,11,30,19,2001,1313,3314,3390
0130-001,2014,11,30,20,2012,992,3004,3314
0130-001,2014,11,30,21,1552,933,2485,3004
0130-001,2014,11,30,22,1343,742,2085,2485
0130-001,2014,11,30,23,887,495,1382,2085
0130-001,2014,11,30,24,464,352,816,1382
0130-001,2014,12,1,1,245,250,495,816
0130-001,2014,12,1,2,155,170,325,495
0130-001,2014,12,1,3,114,129,243,325
0130-001,2014,12,1,4,94,124,218,243
0130-001,2014,12,1,5,157,201,358,218
0130-001,2014,12,1,6,388,384,772,358
0130-001,2014,12,1,7,1366,718,2084,772
0130-001,2014,12,1,8,2024,1702,3726,2084
0130-001,2014,12,1,9,2186,1983,4169,3726
0130-001,2014,12,1,10,1677,1770,3447,4169
0130-001,2014,12,1,11,1571,1601,3172,3447
0130-001,2014,12,1,12,1454,1624,3078,3172
0130-001,2014,12,1,13,1230,1498,2728,3078
0130-001,2014,12,1,14,1466,1614,3080,2728
0130-001,2014,12,1,15,1522,1729,3251,3080
0130-001,2014,12,1,16,1473,1735,3208,3251
0130-001,2014,12,1,17,1446,1750,3196,3208
0130-001,2014,12,1,18,1389,2000,3389,3196
0130-001,2014,12,1,19,1428,2245,3673,3389
0130-001,2014,12,1,20,1007,1566,2573,3673
0130-001,2014,12,1,21,836,1330,2166,2573
0130-001,2014,12,1,22,872,979,1851,2166
0130-001,2014,12,1,23,546,532,1078,1851
0130-001,2014,12,1,24,352,368,720,1078
0130-001,2014,12,2,1,242,236,478,720
0130-001,2014,12,2,2,130,156,286,478
0130-001,2014,12,2,3,132,139,271,286
0130-001,2014,12,2,4,103,128,231,271
0130-001,2014,12,2,5,125,186,311,231
0130-001,2014,12,2,6,280,285,565,311
0130-001,2014,12,2,7,1194,615,1809,565
0130-001,2014,12,2,8,1991,1549,3540,1809
0130-001,2014,12,2,9,1923,1812,3735,3540
0130-001,2014,12,2,10,1652,1567,3219,3735
0130-001,2014,12,2,11,1580,1622,3202,3219
0130-001,2014,12,2,12,1531,1628,3159,3202
0130-001,2014,12,2,13,1266,1501,2767,3159
0130-001,2014,12,2,14,1560,1621,3181,2767
0130-001,2014,12,2,15,1693,1760,3453,3181
0130-001,2014,12,2,16,1794,1864,3658,3453
0130-001,2014,12,2,17,1589,1915,3504,3658
0130-001,2014,12,2,18,1695,2265,3960,3504
0130-001,2014,12,2,19,1513,2317,3830,3960
0130-001,2014,12,2,20,1122,1654,2776,3830
0130-001,2014,12,2,21,953,1235,2188,2776
0130-001,2014,12,2,22,492,354,846,2188
0130-001,2014,12,2,23,190,237,427,846
0130-001,2014,12,2,24,407,190,597,427
0130-001,2014,12,3,1,305,115,420,597
0130-001,2014,12,3,2,159,70,229,420
0130-001,2014,12,3,3,125,60,185,229
0130-001,2014,12,3,4,89,40,129,185
0130-001,2014,12,3,5,119,104,223,129
0130-001,2014,12,3,6,245,175,420,223
0130-001,2014,12,3,7,973,381,1354,420
0130-001,2014,12,3,8,1673,863,2536,1354
0130-001,2014,12,3,9,1875,1104,2979,2536
0130-001,2014,12,3,10,1783,1294,3077,2979
0130-001,2014,12,3,11,1439,1115,2554,3077
0130-001,2014,12,3,12,1410,970,2380,2554
0130-001,2014,12,3,13,1237,1066,2303,2380
0130-001,2014,12,3,14,1522,1239,2761,2303
0130-001,2014,12,3,15,1513,1358,2871,2761
0130-001,2014,12,3,16,1536,1363,2899,2871
0130-001,2014,12,3,17,1484,1520,3004,2899
0130-001,2014,12,3,18,1358,1581,2939,3004
0130-001,2014,12,3,19,1333,1556,2889,2939
0130-001,2014,12,3,20,897,1157,2054,2889
0130-001,2014,12,3,21,906,986,1892,2054
0130-001,2014,12,3,22,762,702,1464,1892
0130-001,2014,12,3,23,537,441,978,1464
0130-001,2014,12,3,24,364,256,620,978
0130-001,2014,12,4,1,278,185,463,620
0130-001,2014,12,4,2,125,117,242,463
0130-001,2014,12,4,3,78,78,156,242
0130-001,2014,12,4,4,94,75,169,156
0130-001,2014,12,4,5,109,107,216,169
0130-001,2014,12,4,6,197,142,339,216
0130-001,2014,12,4,7,940,535,1475,339
0130-001,2014,12,4,8,1578,1378,2956,1475
0130-001,2014,12,4,9,1661,1645,3306,2956
0130-001,2014,12,4,10,1657,1414,3071,3306
0130-001,2014,12,4,11,1836,1466,3302,3071
0130-001,2014,12,4,12,1689,1470,3159,3302
0130-001,2014,12,4,13,1264,1408,2672,3159
0130-001,2014,12,4,14,1576,1558,3134,2672
0130-001,2014,12,4,15,1682,1708,3390,3134
0130-001,2014,12,4,16,1635,1508,3143,3390
0130-001,2014,12,4,17,1614,1596,3210,3143
0130-001,2014,12,4,18,1787,1832,3619,3210
0130-001,2014,12,4,19,1506,1734,3240,3619
0130-001,2014,12,4,20,1183,1323,2506,3240
0130-001,2014,12,4,21,957,977,1934,2506
0130-001,2014,12,4,22,838,600,1438,1934
0130-001,2014,12,4,23,643,393,1036,1438
0130-001,2014,12,4,24,404,229,633,1036
0130-001,2014,12,5,1,319,193,512,633
0130-001,2014,12,5,2,190,137,327,512
0130-001,2014,12,5,3,146,100,246,327
0130-001,2014,12,5,4,130,113,243,246
0130-001,2014,12,5,5,121,127,248,243
0130-001,2014,12,5,6,292,233,525,248
0130-001,2014,12,5,7,1236,640,1876,525
0130-001,2014,12,5,8,1844,1620,3464,1876
0130-001,2014,12,5,9,1968,1970,3938,3464
0130-001,2014,12,5,10,1608,1691,3299,3938
0130-001,2014,12,5,11,1673,1836,3509,3299
0130-001,2014,12,5,12,1603,1738,3341,3509
0130-001,2014,12,5,13,1416,1518,2934,3341
0130-001,2014,12,5,14,1626,1330,2956,2934
0130-001,2014,12,5,15,1745,1646,3391,2956
0130-001,2014,12,5,16,1752,1544,3296,3391
0130-001,2014,12,5,17,1853,1801,3654,3296
0130-001,2014,12,5,18,1972,1935,3907,3654
0130-001,2014,12,5,19,1826,1958,3784,3907
0130-001,2014,12,5,20,1250,1602,2852,3784
0130-001,2014,12,5,21,1084,1240,2324,2852
0130-001,2014,12,5,22,1056,866,1922,2324
0130-001,2014,12,5,23,822,603,1425,1922
0130-001,2014,12,5,24,559,420,979,1425
0130-001,2014,12,6,1,393,330,723,979
0130-001,2014,12,6,2,332,226,558,723
0130-001,2014,12,6,3,220,146,366,558
0130-001,2014,12,6,4,184,144,328,366
0130-001,2014,12,6,5,146,151,297,328
0130-001,2014,12,6,6,262,226,488,297
0130-001,2014,12,6,7,759,460,1219,488
0130-001,2014,12,6,8,1185,899,2084,1219
0130-001,2014,12,6,9,1509,1236,2745,2084
0130-001,2014,12,6,10,1544,1358,2902,2745
0130-001,2014,12,6,11,1697,1882,3579,2902
0130-001,2014,12,6,12,1538,2087,3625,3579
0130-001,2014,12,6,13,1499,2358,3857,3625
0130-001,2014,12,6,14,1686,1939,3625,3857
0130-001,2014,12,6,15,1776,1603,3379,3625
0130-001,2014,12,6,16,1913,1699,3612,3379
0130-001,2014,12,6,17,1713,1565,3278,3612
0130-001,2014,12,6,18,1850,1296,3146,3278
0130-001,2014,12,6,19,1953,1284,3237,3146
0130-001,2014,12,6,20,1362,935,2297,3237
0130-001,2014,12,6,21,904,750,1654,2297
0130-001,2014,12,6,22,892,675,1567,1654
0130-001,2014,12,6,23,650,396,1046,1567
0130-001,2014,12,6,24,497,287,784,1046
0130-001,2014,12,7,1,377,261,638,784
0130-001,2014,12,7,2,242,206,448,638
0130-001,2014,12,7,3,211,128,339,448
0130-001,2014,12,7,4,172,105,277,339
0130-001,2014,12,7,5,143,105,248,277
0130-001,2014,12,7,6,190,162,352,248
0130-001,2014,12,7,7,404,237,641,352
0130-001,2014,12,7,8,458,462,920,641
0130-001,2014,12,7,9,706,694,1400,920
0130-001,2014,12,7,10,760,830,1590,1400
0130-001,2014,12,7,11,1025,1034,2059,1590
0130-001,2014,12,7,12,1047,1110,2157,2059
0130-001,2014,12,7,13,1219,1483,2702,2157
0130-001,2014,12,7,14,1455,1352,2807,2702
0130-001,2014,12,7,15,1563,1397,2960,2807
0130-001,2014,12,7,16,1803,1532,3335,2960
0130-001,2014,12,7,17,1889,1444,3333,3335
0130-001,2014,12,7,18,1797,1383,3180,3333
0130-001,2014,12,7,19,1767,935,2702,3180
0130-001,2014,12,7,20,1237,758,1995,2702
0130-001,2014,12,7,21,1110,682,1792,1995
0130-001,2014,12,7,22,978,610,1588,1792
0130-001,2014,12,7,23,560,426,986,1588
0130-001,2014,12,7,24,398,249,647,986
0130-001,2014,12,8,1,251,187,438,647
0130-001,2014,12,8,2,150,136,286,438
0130-001,2014,12,8,3,116,110,226,286
0130-001,2014,12,8,4,105,76,181,226
0130-001,2014,12,8,5,109,102,211,181
0130-001,2014,12,8,6,303,178,481,211
0130-001,2014,12,8,7,1273,444,1717,481
0130-001,2014,12,8,8,1918,1704,3622,1717
0130-001,2014,12,8,9,2018,2004,4022,3622
0130-001,2014,12,8,10,1635,1722,3357,4022
0130-001,2014,12,8,11,1632,1706,3338,3357
0130-001,2014,12,8,12,1477,1480,2957,3338
0130-001,2014,12,8,13,1362,1278,2640,2957
0130-001,2014,12,8,14,1648,1329,2977,2640
0130-001,2014,12,8,15,1709,1537,3246,2977
0130-001,2014,12,8,16,1763,1506,3269,3246
0130-001,2014,12,8,17,1612,1548,3160,3269
0130-001,2014,12,8,18,1747,1829,3576,3160
0130-001,2014,12,8,19,1655,1830,3485,3576
0130-001,2014,12,8,20,1120,1295,2415,3485
0130-001,2014,12,8,21,1027,1331,2358,2415
0130-001,2014,12,8,22,984,1147,2131,2358
0130-001,2014,12,8,23,710,600,1310,2131
0130-001,2014,12,8,24,467,382,849,1310
0130-001,2014,12,9,1,303,247,550,849
0130-001,2014,12,9,2,197,163,360,550
0130-001,2014,12,9,3,125,117,242,360
0130-001,2014,12,9,4,155,149,304,242
0130-001,2014,12,9,5,152,202,354,304
0130-001,2014,12,9,6,330,327,657,354
0130-001,2014,12,9,7,1245,501,1746,657
0130-001,2014,12,9,8,1999,1297,3296,1746
0130-001,2014,12,9,9,2038,1648,3686,3296
0130-001,2014,12,9,10,1761,1389,3150,3686
0130-001,2014,12,9,11,1711,1704,3415,3150
0130-001,2014,12,9,12,1504,1484,2988,3415
0130-001,2014,12,9,13,1336,1276,2612,2988
0130-001,2014,12,9,14,1617,1346,2963,2612
0130-001,2014,12,9,15,1578,1510,3088,2963
0130-001,2014,12,9,16,1774,1484,3258,3088
0130-001,2014,12,9,17,1677,1529,3206,3258
0130-001,2014,12,9,18,1675,1819,3494,3206
0130-001,2014,12,9,19,1661,2046,3707,3494
0130-001,2014,12,9,20,1198,1748,2946,3707
0130-001,2014,12,9,21,1093,1508,2601,2946
0130-001,2014,12,9,22,1002,1324,2326,2601
0130-001,2014,12,9,23,786,776,1562,2326
0130-001,2014,12,9,24,447,457,904,1562
0130-001,2014,12,10,1,330,322,652,904
0130-001,2014,12,10,2,215,240,455,652
0130-001,2014,12,10,3,141,164,305,455
0130-001,2014,12,10,4,141,149,290,305
0130-001,2014,12,10,5,154,206,360,290
0130-001,2014,12,10,6,330,365,695,360
0130-001,2014,12,10,7,1342,705,2047,695
0130-001,2014,12,10,8,2066,1695,3761,2047
0130-001,2014,12,10,9,2101,2028,4129,3761
0130-001,2014,12,10,10,1819,1845,3664,4129
0130-001,2014,12,10,11,1871,1715,3586,3664
0130-001,2014,12,10,12,1621,1466,3087,3586
0130-001,2014,12,10,13,1327,1260,2587,3087
0130-001,2014,12,10,14,1577,1471,3048,2587
0130-001,2014,12,10,15,1610,1548,3158,3048
0130-001,2014,12,10,16,1619,1551,3170,3158
0130-001,2014,12,10,17,1560,1585,3145,3170
0130-001,2014,12,10,18,1510,1826,3336,3145
0130-001,2014,12,10,19,1418,1930,3348,3336
0130-001,2014,12,10,20,1022,1401,2423,3348
0130-001,2014,12,10,21,995,1180,2175,2423
0130-001,2014,12,10,22,908,957,1865,2175
0130-001,2014,12,10,23,648,590,1238,1865
0130-001,2014,12,10,24,416,319,735,1238
0130-001,2014,12,11,1,364,227,591,735
0130-001,2014,12,11,2,208,147,355,591
0130-001,2014,12,11,3,166,94,260,355
0130-001,2014,12,11,4,148,96,244,260
0130-001,2014,12,11,5,150,120,270,244
0130-001,2014,12,11,6,325,200,525,270
0130-001,2014,12,11,7,1234,590,1824,525
0130-001,2014,12,11,8,1940,1476,3416,1824
0130-001,2014,12,11,9,2095,1808,3903,3416
0130-001,2014,12,11,10,1673,1562,3235,3903
0130-001,2014,12,11,11,1722,1584,3306,3235
0130-001,2014,12,11,12,1502,1634,3136,3306
0130-001,2014,12,11,13,1441,1532,2973,3136
0130-001,2014,12,11,14,1767,1680,3447,2973
0130-001,2014,12,11,15,1882,1734,3616,3447
0130-001,2014,12,11,16,1821,1524,3345,3616
0130-001,2014,12,11,17,1619,1584,3203,3345
0130-001,2014,12,11,18,1711,2015,3726,3203
0130-001,2014,12,11,19,1592,1983,3575,3726
0130-001,2014,12,11,20,1149,1579,2728,3575
0130-001,2014,12,11,21,1144,1446,2590,2728
0130-001,2014,12,11,22,1066,1338,2404,2590
0130-001,2014,12,11,23,825,789,1614,2404
0130-001,2014,12,11,24,506,525,1031,1614
0130-001,2014,12,12,1,389,364,753,1031
0130-001,2014,12,12,2,213,251,464,753
0130-001,2014,12,12,3,209,200,409,464
0130-001,2014,12,12,4,152,164,316,409
0130-001,2014,12,12,5,152,205,357,316
0130-001,2014,12,12,6,328,284,612,357
0130-001,2014,12,12,7,1396,618,2014,612
0130-001,2014,12,12,8,2022,1573,3595,2014
0130-001,2014,12,12,9,2124,1893,4017,3595
0130-001,2014,12,12,10,1722,1635,3357,4017
0130-001,2014,12,12,11,1830,1790,3620,3357
0130-001,2014,12,12,12,1626,1682,3308,3620
0130-001,2014,12,12,13,1464,1231,2695,3308
0130-001,2014,12,12,14,1580,1529,3109,2695
0130-001,2014,12,12,15,1812,1601,3413,3109
0130-001,2014,12,12,16,1716,1616,3332,3413
0130-001,2014,12,12,17,1437,1332,2769,3332
0130-001,2014,12,12,18,1715,1551,3266,2769
0130-001,2014,12,12,19,1817,1638,3455,3266
0130-001,2014,12,12,20,1174,1459,2633,3455
0130-001,2014,12,12,21,863,1244,2107,2633
0130-001,2014,12,12,22,771,924,1695,2107
0130-001,2014,12,12,23,632,495,1127,1695
0130-001,2014,12,12,24,411,325,736,1127
0130-001,2014,12,13,1,265,333,598,736
0130-001,2014,12,13,2,247,262,509,598
0130-001,2014,12,13,3,150,180,330,509
0130-001,2014,12,13,4,157,167,324,330
0130-001,2014,12,13,5,139,197,336,324
0130-001,2014,12,13,6,190,234,424,336
0130-001,2014,12,13,7,458,364,822,424
0130-001,2014,12,13,8,919,690,1609,822
0130-001,2014,12,13,9,1050,1029,2079,1609
0130-001,2014,12,13,10,1149,1262,2411,2079
0130-001,2014,12,13,11,1443,1582,3025,2411
0130-001,2014,12,13,12,1475,1610,3085,3025
0130-001,2014,12,13,13,1491,2065,3556,3085
0130-001,2014,12,13,14,1682,1788,3470,3556
0130-001,2014,12,13,15,1677,1613,3290,3470
0130-001,2014,12,13,16,1878,1656,3534,3290
0130-001,2014,12,13,17,1915,1608,3523,3534
0130-001,2014,12,13,18,1887,1529,3416,3523
0130-001,2014,12,13,19,1729,1436,3165,3416
0130-001,2014,12,13,20,1155,943,2098,3165
0130-001,2014,12,13,21,966,802,1768,2098
0130-001,2014,12,13,22,858,742,1600,1768
0130-001,2014,12,13,23,634,432,1066,1600
0130-001,2014,12,13,24,433,345,778,1066
0130-001,2014,12,14,1,404,241,645,778
0130-001,2014,12,14,2,305,212,517,645
0130-001,2014,12,14,3,249,144,393,517
0130-001,2014,12,14,4,227,151,378,393
0130-001,2014,12,14,5,190,130,320,378
0130-001,2014,12,14,6,175,180,355,320
0130-001,2014,12,14,7,391,268,659,355
0130-001,2014,12,14,8,515,429,944,659
0130-001,2014,12,14,9,706,759,1465,944
0130-001,2014,12,14,10,863,882,1745,1465
0130-001,2014,12,14,11,1104,1121,2225,1745
0130-001,2014,12,14,12,1081,1366,2447,2225
0130-001,2014,12,14,13,1194,1590,2784,2447
0130-001,2014,12,14,14,1441,1519,2960,2784
0130-001,2014,12,14,15,1630,1599,3229,2960
0130-001,2014,12,14,16,1652,1571,3223,3229
0130-001,2014,12,14,17,1669,1485,3154,3223
0130-001,2014,12,14,18,1675,1296,2971,3154
0130-001,2014,12,14,19,1430,1091,2521,2971
0130-001,2014,12,14,20,1097,908,2005,2521
0130-001,2014,12,14,21,845,689,1534,2005
0130-001,2014,12,14,22,735,609,1344,1534
0130-001,2014,12,14,23,487,434,921,1344
0130-001,2014,12,14,24,308,301,609,921
0130-001,2014,12,15,1,236,199,435,609
0130-001,2014,12,15,2,150,145,295,435
0130-001,2014,12,15,3,107,116,223,295
0130-001,2014,12,15,4,103,108,211,223
0130-001,2014,12,15,5,121,174,295,211
0130-001,2014,12,15,6,397,371,768,295
0130-001,2014,12,15,7,1349,681,2030,768
0130-001,2014,12,15,8,1862,1705,3567,2030
0130-001,2014,12,15,9,2104,2024,4128,3567
0130-001,2014,12,15,10,1697,1675,3372,4128
0130-001,2014,12,15,11,1776,1810,3586,3372
0130-001,2014,12,15,12,1720,1552,3272,3586
0130-001,2014,12,15,13,1322,1388,2710,3272
0130-001,2014,12,15,14,1626,1472,3098,2710
0130-001,2014,12,15,15,1756,1633,3389,3098
0130-001,2014,12,15,16,1686,1620,3306,3389
0130-001,2014,12,15,17,1697,1649,3346,3306
0130-001,2014,12,15,18,1632,1914,3546,3346
0130-001,2014,12,15,19,1466,2038,3504,3546
0130-001,2014,12,15,20,1081,1186,2267,3504
0130-001,2014,12,15,21,1092,911,2003,2267
0130-001,2014,12,15,22,1029,676,1705,2003
0130-001,2014,12,15,23,800,447,1247,1705
0130-001,2014,12,15,24,461,348,809,1247
0130-001,2014,12,16,1,373,283,656,809
0130-001,2014,12,16,2,215,209,424,656
0130-001,2014,12,16,3,172,160,332,424
0130-001,2014,12,16,4,136,158,294,332
0130-001,2014,12,16,5,139,209,348,294
0130-001,2014,12,16,6,276,285,561,348
0130-001,2014,12,16,7,1252,622,1874,561
0130-001,2014,12,16,8,1916,1595,3511,1874
0130-001,2014,12,16,9,1928,1903,3831,3511
0130-001,2014,12,16,10,1553,1446,2999,3831
0130-001,2014,12,16,11,1646,1506,3152,2999
0130-001,2014,12,16,12,1508,1622,3130,3152
0130-001,2014,12,16,13,1315,1477,2792,3130
0130-001,2014,12,16,14,1554,1671,3225,2792
0130-001,2014,12,16,15,1655,1593,3248,3225
0130-001,2014,12,16,16,1659,1453,3112,3248
0130-001,2014,12,16,17,1682,1691,3373,3112
0130-001,2014,12,16,18,1549,1904,3453,3373
0130-001,2014,12,16,19,1416,1790,3206,3453
0130-001,2014,12,16,20,1151,1225,2376,3206
0130-001,2014,12,16,21,1066,1187,2253,2376
0130-001,2014,12,16,22,937,882,1819,2253
0130-001,2014,12,16,23,656,513,1169,1819
0130-001,2014,12,16,24,510,317,827,1169
0130-001,2014,12,17,1,307,243,550,827
0130-001,2014,12,17,2,206,145,351,550
0130-001,2014,12,17,3,163,104,267,351
0130-001,2014,12,17,4,141,101,242,267
0130-001,2014,12,17,5,143,119,262,242
0130-001,2014,12,17,6,271,221,492,262
0130-001,2014,12,17,7,1120,546,1666,492
0130-001,2014,12,17,8,1956,1377,3333,1666
0130-001,2014,12,17,9,2006,1661,3667,3333
0130-001,2014,12,17,10,1716,1415,3131,3667
0130-001,2014,12,17,11,1671,1728,3399,3131
0130-001,2014,12,17,12,1646,1701,3347,3399
0130-001,2014,12,17,13,1417,1583,3000,3347
0130-001,2014,12,17,14,1632,1819,3451,3000
0130-001,2014,12,17,15,1706,2017,3723,3451
0130-001,2014,12,17,16,1702,1918,3620,3723
0130-001,2014,12,17,17,1637,1862,3499,3620
0130-001,2014,12,17,18,1662,2346,4008,3499
0130-001,2014,12,17,19,1502,2419,3921,4008
0130-001,2014,12,17,20,1147,1727,2874,3921
0130-001,2014,12,17,21,1084,1342,2426,2874
0130-001,2014,12,17,22,1054,1202,2256,2426
0130-001,2014,12,17,23,760,743,1503,2256
0130-001,2014,12,17,24,467,508,975,1503
0130-001,2014,12,18,1,308,293,601,975
0130-001,2014,12,18,2,199,203,402,601
0130-001,2014,12,18,3,170,167,337,402
0130-001,2014,12,18,4,123,167,290,337
0130-001,2014,12,18,5,141,201,342,290
0130-001,2014,12,18,6,326,304,630,342
0130-001,2014,12,18,7,1187,646,1833,630
0130-001,2014,12,18,8,1967,1573,3540,1833
0130-001,2014,12,18,9,2071,1971,4042,3540
0130-001,2014,12,18,10,1716,1709,3425,4042
0130-001,2014,12,18,11,1724,1702,3426,3425
0130-001,2014,12,18,12,1551,1798,3349,3426
0130-001,2014,12,18,13,1295,1655,2950,3349
0130-001,2014,12,18,14,1673,1801,3474,2950
0130-001,2014,12,18,15,1877,1760,3637,3474
0130-001,2014,12,18,16,1626,1541,3167,3637
0130-001,2014,12,18,17,1428,1572,3000,3167
0130-001,2014,12,18,18,1747,2363,4110,3000
0130-001,2014,12,18,19,1500,2395,3895,4110
0130-001,2014,12,18,20,1223,1699,2922,3895
0130-001,2014,12,18,21,1124,1538,2662,2922
0130-001,2014,12,18,22,1086,1167,2253,2662
0130-001,2014,12,18,23,719,740,1459,2253
0130-001,2014,12,18,24,515,513,1028,1459
0130-001,2014,12,19,1,371,377,748,1028
0130-001,2014,12,19,2,231,253,484,748
0130-001,2014,12,19,3,188,183,371,484
0130-001,2014,12,19,4,148,188,336,371
0130-001,2014,12,19,5,155,212,367,336
0130-001,2014,12,19,6,280,348,628,367
0130-001,2014,12,19,7,1209,637,1846,628
0130-001,2014,12,19,8,1851,1687,3538,1846
0130-001,2014,12,19,9,2191,1960,4151,3538
0130-001,2014,12,19,10,1680,1678,3358,4151
0130-001,2014,12,19,11,1747,1785,3532,3358
0130-001,2014,12,19,12,1601,1675,3276,3532
0130-001,2014,12,19,13,1455,1861,3316,3276
0130-001,2014,12,19,14,1682,1844,3526,3316
0130-001,2014,12,19,15,1880,1966,3846,3526
0130-001,2014,12,19,16,1679,1644,3323,3846
0130-001,2014,12,19,17,1645,1495,3140,3323
0130-001,2014,12,19,18,1844,1879,3723,3140
0130-001,2014,12,19,19,1822,2052,3874,3723
0130-001,2014,12,19,20,1212,1700,2912,3874
0130-001,2014,12,19,21,974,1274,2248,2912
0130-001,2014,12,19,22,914,984,1898,2248
0130-001,2014,12,19,23,727,678,1405,1898
0130-001,2014,12,19,24,485,472,957,1405
0130-001,2014,12,20,1,256,383,639,957
0130-001,2014,12,20,2,420,230,650,639
0130-001,2014,12,20,3,359,211,570,650
0130-001,2014,12,20,4,249,168,417,570
0130-001,2014,12,20,5,215,155,370,417
0130-001,2014,12,20,6,272,239,511,370
0130-001,2014,12,20,7,708,366,1074,511
0130-001,2014,12,20,8,1086,690,1776,1074
0130-001,2014,12,20,9,1387,1154,2541,1776
0130-001,2014,12,20,10,1472,1266,2738,2541
0130-001,2014,12,20,11,1517,1444,2961,2738
0130-001,2014,12,20,12,1670,1608,3278,2961
0130-001,2014,12,20,13,1621,1772,3393,3278
0130-001,2014,12,20,14,1889,1638,3527,3393
0130-001,2014,12,20,15,1911,1623,3534,3527
0130-001,2014,12,20,16,1841,1612,3453,3534
0130-001,2014,12,20,17,1875,1650,3525,3453
0130-001,2014,12,20,18,1907,1762,3669,3525
0130-001,2014,12,20,19,1920,1588,3508,3669
0130-001,2014,12,20,20,1165,979,2144,3508
0130-001,2014,12,20,21,1005,877,1882,2144
0130-001,2014,12,20,22,926,757,1683,1882
0130-001,2014,12,20,23,748,535,1283,1683
0130-001,2014,12,20,24,515,379,894,1283
0130-001,2014,12,21,1,420,291,711,894
0130-001,2014,12,21,2,308,290,598,711
0130-001,2014,12,21,3,263,195,458,598
0130-001,2014,12,21,4,177,154,331,458
0130-001,2014,12,21,5,172,159,331,331
0130-001,2014,12,21,6,218,229,447,331
0130-001,2014,12,21,7,400,320,720,447
0130-001,2014,12,21,8,566,499,1065,720
0130-001,2014,12,21,9,688,691,1379,1065
0130-001,2014,12,21,10,861,1027,1888,1379
0130-001,2014,12,21,11,1003,968,1971,1888
0130-001,2014,12,21,12,1167,1386,2553,1971
0130-001,2014,12,21,13,1228,1556,2784,2553
0130-001,2014,12,21,14,1387,1354,2741,2784
0130-001,2014,12,21,15,1430,1406,2836,2741
0130-001,2014,12,21,16,1448,1421,2869,2836
0130-001,2014,12,21,17,1817,1631,3448,2869
0130-001,2014,12,21,18,1610,1520,3130,3448
0130-001,2014,12,21,19,1479,1078,2557,3130
0130-001,2014,12,21,20,901,684,1585,2557
0130-001,2014,12,21,21,863,593,1456,1585
0130-001,2014,12,21,22,759,566,1325,1456
0130-001,2014,12,21,23,550,388,938,1325
0130-001,2014,12,21,24,305,287,592,938
0130-001,2014,12,22,1,240,199,439,592
0130-001,2014,12,22,2,132,120,252,439
0130-001,2014,12,22,3,101,91,192,252
0130-001,2014,12,22,4,69,110,179,192
0130-001,2014,12,22,5,110,161,271,179
0130-001,2014,12,22,6,317,306,623,271
0130-001,2014,12,22,7,1129,659,1788,623
0130-001,2014,12,22,8,1720,1463,3183,1788
0130-001,2014,12,22,9,1945,1846,3791,3183
0130-001,2014,12,22,10,1756,1564,3320,3791
0130-001,2014,12,22,11,1302,1620,2922,3320
0130-001,2014,12,22,12,1133,1521,2654,2922
0130-001,2014,12,22,13,1003,1385,2388,2654
0130-001,2014,12,22,14,1374,1480,2854,2388
0130-001,2014,12,22,15,1472,1588,3060,2854
0130-001,2014,12,22,16,1520,1121,2641,3060
0130-001,2014,12,22,17,1499,1115,2614,2641
0130-001,2014,12,22,18,1461,1411,2872,2614
0130-001,2014,12,22,19,1309,1378,2687,2872
0130-001,2014,12,22,20,1041,897,1938,2687
0130-001,2014,12,22,21,852,920,1772,1938
0130-001,2014,12,22,22,795,814,1609,1772
0130-001,2014,12,22,23,645,510,1155,1609
0130-001,2014,12,22,24,409,283,692,1155
0130-001,2014,12,23,1,278,197,475,692
0130-001,2014,12,23,2,186,158,344,475
0130-001,2014,12,23,3,119,102,221,344
0130-001,2014,12,23,4,130,114,244,221
0130-001,2014,12,23,5,132,157,289,244
0130-001,2014,12,23,6,242,268,510,289
0130-001,2014,12,23,7,1088,488,1576,510
0130-001,2014,12,23,8,1758,1394,3152,1576
0130-001,2014,12,23,9,1907,1696,3603,3152
0130-001,2014,12,23,10,1817,1402,3219,3603
0130-001,2014,12,23,11,1731,1468,3199,3219
0130-001,2014,12,23,12,1783,1582,3365,3199
0130-001,2014,12,23,13,1502,1429,2931,3365
0130-001,2014,12,23,14,1742,1592,3334,2931
0130-001,2014,12,23,15,1796,1614,3410,3334
0130-001,2014,12,23,16,1799,1544,3343,3410
0130-001,2014,12,23,17,1851,1635,3486,3343
0130-001,2014,12,23,18,1796,1743,3539,3486
0130-001,2014,12,23,19,1549,1779,3328,3539
0130-001,2014,12,23,20,1176,1448,2624,3328
0130-001,2014,12,23,21,1106,1117,2223,2624
0130-001,2014,12,23,22,1104,969,2073,2223
0130-001,2014,12,23,23,883,672,1555,2073
0130-001,2014,12,23,24,598,414,1012,1555
0130-001,2014,12,24,1,431,271,702,1012
0130-001,2014,12,24,2,258,207,465,702
0130-001,2014,12,24,3,188,148,336,465
0130-001,2014,12,24,4,148,136,284,336
0130-001,2014,12,24,5,184,165,349,284
0130-001,2014,12,24,6,319,255,574,349
0130-001,2014,12,24,7,1268,455,1723,574
0130-001,2014,12,24,8,1832,1125,2957,1723
0130-001,2014,12,24,9,2026,1418,3444,2957
0130-001,2014,12,24,10,2040,1317,3357,3444
0130-001,2014,12,24,11,1850,1480,3330,3357
0130-001,2014,12,24,12,1925,1381,3306,3330
0130-001,2014,12,24,13,1472,1330,2802,3306
0130-001,2014,12,24,14,1670,1516,3186,2802
0130-001,2014,12,24,15,1855,1668,3523,3186
0130-001,2014,12,24,16,1832,1635,3467,3523
0130-001,2014,12,24,17,1797,1682,3479,3467
0130-001,2014,12,24,18,1922,2029,3951,3479
0130-001,2014,12,24,19,1779,2206,3985,3951
0130-001,2014,12,24,20,1380,1863,3243,3985
0130-001,2014,12,24,21,1198,1164,2362,3243
0130-001,2014,12,24,22,1081,905,1986,2362
0130-001,2014,12,24,23,899,633,1532,1986
0130-001,2014,12,24,24,632,447,1079,1532
0130-001,2014,12,25,1,465,402,867,1079
0130-001,2014,12,25,2,298,284,582,867
0130-001,2014,12,25,3,256,198,454,582
0130-001,2014,12,25,4,175,165,340,454
0130-001,2014,12,25,5,217,177,394,340
0130-001,2014,12,25,6,280,244,524,394
0130-001,2014,12,25,7,640,321,961,524
0130-001,2014,12,25,8,1023,656,1679,961
0130-001,2014,12,25,9,960,905,1865,1679
0130-001,2014,12,25,10,1117,1041,2158,1865
0130-001,2014,12,25,11,1279,1293,2572,2158
0130-001,2014,12,25,12,1218,1160,2378,2572
0130-001,2014,12,25,13,1273,1277,2550,2378
0130-001,2014,12,25,14,1560,1344,2904,2550
0130-001,2014,12,25,15,1509,1391,2900,2904
0130-001,2014,12,25,16,1574,1284,2858,2900
0130-001,2014,12,25,17,1576,1258,2834,2858
0130-001,2014,12,25,18,1272,1388,2660,2834
0130-001,2014,12,25,19,1317,982,2299,2660
0130-001,2014,12,25,20,1182,765,1947,2299
0130-001,2014,12,25,21,957,750,1707,1947
0130-001,2014,12,25,22,921,705,1626,1707
0130-001,2014,12,25,23,632,477,1109,1626
0130-001,2014,12,25,24,415,369,784,1109
0130-001,2014,12,26,1,308,274,582,784
0130-001,2014,12,26,2,190,185,375,582
0130-001,2014,12,26,3,154,140,294,375
0130-001,2014,12,26,4,114,139,253,294
0130-001,2014,12,26,5,146,205,351,253
0130-001,2014,12,26,6,379,369,748,351
0130-001,2014,12,26,7,1286,619,1905,748
0130-001,2014,12,26,8,2026,1443,3469,1905
0130-001,2014,12,26,9,1977,1779,3756,3469
0130-001,2014,12,26,10,1767,1720,3487,3756
0130-001,2014,12,26,11,1776,1925,3701,3487
0130-001,2014,12,26,12,1736,1872,3608,3701
0130-001,2014,12,26,13,1460,1439,2899,3608
0130-001,2014,12,26,14,1631,1512,3143,2899
0130-001,2014,12,26,15,1846,1602,3448,3143
0130-001,2014,12,26,16,1698,1550,3248,3448
0130-001,2014,12,26,17,1541,1662,3203,3248
0130-001,2014,12,26,18,1780,1925,3705,3203
0130-001,2014,12,26,19,1820,1948,3768,3705
0130-001,2014,12,26,20,1193,1614,2807,3768
0130-001,2014,12,26,21,1176,1330,2506,2807
0130-001,2014,12,26,22,1140,1177,2317,2506
0130-001,2014,12,26,23,854,793,1647,2317
0130-001,2014,12,26,24,670,741,1411,1647
0130-001,2014,12,27,1,510,493,1003,1411
0130-001,2014,12,27,2,362,348,710,1003
0130-001,2014,12,27,3,280,233,513,710
0130-001,2014,12,27,4,217,217,434,513
0130-001,2014,12,27,5,256,245,501,434
0130-001,2014,12,27,6,339,348,687,501
0130-001,2014,12,27,7,804,492,1296,687
0130-001,2014,12,27,8,1246,857,2103,1296
0130-001,2014,12,27,9,1538,1348,2886,2103
0130-001,2014,12,27,10,1491,1698,3189,2886
0130-001,2014,12,27,11,1752,1938,3690,3189
0130-001,2014,12,27,12,1760,1975,3735,3690
0130-001,2014,12,27,13,1556,1893,3449,3735
0130-001,2014,12,27,14,1786,1511,3297,3449
0130-001,2014,12,27,15,1794,1581,3375,3297
0130-001,2014,12,27,16,1860,1599,3459,3375
0130-001,2014,12,27,17,1895,1644,3539,3459
0130-001,2014,12,27,18,1897,1796,3693,3539
0130-001,2014,12,27,19,1824,1342,3166,3693
0130-001,2014,12,27,20,1160,1009,2169,3166
0130-001,2014,12,27,21,944,1037,1981,2169
0130-001,2014,12,27,22,919,826,1745,1981
0130-001,2014,12,27,23,721,622,1343,1745
0130-001,2014,12,27,24,514,466,980,1343
0130-001,2014,12,28,1,411,372,783,980
0130-001,2014,12,28,2,339,243,582,783
0130-001,2014,12,28,3,272,220,492,582
0130-001,2014,12,28,4,193,186,379,492
0130-001,2014,12,28,5,197,173,370,379
0130-001,2014,12,28,6,229,237,466,370
0130-001,2014,12,28,7,460,356,816,466
0130-001,2014,12,28,8,667,450,1117,816
0130-001,2014,12,28,9,723,814,1537,1117
0130-001,2014,12,28,10,834,944,1778,1537
0130-001,2014,12,28,11,1030,1159,2189,1778
0130-001,2014,12,28,12,1124,1299,2423,2189
0130-001,2014,12,28,13,1211,1096,2307,2423
0130-001,2014,12,28,14,1414,1061,2475,2307
0130-001,2014,12,28,15,1530,1130,2660,2475
0130-001,2014,12,28,16,1550,1176,2726,2660
0130-001,2014,12,28,17,1743,1137,2880,2726
0130-001,2014,12,28,18,1642,1160,2802,2880
0130-001,2014,12,28,19,1454,910,2364,2802
0130-001,2014,12,28,20,999,734,1733,2364
0130-001,2014,12,28,21,854,590,1444,1733
0130-001,2014,12,28,22,747,589,1336,1444
0130-001,2014,12,28,23,539,475,1014,1336
0130-001,2014,12,28,24,366,290,656,1014
0130-001,2014,12,29,1,256,199,455,656
0130-001,2014,12,29,2,168,131,299,455
0130-001,2014,12,29,3,125,92,217,299
0130-001,2014,12,29,4,112,110,222,217
0130-001,2014,12,29,5,146,168,314,222
0130-001,2014,12,29,6,391,331,722,314
0130-001,2014,12,29,7,1446,636,2082,722
0130-001,2014,12,29,8,1968,1598,3566,2082
0130-001,2014,12,29,9,2024,1669,3693,3566
0130-001,2014,12,29,10,1726,1453,3179,3693
0130-001,2014,12,29,11,1539,1431,2970,3179
0130-001,2014,12,29,12,1426,1490,2916,2970
0130-001,2014,12,29,13,1162,1382,2544,2916
0130-001,2014,12,29,14,1500,1487,2987,2544
0130-001,2014,12,29,15,1614,1542,3156,2987
0130-001,2014,12,29,16,1603,1550,3153,3156
0130-001,2014,12,29,17,1598,1587,3185,3153
0130-001,2014,12,29,18,1546,1739,3285,3185
0130-001,2014,12,29,19,1388,1919,3307,3285
0130-001,2014,12,29,20,1061,1260,2321,3307
0130-001,2014,12,29,21,972,1254,2226,2321
0130-001,2014,12,29,22,912,874,1786,2226
0130-001,2014,12,29,23,722,549,1271,1786
0130-001,2014,12,29,24,435,400,835,1271
0130-001,2014,12,30,1,211,277,488,835
0130-001,2014,12,30,2,272,222,494,488
0130-001,2014,12,30,3,191,157,348,494
0130-001,2014,12,30,4,159,181,340,348
0130-001,2014,12,30,5,157,182,339,340
0130-001,2014,12,30,6,148,236,384,339
0130-001,2014,12,30,7,200,459,659,384
0130-001,2014,12,30,8,1837,1194,3031,659
0130-001,2014,12,30,9,1918,1490,3408,3031
0130-001,2014,12,30,10,1685,1357,3042,3408
0130-001,2014,12,30,11,1688,1429,3117,3042
0130-001,2014,12,30,12,1646,1543,3189,3117
0130-001,2014,12,30,13,1408,1381,2789,3189
0130-001,2014,12,30,14,1648,1513,3161,2789
0130-001,2014,12,30,15,1726,1636,3362,3161
0130-001,2014,12,30,16,1729,1635,3364,3362
0130-001,2014,12,30,17,1766,1579,3345,3364
0130-001,2014,12,30,18,1672,1821,3493,3345
0130-001,2014,12,30,19,1482,1913,3395,3493
0130-001,2014,12,30,20,1164,1303,2467,3395
0130-001,2014,12,30,21,1086,1154,2240,2467
0130-001,2014,12,30,22,1020,1009,2029,2240
0130-001,2014,12,30,23,895,769,1664,2029
0130-001,2014,12,30,24,613,507,1120,1664
0130-001,2014,12,31,1,452,312,764,1120
0130-001,2014,12,31,2,355,234,589,764
0130-001,2014,12,31,3,238,179,417,589
0130-001,2014,12,31,4,193,172,365,417
0130-001,2014,12,31,5,164,160,324,365
0130-001,2014,12,31,6,285,242,527,324
0130-001,2014,12,31,7,1032,500,1532,527
0130-001,2014,12,31,8,1918,1251,3169,1532
0130-001,2014,12,31,9,2013,1540,3553,3169
0130-001,2014,12,31,10,1594,1366,2960,3553
0130-001,2014,12,31,11,1713,1604,3317,2960
0130-001,2014,12,31,12,1648,1541,3189,3317
0130-001,2014,12,31,13,1556,1456,3012,3189
0130-001,2014,12,31,14,1711,1668,3379,3012
0130-001,2014,12,31,15,1826,1842,3668,3379
0130-001,2014,12,31,16,2020,1776,3796,3668
0130-001,2014,12,31,17,1779,1772,3551,3796
0130-001,2014,12,31,18,1896,1836,3732,3551
0130-001,2014,12,31,19,1788,1713,3501,3732
0130-001,2014,12,31,20,1419,1276,2695,3501
0130-001,2014,12,31,21,1142,1040,2182,2695
0130-001,2014,12,31,22,969,909,1878,2182
0130-001,2014,12,31,23,760,728,1488,1878
0130-001,2014,12,31,24,580,527,1107,1488
0130-001,2015,1,1,1,496,410,906,1107
0130-001,2015,1,1,2,461,386,847,906
0130-001,2015,1,1,3,310,265,575,847
0130-001,2015,1,1,4,221,207,428,575
0130-001,2015,1,1,5,196,188,384,428
0130-001,2015,1,1,6,217,256,473,384
0130-001,2015,1,1,7,362,291,653,473
0130-001,2015,1,1,8,406,371,777,653
0130-001,2015,1,1,9,430,540,970,777
0130-001,2015,1,1,10,558,611,1169,970
0130-001,2015,1,1,11,791,845,1636,1169
0130-001,2015,1,1,12,974,1042,2016,1636
0130-001,2015,1,1,13,1091,1201,2292,2016
0130-001,2015,1,1,14,1137,1270,2407,2292
0130-001,2015,1,1,15,1232,1320,2552,2407
0130-001,2015,1,1,16,1336,1244,2580,2552
0130-001,2015,1,1,17,1383,1227,2610,2580
0130-001,2015,1,1,18,1366,1220,2586,2610
0130-001,2015,1,1,19,1121,1003,2124,2586
0130-001,2015,1,1,20,910,835,1745,2124
0130-001,2015,1,1,21,820,747,1567,1745
0130-001,2015,1,1,22,699,581,1280,1567
0130-001,2015,1,1,23,529,388,917,1280
0130-001,2015,1,1,24,331,254,585,917
0130-001,2015,1,2,1,353,313,666,585
0130-001,2015,1,2,2,222,188,410,666
0130-001,2015,1,2,3,164,161,325,410
0130-001,2015,1,2,4,141,161,302,325
0130-001,2015,1,2,5,152,192,344,302
0130-001,2015,1,2,6,297,320,617,344
0130-001,2015,1,2,7,999,600,1599,617
0130-001,2015,1,2,8,2026,1396,3422,1599
0130-001,2015,1,2,9,1902,1790,3692,3422
0130-001,2015,1,2,10,1605,1499,3104,3692
0130-001,2015,1,2,11,1618,1706,3324,3104
0130-001,2015,1,2,12,1561,1655,3216,3324
0130-001,2015,1,2,13,1404,1534,2938,3216
0130-001,2015,1,2,14,1679,1725,3404,2938
0130-001,2015,1,2,15,1845,1764,3609,3404
0130-001,2015,1,2,16,1843,1841,3684,3609
0130-001,2015,1,2,17,1710,1820,3530,3684
0130-001,2015,1,2,18,1778,2204,3982,3530
0130-001,2015,1,2,19,1816,2324,4140,3982
0130-001,2015,1,2,20,1401,1851,3252,4140
0130-001,2015,1,2,21,1191,1473,2664,3252
0130-001,2015,1,2,22,1038,1130,2168,2664
0130-001,2015,1,2,23,862,801,1663,2168
0130-001,2015,1,2,24,595,511,1106,1663
0130-001,2015,1,3,1,420,379,799,1106
0130-001,2015,1,3,2,300,266,566,799
0130-001,2015,1,3,3,227,209,436,566
0130-001,2015,1,3,4,183,185,368,436
0130-001,2015,1,3,5,195,243,438,368
0130-001,2015,1,3,6,293,332,625,438
0130-001,2015,1,3,7,654,500,1154,625
0130-001,2015,1,3,8,1215,825,2040,1154
0130-001,2015,1,3,9,1336,1316,2652,2040
0130-001,2015,1,3,10,1423,1512,2935,2652
0130-001,2015,1,3,11,1528,1589,3117,2935
0130-001,2015,1,3,12,1523,1667,3190,3117
0130-001,2015,1,3,13,1508,1680,3188,3190
0130-001,2015,1,3,14,1569,1847,3416,3188
0130-001,2015,1,3,15,1658,1856,3514,3416
0130-001,2015,1,3,16,1646,1847,3493,3514
0130-001,2015,1,3,17,1706,1757,3463,3493
0130-001,2015,1,3,18,1829,2057,3886,3463
0130-001,2015,1,3,19,1631,1706,3337,3886
0130-001,2015,1,3,20,1232,1115,2347,3337
0130-001,2015,1,3,21,992,942,1934,2347
0130-001,2015,1,3,22,906,803,1709,1934
0130-001,2015,1,3,23,697,564,1261,1709
0130-001,2015,1,3,24,457,407,864,1261
0130-001,2015,1,4,1,364,316,680,864
0130-001,2015,1,4,2,279,246,525,680
0130-001,2015,1,4,3,202,184,386,525
0130-001,2015,1,4,4,186,150,336,386
0130-001,2015,1,4,5,182,159,341,336
0130-001,2015,1,4,6,196,239,435,341
0130-001,2015,1,4,7,385,316,701,435
0130-001,2015,1,4,8,518,440,958,701
0130-001,2015,1,4,9,690,732,1422,958
0130-001,2015,1,4,10,780,892,1672,1422
0130-001,2015,1,4,11,966,1106,2072,1672
0130-001,2015,1,4,12,1001,1199,2200,2072
0130-001,2015,1,4,13,1132,1372,2504,2200
0130-001,2015,1,4,14,1341,1533,2874,2504
0130-001,2015,1,4,15,1454,1446,2900,2874
0130-001,2015,1,4,16,1549,1485,3034,2900
0130-001,2015,1,4,17,1620,1427,3047,3034
0130-001,2015,1,4,18,1641,1416,3057,3047
0130-001,2015,1,4,19,1477,1108,2585,3057
0130-001,2015,1,4,20,1111,920,2031,2585
0130-001,2015,1,4,21,937,773,1710,2031
0130-001,2015,1,4,22,856,649,1505,1710
0130-001,2015,1,4,23,575,430,1005,1505
0130-001,2015,1,4,24,384,310,694,1005
0130-001,2015,1,5,1,255,227,482,694
0130-001,2015,1,5,2,153,147,300,482
0130-001,2015,1,5,3,127,103,230,300
0130-001,2015,1,5,4,95,122,217,230
0130-001,2015,1,5,5,132,183,315,217
0130-001,2015,1,5,6,326,333,659,315
0130-001,2015,1,5,7,1189,680,1869,659
0130-001,2015,1,5,8,2094,1518,3612,1869
0130-001,2015,1,5,9,1974,1820,3794,3612
0130-001,2015,1,5,10,1678,1649,3327,3794
0130-001,2015,1,5,11,1711,1687,3398,3327
0130-001,2015,1,5,12,1537,1612,3149,3398
0130-001,2015,1,5,13,1535,1521,3056,3149
0130-001,2015,1,5,14,1733,1743,3476,3056
0130-001,2015,1,5,15,1807,1828,3635,3476
0130-001,2015,1,5,16,1831,1804,3635,3635
0130-001,2015,1,5,17,1702,1787,3489,3635
0130-001,2015,1,5,18,1673,2166,3839,3489
0130-001,2015,1,5,19,1714,2192,3906,3839
0130-001,2015,1,5,20,1249,1526,2775,3906
0130-001,2015,1,5,21,1093,1461,2554,2775
0130-001,2015,1,5,22,925,1155,2080,2554
0130-001,2015,1,5,23,698,663,1361,2080
0130-001,2015,1,5,24,487,416,903,1361
0130-001,2015,1,6,1,299,284,583,903
0130-001,2015,1,6,2,196,180,376,583
0130-001,2015,1,6,3,151,153,304,376
0130-001,2015,1,6,4,133,154,287,304
0130-001,2015,1,6,5,147,201,348,287
0130-001,2015,1,6,6,260,322,582,348
0130-001,2015,1,6,7,1076,628,1704,582
0130-001,2015,1,6,8,2021,1469,3490,1704
0130-001,2015,1,6,9,1964,1893,3857,3490
0130-001,2015,1,6,10,1575,1614,3189,3857
0130-001,2015,1,6,11,1670,1578,3248,3189
0130-001,2015,1,6,12,1637,1547,3184,3248
0130-001,2015,1,6,13,1460,1511,2971,3184
0130-001,2015,1,6,14,1694,1705,3399,2971
0130-001,2015,1,6,15,1788,1785,3573,3399
0130-001,2015,1,6,16,1774,1790,3564,3573
0130-001,2015,1,6,17,1592,1807,3399,3564
0130-001,2015,1,6,18,1740,2095,3835,3399
0130-001,2015,1,6,19,1657,2200,3857,3835
0130-001,2015,1,6,20,1266,1558,2824,3857
0130-001,2015,1,6,21,1095,1501,2596,2824
0130-001,2015,1,6,22,1015,1185,2200,2596
0130-001,2015,1,6,23,733,665,1398,2200
0130-001,2015,1,6,24,491,421,912,1398
0130-001,2015,1,7,1,325,286,611,912
0130-001,2015,1,7,2,218,211,429,611
0130-001,2015,1,7,3,178,164,342,429
0130-001,2015,1,7,4,130,159,289,342
0130-001,2015,1,7,5,149,199,348,289
0130-001,2015,1,7,6,289,327,616,348
0130-001,2015,1,7,7,998,597,1595,616
0130-001,2015,1,7,8,2026,1460,3486,1595
0130-001,2015,1,7,9,1917,1895,3812,3486
0130-001,2015,1,7,10,1683,1561,3244,3812
0130-001,2015,1,7,11,1701,1593,3294,3244
0130-001,2015,1,7,12,1648,1507,3155,3294
0130-001,2015,1,7,13,1397,1425,2822,3155
0130-001,2015,1,7,14,1690,1696,3386,2822
0130-001,2015,1,7,15,1775,1712,3487,3386
0130-001,2015,1,7,16,1728,1763,3491,3487
0130-001,2015,1,7,17,1601,1743,3344,3491
0130-001,2015,1,7,18,1710,2165,3875,3344
0130-001,2015,1,7,19,1660,2281,3941,3875
0130-001,2015,1,7,20,1281,1583,2864,3941
0130-001,2015,1,7,21,1129,1393,2522,2864
0130-001,2015,1,7,22,1032,1031,2063,2522
0130-001,2015,1,7,23,750,691,1441,2063
0130-001,2015,1,7,24,504,458,962,1441
0130-001,2015,1,8,1,340,316,656,962
0130-001,2015,1,8,2,223,201,424,656
0130-001,2015,1,8,3,163,158,321,424
0130-001,2015,1,8,4,140,139,279,321
0130-001,2015,1,8,5,147,196,343,279
0130-001,2015,1,8,6,273,317,590,343
0130-001,2015,1,8,7,985,568,1553,590
0130-001,2015,1,8,8,2019,1428,3447,1553
0130-001,2015,1,8,9,1993,1837,3830,3447
0130-001,2015,1,8,10,1692,1531,3223,3830
0130-001,2015,1,8,11,1704,1612,3316,3223
0130-001,2015,1,8,12,1563,1578,3141,3316
0130-001,2015,1,8,13,1398,1409,2807,3141
0130-001,2015,1,8,14,1636,1649,3285,2807
0130-001,2015,1,8,15,1702,1761,3463,3285
0130-001,2015,1,8,16,1569,1616,3185,3463
0130-001,2015,1,8,17,1641,1682,3323,3185
0130-001,2015,1,8,18,1663,2105,3768,3323
0130-001,2015,1,8,19,1656,2196,3852,3768
0130-001,2015,1,8,20,1298,1560,2858,3852
0130-001,2015,1,8,21,1133,1472,2605,2858
0130-001,2015,1,8,22,1070,1159,2229,2605
0130-001,2015,1,8,23,777,678,1455,2229
0130-001,2015,1,8,24,521,473,994,1455
0130-001,2015,1,9,1,350,318,668,994
0130-001,2015,1,9,2,226,204,430,668
0130-001,2015,1,9,3,163,155,318,430
0130-001,2015,1,9,4,137,166,303,318
0130-001,2015,1,9,5,139,204,343,303
0130-001,2015,1,9,6,278,319,597,343
0130-001,2015,1,9,7,1003,590,1593,597
0130-001,2015,1,9,8,2031,1404,3435,1593
0130-001,2015,1,9,9,1971,1830,3801,3435
0130-001,2015,1,9,10,1667,1599,3266,3801
0130-001,2015,1,9,11,1716,1691,3407,3266
0130-001,2015,1,9,12,1603,1608,3211,3407
0130-001,2015,1,9,13,1424,1571,2995,3211
0130-001,2015,1,9,14,1723,1752,3475,2995
0130-001,2015,1,9,15,1804,1816,3620,3475
0130-001,2015,1,9,16,1837,1846,3683,3620
0130-001,2015,1,9,17,1697,1850,3547,3683
0130-001,2015,1,9,18,1861,2225,4086,3547
0130-001,2015,1,9,19,1865,2429,4294,4086
0130-001,2015,1,9,20,1397,1826,3223,4294
0130-001,2015,1,9,21,1208,1502,2710,3223
0130-001,2015,1,9,22,1069,1206,2275,2710
0130-001,2015,1,9,23,876,750,1626,2275
0130-001,2015,1,9,24,621,541,1162,1626
0130-001,2015,1,10,1,478,398,876,1162
0130-001,2015,1,10,2,319,293,612,876
0130-001,2015,1,10,3,249,232,481,612
0130-001,2015,1,10,4,213,208,421,481
0130-001,2015,1,10,5,182,260,442,421
0130-001,2015,1,10,6,302,344,646,442
0130-001,2015,1,10,7,675,489,1164,646
0130-001,2015,1,10,8,1209,862,2071,1164
0130-001,2015,1,10,9,1389,1374,2763,2071
0130-001,2015,1,10,10,1466,1526,2992,2763
0130-001,2015,1,10,11,1564,1668,3232,2992
0130-001,2015,1,10,12,1603,1827,3430,3232
0130-001,2015,1,10,13,1567,1957,3524,3430
0130-001,2015,1,10,14,1641,1911,3552,3524
0130-001,2015,1,10,15,1676,1906,3582,3552
0130-001,2015,1,10,16,1777,1881,3658,3582
0130-001,2015,1,10,17,1844,1840,3684,3658
0130-001,2015,1,10,18,1940,2111,4051,3684
0130-001,2015,1,10,19,1708,1814,3522,4051
0130-001,2015,1,10,20,1251,1222,2473,3522
0130-001,2015,1,10,21,1038,975,2013,2473
0130-001,2015,1,10,22,1017,830,1847,2013
0130-001,2015,1,10,23,709,589,1298,1847
0130-001,2015,1,10,24,527,429,956,1298
0130-001,2015,1,11,1,385,331,716,956
0130-001,2015,1,11,2,285,233,518,716
0130-001,2015,1,11,3,239,201,440,518
0130-001,2015,1,11,4,194,151,345,440
0130-001,2015,1,11,5,150,152,302,345
0130-001,2015,1,11,6,195,248,443,302
0130-001,2015,1,11,7,358,294,652,443
0130-001,2015,1,11,8,523,469,992,652
0130-001,2015,1,11,9,690,761,1451,992
0130-001,2015,1,11,10,819,930,1749,1451
0130-001,2015,1,11,11,964,1275,2239,1749
0130-001,2015,1,11,12,1057,1273,2330,2239
0130-001,2015,1,11,13,1277,1356,2633,2330
0130-001,2015,1,11,14,1367,1459,2826,2633
0130-001,2015,1,11,15,1462,1459,2921,2826
0130-001,2015,1,11,16,1574,1476,3050,2921
0130-001,2015,1,11,17,1673,1393,3066,3050
0130-001,2015,1,11,18,1634,1400,3034,3066
0130-001,2015,1,11,19,1551,1197,2748,3034
0130-001,2015,1,11,20,1161,907,2068,2748
0130-001,2015,1,11,21,963,776,1739,2068
0130-001,2015,1,11,22,826,677,1503,1739
0130-001,2015,1,11,23,559,452,1011,1503
0130-001,2015,1,11,24,392,303,695,1011
0130-001,2015,1,12,1,266,215,481,695
0130-001,2015,1,12,2,159,148,307,481
0130-001,2015,1,12,3,113,112,225,307
0130-001,2015,1,12,4,114,118,232,225
0130-001,2015,1,12,5,143,186,329,232
0130-001,2015,1,12,6,316,343,659,329
0130-001,2015,1,12,7,1163,659,1822,659
0130-001,2015,1,12,8,2046,1494,3540,1822
0130-001,2015,1,12,9,2003,1869,3872,3540
0130-001,2015,1,12,10,1710,1669,3379,3872
0130-001,2015,1,12,11,1667,1645,3312,3379
0130-001,2015,1,12,12,1623,1624,3247,3312
0130-001,2015,1,12,13,1419,1475,2894,3247
0130-001,2015,1,12,14,1697,1711,3408,2894
0130-001,2015,1,12,15,1829,1808,3637,3408
0130-001,2015,1,12,16,1791,1787,3578,3637
0130-001,2015,1,12,17,1584,1747,3331,3578
0130-001,2015,1,12,18,1710,2129,3839,3331
0130-001,2015,1,12,19,1699,2288,3987,3839
0130-001,2015,1,12,20,1280,1614,2894,3987
0130-001,2015,1,12,21,1133,1501,2634,2894
0130-001,2015,1,12,22,964,1145,2109,2634
0130-001,2015,1,12,23,755,683,1438,2109
0130-001,2015,1,12,24,455,429,884,1438
0130-001,2015,1,13,1,330,298,628,884
0130-001,2015,1,13,2,204,187,391,628
0130-001,2015,1,13,3,155,154,309,391
0130-001,2015,1,13,4,139,159,298,309
0130-001,2015,1,13,5,158,202,360,298
0130-001,2015,1,13,6,267,304,571,360
0130-001,2015,1,13,7,1024,627,1651,571
0130-001,2015,1,13,8,2048,1422,3470,1651
0130-001,2015,1,13,9,1880,1887,3767,3470
0130-001,2015,1,13,10,1761,1640,3401,3767
0130-001,2015,1,13,11,1654,1646,3300,3401
0130-001,2015,1,13,12,1558,1532,3090,3300
0130-001,2015,1,13,13,1437,1475,2912,3090
0130-001,2015,1,13,14,1690,1686,3376,2912
0130-001,2015,1,13,15,1780,1780,3560,3376
0130-001,2015,1,13,16,1730,1786,3516,3560
0130-001,2015,1,13,17,1624,1758,3382,3516
0130-001,2015,1,13,18,1660,2133,3793,3382
0130-001,2015,1,13,19,1655,2248,3903,3793
0130-001,2015,1,13,20,1309,1593,2902,3903
0130-001,2015,1,13,21,1129,1517,2646,2902
0130-001,2015,1,13,22,1066,1120,2186,2646
0130-001,2015,1,13,23,750,688,1438,2186
0130-001,2015,1,13,24,491,482,973,1438
0130-001,2015,1,14,1,345,301,646,973
0130-001,2015,1,14,2,244,220,464,646
0130-001,2015,1,14,3,175,152,327,464
0130-001,2015,1,14,4,145,148,293,327
0130-001,2015,1,14,5,154,214,368,293
0130-001,2015,1,14,6,296,310,606,368
0130-001,2015,1,14,7,995,594,1589,606
0130-001,2015,1,14,8,2104,1425,3529,1589
0130-001,2015,1,14,9,2071,1924,3995,3529
0130-001,2015,1,14,10,1704,1670,3374,3995
0130-001,2015,1,14,11,1727,1656,3383,3374
0130-001,2015,1,14,12,1627,1564,3191,3383
0130-001,2015,1,14,13,1384,1405,2789,3191
0130-001,2015,1,14,14,1663,1690,3353,2789
0130-001,2015,1,14,15,1706,1793,3499,3353
0130-001,2015,1,14,16,1755,1736,3491,3499
0130-001,2015,1,14,17,1625,1741,3366,3491
0130-001,2015,1,14,18,1680,2176,3856,3366
0130-001,2015,1,14,19,1639,2399,4038,3856
0130-001,2015,1,14,20,1336,1614,2950,4038
0130-001,2015,1,14,21,1129,1455,2584,2950
0130-001,2015,1,14,22,1070,1095,2165,2584
0130-001,2015,1,14,23,779,669,1448,2165
0130-001,2015,1,14,24,511,489,1000,1448
0130-001,2015,1,15,1,357,291,648,1000
0130-001,2015,1,15,2,228,212,440,648
0130-001,2015,1,15,3,157,152,309,440
0130-001,2015,1,15,4,150,152,302,309
0130-001,2015,1,15,5,159,209,368,302
0130-001,2015,1,15,6,273,308,581,368
0130-001,2015,1,15,7,982,586,1568,581
0130-001,2015,1,15,8,2100,1401,3501,1568
0130-001,2015,1,15,9,1922,1886,3808,3501
0130-001,2015,1,15,10,1673,1612,3285,3808
0130-001,2015,1,15,11,1683,1576,3259,3285
0130-001,2015,1,15,12,1628,1577,3205,3259
0130-001,2015,1,15,13,1409,1492,2901,3205
0130-001,2015,1,15,14,1641,1695,3336,2901
0130-001,2015,1,15,15,1734,1736,3470,3336
0130-001,2015,1,15,16,1721,1745,3466,3470
0130-001,2015,1,15,17,1653,1774,3427,3466
0130-001,2015,1,15,18,1654,2102,3756,3427
0130-001,2015,1,15,19,1653,2213,3866,3756
0130-001,2015,1,15,20,1203,1610,2813,3866
0130-001,2015,1,15,21,1127,1480,2607,2813
0130-001,2015,1,15,22,1032,1123,2155,2607
0130-001,2015,1,15,23,799,728,1527,2155
0130-001,2015,1,15,24,552,481,1033,1527
0130-001,2015,1,16,1,382,340,722,1033
0130-001,2015,1,16,2,235,191,426,722
0130-001,2015,1,16,3,165,177,342,426
0130-001,2015,1,16,4,155,151,306,342
0130-001,2015,1,16,5,154,224,378,306
0130-001,2015,1,16,6,286,322,608,378
0130-001,2015,1,16,7,981,598,1579,608
0130-001,2015,1,16,8,2064,1386,3450,1579
0130-001,2015,1,16,9,1948,1883,3831,3450
0130-001,2015,1,16,10,1687,1644,3331,3831
0130-001,2015,1,16,11,1706,1690,3396,3331
0130-001,2015,1,16,12,1606,1626,3232,3396
0130-001,2015,1,16,13,1475,1522,2997,3232
0130-001,2015,1,16,14,1674,1728,3402,2997
0130-001,2015,1,16,15,1786,1749,3535,3402
0130-001,2015,1,16,16,1748,1809,3557,3535
0130-001,2015,1,16,17,1714,1836,3550,3557
0130-001,2015,1,16,18,1883,2294,4177,3550
0130-001,2015,1,16,19,1899,2501,4400,4177
0130-001,2015,1,16,20,1461,1846,3307,4400
0130-001,2015,1,16,21,1202,1513,2715,3307
0130-001,2015,1,16,22,1104,1200,2304,2715
0130-001,2015,1,16,23,910,781,1691,2304
0130-001,2015,1,16,24,611,507,1118,1691
0130-001,2015,1,17,1,475,413,888,1118
0130-001,2015,1,17,2,335,305,640,888
0130-001,2015,1,17,3,253,211,464,640
0130-001,2015,1,17,4,209,213,422,464
0130-001,2015,1,17,5,185,240,425,422
0130-001,2015,1,17,6,309,311,620,425
0130-001,2015,1,17,7,656,512,1168,620
0130-001,2015,1,17,8,1256,904,2160,1168
0130-001,2015,1,17,9,1473,1494,2967,2160
0130-001,2015,1,17,10,1515,1570,3085,2967
0130-001,2015,1,17,11,1545,1688,3233,3085
0130-001,2015,1,17,12,1660,1802,3462,3233
0130-001,2015,1,17,13,1580,1938,3518,3462
0130-001,2015,1,17,14,1579,1959,3538,3518
0130-001,2015,1,17,15,1697,1859,3556,3538
0130-001,2015,1,17,16,1723,1860,3583,3556
0130-001,2015,1,17,17,1782,1785,3567,3583
0130-001,2015,1,17,18,1897,2077,3974,3567
0130-001,2015,1,17,19,1787,1850,3637,3974
0130-001,2015,1,17,20,1313,1147,2460,3637
0130-001,2015,1,17,21,996,979,1975,2460
0130-001,2015,1,17,22,971,830,1801,1975
0130-001,2015,1,17,23,712,624,1336,1801
0130-001,2015,1,17,24,514,429,943,1336
0130-001,2015,1,18,1,389,340,729,943
0130-001,2015,1,18,2,279,245,524,729
0130-001,2015,1,18,3,220,189,409,524
0130-001,2015,1,18,4,172,151,323,409
0130-001,2015,1,18,5,165,156,321,323
0130-001,2015,1,18,6,206,232,438,321
0130-001,2015,1,18,7,394,346,740,438
0130-001,2015,1,18,8,572,496,1068,740
0130-001,2015,1,18,9,698,799,1497,1068
0130-001,2015,1,18,10,831,986,1817,1497
0130-001,2015,1,18,11,1031,1222,2253,1817
0130-001,2015,1,18,12,1016,1277,2293,2253
0130-001,2015,1,18,13,1249,1421,2670,2293
0130-001,2015,1,18,14,1398,1444,2842,2670
0130-001,2015,1,18,15,1478,1488,2966,2842
0130-001,2015,1,18,16,1573,1527,3100,2966
0130-001,2015,1,18,17,1600,1457,3057,3100
0130-001,2015,1,18,18,1707,1486,3193,3057
0130-001,2015,1,18,19,1551,1233,2784,3193
0130-001,2015,1,18,20,1162,974,2136,2784
0130-001,2015,1,18,21,954,794,1748,2136
0130-001,2015,1,18,22,897,706,1603,1748
0130-001,2015,1,18,23,642,476,1118,1603
0130-001,2015,1,18,24,446,369,815,1118
0130-001,2015,1,19,1,247,234,481,815
0130-001,2015,1,19,2,156,147,303,481
0130-001,2015,1,19,3,120,116,236,303
0130-001,2015,1,19,4,104,118,222,236
0130-001,2015,1,19,5,125,183,308,222
0130-001,2015,1,19,6,268,317,585,308
0130-001,2015,1,19,7,1067,610,1677,585
0130-001,2015,1,19,8,1896,1335,3231,1677
0130-001,2015,1,19,9,1864,1704,3568,3231
0130-001,2015,1,19,10,1529,1545,3074,3568
0130-001,2015,1,19,11,1528,1471,2999,3074
0130-001,2015,1,19,12,1565,1480,3045,2999
0130-001,2015,1,19,13,1360,1417,2777,3045
0130-001,2015,1,19,14,1587,1605,3192,2777
0130-001,2015,1,19,15,1715,1688,3403,3192
0130-001,2015,1,19,16,1697,1654,3351,3403
0130-001,2015,1,19,17,1504,1620,3124,3351
0130-001,2015,1,19,18,1493,1972,3465,3124
0130-001,2015,1,19,19,1635,2123,3758,3465
0130-001,2015,1,19,20,1138,1455,2593,3758
0130-001,2015,1,19,21,963,1341,2304,2593
0130-001,2015,1,19,22,847,991,1838,2304
0130-001,2015,1,19,23,650,600,1250,1838
0130-001,2015,1,19,24,432,369,801,1250
0130-001,2015,1,20,1,278,265,543,801
0130-001,2015,1,20,2,190,173,363,543
0130-001,2015,1,20,3,147,133,280,363
0130-001,2015,1,20,4,122,137,259,280
0130-001,2015,1,20,5,140,175,315,259
0130-001,2015,1,20,6,242,304,546,315
0130-001,2015,1,20,7,900,537,1437,546
0130-001,2015,1,20,8,1810,1269,3079,1437
0130-001,2015,1,20,9,1802,1709,3511,3079
0130-001,2015,1,20,10,1629,1589,3218,3511
0130-001,2015,1,20,11,1593,1513,3106,3218
0130-001,2015,1,20,12,1569,1502,3071,3106
0130-001,2015,1,20,13,1371,1421,2792,3071
0130-001,2015,1,20,14,1602,1698,3300,2792
0130-001,2015,1,20,15,1731,1708,3439,3300
0130-001,2015,1,20,16,1648,1622,3270,3439
0130-001,2015,1,20,17,1543,1699,3242,3270
0130-001,2015,1,20,18,1593,1968,3561,3242
0130-001,2015,1,20,19,1581,2180,3761,3561
0130-001,2015,1,20,20,1209,1546,2755,3761
0130-001,2015,1,20,21,1107,1444,2551,2755
0130-001,2015,1,20,22,986,1084,2070,2551
0130-001,2015,1,20,23,740,704,1444,2070
0130-001,2015,1,20,24,487,424,911,1444
0130-001,2015,1,21,1,349,293,642,911
0130-001,2015,1,21,2,221,208,429,642
0130-001,2015,1,21,3,169,165,334,429
0130-001,2015,1,21,4,162,152,314,334
0130-001,2015,1,21,5,154,206,360,314
0130-001,2015,1,21,6,273,312,585,360
0130-001,2015,1,21,7,970,626,1596,585
0130-001,2015,1,21,8,2041,1357,3398,1596
0130-001,2015,1,21,9,1974,1779,3753,3398
0130-001,2015,1,21,10,1671,1660,3331,3753
0130-001,2015,1,21,11,1732,1561,3293,3331
0130-001,2015,1,21,12,1634,1612,3246,3293
0130-001,2015,1,21,13,1423,1462,2885,3246
0130-001,2015,1,21,14,1689,1645,3334,2885
0130-001,2015,1,21,15,1789,1766,3555,3334
0130-001,2015,1,21,16,1728,1756,3484,3555
0130-001,2015,1,21,17,1612,1769,3381,3484
0130-001,2015,1,21,18,1701,2184,3885,3381
0130-001,2015,1,21,19,1687,2350,4037,3885
0130-001,2015,1,21,20,1272,1625,2897,4037
0130-001,2015,1,21,21,1127,1426,2553,2897
0130-001,2015,1,21,22,1076,1077,2153,2553
0130-001,2015,1,21,23,786,703,1489,2153
0130-001,2015,1,21,24,575,494,1069,1489
0130-001,2015,1,22,1,348,313,661,1069
0130-001,2015,1,22,2,226,213,439,661
0130-001,2015,1,22,3,165,161,326,439
0130-001,2015,1,22,4,144,152,296,326
0130-001,2015,1,22,5,168,211,379,296
0130-001,2015,1,22,6,279,323,602,379
0130-001,2015,1,22,7,988,626,1614,602
0130-001,2015,1,22,8,2074,1387,3461,1614
0130-001,2015,1,22,9,1950,1808,3758,3461
0130-001,2015,1,22,10,1708,1632,3340,3758
0130-001,2015,1,22,11,1740,1580,3320,3340
0130-001,2015,1,22,12,1616,1646,3262,3320
0130-001,2015,1,22,13,1405,1456,2861,3262
0130-001,2015,1,22,14,1637,1695,3332,2861
0130-001,2015,1,22,15,1735,1737,3472,3332
0130-001,2015,1,22,16,1803,1735,3538,3472
0130-001,2015,1,22,17,1599,1766,3365,3538
0130-001,2015,1,22,18,1706,2129,3835,3365
0130-001,2015,1,22,19,1690,2260,3950,3835
0130-001,2015,1,22,20,1288,1613,2901,3950
0130-001,2015,1,22,21,1156,1582,2738,2901
0130-001,2015,1,22,22,1068,1214,2282,2738
0130-001,2015,1,22,23,815,683,1498,2282
0130-001,2015,1,22,24,546,497,1043,1498
0130-001,2015,1,23,1,382,339,721,1043
0130-001,2015,1,23,2,243,212,455,721
0130-001,2015,1,23,3,155,175,330,455
0130-001,2015,1,23,4,144,151,295,330
0130-001,2015,1,23,5,163,205,368,295
0130-001,2015,1,23,6,278,328,606,368
0130-001,2015,1,23,7,959,596,1555,606
0130-001,2015,1,23,8,2117,1402,3519,1555
0130-001,2015,1,23,9,1973,1806,3779,3519
0130-001,2015,1,23,10,1675,1695,3370,3779
0130-001,2015,1,23,11,1732,1685,3417,3370
0130-001,2015,1,23,12,1628,1672,3300,3417
0130-001,2015,1,23,13,1474,1567,3041,3300
0130-001,2015,1,23,14,1738,1753,3491,3041
0130-001,2015,1,23,15,1804,1860,3664,3491
0130-001,2015,1,23,16,1788,1792,3580,3664
0130-001,2015,1,23,17,1743,1866,3609,3580
0130-001,2015,1,23,18,1851,2281,4132,3609
0130-001,2015,1,23,19,1927,2489,4416,4132
0130-001,2015,1,23,20,1473,1977,3450,4416
0130-001,2015,1,23,21,1244,1549,2793,3450
0130-001,2015,1,23,22,1139,1186,2325,2793
0130-001,2015,1,23,23,916,787,1703,2325
0130-001,2015,1,23,24,629,526,1155,1703
0130-001,2015,1,24,1,454,402,856,1155
0130-001,2015,1,24,2,349,297,646,856
0130-001,2015,1,24,3,253,225,478,646
0130-001,2015,1,24,4,220,194,414,478
0130-001,2015,1,24,5,216,256,472,414
0130-001,2015,1,24,6,318,360,678,472
0130-001,2015,1,24,7,634,492,1126,678
0130-001,2015,1,24,8,1215,837,2052,1126
0130-001,2015,1,24,9,1401,1445,2846,2052
0130-001,2015,1,24,10,1484,1582,3066,2846
0130-001,2015,1,24,11,1579,1718,3297,3066
0130-001,2015,1,24,12,1639,1797,3436,3297
0130-001,2015,1,24,13,1580,1896,3476,3436
0130-001,2015,1,24,14,1701,1884,3585,3476
0130-001,2015,1,24,15,1763,1933,3696,3585
0130-001,2015,1,24,16,1727,1798,3525,3696
0130-001,2015,1,24,17,1714,1715,3429,3525
0130-001,2015,1,24,18,1779,2050,3829,3429
0130-001,2015,1,24,19,1661,1817,3478,3829
0130-001,2015,1,24,20,1309,1148,2457,3478
0130-001,2015,1,24,21,1070,985,2055,2457
0130-001,2015,1,24,22,985,826,1811,2055
0130-001,2015,1,24,23,764,595,1359,1811
0130-001,2015,1,24,24,515,444,959,1359
0130-001,2015,1,25,1,400,327,727,959
0130-001,2015,1,25,2,279,236,515,727
0130-001,2015,1,25,3,233,194,427,515
0130-001,2015,1,25,4,168,169,337,427
0130-001,2015,1,25,5,165,156,321,337
0130-001,2015,1,25,6,202,231,433,321
0130-001,2015,1,25,7,394,327,721,433
0130-001,2015,1,25,8,565,505,1070,721
0130-001,2015,1,25,9,794,864,1658,1070
0130-001,2015,1,25,10,834,957,1791,1658
0130-001,2015,1,25,11,1104,1271,2375,1791
0130-001,2015,1,25,12,1022,1204,2226,2375
0130-001,2015,1,25,13,1256,1452,2708,2226
0130-001,2015,1,25,14,1321,1411,2732,2708
0130-001,2015,1,25,15,1475,1440,2915,2732
0130-001,2015,1,25,16,1539,1470,3009,2915
0130-001,2015,1,25,17,1539,1376,2915,3009
0130-001,2015,1,25,18,1580,1519,3099,2915
0130-001,2015,1,25,19,1419,1139,2558,3099
0130-001,2015,1,25,20,1036,893,1929,2558
0130-001,2015,1,25,21,923,745,1668,1929
0130-001,2015,1,25,22,831,689,1520,1668
0130-001,2015,1,25,23,578,464,1042,1520
0130-001,2015,1,25,24,394,314,708,1042
0130-001,2015,1,26,1,275,254,529,708
0130-001,2015,1,26,2,162,146,308,529
0130-001,2015,1,26,3,102,100,202,308
0130-001,2015,1,26,4,99,121,220,202
0130-001,2015,1,26,5,138,184,322,220
0130-001,2015,1,26,6,306,319,625,322
0130-001,2015,1,26,7,1104,657,1761,625
0130-001,2015,1,26,8,2120,1445,3565,1761
0130-001,2015,1,26,9,1958,1861,3819,3565
0130-001,2015,1,26,10,1683,1643,3326,3819
0130-001,2015,1,26,11,1751,1667,3418,3326
0130-001,2015,1,26,12,1664,1663,3327,3418
0130-001,2015,1,26,13,1545,1569,3114,3327
0130-001,2015,1,26,14,1782,1781,3563,3114
0130-001,2015,1,26,15,1820,1856,3676,3563
0130-001,2015,1,26,16,1826,1842,3668,3676
0130-001,2015,1,26,17,1673,1818,3491,3668
0130-001,2015,1,26,18,1714,2177,3891,3491
0130-001,2015,1,26,19,1773,2292,4065,3891
0130-001,2015,1,26,20,1297,1668,2965,4065
0130-001,2015,1,26,21,1152,1585,2737,2965
0130-001,2015,1,26,22,1015,1179,2194,2737
0130-001,2015,1,26,23,772,704,1476,2194
0130-001,2015,1,26,24,500,481,981,1476
0130-001,2015,1,27,1,342,302,644,981
0130-001,2015,1,27,2,224,196,420,644
0130-001,2015,1,27,3,155,168,323,420
0130-001,2015,1,27,4,130,174,304,323
0130-001,2015,1,27,5,172,215,387,304
0130-001,2015,1,27,6,304,321,625,387
0130-001,2015,1,27,7,989,609,1598,625
0130-001,2015,1,27,8,2124,1384,3508,1598
0130-001,2015,1,27,9,2013,1888,3901,3508
0130-001,2015,1,27,10,1758,1682,3440,3901
0130-001,2015,1,27,11,1804,1780,3584,3440
0130-001,2015,1,27,12,1736,1654,3390,3584
0130-001,2015,1,27,13,1452,1600,3052,3390
0130-001,2015,1,27,14,1780,1823,3603,3052
0130-001,2015,1,27,15,1815,1856,3671,3603
0130-001,2015,1,27,16,1818,1837,3655,3671
0130-001,2015,1,27,17,1668,1900,3568,3655
0130-001,2015,1,27,18,1805,2218,4023,3568
0130-001,2015,1,27,19,1752,2322,4074,4023
0130-001,2015,1,27,20,1389,1815,3204,4074
0130-001,2015,1,27,21,1239,1624,2863,3204
0130-001,2015,1,27,22,1121,1221,2342,2863
0130-001,2015,1,27,23,848,744,1592,2342
0130-001,2015,1,27,24,566,500,1066,1592
0130-001,2015,1,28,1,347,297,644,1066
0130-001,2015,1,28,2,233,214,447,644
0130-001,2015,1,28,3,172,159,331,447
0130-001,2015,1,28,4,154,150,304,331
0130-001,2015,1,28,5,154,210,364,304
0130-001,2015,1,28,6,285,311,596,364
0130-001,2015,1,28,7,983,610,1593,596
0130-001,2015,1,28,8,2073,1391,3464,1593
0130-001,2015,1,28,9,2023,1852,3875,3464
0130-001,2015,1,28,10,1688,1665,3353,3875
0130-001,2015,1,28,11,1730,1609,3339,3353
0130-001,2015,1,28,12,1631,1588,3219,3339
0130-001,2015,1,28,13,1404,1434,2838,3219
0130-001,2015,1,28,14,1676,1668,3344,2838
0130-001,2015,1,28,15,1748,1780,3528,3344
0130-001,2015,1,28,16,1742,1746,3488,3528
0130-001,2015,1,28,17,1619,1755,3374,3488
0130-001,2015,1,28,18,1691,2180,3871,3374
0130-001,2015,1,28,19,1663,2375,4038,3871
0130-001,2015,1,28,20,1304,1620,2924,4038
0130-001,2015,1,28,21,1128,1441,2569,2924
0130-001,2015,1,28,22,1073,1086,2159,2569
0130-001,2015,1,28,23,783,686,1469,2159
0130-001,2015,1,28,24,543,492,1035,1469
0130-001,2015,1,29,1,353,302,655,1035
0130-001,2015,1,29,2,227,213,440,655
0130-001,2015,1,29,3,161,157,318,440
0130-001,2015,1,29,4,147,152,299,318
0130-001,2015,1,29,5,164,210,374,299
0130-001,2015,1,29,6,276,316,592,374
0130-001,2015,1,29,7,985,606,1591,592
0130-001,2015,1,29,8,2087,1394,3481,1591
0130-001,2015,1,29,9,1936,1847,3783,3481
0130-001,2015,1,29,10,1691,1622,3313,3783
0130-001,2015,1,29,11,1712,1578,3290,3313
0130-001,2015,1,29,12,1622,1612,3234,3290
0130-001,2015,1,29,13,1407,1474,2881,3234
0130-001,2015,1,29,14,1639,1695,3334,2881
0130-001,2015,1,29,15,1735,1737,3472,3334
0130-001,2015,1,29,16,1762,1740,3502,3472
0130-001,2015,1,29,17,1626,1770,3396,3502
0130-001,2015,1,29,18,1680,2116,3796,3396
0130-001,2015,1,29,19,1672,2237,3909,3796
0130-001,2015,1,29,20,1246,1612,2858,3909
0130-001,2015,1,29,21,1142,1531,2673,2858
0130-001,2015,1,29,22,1050,1169,2219,2673
0130-001,2015,1,29,23,807,706,1513,2219
0130-001,2015,1,29,24,549,489,1038,1513
0130-001,2015,1,30,1,382,340,722,1038
0130-001,2015,1,30,2,239,202,441,722
0130-001,2015,1,30,3,160,176,336,441
0130-001,2015,1,30,4,150,151,301,336
0130-001,2015,1,30,5,159,215,374,301
0130-001,2015,1,30,6,282,325,607,374
0130-001,2015,1,30,7,970,597,1567,607
0130-001,2015,1,30,8,2091,1394,3485,1567
0130-001,2015,1,30,9,1961,1845,3806,3485
0130-001,2015,1,30,10,1681,1670,3351,3806
0130-001,2015,1,30,11,1719,1688,3407,3351
0130-001,2015,1,30,12,1617,1649,3266,3407
0130-001,2015,1,30,13,1475,1545,3020,3266
0130-001,2015,1,30,14,1706,1741,3447,3020
0130-001,2015,1,30,15,1795,1805,3600,3447
0130-001,2015,1,30,16,1768,1801,3569,3600
0130-001,2015,1,30,17,1729,1851,3580,3569
0130-001,2015,1,30,18,1867,2288,4155,3580
0130-001,2015,1,30,19,1913,2495,4408,4155
0130-001,2015,1,30,20,1467,1912,3379,4408
0130-001,2015,1,30,21,1223,1531,2754,3379
0130-001,2015,1,30,22,1122,1193,2315,2754
0130-001,2015,1,30,23,913,784,1697,2315
0130-001,2015,1,30,24,620,517,1137,1697
0130-001,2015,1,31,1,465,408,873,1137
0130-001,2015,1,31,2,337,301,638,873
0130-001,2015,1,31,3,231,218,449,638
0130-001,2015,1,31,4,177,204,381,449
0130-001,2015,1,31,5,164,248,412,381
0130-001,2015,1,31,6,201,336,537,412
0130-001,2015,1,31,7,453,502,955,537
0130-001,2015,1,31,8,761,871,1632,955
0130-001,2015,1,31,9,973,1470,2443,1632
0130-001,2015,1,31,10,1102,1576,2678,2443
0130-001,2015,1,31,11,1408,1703,3111,2678
0130-001,2015,1,31,12,1690,1800,3490,3111
0130-001,2015,1,31,13,1731,1917,3648,3490
0130-001,2015,1,31,14,1828,1922,3750,3648
0130-001,2015,1,31,15,1884,1896,3780,3750
0130-001,2015,1,31,16,1898,1829,3727,3780
0130-001,2015,1,31,17,1917,1750,3667,3727
0130-001,2015,1,31,18,2016,2064,4080,3667
0130-001,2015,1,31,19,1953,1834,3787,4080
0130-001,2015,1,31,20,1684,1148,2832,3787
0130-001,2015,1,31,21,1372,982,2354,2832
0130-001,2015,1,31,22,1386,828,2214,2354
0130-001,2015,1,31,23,1020,610,1630,2214
0130-001,2015,1,31,24,754,437,1191,1630
0130-001,2015,2,1,1,369,281,650,1191
0130-001,2015,2,1,2,306,199,505,650
0130-001,2015,2,1,3,229,164,393,505
0130-001,2015,2,1,4,197,149,346,393
0130-001,2015,2,1,5,169,118,287,346
0130-001,2015,2,1,6,236,197,433,287
0130-001,2015,2,1,7,399,237,636,433
0130-001,2015,2,1,8,587,436,1023,636
0130-001,2015,2,1,9,696,854,1550,1023
0130-001,2015,2,1,10,864,1025,1889,1550
0130-001,2015,2,1,11,1148,1258,2406,1889
0130-001,2015,2,1,12,1066,1285,2351,2406
0130-001,2015,2,1,13,1218,1450,2668,2351
0130-001,2015,2,1,14,1381,1410,2791,2668
0130-001,2015,2,1,15,1398,1677,3075,2791
0130-001,2015,2,1,16,1554,1617,3171,3075
0130-001,2015,2,1,17,1668,1513,3181,3171
0130-001,2015,2,1,18,1752,1584,3336,3181
0130-001,2015,2,1,19,1500,1207,2707,3336
0130-001,2015,2,1,20,1209,990,2199,2707
0130-001,2015,2,1,21,973,787,1760,2199
0130-001,2015,2,1,22,928,620,1548,1760
0130-001,2015,2,1,23,644,398,1042,1548
0130-001,2015,2,1,24,369,272,641,1042
0130-001,2015,2,2,1,258,182,440,641
0130-001,2015,2,2,2,156,99,255,440
0130-001,2015,2,2,3,88,82,170,255
0130-001,2015,2,2,4,92,76,168,170
0130-001,2015,2,2,5,156,143,299,168
0130-001,2015,2,2,6,379,285,664,299
0130-001,2015,2,2,7,1447,572,2019,664
0130-001,2015,2,2,8,1993,1417,3410,2019
0130-001,2015,2,2,9,1992,1858,3850,3410
0130-001,2015,2,2,10,1670,1605,3275,3850
0130-001,2015,2,2,11,1697,1626,3323,3275
0130-001,2015,2,2,12,1515,1632,3147,3323
0130-001,2015,2,2,13,1482,1454,2936,3147
0130-001,2015,2,2,14,1561,1720,3281,2936
0130-001,2015,2,2,15,1745,1875,3620,3281
0130-001,2015,2,2,16,1724,1900,3624,3620
0130-001,2015,2,2,17,1599,1831,3430,3624
0130-001,2015,2,2,18,1729,2166,3895,3430
0130-001,2015,2,2,19,1557,2225,3782,3895
0130-001,2015,2,2,20,1227,1548,2775,3782
0130-001,2015,2,2,21,1080,1607,2687,2775
0130-001,2015,2,2,22,991,1151,2142,2687
0130-001,2015,2,2,23,701,611,1312,2142
0130-001,2015,2,2,24,415,392,807,1312
0130-001,2015,2,3,1,299,256,555,807
0130-001,2015,2,3,2,208,176,384,555
0130-001,2015,2,3,3,131,109,240,384
0130-001,2015,2,3,4,152,97,249,240
0130-001,2015,2,3,5,152,172,324,249
0130-001,2015,2,3,6,304,272,576,324
0130-001,2015,2,3,7,1304,507,1811,576
0130-001,2015,2,3,8,2113,1423,3536,1811
0130-001,2015,2,3,9,2115,1900,4015,3536
0130-001,2015,2,3,10,1683,1739,3422,4015
0130-001,2015,2,3,11,1790,1628,3418,3422
0130-001,2015,2,3,12,1633,1643,3276,3418
0130-001,2015,2,3,13,1325,1456,2781,3276
0130-001,2015,2,3,14,1645,1609,3254,2781
0130-001,2015,2,3,15,1736,1806,3542,3254
0130-001,2015,2,3,16,1722,1856,3578,3542
0130-001,2015,2,3,17,1665,1879,3544,3578
0130-001,2015,2,3,18,1645,2242,3887,3544
0130-001,2015,2,3,19,1559,2197,3756,3887
0130-001,2015,2,3,20,1168,1582,2750,3756
0130-001,2015,2,3,21,1044,1565,2609,2750
0130-001,2015,2,3,22,1027,1101,2128,2609
0130-001,2015,2,3,23,776,668,1444,2128
0130-001,2015,2,3,24,462,419,881,1444
0130-001,2015,2,4,1,358,316,674,881
0130-001,2015,2,4,2,192,151,343,674
0130-001,2015,2,4,3,160,134,294,343
0130-001,2015,2,4,4,120,99,219,294
0130-001,2015,2,4,5,152,170,322,219
0130-001,2015,2,4,6,399,289,688,322
0130-001,2015,2,4,7,1305,551,1856,688
0130-001,2015,2,4,8,2079,1484,3563,1856
0130-001,2015,2,4,9,2086,1912,3998,3563
0130-001,2015,2,4,10,1831,1686,3517,3998
0130-001,2015,2,4,11,1802,1693,3495,3517
0130-001,2015,2,4,12,1633,1852,3485,3495
0130-001,2015,2,4,13,1348,1622,2970,3485
0130-001,2015,2,4,14,1704,1695,3399,2970
0130-001,2015,2,4,15,1901,1768,3669,3399
0130-001,2015,2,4,16,1749,1856,3605,3669
0130-001,2015,2,4,17,1593,1845,3438,3605
0130-001,2015,2,4,18,1481,2277,3758,3438
0130-001,2015,2,4,19,1440,1776,3216,3758
0130-001,2015,2,4,20,1218,1802,3020,3216
0130-001,2015,2,4,21,1086,1323,2409,3020
0130-001,2015,2,4,22,1027,1059,2086,2409
0130-001,2015,2,4,23,771,618,1389,2086
0130-001,2015,2,4,24,496,406,902,1389
0130-001,2015,2,5,1,383,268,651,902
0130-001,2015,2,5,2,194,176,370,651
0130-001,2015,2,5,3,169,130,299,370
0130-001,2015,2,5,4,102,111,213,299
0130-001,2015,2,5,5,163,143,306,213
0130-001,2015,2,5,6,331,266,597,306
0130-001,2015,2,5,7,1291,538,1829,597
0130-001,2015,2,5,8,2092,1433,3525,1829
0130-001,2015,2,5,9,2074,1877,3951,3525
0130-001,2015,2,5,10,1763,1691,3454,3951
0130-001,2015,2,5,11,1810,1730,3540,3454
0130-001,2015,2,5,12,1631,1676,3307,3540
0130-001,2015,2,5,13,1400,1473,2873,3307
0130-001,2015,2,5,14,1686,1622,3308,2873
0130-001,2015,2,5,15,1767,1852,3619,3308
0130-001,2015,2,5,16,1833,1854,3687,3619
0130-001,2015,2,5,17,1583,1868,3451,3687
0130-001,2015,2,5,18,1672,2343,4015,3451
0130-001,2015,2,5,19,1574,2281,3855,4015
0130-001,2015,2,5,20,1254,1617,2871,3855
0130-001,2015,2,5,21,1098,1519,2617,2871
0130-001,2015,2,5,22,1080,1111,2191,2617
0130-001,2015,2,5,23,791,718,1509,2191
0130-001,2015,2,5,24,458,442,900,1509
0130-001,2015,2,6,1,349,295,644,900
0130-001,2015,2,6,2,235,185,420,644
0130-001,2015,2,6,3,158,141,299,420
0130-001,2015,2,6,4,149,153,302,299
0130-001,2015,2,6,5,163,178,341,302
0130-001,2015,2,6,6,415,264,679,341
0130-001,2015,2,6,7,1318,599,1917,679
0130-001,2015,2,6,8,1956,1458,3414,1917
0130-001,2015,2,6,9,2053,1900,3953,3414
0130-001,2015,2,6,10,2006,1772,3778,3953
0130-001,2015,2,6,11,1810,1799,3609,3778
0130-001,2015,2,6,12,1727,1891,3618,3609
0130-001,2015,2,6,13,1427,1617,3044,3618
0130-001,2015,2,6,14,1763,1848,3611,3044
0130-001,2015,2,6,15,1888,2063,3951,3611
0130-001,2015,2,6,16,1904,1921,3825,3951
0130-001,2015,2,6,17,1844,1969,3813,3825
0130-001,2015,2,6,18,1822,2378,4200,3813
0130-001,2015,2,6,19,1901,2389,4290,4200
0130-001,2015,2,6,20,1404,2019,3423,4290
0130-001,2015,2,6,21,1157,1624,2781,3423
0130-001,2015,2,6,22,1071,1168,2239,2781
0130-001,2015,2,6,23,918,735,1653,2239
0130-001,2015,2,6,24,608,503,1111,1653
0130-001,2015,2,7,1,437,429,866,1111
0130-001,2015,2,7,2,338,256,594,866
0130-001,2015,2,7,3,226,187,413,594
0130-001,2015,2,7,4,181,172,353,413
0130-001,2015,2,7,5,219,191,410,353
0130-001,2015,2,7,6,349,308,657,410
0130-001,2015,2,7,7,816,440,1256,657
0130-001,2015,2,7,8,1506,954,2460,1256
0130-001,2015,2,7,9,1645,1435,3080,2460
0130-001,2015,2,7,10,1815,1795,3610,3080
0130-001,2015,2,7,11,1765,1942,3707,3610
0130-001,2015,2,7,12,1654,2021,3675,3707
0130-001,2015,2,7,13,1563,1998,3561,3675
0130-001,2015,2,7,14,1718,1950,3668,3561
0130-001,2015,2,7,15,1790,1862,3652,3668
0130-001,2015,2,7,16,1815,1979,3794,3652
0130-001,2015,2,7,17,1852,1772,3624,3794
0130-001,2015,2,7,18,1895,2202,4097,3624
0130-001,2015,2,7,19,1683,1812,3495,4097
0130-001,2015,2,7,20,1246,1128,2374,3495
0130-001,2015,2,7,21,1084,1011,2095,2374
0130-001,2015,2,7,22,941,749,1690,2095
0130-001,2015,2,7,23,619,477,1096,1690
0130-001,2015,2,7,24,469,402,871,1096
0130-001,2015,2,8,1,351,289,640,871
0130-001,2015,2,8,2,217,218,435,640
0130-001,2015,2,8,3,194,153,347,435
0130-001,2015,2,8,4,136,113,249,347
0130-001,2015,2,8,5,149,153,302,249
0130-001,2015,2,8,6,220,214,434,302
0130-001,2015,2,8,7,438,302,740,434
0130-001,2015,2,8,8,587,452,1039,740
0130-001,2015,2,8,9,776,791,1567,1039
0130-001,2015,2,8,10,887,973,1860,1567
0130-001,2015,2,8,11,1069,1205,2274,1860
0130-001,2015,2,8,12,937,1187,2124,2274
0130-001,2015,2,8,13,1009,1253,2262,2124
0130-001,2015,2,8,14,1352,1366,2718,2262
0130-001,2015,2,8,15,1404,1399,2803,2718
0130-001,2015,2,8,16,1268,1341,2609,2803
0130-001,2015,2,8,17,1469,1291,2760,2609
0130-001,2015,2,8,18,1352,1243,2595,2760
0130-001,2015,2,8,19,1366,1019,2385,2595
0130-001,2015,2,8,20,1066,829,1895,2385
0130-001,2015,2,8,21,887,689,1576,1895
0130-001,2015,2,8,22,807,561,1368,1576
0130-001,2015,2,8,23,494,392,886,1368
0130-001,2015,2,8,24,319,245,564,886
0130-001,2015,2,9,1,210,149,359,564
0130-001,2015,2,9,2,149,113,262,359
0130-001,2015,2,9,3,79,63,142,262
0130-001,2015,2,9,4,81,70,151,142
0130-001,2015,2,9,5,129,120,249,151
0130-001,2015,2,9,6,383,275,658,249
0130-001,2015,2,9,7,1481,582,2063,658
0130-001,2015,2,9,8,2040,1479,3519,2063
0130-001,2015,2,9,9,2189,1912,4101,3519
0130-001,2015,2,9,10,1724,1733,3457,4101
0130-001,2015,2,9,11,1702,1670,3372,3457
0130-001,2015,2,9,12,1507,1638,3145,3372
0130-001,2015,2,9,13,1370,1440,2810,3145
0130-001,2015,2,9,14,1729,1691,3420,2810
0130-001,2015,2,9,15,1861,1879,3740,3420
0130-001,2015,2,9,16,1829,1791,3620,3740
0130-001,2015,2,9,17,1709,1739,3448,3620
0130-001,2015,2,9,18,1609,2146,3755,3448
0130-001,2015,2,9,19,1643,2132,3775,3755
0130-001,2015,2,9,20,1227,1574,2801,3775
0130-001,2015,2,9,21,1037,1486,2523,2801
0130-001,2015,2,9,22,926,1092,2018,2523
0130-001,2015,2,9,23,707,611,1318,2018
0130-001,2015,2,9,24,399,417,816,1318
0130-001,2015,2,10,1,269,237,506,816
0130-001,2015,2,10,2,194,130,324,506
0130-001,2015,2,10,3,147,124,271,324
0130-001,2015,2,10,4,113,116,229,271
0130-001,2015,2,10,5,174,149,323,229
0130-001,2015,2,10,6,329,258,587,323
0130-001,2015,2,10,7,1309,538,1847,587
0130-001,2015,2,10,8,2090,1454,3544,1847
0130-001,2015,2,10,9,2156,1929,4085,3544
0130-001,2015,2,10,10,1840,1764,3604,4085
0130-001,2015,2,10,11,1876,1737,3613,3604
0130-001,2015,2,10,12,1658,1868,3526,3613
0130-001,2015,2,10,13,1468,1584,3052,3526
0130-001,2015,2,10,14,1690,1912,3602,3052
0130-001,2015,2,10,15,1876,1896,3772,3602
0130-001,2015,2,10,16,1833,1896,3729,3772
0130-001,2015,2,10,17,1599,1981,3580,3729
0130-001,2015,2,10,18,1583,2251,3834,3580
0130-001,2015,2,10,19,1583,2262,3845,3834
0130-001,2015,2,10,20,1288,1678,2966,3845
0130-001,2015,2,10,21,1064,1540,2604,2966
0130-001,2015,2,10,22,989,1161,2150,2604
0130-001,2015,2,10,23,771,682,1453,2150
0130-001,2015,2,10,24,499,444,943,1453
0130-001,2015,2,11,1,337,335,672,943
0130-001,2015,2,11,2,228,170,398,672
0130-001,2015,2,11,3,149,145,294,398
0130-001,2015,2,11,4,131,155,286,294
0130-001,2015,2,11,5,170,116,286,286
0130-001,2015,2,11,6,378,293,671,286
0130-001,2015,2,11,7,1266,532,1798,671
0130-001,2015,2,11,8,2102,1329,3431,1798
0130-001,2015,2,11,9,2044,1908,3952,3431
0130-001,2015,2,11,10,1779,1783,3562,3952
0130-001,2015,2,11,11,1801,1802,3603,3562
0130-001,2015,2,11,12,1532,1714,3246,3603
0130-001,2015,2,11,13,1606,1599,3205,3246
0130-001,2015,2,11,14,1802,1835,3637,3205
0130-001,2015,2,11,15,1928,1925,3853,3637
0130-001,2015,2,11,16,1806,1921,3727,3853
0130-001,2015,2,11,17,1681,1891,3572,3727
0130-001,2015,2,11,18,1625,2316,3941,3572
0130-001,2015,2,11,19,1565,2371,3936,3941
0130-001,2015,2,11,20,1291,1705,2996,3936
0130-001,2015,2,11,21,1048,1433,2481,2996
0130-001,2015,2,11,22,1075,1080,2155,2481
0130-001,2015,2,11,23,857,676,1533,2155
0130-001,2015,2,11,24,628,444,1072,1533
0130-001,2015,2,12,1,408,316,724,1072
0130-001,2015,2,12,2,238,187,425,724
0130-001,2015,2,12,3,154,141,295,425
0130-001,2015,2,12,4,136,118,254,295
0130-001,2015,2,12,5,144,189,333,254
0130-001,2015,2,12,6,333,254,587,333
0130-001,2015,2,12,7,1286,534,1820,587
0130-001,2015,2,12,8,2106,1429,3535,1820
0130-001,2015,2,12,9,2083,1952,4035,3535
0130-001,2015,2,12,10,1792,1733,3525,4035
0130-001,2015,2,12,11,1817,1887,3704,3525
0130-001,2015,2,12,12,1659,1810,3469,3704
0130-001,2015,2,12,13,1475,1691,3166,3469
0130-001,2015,2,12,14,1777,1741,3518,3166
0130-001,2015,2,12,15,1960,1799,3759,3518
0130-001,2015,2,12,16,1972,1906,3878,3759
0130-001,2015,2,12,17,1801,2030,3831,3878
0130-001,2015,2,12,18,1690,2326,4016,3831
0130-001,2015,2,12,19,1645,2329,3974,4016
0130-001,2015,2,12,20,1361,1764,3125,3974
0130-001,2015,2,12,21,1125,1525,2650,3125
0130-001,2015,2,12,22,1071,1199,2270,2650
0130-001,2015,2,12,23,867,789,1656,2270
0130-001,2015,2,12,24,540,465,1005,1656
0130-001,2015,2,13,1,347,323,670,1005
0130-001,2015,2,13,2,210,205,415,670
0130-001,2015,2,13,3,152,130,282,415
0130-001,2015,2,13,4,145,132,277,282
0130-001,2015,2,13,5,170,189,359,277
0130-001,2015,2,13,6,394,327,721,359
0130-001,2015,2,13,7,1393,555,1948,721
0130-001,2015,2,13,8,2084,1471,3555,1948
0130-001,2015,2,13,9,2056,1958,4014,3555
0130-001,2015,2,13,10,2047,1868,3915,4014
0130-001,2015,2,13,11,1881,2009,3890,3915
0130-001,2015,2,13,12,1919,2038,3957,3890
0130-001,2015,2,13,13,1532,2009,3541,3957
0130-001,2015,2,13,14,1865,2184,4049,3541
0130-001,2015,2,13,15,1936,1956,3892,4049
0130-001,2015,2,13,16,1988,2040,4028,3892
0130-001,2015,2,13,17,1992,1965,3957,4028
0130-001,2015,2,13,18,1938,2306,4244,3957
0130-001,2015,2,13,19,1953,2449,4402,4244
0130-001,2015,2,13,20,1448,2027,3475,4402
0130-001,2015,2,13,21,1368,1567,2935,3475
0130-001,2015,2,13,22,1238,1214,2452,2935
0130-001,2015,2,13,23,926,783,1709,2452
0130-001,2015,2,13,24,628,584,1212,1709
0130-001,2015,2,14,1,451,375,826,1212
0130-001,2015,2,14,2,322,260,582,826
0130-001,2015,2,14,3,240,210,450,582
0130-001,2015,2,14,4,185,210,395,450
0130-001,2015,2,14,5,201,210,411,395
0130-001,2015,2,14,6,408,358,766,411
0130-001,2015,2,14,7,919,448,1367,766
0130-001,2015,2,14,8,1583,1023,2606,1367
0130-001,2015,2,14,9,1717,1551,3268,2606
0130-001,2015,2,14,10,1734,1760,3494,3268
0130-001,2015,2,14,11,1683,2013,3696,3494
0130-001,2015,2,14,12,1688,2025,3713,3696
0130-001,2015,2,14,13,1636,2021,3657,3713
0130-001,2015,2,14,14,1845,1973,3818,3657
0130-001,2015,2,14,15,1736,1906,3642,3818
0130-001,2015,2,14,16,1824,1902,3726,3642
0130-001,2015,2,14,17,1717,1927,3644,3726
0130-001,2015,2,14,18,1847,2158,4005,3644
0130-001,2015,2,14,19,1783,1848,3631,4005
0130-001,2015,2,14,20,1313,1337,2650,3631
0130-001,2015,2,14,21,1069,1040,2109,2650
0130-001,2015,2,14,22,1034,892,1926,2109
0130-001,2015,2,14,23,785,595,1380,1926
0130-001,2015,2,14,24,581,459,1040,1380
0130-001,2015,2,15,1,397,277,674,1040
0130-001,2015,2,15,2,288,218,506,674
0130-001,2015,2,15,3,220,176,396,506
0130-001,2015,2,15,4,185,147,332,396
0130-001,2015,2,15,5,163,128,291,332
0130-001,2015,2,15,6,279,254,533,291
0130-001,2015,2,15,7,496,344,840,533
0130-001,2015,2,15,8,808,580,1388,840
0130-001,2015,2,15,9,928,952,1880,1388
0130-001,2015,2,15,10,966,1251,2217,1880
0130-001,2015,2,15,11,1150,1442,2592,2217
0130-001,2015,2,15,12,1078,1346,2424,2592
0130-001,2015,2,15,13,1234,1594,2828,2424
0130-001,2015,2,15,14,1479,1530,3009,2828
0130-001,2015,2,15,15,1549,1666,3215,3009
0130-001,2015,2,15,16,1602,1655,3257,3215
0130-001,2015,2,15,17,1688,1571,3259,3257
0130-001,2015,2,15,18,1584,1758,3342,3259
0130-001,2015,2,15,19,1466,1276,2742,3342
0130-001,2015,2,15,20,1109,904,2013,2742
0130-001,2015,2,15,21,900,795,1695,2013
0130-001,2015,2,15,22,894,666,1560,1695
0130-001,2015,2,15,23,630,427,1057,1560
0130-001,2015,2,15,24,360,122,482,1057
0130-001,2015,2,16,1,211,90,301,482
0130-001,2015,2,16,2,156,57,213,301
0130-001,2015,2,16,3,122,61,183,213
0130-001,2015,2,16,4,86,36,122,183
0130-001,2015,2,16,5,142,59,201,122
0130-001,2015,2,16,6,381,139,520,201
0130-001,2015,2,16,7,1464,367,1831,520
0130-001,2015,2,16,8,2016,837,2853,1831
0130-001,2015,2,16,9,2090,1415,3505,2853
0130-001,2015,2,16,10,1697,1530,3227,3505
0130-001,2015,2,16,11,1700,1281,2981,3227
0130-001,2015,2,16,12,1511,1218,2729,2981
0130-001,2015,2,16,13,1426,1316,2742,2729
0130-001,2015,2,16,14,1645,1381,3026,2742
0130-001,2015,2,16,15,1803,1838,3641,3026
0130-001,2015,2,16,16,1776,1831,3607,3641
0130-001,2015,2,16,17,1654,1670,3324,3607
0130-001,2015,2,16,18,1669,1643,3312,3324
0130-001,2015,2,16,19,1600,1718,3318,3312
0130-001,2015,2,16,20,1227,1607,2834,3318
0130-001,2015,2,16,21,1058,1666,2724,2834
0130-001,2015,2,16,22,958,1243,2201,2724
0130-001,2015,2,16,23,704,523,1227,2201
0130-001,2015,2,16,24,310,427,737,1227
0130-001,2015,2,17,1,238,287,525,737
0130-001,2015,2,17,2,177,241,418,525
0130-001,2015,2,17,3,133,149,282,418
0130-001,2015,2,17,4,118,157,275,282
0130-001,2015,2,17,5,135,170,305,275
0130-001,2015,2,17,6,282,258,540,305
0130-001,2015,2,17,7,908,486,1394,540
0130-001,2015,2,17,8,2132,1239,3371,1394
0130-001,2015,2,17,9,1968,1835,3803,3371
0130-001,2015,2,17,10,1636,1770,3406,3803
0130-001,2015,2,17,11,1754,1877,3631,3406
0130-001,2015,2,17,12,1790,1797,3587,3631
0130-001,2015,2,17,13,1706,2036,3742,3587
0130-001,2015,2,17,14,1728,2400,4128,3742
0130-001,2015,2,17,15,1843,2590,4433,4128
0130-001,2015,2,17,16,1784,2605,4389,4433
0130-001,2015,2,17,17,1826,2697,4523,4389
0130-001,2015,2,17,18,1765,2889,4654,4523
0130-001,2015,2,17,19,1610,2791,4401,4654
0130-001,2015,2,17,20,1301,2640,3941,4401
0130-001,2015,2,17,21,1152,2546,3698,3941
0130-001,2015,2,17,22,986,2552,3538,3698
0130-001,2015,2,17,23,830,2119,2949,3538
0130-001,2015,2,17,24,548,1446,1994,2949
0130-001,2015,2,18,1,417,716,1133,1994
0130-001,2015,2,18,2,274,585,859,1133
0130-001,2015,2,18,3,221,518,739,859
0130-001,2015,2,18,4,196,471,667,739
0130-001,2015,2,18,5,173,747,920,667
0130-001,2015,2,18,6,224,1278,1502,920
0130-001,2015,2,18,7,371,1344,1715,1502
0130-001,2015,2,18,8,502,1457,1959,1715
0130-001,2015,2,18,9,724,1745,2469,1959
0130-001,2015,2,18,10,1062,1922,2984,2469
0130-001,2015,2,18,11,1414,2000,3414,2984
0130-001,2015,2,18,12,1618,1903,3521,3414
0130-001,2015,2,18,13,1436,1674,3110,3521
0130-001,2015,2,18,14,1354,1494,2848,3110
0130-001,2015,2,18,15,1328,1435,2763,2848
0130-001,2015,2,18,16,1257,1242,2499,2763
0130-001,2015,2,18,17,1205,1147,2352,2499
0130-001,2015,2,18,18,1130,1037,2167,2352
0130-001,2015,2,18,19,934,878,1812,2167
0130-001,2015,2,18,20,784,824,1608,1812
0130-001,2015,2,18,21,640,717,1357,1608
0130-001,2015,2,18,22,592,575,1167,1357
0130-001,2015,2,18,23,472,405,877,1167
0130-001,2015,2,18,24,342,272,614,877
0130-001,2015,2,19,1,239,201,440,614
0130-001,2015,2,19,2,144,141,285,440
0130-001,2015,2,19,3,106,103,209,285
0130-001,2015,2,19,4,96,83,179,209
0130-001,2015,2,19,5,97,91,188,179
0130-001,2015,2,19,6,131,182,313,188
0130-001,2015,2,19,7,428,330,758,313
0130-001,2015,2,19,8,878,638,1516,758
0130-001,2015,2,19,9,828,754,1582,1516
0130-001,2015,2,19,10,706,762,1468,1582
0130-001,2015,2,19,11,1343,1226,2569,1468
0130-001,2015,2,19,12,1819,1584,3403,2569
0130-001,2015,2,19,13,1892,1779,3671,3403
0130-001,2015,2,19,14,2190,1943,4133,3671
0130-001,2015,2,19,15,2133,1958,4091,4133
0130-001,2015,2,19,16,2292,2006,4298,4091
0130-001,2015,2,19,17,2182,2115,4297,4298
0130-001,2015,2,19,18,2089,1880,3969,4297
0130-001,2015,2,19,19,1868,1554,3422,3969
0130-001,2015,2,19,20,1467,1087,2554,3422
0130-001,2015,2,19,21,993,849,1842,2554
0130-001,2015,2,19,22,845,760,1605,1842
0130-001,2015,2,19,23,654,509,1163,1605
0130-001,2015,2,19,24,560,378,938,1163
0130-001,2015,2,20,1,484,253,737,938
0130-001,2015,2,20,2,363,157,520,737
0130-001,2015,2,20,3,214,119,333,520
0130-001,2015,2,20,4,144,104,248,333
0130-001,2015,2,20,5,120,102,222,248
0130-001,2015,2,20,6,146,163,309,222
0130-001,2015,2,20,7,259,165,424,309
0130-001,2015,2,20,8,334,261,595,424
0130-001,2015,2,20,9,464,444,908,595
0130-001,2015,2,20,10,653,584,1237,908
0130-001,2015,2,20,11,1108,850,1958,1237
0130-001,2015,2,20,12,1602,1158,2760,1958
0130-001,2015,2,20,13,1759,1257,3016,2760
0130-001,2015,2,20,14,1883,1309,3192,3016
0130-001,2015,2,20,15,1911,1375,3286,3192
0130-001,2015,2,20,16,1852,1396,3248,3286
0130-001,2015,2,20,17,1767,1234,3001,3248
0130-001,2015,2,20,18,1859,1148,3007,3001
0130-001,2015,2,20,19,1821,1072,2893,3007
0130-001,2015,2,20,20,1840,812,2652,2893
0130-001,2015,2,20,21,1636,751,2387,2652
0130-001,2015,2,20,22,1605,708,2313,2387
0130-001,2015,2,20,23,1207,473,1680,2313
0130-001,2015,2,20,24,880,324,1204,1680
0130-001,2015,2,21,1,642,248,890,1204
0130-001,2015,2,21,2,464,169,633,890
0130-001,2015,2,21,3,252,131,383,633
0130-001,2015,2,21,4,143,87,230,383
0130-001,2015,2,21,5,138,105,243,230
0130-001,2015,2,21,6,179,205,384,243
0130-001,2015,2,21,7,459,337,796,384
0130-001,2015,2,21,8,995,703,1698,796
0130-001,2015,2,21,9,1139,1127,2266,1698
0130-001,2015,2,21,10,1113,1105,2218,2266
0130-001,2015,2,21,11,1212,1273,2485,2218
0130-001,2015,2,21,12,1365,1298,2663,2485
0130-001,2015,2,21,13,1523,1376,2899,2663
0130-001,2015,2,21,14,1759,1593,3352,2899
0130-001,2015,2,21,15,1823,1574,3397,3352
0130-001,2015,2,21,16,1829,1548,3377,3397
0130-001,2015,2,21,17,1872,1577,3449,3377
0130-001,2015,2,21,18,1751,1634,3385,3449
0130-001,2015,2,21,19,1555,1403,2958,3385
0130-001,2015,2,21,20,1213,1077,2290,2958
0130-001,2015,2,21,21,1008,869,1877,2290
0130-001,2015,2,21,22,883,805,1688,1877
0130-001,2015,2,21,23,635,528,1163,1688
0130-001,2015,2,21,24,470,338,808,1163
0130-001,2015,2,22,1,308,247,555,808
0130-001,2015,2,22,2,189,170,359,555
0130-001,2015,2,22,3,140,114,254,359
0130-001,2015,2,22,4,121,123,244,254
0130-001,2015,2,22,5,158,188,346,244
0130-001,2015,2,22,6,313,303,616,346
0130-001,2015,2,22,7,1006,599,1605,616
0130-001,2015,2,22,8,2096,1443,3539,1605
0130-001,2015,2,22,9,1943,1926,3869,3539
0130-001,2015,2,22,10,1653,1613,3266,3869
0130-001,2015,2,22,11,1599,1679,3278,3266
0130-001,2015,2,22,12,1545,1573,3118,3278
0130-001,2015,2,22,13,1511,1459,2970,3118
0130-001,2015,2,22,14,1678,1692,3370,2970
0130-001,2015,2,22,15,1769,1804,3573,3370
0130-001,2015,2,22,16,1762,1824,3586,3573
0130-001,2015,2,22,17,1634,1738,3372,3586
0130-001,2015,2,22,18,1737,2155,3892,3372
0130-001,2015,2,22,19,1769,2214,3983,3892
0130-001,2015,2,22,20,1312,1573,2885,3983
0130-001,2015,2,22,21,1094,1371,2465,2885
0130-001,2015,2,22,22,1053,1069,2122,2465
0130-001,2015,2,22,23,763,704,1467,2122
0130-001,2015,2,22,24,492,446,938,1467
0130-001,2015,2,23,1,399,168,567,938
0130-001,2015,2,23,2,326,99,425,567
0130-001,2015,2,23,3,792,78,870,425
0130-001,2015,2,23,4,692,97,789,870
0130-001,2015,2,23,5,887,132,1019,789
0130-001,2015,2,23,6,1214,260,1474,1019
0130-001,2015,2,23,7,1851,580,2431,1474
0130-001,2015,2,23,8,2018,1417,3435,2431
0130-001,2015,2,23,9,1969,1779,3748,3435
0130-001,2015,2,23,10,1624,1686,3310,3748
0130-001,2015,2,23,11,1618,1628,3246,3310
0130-001,2015,2,23,12,1413,1588,3001,3246
0130-001,2015,2,23,13,1382,1484,2866,3001
0130-001,2015,2,23,14,1561,1774,3335,2866
0130-001,2015,2,23,15,1734,1835,3569,3335
0130-001,2015,2,23,16,1668,1728,3396,3569
0130-001,2015,2,23,17,1618,1856,3474,3396
0130-001,2015,2,23,18,1697,2267,3964,3474
0130-001,2015,2,23,19,1713,2255,3968,3964
0130-001,2015,2,23,20,1400,1661,3061,3968
0130-001,2015,2,23,21,1048,1373,2421,3061
0130-001,2015,2,23,22,1021,1180,2201,2421
0130-001,2015,2,23,23,767,699,1466,2201
0130-001,2015,2,23,24,476,421,897,1466
0130-001,2015,2,24,1,290,258,548,897
0130-001,2015,2,24,2,219,159,378,548
0130-001,2015,2,24,3,154,136,290,378
0130-001,2015,2,24,4,122,113,235,290
0130-001,2015,2,24,5,144,162,306,235
0130-001,2015,2,24,6,372,264,636,306
0130-001,2015,2,24,7,1320,540,1860,636
0130-001,2015,2,24,8,2072,1511,3583,1860
0130-001,2015,2,24,9,1945,1904,3849,3583
0130-001,2015,2,24,10,1756,1751,3507,3849
0130-001,2015,2,24,11,1836,1657,3493,3507
0130-001,2015,2,24,12,1597,1624,3221,3493
0130-001,2015,2,24,13,1348,1594,2942,3221
0130-001,2015,2,24,14,1661,1783,3444,2942
0130-001,2015,2,24,15,1954,1860,3814,3444
0130-001,2015,2,24,16,2010,1837,3847,3814
0130-001,2015,2,24,17,1765,1925,3690,3847
0130-001,2015,2,24,18,1731,2247,3978,3690
0130-001,2015,2,24,19,1663,2261,3924,3978
0130-001,2015,2,24,20,1325,1753,3078,3924
0130-001,2015,2,24,21,1084,1561,2645,3078
0130-001,2015,2,24,22,1075,1230,2305,2645
0130-001,2015,2,24,23,850,770,1620,2305
0130-001,2015,2,24,24,512,406,918,1620
0130-001,2015,2,25,1,356,262,618,918
0130-001,2015,2,25,2,240,168,408,618
0130-001,2015,2,25,3,161,143,304,408
0130-001,2015,2,25,4,127,116,243,304
0130-001,2015,2,25,5,124,155,279,243
0130-001,2015,2,25,6,401,283,684,279
0130-001,2015,2,25,7,1304,601,1905,684
0130-001,2015,2,25,8,2038,1452,3490,1905
0130-001,2015,2,25,9,2183,1948,4131,3490
0130-001,2015,2,25,10,1886,1804,3690,4131
0130-001,2015,2,25,11,1844,1682,3526,3690
0130-001,2015,2,25,12,1692,1649,3341,3526
0130-001,2015,2,25,13,1475,1553,3028,3341
0130-001,2015,2,25,14,1759,1839,3598,3028
0130-001,2015,2,25,15,1903,1866,3769,3598
0130-001,2015,2,25,16,1953,1839,3792,3769
0130-001,2015,2,25,17,1751,1900,3651,3792
0130-001,2015,2,25,18,1709,2347,4056,3651
0130-001,2015,2,25,19,1717,2434,4151,4056
0130-001,2015,2,25,20,1375,1866,3241,4151
0130-001,2015,2,25,21,1241,1477,2718,3241
0130-001,2015,2,25,22,1207,1210,2417,2718
0130-001,2015,2,25,23,909,726,1635,2417
0130-001,2015,2,25,24,569,461,1030,1635
0130-001,2015,2,26,1,394,300,694,1030
0130-001,2015,2,26,2,204,151,355,694
0130-001,2015,2,26,3,156,80,236,355
0130-001,2015,2,26,4,144,53,197,236
0130-001,2015,2,26,5,360,116,476,197
0130-001,2015,2,26,6,1162,222,1384,476
0130-001,2015,2,26,7,1509,523,2032,1384
0130-001,2015,2,26,8,2194,1452,3646,2032
0130-001,2015,2,26,9,2203,1948,4151,3646
0130-001,2015,2,26,10,1936,1716,3652,4151
0130-001,2015,2,26,11,1801,1716,3517,3652
0130-001,2015,2,26,12,1659,1640,3299,3517
0130-001,2015,2,26,13,1438,1599,3037,3299
0130-001,2015,2,26,14,1732,1774,3506,3037
0130-001,2015,2,26,15,1981,1873,3854,3506
0130-001,2015,2,26,16,1702,1779,3481,3854
0130-001,2015,2,26,17,1654,1854,3508,3481
0130-001,2015,2,26,18,1751,2214,3965,3508
0130-001,2015,2,26,19,1734,2278,4012,3965
0130-001,2015,2,26,20,1366,1668,3034,4012
0130-001,2015,2,26,21,1214,1494,2708,3034
0130-001,2015,2,26,22,1114,1253,2367,2708
0130-001,2015,2,26,23,871,739,1610,2367
0130-001,2015,2,26,24,573,467,1040,1610
0130-001,2015,2,27,1,376,323,699,1040
0130-001,2015,2,27,2,258,180,438,699
0130-001,2015,2,27,3,165,187,352,438
0130-001,2015,2,27,4,133,116,249,352
0130-001,2015,2,27,5,149,155,304,249
0130-001,2015,2,27,6,371,312,683,304
0130-001,2015,2,27,7,1350,559,1909,683
0130-001,2015,2,27,8,2152,1352,3504,1909
0130-001,2015,2,27,9,2067,1933,4000,3504
0130-001,2015,2,27,10,1883,1831,3714,4000
0130-001,2015,2,27,11,1833,1737,3570,3714
0130-001,2015,2,27,12,1554,1766,3320,3570
0130-001,2015,2,27,13,1541,1682,3223,3320
0130-001,2015,2,27,14,1768,1843,3611,3223
0130-001,2015,2,27,15,2020,1952,3972,3611
0130-001,2015,2,27,16,2071,1751,3822,3972
0130-001,2015,2,27,17,1813,1954,3767,3822
0130-001,2015,2,27,18,1869,2364,4233,3767
0130-001,2015,2,27,19,1956,2365,4321,4233
0130-001,2015,2,27,20,1531,2023,3554,4321
0130-001,2015,2,27,21,1325,1626,2951,3554
0130-001,2015,2,27,22,1159,1243,2402,2951
0130-001,2015,2,27,23,962,785,1747,2402
0130-001,2015,2,27,24,682,595,1277,1747
0130-001,2015,2,28,1,506,381,887,1277
0130-001,2015,2,28,2,333,266,599,887
0130-001,2015,2,28,3,244,193,437,599
0130-001,2015,2,28,4,219,208,427,437
0130-001,2015,2,28,5,240,208,448,427
0130-001,2015,2,28,6,417,306,723,448
0130-001,2015,2,28,7,846,434,1280,723
0130-001,2015,2,28,8,1406,1030,2436,1280
0130-001,2015,2,28,9,1552,1632,3184,2436
0130-001,2015,2,28,10,1781,1737,3518,3184
0130-001,2015,2,28,11,1708,1944,3652,3518
0130-001,2015,2,28,12,1638,1914,3552,3652
0130-001,2015,2,28,13,1817,2138,3955,3552
0130-001,2015,2,28,14,1888,2143,4031,3955
0130-001,2015,2,28,15,1976,2042,4018,4031
0130-001,2015,2,28,16,2076,1917,3993,4018
0130-001,2015,2,28,17,1995,1894,3889,3993
0130-001,2015,2,28,18,1992,2151,4143,3889
0130-001,2015,2,28,19,1965,1958,3923,4143
0130-001,2015,2,28,20,1820,1145,2965,3923
0130-001,2015,2,28,21,1291,1120,2411,2965
0130-001,2015,2,28,22,1193,925,2118,2411
0130-001,2015,2,28,23,848,569,1417,2118
0130-001,2015,2,28,24,549,419,968,1417
0130-001,2015,3,1,1,379,284,663,968
0130-001,2015,3,1,2,281,216,497,663
0130-001,2015,3,1,3,223,147,370,497
0130-001,2015,3,1,4,170,139,309,370
0130-001,2015,3,1,5,173,131,304,309
0130-001,2015,3,1,6,266,229,495,304
0130-001,2015,3,1,7,488,322,810,495
0130-001,2015,3,1,8,767,592,1359,810
0130-001,2015,3,1,9,879,985,1864,1359
0130-001,2015,3,1,10,951,1188,2139,1864
0130-001,2015,3,1,11,1215,1349,2564,2139
0130-001,2015,3,1,12,1178,1376,2554,2564
0130-001,2015,3,1,13,1267,1494,2761,2554
0130-001,2015,3,1,14,1244,1415,2659,2761
0130-001,2015,3,1,15,1264,1585,2849,2659
0130-001,2015,3,1,16,1620,1544,3164,2849
0130-001,2015,3,1,17,1726,1534,3260,3164
0130-001,2015,3,1,18,1531,1620,3151,3260
0130-001,2015,3,1,19,1589,1246,2835,3151
0130-001,2015,3,1,20,1179,935,2114,2835
0130-001,2015,3,1,21,984,794,1778,2114
0130-001,2015,3,1,22,919,638,1557,1778
0130-001,2015,3,1,23,616,424,1040,1557
0130-001,2015,3,1,24,384,185,569,1040
0130-001,2015,3,2,1,229,147,376,569
0130-001,2015,3,2,2,158,98,256,376
0130-001,2015,3,2,3,84,63,147,256
0130-001,2015,3,2,4,86,65,151,147
0130-001,2015,3,2,5,142,83,225,151
0130-001,2015,3,2,6,381,200,581,225
0130-001,2015,3,2,7,1464,494,1958,581
0130-001,2015,3,2,8,2016,1246,3262,1958
0130-001,2015,3,2,9,2090,1676,3766,3262
0130-001,2015,3,2,10,1697,1574,3271,3766
0130-001,2015,3,2,11,1700,1428,3128,3271
0130-001,2015,3,2,12,1511,1414,2925,3128
0130-001,2015,3,2,13,1426,1388,2814,2925
0130-001,2015,3,2,14,1645,1494,3139,2814
0130-001,2015,3,2,15,1803,1756,3559,3139
0130-001,2015,3,2,16,1776,1829,3605,3559
0130-001,2015,3,2,17,1654,1730,3384,3605
0130-001,2015,3,2,18,1669,1943,3612,3384
0130-001,2015,3,2,19,1600,1995,3595,3612
0130-001,2015,3,2,20,1227,1660,2887,3595
0130-001,2015,3,2,21,1058,1605,2663,2887
0130-001,2015,3,2,22,958,1207,2165,2663
0130-001,2015,3,2,23,607,566,1173,2165
0130-001,2015,3,2,24,387,400,787,1173
0130-001,2015,3,3,1,339,251,590,787
0130-001,2015,3,3,2,200,148,348,590
0130-001,2015,3,3,3,128,140,268,348
0130-001,2015,3,3,4,128,110,238,268
0130-001,2015,3,3,5,177,148,325,238
0130-001,2015,3,3,6,327,253,580,325
0130-001,2015,3,3,7,1332,552,1884,580
0130-001,2015,3,3,8,2014,1526,3540,1884
0130-001,2015,3,3,9,2134,1933,4067,3540
0130-001,2015,3,3,10,1808,1660,3468,4067
0130-001,2015,3,3,11,1723,1634,3357,3468
0130-001,2015,3,3,12,1750,1482,3232,3357
0130-001,2015,3,3,13,1457,1294,2751,3232
0130-001,2015,3,3,14,1828,1575,3403,2751
0130-001,2015,3,3,15,1870,1819,3689,3403
0130-001,2015,3,3,16,1939,1824,3763,3689
0130-001,2015,3,3,17,1597,1809,3406,3763
0130-001,2015,3,3,18,1381,2042,3423,3406
0130-001,2015,3,3,19,1392,1767,3159,3423
0130-001,2015,3,3,20,1271,1175,2446,3159
0130-001,2015,3,3,21,1145,1433,2578,2446
0130-001,2015,3,3,22,1049,1132,2181,2578
0130-001,2015,3,3,23,825,633,1458,2181
0130-001,2015,3,3,24,445,399,844,1458
0130-001,2015,3,4,1,344,265,609,844
0130-001,2015,3,4,2,238,152,390,609
0130-001,2015,3,4,3,100,132,232,390
0130-001,2015,3,4,4,65,114,179,232
0130-001,2015,3,4,5,227,142,369,179
0130-001,2015,3,4,6,377,249,626,369
0130-001,2015,3,4,7,1312,544,1856,626
0130-001,2015,3,4,8,2077,1537,3614,1856
0130-001,2015,3,4,9,2153,1866,4019,3614
0130-001,2015,3,4,10,1832,1597,3429,4019
0130-001,2015,3,4,11,1822,1650,3472,3429
0130-001,2015,3,4,12,1612,1591,3203,3472
0130-001,2015,3,4,13,1540,1431,2971,3203
0130-001,2015,3,4,14,1780,1579,3359,2971
0130-001,2015,3,4,15,1916,1791,3707,3359
0130-001,2015,3,4,16,1880,1702,3582,3707
0130-001,2015,3,4,17,1716,1769,3485,3582
0130-001,2015,3,4,18,1667,2313,3980,3485
0130-001,2015,3,4,19,1641,2393,4034,3980
0130-001,2015,3,4,20,1333,1652,2985,4034
0130-001,2015,3,4,21,1144,1490,2634,2985
0130-001,2015,3,4,22,1141,1072,2213,2634
0130-001,2015,3,4,23,641,655,1296,2213
0130-001,2015,3,4,24,367,387,754,1296
0130-001,2015,3,5,1,269,283,552,754
0130-001,2015,3,5,2,175,229,404,552
0130-001,2015,3,5,3,151,116,267,404
0130-001,2015,3,5,4,124,100,224,267
0130-001,2015,3,5,5,173,152,325,224
0130-001,2015,3,5,6,406,261,667,325
0130-001,2015,3,5,7,1266,574,1840,667
0130-001,2015,3,5,8,2108,1698,3806,1840
0130-001,2015,3,5,9,2131,1914,4045,3806
0130-001,2015,3,5,10,1490,1676,3166,4045
0130-001,2015,3,5,11,1382,1589,2971,3166
0130-001,2015,3,5,12,1654,1522,3176,2971
0130-001,2015,3,5,13,1412,1433,2845,3176
0130-001,2015,3,5,14,1570,1644,3214,2845
0130-001,2015,3,5,15,1585,1607,3192,3214
0130-001,2015,3,5,16,1519,1743,3262,3192
0130-001,2015,3,5,17,1394,1826,3220,3262
0130-001,2015,3,5,18,1375,2189,3564,3220
0130-001,2015,3,5,19,1571,2298,3869,3564
0130-001,2015,3,5,20,1274,1589,2863,3869
0130-001,2015,3,5,21,1244,1482,2726,2863
0130-001,2015,3,5,22,1099,1159,2258,2726
0130-001,2015,3,5,23,894,720,1614,2258
0130-001,2015,3,5,24,564,407,971,1614
0130-001,2015,3,6,1,380,283,663,971
0130-001,2015,3,6,2,226,229,455,663
0130-001,2015,3,6,3,165,108,273,455
0130-001,2015,3,6,4,125,108,233,273
0130-001,2015,3,6,5,188,144,332,233
0130-001,2015,3,6,6,374,263,637,332
0130-001,2015,3,6,7,1300,542,1842,637
0130-001,2015,3,6,8,1983,1595,3578,1842
0130-001,2015,3,6,9,2034,1856,3890,3578
0130-001,2015,3,6,10,1751,1676,3427,3890
0130-001,2015,3,6,11,1800,1623,3423,3427
0130-001,2015,3,6,12,1528,1601,3129,3423
0130-001,2015,3,6,13,1207,1571,2778,3129
0130-001,2015,3,6,14,1388,1757,3145,2778
0130-001,2015,3,6,15,1527,1858,3385,3145
0130-001,2015,3,6,16,1813,1819,3632,3385
0130-001,2015,3,6,17,1802,1919,3721,3632
0130-001,2015,3,6,18,1933,2341,4274,3721
0130-001,2015,3,6,19,1867,2410,4277,4274
0130-001,2015,3,6,20,1519,1935,3454,4277
0130-001,2015,3,6,21,1261,1486,2747,3454
0130-001,2015,3,6,22,1265,1146,2411,2747
0130-001,2015,3,6,23,973,736,1709,2411
0130-001,2015,3,6,24,636,532,1168,1709
0130-001,2015,3,7,1,482,382,864,1168
0130-001,2015,3,7,2,329,241,570,864
0130-001,2015,3,7,3,253,140,393,570
0130-001,2015,3,7,4,191,174,365,393
0130-001,2015,3,7,5,203,195,398,365
0130-001,2015,3,7,6,373,300,673,398
0130-001,2015,3,7,7,960,528,1488,673
0130-001,2015,3,7,8,1416,1114,2530,1488
0130-001,2015,3,7,9,1680,1537,3217,2530
0130-001,2015,3,7,10,1590,1682,3272,3217
0130-001,2015,3,7,11,1817,1975,3792,3272
0130-001,2015,3,7,12,1790,2086,3876,3792
0130-001,2015,3,7,13,1757,1945,3702,3876
0130-001,2015,3,7,14,1515,1694,3209,3702
0130-001,2015,3,7,15,1482,1830,3312,3209
0130-001,2015,3,7,16,1586,1884,3470,3312
0130-001,2015,3,7,17,1738,1785,3523,3470
0130-001,2015,3,7,18,1724,2213,3937,3523
0130-001,2015,3,7,19,1822,1834,3656,3937
0130-001,2015,3,7,20,1441,1205,2646,3656
0130-001,2015,3,7,21,1232,967,2199,2646
0130-001,2015,3,7,22,1054,799,1853,2199
0130-001,2015,3,7,23,774,544,1318,1853
0130-001,2015,3,7,24,571,405,976,1318
0130-001,2015,3,8,1,361,290,651,976
0130-001,2015,3,8,2,274,213,487,651
0130-001,2015,3,8,3,226,118,344,487
0130-001,2015,3,8,4,155,130,285,344
0130-001,2015,3,8,5,183,134,317,285
0130-001,2015,3,8,6,253,203,456,317
0130-001,2015,3,8,7,479,300,779,456
0130-001,2015,3,8,8,725,603,1328,779
0130-001,2015,3,8,9,829,1017,1846,1328
0130-001,2015,3,8,10,936,1124,2060,1846
0130-001,2015,3,8,11,1279,1256,2535,2060
0130-001,2015,3,8,12,1277,1405,2682,2535
0130-001,2015,3,8,13,1300,1393,2693,2682
0130-001,2015,3,8,14,1379,1300,2679,2693
0130-001,2015,3,8,15,1474,1504,2978,2679
0130-001,2015,3,8,16,1638,1433,3071,2978
0130-001,2015,3,8,17,1763,1496,3259,3071
0130-001,2015,3,8,18,1478,1482,2960,3259
0130-001,2015,3,8,19,1711,1215,2926,2960
0130-001,2015,3,8,20,1248,965,2213,2926
0130-001,2015,3,8,21,1068,793,1861,2213
0130-001,2015,3,8,22,943,609,1552,1861
0130-001,2015,3,8,23,602,421,1023,1552
0130-001,2015,3,8,24,408,247,655,1023
0130-001,2015,3,9,1,246,203,449,655
0130-001,2015,3,9,2,159,138,297,449
0130-001,2015,3,9,3,106,65,171,297
0130-001,2015,3,9,4,92,93,185,171
0130-001,2015,3,9,5,165,106,271,185
0130-001,2015,3,9,6,462,261,723,271
0130-001,2015,3,9,7,1444,621,2065,723
0130-001,2015,3,9,8,2012,1654,3666,2065
0130-001,2015,3,9,9,2036,1937,3973,3666
0130-001,2015,3,9,10,1882,1617,3499,3973
0130-001,2015,3,9,11,1792,1575,3367,3499
0130-001,2015,3,9,12,1720,1609,3329,3367
0130-001,2015,3,9,13,1445,1460,2905,3329
0130-001,2015,3,9,14,1784,1607,3391,2905
0130-001,2015,3,9,15,1696,1674,3370,3391
0130-001,2015,3,9,16,1784,1826,3610,3370
0130-001,2015,3,9,17,1697,1789,3486,3610
0130-001,2015,3,9,18,1812,2242,4054,3486
0130-001,2015,3,9,19,1730,2272,4002,4054
0130-001,2015,3,9,20,1332,1712,3044,4002
0130-001,2015,3,9,21,1136,1543,2679,3044
0130-001,2015,3,9,22,1224,1171,2395,2679
0130-001,2015,3,9,23,783,609,1392,2395
0130-001,2015,3,9,24,463,372,835,1392
0130-001,2015,3,10,1,309,279,588,835
0130-001,2015,3,10,2,214,180,394,588
0130-001,2015,3,10,3,148,114,262,394
0130-001,2015,3,10,4,133,93,226,262
0130-001,2015,3,10,5,158,154,312,226
0130-001,2015,3,10,6,367,247,614,312
0130-001,2015,3,10,7,1409,552,1961,614
0130-001,2015,3,10,8,1965,1617,3582,1961
0130-001,2015,3,10,9,1908,1815,3723,3582
0130-001,2015,3,10,10,1755,1743,3498,3723
0130-001,2015,3,10,11,1793,1646,3439,3498
0130-001,2015,3,10,12,1720,1595,3315,3439
0130-001,2015,3,10,13,1416,1512,2928,3315
0130-001,2015,3,10,14,1829,1686,3515,2928
0130-001,2015,3,10,15,1765,1765,3530,3515
0130-001,2015,3,10,16,1377,1777,3154,3530
0130-001,2015,3,10,17,1616,1789,3405,3154
0130-001,2015,3,10,18,1760,2185,3945,3405
0130-001,2015,3,10,19,1694,2295,3989,3945
0130-001,2015,3,10,20,1352,1587,2939,3989
0130-001,2015,3,10,21,1193,1575,2768,2939
0130-001,2015,3,10,22,1235,1237,2472,2768
0130-001,2015,3,10,23,860,714,1574,2472
0130-001,2015,3,10,24,563,385,948,1574
0130-001,2015,3,11,1,332,251,583,948
0130-001,2015,3,11,2,235,146,381,583
0130-001,2015,3,11,3,164,130,294,381
0130-001,2015,3,11,4,125,93,218,294
0130-001,2015,3,11,5,158,138,296,218
0130-001,2015,3,11,6,439,271,710,296
0130-001,2015,3,11,7,1339,564,1903,710
0130-001,2015,3,11,8,2127,1666,3793,1903
0130-001,2015,3,11,9,2018,1876,3894,3793
0130-001,2015,3,11,10,1797,1664,3461,3894
0130-001,2015,3,11,11,1872,1710,3582,3461
0130-001,2015,3,11,12,1778,1656,3434,3582
0130-001,2015,3,11,13,1571,1615,3186,3434
0130-001,2015,3,11,14,1797,1858,3655,3186
0130-001,2015,3,11,15,1861,1799,3660,3655
0130-001,2015,3,11,16,1863,1749,3612,3660
0130-001,2015,3,11,17,1684,1989,3673,3612
0130-001,2015,3,11,18,1826,2296,4122,3673
0130-001,2015,3,11,19,1839,2414,4253,4122
0130-001,2015,3,11,20,1418,1850,3268,4253
0130-001,2015,3,11,21,1211,1488,2699,3268
0130-001,2015,3,11,22,1273,1088,2361,2699
0130-001,2015,3,11,23,958,661,1619,2361
0130-001,2015,3,11,24,566,431,997,1619
0130-001,2015,3,12,1,353,281,634,997
0130-001,2015,3,12,2,231,188,419,634
0130-001,2015,3,12,3,154,148,302,419
0130-001,2015,3,12,4,136,116,252,302
0130-001,2015,3,12,5,170,186,356,252
0130-001,2015,3,12,6,431,285,716,356
0130-001,2015,3,12,7,1179,552,1731,716
0130-001,2015,3,12,8,1437,1676,3113,1731
0130-001,2015,3,12,9,1527,1908,3435,3113
0130-001,2015,3,12,10,1886,1654,3540,3435
0130-001,2015,3,12,11,1798,1844,3642,3540
0130-001,2015,3,12,12,1656,1664,3320,3642
0130-001,2015,3,12,13,1425,1413,2838,3320
0130-001,2015,3,12,14,1651,1678,3329,2838
0130-001,2015,3,12,15,1783,1777,3560,3329
0130-001,2015,3,12,16,1610,1773,3383,3560
0130-001,2015,3,12,17,1524,1785,3309,3383
0130-001,2015,3,12,18,1563,2288,3851,3309
0130-001,2015,3,12,19,1652,2435,4087,3851
0130-001,2015,3,12,20,1320,1836,3156,4087
0130-001,2015,3,12,21,1229,1595,2824,3156
0130-001,2015,3,12,22,1233,1132,2365,2824
0130-001,2015,3,12,23,940,720,1660,2365
0130-001,2015,3,12,24,589,445,1034,1660
0130-001,2015,3,13,1,447,316,763,1034
0130-001,2015,3,13,2,235,207,442,763
0130-001,2015,3,13,3,180,150,330,442
0130-001,2015,3,13,4,140,120,260,330
0130-001,2015,3,13,5,168,172,340,260
0130-001,2015,3,13,6,372,160,532,340
0130-001,2015,3,13,7,1325,314,1639,532
0130-001,2015,3,13,8,2068,1334,3402,1639
0130-001,2015,3,13,9,2050,1961,4011,3402
0130-001,2015,3,13,10,1817,1613,3430,4011
0130-001,2015,3,13,11,1816,1662,3478,3430
0130-001,2015,3,13,12,1541,1761,3302,3478
0130-001,2015,3,13,13,1374,1559,2933,3302
0130-001,2015,3,13,14,1578,1817,3395,2933
0130-001,2015,3,13,15,1774,1973,3747,3395
0130-001,2015,3,13,16,1942,1981,3923,3747
0130-001,2015,3,13,17,1808,1931,3739,3923
0130-001,2015,3,13,18,1901,2286,4187,3739
0130-001,2015,3,13,19,1912,2491,4403,4187
0130-001,2015,3,13,20,1525,2018,3543,4403
0130-001,2015,3,13,21,1293,1652,2945,3543
0130-001,2015,3,13,22,1299,1237,2536,2945
0130-001,2015,3,13,23,981,728,1709,2536
0130-001,2015,3,13,24,635,504,1139,1709
0130-001,2015,3,14,1,518,358,876,1139
0130-001,2015,3,14,2,325,281,606,876
0130-001,2015,3,14,3,267,176,443,606
0130-001,2015,3,14,4,183,170,353,443
0130-001,2015,3,14,5,225,193,418,353
0130-001,2015,3,14,6,435,294,729,418
0130-001,2015,3,14,7,903,459,1362,729
0130-001,2015,3,14,8,1411,1110,2521,1362
0130-001,2015,3,14,9,1616,1623,3239,2521
0130-001,2015,3,14,10,1686,1729,3415,3239
0130-001,2015,3,14,11,1762,2137,3899,3415
0130-001,2015,3,14,12,1714,2155,3869,3899
0130-001,2015,3,14,13,1787,2094,3881,3869
0130-001,2015,3,14,14,1702,1981,3683,3881
0130-001,2015,3,14,15,1729,1933,3662,3683
0130-001,2015,3,14,16,1831,1989,3820,3662
0130-001,2015,3,14,17,1866,2056,3922,3820
0130-001,2015,3,14,18,1858,2320,4178,3922
0130-001,2015,3,14,19,1894,1890,3784,4178
0130-001,2015,3,14,20,1616,1294,2910,3784
0130-001,2015,3,14,21,1376,1086,2462,2910
0130-001,2015,3,14,22,1204,851,2055,2462
0130-001,2015,3,14,23,912,627,1539,2055
0130-001,2015,3,14,24,553,421,974,1539
0130-001,2015,3,15,1,461,285,746,974
0130-001,2015,3,15,2,308,211,519,746
0130-001,2015,3,15,3,209,154,363,519
0130-001,2015,3,15,4,163,104,267,363
0130-001,2015,3,15,5,185,114,299,267
0130-001,2015,3,15,6,250,227,477,299
0130-001,2015,3,15,7,547,277,824,477
0130-001,2015,3,15,8,734,524,1258,824
0130-001,2015,3,15,9,840,928,1768,1258
0130-001,2015,3,15,10,1018,1088,2106,1768
0130-001,2015,3,15,11,1244,1343,2587,2106
0130-001,2015,3,15,12,1173,1539,2712,2587
0130-001,2015,3,15,13,1317,1492,2809,2712
0130-001,2015,3,15,14,1514,1500,3014,2809
0130-001,2015,3,15,15,1683,1577,3260,3014
0130-001,2015,3,15,16,1790,1599,3389,3260
0130-001,2015,3,15,17,1896,1615,3511,3389
0130-001,2015,3,15,18,1781,1661,3442,3511
0130-001,2015,3,15,19,1588,1229,2817,3442
0130-001,2015,3,15,20,1490,1136,2626,2817
0130-001,2015,3,15,21,1327,882,2209,2626
0130-001,2015,3,15,22,1033,676,1709,2209
0130-001,2015,3,15,23,737,445,1182,1709
0130-001,2015,3,15,24,419,294,713,1182
0130-001,2015,3,16,1,276,213,489,713
0130-001,2015,3,16,2,162,130,292,489
0130-001,2015,3,16,3,110,71,181,292
0130-001,2015,3,16,4,110,79,189,181
0130-001,2015,3,16,5,182,126,308,189
0130-001,2015,3,16,6,490,308,798,308
0130-001,2015,3,16,7,1480,710,2190,798
0130-001,2015,3,16,8,2003,1759,3762,2190
0130-001,2015,3,16,9,1985,1892,3877,3762
0130-001,2015,3,16,10,1852,1751,3603,3877
0130-001,2015,3,16,11,1772,1565,3337,3603
0130-001,2015,3,16,12,1759,1692,3451,3337
0130-001,2015,3,16,13,1436,1490,2926,3451
0130-001,2015,3,16,14,1714,1718,3432,2926
0130-001,2015,3,16,15,1750,1797,3547,3432
0130-001,2015,3,16,16,1780,1712,3492,3547
0130-001,2015,3,16,17,1676,1872,3548,3492
0130-001,2015,3,16,18,1740,2270,4010,3548
0130-001,2015,3,16,19,1665,2310,3975,4010
0130-001,2015,3,16,20,1280,1682,2962,3975
0130-001,2015,3,16,21,1097,1522,2619,2962
0130-001,2015,3,16,22,1032,1108,2140,2619
0130-001,2015,3,16,23,724,651,1375,2140
0130-001,2015,3,16,24,490,427,917,1375
0130-001,2015,3,17,1,275,255,530,917
0130-001,2015,3,17,2,226,172,398,530
0130-001,2015,3,17,3,163,118,281,398
0130-001,2015,3,17,4,138,132,270,281
0130-001,2015,3,17,5,171,172,343,270
0130-001,2015,3,17,6,342,271,613,343
0130-001,2015,3,17,7,1193,651,1844,613
0130-001,2015,3,17,8,1660,1648,3308,1844
0130-001,2015,3,17,9,1893,1949,3842,3308
0130-001,2015,3,17,10,1787,1684,3471,3842
0130-001,2015,3,17,11,1758,1652,3410,3471
0130-001,2015,3,17,12,1735,1545,3280,3410
0130-001,2015,3,17,13,1436,1419,2855,3280
0130-001,2015,3,17,14,1828,1597,3425,2855
0130-001,2015,3,17,15,1818,1817,3635,3425
0130-001,2015,3,17,16,1658,1722,3380,3635
0130-001,2015,3,17,17,1606,1811,3417,3380
0130-001,2015,3,17,18,1570,2288,3858,3417
0130-001,2015,3,17,19,1543,2338,3881,3858
0130-001,2015,3,17,20,1312,1625,2937,3881
0130-001,2015,3,17,21,1169,1569,2738,2937
0130-001,2015,3,17,22,1142,1223,2365,2738
0130-001,2015,3,17,23,523,659,1182,2365
0130-001,2015,3,17,24,340,431,771,1182
0130-001,2015,3,18,1,245,261,506,771
0130-001,2015,3,18,2,157,172,329,506
0130-001,2015,3,18,3,125,154,279,329
0130-001,2015,3,18,4,104,110,214,279
0130-001,2015,3,18,5,119,118,237,214
0130-001,2015,3,18,6,234,260,494,237
0130-001,2015,3,18,7,1326,554,1880,494
0130-001,2015,3,18,8,2102,1602,3704,1880
0130-001,2015,3,18,9,2086,1871,3957,3704
0130-001,2015,3,18,10,1814,1630,3444,3957
0130-001,2015,3,18,11,1847,1680,3527,3444
0130-001,2015,3,18,12,1695,1624,3319,3527
0130-001,2015,3,18,13,1556,1523,3079,3319
0130-001,2015,3,18,14,1788,1718,3506,3079
0130-001,2015,3,18,15,1888,1795,3683,3506
0130-001,2015,3,18,16,1872,1726,3598,3683
0130-001,2015,3,18,17,1700,1879,3579,3598
0130-001,2015,3,18,18,1746,1971,3717,3579
0130-001,2015,3,18,19,1740,2193,3933,3717
0130-001,2015,3,18,20,1376,1644,3020,3933
0130-001,2015,3,18,21,1178,1357,2535,3020
0130-001,2015,3,18,22,1207,1003,2210,2535
0130-001,2015,3,18,23,800,623,1423,2210
0130-001,2015,3,18,24,426,389,815,1423
0130-001,2015,3,19,1,311,265,576,815
0130-001,2015,3,19,2,203,203,406,576
0130-001,2015,3,19,3,152,124,276,406
0130-001,2015,3,19,4,130,116,246,276
0130-001,2015,3,19,5,172,160,332,246
0130-001,2015,3,19,6,418,279,697,332
0130-001,2015,3,19,7,1222,572,1794,697
0130-001,2015,3,19,8,1772,1585,3357,1794
0130-001,2015,3,19,9,1829,1844,3673,3357
0130-001,2015,3,19,10,1688,1575,3263,3673
0130-001,2015,3,19,11,1590,1640,3230,3263
0130-001,2015,3,19,12,1655,1555,3210,3230
0130-001,2015,3,19,13,1418,1383,2801,3210
0130-001,2015,3,19,14,1610,1619,3229,2801
0130-001,2015,3,19,15,1684,1755,3439,3229
0130-001,2015,3,19,16,1564,1811,3375,3439
0130-001,2015,3,19,17,1459,1815,3274,3375
0130-001,2015,3,19,18,1469,2305,3774,3274
0130-001,2015,3,19,19,1612,2344,3956,3774
0130-001,2015,3,19,20,1297,1783,3080,3956
0130-001,2015,3,19,21,1236,1539,2775,3080
0130-001,2015,3,19,22,1166,1235,2401,2775
0130-001,2015,3,19,23,917,775,1692,2401
0130-001,2015,3,19,24,576,486,1062,1692
0130-001,2015,3,20,1,414,273,687,1062
0130-001,2015,3,20,2,230,170,400,687
0130-001,2015,3,20,3,172,156,328,400
0130-001,2015,3,20,4,132,122,254,328
0130-001,2015,3,20,5,178,193,371,254
0130-001,2015,3,20,6,373,298,671,371
0130-001,2015,3,20,7,1312,680,1992,671
0130-001,2015,3,20,8,2026,1541,3567,1992
0130-001,2015,3,20,9,2042,1947,3989,3567
0130-001,2015,3,20,10,1784,1654,3438,3989
0130-001,2015,3,20,11,1808,1753,3561,3438
0130-001,2015,3,20,12,1534,1824,3358,3561
0130-001,2015,3,20,13,1290,1627,2917,3358
0130-001,2015,3,20,14,1483,1763,3246,2917
0130-001,2015,3,20,15,1650,1874,3524,3246
0130-001,2015,3,20,16,1878,1811,3689,3524
0130-001,2015,3,20,17,1805,1836,3641,3689
0130-001,2015,3,20,18,1917,2381,4298,3641
0130-001,2015,3,20,19,1890,2439,4329,4298
0130-001,2015,3,20,20,1522,2066,3588,4329
0130-001,2015,3,20,21,1277,1656,2933,3588
0130-001,2015,3,20,22,1282,1165,2447,2933
0130-001,2015,3,20,23,695,771,1466,2447
0130-001,2015,3,20,24,446,502,948,1466
0130-001,2015,3,21,1,339,419,758,948
0130-001,2015,3,21,2,218,261,479,758
0130-001,2015,3,21,3,168,172,340,479
0130-001,2015,3,21,4,124,166,290,340
0130-001,2015,3,21,5,142,182,324,290
0130-001,2015,3,21,6,234,316,550,324
0130-001,2015,3,21,7,631,587,1218,550
0130-001,2015,3,21,8,1414,1140,2554,1218
0130-001,2015,3,21,9,1648,1682,3330,2554
0130-001,2015,3,21,10,1638,1767,3405,3330
0130-001,2015,3,21,11,1790,2024,3814,3405
0130-001,2015,3,21,12,1752,2096,3848,3814
0130-001,2015,3,21,13,1772,2070,3842,3848
0130-001,2015,3,21,14,1608,1789,3397,3842
0130-001,2015,3,21,15,1606,1884,3490,3397
0130-001,2015,3,21,16,1708,1852,3560,3490
0130-001,2015,3,21,17,1802,1878,3680,3560
0130-001,2015,3,21,18,1791,2118,3909,3680
0130-001,2015,3,21,19,1858,1878,3736,3909
0130-001,2015,3,21,20,1528,1385,2913,3736
0130-001,2015,3,21,21,1304,1132,2436,2913
0130-001,2015,3,21,22,1129,829,1958,2436
0130-001,2015,3,21,23,843,605,1448,1958
0130-001,2015,3,21,24,341,413,754,1448
0130-001,2015,3,22,1,497,310,807,754
0130-001,2015,3,22,2,332,237,569,807
0130-001,2015,3,22,3,260,170,430,569
0130-001,2015,3,22,4,189,148,337,430
0130-001,2015,3,22,5,205,158,363,337
0130-001,2015,3,22,6,307,205,512,363
0130-001,2015,3,22,7,568,330,898,512
0130-001,2015,3,22,8,665,593,1258,898
0130-001,2015,3,22,9,808,908,1716,1258
0130-001,2015,3,22,10,954,1031,1985,1716
0130-001,2015,3,22,11,1292,1302,2594,1985
0130-001,2015,3,22,12,1056,1256,2312,2594
0130-001,2015,3,22,13,1285,1355,2640,2312
0130-001,2015,3,22,14,1292,1314,2606,2640
0130-001,2015,3,22,15,1491,1417,2908,2606
0130-001,2015,3,22,16,1602,1448,3050,2908
0130-001,2015,3,22,17,1816,1429,3245,3050
0130-001,2015,3,22,18,1778,1457,3235,3245
0130-001,2015,3,22,19,1741,1284,3025,3235
0130-001,2015,3,22,20,1352,975,2327,3025
0130-001,2015,3,22,21,1169,833,2002,2327
0130-001,2015,3,22,22,1024,631,1655,2002
0130-001,2015,3,22,23,684,415,1099,1655
0130-001,2015,3,22,24,378,290,668,1099
0130-001,2015,3,23,1,242,172,414,668
0130-001,2015,3,23,2,171,126,297,414
0130-001,2015,3,23,3,110,79,189,297
0130-001,2015,3,23,4,85,75,160,189
0130-001,2015,3,23,5,143,110,253,160
0130-001,2015,3,23,6,482,287,769,253
0130-001,2015,3,23,7,2002,700,2702,769
0130-001,2015,3,23,8,2062,1672,3734,2702
0130-001,2015,3,23,9,2200,1900,4100,3734
0130-001,2015,3,23,10,2037,1670,3707,4100
0130-001,2015,3,23,11,1789,1682,3471,3707
0130-001,2015,3,23,12,1682,1634,3316,3471
0130-001,2015,3,23,13,1562,1456,3018,3316
0130-001,2015,3,23,14,1796,1761,3557,3018
0130-001,2015,3,23,15,1852,1795,3647,3557
0130-001,2015,3,23,16,1826,1902,3728,3647
0130-001,2015,3,23,17,1676,1757,3433,3728
0130-001,2015,3,23,18,1689,2218,3907,3433
0130-001,2015,3,23,19,1874,2329,4203,3907
0130-001,2015,3,23,20,1382,1767,3149,4203
0130-001,2015,3,23,21,1172,1514,2686,3149
0130-001,2015,3,23,22,1209,1193,2402,2686
0130-001,2015,3,23,23,882,585,1467,2402
0130-001,2015,3,23,24,577,445,1022,1467
0130-001,2015,3,24,1,392,277,669,1022
0130-001,2015,3,24,2,219,158,377,669
0130-001,2015,3,24,3,217,128,345,377
0130-001,2015,3,24,4,161,110,271,345
0130-001,2015,3,24,5,201,188,389,271
0130-001,2015,3,24,6,441,273,714,389
0130-001,2015,3,24,7,1616,655,2271,714
0130-001,2015,3,24,8,2108,1706,3814,2271
0130-001,2015,3,24,9,2172,1896,4068,3814
0130-001,2015,3,24,10,2013,1769,3782,4068
0130-001,2015,3,24,11,2071,1741,3812,3782
0130-001,2015,3,24,12,1845,1530,3375,3812
0130-001,2015,3,24,13,1576,1539,3115,3375
0130-001,2015,3,24,14,1935,1644,3579,3115
0130-001,2015,3,24,15,1978,1817,3795,3579
0130-001,2015,3,24,16,1891,1797,3688,3795
0130-001,2015,3,24,17,1694,1943,3637,3688
0130-001,2015,3,24,18,1796,2252,4048,3637
0130-001,2015,3,24,19,1754,2358,4112,4048
0130-001,2015,3,24,20,1412,1729,3141,4112
0130-001,2015,3,24,21,1269,1611,2880,3141
0130-001,2015,3,24,22,1252,1256,2508,2880
0130-001,2015,3,24,23,927,690,1617,2508
0130-001,2015,3,24,24,543,459,1002,1617
0130-001,2015,3,25,1,367,285,652,1002
0130-001,2015,3,25,2,263,186,449,652
0130-001,2015,3,25,3,178,136,314,449
0130-001,2015,3,25,4,147,122,269,314
0130-001,2015,3,25,5,178,146,324,269
0130-001,2015,3,25,6,397,292,689,324
0130-001,2015,3,25,7,1534,720,2254,689
0130-001,2015,3,25,8,2122,1595,3717,2254
0130-001,2015,3,25,9,2120,1971,4091,3717
0130-001,2015,3,25,10,1851,1696,3547,4091
0130-001,2015,3,25,11,1851,1619,3470,3547
0130-001,2015,3,25,12,1763,1650,3413,3470
0130-001,2015,3,25,13,1458,1504,2962,3413
0130-001,2015,3,25,14,1794,1686,3480,2962
0130-001,2015,3,25,15,1775,1783,3558,3480
0130-001,2015,3,25,16,1673,1832,3505,3558
0130-001,2015,3,25,17,1687,1854,3541,3505
0130-001,2015,3,25,18,1711,2252,3963,3541
0130-001,2015,3,25,19,1690,2538,4228,3963
0130-001,2015,3,25,20,1423,1807,3230,4228
0130-001,2015,3,25,21,1211,1486,2697,3230
0130-001,2015,3,25,22,1206,1072,2278,2697
0130-001,2015,3,25,23,934,710,1644,2278
0130-001,2015,3,25,24,568,477,1045,1644
0130-001,2015,3,26,1,378,298,676,1045
0130-001,2015,3,26,2,231,201,432,676
0130-001,2015,3,26,3,164,150,314,432
0130-001,2015,3,26,4,113,124,237,314
0130-001,2015,3,26,5,191,168,359,237
0130-001,2015,3,26,6,423,316,739,359
0130-001,2015,3,26,7,1572,663,2235,739
0130-001,2015,3,26,8,1990,1640,3630,2235
0130-001,2015,3,26,9,2109,1842,3951,3630
0130-001,2015,3,26,10,1935,1684,3619,3951
0130-001,2015,3,26,11,1835,1636,3471,3619
0130-001,2015,3,26,12,1669,1609,3278,3471
0130-001,2015,3,26,13,1488,1409,2897,3278
0130-001,2015,3,26,14,1711,1646,3357,2897
0130-001,2015,3,26,15,1835,1743,3578,3357
0130-001,2015,3,26,16,1789,1870,3659,3578
0130-001,2015,3,26,17,1636,1910,3546,3659
0130-001,2015,3,26,18,1831,2294,4125,3546
0130-001,2015,3,26,19,1710,2459,4169,4125
0130-001,2015,3,26,20,1331,1850,3181,4169
0130-001,2015,3,26,21,1172,1541,2713,3181
0130-001,2015,3,26,22,1241,1264,2505,2713
0130-001,2015,3,26,23,931,728,1659,2505
0130-001,2015,3,26,24,554,477,1031,1659
0130-001,2015,3,27,1,379,322,701,1031
0130-001,2015,3,27,2,238,193,431,701
0130-001,2015,3,27,3,191,152,343,431
0130-001,2015,3,27,4,154,152,306,343
0130-001,2015,3,27,5,171,154,325,306
0130-001,2015,3,27,6,445,287,732,325
0130-001,2015,3,27,7,1563,692,2255,732
0130-001,2015,3,27,8,2000,1532,3532,2255
0130-001,2015,3,27,9,2145,1902,4047,3532
0130-001,2015,3,27,10,1918,1654,3572,4047
0130-001,2015,3,27,11,1817,1625,3442,3572
0130-001,2015,3,27,12,1615,1652,3267,3442
0130-001,2015,3,27,13,1449,1490,2939,3267
0130-001,2015,3,27,14,1678,1729,3407,2939
0130-001,2015,3,27,15,1819,1832,3651,3407
0130-001,2015,3,27,16,1910,1917,3827,3651
0130-001,2015,3,27,17,1806,1917,3723,3827
0130-001,2015,3,27,18,1909,2327,4236,3723
0130-001,2015,3,27,19,1901,2591,4492,4236
0130-001,2015,3,27,20,1524,1904,3428,4492
0130-001,2015,3,27,21,1285,1668,2953,3428
0130-001,2015,3,27,22,1290,1096,2386,2953
0130-001,2015,3,27,23,838,734,1572,2386
0130-001,2015,3,27,24,540,528,1068,1572
0130-001,2015,3,28,1,258,360,618,1068
0130-001,2015,3,28,2,245,261,506,618
0130-001,2015,3,28,3,201,195,396,506
0130-001,2015,3,28,4,168,156,324,396
0130-001,2015,3,28,5,156,209,365,324
0130-001,2015,3,28,6,341,320,661,365
0130-001,2015,3,28,7,753,593,1346,661
0130-001,2015,3,28,8,1412,1092,2504,1346
0130-001,2015,3,28,9,1632,1662,3294,2504
0130-001,2015,3,28,10,1662,1801,3463,3294
0130-001,2015,3,28,11,1776,2195,3971,3463
0130-001,2015,3,28,12,1733,2305,4038,3971
0130-001,2015,3,28,13,1780,2467,4247,4038
0130-001,2015,3,28,14,1655,2072,3727,4247
0130-001,2015,3,28,15,1962,1945,3907,3727
0130-001,2015,3,28,16,1831,1844,3675,3907
0130-001,2015,3,28,17,1923,1811,3734,3675
0130-001,2015,3,28,18,1994,2185,4179,3734
0130-001,2015,3,28,19,1958,1866,3824,4179
0130-001,2015,3,28,20,1634,1294,2928,3824
0130-001,2015,3,28,21,1278,1047,2325,2928
0130-001,2015,3,28,22,1176,857,2033,2325
0130-001,2015,3,28,23,778,583,1361,2033
0130-001,2015,3,28,24,501,445,946,1361
0130-001,2015,3,29,1,406,296,702,946
0130-001,2015,3,29,2,305,221,526,702
0130-001,2015,3,29,3,238,166,404,526
0130-001,2015,3,29,4,157,140,297,404
0130-001,2015,3,29,5,178,118,296,297
0130-001,2015,3,29,6,186,193,379,296
0130-001,2015,3,29,7,558,298,856,379
0130-001,2015,3,29,8,700,532,1232,856
0130-001,2015,3,29,9,824,855,1679,1232
0130-001,2015,3,29,10,986,1136,2122,1679
0130-001,2015,3,29,11,1268,1343,2611,2122
0130-001,2015,3,29,12,1114,1524,2638,2611
0130-001,2015,3,29,13,1301,1363,2664,2638
0130-001,2015,3,29,14,1403,1488,2891,2664
0130-001,2015,3,29,15,1587,1425,3012,2891
0130-001,2015,3,29,16,1696,1458,3154,3012
0130-001,2015,3,29,17,1948,1472,3420,3154
0130-001,2015,3,29,18,1932,1598,3530,3420
0130-001,2015,3,29,19,1958,1421,3379,3530
0130-001,2015,3,29,20,1615,1066,2681,3379
0130-001,2015,3,29,21,1460,967,2427,2681
0130-001,2015,3,29,22,1128,716,1844,2427
0130-001,2015,3,29,23,786,445,1231,1844
0130-001,2015,3,29,24,448,308,756,1231
0130-001,2015,3,30,1,244,195,439,756
0130-001,2015,3,30,2,152,110,262,439
0130-001,2015,3,30,3,127,87,214,262
0130-001,2015,3,30,4,117,106,223,214
0130-001,2015,3,30,5,194,152,346,223
0130-001,2015,3,30,6,515,312,827,346
0130-001,2015,3,30,7,1764,748,2512,827
0130-001,2015,3,30,8,2103,1569,3672,2512
0130-001,2015,3,30,9,2238,1886,4124,3672
0130-001,2015,3,30,10,1840,1769,3609,4124
0130-001,2015,3,30,11,1815,1682,3497,3609
0130-001,2015,3,30,12,1694,1539,3233,3497
0130-001,2015,3,30,13,1456,1407,2863,3233
0130-001,2015,3,30,14,1655,1632,3287,2863
0130-001,2015,3,30,15,1808,1815,3623,3287
0130-001,2015,3,30,16,1763,1852,3615,3623
0130-001,2015,3,30,17,1784,1850,3634,3615
0130-001,2015,3,30,18,1740,2256,3996,3634
0130-001,2015,3,30,19,1768,2399,4167,3996
0130-001,2015,3,30,20,1370,1797,3167,4167
0130-001,2015,3,30,21,1176,1561,2737,3167
0130-001,2015,3,30,22,1102,1163,2265,2737
0130-001,2015,3,30,23,760,649,1409,2265
0130-001,2015,3,30,24,596,459,1055,1409
0130-001,2015,3,31,1,300,255,555,1055
0130-001,2015,3,31,2,212,156,368,555
0130-001,2015,3,31,3,145,126,271,368
0130-001,2015,3,31,4,131,116,247,271
0130-001,2015,3,31,5,203,166,369,247
0130-001,2015,3,31,6,397,298,695,369
0130-001,2015,3,31,7,1558,649,2207,695
0130-001,2015,3,31,8,2032,1543,3575,2207
0130-001,2015,3,31,9,2043,1888,3931,3575
0130-001,2015,3,31,10,1872,1642,3514,3931
0130-001,2015,3,31,11,1757,1619,3376,3514
0130-001,2015,3,31,12,1701,1559,3260,3376
0130-001,2015,3,31,13,1428,1484,2912,3260
0130-001,2015,3,31,14,1882,1571,3453,2912
0130-001,2015,3,31,15,1898,1440,3338,3453
0130-001,2015,3,31,16,1774,1427,3201,3338
0130-001,2015,3,31,17,1650,1757,3407,3201
0130-001,2015,3,31,18,1683,2030,3713,3407
0130-001,2015,3,31,19,1648,2230,3878,3713
0130-001,2015,3,31,20,1362,1636,2998,3878
0130-001,2015,3,31,21,1219,1359,2578,2998
0130-001,2015,3,31,22,1197,908,2105,2578
0130-001,2015,3,31,23,725,585,1310,2105
0130-001,2015,3,31,24,442,273,715,1310
0130-001,2015,4,1,1,306,183,489,715
0130-001,2015,4,1,2,210,176,386,489
0130-001,2015,4,1,3,152,120,272,386
0130-001,2015,4,1,4,126,117,243,272
0130-001,2015,4,1,5,148,169,317,243
0130-001,2015,4,1,6,316,219,535,317
0130-001,2015,4,1,7,1430,675,2105,535
0130-001,2015,4,1,8,2112,1706,3818,2105
0130-001,2015,4,1,9,2103,2025,4128,3818
0130-001,2015,4,1,10,1832,2010,3842,4128
0130-001,2015,4,1,11,1849,1792,3641,3842
0130-001,2015,4,1,12,1729,1848,3577,3641
0130-001,2015,4,1,13,1507,1585,3092,3577
0130-001,2015,4,1,14,1791,2019,3810,3092
0130-001,2015,4,1,15,1832,1906,3738,3810
0130-001,2015,4,1,16,1772,1884,3656,3738
0130-001,2015,4,1,17,1694,1938,3632,3656
0130-001,2015,4,1,18,1728,2533,4261,3632
0130-001,2015,4,1,19,1715,2741,4456,4261
0130-001,2015,4,1,20,1400,1904,3304,4456
0130-001,2015,4,1,21,1194,1549,2743,3304
0130-001,2015,4,1,22,1206,1180,2386,2743
0130-001,2015,4,1,23,867,771,1638,2386
0130-001,2015,4,1,24,703,446,1149,1638
0130-001,2015,4,2,1,344,326,670,1149
0130-001,2015,4,2,2,217,230,447,670
0130-001,2015,4,2,3,158,144,302,447
0130-001,2015,4,2,4,122,153,275,302
0130-001,2015,4,2,5,182,252,434,275
0130-001,2015,4,2,6,420,308,728,434
0130-001,2015,4,2,7,1397,767,2164,728
0130-001,2015,4,2,8,1881,1866,3747,2164
0130-001,2015,4,2,9,1969,2082,4051,3747
0130-001,2015,4,2,10,1812,1909,3721,4051
0130-001,2015,4,2,11,1712,1873,3585,3721
0130-001,2015,4,2,12,1662,1798,3460,3585
0130-001,2015,4,2,13,1453,1536,2989,3460
0130-001,2015,4,2,14,1660,1906,3566,2989
0130-001,2015,4,2,15,1760,1859,3619,3566
0130-001,2015,4,2,16,1676,2019,3695,3619
0130-001,2015,4,2,17,1548,2091,3639,3695
0130-001,2015,4,2,18,1650,2535,4185,3639
0130-001,2015,4,2,19,1661,2493,4154,4185
0130-001,2015,4,2,20,1314,1783,3097,4154
0130-001,2015,4,2,21,1204,1704,2908,3097
0130-001,2015,4,2,22,1204,1338,2542,2908
0130-001,2015,4,2,23,924,628,1552,2542
0130-001,2015,4,2,24,528,472,1000,1552
0130-001,2015,4,3,1,396,281,677,1000
0130-001,2015,4,3,2,234,180,414,677
0130-001,2015,4,3,3,182,140,322,414
0130-001,2015,4,3,4,143,79,222,322
0130-001,2015,4,3,5,174,165,339,222
0130-001,2015,4,3,6,409,279,688,339
0130-001,2015,4,3,7,1438,688,2126,688
0130-001,2015,4,3,8,2013,1832,3845,2126
0130-001,2015,4,3,9,2094,2113,4207,3845
0130-001,2015,4,3,10,1851,1727,3578,4207
0130-001,2015,4,3,11,1812,1947,3759,3578
0130-001,2015,4,3,12,1574,1877,3451,3759
0130-001,2015,4,3,13,1370,1821,3191,3451
0130-001,2015,4,3,14,1580,1956,3536,3191
0130-001,2015,4,3,15,2085,2050,4135,3536
0130-001,2015,4,3,16,2155,1992,4147,4135
0130-001,2015,4,3,17,2157,2088,4245,4147
0130-001,2015,4,3,18,2384,2538,4922,4245
0130-001,2015,4,3,19,2231,2793,5024,4922
0130-001,2015,4,3,20,1999,2235,4234,5024
0130-001,2015,4,3,21,2122,1821,3943,4234
0130-001,2015,4,3,22,1738,1403,3141,3943
0130-001,2015,4,3,23,1289,848,2137,3141
0130-001,2015,4,3,24,859,619,1478,2137
0130-001,2015,4,4,1,298,448,746,1478
0130-001,2015,4,4,2,232,270,502,746
0130-001,2015,4,4,3,184,201,385,502
0130-001,2015,4,4,4,146,174,320,385
0130-001,2015,4,4,5,149,192,341,320
0130-001,2015,4,4,6,288,344,632,341
0130-001,2015,4,4,7,692,619,1311,632
0130-001,2015,4,4,8,1413,1309,2722,1311
0130-001,2015,4,4,9,1640,1969,3609,2722
0130-001,2015,4,4,10,2085,2376,4461,3609
0130-001,2015,4,4,11,2262,2635,4897,4461
0130-001,2015,4,4,12,2275,2819,5094,4897
0130-001,2015,4,4,13,2446,2684,5130,5094
0130-001,2015,4,4,14,2985,2414,5399,5130
0130-001,2015,4,4,15,2178,2046,4224,5399
0130-001,2015,4,4,16,2087,2048,4135,4224
0130-001,2015,4,4,17,1862,1978,3840,4135
0130-001,2015,4,4,18,1892,1900,3792,3840
0130-001,2015,4,4,19,1908,1412,3320,3792
0130-001,2015,4,4,20,1581,1084,2665,3320
0130-001,2015,4,4,21,1291,1061,2352,2665
0130-001,2015,4,4,22,1152,823,1975,2352
0130-001,2015,4,4,23,810,580,1390,1975
0130-001,2015,4,4,24,421,389,810,1390
0130-001,2015,4,5,1,452,317,769,810
0130-001,2015,4,5,2,318,151,469,769
0130-001,2015,4,5,3,249,174,423,469
0130-001,2015,4,5,4,173,153,326,423
0130-001,2015,4,5,5,192,133,325,326
0130-001,2015,4,5,6,246,254,500,325
0130-001,2015,4,5,7,563,452,1015,500
0130-001,2015,4,5,8,682,688,1370,1015
0130-001,2015,4,5,9,816,931,1747,1370
0130-001,2015,4,5,10,970,1221,2191,1747
0130-001,2015,4,5,11,1280,1410,2690,2191
0130-001,2015,4,5,12,1085,1284,2369,2690
0130-001,2015,4,5,13,1293,1443,2736,2369
0130-001,2015,4,5,14,1348,1630,2978,2736
0130-001,2015,4,5,15,1539,1556,3095,2978
0130-001,2015,4,5,16,1649,1520,3169,3095
0130-001,2015,4,5,17,1882,1594,3476,3169
0130-001,2015,4,5,18,1855,1378,3233,3476
0130-001,2015,4,5,19,1850,1032,2882,3233
0130-001,2015,4,5,20,1484,920,2404,2882
0130-001,2015,4,5,21,1314,879,2193,2404
0130-001,2015,4,5,22,1076,724,1800,2193
0130-001,2015,4,5,23,735,495,1230,1800
0130-001,2015,4,5,24,413,302,715,1230
0130-001,2015,4,6,1,199,221,420,715
0130-001,2015,4,6,2,154,140,294,420
0130-001,2015,4,6,3,118,93,211,294
0130-001,2015,4,6,4,101,90,191,211
0130-001,2015,4,6,5,168,169,337,191
0130-001,2015,4,6,6,498,356,854,337
0130-001,2015,4,6,7,1883,756,2639,854
0130-001,2015,4,6,8,2082,1904,3986,2639
0130-001,2015,4,6,9,2219,2172,4391,3986
0130-001,2015,4,6,10,1938,1754,3692,4391
0130-001,2015,4,6,11,1802,1866,3668,3692
0130-001,2015,4,6,12,1688,1668,3356,3668
0130-001,2015,4,6,13,1509,1765,3274,3356
0130-001,2015,4,6,14,1726,1956,3682,3274
0130-001,2015,4,6,15,1830,1904,3734,3682
0130-001,2015,4,6,16,1794,2001,3795,3734
0130-001,2015,4,6,17,1730,1990,3720,3795
0130-001,2015,4,6,18,1714,2578,4292,3720
0130-001,2015,4,6,19,1821,2639,4460,4292
0130-001,2015,4,6,20,1376,1945,3321,4460
0130-001,2015,4,6,21,1174,1720,2894,3321
0130-001,2015,4,6,22,1156,1228,2384,2894
0130-001,2015,4,6,23,821,769,1590,2384
0130-001,2015,4,6,24,687,437,1124,1590
0130-001,2015,4,7,1,346,277,623,1124
0130-001,2015,4,7,2,216,216,432,623
0130-001,2015,4,7,3,181,124,305,432
0130-001,2015,4,7,4,146,131,277,305
0130-001,2015,4,7,5,202,185,387,277
0130-001,2015,4,7,6,419,308,727,387
0130-001,2015,4,7,7,1995,783,2778,727
0130-001,2015,4,7,8,2258,1810,4068,2778
0130-001,2015,4,7,9,2556,2160,4716,4068
0130-001,2015,4,7,10,2166,1814,3980,4716
0130-001,2015,4,7,11,2118,1821,3939,3980
0130-001,2015,4,7,12,1822,1749,3571,3939
0130-001,2015,4,7,13,1662,1639,3301,3571
0130-001,2015,4,7,14,1976,1821,3797,3301
0130-001,2015,4,7,15,2020,1981,4001,3797
0130-001,2015,4,7,16,1931,1958,3889,4001
0130-001,2015,4,7,17,1902,1983,3885,3889
0130-001,2015,4,7,18,1857,2587,4444,3885
0130-001,2015,4,7,19,1783,2726,4509,4444
0130-001,2015,4,7,20,1516,1864,3380,4509
0130-001,2015,4,7,21,1275,1700,2975,3380
0130-001,2015,4,7,22,1330,1322,2652,2975
0130-001,2015,4,7,23,909,778,1687,2652
0130-001,2015,4,7,24,664,443,1107,1687
0130-001,2015,4,8,1,411,304,715,1107
0130-001,2015,4,8,2,277,227,504,715
0130-001,2015,4,8,3,203,144,347,504
0130-001,2015,4,8,4,156,138,294,347
0130-001,2015,4,8,5,176,162,338,294
0130-001,2015,4,8,6,489,320,809,338
0130-001,2015,4,8,7,1835,751,2586,809
0130-001,2015,4,8,8,2316,1810,4126,2586
0130-001,2015,4,8,9,2386,2187,4573,4126
0130-001,2015,4,8,10,2306,1936,4242,4573
0130-001,2015,4,8,11,2069,1877,3946,4242
0130-001,2015,4,8,12,1855,1646,3501,3946
0130-001,2015,4,8,13,1835,1754,3589,3501
0130-001,2015,4,8,14,2081,1918,3999,3589
0130-001,2015,4,8,15,2160,1931,4091,3999
0130-001,2015,4,8,16,1978,1873,3851,4091
0130-001,2015,4,8,17,2040,2008,4048,3851
0130-001,2015,4,8,18,2018,2617,4635,4048
0130-001,2015,4,8,19,2055,2832,4887,4635
0130-001,2015,4,8,20,1662,2037,3699,4887
0130-001,2015,4,8,21,1419,1625,3044,3699
0130-001,2015,4,8,22,1254,1248,2502,3044
0130-001,2015,4,8,23,1038,774,1812,2502
0130-001,2015,4,8,24,643,454,1097,1812
0130-001,2015,4,9,1,440,306,746,1097
0130-001,2015,4,9,2,312,212,524,746
0130-001,2015,4,9,3,180,176,356,524
0130-001,2015,4,9,4,158,131,289,356
0130-001,2015,4,9,5,213,205,418,289
0130-001,2015,4,9,6,526,311,837,418
0130-001,2015,4,9,7,1921,729,2650,837
0130-001,2015,4,9,8,2254,1720,3974,2650
0130-001,2015,4,9,9,2437,2111,4548,3974
0130-001,2015,4,9,10,2275,1767,4042,4548
0130-001,2015,4,9,11,1939,1830,3769,4042
0130-001,2015,4,9,12,1795,1794,3589,3769
0130-001,2015,4,9,13,1653,1729,3382,3589
0130-001,2015,4,9,14,1999,1873,3872,3382
0130-001,2015,4,9,15,2026,1902,3928,3872
0130-001,2015,4,9,16,2013,1929,3942,3928
0130-001,2015,4,9,17,1956,2095,4051,3942
0130-001,2015,4,9,18,1851,2686,4537,4051
0130-001,2015,4,9,19,1869,2705,4574,4537
0130-001,2015,4,9,20,1487,1987,3474,4574
0130-001,2015,4,9,21,1298,1686,2984,3474
0130-001,2015,4,9,22,1335,1349,2684,2984
0130-001,2015,4,9,23,987,771,1758,2684
0130-001,2015,4,9,24,602,481,1083,1758
0130-001,2015,4,10,1,477,344,821,1083
0130-001,2015,4,10,2,312,230,542,821
0130-001,2015,4,10,3,168,142,310,542
0130-001,2015,4,10,4,166,124,290,310
0130-001,2015,4,10,5,211,189,400,290
0130-001,2015,4,10,6,493,331,824,400
0130-001,2015,4,10,7,1888,796,2684,824
0130-001,2015,4,10,8,2266,1821,4087,2684
0130-001,2015,4,10,9,2396,2122,4518,4087
0130-001,2015,4,10,10,2301,1906,4207,4518
0130-001,2015,4,10,11,2007,1900,3907,4207
0130-001,2015,4,10,12,2160,1823,3983,3907
0130-001,2015,4,10,13,2707,1884,4591,3983
0130-001,2015,4,10,14,2287,2093,4380,4591
0130-001,2015,4,10,15,2199,1994,4193,4380
0130-001,2015,4,10,16,2122,2086,4208,4193
0130-001,2015,4,10,17,2038,2199,4237,4208
0130-001,2015,4,10,18,2016,2792,4808,4237
0130-001,2015,4,10,19,2020,3013,5033,4808
0130-001,2015,4,10,20,1775,2383,4158,5033
0130-001,2015,4,10,21,1474,1850,3324,4158
0130-001,2015,4,10,22,1411,1461,2872,3324
0130-001,2015,4,10,23,1112,841,1953,2872
0130-001,2015,4,10,24,756,616,1372,1953
0130-001,2015,4,11,1,547,428,975,1372
0130-001,2015,4,11,2,345,272,617,975
0130-001,2015,4,11,3,273,174,447,617
0130-001,2015,4,11,4,253,234,487,447
0130-001,2015,4,11,5,242,239,481,487
0130-001,2015,4,11,6,483,340,823,481
0130-001,2015,4,11,7,1211,673,1884,823
0130-001,2015,4,11,8,1771,1243,3014,1884
0130-001,2015,4,11,9,1911,1846,3757,3014
0130-001,2015,4,11,10,1933,1994,3927,3757
0130-001,2015,4,11,11,1913,2430,4343,3927
0130-001,2015,4,11,12,1843,2615,4458,4343
0130-001,2015,4,11,13,1713,2623,4336,4458
0130-001,2015,4,11,14,1802,2605,4407,4336
0130-001,2015,4,11,15,1754,2275,4029,4407
0130-001,2015,4,11,16,1935,2226,4161,4029
0130-001,2015,4,11,17,2059,2147,4206,4161
0130-001,2015,4,11,18,2229,2592,4821,4206
0130-001,2015,4,11,19,2129,2333,4462,4821
0130-001,2015,4,11,20,1769,1612,3381,4462
0130-001,2015,4,11,21,1612,1201,2813,3381
0130-001,2015,4,11,22,1618,935,2553,2813
0130-001,2015,4,11,23,1096,693,1789,2553
0130-001,2015,4,11,24,674,520,1194,1789
0130-001,2015,4,12,1,522,362,884,1194
0130-001,2015,4,12,2,327,270,597,884
0130-001,2015,4,12,3,259,189,448,597
0130-001,2015,4,12,4,209,156,365,448
0130-001,2015,4,12,5,240,149,389,365
0130-001,2015,4,12,6,335,248,583,389
0130-001,2015,4,12,7,594,443,1037,583
0130-001,2015,4,12,8,839,646,1485,1037
0130-001,2015,4,12,9,907,980,1887,1485
0130-001,2015,4,12,10,1119,1126,2245,1887
0130-001,2015,4,12,11,1316,1336,2652,2245
0130-001,2015,4,12,12,1205,1610,2815,2652
0130-001,2015,4,12,13,1298,1547,2845,2815
0130-001,2015,4,12,14,1565,1576,3141,2845
0130-001,2015,4,12,15,1616,1660,3276,3141
0130-001,2015,4,12,16,1756,1509,3265,3276
0130-001,2015,4,12,17,1965,1601,3566,3265
0130-001,2015,4,12,18,1948,1520,3468,3566
0130-001,2015,4,12,19,1927,1261,3188,3468
0130-001,2015,4,12,20,1725,1104,2829,3188
0130-001,2015,4,12,21,1658,902,2560,2829
0130-001,2015,4,12,22,1273,724,1997,2560
0130-001,2015,4,12,23,802,463,1265,1997
0130-001,2015,4,12,24,503,315,818,1265
0130-001,2015,4,13,1,290,225,515,818
0130-001,2015,4,13,2,168,135,303,515
0130-001,2015,4,13,3,162,111,273,303
0130-001,2015,4,13,4,129,81,210,273
0130-001,2015,4,13,5,183,165,348,210
0130-001,2015,4,13,6,571,342,913,348
0130-001,2015,4,13,7,1958,855,2813,913
0130-001,2015,4,13,8,2209,1848,4057,2813
0130-001,2015,4,13,9,2297,2172,4469,4057
0130-001,2015,4,13,10,2122,1693,3815,4469
0130-001,2015,4,13,11,2188,1956,4144,3815
0130-001,2015,4,13,12,1892,1727,3619,4144
0130-001,2015,4,13,13,1727,1715,3442,3619
0130-001,2015,4,13,14,1997,2030,4027,3442
0130-001,2015,4,13,15,1797,1891,3688,4027
0130-001,2015,4,13,16,1778,2019,3797,3688
0130-001,2015,4,13,17,1757,2028,3785,3797
0130-001,2015,4,13,18,1727,2374,4101,3785
0130-001,2015,4,13,19,1794,2596,4390,4101
0130-001,2015,4,13,20,1373,1848,3221,4390
0130-001,2015,4,13,21,1175,1839,3014,3221
0130-001,2015,4,13,22,1129,1237,2366,3014
0130-001,2015,4,13,23,790,652,1442,2366
0130-001,2015,4,13,24,642,286,928,1442
0130-001,2015,4,14,1,323,223,546,928
0130-001,2015,4,14,2,214,86,300,546
0130-001,2015,4,14,3,163,104,267,300
0130-001,2015,4,14,4,138,50,188,267
0130-001,2015,4,14,5,202,70,272,188
0130-001,2015,4,14,6,408,176,584,272
0130-001,2015,4,14,7,1776,450,2226,584
0130-001,2015,4,14,8,2145,1257,3402,2226
0130-001,2015,4,14,9,2300,1628,3928,3402
0130-001,2015,4,14,10,2019,1798,3817,3928
0130-001,2015,4,14,11,1938,1794,3732,3817
0130-001,2015,4,14,12,1762,1661,3423,3732
0130-001,2015,4,14,13,1545,1754,3299,3423
0130-001,2015,4,14,14,1929,1816,3745,3299
0130-001,2015,4,14,15,1959,1888,3847,3745
0130-001,2015,4,14,16,1852,2023,3875,3847
0130-001,2015,4,14,17,1776,1886,3662,3875
0130-001,2015,4,14,18,1770,2410,4180,3662
0130-001,2015,4,14,19,1716,2654,4370,4180
0130-001,2015,4,14,20,1439,1821,3260,4370
0130-001,2015,4,14,21,1190,1691,2881,3260
0130-001,2015,4,14,22,1079,1225,2304,2881
0130-001,2015,4,14,23,777,767,1544,2304
0130-001,2015,4,14,24,795,475,1270,1544
0130-001,2015,4,15,1,358,335,693,1270
0130-001,2015,4,15,2,244,176,420,693
0130-001,2015,4,15,3,178,68,246,420
0130-001,2015,4,15,4,141,61,202,246
0130-001,2015,4,15,5,162,126,288,202
0130-001,2015,4,15,6,402,315,717,288
0130-001,2015,4,15,7,1632,760,2392,717
0130-001,2015,4,15,8,2214,1731,3945,2392
0130-001,2015,4,15,9,2244,2264,4508,3945
0130-001,2015,4,15,10,2069,1976,4045,4508
0130-001,2015,4,15,11,1959,1751,3710,4045
0130-001,2015,4,15,12,1792,1848,3640,3710
0130-001,2015,4,15,13,1671,1713,3384,3640
0130-001,2015,4,15,14,1936,1940,3876,3384
0130-001,2015,4,15,15,1996,1904,3900,3876
0130-001,2015,4,15,16,1875,2055,3930,3900
0130-001,2015,4,15,17,1867,1996,3863,3930
0130-001,2015,4,15,18,1873,2662,4535,3863
0130-001,2015,4,15,19,1885,2943,4828,4535
0130-001,2015,4,15,20,1531,2052,3583,4828
0130-001,2015,4,15,21,1306,1727,3033,3583
0130-001,2015,4,15,22,1230,1340,2570,3033
0130-001,2015,4,15,23,952,762,1714,2570
0130-001,2015,4,15,24,394,544,938,1714
0130-001,2015,4,16,1,259,338,597,938
0130-001,2015,4,16,2,178,178,356,597
0130-001,2015,4,16,3,123,153,276,356
0130-001,2015,4,16,4,130,140,270,276
0130-001,2015,4,16,5,121,167,288,270
0130-001,2015,4,16,6,297,338,635,288
0130-001,2015,4,16,7,988,796,1784,635
0130-001,2015,4,16,8,2068,1763,3831,1784
0130-001,2015,4,16,9,2203,2185,4388,3831
0130-001,2015,4,16,10,2044,1983,4027,4388
0130-001,2015,4,16,11,1826,1927,3753,4027
0130-001,2015,4,16,12,1728,1801,3529,3753
0130-001,2015,4,16,13,1553,1661,3214,3529
0130-001,2015,4,16,14,1830,1956,3786,3214
0130-001,2015,4,16,15,1893,1700,3593,3786
0130-001,2015,4,16,16,1844,1855,3699,3593
0130-001,2015,4,16,17,1752,2008,3760,3699
0130-001,2015,4,16,18,1750,2468,4218,3760
0130-001,2015,4,16,19,1765,2638,4403,4218
0130-001,2015,4,16,20,1400,1828,3228,4403
0130-001,2015,4,16,21,1251,1798,3049,3228
0130-001,2015,4,16,22,1270,1295,2565,3049
0130-001,2015,4,16,23,956,722,1678,2565
0130-001,2015,4,16,24,565,497,1062,1678
0130-001,2015,4,17,1,214,306,520,1062
0130-001,2015,4,17,2,203,212,415,520
0130-001,2015,4,17,3,176,187,363,415
0130-001,2015,4,17,4,132,117,249,363
0130-001,2015,4,17,5,257,219,476,249
0130-001,2015,4,17,6,451,317,768,476
0130-001,2015,4,17,7,1663,843,2506,768
0130-001,2015,4,17,8,2140,1839,3979,2506
0130-001,2015,4,17,9,2245,2129,4374,3979
0130-001,2015,4,17,10,2076,1963,4039,4374
0130-001,2015,4,17,11,1910,1990,3900,4039
0130-001,2015,4,17,12,1867,1978,3845,3900
0130-001,2015,4,17,13,2038,1837,3875,3845
0130-001,2015,4,17,14,1934,1938,3872,3875
0130-001,2015,4,17,15,2142,2037,4179,3872
0130-001,2015,4,17,16,2138,2237,4375,4179
0130-001,2015,4,17,17,2098,2133,4231,4375
0130-001,2015,4,17,18,2200,2684,4884,4231
0130-001,2015,4,17,19,2126,2889,5015,4884
0130-001,2015,4,17,20,1887,2172,4059,5015
0130-001,2015,4,17,21,1798,1927,3725,4059
0130-001,2015,4,17,22,1574,1324,2898,3725
0130-001,2015,4,17,23,1200,893,2093,2898
0130-001,2015,4,17,24,808,562,1370,2093
0130-001,2015,4,18,1,261,432,693,1370
0130-001,2015,4,18,2,198,281,479,693
0130-001,2015,4,18,3,128,194,322,479
0130-001,2015,4,18,4,111,162,273,322
0130-001,2015,4,18,5,118,223,341,273
0130-001,2015,4,18,6,248,358,606,341
0130-001,2015,4,18,7,641,686,1327,606
0130-001,2015,4,18,8,1592,1300,2892,1327
0130-001,2015,4,18,9,1776,1976,3752,2892
0130-001,2015,4,18,10,2009,2017,4026,3752
0130-001,2015,4,18,11,2088,2275,4363,4026
0130-001,2015,4,18,12,2059,2451,4510,4363
0130-001,2015,4,18,13,2080,2435,4515,4510
0130-001,2015,4,18,14,2394,2097,4491,4515
0130-001,2015,4,18,15,1966,2043,4009,4491
0130-001,2015,4,18,16,2011,2100,4111,4009
0130-001,2015,4,18,17,1960,1936,3896,4111
0130-001,2015,4,18,18,2060,2295,4355,3896
0130-001,2015,4,18,19,2018,2151,4169,4355
0130-001,2015,4,18,20,1675,1353,3028,4169
0130-001,2015,4,18,21,1452,1183,2635,3028
0130-001,2015,4,18,22,1385,958,2343,2635
0130-001,2015,4,18,23,953,639,1592,2343
0130-001,2015,4,18,24,302,437,739,1592
0130-001,2015,4,19,1,223,380,603,739
0130-001,2015,4,19,2,119,115,234,603
0130-001,2015,4,19,3,254,138,392,234
0130-001,2015,4,19,4,191,135,326,392
0130-001,2015,4,19,5,216,151,367,326
0130-001,2015,4,19,6,290,243,533,367
0130-001,2015,4,19,7,578,299,877,533
0130-001,2015,4,19,8,760,630,1390,877
0130-001,2015,4,19,9,862,846,1708,1390
0130-001,2015,4,19,10,1044,1066,2110,1708
0130-001,2015,4,19,11,1298,1223,2521,2110
0130-001,2015,4,19,12,1145,1228,2373,2521
0130-001,2015,4,19,13,1296,1515,2811,2373
0130-001,2015,4,19,14,1456,1329,2785,2811
0130-001,2015,4,19,15,1578,1374,2952,2785
0130-001,2015,4,19,16,1702,1441,3143,2952
0130-001,2015,4,19,17,1924,1201,3125,3143
0130-001,2015,4,19,18,1902,1207,3109,3125
0130-001,2015,4,19,19,1888,1144,3032,3109
0130-001,2015,4,19,20,1604,913,2517,3032
0130-001,2015,4,19,21,1486,848,2334,2517
0130-001,2015,4,19,22,1174,668,1842,2334
0130-001,2015,4,19,23,768,490,1258,1842
0130-001,2015,4,19,24,458,317,775,1258
0130-001,2015,4,20,1,102,212,314,775
0130-001,2015,4,20,2,89,131,220,314
0130-001,2015,4,20,3,41,75,116,220
0130-001,2015,4,20,4,35,77,112,116
0130-001,2015,4,20,5,70,149,219,112
0130-001,2015,4,20,6,534,288,822,219
0130-001,2015,4,20,7,1920,657,2577,822
0130-001,2015,4,20,8,2146,1448,3594,2577
0130-001,2015,4,20,9,2258,1792,4050,3594
0130-001,2015,4,20,10,2030,1331,3361,4050
0130-001,2015,4,20,11,1995,1345,3340,3361
0130-001,2015,4,20,12,1790,1587,3377,3340
0130-001,2015,4,20,13,1618,1293,2911,3377
0130-001,2015,4,20,14,1862,1704,3566,2911
0130-001,2015,4,20,15,1814,1951,3765,3566
0130-001,2015,4,20,16,1786,1983,3769,3765
0130-001,2015,4,20,17,1744,1976,3720,3769
0130-001,2015,4,20,18,1720,2387,4107,3720
0130-001,2015,4,20,19,1808,2529,4337,4107
0130-001,2015,4,20,20,1374,1895,3269,4337
0130-001,2015,4,20,21,1174,1756,2930,3269
0130-001,2015,4,20,22,1142,1356,2498,2930
0130-001,2015,4,20,23,806,823,1629,2498
0130-001,2015,4,20,24,664,481,1145,1629
0130-001,2015,4,21,1,139,288,427,1145
0130-001,2015,4,21,2,111,178,289,427
0130-001,2015,4,21,3,141,153,294,289
0130-001,2015,4,21,4,54,142,196,294
0130-001,2015,4,21,5,108,210,318,196
0130-001,2015,4,21,6,219,342,561,318
0130-001,2015,4,21,7,685,735,1420,561
0130-001,2015,4,21,8,2202,1715,3917,1420
0130-001,2015,4,21,9,2428,2124,4552,3917
0130-001,2015,4,21,10,2092,1888,3980,4552
0130-001,2015,4,21,11,2028,1954,3982,3980
0130-001,2015,4,21,12,1792,1693,3485,3982
0130-001,2015,4,21,13,1604,1682,3286,3485
0130-001,2015,4,21,14,1952,1933,3885,3286
0130-001,2015,4,21,15,1990,1837,3827,3885
0130-001,2015,4,21,16,1892,2039,3931,3827
0130-001,2015,4,21,17,1839,2133,3972,3931
0130-001,2015,4,21,18,1814,2578,4392,3972
0130-001,2015,4,21,19,1750,2785,4535,4392
0130-001,2015,4,21,20,1478,2196,3674,4535
0130-001,2015,4,21,21,1232,1790,3022,3674
0130-001,2015,4,21,22,1204,1362,2566,3022
0130-001,2015,4,21,23,843,825,1668,2566
0130-001,2015,4,21,24,730,551,1281,1668
0130-001,2015,4,22,1,374,286,660,1281
0130-001,2015,4,22,2,281,198,479,660
0130-001,2015,4,22,3,201,147,348,479
0130-001,2015,4,22,4,158,131,289,348
0130-001,2015,4,22,5,207,198,405,289
0130-001,2015,4,22,6,506,342,848,405
0130-001,2015,4,22,7,1898,843,2741,848
0130-001,2015,4,22,8,2324,1745,4069,2741
0130-001,2015,4,22,9,2484,2208,4692,4069
0130-001,2015,4,22,10,2357,1927,4284,4692
0130-001,2015,4,22,11,2085,1891,3976,4284
0130-001,2015,4,22,12,1814,1866,3680,3976
0130-001,2015,4,22,13,1633,1650,3283,3680
0130-001,2015,4,22,14,2018,1879,3897,3283
0130-001,2015,4,22,15,1987,1987,3974,3897
0130-001,2015,4,22,16,1993,2086,4079,3974
0130-001,2015,4,22,17,1935,2131,4066,4079
0130-001,2015,4,22,18,1863,2614,4477,4066
0130-001,2015,4,22,19,1869,2825,4694,4477
0130-001,2015,4,22,20,1604,2077,3681,4694
0130-001,2015,4,22,21,1308,1673,2981,3681
0130-001,2015,4,22,22,1189,1282,2471,2981
0130-001,2015,4,22,23,1040,825,1865,2471
0130-001,2015,4,22,24,682,481,1163,1865
0130-001,2015,4,23,1,386,353,739,1163
0130-001,2015,4,23,2,285,221,506,739
0130-001,2015,4,23,3,187,147,334,506
0130-001,2015,4,23,4,150,142,292,334
0130-001,2015,4,23,5,193,171,364,292
0130-001,2015,4,23,6,495,326,821,364
0130-001,2015,4,23,7,1915,803,2718,821
0130-001,2015,4,23,8,2295,1798,4093,2718
0130-001,2015,4,23,9,2413,2160,4573,4093
0130-001,2015,4,23,10,2197,1994,4191,4573
0130-001,2015,4,23,11,2003,1846,3849,4191
0130-001,2015,4,23,12,1865,1812,3677,3849
0130-001,2015,4,23,13,1874,1634,3508,3677
0130-001,2015,4,23,14,2013,1807,3820,3508
0130-001,2015,4,23,15,2071,2014,4085,3820
0130-001,2015,4,23,16,2046,2032,4078,4085
0130-001,2015,4,23,17,1849,2120,3969,4078
0130-001,2015,4,23,18,1991,2603,4594,3969
0130-001,2015,4,23,19,1950,2868,4818,4594
0130-001,2015,4,23,20,1512,1965,3477,4818
0130-001,2015,4,23,21,1230,1715,2945,3477
0130-001,2015,4,23,22,1312,1520,2832,2945
0130-001,2015,4,23,23,966,839,1805,2832
0130-001,2015,4,23,24,717,499,1216,1805
0130-001,2015,4,24,1,495,383,878,1216
0130-001,2015,4,24,2,296,198,494,878
0130-001,2015,4,24,3,224,198,422,494
0130-001,2015,4,24,4,185,140,325,422
0130-001,2015,4,24,5,224,201,425,325
0130-001,2015,4,24,6,506,351,857,425
0130-001,2015,4,24,7,1845,848,2693,857
0130-001,2015,4,24,8,2188,1733,3921,2693
0130-001,2015,4,24,9,2330,2109,4439,3921
0130-001,2015,4,24,10,2040,1868,3908,4439
0130-001,2015,4,24,11,2143,1933,4076,3908
0130-001,2015,4,24,12,1974,1902,3876,4076
0130-001,2015,4,24,13,1678,1731,3409,3876
0130-001,2015,4,24,14,2007,2017,4024,3409
0130-001,2015,4,24,15,2055,2048,4103,4024
0130-001,2015,4,24,16,1968,2111,4079,4103
0130-001,2015,4,24,17,2059,2127,4186,4079
0130-001,2015,4,24,18,2129,2641,4770,4186
0130-001,2015,4,24,19,2061,3014,5075,4770
0130-001,2015,4,24,20,1740,2758,4498,5075
0130-001,2015,4,24,21,1472,2196,3668,4498
0130-001,2015,4,24,22,1423,1371,2794,3668
0130-001,2015,4,24,23,1162,960,2122,2794
0130-001,2015,4,24,24,781,646,1427,2122
0130-001,2015,4,25,1,573,450,1023,1427
0130-001,2015,4,25,2,364,311,675,1023
0130-001,2015,4,25,3,308,250,558,675
0130-001,2015,4,25,4,252,225,477,558
0130-001,2015,4,25,5,273,232,505,477
0130-001,2015,4,25,6,540,394,934,505
0130-001,2015,4,25,7,1341,688,2029,934
0130-001,2015,4,25,8,1775,1275,3050,2029
0130-001,2015,4,25,9,2073,1848,3921,3050
0130-001,2015,4,25,10,1927,2064,3991,3921
0130-001,2015,4,25,11,1985,2405,4390,3991
0130-001,2015,4,25,12,1882,2442,4324,4390
0130-001,2015,4,25,13,1948,2313,4261,4324
0130-001,2015,4,25,14,1917,2129,4046,4261
0130-001,2015,4,25,15,1943,2214,4157,4046
0130-001,2015,4,25,16,1985,2057,4042,4157
0130-001,2015,4,25,17,2077,1978,4055,4042
0130-001,2015,4,25,18,2100,2441,4541,4055
0130-001,2015,4,25,19,2100,2185,4285,4541
0130-001,2015,4,25,20,1583,1495,3078,4285
0130-001,2015,4,25,21,1390,1261,2651,3078
0130-001,2015,4,25,22,1201,1064,2265,2651
0130-001,2015,4,25,23,1026,769,1795,2265
0130-001,2015,4,25,24,582,517,1099,1795
0130-001,2015,4,26,1,466,371,837,1099
0130-001,2015,4,26,2,339,281,620,837
0130-001,2015,4,26,3,267,183,450,620
0130-001,2015,4,26,4,172,169,341,450
0130-001,2015,4,26,5,259,160,419,341
0130-001,2015,4,26,6,355,297,652,419
0130-001,2015,4,26,7,703,412,1115,652
0130-001,2015,4,26,8,925,762,1687,1115
0130-001,2015,4,26,9,1022,1118,2140,1687
0130-001,2015,4,26,10,1152,1345,2497,2140
0130-001,2015,4,26,11,1394,1452,2846,2497
0130-001,2015,4,26,12,1330,1457,2787,2846
0130-001,2015,4,26,13,1365,1538,2903,2787
0130-001,2015,4,26,14,1588,1371,2959,2903
0130-001,2015,4,26,15,1577,1556,3133,2959
0130-001,2015,4,26,16,1732,1673,3405,3133
0130-001,2015,4,26,17,1974,1470,3444,3405
0130-001,2015,4,26,18,1974,1619,3593,3444
0130-001,2015,4,26,19,1824,1441,3265,3593
0130-001,2015,4,26,20,1814,1230,3044,3265
0130-001,2015,4,26,21,1621,1066,2687,3044
0130-001,2015,4,26,22,1370,789,2159,2687
0130-001,2015,4,26,23,824,616,1440,2159
0130-001,2015,4,26,24,423,304,727,1440
0130-001,2015,4,27,1,296,234,530,727
0130-001,2015,4,27,2,185,106,291,530
0130-001,2015,4,27,3,162,93,255,291
0130-001,2015,4,27,4,127,108,235,255
0130-001,2015,4,27,5,226,183,409,235
0130-001,2015,4,27,6,584,365,949,409
0130-001,2015,4,27,7,1999,855,2854,949
0130-001,2015,4,27,8,2252,1812,4064,2854
0130-001,2015,4,27,9,2337,2120,4457,4064
0130-001,2015,4,27,10,2186,1857,4043,4457
0130-001,2015,4,27,11,1978,1985,3963,4043
0130-001,2015,4,27,12,1978,1816,3794,3963
0130-001,2015,4,27,13,1666,1754,3420,3794
0130-001,2015,4,27,14,2009,1776,3785,3420
0130-001,2015,4,27,15,2088,1920,4008,3785
0130-001,2015,4,27,16,2059,2017,4076,4008
0130-001,2015,4,27,17,1890,2120,4010,4076
0130-001,2015,4,27,18,2050,2533,4583,4010
0130-001,2015,4,27,19,1968,2651,4619,4583
0130-001,2015,4,27,20,1596,2077,3673,4619
0130-001,2015,4,27,21,1370,1807,3177,3673
0130-001,2015,4,27,22,1345,1318,2663,3177
0130-001,2015,4,27,23,972,852,1824,2663
0130-001,2015,4,27,24,569,419,988,1824
0130-001,2015,4,28,1,378,338,716,988
0130-001,2015,4,28,2,281,214,495,716
0130-001,2015,4,28,3,152,158,310,495
0130-001,2015,4,28,4,133,149,282,310
0130-001,2015,4,28,5,213,187,400,282
0130-001,2015,4,28,6,543,369,912,400
0130-001,2015,4,28,7,1843,843,2686,912
0130-001,2015,4,28,8,2122,1790,3912,2686
0130-001,2015,4,28,9,2326,2138,4464,3912
0130-001,2015,4,28,10,2248,1886,4134,4464
0130-001,2015,4,28,11,2069,1987,4056,4134
0130-001,2015,4,28,12,1929,1922,3851,4056
0130-001,2015,4,28,13,1645,1637,3282,3851
0130-001,2015,4,28,14,1976,1785,3761,3282
0130-001,2015,4,28,15,2106,1954,4060,3761
0130-001,2015,4,28,16,1921,1981,3902,4060
0130-001,2015,4,28,17,1931,2032,3963,3902
0130-001,2015,4,28,18,1958,2563,4521,3963
0130-001,2015,4,28,19,1898,2691,4589,4521
0130-001,2015,4,28,20,1472,1891,3363,4589
0130-001,2015,4,28,21,1300,1825,3125,3363
0130-001,2015,4,28,22,1295,1421,2716,3125
0130-001,2015,4,28,23,923,785,1708,2716
0130-001,2015,4,28,24,576,551,1127,1708
0130-001,2015,4,29,1,234,272,506,1127
0130-001,2015,4,29,2,141,75,216,506
0130-001,2015,4,29,3,127,79,206,216
0130-001,2015,4,29,4,115,97,212,206
0130-001,2015,4,29,5,119,135,254,212
0130-001,2015,4,29,6,170,216,386,254
0130-001,2015,4,29,7,1765,508,2273,386
0130-001,2015,4,29,8,2269,1358,3627,2273
0130-001,2015,4,29,9,2364,1655,4019,3627
0130-001,2015,4,29,10,2213,1812,4025,4019
0130-001,2015,4,29,11,2022,1300,3322,4025
0130-001,2015,4,29,12,1803,1592,3395,3322
0130-001,2015,4,29,13,1652,1248,2900,3395
0130-001,2015,4,29,14,1977,1428,3405,2900
0130-001,2015,4,29,15,1992,1612,3604,3405
0130-001,2015,4,29,16,1934,1981,3915,3604
0130-001,2015,4,29,17,1901,1954,3855,3915
0130-001,2015,4,29,18,1868,2381,4249,3855
0130-001,2015,4,29,19,1877,2729,4606,4249
0130-001,2015,4,29,20,1568,1967,3535,4606
0130-001,2015,4,29,21,1307,1632,2939,3535
0130-001,2015,4,29,22,1210,1223,2433,2939
0130-001,2015,4,29,23,996,778,1774,2433
0130-001,2015,4,29,24,578,520,1098,1774
0130-001,2015,4,30,1,458,358,816,1098
0130-001,2015,4,30,2,242,232,474,816
0130-001,2015,4,30,3,155,178,333,474
0130-001,2015,4,30,4,140,158,298,333
0130-001,2015,4,30,5,157,196,353,298
0130-001,2015,4,30,6,396,401,797,353
0130-001,2015,4,30,7,1452,789,2241,797
0130-001,2015,4,30,8,2182,1886,4068,2241
0130-001,2015,4,30,9,2308,2070,4378,4068
0130-001,2015,4,30,10,2120,1884,4004,4378
0130-001,2015,4,30,11,1914,1960,3874,4004
0130-001,2015,4,30,12,1796,1727,3523,3874
0130-001,2015,4,30,13,1714,1718,3432,3523
0130-001,2015,4,30,14,1922,2010,3932,3432
0130-001,2015,4,30,15,1982,2064,4046,3932
0130-001,2015,4,30,16,1945,2003,3948,4046
0130-001,2015,4,30,17,2137,2111,4248,3948
0130-001,2015,4,30,18,2306,2646,4952,4248
0130-001,2015,4,30,19,2481,2843,5324,4952
0130-001,2015,4,30,20,2166,2426,4592,5324
0130-001,2015,4,30,21,1872,1929,3801,4592
0130-001,2015,4,30,22,1606,1540,3146,3801
0130-001,2015,4,30,23,1347,1001,2348,3146
0130-001,2015,4,30,24,884,693,1577,2348
0130-001,2015,5,1,1,617,434,1051,1577
0130-001,2015,5,1,2,400,314,714,1051
0130-001,2015,5,1,3,327,252,579,714
0130-001,2015,5,1,4,272,224,496,579
0130-001,2015,5,1,5,268,235,503,496
0130-001,2015,5,1,6,525,383,908,503
0130-001,2015,5,1,7,1282,694,1976,908
0130-001,2015,5,1,8,2014,1519,3533,1976
0130-001,2015,5,1,9,2132,2120,4252,3533
0130-001,2015,5,1,10,2058,2151,4209,4252
0130-001,2015,5,1,11,2026,2299,4325,4209
0130-001,2015,5,1,12,1920,2502,4422,4325
0130-001,2015,5,1,13,1858,2551,4409,4422
0130-001,2015,5,1,14,1970,2670,4640,4409
0130-001,2015,5,1,15,2098,2453,4551,4640
0130-001,2015,5,1,16,2053,2535,4588,4551
0130-001,2015,5,1,17,2078,2573,4651,4588
0130-001,2015,5,1,18,2164,2617,4781,4651
0130-001,2015,5,1,19,2094,2678,4772,4781
0130-001,2015,5,1,20,1814,1888,3702,4772
0130-001,2015,5,1,21,1311,1452,2763,3702
0130-001,2015,5,1,22,1133,999,2132,2763
0130-001,2015,5,1,23,964,730,1694,2132
0130-001,2015,5,1,24,577,555,1132,1694
0130-001,2015,5,2,1,477,365,842,1132
0130-001,2015,5,2,2,345,248,593,842
0130-001,2015,5,2,3,263,230,493,593
0130-001,2015,5,2,4,181,175,356,493
0130-001,2015,5,2,5,225,188,413,356
0130-001,2015,5,2,6,511,431,942,413
0130-001,2015,5,2,7,1133,648,1781,942
0130-001,2015,5,2,8,1448,1156,2604,1781
0130-001,2015,5,2,9,1699,1956,3655,2604
0130-001,2015,5,2,10,1810,2352,4162,3655
0130-001,2015,5,2,11,1850,2586,4436,4162
0130-001,2015,5,2,12,1527,2686,4213,4436
0130-001,2015,5,2,13,1697,2630,4327,4213
0130-001,2015,5,2,14,1767,2416,4183,4327
0130-001,2015,5,2,15,1739,2272,4011,4183
0130-001,2015,5,2,16,1887,2270,4157,4011
0130-001,2015,5,2,17,2038,1863,3901,4157
0130-001,2015,5,2,18,2099,2215,4314,3901
0130-001,2015,5,2,19,1671,1804,3475,4314
0130-001,2015,5,2,20,1629,1309,2938,3475
0130-001,2015,5,2,21,1421,1174,2595,2938
0130-001,2015,5,2,22,1293,865,2158,2595
0130-001,2015,5,2,23,990,573,1563,2158
0130-001,2015,5,2,24,526,275,801,1563
0130-001,2015,5,3,1,185,155,340,801
0130-001,2015,5,3,2,229,100,329,340
0130-001,2015,5,3,3,260,89,349,329
0130-001,2015,5,3,4,182,78,260,349
0130-001,2015,5,3,5,238,84,322,260
0130-001,2015,5,3,6,322,268,590,322
0130-001,2015,5,3,7,640,321,961,590
0130-001,2015,5,3,8,842,630,1472,961
0130-001,2015,5,3,9,942,842,1784,1472
0130-001,2015,5,3,10,1098,1090,2188,1784
0130-001,2015,5,3,11,1346,1404,2750,2188
0130-001,2015,5,3,12,1238,1395,2633,2750
0130-001,2015,5,3,13,1330,1426,2756,2633
0130-001,2015,5,3,14,1522,1340,2862,2756
0130-001,2015,5,3,15,1578,1748,3326,2862
0130-001,2015,5,3,16,1717,1574,3291,3326
0130-001,2015,5,3,17,1949,1393,3342,3291
0130-001,2015,5,3,18,1938,1167,3105,3342
0130-001,2015,5,3,19,1856,741,2597,3105
0130-001,2015,5,3,20,1709,781,2490,2597
0130-001,2015,5,3,21,1554,520,2074,2490
0130-001,2015,5,3,22,1272,714,1986,2074
0130-001,2015,5,3,23,796,515,1311,1986
0130-001,2015,5,3,24,308,330,638,1311
0130-001,2015,5,4,1,230,206,436,638
0130-001,2015,5,4,2,137,175,312,436
0130-001,2015,5,4,3,102,144,246,312
0130-001,2015,5,4,4,81,115,196,246
0130-001,2015,5,4,5,148,171,319,196
0130-001,2015,5,4,6,559,365,924,319
0130-001,2015,5,4,7,1960,772,2732,924
0130-001,2015,5,4,8,2199,1521,3720,2732
0130-001,2015,5,4,9,2298,2029,4327,3720
0130-001,2015,5,4,10,2108,1813,3921,4327
0130-001,2015,5,4,11,1986,2051,4037,3921
0130-001,2015,5,4,12,1884,2023,3907,4037
0130-001,2015,5,4,13,1642,1777,3419,3907
0130-001,2015,5,4,14,1936,2038,3974,3419
0130-001,2015,5,4,15,1951,2109,4060,3974
0130-001,2015,5,4,16,1922,2118,4040,4060
0130-001,2015,5,4,17,1817,2014,3831,4040
0130-001,2015,5,4,18,2334,2434,4768,3831
0130-001,2015,5,4,19,2236,2624,4860,4768
0130-001,2015,5,4,20,2035,1919,3954,4860
0130-001,2015,5,4,21,1716,1594,3310,3954
0130-001,2015,5,4,22,1437,1284,2721,3310
0130-001,2015,5,4,23,1179,829,2008,2721
0130-001,2015,5,4,24,734,489,1223,2008
0130-001,2015,5,5,1,528,361,889,1223
0130-001,2015,5,5,2,410,235,645,889
0130-001,2015,5,5,3,312,168,480,645
0130-001,2015,5,5,4,263,135,398,480
0130-001,2015,5,5,5,255,157,412,398
0130-001,2015,5,5,6,538,317,855,412
0130-001,2015,5,5,7,1226,555,1781,855
0130-001,2015,5,5,8,1558,845,2403,1781
0130-001,2015,5,5,9,1392,1158,2550,2403
0130-001,2015,5,5,10,1518,1408,2926,2550
0130-001,2015,5,5,11,1543,1673,3216,2926
0130-001,2015,5,5,12,1582,1649,3231,3216
0130-001,2015,5,5,13,1624,1572,3196,3231
0130-001,2015,5,5,14,1964,1634,3598,3196
0130-001,2015,5,5,15,2048,1596,3644,3598
0130-001,2015,5,5,16,1869,1766,3635,3644
0130-001,2015,5,5,17,1825,1707,3532,3635
0130-001,2015,5,5,18,1909,2056,3965,3532
0130-001,2015,5,5,19,1627,1735,3362,3965
0130-001,2015,5,5,20,1593,1337,2930,3362
0130-001,2015,5,5,21,1433,1158,2591,2930
0130-001,2015,5,5,22,1207,827,2034,2591
0130-001,2015,5,5,23,868,577,1445,2034
0130-001,2015,5,5,24,515,339,854,1445
0130-001,2015,5,6,1,345,239,584,854
0130-001,2015,5,6,2,270,142,412,584
0130-001,2015,5,6,3,163,129,292,412
0130-001,2015,5,6,4,132,93,225,292
0130-001,2015,5,6,5,166,146,312,225
0130-001,2015,5,6,6,592,392,984,312
0130-001,2015,5,6,7,1967,856,2823,984
0130-001,2015,5,6,8,2180,1751,3931,2823
0130-001,2015,5,6,9,2310,2003,4313,3931
0130-001,2015,5,6,10,2170,1768,3938,4313
0130-001,2015,5,6,11,1993,1766,3759,3938
0130-001,2015,5,6,12,1776,1888,3664,3759
0130-001,2015,5,6,13,1546,1510,3056,3664
0130-001,2015,5,6,14,1524,1720,3244,3056
0130-001,2015,5,6,15,1820,1819,3639,3244
0130-001,2015,5,6,16,2044,1928,3972,3639
0130-001,2015,5,6,17,1737,2065,3802,3972
0130-001,2015,5,6,18,1903,2577,4480,3802
0130-001,2015,5,6,19,1780,2731,4511,4480
0130-001,2015,5,6,20,1490,2078,3568,4511
0130-001,2015,5,6,21,1175,1753,2928,3568
0130-001,2015,5,6,22,1226,1329,2555,2928
0130-001,2015,5,6,23,917,792,1709,2555
0130-001,2015,5,6,24,594,498,1092,1709
0130-001,2015,5,7,1,389,323,712,1092
0130-001,2015,5,7,2,244,193,437,712
0130-001,2015,5,7,3,197,129,326,437
0130-001,2015,5,7,4,155,166,321,326
0130-001,2015,5,7,5,200,204,404,321
0130-001,2015,5,7,6,523,367,890,404
0130-001,2015,5,7,7,1789,818,2607,890
0130-001,2015,5,7,8,2197,1815,4012,2607
0130-001,2015,5,7,9,2318,2067,4385,4012
0130-001,2015,5,7,10,2023,1868,3891,4385
0130-001,2015,5,7,11,1974,1945,3919,3891
0130-001,2015,5,7,12,1725,1905,3630,3919
0130-001,2015,5,7,13,1616,1715,3331,3630
0130-001,2015,5,7,14,1818,1903,3721,3331
0130-001,2015,5,7,15,1901,1848,3749,3721
0130-001,2015,5,7,16,1920,1939,3859,3749
0130-001,2015,5,7,17,1678,2025,3703,3859
0130-001,2015,5,7,18,1867,2522,4389,3703
0130-001,2015,5,7,19,1784,2603,4387,4389
0130-001,2015,5,7,20,1578,2007,3585,4387
0130-001,2015,5,7,21,1362,1892,3254,3585
0130-001,2015,5,7,22,1345,1510,2855,3254
0130-001,2015,5,7,23,945,860,1805,2855
0130-001,2015,5,7,24,640,562,1202,1805
0130-001,2015,5,8,1,455,356,811,1202
0130-001,2015,5,8,2,247,248,495,811
0130-001,2015,5,8,3,198,155,353,495
0130-001,2015,5,8,4,176,126,302,353
0130-001,2015,5,8,5,189,186,375,302
0130-001,2015,5,8,6,560,423,983,375
0130-001,2015,5,8,7,1799,831,2630,983
0130-001,2015,5,8,8,2134,1713,3847,2630
0130-001,2015,5,8,9,2232,2053,4285,3847
0130-001,2015,5,8,10,2168,1886,4054,4285
0130-001,2015,5,8,11,1991,2036,4027,4054
0130-001,2015,5,8,12,2061,1921,3982,4027
0130-001,2015,5,8,13,1744,1901,3645,3982
0130-001,2015,5,8,14,1935,2042,3977,3645
0130-001,2015,5,8,15,2044,2155,4199,3977
0130-001,2015,5,8,16,2127,2266,4393,4199
0130-001,2015,5,8,17,2004,2124,4128,4393
0130-001,2015,5,8,18,2176,2697,4873,4128
0130-001,2015,5,8,19,2170,2912,5082,4873
0130-001,2015,5,8,20,1967,2423,4390,5082
0130-001,2015,5,8,21,1576,1992,3568,4390
0130-001,2015,5,8,22,1441,1534,2975,3568
0130-001,2015,5,8,23,1022,1013,2035,2975
0130-001,2015,5,8,24,653,606,1259,2035
0130-001,2015,5,9,1,436,387,823,1259
0130-001,2015,5,9,2,310,290,600,823
0130-001,2015,5,9,3,253,173,426,600
0130-001,2015,5,9,4,185,186,371,426
0130-001,2015,5,9,5,253,213,466,371
0130-001,2015,5,9,6,506,394,900,466
0130-001,2015,5,9,7,1224,717,1941,900
0130-001,2015,5,9,8,1859,1251,3110,1941
0130-001,2015,5,9,9,1840,1766,3606,3110
0130-001,2015,5,9,10,1963,2034,3997,3606
0130-001,2015,5,9,11,1855,2257,4112,3997
0130-001,2015,5,9,12,1895,2286,4181,4112
0130-001,2015,5,9,13,1731,2003,3734,4181
0130-001,2015,5,9,14,1929,2471,4400,3734
0130-001,2015,5,9,15,1929,2149,4078,4400
0130-001,2015,5,9,16,2082,2140,4222,4078
0130-001,2015,5,9,17,2182,2109,4291,4222
0130-001,2015,5,9,18,2190,2120,4310,4291
0130-001,2015,5,9,19,2063,2162,4225,4310
0130-001,2015,5,9,20,1731,1536,3267,4225
0130-001,2015,5,9,21,1373,1373,2746,3267
0130-001,2015,5,9,22,1279,1079,2358,2746
0130-001,2015,5,9,23,853,730,1583,2358
0130-001,2015,5,9,24,591,445,1036,1583
0130-001,2015,5,10,1,368,350,718,1036
0130-001,2015,5,10,2,361,230,591,718
0130-001,2015,5,10,3,230,202,432,591
0130-001,2015,5,10,4,178,151,329,432
0130-001,2015,5,10,5,208,144,352,329
0130-001,2015,5,10,6,400,286,686,352
0130-001,2015,5,10,7,707,436,1143,686
0130-001,2015,5,10,8,920,686,1606,1143
0130-001,2015,5,10,9,981,960,1941,1606
0130-001,2015,5,10,10,1120,1227,2347,1941
0130-001,2015,5,10,11,1264,1439,2703,2347
0130-001,2015,5,10,12,1184,1499,2683,2703
0130-001,2015,5,10,13,1363,1424,2787,2683
0130-001,2015,5,10,14,1458,1461,2919,2787
0130-001,2015,5,10,15,1610,1510,3120,2919
0130-001,2015,5,10,16,1935,1580,3515,3120
0130-001,2015,5,10,17,1952,1552,3504,3515
0130-001,2015,5,10,18,1857,1556,3413,3504
0130-001,2015,5,10,19,2005,1388,3393,3413
0130-001,2015,5,10,20,1791,1225,3016,3393
0130-001,2015,5,10,21,1676,1132,2808,3016
0130-001,2015,5,10,22,1509,935,2444,2808
0130-001,2015,5,10,23,854,564,1418,2444
0130-001,2015,5,10,24,509,341,850,1418
0130-001,2015,5,11,1,293,270,563,850
0130-001,2015,5,11,2,197,168,365,563
0130-001,2015,5,11,3,102,107,209,365
0130-001,2015,5,11,4,99,98,197,209
0130-001,2015,5,11,5,197,140,337,197
0130-001,2015,5,11,6,575,363,938,337
0130-001,2015,5,11,7,1938,907,2845,938
0130-001,2015,5,11,8,2129,1817,3946,2845
0130-001,2015,5,11,9,2210,2111,4321,3946
0130-001,2015,5,11,10,2050,1894,3944,4321
0130-001,2015,5,11,11,1955,1899,3854,3944
0130-001,2015,5,11,12,1850,1768,3618,3854
0130-001,2015,5,11,13,1673,1565,3238,3618
0130-001,2015,5,11,14,1780,1786,3566,3238
0130-001,2015,5,11,15,1788,2045,3833,3566
0130-001,2015,5,11,16,1901,1894,3795,3833
0130-001,2015,5,11,17,1833,2056,3889,3795
0130-001,2015,5,11,18,1820,2552,4372,3889
0130-001,2015,5,11,19,2102,2221,4323,4372
0130-001,2015,5,11,20,1816,1223,3039,4323
0130-001,2015,5,11,21,1543,1337,2880,3039
0130-001,2015,5,11,22,1391,949,2340,2880
0130-001,2015,5,11,23,1076,692,1768,2340
0130-001,2015,5,11,24,451,367,818,1768
0130-001,2015,5,12,1,227,184,411,818
0130-001,2015,5,12,2,204,149,353,411
0130-001,2015,5,12,3,148,91,239,353
0130-001,2015,5,12,4,89,98,187,239
0130-001,2015,5,12,5,151,73,224,187
0130-001,2015,5,12,6,257,219,476,224
0130-001,2015,5,12,7,775,697,1472,476
0130-001,2015,5,12,8,1840,1755,3595,1472
0130-001,2015,5,12,9,1859,2133,3992,3595
0130-001,2015,5,12,10,1883,1943,3826,3992
0130-001,2015,5,12,11,1806,1883,3689,3826
0130-001,2015,5,12,12,1756,1795,3551,3689
0130-001,2015,5,12,13,1634,1563,3197,3551
0130-001,2015,5,12,14,1970,1870,3840,3197
0130-001,2015,5,12,15,2077,1994,4071,3840
0130-001,2015,5,12,16,1895,2000,3895,4071
0130-001,2015,5,12,17,1878,2016,3894,3895
0130-001,2015,5,12,18,1934,2648,4582,3894
0130-001,2015,5,12,19,1762,2651,4413,4582
0130-001,2015,5,12,20,1532,1731,3263,4413
0130-001,2015,5,12,21,1366,1415,2781,3263
0130-001,2015,5,12,22,1251,1178,2429,2781
0130-001,2015,5,12,23,896,754,1650,2429
0130-001,2015,5,12,24,546,496,1042,1650
0130-001,2015,5,13,1,257,310,567,1042
0130-001,2015,5,13,2,206,230,436,567
0130-001,2015,5,13,3,145,146,291,436
0130-001,2015,5,13,4,124,146,270,291
0130-001,2015,5,13,5,142,166,308,270
0130-001,2015,5,13,6,381,425,806,308
0130-001,2015,5,13,7,1866,818,2684,806
0130-001,2015,5,13,8,2224,1740,3964,2684
0130-001,2015,5,13,9,2337,2100,4437,3964
0130-001,2015,5,13,10,2192,1775,3967,4437
0130-001,2015,5,13,11,2008,1755,3763,3967
0130-001,2015,5,13,12,1790,1660,3450,3763
0130-001,2015,5,13,13,1599,1479,3078,3450
0130-001,2015,5,13,14,1750,1824,3574,3078
0130-001,2015,5,13,15,1906,1894,3800,3574
0130-001,2015,5,13,16,1989,1989,3978,3800
0130-001,2015,5,13,17,1819,2104,3923,3978
0130-001,2015,5,13,18,1886,2809,4695,3923
0130-001,2015,5,13,19,1828,2833,4661,4695
0130-001,2015,5,13,20,1529,2040,3569,4661
0130-001,2015,5,13,21,1241,1788,3029,3569
0130-001,2015,5,13,22,1412,1296,2708,3029
0130-001,2015,5,13,23,1058,787,1845,2708
0130-001,2015,5,13,24,643,588,1231,1845
0130-001,2015,5,14,1,432,403,835,1231
0130-001,2015,5,14,2,306,237,543,835
0130-001,2015,5,14,3,244,193,437,543
0130-001,2015,5,14,4,225,162,387,437
0130-001,2015,5,14,5,210,197,407,387
0130-001,2015,5,14,6,623,438,1061,407
0130-001,2015,5,14,7,1925,778,2703,1061
0130-001,2015,5,14,8,2189,1731,3920,2703
0130-001,2015,5,14,9,2312,2089,4401,3920
0130-001,2015,5,14,10,2036,1808,3844,4401
0130-001,2015,5,14,11,1944,1810,3754,3844
0130-001,2015,5,14,12,1760,1720,3480,3754
0130-001,2015,5,14,13,1665,1508,3173,3480
0130-001,2015,5,14,14,1870,1813,3683,3173
0130-001,2015,5,14,15,1950,1833,3783,3683
0130-001,2015,5,14,16,1997,2045,4042,3783
0130-001,2015,5,14,17,1982,2215,4197,4042
0130-001,2015,5,14,18,1869,2672,4541,4197
0130-001,2015,5,14,19,1835,2667,4502,4541
0130-001,2015,5,14,20,1426,2095,3521,4502
0130-001,2015,5,14,21,1231,1947,3178,3521
0130-001,2015,5,14,22,1339,1406,2745,3178
0130-001,2015,5,14,23,1043,842,1885,2745
0130-001,2015,5,14,24,773,522,1295,1885
0130-001,2015,5,15,1,432,396,828,1295
0130-001,2015,5,15,2,270,226,496,828
0130-001,2015,5,15,3,219,177,396,496
0130-001,2015,5,15,4,204,184,388,396
0130-001,2015,5,15,5,210,217,427,388
0130-001,2015,5,15,6,555,429,984,427
0130-001,2015,5,15,7,1882,807,2689,984
0130-001,2015,5,15,8,2183,1742,3925,2689
0130-001,2015,5,15,9,2221,2149,4370,3925
0130-001,2015,5,15,10,2068,1888,3956,4370
0130-001,2015,5,15,11,1946,1802,3748,3956
0130-001,2015,5,15,12,1910,1751,3661,3748
0130-001,2015,5,15,13,1691,1793,3484,3661
0130-001,2015,5,15,14,1852,1923,3775,3484
0130-001,2015,5,15,15,1972,2111,4083,3775
0130-001,2015,5,15,16,2051,2082,4133,4083
0130-001,2015,5,15,17,1957,2142,4099,4133
0130-001,2015,5,15,18,2023,2668,4691,4099
0130-001,2015,5,15,19,1914,2739,4653,4691
0130-001,2015,5,15,20,1701,2213,3914,4653
0130-001,2015,5,15,21,1418,1821,3239,3914
0130-001,2015,5,15,22,1256,1377,2633,3239
0130-001,2015,5,15,23,1043,871,1914,2633
0130-001,2015,5,15,24,709,639,1348,1914
0130-001,2015,5,16,1,534,438,972,1348
0130-001,2015,5,16,2,383,339,722,972
0130-001,2015,5,16,3,296,246,542,722
0130-001,2015,5,16,4,198,195,393,542
0130-001,2015,5,16,5,272,206,478,393
0130-001,2015,5,16,6,581,429,1010,478
0130-001,2015,5,16,7,1260,739,1999,1010
0130-001,2015,5,16,8,1884,1234,3118,1999
0130-001,2015,5,16,9,1910,2023,3933,3118
0130-001,2015,5,16,10,1833,1919,3752,3933
0130-001,2015,5,16,11,1776,2277,4053,3752
0130-001,2015,5,16,12,1903,2487,4390,4053
0130-001,2015,5,16,13,1795,2336,4131,4390
0130-001,2015,5,16,14,1931,2020,3951,4131
0130-001,2015,5,16,15,2044,1978,4022,3951
0130-001,2015,5,16,16,1959,1945,3904,4022
0130-001,2015,5,16,17,1993,2036,4029,3904
0130-001,2015,5,16,18,2121,2345,4466,4029
0130-001,2015,5,16,19,1978,2029,4007,4466
0130-001,2015,5,16,20,1486,1519,3005,4007
0130-001,2015,5,16,21,1314,1362,2676,3005
0130-001,2015,5,16,22,1220,1079,2299,2676
0130-001,2015,5,16,23,881,701,1582,2299
0130-001,2015,5,16,24,632,553,1185,1582
0130-001,2015,5,17,1,451,420,871,1185
0130-001,2015,5,17,2,361,266,627,871
0130-001,2015,5,17,3,255,180,435,627
0130-001,2015,5,17,4,187,184,371,435
0130-001,2015,5,17,5,227,166,393,371
0130-001,2015,5,17,6,315,268,583,393
0130-001,2015,5,17,7,717,434,1151,583
0130-001,2015,5,17,8,964,701,1665,1151
0130-001,2015,5,17,9,945,1081,2026,1665
0130-001,2015,5,17,10,998,1289,2287,2026
0130-001,2015,5,17,11,1220,1678,2898,2287
0130-001,2015,5,17,12,1282,1698,2980,2898
0130-001,2015,5,17,13,1443,1572,3015,2980
0130-001,2015,5,17,14,1722,1583,3305,3015
0130-001,2015,5,17,15,1778,1631,3409,3305
0130-001,2015,5,17,16,1850,1525,3375,3409
0130-001,2015,5,17,17,1989,1640,3629,3375
0130-001,2015,5,17,18,2020,1581,3601,3629
0130-001,2015,5,17,19,1899,1488,3387,3601
0130-001,2015,5,17,20,1501,1194,2695,3387
0130-001,2015,5,17,21,1260,1132,2392,2695
0130-001,2015,5,17,22,1081,765,1846,2392
0130-001,2015,5,17,23,830,593,1423,1846
0130-001,2015,5,17,24,489,365,854,1423
0130-001,2015,5,18,1,347,228,575,854
0130-001,2015,5,18,2,187,157,344,575
0130-001,2015,5,18,3,110,80,190,344
0130-001,2015,5,18,4,112,107,219,190
0130-001,2015,5,18,5,155,118,273,219
0130-001,2015,5,18,6,611,405,1016,273
0130-001,2015,5,18,7,1953,889,2842,1016
0130-001,2015,5,18,8,2112,1753,3865,2842
0130-001,2015,5,18,9,2269,2007,4276,3865
0130-001,2015,5,18,10,1903,1755,3658,4276
0130-001,2015,5,18,11,1887,1775,3662,3658
0130-001,2015,5,18,12,1712,1802,3514,3662
0130-001,2015,5,18,13,1688,1574,3262,3514
0130-001,2015,5,18,14,1740,1722,3462,3262
0130-001,2015,5,18,15,1808,1777,3585,3462
0130-001,2015,5,18,16,1793,1965,3758,3585
0130-001,2015,5,18,17,1891,1961,3852,3758
0130-001,2015,5,18,18,1812,2711,4523,3852
0130-001,2015,5,18,19,1797,2635,4432,4523
0130-001,2015,5,18,20,1433,1930,3363,4432
0130-001,2015,5,18,21,1209,1923,3132,3363
0130-001,2015,5,18,22,1162,1337,2499,3132
0130-001,2015,5,18,23,832,893,1725,2499
0130-001,2015,5,18,24,534,451,985,1725
0130-001,2015,5,19,1,281,312,593,985
0130-001,2015,5,19,2,200,239,439,593
0130-001,2015,5,19,3,146,173,319,439
0130-001,2015,5,19,4,127,135,262,319
0130-001,2015,5,19,5,178,142,320,262
0130-001,2015,5,19,6,434,354,788,320
0130-001,2015,5,19,7,1000,792,1792,788
0130-001,2015,5,19,8,1699,1826,3525,1792
0130-001,2015,5,19,9,1626,2144,3770,3525
0130-001,2015,5,19,10,1700,1945,3645,3770
0130-001,2015,5,19,11,1674,1649,3323,3645
0130-001,2015,5,19,12,1669,1722,3391,3323
0130-001,2015,5,19,13,1629,1607,3236,3391
0130-001,2015,5,19,14,1967,1824,3791,3236
0130-001,2015,5,19,15,2062,1804,3866,3791
0130-001,2015,5,19,16,1882,1795,3677,3866
0130-001,2015,5,19,17,1852,2076,3928,3677
0130-001,2015,5,19,18,1922,2564,4486,3928
0130-001,2015,5,19,19,1694,2469,4163,4486
0130-001,2015,5,19,20,1562,1362,2924,4163
0130-001,2015,5,19,21,1400,1231,2631,2924
0130-001,2015,5,19,22,1229,1130,2359,2631
0130-001,2015,5,19,23,598,792,1390,2359
0130-001,2015,5,19,24,457,502,959,1390
0130-001,2015,5,20,1,325,317,642,959
0130-001,2015,5,20,2,238,193,431,642
0130-001,2015,5,20,3,154,138,292,431
0130-001,2015,5,20,4,128,153,281,292
0130-001,2015,5,20,5,154,151,305,281
0130-001,2015,5,20,6,486,341,827,305
0130-001,2015,5,20,7,1916,812,2728,827
0130-001,2015,5,20,8,2202,1777,3979,2728
0130-001,2015,5,20,9,2324,2122,4446,3979
0130-001,2015,5,20,10,2181,1839,4020,4446
0130-001,2015,5,20,11,2000,1700,3700,4020
0130-001,2015,5,20,12,1783,1793,3576,3700
0130-001,2015,5,20,13,1572,1583,3155,3576
0130-001,2015,5,20,14,1637,1833,3470,3155
0130-001,2015,5,20,15,1863,2058,3921,3470
0130-001,2015,5,20,16,2016,1923,3939,3921
0130-001,2015,5,20,17,1778,2014,3792,3939
0130-001,2015,5,20,18,1894,2632,4526,3792
0130-001,2015,5,20,19,1804,2792,4596,4526
0130-001,2015,5,20,20,1510,2038,3548,4596
0130-001,2015,5,20,21,1208,1680,2888,3548
0130-001,2015,5,20,22,1356,1302,2658,2888
0130-001,2015,5,20,23,998,812,1810,2658
0130-001,2015,5,20,24,628,542,1170,1810
0130-001,2015,5,21,1,421,396,817,1170
0130-001,2015,5,21,2,236,230,466,817
0130-001,2015,5,21,3,191,160,351,466
0130-001,2015,5,21,4,180,151,331,351
0130-001,2015,5,21,5,180,188,368,331
0130-001,2015,5,21,6,591,374,965,368
0130-001,2015,5,21,7,1816,836,2652,965
0130-001,2015,5,21,8,2101,1797,3898,2652
0130-001,2015,5,21,9,2260,2179,4439,3898
0130-001,2015,5,21,10,2084,1777,3861,4439
0130-001,2015,5,21,11,1759,1797,3556,3861
0130-001,2015,5,21,12,1742,1704,3446,3556
0130-001,2015,5,21,13,1640,1492,3132,3446
0130-001,2015,5,21,14,1844,1775,3619,3132
0130-001,2015,5,21,15,1926,1808,3734,3619
0130-001,2015,5,21,16,1958,1848,3806,3734
0130-001,2015,5,21,17,1830,2005,3835,3806
0130-001,2015,5,21,18,1868,2760,4628,3835
0130-001,2015,5,21,19,1810,2708,4518,4628
0130-001,2015,5,21,20,1502,1992,3494,4518
0130-001,2015,5,21,21,1296,1943,3239,3494
0130-001,2015,5,21,22,1324,1393,2717,3239
0130-001,2015,5,21,23,983,809,1792,2717
0130-001,2015,5,21,24,585,551,1136,1792
0130-001,2015,5,22,1,451,343,794,1136
0130-001,2015,5,22,2,302,233,535,794
0130-001,2015,5,22,3,208,233,441,535
0130-001,2015,5,22,4,208,173,381,441
0130-001,2015,5,22,5,266,206,472,381
0130-001,2015,5,22,6,630,429,1059,472
0130-001,2015,5,22,7,1889,904,2793,1059
0130-001,2015,5,22,8,2165,1724,3889,2793
0130-001,2015,5,22,9,2327,2058,4385,3889
0130-001,2015,5,22,10,2134,1886,4020,4385
0130-001,2015,5,22,11,1963,1802,3765,4020
0130-001,2015,5,22,12,1788,1784,3572,3765
0130-001,2015,5,22,13,1254,1702,2956,3572
0130-001,2015,5,22,14,1771,1430,3201,2956
0130-001,2015,5,22,15,2051,2118,4169,3201
0130-001,2015,5,22,16,2031,2053,4084,4169
0130-001,2015,5,22,17,2012,2115,4127,4084
0130-001,2015,5,22,18,2112,2705,4817,4127
0130-001,2015,5,22,19,2165,2757,4922,4817
0130-001,2015,5,22,20,1816,2299,4115,4922
0130-001,2015,5,22,21,1622,1923,3545,4115
0130-001,2015,5,22,22,1495,1554,3049,3545
0130-001,2015,5,22,23,1175,949,2124,3049
0130-001,2015,5,22,24,845,591,1436,2124
0130-001,2015,5,23,1,585,449,1034,1436
0130-001,2015,5,23,2,413,332,745,1034
0130-001,2015,5,23,3,340,226,566,745
0130-001,2015,5,23,4,325,210,535,566
0130-001,2015,5,23,5,315,241,556,535
0130-001,2015,5,23,6,753,434,1187,556
0130-001,2015,5,23,7,1356,789,2145,1187
0130-001,2015,5,23,8,1953,1384,3337,2145
0130-001,2015,5,23,9,1972,2175,4147,3337
0130-001,2015,5,23,10,2051,2352,4403,4147
0130-001,2015,5,23,11,2027,2420,4447,4403
0130-001,2015,5,23,12,2029,2480,4509,4447
0130-001,2015,5,23,13,1882,2641,4523,4509
0130-001,2015,5,23,14,1814,2653,4467,4523
0130-001,2015,5,23,15,1793,2579,4372,4467
0130-001,2015,5,23,16,1946,2442,4388,4372
0130-001,2015,5,23,17,2103,2606,4709,4388
0130-001,2015,5,23,18,2063,2644,4707,4709
0130-001,2015,5,23,19,2033,2573,4606,4707
0130-001,2015,5,23,20,1529,1797,3326,4606
0130-001,2015,5,23,21,1245,1441,2686,3326
0130-001,2015,5,23,22,1182,1024,2206,2686
0130-001,2015,5,23,23,845,717,1562,2206
0130-001,2015,5,23,24,575,458,1033,1562
0130-001,2015,5,24,1,428,345,773,1033
0130-001,2015,5,24,2,315,213,528,773
0130-001,2015,5,24,3,264,197,461,528
0130-001,2015,5,24,4,204,135,339,461
0130-001,2015,5,24,5,198,164,362,339
0130-001,2015,5,24,6,385,275,660,362
0130-001,2015,5,24,7,775,392,1167,660
0130-001,2015,5,24,8,841,648,1489,1167
0130-001,2015,5,24,9,939,1086,2025,1489
0130-001,2015,5,24,10,964,1309,2273,2025
0130-001,2015,5,24,11,1273,1552,2825,2273
0130-001,2015,5,24,12,1237,1519,2756,2825
0130-001,2015,5,24,13,1211,1428,2639,2756
0130-001,2015,5,24,14,1207,1340,2547,2639
0130-001,2015,5,24,15,1377,1311,2688,2547
0130-001,2015,5,24,16,1529,1291,2820,2688
0130-001,2015,5,24,17,1712,1450,3162,2820
0130-001,2015,5,24,18,1656,1468,3124,3162
0130-001,2015,5,24,19,1763,1353,3116,3124
0130-001,2015,5,24,20,1578,1251,2829,3116
0130-001,2015,5,24,21,1556,991,2547,2829
0130-001,2015,5,24,22,1431,862,2293,2547
0130-001,2015,5,24,23,1003,630,1633,2293
0130-001,2015,5,24,24,613,456,1069,1633
0130-001,2015,5,25,1,361,328,689,1069
0130-001,2015,5,25,2,247,202,449,689
0130-001,2015,5,25,3,223,162,385,449
0130-001,2015,5,25,4,172,133,305,385
0130-001,2015,5,25,5,185,157,342,305
0130-001,2015,5,25,6,464,332,796,342
0130-001,2015,5,25,7,1013,520,1533,796
0130-001,2015,5,25,8,1439,876,2315,1533
0130-001,2015,5,25,9,1165,1167,2332,2315
0130-001,2015,5,25,10,1341,1393,2734,2332
0130-001,2015,5,25,11,1452,1512,2964,2734
0130-001,2015,5,25,12,1665,1483,3148,2964
0130-001,2015,5,25,13,1833,1488,3321,3148
0130-001,2015,5,25,14,1904,1709,3613,3321
0130-001,2015,5,25,15,2012,1671,3683,3613
0130-001,2015,5,25,16,1961,1640,3601,3683
0130-001,2015,5,25,17,2085,1707,3792,3601
0130-001,2015,5,25,18,2012,1910,3922,3792
0130-001,2015,5,25,19,2001,1552,3553,3922
0130-001,2015,5,25,20,1705,1410,3115,3553
0130-001,2015,5,25,21,1394,1170,2564,3115
0130-001,2015,5,25,22,1190,935,2125,2564
0130-001,2015,5,25,23,815,681,1496,2125
0130-001,2015,5,25,24,557,363,920,1496
0130-001,2015,5,26,1,336,281,617,920
0130-001,2015,5,26,2,195,177,372,617
0130-001,2015,5,26,3,144,100,244,372
0130-001,2015,5,26,4,165,144,309,244
0130-001,2015,5,26,5,202,151,353,309
0130-001,2015,5,26,6,611,407,1018,353
0130-001,2015,5,26,7,1904,902,2806,1018
0130-001,2015,5,26,8,2063,1753,3816,2806
0130-001,2015,5,26,9,2191,1981,4172,3816
0130-001,2015,5,26,10,2165,1928,4093,4172
0130-001,2015,5,26,11,1863,1797,3660,4093
0130-001,2015,5,26,12,1844,1905,3749,3660
0130-001,2015,5,26,13,1535,1764,3299,3749
0130-001,2015,5,26,14,1761,1892,3653,3299
0130-001,2015,5,26,15,1995,1923,3918,3653
0130-001,2015,5,26,16,1946,2009,3955,3918
0130-001,2015,5,26,17,1918,2067,3985,3955
0130-001,2015,5,26,18,1986,2657,4643,3985
0130-001,2015,5,26,19,1891,2933,4824,4643
0130-001,2015,5,26,20,1395,2484,3879,4824
0130-001,2015,5,26,21,1241,1886,3127,3879
0130-001,2015,5,26,22,1250,1479,2729,3127
0130-001,2015,5,26,23,832,827,1659,2729
0130-001,2015,5,26,24,585,504,1089,1659
0130-001,2015,5,27,1,393,347,740,1089
0130-001,2015,5,27,2,255,202,457,740
0130-001,2015,5,27,3,165,151,316,457
0130-001,2015,5,27,4,148,133,281,316
0130-001,2015,5,27,5,214,202,416,281
0130-001,2015,5,27,6,628,405,1033,416
0130-001,2015,5,27,7,1831,842,2673,1033
0130-001,2015,5,27,8,2095,1782,3877,2673
0130-001,2015,5,27,9,2189,2131,4320,3877
0130-001,2015,5,27,10,2170,1910,4080,4320
0130-001,2015,5,27,11,1970,1874,3844,4080
0130-001,2015,5,27,12,1844,1742,3586,3844
0130-001,2015,5,27,13,1654,1519,3173,3586
0130-001,2015,5,27,14,1972,1903,3875,3173
0130-001,2015,5,27,15,1978,1970,3948,3875
0130-001,2015,5,27,16,1891,1934,3825,3948
0130-001,2015,5,27,17,1933,2162,4095,3825
0130-001,2015,5,27,18,1820,2606,4426,4095
0130-001,2015,5,27,19,1808,2693,4501,4426
0130-001,2015,5,27,20,1495,2115,3610,4501
0130-001,2015,5,27,21,1216,1693,2909,3610
0130-001,2015,5,27,22,1299,1382,2681,2909
0130-001,2015,5,27,23,937,882,1819,2681
0130-001,2015,5,27,24,611,560,1171,1819
0130-001,2015,5,28,1,394,350,744,1171
0130-001,2015,5,28,2,281,235,516,744
0130-001,2015,5,28,3,180,166,346,516
0130-001,2015,5,28,4,170,166,336,346
0130-001,2015,5,28,5,219,228,447,336
0130-001,2015,5,28,6,581,376,957,447
0130-001,2015,5,28,7,1899,836,2735,957
0130-001,2015,5,28,8,2080,1720,3800,2735
0130-001,2015,5,28,9,2305,2060,4365,3800
0130-001,2015,5,28,10,1991,1861,3852,4365
0130-001,2015,5,28,11,1827,1804,3631,3852
0130-001,2015,5,28,12,1682,1826,3508,3631
0130-001,2015,5,28,13,1527,1508,3035,3508
0130-001,2015,5,28,14,1908,1764,3672,3035
0130-001,2015,5,28,15,2067,1757,3824,3672
0130-001,2015,5,28,16,2021,1908,3929,3824
0130-001,2015,5,28,17,1869,2060,3929,3929
0130-001,2015,5,28,18,1852,2524,4376,3929
0130-001,2015,5,28,19,1952,2616,4568,4376
0130-001,2015,5,28,20,1524,1967,3491,4568
0130-001,2015,5,28,21,1282,1740,3022,3491
0130-001,2015,5,28,22,1331,1479,2810,3022
0130-001,2015,5,28,23,1116,796,1912,2810
0130-001,2015,5,28,24,681,562,1243,1912
0130-001,2015,5,29,1,470,374,844,1243
0130-001,2015,5,29,2,357,235,592,844
0130-001,2015,5,29,3,253,210,463,592
0130-001,2015,5,29,4,215,199,414,463
0130-001,2015,5,29,5,257,173,430,414
0130-001,2015,5,29,6,613,416,1029,430
0130-001,2015,5,29,7,1846,882,2728,1029
0130-001,2015,5,29,8,2110,1649,3759,2728
0130-001,2015,5,29,9,2109,1950,4059,3759
0130-001,2015,5,29,10,1986,1908,3894,4059
0130-001,2015,5,29,11,1906,1830,3736,3894
0130-001,2015,5,29,12,1872,1879,3751,3736
0130-001,2015,5,29,13,1595,1662,3257,3751
0130-001,2015,5,29,14,1872,1870,3742,3257
0130-001,2015,5,29,15,2010,1941,3951,3742
0130-001,2015,5,29,16,1837,1833,3670,3951
0130-001,2015,5,29,17,1897,2179,4076,3670
0130-001,2015,5,29,18,2044,2635,4679,4076
0130-001,2015,5,29,19,2035,2741,4776,4679
0130-001,2015,5,29,20,1642,2179,3821,4776
0130-001,2015,5,29,21,1394,1914,3308,3821
0130-001,2015,5,29,22,1324,1371,2695,3308
0130-001,2015,5,29,23,1079,922,2001,2695
0130-001,2015,5,29,24,702,608,1310,2001
0130-001,2015,5,30,1,542,449,991,1310
0130-001,2015,5,30,2,402,297,699,991
0130-001,2015,5,30,3,264,224,488,699
0130-001,2015,5,30,4,195,188,383,488
0130-001,2015,5,30,5,291,224,515,383
0130-001,2015,5,30,6,668,432,1100,515
0130-001,2015,5,30,7,1309,764,2073,1100
0130-001,2015,5,30,8,1920,1309,3229,2073
0130-001,2015,5,30,9,1942,2099,4041,3229
0130-001,2015,5,30,10,1942,2136,4078,4041
0130-001,2015,5,30,11,1901,2348,4249,4078
0130-001,2015,5,30,12,1965,2484,4449,4249
0130-001,2015,5,30,13,1838,2488,4326,4449
0130-001,2015,5,30,14,1872,2336,4208,4326
0130-001,2015,5,30,15,1920,2278,4198,4208
0130-001,2015,5,30,16,1953,2194,4147,4198
0130-001,2015,5,30,17,2053,2321,4374,4147
0130-001,2015,5,30,18,2084,2237,4321,4374
0130-001,2015,5,30,19,2006,1892,3898,4321
0130-001,2015,5,30,20,1509,1561,3070,3898
0130-001,2015,5,30,21,1279,1229,2508,3070
0130-001,2015,5,30,22,1201,995,2196,2508
0130-001,2015,5,30,23,864,688,1552,2196
0130-001,2015,5,30,24,342,462,804,1552
0130-001,2015,5,31,1,440,334,774,804
0130-001,2015,5,31,2,338,297,635,774
0130-001,2015,5,31,3,260,208,468,635
0130-001,2015,5,31,4,196,162,358,468
0130-001,2015,5,31,5,212,160,372,358
0130-001,2015,5,31,6,350,268,618,372
0130-001,2015,5,31,7,746,487,1233,618
0130-001,2015,5,31,8,902,732,1634,1233
0130-001,2015,5,31,9,942,1092,2034,1634
0130-001,2015,5,31,10,981,1247,2228,2034
0130-001,2015,5,31,11,1246,1477,2723,2228
0130-001,2015,5,31,12,1260,1501,2761,2723
0130-001,2015,5,31,13,1327,1556,2883,2761
0130-001,2015,5,31,14,1464,1490,2954,2883
0130-001,2015,5,31,15,1554,1627,3181,2954
0130-001,2015,5,31,16,1556,1620,3176,3181
0130-001,2015,5,31,17,1612,1664,3276,3176
0130-001,2015,5,31,18,1670,1651,3321,3276
0130-001,2015,5,31,19,1639,1488,3127,3321
0130-001,2015,5,31,20,1314,1273,2587,3127
0130-001,2015,5,31,21,1230,986,2216,2587
0130-001,2015,5,31,22,1092,840,1932,2216
0130-001,2015,5,31,23,798,542,1340,1932
0130-001,2015,5,31,24,496,361,857,1340
0130-001,2015,6,1,1,287,210,497,857
0130-001,2015,6,1,2,186,128,314,497
0130-001,2015,6,1,3,122,101,223,314
0130-001,2015,6,1,4,133,78,211,223
0130-001,2015,6,1,5,171,169,340,211
0130-001,2015,6,1,6,538,423,961,340
0130-001,2015,6,1,7,1483,786,2269,961
0130-001,2015,6,1,8,1776,1625,3401,2269
0130-001,2015,6,1,9,1717,1951,3668,3401
0130-001,2015,6,1,10,1622,1449,3071,3668
0130-001,2015,6,1,11,1670,1775,3445,3071
0130-001,2015,6,1,12,1688,1660,3348,3445
0130-001,2015,6,1,13,1760,1449,3209,3348
0130-001,2015,6,1,14,1822,1672,3494,3209
0130-001,2015,6,1,15,1910,1814,3724,3494
0130-001,2015,6,1,16,1877,1705,3582,3724
0130-001,2015,6,1,17,1988,1886,3874,3582
0130-001,2015,6,1,18,1912,2263,4175,3874
0130-001,2015,6,1,19,1899,2375,4274,4175
0130-001,2015,6,1,20,1569,1976,3545,4274
0130-001,2015,6,1,21,1302,1646,2948,3545
0130-001,2015,6,1,22,1176,1287,2463,2948
0130-001,2015,6,1,23,824,737,1561,2463
0130-001,2015,6,1,24,546,380,926,1561
0130-001,2015,6,2,1,336,249,585,926
0130-001,2015,6,2,2,209,156,365,585
0130-001,2015,6,2,3,197,163,360,365
0130-001,2015,6,2,4,178,132,310,360
0130-001,2015,6,2,5,186,175,361,310
0130-001,2015,6,2,6,596,384,980,361
0130-001,2015,6,2,7,1785,829,2614,980
0130-001,2015,6,2,8,2074,1561,3635,2614
0130-001,2015,6,2,9,2165,1775,3940,3635
0130-001,2015,6,2,10,1819,1865,3684,3940
0130-001,2015,6,2,11,1892,1705,3597,3684
0130-001,2015,6,2,12,1705,1564,3269,3597
0130-001,2015,6,2,13,1476,1451,2927,3269
0130-001,2015,6,2,14,1667,1740,3407,2927
0130-001,2015,6,2,15,1887,1709,3596,3407
0130-001,2015,6,2,16,1756,1762,3518,3596
0130-001,2015,6,2,17,1691,1869,3560,3518
0130-001,2015,6,2,18,1741,2267,4008,3560
0130-001,2015,6,2,19,1631,2455,4086,4008
0130-001,2015,6,2,20,1286,1689,2975,4086
0130-001,2015,6,2,21,1153,1705,2858,2975
0130-001,2015,6,2,22,1077,1268,2345,2858
0130-001,2015,6,2,23,866,686,1552,2345
0130-001,2015,6,2,24,518,423,941,1552
0130-001,2015,6,3,1,342,265,607,941
0130-001,2015,6,3,2,211,169,380,607
0130-001,2015,6,3,3,217,169,386,380
0130-001,2015,6,3,4,131,115,246,386
0130-001,2015,6,3,5,177,144,321,246
0130-001,2015,6,3,6,627,362,989,321
0130-001,2015,6,3,7,1776,809,2585,989
0130-001,2015,6,3,8,2025,1621,3646,2585
0130-001,2015,6,3,9,2091,1838,3929,3646
0130-001,2015,6,3,10,1738,1783,3521,3929
0130-001,2015,6,3,11,1790,1602,3392,3521
0130-001,2015,6,3,12,1625,1506,3131,3392
0130-001,2015,6,3,13,1340,1442,2782,3131
0130-001,2015,6,3,14,1627,1607,3234,2782
0130-001,2015,6,3,15,1721,1682,3403,3234
0130-001,2015,6,3,16,1707,1695,3402,3403
0130-001,2015,6,3,17,1553,1849,3402,3402
0130-001,2015,6,3,18,1661,2314,3975,3402
0130-001,2015,6,3,19,1638,2531,4169,3975
0130-001,2015,6,3,20,1284,1966,3250,4169
0130-001,2015,6,3,21,1133,1518,2651,3250
0130-001,2015,6,3,22,1255,1241,2496,2651
0130-001,2015,6,3,23,879,761,1640,2496
0130-001,2015,6,3,24,551,411,962,1640
0130-001,2015,6,4,1,389,325,714,962
0130-001,2015,6,4,2,262,195,457,714
0130-001,2015,6,4,3,175,148,323,457
0130-001,2015,6,4,4,153,122,275,323
0130-001,2015,6,4,5,189,138,327,275
0130-001,2015,6,4,6,580,362,942,327
0130-001,2015,6,4,7,1749,798,2547,942
0130-001,2015,6,4,8,1990,1629,3619,2547
0130-001,2015,6,4,9,2125,1879,4004,3619
0130-001,2015,6,4,10,1932,1678,3610,4004
0130-001,2015,6,4,11,1850,1728,3578,3610
0130-001,2015,6,4,12,1730,1623,3353,3578
0130-001,2015,6,4,13,1369,1309,2678,3353
0130-001,2015,6,4,14,1514,1596,3110,2678
0130-001,2015,6,4,15,1462,1598,3060,3110
0130-001,2015,6,4,16,1796,1648,3444,3060
0130-001,2015,6,4,17,1596,1859,3455,3444
0130-001,2015,6,4,18,1661,2294,3955,3455
0130-001,2015,6,4,19,1609,2432,4041,3955
0130-001,2015,6,4,20,1273,1789,3062,4041
0130-001,2015,6,4,21,1091,1559,2650,3062
0130-001,2015,6,4,22,1104,1133,2237,2650
0130-001,2015,6,4,23,819,712,1531,2237
0130-001,2015,6,4,24,454,427,881,1531
0130-001,2015,6,5,1,345,318,663,881
0130-001,2015,6,5,2,226,146,372,663
0130-001,2015,6,5,3,157,132,289,372
0130-001,2015,6,5,4,138,124,262,289
0130-001,2015,6,5,5,137,179,316,262
0130-001,2015,6,5,6,622,341,963,316
0130-001,2015,6,5,7,1868,745,2613,963
0130-001,2015,6,5,8,2138,1537,3675,2613
0130-001,2015,6,5,9,2218,1898,4116,3675
0130-001,2015,6,5,10,2060,1576,3636,4116
0130-001,2015,6,5,11,1740,1724,3464,3636
0130-001,2015,6,5,12,1616,1596,3212,3464
0130-001,2015,6,5,13,1375,1514,2889,3212
0130-001,2015,6,5,14,1611,1719,3330,2889
0130-001,2015,6,5,15,1774,1678,3452,3330
0130-001,2015,6,5,16,1681,1785,3466,3452
0130-001,2015,6,5,17,1711,1804,3515,3466
0130-001,2015,6,5,18,1859,2306,4165,3515
0130-001,2015,6,5,19,1890,2569,4459,4165
0130-001,2015,6,5,20,1562,1970,3532,4459
0130-001,2015,6,5,21,1182,1582,2764,3532
0130-001,2015,6,5,22,1097,1276,2373,2764
0130-001,2015,6,5,23,906,796,1702,2373
0130-001,2015,6,5,24,643,522,1165,1702
0130-001,2015,6,6,1,411,351,762,1165
0130-001,2015,6,6,2,322,261,583,762
0130-001,2015,6,6,3,249,230,479,583
0130-001,2015,6,6,4,213,177,390,479
0130-001,2015,6,6,5,256,175,431,390
0130-001,2015,6,6,6,563,388,951,431
0130-001,2015,6,6,7,1064,587,1651,951
0130-001,2015,6,6,8,1501,919,2420,1651
0130-001,2015,6,6,9,1347,1321,2668,2420
0130-001,2015,6,6,10,1338,1553,2891,2668
0130-001,2015,6,6,11,1489,1777,3266,2891
0130-001,2015,6,6,12,1476,1767,3243,3266
0130-001,2015,6,6,13,1311,1535,2846,3243
0130-001,2015,6,6,14,1386,1588,2974,2846
0130-001,2015,6,6,15,1404,1598,3002,2974
0130-001,2015,6,6,16,1424,1365,2789,3002
0130-001,2015,6,6,17,1433,1549,2982,2789
0130-001,2015,6,6,18,1496,1904,3400,2982
0130-001,2015,6,6,19,1458,1617,3075,3400
0130-001,2015,6,6,20,1110,1153,2263,3075
0130-001,2015,6,6,21,952,954,1906,2263
0130-001,2015,6,6,22,952,757,1709,1906
0130-001,2015,6,6,23,759,507,1266,1709
0130-001,2015,6,6,24,507,372,879,1266
0130-001,2015,6,7,1,351,251,602,879
0130-001,2015,6,7,2,238,185,423,602
0130-001,2015,6,7,3,189,126,315,423
0130-001,2015,6,7,4,206,109,315,315
0130-001,2015,6,7,5,187,119,306,315
0130-001,2015,6,7,6,403,185,588,306
0130-001,2015,6,7,7,612,353,965,588
0130-001,2015,6,7,8,667,528,1195,965
0130-001,2015,6,7,9,738,737,1475,1195
0130-001,2015,6,7,10,774,975,1749,1475
0130-001,2015,6,7,11,997,1153,2150,1749
0130-001,2015,6,7,12,921,1040,1961,2150
0130-001,2015,6,7,13,1095,1057,2152,1961
0130-001,2015,6,7,14,1195,1166,2361,2152
0130-001,2015,6,7,15,1206,1217,2423,2361
0130-001,2015,6,7,16,1329,1313,2642,2423
0130-001,2015,6,7,17,1670,1282,2952,2642
0130-001,2015,6,7,18,1494,1211,2705,2952
0130-001,2015,6,7,19,1467,1159,2626,2705
0130-001,2015,6,7,20,1213,1057,2270,2626
0130-001,2015,6,7,21,1073,913,1986,2270
0130-001,2015,6,7,22,954,647,1601,1986
0130-001,2015,6,7,23,705,415,1120,1601
0130-001,2015,6,7,24,402,288,690,1120
0130-001,2015,6,8,1,267,204,471,690
0130-001,2015,6,8,2,160,101,261,471
0130-001,2015,6,8,3,117,128,245,261
0130-001,2015,6,8,4,120,78,198,245
0130-001,2015,6,8,5,213,136,349,198
0130-001,2015,6,8,6,629,341,970,349
0130-001,2015,6,8,7,1930,827,2757,970
0130-001,2015,6,8,8,1956,1695,3651,2757
0130-001,2015,6,8,9,2176,1812,3988,3651
0130-001,2015,6,8,10,1681,1564,3245,3988
0130-001,2015,6,8,11,1738,1531,3269,3245
0130-001,2015,6,8,12,1636,1557,3193,3269
0130-001,2015,6,8,13,1386,1416,2802,3193
0130-001,2015,6,8,14,1680,1691,3371,2802
0130-001,2015,6,8,15,1776,1617,3393,3371
0130-001,2015,6,8,16,1663,1801,3464,3393
0130-001,2015,6,8,17,1654,1842,3496,3464
0130-001,2015,6,8,18,1783,2165,3948,3496
0130-001,2015,6,8,19,1656,2447,4103,3948
0130-001,2015,6,8,20,1271,1687,2958,4103
0130-001,2015,6,8,21,1073,1664,2737,2958
0130-001,2015,6,8,22,1070,1194,2264,2737
0130-001,2015,6,8,23,801,673,1474,2264
0130-001,2015,6,8,24,502,421,923,1474
0130-001,2015,6,9,1,347,267,614,923
0130-001,2015,6,9,2,209,171,380,614
0130-001,2015,6,9,3,162,146,308,380
0130-001,2015,6,9,4,137,122,259,308
0130-001,2015,6,9,5,197,189,386,259
0130-001,2015,6,9,6,560,316,876,386
0130-001,2015,6,9,7,1747,792,2539,876
0130-001,2015,6,9,8,1932,1609,3541,2539
0130-001,2015,6,9,9,2162,1822,3984,3541
0130-001,2015,6,9,10,1872,1685,3557,3984
0130-001,2015,6,9,11,1778,1541,3319,3557
0130-001,2015,6,9,12,1603,1549,3152,3319
0130-001,2015,6,9,13,1331,1406,2737,3152
0130-001,2015,6,9,14,1616,1685,3301,2737
0130-001,2015,6,9,15,1696,1561,3257,3301
0130-001,2015,6,9,16,1625,1713,3338,3257
0130-001,2015,6,9,17,1627,1845,3472,3338
0130-001,2015,6,9,18,1723,2302,4025,3472
0130-001,2015,6,9,19,1727,2422,4149,4025
0130-001,2015,6,9,20,1320,1740,3060,4149
0130-001,2015,6,9,21,1111,1701,2812,3060
0130-001,2015,6,9,22,1135,1248,2383,2812
0130-001,2015,6,9,23,788,733,1521,2383
0130-001,2015,6,9,24,500,437,937,1521
0130-001,2015,6,10,1,400,300,700,937
0130-001,2015,6,10,2,251,171,422,700
0130-001,2015,6,10,3,160,144,304,422
0130-001,2015,6,10,4,133,128,261,304
0130-001,2015,6,10,5,207,173,380,261
0130-001,2015,6,10,6,598,364,962,380
0130-001,2015,6,10,7,1829,800,2629,962
0130-001,2015,6,10,8,2065,1699,3764,2629
0130-001,2015,6,10,9,2057,1658,3715,3764
0130-001,2015,6,10,10,1843,1734,3577,3715
0130-001,2015,6,10,11,1836,1605,3441,3577
0130-001,2015,6,10,12,1642,1486,3128,3441
0130-001,2015,6,10,13,1375,1371,2746,3128
0130-001,2015,6,10,14,1671,1588,3259,2746
0130-001,2015,6,10,15,1723,1652,3375,3259
0130-001,2015,6,10,16,1749,1703,3452,3375
0130-001,2015,6,10,17,1740,1947,3687,3452
0130-001,2015,6,10,18,1794,2402,4196,3687
0130-001,2015,6,10,19,1798,2559,4357,4196
0130-001,2015,6,10,20,1384,1842,3226,4357
0130-001,2015,6,10,21,1160,1613,2773,3226
0130-001,2015,6,10,22,1226,1120,2346,2773
0130-001,2015,6,10,23,872,743,1615,2346
0130-001,2015,6,10,24,581,411,992,1615
0130-001,2015,6,11,1,462,310,772,992
0130-001,2015,6,11,2,311,232,543,772
0130-001,2015,6,11,3,222,144,366,543
0130-001,2015,6,11,4,173,128,301,366
0130-001,2015,6,11,5,191,210,401,301
0130-001,2015,6,11,6,652,376,1028,401
0130-001,2015,6,11,7,1816,764,2580,1028
0130-001,2015,6,11,8,1956,1613,3569,2580
0130-001,2015,6,11,9,2055,1742,3797,3569
0130-001,2015,6,11,10,2015,1719,3734,3797
0130-001,2015,6,11,11,1819,1703,3522,3734
0130-001,2015,6,11,12,1645,1592,3237,3522
0130-001,2015,6,11,13,1355,1358,2713,3237
0130-001,2015,6,11,14,1700,1719,3419,2713
0130-001,2015,6,11,15,1801,1865,3666,3419
0130-001,2015,6,11,16,1761,1711,3472,3666
0130-001,2015,6,11,17,1723,1916,3639,3472
0130-001,2015,6,11,18,1734,2267,4001,3639
0130-001,2015,6,11,19,1640,2379,4019,4001
0130-001,2015,6,11,20,1280,1738,3018,4019
0130-001,2015,6,11,21,1122,1734,2856,3018
0130-001,2015,6,11,22,1106,1178,2284,2856
0130-001,2015,6,11,23,852,739,1591,2284
0130-001,2015,6,11,24,659,394,1053,1591
0130-001,2015,6,12,1,408,300,708,1053
0130-001,2015,6,12,2,292,197,489,708
0130-001,2015,6,12,3,205,165,370,489
0130-001,2015,6,12,4,176,146,322,370
0130-001,2015,6,12,5,197,181,378,322
0130-001,2015,6,12,6,618,333,951,378
0130-001,2015,6,12,7,1857,741,2598,951
0130-001,2015,6,12,8,2124,1574,3698,2598
0130-001,2015,6,12,9,2164,1925,4089,3698
0130-001,2015,6,12,10,2023,1633,3656,4089
0130-001,2015,6,12,11,1823,1687,3510,3656
0130-001,2015,6,12,12,1744,1687,3431,3510
0130-001,2015,6,12,13,1485,1404,2889,3431
0130-001,2015,6,12,14,1742,1719,3461,2889
0130-001,2015,6,12,15,1892,1756,3648,3461
0130-001,2015,6,12,16,1759,1828,3587,3648
0130-001,2015,6,12,17,1804,1937,3741,3587
0130-001,2015,6,12,18,1952,2349,4301,3741
0130-001,2015,6,12,19,1962,2579,4541,4301
0130-001,2015,6,12,20,1602,2162,3764,4541
0130-001,2015,6,12,21,1288,1771,3059,3764
0130-001,2015,6,12,22,1210,1371,2581,3059
0130-001,2015,6,12,23,992,807,1799,2581
0130-001,2015,6,12,24,672,563,1235,1799
0130-001,2015,6,13,1,476,442,918,1235
0130-001,2015,6,13,2,362,236,598,918
0130-001,2015,6,13,3,256,214,470,598
0130-001,2015,6,13,4,204,148,352,470
0130-001,2015,6,13,5,274,212,486,352
0130-001,2015,6,13,6,616,347,963,486
0130-001,2015,6,13,7,1186,677,1863,963
0130-001,2015,6,13,8,1710,1129,2839,1863
0130-001,2015,6,13,9,1644,1623,3267,2839
0130-001,2015,6,13,10,1640,1791,3431,3267
0130-001,2015,6,13,11,1695,1746,3441,3431
0130-001,2015,6,13,12,1720,1752,3472,3441
0130-001,2015,6,13,13,1574,1744,3318,3472
0130-001,2015,6,13,14,1629,1639,3268,3318
0130-001,2015,6,13,15,1662,1801,3463,3268
0130-001,2015,6,13,16,1688,1668,3356,3463
0130-001,2015,6,13,17,1743,1656,3399,3356
0130-001,2015,6,13,18,1790,2030,3820,3399
0130-001,2015,6,13,19,1732,1801,3533,3820
0130-001,2015,6,13,20,1310,1262,2572,3533
0130-001,2015,6,13,21,1116,1079,2195,2572
0130-001,2015,6,13,22,1076,876,1952,2195
0130-001,2015,6,13,23,812,577,1389,1952
0130-001,2015,6,13,24,424,435,859,1389
0130-001,2015,6,14,1,422,294,716,859
0130-001,2015,6,14,2,327,216,543,716
0130-001,2015,6,14,3,218,189,407,543
0130-001,2015,6,14,4,197,140,337,407
0130-001,2015,6,14,5,220,130,350,337
0130-001,2015,6,14,6,394,232,626,350
0130-001,2015,6,14,7,694,398,1092,626
0130-001,2015,6,14,8,754,544,1298,1092
0130-001,2015,6,14,9,838,768,1606,1298
0130-001,2015,6,14,10,869,967,1836,1606
0130-001,2015,6,14,11,1135,1182,2317,1836
0130-001,2015,6,14,12,1079,1106,2185,2317
0130-001,2015,6,14,13,1153,1151,2304,2185
0130-001,2015,6,14,14,1201,1252,2453,2304
0130-001,2015,6,14,15,1292,1268,2560,2453
0130-001,2015,6,14,16,1364,1291,2655,2560
0130-001,2015,6,14,17,1396,1294,2690,2655
0130-001,2015,6,14,18,1525,1285,2810,2690
0130-001,2015,6,14,19,1337,1209,2546,2810
0130-001,2015,6,14,20,1046,1051,2097,2546
0130-001,2015,6,14,21,981,870,1851,2097
0130-001,2015,6,14,22,817,718,1535,1851
0130-001,2015,6,14,23,629,454,1083,1535
0130-001,2015,6,14,24,389,323,712,1083
0130-001,2015,6,15,1,246,202,448,712
0130-001,2015,6,15,2,175,128,303,448
0130-001,2015,6,15,3,99,97,196,303
0130-001,2015,6,15,4,95,64,159,196
0130-001,2015,6,15,5,204,181,385,159
0130-001,2015,6,15,6,630,355,985,385
0130-001,2015,6,15,7,1883,825,2708,985
0130-001,2015,6,15,8,1939,1691,3630,2708
0130-001,2015,6,15,9,2144,1894,4038,3630
0130-001,2015,6,15,10,1750,1627,3377,4038
0130-001,2015,6,15,11,1796,1699,3495,3377
0130-001,2015,6,15,12,1612,1545,3157,3495
0130-001,2015,6,15,13,1445,1481,2926,3157
0130-001,2015,6,15,14,1478,1629,3107,2926
0130-001,2015,6,15,15,1839,1697,3536,3107
0130-001,2015,6,15,16,1785,1781,3566,3536
0130-001,2015,6,15,17,1652,1886,3538,3566
0130-001,2015,6,15,18,1779,2279,4058,3538
0130-001,2015,6,15,19,1785,2415,4200,4058
0130-001,2015,6,15,20,1353,1738,3091,4200
0130-001,2015,6,15,21,1113,1639,2752,3091
0130-001,2015,6,15,22,1033,1241,2274,2752
0130-001,2015,6,15,23,814,690,1504,2274
0130-001,2015,6,15,24,496,483,979,1504
0130-001,2015,6,16,1,351,284,635,979
0130-001,2015,6,16,2,284,193,477,635
0130-001,2015,6,16,3,184,144,328,477
0130-001,2015,6,16,4,131,132,263,328
0130-001,2015,6,16,5,227,179,406,263
0130-001,2015,6,16,6,641,320,961,406
0130-001,2015,6,16,7,1845,813,2658,961
0130-001,2015,6,16,8,1981,1629,3610,2658
0130-001,2015,6,16,9,2108,1857,3965,3610
0130-001,2015,6,16,10,1919,1672,3591,3965
0130-001,2015,6,16,11,1794,1619,3413,3591
0130-001,2015,6,16,12,1582,1639,3221,3413
0130-001,2015,6,16,13,1378,1434,2812,3221
0130-001,2015,6,16,14,1111,1607,2718,2812
0130-001,2015,6,16,15,1253,1572,2825,2718
0130-001,2015,6,16,16,1683,1627,3310,2825
0130-001,2015,6,16,17,1770,1812,3582,3310
0130-001,2015,6,16,18,1678,2384,4062,3582
0130-001,2015,6,16,19,1663,2469,4132,4062
0130-001,2015,6,16,20,1309,1738,3047,4132
0130-001,2015,6,16,21,1155,1678,2833,3047
0130-001,2015,6,16,22,1044,1248,2292,2833
0130-001,2015,6,16,23,917,684,1601,2292
0130-001,2015,6,16,24,590,444,1034,1601
0130-001,2015,6,17,1,349,376,725,1034
0130-001,2015,6,17,2,262,177,439,725
0130-001,2015,6,17,3,182,122,304,439
0130-001,2015,6,17,4,142,148,290,304
0130-001,2015,6,17,5,211,179,390,290
0130-001,2015,6,17,6,638,374,1012,390
0130-001,2015,6,17,7,1790,805,2595,1012
0130-001,2015,6,17,8,2006,1656,3662,2595
0130-001,2015,6,17,9,2146,1968,4114,3662
0130-001,2015,6,17,10,1823,1691,3514,4114
0130-001,2015,6,17,11,1789,1574,3363,3514
0130-001,2015,6,17,12,1545,1496,3041,3363
0130-001,2015,6,17,13,1404,1492,2896,3041
0130-001,2015,6,17,14,1656,1553,3209,2896
0130-001,2015,6,17,15,1749,1701,3450,3209
0130-001,2015,6,17,16,1776,1775,3551,3450
0130-001,2015,6,17,17,1646,1914,3560,3551
0130-001,2015,6,17,18,1728,1984,3712,3560
0130-001,2015,6,17,19,1718,2422,4140,3712
0130-001,2015,6,17,20,1334,2035,3369,4140
0130-001,2015,6,17,21,1146,1406,2552,3369
0130-001,2015,6,17,22,1240,1127,2367,2552
0130-001,2015,6,17,23,876,692,1568,2367
0130-001,2015,6,17,24,578,431,1009,1568
0130-001,2015,6,18,1,356,310,666,1009
0130-001,2015,6,18,2,304,169,473,666
0130-001,2015,6,18,3,191,117,308,473
0130-001,2015,6,18,4,168,101,269,308
0130-001,2015,6,18,5,190,128,318,269
0130-001,2015,6,18,6,616,368,984,318
0130-001,2015,6,18,7,1782,786,2568,984
0130-001,2015,6,18,8,1973,1652,3625,2568
0130-001,2015,6,18,9,2090,1826,3916,3625
0130-001,2015,6,18,10,1974,1619,3593,3916
0130-001,2015,6,18,11,1834,1494,3328,3593
0130-001,2015,6,18,12,1688,1481,3169,3328
0130-001,2015,6,18,13,1246,1434,2680,3169
0130-001,2015,6,18,14,1545,1586,3131,2680
0130-001,2015,6,18,15,1736,1689,3425,3131
0130-001,2015,6,18,16,1665,1406,3071,3425
0130-001,2015,6,18,17,1545,1607,3152,3071
0130-001,2015,6,18,18,1779,2343,4122,3152
0130-001,2015,6,18,19,1689,2422,4111,4122
0130-001,2015,6,18,20,1324,1779,3103,4111
0130-001,2015,6,18,21,1106,1674,2780,3103
0130-001,2015,6,18,22,1111,1293,2404,2780
0130-001,2015,6,18,23,944,751,1695,2404
0130-001,2015,6,18,24,585,524,1109,1695
0130-001,2015,6,19,1,407,339,746,1109
0130-001,2015,6,19,2,231,165,396,746
0130-001,2015,6,19,3,184,146,330,396
0130-001,2015,6,19,4,175,128,303,330
0130-001,2015,6,19,5,244,202,446,303
0130-001,2015,6,19,6,656,386,1042,446
0130-001,2015,6,19,7,1908,800,2708,1042
0130-001,2015,6,19,8,1999,1639,3638,2708
0130-001,2015,6,19,9,2204,1884,4088,3638
0130-001,2015,6,19,10,1872,1617,3489,4088
0130-001,2015,6,19,11,1903,1605,3508,3489
0130-001,2015,6,19,12,1680,1633,3313,3508
0130-001,2015,6,19,13,1430,1635,3065,3313
0130-001,2015,6,19,14,1676,1742,3418,3065
0130-001,2015,6,19,15,1833,1687,3520,3418
0130-001,2015,6,19,16,1720,1838,3558,3520
0130-001,2015,6,19,17,1758,1894,3652,3558
0130-001,2015,6,19,18,1794,2283,4077,3652
0130-001,2015,6,19,19,1852,2650,4502,4077
0130-001,2015,6,19,20,1583,2177,3760,4502
0130-001,2015,6,19,21,1317,1744,3061,3760
0130-001,2015,6,19,22,1329,1346,2675,3061
0130-001,2015,6,19,23,966,747,1713,2675
0130-001,2015,6,19,24,625,573,1198,1713
0130-001,2015,6,20,1,543,417,960,1198
0130-001,2015,6,20,2,371,269,640,960
0130-001,2015,6,20,3,278,208,486,640
0130-001,2015,6,20,4,233,185,418,486
0130-001,2015,6,20,5,267,236,503,418
0130-001,2015,6,20,6,594,364,958,503
0130-001,2015,6,20,7,1037,618,1655,958
0130-001,2015,6,20,8,1489,1038,2527,1655
0130-001,2015,6,20,9,1484,1574,3058,2527
0130-001,2015,6,20,10,1418,1633,3051,3058
0130-001,2015,6,20,11,1592,1925,3517,3051
0130-001,2015,6,20,12,1598,1762,3360,3517
0130-001,2015,6,20,13,1442,1830,3272,3360
0130-001,2015,6,20,14,1508,1689,3197,3272
0130-001,2015,6,20,15,1533,1744,3277,3197
0130-001,2015,6,20,16,1556,1855,3411,3277
0130-001,2015,6,20,17,1588,1535,3123,3411
0130-001,2015,6,20,18,1643,1789,3432,3123
0130-001,2015,6,20,19,1595,1602,3197,3432
0130-001,2015,6,20,20,1210,1168,2378,3197
0130-001,2015,6,20,21,1034,897,1931,2378
0130-001,2015,6,20,22,1014,780,1794,1931
0130-001,2015,6,20,23,796,489,1285,1794
0130-001,2015,6,20,24,502,376,878,1285
0130-001,2015,6,21,1,371,320,691,878
0130-001,2015,6,21,2,315,210,525,691
0130-001,2015,6,21,3,224,167,391,525
0130-001,2015,6,21,4,251,138,389,391
0130-001,2015,6,21,5,275,144,419,389
0130-001,2015,6,21,6,458,257,715,419
0130-001,2015,6,21,7,670,376,1046,715
0130-001,2015,6,21,8,772,647,1419,1046
0130-001,2015,6,21,9,788,883,1671,1419
0130-001,2015,6,21,10,822,1086,1908,1671
0130-001,2015,6,21,11,1066,1223,2289,1908
0130-001,2015,6,21,12,1000,1209,2209,2289
0130-001,2015,6,21,13,1124,1344,2468,2209
0130-001,2015,6,21,14,1251,1389,2640,2468
0130-001,2015,6,21,15,1364,1391,2755,2640
0130-001,2015,6,21,16,1500,1377,2877,2755
0130-001,2015,6,21,17,1476,1391,2867,2877
0130-001,2015,6,21,18,1638,1446,3084,2867
0130-001,2015,6,21,19,1616,1305,2921,3084
0130-001,2015,6,21,20,1277,1139,2416,2921
0130-001,2015,6,21,21,1226,1047,2273,2416
0130-001,2015,6,21,22,1095,798,1893,2273
0130-001,2015,6,21,23,785,454,1239,1893
0130-001,2015,6,21,24,449,353,802,1239
0130-001,2015,6,22,1,305,228,533,802
0130-001,2015,6,22,2,207,126,333,533
0130-001,2015,6,22,3,118,76,194,333
0130-001,2015,6,22,4,120,97,217,194
0130-001,2015,6,22,5,235,142,377,217
0130-001,2015,6,22,6,718,421,1139,377
0130-001,2015,6,22,7,1897,850,2747,1139
0130-001,2015,6,22,8,2028,1682,3710,2747
0130-001,2015,6,22,9,2148,1810,3958,3710
0130-001,2015,6,22,10,1747,1703,3450,3958
0130-001,2015,6,22,11,1816,1664,3480,3450
0130-001,2015,6,22,12,1620,1543,3163,3480
0130-001,2015,6,22,13,1378,1434,2812,3163
0130-001,2015,6,22,14,1511,1561,3072,2812
0130-001,2015,6,22,15,1665,1713,3378,3072
0130-001,2015,6,22,16,1464,1834,3298,3378
0130-001,2015,6,22,17,1667,1888,3555,3298
0130-001,2015,6,22,18,1709,2318,4027,3555
0130-001,2015,6,22,19,1769,2320,4089,4027
0130-001,2015,6,22,20,1171,1808,2979,4089
0130-001,2015,6,22,21,1028,1641,2669,2979
0130-001,2015,6,22,22,1062,1258,2320,2669
0130-001,2015,6,22,23,799,651,1450,2320
0130-001,2015,6,22,24,514,431,945,1450
0130-001,2015,6,23,1,315,310,625,945
0130-001,2015,6,23,2,197,179,376,625
0130-001,2015,6,23,3,162,144,306,376
0130-001,2015,6,23,4,137,128,265,306
0130-001,2015,6,23,5,233,181,414,265
0130-001,2015,6,23,6,674,384,1058,414
0130-001,2015,6,23,7,1814,727,2541,1058
0130-001,2015,6,23,8,1950,1658,3608,2541
0130-001,2015,6,23,9,2085,1949,4034,3608
0130-001,2015,6,23,10,1839,1715,3554,4034
0130-001,2015,6,23,11,1876,1605,3481,3554
0130-001,2015,6,23,12,1618,1457,3075,3481
0130-001,2015,6,23,13,1409,1369,2778,3075
0130-001,2015,6,23,14,1504,1623,3127,2778
0130-001,2015,6,23,15,1761,1746,3507,3127
0130-001,2015,6,23,16,1712,1664,3376,3507
0130-001,2015,6,23,17,1732,1941,3673,3376
0130-001,2015,6,23,18,1676,2277,3953,3673
0130-001,2015,6,23,19,1770,2443,4213,3953
0130-001,2015,6,23,20,1259,1812,3071,4213
0130-001,2015,6,23,21,1144,1687,2831,3071
0130-001,2015,6,23,22,1193,1319,2512,2831
0130-001,2015,6,23,23,859,747,1606,2512
0130-001,2015,6,23,24,543,450,993,1606
0130-001,2015,6,24,1,393,304,697,993
0130-001,2015,6,24,2,240,160,400,697
0130-001,2015,6,24,3,175,136,311,400
0130-001,2015,6,24,4,148,148,296,311
0130-001,2015,6,24,5,244,204,448,296
0130-001,2015,6,24,6,685,378,1063,448
0130-001,2015,6,24,7,1910,788,2698,1063
0130-001,2015,6,24,8,2052,1629,3681,2698
0130-001,2015,6,24,9,2179,1929,4108,3681
0130-001,2015,6,24,10,1919,1703,3622,4108
0130-001,2015,6,24,11,1810,1625,3435,3622
0130-001,2015,6,24,12,1656,1600,3256,3435
0130-001,2015,6,24,13,1444,1404,2848,3256
0130-001,2015,6,24,14,1767,1607,3374,2848
0130-001,2015,6,24,15,1832,1724,3556,3374
0130-001,2015,6,24,16,1823,1801,3624,3556
0130-001,2015,6,24,17,1693,1888,3581,3624
0130-001,2015,6,24,18,1761,2222,3983,3581
0130-001,2015,6,24,19,1758,2502,4260,3983
0130-001,2015,6,24,20,1359,1646,3005,4260
0130-001,2015,6,24,21,1153,1518,2671,3005
0130-001,2015,6,24,22,1233,1151,2384,2671
0130-001,2015,6,24,23,874,663,1537,2384
0130-001,2015,6,24,24,580,444,1024,1537
0130-001,2015,6,25,1,364,323,687,1024
0130-001,2015,6,25,2,318,206,524,687
0130-001,2015,6,25,3,249,146,395,524
0130-001,2015,6,25,4,204,103,307,395
0130-001,2015,6,25,5,240,204,444,307
0130-001,2015,6,25,6,670,419,1089,444
0130-001,2015,6,25,7,1901,807,2708,1089
0130-001,2015,6,25,8,2068,1629,3697,2708
0130-001,2015,6,25,9,2184,1873,4057,3697
0130-001,2015,6,25,10,2536,1617,4153,4057
0130-001,2015,6,25,11,1799,1676,3475,4153
0130-001,2015,6,25,12,1603,1555,3158,3475
0130-001,2015,6,25,13,1513,1459,2972,3158
0130-001,2015,6,25,14,1725,1668,3393,2972
0130-001,2015,6,25,15,1754,1631,3385,3393
0130-001,2015,6,25,16,1790,1785,3575,3385
0130-001,2015,6,25,17,1634,1801,3435,3575
0130-001,2015,6,25,18,1756,1883,3639,3435
0130-001,2015,6,25,19,1664,1857,3521,3639
0130-001,2015,6,25,20,1302,1613,2915,3521
0130-001,2015,6,25,21,1114,1350,2464,2915
0130-001,2015,6,25,22,1108,1069,2177,2464
0130-001,2015,6,25,23,898,528,1426,2177
0130-001,2015,6,25,24,622,298,920,1426
0130-001,2015,6,26,1,408,236,644,920
0130-001,2015,6,26,2,262,167,429,644
0130-001,2015,6,26,3,194,146,340,429
0130-001,2015,6,26,4,176,124,300,340
0130-001,2015,6,26,5,220,175,395,300
0130-001,2015,6,26,6,637,199,836,395
0130-001,2015,6,26,7,1882,505,2387,836
0130-001,2015,6,26,8,2062,1572,3634,2387
0130-001,2015,6,26,9,2184,1814,3998,3634
0130-001,2015,6,26,10,1948,1720,3668,3998
0130-001,2015,6,26,11,1863,1650,3513,3668
0130-001,2015,6,26,12,1712,1748,3460,3513
0130-001,2015,6,26,13,1458,1568,3026,3460
0130-001,2015,6,26,14,1709,1734,3443,3026
0130-001,2015,6,26,15,1862,1808,3670,3443
0130-001,2015,6,26,16,1740,1830,3570,3670
0130-001,2015,6,26,17,1781,1953,3734,3570
0130-001,2015,6,26,18,1873,2345,4218,3734
0130-001,2015,6,26,19,1907,2649,4556,4218
0130-001,2015,6,26,20,1545,2138,3683,4556
0130-001,2015,6,26,21,1313,1680,2993,3683
0130-001,2015,6,26,22,1345,1266,2611,2993
0130-001,2015,6,26,23,949,821,1770,2611
0130-001,2015,6,26,24,659,552,1211,1770
0130-001,2015,6,27,1,296,435,731,1211
0130-001,2015,6,27,2,160,290,450,731
0130-001,2015,6,27,3,138,193,331,450
0130-001,2015,6,27,4,137,156,293,331
0130-001,2015,6,27,5,162,208,370,293
0130-001,2015,6,27,6,605,388,993,370
0130-001,2015,6,27,7,1112,686,1798,993
0130-001,2015,6,27,8,1600,1145,2745,1798
0130-001,2015,6,27,9,1564,1629,3193,2745
0130-001,2015,6,27,10,1529,1707,3236,3193
0130-001,2015,6,27,11,1644,1943,3587,3236
0130-001,2015,6,27,12,1659,1863,3522,3587
0130-001,2015,6,27,13,1508,1933,3441,3522
0130-001,2015,6,27,14,1568,1703,3271,3441
0130-001,2015,6,27,15,1598,1886,3484,3271
0130-001,2015,6,27,16,1622,1621,3243,3484
0130-001,2015,6,27,17,1666,1853,3519,3243
0130-001,2015,6,27,18,1716,2177,3893,3519
0130-001,2015,6,27,19,1664,1949,3613,3893
0130-001,2015,6,27,20,1260,1354,2614,3613
0130-001,2015,6,27,21,1175,1153,2328,2614
0130-001,2015,6,27,22,1070,934,2004,2328
0130-001,2015,6,27,23,846,618,1464,2004
0130-001,2015,6,27,24,571,419,990,1464
0130-001,2015,6,28,1,422,335,757,990
0130-001,2015,6,28,2,271,238,509,757
0130-001,2015,6,28,3,229,163,392,509
0130-001,2015,6,28,4,195,165,360,392
0130-001,2015,6,28,5,217,181,398,360
0130-001,2015,6,28,6,360,288,648,398
0130-001,2015,6,28,7,594,444,1038,648
0130-001,2015,6,28,8,779,647,1426,1038
0130-001,2015,6,28,9,814,868,1682,1426
0130-001,2015,6,28,10,846,1084,1930,1682
0130-001,2015,6,28,11,1100,1205,2305,1930
0130-001,2015,6,28,12,1040,1184,2224,2305
0130-001,2015,6,28,13,1138,1301,2439,2224
0130-001,2015,6,28,14,1226,1352,2578,2439
0130-001,2015,6,28,15,1328,1399,2727,2578
0130-001,2015,6,28,16,1432,1350,2782,2727
0130-001,2015,6,28,17,1436,1239,2675,2782
0130-001,2015,6,28,18,1582,1401,2983,2675
0130-001,2015,6,28,19,1476,1274,2750,2983
0130-001,2015,6,28,20,1162,1075,2237,2750
0130-001,2015,6,28,21,1104,1012,2116,2237
0130-001,2015,6,28,22,956,839,1795,2116
0130-001,2015,6,28,23,707,528,1235,1795
0130-001,2015,6,28,24,419,325,744,1235
0130-001,2015,6,29,1,273,214,487,744
0130-001,2015,6,29,2,171,140,311,487
0130-001,2015,6,29,3,115,95,210,311
0130-001,2015,6,29,4,106,97,203,210
0130-001,2015,6,29,5,191,119,310,203
0130-001,2015,6,29,6,687,362,1049,310
0130-001,2015,6,29,7,1905,776,2681,1049
0130-001,2015,6,29,8,2003,1561,3564,2681
0130-001,2015,6,29,9,2135,1955,4090,3564
0130-001,2015,6,29,10,1903,1672,3575,4090
0130-001,2015,6,29,11,1872,1742,3614,3575
0130-001,2015,6,29,12,1703,1627,3330,3614
0130-001,2015,6,29,13,1286,1438,2724,3330
0130-001,2015,6,29,14,1843,1613,3456,2724
0130-001,2015,6,29,15,1908,1724,3632,3456
0130-001,2015,6,29,16,2014,1836,3850,3632
0130-001,2015,6,29,17,1723,1787,3510,3850
0130-001,2015,6,29,18,1821,2275,4096,3510
0130-001,2015,6,29,19,1798,2517,4315,4096
0130-001,2015,6,29,20,1353,1775,3128,4315
0130-001,2015,6,29,21,1062,1676,2738,3128
0130-001,2015,6,29,22,1144,1274,2418,2738
0130-001,2015,6,29,23,872,792,1664,2418
0130-001,2015,6,29,24,538,454,992,1664
0130-001,2015,6,30,1,340,271,611,992
0130-001,2015,6,30,2,217,187,404,611
0130-001,2015,6,30,3,211,130,341,404
0130-001,2015,6,30,4,175,140,315,341
0130-001,2015,6,30,5,264,150,414,315
0130-001,2015,6,30,6,629,345,974,414
0130-001,2015,6,30,7,1681,768,2449,974
0130-001,2015,6,30,8,2014,1639,3653,2449
0130-001,2015,6,30,9,2122,1892,4014,3653
0130-001,2015,6,30,10,1845,1678,3523,4014
0130-001,2015,6,30,11,1825,1693,3518,3523
0130-001,2015,6,30,12,1676,1590,3266,3518
0130-001,2015,6,30,13,1426,1500,2926,3266
0130-001,2015,6,30,14,1799,1717,3516,2926
0130-001,2015,6,30,15,1839,1744,3583,3516
0130-001,2015,6,30,16,1783,1793,3576,3583
0130-001,2015,6,30,17,1631,1775,3406,3576
0130-001,2015,6,30,18,1642,2310,3952,3406
0130-001,2015,6,30,19,1603,2366,3969,3952
0130-001,2015,6,30,20,1309,1717,3026,3969
0130-001,2015,6,30,21,1110,1639,2749,3026
0130-001,2015,6,30,22,1102,1237,2339,2749
0130-001,2015,6,30,23,865,761,1626,2339
0130-001,2015,6,30,24,578,460,1038,1626
0130-001,2015,7,1,1,437,333,770,1038
0130-001,2015,7,1,2,259,192,451,770
0130-001,2015,7,1,3,211,146,357,451
0130-001,2015,7,1,4,164,181,345,357
0130-001,2015,7,1,5,228,199,427,345
0130-001,2015,7,1,6,575,381,956,427
0130-001,2015,7,1,7,1795,828,2623,956
0130-001,2015,7,1,8,2086,1749,3835,2623
0130-001,2015,7,1,9,2147,2145,4292,3835
0130-001,2015,7,1,10,1915,1784,3699,4292
0130-001,2015,7,1,11,1856,1786,3642,3699
0130-001,2015,7,1,12,1809,1782,3591,3642
0130-001,2015,7,1,13,1598,1527,3125,3591
0130-001,2015,7,1,14,1866,1826,3692,3125
0130-001,2015,7,1,15,1860,1826,3686,3692
0130-001,2015,7,1,16,1938,1934,3872,3686
0130-001,2015,7,1,17,1611,1901,3512,3872
0130-001,2015,7,1,18,1756,2460,4216,3512
0130-001,2015,7,1,19,1868,2679,4547,4216
0130-001,2015,7,1,20,1397,2035,3432,4547
0130-001,2015,7,1,21,1230,1637,2867,3432
0130-001,2015,7,1,22,1209,1247,2456,2867
0130-001,2015,7,1,23,894,824,1718,2456
0130-001,2015,7,1,24,522,487,1009,1718
0130-001,2015,7,2,1,388,364,752,1009
0130-001,2015,7,2,2,257,216,473,752
0130-001,2015,7,2,3,179,161,340,473
0130-001,2015,7,2,4,148,152,300,340
0130-001,2015,7,2,5,196,166,362,300
0130-001,2015,7,2,6,594,412,1006,362
0130-001,2015,7,2,7,1849,840,2689,1006
0130-001,2015,7,2,8,2127,1742,3869,2689
0130-001,2015,7,2,9,2227,1949,4176,3869
0130-001,2015,7,2,10,1839,1800,3639,4176
0130-001,2015,7,2,11,1826,1846,3672,3639
0130-001,2015,7,2,12,1767,1771,3538,3672
0130-001,2015,7,2,13,1573,1648,3221,3538
0130-001,2015,7,2,14,1991,1859,3850,3221
0130-001,2015,7,2,15,1942,1846,3788,3850
0130-001,2015,7,2,16,2006,1934,3940,3788
0130-001,2015,7,2,17,1737,1996,3733,3940
0130-001,2015,7,2,18,1780,2555,4335,3733
0130-001,2015,7,2,19,1894,2701,4595,4335
0130-001,2015,7,2,20,1441,1923,3364,4595
0130-001,2015,7,2,21,1240,1960,3200,3364
0130-001,2015,7,2,22,1202,1445,2647,3200
0130-001,2015,7,2,23,978,842,1820,2647
0130-001,2015,7,2,24,638,483,1121,1820
0130-001,2015,7,3,1,424,390,814,1121
0130-001,2015,7,3,2,257,199,456,814
0130-001,2015,7,3,3,186,150,336,456
0130-001,2015,7,3,4,154,172,326,336
0130-001,2015,7,3,5,207,188,395,326
0130-001,2015,7,3,6,606,430,1036,395
0130-001,2015,7,3,7,1887,721,2608,1036
0130-001,2015,7,3,8,2126,1685,3811,2608
0130-001,2015,7,3,9,2266,2115,4381,3811
0130-001,2015,7,3,10,1968,1824,3792,4381
0130-001,2015,7,3,11,2038,1883,3921,3792
0130-001,2015,7,3,12,1818,1901,3719,3921
0130-001,2015,7,3,13,1704,1731,3435,3719
0130-001,2015,7,3,14,1905,1839,3744,3435
0130-001,2015,7,3,15,1981,1958,3939,3744
0130-001,2015,7,3,16,2063,1956,4019,3939
0130-001,2015,7,3,17,1989,2218,4207,4019
0130-001,2015,7,3,18,2029,2540,4569,4207
0130-001,2015,7,3,19,2042,2850,4892,4569
0130-001,2015,7,3,20,1699,2348,4047,4892
0130-001,2015,7,3,21,1393,1910,3303,4047
0130-001,2015,7,3,22,1397,1505,2902,3303
0130-001,2015,7,3,23,1074,994,2068,2902
0130-001,2015,7,3,24,758,597,1355,2068
0130-001,2015,7,4,1,509,461,970,1355
0130-001,2015,7,4,2,376,289,665,970
0130-001,2015,7,4,3,295,210,505,665
0130-001,2015,7,4,4,222,212,434,505
0130-001,2015,7,4,5,270,232,502,434
0130-001,2015,7,4,6,668,395,1063,502
0130-001,2015,7,4,7,1145,637,1782,1063
0130-001,2015,7,4,8,1704,1135,2839,1782
0130-001,2015,7,4,9,1824,1729,3553,2839
0130-001,2015,7,4,10,1826,2015,3841,3553
0130-001,2015,7,4,11,1809,2331,4140,3841
0130-001,2015,7,4,12,1919,2163,4082,4140
0130-001,2015,7,4,13,1769,2198,3967,4082
0130-001,2015,7,4,14,1879,2009,3888,3967
0130-001,2015,7,4,15,1847,2029,3876,3888
0130-001,2015,7,4,16,2036,2029,4065,3876
0130-001,2015,7,4,17,1907,1923,3830,4065
0130-001,2015,7,4,18,1936,2326,4262,3830
0130-001,2015,7,4,19,1814,2000,3814,4262
0130-001,2015,7,4,20,1444,1507,2951,3814
0130-001,2015,7,4,21,1228,1370,2598,2951
0130-001,2015,7,4,22,1179,1071,2250,2598
0130-001,2015,7,4,23,902,705,1607,2250
0130-001,2015,7,4,24,623,516,1139,1607
0130-001,2015,7,5,1,403,324,727,1139
0130-001,2015,7,5,2,317,241,558,727
0130-001,2015,7,5,3,249,185,434,558
0130-001,2015,7,5,4,173,150,323,434
0130-001,2015,7,5,5,253,163,416,323
0130-001,2015,7,5,6,418,265,683,416
0130-001,2015,7,5,7,670,434,1104,683
0130-001,2015,7,5,8,765,604,1369,1104
0130-001,2015,7,5,9,839,1035,1874,1369
0130-001,2015,7,5,10,1010,1225,2235,1874
0130-001,2015,7,5,11,1154,1474,2628,2235
0130-001,2015,7,5,12,1148,1665,2813,2628
0130-001,2015,7,5,13,1350,1667,3017,2813
0130-001,2015,7,5,14,1507,1573,3080,3017
0130-001,2015,7,5,15,1515,1604,3119,3080
0130-001,2015,7,5,16,1791,1709,3500,3119
0130-001,2015,7,5,17,1784,1538,3322,3500
0130-001,2015,7,5,18,1780,1659,3439,3322
0130-001,2015,7,5,19,1710,1441,3151,3439
0130-001,2015,7,5,20,1264,1300,2564,3151
0130-001,2015,7,5,21,1175,1139,2314,2564
0130-001,2015,7,5,22,1109,877,1986,2314
0130-001,2015,7,5,23,794,566,1360,1986
0130-001,2015,7,5,24,458,344,802,1360
0130-001,2015,7,6,1,327,196,523,802
0130-001,2015,7,6,2,150,122,272,523
0130-001,2015,7,6,3,145,86,231,272
0130-001,2015,7,6,4,111,91,202,231
0130-001,2015,7,6,5,188,163,351,202
0130-001,2015,7,6,6,648,423,1071,351
0130-001,2015,7,6,7,1907,857,2764,1071
0130-001,2015,7,6,8,2069,1692,3761,2764
0130-001,2015,7,6,9,2244,2154,4398,3761
0130-001,2015,7,6,10,2010,1888,3898,4398
0130-001,2015,7,6,11,1902,1874,3776,3898
0130-001,2015,7,6,12,1820,1705,3525,3776
0130-001,2015,7,6,13,1471,1500,2971,3525
0130-001,2015,7,6,14,1932,1736,3668,2971
0130-001,2015,7,6,15,1839,1819,3658,3668
0130-001,2015,7,6,16,1928,1894,3822,3658
0130-001,2015,7,6,17,1811,2007,3818,3822
0130-001,2015,7,6,18,1816,2460,4276,3818
0130-001,2015,7,6,19,1737,2498,4235,4276
0130-001,2015,7,6,20,1342,1985,3327,4235
0130-001,2015,7,6,21,1224,1817,3041,3327
0130-001,2015,7,6,22,1052,1320,2372,3041
0130-001,2015,7,6,23,888,815,1703,2372
0130-001,2015,7,6,24,501,445,946,1703
0130-001,2015,7,7,1,355,296,651,946
0130-001,2015,7,7,2,234,199,433,651
0130-001,2015,7,7,3,156,177,333,433
0130-001,2015,7,7,4,150,152,302,333
0130-001,2015,7,7,5,205,216,421,302
0130-001,2015,7,7,6,598,373,971,421
0130-001,2015,7,7,7,1871,782,2653,971
0130-001,2015,7,7,8,2211,1584,3795,2653
0130-001,2015,7,7,9,2314,2128,4442,3795
0130-001,2015,7,7,10,1905,1859,3764,4442
0130-001,2015,7,7,11,1877,1791,3668,3764
0130-001,2015,7,7,12,1737,1650,3387,3668
0130-001,2015,7,7,13,1507,1551,3058,3387
0130-001,2015,7,7,14,1845,1773,3618,3058
0130-001,2015,7,7,15,1890,1833,3723,3618
0130-001,2015,7,7,16,1771,1976,3747,3723
0130-001,2015,7,7,17,1788,1932,3720,3747
0130-001,2015,7,7,18,1769,2520,4289,3720
0130-001,2015,7,7,19,1666,2480,4146,4289
0130-001,2015,7,7,20,1284,1855,3139,4146
0130-001,2015,7,7,21,1127,1786,2913,3139
0130-001,2015,7,7,22,1148,1260,2408,2913
0130-001,2015,7,7,23,555,762,1317,2408
0130-001,2015,7,7,24,416,531,947,1317
0130-001,2015,7,8,1,408,331,739,947
0130-001,2015,7,8,2,232,106,338,739
0130-001,2015,7,8,3,190,82,272,338
0130-001,2015,7,8,4,158,100,258,272
0130-001,2015,7,8,5,211,177,388,258
0130-001,2015,7,8,6,562,337,899,388
0130-001,2015,7,8,7,1807,692,2499,899
0130-001,2015,7,8,8,2086,1650,3736,2499
0130-001,2015,7,8,9,2142,2097,4239,3736
0130-001,2015,7,8,10,1900,1742,3642,4239
0130-001,2015,7,8,11,1830,1692,3522,3642
0130-001,2015,7,8,12,1732,1663,3395,3522
0130-001,2015,7,8,13,1521,1511,3032,3395
0130-001,2015,7,8,14,1816,1630,3446,3032
0130-001,2015,7,8,15,1846,1795,3641,3446
0130-001,2015,7,8,16,1880,1760,3640,3641
0130-001,2015,7,8,17,1794,1780,3574,3640
0130-001,2015,7,8,18,1757,2322,4079,3574
0130-001,2015,7,8,19,1835,2415,4250,4079
0130-001,2015,7,8,20,1456,1511,2967,4250
0130-001,2015,7,8,21,1258,1593,2851,2967
0130-001,2015,7,8,22,1205,1196,2401,2851
0130-001,2015,7,8,23,913,668,1581,2401
0130-001,2015,7,8,24,572,434,1006,1581
0130-001,2015,7,9,1,403,315,718,1006
0130-001,2015,7,9,2,251,214,465,718
0130-001,2015,7,9,3,160,177,337,465
0130-001,2015,7,9,4,156,170,326,337
0130-001,2015,7,9,5,190,181,371,326
0130-001,2015,7,9,6,608,234,842,371
0130-001,2015,7,9,7,1841,771,2612,842
0130-001,2015,7,9,8,2109,1623,3732,2612
0130-001,2015,7,9,9,2194,1923,4117,3732
0130-001,2015,7,9,10,1833,1802,3635,4117
0130-001,2015,7,9,11,1847,1674,3521,3635
0130-001,2015,7,9,12,1727,1601,3328,3521
0130-001,2015,7,9,13,1579,1483,3062,3328
0130-001,2015,7,9,14,1828,1652,3480,3062
0130-001,2015,7,9,15,1492,1784,3276,3480
0130-001,2015,7,9,16,1816,1925,3741,3276
0130-001,2015,7,9,17,1780,1848,3628,3741
0130-001,2015,7,9,18,1767,2564,4331,3628
0130-001,2015,7,9,19,1831,2546,4377,4331
0130-001,2015,7,9,20,1475,1868,3343,4377
0130-001,2015,7,9,21,1272,1762,3034,3343
0130-001,2015,7,9,22,1255,1342,2597,3034
0130-001,2015,7,9,23,976,817,1793,2597
0130-001,2015,7,9,24,659,474,1133,1793
0130-001,2015,7,10,1,393,344,737,1133
0130-001,2015,7,10,2,255,249,504,737
0130-001,2015,7,10,3,181,201,382,504
0130-001,2015,7,10,4,145,117,262,382
0130-001,2015,7,10,5,175,192,367,262
0130-001,2015,7,10,6,634,401,1035,367
0130-001,2015,7,10,7,1814,723,2537,1035
0130-001,2015,7,10,8,2071,1698,3769,2537
0130-001,2015,7,10,9,2092,2178,4270,3769
0130-001,2015,7,10,10,1881,1813,3694,4270
0130-001,2015,7,10,11,1913,1841,3754,3694
0130-001,2015,7,10,12,1710,1674,3384,3754
0130-001,2015,7,10,13,1581,1740,3321,3384
0130-001,2015,7,10,14,1807,1826,3633,3321
0130-001,2015,7,10,15,1922,1844,3766,3633
0130-001,2015,7,10,16,1902,2090,3992,3766
0130-001,2015,7,10,17,1885,2044,3929,3992
0130-001,2015,7,10,18,1735,2540,4275,3929
0130-001,2015,7,10,19,2021,2745,4766,4275
0130-001,2015,7,10,20,1951,2370,4321,4766
0130-001,2015,7,10,21,1422,1976,3398,4321
0130-001,2015,7,10,22,1285,1394,2679,3398
0130-001,2015,7,10,23,1129,877,2006,2679
0130-001,2015,7,10,24,735,648,1383,2006
0130-001,2015,7,11,1,539,437,976,1383
0130-001,2015,7,11,2,399,342,741,976
0130-001,2015,7,11,3,266,252,518,741
0130-001,2015,7,11,4,257,227,484,518
0130-001,2015,7,11,5,274,302,576,484
0130-001,2015,7,11,6,623,392,1015,576
0130-001,2015,7,11,7,1302,668,1970,1015
0130-001,2015,7,11,8,1685,1196,2881,1970
0130-001,2015,7,11,9,1858,1734,3592,2881
0130-001,2015,7,11,10,1879,1923,3802,3592
0130-001,2015,7,11,11,1726,2154,3880,3802
0130-001,2015,7,11,12,1789,2192,3981,3880
0130-001,2015,7,11,13,1638,2051,3689,3981
0130-001,2015,7,11,14,1724,1956,3680,3689
0130-001,2015,7,11,15,1722,1958,3680,3680
0130-001,2015,7,11,16,1829,1808,3637,3680
0130-001,2015,7,11,17,1786,1863,3649,3637
0130-001,2015,7,11,18,1826,2339,4165,3649
0130-001,2015,7,11,19,1739,2115,3854,4165
0130-001,2015,7,11,20,1352,1505,2857,3854
0130-001,2015,7,11,21,1202,1300,2502,2857
0130-001,2015,7,11,22,1124,947,2071,2502
0130-001,2015,7,11,23,874,703,1577,2071
0130-001,2015,7,11,24,597,419,1016,1577
0130-001,2015,7,12,1,412,259,671,1016
0130-001,2015,7,12,2,294,172,466,671
0130-001,2015,7,12,3,239,144,383,466
0130-001,2015,7,12,4,184,115,299,383
0130-001,2015,7,12,5,235,112,347,299
0130-001,2015,7,12,6,389,201,590,347
0130-001,2015,7,12,7,632,313,945,590
0130-001,2015,7,12,8,772,568,1340,945
0130-001,2015,7,12,9,826,912,1738,1340
0130-001,2015,7,12,10,928,1036,1964,1738
0130-001,2015,7,12,11,1127,1230,2357,1964
0130-001,2015,7,12,12,1207,1262,2469,2357
0130-001,2015,7,12,13,1515,1469,2984,2469
0130-001,2015,7,12,14,1706,1550,3256,2984
0130-001,2015,7,12,15,1541,1626,3167,3256
0130-001,2015,7,12,16,1739,1602,3341,3167
0130-001,2015,7,12,17,1883,1520,3403,3341
0130-001,2015,7,12,18,1839,1536,3375,3403
0130-001,2015,7,12,19,1685,1376,3061,3375
0130-001,2015,7,12,20,1348,1193,2541,3061
0130-001,2015,7,12,21,1429,1119,2548,2541
0130-001,2015,7,12,22,1207,822,2029,2548
0130-001,2015,7,12,23,944,554,1498,2029
0130-001,2015,7,12,24,784,343,1127,1498
0130-001,2015,7,13,1,300,93,393,1127
0130-001,2015,7,13,2,160,75,235,393
0130-001,2015,7,13,3,130,53,183,235
0130-001,2015,7,13,4,108,49,157,183
0130-001,2015,7,13,5,190,100,290,157
0130-001,2015,7,13,6,668,183,851,290
0130-001,2015,7,13,7,1906,743,2649,851
0130-001,2015,7,13,8,2036,1683,3719,2649
0130-001,2015,7,13,9,2190,2148,4338,3719
0130-001,2015,7,13,10,1956,1904,3860,4338
0130-001,2015,7,13,11,1887,1839,3726,3860
0130-001,2015,7,13,12,1762,1724,3486,3726
0130-001,2015,7,13,13,1520,1536,3056,3486
0130-001,2015,7,13,14,1888,1742,3630,3056
0130-001,2015,7,13,15,1874,1860,3734,3630
0130-001,2015,7,13,16,1971,1866,3837,3734
0130-001,2015,7,13,17,1767,1989,3756,3837
0130-001,2015,7,13,18,1818,2429,4247,3756
0130-001,2015,7,13,19,1768,2436,4204,4247
0130-001,2015,7,13,20,1348,1769,3117,4204
0130-001,2015,7,13,21,1143,1709,2852,3117
0130-001,2015,7,13,22,1098,1326,2424,2852
0130-001,2015,7,13,23,880,727,1607,2424
0130-001,2015,7,13,24,520,487,1007,1607
0130-001,2015,7,14,1,348,309,657,1007
0130-001,2015,7,14,2,226,188,414,657
0130-001,2015,7,14,3,184,152,336,414
0130-001,2015,7,14,4,162,124,286,336
0130-001,2015,7,14,5,234,192,426,286
0130-001,2015,7,14,6,614,324,938,426
0130-001,2015,7,14,7,1776,789,2565,938
0130-001,2015,7,14,8,2112,1751,3863,2565
0130-001,2015,7,14,9,2218,2130,4348,3863
0130-001,2015,7,14,10,1875,1908,3783,4348
0130-001,2015,7,14,11,1851,1714,3565,3783
0130-001,2015,7,14,12,1706,1817,3523,3565
0130-001,2015,7,14,13,1466,1557,3023,3523
0130-001,2015,7,14,14,1822,1672,3494,3023
0130-001,2015,7,14,15,1864,1712,3576,3494
0130-001,2015,7,14,16,1777,1919,3696,3576
0130-001,2015,7,14,17,1710,2040,3750,3696
0130-001,2015,7,14,18,1706,2480,4186,3750
0130-001,2015,7,14,19,1634,2676,4310,4186
0130-001,2015,7,14,20,1296,1936,3232,4310
0130-001,2015,7,14,21,1236,1784,3020,3232
0130-001,2015,7,14,22,1205,1427,2632,3020
0130-001,2015,7,14,23,936,853,1789,2632
0130-001,2015,7,14,24,515,538,1053,1789
0130-001,2015,7,15,1,380,320,700,1053
0130-001,2015,7,15,2,204,192,396,700
0130-001,2015,7,15,3,167,174,341,396
0130-001,2015,7,15,4,150,141,291,341
0130-001,2015,7,15,5,192,148,340,291
0130-001,2015,7,15,6,547,362,909,340
0130-001,2015,7,15,7,1818,791,2609,909
0130-001,2015,7,15,8,2084,1747,3831,2609
0130-001,2015,7,15,9,2134,2121,4255,3831
0130-001,2015,7,15,10,1883,1839,3722,4255
0130-001,2015,7,15,11,1843,1817,3660,3722
0130-001,2015,7,15,12,1770,1804,3574,3660
0130-001,2015,7,15,13,1560,1555,3115,3574
0130-001,2015,7,15,14,1841,1742,3583,3115
0130-001,2015,7,15,15,1853,1932,3785,3583
0130-001,2015,7,15,16,1909,1956,3865,3785
0130-001,2015,7,15,17,1702,2104,3806,3865
0130-001,2015,7,15,18,1759,2685,4444,3806
0130-001,2015,7,15,19,1801,2734,4535,4444
0130-001,2015,7,15,20,1513,2126,3639,4535
0130-001,2015,7,15,21,1285,1676,2961,3639
0130-001,2015,7,15,22,1202,1322,2524,2961
0130-001,2015,7,15,23,932,710,1642,2524
0130-001,2015,7,15,24,621,536,1157,1642
0130-001,2015,7,16,1,418,348,766,1157
0130-001,2015,7,16,2,245,236,481,766
0130-001,2015,7,16,3,141,172,313,481
0130-001,2015,7,16,4,164,181,345,313
0130-001,2015,7,16,5,185,212,397,345
0130-001,2015,7,16,6,621,397,1018,397
0130-001,2015,7,16,7,1831,798,2629,1018
0130-001,2015,7,16,8,2088,1778,3866,2629
0130-001,2015,7,16,9,2159,2112,4271,3866
0130-001,2015,7,16,10,1826,1908,3734,4271
0130-001,2015,7,16,11,1868,1723,3591,3734
0130-001,2015,7,16,12,1687,1707,3394,3591
0130-001,2015,7,16,13,1585,1540,3125,3394
0130-001,2015,7,16,14,1665,1731,3396,3125
0130-001,2015,7,16,15,1418,1767,3185,3396
0130-001,2015,7,16,16,1627,1960,3587,3185
0130-001,2015,7,16,17,1822,1910,3732,3587
0130-001,2015,7,16,18,1752,2504,4256,3732
0130-001,2015,7,16,19,1769,2668,4437,4256
0130-001,2015,7,16,20,1507,2033,3540,4437
0130-001,2015,7,16,21,1304,1846,3150,3540
0130-001,2015,7,16,22,1306,1320,2626,3150
0130-001,2015,7,16,23,974,800,1774,2626
0130-001,2015,7,16,24,680,577,1257,1774
0130-001,2015,7,17,1,437,355,792,1257
0130-001,2015,7,17,2,272,214,486,792
0130-001,2015,7,17,3,207,179,386,486
0130-001,2015,7,17,4,166,185,351,386
0130-001,2015,7,17,5,213,203,416,351
0130-001,2015,7,17,6,604,392,996,416
0130-001,2015,7,17,7,1833,787,2620,996
0130-001,2015,7,17,8,2112,1674,3786,2620
0130-001,2015,7,17,9,2212,2068,4280,3786
0130-001,2015,7,17,10,1949,2033,3982,4280
0130-001,2015,7,17,11,1921,1848,3769,3982
0130-001,2015,7,17,12,1898,1802,3700,3769
0130-001,2015,7,17,13,1670,1771,3441,3700
0130-001,2015,7,17,14,1951,1936,3887,3441
0130-001,2015,7,17,15,1997,2055,4052,3887
0130-001,2015,7,17,16,1923,2110,4033,4052
0130-001,2015,7,17,17,1991,2084,4075,4033
0130-001,2015,7,17,18,2023,2577,4600,4075
0130-001,2015,7,17,19,1970,2774,4744,4600
0130-001,2015,7,17,20,1752,2339,4091,4744
0130-001,2015,7,17,21,1443,1855,3298,4091
0130-001,2015,7,17,22,1257,1331,2588,3298
0130-001,2015,7,17,23,1082,822,1904,2588
0130-001,2015,7,17,24,750,562,1312,1904
0130-001,2015,7,18,1,537,439,976,1312
0130-001,2015,7,18,2,378,302,680,976
0130-001,2015,7,18,3,232,216,448,680
0130-001,2015,7,18,4,245,216,461,448
0130-001,2015,7,18,5,264,238,502,461
0130-001,2015,7,18,6,572,406,978,502
0130-001,2015,7,18,7,1192,701,1893,978
0130-001,2015,7,18,8,1756,1258,3014,1893
0130-001,2015,7,18,9,1883,1615,3498,3014
0130-001,2015,7,18,10,1723,1824,3547,3498
0130-001,2015,7,18,11,1794,2044,3838,3547
0130-001,2015,7,18,12,1833,2081,3914,3838
0130-001,2015,7,18,13,1942,2278,4220,3914
0130-001,2015,7,18,14,1757,2205,3962,4220
0130-001,2015,7,18,15,1828,1967,3795,3962
0130-001,2015,7,18,16,1854,1885,3739,3795
0130-001,2015,7,18,17,1894,1919,3813,3739
0130-001,2015,7,18,18,1976,2271,4247,3813
0130-001,2015,7,18,19,1776,2000,3776,4247
0130-001,2015,7,18,20,1398,1403,2801,3776
0130-001,2015,7,18,21,1215,1218,2433,2801
0130-001,2015,7,18,22,1152,644,1796,2433
0130-001,2015,7,18,23,888,344,1232,1796
0130-001,2015,7,18,24,610,265,875,1232
0130-001,2015,7,19,1,408,194,602,875
0130-001,2015,7,19,2,306,102,408,602
0130-001,2015,7,19,3,244,102,346,408
0130-001,2015,7,19,4,178,80,258,346
0130-001,2015,7,19,5,244,62,306,258
0130-001,2015,7,19,6,404,137,541,306
0130-001,2015,7,19,7,651,192,843,541
0130-001,2015,7,19,8,768,531,1299,843
0130-001,2015,7,19,9,832,789,1621,1299
0130-001,2015,7,19,10,969,846,1815,1621
0130-001,2015,7,19,11,1140,985,2125,1815
0130-001,2015,7,19,12,1178,859,2037,2125
0130-001,2015,7,19,13,1432,1271,2703,2037
0130-001,2015,7,19,14,1606,1527,3133,2703
0130-001,2015,7,19,15,1528,1649,3177,3133
0130-001,2015,7,19,16,1765,1494,3259,3177
0130-001,2015,7,19,17,1834,1502,3336,3259
0130-001,2015,7,19,18,1810,1414,3224,3336
0130-001,2015,7,19,19,1698,1311,3009,3224
0130-001,2015,7,19,20,1306,1086,2392,3009
0130-001,2015,7,19,21,1429,1099,2528,2392
0130-001,2015,7,19,22,1162,767,1929,2528
0130-001,2015,7,19,23,854,542,1396,1929
0130-001,2015,7,19,24,621,342,963,1396
0130-001,2015,7,20,1,298,199,497,963
0130-001,2015,7,20,2,195,157,352,497
0130-001,2015,7,20,3,130,97,227,352
0130-001,2015,7,20,4,111,111,222,227
0130-001,2015,7,20,5,251,124,375,222
0130-001,2015,7,20,6,695,410,1105,375
0130-001,2015,7,20,7,1773,853,2626,1105
0130-001,2015,7,20,8,1854,1656,3510,2626
0130-001,2015,7,20,9,1978,2024,4002,3510
0130-001,2015,7,20,10,1745,1921,3666,4002
0130-001,2015,7,20,11,1729,1804,3533,3666
0130-001,2015,7,20,12,1666,1742,3408,3533
0130-001,2015,7,20,13,1496,1573,3069,3408
0130-001,2015,7,20,14,1846,1749,3595,3069
0130-001,2015,7,20,15,1894,1901,3795,3595
0130-001,2015,7,20,16,2180,1839,4019,3795
0130-001,2015,7,20,17,1917,1971,3888,4019
0130-001,2015,7,20,18,1814,2495,4309,3888
0130-001,2015,7,20,19,1737,2700,4437,4309
0130-001,2015,7,20,20,1524,1914,3438,4437
0130-001,2015,7,20,21,1433,1764,3197,3438
0130-001,2015,7,20,22,1194,1339,2533,3197
0130-001,2015,7,20,23,892,776,1668,2533
0130-001,2015,7,20,24,619,470,1089,1668
0130-001,2015,7,21,1,526,298,824,1089
0130-001,2015,7,21,2,327,192,519,824
0130-001,2015,7,21,3,221,137,358,519
0130-001,2015,7,21,4,156,161,317,358
0130-001,2015,7,21,5,220,181,401,317
0130-001,2015,7,21,6,606,336,942,401
0130-001,2015,7,21,7,1824,770,2594,942
0130-001,2015,7,21,8,2162,1692,3854,2594
0130-001,2015,7,21,9,2266,2044,4310,3854
0130-001,2015,7,21,10,1890,1840,3730,4310
0130-001,2015,7,21,11,1864,1877,3741,3730
0130-001,2015,7,21,12,1722,1919,3641,3741
0130-001,2015,7,21,13,1486,1582,3068,3641
0130-001,2015,7,21,14,1834,1789,3623,3068
0130-001,2015,7,21,15,1877,1861,3738,3623
0130-001,2015,7,21,16,1774,1901,3675,3738
0130-001,2015,7,21,17,1749,1938,3687,3675
0130-001,2015,7,21,18,1738,2306,4044,3687
0130-001,2015,7,21,19,1650,2656,4306,4044
0130-001,2015,7,21,20,1406,1861,3267,4306
0130-001,2015,7,21,21,1268,1764,3032,3267
0130-001,2015,7,21,22,1213,1251,2464,3032
0130-001,2015,7,21,23,961,732,1693,2464
0130-001,2015,7,21,24,537,489,1026,1693
0130-001,2015,7,22,1,395,307,702,1026
0130-001,2015,7,22,2,240,234,474,702
0130-001,2015,7,22,3,177,190,367,474
0130-001,2015,7,22,4,147,170,317,367
0130-001,2015,7,22,5,188,194,382,317
0130-001,2015,7,22,6,547,359,906,382
0130-001,2015,7,22,7,1812,725,2537,906
0130-001,2015,7,22,8,2085,1634,3719,2537
0130-001,2015,7,22,9,2138,2064,4202,3719
0130-001,2015,7,22,10,1892,1883,3775,4202
0130-001,2015,7,22,11,1836,1738,3574,3775
0130-001,2015,7,22,12,1751,1685,3436,3574
0130-001,2015,7,22,13,1540,1698,3238,3436
0130-001,2015,7,22,14,1828,1773,3601,3238
0130-001,2015,7,22,15,1850,1921,3771,3601
0130-001,2015,7,22,16,1894,1932,3826,3771
0130-001,2015,7,22,17,1748,2000,3748,3826
0130-001,2015,7,22,18,1794,2493,4287,3748
0130-001,2015,7,22,19,1791,2756,4547,4287
0130-001,2015,7,22,20,1507,2046,3553,4547
0130-001,2015,7,22,21,1287,1718,3005,3553
0130-001,2015,7,22,22,1221,1313,2534,3005
0130-001,2015,7,22,23,921,773,1694,2534
0130-001,2015,7,22,24,630,538,1168,1694
0130-001,2015,7,23,1,412,412,824,1168
0130-001,2015,7,23,2,245,282,527,824
0130-001,2015,7,23,3,171,177,348,527
0130-001,2015,7,23,4,160,177,337,348
0130-001,2015,7,23,5,188,181,369,337
0130-001,2015,7,23,6,627,370,997,369
0130-001,2015,7,23,7,1782,789,2571,997
0130-001,2015,7,23,8,2114,1700,3814,2571
0130-001,2015,7,23,9,2125,2011,4136,3814
0130-001,2015,7,23,10,1858,1836,3694,4136
0130-001,2015,7,23,11,1888,1786,3674,3694
0130-001,2015,7,23,12,1718,1848,3566,3674
0130-001,2015,7,23,13,1515,1659,3174,3566
0130-001,2015,7,23,14,1572,1806,3378,3174
0130-001,2015,7,23,15,1344,1934,3278,3378
0130-001,2015,7,23,16,1573,1982,3555,3278
0130-001,2015,7,23,17,1792,1948,3740,3555
0130-001,2015,7,23,18,1824,2474,4298,3740
0130-001,2015,7,23,19,1773,2490,4263,4298
0130-001,2015,7,23,20,1482,1696,3178,4263
0130-001,2015,7,23,21,1300,1718,3018,3178
0130-001,2015,7,23,22,1272,1289,2561,3018
0130-001,2015,7,23,23,1006,727,1733,2561
0130-001,2015,7,23,24,657,481,1138,1733
0130-001,2015,7,24,1,415,344,759,1138
0130-001,2015,7,24,2,264,155,419,759
0130-001,2015,7,24,3,194,84,278,419
0130-001,2015,7,24,4,156,82,238,278
0130-001,2015,7,24,5,194,73,267,238
0130-001,2015,7,24,6,619,394,1013,267
0130-001,2015,7,24,7,1824,772,2596,1013
0130-001,2015,7,24,8,2092,1580,3672,2596
0130-001,2015,7,24,9,2152,2006,4158,3672
0130-001,2015,7,24,10,1915,1882,3797,4158
0130-001,2015,7,24,11,1917,1868,3785,3797
0130-001,2015,7,24,12,1804,1906,3710,3785
0130-001,2015,7,24,13,1626,1725,3351,3710
0130-001,2015,7,24,14,1879,1892,3771,3351
0130-001,2015,7,24,15,1960,1828,3788,3771
0130-001,2015,7,24,16,1912,2046,3958,3788
0130-001,2015,7,24,17,1938,1925,3863,3958
0130-001,2015,7,24,18,1879,2537,4416,3863
0130-001,2015,7,24,19,1996,2683,4679,4416
0130-001,2015,7,24,20,1852,1830,3682,4679
0130-001,2015,7,24,21,1432,1196,2628,3682
0130-001,2015,7,24,22,1271,1251,2522,2628
0130-001,2015,7,24,23,1106,795,1901,2522
0130-001,2015,7,24,24,742,527,1269,1901
0130-001,2015,7,25,1,538,401,939,1269
0130-001,2015,7,25,2,388,331,719,939
0130-001,2015,7,25,3,249,146,395,719
0130-001,2015,7,25,4,251,122,373,395
0130-001,2015,7,25,5,269,252,521,373
0130-001,2015,7,25,6,598,348,946,521
0130-001,2015,7,25,7,1247,621,1868,946
0130-001,2015,7,25,8,1720,1088,2808,1868
0130-001,2015,7,25,9,1870,1597,3467,2808
0130-001,2015,7,25,10,1801,1828,3629,3467
0130-001,2015,7,25,11,1760,1912,3672,3629
0130-001,2015,7,25,12,1811,2167,3978,3672
0130-001,2015,7,25,13,1790,2163,3953,3978
0130-001,2015,7,25,14,1740,2295,4035,3953
0130-001,2015,7,25,15,1775,2231,4006,4035
0130-001,2015,7,25,16,1833,1910,3743,4006
0130-001,2015,7,25,17,1845,2000,3845,3743
0130-001,2015,7,25,18,2028,2302,4330,3845
0130-001,2015,7,25,19,1864,1938,3802,4330
0130-001,2015,7,25,20,1477,1333,2810,3802
0130-001,2015,7,25,21,1296,1128,2424,2810
0130-001,2015,7,25,22,1110,879,1989,2424
0130-001,2015,7,25,23,816,617,1433,1989
0130-001,2015,7,25,24,549,463,1012,1433
0130-001,2015,7,26,1,410,342,752,1012
0130-001,2015,7,26,2,300,245,545,752
0130-001,2015,7,26,3,242,174,416,545
0130-001,2015,7,26,4,181,119,300,416
0130-001,2015,7,26,5,240,135,375,300
0130-001,2015,7,26,6,396,241,637,375
0130-001,2015,7,26,7,642,450,1092,637
0130-001,2015,7,26,8,770,668,1438,1092
0130-001,2015,7,26,9,829,912,1741,1438
0130-001,2015,7,26,10,948,1029,1977,1741
0130-001,2015,7,26,11,1134,1227,2361,1977
0130-001,2015,7,26,12,1192,1375,2567,2361
0130-001,2015,7,26,13,1474,1403,2877,2567
0130-001,2015,7,26,14,1656,1381,3037,2877
0130-001,2015,7,26,15,1534,1458,2992,3037
0130-001,2015,7,26,16,1752,1421,3173,2992
0130-001,2015,7,26,17,1858,1399,3257,3173
0130-001,2015,7,26,18,1614,1495,3109,3257
0130-001,2015,7,26,19,1456,1350,2806,3109
0130-001,2015,7,26,20,1255,1214,2469,2806
0130-001,2015,7,26,21,1427,1027,2454,2469
0130-001,2015,7,26,22,1116,848,1964,2454
0130-001,2015,7,26,23,765,606,1371,1964
0130-001,2015,7,26,24,458,359,817,1371
0130-001,2015,7,27,1,295,219,514,817
0130-001,2015,7,27,2,230,174,404,514
0130-001,2015,7,27,3,131,124,255,404
0130-001,2015,7,27,4,93,91,184,255
0130-001,2015,7,27,5,126,166,292,184
0130-001,2015,7,27,6,317,386,703,292
0130-001,2015,7,27,7,1640,754,2394,703
0130-001,2015,7,27,8,1673,1610,3283,2394
0130-001,2015,7,27,9,1765,2011,3776,3283
0130-001,2015,7,27,10,1534,1861,3395,3776
0130-001,2015,7,27,11,1571,1881,3452,3395
0130-001,2015,7,27,12,1571,2013,3584,3452
0130-001,2015,7,27,13,1473,1795,3268,3584
0130-001,2015,7,27,14,1805,1747,3552,3268
0130-001,2015,7,27,15,1839,1954,3793,3552
0130-001,2015,7,27,16,1930,1934,3864,3793
0130-001,2015,7,27,17,1769,1910,3679,3864
0130-001,2015,7,27,18,1822,2379,4201,3679
0130-001,2015,7,27,19,1752,2594,4346,4201
0130-001,2015,7,27,20,1488,1901,3389,4346
0130-001,2015,7,27,21,1287,1780,3067,3389
0130-001,2015,7,27,22,1183,1348,2531,3067
0130-001,2015,7,27,23,862,798,1660,2531
0130-001,2015,7,27,24,515,503,1018,1660
0130-001,2015,7,28,1,372,260,632,1018
0130-001,2015,7,28,2,268,194,462,632
0130-001,2015,7,28,3,186,203,389,462
0130-001,2015,7,28,4,128,161,289,389
0130-001,2015,7,28,5,481,188,669,289
0130-001,2015,7,28,6,1279,348,1627,669
0130-001,2015,7,28,7,1868,751,2619,1627
0130-001,2015,7,28,8,2055,1634,3689,2619
0130-001,2015,7,28,9,2060,1958,4018,3689
0130-001,2015,7,28,10,1924,1771,3695,4018
0130-001,2015,7,28,11,1892,1852,3744,3695
0130-001,2015,7,28,12,1704,1844,3548,3744
0130-001,2015,7,28,13,1465,1815,3280,3548
0130-001,2015,7,28,14,1727,1778,3505,3280
0130-001,2015,7,28,15,1921,1868,3789,3505
0130-001,2015,7,28,16,1972,1991,3963,3789
0130-001,2015,7,28,17,1896,1980,3876,3963
0130-001,2015,7,28,18,1881,2551,4432,3876
0130-001,2015,7,28,19,1824,2756,4580,4432
0130-001,2015,7,28,20,1427,2011,3438,4580
0130-001,2015,7,28,21,1298,1780,3078,3438
0130-001,2015,7,28,22,1219,1399,2618,3078
0130-001,2015,7,28,23,985,910,1895,2618
0130-001,2015,7,28,24,560,520,1080,1895
0130-001,2015,7,29,1,410,293,703,1080
0130-001,2015,7,29,2,276,210,486,703
0130-001,2015,7,29,3,186,161,347,486
0130-001,2015,7,29,4,141,152,293,347
0130-001,2015,7,29,5,183,161,344,293
0130-001,2015,7,29,6,545,350,895,344
0130-001,2015,7,29,7,1815,706,2521,895
0130-001,2015,7,29,8,2084,1514,3598,2521
0130-001,2015,7,29,9,2136,1876,4012,3598
0130-001,2015,7,29,10,1888,1780,3668,4012
0130-001,2015,7,29,11,1840,1680,3520,3668
0130-001,2015,7,29,12,1760,1758,3518,3520
0130-001,2015,7,29,13,1550,1668,3218,3518
0130-001,2015,7,29,14,1834,2084,3918,3218
0130-001,2015,7,29,15,1852,2097,3949,3918
0130-001,2015,7,29,16,1902,2101,4003,3949
0130-001,2015,7,29,17,1725,1868,3593,4003
0130-001,2015,7,29,18,1814,2414,4228,3593
0130-001,2015,7,29,19,1805,2535,4340,4228
0130-001,2015,7,29,20,1501,2081,3582,4340
0130-001,2015,7,29,21,1289,1736,3025,3582
0130-001,2015,7,29,22,1240,1238,2478,3025
0130-001,2015,7,29,23,907,756,1663,2478
0130-001,2015,7,29,24,638,487,1125,1663
0130-001,2015,7,30,1,405,318,723,1125
0130-001,2015,7,30,2,245,201,446,723
0130-001,2015,7,30,3,202,188,390,446
0130-001,2015,7,30,4,156,155,311,390
0130-001,2015,7,30,5,192,243,435,311
0130-001,2015,7,30,6,632,366,998,435
0130-001,2015,7,30,7,1733,780,2513,998
0130-001,2015,7,30,8,2130,1623,3753,2513
0130-001,2015,7,30,9,2101,1910,4011,3753
0130-001,2015,7,30,10,1888,1764,3652,4011
0130-001,2015,7,30,11,1909,1848,3757,3652
0130-001,2015,7,30,12,1748,1989,3737,3757
0130-001,2015,7,30,13,1443,1778,3221,3737
0130-001,2015,7,30,14,1477,1881,3358,3221
0130-001,2015,7,30,15,1647,2101,3748,3358
0130-001,2015,7,30,16,1520,2004,3524,3748
0130-001,2015,7,30,17,1761,1987,3748,3524
0130-001,2015,7,30,18,1896,2444,4340,3748
0130-001,2015,7,30,19,1775,2311,4086,4340
0130-001,2015,7,30,20,1458,2216,3674,4086
0130-001,2015,7,30,21,1296,1828,3124,3674
0130-001,2015,7,30,22,1238,1300,2538,3124
0130-001,2015,7,30,23,1036,778,1814,2538
0130-001,2015,7,30,24,632,593,1225,1814
0130-001,2015,7,31,1,435,296,731,1225
0130-001,2015,7,31,2,278,234,512,731
0130-001,2015,7,31,3,207,192,399,512
0130-001,2015,7,31,4,198,196,394,399
0130-001,2015,7,31,5,240,219,459,394
0130-001,2015,7,31,6,634,397,1031,459
0130-001,2015,7,31,7,1849,756,2605,1031
0130-001,2015,7,31,8,2131,1485,3616,2605
0130-001,2015,7,31,9,1972,1943,3915,3616
0130-001,2015,7,31,10,1869,1731,3600,3915
0130-001,2015,7,31,11,1904,1888,3792,3600
0130-001,2015,7,31,12,1767,2011,3778,3792
0130-001,2015,7,31,13,1568,1857,3425,3778
0130-001,2015,7,31,14,1752,2002,3754,3425
0130-001,2015,7,31,15,1852,2112,3964,3754
0130-001,2015,7,31,16,1974,2145,4119,3964
0130-001,2015,7,31,17,1852,2073,3925,4119
0130-001,2015,7,31,18,2059,2590,4649,3925
0130-001,2015,7,31,19,2008,2837,4845,4649
0130-001,2015,7,31,20,1699,2467,4166,4845
0130-001,2015,7,31,21,1420,1879,3299,4166
0130-001,2015,7,31,22,1236,1350,2586,3299
0130-001,2015,7,31,23,1078,1022,2100,2586
0130-001,2015,7,31,24,723,677,1400,2100
0130-001,2015,8,1,1,473,374,847,1400
0130-001,2015,8,1,2,348,285,633,847
0130-001,2015,8,1,3,262,194,456,633
0130-001,2015,8,1,4,234,238,472,456
0130-001,2015,8,1,5,293,192,485,472
0130-001,2015,8,1,6,569,410,979,485
0130-001,2015,8,1,7,1108,665,1773,979
0130-001,2015,8,1,8,1370,1315,2685,1773
0130-001,2015,8,1,9,1462,1859,3321,2685
0130-001,2015,8,1,10,1500,2394,3894,3321
0130-001,2015,8,1,11,1633,2485,4118,3894
0130-001,2015,8,1,12,1577,2553,4130,4118
0130-001,2015,8,1,13,1513,2487,4000,4130
0130-001,2015,8,1,14,1458,2517,3975,4000
0130-001,2015,8,1,15,1439,2286,3725,3975
0130-001,2015,8,1,16,1565,2303,3868,3725
0130-001,2015,8,1,17,1651,1912,3563,3868
0130-001,2015,8,1,18,1802,2065,3867,3563
0130-001,2015,8,1,19,1631,1840,3471,3867
0130-001,2015,8,1,20,1300,1156,2456,3471
0130-001,2015,8,1,21,1292,1075,2367,2456
0130-001,2015,8,1,22,1018,903,1921,2367
0130-001,2015,8,1,23,788,608,1396,1921
0130-001,2015,8,1,24,530,372,902,1396
0130-001,2015,8,2,1,409,298,707,902
0130-001,2015,8,2,2,303,236,539,707
0130-001,2015,8,2,3,243,107,350,539
0130-001,2015,8,2,4,180,124,304,350
0130-001,2015,8,2,5,242,145,387,304
0130-001,2015,8,2,6,400,173,573,387
0130-001,2015,8,2,7,646,393,1039,573
0130-001,2015,8,2,8,769,408,1177,1039
0130-001,2015,8,2,9,830,451,1281,1177
0130-001,2015,8,2,10,958,916,1874,1281
0130-001,2015,8,2,11,1137,1086,2223,1874
0130-001,2015,8,2,12,1185,1330,2515,2223
0130-001,2015,8,2,13,1453,1394,2847,2515
0130-001,2015,8,2,14,1631,1396,3027,2847
0130-001,2015,8,2,15,1531,1394,2925,3027
0130-001,2015,8,2,16,1795,1389,3184,2925
0130-001,2015,8,2,17,1761,1387,3148,3184
0130-001,2015,8,2,18,1675,1349,3024,3148
0130-001,2015,8,2,19,1601,1256,2857,3024
0130-001,2015,8,2,20,1478,1143,2621,2857
0130-001,2015,8,2,21,1524,988,2512,2621
0130-001,2015,8,2,22,1186,786,1972,2512
0130-001,2015,8,2,23,829,519,1348,1972
0130-001,2015,8,2,24,483,321,804,1348
0130-001,2015,8,3,1,313,230,543,804
0130-001,2015,8,3,2,208,175,383,543
0130-001,2015,8,3,3,127,85,212,383
0130-001,2015,8,3,4,129,100,229,212
0130-001,2015,8,3,5,153,132,285,229
0130-001,2015,8,3,6,499,294,793,285
0130-001,2015,8,3,7,1347,682,2029,793
0130-001,2015,8,3,8,1690,1383,3073,2029
0130-001,2015,8,3,9,1727,1742,3469,3073
0130-001,2015,8,3,10,1695,1661,3356,3469
0130-001,2015,8,3,11,1723,1748,3471,3356
0130-001,2015,8,3,12,1585,1755,3340,3471
0130-001,2015,8,3,13,1336,1619,2955,3340
0130-001,2015,8,3,14,1605,1700,3305,2955
0130-001,2015,8,3,15,1761,1833,3594,3305
0130-001,2015,8,3,16,1750,1816,3566,3594
0130-001,2015,8,3,17,1881,1610,3491,3566
0130-001,2015,8,3,18,1756,2143,3899,3491
0130-001,2015,8,3,19,1681,2160,3841,3899
0130-001,2015,8,3,20,1331,1608,2939,3841
0130-001,2015,8,3,21,1191,1254,2445,2939
0130-001,2015,8,3,22,1048,948,1996,2445
0130-001,2015,8,3,23,851,582,1433,1996
0130-001,2015,8,3,24,514,366,880,1433
0130-001,2015,8,4,1,350,321,671,880
0130-001,2015,8,4,2,225,162,387,671
0130-001,2015,8,4,3,161,170,331,387
0130-001,2015,8,4,4,155,122,277,331
0130-001,2015,8,4,5,164,207,371,277
0130-001,2015,8,4,6,532,313,845,371
0130-001,2015,8,4,7,1309,689,1998,845
0130-001,2015,8,4,8,1631,1279,2910,1998
0130-001,2015,8,4,9,1752,1666,3418,2910
0130-001,2015,8,4,10,1625,1561,3186,3418
0130-001,2015,8,4,11,1640,1674,3314,3186
0130-001,2015,8,4,12,1565,1595,3160,3314
0130-001,2015,8,4,13,1347,1585,2932,3160
0130-001,2015,8,4,14,1669,1608,3277,2932
0130-001,2015,8,4,15,1677,1655,3332,3277
0130-001,2015,8,4,16,1809,1846,3655,3332
0130-001,2015,8,4,17,1697,1770,3467,3655
0130-001,2015,8,4,18,1861,2228,4089,3467
0130-001,2015,8,4,19,1972,2223,4195,4089
0130-001,2015,8,4,20,1592,1663,3255,4195
0130-001,2015,8,4,21,1263,1334,2597,3255
0130-001,2015,8,4,22,1086,986,2072,2597
0130-001,2015,8,4,23,819,706,1525,2072
0130-001,2015,8,4,24,525,442,967,1525
0130-001,2015,8,5,1,346,253,599,967
0130-001,2015,8,5,2,231,179,410,599
0130-001,2015,8,5,3,190,151,341,410
0130-001,2015,8,5,4,139,134,273,341
0130-001,2015,8,5,5,185,162,347,273
0130-001,2015,8,5,6,503,340,843,347
0130-001,2015,8,5,7,1373,686,2059,843
0130-001,2015,8,5,8,1776,1394,3170,2059
0130-001,2015,8,5,9,1806,1689,3495,3170
0130-001,2015,8,5,10,1664,1676,3340,3495
0130-001,2015,8,5,11,1725,1623,3348,3340
0130-001,2015,8,5,12,1601,1831,3432,3348
0130-001,2015,8,5,13,1484,1638,3122,3432
0130-001,2015,8,5,14,1767,1706,3473,3122
0130-001,2015,8,5,15,1771,1827,3598,3473
0130-001,2015,8,5,16,1815,1770,3585,3598
0130-001,2015,8,5,17,1620,1765,3385,3585
0130-001,2015,8,5,18,1809,2209,4018,3385
0130-001,2015,8,5,19,1739,2371,4110,4018
0130-001,2015,8,5,20,1397,1644,3041,4110
0130-001,2015,8,5,21,1252,1347,2599,3041
0130-001,2015,8,5,22,1048,1018,2066,2599
0130-001,2015,8,5,23,910,672,1582,2066
0130-001,2015,8,5,24,610,506,1116,1582
0130-001,2015,8,6,1,383,272,655,1116
0130-001,2015,8,6,2,251,179,430,655
0130-001,2015,8,6,3,166,173,339,430
0130-001,2015,8,6,4,155,98,253,339
0130-001,2015,8,6,5,196,173,369,253
0130-001,2015,8,6,6,527,325,852,369
0130-001,2015,8,6,7,1452,665,2117,852
0130-001,2015,8,6,8,1931,1319,3250,2117
0130-001,2015,8,6,9,1977,1791,3768,3250
0130-001,2015,8,6,10,1730,1727,3457,3768
0130-001,2015,8,6,11,1815,1678,3493,3457
0130-001,2015,8,6,12,1570,1791,3361,3493
0130-001,2015,8,6,13,1517,1695,3212,3361
0130-001,2015,8,6,14,1697,1810,3507,3212
0130-001,2015,8,6,15,1787,1782,3569,3507
0130-001,2015,8,6,16,1793,1829,3622,3569
0130-001,2015,8,6,17,1690,1855,3545,3622
0130-001,2015,8,6,18,1828,2190,4018,3545
0130-001,2015,8,6,19,1784,2372,4156,4018
0130-001,2015,8,6,20,1384,1668,3052,4156
0130-001,2015,8,6,21,1193,1457,2650,3052
0130-001,2015,8,6,22,1095,1086,2181,2650
0130-001,2015,8,6,23,830,604,1434,2181
0130-001,2015,8,6,24,547,434,981,1434
0130-001,2015,8,7,1,437,330,767,981
0130-001,2015,8,7,2,260,217,477,767
0130-001,2015,8,7,3,196,143,339,477
0130-001,2015,8,7,4,159,128,287,339
0130-001,2015,8,7,5,216,194,410,287
0130-001,2015,8,7,6,499,366,865,410
0130-001,2015,8,7,7,1399,748,2147,865
0130-001,2015,8,7,8,2049,1449,3498,2147
0130-001,2015,8,7,9,1879,1848,3727,3498
0130-001,2015,8,7,10,1890,1740,3630,3727
0130-001,2015,8,7,11,1835,1901,3736,3630
0130-001,2015,8,7,12,1712,1867,3579,3736
0130-001,2015,8,7,13,1515,1833,3348,3579
0130-001,2015,8,7,14,1688,1863,3551,3348
0130-001,2015,8,7,15,1795,1814,3609,3551
0130-001,2015,8,7,16,1863,1976,3839,3609
0130-001,2015,8,7,17,1903,1988,3891,3839
0130-001,2015,8,7,18,2034,2286,4320,3891
0130-001,2015,8,7,19,1876,2454,4330,4320
0130-001,2015,8,7,20,1581,1874,3455,4330
0130-001,2015,8,7,21,1371,1583,2954,3455
0130-001,2015,8,7,22,1156,1192,2348,2954
0130-001,2015,8,7,23,910,752,1662,2348
0130-001,2015,8,7,24,604,576,1180,1662
0130-001,2015,8,8,1,472,376,848,1180
0130-001,2015,8,8,2,324,240,564,848
0130-001,2015,8,8,3,264,196,460,564
0130-001,2015,8,8,4,227,160,387,460
0130-001,2015,8,8,5,262,187,449,387
0130-001,2015,8,8,6,532,338,870,449
0130-001,2015,8,8,7,1013,640,1653,870
0130-001,2015,8,8,8,1515,997,2512,1653
0130-001,2015,8,8,9,1686,1515,3201,2512
0130-001,2015,8,8,10,1776,1736,3512,3201
0130-001,2015,8,8,11,1688,1944,3632,3512
0130-001,2015,8,8,12,1686,2103,3789,3632
0130-001,2015,8,8,13,1465,2156,3621,3789
0130-001,2015,8,8,14,1460,1659,3119,3621
0130-001,2015,8,8,15,1607,1913,3520,3119
0130-001,2015,8,8,16,1699,1922,3621,3520
0130-001,2015,8,8,17,1748,1661,3409,3621
0130-001,2015,8,8,18,1915,1923,3838,3409
0130-001,2015,8,8,19,1748,1710,3458,3838
0130-001,2015,8,8,20,1388,1285,2673,3458
0130-001,2015,8,8,21,1294,1111,2405,2673
0130-001,2015,8,8,22,1064,839,1903,2405
0130-001,2015,8,8,23,802,597,1399,1903
0130-001,2015,8,8,24,540,432,972,1399
0130-001,2015,8,9,1,410,321,731,972
0130-001,2015,8,9,2,302,226,528,731
0130-001,2015,8,9,3,242,153,395,528
0130-001,2015,8,9,4,180,141,321,395
0130-001,2015,8,9,5,241,130,371,321
0130-001,2015,8,9,6,398,232,630,371
0130-001,2015,8,9,7,644,410,1054,630
0130-001,2015,8,9,8,770,593,1363,1054
0130-001,2015,8,9,9,830,850,1680,1363
0130-001,2015,8,9,10,953,1001,1954,1680
0130-001,2015,8,9,11,1060,1094,2154,1954
0130-001,2015,8,9,12,1035,1266,2301,2154
0130-001,2015,8,9,13,1110,1396,2506,2301
0130-001,2015,8,9,14,1066,1234,2300,2506
0130-001,2015,8,9,15,1333,1264,2597,2300
0130-001,2015,8,9,16,1397,1317,2714,2597
0130-001,2015,8,9,17,1427,1362,2789,2714
0130-001,2015,8,9,18,1417,1456,2873,2789
0130-001,2015,8,9,19,1358,1264,2622,2873
0130-001,2015,8,9,20,1141,1062,2203,2622
0130-001,2015,8,9,21,1283,1022,2305,2203
0130-001,2015,8,9,22,956,799,1755,2305
0130-001,2015,8,9,23,716,519,1235,1755
0130-001,2015,8,9,24,453,342,795,1235
0130-001,2015,8,10,1,289,207,496,795
0130-001,2015,8,10,2,185,122,307,496
0130-001,2015,8,10,3,133,107,240,307
0130-001,2015,8,10,4,142,113,255,240
0130-001,2015,8,10,5,219,124,343,255
0130-001,2015,8,10,6,586,347,933,343
0130-001,2015,8,10,7,1879,810,2689,933
0130-001,2015,8,10,8,2056,1449,3505,2689
0130-001,2015,8,10,9,2124,1852,3976,3505
0130-001,2015,8,10,10,1916,1757,3673,3976
0130-001,2015,8,10,11,1868,1723,3591,3673
0130-001,2015,8,10,12,1739,1727,3466,3591
0130-001,2015,8,10,13,1554,1576,3130,3466
0130-001,2015,8,10,14,1747,1672,3419,3130
0130-001,2015,8,10,15,1841,1816,3657,3419
0130-001,2015,8,10,16,1870,1899,3769,3657
0130-001,2015,8,10,17,1750,1804,3554,3769
0130-001,2015,8,10,18,1826,2436,4262,3554
0130-001,2015,8,10,19,1789,2510,4299,4262
0130-001,2015,8,10,20,1388,1971,3359,4299
0130-001,2015,8,10,21,1261,1787,3048,3359
0130-001,2015,8,10,22,1051,1254,2305,3048
0130-001,2015,8,10,23,864,759,1623,2305
0130-001,2015,8,10,24,518,491,1009,1623
0130-001,2015,8,11,1,363,277,640,1009
0130-001,2015,8,11,2,242,221,463,640
0130-001,2015,8,11,3,175,166,341,463
0130-001,2015,8,11,4,150,128,278,341
0130-001,2015,8,11,5,186,183,369,278
0130-001,2015,8,11,6,565,323,888,369
0130-001,2015,8,11,7,1795,750,2545,888
0130-001,2015,8,11,8,1999,1455,3454,2545
0130-001,2015,8,11,9,2133,1810,3943,3454
0130-001,2015,8,11,10,1911,1736,3647,3943
0130-001,2015,8,11,11,1795,1683,3478,3647
0130-001,2015,8,11,12,1738,1676,3414,3478
0130-001,2015,8,11,13,1425,1521,2946,3414
0130-001,2015,8,11,14,1725,1768,3493,2946
0130-001,2015,8,11,15,1850,1814,3664,3493
0130-001,2015,8,11,16,1934,1863,3797,3664
0130-001,2015,8,11,17,1760,1940,3700,3797
0130-001,2015,8,11,18,1796,2281,4077,3700
0130-001,2015,8,11,19,1774,2481,4255,4077
0130-001,2015,8,11,20,1344,1867,3211,4255
0130-001,2015,8,11,21,1197,1714,2911,3211
0130-001,2015,8,11,22,1099,1279,2378,2911
0130-001,2015,8,11,23,823,763,1586,2378
0130-001,2015,8,11,24,553,463,1016,1586
0130-001,2015,8,12,1,363,283,646,1016
0130-001,2015,8,12,2,247,217,464,646
0130-001,2015,8,12,3,173,164,337,464
0130-001,2015,8,12,4,150,147,297,337
0130-001,2015,8,12,5,236,162,398,297
0130-001,2015,8,12,6,499,338,837,398
0130-001,2015,8,12,7,1769,763,2532,837
0130-001,2015,8,12,8,2014,1426,3440,2532
0130-001,2015,8,12,9,2031,1804,3835,3440
0130-001,2015,8,12,10,1833,1810,3643,3835
0130-001,2015,8,12,11,1964,1717,3681,3643
0130-001,2015,8,12,12,1747,1765,3512,3681
0130-001,2015,8,12,13,1458,1714,3172,3512
0130-001,2015,8,12,14,1826,1672,3498,3172
0130-001,2015,8,12,15,1909,1804,3713,3498
0130-001,2015,8,12,16,1951,1850,3801,3713
0130-001,2015,8,12,17,1752,1912,3664,3801
0130-001,2015,8,12,18,1750,2294,4044,3664
0130-001,2015,8,12,19,1914,2641,4555,4044
0130-001,2015,8,12,20,1489,2044,3533,4555
0130-001,2015,8,12,21,1195,1666,2861,3533
0130-001,2015,8,12,22,1117,1192,2309,2861
0130-001,2015,8,12,23,943,784,1727,2309
0130-001,2015,8,12,24,589,497,1086,1727
0130-001,2015,8,13,1,391,308,699,1086
0130-001,2015,8,13,2,212,211,423,699
0130-001,2015,8,13,3,181,160,341,423
0130-001,2015,8,13,4,166,149,315,341
0130-001,2015,8,13,5,234,202,436,315
0130-001,2015,8,13,6,578,355,933,436
0130-001,2015,8,13,7,1769,782,2551,933
0130-001,2015,8,13,8,2065,1532,3597,2551
0130-001,2015,8,13,9,2178,1899,4077,3597
0130-001,2015,8,13,10,2047,1740,3787,4077
0130-001,2015,8,13,11,1936,1778,3714,3787
0130-001,2015,8,13,12,1833,1816,3649,3714
0130-001,2015,8,13,13,1550,1553,3103,3649
0130-001,2015,8,13,14,1743,1755,3498,3103
0130-001,2015,8,13,15,1899,1867,3766,3498
0130-001,2015,8,13,16,1905,1937,3842,3766
0130-001,2015,8,13,17,1806,1999,3805,3842
0130-001,2015,8,13,18,1973,2356,4329,3805
0130-001,2015,8,13,19,1887,2610,4497,4329
0130-001,2015,8,13,20,1576,2163,3739,4497
0130-001,2015,8,13,21,1412,1816,3228,3739
0130-001,2015,8,13,22,1281,1326,2607,3228
0130-001,2015,8,13,23,989,848,1837,2607
0130-001,2015,8,13,24,541,568,1109,1837
0130-001,2015,8,14,1,413,313,726,1109
0130-001,2015,8,14,2,284,223,507,726
0130-001,2015,8,14,3,219,183,402,507
0130-001,2015,8,14,4,188,181,369,402
0130-001,2015,8,14,5,269,219,488,369
0130-001,2015,8,14,6,523,379,902,488
0130-001,2015,8,14,7,1355,646,2001,902
0130-001,2015,8,14,8,1980,1224,3204,2001
0130-001,2015,8,14,9,1763,1831,3594,3204
0130-001,2015,8,14,10,1664,1918,3582,3594
0130-001,2015,8,14,11,1767,2192,3959,3582
0130-001,2015,8,14,12,1690,2355,4045,3959
0130-001,2015,8,14,13,1392,2129,3521,4045
0130-001,2015,8,14,14,1620,2065,3685,3521
0130-001,2015,8,14,15,1749,1925,3674,3685
0130-001,2015,8,14,16,1723,1778,3501,3674
0130-001,2015,8,14,17,1719,1852,3571,3501
0130-001,2015,8,14,18,1842,2358,4200,3571
0130-001,2015,8,14,19,1782,2354,4136,4200
0130-001,2015,8,14,20,1515,1646,3161,4136
0130-001,2015,8,14,21,1370,1396,2766,3161
0130-001,2015,8,14,22,1070,1071,2141,2766
0130-001,2015,8,14,23,887,737,1624,2141
0130-001,2015,8,14,24,593,493,1086,1624
0130-001,2015,8,15,1,462,332,794,1086
0130-001,2015,8,15,2,313,262,575,794
0130-001,2015,8,15,3,210,185,395,575
0130-001,2015,8,15,4,210,175,385,395
0130-001,2015,8,15,5,242,198,440,385
0130-001,2015,8,15,6,486,313,799,440
0130-001,2015,8,15,7,1121,593,1714,799
0130-001,2015,8,15,8,1416,952,2368,1714
0130-001,2015,8,15,9,1292,1307,2599,2368
0130-001,2015,8,15,10,1346,1423,2769,2599
0130-001,2015,8,15,11,1370,1714,3084,2769
0130-001,2015,8,15,12,1340,1946,3286,3084
0130-001,2015,8,15,13,1261,1978,3239,3286
0130-001,2015,8,15,14,1401,1663,3064,3239
0130-001,2015,8,15,15,1436,1540,2976,3064
0130-001,2015,8,15,16,1609,1542,3151,2976
0130-001,2015,8,15,17,1673,1547,3220,3151
0130-001,2015,8,15,18,1715,1954,3669,3220
0130-001,2015,8,15,19,1658,1625,3283,3669
0130-001,2015,8,15,20,1388,1317,2705,3283
0130-001,2015,8,15,21,1248,1177,2425,2705
0130-001,2015,8,15,22,981,763,1744,2425
0130-001,2015,8,15,23,755,589,1344,1744
0130-001,2015,8,15,24,508,444,952,1344
0130-001,2015,8,16,1,398,387,785,952
0130-001,2015,8,16,2,262,228,490,785
0130-001,2015,8,16,3,238,151,389,490
0130-001,2015,8,16,4,181,141,322,389
0130-001,2015,8,16,5,205,128,333,322
0130-001,2015,8,16,6,330,240,570,333
0130-001,2015,8,16,7,646,325,971,570
0130-001,2015,8,16,8,707,625,1332,971
0130-001,2015,8,16,9,818,1007,1825,1332
0130-001,2015,8,16,10,869,1088,1957,1825
0130-001,2015,8,16,11,1145,1209,2354,1957
0130-001,2015,8,16,12,1156,1389,2545,2354
0130-001,2015,8,16,13,1416,1606,3022,2545
0130-001,2015,8,16,14,1533,1305,2838,3022
0130-001,2015,8,16,15,1638,1472,3110,2838
0130-001,2015,8,16,16,1526,1557,3083,3110
0130-001,2015,8,16,17,1660,1572,3232,3083
0130-001,2015,8,16,18,1675,1517,3192,3232
0130-001,2015,8,16,19,1594,1432,3026,3192
0130-001,2015,8,16,20,1360,1139,2499,3026
0130-001,2015,8,16,21,1136,956,2092,2499
0130-001,2015,8,16,22,1071,672,1743,2092
0130-001,2015,8,16,23,884,497,1381,1743
0130-001,2015,8,16,24,468,319,787,1381
0130-001,2015,8,17,1,301,192,493,787
0130-001,2015,8,17,2,196,134,330,493
0130-001,2015,8,17,3,130,90,220,330
0130-001,2015,8,17,4,136,85,221,220
0130-001,2015,8,17,5,186,151,337,221
0130-001,2015,8,17,6,542,338,880,337
0130-001,2015,8,17,7,1613,886,2499,880
0130-001,2015,8,17,8,1873,1572,3445,2499
0130-001,2015,8,17,9,1926,1889,3815,3445
0130-001,2015,8,17,10,1806,1657,3463,3815
0130-001,2015,8,17,11,1796,1895,3691,3463
0130-001,2015,8,17,12,1662,1608,3270,3691
0130-001,2015,8,17,13,1445,1587,3032,3270
0130-001,2015,8,17,14,1676,1653,3329,3032
0130-001,2015,8,17,15,1801,1812,3613,3329
0130-001,2015,8,17,16,1810,1755,3565,3613
0130-001,2015,8,17,17,1699,1912,3611,3565
0130-001,2015,8,17,18,1784,2303,4087,3611
0130-001,2015,8,17,19,1789,2579,4368,4087
0130-001,2015,8,17,20,1513,2007,3520,4368
0130-001,2015,8,17,21,1230,1661,2891,3520
0130-001,2015,8,17,22,1163,1198,2361,2891
0130-001,2015,8,17,23,784,750,1534,2361
0130-001,2015,8,17,24,608,474,1082,1534
0130-001,2015,8,18,1,385,255,640,1082
0130-001,2015,8,18,2,221,226,447,640
0130-001,2015,8,18,3,199,151,350,447
0130-001,2015,8,18,4,146,179,325,350
0130-001,2015,8,18,5,240,160,400,325
0130-001,2015,8,18,6,576,351,927,400
0130-001,2015,8,18,7,1820,767,2587,927
0130-001,2015,8,18,8,2010,1561,3571,2587
0130-001,2015,8,18,9,2212,1838,4050,3571
0130-001,2015,8,18,10,1874,1761,3635,4050
0130-001,2015,8,18,11,1828,1761,3589,3635
0130-001,2015,8,18,12,1717,1680,3397,3589
0130-001,2015,8,18,13,1577,1572,3149,3397
0130-001,2015,8,18,14,1920,1685,3605,3149
0130-001,2015,8,18,15,1842,1780,3622,3605
0130-001,2015,8,18,16,1899,1908,3807,3622
0130-001,2015,8,18,17,1710,1827,3537,3807
0130-001,2015,8,18,18,1761,2456,4217,3537
0130-001,2015,8,18,19,1750,2563,4313,4217
0130-001,2015,8,18,20,1508,2048,3556,4313
0130-001,2015,8,18,21,1244,1797,3041,3556
0130-001,2015,8,18,22,1092,1305,2397,3041
0130-001,2015,8,18,23,854,763,1617,2397
0130-001,2015,8,18,24,613,463,1076,1617
0130-001,2015,8,19,1,339,281,620,1076
0130-001,2015,8,19,2,242,194,436,620
0130-001,2015,8,19,3,188,151,339,436
0130-001,2015,8,19,4,139,164,303,339
0130-001,2015,8,19,5,186,177,363,303
0130-001,2015,8,19,6,584,383,967,363
0130-001,2015,8,19,7,1793,818,2611,967
0130-001,2015,8,19,8,2072,1553,3625,2611
0130-001,2015,8,19,9,2091,2014,4105,3625
0130-001,2015,8,19,10,1830,1740,3570,4105
0130-001,2015,8,19,11,1820,1587,3407,3570
0130-001,2015,8,19,12,1677,1659,3336,3407
0130-001,2015,8,19,13,1511,1634,3145,3336
0130-001,2015,8,19,14,1763,1763,3526,3145
0130-001,2015,8,19,15,1752,1823,3575,3526
0130-001,2015,8,19,16,1947,1880,3827,3575
0130-001,2015,8,19,17,1841,1882,3723,3827
0130-001,2015,8,19,18,1820,2417,4237,3723
0130-001,2015,8,19,19,1795,2590,4385,4237
0130-001,2015,8,19,20,1491,1995,3486,4385
0130-001,2015,8,19,21,1239,1695,2934,3486
0130-001,2015,8,19,22,1070,1245,2315,2934
0130-001,2015,8,19,23,878,786,1664,2315
0130-001,2015,8,19,24,538,455,993,1664
0130-001,2015,8,20,1,369,321,690,993
0130-001,2015,8,20,2,243,170,413,690
0130-001,2015,8,20,3,201,164,365,413
0130-001,2015,8,20,4,155,166,321,365
0130-001,2015,8,20,5,214,141,355,321
0130-001,2015,8,20,6,571,374,945,355
0130-001,2015,8,20,7,1787,786,2573,945
0130-001,2015,8,20,8,2003,1528,3531,2573
0130-001,2015,8,20,9,2192,1965,4157,3531
0130-001,2015,8,20,10,2008,1863,3871,4157
0130-001,2015,8,20,11,1947,1759,3706,3871
0130-001,2015,8,20,12,1747,1689,3436,3706
0130-001,2015,8,20,13,1534,1574,3108,3436
0130-001,2015,8,20,14,1720,1496,3216,3108
0130-001,2015,8,20,15,1843,1889,3732,3216
0130-001,2015,8,20,16,1849,1835,3684,3732
0130-001,2015,8,20,17,1748,1850,3598,3684
0130-001,2015,8,20,18,1900,1657,3557,3598
0130-001,2015,8,20,19,1836,2491,4327,3557
0130-001,2015,8,20,20,1480,1319,2799,4327
0130-001,2015,8,20,21,1302,984,2286,2799
0130-001,2015,8,20,22,341,769,1110,2286
0130-001,2015,8,20,23,311,425,736,1110
0130-001,2015,8,20,24,264,298,562,736
0130-001,2015,8,21,1,425,166,591,562
0130-001,2015,8,21,2,272,100,372,591
0130-001,2015,8,21,3,208,85,293,372
0130-001,2015,8,21,4,174,71,245,293
0130-001,2015,8,21,5,242,71,313,245
0130-001,2015,8,21,6,511,166,677,313
0130-001,2015,8,21,7,1377,423,1800,677
0130-001,2015,8,21,8,2014,960,2974,1800
0130-001,2015,8,21,9,1821,1678,3499,2974
0130-001,2015,8,21,10,1777,1651,3428,3499
0130-001,2015,8,21,11,1801,1763,3564,3428
0130-001,2015,8,21,12,1701,1825,3526,3564
0130-001,2015,8,21,13,1454,1621,3075,3526
0130-001,2015,8,21,14,1654,1746,3400,3075
0130-001,2015,8,21,15,1772,1918,3690,3400
0130-001,2015,8,21,16,1793,1942,3735,3690
0130-001,2015,8,21,17,1811,1944,3755,3735
0130-001,2015,8,21,18,1938,2445,4383,3755
0130-001,2015,8,21,19,1829,2735,4564,4383
0130-001,2015,8,21,20,1548,2171,3719,4564
0130-001,2015,8,21,21,1370,1787,3157,3719
0130-001,2015,8,21,22,1113,1245,2358,3157
0130-001,2015,8,21,23,361,825,1186,2358
0130-001,2015,8,21,24,332,614,946,1186
0130-001,2015,8,22,1,256,368,624,946
0130-001,2015,8,22,2,201,255,456,624
0130-001,2015,8,22,3,179,211,390,456
0130-001,2015,8,22,4,139,226,365,390
0130-001,2015,8,22,5,139,215,354,365
0130-001,2015,8,22,6,509,347,856,354
0130-001,2015,8,22,7,1067,589,1656,856
0130-001,2015,8,22,8,1466,1060,2526,1656
0130-001,2015,8,22,9,1489,1598,3087,2526
0130-001,2015,8,22,10,1561,1765,3326,3087
0130-001,2015,8,22,11,1529,1986,3515,3326
0130-001,2015,8,22,12,1513,2171,3684,3515
0130-001,2015,8,22,13,1363,1929,3292,3684
0130-001,2015,8,22,14,1430,1831,3261,3292
0130-001,2015,8,22,15,1522,1948,3470,3261
0130-001,2015,8,22,16,1654,1923,3577,3470
0130-001,2015,8,22,17,1710,1927,3637,3577
0130-001,2015,8,22,18,1815,2343,4158,3637
0130-001,2015,8,22,19,1703,2103,3806,4158
0130-001,2015,8,22,20,1388,1413,2801,3806
0130-001,2015,8,22,21,1271,1141,2412,2801
0130-001,2015,8,22,22,1022,880,1902,2412
0130-001,2015,8,22,23,778,640,1418,1902
0130-001,2015,8,22,24,243,425,668,1418
0130-001,2015,8,23,1,404,321,725,668
0130-001,2015,8,23,2,282,268,550,725
0130-001,2015,8,23,3,240,179,419,550
0130-001,2015,8,23,4,180,134,314,419
0130-001,2015,8,23,5,223,166,389,314
0130-001,2015,8,23,6,364,268,632,389
0130-001,2015,8,23,7,645,404,1049,632
0130-001,2015,8,23,8,738,587,1325,1049
0130-001,2015,8,23,9,824,1005,1829,1325
0130-001,2015,8,23,10,911,1086,1997,1829
0130-001,2015,8,23,11,1102,1205,2307,1997
0130-001,2015,8,23,12,1096,1432,2528,2307
0130-001,2015,8,23,13,1263,1460,2723,2528
0130-001,2015,8,23,14,1300,1394,2694,2723
0130-001,2015,8,23,15,1486,1477,2963,2694
0130-001,2015,8,23,16,1462,1428,2890,2963
0130-001,2015,8,23,17,1544,1562,3106,2890
0130-001,2015,8,23,18,1510,1551,3061,3106
0130-001,2015,8,23,19,1377,1389,2766,3061
0130-001,2015,8,23,20,1248,1313,2561,2766
0130-001,2015,8,23,21,1410,1149,2559,2561
0130-001,2015,8,23,22,1020,765,1785,2559
0130-001,2015,8,23,23,694,531,1225,1785
0130-001,2015,8,23,24,350,349,699,1225
0130-001,2015,8,24,1,328,207,535,699
0130-001,2015,8,24,2,166,151,317,535
0130-001,2015,8,24,3,118,98,216,317
0130-001,2015,8,24,4,107,107,214,216
0130-001,2015,8,24,5,172,126,298,214
0130-001,2015,8,24,6,600,400,1000,298
0130-001,2015,8,24,7,1587,776,2363,1000
0130-001,2015,8,24,8,2034,1782,3816,2363
0130-001,2015,8,24,9,2233,1991,4224,3816
0130-001,2015,8,24,10,1923,1818,3741,4224
0130-001,2015,8,24,11,1785,1793,3578,3741
0130-001,2015,8,24,12,1646,1723,3369,3578
0130-001,2015,8,24,13,1416,1447,2863,3369
0130-001,2015,8,24,14,1681,1738,3419,2863
0130-001,2015,8,24,15,1802,1876,3678,3419
0130-001,2015,8,24,16,1969,1980,3949,3678
0130-001,2015,8,24,17,1861,1797,3658,3949
0130-001,2015,8,24,18,1791,2462,4253,3658
0130-001,2015,8,24,19,1752,2531,4283,4253
0130-001,2015,8,24,20,1392,2165,3557,4283
0130-001,2015,8,24,21,1257,1808,3065,3557
0130-001,2015,8,24,22,1068,1277,2345,3065
0130-001,2015,8,24,23,895,727,1622,2345
0130-001,2015,8,24,24,547,470,1017,1622
0130-001,2015,8,25,1,313,283,596,1017
0130-001,2015,8,25,2,144,156,300,596
0130-001,2015,8,25,3,187,128,315,300
0130-001,2015,8,25,4,148,141,289,315
0130-001,2015,8,25,5,213,126,339,289
0130-001,2015,8,25,6,570,322,892,339
0130-001,2015,8,25,7,1808,730,2538,892
0130-001,2015,8,25,8,2004,1516,3520,2538
0130-001,2015,8,25,9,2172,1810,3982,3520
0130-001,2015,8,25,10,1892,1717,3609,3982
0130-001,2015,8,25,11,1812,1668,3480,3609
0130-001,2015,8,25,12,1728,1695,3423,3480
0130-001,2015,8,25,13,1501,1479,2980,3423
0130-001,2015,8,25,14,1822,1695,3517,2980
0130-001,2015,8,25,15,1846,1751,3597,3517
0130-001,2015,8,25,16,1916,1878,3794,3597
0130-001,2015,8,25,17,1735,1884,3619,3794
0130-001,2015,8,25,18,1778,2171,3949,3619
0130-001,2015,8,25,19,1762,2334,4096,3949
0130-001,2015,8,25,20,1426,1804,3230,4096
0130-001,2015,8,25,21,1220,1761,2981,3230
0130-001,2015,8,25,22,1096,1109,2205,2981
0130-001,2015,8,25,23,838,667,1505,2205
0130-001,2015,8,25,24,583,438,1021,1505
0130-001,2015,8,26,1,351,257,608,1021
0130-001,2015,8,26,2,244,187,431,608
0130-001,2015,8,26,3,180,158,338,431
0130-001,2015,8,26,4,144,143,287,338
0130-001,2015,8,26,5,211,173,384,287
0130-001,2015,8,26,6,542,336,878,384
0130-001,2015,8,26,7,1781,776,2557,878
0130-001,2015,8,26,8,2043,1640,3683,2557
0130-001,2015,8,26,9,2061,1982,4043,3683
0130-001,2015,8,26,10,1832,1772,3604,4043
0130-001,2015,8,26,11,1892,1770,3662,3604
0130-001,2015,8,26,12,1712,1755,3467,3662
0130-001,2015,8,26,13,1484,1557,3041,3467
0130-001,2015,8,26,14,1794,1833,3627,3041
0130-001,2015,8,26,15,1830,1831,3661,3627
0130-001,2015,8,26,16,1949,2014,3963,3661
0130-001,2015,8,26,17,1796,1961,3757,3963
0130-001,2015,8,26,18,1785,2449,4234,3757
0130-001,2015,8,26,19,1854,2585,4439,4234
0130-001,2015,8,26,20,1490,2086,3576,4439
0130-001,2015,8,26,21,1217,1638,2855,3576
0130-001,2015,8,26,22,1094,1207,2301,2855
0130-001,2015,8,26,23,910,695,1605,2301
0130-001,2015,8,26,24,564,453,1017,1605
0130-001,2015,8,27,1,380,319,699,1017
0130-001,2015,8,27,2,228,192,420,699
0130-001,2015,8,27,3,191,145,336,420
0130-001,2015,8,27,4,160,124,284,336
0130-001,2015,8,27,5,224,185,409,284
0130-001,2015,8,27,6,574,190,764,409
0130-001,2015,8,27,7,1778,536,2314,764
0130-001,2015,8,27,8,2034,1540,3574,2314
0130-001,2015,8,27,9,2185,1946,4131,3574
0130-001,2015,8,27,10,2028,1793,3821,4131
0130-001,2015,8,27,11,1942,1717,3659,3821
0130-001,2015,8,27,12,1790,1812,3602,3659
0130-001,2015,8,27,13,1542,1515,3057,3602
0130-001,2015,8,27,14,1732,1736,3468,3057
0130-001,2015,8,27,15,1871,1918,3789,3468
0130-001,2015,8,27,16,1877,1897,3774,3789
0130-001,2015,8,27,17,1777,1842,3619,3774
0130-001,2015,8,27,18,1936,2439,4375,3619
0130-001,2015,8,27,19,1862,2638,4500,4375
0130-001,2015,8,27,20,1528,1980,3508,4500
0130-001,2015,8,27,21,1357,1761,3118,3508
0130-001,2015,8,27,22,811,1328,2139,3118
0130-001,2015,8,27,23,650,859,1509,2139
0130-001,2015,8,27,24,402,525,927,1509
0130-001,2015,8,28,1,357,313,670,927
0130-001,2015,8,28,2,225,183,408,670
0130-001,2015,8,28,3,137,200,337,408
0130-001,2015,8,28,4,137,160,297,337
0130-001,2015,8,28,5,159,200,359,297
0130-001,2015,8,28,6,517,355,872,359
0130-001,2015,8,28,7,1366,731,2097,872
0130-001,2015,8,28,8,1997,1615,3612,2097
0130-001,2015,8,28,9,1792,2073,3865,3612
0130-001,2015,8,28,10,1720,1744,3464,3865
0130-001,2015,8,28,11,1784,1687,3471,3464
0130-001,2015,8,28,12,1696,1689,3385,3471
0130-001,2015,8,28,13,1423,1632,3055,3385
0130-001,2015,8,28,14,1637,1311,2948,3055
0130-001,2015,8,28,15,1760,1967,3727,2948
0130-001,2015,8,28,16,1758,1366,3124,3727
0130-001,2015,8,28,17,1765,1770,3535,3124
0130-001,2015,8,28,18,1890,2558,4448,3535
0130-001,2015,8,28,19,1806,2793,4599,4448
0130-001,2015,8,28,20,1532,2256,3788,4599
0130-001,2015,8,28,21,1370,1810,3180,3788
0130-001,2015,8,28,22,1092,1279,2371,3180
0130-001,2015,8,28,23,624,865,1489,2371
0130-001,2015,8,28,24,462,589,1051,1489
0130-001,2015,8,29,1,359,402,761,1051
0130-001,2015,8,29,2,257,279,536,761
0130-001,2015,8,29,3,194,232,426,536
0130-001,2015,8,29,4,174,226,400,426
0130-001,2015,8,29,5,190,234,424,400
0130-001,2015,8,29,6,498,381,879,424
0130-001,2015,8,29,7,1094,646,1740,879
0130-001,2015,8,29,8,1441,1111,2552,1740
0130-001,2015,8,29,9,1390,1748,3138,2552
0130-001,2015,8,29,10,1454,1842,3296,3138
0130-001,2015,8,29,11,1450,2069,3519,3296
0130-001,2015,8,29,12,1426,2065,3491,3519
0130-001,2015,8,29,13,1312,2286,3598,3491
0130-001,2015,8,29,14,1416,2001,3417,3598
0130-001,2015,8,29,15,1479,1908,3387,3417
0130-001,2015,8,29,16,1632,2075,3707,3387
0130-001,2015,8,29,17,1692,2022,3714,3707
0130-001,2015,8,29,18,1960,2258,4218,3714
0130-001,2015,8,29,19,1934,2037,3971,4218
0130-001,2015,8,29,20,1377,1534,2911,3971
0130-001,2015,8,29,21,1312,1188,2500,2911
0130-001,2015,8,29,22,989,888,1877,2500
0130-001,2015,8,29,23,746,640,1386,1877
0130-001,2015,8,29,24,549,468,1017,1386
0130-001,2015,8,30,1,401,317,718,1017
0130-001,2015,8,30,2,272,234,506,718
0130-001,2015,8,30,3,239,177,416,506
0130-001,2015,8,30,4,180,160,340,416
0130-001,2015,8,30,5,214,156,370,340
0130-001,2015,8,30,6,347,255,602,370
0130-001,2015,8,30,7,646,372,1018,602
0130-001,2015,8,30,8,722,580,1302,1018
0130-001,2015,8,30,9,821,1020,1841,1302
0130-001,2015,8,30,10,890,1099,1989,1841
0130-001,2015,8,30,11,1124,1275,2399,1989
0130-001,2015,8,30,12,1126,1406,2532,2399
0130-001,2015,8,30,13,1340,1542,2882,2532
0130-001,2015,8,30,14,1416,1470,2886,2882
0130-001,2015,8,30,15,1562,1411,2973,2886
0130-001,2015,8,30,16,1494,1576,3070,2973
0130-001,2015,8,30,17,1602,1540,3142,3070
0130-001,2015,8,30,18,1592,1658,3250,3142
0130-001,2015,8,30,19,1486,1334,2820,3250
0130-001,2015,8,30,20,1304,1243,2547,2820
0130-001,2015,8,30,21,1273,1048,2321,2547
0130-001,2015,8,30,22,1046,771,1817,2321
0130-001,2015,8,30,23,789,519,1308,1817
0130-001,2015,8,30,24,409,349,758,1308
0130-001,2015,8,31,1,289,211,500,758
0130-001,2015,8,31,2,166,128,294,500
0130-001,2015,8,31,3,146,68,214,294
0130-001,2015,8,31,4,111,141,252,214
0130-001,2015,8,31,5,179,162,341,252
0130-001,2015,8,31,6,622,334,956,341
0130-001,2015,8,31,7,1600,791,2391,956
0130-001,2015,8,31,8,1954,1734,3688,2391
0130-001,2015,8,31,9,2080,2048,4128,3688
0130-001,2015,8,31,10,1864,1778,3642,4128
0130-001,2015,8,31,11,1790,1778,3568,3642
0130-001,2015,8,31,12,1654,1782,3436,3568
0130-001,2015,8,31,13,1430,1470,2900,3436
0130-001,2015,8,31,14,1678,1674,3352,2900
0130-001,2015,8,31,15,1802,1589,3391,3352
0130-001,2015,8,31,16,1817,1916,3733,3391
0130-001,2015,8,31,17,1767,2052,3819,3733
0130-001,2015,8,31,18,1847,2432,4279,3819
0130-001,2015,8,31,19,1743,2486,4229,4279
0130-001,2015,8,31,20,1347,2090,3437,4229
0130-001,2015,8,31,21,1208,1751,2959,3437
0130-001,2015,8,31,22,1116,1196,2312,2959
0130-001,2015,8,31,23,873,793,1666,2312
0130-001,2015,8,31,24,562,421,983,1666
0130-001,2015,9,1,1,341,294,635,983
0130-001,2015,9,1,2,230,179,409,635
0130-001,2015,9,1,3,148,160,308,409
0130-001,2015,9,1,4,141,143,284,308
0130-001,2015,9,1,5,177,181,358,284
0130-001,2015,9,1,6,435,292,727,358
0130-001,2015,9,1,7,1118,692,1810,727
0130-001,2015,9,1,8,1399,1470,2869,1810
0130-001,2015,9,1,9,1939,1781,3720,2869
0130-001,2015,9,1,10,1780,1673,3453,3720
0130-001,2015,9,1,11,1741,1547,3288,3453
0130-001,2015,9,1,12,1522,1502,3024,3288
0130-001,2015,9,1,13,1265,1295,2560,3024
0130-001,2015,9,1,14,1595,1589,3184,2560
0130-001,2015,9,1,15,1640,1737,3377,3184
0130-001,2015,9,1,16,1638,1691,3329,3377
0130-001,2015,9,1,17,1655,1775,3430,3329
0130-001,2015,9,1,18,1582,2250,3832,3430
0130-001,2015,9,1,19,1618,2246,3864,3832
0130-001,2015,9,1,20,1327,1821,3148,3864
0130-001,2015,9,1,21,1178,1600,2778,3148
0130-001,2015,9,1,22,1092,1132,2224,2778
0130-001,2015,9,1,23,837,675,1512,2224
0130-001,2015,9,1,24,512,412,924,1512
0130-001,2015,9,2,1,329,291,620,924
0130-001,2015,9,2,2,206,194,400,620
0130-001,2015,9,2,3,165,150,315,400
0130-001,2015,9,2,4,112,93,205,315
0130-001,2015,9,2,5,177,166,343,205
0130-001,2015,9,2,6,563,310,873,343
0130-001,2015,9,2,7,1669,678,2347,873
0130-001,2015,9,2,8,1881,1483,3364,2347
0130-001,2015,9,2,9,2010,1746,3756,3364
0130-001,2015,9,2,10,1891,1587,3478,3756
0130-001,2015,9,2,11,1754,1489,3243,3478
0130-001,2015,9,2,12,1585,1587,3172,3243
0130-001,2015,9,2,13,1390,1335,2725,3172
0130-001,2015,9,2,14,1583,1525,3108,2725
0130-001,2015,9,2,15,1725,1575,3300,3108
0130-001,2015,9,2,16,1712,1552,3264,3300
0130-001,2015,9,2,17,1643,1790,3433,3264
0130-001,2015,9,2,18,1571,2276,3847,3433
0130-001,2015,9,2,19,1628,2323,3951,3847
0130-001,2015,9,2,20,1291,1871,3162,3951
0130-001,2015,9,2,21,1109,1420,2529,3162
0130-001,2015,9,2,22,1085,1082,2167,2529
0130-001,2015,9,2,23,786,644,1430,2167
0130-001,2015,9,2,24,524,419,943,1430
0130-001,2015,9,3,1,374,281,655,943
0130-001,2015,9,3,2,236,164,400,655
0130-001,2015,9,3,3,196,162,358,400
0130-001,2015,9,3,4,158,127,285,358
0130-001,2015,9,3,5,219,106,325,285
0130-001,2015,9,3,6,572,329,901,325
0130-001,2015,9,3,7,1782,694,2476,901
0130-001,2015,9,3,8,2018,1502,3520,2476
0130-001,2015,9,3,9,2188,1835,4023,3520
0130-001,2015,9,3,10,2018,1589,3607,4023
0130-001,2015,9,3,11,1944,1485,3429,3607
0130-001,2015,9,3,12,1768,1504,3272,3429
0130-001,2015,9,3,13,1538,1330,2868,3272
0130-001,2015,9,3,14,1726,1533,3259,2868
0130-001,2015,9,3,15,1857,1656,3513,3259
0130-001,2015,9,3,16,1535,1648,3183,3513
0130-001,2015,9,3,17,1390,1752,3142,3183
0130-001,2015,9,3,18,1660,2171,3831,3142
0130-001,2015,9,3,19,1633,2341,3974,3831
0130-001,2015,9,3,20,1328,1817,3145,3974
0130-001,2015,9,3,21,1159,1597,2756,3145
0130-001,2015,9,3,22,1097,1132,2229,2756
0130-001,2015,9,3,23,789,773,1562,2229
0130-001,2015,9,3,24,490,415,905,1562
0130-001,2015,9,4,1,322,283,605,905
0130-001,2015,9,4,2,187,191,378,605
0130-001,2015,9,4,3,131,133,264,378
0130-001,2015,9,4,4,132,146,278,264
0130-001,2015,9,4,5,158,170,328,278
0130-001,2015,9,4,6,514,319,833,328
0130-001,2015,9,4,7,1372,702,2074,833
0130-001,2015,9,4,8,2006,1499,3505,2074
0130-001,2015,9,4,9,1806,1892,3698,3505
0130-001,2015,9,4,10,1748,1552,3300,3698
0130-001,2015,9,4,11,1792,1632,3424,3300
0130-001,2015,9,4,12,1698,1760,3458,3424
0130-001,2015,9,4,13,1438,1481,2919,3458
0130-001,2015,9,4,14,1311,1466,2777,2919
0130-001,2015,9,4,15,1491,1852,3343,2777
0130-001,2015,9,4,16,1583,1700,3283,3343
0130-001,2015,9,4,17,1643,1900,3543,3283
0130-001,2015,9,4,18,1715,2261,3976,3543
0130-001,2015,9,4,19,1776,2406,4182,3976
0130-001,2015,9,4,20,1424,1996,3420,4182
0130-001,2015,9,4,21,1255,1600,2855,3420
0130-001,2015,9,4,22,1268,1243,2511,2855
0130-001,2015,9,4,23,981,771,1752,2511
0130-001,2015,9,4,24,647,525,1172,1752
0130-001,2015,9,5,1,439,358,797,1172
0130-001,2015,9,5,2,362,277,639,797
0130-001,2015,9,5,3,243,196,439,639
0130-001,2015,9,5,4,204,193,397,439
0130-001,2015,9,5,5,247,187,434,397
0130-001,2015,9,5,6,516,352,868,434
0130-001,2015,9,5,7,1178,627,1805,868
0130-001,2015,9,5,8,1679,1024,2703,1805
0130-001,2015,9,5,9,1689,1579,3268,2703
0130-001,2015,9,5,10,1642,1889,3531,3268
0130-001,2015,9,5,11,1619,2128,3747,3531
0130-001,2015,9,5,12,1648,2170,3818,3747
0130-001,2015,9,5,13,1595,2267,3862,3818
0130-001,2015,9,5,14,1423,2090,3513,3862
0130-001,2015,9,5,15,1500,1926,3426,3513
0130-001,2015,9,5,16,1643,1840,3483,3426
0130-001,2015,9,5,17,1701,1785,3486,3483
0130-001,2015,9,5,18,1888,2005,3893,3486
0130-001,2015,9,5,19,1818,1764,3582,3893
0130-001,2015,9,5,20,1382,1258,2640,3582
0130-001,2015,9,5,21,1292,1095,2387,2640
0130-001,2015,9,5,22,1006,832,1838,2387
0130-001,2015,9,5,23,269,550,819,1838
0130-001,2015,9,5,24,232,467,699,819
0130-001,2015,9,6,1,192,310,502,699
0130-001,2015,9,6,2,166,187,353,502
0130-001,2015,9,6,3,129,187,316,353
0130-001,2015,9,6,4,124,123,247,316
0130-001,2015,9,6,5,95,108,203,247
0130-001,2015,9,6,6,177,221,398,203
0130-001,2015,9,6,7,243,398,641,398
0130-001,2015,9,6,8,197,684,881,641
0130-001,2015,9,6,9,302,732,1034,881
0130-001,2015,9,6,10,428,1061,1489,1034
0130-001,2015,9,6,11,601,1314,1915,1489
0130-001,2015,9,6,12,873,1447,2320,1915
0130-001,2015,9,6,13,1077,1347,2424,2320
0130-001,2015,9,6,14,1390,1447,2837,2424
0130-001,2015,9,6,15,1539,1433,2972,2837
0130-001,2015,9,6,16,1746,1339,3085,2972
0130-001,2015,9,6,17,1866,1412,3278,3085
0130-001,2015,9,6,18,1896,1474,3370,3278
0130-001,2015,9,6,19,1712,1232,2944,3370
0130-001,2015,9,6,20,1616,1003,2619,2944
0130-001,2015,9,6,21,1397,882,2279,2619
0130-001,2015,9,6,22,1032,617,1649,2279
0130-001,2015,9,6,23,647,460,1107,1649
0130-001,2015,9,6,24,427,260,687,1107
0130-001,2015,9,7,1,230,170,400,687
0130-001,2015,9,7,2,120,102,222,400
0130-001,2015,9,7,3,98,89,187,222
0130-001,2015,9,7,4,93,102,195,187
0130-001,2015,9,7,5,176,145,321,195
0130-001,2015,9,7,6,611,350,961,321
0130-001,2015,9,7,7,1594,798,2392,961
0130-001,2015,9,7,8,1994,1550,3544,2392
0130-001,2015,9,7,9,2156,1775,3931,3544
0130-001,2015,9,7,10,1894,1585,3479,3931
0130-001,2015,9,7,11,1788,1558,3346,3479
0130-001,2015,9,7,12,1650,1564,3214,3346
0130-001,2015,9,7,13,1423,1452,2875,3214
0130-001,2015,9,7,14,1680,1598,3278,2875
0130-001,2015,9,7,15,1802,1658,3460,3278
0130-001,2015,9,7,16,1893,1789,3682,3460
0130-001,2015,9,7,17,1814,1854,3668,3682
0130-001,2015,9,7,18,1819,2206,4025,3668
0130-001,2015,9,7,19,1748,2209,3957,4025
0130-001,2015,9,7,20,1370,1881,3251,3957
0130-001,2015,9,7,21,1232,1625,2857,3251
0130-001,2015,9,7,22,969,1289,2258,2857
0130-001,2015,9,7,23,774,675,1449,2258
0130-001,2015,9,7,24,507,410,917,1449
0130-001,2015,9,8,1,320,273,593,917
0130-001,2015,9,8,2,204,170,374,593
0130-001,2015,9,8,3,129,131,260,374
0130-001,2015,9,8,4,132,123,255,260
0130-001,2015,9,8,5,195,179,374,255
0130-001,2015,9,8,6,502,352,854,374
0130-001,2015,9,8,7,1463,740,2203,854
0130-001,2015,9,8,8,1702,1497,3199,2203
0130-001,2015,9,8,9,2056,1773,3829,3199
0130-001,2015,9,8,10,1836,1550,3386,3829
0130-001,2015,9,8,11,1776,1598,3374,3386
0130-001,2015,9,8,12,1625,1579,3204,3374
0130-001,2015,9,8,13,1383,1368,2751,3204
0130-001,2015,9,8,14,1708,1612,3320,2751
0130-001,2015,9,8,15,1743,1629,3372,3320
0130-001,2015,9,8,16,1777,1531,3308,3372
0130-001,2015,9,8,17,1695,1481,3176,3308
0130-001,2015,9,8,18,1407,2132,3539,3176
0130-001,2015,9,8,19,1597,2266,3863,3539
0130-001,2015,9,8,20,1330,1710,3040,3863
0130-001,2015,9,8,21,1097,1645,2742,3040
0130-001,2015,9,8,22,1048,1195,2243,2742
0130-001,2015,9,8,23,738,677,1415,2243
0130-001,2015,9,8,24,514,371,885,1415
0130-001,2015,9,9,1,367,296,663,885
0130-001,2015,9,9,2,213,160,373,663
0130-001,2015,9,9,3,131,141,272,373
0130-001,2015,9,9,4,127,95,222,272
0130-001,2015,9,9,5,117,191,308,222
0130-001,2015,9,9,6,274,321,595,308
0130-001,2015,9,9,7,695,734,1429,595
0130-001,2015,9,9,8,872,1524,2396,1429
0130-001,2015,9,9,9,1947,1888,3835,2396
0130-001,2015,9,9,10,1826,1633,3459,3835
0130-001,2015,9,9,11,1621,1474,3095,3459
0130-001,2015,9,9,12,1525,1589,3114,3095
0130-001,2015,9,9,13,1291,1341,2632,3114
0130-001,2015,9,9,14,1547,1541,3088,2632
0130-001,2015,9,9,15,1657,1616,3273,3088
0130-001,2015,9,9,16,1784,1673,3457,3273
0130-001,2015,9,9,17,1665,1760,3425,3457
0130-001,2015,9,9,18,1763,2226,3989,3425
0130-001,2015,9,9,19,1616,2353,3969,3989
0130-001,2015,9,9,20,1399,1960,3359,3969
0130-001,2015,9,9,21,1121,1441,2562,3359
0130-001,2015,9,9,22,1120,1164,2284,2562
0130-001,2015,9,9,23,846,703,1549,2284
0130-001,2015,9,9,24,591,436,1027,1549
0130-001,2015,9,10,1,350,246,596,1027
0130-001,2015,9,10,2,213,191,404,596
0130-001,2015,9,10,3,180,141,321,404
0130-001,2015,9,10,4,136,118,254,321
0130-001,2015,9,10,5,182,158,340,254
0130-001,2015,9,10,6,528,342,870,340
0130-001,2015,9,10,7,1751,726,2477,870
0130-001,2015,9,10,8,1881,1420,3301,2477
0130-001,2015,9,10,9,2009,1913,3922,3301
0130-001,2015,9,10,10,1890,1541,3431,3922
0130-001,2015,9,10,11,1813,1716,3529,3431
0130-001,2015,9,10,12,1570,1629,3199,3529
0130-001,2015,9,10,13,1368,1324,2692,3199
0130-001,2015,9,10,14,1645,1585,3230,2692
0130-001,2015,9,10,15,1826,1670,3496,3230
0130-001,2015,9,10,16,1640,1723,3363,3496
0130-001,2015,9,10,17,1671,1812,3483,3363
0130-001,2015,9,10,18,1667,2178,3845,3483
0130-001,2015,9,10,19,1660,2292,3952,3845
0130-001,2015,9,10,20,1349,1775,3124,3952
0130-001,2015,9,10,21,1096,1560,2656,3124
0130-001,2015,9,10,22,1116,1205,2321,2656
0130-001,2015,9,10,23,820,671,1491,2321
0130-001,2015,9,10,24,563,450,1013,1491
0130-001,2015,9,11,1,380,285,665,1013
0130-001,2015,9,11,2,221,187,408,665
0130-001,2015,9,11,3,170,141,311,408
0130-001,2015,9,11,4,187,123,310,311
0130-001,2015,9,11,5,189,193,382,310
0130-001,2015,9,11,6,528,340,868,382
0130-001,2015,9,11,7,1693,652,2345,868
0130-001,2015,9,11,8,1924,1479,3403,2345
0130-001,2015,9,11,9,2013,1792,3805,3403
0130-001,2015,9,11,10,1845,1572,3417,3805
0130-001,2015,9,11,11,1729,1577,3306,3417
0130-001,2015,9,11,12,1590,1573,3163,3306
0130-001,2015,9,11,13,1453,1535,2988,3163
0130-001,2015,9,11,14,1633,1754,3387,2988
0130-001,2015,9,11,15,1626,1579,3205,3387
0130-001,2015,9,11,16,1670,1708,3378,3205
0130-001,2015,9,11,17,1704,1835,3539,3378
0130-001,2015,9,11,18,1802,2205,4007,3539
0130-001,2015,9,11,19,1791,2270,4061,4007
0130-001,2015,9,11,20,1478,1977,3455,4061
0130-001,2015,9,11,21,1312,1562,2874,3455
0130-001,2015,9,11,22,1180,1043,2223,2874
0130-001,2015,9,11,23,802,757,1559,2223
0130-001,2015,9,11,24,247,461,708,1559
0130-001,2015,9,12,1,228,315,543,708
0130-001,2015,9,12,2,199,241,440,543
0130-001,2015,9,12,3,163,206,369,440
0130-001,2015,9,12,4,189,141,330,369
0130-001,2015,9,12,5,218,187,405,330
0130-001,2015,9,12,6,507,369,876,405
0130-001,2015,9,12,7,1136,640,1776,876
0130-001,2015,9,12,8,1560,1153,2713,1776
0130-001,2015,9,12,9,1540,1708,3248,2713
0130-001,2015,9,12,10,1548,1936,3484,3248
0130-001,2015,9,12,11,1534,2188,3722,3484
0130-001,2015,9,12,12,1537,2275,3812,3722
0130-001,2015,9,12,13,1454,2248,3702,3812
0130-001,2015,9,12,14,1420,2178,3598,3702
0130-001,2015,9,12,15,1490,1944,3434,3598
0130-001,2015,9,12,16,1638,1748,3386,3434
0130-001,2015,9,12,17,1696,1752,3448,3386
0130-001,2015,9,12,18,1924,2063,3987,3448
0130-001,2015,9,12,19,1876,1873,3749,3987
0130-001,2015,9,12,20,1380,1239,2619,3749
0130-001,2015,9,12,21,1302,1015,2317,2619
0130-001,2015,9,12,22,998,838,1836,2317
0130-001,2015,9,12,23,508,550,1058,1836
0130-001,2015,9,12,24,390,227,617,1058
0130-001,2015,9,13,1,296,123,419,617
0130-001,2015,9,13,2,219,95,314,419
0130-001,2015,9,13,3,184,68,252,314
0130-001,2015,9,13,4,152,143,295,252
0130-001,2015,9,13,5,154,112,266,295
0130-001,2015,9,13,6,262,235,497,266
0130-001,2015,9,13,7,444,479,923,497
0130-001,2015,9,13,8,460,682,1142,923
0130-001,2015,9,13,9,562,1011,1573,1142
0130-001,2015,9,13,10,659,1262,1921,1573
0130-001,2015,9,13,11,862,1264,2126,1921
0130-001,2015,9,13,12,1000,1178,2178,2126
0130-001,2015,9,13,13,1208,1222,2430,2178
0130-001,2015,9,13,14,1403,1232,2635,2430
0130-001,2015,9,13,15,1550,1255,2805,2635
0130-001,2015,9,13,16,1620,1404,3024,2805
0130-001,2015,9,13,17,1734,1360,3094,3024
0130-001,2015,9,13,18,1744,1471,3215,3094
0130-001,2015,9,13,19,1599,1272,2871,3215
0130-001,2015,9,13,20,1460,1016,2476,2871
0130-001,2015,9,13,21,1335,886,2221,2476
0130-001,2015,9,13,22,1039,776,1815,2221
0130-001,2015,9,13,23,718,502,1220,1815
0130-001,2015,9,13,24,418,291,709,1220
0130-001,2015,9,14,1,255,187,442,709
0130-001,2015,9,14,2,141,100,241,442
0130-001,2015,9,14,3,101,58,159,241
0130-001,2015,9,14,4,108,87,195,159
0130-001,2015,9,14,5,143,116,259,195
0130-001,2015,9,14,6,562,321,883,259
0130-001,2015,9,14,7,1797,792,2589,883
0130-001,2015,9,14,8,1869,1541,3410,2589
0130-001,2015,9,14,9,1958,1756,3714,3410
0130-001,2015,9,14,10,1879,1587,3466,3714
0130-001,2015,9,14,11,1789,1583,3372,3466
0130-001,2015,9,14,12,1652,1593,3245,3372
0130-001,2015,9,14,13,1426,1399,2825,3245
0130-001,2015,9,14,14,1679,1533,3212,2825
0130-001,2015,9,14,15,1802,1643,3445,3212
0130-001,2015,9,14,16,1855,1693,3548,3445
0130-001,2015,9,14,17,1612,1890,3502,3548
0130-001,2015,9,14,18,1700,2225,3925,3502
0130-001,2015,9,14,19,1657,2279,3936,3925
0130-001,2015,9,14,20,1306,1896,3202,3936
0130-001,2015,9,14,21,1087,1545,2632,3202
0130-001,2015,9,14,22,1024,1118,2142,2632
0130-001,2015,9,14,23,729,677,1406,2142
0130-001,2015,9,14,24,483,360,843,1406
0130-001,2015,9,15,1,310,275,585,843
0130-001,2015,9,15,2,201,187,388,585
0130-001,2015,9,15,3,158,129,287,388
0130-001,2015,9,15,4,117,97,214,287
0130-001,2015,9,15,5,166,162,328,214
0130-001,2015,9,15,6,541,310,851,328
0130-001,2015,9,15,7,1719,715,2434,851
0130-001,2015,9,15,8,1849,1422,3271,2434
0130-001,2015,9,15,9,2005,1785,3790,3271
0130-001,2015,9,15,10,1944,1600,3544,3790
0130-001,2015,9,15,11,1758,1477,3235,3544
0130-001,2015,9,15,12,1574,1458,3032,3235
0130-001,2015,9,15,13,1324,1447,2771,3032
0130-001,2015,9,15,14,1652,1625,3277,2771
0130-001,2015,9,15,15,1692,1547,3239,3277
0130-001,2015,9,15,16,1708,1837,3545,3239
0130-001,2015,9,15,17,1621,1883,3504,3545
0130-001,2015,9,15,18,1727,2107,3834,3504
0130-001,2015,9,15,19,1565,2317,3882,3834
0130-001,2015,9,15,20,1277,1806,3083,3882
0130-001,2015,9,15,21,1113,1575,2688,3083
0130-001,2015,9,15,22,1121,1205,2326,2688
0130-001,2015,9,15,23,825,669,1494,2326
0130-001,2015,9,15,24,463,388,851,1494
0130-001,2015,9,16,1,391,256,647,851
0130-001,2015,9,16,2,213,168,381,647
0130-001,2015,9,16,3,143,173,316,381
0130-001,2015,9,16,4,134,135,269,316
0130-001,2015,9,16,5,190,135,325,269
0130-001,2015,9,16,6,558,360,918,325
0130-001,2015,9,16,7,1722,753,2475,918
0130-001,2015,9,16,8,1891,1573,3464,2475
0130-001,2015,9,16,9,2002,1767,3769,3464
0130-001,2015,9,16,10,1943,1581,3524,3769
0130-001,2015,9,16,11,1761,1497,3258,3524
0130-001,2015,9,16,12,1592,1527,3119,3258
0130-001,2015,9,16,13,1366,1391,2757,3119
0130-001,2015,9,16,14,1703,1610,3313,2757
0130-001,2015,9,16,15,1748,1742,3490,3313
0130-001,2015,9,16,16,1831,1708,3539,3490
0130-001,2015,9,16,17,1587,1714,3301,3539
0130-001,2015,9,16,18,1719,2261,3980,3301
0130-001,2015,9,16,19,1655,2441,4096,3980
0130-001,2015,9,16,20,1397,1971,3368,4096
0130-001,2015,9,16,21,1144,1460,2604,3368
0130-001,2015,9,16,22,1176,1157,2333,2604
0130-001,2015,9,16,23,839,700,1539,2333
0130-001,2015,9,16,24,502,433,935,1539
0130-001,2015,9,17,1,336,218,554,935
0130-001,2015,9,17,2,226,181,407,554
0130-001,2015,9,17,3,177,164,341,407
0130-001,2015,9,17,4,143,120,263,341
0130-001,2015,9,17,5,209,171,380,263
0130-001,2015,9,17,6,519,302,821,380
0130-001,2015,9,17,7,1688,682,2370,821
0130-001,2015,9,17,8,1871,1481,3352,2370
0130-001,2015,9,17,9,2037,1844,3881,3352
0130-001,2015,9,17,10,1972,1581,3553,3881
0130-001,2015,9,17,11,1775,1489,3264,3553
0130-001,2015,9,17,12,1669,1556,3225,3264
0130-001,2015,9,17,13,1453,1395,2848,3225
0130-001,2015,9,17,14,1686,1643,3329,2848
0130-001,2015,9,17,15,1842,1689,3531,3329
0130-001,2015,9,17,16,1588,1779,3367,3531
0130-001,2015,9,17,17,1748,1804,3552,3367
0130-001,2015,9,17,18,1796,2422,4218,3552
0130-001,2015,9,17,19,1611,2981,4592,4218
0130-001,2015,9,17,20,1311,2040,3351,4592
0130-001,2015,9,17,21,1099,1693,2792,3351
0130-001,2015,9,17,22,1138,1166,2304,2792
0130-001,2015,9,17,23,776,711,1487,2304
0130-001,2015,9,17,24,567,406,973,1487
0130-001,2015,9,18,1,346,256,602,973
0130-001,2015,9,18,2,196,181,377,602
0130-001,2015,9,18,3,172,116,288,377
0130-001,2015,9,18,4,151,162,313,288
0130-001,2015,9,18,5,209,193,402,313
0130-001,2015,9,18,6,557,348,905,402
0130-001,2015,9,18,7,1657,702,2359,905
0130-001,2015,9,18,8,1869,1502,3371,2359
0130-001,2015,9,18,9,1935,1754,3689,3371
0130-001,2015,9,18,10,1939,1585,3524,3689
0130-001,2015,9,18,11,1878,1545,3423,3524
0130-001,2015,9,18,12,1644,1566,3210,3423
0130-001,2015,9,18,13,1446,1635,3081,3210
0130-001,2015,9,18,14,1472,1658,3130,3081
0130-001,2015,9,18,15,1558,1775,3333,3130
0130-001,2015,9,18,16,1626,1833,3459,3333
0130-001,2015,9,18,17,1813,1904,3717,3459
0130-001,2015,9,18,18,1867,2205,4072,3717
0130-001,2015,9,18,19,1936,2407,4343,4072
0130-001,2015,9,18,20,1713,2063,3776,4343
0130-001,2015,9,18,21,1301,1648,2949,3776
0130-001,2015,9,18,22,1202,1193,2395,2949
0130-001,2015,9,18,23,894,730,1624,2395
0130-001,2015,9,18,24,579,465,1044,1624
0130-001,2015,9,19,1,483,394,877,1044
0130-001,2015,9,19,2,307,248,555,877
0130-001,2015,9,19,3,249,214,463,555
0130-001,2015,9,19,4,237,185,422,463
0130-001,2015,9,19,5,218,216,434,422
0130-001,2015,9,19,6,569,312,881,434
0130-001,2015,9,19,7,1159,648,1807,881
0130-001,2015,9,19,8,1751,1126,2877,1807
0130-001,2015,9,19,9,1870,1769,3639,2877
0130-001,2015,9,19,10,1660,1750,3410,3639
0130-001,2015,9,19,11,1765,1840,3605,3410
0130-001,2015,9,19,12,1878,1844,3722,3605
0130-001,2015,9,19,13,1729,1833,3562,3722
0130-001,2015,9,19,14,1306,1508,2814,3562
0130-001,2015,9,19,15,1522,1641,3163,2814
0130-001,2015,9,19,16,1672,1437,3109,3163
0130-001,2015,9,19,17,1818,1817,3635,3109
0130-001,2015,9,19,18,1790,2089,3879,3635
0130-001,2015,9,19,19,1820,1969,3789,3879
0130-001,2015,9,19,20,1375,1395,2770,3789
0130-001,2015,9,19,21,1079,1063,2142,2770
0130-001,2015,9,19,22,1008,857,1865,2142
0130-001,2015,9,19,23,781,552,1333,1865
0130-001,2015,9,19,24,519,410,929,1333
0130-001,2015,9,20,1,380,323,703,929
0130-001,2015,9,20,2,276,206,482,703
0130-001,2015,9,20,3,233,158,391,482
0130-001,2015,9,20,4,199,135,334,391
0130-001,2015,9,20,5,184,114,298,334
0130-001,2015,9,20,6,387,267,654,298
0130-001,2015,9,20,7,676,461,1137,654
0130-001,2015,9,20,8,878,750,1628,1137
0130-001,2015,9,20,9,1003,976,1979,1628
0130-001,2015,9,20,10,1154,1234,2388,1979
0130-001,2015,9,20,11,1185,1312,2497,2388
0130-001,2015,9,20,12,1103,1301,2404,2497
0130-001,2015,9,20,13,1310,1406,2716,2404
0130-001,2015,9,20,14,1352,1385,2737,2716
0130-001,2015,9,20,15,1489,1512,3001,2737
0130-001,2015,9,20,16,1559,1558,3117,3001
0130-001,2015,9,20,17,1535,1560,3095,3117
0130-001,2015,9,20,18,1575,1574,3149,3095
0130-001,2015,9,20,19,1530,1401,2931,3149
0130-001,2015,9,20,20,1200,1091,2291,2931
0130-001,2015,9,20,21,1101,940,2041,2291
0130-001,2015,9,20,22,942,717,1659,2041
0130-001,2015,9,20,23,634,417,1051,1659
0130-001,2015,9,20,24,386,256,642,1051
0130-001,2015,9,21,1,264,173,437,642
0130-001,2015,9,21,2,185,125,310,437
0130-001,2015,9,21,3,141,64,205,310
0130-001,2015,9,21,4,105,97,202,205
0130-001,2015,9,21,5,168,183,351,202
0130-001,2015,9,21,6,560,321,881,351
0130-001,2015,9,21,7,1744,721,2465,881
0130-001,2015,9,21,8,1908,1512,3420,2465
0130-001,2015,9,21,9,2059,1839,3898,3420
0130-001,2015,9,21,10,1799,1666,3465,3898
0130-001,2015,9,21,11,1794,1744,3538,3465
0130-001,2015,9,21,12,1789,1618,3407,3538
0130-001,2015,9,21,13,1582,1554,3136,3407
0130-001,2015,9,21,14,1806,1645,3451,3136
0130-001,2015,9,21,15,1876,1671,3547,3451
0130-001,2015,9,21,16,1744,1837,3581,3547
0130-001,2015,9,21,17,1667,1919,3586,3581
0130-001,2015,9,21,18,1701,2180,3881,3586
0130-001,2015,9,21,19,1633,2320,3953,3881
0130-001,2015,9,21,20,1376,1802,3178,3953
0130-001,2015,9,21,21,1168,1608,2776,3178
0130-001,2015,9,21,22,1101,1168,2269,2776
0130-001,2015,9,21,23,771,696,1467,2269
0130-001,2015,9,21,24,516,406,922,1467
0130-001,2015,9,22,1,327,292,619,922
0130-001,2015,9,22,2,233,202,435,619
0130-001,2015,9,22,3,144,133,277,435
0130-001,2015,9,22,4,134,127,261,277
0130-001,2015,9,22,5,187,145,332,261
0130-001,2015,9,22,6,579,348,927,332
0130-001,2015,9,22,7,1648,702,2350,927
0130-001,2015,9,22,8,1908,1539,3447,2350
0130-001,2015,9,22,9,2030,1846,3876,3447
0130-001,2015,9,22,10,1806,1662,3468,3876
0130-001,2015,9,22,11,1888,1648,3536,3468
0130-001,2015,9,22,12,1792,1629,3421,3536
0130-001,2015,9,22,13,1470,1512,2982,3421
0130-001,2015,9,22,14,1773,1783,3556,2982
0130-001,2015,9,22,15,1814,1785,3599,3556
0130-001,2015,9,22,16,1741,1863,3604,3599
0130-001,2015,9,22,17,1787,1906,3693,3604
0130-001,2015,9,22,18,1838,2225,4063,3693
0130-001,2015,9,22,19,1628,2278,3906,4063
0130-001,2015,9,22,20,1354,1879,3233,3906
0130-001,2015,9,22,21,1234,1562,2796,3233
0130-001,2015,9,22,22,1125,1220,2345,2796
0130-001,2015,9,22,23,873,726,1599,2345
0130-001,2015,9,22,24,517,448,965,1599
0130-001,2015,9,23,1,360,291,651,965
0130-001,2015,9,23,2,245,185,430,651
0130-001,2015,9,23,3,187,154,341,430
0130-001,2015,9,23,4,151,135,286,341
0130-001,2015,9,23,5,201,162,363,286
0130-001,2015,9,23,6,516,329,845,363
0130-001,2015,9,23,7,1717,698,2415,845
0130-001,2015,9,23,8,1852,1483,3335,2415
0130-001,2015,9,23,9,1995,1900,3895,3335
0130-001,2015,9,23,10,1886,1689,3575,3895
0130-001,2015,9,23,11,1842,1633,3475,3575
0130-001,2015,9,23,12,1999,1593,3592,3475
0130-001,2015,9,23,13,1600,1547,3147,3592
0130-001,2015,9,23,14,1806,1698,3504,3147
0130-001,2015,9,23,15,1869,1825,3694,3504
0130-001,2015,9,23,16,1941,1708,3649,3694
0130-001,2015,9,23,17,1707,1956,3663,3649
0130-001,2015,9,23,18,1809,2248,4057,3663
0130-001,2015,9,23,19,1667,2341,4008,4057
0130-001,2015,9,23,20,1412,1894,3306,4008
0130-001,2015,9,23,21,1253,1589,2842,3306
0130-001,2015,9,23,22,1108,1210,2318,2842
0130-001,2015,9,23,23,858,746,1604,2318
0130-001,2015,9,23,24,584,490,1074,1604
0130-001,2015,9,24,1,386,310,696,1074
0130-001,2015,9,24,2,255,158,413,696
0130-001,2015,9,24,3,156,146,302,413
0130-001,2015,9,24,4,165,160,325,302
0130-001,2015,9,24,5,211,189,400,325
0130-001,2015,9,24,6,524,275,799,400
0130-001,2015,9,24,7,1720,759,2479,799
0130-001,2015,9,24,8,1876,1497,3373,2479
0130-001,2015,9,24,9,2023,1862,3885,3373
0130-001,2015,9,24,10,1931,1635,3566,3885
0130-001,2015,9,24,11,1794,1752,3546,3566
0130-001,2015,9,24,12,1620,1645,3265,3546
0130-001,2015,9,24,13,1410,1604,3014,3265
0130-001,2015,9,24,14,1666,1785,3451,3014
0130-001,2015,9,24,15,1834,1825,3659,3451
0130-001,2015,9,24,16,1614,1806,3420,3659
0130-001,2015,9,24,17,1710,1769,3479,3420
0130-001,2015,9,24,18,1732,2261,3993,3479
0130-001,2015,9,24,19,1636,2389,4025,3993
0130-001,2015,9,24,20,1330,2084,3414,4025
0130-001,2015,9,24,21,1098,1727,2825,3414
0130-001,2015,9,24,22,1127,1249,2376,2825
0130-001,2015,9,24,23,798,834,1632,2376
0130-001,2015,9,24,24,565,475,1040,1632
0130-001,2015,9,25,1,163,310,473,1040
0130-001,2015,9,25,2,125,246,371,473
0130-001,2015,9,25,3,141,164,305,371
0130-001,2015,9,25,4,110,183,293,305
0130-001,2015,9,25,5,107,160,267,293
0130-001,2015,9,25,6,542,315,857,267
0130-001,2015,9,25,7,1675,646,2321,857
0130-001,2015,9,25,8,1896,1481,3377,2321
0130-001,2015,9,25,9,1974,1839,3813,3377
0130-001,2015,9,25,10,1892,1729,3621,3813
0130-001,2015,9,25,11,1804,1856,3660,3621
0130-001,2015,9,25,12,1617,1752,3369,3660
0130-001,2015,9,25,13,1450,2063,3513,3369
0130-001,2015,9,25,14,1552,2109,3661,3513
0130-001,2015,9,25,15,1592,2223,3815,3661
0130-001,2015,9,25,16,1648,2365,4013,3815
0130-001,2015,9,25,17,1692,2499,4191,4013
0130-001,2015,9,25,18,1671,2559,4230,4191
0130-001,2015,9,25,19,1510,2499,4009,4230
0130-001,2015,9,25,20,1291,2298,3589,4009
0130-001,2015,9,25,21,1015,2369,3384,3589
0130-001,2015,9,25,22,925,2081,3006,3384
0130-001,2015,9,25,23,796,1854,2650,3006
0130-001,2015,9,25,24,579,903,1482,2650
0130-001,2015,9,26,1,430,703,1133,1482
0130-001,2015,9,26,2,310,663,973,1133
0130-001,2015,9,26,3,216,698,914,973
0130-001,2015,9,26,4,168,1214,1382,914
0130-001,2015,9,26,5,170,1560,1730,1382
0130-001,2015,9,26,6,297,1706,2003,1730
0130-001,2015,9,26,7,504,1894,2398,2003
0130-001,2015,9,26,8,700,2054,2754,2398
0130-001,2015,9,26,9,853,2042,2895,2754
0130-001,2015,9,26,10,1154,2234,3388,2895
0130-001,2015,9,26,11,1381,2311,3692,3388
0130-001,2015,9,26,12,1509,2296,3805,3692
0130-001,2015,9,26,13,1359,2278,3637,3805
0130-001,2015,9,26,14,1154,1975,3129,3637
0130-001,2015,9,26,15,931,1771,2702,3129
0130-001,2015,9,26,16,972,1439,2411,2702
0130-001,2015,9,26,17,1072,1232,2304,2411
0130-001,2015,9,26,18,1061,1232,2293,2304
0130-001,2015,9,26,19,1017,1070,2087,2293
0130-001,2015,9,26,20,783,832,1615,2087
0130-001,2015,9,26,21,676,709,1385,1615
0130-001,2015,9,26,22,582,582,1164,1385
0130-001,2015,9,26,23,469,429,898,1164
0130-001,2015,9,26,24,348,256,604,898
0130-001,2015,9,27,1,228,208,436,604
0130-001,2015,9,27,2,149,120,269,436
0130-001,2015,9,27,3,132,87,219,269
0130-001,2015,9,27,4,88,58,146,219
0130-001,2015,9,27,5,119,75,194,146
0130-001,2015,9,27,6,185,148,333,194
0130-001,2015,9,27,7,555,360,915,333
0130-001,2015,9,27,8,669,945,1614,915
0130-001,2015,9,27,9,782,1084,1866,1614
0130-001,2015,9,27,10,906,1241,2147,1866
0130-001,2015,9,27,11,1024,1860,2884,2147
0130-001,2015,9,27,12,1052,2006,3058,2884
0130-001,2015,9,27,13,1259,2029,3288,3058
0130-001,2015,9,27,14,1378,2073,3451,3288
0130-001,2015,9,27,15,1520,2261,3781,3451
0130-001,2015,9,27,16,2110,2393,4503,3781
0130-001,2015,9,27,17,2045,2378,4423,4503
0130-001,2015,9,27,18,1997,2403,4400,4423
0130-001,2015,9,27,19,1897,2259,4156,4400
0130-001,2015,9,27,20,1542,1485,3027,4156
0130-001,2015,9,27,21,1390,997,2387,3027
0130-001,2015,9,27,22,1416,613,2029,2387
0130-001,2015,9,27,23,1043,456,1499,2029
0130-001,2015,9,27,24,803,331,1134,1499
0130-001,2015,9,28,1,587,170,757,1134
0130-001,2015,9,28,2,286,121,407,757
0130-001,2015,9,28,3,201,68,269,407
0130-001,2015,9,28,4,134,70,204,269
0130-001,2015,9,28,5,132,68,200,204
0130-001,2015,9,28,6,170,118,288,200
0130-001,2015,9,28,7,343,179,522,288
0130-001,2015,9,28,8,481,289,770,522
0130-001,2015,9,28,9,603,463,1066,770
0130-001,2015,9,28,10,942,682,1624,1066
0130-001,2015,9,28,11,1693,936,2629,1624
0130-001,2015,9,28,12,1867,1055,2922,2629
0130-001,2015,9,28,13,1660,1082,2742,2922
0130-001,2015,9,28,14,1717,1072,2789,2742
0130-001,2015,9,28,15,1808,1134,2942,2789
0130-001,2015,9,28,16,1784,1162,2946,2942
0130-001,2015,9,28,17,1902,1105,3007,2946
0130-001,2015,9,28,18,1982,1072,3054,3007
0130-001,2015,9,28,19,1934,934,2868,3054
0130-001,2015,9,28,20,1890,792,2682,2868
0130-001,2015,9,28,21,1585,663,2248,2682
0130-001,2015,9,28,22,1515,565,2080,2248
0130-001,2015,9,28,23,1503,406,1909,2080
0130-001,2015,9,28,24,1322,298,1620,1909
0130-001,2015,9,29,1,1142,202,1344,1620
0130-001,2015,9,29,2,589,179,768,1344
0130-001,2015,9,29,3,327,118,445,768
0130-001,2015,9,29,4,192,102,294,445
0130-001,2015,9,29,5,172,91,263,294
0130-001,2015,9,29,6,238,139,377,263
0130-001,2015,9,29,7,505,237,742,377
0130-001,2015,9,29,8,801,427,1228,742
0130-001,2015,9,29,9,810,690,1500,1228
0130-001,2015,9,29,10,921,911,1832,1500
0130-001,2015,9,29,11,1215,1124,2339,1832
0130-001,2015,9,29,12,1482,1168,2650,2339
0130-001,2015,9,29,13,1574,1237,2811,2650
0130-001,2015,9,29,14,1421,1320,2741,2811
0130-001,2015,9,29,15,1527,1382,2909,2741
0130-001,2015,9,29,16,1417,1303,2720,2909
0130-001,2015,9,29,17,1472,1232,2704,2720
0130-001,2015,9,29,18,1501,1318,2819,2704
0130-001,2015,9,29,19,1371,1234,2605,2819
0130-001,2015,9,29,20,1205,905,2110,2605
0130-001,2015,9,29,21,1005,801,1806,2110
0130-001,2015,9,29,22,972,590,1562,1806
0130-001,2015,9,29,23,716,398,1114,1562
0130-001,2015,9,29,24,485,252,737,1114
0130-001,2015,9,30,1,297,198,495,737
0130-001,2015,9,30,2,175,93,268,495
0130-001,2015,9,30,3,129,102,231,268
0130-001,2015,9,30,4,124,100,224,231
0130-001,2015,9,30,5,168,143,311,224
0130-001,2015,9,30,6,493,269,762,311
0130-001,2015,9,30,7,1436,596,2032,762
0130-001,2015,9,30,8,1895,1395,3290,2032
0130-001,2015,9,30,9,1831,1614,3445,3290
0130-001,2015,9,30,10,1636,1549,3185,3445
0130-001,2015,9,30,11,1553,1504,3057,3185
0130-001,2015,9,30,12,1525,1499,3024,3057
0130-001,2015,9,30,13,1457,1520,2977,3024
0130-001,2015,9,30,14,1565,1614,3179,2977
0130-001,2015,9,30,15,1645,1683,3328,3179
0130-001,2015,9,30,16,1708,1616,3324,3328
0130-001,2015,9,30,17,1506,1689,3195,3324
0130-001,2015,9,30,18,1633,2052,3685,3195
0130-001,2015,9,30,19,1542,2225,3767,3685
0130-001,2015,9,30,20,1229,1604,2833,3767
0130-001,2015,9,30,21,990,1268,2258,2833
0130-001,2015,9,30,22,897,897,1794,2258
0130-001,2015,9,30,23,728,619,1347,1794
0130-001,2015,9,30,24,476,406,882,1347
0130-001,2015,10,1,1,361,291,652,882
0130-001,2015,10,1,2,240,159,399,652
0130-001,2015,10,1,3,166,50,216,399
0130-001,2015,10,1,4,154,76,230,216
0130-001,2015,10,1,5,210,190,400,230
0130-001,2015,10,1,6,522,311,833,400
0130-001,2015,10,1,7,1704,614,2318,833
0130-001,2015,10,1,8,1874,1315,3189,2318
0130-001,2015,10,1,9,2030,1159,3189,3189
0130-001,2015,10,1,10,1952,1333,3285,3189
0130-001,2015,10,1,11,1784,1713,3497,3285
0130-001,2015,10,1,12,1644,1612,3256,3497
0130-001,2015,10,1,13,1432,1514,2946,3256
0130-001,2015,10,1,14,1676,1697,3373,2946
0130-001,2015,10,1,15,1838,1789,3627,3373
0130-001,2015,10,1,16,1601,1793,3394,3627
0130-001,2015,10,1,17,1729,1838,3567,3394
0130-001,2015,10,1,18,1764,2306,4070,3567
0130-001,2015,10,1,19,1624,2375,3999,4070
0130-001,2015,10,1,20,1320,1820,3140,3999
0130-001,2015,10,1,21,1098,1559,2657,3140
0130-001,2015,10,1,22,1132,1126,2258,2657
0130-001,2015,10,1,23,787,719,1506,2258
0130-001,2015,10,1,24,566,447,1013,1506
0130-001,2015,10,2,1,254,302,556,1013
0130-001,2015,10,2,2,160,204,364,556
0130-001,2015,10,2,3,156,152,308,364
0130-001,2015,10,2,4,130,114,244,308
0130-001,2015,10,2,5,158,166,324,244
0130-001,2015,10,2,6,550,344,894,324
0130-001,2015,10,2,7,1666,780,2446,894
0130-001,2015,10,2,8,1882,1612,3494,2446
0130-001,2015,10,2,9,1954,1985,3939,3494
0130-001,2015,10,2,10,1916,1822,3738,3939
0130-001,2015,10,2,11,1841,1967,3808,3738
0130-001,2015,10,2,12,1630,1907,3537,3808
0130-001,2015,10,2,13,1448,1762,3210,3537
0130-001,2015,10,2,14,1695,1867,3562,3210
0130-001,2015,10,2,15,1961,1969,3930,3562
0130-001,2015,10,2,16,1873,2034,3907,3930
0130-001,2015,10,2,17,1918,2110,4028,3907
0130-001,2015,10,2,18,2031,2619,4650,4028
0130-001,2015,10,2,19,1980,2639,4619,4650
0130-001,2015,10,2,20,1718,2260,3978,4619
0130-001,2015,10,2,21,1306,1806,3112,3978
0130-001,2015,10,2,22,1145,1253,2398,3112
0130-001,2015,10,2,23,923,871,1794,2398
0130-001,2015,10,2,24,653,623,1276,1794
0130-001,2015,10,3,1,428,398,826,1276
0130-001,2015,10,3,2,346,242,588,826
0130-001,2015,10,3,3,243,201,444,588
0130-001,2015,10,3,4,230,188,418,444
0130-001,2015,10,3,5,220,199,419,418
0130-001,2015,10,3,6,465,333,798,419
0130-001,2015,10,3,7,1176,583,1759,798
0130-001,2015,10,3,8,1673,1068,2741,1759
0130-001,2015,10,3,9,1539,1456,2995,2741
0130-001,2015,10,3,10,1741,1849,3590,2995
0130-001,2015,10,3,11,1831,2155,3986,3590
0130-001,2015,10,3,12,1860,2068,3928,3986
0130-001,2015,10,3,13,1526,2414,3940,3928
0130-001,2015,10,3,14,1586,2179,3765,3940
0130-001,2015,10,3,15,1720,1905,3625,3765
0130-001,2015,10,3,16,1607,1782,3389,3625
0130-001,2015,10,3,17,1693,1777,3470,3389
0130-001,2015,10,3,18,1889,2237,4126,3470
0130-001,2015,10,3,19,1792,2114,3906,4126
0130-001,2015,10,3,20,1337,1347,2684,3906
0130-001,2015,10,3,21,1067,1123,2190,2684
0130-001,2015,10,3,22,1017,869,1886,2190
0130-001,2015,10,3,23,684,581,1265,1886
0130-001,2015,10,3,24,525,398,923,1265
0130-001,2015,10,4,1,372,335,707,923
0130-001,2015,10,4,2,273,235,508,707
0130-001,2015,10,4,3,218,157,375,508
0130-001,2015,10,4,4,158,152,310,375
0130-001,2015,10,4,5,201,141,342,310
0130-001,2015,10,4,6,354,244,598,342
0130-001,2015,10,4,7,642,393,1035,598
0130-001,2015,10,4,8,809,753,1562,1035
0130-001,2015,10,4,9,982,1036,2018,1562
0130-001,2015,10,4,10,968,1193,2161,2018
0130-001,2015,10,4,11,1256,1373,2629,2161
0130-001,2015,10,4,12,1147,1476,2623,2629
0130-001,2015,10,4,13,1176,1478,2654,2623
0130-001,2015,10,4,14,1487,1527,3014,2654
0130-001,2015,10,4,15,1767,1608,3375,3014
0130-001,2015,10,4,16,1939,1521,3460,3375
0130-001,2015,10,4,17,1749,1588,3337,3460
0130-001,2015,10,4,18,1736,1887,3623,3337
0130-001,2015,10,4,19,1633,1476,3109,3623
0130-001,2015,10,4,20,1258,1083,2341,3109
0130-001,2015,10,4,21,1065,905,1970,2341
0130-001,2015,10,4,22,925,710,1635,1970
0130-001,2015,10,4,23,603,501,1104,1635
0130-001,2015,10,4,24,410,297,707,1104
0130-001,2015,10,5,1,280,201,481,707
0130-001,2015,10,5,2,127,101,228,481
0130-001,2015,10,5,3,119,108,227,228
0130-001,2015,10,5,4,115,110,225,227
0130-001,2015,10,5,5,195,143,338,225
0130-001,2015,10,5,6,603,347,950,338
0130-001,2015,10,5,7,1918,871,2789,950
0130-001,2015,10,5,8,2136,1791,3927,2789
0130-001,2015,10,5,9,2206,2034,4240,3927
0130-001,2015,10,5,10,1823,1782,3605,4240
0130-001,2015,10,5,11,1916,1878,3794,3605
0130-001,2015,10,5,12,1741,1847,3588,3794
0130-001,2015,10,5,13,1491,1570,3061,3588
0130-001,2015,10,5,14,1736,1860,3596,3061
0130-001,2015,10,5,15,1831,1923,3754,3596
0130-001,2015,10,5,16,2044,2041,4085,3754
0130-001,2015,10,5,17,1842,2121,3963,4085
0130-001,2015,10,5,18,2013,2507,4520,3963
0130-001,2015,10,5,19,1926,2514,4440,4520
0130-001,2015,10,5,20,1442,1873,3315,4440
0130-001,2015,10,5,21,1234,1708,2942,3315
0130-001,2015,10,5,22,1059,1362,2421,2942
0130-001,2015,10,5,23,768,780,1548,2421
0130-001,2015,10,5,24,521,405,926,1548
0130-001,2015,10,6,1,364,288,652,926
0130-001,2015,10,6,2,261,184,445,652
0130-001,2015,10,6,3,154,150,304,445
0130-001,2015,10,6,4,170,137,307,304
0130-001,2015,10,6,5,203,139,342,307
0130-001,2015,10,6,6,661,358,1019,342
0130-001,2015,10,6,7,1910,829,2739,1019
0130-001,2015,10,6,8,2186,1744,3930,2739
0130-001,2015,10,6,9,2201,2007,4208,3930
0130-001,2015,10,6,10,1953,1847,3800,4208
0130-001,2015,10,6,11,1955,1802,3757,3800
0130-001,2015,10,6,12,1805,1806,3611,3757
0130-001,2015,10,6,13,1535,1688,3223,3611
0130-001,2015,10,6,14,1780,1896,3676,3223
0130-001,2015,10,6,15,1951,2070,4021,3676
0130-001,2015,10,6,16,2041,1965,4006,4021
0130-001,2015,10,6,17,1974,2106,4080,4006
0130-001,2015,10,6,18,1772,2557,4329,4080
0130-001,2015,10,6,19,1702,2400,4102,4329
0130-001,2015,10,6,20,1372,2032,3404,4102
0130-001,2015,10,6,21,1215,1726,2941,3404
0130-001,2015,10,6,22,1090,1291,2381,2941
0130-001,2015,10,6,23,877,764,1641,2381
0130-001,2015,10,6,24,529,451,980,1641
0130-001,2015,10,7,1,379,286,665,980
0130-001,2015,10,7,2,230,192,422,665
0130-001,2015,10,7,3,173,139,312,422
0130-001,2015,10,7,4,166,130,296,312
0130-001,2015,10,7,5,170,155,325,296
0130-001,2015,10,7,6,572,364,936,325
0130-001,2015,10,7,7,1872,806,2678,936
0130-001,2015,10,7,8,2202,1771,3973,2678
0130-001,2015,10,7,9,2199,2132,4331,3973
0130-001,2015,10,7,10,2105,1873,3978,4331
0130-001,2015,10,7,11,1860,1900,3760,3978
0130-001,2015,10,7,12,1712,1873,3585,3760
0130-001,2015,10,7,13,1495,1552,3047,3585
0130-001,2015,10,7,14,1745,1869,3614,3047
0130-001,2015,10,7,15,1949,2005,3954,3614
0130-001,2015,10,7,16,2009,2074,4083,3954
0130-001,2015,10,7,17,2021,1972,3993,4083
0130-001,2015,10,7,18,1901,2661,4562,3993
0130-001,2015,10,7,19,1716,2696,4412,4562
0130-001,2015,10,7,20,1446,2025,3471,4412
0130-001,2015,10,7,21,1211,1614,2825,3471
0130-001,2015,10,7,22,1135,1260,2395,2825
0130-001,2015,10,7,23,987,713,1700,2395
0130-001,2015,10,7,24,574,427,1001,1700
0130-001,2015,10,8,1,393,338,731,1001
0130-001,2015,10,8,2,257,199,456,731
0130-001,2015,10,8,3,171,161,332,456
0130-001,2015,10,8,4,129,155,284,332
0130-001,2015,10,8,5,179,195,374,284
0130-001,2015,10,8,6,601,349,950,374
0130-001,2015,10,8,7,1899,759,2658,950
0130-001,2015,10,8,8,2132,1706,3838,2658
0130-001,2015,10,8,9,2315,2123,4438,3838
0130-001,2015,10,8,10,2184,1864,4048,4438
0130-001,2015,10,8,11,2029,1876,3905,4048
0130-001,2015,10,8,12,1901,1777,3678,3905
0130-001,2015,10,8,13,1421,1655,3076,3678
0130-001,2015,10,8,14,1671,1847,3518,3076
0130-001,2015,10,8,15,2054,1958,4012,3518
0130-001,2015,10,8,16,2021,2188,4209,4012
0130-001,2015,10,8,17,1930,2213,4143,4209
0130-001,2015,10,8,18,1988,2583,4571,4143
0130-001,2015,10,8,19,1930,2752,4682,4571
0130-001,2015,10,8,20,1600,2291,3891,4682
0130-001,2015,10,8,21,1427,1878,3305,3891
0130-001,2015,10,8,22,1238,1369,2607,3305
0130-001,2015,10,8,23,966,842,1808,2607
0130-001,2015,10,8,24,1007,440,1447,1808
0130-001,2015,10,9,1,208,347,555,1447
0130-001,2015,10,9,2,142,253,395,555
0130-001,2015,10,9,3,148,199,347,395
0130-001,2015,10,9,4,120,184,304,347
0130-001,2015,10,9,5,132,215,347,304
0130-001,2015,10,9,6,546,380,926,347
0130-001,2015,10,9,7,1670,637,2307,926
0130-001,2015,10,9,8,1889,1197,3086,2307
0130-001,2015,10,9,9,1964,1746,3710,3086
0130-001,2015,10,9,10,1904,2048,3952,3710
0130-001,2015,10,9,11,1822,2380,4202,3952
0130-001,2015,10,9,12,1624,2543,4167,4202
0130-001,2015,10,9,13,1449,2460,3909,4167
0130-001,2015,10,9,14,1624,2536,4160,3909
0130-001,2015,10,9,15,1776,2527,4303,4160
0130-001,2015,10,9,16,1760,2541,4301,4303
0130-001,2015,10,9,17,1805,2476,4281,4301
0130-001,2015,10,9,18,1851,2816,4667,4281
0130-001,2015,10,9,19,1662,2574,4236,4667
0130-001,2015,10,9,20,1454,1623,3077,4236
0130-001,2015,10,9,21,1127,1170,2297,3077
0130-001,2015,10,9,22,1054,893,1947,2297
0130-001,2015,10,9,23,859,757,1616,1947
0130-001,2015,10,9,24,539,454,993,1616
0130-001,2015,10,10,1,368,311,679,993
0130-001,2015,10,10,2,288,226,514,679
0130-001,2015,10,10,3,255,172,427,514
0130-001,2015,10,10,4,168,188,356,427
0130-001,2015,10,10,5,199,201,400,356
0130-001,2015,10,10,6,449,347,796,400
0130-001,2015,10,10,7,1003,514,1517,796
0130-001,2015,10,10,8,1712,1070,2782,1517
0130-001,2015,10,10,9,1704,1704,3408,2782
0130-001,2015,10,10,10,1700,1847,3547,3408
0130-001,2015,10,10,11,1798,2112,3910,3547
0130-001,2015,10,10,12,1869,2094,3963,3910
0130-001,2015,10,10,13,1628,1929,3557,3963
0130-001,2015,10,10,14,1446,1887,3333,3557
0130-001,2015,10,10,15,1621,2056,3677,3333
0130-001,2015,10,10,16,1640,1789,3429,3677
0130-001,2015,10,10,17,1756,1815,3571,3429
0130-001,2015,10,10,18,1840,1820,3660,3571
0130-001,2015,10,10,19,1806,1661,3467,3660
0130-001,2015,10,10,20,1356,1059,2415,3467
0130-001,2015,10,10,21,1073,978,2051,2415
0130-001,2015,10,10,22,1012,771,1783,2051
0130-001,2015,10,10,23,732,597,1329,1783
0130-001,2015,10,10,24,522,309,831,1329
0130-001,2015,10,11,1,376,184,560,831
0130-001,2015,10,11,2,274,197,471,560
0130-001,2015,10,11,3,226,152,378,471
0130-001,2015,10,11,4,178,134,312,378
0130-001,2015,10,11,5,192,126,318,312
0130-001,2015,10,11,6,370,224,594,318
0130-001,2015,10,11,7,659,360,1019,594
0130-001,2015,10,11,8,844,612,1456,1019
0130-001,2015,10,11,9,992,931,1923,1456
0130-001,2015,10,11,10,1061,1072,2133,1923
0130-001,2015,10,11,11,1220,1402,2622,2133
0130-001,2015,10,11,12,1125,1572,2697,2622
0130-001,2015,10,11,13,1243,1626,2869,2697
0130-001,2015,10,11,14,1420,1550,2970,2869
0130-001,2015,10,11,15,1628,1592,3220,2970
0130-001,2015,10,11,16,1749,1590,3339,3220
0130-001,2015,10,11,17,1642,2024,3666,3339
0130-001,2015,10,11,18,1656,1583,3239,3666
0130-001,2015,10,11,19,1582,1438,3020,3239
0130-001,2015,10,11,20,1229,958,2187,3020
0130-001,2015,10,11,21,1083,929,2012,2187
0130-001,2015,10,11,22,934,628,1562,2012
0130-001,2015,10,11,23,618,476,1094,1562
0130-001,2015,10,11,24,398,255,653,1094
0130-001,2015,10,12,1,272,239,511,653
0130-001,2015,10,12,2,156,121,277,511
0130-001,2015,10,12,3,130,108,238,277
0130-001,2015,10,12,4,110,94,204,238
0130-001,2015,10,12,5,182,134,316,204
0130-001,2015,10,12,6,582,358,940,316
0130-001,2015,10,12,7,1831,804,2635,940
0130-001,2015,10,12,8,2022,1751,3773,2635
0130-001,2015,10,12,9,2132,2139,4271,3773
0130-001,2015,10,12,10,1811,1856,3667,4271
0130-001,2015,10,12,11,1855,1840,3695,3667
0130-001,2015,10,12,12,1765,1873,3638,3695
0130-001,2015,10,12,13,1536,1748,3284,3638
0130-001,2015,10,12,14,1771,1858,3629,3284
0130-001,2015,10,12,15,1854,2014,3868,3629
0130-001,2015,10,12,16,1894,1972,3866,3868
0130-001,2015,10,12,17,1754,2132,3886,3866
0130-001,2015,10,12,18,1857,2548,4405,3886
0130-001,2015,10,12,19,1780,2544,4324,4405
0130-001,2015,10,12,20,1409,2027,3436,4324
0130-001,2015,10,12,21,1201,1708,2909,3436
0130-001,2015,10,12,22,1080,1242,2322,2909
0130-001,2015,10,12,23,770,773,1543,2322
0130-001,2015,10,12,24,518,427,945,1543
0130-001,2015,10,13,1,346,322,668,945
0130-001,2015,10,13,2,247,175,422,668
0130-001,2015,10,13,3,149,105,254,422
0130-001,2015,10,13,4,152,92,244,254
0130-001,2015,10,13,5,195,192,387,244
0130-001,2015,10,13,6,620,313,933,387
0130-001,2015,10,13,7,1779,893,2672,933
0130-001,2015,10,13,8,2047,1684,3731,2672
0130-001,2015,10,13,9,2116,2166,4282,3731
0130-001,2015,10,13,10,1880,1668,3548,4282
0130-001,2015,10,13,11,1922,1871,3793,3548
0130-001,2015,10,13,12,1798,1885,3683,3793
0130-001,2015,10,13,13,1502,1717,3219,3683
0130-001,2015,10,13,14,1804,1849,3653,3219
0130-001,2015,10,13,15,1932,2063,3995,3653
0130-001,2015,10,13,16,1943,2039,3982,3995
0130-001,2015,10,13,17,1745,2173,3918,3982
0130-001,2015,10,13,18,1736,2562,4298,3918
0130-001,2015,10,13,19,1685,2494,4179,4298
0130-001,2015,10,13,20,1353,1949,3302,4179
0130-001,2015,10,13,21,1122,1704,2826,3302
0130-001,2015,10,13,22,1065,1380,2445,2826
0130-001,2015,10,13,23,830,775,1605,2445
0130-001,2015,10,13,24,531,463,994,1605
0130-001,2015,10,14,1,375,264,639,994
0130-001,2015,10,14,2,241,197,438,639
0130-001,2015,10,14,3,152,137,289,438
0130-001,2015,10,14,4,125,146,271,289
0130-001,2015,10,14,5,185,195,380,271
0130-001,2015,10,14,6,519,367,886,380
0130-001,2015,10,14,7,1749,757,2506,886
0130-001,2015,10,14,8,2068,1715,3783,2506
0130-001,2015,10,14,9,2246,2016,4262,3783
0130-001,2015,10,14,10,2167,1987,4154,4262
0130-001,2015,10,14,11,1963,1722,3685,4154
0130-001,2015,10,14,12,1704,1876,3580,3685
0130-001,2015,10,14,13,1631,1726,3357,3580
0130-001,2015,10,14,14,1831,2003,3834,3357
0130-001,2015,10,14,15,1850,1940,3790,3834
0130-001,2015,10,14,16,1953,2077,4030,3790
0130-001,2015,10,14,17,1747,2152,3899,4030
0130-001,2015,10,14,18,1938,2642,4580,3899
0130-001,2015,10,14,19,1992,2606,4598,4580
0130-001,2015,10,14,20,1256,2001,3257,4598
0130-001,2015,10,14,21,1207,1574,2781,3257
0130-001,2015,10,14,22,1096,1230,2326,2781
0130-001,2015,10,14,23,886,759,1645,2326
0130-001,2015,10,14,24,545,485,1030,1645
0130-001,2015,10,15,1,405,342,747,1030
0130-001,2015,10,15,2,218,224,442,747
0130-001,2015,10,15,3,162,168,330,442
0130-001,2015,10,15,4,156,137,293,330
0130-001,2015,10,15,5,181,188,369,293
0130-001,2015,10,15,6,517,306,823,369
0130-001,2015,10,15,7,1846,829,2675,823
0130-001,2015,10,15,8,2083,1726,3809,2675
0130-001,2015,10,15,9,2267,2166,4433,3809
0130-001,2015,10,15,10,2081,1789,3870,4433
0130-001,2015,10,15,11,1934,1862,3796,3870
0130-001,2015,10,15,12,1712,1853,3565,3796
0130-001,2015,10,15,13,1526,1699,3225,3565
0130-001,2015,10,15,14,1753,1873,3626,3225
0130-001,2015,10,15,15,1895,2074,3969,3626
0130-001,2015,10,15,16,1951,1938,3889,3969
0130-001,2015,10,15,17,1730,2219,3949,3889
0130-001,2015,10,15,18,1774,2445,4219,3949
0130-001,2015,10,15,19,1722,2733,4455,4219
0130-001,2015,10,15,20,1425,2023,3448,4455
0130-001,2015,10,15,21,1269,1668,2937,3448
0130-001,2015,10,15,22,1256,1382,2638,2937
0130-001,2015,10,15,23,947,822,1769,2638
0130-001,2015,10,15,24,603,478,1081,1769
0130-001,2015,10,16,1,366,351,717,1081
0130-001,2015,10,16,2,273,235,508,717
0130-001,2015,10,16,3,162,190,352,508
0130-001,2015,10,16,4,183,150,333,352
0130-001,2015,10,16,5,201,230,431,333
0130-001,2015,10,16,6,515,407,922,431
0130-001,2015,10,16,7,1823,802,2625,922
0130-001,2015,10,16,8,2085,1623,3708,2625
0130-001,2015,10,16,9,2301,2079,4380,3708
0130-001,2015,10,16,10,2046,1777,3823,4380
0130-001,2015,10,16,11,2048,1887,3935,3823
0130-001,2015,10,16,12,2004,1905,3909,3935
0130-001,2015,10,16,13,1574,1920,3494,3909
0130-001,2015,10,16,14,1739,2110,3849,3494
0130-001,2015,10,16,15,1943,2101,4044,3849
0130-001,2015,10,16,16,2101,2186,4287,4044
0130-001,2015,10,16,17,2025,2269,4294,4287
0130-001,2015,10,16,18,2089,2671,4760,4294
0130-001,2015,10,16,19,1932,2641,4573,4760
0130-001,2015,10,16,20,1557,2295,3852,4573
0130-001,2015,10,16,21,1384,1824,3208,3852
0130-001,2015,10,16,22,1259,1326,2585,3208
0130-001,2015,10,16,23,1044,911,1955,2585
0130-001,2015,10,16,24,704,530,1234,1955
0130-001,2015,10,17,1,541,420,961,1234
0130-001,2015,10,17,2,331,284,615,961
0130-001,2015,10,17,3,280,206,486,615
0130-001,2015,10,17,4,255,219,474,486
0130-001,2015,10,17,5,284,224,508,474
0130-001,2015,10,17,6,502,340,842,508
0130-001,2015,10,17,7,1240,744,1984,842
0130-001,2015,10,17,8,1862,1289,3151,1984
0130-001,2015,10,17,9,1916,1844,3760,3151
0130-001,2015,10,17,10,1766,1927,3693,3760
0130-001,2015,10,17,11,1830,2283,4113,3693
0130-001,2015,10,17,12,1866,2322,4188,4113
0130-001,2015,10,17,13,1664,2292,3956,4188
0130-001,2015,10,17,14,1464,2238,3702,3956
0130-001,2015,10,17,15,1634,2204,3838,3702
0130-001,2015,10,17,16,2079,2112,4191,3838
0130-001,2015,10,17,17,2219,2161,4380,4191
0130-001,2015,10,17,18,2202,2420,4622,4380
0130-001,2015,10,17,19,2238,2262,4500,4622
0130-001,2015,10,17,20,1875,1536,3411,4500
0130-001,2015,10,17,21,1438,1248,2686,3411
0130-001,2015,10,17,22,1127,954,2081,2686
0130-001,2015,10,17,23,789,641,1430,2081
0130-001,2015,10,17,24,578,492,1070,1430
0130-001,2015,10,18,1,401,347,748,1070
0130-001,2015,10,18,2,329,253,582,748
0130-001,2015,10,18,3,241,190,431,582
0130-001,2015,10,18,4,175,141,316,431
0130-001,2015,10,18,5,183,161,344,316
0130-001,2015,10,18,6,327,259,586,344
0130-001,2015,10,18,7,690,463,1153,586
0130-001,2015,10,18,8,898,690,1588,1153
0130-001,2015,10,18,9,1048,972,2020,1588
0130-001,2015,10,18,10,1098,1152,2250,2020
0130-001,2015,10,18,11,1320,1527,2847,2250
0130-001,2015,10,18,12,1199,1402,2601,2847
0130-001,2015,10,18,13,1331,1572,2903,2601
0130-001,2015,10,18,14,1491,1594,3085,2903
0130-001,2015,10,18,15,1559,1661,3220,3085
0130-001,2015,10,18,16,1811,1715,3526,3220
0130-001,2015,10,18,17,1838,1800,3638,3526
0130-001,2015,10,18,18,1956,1862,3818,3638
0130-001,2015,10,18,19,1899,1539,3438,3818
0130-001,2015,10,18,20,1619,1186,2805,3438
0130-001,2015,10,18,21,1467,1027,2494,2805
0130-001,2015,10,18,22,1143,847,1990,2494
0130-001,2015,10,18,23,789,527,1316,1990
0130-001,2015,10,18,24,440,362,802,1316
0130-001,2015,10,19,1,307,235,542,802
0130-001,2015,10,19,2,179,155,334,542
0130-001,2015,10,19,3,152,85,237,334
0130-001,2015,10,19,4,131,99,230,237
0130-001,2015,10,19,5,187,161,348,230
0130-001,2015,10,19,6,630,326,956,348
0130-001,2015,10,19,7,1887,793,2680,956
0130-001,2015,10,19,8,2097,1715,3812,2680
0130-001,2015,10,19,9,2342,2099,4441,3812
0130-001,2015,10,19,10,1868,1809,3677,4441
0130-001,2015,10,19,11,1741,1762,3503,3677
0130-001,2015,10,19,12,1720,1731,3451,3503
0130-001,2015,10,19,13,1483,1668,3151,3451
0130-001,2015,10,19,14,1778,1873,3651,3151
0130-001,2015,10,19,15,1782,1833,3615,3651
0130-001,2015,10,19,16,1815,2130,3945,3615
0130-001,2015,10,19,17,1728,1998,3726,3945
0130-001,2015,10,19,18,1868,2536,4404,3726
0130-001,2015,10,19,19,1749,2608,4357,4404
0130-001,2015,10,19,20,1283,1777,3060,4357
0130-001,2015,10,19,21,1162,1724,2886,3060
0130-001,2015,10,19,22,1038,1322,2360,2886
0130-001,2015,10,19,23,750,719,1469,2360
0130-001,2015,10,19,24,496,407,903,1469
0130-001,2015,10,20,1,319,277,596,903
0130-001,2015,10,20,2,267,179,446,596
0130-001,2015,10,20,3,189,130,319,446
0130-001,2015,10,20,4,138,143,281,319
0130-001,2015,10,20,5,189,204,393,281
0130-001,2015,10,20,6,576,329,905,393
0130-001,2015,10,20,7,1658,730,2388,905
0130-001,2015,10,20,8,2116,1748,3864,2388
0130-001,2015,10,20,9,2313,2061,4374,3864
0130-001,2015,10,20,10,2070,1798,3868,4374
0130-001,2015,10,20,11,1879,1744,3623,3868
0130-001,2015,10,20,12,1741,1739,3480,3623
0130-001,2015,10,20,13,1495,1635,3130,3480
0130-001,2015,10,20,14,1840,1849,3689,3130
0130-001,2015,10,20,15,1868,1896,3764,3689
0130-001,2015,10,20,16,1827,2032,3859,3764
0130-001,2015,10,20,17,1662,2005,3667,3859
0130-001,2015,10,20,18,1860,2474,4334,3667
0130-001,2015,10,20,19,1718,2635,4353,4334
0130-001,2015,10,20,20,1310,1869,3179,4353
0130-001,2015,10,20,21,1186,1791,2977,3179
0130-001,2015,10,20,22,1090,1302,2392,2977
0130-001,2015,10,20,23,817,782,1599,2392
0130-001,2015,10,20,24,523,474,997,1599
0130-001,2015,10,21,1,393,326,719,997
0130-001,2015,10,21,2,230,228,458,719
0130-001,2015,10,21,3,210,155,365,458
0130-001,2015,10,21,4,173,112,285,365
0130-001,2015,10,21,5,171,188,359,285
0130-001,2015,10,21,6,579,340,919,359
0130-001,2015,10,21,7,1710,773,2483,919
0130-001,2015,10,21,8,2118,1606,3724,2483
0130-001,2015,10,21,9,2298,2014,4312,3724
0130-001,2015,10,21,10,1980,1907,3887,4312
0130-001,2015,10,21,11,2011,1811,3822,3887
0130-001,2015,10,21,12,1811,1748,3559,3822
0130-001,2015,10,21,13,1549,1719,3268,3559
0130-001,2015,10,21,14,1903,1853,3756,3268
0130-001,2015,10,21,15,2091,2050,4141,3756
0130-001,2015,10,21,16,1912,1943,3855,4141
0130-001,2015,10,21,17,1732,2074,3806,3855
0130-001,2015,10,21,18,1862,2617,4479,3806
0130-001,2015,10,21,19,1679,2660,4339,4479
0130-001,2015,10,21,20,1277,1983,3260,4339
0130-001,2015,10,21,21,1252,1559,2811,3260
0130-001,2015,10,21,22,1207,1228,2435,2811
0130-001,2015,10,21,23,910,766,1676,2435
0130-001,2015,10,21,24,609,483,1092,1676
0130-001,2015,10,22,1,381,338,719,1092
0130-001,2015,10,22,2,253,195,448,719
0130-001,2015,10,22,3,185,159,344,448
0130-001,2015,10,22,4,168,123,291,344
0130-001,2015,10,22,5,175,190,365,291
0130-001,2015,10,22,6,546,315,861,365
0130-001,2015,10,22,7,1776,726,2502,861
0130-001,2015,10,22,8,2132,1588,3720,2502
0130-001,2015,10,22,9,2239,2126,4365,3720
0130-001,2015,10,22,10,2095,1760,3855,4365
0130-001,2015,10,22,11,1963,1878,3841,3855
0130-001,2015,10,22,12,1761,1885,3646,3841
0130-001,2015,10,22,13,1487,1686,3173,3646
0130-001,2015,10,22,14,1924,1827,3751,3173
0130-001,2015,10,22,15,1982,1871,3853,3751
0130-001,2015,10,22,16,1800,2061,3861,3853
0130-001,2015,10,22,17,1807,2092,3899,3861
0130-001,2015,10,22,18,1796,2552,4348,3899
0130-001,2015,10,22,19,1819,2670,4489,4348
0130-001,2015,10,22,20,1259,1952,3211,4489
0130-001,2015,10,22,21,1118,1804,2922,3211
0130-001,2015,10,22,22,1180,1262,2442,2922
0130-001,2015,10,22,23,929,708,1637,2442
0130-001,2015,10,22,24,651,460,1111,1637
0130-001,2015,10,23,1,430,306,736,1111
0130-001,2015,10,23,2,265,219,484,736
0130-001,2015,10,23,3,175,190,365,484
0130-001,2015,10,23,4,175,155,330,365
0130-001,2015,10,23,5,168,192,360,330
0130-001,2015,10,23,6,525,351,876,360
0130-001,2015,10,23,7,1815,744,2559,876
0130-001,2015,10,23,8,2219,1628,3847,2559
0130-001,2015,10,23,9,2276,2157,4433,3847
0130-001,2015,10,23,10,1971,1760,3731,4433
0130-001,2015,10,23,11,2101,1943,4044,3731
0130-001,2015,10,23,12,1697,1775,3472,4044
0130-001,2015,10,23,13,1500,1672,3172,3472
0130-001,2015,10,23,14,1943,1909,3852,3172
0130-001,2015,10,23,15,2046,2083,4129,3852
0130-001,2015,10,23,16,1860,2114,3974,4129
0130-001,2015,10,23,17,1940,2161,4101,3974
0130-001,2015,10,23,18,2042,2594,4636,4101
0130-001,2015,10,23,19,2153,2683,4836,4636
0130-001,2015,10,23,20,1535,2333,3868,4836
0130-001,2015,10,23,21,1277,1643,2920,3868
0130-001,2015,10,23,22,1277,1364,2641,2920
0130-001,2015,10,23,23,949,867,1816,2641
0130-001,2015,10,23,24,597,617,1214,1816
0130-001,2015,10,24,1,502,413,915,1214
0130-001,2015,10,24,2,321,275,596,915
0130-001,2015,10,24,3,278,206,484,596
0130-001,2015,10,24,4,224,188,412,484
0130-001,2015,10,24,5,238,251,489,412
0130-001,2015,10,24,6,476,353,829,489
0130-001,2015,10,24,7,1122,695,1817,829
0130-001,2015,10,24,8,1787,1199,2986,1817
0130-001,2015,10,24,9,1810,1717,3527,2986
0130-001,2015,10,24,10,1832,2007,3839,3527
0130-001,2015,10,24,11,1863,2454,4317,3839
0130-001,2015,10,24,12,1862,2550,4412,4317
0130-001,2015,10,24,13,1699,2655,4354,4412
0130-001,2015,10,24,14,1481,2588,4069,4354
0130-001,2015,10,24,15,1646,2351,3997,4069
0130-001,2015,10,24,16,1860,2144,4004,3997
0130-001,2015,10,24,17,1988,2041,4029,4004
0130-001,2015,10,24,18,2021,2269,4290,4029
0130-001,2015,10,24,19,2022,2054,4076,4290
0130-001,2015,10,24,20,1616,1318,2934,4076
0130-001,2015,10,24,21,1256,1139,2395,2934
0130-001,2015,10,24,22,1070,922,1992,2395
0130-001,2015,10,24,23,760,590,1350,1992
0130-001,2015,10,24,24,550,463,1013,1350
0130-001,2015,10,25,1,388,311,699,1013
0130-001,2015,10,25,2,302,246,548,699
0130-001,2015,10,25,3,234,199,433,548
0130-001,2015,10,25,4,176,148,324,433
0130-001,2015,10,25,5,188,143,331,324
0130-001,2015,10,25,6,348,215,563,331
0130-001,2015,10,25,7,674,358,1032,563
0130-001,2015,10,25,8,871,599,1470,1032
0130-001,2015,10,25,9,1020,1003,2023,1470
0130-001,2015,10,25,10,1469,1228,2697,2023
0130-001,2015,10,25,11,1281,1431,2712,2697
0130-001,2015,10,25,12,1176,1505,2681,2712
0130-001,2015,10,25,13,1326,1474,2800,2681
0130-001,2015,10,25,14,1415,1465,2880,2800
0130-001,2015,10,25,15,1497,1568,3065,2880
0130-001,2015,10,25,16,1611,1523,3134,3065
0130-001,2015,10,25,17,1734,1585,3319,3134
0130-001,2015,10,25,18,1870,1710,3580,3319
0130-001,2015,10,25,19,1846,1489,3335,3580
0130-001,2015,10,25,20,1695,1128,2823,3335
0130-001,2015,10,25,21,1339,1045,2384,2823
0130-001,2015,10,25,22,1114,766,1880,2384
0130-001,2015,10,25,23,719,456,1175,1880
0130-001,2015,10,25,24,482,382,864,1175
0130-001,2015,10,26,1,278,208,486,864
0130-001,2015,10,26,2,183,126,309,486
0130-001,2015,10,26,3,125,88,213,309
0130-001,2015,10,26,4,119,123,242,213
0130-001,2015,10,26,5,189,181,370,242
0130-001,2015,10,26,6,632,311,943,370
0130-001,2015,10,26,7,1959,784,2743,943
0130-001,2015,10,26,8,2149,1681,3830,2743
0130-001,2015,10,26,9,2298,1994,4292,3830
0130-001,2015,10,26,10,1963,1847,3810,4292
0130-001,2015,10,26,11,1912,1963,3875,3810
0130-001,2015,10,26,12,1835,1878,3713,3875
0130-001,2015,10,26,13,1535,1751,3286,3713
0130-001,2015,10,26,14,1718,1940,3658,3286
0130-001,2015,10,26,15,1895,2039,3934,3658
0130-001,2015,10,26,16,1930,2074,4004,3934
0130-001,2015,10,26,17,1815,2126,3941,4004
0130-001,2015,10,26,18,1941,2456,4397,3941
0130-001,2015,10,26,19,1802,2624,4426,4397
0130-001,2015,10,26,20,1473,1989,3462,4426
0130-001,2015,10,26,21,1193,1594,2787,3462
0130-001,2015,10,26,22,1108,1291,2399,2787
0130-001,2015,10,26,23,758,735,1493,2399
0130-001,2015,10,26,24,525,405,930,1493
0130-001,2015,10,27,1,332,271,603,930
0130-001,2015,10,27,2,257,168,425,603
0130-001,2015,10,27,3,169,126,295,425
0130-001,2015,10,27,4,145,114,259,295
0130-001,2015,10,27,5,192,210,402,259
0130-001,2015,10,27,6,598,297,895,402
0130-001,2015,10,27,7,1718,614,2332,895
0130-001,2015,10,27,8,2082,1523,3605,2332
0130-001,2015,10,27,9,2214,2014,4228,3605
0130-001,2015,10,27,10,1975,1717,3692,4228
0130-001,2015,10,27,11,1900,1782,3682,3692
0130-001,2015,10,27,12,1770,1699,3469,3682
0130-001,2015,10,27,13,1498,1570,3068,3469
0130-001,2015,10,27,14,1822,1847,3669,3068
0130-001,2015,10,27,15,1900,1920,3820,3669
0130-001,2015,10,27,16,1885,2068,3953,3820
0130-001,2015,10,27,17,1704,2034,3738,3953
0130-001,2015,10,27,18,1798,2467,4265,3738
0130-001,2015,10,27,19,1702,2580,4282,4265
0130-001,2015,10,27,20,1332,1831,3163,4282
0130-001,2015,10,27,21,1154,1757,2911,3163
0130-001,2015,10,27,22,1078,1311,2389,2911
0130-001,2015,10,27,23,824,693,1517,2389
0130-001,2015,10,27,24,527,474,1001,1517
0130-001,2015,10,28,1,384,300,684,1001
0130-001,2015,10,28,2,236,197,433,684
0130-001,2015,10,28,3,181,150,331,433
0130-001,2015,10,28,4,149,152,301,331
0130-001,2015,10,28,5,178,152,330,301
0130-001,2015,10,28,6,549,371,920,330
0130-001,2015,10,28,7,1730,746,2476,920
0130-001,2015,10,28,8,2093,1690,3783,2476
0130-001,2015,10,28,9,2272,2099,4371,3783
0130-001,2015,10,28,10,2074,1815,3889,4371
0130-001,2015,10,28,11,1987,1822,3809,3889
0130-001,2015,10,28,12,1758,1762,3520,3809
0130-001,2015,10,28,13,1590,1664,3254,3520
0130-001,2015,10,28,14,1782,1925,3707,3254
0130-001,2015,10,28,15,1860,1987,3847,3707
0130-001,2015,10,28,16,1831,2126,3957,3847
0130-001,2015,10,28,17,1837,2224,4061,3957
0130-001,2015,10,28,18,1872,2601,4473,4061
0130-001,2015,10,28,19,1792,2735,4527,4473
0130-001,2015,10,28,20,1331,1896,3227,4527
0130-001,2015,10,28,21,1164,1693,2857,3227
0130-001,2015,10,28,22,1133,1117,2250,2857
0130-001,2015,10,28,23,795,679,1474,2250
0130-001,2015,10,28,24,579,445,1024,1474
0130-001,2015,10,29,1,354,340,694,1024
0130-001,2015,10,29,2,255,170,425,694
0130-001,2015,10,29,3,183,155,338,425
0130-001,2015,10,29,4,154,152,306,338
0130-001,2015,10,29,5,185,184,369,306
0130-001,2015,10,29,6,519,342,861,369
0130-001,2015,10,29,7,1802,748,2550,861
0130-001,2015,10,29,8,2083,1695,3778,2550
0130-001,2015,10,29,9,2236,2137,4373,3778
0130-001,2015,10,29,10,1974,1715,3689,4373
0130-001,2015,10,29,11,2027,1824,3851,3689
0130-001,2015,10,29,12,1640,1786,3426,3851
0130-001,2015,10,29,13,1429,1632,3061,3426
0130-001,2015,10,29,14,1804,1842,3646,3061
0130-001,2015,10,29,15,1850,1827,3677,3646
0130-001,2015,10,29,16,1835,2141,3976,3677
0130-001,2015,10,29,17,1755,2168,3923,3976
0130-001,2015,10,29,18,1875,2575,4450,3923
0130-001,2015,10,29,19,1802,2554,4356,4450
0130-001,2015,10,29,20,1324,1914,3238,4356
0130-001,2015,10,29,21,1158,1735,2893,3238
0130-001,2015,10,29,22,888,1282,2170,2893
0130-001,2015,10,29,23,850,541,1391,2170
0130-001,2015,10,29,24,698,300,998,1391
0130-001,2015,10,30,1,397,277,674,998
0130-001,2015,10,30,2,346,139,485,674
0130-001,2015,10,30,3,162,155,317,485
0130-001,2015,10,30,4,137,137,274,317
0130-001,2015,10,30,5,218,206,424,274
0130-001,2015,10,30,6,520,302,822,424
0130-001,2015,10,30,7,1819,748,2567,822
0130-001,2015,10,30,8,2152,1695,3847,2567
0130-001,2015,10,30,9,2288,2050,4338,3847
0130-001,2015,10,30,10,2008,1858,3866,4338
0130-001,2015,10,30,11,2074,1920,3994,3866
0130-001,2015,10,30,12,1850,1833,3683,3994
0130-001,2015,10,30,13,1537,1757,3294,3683
0130-001,2015,10,30,14,1841,1987,3828,3294
0130-001,2015,10,30,15,2029,2039,4068,3828
0130-001,2015,10,30,16,2120,2065,4185,4068
0130-001,2015,10,30,17,2050,2242,4292,4185
0130-001,2015,10,30,18,2064,2628,4692,4292
0130-001,2015,10,30,19,1963,2699,4662,4692
0130-001,2015,10,30,20,1465,2173,3638,4662
0130-001,2015,10,30,21,1339,1739,3078,3638
0130-001,2015,10,30,22,1182,1226,2408,3078
0130-001,2015,10,30,23,912,833,1745,2408
0130-001,2015,10,30,24,564,489,1053,1745
0130-001,2015,10,31,1,492,389,881,1053
0130-001,2015,10,31,2,294,268,562,881
0130-001,2015,10,31,3,226,188,414,562
0130-001,2015,10,31,4,199,201,400,414
0130-001,2015,10,31,5,261,221,482,400
0130-001,2015,10,31,6,489,300,789,482
0130-001,2015,10,31,7,1181,605,1786,789
0130-001,2015,10,31,8,1824,1181,3005,1786
0130-001,2015,10,31,9,1863,1967,3830,3005
0130-001,2015,10,31,10,1898,2126,4024,3830
0130-001,2015,10,31,11,1896,2492,4388,4024
0130-001,2015,10,31,12,1859,2568,4427,4388
0130-001,2015,10,31,13,1734,2474,4208,4427
0130-001,2015,10,31,14,1498,2413,3911,4208
0130-001,2015,10,31,15,1658,2278,3936,3911
0130-001,2015,10,31,16,1970,2056,4026,3936
0130-001,2015,10,31,17,2104,1984,4088,4026
0130-001,2015,10,31,18,2112,2157,4269,4088
0130-001,2015,10,31,19,2130,1956,4086,4269
0130-001,2015,10,31,20,1746,1254,3000,4086
0130-001,2015,10,31,21,1347,1099,2446,3000
0130-001,2015,10,31,22,1098,884,1982,2446
0130-001,2015,10,31,23,774,592,1366,1982
0130-001,2015,10,31,24,564,424,988,1366
0130-001,2015,11,1,1,387,341,728,988
0130-001,2015,11,1,2,301,244,545,728
0130-001,2015,11,1,3,230,174,404,545
0130-001,2015,11,1,4,167,147,314,404
0130-001,2015,11,1,5,192,151,343,314
0130-001,2015,11,1,6,341,252,593,343
0130-001,2015,11,1,7,666,428,1094,593
0130-001,2015,11,1,8,854,722,1576,1094
0130-001,2015,11,1,9,1015,1004,2019,1576
0130-001,2015,11,1,10,1033,1173,2206,2019
0130-001,2015,11,1,11,1288,1450,2738,2206
0130-001,2015,11,1,12,1173,1439,2612,2738
0130-001,2015,11,1,13,1254,1525,2779,2612
0130-001,2015,11,1,14,1489,1561,3050,2779
0130-001,2015,11,1,15,1663,1635,3298,3050
0130-001,2015,11,1,16,1875,1618,3493,3298
0130-001,2015,11,1,17,1794,1694,3488,3493
0130-001,2015,11,1,18,1846,1875,3721,3488
0130-001,2015,11,1,19,1766,1508,3274,3721
0130-001,2015,11,1,20,1439,1135,2574,3274
0130-001,2015,11,1,21,1266,966,2232,2574
0130-001,2015,11,1,22,1034,779,1813,2232
0130-001,2015,11,1,23,696,514,1210,1813
0130-001,2015,11,1,24,425,330,755,1210
0130-001,2015,11,2,1,294,218,512,755
0130-001,2015,11,2,2,153,128,281,512
0130-001,2015,11,2,3,136,97,233,281
0130-001,2015,11,2,4,123,105,228,233
0130-001,2015,11,2,5,191,152,343,228
0130-001,2015,11,2,6,617,337,954,343
0130-001,2015,11,2,7,1903,832,2735,954
0130-001,2015,11,2,8,2117,1753,3870,2735
0130-001,2015,11,2,9,2274,2067,4341,3870
0130-001,2015,11,2,10,1846,1796,3642,4341
0130-001,2015,11,2,11,1829,1820,3649,3642
0130-001,2015,11,2,12,1731,1789,3520,3649
0130-001,2015,11,2,13,1487,1619,3106,3520
0130-001,2015,11,2,14,1757,1867,3624,3106
0130-001,2015,11,2,15,1807,1878,3685,3624
0130-001,2015,11,2,16,1930,2086,4016,3685
0130-001,2015,11,2,17,1785,2060,3845,4016
0130-001,2015,11,2,18,1941,2522,4463,3845
0130-001,2015,11,2,19,1838,2561,4399,4463
0130-001,2015,11,2,20,1363,1825,3188,4399
0130-001,2015,11,2,21,1198,1716,2914,3188
0130-001,2015,11,2,22,1049,1342,2391,2914
0130-001,2015,11,2,23,759,750,1509,2391
0130-001,2015,11,2,24,509,406,915,1509
0130-001,2015,11,3,1,342,283,625,915
0130-001,2015,11,3,2,264,182,446,625
0130-001,2015,11,3,3,172,140,312,446
0130-001,2015,11,3,4,154,140,294,312
0130-001,2015,11,3,5,196,172,368,294
0130-001,2015,11,3,6,619,344,963,368
0130-001,2015,11,3,7,1784,780,2564,963
0130-001,2015,11,3,8,2151,1746,3897,2564
0130-001,2015,11,3,9,2257,2034,4291,3897
0130-001,2015,11,3,10,2012,1823,3835,4291
0130-001,2015,11,3,11,1917,1773,3690,3835
0130-001,2015,11,3,12,1773,1773,3546,3690
0130-001,2015,11,3,13,1515,1662,3177,3546
0130-001,2015,11,3,14,1810,1873,3683,3177
0130-001,2015,11,3,15,1910,1983,3893,3683
0130-001,2015,11,3,16,1934,1999,3933,3893
0130-001,2015,11,3,17,1818,2056,3874,3933
0130-001,2015,11,3,18,1816,2516,4332,3874
0130-001,2015,11,3,19,1710,2518,4228,4332
0130-001,2015,11,3,20,1341,1951,3292,4228
0130-001,2015,11,3,21,1201,1759,2960,3292
0130-001,2015,11,3,22,1090,1297,2387,2960
0130-001,2015,11,3,23,847,773,1620,2387
0130-001,2015,11,3,24,526,463,989,1620
0130-001,2015,11,4,1,386,306,692,989
0130-001,2015,11,4,2,230,210,440,692
0130-001,2015,11,4,3,192,147,339,440
0130-001,2015,11,4,4,170,121,291,339
0130-001,2015,11,4,5,171,172,343,291
0130-001,2015,11,4,6,576,352,928,343
0130-001,2015,11,4,7,1791,790,2581,928
0130-001,2015,11,4,8,2160,1689,3849,2581
0130-001,2015,11,4,9,2249,2073,4322,3849
0130-001,2015,11,4,10,2043,1890,3933,4322
0130-001,2015,11,4,11,1936,1856,3792,3933
0130-001,2015,11,4,12,1762,1811,3573,3792
0130-001,2015,11,4,13,1522,1636,3158,3573
0130-001,2015,11,4,14,1824,1861,3685,3158
0130-001,2015,11,4,15,2020,2028,4048,3685
0130-001,2015,11,4,16,1961,2009,3970,4048
0130-001,2015,11,4,17,1877,2023,3900,3970
0130-001,2015,11,4,18,1882,2639,4521,3900
0130-001,2015,11,4,19,1698,2678,4376,4521
0130-001,2015,11,4,20,1362,2004,3366,4376
0130-001,2015,11,4,21,1232,1587,2819,3366
0130-001,2015,11,4,22,1171,1244,2415,2819
0130-001,2015,11,4,23,949,740,1689,2415
0130-001,2015,11,4,24,592,455,1047,1689
0130-001,2015,11,5,1,387,338,725,1047
0130-001,2015,11,5,2,255,197,452,725
0130-001,2015,11,5,3,178,160,338,452
0130-001,2015,11,5,4,149,139,288,338
0130-001,2015,11,5,5,177,193,370,288
0130-001,2015,11,5,6,574,332,906,370
0130-001,2015,11,5,7,1838,743,2581,906
0130-001,2015,11,5,8,2132,1647,3779,2581
0130-001,2015,11,5,9,2277,2125,4402,3779
0130-001,2015,11,5,10,2140,1812,3952,4402
0130-001,2015,11,5,11,1996,1877,3873,3952
0130-001,2015,11,5,12,1831,1831,3662,3873
0130-001,2015,11,5,13,1454,1671,3125,3662
0130-001,2015,11,5,14,1798,1837,3635,3125
0130-001,2015,11,5,15,2018,1915,3933,3635
0130-001,2015,11,5,16,1911,2125,4036,3933
0130-001,2015,11,5,17,1869,2153,4022,4036
0130-001,2015,11,5,18,1892,2568,4460,4022
0130-001,2015,11,5,19,1875,2711,4586,4460
0130-001,2015,11,5,20,1430,2122,3552,4586
0130-001,2015,11,5,21,1273,1841,3114,3552
0130-001,2015,11,5,22,1209,1316,2525,3114
0130-001,2015,11,5,23,948,775,1723,2525
0130-001,2015,11,5,24,829,450,1279,1723
0130-001,2015,11,6,1,319,327,646,1279
0130-001,2015,11,6,2,204,236,440,646
0130-001,2015,11,6,3,162,195,357,440
0130-001,2015,11,6,4,148,170,318,357
0130-001,2015,11,6,5,150,204,354,318
0130-001,2015,11,6,6,536,366,902,354
0130-001,2015,11,6,7,1743,691,2434,902
0130-001,2015,11,6,8,2054,1413,3467,2434
0130-001,2015,11,6,9,2120,1952,4072,3467
0130-001,2015,11,6,10,1938,1904,3842,4072
0130-001,2015,11,6,11,1962,2162,4124,3842
0130-001,2015,11,6,12,1661,2159,3820,4124
0130-001,2015,11,6,13,1475,2066,3541,3820
0130-001,2015,11,6,14,1784,2223,4007,3541
0130-001,2015,11,6,15,1911,2305,4216,4007
0130-001,2015,11,6,16,1810,2328,4138,4216
0130-001,2015,11,6,17,1873,2319,4192,4138
0130-001,2015,11,6,18,1947,2705,4652,4192
0130-001,2015,11,6,19,1908,2629,4537,4652
0130-001,2015,11,6,20,1495,1978,3473,4537
0130-001,2015,11,6,21,1202,1407,2609,3473
0130-001,2015,11,6,22,1166,1129,2295,2609
0130-001,2015,11,6,23,904,812,1716,2295
0130-001,2015,11,6,24,568,536,1104,1716
0130-001,2015,11,7,1,435,362,797,1104
0130-001,2015,11,7,2,305,251,556,797
0130-001,2015,11,7,3,267,189,456,556
0130-001,2015,11,7,4,196,188,384,456
0130-001,2015,11,7,5,219,226,445,384
0130-001,2015,11,7,6,463,350,813,445
0130-001,2015,11,7,7,1063,605,1668,813
0130-001,2015,11,7,8,1750,1135,2885,1668
0130-001,2015,11,7,9,1757,1711,3468,2885
0130-001,2015,11,7,10,1766,1927,3693,3468
0130-001,2015,11,7,11,1831,2283,4114,3693
0130-001,2015,11,7,12,1866,2322,4188,4114
0130-001,2015,11,7,13,1664,2292,3956,4188
0130-001,2015,11,7,14,1464,2238,3702,3956
0130-001,2015,11,7,15,1634,2204,3838,3702
0130-001,2015,11,7,16,1750,1967,3717,3838
0130-001,2015,11,7,17,1872,1928,3800,3717
0130-001,2015,11,7,18,1931,2045,3976,3800
0130-001,2015,11,7,19,1914,1858,3772,3976
0130-001,2015,11,7,20,1486,1189,2675,3772
0130-001,2015,11,7,21,1165,1059,2224,2675
0130-001,2015,11,7,22,1041,847,1888,2224
0130-001,2015,11,7,23,746,594,1340,1888
0130-001,2015,11,7,24,536,386,922,1340
0130-001,2015,11,8,1,382,248,630,922
0130-001,2015,11,8,2,288,222,510,630
0130-001,2015,11,8,3,230,176,406,510
0130-001,2015,11,8,4,177,141,318,406
0130-001,2015,11,8,5,190,135,325,318
0130-001,2015,11,8,6,359,220,579,325
0130-001,2015,11,8,7,667,359,1026,579
0130-001,2015,11,8,8,858,606,1464,1026
0130-001,2015,11,8,9,1006,967,1973,1464
0130-001,2015,11,8,10,1265,1150,2415,1973
0130-001,2015,11,8,11,1251,1417,2668,2415
0130-001,2015,11,8,12,1151,1539,2690,2668
0130-001,2015,11,8,13,1285,1550,2835,2690
0130-001,2015,11,8,14,1418,1508,2926,2835
0130-001,2015,11,8,15,1563,1580,3143,2926
0130-001,2015,11,8,16,1680,1557,3237,3143
0130-001,2015,11,8,17,1688,1805,3493,3237
0130-001,2015,11,8,18,1763,1647,3410,3493
0130-001,2015,11,8,19,1714,1464,3178,3410
0130-001,2015,11,8,20,1462,1043,2505,3178
0130-001,2015,11,8,21,1211,987,2198,2505
0130-001,2015,11,8,22,1024,697,1721,2198
0130-001,2015,11,8,23,669,466,1135,1721
0130-001,2015,11,8,24,440,319,759,1135
0130-001,2015,11,9,1,275,224,499,759
0130-001,2015,11,9,2,170,124,294,499
0130-001,2015,11,9,3,128,98,226,294
0130-001,2015,11,9,4,115,109,224,226
0130-001,2015,11,9,5,186,158,344,224
0130-001,2015,11,9,6,607,335,942,344
0130-001,2015,11,9,7,1895,794,2689,942
0130-001,2015,11,9,8,2086,1716,3802,2689
0130-001,2015,11,9,9,2215,2067,4282,3802
0130-001,2015,11,9,10,1887,1852,3739,4282
0130-001,2015,11,9,11,1884,1902,3786,3739
0130-001,2015,11,9,12,1800,1876,3676,3786
0130-001,2015,11,9,13,1536,1750,3286,3676
0130-001,2015,11,9,14,1745,1899,3644,3286
0130-001,2015,11,9,15,1875,2027,3902,3644
0130-001,2015,11,9,16,1912,2023,3935,3902
0130-001,2015,11,9,17,1785,2129,3914,3935
0130-001,2015,11,9,18,1899,2502,4401,3914
0130-001,2015,11,9,19,1791,2584,4375,4401
0130-001,2015,11,9,20,1441,2008,3449,4375
0130-001,2015,11,9,21,1197,1651,2848,3449
0130-001,2015,11,9,22,1094,1267,2361,2848
0130-001,2015,11,9,23,764,754,1518,2361
0130-001,2015,11,9,24,522,416,938,1518
0130-001,2015,11,10,1,339,297,636,938
0130-001,2015,11,10,2,252,172,424,636
0130-001,2015,11,10,3,159,116,275,424
0130-001,2015,11,10,4,149,103,252,275
0130-001,2015,11,10,5,194,201,395,252
0130-001,2015,11,10,6,609,305,914,395
0130-001,2015,11,10,7,1749,754,2503,914
0130-001,2015,11,10,8,2065,1604,3669,2503
0130-001,2015,11,10,9,2165,2090,4255,3669
0130-001,2015,11,10,10,1928,1693,3621,4255
0130-001,2015,11,10,11,1911,1827,3738,3621
0130-001,2015,11,10,12,1784,1792,3576,3738
0130-001,2015,11,10,13,1500,1644,3144,3576
0130-001,2015,11,10,14,1813,1848,3661,3144
0130-001,2015,11,10,15,1916,1992,3908,3661
0130-001,2015,11,10,16,1914,2054,3968,3908
0130-001,2015,11,10,17,1725,2104,3829,3968
0130-001,2015,11,10,18,1767,2515,4282,3829
0130-001,2015,11,10,19,1694,2537,4231,4282
0130-001,2015,11,10,20,1343,1890,3233,4231
0130-001,2015,11,10,21,1138,1731,2869,3233
0130-001,2015,11,10,22,1072,1346,2418,2869
0130-001,2015,11,10,23,827,734,1561,2418
0130-001,2015,11,10,24,529,469,998,1561
0130-001,2015,11,11,1,354,156,510,998
0130-001,2015,11,11,2,229,102,331,510
0130-001,2015,11,11,3,175,109,284,331
0130-001,2015,11,11,4,138,86,224,284
0130-001,2015,11,11,5,154,123,277,224
0130-001,2015,11,11,6,465,206,671,277
0130-001,2015,11,11,7,1420,479,1899,671
0130-001,2015,11,11,8,1861,1088,2949,1899
0130-001,2015,11,11,9,1978,1452,3430,2949
0130-001,2015,11,11,10,1649,1701,3350,3430
0130-001,2015,11,11,11,1676,1779,3455,3350
0130-001,2015,11,11,12,1715,1738,3453,3455
0130-001,2015,11,11,13,1402,1640,3042,3453
0130-001,2015,11,11,14,1614,1821,3435,3042
0130-001,2015,11,11,15,1667,1968,3635,3435
0130-001,2015,11,11,16,1739,2023,3762,3635
0130-001,2015,11,11,17,1736,2028,3764,3762
0130-001,2015,11,11,18,1687,2416,4103,3764
0130-001,2015,11,11,19,1656,2188,3844,4103
0130-001,2015,11,11,20,1317,1730,3047,3844
0130-001,2015,11,11,21,1216,1427,2643,3047
0130-001,2015,11,11,22,1108,1129,2237,2643
0130-001,2015,11,11,23,880,643,1523,2237
0130-001,2015,11,11,24,568,399,967,1523
0130-001,2015,11,12,1,395,269,664,967
0130-001,2015,11,12,2,259,186,445,664
0130-001,2015,11,12,3,192,123,315,445
0130-001,2015,11,12,4,169,130,299,315
0130-001,2015,11,12,5,179,163,342,299
0130-001,2015,11,12,6,487,282,769,342
0130-001,2015,11,12,7,1523,729,2252,769
0130-001,2015,11,12,8,1993,1385,3378,2252
0130-001,2015,11,12,9,1961,1764,3725,3378
0130-001,2015,11,12,10,1939,1889,3828,3725
0130-001,2015,11,12,11,1722,1853,3575,3828
0130-001,2015,11,12,12,1592,1711,3303,3575
0130-001,2015,11,12,13,1353,1604,2957,3303
0130-001,2015,11,12,14,1796,1842,3638,2957
0130-001,2015,11,12,15,1725,1927,3652,3638
0130-001,2015,11,12,16,1699,1897,3596,3652
0130-001,2015,11,12,17,1762,2212,3974,3596
0130-001,2015,11,12,18,1881,2502,4383,3974
0130-001,2015,11,12,19,1869,2423,4292,4383
0130-001,2015,11,12,20,1431,1841,3272,4292
0130-001,2015,11,12,21,1196,1486,2682,3272
0130-001,2015,11,12,22,1083,1212,2295,2682
0130-001,2015,11,12,23,804,710,1514,2295
0130-001,2015,11,12,24,493,447,940,1514
0130-001,2015,11,13,1,335,306,641,940
0130-001,2015,11,13,2,246,158,404,641
0130-001,2015,11,13,3,188,127,315,404
0130-001,2015,11,13,4,135,130,265,315
0130-001,2015,11,13,5,174,179,353,265
0130-001,2015,11,13,6,474,298,772,353
0130-001,2015,11,13,7,1489,663,2152,772
0130-001,2015,11,13,8,2103,1430,3533,2152
0130-001,2015,11,13,9,2204,2021,4225,3533
0130-001,2015,11,13,10,1973,1859,3832,4225
0130-001,2015,11,13,11,2018,1890,3908,3832
0130-001,2015,11,13,12,1756,1813,3569,3908
0130-001,2015,11,13,13,1506,1670,3176,3569
0130-001,2015,11,13,14,1812,1883,3695,3176
0130-001,2015,11,13,15,1970,1990,3960,3695
0130-001,2015,11,13,16,1965,1974,3939,3960
0130-001,2015,11,13,17,1962,2096,4058,3939
0130-001,2015,11,13,18,2006,2369,4375,4058
0130-001,2015,11,13,19,1936,2520,4456,4375
0130-001,2015,11,13,20,1480,2062,3542,4456
0130-001,2015,11,13,21,1270,1720,2990,3542
0130-001,2015,11,13,22,1078,1257,2335,2990
0130-001,2015,11,13,23,770,799,1569,2335
0130-001,2015,11,13,24,557,545,1102,1569
0130-001,2015,11,14,1,444,391,835,1102
0130-001,2015,11,14,2,267,274,541,835
0130-001,2015,11,14,3,209,172,381,541
0130-001,2015,11,14,4,189,174,363,381
0130-001,2015,11,14,5,181,250,431,363
0130-001,2015,11,14,6,343,356,699,431
0130-001,2015,11,14,7,756,645,1401,699
0130-001,2015,11,14,8,1231,1047,2278,1401
0130-001,2015,11,14,9,1533,1666,3199,2278
0130-001,2015,11,14,10,1524,1922,3446,3199
0130-001,2015,11,14,11,1713,2396,4109,3446
0130-001,2015,11,14,12,1686,2526,4212,4109
0130-001,2015,11,14,13,1651,2621,4272,4212
0130-001,2015,11,14,14,1703,2418,4121,4272
0130-001,2015,11,14,15,1745,2347,4092,4121
0130-001,2015,11,14,16,1884,2089,3973,4092
0130-001,2015,11,14,17,1957,1445,3402,3973
0130-001,2015,11,14,18,1905,1080,2985,3402
0130-001,2015,11,14,19,1864,948,2812,2985
0130-001,2015,11,14,20,1385,602,1987,2812
0130-001,2015,11,14,21,1090,463,1553,1987
0130-001,2015,11,14,22,940,530,1470,1553
0130-001,2015,11,14,23,682,397,1079,1470
0130-001,2015,11,14,24,498,367,865,1079
0130-001,2015,11,15,1,408,281,689,865
0130-001,2015,11,15,2,273,183,456,689
0130-001,2015,11,15,3,203,144,347,456
0130-001,2015,11,15,4,204,86,290,347
0130-001,2015,11,15,5,177,121,298,290
0130-001,2015,11,15,6,283,204,487,298
0130-001,2015,11,15,7,555,292,847,487
0130-001,2015,11,15,8,725,510,1235,847
0130-001,2015,11,15,9,856,668,1524,1235
0130-001,2015,11,15,10,1028,791,1819,1524
0130-001,2015,11,15,11,1201,930,2131,1819
0130-001,2015,11,15,12,1157,1025,2182,2131
0130-001,2015,11,15,13,1364,1388,2752,2182
0130-001,2015,11,15,14,1821,1666,3487,2752
0130-001,2015,11,15,15,1809,1768,3577,3487
0130-001,2015,11,15,16,1875,1842,3717,3577
0130-001,2015,11,15,17,1901,1738,3639,3717
0130-001,2015,11,15,18,1881,1834,3715,3639
0130-001,2015,11,15,19,1949,1465,3414,3715
0130-001,2015,11,15,20,1952,1111,3063,3414
0130-001,2015,11,15,21,1956,1076,3032,3063
0130-001,2015,11,15,22,1579,804,2383,3032
0130-001,2015,11,15,23,1288,572,1860,2383
0130-001,2015,11,15,24,513,356,869,1860
0130-001,2015,11,16,1,231,220,451,869
0130-001,2015,11,16,2,155,125,280,451
0130-001,2015,11,16,3,128,103,231,280
0130-001,2015,11,16,4,114,103,217,231
0130-001,2015,11,16,5,141,158,299,217
0130-001,2015,11,16,6,504,377,881,299
0130-001,2015,11,16,7,1522,779,2301,881
0130-001,2015,11,16,8,1922,1699,3621,2301
0130-001,2015,11,16,9,2128,2062,4190,3621
0130-001,2015,11,16,10,1903,1950,3853,4190
0130-001,2015,11,16,11,1833,1902,3735,3853
0130-001,2015,11,16,12,1706,1736,3442,3735
0130-001,2015,11,16,13,1512,1598,3110,3442
0130-001,2015,11,16,14,1751,1869,3620,3110
0130-001,2015,11,16,15,1841,1738,3579,3620
0130-001,2015,11,16,16,1921,2040,3961,3579
0130-001,2015,11,16,17,1785,2108,3893,3961
0130-001,2015,11,16,18,1920,2365,4285,3893
0130-001,2015,11,16,19,1814,2334,4148,4285
0130-001,2015,11,16,20,1402,1831,3233,4148
0130-001,2015,11,16,21,1198,1654,2852,3233
0130-001,2015,11,16,22,1072,1254,2326,2852
0130-001,2015,11,16,23,712,753,1465,2326
0130-001,2015,11,16,24,407,454,861,1465
0130-001,2015,11,17,1,279,324,603,861
0130-001,2015,11,17,2,172,222,394,603
0130-001,2015,11,17,3,146,158,304,394
0130-001,2015,11,17,4,117,165,282,304
0130-001,2015,11,17,5,161,219,380,282
0130-001,2015,11,17,6,408,373,781,380
0130-001,2015,11,17,7,1352,755,2107,781
0130-001,2015,11,17,8,1870,1618,3488,2107
0130-001,2015,11,17,9,1981,2132,4113,3488
0130-001,2015,11,17,10,1699,1796,3495,4113
0130-001,2015,11,17,11,1760,1810,3570,3495
0130-001,2015,11,17,12,1620,1775,3395,3570
0130-001,2015,11,17,13,1405,1593,2998,3395
0130-001,2015,11,17,14,1680,1823,3503,2998
0130-001,2015,11,17,15,1605,1732,3337,3503
0130-001,2015,11,17,16,1972,1863,3835,3337
0130-001,2015,11,17,17,1852,2025,3877,3835
0130-001,2015,11,17,18,1700,2457,4157,3877
0130-001,2015,11,17,19,1642,1893,3535,4157
0130-001,2015,11,17,20,1212,983,2195,3535
0130-001,2015,11,17,21,1153,938,2091,2195
0130-001,2015,11,17,22,1065,625,1690,2091
0130-001,2015,11,17,23,832,481,1313,1690
0130-001,2015,11,17,24,534,350,884,1313
0130-001,2015,11,18,1,316,218,534,884
0130-001,2015,11,18,2,235,169,404,534
0130-001,2015,11,18,3,183,151,334,404
0130-001,2015,11,18,4,127,128,255,334
0130-001,2015,11,18,5,194,176,370,255
0130-001,2015,11,18,6,463,286,749,370
0130-001,2015,11,18,7,1516,552,2068,749
0130-001,2015,11,18,8,1940,1037,2977,2068
0130-001,2015,11,18,9,2055,2066,4121,2977
0130-001,2015,11,18,10,1805,1797,3602,4121
0130-001,2015,11,18,11,1842,1744,3586,3602
0130-001,2015,11,18,12,1656,1756,3412,3586
0130-001,2015,11,18,13,1499,1665,3164,3412
0130-001,2015,11,18,14,1591,1825,3416,3164
0130-001,2015,11,18,15,1652,1983,3635,3416
0130-001,2015,11,18,16,1721,2011,3732,3635
0130-001,2015,11,18,17,1557,2000,3557,3732
0130-001,2015,11,18,18,1850,2363,4213,3557
0130-001,2015,11,18,19,1880,2516,4396,4213
0130-001,2015,11,18,20,1422,1799,3221,4396
0130-001,2015,11,18,21,1237,1517,2754,3221
0130-001,2015,11,18,22,1160,1131,2291,2754
0130-001,2015,11,18,23,941,823,1764,2291
0130-001,2015,11,18,24,601,511,1112,1764
0130-001,2015,11,19,1,437,378,815,1112
0130-001,2015,11,19,2,274,235,509,815
0130-001,2015,11,19,3,201,174,375,509
0130-001,2015,11,19,4,147,185,332,375
0130-001,2015,11,19,5,239,231,470,332
0130-001,2015,11,19,6,506,350,856,470
0130-001,2015,11,19,7,1487,548,2035,856
0130-001,2015,11,19,8,1872,1073,2945,2035
0130-001,2015,11,19,9,1967,1698,3665,2945
0130-001,2015,11,19,10,1816,1763,3579,3665
0130-001,2015,11,19,11,1763,1669,3432,3579
0130-001,2015,11,19,12,1635,1637,3272,3432
0130-001,2015,11,19,13,1460,1631,3091,3272
0130-001,2015,11,19,14,1715,1788,3503,3091
0130-001,2015,11,19,15,1771,1901,3672,3503
0130-001,2015,11,19,16,1849,1956,3805,3672
0130-001,2015,11,19,17,1670,2148,3818,3805
0130-001,2015,11,19,18,1827,2391,4218,3818
0130-001,2015,11,19,19,1639,2428,4067,4218
0130-001,2015,11,19,20,1329,1599,2928,4067
0130-001,2015,11,19,21,1128,1146,2274,2928
0130-001,2015,11,19,22,990,838,1828,2274
0130-001,2015,11,19,23,761,470,1231,1828
0130-001,2015,11,19,24,514,308,822,1231
0130-001,2015,11,20,1,401,202,603,822
0130-001,2015,11,20,2,227,107,334,603
0130-001,2015,11,20,3,157,94,251,334
0130-001,2015,11,20,4,147,89,236,251
0130-001,2015,11,20,5,178,151,329,236
0130-001,2015,11,20,6,449,239,688,329
0130-001,2015,11,20,7,1441,601,2042,688
0130-001,2015,11,20,8,1883,1384,3267,2042
0130-001,2015,11,20,9,2034,1906,3940,3267
0130-001,2015,11,20,10,1716,1791,3507,3940
0130-001,2015,11,20,11,1847,1859,3706,3507
0130-001,2015,11,20,12,1686,1815,3501,3706
0130-001,2015,11,20,13,1485,1638,3123,3501
0130-001,2015,11,20,14,1630,1728,3358,3123
0130-001,2015,11,20,15,1696,1862,3558,3358
0130-001,2015,11,20,16,1857,1773,3630,3558
0130-001,2015,11,20,17,1770,1918,3688,3630
0130-001,2015,11,20,18,1859,2267,4126,3688
0130-001,2015,11,20,19,1804,2202,4006,4126
0130-001,2015,11,20,20,1466,1797,3263,4006
0130-001,2015,11,20,21,1223,1542,2765,3263
0130-001,2015,11,20,22,1153,1059,2212,2765
0130-001,2015,11,20,23,946,733,1679,2212
0130-001,2015,11,20,24,628,478,1106,1679
0130-001,2015,11,21,1,478,347,825,1106
0130-001,2015,11,21,2,331,249,580,825
0130-001,2015,11,21,3,221,142,363,580
0130-001,2015,11,21,4,207,183,390,363
0130-001,2015,11,21,5,203,190,393,390
0130-001,2015,11,21,6,441,302,743,393
0130-001,2015,11,21,7,1080,498,1578,743
0130-001,2015,11,21,8,1600,1069,2669,1578
0130-001,2015,11,21,9,1666,1456,3122,2669
0130-001,2015,11,21,10,1691,1634,3325,3122
0130-001,2015,11,21,11,1857,1978,3835,3325
0130-001,2015,11,21,12,1740,2036,3776,3835
0130-001,2015,11,21,13,1920,2123,4043,3776
0130-001,2015,11,21,14,1726,2023,3749,4043
0130-001,2015,11,21,15,1874,1887,3761,3749
0130-001,2015,11,21,16,1861,1930,3791,3761
0130-001,2015,11,21,17,1877,1955,3832,3791
0130-001,2015,11,21,18,1951,2108,4059,3832
0130-001,2015,11,21,19,1967,2158,4125,4059
0130-001,2015,11,21,20,1767,1185,2952,4125
0130-001,2015,11,21,21,1192,983,2175,2952
0130-001,2015,11,21,22,1050,851,1901,2175
0130-001,2015,11,21,23,744,684,1428,1901
0130-001,2015,11,21,24,488,571,1059,1428
0130-001,2015,11,22,1,399,334,733,1059
0130-001,2015,11,22,2,249,246,495,733
0130-001,2015,11,22,3,244,198,442,495
0130-001,2015,11,22,4,194,154,348,442
0130-001,2015,11,22,5,196,164,360,348
0130-001,2015,11,22,6,359,260,619,360
0130-001,2015,11,22,7,629,430,1059,619
0130-001,2015,11,22,8,976,663,1639,1059
0130-001,2015,11,22,9,1096,966,2062,1639
0130-001,2015,11,22,10,1048,1160,2208,2062
0130-001,2015,11,22,11,1228,1348,2576,2208
0130-001,2015,11,22,12,1200,1419,2619,2576
0130-001,2015,11,22,13,1335,1410,2745,2619
0130-001,2015,11,22,14,1586,1474,3060,2745
0130-001,2015,11,22,15,1940,1664,3604,3060
0130-001,2015,11,22,16,2014,1768,3782,3604
0130-001,2015,11,22,17,1993,1637,3630,3782
0130-001,2015,11,22,18,1944,1678,3622,3630
0130-001,2015,11,22,19,1969,1536,3505,3622
0130-001,2015,11,22,20,1906,1068,2974,3505
0130-001,2015,11,22,21,1853,947,2800,2974
0130-001,2015,11,22,22,1747,871,2618,2800
0130-001,2015,11,22,23,1232,599,1831,2618
0130-001,2015,11,22,24,518,364,882,1831
0130-001,2015,11,23,1,276,221,497,882
0130-001,2015,11,23,2,135,163,298,497
0130-001,2015,11,23,3,98,104,202,298
0130-001,2015,11,23,4,82,133,215,202
0130-001,2015,11,23,5,166,191,357,215
0130-001,2015,11,23,6,447,355,802,357
0130-001,2015,11,23,7,1376,764,2140,802
0130-001,2015,11,23,8,1811,1632,3443,2140
0130-001,2015,11,23,9,1867,2047,3914,3443
0130-001,2015,11,23,10,1624,1782,3406,3914
0130-001,2015,11,23,11,1661,1765,3426,3406
0130-001,2015,11,23,12,1649,1830,3479,3426
0130-001,2015,11,23,13,1567,1534,3101,3479
0130-001,2015,11,23,14,1709,1795,3504,3101
0130-001,2015,11,23,15,1772,1927,3699,3504
0130-001,2015,11,23,16,1750,2000,3750,3699
0130-001,2015,11,23,17,1612,2122,3734,3750
0130-001,2015,11,23,18,1709,2469,4178,3734
0130-001,2015,11,23,19,1587,2384,3971,4178
0130-001,2015,11,23,20,1245,1534,2779,3971
0130-001,2015,11,23,21,1090,1128,2218,2779
0130-001,2015,11,23,22,1017,884,1901,2218
0130-001,2015,11,23,23,661,542,1203,1901
0130-001,2015,11,23,24,471,351,822,1203
0130-001,2015,11,24,1,277,235,512,822
0130-001,2015,11,24,2,212,133,345,512
0130-001,2015,11,24,3,156,96,252,345
0130-001,2015,11,24,4,132,111,243,252
0130-001,2015,11,24,5,185,181,366,243
0130-001,2015,11,24,6,507,334,841,366
0130-001,2015,11,24,7,1513,764,2277,841
0130-001,2015,11,24,8,1989,1647,3636,2277
0130-001,2015,11,24,9,2127,2102,4229,3636
0130-001,2015,11,24,10,1856,1828,3684,4229
0130-001,2015,11,24,11,1824,1764,3588,3684
0130-001,2015,11,24,12,1655,1794,3449,3588
0130-001,2015,11,24,13,1476,1568,3044,3449
0130-001,2015,11,24,14,1742,1864,3606,3044
0130-001,2015,11,24,15,1844,1968,3812,3606
0130-001,2015,11,24,16,1841,1895,3736,3812
0130-001,2015,11,24,17,1737,2179,3916,3736
0130-001,2015,11,24,18,1904,2429,4333,3916
0130-001,2015,11,24,19,1827,2566,4393,4333
0130-001,2015,11,24,20,1344,1873,3217,4393
0130-001,2015,11,24,21,1161,1644,2805,3217
0130-001,2015,11,24,22,1107,1328,2435,2805
0130-001,2015,11,24,23,887,830,1717,2435
0130-001,2015,11,24,24,465,526,991,1717
0130-001,2015,11,25,1,303,344,647,991
0130-001,2015,11,25,2,192,210,402,647
0130-001,2015,11,25,3,148,170,318,402
0130-001,2015,11,25,4,111,159,270,318
0130-001,2015,11,25,5,137,239,376,270
0130-001,2015,11,25,6,351,338,689,376
0130-001,2015,11,25,7,1225,720,1945,689
0130-001,2015,11,25,8,1827,1558,3385,1945
0130-001,2015,11,25,9,1928,2042,3970,3385
0130-001,2015,11,25,10,1652,1867,3519,3970
0130-001,2015,11,25,11,1772,1736,3508,3519
0130-001,2015,11,25,12,1619,1749,3368,3508
0130-001,2015,11,25,13,1543,1601,3144,3368
0130-001,2015,11,25,14,1656,1892,3548,3144
0130-001,2015,11,25,15,1652,1868,3520,3548
0130-001,2015,11,25,16,1717,1935,3652,3520
0130-001,2015,11,25,17,1743,2093,3836,3652
0130-001,2015,11,25,18,1753,2442,4195,3836
0130-001,2015,11,25,19,1504,2491,3995,4195
0130-001,2015,11,25,20,1224,1819,3043,3995
0130-001,2015,11,25,21,1084,1526,2610,3043
0130-001,2015,11,25,22,1014,1217,2231,2610
0130-001,2015,11,25,23,733,765,1498,2231
0130-001,2015,11,25,24,452,479,931,1498
0130-001,2015,11,26,1,341,313,654,931
0130-001,2015,11,26,2,211,232,443,654
0130-001,2015,11,26,3,145,182,327,443
0130-001,2015,11,26,4,131,174,305,327
0130-001,2015,11,26,5,171,226,397,305
0130-001,2015,11,26,6,365,265,630,397
0130-001,2015,11,26,7,725,511,1236,630
0130-001,2015,11,26,8,1066,813,1879,1236
0130-001,2015,11,26,9,1104,1125,2229,1879
0130-001,2015,11,26,10,1333,1354,2687,2229
0130-001,2015,11,26,11,1292,1616,2908,2687
0130-001,2015,11,26,12,1256,1603,2859,2908
0130-001,2015,11,26,13,1065,1364,2429,2859
0130-001,2015,11,26,14,1271,1584,2855,2429
0130-001,2015,11,26,15,1287,1574,2861,2855
0130-001,2015,11,26,16,1362,1832,3194,2861
0130-001,2015,11,26,17,1449,1821,3270,3194
0130-001,2015,11,26,18,1429,1804,3233,3270
0130-001,2015,11,26,19,1385,1725,3110,3233
0130-001,2015,11,26,20,1062,1359,2421,3110
0130-001,2015,11,26,21,800,1107,1907,2421
0130-001,2015,11,26,22,751,818,1569,1907
0130-001,2015,11,26,23,569,494,1063,1569
0130-001,2015,11,26,24,331,307,638,1063
0130-001,2015,11,27,1,303,216,519,638
0130-001,2015,11,27,2,173,163,336,519
0130-001,2015,11,27,3,131,129,260,336
0130-001,2015,11,27,4,126,144,270,260
0130-001,2015,11,27,5,181,215,396,270
0130-001,2015,11,27,6,446,332,778,396
0130-001,2015,11,27,7,1385,657,2042,778
0130-001,2015,11,27,8,1693,1267,2960,2042
0130-001,2015,11,27,9,1743,1533,3276,2960
0130-001,2015,11,27,10,1700,1423,3123,3276
0130-001,2015,11,27,11,1879,1599,3478,3123
0130-001,2015,11,27,12,1486,1696,3182,3478
0130-001,2015,11,27,13,1465,1555,3020,3182
0130-001,2015,11,27,14,1434,1760,3194,3020
0130-001,2015,11,27,15,1642,1920,3562,3194
0130-001,2015,11,27,16,1574,1918,3492,3562
0130-001,2015,11,27,17,1632,1934,3566,3492
0130-001,2015,11,27,18,1554,2219,3773,3566
0130-001,2015,11,27,19,1634,2247,3881,3773
0130-001,2015,11,27,20,1425,1961,3386,3881
0130-001,2015,11,27,21,1045,1579,2624,3386
0130-001,2015,11,27,22,950,1198,2148,2624
0130-001,2015,11,27,23,721,764,1485,2148
0130-001,2015,11,27,24,516,540,1056,1485
0130-001,2015,11,28,1,346,387,733,1056
0130-001,2015,11,28,2,269,296,565,733
0130-001,2015,11,28,3,206,208,414,565
0130-001,2015,11,28,4,242,225,467,414
0130-001,2015,11,28,5,235,261,496,467
0130-001,2015,11,28,6,498,328,826,496
0130-001,2015,11,28,7,1003,621,1624,826
0130-001,2015,11,28,8,1416,1003,2419,1624
0130-001,2015,11,28,9,1600,1533,3133,2419
0130-001,2015,11,28,10,1608,1862,3470,3133
0130-001,2015,11,28,11,1785,2293,4078,3470
0130-001,2015,11,28,12,1713,2340,4053,4078
0130-001,2015,11,28,13,1786,2273,4059,4053
0130-001,2015,11,28,14,1714,2290,4004,4059
0130-001,2015,11,28,15,1810,2290,4100,4004
0130-001,2015,11,28,16,1872,2317,4189,4100
0130-001,2015,11,28,17,1917,2243,4160,4189
0130-001,2015,11,28,18,1928,2287,4215,4160
0130-001,2015,11,28,19,1916,2153,4069,4215
0130-001,2015,11,28,20,1143,1330,2473,4069
0130-001,2015,11,28,21,885,1007,1892,2473
0130-001,2015,11,28,22,791,776,1567,1892
0130-001,2015,11,28,23,660,695,1355,1567
0130-001,2015,11,28,24,443,464,907,1355
0130-001,2015,11,29,1,331,352,683,907
0130-001,2015,11,29,2,251,247,498,683
0130-001,2015,11,29,3,177,175,352,498
0130-001,2015,11,29,4,164,206,370,352
0130-001,2015,11,29,5,144,154,298,370
0130-001,2015,11,29,6,228,240,468,298
0130-001,2015,11,29,7,467,367,834,468
0130-001,2015,11,29,8,574,592,1166,834
0130-001,2015,11,29,9,733,885,1618,1166
0130-001,2015,11,29,10,787,1098,1885,1618
0130-001,2015,11,29,11,1018,1344,2362,1885
0130-001,2015,11,29,12,1284,1480,2764,2362
0130-001,2015,11,29,13,1465,1543,3008,2764
0130-001,2015,11,29,14,1714,1736,3450,3008
0130-001,2015,11,29,15,1805,1709,3514,3450
0130-001,2015,11,29,16,1868,1755,3623,3514
0130-001,2015,11,29,17,1825,1540,3365,3623
0130-001,2015,11,29,18,1827,1551,3378,3365
0130-001,2015,11,29,19,1763,1250,3013,3378
0130-001,2015,11,29,20,1702,1030,2732,3013
0130-001,2015,11,29,21,1549,988,2537,2732
0130-001,2015,11,29,22,1111,712,1823,2537
0130-001,2015,11,29,23,623,494,1117,1823
0130-001,2015,11,29,24,372,364,736,1117
0130-001,2015,11,30,1,255,216,471,736
0130-001,2015,11,30,2,146,147,293,471
0130-001,2015,11,30,3,89,101,190,293
0130-001,2015,11,30,4,97,152,249,190
0130-001,2015,11,30,5,141,196,337,249
0130-001,2015,11,30,6,463,360,823,337
0130-001,2015,11,30,7,1510,801,2311,823
0130-001,2015,11,30,8,1875,1659,3534,2311
0130-001,2015,11,30,9,2082,1980,4062,3534
0130-001,2015,11,30,10,2016,1791,3807,4062
0130-001,2015,11,30,11,2074,1777,3851,3807
0130-001,2015,11,30,12,1807,1778,3585,3851
0130-001,2015,11,30,13,1382,1544,2926,3585
0130-001,2015,11,30,14,1664,1915,3579,2926
0130-001,2015,11,30,15,1767,1874,3641,3579
0130-001,2015,11,30,16,1961,1917,3878,3641
0130-001,2015,11,30,17,1990,2061,4051,3878
0130-001,2015,11,30,18,1978,2389,4367,4051
0130-001,2015,11,30,19,1747,2467,4214,4367
0130-001,2015,11,30,20,1324,1754,3078,4214
0130-001,2015,11,30,21,1212,1585,2797,3078
0130-001,2015,11,30,22,1078,1049,2127,2797
0130-001,2015,11,30,23,731,647,1378,2127
0130-001,2015,11,30,24,519,450,969,1378
0130-001,2015,12,1,1,315,296,611,969
0130-001,2015,12,1,2,212,211,423,611
0130-001,2015,12,1,3,156,170,326,423
0130-001,2015,12,1,4,148,180,328,326
0130-001,2015,12,1,5,190,267,457,328
0130-001,2015,12,1,6,433,350,783,457
0130-001,2015,12,1,7,1359,780,2139,783
0130-001,2015,12,1,8,1607,1526,3133,2139
0130-001,2015,12,1,9,1757,1887,3644,3133
0130-001,2015,12,1,10,1685,1480,3165,3644
0130-001,2015,12,1,11,1883,1458,3341,3165
0130-001,2015,12,1,12,1808,1503,3311,3341
0130-001,2015,12,1,13,1651,1350,3001,3311
0130-001,2015,12,1,14,1708,1744,3452,3001
0130-001,2015,12,1,15,1605,1766,3371,3452
0130-001,2015,12,1,16,1523,1998,3521,3371
0130-001,2015,12,1,17,1524,2046,3570,3521
0130-001,2015,12,1,18,1871,2139,4010,3570
0130-001,2015,12,1,19,1643,2063,3706,4010
0130-001,2015,12,1,20,1331,1525,2856,3706
0130-001,2015,12,1,21,1217,1416,2633,2856
0130-001,2015,12,1,22,1036,1112,2148,2633
0130-001,2015,12,1,23,825,624,1449,2148
0130-001,2015,12,1,24,538,352,890,1449
0130-001,2015,12,2,1,364,226,590,890
0130-001,2015,12,2,2,241,133,374,590
0130-001,2015,12,2,3,169,119,288,374
0130-001,2015,12,2,4,147,124,271,288
0130-001,2015,12,2,5,177,142,319,271
0130-001,2015,12,2,6,450,250,700,319
0130-001,2015,12,2,7,1439,569,2008,700
0130-001,2015,12,2,8,1861,1424,3285,2008
0130-001,2015,12,2,9,1803,1694,3497,3285
0130-001,2015,12,2,10,1385,1508,2893,3497
0130-001,2015,12,2,11,1367,1542,2909,2893
0130-001,2015,12,2,12,1320,1510,2830,2909
0130-001,2015,12,2,13,1190,1286,2476,2830
0130-001,2015,12,2,14,1284,1456,2740,2476
0130-001,2015,12,2,15,1406,1672,3078,2740
0130-001,2015,12,2,16,1503,1696,3199,3078
0130-001,2015,12,2,17,1357,1840,3197,3199
0130-001,2015,12,2,18,1428,2151,3579,3197
0130-001,2015,12,2,19,1353,2032,3385,3579
0130-001,2015,12,2,20,1083,1529,2612,3385
0130-001,2015,12,2,21,883,1213,2096,2612
0130-001,2015,12,2,22,895,922,1817,2096
0130-001,2015,12,2,23,644,609,1253,1817
0130-001,2015,12,2,24,417,363,780,1253
0130-001,2015,12,3,1,293,238,531,780
0130-001,2015,12,3,2,175,173,348,531
0130-001,2015,12,3,3,134,124,258,348
0130-001,2015,12,3,4,111,133,244,258
0130-001,2015,12,3,5,124,128,252,244
0130-001,2015,12,3,6,321,235,556,252
0130-001,2015,12,3,7,1098,539,1637,556
0130-001,2015,12,3,8,1543,1415,2958,1637
0130-001,2015,12,3,9,1528,1552,3080,2958
0130-001,2015,12,3,10,1268,1256,2524,3080
0130-001,2015,12,3,11,1313,1364,2677,2524
0130-001,2015,12,3,12,1160,1440,2600,2677
0130-001,2015,12,3,13,1072,1415,2487,2600
0130-001,2015,12,3,14,1342,1553,2895,2487
0130-001,2015,12,3,15,1478,1513,2991,2895
0130-001,2015,12,3,16,1559,1581,3140,2991
0130-001,2015,12,3,17,1105,1135,2240,3140
0130-001,2015,12,3,18,898,1286,2184,2240
0130-001,2015,12,3,19,1093,1498,2591,2184
0130-001,2015,12,3,20,704,1451,2155,2591
0130-001,2015,12,3,21,498,1321,1819,2155
0130-001,2015,12,3,22,442,932,1374,1819
0130-001,2015,12,3,23,310,380,690,1374
0130-001,2015,12,3,24,201,278,479,690
0130-001,2015,12,4,1,161,251,412,479
0130-001,2015,12,4,2,131,155,286,412
0130-001,2015,12,4,3,83,113,196,286
0130-001,2015,12,4,4,97,128,225,196
0130-001,2015,12,4,5,114,175,289,225
0130-001,2015,12,4,6,290,289,579,289
0130-001,2015,12,4,7,1013,622,1635,579
0130-001,2015,12,4,8,1788,1261,3049,1635
0130-001,2015,12,4,9,1888,1599,3487,3049
0130-001,2015,12,4,10,1708,1468,3176,3487
0130-001,2015,12,4,11,1863,1583,3446,3176
0130-001,2015,12,4,12,1586,1684,3270,3446
0130-001,2015,12,4,13,1475,1741,3216,3270
0130-001,2015,12,4,14,1532,1898,3430,3216
0130-001,2015,12,4,15,1669,1898,3567,3430
0130-001,2015,12,4,16,1716,1843,3559,3567
0130-001,2015,12,4,17,1701,2076,3777,3559
0130-001,2015,12,4,18,1706,1812,3518,3777
0130-001,2015,12,4,19,1719,2474,4193,3518
0130-001,2015,12,4,20,1446,1994,3440,4193
0130-001,2015,12,4,21,1134,1736,2870,3440
0130-001,2015,12,4,22,1052,1149,2201,2870
0130-001,2015,12,4,23,961,842,1803,2201
0130-001,2015,12,4,24,625,564,1189,1803
0130-001,2015,12,5,1,487,433,920,1189
0130-001,2015,12,5,2,323,282,605,920
0130-001,2015,12,5,3,234,225,459,605
0130-001,2015,12,5,4,225,232,457,459
0130-001,2015,12,5,5,231,240,471,457
0130-001,2015,12,5,6,403,330,733,471
0130-001,2015,12,5,7,847,612,1459,733
0130-001,2015,12,5,8,1393,1093,2486,1459
0130-001,2015,12,5,9,1468,1626,3094,2486
0130-001,2015,12,5,10,1636,1864,3500,3094
0130-001,2015,12,5,11,1736,2095,3831,3500
0130-001,2015,12,5,12,1450,2366,3816,3831
0130-001,2015,12,5,13,1517,2364,3881,3816
0130-001,2015,12,5,14,1877,2250,4127,3881
0130-001,2015,12,5,15,1976,2239,4215,4127
0130-001,2015,12,5,16,1983,2163,4146,4215
0130-001,2015,12,5,17,2000,2284,4284,4146
0130-001,2015,12,5,18,2054,2442,4496,4284
0130-001,2015,12,5,19,2027,2167,4194,4496
0130-001,2015,12,5,20,1468,1242,2710,4194
0130-001,2015,12,5,21,1125,1013,2138,2710
0130-001,2015,12,5,22,1067,728,1795,2138
0130-001,2015,12,5,23,796,587,1383,1795
0130-001,2015,12,5,24,569,461,1030,1383
0130-001,2015,12,6,1,486,337,823,1030
0130-001,2015,12,6,2,319,253,572,823
0130-001,2015,12,6,3,258,199,457,572
0130-001,2015,12,6,4,219,144,363,457
0130-001,2015,12,6,5,178,127,305,363
0130-001,2015,12,6,6,287,180,467,305
0130-001,2015,12,6,7,574,296,870,467
0130-001,2015,12,6,8,634,560,1194,870
0130-001,2015,12,6,9,819,999,1818,1194
0130-001,2015,12,6,10,1033,1047,2080,1818
0130-001,2015,12,6,11,1178,1292,2470,2080
0130-001,2015,12,6,12,1157,1432,2589,2470
0130-001,2015,12,6,13,1201,1525,2726,2589
0130-001,2015,12,6,14,1427,1734,3161,2726
0130-001,2015,12,6,15,1482,1815,3297,3161
0130-001,2015,12,6,16,1568,1680,3248,3297
0130-001,2015,12,6,17,1749,1747,3496,3248
0130-001,2015,12,6,18,1766,1706,3472,3496
0130-001,2015,12,6,19,1783,1191,2974,3472
0130-001,2015,12,6,20,1450,904,2354,2974
0130-001,2015,12,6,21,1168,717,1885,2354
0130-001,2015,12,6,22,912,633,1545,1885
0130-001,2015,12,6,23,675,409,1084,1545
0130-001,2015,12,6,24,412,245,657,1084
0130-001,2015,12,7,1,254,144,398,657
0130-001,2015,12,7,2,168,111,279,398
0130-001,2015,12,7,3,117,77,194,279
0130-001,2015,12,7,4,127,91,218,194
0130-001,2015,12,7,5,171,138,309,218
0130-001,2015,12,7,6,515,235,750,309
0130-001,2015,12,7,7,1614,656,2270,750
0130-001,2015,12,7,8,1860,1499,3359,2270
0130-001,2015,12,7,9,1986,1731,3717,3359
0130-001,2015,12,7,10,1602,1335,2937,3717
0130-001,2015,12,7,11,1455,1468,2923,2937
0130-001,2015,12,7,12,1355,1400,2755,2923
0130-001,2015,12,7,13,1328,1072,2400,2755
0130-001,2015,12,7,14,1477,1596,3073,2400
0130-001,2015,12,7,15,1583,1705,3288,3073
0130-001,2015,12,7,16,1543,1785,3328,3288
0130-001,2015,12,7,17,1441,1786,3227,3328
0130-001,2015,12,7,18,1605,2182,3787,3227
0130-001,2015,12,7,19,1462,2006,3468,3787
0130-001,2015,12,7,20,1133,1253,2386,3468
0130-001,2015,12,7,21,975,1306,2281,2386
0130-001,2015,12,7,22,861,993,1854,2281
0130-001,2015,12,7,23,618,545,1163,1854
0130-001,2015,12,7,24,432,308,740,1163
0130-001,2015,12,8,1,290,241,531,740
0130-001,2015,12,8,2,203,134,337,531
0130-001,2015,12,8,3,131,93,224,337
0130-001,2015,12,8,4,140,134,274,224
0130-001,2015,12,8,5,186,139,325,274
0130-001,2015,12,8,6,503,234,737,325
0130-001,2015,12,8,7,1466,588,2054,737
0130-001,2015,12,8,8,1927,1346,3273,2054
0130-001,2015,12,8,9,1902,1695,3597,3273
0130-001,2015,12,8,10,1656,1459,3115,3597
0130-001,2015,12,8,11,1585,1430,3015,3115
0130-001,2015,12,8,12,1450,1483,2933,3015
0130-001,2015,12,8,13,1266,1328,2594,2933
0130-001,2015,12,8,14,1476,1469,2945,2594
0130-001,2015,12,8,15,1550,1474,3024,2945
0130-001,2015,12,8,16,1467,1759,3226,3024
0130-001,2015,12,8,17,1418,1920,3338,3226
0130-001,2015,12,8,18,1740,2128,3868,3338
0130-001,2015,12,8,19,1556,2188,3744,3868
0130-001,2015,12,8,20,1331,1579,2910,3744
0130-001,2015,12,8,21,1182,1559,2741,2910
0130-001,2015,12,8,22,1050,1174,2224,2741
0130-001,2015,12,8,23,853,755,1608,2224
0130-001,2015,12,8,24,539,473,1012,1608
0130-001,2015,12,9,1,386,361,747,1012
0130-001,2015,12,9,2,229,189,418,747
0130-001,2015,12,9,3,137,151,288,418
0130-001,2015,12,9,4,142,164,306,288
0130-001,2015,12,9,5,190,227,417,306
0130-001,2015,12,9,6,514,294,808,417
0130-001,2015,12,9,7,1440,644,2084,808
0130-001,2015,12,9,8,1754,1491,3245,2084
0130-001,2015,12,9,9,1863,1868,3731,3245
0130-001,2015,12,9,10,1550,1688,3238,3731
0130-001,2015,12,9,11,1508,1639,3147,3238
0130-001,2015,12,9,12,1487,1630,3117,3147
0130-001,2015,12,9,13,1292,1444,2736,3117
0130-001,2015,12,9,14,1473,1674,3147,2736
0130-001,2015,12,9,15,1607,1770,3377,3147
0130-001,2015,12,9,16,1518,1816,3334,3377
0130-001,2015,12,9,17,1422,1966,3388,3334
0130-001,2015,12,9,18,1523,2296,3819,3388
0130-001,2015,12,9,19,1471,2262,3733,3819
0130-001,2015,12,9,20,1161,1674,2835,3733
0130-001,2015,12,9,21,999,1370,2369,2835
0130-001,2015,12,9,22,1031,1070,2101,2369
0130-001,2015,12,9,23,817,687,1504,2101
0130-001,2015,12,9,24,512,421,933,1504
0130-001,2015,12,10,1,328,226,554,933
0130-001,2015,12,10,2,238,119,357,554
0130-001,2015,12,10,3,149,91,240,357
0130-001,2015,12,10,4,154,114,268,240
0130-001,2015,12,10,5,177,152,329,268
0130-001,2015,12,10,6,464,269,733,329
0130-001,2015,12,10,7,1441,647,2088,733
0130-001,2015,12,10,8,1836,1337,3173,2088
0130-001,2015,12,10,9,1893,1757,3650,3173
0130-001,2015,12,10,10,1581,1400,2981,3650
0130-001,2015,12,10,11,1461,1406,2867,2981
0130-001,2015,12,10,12,1269,1497,2766,2867
0130-001,2015,12,10,13,1193,1360,2553,2766
0130-001,2015,12,10,14,1489,1482,2971,2553
0130-001,2015,12,10,15,1497,1535,3032,2971
0130-001,2015,12,10,16,1505,1766,3271,3032
0130-001,2015,12,10,17,1661,2050,3711,3271
0130-001,2015,12,10,18,1752,2148,3900,3711
0130-001,2015,12,10,19,1570,2178,3748,3900
0130-001,2015,12,10,20,1289,1731,3020,3748
0130-001,2015,12,10,21,1102,1530,2632,3020
0130-001,2015,12,10,22,983,1211,2194,2632
0130-001,2015,12,10,23,742,849,1591,2194
0130-001,2015,12,10,24,476,523,999,1591
0130-001,2015,12,11,1,359,382,741,999
0130-001,2015,12,11,2,201,254,455,741
0130-001,2015,12,11,3,142,185,327,455
0130-001,2015,12,11,4,127,205,332,327
0130-001,2015,12,11,5,151,245,396,332
0130-001,2015,12,11,6,403,385,788,396
0130-001,2015,12,11,7,1228,795,2023,788
0130-001,2015,12,11,8,1740,1578,3318,2023
0130-001,2015,12,11,9,1816,1995,3811,3318
0130-001,2015,12,11,10,1704,1655,3359,3811
0130-001,2015,12,11,11,1871,1859,3730,3359
0130-001,2015,12,11,12,1536,1755,3291,3730
0130-001,2015,12,11,13,1470,1696,3166,3291
0130-001,2015,12,11,14,1483,1924,3407,3166
0130-001,2015,12,11,15,1656,2031,3687,3407
0130-001,2015,12,11,16,1645,1953,3598,3687
0130-001,2015,12,11,17,1666,2184,3850,3598
0130-001,2015,12,11,18,1630,2506,4136,3850
0130-001,2015,12,11,19,1676,2458,4134,4136
0130-001,2015,12,11,20,1436,1943,3379,4134
0130-001,2015,12,11,21,1090,1665,2755,3379
0130-001,2015,12,11,22,1001,1280,2281,2755
0130-001,2015,12,11,23,852,913,1765,2281
0130-001,2015,12,11,24,573,573,1146,1765
0130-001,2015,12,12,1,461,487,948,1146
0130-001,2015,12,12,2,321,326,647,948
0130-001,2015,12,12,3,205,225,430,647
0130-001,2015,12,12,4,196,212,408,430
0130-001,2015,12,12,5,210,256,466,408
0130-001,2015,12,12,6,402,352,754,466
0130-001,2015,12,12,7,755,673,1428,754
0130-001,2015,12,12,8,1233,1069,2302,1428
0130-001,2015,12,12,9,1534,1580,3114,2302
0130-001,2015,12,12,10,1622,1863,3485,3114
0130-001,2015,12,12,11,1760,2194,3954,3485
0130-001,2015,12,12,12,1582,2353,3935,3954
0130-001,2015,12,12,13,1652,2318,3970,3935
0130-001,2015,12,12,14,1796,2270,4066,3970
0130-001,2015,12,12,15,1893,2264,4157,4066
0130-001,2015,12,12,16,1928,2240,4168,4157
0130-001,2015,12,12,17,1958,2264,4222,4168
0130-001,2015,12,12,18,1991,2364,4355,4222
0130-001,2015,12,12,19,1972,2160,4132,4355
0130-001,2015,12,12,20,1306,1286,2592,4132
0130-001,2015,12,12,21,1005,1010,2015,2592
0130-001,2015,12,12,22,882,889,1771,2015
0130-001,2015,12,12,23,773,662,1435,1771
0130-001,2015,12,12,24,490,491,981,1435
0130-001,2015,12,13,1,388,370,758,981
0130-001,2015,12,13,2,294,291,585,758
0130-001,2015,12,13,3,231,219,450,585
0130-001,2015,12,13,4,187,157,344,450
0130-001,2015,12,13,5,162,158,320,344
0130-001,2015,12,13,6,246,210,456,320
0130-001,2015,12,13,7,408,319,727,456
0130-001,2015,12,13,8,600,595,1195,727
0130-001,2015,12,13,9,665,917,1582,1195
0130-001,2015,12,13,10,788,1057,1845,1582
0130-001,2015,12,13,11,1033,1275,2308,1845
0130-001,2015,12,13,12,1054,1467,2521,2308
0130-001,2015,12,13,13,1285,1592,2877,2521
0130-001,2015,12,13,14,1443,1583,3026,2877
0130-001,2015,12,13,15,1589,1508,3097,3026
0130-001,2015,12,13,16,1678,1608,3286,3097
0130-001,2015,12,13,17,1592,1562,3154,3286
0130-001,2015,12,13,18,1640,1484,3124,3154
0130-001,2015,12,13,19,1659,1125,2784,3124
0130-001,2015,12,13,20,1306,872,2178,2784
0130-001,2015,12,13,21,1071,820,1891,2178
0130-001,2015,12,13,22,867,613,1480,1891
0130-001,2015,12,13,23,643,430,1073,1480
0130-001,2015,12,13,24,433,284,717,1073
0130-001,2015,12,14,1,258,168,426,717
0130-001,2015,12,14,2,161,103,264,426
0130-001,2015,12,14,3,93,93,186,264
0130-001,2015,12,14,4,114,118,232,186
0130-001,2015,12,14,5,161,198,359,232
0130-001,2015,12,14,6,509,331,840,359
0130-001,2015,12,14,7,1374,841,2215,840
0130-001,2015,12,14,8,1484,1529,3013,2215
0130-001,2015,12,14,9,1614,1984,3598,3013
0130-001,2015,12,14,10,1436,1710,3146,3598
0130-001,2015,12,14,11,1385,1781,3166,3146
0130-001,2015,12,14,12,1372,1755,3127,3166
0130-001,2015,12,14,13,1316,1678,2994,3127
0130-001,2015,12,14,14,1456,1860,3316,2994
0130-001,2015,12,14,15,1488,1793,3281,3316
0130-001,2015,12,14,16,1503,1858,3361,3281
0130-001,2015,12,14,17,1603,1930,3533,3361
0130-001,2015,12,14,18,1678,2209,3887,3533
0130-001,2015,12,14,19,1713,2264,3977,3887
0130-001,2015,12,14,20,1302,1686,2988,3977
0130-001,2015,12,14,21,1045,1537,2582,2988
0130-001,2015,12,14,22,967,1202,2169,2582
0130-001,2015,12,14,23,707,760,1467,2169
0130-001,2015,12,14,24,455,462,917,1467
0130-001,2015,12,15,1,344,333,677,917
0130-001,2015,12,15,2,223,199,422,677
0130-001,2015,12,15,3,153,159,312,422
0130-001,2015,12,15,4,164,160,324,312
0130-001,2015,12,15,5,188,232,420,324
0130-001,2015,12,15,6,489,364,853,420
0130-001,2015,12,15,7,1453,793,2246,853
0130-001,2015,12,15,8,1692,1560,3252,2246
0130-001,2015,12,15,9,1610,1868,3478,3252
0130-001,2015,12,15,10,1210,1226,2436,3478
0130-001,2015,12,15,11,1269,1025,2294,2436
0130-001,2015,12,15,12,1065,1028,2093,2294
0130-001,2015,12,15,13,1017,939,1956,2093
0130-001,2015,12,15,14,1278,1069,2347,1956
0130-001,2015,12,15,15,1275,1156,2431,2347
0130-001,2015,12,15,16,1277,1136,2413,2431
0130-001,2015,12,15,17,1213,1190,2403,2413
0130-001,2015,12,15,18,1225,1410,2635,2403
0130-001,2015,12,15,19,1167,1409,2576,2635
0130-001,2015,12,15,20,841,1032,1873,2576
0130-001,2015,12,15,21,770,1043,1813,1873
0130-001,2015,12,15,22,739,892,1631,1813
0130-001,2015,12,15,23,565,593,1158,1631
0130-001,2015,12,15,24,360,433,793,1158
0130-001,2015,12,16,1,256,306,562,793
0130-001,2015,12,16,2,153,216,369,562
0130-001,2015,12,16,3,143,171,314,369
0130-001,2015,12,16,4,133,195,328,314
0130-001,2015,12,16,5,164,249,413,328
0130-001,2015,12,16,6,401,346,747,413
0130-001,2015,12,16,7,1267,793,2060,747
0130-001,2015,12,16,8,1624,1209,2833,2060
0130-001,2015,12,16,9,1456,1421,2877,2833
0130-001,2015,12,16,10,1271,1202,2473,2877
0130-001,2015,12,16,11,1237,1109,2346,2473
0130-001,2015,12,16,12,1266,1463,2729,2346
0130-001,2015,12,16,13,1319,1591,2910,2729
0130-001,2015,12,16,14,1452,1798,3250,2910
0130-001,2015,12,16,15,1492,1644,3136,3250
0130-001,2015,12,16,16,1321,1478,2799,3136
0130-001,2015,12,16,17,1281,1334,2615,2799
0130-001,2015,12,16,18,1431,2135,3566,2615
0130-001,2015,12,16,19,1307,2510,3817,3566
0130-001,2015,12,16,20,1071,1601,2672,3817
0130-001,2015,12,16,21,906,1325,2231,2672
0130-001,2015,12,16,22,923,1098,2021,2231
0130-001,2015,12,16,23,697,745,1442,2021
0130-001,2015,12,16,24,432,384,816,1442
0130-001,2015,12,17,1,323,351,674,816
0130-001,2015,12,17,2,194,186,380,674
0130-001,2015,12,17,3,140,143,283,380
0130-001,2015,12,17,4,145,158,303,283
0130-001,2015,12,17,5,192,187,379,303
0130-001,2015,12,17,6,465,241,706,379
0130-001,2015,12,17,7,1467,621,2088,706
0130-001,2015,12,17,8,1724,1386,3110,2088
0130-001,2015,12,17,9,1907,1809,3716,3110
0130-001,2015,12,17,10,1553,1608,3161,3716
0130-001,2015,12,17,11,1418,1677,3095,3161
0130-001,2015,12,17,12,1524,1712,3236,3095
0130-001,2015,12,17,13,1367,1612,2979,3236
0130-001,2015,12,17,14,1481,1777,3258,2979
0130-001,2015,12,17,15,1630,1848,3478,3258
0130-001,2015,12,17,16,1524,1905,3429,3478
0130-001,2015,12,17,17,1616,2010,3626,3429
0130-001,2015,12,17,18,1748,2388,4136,3626
0130-001,2015,12,17,19,1608,2466,4074,4136
0130-001,2015,12,17,20,1342,1737,3079,4074
0130-001,2015,12,17,21,1142,1495,2637,3079
0130-001,2015,12,17,22,1083,1184,2267,2637
0130-001,2015,12,17,23,877,750,1627,2267
0130-001,2015,12,17,24,623,471,1094,1627
0130-001,2015,12,18,1,458,377,835,1094
0130-001,2015,12,18,2,320,263,583,835
0130-001,2015,12,18,3,177,172,349,583
0130-001,2015,12,18,4,184,173,357,349
0130-001,2015,12,18,5,232,250,482,357
0130-001,2015,12,18,6,481,368,849,482
0130-001,2015,12,18,7,1434,709,2143,849
0130-001,2015,12,18,8,1792,1529,3321,2143
0130-001,2015,12,18,9,1914,1826,3740,3321
0130-001,2015,12,18,10,1680,1364,3044,3740
0130-001,2015,12,18,11,1851,1190,3041,3044
0130-001,2015,12,18,12,1608,1356,2964,3041
0130-001,2015,12,18,13,1315,1526,2841,2964
0130-001,2015,12,18,14,1579,1954,3533,2841
0130-001,2015,12,18,15,1641,1896,3537,3533
0130-001,2015,12,18,16,1679,1567,3246,3537
0130-001,2015,12,18,17,1727,1685,3412,3246
0130-001,2015,12,18,18,1799,2446,4245,3412
0130-001,2015,12,18,19,1651,2554,4205,4245
0130-001,2015,12,18,20,1407,1903,3310,4205
0130-001,2015,12,18,21,1328,1619,2947,3310
0130-001,2015,12,18,22,1284,1208,2492,2947
0130-001,2015,12,18,23,1007,902,1909,2492
0130-001,2015,12,18,24,721,559,1280,1909
0130-001,2015,12,19,1,552,498,1050,1280
0130-001,2015,12,19,2,426,373,799,1050
0130-001,2015,12,19,3,318,262,580,799
0130-001,2015,12,19,4,246,192,438,580
0130-001,2015,12,19,5,248,211,459,438
0130-001,2015,12,19,6,439,252,691,459
0130-001,2015,12,19,7,889,529,1418,691
0130-001,2015,12,19,8,1438,974,2412,1418
0130-001,2015,12,19,9,1435,1550,2985,2412
0130-001,2015,12,19,10,1652,1725,3377,2985
0130-001,2015,12,19,11,1704,1895,3599,3377
0130-001,2015,12,19,12,1474,2130,3604,3599
0130-001,2015,12,19,13,1429,2056,3485,3604
0130-001,2015,12,19,14,1560,2094,3654,3485
0130-001,2015,12,19,15,1666,1991,3657,3654
0130-001,2015,12,19,16,1721,1952,3673,3657
0130-001,2015,12,19,17,1937,1997,3934,3673
0130-001,2015,12,19,18,1837,2280,4117,3934
0130-001,2015,12,19,19,1886,1898,3784,4117
0130-001,2015,12,19,20,1518,1244,2762,3784
0130-001,2015,12,19,21,1119,717,1836,2762
0130-001,2015,12,19,22,1048,876,1924,1836
0130-001,2015,12,19,23,803,652,1455,1924
0130-001,2015,12,19,24,583,522,1105,1455
0130-001,2015,12,20,1,500,409,909,1105
0130-001,2015,12,20,2,397,270,667,909
0130-001,2015,12,20,3,313,196,509,667
0130-001,2015,12,20,4,244,196,440,509
0130-001,2015,12,20,5,191,150,341,440
0130-001,2015,12,20,6,284,219,503,341
0130-001,2015,12,20,7,517,295,812,503
0130-001,2015,12,20,8,729,523,1252,812
0130-001,2015,12,20,9,869,950,1819,1252
0130-001,2015,12,20,10,951,733,1684,1819
0130-001,2015,12,20,11,1151,1138,2289,1684
0130-001,2015,12,20,12,1205,1506,2711,2289
0130-001,2015,12,20,13,1349,1388,2737,2711
0130-001,2015,12,20,14,1557,1532,3089,2737
0130-001,2015,12,20,15,1633,1530,3163,3089
0130-001,2015,12,20,16,1777,1807,3584,3163
0130-001,2015,12,20,17,1890,1685,3575,3584
0130-001,2015,12,20,18,1813,1707,3520,3575
0130-001,2015,12,20,19,1557,1326,2883,3520
0130-001,2015,12,20,20,1322,841,2163,2883
0130-001,2015,12,20,21,1116,715,1831,2163
0130-001,2015,12,20,22,966,544,1510,1831
0130-001,2015,12,20,23,687,359,1046,1510
0130-001,2015,12,20,24,397,237,634,1046
0130-001,2015,12,21,1,291,147,438,634
0130-001,2015,12,21,2,165,101,266,438
0130-001,2015,12,21,3,141,80,221,266
0130-001,2015,12,21,4,105,89,194,221
0130-001,2015,12,21,5,166,168,334,194
0130-001,2015,12,21,6,512,283,795,334
0130-001,2015,12,21,7,1494,748,2242,795
0130-001,2015,12,21,8,1672,1514,3186,2242
0130-001,2015,12,21,9,1800,1858,3658,3186
0130-001,2015,12,21,10,1519,1522,3041,3658
0130-001,2015,12,21,11,1420,1624,3044,3041
0130-001,2015,12,21,12,1364,1578,2942,3044
0130-001,2015,12,21,13,1322,1375,2697,2942
0130-001,2015,12,21,14,1466,1728,3194,2697
0130-001,2015,12,21,15,1536,1749,3285,3194
0130-001,2015,12,21,16,1523,1822,3345,3285
0130-001,2015,12,21,17,1522,1858,3380,3345
0130-001,2015,12,21,18,1642,2196,3838,3380
0130-001,2015,12,21,19,963,1026,1989,3838
0130-001,2015,12,21,20,802,701,1503,1989
0130-001,2015,12,21,21,763,565,1328,1503
0130-001,2015,12,21,22,680,503,1183,1328
0130-001,2015,12,21,23,553,337,890,1183
0130-001,2015,12,21,24,329,202,531,890
0130-001,2015,12,22,1,233,176,409,531
0130-001,2015,12,22,2,150,111,261,409
0130-001,2015,12,22,3,89,88,177,261
0130-001,2015,12,22,4,76,85,161,177
0130-001,2015,12,22,5,106,133,239,161
0130-001,2015,12,22,6,292,299,591,239
0130-001,2015,12,22,7,1031,690,1721,591
0130-001,2015,12,22,8,1446,1453,2899,1721
0130-001,2015,12,22,9,1633,1782,3415,2899
0130-001,2015,12,22,10,1526,1342,2868,3415
0130-001,2015,12,22,11,1588,1228,2816,2868
0130-001,2015,12,22,12,1188,1256,2444,2816
0130-001,2015,12,22,13,1021,1134,2155,2444
0130-001,2015,12,22,14,1348,1269,2617,2155
0130-001,2015,12,22,15,1260,1315,2575,2617
0130-001,2015,12,22,16,1440,1448,2888,2575
0130-001,2015,12,22,17,1514,1555,3069,2888
0130-001,2015,12,22,18,1503,1769,3272,3069
0130-001,2015,12,22,19,1336,1798,3134,3272
0130-001,2015,12,22,20,1094,1306,2400,3134
0130-001,2015,12,22,21,928,1301,2229,2400
0130-001,2015,12,22,22,894,1033,1927,2229
0130-001,2015,12,22,23,702,674,1376,1927
0130-001,2015,12,22,24,471,453,924,1376
0130-001,2015,12,23,1,324,221,545,924
0130-001,2015,12,23,2,217,131,348,545
0130-001,2015,12,23,3,147,105,252,348
0130-001,2015,12,23,4,124,104,228,252
0130-001,2015,12,23,5,132,144,276,228
0130-001,2015,12,23,6,458,320,778,276
0130-001,2015,12,23,7,1354,718,2072,778
0130-001,2015,12,23,8,1689,1350,3039,2072
0130-001,2015,12,23,9,1660,1644,3304,3039
0130-001,2015,12,23,10,1410,1445,2855,3304
0130-001,2015,12,23,11,1372,1374,2746,2855
0130-001,2015,12,23,12,1376,1546,2922,2746
0130-001,2015,12,23,13,1306,1518,2824,2922
0130-001,2015,12,23,14,1462,1736,3198,2824
0130-001,2015,12,23,15,1550,1707,3257,3198
0130-001,2015,12,23,16,1420,1647,3067,3257
0130-001,2015,12,23,17,1352,1650,3002,3067
0130-001,2015,12,23,18,1477,2216,3693,3002
0130-001,2015,12,23,19,1389,2386,3775,3693
0130-001,2015,12,23,20,1116,1638,2754,3775
0130-001,2015,12,23,21,952,1348,2300,2754
0130-001,2015,12,23,22,977,1084,2061,2300
0130-001,2015,12,23,23,757,716,1473,2061
0130-001,2015,12,23,24,472,402,874,1473
0130-001,2015,12,24,1,425,228,653,874
0130-001,2015,12,24,2,263,143,406,653
0130-001,2015,12,24,3,162,139,301,406
0130-001,2015,12,24,4,185,122,307,301
0130-001,2015,12,24,5,205,197,402,307
0130-001,2015,12,24,6,464,255,719,402
0130-001,2015,12,24,7,1454,634,2088,719
0130-001,2015,12,24,8,1780,1362,3142,2088
0130-001,2015,12,24,9,1900,1783,3683,3142
0130-001,2015,12,24,10,1567,1504,3071,3683
0130-001,2015,12,24,11,1440,1542,2982,3071
0130-001,2015,12,24,12,1396,1604,3000,2982
0130-001,2015,12,24,13,1280,1486,2766,3000
0130-001,2015,12,24,14,1485,1630,3115,2766
0130-001,2015,12,24,15,1564,1692,3256,3115
0130-001,2015,12,24,16,1514,1836,3350,3256
0130-001,2015,12,24,17,1638,2030,3668,3350
0130-001,2015,12,24,18,1750,2268,4018,3668
0130-001,2015,12,24,19,1589,2322,3911,4018
0130-001,2015,12,24,20,1316,1734,3050,3911
0130-001,2015,12,24,21,1122,1512,2634,3050
0130-001,2015,12,24,22,1033,1198,2231,2634
0130-001,2015,12,24,23,810,800,1610,2231
0130-001,2015,12,24,24,550,497,1047,1610
0130-001,2015,12,25,1,507,380,887,1047
0130-001,2015,12,25,2,336,258,594,887
0130-001,2015,12,25,3,255,178,433,594
0130-001,2015,12,25,4,251,189,440,433
0130-001,2015,12,25,5,252,248,500,440
0130-001,2015,12,25,6,412,376,788,500
0130-001,2015,12,25,7,804,752,1556,788
0130-001,2015,12,25,8,960,1554,2514,1556
0130-001,2015,12,25,9,1000,1910,2910,2514
0130-001,2015,12,25,10,1066,1510,2576,2910
0130-001,2015,12,25,11,1202,1524,2726,2576
0130-001,2015,12,25,12,1138,1556,2694,2726
0130-001,2015,12,25,13,1399,1611,3010,2694
0130-001,2015,12,25,14,1581,1939,3520,3010
0130-001,2015,12,25,15,1575,1964,3539,3520
0130-001,2015,12,25,16,1590,1760,3350,3539
0130-001,2015,12,25,17,1525,1934,3459,3350
0130-001,2015,12,25,18,1691,2476,4167,3459
0130-001,2015,12,25,19,1624,2506,4130,4167
0130-001,2015,12,25,20,1193,1923,3116,4130
0130-001,2015,12,25,21,1012,1642,2654,3116
0130-001,2015,12,25,22,864,1244,2108,2654
0130-001,2015,12,25,23,720,908,1628,2108
0130-001,2015,12,25,24,448,566,1014,1628
0130-001,2015,12,26,1,506,492,998,1014
0130-001,2015,12,26,2,374,350,724,998
0130-001,2015,12,26,3,262,244,506,724
0130-001,2015,12,26,4,221,202,423,506
0130-001,2015,12,26,5,229,234,463,423
0130-001,2015,12,26,6,420,302,722,463
0130-001,2015,12,26,7,822,601,1423,722
0130-001,2015,12,26,8,1336,1022,2358,1423
0130-001,2015,12,26,9,1484,1565,3049,2358
0130-001,2015,12,26,10,1637,1794,3431,3049
0130-001,2015,12,26,11,1732,2044,3776,3431
0130-001,2015,12,26,12,1528,2242,3770,3776
0130-001,2015,12,26,13,1540,2187,3727,3770
0130-001,2015,12,26,14,1678,2182,3860,3727
0130-001,2015,12,26,15,1780,2128,3908,3860
0130-001,2015,12,26,16,1824,2096,3920,3908
0130-001,2015,12,26,17,1948,2130,4078,3920
0130-001,2015,12,26,18,1914,2322,4236,4078
0130-001,2015,12,26,19,1929,2029,3958,4236
0130-001,2015,12,26,20,1412,1265,2677,3958
0130-001,2015,12,26,21,1062,864,1926,2677
0130-001,2015,12,26,22,965,882,1847,1926
0130-001,2015,12,26,23,788,657,1445,1847
0130-001,2015,12,26,24,536,506,1042,1445
0130-001,2015,12,27,1,444,390,834,1042
0130-001,2015,12,27,2,346,280,626,834
0130-001,2015,12,27,3,272,208,480,626
0130-001,2015,12,27,4,216,176,392,480
0130-001,2015,12,27,5,176,154,330,392
0130-001,2015,12,27,6,265,214,479,330
0130-001,2015,12,27,7,462,307,769,479
0130-001,2015,12,27,8,664,559,1223,769
0130-001,2015,12,27,9,767,934,1701,1223
0130-001,2015,12,27,10,870,895,1765,1701
0130-001,2015,12,27,11,1092,1206,2298,1765
0130-001,2015,12,27,12,1130,1486,2616,2298
0130-001,2015,12,27,13,1317,1490,2807,2616
0130-001,2015,12,27,14,1500,1558,3058,2807
0130-001,2015,12,27,15,1611,1519,3130,3058
0130-001,2015,12,27,16,1728,1708,3436,3130
0130-001,2015,12,27,17,1741,1624,3365,3436
0130-001,2015,12,27,18,1726,1596,3322,3365
0130-001,2015,12,27,19,1608,1226,2834,3322
0130-001,2015,12,27,20,1314,856,2170,2834
0130-001,2015,12,27,21,1094,768,1862,2170
0130-001,2015,12,27,22,916,578,1494,1862
0130-001,2015,12,27,23,665,394,1059,1494
0130-001,2015,12,27,24,415,260,675,1059
0130-001,2015,12,28,1,296,215,511,675
0130-001,2015,12,28,2,146,103,249,511
0130-001,2015,12,28,3,125,79,204,249
0130-001,2015,12,28,4,114,115,229,204
0130-001,2015,12,28,5,182,207,389,229
0130-001,2015,12,28,6,504,307,811,389
0130-001,2015,12,28,7,1592,794,2386,811
0130-001,2015,12,28,8,1727,1522,3249,2386
0130-001,2015,12,28,9,1780,1921,3701,3249
0130-001,2015,12,28,10,1666,1616,3282,3701
0130-001,2015,12,28,11,1740,1702,3442,3282
0130-001,2015,12,28,12,1688,1666,3354,3442
0130-001,2015,12,28,13,1561,1526,3087,3354
0130-001,2015,12,28,14,1800,1794,3594,3087
0130-001,2015,12,28,15,1839,1771,3610,3594
0130-001,2015,12,28,16,1862,1840,3702,3610
0130-001,2015,12,28,17,1796,1894,3690,3702
0130-001,2015,12,28,18,1879,2202,4081,3690
0130-001,2015,12,28,19,1627,1645,3272,4081
0130-001,2015,12,28,20,1315,1194,2509,3272
0130-001,2015,12,28,21,1108,1168,2276,2509
0130-001,2015,12,28,22,996,841,1837,2276
0130-001,2015,12,28,23,790,571,1361,1837
0130-001,2015,12,28,24,569,397,966,1361
0130-001,2015,12,29,1,394,305,699,966
0130-001,2015,12,29,2,249,161,410,699
0130-001,2015,12,29,3,175,122,297,410
0130-001,2015,12,29,4,186,127,313,297
0130-001,2015,12,29,5,206,213,419,313
0130-001,2015,12,29,6,473,310,783,419
0130-001,2015,12,29,7,1242,742,1984,783
0130-001,2015,12,29,8,1569,1506,3075,1984
0130-001,2015,12,29,9,1622,1825,3447,3075
0130-001,2015,12,29,10,1368,1284,2652,3447
0130-001,2015,12,29,11,1428,1126,2554,2652
0130-001,2015,12,29,12,1126,1142,2268,2554
0130-001,2015,12,29,13,1019,1036,2055,2268
0130-001,2015,12,29,14,1313,1169,2482,2055
0130-001,2015,12,29,15,1268,1236,2504,2482
0130-001,2015,12,29,16,1358,1292,2650,2504
0130-001,2015,12,29,17,1364,1372,2736,2650
0130-001,2015,12,29,18,1364,1590,2954,2736
0130-001,2015,12,29,19,1252,1604,2856,2954
0130-001,2015,12,29,20,968,1169,2137,2856
0130-001,2015,12,29,21,1143,1074,2217,2137
0130-001,2015,12,29,22,1068,903,1971,2217
0130-001,2015,12,29,23,831,700,1531,1971
0130-001,2015,12,29,24,607,565,1172,1531
0130-001,2015,12,30,1,454,409,863,1172
0130-001,2015,12,30,2,291,259,550,863
0130-001,2015,12,30,3,199,199,398,550
0130-001,2015,12,30,4,191,176,367,398
0130-001,2015,12,30,5,195,255,450,367
0130-001,2015,12,30,6,463,361,824,450
0130-001,2015,12,30,7,1310,756,2066,824
0130-001,2015,12,30,8,1656,1280,2936,2066
0130-001,2015,12,30,9,1558,1532,3090,2936
0130-001,2015,12,30,10,1340,1324,2664,3090
0130-001,2015,12,30,11,1304,1242,2546,2664
0130-001,2015,12,30,12,1321,1504,2825,2546
0130-001,2015,12,30,13,1312,1554,2866,2825
0130-001,2015,12,30,14,1457,1767,3224,2866
0130-001,2015,12,30,15,1521,1676,3197,3224
0130-001,2015,12,30,16,1370,1562,2932,3197
0130-001,2015,12,30,17,1316,1492,2808,2932
0130-001,2015,12,30,18,1454,2176,3630,2808
0130-001,2015,12,30,19,1348,2448,3796,3630
0130-001,2015,12,30,20,1094,1620,2714,3796
0130-001,2015,12,30,21,667,810,1477,2714
0130-001,2015,12,30,22,631,646,1277,1477
0130-001,2015,12,30,23,525,434,959,1277
0130-001,2015,12,30,24,350,310,660,959
0130-001,2015,12,31,1,295,242,537,660
0130-001,2015,12,31,2,222,147,369,537
0130-001,2015,12,31,3,134,109,243,369
0130-001,2015,12,31,4,107,105,212,243
0130-001,2015,12,31,5,117,127,244,212
0130-001,2015,12,31,6,203,154,357,244
0130-001,2015,12,31,7,667,351,1018,357
0130-001,2015,12,31,8,1238,772,2010,1018
0130-001,2015,12,31,9,1082,1098,2180,2010
0130-001,2015,12,31,10,1047,939,1986,2180
0130-001,2015,12,31,11,1161,1184,2345,1986
0130-001,2015,12,31,12,1127,1243,2370,2345
0130-001,2015,12,31,13,1012,1229,2241,2370
0130-001,2015,12,31,14,1152,1378,2530,2241
0130-001,2015,12,31,15,1243,1479,2722,2530
0130-001,2015,12,31,16,1332,1541,2873,2722
0130-001,2015,12,31,17,1554,1469,3023,2873
0130-001,2015,12,31,18,1651,1693,3344,3023
0130-001,2015,12,31,19,1539,1537,3076,3344
0130-001,2015,12,31,20,1299,1093,2392,3076
0130-001,2015,12,31,21,992,798,1790,2392
0130-001,2015,12,31,22,803,561,1364,1790
0130-001,2015,12,31,23,898,461,1359,1364
0130-001,2015,12,31,24,616,301,917,1359
0130-001,2016,6,1,1,359,270,629,917
0130-001,2016,6,1,2,240,187,427,629
0130-001,2016,6,1,3,186,140,326,427
0130-001,2016,6,1,4,145,139,284,326
0130-001,2016,6,1,5,207,152,359,284
0130-001,2016,6,1,6,603,360,963,359
0130-001,2016,6,1,7,1655,758,2413,963
0130-001,2016,6,1,8,1667,1420,3087,2413
0130-001,2016,6,1,9,1420,1738,3158,3087
0130-001,2016,6,1,10,1454,1379,2833,3158
0130-001,2016,6,1,11,1614,1461,3075,2833
0130-001,2016,6,1,12,1507,1444,2951,3075
0130-001,2016,6,1,13,1343,1249,2592,2951
0130-001,2016,6,1,14,1542,1565,3107,2592
0130-001,2016,6,1,15,1575,1678,3253,3107
0130-001,2016,6,1,16,1618,1731,3349,3253
0130-001,2016,6,1,17,1582,1822,3404,3349
0130-001,2016,6,1,18,1556,2327,3883,3404
0130-001,2016,6,1,19,1588,2533,4121,3883
0130-001,2016,6,1,20,1267,1797,3064,4121
0130-001,2016,6,1,21,1132,1528,2660,3064
0130-001,2016,6,1,22,1195,1221,2416,2660
0130-001,2016,6,1,23,880,661,1541,2416
0130-001,2016,6,1,24,580,476,1056,1541
0130-001,2016,6,2,1,415,343,758,1056
0130-001,2016,6,2,2,217,187,404,758
0130-001,2016,6,2,3,197,133,330,404
0130-001,2016,6,2,4,138,163,301,330
0130-001,2016,6,2,5,231,188,419,301
0130-001,2016,6,2,6,670,407,1077,419
0130-001,2016,6,2,7,1581,827,2408,1077
0130-001,2016,6,2,8,1762,1555,3317,2408
0130-001,2016,6,2,9,1489,1740,3229,3317
0130-001,2016,6,2,10,1517,1531,3048,3229
0130-001,2016,6,2,11,1606,1560,3166,3048
0130-001,2016,6,2,12,1506,1506,3012,3166
0130-001,2016,6,2,13,1327,1351,2678,3012
0130-001,2016,6,2,14,1625,1621,3246,2678
0130-001,2016,6,2,15,1627,1729,3356,3246
0130-001,2016,6,2,16,1587,1764,3351,3356
0130-001,2016,6,2,17,1559,1993,3552,3351
0130-001,2016,6,2,18,1633,2320,3953,3552
0130-001,2016,6,2,19,1559,2423,3982,3953
0130-001,2016,6,2,20,1281,1803,3084,3982
0130-001,2016,6,2,21,1141,1720,2861,3084
0130-001,2016,6,2,22,1150,1203,2353,2861
0130-001,2016,6,2,23,927,733,1660,2353
0130-001,2016,6,2,24,599,447,1046,1660
0130-001,2016,6,3,1,384,371,755,1046
0130-001,2016,6,3,2,285,208,493,755
0130-001,2016,6,3,3,187,157,344,493
0130-001,2016,6,3,4,167,168,335,344
0130-001,2016,6,3,5,194,197,391,335
0130-001,2016,6,3,6,696,456,1152,391
0130-001,2016,6,3,7,1603,900,2503,1152
0130-001,2016,6,3,8,1716,1628,3344,2503
0130-001,2016,6,3,9,1583,1659,3242,3344
0130-001,2016,6,3,10,1551,1471,3022,3242
0130-001,2016,6,3,11,1679,1549,3228,3022
0130-001,2016,6,3,12,1597,1713,3310,3228
0130-001,2016,6,3,13,1470,1449,2919,3310
0130-001,2016,6,3,14,1657,1631,3288,2919
0130-001,2016,6,3,15,1642,1761,3403,3288
0130-001,2016,6,3,16,1793,1854,3647,3403
0130-001,2016,6,3,17,1740,1977,3717,3647
0130-001,2016,6,3,18,1808,2390,4198,3717
0130-001,2016,6,3,19,1744,2552,4296,4198
0130-001,2016,6,3,20,1547,1957,3504,4296
0130-001,2016,6,3,21,1259,1772,3031,3504
0130-001,2016,6,3,22,1214,1393,2607,3031
0130-001,2016,6,3,23,1037,926,1963,2607
0130-001,2016,6,3,24,701,663,1364,1963
0130-001,2016,6,4,1,499,473,972,1364
0130-001,2016,6,4,2,336,324,660,972
0130-001,2016,6,4,3,254,259,513,660
0130-001,2016,6,4,4,210,259,469,513
0130-001,2016,6,4,5,264,256,520,469
0130-001,2016,6,4,6,635,454,1089,520
0130-001,2016,6,4,7,1130,826,1956,1089
0130-001,2016,6,4,8,1428,1161,2589,1956
0130-001,2016,6,4,9,1430,1847,3277,2589
0130-001,2016,6,4,10,1576,2118,3694,3277
0130-001,2016,6,4,11,1714,2432,4146,3694
0130-001,2016,6,4,12,1558,2414,3972,4146
0130-001,2016,6,4,13,1513,2467,3980,3972
0130-001,2016,6,4,14,1612,2581,4193,3980
0130-001,2016,6,4,15,1578,2439,4017,4193
0130-001,2016,6,4,16,1656,2446,4102,4017
0130-001,2016,6,4,17,1576,2491,4067,4102
0130-001,2016,6,4,18,1686,2605,4291,4067
0130-001,2016,6,4,19,1665,2457,4122,4291
0130-001,2016,6,4,20,1308,1898,3206,4122
0130-001,2016,6,4,21,1264,1410,2674,3206
0130-001,2016,6,4,22,1071,1008,2079,2674
0130-001,2016,6,4,23,829,698,1527,2079
0130-001,2016,6,4,24,487,525,1012,1527
0130-001,2016,6,5,1,369,353,722,1012
0130-001,2016,6,5,2,311,261,572,722
0130-001,2016,6,5,3,246,192,438,572
0130-001,2016,6,5,4,208,167,375,438
0130-001,2016,6,5,5,214,177,391,375
0130-001,2016,6,5,6,424,329,753,391
0130-001,2016,6,5,7,644,486,1130,753
0130-001,2016,6,5,8,766,660,1426,1130
0130-001,2016,6,5,9,864,1008,1872,1426
0130-001,2016,6,5,10,1068,1288,2356,1872
0130-001,2016,6,5,11,1217,1413,2630,2356
0130-001,2016,6,5,12,1211,1421,2632,2630
0130-001,2016,6,5,13,1215,1406,2621,2632
0130-001,2016,6,5,14,1346,1378,2724,2621
0130-001,2016,6,5,15,1413,1415,2828,2724
0130-001,2016,6,5,16,1796,1435,3231,2828
0130-001,2016,6,5,17,1758,1496,3254,3231
0130-001,2016,6,5,18,1801,1505,3306,3254
0130-001,2016,6,5,19,1662,1393,3055,3306
0130-001,2016,6,5,20,1525,1171,2696,3055
0130-001,2016,6,5,21,1266,1098,2364,2696
0130-001,2016,6,5,22,1238,952,2190,2364
0130-001,2016,6,5,23,888,667,1555,2190
0130-001,2016,6,5,24,661,483,1144,1555
0130-001,2016,6,6,1,453,363,816,1144
0130-001,2016,6,6,2,273,246,519,816
0130-001,2016,6,6,3,204,167,371,519
0130-001,2016,6,6,4,195,185,380,371
0130-001,2016,6,6,5,231,253,484,380
0130-001,2016,6,6,6,619,385,1004,484
0130-001,2016,6,6,7,970,621,1591,1004
0130-001,2016,6,6,8,1146,850,1996,1591
0130-001,2016,6,6,9,1073,1010,2083,1996
0130-001,2016,6,6,10,1167,1190,2357,2083
0130-001,2016,6,6,11,1333,1281,2614,2357
0130-001,2016,6,6,12,1368,1579,2947,2614
0130-001,2016,6,6,13,1436,1411,2847,2947
0130-001,2016,6,6,14,1600,1544,3144,2847
0130-001,2016,6,6,15,1717,1615,3332,3144
0130-001,2016,6,6,16,1842,1646,3488,3332
0130-001,2016,6,6,17,1854,1654,3508,3488
0130-001,2016,6,6,18,1937,1798,3735,3508
0130-001,2016,6,6,19,1767,1600,3367,3735
0130-001,2016,6,6,20,1670,1248,2918,3367
0130-001,2016,6,6,21,1406,1171,2577,2918
0130-001,2016,6,6,22,1063,897,1960,2577
0130-001,2016,6,6,23,776,623,1399,1960
0130-001,2016,6,6,24,479,426,905,1399
0130-001,2016,6,7,1,364,272,636,905
0130-001,2016,6,7,2,157,165,322,636
0130-001,2016,6,7,3,139,121,260,322
0130-001,2016,6,7,4,102,144,246,260
0130-001,2016,6,7,5,139,205,344,246
0130-001,2016,6,7,6,484,348,832,344
0130-001,2016,6,7,7,1361,650,2011,832
0130-001,2016,6,7,8,1404,1050,2454,2011
0130-001,2016,6,7,9,1301,1214,2515,2454
0130-001,2016,6,7,10,1234,1027,2261,2515
0130-001,2016,6,7,11,1291,1075,2366,2261
0130-001,2016,6,7,12,1242,1076,2318,2366
0130-001,2016,6,7,13,1217,1253,2470,2318
0130-001,2016,6,7,14,1617,1639,3256,2470
0130-001,2016,6,7,15,1651,1722,3373,3256
0130-001,2016,6,7,16,1641,1749,3390,3373
0130-001,2016,6,7,17,1699,1954,3653,3390
0130-001,2016,6,7,18,1775,2243,4018,3653
0130-001,2016,6,7,19,1593,2406,3999,4018
0130-001,2016,6,7,20,1282,1891,3173,3999
0130-001,2016,6,7,21,1120,1834,2954,3173
0130-001,2016,6,7,22,1129,1444,2573,2954
0130-001,2016,6,7,23,884,889,1773,2573
0130-001,2016,6,7,24,539,549,1088,1773
0130-001,2016,6,8,1,374,393,767,1088
0130-001,2016,6,8,2,228,254,482,767
0130-001,2016,6,8,3,164,196,360,482
0130-001,2016,6,8,4,147,211,358,360
0130-001,2016,6,8,5,230,248,478,358
0130-001,2016,6,8,6,610,483,1093,478
0130-001,2016,6,8,7,1628,956,2584,1093
0130-001,2016,6,8,8,1799,1495,3294,2584
0130-001,2016,6,8,9,1669,2061,3730,3294
0130-001,2016,6,8,10,1602,1706,3308,3730
0130-001,2016,6,8,11,1668,1692,3360,3308
0130-001,2016,6,8,12,1514,1510,3024,3360
0130-001,2016,6,8,13,1345,1473,2818,3024
0130-001,2016,6,8,14,1646,1640,3286,2818
0130-001,2016,6,8,15,1605,1644,3249,3286
0130-001,2016,6,8,16,1632,1758,3390,3249
0130-001,2016,6,8,17,1676,1920,3596,3390
0130-001,2016,6,8,18,1642,2336,3978,3596
0130-001,2016,6,8,19,1654,2547,4201,3978
0130-001,2016,6,8,20,1291,1934,3225,4201
0130-001,2016,6,8,21,1213,1798,3011,3225
0130-001,2016,6,8,22,1148,1431,2579,3011
0130-001,2016,6,8,23,935,911,1846,2579
0130-001,2016,6,8,24,604,591,1195,1846
0130-001,2016,6,9,1,406,386,792,1195
0130-001,2016,6,9,2,256,249,505,792
0130-001,2016,6,9,3,155,180,335,505
0130-001,2016,6,9,4,150,204,354,335
0130-001,2016,6,9,5,244,245,489,354
0130-001,2016,6,9,6,607,496,1103,489
0130-001,2016,6,9,7,1599,938,2537,1103
0130-001,2016,6,9,8,1812,1691,3503,2537
0130-001,2016,6,9,9,1838,1964,3802,3503
0130-001,2016,6,9,10,1614,1710,3324,3802
0130-001,2016,6,9,11,1594,1633,3227,3324
0130-001,2016,6,9,12,1538,1565,3103,3227
0130-001,2016,6,9,13,1395,1502,2897,3103
0130-001,2016,6,9,14,1578,1573,3151,2897
0130-001,2016,6,9,15,1630,1650,3280,3151
0130-001,2016,6,9,16,1698,1733,3431,3280
0130-001,2016,6,9,17,1550,1905,3455,3431
0130-001,2016,6,9,18,1688,2281,3969,3455
0130-001,2016,6,9,19,1581,2424,4005,3969
0130-001,2016,6,9,20,1335,1915,3250,4005
0130-001,2016,6,9,21,1149,1740,2889,3250
0130-001,2016,6,9,22,1165,1444,2609,2889
0130-001,2016,6,9,23,889,946,1835,2609
0130-001,2016,6,9,24,583,585,1168,1835
0130-001,2016,6,10,1,404,426,830,1168
0130-001,2016,6,10,2,268,271,539,830
0130-001,2016,6,10,3,171,193,364,539
0130-001,2016,6,10,4,175,196,371,364
0130-001,2016,6,10,5,238,277,515,371
0130-001,2016,6,10,6,643,527,1170,515
0130-001,2016,6,10,7,1593,913,2506,1170
0130-001,2016,6,10,8,1915,1703,3618,2506
0130-001,2016,6,10,9,1749,1959,3708,3618
0130-001,2016,6,10,10,1720,1710,3430,3708
0130-001,2016,6,10,11,1681,1690,3371,3430
0130-001,2016,6,10,12,1594,1662,3256,3371
0130-001,2016,6,10,13,1478,1543,3021,3256
0130-001,2016,6,10,14,1639,1697,3336,3021
0130-001,2016,6,10,15,1718,1715,3433,3336
0130-001,2016,6,10,16,1758,1824,3582,3433
0130-001,2016,6,10,17,1695,1937,3632,3582
0130-001,2016,6,10,18,1772,2476,4248,3632
0130-001,2016,6,10,19,1743,2681,4424,4248
0130-001,2016,6,10,20,1571,2141,3712,4424
0130-001,2016,6,10,21,1312,1817,3129,3712
0130-001,2016,6,10,22,1216,1463,2679,3129
0130-001,2016,6,10,23,1008,1049,2057,2679
0130-001,2016,6,10,24,664,701,1365,2057
0130-001,2016,6,11,1,545,488,1033,1365
0130-001,2016,6,11,2,399,384,783,1033
0130-001,2016,6,11,3,271,268,539,783
0130-001,2016,6,11,4,221,272,493,539
0130-001,2016,6,11,5,298,294,592,493
0130-001,2016,6,11,6,642,506,1148,592
0130-001,2016,6,11,7,1142,835,1977,1148
0130-001,2016,6,11,8,1441,1225,2666,1977
0130-001,2016,6,11,9,1609,1685,3294,2666
0130-001,2016,6,11,10,1616,1701,3317,3294
0130-001,2016,6,11,11,1665,1832,3497,3317
0130-001,2016,6,11,12,1677,2006,3683,3497
0130-001,2016,6,11,13,1580,1922,3502,3683
0130-001,2016,6,11,14,1653,1851,3504,3502
0130-001,2016,6,11,15,1715,1678,3393,3504
0130-001,2016,6,11,16,1607,1887,3494,3393
0130-001,2016,6,11,17,1698,1796,3494,3494
0130-001,2016,6,11,18,1773,2177,3950,3494
0130-001,2016,6,11,19,1665,2047,3712,3950
0130-001,2016,6,11,20,1422,1454,2876,3712
0130-001,2016,6,11,21,1155,1295,2450,2876
0130-001,2016,6,11,22,1142,1129,2271,2450
0130-001,2016,6,11,23,873,746,1619,2271
0130-001,2016,6,11,24,612,580,1192,1619
0130-001,2016,6,12,1,426,391,817,1192
0130-001,2016,6,12,2,303,321,624,817
0130-001,2016,6,12,3,261,221,482,624
0130-001,2016,6,12,4,221,178,399,482
0130-001,2016,6,12,5,235,187,422,399
0130-001,2016,6,12,6,456,312,768,422
0130-001,2016,6,12,7,636,476,1112,768
0130-001,2016,6,12,8,712,675,1387,1112
0130-001,2016,6,12,9,847,961,1808,1387
0130-001,2016,6,12,10,997,1146,2143,1808
0130-001,2016,6,12,11,1255,1296,2551,2143
0130-001,2016,6,12,12,1155,1325,2480,2551
0130-001,2016,6,12,13,1218,1364,2582,2480
0130-001,2016,6,12,14,1402,1389,2791,2582
0130-001,2016,6,12,15,1422,1445,2867,2791
0130-001,2016,6,12,16,1450,1515,2965,2867
0130-001,2016,6,12,17,1579,1488,3067,2965
0130-001,2016,6,12,18,1550,1526,3076,3067
0130-001,2016,6,12,19,1420,1418,2838,3076
0130-001,2016,6,12,20,1213,1226,2439,2838
0130-001,2016,6,12,21,1119,1003,2122,2439
0130-001,2016,6,12,22,949,930,1879,2122
0130-001,2016,6,12,23,715,624,1339,1879
0130-001,2016,6,12,24,497,407,904,1339
0130-001,2016,6,13,1,289,225,514,904
0130-001,2016,6,13,2,186,169,355,514
0130-001,2016,6,13,3,150,132,282,355
0130-001,2016,6,13,4,118,168,286,282
0130-001,2016,6,13,5,216,223,439,286
0130-001,2016,6,13,6,713,492,1205,439
0130-001,2016,6,13,7,1672,985,2657,1205
0130-001,2016,6,13,8,1701,1752,3453,2657
0130-001,2016,6,13,9,1829,1889,3718,3453
0130-001,2016,6,13,10,1600,1678,3278,3718
0130-001,2016,6,13,11,1608,1698,3306,3278
0130-001,2016,6,13,12,1455,1475,2930,3306
0130-001,2016,6,13,13,1472,1578,3050,2930
0130-001,2016,6,13,14,1615,1655,3270,3050
0130-001,2016,6,13,15,1603,1771,3374,3270
0130-001,2016,6,13,16,1706,1854,3560,3374
0130-001,2016,6,13,17,1590,1961,3551,3560
0130-001,2016,6,13,18,1685,2430,4115,3551
0130-001,2016,6,13,19,1632,2489,4121,4115
0130-001,2016,6,13,20,1331,1944,3275,4121
0130-001,2016,6,13,21,1241,1836,3077,3275
0130-001,2016,6,13,22,1124,1406,2530,3077
0130-001,2016,6,13,23,888,837,1725,2530
0130-001,2016,6,13,24,464,551,1015,1725
0130-001,2016,6,14,1,362,335,697,1015
0130-001,2016,6,14,2,210,223,433,697
0130-001,2016,6,14,3,144,191,335,433
0130-001,2016,6,14,4,153,199,352,335
0130-001,2016,6,14,5,222,248,470,352
0130-001,2016,6,14,6,675,476,1151,470
0130-001,2016,6,14,7,1615,931,2546,1151
0130-001,2016,6,14,8,1704,1751,3455,2546
0130-001,2016,6,14,9,1847,1978,3825,3455
0130-001,2016,6,14,10,1642,1718,3360,3825
0130-001,2016,6,14,11,1651,1654,3305,3360
0130-001,2016,6,14,12,1585,1600,3185,3305
0130-001,2016,6,14,13,1371,1462,2833,3185
0130-001,2016,6,14,14,1576,1598,3174,2833
0130-001,2016,6,14,15,1636,1678,3314,3174
0130-001,2016,6,14,16,1590,1753,3343,3314
0130-001,2016,6,14,17,1676,1980,3656,3343
0130-001,2016,6,14,18,1701,2365,4066,3656
0130-001,2016,6,14,19,1594,2494,4088,4066
0130-001,2016,6,14,20,1354,1988,3342,4088
0130-001,2016,6,14,21,1170,1768,2938,3342
0130-001,2016,6,14,22,1124,1432,2556,2938
0130-001,2016,6,14,23,897,884,1781,2556
0130-001,2016,6,14,24,565,585,1150,1781
0130-001,2016,6,15,1,384,375,759,1150
0130-001,2016,6,15,2,220,244,464,759
0130-001,2016,6,15,3,176,167,343,464
0130-001,2016,6,15,4,159,218,377,343
0130-001,2016,6,15,5,222,252,474,377
0130-001,2016,6,15,6,625,480,1105,474
0130-001,2016,6,15,7,1592,917,2509,1105
0130-001,2016,6,15,8,1667,1692,3359,2509
0130-001,2016,6,15,9,1832,1887,3719,3359
0130-001,2016,6,15,10,1624,1658,3282,3719
0130-001,2016,6,15,11,1530,1391,2921,3282
0130-001,2016,6,15,12,1553,1618,3171,2921
0130-001,2016,6,15,13,1404,1493,2897,3171
0130-001,2016,6,15,14,1656,1642,3298,2897
0130-001,2016,6,15,15,1692,1746,3438,3298
0130-001,2016,6,15,16,1640,1770,3410,3438
0130-001,2016,6,15,17,1642,2000,3642,3410
0130-001,2016,6,15,18,1720,2335,4055,3642
0130-001,2016,6,15,19,1670,2538,4208,4055
0130-001,2016,6,15,20,1396,1997,3393,4208
0130-001,2016,6,15,21,1207,1826,3033,3393
0130-001,2016,6,15,22,1153,1442,2595,3033
0130-001,2016,6,15,23,917,834,1751,2595
0130-001,2016,6,15,24,617,542,1159,1751
0130-001,2016,6,16,1,412,416,828,1159
0130-001,2016,6,16,2,246,250,496,828
0130-001,2016,6,16,3,191,199,390,496
0130-001,2016,6,16,4,159,197,356,390
0130-001,2016,6,16,5,225,284,509,356
0130-001,2016,6,16,6,667,480,1147,509
0130-001,2016,6,16,7,1569,941,2510,1147
0130-001,2016,6,16,8,1630,1634,3264,2510
0130-001,2016,6,16,9,1818,1796,3614,3264
0130-001,2016,6,16,10,1606,1597,3203,3614
0130-001,2016,6,16,11,1408,1128,2536,3203
0130-001,2016,6,16,12,1521,1636,3157,2536
0130-001,2016,6,16,13,1436,1524,2960,3157
0130-001,2016,6,16,14,1735,1686,3421,2960
0130-001,2016,6,16,15,1747,1813,3560,3421
0130-001,2016,6,16,16,1690,1786,3476,3560
0130-001,2016,6,16,17,1609,2021,3630,3476
0130-001,2016,6,16,18,1740,2305,4045,3630
0130-001,2016,6,16,19,1745,2582,4327,4045
0130-001,2016,6,16,20,1438,2006,3444,4327
0130-001,2016,6,16,21,1244,1885,3129,3444
0130-001,2016,6,16,22,1182,1451,2633,3129
0130-001,2016,6,16,23,953,982,1935,2633
0130-001,2016,6,16,24,591,605,1196,1935
0130-001,2016,6,17,1,423,452,875,1196
0130-001,2016,6,17,2,271,250,521,875
0130-001,2016,6,17,3,183,212,395,521
0130-001,2016,6,17,4,184,206,390,395
0130-001,2016,6,17,5,251,258,509,390
0130-001,2016,6,17,6,673,540,1213,509
0130-001,2016,6,17,7,1598,966,2564,1213
0130-001,2016,6,17,8,1679,1651,3330,2564
0130-001,2016,6,17,9,1774,1966,3740,3330
0130-001,2016,6,17,10,1684,1710,3394,3740
0130-001,2016,6,17,11,1736,1646,3382,3394
0130-001,2016,6,17,12,1575,1713,3288,3382
0130-001,2016,6,17,13,1444,1669,3113,3288
0130-001,2016,6,17,14,1666,1818,3484,3113
0130-001,2016,6,17,15,1680,1844,3524,3484
0130-001,2016,6,17,16,1690,1891,3581,3524
0130-001,2016,6,17,17,1718,1957,3675,3581
0130-001,2016,6,17,18,1718,2554,4272,3675
0130-001,2016,6,17,19,1720,2721,4441,4272
0130-001,2016,6,17,20,1673,2250,3923,4441
0130-001,2016,6,17,21,1256,1871,3127,3923
0130-001,2016,6,17,22,1336,1561,2897,3127
0130-001,2016,6,17,23,1042,960,2002,2897
0130-001,2016,6,17,24,693,724,1417,2002
0130-001,2016,6,18,1,545,498,1043,1417
0130-001,2016,6,18,2,338,314,652,1043
0130-001,2016,6,18,3,264,271,535,652
0130-001,2016,6,18,4,251,307,558,535
0130-001,2016,6,18,5,288,299,587,558
0130-001,2016,6,18,6,682,531,1213,587
0130-001,2016,6,18,7,1168,827,1995,1213
0130-001,2016,6,18,8,1495,1302,2797,1995
0130-001,2016,6,18,9,1770,1779,3549,2797
0130-001,2016,6,18,10,1747,1863,3610,3549
0130-001,2016,6,18,11,1666,2028,3694,3610
0130-001,2016,6,18,12,1595,2229,3824,3694
0130-001,2016,6,18,13,1793,2122,3915,3824
0130-001,2016,6,18,14,1728,1987,3715,3915
0130-001,2016,6,18,15,1730,2057,3787,3715
0130-001,2016,6,18,16,1772,2153,3925,3787
0130-001,2016,6,18,17,1752,2247,3999,3925
0130-001,2016,6,18,18,1824,2434,4258,3999
0130-001,2016,6,18,19,1907,2328,4235,4258
0130-001,2016,6,18,20,1460,1687,3147,4235
0130-001,2016,6,18,21,1280,1414,2694,3147
0130-001,2016,6,18,22,1220,1106,2326,2694
0130-001,2016,6,18,23,988,793,1781,2326
0130-001,2016,6,18,24,623,587,1210,1781
0130-001,2016,6,19,1,458,399,857,1210
0130-001,2016,6,19,2,319,282,601,857
0130-001,2016,6,19,3,278,216,494,601
0130-001,2016,6,19,4,225,199,424,494
0130-001,2016,6,19,5,254,194,448,424
0130-001,2016,6,19,6,494,380,874,448
0130-001,2016,6,19,7,711,502,1213,874
0130-001,2016,6,19,8,755,724,1479,1213
0130-001,2016,6,19,9,954,1059,2013,1479
0130-001,2016,6,19,10,1035,1196,2231,2013
0130-001,2016,6,19,11,1224,1410,2634,2231
0130-001,2016,6,19,12,1296,1492,2788,2634
0130-001,2016,6,19,13,1348,1443,2791,2788
0130-001,2016,6,19,14,1517,1511,3028,2791
0130-001,2016,6,19,15,1521,1606,3127,3028
0130-001,2016,6,19,16,1730,1684,3414,3127
0130-001,2016,6,19,17,1794,1679,3473,3414
0130-001,2016,6,19,18,1691,1679,3370,3473
0130-001,2016,6,19,19,1670,1546,3216,3370
0130-001,2016,6,19,20,1376,1292,2668,3216
0130-001,2016,6,19,21,1213,1251,2464,2668
0130-001,2016,6,19,22,1109,964,2073,2464
0130-001,2016,6,19,23,766,657,1423,2073
0130-001,2016,6,19,24,463,426,889,1423
0130-001,2016,6,20,1,313,273,586,889
0130-001,2016,6,20,2,160,146,306,586
0130-001,2016,6,20,3,149,127,276,306
0130-001,2016,6,20,4,151,188,339,276
0130-001,2016,6,20,5,222,254,476,339
0130-001,2016,6,20,6,723,472,1195,476
0130-001,2016,6,20,7,1694,986,2680,1195
0130-001,2016,6,20,8,1707,1771,3478,2680
0130-001,2016,6,20,9,1808,1961,3769,3478
0130-001,2016,6,20,10,1529,1658,3187,3769
0130-001,2016,6,20,11,1708,1638,3346,3187
0130-001,2016,6,20,12,1522,1709,3231,3346
0130-001,2016,6,20,13,1458,1565,3023,3231
0130-001,2016,6,20,14,1671,1854,3525,3023
0130-001,2016,6,20,15,1709,1838,3547,3525
0130-001,2016,6,20,16,1733,1819,3552,3547
0130-001,2016,6,20,17,1645,1956,3601,3552
0130-001,2016,6,20,18,1709,2376,4085,3601
0130-001,2016,6,20,19,1691,2530,4221,4085
0130-001,2016,6,20,20,1333,2018,3351,4221
0130-001,2016,6,20,21,1214,1816,3030,3351
0130-001,2016,6,20,22,1153,1444,2597,3030
0130-001,2016,6,20,23,831,899,1730,2597
0130-001,2016,6,20,24,504,577,1081,1730
0130-001,2016,6,21,1,387,378,765,1081
0130-001,2016,6,21,2,205,236,441,765
0130-001,2016,6,21,3,173,169,342,441
0130-001,2016,6,21,4,141,204,345,342
0130-001,2016,6,21,5,234,268,502,345
0130-001,2016,6,21,6,664,505,1169,502
0130-001,2016,6,21,7,1605,932,2537,1169
0130-001,2016,6,21,8,1681,1716,3397,2537
0130-001,2016,6,21,9,1745,1989,3734,3397
0130-001,2016,6,21,10,1653,1717,3370,3734
0130-001,2016,6,21,11,1668,1638,3306,3370
0130-001,2016,6,21,12,1616,1584,3200,3306
0130-001,2016,6,21,13,1318,1486,2804,3200
0130-001,2016,6,21,14,1683,1728,3411,2804
0130-001,2016,6,21,15,1718,1790,3508,3411
0130-001,2016,6,21,16,1686,1801,3487,3508
0130-001,2016,6,21,17,1592,1892,3484,3487
0130-001,2016,6,21,18,1640,2384,4024,3484
0130-001,2016,6,21,19,1639,2548,4187,4024
0130-001,2016,6,21,20,1318,1899,3217,4187
0130-001,2016,6,21,21,1196,1851,3047,3217
0130-001,2016,6,21,22,1140,1465,2605,3047
0130-001,2016,6,21,23,847,901,1748,2605
0130-001,2016,6,21,24,571,565,1136,1748
0130-001,2016,6,22,1,381,393,774,1136
0130-001,2016,6,22,2,228,251,479,774
0130-001,2016,6,22,3,173,192,365,479
0130-001,2016,6,22,4,144,210,354,365
0130-001,2016,6,22,5,217,257,474,354
0130-001,2016,6,22,6,589,451,1040,474
0130-001,2016,6,22,7,1580,911,2491,1040
0130-001,2016,6,22,8,1744,1640,3384,2491
0130-001,2016,6,22,9,1709,1971,3680,3384
0130-001,2016,6,22,10,1640,1700,3340,3680
0130-001,2016,6,22,11,1697,1693,3390,3340
0130-001,2016,6,22,12,1568,1630,3198,3390
0130-001,2016,6,22,13,1421,1553,2974,3198
0130-001,2016,6,22,14,1642,1674,3316,2974
0130-001,2016,6,22,15,1673,1729,3402,3316
0130-001,2016,6,22,16,1725,1772,3497,3402
0130-001,2016,6,22,17,1586,1925,3511,3497
0130-001,2016,6,22,18,1700,2359,4059,3511
0130-001,2016,6,22,19,1437,1907,3344,4059
0130-001,2016,6,22,20,1036,1132,2168,3344
0130-001,2016,6,22,21,906,976,1882,2168
0130-001,2016,6,22,22,914,806,1720,1882
0130-001,2016,6,22,23,651,568,1219,1720
0130-001,2016,6,22,24,440,395,835,1219
0130-001,2016,6,23,1,313,480,793,835
0130-001,2016,6,23,2,183,287,470,793
0130-001,2016,6,23,3,148,246,394,470
0130-001,2016,6,23,4,123,264,387,394
0130-001,2016,6,23,5,201,390,591,387
0130-001,2016,6,23,6,665,785,1450,591
0130-001,2016,6,23,7,1486,1272,2758,1450
0130-001,2016,6,23,8,1282,1645,2927,2758
0130-001,2016,6,23,9,1480,1789,3269,2927
0130-001,2016,6,23,10,1438,1507,2945,3269
0130-001,2016,6,23,11,1548,1510,3058,2945
0130-001,2016,6,23,12,1556,1441,2997,3058
0130-001,2016,6,23,13,1446,1274,2720,2997
0130-001,2016,6,23,14,1637,1568,3205,2720
0130-001,2016,6,23,15,1719,1495,3214,3205
0130-001,2016,6,23,16,1708,1568,3276,3214
0130-001,2016,6,23,17,1626,1744,3370,3276
0130-001,2016,6,23,18,1694,1985,3679,3370
0130-001,2016,6,23,19,1672,2202,3874,3679
0130-001,2016,6,23,20,1345,1728,3073,3874
0130-001,2016,6,23,21,1213,1571,2784,3073
0130-001,2016,6,23,22,1161,1266,2427,2784
0130-001,2016,6,23,23,929,847,1776,2427
0130-001,2016,6,23,24,533,572,1105,1776
0130-001,2016,6,24,1,300,427,727,1105
0130-001,2016,6,24,2,197,237,434,727
0130-001,2016,6,24,3,145,171,316,434
0130-001,2016,6,24,4,106,186,292,316
0130-001,2016,6,24,5,152,242,394,292
0130-001,2016,6,24,6,484,424,908,394
0130-001,2016,6,24,7,1407,750,2157,908
0130-001,2016,6,24,8,1585,1405,2990,2157
0130-001,2016,6,24,9,1657,1643,3300,2990
0130-001,2016,6,24,10,1410,1432,2842,3300
0130-001,2016,6,24,11,1285,1448,2733,2842
0130-001,2016,6,24,12,1242,1476,2718,2733
0130-001,2016,6,24,13,1118,1362,2480,2718
0130-001,2016,6,24,14,1368,1492,2860,2480
0130-001,2016,6,24,15,1408,1599,3007,2860
0130-001,2016,6,24,16,1461,1724,3185,3007
0130-001,2016,6,24,17,1586,1749,3335,3185
0130-001,2016,6,24,18,1581,2008,3589,3335
0130-001,2016,6,24,19,1642,2664,4306,3589
0130-001,2016,6,24,20,1578,2124,3702,4306
0130-001,2016,6,24,21,1364,1604,2968,3702
0130-001,2016,6,24,22,1216,1197,2413,2968
0130-001,2016,6,24,23,959,862,1821,2413
0130-001,2016,6,24,24,645,581,1226,1821
0130-001,2016,6,25,1,525,430,955,1226
0130-001,2016,6,25,2,363,293,656,955
0130-001,2016,6,25,3,248,243,491,656
0130-001,2016,6,25,4,199,230,429,491
0130-001,2016,6,25,5,303,260,563,429
0130-001,2016,6,25,6,655,471,1126,563
0130-001,2016,6,25,7,1048,734,1782,1126
0130-001,2016,6,25,8,1508,973,2481,1782
0130-001,2016,6,25,9,1549,1328,2877,2481
0130-001,2016,6,25,10,1624,1562,3186,2877
0130-001,2016,6,25,11,1741,1628,3369,3186
0130-001,2016,6,25,12,1673,1691,3364,3369
0130-001,2016,6,25,13,1661,1623,3284,3364
0130-001,2016,6,25,14,1618,1626,3244,3284
0130-001,2016,6,25,15,1678,1702,3380,3244
0130-001,2016,6,25,16,1627,1593,3220,3380
0130-001,2016,6,25,17,1805,1640,3445,3220
0130-001,2016,6,25,18,1779,1896,3675,3445
0130-001,2016,6,25,19,1683,1807,3490,3675
0130-001,2016,6,25,20,1440,1328,2768,3490
0130-001,2016,6,25,21,1210,1203,2413,2768
0130-001,2016,6,25,22,1162,969,2131,2413
0130-001,2016,6,25,23,927,709,1636,2131
0130-001,2016,6,25,24,596,480,1076,1636
0130-001,2016,6,26,1,445,378,823,1076
0130-001,2016,6,26,2,315,260,575,823
0130-001,2016,6,26,3,222,209,431,575
0130-001,2016,6,26,4,183,169,352,431
0130-001,2016,6,26,5,245,180,425,352
0130-001,2016,6,26,6,459,298,757,425
0130-001,2016,6,26,7,708,461,1169,757
0130-001,2016,6,26,8,863,664,1527,1169
0130-001,2016,6,26,9,1101,982,2083,1527
0130-001,2016,6,26,10,1040,994,2034,2083
0130-001,2016,6,26,11,1301,1111,2412,2034
0130-001,2016,6,26,12,1203,1289,2492,2412
0130-001,2016,6,26,13,1424,1314,2738,2492
0130-001,2016,6,26,14,1489,1274,2763,2738
0130-001,2016,6,26,15,1491,1292,2783,2763
0130-001,2016,6,26,16,1560,1338,2898,2783
0130-001,2016,6,26,17,1559,1437,2996,2898
0130-001,2016,6,26,18,1586,1429,3015,2996
0130-001,2016,6,26,19,1582,1263,2845,3015
0130-001,2016,6,26,20,1358,1112,2470,2845
0130-001,2016,6,26,21,1126,1115,2241,2470
0130-001,2016,6,26,22,1015,886,1901,2241
0130-001,2016,6,26,23,740,601,1341,1901
0130-001,2016,6,26,24,489,448,937,1341
0130-001,2016,6,27,1,301,246,547,937
0130-001,2016,6,27,2,200,163,363,547
0130-001,2016,6,27,3,151,120,271,363
0130-001,2016,6,27,4,119,183,302,271
0130-001,2016,6,27,5,246,248,494,302
0130-001,2016,6,27,6,760,470,1230,494
0130-001,2016,6,27,7,1681,848,2529,1230
0130-001,2016,6,27,8,1761,1543,3304,2529
0130-001,2016,6,27,9,1866,1717,3583,3304
0130-001,2016,6,27,10,1641,1458,3099,3583
0130-001,2016,6,27,11,1620,1498,3118,3099
0130-001,2016,6,27,12,1572,1467,3039,3118
0130-001,2016,6,27,13,1460,1328,2788,3039
0130-001,2016,6,27,14,1674,1497,3171,2788
0130-001,2016,6,27,15,1691,1516,3207,3171
0130-001,2016,6,27,16,1705,1628,3333,3207
0130-001,2016,6,27,17,1609,1663,3272,3333
0130-001,2016,6,27,18,1668,2032,3700,3272
0130-001,2016,6,27,19,1692,2168,3860,3700
0130-001,2016,6,27,20,1306,1706,3012,3860
0130-001,2016,6,27,21,1225,1565,2790,3012
0130-001,2016,6,27,22,1130,1301,2431,2790
0130-001,2016,6,27,23,787,780,1567,2431
0130-001,2016,6,27,24,486,454,940,1567
0130-001,2016,6,28,1,337,346,683,940
0130-001,2016,6,28,2,212,189,401,683
0130-001,2016,6,28,3,156,163,319,401
0130-001,2016,6,28,4,174,207,381,319
0130-001,2016,6,28,5,199,237,436,381
0130-001,2016,6,28,6,711,485,1196,436
0130-001,2016,6,28,7,1612,896,2508,1196
0130-001,2016,6,28,8,1725,1424,3149,2508
0130-001,2016,6,28,9,1801,1666,3467,3149
0130-001,2016,6,28,10,1631,1421,3052,3467
0130-001,2016,6,28,11,1732,1441,3173,3052
0130-001,2016,6,28,12,1594,1397,2991,3173
0130-001,2016,6,28,13,1428,1254,2682,2991
0130-001,2016,6,28,14,1660,1521,3181,2682
0130-001,2016,6,28,15,1748,1539,3287,3181
0130-001,2016,6,28,16,1673,1578,3251,3287
0130-001,2016,6,28,17,1624,1604,3228,3251
0130-001,2016,6,28,18,1705,1987,3692,3228
0130-001,2016,6,28,19,1652,2159,3811,3692
0130-001,2016,6,28,20,1357,1717,3074,3811
0130-001,2016,6,28,21,1215,1632,2847,3074
0130-001,2016,6,28,22,1144,1275,2419,2847
0130-001,2016,6,28,23,889,791,1680,2419
0130-001,2016,6,28,24,565,534,1099,1680
0130-001,2016,6,29,1,363,350,713,1099
0130-001,2016,6,29,2,253,221,474,713
0130-001,2016,6,29,3,195,188,383,474
0130-001,2016,6,29,4,156,228,384,383
0130-001,2016,6,29,5,221,237,458,384
0130-001,2016,6,29,6,684,461,1145,458
0130-001,2016,6,29,7,1596,875,2471,1145
0130-001,2016,6,29,8,1680,1486,3166,2471
0130-001,2016,6,29,9,1800,1717,3517,3166
0130-001,2016,6,29,10,1660,1467,3127,3517
0130-001,2016,6,29,11,1693,1394,3087,3127
0130-001,2016,6,29,12,1560,1441,3001,3087
0130-001,2016,6,29,13,1414,1272,2686,3001
0130-001,2016,6,29,14,1639,1509,3148,2686
0130-001,2016,6,29,15,1722,1592,3314,3148
0130-001,2016,6,29,16,1699,1648,3347,3314
0130-001,2016,6,29,17,1610,1631,3241,3347
0130-001,2016,6,29,18,1692,2156,3848,3241
0130-001,2016,6,29,19,1608,2260,3868,3848
0130-001,2016,6,29,20,1332,1755,3087,3868
0130-001,2016,6,29,21,1175,1403,2578,3087
0130-001,2016,6,29,22,1197,1204,2401,2578
0130-001,2016,6,29,23,988,794,1782,2401
0130-001,2016,6,29,24,592,507,1099,1782
0130-001,2016,6,30,1,424,399,823,1099
0130-001,2016,6,30,2,269,251,520,823
0130-001,2016,6,30,3,212,175,387,520
0130-001,2016,6,30,4,166,197,363,387
0130-001,2016,6,30,5,220,237,457,363
0130-001,2016,6,30,6,649,426,1075,457
0130-001,2016,6,30,7,1607,881,2488,1075
0130-001,2016,6,30,8,1652,1450,3102,2488
0130-001,2016,6,30,9,1909,1724,3633,3102
0130-001,2016,6,30,10,1598,1423,3021,3633
0130-001,2016,6,30,11,1722,1494,3216,3021
0130-001,2016,6,30,12,1541,1420,2961,3216
0130-001,2016,6,30,13,1474,1281,2755,2961
0130-001,2016,6,30,14,1655,1498,3153,2755
0130-001,2016,6,30,15,1673,1580,3253,3153
0130-001,2016,6,30,16,1680,1553,3233,3253
0130-001,2016,6,30,17,1589,1637,3226,3233
0130-001,2016,6,30,18,1672,1999,3671,3226
0130-001,2016,6,30,19,1700,2184,3884,3671
0130-001,2016,6,30,20,1357,1764,3121,3884
0130-001,2016,6,30,21,1199,1521,2720,3121
0130-001,2016,6,30,22,1134,1230,2364,2720
0130-001,2016,6,30,23,888,405,1293,2364
0130-001,2016,6,30,24,612,645,1257,1293
0130-001,2016,7,1,1,457,353,810,1257
0130-001,2016,7,1,2,289,206,495,810
0130-001,2016,7,1,3,196,225,421,495
0130-001,2016,7,1,4,202,227,429,421
0130-001,2016,7,1,5,248,263,511,429
0130-001,2016,7,1,6,682,473,1155,511
0130-001,2016,7,1,7,1605,866,2471,1155
0130-001,2016,7,1,8,1725,1654,3379,2471
0130-001,2016,7,1,9,1858,1971,3829,3379
0130-001,2016,7,1,10,1631,1615,3246,3829
0130-001,2016,7,1,11,1790,1754,3544,3246
0130-001,2016,7,1,12,1773,1634,3407,3544
0130-001,2016,7,1,13,1526,1657,3183,3407
0130-001,2016,7,1,14,1523,1301,2824,3183
0130-001,2016,7,1,15,1436,1362,2798,2824
0130-001,2016,7,1,16,1391,1319,2710,2798
0130-001,2016,7,1,17,1395,1703,3098,2710
0130-001,2016,7,1,18,1371,1496,2867,3098
0130-001,2016,7,1,19,1308,1584,2892,2867
0130-001,2016,7,1,20,1163,1244,2407,2892
0130-001,2016,7,1,21,1022,1128,2150,2407
0130-001,2016,7,1,22,1094,1009,2103,2150
0130-001,2016,7,1,23,911,860,1771,2103
0130-001,2016,7,1,24,556,597,1153,1771
0130-001,2016,7,2,1,446,432,878,1153
0130-001,2016,7,2,2,265,284,549,878
0130-001,2016,7,2,3,232,228,460,549
0130-001,2016,7,2,4,175,228,403,460
0130-001,2016,7,2,5,181,228,409,403
0130-001,2016,7,2,6,413,328,741,409
0130-001,2016,7,2,7,770,509,1279,741
0130-001,2016,7,2,8,1111,738,1849,1279
0130-001,2016,7,2,9,1329,1101,2430,1849
0130-001,2016,7,2,10,1476,1497,2973,2430
0130-001,2016,7,2,11,1619,1735,3354,2973
0130-001,2016,7,2,12,1645,1862,3507,3354
0130-001,2016,7,2,13,1655,1915,3570,3507
0130-001,2016,7,2,14,1714,1848,3562,3570
0130-001,2016,7,2,15,1701,1817,3518,3562
0130-001,2016,7,2,16,1791,1803,3594,3518
0130-001,2016,7,2,17,1818,1939,3757,3594
0130-001,2016,7,2,18,1762,2152,3914,3757
0130-001,2016,7,2,19,1567,1894,3461,3914
0130-001,2016,7,2,20,1412,1379,2791,3461
0130-001,2016,7,2,21,1230,1299,2529,2791
0130-001,2016,7,2,22,1157,1009,2166,2529
0130-001,2016,7,2,23,837,715,1552,2166
0130-001,2016,7,2,24,576,520,1096,1552
0130-001,2016,7,3,1,459,428,887,1096
0130-001,2016,7,3,2,290,312,602,887
0130-001,2016,7,3,3,271,215,486,602
0130-001,2016,7,3,4,158,167,325,486
0130-001,2016,7,3,5,233,189,422,325
0130-001,2016,7,3,6,405,258,663,422
0130-001,2016,7,3,7,628,443,1071,663
0130-001,2016,7,3,8,709,621,1330,1071
0130-001,2016,7,3,9,850,866,1716,1330
0130-001,2016,7,3,10,949,1110,2059,1716
0130-001,2016,7,3,11,1193,1349,2542,2059
0130-001,2016,7,3,12,1191,1462,2653,2542
0130-001,2016,7,3,13,1332,1530,2862,2653
0130-001,2016,7,3,14,1479,1570,3049,2862
0130-001,2016,7,3,15,1537,1570,3107,3049
0130-001,2016,7,3,16,1339,1039,2378,3107
0130-001,2016,7,3,17,1305,974,2279,2378
0130-001,2016,7,3,18,1400,1117,2517,2279
0130-001,2016,7,3,19,1325,980,2305,2517
0130-001,2016,7,3,20,1147,1012,2159,2305
0130-001,2016,7,3,21,1140,1040,2180,2159
0130-001,2016,7,3,22,1003,912,1915,2180
0130-001,2016,7,3,23,719,567,1286,1915
0130-001,2016,7,3,24,434,398,832,1286
0130-001,2016,7,4,1,281,251,532,832
0130-001,2016,7,4,2,158,146,304,532
0130-001,2016,7,4,3,125,112,237,304
0130-001,2016,7,4,4,118,158,276,237
0130-001,2016,7,4,5,180,217,397,276
0130-001,2016,7,4,6,553,374,927,397
0130-001,2016,7,4,7,1489,863,2352,927
0130-001,2016,7,4,8,1525,1569,3094,2352
0130-001,2016,7,4,9,1558,1581,3139,3094
0130-001,2016,7,4,10,1358,1330,2688,3139
0130-001,2016,7,4,11,1455,1425,2880,2688
0130-001,2016,7,4,12,1506,1552,3058,2880
0130-001,2016,7,4,13,1305,1448,2753,3058
0130-001,2016,7,4,14,1353,1610,2963,2753
0130-001,2016,7,4,15,1374,1650,3024,2963
0130-001,2016,7,4,16,1671,1701,3372,3024
0130-001,2016,7,4,17,1577,1774,3351,3372
0130-001,2016,7,4,18,1530,2234,3764,3351
0130-001,2016,7,4,19,1562,2344,3906,3764
0130-001,2016,7,4,20,1253,1783,3036,3906
0130-001,2016,7,4,21,1121,1647,2768,3036
0130-001,2016,7,4,22,945,1207,2152,2768
0130-001,2016,7,4,23,683,746,1429,2152
0130-001,2016,7,4,24,458,481,939,1429
0130-001,2016,7,5,1,311,335,646,939
0130-001,2016,7,5,2,193,186,379,646
0130-001,2016,7,5,3,146,158,304,379
0130-001,2016,7,5,4,130,183,313,304
0130-001,2016,7,5,5,174,198,372,313
0130-001,2016,7,5,6,538,395,933,372
0130-001,2016,7,5,7,1251,654,1905,933
0130-001,2016,7,5,8,1570,1498,3068,1905
0130-001,2016,7,5,9,1750,1910,3660,3068
0130-001,2016,7,5,10,1552,1558,3110,3660
0130-001,2016,7,5,11,1625,1503,3128,3110
0130-001,2016,7,5,12,1530,1454,2984,3128
0130-001,2016,7,5,13,1505,1549,3054,2984
0130-001,2016,7,5,14,1513,1374,2887,3054
0130-001,2016,7,5,15,1524,1508,3032,2887
0130-001,2016,7,5,16,1759,1746,3505,3032
0130-001,2016,7,5,17,1536,1759,3295,3505
0130-001,2016,7,5,18,1556,2121,3677,3295
0130-001,2016,7,5,19,1564,2456,4020,3677
0130-001,2016,7,5,20,1309,1791,3100,4020
0130-001,2016,7,5,21,950,1054,2004,3100
0130-001,2016,7,5,22,839,866,1705,2004
0130-001,2016,7,5,23,685,664,1349,1705
0130-001,2016,7,5,24,512,513,1025,1349
0130-001,2016,7,6,1,357,347,704,1025
0130-001,2016,7,6,2,216,220,436,704
0130-001,2016,7,6,3,158,169,327,436
0130-001,2016,7,6,4,142,175,317,327
0130-001,2016,7,6,5,173,206,379,317
0130-001,2016,7,6,6,462,392,854,379
0130-001,2016,7,6,7,1413,803,2216,854
0130-001,2016,7,6,8,1714,1633,3347,2216
0130-001,2016,7,6,9,1735,1850,3585,3347
0130-001,2016,7,6,10,1651,1673,3324,3585
0130-001,2016,7,6,11,1501,1320,2821,3324
0130-001,2016,7,6,12,1461,1423,2884,2821
0130-001,2016,7,6,13,1564,1515,3079,2884
0130-001,2016,7,6,14,1708,1683,3391,3079
0130-001,2016,7,6,15,1610,1737,3347,3391
0130-001,2016,7,6,16,1523,1519,3042,3347
0130-001,2016,7,6,17,1608,1747,3355,3042
0130-001,2016,7,6,18,1458,1790,3248,3355
0130-001,2016,7,6,19,1409,1786,3195,3248
0130-001,2016,7,6,20,1057,1160,2217,3195
0130-001,2016,7,6,21,1047,1167,2214,2217
0130-001,2016,7,6,22,1028,1010,2038,2214
0130-001,2016,7,6,23,783,776,1559,2038
0130-001,2016,7,6,24,579,548,1127,1559
0130-001,2016,7,7,1,377,365,742,1127
0130-001,2016,7,7,2,250,276,526,742
0130-001,2016,7,7,3,169,191,360,526
0130-001,2016,7,7,4,163,207,370,360
0130-001,2016,7,7,5,203,243,446,370
0130-001,2016,7,7,6,556,411,967,446
0130-001,2016,7,7,7,1577,861,2438,967
0130-001,2016,7,7,8,1724,1674,3398,2438
0130-001,2016,7,7,9,1795,1922,3717,3398
0130-001,2016,7,7,10,1656,1595,3251,3717
0130-001,2016,7,7,11,1740,1658,3398,3251
0130-001,2016,7,7,12,1629,1696,3325,3398
0130-001,2016,7,7,13,1439,1487,2926,3325
0130-001,2016,7,7,14,1742,1623,3365,2926
0130-001,2016,7,7,15,1669,1597,3266,3365
0130-001,2016,7,7,16,1568,1382,2950,3266
0130-001,2016,7,7,17,1677,1820,3497,2950
0130-001,2016,7,7,18,1635,2263,3898,3497
0130-001,2016,7,7,19,1722,2426,4148,3898
0130-001,2016,7,7,20,1281,1797,3078,4148
0130-001,2016,7,7,21,1222,1699,2921,3078
0130-001,2016,7,7,22,1166,1358,2524,2921
0130-001,2016,7,7,23,907,858,1765,2524
0130-001,2016,7,7,24,610,587,1197,1765
0130-001,2016,7,8,1,398,443,841,1197
0130-001,2016,7,8,2,241,230,471,841
0130-001,2016,7,8,3,207,214,421,471
0130-001,2016,7,8,4,147,196,343,421
0130-001,2016,7,8,5,242,284,526,343
0130-001,2016,7,8,6,652,475,1127,526
0130-001,2016,7,8,7,1589,983,2572,1127
0130-001,2016,7,8,8,1716,1738,3454,2572
0130-001,2016,7,8,9,1803,2013,3816,3454
0130-001,2016,7,8,10,1517,1497,3014,3816
0130-001,2016,7,8,11,1713,1570,3283,3014
0130-001,2016,7,8,12,1625,1682,3307,3283
0130-001,2016,7,8,13,1479,1558,3037,3307
0130-001,2016,7,8,14,1807,1782,3589,3037
0130-001,2016,7,8,15,1779,1834,3613,3589
0130-001,2016,7,8,16,1805,1898,3703,3613
0130-001,2016,7,8,17,1737,1955,3692,3703
0130-001,2016,7,8,18,1742,2558,4300,3692
0130-001,2016,7,8,19,1775,2756,4531,4300
0130-001,2016,7,8,20,1546,2418,3964,4531
0130-001,2016,7,8,21,1377,1960,3337,3964
0130-001,2016,7,8,22,1379,1449,2828,3337
0130-001,2016,7,8,23,1063,922,1985,2828
0130-001,2016,7,8,24,687,658,1345,1985
0130-001,2016,7,9,1,515,444,959,1345
0130-001,2016,7,9,2,330,340,670,959
0130-001,2016,7,9,3,255,268,523,670
0130-001,2016,7,9,4,260,260,520,523
0130-001,2016,7,9,5,274,305,579,520
0130-001,2016,7,9,6,685,471,1156,579
0130-001,2016,7,9,7,1199,831,2030,1156
0130-001,2016,7,9,8,1534,1256,2790,2030
0130-001,2016,7,9,9,1601,1756,3357,2790
0130-001,2016,7,9,10,1653,1895,3548,3357
0130-001,2016,7,9,11,1701,1905,3606,3548
0130-001,2016,7,9,12,1724,2065,3789,3606
0130-001,2016,7,9,13,1626,2022,3648,3789
0130-001,2016,7,9,14,1617,1974,3591,3648
0130-001,2016,7,9,15,1725,1918,3643,3591
0130-001,2016,7,9,16,1706,1872,3578,3643
0130-001,2016,7,9,17,1794,1993,3787,3578
0130-001,2016,7,9,18,1781,2176,3957,3787
0130-001,2016,7,9,19,1704,2054,3758,3957
0130-001,2016,7,9,20,1419,1544,2963,3758
0130-001,2016,7,9,21,1295,1281,2576,2963
0130-001,2016,7,9,22,1279,1042,2321,2576
0130-001,2016,7,9,23,894,722,1616,2321
0130-001,2016,7,9,24,622,580,1202,1616
0130-001,2016,7,10,1,451,433,884,1202
0130-001,2016,7,10,2,308,290,598,884
0130-001,2016,7,10,3,257,218,475,598
0130-001,2016,7,10,4,178,180,358,475
0130-001,2016,7,10,5,245,205,450,358
0130-001,2016,7,10,6,477,335,812,450
0130-001,2016,7,10,7,677,518,1195,812
0130-001,2016,7,10,8,786,792,1578,1195
0130-001,2016,7,10,9,910,1134,2044,1578
0130-001,2016,7,10,10,1057,1250,2307,2044
0130-001,2016,7,10,11,1435,1440,2875,2307
0130-001,2016,7,10,12,1210,1389,2599,2875
0130-001,2016,7,10,13,1514,1356,2870,2599
0130-001,2016,7,10,14,1394,1398,2792,2870
0130-001,2016,7,10,15,1510,1476,2986,2792
0130-001,2016,7,10,16,1764,1402,3166,2986
0130-001,2016,7,10,17,1726,1546,3272,3166
0130-001,2016,7,10,18,1705,1566,3271,3272
0130-001,2016,7,10,19,1728,1397,3125,3271
0130-001,2016,7,10,20,1264,1221,2485,3125
0130-001,2016,7,10,21,1190,1122,2312,2485
0130-001,2016,7,10,22,993,954,1947,2312
0130-001,2016,7,10,23,654,617,1271,1947
0130-001,2016,7,10,24,468,423,891,1271
0130-001,2016,7,11,1,308,258,566,891
0130-001,2016,7,11,2,169,169,338,566
0130-001,2016,7,11,3,125,111,236,338
0130-001,2016,7,11,4,126,164,290,236
0130-001,2016,7,11,5,231,250,481,290
0130-001,2016,7,11,6,725,453,1178,481
0130-001,2016,7,11,7,1814,992,2806,1178
0130-001,2016,7,11,8,1746,1777,3523,2806
0130-001,2016,7,11,9,1840,1966,3806,3523
0130-001,2016,7,11,10,1751,1675,3426,3806
0130-001,2016,7,11,11,1711,1719,3430,3426
0130-001,2016,7,11,12,1715,1717,3432,3430
0130-001,2016,7,11,13,1417,1568,2985,3432
0130-001,2016,7,11,14,1641,1724,3365,2985
0130-001,2016,7,11,15,1823,1785,3608,3365
0130-001,2016,7,11,16,1724,1884,3608,3608
0130-001,2016,7,11,17,1730,2014,3744,3608
0130-001,2016,7,11,18,1754,2405,4159,3744
0130-001,2016,7,11,19,1696,2557,4253,4159
0130-001,2016,7,11,20,1387,1989,3376,4253
0130-001,2016,7,11,21,1220,1863,3083,3376
0130-001,2016,7,11,22,1123,1449,2572,3083
0130-001,2016,7,11,23,807,832,1639,2572
0130-001,2016,7,11,24,509,550,1059,1639
0130-001,2016,7,12,1,342,354,696,1059
0130-001,2016,7,12,2,230,253,483,696
0130-001,2016,7,12,3,176,162,338,483
0130-001,2016,7,12,4,126,181,307,338
0130-001,2016,7,12,5,186,219,405,307
0130-001,2016,7,12,6,498,418,916,405
0130-001,2016,7,12,7,1522,832,2354,916
0130-001,2016,7,12,8,1671,1682,3353,2354
0130-001,2016,7,12,9,1822,2004,3826,3353
0130-001,2016,7,12,10,1673,1671,3344,3826
0130-001,2016,7,12,11,1733,1635,3368,3344
0130-001,2016,7,12,12,1524,1432,2956,3368
0130-001,2016,7,12,13,1405,1541,2946,2956
0130-001,2016,7,12,14,1663,1719,3382,2946
0130-001,2016,7,12,15,1805,1754,3559,3382
0130-001,2016,7,12,16,1763,1815,3578,3559
0130-001,2016,7,12,17,1695,2098,3793,3578
0130-001,2016,7,12,18,1737,2541,4278,3793
0130-001,2016,7,12,19,1672,2588,4260,4278
0130-001,2016,7,12,20,1377,1916,3293,4260
0130-001,2016,7,12,21,1288,1806,3094,3293
0130-001,2016,7,12,22,1158,1397,2555,3094
0130-001,2016,7,12,23,874,845,1719,2555
0130-001,2016,7,12,24,536,578,1114,1719
0130-001,2016,7,13,1,429,406,835,1114
0130-001,2016,7,13,2,247,230,477,835
0130-001,2016,7,13,3,200,201,401,477
0130-001,2016,7,13,4,187,212,399,401
0130-001,2016,7,13,5,231,257,488,399
0130-001,2016,7,13,6,692,478,1170,488
0130-001,2016,7,13,7,1670,948,2618,1170
0130-001,2016,7,13,8,1696,1699,3395,2618
0130-001,2016,7,13,9,1903,1980,3883,3395
0130-001,2016,7,13,10,1700,1687,3387,3883
0130-001,2016,7,13,11,1712,1685,3397,3387
0130-001,2016,7,13,12,1585,1737,3322,3397
0130-001,2016,7,13,13,1529,1548,3077,3322
0130-001,2016,7,13,14,1778,1737,3515,3077
0130-001,2016,7,13,15,1751,1781,3532,3515
0130-001,2016,7,13,16,1771,1872,3643,3532
0130-001,2016,7,13,17,1676,2022,3698,3643
0130-001,2016,7,13,18,1745,2416,4161,3698
0130-001,2016,7,13,19,1759,2650,4409,4161
0130-001,2016,7,13,20,1381,2031,3412,4409
0130-001,2016,7,13,21,1367,1761,3128,3412
0130-001,2016,7,13,22,1198,1402,2600,3128
0130-001,2016,7,13,23,1011,893,1904,2600
0130-001,2016,7,13,24,583,585,1168,1904
0130-001,2016,7,14,1,431,431,862,1168
0130-001,2016,7,14,2,268,257,525,862
0130-001,2016,7,14,3,194,195,389,525
0130-001,2016,7,14,4,170,218,388,389
0130-001,2016,7,14,5,214,249,463,388
0130-001,2016,7,14,6,669,468,1137,463
0130-001,2016,7,14,7,1676,983,2659,1137
0130-001,2016,7,14,8,1648,1729,3377,2659
0130-001,2016,7,14,9,1812,1931,3743,3377
0130-001,2016,7,14,10,1700,1667,3367,3743
0130-001,2016,7,14,11,1715,1664,3379,3367
0130-001,2016,7,14,12,1681,1743,3424,3379
0130-001,2016,7,14,13,1440,1733,3173,3424
0130-001,2016,7,14,14,1841,1862,3703,3173
0130-001,2016,7,14,15,1726,1957,3683,3703
0130-001,2016,7,14,16,1707,1869,3576,3683
0130-001,2016,7,14,17,1643,2063,3706,3576
0130-001,2016,7,14,18,1746,2359,4105,3706
0130-001,2016,7,14,19,1718,2574,4292,4105
0130-001,2016,7,14,20,1445,2005,3450,4292
0130-001,2016,7,14,21,1280,1872,3152,3450
0130-001,2016,7,14,22,1199,1507,2706,3152
0130-001,2016,7,14,23,910,859,1769,2706
0130-001,2016,7,14,24,629,553,1182,1769
0130-001,2016,7,15,1,405,361,766,1182
0130-001,2016,7,15,2,249,277,526,766
0130-001,2016,7,15,3,174,196,370,526
0130-001,2016,7,15,4,175,202,377,370
0130-001,2016,7,15,5,220,244,464,377
0130-001,2016,7,15,6,686,479,1165,464
0130-001,2016,7,15,7,1707,935,2642,1165
0130-001,2016,7,15,8,1697,1745,3442,2642
0130-001,2016,7,15,9,1789,2038,3827,3442
0130-001,2016,7,15,10,1682,1783,3465,3827
0130-001,2016,7,15,11,1721,1736,3457,3465
0130-001,2016,7,15,12,1669,1721,3390,3457
0130-001,2016,7,15,13,1587,1648,3235,3390
0130-001,2016,7,15,14,1811,1772,3583,3235
0130-001,2016,7,15,15,1679,1882,3561,3583
0130-001,2016,7,15,16,1759,1868,3627,3561
0130-001,2016,7,15,17,1681,2277,3958,3627
0130-001,2016,7,15,18,1751,2620,4371,3958
0130-001,2016,7,15,19,1764,2878,4642,4371
0130-001,2016,7,15,20,1560,2308,3868,4642
0130-001,2016,7,15,21,1391,1905,3296,3868
0130-001,2016,7,15,22,1333,1404,2737,3296
0130-001,2016,7,15,23,995,923,1918,2737
0130-001,2016,7,15,24,628,626,1254,1918
0130-001,2016,7,16,1,513,534,1047,1254
0130-001,2016,7,16,2,332,322,654,1047
0130-001,2016,7,16,3,268,238,506,654
0130-001,2016,7,16,4,190,256,446,506
0130-001,2016,7,16,5,209,232,441,446
0130-001,2016,7,16,6,436,413,849,441
0130-001,2016,7,16,7,933,661,1594,849
0130-001,2016,7,16,8,1401,993,2394,1594
0130-001,2016,7,16,9,1588,1545,3133,2394
0130-001,2016,7,16,10,1636,1704,3340,3133
0130-001,2016,7,16,11,1721,1811,3532,3340
0130-001,2016,7,16,12,1718,1971,3689,3532
0130-001,2016,7,16,13,1450,1476,2926,3689
0130-001,2016,7,16,14,1715,2011,3726,2926
0130-001,2016,7,16,15,1735,1932,3667,3726
0130-001,2016,7,16,16,1669,1736,3405,3667
0130-001,2016,7,16,17,1742,1927,3669,3405
0130-001,2016,7,16,18,1643,1945,3588,3669
0130-001,2016,7,16,19,1528,1530,3058,3588
0130-001,2016,7,16,20,1288,1278,2566,3058
0130-001,2016,7,16,21,1138,1179,2317,2566
0130-001,2016,7,16,22,1152,926,2078,2317
0130-001,2016,7,16,23,817,668,1485,2078
0130-001,2016,7,16,24,472,439,911,1485
0130-001,2016,7,17,1,306,320,626,911
0130-001,2016,7,17,2,243,252,495,626
0130-001,2016,7,17,3,212,179,391,495
0130-001,2016,7,17,4,156,169,325,391
0130-001,2016,7,17,5,182,168,350,325
0130-001,2016,7,17,6,356,273,629,350
0130-001,2016,7,17,7,645,454,1099,629
0130-001,2016,7,17,8,747,707,1454,1099
0130-001,2016,7,17,9,883,999,1882,1454
0130-001,2016,7,17,10,997,1038,2035,1882
0130-001,2016,7,17,11,1162,1118,2280,2035
0130-001,2016,7,17,12,1184,1239,2423,2280
0130-001,2016,7,17,13,1356,1442,2798,2423
0130-001,2016,7,17,14,1529,1548,3077,2798
0130-001,2016,7,17,15,1683,1661,3344,3077
0130-001,2016,7,17,16,1706,1762,3468,3344
0130-001,2016,7,17,17,1831,1783,3614,3468
0130-001,2016,7,17,18,1676,1765,3441,3614
0130-001,2016,7,17,19,1606,1551,3157,3441
0130-001,2016,7,17,20,1436,1281,2717,3157
0130-001,2016,7,17,21,1378,1159,2537,2717
0130-001,2016,7,17,22,1084,930,2014,2537
0130-001,2016,7,17,23,721,610,1331,2014
0130-001,2016,7,17,24,464,404,868,1331
0130-001,2016,7,18,1,295,236,531,868
0130-001,2016,7,18,2,200,198,398,531
0130-001,2016,7,18,3,157,113,270,398
0130-001,2016,7,18,4,115,167,282,270
0130-001,2016,7,18,5,216,215,431,282
0130-001,2016,7,18,6,725,500,1225,431
0130-001,2016,7,18,7,1798,960,2758,1225
0130-001,2016,7,18,8,1756,1693,3449,2758
0130-001,2016,7,18,9,1784,2021,3805,3449
0130-001,2016,7,18,10,1631,1666,3297,3805
0130-001,2016,7,18,11,1673,1667,3340,3297
0130-001,2016,7,18,12,1702,1683,3385,3340
0130-001,2016,7,18,13,1501,1527,3028,3385
0130-001,2016,7,18,14,1771,1714,3485,3028
0130-001,2016,7,18,15,1765,1775,3540,3485
0130-001,2016,7,18,16,1692,1764,3456,3540
0130-001,2016,7,18,17,1766,1978,3744,3456
0130-001,2016,7,18,18,1717,2382,4099,3744
0130-001,2016,7,18,19,1720,2537,4257,4099
0130-001,2016,7,18,20,1364,1845,3209,4257
0130-001,2016,7,18,21,1277,1831,3108,3209
0130-001,2016,7,18,22,1047,1440,2487,3108
0130-001,2016,7,18,23,826,815,1641,2487
0130-001,2016,7,18,24,512,538,1050,1641
0130-001,2016,7,19,1,360,347,707,1050
0130-001,2016,7,19,2,256,222,478,707
0130-001,2016,7,19,3,172,197,369,478
0130-001,2016,7,19,4,162,184,346,369
0130-001,2016,7,19,5,199,237,436,346
0130-001,2016,7,19,6,677,511,1188,436
0130-001,2016,7,19,7,1679,916,2595,1188
0130-001,2016,7,19,8,1706,1689,3395,2595
0130-001,2016,7,19,9,1810,1966,3776,3395
0130-001,2016,7,19,10,1716,1662,3378,3776
0130-001,2016,7,19,11,1715,1725,3440,3378
0130-001,2016,7,19,12,1674,1737,3411,3440
0130-001,2016,7,19,13,1527,1489,3016,3411
0130-001,2016,7,19,14,1735,1677,3412,3016
0130-001,2016,7,19,15,1735,1698,3433,3412
0130-001,2016,7,19,16,1752,1802,3554,3433
0130-001,2016,7,19,17,1687,1989,3676,3554
0130-001,2016,7,19,18,1723,2363,4086,3676
0130-001,2016,7,19,19,1731,2598,4329,4086
0130-001,2016,7,19,20,1387,1935,3322,4329
0130-001,2016,7,19,21,1312,1901,3213,3322
0130-001,2016,7,19,22,1185,1442,2627,3213
0130-001,2016,7,19,23,851,846,1697,2627
0130-001,2016,7,19,24,591,569,1160,1697
0130-001,2016,7,20,1,390,386,776,1160
0130-001,2016,7,20,2,251,248,499,776
0130-001,2016,7,20,3,159,189,348,499
0130-001,2016,7,20,4,188,218,406,348
0130-001,2016,7,20,5,206,223,429,406
0130-001,2016,7,20,6,712,498,1210,429
0130-001,2016,7,20,7,1706,933,2639,1210
0130-001,2016,7,20,8,1714,1731,3445,2639
0130-001,2016,7,20,9,1783,1983,3766,3445
0130-001,2016,7,20,10,1725,1708,3433,3766
0130-001,2016,7,20,11,1725,1730,3455,3433
0130-001,2016,7,20,12,1639,1613,3252,3455
0130-001,2016,7,20,13,1541,1572,3113,3252
0130-001,2016,7,20,14,1657,1701,3358,3113
0130-001,2016,7,20,15,1770,1746,3516,3358
0130-001,2016,7,20,16,1694,1823,3517,3516
0130-001,2016,7,20,17,1604,1927,3531,3517
0130-001,2016,7,20,18,1749,2464,4213,3531
0130-001,2016,7,20,19,1722,2714,4436,4213
0130-001,2016,7,20,20,1425,2042,3467,4436
0130-001,2016,7,20,21,1277,1687,2964,3467
0130-001,2016,7,20,22,1162,1309,2471,2964
0130-001,2016,7,20,23,873,858,1731,2471
0130-001,2016,7,20,24,637,557,1194,1731
0130-001,2016,7,21,1,408,381,789,1194
0130-001,2016,7,21,2,233,260,493,789
0130-001,2016,7,21,3,187,236,423,493
0130-001,2016,7,21,4,207,191,398,423
0130-001,2016,7,21,5,234,254,488,398
0130-001,2016,7,21,6,661,484,1145,488
0130-001,2016,7,21,7,1703,911,2614,1145
0130-001,2016,7,21,8,1694,1613,3307,2614
0130-001,2016,7,21,9,1780,1944,3724,3307
0130-001,2016,7,21,10,1712,1705,3417,3724
0130-001,2016,7,21,11,1755,1714,3469,3417
0130-001,2016,7,21,12,1689,1735,3424,3469
0130-001,2016,7,21,13,1466,1606,3072,3424
0130-001,2016,7,21,14,1771,1693,3464,3072
0130-001,2016,7,21,15,1732,1766,3498,3464
0130-001,2016,7,21,16,1802,1787,3589,3498
0130-001,2016,7,21,17,1610,2073,3683,3589
0130-001,2016,7,21,18,1780,2429,4209,3683
0130-001,2016,7,21,19,1710,2518,4228,4209
0130-001,2016,7,21,20,1400,1992,3392,4228
0130-001,2016,7,21,21,1287,1819,3106,3392
0130-001,2016,7,21,22,1198,1400,2598,3106
0130-001,2016,7,21,23,911,873,1784,2598
0130-001,2016,7,21,24,588,577,1165,1784
0130-001,2016,7,22,1,399,413,812,1165
0130-001,2016,7,22,2,246,257,503,812
0130-001,2016,7,22,3,200,188,388,503
0130-001,2016,7,22,4,180,238,418,388
0130-001,2016,7,22,5,248,242,490,418
0130-001,2016,7,22,6,682,510,1192,490
0130-001,2016,7,22,7,1656,896,2552,1192
0130-001,2016,7,22,8,1785,1567,3352,2552
0130-001,2016,7,22,9,1719,2012,3731,3352
0130-001,2016,7,22,10,1686,1726,3412,3731
0130-001,2016,7,22,11,1717,1770,3487,3412
0130-001,2016,7,22,12,1791,1774,3565,3487
0130-001,2016,7,22,13,1527,1607,3134,3565
0130-001,2016,7,22,14,1804,1744,3548,3134
0130-001,2016,7,22,15,1711,1759,3470,3548
0130-001,2016,7,22,16,1652,1902,3554,3470
0130-001,2016,7,22,17,1682,2085,3767,3554
0130-001,2016,7,22,18,1678,2420,4098,3767
0130-001,2016,7,22,19,1698,2531,4229,4098
0130-001,2016,7,22,20,1752,2180,3932,4229
0130-001,2016,7,22,21,1497,1966,3463,3932
0130-001,2016,7,22,22,1357,1455,2812,3463
0130-001,2016,7,22,23,1018,947,1965,2812
0130-001,2016,7,22,24,707,633,1340,1965
0130-001,2016,7,23,1,522,443,965,1340
0130-001,2016,7,23,2,394,335,729,965
0130-001,2016,7,23,3,292,285,577,729
0130-001,2016,7,23,4,218,264,482,577
0130-001,2016,7,23,5,312,308,620,482
0130-001,2016,7,23,6,675,506,1181,620
0130-001,2016,7,23,7,1176,779,1955,1181
0130-001,2016,7,23,8,1491,1213,2704,1955
0130-001,2016,7,23,9,1720,1650,3370,2704
0130-001,2016,7,23,10,1802,1896,3698,3370
0130-001,2016,7,23,11,1674,1960,3634,3698
0130-001,2016,7,23,12,1643,2119,3762,3634
0130-001,2016,7,23,13,1734,2023,3757,3762
0130-001,2016,7,23,14,1783,2053,3836,3757
0130-001,2016,7,23,15,1686,1906,3592,3836
0130-001,2016,7,23,16,1700,1867,3567,3592
0130-001,2016,7,23,17,1662,2040,3702,3567
0130-001,2016,7,23,18,1712,2269,3981,3702
0130-001,2016,7,23,19,1727,1994,3721,3981
0130-001,2016,7,23,20,1417,1516,2933,3721
0130-001,2016,7,23,21,1263,1272,2535,2933
0130-001,2016,7,23,22,1356,1055,2411,2535
0130-001,2016,7,23,23,883,781,1664,2411
0130-001,2016,7,23,24,612,540,1152,1664
0130-001,2016,7,24,1,432,402,834,1152
0130-001,2016,7,24,2,302,274,576,834
0130-001,2016,7,24,3,266,196,462,576
0130-001,2016,7,24,4,187,172,359,462
0130-001,2016,7,24,5,234,187,421,359
0130-001,2016,7,24,6,441,327,768,421
0130-001,2016,7,24,7,662,500,1162,768
0130-001,2016,7,24,8,782,696,1478,1162
0130-001,2016,7,24,9,894,976,1870,1478
0130-001,2016,7,24,10,992,1140,2132,1870
0130-001,2016,7,24,11,1220,1295,2515,2132
0130-001,2016,7,24,12,1370,1298,2668,2515
0130-001,2016,7,24,13,1579,1407,2986,2668
0130-001,2016,7,24,14,1637,1418,3055,2986
0130-001,2016,7,24,15,1814,1440,3254,3055
0130-001,2016,7,24,16,1693,1494,3187,3254
0130-001,2016,7,24,17,1789,1469,3258,3187
0130-001,2016,7,24,18,1780,1577,3357,3258
0130-001,2016,7,24,19,1752,1475,3227,3357
0130-001,2016,7,24,20,1411,1158,2569,3227
0130-001,2016,7,24,21,1319,1112,2431,2569
0130-001,2016,7,24,22,1084,914,1998,2431
0130-001,2016,7,24,23,718,649,1367,1998
0130-001,2016,7,24,24,477,421,898,1367
0130-001,2016,7,25,1,301,260,561,898
0130-001,2016,7,25,2,173,163,336,561
0130-001,2016,7,25,3,143,147,290,336
0130-001,2016,7,25,4,143,188,331,290
0130-001,2016,7,25,5,227,210,437,331
0130-001,2016,7,25,6,724,467,1191,437
0130-001,2016,7,25,7,1753,967,2720,1191
0130-001,2016,7,25,8,1711,1685,3396,2720
0130-001,2016,7,25,9,1786,1920,3706,3396
0130-001,2016,7,25,10,1638,1647,3285,3706
0130-001,2016,7,25,11,1804,1822,3626,3285
0130-001,2016,7,25,12,1756,1785,3541,3626
0130-001,2016,7,25,13,1504,1584,3088,3541
0130-001,2016,7,25,14,1710,1694,3404,3088
0130-001,2016,7,25,15,1766,1809,3575,3404
0130-001,2016,7,25,16,1758,1945,3703,3575
0130-001,2016,7,25,17,1656,1998,3654,3703
0130-001,2016,7,25,18,1704,2094,3798,3654
0130-001,2016,7,25,19,1804,2552,4356,3798
0130-001,2016,7,25,20,1497,2029,3526,4356
0130-001,2016,7,25,21,1318,1920,3238,3526
0130-001,2016,7,25,22,1122,1416,2538,3238
0130-001,2016,7,25,23,890,812,1702,2538
0130-001,2016,7,25,24,524,536,1060,1702
0130-001,2016,7,26,1,370,348,718,1060
0130-001,2016,7,26,2,227,233,460,718
0130-001,2016,7,26,3,170,168,338,460
0130-001,2016,7,26,4,166,209,375,338
0130-001,2016,7,26,5,219,272,491,375
0130-001,2016,7,26,6,678,506,1184,491
0130-001,2016,7,26,7,1667,956,2623,1184
0130-001,2016,7,26,8,1828,1605,3433,2623
0130-001,2016,7,26,9,1764,1975,3739,3433
0130-001,2016,7,26,10,1801,1706,3507,3739
0130-001,2016,7,26,11,1768,1801,3569,3507
0130-001,2016,7,26,12,1726,1791,3517,3569
0130-001,2016,7,26,13,1531,1667,3198,3517
0130-001,2016,7,26,14,1738,1865,3603,3198
0130-001,2016,7,26,15,1770,1796,3566,3603
0130-001,2016,7,26,16,1778,1900,3678,3566
0130-001,2016,7,26,17,1749,1864,3613,3678
0130-001,2016,7,26,18,1799,2386,4185,3613
0130-001,2016,7,26,19,1690,2468,4158,4185
0130-001,2016,7,26,20,1388,2009,3397,4158
0130-001,2016,7,26,21,1325,1886,3211,3397
0130-001,2016,7,26,22,1172,1391,2563,3211
0130-001,2016,7,26,23,952,898,1850,2563
0130-001,2016,7,26,24,567,579,1146,1850
0130-001,2016,7,27,1,378,332,710,1146
0130-001,2016,7,27,2,225,226,451,710
0130-001,2016,7,27,3,182,186,368,451
0130-001,2016,7,27,4,161,226,387,368
0130-001,2016,7,27,5,214,247,461,387
0130-001,2016,7,27,6,717,515,1232,461
0130-001,2016,7,27,7,1673,924,2597,1232
0130-001,2016,7,27,8,1691,1560,3251,2597
0130-001,2016,7,27,9,1894,1958,3852,3251
0130-001,2016,7,27,10,1740,1824,3564,3852
0130-001,2016,7,27,11,1824,1863,3687,3564
0130-001,2016,7,27,12,1638,1775,3413,3687
0130-001,2016,7,27,13,1596,1645,3241,3413
0130-001,2016,7,27,14,1644,1821,3465,3241
0130-001,2016,7,27,15,1714,1839,3553,3465
0130-001,2016,7,27,16,1779,1813,3592,3553
0130-001,2016,7,27,17,1656,1934,3590,3592
0130-001,2016,7,27,18,1765,2505,4270,3590
0130-001,2016,7,27,19,1776,2663,4439,4270
0130-001,2016,7,27,20,1462,1912,3374,4439
0130-001,2016,7,27,21,1303,1678,2981,3374
0130-001,2016,7,27,22,1171,1333,2504,2981
0130-001,2016,7,27,23,922,849,1771,2504
0130-001,2016,7,27,24,588,551,1139,1771
0130-001,2016,7,28,1,429,353,782,1139
0130-001,2016,7,28,2,253,222,475,782
0130-001,2016,7,28,3,183,202,385,475
0130-001,2016,7,28,4,164,209,373,385
0130-001,2016,7,28,5,244,268,512,373
0130-001,2016,7,28,6,690,474,1164,512
0130-001,2016,7,28,7,1623,938,2561,1164
0130-001,2016,7,28,8,1686,1563,3249,2561
0130-001,2016,7,28,9,1692,1862,3554,3249
0130-001,2016,7,28,10,1652,1654,3306,3554
0130-001,2016,7,28,11,1740,1757,3497,3306
0130-001,2016,7,28,12,1590,1800,3390,3497
0130-001,2016,7,28,13,1506,1722,3228,3390
0130-001,2016,7,28,14,1672,1656,3328,3228
0130-001,2016,7,28,15,1694,1776,3470,3328
0130-001,2016,7,28,16,1748,1873,3621,3470
0130-001,2016,7,28,17,1672,1945,3617,3621
0130-001,2016,7,28,18,1862,2250,4112,3617
0130-001,2016,7,28,19,1677,2577,4254,4112
0130-001,2016,7,28,20,1451,1965,3416,4254
0130-001,2016,7,28,21,1357,1844,3201,3416
0130-001,2016,7,28,22,1132,1381,2513,3201
0130-001,2016,7,28,23,951,892,1843,2513
0130-001,2016,7,28,24,590,558,1148,1843
0130-001,2016,7,29,1,415,400,815,1148
0130-001,2016,7,29,2,284,247,531,815
0130-001,2016,7,29,3,189,194,383,531
0130-001,2016,7,29,4,183,205,388,383
0130-001,2016,7,29,5,219,264,483,388
0130-001,2016,7,29,6,687,486,1173,483
0130-001,2016,7,29,7,1646,902,2548,1173
0130-001,2016,7,29,8,1753,1562,3315,2548
0130-001,2016,7,29,9,1715,1887,3602,3315
0130-001,2016,7,29,10,1480,1729,3209,3602
0130-001,2016,7,29,11,1592,1618,3210,3209
0130-001,2016,7,29,12,1550,1561,3111,3210
0130-001,2016,7,29,13,1500,1650,3150,3111
0130-001,2016,7,29,14,1591,1850,3441,3150
0130-001,2016,7,29,15,1502,1483,2985,3441
0130-001,2016,7,29,16,1574,1658,3232,2985
0130-001,2016,7,29,17,1538,1620,3158,3232
0130-001,2016,7,29,18,1626,2112,3738,3158
0130-001,2016,7,29,19,1474,1632,3106,3738
0130-001,2016,7,29,20,1284,1538,2822,3106
0130-001,2016,7,29,21,1235,1602,2837,2822
0130-001,2016,7,29,22,1241,1228,2469,2837
0130-001,2016,7,29,23,1021,905,1926,2469
0130-001,2016,7,29,24,631,596,1227,1926
0130-001,2016,7,30,1,517,444,961,1227
0130-001,2016,7,30,2,332,297,629,961
0130-001,2016,7,30,3,261,241,502,629
0130-001,2016,7,30,4,185,250,435,502
0130-001,2016,7,30,5,215,232,447,435
0130-001,2016,7,30,6,572,399,971,447
0130-001,2016,7,30,7,1005,697,1702,971
0130-001,2016,7,30,8,1367,1163,2530,1702
0130-001,2016,7,30,9,1410,1716,3126,2530
0130-001,2016,7,30,10,1529,1783,3312,3126
0130-001,2016,7,30,11,1518,2040,3558,3312
0130-001,2016,7,30,12,1504,2091,3595,3558
0130-001,2016,7,30,13,1625,2275,3900,3595
0130-001,2016,7,30,14,1574,2293,3867,3900
0130-001,2016,7,30,15,1636,2280,3916,3867
0130-001,2016,7,30,16,1731,2073,3804,3916
0130-001,2016,7,30,17,1753,1961,3714,3804
0130-001,2016,7,30,18,1833,2057,3890,3714
0130-001,2016,7,30,19,1706,1915,3621,3890
0130-001,2016,7,30,20,1503,1480,2983,3621
0130-001,2016,7,30,21,1213,1209,2422,2983
0130-001,2016,7,30,22,1229,906,2135,2422
0130-001,2016,7,30,23,837,682,1519,2135
0130-001,2016,7,30,24,550,518,1068,1519
0130-001,2016,7,31,1,407,360,767,1068
0130-001,2016,7,31,2,268,252,520,767
0130-001,2016,7,31,3,241,194,435,520
0130-001,2016,7,31,4,209,151,360,435
0130-001,2016,7,31,5,221,161,382,360
0130-001,2016,7,31,6,442,334,776,382
0130-001,2016,7,31,7,699,474,1173,776
0130-001,2016,7,31,8,797,633,1430,1173
0130-001,2016,7,31,9,876,991,1867,1430
0130-001,2016,7,31,10,1028,1147,2175,1867
0130-001,2016,7,31,11,1235,1412,2647,2175
0130-001,2016,7,31,12,1143,1423,2566,2647
0130-001,2016,7,31,13,1227,1498,2725,2566
0130-001,2016,7,31,14,1329,1511,2840,2725
0130-001,2016,7,31,15,1504,1414,2918,2840
0130-001,2016,7,31,16,1721,1483,3204,2918
0130-001,2016,7,31,17,1692,1492,3184,3204
0130-001,2016,7,31,18,1742,1582,3324,3184
0130-001,2016,7,31,19,1606,1541,3147,3324
0130-001,2016,7,31,20,1387,1249,2636,3147
0130-001,2016,7,31,21,1299,1173,2472,2636
0130-001,2016,7,31,22,1110,944,2054,2472
0130-001,2016,7,31,23,808,692,1500,2054
0130-001,2016,7,31,24,499,471,970,1500
0130-001,2016,8,1,1,365,304,669,970
0130-001,2016,8,1,2,217,212,429,669
0130-001,2016,8,1,3,172,137,309,429
0130-001,2016,8,1,4,132,168,300,309
0130-001,2016,8,1,5,209,217,426,300
0130-001,2016,8,1,6,626,467,1093,426
0130-001,2016,8,1,7,1379,844,2223,1093
0130-001,2016,8,1,8,1581,1394,2975,2223
0130-001,2016,8,1,9,1578,1715,3293,2975
0130-001,2016,8,1,10,1695,1662,3357,3293
0130-001,2016,8,1,11,1713,1832,3545,3357
0130-001,2016,8,1,12,1682,1869,3551,3545
0130-001,2016,8,1,13,1546,1809,3355,3551
0130-001,2016,8,1,14,1641,1831,3472,3355
0130-001,2016,8,1,15,1739,1937,3676,3472
0130-001,2016,8,1,16,1780,1829,3609,3676
0130-001,2016,8,1,17,1694,1827,3521,3609
0130-001,2016,8,1,18,1735,2135,3870,3521
0130-001,2016,8,1,19,1735,2262,3997,3870
0130-001,2016,8,1,20,1504,1596,3100,3997
0130-001,2016,8,1,21,1222,1421,2643,3100
0130-001,2016,8,1,22,975,1141,2116,2643
0130-001,2016,8,1,23,794,737,1531,2116
0130-001,2016,8,1,24,505,492,997,1531
0130-001,2016,8,2,1,356,363,719,997
0130-001,2016,8,2,2,217,228,445,719
0130-001,2016,8,2,3,183,176,359,445
0130-001,2016,8,2,4,146,189,335,359
0130-001,2016,8,2,5,202,215,417,335
0130-001,2016,8,2,6,621,452,1073,417
0130-001,2016,8,2,7,1309,825,2134,1073
0130-001,2016,8,2,8,1565,1261,2826,2134
0130-001,2016,8,2,9,1594,1652,3246,2826
0130-001,2016,8,2,10,1578,1555,3133,3246
0130-001,2016,8,2,11,1715,1697,3412,3133
0130-001,2016,8,2,12,1668,1770,3438,3412
0130-001,2016,8,2,13,1510,1673,3183,3438
0130-001,2016,8,2,14,1692,1733,3425,3183
0130-001,2016,8,2,15,1738,1792,3530,3425
0130-001,2016,8,2,16,1738,1852,3590,3530
0130-001,2016,8,2,17,1704,1766,3470,3590
0130-001,2016,8,2,18,1807,2142,3949,3470
0130-001,2016,8,2,19,1763,2228,3991,3949
0130-001,2016,8,2,20,1558,1596,3154,3991
0130-001,2016,8,2,21,1193,1484,2677,3154
0130-001,2016,8,2,22,1005,1149,2154,2677
0130-001,2016,8,2,23,769,736,1505,2154
0130-001,2016,8,2,24,570,535,1105,1505
0130-001,2016,8,3,1,282,304,586,1105
0130-001,2016,8,3,2,185,196,381,586
0130-001,2016,8,3,3,173,173,346,381
0130-001,2016,8,3,4,178,201,379,346
0130-001,2016,8,3,5,229,218,447,379
0130-001,2016,8,3,6,591,420,1011,447
0130-001,2016,8,3,7,1348,803,2151,1011
0130-001,2016,8,3,8,1500,1368,2868,2151
0130-001,2016,8,3,9,1609,1586,3195,2868
0130-001,2016,8,3,10,1579,1563,3142,3195
0130-001,2016,8,3,11,1672,1732,3404,3142
0130-001,2016,8,3,12,1572,1792,3364,3404
0130-001,2016,8,3,13,1522,1635,3157,3364
0130-001,2016,8,3,14,1595,1764,3359,3157
0130-001,2016,8,3,15,1763,1823,3586,3359
0130-001,2016,8,3,16,1764,1787,3551,3586
0130-001,2016,8,3,17,1647,1873,3520,3551
0130-001,2016,8,3,18,1723,2192,3915,3520
0130-001,2016,8,3,19,1834,2310,4144,3915
0130-001,2016,8,3,20,1424,1628,3052,4144
0130-001,2016,8,3,21,1175,1388,2563,3052
0130-001,2016,8,3,22,1099,1092,2191,2563
0130-001,2016,8,3,23,863,791,1654,2191
0130-001,2016,8,3,24,563,520,1083,1654
0130-001,2016,8,4,1,406,331,737,1083
0130-001,2016,8,4,2,280,256,536,737
0130-001,2016,8,4,3,200,184,384,536
0130-001,2016,8,4,4,152,195,347,384
0130-001,2016,8,4,5,231,224,455,347
0130-001,2016,8,4,6,632,439,1071,455
0130-001,2016,8,4,7,1425,852,2277,1071
0130-001,2016,8,4,8,1724,1416,3140,2277
0130-001,2016,8,4,9,1694,1713,3407,3140
0130-001,2016,8,4,10,1741,1671,3412,3407
0130-001,2016,8,4,11,1466,1623,3089,3412
0130-001,2016,8,4,12,1610,1801,3411,3089
0130-001,2016,8,4,13,1456,1655,3111,3411
0130-001,2016,8,4,14,1676,1770,3446,3111
0130-001,2016,8,4,15,1726,1774,3500,3446
0130-001,2016,8,4,16,1742,1842,3584,3500
0130-001,2016,8,4,17,1674,1848,3522,3584
0130-001,2016,8,4,18,1810,2218,4028,3522
0130-001,2016,8,4,19,1717,2373,4090,4028
0130-001,2016,8,4,20,1392,1852,3244,4090
0130-001,2016,8,4,21,1208,1533,2741,3244
0130-001,2016,8,4,22,1069,1169,2238,2741
0130-001,2016,8,4,23,831,743,1574,2238
0130-001,2016,8,4,24,579,509,1088,1574
0130-001,2016,8,5,1,384,346,730,1088
0130-001,2016,8,5,2,239,212,451,730
0130-001,2016,8,5,3,194,190,384,451
0130-001,2016,8,5,4,167,200,367,384
0130-001,2016,8,5,5,209,263,472,367
0130-001,2016,8,5,6,637,417,1054,472
0130-001,2016,8,5,7,1384,841,2225,1054
0130-001,2016,8,5,8,1728,1430,3158,2225
0130-001,2016,8,5,9,1686,1731,3417,3158
0130-001,2016,8,5,10,1624,1644,3268,3417
0130-001,2016,8,5,11,1769,1729,3498,3268
0130-001,2016,8,5,12,1629,1757,3386,3498
0130-001,2016,8,5,13,1529,1747,3276,3386
0130-001,2016,8,5,14,1727,1842,3569,3276
0130-001,2016,8,5,15,1785,1835,3620,3569
0130-001,2016,8,5,16,1774,1826,3600,3620
0130-001,2016,8,5,17,1690,1971,3661,3600
0130-001,2016,8,5,18,1701,2303,4004,3661
0130-001,2016,8,5,19,1766,2527,4293,4004
0130-001,2016,8,5,20,1546,2013,3559,4293
0130-001,2016,8,5,21,1373,1589,2962,3559
0130-001,2016,8,5,22,1190,1193,2383,2962
0130-001,2016,8,5,23,933,874,1807,2383
0130-001,2016,8,5,24,627,563,1190,1807
0130-001,2016,8,6,1,488,445,933,1190
0130-001,2016,8,6,2,295,293,588,933
0130-001,2016,8,6,3,223,224,447,588
0130-001,2016,8,6,4,229,203,432,447
0130-001,2016,8,6,5,263,236,499,432
0130-001,2016,8,6,6,571,391,962,499
0130-001,2016,8,6,7,1069,726,1795,962
0130-001,2016,8,6,8,1357,1110,2467,1795
0130-001,2016,8,6,9,1414,1500,2914,2467
0130-001,2016,8,6,10,1552,1673,3225,2914
0130-001,2016,8,6,11,1653,1765,3418,3225
0130-001,2016,8,6,12,1651,1892,3543,3418
0130-001,2016,8,6,13,1581,1880,3461,3543
0130-001,2016,8,6,14,1547,1864,3411,3461
0130-001,2016,8,6,15,1588,1746,3334,3411
0130-001,2016,8,6,16,1654,1848,3502,3334
0130-001,2016,8,6,17,1697,1799,3496,3502
0130-001,2016,8,6,18,1779,1995,3774,3496
0130-001,2016,8,6,19,1716,1864,3580,3774
0130-001,2016,8,6,20,1386,1437,2823,3580
0130-001,2016,8,6,21,1215,1326,2541,2823
0130-001,2016,8,6,22,1219,1026,2245,2541
0130-001,2016,8,6,23,813,676,1489,2245
0130-001,2016,8,6,24,520,487,1007,1489
0130-001,2016,8,7,1,422,332,754,1007
0130-001,2016,8,7,2,328,246,574,754
0130-001,2016,8,7,3,246,184,430,574
0130-001,2016,8,7,4,180,151,331,430
0130-001,2016,8,7,5,225,154,379,331
0130-001,2016,8,7,6,346,264,610,379
0130-001,2016,8,7,7,639,411,1050,610
0130-001,2016,8,7,8,767,590,1357,1050
0130-001,2016,8,7,9,835,861,1696,1357
0130-001,2016,8,7,10,957,1029,1986,1696
0130-001,2016,8,7,11,1074,1136,2210,1986
0130-001,2016,8,7,12,1073,1226,2299,2210
0130-001,2016,8,7,13,1173,1434,2607,2299
0130-001,2016,8,7,14,1246,1290,2536,2607
0130-001,2016,8,7,15,1429,1323,2752,2536
0130-001,2016,8,7,16,1465,1405,2870,2752
0130-001,2016,8,7,17,1551,1403,2954,2870
0130-001,2016,8,7,18,1593,1492,3085,2954
0130-001,2016,8,7,19,1511,1300,2811,3085
0130-001,2016,8,7,20,1317,1049,2366,2811
0130-001,2016,8,7,21,1340,1007,2347,2366
0130-001,2016,8,7,22,943,763,1706,2347
0130-001,2016,8,7,23,670,535,1205,1706
0130-001,2016,8,7,24,442,337,779,1205
0130-001,2016,8,8,1,281,220,501,779
0130-001,2016,8,8,2,183,145,328,501
0130-001,2016,8,8,3,126,112,238,328
0130-001,2016,8,8,4,130,141,271,238
0130-001,2016,8,8,5,201,162,363,271
0130-001,2016,8,8,6,522,374,896,363
0130-001,2016,8,8,7,1717,835,2552,896
0130-001,2016,8,8,8,1991,1552,3543,2552
0130-001,2016,8,8,9,2051,1839,3890,3543
0130-001,2016,8,8,10,1876,1709,3585,3890
0130-001,2016,8,8,11,1807,1735,3542,3585
0130-001,2016,8,8,12,1748,1701,3449,3542
0130-001,2016,8,8,13,1527,1572,3099,3449
0130-001,2016,8,8,14,1777,1745,3522,3099
0130-001,2016,8,8,15,1844,1823,3667,3522
0130-001,2016,8,8,16,1900,1933,3833,3667
0130-001,2016,8,8,17,1768,1869,3637,3833
0130-001,2016,8,8,18,1817,2336,4153,3637
0130-001,2016,8,8,19,1827,2495,4322,4153
0130-001,2016,8,8,20,1464,1966,3430,4322
0130-001,2016,8,8,21,1288,1766,3054,3430
0130-001,2016,8,8,22,1088,1278,2366,3054
0130-001,2016,8,8,23,864,781,1645,2366
0130-001,2016,8,8,24,531,471,1002,1645
0130-001,2016,8,9,1,365,316,681,1002
0130-001,2016,8,9,2,232,227,459,681
0130-001,2016,8,9,3,172,169,341,459
0130-001,2016,8,9,4,152,155,307,341
0130-001,2016,8,9,5,185,210,395,307
0130-001,2016,8,9,6,500,354,854,395
0130-001,2016,8,9,7,1595,796,2391,854
0130-001,2016,8,9,8,1929,1502,3431,2391
0130-001,2016,8,9,9,2064,1824,3888,3431
0130-001,2016,8,9,10,1873,1738,3611,3888
0130-001,2016,8,9,11,1807,1714,3521,3611
0130-001,2016,8,9,12,1705,1701,3406,3521
0130-001,2016,8,9,13,1472,1551,3023,3406
0130-001,2016,8,9,14,1711,1771,3482,3023
0130-001,2016,8,9,15,1866,1870,3736,3482
0130-001,2016,8,9,16,1890,1879,3769,3736
0130-001,2016,8,9,17,1785,1903,3688,3769
0130-001,2016,8,9,18,1807,2261,4068,3688
0130-001,2016,8,9,19,1789,2484,4273,4068
0130-001,2016,8,9,20,1418,1879,3297,4273
0130-001,2016,8,9,21,1244,1722,2966,3297
0130-001,2016,8,9,22,1121,1284,2405,2966
0130-001,2016,8,9,23,861,782,1643,2405
0130-001,2016,8,9,24,571,494,1065,1643
0130-001,2016,8,10,1,381,317,698,1065
0130-001,2016,8,10,2,245,233,478,698
0130-001,2016,8,10,3,187,159,346,478
0130-001,2016,8,10,4,154,171,325,346
0130-001,2016,8,10,5,214,173,387,325
0130-001,2016,8,10,6,462,387,849,387
0130-001,2016,8,10,7,1587,789,2376,849
0130-001,2016,8,10,8,1951,1509,3460,2376
0130-001,2016,8,10,9,1979,1835,3814,3460
0130-001,2016,8,10,10,1854,1755,3609,3814
0130-001,2016,8,10,11,1882,1723,3605,3609
0130-001,2016,8,10,12,1749,1821,3570,3605
0130-001,2016,8,10,13,1484,1772,3256,3570
0130-001,2016,8,10,14,1790,1772,3562,3256
0130-001,2016,8,10,15,1854,1849,3703,3562
0130-001,2016,8,10,16,1890,1873,3763,3703
0130-001,2016,8,10,17,1756,1886,3642,3763
0130-001,2016,8,10,18,1798,2245,4043,3642
0130-001,2016,8,10,19,1911,2521,4432,4043
0130-001,2016,8,10,20,1444,1967,3411,4432
0130-001,2016,8,10,21,1265,1649,2914,3411
0130-001,2016,8,10,22,1137,1209,2346,2914
0130-001,2016,8,10,23,943,763,1706,2346
0130-001,2016,8,10,24,552,502,1054,1706
0130-001,2016,8,11,1,384,312,696,1054
0130-001,2016,8,11,2,241,237,478,696
0130-001,2016,8,11,3,195,179,374,478
0130-001,2016,8,11,4,165,182,347,374
0130-001,2016,8,11,5,220,225,445,347
0130-001,2016,8,11,6,503,367,870,445
0130-001,2016,8,11,7,1553,777,2330,870
0130-001,2016,8,11,8,1990,1555,3545,2330
0130-001,2016,8,11,9,2045,1872,3917,3545
0130-001,2016,8,11,10,1869,1718,3587,3917
0130-001,2016,8,11,11,1873,1742,3615,3587
0130-001,2016,8,11,12,1779,1776,3555,3615
0130-001,2016,8,11,13,1521,1627,3148,3555
0130-001,2016,8,11,14,1734,1787,3521,3148
0130-001,2016,8,11,15,1873,1888,3761,3521
0130-001,2016,8,11,16,1878,1902,3780,3761
0130-001,2016,8,11,17,1801,1998,3799,3780
0130-001,2016,8,11,18,1955,2309,4264,3799
0130-001,2016,8,11,19,1918,2538,4456,4264
0130-001,2016,8,11,20,1598,2149,3747,4456
0130-001,2016,8,11,21,1438,1848,3286,3747
0130-001,2016,8,11,22,1276,1327,2603,3286
0130-001,2016,8,11,23,1007,821,1828,2603
0130-001,2016,8,11,24,595,581,1176,1828
0130-001,2016,8,12,1,446,365,811,1176
0130-001,2016,8,12,2,313,272,585,811
0130-001,2016,8,12,3,246,218,464,585
0130-001,2016,8,12,4,210,204,414,464
0130-001,2016,8,12,5,256,242,498,414
0130-001,2016,8,12,6,482,379,861,498
0130-001,2016,8,12,7,1212,657,1869,861
0130-001,2016,8,12,8,1739,1127,2866,1869
0130-001,2016,8,12,9,1539,1649,3188,2866
0130-001,2016,8,12,10,1566,1830,3396,3188
0130-001,2016,8,12,11,1608,2137,3745,3396
0130-001,2016,8,12,12,1620,2295,3915,3745
0130-001,2016,8,12,13,1359,2149,3508,3915
0130-001,2016,8,12,14,1505,2113,3618,3508
0130-001,2016,8,12,15,1598,2085,3683,3618
0130-001,2016,8,12,16,1671,2005,3676,3683
0130-001,2016,8,12,17,1640,1942,3582,3676
0130-001,2016,8,12,18,1815,2185,4000,3582
0130-001,2016,8,12,19,1786,2116,3902,4000
0130-001,2016,8,12,20,1496,1560,3056,3902
0130-001,2016,8,12,21,1353,1340,2693,3056
0130-001,2016,8,12,22,1128,1031,2159,2693
0130-001,2016,8,12,23,864,690,1554,2159
0130-001,2016,8,12,24,576,501,1077,1554
0130-001,2016,8,13,1,433,368,801,1077
0130-001,2016,8,13,2,309,274,583,801
0130-001,2016,8,13,3,215,183,398,583
0130-001,2016,8,13,4,200,200,400,398
0130-001,2016,8,13,5,220,219,439,400
0130-001,2016,8,13,6,467,336,803,439
0130-001,2016,8,13,7,1031,596,1627,803
0130-001,2016,8,13,8,1351,948,2299,1627
0130-001,2016,8,13,9,1297,1294,2591,2299
0130-001,2016,8,13,10,1383,1481,2864,2591
0130-001,2016,8,13,11,1375,1616,2991,2864
0130-001,2016,8,13,12,1466,1824,3290,2991
0130-001,2016,8,13,13,1389,1854,3243,3290
0130-001,2016,8,13,14,1474,1682,3156,3243
0130-001,2016,8,13,15,1539,1654,3193,3156
0130-001,2016,8,13,16,1677,1735,3412,3193
0130-001,2016,8,13,17,1827,1866,3693,3412
0130-001,2016,8,13,18,1800,2149,3949,3693
0130-001,2016,8,13,19,1788,1735,3523,3949
0130-001,2016,8,13,20,1627,1359,2986,3523
0130-001,2016,8,13,21,1465,1219,2684,2986
0130-001,2016,8,13,22,1243,860,2103,2684
0130-001,2016,8,13,23,899,642,1541,2103
0130-001,2016,8,13,24,536,482,1018,1541
0130-001,2016,8,14,1,427,392,819,1018
0130-001,2016,8,14,2,287,241,528,819
0130-001,2016,8,14,3,237,190,427,528
0130-001,2016,8,14,4,183,146,329,427
0130-001,2016,8,14,5,200,145,345,329
0130-001,2016,8,14,6,319,260,579,345
0130-001,2016,8,14,7,594,381,975,579
0130-001,2016,8,14,8,693,613,1306,975
0130-001,2016,8,14,9,826,968,1794,1306
0130-001,2016,8,14,10,874,1051,1925,1794
0130-001,2016,8,14,11,1100,1223,2323,1925
0130-001,2016,8,14,12,1206,1399,2605,2323
0130-001,2016,8,14,13,1438,1596,3034,2605
0130-001,2016,8,14,14,1552,1375,2927,3034
0130-001,2016,8,14,15,1703,1481,3184,2927
0130-001,2016,8,14,16,1733,1555,3288,3184
0130-001,2016,8,14,17,1741,1504,3245,3288
0130-001,2016,8,14,18,1758,1478,3236,3245
0130-001,2016,8,14,19,1710,1391,3101,3236
0130-001,2016,8,14,20,1469,1118,2587,3101
0130-001,2016,8,14,21,1348,981,2329,2587
0130-001,2016,8,14,22,1033,698,1731,2329
0130-001,2016,8,14,23,808,507,1315,1731
0130-001,2016,8,14,24,440,354,794,1315
0130-001,2016,8,15,1,297,207,504,794
0130-001,2016,8,15,2,181,142,323,504
0130-001,2016,8,15,3,126,101,227,323
0130-001,2016,8,15,4,131,120,251,227
0130-001,2016,8,15,5,174,167,341,251
0130-001,2016,8,15,6,489,351,840,341
0130-001,2016,8,15,7,1575,862,2437,840
0130-001,2016,8,15,8,1859,1686,3545,2437
0130-001,2016,8,15,9,1971,1873,3844,3545
0130-001,2016,8,15,10,1748,1699,3447,3844
0130-001,2016,8,15,11,1748,1796,3544,3447
0130-001,2016,8,15,12,1659,1643,3302,3544
0130-001,2016,8,15,13,1459,1557,3016,3302
0130-001,2016,8,15,14,1726,1706,3432,3016
0130-001,2016,8,15,15,1821,1856,3677,3432
0130-001,2016,8,15,16,1842,1796,3638,3677
0130-001,2016,8,15,17,1698,1848,3546,3638
0130-001,2016,8,15,18,1756,2234,3990,3546
0130-001,2016,8,15,19,1756,2488,4244,3990
0130-001,2016,8,15,20,1454,1844,3298,4244
0130-001,2016,8,15,21,1188,1637,2825,3298
0130-001,2016,8,15,22,1119,1192,2311,2825
0130-001,2016,8,15,23,766,709,1475,2311
0130-001,2016,8,15,24,546,462,1008,1475
0130-001,2016,8,16,1,354,283,637,1008
0130-001,2016,8,16,2,219,210,429,637
0130-001,2016,8,16,3,188,148,336,429
0130-001,2016,8,16,4,143,181,324,336
0130-001,2016,8,16,5,210,182,392,324
0130-001,2016,8,16,6,464,352,816,392
0130-001,2016,8,16,7,1587,750,2337,816
0130-001,2016,8,16,8,1947,1602,3549,2337
0130-001,2016,8,16,9,2123,1909,4032,3549
0130-001,2016,8,16,10,1796,1731,3527,4032
0130-001,2016,8,16,11,1787,1742,3529,3527
0130-001,2016,8,16,12,1725,1679,3404,3529
0130-001,2016,8,16,13,1549,1534,3083,3404
0130-001,2016,8,16,14,1862,1700,3562,3083
0130-001,2016,8,16,15,1795,1779,3574,3562
0130-001,2016,8,16,16,1858,1881,3739,3574
0130-001,2016,8,16,17,1760,1849,3609,3739
0130-001,2016,8,16,18,1806,2276,4082,3609
0130-001,2016,8,16,19,1757,2511,4268,4082
0130-001,2016,8,16,20,1435,1950,3385,4268
0130-001,2016,8,16,21,1263,1779,3042,3385
0130-001,2016,8,16,22,1125,1292,2417,3042
0130-001,2016,8,16,23,879,766,1645,2417
0130-001,2016,8,16,24,585,495,1080,1645
0130-001,2016,8,17,1,367,322,689,1080
0130-001,2016,8,17,2,234,234,468,689
0130-001,2016,8,17,3,190,164,354,468
0130-001,2016,8,17,4,156,191,347,354
0130-001,2016,8,17,5,209,226,435,347
0130-001,2016,8,17,6,569,409,978,435
0130-001,2016,8,17,7,1626,828,2454,978
0130-001,2016,8,17,8,1822,1613,3435,2454
0130-001,2016,8,17,9,1949,1932,3881,3435
0130-001,2016,8,17,10,1718,1696,3414,3881
0130-001,2016,8,17,11,1784,1745,3529,3414
0130-001,2016,8,17,12,1696,1708,3404,3529
0130-001,2016,8,17,13,1495,1572,3067,3404
0130-001,2016,8,17,14,1705,1701,3406,3067
0130-001,2016,8,17,15,1716,1751,3467,3406
0130-001,2016,8,17,16,1706,1795,3501,3467
0130-001,2016,8,17,17,1786,1935,3721,3501
0130-001,2016,8,17,18,1706,2303,4009,3721
0130-001,2016,8,17,19,1791,2675,4466,4009
0130-001,2016,8,17,20,1440,2035,3475,4466
0130-001,2016,8,17,21,1251,1725,2976,3475
0130-001,2016,8,17,22,1131,1315,2446,2976
0130-001,2016,8,17,23,867,789,1656,2446
0130-001,2016,8,17,24,618,517,1135,1656
0130-001,2016,8,18,1,380,361,741,1135
0130-001,2016,8,18,2,248,258,506,741
0130-001,2016,8,18,3,191,181,372,506
0130-001,2016,8,18,4,168,201,369,372
0130-001,2016,8,18,5,208,269,477,369
0130-001,2016,8,18,6,674,466,1140,477
0130-001,2016,8,18,7,1666,905,2571,1140
0130-001,2016,8,18,8,1697,1624,3321,2571
0130-001,2016,8,18,9,1775,1954,3729,3321
0130-001,2016,8,18,10,1641,1660,3301,3729
0130-001,2016,8,18,11,1781,1748,3529,3301
0130-001,2016,8,18,12,1667,1737,3404,3529
0130-001,2016,8,18,13,1506,1651,3157,3404
0130-001,2016,8,18,14,1786,1668,3454,3157
0130-001,2016,8,18,15,1460,1218,2678,3454
0130-001,2016,8,18,16,1660,1701,3361,2678
0130-001,2016,8,18,17,1645,1935,3580,3361
0130-001,2016,8,18,18,1702,2255,3957,3580
0130-001,2016,8,18,19,1746,2556,4302,3957
0130-001,2016,8,18,20,1375,1933,3308,4302
0130-001,2016,8,18,21,1233,1827,3060,3308
0130-001,2016,8,18,22,1136,1416,2552,3060
0130-001,2016,8,18,23,866,831,1697,2552
0130-001,2016,8,18,24,578,516,1094,1697
0130-001,2016,8,19,1,408,373,781,1094
0130-001,2016,8,19,2,232,244,476,781
0130-001,2016,8,19,3,195,202,397,476
0130-001,2016,8,19,4,178,227,405,397
0130-001,2016,8,19,5,234,267,501,405
0130-001,2016,8,19,6,695,458,1153,501
0130-001,2016,8,19,7,1648,913,2561,1153
0130-001,2016,8,19,8,1695,1692,3387,2561
0130-001,2016,8,19,9,1807,1923,3730,3387
0130-001,2016,8,19,10,1685,1677,3362,3730
0130-001,2016,8,19,11,1728,1747,3475,3362
0130-001,2016,8,19,12,1691,1734,3425,3475
0130-001,2016,8,19,13,1500,1658,3158,3425
0130-001,2016,8,19,14,1744,1841,3585,3158
0130-001,2016,8,19,15,1715,1855,3570,3585
0130-001,2016,8,19,16,1716,1917,3633,3570
0130-001,2016,8,19,17,1745,2062,3807,3633
0130-001,2016,8,19,18,1798,2427,4225,3807
0130-001,2016,8,19,19,1744,2736,4480,4225
0130-001,2016,8,19,20,1484,2187,3671,4480
0130-001,2016,8,19,21,1390,1952,3342,3671
0130-001,2016,8,19,22,1292,1468,2760,3342
0130-001,2016,8,19,23,1044,941,1985,2760
0130-001,2016,8,19,24,665,668,1333,1985
0130-001,2016,8,20,1,518,441,959,1333
0130-001,2016,8,20,2,350,350,700,959
0130-001,2016,8,20,3,284,233,517,700
0130-001,2016,8,20,4,238,276,514,517
0130-001,2016,8,20,5,283,274,557,514
0130-001,2016,8,20,6,646,433,1079,557
0130-001,2016,8,20,7,1311,742,2053,1079
0130-001,2016,8,20,8,1589,1113,2702,2053
0130-001,2016,8,20,9,1603,1573,3176,2702
0130-001,2016,8,20,10,1635,1766,3401,3176
0130-001,2016,8,20,11,1756,1821,3577,3401
0130-001,2016,8,20,12,1785,1919,3704,3577
0130-001,2016,8,20,13,1719,1845,3564,3704
0130-001,2016,8,20,14,1624,1926,3550,3564
0130-001,2016,8,20,15,1711,1825,3536,3550
0130-001,2016,8,20,16,1760,1789,3549,3536
0130-001,2016,8,20,17,1816,1908,3724,3549
0130-001,2016,8,20,18,1721,2233,3954,3724
0130-001,2016,8,20,19,1661,2213,3874,3954
0130-001,2016,8,20,20,1440,1556,2996,3874
0130-001,2016,8,20,21,1272,1261,2533,2996
0130-001,2016,8,20,22,1283,1038,2321,2533
0130-001,2016,8,20,23,915,777,1692,2321
0130-001,2016,8,20,24,579,548,1127,1692
0130-001,2016,8,21,1,436,395,831,1127
0130-001,2016,8,21,2,277,282,559,831
0130-001,2016,8,21,3,271,206,477,559
0130-001,2016,8,21,4,195,185,380,477
0130-001,2016,8,21,5,239,199,438,380
0130-001,2016,8,21,6,461,297,758,438
0130-001,2016,8,21,7,689,527,1216,758
0130-001,2016,8,21,8,835,680,1515,1216
0130-001,2016,8,21,9,899,1088,1987,1515
0130-001,2016,8,21,10,992,1133,2125,1987
0130-001,2016,8,21,11,1220,1385,2605,2125
0130-001,2016,8,21,12,1303,1412,2715,2605
0130-001,2016,8,21,13,1412,1612,3024,2715
0130-001,2016,8,21,14,1504,1612,3116,3024
0130-001,2016,8,21,15,1552,1676,3228,3116
0130-001,2016,8,21,16,1616,1601,3217,3228
0130-001,2016,8,21,17,1635,1645,3280,3217
0130-001,2016,8,21,18,1763,1676,3439,3280
0130-001,2016,8,21,19,1623,1508,3131,3439
0130-001,2016,8,21,20,1417,1306,2723,3131
0130-001,2016,8,21,21,1262,1146,2408,2723
0130-001,2016,8,21,22,1062,934,1996,2408
0130-001,2016,8,21,23,732,647,1379,1996
0130-001,2016,8,21,24,520,436,956,1379
0130-001,2016,8,22,1,306,265,571,956
0130-001,2016,8,22,2,176,169,345,571
0130-001,2016,8,22,3,150,116,266,345
0130-001,2016,8,22,4,130,191,321,266
0130-001,2016,8,22,5,224,231,455,321
0130-001,2016,8,22,6,759,476,1235,455
0130-001,2016,8,22,7,1838,1063,2901,1235
0130-001,2016,8,22,8,1748,1704,3452,2901
0130-001,2016,8,22,9,1828,1995,3823,3452
0130-001,2016,8,22,10,1681,1619,3300,3823
0130-001,2016,8,22,11,1717,1720,3437,3300
0130-001,2016,8,22,12,1662,1672,3334,3437
0130-001,2016,8,22,13,1509,1577,3086,3334
0130-001,2016,8,22,14,1699,1683,3382,3086
0130-001,2016,8,22,15,1753,1796,3549,3382
0130-001,2016,8,22,16,1763,1781,3544,3549
0130-001,2016,8,22,17,1657,1947,3604,3544
0130-001,2016,8,22,18,1758,2360,4118,3604
0130-001,2016,8,22,19,1655,2561,4216,4118
0130-001,2016,8,22,20,1433,2038,3471,4216
0130-001,2016,8,22,21,1281,1878,3159,3471
0130-001,2016,8,22,22,1108,1363,2471,3159
0130-001,2016,8,22,23,818,838,1656,2471
0130-001,2016,8,22,24,526,522,1048,1656
0130-001,2016,8,23,1,348,329,677,1048
0130-001,2016,8,23,2,239,215,454,677
0130-001,2016,8,23,3,181,195,376,454
0130-001,2016,8,23,4,157,222,379,376
0130-001,2016,8,23,5,226,278,504,379
0130-001,2016,8,23,6,705,464,1169,504
0130-001,2016,8,23,7,1756,1015,2771,1169
0130-001,2016,8,23,8,1673,1694,3367,2771
0130-001,2016,8,23,9,1765,1981,3746,3367
0130-001,2016,8,23,10,1708,1675,3383,3746
0130-001,2016,8,23,11,1716,1692,3408,3383
0130-001,2016,8,23,12,1694,1684,3378,3408
0130-001,2016,8,23,13,1497,1603,3100,3378
0130-001,2016,8,23,14,1754,1742,3496,3100
0130-001,2016,8,23,15,1772,1804,3576,3496
0130-001,2016,8,23,16,1802,1858,3660,3576
0130-001,2016,8,23,17,1690,1994,3684,3660
0130-001,2016,8,23,18,1792,2370,4162,3684
0130-001,2016,8,23,19,1695,2476,4171,4162
0130-001,2016,8,23,20,1488,2012,3500,4171
0130-001,2016,8,23,21,1278,1855,3133,3500
0130-001,2016,8,23,22,1135,1342,2477,3133
0130-001,2016,8,23,23,833,891,1724,2477
0130-001,2016,8,23,24,494,499,993,1724
0130-001,2016,8,24,1,440,371,811,993
0130-001,2016,8,24,2,224,256,480,811
0130-001,2016,8,24,3,193,210,403,480
0130-001,2016,8,24,4,156,223,379,403
0130-001,2016,8,24,5,221,260,481,379
0130-001,2016,8,24,6,681,442,1123,481
0130-001,2016,8,24,7,1684,926,2610,1123
0130-001,2016,8,24,8,1751,1618,3369,2610
0130-001,2016,8,24,9,1872,2080,3952,3369
0130-001,2016,8,24,10,1787,1717,3504,3952
0130-001,2016,8,24,11,1599,1500,3099,3504
0130-001,2016,8,24,12,1582,1467,3049,3099
0130-001,2016,8,24,13,1507,1586,3093,3049
0130-001,2016,8,24,14,1740,1829,3569,3093
0130-001,2016,8,24,15,1792,1811,3603,3569
0130-001,2016,8,24,16,1840,1936,3776,3603
0130-001,2016,8,24,17,1722,2041,3763,3776
0130-001,2016,8,24,18,1846,2469,4315,3763
0130-001,2016,8,24,19,1701,2658,4359,4315
0130-001,2016,8,24,20,1467,2089,3556,4359
0130-001,2016,8,24,21,1283,1758,3041,3556
0130-001,2016,8,24,22,1201,1342,2543,3041
0130-001,2016,8,24,23,878,840,1718,2543
0130-001,2016,8,24,24,581,580,1161,1718
0130-001,2016,8,25,1,391,386,777,1161
0130-001,2016,8,25,2,252,269,521,777
0130-001,2016,8,25,3,192,192,384,521
0130-001,2016,8,25,4,181,203,384,384
0130-001,2016,8,25,5,238,268,506,384
0130-001,2016,8,25,6,702,463,1165,506
0130-001,2016,8,25,7,1691,943,2634,1165
0130-001,2016,8,25,8,1681,1735,3416,2634
0130-001,2016,8,25,9,1819,1950,3769,3416
0130-001,2016,8,25,10,1773,1682,3455,3769
0130-001,2016,8,25,11,1760,1742,3502,3455
0130-001,2016,8,25,12,1653,1696,3349,3502
0130-001,2016,8,25,13,1531,1582,3113,3349
0130-001,2016,8,25,14,1674,1728,3402,3113
0130-001,2016,8,25,15,1742,1806,3548,3402
0130-001,2016,8,25,16,1815,1934,3749,3548
0130-001,2016,8,25,17,1669,1893,3562,3749
0130-001,2016,8,25,18,1844,2448,4292,3562
0130-001,2016,8,25,19,1628,2480,4108,4292
0130-001,2016,8,25,20,1411,2091,3502,4108
0130-001,2016,8,25,21,1290,1800,3090,3502
0130-001,2016,8,25,22,1092,1404,2496,3090
0130-001,2016,8,25,23,895,868,1763,2496
0130-001,2016,8,25,24,625,566,1191,1763
0130-001,2016,8,26,1,424,433,857,1191
0130-001,2016,8,26,2,239,249,488,857
0130-001,2016,8,26,3,202,185,387,488
0130-001,2016,8,26,4,178,229,407,387
0130-001,2016,8,26,5,236,270,506,407
0130-001,2016,8,26,6,700,453,1153,506
0130-001,2016,8,26,7,1451,797,2248,1153
0130-001,2016,8,26,8,1621,1603,3224,2248
0130-001,2016,8,26,9,1747,1984,3731,3224
0130-001,2016,8,26,10,1567,1466,3033,3731
0130-001,2016,8,26,11,1781,1701,3482,3033
0130-001,2016,8,26,12,1748,1728,3476,3482
0130-001,2016,8,26,13,1566,1615,3181,3476
0130-001,2016,8,26,14,1497,1867,3364,3181
0130-001,2016,8,26,15,1332,1860,3192,3364
0130-001,2016,8,26,16,1693,1954,3647,3192
0130-001,2016,8,26,17,1818,2111,3929,3647
0130-001,2016,8,26,18,1811,2450,4261,3929
0130-001,2016,8,26,19,1790,2634,4424,4261
0130-001,2016,8,26,20,1555,2126,3681,4424
0130-001,2016,8,26,21,1377,1824,3201,3681
0130-001,2016,8,26,22,1353,1371,2724,3201
0130-001,2016,8,26,23,973,906,1879,2724
0130-001,2016,8,26,24,653,637,1290,1879
0130-001,2016,8,27,1,525,443,968,1290
0130-001,2016,8,27,2,360,349,709,968
0130-001,2016,8,27,3,287,259,546,709
0130-001,2016,8,27,4,229,271,500,546
0130-001,2016,8,27,5,283,276,559,500
0130-001,2016,8,27,6,620,465,1085,559
0130-001,2016,8,27,7,1272,783,2055,1085
0130-001,2016,8,27,8,1576,1201,2777,2055
0130-001,2016,8,27,9,1651,1816,3467,2777
0130-001,2016,8,27,10,1662,1944,3606,3467
0130-001,2016,8,27,11,1844,2033,3877,3606
0130-001,2016,8,27,12,1800,2159,3959,3877
0130-001,2016,8,27,13,1753,2086,3839,3959
0130-001,2016,8,27,14,1750,2110,3860,3839
0130-001,2016,8,27,15,1760,1961,3721,3860
0130-001,2016,8,27,16,1834,1902,3736,3721
0130-001,2016,8,27,17,1897,1946,3843,3736
0130-001,2016,8,27,18,1819,2210,4029,3843
0130-001,2016,8,27,19,1761,2186,3947,4029
0130-001,2016,8,27,20,1632,1513,3145,3947
0130-001,2016,8,27,21,1430,1311,2741,3145
0130-001,2016,8,27,22,1314,1063,2377,2741
0130-001,2016,8,27,23,849,779,1628,2377
0130-001,2016,8,27,24,588,548,1136,1628
0130-001,2016,8,28,1,426,381,807,1136
0130-001,2016,8,28,2,327,295,622,807
0130-001,2016,8,28,3,226,200,426,622
0130-001,2016,8,28,4,195,194,389,426
0130-001,2016,8,28,5,233,192,425,389
0130-001,2016,8,28,6,463,344,807,425
0130-001,2016,8,28,7,726,569,1295,807
0130-001,2016,8,28,8,936,801,1737,1295
0130-001,2016,8,28,9,948,1065,2013,1737
0130-001,2016,8,28,10,1068,1146,2214,2013
0130-001,2016,8,28,11,1358,1314,2672,2214
0130-001,2016,8,28,12,1529,1408,2937,2672
0130-001,2016,8,28,13,1631,1460,3091,2937
0130-001,2016,8,28,14,1844,1445,3289,3091
0130-001,2016,8,28,15,1775,1483,3258,3289
0130-001,2016,8,28,16,1873,1570,3443,3258
0130-001,2016,8,28,17,1883,1525,3408,3443
0130-001,2016,8,28,18,1687,1681,3368,3408
0130-001,2016,8,28,19,1746,1490,3236,3368
0130-001,2016,8,28,20,1613,1201,2814,3236
0130-001,2016,8,28,21,1306,880,2186,2814
0130-001,2016,8,28,22,1191,653,1844,2186
0130-001,2016,8,28,23,1088,555,1643,1844
0130-001,2016,8,28,24,546,438,984,1643
0130-001,2016,8,29,1,280,256,536,984
0130-001,2016,8,29,2,170,163,333,536
0130-001,2016,8,29,3,140,124,264,333
0130-001,2016,8,29,4,119,200,319,264
0130-001,2016,8,29,5,228,233,461,319
0130-001,2016,8,29,6,674,411,1085,461
0130-001,2016,8,29,7,1761,959,2720,1085
0130-001,2016,8,29,8,1658,1714,3372,2720
0130-001,2016,8,29,9,1877,1961,3838,3372
0130-001,2016,8,29,10,1734,1586,3320,3838
0130-001,2016,8,29,11,1716,1835,3551,3320
0130-001,2016,8,29,12,1661,1722,3383,3551
0130-001,2016,8,29,13,1576,1574,3150,3383
0130-001,2016,8,29,14,1741,1810,3551,3150
0130-001,2016,8,29,15,1750,1836,3586,3551
0130-001,2016,8,29,16,1630,1887,3517,3586
0130-001,2016,8,29,17,1742,2111,3853,3517
0130-001,2016,8,29,18,1573,1598,3171,3853
0130-001,2016,8,29,19,1463,2119,3582,3171
0130-001,2016,8,29,20,1431,2153,3584,3582
0130-001,2016,8,29,21,1226,1821,3047,3584
0130-001,2016,8,29,22,1022,1304,2326,3047
0130-001,2016,8,29,23,783,838,1621,2326
0130-001,2016,8,29,24,486,501,987,1621
0130-001,2016,8,30,1,373,391,764,987
0130-001,2016,8,30,2,233,216,449,764
0130-001,2016,8,30,3,177,177,354,449
0130-001,2016,8,30,4,162,210,372,354
0130-001,2016,8,30,5,207,255,462,372
0130-001,2016,8,30,6,652,475,1127,462
0130-001,2016,8,30,7,1682,926,2608,1127
0130-001,2016,8,30,8,1676,1652,3328,2608
0130-001,2016,8,30,9,1901,1943,3844,3328
0130-001,2016,8,30,10,1654,1708,3362,3844
0130-001,2016,8,30,11,1775,1773,3548,3362
0130-001,2016,8,30,12,1692,1669,3361,3548
0130-001,2016,8,30,13,1546,1597,3143,3361
0130-001,2016,8,30,14,1494,1586,3080,3143
0130-001,2016,8,30,15,1635,1651,3286,3080
0130-001,2016,8,30,16,1612,1696,3308,3286
0130-001,2016,8,30,17,1681,1985,3666,3308
0130-001,2016,8,30,18,1631,2323,3954,3666
0130-001,2016,8,30,19,1653,2584,4237,3954
0130-001,2016,8,30,20,1430,1962,3392,4237
0130-001,2016,8,30,21,1262,1769,3031,3392
0130-001,2016,8,30,22,1068,1357,2425,3031
0130-001,2016,8,30,23,797,851,1648,2425
0130-001,2016,8,30,24,473,471,944,1648
0130-001,2016,8,31,1,282,291,573,944
0130-001,2016,8,31,2,184,191,375,573
0130-001,2016,8,31,3,140,185,325,375
0130-001,2016,8,31,4,123,165,288,325
0130-001,2016,8,31,5,175,221,396,288
0130-001,2016,8,31,6,520,379,899,396
0130-001,2016,8,31,7,1447,807,2254,899
0130-001,2016,8,31,8,1722,1586,3308,2254
0130-001,2016,8,31,9,1713,1906,3619,3308
0130-001,2016,8,31,10,1645,1687,3332,3619
0130-001,2016,8,31,11,1651,1693,3344,3332
0130-001,2016,8,31,12,1575,1644,3219,3344
0130-001,2016,8,31,13,1431,1413,2844,3219
0130-001,2016,8,31,14,1550,1481,3031,2844
0130-001,2016,8,31,15,1534,1511,3045,3031
0130-001,2016,8,31,16,1663,1524,3187,3045
0130-001,2016,8,31,17,1608,1882,3490,3187
0130-001,2016,8,31,18,1698,2395,4093,3490
0130-001,2016,8,31,19,1741,2377,4118,4093
0130-001,2016,8,31,20,1424,1961,3385,4118
0130-001,2016,8,31,21,1201,1614,2815,3385
0130-001,2016,8,31,22,1127,1278,2405,2815
0130-001,2016,8,31,23,898,859,1757,2405
0130-001,2016,8,31,24,614,571,1185,1757
0130-001,2016,9,1,1,411,394,805,1185
0130-001,2016,9,1,2,248,240,488,805
0130-001,2016,9,1,3,163,182,345,488
0130-001,2016,9,1,4,164,207,371,345
0130-001,2016,9,1,5,251,273,524,371
0130-001,2016,9,1,6,616,464,1080,524
0130-001,2016,9,1,7,1634,863,2497,1080
0130-001,2016,9,1,8,1792,1717,3509,2497
0130-001,2016,9,1,9,1878,1953,3831,3509
0130-001,2016,9,1,10,1766,1723,3489,3831
0130-001,2016,9,1,11,1783,1670,3453,3489
0130-001,2016,9,1,12,1731,1685,3416,3453
0130-001,2016,9,1,13,1572,1455,3027,3416
0130-001,2016,9,1,14,1557,1378,2935,3027
0130-001,2016,9,1,15,1549,1428,2977,2935
0130-001,2016,9,1,16,1561,1564,3125,2977
0130-001,2016,9,1,17,1664,2048,3712,3125
0130-001,2016,9,1,18,1793,2326,4119,3712
0130-001,2016,9,1,19,1689,2609,4298,4119
0130-001,2016,9,1,20,1453,2135,3588,4298
0130-001,2016,9,1,21,1281,1785,3066,3588
0130-001,2016,9,1,22,1110,1281,2391,3066
0130-001,2016,9,1,23,846,897,1743,2391
0130-001,2016,9,1,24,646,584,1230,1743
0130-001,2016,9,2,1,408,403,811,1230
0130-001,2016,9,2,2,206,234,440,811
0130-001,2016,9,2,3,128,170,298,440
0130-001,2016,9,2,4,150,195,345,298
0130-001,2016,9,2,5,224,244,468,345
0130-001,2016,9,2,6,626,475,1101,468
0130-001,2016,9,2,7,1723,876,2599,1101
0130-001,2016,9,2,8,1742,1672,3414,2599
0130-001,2016,9,2,9,1824,1936,3760,3414
0130-001,2016,9,2,10,1462,1629,3091,3760
0130-001,2016,9,2,11,1803,1862,3665,3091
0130-001,2016,9,2,12,1735,1687,3422,3665
0130-001,2016,9,2,13,1507,1594,3101,3422
0130-001,2016,9,2,14,1812,1867,3679,3101
0130-001,2016,9,2,15,1782,1899,3681,3679
0130-001,2016,9,2,16,1947,2025,3972,3681
0130-001,2016,9,2,17,1876,2098,3974,3972
0130-001,2016,9,2,18,1809,2508,4317,3974
0130-001,2016,9,2,19,1779,2774,4553,4317
0130-001,2016,9,2,20,1562,2198,3760,4553
0130-001,2016,9,2,21,1393,1923,3316,3760
0130-001,2016,9,2,22,1391,1484,2875,3316
0130-001,2016,9,2,23,987,993,1980,2875
0130-001,2016,9,2,24,602,592,1194,1980
0130-001,2016,9,3,1,531,445,976,1194
0130-001,2016,9,3,2,370,347,717,976
0130-001,2016,9,3,3,289,284,573,717
0130-001,2016,9,3,4,219,266,485,573
0130-001,2016,9,3,5,282,278,560,485
0130-001,2016,9,3,6,594,496,1090,560
0130-001,2016,9,3,7,1232,824,2056,1090
0130-001,2016,9,3,8,1562,1288,2850,2056
0130-001,2016,9,3,9,1699,2059,3758,2850
0130-001,2016,9,3,10,1689,2122,3811,3758
0130-001,2016,9,3,11,1932,2244,4176,3811
0130-001,2016,9,3,12,1814,2399,4213,4176
0130-001,2016,9,3,13,1787,2327,4114,4213
0130-001,2016,9,3,14,1876,2293,4169,4114
0130-001,2016,9,3,15,1808,2097,3905,4169
0130-001,2016,9,3,16,1907,2014,3921,3905
0130-001,2016,9,3,17,1977,1983,3960,3921
0130-001,2016,9,3,18,1916,2186,4102,3960
0130-001,2016,9,3,19,1861,2159,4020,4102
0130-001,2016,9,3,20,1824,1470,3294,4020
0130-001,2016,9,3,21,1587,1361,2948,3294
0130-001,2016,9,3,22,1345,1087,2432,2948
0130-001,2016,9,3,23,783,780,1563,2432
0130-001,2016,9,3,24,596,548,1144,1563
0130-001,2016,9,4,1,417,377,794,1144
0130-001,2016,9,4,2,296,271,567,794
0130-001,2016,9,4,3,242,222,464,567
0130-001,2016,9,4,4,166,180,346,464
0130-001,2016,9,4,5,189,200,389,346
0130-001,2016,9,4,6,427,341,768,389
0130-001,2016,9,4,7,814,621,1435,768
0130-001,2016,9,4,8,938,961,1899,1435
0130-001,2016,9,4,9,1066,1379,2445,1899
0130-001,2016,9,4,10,1142,1272,2414,2445
0130-001,2016,9,4,11,1271,1462,2733,2414
0130-001,2016,9,4,12,1360,1461,2821,2733
0130-001,2016,9,4,13,1472,1518,2990,2821
0130-001,2016,9,4,14,1791,1682,3473,2990
0130-001,2016,9,4,15,1802,1701,3503,3473
0130-001,2016,9,4,16,1845,1758,3603,3503
0130-001,2016,9,4,17,1872,1722,3594,3603
0130-001,2016,9,4,18,1919,1675,3594,3594
0130-001,2016,9,4,19,1873,1507,3380,3594
0130-001,2016,9,4,20,1860,1307,3167,3380
0130-001,2016,9,4,21,1475,1127,2602,3167
0130-001,2016,9,4,22,1167,908,2075,2602
0130-001,2016,9,4,23,722,590,1312,2075
0130-001,2016,9,4,24,460,409,869,1312
0130-001,2016,9,5,1,291,267,558,869
0130-001,2016,9,5,2,178,166,344,558
0130-001,2016,9,5,3,107,137,244,344
0130-001,2016,9,5,4,158,173,331,244
0130-001,2016,9,5,5,231,241,472,331
0130-001,2016,9,5,6,709,473,1182,472
0130-001,2016,9,5,7,1756,989,2745,1182
0130-001,2016,9,5,8,1888,1683,3571,2745
0130-001,2016,9,5,9,1889,2000,3889,3571
0130-001,2016,9,5,10,1703,1691,3394,3889
0130-001,2016,9,5,11,1758,1649,3407,3394
0130-001,2016,9,5,12,1729,1768,3497,3407
0130-001,2016,9,5,13,1545,1624,3169,3497
0130-001,2016,9,5,14,1741,1777,3518,3169
0130-001,2016,9,5,15,1783,1807,3590,3518
0130-001,2016,9,5,16,1743,1842,3585,3590
0130-001,2016,9,5,17,1687,2040,3727,3585
0130-001,2016,9,5,18,1746,2305,4051,3727
0130-001,2016,9,5,19,1740,2570,4310,4051
0130-001,2016,9,5,20,1438,2118,3556,4310
0130-001,2016,9,5,21,1262,1902,3164,3556
0130-001,2016,9,5,22,1086,1504,2590,3164
0130-001,2016,9,5,23,858,823,1681,2590
0130-001,2016,9,5,24,519,532,1051,1681
0130-001,2016,9,6,1,348,342,690,1051
0130-001,2016,9,6,2,233,247,480,690
0130-001,2016,9,6,3,173,157,330,480
0130-001,2016,9,6,4,160,225,385,330
0130-001,2016,9,6,5,227,271,498,385
0130-001,2016,9,6,6,672,461,1133,498
0130-001,2016,9,6,7,1743,943,2686,1133
0130-001,2016,9,6,8,1745,1703,3448,2686
0130-001,2016,9,6,9,1855,1929,3784,3448
0130-001,2016,9,6,10,1738,1771,3509,3784
0130-001,2016,9,6,11,1805,1725,3530,3509
0130-001,2016,9,6,12,1685,1681,3366,3530
0130-001,2016,9,6,13,1569,1660,3229,3366
0130-001,2016,9,6,14,1791,1673,3464,3229
0130-001,2016,9,6,15,1755,1783,3538,3464
0130-001,2016,9,6,16,1739,1923,3662,3538
0130-001,2016,9,6,17,1741,2091,3832,3662
0130-001,2016,9,6,18,1728,2463,4191,3832
0130-001,2016,9,6,19,1694,2550,4244,4191
0130-001,2016,9,6,20,1479,2121,3600,4244
0130-001,2016,9,6,21,1272,1862,3134,3600
0130-001,2016,9,6,22,1081,1464,2545,3134
0130-001,2016,9,6,23,958,864,1822,2545
0130-001,2016,9,6,24,551,562,1113,1822
0130-001,2016,9,7,1,395,367,762,1113
0130-001,2016,9,7,2,241,238,479,762
0130-001,2016,9,7,3,185,175,360,479
0130-001,2016,9,7,4,168,236,404,360
0130-001,2016,9,7,5,232,270,502,404
0130-001,2016,9,7,6,687,468,1155,502
0130-001,2016,9,7,7,1725,949,2674,1155
0130-001,2016,9,7,8,1672,1726,3398,2674
0130-001,2016,9,7,9,1811,1994,3805,3398
0130-001,2016,9,7,10,1815,1773,3588,3805
0130-001,2016,9,7,11,1698,1743,3441,3588
0130-001,2016,9,7,12,1758,1725,3483,3441
0130-001,2016,9,7,13,1599,1643,3242,3483
0130-001,2016,9,7,14,1751,1785,3536,3242
0130-001,2016,9,7,15,1786,1816,3602,3536
0130-001,2016,9,7,16,1749,1836,3585,3602
0130-001,2016,9,7,17,1699,2070,3769,3585
0130-001,2016,9,7,18,1754,2458,4212,3769
0130-001,2016,9,7,19,1652,2567,4219,4212
0130-001,2016,9,7,20,1488,2028,3516,4219
0130-001,2016,9,7,21,1235,1817,3052,3516
0130-001,2016,9,7,22,1171,1323,2494,3052
0130-001,2016,9,7,23,921,889,1810,2494
0130-001,2016,9,7,24,586,560,1146,1810
0130-001,2016,9,8,1,412,426,838,1146
0130-001,2016,9,8,2,250,272,522,838
0130-001,2016,9,8,3,190,224,414,522
0130-001,2016,9,8,4,175,249,424,414
0130-001,2016,9,8,5,243,291,534,424
0130-001,2016,9,8,6,645,464,1109,534
0130-001,2016,9,8,7,1716,934,2650,1109
0130-001,2016,9,8,8,1824,1700,3524,2650
0130-001,2016,9,8,9,1890,1954,3844,3524
0130-001,2016,9,8,10,1790,1710,3500,3844
0130-001,2016,9,8,11,1788,1754,3542,3500
0130-001,2016,9,8,12,1693,1844,3537,3542
0130-001,2016,9,8,13,1604,1737,3341,3537
0130-001,2016,9,8,14,1746,1646,3392,3341
0130-001,2016,9,8,15,1774,1882,3656,3392
0130-001,2016,9,8,16,1763,2106,3869,3656
0130-001,2016,9,8,17,1816,2243,4059,3869
0130-001,2016,9,8,18,1759,2539,4298,4059
0130-001,2016,9,8,19,1819,2611,4430,4298
0130-001,2016,9,8,20,1450,2130,3580,4430
0130-001,2016,9,8,21,1312,1810,3122,3580
0130-001,2016,9,8,22,1237,1507,2744,3122
0130-001,2016,9,8,23,995,922,1917,2744
0130-001,2016,9,8,24,582,617,1199,1917
0130-001,2016,9,9,1,446,436,882,1199
0130-001,2016,9,9,2,266,214,480,882
0130-001,2016,9,9,3,217,184,401,480
0130-001,2016,9,9,4,184,248,432,401
0130-001,2016,9,9,5,240,315,555,432
0130-001,2016,9,9,6,694,491,1185,555
0130-001,2016,9,9,7,1711,954,2665,1185
0130-001,2016,9,9,8,1827,1693,3520,2665
0130-001,2016,9,9,9,1929,1985,3914,3520
0130-001,2016,9,9,10,1835,1736,3571,3914
0130-001,2016,9,9,11,1798,1844,3642,3571
0130-001,2016,9,9,12,1810,1804,3614,3642
0130-001,2016,9,9,13,1542,1721,3263,3614
0130-001,2016,9,9,14,1861,1817,3678,3263
0130-001,2016,9,9,15,1761,1947,3708,3678
0130-001,2016,9,9,16,1834,2086,3920,3708
0130-001,2016,9,9,17,1858,2193,4051,3920
0130-001,2016,9,9,18,1880,2532,4412,4051
0130-001,2016,9,9,19,1785,2635,4420,4412
0130-001,2016,9,9,20,1641,2351,3992,4420
0130-001,2016,9,9,21,1485,1979,3464,3992
0130-001,2016,9,9,22,1406,1507,2913,3464
0130-001,2016,9,9,23,1152,1012,2164,2913
0130-001,2016,9,9,24,719,696,1415,2164
0130-001,2016,9,10,1,534,524,1058,1415
0130-001,2016,9,10,2,341,340,681,1058
0130-001,2016,9,10,3,300,272,572,681
0130-001,2016,9,10,4,271,277,548,572
0130-001,2016,9,10,5,286,339,625,548
0130-001,2016,9,10,6,642,479,1121,625
0130-001,2016,9,10,7,1276,875,2151,1121
0130-001,2016,9,10,8,1659,1251,2910,2151
0130-001,2016,9,10,9,1815,1826,3641,2910
0130-001,2016,9,10,10,1768,1866,3634,3641
0130-001,2016,9,10,11,1835,2049,3884,3634
0130-001,2016,9,10,12,1831,2017,3848,3884
0130-001,2016,9,10,13,1723,1896,3619,3848
0130-001,2016,9,10,14,1785,2028,3813,3619
0130-001,2016,9,10,15,1767,1983,3750,3813
0130-001,2016,9,10,16,1868,2059,3927,3750
0130-001,2016,9,10,17,1876,2054,3930,3927
0130-001,2016,9,10,18,1835,2353,4188,3930
0130-001,2016,9,10,19,1762,2247,4009,4188
0130-001,2016,9,10,20,1556,1632,3188,4009
0130-001,2016,9,10,21,1358,1349,2707,3188
0130-001,2016,9,10,22,1306,1027,2333,2707
0130-001,2016,9,10,23,879,752,1631,2333
0130-001,2016,9,10,24,601,563,1164,1631
0130-001,2016,9,11,1,433,390,823,1164
0130-001,2016,9,11,2,338,266,604,823
0130-001,2016,9,11,3,241,251,492,604
0130-001,2016,9,11,4,219,208,427,492
0130-001,2016,9,11,5,223,177,400,427
0130-001,2016,9,11,6,488,374,862,400
0130-001,2016,9,11,7,800,563,1363,862
0130-001,2016,9,11,8,1057,751,1808,1363
0130-001,2016,9,11,9,988,1001,1989,1808
0130-001,2016,9,11,10,1101,1144,2245,1989
0130-001,2016,9,11,11,1339,1367,2706,2245
0130-001,2016,9,11,12,1371,1372,2743,2706
0130-001,2016,9,11,13,1465,1627,3092,2743
0130-001,2016,9,11,14,1572,1541,3113,3092
0130-001,2016,9,11,15,1590,1613,3203,3113
0130-001,2016,9,11,16,1655,1749,3404,3203
0130-001,2016,9,11,17,1531,1708,3239,3404
0130-001,2016,9,11,18,1539,1866,3405,3239
0130-001,2016,9,11,19,1428,1586,3014,3405
0130-001,2016,9,11,20,1229,1321,2550,3014
0130-001,2016,9,11,21,1116,1060,2176,2550
0130-001,2016,9,11,22,858,834,1692,2176
0130-001,2016,9,11,23,639,578,1217,1692
0130-001,2016,9,11,24,449,397,846,1217
0130-001,2016,9,12,1,286,265,551,846
0130-001,2016,9,12,2,166,180,346,551
0130-001,2016,9,12,3,151,147,298,346
0130-001,2016,9,12,4,135,167,302,298
0130-001,2016,9,12,5,212,256,468,302
0130-001,2016,9,12,6,656,491,1147,468
0130-001,2016,9,12,7,1742,987,2729,1147
0130-001,2016,9,12,8,1831,1744,3575,2729
0130-001,2016,9,12,9,1941,1983,3924,3575
0130-001,2016,9,12,10,1838,1829,3667,3924
0130-001,2016,9,12,11,1898,1920,3818,3667
0130-001,2016,9,12,12,1805,1984,3789,3818
0130-001,2016,9,12,13,1750,1836,3586,3789
0130-001,2016,9,12,14,1826,1788,3614,3586
0130-001,2016,9,12,15,1804,1897,3701,3614
0130-001,2016,9,12,16,1848,2203,4051,3701
0130-001,2016,9,12,17,1849,2186,4035,4051
0130-001,2016,9,12,18,1877,2516,4393,4035
0130-001,2016,9,12,19,1771,2659,4430,4393
0130-001,2016,9,12,20,1571,2281,3852,4430
0130-001,2016,9,12,21,1411,1948,3359,3852
0130-001,2016,9,12,22,1373,1542,2915,3359
0130-001,2016,9,12,23,937,927,1864,2915
0130-001,2016,9,12,24,617,615,1232,1864
0130-001,2016,9,13,1,449,406,855,1232
0130-001,2016,9,13,2,268,276,544,855
0130-001,2016,9,13,3,202,226,428,544
0130-001,2016,9,13,4,203,249,452,428
0130-001,2016,9,13,5,257,275,532,452
0130-001,2016,9,13,6,537,466,1003,532
0130-001,2016,9,13,7,1555,819,2374,1003
0130-001,2016,9,13,8,1856,1692,3548,2374
0130-001,2016,9,13,9,1941,2024,3965,3548
0130-001,2016,9,13,10,1716,1719,3435,3965
0130-001,2016,9,13,11,1923,1989,3912,3435
0130-001,2016,9,13,12,1842,2015,3857,3912
0130-001,2016,9,13,13,1684,1993,3677,3857
0130-001,2016,9,13,14,1847,2226,4073,3677
0130-001,2016,9,13,15,1886,2384,4270,4073
0130-001,2016,9,13,16,1976,2391,4367,4270
0130-001,2016,9,13,17,1850,2596,4446,4367
0130-001,2016,9,13,18,1880,2628,4508,4446
0130-001,2016,9,13,19,1600,2691,4291,4508
0130-001,2016,9,13,20,1363,2439,3802,4291
0130-001,2016,9,13,21,1194,2336,3530,3802
0130-001,2016,9,13,22,1122,1765,2887,3530
0130-001,2016,9,13,23,872,1322,2194,2887
0130-001,2016,9,13,24,643,960,1603,2194
0130-001,2016,9,14,1,429,916,1345,1603
0130-001,2016,9,14,2,332,1028,1360,1345
0130-001,2016,9,14,3,276,1020,1296,1360
0130-001,2016,9,14,4,251,1374,1625,1296
0130-001,2016,9,14,5,256,1548,1804,1625
0130-001,2016,9,14,6,344,1684,2028,1804
0130-001,2016,9,14,7,611,1927,2538,2028
0130-001,2016,9,14,8,762,1861,2623,2538
0130-001,2016,9,14,9,977,2109,3086,2623
0130-001,2016,9,14,10,1279,2188,3467,3086
0130-001,2016,9,14,11,1501,2454,3955,3467
0130-001,2016,9,14,12,1849,2204,4053,3955
0130-001,2016,9,14,13,1610,2283,3893,4053
0130-001,2016,9,14,14,1815,2243,4058,3893
0130-001,2016,9,14,15,1469,2121,3590,4058
0130-001,2016,9,14,16,1317,1879,3196,3590
0130-001,2016,9,14,17,1249,1731,2980,3196
0130-001,2016,9,14,18,1239,1547,2786,2980
0130-001,2016,9,14,19,1122,1384,2506,2786
0130-001,2016,9,14,20,906,1031,1937,2506
0130-001,2016,9,14,21,754,922,1676,1937
0130-001,2016,9,14,22,665,664,1329,1676
0130-001,2016,9,14,23,493,470,963,1329
0130-001,2016,9,14,24,366,333,699,963
0130-001,2016,9,15,1,291,260,551,699
0130-001,2016,9,15,2,193,165,358,551
0130-001,2016,9,15,3,119,108,227,358
0130-001,2016,9,15,4,111,85,196,227
0130-001,2016,9,15,5,102,116,218,196
0130-001,2016,9,15,6,214,200,414,218
0130-001,2016,9,15,7,635,546,1181,414
0130-001,2016,9,15,8,1112,1023,2135,1181
0130-001,2016,9,15,9,870,1050,1920,2135
0130-001,2016,9,15,10,874,1380,2254,1920
0130-001,2016,9,15,11,1478,1994,3472,2254
0130-001,2016,9,15,12,1829,2156,3985,3472
0130-001,2016,9,15,13,1707,2155,3862,3985
0130-001,2016,9,15,14,1773,2284,4057,3862
0130-001,2016,9,15,15,2107,2470,4577,4057
0130-001,2016,9,15,16,2162,2619,4781,4577
0130-001,2016,9,15,17,2262,2643,4905,4781
0130-001,2016,9,15,18,2305,2604,4909,4905
0130-001,2016,9,15,19,2038,2468,4506,4909
0130-001,2016,9,15,20,1758,1244,3002,4506
0130-001,2016,9,15,21,1631,951,2582,3002
0130-001,2016,9,15,22,1167,799,1966,2582
0130-001,2016,9,15,23,976,563,1539,1966
0130-001,2016,9,15,24,654,430,1084,1539
0130-001,2016,9,16,1,480,272,752,1084
0130-001,2016,9,16,2,297,192,489,752
0130-001,2016,9,16,3,190,117,307,489
0130-001,2016,9,16,4,166,110,276,307
0130-001,2016,9,16,5,181,108,289,276
0130-001,2016,9,16,6,225,187,412,289
0130-001,2016,9,16,7,379,274,653,412
0130-001,2016,9,16,8,552,390,942,653
0130-001,2016,9,16,9,714,549,1263,942
0130-001,2016,9,16,10,1071,759,1830,1263
0130-001,2016,9,16,11,1597,1002,2599,1830
0130-001,2016,9,16,12,1889,1262,3151,2599
0130-001,2016,9,16,13,1783,1247,3030,3151
0130-001,2016,9,16,14,1931,1252,3183,3030
0130-001,2016,9,16,15,1854,1378,3232,3183
0130-001,2016,9,16,16,1737,1212,2949,3232
0130-001,2016,9,16,17,1836,1227,3063,2949
0130-001,2016,9,16,18,1695,1071,2766,3063
0130-001,2016,9,16,19,1726,1095,2821,2766
0130-001,2016,9,16,20,1829,1036,2865,2821
0130-001,2016,9,16,21,1866,802,2668,2865
0130-001,2016,9,16,22,1699,647,2346,2668
0130-001,2016,9,16,23,1596,528,2124,2346
0130-001,2016,9,16,24,1564,392,1956,2124
0130-001,2016,9,17,1,1016,304,1320,1956
0130-001,2016,9,17,2,512,197,709,1320
0130-001,2016,9,17,3,251,162,413,709
0130-001,2016,9,17,4,185,148,333,413
0130-001,2016,9,17,5,192,169,361,333
0130-001,2016,9,17,6,255,226,481,361
0130-001,2016,9,17,7,426,330,756,481
0130-001,2016,9,17,8,654,524,1178,756
0130-001,2016,9,17,9,784,740,1524,1178
0130-001,2016,9,17,10,984,1041,2025,1524
0130-001,2016,9,17,11,1223,1161,2384,2025
0130-001,2016,9,17,12,1552,1353,2905,2384
0130-001,2016,9,17,13,1837,1436,3273,2905
0130-001,2016,9,17,14,1841,1447,3288,3273
0130-001,2016,9,17,15,1851,1399,3250,3288
0130-001,2016,9,17,16,1887,1444,3331,3250
0130-001,2016,9,17,17,1720,1249,2969,3331
0130-001,2016,9,17,18,1941,1403,3344,2969
0130-001,2016,9,17,19,1917,1312,3229,3344
0130-001,2016,9,17,20,1431,976,2407,3229
0130-001,2016,9,17,21,1372,931,2303,2407
0130-001,2016,9,17,22,1033,735,1768,2303
0130-001,2016,9,17,23,647,567,1214,1768
0130-001,2016,9,17,24,523,460,983,1214
0130-001,2016,9,18,1,407,365,772,983
0130-001,2016,9,18,2,287,264,551,772
0130-001,2016,9,18,3,232,203,435,551
0130-001,2016,9,18,4,210,177,387,435
0130-001,2016,9,18,5,181,148,329,387
0130-001,2016,9,18,6,293,200,493,329
0130-001,2016,9,18,7,495,386,881,493
0130-001,2016,9,18,8,623,523,1146,881
0130-001,2016,9,18,9,791,714,1505,1146
0130-001,2016,9,18,10,837,873,1710,1505
0130-001,2016,9,18,11,1074,1143,2217,1710
0130-001,2016,9,18,12,1100,1173,2273,2217
0130-001,2016,9,18,13,1307,1352,2659,2273
0130-001,2016,9,18,14,1387,1424,2811,2659
0130-001,2016,9,18,15,1442,1576,3018,2811
0130-001,2016,9,18,16,1475,1497,2972,3018
0130-001,2016,9,18,17,1531,1585,3116,2972
0130-001,2016,9,18,18,1480,1509,2989,3116
0130-001,2016,9,18,19,1270,1385,2655,2989
0130-001,2016,9,18,20,1152,1104,2256,2655
0130-001,2016,9,18,21,1044,880,1924,2256
0130-001,2016,9,18,22,929,694,1623,1924
0130-001,2016,9,18,23,615,526,1141,1623
0130-001,2016,9,18,24,443,327,770,1141
0130-001,2016,9,19,1,290,249,539,770
0130-001,2016,9,19,2,179,177,356,539
0130-001,2016,9,19,3,156,154,310,356
0130-001,2016,9,19,4,136,173,309,310
0130-001,2016,9,19,5,189,224,413,309
0130-001,2016,9,19,6,706,448,1154,413
0130-001,2016,9,19,7,1702,990,2692,1154
0130-001,2016,9,19,8,1712,1707,3419,2692
0130-001,2016,9,19,9,1908,1883,3791,3419
0130-001,2016,9,19,10,1620,1704,3324,3791
0130-001,2016,9,19,11,1734,1694,3428,3324
0130-001,2016,9,19,12,1634,1604,3238,3428
0130-001,2016,9,19,13,1571,1529,3100,3238
0130-001,2016,9,19,14,1705,1642,3347,3100
0130-001,2016,9,19,15,1763,1811,3574,3347
0130-001,2016,9,19,16,1806,1808,3614,3574
0130-001,2016,9,19,17,1682,1974,3656,3614
0130-001,2016,9,19,18,1752,2358,4110,3656
0130-001,2016,9,19,19,1627,2520,4147,4110
0130-001,2016,9,19,20,1410,2013,3423,4147
0130-001,2016,9,19,21,1220,1747,2967,3423
0130-001,2016,9,19,22,1065,1280,2345,2967
0130-001,2016,9,19,23,772,773,1545,2345
0130-001,2016,9,19,24,496,470,966,1545
0130-001,2016,9,20,1,336,347,683,966
0130-001,2016,9,20,2,210,220,430,683
0130-001,2016,9,20,3,151,163,314,430
0130-001,2016,9,20,4,148,202,350,314
0130-001,2016,9,20,5,235,282,517,350
0130-001,2016,9,20,6,650,442,1092,517
0130-001,2016,9,20,7,1634,912,2546,1092
0130-001,2016,9,20,8,1702,1719,3421,2546
0130-001,2016,9,20,9,1837,1967,3804,3421
0130-001,2016,9,20,10,1844,1737,3581,3804
0130-001,2016,9,20,11,1734,1698,3432,3581
0130-001,2016,9,20,12,1599,1556,3155,3432
0130-001,2016,9,20,13,1531,1524,3055,3155
0130-001,2016,9,20,14,1774,1763,3537,3055
0130-001,2016,9,20,15,1723,1772,3495,3537
0130-001,2016,9,20,16,1747,1884,3631,3495
0130-001,2016,9,20,17,1775,2079,3854,3631
0130-001,2016,9,20,18,1790,2357,4147,3854
0130-001,2016,9,20,19,1669,2590,4259,4147
0130-001,2016,9,20,20,1427,2069,3496,4259
0130-001,2016,9,20,21,1223,1789,3012,3496
0130-001,2016,9,20,22,1158,1336,2494,3012
0130-001,2016,9,20,23,840,904,1744,2494
0130-001,2016,9,20,24,519,530,1049,1744
0130-001,2016,9,21,1,348,329,677,1049
0130-001,2016,9,21,2,254,230,484,677
0130-001,2016,9,21,3,179,182,361,484
0130-001,2016,9,21,4,161,197,358,361
0130-001,2016,9,21,5,233,281,514,358
0130-001,2016,9,21,6,657,467,1124,514
0130-001,2016,9,21,7,1704,917,2621,1124
0130-001,2016,9,21,8,1714,1724,3438,2621
0130-001,2016,9,21,9,1883,1913,3796,3438
0130-001,2016,9,21,10,1757,1723,3480,3796
0130-001,2016,9,21,11,1801,1656,3457,3480
0130-001,2016,9,21,12,1605,1675,3280,3457
0130-001,2016,9,21,13,1576,1544,3120,3280
0130-001,2016,9,21,14,1769,1685,3454,3120
0130-001,2016,9,21,15,1800,1796,3596,3454
0130-001,2016,9,21,16,1772,1883,3655,3596
0130-001,2016,9,21,17,1708,2046,3754,3655
0130-001,2016,9,21,18,1873,2429,4302,3754
0130-001,2016,9,21,19,1682,2640,4322,4302
0130-001,2016,9,21,20,1314,2186,3500,4322
0130-001,2016,9,21,21,1229,1700,2929,3500
0130-001,2016,9,21,22,1206,1246,2452,2929
0130-001,2016,9,21,23,878,808,1686,2452
0130-001,2016,9,21,24,562,590,1152,1686
0130-001,2016,9,22,1,388,391,779,1152
0130-001,2016,9,22,2,238,221,459,779
0130-001,2016,9,22,3,172,215,387,459
0130-001,2016,9,22,4,173,213,386,387
0130-001,2016,9,22,5,242,257,499,386
0130-001,2016,9,22,6,662,469,1131,499
0130-001,2016,9,22,7,1683,923,2606,1131
0130-001,2016,9,22,8,1748,1681,3429,2606
0130-001,2016,9,22,9,1826,2025,3851,3429
0130-001,2016,9,22,10,1778,1753,3531,3851
0130-001,2016,9,22,11,1704,1720,3424,3531
0130-001,2016,9,22,12,1614,1790,3404,3424
0130-001,2016,9,22,13,1546,1700,3246,3404
0130-001,2016,9,22,14,1776,1714,3490,3246
0130-001,2016,9,22,15,1856,1785,3641,3490
0130-001,2016,9,22,16,1741,1841,3582,3641
0130-001,2016,9,22,17,1709,2066,3775,3582
0130-001,2016,9,22,18,1830,2363,4193,3775
0130-001,2016,9,22,19,1599,2499,4098,4193
0130-001,2016,9,22,20,1428,2054,3482,4098
0130-001,2016,9,22,21,1247,1789,3036,3482
0130-001,2016,9,22,22,1177,1365,2542,3036
0130-001,2016,9,22,23,848,913,1761,2542
0130-001,2016,9,22,24,569,538,1107,1761
0130-001,2016,9,23,1,393,399,792,1107
0130-001,2016,9,23,2,286,257,543,792
0130-001,2016,9,23,3,172,215,387,543
0130-001,2016,9,23,4,167,228,395,387
0130-001,2016,9,23,5,260,276,536,395
0130-001,2016,9,23,6,670,461,1131,536
0130-001,2016,9,23,7,1726,930,2656,1131
0130-001,2016,9,23,8,1814,1711,3525,2656
0130-001,2016,9,23,9,1869,1946,3815,3525
0130-001,2016,9,23,10,1709,1632,3341,3815
0130-001,2016,9,23,11,1813,1605,3418,3341
0130-001,2016,9,23,12,1663,1694,3357,3418
0130-001,2016,9,23,13,1546,1588,3134,3357
0130-001,2016,9,23,14,1773,1679,3452,3134
0130-001,2016,9,23,15,1792,1729,3521,3452
0130-001,2016,9,23,16,1716,1697,3413,3521
0130-001,2016,9,23,17,1679,2051,3730,3413
0130-001,2016,9,23,18,1808,2474,4282,3730
0130-001,2016,9,23,19,1736,2615,4351,4282
0130-001,2016,9,23,20,1484,2165,3649,4351
0130-001,2016,9,23,21,1320,1763,3083,3649
0130-001,2016,9,23,22,1315,1333,2648,3083
0130-001,2016,9,23,23,899,888,1787,2648
0130-001,2016,9,23,24,629,610,1239,1787
0130-001,2016,9,24,1,532,445,977,1239
0130-001,2016,9,24,2,369,337,706,977
0130-001,2016,9,24,3,260,261,521,706
0130-001,2016,9,24,4,237,273,510,521
0130-001,2016,9,24,5,276,305,581,510
0130-001,2016,9,24,6,644,452,1096,581
0130-001,2016,9,24,7,1207,799,2006,1096
0130-001,2016,9,24,8,1651,1236,2887,2006
0130-001,2016,9,24,9,1631,1825,3456,2887
0130-001,2016,9,24,10,1782,1900,3682,3456
0130-001,2016,9,24,11,1816,2144,3960,3682
0130-001,2016,9,24,12,1758,2410,4168,3960
0130-001,2016,9,24,13,1760,2197,3957,4168
0130-001,2016,9,24,14,1839,1952,3791,3957
0130-001,2016,9,24,15,1746,1945,3691,3791
0130-001,2016,9,24,16,1843,1925,3768,3691
0130-001,2016,9,24,17,1828,2008,3836,3768
0130-001,2016,9,24,18,1932,2362,4294,3836
0130-001,2016,9,24,19,1819,2242,4061,4294
0130-001,2016,9,24,20,1596,1568,3164,4061
0130-001,2016,9,24,21,1221,1157,2378,3164
0130-001,2016,9,24,22,1262,942,2204,2378
0130-001,2016,9,24,23,862,751,1613,2204
0130-001,2016,9,24,24,553,569,1122,1613
0130-001,2016,9,25,1,421,408,829,1122
0130-001,2016,9,25,2,324,282,606,829
0130-001,2016,9,25,3,271,235,506,606
0130-001,2016,9,25,4,220,205,425,506
0130-001,2016,9,25,5,239,197,436,425
0130-001,2016,9,25,6,413,309,722,436
0130-001,2016,9,25,7,693,535,1228,722
0130-001,2016,9,25,8,946,753,1699,1228
0130-001,2016,9,25,9,1072,1085,2157,1699
0130-001,2016,9,25,10,1145,1182,2327,2157
0130-001,2016,9,25,11,1328,1285,2613,2327
0130-001,2016,9,25,12,1235,1352,2587,2613
0130-001,2016,9,25,13,1340,1424,2764,2587
0130-001,2016,9,25,14,1419,1422,2841,2764
0130-001,2016,9,25,15,1340,1483,2823,2841
0130-001,2016,9,25,16,1323,1563,2886,2823
0130-001,2016,9,25,17,1380,1679,3059,2886
0130-001,2016,9,25,18,1576,1774,3350,3059
0130-001,2016,9,25,19,1442,1528,2970,3350
0130-001,2016,9,25,20,1494,1231,2725,2970
0130-001,2016,9,25,21,1258,1071,2329,2725
0130-001,2016,9,25,22,991,839,1830,2329
0130-001,2016,9,25,23,673,593,1266,1830
0130-001,2016,9,25,24,450,360,810,1266
0130-001,2016,9,26,1,255,286,541,810
0130-001,2016,9,26,2,172,147,319,541
0130-001,2016,9,26,3,149,136,285,319
0130-001,2016,9,26,4,152,178,330,285
0130-001,2016,9,26,5,246,262,508,330
0130-001,2016,9,26,6,714,482,1196,508
0130-001,2016,9,26,7,1743,959,2702,1196
0130-001,2016,9,26,8,1822,1720,3542,2702
0130-001,2016,9,26,9,1833,1961,3794,3542
0130-001,2016,9,26,10,1725,1670,3395,3794
0130-001,2016,9,26,11,1594,1682,3276,3395
0130-001,2016,9,26,12,1307,1657,2964,3276
0130-001,2016,9,26,13,1526,1522,3048,2964
0130-001,2016,9,26,14,1563,1723,3286,3048
0130-001,2016,9,26,15,1598,1805,3403,3286
0130-001,2016,9,26,16,1764,1918,3682,3403
0130-001,2016,9,26,17,1746,2109,3855,3682
0130-001,2016,9,26,18,1728,2338,4066,3855
0130-001,2016,9,26,19,1662,2546,4208,4066
0130-001,2016,9,26,20,1385,2003,3388,4208
0130-001,2016,9,26,21,1174,1796,2970,3388
0130-001,2016,9,26,22,1103,1343,2446,2970
0130-001,2016,9,26,23,820,823,1643,2446
0130-001,2016,9,26,24,498,479,977,1643
0130-001,2016,9,27,1,365,384,749,977
0130-001,2016,9,27,2,228,198,426,749
0130-001,2016,9,27,3,178,199,377,426
0130-001,2016,9,27,4,158,214,372,377
0130-001,2016,9,27,5,267,274,541,372
0130-001,2016,9,27,6,595,479,1074,541
0130-001,2016,9,27,7,1629,888,2517,1074
0130-001,2016,9,27,8,1791,1710,3501,2517
0130-001,2016,9,27,9,1823,1932,3755,3501
0130-001,2016,9,27,10,1728,1692,3420,3755
0130-001,2016,9,27,11,1508,1388,2896,3420
0130-001,2016,9,27,12,1363,1162,2525,2896
0130-001,2016,9,27,13,1229,1029,2258,2525
0130-001,2016,9,27,14,1564,1349,2913,2258
0130-001,2016,9,27,15,1564,1608,3172,2913
0130-001,2016,9,27,16,1778,1806,3584,3172
0130-001,2016,9,27,17,1696,1912,3608,3584
0130-001,2016,9,27,18,1692,2264,3956,3608
0130-001,2016,9,27,19,1626,2438,4064,3956
0130-001,2016,9,27,20,1346,1986,3332,4064
0130-001,2016,9,27,21,1219,1687,2906,3332
0130-001,2016,9,27,22,1189,1262,2451,2906
0130-001,2016,9,27,23,797,810,1607,2451
0130-001,2016,9,27,24,472,497,969,1607
0130-001,2016,9,28,1,264,324,588,969
0130-001,2016,9,28,2,166,195,361,588
0130-001,2016,9,28,3,161,177,338,361
0130-001,2016,9,28,4,182,211,393,338
0130-001,2016,9,28,5,232,279,511,393
0130-001,2016,9,28,6,700,454,1154,511
0130-001,2016,9,28,7,1699,942,2641,1154
0130-001,2016,9,28,8,1763,1715,3478,2641
0130-001,2016,9,28,9,1888,2018,3906,3478
0130-001,2016,9,28,10,1730,1705,3435,3906
0130-001,2016,9,28,11,1743,1712,3455,3435
0130-001,2016,9,28,12,1609,1651,3260,3455
0130-001,2016,9,28,13,1464,1618,3082,3260
0130-001,2016,9,28,14,1736,1770,3506,3082
0130-001,2016,9,28,15,1753,1825,3578,3506
0130-001,2016,9,28,16,1825,1892,3717,3578
0130-001,2016,9,28,17,1740,1988,3728,3717
0130-001,2016,9,28,18,1786,2484,4270,3728
0130-001,2016,9,28,19,1638,2528,4166,4270
0130-001,2016,9,28,20,1353,2013,3366,4166
0130-001,2016,9,28,21,1293,1597,2890,3366
0130-001,2016,9,28,22,1202,1174,2376,2890
0130-001,2016,9,28,23,934,867,1801,2376
0130-001,2016,9,28,24,639,574,1213,1801
0130-001,2016,9,29,1,421,457,878,1213
0130-001,2016,9,29,2,264,234,498,878
0130-001,2016,9,29,3,184,210,394,498
0130-001,2016,9,29,4,167,221,388,394
0130-001,2016,9,29,5,238,246,484,388
0130-001,2016,9,29,6,678,457,1135,484
0130-001,2016,9,29,7,1685,923,2608,1135
0130-001,2016,9,29,8,1782,1716,3498,2608
0130-001,2016,9,29,9,1861,1946,3807,3498
0130-001,2016,9,29,10,1772,1704,3476,3807
0130-001,2016,9,29,11,1738,1685,3423,3476
0130-001,2016,9,29,12,1627,1686,3313,3423
0130-001,2016,9,29,13,1508,1555,3063,3313
0130-001,2016,9,29,14,1791,1698,3489,3063
0130-001,2016,9,29,15,1790,1741,3531,3489
0130-001,2016,9,29,16,1810,1796,3606,3531
0130-001,2016,9,29,17,1708,2025,3733,3606
0130-001,2016,9,29,18,1797,2436,4233,3733
0130-001,2016,9,29,19,1695,2516,4211,4233
0130-001,2016,9,29,20,1379,1963,3342,4211
0130-001,2016,9,29,21,1245,1725,2970,3342
0130-001,2016,9,29,22,1237,1448,2685,2970
0130-001,2016,9,29,23,926,933,1859,2685
0130-001,2016,9,29,24,584,623,1207,1859
0130-001,2016,9,30,1,403,407,810,1207
0130-001,2016,9,30,2,241,234,475,810
0130-001,2016,9,30,3,206,197,403,475
0130-001,2016,9,30,4,168,217,385,403
0130-001,2016,9,30,5,257,278,535,385
0130-001,2016,9,30,6,687,504,1191,535
0130-001,2016,9,30,7,1696,964,2660,1191
0130-001,2016,9,30,8,1727,1665,3392,2660
0130-001,2016,9,30,9,1824,1927,3751,3392
0130-001,2016,9,30,10,1719,1734,3453,3751
0130-001,2016,9,30,11,1757,1690,3447,3453
0130-001,2016,9,30,12,1713,1696,3409,3447
0130-001,2016,9,30,13,1556,1679,3235,3409
0130-001,2016,9,30,14,1872,1778,3650,3235
0130-001,2016,9,30,15,1727,1872,3599,3650
0130-001,2016,9,30,16,1830,1901,3731,3599
0130-001,2016,9,30,17,1858,2071,3929,3731
0130-001,2016,9,30,18,1887,2525,4412,3929
0130-001,2016,9,30,19,1858,2561,4419,4412
0130-001,2016,9,30,20,1496,2273,3769,4419
0130-001,2016,9,30,21,1292,1771,3063,3769
0130-001,2016,9,30,22,1362,1409,2771,3063
0130-001,2016,9,30,23,987,986,1973,2771
0130-001,2016,9,30,24,695,673,1368,1973
0130-001,2016,10,1,1,563,483,1046,1368
0130-001,2016,10,1,2,385,370,755,1046
0130-001,2016,10,1,3,296,286,582,755
0130-001,2016,10,1,4,241,290,531,582
0130-001,2016,10,1,5,287,305,592,531
0130-001,2016,10,1,6,609,453,1062,592
0130-001,2016,10,1,7,1231,766,1997,1062
0130-001,2016,10,1,8,1616,1278,2894,1997
0130-001,2016,10,1,9,1821,1871,3692,2894
0130-001,2016,10,1,10,1791,1903,3694,3692
0130-001,2016,10,1,11,1630,2027,3657,3694
0130-001,2016,10,1,12,1614,2259,3873,3657
0130-001,2016,10,1,13,1709,2364,4073,3873
0130-001,2016,10,1,14,1828,2336,4164,4073
0130-001,2016,10,1,15,1771,2346,4117,4164
0130-001,2016,10,1,16,1878,2319,4197,4117
0130-001,2016,10,1,17,1826,2309,4135,4197
0130-001,2016,10,1,18,1892,2412,4304,4135
0130-001,2016,10,1,19,1789,2226,4015,4304
0130-001,2016,10,1,20,1649,1647,3296,4015
0130-001,2016,10,1,21,1292,1283,2575,3296
0130-001,2016,10,1,22,1324,1000,2324,2575
0130-001,2016,10,1,23,885,688,1573,2324
0130-001,2016,10,1,24,538,473,1011,1573
0130-001,2016,10,2,1,428,417,845,1011
0130-001,2016,10,2,2,296,281,577,845
0130-001,2016,10,2,3,255,216,471,577
0130-001,2016,10,2,4,208,208,416,471
0130-001,2016,10,2,5,215,173,388,416
0130-001,2016,10,2,6,308,258,566,388
0130-001,2016,10,2,7,578,423,1001,566
0130-001,2016,10,2,8,689,663,1352,1001
0130-001,2016,10,2,9,862,974,1836,1352
0130-001,2016,10,2,10,1027,1147,2174,1836
0130-001,2016,10,2,11,1216,1416,2632,2174
0130-001,2016,10,2,12,1299,1398,2697,2632
0130-001,2016,10,2,13,1339,1557,2896,2697
0130-001,2016,10,2,14,1268,1168,2436,2896
0130-001,2016,10,2,15,1457,1565,3022,2436
0130-001,2016,10,2,16,1621,1581,3202,3022
0130-001,2016,10,2,17,1634,1519,3153,3202
0130-001,2016,10,2,18,1762,1577,3339,3153
0130-001,2016,10,2,19,1658,1371,3029,3339
0130-001,2016,10,2,20,1433,1123,2556,3029
0130-001,2016,10,2,21,1135,927,2062,2556
0130-001,2016,10,2,22,877,726,1603,2062
0130-001,2016,10,2,23,589,468,1057,1603
0130-001,2016,10,2,24,366,338,704,1057
0130-001,2016,10,3,1,297,246,543,704
0130-001,2016,10,3,2,145,197,342,543
0130-001,2016,10,3,3,146,129,275,342
0130-001,2016,10,3,4,156,165,321,275
0130-001,2016,10,3,5,212,229,441,321
0130-001,2016,10,3,6,470,348,818,441
0130-001,2016,10,3,7,793,485,1278,818
0130-001,2016,10,3,8,890,605,1495,1278
0130-001,2016,10,3,9,1071,905,1976,1495
0130-001,2016,10,3,10,1121,943,2064,1976
0130-001,2016,10,3,11,1311,1330,2641,2064
0130-001,2016,10,3,12,1416,1645,3061,2641
0130-001,2016,10,3,13,1488,1572,3060,3061
0130-001,2016,10,3,14,1599,1720,3319,3060
0130-001,2016,10,3,15,1715,1704,3419,3319
0130-001,2016,10,3,16,1794,1726,3520,3419
0130-001,2016,10,3,17,1789,1731,3520,3520
0130-001,2016,10,3,18,1751,2065,3816,3520
0130-001,2016,10,3,19,1585,1844,3429,3816
0130-001,2016,10,3,20,1490,1414,2904,3429
0130-001,2016,10,3,21,1143,1184,2327,2904
0130-001,2016,10,3,22,973,877,1850,2327
0130-001,2016,10,3,23,756,621,1377,1850
0130-001,2016,10,3,24,490,395,885,1377
0130-001,2016,10,4,1,317,286,603,885
0130-001,2016,10,4,2,172,185,357,603
0130-001,2016,10,4,3,161,163,324,357
0130-001,2016,10,4,4,133,158,291,324
0130-001,2016,10,4,5,226,215,441,291
0130-001,2016,10,4,6,658,480,1138,441
0130-001,2016,10,4,7,1692,970,2662,1138
0130-001,2016,10,4,8,1681,1744,3425,2662
0130-001,2016,10,4,9,1827,1978,3805,3425
0130-001,2016,10,4,10,1839,1743,3582,3805
0130-001,2016,10,4,11,1823,1708,3531,3582
0130-001,2016,10,4,12,1712,1703,3415,3531
0130-001,2016,10,4,13,1545,1555,3100,3415
0130-001,2016,10,4,14,1815,1739,3554,3100
0130-001,2016,10,4,15,1840,1809,3649,3554
0130-001,2016,10,4,16,1810,1955,3765,3649
0130-001,2016,10,4,17,1707,2047,3754,3765
0130-001,2016,10,4,18,1808,2450,4258,3754
0130-001,2016,10,4,19,1739,2559,4298,4258
0130-001,2016,10,4,20,1357,2151,3508,4298
0130-001,2016,10,4,21,1173,1802,2975,3508
0130-001,2016,10,4,22,1119,1279,2398,2975
0130-001,2016,10,4,23,787,889,1676,2398
0130-001,2016,10,4,24,522,525,1047,1676
0130-001,2016,10,5,1,361,366,727,1047
0130-001,2016,10,5,2,213,222,435,727
0130-001,2016,10,5,3,147,192,339,435
0130-001,2016,10,5,4,200,183,383,339
0130-001,2016,10,5,5,220,246,466,383
0130-001,2016,10,5,6,507,377,884,466
0130-001,2016,10,5,7,1482,843,2325,884
0130-001,2016,10,5,8,1422,1383,2805,2325
0130-001,2016,10,5,9,1496,1618,3114,2805
0130-001,2016,10,5,10,1410,1203,2613,3114
0130-001,2016,10,5,11,1540,1380,2920,2613
0130-001,2016,10,5,12,1602,1561,3163,2920
0130-001,2016,10,5,13,1467,1539,3006,3163
0130-001,2016,10,5,14,1734,1624,3358,3006
0130-001,2016,10,5,15,1850,1809,3659,3358
0130-001,2016,10,5,16,1790,1858,3648,3659
0130-001,2016,10,5,17,1614,2067,3681,3648
0130-001,2016,10,5,18,1741,2451,4192,3681
0130-001,2016,10,5,19,1654,2523,4177,4192
0130-001,2016,10,5,20,1349,1924,3273,4177
0130-001,2016,10,5,21,1242,1694,2936,3273
0130-001,2016,10,5,22,1143,1269,2412,2936
0130-001,2016,10,5,23,849,855,1704,2412
0130-001,2016,10,5,24,625,619,1244,1704
0130-001,2016,10,6,1,391,353,744,1244
0130-001,2016,10,6,2,247,262,509,744
0130-001,2016,10,6,3,183,195,378,509
0130-001,2016,10,6,4,154,185,339,378
0130-001,2016,10,6,5,249,260,509,339
0130-001,2016,10,6,6,646,460,1106,509
0130-001,2016,10,6,7,1642,963,2605,1106
0130-001,2016,10,6,8,1781,1677,3458,2605
0130-001,2016,10,6,9,1879,1981,3860,3458
0130-001,2016,10,6,10,1730,1717,3447,3860
0130-001,2016,10,6,11,1838,1767,3605,3447
0130-001,2016,10,6,12,1616,1763,3379,3605
0130-001,2016,10,6,13,1559,1714,3273,3379
0130-001,2016,10,6,14,1827,1788,3615,3273
0130-001,2016,10,6,15,1748,1757,3505,3615
0130-001,2016,10,6,16,1780,1804,3584,3505
0130-001,2016,10,6,17,1723,2044,3767,3584
0130-001,2016,10,6,18,1845,2414,4259,3767
0130-001,2016,10,6,19,1670,2525,4195,4259
0130-001,2016,10,6,20,1401,1988,3389,4195
0130-001,2016,10,6,21,1209,1784,2993,3389
0130-001,2016,10,6,22,1177,1387,2564,2993
0130-001,2016,10,6,23,875,897,1772,2564
0130-001,2016,10,6,24,573,622,1195,1772
0130-001,2016,10,7,1,417,376,793,1195
0130-001,2016,10,7,2,246,279,525,793
0130-001,2016,10,7,3,205,213,418,525
0130-001,2016,10,7,4,184,226,410,418
0130-001,2016,10,7,5,266,268,534,410
0130-001,2016,10,7,6,660,491,1151,534
0130-001,2016,10,7,7,1722,986,2708,1151
0130-001,2016,10,7,8,1706,1714,3420,2708
0130-001,2016,10,7,9,1889,1984,3873,3420
0130-001,2016,10,7,10,1728,1669,3397,3873
0130-001,2016,10,7,11,1752,1734,3486,3397
0130-001,2016,10,7,12,1678,1797,3475,3486
0130-001,2016,10,7,13,1538,1693,3231,3475
0130-001,2016,10,7,14,1831,1838,3669,3231
0130-001,2016,10,7,15,1745,1831,3576,3669
0130-001,2016,10,7,16,1770,1998,3768,3576
0130-001,2016,10,7,17,1770,2124,3894,3768
0130-001,2016,10,7,18,1431,1479,2910,3894
0130-001,2016,10,7,19,1278,1345,2623,2910
0130-001,2016,10,7,20,1212,1331,2543,2623
0130-001,2016,10,7,21,1083,1328,2411,2543
0130-001,2016,10,7,22,1321,1383,2704,2411
0130-001,2016,10,7,23,972,880,1852,2704
0130-001,2016,10,7,24,660,629,1289,1852
0130-001,2016,10,8,1,478,439,917,1289
0130-001,2016,10,8,2,330,309,639,917
0130-001,2016,10,8,3,232,246,478,639
0130-001,2016,10,8,4,206,260,466,478
0130-001,2016,10,8,5,255,273,528,466
0130-001,2016,10,8,6,532,428,960,528
0130-001,2016,10,8,7,972,660,1632,960
0130-001,2016,10,8,8,1550,1108,2658,1632
0130-001,2016,10,8,9,1598,1717,3315,2658
0130-001,2016,10,8,10,1691,1801,3492,3315
0130-001,2016,10,8,11,1867,2090,3957,3492
0130-001,2016,10,8,12,1655,1849,3504,3957
0130-001,2016,10,8,13,1862,2104,3966,3504
0130-001,2016,10,8,14,1831,2124,3955,3966
0130-001,2016,10,8,15,1843,1942,3785,3955
0130-001,2016,10,8,16,1752,1914,3666,3785
0130-001,2016,10,8,17,1900,2003,3903,3666
0130-001,2016,10,8,18,1879,2373,4252,3903
0130-001,2016,10,8,19,1808,2221,4029,4252
0130-001,2016,10,8,20,1699,1630,3329,4029
0130-001,2016,10,8,21,1208,1212,2420,3329
0130-001,2016,10,8,22,1030,994,2024,2420
0130-001,2016,10,8,23,856,679,1535,2024
0130-001,2016,10,8,24,610,553,1163,1535
0130-001,2016,10,9,1,449,451,900,1163
0130-001,2016,10,9,2,365,294,659,900
0130-001,2016,10,9,3,266,239,505,659
0130-001,2016,10,9,4,198,180,378,505
0130-001,2016,10,9,5,247,182,429,378
0130-001,2016,10,9,6,444,316,760,429
0130-001,2016,10,9,7,691,511,1202,760
0130-001,2016,10,9,8,943,845,1788,1202
0130-001,2016,10,9,9,1099,1199,2298,1788
0130-001,2016,10,9,10,1181,1218,2399,2298
0130-001,2016,10,9,11,1560,1377,2937,2399
0130-001,2016,10,9,12,1374,1463,2837,2937
0130-001,2016,10,9,13,1422,1428,2850,2837
0130-001,2016,10,9,14,1527,1606,3133,2850
0130-001,2016,10,9,15,1645,1645,3290,3133
0130-001,2016,10,9,16,1694,1639,3333,3290
0130-001,2016,10,9,17,1740,1730,3470,3333
0130-001,2016,10,9,18,1700,1917,3617,3470
0130-001,2016,10,9,19,1732,1605,3337,3617
0130-001,2016,10,9,20,1538,1275,2813,3337
0130-001,2016,10,9,21,1360,1078,2438,2813
0130-001,2016,10,9,22,1007,790,1797,2438
0130-001,2016,10,9,23,708,637,1345,1797
0130-001,2016,10,9,24,445,373,818,1345
0130-001,2016,10,10,1,241,258,499,818
0130-001,2016,10,10,2,161,144,305,499
0130-001,2016,10,10,3,153,135,288,305
0130-001,2016,10,10,4,124,147,271,288
0130-001,2016,10,10,5,249,243,492,271
0130-001,2016,10,10,6,731,464,1195,492
0130-001,2016,10,10,7,1763,1037,2800,1195
0130-001,2016,10,10,8,1704,1747,3451,2800
0130-001,2016,10,10,9,1816,2002,3818,3451
0130-001,2016,10,10,10,1710,1717,3427,3818
0130-001,2016,10,10,11,1709,1770,3479,3427
0130-001,2016,10,10,12,1699,1949,3648,3479
0130-001,2016,10,10,13,1601,1772,3373,3648
0130-001,2016,10,10,14,1814,1811,3625,3373
0130-001,2016,10,10,15,1704,1755,3459,3625
0130-001,2016,10,10,16,1843,1931,3774,3459
0130-001,2016,10,10,17,1765,2099,3864,3774
0130-001,2016,10,10,18,1774,2454,4228,3864
0130-001,2016,10,10,19,1647,2442,4089,4228
0130-001,2016,10,10,20,1414,1979,3393,4089
0130-001,2016,10,10,21,1164,1725,2889,3393
0130-001,2016,10,10,22,1117,1360,2477,2889
0130-001,2016,10,10,23,824,805,1629,2477
0130-001,2016,10,10,24,492,479,971,1629
0130-001,2016,10,11,1,331,323,654,971
0130-001,2016,10,11,2,199,212,411,654
0130-001,2016,10,11,3,178,199,377,411
0130-001,2016,10,11,4,177,233,410,377
0130-001,2016,10,11,5,243,265,508,410
0130-001,2016,10,11,6,690,504,1194,508
0130-001,2016,10,11,7,1750,933,2683,1194
0130-001,2016,10,11,8,1757,1683,3440,2683
0130-001,2016,10,11,9,1873,2023,3896,3440
0130-001,2016,10,11,10,1845,1776,3621,3896
0130-001,2016,10,11,11,1793,1707,3500,3621
0130-001,2016,10,11,12,1645,1679,3324,3500
0130-001,2016,10,11,13,1527,1603,3130,3324
0130-001,2016,10,11,14,1874,1808,3682,3130
0130-001,2016,10,11,15,1747,1771,3518,3682
0130-001,2016,10,11,16,1779,1886,3665,3518
0130-001,2016,10,11,17,1723,2079,3802,3665
0130-001,2016,10,11,18,1739,2401,4140,3802
0130-001,2016,10,11,19,1601,2387,3988,4140
0130-001,2016,10,11,20,1363,1958,3321,3988
0130-001,2016,10,11,21,1147,1801,2948,3321
0130-001,2016,10,11,22,1118,1255,2373,2948
0130-001,2016,10,11,23,842,856,1698,2373
0130-001,2016,10,11,24,540,541,1081,1698
0130-001,2016,10,12,1,377,345,722,1081
0130-001,2016,10,12,2,219,234,453,722
0130-001,2016,10,12,3,181,194,375,453
0130-001,2016,10,12,4,158,216,374,375
0130-001,2016,10,12,5,246,254,500,374
0130-001,2016,10,12,6,724,457,1181,500
0130-001,2016,10,12,7,1697,958,2655,1181
0130-001,2016,10,12,8,1716,1743,3459,2655
0130-001,2016,10,12,9,1877,1963,3840,3459
0130-001,2016,10,12,10,1767,1674,3441,3840
0130-001,2016,10,12,11,1777,1800,3577,3441
0130-001,2016,10,12,12,1603,1707,3310,3577
0130-001,2016,10,12,13,1555,1583,3138,3310
0130-001,2016,10,12,14,1852,1756,3608,3138
0130-001,2016,10,12,15,1759,1803,3562,3608
0130-001,2016,10,12,16,1758,1945,3703,3562
0130-001,2016,10,12,17,1696,1992,3688,3703
0130-001,2016,10,12,18,1743,2442,4185,3688
0130-001,2016,10,12,19,1647,2496,4143,4185
0130-001,2016,10,12,20,1328,2089,3417,4143
0130-001,2016,10,12,21,1152,1561,2713,3417
0130-001,2016,10,12,22,1179,1209,2388,2713
0130-001,2016,10,12,23,868,831,1699,2388
0130-001,2016,10,12,24,567,541,1108,1699
0130-001,2016,10,13,1,392,361,753,1108
0130-001,2016,10,13,2,219,235,454,753
0130-001,2016,10,13,3,177,200,377,454
0130-001,2016,10,13,4,166,203,369,377
0130-001,2016,10,13,5,233,254,487,369
0130-001,2016,10,13,6,684,474,1158,487
0130-001,2016,10,13,7,1703,930,2633,1158
0130-001,2016,10,13,8,1739,1680,3419,2633
0130-001,2016,10,13,9,1898,1974,3872,3419
0130-001,2016,10,13,10,1687,1667,3354,3872
0130-001,2016,10,13,11,1711,1712,3423,3354
0130-001,2016,10,13,12,1674,1688,3362,3423
0130-001,2016,10,13,13,1565,1592,3157,3362
0130-001,2016,10,13,14,1845,1787,3632,3157
0130-001,2016,10,13,15,1770,1765,3535,3632
0130-001,2016,10,13,16,1765,1889,3654,3535
0130-001,2016,10,13,17,1665,2064,3729,3654
0130-001,2016,10,13,18,1795,2444,4239,3729
0130-001,2016,10,13,19,1648,2503,4151,4239
0130-001,2016,10,13,20,1310,1937,3247,4151
0130-001,2016,10,13,21,1211,1723,2934,3247
0130-001,2016,10,13,22,1145,1312,2457,2934
0130-001,2016,10,13,23,845,824,1669,2457
0130-001,2016,10,13,24,592,553,1145,1669
0130-001,2016,10,14,1,392,366,758,1145
0130-001,2016,10,14,2,256,257,513,758
0130-001,2016,10,14,3,173,207,380,513
0130-001,2016,10,14,4,181,203,384,380
0130-001,2016,10,14,5,234,268,502,384
0130-001,2016,10,14,6,719,507,1226,502
0130-001,2016,10,14,7,1704,932,2636,1226
0130-001,2016,10,14,8,1735,1676,3411,2636
0130-001,2016,10,14,9,1885,1992,3877,3411
0130-001,2016,10,14,10,1718,1674,3392,3877
0130-001,2016,10,14,11,1752,1655,3407,3392
0130-001,2016,10,14,12,1702,1785,3487,3407
0130-001,2016,10,14,13,1575,1622,3197,3487
0130-001,2016,10,14,14,1831,1906,3737,3197
0130-001,2016,10,14,15,1783,1919,3702,3737
0130-001,2016,10,14,16,1816,1914,3730,3702
0130-001,2016,10,14,17,1700,2185,3885,3730
0130-001,2016,10,14,18,1774,2379,4153,3885
0130-001,2016,10,14,19,1714,2389,4103,4153
0130-001,2016,10,14,20,1528,1807,3335,4103
0130-001,2016,10,14,21,1324,2088,3412,3335
0130-001,2016,10,14,22,1282,1301,2583,3412
0130-001,2016,10,14,23,968,855,1823,2583
0130-001,2016,10,14,24,643,608,1251,1823
0130-001,2016,10,15,1,497,427,924,1251
0130-001,2016,10,15,2,335,306,641,924
0130-001,2016,10,15,3,259,240,499,641
0130-001,2016,10,15,4,222,272,494,499
0130-001,2016,10,15,5,284,281,565,494
0130-001,2016,10,15,6,612,462,1074,565
0130-001,2016,10,15,7,1207,820,2027,1074
0130-001,2016,10,15,8,1665,1237,2902,2027
0130-001,2016,10,15,9,1805,1809,3614,2902
0130-001,2016,10,15,10,1907,1942,3849,3614
0130-001,2016,10,15,11,1839,2030,3869,3849
0130-001,2016,10,15,12,1730,2307,4037,3869
0130-001,2016,10,15,13,1824,2427,4251,4037
0130-001,2016,10,15,14,1808,2387,4195,4251
0130-001,2016,10,15,15,1974,2230,4204,4195
0130-001,2016,10,15,16,1888,2237,4125,4204
0130-001,2016,10,15,17,1889,2199,4088,4125
0130-001,2016,10,15,18,1715,2224,3939,4088
0130-001,2016,10,15,19,1927,2140,4067,3939
0130-001,2016,10,15,20,1900,1516,3416,4067
0130-001,2016,10,15,21,1584,1243,2827,3416
0130-001,2016,10,15,22,1248,1086,2334,2827
0130-001,2016,10,15,23,812,755,1567,2334
0130-001,2016,10,15,24,550,533,1083,1567
0130-001,2016,10,16,1,464,422,886,1083
0130-001,2016,10,16,2,339,278,617,886
0130-001,2016,10,16,3,251,233,484,617
0130-001,2016,10,16,4,231,213,444,484
0130-001,2016,10,16,5,206,192,398,444
0130-001,2016,10,16,6,347,277,624,398
0130-001,2016,10,16,7,633,428,1061,624
0130-001,2016,10,16,8,787,702,1489,1061
0130-001,2016,10,16,9,980,1046,2026,1489
0130-001,2016,10,16,10,1087,1272,2359,2026
0130-001,2016,10,16,11,1398,1561,2959,2359
0130-001,2016,10,16,12,1332,1595,2927,2959
0130-001,2016,10,16,13,1479,1647,3126,2927
0130-001,2016,10,16,14,1624,1673,3297,3126
0130-001,2016,10,16,15,1785,1664,3449,3297
0130-001,2016,10,16,16,1802,1713,3515,3449
0130-001,2016,10,16,17,1871,1655,3526,3515
0130-001,2016,10,16,18,1673,1525,3198,3526
0130-001,2016,10,16,19,1319,972,2291,3198
0130-001,2016,10,16,20,1352,748,2100,2291
0130-001,2016,10,16,21,1080,704,1784,2100
0130-001,2016,10,16,22,858,577,1435,1784
0130-001,2016,10,16,23,598,453,1051,1435
0130-001,2016,10,16,24,379,317,696,1051
0130-001,2016,10,17,1,219,236,455,696
0130-001,2016,10,17,2,153,158,311,455
0130-001,2016,10,17,3,102,113,215,311
0130-001,2016,10,17,4,92,154,246,215
0130-001,2016,10,17,5,171,206,377,246
0130-001,2016,10,17,6,512,387,899,377
0130-001,2016,10,17,7,1603,853,2456,899
0130-001,2016,10,17,8,1380,1176,2556,2456
0130-001,2016,10,17,9,1597,1704,3301,2556
0130-001,2016,10,17,10,1765,1591,3356,3301
0130-001,2016,10,17,11,1626,1671,3297,3356
0130-001,2016,10,17,12,1641,1677,3318,3297
0130-001,2016,10,17,13,1469,1547,3016,3318
0130-001,2016,10,17,14,1727,1773,3500,3016
0130-001,2016,10,17,15,1633,1728,3361,3500
0130-001,2016,10,17,16,1614,1792,3406,3361
0130-001,2016,10,17,17,1658,2031,3689,3406
0130-001,2016,10,17,18,1637,2386,4023,3689
0130-001,2016,10,17,19,1702,2471,4173,4023
0130-001,2016,10,17,20,1319,1912,3231,4173
0130-001,2016,10,17,21,1172,1793,2965,3231
0130-001,2016,10,17,22,1062,1342,2404,2965
0130-001,2016,10,17,23,843,844,1687,2404
0130-001,2016,10,17,24,499,496,995,1687
0130-001,2016,10,18,1,348,328,676,995
0130-001,2016,10,18,2,195,248,443,676
0130-001,2016,10,18,3,163,160,323,443
0130-001,2016,10,18,4,148,209,357,323
0130-001,2016,10,18,5,231,259,490,357
0130-001,2016,10,18,6,683,466,1149,490
0130-001,2016,10,18,7,1651,906,2557,1149
0130-001,2016,10,18,8,1818,1632,3450,2557
0130-001,2016,10,18,9,1793,2028,3821,3450
0130-001,2016,10,18,10,1726,1714,3440,3821
0130-001,2016,10,18,11,1641,1636,3277,3440
0130-001,2016,10,18,12,1647,1588,3235,3277
0130-001,2016,10,18,13,1518,1607,3125,3235
0130-001,2016,10,18,14,1763,1668,3431,3125
0130-001,2016,10,18,15,1737,1790,3527,3431
0130-001,2016,10,18,16,1670,1839,3509,3527
0130-001,2016,10,18,17,1592,2039,3631,3509
0130-001,2016,10,18,18,1774,2391,4165,3631
0130-001,2016,10,18,19,1626,2400,4026,4165
0130-001,2016,10,18,20,1357,1947,3304,4026
0130-001,2016,10,18,21,1207,1795,3002,3304
0130-001,2016,10,18,22,1094,1343,2437,3002
0130-001,2016,10,18,23,818,880,1698,2437
0130-001,2016,10,18,24,540,549,1089,1698
0130-001,2016,10,19,1,369,357,726,1089
0130-001,2016,10,19,2,229,238,467,726
0130-001,2016,10,19,3,184,181,365,467
0130-001,2016,10,19,4,163,203,366,365
0130-001,2016,10,19,5,241,270,511,366
0130-001,2016,10,19,6,658,455,1113,511
0130-001,2016,10,19,7,1633,929,2562,1113
0130-001,2016,10,19,8,1752,1700,3452,2562
0130-001,2016,10,19,9,1916,1905,3821,3452
0130-001,2016,10,19,10,1686,1744,3430,3821
0130-001,2016,10,19,11,1679,1774,3453,3430
0130-001,2016,10,19,12,1594,1702,3296,3453
0130-001,2016,10,19,13,1611,1619,3230,3296
0130-001,2016,10,19,14,1723,1791,3514,3230
0130-001,2016,10,19,15,1749,1816,3565,3514
0130-001,2016,10,19,16,1690,1776,3466,3565
0130-001,2016,10,19,17,1633,2098,3731,3466
0130-001,2016,10,19,18,1663,2520,4183,3731
0130-001,2016,10,19,19,1606,2549,4155,4183
0130-001,2016,10,19,20,1349,2059,3408,4155
0130-001,2016,10,19,21,1163,1665,2828,3408
0130-001,2016,10,19,22,1164,1350,2514,2828
0130-001,2016,10,19,23,869,878,1747,2514
0130-001,2016,10,19,24,580,574,1154,1747
0130-001,2016,10,20,1,415,385,800,1154
0130-001,2016,10,20,2,263,254,517,800
0130-001,2016,10,20,3,173,193,366,517
0130-001,2016,10,20,4,170,209,379,366
0130-001,2016,10,20,5,225,244,469,379
0130-001,2016,10,20,6,681,448,1129,469
0130-001,2016,10,20,7,1634,898,2532,1129
0130-001,2016,10,20,8,1784,1645,3429,2532
0130-001,2016,10,20,9,1868,2010,3878,3429
0130-001,2016,10,20,10,1749,1699,3448,3878
0130-001,2016,10,20,11,1764,1724,3488,3448
0130-001,2016,10,20,12,1689,1697,3386,3488
0130-001,2016,10,20,13,1471,1553,3024,3386
0130-001,2016,10,20,14,1761,1733,3494,3024
0130-001,2016,10,20,15,1758,1815,3573,3494
0130-001,2016,10,20,16,1811,1896,3707,3573
0130-001,2016,10,20,17,1679,1985,3664,3707
0130-001,2016,10,20,18,1827,2376,4203,3664
0130-001,2016,10,20,19,1801,2433,4234,4203
0130-001,2016,10,20,20,1428,1965,3393,4234
0130-001,2016,10,20,21,1218,1710,2928,3393
0130-001,2016,10,20,22,1099,1369,2468,2928
0130-001,2016,10,20,23,909,939,1848,2468
0130-001,2016,10,20,24,595,549,1144,1848
0130-001,2016,10,21,1,403,357,760,1144
0130-001,2016,10,21,2,244,274,518,760
0130-001,2016,10,21,3,195,217,412,518
0130-001,2016,10,21,4,206,237,443,412
0130-001,2016,10,21,5,255,278,533,443
0130-001,2016,10,21,6,633,439,1072,533
0130-001,2016,10,21,7,1696,887,2583,1072
0130-001,2016,10,21,8,1742,1639,3381,2583
0130-001,2016,10,21,9,1906,2000,3906,3381
0130-001,2016,10,21,10,1777,1691,3468,3906
0130-001,2016,10,21,11,1782,1737,3519,3468
0130-001,2016,10,21,12,1763,1732,3495,3519
0130-001,2016,10,21,13,1656,1634,3290,3495
0130-001,2016,10,21,14,1784,1777,3561,3290
0130-001,2016,10,21,15,1737,1800,3537,3561
0130-001,2016,10,21,16,1754,1946,3700,3537
0130-001,2016,10,21,17,1767,2129,3896,3700
0130-001,2016,10,21,18,1772,2221,3993,3896
0130-001,2016,10,21,19,1669,2297,3966,3993
0130-001,2016,10,21,20,1540,2315,3855,3966
0130-001,2016,10,21,21,1361,1920,3281,3855
0130-001,2016,10,21,22,1243,1304,2547,3281
0130-001,2016,10,21,23,985,925,1910,2547
0130-001,2016,10,21,24,654,625,1279,1910
0130-001,2016,10,22,1,489,442,931,1279
0130-001,2016,10,22,2,379,329,708,931
0130-001,2016,10,22,3,269,238,507,708
0130-001,2016,10,22,4,240,299,539,507
0130-001,2016,10,22,5,283,303,586,539
0130-001,2016,10,22,6,577,446,1023,586
0130-001,2016,10,22,7,1225,802,2027,1023
0130-001,2016,10,22,8,1539,1242,2781,2027
0130-001,2016,10,22,9,1676,1714,3390,2781
0130-001,2016,10,22,10,1678,1843,3521,3390
0130-001,2016,10,22,11,1772,1974,3746,3521
0130-001,2016,10,22,12,1746,2019,3765,3746
0130-001,2016,10,22,13,1786,2105,3891,3765
0130-001,2016,10,22,14,1736,2045,3781,3891
0130-001,2016,10,22,15,1727,2001,3728,3781
0130-001,2016,10,22,16,1856,1892,3748,3728
0130-001,2016,10,22,17,1674,2021,3695,3748
0130-001,2016,10,22,18,1830,2228,4058,3695
0130-001,2016,10,22,19,1876,2103,3979,4058
0130-001,2016,10,22,20,1613,1433,3046,3979
0130-001,2016,10,22,21,1270,1208,2478,3046
0130-001,2016,10,22,22,1137,994,2131,2478
0130-001,2016,10,22,23,816,750,1566,2131
0130-001,2016,10,22,24,598,535,1133,1566
0130-001,2016,10,23,1,437,422,859,1133
0130-001,2016,10,23,2,318,268,586,859
0130-001,2016,10,23,3,262,228,490,586
0130-001,2016,10,23,4,200,151,351,490
0130-001,2016,10,23,5,245,203,448,351
0130-001,2016,10,23,6,380,293,673,448
0130-001,2016,10,23,7,720,482,1202,673
0130-001,2016,10,23,8,831,681,1512,1202
0130-001,2016,10,23,9,1061,1072,2133,1512
0130-001,2016,10,23,10,1064,1129,2193,2133
0130-001,2016,10,23,11,1364,1367,2731,2193
0130-001,2016,10,23,12,1189,1288,2477,2731
0130-001,2016,10,23,13,1336,1362,2698,2477
0130-001,2016,10,23,14,1431,1503,2934,2698
0130-001,2016,10,23,15,1712,1584,3296,2934
0130-001,2016,10,23,16,1615,1652,3267,3296
0130-001,2016,10,23,17,1833,1591,3424,3267
0130-001,2016,10,23,18,1786,1553,3339,3424
0130-001,2016,10,23,19,1616,1292,2908,3339
0130-001,2016,10,23,20,1632,1031,2663,2908
0130-001,2016,10,23,21,1263,898,2161,2663
0130-001,2016,10,23,22,1261,800,2061,2161
0130-001,2016,10,23,23,766,633,1399,2061
0130-001,2016,10,23,24,460,345,805,1399
0130-001,2016,10,24,1,258,270,528,805
0130-001,2016,10,24,2,169,151,320,528
0130-001,2016,10,24,3,136,123,259,320
0130-001,2016,10,24,4,121,166,287,259
0130-001,2016,10,24,5,242,222,464,287
0130-001,2016,10,24,6,717,449,1166,464
0130-001,2016,10,24,7,1804,949,2753,1166
0130-001,2016,10,24,8,1858,1690,3548,2753
0130-001,2016,10,24,9,1768,2008,3776,3548
0130-001,2016,10,24,10,1721,1694,3415,3776
0130-001,2016,10,24,11,1775,1675,3450,3415
0130-001,2016,10,24,12,1639,1725,3364,3450
0130-001,2016,10,24,13,1519,1675,3194,3364
0130-001,2016,10,24,14,1773,1796,3569,3194
0130-001,2016,10,24,15,1756,1802,3558,3569
0130-001,2016,10,24,16,1782,1842,3624,3558
0130-001,2016,10,24,17,1698,2042,3740,3624
0130-001,2016,10,24,18,1771,2374,4145,3740
0130-001,2016,10,24,19,1639,2506,4145,4145
0130-001,2016,10,24,20,1356,2040,3396,4145
0130-001,2016,10,24,21,1193,1765,2958,3396
0130-001,2016,10,24,22,1108,1310,2418,2958
0130-001,2016,10,24,23,829,836,1665,2418
0130-001,2016,10,24,24,559,579,1138,1665
0130-001,2016,10,25,1,359,340,699,1138
0130-001,2016,10,25,2,216,255,471,699
0130-001,2016,10,25,3,169,149,318,471
0130-001,2016,10,25,4,158,211,369,318
0130-001,2016,10,25,5,222,234,456,369
0130-001,2016,10,25,6,524,427,951,456
0130-001,2016,10,25,7,1488,770,2258,951
0130-001,2016,10,25,8,1675,1553,3228,2258
0130-001,2016,10,25,9,1763,1949,3712,3228
0130-001,2016,10,25,10,1701,1683,3384,3712
0130-001,2016,10,25,11,1652,1686,3338,3384
0130-001,2016,10,25,12,1608,1623,3231,3338
0130-001,2016,10,25,13,1499,1556,3055,3231
0130-001,2016,10,25,14,1780,1691,3471,3055
0130-001,2016,10,25,15,1743,1775,3518,3471
0130-001,2016,10,25,16,1734,1826,3560,3518
0130-001,2016,10,25,17,1658,1921,3579,3560
0130-001,2016,10,25,18,1645,2211,3856,3579
0130-001,2016,10,25,19,1631,2399,4030,3856
0130-001,2016,10,25,20,1304,1980,3284,4030
0130-001,2016,10,25,21,1197,1724,2921,3284
0130-001,2016,10,25,22,1118,1342,2460,2921
0130-001,2016,10,25,23,846,808,1654,2460
0130-001,2016,10,25,24,584,563,1147,1654
0130-001,2016,10,26,1,397,372,769,1147
0130-001,2016,10,26,2,212,266,478,769
0130-001,2016,10,26,3,192,196,388,478
0130-001,2016,10,26,4,173,200,373,388
0130-001,2016,10,26,5,232,245,477,373
0130-001,2016,10,26,6,672,446,1118,477
0130-001,2016,10,26,7,1600,903,2503,1118
0130-001,2016,10,26,8,1727,1623,3350,2503
0130-001,2016,10,26,9,1839,1959,3798,3350
0130-001,2016,10,26,10,1689,1707,3396,3798
0130-001,2016,10,26,11,1701,1700,3401,3396
0130-001,2016,10,26,12,1736,1697,3433,3401
0130-001,2016,10,26,13,1563,1564,3127,3433
0130-001,2016,10,26,14,1788,1712,3500,3127
0130-001,2016,10,26,15,1691,1824,3515,3500
0130-001,2016,10,26,16,1738,1845,3583,3515
0130-001,2016,10,26,17,1568,2044,3612,3583
0130-001,2016,10,26,18,1688,2374,4062,3612
0130-001,2016,10,26,19,1619,2387,4006,4062
0130-001,2016,10,26,20,1408,2071,3479,4006
0130-001,2016,10,26,21,1207,1615,2822,3479
0130-001,2016,10,26,22,1160,1228,2388,2822
0130-001,2016,10,26,23,849,801,1650,2388
0130-001,2016,10,26,24,591,583,1174,1650
0130-001,2016,10,27,1,380,368,748,1174
0130-001,2016,10,27,2,223,225,448,748
0130-001,2016,10,27,3,206,184,390,448
0130-001,2016,10,27,4,154,192,346,390
0130-001,2016,10,27,5,231,277,508,346
0130-001,2016,10,27,6,668,454,1122,508
0130-001,2016,10,27,7,1639,907,2546,1122
0130-001,2016,10,27,8,1750,1626,3376,2546
0130-001,2016,10,27,9,1909,1963,3872,3376
0130-001,2016,10,27,10,1673,1710,3383,3872
0130-001,2016,10,27,11,1411,1542,2953,3383
0130-001,2016,10,27,12,1690,1615,3305,2953
0130-001,2016,10,27,13,1481,1526,3007,3305
0130-001,2016,10,27,14,1728,1681,3409,3007
0130-001,2016,10,27,15,1781,1651,3432,3409
0130-001,2016,10,27,16,1707,1772,3479,3432
0130-001,2016,10,27,17,1602,2027,3629,3479
0130-001,2016,10,27,18,1728,2269,3997,3629
0130-001,2016,10,27,19,1557,2438,3995,3997
0130-001,2016,10,27,20,1318,1888,3206,3995
0130-001,2016,10,27,21,1212,1791,3003,3206
0130-001,2016,10,27,22,1163,1487,2650,3003
0130-001,2016,10,27,23,892,909,1801,2650
0130-001,2016,10,27,24,620,581,1201,1801
0130-001,2016,10,28,1,396,371,767,1201
0130-001,2016,10,28,2,249,248,497,767
0130-001,2016,10,28,3,188,208,396,497
0130-001,2016,10,28,4,192,242,434,396
0130-001,2016,10,28,5,255,249,504,434
0130-001,2016,10,28,6,582,424,1006,504
0130-001,2016,10,28,7,1498,811,2309,1006
0130-001,2016,10,28,8,1694,1555,3249,2309
0130-001,2016,10,28,9,1804,1949,3753,3249
0130-001,2016,10,28,10,1679,1556,3235,3753
0130-001,2016,10,28,11,1780,1681,3461,3235
0130-001,2016,10,28,12,1695,1698,3393,3461
0130-001,2016,10,28,13,1484,1550,3034,3393
0130-001,2016,10,28,14,1839,1783,3622,3034
0130-001,2016,10,28,15,1780,1862,3642,3622
0130-001,2016,10,28,16,1738,1814,3552,3642
0130-001,2016,10,28,17,1755,2026,3781,3552
0130-001,2016,10,28,18,1671,2355,4026,3781
0130-001,2016,10,28,19,1628,2555,4183,4026
0130-001,2016,10,28,20,1525,2333,3858,4183
0130-001,2016,10,28,21,1359,1943,3302,3858
0130-001,2016,10,28,22,1334,1561,2895,3302
0130-001,2016,10,28,23,940,919,1859,2895
0130-001,2016,10,28,24,690,668,1358,1859
0130-001,2016,10,29,1,529,456,985,1358
0130-001,2016,10,29,2,336,327,663,985
0130-001,2016,10,29,3,273,234,507,663
0130-001,2016,10,29,4,222,267,489,507
0130-001,2016,10,29,5,260,313,573,489
0130-001,2016,10,29,6,582,446,1028,573
0130-001,2016,10,29,7,1139,820,1959,1028
0130-001,2016,10,29,8,1575,1284,2859,1959
0130-001,2016,10,29,9,1683,1842,3525,2859
0130-001,2016,10,29,10,1752,1861,3613,3525
0130-001,2016,10,29,11,1752,2028,3780,3613
0130-001,2016,10,29,12,1788,2144,3932,3780
0130-001,2016,10,29,13,1720,2289,4009,3932
0130-001,2016,10,29,14,1821,2304,4125,4009
0130-001,2016,10,29,15,1837,2169,4006,4125
0130-001,2016,10,29,16,1829,2057,3886,4006
0130-001,2016,10,29,17,1939,1919,3858,3886
0130-001,2016,10,29,18,1989,2237,4226,3858
0130-001,2016,10,29,19,1933,1942,3875,4226
0130-001,2016,10,29,20,1571,1558,3129,3875
0130-001,2016,10,29,21,1341,1188,2529,3129
0130-001,2016,10,29,22,1197,990,2187,2529
0130-001,2016,10,29,23,787,764,1551,2187
0130-001,2016,10,29,24,556,511,1067,1551
0130-001,2016,10,30,1,419,399,818,1067
0130-001,2016,10,30,2,291,284,575,818
0130-001,2016,10,30,3,229,209,438,575
0130-001,2016,10,30,4,186,173,359,438
0130-001,2016,10,30,5,237,182,419,359
0130-001,2016,10,30,6,368,278,646,419
0130-001,2016,10,30,7,648,435,1083,646
0130-001,2016,10,30,8,809,620,1429,1083
0130-001,2016,10,30,9,985,973,1958,1429
0130-001,2016,10,30,10,1051,1191,2242,1958
0130-001,2016,10,30,11,1297,1388,2685,2242
0130-001,2016,10,30,12,1238,1471,2709,2685
0130-001,2016,10,30,13,1493,1476,2969,2709
0130-001,2016,10,30,14,1659,1575,3234,2969
0130-001,2016,10,30,15,1664,1669,3333,3234
0130-001,2016,10,30,16,1844,1836,3680,3333
0130-001,2016,10,30,17,1974,1697,3671,3680
0130-001,2016,10,30,18,1798,1791,3589,3671
0130-001,2016,10,30,19,1966,1555,3521,3589
0130-001,2016,10,30,20,1775,1217,2992,3521
0130-001,2016,10,30,21,1592,1099,2691,2992
0130-001,2016,10,30,22,1301,873,2174,2691
0130-001,2016,10,30,23,788,603,1391,2174
0130-001,2016,10,30,24,470,417,887,1391
0130-001,2016,10,31,1,298,245,543,887
0130-001,2016,10,31,2,181,156,337,543
0130-001,2016,10,31,3,147,133,280,337
0130-001,2016,10,31,4,131,160,291,280
0130-001,2016,10,31,5,259,235,494,291
0130-001,2016,10,31,6,669,477,1146,494
0130-001,2016,10,31,7,1711,941,2652,1146
0130-001,2016,10,31,8,1774,1623,3397,2652
0130-001,2016,10,31,9,1889,1911,3800,3397
0130-001,2016,10,31,10,1637,1452,3089,3800
0130-001,2016,10,31,11,1631,1667,3298,3089
0130-001,2016,10,31,12,1664,1617,3281,3298
0130-001,2016,10,31,13,1570,1552,3122,3281
0130-001,2016,10,31,14,1739,1616,3355,3122
0130-001,2016,10,31,15,1720,1731,3451,3355
0130-001,2016,10,31,16,1749,1914,3663,3451
0130-001,2016,10,31,17,1660,1898,3558,3663
0130-001,2016,10,31,18,1686,2286,3972,3558
0130-001,2016,10,31,19,1641,2336,3977,3972
0130-001,2016,10,31,20,1390,1909,3299,3977
0130-001,2016,10,31,21,1200,1676,2876,3299
0130-001,2016,10,31,22,1027,1340,2367,2876
0130-001,2016,10,31,23,780,777,1557,2367
0130-001,2016,10,31,24,544,539,1083,1557
0130-001,2016,11,1,1,346,355,701,1083
0130-001,2016,11,1,2,218,200,418,701
0130-001,2016,11,1,3,168,177,345,418
0130-001,2016,11,1,4,146,197,343,345
0130-001,2016,11,1,5,217,259,476,343
0130-001,2016,11,1,6,617,472,1089,476
0130-001,2016,11,1,7,1694,857,2551,1089
0130-001,2016,11,1,8,1735,1602,3337,2551
0130-001,2016,11,1,9,1859,1992,3851,3337
0130-001,2016,11,1,10,1672,1675,3347,3851
0130-001,2016,11,1,11,1823,1628,3451,3347
0130-001,2016,11,1,12,1657,1743,3400,3451
0130-001,2016,11,1,13,1496,1548,3044,3400
0130-001,2016,11,1,14,1748,1698,3446,3044
0130-001,2016,11,1,15,1690,1773,3463,3446
0130-001,2016,11,1,16,1783,1734,3517,3463
0130-001,2016,11,1,17,1648,2034,3682,3517
0130-001,2016,11,1,18,1792,2294,4086,3682
0130-001,2016,11,1,19,1600,2349,3949,4086
0130-001,2016,11,1,20,1369,1896,3265,3949
0130-001,2016,11,1,21,1182,1757,2939,3265
0130-001,2016,11,1,22,1096,1339,2435,2939
0130-001,2016,11,1,23,863,827,1690,2435
0130-001,2016,11,1,24,498,530,1028,1690
0130-001,2016,11,2,1,339,338,677,1028
0130-001,2016,11,2,2,201,220,421,677
0130-001,2016,11,2,3,148,192,340,421
0130-001,2016,11,2,4,158,169,327,340
0130-001,2016,11,2,5,239,229,468,327
0130-001,2016,11,2,6,613,457,1070,468
0130-001,2016,11,2,7,1645,859,2504,1070
0130-001,2016,11,2,8,1774,1608,3382,2504
0130-001,2016,11,2,9,1798,1891,3689,3382
0130-001,2016,11,2,10,1757,1669,3426,3689
0130-001,2016,11,2,11,1663,1708,3371,3426
0130-001,2016,11,2,12,1627,1680,3307,3371
0130-001,2016,11,2,13,1547,1635,3182,3307
0130-001,2016,11,2,14,1682,1635,3317,3182
0130-001,2016,11,2,15,1807,1748,3555,3317
0130-001,2016,11,2,16,1799,1844,3643,3555
0130-001,2016,11,2,17,1755,2042,3797,3643
0130-001,2016,11,2,18,1724,2359,4083,3797
0130-001,2016,11,2,19,1679,2280,3959,4083
0130-001,2016,11,2,20,1425,1842,3267,3959
0130-001,2016,11,2,21,1164,1576,2740,3267
0130-001,2016,11,2,22,1128,1255,2383,2740
0130-001,2016,11,2,23,861,777,1638,2383
0130-001,2016,11,2,24,576,518,1094,1638
0130-001,2016,11,3,1,379,362,741,1094
0130-001,2016,11,3,2,229,230,459,741
0130-001,2016,11,3,3,164,203,367,459
0130-001,2016,11,3,4,155,181,336,367
0130-001,2016,11,3,5,239,252,491,336
0130-001,2016,11,3,6,610,456,1066,491
0130-001,2016,11,3,7,1642,866,2508,1066
0130-001,2016,11,3,8,1773,1626,3399,2508
0130-001,2016,11,3,9,1836,1913,3749,3399
0130-001,2016,11,3,10,1705,1608,3313,3749
0130-001,2016,11,3,11,1693,1660,3353,3313
0130-001,2016,11,3,12,1641,1645,3286,3353
0130-001,2016,11,3,13,1555,1481,3036,3286
0130-001,2016,11,3,14,1727,1677,3404,3036
0130-001,2016,11,3,15,1724,1736,3460,3404
0130-001,2016,11,3,16,1678,1792,3470,3460
0130-001,2016,11,3,17,1703,2012,3715,3470
0130-001,2016,11,3,18,1773,2397,4170,3715
0130-001,2016,11,3,19,1635,2313,3948,4170
0130-001,2016,11,3,20,1397,1877,3274,3948
0130-001,2016,11,3,21,1195,1797,2992,3274
0130-001,2016,11,3,22,1197,1359,2556,2992
0130-001,2016,11,3,23,871,839,1710,2556
0130-001,2016,11,3,24,549,558,1107,1710
0130-001,2016,11,4,1,366,385,751,1107
0130-001,2016,11,4,2,221,202,423,751
0130-001,2016,11,4,3,173,178,351,423
0130-001,2016,11,4,4,141,199,340,351
0130-001,2016,11,4,5,245,268,513,340
0130-001,2016,11,4,6,633,484,1117,513
0130-001,2016,11,4,7,1621,886,2507,1117
0130-001,2016,11,4,8,1868,1579,3447,2507
0130-001,2016,11,4,9,1904,1915,3819,3447
0130-001,2016,11,4,10,1702,1699,3401,3819
0130-001,2016,11,4,11,1680,1741,3421,3401
0130-001,2016,11,4,12,1601,1677,3278,3421
0130-001,2016,11,4,13,1515,1595,3110,3278
0130-001,2016,11,4,14,1677,1697,3374,3110
0130-001,2016,11,4,15,1601,1772,3373,3374
0130-001,2016,11,4,16,1576,1817,3393,3373
0130-001,2016,11,4,17,1585,1992,3577,3393
0130-001,2016,11,4,18,1501,2272,3773,3577
0130-001,2016,11,4,19,1492,2067,3559,3773
0130-001,2016,11,4,20,1484,2015,3499,3559
0130-001,2016,11,4,21,1330,1812,3142,3499
0130-001,2016,11,4,22,1237,1341,2578,3142
0130-001,2016,11,4,23,972,909,1881,2578
0130-001,2016,11,4,24,632,570,1202,1881
0130-001,2016,11,5,1,499,467,966,1202
0130-001,2016,11,5,2,362,320,682,966
0130-001,2016,11,5,3,261,249,510,682
0130-001,2016,11,5,4,211,242,453,510
0130-001,2016,11,5,5,259,282,541,453
0130-001,2016,11,5,6,595,486,1081,541
0130-001,2016,11,5,7,1173,765,1938,1081
0130-001,2016,11,5,8,1616,1233,2849,1938
0130-001,2016,11,5,9,1633,1793,3426,2849
0130-001,2016,11,5,10,1729,1963,3692,3426
0130-001,2016,11,5,11,1646,2083,3729,3692
0130-001,2016,11,5,12,1615,2156,3771,3729
0130-001,2016,11,5,13,1600,2198,3798,3771
0130-001,2016,11,5,14,1689,2179,3868,3798
0130-001,2016,11,5,15,1560,2069,3629,3868
0130-001,2016,11,5,16,1676,1969,3645,3629
0130-001,2016,11,5,17,1624,2087,3711,3645
0130-001,2016,11,5,18,1791,2148,3939,3711
0130-001,2016,11,5,19,1748,1956,3704,3939
0130-001,2016,11,5,20,1659,1551,3210,3704
0130-001,2016,11,5,21,1342,1202,2544,3210
0130-001,2016,11,5,22,1143,983,2126,2544
0130-001,2016,11,5,23,811,698,1509,2126
0130-001,2016,11,5,24,554,527,1081,1509
0130-001,2016,11,6,1,382,369,751,1081
0130-001,2016,11,6,2,303,278,581,751
0130-001,2016,11,6,3,226,214,440,581
0130-001,2016,11,6,4,196,177,373,440
0130-001,2016,11,6,5,207,204,411,373
0130-001,2016,11,6,6,362,295,657,411
0130-001,2016,11,6,7,599,474,1073,657
0130-001,2016,11,6,8,843,684,1527,1073
0130-001,2016,11,6,9,1043,980,2023,1527
0130-001,2016,11,6,10,1256,1260,2516,2023
0130-001,2016,11,6,11,1361,1460,2821,2516
0130-001,2016,11,6,12,1293,1491,2784,2821
0130-001,2016,11,6,13,1419,1519,2938,2784
0130-001,2016,11,6,14,1612,1606,3218,2938
0130-001,2016,11,6,15,1665,1674,3339,3218
0130-001,2016,11,6,16,1651,1606,3257,3339
0130-001,2016,11,6,17,1500,1653,3153,3257
0130-001,2016,11,6,18,1432,1668,3100,3153
0130-001,2016,11,6,19,1471,1520,2991,3100
0130-001,2016,11,6,20,1460,1178,2638,2991
0130-001,2016,11,6,21,1410,992,2402,2638
0130-001,2016,11,6,22,1405,858,2263,2402
0130-001,2016,11,6,23,859,624,1483,2263
0130-001,2016,11,6,24,532,401,933,1483
0130-001,2016,11,7,1,313,265,578,933
0130-001,2016,11,7,2,156,174,330,578
0130-001,2016,11,7,3,128,109,237,330
0130-001,2016,11,7,4,126,163,289,237
0130-001,2016,11,7,5,269,238,507,289
0130-001,2016,11,7,6,669,497,1166,507
0130-001,2016,11,7,7,1631,890,2521,1166
0130-001,2016,11,7,8,1609,1654,3263,2521
0130-001,2016,11,7,9,1649,1903,3552,3263
0130-001,2016,11,7,10,1679,1645,3324,3552
0130-001,2016,11,7,11,1568,1645,3213,3324
0130-001,2016,11,7,12,1559,1622,3181,3213
0130-001,2016,11,7,13,1463,1599,3062,3181
0130-001,2016,11,7,14,1657,1791,3448,3062
0130-001,2016,11,7,15,1634,1874,3508,3448
0130-001,2016,11,7,16,1624,1826,3450,3508
0130-001,2016,11,7,17,1545,1941,3486,3450
0130-001,2016,11,7,18,1584,2312,3896,3486
0130-001,2016,11,7,19,1497,2378,3875,3896
0130-001,2016,11,7,20,1342,1779,3121,3875
0130-001,2016,11,7,21,1120,1739,2859,3121
0130-001,2016,11,7,22,1010,1223,2233,2859
0130-001,2016,11,7,23,767,729,1496,2233
0130-001,2016,11,7,24,503,524,1027,1496
0130-001,2016,11,8,1,319,326,645,1027
0130-001,2016,11,8,2,199,225,424,645
0130-001,2016,11,8,3,148,169,317,424
0130-001,2016,11,8,4,137,188,325,317
0130-001,2016,11,8,5,220,251,471,325
0130-001,2016,11,8,6,597,488,1085,471
0130-001,2016,11,8,7,1552,864,2416,1085
0130-001,2016,11,8,8,1609,1656,3265,2416
0130-001,2016,11,8,9,1623,1852,3475,3265
0130-001,2016,11,8,10,1589,1694,3283,3475
0130-001,2016,11,8,11,1638,1735,3373,3283
0130-001,2016,11,8,12,1477,1783,3260,3373
0130-001,2016,11,8,13,1500,1740,3240,3260
0130-001,2016,11,8,14,1512,1725,3237,3240
0130-001,2016,11,8,15,1366,1746,3112,3237
0130-001,2016,11,8,16,1373,1744,3117,3112
0130-001,2016,11,8,17,1563,1940,3503,3117
0130-001,2016,11,8,18,1668,2355,4023,3503
0130-001,2016,11,8,19,1643,2344,3987,4023
0130-001,2016,11,8,20,1367,1809,3176,3987
0130-001,2016,11,8,21,1192,1732,2924,3176
0130-001,2016,11,8,22,1126,1314,2440,2924
0130-001,2016,11,8,23,819,822,1641,2440
0130-001,2016,11,8,24,516,540,1056,1641
0130-001,2016,11,9,1,350,326,676,1056
0130-001,2016,11,9,2,200,203,403,676
0130-001,2016,11,9,3,150,175,325,403
0130-001,2016,11,9,4,135,194,329,325
0130-001,2016,11,9,5,229,232,461,329
0130-001,2016,11,9,6,604,460,1064,461
0130-001,2016,11,9,7,1571,840,2411,1064
0130-001,2016,11,9,8,1517,1669,3186,2411
0130-001,2016,11,9,9,1680,1875,3555,3186
0130-001,2016,11,9,10,1677,1626,3303,3555
0130-001,2016,11,9,11,1604,1686,3290,3303
0130-001,2016,11,9,12,1558,1645,3203,3290
0130-001,2016,11,9,13,1488,1546,3034,3203
0130-001,2016,11,9,14,1586,1656,3242,3034
0130-001,2016,11,9,15,1536,1467,3003,3242
0130-001,2016,11,9,16,1684,1961,3645,3003
0130-001,2016,11,9,17,1618,1781,3399,3645
0130-001,2016,11,9,18,1781,2366,4147,3399
0130-001,2016,11,9,19,1586,2154,3740,4147
0130-001,2016,11,9,20,1320,1886,3206,3740
0130-001,2016,11,9,21,1173,1574,2747,3206
0130-001,2016,11,9,22,1101,1231,2332,2747
0130-001,2016,11,9,23,921,786,1707,2332
0130-001,2016,11,9,24,574,553,1127,1707
0130-001,2016,11,10,1,367,342,709,1127
0130-001,2016,11,10,2,228,213,441,709
0130-001,2016,11,10,3,147,184,331,441
0130-001,2016,11,10,4,165,194,359,331
0130-001,2016,11,10,5,244,254,498,359
0130-001,2016,11,10,6,631,477,1108,498
0130-001,2016,11,10,7,1533,877,2410,1108
0130-001,2016,11,10,8,1617,1588,3205,2410
0130-001,2016,11,10,9,1774,1966,3740,3205
0130-001,2016,11,10,10,1699,1611,3310,3740
0130-001,2016,11,10,11,1577,1741,3318,3310
0130-001,2016,11,10,12,1607,1726,3333,3318
0130-001,2016,11,10,13,1504,1552,3056,3333
0130-001,2016,11,10,14,1553,1774,3327,3056
0130-001,2016,11,10,15,1455,1757,3212,3327
0130-001,2016,11,10,16,1475,1735,3210,3212
0130-001,2016,11,10,17,1392,1951,3343,3210
0130-001,2016,11,10,18,1372,1849,3221,3343
0130-001,2016,11,10,19,1296,1375,2671,3221
0130-001,2016,11,10,20,1161,1426,2587,2671
0130-001,2016,11,10,21,1108,1601,2709,2587
0130-001,2016,11,10,22,1120,1264,2384,2709
0130-001,2016,11,10,23,816,804,1620,2384
0130-001,2016,11,10,24,477,483,960,1620
0130-001,2016,11,11,1,342,331,673,960
0130-001,2016,11,11,2,262,255,517,673
0130-001,2016,11,11,3,174,191,365,517
0130-001,2016,11,11,4,157,189,346,365
0130-001,2016,11,11,5,226,249,475,346
0130-001,2016,11,11,6,600,464,1064,475
0130-001,2016,11,11,7,1507,831,2338,1064
0130-001,2016,11,11,8,1664,1605,3269,2338
0130-001,2016,11,11,9,1683,1897,3580,3269
0130-001,2016,11,11,10,1555,1697,3252,3580
0130-001,2016,11,11,11,1447,1729,3176,3252
0130-001,2016,11,11,12,1575,1817,3392,3176
0130-001,2016,11,11,13,1474,1646,3120,3392
0130-001,2016,11,11,14,1658,1780,3438,3120
0130-001,2016,11,11,15,1617,1729,3346,3438
0130-001,2016,11,11,16,1682,1968,3650,3346
0130-001,2016,11,11,17,1837,2077,3914,3650
0130-001,2016,11,11,18,1684,2331,4015,3914
0130-001,2016,11,11,19,1621,2026,3647,4015
0130-001,2016,11,11,20,1382,2219,3601,3647
0130-001,2016,11,11,21,1299,1758,3057,3601
0130-001,2016,11,11,22,1314,1373,2687,3057
0130-001,2016,11,11,23,1149,893,2042,2687
0130-001,2016,11,11,24,730,649,1379,2042
0130-001,2016,11,12,1,505,497,1002,1379
0130-001,2016,11,12,2,352,316,668,1002
0130-001,2016,11,12,3,205,228,433,668
0130-001,2016,11,12,4,215,282,497,433
0130-001,2016,11,12,5,275,262,537,497
0130-001,2016,11,12,6,620,474,1094,537
0130-001,2016,11,12,7,1172,763,1935,1094
0130-001,2016,11,12,8,1449,1274,2723,1935
0130-001,2016,11,12,9,1538,1806,3344,2723
0130-001,2016,11,12,10,1711,2012,3723,3344
0130-001,2016,11,12,11,1553,1842,3395,3723
0130-001,2016,11,12,12,1309,1662,2971,3395
0130-001,2016,11,12,13,1763,2229,3992,2971
0130-001,2016,11,12,14,1777,2221,3998,3992
0130-001,2016,11,12,15,1711,2174,3885,3998
0130-001,2016,11,12,16,1896,2208,4104,3885
0130-001,2016,11,12,17,1789,2205,3994,4104
0130-001,2016,11,12,18,1801,2297,4098,3994
0130-001,2016,11,12,19,1764,2028,3792,4098
0130-001,2016,11,12,20,1650,1572,3222,3792
0130-001,2016,11,12,21,1227,1249,2476,3222
0130-001,2016,11,12,22,1034,966,2000,2476
0130-001,2016,11,12,23,864,660,1524,2000
0130-001,2016,11,12,24,570,511,1081,1524
0130-001,2016,11,13,1,424,387,811,1081
0130-001,2016,11,13,2,287,256,543,811
0130-001,2016,11,13,3,249,228,477,543
0130-001,2016,11,13,4,193,167,360,477
0130-001,2016,11,13,5,211,196,407,360
0130-001,2016,11,13,6,360,283,643,407
0130-001,2016,11,13,7,656,446,1102,643
0130-001,2016,11,13,8,852,687,1539,1102
0130-001,2016,11,13,9,1021,978,1999,1539
0130-001,2016,11,13,10,1085,1164,2249,1999
0130-001,2016,11,13,11,1310,1352,2662,2249
0130-001,2016,11,13,12,1300,1314,2614,2662
0130-001,2016,11,13,13,1501,1483,2984,2614
0130-001,2016,11,13,14,1596,1515,3111,2984
0130-001,2016,11,13,15,1746,1663,3409,3111
0130-001,2016,11,13,16,1928,1786,3714,3409
0130-001,2016,11,13,17,1781,1733,3514,3714
0130-001,2016,11,13,18,1800,1811,3611,3514
0130-001,2016,11,13,19,1656,1444,3100,3611
0130-001,2016,11,13,20,1638,1192,2830,3100
0130-001,2016,11,13,21,1378,982,2360,2830
0130-001,2016,11,13,22,1372,846,2218,2360
0130-001,2016,11,13,23,780,643,1423,2218
0130-001,2016,11,13,24,452,384,836,1423
0130-001,2016,11,14,1,291,267,558,836
0130-001,2016,11,14,2,175,153,328,558
0130-001,2016,11,14,3,113,126,239,328
0130-001,2016,11,14,4,129,189,318,239
0130-001,2016,11,14,5,232,215,447,318
0130-001,2016,11,14,6,728,484,1212,447
0130-001,2016,11,14,7,1591,946,2537,1212
0130-001,2016,11,14,8,1744,1672,3416,2537
0130-001,2016,11,14,9,1850,1916,3766,3416
0130-001,2016,11,14,10,1648,1631,3279,3766
0130-001,2016,11,14,11,1650,1679,3329,3279
0130-001,2016,11,14,12,1594,1486,3080,3329
0130-001,2016,11,14,13,1462,1627,3089,3080
0130-001,2016,11,14,14,1663,1720,3383,3089
0130-001,2016,11,14,15,1619,1777,3396,3383
0130-001,2016,11,14,16,1605,1807,3412,3396
0130-001,2016,11,14,17,1588,1992,3580,3412
0130-001,2016,11,14,18,1353,1905,3258,3580
0130-001,2016,11,14,19,1162,1397,2559,3258
0130-001,2016,11,14,20,1069,1332,2401,2559
0130-001,2016,11,14,21,879,1043,1922,2401
0130-001,2016,11,14,22,819,873,1692,1922
0130-001,2016,11,14,23,738,676,1414,1692
0130-001,2016,11,14,24,481,482,963,1414
0130-001,2016,11,15,1,303,313,616,963
0130-001,2016,11,15,2,232,232,464,616
0130-001,2016,11,15,3,142,165,307,464
0130-001,2016,11,15,4,150,202,352,307
0130-001,2016,11,15,5,216,229,445,352
0130-001,2016,11,15,6,672,463,1135,445
0130-001,2016,11,15,7,1615,877,2492,1135
0130-001,2016,11,15,8,1570,1598,3168,2492
0130-001,2016,11,15,9,1611,1951,3562,3168
0130-001,2016,11,15,10,1485,1616,3101,3562
0130-001,2016,11,15,11,1533,1662,3195,3101
0130-001,2016,11,15,12,1509,1564,3073,3195
0130-001,2016,11,15,13,1495,1572,3067,3073
0130-001,2016,11,15,14,1685,1750,3435,3067
0130-001,2016,11,15,15,1575,1756,3331,3435
0130-001,2016,11,15,16,1616,1818,3434,3331
0130-001,2016,11,15,17,1596,2060,3656,3434
0130-001,2016,11,15,18,1611,2312,3923,3656
0130-001,2016,11,15,19,1572,2289,3861,3923
0130-001,2016,11,15,20,1346,1881,3227,3861
0130-001,2016,11,15,21,1209,1683,2892,3227
0130-001,2016,11,15,22,1062,1318,2380,2892
0130-001,2016,11,15,23,936,822,1758,2380
0130-001,2016,11,15,24,528,549,1077,1758
0130-001,2016,11,16,1,355,350,705,1077
0130-001,2016,11,16,2,239,253,492,705
0130-001,2016,11,16,3,153,194,347,492
0130-001,2016,11,16,4,178,223,401,347
0130-001,2016,11,16,5,225,239,464,401
0130-001,2016,11,16,6,642,472,1114,464
0130-001,2016,11,16,7,1636,819,2455,1114
0130-001,2016,11,16,8,1701,1638,3339,2455
0130-001,2016,11,16,9,1740,1940,3680,3339
0130-001,2016,11,16,10,1577,1734,3311,3680
0130-001,2016,11,16,11,1662,1683,3345,3311
0130-001,2016,11,16,12,1633,1671,3304,3345
0130-001,2016,11,16,13,1481,1567,3048,3304
0130-001,2016,11,16,14,1652,1762,3414,3048
0130-001,2016,11,16,15,1669,1817,3486,3414
0130-001,2016,11,16,16,1653,1781,3434,3486
0130-001,2016,11,16,17,1577,2015,3592,3434
0130-001,2016,11,16,18,1661,2303,3964,3592
0130-001,2016,11,16,19,1547,2334,3881,3964
0130-001,2016,11,16,20,1339,1831,3170,3881
0130-001,2016,11,16,21,1133,1561,2694,3170
0130-001,2016,11,16,22,1133,1196,2329,2694
0130-001,2016,11,16,23,865,813,1678,2329
0130-001,2016,11,16,24,519,545,1064,1678
0130-001,2016,11,17,1,375,381,756,1064
0130-001,2016,11,17,2,255,220,475,756
0130-001,2016,11,17,3,172,199,371,475
0130-001,2016,11,17,4,178,234,412,371
0130-001,2016,11,17,5,223,253,476,412
0130-001,2016,11,17,6,630,468,1098,476
0130-001,2016,11,17,7,1652,971,2623,1098
0130-001,2016,11,17,8,1652,1626,3278,2623
0130-001,2016,11,17,9,1770,1802,3572,3278
0130-001,2016,11,17,10,1685,1732,3417,3572
0130-001,2016,11,17,11,1589,1661,3250,3417
0130-001,2016,11,17,12,1527,1672,3199,3250
0130-001,2016,11,17,13,1536,1651,3187,3199
0130-001,2016,11,17,14,1697,1761,3458,3187
0130-001,2016,11,17,15,1660,1818,3478,3458
0130-001,2016,11,17,16,1612,1810,3422,3478
0130-001,2016,11,17,17,1540,2077,3617,3422
0130-001,2016,11,17,18,1636,2203,3839,3617
0130-001,2016,11,17,19,1492,2248,3740,3839
0130-001,2016,11,17,20,1317,1926,3243,3740
0130-001,2016,11,17,21,1192,1585,2777,3243
0130-001,2016,11,17,22,1069,1361,2430,2777
0130-001,2016,11,17,23,855,803,1658,2430
0130-001,2016,11,17,24,532,531,1063,1658
0130-001,2016,11,18,1,390,386,776,1063
0130-001,2016,11,18,2,252,247,499,776
0130-001,2016,11,18,3,196,215,411,499
0130-001,2016,11,18,4,160,204,364,411
0130-001,2016,11,18,5,248,256,504,364
0130-001,2016,11,18,6,639,474,1113,504
0130-001,2016,11,18,7,1578,857,2435,1113
0130-001,2016,11,18,8,1760,1602,3362,2435
0130-001,2016,11,18,9,1717,1921,3638,3362
0130-001,2016,11,18,10,1729,1630,3359,3638
0130-001,2016,11,18,11,1666,1730,3396,3359
0130-001,2016,11,18,12,1562,1728,3290,3396
0130-001,2016,11,18,13,1545,1666,3211,3290
0130-001,2016,11,18,14,1685,1700,3385,3211
0130-001,2016,11,18,15,1593,1893,3486,3385
0130-001,2016,11,18,16,1469,1844,3313,3486
0130-001,2016,11,18,17,1415,1965,3380,3313
0130-001,2016,11,18,18,1592,2302,3894,3380
0130-001,2016,11,18,19,1556,2046,3602,3894
0130-001,2016,11,18,20,1426,1567,2993,3602
0130-001,2016,11,18,21,1239,1468,2707,2993
0130-001,2016,11,18,22,1178,1346,2524,2707
0130-001,2016,11,18,23,942,1094,2036,2524
0130-001,2016,11,18,24,575,653,1228,2036
0130-001,2016,11,19,1,487,400,887,1228
0130-001,2016,11,19,2,360,333,693,887
0130-001,2016,11,19,3,234,262,496,693
0130-001,2016,11,19,4,229,253,482,496
0130-001,2016,11,19,5,239,318,557,482
0130-001,2016,11,19,6,538,458,996,557
0130-001,2016,11,19,7,1065,699,1764,996
0130-001,2016,11,19,8,1464,1174,2638,1764
0130-001,2016,11,19,9,1623,1722,3345,2638
0130-001,2016,11,19,10,1677,1972,3649,3345
0130-001,2016,11,19,11,1726,1948,3674,3649
0130-001,2016,11,19,12,1868,2287,4155,3674
0130-001,2016,11,19,13,1723,2323,4046,4155
0130-001,2016,11,19,14,1783,2300,4083,4046
0130-001,2016,11,19,15,1732,2249,3981,4083
0130-001,2016,11,19,16,1814,2115,3929,3981
0130-001,2016,11,19,17,1848,2063,3911,3929
0130-001,2016,11,19,18,1691,2183,3874,3911
0130-001,2016,11,19,19,1744,2031,3775,3874
0130-001,2016,11,19,20,1456,1486,2942,3775
0130-001,2016,11,19,21,1125,1155,2280,2942
0130-001,2016,11,19,22,972,983,1955,2280
0130-001,2016,11,19,23,838,845,1683,1955
0130-001,2016,11,19,24,486,437,923,1683
0130-001,2016,11,20,1,386,357,743,923
0130-001,2016,11,20,2,304,293,597,743
0130-001,2016,11,20,3,247,200,447,597
0130-001,2016,11,20,4,188,205,393,447
0130-001,2016,11,20,5,216,186,402,393
0130-001,2016,11,20,6,354,266,620,402
0130-001,2016,11,20,7,643,459,1102,620
0130-001,2016,11,20,8,833,709,1542,1102
0130-001,2016,11,20,9,1008,1005,2013,1542
0130-001,2016,11,20,10,1070,1206,2276,2013
0130-001,2016,11,20,11,1397,1468,2865,2276
0130-001,2016,11,20,12,1288,1443,2731,2865
0130-001,2016,11,20,13,1621,1552,3173,2731
0130-001,2016,11,20,14,1657,1666,3323,3173
0130-001,2016,11,20,15,1735,1777,3512,3323
0130-001,2016,11,20,16,1681,1680,3361,3512
0130-001,2016,11,20,17,1584,1660,3244,3361
0130-001,2016,11,20,18,1770,1793,3563,3244
0130-001,2016,11,20,19,1689,1488,3177,3563
0130-001,2016,11,20,20,1558,1206,2764,3177
0130-001,2016,11,20,21,1353,1081,2434,2764
0130-001,2016,11,20,22,1145,819,1964,2434
0130-001,2016,11,20,23,688,581,1269,1964
0130-001,2016,11,20,24,476,374,850,1269
0130-001,2016,11,21,1,306,244,550,850
0130-001,2016,11,21,2,172,166,338,550
0130-001,2016,11,21,3,111,119,230,338
0130-001,2016,11,21,4,139,171,310,230
0130-001,2016,11,21,5,258,242,500,310
0130-001,2016,11,21,6,719,481,1200,500
0130-001,2016,11,21,7,1677,944,2621,1200
0130-001,2016,11,21,8,1677,1631,3308,2621
0130-001,2016,11,21,9,1760,1878,3638,3308
0130-001,2016,11,21,10,1554,1625,3179,3638
0130-001,2016,11,21,11,1732,1697,3429,3179
0130-001,2016,11,21,12,1630,1578,3208,3429
0130-001,2016,11,21,13,1462,1512,2974,3208
0130-001,2016,11,21,14,1668,1678,3346,2974
0130-001,2016,11,21,15,1614,1693,3307,3346
0130-001,2016,11,21,16,1670,1846,3516,3307
0130-001,2016,11,21,17,1652,2000,3652,3516
0130-001,2016,11,21,18,1625,2243,3868,3652
0130-001,2016,11,21,19,1569,2242,3811,3868
0130-001,2016,11,21,20,1246,1812,3058,3811
0130-001,2016,11,21,21,1067,1634,2701,3058
0130-001,2016,11,21,22,1099,1358,2457,2701
0130-001,2016,11,21,23,742,769,1511,2457
0130-001,2016,11,21,24,514,527,1041,1511
0130-001,2016,11,22,1,350,349,699,1041
0130-001,2016,11,22,2,206,220,426,699
0130-001,2016,11,22,3,147,176,323,426
0130-001,2016,11,22,4,151,206,357,323
0130-001,2016,11,22,5,214,260,474,357
0130-001,2016,11,22,6,622,491,1113,474
0130-001,2016,11,22,7,1503,816,2319,1113
0130-001,2016,11,22,8,1608,1563,3171,2319
0130-001,2016,11,22,9,1665,1906,3571,3171
0130-001,2016,11,22,10,1637,1706,3343,3571
0130-001,2016,11,22,11,1480,1667,3147,3343
0130-001,2016,11,22,12,1399,1542,2941,3147
0130-001,2016,11,22,13,1392,1517,2909,2941
0130-001,2016,11,22,14,1645,1681,3326,2909
0130-001,2016,11,22,15,1582,1803,3385,3326
0130-001,2016,11,22,16,1509,1745,3254,3385
0130-001,2016,11,22,17,1568,1919,3487,3254
0130-001,2016,11,22,18,1679,2199,3878,3487
0130-001,2016,11,22,19,1506,2253,3759,3878
0130-001,2016,11,22,20,1231,1733,2964,3759
0130-001,2016,11,22,21,1192,1703,2895,2964
0130-001,2016,11,22,22,1124,1369,2493,2895
0130-001,2016,11,22,23,815,835,1650,2493
0130-001,2016,11,22,24,507,545,1052,1650
0130-001,2016,11,23,1,317,318,635,1052
0130-001,2016,11,23,2,221,211,432,635
0130-001,2016,11,23,3,164,172,336,432
0130-001,2016,11,23,4,145,185,330,336
0130-001,2016,11,23,5,226,234,460,330
0130-001,2016,11,23,6,601,439,1040,460
0130-001,2016,11,23,7,1591,838,2429,1040
0130-001,2016,11,23,8,1581,1591,3172,2429
0130-001,2016,11,23,9,1706,1839,3545,3172
0130-001,2016,11,23,10,1610,1658,3268,3545
0130-001,2016,11,23,11,1541,1622,3163,3268
0130-001,2016,11,23,12,1470,1599,3069,3163
0130-001,2016,11,23,13,1454,1546,3000,3069
0130-001,2016,11,23,14,1609,1634,3243,3000
0130-001,2016,11,23,15,1605,1685,3290,3243
0130-001,2016,11,23,16,1394,1814,3208,3290
0130-001,2016,11,23,17,1505,1840,3345,3208
0130-001,2016,11,23,18,1643,2304,3947,3345
0130-001,2016,11,23,19,1525,2317,3842,3947
0130-001,2016,11,23,20,1256,1862,3118,3842
0130-001,2016,11,23,21,1158,1470,2628,3118
0130-001,2016,11,23,22,1079,1176,2255,2628
0130-001,2016,11,23,23,755,770,1525,2255
0130-001,2016,11,23,24,533,528,1061,1525
0130-001,2016,11,24,1,370,405,775,1061
0130-001,2016,11,24,2,230,279,509,775
0130-001,2016,11,24,3,174,177,351,509
0130-001,2016,11,24,4,158,203,361,351
0130-001,2016,11,24,5,230,240,470,361
0130-001,2016,11,24,6,590,443,1033,470
0130-001,2016,11,24,7,1594,759,2353,1033
0130-001,2016,11,24,8,1668,1508,3176,2353
0130-001,2016,11,24,9,1673,1874,3547,3176
0130-001,2016,11,24,10,1601,1689,3290,3547
0130-001,2016,11,24,11,1634,1605,3239,3290
0130-001,2016,11,24,12,1553,1635,3188,3239
0130-001,2016,11,24,13,1520,1458,2978,3188
0130-001,2016,11,24,14,1694,1667,3361,2978
0130-001,2016,11,24,15,1684,1730,3414,3361
0130-001,2016,11,24,16,1581,1709,3290,3414
0130-001,2016,11,24,17,1557,1980,3537,3290
0130-001,2016,11,24,18,1496,2231,3727,3537
0130-001,2016,11,24,19,1499,2156,3655,3727
0130-001,2016,11,24,20,1238,1754,2992,3655
0130-001,2016,11,24,21,1195,1681,2876,2992
0130-001,2016,11,24,22,1082,1319,2401,2876
0130-001,2016,11,24,23,817,782,1599,2401
0130-001,2016,11,24,24,527,501,1028,1599
0130-001,2016,11,25,1,398,370,768,1028
0130-001,2016,11,25,2,217,229,446,768
0130-001,2016,11,25,3,171,186,357,446
0130-001,2016,11,25,4,142,188,330,357
0130-001,2016,11,25,5,246,240,486,330
0130-001,2016,11,25,6,593,447,1040,486
0130-001,2016,11,25,7,1595,809,2404,1040
0130-001,2016,11,25,8,1618,1534,3152,2404
0130-001,2016,11,25,9,1685,1907,3592,3152
0130-001,2016,11,25,10,1615,1615,3230,3592
0130-001,2016,11,25,11,1529,1667,3196,3230
0130-001,2016,11,25,12,1434,1578,3012,3196
0130-001,2016,11,25,13,1433,1569,3002,3012
0130-001,2016,11,25,14,1579,1704,3283,3002
0130-001,2016,11,25,15,1479,1727,3206,3283
0130-001,2016,11,25,16,1590,1811,3401,3206
0130-001,2016,11,25,17,1485,1997,3482,3401
0130-001,2016,11,25,18,1648,2075,3723,3482
0130-001,2016,11,25,19,1624,2347,3971,3723
0130-001,2016,11,25,20,1480,2066,3546,3971
0130-001,2016,11,25,21,1240,1768,3008,3546
0130-001,2016,11,25,22,1225,1433,2658,3008
0130-001,2016,11,25,23,883,851,1734,2658
0130-001,2016,11,25,24,636,578,1214,1734
0130-001,2016,11,26,1,477,434,911,1214
0130-001,2016,11,26,2,322,304,626,911
0130-001,2016,11,26,3,239,233,472,626
0130-001,2016,11,26,4,218,261,479,472
0130-001,2016,11,26,5,266,250,516,479
0130-001,2016,11,26,6,542,461,1003,516
0130-001,2016,11,26,7,1046,690,1736,1003
0130-001,2016,11,26,8,1406,1165,2571,1736
0130-001,2016,11,26,9,1517,1593,3110,2571
0130-001,2016,11,26,10,1438,1749,3187,3110
0130-001,2016,11,26,11,1485,1850,3335,3187
0130-001,2016,11,26,12,1512,1874,3386,3335
0130-001,2016,11,26,13,1507,1897,3404,3386
0130-001,2016,11,26,14,1382,1835,3217,3404
0130-001,2016,11,26,15,1400,1717,3117,3217
0130-001,2016,11,26,16,1433,1815,3248,3117
0130-001,2016,11,26,17,1546,1833,3379,3248
0130-001,2016,11,26,18,1688,2118,3806,3379
0130-001,2016,11,26,19,1569,1763,3332,3806
0130-001,2016,11,26,20,1375,1212,2587,3332
0130-001,2016,11,26,21,1046,1010,2056,2587
0130-001,2016,11,26,22,992,828,1820,2056
0130-001,2016,11,26,23,752,608,1360,1820
0130-001,2016,11,26,24,537,450,987,1360
0130-001,2016,11,27,1,410,346,756,987
0130-001,2016,11,27,2,293,277,570,756
0130-001,2016,11,27,3,222,184,406,570
0130-001,2016,11,27,4,197,158,355,406
0130-001,2016,11,27,5,203,166,369,355
0130-001,2016,11,27,6,331,274,605,369
0130-001,2016,11,27,7,548,352,900,605
0130-001,2016,11,27,8,731,631,1362,900
0130-001,2016,11,27,9,895,871,1766,1362
0130-001,2016,11,27,10,1022,1086,2108,1766
0130-001,2016,11,27,11,1219,1338,2557,2108
0130-001,2016,11,27,12,1260,1284,2544,2557
0130-001,2016,11,27,13,1382,1407,2789,2544
0130-001,2016,11,27,14,1503,1395,2898,2789
0130-001,2016,11,27,15,1558,1642,3200,2898
0130-001,2016,11,27,16,1694,1697,3391,3200
0130-001,2016,11,27,17,1639,1574,3213,3391
0130-001,2016,11,27,18,1616,1568,3184,3213
0130-001,2016,11,27,19,1519,1283,2802,3184
0130-001,2016,11,27,20,1289,1055,2344,2802
0130-001,2016,11,27,21,1126,889,2015,2344
0130-001,2016,11,27,22,1002,759,1761,2015
0130-001,2016,11,27,23,671,525,1196,1761
0130-001,2016,11,27,24,412,345,757,1196
0130-001,2016,11,28,1,267,214,481,757
0130-001,2016,11,28,2,153,155,308,481
0130-001,2016,11,28,3,135,119,254,308
0130-001,2016,11,28,4,129,169,298,254
0130-001,2016,11,28,5,235,223,458,298
0130-001,2016,11,28,6,642,437,1079,458
0130-001,2016,11,28,7,1564,851,2415,1079
0130-001,2016,11,28,8,1454,1583,3037,2415
0130-001,2016,11,28,9,1652,1610,3262,3037
0130-001,2016,11,28,10,1658,1574,3232,3262
0130-001,2016,11,28,11,1657,1717,3374,3232
0130-001,2016,11,28,12,1608,1696,3304,3374
0130-001,2016,11,28,13,1537,1578,3115,3304
0130-001,2016,11,28,14,1663,1720,3383,3115
0130-001,2016,11,28,15,1701,1841,3542,3383
0130-001,2016,11,28,16,1482,1629,3111,3542
0130-001,2016,11,28,17,1707,2008,3715,3111
0130-001,2016,11,28,18,1634,2106,3740,3715
0130-001,2016,11,28,19,1598,2207,3805,3740
0130-001,2016,11,28,20,1219,1682,2901,3805
0130-001,2016,11,28,21,1108,1619,2727,2901
0130-001,2016,11,28,22,1022,1301,2323,2727
0130-001,2016,11,28,23,737,714,1451,2323
0130-001,2016,11,28,24,493,472,965,1451
0130-001,2016,11,29,1,311,320,631,965
0130-001,2016,11,29,2,219,197,416,631
0130-001,2016,11,29,3,149,162,311,416
0130-001,2016,11,29,4,132,191,323,311
0130-001,2016,11,29,5,216,223,439,323
0130-001,2016,11,29,6,552,407,959,439
0130-001,2016,11,29,7,1581,782,2363,959
0130-001,2016,11,29,8,1561,1437,2998,2363
0130-001,2016,11,29,9,1666,1856,3522,2998
0130-001,2016,11,29,10,1503,1650,3153,3522
0130-001,2016,11,29,11,1536,1628,3164,3153
0130-001,2016,11,29,12,1457,1535,2992,3164
0130-001,2016,11,29,13,1375,1571,2946,2992
0130-001,2016,11,29,14,1588,1622,3210,2946
0130-001,2016,11,29,15,1564,1702,3266,3210
0130-001,2016,11,29,16,1598,1771,3369,3266
0130-001,2016,11,29,17,1543,1954,3497,3369
0130-001,2016,11,29,18,1654,2159,3813,3497
0130-001,2016,11,29,19,1567,2234,3801,3813
0130-001,2016,11,29,20,1180,1700,2880,3801
0130-001,2016,11,29,21,1079,1682,2761,2880
0130-001,2016,11,29,22,1134,1208,2342,2761
0130-001,2016,11,29,23,799,788,1587,2342
0130-001,2016,11,29,24,527,558,1085,1587
0130-001,2016,11,30,1,361,385,746,1085
0130-001,2016,11,30,2,221,222,443,746
0130-001,2016,11,30,3,169,194,363,443
0130-001,2016,11,30,4,157,189,346,363
0130-001,2016,11,30,5,232,265,497,346
0130-001,2016,11,30,6,575,409,984,497
0130-001,2016,11,30,7,1525,792,2317,984
0130-001,2016,11,30,8,1409,1494,2903,2317
0130-001,2016,11,30,9,1520,1931,3451,2903
0130-001,2016,11,30,10,1636,1624,3260,3451
0130-001,2016,11,30,11,1554,1567,3121,3260
0130-001,2016,11,30,12,1495,1623,3118,3121
0130-001,2016,11,30,13,1428,1489,2917,3118
0130-001,2016,11,30,14,1669,1673,3342,2917
0130-001,2016,11,30,15,1604,1732,3336,3342
0130-001,2016,11,30,16,1618,1813,3431,3336
0130-001,2016,11,30,17,1494,1961,3455,3431
0130-001,2016,11,30,18,1597,2172,3769,3455
0130-001,2016,11,30,19,1527,2356,3883,3769
0130-001,2016,11,30,20,1314,1798,3112,3883
0130-001,2016,11,30,21,1126,1505,2631,3112
0130-001,2016,11,30,22,1075,1169,2244,2631
0130-001,2016,11,30,23,846,826,1672,2244
0130-001,2016,11,30,24,565,553,1118,1672
0130-001,2016,12,1,1,396,380,776,1118
0130-001,2016,12,1,2,238,227,465,776
0130-001,2016,12,1,3,179,179,358,465
0130-001,2016,12,1,4,167,192,359,358
0130-001,2016,12,1,5,254,259,513,359
0130-001,2016,12,1,6,545,451,996,513
0130-001,2016,12,1,7,1555,765,2320,996
0130-001,2016,12,1,8,1620,1507,3127,2320
0130-001,2016,12,1,9,1651,1970,3621,3127
0130-001,2016,12,1,10,1590,1562,3152,3621
0130-001,2016,12,1,11,1693,1653,3346,3152
0130-001,2016,12,1,12,1509,1669,3178,3346
0130-001,2016,12,1,13,1464,1432,2896,3178
0130-001,2016,12,1,14,1610,1640,3250,2896
0130-001,2016,12,1,15,1675,1737,3412,3250
0130-001,2016,12,1,16,1608,1796,3404,3412
0130-001,2016,12,1,17,1598,1975,3573,3404
0130-001,2016,12,1,18,1615,2251,3866,3573
0130-001,2016,12,1,19,1476,2252,3728,3866
0130-001,2016,12,1,20,1313,1717,3030,3728
0130-001,2016,12,1,21,1132,1646,2778,3030
0130-001,2016,12,1,22,1085,1220,2305,2778
0130-001,2016,12,1,23,824,799,1623,2305
0130-001,2016,12,1,24,531,502,1033,1623
0130-001,2016,12,2,1,380,367,747,1033
0130-001,2016,12,2,2,216,237,453,747
0130-001,2016,12,2,3,163,184,347,453
0130-001,2016,12,2,4,136,182,318,347
0130-001,2016,12,2,5,247,215,462,318
0130-001,2016,12,2,6,542,420,962,462
0130-001,2016,12,2,7,1510,791,2301,962
0130-001,2016,12,2,8,1660,1449,3109,2301
0130-001,2016,12,2,9,1619,1836,3455,3109
0130-001,2016,12,2,10,1542,1640,3182,3455
0130-001,2016,12,2,11,1571,1604,3175,3182
0130-001,2016,12,2,12,1540,1612,3152,3175
0130-001,2016,12,2,13,1467,1554,3021,3152
0130-001,2016,12,2,14,1671,1722,3393,3021
0130-001,2016,12,2,15,1577,1749,3326,3393
0130-001,2016,12,2,16,1628,1745,3373,3326
0130-001,2016,12,2,17,1530,2027,3557,3373
0130-001,2016,12,2,18,1567,2180,3747,3557
0130-001,2016,12,2,19,1666,2066,3732,3747
0130-001,2016,12,2,20,1423,1991,3414,3732
0130-001,2016,12,2,21,1204,1642,2846,3414
0130-001,2016,12,2,22,1211,1504,2715,2846
0130-001,2016,12,2,23,936,992,1928,2715
0130-001,2016,12,2,24,590,613,1203,1928
0130-001,2016,12,3,1,491,449,940,1203
0130-001,2016,12,3,2,338,302,640,940
0130-001,2016,12,3,3,241,242,483,640
0130-001,2016,12,3,4,224,232,456,483
0130-001,2016,12,3,5,258,258,516,456
0130-001,2016,12,3,6,498,401,899,516
0130-001,2016,12,3,7,1004,658,1662,899
0130-001,2016,12,3,8,1337,1041,2378,1662
0130-001,2016,12,3,9,1559,1513,3072,2378
0130-001,2016,12,3,10,1588,1738,3326,3072
0130-001,2016,12,3,11,1568,1782,3350,3326
0130-001,2016,12,3,12,1667,1808,3475,3350
0130-001,2016,12,3,13,1598,1872,3470,3475
0130-001,2016,12,3,14,1689,1876,3565,3470
0130-001,2016,12,3,15,1688,1811,3499,3565
0130-001,2016,12,3,16,1805,1871,3676,3499
0130-001,2016,12,3,17,1732,1918,3650,3676
0130-001,2016,12,3,18,1664,2127,3791,3650
0130-001,2016,12,3,19,1560,1926,3486,3791
0130-001,2016,12,3,20,1289,1280,2569,3486
0130-001,2016,12,3,21,1093,1036,2129,2569
0130-001,2016,12,3,22,966,866,1832,2129
0130-001,2016,12,3,23,826,692,1518,1832
0130-001,2016,12,3,24,605,485,1090,1518
0130-001,2016,12,4,1,447,394,841,1090
0130-001,2016,12,4,2,310,324,634,841
0130-001,2016,12,4,3,266,233,499,634
0130-001,2016,12,4,4,210,164,374,499
0130-001,2016,12,4,5,195,163,358,374
0130-001,2016,12,4,6,314,256,570,358
0130-001,2016,12,4,7,507,405,912,570
0130-001,2016,12,4,8,654,579,1233,912
0130-001,2016,12,4,9,856,886,1742,1233
0130-001,2016,12,4,10,1000,1143,2143,1742
0130-001,2016,12,4,11,1144,1391,2535,2143
0130-001,2016,12,4,12,1212,1422,2634,2535
0130-001,2016,12,4,13,1352,1604,2956,2634
0130-001,2016,12,4,14,1523,1591,3114,2956
0130-001,2016,12,4,15,1592,1625,3217,3114
0130-001,2016,12,4,16,1600,1669,3269,3217
0130-001,2016,12,4,17,1581,1682,3263,3269
0130-001,2016,12,4,18,1585,1699,3284,3263
0130-001,2016,12,4,19,1521,1323,2844,3284
0130-001,2016,12,4,20,1321,1026,2347,2844
0130-001,2016,12,4,21,1120,874,1994,2347
0130-001,2016,12,4,22,914,783,1697,1994
0130-001,2016,12,4,23,678,543,1221,1697
0130-001,2016,12,4,24,397,335,732,1221
0130-001,2016,12,5,1,271,247,518,732
0130-001,2016,12,5,2,135,147,282,518
0130-001,2016,12,5,3,118,125,243,282
0130-001,2016,12,5,4,121,146,267,243
0130-001,2016,12,5,5,233,213,446,267
0130-001,2016,12,5,6,607,412,1019,446
0130-001,2016,12,5,7,1644,871,2515,1019
0130-001,2016,12,5,8,1622,1477,3099,2515
0130-001,2016,12,5,9,1724,1862,3586,3099
0130-001,2016,12,5,10,1537,1606,3143,3586
0130-001,2016,12,5,11,1664,1654,3318,3143
0130-001,2016,12,5,12,1572,1650,3222,3318
0130-001,2016,12,5,13,1500,1572,3072,3222
0130-001,2016,12,5,14,1673,1709,3382,3072
0130-001,2016,12,5,15,1523,1694,3217,3382
0130-001,2016,12,5,16,1619,1787,3406,3217
0130-001,2016,12,5,17,1483,1944,3427,3406
0130-001,2016,12,5,18,1535,2180,3715,3427
0130-001,2016,12,5,19,1432,2224,3656,3715
0130-001,2016,12,5,20,1260,1746,3006,3656
0130-001,2016,12,5,21,1068,1628,2696,3006
0130-001,2016,12,5,22,990,1262,2252,2696
0130-001,2016,12,5,23,749,803,1552,2252
0130-001,2016,12,5,24,465,498,963,1552
0130-001,2016,12,6,1,342,314,656,963
0130-001,2016,12,6,2,191,214,405,656
0130-001,2016,12,6,3,158,170,328,405
0130-001,2016,12,6,4,155,193,348,328
0130-001,2016,12,6,5,235,263,498,348
0130-001,2016,12,6,6,583,440,1023,498
0130-001,2016,12,6,7,1511,791,2302,1023
0130-001,2016,12,6,8,1594,1484,3078,2302
0130-001,2016,12,6,9,1687,1844,3531,3078
0130-001,2016,12,6,10,1556,1631,3187,3531
0130-001,2016,12,6,11,1629,1357,2986,3187
0130-001,2016,12,6,12,1522,1468,2990,2986
0130-001,2016,12,6,13,1402,1723,3125,2990
0130-001,2016,12,6,14,1642,1460,3102,3125
0130-001,2016,12,6,15,1618,1292,2910,3102
0130-001,2016,12,6,16,1561,1868,3429,2910
0130-001,2016,12,6,17,1564,1864,3428,3429
0130-001,2016,12,6,18,1644,2174,3818,3428
0130-001,2016,12,6,19,1563,2203,3766,3818
0130-001,2016,12,6,20,1238,1677,2915,3766
0130-001,2016,12,6,21,1083,1660,2743,2915
0130-001,2016,12,6,22,1098,1283,2381,2743
0130-001,2016,12,6,23,787,818,1605,2381
0130-001,2016,12,6,24,468,556,1024,1605
0130-001,2016,12,7,1,377,340,717,1024
0130-001,2016,12,7,2,216,218,434,717
0130-001,2016,12,7,3,164,184,348,434
0130-001,2016,12,7,4,145,186,331,348
0130-001,2016,12,7,5,223,249,472,331
0130-001,2016,12,7,6,561,390,951,472
0130-001,2016,12,7,7,1523,795,2318,951
0130-001,2016,12,7,8,1625,1457,3082,2318
0130-001,2016,12,7,9,1697,1783,3480,3082
0130-001,2016,12,7,10,1591,1544,3135,3480
0130-001,2016,12,7,11,1585,1470,3055,3135
0130-001,2016,12,7,12,1483,1644,3127,3055
0130-001,2016,12,7,13,1481,1455,2936,3127
0130-001,2016,12,7,14,1612,1623,3235,2936
0130-001,2016,12,7,15,1462,1646,3108,3235
0130-001,2016,12,7,16,1371,1700,3071,3108
0130-001,2016,12,7,17,1370,1907,3277,3071
0130-001,2016,12,7,18,1549,2262,3811,3277
0130-001,2016,12,7,19,1485,2411,3896,3811
0130-001,2016,12,7,20,1259,1633,2892,3896
0130-001,2016,12,7,21,1095,1539,2634,2892
0130-001,2016,12,7,22,1040,1152,2192,2634
0130-001,2016,12,7,23,815,796,1611,2192
0130-001,2016,12,7,24,522,538,1060,1611
0130-001,2016,12,8,1,373,313,686,1060
0130-001,2016,12,8,2,231,249,480,686
0130-001,2016,12,8,3,151,198,349,480
0130-001,2016,12,8,4,173,188,361,349
0130-001,2016,12,8,5,234,241,475,361
0130-001,2016,12,8,6,513,406,919,475
0130-001,2016,12,8,7,1507,804,2311,919
0130-001,2016,12,8,8,1554,1495,3049,2311
0130-001,2016,12,8,9,1745,1935,3680,3049
0130-001,2016,12,8,10,1382,1463,2845,3680
0130-001,2016,12,8,11,1473,1606,3079,2845
0130-001,2016,12,8,12,1531,1642,3173,3079
0130-001,2016,12,8,13,1492,1359,2851,3173
0130-001,2016,12,8,14,1531,1565,3096,2851
0130-001,2016,12,8,15,1490,1508,2998,3096
0130-001,2016,12,8,16,1577,1715,3292,2998
0130-001,2016,12,8,17,1474,1932,3406,3292
0130-001,2016,12,8,18,1580,2234,3814,3406
0130-001,2016,12,8,19,1398,2278,3676,3814
0130-001,2016,12,8,20,1235,1668,2903,3676
0130-001,2016,12,8,21,1066,1457,2523,2903
0130-001,2016,12,8,22,1011,1176,2187,2523
0130-001,2016,12,8,23,697,682,1379,2187
0130-001,2016,12,8,24,535,520,1055,1379
0130-001,2016,12,9,1,356,373,729,1055
0130-001,2016,12,9,2,273,261,534,729
0130-001,2016,12,9,3,186,196,382,534
0130-001,2016,12,9,4,166,217,383,382
0130-001,2016,12,9,5,219,226,445,383
0130-001,2016,12,9,6,547,397,944,445
0130-001,2016,12,9,7,1444,743,2187,944
0130-001,2016,12,9,8,1449,1397,2846,2187
0130-001,2016,12,9,9,1682,1904,3586,2846
0130-001,2016,12,9,10,1561,1572,3133,3586
0130-001,2016,12,9,11,1233,1587,2820,3133
0130-001,2016,12,9,12,1474,1650,3124,2820
0130-001,2016,12,9,13,1430,1572,3002,3124
0130-001,2016,12,9,14,1581,1722,3303,3002
0130-001,2016,12,9,15,1529,1843,3372,3303
0130-001,2016,12,9,16,1691,1808,3499,3372
0130-001,2016,12,9,17,1691,1951,3642,3499
0130-001,2016,12,9,18,1681,2278,3959,3642
0130-001,2016,12,9,19,1544,2297,3841,3959
0130-001,2016,12,9,20,1412,1836,3248,3841
0130-001,2016,12,9,21,1184,1548,2732,3248
0130-001,2016,12,9,22,1149,1297,2446,2732
0130-001,2016,12,9,23,941,830,1771,2446
0130-001,2016,12,9,24,627,597,1224,1771
0130-001,2016,12,10,1,498,473,971,1224
0130-001,2016,12,10,2,351,313,664,971
0130-001,2016,12,10,3,243,259,502,664
0130-001,2016,12,10,4,240,258,498,502
0130-001,2016,12,10,5,253,308,561,498
0130-001,2016,12,10,6,432,391,823,561
0130-001,2016,12,10,7,965,619,1584,823
0130-001,2016,12,10,8,1327,1001,2328,1584
0130-001,2016,12,10,9,1519,1459,2978,2328
0130-001,2016,12,10,10,1492,1649,3141,2978
0130-001,2016,12,10,11,1632,1711,3343,3141
0130-001,2016,12,10,12,1524,1842,3366,3343
0130-001,2016,12,10,13,1543,1903,3446,3366
0130-001,2016,12,10,14,1655,1823,3478,3446
0130-001,2016,12,10,15,1652,1752,3404,3478
0130-001,2016,12,10,16,1761,1946,3707,3404
0130-001,2016,12,10,17,1725,1875,3600,3707
0130-001,2016,12,10,18,1603,2134,3737,3600
0130-001,2016,12,10,19,1558,1924,3482,3737
0130-001,2016,12,10,20,1329,1270,2599,3482
0130-001,2016,12,10,21,1062,1014,2076,2599
0130-001,2016,12,10,22,1014,878,1892,2076
0130-001,2016,12,10,23,811,647,1458,1892
0130-001,2016,12,10,24,578,501,1079,1458
0130-001,2016,12,11,1,458,400,858,1079
0130-001,2016,12,11,2,381,325,706,858
0130-001,2016,12,11,3,308,260,568,706
0130-001,2016,12,11,4,214,195,409,568
0130-001,2016,12,11,5,224,187,411,409
0130-001,2016,12,11,6,285,219,504,411
0130-001,2016,12,11,7,545,372,917,504
0130-001,2016,12,11,8,737,534,1271,917
0130-001,2016,12,11,9,864,819,1683,1271
0130-001,2016,12,11,10,899,1069,1968,1683
0130-001,2016,12,11,11,1148,1207,2355,1968
0130-001,2016,12,11,12,1236,1371,2607,2355
0130-001,2016,12,11,13,1384,1495,2879,2607
0130-001,2016,12,11,14,1514,1446,2960,2879
0130-001,2016,12,11,15,1473,1540,3013,2960
0130-001,2016,12,11,16,1601,1579,3180,3013
0130-001,2016,12,11,17,1448,1472,2920,3180
0130-001,2016,12,11,18,1702,1604,3306,2920
0130-001,2016,12,11,19,1573,1236,2809,3306
0130-001,2016,12,11,20,1158,1014,2172,2809
0130-001,2016,12,11,21,1025,896,1921,2172
0130-001,2016,12,11,22,877,761,1638,1921
0130-001,2016,12,11,23,595,507,1102,1638
0130-001,2016,12,11,24,464,375,839,1102
0130-001,2016,12,12,1,281,234,515,839
0130-001,2016,12,12,2,153,128,281,515
0130-001,2016,12,12,3,122,119,241,281
0130-001,2016,12,12,4,134,148,282,241
0130-001,2016,12,12,5,207,220,427,282
0130-001,2016,12,12,6,602,432,1034,427
0130-001,2016,12,12,7,1606,821,2427,1034
0130-001,2016,12,12,8,1479,1440,2919,2427
0130-001,2016,12,12,9,1710,1756,3466,2919
0130-001,2016,12,12,10,1584,1554,3138,3466
0130-001,2016,12,12,11,1611,1621,3232,3138
0130-001,2016,12,12,12,1507,1626,3133,3232
0130-001,2016,12,12,13,1448,1502,2950,3133
0130-001,2016,12,12,14,1603,1560,3163,2950
0130-001,2016,12,12,15,1461,1592,3053,3163
0130-001,2016,12,12,16,1588,1711,3299,3053
0130-001,2016,12,12,17,1512,1923,3435,3299
0130-001,2016,12,12,18,1654,2176,3830,3435
0130-001,2016,12,12,19,1555,2309,3864,3830
0130-001,2016,12,12,20,1227,1785,3012,3864
0130-001,2016,12,12,21,1127,1541,2668,3012
0130-001,2016,12,12,22,1034,1237,2271,2668
0130-001,2016,12,12,23,746,755,1501,2271
0130-001,2016,12,12,24,517,514,1031,1501
0130-001,2016,12,13,1,318,329,647,1031
0130-001,2016,12,13,2,216,215,431,647
0130-001,2016,12,13,3,146,181,327,431
0130-001,2016,12,13,4,143,182,325,327
0130-001,2016,12,13,5,217,225,442,325
0130-001,2016,12,13,6,499,413,912,442
0130-001,2016,12,13,7,1486,776,2262,912
0130-001,2016,12,13,8,1545,1449,2994,2262
0130-001,2016,12,13,9,1724,1845,3569,2994
0130-001,2016,12,13,10,1550,1568,3118,3569
0130-001,2016,12,13,11,1571,1658,3229,3118
0130-001,2016,12,13,12,1437,1588,3025,3229
0130-001,2016,12,13,13,1461,1473,2934,3025
0130-001,2016,12,13,14,1669,1576,3245,2934
0130-001,2016,12,13,15,1478,1621,3099,3245
0130-001,2016,12,13,16,1619,1719,3338,3099
0130-001,2016,12,13,17,1590,1835,3425,3338
0130-001,2016,12,13,18,1537,2156,3693,3425
0130-001,2016,12,13,19,1518,2311,3829,3693
0130-001,2016,12,13,20,1240,1722,2962,3829
0130-001,2016,12,13,21,1088,1623,2711,2962
0130-001,2016,12,13,22,1039,1218,2257,2711
0130-001,2016,12,13,23,785,776,1561,2257
0130-001,2016,12,13,24,563,517,1080,1561
0130-001,2016,12,14,1,337,351,688,1080
0130-001,2016,12,14,2,246,233,479,688
0130-001,2016,12,14,3,160,200,360,479
0130-001,2016,12,14,4,143,196,339,360
0130-001,2016,12,14,5,209,234,443,339
0130-001,2016,12,14,6,524,405,929,443
0130-001,2016,12,14,7,1503,753,2256,929
0130-001,2016,12,14,8,1490,1454,2944,2256
0130-001,2016,12,14,9,1636,1712,3348,2944
0130-001,2016,12,14,10,1541,1510,3051,3348
0130-001,2016,12,14,11,1590,1581,3171,3051
0130-001,2016,12,14,12,1460,1510,2970,3171
0130-001,2016,12,14,13,1325,1500,2825,2970
0130-001,2016,12,14,14,1619,1585,3204,2825
0130-001,2016,12,14,15,1596,1625,3221,3204
0130-001,2016,12,14,16,1512,1716,3228,3221
0130-001,2016,12,14,17,1549,1902,3451,3228
0130-001,2016,12,14,18,1456,2158,3614,3451
0130-001,2016,12,14,19,1510,2315,3825,3614
0130-001,2016,12,14,20,1220,1830,3050,3825
0130-001,2016,12,14,21,1105,1464,2569,3050
0130-001,2016,12,14,22,1051,1127,2178,2569
0130-001,2016,12,14,23,792,745,1537,2178
0130-001,2016,12,14,24,538,493,1031,1537
0130-001,2016,12,15,1,388,347,735,1031
0130-001,2016,12,15,2,262,244,506,735
0130-001,2016,12,15,3,161,193,354,506
0130-001,2016,12,15,4,155,191,346,354
0130-001,2016,12,15,5,194,267,461,346
0130-001,2016,12,15,6,540,430,970,461
0130-001,2016,12,15,7,1509,711,2220,970
0130-001,2016,12,15,8,1468,1403,2871,2220
0130-001,2016,12,15,9,1674,1754,3428,2871
0130-001,2016,12,15,10,1497,1499,2996,3428
0130-001,2016,12,15,11,1310,1498,2808,2996
0130-001,2016,12,15,12,1451,1611,3062,2808
0130-001,2016,12,15,13,1475,1503,2978,3062
0130-001,2016,12,15,14,1647,1577,3224,2978
0130-001,2016,12,15,15,1630,1739,3369,3224
0130-001,2016,12,15,16,1686,1615,3301,3369
0130-001,2016,12,15,17,1445,1796,3241,3301
0130-001,2016,12,15,18,1533,2143,3676,3241
0130-001,2016,12,15,19,1513,2206,3719,3676
0130-001,2016,12,15,20,1213,1720,2933,3719
0130-001,2016,12,15,21,1173,1537,2710,2933
0130-001,2016,12,15,22,1089,1223,2312,2710
0130-001,2016,12,15,23,903,813,1716,2312
0130-001,2016,12,15,24,546,485,1031,1716
0130-001,2016,12,16,1,376,358,734,1031
0130-001,2016,12,16,2,246,218,464,734
0130-001,2016,12,16,3,184,205,389,464
0130-001,2016,12,16,4,154,190,344,389
0130-001,2016,12,16,5,233,256,489,344
0130-001,2016,12,16,6,503,418,921,489
0130-001,2016,12,16,7,1487,716,2203,921
0130-001,2016,12,16,8,1493,1362,2855,2203
0130-001,2016,12,16,9,1694,1640,3334,2855
0130-001,2016,12,16,10,1506,1479,2985,3334
0130-001,2016,12,16,11,1544,1531,3075,2985
0130-001,2016,12,16,12,1525,1641,3166,3075
0130-001,2016,12,16,13,1464,1577,3041,3166
0130-001,2016,12,16,14,1663,1651,3314,3041
0130-001,2016,12,16,15,1718,1715,3433,3314
0130-001,2016,12,16,16,1727,1836,3563,3433
0130-001,2016,12,16,17,1602,1892,3494,3563
0130-001,2016,12,16,18,1672,2229,3901,3494
0130-001,2016,12,16,19,1691,2385,4076,3901
0130-001,2016,12,16,20,1333,1904,3237,4076
0130-001,2016,12,16,21,1187,1488,2675,3237
0130-001,2016,12,16,22,1236,1233,2469,2675
0130-001,2016,12,16,23,990,884,1874,2469
0130-001,2016,12,16,24,640,653,1293,1874
0130-001,2016,12,17,1,496,479,975,1293
0130-001,2016,12,17,2,415,348,763,975
0130-001,2016,12,17,3,273,279,552,763
0130-001,2016,12,17,4,224,252,476,552
0130-001,2016,12,17,5,272,272,544,476
0130-001,2016,12,17,6,484,405,889,544
0130-001,2016,12,17,7,950,670,1620,889
0130-001,2016,12,17,8,1265,1001,2266,1620
0130-001,2016,12,17,9,1410,1455,2865,2266
0130-001,2016,12,17,10,1419,1619,3038,2865
0130-001,2016,12,17,11,1668,1805,3473,3038
0130-001,2016,12,17,12,1650,1823,3473,3473
0130-001,2016,12,17,13,1600,1916,3516,3473
0130-001,2016,12,17,14,1640,1850,3490,3516
0130-001,2016,12,17,15,1638,1898,3536,3490
0130-001,2016,12,17,16,1697,1857,3554,3536
0130-001,2016,12,17,17,1680,1964,3644,3554
0130-001,2016,12,17,18,1718,2156,3874,3644
0130-001,2016,12,17,19,1469,1842,3311,3874
0130-001,2016,12,17,20,1303,1235,2538,3311
0130-001,2016,12,17,21,1063,1026,2089,2538
0130-001,2016,12,17,22,1034,876,1910,2089
0130-001,2016,12,17,23,789,646,1435,1910
0130-001,2016,12,17,24,600,532,1132,1435
0130-001,2016,12,18,1,467,411,878,1132
0130-001,2016,12,18,2,377,306,683,878
0130-001,2016,12,18,3,281,267,548,683
0130-001,2016,12,18,4,223,191,414,548
0130-001,2016,12,18,5,197,159,356,414
0130-001,2016,12,18,6,324,263,587,356
0130-001,2016,12,18,7,545,394,939,587
0130-001,2016,12,18,8,734,584,1318,939
0130-001,2016,12,18,9,830,854,1684,1318
0130-001,2016,12,18,10,855,1043,1898,1684
0130-001,2016,12,18,11,1181,1317,2498,1898
0130-001,2016,12,18,12,1194,1463,2657,2498
0130-001,2016,12,18,13,1376,1569,2945,2657
0130-001,2016,12,18,14,1567,1546,3113,2945
0130-001,2016,12,18,15,1538,1574,3112,3113
0130-001,2016,12,18,16,1641,1541,3182,3112
0130-001,2016,12,18,17,1658,1609,3267,3182
0130-001,2016,12,18,18,1523,1684,3207,3267
0130-001,2016,12,18,19,1421,1296,2717,3207
0130-001,2016,12,18,20,1205,1036,2241,2717
0130-001,2016,12,18,21,1033,897,1930,2241
0130-001,2016,12,18,22,939,730,1669,1930
0130-001,2016,12,18,23,679,526,1205,1669
0130-001,2016,12,18,24,438,343,781,1205
0130-001,2016,12,19,1,284,222,506,781
0130-001,2016,12,19,2,163,159,322,506
0130-001,2016,12,19,3,119,118,237,322
0130-001,2016,12,19,4,111,142,253,237
0130-001,2016,12,19,5,230,231,461,253
0130-001,2016,12,19,6,546,406,952,461
0130-001,2016,12,19,7,1516,812,2328,952
0130-001,2016,12,19,8,1429,1497,2926,2328
0130-001,2016,12,19,9,1705,1798,3503,2926
0130-001,2016,12,19,10,1474,1565,3039,3503
0130-001,2016,12,19,11,1556,1555,3111,3039
0130-001,2016,12,19,12,1468,1563,3031,3111
0130-001,2016,12,19,13,1485,1388,2873,3031
0130-001,2016,12,19,14,1695,1596,3291,2873
0130-001,2016,12,19,15,1581,1713,3294,3291
0130-001,2016,12,19,16,1598,1724,3322,3294
0130-001,2016,12,19,17,1553,1832,3385,3322
0130-001,2016,12,19,18,1537,2179,3716,3385
0130-001,2016,12,19,19,1492,2204,3696,3716
0130-001,2016,12,19,20,1202,1682,2884,3696
0130-001,2016,12,19,21,1060,1652,2712,2884
0130-001,2016,12,19,22,1026,1212,2238,2712
0130-001,2016,12,19,23,719,702,1421,2238
0130-001,2016,12,19,24,494,494,988,1421
0130-001,2016,12,20,1,332,352,684,988
0130-001,2016,12,20,2,226,209,435,684
0130-001,2016,12,20,3,164,186,350,435
0130-001,2016,12,20,4,162,203,365,350
0130-001,2016,12,20,5,231,245,476,365
0130-001,2016,12,20,6,559,408,967,476
0130-001,2016,12,20,7,1533,801,2334,967
0130-001,2016,12,20,8,1494,1487,2981,2334
0130-001,2016,12,20,9,1625,1757,3382,2981
0130-001,2016,12,20,10,1544,1542,3086,3382
0130-001,2016,12,20,11,1444,1569,3013,3086
0130-001,2016,12,20,12,1428,1579,3007,3013
0130-001,2016,12,20,13,1447,1523,2970,3007
0130-001,2016,12,20,14,1622,1591,3213,2970
0130-001,2016,12,20,15,1477,1579,3056,3213
0130-001,2016,12,20,16,1549,1749,3298,3056
0130-001,2016,12,20,17,1562,1930,3492,3298
0130-001,2016,12,20,18,1585,2125,3710,3492
0130-001,2016,12,20,19,1529,2201,3730,3710
0130-001,2016,12,20,20,1135,1832,2967,3730
0130-001,2016,12,20,21,1108,1624,2732,2967
0130-001,2016,12,20,22,1092,1178,2270,2732
0130-001,2016,12,20,23,848,808,1656,2270
0130-001,2016,12,20,24,530,537,1067,1656
0130-001,2016,12,21,1,380,382,762,1067
0130-001,2016,12,21,2,239,245,484,762
0130-001,2016,12,21,3,180,209,389,484
0130-001,2016,12,21,4,166,192,358,389
0130-001,2016,12,21,5,218,259,477,358
0130-001,2016,12,21,6,549,448,997,477
0130-001,2016,12,21,7,1517,779,2296,997
0130-001,2016,12,21,8,1611,1524,3135,2296
0130-001,2016,12,21,9,1605,1882,3487,3135
0130-001,2016,12,21,10,1521,1543,3064,3487
0130-001,2016,12,21,11,1642,1557,3199,3064
0130-001,2016,12,21,12,1491,1601,3092,3199
0130-001,2016,12,21,13,1399,1455,2854,3092
0130-001,2016,12,21,14,1612,1617,3229,2854
0130-001,2016,12,21,15,1465,1715,3180,3229
0130-001,2016,12,21,16,1326,1654,2980,3180
0130-001,2016,12,21,17,1361,1682,3043,2980
0130-001,2016,12,21,18,1451,2024,3475,3043
0130-001,2016,12,21,19,1373,2118,3491,3475
0130-001,2016,12,21,20,1229,1735,2964,3491
0130-001,2016,12,21,21,1135,1384,2519,2964
0130-001,2016,12,21,22,1110,1109,2219,2519
0130-001,2016,12,21,23,796,725,1521,2219
0130-001,2016,12,21,24,557,549,1106,1521
0130-001,2016,12,22,1,385,356,741,1106
0130-001,2016,12,22,2,256,259,515,741
0130-001,2016,12,22,3,177,198,375,515
0130-001,2016,12,22,4,150,185,335,375
0130-001,2016,12,22,5,213,248,461,335
0130-001,2016,12,22,6,486,417,903,461
0130-001,2016,12,22,7,1294,742,2036,903
0130-001,2016,12,22,8,1279,1433,2712,2036
0130-001,2016,12,22,9,1556,1847,3403,2712
0130-001,2016,12,22,10,1513,1513,3026,3403
0130-001,2016,12,22,11,1477,1494,2971,3026
0130-001,2016,12,22,12,1416,1525,2941,2971
0130-001,2016,12,22,13,1372,1423,2795,2941
0130-001,2016,12,22,14,1576,1515,3091,2795
0130-001,2016,12,22,15,1353,1574,2927,3091
0130-001,2016,12,22,16,1436,1568,3004,2927
0130-001,2016,12,22,17,1437,1771,3208,3004
0130-001,2016,12,22,18,1386,1831,3217,3208
0130-001,2016,12,22,19,1263,1763,3026,3217
0130-001,2016,12,22,20,1107,1581,2688,3026
0130-001,2016,12,22,21,1132,1421,2553,2688
0130-001,2016,12,22,22,1071,1219,2290,2553
0130-001,2016,12,22,23,855,783,1638,2290
0130-001,2016,12,22,24,568,559,1127,1638
0130-001,2016,12,23,1,427,412,839,1127
0130-001,2016,12,23,2,261,264,525,839
0130-001,2016,12,23,3,195,202,397,525
0130-001,2016,12,23,4,158,205,363,397
0130-001,2016,12,23,5,224,224,448,363
0130-001,2016,12,23,6,482,369,851,448
0130-001,2016,12,23,7,1357,679,2036,851
0130-001,2016,12,23,8,1579,1421,3000,2036
0130-001,2016,12,23,9,1427,1674,3101,3000
0130-001,2016,12,23,10,1342,1091,2433,3101
0130-001,2016,12,23,11,1165,1018,2183,2433
0130-001,2016,12,23,12,1196,1281,2477,2183
0130-001,2016,12,23,13,1245,1350,2595,2477
0130-001,2016,12,23,14,1516,1532,3048,2595
0130-001,2016,12,23,15,1523,1468,2991,3048
0130-001,2016,12,23,16,1443,1513,2956,2991
0130-001,2016,12,23,17,1460,1767,3227,2956
0130-001,2016,12,23,18,1459,1982,3441,3227
0130-001,2016,12,23,19,1439,2125,3564,3441
0130-001,2016,12,23,20,1235,1731,2966,3564
0130-001,2016,12,23,21,1065,1405,2470,2966
0130-001,2016,12,23,22,1092,1137,2229,2470
0130-001,2016,12,23,23,932,782,1714,2229
0130-001,2016,12,23,24,597,563,1160,1714
0130-001,2016,12,24,1,476,452,928,1160
0130-001,2016,12,24,2,331,330,661,928
0130-001,2016,12,24,3,266,235,501,661
0130-001,2016,12,24,4,274,270,544,501
0130-001,2016,12,24,5,222,270,492,544
0130-001,2016,12,24,6,445,382,827,492
0130-001,2016,12,24,7,859,565,1424,827
0130-001,2016,12,24,8,1140,856,1996,1424
0130-001,2016,12,24,9,1199,1222,2421,1996
0130-001,2016,12,24,10,1456,1349,2805,2421
0130-001,2016,12,24,11,1650,1493,3143,2805
0130-001,2016,12,24,12,1587,1490,3077,3143
0130-001,2016,12,24,13,1572,1625,3197,3077
0130-001,2016,12,24,14,1648,1607,3255,3197
0130-001,2016,12,24,15,1645,1586,3231,3255
0130-001,2016,12,24,16,1729,1669,3398,3231
0130-001,2016,12,24,17,1613,1568,3181,3398
0130-001,2016,12,24,18,1620,1736,3356,3181
0130-001,2016,12,24,19,1504,1587,3091,3356
0130-001,2016,12,24,20,1179,1101,2280,3091
0130-001,2016,12,24,21,1078,968,2046,2280
0130-001,2016,12,24,22,1093,810,1903,2046
0130-001,2016,12,24,23,763,642,1405,1903
0130-001,2016,12,24,24,560,444,1004,1405
0130-001,2016,12,25,1,385,357,742,1004
0130-001,2016,12,25,2,321,251,572,742
0130-001,2016,12,25,3,238,205,443,572
0130-001,2016,12,25,4,217,177,394,443
0130-001,2016,12,25,5,195,162,357,394
0130-001,2016,12,25,6,250,211,461,357
0130-001,2016,12,25,7,453,306,759,461
0130-001,2016,12,25,8,598,437,1035,759
0130-001,2016,12,25,9,644,655,1299,1035
0130-001,2016,12,25,10,763,843,1606,1299
0130-001,2016,12,25,11,1046,1127,2173,1606
0130-001,2016,12,25,12,1065,1166,2231,2173
0130-001,2016,12,25,13,1198,1322,2520,2231
0130-001,2016,12,25,14,1240,1377,2617,2520
0130-001,2016,12,25,15,1415,1422,2837,2617
0130-001,2016,12,25,16,1441,1460,2901,2837
0130-001,2016,12,25,17,1407,1444,2851,2901
0130-001,2016,12,25,18,1400,1512,2912,2851
0130-001,2016,12,25,19,1273,1168,2441,2912
0130-001,2016,12,25,20,1143,980,2123,2441
0130-001,2016,12,25,21,902,830,1732,2123
0130-001,2016,12,25,22,888,731,1619,1732
0130-001,2016,12,25,23,650,523,1173,1619
0130-001,2016,12,25,24,420,364,784,1173
0130-001,2016,12,26,1,292,277,569,784
0130-001,2016,12,26,2,188,189,377,569
0130-001,2016,12,26,3,136,119,255,377
0130-001,2016,12,26,4,149,167,316,255
0130-001,2016,12,26,5,212,246,458,316
0130-001,2016,12,26,6,571,432,1003,458
0130-001,2016,12,26,7,1612,799,2411,1003
0130-001,2016,12,26,8,1605,1509,3114,2411
0130-001,2016,12,26,9,1554,1826,3380,3114
0130-001,2016,12,26,10,1452,1505,2957,3380
0130-001,2016,12,26,11,1472,1482,2954,2957
0130-001,2016,12,26,12,1527,1533,3060,2954
0130-001,2016,12,26,13,1421,1443,2864,3060
0130-001,2016,12,26,14,1548,1581,3129,2864
0130-001,2016,12,26,15,1534,1611,3145,3129
0130-001,2016,12,26,16,1492,1578,3070,3145
0130-001,2016,12,26,17,1475,1808,3283,3070
0130-001,2016,12,26,18,1526,2006,3532,3283
0130-001,2016,12,26,19,1419,2170,3589,3532
0130-001,2016,12,26,20,1161,1572,2733,3589
0130-001,2016,12,26,21,1102,1462,2564,2733
0130-001,2016,12,26,22,1004,1148,2152,2564
0130-001,2016,12,26,23,718,688,1406,2152
0130-001,2016,12,26,24,440,490,930,1406
0130-001,2016,12,27,1,366,335,701,930
0130-001,2016,12,27,2,220,193,413,701
0130-001,2016,12,27,3,186,204,390,413
0130-001,2016,12,27,4,153,206,359,390
0130-001,2016,12,27,5,220,226,446,359
0130-001,2016,12,27,6,520,401,921,446
0130-001,2016,12,27,7,1463,759,2222,921
0130-001,2016,12,27,8,1593,1473,3066,2222
0130-001,2016,12,27,9,1633,1813,3446,3066
0130-001,2016,12,27,10,1512,1579,3091,3446
0130-001,2016,12,27,11,1592,1527,3119,3091
0130-001,2016,12,27,12,1515,1600,3115,3119
0130-001,2016,12,27,13,1425,1450,2875,3115
0130-001,2016,12,27,14,1660,1626,3286,2875
0130-001,2016,12,27,15,1603,1677,3280,3286
0130-001,2016,12,27,16,1618,1689,3307,3280
0130-001,2016,12,27,17,1485,1895,3380,3307
0130-001,2016,12,27,18,1614,2170,3784,3380
0130-001,2016,12,27,19,1462,2135,3597,3784
0130-001,2016,12,27,20,1231,1695,2926,3597
0130-001,2016,12,27,21,1076,1510,2586,2926
0130-001,2016,12,27,22,1023,1127,2150,2586
0130-001,2016,12,27,23,764,712,1476,2150
0130-001,2016,12,27,24,524,473,997,1476
0130-001,2016,12,28,1,412,370,782,997
0130-001,2016,12,28,2,231,207,438,782
0130-001,2016,12,28,3,156,174,330,438
0130-001,2016,12,28,4,142,181,323,330
0130-001,2016,12,28,5,205,233,438,323
0130-001,2016,12,28,6,512,366,878,438
0130-001,2016,12,28,7,1491,703,2194,878
0130-001,2016,12,28,8,1349,1304,2653,2194
0130-001,2016,12,28,9,1536,1724,3260,2653
0130-001,2016,12,28,10,1451,1461,2912,3260
0130-001,2016,12,28,11,1613,1535,3148,2912
0130-001,2016,12,28,12,1494,1625,3119,3148
0130-001,2016,12,28,13,1448,1479,2927,3119
0130-001,2016,12,28,14,1674,1576,3250,2927
0130-001,2016,12,28,15,1632,1640,3272,3250
0130-001,2016,12,28,16,1541,1626,3167,3272
0130-001,2016,12,28,17,1501,1781,3282,3167
0130-001,2016,12,28,18,1531,2108,3639,3282
0130-001,2016,12,28,19,1506,2262,3768,3639
0130-001,2016,12,28,20,1187,1650,2837,3768
0130-001,2016,12,28,21,1094,1371,2465,2837
0130-001,2016,12,28,22,1142,1151,2293,2465
0130-001,2016,12,28,23,830,724,1554,2293
0130-001,2016,12,28,24,589,514,1103,1554
0130-001,2016,12,29,1,401,426,827,1103
0130-001,2016,12,29,2,293,244,537,827
0130-001,2016,12,29,3,189,204,393,537
0130-001,2016,12,29,4,166,200,366,393
0130-001,2016,12,29,5,224,242,466,366
0130-001,2016,12,29,6,499,362,861,466
0130-001,2016,12,29,7,1295,686,1981,861
0130-001,2016,12,29,8,1433,1226,2659,1981
0130-001,2016,12,29,9,1360,1464,2824,2659
0130-001,2016,12,29,10,1479,1358,2837,2824
0130-001,2016,12,29,11,1389,1424,2813,2837
0130-001,2016,12,29,12,1394,1546,2940,2813
0130-001,2016,12,29,13,1421,1477,2898,2940
0130-001,2016,12,29,14,1597,1608,3205,2898
0130-001,2016,12,29,15,1553,1641,3194,3205
0130-001,2016,12,29,16,1729,1652,3381,3194
0130-001,2016,12,29,17,1500,1796,3296,3381
0130-001,2016,12,29,18,1622,2192,3814,3296
0130-001,2016,12,29,19,1678,1987,3665,3814
0130-001,2016,12,29,20,1122,1550,2672,3665
0130-001,2016,12,29,21,1132,1377,2509,2672
0130-001,2016,12,29,22,1016,1008,2024,2509
0130-001,2016,12,29,23,875,696,1571,2024
0130-001,2016,12,29,24,593,559,1152,1571
0130-001,2016,12,30,1,434,392,826,1152
0130-001,2016,12,30,2,317,257,574,826
0130-001,2016,12,30,3,187,214,401,574
0130-001,2016,12,30,4,174,200,374,401
0130-001,2016,12,30,5,187,241,428,374
0130-001,2016,12,30,6,477,396,873,428
0130-001,2016,12,30,7,1293,673,1966,873
0130-001,2016,12,30,8,1551,1246,2797,1966
0130-001,2016,12,30,9,1460,1537,2997,2797
0130-001,2016,12,30,10,1528,1438,2966,2997
0130-001,2016,12,30,11,1599,1597,3196,2966
0130-001,2016,12,30,12,1559,1728,3287,3196
0130-001,2016,12,30,13,1430,1614,3044,3287
0130-001,2016,12,30,14,1684,1790,3474,3044
0130-001,2016,12,30,15,1512,1791,3303,3474
0130-001,2016,12,30,16,1619,1925,3544,3303
0130-001,2016,12,30,17,1692,2052,3744,3544
0130-001,2016,12,30,18,1745,2225,3970,3744
0130-001,2016,12,30,19,1612,2116,3728,3970
0130-001,2016,12,30,20,1408,1688,3096,3728
0130-001,2016,12,30,21,1138,1326,2464,3096
0130-001,2016,12,30,22,1036,1016,2052,2464
0130-001,2016,12,30,23,909,795,1704,2052
0130-001,2016,12,30,24,617,578,1195,1704
0130-001,2016,12,31,1,541,454,995,1195
0130-001,2016,12,31,2,400,302,702,995
0130-001,2016,12,31,3,289,256,545,702
0130-001,2016,12,31,4,246,259,505,545
0130-001,2016,12,31,5,237,251,488,505
0130-001,2016,12,31,6,373,338,711,488
0130-001,2016,12,31,7,721,527,1248,711
0130-001,2016,12,31,8,959,720,1679,1248
0130-001,2016,12,31,9,1112,1091,2203,1679
0130-001,2016,12,31,10,1279,1381,2660,2203
0130-001,2016,12,31,11,1441,1631,3072,2660
0130-001,2016,12,31,12,1564,1756,3320,3072
0130-001,2016,12,31,13,1576,1844,3420,3320
0130-001,2016,12,31,14,1627,1775,3402,3420
0130-001,2016,12,31,15,1602,1892,3494,3402
0130-001,2016,12,31,16,1755,1761,3516,3494
0130-001,2016,12,31,17,1856,1794,3650,3516
0130-001,2016,12,31,18,1812,1771,3583,3650
0130-001,2016,12,31,19,1588,1515,3103,3583
0130-001,2016,12,31,20,1220,1055,2275,3103
0130-001,2016,12,31,21,976,881,1857,2275
0130-001,2016,12,31,22,853,814,1667,1857
0130-001,2016,12,31,23,663,608,1271,1667
0130-001,2016,12,31,24,471,449,920,1271
0130-001,2017,1,1,1,509,412,921,920
0130-001,2017,1,1,2,366,375,741,921
0130-001,2017,1,1,3,266,250,516,741
0130-001,2017,1,1,4,176,166,342,516
0130-001,2017,1,1,5,195,165,360,342
0130-001,2017,1,1,6,217,212,429,360
0130-001,2017,1,1,7,368,293,661,429
0130-001,2017,1,1,8,418,344,762,661
0130-001,2017,1,1,9,556,549,1105,762
0130-001,2017,1,1,10,693,702,1395,1105
0130-001,2017,1,1,11,915,994,1909,1395
0130-001,2017,1,1,12,1004,1108,2112,1909
0130-001,2017,1,1,13,1254,1255,2509,2112
0130-001,2017,1,1,14,1321,1389,2710,2509
0130-001,2017,1,1,15,1407,1434,2841,2710
0130-001,2017,1,1,16,1439,1497,2936,2841
0130-001,2017,1,1,17,1433,1420,2853,2936
0130-001,2017,1,1,18,1348,1389,2737,2853
0130-001,2017,1,1,19,1199,1219,2418,2737
0130-001,2017,1,1,20,1116,1053,2169,2418
0130-001,2017,1,1,21,1031,890,1921,2169
0130-001,2017,1,1,22,842,686,1528,1921
0130-001,2017,1,1,23,628,551,1179,1528
0130-001,2017,1,1,24,404,364,768,1179
0130-001,2017,1,2,1,277,250,527,768
0130-001,2017,1,2,2,167,131,298,527
0130-001,2017,1,2,3,120,114,234,298
0130-001,2017,1,2,4,116,120,236,234
0130-001,2017,1,2,5,200,201,401,236
0130-001,2017,1,2,6,534,403,937,401
0130-001,2017,1,2,7,1474,829,2303,937
0130-001,2017,1,2,8,1467,1318,2785,2303
0130-001,2017,1,2,9,1471,1670,3141,2785
0130-001,2017,1,2,10,1380,1401,2781,3141
0130-001,2017,1,2,11,1453,1459,2912,2781
0130-001,2017,1,2,12,1439,1511,2950,2912
0130-001,2017,1,2,13,1345,1411,2756,2950
0130-001,2017,1,2,14,1541,1589,3130,2756
0130-001,2017,1,2,15,1615,1673,3288,3130
0130-001,2017,1,2,16,1744,1655,3399,3288
0130-001,2017,1,2,17,1521,1779,3300,3399
0130-001,2017,1,2,18,1560,2109,3669,3300
0130-001,2017,1,2,19,1532,2203,3735,3669
0130-001,2017,1,2,20,1129,1583,2712,3735
0130-001,2017,1,2,21,1060,1458,2518,2712
0130-001,2017,1,2,22,952,1093,2045,2518
0130-001,2017,1,2,23,642,619,1261,2045
0130-001,2017,1,2,24,446,440,886,1261
0130-001,2017,1,3,1,296,292,588,886
0130-001,2017,1,3,2,181,194,375,588
0130-001,2017,1,3,3,181,169,350,375
0130-001,2017,1,3,4,125,184,309,350
0130-001,2017,1,3,5,223,272,495,309
0130-001,2017,1,3,6,525,400,925,495
0130-001,2017,1,3,7,1514,735,2249,925
0130-001,2017,1,3,8,1458,1377,2835,2249
0130-001,2017,1,3,9,1659,1600,3259,2835
0130-001,2017,1,3,10,1519,1515,3034,3259
0130-001,2017,1,3,11,1543,1531,3074,3034
0130-001,2017,1,3,12,1485,1504,2989,3074
0130-001,2017,1,3,13,1365,1385,2750,2989
0130-001,2017,1,3,14,1622,1596,3218,2750
0130-001,2017,1,3,15,1570,1600,3170,3218
0130-001,2017,1,3,16,1565,1599,3164,3170
0130-001,2017,1,3,17,1432,1775,3207,3164
0130-001,2017,1,3,18,1578,2165,3743,3207
0130-001,2017,1,3,19,1531,2125,3656,3743
0130-001,2017,1,3,20,1207,1715,2922,3656
0130-001,2017,1,3,21,1113,1587,2700,2922
0130-001,2017,1,3,22,879,1141,2020,2700
0130-001,2017,1,3,23,727,704,1431,2020
0130-001,2017,1,3,24,429,508,937,1431
0130-001,2017,1,4,1,361,332,693,937
0130-001,2017,1,4,2,199,205,404,693
0130-001,2017,1,4,3,167,171,338,404
0130-001,2017,1,4,4,144,193,337,338
0130-001,2017,1,4,5,205,244,449,337
0130-001,2017,1,4,6,524,377,901,449
0130-001,2017,1,4,7,1542,776,2318,901
0130-001,2017,1,4,8,1500,1371,2871,2318
0130-001,2017,1,4,9,1555,1642,3197,2871
0130-001,2017,1,4,10,1518,1555,3073,3197
0130-001,2017,1,4,11,1493,1474,2967,3073
0130-001,2017,1,4,12,1511,1466,2977,2967
0130-001,2017,1,4,13,1298,1466,2764,2977
0130-001,2017,1,4,14,1552,1607,3159,2764
0130-001,2017,1,4,15,1565,1646,3211,3159
0130-001,2017,1,4,16,1625,1642,3267,3211
0130-001,2017,1,4,17,1482,1837,3319,3267
0130-001,2017,1,4,18,1533,2188,3721,3319
0130-001,2017,1,4,19,1492,2273,3765,3721
0130-001,2017,1,4,20,1208,1740,2948,3765
0130-001,2017,1,4,21,1096,1527,2623,2948
0130-001,2017,1,4,22,970,1391,2361,2623
0130-001,2017,1,4,23,741,635,1376,2361
0130-001,2017,1,4,24,523,488,1011,1376
0130-001,2017,1,5,1,335,339,674,1011
0130-001,2017,1,5,2,260,242,502,674
0130-001,2017,1,5,3,162,176,338,502
0130-001,2017,1,5,4,174,195,369,338
0130-001,2017,1,5,5,205,244,449,369
0130-001,2017,1,5,6,505,406,911,449
0130-001,2017,1,5,7,1551,772,2323,911
0130-001,2017,1,5,8,1468,1366,2834,2323
0130-001,2017,1,5,9,1628,1726,3354,2834
0130-001,2017,1,5,10,1538,1511,3049,3354
0130-001,2017,1,5,11,1591,1501,3092,3049
0130-001,2017,1,5,12,1496,1552,3048,3092
0130-001,2017,1,5,13,1389,1419,2808,3048
0130-001,2017,1,5,14,1579,1613,3192,2808
0130-001,2017,1,5,15,1570,1612,3182,3192
0130-001,2017,1,5,16,1567,1627,3194,3182
0130-001,2017,1,5,17,1523,1693,3216,3194
0130-001,2017,1,5,18,1518,2127,3645,3216
0130-001,2017,1,5,19,1499,2176,3675,3645
0130-001,2017,1,5,20,1169,1665,2834,3675
0130-001,2017,1,5,21,1069,1569,2638,2834
0130-001,2017,1,5,22,958,1127,2085,2638
0130-001,2017,1,5,23,746,726,1472,2085
0130-001,2017,1,5,24,526,490,1016,1472
0130-001,2017,1,6,1,366,399,765,1016
0130-001,2017,1,6,2,249,215,464,765
0130-001,2017,1,6,3,181,217,398,464
0130-001,2017,1,6,4,146,184,330,398
0130-001,2017,1,6,5,206,250,456,330
0130-001,2017,1,6,6,518,396,914,456
0130-001,2017,1,6,7,1530,732,2262,914
0130-001,2017,1,6,8,1626,1378,3004,2262
0130-001,2017,1,6,9,1611,1722,3333,3004
0130-001,2017,1,6,10,1586,1592,3178,3333
0130-001,2017,1,6,11,1575,1596,3171,3178
0130-001,2017,1,6,12,1562,1622,3184,3171
0130-001,2017,1,6,13,1418,1505,2923,3184
0130-001,2017,1,6,14,1586,1652,3238,2923
0130-001,2017,1,6,15,1690,1707,3397,3238
0130-001,2017,1,6,16,1615,1673,3288,3397
0130-001,2017,1,6,17,1581,1840,3421,3288
0130-001,2017,1,6,18,1642,2242,3884,3421
0130-001,2017,1,6,19,1464,2230,3694,3884
0130-001,2017,1,6,20,1390,1889,3279,3694
0130-001,2017,1,6,21,1168,1619,2787,3279
0130-001,2017,1,6,22,1059,1203,2262,2787
0130-001,2017,1,6,23,847,779,1626,2262
0130-001,2017,1,6,24,608,614,1222,1626
0130-001,2017,1,7,1,457,406,863,1222
0130-001,2017,1,7,2,312,278,590,863
0130-001,2017,1,7,3,257,239,496,590
0130-001,2017,1,7,4,202,198,400,496
0130-001,2017,1,7,5,241,316,557,400
0130-001,2017,1,7,6,476,392,868,557
0130-001,2017,1,7,7,995,672,1667,868
0130-001,2017,1,7,8,1311,927,2238,1667
0130-001,2017,1,7,9,1411,1339,2750,2238
0130-001,2017,1,7,10,1468,1591,3059,2750
0130-001,2017,1,7,11,1502,1641,3143,3059
0130-001,2017,1,7,12,1516,1601,3117,3143
0130-001,2017,1,7,13,1399,1721,3120,3117
0130-001,2017,1,7,14,1509,1724,3233,3120
0130-001,2017,1,7,15,1515,1677,3192,3233
0130-001,2017,1,7,16,1558,1710,3268,3192
0130-001,2017,1,7,17,1659,1839,3498,3268
0130-001,2017,1,7,18,1588,2013,3601,3498
0130-001,2017,1,7,19,1542,1733,3275,3601
0130-001,2017,1,7,20,1243,1275,2518,3275
0130-001,2017,1,7,21,1093,983,2076,2518
0130-001,2017,1,7,22,991,776,1767,2076
0130-001,2017,1,7,23,771,644,1415,1767
0130-001,2017,1,7,24,550,478,1028,1415
0130-001,2017,1,8,1,384,356,740,1028
0130-001,2017,1,8,2,248,244,492,740
0130-001,2017,1,8,3,235,213,448,492
0130-001,2017,1,8,4,163,175,338,448
0130-001,2017,1,8,5,191,183,374,338
0130-001,2017,1,8,6,299,273,572,374
0130-001,2017,1,8,7,516,406,922,572
0130-001,2017,1,8,8,648,513,1161,922
0130-001,2017,1,8,9,748,826,1574,1161
0130-001,2017,1,8,10,888,959,1847,1574
0130-001,2017,1,8,11,1062,1209,2271,1847
0130-001,2017,1,8,12,967,1184,2151,2271
0130-001,2017,1,8,13,1221,1293,2514,2151
0130-001,2017,1,8,14,1359,1474,2833,2514
0130-001,2017,1,8,15,1421,1358,2779,2833
0130-001,2017,1,8,16,1518,1432,2950,2779
0130-001,2017,1,8,17,1388,1458,2846,2950
0130-001,2017,1,8,18,1381,1521,2902,2846
0130-001,2017,1,8,19,1263,1207,2470,2902
0130-001,2017,1,8,20,1099,943,2042,2470
0130-001,2017,1,8,21,942,825,1767,2042
0130-001,2017,1,8,22,826,730,1556,1767
0130-001,2017,1,8,23,626,519,1145,1556
0130-001,2017,1,8,24,439,342,781,1145
0130-001,2017,1,9,1,250,219,469,781
0130-001,2017,1,9,2,168,174,342,469
0130-001,2017,1,9,3,116,123,239,342
0130-001,2017,1,9,4,106,149,255,239
0130-001,2017,1,9,5,205,197,402,255
0130-001,2017,1,9,6,573,414,987,402
0130-001,2017,1,9,7,1611,790,2401,987
0130-001,2017,1,9,8,1583,1408,2991,2401
0130-001,2017,1,9,9,1575,1677,3252,2991
0130-001,2017,1,9,10,1458,1495,2953,3252
0130-001,2017,1,9,11,1402,1523,2925,2953
0130-001,2017,1,9,12,1429,1544,2973,2925
0130-001,2017,1,9,13,1329,1456,2785,2973
0130-001,2017,1,9,14,1522,1566,3088,2785
0130-001,2017,1,9,15,1470,1638,3108,3088
0130-001,2017,1,9,16,1499,1685,3184,3108
0130-001,2017,1,9,17,1417,1799,3216,3184
0130-001,2017,1,9,18,1578,2145,3723,3216
0130-001,2017,1,9,19,1566,2134,3700,3723
0130-001,2017,1,9,20,1194,1624,2818,3700
0130-001,2017,1,9,21,1051,1582,2633,2818
0130-001,2017,1,9,22,895,1158,2053,2633
0130-001,2017,1,9,23,727,723,1450,2053
0130-001,2017,1,9,24,428,439,867,1450
0130-001,2017,1,10,1,285,282,567,867
0130-001,2017,1,10,2,204,175,379,567
0130-001,2017,1,10,3,167,172,339,379
0130-001,2017,1,10,4,191,166,357,339
0130-001,2017,1,10,5,198,233,431,357
0130-001,2017,1,10,6,500,404,904,431
0130-001,2017,1,10,7,1526,735,2261,904
0130-001,2017,1,10,8,1662,1362,3024,2261
0130-001,2017,1,10,9,1529,1725,3254,3024
0130-001,2017,1,10,10,1559,1508,3067,3254
0130-001,2017,1,10,11,1566,1512,3078,3067
0130-001,2017,1,10,12,1490,1449,2939,3078
0130-001,2017,1,10,13,1390,1430,2820,2939
0130-001,2017,1,10,14,1622,1593,3215,2820
0130-001,2017,1,10,15,1466,1627,3093,3215
0130-001,2017,1,10,16,1497,1645,3142,3093
0130-001,2017,1,10,17,1376,1760,3136,3142
0130-001,2017,1,10,18,1541,2074,3615,3136
0130-001,2017,1,10,19,1489,2145,3634,3615
0130-001,2017,1,10,20,1245,1707,2952,3634
0130-001,2017,1,10,21,1067,1504,2571,2952
0130-001,2017,1,10,22,974,1204,2178,2571
0130-001,2017,1,10,23,754,711,1465,2178
0130-001,2017,1,10,24,482,500,982,1465
0130-001,2017,1,11,1,314,313,627,982
0130-001,2017,1,11,2,213,182,395,627
0130-001,2017,1,11,3,170,164,334,395
0130-001,2017,1,11,4,157,169,326,334
0130-001,2017,1,11,5,185,214,399,326
0130-001,2017,1,11,6,518,376,894,399
0130-001,2017,1,11,7,1465,748,2213,894
0130-001,2017,1,11,8,1394,1280,2674,2213
0130-001,2017,1,11,9,1532,1626,3158,2674
0130-001,2017,1,11,10,1561,1492,3053,3158
0130-001,2017,1,11,11,1575,1490,3065,3053
0130-001,2017,1,11,12,1504,1512,3016,3065
0130-001,2017,1,11,13,1354,1375,2729,3016
0130-001,2017,1,11,14,1667,1668,3335,2729
0130-001,2017,1,11,15,1562,1581,3143,3335
0130-001,2017,1,11,16,1522,1561,3083,3143
0130-001,2017,1,11,17,1510,1761,3271,3083
0130-001,2017,1,11,18,1579,2278,3857,3271
0130-001,2017,1,11,19,1539,2206,3745,3857
0130-001,2017,1,11,20,1213,1677,2890,3745
0130-001,2017,1,11,21,1127,1411,2538,2890
0130-001,2017,1,11,22,990,1047,2037,2538
0130-001,2017,1,11,23,824,691,1515,2037
0130-001,2017,1,11,24,490,505,995,1515
0130-001,2017,1,12,1,325,349,674,995
0130-001,2017,1,12,2,209,199,408,674
0130-001,2017,1,12,3,158,170,328,408
0130-001,2017,1,12,4,143,188,331,328
0130-001,2017,1,12,5,167,235,402,331
0130-001,2017,1,12,6,504,338,842,402
0130-001,2017,1,12,7,1474,710,2184,842
0130-001,2017,1,12,8,1432,1313,2745,2184
0130-001,2017,1,12,9,1630,1709,3339,2745
0130-001,2017,1,12,10,1434,1309,2743,3339
0130-001,2017,1,12,11,1300,1373,2673,2743
0130-001,2017,1,12,12,1379,1457,2836,2673
0130-001,2017,1,12,13,1238,1343,2581,2836
0130-001,2017,1,12,14,1505,1542,3047,2581
0130-001,2017,1,12,15,1574,1595,3169,3047
0130-001,2017,1,12,16,1532,1565,3097,3169
0130-001,2017,1,12,17,1394,1693,3087,3097
0130-001,2017,1,12,18,1519,1981,3500,3087
0130-001,2017,1,12,19,1486,2136,3622,3500
0130-001,2017,1,12,20,1167,1684,2851,3622
0130-001,2017,1,12,21,1074,1555,2629,2851
0130-001,2017,1,12,22,988,1073,2061,2629
0130-001,2017,1,12,23,763,661,1424,2061
0130-001,2017,1,12,24,489,473,962,1424
0130-001,2017,1,13,1,350,310,660,962
0130-001,2017,1,13,2,221,206,427,660
0130-001,2017,1,13,3,162,173,335,427
0130-001,2017,1,13,4,167,188,355,335
0130-001,2017,1,13,5,194,242,436,355
0130-001,2017,1,13,6,506,358,864,436
0130-001,2017,1,13,7,1450,705,2155,864
0130-001,2017,1,13,8,1511,1294,2805,2155
0130-001,2017,1,13,9,1573,1659,3232,2805
0130-001,2017,1,13,10,1575,1517,3092,3232
0130-001,2017,1,13,11,1629,1574,3203,3092
0130-001,2017,1,13,12,1514,1434,2948,3203
0130-001,2017,1,13,13,1433,1401,2834,2948
0130-001,2017,1,13,14,1587,1649,3236,2834
0130-001,2017,1,13,15,1614,1540,3154,3236
0130-001,2017,1,13,16,1585,1681,3266,3154
0130-001,2017,1,13,17,1533,1876,3409,3266
0130-001,2017,1,13,18,1613,2157,3770,3409
0130-001,2017,1,13,19,1491,2191,3682,3770
0130-001,2017,1,13,20,1237,1809,3046,3682
0130-001,2017,1,13,21,1184,1552,2736,3046
0130-001,2017,1,13,22,1058,1051,2109,2736
0130-001,2017,1,13,23,825,733,1558,2109
0130-001,2017,1,13,24,558,513,1071,1558
0130-001,2017,1,14,1,437,389,826,1071
0130-001,2017,1,14,2,309,276,585,826
0130-001,2017,1,14,3,214,196,410,585
0130-001,2017,1,14,4,212,234,446,410
0130-001,2017,1,14,5,180,228,408,446
0130-001,2017,1,14,6,466,383,849,408
0130-001,2017,1,14,7,925,586,1511,849
0130-001,2017,1,14,8,1258,926,2184,1511
0130-001,2017,1,14,9,1469,1342,2811,2184
0130-001,2017,1,14,10,1507,1535,3042,2811
0130-001,2017,1,14,11,1552,1606,3158,3042
0130-001,2017,1,14,12,1483,1845,3328,3158
0130-001,2017,1,14,13,1575,1891,3466,3328
0130-001,2017,1,14,14,1646,1799,3445,3466
0130-001,2017,1,14,15,1665,1779,3444,3445
0130-001,2017,1,14,16,1639,1755,3394,3444
0130-001,2017,1,14,17,1673,1892,3565,3394
0130-001,2017,1,14,18,1771,2022,3793,3565
0130-001,2017,1,14,19,1682,1633,3315,3793
0130-001,2017,1,14,20,1226,1162,2388,3315
0130-001,2017,1,14,21,1049,921,1970,2388
0130-001,2017,1,14,22,981,752,1733,1970
0130-001,2017,1,14,23,727,556,1283,1733
0130-001,2017,1,14,24,513,452,965,1283
0130-001,2017,1,15,1,384,322,706,965
0130-001,2017,1,15,2,288,247,535,706
0130-001,2017,1,15,3,230,195,425,535
0130-001,2017,1,15,4,177,152,329,425
0130-001,2017,1,15,5,169,157,326,329
0130-001,2017,1,15,6,263,223,486,326
0130-001,2017,1,15,7,477,371,848,486
0130-001,2017,1,15,8,617,500,1117,848
0130-001,2017,1,15,9,726,809,1535,1117
0130-001,2017,1,15,10,832,997,1829,1535
0130-001,2017,1,15,11,1086,1233,2319,1829
0130-001,2017,1,15,12,1102,1329,2431,2319
0130-001,2017,1,15,13,1274,1283,2557,2431
0130-001,2017,1,15,14,1356,1493,2849,2557
0130-001,2017,1,15,15,1576,1582,3158,2849
0130-001,2017,1,15,16,1612,1545,3157,3158
0130-001,2017,1,15,17,1526,1505,3031,3157
0130-001,2017,1,15,18,1536,1532,3068,3031
0130-001,2017,1,15,19,1497,1178,2675,3068
0130-001,2017,1,15,20,1149,898,2047,2675
0130-001,2017,1,15,21,1067,840,1907,2047
0130-001,2017,1,15,22,910,652,1562,1907
0130-001,2017,1,15,23,571,486,1057,1562
0130-001,2017,1,15,24,425,352,777,1057
0130-001,2017,1,16,1,257,183,440,777
0130-001,2017,1,16,2,161,135,296,440
0130-001,2017,1,16,3,102,118,220,296
0130-001,2017,1,16,4,122,130,252,220
0130-001,2017,1,16,5,190,210,400,252
0130-001,2017,1,16,6,572,400,972,400
0130-001,2017,1,16,7,1567,757,2324,972
0130-001,2017,1,16,8,1441,1270,2711,2324
0130-001,2017,1,16,9,1602,1616,3218,2711
0130-001,2017,1,16,10,1437,1440,2877,3218
0130-001,2017,1,16,11,1649,1487,3136,2877
0130-001,2017,1,16,12,1563,1506,3069,3136
0130-001,2017,1,16,13,1454,1431,2885,3069
0130-001,2017,1,16,14,1639,1621,3260,2885
0130-001,2017,1,16,15,1570,1724,3294,3260
0130-001,2017,1,16,16,1650,1746,3396,3294
0130-001,2017,1,16,17,1484,1797,3281,3396
0130-001,2017,1,16,18,1650,2086,3736,3281
0130-001,2017,1,16,19,1579,2100,3679,3736
0130-001,2017,1,16,20,1186,1797,2983,3679
0130-001,2017,1,16,21,1083,1494,2577,2983
0130-001,2017,1,16,22,897,1090,1987,2577
0130-001,2017,1,16,23,690,674,1364,1987
0130-001,2017,1,16,24,443,452,895,1364
0130-001,2017,1,17,1,281,268,549,895
0130-001,2017,1,17,2,209,201,410,549
0130-001,2017,1,17,3,150,150,300,410
0130-001,2017,1,17,4,125,177,302,300
0130-001,2017,1,17,5,177,259,436,302
0130-001,2017,1,17,6,513,390,903,436
0130-001,2017,1,17,7,1517,717,2234,903
0130-001,2017,1,17,8,1364,1317,2681,2234
0130-001,2017,1,17,9,1681,1689,3370,2681
0130-001,2017,1,17,10,1512,1490,3002,3370
0130-001,2017,1,17,11,1650,1470,3120,3002
0130-001,2017,1,17,12,1546,1659,3205,3120
0130-001,2017,1,17,13,1511,1464,2975,3205
0130-001,2017,1,17,14,1627,1651,3278,2975
0130-001,2017,1,17,15,1737,1638,3375,3278
0130-001,2017,1,17,16,1615,1679,3294,3375
0130-001,2017,1,17,17,1627,1818,3445,3294
0130-001,2017,1,17,18,1646,2154,3800,3445
0130-001,2017,1,17,19,1591,2169,3760,3800
0130-001,2017,1,17,20,1185,1727,2912,3760
0130-001,2017,1,17,21,1055,1653,2708,2912
0130-001,2017,1,17,22,947,1187,2134,2708
0130-001,2017,1,17,23,783,751,1534,2134
0130-001,2017,1,17,24,461,464,925,1534
0130-001,2017,1,18,1,315,294,609,925
0130-001,2017,1,18,2,243,218,461,609
0130-001,2017,1,18,3,151,158,309,461
0130-001,2017,1,18,4,142,176,318,309
0130-001,2017,1,18,5,184,225,409,318
0130-001,2017,1,18,6,534,383,917,409
0130-001,2017,1,18,7,1500,712,2212,917
0130-001,2017,1,18,8,1442,1348,2790,2212
0130-001,2017,1,18,9,1609,1659,3268,2790
0130-001,2017,1,18,10,1549,1541,3090,3268
0130-001,2017,1,18,11,1670,1493,3163,3090
0130-001,2017,1,18,12,1589,1522,3111,3163
0130-001,2017,1,18,13,1390,1522,2912,3111
0130-001,2017,1,18,14,1621,1610,3231,2912
0130-001,2017,1,18,15,1555,1688,3243,3231
0130-001,2017,1,18,16,1570,1689,3259,3243
0130-001,2017,1,18,17,1577,1832,3409,3259
0130-001,2017,1,18,18,1604,2179,3783,3409
0130-001,2017,1,18,19,1473,2243,3716,3783
0130-001,2017,1,18,20,1259,1751,3010,3716
0130-001,2017,1,18,21,1100,1446,2546,3010
0130-001,2017,1,18,22,1039,1170,2209,2546
0130-001,2017,1,18,23,805,798,1603,2209
0130-001,2017,1,18,24,501,481,982,1603
0130-001,2017,1,19,1,375,351,726,982
0130-001,2017,1,19,2,276,206,482,726
0130-001,2017,1,19,3,166,186,352,482
0130-001,2017,1,19,4,140,201,341,352
0130-001,2017,1,19,5,196,236,432,341
0130-001,2017,1,19,6,525,411,936,432
0130-001,2017,1,19,7,1516,746,2262,936
0130-001,2017,1,19,8,1493,1342,2835,2262
0130-001,2017,1,19,9,1660,1690,3350,2835
0130-001,2017,1,19,10,1532,1492,3024,3350
0130-001,2017,1,19,11,1670,1554,3224,3024
0130-001,2017,1,19,12,1535,1561,3096,3224
0130-001,2017,1,19,13,1442,1412,2854,3096
0130-001,2017,1,19,14,1648,1628,3276,2854
0130-001,2017,1,19,15,1596,1716,3312,3276
0130-001,2017,1,19,16,1597,1729,3326,3312
0130-001,2017,1,19,17,1545,1862,3407,3326
0130-001,2017,1,19,18,1669,2208,3877,3407
0130-001,2017,1,19,19,1555,2149,3704,3877
0130-001,2017,1,19,20,1175,1733,2908,3704
0130-001,2017,1,19,21,1088,1596,2684,2908
0130-001,2017,1,19,22,1003,1195,2198,2684
0130-001,2017,1,19,23,750,756,1506,2198
0130-001,2017,1,19,24,492,527,1019,1506
0130-001,2017,1,20,1,410,368,778,1019
0130-001,2017,1,20,2,259,273,532,778
0130-001,2017,1,20,3,147,169,316,532
0130-001,2017,1,20,4,134,131,265,316
0130-001,2017,1,20,5,169,158,327,265
0130-001,2017,1,20,6,465,267,732,327
0130-001,2017,1,20,7,1243,520,1763,732
0130-001,2017,1,20,8,801,707,1508,1763
0130-001,2017,1,20,9,1110,1170,2280,1508
0130-001,2017,1,20,10,1304,1235,2539,2280
0130-001,2017,1,20,11,1274,1181,2455,2539
0130-001,2017,1,20,12,1208,1306,2514,2455
0130-001,2017,1,20,13,1234,1302,2536,2514
0130-001,2017,1,20,14,1404,1463,2867,2536
0130-001,2017,1,20,15,1555,1424,2979,2867
0130-001,2017,1,20,16,1456,1515,2971,2979
0130-001,2017,1,20,17,1483,1723,3206,2971
0130-001,2017,1,20,18,1577,1914,3491,3206
0130-001,2017,1,20,19,1503,1962,3465,3491
0130-001,2017,1,20,20,1202,1597,2799,3465
0130-001,2017,1,20,21,988,1287,2275,2799
0130-001,2017,1,20,22,877,949,1826,2275
0130-001,2017,1,20,23,776,604,1380,1826
0130-001,2017,1,20,24,504,443,947,1380
0130-001,2017,1,21,1,386,347,733,947
0130-001,2017,1,21,2,250,250,500,733
0130-001,2017,1,21,3,215,203,418,500
0130-001,2017,1,21,4,190,191,381,418
0130-001,2017,1,21,5,200,251,451,381
0130-001,2017,1,21,6,427,349,776,451
0130-001,2017,1,21,7,874,563,1437,776
0130-001,2017,1,21,8,1323,846,2169,1437
0130-001,2017,1,21,9,1374,1260,2634,2169
0130-001,2017,1,21,10,1369,1456,2825,2634
0130-001,2017,1,21,11,1478,1678,3156,2825
0130-001,2017,1,21,12,1543,1703,3246,3156
0130-001,2017,1,21,13,1584,1671,3255,3246
0130-001,2017,1,21,14,1622,1706,3328,3255
0130-001,2017,1,21,15,1647,1700,3347,3328
0130-001,2017,1,21,16,1582,1818,3400,3347
0130-001,2017,1,21,17,1662,1776,3438,3400
0130-001,2017,1,21,18,1698,1923,3621,3438
0130-001,2017,1,21,19,1535,1681,3216,3621
0130-001,2017,1,21,20,1180,1115,2295,3216
0130-001,2017,1,21,21,996,902,1898,2295
0130-001,2017,1,21,22,859,685,1544,1898
0130-001,2017,1,21,23,672,468,1140,1544
0130-001,2017,1,21,24,398,346,744,1140
0130-001,2017,1,22,1,303,223,526,744
0130-001,2017,1,22,2,212,149,361,526
0130-001,2017,1,22,3,189,138,327,361
0130-001,2017,1,22,4,143,98,241,327
0130-001,2017,1,22,5,150,99,249,241
0130-001,2017,1,22,6,189,140,329,249
0130-001,2017,1,22,7,436,243,679,329
0130-001,2017,1,22,8,582,401,983,679
0130-001,2017,1,22,9,638,613,1251,983
0130-001,2017,1,22,10,773,824,1597,1251
0130-001,2017,1,22,11,924,1050,1974,1597
0130-001,2017,1,22,12,939,1144,2083,1974
0130-001,2017,1,22,13,1144,1278,2422,2083
0130-001,2017,1,22,14,1154,1405,2559,2422
0130-001,2017,1,22,15,1321,1373,2694,2559
0130-001,2017,1,22,16,1393,1357,2750,2694
0130-001,2017,1,22,17,1391,1386,2777,2750
0130-001,2017,1,22,18,1394,1393,2787,2777
0130-001,2017,1,22,19,1303,987,2290,2787
0130-001,2017,1,22,20,983,732,1715,2290
0130-001,2017,1,22,21,778,646,1424,1715
0130-001,2017,1,22,22,690,533,1223,1424
0130-001,2017,1,22,23,514,388,902,1223
0130-001,2017,1,22,24,342,302,644,902
0130-001,2017,1,23,1,229,195,424,644
0130-001,2017,1,23,2,139,110,249,424
0130-001,2017,1,23,3,119,100,219,249
0130-001,2017,1,23,4,111,142,253,219
0130-001,2017,1,23,5,178,189,367,253
0130-001,2017,1,23,6,512,376,888,367
0130-001,2017,1,23,7,1544,715,2259,888
0130-001,2017,1,23,8,1445,1288,2733,2259
0130-001,2017,1,23,9,1684,1573,3257,2733
0130-001,2017,1,23,10,1506,1375,2881,3257
0130-001,2017,1,23,11,1555,1510,3065,2881
0130-001,2017,1,23,12,1564,1669,3233,3065
0130-001,2017,1,23,13,1495,1482,2977,3233
0130-001,2017,1,23,14,1764,1705,3469,2977
0130-001,2017,1,23,15,1716,1683,3399,3469
0130-001,2017,1,23,16,1670,1779,3449,3399
0130-001,2017,1,23,17,1731,1827,3558,3449
0130-001,2017,1,23,18,1690,2022,3712,3558
0130-001,2017,1,23,19,1600,1946,3546,3712
0130-001,2017,1,23,20,1260,1534,2794,3546
0130-001,2017,1,23,21,1110,1514,2624,2794
0130-001,2017,1,23,22,900,1117,2017,2624
0130-001,2017,1,23,23,736,696,1432,2017
0130-001,2017,1,23,24,454,450,904,1432
0130-001,2017,1,24,1,309,303,612,904
0130-001,2017,1,24,2,188,185,373,612
0130-001,2017,1,24,3,127,169,296,373
0130-001,2017,1,24,4,152,184,336,296
0130-001,2017,1,24,5,198,224,422,336
0130-001,2017,1,24,6,492,403,895,422
0130-001,2017,1,24,7,1528,668,2196,895
0130-001,2017,1,24,8,1436,1270,2706,2196
0130-001,2017,1,24,9,1626,1626,3252,2706
0130-001,2017,1,24,10,1637,1516,3153,3252
0130-001,2017,1,24,11,1618,1632,3250,3153
0130-001,2017,1,24,12,1605,1727,3332,3250
0130-001,2017,1,24,13,1495,1453,2948,3332
0130-001,2017,1,24,14,1832,1860,3692,2948
0130-001,2017,1,24,15,1703,1770,3473,3692
0130-001,2017,1,24,16,1652,1784,3436,3473
0130-001,2017,1,24,17,1663,1818,3481,3436
0130-001,2017,1,24,18,1595,2158,3753,3481
0130-001,2017,1,24,19,1632,2144,3776,3753
0130-001,2017,1,24,20,1340,1657,2997,3776
0130-001,2017,1,24,21,1180,1640,2820,2997
0130-001,2017,1,24,22,1063,1158,2221,2820
0130-001,2017,1,24,23,823,711,1534,2221
0130-001,2017,1,24,24,512,520,1032,1534
0130-001,2017,1,25,1,396,378,774,1032
0130-001,2017,1,25,2,241,206,447,774
0130-001,2017,1,25,3,160,154,314,447
0130-001,2017,1,25,4,150,195,345,314
0130-001,2017,1,25,5,197,240,437,345
0130-001,2017,1,25,6,499,358,857,437
0130-001,2017,1,25,7,1465,724,2189,857
0130-001,2017,1,25,8,1468,1286,2754,2189
0130-001,2017,1,25,9,1612,1646,3258,2754
0130-001,2017,1,25,10,1595,1437,3032,3258
0130-001,2017,1,25,11,1574,1607,3181,3032
0130-001,2017,1,25,12,1475,1738,3213,3181
0130-001,2017,1,25,13,1417,1562,2979,3213
0130-001,2017,1,25,14,1601,1750,3351,2979
0130-001,2017,1,25,15,1611,1800,3411,3351
0130-001,2017,1,25,16,1668,1972,3640,3411
0130-001,2017,1,25,17,1620,1970,3590,3640
0130-001,2017,1,25,18,1724,2282,4006,3590
0130-001,2017,1,25,19,1580,2291,3871,4006
0130-001,2017,1,25,20,1377,1849,3226,3871
0130-001,2017,1,25,21,1235,1564,2799,3226
0130-001,2017,1,25,22,1213,1242,2455,2799
0130-001,2017,1,25,23,918,779,1697,2455
0130-001,2017,1,25,24,569,553,1122,1697
0130-001,2017,1,26,1,414,402,816,1122
0130-001,2017,1,26,2,288,240,528,816
0130-001,2017,1,26,3,191,196,387,528
0130-001,2017,1,26,4,157,203,360,387
0130-001,2017,1,26,5,211,257,468,360
0130-001,2017,1,26,6,457,352,809,468
0130-001,2017,1,26,7,1322,617,1939,809
0130-001,2017,1,26,8,1664,1296,2960,1939
0130-001,2017,1,26,9,1563,1585,3148,2960
0130-001,2017,1,26,10,1638,1535,3173,3148
0130-001,2017,1,26,11,1687,1814,3501,3173
0130-001,2017,1,26,12,1742,1887,3629,3501
0130-001,2017,1,26,13,1455,1832,3287,3629
0130-001,2017,1,26,14,1753,2324,4077,3287
0130-001,2017,1,26,15,1704,2335,4039,4077
0130-001,2017,1,26,16,1679,2155,3834,4039
0130-001,2017,1,26,17,1462,1737,3199,3834
0130-001,2017,1,26,18,1547,2270,3817,3199
0130-001,2017,1,26,19,1522,2020,3542,3817
0130-001,2017,1,26,20,1282,2228,3510,3542
0130-001,2017,1,26,21,1135,1985,3120,3510
0130-001,2017,1,26,22,1009,1667,2676,3120
0130-001,2017,1,26,23,817,1256,2073,2676
0130-001,2017,1,26,24,531,757,1288,2073
0130-001,2017,1,27,1,424,578,1002,1288
0130-001,2017,1,27,2,311,460,771,1002
0130-001,2017,1,27,3,253,403,656,771
0130-001,2017,1,27,4,212,376,588,656
0130-001,2017,1,27,5,206,437,643,588
0130-001,2017,1,27,6,234,443,677,643
0130-001,2017,1,27,7,378,635,1013,677
0130-001,2017,1,27,8,513,1052,1565,1013
0130-001,2017,1,27,9,780,1092,1872,1565
0130-001,2017,1,27,10,1072,1242,2314,1872
0130-001,2017,1,27,11,1373,1456,2829,2314
0130-001,2017,1,27,12,1501,1316,2817,2829
0130-001,2017,1,27,13,1306,981,2287,2817
0130-001,2017,1,27,14,1131,938,2069,2287
0130-001,2017,1,27,15,1196,1053,2249,2069
0130-001,2017,1,27,16,1300,1406,2706,2249
0130-001,2017,1,27,17,1287,1225,2512,2706
0130-001,2017,1,27,18,1253,1137,2390,2512
0130-001,2017,1,27,19,1042,998,2040,2390
0130-001,2017,1,27,20,847,805,1652,2040
0130-001,2017,1,27,21,685,765,1450,1652
0130-001,2017,1,27,22,588,600,1188,1450
0130-001,2017,1,27,23,458,447,905,1188
0130-001,2017,1,27,24,338,283,621,905
0130-001,2017,1,28,1,201,186,387,621
0130-001,2017,1,28,2,177,125,302,387
0130-001,2017,1,28,3,98,80,178,302
0130-001,2017,1,28,4,90,71,161,178
0130-001,2017,1,28,5,85,103,188,161
0130-001,2017,1,28,6,162,151,313,188
0130-001,2017,1,28,7,495,294,789,313
0130-001,2017,1,28,8,929,613,1542,789
0130-001,2017,1,28,9,905,656,1561,1542
0130-001,2017,1,28,10,708,766,1474,1561
0130-001,2017,1,28,11,1182,1166,2348,1474
0130-001,2017,1,28,12,1848,1608,3456,2348
0130-001,2017,1,28,13,1637,1599,3236,3456
0130-001,2017,1,28,14,1812,1605,3417,3236
0130-001,2017,1,28,15,1809,1771,3580,3417
0130-001,2017,1,28,16,1668,1798,3466,3580
0130-001,2017,1,28,17,1842,1648,3490,3466
0130-001,2017,1,28,18,1749,1658,3407,3490
0130-001,2017,1,28,19,1559,1056,2615,3407
0130-001,2017,1,28,20,1362,869,2231,2615
0130-001,2017,1,28,21,1112,774,1886,2231
0130-001,2017,1,28,22,734,681,1415,1886
0130-001,2017,1,28,23,523,508,1031,1415
0130-001,2017,1,28,24,402,336,738,1031
0130-001,2017,1,29,1,313,237,550,738
0130-001,2017,1,29,2,224,153,377,550
0130-001,2017,1,29,3,183,108,291,377
0130-001,2017,1,29,4,121,84,205,291
0130-001,2017,1,29,5,116,95,211,205
0130-001,2017,1,29,6,145,119,264,211
0130-001,2017,1,29,7,275,174,449,264
0130-001,2017,1,29,8,272,272,544,449
0130-001,2017,1,29,9,448,419,867,544
0130-001,2017,1,29,10,621,666,1287,867
0130-001,2017,1,29,11,888,860,1748,1287
0130-001,2017,1,29,12,1039,1138,2177,1748
0130-001,2017,1,29,13,1226,1299,2525,2177
0130-001,2017,1,29,14,1243,1281,2524,2525
0130-001,2017,1,29,15,1451,1249,2700,2524
0130-001,2017,1,29,16,1651,1313,2964,2700
0130-001,2017,1,29,17,1632,1203,2835,2964
0130-001,2017,1,29,18,1610,1148,2758,2835
0130-001,2017,1,29,19,1540,1009,2549,2758
0130-001,2017,1,29,20,1431,731,2162,2549
0130-001,2017,1,29,21,1406,709,2115,2162
0130-001,2017,1,29,22,1070,540,1610,2115
0130-001,2017,1,29,23,892,416,1308,1610
0130-001,2017,1,29,24,541,302,843,1308
0130-001,2017,1,30,1,332,220,552,843
0130-001,2017,1,30,2,285,141,426,552
0130-001,2017,1,30,3,191,122,313,426
0130-001,2017,1,30,4,142,106,248,313
0130-001,2017,1,30,5,144,118,262,248
0130-001,2017,1,30,6,169,202,371,262
0130-001,2017,1,30,7,364,227,591,371
0130-001,2017,1,30,8,506,386,892,591
0130-001,2017,1,30,9,581,519,1100,892
0130-001,2017,1,30,10,716,670,1386,1100
0130-001,2017,1,30,11,834,887,1721,1386
0130-001,2017,1,30,12,976,1157,2133,1721
0130-001,2017,1,30,13,1058,1308,2366,2133
0130-001,2017,1,30,14,1295,1367,2662,2366
0130-001,2017,1,30,15,1247,1465,2712,2662
0130-001,2017,1,30,16,1512,1411,2923,2712
0130-001,2017,1,30,17,1447,1364,2811,2923
0130-001,2017,1,30,18,1451,1370,2821,2811
0130-001,2017,1,30,19,1320,1190,2510,2821
0130-001,2017,1,30,20,1100,820,1920,2510
0130-001,2017,1,30,21,959,701,1660,1920
0130-001,2017,1,30,22,795,608,1403,1660
0130-001,2017,1,30,23,603,489,1092,1403
0130-001,2017,1,30,24,443,347,790,1092
0130-001,2017,1,31,1,345,245,590,790
0130-001,2017,1,31,2,185,148,333,590
0130-001,2017,1,31,3,145,129,274,333
0130-001,2017,1,31,4,137,129,266,274
0130-001,2017,1,31,5,179,165,344,266
0130-001,2017,1,31,6,381,286,667,344
0130-001,2017,1,31,7,1226,538,1764,667
0130-001,2017,1,31,8,1683,1028,2711,1764
0130-001,2017,1,31,9,1511,1483,2994,2711
0130-001,2017,1,31,10,1326,1284,2610,2994
0130-001,2017,1,31,11,1477,1531,3008,2610
0130-001,2017,1,31,12,1496,1495,2991,3008
0130-001,2017,1,31,13,1413,1468,2881,2991
0130-001,2017,1,31,14,1530,1594,3124,2881
0130-001,2017,1,31,15,1649,1606,3255,3124
0130-001,2017,1,31,16,1629,1633,3262,3255
0130-001,2017,1,31,17,1677,1793,3470,3262
0130-001,2017,1,31,18,1583,1973,3556,3470
0130-001,2017,1,31,19,1526,2071,3597,3556
0130-001,2017,1,31,20,1253,1612,2865,3597
0130-001,2017,1,31,21,983,1437,2420,2865
0130-001,2017,1,31,22,856,1033,1889,2420
0130-001,2017,1,31,23,734,697,1431,1889
0130-001,2017,1,31,24,452,462,914,1431
0130-001,2017,2,1,1,325,279,604,914
0130-001,2017,2,1,2,225,213,438,604
0130-001,2017,2,1,3,136,141,277,438
0130-001,2017,2,1,4,135,174,309,277
0130-001,2017,2,1,5,188,232,420,309
0130-001,2017,2,1,6,481,370,851,420
0130-001,2017,2,1,7,1424,705,2129,851
0130-001,2017,2,1,8,1518,1281,2799,2129
0130-001,2017,2,1,9,1645,1676,3321,2799
0130-001,2017,2,1,10,1545,1522,3067,3321
0130-001,2017,2,1,11,1570,1486,3056,3067
0130-001,2017,2,1,12,1487,1453,2940,3056
0130-001,2017,2,1,13,1438,1371,2809,2940
0130-001,2017,2,1,14,1501,1513,3014,2809
0130-001,2017,2,1,15,1590,1638,3228,3014
0130-001,2017,2,1,16,1608,1649,3257,3228
0130-001,2017,2,1,17,1443,1747,3190,3257
0130-001,2017,2,1,18,1579,2133,3712,3190
0130-001,2017,2,1,19,1521,2049,3570,3712
0130-001,2017,2,1,20,1214,1771,2985,3570
0130-001,2017,2,1,21,1035,1470,2505,2985
0130-001,2017,2,1,22,967,1061,2028,2505
0130-001,2017,2,1,23,727,696,1423,2028
0130-001,2017,2,1,24,456,506,962,1423
0130-001,2017,2,2,1,343,344,687,962
0130-001,2017,2,2,2,229,209,438,687
0130-001,2017,2,2,3,139,172,311,438
0130-001,2017,2,2,4,137,158,295,311
0130-001,2017,2,2,5,183,220,403,295
0130-001,2017,2,2,6,465,363,828,403
0130-001,2017,2,2,7,1399,703,2102,828
0130-001,2017,2,2,8,1546,1245,2791,2102
0130-001,2017,2,2,9,1665,1667,3332,2791
0130-001,2017,2,2,10,1627,1446,3073,3332
0130-001,2017,2,2,11,1586,1482,3068,3073
0130-001,2017,2,2,12,1574,1522,3096,3068
0130-001,2017,2,2,13,1405,1461,2866,3096
0130-001,2017,2,2,14,1653,1629,3282,2866
0130-001,2017,2,2,15,1584,1699,3283,3282
0130-001,2017,2,2,16,1682,1659,3341,3283
0130-001,2017,2,2,17,1517,1764,3281,3341
0130-001,2017,2,2,18,1552,2089,3641,3281
0130-001,2017,2,2,19,1557,2176,3733,3641
0130-001,2017,2,2,20,1243,1715,2958,3733
0130-001,2017,2,2,21,1049,1561,2610,2958
0130-001,2017,2,2,22,929,1220,2149,2610
0130-001,2017,2,2,23,772,776,1548,2149
0130-001,2017,2,2,24,465,470,935,1548
0130-001,2017,2,3,1,371,339,710,935
0130-001,2017,2,3,2,219,226,445,710
0130-001,2017,2,3,3,163,196,359,445
0130-001,2017,2,3,4,131,169,300,359
0130-001,2017,2,3,5,201,233,434,300
0130-001,2017,2,3,6,492,372,864,434
0130-001,2017,2,3,7,1364,696,2060,864
0130-001,2017,2,3,8,1404,1308,2712,2060
0130-001,2017,2,3,9,1787,1779,3566,2712
0130-001,2017,2,3,10,1661,1476,3137,3566
0130-001,2017,2,3,11,1608,1522,3130,3137
0130-001,2017,2,3,12,1506,1509,3015,3130
0130-001,2017,2,3,13,1426,1520,2946,3015
0130-001,2017,2,3,14,1653,1620,3273,2946
0130-001,2017,2,3,15,1710,1710,3420,3273
0130-001,2017,2,3,16,1640,1741,3381,3420
0130-001,2017,2,3,17,1690,1761,3451,3381
0130-001,2017,2,3,18,1744,2269,4013,3451
0130-001,2017,2,3,19,1619,2321,3940,4013
0130-001,2017,2,3,20,1360,1840,3200,3940
0130-001,2017,2,3,21,1064,1712,2776,3200
0130-001,2017,2,3,22,987,1215,2202,2776
0130-001,2017,2,3,23,832,763,1595,2202
0130-001,2017,2,3,24,577,555,1132,1595
0130-001,2017,2,4,1,447,446,893,1132
0130-001,2017,2,4,2,335,305,640,893
0130-001,2017,2,4,3,238,233,471,640
0130-001,2017,2,4,4,203,241,444,471
0130-001,2017,2,4,5,203,247,450,444
0130-001,2017,2,4,6,418,323,741,450
0130-001,2017,2,4,7,872,581,1453,741
0130-001,2017,2,4,8,1356,899,2255,1453
0130-001,2017,2,4,9,1474,1305,2779,2255
0130-001,2017,2,4,10,1494,1529,3023,2779
0130-001,2017,2,4,11,1524,1771,3295,3023
0130-001,2017,2,4,12,1642,1702,3344,3295
0130-001,2017,2,4,13,1691,2012,3703,3344
0130-001,2017,2,4,14,1800,1832,3632,3703
0130-001,2017,2,4,15,1752,1846,3598,3632
0130-001,2017,2,4,16,1723,1861,3584,3598
0130-001,2017,2,4,17,1716,1906,3622,3584
0130-001,2017,2,4,18,1797,2109,3906,3622
0130-001,2017,2,4,19,1507,1800,3307,3906
0130-001,2017,2,4,20,1211,1161,2372,3307
0130-001,2017,2,4,21,1008,942,1950,2372
0130-001,2017,2,4,22,913,798,1711,1950
0130-001,2017,2,4,23,656,565,1221,1711
0130-001,2017,2,4,24,500,448,948,1221
0130-001,2017,2,5,1,370,358,728,948
0130-001,2017,2,5,2,261,253,514,728
0130-001,2017,2,5,3,213,180,393,514
0130-001,2017,2,5,4,179,182,361,393
0130-001,2017,2,5,5,190,179,369,361
0130-001,2017,2,5,6,257,242,499,369
0130-001,2017,2,5,7,470,340,810,499
0130-001,2017,2,5,8,574,515,1089,810
0130-001,2017,2,5,9,818,755,1573,1089
0130-001,2017,2,5,10,898,969,1867,1573
0130-001,2017,2,5,11,1107,1186,2293,1867
0130-001,2017,2,5,12,1166,1418,2584,2293
0130-001,2017,2,5,13,1286,1530,2816,2584
0130-001,2017,2,5,14,1505,1535,3040,2816
0130-001,2017,2,5,15,1451,1609,3060,3040
0130-001,2017,2,5,16,1551,1547,3098,3060
0130-001,2017,2,5,17,1505,1605,3110,3098
0130-001,2017,2,5,18,1466,1489,2955,3110
0130-001,2017,2,5,19,1346,1149,2495,2955
0130-001,2017,2,5,20,1120,896,2016,2495
0130-001,2017,2,5,21,919,721,1640,2016
0130-001,2017,2,5,22,807,649,1456,1640
0130-001,2017,2,5,23,577,472,1049,1456
0130-001,2017,2,5,24,399,333,732,1049
0130-001,2017,2,6,1,247,241,488,732
0130-001,2017,2,6,2,145,131,276,488
0130-001,2017,2,6,3,130,122,252,276
0130-001,2017,2,6,4,137,144,281,252
0130-001,2017,2,6,5,191,211,402,281
0130-001,2017,2,6,6,549,381,930,402
0130-001,2017,2,6,7,1560,767,2327,930
0130-001,2017,2,6,8,1515,1365,2880,2327
0130-001,2017,2,6,9,1752,1863,3615,2880
0130-001,2017,2,6,10,1530,1553,3083,3615
0130-001,2017,2,6,11,1632,1535,3167,3083
0130-001,2017,2,6,12,1479,1592,3071,3167
0130-001,2017,2,6,13,1373,1439,2812,3071
0130-001,2017,2,6,14,1562,1451,3013,2812
0130-001,2017,2,6,15,1663,1570,3233,3013
0130-001,2017,2,6,16,1588,1501,3089,3233
0130-001,2017,2,6,17,1554,1725,3279,3089
0130-001,2017,2,6,18,1542,2216,3758,3279
0130-001,2017,2,6,19,1649,2245,3894,3758
0130-001,2017,2,6,20,1248,1634,2882,3894
0130-001,2017,2,6,21,1066,1548,2614,2882
0130-001,2017,2,6,22,953,1257,2210,2614
0130-001,2017,2,6,23,693,725,1418,2210
0130-001,2017,2,6,24,489,506,995,1418
0130-001,2017,2,7,1,310,314,624,995
0130-001,2017,2,7,2,193,198,391,624
0130-001,2017,2,7,3,157,163,320,391
0130-001,2017,2,7,4,145,167,312,320
0130-001,2017,2,7,5,179,261,440,312
0130-001,2017,2,7,6,486,356,842,440
0130-001,2017,2,7,7,1444,704,2148,842
0130-001,2017,2,7,8,1516,1411,2927,2148
0130-001,2017,2,7,9,1638,1798,3436,2927
0130-001,2017,2,7,10,1567,1626,3193,3436
0130-001,2017,2,7,11,1596,1572,3168,3193
0130-001,2017,2,7,12,1509,1495,3004,3168
0130-001,2017,2,7,13,1386,1391,2777,3004
0130-001,2017,2,7,14,1595,1573,3168,2777
0130-001,2017,2,7,15,1653,1614,3267,3168
0130-001,2017,2,7,16,1600,1608,3208,3267
0130-001,2017,2,7,17,1429,1846,3275,3208
0130-001,2017,2,7,18,1623,2151,3774,3275
0130-001,2017,2,7,19,1515,2110,3625,3774
0130-001,2017,2,7,20,1253,1667,2920,3625
0130-001,2017,2,7,21,1081,1602,2683,2920
0130-001,2017,2,7,22,983,1185,2168,2683
0130-001,2017,2,7,23,746,743,1489,2168
0130-001,2017,2,7,24,468,535,1003,1489
0130-001,2017,2,8,1,360,367,727,1003
0130-001,2017,2,8,2,202,209,411,727
0130-001,2017,2,8,3,178,156,334,411
0130-001,2017,2,8,4,153,201,354,334
0130-001,2017,2,8,5,200,217,417,354
0130-001,2017,2,8,6,483,342,825,417
0130-001,2017,2,8,7,1465,730,2195,825
0130-001,2017,2,8,8,1619,1386,3005,2195
0130-001,2017,2,8,9,1707,1838,3545,3005
0130-001,2017,2,8,10,1570,1640,3210,3545
0130-001,2017,2,8,11,1587,1596,3183,3210
0130-001,2017,2,8,12,1558,1544,3102,3183
0130-001,2017,2,8,13,1472,1464,2936,3102
0130-001,2017,2,8,14,1722,1569,3291,2936
0130-001,2017,2,8,15,1595,1713,3308,3291
0130-001,2017,2,8,16,1581,1670,3251,3308
0130-001,2017,2,8,17,1536,1821,3357,3251
0130-001,2017,2,8,18,1655,2310,3965,3357
0130-001,2017,2,8,19,1568,2256,3824,3965
0130-001,2017,2,8,20,1247,1711,2958,3824
0130-001,2017,2,8,21,1028,1485,2513,2958
0130-001,2017,2,8,22,1018,1172,2190,2513
0130-001,2017,2,8,23,840,719,1559,2190
0130-001,2017,2,8,24,543,492,1035,1559
0130-001,2017,2,9,1,360,331,691,1035
0130-001,2017,2,9,2,229,246,475,691
0130-001,2017,2,9,3,166,180,346,475
0130-001,2017,2,9,4,132,173,305,346
0130-001,2017,2,9,5,196,239,435,305
0130-001,2017,2,9,6,498,376,874,435
0130-001,2017,2,9,7,1346,701,2047,874
0130-001,2017,2,9,8,1646,1403,3049,2047
0130-001,2017,2,9,9,1611,1749,3360,3049
0130-001,2017,2,9,10,1641,1547,3188,3360
0130-001,2017,2,9,11,1609,1589,3198,3188
0130-001,2017,2,9,12,1549,1558,3107,3198
0130-001,2017,2,9,13,1382,1485,2867,3107
0130-001,2017,2,9,14,1629,1658,3287,2867
0130-001,2017,2,9,15,1578,1642,3220,3287
0130-001,2017,2,9,16,1603,1723,3326,3220
0130-001,2017,2,9,17,1677,1853,3530,3326
0130-001,2017,2,9,18,1580,2227,3807,3530
0130-001,2017,2,9,19,1458,2104,3562,3807
0130-001,2017,2,9,20,1225,1617,2842,3562
0130-001,2017,2,9,21,1079,1619,2698,2842
0130-001,2017,2,9,22,1078,1183,2261,2698
0130-001,2017,2,9,23,772,748,1520,2261
0130-001,2017,2,9,24,506,516,1022,1520
0130-001,2017,2,10,1,369,317,686,1022
0130-001,2017,2,10,2,240,220,460,686
0130-001,2017,2,10,3,155,172,327,460
0130-001,2017,2,10,4,154,199,353,327
0130-001,2017,2,10,5,198,214,412,353
0130-001,2017,2,10,6,456,356,812,412
0130-001,2017,2,10,7,1356,691,2047,812
0130-001,2017,2,10,8,1506,1294,2800,2047
0130-001,2017,2,10,9,1626,1681,3307,2800
0130-001,2017,2,10,10,1505,1463,2968,3307
0130-001,2017,2,10,11,1476,1544,3020,2968
0130-001,2017,2,10,12,1464,1532,2996,3020
0130-001,2017,2,10,13,1490,1434,2924,2996
0130-001,2017,2,10,14,1546,1619,3165,2924
0130-001,2017,2,10,15,1655,1721,3376,3165
0130-001,2017,2,10,16,1685,1690,3375,3376
0130-001,2017,2,10,17,1625,1813,3438,3375
0130-001,2017,2,10,18,1681,2231,3912,3438
0130-001,2017,2,10,19,1599,2259,3858,3912
0130-001,2017,2,10,20,1421,1757,3178,3858
0130-001,2017,2,10,21,1127,1545,2672,3178
0130-001,2017,2,10,22,975,1111,2086,2672
0130-001,2017,2,10,23,819,755,1574,2086
0130-001,2017,2,10,24,560,507,1067,1574
0130-001,2017,2,11,1,421,396,817,1067
0130-001,2017,2,11,2,324,306,630,817
0130-001,2017,2,11,3,221,263,484,630
0130-001,2017,2,11,4,213,224,437,484
0130-001,2017,2,11,5,196,227,423,437
0130-001,2017,2,11,6,422,314,736,423
0130-001,2017,2,11,7,839,566,1405,736
0130-001,2017,2,11,8,1251,936,2187,1405
0130-001,2017,2,11,9,1397,1340,2737,2187
0130-001,2017,2,11,10,1530,1509,3039,2737
0130-001,2017,2,11,11,1608,1829,3437,3039
0130-001,2017,2,11,12,1615,1824,3439,3437
0130-001,2017,2,11,13,1605,1925,3530,3439
0130-001,2017,2,11,14,1709,1812,3521,3530
0130-001,2017,2,11,15,1663,1889,3552,3521
0130-001,2017,2,11,16,1722,1846,3568,3552
0130-001,2017,2,11,17,1746,1774,3520,3568
0130-001,2017,2,11,18,1820,2037,3857,3520
0130-001,2017,2,11,19,1687,1770,3457,3857
0130-001,2017,2,11,20,1267,1238,2505,3457
0130-001,2017,2,11,21,1074,997,2071,2505
0130-001,2017,2,11,22,969,836,1805,2071
0130-001,2017,2,11,23,727,637,1364,1805
0130-001,2017,2,11,24,520,466,986,1364
0130-001,2017,2,12,1,378,340,718,986
0130-001,2017,2,12,2,277,254,531,718
0130-001,2017,2,12,3,223,202,425,531
0130-001,2017,2,12,4,177,147,324,425
0130-001,2017,2,12,5,156,158,314,324
0130-001,2017,2,12,6,262,231,493,314
0130-001,2017,2,12,7,442,335,777,493
0130-001,2017,2,12,8,612,504,1116,777
0130-001,2017,2,12,9,754,782,1536,1116
0130-001,2017,2,12,10,908,1009,1917,1536
0130-001,2017,2,12,11,1192,1102,2294,1917
0130-001,2017,2,12,12,1114,1216,2330,2294
0130-001,2017,2,12,13,1253,1292,2545,2330
0130-001,2017,2,12,14,1338,1392,2730,2545
0130-001,2017,2,12,15,1383,1518,2901,2730
0130-001,2017,2,12,16,1499,1497,2996,2901
0130-001,2017,2,12,17,1588,1516,3104,2996
0130-001,2017,2,12,18,1507,1415,2922,3104
0130-001,2017,2,12,19,1393,1236,2629,2922
0130-001,2017,2,12,20,1178,969,2147,2629
0130-001,2017,2,12,21,961,851,1812,2147
0130-001,2017,2,12,22,795,710,1505,1812
0130-001,2017,2,12,23,623,524,1147,1505
0130-001,2017,2,12,24,409,377,786,1147
0130-001,2017,2,13,1,268,246,514,786
0130-001,2017,2,13,2,132,160,292,514
0130-001,2017,2,13,3,127,113,240,292
0130-001,2017,2,13,4,127,141,268,240
0130-001,2017,2,13,5,204,206,410,268
0130-001,2017,2,13,6,528,379,907,410
0130-001,2017,2,13,7,1549,747,2296,907
0130-001,2017,2,13,8,1540,1350,2890,2296
0130-001,2017,2,13,9,1641,1677,3318,2890
0130-001,2017,2,13,10,1468,1509,2977,3318
0130-001,2017,2,13,11,1724,1493,3217,2977
0130-001,2017,2,13,12,1466,1629,3095,3217
0130-001,2017,2,13,13,1474,1438,2912,3095
0130-001,2017,2,13,14,1592,1599,3191,2912
0130-001,2017,2,13,15,1645,1675,3320,3191
0130-001,2017,2,13,16,1552,1591,3143,3320
0130-001,2017,2,13,17,1509,1836,3345,3143
0130-001,2017,2,13,18,1527,2160,3687,3345
0130-001,2017,2,13,19,1515,2125,3640,3687
0130-001,2017,2,13,20,1227,1613,2840,3640
0130-001,2017,2,13,21,1040,1557,2597,2840
0130-001,2017,2,13,22,921,1229,2150,2597
0130-001,2017,2,13,23,687,648,1335,2150
0130-001,2017,2,13,24,460,417,877,1335
0130-001,2017,2,14,1,328,340,668,877
0130-001,2017,2,14,2,213,185,398,668
0130-001,2017,2,14,3,141,157,298,398
0130-001,2017,2,14,4,137,155,292,298
0130-001,2017,2,14,5,208,226,434,292
0130-001,2017,2,14,6,518,375,893,434
0130-001,2017,2,14,7,1417,707,2124,893
0130-001,2017,2,14,8,1601,1313,2914,2124
0130-001,2017,2,14,9,1623,1670,3293,2914
0130-001,2017,2,14,10,1585,1538,3123,3293
0130-001,2017,2,14,11,1612,1607,3219,3123
0130-001,2017,2,14,12,1522,1573,3095,3219
0130-001,2017,2,14,13,1456,1495,2951,3095
0130-001,2017,2,14,14,1622,1637,3259,2951
0130-001,2017,2,14,15,1622,1680,3302,3259
0130-001,2017,2,14,16,1607,1659,3266,3302
0130-001,2017,2,14,17,1509,1795,3304,3266
0130-001,2017,2,14,18,1283,1975,3258,3304
0130-001,2017,2,14,19,1543,2137,3680,3258
0130-001,2017,2,14,20,1285,1842,3127,3680
0130-001,2017,2,14,21,1135,1681,2816,3127
0130-001,2017,2,14,22,1009,1299,2308,2816
0130-001,2017,2,14,23,858,787,1645,2308
0130-001,2017,2,14,24,491,500,991,1645
0130-001,2017,2,15,1,344,352,696,991
0130-001,2017,2,15,2,248,204,452,696
0130-001,2017,2,15,3,153,190,343,452
0130-001,2017,2,15,4,139,173,312,343
0130-001,2017,2,15,5,216,233,449,312
0130-001,2017,2,15,6,502,318,820,449
0130-001,2017,2,15,7,1461,737,2198,820
0130-001,2017,2,15,8,1572,1366,2938,2198
0130-001,2017,2,15,9,1592,1685,3277,2938
0130-001,2017,2,15,10,1609,1601,3210,3277
0130-001,2017,2,15,11,1690,1603,3293,3210
0130-001,2017,2,15,12,1564,1576,3140,3293
0130-001,2017,2,15,13,1434,1494,2928,3140
0130-001,2017,2,15,14,1567,1644,3211,2928
0130-001,2017,2,15,15,1585,1686,3271,3211
0130-001,2017,2,15,16,1561,1583,3144,3271
0130-001,2017,2,15,17,1538,1783,3321,3144
0130-001,2017,2,15,18,1606,2337,3943,3321
0130-001,2017,2,15,19,1564,2267,3831,3943
0130-001,2017,2,15,20,1303,1764,3067,3831
0130-001,2017,2,15,21,1097,1443,2540,3067
0130-001,2017,2,15,22,983,1185,2168,2540
0130-001,2017,2,15,23,819,716,1535,2168
0130-001,2017,2,15,24,542,524,1066,1535
0130-001,2017,2,16,1,408,362,770,1066
0130-001,2017,2,16,2,259,247,506,770
0130-001,2017,2,16,3,144,189,333,506
0130-001,2017,2,16,4,171,195,366,333
0130-001,2017,2,16,5,192,246,438,366
0130-001,2017,2,16,6,486,351,837,438
0130-001,2017,2,16,7,1415,725,2140,837
0130-001,2017,2,16,8,1676,1349,3025,2140
0130-001,2017,2,16,9,1599,1753,3352,3025
0130-001,2017,2,16,10,1631,1559,3190,3352
0130-001,2017,2,16,11,1648,1548,3196,3190
0130-001,2017,2,16,12,1559,1611,3170,3196
0130-001,2017,2,16,13,1404,1510,2914,3170
0130-001,2017,2,16,14,1677,1648,3325,2914
0130-001,2017,2,16,15,1594,1622,3216,3325
0130-001,2017,2,16,16,1652,1672,3324,3216
0130-001,2017,2,16,17,1620,1807,3427,3324
0130-001,2017,2,16,18,1643,2220,3863,3427
0130-001,2017,2,16,19,1550,2263,3813,3863
0130-001,2017,2,16,20,1248,1743,2991,3813
0130-001,2017,2,16,21,1144,1664,2808,2991
0130-001,2017,2,16,22,1051,1311,2362,2808
0130-001,2017,2,16,23,821,763,1584,2362
0130-001,2017,2,16,24,542,551,1093,1584
0130-001,2017,2,17,1,384,330,714,1093
0130-001,2017,2,17,2,241,231,472,714
0130-001,2017,2,17,3,181,204,385,472
0130-001,2017,2,17,4,153,170,323,385
0130-001,2017,2,17,5,197,220,417,323
0130-001,2017,2,17,6,464,348,812,417
0130-001,2017,2,17,7,1414,748,2162,812
0130-001,2017,2,17,8,1558,1326,2884,2162
0130-001,2017,2,17,9,1604,1727,3331,2884
0130-001,2017,2,17,10,1578,1564,3142,3331
0130-001,2017,2,17,11,1588,1646,3234,3142
0130-001,2017,2,17,12,1516,1546,3062,3234
0130-001,2017,2,17,13,1431,1527,2958,3062
0130-001,2017,2,17,14,1625,1646,3271,2958
0130-001,2017,2,17,15,1651,1731,3382,3271
0130-001,2017,2,17,16,1518,1734,3252,3382
0130-001,2017,2,17,17,1600,1873,3473,3252
0130-001,2017,2,17,18,1703,2211,3914,3473
0130-001,2017,2,17,19,1608,2349,3957,3914
0130-001,2017,2,17,20,1375,1856,3231,3957
0130-001,2017,2,17,21,1237,1613,2850,3231
0130-001,2017,2,17,22,1120,1328,2448,2850
0130-001,2017,2,17,23,876,826,1702,2448
0130-001,2017,2,17,24,566,551,1117,1702
0130-001,2017,2,18,1,447,429,876,1117
0130-001,2017,2,18,2,313,302,615,876
0130-001,2017,2,18,3,242,224,466,615
0130-001,2017,2,18,4,189,223,412,466
0130-001,2017,2,18,5,202,266,468,412
0130-001,2017,2,18,6,474,352,826,468
0130-001,2017,2,18,7,917,575,1492,826
0130-001,2017,2,18,8,1322,957,2279,1492
0130-001,2017,2,18,9,1381,1385,2766,2279
0130-001,2017,2,18,10,1495,1593,3088,2766
0130-001,2017,2,18,11,1540,1775,3315,3088
0130-001,2017,2,18,12,1553,1877,3430,3315
0130-001,2017,2,18,13,1596,1924,3520,3430
0130-001,2017,2,18,14,1685,1850,3535,3520
0130-001,2017,2,18,15,1571,1791,3362,3535
0130-001,2017,2,18,16,1750,1783,3533,3362
0130-001,2017,2,18,17,1868,1844,3712,3533
0130-001,2017,2,18,18,1850,2106,3956,3712
0130-001,2017,2,18,19,1670,1791,3461,3956
0130-001,2017,2,18,20,1391,1446,2837,3461
0130-001,2017,2,18,21,1109,1179,2288,2837
0130-001,2017,2,18,22,979,777,1756,2288
0130-001,2017,2,18,23,812,666,1478,1756
0130-001,2017,2,18,24,543,453,996,1478
0130-001,2017,2,19,1,391,356,747,996
0130-001,2017,2,19,2,321,280,601,747
0130-001,2017,2,19,3,242,212,454,601
0130-001,2017,2,19,4,186,171,357,454
0130-001,2017,2,19,5,183,167,350,357
0130-001,2017,2,19,6,254,220,474,350
0130-001,2017,2,19,7,505,387,892,474
0130-001,2017,2,19,8,639,542,1181,892
0130-001,2017,2,19,9,807,819,1626,1181
0130-001,2017,2,19,10,964,1042,2006,1626
0130-001,2017,2,19,11,1117,1266,2383,2006
0130-001,2017,2,19,12,1118,1374,2492,2383
0130-001,2017,2,19,13,1350,1506,2856,2492
0130-001,2017,2,19,14,1409,1523,2932,2856
0130-001,2017,2,19,15,1520,1606,3126,2932
0130-001,2017,2,19,16,1642,1711,3353,3126
0130-001,2017,2,19,17,1591,1581,3172,3353
0130-001,2017,2,19,18,1639,1524,3163,3172
0130-001,2017,2,19,19,1520,1295,2815,3163
0130-001,2017,2,19,20,1194,1014,2208,2815
0130-001,2017,2,19,21,1029,816,1845,2208
0130-001,2017,2,19,22,814,688,1502,1845
0130-001,2017,2,19,23,629,499,1128,1502
0130-001,2017,2,19,24,417,357,774,1128
0130-001,2017,2,20,1,255,219,474,774
0130-001,2017,2,20,2,159,121,280,474
0130-001,2017,2,20,3,104,120,224,280
0130-001,2017,2,20,4,142,150,292,224
0130-001,2017,2,20,5,184,194,378,292
0130-001,2017,2,20,6,548,395,943,378
0130-001,2017,2,20,7,1584,787,2371,943
0130-001,2017,2,20,8,1636,1439,3075,2371
0130-001,2017,2,20,9,1568,1693,3261,3075
0130-001,2017,2,20,10,1571,1646,3217,3261
0130-001,2017,2,20,11,1648,1527,3175,3217
0130-001,2017,2,20,12,1559,1554,3113,3175
0130-001,2017,2,20,13,1378,1398,2776,3113
0130-001,2017,2,20,14,1664,1671,3335,2776
0130-001,2017,2,20,15,1599,1692,3291,3335
0130-001,2017,2,20,16,1672,1572,3244,3291
0130-001,2017,2,20,17,1513,1755,3268,3244
0130-001,2017,2,20,18,1662,2238,3900,3268
0130-001,2017,2,20,19,1636,2154,3790,3900
0130-001,2017,2,20,20,1221,1701,2922,3790
0130-001,2017,2,20,21,1063,1607,2670,2922
0130-001,2017,2,20,22,939,1160,2099,2670
0130-001,2017,2,20,23,671,710,1381,2099
0130-001,2017,2,20,24,421,442,863,1381
0130-001,2017,2,21,1,302,307,609,863
0130-001,2017,2,21,2,204,193,397,609
0130-001,2017,2,21,3,139,157,296,397
0130-001,2017,2,21,4,142,181,323,296
0130-001,2017,2,21,5,212,221,433,323
0130-001,2017,2,21,6,523,386,909,433
0130-001,2017,2,21,7,1474,783,2257,909
0130-001,2017,2,21,8,1425,1347,2772,2257
0130-001,2017,2,21,9,1605,1721,3326,2772
0130-001,2017,2,21,10,1704,1659,3363,3326
0130-001,2017,2,21,11,1647,1608,3255,3363
0130-001,2017,2,21,12,1616,1510,3126,3255
0130-001,2017,2,21,13,1418,1496,2914,3126
0130-001,2017,2,21,14,1741,1583,3324,2914
0130-001,2017,2,21,15,1662,1634,3296,3324
0130-001,2017,2,21,16,1629,1705,3334,3296
0130-001,2017,2,21,17,1580,1766,3346,3334
0130-001,2017,2,21,18,1611,2251,3862,3346
0130-001,2017,2,21,19,1569,2195,3764,3862
0130-001,2017,2,21,20,1259,1751,3010,3764
0130-001,2017,2,21,21,1121,1689,2810,3010
0130-001,2017,2,21,22,1104,1221,2325,2810
0130-001,2017,2,21,23,778,785,1563,2325
0130-001,2017,2,21,24,518,493,1011,1563
0130-001,2017,2,22,1,330,343,673,1011
0130-001,2017,2,22,2,206,207,413,673
0130-001,2017,2,22,3,175,193,368,413
0130-001,2017,2,22,4,145,167,312,368
0130-001,2017,2,22,5,216,203,419,312
0130-001,2017,2,22,6,483,359,842,419
0130-001,2017,2,22,7,1404,703,2107,842
0130-001,2017,2,22,8,1662,1441,3103,2107
0130-001,2017,2,22,9,1560,1728,3288,3103
0130-001,2017,2,22,10,1497,1480,2977,3288
0130-001,2017,2,22,11,1479,1476,2955,2977
0130-001,2017,2,22,12,1365,1460,2825,2955
0130-001,2017,2,22,13,1320,1402,2722,2825
0130-001,2017,2,22,14,1413,1457,2870,2722
0130-001,2017,2,22,15,1515,1509,3024,2870
0130-001,2017,2,22,16,1502,1498,3000,3024
0130-001,2017,2,22,17,1390,1634,3024,3000
0130-001,2017,2,22,18,1441,2041,3482,3024
0130-001,2017,2,22,19,1499,2216,3715,3482
0130-001,2017,2,22,20,1191,1443,2634,3715
0130-001,2017,2,22,21,982,1449,2431,2634
0130-001,2017,2,22,22,999,1135,2134,2431
0130-001,2017,2,22,23,708,710,1418,2134
0130-001,2017,2,22,24,487,459,946,1418
0130-001,2017,2,23,1,375,352,727,946
0130-001,2017,2,23,2,241,232,473,727
0130-001,2017,2,23,3,171,162,333,473
0130-001,2017,2,23,4,123,182,305,333
0130-001,2017,2,23,5,192,215,407,305
0130-001,2017,2,23,6,483,374,857,407
0130-001,2017,2,23,7,1427,709,2136,857
0130-001,2017,2,23,8,1587,1404,2991,2136
0130-001,2017,2,23,9,1647,1728,3375,2991
0130-001,2017,2,23,10,1667,1608,3275,3375
0130-001,2017,2,23,11,1605,1618,3223,3275
0130-001,2017,2,23,12,1506,1625,3131,3223
0130-001,2017,2,23,13,1522,1491,3013,3131
0130-001,2017,2,23,14,1716,1690,3406,3013
0130-001,2017,2,23,15,1633,1637,3270,3406
0130-001,2017,2,23,16,1560,1757,3317,3270
0130-001,2017,2,23,17,1495,1810,3305,3317
0130-001,2017,2,23,18,1708,2226,3934,3305
0130-001,2017,2,23,19,1636,2127,3763,3934
0130-001,2017,2,23,20,1253,1824,3077,3763
0130-001,2017,2,23,21,1158,1633,2791,3077
0130-001,2017,2,23,22,1094,1297,2391,2791
0130-001,2017,2,23,23,831,808,1639,2391
0130-001,2017,2,23,24,503,544,1047,1639
0130-001,2017,2,24,1,392,376,768,1047
0130-001,2017,2,24,2,251,229,480,768
0130-001,2017,2,24,3,164,181,345,480
0130-001,2017,2,24,4,155,177,332,345
0130-001,2017,2,24,5,204,247,451,332
0130-001,2017,2,24,6,519,390,909,451
0130-001,2017,2,24,7,1414,730,2144,909
0130-001,2017,2,24,8,1695,1331,3026,2144
0130-001,2017,2,24,9,1642,1737,3379,3026
0130-001,2017,2,24,10,1619,1601,3220,3379
0130-001,2017,2,24,11,1663,1603,3266,3220
0130-001,2017,2,24,12,1556,1605,3161,3266
0130-001,2017,2,24,13,1478,1492,2970,3161
0130-001,2017,2,24,14,1681,1684,3365,2970
0130-001,2017,2,24,15,1629,1721,3350,3365
0130-001,2017,2,24,16,1617,1745,3362,3350
0130-001,2017,2,24,17,1554,1819,3373,3362
0130-001,2017,2,24,18,1595,2356,3951,3373
0130-001,2017,2,24,19,1686,2178,3864,3951
0130-001,2017,2,24,20,1465,1874,3339,3864
0130-001,2017,2,24,21,1149,1603,2752,3339
0130-001,2017,2,24,22,1140,1255,2395,2752
0130-001,2017,2,24,23,886,838,1724,2395
0130-001,2017,2,24,24,612,613,1225,1724
0130-001,2017,2,25,1,477,424,901,1225
0130-001,2017,2,25,2,323,316,639,901
0130-001,2017,2,25,3,227,233,460,639
0130-001,2017,2,25,4,192,239,431,460
0130-001,2017,2,25,5,188,255,443,431
0130-001,2017,2,25,6,447,369,816,443
0130-001,2017,2,25,7,940,626,1566,816
0130-001,2017,2,25,8,1316,1045,2361,1566
0130-001,2017,2,25,9,1472,1401,2873,2361
0130-001,2017,2,25,10,1439,1497,2936,2873
0130-001,2017,2,25,11,1656,1757,3413,2936
0130-001,2017,2,25,12,1698,1899,3597,3413
0130-001,2017,2,25,13,1624,1930,3554,3597
0130-001,2017,2,25,14,1804,1774,3578,3554
0130-001,2017,2,25,15,1785,1849,3634,3578
0130-001,2017,2,25,16,1869,1908,3777,3634
0130-001,2017,2,25,17,1850,1913,3763,3777
0130-001,2017,2,25,18,1862,2153,4015,3763
0130-001,2017,2,25,19,1754,1916,3670,4015
0130-001,2017,2,25,20,1527,1323,2850,3670
0130-001,2017,2,25,21,1131,1049,2180,2850
0130-001,2017,2,25,22,1022,896,1918,2180
0130-001,2017,2,25,23,748,695,1443,1918
0130-001,2017,2,25,24,537,449,986,1443
0130-001,2017,2,26,1,427,357,784,986
0130-001,2017,2,26,2,298,268,566,784
0130-001,2017,2,26,3,225,220,445,566
0130-001,2017,2,26,4,187,162,349,445
0130-001,2017,2,26,5,189,150,339,349
0130-001,2017,2,26,6,257,257,514,339
0130-001,2017,2,26,7,551,405,956,514
0130-001,2017,2,26,8,689,554,1243,956
0130-001,2017,2,26,9,864,845,1709,1243
0130-001,2017,2,26,10,967,1043,2010,1709
0130-001,2017,2,26,11,1217,1241,2458,2010
0130-001,2017,2,26,12,1187,1286,2473,2458
0130-001,2017,2,26,13,1370,1352,2722,2473
0130-001,2017,2,26,14,1451,1429,2880,2722
0130-001,2017,2,26,15,1449,1580,3029,2880
0130-001,2017,2,26,16,1500,1518,3018,3029
0130-001,2017,2,26,17,1415,1536,2951,3018
0130-001,2017,2,26,18,1520,1544,3064,2951
0130-001,2017,2,26,19,1361,1341,2702,3064
0130-001,2017,2,26,20,1227,1023,2250,2702
0130-001,2017,2,26,21,1155,915,2070,2250
0130-001,2017,2,26,22,827,786,1613,2070
0130-001,2017,2,26,23,604,560,1164,1613
0130-001,2017,2,26,24,471,369,840,1164
0130-001,2017,2,27,1,285,232,517,840
0130-001,2017,2,27,2,165,163,328,517
0130-001,2017,2,27,3,105,120,225,328
0130-001,2017,2,27,4,119,148,267,225
0130-001,2017,2,27,5,219,222,441,267
0130-001,2017,2,27,6,592,407,999,441
0130-001,2017,2,27,7,1619,823,2442,999
0130-001,2017,2,27,8,1682,1491,3173,2442
0130-001,2017,2,27,9,1760,1732,3492,3173
0130-001,2017,2,27,10,1555,1637,3192,3492
0130-001,2017,2,27,11,1699,1424,3123,3192
0130-001,2017,2,27,12,1549,1712,3261,3123
0130-001,2017,2,27,13,1430,1518,2948,3261
0130-001,2017,2,27,14,1736,1448,3184,2948
0130-001,2017,2,27,15,1574,1768,3342,3184
0130-001,2017,2,27,16,1562,1828,3390,3342
0130-001,2017,2,27,17,1448,1846,3294,3390
0130-001,2017,2,27,18,1594,2259,3853,3294
0130-001,2017,2,27,19,1619,2260,3879,3853
0130-001,2017,2,27,20,1325,1787,3112,3879
0130-001,2017,2,27,21,1116,1652,2768,3112
0130-001,2017,2,27,22,1018,1246,2264,2768
0130-001,2017,2,27,23,767,791,1558,2264
0130-001,2017,2,27,24,465,521,986,1558
0130-001,2017,2,28,1,345,331,676,986
0130-001,2017,2,28,2,215,231,446,676
0130-001,2017,2,28,3,132,153,285,446
0130-001,2017,2,28,4,154,198,352,285
0130-001,2017,2,28,5,234,262,496,352
0130-001,2017,2,28,6,547,408,955,496
0130-001,2017,2,28,7,1494,794,2288,955
0130-001,2017,2,28,8,1596,1420,3016,2288
0130-001,2017,2,28,9,1771,1772,3543,3016
0130-001,2017,2,28,10,1627,1645,3272,3543
0130-001,2017,2,28,11,1700,1575,3275,3272
0130-001,2017,2,28,12,1597,1581,3178,3275
0130-001,2017,2,28,13,1462,1470,2932,3178
0130-001,2017,2,28,14,1682,1718,3400,2932
0130-001,2017,2,28,15,1626,1692,3318,3400
0130-001,2017,2,28,16,1628,1719,3347,3318
0130-001,2017,2,28,17,1620,1883,3503,3347
0130-001,2017,2,28,18,1629,2336,3965,3503
0130-001,2017,2,28,19,1588,2391,3979,3965
0130-001,2017,2,28,20,1409,2000,3409,3979
0130-001,2017,2,28,21,1208,1756,2964,3409
0130-001,2017,2,28,22,1099,1422,2521,2964
0130-001,2017,2,28,23,868,826,1694,2521
0130-001,2017,2,28,24,631,596,1227,1694
0130-001,2017,3,1,1,433,469,902,1227
0130-001,2017,3,1,2,305,306,611,902
0130-001,2017,3,1,3,237,224,461,611
0130-001,2017,3,1,4,203,237,440,461
0130-001,2017,3,1,5,256,255,511,440
0130-001,2017,3,1,6,488,378,866,511
0130-001,2017,3,1,7,1063,598,1661,866
0130-001,2017,3,1,8,1226,878,2104,1661
0130-001,2017,3,1,9,1290,1167,2457,2104
0130-001,2017,3,1,10,1215,1220,2435,2457
0130-001,2017,3,1,11,1328,1473,2801,2435
0130-001,2017,3,1,12,1461,1695,3156,2801
0130-001,2017,3,1,13,1474,1666,3140,3156
0130-001,2017,3,1,14,1578,1752,3330,3140
0130-001,2017,3,1,15,1583,1697,3280,3330
0130-001,2017,3,1,16,1660,1726,3386,3280
0130-001,2017,3,1,17,1563,1791,3354,3386
0130-001,2017,3,1,18,1533,1950,3483,3354
0130-001,2017,3,1,19,1607,1613,3220,3483
0130-001,2017,3,1,20,1283,1277,2560,3220
0130-001,2017,3,1,21,1096,1047,2143,2560
0130-001,2017,3,1,22,942,771,1713,2143
0130-001,2017,3,1,23,632,512,1144,1713
0130-001,2017,3,1,24,408,352,760,1144
0130-001,2017,3,2,1,238,263,501,760
0130-001,2017,3,2,2,176,163,339,501
0130-001,2017,3,2,3,114,132,246,339
0130-001,2017,3,2,4,104,147,251,246
0130-001,2017,3,2,5,165,202,367,251
0130-001,2017,3,2,6,528,402,930,367
0130-001,2017,3,2,7,1530,841,2371,930
0130-001,2017,3,2,8,1563,1589,3152,2371
0130-001,2017,3,2,9,1754,1841,3595,3152
0130-001,2017,3,2,10,1674,1621,3295,3595
0130-001,2017,3,2,11,1632,1562,3194,3295
0130-001,2017,3,2,12,1521,1524,3045,3194
0130-001,2017,3,2,13,1426,1499,2925,3045
0130-001,2017,3,2,14,1648,1722,3370,2925
0130-001,2017,3,2,15,1645,1672,3317,3370
0130-001,2017,3,2,16,1706,1517,3223,3317
0130-001,2017,3,2,17,1550,1952,3502,3223
0130-001,2017,3,2,18,1599,2200,3799,3502
0130-001,2017,3,2,19,1536,2197,3733,3799
0130-001,2017,3,2,20,1313,1711,3024,3733
0130-001,2017,3,2,21,1149,1650,2799,3024
0130-001,2017,3,2,22,969,1239,2208,2799
0130-001,2017,3,2,23,789,791,1580,2208
0130-001,2017,3,2,24,489,520,1009,1580
0130-001,2017,3,3,1,371,362,733,1009
0130-001,2017,3,3,2,194,218,412,733
0130-001,2017,3,3,3,155,162,317,412
0130-001,2017,3,3,4,137,173,310,317
0130-001,2017,3,3,5,199,232,431,310
0130-001,2017,3,3,6,536,415,951,431
0130-001,2017,3,3,7,1566,843,2409,951
0130-001,2017,3,3,8,1605,1564,3169,2409
0130-001,2017,3,3,9,1817,1858,3675,3169
0130-001,2017,3,3,10,1662,1573,3235,3675
0130-001,2017,3,3,11,1657,1590,3247,3235
0130-001,2017,3,3,12,1618,1653,3271,3247
0130-001,2017,3,3,13,1429,1506,2935,3271
0130-001,2017,3,3,14,1663,1625,3288,2935
0130-001,2017,3,3,15,1731,1719,3450,3288
0130-001,2017,3,3,16,1614,1744,3358,3450
0130-001,2017,3,3,17,1474,1905,3379,3358
0130-001,2017,3,3,18,1733,2274,4007,3379
0130-001,2017,3,3,19,1691,2449,4140,4007
0130-001,2017,3,3,20,1388,1882,3270,4140
0130-001,2017,3,3,21,1171,1630,2801,3270
0130-001,2017,3,3,22,1056,1240,2296,2801
0130-001,2017,3,3,23,842,843,1685,2296
0130-001,2017,3,3,24,604,562,1166,1685
0130-001,2017,3,4,1,414,412,826,1166
0130-001,2017,3,4,2,337,288,625,826
0130-001,2017,3,4,3,225,223,448,625
0130-001,2017,3,4,4,198,226,424,448
0130-001,2017,3,4,5,237,274,511,424
0130-001,2017,3,4,6,463,382,845,511
0130-001,2017,3,4,7,1042,676,1718,845
0130-001,2017,3,4,8,1359,1076,2435,1718
0130-001,2017,3,4,9,1508,1507,3015,2435
0130-001,2017,3,4,10,1452,1624,3076,3015
0130-001,2017,3,4,11,1522,1768,3290,3076
0130-001,2017,3,4,12,1522,1778,3300,3290
0130-001,2017,3,4,13,1560,1750,3310,3300
0130-001,2017,3,4,14,1571,1628,3199,3310
0130-001,2017,3,4,15,1609,1732,3341,3199
0130-001,2017,3,4,16,1603,1799,3402,3341
0130-001,2017,3,4,17,1695,1823,3518,3402
0130-001,2017,3,4,18,1810,2036,3846,3518
0130-001,2017,3,4,19,1658,1880,3538,3846
0130-001,2017,3,4,20,1332,1314,2646,3538
0130-001,2017,3,4,21,1070,1050,2120,2646
0130-001,2017,3,4,22,1015,839,1854,2120
0130-001,2017,3,4,23,742,610,1352,1854
0130-001,2017,3,4,24,516,463,979,1352
0130-001,2017,3,5,1,425,352,777,979
0130-001,2017,3,5,2,288,266,554,777
0130-001,2017,3,5,3,220,193,413,554
0130-001,2017,3,5,4,180,163,343,413
0130-001,2017,3,5,5,157,147,304,343
0130-001,2017,3,5,6,307,200,507,304
0130-001,2017,3,5,7,549,412,961,507
0130-001,2017,3,5,8,756,627,1383,961
0130-001,2017,3,5,9,976,990,1966,1383
0130-001,2017,3,5,10,976,1095,2071,1966
0130-001,2017,3,5,11,1178,1342,2520,2071
0130-001,2017,3,5,12,1168,1460,2628,2520
0130-001,2017,3,5,13,1405,1395,2800,2628
0130-001,2017,3,5,14,1438,1321,2759,2800
0130-001,2017,3,5,15,1562,1627,3189,2759
0130-001,2017,3,5,16,1584,1644,3228,3189
0130-001,2017,3,5,17,1537,1624,3161,3228
0130-001,2017,3,5,18,1598,1616,3214,3161
0130-001,2017,3,5,19,1485,1469,2954,3214
0130-001,2017,3,5,20,1244,1103,2347,2954
0130-001,2017,3,5,21,1055,951,2006,2347
0130-001,2017,3,5,22,888,763,1651,2006
0130-001,2017,3,5,23,632,465,1097,1651
0130-001,2017,3,5,24,430,341,771,1097
0130-001,2017,3,6,1,248,225,473,771
0130-001,2017,3,6,2,170,125,295,473
0130-001,2017,3,6,3,126,127,253,295
0130-001,2017,3,6,4,113,132,245,253
0130-001,2017,3,6,5,178,206,384,245
0130-001,2017,3,6,6,586,411,997,384
0130-001,2017,3,6,7,1631,879,2510,997
0130-001,2017,3,6,8,1456,1635,3091,2510
0130-001,2017,3,6,9,1424,1798,3222,3091
0130-001,2017,3,6,10,1651,1579,3230,3222
0130-001,2017,3,6,11,1563,1486,3049,3230
0130-001,2017,3,6,12,1469,1635,3104,3049
0130-001,2017,3,6,13,1406,1382,2788,3104
0130-001,2017,3,6,14,1618,1618,3236,2788
0130-001,2017,3,6,15,1530,1595,3125,3236
0130-001,2017,3,6,16,1519,1624,3143,3125
0130-001,2017,3,6,17,1539,1877,3416,3143
0130-001,2017,3,6,18,1557,2200,3757,3416
0130-001,2017,3,6,19,1526,2236,3762,3757
0130-001,2017,3,6,20,1307,1728,3035,3762
0130-001,2017,3,6,21,1064,1635,2699,3035
0130-001,2017,3,6,22,1033,1212,2245,2699
0130-001,2017,3,6,23,721,774,1495,2245
0130-001,2017,3,6,24,460,476,936,1495
0130-001,2017,3,7,1,311,315,626,936
0130-001,2017,3,7,2,198,205,403,626
0130-001,2017,3,7,3,141,151,292,403
0130-001,2017,3,7,4,109,160,269,292
0130-001,2017,3,7,5,169,207,376,269
0130-001,2017,3,7,6,517,412,929,376
0130-001,2017,3,7,7,1453,879,2332,929
0130-001,2017,3,7,8,1431,1579,3010,2332
0130-001,2017,3,7,9,1592,1902,3494,3010
0130-001,2017,3,7,10,1526,1641,3167,3494
0130-001,2017,3,7,11,1533,1530,3063,3167
0130-001,2017,3,7,12,1507,1553,3060,3063
0130-001,2017,3,7,13,1438,1359,2797,3060
0130-001,2017,3,7,14,1537,1527,3064,2797
0130-001,2017,3,7,15,1512,1566,3078,3064
0130-001,2017,3,7,16,1559,1682,3241,3078
0130-001,2017,3,7,17,1476,1894,3370,3241
0130-001,2017,3,7,18,1644,2161,3805,3370
0130-001,2017,3,7,19,1526,2372,3898,3805
0130-001,2017,3,7,20,1260,1721,2981,3898
0130-001,2017,3,7,21,1072,1705,2777,2981
0130-001,2017,3,7,22,1066,1219,2285,2777
0130-001,2017,3,7,23,795,796,1591,2285
0130-001,2017,3,7,24,488,527,1015,1591
0130-001,2017,3,8,1,327,337,664,1015
0130-001,2017,3,8,2,197,214,411,664
0130-001,2017,3,8,3,133,160,293,411
0130-001,2017,3,8,4,157,175,332,293
0130-001,2017,3,8,5,187,233,420,332
0130-001,2017,3,8,6,514,396,910,420
0130-001,2017,3,8,7,1528,875,2403,910
0130-001,2017,3,8,8,1178,1578,2756,2403
0130-001,2017,3,8,9,1634,1837,3471,2756
0130-001,2017,3,8,10,1622,1544,3166,3471
0130-001,2017,3,8,11,1467,1518,2985,3166
0130-001,2017,3,8,12,1506,1554,3060,2985
0130-001,2017,3,8,13,1351,1391,2742,3060
0130-001,2017,3,8,14,1594,1652,3246,2742
0130-001,2017,3,8,15,1651,1643,3294,3246
0130-001,2017,3,8,16,1630,1741,3371,3294
0130-001,2017,3,8,17,1451,1883,3334,3371
0130-001,2017,3,8,18,1655,2320,3975,3334
0130-001,2017,3,8,19,1448,2397,3845,3975
0130-001,2017,3,8,20,1307,1689,2996,3845
0130-001,2017,3,8,21,1160,1594,2754,2996
0130-001,2017,3,8,22,1140,1232,2372,2754
0130-001,2017,3,8,23,793,735,1528,2372
0130-001,2017,3,8,24,514,544,1058,1528
0130-001,2017,3,9,1,359,334,693,1058
0130-001,2017,3,9,2,213,214,427,693
0130-001,2017,3,9,3,162,164,326,427
0130-001,2017,3,9,4,148,192,340,326
0130-001,2017,3,9,5,197,229,426,340
0130-001,2017,3,9,6,580,417,997,426
0130-001,2017,3,9,7,1511,841,2352,997
0130-001,2017,3,9,8,1539,1577,3116,2352
0130-001,2017,3,9,9,1585,1925,3510,3116
0130-001,2017,3,9,10,1581,1641,3222,3510
0130-001,2017,3,9,11,1554,1550,3104,3222
0130-001,2017,3,9,12,1451,1523,2974,3104
0130-001,2017,3,9,13,1411,1418,2829,2974
0130-001,2017,3,9,14,1608,1651,3259,2829
0130-001,2017,3,9,15,1480,1700,3180,3259
0130-001,2017,3,9,16,1486,1610,3096,3180
0130-001,2017,3,9,17,1492,1898,3390,3096
0130-001,2017,3,9,18,1681,2237,3918,3390
0130-001,2017,3,9,19,1549,2310,3859,3918
0130-001,2017,3,9,20,1331,1711,3042,3859
0130-001,2017,3,9,21,1118,1566,2684,3042
0130-001,2017,3,9,22,1012,1212,2224,2684
0130-001,2017,3,9,23,807,785,1592,2224
0130-001,2017,3,9,24,483,549,1032,1592
0130-001,2017,3,10,1,376,390,766,1032
0130-001,2017,3,10,2,232,250,482,766
0130-001,2017,3,10,3,157,161,318,482
0130-001,2017,3,10,4,129,184,313,318
0130-001,2017,3,10,5,215,245,460,313
0130-001,2017,3,10,6,571,425,996,460
0130-001,2017,3,10,7,1559,838,2397,996
0130-001,2017,3,10,8,1431,1587,3018,2397
0130-001,2017,3,10,9,1627,1879,3506,3018
0130-001,2017,3,10,10,1671,1677,3348,3506
0130-001,2017,3,10,11,1589,1578,3167,3348
0130-001,2017,3,10,12,1343,1532,2875,3167
0130-001,2017,3,10,13,1444,1449,2893,2875
0130-001,2017,3,10,14,1593,1599,3192,2893
0130-001,2017,3,10,15,1543,1726,3269,3192
0130-001,2017,3,10,16,1622,1668,3290,3269
0130-001,2017,3,10,17,1562,1928,3490,3290
0130-001,2017,3,10,18,1619,2302,3921,3490
0130-001,2017,3,10,19,1721,2547,4268,3921
0130-001,2017,3,10,20,1364,1985,3349,4268
0130-001,2017,3,10,21,1199,1716,2915,3349
0130-001,2017,3,10,22,1131,1259,2390,2915
0130-001,2017,3,10,23,898,881,1779,2390
0130-001,2017,3,10,24,587,604,1191,1779
0130-001,2017,3,11,1,487,481,968,1191
0130-001,2017,3,11,2,385,343,728,968
0130-001,2017,3,11,3,257,280,537,728
0130-001,2017,3,11,4,202,235,437,537
0130-001,2017,3,11,5,236,264,500,437
0130-001,2017,3,11,6,467,380,847,500
0130-001,2017,3,11,7,1040,739,1779,847
0130-001,2017,3,11,8,1411,1073,2484,1779
0130-001,2017,3,11,9,1381,1521,2902,2484
0130-001,2017,3,11,10,1362,1652,3014,2902
0130-001,2017,3,11,11,1472,1738,3210,3014
0130-001,2017,3,11,12,1473,1778,3251,3210
0130-001,2017,3,11,13,1449,1706,3155,3251
0130-001,2017,3,11,14,1657,1786,3443,3155
0130-001,2017,3,11,15,1611,1822,3433,3443
0130-001,2017,3,11,16,1649,1790,3439,3433
0130-001,2017,3,11,17,1739,1880,3619,3439
0130-001,2017,3,11,18,1839,2252,4091,3619
0130-001,2017,3,11,19,1705,1910,3615,4091
0130-001,2017,3,11,20,1372,1464,2836,3615
0130-001,2017,3,11,21,1134,1068,2202,2836
0130-001,2017,3,11,22,1029,875,1904,2202
0130-001,2017,3,11,23,815,655,1470,1904
0130-001,2017,3,11,24,536,460,996,1470
0130-001,2017,3,12,1,400,345,745,996
0130-001,2017,3,12,2,291,273,564,745
0130-001,2017,3,12,3,212,199,411,564
0130-001,2017,3,12,4,196,187,383,411
0130-001,2017,3,12,5,197,144,341,383
0130-001,2017,3,12,6,300,292,592,341
0130-001,2017,3,12,7,631,411,1042,592
0130-001,2017,3,12,8,664,591,1255,1042
0130-001,2017,3,12,9,842,896,1738,1255
0130-001,2017,3,12,10,936,1076,2012,1738
0130-001,2017,3,12,11,1235,1227,2462,2012
0130-001,2017,3,12,12,1162,1311,2473,2462
0130-001,2017,3,12,13,1296,1388,2684,2473
0130-001,2017,3,12,14,1433,1450,2883,2684
0130-001,2017,3,12,15,1464,1494,2958,2883
0130-001,2017,3,12,16,1504,1513,3017,2958
0130-001,2017,3,12,17,1585,1547,3132,3017
0130-001,2017,3,12,18,1630,1585,3215,3132
0130-001,2017,3,12,19,1541,1368,2909,3215
0130-001,2017,3,12,20,1161,1090,2251,2909
0130-001,2017,3,12,21,1108,997,2105,2251
0130-001,2017,3,12,22,818,790,1608,2105
0130-001,2017,3,12,23,635,514,1149,1608
0130-001,2017,3,12,24,415,375,790,1149
0130-001,2017,3,13,1,285,211,496,790
0130-001,2017,3,13,2,154,140,294,496
0130-001,2017,3,13,3,115,132,247,294
0130-001,2017,3,13,4,122,166,288,247
0130-001,2017,3,13,5,234,216,450,288
0130-001,2017,3,13,6,612,454,1066,450
0130-001,2017,3,13,7,1628,894,2522,1066
0130-001,2017,3,13,8,1404,1665,3069,2522
0130-001,2017,3,13,9,1620,1838,3458,3069
0130-001,2017,3,13,10,1514,1653,3167,3458
0130-001,2017,3,13,11,1613,1626,3239,3167
0130-001,2017,3,13,12,1516,1559,3075,3239
0130-001,2017,3,13,13,1483,1498,2981,3075
0130-001,2017,3,13,14,1602,1595,3197,2981
0130-001,2017,3,13,15,1631,1642,3273,3197
0130-001,2017,3,13,16,1484,1702,3186,3273
0130-001,2017,3,13,17,1603,1995,3598,3186
0130-001,2017,3,13,18,1566,2325,3891,3598
0130-001,2017,3,13,19,1509,2353,3862,3891
0130-001,2017,3,13,20,1266,1800,3066,3862
0130-001,2017,3,13,21,1098,1707,2805,3066
0130-001,2017,3,13,22,1114,1271,2385,2805
0130-001,2017,3,13,23,704,747,1451,2385
0130-001,2017,3,13,24,459,486,945,1451
0130-001,2017,3,14,1,328,326,654,945
0130-001,2017,3,14,2,223,213,436,654
0130-001,2017,3,14,3,135,172,307,436
0130-001,2017,3,14,4,138,168,306,307
0130-001,2017,3,14,5,206,239,445,306
0130-001,2017,3,14,6,589,409,998,445
0130-001,2017,3,14,7,1617,876,2493,998
0130-001,2017,3,14,8,1464,1647,3111,2493
0130-001,2017,3,14,9,1586,2056,3642,3111
0130-001,2017,3,14,10,1664,1729,3393,3642
0130-001,2017,3,14,11,1574,1691,3265,3393
0130-001,2017,3,14,12,1463,1542,3005,3265
0130-001,2017,3,14,13,1491,1457,2948,3005
0130-001,2017,3,14,14,1508,1663,3171,2948
0130-001,2017,3,14,15,1544,1686,3230,3171
0130-001,2017,3,14,16,1553,1734,3287,3230
0130-001,2017,3,14,17,1568,1914,3482,3287
0130-001,2017,3,14,18,1612,2266,3878,3482
0130-001,2017,3,14,19,1537,2362,3899,3878
0130-001,2017,3,14,20,1329,1763,3092,3899
0130-001,2017,3,14,21,1171,1764,2935,3092
0130-001,2017,3,14,22,1077,1298,2375,2935
0130-001,2017,3,14,23,831,816,1647,2375
0130-001,2017,3,14,24,481,519,1000,1647
0130-001,2017,3,15,1,332,345,677,1000
0130-001,2017,3,15,2,219,206,425,677
0130-001,2017,3,15,3,149,166,315,425
0130-001,2017,3,15,4,132,174,306,315
0130-001,2017,3,15,5,204,217,421,306
0130-001,2017,3,15,6,560,381,941,421
0130-001,2017,3,15,7,1613,866,2479,941
0130-001,2017,3,15,8,1527,1583,3110,2479
0130-001,2017,3,15,9,1512,1935,3447,3110
0130-001,2017,3,15,10,1700,1666,3366,3447
0130-001,2017,3,15,11,1623,1562,3185,3366
0130-001,2017,3,15,12,1529,1498,3027,3185
0130-001,2017,3,15,13,1407,1426,2833,3027
0130-001,2017,3,15,14,1519,1559,3078,2833
0130-001,2017,3,15,15,1567,1717,3284,3078
0130-001,2017,3,15,16,1612,1784,3396,3284
0130-001,2017,3,15,17,1537,1824,3361,3396
0130-001,2017,3,15,18,1593,2383,3976,3361
0130-001,2017,3,15,19,1605,2482,4087,3976
0130-001,2017,3,15,20,1289,1816,3105,4087
0130-001,2017,3,15,21,1161,1569,2730,3105
0130-001,2017,3,15,22,1141,1275,2416,2730
0130-001,2017,3,15,23,818,772,1590,2416
0130-001,2017,3,15,24,552,537,1089,1590
0130-001,2017,3,16,1,368,364,732,1089
0130-001,2017,3,16,2,230,234,464,732
0130-001,2017,3,16,3,170,179,349,464
0130-001,2017,3,16,4,136,194,330,349
0130-001,2017,3,16,5,204,249,453,330
0130-001,2017,3,16,6,584,424,1008,453
0130-001,2017,3,16,7,1618,882,2500,1008
0130-001,2017,3,16,8,1376,1610,2986,2500
0130-001,2017,3,16,9,1552,1930,3482,2986
0130-001,2017,3,16,10,1522,1608,3130,3482
0130-001,2017,3,16,11,1563,1520,3083,3130
0130-001,2017,3,16,12,1477,1585,3062,3083
0130-001,2017,3,16,13,1479,1426,2905,3062
0130-001,2017,3,16,14,1618,1646,3264,2905
0130-001,2017,3,16,15,1603,1711,3314,3264
0130-001,2017,3,16,16,1548,1725,3273,3314
0130-001,2017,3,16,17,1589,1965,3554,3273
0130-001,2017,3,16,18,1717,2252,3969,3554
0130-001,2017,3,16,19,1522,2425,3947,3969
0130-001,2017,3,16,20,1327,1809,3136,3947
0130-001,2017,3,16,21,1102,1665,2767,3136
0130-001,2017,3,16,22,1048,1299,2347,2767
0130-001,2017,3,16,23,813,812,1625,2347
0130-001,2017,3,16,24,529,528,1057,1625
0130-001,2017,3,17,1,396,387,783,1057
0130-001,2017,3,17,2,238,217,455,783
0130-001,2017,3,17,3,161,188,349,455
0130-001,2017,3,17,4,150,211,361,349
0130-001,2017,3,17,5,218,250,468,361
0130-001,2017,3,17,6,606,409,1015,468
0130-001,2017,3,17,7,1598,878,2476,1015
0130-001,2017,3,17,8,1431,1466,2897,2476
0130-001,2017,3,17,9,1574,1957,3531,2897
0130-001,2017,3,17,10,1558,1608,3166,3531
0130-001,2017,3,17,11,1539,1666,3205,3166
0130-001,2017,3,17,12,1501,1582,3083,3205
0130-001,2017,3,17,13,1474,1519,2993,3083
0130-001,2017,3,17,14,1592,1660,3252,2993
0130-001,2017,3,17,15,1637,1703,3340,3252
0130-001,2017,3,17,16,1595,1842,3437,3340
0130-001,2017,3,17,17,1627,2038,3665,3437
0130-001,2017,3,17,18,1675,2397,4072,3665
0130-001,2017,3,17,19,1593,2479,4072,4072
0130-001,2017,3,17,20,1398,2010,3408,4072
0130-001,2017,3,17,21,1191,1705,2896,3408
0130-001,2017,3,17,22,1123,1282,2405,2896
0130-001,2017,3,17,23,916,834,1750,2405
0130-001,2017,3,17,24,632,580,1212,1750
0130-001,2017,3,18,1,459,425,884,1212
0130-001,2017,3,18,2,359,307,666,884
0130-001,2017,3,18,3,211,222,433,666
0130-001,2017,3,18,4,207,238,445,433
0130-001,2017,3,18,5,217,272,489,445
0130-001,2017,3,18,6,557,426,983,489
0130-001,2017,3,18,7,1102,758,1860,983
0130-001,2017,3,18,8,1424,1048,2472,1860
0130-001,2017,3,18,9,1444,1575,3019,2472
0130-001,2017,3,18,10,1474,1733,3207,3019
0130-001,2017,3,18,11,1607,1753,3360,3207
0130-001,2017,3,18,12,1588,1819,3407,3360
0130-001,2017,3,18,13,1612,1818,3430,3407
0130-001,2017,3,18,14,1534,1828,3362,3430
0130-001,2017,3,18,15,1596,1780,3376,3362
0130-001,2017,3,18,16,1744,1846,3590,3376
0130-001,2017,3,18,17,1747,1872,3619,3590
0130-001,2017,3,18,18,1726,2131,3857,3619
0130-001,2017,3,18,19,1613,1891,3504,3857
0130-001,2017,3,18,20,1377,1387,2764,3504
0130-001,2017,3,18,21,1155,1162,2317,2764
0130-001,2017,3,18,22,1028,889,1917,2317
0130-001,2017,3,18,23,820,636,1456,1917
0130-001,2017,3,18,24,549,490,1039,1456
0130-001,2017,3,19,1,389,399,788,1039
0130-001,2017,3,19,2,290,235,525,788
0130-001,2017,3,19,3,212,215,427,525
0130-001,2017,3,19,4,181,180,361,427
0130-001,2017,3,19,5,218,160,378,361
0130-001,2017,3,19,6,329,264,593,378
0130-001,2017,3,19,7,565,446,1011,593
0130-001,2017,3,19,8,804,636,1440,1011
0130-001,2017,3,19,9,870,909,1779,1440
0130-001,2017,3,19,10,950,1168,2118,1779
0130-001,2017,3,19,11,1248,1352,2600,2118
0130-001,2017,3,19,12,1194,1367,2561,2600
0130-001,2017,3,19,13,1354,1484,2838,2561
0130-001,2017,3,19,14,1296,1512,2808,2838
0130-001,2017,3,19,15,1615,1684,3299,2808
0130-001,2017,3,19,16,1558,1602,3160,3299
0130-001,2017,3,19,17,1687,1710,3397,3160
0130-001,2017,3,19,18,1635,1673,3308,3397
0130-001,2017,3,19,19,1547,1491,3038,3308
0130-001,2017,3,19,20,1323,1247,2570,3038
0130-001,2017,3,19,21,1217,1040,2257,2570
0130-001,2017,3,19,22,998,765,1763,2257
0130-001,2017,3,19,23,695,554,1249,1763
0130-001,2017,3,19,24,447,357,804,1249
0130-001,2017,3,20,1,284,227,511,804
0130-001,2017,3,20,2,165,150,315,511
0130-001,2017,3,20,3,122,109,231,315
0130-001,2017,3,20,4,120,155,275,231
0130-001,2017,3,20,5,251,228,479,275
0130-001,2017,3,20,6,682,475,1157,479
0130-001,2017,3,20,7,1635,947,2582,1157
0130-001,2017,3,20,8,1472,1722,3194,2582
0130-001,2017,3,20,9,1612,1930,3542,3194
0130-001,2017,3,20,10,1572,1614,3186,3542
0130-001,2017,3,20,11,1664,1528,3192,3186
0130-001,2017,3,20,12,1540,1518,3058,3192
0130-001,2017,3,20,13,1374,1449,2823,3058
0130-001,2017,3,20,14,1596,1558,3154,2823
0130-001,2017,3,20,15,1509,1622,3131,3154
0130-001,2017,3,20,16,1537,1751,3288,3131
0130-001,2017,3,20,17,1427,1940,3367,3288
0130-001,2017,3,20,18,1540,2272,3812,3367
0130-001,2017,3,20,19,1499,2320,3819,3812
0130-001,2017,3,20,20,1246,1713,2959,3819
0130-001,2017,3,20,21,1035,1693,2728,2959
0130-001,2017,3,20,22,1071,1262,2333,2728
0130-001,2017,3,20,23,722,748,1470,2333
0130-001,2017,3,20,24,460,462,922,1470
0130-001,2017,3,21,1,321,332,653,922
0130-001,2017,3,21,2,193,204,397,653
0130-001,2017,3,21,3,143,159,302,397
0130-001,2017,3,21,4,134,180,314,302
0130-001,2017,3,21,5,214,256,470,314
0130-001,2017,3,21,6,641,461,1102,470
0130-001,2017,3,21,7,1585,860,2445,1102
0130-001,2017,3,21,8,1490,1698,3188,2445
0130-001,2017,3,21,9,1657,1941,3598,3188
0130-001,2017,3,21,10,1520,1541,3061,3598
0130-001,2017,3,21,11,1588,1617,3205,3061
0130-001,2017,3,21,12,1486,1494,2980,3205
0130-001,2017,3,21,13,1393,1439,2832,2980
0130-001,2017,3,21,14,1610,1656,3266,2832
0130-001,2017,3,21,15,1561,1623,3184,3266
0130-001,2017,3,21,16,1591,1759,3350,3184
0130-001,2017,3,21,17,1551,1802,3353,3350
0130-001,2017,3,21,18,1544,2316,3860,3353
0130-001,2017,3,21,19,1512,2465,3977,3860
0130-001,2017,3,21,20,1181,1797,2978,3977
0130-001,2017,3,21,21,1112,1683,2795,2978
0130-001,2017,3,21,22,1169,1271,2440,2795
0130-001,2017,3,21,23,782,767,1549,2440
0130-001,2017,3,21,24,486,519,1005,1549
0130-001,2017,3,22,1,355,342,697,1005
0130-001,2017,3,22,2,244,192,436,697
0130-001,2017,3,22,3,136,156,292,436
0130-001,2017,3,22,4,147,189,336,292
0130-001,2017,3,22,5,226,246,472,336
0130-001,2017,3,22,6,594,411,1005,472
0130-001,2017,3,22,7,1581,872,2453,1005
0130-001,2017,3,22,8,1532,1609,3141,2453
0130-001,2017,3,22,9,1583,1945,3528,3141
0130-001,2017,3,22,10,1643,1607,3250,3528
0130-001,2017,3,22,11,1585,1513,3098,3250
0130-001,2017,3,22,12,1433,1539,2972,3098
0130-001,2017,3,22,13,1388,1440,2828,2972
0130-001,2017,3,22,14,1598,1492,3090,2828
0130-001,2017,3,22,15,1582,1752,3334,3090
0130-001,2017,3,22,16,1619,1787,3406,3334
0130-001,2017,3,22,17,1599,1895,3494,3406
0130-001,2017,3,22,18,1645,2469,4114,3494
0130-001,2017,3,22,19,1539,2480,4019,4114
0130-001,2017,3,22,20,1317,1815,3132,4019
0130-001,2017,3,22,21,1130,1552,2682,3132
0130-001,2017,3,22,22,1115,1188,2303,2682
0130-001,2017,3,22,23,833,795,1628,2303
0130-001,2017,3,22,24,501,532,1033,1628
0130-001,2017,3,23,1,364,365,729,1033
0130-001,2017,3,23,2,227,236,463,729
0130-001,2017,3,23,3,155,174,329,463
0130-001,2017,3,23,4,154,191,345,329
0130-001,2017,3,23,5,202,255,457,345
0130-001,2017,3,23,6,628,456,1084,457
0130-001,2017,3,23,7,1630,890,2520,1084
0130-001,2017,3,23,8,1427,1604,3031,2520
0130-001,2017,3,23,9,1601,1881,3482,3031
0130-001,2017,3,23,10,1663,1622,3285,3482
0130-001,2017,3,23,11,1578,1605,3183,3285
0130-001,2017,3,23,12,1431,1457,2888,3183
0130-001,2017,3,23,13,1377,1444,2821,2888
0130-001,2017,3,23,14,1618,1607,3225,2821
0130-001,2017,3,23,15,1513,1688,3201,3225
0130-001,2017,3,23,16,1560,1802,3362,3201
0130-001,2017,3,23,17,1537,1836,3373,3362
0130-001,2017,3,23,18,1637,2374,4011,3373
0130-001,2017,3,23,19,1574,2475,4049,4011
0130-001,2017,3,23,20,1303,1734,3037,4049
0130-001,2017,3,23,21,1163,1718,2881,3037
0130-001,2017,3,23,22,1105,1247,2352,2881
0130-001,2017,3,23,23,835,794,1629,2352
0130-001,2017,3,23,24,504,531,1035,1629
0130-001,2017,3,24,1,387,370,757,1035
0130-001,2017,3,24,2,228,208,436,757
0130-001,2017,3,24,3,163,167,330,436
0130-001,2017,3,24,4,143,196,339,330
0130-001,2017,3,24,5,214,253,467,339
0130-001,2017,3,24,6,593,449,1042,467
0130-001,2017,3,24,7,1549,833,2382,1042
0130-001,2017,3,24,8,1439,1575,3014,2382
0130-001,2017,3,24,9,1603,1996,3599,3014
0130-001,2017,3,24,10,1622,1568,3190,3599
0130-001,2017,3,24,11,1525,1629,3154,3190
0130-001,2017,3,24,12,1532,1609,3141,3154
0130-001,2017,3,24,13,1430,1501,2931,3141
0130-001,2017,3,24,14,1569,1669,3238,2931
0130-001,2017,3,24,15,1522,1645,3167,3238
0130-001,2017,3,24,16,1606,1843,3449,3167
0130-001,2017,3,24,17,1573,1944,3517,3449
0130-001,2017,3,24,18,1703,2443,4146,3517
0130-001,2017,3,24,19,1671,2526,4197,4146
0130-001,2017,3,24,20,1404,1905,3309,4197
0130-001,2017,3,24,21,1185,1652,2837,3309
0130-001,2017,3,24,22,1083,1309,2392,2837
0130-001,2017,3,24,23,967,877,1844,2392
0130-001,2017,3,24,24,609,566,1175,1844
0130-001,2017,3,25,1,462,450,912,1175
0130-001,2017,3,25,2,332,290,622,912
0130-001,2017,3,25,3,244,219,463,622
0130-001,2017,3,25,4,213,230,443,463
0130-001,2017,3,25,5,225,287,512,443
0130-001,2017,3,25,6,514,420,934,512
0130-001,2017,3,25,7,1025,751,1776,934
0130-001,2017,3,25,8,1385,1123,2508,1776
0130-001,2017,3,25,9,1405,1604,3009,2508
0130-001,2017,3,25,10,1390,1744,3134,3009
0130-001,2017,3,25,11,1408,1713,3121,3134
0130-001,2017,3,25,12,1423,1877,3300,3121
0130-001,2017,3,25,13,1497,1732,3229,3300
0130-001,2017,3,25,14,1558,1806,3364,3229
0130-001,2017,3,25,15,1646,1745,3391,3364
0130-001,2017,3,25,16,1699,1796,3495,3391
0130-001,2017,3,25,17,1202,1711,2913,3495
0130-001,2017,3,25,18,1631,2061,3692,2913
0130-001,2017,3,25,19,1658,1860,3518,3692
0130-001,2017,3,25,20,1338,1305,2643,3518
0130-001,2017,3,25,21,1062,1143,2205,2643
0130-001,2017,3,25,22,1014,913,1927,2205
0130-001,2017,3,25,23,820,673,1493,1927
0130-001,2017,3,25,24,549,445,994,1493
0130-001,2017,3,26,1,370,350,720,994
0130-001,2017,3,26,2,280,263,543,720
0130-001,2017,3,26,3,211,176,387,543
0130-001,2017,3,26,4,200,156,356,387
0130-001,2017,3,26,5,178,165,343,356
0130-001,2017,3,26,6,327,241,568,343
0130-001,2017,3,26,7,615,465,1080,568
0130-001,2017,3,26,8,767,685,1452,1080
0130-001,2017,3,26,9,887,1051,1938,1452
0130-001,2017,3,26,10,1023,1110,2133,1938
0130-001,2017,3,26,11,1391,1336,2727,2133
0130-001,2017,3,26,12,1228,1344,2572,2727
0130-001,2017,3,26,13,1331,1384,2715,2572
0130-001,2017,3,26,14,1401,1450,2851,2715
0130-001,2017,3,26,15,1480,1491,2971,2851
0130-001,2017,3,26,16,1511,1534,3045,2971
0130-001,2017,3,26,17,1536,1584,3120,3045
0130-001,2017,3,26,18,1533,1582,3115,3120
0130-001,2017,3,26,19,1425,1320,2745,3115
0130-001,2017,3,26,20,1215,1110,2325,2745
0130-001,2017,3,26,21,1163,1000,2163,2325
0130-001,2017,3,26,22,864,827,1691,2163
0130-001,2017,3,26,23,594,516,1110,1691
0130-001,2017,3,26,24,400,354,754,1110
0130-001,2017,3,27,1,269,237,506,754
0130-001,2017,3,27,2,148,143,291,506
0130-001,2017,3,27,3,112,112,224,291
0130-001,2017,3,27,4,127,176,303,224
0130-001,2017,3,27,5,204,199,403,303
0130-001,2017,3,27,6,656,514,1170,403
0130-001,2017,3,27,7,1678,928,2606,1170
0130-001,2017,3,27,8,1541,1689,3230,2606
0130-001,2017,3,27,9,1574,1884,3458,3230
0130-001,2017,3,27,10,1556,1666,3222,3458
0130-001,2017,3,27,11,1528,1589,3117,3222
0130-001,2017,3,27,12,1477,1512,2989,3117
0130-001,2017,3,27,13,1471,1469,2940,2989
0130-001,2017,3,27,14,1608,1659,3267,2940
0130-001,2017,3,27,15,1616,1677,3293,3267
0130-001,2017,3,27,16,1604,1629,3233,3293
0130-001,2017,3,27,17,1566,1946,3512,3233
0130-001,2017,3,27,18,1489,2254,3743,3512
0130-001,2017,3,27,19,1525,2341,3866,3743
0130-001,2017,3,27,20,1251,1734,2985,3866
0130-001,2017,3,27,21,1068,1688,2756,2985
0130-001,2017,3,27,22,1083,1237,2320,2756
0130-001,2017,3,27,23,751,752,1503,2320
0130-001,2017,3,27,24,447,436,883,1503
0130-001,2017,3,28,1,316,328,644,883
0130-001,2017,3,28,2,184,201,385,644
0130-001,2017,3,28,3,147,146,293,385
0130-001,2017,3,28,4,150,210,360,293
0130-001,2017,3,28,5,200,268,468,360
0130-001,2017,3,28,6,597,425,1022,468
0130-001,2017,3,28,7,1610,876,2486,1022
0130-001,2017,3,28,8,1508,1656,3164,2486
0130-001,2017,3,28,9,1614,1871,3485,3164
0130-001,2017,3,28,10,1567,1568,3135,3485
0130-001,2017,3,28,11,1562,1639,3201,3135
0130-001,2017,3,28,12,1459,1517,2976,3201
0130-001,2017,3,28,13,1439,1410,2849,2976
0130-001,2017,3,28,14,1584,1690,3274,2849
0130-001,2017,3,28,15,1573,1623,3196,3274
0130-001,2017,3,28,16,1589,1718,3307,3196
0130-001,2017,3,28,17,1614,1917,3531,3307
0130-001,2017,3,28,18,1645,2335,3980,3531
0130-001,2017,3,28,19,1576,2369,3945,3980
0130-001,2017,3,28,20,1232,1754,2986,3945
0130-001,2017,3,28,21,1074,1675,2749,2986
0130-001,2017,3,28,22,1035,1233,2268,2749
0130-001,2017,3,28,23,778,775,1553,2268
0130-001,2017,3,28,24,488,494,982,1553
0130-001,2017,3,29,1,374,354,728,982
0130-001,2017,3,29,2,224,225,449,728
0130-001,2017,3,29,3,154,192,346,449
0130-001,2017,3,29,4,161,175,336,346
0130-001,2017,3,29,5,222,240,462,336
0130-001,2017,3,29,6,614,457,1071,462
0130-001,2017,3,29,7,1607,829,2436,1071
0130-001,2017,3,29,8,1420,1656,3076,2436
0130-001,2017,3,29,9,1637,1853,3490,3076
0130-001,2017,3,29,10,1611,1671,3282,3490
0130-001,2017,3,29,11,1478,1431,2909,3282
0130-001,2017,3,29,12,1470,1441,2911,2909
0130-001,2017,3,29,13,1344,1425,2769,2911
0130-001,2017,3,29,14,1554,1564,3118,2769
0130-001,2017,3,29,15,1491,1635,3126,3118
0130-001,2017,3,29,16,1546,1756,3302,3126
0130-001,2017,3,29,17,1508,1867,3375,3302
0130-001,2017,3,29,18,1606,2379,3985,3375
0130-001,2017,3,29,19,1579,2429,4008,3985
0130-001,2017,3,29,20,1264,1930,3194,4008
0130-001,2017,3,29,21,1121,1516,2637,3194
0130-001,2017,3,29,22,1267,1231,2498,2637
0130-001,2017,3,29,23,906,832,1738,2498
0130-001,2017,3,29,24,580,609,1189,1738
0130-001,2017,3,30,1,400,386,786,1189
0130-001,2017,3,30,2,244,232,476,786
0130-001,2017,3,30,3,165,197,362,476
0130-001,2017,3,30,4,152,182,334,362
0130-001,2017,3,30,5,209,238,447,334
0130-001,2017,3,30,6,510,405,915,447
0130-001,2017,3,30,7,1561,811,2372,915
0130-001,2017,3,30,8,1498,1569,3067,2372
0130-001,2017,3,30,9,1568,1933,3501,3067
0130-001,2017,3,30,10,1574,1611,3185,3501
0130-001,2017,3,30,11,1521,1526,3047,3185
0130-001,2017,3,30,12,1488,1480,2968,3047
0130-001,2017,3,30,13,1398,1387,2785,2968
0130-001,2017,3,30,14,1617,1658,3275,2785
0130-001,2017,3,30,15,1580,1664,3244,3275
0130-001,2017,3,30,16,1579,1758,3337,3244
0130-001,2017,3,30,17,1486,1836,3322,3337
0130-001,2017,3,30,18,1578,2280,3858,3322
0130-001,2017,3,30,19,1549,2353,3902,3858
0130-001,2017,3,30,20,1286,1829,3115,3902
0130-001,2017,3,30,21,1118,1701,2819,3115
0130-001,2017,3,30,22,1118,1374,2492,2819
0130-001,2017,3,30,23,799,832,1631,2492
0130-001,2017,3,30,24,546,525,1071,1631
0130-001,2017,3,31,1,396,383,779,1071
0130-001,2017,3,31,2,244,227,471,779
0130-001,2017,3,31,3,176,178,354,471
0130-001,2017,3,31,4,163,196,359,354
0130-001,2017,3,31,5,229,243,472,359
0130-001,2017,3,31,6,546,426,972,472
0130-001,2017,3,31,7,1583,834,2417,972
0130-001,2017,3,31,8,1524,1554,3078,2417
0130-001,2017,3,31,9,1593,1949,3542,3078
0130-001,2017,3,31,10,1572,1574,3146,3542
0130-001,2017,3,31,11,1583,1655,3238,3146
0130-001,2017,3,31,12,1601,1566,3167,3238
0130-001,2017,3,31,13,1346,1464,2810,3167
0130-001,2017,3,31,14,1595,1734,3329,2810
0130-001,2017,3,31,15,1595,1761,3356,3329
0130-001,2017,3,31,16,1623,1765,3388,3356
0130-001,2017,3,31,17,1551,1845,3396,3388
0130-001,2017,3,31,18,1711,2218,3929,3396
0130-001,2017,3,31,19,1596,2460,4056,3929
0130-001,2017,3,31,20,1354,1890,3244,4056
0130-001,2017,3,31,21,1252,1700,2952,3244
0130-001,2017,3,31,22,1123,1455,2578,2952
0130-001,2017,3,31,23,881,863,1744,2578
0130-001,2017,3,31,24,611,653,1264,1744
0130-001,2017,4,1,1,495,433,928,1264
0130-001,2017,4,1,2,352,331,683,928
0130-001,2017,4,1,3,233,240,473,683
0130-001,2017,4,1,4,215,240,455,473
0130-001,2017,4,1,5,195,249,444,455
0130-001,2017,4,1,6,484,395,879,444
0130-001,2017,4,1,7,1049,673,1722,879
0130-001,2017,4,1,8,1278,1074,2352,1722
0130-001,2017,4,1,9,1544,1585,3129,2352
0130-001,2017,4,1,10,1546,1749,3295,3129
0130-001,2017,4,1,11,1600,1756,3356,3295
0130-001,2017,4,1,12,1518,1923,3441,3356
0130-001,2017,4,1,13,1573,1855,3428,3441
0130-001,2017,4,1,14,1574,1920,3494,3428
0130-001,2017,4,1,15,1545,1875,3420,3494
0130-001,2017,4,1,16,1562,1902,3464,3420
0130-001,2017,4,1,17,1748,1856,3604,3464
0130-001,2017,4,1,18,1715,2120,3835,3604
0130-001,2017,4,1,19,1609,2019,3628,3835
0130-001,2017,4,1,20,1355,1448,2803,3628
0130-001,2017,4,1,21,1094,1255,2349,2803
0130-001,2017,4,1,22,1082,892,1974,2349
0130-001,2017,4,1,23,740,654,1394,1974
0130-001,2017,4,1,24,563,495,1058,1394
0130-001,2017,4,2,1,444,363,807,1058
0130-001,2017,4,2,2,275,245,520,807
0130-001,2017,4,2,3,246,238,484,520
0130-001,2017,4,2,4,170,155,325,484
0130-001,2017,4,2,5,193,161,354,325
0130-001,2017,4,2,6,316,271,587,354
0130-001,2017,4,2,7,605,431,1036,587
0130-001,2017,4,2,8,700,623,1323,1036
0130-001,2017,4,2,9,915,932,1847,1323
0130-001,2017,4,2,10,1017,1172,2189,1847
0130-001,2017,4,2,11,1253,1340,2593,2189
0130-001,2017,4,2,12,1188,1340,2528,2593
0130-001,2017,4,2,13,1347,1428,2775,2528
0130-001,2017,4,2,14,1456,1558,3014,2775
0130-001,2017,4,2,15,1488,1593,3081,3014
0130-001,2017,4,2,16,1595,1629,3224,3081
0130-001,2017,4,2,17,1580,1655,3235,3224
0130-001,2017,4,2,18,1650,1628,3278,3235
0130-001,2017,4,2,19,1552,1499,3051,3278
0130-001,2017,4,2,20,1351,1135,2486,3051
0130-001,2017,4,2,21,1393,1067,2460,2486
0130-001,2017,4,2,22,1081,827,1908,2460
0130-001,2017,4,2,23,781,557,1338,1908
0130-001,2017,4,2,24,459,404,863,1338
0130-001,2017,4,3,1,313,279,592,863
0130-001,2017,4,3,2,145,155,300,592
0130-001,2017,4,3,3,139,119,258,300
0130-001,2017,4,3,4,112,138,250,258
0130-001,2017,4,3,5,238,194,432,250
0130-001,2017,4,3,6,559,447,1006,432
0130-001,2017,4,3,7,1728,949,2677,1006
0130-001,2017,4,3,8,1527,1595,3122,2677
0130-001,2017,4,3,9,1575,1921,3496,3122
0130-001,2017,4,3,10,1537,1618,3155,3496
0130-001,2017,4,3,11,1588,1569,3157,3155
0130-001,2017,4,3,12,1522,1522,3044,3157
0130-001,2017,4,3,13,1349,1431,2780,3044
0130-001,2017,4,3,14,1619,1525,3144,2780
0130-001,2017,4,3,15,1608,1579,3187,3144
0130-001,2017,4,3,16,1543,1747,3290,3187
0130-001,2017,4,3,17,1553,1631,3184,3290
0130-001,2017,4,3,18,1611,2316,3927,3184
0130-001,2017,4,3,19,1542,2457,3999,3927
0130-001,2017,4,3,20,1284,1869,3153,3999
0130-001,2017,4,3,21,1091,1726,2817,3153
0130-001,2017,4,3,22,1052,1465,2517,2817
0130-001,2017,4,3,23,783,808,1591,2517
0130-001,2017,4,3,24,476,511,987,1591
0130-001,2017,4,4,1,323,356,679,987
0130-001,2017,4,4,2,214,198,412,679
0130-001,2017,4,4,3,144,140,284,412
0130-001,2017,4,4,4,133,178,311,284
0130-001,2017,4,4,5,214,209,423,311
0130-001,2017,4,4,6,555,409,964,423
0130-001,2017,4,4,7,1600,847,2447,964
0130-001,2017,4,4,8,1526,1626,3152,2447
0130-001,2017,4,4,9,1663,1955,3618,3152
0130-001,2017,4,4,10,1571,1587,3158,3618
0130-001,2017,4,4,11,1534,1538,3072,3158
0130-001,2017,4,4,12,1409,1592,3001,3072
0130-001,2017,4,4,13,1380,1375,2755,3001
0130-001,2017,4,4,14,1602,1608,3210,2755
0130-001,2017,4,4,15,1598,1731,3329,3210
0130-001,2017,4,4,16,1557,1730,3287,3329
0130-001,2017,4,4,17,1453,1814,3267,3287
0130-001,2017,4,4,18,1641,2198,3839,3267
0130-001,2017,4,4,19,1633,2384,4017,3839
0130-001,2017,4,4,20,1256,1811,3067,4017
0130-001,2017,4,4,21,1155,1823,2978,3067
0130-001,2017,4,4,22,1036,1380,2416,2978
0130-001,2017,4,4,23,833,771,1604,2416
0130-001,2017,4,4,24,557,568,1125,1604
0130-001,2017,4,5,1,381,398,779,1125
0130-001,2017,4,5,2,209,237,446,779
0130-001,2017,4,5,3,147,184,331,446
0130-001,2017,4,5,4,150,176,326,331
0130-001,2017,4,5,5,211,227,438,326
0130-001,2017,4,5,6,493,415,908,438
0130-001,2017,4,5,7,1553,876,2429,908
0130-001,2017,4,5,8,1487,1587,3074,2429
0130-001,2017,4,5,9,1670,1968,3638,3074
0130-001,2017,4,5,10,1544,1684,3228,3638
0130-001,2017,4,5,11,1551,1582,3133,3228
0130-001,2017,4,5,12,1422,1587,3009,3133
0130-001,2017,4,5,13,1451,1440,2891,3009
0130-001,2017,4,5,14,1573,1688,3261,2891
0130-001,2017,4,5,15,1520,1653,3173,3261
0130-001,2017,4,5,16,1562,1747,3309,3173
0130-001,2017,4,5,17,1539,1786,3325,3309
0130-001,2017,4,5,18,1549,2133,3682,3325
0130-001,2017,4,5,19,1459,2308,3767,3682
0130-001,2017,4,5,20,1247,1693,2940,3767
0130-001,2017,4,5,21,1052,1484,2536,2940
0130-001,2017,4,5,22,1027,1148,2175,2536
0130-001,2017,4,5,23,842,793,1635,2175
0130-001,2017,4,5,24,519,500,1019,1635
0130-001,2017,4,6,1,379,391,770,1019
0130-001,2017,4,6,2,220,274,494,770
0130-001,2017,4,6,3,151,163,314,494
0130-001,2017,4,6,4,124,194,318,314
0130-001,2017,4,6,5,202,198,400,318
0130-001,2017,4,6,6,472,390,862,400
0130-001,2017,4,6,7,1496,752,2248,862
0130-001,2017,4,6,8,1453,1570,3023,2248
0130-001,2017,4,6,9,1598,1972,3570,3023
0130-001,2017,4,6,10,1648,1597,3245,3570
0130-001,2017,4,6,11,1562,1617,3179,3245
0130-001,2017,4,6,12,1565,1584,3149,3179
0130-001,2017,4,6,13,1342,1403,2745,3149
0130-001,2017,4,6,14,1546,1619,3165,2745
0130-001,2017,4,6,15,1578,1658,3236,3165
0130-001,2017,4,6,16,1613,1739,3352,3236
0130-001,2017,4,6,17,1539,1891,3430,3352
0130-001,2017,4,6,18,1509,2288,3797,3430
0130-001,2017,4,6,19,1528,2403,3931,3797
0130-001,2017,4,6,20,1293,1760,3053,3931
0130-001,2017,4,6,21,1114,1651,2765,3053
0130-001,2017,4,6,22,1062,1302,2364,2765
0130-001,2017,4,6,23,813,855,1668,2364
0130-001,2017,4,6,24,524,606,1130,1668
0130-001,2017,4,7,1,398,378,776,1130
0130-001,2017,4,7,2,246,229,475,776
0130-001,2017,4,7,3,182,198,380,475
0130-001,2017,4,7,4,155,187,342,380
0130-001,2017,4,7,5,260,245,505,342
0130-001,2017,4,7,6,541,442,983,505
0130-001,2017,4,7,7,1644,873,2517,983
0130-001,2017,4,7,8,1514,1565,3079,2517
0130-001,2017,4,7,9,1621,1914,3535,3079
0130-001,2017,4,7,10,1516,1598,3114,3535
0130-001,2017,4,7,11,1555,1647,3202,3114
0130-001,2017,4,7,12,1485,1594,3079,3202
0130-001,2017,4,7,13,1456,1416,2872,3079
0130-001,2017,4,7,14,1553,1589,3142,2872
0130-001,2017,4,7,15,1634,1663,3297,3142
0130-001,2017,4,7,16,1616,1787,3403,3297
0130-001,2017,4,7,17,1576,2028,3604,3403
0130-001,2017,4,7,18,1632,2312,3944,3604
0130-001,2017,4,7,19,1584,2516,4100,3944
0130-001,2017,4,7,20,1445,2040,3485,4100
0130-001,2017,4,7,21,1278,1786,3064,3485
0130-001,2017,4,7,22,1239,1424,2663,3064
0130-001,2017,4,7,23,924,972,1896,2663
0130-001,2017,4,7,24,589,620,1209,1896
0130-001,2017,4,8,1,472,399,871,1209
0130-001,2017,4,8,2,317,317,634,871
0130-001,2017,4,8,3,237,241,478,634
0130-001,2017,4,8,4,204,252,456,478
0130-001,2017,4,8,5,254,263,517,456
0130-001,2017,4,8,6,505,420,925,517
0130-001,2017,4,8,7,1162,694,1856,925
0130-001,2017,4,8,8,1433,1193,2626,1856
0130-001,2017,4,8,9,1382,1699,3081,2626
0130-001,2017,4,8,10,1496,1864,3360,3081
0130-001,2017,4,8,11,1693,1891,3584,3360
0130-001,2017,4,8,12,1574,2001,3575,3584
0130-001,2017,4,8,13,1491,1962,3453,3575
0130-001,2017,4,8,14,1575,1884,3459,3453
0130-001,2017,4,8,15,1600,1851,3451,3459
0130-001,2017,4,8,16,1646,1837,3483,3451
0130-001,2017,4,8,17,1636,1911,3547,3483
0130-001,2017,4,8,18,1784,2159,3943,3547
0130-001,2017,4,8,19,1757,2068,3825,3943
0130-001,2017,4,8,20,1455,1360,2815,3825
0130-001,2017,4,8,21,1151,1171,2322,2815
0130-001,2017,4,8,22,1056,1007,2063,2322
0130-001,2017,4,8,23,787,650,1437,2063
0130-001,2017,4,8,24,570,484,1054,1437
0130-001,2017,4,9,1,446,369,815,1054
0130-001,2017,4,9,2,300,271,571,815
0130-001,2017,4,9,3,231,192,423,571
0130-001,2017,4,9,4,189,164,353,423
0130-001,2017,4,9,5,202,166,368,353
0130-001,2017,4,9,6,309,272,581,368
0130-001,2017,4,9,7,665,436,1101,581
0130-001,2017,4,9,8,737,649,1386,1101
0130-001,2017,4,9,9,914,935,1849,1386
0130-001,2017,4,9,10,1006,1061,2067,1849
0130-001,2017,4,9,11,1255,1301,2556,2067
0130-001,2017,4,9,12,1147,1275,2422,2556
0130-001,2017,4,9,13,1250,1338,2588,2422
0130-001,2017,4,9,14,1332,1487,2819,2588
0130-001,2017,4,9,15,1378,1347,2725,2819
0130-001,2017,4,9,16,1465,1363,2828,2725
0130-001,2017,4,9,17,1429,1331,2760,2828
0130-001,2017,4,9,18,1433,1460,2893,2760
0130-001,2017,4,9,19,1474,1283,2757,2893
0130-001,2017,4,9,20,1284,1105,2389,2757
0130-001,2017,4,9,21,1228,1043,2271,2389
0130-001,2017,4,9,22,978,855,1833,2271
0130-001,2017,4,9,23,738,572,1310,1833
0130-001,2017,4,9,24,480,402,882,1310
0130-001,2017,4,10,1,273,259,532,882
0130-001,2017,4,10,2,145,159,304,532
0130-001,2017,4,10,3,132,119,251,304
0130-001,2017,4,10,4,106,147,253,251
0130-001,2017,4,10,5,223,229,452,253
0130-001,2017,4,10,6,611,469,1080,452
0130-001,2017,4,10,7,1707,907,2614,1080
0130-001,2017,4,10,8,1489,1653,3142,2614
0130-001,2017,4,10,9,1636,1907,3543,3142
0130-001,2017,4,10,10,1567,1576,3143,3543
0130-001,2017,4,10,11,1527,1628,3155,3143
0130-001,2017,4,10,12,1470,1565,3035,3155
0130-001,2017,4,10,13,1377,1472,2849,3035
0130-001,2017,4,10,14,1623,1587,3210,2849
0130-001,2017,4,10,15,1560,1613,3173,3210
0130-001,2017,4,10,16,1558,1683,3241,3173
0130-001,2017,4,10,17,1562,1867,3429,3241
0130-001,2017,4,10,18,1563,2307,3870,3429
0130-001,2017,4,10,19,1521,2483,4004,3870
0130-001,2017,4,10,20,1287,1863,3150,4004
0130-001,2017,4,10,21,1232,1869,3101,3150
0130-001,2017,4,10,22,1083,1388,2471,3101
0130-001,2017,4,10,23,784,809,1593,2471
0130-001,2017,4,10,24,516,573,1089,1593
0130-001,2017,4,11,1,388,343,731,1089
0130-001,2017,4,11,2,218,205,423,731
0130-001,2017,4,11,3,159,195,354,423
0130-001,2017,4,11,4,137,189,326,354
0130-001,2017,4,11,5,239,238,477,326
0130-001,2017,4,11,6,485,411,896,477
0130-001,2017,4,11,7,1515,778,2293,896
0130-001,2017,4,11,8,1413,1573,2986,2293
0130-001,2017,4,11,9,1583,1929,3512,2986
0130-001,2017,4,11,10,1647,1618,3265,3512
0130-001,2017,4,11,11,1597,1490,3087,3265
0130-001,2017,4,11,12,1506,1584,3090,3087
0130-001,2017,4,11,13,1343,1392,2735,3090
0130-001,2017,4,11,14,1649,1524,3173,2735
0130-001,2017,4,11,15,1605,1666,3271,3173
0130-001,2017,4,11,16,1540,1743,3283,3271
0130-001,2017,4,11,17,1535,1892,3427,3283
0130-001,2017,4,11,18,1621,2224,3845,3427
0130-001,2017,4,11,19,1538,2434,3972,3845
0130-001,2017,4,11,20,1312,1835,3147,3972
0130-001,2017,4,11,21,1187,1804,2991,3147
0130-001,2017,4,11,22,1056,1349,2405,2991
0130-001,2017,4,11,23,819,864,1683,2405
0130-001,2017,4,11,24,548,576,1124,1683
0130-001,2017,4,12,1,389,344,733,1124
0130-001,2017,4,12,2,214,227,441,733
0130-001,2017,4,12,3,170,199,369,441
0130-001,2017,4,12,4,118,168,286,369
0130-001,2017,4,12,5,291,220,511,286
0130-001,2017,4,12,6,599,422,1021,511
0130-001,2017,4,12,7,1671,859,2530,1021
0130-001,2017,4,12,8,1590,1563,3153,2530
0130-001,2017,4,12,9,1587,1964,3551,3153
0130-001,2017,4,12,10,1626,1650,3276,3551
0130-001,2017,4,12,11,1509,1548,3057,3276
0130-001,2017,4,12,12,1504,1571,3075,3057
0130-001,2017,4,12,13,1339,1405,2744,3075
0130-001,2017,4,12,14,1577,1574,3151,2744
0130-001,2017,4,12,15,1503,1656,3159,3151
0130-001,2017,4,12,16,1583,1792,3375,3159
0130-001,2017,4,12,17,1478,1839,3317,3375
0130-001,2017,4,12,18,1584,2355,3939,3317
0130-001,2017,4,12,19,1583,2548,4131,3939
0130-001,2017,4,12,20,1305,1857,3162,4131
0130-001,2017,4,12,21,1238,1509,2747,3162
0130-001,2017,4,12,22,1127,1323,2450,2747
0130-001,2017,4,12,23,871,924,1795,2450
0130-001,2017,4,12,24,598,583,1181,1795
0130-001,2017,4,13,1,425,399,824,1181
0130-001,2017,4,13,2,228,237,465,824
0130-001,2017,4,13,3,158,212,370,465
0130-001,2017,4,13,4,120,172,292,370
0130-001,2017,4,13,5,232,254,486,292
0130-001,2017,4,13,6,582,456,1038,486
0130-001,2017,4,13,7,1324,860,2184,1038
0130-001,2017,4,13,8,1374,1495,2869,2184
0130-001,2017,4,13,9,1706,1803,3509,2869
0130-001,2017,4,13,10,1637,1802,3439,3509
0130-001,2017,4,13,11,1582,1583,3165,3439
0130-001,2017,4,13,12,1470,1596,3066,3165
0130-001,2017,4,13,13,1310,1436,2746,3066
0130-001,2017,4,13,14,1585,1672,3257,2746
0130-001,2017,4,13,15,1576,1635,3211,3257
0130-001,2017,4,13,16,1632,1738,3370,3211
0130-001,2017,4,13,17,1510,1844,3354,3370
0130-001,2017,4,13,18,1647,2250,3897,3354
0130-001,2017,4,13,19,1576,2491,4067,3897
0130-001,2017,4,13,20,1293,1804,3097,4067
0130-001,2017,4,13,21,1118,1685,2803,3097
0130-001,2017,4,13,22,1110,1352,2462,2803
0130-001,2017,4,13,23,863,912,1775,2462
0130-001,2017,4,13,24,580,575,1155,1775
0130-001,2017,4,14,1,445,393,838,1155
0130-001,2017,4,14,2,230,220,450,838
0130-001,2017,4,14,3,140,185,325,450
0130-001,2017,4,14,4,159,186,345,325
0130-001,2017,4,14,5,233,248,481,345
0130-001,2017,4,14,6,529,455,984,481
0130-001,2017,4,14,7,1637,868,2505,984
0130-001,2017,4,14,8,1439,1563,3002,2505
0130-001,2017,4,14,9,1662,1869,3531,3002
0130-001,2017,4,14,10,1623,1658,3281,3531
0130-001,2017,4,14,11,1537,1591,3128,3281
0130-001,2017,4,14,12,1439,1601,3040,3128
0130-001,2017,4,14,13,1372,1535,2907,3040
0130-001,2017,4,14,14,1544,1673,3217,2907
0130-001,2017,4,14,15,1604,1658,3262,3217
0130-001,2017,4,14,16,1595,1731,3326,3262
0130-001,2017,4,14,17,1564,1951,3515,3326
0130-001,2017,4,14,18,1596,2390,3986,3515
0130-001,2017,4,14,19,1637,2515,4152,3986
0130-001,2017,4,14,20,1372,1983,3355,4152
0130-001,2017,4,14,21,1245,1680,2925,3355
0130-001,2017,4,14,22,1164,1358,2522,2925
0130-001,2017,4,14,23,906,887,1793,2522
0130-001,2017,4,14,24,621,609,1230,1793
0130-001,2017,4,15,1,502,447,949,1230
0130-001,2017,4,15,2,357,329,686,949
0130-001,2017,4,15,3,246,235,481,686
0130-001,2017,4,15,4,223,237,460,481
0130-001,2017,4,15,5,228,285,513,460
0130-001,2017,4,15,6,509,403,912,513
0130-001,2017,4,15,7,1188,767,1955,912
0130-001,2017,4,15,8,1362,1115,2477,1955
0130-001,2017,4,15,9,1389,1540,2929,2477
0130-001,2017,4,15,10,1384,1660,3044,2929
0130-001,2017,4,15,11,1511,1805,3316,3044
0130-001,2017,4,15,12,1559,1735,3294,3316
0130-001,2017,4,15,13,1525,1839,3364,3294
0130-001,2017,4,15,14,1670,1796,3466,3364
0130-001,2017,4,15,15,1615,1789,3404,3466
0130-001,2017,4,15,16,1712,1766,3478,3404
0130-001,2017,4,15,17,1535,1925,3460,3478
0130-001,2017,4,15,18,1693,2206,3899,3460
0130-001,2017,4,15,19,1543,2103,3646,3899
0130-001,2017,4,15,20,1412,1416,2828,3646
0130-001,2017,4,15,21,1193,1241,2434,2828
0130-001,2017,4,15,22,1078,993,2071,2434
0130-001,2017,4,15,23,811,750,1561,2071
0130-001,2017,4,15,24,555,501,1056,1561
0130-001,2017,4,16,1,409,360,769,1056
0130-001,2017,4,16,2,313,268,581,769
0130-001,2017,4,16,3,208,200,408,581
0130-001,2017,4,16,4,159,174,333,408
0130-001,2017,4,16,5,244,197,441,333
0130-001,2017,4,16,6,355,312,667,441
0130-001,2017,4,16,7,733,508,1241,667
0130-001,2017,4,16,8,818,723,1541,1241
0130-001,2017,4,16,9,929,1044,1973,1541
0130-001,2017,4,16,10,1019,1167,2186,1973
0130-001,2017,4,16,11,1447,1385,2832,2186
0130-001,2017,4,16,12,1245,1408,2653,2832
0130-001,2017,4,16,13,1356,1493,2849,2653
0130-001,2017,4,16,14,1515,1543,3058,2849
0130-001,2017,4,16,15,1664,1623,3287,3058
0130-001,2017,4,16,16,1517,1677,3194,3287
0130-001,2017,4,16,17,1553,1640,3193,3194
0130-001,2017,4,16,18,1488,1698,3186,3193
0130-001,2017,4,16,19,1552,1516,3068,3186
0130-001,2017,4,16,20,1338,1249,2587,3068
0130-001,2017,4,16,21,1311,1113,2424,2587
0130-001,2017,4,16,22,1098,850,1948,2424
0130-001,2017,4,16,23,728,624,1352,1948
0130-001,2017,4,16,24,489,414,903,1352
0130-001,2017,4,17,1,313,248,561,903
0130-001,2017,4,17,2,199,181,380,561
0130-001,2017,4,17,3,140,132,272,380
0130-001,2017,4,17,4,145,156,301,272
0130-001,2017,4,17,5,198,207,405,301
0130-001,2017,4,17,6,571,467,1038,405
0130-001,2017,4,17,7,1698,906,2604,1038
0130-001,2017,4,17,8,1550,1599,3149,2604
0130-001,2017,4,17,9,1559,1881,3440,3149
0130-001,2017,4,17,10,1498,1660,3158,3440
0130-001,2017,4,17,11,1587,1572,3159,3158
0130-001,2017,4,17,12,1418,1542,2960,3159
0130-001,2017,4,17,13,1339,1417,2756,2960
0130-001,2017,4,17,14,1550,1528,3078,2756
0130-001,2017,4,17,15,1492,1533,3025,3078
0130-001,2017,4,17,16,1511,1700,3211,3025
0130-001,2017,4,17,17,1514,1793,3307,3211
0130-001,2017,4,17,18,1600,2117,3717,3307
0130-001,2017,4,17,19,1548,2469,4017,3717
0130-001,2017,4,17,20,1323,1747,3070,4017
0130-001,2017,4,17,21,1088,1685,2773,3070
0130-001,2017,4,17,22,1005,1297,2302,2773
0130-001,2017,4,17,23,725,762,1487,2302
0130-001,2017,4,17,24,461,517,978,1487
0130-001,2017,4,18,1,353,334,687,978
0130-001,2017,4,18,2,222,230,452,687
0130-001,2017,4,18,3,153,182,335,452
0130-001,2017,4,18,4,135,180,315,335
0130-001,2017,4,18,5,201,230,431,315
0130-001,2017,4,18,6,562,440,1002,431
0130-001,2017,4,18,7,1624,841,2465,1002
0130-001,2017,4,18,8,1527,1603,3130,2465
0130-001,2017,4,18,9,1675,1945,3620,3130
0130-001,2017,4,18,10,1591,1633,3224,3620
0130-001,2017,4,18,11,1581,1525,3106,3224
0130-001,2017,4,18,12,1588,1608,3196,3106
0130-001,2017,4,18,13,1383,1437,2820,3196
0130-001,2017,4,18,14,1686,1609,3295,2820
0130-001,2017,4,18,15,1522,1716,3238,3295
0130-001,2017,4,18,16,1519,1789,3308,3238
0130-001,2017,4,18,17,1535,1876,3411,3308
0130-001,2017,4,18,18,1464,2091,3555,3411
0130-001,2017,4,18,19,1556,2341,3897,3555
0130-001,2017,4,18,20,1174,1795,2969,3897
0130-001,2017,4,18,21,1123,1524,2647,2969
0130-001,2017,4,18,22,1066,1517,2583,2647
0130-001,2017,4,18,23,788,813,1601,2583
0130-001,2017,4,18,24,501,564,1065,1601
0130-001,2017,4,19,1,370,349,719,1065
0130-001,2017,4,19,2,231,230,461,719
0130-001,2017,4,19,3,154,172,326,461
0130-001,2017,4,19,4,135,162,297,326
0130-001,2017,4,19,5,213,206,419,297
0130-001,2017,4,19,6,525,443,968,419
0130-001,2017,4,19,7,1593,848,2441,968
0130-001,2017,4,19,8,1470,1566,3036,2441
0130-001,2017,4,19,9,1531,1924,3455,3036
0130-001,2017,4,19,10,1491,1528,3019,3455
0130-001,2017,4,19,11,1541,1575,3116,3019
0130-001,2017,4,19,12,1412,1558,2970,3116
0130-001,2017,4,19,13,1313,1459,2772,2970
0130-001,2017,4,19,14,1543,1547,3090,2772
0130-001,2017,4,19,15,1477,1628,3105,3090
0130-001,2017,4,19,16,1518,1689,3207,3105
0130-001,2017,4,19,17,1471,1988,3459,3207
0130-001,2017,4,19,18,1535,2380,3915,3459
0130-001,2017,4,19,19,1542,2526,4068,3915
0130-001,2017,4,19,20,1357,1936,3293,4068
0130-001,2017,4,19,21,1234,1664,2898,3293
0130-001,2017,4,19,22,1147,1390,2537,2898
0130-001,2017,4,19,23,855,849,1704,2537
0130-001,2017,4,19,24,577,593,1170,1704
0130-001,2017,4,20,1,416,368,784,1170
0130-001,2017,4,20,2,203,244,447,784
0130-001,2017,4,20,3,168,190,358,447
0130-001,2017,4,20,4,142,199,341,358
0130-001,2017,4,20,5,222,232,454,341
0130-001,2017,4,20,6,528,425,953,454
0130-001,2017,4,20,7,1623,870,2493,953
0130-001,2017,4,20,8,1557,1595,3152,2493
0130-001,2017,4,20,9,1614,1925,3539,3152
0130-001,2017,4,20,10,1524,1645,3169,3539
0130-001,2017,4,20,11,1564,1617,3181,3169
0130-001,2017,4,20,12,1453,1582,3035,3181
0130-001,2017,4,20,13,1356,1530,2886,3035
0130-001,2017,4,20,14,1640,1618,3258,2886
0130-001,2017,4,20,15,1544,1692,3236,3258
0130-001,2017,4,20,16,1535,1778,3313,3236
0130-001,2017,4,20,17,1578,1825,3403,3313
0130-001,2017,4,20,18,1642,2243,3885,3403
0130-001,2017,4,20,19,1548,2474,4022,3885
0130-001,2017,4,20,20,1354,1873,3227,4022
0130-001,2017,4,20,21,1151,1788,2939,3227
0130-001,2017,4,20,22,1174,1406,2580,2939
0130-001,2017,4,20,23,860,947,1807,2580
0130-001,2017,4,20,24,547,599,1146,1807
0130-001,2017,4,21,1,394,372,766,1146
0130-001,2017,4,21,2,256,274,530,766
0130-001,2017,4,21,3,176,186,362,530
0130-001,2017,4,21,4,149,233,382,362
0130-001,2017,4,21,5,229,248,477,382
0130-001,2017,4,21,6,597,493,1090,477
0130-001,2017,4,21,7,1639,847,2486,1090
0130-001,2017,4,21,8,1550,1509,3059,2486
0130-001,2017,4,21,9,1641,1976,3617,3059
0130-001,2017,4,21,10,1697,1690,3387,3617
0130-001,2017,4,21,11,1622,1688,3310,3387
0130-001,2017,4,21,12,1557,1656,3213,3310
0130-001,2017,4,21,13,1388,1515,2903,3213
0130-001,2017,4,21,14,1658,1677,3335,2903
0130-001,2017,4,21,15,1702,1746,3448,3335
0130-001,2017,4,21,16,1646,1713,3359,3448
0130-001,2017,4,21,17,1587,1896,3483,3359
0130-001,2017,4,21,18,1739,2412,4151,3483
0130-001,2017,4,21,19,1603,2607,4210,4151
0130-001,2017,4,21,20,1359,1976,3335,4210
0130-001,2017,4,21,21,1150,1822,2972,3335
0130-001,2017,4,21,22,1190,1440,2630,2972
0130-001,2017,4,21,23,914,924,1838,2630
0130-001,2017,4,21,24,586,577,1163,1838
0130-001,2017,4,22,1,492,440,932,1163
0130-001,2017,4,22,2,335,291,626,932
0130-001,2017,4,22,3,249,272,521,626
0130-001,2017,4,22,4,230,256,486,521
0130-001,2017,4,22,5,236,240,476,486
0130-001,2017,4,22,6,497,448,945,476
0130-001,2017,4,22,7,1223,731,1954,945
0130-001,2017,4,22,8,1393,1189,2582,1954
0130-001,2017,4,22,9,1424,1573,2997,2582
0130-001,2017,4,22,10,1375,1855,3230,2997
0130-001,2017,4,22,11,1414,1881,3295,3230
0130-001,2017,4,22,12,1538,1833,3371,3295
0130-001,2017,4,22,13,1518,1755,3273,3371
0130-001,2017,4,22,14,1548,1755,3303,3273
0130-001,2017,4,22,15,1564,1782,3346,3303
0130-001,2017,4,22,16,1666,1848,3514,3346
0130-001,2017,4,22,17,1671,1912,3583,3514
0130-001,2017,4,22,18,1701,2175,3876,3583
0130-001,2017,4,22,19,1649,2030,3679,3876
0130-001,2017,4,22,20,1431,1493,2924,3679
0130-001,2017,4,22,21,1162,1311,2473,2924
0130-001,2017,4,22,22,1041,1010,2051,2473
0130-001,2017,4,22,23,873,675,1548,2051
0130-001,2017,4,22,24,552,497,1049,1548
0130-001,2017,4,23,1,449,419,868,1049
0130-001,2017,4,23,2,336,268,604,868
0130-001,2017,4,23,3,223,227,450,604
0130-001,2017,4,23,4,184,161,345,450
0130-001,2017,4,23,5,213,183,396,345
0130-001,2017,4,23,6,359,272,631,396
0130-001,2017,4,23,7,719,503,1222,631
0130-001,2017,4,23,8,760,684,1444,1222
0130-001,2017,4,23,9,898,895,1793,1444
0130-001,2017,4,23,10,990,1158,2148,1793
0130-001,2017,4,23,11,1222,1261,2483,2148
0130-001,2017,4,23,12,1125,1255,2380,2483
0130-001,2017,4,23,13,1266,1353,2619,2380
0130-001,2017,4,23,14,1326,1388,2714,2619
0130-001,2017,4,23,15,1440,1349,2789,2714
0130-001,2017,4,23,16,1433,1314,2747,2789
0130-001,2017,4,23,17,1394,1441,2835,2747
0130-001,2017,4,23,18,1498,1588,3086,2835
0130-001,2017,4,23,19,1547,1488,3035,3086
0130-001,2017,4,23,20,1304,1282,2586,3035
0130-001,2017,4,23,21,1137,1062,2199,2586
0130-001,2017,4,23,22,962,867,1829,2199
0130-001,2017,4,23,23,690,596,1286,1829
0130-001,2017,4,23,24,450,401,851,1286
0130-001,2017,4,24,1,315,264,579,851
0130-001,2017,4,24,2,164,145,309,579
0130-001,2017,4,24,3,122,132,254,309
0130-001,2017,4,24,4,105,159,264,254
0130-001,2017,4,24,5,238,213,451,264
0130-001,2017,4,24,6,674,480,1154,451
0130-001,2017,4,24,7,1720,932,2652,1154
0130-001,2017,4,24,8,1519,1581,3100,2652
0130-001,2017,4,24,9,1589,1960,3549,3100
0130-001,2017,4,24,10,1505,1712,3217,3549
0130-001,2017,4,24,11,1564,1667,3231,3217
0130-001,2017,4,24,12,1459,1518,2977,3231
0130-001,2017,4,24,13,1444,1499,2943,2977
0130-001,2017,4,24,14,1520,1593,3113,2943
0130-001,2017,4,24,15,1545,1533,3078,3113
0130-001,2017,4,24,16,1506,1796,3302,3078
0130-001,2017,4,24,17,1560,1830,3390,3302
0130-001,2017,4,24,18,1619,2358,3977,3390
0130-001,2017,4,24,19,1554,2520,4074,3977
0130-001,2017,4,24,20,1313,1899,3212,4074
0130-001,2017,4,24,21,1166,1807,2973,3212
0130-001,2017,4,24,22,1080,1425,2505,2973
0130-001,2017,4,24,23,791,807,1598,2505
0130-001,2017,4,24,24,460,566,1026,1598
0130-001,2017,4,25,1,358,356,714,1026
0130-001,2017,4,25,2,201,235,436,714
0130-001,2017,4,25,3,147,175,322,436
0130-001,2017,4,25,4,133,191,324,322
0130-001,2017,4,25,5,215,251,466,324
0130-001,2017,4,25,6,600,448,1048,466
0130-001,2017,4,25,7,1684,915,2599,1048
0130-001,2017,4,25,8,1427,1547,2974,2599
0130-001,2017,4,25,9,1593,1897,3490,2974
0130-001,2017,4,25,10,1611,1664,3275,3490
0130-001,2017,4,25,11,1525,1600,3125,3275
0130-001,2017,4,25,12,1570,1613,3183,3125
0130-001,2017,4,25,13,1347,1353,2700,3183
0130-001,2017,4,25,14,1567,1648,3215,2700
0130-001,2017,4,25,15,1550,1653,3203,3215
0130-001,2017,4,25,16,1557,1773,3330,3203
0130-001,2017,4,25,17,1511,1981,3492,3330
0130-001,2017,4,25,18,1681,2236,3917,3492
0130-001,2017,4,25,19,1536,2506,4042,3917
0130-001,2017,4,25,20,1319,1814,3133,4042
0130-001,2017,4,25,21,1104,1803,2907,3133
0130-001,2017,4,25,22,1080,1355,2435,2907
0130-001,2017,4,25,23,837,852,1689,2435
0130-001,2017,4,25,24,519,551,1070,1689
0130-001,2017,4,26,1,369,396,765,1070
0130-001,2017,4,26,2,232,215,447,765
0130-001,2017,4,26,3,138,179,317,447
0130-001,2017,4,26,4,141,185,326,317
0130-001,2017,4,26,5,222,226,448,326
0130-001,2017,4,26,6,595,441,1036,448
0130-001,2017,4,26,7,1630,878,2508,1036
0130-001,2017,4,26,8,1583,1602,3185,2508
0130-001,2017,4,26,9,1615,1892,3507,3185
0130-001,2017,4,26,10,1555,1689,3244,3507
0130-001,2017,4,26,11,1546,1742,3288,3244
0130-001,2017,4,26,12,1448,1798,3246,3288
0130-001,2017,4,26,13,1393,1585,2978,3246
0130-001,2017,4,26,14,1660,1687,3347,2978
0130-001,2017,4,26,15,1531,1769,3300,3347
0130-001,2017,4,26,16,1613,1759,3372,3300
0130-001,2017,4,26,17,1546,1838,3384,3372
0130-001,2017,4,26,18,1640,2381,4021,3384
0130-001,2017,4,26,19,1517,2564,4081,4021
0130-001,2017,4,26,20,1304,1982,3286,4081
0130-001,2017,4,26,21,1147,1654,2801,3286
0130-001,2017,4,26,22,1131,1344,2475,2801
0130-001,2017,4,26,23,845,795,1640,2475
0130-001,2017,4,26,24,539,557,1096,1640
0130-001,2017,4,27,1,397,371,768,1096
0130-001,2017,4,27,2,250,233,483,768
0130-001,2017,4,27,3,184,208,392,483
0130-001,2017,4,27,4,157,205,362,392
0130-001,2017,4,27,5,234,275,509,362
0130-001,2017,4,27,6,610,456,1066,509
0130-001,2017,4,27,7,1588,866,2454,1066
0130-001,2017,4,27,8,1570,1599,3169,2454
0130-001,2017,4,27,9,1594,1925,3519,3169
0130-001,2017,4,27,10,1606,1606,3212,3519
0130-001,2017,4,27,11,1528,1655,3183,3212
0130-001,2017,4,27,12,1471,1581,3052,3183
0130-001,2017,4,27,13,1449,1519,2968,3052
0130-001,2017,4,27,14,1638,1693,3331,2968
0130-001,2017,4,27,15,1478,1692,3170,3331
0130-001,2017,4,27,16,1546,1801,3347,3170
0130-001,2017,4,27,17,1556,1922,3478,3347
0130-001,2017,4,27,18,1629,2230,3859,3478
0130-001,2017,4,27,19,1493,2430,3923,3859
0130-001,2017,4,27,20,1281,1901,3182,3923
0130-001,2017,4,27,21,1175,1753,2928,3182
0130-001,2017,4,27,22,1102,1504,2606,2928
0130-001,2017,4,27,23,861,860,1721,2606
0130-001,2017,4,27,24,538,580,1118,1721
0130-001,2017,4,28,1,430,392,822,1118
0130-001,2017,4,28,2,240,263,503,822
0130-001,2017,4,28,3,153,181,334,503
0130-001,2017,4,28,4,139,214,353,334
0130-001,2017,4,28,5,243,249,492,353
0130-001,2017,4,28,6,604,451,1055,492
0130-001,2017,4,28,7,1684,925,2609,1055
0130-001,2017,4,28,8,1513,1497,3010,2609
0130-001,2017,4,28,9,1606,1946,3552,3010
0130-001,2017,4,28,10,1477,1606,3083,3552
0130-001,2017,4,28,11,1428,1716,3144,3083
0130-001,2017,4,28,12,1485,1736,3221,3144
0130-001,2017,4,28,13,1400,1595,2995,3221
0130-001,2017,4,28,14,1670,1703,3373,2995
0130-001,2017,4,28,15,1451,1737,3188,3373
0130-001,2017,4,28,16,1516,1827,3343,3188
0130-001,2017,4,28,17,1537,1960,3497,3343
0130-001,2017,4,28,18,1566,2334,3900,3497
0130-001,2017,4,28,19,1517,2587,4104,3900
0130-001,2017,4,28,20,1404,2085,3489,4104
0130-001,2017,4,28,21,1160,1791,2951,3489
0130-001,2017,4,28,22,1187,1414,2601,2951
0130-001,2017,4,28,23,930,891,1821,2601
0130-001,2017,4,28,24,611,682,1293,1821
0130-001,2017,4,29,1,464,432,896,1293
0130-001,2017,4,29,2,357,325,682,896
0130-001,2017,4,29,3,258,248,506,682
0130-001,2017,4,29,4,237,260,497,506
0130-001,2017,4,29,5,228,274,502,497
0130-001,2017,4,29,6,587,460,1047,502
0130-001,2017,4,29,7,1222,766,1988,1047
0130-001,2017,4,29,8,1446,1189,2635,1988
0130-001,2017,4,29,9,1499,1733,3232,2635
0130-001,2017,4,29,10,1575,1917,3492,3232
0130-001,2017,4,29,11,1462,1624,3086,3492
0130-001,2017,4,29,12,1548,1888,3436,3086
0130-001,2017,4,29,13,1522,1925,3447,3436
0130-001,2017,4,29,14,1609,1840,3449,3447
0130-001,2017,4,29,15,1590,1781,3371,3449
0130-001,2017,4,29,16,1689,1946,3635,3371
0130-001,2017,4,29,17,1603,2345,3948,3635
0130-001,2017,4,29,18,1713,2266,3979,3948
0130-001,2017,4,29,19,1529,2025,3554,3979
0130-001,2017,4,29,20,1349,1439,2788,3554
0130-001,2017,4,29,21,1190,1259,2449,2788
0130-001,2017,4,29,22,1028,966,1994,2449
0130-001,2017,4,29,23,780,680,1460,1994
0130-001,2017,4,29,24,507,485,992,1460
0130-001,2017,4,30,1,381,357,738,992
0130-001,2017,4,30,2,301,281,582,738
0130-001,2017,4,30,3,221,211,432,582
0130-001,2017,4,30,4,187,171,358,432
0130-001,2017,4,30,5,195,158,353,358
0130-001,2017,4,30,6,370,295,665,353
0130-001,2017,4,30,7,703,500,1203,665
0130-001,2017,4,30,8,851,721,1572,1203
0130-001,2017,4,30,9,874,978,1852,1572
0130-001,2017,4,30,10,1054,1178,2232,1852
0130-001,2017,4,30,11,1147,1315,2462,2232
0130-001,2017,4,30,12,1065,1369,2434,2462
0130-001,2017,4,30,13,1251,1354,2605,2434
0130-001,2017,4,30,14,1438,1376,2814,2605
0130-001,2017,4,30,15,1372,1414,2786,2814
0130-001,2017,4,30,16,1504,1578,3082,2786
0130-001,2017,4,30,17,1460,1497,2957,3082
0130-001,2017,4,30,18,1547,1651,3198,2957
0130-001,2017,4,30,19,1461,1536,2997,3198
0130-001,2017,4,30,20,1223,1205,2428,2997
0130-001,2017,4,30,21,1289,1180,2469,2428
0130-001,2017,4,30,22,1013,861,1874,2469
0130-001,2017,4,30,23,744,644,1388,1874
0130-001,2017,4,30,24,517,440,957,1388
0130-001,2017,5,1,1,290,318,608,957
0130-001,2017,5,1,2,190,186,376,608
0130-001,2017,5,1,3,180,161,341,376
0130-001,2017,5,1,4,131,161,292,341
0130-001,2017,5,1,5,203,195,398,292
0130-001,2017,5,1,6,381,329,710,398
0130-001,2017,5,1,7,1150,684,1834,710
0130-001,2017,5,1,8,1516,1316,2832,1834
0130-001,2017,5,1,9,1601,1528,3129,2832
0130-001,2017,5,1,10,1496,1496,2992,3129
0130-001,2017,5,1,11,1606,1598,3204,2992
0130-001,2017,5,1,12,1482,1647,3129,3204
0130-001,2017,5,1,13,1514,1643,3157,3129
0130-001,2017,5,1,14,1601,1755,3356,3157
0130-001,2017,5,1,15,1621,1683,3304,3356
0130-001,2017,5,1,16,1621,1767,3388,3304
0130-001,2017,5,1,17,1625,1841,3466,3388
0130-001,2017,5,1,18,1646,2091,3737,3466
0130-001,2017,5,1,19,1508,2114,3622,3737
0130-001,2017,5,1,20,1297,1496,2793,3622
0130-001,2017,5,1,21,1142,1295,2437,2793
0130-001,2017,5,1,22,1005,990,1995,2437
0130-001,2017,5,1,23,752,699,1451,1995
0130-001,2017,5,1,24,516,478,994,1451
0130-001,2017,5,2,1,345,293,638,994
0130-001,2017,5,2,2,205,196,401,638
0130-001,2017,5,2,3,157,189,346,401
0130-001,2017,5,2,4,160,191,351,346
0130-001,2017,5,2,5,259,216,475,351
0130-001,2017,5,2,6,630,486,1116,475
0130-001,2017,5,2,7,1727,930,2657,1116
0130-001,2017,5,2,8,1503,1563,3066,2657
0130-001,2017,5,2,9,1587,1928,3515,3066
0130-001,2017,5,2,10,1627,1670,3297,3515
0130-001,2017,5,2,11,1535,1695,3230,3297
0130-001,2017,5,2,12,1519,1717,3236,3230
0130-001,2017,5,2,13,1464,1531,2995,3236
0130-001,2017,5,2,14,1679,1714,3393,2995
0130-001,2017,5,2,15,1570,1731,3301,3393
0130-001,2017,5,2,16,1601,1840,3441,3301
0130-001,2017,5,2,17,1681,1931,3612,3441
0130-001,2017,5,2,18,1590,2402,3992,3612
0130-001,2017,5,2,19,1619,2577,4196,3992
0130-001,2017,5,2,20,1388,2001,3389,4196
0130-001,2017,5,2,21,1194,1794,2988,3389
0130-001,2017,5,2,22,1092,1329,2421,2988
0130-001,2017,5,2,23,889,818,1707,2421
0130-001,2017,5,2,24,613,581,1194,1707
0130-001,2017,5,3,1,434,409,843,1194
0130-001,2017,5,3,2,276,283,559,843
0130-001,2017,5,3,3,249,222,471,559
0130-001,2017,5,3,4,185,219,404,471
0130-001,2017,5,3,5,259,232,491,404
0130-001,2017,5,3,6,541,456,997,491
0130-001,2017,5,3,7,1198,715,1913,997
0130-001,2017,5,3,8,1396,1103,2499,1913
0130-001,2017,5,3,9,1338,1332,2670,2499
0130-001,2017,5,3,10,1394,1536,2930,2670
0130-001,2017,5,3,11,1398,1709,3107,2930
0130-001,2017,5,3,12,1437,1899,3336,3107
0130-001,2017,5,3,13,1293,1712,3005,3336
0130-001,2017,5,3,14,1352,1775,3127,3005
0130-001,2017,5,3,15,1429,1780,3209,3127
0130-001,2017,5,3,16,1437,1634,3071,3209
0130-001,2017,5,3,17,1398,1702,3100,3071
0130-001,2017,5,3,18,1582,1954,3536,3100
0130-001,2017,5,3,19,1407,1888,3295,3536
0130-001,2017,5,3,20,1252,1454,2706,3295
0130-001,2017,5,3,21,1012,1221,2233,2706
0130-001,2017,5,3,22,1010,1005,2015,2233
0130-001,2017,5,3,23,809,635,1444,2015
0130-001,2017,5,3,24,492,436,928,1444
0130-001,2017,5,4,1,370,319,689,928
0130-001,2017,5,4,2,223,225,448,689
0130-001,2017,5,4,3,150,168,318,448
0130-001,2017,5,4,4,135,161,296,318
0130-001,2017,5,4,5,244,215,459,296
0130-001,2017,5,4,6,541,396,937,459
0130-001,2017,5,4,7,1377,837,2214,937
0130-001,2017,5,4,8,1569,1291,2860,2214
0130-001,2017,5,4,9,1507,1609,3116,2860
0130-001,2017,5,4,10,1532,1580,3112,3116
0130-001,2017,5,4,11,1488,1660,3148,3112
0130-001,2017,5,4,12,1459,1710,3169,3148
0130-001,2017,5,4,13,1403,1492,2895,3169
0130-001,2017,5,4,14,1574,1810,3384,2895
0130-001,2017,5,4,15,1477,1727,3204,3384
0130-001,2017,5,4,16,1540,1808,3348,3204
0130-001,2017,5,4,17,1582,1919,3501,3348
0130-001,2017,5,4,18,1662,2144,3806,3501
0130-001,2017,5,4,19,1547,2273,3820,3806
0130-001,2017,5,4,20,1341,1747,3088,3820
0130-001,2017,5,4,21,1242,1535,2777,3088
0130-001,2017,5,4,22,959,1245,2204,2777
0130-001,2017,5,4,23,766,810,1576,2204
0130-001,2017,5,4,24,548,505,1053,1576
0130-001,2017,5,5,1,399,342,741,1053
0130-001,2017,5,5,2,271,252,523,741
0130-001,2017,5,5,3,240,209,449,523
0130-001,2017,5,5,4,215,196,411,449
0130-001,2017,5,5,5,207,234,441,411
0130-001,2017,5,5,6,522,370,892,441
0130-001,2017,5,5,7,1060,666,1726,892
0130-001,2017,5,5,8,1088,937,2025,1726
0130-001,2017,5,5,9,1142,1197,2339,2025
0130-001,2017,5,5,10,1267,1568,2835,2339
0130-001,2017,5,5,11,1377,1839,3216,2835
0130-001,2017,5,5,12,1324,2140,3464,3216
0130-001,2017,5,5,13,1274,2061,3335,3464
0130-001,2017,5,5,14,1250,1894,3144,3335
0130-001,2017,5,5,15,1367,1632,2999,3144
0130-001,2017,5,5,16,1516,1571,3087,2999
0130-001,2017,5,5,17,1537,1650,3187,3087
0130-001,2017,5,5,18,1476,1842,3318,3187
0130-001,2017,5,5,19,1464,1592,3056,3318
0130-001,2017,5,5,20,1182,1260,2442,3056
0130-001,2017,5,5,21,1155,1158,2313,2442
0130-001,2017,5,5,22,1000,849,1849,2313
0130-001,2017,5,5,23,699,615,1314,1849
0130-001,2017,5,5,24,485,461,946,1314
0130-001,2017,5,6,1,345,316,661,946
0130-001,2017,5,6,2,240,210,450,661
0130-001,2017,5,6,3,173,188,361,450
0130-001,2017,5,6,4,157,166,323,361
0130-001,2017,5,6,5,194,215,409,323
0130-001,2017,5,6,6,472,378,850,409
0130-001,2017,5,6,7,983,600,1583,850
0130-001,2017,5,6,8,1018,830,1848,1583
0130-001,2017,5,6,9,1117,1089,2206,1848
0130-001,2017,5,6,10,1242,1401,2643,2206
0130-001,2017,5,6,11,1301,1515,2816,2643
0130-001,2017,5,6,12,1372,1570,2942,2816
0130-001,2017,5,6,13,1335,1460,2795,2942
0130-001,2017,5,6,14,1330,1529,2859,2795
0130-001,2017,5,6,15,1384,1513,2897,2859
0130-001,2017,5,6,16,1423,1639,3062,2897
0130-001,2017,5,6,17,1529,1703,3232,3062
0130-001,2017,5,6,18,1463,1788,3251,3232
0130-001,2017,5,6,19,1478,1566,3044,3251
0130-001,2017,5,6,20,1439,1223,2662,3044
0130-001,2017,5,6,21,1274,1164,2438,2662
0130-001,2017,5,6,22,1230,953,2183,2438
0130-001,2017,5,6,23,812,698,1510,2183
0130-001,2017,5,6,24,552,452,1004,1510
0130-001,2017,5,7,1,372,340,712,1004
0130-001,2017,5,7,2,269,225,494,712
0130-001,2017,5,7,3,208,185,393,494
0130-001,2017,5,7,4,183,149,332,393
0130-001,2017,5,7,5,188,151,339,332
0130-001,2017,5,7,6,350,269,619,339
0130-001,2017,5,7,7,638,449,1087,619
0130-001,2017,5,7,8,663,665,1328,1087
0130-001,2017,5,7,9,822,931,1753,1328
0130-001,2017,5,7,10,934,1089,2023,1753
0130-001,2017,5,7,11,1316,1312,2628,2023
0130-001,2017,5,7,12,1324,1432,2756,2628
0130-001,2017,5,7,13,1375,1478,2853,2756
0130-001,2017,5,7,14,1404,1377,2781,2853
0130-001,2017,5,7,15,1564,1576,3140,2781
0130-001,2017,5,7,16,1631,1567,3198,3140
0130-001,2017,5,7,17,1668,1491,3159,3198
0130-001,2017,5,7,18,1675,1688,3363,3159
0130-001,2017,5,7,19,1631,1444,3075,3363
0130-001,2017,5,7,20,1296,1229,2525,3075
0130-001,2017,5,7,21,1347,1187,2534,2525
0130-001,2017,5,7,22,1080,959,2039,2534
0130-001,2017,5,7,23,762,706,1468,2039
0130-001,2017,5,7,24,473,358,831,1468
0130-001,2017,5,8,1,334,259,593,831
0130-001,2017,5,8,2,200,171,371,593
0130-001,2017,5,8,3,140,129,269,371
0130-001,2017,5,8,4,116,139,255,269
0130-001,2017,5,8,5,228,250,478,255
0130-001,2017,5,8,6,642,454,1096,478
0130-001,2017,5,8,7,1688,966,2654,1096
0130-001,2017,5,8,8,1436,1605,3041,2654
0130-001,2017,5,8,9,1449,1907,3356,3041
0130-001,2017,5,8,10,1511,1590,3101,3356
0130-001,2017,5,8,11,1424,1510,2934,3101
0130-001,2017,5,8,12,1631,1596,3227,2934
0130-001,2017,5,8,13,1552,1523,3075,3227
0130-001,2017,5,8,14,1510,1666,3176,3075
0130-001,2017,5,8,15,1523,1698,3221,3176
0130-001,2017,5,8,16,1544,1796,3340,3221
0130-001,2017,5,8,17,1573,1903,3476,3340
0130-001,2017,5,8,18,1577,2438,4015,3476
0130-001,2017,5,8,19,1640,2384,4024,4015
0130-001,2017,5,8,20,1403,1977,3380,4024
0130-001,2017,5,8,21,1223,1726,2949,3380
0130-001,2017,5,8,22,1058,1359,2417,2949
0130-001,2017,5,8,23,782,834,1616,2417
0130-001,2017,5,8,24,513,530,1043,1616
0130-001,2017,5,9,1,390,367,757,1043
0130-001,2017,5,9,2,241,250,491,757
0130-001,2017,5,9,3,214,200,414,491
0130-001,2017,5,9,4,171,180,351,414
0130-001,2017,5,9,5,259,264,523,351
0130-001,2017,5,9,6,476,367,843,523
0130-001,2017,5,9,7,1147,705,1852,843
0130-001,2017,5,9,8,1333,1056,2389,1852
0130-001,2017,5,9,9,1361,1347,2708,2389
0130-001,2017,5,9,10,1498,1429,2927,2708
0130-001,2017,5,9,11,1474,1541,3015,2927
0130-001,2017,5,9,12,1414,1591,3005,3015
0130-001,2017,5,9,13,1443,1602,3045,3005
0130-001,2017,5,9,14,1524,1609,3133,3045
0130-001,2017,5,9,15,1498,1696,3194,3133
0130-001,2017,5,9,16,1515,1764,3279,3194
0130-001,2017,5,9,17,1464,1763,3227,3279
0130-001,2017,5,9,18,1418,1888,3306,3227
0130-001,2017,5,9,19,1451,1850,3301,3306
0130-001,2017,5,9,20,1161,1254,2415,3301
0130-001,2017,5,9,21,1081,1216,2297,2415
0130-001,2017,5,9,22,888,926,1814,2297
0130-001,2017,5,9,23,601,564,1165,1814
0130-001,2017,5,9,24,441,418,859,1165
0130-001,2017,5,10,1,283,291,574,859
0130-001,2017,5,10,2,188,158,346,574
0130-001,2017,5,10,3,129,166,295,346
0130-001,2017,5,10,4,138,151,289,295
0130-001,2017,5,10,5,230,201,431,289
0130-001,2017,5,10,6,565,429,994,431
0130-001,2017,5,10,7,1572,839,2411,994
0130-001,2017,5,10,8,1452,1604,3056,2411
0130-001,2017,5,10,9,1567,1987,3554,3056
0130-001,2017,5,10,10,1542,1588,3130,3554
0130-001,2017,5,10,11,1536,1575,3111,3130
0130-001,2017,5,10,12,1552,1481,3033,3111
0130-001,2017,5,10,13,1507,1437,2944,3033
0130-001,2017,5,10,14,1484,1674,3158,2944
0130-001,2017,5,10,15,1591,1566,3157,3158
0130-001,2017,5,10,16,1556,1750,3306,3157
0130-001,2017,5,10,17,1467,1783,3250,3306
0130-001,2017,5,10,18,1663,2385,4048,3250
0130-001,2017,5,10,19,1513,2516,4029,4048
0130-001,2017,5,10,20,1255,1962,3217,4029
0130-001,2017,5,10,21,1199,1665,2864,3217
0130-001,2017,5,10,22,1110,1354,2464,2864
0130-001,2017,5,10,23,801,808,1609,2464
0130-001,2017,5,10,24,545,534,1079,1609
0130-001,2017,5,11,1,403,340,743,1079
0130-001,2017,5,11,2,247,228,475,743
0130-001,2017,5,11,3,177,194,371,475
0130-001,2017,5,11,4,159,226,385,371
0130-001,2017,5,11,5,237,220,457,385
0130-001,2017,5,11,6,623,434,1057,457
0130-001,2017,5,11,7,1610,912,2522,1057
0130-001,2017,5,11,8,1481,1584,3065,2522
0130-001,2017,5,11,9,1564,1940,3504,3065
0130-001,2017,5,11,10,1606,1624,3230,3504
0130-001,2017,5,11,11,1653,1581,3234,3230
0130-001,2017,5,11,12,1587,1541,3128,3234
0130-001,2017,5,11,13,1459,1367,2826,3128
0130-001,2017,5,11,14,1578,1709,3287,2826
0130-001,2017,5,11,15,1534,1664,3198,3287
0130-001,2017,5,11,16,1498,1790,3288,3198
0130-001,2017,5,11,17,1486,1927,3413,3288
0130-001,2017,5,11,18,1650,2355,4005,3413
0130-001,2017,5,11,19,1581,2552,4133,4005
0130-001,2017,5,11,20,1237,1860,3097,4133
0130-001,2017,5,11,21,1216,1812,3028,3097
0130-001,2017,5,11,22,1081,1488,2569,3028
0130-001,2017,5,11,23,835,871,1706,2569
0130-001,2017,5,11,24,619,531,1150,1706
0130-001,2017,5,12,1,419,400,819,1150
0130-001,2017,5,12,2,250,245,495,819
0130-001,2017,5,12,3,186,182,368,495
0130-001,2017,5,12,4,153,201,354,368
0130-001,2017,5,12,5,224,255,479,354
0130-001,2017,5,12,6,657,459,1116,479
0130-001,2017,5,12,7,1699,900,2599,1116
0130-001,2017,5,12,8,1517,1586,3103,2599
0130-001,2017,5,12,9,1589,1942,3531,3103
0130-001,2017,5,12,10,1465,1597,3062,3531
0130-001,2017,5,12,11,1508,1585,3093,3062
0130-001,2017,5,12,12,1454,1610,3064,3093
0130-001,2017,5,12,13,1416,1494,2910,3064
0130-001,2017,5,12,14,1568,1767,3335,2910
0130-001,2017,5,12,15,1561,1698,3259,3335
0130-001,2017,5,12,16,1547,1778,3325,3259
0130-001,2017,5,12,17,1598,1830,3428,3325
0130-001,2017,5,12,18,1642,2360,4002,3428
0130-001,2017,5,12,19,1545,2559,4104,4002
0130-001,2017,5,12,20,1386,2018,3404,4104
0130-001,2017,5,12,21,1206,1755,2961,3404
0130-001,2017,5,12,22,1096,1336,2432,2961
0130-001,2017,5,12,23,876,872,1748,2432
0130-001,2017,5,12,24,605,613,1218,1748
0130-001,2017,5,13,1,461,411,872,1218
0130-001,2017,5,13,2,337,337,674,872
0130-001,2017,5,13,3,301,230,531,674
0130-001,2017,5,13,4,219,261,480,531
0130-001,2017,5,13,5,237,268,505,480
0130-001,2017,5,13,6,573,437,1010,505
0130-001,2017,5,13,7,1278,754,2032,1010
0130-001,2017,5,13,8,1380,1112,2492,2032
0130-001,2017,5,13,9,1263,1530,2793,2492
0130-001,2017,5,13,10,1527,1795,3322,2793
0130-001,2017,5,13,11,1579,1826,3405,3322
0130-001,2017,5,13,12,1560,1701,3261,3405
0130-001,2017,5,13,13,1458,1746,3204,3261
0130-001,2017,5,13,14,1502,1798,3300,3204
0130-001,2017,5,13,15,1559,1768,3327,3300
0130-001,2017,5,13,16,1437,1553,2990,3327
0130-001,2017,5,13,17,1512,1952,3464,2990
0130-001,2017,5,13,18,1626,2008,3634,3464
0130-001,2017,5,13,19,1582,1858,3440,3634
0130-001,2017,5,13,20,1271,1272,2543,3440
0130-001,2017,5,13,21,1090,1145,2235,2543
0130-001,2017,5,13,22,1026,958,1984,2235
0130-001,2017,5,13,23,801,662,1463,1984
0130-001,2017,5,13,24,531,488,1019,1463
0130-001,2017,5,14,1,417,351,768,1019
0130-001,2017,5,14,2,301,294,595,768
0130-001,2017,5,14,3,267,219,486,595
0130-001,2017,5,14,4,176,170,346,486
0130-001,2017,5,14,5,215,181,396,346
0130-001,2017,5,14,6,439,298,737,396
0130-001,2017,5,14,7,724,523,1247,737
0130-001,2017,5,14,8,781,665,1446,1247
0130-001,2017,5,14,9,841,960,1801,1446
0130-001,2017,5,14,10,1007,1134,2141,1801
0130-001,2017,5,14,11,1210,1232,2442,2141
0130-001,2017,5,14,12,1160,1244,2404,2442
0130-001,2017,5,14,13,1266,1331,2597,2404
0130-001,2017,5,14,14,1381,1449,2830,2597
0130-001,2017,5,14,15,1412,1376,2788,2830
0130-001,2017,5,14,16,1357,1491,2848,2788
0130-001,2017,5,14,17,1374,1521,2895,2848
0130-001,2017,5,14,18,1363,1598,2961,2895
0130-001,2017,5,14,19,1416,1428,2844,2961
0130-001,2017,5,14,20,1239,1182,2421,2844
0130-001,2017,5,14,21,1110,1072,2182,2421
0130-001,2017,5,14,22,931,908,1839,2182
0130-001,2017,5,14,23,716,611,1327,1839
0130-001,2017,5,14,24,481,415,896,1327
0130-001,2017,5,15,1,298,273,571,896
0130-001,2017,5,15,2,189,191,380,571
0130-001,2017,5,15,3,140,126,266,380
0130-001,2017,5,15,4,126,149,275,266
0130-001,2017,5,15,5,231,215,446,275
0130-001,2017,5,15,6,728,502,1230,446
0130-001,2017,5,15,7,1695,992,2687,1230
0130-001,2017,5,15,8,1565,1627,3192,2687
0130-001,2017,5,15,9,1629,1913,3542,3192
0130-001,2017,5,15,10,1542,1609,3151,3542
0130-001,2017,5,15,11,1650,1621,3271,3151
0130-001,2017,5,15,12,1533,1479,3012,3271
0130-001,2017,5,15,13,1468,1450,2918,3012
0130-001,2017,5,15,14,1565,1644,3209,2918
0130-001,2017,5,15,15,1706,1703,3409,3209
0130-001,2017,5,15,16,1556,1745,3301,3409
0130-001,2017,5,15,17,1614,1967,3581,3301
0130-001,2017,5,15,18,1613,2458,4071,3581
0130-001,2017,5,15,19,1561,2477,4038,4071
0130-001,2017,5,15,20,1224,1918,3142,4038
0130-001,2017,5,15,21,1184,1797,2981,3142
0130-001,2017,5,15,22,1028,1365,2393,2981
0130-001,2017,5,15,23,826,807,1633,2393
0130-001,2017,5,15,24,477,544,1021,1633
0130-001,2017,5,16,1,343,336,679,1021
0130-001,2017,5,16,2,237,232,469,679
0130-001,2017,5,16,3,149,201,350,469
0130-001,2017,5,16,4,140,179,319,350
0130-001,2017,5,16,5,229,261,490,319
0130-001,2017,5,16,6,645,475,1120,490
0130-001,2017,5,16,7,1726,882,2608,1120
0130-001,2017,5,16,8,1381,1629,3010,2608
0130-001,2017,5,16,9,1486,1968,3454,3010
0130-001,2017,5,16,10,1560,1678,3238,3454
0130-001,2017,5,16,11,1599,1604,3203,3238
0130-001,2017,5,16,12,1454,1611,3065,3203
0130-001,2017,5,16,13,1466,1429,2895,3065
0130-001,2017,5,16,14,1578,1605,3183,2895
0130-001,2017,5,16,15,1517,1681,3198,3183
0130-001,2017,5,16,16,1550,1652,3202,3198
0130-001,2017,5,16,17,1458,1893,3351,3202
0130-001,2017,5,16,18,1467,2367,3834,3351
0130-001,2017,5,16,19,1527,2474,4001,3834
0130-001,2017,5,16,20,1264,1783,3047,4001
0130-001,2017,5,16,21,1144,1775,2919,3047
0130-001,2017,5,16,22,1127,1483,2610,2919
0130-001,2017,5,16,23,820,860,1680,2610
0130-001,2017,5,16,24,530,578,1108,1680
0130-001,2017,5,17,1,399,348,747,1108
0130-001,2017,5,17,2,241,239,480,747
0130-001,2017,5,17,3,174,216,390,480
0130-001,2017,5,17,4,145,187,332,390
0130-001,2017,5,17,5,207,226,433,332
0130-001,2017,5,17,6,675,482,1157,433
0130-001,2017,5,17,7,1630,916,2546,1157
0130-001,2017,5,17,8,1442,1651,3093,2546
0130-001,2017,5,17,9,1523,1994,3517,3093
0130-001,2017,5,17,10,1604,1558,3162,3517
0130-001,2017,5,17,11,1573,1583,3156,3162
0130-001,2017,5,17,12,1464,1540,3004,3156
0130-001,2017,5,17,13,1440,1529,2969,3004
0130-001,2017,5,17,14,1573,1697,3270,2969
0130-001,2017,5,17,15,1485,1622,3107,3270
0130-001,2017,5,17,16,1597,1667,3264,3107
0130-001,2017,5,17,17,1564,1887,3451,3264
0130-001,2017,5,17,18,1655,2468,4123,3451
0130-001,2017,5,17,19,1585,2519,4104,4123
0130-001,2017,5,17,20,1339,1907,3246,4104
0130-001,2017,5,17,21,1192,1660,2852,3246
0130-001,2017,5,17,22,1180,1313,2493,2852
0130-001,2017,5,17,23,885,853,1738,2493
0130-001,2017,5,17,24,592,608,1200,1738
0130-001,2017,5,18,1,403,398,801,1200
0130-001,2017,5,18,2,274,278,552,801
0130-001,2017,5,18,3,183,221,404,552
0130-001,2017,5,18,4,139,194,333,404
0130-001,2017,5,18,5,213,244,457,333
0130-001,2017,5,18,6,662,494,1156,457
0130-001,2017,5,18,7,1725,925,2650,1156
0130-001,2017,5,18,8,1577,1646,3223,2650
0130-001,2017,5,18,9,1551,1908,3459,3223
0130-001,2017,5,18,10,1597,1661,3258,3459
0130-001,2017,5,18,11,1544,1669,3213,3258
0130-001,2017,5,18,12,1539,1578,3117,3213
0130-001,2017,5,18,13,1367,1496,2863,3117
0130-001,2017,5,18,14,1620,1645,3265,2863
0130-001,2017,5,18,15,1567,1690,3257,3265
0130-001,2017,5,18,16,1585,1796,3381,3257
0130-001,2017,5,18,17,1542,1919,3461,3381
0130-001,2017,5,18,18,1610,2404,4014,3461
0130-001,2017,5,18,19,1558,2502,4060,4014
0130-001,2017,5,18,20,1293,1930,3223,4060
0130-001,2017,5,18,21,1215,1823,3038,3223
0130-001,2017,5,18,22,1116,1453,2569,3038
0130-001,2017,5,18,23,993,864,1857,2569
0130-001,2017,5,18,24,579,568,1147,1857
0130-001,2017,5,19,1,382,377,759,1147
0130-001,2017,5,19,2,248,245,493,759
0130-001,2017,5,19,3,183,195,378,493
0130-001,2017,5,19,4,163,211,374,378
0130-001,2017,5,19,5,212,254,466,374
0130-001,2017,5,19,6,672,485,1157,466
0130-001,2017,5,19,7,1651,889,2540,1157
0130-001,2017,5,19,8,1520,1621,3141,2540
0130-001,2017,5,19,9,1601,1897,3498,3141
0130-001,2017,5,19,10,1536,1562,3098,3498
0130-001,2017,5,19,11,1635,1626,3261,3098
0130-001,2017,5,19,12,1618,1642,3260,3261
0130-001,2017,5,19,13,1308,1435,2743,3260
0130-001,2017,5,19,14,1577,1633,3210,2743
0130-001,2017,5,19,15,1632,1678,3310,3210
0130-001,2017,5,19,16,1615,1877,3492,3310
0130-001,2017,5,19,17,1546,1944,3490,3492
0130-001,2017,5,19,18,1620,2518,4138,3490
0130-001,2017,5,19,19,1616,2610,4226,4138
0130-001,2017,5,19,20,1403,1999,3402,4226
0130-001,2017,5,19,21,1290,1794,3084,3402
0130-001,2017,5,19,22,1202,1442,2644,3084
0130-001,2017,5,19,23,967,995,1962,2644
0130-001,2017,5,19,24,672,660,1332,1962
0130-001,2017,5,20,1,521,545,1066,1332
0130-001,2017,5,20,2,320,333,653,1066
0130-001,2017,5,20,3,236,245,481,653
0130-001,2017,5,20,4,185,232,417,481
0130-001,2017,5,20,5,238,298,536,417
0130-001,2017,5,20,6,642,502,1144,536
0130-001,2017,5,20,7,1233,773,2006,1144
0130-001,2017,5,20,8,1405,1130,2535,2006
0130-001,2017,5,20,9,1337,1595,2932,2535
0130-001,2017,5,20,10,1392,1654,3046,2932
0130-001,2017,5,20,11,1363,1723,3086,3046
0130-001,2017,5,20,12,1367,1722,3089,3086
0130-001,2017,5,20,13,1349,1624,2973,3089
0130-001,2017,5,20,14,1441,1708,3149,2973
0130-001,2017,5,20,15,1506,1723,3229,3149
0130-001,2017,5,20,16,1698,1855,3553,3229
0130-001,2017,5,20,17,1618,1992,3610,3553
0130-001,2017,5,20,18,1788,2216,4004,3610
0130-001,2017,5,20,19,1655,1935,3590,4004
0130-001,2017,5,20,20,1381,1440,2821,3590
0130-001,2017,5,20,21,1113,1224,2337,2821
0130-001,2017,5,20,22,993,985,1978,2337
0130-001,2017,5,20,23,852,761,1613,1978
0130-001,2017,5,20,24,546,559,1105,1613
0130-001,2017,5,21,1,431,414,845,1105
0130-001,2017,5,21,2,319,294,613,845
0130-001,2017,5,21,3,226,198,424,613
0130-001,2017,5,21,4,217,200,417,424
0130-001,2017,5,21,5,223,177,400,417
0130-001,2017,5,21,6,416,292,708,400
0130-001,2017,5,21,7,708,577,1285,708
0130-001,2017,5,21,8,754,754,1508,1285
0130-001,2017,5,21,9,929,923,1852,1508
0130-001,2017,5,21,10,1013,1181,2194,1852
0130-001,2017,5,21,11,1263,1430,2693,2194
0130-001,2017,5,21,12,1197,1397,2594,2693
0130-001,2017,5,21,13,1352,1417,2769,2594
0130-001,2017,5,21,14,1448,1536,2984,2769
0130-001,2017,5,21,15,1454,1595,3049,2984
0130-001,2017,5,21,16,1467,1611,3078,3049
0130-001,2017,5,21,17,1566,1504,3070,3078
0130-001,2017,5,21,18,1504,1618,3122,3070
0130-001,2017,5,21,19,1528,1458,2986,3122
0130-001,2017,5,21,20,1333,1236,2569,2986
0130-001,2017,5,21,21,1196,1236,2432,2569
0130-001,2017,5,21,22,1050,945,1995,2432
0130-001,2017,5,21,23,756,646,1402,1995
0130-001,2017,5,21,24,476,443,919,1402
0130-001,2017,5,22,1,310,274,584,919
0130-001,2017,5,22,2,171,170,341,584
0130-001,2017,5,22,3,154,137,291,341
0130-001,2017,5,22,4,120,142,262,291
0130-001,2017,5,22,5,226,256,482,262
0130-001,2017,5,22,6,727,456,1183,482
0130-001,2017,5,22,7,1689,947,2636,1183
0130-001,2017,5,22,8,1424,1652,3076,2636
0130-001,2017,5,22,9,1691,1983,3674,3076
0130-001,2017,5,22,10,1553,1627,3180,3674
0130-001,2017,5,22,11,1611,1653,3264,3180
0130-001,2017,5,22,12,1459,1530,2989,3264
0130-001,2017,5,22,13,1427,1444,2871,2989
0130-001,2017,5,22,14,1491,1631,3122,2871
0130-001,2017,5,22,15,1627,1614,3241,3122
0130-001,2017,5,22,16,1551,1763,3314,3241
0130-001,2017,5,22,17,1530,1841,3371,3314
0130-001,2017,5,22,18,1610,2508,4118,3371
0130-001,2017,5,22,19,1679,2509,4188,4118
0130-001,2017,5,22,20,1345,1950,3295,4188
0130-001,2017,5,22,21,1154,1805,2959,3295
0130-001,2017,5,22,22,1040,1405,2445,2959
0130-001,2017,5,22,23,850,758,1608,2445
0130-001,2017,5,22,24,572,552,1124,1608
0130-001,2017,5,23,1,365,346,711,1124
0130-001,2017,5,23,2,237,223,460,711
0130-001,2017,5,23,3,160,186,346,460
0130-001,2017,5,23,4,153,189,342,346
0130-001,2017,5,23,5,220,269,489,342
0130-001,2017,5,23,6,671,468,1139,489
0130-001,2017,5,23,7,1680,919,2599,1139
0130-001,2017,5,23,8,1494,1688,3182,2599
0130-001,2017,5,23,9,1534,1961,3495,3182
0130-001,2017,5,23,10,1614,1687,3301,3495
0130-001,2017,5,23,11,1481,1680,3161,3301
0130-001,2017,5,23,12,1480,1624,3104,3161
0130-001,2017,5,23,13,1464,1379,2843,3104
0130-001,2017,5,23,14,1641,1638,3279,2843
0130-001,2017,5,23,15,1585,1710,3295,3279
0130-001,2017,5,23,16,1533,1760,3293,3295
0130-001,2017,5,23,17,1473,1870,3343,3293
0130-001,2017,5,23,18,1586,2362,3948,3343
0130-001,2017,5,23,19,1627,2515,4142,3948
0130-001,2017,5,23,20,1267,1830,3097,4142
0130-001,2017,5,23,21,1081,1726,2807,3097
0130-001,2017,5,23,22,1067,1393,2460,2807
0130-001,2017,5,23,23,831,832,1663,2460
0130-001,2017,5,23,24,501,518,1019,1663
0130-001,2017,5,24,1,358,378,736,1019
0130-001,2017,5,24,2,224,225,449,736
0130-001,2017,5,24,3,156,161,317,449
0130-001,2017,5,24,4,133,157,290,317
0130-001,2017,5,24,5,192,243,435,290
0130-001,2017,5,24,6,597,453,1050,435
0130-001,2017,5,24,7,1589,838,2427,1050
0130-001,2017,5,24,8,1524,1585,3109,2427
0130-001,2017,5,24,9,1551,2015,3566,3109
0130-001,2017,5,24,10,1548,1604,3152,3566
0130-001,2017,5,24,11,1528,1577,3105,3152
0130-001,2017,5,24,12,1474,1558,3032,3105
0130-001,2017,5,24,13,1408,1415,2823,3032
0130-001,2017,5,24,14,1565,1587,3152,2823
0130-001,2017,5,24,15,1583,1612,3195,3152
0130-001,2017,5,24,16,1633,1793,3426,3195
0130-001,2017,5,24,17,1484,1859,3343,3426
0130-001,2017,5,24,18,1702,2417,4119,3343
0130-001,2017,5,24,19,1569,2572,4141,4119
0130-001,2017,5,24,20,1184,1924,3108,4141
0130-001,2017,5,24,21,1155,1635,2790,3108
0130-001,2017,5,24,22,1140,1300,2440,2790
0130-001,2017,5,24,23,847,858,1705,2440
0130-001,2017,5,24,24,614,558,1172,1705
0130-001,2017,5,25,1,402,381,783,1172
0130-001,2017,5,25,2,251,237,488,783
0130-001,2017,5,25,3,167,207,374,488
0130-001,2017,5,25,4,140,177,317,374
0130-001,2017,5,25,5,227,244,471,317
0130-001,2017,5,25,6,668,515,1183,471
0130-001,2017,5,25,7,1713,938,2651,1183
0130-001,2017,5,25,8,1485,1652,3137,2651
0130-001,2017,5,25,9,1461,1990,3451,3137
0130-001,2017,5,25,10,1546,1605,3151,3451
0130-001,2017,5,25,11,1532,1647,3179,3151
0130-001,2017,5,25,12,1468,1635,3103,3179
0130-001,2017,5,25,13,1322,1515,2837,3103
0130-001,2017,5,25,14,1663,1672,3335,2837
0130-001,2017,5,25,15,1511,1644,3155,3335
0130-001,2017,5,25,16,1587,1845,3432,3155
0130-001,2017,5,25,17,1593,2010,3603,3432
0130-001,2017,5,25,18,1663,2395,4058,3603
0130-001,2017,5,25,19,1547,2553,4100,4058
0130-001,2017,5,25,20,1334,1823,3157,4100
0130-001,2017,5,25,21,1198,1720,2918,3157
0130-001,2017,5,25,22,1217,1470,2687,2918
0130-001,2017,5,25,23,924,963,1887,2687
0130-001,2017,5,25,24,585,596,1181,1887
0130-001,2017,5,26,1,414,414,828,1181
0130-001,2017,5,26,2,241,264,505,828
0130-001,2017,5,26,3,185,208,393,505
0130-001,2017,5,26,4,149,208,357,393
0130-001,2017,5,26,5,261,284,545,357
0130-001,2017,5,26,6,664,540,1204,545
0130-001,2017,5,26,7,1675,953,2628,1204
0130-001,2017,5,26,8,1555,1644,3199,2628
0130-001,2017,5,26,9,1603,1886,3489,3199
0130-001,2017,5,26,10,1521,1750,3271,3489
0130-001,2017,5,26,11,1596,1671,3267,3271
0130-001,2017,5,26,12,1531,1717,3248,3267
0130-001,2017,5,26,13,1515,1595,3110,3248
0130-001,2017,5,26,14,1557,1692,3249,3110
0130-001,2017,5,26,15,1573,1744,3317,3249
0130-001,2017,5,26,16,1621,1875,3496,3317
0130-001,2017,5,26,17,1613,2043,3656,3496
0130-001,2017,5,26,18,1740,2450,4190,3656
0130-001,2017,5,26,19,1639,2656,4295,4190
0130-001,2017,5,26,20,1367,2069,3436,4295
0130-001,2017,5,26,21,1226,1452,2678,3436
0130-001,2017,5,26,22,1191,1506,2697,2678
0130-001,2017,5,26,23,967,949,1916,2697
0130-001,2017,5,26,24,664,692,1356,1916
0130-001,2017,5,27,1,514,507,1021,1356
0130-001,2017,5,27,2,397,345,742,1021
0130-001,2017,5,27,3,273,252,525,742
0130-001,2017,5,27,4,206,270,476,525
0130-001,2017,5,27,5,303,299,602,476
0130-001,2017,5,27,6,654,534,1188,602
0130-001,2017,5,27,7,1264,783,2047,1188
0130-001,2017,5,27,8,1421,1101,2522,2047
0130-001,2017,5,27,9,1412,1616,3028,2522
0130-001,2017,5,27,10,1571,1793,3364,3028
0130-001,2017,5,27,11,1588,1852,3440,3364
0130-001,2017,5,27,12,1612,1960,3572,3440
0130-001,2017,5,27,13,1481,1757,3238,3572
0130-001,2017,5,27,14,1654,1909,3563,3238
0130-001,2017,5,27,15,1647,1774,3421,3563
0130-001,2017,5,27,16,1685,1838,3523,3421
0130-001,2017,5,27,17,1668,1888,3556,3523
0130-001,2017,5,27,18,1796,2202,3998,3556
0130-001,2017,5,27,19,1680,2057,3737,3998
0130-001,2017,5,27,20,1386,1560,2946,3737
0130-001,2017,5,27,21,1229,1310,2539,2946
0130-001,2017,5,27,22,1101,966,2067,2539
0130-001,2017,5,27,23,983,765,1748,2067
0130-001,2017,5,27,24,587,571,1158,1748
0130-001,2017,5,28,1,446,396,842,1158
0130-001,2017,5,28,2,379,307,686,842
0130-001,2017,5,28,3,271,260,531,686
0130-001,2017,5,28,4,203,185,388,531
0130-001,2017,5,28,5,268,206,474,388
0130-001,2017,5,28,6,409,329,738,474
0130-001,2017,5,28,7,715,496,1211,738
0130-001,2017,5,28,8,796,679,1475,1211
0130-001,2017,5,28,9,957,1012,1969,1475
0130-001,2017,5,28,10,1089,1216,2305,1969
0130-001,2017,5,28,11,1269,1367,2636,2305
0130-001,2017,5,28,12,1194,1348,2542,2636
0130-001,2017,5,28,13,1330,1425,2755,2542
0130-001,2017,5,28,14,1393,1482,2875,2755
0130-001,2017,5,28,15,1426,1462,2888,2875
0130-001,2017,5,28,16,1511,1568,3079,2888
0130-001,2017,5,28,17,1439,1501,2940,3079
0130-001,2017,5,28,18,1335,1566,2901,2940
0130-001,2017,5,28,19,1451,1479,2930,2901
0130-001,2017,5,28,20,1276,1272,2548,2930
0130-001,2017,5,28,21,1151,1183,2334,2548
0130-001,2017,5,28,22,963,912,1875,2334
0130-001,2017,5,28,23,685,637,1322,1875
0130-001,2017,5,28,24,487,442,929,1322
0130-001,2017,5,29,1,278,247,525,929
0130-001,2017,5,29,2,176,174,350,525
0130-001,2017,5,29,3,137,116,253,350
0130-001,2017,5,29,4,138,156,294,253
0130-001,2017,5,29,5,246,248,494,294
0130-001,2017,5,29,6,743,537,1280,494
0130-001,2017,5,29,7,1697,982,2679,1280
0130-001,2017,5,29,8,1542,1694,3236,2679
0130-001,2017,5,29,9,1536,1998,3534,3236
0130-001,2017,5,29,10,1582,1636,3218,3534
0130-001,2017,5,29,11,1451,1576,3027,3218
0130-001,2017,5,29,12,1441,1651,3092,3027
0130-001,2017,5,29,13,1436,1479,2915,3092
0130-001,2017,5,29,14,1588,1645,3233,2915
0130-001,2017,5,29,15,1505,1695,3200,3233
0130-001,2017,5,29,16,1559,1670,3229,3200
0130-001,2017,5,29,17,1567,1902,3469,3229
0130-001,2017,5,29,18,1658,2349,4007,3469
0130-001,2017,5,29,19,1555,2545,4100,4007
0130-001,2017,5,29,20,1262,1904,3166,4100
0130-001,2017,5,29,21,1186,1871,3057,3166
0130-001,2017,5,29,22,1043,1374,2417,3057
0130-001,2017,5,29,23,835,844,1679,2417
0130-001,2017,5,29,24,495,571,1066,1679
0130-001,2017,5,30,1,363,323,686,1066
0130-001,2017,5,30,2,212,206,418,686
0130-001,2017,5,30,3,155,189,344,418
0130-001,2017,5,30,4,151,192,343,344
0130-001,2017,5,30,5,260,268,528,343
0130-001,2017,5,30,6,631,486,1117,528
0130-001,2017,5,30,7,1684,943,2627,1117
0130-001,2017,5,30,8,1489,1699,3188,2627
0130-001,2017,5,30,9,1524,1965,3489,3188
0130-001,2017,5,30,10,1465,1684,3149,3489
0130-001,2017,5,30,11,1597,1666,3263,3149
0130-001,2017,5,30,12,1509,1686,3195,3263
0130-001,2017,5,30,13,1397,1432,2829,3195
0130-001,2017,5,30,14,1597,1701,3298,2829
0130-001,2017,5,30,15,1503,1609,3112,3298
0130-001,2017,5,30,16,1566,1781,3347,3112
0130-001,2017,5,30,17,1592,1965,3557,3347
0130-001,2017,5,30,18,1619,2378,3997,3557
0130-001,2017,5,30,19,1501,2673,4174,3997
0130-001,2017,5,30,20,1197,1958,3155,4174
0130-001,2017,5,30,21,1132,1674,2806,3155
0130-001,2017,5,30,22,1087,1279,2366,2806
0130-001,2017,5,30,23,1193,827,2020,2366
0130-001,2017,5,30,24,583,583,1166,2020
0130-001,2017,5,31,1,413,365,778,1166
0130-001,2017,5,31,2,219,216,435,778
0130-001,2017,5,31,3,173,198,371,435
0130-001,2017,5,31,4,144,203,347,371
0130-001,2017,5,31,5,248,261,509,347
0130-001,2017,5,31,6,678,488,1166,509
0130-001,2017,5,31,7,1609,927,2536,1166
0130-001,2017,5,31,8,1396,1629,3025,2536
0130-001,2017,5,31,9,1540,1960,3500,3025
0130-001,2017,5,31,10,1557,1575,3132,3500
0130-001,2017,5,31,11,1559,1585,3144,3132
0130-001,2017,5,31,12,1490,1536,3026,3144
0130-001,2017,5,31,13,1329,1502,2831,3026
0130-001,2017,5,31,14,1628,1625,3253,2831
0130-001,2017,5,31,15,1521,1710,3231,3253
0130-001,2017,5,31,16,1548,1767,3315,3231
0130-001,2017,5,31,17,1563,1902,3465,3315
0130-001,2017,5,31,18,1640,2337,3977,3465
0130-001,2017,5,31,19,1522,2541,4063,3977
0130-001,2017,5,31,20,1294,1930,3224,4063
0130-001,2017,5,31,21,1223,1664,2887,3224
0130-001,2017,5,31,22,1138,1265,2403,2887
0130-001,2017,5,31,23,900,866,1766,2403
0130-001,2017,5,31,24,640,627,1267,1766
0130-001,2017,6,1,1,419,382,801,1267
0130-001,2017,6,1,2,267,244,511,801
0130-001,2017,6,1,3,174,193,367,511
0130-001,2017,6,1,4,172,209,381,367
0130-001,2017,6,1,5,256,275,531,381
0130-001,2017,6,1,6,642,485,1127,531
0130-001,2017,6,1,7,1611,907,2518,1127
0130-001,2017,6,1,8,1344,1659,3003,2518
0130-001,2017,6,1,9,1600,1926,3526,3003
0130-001,2017,6,1,10,1501,1558,3059,3526
0130-001,2017,6,1,11,1532,1492,3024,3059
0130-001,2017,6,1,12,1523,1559,3082,3024
0130-001,2017,6,1,13,1333,1423,2756,3082
0130-001,2017,6,1,14,1641,1675,3316,2756
0130-001,2017,6,1,15,1540,1618,3158,3316
0130-001,2017,6,1,16,1571,1755,3326,3158
0130-001,2017,6,1,17,1493,2009,3502,3326
0130-001,2017,6,1,18,1613,2267,3880,3502
0130-001,2017,6,1,19,1574,2253,3827,3880
0130-001,2017,6,1,20,1302,1848,3150,3827
0130-001,2017,6,1,21,1150,1798,2948,3150
0130-001,2017,6,1,22,1096,1390,2486,2948
0130-001,2017,6,1,23,904,852,1756,2486
0130-001,2017,6,1,24,585,570,1155,1756
0130-001,2017,6,2,1,412,384,796,1155
0130-001,2017,6,2,2,237,238,475,796
0130-001,2017,6,2,3,179,194,373,475
0130-001,2017,6,2,4,146,205,351,373
0130-001,2017,6,2,5,273,285,558,351
0130-001,2017,6,2,6,698,519,1217,558
0130-001,2017,6,2,7,1662,942,2604,1217
0130-001,2017,6,2,8,1541,1630,3171,2604
0130-001,2017,6,2,9,1480,1947,3427,3171
0130-001,2017,6,2,10,1595,1630,3225,3427
0130-001,2017,6,2,11,1540,1582,3122,3225
0130-001,2017,6,2,12,1515,1586,3101,3122
0130-001,2017,6,2,13,1403,1654,3057,3101
0130-001,2017,6,2,14,1642,1698,3340,3057
0130-001,2017,6,2,15,1573,1696,3269,3340
0130-001,2017,6,2,16,1578,1744,3322,3269
0130-001,2017,6,2,17,1567,1951,3518,3322
0130-001,2017,6,2,18,1617,2402,4019,3518
0130-001,2017,6,2,19,1665,2611,4276,4019
0130-001,2017,6,2,20,1396,2091,3487,4276
0130-001,2017,6,2,21,1245,1870,3115,3487
0130-001,2017,6,2,22,1301,1483,2784,3115
0130-001,2017,6,2,23,967,948,1915,2784
0130-001,2017,6,2,24,693,702,1395,1915
0130-001,2017,6,3,1,493,457,950,1395
0130-001,2017,6,3,2,340,326,666,950
0130-001,2017,6,3,3,254,246,500,666
0130-001,2017,6,3,4,178,276,454,500
0130-001,2017,6,3,5,283,266,549,454
0130-001,2017,6,3,6,637,564,1201,549
0130-001,2017,6,3,7,1173,710,1883,1201
0130-001,2017,6,3,8,1339,1132,2471,1883
0130-001,2017,6,3,9,1405,1572,2977,2471
0130-001,2017,6,3,10,1446,1830,3276,2977
0130-001,2017,6,3,11,1578,1901,3479,3276
0130-001,2017,6,3,12,1542,1892,3434,3479
0130-001,2017,6,3,13,1528,1807,3335,3434
0130-001,2017,6,3,14,1662,1837,3499,3335
0130-001,2017,6,3,15,1559,1735,3294,3499
0130-001,2017,6,3,16,1612,1868,3480,3294
0130-001,2017,6,3,17,1589,1924,3513,3480
0130-001,2017,6,3,18,1694,2089,3783,3513
0130-001,2017,6,3,19,1693,1911,3604,3783
0130-001,2017,6,3,20,1329,1386,2715,3604
0130-001,2017,6,3,21,1130,1252,2382,2715
0130-001,2017,6,3,22,1101,995,2096,2382
0130-001,2017,6,3,23,828,754,1582,2096
0130-001,2017,6,3,24,543,549,1092,1582
0130-001,2017,6,4,1,412,345,757,1092
0130-001,2017,6,4,2,347,283,630,757
0130-001,2017,6,4,3,245,208,453,630
0130-001,2017,6,4,4,174,194,368,453
0130-001,2017,6,4,5,250,195,445,368
0130-001,2017,6,4,6,444,327,771,445
0130-001,2017,6,4,7,627,475,1102,771
0130-001,2017,6,4,8,723,653,1376,1102
0130-001,2017,6,4,9,938,903,1841,1376
0130-001,2017,6,4,10,1004,1212,2216,1841
0130-001,2017,6,4,11,1119,1304,2423,2216
0130-001,2017,6,4,12,1138,1384,2522,2423
0130-001,2017,6,4,13,1244,1396,2640,2522
0130-001,2017,6,4,14,1345,1519,2864,2640
0130-001,2017,6,4,15,1471,1592,3063,2864
0130-001,2017,6,4,16,1573,1548,3121,3063
0130-001,2017,6,4,17,1505,1530,3035,3121
0130-001,2017,6,4,18,1561,1508,3069,3035
0130-001,2017,6,4,19,1498,1425,2923,3069
0130-001,2017,6,4,20,1231,1175,2406,2923
0130-001,2017,6,4,21,1241,1163,2404,2406
0130-001,2017,6,4,22,1114,955,2069,2404
0130-001,2017,6,4,23,733,626,1359,2069
0130-001,2017,6,4,24,481,460,941,1359
0130-001,2017,6,5,1,281,253,534,941
0130-001,2017,6,5,2,165,172,337,534
0130-001,2017,6,5,3,123,134,257,337
0130-001,2017,6,5,4,131,159,290,257
0130-001,2017,6,5,5,237,227,464,290
0130-001,2017,6,5,6,722,483,1205,464
0130-001,2017,6,5,7,1675,911,2586,1205
0130-001,2017,6,5,8,1538,1527,3065,2586
0130-001,2017,6,5,9,1445,1825,3270,3065
0130-001,2017,6,5,10,1553,1678,3231,3270
0130-001,2017,6,5,11,1619,1665,3284,3231
0130-001,2017,6,5,12,1556,1629,3185,3284
0130-001,2017,6,5,13,1442,1584,3026,3185
0130-001,2017,6,5,14,1612,1581,3193,3026
0130-001,2017,6,5,15,1632,1783,3415,3193
0130-001,2017,6,5,16,1655,1808,3463,3415
0130-001,2017,6,5,17,1635,1881,3516,3463
0130-001,2017,6,5,18,1721,2258,3979,3516
0130-001,2017,6,5,19,1681,2485,4166,3979
0130-001,2017,6,5,20,1317,1925,3242,4166
0130-001,2017,6,5,21,1177,1717,2894,3242
0130-001,2017,6,5,22,1052,1275,2327,2894
0130-001,2017,6,5,23,895,817,1712,2327
0130-001,2017,6,5,24,576,594,1170,1712
0130-001,2017,6,6,1,470,381,851,1170
0130-001,2017,6,6,2,321,321,642,851
0130-001,2017,6,6,3,235,230,465,642
0130-001,2017,6,6,4,210,242,452,465
0130-001,2017,6,6,5,268,276,544,452
0130-001,2017,6,6,6,610,451,1061,544
0130-001,2017,6,6,7,1196,737,1933,1061
0130-001,2017,6,6,8,1279,944,2223,1933
0130-001,2017,6,6,9,1207,1209,2416,2223
0130-001,2017,6,6,10,1251,1335,2586,2416
0130-001,2017,6,6,11,1298,1411,2709,2586
0130-001,2017,6,6,12,1403,1494,2897,2709
0130-001,2017,6,6,13,1314,1535,2849,2897
0130-001,2017,6,6,14,1378,1522,2900,2849
0130-001,2017,6,6,15,1480,1584,3064,2900
0130-001,2017,6,6,16,1449,1600,3049,3064
0130-001,2017,6,6,17,1419,1758,3177,3049
0130-001,2017,6,6,18,1561,1902,3463,3177
0130-001,2017,6,6,19,1374,1627,3001,3463
0130-001,2017,6,6,20,1207,1193,2400,3001
0130-001,2017,6,6,21,1028,1074,2102,2400
0130-001,2017,6,6,22,880,896,1776,2102
0130-001,2017,6,6,23,623,554,1177,1776
0130-001,2017,6,6,24,413,403,816,1177
0130-001,2017,6,7,1,289,284,573,816
0130-001,2017,6,7,2,184,156,340,573
0130-001,2017,6,7,3,120,125,245,340
0130-001,2017,6,7,4,112,122,234,245
0130-001,2017,6,7,5,188,201,389,234
0130-001,2017,6,7,6,570,450,1020,389
0130-001,2017,6,7,7,1588,885,2473,1020
0130-001,2017,6,7,8,1494,1561,3055,2473
0130-001,2017,6,7,9,1595,1928,3523,3055
0130-001,2017,6,7,10,1550,1579,3129,3523
0130-001,2017,6,7,11,1608,1605,3213,3129
0130-001,2017,6,7,12,1490,1585,3075,3213
0130-001,2017,6,7,13,1420,1425,2845,3075
0130-001,2017,6,7,14,1568,1677,3245,2845
0130-001,2017,6,7,15,1514,1641,3155,3245
0130-001,2017,6,7,16,1477,1735,3212,3155
0130-001,2017,6,7,17,1476,1879,3355,3212
0130-001,2017,6,7,18,1495,2298,3793,3355
0130-001,2017,6,7,19,1571,2385,3956,3793
0130-001,2017,6,7,20,1169,1742,2911,3956
0130-001,2017,6,7,21,1071,1532,2603,2911
0130-001,2017,6,7,22,1038,1209,2247,2603
0130-001,2017,6,7,23,799,816,1615,2247
0130-001,2017,6,7,24,500,547,1047,1615
0130-001,2017,6,8,1,417,341,758,1047
0130-001,2017,6,8,2,181,231,412,758
0130-001,2017,6,8,3,165,170,335,412
0130-001,2017,6,8,4,167,191,358,335
0130-001,2017,6,8,5,234,246,480,358
0130-001,2017,6,8,6,694,488,1182,480
0130-001,2017,6,8,7,1672,905,2577,1182
0130-001,2017,6,8,8,1595,1584,3179,2577
0130-001,2017,6,8,9,1528,1948,3476,3179
0130-001,2017,6,8,10,1602,1555,3157,3476
0130-001,2017,6,8,11,1607,1498,3105,3157
0130-001,2017,6,8,12,1487,1623,3110,3105
0130-001,2017,6,8,13,1396,1502,2898,3110
0130-001,2017,6,8,14,1612,1691,3303,2898
0130-001,2017,6,8,15,1525,1660,3185,3303
0130-001,2017,6,8,16,1545,1708,3253,3185
0130-001,2017,6,8,17,1545,1880,3425,3253
0130-001,2017,6,8,18,1568,2307,3875,3425
0130-001,2017,6,8,19,1620,2535,4155,3875
0130-001,2017,6,8,20,1266,1869,3135,4155
0130-001,2017,6,8,21,1232,1813,3045,3135
0130-001,2017,6,8,22,1110,1449,2559,3045
0130-001,2017,6,8,23,869,896,1765,2559
0130-001,2017,6,8,24,567,575,1142,1765
0130-001,2017,6,9,1,412,364,776,1142
0130-001,2017,6,9,2,230,223,453,776
0130-001,2017,6,9,3,170,194,364,453
0130-001,2017,6,9,4,155,191,346,364
0130-001,2017,6,9,5,253,261,514,346
0130-001,2017,6,9,6,679,508,1187,514
0130-001,2017,6,9,7,1684,911,2595,1187
0130-001,2017,6,9,8,1446,1581,3027,2595
0130-001,2017,6,9,9,1532,1901,3433,3027
0130-001,2017,6,9,10,1497,1583,3080,3433
0130-001,2017,6,9,11,1485,1550,3035,3080
0130-001,2017,6,9,12,1489,1594,3083,3035
0130-001,2017,6,9,13,1232,1581,2813,3083
0130-001,2017,6,9,14,1538,1667,3205,2813
0130-001,2017,6,9,15,1438,1741,3179,3205
0130-001,2017,6,9,16,1615,1757,3372,3179
0130-001,2017,6,9,17,1555,2023,3578,3372
0130-001,2017,6,9,18,1691,2422,4113,3578
0130-001,2017,6,9,19,1584,2641,4225,4113
0130-001,2017,6,9,20,1411,2155,3566,4225
0130-001,2017,6,9,21,1317,1771,3088,3566
0130-001,2017,6,9,22,1285,1389,2674,3088
0130-001,2017,6,9,23,983,946,1929,2674
0130-001,2017,6,9,24,658,628,1286,1929
0130-001,2017,6,10,1,534,446,980,1286
0130-001,2017,6,10,2,355,300,655,980
0130-001,2017,6,10,3,267,254,521,655
0130-001,2017,6,10,4,217,246,463,521
0130-001,2017,6,10,5,266,300,566,463
0130-001,2017,6,10,6,614,487,1101,566
0130-001,2017,6,10,7,1235,812,2047,1101
0130-001,2017,6,10,8,1389,1101,2490,2047
0130-001,2017,6,10,9,1369,1633,3002,2490
0130-001,2017,6,10,10,1532,1691,3223,3002
0130-001,2017,6,10,11,1628,1890,3518,3223
0130-001,2017,6,10,12,1622,1897,3519,3518
0130-001,2017,6,10,13,1592,1703,3295,3519
0130-001,2017,6,10,14,1492,1878,3370,3295
0130-001,2017,6,10,15,1621,1827,3448,3370
0130-001,2017,6,10,16,1605,1725,3330,3448
0130-001,2017,6,10,17,1706,1925,3631,3330
0130-001,2017,6,10,18,1807,2193,4000,3631
0130-001,2017,6,10,19,1614,1976,3590,4000
0130-001,2017,6,10,20,1292,1399,2691,3590
0130-001,2017,6,10,21,1168,1117,2285,2691
0130-001,2017,6,10,22,1077,1026,2103,2285
0130-001,2017,6,10,23,810,699,1509,2103
0130-001,2017,6,10,24,564,549,1113,1509
0130-001,2017,6,11,1,436,407,843,1113
0130-001,2017,6,11,2,376,290,666,843
0130-001,2017,6,11,3,234,237,471,666
0130-001,2017,6,11,4,220,177,397,471
0130-001,2017,6,11,5,207,185,392,397
0130-001,2017,6,11,6,458,323,781,392
0130-001,2017,6,11,7,673,515,1188,781
0130-001,2017,6,11,8,714,618,1332,1188
0130-001,2017,6,11,9,869,963,1832,1332
0130-001,2017,6,11,10,1049,1118,2167,1832
0130-001,2017,6,11,11,1199,1279,2478,2167
0130-001,2017,6,11,12,1155,1299,2454,2478
0130-001,2017,6,11,13,1224,1372,2596,2454
0130-001,2017,6,11,14,1403,1401,2804,2596
0130-001,2017,6,11,15,1402,1490,2892,2804
0130-001,2017,6,11,16,1369,1519,2888,2892
0130-001,2017,6,11,17,1418,1406,2824,2888
0130-001,2017,6,11,18,1477,1449,2926,2824
0130-001,2017,6,11,19,1442,1394,2836,2926
0130-001,2017,6,11,20,1169,1136,2305,2836
0130-001,2017,6,11,21,1126,1152,2278,2305
0130-001,2017,6,11,22,1035,952,1987,2278
0130-001,2017,6,11,23,738,694,1432,1987
0130-001,2017,6,11,24,492,397,889,1432
0130-001,2017,6,12,1,298,244,542,889
0130-001,2017,6,12,2,155,160,315,542
0130-001,2017,6,12,3,148,124,272,315
0130-001,2017,6,12,4,135,151,286,272
0130-001,2017,6,12,5,237,231,468,286
0130-001,2017,6,12,6,766,516,1282,468
0130-001,2017,6,12,7,1681,980,2661,1282
0130-001,2017,6,12,8,1521,1662,3183,2661
0130-001,2017,6,12,9,1580,1867,3447,3183
0130-001,2017,6,12,10,1578,1599,3177,3447
0130-001,2017,6,12,11,1546,1595,3141,3177
0130-001,2017,6,12,12,1503,1639,3142,3141
0130-001,2017,6,12,13,1386,1478,2864,3142
0130-001,2017,6,12,14,1654,1689,3343,2864
0130-001,2017,6,12,15,1620,1672,3292,3343
0130-001,2017,6,12,16,1601,1765,3366,3292
0130-001,2017,6,12,17,1603,1943,3546,3366
0130-001,2017,6,12,18,1621,2354,3975,3546
0130-001,2017,6,12,19,1592,2496,4088,3975
0130-001,2017,6,12,20,1282,1798,3080,4088
0130-001,2017,6,12,21,1109,1650,2759,3080
0130-001,2017,6,12,22,1023,1316,2339,2759
0130-001,2017,6,12,23,791,776,1567,2339
0130-001,2017,6,12,24,510,504,1014,1567
0130-001,2017,6,13,1,351,317,668,1014
0130-001,2017,6,13,2,198,214,412,668
0130-001,2017,6,13,3,171,182,353,412
0130-001,2017,6,13,4,146,179,325,353
0130-001,2017,6,13,5,239,250,489,325
0130-001,2017,6,13,6,680,489,1169,489
0130-001,2017,6,13,7,1693,948,2641,1169
0130-001,2017,6,13,8,1570,1616,3186,2641
0130-001,2017,6,13,9,1579,1942,3521,3186
0130-001,2017,6,13,10,1596,1597,3193,3521
0130-001,2017,6,13,11,1560,1568,3128,3193
0130-001,2017,6,13,12,1421,1571,2992,3128
0130-001,2017,6,13,13,1333,1336,2669,2992
0130-001,2017,6,13,14,1587,1565,3152,2669
0130-001,2017,6,13,15,1540,1631,3171,3152
0130-001,2017,6,13,16,1513,1593,3106,3171
0130-001,2017,6,13,17,1548,1893,3441,3106
0130-001,2017,6,13,18,1643,2291,3934,3441
0130-001,2017,6,13,19,1607,2484,4091,3934
0130-001,2017,6,13,20,1338,1804,3142,4091
0130-001,2017,6,13,21,1154,1728,2882,3142
0130-001,2017,6,13,22,1141,1424,2565,2882
0130-001,2017,6,13,23,846,805,1651,2565
0130-001,2017,6,13,24,539,585,1124,1651
0130-001,2017,6,14,1,407,387,794,1124
0130-001,2017,6,14,2,236,241,477,794
0130-001,2017,6,14,3,169,161,330,477
0130-001,2017,6,14,4,144,198,342,330
0130-001,2017,6,14,5,257,286,543,342
0130-001,2017,6,14,6,667,472,1139,543
0130-001,2017,6,14,7,1659,962,2621,1139
0130-001,2017,6,14,8,1566,1641,3207,2621
0130-001,2017,6,14,9,1544,1936,3480,3207
0130-001,2017,6,14,10,1549,1612,3161,3480
0130-001,2017,6,14,11,1525,1397,2922,3161
0130-001,2017,6,14,12,1466,1638,3104,2922
0130-001,2017,6,14,13,1342,1430,2772,3104
0130-001,2017,6,14,14,1533,1609,3142,2772
0130-001,2017,6,14,15,1533,1618,3151,3142
0130-001,2017,6,14,16,1604,1745,3349,3151
0130-001,2017,6,14,17,1504,1759,3263,3349
0130-001,2017,6,14,18,1601,2459,4060,3263
0130-001,2017,6,14,19,1614,2552,4166,4060
0130-001,2017,6,14,20,1355,1876,3231,4166
0130-001,2017,6,14,21,1206,1627,2833,3231
0130-001,2017,6,14,22,1172,1311,2483,2833
0130-001,2017,6,14,23,941,883,1824,2483
0130-001,2017,6,14,24,577,594,1171,1824
0130-001,2017,6,15,1,409,403,812,1171
0130-001,2017,6,15,2,225,251,476,812
0130-001,2017,6,15,3,161,193,354,476
0130-001,2017,6,15,4,169,206,375,354
0130-001,2017,6,15,5,265,277,542,375
0130-001,2017,6,15,6,691,488,1179,542
0130-001,2017,6,15,7,1702,976,2678,1179
0130-001,2017,6,15,8,1490,1619,3109,2678
0130-001,2017,6,15,9,1602,1962,3564,3109
0130-001,2017,6,15,10,1640,1630,3270,3564
0130-001,2017,6,15,11,1513,1482,2995,3270
0130-001,2017,6,15,12,1563,1699,3262,2995
0130-001,2017,6,15,13,1371,1491,2862,3262
0130-001,2017,6,15,14,1571,1666,3237,2862
0130-001,2017,6,15,15,1606,1640,3246,3237
0130-001,2017,6,15,16,1557,1789,3346,3246
0130-001,2017,6,15,17,1530,1967,3497,3346
0130-001,2017,6,15,18,1721,2358,4079,3497
0130-001,2017,6,15,19,1632,2481,4113,4079
0130-001,2017,6,15,20,1379,1951,3330,4113
0130-001,2017,6,15,21,1291,1816,3107,3330
0130-001,2017,6,15,22,1180,1436,2616,3107
0130-001,2017,6,15,23,895,934,1829,2616
0130-001,2017,6,15,24,647,624,1271,1829
0130-001,2017,6,16,1,402,384,786,1271
0130-001,2017,6,16,2,246,247,493,786
0130-001,2017,6,16,3,186,226,412,493
0130-001,2017,6,16,4,165,215,380,412
0130-001,2017,6,16,5,270,242,512,380
0130-001,2017,6,16,6,673,497,1170,512
0130-001,2017,6,16,7,1674,921,2595,1170
0130-001,2017,6,16,8,1600,1589,3189,2595
0130-001,2017,6,16,9,1584,1951,3535,3189
0130-001,2017,6,16,10,1580,1593,3173,3535
0130-001,2017,6,16,11,1553,1639,3192,3173
0130-001,2017,6,16,12,1540,1680,3220,3192
0130-001,2017,6,16,13,1491,1560,3051,3220
0130-001,2017,6,16,14,1653,1867,3520,3051
0130-001,2017,6,16,15,1539,1761,3300,3520
0130-001,2017,6,16,16,1666,1862,3528,3300
0130-001,2017,6,16,17,1569,2081,3650,3528
0130-001,2017,6,16,18,1765,2461,4226,3650
0130-001,2017,6,16,19,1622,2588,4210,4226
0130-001,2017,6,16,20,1437,2087,3524,4210
0130-001,2017,6,16,21,1334,1891,3225,3524
0130-001,2017,6,16,22,1445,1315,2760,3225
0130-001,2017,6,16,23,1004,881,1885,2760
0130-001,2017,6,16,24,639,653,1292,1885
0130-001,2017,6,17,1,497,492,989,1292
0130-001,2017,6,17,2,359,336,695,989
0130-001,2017,6,17,3,261,283,544,695
0130-001,2017,6,17,4,207,250,457,544
0130-001,2017,6,17,5,296,296,592,457
0130-001,2017,6,17,6,621,456,1077,592
0130-001,2017,6,17,7,1229,791,2020,1077
0130-001,2017,6,17,8,1376,1176,2552,2020
0130-001,2017,6,17,9,1429,1639,3068,2552
0130-001,2017,6,17,10,1544,1825,3369,3068
0130-001,2017,6,17,11,1594,1783,3377,3369
0130-001,2017,6,17,12,1625,1801,3426,3377
0130-001,2017,6,17,13,1609,1810,3419,3426
0130-001,2017,6,17,14,1671,1937,3608,3419
0130-001,2017,6,17,15,1713,1818,3531,3608
0130-001,2017,6,17,16,1713,1861,3574,3531
0130-001,2017,6,17,17,1776,1907,3683,3574
0130-001,2017,6,17,18,1801,2131,3932,3683
0130-001,2017,6,17,19,1668,1987,3655,3932
0130-001,2017,6,17,20,1377,1467,2844,3655
0130-001,2017,6,17,21,1153,1310,2463,2844
0130-001,2017,6,17,22,1124,1057,2181,2463
0130-001,2017,6,17,23,882,800,1682,2181
0130-001,2017,6,17,24,573,555,1128,1682
0130-001,2017,6,18,1,429,407,836,1128
0130-001,2017,6,18,2,324,308,632,836
0130-001,2017,6,18,3,222,238,460,632
0130-001,2017,6,18,4,189,157,346,460
0130-001,2017,6,18,5,247,181,428,346
0130-001,2017,6,18,6,446,326,772,428
0130-001,2017,6,18,7,664,504,1168,772
0130-001,2017,6,18,8,768,701,1469,1168
0130-001,2017,6,18,9,865,977,1842,1469
0130-001,2017,6,18,10,985,1171,2156,1842
0130-001,2017,6,18,11,1179,1394,2573,2156
0130-001,2017,6,18,12,1199,1450,2649,2573
0130-001,2017,6,18,13,1316,1542,2858,2649
0130-001,2017,6,18,14,1472,1552,3024,2858
0130-001,2017,6,18,15,1532,1635,3167,3024
0130-001,2017,6,18,16,1636,1625,3261,3167
0130-001,2017,6,18,17,1574,1644,3218,3261
0130-001,2017,6,18,18,1660,1723,3383,3218
0130-001,2017,6,18,19,1662,1456,3118,3383
0130-001,2017,6,18,20,1352,1308,2660,3118
0130-001,2017,6,18,21,1276,1216,2492,2660
0130-001,2017,6,18,22,1131,1003,2134,2492
0130-001,2017,6,18,23,812,681,1493,2134
0130-001,2017,6,18,24,535,462,997,1493
0130-001,2017,6,19,1,300,287,587,997
0130-001,2017,6,19,2,174,162,336,587
0130-001,2017,6,19,3,134,118,252,336
0130-001,2017,6,19,4,143,165,308,252
0130-001,2017,6,19,5,250,229,479,308
0130-001,2017,6,19,6,745,489,1234,479
0130-001,2017,6,19,7,1770,939,2709,1234
0130-001,2017,6,19,8,1573,1660,3233,2709
0130-001,2017,6,19,9,1647,1869,3516,3233
0130-001,2017,6,19,10,1544,1549,3093,3516
0130-001,2017,6,19,11,1512,1619,3131,3093
0130-001,2017,6,19,12,1524,1546,3070,3131
0130-001,2017,6,19,13,1416,1433,2849,3070
0130-001,2017,6,19,14,1611,1723,3334,2849
0130-001,2017,6,19,15,1612,1623,3235,3334
0130-001,2017,6,19,16,1583,1712,3295,3235
0130-001,2017,6,19,17,1530,1906,3436,3295
0130-001,2017,6,19,18,1654,2372,4026,3436
0130-001,2017,6,19,19,1597,2515,4112,4026
0130-001,2017,6,19,20,1298,1860,3158,4112
0130-001,2017,6,19,21,1180,1759,2939,3158
0130-001,2017,6,19,22,1078,1352,2430,2939
0130-001,2017,6,19,23,792,764,1556,2430
0130-001,2017,6,19,24,505,552,1057,1556
0130-001,2017,6,20,1,371,329,700,1057
0130-001,2017,6,20,2,236,234,470,700
0130-001,2017,6,20,3,166,162,328,470
0130-001,2017,6,20,4,146,188,334,328
0130-001,2017,6,20,5,265,263,528,334
0130-001,2017,6,20,6,664,484,1148,528
0130-001,2017,6,20,7,1622,958,2580,1148
0130-001,2017,6,20,8,1583,1564,3147,2580
0130-001,2017,6,20,9,1602,1926,3528,3147
0130-001,2017,6,20,10,1605,1695,3300,3528
0130-001,2017,6,20,11,1598,1567,3165,3300
0130-001,2017,6,20,12,1502,1600,3102,3165
0130-001,2017,6,20,13,1350,1443,2793,3102
0130-001,2017,6,20,14,1629,1666,3295,2793
0130-001,2017,6,20,15,1501,1656,3157,3295
0130-001,2017,6,20,16,1547,1724,3271,3157
0130-001,2017,6,20,17,1541,1906,3447,3271
0130-001,2017,6,20,18,1660,2289,3949,3447
0130-001,2017,6,20,19,1640,2472,4112,3949
0130-001,2017,6,20,20,1294,1902,3196,4112
0130-001,2017,6,20,21,1139,1729,2868,3196
0130-001,2017,6,20,22,1112,1430,2542,2868
0130-001,2017,6,20,23,829,869,1698,2542
0130-001,2017,6,20,24,534,542,1076,1698
0130-001,2017,6,21,1,384,368,752,1076
0130-001,2017,6,21,2,244,243,487,752
0130-001,2017,6,21,3,157,193,350,487
0130-001,2017,6,21,4,164,205,369,350
0130-001,2017,6,21,5,256,221,477,369
0130-001,2017,6,21,6,672,524,1196,477
0130-001,2017,6,21,7,1677,932,2609,1196
0130-001,2017,6,21,8,1506,1619,3125,2609
0130-001,2017,6,21,9,1547,1954,3501,3125
0130-001,2017,6,21,10,1566,1517,3083,3501
0130-001,2017,6,21,11,1481,1668,3149,3083
0130-001,2017,6,21,12,1339,1535,2874,3149
0130-001,2017,6,21,13,1457,1432,2889,2874
0130-001,2017,6,21,14,1691,1800,3491,2889
0130-001,2017,6,21,15,1480,1643,3123,3491
0130-001,2017,6,21,16,1503,1711,3214,3123
0130-001,2017,6,21,17,1491,1930,3421,3214
0130-001,2017,6,21,18,1706,2362,4068,3421
0130-001,2017,6,21,19,1615,2578,4193,4068
0130-001,2017,6,21,20,1342,1921,3263,4193
0130-001,2017,6,21,21,1158,1689,2847,3263
0130-001,2017,6,21,22,1138,1361,2499,2847
0130-001,2017,6,21,23,926,885,1811,2499
0130-001,2017,6,21,24,603,575,1178,1811
0130-001,2017,6,22,1,426,384,810,1178
0130-001,2017,6,22,2,264,241,505,810
0130-001,2017,6,22,3,186,207,393,505
0130-001,2017,6,22,4,167,213,380,393
0130-001,2017,6,22,5,267,258,525,380
0130-001,2017,6,22,6,667,507,1174,525
0130-001,2017,6,22,7,1683,930,2613,1174
0130-001,2017,6,22,8,1505,1587,3092,2613
0130-001,2017,6,22,9,1578,1933,3511,3092
0130-001,2017,6,22,10,1636,1591,3227,3511
0130-001,2017,6,22,11,1504,1534,3038,3227
0130-001,2017,6,22,12,1456,1590,3046,3038
0130-001,2017,6,22,13,1339,1482,2821,3046
0130-001,2017,6,22,14,1556,1712,3268,2821
0130-001,2017,6,22,15,1549,1617,3166,3268
0130-001,2017,6,22,16,1552,1685,3237,3166
0130-001,2017,6,22,17,1582,1863,3445,3237
0130-001,2017,6,22,18,1690,2342,4032,3445
0130-001,2017,6,22,19,1610,2487,4097,4032
0130-001,2017,6,22,20,1340,1802,3142,4097
0130-001,2017,6,22,21,1183,1748,2931,3142
0130-001,2017,6,22,22,1155,1470,2625,2931
0130-001,2017,6,22,23,857,891,1748,2625
0130-001,2017,6,22,24,580,548,1128,1748
0130-001,2017,6,23,1,427,416,843,1128
0130-001,2017,6,23,2,261,232,493,843
0130-001,2017,6,23,3,156,226,382,493
0130-001,2017,6,23,4,165,207,372,382
0130-001,2017,6,23,5,292,236,528,372
0130-001,2017,6,23,6,687,509,1196,528
0130-001,2017,6,23,7,1659,942,2601,1196
0130-001,2017,6,23,8,1632,1569,3201,2601
0130-001,2017,6,23,9,1637,1941,3578,3201
0130-001,2017,6,23,10,1655,1606,3261,3578
0130-001,2017,6,23,11,1464,1557,3021,3261
0130-001,2017,6,23,12,1503,1602,3105,3021
0130-001,2017,6,23,13,1460,1404,2864,3105
0130-001,2017,6,23,14,1646,1905,3551,2864
0130-001,2017,6,23,15,1568,1705,3273,3551
0130-001,2017,6,23,16,1591,1965,3556,3273
0130-001,2017,6,23,17,1591,2048,3639,3556
0130-001,2017,6,23,18,1705,2406,4111,3639
0130-001,2017,6,23,19,1693,2514,4207,4111
0130-001,2017,6,23,20,1440,2046,3486,4207
0130-001,2017,6,23,21,1278,1781,3059,3486
0130-001,2017,6,23,22,1301,1375,2676,3059
0130-001,2017,6,23,23,1017,895,1912,2676
0130-001,2017,6,23,24,692,601,1293,1912
0130-001,2017,6,24,1,505,517,1022,1293
0130-001,2017,6,24,2,347,311,658,1022
0130-001,2017,6,24,3,276,256,532,658
0130-001,2017,6,24,4,226,279,505,532
0130-001,2017,6,24,5,317,290,607,505
0130-001,2017,6,24,6,631,506,1137,607
0130-001,2017,6,24,7,1163,793,1956,1137
0130-001,2017,6,24,8,1313,973,2286,1956
0130-001,2017,6,24,9,1422,1531,2953,2286
0130-001,2017,6,24,10,1465,1639,3104,2953
0130-001,2017,6,24,11,1526,1712,3238,3104
0130-001,2017,6,24,12,1550,1750,3300,3238
0130-001,2017,6,24,13,1464,1686,3150,3300
0130-001,2017,6,24,14,1590,1764,3354,3150
0130-001,2017,6,24,15,1622,1788,3410,3354
0130-001,2017,6,24,16,1613,1794,3407,3410
0130-001,2017,6,24,17,1606,1935,3541,3407
0130-001,2017,6,24,18,1594,2014,3608,3541
0130-001,2017,6,24,19,1558,1872,3430,3608
0130-001,2017,6,24,20,1336,1271,2607,3430
0130-001,2017,6,24,21,1078,1160,2238,2607
0130-001,2017,6,24,22,1032,950,1982,2238
0130-001,2017,6,24,23,824,675,1499,1982
0130-001,2017,6,24,24,537,494,1031,1499
0130-001,2017,6,25,1,435,380,815,1031
0130-001,2017,6,25,2,316,303,619,815
0130-001,2017,6,25,3,245,215,460,619
0130-001,2017,6,25,4,206,174,380,460
0130-001,2017,6,25,5,218,174,392,380
0130-001,2017,6,25,6,405,279,684,392
0130-001,2017,6,25,7,635,490,1125,684
0130-001,2017,6,25,8,672,657,1329,1125
0130-001,2017,6,25,9,842,1018,1860,1329
0130-001,2017,6,25,10,978,1103,2081,1860
0130-001,2017,6,25,11,1164,1186,2350,2081
0130-001,2017,6,25,12,1137,1232,2369,2350
0130-001,2017,6,25,13,1239,1353,2592,2369
0130-001,2017,6,25,14,1285,1341,2626,2592
0130-001,2017,6,25,15,1364,1403,2767,2626
0130-001,2017,6,25,16,1374,1460,2834,2767
0130-001,2017,6,25,17,1443,1525,2968,2834
0130-001,2017,6,25,18,1368,1438,2806,2968
0130-001,2017,6,25,19,1525,1398,2923,2806
0130-001,2017,6,25,20,1168,1190,2358,2923
0130-001,2017,6,25,21,1132,1121,2253,2358
0130-001,2017,6,25,22,983,829,1812,2253
0130-001,2017,6,25,23,704,637,1341,1812
0130-001,2017,6,25,24,500,380,880,1341
0130-001,2017,6,26,1,271,264,535,880
0130-001,2017,6,26,2,188,169,357,535
0130-001,2017,6,26,3,149,120,269,357
0130-001,2017,6,26,4,127,170,297,269
0130-001,2017,6,26,5,280,258,538,297
0130-001,2017,6,26,6,680,500,1180,538
0130-001,2017,6,26,7,1778,970,2748,1180
0130-001,2017,6,26,8,1612,1640,3252,2748
0130-001,2017,6,26,9,1557,1863,3420,3252
0130-001,2017,6,26,10,1543,1627,3170,3420
0130-001,2017,6,26,11,1618,1574,3192,3170
0130-001,2017,6,26,12,1463,1571,3034,3192
0130-001,2017,6,26,13,1415,1433,2848,3034
0130-001,2017,6,26,14,1478,1536,3014,2848
0130-001,2017,6,26,15,1711,1790,3501,3014
0130-001,2017,6,26,16,1583,1756,3339,3501
0130-001,2017,6,26,17,1478,1797,3275,3339
0130-001,2017,6,26,18,1508,2085,3593,3275
0130-001,2017,6,26,19,1562,2276,3838,3593
0130-001,2017,6,26,20,1285,1756,3041,3838
0130-001,2017,6,26,21,1086,1671,2757,3041
0130-001,2017,6,26,22,1005,1325,2330,2757
0130-001,2017,6,26,23,753,760,1513,2330
0130-001,2017,6,26,24,500,478,978,1513
0130-001,2017,6,27,1,326,342,668,978
0130-001,2017,6,27,2,207,185,392,668
0130-001,2017,6,27,3,144,188,332,392
0130-001,2017,6,27,4,116,181,297,332
0130-001,2017,6,27,5,257,227,484,297
0130-001,2017,6,27,6,658,472,1130,484
0130-001,2017,6,27,7,1599,937,2536,1130
0130-001,2017,6,27,8,1563,1535,3098,2536
0130-001,2017,6,27,9,1613,1998,3611,3098
0130-001,2017,6,27,10,1539,1572,3111,3611
0130-001,2017,6,27,11,1537,1573,3110,3111
0130-001,2017,6,27,12,1514,1586,3100,3110
0130-001,2017,6,27,13,1384,1455,2839,3100
0130-001,2017,6,27,14,1630,1806,3436,2839
0130-001,2017,6,27,15,1557,1579,3136,3436
0130-001,2017,6,27,16,1553,1684,3237,3136
0130-001,2017,6,27,17,1482,1893,3375,3237
0130-001,2017,6,27,18,1677,2356,4033,3375
0130-001,2017,6,27,19,1613,2439,4052,4033
0130-001,2017,6,27,20,1248,1726,2974,4052
0130-001,2017,6,27,21,1090,1679,2769,2974
0130-001,2017,6,27,22,1104,1379,2483,2769
0130-001,2017,6,27,23,732,786,1518,2483
0130-001,2017,6,27,24,537,520,1057,1518
0130-001,2017,6,28,1,354,312,666,1057
0130-001,2017,6,28,2,227,218,445,666
0130-001,2017,6,28,3,171,176,347,445
0130-001,2017,6,28,4,160,227,387,347
0130-001,2017,6,28,5,262,238,500,387
0130-001,2017,6,28,6,655,464,1119,500
0130-001,2017,6,28,7,1584,949,2533,1119
0130-001,2017,6,28,8,1604,1573,3177,2533
0130-001,2017,6,28,9,1609,1934,3543,3177
0130-001,2017,6,28,10,1510,1604,3114,3543
0130-001,2017,6,28,11,1609,1585,3194,3114
0130-001,2017,6,28,12,1502,1531,3033,3194
0130-001,2017,6,28,13,1331,1496,2827,3033
0130-001,2017,6,28,14,1640,1630,3270,2827
0130-001,2017,6,28,15,1525,1667,3192,3270
0130-001,2017,6,28,16,1532,1741,3273,3192
0130-001,2017,6,28,17,1540,1856,3396,3273
0130-001,2017,6,28,18,1627,2354,3981,3396
0130-001,2017,6,28,19,1597,2537,4134,3981
0130-001,2017,6,28,20,1269,1884,3153,4134
0130-001,2017,6,28,21,1147,1585,2732,3153
0130-001,2017,6,28,22,1196,1282,2478,2732
0130-001,2017,6,28,23,859,837,1696,2478
0130-001,2017,6,28,24,595,555,1150,1696
0130-001,2017,6,29,1,446,382,828,1150
0130-001,2017,6,29,2,249,269,518,828
0130-001,2017,6,29,3,182,211,393,518
0130-001,2017,6,29,4,156,221,377,393
0130-001,2017,6,29,5,272,272,544,377
0130-001,2017,6,29,6,675,507,1182,544
0130-001,2017,6,29,7,1625,933,2558,1182
0130-001,2017,6,29,8,1600,1616,3216,2558
0130-001,2017,6,29,9,1568,1912,3480,3216
0130-001,2017,6,29,10,1555,1564,3119,3480
0130-001,2017,6,29,11,1557,1625,3182,3119
0130-001,2017,6,29,12,1414,1580,2994,3182
0130-001,2017,6,29,13,1326,1381,2707,2994
0130-001,2017,6,29,14,1607,1559,3166,2707
0130-001,2017,6,29,15,1469,1587,3056,3166
0130-001,2017,6,29,16,1481,1739,3220,3056
0130-001,2017,6,29,17,1491,1843,3334,3220
0130-001,2017,6,29,18,1627,2323,3950,3334
0130-001,2017,6,29,19,1641,2397,4038,3950
0130-001,2017,6,29,20,1205,1810,3015,4038
0130-001,2017,6,29,21,1190,1658,2848,3015
0130-001,2017,6,29,22,1091,1349,2440,2848
0130-001,2017,6,29,23,825,866,1691,2440
0130-001,2017,6,29,24,608,586,1194,1691
0130-001,2017,6,30,1,393,379,772,1194
0130-001,2017,6,30,2,254,248,502,772
0130-001,2017,6,30,3,187,203,390,502
0130-001,2017,6,30,4,157,222,379,390
0130-001,2017,6,30,5,262,254,516,379
0130-001,2017,6,30,6,674,490,1164,516
0130-001,2017,6,30,7,1588,952,2540,1164
0130-001,2017,6,30,8,1639,1625,3264,2540
0130-001,2017,6,30,9,1572,1888,3460,3264
0130-001,2017,6,30,10,1505,1606,3111,3460
0130-001,2017,6,30,11,1567,1590,3157,3111
0130-001,2017,6,30,12,1471,1532,3003,3157
0130-001,2017,6,30,13,1246,1502,2748,3003
0130-001,2017,6,30,14,1592,1635,3227,2748
0130-001,2017,6,30,15,1531,1735,3266,3227
0130-001,2017,6,30,16,1543,1736,3279,3266
0130-001,2017,6,30,17,1534,1881,3415,3279
0130-001,2017,6,30,18,1747,2417,4164,3415
0130-001,2017,6,30,19,1681,2553,4234,4164
0130-001,2017,6,30,20,1389,2199,3588,4234
0130-001,2017,6,30,21,1342,1730,3072,3588
0130-001,2017,6,30,22,1299,1309,2608,3072
0130-001,2017,6,30,23,993,917,1910,2608
0130-001,2017,6,30,24,618,597,1215,1910
0130-001,2017,7,1,1,482,498,980,1215
0130-001,2017,7,1,2,347,322,669,980
0130-001,2017,7,1,3,269,260,529,669
0130-001,2017,7,1,4,218,296,514,529
0130-001,2017,7,1,5,302,280,582,514
0130-001,2017,7,1,6,585,521,1106,582
0130-001,2017,7,1,7,1187,771,1958,1106
0130-001,2017,7,1,8,1389,1060,2449,1958
0130-001,2017,7,1,9,1377,1458,2835,2449
0130-001,2017,7,1,10,1408,1583,2991,2835
0130-001,2017,7,1,11,1496,1714,3210,2991
0130-001,2017,7,1,12,1487,1787,3274,3210
0130-001,2017,7,1,13,1576,1737,3313,3274
0130-001,2017,7,1,14,1499,1843,3342,3313
0130-001,2017,7,1,15,1493,1755,3248,3342
0130-001,2017,7,1,16,1535,1783,3318,3248
0130-001,2017,7,1,17,1507,1896,3403,3318
0130-001,2017,7,1,18,1457,1909,3366,3403
0130-001,2017,7,1,19,1526,1892,3418,3366
0130-001,2017,7,1,20,1252,1309,2561,3418
0130-001,2017,7,1,21,1100,1126,2226,2561
0130-001,2017,7,1,22,1110,920,2030,2226
0130-001,2017,7,1,23,729,681,1410,2030
0130-001,2017,7,1,24,508,494,1002,1410
0130-001,2017,7,2,1,416,361,777,1002
0130-001,2017,7,2,2,319,242,561,777
0130-001,2017,7,2,3,233,226,459,561
0130-001,2017,7,2,4,192,184,376,459
0130-001,2017,7,2,5,208,173,381,376
0130-001,2017,7,2,6,327,263,590,381
0130-001,2017,7,2,7,526,427,953,590
0130-001,2017,7,2,8,645,534,1179,953
0130-001,2017,7,2,9,760,801,1561,1179
0130-001,2017,7,2,10,909,1004,1913,1561
0130-001,2017,7,2,11,1092,1359,2451,1913
0130-001,2017,7,2,12,1109,1512,2621,2451
0130-001,2017,7,2,13,1291,1663,2954,2621
0130-001,2017,7,2,14,1381,1503,2884,2954
0130-001,2017,7,2,15,1401,1601,3002,2884
0130-001,2017,7,2,16,1479,1559,3038,3002
0130-001,2017,7,2,17,1520,1570,3090,3038
0130-001,2017,7,2,18,1474,1437,2911,3090
0130-001,2017,7,2,19,1369,1362,2731,2911
0130-001,2017,7,2,20,1397,1110,2507,2731
0130-001,2017,7,2,21,1101,944,2045,2507
0130-001,2017,7,2,22,976,789,1765,2045
0130-001,2017,7,2,23,673,530,1203,1765
0130-001,2017,7,2,24,378,335,713,1203
0130-001,2017,7,3,1,263,227,490,713
0130-001,2017,7,3,2,173,180,353,490
0130-001,2017,7,3,3,144,121,265,353
0130-001,2017,7,3,4,109,157,266,265
0130-001,2017,7,3,5,206,210,416,266
0130-001,2017,7,3,6,586,425,1011,416
0130-001,2017,7,3,7,1587,896,2483,1011
0130-001,2017,7,3,8,1424,1604,3028,2483
0130-001,2017,7,3,9,1466,1848,3314,3028
0130-001,2017,7,3,10,1471,1532,3003,3314
0130-001,2017,7,3,11,1368,1478,2846,3003
0130-001,2017,7,3,12,1479,1509,2988,2846
0130-001,2017,7,3,13,1354,1485,2839,2988
0130-001,2017,7,3,14,1603,1554,3157,2839
0130-001,2017,7,3,15,1512,1572,3084,3157
0130-001,2017,7,3,16,1531,1632,3163,3084
0130-001,2017,7,3,17,1440,1834,3274,3163
0130-001,2017,7,3,18,1513,2117,3630,3274
0130-001,2017,7,3,19,1573,2303,3876,3630
0130-001,2017,7,3,20,1209,1766,2975,3876
0130-001,2017,7,3,21,1136,1674,2810,2975
0130-001,2017,7,3,22,998,1228,2226,2810
0130-001,2017,7,3,23,746,740,1486,2226
0130-001,2017,7,3,24,460,456,916,1486
0130-001,2017,7,4,1,325,295,620,916
0130-001,2017,7,4,2,201,216,417,620
0130-001,2017,7,4,3,191,150,341,417
0130-001,2017,7,4,4,118,196,314,341
0130-001,2017,7,4,5,209,198,407,314
0130-001,2017,7,4,6,522,415,937,407
0130-001,2017,7,4,7,1489,816,2305,937
0130-001,2017,7,4,8,1347,1581,2928,2305
0130-001,2017,7,4,9,1462,1935,3397,2928
0130-001,2017,7,4,10,1600,1462,3062,3397
0130-001,2017,7,4,11,1527,1532,3059,3062
0130-001,2017,7,4,12,1487,1594,3081,3059
0130-001,2017,7,4,13,1423,1406,2829,3081
0130-001,2017,7,4,14,1654,1660,3314,2829
0130-001,2017,7,4,15,1588,1652,3240,3314
0130-001,2017,7,4,16,1590,1793,3383,3240
0130-001,2017,7,4,17,1557,1823,3380,3383
0130-001,2017,7,4,18,1592,2159,3751,3380
0130-001,2017,7,4,19,1661,2387,4048,3751
0130-001,2017,7,4,20,1282,1860,3142,4048
0130-001,2017,7,4,21,1157,1729,2886,3142
0130-001,2017,7,4,22,1060,1367,2427,2886
0130-001,2017,7,4,23,855,801,1656,2427
0130-001,2017,7,4,24,489,527,1016,1656
0130-001,2017,7,5,1,383,315,698,1016
0130-001,2017,7,5,2,246,256,502,698
0130-001,2017,7,5,3,172,190,362,502
0130-001,2017,7,5,4,164,182,346,362
0130-001,2017,7,5,5,247,236,483,346
0130-001,2017,7,5,6,614,487,1101,483
0130-001,2017,7,5,7,1657,942,2599,1101
0130-001,2017,7,5,8,1623,1616,3239,2599
0130-001,2017,7,5,9,1536,1952,3488,3239
0130-001,2017,7,5,10,1533,1606,3139,3488
0130-001,2017,7,5,11,1592,1571,3163,3139
0130-001,2017,7,5,12,1467,1597,3064,3163
0130-001,2017,7,5,13,1416,1489,2905,3064
0130-001,2017,7,5,14,1625,1642,3267,2905
0130-001,2017,7,5,15,1617,1622,3239,3267
0130-001,2017,7,5,16,1495,1677,3172,3239
0130-001,2017,7,5,17,1507,1875,3382,3172
0130-001,2017,7,5,18,1638,2319,3957,3382
0130-001,2017,7,5,19,1660,2512,4172,3957
0130-001,2017,7,5,20,1301,1914,3215,4172
0130-001,2017,7,5,21,1232,1575,2807,3215
0130-001,2017,7,5,22,1124,1218,2342,2807
0130-001,2017,7,5,23,833,804,1637,2342
0130-001,2017,7,5,24,592,545,1137,1637
0130-001,2017,7,6,1,442,378,820,1137
0130-001,2017,7,6,2,252,248,500,820
0130-001,2017,7,6,3,169,208,377,500
0130-001,2017,7,6,4,161,209,370,377
0130-001,2017,7,6,5,261,252,513,370
0130-001,2017,7,6,6,666,464,1130,513
0130-001,2017,7,6,7,1661,986,2647,1130
0130-001,2017,7,6,8,1515,1585,3100,2647
0130-001,2017,7,6,9,1589,1934,3523,3100
0130-001,2017,7,6,10,1511,1592,3103,3523
0130-001,2017,7,6,11,1531,1600,3131,3103
0130-001,2017,7,6,12,1524,1594,3118,3131
0130-001,2017,7,6,13,1412,1524,2936,3118
0130-001,2017,7,6,14,1636,1590,3226,2936
0130-001,2017,7,6,15,1506,1686,3192,3226
0130-001,2017,7,6,16,1525,1586,3111,3192
0130-001,2017,7,6,17,1353,1727,3080,3111
0130-001,2017,7,6,18,1579,2193,3772,3080
0130-001,2017,7,6,19,1601,2468,4069,3772
0130-001,2017,7,6,20,1251,1842,3093,4069
0130-001,2017,7,6,21,1118,1695,2813,3093
0130-001,2017,7,6,22,1139,1245,2384,2813
0130-001,2017,7,6,23,781,815,1596,2384
0130-001,2017,7,6,24,572,511,1083,1596
0130-001,2017,7,7,1,362,388,750,1083
0130-001,2017,7,7,2,201,232,433,750
0130-001,2017,7,7,3,180,182,362,433
0130-001,2017,7,7,4,152,209,361,362
0130-001,2017,7,7,5,222,220,442,361
0130-001,2017,7,7,6,630,477,1107,442
0130-001,2017,7,7,7,1570,863,2433,1107
0130-001,2017,7,7,8,1652,1601,3253,2433
0130-001,2017,7,7,9,1510,1866,3376,3253
0130-001,2017,7,7,10,1550,1589,3139,3376
0130-001,2017,7,7,11,1591,1546,3137,3139
0130-001,2017,7,7,12,1478,1524,3002,3137
0130-001,2017,7,7,13,1383,1554,2937,3002
0130-001,2017,7,7,14,1662,1658,3320,2937
0130-001,2017,7,7,15,1571,1730,3301,3320
0130-001,2017,7,7,16,1627,1736,3363,3301
0130-001,2017,7,7,17,1589,1873,3462,3363
0130-001,2017,7,7,18,1717,2347,4064,3462
0130-001,2017,7,7,19,1575,2354,3929,4064
0130-001,2017,7,7,20,1352,2046,3398,3929
0130-001,2017,7,7,21,1237,1671,2908,3398
0130-001,2017,7,7,22,1237,1228,2465,2908
0130-001,2017,7,7,23,937,811,1748,2465
0130-001,2017,7,7,24,550,577,1127,1748
0130-001,2017,7,8,1,489,412,901,1127
0130-001,2017,7,8,2,319,295,614,901
0130-001,2017,7,8,3,251,238,489,614
0130-001,2017,7,8,4,200,233,433,489
0130-001,2017,7,8,5,234,251,485,433
0130-001,2017,7,8,6,500,424,924,485
0130-001,2017,7,8,7,931,689,1620,924
0130-001,2017,7,8,8,1267,942,2209,1620
0130-001,2017,7,8,9,1335,1318,2653,2209
0130-001,2017,7,8,10,1230,1347,2577,2653
0130-001,2017,7,8,11,1364,1609,2973,2577
0130-001,2017,7,8,12,1493,1800,3293,2973
0130-001,2017,7,8,13,1425,1607,3032,3293
0130-001,2017,7,8,14,1405,1734,3139,3032
0130-001,2017,7,8,15,1402,1623,3025,3139
0130-001,2017,7,8,16,1420,1611,3031,3025
0130-001,2017,7,8,17,1409,1640,3049,3031
0130-001,2017,7,8,18,1420,1756,3176,3049
0130-001,2017,7,8,19,1675,1793,3468,3176
0130-001,2017,7,8,20,1314,1335,2649,3468
0130-001,2017,7,8,21,1135,1111,2246,2649
0130-001,2017,7,8,22,1132,918,2050,2246
0130-001,2017,7,8,23,814,673,1487,2050
0130-001,2017,7,8,24,542,515,1057,1487
0130-001,2017,7,9,1,415,400,815,1057
0130-001,2017,7,9,2,321,288,609,815
0130-001,2017,7,9,3,271,226,497,609
0130-001,2017,7,9,4,201,169,370,497
0130-001,2017,7,9,5,184,154,338,370
0130-001,2017,7,9,6,402,291,693,338
0130-001,2017,7,9,7,573,460,1033,693
0130-001,2017,7,9,8,629,574,1203,1033
0130-001,2017,7,9,9,822,821,1643,1203
0130-001,2017,7,9,10,900,1029,1929,1643
0130-001,2017,7,9,11,1149,1251,2400,1929
0130-001,2017,7,9,12,1059,1279,2338,2400
0130-001,2017,7,9,13,1162,1315,2477,2338
0130-001,2017,7,9,14,1294,1457,2751,2477
0130-001,2017,7,9,15,1291,1416,2707,2751
0130-001,2017,7,9,16,1286,1410,2696,2707
0130-001,2017,7,9,17,1407,1296,2703,2696
0130-001,2017,7,9,18,1332,1433,2765,2703
0130-001,2017,7,9,19,1387,1394,2781,2765
0130-001,2017,7,9,20,1301,1101,2402,2781
0130-001,2017,7,9,21,1085,1009,2094,2402
0130-001,2017,7,9,22,1033,925,1958,2094
0130-001,2017,7,9,23,709,626,1335,1958
0130-001,2017,7,9,24,461,375,836,1335
0130-001,2017,7,10,1,265,227,492,836
0130-001,2017,7,10,2,161,150,311,492
0130-001,2017,7,10,3,116,112,228,311
0130-001,2017,7,10,4,124,170,294,228
0130-001,2017,7,10,5,201,212,413,294
0130-001,2017,7,10,6,709,442,1151,413
0130-001,2017,7,10,7,1655,940,2595,1151
0130-001,2017,7,10,8,1498,1538,3036,2595
0130-001,2017,7,10,9,1504,1914,3418,3036
0130-001,2017,7,10,10,1407,1442,2849,3418
0130-001,2017,7,10,11,1207,1470,2677,2849
0130-001,2017,7,10,12,1378,1425,2803,2677
0130-001,2017,7,10,13,1304,1487,2791,2803
0130-001,2017,7,10,14,1534,1503,3037,2791
0130-001,2017,7,10,15,1566,1562,3128,3037
0130-001,2017,7,10,16,1524,1721,3245,3128
0130-001,2017,7,10,17,1473,1779,3252,3245
0130-001,2017,7,10,18,1586,2110,3696,3252
0130-001,2017,7,10,19,1549,2273,3822,3696
0130-001,2017,7,10,20,1214,1692,2906,3822
0130-001,2017,7,10,21,1091,1624,2715,2906
0130-001,2017,7,10,22,980,1254,2234,2715
0130-001,2017,7,10,23,705,676,1381,2234
0130-001,2017,7,10,24,475,439,914,1381
0130-001,2017,7,11,1,321,330,651,914
0130-001,2017,7,11,2,211,190,401,651
0130-001,2017,7,11,3,156,176,332,401
0130-001,2017,7,11,4,133,196,329,332
0130-001,2017,7,11,5,181,215,396,329
0130-001,2017,7,11,6,610,435,1045,396
0130-001,2017,7,11,7,1610,863,2473,1045
0130-001,2017,7,11,8,1624,1584,3208,2473
0130-001,2017,7,11,9,1606,1910,3516,3208
0130-001,2017,7,11,10,1517,1575,3092,3516
0130-001,2017,7,11,11,1580,1622,3202,3092
0130-001,2017,7,11,12,1488,1514,3002,3202
0130-001,2017,7,11,13,1403,1433,2836,3002
0130-001,2017,7,11,14,1606,1712,3318,2836
0130-001,2017,7,11,15,1588,1583,3171,3318
0130-001,2017,7,11,16,1599,1692,3291,3171
0130-001,2017,7,11,17,1503,1889,3392,3291
0130-001,2017,7,11,18,1678,2192,3870,3392
0130-001,2017,7,11,19,1574,2333,3907,3870
0130-001,2017,7,11,20,1366,1831,3197,3907
0130-001,2017,7,11,21,1199,1692,2891,3197
0130-001,2017,7,11,22,1106,1324,2430,2891
0130-001,2017,7,11,23,807,809,1616,2430
0130-001,2017,7,11,24,528,522,1050,1616
0130-001,2017,7,12,1,361,324,685,1050
0130-001,2017,7,12,2,208,230,438,685
0130-001,2017,7,12,3,155,190,345,438
0130-001,2017,7,12,4,148,209,357,345
0130-001,2017,7,12,5,236,243,479,357
0130-001,2017,7,12,6,673,494,1167,479
0130-001,2017,7,12,7,1623,928,2551,1167
0130-001,2017,7,12,8,1529,1610,3139,2551
0130-001,2017,7,12,9,1589,1896,3485,3139
0130-001,2017,7,12,10,1557,1573,3130,3485
0130-001,2017,7,12,11,1521,1548,3069,3130
0130-001,2017,7,12,12,1539,1598,3137,3069
0130-001,2017,7,12,13,1338,1360,2698,3137
0130-001,2017,7,12,14,1483,1593,3076,2698
0130-001,2017,7,12,15,1578,1588,3166,3076
0130-001,2017,7,12,16,1675,1783,3458,3166
0130-001,2017,7,12,17,1611,1871,3482,3458
0130-001,2017,7,12,18,1700,2376,4076,3482
0130-001,2017,7,12,19,1617,2475,4092,4076
0130-001,2017,7,12,20,1351,1977,3328,4092
0130-001,2017,7,12,21,1166,1662,2828,3328
0130-001,2017,7,12,22,1188,1277,2465,2828
0130-001,2017,7,12,23,886,867,1753,2465
0130-001,2017,7,12,24,564,525,1089,1753
0130-001,2017,7,13,1,388,363,751,1089
0130-001,2017,7,13,2,233,252,485,751
0130-001,2017,7,13,3,189,200,389,485
0130-001,2017,7,13,4,157,237,394,389
0130-001,2017,7,13,5,231,268,499,394
0130-001,2017,7,13,6,703,452,1155,499
0130-001,2017,7,13,7,1681,917,2598,1155
0130-001,2017,7,13,8,1568,1619,3187,2598
0130-001,2017,7,13,9,1621,1863,3484,3187
0130-001,2017,7,13,10,1556,1701,3257,3484
0130-001,2017,7,13,11,1563,1611,3174,3257
0130-001,2017,7,13,12,1426,1488,2914,3174
0130-001,2017,7,13,13,1383,1399,2782,2914
0130-001,2017,7,13,14,1556,1651,3207,2782
0130-001,2017,7,13,15,1596,1593,3189,3207
0130-001,2017,7,13,16,1560,1717,3277,3189
0130-001,2017,7,13,17,1509,1910,3419,3277
0130-001,2017,7,13,18,1649,2197,3846,3419
0130-001,2017,7,13,19,1651,2388,4039,3846
0130-001,2017,7,13,20,1324,1795,3119,4039
0130-001,2017,7,13,21,1139,1771,2910,3119
0130-001,2017,7,13,22,1165,1363,2528,2910
0130-001,2017,7,13,23,861,876,1737,2528
0130-001,2017,7,13,24,600,586,1186,1737
0130-001,2017,7,14,1,388,382,770,1186
0130-001,2017,7,14,2,243,256,499,770
0130-001,2017,7,14,3,171,197,368,499
0130-001,2017,7,14,4,135,201,336,368
0130-001,2017,7,14,5,260,239,499,336
0130-001,2017,7,14,6,690,482,1172,499
0130-001,2017,7,14,7,1666,930,2596,1172
0130-001,2017,7,14,8,1548,1621,3169,2596
0130-001,2017,7,14,9,1629,1931,3560,3169
0130-001,2017,7,14,10,1466,1584,3050,3560
0130-001,2017,7,14,11,1623,1561,3184,3050
0130-001,2017,7,14,12,1532,1632,3164,3184
0130-001,2017,7,14,13,1404,1466,2870,3164
0130-001,2017,7,14,14,1631,1725,3356,2870
0130-001,2017,7,14,15,1638,1590,3228,3356
0130-001,2017,7,14,16,1700,1778,3478,3228
0130-001,2017,7,14,17,1651,1911,3562,3478
0130-001,2017,7,14,18,1825,2403,4228,3562
0130-001,2017,7,14,19,1683,2497,4180,4228
0130-001,2017,7,14,20,1458,2048,3506,4180
0130-001,2017,7,14,21,1327,1777,3104,3506
0130-001,2017,7,14,22,1329,1332,2661,3104
0130-001,2017,7,14,23,933,920,1853,2661
0130-001,2017,7,14,24,653,642,1295,1853
0130-001,2017,7,15,1,484,404,888,1295
0130-001,2017,7,15,2,349,325,674,888
0130-001,2017,7,15,3,264,255,519,674
0130-001,2017,7,15,4,195,244,439,519
0130-001,2017,7,15,5,244,258,502,439
0130-001,2017,7,15,6,532,408,940,502
0130-001,2017,7,15,7,1110,734,1844,940
0130-001,2017,7,15,8,1365,1033,2398,1844
0130-001,2017,7,15,9,1365,1462,2827,2398
0130-001,2017,7,15,10,1374,1613,2987,2827
0130-001,2017,7,15,11,1500,1739,3239,2987
0130-001,2017,7,15,12,1484,1836,3320,3239
0130-001,2017,7,15,13,1528,1913,3441,3320
0130-001,2017,7,15,14,1523,1864,3387,3441
0130-001,2017,7,15,15,1528,1751,3279,3387
0130-001,2017,7,15,16,1510,1792,3302,3279
0130-001,2017,7,15,17,1521,1774,3295,3302
0130-001,2017,7,15,18,1652,1940,3592,3295
0130-001,2017,7,15,19,1492,1827,3319,3592
0130-001,2017,7,15,20,1249,1359,2608,3319
0130-001,2017,7,15,21,1101,1115,2216,2608
0130-001,2017,7,15,22,1184,883,2067,2216
0130-001,2017,7,15,23,745,642,1387,2067
0130-001,2017,7,15,24,528,497,1025,1387
0130-001,2017,7,16,1,424,387,811,1025
0130-001,2017,7,16,2,322,281,603,811
0130-001,2017,7,16,3,267,225,492,603
0130-001,2017,7,16,4,177,148,325,492
0130-001,2017,7,16,5,213,173,386,325
0130-001,2017,7,16,6,284,215,499,386
0130-001,2017,7,16,7,478,423,901,499
0130-001,2017,7,16,8,624,536,1160,901
0130-001,2017,7,16,9,720,834,1554,1160
0130-001,2017,7,16,10,779,918,1697,1554
0130-001,2017,7,16,11,993,1199,2192,1697
0130-001,2017,7,16,12,979,1291,2270,2192
0130-001,2017,7,16,13,1179,1371,2550,2270
0130-001,2017,7,16,14,1291,1482,2773,2550
0130-001,2017,7,16,15,1427,1477,2904,2773
0130-001,2017,7,16,16,1506,1508,3014,2904
0130-001,2017,7,16,17,1562,1446,3008,3014
0130-001,2017,7,16,18,1375,1471,2846,3008
0130-001,2017,7,16,19,1310,1330,2640,2846
0130-001,2017,7,16,20,1326,1166,2492,2640
0130-001,2017,7,16,21,1144,1018,2162,2492
0130-001,2017,7,16,22,979,778,1757,2162
0130-001,2017,7,16,23,727,592,1319,1757
0130-001,2017,7,16,24,436,381,817,1319
0130-001,2017,7,17,1,283,220,503,817
0130-001,2017,7,17,2,158,167,325,503
0130-001,2017,7,17,3,152,113,265,325
0130-001,2017,7,17,4,123,164,287,265
0130-001,2017,7,17,5,233,227,460,287
0130-001,2017,7,17,6,690,504,1194,460
0130-001,2017,7,17,7,1640,1007,2647,1194
0130-001,2017,7,17,8,1519,1575,3094,2647
0130-001,2017,7,17,9,1714,1899,3613,3094
0130-001,2017,7,17,10,1533,1540,3073,3613
0130-001,2017,7,17,11,1578,1560,3138,3073
0130-001,2017,7,17,12,1526,1579,3105,3138
0130-001,2017,7,17,13,1426,1395,2821,3105
0130-001,2017,7,17,14,1511,1605,3116,2821
0130-001,2017,7,17,15,1438,1577,3015,3116
0130-001,2017,7,17,16,1583,1656,3239,3015
0130-001,2017,7,17,17,1572,1861,3433,3239
0130-001,2017,7,17,18,1632,2213,3845,3433
0130-001,2017,7,17,19,1572,2328,3900,3845
0130-001,2017,7,17,20,1254,1735,2989,3900
0130-001,2017,7,17,21,1089,1612,2701,2989
0130-001,2017,7,17,22,1020,1293,2313,2701
0130-001,2017,7,17,23,748,757,1505,2313
0130-001,2017,7,17,24,490,438,928,1505
0130-001,2017,7,18,1,351,300,651,928
0130-001,2017,7,18,2,220,221,441,651
0130-001,2017,7,18,3,165,194,359,441
0130-001,2017,7,18,4,138,195,333,359
0130-001,2017,7,18,5,214,242,456,333
0130-001,2017,7,18,6,617,477,1094,456
0130-001,2017,7,18,7,1572,925,2497,1094
0130-001,2017,7,18,8,1411,1558,2969,2497
0130-001,2017,7,18,9,1629,1803,3432,2969
0130-001,2017,7,18,10,1538,1599,3137,3432
0130-001,2017,7,18,11,1582,1616,3198,3137
0130-001,2017,7,18,12,1112,1437,2549,3198
0130-001,2017,7,18,13,1411,1451,2862,2549
0130-001,2017,7,18,14,1463,1626,3089,2862
0130-001,2017,7,18,15,1458,1619,3077,3089
0130-001,2017,7,18,16,1490,1488,2978,3077
0130-001,2017,7,18,17,1446,1998,3444,2978
0130-001,2017,7,18,18,1715,2210,3925,3444
0130-001,2017,7,18,19,1628,2352,3980,3925
0130-001,2017,7,18,20,1285,1809,3094,3980
0130-001,2017,7,18,21,1165,1753,2918,3094
0130-001,2017,7,18,22,1105,1239,2344,2918
0130-001,2017,7,18,23,813,858,1671,2344
0130-001,2017,7,18,24,553,548,1101,1671
0130-001,2017,7,19,1,352,345,697,1101
0130-001,2017,7,19,2,213,240,453,697
0130-001,2017,7,19,3,167,184,351,453
0130-001,2017,7,19,4,134,180,314,351
0130-001,2017,7,19,5,226,243,469,314
0130-001,2017,7,19,6,638,495,1133,469
0130-001,2017,7,19,7,1631,929,2560,1133
0130-001,2017,7,19,8,1618,1601,3219,2560
0130-001,2017,7,19,9,1589,1924,3513,3219
0130-001,2017,7,19,10,1521,1595,3116,3513
0130-001,2017,7,19,11,1612,1584,3196,3116
0130-001,2017,7,19,12,1481,1544,3025,3196
0130-001,2017,7,19,13,1351,1440,2791,3025
0130-001,2017,7,19,14,1625,1549,3174,2791
0130-001,2017,7,19,15,1573,1654,3227,3174
0130-001,2017,7,19,16,1603,1804,3407,3227
0130-001,2017,7,19,17,1613,1836,3449,3407
0130-001,2017,7,19,18,1704,2367,4071,3449
0130-001,2017,7,19,19,1596,2484,4080,4071
0130-001,2017,7,19,20,1374,1871,3245,4080
0130-001,2017,7,19,21,1154,1639,2793,3245
0130-001,2017,7,19,22,1153,1255,2408,2793
0130-001,2017,7,19,23,888,858,1746,2408
0130-001,2017,7,19,24,605,535,1140,1746
0130-001,2017,7,20,1,400,373,773,1140
0130-001,2017,7,20,2,258,244,502,773
0130-001,2017,7,20,3,191,184,375,502
0130-001,2017,7,20,4,154,202,356,375
0130-001,2017,7,20,5,237,234,471,356
0130-001,2017,7,20,6,663,484,1147,471
0130-001,2017,7,20,7,1636,968,2604,1147
0130-001,2017,7,20,8,1608,1556,3164,2604
0130-001,2017,7,20,9,1628,1919,3547,3164
0130-001,2017,7,20,10,1600,1624,3224,3547
0130-001,2017,7,20,11,1585,1601,3186,3224
0130-001,2017,7,20,12,1496,1671,3167,3186
0130-001,2017,7,20,13,1380,1559,2939,3167
0130-001,2017,7,20,14,1658,1722,3380,2939
0130-001,2017,7,20,15,1581,1584,3165,3380
0130-001,2017,7,20,16,1547,1743,3290,3165
0130-001,2017,7,20,17,1529,1831,3360,3290
0130-001,2017,7,20,18,1707,2233,3940,3360
0130-001,2017,7,20,19,1583,2487,4070,3940
0130-001,2017,7,20,20,1289,1893,3182,4070
0130-001,2017,7,20,21,1335,1762,3097,3182
0130-001,2017,7,20,22,1097,1346,2443,3097
0130-001,2017,7,20,23,908,869,1777,2443
0130-001,2017,7,20,24,572,535,1107,1777
0130-001,2017,7,21,1,422,396,818,1107
0130-001,2017,7,21,2,261,292,553,818
0130-001,2017,7,21,3,204,209,413,553
0130-001,2017,7,21,4,159,223,382,413
0130-001,2017,7,21,5,230,249,479,382
0130-001,2017,7,21,6,647,498,1145,479
0130-001,2017,7,21,7,1588,969,2557,1145
0130-001,2017,7,21,8,1573,1553,3126,2557
0130-001,2017,7,21,9,1594,1943,3537,3126
0130-001,2017,7,21,10,1555,1614,3169,3537
0130-001,2017,7,21,11,1595,1665,3260,3169
0130-001,2017,7,21,12,1540,1723,3263,3260
0130-001,2017,7,21,13,1469,1593,3062,3263
0130-001,2017,7,21,14,1681,1743,3424,3062
0130-001,2017,7,21,15,1566,1747,3313,3424
0130-001,2017,7,21,16,1677,1852,3529,3313
0130-001,2017,7,21,17,1637,1925,3562,3529
0130-001,2017,7,21,18,1783,2374,4157,3562
0130-001,2017,7,21,19,1698,2532,4230,4157
0130-001,2017,7,21,20,1513,2174,3687,4230
0130-001,2017,7,21,21,1311,1790,3101,3687
0130-001,2017,7,21,22,1359,1386,2745,3101
0130-001,2017,7,21,23,989,930,1919,2745
0130-001,2017,7,21,24,656,579,1235,1919
0130-001,2017,7,22,1,462,413,875,1235
0130-001,2017,7,22,2,332,321,653,875
0130-001,2017,7,22,3,262,235,497,653
0130-001,2017,7,22,4,213,276,489,497
0130-001,2017,7,22,5,273,284,557,489
0130-001,2017,7,22,6,624,461,1085,557
0130-001,2017,7,22,7,1129,805,1934,1085
0130-001,2017,7,22,8,1321,1200,2521,1934
0130-001,2017,7,22,9,1457,1557,3014,2521
0130-001,2017,7,22,10,1394,1609,3003,3014
0130-001,2017,7,22,11,1492,1731,3223,3003
0130-001,2017,7,22,12,1450,1781,3231,3223
0130-001,2017,7,22,13,1475,1856,3331,3231
0130-001,2017,7,22,14,1534,1879,3413,3331
0130-001,2017,7,22,15,1594,1791,3385,3413
0130-001,2017,7,22,16,1553,1915,3468,3385
0130-001,2017,7,22,17,1573,1817,3390,3468
0130-001,2017,7,22,18,1617,2065,3682,3390
0130-001,2017,7,22,19,1637,1897,3534,3682
0130-001,2017,7,22,20,1286,1532,2818,3534
0130-001,2017,7,22,21,1271,1275,2546,2818
0130-001,2017,7,22,22,1234,974,2208,2546
0130-001,2017,7,22,23,788,750,1538,2208
0130-001,2017,7,22,24,614,516,1130,1538
0130-001,2017,7,23,1,407,374,781,1130
0130-001,2017,7,23,2,310,267,577,781
0130-001,2017,7,23,3,229,202,431,577
0130-001,2017,7,23,4,204,177,381,431
0130-001,2017,7,23,5,232,188,420,381
0130-001,2017,7,23,6,431,316,747,420
0130-001,2017,7,23,7,628,466,1094,747
0130-001,2017,7,23,8,670,675,1345,1094
0130-001,2017,7,23,9,787,975,1762,1345
0130-001,2017,7,23,10,867,1019,1886,1762
0130-001,2017,7,23,11,1121,1237,2358,1886
0130-001,2017,7,23,12,1053,1262,2315,2358
0130-001,2017,7,23,13,1157,1324,2481,2315
0130-001,2017,7,23,14,1317,1431,2748,2481
0130-001,2017,7,23,15,1359,1417,2776,2748
0130-001,2017,7,23,16,1294,1445,2739,2776
0130-001,2017,7,23,17,1561,1339,2900,2739
0130-001,2017,7,23,18,1403,1517,2920,2900
0130-001,2017,7,23,19,1314,1275,2589,2920
0130-001,2017,7,23,20,1270,1127,2397,2589
0130-001,2017,7,23,21,1106,975,2081,2397
0130-001,2017,7,23,22,879,812,1691,2081
0130-001,2017,7,23,23,629,561,1190,1691
0130-001,2017,7,23,24,462,378,840,1190
0130-001,2017,7,24,1,279,214,493,840
0130-001,2017,7,24,2,133,133,266,493
0130-001,2017,7,24,3,124,135,259,266
0130-001,2017,7,24,4,138,166,304,259
0130-001,2017,7,24,5,222,209,431,304
0130-001,2017,7,24,6,672,485,1157,431
0130-001,2017,7,24,7,1665,974,2639,1157
0130-001,2017,7,24,8,1574,1543,3117,2639
0130-001,2017,7,24,9,1531,1824,3355,3117
0130-001,2017,7,24,10,1473,1592,3065,3355
0130-001,2017,7,24,11,1571,1593,3164,3065
0130-001,2017,7,24,12,1509,1606,3115,3164
0130-001,2017,7,24,13,1298,1450,2748,3115
0130-001,2017,7,24,14,1428,1519,2947,2748
0130-001,2017,7,24,15,1496,1583,3079,2947
0130-001,2017,7,24,16,1426,1625,3051,3079
0130-001,2017,7,24,17,1473,1783,3256,3051
0130-001,2017,7,24,18,1529,2031,3560,3256
0130-001,2017,7,24,19,1517,2308,3825,3560
0130-001,2017,7,24,20,1218,1730,2948,3825
0130-001,2017,7,24,21,1180,1629,2809,2948
0130-001,2017,7,24,22,932,1236,2168,2809
0130-001,2017,7,24,23,702,707,1409,2168
0130-001,2017,7,24,24,463,417,880,1409
0130-001,2017,7,25,1,315,309,624,880
0130-001,2017,7,25,2,189,210,399,624
0130-001,2017,7,25,3,153,178,331,399
0130-001,2017,7,25,4,154,195,349,331
0130-001,2017,7,25,5,193,235,428,349
0130-001,2017,7,25,6,572,435,1007,428
0130-001,2017,7,25,7,1560,892,2452,1007
0130-001,2017,7,25,8,1594,1485,3079,2452
0130-001,2017,7,25,9,1536,1821,3357,3079
0130-001,2017,7,25,10,1522,1602,3124,3357
0130-001,2017,7,25,11,1549,1712,3261,3124
0130-001,2017,7,25,12,1523,1574,3097,3261
0130-001,2017,7,25,13,1377,1506,2883,3097
0130-001,2017,7,25,14,1612,1559,3171,2883
0130-001,2017,7,25,15,1522,1663,3185,3171
0130-001,2017,7,25,16,1626,1673,3299,3185
0130-001,2017,7,25,17,1562,1853,3415,3299
0130-001,2017,7,25,18,1765,2216,3981,3415
0130-001,2017,7,25,19,1661,2329,3990,3981
0130-001,2017,7,25,20,1321,2019,3340,3990
0130-001,2017,7,25,21,1249,1728,2977,3340
0130-001,2017,7,25,22,1174,1351,2525,2977
0130-001,2017,7,25,23,841,811,1652,2525
0130-001,2017,7,25,24,542,542,1084,1652
0130-001,2017,7,26,1,417,341,758,1084
0130-001,2017,7,26,2,265,277,542,758
0130-001,2017,7,26,3,181,192,373,542
0130-001,2017,7,26,4,160,217,377,373
0130-001,2017,7,26,5,216,236,452,377
0130-001,2017,7,26,6,659,499,1158,452
0130-001,2017,7,26,7,1663,934,2597,1158
0130-001,2017,7,26,8,1586,1487,3073,2597
0130-001,2017,7,26,9,1498,1810,3308,3073
0130-001,2017,7,26,10,1533,1574,3107,3308
0130-001,2017,7,26,11,1637,1663,3300,3107
0130-001,2017,7,26,12,1551,1609,3160,3300
0130-001,2017,7,26,13,1389,1588,2977,3160
0130-001,2017,7,26,14,1576,1704,3280,2977
0130-001,2017,7,26,15,1606,1705,3311,3280
0130-001,2017,7,26,16,1583,1684,3267,3311
0130-001,2017,7,26,17,1561,1868,3429,3267
0130-001,2017,7,26,18,1714,2274,3988,3429
0130-001,2017,7,26,19,1575,2410,3985,3988
0130-001,2017,7,26,20,1352,1945,3297,3985
0130-001,2017,7,26,21,1310,1574,2884,3297
0130-001,2017,7,26,22,1213,1292,2505,2884
0130-001,2017,7,26,23,956,808,1764,2505
0130-001,2017,7,26,24,561,589,1150,1764
0130-001,2017,7,27,1,426,382,808,1150
0130-001,2017,7,27,2,263,255,518,808
0130-001,2017,7,27,3,206,189,395,518
0130-001,2017,7,27,4,165,211,376,395
0130-001,2017,7,27,5,220,254,474,376
0130-001,2017,7,27,6,676,480,1156,474
0130-001,2017,7,27,7,1610,945,2555,1156
0130-001,2017,7,27,8,1568,1504,3072,2555
0130-001,2017,7,27,9,1562,1833,3395,3072
0130-001,2017,7,27,10,1519,1624,3143,3395
0130-001,2017,7,27,11,1566,1665,3231,3143
0130-001,2017,7,27,12,1577,1694,3271,3231
0130-001,2017,7,27,13,1460,1494,2954,3271
0130-001,2017,7,27,14,1623,1644,3267,2954
0130-001,2017,7,27,15,1573,1605,3178,3267
0130-001,2017,7,27,16,1614,1713,3327,3178
0130-001,2017,7,27,17,1545,1913,3458,3327
0130-001,2017,7,27,18,1681,2236,3917,3458
0130-001,2017,7,27,19,1597,2379,3976,3917
0130-001,2017,7,27,20,1391,1823,3214,3976
0130-001,2017,7,27,21,1172,1670,2842,3214
0130-001,2017,7,27,22,1178,1353,2531,2842
0130-001,2017,7,27,23,818,869,1687,2531
0130-001,2017,7,27,24,592,538,1130,1687
0130-001,2017,7,28,1,401,374,775,1130
0130-001,2017,7,28,2,254,257,511,775
0130-001,2017,7,28,3,201,218,419,511
0130-001,2017,7,28,4,143,210,353,419
0130-001,2017,7,28,5,232,252,484,353
0130-001,2017,7,28,6,600,468,1068,484
0130-001,2017,7,28,7,1531,936,2467,1068
0130-001,2017,7,28,8,1628,1471,3099,2467
0130-001,2017,7,28,9,1565,1835,3400,3099
0130-001,2017,7,28,10,1596,1632,3228,3400
0130-001,2017,7,28,11,1514,1666,3180,3228
0130-001,2017,7,28,12,1500,1605,3105,3180
0130-001,2017,7,28,13,1508,1558,3066,3105
0130-001,2017,7,28,14,1537,1722,3259,3066
0130-001,2017,7,28,15,1547,1717,3264,3259
0130-001,2017,7,28,16,1549,1785,3334,3264
0130-001,2017,7,28,17,1584,1859,3443,3334
0130-001,2017,7,28,18,1652,2090,3742,3443
0130-001,2017,7,28,19,1580,2043,3623,3742
0130-001,2017,7,28,20,1350,2177,3527,3623
0130-001,2017,7,28,21,1218,1653,2871,3527
0130-001,2017,7,28,22,1258,1240,2498,2871
0130-001,2017,7,28,23,903,801,1704,2498
0130-001,2017,7,28,24,667,569,1236,1704
0130-001,2017,7,29,1,387,370,757,1236
0130-001,2017,7,29,2,326,299,625,757
0130-001,2017,7,29,3,268,238,506,625
0130-001,2017,7,29,4,201,261,462,506
0130-001,2017,7,29,5,245,252,497,462
0130-001,2017,7,29,6,569,415,984,497
0130-001,2017,7,29,7,1073,770,1843,984
0130-001,2017,7,29,8,1187,1106,2293,1843
0130-001,2017,7,29,9,1342,1511,2853,2293
0130-001,2017,7,29,10,1448,1725,3173,2853
0130-001,2017,7,29,11,1506,2004,3510,3173
0130-001,2017,7,29,12,1611,1887,3498,3510
0130-001,2017,7,29,13,1455,1876,3331,3498
0130-001,2017,7,29,14,1608,1902,3510,3331
0130-001,2017,7,29,15,1596,1784,3380,3510
0130-001,2017,7,29,16,1768,1814,3582,3380
0130-001,2017,7,29,17,1552,1805,3357,3582
0130-001,2017,7,29,18,1575,1837,3412,3357
0130-001,2017,7,29,19,1505,1746,3251,3412
0130-001,2017,7,29,20,1217,1300,2517,3251
0130-001,2017,7,29,21,1146,1114,2260,2517
0130-001,2017,7,29,22,1141,910,2051,2260
0130-001,2017,7,29,23,777,649,1426,2051
0130-001,2017,7,29,24,530,507,1037,1426
0130-001,2017,7,30,1,393,376,769,1037
0130-001,2017,7,30,2,272,256,528,769
0130-001,2017,7,30,3,226,204,430,528
0130-001,2017,7,30,4,181,176,357,430
0130-001,2017,7,30,5,203,164,367,357
0130-001,2017,7,30,6,400,289,689,367
0130-001,2017,7,30,7,650,466,1116,689
0130-001,2017,7,30,8,756,673,1429,1116
0130-001,2017,7,30,9,816,971,1787,1429
0130-001,2017,7,30,10,919,1058,1977,1787
0130-001,2017,7,30,11,1139,1306,2445,1977
0130-001,2017,7,30,12,1099,1342,2441,2445
0130-001,2017,7,30,13,1165,1403,2568,2441
0130-001,2017,7,30,14,1320,1443,2763,2568
0130-001,2017,7,30,15,1312,1432,2744,2763
0130-001,2017,7,30,16,1391,1437,2828,2744
0130-001,2017,7,30,17,1534,1428,2962,2828
0130-001,2017,7,30,18,1491,1431,2922,2962
0130-001,2017,7,30,19,1461,1334,2795,2922
0130-001,2017,7,30,20,1356,1131,2487,2795
0130-001,2017,7,30,21,1169,1038,2207,2487
0130-001,2017,7,30,22,1002,883,1885,2207
0130-001,2017,7,30,23,728,630,1358,1885
0130-001,2017,7,30,24,463,424,887,1358
0130-001,2017,7,31,1,277,274,551,887
0130-001,2017,7,31,2,184,186,370,551
0130-001,2017,7,31,3,137,117,254,370
0130-001,2017,7,31,4,144,186,330,254
0130-001,2017,7,31,5,199,197,396,330
0130-001,2017,7,31,6,602,416,1018,396
0130-001,2017,7,31,7,1265,862,2127,1018
0130-001,2017,7,31,8,1493,1330,2823,2127
0130-001,2017,7,31,9,1461,1723,3184,2823
0130-001,2017,7,31,10,1403,1431,2834,3184
0130-001,2017,7,31,11,1289,1506,2795,2834
0130-001,2017,7,31,12,1350,1580,2930,2795
0130-001,2017,7,31,13,1349,1535,2884,2930
0130-001,2017,7,31,14,1557,1654,3211,2884
0130-001,2017,7,31,15,1498,1654,3152,3211
0130-001,2017,7,31,16,1586,1672,3258,3152
0130-001,2017,7,31,17,1557,1636,3193,3258
0130-001,2017,7,31,18,1623,1806,3429,3193
0130-001,2017,7,31,19,1337,1662,2999,3429
0130-001,2017,7,31,20,1264,1645,2909,2999
0130-001,2017,7,31,21,1072,1214,2286,2909
0130-001,2017,7,31,22,885,926,1811,2286
0130-001,2017,7,31,23,666,655,1321,1811
0130-001,2017,7,31,24,491,448,939,1321
0130-001,2017,8,1,1,320,283,603,939
0130-001,2017,8,1,2,195,220,415,603
0130-001,2017,8,1,3,176,161,337,415
0130-001,2017,8,1,4,152,191,343,337
0130-001,2017,8,1,5,178,197,375,343
0130-001,2017,8,1,6,465,385,850,375
0130-001,2017,8,1,7,1119,783,1902,850
0130-001,2017,8,1,8,1413,1234,2647,1902
0130-001,2017,8,1,9,1434,1644,3078,2647
0130-001,2017,8,1,10,1440,1383,2823,3078
0130-001,2017,8,1,11,1606,1603,3209,2823
0130-001,2017,8,1,12,1572,1658,3230,3209
0130-001,2017,8,1,13,1412,1486,2898,3230
0130-001,2017,8,1,14,1667,1639,3306,2898
0130-001,2017,8,1,15,1594,1686,3280,3306
0130-001,2017,8,1,16,1690,1581,3271,3280
0130-001,2017,8,1,17,1574,1658,3232,3271
0130-001,2017,8,1,18,1685,2047,3732,3232
0130-001,2017,8,1,19,1611,2240,3851,3732
0130-001,2017,8,1,20,1362,1667,3029,3851
0130-001,2017,8,1,21,1245,1449,2694,3029
0130-001,2017,8,1,22,1078,1135,2213,2694
0130-001,2017,8,1,23,755,758,1513,2213
0130-001,2017,8,1,24,542,465,1007,1513
0130-001,2017,8,2,1,397,338,735,1007
0130-001,2017,8,2,2,248,254,502,735
0130-001,2017,8,2,3,163,169,332,502
0130-001,2017,8,2,4,145,200,345,332
0130-001,2017,8,2,5,198,205,403,345
0130-001,2017,8,2,6,592,453,1045,403
0130-001,2017,8,2,7,1281,819,2100,1045
0130-001,2017,8,2,8,1369,1198,2567,2100
0130-001,2017,8,2,9,1632,1629,3261,2567
0130-001,2017,8,2,10,1437,1514,2951,3261
0130-001,2017,8,2,11,1568,1554,3122,2951
0130-001,2017,8,2,12,1537,1613,3150,3122
0130-001,2017,8,2,13,1400,1543,2943,3150
0130-001,2017,8,2,14,1629,1623,3252,2943
0130-001,2017,8,2,15,1523,1626,3149,3252
0130-001,2017,8,2,16,1631,1620,3251,3149
0130-001,2017,8,2,17,1532,1778,3310,3251
0130-001,2017,8,2,18,1560,2122,3682,3310
0130-001,2017,8,2,19,1650,2160,3810,3682
0130-001,2017,8,2,20,1232,1554,2786,3810
0130-001,2017,8,2,21,1138,1352,2490,2786
0130-001,2017,8,2,22,1036,1007,2043,2490
0130-001,2017,8,2,23,840,688,1528,2043
0130-001,2017,8,2,24,567,522,1089,1528
0130-001,2017,8,3,1,383,315,698,1089
0130-001,2017,8,3,2,245,225,470,698
0130-001,2017,8,3,3,196,156,352,470
0130-001,2017,8,3,4,143,196,339,352
0130-001,2017,8,3,5,226,220,446,339
0130-001,2017,8,3,6,617,439,1056,446
0130-001,2017,8,3,7,1292,820,2112,1056
0130-001,2017,8,3,8,1550,1247,2797,2112
0130-001,2017,8,3,9,1635,1591,3226,2797
0130-001,2017,8,3,10,1494,1497,2991,3226
0130-001,2017,8,3,11,1537,1524,3061,2991
0130-001,2017,8,3,12,1522,1693,3215,3061
0130-001,2017,8,3,13,1366,1556,2922,3215
0130-001,2017,8,3,14,1529,1570,3099,2922
0130-001,2017,8,3,15,1599,1588,3187,3099
0130-001,2017,8,3,16,1475,1624,3099,3187
0130-001,2017,8,3,17,1562,1719,3281,3099
0130-001,2017,8,3,18,1604,2078,3682,3281
0130-001,2017,8,3,19,1603,2143,3746,3682
0130-001,2017,8,3,20,1241,1646,2887,3746
0130-001,2017,8,3,21,1186,1456,2642,2887
0130-001,2017,8,3,22,1021,1052,2073,2642
0130-001,2017,8,3,23,782,743,1525,2073
0130-001,2017,8,3,24,531,495,1026,1525
0130-001,2017,8,4,1,353,346,699,1026
0130-001,2017,8,4,2,253,213,466,699
0130-001,2017,8,4,3,192,147,339,466
0130-001,2017,8,4,4,138,217,355,339
0130-001,2017,8,4,5,194,197,391,355
0130-001,2017,8,4,6,634,441,1075,391
0130-001,2017,8,4,7,1305,792,2097,1075
0130-001,2017,8,4,8,1571,1228,2799,2097
0130-001,2017,8,4,9,1696,1581,3277,2799
0130-001,2017,8,4,10,1588,1510,3098,3277
0130-001,2017,8,4,11,1457,1553,3010,3098
0130-001,2017,8,4,12,1494,1611,3105,3010
0130-001,2017,8,4,13,1427,1592,3019,3105
0130-001,2017,8,4,14,1551,1699,3250,3019
0130-001,2017,8,4,15,1610,1717,3327,3250
0130-001,2017,8,4,16,1585,1717,3302,3327
0130-001,2017,8,4,17,1620,1792,3412,3302
0130-001,2017,8,4,18,1568,2072,3640,3412
0130-001,2017,8,4,19,1644,2209,3853,3640
0130-001,2017,8,4,20,1306,1683,2989,3853
0130-001,2017,8,4,21,1185,1465,2650,2989
0130-001,2017,8,4,22,1141,1153,2294,2650
0130-001,2017,8,4,23,821,743,1564,2294
0130-001,2017,8,4,24,551,525,1076,1564
0130-001,2017,8,5,1,410,351,761,1076
0130-001,2017,8,5,2,330,265,595,761
0130-001,2017,8,5,3,256,208,464,595
0130-001,2017,8,5,4,192,185,377,464
0130-001,2017,8,5,5,256,194,450,377
0130-001,2017,8,5,6,542,365,907,450
0130-001,2017,8,5,7,1039,682,1721,907
0130-001,2017,8,5,8,1129,923,2052,1721
0130-001,2017,8,5,9,1290,1250,2540,2052
0130-001,2017,8,5,10,1381,1479,2860,2540
0130-001,2017,8,5,11,1435,1655,3090,2860
0130-001,2017,8,5,12,1402,1718,3120,3090
0130-001,2017,8,5,13,1410,1608,3018,3120
0130-001,2017,8,5,14,1511,1717,3228,3018
0130-001,2017,8,5,15,1571,1695,3266,3228
0130-001,2017,8,5,16,1478,1690,3168,3266
0130-001,2017,8,5,17,1474,1657,3131,3168
0130-001,2017,8,5,18,1672,1787,3459,3131
0130-001,2017,8,5,19,1513,1635,3148,3459
0130-001,2017,8,5,20,1309,1358,2667,3148
0130-001,2017,8,5,21,1197,1104,2301,2667
0130-001,2017,8,5,22,1152,895,2047,2301
0130-001,2017,8,5,23,774,692,1466,2047
0130-001,2017,8,5,24,537,502,1039,1466
0130-001,2017,8,6,1,379,324,703,1039
0130-001,2017,8,6,2,291,271,562,703
0130-001,2017,8,6,3,234,188,422,562
0130-001,2017,8,6,4,173,153,326,422
0130-001,2017,8,6,5,219,149,368,326
0130-001,2017,8,6,6,382,250,632,368
0130-001,2017,8,6,7,636,438,1074,632
0130-001,2017,8,6,8,716,560,1276,1074
0130-001,2017,8,6,9,753,805,1558,1276
0130-001,2017,8,6,10,926,1045,1971,1558
0130-001,2017,8,6,11,1070,1240,2310,1971
0130-001,2017,8,6,12,1086,1311,2397,2310
0130-001,2017,8,6,13,1198,1380,2578,2397
0130-001,2017,8,6,14,1319,1413,2732,2578
0130-001,2017,8,6,15,1355,1341,2696,2732
0130-001,2017,8,6,16,1441,1467,2908,2696
0130-001,2017,8,6,17,1489,1342,2831,2908
0130-001,2017,8,6,18,1520,1430,2950,2831
0130-001,2017,8,6,19,1578,1257,2835,2950
0130-001,2017,8,6,20,1465,1166,2631,2835
0130-001,2017,8,6,21,1228,1074,2302,2631
0130-001,2017,8,6,22,943,903,1846,2302
0130-001,2017,8,6,23,726,601,1327,1846
0130-001,2017,8,6,24,477,440,917,1327
0130-001,2017,8,7,1,320,304,624,917
0130-001,2017,8,7,2,217,153,370,624
0130-001,2017,8,7,3,124,139,263,370
0130-001,2017,8,7,4,132,161,293,263
0130-001,2017,8,7,5,222,204,426,293
0130-001,2017,8,7,6,650,432,1082,426
0130-001,2017,8,7,7,1643,913,2556,1082
0130-001,2017,8,7,8,1560,1432,2992,2556
0130-001,2017,8,7,9,1635,1652,3287,2992
0130-001,2017,8,7,10,1508,1508,3016,3287
0130-001,2017,8,7,11,1481,1494,2975,3016
0130-001,2017,8,7,12,1500,1505,3005,2975
0130-001,2017,8,7,13,1391,1469,2860,3005
0130-001,2017,8,7,14,1537,1605,3142,2860
0130-001,2017,8,7,15,1519,1587,3106,3142
0130-001,2017,8,7,16,1615,1654,3269,3106
0130-001,2017,8,7,17,1537,1736,3273,3269
0130-001,2017,8,7,18,1585,2064,3649,3273
0130-001,2017,8,7,19,1563,2306,3869,3649
0130-001,2017,8,7,20,1336,1744,3080,3869
0130-001,2017,8,7,21,1185,1688,2873,3080
0130-001,2017,8,7,22,998,1148,2146,2873
0130-001,2017,8,7,23,738,732,1470,2146
0130-001,2017,8,7,24,525,419,944,1470
0130-001,2017,8,8,1,325,249,574,944
0130-001,2017,8,8,2,215,207,422,574
0130-001,2017,8,8,3,142,189,331,422
0130-001,2017,8,8,4,139,179,318,331
0130-001,2017,8,8,5,225,221,446,318
0130-001,2017,8,8,6,595,441,1036,446
0130-001,2017,8,8,7,1457,823,2280,1036
0130-001,2017,8,8,8,1617,1392,3009,2280
0130-001,2017,8,8,9,1568,1731,3299,3009
0130-001,2017,8,8,10,1538,1528,3066,3299
0130-001,2017,8,8,11,1599,1560,3159,3066
0130-001,2017,8,8,12,1481,1544,3025,3159
0130-001,2017,8,8,13,1389,1395,2784,3025
0130-001,2017,8,8,14,1630,1533,3163,2784
0130-001,2017,8,8,15,1547,1593,3140,3163
0130-001,2017,8,8,16,1520,1585,3105,3140
0130-001,2017,8,8,17,1515,1827,3342,3105
0130-001,2017,8,8,18,1622,2035,3657,3342
0130-001,2017,8,8,19,1612,2151,3763,3657
0130-001,2017,8,8,20,1310,1761,3071,3763
0130-001,2017,8,8,21,1199,1719,2918,3071
0130-001,2017,8,8,22,969,1217,2186,2918
0130-001,2017,8,8,23,770,734,1504,2186
0130-001,2017,8,8,24,522,427,949,1504
0130-001,2017,8,9,1,348,318,666,949
0130-001,2017,8,9,2,251,196,447,666
0130-001,2017,8,9,3,141,172,313,447
0130-001,2017,8,9,4,171,202,373,313
0130-001,2017,8,9,5,214,197,411,373
0130-001,2017,8,9,6,594,404,998,411
0130-001,2017,8,9,7,1464,855,2319,998
0130-001,2017,8,9,8,1545,1338,2883,2319
0130-001,2017,8,9,9,1511,1738,3249,2883
0130-001,2017,8,9,10,1501,1525,3026,3249
0130-001,2017,8,9,11,1549,1477,3026,3026
0130-001,2017,8,9,12,1494,1495,2989,3026
0130-001,2017,8,9,13,1327,1397,2724,2989
0130-001,2017,8,9,14,1568,1516,3084,2724
0130-001,2017,8,9,15,1567,1549,3116,3084
0130-001,2017,8,9,16,1504,1584,3088,3116
0130-001,2017,8,9,17,1497,1818,3315,3088
0130-001,2017,8,9,18,1620,2123,3743,3315
0130-001,2017,8,9,19,1518,2269,3787,3743
0130-001,2017,8,9,20,1284,1705,2989,3787
0130-001,2017,8,9,21,1115,1448,2563,2989
0130-001,2017,8,9,22,1028,1164,2192,2563
0130-001,2017,8,9,23,745,699,1444,2192
0130-001,2017,8,9,24,537,437,974,1444
0130-001,2017,8,10,1,351,319,670,974
0130-001,2017,8,10,2,240,211,451,670
0130-001,2017,8,10,3,181,180,361,451
0130-001,2017,8,10,4,148,198,346,361
0130-001,2017,8,10,5,230,194,424,346
0130-001,2017,8,10,6,558,438,996,424
0130-001,2017,8,10,7,1475,832,2307,996
0130-001,2017,8,10,8,1453,1349,2802,2307
0130-001,2017,8,10,9,1529,1637,3166,2802
0130-001,2017,8,10,10,1514,1440,2954,3166
0130-001,2017,8,10,11,1447,1400,2847,2954
0130-001,2017,8,10,12,1458,1511,2969,2847
0130-001,2017,8,10,13,1403,1484,2887,2969
0130-001,2017,8,10,14,1554,1561,3115,2887
0130-001,2017,8,10,15,1633,1584,3217,3115
0130-001,2017,8,10,16,1498,1554,3052,3217
0130-001,2017,8,10,17,1480,1778,3258,3052
0130-001,2017,8,10,18,1642,2013,3655,3258
0130-001,2017,8,10,19,1531,2224,3755,3655
0130-001,2017,8,10,20,1257,1749,3006,3755
0130-001,2017,8,10,21,1192,1663,2855,3006
0130-001,2017,8,10,22,1097,1256,2353,2855
0130-001,2017,8,10,23,808,772,1580,2353
0130-001,2017,8,10,24,583,508,1091,1580
0130-001,2017,8,11,1,394,343,737,1091
0130-001,2017,8,11,2,262,227,489,737
0130-001,2017,8,11,3,182,172,354,489
0130-001,2017,8,11,4,169,200,369,354
0130-001,2017,8,11,5,222,224,446,369
0130-001,2017,8,11,6,685,436,1121,446
0130-001,2017,8,11,7,1557,902,2459,1121
0130-001,2017,8,11,8,1615,1392,3007,2459
0130-001,2017,8,11,9,1586,1705,3291,3007
0130-001,2017,8,11,10,1555,1556,3111,3291
0130-001,2017,8,11,11,1569,1512,3081,3111
0130-001,2017,8,11,12,1536,1529,3065,3081
0130-001,2017,8,11,13,1434,1635,3069,3065
0130-001,2017,8,11,14,1579,1593,3172,3069
0130-001,2017,8,11,15,1555,1701,3256,3172
0130-001,2017,8,11,16,1689,1741,3430,3256
0130-001,2017,8,11,17,1522,1758,3280,3430
0130-001,2017,8,11,18,1539,2081,3620,3280
0130-001,2017,8,11,19,1610,2169,3779,3620
0130-001,2017,8,11,20,1470,2089,3559,3779
0130-001,2017,8,11,21,1319,1693,3012,3559
0130-001,2017,8,11,22,1272,1261,2533,3012
0130-001,2017,8,11,23,887,805,1692,2533
0130-001,2017,8,11,24,648,584,1232,1692
0130-001,2017,8,12,1,440,422,862,1232
0130-001,2017,8,12,2,306,276,582,862
0130-001,2017,8,12,3,273,252,525,582
0130-001,2017,8,12,4,196,230,426,525
0130-001,2017,8,12,5,258,241,499,426
0130-001,2017,8,12,6,561,415,976,499
0130-001,2017,8,12,7,1184,736,1920,976
0130-001,2017,8,12,8,1377,1051,2428,1920
0130-001,2017,8,12,9,1390,1330,2720,2428
0130-001,2017,8,12,10,1410,1535,2945,2720
0130-001,2017,8,12,11,1492,1793,3285,2945
0130-001,2017,8,12,12,1492,1859,3351,3285
0130-001,2017,8,12,13,1495,2042,3537,3351
0130-001,2017,8,12,14,1499,1909,3408,3537
0130-001,2017,8,12,15,1570,1774,3344,3408
0130-001,2017,8,12,16,1476,1734,3210,3344
0130-001,2017,8,12,17,1665,1799,3464,3210
0130-001,2017,8,12,18,1659,1892,3551,3464
0130-001,2017,8,12,19,1467,1835,3302,3551
0130-001,2017,8,12,20,1308,1301,2609,3302
0130-001,2017,8,12,21,1162,1161,2323,2609
0130-001,2017,8,12,22,1096,864,1960,2323
0130-001,2017,8,12,23,780,628,1408,1960
0130-001,2017,8,12,24,530,465,995,1408
0130-001,2017,8,13,1,394,332,726,995
0130-001,2017,8,13,2,335,268,603,726
0130-001,2017,8,13,3,248,195,443,603
0130-001,2017,8,13,4,200,159,359,443
0130-001,2017,8,13,5,207,162,369,359
0130-001,2017,8,13,6,413,280,693,369
0130-001,2017,8,13,7,666,466,1132,693
0130-001,2017,8,13,8,739,648,1387,1132
0130-001,2017,8,13,9,854,871,1725,1387
0130-001,2017,8,13,10,1017,958,1975,1725
0130-001,2017,8,13,11,1156,1218,2374,1975
0130-001,2017,8,13,12,1110,1136,2246,2374
0130-001,2017,8,13,13,1176,1207,2383,2246
0130-001,2017,8,13,14,1270,1266,2536,2383
0130-001,2017,8,13,15,1343,1372,2715,2536
0130-001,2017,8,13,16,1352,1410,2762,2715
0130-001,2017,8,13,17,1363,1306,2669,2762
0130-001,2017,8,13,18,1338,1337,2675,2669
0130-001,2017,8,13,19,1327,1239,2566,2675
0130-001,2017,8,13,20,1312,1112,2424,2566
0130-001,2017,8,13,21,1082,933,2015,2424
0130-001,2017,8,13,22,902,794,1696,2015
0130-001,2017,8,13,23,727,577,1304,1696
0130-001,2017,8,13,24,470,397,867,1304
0130-001,2017,8,14,1,296,264,560,867
0130-001,2017,8,14,2,202,177,379,560
0130-001,2017,8,14,3,147,113,260,379
0130-001,2017,8,14,4,140,170,310,260
0130-001,2017,8,14,5,216,195,411,310
0130-001,2017,8,14,6,649,393,1042,411
0130-001,2017,8,14,7,1431,825,2256,1042
0130-001,2017,8,14,8,1616,1296,2912,2256
0130-001,2017,8,14,9,1441,1506,2947,2912
0130-001,2017,8,14,10,1489,1416,2905,2947
0130-001,2017,8,14,11,1247,1253,2500,2905
0130-001,2017,8,14,12,1123,1265,2388,2500
0130-001,2017,8,14,13,1153,1306,2459,2388
0130-001,2017,8,14,14,1291,1349,2640,2459
0130-001,2017,8,14,15,1132,1317,2449,2640
0130-001,2017,8,14,16,1562,1603,3165,2449
0130-001,2017,8,14,17,1536,1707,3243,3165
0130-001,2017,8,14,18,1699,1904,3603,3243
0130-001,2017,8,14,19,1612,2096,3708,3603
0130-001,2017,8,14,20,1202,1650,2852,3708
0130-001,2017,8,14,21,1030,1345,2375,2852
0130-001,2017,8,14,22,754,952,1706,2375
0130-001,2017,8,14,23,587,584,1171,1706
0130-001,2017,8,14,24,420,450,870,1171
0130-001,2017,8,15,1,357,350,707,870
0130-001,2017,8,15,2,227,231,458,707
0130-001,2017,8,15,3,149,181,330,458
0130-001,2017,8,15,4,169,198,367,330
0130-001,2017,8,15,5,188,182,370,367
0130-001,2017,8,15,6,434,331,765,370
0130-001,2017,8,15,7,941,590,1531,765
0130-001,2017,8,15,8,1150,798,1948,1531
0130-001,2017,8,15,9,1076,1010,2086,1948
0130-001,2017,8,15,10,1122,1120,2242,2086
0130-001,2017,8,15,11,1137,1268,2405,2242
0130-001,2017,8,15,12,1024,1296,2320,2405
0130-001,2017,8,15,13,1298,1350,2648,2320
0130-001,2017,8,15,14,1318,1475,2793,2648
0130-001,2017,8,15,15,1258,1384,2642,2793
0130-001,2017,8,15,16,1410,1502,2912,2642
0130-001,2017,8,15,17,1436,1402,2838,2912
0130-001,2017,8,15,18,1404,1486,2890,2838
0130-001,2017,8,15,19,1285,1456,2741,2890
0130-001,2017,8,15,20,1170,1166,2336,2741
0130-001,2017,8,15,21,1061,994,2055,2336
0130-001,2017,8,15,22,877,741,1618,2055
0130-001,2017,8,15,23,635,510,1145,1618
0130-001,2017,8,15,24,500,365,865,1145
0130-001,2017,8,16,1,263,249,512,865
0130-001,2017,8,16,2,177,169,346,512
0130-001,2017,8,16,3,129,113,242,346
0130-001,2017,8,16,4,135,153,288,242
0130-001,2017,8,16,5,205,190,395,288
0130-001,2017,8,16,6,585,415,1000,395
0130-001,2017,8,16,7,1548,825,2373,1000
0130-001,2017,8,16,8,1707,1447,3154,2373
0130-001,2017,8,16,9,1505,1690,3195,3154
0130-001,2017,8,16,10,1503,1486,2989,3195
0130-001,2017,8,16,11,1593,1441,3034,2989
0130-001,2017,8,16,12,1519,1503,3022,3034
0130-001,2017,8,16,13,1414,1371,2785,3022
0130-001,2017,8,16,14,1615,1531,3146,2785
0130-001,2017,8,16,15,1514,1538,3052,3146
0130-001,2017,8,16,16,1617,1606,3223,3052
0130-001,2017,8,16,17,1499,1677,3176,3223
0130-001,2017,8,16,18,1650,2048,3698,3176
0130-001,2017,8,16,19,1533,2297,3830,3698
0130-001,2017,8,16,20,1366,1802,3168,3830
0130-001,2017,8,16,21,1105,1507,2612,3168
0130-001,2017,8,16,22,1090,1100,2190,2612
0130-001,2017,8,16,23,806,741,1547,2190
0130-001,2017,8,16,24,479,462,941,1547
0130-001,2017,8,17,1,302,300,602,941
0130-001,2017,8,17,2,191,198,389,602
0130-001,2017,8,17,3,167,177,344,389
0130-001,2017,8,17,4,152,168,320,344
0130-001,2017,8,17,5,204,242,446,320
0130-001,2017,8,17,6,567,418,985,446
0130-001,2017,8,17,7,1603,848,2451,985
0130-001,2017,8,17,8,1642,1450,3092,2451
0130-001,2017,8,17,9,1621,1713,3334,3092
0130-001,2017,8,17,10,1511,1488,2999,3334
0130-001,2017,8,17,11,1602,1543,3145,2999
0130-001,2017,8,17,12,1504,1531,3035,3145
0130-001,2017,8,17,13,1357,1477,2834,3035
0130-001,2017,8,17,14,1586,1587,3173,2834
0130-001,2017,8,17,15,1482,1559,3041,3173
0130-001,2017,8,17,16,1561,1603,3164,3041
0130-001,2017,8,17,17,1489,1766,3255,3164
0130-001,2017,8,17,18,1573,2091,3664,3255
0130-001,2017,8,17,19,1556,2155,3711,3664
0130-001,2017,8,17,20,1218,1762,2980,3711
0130-001,2017,8,17,21,1156,1687,2843,2980
0130-001,2017,8,17,22,1093,1259,2352,2843
0130-001,2017,8,17,23,773,770,1543,2352
0130-001,2017,8,17,24,563,502,1065,1543
0130-001,2017,8,18,1,363,346,709,1065
0130-001,2017,8,18,2,242,222,464,709
0130-001,2017,8,18,3,179,174,353,464
0130-001,2017,8,18,4,144,189,333,353
0130-001,2017,8,18,5,238,232,470,333
0130-001,2017,8,18,6,600,446,1046,470
0130-001,2017,8,18,7,1640,871,2511,1046
0130-001,2017,8,18,8,1640,1529,3169,2511
0130-001,2017,8,18,9,1663,1710,3373,3169
0130-001,2017,8,18,10,1545,1541,3086,3373
0130-001,2017,8,18,11,1534,1525,3059,3086
0130-001,2017,8,18,12,1465,1533,2998,3059
0130-001,2017,8,18,13,1380,1507,2887,2998
0130-001,2017,8,18,14,1560,1589,3149,2887
0130-001,2017,8,18,15,1589,1589,3178,3149
0130-001,2017,8,18,16,1579,1654,3233,3178
0130-001,2017,8,18,17,1477,1807,3284,3233
0130-001,2017,8,18,18,1439,2126,3565,3284
0130-001,2017,8,18,19,1488,2165,3653,3565
0130-001,2017,8,18,20,1434,1979,3413,3653
0130-001,2017,8,18,21,1311,1687,2998,3413
0130-001,2017,8,18,22,1235,1285,2520,2998
0130-001,2017,8,18,23,895,822,1717,2520
0130-001,2017,8,18,24,615,545,1160,1717
0130-001,2017,8,19,1,466,382,848,1160
0130-001,2017,8,19,2,353,295,648,848
0130-001,2017,8,19,3,268,244,512,648
0130-001,2017,8,19,4,242,253,495,512
0130-001,2017,8,19,5,248,261,509,495
0130-001,2017,8,19,6,637,410,1047,509
0130-001,2017,8,19,7,1217,776,1993,1047
0130-001,2017,8,19,8,1416,1018,2434,1993
0130-001,2017,8,19,9,1337,1327,2664,2434
0130-001,2017,8,19,10,1437,1428,2865,2664
0130-001,2017,8,19,11,1451,1615,3066,2865
0130-001,2017,8,19,12,1512,1654,3166,3066
0130-001,2017,8,19,13,1436,1679,3115,3166
0130-001,2017,8,19,14,1535,1711,3246,3115
0130-001,2017,8,19,15,1573,1596,3169,3246
0130-001,2017,8,19,16,1619,1825,3444,3169
0130-001,2017,8,19,17,1634,1866,3500,3444
0130-001,2017,8,19,18,1665,1926,3591,3500
0130-001,2017,8,19,19,1494,1768,3262,3591
0130-001,2017,8,19,20,1319,1330,2649,3262
0130-001,2017,8,19,21,1176,1084,2260,2649
0130-001,2017,8,19,22,1125,846,1971,2260
0130-001,2017,8,19,23,797,626,1423,1971
0130-001,2017,8,19,24,491,487,978,1423
0130-001,2017,8,20,1,410,310,720,978
0130-001,2017,8,20,2,301,248,549,720
0130-001,2017,8,20,3,255,206,461,549
0130-001,2017,8,20,4,156,131,287,461
0130-001,2017,8,20,5,195,153,348,287
0130-001,2017,8,20,6,316,234,550,348
0130-001,2017,8,20,7,433,369,802,550
0130-001,2017,8,20,8,472,462,934,802
0130-001,2017,8,20,9,667,720,1387,934
0130-001,2017,8,20,10,803,939,1742,1387
0130-001,2017,8,20,11,1037,1199,2236,1742
0130-001,2017,8,20,12,1056,1254,2310,2236
0130-001,2017,8,20,13,1243,1336,2579,2310
0130-001,2017,8,20,14,1462,1466,2928,2579
0130-001,2017,8,20,15,1476,1470,2946,2928
0130-001,2017,8,20,16,1526,1435,2961,2946
0130-001,2017,8,20,17,1403,1447,2850,2961
0130-001,2017,8,20,18,1285,1241,2526,2850
0130-001,2017,8,20,19,1429,1280,2709,2526
0130-001,2017,8,20,20,1144,945,2089,2709
0130-001,2017,8,20,21,990,817,1807,2089
0130-001,2017,8,20,22,876,703,1579,1807
0130-001,2017,8,20,23,653,534,1187,1579
0130-001,2017,8,20,24,395,350,745,1187
0130-001,2017,8,21,1,254,196,450,745
0130-001,2017,8,21,2,158,156,314,450
0130-001,2017,8,21,3,105,102,207,314
0130-001,2017,8,21,4,106,119,225,207
0130-001,2017,8,21,5,189,175,364,225
0130-001,2017,8,21,6,552,387,939,364
0130-001,2017,8,21,7,1705,937,2642,939
0130-001,2017,8,21,8,1495,1429,2924,2642
0130-001,2017,8,21,9,1600,1704,3304,2924
0130-001,2017,8,21,10,1480,1410,2890,3304
0130-001,2017,8,21,11,1510,1415,2925,2890
0130-001,2017,8,21,12,1507,1667,3174,2925
0130-001,2017,8,21,13,1275,1627,2902,3174
0130-001,2017,8,21,14,1571,1506,3077,2902
0130-001,2017,8,21,15,1414,1449,2863,3077
0130-001,2017,8,21,16,1466,1604,3070,2863
0130-001,2017,8,21,17,1436,1672,3108,3070
0130-001,2017,8,21,18,1419,1898,3317,3108
0130-001,2017,8,21,19,1492,2050,3542,3317
0130-001,2017,8,21,20,1233,1744,2977,3542
0130-001,2017,8,21,21,1084,1582,2666,2977
0130-001,2017,8,21,22,937,1126,2063,2666
0130-001,2017,8,21,23,734,697,1431,2063
0130-001,2017,8,21,24,485,418,903,1431
0130-001,2017,8,22,1,308,300,608,903
0130-001,2017,8,22,2,236,180,416,608
0130-001,2017,8,22,3,136,157,293,416
0130-001,2017,8,22,4,132,198,330,293
0130-001,2017,8,22,5,208,218,426,330
0130-001,2017,8,22,6,666,440,1106,426
0130-001,2017,8,22,7,1686,899,2585,1106
0130-001,2017,8,22,8,1450,1466,2916,2585
0130-001,2017,8,22,9,1693,1789,3482,2916
0130-001,2017,8,22,10,1608,1425,3033,3482
0130-001,2017,8,22,11,1500,1412,2912,3033
0130-001,2017,8,22,12,1541,1478,3019,2912
0130-001,2017,8,22,13,1363,1343,2706,3019
0130-001,2017,8,22,14,1547,1625,3172,2706
0130-001,2017,8,22,15,1577,1590,3167,3172
0130-001,2017,8,22,16,1557,1674,3231,3167
0130-001,2017,8,22,17,1533,1881,3414,3231
0130-001,2017,8,22,18,1528,2148,3676,3414
0130-001,2017,8,22,19,1539,2136,3675,3676
0130-001,2017,8,22,20,1341,1763,3104,3675
0130-001,2017,8,22,21,1184,1719,2903,3104
0130-001,2017,8,22,22,1066,1336,2402,2903
0130-001,2017,8,22,23,843,817,1660,2402
0130-001,2017,8,22,24,534,517,1051,1660
0130-001,2017,8,23,1,386,298,684,1051
0130-001,2017,8,23,2,231,211,442,684
0130-001,2017,8,23,3,166,173,339,442
0130-001,2017,8,23,4,136,194,330,339
0130-001,2017,8,23,5,175,201,376,330
0130-001,2017,8,23,6,549,411,960,376
0130-001,2017,8,23,7,1505,800,2305,960
0130-001,2017,8,23,8,1574,1456,3030,2305
0130-001,2017,8,23,9,1588,1772,3360,3030
0130-001,2017,8,23,10,1542,1517,3059,3360
0130-001,2017,8,23,11,1534,1498,3032,3059
0130-001,2017,8,23,12,1406,1395,2801,3032
0130-001,2017,8,23,13,1382,1426,2808,2801
0130-001,2017,8,23,14,1470,1487,2957,2808
0130-001,2017,8,23,15,1547,1532,3079,2957
0130-001,2017,8,23,16,1562,1526,3088,3079
0130-001,2017,8,23,17,1459,1844,3303,3088
0130-001,2017,8,23,18,1648,2152,3800,3303
0130-001,2017,8,23,19,1584,2238,3822,3800
0130-001,2017,8,23,20,1324,1797,3121,3822
0130-001,2017,8,23,21,1127,1469,2596,3121
0130-001,2017,8,23,22,1040,1136,2176,2596
0130-001,2017,8,23,23,787,718,1505,2176
0130-001,2017,8,23,24,519,445,964,1505
0130-001,2017,8,24,1,394,323,717,964
0130-001,2017,8,24,2,214,204,418,717
0130-001,2017,8,24,3,167,178,345,418
0130-001,2017,8,24,4,144,191,335,345
0130-001,2017,8,24,5,220,229,449,335
0130-001,2017,8,24,6,576,416,992,449
0130-001,2017,8,24,7,1550,818,2368,992
0130-001,2017,8,24,8,1642,1445,3087,2368
0130-001,2017,8,24,9,1559,1808,3367,3087
0130-001,2017,8,24,10,1570,1559,3129,3367
0130-001,2017,8,24,11,1606,1480,3086,3129
0130-001,2017,8,24,12,1451,1444,2895,3086
0130-001,2017,8,24,13,1368,1319,2687,2895
0130-001,2017,8,24,14,1556,1587,3143,2687
0130-001,2017,8,24,15,1527,1494,3021,3143
0130-001,2017,8,24,16,1491,1561,3052,3021
0130-001,2017,8,24,17,1358,1599,2957,3052
0130-001,2017,8,24,18,1596,2002,3598,2957
0130-001,2017,8,24,19,1531,2116,3647,3598
0130-001,2017,8,24,20,1173,1733,2906,3647
0130-001,2017,8,24,21,1083,1534,2617,2906
0130-001,2017,8,24,22,986,1079,2065,2617
0130-001,2017,8,24,23,755,718,1473,2065
0130-001,2017,8,24,24,568,478,1046,1473
0130-001,2017,8,25,1,344,299,643,1046
0130-001,2017,8,25,2,229,175,404,643
0130-001,2017,8,25,3,148,172,320,404
0130-001,2017,8,25,4,157,171,328,320
0130-001,2017,8,25,5,250,232,482,328
0130-001,2017,8,25,6,589,460,1049,482
0130-001,2017,8,25,7,1616,905,2521,1049
0130-001,2017,8,25,8,1680,1502,3182,2521
0130-001,2017,8,25,9,1654,1776,3430,3182
0130-001,2017,8,25,10,1601,1541,3142,3430
0130-001,2017,8,25,11,1477,1514,2991,3142
0130-001,2017,8,25,12,1502,1550,3052,2991
0130-001,2017,8,25,13,1368,1411,2779,3052
0130-001,2017,8,25,14,1558,1561,3119,2779
0130-001,2017,8,25,15,1483,1661,3144,3119
0130-001,2017,8,25,16,1719,1708,3427,3144
0130-001,2017,8,25,17,1619,1876,3495,3427
0130-001,2017,8,25,18,1717,2238,3955,3495
0130-001,2017,8,25,19,1577,2139,3716,3955
0130-001,2017,8,25,20,1483,2005,3488,3716
0130-001,2017,8,25,21,1315,1720,3035,3488
0130-001,2017,8,25,22,1304,1250,2554,3035
0130-001,2017,8,25,23,1025,838,1863,2554
0130-001,2017,8,25,24,649,593,1242,1863
0130-001,2017,8,26,1,546,420,966,1242
0130-001,2017,8,26,2,341,283,624,966
0130-001,2017,8,26,3,290,249,539,624
0130-001,2017,8,26,4,237,240,477,539
0130-001,2017,8,26,5,270,247,517,477
0130-001,2017,8,26,6,596,435,1031,517
0130-001,2017,8,26,7,1274,768,2042,1031
0130-001,2017,8,26,8,1345,1091,2436,2042
0130-001,2017,8,26,9,1375,1387,2762,2436
0130-001,2017,8,26,10,1410,1469,2879,2762
0130-001,2017,8,26,11,1635,1768,3403,2879
0130-001,2017,8,26,12,1650,1629,3279,3403
0130-001,2017,8,26,13,1525,1819,3344,3279
0130-001,2017,8,26,14,1579,1796,3375,3344
0130-001,2017,8,26,15,1651,1657,3308,3375
0130-001,2017,8,26,16,1605,1788,3393,3308
0130-001,2017,8,26,17,1699,1888,3587,3393
0130-001,2017,8,26,18,1816,1950,3766,3587
0130-001,2017,8,26,19,1645,1753,3398,3766
0130-001,2017,8,26,20,1353,1476,2829,3398
0130-001,2017,8,26,21,1206,1208,2414,2829
0130-001,2017,8,26,22,1195,987,2182,2414
0130-001,2017,8,26,23,803,702,1505,2182
0130-001,2017,8,26,24,535,489,1024,1505
0130-001,2017,8,27,1,415,355,770,1024
0130-001,2017,8,27,2,310,273,583,770
0130-001,2017,8,27,3,254,219,473,583
0130-001,2017,8,27,4,202,157,359,473
0130-001,2017,8,27,5,206,159,365,359
0130-001,2017,8,27,6,405,272,677,365
0130-001,2017,8,27,7,734,429,1163,677
0130-001,2017,8,27,8,783,594,1377,1163
0130-001,2017,8,27,9,861,878,1739,1377
0130-001,2017,8,27,10,981,1040,2021,1739
0130-001,2017,8,27,11,1220,1269,2489,2021
0130-001,2017,8,27,12,1138,1300,2438,2489
0130-001,2017,8,27,13,1241,1337,2578,2438
0130-001,2017,8,27,14,1315,1392,2707,2578
0130-001,2017,8,27,15,1473,1493,2966,2707
0130-001,2017,8,27,16,1600,1549,3149,2966
0130-001,2017,8,27,17,1555,1467,3022,3149
0130-001,2017,8,27,18,1580,1483,3063,3022
0130-001,2017,8,27,19,1655,1413,3068,3063
0130-001,2017,8,27,20,1749,1233,2982,3068
0130-001,2017,8,27,21,1466,1030,2496,2982
0130-001,2017,8,27,22,1241,963,2204,2496
0130-001,2017,8,27,23,760,659,1419,2204
0130-001,2017,8,27,24,446,402,848,1419
0130-001,2017,8,28,1,293,287,580,848
0130-001,2017,8,28,2,170,168,338,580
0130-001,2017,8,28,3,140,121,261,338
0130-001,2017,8,28,4,121,167,288,261
0130-001,2017,8,28,5,231,195,426,288
0130-001,2017,8,28,6,670,465,1135,426
0130-001,2017,8,28,7,1788,987,2775,1135
0130-001,2017,8,28,8,1667,1501,3168,2775
0130-001,2017,8,28,9,1595,1760,3355,3168
0130-001,2017,8,28,10,1595,1488,3083,3355
0130-001,2017,8,28,11,1501,1510,3011,3083
0130-001,2017,8,28,12,1493,1586,3079,3011
0130-001,2017,8,28,13,1430,1413,2843,3079
0130-001,2017,8,28,14,1603,1624,3227,2843
0130-001,2017,8,28,15,1595,1585,3180,3227
0130-001,2017,8,28,16,1612,1710,3322,3180
0130-001,2017,8,28,17,1566,1851,3417,3322
0130-001,2017,8,28,18,1596,1929,3525,3417
0130-001,2017,8,28,19,1463,1849,3312,3525
0130-001,2017,8,28,20,1300,1787,3087,3312
0130-001,2017,8,28,21,1082,1515,2597,3087
0130-001,2017,8,28,22,987,1092,2079,2597
0130-001,2017,8,28,23,710,664,1374,2079
0130-001,2017,8,28,24,441,422,863,1374
0130-001,2017,8,29,1,337,289,626,863
0130-001,2017,8,29,2,210,165,375,626
0130-001,2017,8,29,3,133,163,296,375
0130-001,2017,8,29,4,159,194,353,296
0130-001,2017,8,29,5,191,209,400,353
0130-001,2017,8,29,6,582,432,1014,400
0130-001,2017,8,29,7,1680,904,2584,1014
0130-001,2017,8,29,8,1584,1483,3067,2584
0130-001,2017,8,29,9,1567,1740,3307,3067
0130-001,2017,8,29,10,1632,1470,3102,3307
0130-001,2017,8,29,11,1657,1512,3169,3102
0130-001,2017,8,29,12,1493,1591,3084,3169
0130-001,2017,8,29,13,1361,1397,2758,3084
0130-001,2017,8,29,14,1640,1558,3198,2758
0130-001,2017,8,29,15,1525,1644,3169,3198
0130-001,2017,8,29,16,1641,1716,3357,3169
0130-001,2017,8,29,17,1620,1790,3410,3357
0130-001,2017,8,29,18,1700,2034,3734,3410
0130-001,2017,8,29,19,1629,2140,3769,3734
0130-001,2017,8,29,20,1299,1771,3070,3769
0130-001,2017,8,29,21,1136,1659,2795,3070
0130-001,2017,8,29,22,1074,1200,2274,2795
0130-001,2017,8,29,23,874,758,1632,2274
0130-001,2017,8,29,24,543,502,1045,1632
0130-001,2017,8,30,1,385,313,698,1045
0130-001,2017,8,30,2,195,190,385,698
0130-001,2017,8,30,3,153,162,315,385
0130-001,2017,8,30,4,167,196,363,315
0130-001,2017,8,30,5,229,220,449,363
0130-001,2017,8,30,6,626,432,1058,449
0130-001,2017,8,30,7,1642,894,2536,1058
0130-001,2017,8,30,8,1642,1418,3060,2536
0130-001,2017,8,30,9,1502,1752,3254,3060
0130-001,2017,8,30,10,1639,1358,2997,3254
0130-001,2017,8,30,11,1502,1404,2906,2997
0130-001,2017,8,30,12,1456,1536,2992,2906
0130-001,2017,8,30,13,1464,1470,2934,2992
0130-001,2017,8,30,14,1561,1492,3053,2934
0130-001,2017,8,30,15,1658,1598,3256,3053
0130-001,2017,8,30,16,1559,1555,3114,3256
0130-001,2017,8,30,17,1571,1793,3364,3114
0130-001,2017,8,30,18,1719,2086,3805,3364
0130-001,2017,8,30,19,1621,1899,3520,3805
0130-001,2017,8,30,20,1289,1739,3028,3520
0130-001,2017,8,30,21,1235,1460,2695,3028
0130-001,2017,8,30,22,1088,1124,2212,2695
0130-001,2017,8,30,23,825,692,1517,2212
0130-001,2017,8,30,24,545,499,1044,1517
0130-001,2017,8,31,1,366,321,687,1044
0130-001,2017,8,31,2,244,224,468,687
0130-001,2017,8,31,3,179,175,354,468
0130-001,2017,8,31,4,170,211,381,354
0130-001,2017,8,31,5,241,217,458,381
0130-001,2017,8,31,6,622,441,1063,458
0130-001,2017,8,31,7,1668,885,2553,1063
0130-001,2017,8,31,8,1618,1466,3084,2553
0130-001,2017,8,31,9,1584,1737,3321,3084
0130-001,2017,8,31,10,1609,1556,3165,3321
0130-001,2017,8,31,11,1540,1528,3068,3165
0130-001,2017,8,31,12,1430,1481,2911,3068
0130-001,2017,8,31,13,1355,1488,2843,2911
0130-001,2017,8,31,14,1573,1637,3210,2843
0130-001,2017,8,31,15,1571,1598,3169,3210
0130-001,2017,8,31,16,1477,1698,3175,3169
0130-001,2017,8,31,17,1545,1795,3340,3175
0130-001,2017,8,31,18,1639,2107,3746,3340
0130-001,2017,8,31,19,1693,2146,3839,3746
0130-001,2017,8,31,20,1332,1698,3030,3839
0130-001,2017,8,31,21,1223,1684,2907,3030
0130-001,2017,8,31,22,1114,1136,2250,2907
0130-001,2017,8,31,23,836,733,1569,2250
0130-001,2017,8,31,24,608,564,1172,1569
0130-001,2017,9,1,1,394,358,752,1172
0130-001,2017,9,1,2,267,201,468,752
0130-001,2017,9,1,3,174,194,368,468
0130-001,2017,9,1,4,157,196,353,368
0130-001,2017,9,1,5,242,226,468,353
0130-001,2017,9,1,6,665,487,1152,468
0130-001,2017,9,1,7,1652,939,2591,1152
0130-001,2017,9,1,8,1585,1461,3046,2591
0130-001,2017,9,1,9,1495,1719,3214,3046
0130-001,2017,9,1,10,1601,1467,3068,3214
0130-001,2017,9,1,11,1537,1449,2986,3068
0130-001,2017,9,1,12,1476,1530,3006,2986
0130-001,2017,9,1,13,1394,1483,2877,3006
0130-001,2017,9,1,14,1571,1630,3201,2877
0130-001,2017,9,1,15,1576,1626,3202,3201
0130-001,2017,9,1,16,1605,1765,3370,3202
0130-001,2017,9,1,17,1622,1834,3456,3370
0130-001,2017,9,1,18,1731,2115,3846,3456
0130-001,2017,9,1,19,1608,1869,3477,3846
0130-001,2017,9,1,20,1396,1919,3315,3477
0130-001,2017,9,1,21,1282,1768,3050,3315
0130-001,2017,9,1,22,1164,1275,2439,3050
0130-001,2017,9,1,23,947,830,1777,2439
0130-001,2017,9,1,24,661,542,1203,1777
0130-001,2017,9,2,1,493,403,896,1203
0130-001,2017,9,2,2,339,312,651,896
0130-001,2017,9,2,3,243,222,465,651
0130-001,2017,9,2,4,203,242,445,465
0130-001,2017,9,2,5,277,229,506,445
0130-001,2017,9,2,6,609,431,1040,506
0130-001,2017,9,2,7,1232,777,2009,1040
0130-001,2017,9,2,8,1378,1044,2422,2009
0130-001,2017,9,2,9,1446,1491,2937,2422
0130-001,2017,9,2,10,1393,1470,2863,2937
0130-001,2017,9,2,11,1430,1739,3169,2863
0130-001,2017,9,2,12,1485,1725,3210,3169
0130-001,2017,9,2,13,1616,1804,3420,3210
0130-001,2017,9,2,14,1754,1811,3565,3420
0130-001,2017,9,2,15,1608,1708,3316,3565
0130-001,2017,9,2,16,1664,1940,3604,3316
0130-001,2017,9,2,17,1701,1865,3566,3604
0130-001,2017,9,2,18,1783,2004,3787,3566
0130-001,2017,9,2,19,1734,1828,3562,3787
0130-001,2017,9,2,20,1488,1354,2842,3562
0130-001,2017,9,2,21,1228,1154,2382,2842
0130-001,2017,9,2,22,1045,911,1956,2382
0130-001,2017,9,2,23,743,645,1388,1956
0130-001,2017,9,2,24,518,457,975,1388
0130-001,2017,9,3,1,428,367,795,975
0130-001,2017,9,3,2,298,254,552,795
0130-001,2017,9,3,3,228,190,418,552
0130-001,2017,9,3,4,195,152,347,418
0130-001,2017,9,3,5,226,156,382,347
0130-001,2017,9,3,6,375,248,623,382
0130-001,2017,9,3,7,738,506,1244,623
0130-001,2017,9,3,8,781,613,1394,1244
0130-001,2017,9,3,9,819,913,1732,1394
0130-001,2017,9,3,10,1065,1071,2136,1732
0130-001,2017,9,3,11,1263,1304,2567,2136
0130-001,2017,9,3,12,1259,1320,2579,2567
0130-001,2017,9,3,13,1293,1347,2640,2579
0130-001,2017,9,3,14,1518,1572,3090,2640
0130-001,2017,9,3,15,1563,1509,3072,3090
0130-001,2017,9,3,16,1615,1641,3256,3072
0130-001,2017,9,3,17,1659,1593,3252,3256
0130-001,2017,9,3,18,1851,1482,3333,3252
0130-001,2017,9,3,19,1795,1391,3186,3333
0130-001,2017,9,3,20,1543,1155,2698,3186
0130-001,2017,9,3,21,1382,1172,2554,2698
0130-001,2017,9,3,22,1049,868,1917,2554
0130-001,2017,9,3,23,802,580,1382,1917
0130-001,2017,9,3,24,484,395,879,1382
0130-001,2017,9,4,1,285,225,510,879
0130-001,2017,9,4,2,180,156,336,510
0130-001,2017,9,4,3,135,102,237,336
0130-001,2017,9,4,4,130,155,285,237
0130-001,2017,9,4,5,254,210,464,285
0130-001,2017,9,4,6,656,448,1104,464
0130-001,2017,9,4,7,1760,954,2714,1104
0130-001,2017,9,4,8,1562,1435,2997,2714
0130-001,2017,9,4,9,1661,1671,3332,2997
0130-001,2017,9,4,10,1666,1554,3220,3332
0130-001,2017,9,4,11,1630,1486,3116,3220
0130-001,2017,9,4,12,1522,1518,3040,3116
0130-001,2017,9,4,13,1440,1400,2840,3040
0130-001,2017,9,4,14,1633,1540,3173,2840
0130-001,2017,9,4,15,1495,1591,3086,3173
0130-001,2017,9,4,16,1574,1661,3235,3086
0130-001,2017,9,4,17,1627,1822,3449,3235
0130-001,2017,9,4,18,1647,2070,3717,3449
0130-001,2017,9,4,19,1600,2143,3743,3717
0130-001,2017,9,4,20,1387,1738,3125,3743
0130-001,2017,9,4,21,1122,1536,2658,3125
0130-001,2017,9,4,22,999,1205,2204,2658
0130-001,2017,9,4,23,792,691,1483,2204
0130-001,2017,9,4,24,528,456,984,1483
0130-001,2017,9,5,1,303,311,614,984
0130-001,2017,9,5,2,197,182,379,614
0130-001,2017,9,5,3,149,149,298,379
0130-001,2017,9,5,4,144,190,334,298
0130-001,2017,9,5,5,220,243,463,334
0130-001,2017,9,5,6,576,427,1003,463
0130-001,2017,9,5,7,1676,922,2598,1003
0130-001,2017,9,5,8,1642,1455,3097,2598
0130-001,2017,9,5,9,1620,1768,3388,3097
0130-001,2017,9,5,10,1621,1502,3123,3388
0130-001,2017,9,5,11,1533,1429,2962,3123
0130-001,2017,9,5,12,1550,1486,3036,2962
0130-001,2017,9,5,13,1430,1355,2785,3036
0130-001,2017,9,5,14,1717,1535,3252,2785
0130-001,2017,9,5,15,1634,1424,3058,3252
0130-001,2017,9,5,16,1681,1612,3293,3058
0130-001,2017,9,5,17,1629,1734,3363,3293
0130-001,2017,9,5,18,1644,1947,3591,3363
0130-001,2017,9,5,19,1675,2036,3711,3591
0130-001,2017,9,5,20,1299,1587,2886,3711
0130-001,2017,9,5,21,1165,1542,2707,2886
0130-001,2017,9,5,22,1036,1194,2230,2707
0130-001,2017,9,5,23,863,722,1585,2230
0130-001,2017,9,5,24,513,518,1031,1585
0130-001,2017,9,6,1,363,327,690,1031
0130-001,2017,9,6,2,197,190,387,690
0130-001,2017,9,6,3,165,173,338,387
0130-001,2017,9,6,4,140,187,327,338
0130-001,2017,9,6,5,221,188,409,327
0130-001,2017,9,6,6,583,412,995,409
0130-001,2017,9,6,7,1570,900,2470,995
0130-001,2017,9,6,8,1722,1442,3164,2470
0130-001,2017,9,6,9,1582,1749,3331,3164
0130-001,2017,9,6,10,1644,1462,3106,3331
0130-001,2017,9,6,11,1649,1468,3117,3106
0130-001,2017,9,6,12,1561,1457,3018,3117
0130-001,2017,9,6,13,1400,1448,2848,3018
0130-001,2017,9,6,14,1620,1490,3110,2848
0130-001,2017,9,6,15,1646,1539,3185,3110
0130-001,2017,9,6,16,1557,1564,3121,3185
0130-001,2017,9,6,17,1550,1698,3248,3121
0130-001,2017,9,6,18,1705,1928,3633,3248
0130-001,2017,9,6,19,1557,1675,3232,3633
0130-001,2017,9,6,20,1226,1586,2812,3232
0130-001,2017,9,6,21,1139,1319,2458,2812
0130-001,2017,9,6,22,973,1020,1993,2458
0130-001,2017,9,6,23,853,721,1574,1993
0130-001,2017,9,6,24,505,443,948,1574
0130-001,2017,9,7,1,372,302,674,948
0130-001,2017,9,7,2,243,211,454,674
0130-001,2017,9,7,3,191,175,366,454
0130-001,2017,9,7,4,158,197,355,366
0130-001,2017,9,7,5,217,245,462,355
0130-001,2017,9,7,6,619,444,1063,462
0130-001,2017,9,7,7,1647,933,2580,1063
0130-001,2017,9,7,8,1540,1426,2966,2580
0130-001,2017,9,7,9,1676,1690,3366,2966
0130-001,2017,9,7,10,1613,1469,3082,3366
0130-001,2017,9,7,11,1583,1477,3060,3082
0130-001,2017,9,7,12,1590,1489,3079,3060
0130-001,2017,9,7,13,1437,1380,2817,3079
0130-001,2017,9,7,14,1618,1587,3205,2817
0130-001,2017,9,7,15,1711,1486,3197,3205
0130-001,2017,9,7,16,1697,1628,3325,3197
0130-001,2017,9,7,17,1642,1800,3442,3325
0130-001,2017,9,7,18,1710,2023,3733,3442
0130-001,2017,9,7,19,1643,2140,3783,3733
0130-001,2017,9,7,20,1369,1681,3050,3783
0130-001,2017,9,7,21,1195,1674,2869,3050
0130-001,2017,9,7,22,1124,1241,2365,2869
0130-001,2017,9,7,23,953,830,1783,2365
0130-001,2017,9,7,24,608,489,1097,1783
0130-001,2017,9,8,1,424,354,778,1097
0130-001,2017,9,8,2,242,202,444,778
0130-001,2017,9,8,3,178,178,356,444
0130-001,2017,9,8,4,138,212,350,356
0130-001,2017,9,8,5,243,239,482,350
0130-001,2017,9,8,6,624,420,1044,482
0130-001,2017,9,8,7,1723,965,2688,1044
0130-001,2017,9,8,8,1658,1427,3085,2688
0130-001,2017,9,8,9,1601,1728,3329,3085
0130-001,2017,9,8,10,1673,1438,3111,3329
0130-001,2017,9,8,11,1629,1574,3203,3111
0130-001,2017,9,8,12,1521,1582,3103,3203
0130-001,2017,9,8,13,1454,1400,2854,3103
0130-001,2017,9,8,14,1616,1605,3221,2854
0130-001,2017,9,8,15,1466,1639,3105,3221
0130-001,2017,9,8,16,1572,1600,3172,3105
0130-001,2017,9,8,17,1724,1787,3511,3172
0130-001,2017,9,8,18,1648,2180,3828,3511
0130-001,2017,9,8,19,1643,1978,3621,3828
0130-001,2017,9,8,20,1545,1880,3425,3621
0130-001,2017,9,8,21,1305,1613,2918,3425
0130-001,2017,9,8,22,1208,1310,2518,2918
0130-001,2017,9,8,23,991,808,1799,2518
0130-001,2017,9,8,24,679,595,1274,1799
0130-001,2017,9,9,1,478,419,897,1274
0130-001,2017,9,9,2,337,263,600,897
0130-001,2017,9,9,3,283,219,502,600
0130-001,2017,9,9,4,240,257,497,502
0130-001,2017,9,9,5,275,258,533,497
0130-001,2017,9,9,6,573,439,1012,533
0130-001,2017,9,9,7,1282,837,2119,1012
0130-001,2017,9,9,8,1445,1087,2532,2119
0130-001,2017,9,9,9,1550,1534,3084,2532
0130-001,2017,9,9,10,1574,1616,3190,3084
0130-001,2017,9,9,11,1690,1831,3521,3190
0130-001,2017,9,9,12,1717,1961,3678,3521
0130-001,2017,9,9,13,1443,1814,3257,3678
0130-001,2017,9,9,14,1608,2002,3610,3257
0130-001,2017,9,9,15,1679,1882,3561,3610
0130-001,2017,9,9,16,1737,1775,3512,3561
0130-001,2017,9,9,17,1669,1799,3468,3512
0130-001,2017,9,9,18,1813,1906,3719,3468
0130-001,2017,9,9,19,1739,1913,3652,3719
0130-001,2017,9,9,20,1477,1368,2845,3652
0130-001,2017,9,9,21,1206,1057,2263,2845
0130-001,2017,9,9,22,1107,871,1978,2263
0130-001,2017,9,9,23,783,654,1437,1978
0130-001,2017,9,9,24,577,487,1064,1437
0130-001,2017,9,10,1,410,379,789,1064
0130-001,2017,9,10,2,338,244,582,789
0130-001,2017,9,10,3,207,206,413,582
0130-001,2017,9,10,4,164,144,308,413
0130-001,2017,9,10,5,226,152,378,308
0130-001,2017,9,10,6,386,279,665,378
0130-001,2017,9,10,7,728,485,1213,665
0130-001,2017,9,10,8,830,643,1473,1213
0130-001,2017,9,10,9,963,855,1818,1473
0130-001,2017,9,10,10,1078,1016,2094,1818
0130-001,2017,9,10,11,1317,1136,2453,2094
0130-001,2017,9,10,12,1212,1208,2420,2453
0130-001,2017,9,10,13,1304,1314,2618,2420
0130-001,2017,9,10,14,1452,1323,2775,2618
0130-001,2017,9,10,15,1434,1402,2836,2775
0130-001,2017,9,10,16,1516,1440,2956,2836
0130-001,2017,9,10,17,1422,1437,2859,2956
0130-001,2017,9,10,18,1539,1399,2938,2859
0130-001,2017,9,10,19,1513,1342,2855,2938
0130-001,2017,9,10,20,1251,1103,2354,2855
0130-001,2017,9,10,21,1116,987,2103,2354
0130-001,2017,9,10,22,978,801,1779,2103
0130-001,2017,9,10,23,697,532,1229,1779
0130-001,2017,9,10,24,470,376,846,1229
0130-001,2017,9,11,1,268,190,458,846
0130-001,2017,9,11,2,153,158,311,458
0130-001,2017,9,11,3,112,103,215,311
0130-001,2017,9,11,4,135,149,284,215
0130-001,2017,9,11,5,210,171,381,284
0130-001,2017,9,11,6,523,389,912,381
0130-001,2017,9,11,7,1555,826,2381,912
0130-001,2017,9,11,8,1484,1381,2865,2381
0130-001,2017,9,11,9,1574,1649,3223,2865
0130-001,2017,9,11,10,1598,1383,2981,3223
0130-001,2017,9,11,11,1576,1439,3015,2981
0130-001,2017,9,11,12,1551,1394,2945,3015
0130-001,2017,9,11,13,1536,1265,2801,2945
0130-001,2017,9,11,14,1535,1484,3019,2801
0130-001,2017,9,11,15,1602,1472,3074,3019
0130-001,2017,9,11,16,1676,1562,3238,3074
0130-001,2017,9,11,17,1541,1609,3150,3238
0130-001,2017,9,11,18,1695,1899,3594,3150
0130-001,2017,9,11,19,1670,2075,3745,3594
0130-001,2017,9,11,20,1305,1658,2963,3745
0130-001,2017,9,11,21,1069,1510,2579,2963
0130-001,2017,9,11,22,1062,1171,2233,2579
0130-001,2017,9,11,23,721,661,1382,2233
0130-001,2017,9,11,24,464,462,926,1382
0130-001,2017,9,12,1,344,289,633,926
0130-001,2017,9,12,2,223,189,412,633
0130-001,2017,9,12,3,165,161,326,412
0130-001,2017,9,12,4,145,193,338,326
0130-001,2017,9,12,5,241,229,470,338
0130-001,2017,9,12,6,611,409,1020,470
0130-001,2017,9,12,7,1682,883,2565,1020
0130-001,2017,9,12,8,1621,1443,3064,2565
0130-001,2017,9,12,9,1662,1634,3296,3064
0130-001,2017,9,12,10,1620,1449,3069,3296
0130-001,2017,9,12,11,1571,1398,2969,3069
0130-001,2017,9,12,12,1504,1385,2889,2969
0130-001,2017,9,12,13,1375,1329,2704,2889
0130-001,2017,9,12,14,1655,1483,3138,2704
0130-001,2017,9,12,15,1539,1523,3062,3138
0130-001,2017,9,12,16,1586,1607,3193,3062
0130-001,2017,9,12,17,1602,1706,3308,3193
0130-001,2017,9,12,18,1691,2011,3702,3308
0130-001,2017,9,12,19,1640,1941,3581,3702
0130-001,2017,9,12,20,1326,1670,2996,3581
0130-001,2017,9,12,21,1149,1615,2764,2996
0130-001,2017,9,12,22,1107,1243,2350,2764
0130-001,2017,9,12,23,860,731,1591,2350
0130-001,2017,9,12,24,544,501,1045,1591
0130-001,2017,9,13,1,340,315,655,1045
0130-001,2017,9,13,2,193,213,406,655
0130-001,2017,9,13,3,177,172,349,406
0130-001,2017,9,13,4,124,185,309,349
0130-001,2017,9,13,5,221,196,417,309
0130-001,2017,9,13,6,613,420,1033,417
0130-001,2017,9,13,7,1684,917,2601,1033
0130-001,2017,9,13,8,1639,1415,3054,2601
0130-001,2017,9,13,9,1570,1681,3251,3054
0130-001,2017,9,13,10,1645,1450,3095,3251
0130-001,2017,9,13,11,1581,1465,3046,3095
0130-001,2017,9,13,12,1547,1437,2984,3046
0130-001,2017,9,13,13,1385,1349,2734,2984
0130-001,2017,9,13,14,1648,1504,3152,2734
0130-001,2017,9,13,15,1498,1443,2941,3152
0130-001,2017,9,13,16,1693,1635,3328,2941
0130-001,2017,9,13,17,1672,1763,3435,3328
0130-001,2017,9,13,18,1817,2101,3918,3435
0130-001,2017,9,13,19,1617,1970,3587,3918
0130-001,2017,9,13,20,1289,1679,2968,3587
0130-001,2017,9,13,21,1094,1444,2538,2968
0130-001,2017,9,13,22,1160,1160,2320,2538
0130-001,2017,9,13,23,897,755,1652,2320
0130-001,2017,9,13,24,646,463,1109,1652
0130-001,2017,9,14,1,440,297,737,1109
0130-001,2017,9,14,2,227,203,430,737
0130-001,2017,9,14,3,171,193,364,430
0130-001,2017,9,14,4,171,195,366,364
0130-001,2017,9,14,5,222,202,424,366
0130-001,2017,9,14,6,599,405,1004,424
0130-001,2017,9,14,7,1667,906,2573,1004
0130-001,2017,9,14,8,1583,1358,2941,2573
0130-001,2017,9,14,9,1637,1643,3280,2941
0130-001,2017,9,14,10,1330,1387,2717,3280
0130-001,2017,9,14,11,1252,1468,2720,2717
0130-001,2017,9,14,12,1458,1369,2827,2720
0130-001,2017,9,14,13,1321,1403,2724,2827
0130-001,2017,9,14,14,1536,1536,3072,2724
0130-001,2017,9,14,15,1644,1621,3265,3072
0130-001,2017,9,14,16,1614,1572,3186,3265
0130-001,2017,9,14,17,1610,1775,3385,3186
0130-001,2017,9,14,18,1726,2041,3767,3385
0130-001,2017,9,14,19,1579,2095,3674,3767
0130-001,2017,9,14,20,1321,1656,2977,3674
0130-001,2017,9,14,21,1206,1497,2703,2977
0130-001,2017,9,14,22,1171,1277,2448,2703
0130-001,2017,9,14,23,936,750,1686,2448
0130-001,2017,9,14,24,591,491,1082,1686
0130-001,2017,9,15,1,372,339,711,1082
0130-001,2017,9,15,2,227,207,434,711
0130-001,2017,9,15,3,166,182,348,434
0130-001,2017,9,15,4,149,195,344,348
0130-001,2017,9,15,5,230,223,453,344
0130-001,2017,9,15,6,620,445,1065,453
0130-001,2017,9,15,7,1591,897,2488,1065
0130-001,2017,9,15,8,1610,1416,3026,2488
0130-001,2017,9,15,9,1577,1645,3222,3026
0130-001,2017,9,15,10,1578,1395,2973,3222
0130-001,2017,9,15,11,1558,1523,3081,2973
0130-001,2017,9,15,12,1544,1473,3017,3081
0130-001,2017,9,15,13,1430,1376,2806,3017
0130-001,2017,9,15,14,1659,1647,3306,2806
0130-001,2017,9,15,15,1632,1636,3268,3306
0130-001,2017,9,15,16,1552,1602,3154,3268
0130-001,2017,9,15,17,1625,1835,3460,3154
0130-001,2017,9,15,18,1679,2101,3780,3460
0130-001,2017,9,15,19,1616,1727,3343,3780
0130-001,2017,9,15,20,1430,1825,3255,3343
0130-001,2017,9,15,21,1355,1594,2949,3255
0130-001,2017,9,15,22,1276,1278,2554,2949
0130-001,2017,9,15,23,1003,809,1812,2554
0130-001,2017,9,15,24,696,596,1292,1812
0130-001,2017,9,16,1,512,399,911,1292
0130-001,2017,9,16,2,341,276,617,911
0130-001,2017,9,16,3,277,250,527,617
0130-001,2017,9,16,4,226,237,463,527
0130-001,2017,9,16,5,262,238,500,463
0130-001,2017,9,16,6,595,458,1053,500
0130-001,2017,9,16,7,1323,844,2167,1053
0130-001,2017,9,16,8,1401,1069,2470,2167
0130-001,2017,9,16,9,1473,1493,2966,2470
0130-001,2017,9,16,10,1480,1636,3116,2966
0130-001,2017,9,16,11,1687,1621,3308,3116
0130-001,2017,9,16,12,1607,1717,3324,3308
0130-001,2017,9,16,13,1585,1763,3348,3324
0130-001,2017,9,16,14,1656,1712,3368,3348
0130-001,2017,9,16,15,1689,1709,3398,3368
0130-001,2017,9,16,16,1759,1675,3434,3398
0130-001,2017,9,16,17,1689,1794,3483,3434
0130-001,2017,9,16,18,1695,1885,3580,3483
0130-001,2017,9,16,19,1739,1817,3556,3580
0130-001,2017,9,16,20,1548,1255,2803,3556
0130-001,2017,9,16,21,1256,1140,2396,2803
0130-001,2017,9,16,22,1164,914,2078,2396
0130-001,2017,9,16,23,888,666,1554,2078
0130-001,2017,9,16,24,606,460,1066,1554
0130-001,2017,9,17,1,421,336,757,1066
0130-001,2017,9,17,2,307,251,558,757
0130-001,2017,9,17,3,235,215,450,558
0130-001,2017,9,17,4,181,138,319,450
0130-001,2017,9,17,5,197,144,341,319
0130-001,2017,9,17,6,412,283,695,341
0130-001,2017,9,17,7,731,480,1211,695
0130-001,2017,9,17,8,922,712,1634,1211
0130-001,2017,9,17,9,981,976,1957,1634
0130-001,2017,9,17,10,1069,1059,2128,1957
0130-001,2017,9,17,11,1338,1251,2589,2128
0130-001,2017,9,17,12,1221,1331,2552,2589
0130-001,2017,9,17,13,1297,1443,2740,2552
0130-001,2017,9,17,14,1599,1456,3055,2740
0130-001,2017,9,17,15,1597,1523,3120,3055
0130-001,2017,9,17,16,1498,1488,2986,3120
0130-001,2017,9,17,17,1717,1412,3129,2986
0130-001,2017,9,17,18,1844,1537,3381,3129
0130-001,2017,9,17,19,1694,1339,3033,3381
0130-001,2017,9,17,20,1541,1129,2670,3033
0130-001,2017,9,17,21,1467,1081,2548,2670
0130-001,2017,9,17,22,1102,807,1909,2548
0130-001,2017,9,17,23,869,558,1427,1909
0130-001,2017,9,17,24,487,386,873,1427
0130-001,2017,9,18,1,289,244,533,873
0130-001,2017,9,18,2,175,146,321,533
0130-001,2017,9,18,3,139,116,255,321
0130-001,2017,9,18,4,150,170,320,255
0130-001,2017,9,18,5,241,168,409,320
0130-001,2017,9,18,6,664,440,1104,409
0130-001,2017,9,18,7,1745,957,2702,1104
0130-001,2017,9,18,8,1569,1420,2989,2702
0130-001,2017,9,18,9,1601,1610,3211,2989
0130-001,2017,9,18,10,1639,1409,3048,3211
0130-001,2017,9,18,11,1539,1456,2995,3048
0130-001,2017,9,18,12,1573,1513,3086,2995
0130-001,2017,9,18,13,1450,1302,2752,3086
0130-001,2017,9,18,14,1622,1543,3165,2752
0130-001,2017,9,18,15,1685,1576,3261,3165
0130-001,2017,9,18,16,1585,1623,3208,3261
0130-001,2017,9,18,17,1584,1796,3380,3208
0130-001,2017,9,18,18,1641,1989,3630,3380
0130-001,2017,9,18,19,1682,1959,3641,3630
0130-001,2017,9,18,20,1340,1633,2973,3641
0130-001,2017,9,18,21,1187,1589,2776,2973
0130-001,2017,9,18,22,1076,1166,2242,2776
0130-001,2017,9,18,23,747,725,1472,2242
0130-001,2017,9,18,24,479,435,914,1472
0130-001,2017,9,19,1,350,292,642,914
0130-001,2017,9,19,2,219,186,405,642
0130-001,2017,9,19,3,150,151,301,405
0130-001,2017,9,19,4,152,197,349,301
0130-001,2017,9,19,5,250,199,449,349
0130-001,2017,9,19,6,611,444,1055,449
0130-001,2017,9,19,7,1661,907,2568,1055
0130-001,2017,9,19,8,1602,1395,2997,2568
0130-001,2017,9,19,9,1617,1644,3261,2997
0130-001,2017,9,19,10,1624,1498,3122,3261
0130-001,2017,9,19,11,1562,1366,2928,3122
0130-001,2017,9,19,12,1379,1414,2793,2928
0130-001,2017,9,19,13,1412,1281,2693,2793
0130-001,2017,9,19,14,1483,1468,2951,2693
0130-001,2017,9,19,15,1420,1461,2881,2951
0130-001,2017,9,19,16,1466,1539,3005,2881
0130-001,2017,9,19,17,1618,1663,3281,3005
0130-001,2017,9,19,18,1643,1987,3630,3281
0130-001,2017,9,19,19,1622,1974,3596,3630
0130-001,2017,9,19,20,1338,1628,2966,3596
0130-001,2017,9,19,21,1211,1471,2682,2966
0130-001,2017,9,19,22,1100,1176,2276,2682
0130-001,2017,9,19,23,818,732,1550,2276
0130-001,2017,9,19,24,496,475,971,1550
0130-001,2017,9,20,1,376,328,704,971
0130-001,2017,9,20,2,208,181,389,704
0130-001,2017,9,20,3,188,174,362,389
0130-001,2017,9,20,4,157,206,363,362
0130-001,2017,9,20,5,228,195,423,363
0130-001,2017,9,20,6,619,448,1067,423
0130-001,2017,9,20,7,1689,901,2590,1067
0130-001,2017,9,20,8,1582,1374,2956,2590
0130-001,2017,9,20,9,1624,1682,3306,2956
0130-001,2017,9,20,10,1640,1331,2971,3306
0130-001,2017,9,20,11,1575,1442,3017,2971
0130-001,2017,9,20,12,1592,1478,3070,3017
0130-001,2017,9,20,13,1506,1396,2902,3070
0130-001,2017,9,20,14,1590,1476,3066,2902
0130-001,2017,9,20,15,1646,1576,3222,3066
0130-001,2017,9,20,16,1651,1593,3244,3222
0130-001,2017,9,20,17,1648,1764,3412,3244
0130-001,2017,9,20,18,1715,1947,3662,3412
0130-001,2017,9,20,19,1594,1636,3230,3662
0130-001,2017,9,20,20,1391,1667,3058,3230
0130-001,2017,9,20,21,1185,1336,2521,3058
0130-001,2017,9,20,22,1229,1171,2400,2521
0130-001,2017,9,20,23,831,787,1618,2400
0130-001,2017,9,20,24,569,499,1068,1618
0130-001,2017,9,21,1,381,344,725,1068
0130-001,2017,9,21,2,249,224,473,725
0130-001,2017,9,21,3,164,157,321,473
0130-001,2017,9,21,4,170,177,347,321
0130-001,2017,9,21,5,244,230,474,347
0130-001,2017,9,21,6,601,417,1018,474
0130-001,2017,9,21,7,1720,904,2624,1018
0130-001,2017,9,21,8,1559,1396,2955,2624
0130-001,2017,9,21,9,1556,1617,3173,2955
0130-001,2017,9,21,10,1683,1387,3070,3173
0130-001,2017,9,21,11,1642,1422,3064,3070
0130-001,2017,9,21,12,1501,1443,2944,3064
0130-001,2017,9,21,13,1443,1363,2806,2944
0130-001,2017,9,21,14,1650,1563,3213,2806
0130-001,2017,9,21,15,1662,1463,3125,3213
0130-001,2017,9,21,16,1642,1535,3177,3125
0130-001,2017,9,21,17,1681,1727,3408,3177
0130-001,2017,9,21,18,1737,1876,3613,3408
0130-001,2017,9,21,19,1591,2042,3633,3613
0130-001,2017,9,21,20,1315,1687,3002,3633
0130-001,2017,9,21,21,1231,1556,2787,3002
0130-001,2017,9,21,22,1173,1231,2404,2787
0130-001,2017,9,21,23,879,805,1684,2404
0130-001,2017,9,21,24,601,517,1118,1684
0130-001,2017,9,22,1,394,367,761,1118
0130-001,2017,9,22,2,231,208,439,761
0130-001,2017,9,22,3,186,187,373,439
0130-001,2017,9,22,4,161,207,368,373
0130-001,2017,9,22,5,282,240,522,368
0130-001,2017,9,22,6,642,458,1100,522
0130-001,2017,9,22,7,1640,959,2599,1100
0130-001,2017,9,22,8,1536,1399,2935,2599
0130-001,2017,9,22,9,1597,1675,3272,2935
0130-001,2017,9,22,10,1640,1362,3002,3272
0130-001,2017,9,22,11,1623,1414,3037,3002
0130-001,2017,9,22,12,1583,1509,3092,3037
0130-001,2017,9,22,13,1405,1344,2749,3092
0130-001,2017,9,22,14,1689,1523,3212,2749
0130-001,2017,9,22,15,1595,1457,3052,3212
0130-001,2017,9,22,16,1737,1598,3335,3052
0130-001,2017,9,22,17,1666,1763,3429,3335
0130-001,2017,9,22,18,1725,2001,3726,3429
0130-001,2017,9,22,19,1717,1747,3464,3726
0130-001,2017,9,22,20,1443,1717,3160,3464
0130-001,2017,9,22,21,1286,1490,2776,3160
0130-001,2017,9,22,22,1193,1180,2373,2776
0130-001,2017,9,22,23,888,783,1671,2373
0130-001,2017,9,22,24,660,547,1207,1671
0130-001,2017,9,23,1,489,425,914,1207
0130-001,2017,9,23,2,318,289,607,914
0130-001,2017,9,23,3,248,228,476,607
0130-001,2017,9,23,4,188,236,424,476
0130-001,2017,9,23,5,291,243,534,424
0130-001,2017,9,23,6,571,492,1063,534
0130-001,2017,9,23,7,1308,808,2116,1063
0130-001,2017,9,23,8,1377,1127,2504,2116
0130-001,2017,9,23,9,1684,1473,3157,2504
0130-001,2017,9,23,10,1712,1468,3180,3157
0130-001,2017,9,23,11,1632,1665,3297,3180
0130-001,2017,9,23,12,1680,1691,3371,3297
0130-001,2017,9,23,13,1532,1659,3191,3371
0130-001,2017,9,23,14,1720,1660,3380,3191
0130-001,2017,9,23,15,1717,1623,3340,3380
0130-001,2017,9,23,16,1740,1613,3353,3340
0130-001,2017,9,23,17,1756,1620,3376,3353
0130-001,2017,9,23,18,1811,1842,3653,3376
0130-001,2017,9,23,19,1787,1722,3509,3653
0130-001,2017,9,23,20,1555,1274,2829,3509
0130-001,2017,9,23,21,1251,1058,2309,2829
0130-001,2017,9,23,22,1062,801,1863,2309
0130-001,2017,9,23,23,796,634,1430,1863
0130-001,2017,9,23,24,531,486,1017,1430
0130-001,2017,9,24,1,393,354,747,1017
0130-001,2017,9,24,2,293,220,513,747
0130-001,2017,9,24,3,221,175,396,513
0130-001,2017,9,24,4,219,146,365,396
0130-001,2017,9,24,5,272,165,437,365
0130-001,2017,9,24,6,422,273,695,437
0130-001,2017,9,24,7,714,487,1201,695
0130-001,2017,9,24,8,902,687,1589,1201
0130-001,2017,9,24,9,992,917,1909,1589
0130-001,2017,9,24,10,1167,1021,2188,1909
0130-001,2017,9,24,11,1346,1204,2550,2188
0130-001,2017,9,24,12,1327,1205,2532,2550
0130-001,2017,9,24,13,1358,1235,2593,2532
0130-001,2017,9,24,14,1595,1352,2947,2593
0130-001,2017,9,24,15,1591,1406,2997,2947
0130-001,2017,9,24,16,1477,1427,2904,2997
0130-001,2017,9,24,17,1440,1411,2851,2904
0130-001,2017,9,24,18,1497,1456,2953,2851
0130-001,2017,9,24,19,1555,1371,2926,2953
0130-001,2017,9,24,20,1293,1068,2361,2926
0130-001,2017,9,24,21,1121,962,2083,2361
0130-001,2017,9,24,22,884,785,1669,2083
0130-001,2017,9,24,23,673,536,1209,1669
0130-001,2017,9,24,24,413,327,740,1209
0130-001,2017,9,25,1,259,221,480,740
0130-001,2017,9,25,2,140,156,296,480
0130-001,2017,9,25,3,126,117,243,296
0130-001,2017,9,25,4,139,157,296,243
0130-001,2017,9,25,5,289,194,483,296
0130-001,2017,9,25,6,677,488,1165,483
0130-001,2017,9,25,7,1683,960,2643,1165
0130-001,2017,9,25,8,1561,1401,2962,2643
0130-001,2017,9,25,9,1578,1619,3197,2962
0130-001,2017,9,25,10,1619,1411,3030,3197
0130-001,2017,9,25,11,1550,1470,3020,3030
0130-001,2017,9,25,12,1536,1436,2972,3020
0130-001,2017,9,25,13,1501,1360,2861,2972
0130-001,2017,9,25,14,1642,1588,3230,2861
0130-001,2017,9,25,15,1537,1528,3065,3230
0130-001,2017,9,25,16,1335,1627,2962,3065
0130-001,2017,9,25,17,1612,1715,3327,2962
0130-001,2017,9,25,18,1700,1998,3698,3327
0130-001,2017,9,25,19,1622,1881,3503,3698
0130-001,2017,9,25,20,1308,1653,2961,3503
0130-001,2017,9,25,21,1235,1570,2805,2961
0130-001,2017,9,25,22,1106,1173,2279,2805
0130-001,2017,9,25,23,829,724,1553,2279
0130-001,2017,9,25,24,507,481,988,1553
0130-001,2017,9,26,1,359,293,652,988
0130-001,2017,9,26,2,209,211,420,652
0130-001,2017,9,26,3,164,189,353,420
0130-001,2017,9,26,4,142,206,348,353
0130-001,2017,9,26,5,262,245,507,348
0130-001,2017,9,26,6,609,485,1094,507
0130-001,2017,9,26,7,1677,902,2579,1094
0130-001,2017,9,26,8,1639,1329,2968,2579
0130-001,2017,9,26,9,1579,1696,3275,2968
0130-001,2017,9,26,10,1645,1438,3083,3275
0130-001,2017,9,26,11,1628,1441,3069,3083
0130-001,2017,9,26,12,1568,1502,3070,3069
0130-001,2017,9,26,13,1461,1412,2873,3070
0130-001,2017,9,26,14,1680,1673,3353,2873
0130-001,2017,9,26,15,1569,1516,3085,3353
0130-001,2017,9,26,16,1565,1642,3207,3085
0130-001,2017,9,26,17,1557,1657,3214,3207
0130-001,2017,9,26,18,1689,1915,3604,3214
0130-001,2017,9,26,19,1638,1900,3538,3604
0130-001,2017,9,26,20,1326,1647,2973,3538
0130-001,2017,9,26,21,1216,1588,2804,2973
0130-001,2017,9,26,22,1140,1195,2335,2804
0130-001,2017,9,26,23,852,754,1606,2335
0130-001,2017,9,26,24,548,502,1050,1606
0130-001,2017,9,27,1,360,345,705,1050
0130-001,2017,9,27,2,225,212,437,705
0130-001,2017,9,27,3,138,160,298,437
0130-001,2017,9,27,4,170,207,377,298
0130-001,2017,9,27,5,254,197,451,377
0130-001,2017,9,27,6,556,403,959,451
0130-001,2017,9,27,7,1575,832,2407,959
0130-001,2017,9,27,8,1523,1332,2855,2407
0130-001,2017,9,27,9,1461,1599,3060,2855
0130-001,2017,9,27,10,1678,1404,3082,3060
0130-001,2017,9,27,11,1666,1516,3182,3082
0130-001,2017,9,27,12,1610,1477,3087,3182
0130-001,2017,9,27,13,1544,1316,2860,3087
0130-001,2017,9,27,14,1681,1440,3121,2860
0130-001,2017,9,27,15,1723,1566,3289,3121
0130-001,2017,9,27,16,1703,1623,3326,3289
0130-001,2017,9,27,17,1655,1691,3346,3326
0130-001,2017,9,27,18,1736,1882,3618,3346
0130-001,2017,9,27,19,1636,1793,3429,3618
0130-001,2017,9,27,20,1410,1735,3145,3429
0130-001,2017,9,27,21,1180,1453,2633,3145
0130-001,2017,9,27,22,1163,1079,2242,2633
0130-001,2017,9,27,23,894,711,1605,2242
0130-001,2017,9,27,24,579,484,1063,1605
0130-001,2017,9,28,1,435,410,845,1063
0130-001,2017,9,28,2,225,234,459,845
0130-001,2017,9,28,3,169,186,355,459
0130-001,2017,9,28,4,177,189,366,355
0130-001,2017,9,28,5,265,251,516,366
0130-001,2017,9,28,6,586,422,1008,516
0130-001,2017,9,28,7,1647,901,2548,1008
0130-001,2017,9,28,8,1585,1336,2921,2548
0130-001,2017,9,28,9,1532,1617,3149,2921
0130-001,2017,9,28,10,1690,1410,3100,3149
0130-001,2017,9,28,11,1664,1497,3161,3100
0130-001,2017,9,28,12,1589,1491,3080,3161
0130-001,2017,9,28,13,1509,1395,2904,3080
0130-001,2017,9,28,14,1668,1545,3213,2904
0130-001,2017,9,28,15,1622,1532,3154,3213
0130-001,2017,9,28,16,1650,1530,3180,3154
0130-001,2017,9,28,17,1621,1678,3299,3180
0130-001,2017,9,28,18,1806,1870,3676,3299
0130-001,2017,9,28,19,1584,1979,3563,3676
0130-001,2017,9,28,20,1417,1705,3122,3563
0130-001,2017,9,28,21,1306,1597,2903,3122
0130-001,2017,9,28,22,1256,1229,2485,2903
0130-001,2017,9,28,23,1035,803,1838,2485
0130-001,2017,9,28,24,632,534,1166,1838
0130-001,2017,9,29,1,442,410,852,1166
0130-001,2017,9,29,2,241,243,484,852
0130-001,2017,9,29,3,221,171,392,484
0130-001,2017,9,29,4,191,200,391,392
0130-001,2017,9,29,5,282,220,502,391
0130-001,2017,9,29,6,612,435,1047,502
0130-001,2017,9,29,7,1669,860,2529,1047
0130-001,2017,9,29,8,1563,1358,2921,2529
0130-001,2017,9,29,9,1532,1583,3115,2921
0130-001,2017,9,29,10,1651,1468,3119,3115
0130-001,2017,9,29,11,1651,1484,3135,3119
0130-001,2017,9,29,12,1670,1585,3255,3135
0130-001,2017,9,29,13,1545,1482,3027,3255
0130-001,2017,9,29,14,1666,1552,3218,3027
0130-001,2017,9,29,15,1568,1553,3121,3218
0130-001,2017,9,29,16,1586,1672,3258,3121
0130-001,2017,9,29,17,1646,1851,3497,3258
0130-001,2017,9,29,18,1738,1930,3668,3497
0130-001,2017,9,29,19,1692,1450,3142,3668
0130-001,2017,9,29,20,1437,1603,3040,3142
0130-001,2017,9,29,21,1311,1500,2811,3040
0130-001,2017,9,29,22,1192,1058,2250,2811
0130-001,2017,9,29,23,1013,797,1810,2250
0130-001,2017,9,29,24,662,563,1225,1810
0130-001,2017,9,30,1,481,408,889,1225
0130-001,2017,9,30,2,351,288,639,889
0130-001,2017,9,30,3,238,211,449,639
0130-001,2017,9,30,4,234,229,463,449
0130-001,2017,9,30,5,287,234,521,463
0130-001,2017,9,30,6,551,434,985,521
0130-001,2017,9,30,7,1205,760,1965,985
0130-001,2017,9,30,8,1462,953,2415,1965
0130-001,2017,9,30,9,1408,1308,2716,2415
0130-001,2017,9,30,10,1466,1414,2880,2716
0130-001,2017,9,30,11,1426,1594,3020,2880
0130-001,2017,9,30,12,1566,1545,3111,3020
0130-001,2017,9,30,13,1595,1549,3144,3111
0130-001,2017,9,30,14,1670,1631,3301,3144
0130-001,2017,9,30,15,1652,1536,3188,3301
0130-001,2017,9,30,16,1683,1686,3369,3188
0130-001,2017,9,30,17,1647,1600,3247,3369
0130-001,2017,9,30,18,1816,1805,3621,3247
0130-001,2017,9,30,19,1674,1694,3368,3621
0130-001,2017,9,30,20,1322,1275,2597,3368
0130-001,2017,9,30,21,1106,952,2058,2597
0130-001,2017,9,30,22,931,765,1696,2058
0130-001,2017,9,30,23,745,524,1269,1696
0130-001,2017,9,30,24,511,416,927,1269
0130-001,2017,10,1,1,401,365,766,927
0130-001,2017,10,1,2,299,263,562,766
0130-001,2017,10,1,3,212,218,430,562
0130-001,2017,10,1,4,209,207,416,430
0130-001,2017,10,1,5,235,182,417,416
0130-001,2017,10,1,6,350,308,658,417
0130-001,2017,10,1,7,789,631,1420,658
0130-001,2017,10,1,8,981,757,1738,1420
0130-001,2017,10,1,9,991,1041,2032,1738
0130-001,2017,10,1,10,1122,1271,2393,2032
0130-001,2017,10,1,11,1299,1568,2867,2393
0130-001,2017,10,1,12,1331,1500,2831,2867
0130-001,2017,10,1,13,1353,1606,2959,2831
0130-001,2017,10,1,14,1485,1613,3098,2959
0130-001,2017,10,1,15,1496,1736,3232,3098
0130-001,2017,10,1,16,1524,1758,3282,3232
0130-001,2017,10,1,17,1593,1671,3264,3282
0130-001,2017,10,1,18,1526,1661,3187,3264
0130-001,2017,10,1,19,1499,1474,2973,3187
0130-001,2017,10,1,20,1136,1111,2247,2973
0130-001,2017,10,1,21,983,995,1978,2247
0130-001,2017,10,1,22,802,787,1589,1978
0130-001,2017,10,1,23,574,549,1123,1589
0130-001,2017,10,1,24,399,337,736,1123
0130-001,2017,10,2,1,306,293,599,736
0130-001,2017,10,2,2,201,183,384,599
0130-001,2017,10,2,3,184,182,366,384
0130-001,2017,10,2,4,132,201,333,366
0130-001,2017,10,2,5,186,221,407,333
0130-001,2017,10,2,6,410,308,718,407
0130-001,2017,10,2,7,850,666,1516,718
0130-001,2017,10,2,8,1110,916,2026,1516
0130-001,2017,10,2,9,1180,1337,2517,2026
0130-001,2017,10,2,10,1370,1611,2981,2517
0130-001,2017,10,2,11,1521,1784,3305,2981
0130-001,2017,10,2,12,1591,1918,3509,3305
0130-001,2017,10,2,13,1609,1858,3467,3509
0130-001,2017,10,2,14,1618,2105,3723,3467
0130-001,2017,10,2,15,1694,2062,3756,3723
0130-001,2017,10,2,16,1529,2148,3677,3756
0130-001,2017,10,2,17,1625,2290,3915,3677
0130-001,2017,10,2,18,1651,2245,3896,3915
0130-001,2017,10,2,19,1498,2110,3608,3896
0130-001,2017,10,2,20,1198,1503,2701,3608
0130-001,2017,10,2,21,1058,1194,2252,2701
0130-001,2017,10,2,22,926,905,1831,2252
0130-001,2017,10,2,23,673,660,1333,1831
0130-001,2017,10,2,24,503,540,1043,1333
0130-001,2017,10,3,1,354,338,692,1043
0130-001,2017,10,3,2,246,255,501,692
0130-001,2017,10,3,3,231,276,507,501
0130-001,2017,10,3,4,172,220,392,507
0130-001,2017,10,3,5,176,213,389,392
0130-001,2017,10,3,6,291,290,581,389
0130-001,2017,10,3,7,446,575,1021,581
0130-001,2017,10,3,8,575,921,1496,1021
0130-001,2017,10,3,9,838,1214,2052,1496
0130-001,2017,10,3,10,1130,1533,2663,2052
0130-001,2017,10,3,11,1405,1685,3090,2663
0130-001,2017,10,3,12,1466,1884,3350,3090
0130-001,2017,10,3,13,1363,1879,3242,3350
0130-001,2017,10,3,14,1215,1825,3040,3242
0130-001,2017,10,3,15,1211,1739,2950,3040
0130-001,2017,10,3,16,1210,1580,2790,2950
0130-001,2017,10,3,17,1225,1332,2557,2790
0130-001,2017,10,3,18,1156,1360,2516,2557
0130-001,2017,10,3,19,1079,1071,2150,2516
0130-001,2017,10,3,20,804,911,1715,2150
0130-001,2017,10,3,21,652,777,1429,1715
0130-001,2017,10,3,22,542,661,1203,1429
0130-001,2017,10,3,23,459,448,907,1203
0130-001,2017,10,3,24,309,316,625,907
0130-001,2017,10,4,1,227,198,425,625
0130-001,2017,10,4,2,155,122,277,425
0130-001,2017,10,4,3,114,107,221,277
0130-001,2017,10,4,4,90,65,155,221
0130-001,2017,10,4,5,91,94,185,155
0130-001,2017,10,4,6,145,150,295,185
0130-001,2017,10,4,7,511,420,931,295
0130-001,2017,10,4,8,1023,777,1800,931
0130-001,2017,10,4,9,848,810,1658,1800
0130-001,2017,10,4,10,755,976,1731,1658
0130-001,2017,10,4,11,1234,1408,2642,1731
0130-001,2017,10,4,12,1566,1667,3233,2642
0130-001,2017,10,4,13,1488,2025,3513,3233
0130-001,2017,10,4,14,1537,2079,3616,3513
0130-001,2017,10,4,15,1693,2111,3804,3616
0130-001,2017,10,4,16,1626,2108,3734,3804
0130-001,2017,10,4,17,1593,2112,3705,3734
0130-001,2017,10,4,18,1576,2111,3687,3705
0130-001,2017,10,4,19,1636,1863,3499,3687
0130-001,2017,10,4,20,1320,1720,3040,3499
0130-001,2017,10,4,21,1464,1104,2568,3040
0130-001,2017,10,4,22,1098,758,1856,2568
0130-001,2017,10,4,23,780,527,1307,1856
0130-001,2017,10,4,24,612,415,1027,1307
0130-001,2017,10,5,1,366,256,622,1027
0130-001,2017,10,5,2,247,173,420,622
0130-001,2017,10,5,3,146,117,263,420
0130-001,2017,10,5,4,132,72,204,263
0130-001,2017,10,5,5,111,101,212,204
0130-001,2017,10,5,6,185,148,333,212
0130-001,2017,10,5,7,333,265,598,333
0130-001,2017,10,5,8,413,420,833,598
0130-001,2017,10,5,9,561,587,1148,833
0130-001,2017,10,5,10,835,812,1647,1148
0130-001,2017,10,5,11,1207,1231,2438,1647
0130-001,2017,10,5,12,1389,1461,2850,2438
0130-001,2017,10,5,13,1131,1489,2620,2850
0130-001,2017,10,5,14,1113,1568,2681,2620
0130-001,2017,10,5,15,1150,1681,2831,2681
0130-001,2017,10,5,16,1546,1522,3068,2831
0130-001,2017,10,5,17,1642,1388,3030,3068
0130-001,2017,10,5,18,1699,1213,2912,3030
0130-001,2017,10,5,19,1495,1034,2529,2912
0130-001,2017,10,5,20,1646,885,2531,2529
0130-001,2017,10,5,21,1260,819,2079,2531
0130-001,2017,10,5,22,1591,663,2254,2079
0130-001,2017,10,5,23,1355,561,1916,2254
0130-001,2017,10,5,24,1523,392,1915,1916
0130-001,2017,10,6,1,962,276,1238,1915
0130-001,2017,10,6,2,537,211,748,1238
0130-001,2017,10,6,3,362,185,547,748
0130-001,2017,10,6,4,183,156,339,547
0130-001,2017,10,6,5,188,116,304,339
0130-001,2017,10,6,6,239,232,471,304
0130-001,2017,10,6,7,455,346,801,471
0130-001,2017,10,6,8,631,531,1162,801
0130-001,2017,10,6,9,725,736,1461,1162
0130-001,2017,10,6,10,919,1014,1933,1461
0130-001,2017,10,6,11,1061,1098,2159,1933
0130-001,2017,10,6,12,1199,1318,2517,2159
0130-001,2017,10,6,13,1196,1306,2502,2517
0130-001,2017,10,6,14,1240,1361,2601,2502
0130-001,2017,10,6,15,1383,1364,2747,2601
0130-001,2017,10,6,16,1550,1306,2856,2747
0130-001,2017,10,6,17,1593,1299,2892,2856
0130-001,2017,10,6,18,1506,1370,2876,2892
0130-001,2017,10,6,19,1438,1309,2747,2876
0130-001,2017,10,6,20,1246,1033,2279,2747
0130-001,2017,10,6,21,1436,909,2345,2279
0130-001,2017,10,6,22,1155,780,1935,2345
0130-001,2017,10,6,23,1057,603,1660,1935
0130-001,2017,10,6,24,782,455,1237,1660
0130-001,2017,10,7,1,491,343,834,1237
0130-001,2017,10,7,2,266,243,509,834
0130-001,2017,10,7,3,219,226,445,509
0130-001,2017,10,7,4,157,196,353,445
0130-001,2017,10,7,5,201,174,375,353
0130-001,2017,10,7,6,339,261,600,375
0130-001,2017,10,7,7,662,458,1120,600
0130-001,2017,10,7,8,798,664,1462,1120
0130-001,2017,10,7,9,930,896,1826,1462
0130-001,2017,10,7,10,1139,1126,2265,1826
0130-001,2017,10,7,11,1271,1288,2559,2265
0130-001,2017,10,7,12,1376,1361,2737,2559
0130-001,2017,10,7,13,1432,1358,2790,2737
0130-001,2017,10,7,14,1365,1460,2825,2790
0130-001,2017,10,7,15,1343,1466,2809,2825
0130-001,2017,10,7,16,1438,1519,2957,2809
0130-001,2017,10,7,17,1499,1404,2903,2957
0130-001,2017,10,7,18,1605,1566,3171,2903
0130-001,2017,10,7,19,1504,1464,2968,3171
0130-001,2017,10,7,20,1373,1066,2439,2968
0130-001,2017,10,7,21,1028,948,1976,2439
0130-001,2017,10,7,22,895,820,1715,1976
0130-001,2017,10,7,23,621,658,1279,1715
0130-001,2017,10,7,24,466,449,915,1279
0130-001,2017,10,8,1,387,333,720,915
0130-001,2017,10,8,2,300,278,578,720
0130-001,2017,10,8,3,220,213,433,578
0130-001,2017,10,8,4,169,154,323,433
0130-001,2017,10,8,5,199,168,367,323
0130-001,2017,10,8,6,306,262,568,367
0130-001,2017,10,8,7,557,460,1017,568
0130-001,2017,10,8,8,740,606,1346,1017
0130-001,2017,10,8,9,809,705,1514,1346
0130-001,2017,10,8,10,910,847,1757,1514
0130-001,2017,10,8,11,1166,1090,2256,1757
0130-001,2017,10,8,12,1096,1189,2285,2256
0130-001,2017,10,8,13,1223,1322,2545,2285
0130-001,2017,10,8,14,1333,1379,2712,2545
0130-001,2017,10,8,15,1332,1415,2747,2712
0130-001,2017,10,8,16,1384,1524,2908,2747
0130-001,2017,10,8,17,1335,1440,2775,2908
0130-001,2017,10,8,18,1457,1616,3073,2775
0130-001,2017,10,8,19,1328,1480,2808,3073
0130-001,2017,10,8,20,1173,1173,2346,2808
0130-001,2017,10,8,21,958,1061,2019,2346
0130-001,2017,10,8,22,831,843,1674,2019
0130-001,2017,10,8,23,704,599,1303,1674
0130-001,2017,10,8,24,452,493,945,1303
0130-001,2017,10,9,1,331,331,662,945
0130-001,2017,10,9,2,200,219,419,662
0130-001,2017,10,9,3,205,179,384,419
0130-001,2017,10,9,4,132,200,332,384
0130-001,2017,10,9,5,257,238,495,332
0130-001,2017,10,9,6,426,405,831,495
0130-001,2017,10,9,7,1049,696,1745,831
0130-001,2017,10,9,8,1378,917,2295,1745
0130-001,2017,10,9,9,1147,1029,2176,2295
0130-001,2017,10,9,10,1179,1212,2391,2176
0130-001,2017,10,9,11,1279,1335,2614,2391
0130-001,2017,10,9,12,1334,1458,2792,2614
0130-001,2017,10,9,13,1287,1459,2746,2792
0130-001,2017,10,9,14,1402,1650,3052,2746
0130-001,2017,10,9,15,1478,1620,3098,3052
0130-001,2017,10,9,16,1422,1616,3038,3098
0130-001,2017,10,9,17,1450,1694,3144,3038
0130-001,2017,10,9,18,1567,1998,3565,3144
0130-001,2017,10,9,19,1435,1812,3247,3565
0130-001,2017,10,9,20,1226,1347,2573,3247
0130-001,2017,10,9,21,1100,1129,2229,2573
0130-001,2017,10,9,22,853,844,1697,2229
0130-001,2017,10,9,23,638,635,1273,1697
0130-001,2017,10,9,24,415,398,813,1273
0130-001,2017,10,10,1,300,289,589,813
0130-001,2017,10,10,2,162,158,320,589
0130-001,2017,10,10,3,161,136,297,320
0130-001,2017,10,10,4,129,167,296,297
0130-001,2017,10,10,5,254,255,509,296
0130-001,2017,10,10,6,595,499,1094,509
0130-001,2017,10,10,7,1654,1008,2662,1094
0130-001,2017,10,10,8,1605,1644,3249,2662
0130-001,2017,10,10,9,1635,1921,3556,3249
0130-001,2017,10,10,10,1512,1573,3085,3556
0130-001,2017,10,10,11,1653,1572,3225,3085
0130-001,2017,10,10,12,1499,1514,3013,3225
0130-001,2017,10,10,13,1436,1407,2843,3013
0130-001,2017,10,10,14,1531,1648,3179,2843
0130-001,2017,10,10,15,1560,1568,3128,3179
0130-001,2017,10,10,16,1601,1770,3371,3128
0130-001,2017,10,10,17,1585,1975,3560,3371
0130-001,2017,10,10,18,1603,2200,3803,3560
0130-001,2017,10,10,19,1619,2218,3837,3803
0130-001,2017,10,10,20,1315,1889,3204,3837
0130-001,2017,10,10,21,1119,1700,2819,3204
0130-001,2017,10,10,22,995,1217,2212,2819
0130-001,2017,10,10,23,738,847,1585,2212
0130-001,2017,10,10,24,476,491,967,1585
0130-001,2017,10,11,1,335,364,699,967
0130-001,2017,10,11,2,193,196,389,699
0130-001,2017,10,11,3,156,181,337,389
0130-001,2017,10,11,4,162,176,338,337
0130-001,2017,10,11,5,239,251,490,338
0130-001,2017,10,11,6,533,430,963,490
0130-001,2017,10,11,7,1450,882,2332,963
0130-001,2017,10,11,8,1422,1478,2900,2332
0130-001,2017,10,11,9,1553,1717,3270,2900
0130-001,2017,10,11,10,1597,1610,3207,3270
0130-001,2017,10,11,11,1503,1584,3087,3207
0130-001,2017,10,11,12,1526,1536,3062,3087
0130-001,2017,10,11,13,1340,1449,2789,3062
0130-001,2017,10,11,14,1634,1644,3278,2789
0130-001,2017,10,11,15,1618,1642,3260,3278
0130-001,2017,10,11,16,1518,1720,3238,3260
0130-001,2017,10,11,17,1507,1810,3317,3238
0130-001,2017,10,11,18,1568,2116,3684,3317
0130-001,2017,10,11,19,1562,2018,3580,3684
0130-001,2017,10,11,20,1267,1790,3057,3580
0130-001,2017,10,11,21,1111,1648,2759,3057
0130-001,2017,10,11,22,1018,1275,2293,2759
0130-001,2017,10,11,23,778,828,1606,2293
0130-001,2017,10,11,24,525,541,1066,1606
0130-001,2017,10,12,1,361,366,727,1066
0130-001,2017,10,12,2,226,248,474,727
0130-001,2017,10,12,3,162,191,353,474
0130-001,2017,10,12,4,144,200,344,353
0130-001,2017,10,12,5,275,276,551,344
0130-001,2017,10,12,6,567,533,1100,551
0130-001,2017,10,12,7,1582,959,2541,1100
0130-001,2017,10,12,8,1555,1515,3070,2541
0130-001,2017,10,12,9,1563,1826,3389,3070
0130-001,2017,10,12,10,1525,1573,3098,3389
0130-001,2017,10,12,11,1603,1590,3193,3098
0130-001,2017,10,12,12,1613,1548,3161,3193
0130-001,2017,10,12,13,1354,1394,2748,3161
0130-001,2017,10,12,14,1668,1568,3236,2748
0130-001,2017,10,12,15,1631,1538,3169,3236
0130-001,2017,10,12,16,1555,1611,3166,3169
0130-001,2017,10,12,17,1640,1852,3492,3166
0130-001,2017,10,12,18,1549,2098,3647,3492
0130-001,2017,10,12,19,1606,2162,3768,3647
0130-001,2017,10,12,20,1279,1701,2980,3768
0130-001,2017,10,12,21,1129,1655,2784,2980
0130-001,2017,10,12,22,1045,1340,2385,2784
0130-001,2017,10,12,23,773,810,1583,2385
0130-001,2017,10,12,24,523,553,1076,1583
0130-001,2017,10,13,1,373,351,724,1076
0130-001,2017,10,13,2,210,243,453,724
0130-001,2017,10,13,3,182,199,381,453
0130-001,2017,10,13,4,156,189,345,381
0130-001,2017,10,13,5,236,281,517,345
0130-001,2017,10,13,6,576,496,1072,517
0130-001,2017,10,13,7,1599,970,2569,1072
0130-001,2017,10,13,8,1407,1563,2970,2569
0130-001,2017,10,13,9,1659,1765,3424,2970
0130-001,2017,10,13,10,1630,1648,3278,3424
0130-001,2017,10,13,11,1653,1606,3259,3278
0130-001,2017,10,13,12,1626,1675,3301,3259
0130-001,2017,10,13,13,1498,1496,2994,3301
0130-001,2017,10,13,14,1656,1624,3280,2994
0130-001,2017,10,13,15,1695,1744,3439,3280
0130-001,2017,10,13,16,1770,1892,3662,3439
0130-001,2017,10,13,17,1672,1891,3563,3662
0130-001,2017,10,13,18,1636,1776,3412,3563
0130-001,2017,10,13,19,1605,1601,3206,3412
0130-001,2017,10,13,20,1359,1912,3271,3206
0130-001,2017,10,13,21,1183,1617,2800,3271
0130-001,2017,10,13,22,1016,1313,2329,2800
0130-001,2017,10,13,23,849,875,1724,2329
0130-001,2017,10,13,24,596,619,1215,1724
0130-001,2017,10,14,1,449,459,908,1215
0130-001,2017,10,14,2,316,280,596,908
0130-001,2017,10,14,3,254,258,512,596
0130-001,2017,10,14,4,227,253,480,512
0130-001,2017,10,14,5,275,295,570,480
0130-001,2017,10,14,6,536,472,1008,570
0130-001,2017,10,14,7,1128,802,1930,1008
0130-001,2017,10,14,8,1333,1187,2520,1930
0130-001,2017,10,14,9,1318,1552,2870,2520
0130-001,2017,10,14,10,1478,1771,3249,2870
0130-001,2017,10,14,11,1656,1813,3469,3249
0130-001,2017,10,14,12,1606,1761,3367,3469
0130-001,2017,10,14,13,1606,1758,3364,3367
0130-001,2017,10,14,14,1717,1835,3552,3364
0130-001,2017,10,14,15,1697,1776,3473,3552
0130-001,2017,10,14,16,1748,1766,3514,3473
0130-001,2017,10,14,17,1800,1866,3666,3514
0130-001,2017,10,14,18,1786,2089,3875,3666
0130-001,2017,10,14,19,1652,1853,3505,3875
0130-001,2017,10,14,20,1321,1337,2658,3505
0130-001,2017,10,14,21,1105,1104,2209,2658
0130-001,2017,10,14,22,919,919,1838,2209
0130-001,2017,10,14,23,768,637,1405,1838
0130-001,2017,10,14,24,512,534,1046,1405
0130-001,2017,10,15,1,442,423,865,1046
0130-001,2017,10,15,2,278,295,573,865
0130-001,2017,10,15,3,255,202,457,573
0130-001,2017,10,15,4,191,186,377,457
0130-001,2017,10,15,5,175,164,339,377
0130-001,2017,10,15,6,371,295,666,339
0130-001,2017,10,15,7,643,527,1170,666
0130-001,2017,10,15,8,859,751,1610,1170
0130-001,2017,10,15,9,971,924,1895,1610
0130-001,2017,10,15,10,1107,1123,2230,1895
0130-001,2017,10,15,11,1259,1321,2580,2230
0130-001,2017,10,15,12,1209,1363,2572,2580
0130-001,2017,10,15,13,1400,1403,2803,2572
0130-001,2017,10,15,14,1525,1497,3022,2803
0130-001,2017,10,15,15,1577,1652,3229,3022
0130-001,2017,10,15,16,1492,1667,3159,3229
0130-001,2017,10,15,17,1651,1724,3375,3159
0130-001,2017,10,15,18,1613,1732,3345,3375
0130-001,2017,10,15,19,1565,1512,3077,3345
0130-001,2017,10,15,20,1223,1318,2541,3077
0130-001,2017,10,15,21,1107,1054,2161,2541
0130-001,2017,10,15,22,912,862,1774,2161
0130-001,2017,10,15,23,695,645,1340,1774
0130-001,2017,10,15,24,436,390,826,1340
0130-001,2017,10,16,1,278,270,548,826
0130-001,2017,10,16,2,152,162,314,548
0130-001,2017,10,16,3,129,142,271,314
0130-001,2017,10,16,4,126,155,281,271
0130-001,2017,10,16,5,230,239,469,281
0130-001,2017,10,16,6,624,470,1094,469
0130-001,2017,10,16,7,1617,1068,2685,1094
0130-001,2017,10,16,8,1609,1635,3244,2685
0130-001,2017,10,16,9,1645,1869,3514,3244
0130-001,2017,10,16,10,1696,1689,3385,3514
0130-001,2017,10,16,11,1594,1671,3265,3385
0130-001,2017,10,16,12,1559,1580,3139,3265
0130-001,2017,10,16,13,1425,1509,2934,3139
0130-001,2017,10,16,14,1686,1628,3314,2934
0130-001,2017,10,16,15,1628,1712,3340,3314
0130-001,2017,10,16,16,1622,1742,3364,3340
0130-001,2017,10,16,17,1581,1889,3470,3364
0130-001,2017,10,16,18,1699,2161,3860,3470
0130-001,2017,10,16,19,1629,2155,3784,3860
0130-001,2017,10,16,20,1292,1844,3136,3784
0130-001,2017,10,16,21,1111,1668,2779,3136
0130-001,2017,10,16,22,921,1306,2227,2779
0130-001,2017,10,16,23,803,769,1572,2227
0130-001,2017,10,16,24,459,483,942,1572
0130-001,2017,10,17,1,316,333,649,942
0130-001,2017,10,17,2,216,226,442,649
0130-001,2017,10,17,3,145,161,306,442
0130-001,2017,10,17,4,132,193,325,306
0130-001,2017,10,17,5,229,265,494,325
0130-001,2017,10,17,6,619,489,1108,494
0130-001,2017,10,17,7,1600,921,2521,1108
0130-001,2017,10,17,8,1604,1514,3118,2521
0130-001,2017,10,17,9,1593,1934,3527,3118
0130-001,2017,10,17,10,1615,1676,3291,3527
0130-001,2017,10,17,11,1701,1682,3383,3291
0130-001,2017,10,17,12,1574,1599,3173,3383
0130-001,2017,10,17,13,1476,1486,2962,3173
0130-001,2017,10,17,14,1609,1648,3257,2962
0130-001,2017,10,17,15,1601,1617,3218,3257
0130-001,2017,10,17,16,1674,1749,3423,3218
0130-001,2017,10,17,17,1561,1877,3438,3423
0130-001,2017,10,17,18,1683,2068,3751,3438
0130-001,2017,10,17,19,1514,2041,3555,3751
0130-001,2017,10,17,20,1280,1801,3081,3555
0130-001,2017,10,17,21,1149,1644,2793,3081
0130-001,2017,10,17,22,1044,1348,2392,2793
0130-001,2017,10,17,23,783,847,1630,2392
0130-001,2017,10,17,24,500,527,1027,1630
0130-001,2017,10,18,1,347,378,725,1027
0130-001,2017,10,18,2,244,242,486,725
0130-001,2017,10,18,3,151,167,318,486
0130-001,2017,10,18,4,150,200,350,318
0130-001,2017,10,18,5,230,231,461,350
0130-001,2017,10,18,6,604,470,1074,461
0130-001,2017,10,18,7,1560,998,2558,1074
0130-001,2017,10,18,8,1524,1550,3074,2558
0130-001,2017,10,18,9,1641,1956,3597,3074
0130-001,2017,10,18,10,1656,1638,3294,3597
0130-001,2017,10,18,11,1653,1650,3303,3294
0130-001,2017,10,18,12,1514,1510,3024,3303
0130-001,2017,10,18,13,1443,1483,2926,3024
0130-001,2017,10,18,14,1633,1713,3346,2926
0130-001,2017,10,18,15,1641,1662,3303,3346
0130-001,2017,10,18,16,1654,1728,3382,3303
0130-001,2017,10,18,17,1560,1812,3372,3382
0130-001,2017,10,18,18,1679,1971,3650,3372
0130-001,2017,10,18,19,1590,1680,3270,3650
0130-001,2017,10,18,20,1219,1778,2997,3270
0130-001,2017,10,18,21,989,1554,2543,2997
0130-001,2017,10,18,22,1002,1219,2221,2543
0130-001,2017,10,18,23,832,789,1621,2221
0130-001,2017,10,18,24,498,506,1004,1621
0130-001,2017,10,19,1,368,394,762,1004
0130-001,2017,10,19,2,238,259,497,762
0130-001,2017,10,19,3,175,158,333,497
0130-001,2017,10,19,4,146,207,353,333
0130-001,2017,10,19,5,226,255,481,353
0130-001,2017,10,19,6,607,461,1068,481
0130-001,2017,10,19,7,1642,997,2639,1068
0130-001,2017,10,19,8,1618,1559,3177,2639
0130-001,2017,10,19,9,1635,1899,3534,3177
0130-001,2017,10,19,10,1611,1546,3157,3534
0130-001,2017,10,19,11,1555,1643,3198,3157
0130-001,2017,10,19,12,1527,1548,3075,3198
0130-001,2017,10,19,13,1461,1522,2983,3075
0130-001,2017,10,19,14,1642,1655,3297,2983
0130-001,2017,10,19,15,1495,1654,3149,3297
0130-001,2017,10,19,16,1624,1818,3442,3149
0130-001,2017,10,19,17,1512,1986,3498,3442
0130-001,2017,10,19,18,1713,2059,3772,3498
0130-001,2017,10,19,19,1566,1948,3514,3772
0130-001,2017,10,19,20,1296,1713,3009,3514
0130-001,2017,10,19,21,1113,1680,2793,3009
0130-001,2017,10,19,22,1047,1297,2344,2793
0130-001,2017,10,19,23,818,789,1607,2344
0130-001,2017,10,19,24,518,525,1043,1607
0130-001,2017,10,20,1,365,415,780,1043
0130-001,2017,10,20,2,223,226,449,780
0130-001,2017,10,20,3,162,211,373,449
0130-001,2017,10,20,4,151,208,359,373
0130-001,2017,10,20,5,250,274,524,359
0130-001,2017,10,20,6,586,451,1037,524
0130-001,2017,10,20,7,1637,1005,2642,1037
0130-001,2017,10,20,8,1562,1605,3167,2642
0130-001,2017,10,20,9,1610,1837,3447,3167
0130-001,2017,10,20,10,1503,1600,3103,3447
0130-001,2017,10,20,11,1239,1603,2842,3103
0130-001,2017,10,20,12,1511,1547,3058,2842
0130-001,2017,10,20,13,1363,1543,2906,3058
0130-001,2017,10,20,14,1767,1620,3387,2906
0130-001,2017,10,20,15,1606,1783,3389,3387
0130-001,2017,10,20,16,1652,1759,3411,3389
0130-001,2017,10,20,17,1622,1955,3577,3411
0130-001,2017,10,20,18,1785,2023,3808,3577
0130-001,2017,10,20,19,1680,1644,3324,3808
0130-001,2017,10,20,20,1357,1924,3281,3324
0130-001,2017,10,20,21,1192,1708,2900,3281
0130-001,2017,10,20,22,1102,1327,2429,2900
0130-001,2017,10,20,23,973,922,1895,2429
0130-001,2017,10,20,24,649,639,1288,1895
0130-001,2017,10,21,1,495,500,995,1288
0130-001,2017,10,21,2,331,305,636,995
0130-001,2017,10,21,3,268,276,544,636
0130-001,2017,10,21,4,211,269,480,544
0130-001,2017,10,21,5,259,270,529,480
0130-001,2017,10,21,6,537,422,959,529
0130-001,2017,10,21,7,1220,878,2098,959
0130-001,2017,10,21,8,1432,1218,2650,2098
0130-001,2017,10,21,9,1735,1693,3428,2650
0130-001,2017,10,21,10,1662,1728,3390,3428
0130-001,2017,10,21,11,1642,1813,3455,3390
0130-001,2017,10,21,12,1675,1860,3535,3455
0130-001,2017,10,21,13,1528,1920,3448,3535
0130-001,2017,10,21,14,1587,1951,3538,3448
0130-001,2017,10,21,15,1724,1791,3515,3538
0130-001,2017,10,21,16,1695,1853,3548,3515
0130-001,2017,10,21,17,1719,1838,3557,3548
0130-001,2017,10,21,18,1865,1981,3846,3557
0130-001,2017,10,21,19,1760,1763,3523,3846
0130-001,2017,10,21,20,1369,1458,2827,3523
0130-001,2017,10,21,21,1144,1189,2333,2827
0130-001,2017,10,21,22,996,939,1935,2333
0130-001,2017,10,21,23,758,732,1490,1935
0130-001,2017,10,21,24,540,573,1113,1490
0130-001,2017,10,22,1,430,416,846,1113
0130-001,2017,10,22,2,315,275,590,846
0130-001,2017,10,22,3,240,186,426,590
0130-001,2017,10,22,4,177,204,381,426
0130-001,2017,10,22,5,210,164,374,381
0130-001,2017,10,22,6,372,302,674,374
0130-001,2017,10,22,7,617,534,1151,674
0130-001,2017,10,22,8,820,762,1582,1151
0130-001,2017,10,22,9,958,1071,2029,1582
0130-001,2017,10,22,10,1086,1237,2323,2029
0130-001,2017,10,22,11,1386,1294,2680,2323
0130-001,2017,10,22,12,1280,1348,2628,2680
0130-001,2017,10,22,13,1300,1376,2676,2628
0130-001,2017,10,22,14,1459,1479,2938,2676
0130-001,2017,10,22,15,1440,1474,2914,2938
0130-001,2017,10,22,16,1497,1550,3047,2914
0130-001,2017,10,22,17,1563,1573,3136,3047
0130-001,2017,10,22,18,1449,1567,3016,3136
0130-001,2017,10,22,19,1578,1466,3044,3016
0130-001,2017,10,22,20,1307,1180,2487,3044
0130-001,2017,10,22,21,1198,1079,2277,2487
0130-001,2017,10,22,22,904,848,1752,2277
0130-001,2017,10,22,23,656,617,1273,1752
0130-001,2017,10,22,24,429,346,775,1273
0130-001,2017,10,23,1,264,249,513,775
0130-001,2017,10,23,2,169,174,343,513
0130-001,2017,10,23,3,132,105,237,343
0130-001,2017,10,23,4,127,158,285,237
0130-001,2017,10,23,5,230,220,450,285
0130-001,2017,10,23,6,642,508,1150,450
0130-001,2017,10,23,7,1727,993,2720,1150
0130-001,2017,10,23,8,1584,1584,3168,2720
0130-001,2017,10,23,9,1630,1886,3516,3168
0130-001,2017,10,23,10,1559,1631,3190,3516
0130-001,2017,10,23,11,1627,1603,3230,3190
0130-001,2017,10,23,12,1573,1588,3161,3230
0130-001,2017,10,23,13,1460,1464,2924,3161
0130-001,2017,10,23,14,1684,1599,3283,2924
0130-001,2017,10,23,15,1692,1709,3401,3283
0130-001,2017,10,23,16,1739,1734,3473,3401
0130-001,2017,10,23,17,1589,1839,3428,3473
0130-001,2017,10,23,18,1708,2044,3752,3428
0130-001,2017,10,23,19,1581,2079,3660,3752
0130-001,2017,10,23,20,1280,1793,3073,3660
0130-001,2017,10,23,21,1139,1671,2810,3073
0130-001,2017,10,23,22,971,1289,2260,2810
0130-001,2017,10,23,23,745,803,1548,2260
0130-001,2017,10,23,24,463,459,922,1548
0130-001,2017,10,24,1,309,348,657,922
0130-001,2017,10,24,2,196,211,407,657
0130-001,2017,10,24,3,143,181,324,407
0130-001,2017,10,24,4,139,202,341,324
0130-001,2017,10,24,5,220,278,498,341
0130-001,2017,10,24,6,596,468,1064,498
0130-001,2017,10,24,7,1545,1029,2574,1064
0130-001,2017,10,24,8,1659,1525,3184,2574
0130-001,2017,10,24,9,1643,1951,3594,3184
0130-001,2017,10,24,10,1660,1651,3311,3594
0130-001,2017,10,24,11,1513,1620,3133,3311
0130-001,2017,10,24,12,1562,1597,3159,3133
0130-001,2017,10,24,13,1394,1484,2878,3159
0130-001,2017,10,24,14,1589,1505,3094,2878
0130-001,2017,10,24,15,1621,1644,3265,3094
0130-001,2017,10,24,16,1655,1737,3392,3265
0130-001,2017,10,24,17,1521,1818,3339,3392
0130-001,2017,10,24,18,1701,2079,3780,3339
0130-001,2017,10,24,19,1590,2078,3668,3780
0130-001,2017,10,24,20,1216,1700,2916,3668
0130-001,2017,10,24,21,1174,1660,2834,2916
0130-001,2017,10,24,22,1079,1290,2369,2834
0130-001,2017,10,24,23,783,862,1645,2369
0130-001,2017,10,24,24,544,540,1084,1645
0130-001,2017,10,25,1,352,312,664,1084
0130-001,2017,10,25,2,219,251,470,664
0130-001,2017,10,25,3,168,144,312,470
0130-001,2017,10,25,4,146,215,361,312
0130-001,2017,10,25,5,210,296,506,361
0130-001,2017,10,25,6,599,460,1059,506
0130-001,2017,10,25,7,1567,968,2535,1059
0130-001,2017,10,25,8,1488,1565,3053,2535
0130-001,2017,10,25,9,1691,1765,3456,3053
0130-001,2017,10,25,10,1550,1550,3100,3456
0130-001,2017,10,25,11,1548,1571,3119,3100
0130-001,2017,10,25,12,1557,1588,3145,3119
0130-001,2017,10,25,13,1586,1549,3135,3145
0130-001,2017,10,25,14,1660,1660,3320,3135
0130-001,2017,10,25,15,1668,1563,3231,3320
0130-001,2017,10,25,16,1595,1690,3285,3231
0130-001,2017,10,25,17,1606,1895,3501,3285
0130-001,2017,10,25,18,1710,1831,3541,3501
0130-001,2017,10,25,19,1555,1580,3135,3541
0130-001,2017,10,25,20,1237,1769,3006,3135
0130-001,2017,10,25,21,1129,1512,2641,3006
0130-001,2017,10,25,22,1055,1148,2203,2641
0130-001,2017,10,25,23,834,809,1643,2203
0130-001,2017,10,25,24,498,569,1067,1643
0130-001,2017,10,26,1,380,345,725,1067
0130-001,2017,10,26,2,221,261,482,725
0130-001,2017,10,26,3,165,179,344,482
0130-001,2017,10,26,4,168,183,351,344
0130-001,2017,10,26,5,248,270,518,351
0130-001,2017,10,26,6,589,471,1060,518
0130-001,2017,10,26,7,1570,965,2535,1060
0130-001,2017,10,26,8,1649,1599,3248,2535
0130-001,2017,10,26,9,1648,1903,3551,3248
0130-001,2017,10,26,10,1689,1763,3452,3551
0130-001,2017,10,26,11,1696,1677,3373,3452
0130-001,2017,10,26,12,1587,1623,3210,3373
0130-001,2017,10,26,13,1477,1454,2931,3210
0130-001,2017,10,26,14,1676,1706,3382,2931
0130-001,2017,10,26,15,1624,1750,3374,3382
0130-001,2017,10,26,16,1638,1736,3374,3374
0130-001,2017,10,26,17,1631,1769,3400,3374
0130-001,2017,10,26,18,1703,1899,3602,3400
0130-001,2017,10,26,19,1587,1598,3185,3602
0130-001,2017,10,26,20,1251,1733,2984,3185
0130-001,2017,10,26,21,1201,1663,2864,2984
0130-001,2017,10,26,22,1094,1290,2384,2864
0130-001,2017,10,26,23,904,859,1763,2384
0130-001,2017,10,26,24,536,563,1099,1763
0130-001,2017,10,27,1,359,370,729,1099
0130-001,2017,10,27,2,245,227,472,729
0130-001,2017,10,27,3,161,195,356,472
0130-001,2017,10,27,4,163,192,355,356
0130-001,2017,10,27,5,222,271,493,355
0130-001,2017,10,27,6,584,480,1064,493
0130-001,2017,10,27,7,1615,936,2551,1064
0130-001,2017,10,27,8,1678,1623,3301,2551
0130-001,2017,10,27,9,1651,1930,3581,3301
0130-001,2017,10,27,10,1566,1537,3103,3581
0130-001,2017,10,27,11,1654,1660,3314,3103
0130-001,2017,10,27,12,1545,1592,3137,3314
0130-001,2017,10,27,13,1508,1417,2925,3137
0130-001,2017,10,27,14,1700,1698,3398,2925
0130-001,2017,10,27,15,1598,1595,3193,3398
0130-001,2017,10,27,16,1678,1802,3480,3193
0130-001,2017,10,27,17,1727,1833,3560,3480
0130-001,2017,10,27,18,1756,1953,3709,3560
0130-001,2017,10,27,19,1603,1625,3228,3709
0130-001,2017,10,27,20,1379,1876,3255,3228
0130-001,2017,10,27,21,1258,1671,2929,3255
0130-001,2017,10,27,22,1131,1289,2420,2929
0130-001,2017,10,27,23,919,892,1811,2420
0130-001,2017,10,27,24,652,626,1278,1811
0130-001,2017,10,28,1,457,415,872,1278
0130-001,2017,10,28,2,360,331,691,872
0130-001,2017,10,28,3,245,264,509,691
0130-001,2017,10,28,4,234,253,487,509
0130-001,2017,10,28,5,250,289,539,487
0130-001,2017,10,28,6,531,487,1018,539
0130-001,2017,10,28,7,1223,833,2056,1018
0130-001,2017,10,28,8,1383,1300,2683,2056
0130-001,2017,10,28,9,1404,1752,3156,2683
0130-001,2017,10,28,10,1545,1737,3282,3156
0130-001,2017,10,28,11,1618,1884,3502,3282
0130-001,2017,10,28,12,1759,1932,3691,3502
0130-001,2017,10,28,13,1633,1882,3515,3691
0130-001,2017,10,28,14,1655,1939,3594,3515
0130-001,2017,10,28,15,1759,1844,3603,3594
0130-001,2017,10,28,16,1737,1746,3483,3603
0130-001,2017,10,28,17,1733,1865,3598,3483
0130-001,2017,10,28,18,1737,1915,3652,3598
0130-001,2017,10,28,19,1715,1828,3543,3652
0130-001,2017,10,28,20,1515,1465,2980,3543
0130-001,2017,10,28,21,1128,1198,2326,2980
0130-001,2017,10,28,22,1032,947,1979,2326
0130-001,2017,10,28,23,782,679,1461,1979
0130-001,2017,10,28,24,586,519,1105,1461
0130-001,2017,10,29,1,384,366,750,1105
0130-001,2017,10,29,2,325,262,587,750
0130-001,2017,10,29,3,246,194,440,587
0130-001,2017,10,29,4,191,174,365,440
0130-001,2017,10,29,5,191,160,351,365
0130-001,2017,10,29,6,323,280,603,351
0130-001,2017,10,29,7,605,473,1078,603
0130-001,2017,10,29,8,776,767,1543,1078
0130-001,2017,10,29,9,992,987,1979,1543
0130-001,2017,10,29,10,1134,1207,2341,1979
0130-001,2017,10,29,11,1321,1433,2754,2341
0130-001,2017,10,29,12,1294,1437,2731,2754
0130-001,2017,10,29,13,1424,1544,2968,2731
0130-001,2017,10,29,14,1512,1465,2977,2968
0130-001,2017,10,29,15,1532,1517,3049,2977
0130-001,2017,10,29,16,1629,1599,3228,3049
0130-001,2017,10,29,17,1623,1619,3242,3228
0130-001,2017,10,29,18,1654,1643,3297,3242
0130-001,2017,10,29,19,1663,1465,3128,3297
0130-001,2017,10,29,20,1363,1251,2614,3128
0130-001,2017,10,29,21,1268,1005,2273,2614
0130-001,2017,10,29,22,949,871,1820,2273
0130-001,2017,10,29,23,677,561,1238,1820
0130-001,2017,10,29,24,423,362,785,1238
0130-001,2017,10,30,1,275,242,517,785
0130-001,2017,10,30,2,147,145,292,517
0130-001,2017,10,30,3,123,110,233,292
0130-001,2017,10,30,4,136,145,281,233
0130-001,2017,10,30,5,220,236,456,281
0130-001,2017,10,30,6,636,458,1094,456
0130-001,2017,10,30,7,1681,1015,2696,1094
0130-001,2017,10,30,8,1486,1506,2992,2696
0130-001,2017,10,30,9,1559,1853,3412,2992
0130-001,2017,10,30,10,1548,1635,3183,3412
0130-001,2017,10,30,11,1617,1623,3240,3183
0130-001,2017,10,30,12,1618,1503,3121,3240
0130-001,2017,10,30,13,1405,1445,2850,3121
0130-001,2017,10,30,14,1607,1613,3220,2850
0130-001,2017,10,30,15,1575,1538,3113,3220
0130-001,2017,10,30,16,1690,1687,3377,3113
0130-001,2017,10,30,17,1634,1769,3403,3377
0130-001,2017,10,30,18,1710,1877,3587,3403
0130-001,2017,10,30,19,1603,1929,3532,3587
0130-001,2017,10,30,20,1249,1674,2923,3532
0130-001,2017,10,30,21,1116,1616,2732,2923
0130-001,2017,10,30,22,982,1230,2212,2732
0130-001,2017,10,30,23,722,826,1548,2212
0130-001,2017,10,30,24,465,497,962,1548
0130-001,2017,10,31,1,310,366,676,962
0130-001,2017,10,31,2,167,188,355,676
0130-001,2017,10,31,3,132,135,267,355
0130-001,2017,10,31,4,151,158,309,267
0130-001,2017,10,31,5,214,259,473,309
0130-001,2017,10,31,6,533,420,953,473
0130-001,2017,10,31,7,1562,929,2491,953
0130-001,2017,10,31,8,1574,1523,3097,2491
0130-001,2017,10,31,9,1549,1844,3393,3097
0130-001,2017,10,31,10,1616,1649,3265,3393
0130-001,2017,10,31,11,1638,1644,3282,3265
0130-001,2017,10,31,12,1574,1561,3135,3282
0130-001,2017,10,31,13,1391,1388,2779,3135
0130-001,2017,10,31,14,1677,1540,3217,2779
0130-001,2017,10,31,15,1639,1662,3301,3217
0130-001,2017,10,31,16,1697,1698,3395,3301
0130-001,2017,10,31,17,1655,1774,3429,3395
0130-001,2017,10,31,18,1662,1759,3421,3429
0130-001,2017,10,31,19,1601,1753,3354,3421
0130-001,2017,10,31,20,1332,1743,3075,3354
0130-001,2017,10,31,21,1128,1664,2792,3075
0130-001,2017,10,31,22,1061,1227,2288,2792
0130-001,2017,10,31,23,777,800,1577,2288
0130-001,2017,10,31,24,534,521,1055,1577
0130-001,2017,11,1,1,364,405,769,1055
0130-001,2017,11,1,2,235,284,519,769
0130-001,2017,11,1,3,147,213,360,519
0130-001,2017,11,1,4,160,257,417,360
0130-001,2017,11,1,5,213,298,511,417
0130-001,2017,11,1,6,583,528,1111,511
0130-001,2017,11,1,7,1554,1069,2623,1111
0130-001,2017,11,1,8,1589,1624,3213,2623
0130-001,2017,11,1,9,1614,1952,3566,3213
0130-001,2017,11,1,10,1596,1827,3423,3566
0130-001,2017,11,1,11,1735,1686,3421,3423
0130-001,2017,11,1,12,1538,1720,3258,3421
0130-001,2017,11,1,13,1436,1463,2899,3258
0130-001,2017,11,1,14,1661,1763,3424,2899
0130-001,2017,11,1,15,1582,1762,3344,3424
0130-001,2017,11,1,16,1671,1857,3528,3344
0130-001,2017,11,1,17,1514,1925,3439,3528
0130-001,2017,11,1,18,1782,2059,3841,3439
0130-001,2017,11,1,19,1525,1628,3153,3841
0130-001,2017,11,1,20,1296,1814,3110,3153
0130-001,2017,11,1,21,1065,1578,2643,3110
0130-001,2017,11,1,22,1028,1303,2331,2643
0130-001,2017,11,1,23,826,824,1650,2331
0130-001,2017,11,1,24,537,603,1140,1650
0130-001,2017,11,2,1,382,451,833,1140
0130-001,2017,11,2,2,198,250,448,833
0130-001,2017,11,2,3,153,214,367,448
0130-001,2017,11,2,4,167,218,385,367
0130-001,2017,11,2,5,229,289,518,385
0130-001,2017,11,2,6,592,509,1101,518
0130-001,2017,11,2,7,1575,1057,2632,1101
0130-001,2017,11,2,8,1609,1639,3248,2632
0130-001,2017,11,2,9,1599,1937,3536,3248
0130-001,2017,11,2,10,1591,1732,3323,3536
0130-001,2017,11,2,11,1561,1601,3162,3323
0130-001,2017,11,2,12,1526,1592,3118,3162
0130-001,2017,11,2,13,1337,1511,2848,3118
0130-001,2017,11,2,14,1553,1574,3127,2848
0130-001,2017,11,2,15,1656,1670,3326,3127
0130-001,2017,11,2,16,1640,1745,3385,3326
0130-001,2017,11,2,17,1588,1871,3459,3385
0130-001,2017,11,2,18,1684,2023,3707,3459
0130-001,2017,11,2,19,1517,2116,3633,3707
0130-001,2017,11,2,20,1274,1784,3058,3633
0130-001,2017,11,2,21,1154,1675,2829,3058
0130-001,2017,11,2,22,1127,1352,2479,2829
0130-001,2017,11,2,23,810,857,1667,2479
0130-001,2017,11,2,24,532,564,1096,1667
0130-001,2017,11,3,1,376,405,781,1096
0130-001,2017,11,3,2,240,249,489,781
0130-001,2017,11,3,3,177,192,369,489
0130-001,2017,11,3,4,155,192,347,369
0130-001,2017,11,3,5,232,276,508,347
0130-001,2017,11,3,6,562,492,1054,508
0130-001,2017,11,3,7,1491,1109,2600,1054
0130-001,2017,11,3,8,1604,1621,3225,2600
0130-001,2017,11,3,9,1632,2018,3650,3225
0130-001,2017,11,3,10,1441,1584,3025,3650
0130-001,2017,11,3,11,1529,1744,3273,3025
0130-001,2017,11,3,12,1538,1811,3349,3273
0130-001,2017,11,3,13,1404,1581,2985,3349
0130-001,2017,11,3,14,1603,1759,3362,2985
0130-001,2017,11,3,15,1659,1657,3316,3362
0130-001,2017,11,3,16,1695,1789,3484,3316
0130-001,2017,11,3,17,1627,2024,3651,3484
0130-001,2017,11,3,18,1777,2059,3836,3651
0130-001,2017,11,3,19,1608,1445,3053,3836
0130-001,2017,11,3,20,1380,1930,3310,3053
0130-001,2017,11,3,21,1199,1702,2901,3310
0130-001,2017,11,3,22,1126,1360,2486,2901
0130-001,2017,11,3,23,949,902,1851,2486
0130-001,2017,11,3,24,637,661,1298,1851
0130-001,2017,11,4,1,495,518,1013,1298
0130-001,2017,11,4,2,301,309,610,1013
0130-001,2017,11,4,3,242,272,514,610
0130-001,2017,11,4,4,204,258,462,514
0130-001,2017,11,4,5,258,288,546,462
0130-001,2017,11,4,6,507,473,980,546
0130-001,2017,11,4,7,1061,872,1933,980
0130-001,2017,11,4,8,1412,1247,2659,1933
0130-001,2017,11,4,9,1364,1657,3021,2659
0130-001,2017,11,4,10,1376,1753,3129,3021
0130-001,2017,11,4,11,1432,1876,3308,3129
0130-001,2017,11,4,12,1454,2126,3580,3308
0130-001,2017,11,4,13,1453,2001,3454,3580
0130-001,2017,11,4,14,1596,2026,3622,3454
0130-001,2017,11,4,15,1564,1850,3414,3622
0130-001,2017,11,4,16,1695,1925,3620,3414
0130-001,2017,11,4,17,1843,2072,3915,3620
0130-001,2017,11,4,18,1689,2008,3697,3915
0130-001,2017,11,4,19,1758,1688,3446,3697
0130-001,2017,11,4,20,1359,1421,2780,3446
0130-001,2017,11,4,21,1122,1208,2330,2780
0130-001,2017,11,4,22,983,1094,2077,2330
0130-001,2017,11,4,23,776,947,1723,2077
0130-001,2017,11,4,24,489,495,984,1723
0130-001,2017,11,5,1,397,362,759,984
0130-001,2017,11,5,2,329,308,637,759
0130-001,2017,11,5,3,204,222,426,637
0130-001,2017,11,5,4,213,154,367,426
0130-001,2017,11,5,5,170,178,348,367
0130-001,2017,11,5,6,323,262,585,348
0130-001,2017,11,5,7,548,536,1084,585
0130-001,2017,11,5,8,801,755,1556,1084
0130-001,2017,11,5,9,901,1036,1937,1556
0130-001,2017,11,5,10,1024,1288,2312,1937
0130-001,2017,11,5,11,1347,1543,2890,2312
0130-001,2017,11,5,12,1271,1467,2738,2890
0130-001,2017,11,5,13,1345,1650,2995,2738
0130-001,2017,11,5,14,1626,1638,3264,2995
0130-001,2017,11,5,15,1514,1728,3242,3264
0130-001,2017,11,5,16,1649,1785,3434,3242
0130-001,2017,11,5,17,1675,1774,3449,3434
0130-001,2017,11,5,18,1837,1738,3575,3449
0130-001,2017,11,5,19,1748,1513,3261,3575
0130-001,2017,11,5,20,1379,1278,2657,3261
0130-001,2017,11,5,21,1183,1065,2248,2657
0130-001,2017,11,5,22,1002,926,1928,2248
0130-001,2017,11,5,23,750,662,1412,1928
0130-001,2017,11,5,24,437,410,847,1412
0130-001,2017,11,6,1,262,232,494,847
0130-001,2017,11,6,2,169,163,332,494
0130-001,2017,11,6,3,143,120,263,332
0130-001,2017,11,6,4,136,165,301,263
0130-001,2017,11,6,5,249,255,504,301
0130-001,2017,11,6,6,616,455,1071,504
0130-001,2017,11,6,7,1669,1072,2741,1071
0130-001,2017,11,6,8,1300,1674,2974,2741
0130-001,2017,11,6,9,1634,1969,3603,2974
0130-001,2017,11,6,10,1593,1728,3321,3603
0130-001,2017,11,6,11,1634,1798,3432,3321
0130-001,2017,11,6,12,1626,1589,3215,3432
0130-001,2017,11,6,13,1460,1562,3022,3215
0130-001,2017,11,6,14,1723,1710,3433,3022
0130-001,2017,11,6,15,1634,1717,3351,3433
0130-001,2017,11,6,16,1674,1926,3600,3351
0130-001,2017,11,6,17,1652,1953,3605,3600
0130-001,2017,11,6,18,1709,1907,3616,3605
0130-001,2017,11,6,19,1616,1881,3497,3616
0130-001,2017,11,6,20,1164,1832,2996,3497
0130-001,2017,11,6,21,1058,1789,2847,2996
0130-001,2017,11,6,22,983,1216,2199,2847
0130-001,2017,11,6,23,760,786,1546,2199
0130-001,2017,11,6,24,478,532,1010,1546
0130-001,2017,11,7,1,341,392,733,1010
0130-001,2017,11,7,2,196,204,400,733
0130-001,2017,11,7,3,127,179,306,400
0130-001,2017,11,7,4,166,182,348,306
0130-001,2017,11,7,5,215,306,521,348
0130-001,2017,11,7,6,596,505,1101,521
0130-001,2017,11,7,7,1545,1073,2618,1101
0130-001,2017,11,7,8,1661,1585,3246,2618
0130-001,2017,11,7,9,1538,2046,3584,3246
0130-001,2017,11,7,10,1647,1782,3429,3584
0130-001,2017,11,7,11,1606,1793,3399,3429
0130-001,2017,11,7,12,1570,1736,3306,3399
0130-001,2017,11,7,13,1442,1494,2936,3306
0130-001,2017,11,7,14,1580,1794,3374,2936
0130-001,2017,11,7,15,1640,1776,3416,3374
0130-001,2017,11,7,16,1672,1906,3578,3416
0130-001,2017,11,7,17,1592,2033,3625,3578
0130-001,2017,11,7,18,1694,2129,3823,3625
0130-001,2017,11,7,19,1611,1999,3610,3823
0130-001,2017,11,7,20,1254,1845,3099,3610
0130-001,2017,11,7,21,1115,1787,2902,3099
0130-001,2017,11,7,22,1075,1315,2390,2902
0130-001,2017,11,7,23,837,849,1686,2390
0130-001,2017,11,7,24,468,527,995,1686
0130-001,2017,11,8,1,388,396,784,995
0130-001,2017,11,8,2,208,259,467,784
0130-001,2017,11,8,3,153,156,309,467
0130-001,2017,11,8,4,154,217,371,309
0130-001,2017,11,8,5,214,276,490,371
0130-001,2017,11,8,6,569,472,1041,490
0130-001,2017,11,8,7,1569,1006,2575,1041
0130-001,2017,11,8,8,1616,1695,3311,2575
0130-001,2017,11,8,9,1632,2004,3636,3311
0130-001,2017,11,8,10,1663,1811,3474,3636
0130-001,2017,11,8,11,1606,1718,3324,3474
0130-001,2017,11,8,12,1540,1663,3203,3324
0130-001,2017,11,8,13,1381,1525,2906,3203
0130-001,2017,11,8,14,1663,1727,3390,2906
0130-001,2017,11,8,15,1679,1760,3439,3390
0130-001,2017,11,8,16,1641,1839,3480,3439
0130-001,2017,11,8,17,1595,2018,3613,3480
0130-001,2017,11,8,18,1738,2053,3791,3613
0130-001,2017,11,8,19,1542,1641,3183,3791
0130-001,2017,11,8,20,1322,1831,3153,3183
0130-001,2017,11,8,21,1106,1553,2659,3153
0130-001,2017,11,8,22,1114,1171,2285,2659
0130-001,2017,11,8,23,797,860,1657,2285
0130-001,2017,11,8,24,533,557,1090,1657
0130-001,2017,11,9,1,346,334,680,1090
0130-001,2017,11,9,2,205,267,472,680
0130-001,2017,11,9,3,144,194,338,472
0130-001,2017,11,9,4,145,213,358,338
0130-001,2017,11,9,5,235,293,528,358
0130-001,2017,11,9,6,599,488,1087,528
0130-001,2017,11,9,7,1581,1020,2601,1087
0130-001,2017,11,9,8,1558,1565,3123,2601
0130-001,2017,11,9,9,1520,1947,3467,3123
0130-001,2017,11,9,10,1631,1735,3366,3467
0130-001,2017,11,9,11,1638,1737,3375,3366
0130-001,2017,11,9,12,1527,1714,3241,3375
0130-001,2017,11,9,13,1439,1489,2928,3241
0130-001,2017,11,9,14,1626,1742,3368,2928
0130-001,2017,11,9,15,1543,1679,3222,3368
0130-001,2017,11,9,16,1583,1780,3363,3222
0130-001,2017,11,9,17,1679,1976,3655,3363
0130-001,2017,11,9,18,1744,1966,3710,3655
0130-001,2017,11,9,19,1592,1525,3117,3710
0130-001,2017,11,9,20,1256,1751,3007,3117
0130-001,2017,11,9,21,1131,1684,2815,3007
0130-001,2017,11,9,22,1050,1372,2422,2815
0130-001,2017,11,9,23,835,897,1732,2422
0130-001,2017,11,9,24,530,572,1102,1732
0130-001,2017,11,10,1,385,407,792,1102
0130-001,2017,11,10,2,251,267,518,792
0130-001,2017,11,10,3,148,182,330,518
0130-001,2017,11,10,4,141,200,341,330
0130-001,2017,11,10,5,234,277,511,341
0130-001,2017,11,10,6,589,494,1083,511
0130-001,2017,11,10,7,1548,1003,2551,1083
0130-001,2017,11,10,8,1604,1598,3202,2551
0130-001,2017,11,10,9,1591,2059,3650,3202
0130-001,2017,11,10,10,1644,1791,3435,3650
0130-001,2017,11,10,11,1717,1906,3623,3435
0130-001,2017,11,10,12,1638,1731,3369,3623
0130-001,2017,11,10,13,1520,1669,3189,3369
0130-001,2017,11,10,14,1636,1786,3422,3189
0130-001,2017,11,10,15,1592,1755,3347,3422
0130-001,2017,11,10,16,1572,1759,3331,3347
0130-001,2017,11,10,17,1517,1848,3365,3331
0130-001,2017,11,10,18,1614,1869,3483,3365
0130-001,2017,11,10,19,1499,1826,3325,3483
0130-001,2017,11,10,20,1372,1897,3269,3325
0130-001,2017,11,10,21,1141,1726,2867,3269
0130-001,2017,11,10,22,1107,1251,2358,2867
0130-001,2017,11,10,23,901,893,1794,2358
0130-001,2017,11,10,24,569,586,1155,1794
0130-001,2017,11,11,1,473,477,950,1155
0130-001,2017,11,11,2,368,340,708,950
0130-001,2017,11,11,3,223,240,463,708
0130-001,2017,11,11,4,203,245,448,463
0130-001,2017,11,11,5,239,291,530,448
0130-001,2017,11,11,6,515,459,974,530
0130-001,2017,11,11,7,1057,814,1871,974
0130-001,2017,11,11,8,1417,1227,2644,1871
0130-001,2017,11,11,9,1271,1710,2981,2644
0130-001,2017,11,11,10,1414,1760,3174,2981
0130-001,2017,11,11,11,1567,1822,3389,3174
0130-001,2017,11,11,12,1509,2016,3525,3389
0130-001,2017,11,11,13,1533,2002,3535,3525
0130-001,2017,11,11,14,1676,2006,3682,3535
0130-001,2017,11,11,15,1824,1804,3628,3682
0130-001,2017,11,11,16,1768,1899,3667,3628
0130-001,2017,11,11,17,1819,1941,3760,3667
0130-001,2017,11,11,18,1613,1908,3521,3760
0130-001,2017,11,11,19,1607,1780,3387,3521
0130-001,2017,11,11,20,1418,1441,2859,3387
0130-001,2017,11,11,21,1090,1206,2296,2859
0130-001,2017,11,11,22,1030,981,2011,2296
0130-001,2017,11,11,23,784,742,1526,2011
0130-001,2017,11,11,24,537,500,1037,1526
0130-001,2017,11,12,1,401,362,763,1037
0130-001,2017,11,12,2,288,281,569,763
0130-001,2017,11,12,3,224,218,442,569
0130-001,2017,11,12,4,205,187,392,442
0130-001,2017,11,12,5,204,183,387,392
0130-001,2017,11,12,6,329,303,632,387
0130-001,2017,11,12,7,547,472,1019,632
0130-001,2017,11,12,8,780,715,1495,1019
0130-001,2017,11,12,9,896,1006,1902,1495
0130-001,2017,11,12,10,1082,1293,2375,1902
0130-001,2017,11,12,11,1294,1448,2742,2375
0130-001,2017,11,12,12,1233,1460,2693,2742
0130-001,2017,11,12,13,1352,1408,2760,2693
0130-001,2017,11,12,14,1470,1592,3062,2760
0130-001,2017,11,12,15,1496,1682,3178,3062
0130-001,2017,11,12,16,1607,1740,3347,3178
0130-001,2017,11,12,17,1651,1749,3400,3347
0130-001,2017,11,12,18,1649,1706,3355,3400
0130-001,2017,11,12,19,1683,1549,3232,3355
0130-001,2017,11,12,20,1424,1222,2646,3232
0130-001,2017,11,12,21,1256,1109,2365,2646
0130-001,2017,11,12,22,943,902,1845,2365
0130-001,2017,11,12,23,685,629,1314,1845
0130-001,2017,11,12,24,408,418,826,1314
0130-001,2017,11,13,1,252,214,466,826
0130-001,2017,11,13,2,164,165,329,466
0130-001,2017,11,13,3,122,101,223,329
0130-001,2017,11,13,4,135,147,282,223
0130-001,2017,11,13,5,233,250,483,282
0130-001,2017,11,13,6,633,500,1133,483
0130-001,2017,11,13,7,1677,1072,2749,1133
0130-001,2017,11,13,8,1209,1603,2812,2749
0130-001,2017,11,13,9,1535,1990,3525,2812
0130-001,2017,11,13,10,1584,1691,3275,3525
0130-001,2017,11,13,11,1652,1746,3398,3275
0130-001,2017,11,13,12,1400,1675,3075,3398
0130-001,2017,11,13,13,1452,1563,3015,3075
0130-001,2017,11,13,14,1632,1718,3350,3015
0130-001,2017,11,13,15,1582,1696,3278,3350
0130-001,2017,11,13,16,1675,1934,3609,3278
0130-001,2017,11,13,17,1637,1934,3571,3609
0130-001,2017,11,13,18,1685,2026,3711,3571
0130-001,2017,11,13,19,1490,2076,3566,3711
0130-001,2017,11,13,20,1202,1827,3029,3566
0130-001,2017,11,13,21,1048,1655,2703,3029
0130-001,2017,11,13,22,964,1231,2195,2703
0130-001,2017,11,13,23,750,754,1504,2195
0130-001,2017,11,13,24,468,533,1001,1504
0130-001,2017,11,14,1,323,299,622,1001
0130-001,2017,11,14,2,200,226,426,622
0130-001,2017,11,14,3,140,182,322,426
0130-001,2017,11,14,4,132,218,350,322
0130-001,2017,11,14,5,223,289,512,350
0130-001,2017,11,14,6,581,492,1073,512
0130-001,2017,11,14,7,1602,988,2590,1073
0130-001,2017,11,14,8,1515,1556,3071,2590
0130-001,2017,11,14,9,1582,1925,3507,3071
0130-001,2017,11,14,10,1621,1661,3282,3507
0130-001,2017,11,14,11,1622,1753,3375,3282
0130-001,2017,11,14,12,1526,1699,3225,3375
0130-001,2017,11,14,13,1424,1543,2967,3225
0130-001,2017,11,14,14,1643,1755,3398,2967
0130-001,2017,11,14,15,1625,1759,3384,3398
0130-001,2017,11,14,16,1696,1798,3494,3384
0130-001,2017,11,14,17,1648,1991,3639,3494
0130-001,2017,11,14,18,1630,1896,3526,3639
0130-001,2017,11,14,19,1636,2138,3774,3526
0130-001,2017,11,14,20,1210,1860,3070,3774
0130-001,2017,11,14,21,1170,1702,2872,3070
0130-001,2017,11,14,22,1071,1329,2400,2872
0130-001,2017,11,14,23,740,833,1573,2400
0130-001,2017,11,14,24,488,510,998,1573
0130-001,2017,11,15,1,349,376,725,998
0130-001,2017,11,15,2,205,232,437,725
0130-001,2017,11,15,3,159,177,336,437
0130-001,2017,11,15,4,143,182,325,336
0130-001,2017,11,15,5,226,257,483,325
0130-001,2017,11,15,6,581,451,1032,483
0130-001,2017,11,15,7,1506,1011,2517,1032
0130-001,2017,11,15,8,1477,1508,2985,2517
0130-001,2017,11,15,9,1551,1939,3490,2985
0130-001,2017,11,15,10,1649,1807,3456,3490
0130-001,2017,11,15,11,1570,1668,3238,3456
0130-001,2017,11,15,12,1583,1693,3276,3238
0130-001,2017,11,15,13,1437,1527,2964,3276
0130-001,2017,11,15,14,1674,1790,3464,2964
0130-001,2017,11,15,15,1659,1836,3495,3464
0130-001,2017,11,15,16,1594,1820,3414,3495
0130-001,2017,11,15,17,1583,1943,3526,3414
0130-001,2017,11,15,18,1696,1914,3610,3526
0130-001,2017,11,15,19,1659,1939,3598,3610
0130-001,2017,11,15,20,1233,1790,3023,3598
0130-001,2017,11,15,21,1163,1570,2733,3023
0130-001,2017,11,15,22,1018,1172,2190,2733
0130-001,2017,11,15,23,804,809,1613,2190
0130-001,2017,11,15,24,527,558,1085,1613
0130-001,2017,11,16,1,352,369,721,1085
0130-001,2017,11,16,2,233,228,461,721
0130-001,2017,11,16,3,165,196,361,461
0130-001,2017,11,16,4,141,174,315,361
0130-001,2017,11,16,5,196,258,454,315
0130-001,2017,11,16,6,562,438,1000,454
0130-001,2017,11,16,7,1569,895,2464,1000
0130-001,2017,11,16,8,1384,1351,2735,2464
0130-001,2017,11,16,9,1406,1815,3221,2735
0130-001,2017,11,16,10,1459,1598,3057,3221
0130-001,2017,11,16,11,1631,1628,3259,3057
0130-001,2017,11,16,12,1639,1719,3358,3259
0130-001,2017,11,16,13,1495,1587,3082,3358
0130-001,2017,11,16,14,1705,1720,3425,3082
0130-001,2017,11,16,15,1661,1675,3336,3425
0130-001,2017,11,16,16,1603,1826,3429,3336
0130-001,2017,11,16,17,1630,1811,3441,3429
0130-001,2017,11,16,18,1758,1722,3480,3441
0130-001,2017,11,16,19,1567,1581,3148,3480
0130-001,2017,11,16,20,1264,1664,2928,3148
0130-001,2017,11,16,21,1138,1502,2640,2928
0130-001,2017,11,16,22,1038,1230,2268,2640
0130-001,2017,11,16,23,777,803,1580,2268
0130-001,2017,11,16,24,502,504,1006,1580
0130-001,2017,11,17,1,371,365,736,1006
0130-001,2017,11,17,2,203,205,408,736
0130-001,2017,11,17,3,173,178,351,408
0130-001,2017,11,17,4,147,181,328,351
0130-001,2017,11,17,5,203,266,469,328
0130-001,2017,11,17,6,561,416,977,469
0130-001,2017,11,17,7,1533,963,2496,977
0130-001,2017,11,17,8,1380,1437,2817,2496
0130-001,2017,11,17,9,1554,1827,3381,2817
0130-001,2017,11,17,10,1571,1708,3279,3381
0130-001,2017,11,17,11,1628,1740,3368,3279
0130-001,2017,11,17,12,1613,1740,3353,3368
0130-001,2017,11,17,13,1462,1623,3085,3353
0130-001,2017,11,17,14,1669,1778,3447,3085
0130-001,2017,11,17,15,1643,1800,3443,3447
0130-001,2017,11,17,16,1603,1863,3466,3443
0130-001,2017,11,17,17,1624,1848,3472,3466
0130-001,2017,11,17,18,1638,1877,3515,3472
0130-001,2017,11,17,19,1587,1231,2818,3515
0130-001,2017,11,17,20,1370,1841,3211,2818
0130-001,2017,11,17,21,1225,1733,2958,3211
0130-001,2017,11,17,22,1093,1215,2308,2958
0130-001,2017,11,17,23,856,826,1682,2308
0130-001,2017,11,17,24,584,612,1196,1682
0130-001,2017,11,18,1,437,428,865,1196
0130-001,2017,11,18,2,332,248,580,865
0130-001,2017,11,18,3,243,263,506,580
0130-001,2017,11,18,4,191,231,422,506
0130-001,2017,11,18,5,229,277,506,422
0130-001,2017,11,18,6,490,421,911,506
0130-001,2017,11,18,7,1052,781,1833,911
0130-001,2017,11,18,8,1328,1061,2389,1833
0130-001,2017,11,18,9,1334,1525,2859,2389
0130-001,2017,11,18,10,1334,1645,2979,2859
0130-001,2017,11,18,11,1417,1838,3255,2979
0130-001,2017,11,18,12,1712,1961,3673,3255
0130-001,2017,11,18,13,1645,1785,3430,3673
0130-001,2017,11,18,14,1755,1790,3545,3430
0130-001,2017,11,18,15,1808,1771,3579,3545
0130-001,2017,11,18,16,1591,1849,3440,3579
0130-001,2017,11,18,17,1725,1766,3491,3440
0130-001,2017,11,18,18,1780,1758,3538,3491
0130-001,2017,11,18,19,1684,1645,3329,3538
0130-001,2017,11,18,20,1421,1368,2789,3329
0130-001,2017,11,18,21,1067,1166,2233,2789
0130-001,2017,11,18,22,984,933,1917,2233
0130-001,2017,11,18,23,728,662,1390,1917
0130-001,2017,11,18,24,492,405,897,1390
0130-001,2017,11,19,1,377,286,663,897
0130-001,2017,11,19,2,278,194,472,663
0130-001,2017,11,19,3,217,169,386,472
0130-001,2017,11,19,4,192,138,330,386
0130-001,2017,11,19,5,189,141,330,330
0130-001,2017,11,19,6,301,219,520,330
0130-001,2017,11,19,7,509,364,873,520
0130-001,2017,11,19,8,727,542,1269,873
0130-001,2017,11,19,9,946,912,1858,1269
0130-001,2017,11,19,10,1147,1203,2350,1858
0130-001,2017,11,19,11,1344,1423,2767,2350
0130-001,2017,11,19,12,1304,1576,2880,2767
0130-001,2017,11,19,13,1416,1637,3053,2880
0130-001,2017,11,19,14,1596,1645,3241,3053
0130-001,2017,11,19,15,1418,1769,3187,3241
0130-001,2017,11,19,16,1610,1845,3455,3187
0130-001,2017,11,19,17,1689,1790,3479,3455
0130-001,2017,11,19,18,1576,1616,3192,3479
0130-001,2017,11,19,19,1600,1392,2992,3192
0130-001,2017,11,19,20,1416,1110,2526,2992
0130-001,2017,11,19,21,1253,996,2249,2526
0130-001,2017,11,19,22,969,833,1802,2249
0130-001,2017,11,19,23,694,581,1275,1802
0130-001,2017,11,19,24,427,406,833,1275
0130-001,2017,11,20,1,278,245,523,833
0130-001,2017,11,20,2,139,150,289,523
0130-001,2017,11,20,3,114,97,211,289
0130-001,2017,11,20,4,124,160,284,211
0130-001,2017,11,20,5,210,236,446,284
0130-001,2017,11,20,6,612,419,1031,446
0130-001,2017,11,20,7,1633,801,2434,1031
0130-001,2017,11,20,8,1363,1151,2514,2434
0130-001,2017,11,20,9,1539,1592,3131,2514
0130-001,2017,11,20,10,1609,1660,3269,3131
0130-001,2017,11,20,11,1576,1790,3366,3269
0130-001,2017,11,20,12,1516,1710,3226,3366
0130-001,2017,11,20,13,1432,1544,2976,3226
0130-001,2017,11,20,14,1640,1701,3341,2976
0130-001,2017,11,20,15,1676,1717,3393,3341
0130-001,2017,11,20,16,1550,1789,3339,3393
0130-001,2017,11,20,17,1578,1817,3395,3339
0130-001,2017,11,20,18,1659,1981,3640,3395
0130-001,2017,11,20,19,1535,1875,3410,3640
0130-001,2017,11,20,20,1225,1767,2992,3410
0130-001,2017,11,20,21,1034,1654,2688,2992
0130-001,2017,11,20,22,998,1231,2229,2688
0130-001,2017,11,20,23,734,732,1466,2229
0130-001,2017,11,20,24,421,460,881,1466
0130-001,2017,11,21,1,301,321,622,881
0130-001,2017,11,21,2,178,188,366,622
0130-001,2017,11,21,3,150,132,282,366
0130-001,2017,11,21,4,125,168,293,282
0130-001,2017,11,21,5,215,214,429,293
0130-001,2017,11,21,6,552,353,905,429
0130-001,2017,11,21,7,1547,828,2375,905
0130-001,2017,11,21,8,1393,1263,2656,2375
0130-001,2017,11,21,9,1358,1588,2946,2656
0130-001,2017,11,21,10,1656,1682,3338,2946
0130-001,2017,11,21,11,1618,1638,3256,3338
0130-001,2017,11,21,12,1647,1635,3282,3256
0130-001,2017,11,21,13,1456,1575,3031,3282
0130-001,2017,11,21,14,1698,1715,3413,3031
0130-001,2017,11,21,15,1672,1659,3331,3413
0130-001,2017,11,21,16,1688,1691,3379,3331
0130-001,2017,11,21,17,1606,1888,3494,3379
0130-001,2017,11,21,18,1684,1912,3596,3494
0130-001,2017,11,21,19,1573,1919,3492,3596
0130-001,2017,11,21,20,1230,1732,2962,3492
0130-001,2017,11,21,21,1121,1620,2741,2962
0130-001,2017,11,21,22,1066,1263,2329,2741
0130-001,2017,11,21,23,782,739,1521,2329
0130-001,2017,11,21,24,473,514,987,1521
0130-001,2017,11,22,1,344,315,659,987
0130-001,2017,11,22,2,194,262,456,659
0130-001,2017,11,22,3,180,181,361,456
0130-001,2017,11,22,4,144,186,330,361
0130-001,2017,11,22,5,215,258,473,330
0130-001,2017,11,22,6,548,427,975,473
0130-001,2017,11,22,7,1488,992,2480,975
0130-001,2017,11,22,8,1503,1396,2899,2480
0130-001,2017,11,22,9,1514,1898,3412,2899
0130-001,2017,11,22,10,1554,1608,3162,3412
0130-001,2017,11,22,11,1624,1691,3315,3162
0130-001,2017,11,22,12,1616,1608,3224,3315
0130-001,2017,11,22,13,1460,1638,3098,3224
0130-001,2017,11,22,14,1619,1581,3200,3098
0130-001,2017,11,22,15,1575,1652,3227,3200
0130-001,2017,11,22,16,1658,1663,3321,3227
0130-001,2017,11,22,17,1564,1871,3435,3321
0130-001,2017,11,22,18,1736,1903,3639,3435
0130-001,2017,11,22,19,1572,1994,3566,3639
0130-001,2017,11,22,20,1246,1746,2992,3566
0130-001,2017,11,22,21,1061,1408,2469,2992
0130-001,2017,11,22,22,994,1140,2134,2469
0130-001,2017,11,22,23,811,761,1572,2134
0130-001,2017,11,22,24,525,495,1020,1572
0130-001,2017,11,23,1,331,334,665,1020
0130-001,2017,11,23,2,208,234,442,665
0130-001,2017,11,23,3,171,201,372,442
0130-001,2017,11,23,4,156,201,357,372
0130-001,2017,11,23,5,216,239,455,357
0130-001,2017,11,23,6,499,352,851,455
0130-001,2017,11,23,7,1530,828,2358,851
0130-001,2017,11,23,8,1369,1144,2513,2358
0130-001,2017,11,23,9,1419,1503,2922,2513
0130-001,2017,11,23,10,1391,1460,2851,2922
0130-001,2017,11,23,11,1406,1293,2699,2851
0130-001,2017,11,23,12,1454,1688,3142,2699
0130-001,2017,11,23,13,1384,1542,2926,3142
0130-001,2017,11,23,14,1658,1817,3475,2926
0130-001,2017,11,23,15,1624,1650,3274,3475
0130-001,2017,11,23,16,1700,1708,3408,3274
0130-001,2017,11,23,17,1606,1854,3460,3408
0130-001,2017,11,23,18,1721,1542,3263,3460
0130-001,2017,11,23,19,1332,1834,3166,3263
0130-001,2017,11,23,20,1263,1663,2926,3166
0130-001,2017,11,23,21,1109,1517,2626,2926
0130-001,2017,11,23,22,1093,1182,2275,2626
0130-001,2017,11,23,23,809,752,1561,2275
0130-001,2017,11,23,24,458,284,742,1561
0130-001,2017,11,24,1,299,178,477,742
0130-001,2017,11,24,2,205,46,251,477
0130-001,2017,11,24,3,146,65,211,251
0130-001,2017,11,24,4,123,76,199,211
0130-001,2017,11,24,5,177,122,299,199
0130-001,2017,11,24,6,426,225,651,299
0130-001,2017,11,24,7,1275,405,1680,651
0130-001,2017,11,24,8,951,593,1544,1680
0130-001,2017,11,24,9,1188,1166,2354,1544
0130-001,2017,11,24,10,1436,1186,2622,2354
0130-001,2017,11,24,11,1351,1275,2626,2622
0130-001,2017,11,24,12,1367,1298,2665,2626
0130-001,2017,11,24,13,1285,1312,2597,2665
0130-001,2017,11,24,14,1521,1459,2980,2597
0130-001,2017,11,24,15,1534,1320,2854,2980
0130-001,2017,11,24,16,1620,1424,3044,2854
0130-001,2017,11,24,17,1598,1623,3221,3044
0130-001,2017,11,24,18,1445,1594,3039,3221
0130-001,2017,11,24,19,1335,1675,3010,3039
0130-001,2017,11,24,20,1263,1648,2911,3010
0130-001,2017,11,24,21,1057,1421,2478,2911
0130-001,2017,11,24,22,990,1187,2177,2478
0130-001,2017,11,24,23,867,781,1648,2177
0130-001,2017,11,24,24,522,389,911,1648
0130-001,2017,11,25,1,436,276,712,911
0130-001,2017,11,25,2,298,235,533,712
0130-001,2017,11,25,3,242,161,403,533
0130-001,2017,11,25,4,206,199,405,403
0130-001,2017,11,25,5,236,237,473,405
0130-001,2017,11,25,6,396,361,757,473
0130-001,2017,11,25,7,949,670,1619,757
0130-001,2017,11,25,8,1244,1069,2313,1619
0130-001,2017,11,25,9,1377,1508,2885,2313
0130-001,2017,11,25,10,1425,1610,3035,2885
0130-001,2017,11,25,11,1521,1701,3222,3035
0130-001,2017,11,25,12,1625,1728,3353,3222
0130-001,2017,11,25,13,1536,1780,3316,3353
0130-001,2017,11,25,14,1628,1780,3408,3316
0130-001,2017,11,25,15,1651,1706,3357,3408
0130-001,2017,11,25,16,1606,1742,3348,3357
0130-001,2017,11,25,17,1534,1880,3414,3348
0130-001,2017,11,25,18,1648,1661,3309,3414
0130-001,2017,11,25,19,1549,1818,3367,3309
0130-001,2017,11,25,20,1315,1253,2568,3367
0130-001,2017,11,25,21,1051,1079,2130,2568
0130-001,2017,11,25,22,952,1055,2007,2130
0130-001,2017,11,25,23,762,1007,1769,2007
0130-001,2017,11,25,24,495,539,1034,1769
0130-001,2017,11,26,1,400,344,744,1034
0130-001,2017,11,26,2,305,250,555,744
0130-001,2017,11,26,3,224,221,445,555
0130-001,2017,11,26,4,161,168,329,445
0130-001,2017,11,26,5,188,160,348,329
0130-001,2017,11,26,6,285,227,512,348
0130-001,2017,11,26,7,524,389,913,512
0130-001,2017,11,26,8,540,584,1124,913
0130-001,2017,11,26,9,826,902,1728,1124
0130-001,2017,11,26,10,961,1136,2097,1728
0130-001,2017,11,26,11,1136,1302,2438,2097
0130-001,2017,11,26,12,1182,1440,2622,2438
0130-001,2017,11,26,13,1341,1454,2795,2622
0130-001,2017,11,26,14,1460,1446,2906,2795
0130-001,2017,11,26,15,1577,1475,3052,2906
0130-001,2017,11,26,16,1556,1624,3180,3052
0130-001,2017,11,26,17,1487,1615,3102,3180
0130-001,2017,11,26,18,1564,1485,3049,3102
0130-001,2017,11,26,19,1545,1294,2839,3049
0130-001,2017,11,26,20,1424,1184,2608,2839
0130-001,2017,11,26,21,1266,1024,2290,2608
0130-001,2017,11,26,22,1004,782,1786,2290
0130-001,2017,11,26,23,684,597,1281,1786
0130-001,2017,11,26,24,425,375,800,1281
0130-001,2017,11,27,1,259,226,485,800
0130-001,2017,11,27,2,156,147,303,485
0130-001,2017,11,27,3,110,110,220,303
0130-001,2017,11,27,4,118,137,255,220
0130-001,2017,11,27,5,223,197,420,255
0130-001,2017,11,27,6,609,358,967,420
0130-001,2017,11,27,7,1572,794,2366,967
0130-001,2017,11,27,8,1410,1222,2632,2366
0130-001,2017,11,27,9,1379,1529,2908,2632
0130-001,2017,11,27,10,1569,1670,3239,2908
0130-001,2017,11,27,11,1690,1673,3363,3239
0130-001,2017,11,27,12,1535,1672,3207,3363
0130-001,2017,11,27,13,1446,1561,3007,3207
0130-001,2017,11,27,14,1579,1773,3352,3007
0130-001,2017,11,27,15,1673,1632,3305,3352
0130-001,2017,11,27,16,1657,1737,3394,3305
0130-001,2017,11,27,17,1663,1880,3543,3394
0130-001,2017,11,27,18,1716,1982,3698,3543
0130-001,2017,11,27,19,1530,2006,3536,3698
0130-001,2017,11,27,20,1233,1802,3035,3536
0130-001,2017,11,27,21,1063,1589,2652,3035
0130-001,2017,11,27,22,931,1144,2075,2652
0130-001,2017,11,27,23,695,799,1494,2075
0130-001,2017,11,27,24,420,495,915,1494
0130-001,2017,11,28,1,340,311,651,915
0130-001,2017,11,28,2,192,208,400,651
0130-001,2017,11,28,3,146,158,304,400
0130-001,2017,11,28,4,130,194,324,304
0130-001,2017,11,28,5,237,252,489,324
0130-001,2017,11,28,6,531,423,954,489
0130-001,2017,11,28,7,1485,908,2393,954
0130-001,2017,11,28,8,1486,1410,2896,2393
0130-001,2017,11,28,9,1504,1757,3261,2896
0130-001,2017,11,28,10,1513,1672,3185,3261
0130-001,2017,11,28,11,1631,1696,3327,3185
0130-001,2017,11,28,12,1531,1668,3199,3327
0130-001,2017,11,28,13,1423,1560,2983,3199
0130-001,2017,11,28,14,1715,1736,3451,2983
0130-001,2017,11,28,15,1598,1709,3307,3451
0130-001,2017,11,28,16,1577,1745,3322,3307
0130-001,2017,11,28,17,1653,1939,3592,3322
0130-001,2017,11,28,18,1704,1905,3609,3592
0130-001,2017,11,28,19,1559,2025,3584,3609
0130-001,2017,11,28,20,1252,1796,3048,3584
0130-001,2017,11,28,21,1081,1661,2742,3048
0130-001,2017,11,28,22,967,1297,2264,2742
0130-001,2017,11,28,23,763,787,1550,2264
0130-001,2017,11,28,24,527,513,1040,1550
0130-001,2017,11,29,1,353,346,699,1040
0130-001,2017,11,29,2,213,248,461,699
0130-001,2017,11,29,3,174,179,353,461
0130-001,2017,11,29,4,135,185,320,353
0130-001,2017,11,29,5,241,258,499,320
0130-001,2017,11,29,6,531,440,971,499
0130-001,2017,11,29,7,1515,1002,2517,971
0130-001,2017,11,29,8,1558,1453,3011,2517
0130-001,2017,11,29,9,1489,1925,3414,3011
0130-001,2017,11,29,10,1618,1708,3326,3414
0130-001,2017,11,29,11,1614,1679,3293,3326
0130-001,2017,11,29,12,1555,1651,3206,3293
0130-001,2017,11,29,13,1404,1583,2987,3206
0130-001,2017,11,29,14,1597,1686,3283,2987
0130-001,2017,11,29,15,1609,1745,3354,3283
0130-001,2017,11,29,16,1621,1741,3362,3354
0130-001,2017,11,29,17,1522,1907,3429,3362
0130-001,2017,11,29,18,1739,1908,3647,3429
0130-001,2017,11,29,19,1448,1959,3407,3647
0130-001,2017,11,29,20,1226,1768,2994,3407
0130-001,2017,11,29,21,1095,1489,2584,2994
0130-001,2017,11,29,22,1013,1157,2170,2584
0130-001,2017,11,29,23,832,786,1618,2170
0130-001,2017,11,29,24,491,527,1018,1618
0130-001,2017,11,30,1,364,352,716,1018
0130-001,2017,11,30,2,220,231,451,716
0130-001,2017,11,30,3,188,199,387,451
0130-001,2017,11,30,4,160,188,348,387
0130-001,2017,11,30,5,221,249,470,348
0130-001,2017,11,30,6,530,396,926,470
0130-001,2017,11,30,7,1493,862,2355,926
0130-001,2017,11,30,8,1374,1248,2622,2355
0130-001,2017,11,30,9,1396,1665,3061,2622
0130-001,2017,11,30,10,1614,1530,3144,3061
0130-001,2017,11,30,11,1615,1460,3075,3144
0130-001,2017,11,30,12,1476,1704,3180,3075
0130-001,2017,11,30,13,1504,1565,3069,3180
0130-001,2017,11,30,14,1635,1769,3404,3069
0130-001,2017,11,30,15,1522,1663,3185,3404
0130-001,2017,11,30,16,1582,1767,3349,3185
0130-001,2017,11,30,17,1632,1826,3458,3349
0130-001,2017,11,30,18,1594,1632,3226,3458
0130-001,2017,11,30,19,1563,1708,3271,3226
0130-001,2017,11,30,20,1235,1664,2899,3271
0130-001,2017,11,30,21,1073,1509,2582,2899
0130-001,2017,11,30,22,1043,1207,2250,2582
0130-001,2017,11,30,23,815,778,1593,2250
0130-001,2017,11,30,24,522,394,916,1593
0130-001,2017,12,1,1,384,309,693,916
0130-001,2017,12,1,2,231,196,427,693
0130-001,2017,12,1,3,163,149,312,427
0130-001,2017,12,1,4,152,155,307,312
0130-001,2017,12,1,5,239,195,434,307
0130-001,2017,12,1,6,531,355,886,434
0130-001,2017,12,1,7,1490,707,2197,886
0130-001,2017,12,1,8,1387,1355,2742,2197
0130-001,2017,12,1,9,1410,1718,3128,2742
0130-001,2017,12,1,10,1570,1554,3124,3128
0130-001,2017,12,1,11,1622,1594,3216,3124
0130-001,2017,12,1,12,1590,1648,3238,3216
0130-001,2017,12,1,13,1427,1648,3075,3238
0130-001,2017,12,1,14,1658,1810,3468,3075
0130-001,2017,12,1,15,1569,1824,3393,3468
0130-001,2017,12,1,16,1622,1794,3416,3393
0130-001,2017,12,1,17,1678,2052,3730,3416
0130-001,2017,12,1,18,1753,1996,3749,3730
0130-001,2017,12,1,19,1568,2270,3838,3749
0130-001,2017,12,1,20,1352,1993,3345,3838
0130-001,2017,12,1,21,1173,1689,2862,3345
0130-001,2017,12,1,22,1049,1327,2376,2862
0130-001,2017,12,1,23,901,917,1818,2376
0130-001,2017,12,1,24,656,589,1245,1818
0130-001,2017,12,2,1,488,441,929,1245
0130-001,2017,12,2,2,302,292,594,929
0130-001,2017,12,2,3,259,234,493,594
0130-001,2017,12,2,4,210,232,442,493
0130-001,2017,12,2,5,221,249,470,442
0130-001,2017,12,2,6,450,366,816,470
0130-001,2017,12,2,7,991,635,1626,816
0130-001,2017,12,2,8,1258,1067,2325,1626
0130-001,2017,12,2,9,1370,1570,2940,2325
0130-001,2017,12,2,10,1534,1801,3335,2940
0130-001,2017,12,2,11,1601,1939,3540,3335
0130-001,2017,12,2,12,1537,2087,3624,3540
0130-001,2017,12,2,13,1634,2118,3752,3624
0130-001,2017,12,2,14,1568,2063,3631,3752
0130-001,2017,12,2,15,1549,2025,3574,3631
0130-001,2017,12,2,16,1594,2017,3611,3574
0130-001,2017,12,2,17,1617,2101,3718,3611
0130-001,2017,12,2,18,1460,2285,3745,3718
0130-001,2017,12,2,19,1440,2047,3487,3745
0130-001,2017,12,2,20,1242,1261,2503,3487
0130-001,2017,12,2,21,1051,1025,2076,2503
0130-001,2017,12,2,22,983,797,1780,2076
0130-001,2017,12,2,23,769,640,1409,1780
0130-001,2017,12,2,24,559,473,1032,1409
0130-001,2017,12,3,1,423,366,789,1032
0130-001,2017,12,3,2,329,289,618,789
0130-001,2017,12,3,3,244,216,460,618
0130-001,2017,12,3,4,208,154,362,460
0130-001,2017,12,3,5,168,145,313,362
0130-001,2017,12,3,6,255,218,473,313
0130-001,2017,12,3,7,456,351,807,473
0130-001,2017,12,3,8,654,570,1224,807
0130-001,2017,12,3,9,780,943,1723,1224
0130-001,2017,12,3,10,933,1095,2028,1723
0130-001,2017,12,3,11,1133,1342,2475,2028
0130-001,2017,12,3,12,1136,1427,2563,2475
0130-001,2017,12,3,13,1281,1565,2846,2563
0130-001,2017,12,3,14,1288,1663,2951,2846
0130-001,2017,12,3,15,1434,1720,3154,2951
0130-001,2017,12,3,16,1638,1675,3313,3154
0130-001,2017,12,3,17,1567,1715,3282,3313
0130-001,2017,12,3,18,1490,1703,3193,3282
0130-001,2017,12,3,19,1456,1257,2713,3193
0130-001,2017,12,3,20,1197,965,2162,2713
0130-001,2017,12,3,21,1061,796,1857,2162
0130-001,2017,12,3,22,942,708,1650,1857
0130-001,2017,12,3,23,662,476,1138,1650
0130-001,2017,12,3,24,435,290,725,1138
0130-001,2017,12,4,1,265,196,461,725
0130-001,2017,12,4,2,156,129,285,461
0130-001,2017,12,4,3,148,101,249,285
0130-001,2017,12,4,4,133,119,252,249
0130-001,2017,12,4,5,219,176,395,252
0130-001,2017,12,4,6,601,324,925,395
0130-001,2017,12,4,7,1600,764,2364,925
0130-001,2017,12,4,8,1454,1488,2942,2364
0130-001,2017,12,4,9,1481,1797,3278,2942
0130-001,2017,12,4,10,1589,1471,3060,3278
0130-001,2017,12,4,11,1618,1561,3179,3060
0130-001,2017,12,4,12,1517,1525,3042,3179
0130-001,2017,12,4,13,1387,1322,2709,3042
0130-001,2017,12,4,14,1604,1653,3257,2709
0130-001,2017,12,4,15,1681,1700,3381,3257
0130-001,2017,12,4,16,1597,1786,3383,3381
0130-001,2017,12,4,17,1583,1865,3448,3383
0130-001,2017,12,4,18,1690,2181,3871,3448
0130-001,2017,12,4,19,1509,2115,3624,3871
0130-001,2017,12,4,20,1154,1500,2654,3624
0130-001,2017,12,4,21,1033,1467,2500,2654
0130-001,2017,12,4,22,884,1128,2012,2500
0130-001,2017,12,4,23,653,674,1327,2012
0130-001,2017,12,4,24,387,403,790,1327
0130-001,2017,12,5,1,280,278,558,790
0130-001,2017,12,5,2,189,174,363,558
0130-001,2017,12,5,3,148,132,280,363
0130-001,2017,12,5,4,124,164,288,280
0130-001,2017,12,5,5,219,201,420,288
0130-001,2017,12,5,6,488,337,825,420
0130-001,2017,12,5,7,1506,690,2196,825
0130-001,2017,12,5,8,1354,1415,2769,2196
0130-001,2017,12,5,9,1474,1770,3244,2769
0130-001,2017,12,5,10,1680,1545,3225,3244
0130-001,2017,12,5,11,1536,1394,2930,3225
0130-001,2017,12,5,12,1509,1476,2985,2930
0130-001,2017,12,5,13,1397,1526,2923,2985
0130-001,2017,12,5,14,1637,1465,3102,2923
0130-001,2017,12,5,15,1643,1383,3026,3102
0130-001,2017,12,5,16,1648,1814,3462,3026
0130-001,2017,12,5,17,1631,1892,3523,3462
0130-001,2017,12,5,18,1609,2151,3760,3523
0130-001,2017,12,5,19,1565,2196,3761,3760
0130-001,2017,12,5,20,1252,1628,2880,3761
0130-001,2017,12,5,21,1037,1610,2647,2880
0130-001,2017,12,5,22,1034,1229,2263,2647
0130-001,2017,12,5,23,719,787,1506,2263
0130-001,2017,12,5,24,479,515,994,1506
0130-001,2017,12,6,1,338,351,689,994
0130-001,2017,12,6,2,195,204,399,689
0130-001,2017,12,6,3,153,168,321,399
0130-001,2017,12,6,4,132,175,307,321
0130-001,2017,12,6,5,164,238,402,307
0130-001,2017,12,6,6,485,342,827,402
0130-001,2017,12,6,7,1233,720,1953,827
0130-001,2017,12,6,8,975,1474,2449,1953
0130-001,2017,12,6,9,1192,1826,3018,2449
0130-001,2017,12,6,10,1542,1616,3158,3018
0130-001,2017,12,6,11,1492,1555,3047,3158
0130-001,2017,12,6,12,1460,1637,3097,3047
0130-001,2017,12,6,13,1331,1450,2781,3097
0130-001,2017,12,6,14,1544,1649,3193,2781
0130-001,2017,12,6,15,1578,1708,3286,3193
0130-001,2017,12,6,16,1562,1758,3320,3286
0130-001,2017,12,6,17,1458,1937,3395,3320
0130-001,2017,12,6,18,1670,2279,3949,3395
0130-001,2017,12,6,19,1515,2337,3852,3949
0130-001,2017,12,6,20,1140,1654,2794,3852
0130-001,2017,12,6,21,1018,1455,2473,2794
0130-001,2017,12,6,22,945,1111,2056,2473
0130-001,2017,12,6,23,792,742,1534,2056
0130-001,2017,12,6,24,485,480,965,1534
0130-001,2017,12,7,1,383,270,653,965
0130-001,2017,12,7,2,229,184,413,653
0130-001,2017,12,7,3,146,145,291,413
0130-001,2017,12,7,4,149,151,300,291
0130-001,2017,12,7,5,200,197,397,300
0130-001,2017,12,7,6,519,338,857,397
0130-001,2017,12,7,7,1474,726,2200,857
0130-001,2017,12,7,8,1314,1416,2730,2200
0130-001,2017,12,7,9,1416,1846,3262,2730
0130-001,2017,12,7,10,1559,1432,2991,3262
0130-001,2017,12,7,11,1609,1506,3115,2991
0130-001,2017,12,7,12,1502,1570,3072,3115
0130-001,2017,12,7,13,1414,1360,2774,3072
0130-001,2017,12,7,14,1660,1524,3184,2774
0130-001,2017,12,7,15,1626,1522,3148,3184
0130-001,2017,12,7,16,1753,1741,3494,3148
0130-001,2017,12,7,17,1621,1991,3612,3494
0130-001,2017,12,7,18,1616,2191,3807,3612
0130-001,2017,12,7,19,1534,2228,3762,3807
0130-001,2017,12,7,20,1164,1700,2864,3762
0130-001,2017,12,7,21,1071,1494,2565,2864
0130-001,2017,12,7,22,1036,1194,2230,2565
0130-001,2017,12,7,23,841,766,1607,2230
0130-001,2017,12,7,24,490,522,1012,1607
0130-001,2017,12,8,1,389,378,767,1012
0130-001,2017,12,8,2,216,258,474,767
0130-001,2017,12,8,3,156,191,347,474
0130-001,2017,12,8,4,156,211,367,347
0130-001,2017,12,8,5,233,236,469,367
0130-001,2017,12,8,6,509,391,900,469
0130-001,2017,12,8,7,1440,769,2209,900
0130-001,2017,12,8,8,1433,1488,2921,2209
0130-001,2017,12,8,9,1398,1950,3348,2921
0130-001,2017,12,8,10,1592,1614,3206,3348
0130-001,2017,12,8,11,1562,1723,3285,3206
0130-001,2017,12,8,12,1641,1703,3344,3285
0130-001,2017,12,8,13,1400,1634,3034,3344
0130-001,2017,12,8,14,1649,1823,3472,3034
0130-001,2017,12,8,15,1630,1937,3567,3472
0130-001,2017,12,8,16,1752,1881,3633,3567
0130-001,2017,12,8,17,1632,2068,3700,3633
0130-001,2017,12,8,18,1607,2392,3999,3700
0130-001,2017,12,8,19,1654,2378,4032,3999
0130-001,2017,12,8,20,1322,1890,3212,4032
0130-001,2017,12,8,21,1165,1607,2772,3212
0130-001,2017,12,8,22,1090,1289,2379,2772
0130-001,2017,12,8,23,870,872,1742,2379
0130-001,2017,12,8,24,602,585,1187,1742
0130-001,2017,12,9,1,501,480,981,1187
0130-001,2017,12,9,2,344,320,664,981
0130-001,2017,12,9,3,266,242,508,664
0130-001,2017,12,9,4,212,235,447,508
0130-001,2017,12,9,5,216,282,498,447
0130-001,2017,12,9,6,470,372,842,498
0130-001,2017,12,9,7,952,646,1598,842
0130-001,2017,12,9,8,1219,1035,2254,1598
0130-001,2017,12,9,9,1356,1520,2876,2254
0130-001,2017,12,9,10,1506,1756,3262,2876
0130-001,2017,12,9,11,1658,1953,3611,3262
0130-001,2017,12,9,12,1594,2098,3692,3611
0130-001,2017,12,9,13,1598,2111,3709,3692
0130-001,2017,12,9,14,1606,2047,3653,3709
0130-001,2017,12,9,15,1543,2008,3551,3653
0130-001,2017,12,9,16,1534,2093,3627,3551
0130-001,2017,12,9,17,1568,2070,3638,3627
0130-001,2017,12,9,18,1601,2249,3850,3638
0130-001,2017,12,9,19,1588,2042,3630,3850
0130-001,2017,12,9,20,1237,1278,2515,3630
0130-001,2017,12,9,21,997,1012,2009,2515
0130-001,2017,12,9,22,1002,884,1886,2009
0130-001,2017,12,9,23,844,655,1499,1886
0130-001,2017,12,9,24,585,496,1081,1499
0130-001,2017,12,10,1,482,385,867,1081
0130-001,2017,12,10,2,335,308,643,867
0130-001,2017,12,10,3,258,240,498,643
0130-001,2017,12,10,4,211,176,387,498
0130-001,2017,12,10,5,174,173,347,387
0130-001,2017,12,10,6,238,215,453,347
0130-001,2017,12,10,7,465,346,811,453
0130-001,2017,12,10,8,573,565,1138,811
0130-001,2017,12,10,9,703,868,1571,1138
0130-001,2017,12,10,10,890,1063,1953,1571
0130-001,2017,12,10,11,1123,1241,2364,1953
0130-001,2017,12,10,12,1209,1419,2628,2364
0130-001,2017,12,10,13,1339,1544,2883,2628
0130-001,2017,12,10,14,1317,1515,2832,2883
0130-001,2017,12,10,15,1425,1524,2949,2832
0130-001,2017,12,10,16,1484,1594,3078,2949
0130-001,2017,12,10,17,1386,1517,2903,3078
0130-001,2017,12,10,18,1443,1544,2987,2903
0130-001,2017,12,10,19,1386,1181,2567,2987
0130-001,2017,12,10,20,1062,943,2005,2567
0130-001,2017,12,10,21,931,858,1789,2005
0130-001,2017,12,10,22,805,687,1492,1789
0130-001,2017,12,10,23,607,469,1076,1492
0130-001,2017,12,10,24,397,330,727,1076
0130-001,2017,12,11,1,229,201,430,727
0130-001,2017,12,11,2,146,116,262,430
0130-001,2017,12,11,3,124,106,230,262
0130-001,2017,12,11,4,118,133,251,230
0130-001,2017,12,11,5,198,209,407,251
0130-001,2017,12,11,6,551,382,933,407
0130-001,2017,12,11,7,1512,831,2343,933
0130-001,2017,12,11,8,1129,1485,2614,2343
0130-001,2017,12,11,9,1270,1870,3140,2614
0130-001,2017,12,11,10,1400,1632,3032,3140
0130-001,2017,12,11,11,1513,1701,3214,3032
0130-001,2017,12,11,12,1569,1691,3260,3214
0130-001,2017,12,11,13,1389,1590,2979,3260
0130-001,2017,12,11,14,1583,1710,3293,2979
0130-001,2017,12,11,15,1517,1693,3210,3293
0130-001,2017,12,11,16,1612,1785,3397,3210
0130-001,2017,12,11,17,1575,1927,3502,3397
0130-001,2017,12,11,18,1593,2193,3786,3502
0130-001,2017,12,11,19,1419,2287,3706,3786
0130-001,2017,12,11,20,1152,1736,2888,3706
0130-001,2017,12,11,21,929,1539,2468,2888
0130-001,2017,12,11,22,830,1220,2050,2468
0130-001,2017,12,11,23,684,758,1442,2050
0130-001,2017,12,11,24,417,488,905,1442
0130-001,2017,12,12,1,311,331,642,905
0130-001,2017,12,12,2,168,207,375,642
0130-001,2017,12,12,3,151,170,321,375
0130-001,2017,12,12,4,123,171,294,321
0130-001,2017,12,12,5,189,229,418,294
0130-001,2017,12,12,6,470,389,859,418
0130-001,2017,12,12,7,1418,785,2203,859
0130-001,2017,12,12,8,1303,1505,2808,2203
0130-001,2017,12,12,9,1320,1857,3177,2808
0130-001,2017,12,12,10,1527,1397,2924,3177
0130-001,2017,12,12,11,1581,1342,2923,2924
0130-001,2017,12,12,12,1549,1308,2857,2923
0130-001,2017,12,12,13,1412,1206,2618,2857
0130-001,2017,12,12,14,1663,1323,2986,2618
0130-001,2017,12,12,15,1569,1389,2958,2986
0130-001,2017,12,12,16,1612,1428,3040,2958
0130-001,2017,12,12,17,1559,1513,3072,3040
0130-001,2017,12,12,18,1715,1783,3498,3072
0130-001,2017,12,12,19,1529,1860,3389,3498
0130-001,2017,12,12,20,1181,1377,2558,3389
0130-001,2017,12,12,21,1077,1333,2410,2558
0130-001,2017,12,12,22,963,1055,2018,2410
0130-001,2017,12,12,23,739,685,1424,2018
0130-001,2017,12,12,24,525,475,1000,1424
0130-001,2017,12,13,1,380,329,709,1000
0130-001,2017,12,13,2,216,225,441,709
0130-001,2017,12,13,3,162,186,348,441
0130-001,2017,12,13,4,115,196,311,348
0130-001,2017,12,13,5,170,242,412,311
0130-001,2017,12,13,6,468,376,844,412
0130-001,2017,12,13,7,1428,773,2201,844
0130-001,2017,12,13,8,1308,1332,2640,2201
0130-001,2017,12,13,9,1384,1567,2951,2640
0130-001,2017,12,13,10,1534,1356,2890,2951
0130-001,2017,12,13,11,1459,1345,2804,2890
0130-001,2017,12,13,12,1441,1487,2928,2804
0130-001,2017,12,13,13,1421,1546,2967,2928
0130-001,2017,12,13,14,1627,1692,3319,2967
0130-001,2017,12,13,15,1577,1635,3212,3319
0130-001,2017,12,13,16,1564,1597,3161,3212
0130-001,2017,12,13,17,1618,1618,3236,3161
0130-001,2017,12,13,18,1671,2147,3818,3236
0130-001,2017,12,13,19,1580,2413,3993,3818
0130-001,2017,12,13,20,1184,1716,2900,3993
0130-001,2017,12,13,21,1111,1395,2506,2900
0130-001,2017,12,13,22,993,1113,2106,2506
0130-001,2017,12,13,23,809,745,1554,2106
0130-001,2017,12,13,24,502,439,941,1554
0130-001,2017,12,14,1,363,349,712,941
0130-001,2017,12,14,2,198,215,413,712
0130-001,2017,12,14,3,160,168,328,413
0130-001,2017,12,14,4,150,175,325,328
0130-001,2017,12,14,5,199,227,426,325
0130-001,2017,12,14,6,464,336,800,426
0130-001,2017,12,14,7,1422,666,2088,800
0130-001,2017,12,14,8,1351,1395,2746,2088
0130-001,2017,12,14,9,1436,1782,3218,2746
0130-001,2017,12,14,10,1501,1554,3055,3218
0130-001,2017,12,14,11,1635,1588,3223,3055
0130-001,2017,12,14,12,1561,1662,3223,3223
0130-001,2017,12,14,13,1436,1558,2994,3223
0130-001,2017,12,14,14,1690,1677,3367,2994
0130-001,2017,12,14,15,1634,1794,3428,3367
0130-001,2017,12,14,16,1467,1760,3227,3428
0130-001,2017,12,14,17,1492,1903,3395,3227
0130-001,2017,12,14,18,1630,2266,3896,3395
0130-001,2017,12,14,19,1472,2336,3808,3896
0130-001,2017,12,14,20,1200,1729,2929,3808
0130-001,2017,12,14,21,1145,1516,2661,2929
0130-001,2017,12,14,22,1066,1204,2270,2661
0130-001,2017,12,14,23,765,782,1547,2270
0130-001,2017,12,14,24,537,478,1015,1547
0130-001,2017,12,15,1,391,368,759,1015
0130-001,2017,12,15,2,224,241,465,759
0130-001,2017,12,15,3,162,189,351,465
0130-001,2017,12,15,4,143,182,325,351
0130-001,2017,12,15,5,202,253,455,325
0130-001,2017,12,15,6,452,393,845,455
0130-001,2017,12,15,7,1421,713,2134,845
0130-001,2017,12,15,8,1413,1446,2859,2134
0130-001,2017,12,15,9,1380,1733,3113,2859
0130-001,2017,12,15,10,1549,1422,2971,3113
0130-001,2017,12,15,11,1622,1361,2983,2971
0130-001,2017,12,15,12,1585,1499,3084,2983
0130-001,2017,12,15,13,1399,1552,2951,3084
0130-001,2017,12,15,14,1626,1803,3429,2951
0130-001,2017,12,15,15,1564,1806,3370,3429
0130-001,2017,12,15,16,1608,1702,3310,3370
0130-001,2017,12,15,17,1695,1789,3484,3310
0130-001,2017,12,15,18,1560,2338,3898,3484
0130-001,2017,12,15,19,1529,2470,3999,3898
0130-001,2017,12,15,20,1264,1904,3168,3999
0130-001,2017,12,15,21,1190,1554,2744,3168
0130-001,2017,12,15,22,1170,1221,2391,2744
0130-001,2017,12,15,23,920,893,1813,2391
0130-001,2017,12,15,24,654,606,1260,1813
0130-001,2017,12,16,1,530,489,1019,1260
0130-001,2017,12,16,2,351,361,712,1019
0130-001,2017,12,16,3,274,271,545,712
0130-001,2017,12,16,4,240,222,462,545
0130-001,2017,12,16,5,229,242,471,462
0130-001,2017,12,16,6,402,329,731,471
0130-001,2017,12,16,7,889,600,1489,731
0130-001,2017,12,16,8,1162,988,2150,1489
0130-001,2017,12,16,9,1322,1503,2825,2150
0130-001,2017,12,16,10,1433,1672,3105,2825
0130-001,2017,12,16,11,1595,1850,3445,3105
0130-001,2017,12,16,12,1648,1977,3625,3445
0130-001,2017,12,16,13,1576,1986,3562,3625
0130-001,2017,12,16,14,1645,1972,3617,3562
0130-001,2017,12,16,15,1564,1945,3509,3617
0130-001,2017,12,16,16,1643,1905,3548,3509
0130-001,2017,12,16,17,1358,1981,3339,3548
0130-001,2017,12,16,18,1324,2218,3542,3339
0130-001,2017,12,16,19,1324,1870,3194,3542
0130-001,2017,12,16,20,1166,1240,2406,3194
0130-001,2017,12,16,21,1056,872,1928,2406
0130-001,2017,12,16,22,902,876,1778,1928
0130-001,2017,12,16,23,774,649,1423,1778
0130-001,2017,12,16,24,587,527,1114,1423
0130-001,2017,12,17,1,440,410,850,1114
0130-001,2017,12,17,2,362,288,650,850
0130-001,2017,12,17,3,243,232,475,650
0130-001,2017,12,17,4,209,194,403,475
0130-001,2017,12,17,5,163,155,318,403
0130-001,2017,12,17,6,254,241,495,318
0130-001,2017,12,17,7,403,345,748,495
0130-001,2017,12,17,8,570,554,1124,748
0130-001,2017,12,17,9,672,902,1574,1124
0130-001,2017,12,17,10,860,888,1748,1574
0130-001,2017,12,17,11,1136,1228,2364,1748
0130-001,2017,12,17,12,1362,1485,2847,2364
0130-001,2017,12,17,13,1407,1479,2886,2847
0130-001,2017,12,17,14,1479,1539,3018,2886
0130-001,2017,12,17,15,1492,1552,3044,3018
0130-001,2017,12,17,16,1655,1674,3329,3044
0130-001,2017,12,17,17,1573,1647,3220,3329
0130-001,2017,12,17,18,1264,1696,2960,3220
0130-001,2017,12,17,19,1292,1311,2603,2960
0130-001,2017,12,17,20,1144,939,2083,2603
0130-001,2017,12,17,21,1035,806,1841,2083
0130-001,2017,12,17,22,890,637,1527,1841
0130-001,2017,12,17,23,649,443,1092,1527
0130-001,2017,12,17,24,449,290,739,1092
0130-001,2017,12,18,1,267,185,452,739
0130-001,2017,12,18,2,165,130,295,452
0130-001,2017,12,18,3,141,99,240,295
0130-001,2017,12,18,4,100,116,216,240
0130-001,2017,12,18,5,195,200,395,216
0130-001,2017,12,18,6,553,345,898,395
0130-001,2017,12,18,7,1483,780,2263,898
0130-001,2017,12,18,8,1105,1506,2611,2263
0130-001,2017,12,18,9,1320,1828,3148,2611
0130-001,2017,12,18,10,1514,1544,3058,3148
0130-001,2017,12,18,11,1574,1590,3164,3058
0130-001,2017,12,18,12,1435,1571,3006,3164
0130-001,2017,12,18,13,1378,1382,2760,3006
0130-001,2017,12,18,14,1660,1662,3322,2760
0130-001,2017,12,18,15,1607,1731,3338,3322
0130-001,2017,12,18,16,1497,1773,3270,3338
0130-001,2017,12,18,17,1519,1845,3364,3270
0130-001,2017,12,18,18,1608,2188,3796,3364
0130-001,2017,12,18,19,1514,1615,3129,3796
0130-001,2017,12,18,20,1146,1192,2338,3129
0130-001,2017,12,18,21,1086,1109,2195,2338
0130-001,2017,12,18,22,917,858,1775,2195
0130-001,2017,12,18,23,669,520,1189,1775
0130-001,2017,12,18,24,439,348,787,1189
0130-001,2017,12,19,1,332,264,596,787
0130-001,2017,12,19,2,217,160,377,596
0130-001,2017,12,19,3,155,137,292,377
0130-001,2017,12,19,4,143,144,287,292
0130-001,2017,12,19,5,204,189,393,287
0130-001,2017,12,19,6,488,354,842,393
0130-001,2017,12,19,7,1362,746,2108,842
0130-001,2017,12,19,8,1150,1470,2620,2108
0130-001,2017,12,19,9,1133,1770,2903,2620
0130-001,2017,12,19,10,1345,1442,2787,2903
0130-001,2017,12,19,11,1438,1399,2837,2787
0130-001,2017,12,19,12,1425,1418,2843,2837
0130-001,2017,12,19,13,1373,1329,2702,2843
0130-001,2017,12,19,14,1625,1430,3055,2702
0130-001,2017,12,19,15,1646,1447,3093,3055
0130-001,2017,12,19,16,1615,1599,3214,3093
0130-001,2017,12,19,17,1555,1743,3298,3214
0130-001,2017,12,19,18,1403,1947,3350,3298
0130-001,2017,12,19,19,1148,2000,3148,3350
0130-001,2017,12,19,20,1180,1569,2749,3148
0130-001,2017,12,19,21,1095,1463,2558,2749
0130-001,2017,12,19,22,981,1106,2087,2558
0130-001,2017,12,19,23,755,741,1496,2087
0130-001,2017,12,19,24,476,495,971,1496
0130-001,2017,12,20,1,367,302,669,971
0130-001,2017,12,20,2,207,188,395,669
0130-001,2017,12,20,3,167,157,324,395
0130-001,2017,12,20,4,128,148,276,324
0130-001,2017,12,20,5,222,202,424,276
0130-001,2017,12,20,6,486,384,870,424
0130-001,2017,12,20,7,1384,749,2133,870
0130-001,2017,12,20,8,1293,1437,2730,2133
0130-001,2017,12,20,9,1313,1763,3076,2730
0130-001,2017,12,20,10,1518,1494,3012,3076
0130-001,2017,12,20,11,1582,1466,3048,3012
0130-001,2017,12,20,12,1518,1574,3092,3048
0130-001,2017,12,20,13,1471,1487,2958,3092
0130-001,2017,12,20,14,1616,1677,3293,2958
0130-001,2017,12,20,15,1604,1711,3315,3293
0130-001,2017,12,20,16,1678,1651,3329,3315
0130-001,2017,12,20,17,1515,1666,3181,3329
0130-001,2017,12,20,18,1586,2120,3706,3181
0130-001,2017,12,20,19,1403,2252,3655,3706
0130-001,2017,12,20,20,1119,1687,2806,3655
0130-001,2017,12,20,21,1082,1366,2448,2806
0130-001,2017,12,20,22,931,1097,2028,2448
0130-001,2017,12,20,23,774,721,1495,2028
0130-001,2017,12,20,24,456,476,932,1495
0130-001,2017,12,21,1,404,292,696,932
0130-001,2017,12,21,2,230,201,431,696
0130-001,2017,12,21,3,186,169,355,431
0130-001,2017,12,21,4,144,154,298,355
0130-001,2017,12,21,5,201,223,424,298
0130-001,2017,12,21,6,473,336,809,424
0130-001,2017,12,21,7,1370,688,2058,809
0130-001,2017,12,21,8,1219,1398,2617,2058
0130-001,2017,12,21,9,1324,1815,3139,2617
0130-001,2017,12,21,10,1463,1509,2972,3139
0130-001,2017,12,21,11,1564,1518,3082,2972
0130-001,2017,12,21,12,1487,1565,3052,3082
0130-001,2017,12,21,13,1478,1455,2933,3052
0130-001,2017,12,21,14,1532,1573,3105,2933
0130-001,2017,12,21,15,1570,1633,3203,3105
0130-001,2017,12,21,16,1535,1702,3237,3203
0130-001,2017,12,21,17,1706,1901,3607,3237
0130-001,2017,12,21,18,1616,2050,3666,3607
0130-001,2017,12,21,19,1420,2043,3463,3666
0130-001,2017,12,21,20,1129,1658,2787,3463
0130-001,2017,12,21,21,1140,1467,2607,2787
0130-001,2017,12,21,22,1005,1209,2214,2607
0130-001,2017,12,21,23,820,792,1612,2214
0130-001,2017,12,21,24,564,528,1092,1612
0130-001,2017,12,22,1,473,365,838,1092
0130-001,2017,12,22,2,270,283,553,838
0130-001,2017,12,22,3,201,191,392,553
0130-001,2017,12,22,4,157,186,343,392
0130-001,2017,12,22,5,211,231,442,343
0130-001,2017,12,22,6,486,394,880,442
0130-001,2017,12,22,7,1384,808,2192,880
0130-001,2017,12,22,8,1203,1397,2600,2192
0130-001,2017,12,22,9,1263,1814,3077,2600
0130-001,2017,12,22,10,1504,1492,2996,3077
0130-001,2017,12,22,11,1573,1684,3257,2996
0130-001,2017,12,22,12,1595,1662,3257,3257
0130-001,2017,12,22,13,1436,1581,3017,3257
0130-001,2017,12,22,14,1703,1724,3427,3017
0130-001,2017,12,22,15,1569,1764,3333,3427
0130-001,2017,12,22,16,1623,1786,3409,3333
0130-001,2017,12,22,17,1627,2021,3648,3409
0130-001,2017,12,22,18,1625,2290,3915,3648
0130-001,2017,12,22,19,1385,2352,3737,3915
0130-001,2017,12,22,20,1311,1902,3213,3737
0130-001,2017,12,22,21,1208,1524,2732,3213
0130-001,2017,12,22,22,1145,1161,2306,2732
0130-001,2017,12,22,23,901,883,1784,2306
0130-001,2017,12,22,24,652,619,1271,1784
0130-001,2017,12,23,1,579,484,1063,1271
0130-001,2017,12,23,2,355,348,703,1063
0130-001,2017,12,23,3,325,291,616,703
0130-001,2017,12,23,4,246,279,525,616
0130-001,2017,12,23,5,275,270,545,525
0130-001,2017,12,23,6,426,390,816,545
0130-001,2017,12,23,7,918,682,1600,816
0130-001,2017,12,23,8,1167,953,2120,1600
0130-001,2017,12,23,9,1283,1393,2676,2120
0130-001,2017,12,23,10,1462,1650,3112,2676
0130-001,2017,12,23,11,1554,1723,3277,3112
0130-001,2017,12,23,12,1626,1798,3424,3277
0130-001,2017,12,23,13,1561,1829,3390,3424
0130-001,2017,12,23,14,1675,1809,3484,3390
0130-001,2017,12,23,15,1683,1803,3486,3484
0130-001,2017,12,23,16,1560,1782,3342,3486
0130-001,2017,12,23,17,1403,1865,3268,3342
0130-001,2017,12,23,18,1437,1989,3426,3268
0130-001,2017,12,23,19,1387,1853,3240,3426
0130-001,2017,12,23,20,1223,1176,2399,3240
0130-001,2017,12,23,21,1033,967,2000,2399
0130-001,2017,12,23,22,994,859,1853,2000
0130-001,2017,12,23,23,802,652,1454,1853
0130-001,2017,12,23,24,547,455,1002,1454
0130-001,2017,12,24,1,423,369,792,1002
0130-001,2017,12,24,2,364,271,635,792
0130-001,2017,12,24,3,238,214,452,635
0130-001,2017,12,24,4,209,171,380,452
0130-001,2017,12,24,5,176,181,357,380
0130-001,2017,12,24,6,225,234,459,357
0130-001,2017,12,24,7,445,299,744,459
0130-001,2017,12,24,8,512,486,998,744
0130-001,2017,12,24,9,604,762,1366,998
0130-001,2017,12,24,10,802,986,1788,1366
0130-001,2017,12,24,11,1026,1212,2238,1788
0130-001,2017,12,24,12,1039,1144,2183,2238
0130-001,2017,12,24,13,1139,1305,2444,2183
0130-001,2017,12,24,14,1337,1363,2700,2444
0130-001,2017,12,24,15,1320,1364,2684,2700
0130-001,2017,12,24,16,1331,1382,2713,2684
0130-001,2017,12,24,17,1393,1328,2721,2713
0130-001,2017,12,24,18,1254,1303,2557,2721
0130-001,2017,12,24,19,1239,1096,2335,2557
0130-001,2017,12,24,20,910,836,1746,2335
0130-001,2017,12,24,21,812,764,1576,1746
0130-001,2017,12,24,22,774,672,1446,1576
0130-001,2017,12,24,23,589,562,1151,1446
0130-001,2017,12,24,24,432,387,819,1151
0130-001,2017,12,25,1,322,315,637,819
0130-001,2017,12,25,2,246,219,465,637
0130-001,2017,12,25,3,201,156,357,465
0130-001,2017,12,25,4,204,176,380,357
0130-001,2017,12,25,5,219,195,414,380
0130-001,2017,12,25,6,363,297,660,414
0130-001,2017,12,25,7,598,430,1028,660
0130-001,2017,12,25,8,687,572,1259,1028
0130-001,2017,12,25,9,690,692,1382,1259
0130-001,2017,12,25,10,841,940,1781,1382
0130-001,2017,12,25,11,1170,1305,2475,1781
0130-001,2017,12,25,12,1139,1430,2569,2475
0130-001,2017,12,25,13,1315,1578,2893,2569
0130-001,2017,12,25,14,1525,1707,3232,2893
0130-001,2017,12,25,15,1617,1644,3261,3232
0130-001,2017,12,25,16,1644,1588,3232,3261
0130-001,2017,12,25,17,1524,1581,3105,3232
0130-001,2017,12,25,18,1428,1680,3108,3105
0130-001,2017,12,25,19,1320,1269,2589,3108
0130-001,2017,12,25,20,1102,1016,2118,2589
0130-001,2017,12,25,21,1073,885,1958,2118
0130-001,2017,12,25,22,919,685,1604,1958
0130-001,2017,12,25,23,648,562,1210,1604
0130-001,2017,12,25,24,468,362,830,1210
0130-001,2017,12,26,1,302,235,537,830
0130-001,2017,12,26,2,200,181,381,537
0130-001,2017,12,26,3,142,117,259,381
0130-001,2017,12,26,4,134,146,280,259
0130-001,2017,12,26,5,200,218,418,280
0130-001,2017,12,26,6,540,396,936,418
0130-001,2017,12,26,7,1450,823,2273,936
0130-001,2017,12,26,8,1123,1349,2472,2273
0130-001,2017,12,26,9,1254,1741,2995,2472
0130-001,2017,12,26,10,1515,1469,2984,2995
0130-001,2017,12,26,11,1548,1517,3065,2984
0130-001,2017,12,26,12,1563,1557,3120,3065
0130-001,2017,12,26,13,1385,1479,2864,3120
0130-001,2017,12,26,14,1629,1682,3311,2864
0130-001,2017,12,26,15,1625,1680,3305,3311
0130-001,2017,12,26,16,1699,1752,3451,3305
0130-001,2017,12,26,17,1332,1852,3184,3451
0130-001,2017,12,26,18,1222,2134,3356,3184
0130-001,2017,12,26,19,1401,2274,3675,3356
0130-001,2017,12,26,20,1216,1626,2842,3675
0130-001,2017,12,26,21,986,1536,2522,2842
0130-001,2017,12,26,22,918,1085,2003,2522
0130-001,2017,12,26,23,745,749,1494,2003
0130-001,2017,12,26,24,505,443,948,1494
0130-001,2017,12,27,1,380,379,759,948
0130-001,2017,12,27,2,235,193,428,759
0130-001,2017,12,27,3,177,170,347,428
0130-001,2017,12,27,4,150,168,318,347
0130-001,2017,12,27,5,218,220,438,318
0130-001,2017,12,27,6,485,369,854,438
0130-001,2017,12,27,7,1199,796,1995,854
0130-001,2017,12,27,8,1039,1342,2381,1995
0130-001,2017,12,27,9,1295,1739,3034,2381
0130-001,2017,12,27,10,1485,1609,3094,3034
0130-001,2017,12,27,11,1604,1577,3181,3094
0130-001,2017,12,27,12,1640,1630,3270,3181
0130-001,2017,12,27,13,1430,1500,2930,3270
0130-001,2017,12,27,14,1639,1669,3308,2930
0130-001,2017,12,27,15,1653,1571,3224,3308
0130-001,2017,12,27,16,1615,1833,3448,3224
0130-001,2017,12,27,17,1549,1855,3404,3448
0130-001,2017,12,27,18,1628,2109,3737,3404
0130-001,2017,12,27,19,1480,2300,3780,3737
0130-001,2017,12,27,20,1193,1723,2916,3780
0130-001,2017,12,27,21,992,1414,2406,2916
0130-001,2017,12,27,22,976,1054,2030,2406
0130-001,2017,12,27,23,801,712,1513,2030
0130-001,2017,12,27,24,563,500,1063,1513
0130-001,2017,12,28,1,400,363,763,1063
0130-001,2017,12,28,2,264,276,540,763
0130-001,2017,12,28,3,196,179,375,540
0130-001,2017,12,28,4,141,180,321,375
0130-001,2017,12,28,5,207,218,425,321
0130-001,2017,12,28,6,482,383,865,425
0130-001,2017,12,28,7,1355,769,2124,865
0130-001,2017,12,28,8,1236,1396,2632,2124
0130-001,2017,12,28,9,1404,1806,3210,2632
0130-001,2017,12,28,10,1520,1403,2923,3210
0130-001,2017,12,28,11,1624,1563,3187,2923
0130-001,2017,12,28,12,1531,1630,3161,3187
0130-001,2017,12,28,13,1433,1464,2897,3161
0130-001,2017,12,28,14,1627,1649,3276,2897
0130-001,2017,12,28,15,1603,1704,3307,3276
0130-001,2017,12,28,16,1717,1743,3460,3307
0130-001,2017,12,28,17,1544,1972,3516,3460
0130-001,2017,12,28,18,1561,2129,3690,3516
0130-001,2017,12,28,19,1480,2270,3750,3690
0130-001,2017,12,28,20,1217,1695,2912,3750
0130-001,2017,12,28,21,1032,1390,2422,2912
0130-001,2017,12,28,22,947,1110,2057,2422
0130-001,2017,12,28,23,857,819,1676,2057
0130-001,2017,12,28,24,552,552,1104,1676
0130-001,2017,12,29,1,446,409,855,1104
0130-001,2017,12,29,2,299,274,573,855
0130-001,2017,12,29,3,214,216,430,573
0130-001,2017,12,29,4,173,203,376,430
0130-001,2017,12,29,5,235,218,453,376
0130-001,2017,12,29,6,463,407,870,453
0130-001,2017,12,29,7,1333,774,2107,870
0130-001,2017,12,29,8,1533,1356,2889,2107
0130-001,2017,12,29,9,1454,1794,3248,2889
0130-001,2017,12,29,10,1551,1518,3069,3248
0130-001,2017,12,29,11,1640,1645,3285,3069
0130-001,2017,12,29,12,1608,1893,3501,3285
0130-001,2017,12,29,13,1510,1622,3132,3501
0130-001,2017,12,29,14,1611,1778,3389,3132
0130-001,2017,12,29,15,1700,1862,3562,3389
0130-001,2017,12,29,16,1763,2087,3850,3562
0130-001,2017,12,29,17,1632,2075,3707,3850
0130-001,2017,12,29,18,1759,2268,4027,3707
0130-001,2017,12,29,19,1564,2245,3809,4027
0130-001,2017,12,29,20,1378,1491,2869,3809
0130-001,2017,12,29,21,1078,1395,2473,2869
0130-001,2017,12,29,22,1049,1086,2135,2473
0130-001,2017,12,29,23,869,873,1742,2135
0130-001,2017,12,29,24,622,556,1178,1742
0130-001,2017,12,30,1,541,448,989,1178
0130-001,2017,12,30,2,424,346,770,989
0130-001,2017,12,30,3,299,271,570,770
0130-001,2017,12,30,4,240,250,490,570
0130-001,2017,12,30,5,252,247,499,490
0130-001,2017,12,30,6,378,375,753,499
0130-001,2017,12,30,7,756,581,1337,753
0130-001,2017,12,30,8,1027,803,1830,1337
0130-001,2017,12,30,9,1128,1181,2309,1830
0130-001,2017,12,30,10,1379,1498,2877,2309
0130-001,2017,12,30,11,1483,1611,3094,2877
0130-001,2017,12,30,12,1602,1709,3311,3094
0130-001,2017,12,30,13,1559,1737,3296,3311
0130-001,2017,12,30,14,1639,1773,3412,3296
0130-001,2017,12,30,15,1607,1805,3412,3412
0130-001,2017,12,30,16,1615,1818,3433,3412
0130-001,2017,12,30,17,1550,1985,3535,3433
0130-001,2017,12,30,18,1368,2031,3399,3535
0130-001,2017,12,30,19,1282,1655,2937,3399
0130-001,2017,12,30,20,1067,1065,2132,2937
0130-001,2017,12,30,21,928,942,1870,2132
0130-001,2017,12,30,22,882,775,1657,1870
0130-001,2017,12,30,23,669,564,1233,1657
0130-001,2017,12,30,24,526,403,929,1233
0130-001,2017,12,31,1,359,353,712,929
0130-001,2017,12,31,2,294,252,546,712
0130-001,2017,12,31,3,239,206,445,546
0130-001,2017,12,31,4,211,150,361,445
0130-001,2017,12,31,5,174,155,329,361
0130-001,2017,12,31,6,221,205,426,329
0130-001,2017,12,31,7,323,310,633,426
0130-001,2017,12,31,8,429,394,823,633
0130-001,2017,12,31,9,567,602,1169,823
0130-001,2017,12,31,10,786,892,1678,1169
0130-001,2017,12,31,11,1091,1200,2291,1678
0130-001,2017,12,31,12,1099,1253,2352,2291
0130-001,2017,12,31,13,1276,1408,2684,2352
0130-001,2017,12,31,14,1391,1494,2885,2684
0130-001,2017,12,31,15,1409,1529,2938,2885
0130-001,2017,12,31,16,1402,1540,2942,2938
0130-001,2017,12,31,17,1535,1495,3030,2942
0130-001,2017,12,31,18,1469,1408,2877,3030
0130-001,2017,12,31,19,1430,1242,2672,2877
0130-001,2017,12,31,20,1086,964,2050,2672
0130-001,2017,12,31,21,850,806,1656,2050
0130-001,2017,12,31,22,708,670,1378,1656
0130-001,2017,12,31,23,610,618,1228,1378
0130-001,2017,12,31,24,438,432,870,1228
0130-001,2018,1,1,1,447,364,811,870
0130-001,2018,1,1,2,428,354,782,811
0130-001,2018,1,1,3,269,207,476,782
0130-001,2018,1,1,4,195,173,368,476
0130-001,2018,1,1,5,188,144,332,368
0130-001,2018,1,1,6,255,274,529,332
0130-001,2018,1,1,7,386,277,663,529
0130-001,2018,1,1,8,406,377,783,663
0130-001,2018,1,1,9,503,468,971,783
0130-001,2018,1,1,10,667,684,1351,971
0130-001,2018,1,1,11,841,868,1709,1351
0130-001,2018,1,1,12,1294,1162,2456,1709
0130-001,2018,1,1,13,1433,1256,2689,2456
0130-001,2018,1,1,14,1335,1378,2713,2689
0130-001,2018,1,1,15,1380,1435,2815,2713
0130-001,2018,1,1,16,1410,1359,2769,2815
0130-001,2018,1,1,17,1444,1353,2797,2769
0130-001,2018,1,1,18,1411,1465,2876,2797
0130-001,2018,1,1,19,1253,1203,2456,2876
0130-001,2018,1,1,20,1063,946,2009,2456
0130-001,2018,1,1,21,985,864,1849,2009
0130-001,2018,1,1,22,777,670,1447,1849
0130-001,2018,1,1,23,600,532,1132,1447
0130-001,2018,1,1,24,403,325,728,1132
0130-001,2018,1,2,1,238,229,467,728
0130-001,2018,1,2,2,152,135,287,467
0130-001,2018,1,2,3,117,91,208,287
0130-001,2018,1,2,4,123,124,247,208
0130-001,2018,1,2,5,187,166,353,247
0130-001,2018,1,2,6,486,380,866,353
0130-001,2018,1,2,7,1363,776,2139,866
0130-001,2018,1,2,8,1155,1379,2534,2139
0130-001,2018,1,2,9,1313,1708,3021,2534
0130-001,2018,1,2,10,1451,1493,2944,3021
0130-001,2018,1,2,11,1556,1535,3091,2944
0130-001,2018,1,2,12,1546,1529,3075,3091
0130-001,2018,1,2,13,1413,1501,2914,3075
0130-001,2018,1,2,14,1615,1689,3304,2914
0130-001,2018,1,2,15,1545,1662,3207,3304
0130-001,2018,1,2,16,1675,1777,3452,3207
0130-001,2018,1,2,17,1562,1742,3304,3452
0130-001,2018,1,2,18,1676,2052,3728,3304
0130-001,2018,1,2,19,1394,2198,3592,3728
0130-001,2018,1,2,20,1105,1619,2724,3592
0130-001,2018,1,2,21,1005,1466,2471,2724
0130-001,2018,1,2,22,853,906,1759,2471
0130-001,2018,1,2,23,635,651,1286,1759
0130-001,2018,1,2,24,445,430,875,1286
0130-001,2018,1,3,1,298,295,593,875
0130-001,2018,1,3,2,187,189,376,593
0130-001,2018,1,3,3,151,139,290,376
0130-001,2018,1,3,4,140,179,319,290
0130-001,2018,1,3,5,195,242,437,319
0130-001,2018,1,3,6,499,377,876,437
0130-001,2018,1,3,7,1370,811,2181,876
0130-001,2018,1,3,8,1395,1361,2756,2181
0130-001,2018,1,3,9,1514,1779,3293,2756
0130-001,2018,1,3,10,1541,1489,3030,3293
0130-001,2018,1,3,11,1584,1561,3145,3030
0130-001,2018,1,3,12,1542,1598,3140,3145
0130-001,2018,1,3,13,1421,1447,2868,3140
0130-001,2018,1,3,14,1574,1683,3257,2868
0130-001,2018,1,3,15,1599,1634,3233,3257
0130-001,2018,1,3,16,1536,1720,3256,3233
0130-001,2018,1,3,17,1500,1853,3353,3256
0130-001,2018,1,3,18,1647,2160,3807,3353
0130-001,2018,1,3,19,1538,2251,3789,3807
0130-001,2018,1,3,20,1221,1715,2936,3789
0130-001,2018,1,3,21,1048,1516,2564,2936
0130-001,2018,1,3,22,906,1105,2011,2564
0130-001,2018,1,3,23,696,670,1366,2011
0130-001,2018,1,3,24,516,445,961,1366
0130-001,2018,1,4,1,320,281,601,961
0130-001,2018,1,4,2,200,178,378,601
0130-001,2018,1,4,3,149,168,317,378
0130-001,2018,1,4,4,142,146,288,317
0130-001,2018,1,4,5,202,238,440,288
0130-001,2018,1,4,6,503,402,905,440
0130-001,2018,1,4,7,1385,783,2168,905
0130-001,2018,1,4,8,1343,1376,2719,2168
0130-001,2018,1,4,9,1409,1746,3155,2719
0130-001,2018,1,4,10,1485,1509,2994,3155
0130-001,2018,1,4,11,1533,1535,3068,2994
0130-001,2018,1,4,12,1528,1513,3041,3068
0130-001,2018,1,4,13,1415,1518,2933,3041
0130-001,2018,1,4,14,1578,1705,3283,2933
0130-001,2018,1,4,15,1642,1629,3271,3283
0130-001,2018,1,4,16,1607,1676,3283,3271
0130-001,2018,1,4,17,1458,1785,3243,3283
0130-001,2018,1,4,18,1553,2025,3578,3243
0130-001,2018,1,4,19,1511,2196,3707,3578
0130-001,2018,1,4,20,1175,1631,2806,3707
0130-001,2018,1,4,21,1008,1491,2499,2806
0130-001,2018,1,4,22,920,1018,1938,2499
0130-001,2018,1,4,23,679,698,1377,1938
0130-001,2018,1,4,24,473,424,897,1377
0130-001,2018,1,5,1,310,323,633,897
0130-001,2018,1,5,2,230,203,433,633
0130-001,2018,1,5,3,162,142,304,433
0130-001,2018,1,5,4,151,186,337,304
0130-001,2018,1,5,5,197,214,411,337
0130-001,2018,1,5,6,479,380,859,411
0130-001,2018,1,5,7,1378,804,2182,859
0130-001,2018,1,5,8,1350,1317,2667,2182
0130-001,2018,1,5,9,1425,1710,3135,2667
0130-001,2018,1,5,10,1578,1561,3139,3135
0130-001,2018,1,5,11,1519,1618,3137,3139
0130-001,2018,1,5,12,1598,1662,3260,3137
0130-001,2018,1,5,13,1416,1461,2877,3260
0130-001,2018,1,5,14,1594,1673,3267,2877
0130-001,2018,1,5,15,1646,1584,3230,3267
0130-001,2018,1,5,16,1668,1853,3521,3230
0130-001,2018,1,5,17,1587,1886,3473,3521
0130-001,2018,1,5,18,1676,2180,3856,3473
0130-001,2018,1,5,19,1600,2349,3949,3856
0130-001,2018,1,5,20,1372,1875,3247,3949
0130-001,2018,1,5,21,1148,1538,2686,3247
0130-001,2018,1,5,22,1059,1143,2202,2686
0130-001,2018,1,5,23,817,757,1574,2202
0130-001,2018,1,5,24,580,536,1116,1574
0130-001,2018,1,6,1,437,387,824,1116
0130-001,2018,1,6,2,321,282,603,824
0130-001,2018,1,6,3,286,244,530,603
0130-001,2018,1,6,4,222,247,469,530
0130-001,2018,1,6,5,234,288,522,469
0130-001,2018,1,6,6,448,371,819,522
0130-001,2018,1,6,7,894,654,1548,819
0130-001,2018,1,6,8,1177,903,2080,1548
0130-001,2018,1,6,9,1239,1282,2521,2080
0130-001,2018,1,6,10,1492,1471,2963,2521
0130-001,2018,1,6,11,1588,1644,3232,2963
0130-001,2018,1,6,12,1473,1688,3161,3232
0130-001,2018,1,6,13,1467,1653,3120,3161
0130-001,2018,1,6,14,1599,1698,3297,3120
0130-001,2018,1,6,15,1570,1692,3262,3297
0130-001,2018,1,6,16,1750,1790,3540,3262
0130-001,2018,1,6,17,1421,1888,3309,3540
0130-001,2018,1,6,18,1410,1969,3379,3309
0130-001,2018,1,6,19,1483,1792,3275,3379
0130-001,2018,1,6,20,1184,1161,2345,3275
0130-001,2018,1,6,21,942,1014,1956,2345
0130-001,2018,1,6,22,899,754,1653,1956
0130-001,2018,1,6,23,707,568,1275,1653
0130-001,2018,1,6,24,488,438,926,1275
0130-001,2018,1,7,1,399,316,715,926
0130-001,2018,1,7,2,298,259,557,715
0130-001,2018,1,7,3,229,202,431,557
0130-001,2018,1,7,4,181,164,345,431
0130-001,2018,1,7,5,170,156,326,345
0130-001,2018,1,7,6,223,229,452,326
0130-001,2018,1,7,7,433,376,809,452
0130-001,2018,1,7,8,489,464,953,809
0130-001,2018,1,7,9,666,746,1412,953
0130-001,2018,1,7,10,809,926,1735,1412
0130-001,2018,1,7,11,1114,1203,2317,1735
0130-001,2018,1,7,12,1022,1263,2285,2317
0130-001,2018,1,7,13,1177,1354,2531,2285
0130-001,2018,1,7,14,1371,1525,2896,2531
0130-001,2018,1,7,15,1423,1557,2980,2896
0130-001,2018,1,7,16,1566,1495,3061,2980
0130-001,2018,1,7,17,1505,1490,2995,3061
0130-001,2018,1,7,18,1225,1389,2614,2995
0130-001,2018,1,7,19,1310,1182,2492,2614
0130-001,2018,1,7,20,1098,937,2035,2492
0130-001,2018,1,7,21,951,804,1755,2035
0130-001,2018,1,7,22,798,668,1466,1755
0130-001,2018,1,7,23,592,467,1059,1466
0130-001,2018,1,7,24,375,319,694,1059
0130-001,2018,1,8,1,259,216,475,694
0130-001,2018,1,8,2,169,141,310,475
0130-001,2018,1,8,3,120,115,235,310
0130-001,2018,1,8,4,123,133,256,235
0130-001,2018,1,8,5,202,186,388,256
0130-001,2018,1,8,6,528,367,895,388
0130-001,2018,1,8,7,1440,826,2266,895
0130-001,2018,1,8,8,1368,1408,2776,2266
0130-001,2018,1,8,9,1363,1670,3033,2776
0130-001,2018,1,8,10,1465,1505,2970,3033
0130-001,2018,1,8,11,1480,1468,2948,2970
0130-001,2018,1,8,12,1467,1498,2965,2948
0130-001,2018,1,8,13,1346,1354,2700,2965
0130-001,2018,1,8,14,1493,1602,3095,2700
0130-001,2018,1,8,15,1565,1557,3122,3095
0130-001,2018,1,8,16,1551,1695,3246,3122
0130-001,2018,1,8,17,1421,1785,3206,3246
0130-001,2018,1,8,18,1573,2028,3601,3206
0130-001,2018,1,8,19,1484,2098,3582,3601
0130-001,2018,1,8,20,1112,1627,2739,3582
0130-001,2018,1,8,21,916,1451,2367,2739
0130-001,2018,1,8,22,798,1010,1808,2367
0130-001,2018,1,8,23,621,611,1232,1808
0130-001,2018,1,8,24,371,376,747,1232
0130-001,2018,1,9,1,252,240,492,747
0130-001,2018,1,9,2,156,157,313,492
0130-001,2018,1,9,3,109,147,256,313
0130-001,2018,1,9,4,124,136,260,256
0130-001,2018,1,9,5,145,155,300,260
0130-001,2018,1,9,6,364,295,659,300
0130-001,2018,1,9,7,1153,690,1843,659
0130-001,2018,1,9,8,679,1021,1700,1843
0130-001,2018,1,9,9,775,1237,2012,1700
0130-001,2018,1,9,10,1202,1107,2309,2012
0130-001,2018,1,9,11,1364,1214,2578,2309
0130-001,2018,1,9,12,1252,1205,2457,2578
0130-001,2018,1,9,13,1194,1226,2420,2457
0130-001,2018,1,9,14,1401,1369,2770,2420
0130-001,2018,1,9,15,1391,1406,2797,2770
0130-001,2018,1,9,16,1367,1464,2831,2797
0130-001,2018,1,9,17,1210,1321,2531,2831
0130-001,2018,1,9,18,1246,1264,2510,2531
0130-001,2018,1,9,19,873,835,1708,2510
0130-001,2018,1,9,20,745,1041,1786,1708
0130-001,2018,1,9,21,713,1163,1876,1786
0130-001,2018,1,9,22,629,981,1610,1876
0130-001,2018,1,9,23,519,458,977,1610
0130-001,2018,1,9,24,311,286,597,977
0130-001,2018,1,10,1,195,224,419,597
0130-001,2018,1,10,2,122,149,271,419
0130-001,2018,1,10,3,105,104,209,271
0130-001,2018,1,10,4,67,110,177,209
0130-001,2018,1,10,5,153,164,317,177
0130-001,2018,1,10,6,350,276,626,317
0130-001,2018,1,10,7,998,578,1576,626
0130-001,2018,1,10,8,518,813,1331,1576
0130-001,2018,1,10,9,674,1050,1724,1331
0130-001,2018,1,10,10,863,1045,1908,1724
0130-001,2018,1,10,11,1071,1113,2184,1908
0130-001,2018,1,10,12,1227,1290,2517,2184
0130-001,2018,1,10,13,1212,1203,2415,2517
0130-001,2018,1,10,14,1373,1495,2868,2415
0130-001,2018,1,10,15,1374,1446,2820,2868
0130-001,2018,1,10,16,1450,1542,2992,2820
0130-001,2018,1,10,17,1313,1610,2923,2992
0130-001,2018,1,10,18,1451,1872,3323,2923
0130-001,2018,1,10,19,1443,1920,3363,3323
0130-001,2018,1,10,20,1052,1492,2544,3363
0130-001,2018,1,10,21,868,1172,2040,2544
0130-001,2018,1,10,22,778,878,1656,2040
0130-001,2018,1,10,23,600,597,1197,1656
0130-001,2018,1,10,24,431,363,794,1197
0130-001,2018,1,11,1,282,283,565,794
0130-001,2018,1,11,2,180,179,359,565
0130-001,2018,1,11,3,157,139,296,359
0130-001,2018,1,11,4,124,139,263,296
0130-001,2018,1,11,5,176,174,350,263
0130-001,2018,1,11,6,413,351,764,350
0130-001,2018,1,11,7,1235,696,1931,764
0130-001,2018,1,11,8,949,1281,2230,1931
0130-001,2018,1,11,9,1074,1567,2641,2230
0130-001,2018,1,11,10,1323,1305,2628,2641
0130-001,2018,1,11,11,1412,1341,2753,2628
0130-001,2018,1,11,12,1447,1402,2849,2753
0130-001,2018,1,11,13,1265,1329,2594,2849
0130-001,2018,1,11,14,1344,1401,2745,2594
0130-001,2018,1,11,15,1420,1348,2768,2745
0130-001,2018,1,11,16,1013,1441,2454,2768
0130-001,2018,1,11,17,910,1566,2476,2454
0130-001,2018,1,11,18,863,1843,2706,2476
0130-001,2018,1,11,19,784,1243,2027,2706
0130-001,2018,1,11,20,930,1525,2455,2027
0130-001,2018,1,11,21,788,1219,2007,2455
0130-001,2018,1,11,22,740,814,1554,2007
0130-001,2018,1,11,23,525,483,1008,1554
0130-001,2018,1,11,24,356,347,703,1008
0130-001,2018,1,12,1,229,251,480,703
0130-001,2018,1,12,2,153,170,323,480
0130-001,2018,1,12,3,129,143,272,323
0130-001,2018,1,12,4,134,142,276,272
0130-001,2018,1,12,5,161,176,337,276
0130-001,2018,1,12,6,396,322,718,337
0130-001,2018,1,12,7,1129,689,1818,718
0130-001,2018,1,12,8,918,1191,2109,1818
0130-001,2018,1,12,9,1035,1463,2498,2109
0130-001,2018,1,12,10,1263,1316,2579,2498
0130-001,2018,1,12,11,1478,1435,2913,2579
0130-001,2018,1,12,12,1430,1451,2881,2913
0130-001,2018,1,12,13,1385,1444,2829,2881
0130-001,2018,1,12,14,1544,1518,3062,2829
0130-001,2018,1,12,15,1560,1639,3199,3062
0130-001,2018,1,12,16,1575,1710,3285,3199
0130-001,2018,1,12,17,1579,1770,3349,3285
0130-001,2018,1,12,18,1718,1992,3710,3349
0130-001,2018,1,12,19,1580,2037,3617,3710
0130-001,2018,1,12,20,1309,1756,3065,3617
0130-001,2018,1,12,21,1019,1376,2395,3065
0130-001,2018,1,12,22,954,1029,1983,2395
0130-001,2018,1,12,23,763,689,1452,1983
0130-001,2018,1,12,24,524,475,999,1452
0130-001,2018,1,13,1,386,364,750,999
0130-001,2018,1,13,2,317,267,584,750
0130-001,2018,1,13,3,191,176,367,584
0130-001,2018,1,13,4,174,218,392,367
0130-001,2018,1,13,5,185,192,377,392
0130-001,2018,1,13,6,352,299,651,377
0130-001,2018,1,13,7,716,517,1233,651
0130-001,2018,1,13,8,958,727,1685,1233
0130-001,2018,1,13,9,1157,1041,2198,1685
0130-001,2018,1,13,10,1285,1244,2529,2198
0130-001,2018,1,13,11,1390,1454,2844,2529
0130-001,2018,1,13,12,1372,1563,2935,2844
0130-001,2018,1,13,13,1474,1562,3036,2935
0130-001,2018,1,13,14,1557,1736,3293,3036
0130-001,2018,1,13,15,1489,1684,3173,3293
0130-001,2018,1,13,16,1538,1657,3195,3173
0130-001,2018,1,13,17,1596,1771,3367,3195
0130-001,2018,1,13,18,1388,1842,3230,3367
0130-001,2018,1,13,19,1191,1517,2708,3230
0130-001,2018,1,13,20,1096,1009,2105,2708
0130-001,2018,1,13,21,960,918,1878,2105
0130-001,2018,1,13,22,821,735,1556,1878
0130-001,2018,1,13,23,707,560,1267,1556
0130-001,2018,1,13,24,465,380,845,1267
0130-001,2018,1,14,1,330,309,639,845
0130-001,2018,1,14,2,262,235,497,639
0130-001,2018,1,14,3,215,198,413,497
0130-001,2018,1,14,4,168,164,332,413
0130-001,2018,1,14,5,171,173,344,332
0130-001,2018,1,14,6,224,211,435,344
0130-001,2018,1,14,7,409,337,746,435
0130-001,2018,1,14,8,473,423,896,746
0130-001,2018,1,14,9,623,674,1297,896
0130-001,2018,1,14,10,851,950,1801,1297
0130-001,2018,1,14,11,1067,1128,2195,1801
0130-001,2018,1,14,12,1144,1226,2370,2195
0130-001,2018,1,14,13,1169,1290,2459,2370
0130-001,2018,1,14,14,1377,1316,2693,2459
0130-001,2018,1,14,15,1355,1462,2817,2693
0130-001,2018,1,14,16,1404,1425,2829,2817
0130-001,2018,1,14,17,1410,1502,2912,2829
0130-001,2018,1,14,18,1364,1356,2720,2912
0130-001,2018,1,14,19,1290,1136,2426,2720
0130-001,2018,1,14,20,970,857,1827,2426
0130-001,2018,1,14,21,872,789,1661,1827
0130-001,2018,1,14,22,784,701,1485,1661
0130-001,2018,1,14,23,564,465,1029,1485
0130-001,2018,1,14,24,379,282,661,1029
0130-001,2018,1,15,1,216,208,424,661
0130-001,2018,1,15,2,156,138,294,424
0130-001,2018,1,15,3,120,117,237,294
0130-001,2018,1,15,4,131,137,268,237
0130-001,2018,1,15,5,244,209,453,268
0130-001,2018,1,15,6,510,400,910,453
0130-001,2018,1,15,7,1454,801,2255,910
0130-001,2018,1,15,8,1307,1371,2678,2255
0130-001,2018,1,15,9,1473,1632,3105,2678
0130-001,2018,1,15,10,1464,1531,2995,3105
0130-001,2018,1,15,11,1651,1620,3271,2995
0130-001,2018,1,15,12,1561,1590,3151,3271
0130-001,2018,1,15,13,1445,1453,2898,3151
0130-001,2018,1,15,14,1724,1578,3302,2898
0130-001,2018,1,15,15,1698,1733,3431,3302
0130-001,2018,1,15,16,1749,1767,3516,3431
0130-001,2018,1,15,17,1641,1903,3544,3516
0130-001,2018,1,15,18,1595,2128,3723,3544
0130-001,2018,1,15,19,1519,2128,3647,3723
0130-001,2018,1,15,20,1227,1801,3028,3647
0130-001,2018,1,15,21,1069,1569,2638,3028
0130-001,2018,1,15,22,868,1073,1941,2638
0130-001,2018,1,15,23,674,681,1355,1941
0130-001,2018,1,15,24,424,397,821,1355
0130-001,2018,1,16,1,292,262,554,821
0130-001,2018,1,16,2,209,188,397,554
0130-001,2018,1,16,3,178,167,345,397
0130-001,2018,1,16,4,139,166,305,345
0130-001,2018,1,16,5,193,216,409,305
0130-001,2018,1,16,6,507,422,929,409
0130-001,2018,1,16,7,1334,807,2141,929
0130-001,2018,1,16,8,1340,1351,2691,2141
0130-001,2018,1,16,9,1355,1737,3092,2691
0130-001,2018,1,16,10,1451,1477,2928,3092
0130-001,2018,1,16,11,1568,1595,3163,2928
0130-001,2018,1,16,12,1561,1599,3160,3163
0130-001,2018,1,16,13,1456,1448,2904,3160
0130-001,2018,1,16,14,1558,1612,3170,2904
0130-001,2018,1,16,15,1625,1581,3206,3170
0130-001,2018,1,16,16,1640,1750,3390,3206
0130-001,2018,1,16,17,1478,1838,3316,3390
0130-001,2018,1,16,18,1606,2037,3643,3316
0130-001,2018,1,16,19,1463,2112,3575,3643
0130-001,2018,1,16,20,699,1403,2102,3575
0130-001,2018,1,16,21,969,1689,2658,2102
0130-001,2018,1,16,22,916,1085,2001,2658
0130-001,2018,1,16,23,697,681,1378,2001
0130-001,2018,1,16,24,487,445,932,1378
0130-001,2018,1,17,1,314,300,614,932
0130-001,2018,1,17,2,190,216,406,614
0130-001,2018,1,17,3,174,153,327,406
0130-001,2018,1,17,4,161,161,322,327
0130-001,2018,1,17,5,169,229,398,322
0130-001,2018,1,17,6,462,405,867,398
0130-001,2018,1,17,7,1258,761,2019,867
0130-001,2018,1,17,8,1290,1362,2652,2019
0130-001,2018,1,17,9,1386,1658,3044,2652
0130-001,2018,1,17,10,1581,1569,3150,3044
0130-001,2018,1,17,11,1506,1575,3081,3150
0130-001,2018,1,17,12,1523,1542,3065,3081
0130-001,2018,1,17,13,1414,1411,2825,3065
0130-001,2018,1,17,14,1525,1689,3214,2825
0130-001,2018,1,17,15,1621,1593,3214,3214
0130-001,2018,1,17,16,1567,1668,3235,3214
0130-001,2018,1,17,17,1478,1780,3258,3235
0130-001,2018,1,17,18,1626,2158,3784,3258
0130-001,2018,1,17,19,1551,2222,3773,3784
0130-001,2018,1,17,20,1168,1750,2918,3773
0130-001,2018,1,17,21,1056,1308,2364,2918
0130-001,2018,1,17,22,983,1109,2092,2364
0130-001,2018,1,17,23,731,703,1434,2092
0130-001,2018,1,17,24,478,459,937,1434
0130-001,2018,1,18,1,345,299,644,937
0130-001,2018,1,18,2,208,232,440,644
0130-001,2018,1,18,3,204,176,380,440
0130-001,2018,1,18,4,137,165,302,380
0130-001,2018,1,18,5,201,194,395,302
0130-001,2018,1,18,6,503,414,917,395
0130-001,2018,1,18,7,1332,778,2110,917
0130-001,2018,1,18,8,1350,1286,2636,2110
0130-001,2018,1,18,9,1427,1761,3188,2636
0130-001,2018,1,18,10,1468,1485,2953,3188
0130-001,2018,1,18,11,1663,1507,3170,2953
0130-001,2018,1,18,12,1455,1522,2977,3170
0130-001,2018,1,18,13,1377,1329,2706,2977
0130-001,2018,1,18,14,1557,1646,3203,2706
0130-001,2018,1,18,15,1616,1677,3293,3203
0130-001,2018,1,18,16,1652,1734,3386,3293
0130-001,2018,1,18,17,1573,1903,3476,3386
0130-001,2018,1,18,18,1619,2119,3738,3476
0130-001,2018,1,18,19,1536,2115,3651,3738
0130-001,2018,1,18,20,1145,1680,2825,3651
0130-001,2018,1,18,21,988,1503,2491,2825
0130-001,2018,1,18,22,941,1033,1974,2491
0130-001,2018,1,18,23,762,713,1475,1974
0130-001,2018,1,18,24,457,472,929,1475
0130-001,2018,1,19,1,352,358,710,929
0130-001,2018,1,19,2,233,230,463,710
0130-001,2018,1,19,3,171,165,336,463
0130-001,2018,1,19,4,137,193,330,336
0130-001,2018,1,19,5,214,225,439,330
0130-001,2018,1,19,6,462,403,865,439
0130-001,2018,1,19,7,1352,765,2117,865
0130-001,2018,1,19,8,1280,1309,2589,2117
0130-001,2018,1,19,9,1391,1803,3194,2589
0130-001,2018,1,19,10,1596,1585,3181,3194
0130-001,2018,1,19,11,1641,1682,3323,3181
0130-001,2018,1,19,12,1560,1629,3189,3323
0130-001,2018,1,19,13,1501,1513,3014,3189
0130-001,2018,1,19,14,1664,1706,3370,3014
0130-001,2018,1,19,15,1673,1726,3399,3370
0130-001,2018,1,19,16,1653,1755,3408,3399
0130-001,2018,1,19,17,1635,1874,3509,3408
0130-001,2018,1,19,18,1742,2109,3851,3509
0130-001,2018,1,19,19,1647,2191,3838,3851
0130-001,2018,1,19,20,1342,1927,3269,3838
0130-001,2018,1,19,21,1103,1516,2619,3269
0130-001,2018,1,19,22,1004,1115,2119,2619
0130-001,2018,1,19,23,816,748,1564,2119
0130-001,2018,1,19,24,606,541,1147,1564
0130-001,2018,1,20,1,418,405,823,1147
0130-001,2018,1,20,2,336,302,638,823
0130-001,2018,1,20,3,254,226,480,638
0130-001,2018,1,20,4,170,232,402,480
0130-001,2018,1,20,5,219,244,463,402
0130-001,2018,1,20,6,402,398,800,463
0130-001,2018,1,20,7,891,625,1516,800
0130-001,2018,1,20,8,1153,970,2123,1516
0130-001,2018,1,20,9,1345,1386,2731,2123
0130-001,2018,1,20,10,1461,1577,3038,2731
0130-001,2018,1,20,11,1598,1678,3276,3038
0130-001,2018,1,20,12,1610,1714,3324,3276
0130-001,2018,1,20,13,1597,1772,3369,3324
0130-001,2018,1,20,14,1649,1792,3441,3369
0130-001,2018,1,20,15,1696,1746,3442,3441
0130-001,2018,1,20,16,1622,1766,3388,3442
0130-001,2018,1,20,17,1562,1893,3455,3388
0130-001,2018,1,20,18,1462,2008,3470,3455
0130-001,2018,1,20,19,1399,1708,3107,3470
0130-001,2018,1,20,20,1193,1196,2389,3107
0130-001,2018,1,20,21,989,1084,2073,2389
0130-001,2018,1,20,22,860,785,1645,2073
0130-001,2018,1,20,23,684,590,1274,1645
0130-001,2018,1,20,24,501,425,926,1274
0130-001,2018,1,21,1,387,338,725,926
0130-001,2018,1,21,2,316,272,588,725
0130-001,2018,1,21,3,238,238,476,588
0130-001,2018,1,21,4,182,182,364,476
0130-001,2018,1,21,5,156,139,295,364
0130-001,2018,1,21,6,248,241,489,295
0130-001,2018,1,21,7,415,392,807,489
0130-001,2018,1,21,8,513,505,1018,807
0130-001,2018,1,21,9,665,711,1376,1018
0130-001,2018,1,21,10,865,986,1851,1376
0130-001,2018,1,21,11,1081,1172,2253,1851
0130-001,2018,1,21,12,1084,1334,2418,2253
0130-001,2018,1,21,13,1224,1400,2624,2418
0130-001,2018,1,21,14,1435,1541,2976,2624
0130-001,2018,1,21,15,1495,1551,3046,2976
0130-001,2018,1,21,16,1556,1582,3138,3046
0130-001,2018,1,21,17,1565,1558,3123,3138
0130-001,2018,1,21,18,1548,1474,3022,3123
0130-001,2018,1,21,19,1439,1205,2644,3022
0130-001,2018,1,21,20,1126,992,2118,2644
0130-001,2018,1,21,21,1004,799,1803,2118
0130-001,2018,1,21,22,754,721,1475,1803
0130-001,2018,1,21,23,616,519,1135,1475
0130-001,2018,1,21,24,413,331,744,1135
0130-001,2018,1,22,1,238,223,461,744
0130-001,2018,1,22,2,148,151,299,461
0130-001,2018,1,22,3,126,112,238,299
0130-001,2018,1,22,4,126,146,272,238
0130-001,2018,1,22,5,215,175,390,272
0130-001,2018,1,22,6,537,435,972,390
0130-001,2018,1,22,7,1503,802,2305,972
0130-001,2018,1,22,8,1322,1374,2696,2305
0130-001,2018,1,22,9,1425,1657,3082,2696
0130-001,2018,1,22,10,1497,1506,3003,3082
0130-001,2018,1,22,11,1576,1561,3137,3003
0130-001,2018,1,22,12,1557,1567,3124,3137
0130-001,2018,1,22,13,1405,1450,2855,3124
0130-001,2018,1,22,14,1638,1706,3344,2855
0130-001,2018,1,22,15,1602,1664,3266,3344
0130-001,2018,1,22,16,1686,1704,3390,3266
0130-001,2018,1,22,17,1531,1866,3397,3390
0130-001,2018,1,22,18,1605,2021,3626,3397
0130-001,2018,1,22,19,1503,2084,3587,3626
0130-001,2018,1,22,20,1149,1660,2809,3587
0130-001,2018,1,22,21,914,1444,2358,2809
0130-001,2018,1,22,22,815,1056,1871,2358
0130-001,2018,1,22,23,610,624,1234,1871
0130-001,2018,1,22,24,441,387,828,1234
0130-001,2018,1,23,1,276,294,570,828
0130-001,2018,1,23,2,179,168,347,570
0130-001,2018,1,23,3,126,137,263,347
0130-001,2018,1,23,4,123,149,272,263
0130-001,2018,1,23,5,192,190,382,272
0130-001,2018,1,23,6,431,400,831,382
0130-001,2018,1,23,7,1316,746,2062,831
0130-001,2018,1,23,8,1245,1346,2591,2062
0130-001,2018,1,23,9,1351,1733,3084,2591
0130-001,2018,1,23,10,1482,1480,2962,3084
0130-001,2018,1,23,11,1584,1521,3105,2962
0130-001,2018,1,23,12,1552,1549,3101,3105
0130-001,2018,1,23,13,1353,1378,2731,3101
0130-001,2018,1,23,14,1518,1610,3128,2731
0130-001,2018,1,23,15,1583,1637,3220,3128
0130-001,2018,1,23,16,1678,1634,3312,3220
0130-001,2018,1,23,17,1583,1778,3361,3312
0130-001,2018,1,23,18,1572,2090,3662,3361
0130-001,2018,1,23,19,1494,2085,3579,3662
0130-001,2018,1,23,20,1232,1645,2877,3579
0130-001,2018,1,23,21,1021,1481,2502,2877
0130-001,2018,1,23,22,858,1089,1947,2502
0130-001,2018,1,23,23,725,736,1461,1947
0130-001,2018,1,23,24,400,371,771,1461
0130-001,2018,1,24,1,282,292,574,771
0130-001,2018,1,24,2,183,198,381,574
0130-001,2018,1,24,3,146,144,290,381
0130-001,2018,1,24,4,139,181,320,290
0130-001,2018,1,24,5,161,174,335,320
0130-001,2018,1,24,6,433,357,790,335
0130-001,2018,1,24,7,1261,715,1976,790
0130-001,2018,1,24,8,1215,1297,2512,1976
0130-001,2018,1,24,9,1504,1692,3196,2512
0130-001,2018,1,24,10,1445,1430,2875,3196
0130-001,2018,1,24,11,1507,1483,2990,2875
0130-001,2018,1,24,12,1527,1556,3083,2990
0130-001,2018,1,24,13,1372,1421,2793,3083
0130-001,2018,1,24,14,1523,1562,3085,2793
0130-001,2018,1,24,15,1604,1563,3167,3085
0130-001,2018,1,24,16,1298,1561,2859,3167
0130-001,2018,1,24,17,1395,1757,3152,2859
0130-001,2018,1,24,18,1735,2130,3865,3152
0130-001,2018,1,24,19,1564,2212,3776,3865
0130-001,2018,1,24,20,1205,1677,2882,3776
0130-001,2018,1,24,21,971,1281,2252,2882
0130-001,2018,1,24,22,870,1023,1893,2252
0130-001,2018,1,24,23,683,659,1342,1893
0130-001,2018,1,24,24,461,429,890,1342
0130-001,2018,1,25,1,299,268,567,890
0130-001,2018,1,25,2,185,193,378,567
0130-001,2018,1,25,3,144,134,278,378
0130-001,2018,1,25,4,118,167,285,278
0130-001,2018,1,25,5,173,189,362,285
0130-001,2018,1,25,6,405,380,785,362
0130-001,2018,1,25,7,1226,712,1938,785
0130-001,2018,1,25,8,1501,1285,2786,1938
0130-001,2018,1,25,9,1421,1729,3150,2786
0130-001,2018,1,25,10,1491,1427,2918,3150
0130-001,2018,1,25,11,1429,1507,2936,2918
0130-001,2018,1,25,12,1451,1443,2894,2936
0130-001,2018,1,25,13,1321,1409,2730,2894
0130-001,2018,1,25,14,1551,1614,3165,2730
0130-001,2018,1,25,15,1599,1559,3158,3165
0130-001,2018,1,25,16,1651,1660,3311,3158
0130-001,2018,1,25,17,1566,1836,3402,3311
0130-001,2018,1,25,18,1599,2045,3644,3402
0130-001,2018,1,25,19,1485,2115,3600,3644
0130-001,2018,1,25,20,1161,1576,2737,3600
0130-001,2018,1,25,21,1036,1423,2459,2737
0130-001,2018,1,25,22,954,1142,2096,2459
0130-001,2018,1,25,23,679,691,1370,2096
0130-001,2018,1,25,24,509,440,949,1370
0130-001,2018,1,26,1,309,317,626,949
0130-001,2018,1,26,2,217,203,420,626
0130-001,2018,1,26,3,133,153,286,420
0130-001,2018,1,26,4,140,162,302,286
0130-001,2018,1,26,5,198,204,402,302
0130-001,2018,1,26,6,404,348,752,402
0130-001,2018,1,26,7,1199,741,1940,752
0130-001,2018,1,26,8,1693,1257,2950,1940
0130-001,2018,1,26,9,1524,1742,3266,2950
0130-001,2018,1,26,10,1491,1503,2994,3266
0130-001,2018,1,26,11,1561,1524,3085,2994
0130-001,2018,1,26,12,1533,1592,3125,3085
0130-001,2018,1,26,13,1356,1511,2867,3125
0130-001,2018,1,26,14,1672,1641,3313,2867
0130-001,2018,1,26,15,1512,1661,3173,3313
0130-001,2018,1,26,16,1579,1749,3328,3173
0130-001,2018,1,26,17,1621,1881,3502,3328
0130-001,2018,1,26,18,1788,2254,4042,3502
0130-001,2018,1,26,19,1473,2268,3741,4042
0130-001,2018,1,26,20,1313,1843,3156,3741
0130-001,2018,1,26,21,1117,1425,2542,3156
0130-001,2018,1,26,22,973,1072,2045,2542
0130-001,2018,1,26,23,769,761,1530,2045
0130-001,2018,1,26,24,496,455,951,1530
0130-001,2018,1,27,1,448,385,833,951
0130-001,2018,1,27,2,297,276,573,833
0130-001,2018,1,27,3,207,195,402,573
0130-001,2018,1,27,4,187,205,392,402
0130-001,2018,1,27,5,202,243,445,392
0130-001,2018,1,27,6,347,343,690,445
0130-001,2018,1,27,7,653,551,1204,690
0130-001,2018,1,27,8,979,804,1783,1204
0130-001,2018,1,27,9,1235,1295,2530,1783
0130-001,2018,1,27,10,1360,1571,2931,2530
0130-001,2018,1,27,11,1529,1689,3218,2931
0130-001,2018,1,27,12,1636,1732,3368,3218
0130-001,2018,1,27,13,1484,1829,3313,3368
0130-001,2018,1,27,14,1641,1793,3434,3313
0130-001,2018,1,27,15,1693,1757,3450,3434
0130-001,2018,1,27,16,1676,1723,3399,3450
0130-001,2018,1,27,17,1538,1741,3279,3399
0130-001,2018,1,27,18,1362,1894,3256,3279
0130-001,2018,1,27,19,1401,1696,3097,3256
0130-001,2018,1,27,20,1195,1171,2366,3097
0130-001,2018,1,27,21,1042,917,1959,2366
0130-001,2018,1,27,22,866,765,1631,1959
0130-001,2018,1,27,23,742,601,1343,1631
0130-001,2018,1,27,24,475,404,879,1343
0130-001,2018,1,28,1,353,324,677,879
0130-001,2018,1,28,2,254,233,487,677
0130-001,2018,1,28,3,211,177,388,487
0130-001,2018,1,28,4,180,178,358,388
0130-001,2018,1,28,5,171,156,327,358
0130-001,2018,1,28,6,225,207,432,327
0130-001,2018,1,28,7,417,351,768,432
0130-001,2018,1,28,8,540,436,976,768
0130-001,2018,1,28,9,662,757,1419,976
0130-001,2018,1,28,10,871,964,1835,1419
0130-001,2018,1,28,11,1070,1202,2272,1835
0130-001,2018,1,28,12,1079,1248,2327,2272
0130-001,2018,1,28,13,1260,1278,2538,2327
0130-001,2018,1,28,14,1297,1436,2733,2538
0130-001,2018,1,28,15,1434,1440,2874,2733
0130-001,2018,1,28,16,1421,1503,2924,2874
0130-001,2018,1,28,17,1481,1464,2945,2924
0130-001,2018,1,28,18,1423,1376,2799,2945
0130-001,2018,1,28,19,1373,1169,2542,2799
0130-001,2018,1,28,20,1020,850,1870,2542
0130-001,2018,1,28,21,970,794,1764,1870
0130-001,2018,1,28,22,774,728,1502,1764
0130-001,2018,1,28,23,539,445,984,1502
0130-001,2018,1,28,24,402,335,737,984
0130-001,2018,1,29,1,229,216,445,737
0130-001,2018,1,29,2,147,141,288,445
0130-001,2018,1,29,3,106,110,216,288
0130-001,2018,1,29,4,117,138,255,216
0130-001,2018,1,29,5,217,202,419,255
0130-001,2018,1,29,6,483,375,858,419
0130-001,2018,1,29,7,1421,807,2228,858
0130-001,2018,1,29,8,1209,1335,2544,2228
0130-001,2018,1,29,9,1336,1680,3016,2544
0130-001,2018,1,29,10,1487,1577,3064,3016
0130-001,2018,1,29,11,1604,1502,3106,3064
0130-001,2018,1,29,12,1457,1454,2911,3106
0130-001,2018,1,29,13,1355,1431,2786,2911
0130-001,2018,1,29,14,1612,1654,3266,2786
0130-001,2018,1,29,15,1651,1650,3301,3266
0130-001,2018,1,29,16,1728,1653,3381,3301
0130-001,2018,1,29,17,1496,1733,3229,3381
0130-001,2018,1,29,18,1514,2116,3630,3229
0130-001,2018,1,29,19,1572,2220,3792,3630
0130-001,2018,1,29,20,1145,1687,2832,3792
0130-001,2018,1,29,21,1063,1533,2596,2832
0130-001,2018,1,29,22,881,1090,1971,2596
0130-001,2018,1,29,23,716,686,1402,1971
0130-001,2018,1,29,24,418,414,832,1402
0130-001,2018,1,30,1,287,305,592,832
0130-001,2018,1,30,2,174,172,346,592
0130-001,2018,1,30,3,149,179,328,346
0130-001,2018,1,30,4,142,162,304,328
0130-001,2018,1,30,5,201,199,400,304
0130-001,2018,1,30,6,461,356,817,400
0130-001,2018,1,30,7,1323,741,2064,817
0130-001,2018,1,30,8,1294,1289,2583,2064
0130-001,2018,1,30,9,1290,1579,2869,2583
0130-001,2018,1,30,10,1488,1664,3152,2869
0130-001,2018,1,30,11,1593,1505,3098,3152
0130-001,2018,1,30,12,1482,1574,3056,3098
0130-001,2018,1,30,13,1459,1375,2834,3056
0130-001,2018,1,30,14,1585,1660,3245,2834
0130-001,2018,1,30,15,1682,1630,3312,3245
0130-001,2018,1,30,16,1745,1726,3471,3312
0130-001,2018,1,30,17,1550,1794,3344,3471
0130-001,2018,1,30,18,1637,2119,3756,3344
0130-001,2018,1,30,19,1499,2189,3688,3756
0130-001,2018,1,30,20,1143,1752,2895,3688
0130-001,2018,1,30,21,1004,1516,2520,2895
0130-001,2018,1,30,22,882,1121,2003,2520
0130-001,2018,1,30,23,777,695,1472,2003
0130-001,2018,1,30,24,431,423,854,1472
0130-001,2018,1,31,1,366,334,700,854
0130-001,2018,1,31,2,204,213,417,700
0130-001,2018,1,31,3,148,148,296,417
0130-001,2018,1,31,4,144,175,319,296
0130-001,2018,1,31,5,187,212,399,319
0130-001,2018,1,31,6,443,397,840,399
0130-001,2018,1,31,7,1351,743,2094,840
0130-001,2018,1,31,8,1379,1295,2674,2094
0130-001,2018,1,31,9,1389,1683,3072,2674
0130-001,2018,1,31,10,1536,1463,2999,3072
0130-001,2018,1,31,11,1562,1486,3048,2999
0130-001,2018,1,31,12,1521,1535,3056,3048
0130-001,2018,1,31,13,1381,1471,2852,3056
0130-001,2018,1,31,14,1608,1717,3325,2852
0130-001,2018,1,31,15,1648,1664,3312,3325
0130-001,2018,1,31,16,1697,1782,3479,3312
0130-001,2018,1,31,17,1539,1882,3421,3479
0130-001,2018,1,31,18,1656,2137,3793,3421
0130-001,2018,1,31,19,1556,2277,3833,3793
0130-001,2018,1,31,20,1194,1724,2918,3833
0130-001,2018,1,31,21,1060,1473,2533,2918
0130-001,2018,1,31,22,992,1080,2072,2533
0130-001,2018,1,31,23,810,699,1509,2072
0130-001,2018,1,31,24,523,486,1009,1509
0130-001,2018,2,1,1,344,350,694,1009
0130-001,2018,2,1,2,217,216,433,694
0130-001,2018,2,1,3,173,161,334,433
0130-001,2018,2,1,4,139,170,309,334
0130-001,2018,2,1,5,212,231,443,309
0130-001,2018,2,1,6,455,418,873,443
0130-001,2018,2,1,7,1409,785,2194,873
0130-001,2018,2,1,8,1338,1341,2679,2194
0130-001,2018,2,1,9,1412,1710,3122,2679
0130-001,2018,2,1,10,1547,1537,3084,3122
0130-001,2018,2,1,11,1627,1576,3203,3084
0130-001,2018,2,1,12,1522,1523,3045,3203
0130-001,2018,2,1,13,1392,1465,2857,3045
0130-001,2018,2,1,14,1632,1619,3251,2857
0130-001,2018,2,1,15,1604,1660,3264,3251
0130-001,2018,2,1,16,1574,1739,3313,3264
0130-001,2018,2,1,17,1522,1829,3351,3313
0130-001,2018,2,1,18,1644,2114,3758,3351
0130-001,2018,2,1,19,1542,2294,3836,3758
0130-001,2018,2,1,20,1240,1735,2975,3836
0130-001,2018,2,1,21,1044,1594,2638,2975
0130-001,2018,2,1,22,954,1138,2092,2638
0130-001,2018,2,1,23,774,729,1503,2092
0130-001,2018,2,1,24,510,516,1026,1503
0130-001,2018,2,2,1,368,368,736,1026
0130-001,2018,2,2,2,203,205,408,736
0130-001,2018,2,2,3,146,178,324,408
0130-001,2018,2,2,4,141,165,306,324
0130-001,2018,2,2,5,204,223,427,306
0130-001,2018,2,2,6,456,381,837,427
0130-001,2018,2,2,7,1382,769,2151,837
0130-001,2018,2,2,8,1373,1379,2752,2151
0130-001,2018,2,2,9,1412,1792,3204,2752
0130-001,2018,2,2,10,1428,1528,2956,3204
0130-001,2018,2,2,11,1520,1603,3123,2956
0130-001,2018,2,2,12,1535,1609,3144,3123
0130-001,2018,2,2,13,1377,1562,2939,3144
0130-001,2018,2,2,14,1612,1666,3278,2939
0130-001,2018,2,2,15,1692,1690,3382,3278
0130-001,2018,2,2,16,1778,1800,3578,3382
0130-001,2018,2,2,17,1600,1933,3533,3578
0130-001,2018,2,2,18,1850,2307,4157,3533
0130-001,2018,2,2,19,1544,2345,3889,4157
0130-001,2018,2,2,20,1356,1871,3227,3889
0130-001,2018,2,2,21,1086,1605,2691,3227
0130-001,2018,2,2,22,1040,1153,2193,2691
0130-001,2018,2,2,23,820,791,1611,2193
0130-001,2018,2,2,24,545,528,1073,1611
0130-001,2018,2,3,1,426,401,827,1073
0130-001,2018,2,3,2,308,267,575,827
0130-001,2018,2,3,3,242,209,451,575
0130-001,2018,2,3,4,207,244,451,451
0130-001,2018,2,3,5,213,220,433,451
0130-001,2018,2,3,6,370,355,725,433
0130-001,2018,2,3,7,809,631,1440,725
0130-001,2018,2,3,8,1110,902,2012,1440
0130-001,2018,2,3,9,1299,1298,2597,2012
0130-001,2018,2,3,10,1666,1538,3204,2597
0130-001,2018,2,3,11,1479,1672,3151,3204
0130-001,2018,2,3,12,1582,1742,3324,3151
0130-001,2018,2,3,13,1555,1841,3396,3324
0130-001,2018,2,3,14,1591,1788,3379,3396
0130-001,2018,2,3,15,1628,1724,3352,3379
0130-001,2018,2,3,16,1634,1727,3361,3352
0130-001,2018,2,3,17,1705,1792,3497,3361
0130-001,2018,2,3,18,1379,1941,3320,3497
0130-001,2018,2,3,19,1362,1757,3119,3320
0130-001,2018,2,3,20,1221,1141,2362,3119
0130-001,2018,2,3,21,974,931,1905,2362
0130-001,2018,2,3,22,837,768,1605,1905
0130-001,2018,2,3,23,695,530,1225,1605
0130-001,2018,2,3,24,465,401,866,1225
0130-001,2018,2,4,1,354,315,669,866
0130-001,2018,2,4,2,240,212,452,669
0130-001,2018,2,4,3,189,188,377,452
0130-001,2018,2,4,4,161,137,298,377
0130-001,2018,2,4,5,151,158,309,298
0130-001,2018,2,4,6,213,218,431,309
0130-001,2018,2,4,7,416,349,765,431
0130-001,2018,2,4,8,539,476,1015,765
0130-001,2018,2,4,9,668,761,1429,1015
0130-001,2018,2,4,10,861,1021,1882,1429
0130-001,2018,2,4,11,1034,1256,2290,1882
0130-001,2018,2,4,12,1029,1292,2321,2290
0130-001,2018,2,4,13,1198,1474,2672,2321
0130-001,2018,2,4,14,1407,1489,2896,2672
0130-001,2018,2,4,15,1444,1568,3012,2896
0130-001,2018,2,4,16,1553,1436,2989,3012
0130-001,2018,2,4,17,1600,1507,3107,2989
0130-001,2018,2,4,18,1560,1426,2986,3107
0130-001,2018,2,4,19,1460,1222,2682,2986
0130-001,2018,2,4,20,1158,983,2141,2682
0130-001,2018,2,4,21,973,839,1812,2141
0130-001,2018,2,4,22,860,665,1525,1812
0130-001,2018,2,4,23,613,499,1112,1525
0130-001,2018,2,4,24,380,309,689,1112
0130-001,2018,2,5,1,238,218,456,689
0130-001,2018,2,5,2,153,141,294,456
0130-001,2018,2,5,3,98,104,202,294
0130-001,2018,2,5,4,100,136,236,202
0130-001,2018,2,5,5,201,173,374,236
0130-001,2018,2,5,6,465,358,823,374
0130-001,2018,2,5,7,1439,807,2246,823
0130-001,2018,2,5,8,1306,1441,2747,2246
0130-001,2018,2,5,9,1572,1810,3382,2747
0130-001,2018,2,5,10,1527,1534,3061,3382
0130-001,2018,2,5,11,1579,1511,3090,3061
0130-001,2018,2,5,12,1479,1510,2989,3090
0130-001,2018,2,5,13,1472,1397,2869,2989
0130-001,2018,2,5,14,1629,1554,3183,2869
0130-001,2018,2,5,15,1600,1661,3261,3183
0130-001,2018,2,5,16,1642,1745,3387,3261
0130-001,2018,2,5,17,1571,1945,3516,3387
0130-001,2018,2,5,18,1705,2242,3947,3516
0130-001,2018,2,5,19,1597,2202,3799,3947
0130-001,2018,2,5,20,1213,1624,2837,3799
0130-001,2018,2,5,21,1030,1462,2492,2837
0130-001,2018,2,5,22,918,1145,2063,2492
0130-001,2018,2,5,23,654,699,1353,2063
0130-001,2018,2,5,24,375,426,801,1353
0130-001,2018,2,6,1,277,266,543,801
0130-001,2018,2,6,2,172,203,375,543
0130-001,2018,2,6,3,143,135,278,375
0130-001,2018,2,6,4,111,164,275,278
0130-001,2018,2,6,5,193,205,398,275
0130-001,2018,2,6,6,434,411,845,398
0130-001,2018,2,6,7,1405,797,2202,845
0130-001,2018,2,6,8,1496,1425,2921,2202
0130-001,2018,2,6,9,1368,1826,3194,2921
0130-001,2018,2,6,10,1621,1525,3146,3194
0130-001,2018,2,6,11,1684,1512,3196,3146
0130-001,2018,2,6,12,1577,1597,3174,3196
0130-001,2018,2,6,13,1432,1478,2910,3174
0130-001,2018,2,6,14,1682,1695,3377,2910
0130-001,2018,2,6,15,1574,1599,3173,3377
0130-001,2018,2,6,16,1621,1789,3410,3173
0130-001,2018,2,6,17,1576,1930,3506,3410
0130-001,2018,2,6,18,1700,2193,3893,3506
0130-001,2018,2,6,19,1617,2148,3765,3893
0130-001,2018,2,6,20,1276,1778,3054,3765
0130-001,2018,2,6,21,1022,1517,2539,3054
0130-001,2018,2,6,22,965,1181,2146,2539
0130-001,2018,2,6,23,692,779,1471,2146
0130-001,2018,2,6,24,413,425,838,1471
0130-001,2018,2,7,1,267,307,574,838
0130-001,2018,2,7,2,175,183,358,574
0130-001,2018,2,7,3,135,134,269,358
0130-001,2018,2,7,4,128,139,267,269
0130-001,2018,2,7,5,181,206,387,267
0130-001,2018,2,7,6,440,354,794,387
0130-001,2018,2,7,7,1282,788,2070,794
0130-001,2018,2,7,8,1266,1397,2663,2070
0130-001,2018,2,7,9,1337,1733,3070,2663
0130-001,2018,2,7,10,1528,1646,3174,3070
0130-001,2018,2,7,11,1574,1530,3104,3174
0130-001,2018,2,7,12,1637,1580,3217,3104
0130-001,2018,2,7,13,1474,1418,2892,3217
0130-001,2018,2,7,14,1721,1614,3335,2892
0130-001,2018,2,7,15,1646,1705,3351,3335
0130-001,2018,2,7,16,1796,1819,3615,3351
0130-001,2018,2,7,17,1544,1881,3425,3615
0130-001,2018,2,7,18,1719,2220,3939,3425
0130-001,2018,2,7,19,1614,2316,3930,3939
0130-001,2018,2,7,20,1277,1824,3101,3930
0130-001,2018,2,7,21,1029,1371,2400,3101
0130-001,2018,2,7,22,1007,1087,2094,2400
0130-001,2018,2,7,23,742,719,1461,2094
0130-001,2018,2,7,24,496,456,952,1461
0130-001,2018,2,8,1,365,333,698,952
0130-001,2018,2,8,2,224,217,441,698
0130-001,2018,2,8,3,161,173,334,441
0130-001,2018,2,8,4,140,162,302,334
0130-001,2018,2,8,5,195,250,445,302
0130-001,2018,2,8,6,452,398,850,445
0130-001,2018,2,8,7,1389,747,2136,850
0130-001,2018,2,8,8,1316,1421,2737,2136
0130-001,2018,2,8,9,1334,1830,3164,2737
0130-001,2018,2,8,10,1682,1590,3272,3164
0130-001,2018,2,8,11,1744,1675,3419,3272
0130-001,2018,2,8,12,1651,1721,3372,3419
0130-001,2018,2,8,13,1567,1635,3202,3372
0130-001,2018,2,8,14,1783,1812,3595,3202
0130-001,2018,2,8,15,1658,1801,3459,3595
0130-001,2018,2,8,16,1636,1790,3426,3459
0130-001,2018,2,8,17,1601,1903,3504,3426
0130-001,2018,2,8,18,1727,2188,3915,3504
0130-001,2018,2,8,19,1656,2268,3924,3915
0130-001,2018,2,8,20,1260,1795,3055,3924
0130-001,2018,2,8,21,1066,1612,2678,3055
0130-001,2018,2,8,22,1007,1165,2172,2678
0130-001,2018,2,8,23,774,808,1582,2172
0130-001,2018,2,8,24,473,490,963,1582
0130-001,2018,2,9,1,363,368,731,963
0130-001,2018,2,9,2,232,229,461,731
0130-001,2018,2,9,3,157,164,321,461
0130-001,2018,2,9,4,148,189,337,321
0130-001,2018,2,9,5,181,227,408,337
0130-001,2018,2,9,6,477,417,894,408
0130-001,2018,2,9,7,1381,793,2174,894
0130-001,2018,2,9,8,1318,1427,2745,2174
0130-001,2018,2,9,9,1524,1844,3368,2745
0130-001,2018,2,9,10,1685,1631,3316,3368
0130-001,2018,2,9,11,1625,1784,3409,3316
0130-001,2018,2,9,12,1469,1779,3248,3409
0130-001,2018,2,9,13,1627,1702,3329,3248
0130-001,2018,2,9,14,1761,1810,3571,3329
0130-001,2018,2,9,15,1574,1722,3296,3571
0130-001,2018,2,9,16,1547,1783,3330,3296
0130-001,2018,2,9,17,1623,1928,3551,3330
0130-001,2018,2,9,18,1761,2236,3997,3551
0130-001,2018,2,9,19,1736,2342,4078,3997
0130-001,2018,2,9,20,1355,1906,3261,4078
0130-001,2018,2,9,21,1149,1679,2828,3261
0130-001,2018,2,9,22,1028,1122,2150,2828
0130-001,2018,2,9,23,870,839,1709,2150
0130-001,2018,2,9,24,574,590,1164,1709
0130-001,2018,2,10,1,484,398,882,1164
0130-001,2018,2,10,2,334,310,644,882
0130-001,2018,2,10,3,252,238,490,644
0130-001,2018,2,10,4,206,273,479,490
0130-001,2018,2,10,5,232,284,516,479
0130-001,2018,2,10,6,423,398,821,516
0130-001,2018,2,10,7,881,646,1527,821
0130-001,2018,2,10,8,1167,954,2121,1527
0130-001,2018,2,10,9,1374,1445,2819,2121
0130-001,2018,2,10,10,1659,1636,3295,2819
0130-001,2018,2,10,11,1600,1718,3318,3295
0130-001,2018,2,10,12,1687,1839,3526,3318
0130-001,2018,2,10,13,1621,1739,3360,3526
0130-001,2018,2,10,14,1577,1722,3299,3360
0130-001,2018,2,10,15,1653,1748,3401,3299
0130-001,2018,2,10,16,1599,1887,3486,3401
0130-001,2018,2,10,17,1510,1972,3482,3486
0130-001,2018,2,10,18,1491,2103,3594,3482
0130-001,2018,2,10,19,1576,1883,3459,3594
0130-001,2018,2,10,20,1364,1338,2702,3459
0130-001,2018,2,10,21,1097,1042,2139,2702
0130-001,2018,2,10,22,960,785,1745,2139
0130-001,2018,2,10,23,801,602,1403,1745
0130-001,2018,2,10,24,478,442,920,1403
0130-001,2018,2,11,1,363,347,710,920
0130-001,2018,2,11,2,265,262,527,710
0130-001,2018,2,11,3,223,182,405,527
0130-001,2018,2,11,4,153,176,329,405
0130-001,2018,2,11,5,186,156,342,329
0130-001,2018,2,11,6,260,240,500,342
0130-001,2018,2,11,7,472,442,914,500
0130-001,2018,2,11,8,600,524,1124,914
0130-001,2018,2,11,9,769,851,1620,1124
0130-001,2018,2,11,10,1028,1076,2104,1620
0130-001,2018,2,11,11,1226,1269,2495,2104
0130-001,2018,2,11,12,1237,1278,2515,2495
0130-001,2018,2,11,13,1457,1531,2988,2515
0130-001,2018,2,11,14,1500,1511,3011,2988
0130-001,2018,2,11,15,1565,1556,3121,3011
0130-001,2018,2,11,16,1576,1565,3141,3121
0130-001,2018,2,11,17,1291,1479,2770,3141
0130-001,2018,2,11,18,1111,1360,2471,2770
0130-001,2018,2,11,19,1153,1148,2301,2471
0130-001,2018,2,11,20,813,764,1577,2301
0130-001,2018,2,11,21,820,646,1466,1577
0130-001,2018,2,11,22,608,511,1119,1466
0130-001,2018,2,11,23,419,374,793,1119
0130-001,2018,2,11,24,284,274,558,793
0130-001,2018,2,12,1,195,167,362,558
0130-001,2018,2,12,2,152,120,272,362
0130-001,2018,2,12,3,98,79,177,272
0130-001,2018,2,12,4,92,106,198,177
0130-001,2018,2,12,5,175,169,344,198
0130-001,2018,2,12,6,443,319,762,344
0130-001,2018,2,12,7,1149,675,1824,762
0130-001,2018,2,12,8,700,1090,1790,1824
0130-001,2018,2,12,9,858,1381,2239,1790
0130-001,2018,2,12,10,1371,1286,2657,2239
0130-001,2018,2,12,11,1520,1417,2937,2657
0130-001,2018,2,12,12,1580,1640,3220,2937
0130-001,2018,2,12,13,1508,1522,3030,3220
0130-001,2018,2,12,14,1569,1668,3237,3030
0130-001,2018,2,12,15,1493,1715,3208,3237
0130-001,2018,2,12,16,1704,1709,3413,3208
0130-001,2018,2,12,17,1649,1820,3469,3413
0130-001,2018,2,12,18,1613,2089,3702,3469
0130-001,2018,2,12,19,1571,2034,3605,3702
0130-001,2018,2,12,20,1232,1783,3015,3605
0130-001,2018,2,12,21,1047,1507,2554,3015
0130-001,2018,2,12,22,960,1085,2045,2554
0130-001,2018,2,12,23,723,660,1383,2045
0130-001,2018,2,12,24,368,370,738,1383
0130-001,2018,2,13,1,244,252,496,738
0130-001,2018,2,13,2,178,149,327,496
0130-001,2018,2,13,3,144,165,309,327
0130-001,2018,2,13,4,142,154,296,309
0130-001,2018,2,13,5,172,225,397,296
0130-001,2018,2,13,6,415,322,737,397
0130-001,2018,2,13,7,1203,635,1838,737
0130-001,2018,2,13,8,854,975,1829,1838
0130-001,2018,2,13,9,991,1251,2242,1829
0130-001,2018,2,13,10,1309,1396,2705,2242
0130-001,2018,2,13,11,1540,1550,3090,2705
0130-001,2018,2,13,12,1649,1701,3350,3090
0130-001,2018,2,13,13,1634,1612,3246,3350
0130-001,2018,2,13,14,1785,1731,3516,3246
0130-001,2018,2,13,15,1727,1746,3473,3516
0130-001,2018,2,13,16,1796,1916,3712,3473
0130-001,2018,2,13,17,1537,1977,3514,3712
0130-001,2018,2,13,18,1679,2232,3911,3514
0130-001,2018,2,13,19,1647,2330,3977,3911
0130-001,2018,2,13,20,1332,1947,3279,3977
0130-001,2018,2,13,21,1228,1652,2880,3279
0130-001,2018,2,13,22,1131,1176,2307,2880
0130-001,2018,2,13,23,878,815,1693,2307
0130-001,2018,2,13,24,560,507,1067,1693
0130-001,2018,2,14,1,408,415,823,1067
0130-001,2018,2,14,2,284,251,535,823
0130-001,2018,2,14,3,183,179,362,535
0130-001,2018,2,14,4,150,190,340,362
0130-001,2018,2,14,5,196,266,462,340
0130-001,2018,2,14,6,423,364,787,462
0130-001,2018,2,14,7,1200,680,1880,787
0130-001,2018,2,14,8,1407,1287,2694,1880
0130-001,2018,2,14,9,1489,1699,3188,2694
0130-001,2018,2,14,10,1611,1700,3311,3188
0130-001,2018,2,14,11,1679,1757,3436,3311
0130-001,2018,2,14,12,1674,1836,3510,3436
0130-001,2018,2,14,13,1598,1955,3553,3510
0130-001,2018,2,14,14,1648,2066,3714,3553
0130-001,2018,2,14,15,1677,2100,3777,3714
0130-001,2018,2,14,16,1753,2229,3982,3777
0130-001,2018,2,14,17,1672,2303,3975,3982
0130-001,2018,2,14,18,1631,2371,4002,3975
0130-001,2018,2,14,19,1621,2303,3924,4002
0130-001,2018,2,14,20,1257,2057,3314,3924
0130-001,2018,2,14,21,1094,1595,2689,3314
0130-001,2018,2,14,22,962,1030,1992,2689
0130-001,2018,2,14,23,866,809,1675,1992
0130-001,2018,2,14,24,525,622,1147,1675
0130-001,2018,2,15,1,345,405,750,1147
0130-001,2018,2,15,2,318,347,665,750
0130-001,2018,2,15,3,239,308,547,665
0130-001,2018,2,15,4,186,249,435,547
0130-001,2018,2,15,5,199,343,542,435
0130-001,2018,2,15,6,274,686,960,542
0130-001,2018,2,15,7,427,1469,1896,960
0130-001,2018,2,15,8,577,1570,2147,1896
0130-001,2018,2,15,9,798,1602,2400,2147
0130-001,2018,2,15,10,1151,1837,2988,2400
0130-001,2018,2,15,11,1412,1908,3320,2988
0130-001,2018,2,15,12,1544,1709,3253,3320
0130-001,2018,2,15,13,1512,1597,3109,3253
0130-001,2018,2,15,14,1330,1479,2809,3109
0130-001,2018,2,15,15,1407,1379,2786,2809
0130-001,2018,2,15,16,1305,1385,2690,2786
0130-001,2018,2,15,17,1213,1290,2503,2690
0130-001,2018,2,15,18,1250,1109,2359,2503
0130-001,2018,2,15,19,1079,964,2043,2359
0130-001,2018,2,15,20,803,828,1631,2043
0130-001,2018,2,15,21,673,686,1359,1631
0130-001,2018,2,15,22,552,578,1130,1359
0130-001,2018,2,15,23,422,429,851,1130
0130-001,2018,2,15,24,329,287,616,851
0130-001,2018,2,16,1,238,219,457,616
0130-001,2018,2,16,2,178,136,314,457
0130-001,2018,2,16,3,108,110,218,314
0130-001,2018,2,16,4,92,64,156,218
0130-001,2018,2,16,5,97,90,187,156
0130-001,2018,2,16,6,161,164,325,187
0130-001,2018,2,16,7,454,296,750,325
0130-001,2018,2,16,8,963,627,1590,750
0130-001,2018,2,16,9,911,729,1640,1590
0130-001,2018,2,16,10,711,718,1429,1640
0130-001,2018,2,16,11,1146,1196,2342,1429
0130-001,2018,2,16,12,1732,1371,3103,2342
0130-001,2018,2,16,13,1599,1487,3086,3103
0130-001,2018,2,16,14,1688,1632,3320,3086
0130-001,2018,2,16,15,1569,1731,3300,3320
0130-001,2018,2,16,16,1543,1593,3136,3300
0130-001,2018,2,16,17,1540,1493,3033,3136
0130-001,2018,2,16,18,1576,1282,2858,3033
0130-001,2018,2,16,19,1472,1238,2710,2858
0130-001,2018,2,16,20,1278,927,2205,2710
0130-001,2018,2,16,21,1309,827,2136,2205
0130-001,2018,2,16,22,905,737,1642,2136
0130-001,2018,2,16,23,559,528,1087,1642
0130-001,2018,2,16,24,421,312,733,1087
0130-001,2018,2,17,1,285,258,543,733
0130-001,2018,2,17,2,217,152,369,543
0130-001,2018,2,17,3,141,127,268,369
0130-001,2018,2,17,4,122,92,214,268
0130-001,2018,2,17,5,106,105,211,214
0130-001,2018,2,17,6,138,142,280,211
0130-001,2018,2,17,7,275,205,480,280
0130-001,2018,2,17,8,331,309,640,480
0130-001,2018,2,17,9,479,409,888,640
0130-001,2018,2,17,10,684,681,1365,888
0130-001,2018,2,17,11,979,982,1961,1365
0130-001,2018,2,17,12,1147,1209,2356,1961
0130-001,2018,2,17,13,1178,1323,2501,2356
0130-001,2018,2,17,14,1452,1289,2741,2501
0130-001,2018,2,17,15,1667,1326,2993,2741
0130-001,2018,2,17,16,1774,1390,3164,2993
0130-001,2018,2,17,17,1678,1291,2969,3164
0130-001,2018,2,17,18,1564,1135,2699,2969
0130-001,2018,2,17,19,1419,1071,2490,2699
0130-001,2018,2,17,20,1419,813,2232,2490
0130-001,2018,2,17,21,1374,781,2155,2232
0130-001,2018,2,17,22,900,634,1534,2155
0130-001,2018,2,17,23,719,553,1272,1534
0130-001,2018,2,17,24,461,412,873,1272
0130-001,2018,2,18,1,394,286,680,873
0130-001,2018,2,18,2,290,233,523,680
0130-001,2018,2,18,3,250,169,419,523
0130-001,2018,2,18,4,171,147,318,419
0130-001,2018,2,18,5,156,143,299,318
0130-001,2018,2,18,6,162,179,341,299
0130-001,2018,2,18,7,304,272,576,341
0130-001,2018,2,18,8,425,361,786,576
0130-001,2018,2,18,9,606,561,1167,786
0130-001,2018,2,18,10,765,763,1528,1167
0130-001,2018,2,18,11,988,1058,2046,1528
0130-001,2018,2,18,12,973,1165,2138,2046
0130-001,2018,2,18,13,1184,1316,2500,2138
0130-001,2018,2,18,14,1299,1432,2731,2500
0130-001,2018,2,18,15,1350,1430,2780,2731
0130-001,2018,2,18,16,1390,1408,2798,2780
0130-001,2018,2,18,17,1371,1294,2665,2798
0130-001,2018,2,18,18,1281,1257,2538,2665
0130-001,2018,2,18,19,1183,1120,2303,2538
0130-001,2018,2,18,20,1035,867,1902,2303
0130-001,2018,2,18,21,822,726,1548,1902
0130-001,2018,2,18,22,734,637,1371,1548
0130-001,2018,2,18,23,631,522,1153,1371
0130-001,2018,2,18,24,467,396,863,1153
0130-001,2018,2,19,1,272,264,536,863
0130-001,2018,2,19,2,183,150,333,536
0130-001,2018,2,19,3,111,126,237,333
0130-001,2018,2,19,4,144,135,279,237
0130-001,2018,2,19,5,205,211,416,279
0130-001,2018,2,19,6,454,375,829,416
0130-001,2018,2,19,7,1329,774,2103,829
0130-001,2018,2,19,8,1687,1324,3011,2103
0130-001,2018,2,19,9,1518,1710,3228,3011
0130-001,2018,2,19,10,1575,1480,3055,3228
0130-001,2018,2,19,11,1636,1592,3228,3055
0130-001,2018,2,19,12,1464,1615,3079,3228
0130-001,2018,2,19,13,1475,1454,2929,3079
0130-001,2018,2,19,14,1582,1645,3227,2929
0130-001,2018,2,19,15,1731,1668,3399,3227
0130-001,2018,2,19,16,1694,1721,3415,3399
0130-001,2018,2,19,17,1512,1720,3232,3415
0130-001,2018,2,19,18,1674,2026,3700,3232
0130-001,2018,2,19,19,1630,2149,3779,3700
0130-001,2018,2,19,20,1213,1623,2836,3779
0130-001,2018,2,19,21,1013,1412,2425,2836
0130-001,2018,2,19,22,898,1070,1968,2425
0130-001,2018,2,19,23,665,647,1312,1968
0130-001,2018,2,19,24,435,420,855,1312
0130-001,2018,2,20,1,288,300,588,855
0130-001,2018,2,20,2,185,191,376,588
0130-001,2018,2,20,3,172,164,336,376
0130-001,2018,2,20,4,133,155,288,336
0130-001,2018,2,20,5,220,232,452,288
0130-001,2018,2,20,6,445,411,856,452
0130-001,2018,2,20,7,1404,776,2180,856
0130-001,2018,2,20,8,1343,1359,2702,2180
0130-001,2018,2,20,9,1320,1758,3078,2702
0130-001,2018,2,20,10,1634,1589,3223,3078
0130-001,2018,2,20,11,1662,1577,3239,3223
0130-001,2018,2,20,12,1636,1573,3209,3239
0130-001,2018,2,20,13,1456,1447,2903,3209
0130-001,2018,2,20,14,1617,1623,3240,2903
0130-001,2018,2,20,15,1660,1610,3270,3240
0130-001,2018,2,20,16,1675,1719,3394,3270
0130-001,2018,2,20,17,1580,1864,3444,3394
0130-001,2018,2,20,18,1662,2233,3895,3444
0130-001,2018,2,20,19,1589,2262,3851,3895
0130-001,2018,2,20,20,1236,1657,2893,3851
0130-001,2018,2,20,21,1025,1578,2603,2893
0130-001,2018,2,20,22,1013,1147,2160,2603
0130-001,2018,2,20,23,756,699,1455,2160
0130-001,2018,2,20,24,473,445,918,1455
0130-001,2018,2,21,1,306,342,648,918
0130-001,2018,2,21,2,184,208,392,648
0130-001,2018,2,21,3,155,162,317,392
0130-001,2018,2,21,4,152,163,315,317
0130-001,2018,2,21,5,195,233,428,315
0130-001,2018,2,21,6,501,414,915,428
0130-001,2018,2,21,7,1425,827,2252,915
0130-001,2018,2,21,8,1262,1405,2667,2252
0130-001,2018,2,21,9,1569,1767,3336,2667
0130-001,2018,2,21,10,1699,1654,3353,3336
0130-001,2018,2,21,11,1679,1558,3237,3353
0130-001,2018,2,21,12,1495,1550,3045,3237
0130-001,2018,2,21,13,1423,1440,2863,3045
0130-001,2018,2,21,14,1618,1670,3288,2863
0130-001,2018,2,21,15,1615,1738,3353,3288
0130-001,2018,2,21,16,1710,1682,3392,3353
0130-001,2018,2,21,17,1598,1912,3510,3392
0130-001,2018,2,21,18,1760,2225,3985,3510
0130-001,2018,2,21,19,1522,2307,3829,3985
0130-001,2018,2,21,20,1268,1852,3120,3829
0130-001,2018,2,21,21,1023,1541,2564,3120
0130-001,2018,2,21,22,1009,1084,2093,2564
0130-001,2018,2,21,23,858,705,1563,2093
0130-001,2018,2,21,24,483,464,947,1563
0130-001,2018,2,22,1,319,362,681,947
0130-001,2018,2,22,2,202,207,409,681
0130-001,2018,2,22,3,168,157,325,409
0130-001,2018,2,22,4,136,174,310,325
0130-001,2018,2,22,5,190,218,408,310
0130-001,2018,2,22,6,497,422,919,408
0130-001,2018,2,22,7,1452,812,2264,919
0130-001,2018,2,22,8,1442,1419,2861,2264
0130-001,2018,2,22,9,1478,1758,3236,2861
0130-001,2018,2,22,10,1588,1648,3236,3236
0130-001,2018,2,22,11,1591,1659,3250,3236
0130-001,2018,2,22,12,1555,1632,3187,3250
0130-001,2018,2,22,13,1522,1432,2954,3187
0130-001,2018,2,22,14,1573,1728,3301,2954
0130-001,2018,2,22,15,1671,1626,3297,3301
0130-001,2018,2,22,16,1679,1698,3377,3297
0130-001,2018,2,22,17,1525,1860,3385,3377
0130-001,2018,2,22,18,1719,2206,3925,3385
0130-001,2018,2,22,19,1538,2258,3796,3925
0130-001,2018,2,22,20,1226,1684,2910,3796
0130-001,2018,2,22,21,1062,1475,2537,2910
0130-001,2018,2,22,22,939,1178,2117,2537
0130-001,2018,2,22,23,762,764,1526,2117
0130-001,2018,2,22,24,493,479,972,1526
0130-001,2018,2,23,1,359,379,738,972
0130-001,2018,2,23,2,205,228,433,738
0130-001,2018,2,23,3,152,147,299,433
0130-001,2018,2,23,4,150,154,304,299
0130-001,2018,2,23,5,218,222,440,304
0130-001,2018,2,23,6,490,410,900,440
0130-001,2018,2,23,7,1437,826,2263,900
0130-001,2018,2,23,8,1377,1360,2737,2263
0130-001,2018,2,23,9,1529,1782,3311,2737
0130-001,2018,2,23,10,1557,1515,3072,3311
0130-001,2018,2,23,11,1589,1625,3214,3072
0130-001,2018,2,23,12,1529,1673,3202,3214
0130-001,2018,2,23,13,1471,1568,3039,3202
0130-001,2018,2,23,14,1661,1725,3386,3039
0130-001,2018,2,23,15,1711,1685,3396,3386
0130-001,2018,2,23,16,1712,1694,3406,3396
0130-001,2018,2,23,17,1611,1978,3589,3406
0130-001,2018,2,23,18,1806,2262,4068,3589
0130-001,2018,2,23,19,1684,2309,3993,4068
0130-001,2018,2,23,20,1355,1875,3230,3993
0130-001,2018,2,23,21,1135,1490,2625,3230
0130-001,2018,2,23,22,1074,1199,2273,2625
0130-001,2018,2,23,23,841,809,1650,2273
0130-001,2018,2,23,24,644,554,1198,1650
0130-001,2018,2,24,1,428,411,839,1198
0130-001,2018,2,24,2,328,308,636,839
0130-001,2018,2,24,3,261,227,488,636
0130-001,2018,2,24,4,242,229,471,488
0130-001,2018,2,24,5,221,271,492,471
0130-001,2018,2,24,6,453,392,845,492
0130-001,2018,2,24,7,954,660,1614,845
0130-001,2018,2,24,8,1167,978,2145,1614
0130-001,2018,2,24,9,1341,1457,2798,2145
0130-001,2018,2,24,10,1562,1598,3160,2798
0130-001,2018,2,24,11,1593,1665,3258,3160
0130-001,2018,2,24,12,1651,1640,3291,3258
0130-001,2018,2,24,13,1617,1742,3359,3291
0130-001,2018,2,24,14,1554,1759,3313,3359
0130-001,2018,2,24,15,1630,1752,3382,3313
0130-001,2018,2,24,16,1706,1780,3486,3382
0130-001,2018,2,24,17,1764,1882,3646,3486
0130-001,2018,2,24,18,1665,2043,3708,3646
0130-001,2018,2,24,19,1606,1756,3362,3708
0130-001,2018,2,24,20,1241,1280,2521,3362
0130-001,2018,2,24,21,1098,1009,2107,2521
0130-001,2018,2,24,22,883,847,1730,2107
0130-001,2018,2,24,23,802,666,1468,1730
0130-001,2018,2,24,24,441,413,854,1468
0130-001,2018,2,25,1,390,379,769,854
0130-001,2018,2,25,2,258,240,498,769
0130-001,2018,2,25,3,222,182,404,498
0130-001,2018,2,25,4,212,173,385,404
0130-001,2018,2,25,5,189,178,367,385
0130-001,2018,2,25,6,283,249,532,367
0130-001,2018,2,25,7,501,407,908,532
0130-001,2018,2,25,8,600,540,1140,908
0130-001,2018,2,25,9,731,869,1600,1140
0130-001,2018,2,25,10,941,992,1933,1600
0130-001,2018,2,25,11,1076,1125,2201,1933
0130-001,2018,2,25,12,1142,1258,2400,2201
0130-001,2018,2,25,13,1197,1335,2532,2400
0130-001,2018,2,25,14,1466,1480,2946,2532
0130-001,2018,2,25,15,1333,1395,2728,2946
0130-001,2018,2,25,16,1363,1415,2778,2728
0130-001,2018,2,25,17,1485,1481,2966,2778
0130-001,2018,2,25,18,1423,1512,2935,2966
0130-001,2018,2,25,19,1469,1333,2802,2935
0130-001,2018,2,25,20,1164,997,2161,2802
0130-001,2018,2,25,21,1022,829,1851,2161
0130-001,2018,2,25,22,862,712,1574,1851
0130-001,2018,2,25,23,618,538,1156,1574
0130-001,2018,2,25,24,361,341,702,1156
0130-001,2018,2,26,1,222,240,462,702
0130-001,2018,2,26,2,139,149,288,462
0130-001,2018,2,26,3,114,109,223,288
0130-001,2018,2,26,4,120,152,272,223
0130-001,2018,2,26,5,229,226,455,272
0130-001,2018,2,26,6,555,401,956,455
0130-001,2018,2,26,7,1532,819,2351,956
0130-001,2018,2,26,8,1341,1410,2751,2351
0130-001,2018,2,26,9,1416,1765,3181,2751
0130-001,2018,2,26,10,1620,1601,3221,3181
0130-001,2018,2,26,11,1715,1602,3317,3221
0130-001,2018,2,26,12,1532,1560,3092,3317
0130-001,2018,2,26,13,1366,1450,2816,3092
0130-001,2018,2,26,14,1670,1625,3295,2816
0130-001,2018,2,26,15,1712,1683,3395,3295
0130-001,2018,2,26,16,1679,1698,3377,3395
0130-001,2018,2,26,17,1651,1849,3500,3377
0130-001,2018,2,26,18,1734,2161,3895,3500
0130-001,2018,2,26,19,1601,2276,3877,3895
0130-001,2018,2,26,20,1229,1754,2983,3877
0130-001,2018,2,26,21,1031,1646,2677,2983
0130-001,2018,2,26,22,967,1187,2154,2677
0130-001,2018,2,26,23,734,679,1413,2154
0130-001,2018,2,26,24,418,440,858,1413
0130-001,2018,2,27,1,286,284,570,858
0130-001,2018,2,27,2,182,203,385,570
0130-001,2018,2,27,3,147,160,307,385
0130-001,2018,2,27,4,130,168,298,307
0130-001,2018,2,27,5,192,243,435,298
0130-001,2018,2,27,6,532,404,936,435
0130-001,2018,2,27,7,1485,825,2310,936
0130-001,2018,2,27,8,1357,1438,2795,2310
0130-001,2018,2,27,9,1470,1738,3208,2795
0130-001,2018,2,27,10,1634,1585,3219,3208
0130-001,2018,2,27,11,1604,1571,3175,3219
0130-001,2018,2,27,12,1640,1576,3216,3175
0130-001,2018,2,27,13,1443,1495,2938,3216
0130-001,2018,2,27,14,1660,1693,3353,2938
0130-001,2018,2,27,15,1677,1705,3382,3353
0130-001,2018,2,27,16,1739,1756,3495,3382
0130-001,2018,2,27,17,1555,1826,3381,3495
0130-001,2018,2,27,18,1739,2177,3916,3381
0130-001,2018,2,27,19,1592,2260,3852,3916
0130-001,2018,2,27,20,1245,1796,3041,3852
0130-001,2018,2,27,21,1049,1694,2743,3041
0130-001,2018,2,27,22,986,1194,2180,2743
0130-001,2018,2,27,23,790,725,1515,2180
0130-001,2018,2,27,24,460,480,940,1515
0130-001,2018,2,28,1,298,332,630,940
0130-001,2018,2,28,2,226,215,441,630
0130-001,2018,2,28,3,179,195,374,441
0130-001,2018,2,28,4,148,171,319,374
0130-001,2018,2,28,5,238,213,451,319
0130-001,2018,2,28,6,490,414,904,451
0130-001,2018,2,28,7,1425,768,2193,904
0130-001,2018,2,28,8,1469,1411,2880,2193
0130-001,2018,2,28,9,1592,1768,3360,2880
0130-001,2018,2,28,10,1645,1607,3252,3360
0130-001,2018,2,28,11,1665,1611,3276,3252
0130-001,2018,2,28,12,1615,1691,3306,3276
0130-001,2018,2,28,13,1499,1600,3099,3306
0130-001,2018,2,28,14,1577,1607,3184,3099
0130-001,2018,2,28,15,1534,1664,3198,3184
0130-001,2018,2,28,16,1613,1706,3319,3198
0130-001,2018,2,28,17,1581,1764,3345,3319
0130-001,2018,2,28,18,1736,2062,3798,3345
0130-001,2018,2,28,19,1546,2250,3796,3798
0130-001,2018,2,28,20,1304,1798,3102,3796
0130-001,2018,2,28,21,1041,1512,2553,3102
0130-001,2018,2,28,22,1015,1106,2121,2553
0130-001,2018,2,28,23,768,756,1524,2121
0130-001,2018,2,28,24,550,511,1061,1524
0130-001,2018,3,1,1,428,388,816,1061
0130-001,2018,3,1,2,314,283,597,816
0130-001,2018,3,1,3,201,220,421,597
0130-001,2018,3,1,4,199,187,386,421
0130-001,2018,3,1,5,215,232,447,386
0130-001,2018,3,1,6,400,356,756,447
0130-001,2018,3,1,7,907,596,1503,756
0130-001,2018,3,1,8,1228,819,2047,1503
0130-001,2018,3,1,9,1133,1051,2184,2047
0130-001,2018,3,1,10,1269,1246,2515,2184
0130-001,2018,3,1,11,1423,1464,2887,2515
0130-001,2018,3,1,12,1411,1657,3068,2887
0130-001,2018,3,1,13,1319,1679,2998,3068
0130-001,2018,3,1,14,1507,1649,3156,2998
0130-001,2018,3,1,15,1594,1690,3284,3156
0130-001,2018,3,1,16,1716,1712,3428,3284
0130-001,2018,3,1,17,1637,1646,3283,3428
0130-001,2018,3,1,18,1688,1934,3622,3283
0130-001,2018,3,1,19,1491,1662,3153,3622
0130-001,2018,3,1,20,1233,1201,2434,3153
0130-001,2018,3,1,21,1052,999,2051,2434
0130-001,2018,3,1,22,885,762,1647,2051
0130-001,2018,3,1,23,635,511,1146,1647
0130-001,2018,3,1,24,377,328,705,1146
0130-001,2018,3,2,1,244,226,470,705
0130-001,2018,3,2,2,180,166,346,470
0130-001,2018,3,2,3,152,144,296,346
0130-001,2018,3,2,4,123,153,276,296
0130-001,2018,3,2,5,203,183,386,276
0130-001,2018,3,2,6,456,386,842,386
0130-001,2018,3,2,7,1402,768,2170,842
0130-001,2018,3,2,8,1782,1444,3226,2170
0130-001,2018,3,2,9,1636,1780,3416,3226
0130-001,2018,3,2,10,1587,1636,3223,3416
0130-001,2018,3,2,11,1627,1649,3276,3223
0130-001,2018,3,2,12,1618,1691,3309,3276
0130-001,2018,3,2,13,1460,1632,3092,3309
0130-001,2018,3,2,14,1764,1858,3622,3092
0130-001,2018,3,2,15,1755,1685,3440,3622
0130-001,2018,3,2,16,1777,1864,3641,3440
0130-001,2018,3,2,17,1709,1927,3636,3641
0130-001,2018,3,2,18,1800,2214,4014,3636
0130-001,2018,3,2,19,1749,2354,4103,4014
0130-001,2018,3,2,20,1405,1826,3231,4103
0130-001,2018,3,2,21,1203,1555,2758,3231
0130-001,2018,3,2,22,1027,1199,2226,2758
0130-001,2018,3,2,23,823,779,1602,2226
0130-001,2018,3,2,24,536,513,1049,1602
0130-001,2018,3,3,1,399,386,785,1049
0130-001,2018,3,3,2,276,237,513,785
0130-001,2018,3,3,3,229,213,442,513
0130-001,2018,3,3,4,217,215,432,442
0130-001,2018,3,3,5,228,267,495,432
0130-001,2018,3,3,6,447,379,826,495
0130-001,2018,3,3,7,957,643,1600,826
0130-001,2018,3,3,8,1163,983,2146,1600
0130-001,2018,3,3,9,1347,1452,2799,2146
0130-001,2018,3,3,10,1528,1612,3140,2799
0130-001,2018,3,3,11,1538,1591,3129,3140
0130-001,2018,3,3,12,1690,1713,3403,3129
0130-001,2018,3,3,13,1503,1651,3154,3403
0130-001,2018,3,3,14,1637,1677,3314,3154
0130-001,2018,3,3,15,1669,1715,3384,3314
0130-001,2018,3,3,16,1584,1767,3351,3384
0130-001,2018,3,3,17,1713,1849,3562,3351
0130-001,2018,3,3,18,1575,1963,3538,3562
0130-001,2018,3,3,19,1563,1796,3359,3538
0130-001,2018,3,3,20,1253,1297,2550,3359
0130-001,2018,3,3,21,1024,1046,2070,2550
0130-001,2018,3,3,22,957,839,1796,2070
0130-001,2018,3,3,23,779,651,1430,1796
0130-001,2018,3,3,24,484,439,923,1430
0130-001,2018,3,4,1,386,349,735,923
0130-001,2018,3,4,2,288,252,540,735
0130-001,2018,3,4,3,217,188,405,540
0130-001,2018,3,4,4,171,172,343,405
0130-001,2018,3,4,5,195,174,369,343
0130-001,2018,3,4,6,261,234,495,369
0130-001,2018,3,4,7,484,401,885,495
0130-001,2018,3,4,8,614,602,1216,885
0130-001,2018,3,4,9,888,901,1789,1216
0130-001,2018,3,4,10,955,1029,1984,1789
0130-001,2018,3,4,11,1148,1278,2426,1984
0130-001,2018,3,4,12,1213,1330,2543,2426
0130-001,2018,3,4,13,1286,1401,2687,2543
0130-001,2018,3,4,14,1479,1481,2960,2687
0130-001,2018,3,4,15,1473,1617,3090,2960
0130-001,2018,3,4,16,1785,1594,3379,3090
0130-001,2018,3,4,17,1585,1594,3179,3379
0130-001,2018,3,4,18,1579,1624,3203,3179
0130-001,2018,3,4,19,1523,1357,2880,3203
0130-001,2018,3,4,20,1284,1151,2435,2880
0130-001,2018,3,4,21,1063,926,1989,2435
0130-001,2018,3,4,22,902,674,1576,1989
0130-001,2018,3,4,23,657,512,1169,1576
0130-001,2018,3,4,24,376,311,687,1169
0130-001,2018,3,5,1,236,198,434,687
0130-001,2018,3,5,2,136,133,269,434
0130-001,2018,3,5,3,119,108,227,269
0130-001,2018,3,5,4,108,140,248,227
0130-001,2018,3,5,5,207,185,392,248
0130-001,2018,3,5,6,532,373,905,392
0130-001,2018,3,5,7,1492,842,2334,905
0130-001,2018,3,5,8,1465,1502,2967,2334
0130-001,2018,3,5,9,1487,1792,3279,2967
0130-001,2018,3,5,10,1593,1487,3080,3279
0130-001,2018,3,5,11,1567,1547,3114,3080
0130-001,2018,3,5,12,1513,1596,3109,3114
0130-001,2018,3,5,13,1349,1401,2750,3109
0130-001,2018,3,5,14,1568,1523,3091,2750
0130-001,2018,3,5,15,1680,1607,3287,3091
0130-001,2018,3,5,16,1635,1661,3296,3287
0130-001,2018,3,5,17,1598,1878,3476,3296
0130-001,2018,3,5,18,1683,2172,3855,3476
0130-001,2018,3,5,19,1607,2253,3860,3855
0130-001,2018,3,5,20,1185,1762,2947,3860
0130-001,2018,3,5,21,1074,1632,2706,2947
0130-001,2018,3,5,22,954,1170,2124,2706
0130-001,2018,3,5,23,735,725,1460,2124
0130-001,2018,3,5,24,404,467,871,1460
0130-001,2018,3,6,1,285,283,568,871
0130-001,2018,3,6,2,182,196,378,568
0130-001,2018,3,6,3,164,164,328,378
0130-001,2018,3,6,4,143,154,297,328
0130-001,2018,3,6,5,205,219,424,297
0130-001,2018,3,6,6,536,410,946,424
0130-001,2018,3,6,7,1513,826,2339,946
0130-001,2018,3,6,8,1476,1517,2993,2339
0130-001,2018,3,6,9,1615,1840,3455,2993
0130-001,2018,3,6,10,1683,1637,3320,3455
0130-001,2018,3,6,11,1632,1547,3179,3320
0130-001,2018,3,6,12,1579,1542,3121,3179
0130-001,2018,3,6,13,1392,1353,2745,3121
0130-001,2018,3,6,14,1633,1605,3238,2745
0130-001,2018,3,6,15,1580,1548,3128,3238
0130-001,2018,3,6,16,1643,1731,3374,3128
0130-001,2018,3,6,17,1629,1916,3545,3374
0130-001,2018,3,6,18,1724,2227,3951,3545
0130-001,2018,3,6,19,1590,2337,3927,3951
0130-001,2018,3,6,20,1269,1839,3108,3927
0130-001,2018,3,6,21,1103,1663,2766,3108
0130-001,2018,3,6,22,1047,1174,2221,2766
0130-001,2018,3,6,23,789,733,1522,2221
0130-001,2018,3,6,24,471,491,962,1522
0130-001,2018,3,7,1,292,314,606,962
0130-001,2018,3,7,2,196,198,394,606
0130-001,2018,3,7,3,145,158,303,394
0130-001,2018,3,7,4,124,146,270,303
0130-001,2018,3,7,5,185,197,382,270
0130-001,2018,3,7,6,549,387,936,382
0130-001,2018,3,7,7,1512,867,2379,936
0130-001,2018,3,7,8,1579,1535,3114,2379
0130-001,2018,3,7,9,1675,1848,3523,3114
0130-001,2018,3,7,10,1683,1572,3255,3523
0130-001,2018,3,7,11,1682,1627,3309,3255
0130-001,2018,3,7,12,1563,1567,3130,3309
0130-001,2018,3,7,13,1391,1489,2880,3130
0130-001,2018,3,7,14,1606,1637,3243,2880
0130-001,2018,3,7,15,1597,1617,3214,3243
0130-001,2018,3,7,16,1621,1691,3312,3214
0130-001,2018,3,7,17,1573,1921,3494,3312
0130-001,2018,3,7,18,1652,2258,3910,3494
0130-001,2018,3,7,19,1643,2393,4036,3910
0130-001,2018,3,7,20,1243,1767,3010,4036
0130-001,2018,3,7,21,1056,1491,2547,3010
0130-001,2018,3,7,22,998,1113,2111,2547
0130-001,2018,3,7,23,810,696,1506,2111
0130-001,2018,3,7,24,491,481,972,1506
0130-001,2018,3,8,1,317,336,653,972
0130-001,2018,3,8,2,182,204,386,653
0130-001,2018,3,8,3,173,156,329,386
0130-001,2018,3,8,4,129,148,277,329
0130-001,2018,3,8,5,185,229,414,277
0130-001,2018,3,8,6,450,366,816,414
0130-001,2018,3,8,7,1331,769,2100,816
0130-001,2018,3,8,8,1483,1435,2918,2100
0130-001,2018,3,8,9,1456,1790,3246,2918
0130-001,2018,3,8,10,1561,1544,3105,3246
0130-001,2018,3,8,11,1539,1417,2956,3105
0130-001,2018,3,8,12,1473,1536,3009,2956
0130-001,2018,3,8,13,1377,1329,2706,3009
0130-001,2018,3,8,14,1631,1561,3192,2706
0130-001,2018,3,8,15,1571,1593,3164,3192
0130-001,2018,3,8,16,1569,1667,3236,3164
0130-001,2018,3,8,17,1450,1850,3300,3236
0130-001,2018,3,8,18,1688,2061,3749,3300
0130-001,2018,3,8,19,1567,2306,3873,3749
0130-001,2018,3,8,20,1250,1681,2931,3873
0130-001,2018,3,8,21,1074,1564,2638,2931
0130-001,2018,3,8,22,948,1188,2136,2638
0130-001,2018,3,8,23,755,748,1503,2136
0130-001,2018,3,8,24,468,489,957,1503
0130-001,2018,3,9,1,346,301,647,957
0130-001,2018,3,9,2,201,229,430,647
0130-001,2018,3,9,3,145,155,300,430
0130-001,2018,3,9,4,126,189,315,300
0130-001,2018,3,9,5,205,214,419,315
0130-001,2018,3,9,6,505,371,876,419
0130-001,2018,3,9,7,1492,825,2317,876
0130-001,2018,3,9,8,1612,1569,3181,2317
0130-001,2018,3,9,9,1664,1894,3558,3181
0130-001,2018,3,9,10,1770,1569,3339,3558
0130-001,2018,3,9,11,1607,1596,3203,3339
0130-001,2018,3,9,12,1558,1568,3126,3203
0130-001,2018,3,9,13,1468,1453,2921,3126
0130-001,2018,3,9,14,1654,1731,3385,2921
0130-001,2018,3,9,15,1709,1701,3410,3385
0130-001,2018,3,9,16,1750,1772,3522,3410
0130-001,2018,3,9,17,1654,1959,3613,3522
0130-001,2018,3,9,18,1828,2311,4139,3613
0130-001,2018,3,9,19,1733,2375,4108,4139
0130-001,2018,3,9,20,1330,1840,3170,4108
0130-001,2018,3,9,21,1188,1659,2847,3170
0130-001,2018,3,9,22,1073,1186,2259,2847
0130-001,2018,3,9,23,908,836,1744,2259
0130-001,2018,3,9,24,546,550,1096,1744
0130-001,2018,3,10,1,436,428,864,1096
0130-001,2018,3,10,2,324,313,637,864
0130-001,2018,3,10,3,244,234,478,637
0130-001,2018,3,10,4,191,206,397,478
0130-001,2018,3,10,5,228,287,515,397
0130-001,2018,3,10,6,490,402,892,515
0130-001,2018,3,10,7,1031,696,1727,892
0130-001,2018,3,10,8,1248,1017,2265,1727
0130-001,2018,3,10,9,1498,1567,3065,2265
0130-001,2018,3,10,10,1597,1644,3241,3065
0130-001,2018,3,10,11,1627,1640,3267,3241
0130-001,2018,3,10,12,1643,1758,3401,3267
0130-001,2018,3,10,13,1548,1735,3283,3401
0130-001,2018,3,10,14,1648,1716,3364,3283
0130-001,2018,3,10,15,1706,1695,3401,3364
0130-001,2018,3,10,16,1674,1729,3403,3401
0130-001,2018,3,10,17,1749,1912,3661,3403
0130-001,2018,3,10,18,1713,2128,3841,3661
0130-001,2018,3,10,19,1648,1933,3581,3841
0130-001,2018,3,10,20,1458,1307,2765,3581
0130-001,2018,3,10,21,1095,1099,2194,2765
0130-001,2018,3,10,22,1005,843,1848,2194
0130-001,2018,3,10,23,753,646,1399,1848
0130-001,2018,3,10,24,520,497,1017,1399
0130-001,2018,3,11,1,432,372,804,1017
0130-001,2018,3,11,2,294,274,568,804
0130-001,2018,3,11,3,244,194,438,568
0130-001,2018,3,11,4,185,166,351,438
0130-001,2018,3,11,5,186,162,348,351
0130-001,2018,3,11,6,295,244,539,348
0130-001,2018,3,11,7,556,432,988,539
0130-001,2018,3,11,8,644,619,1263,988
0130-001,2018,3,11,9,776,860,1636,1263
0130-001,2018,3,11,10,1062,1023,2085,1636
0130-001,2018,3,11,11,1221,1329,2550,2085
0130-001,2018,3,11,12,1301,1274,2575,2550
0130-001,2018,3,11,13,1280,1375,2655,2575
0130-001,2018,3,11,14,1431,1447,2878,2655
0130-001,2018,3,11,15,1444,1465,2909,2878
0130-001,2018,3,11,16,1482,1505,2987,2909
0130-001,2018,3,11,17,1503,1491,2994,2987
0130-001,2018,3,11,18,1507,1635,3142,2994
0130-001,2018,3,11,19,1498,1511,3009,3142
0130-001,2018,3,11,20,1185,1119,2304,3009
0130-001,2018,3,11,21,1066,949,2015,2304
0130-001,2018,3,11,22,906,829,1735,2015
0130-001,2018,3,11,23,640,575,1215,1735
0130-001,2018,3,11,24,394,330,724,1215
0130-001,2018,3,12,1,231,239,470,724
0130-001,2018,3,12,2,147,146,293,470
0130-001,2018,3,12,3,114,131,245,293
0130-001,2018,3,12,4,139,145,284,245
0130-001,2018,3,12,5,218,218,436,284
0130-001,2018,3,12,6,578,403,981,436
0130-001,2018,3,12,7,1671,848,2519,981
0130-001,2018,3,12,8,1509,1608,3117,2519
0130-001,2018,3,12,9,1732,1907,3639,3117
0130-001,2018,3,12,10,1700,1582,3282,3639
0130-001,2018,3,12,11,1701,1619,3320,3282
0130-001,2018,3,12,12,1580,1552,3132,3320
0130-001,2018,3,12,13,1440,1451,2891,3132
0130-001,2018,3,12,14,1629,1663,3292,2891
0130-001,2018,3,12,15,1527,1606,3133,3292
0130-001,2018,3,12,16,1659,1777,3436,3133
0130-001,2018,3,12,17,1597,1840,3437,3436
0130-001,2018,3,12,18,1749,2265,4014,3437
0130-001,2018,3,12,19,1635,2294,3929,4014
0130-001,2018,3,12,20,1252,1811,3063,3929
0130-001,2018,3,12,21,1101,1661,2762,3063
0130-001,2018,3,12,22,1014,1213,2227,2762
0130-001,2018,3,12,23,767,752,1519,2227
0130-001,2018,3,12,24,430,420,850,1519
0130-001,2018,3,13,1,275,306,581,850
0130-001,2018,3,13,2,205,184,389,581
0130-001,2018,3,13,3,153,165,318,389
0130-001,2018,3,13,4,126,144,270,318
0130-001,2018,3,13,5,193,241,434,270
0130-001,2018,3,13,6,582,429,1011,434
0130-001,2018,3,13,7,1614,856,2470,1011
0130-001,2018,3,13,8,1595,1590,3185,2470
0130-001,2018,3,13,9,1711,1881,3592,3185
0130-001,2018,3,13,10,1795,1681,3476,3592
0130-001,2018,3,13,11,1640,1586,3226,3476
0130-001,2018,3,13,12,1606,1625,3231,3226
0130-001,2018,3,13,13,1443,1440,2883,3231
0130-001,2018,3,13,14,1634,1657,3291,2883
0130-001,2018,3,13,15,1656,1670,3326,3291
0130-001,2018,3,13,16,1724,1710,3434,3326
0130-001,2018,3,13,17,1553,1882,3435,3434
0130-001,2018,3,13,18,1735,2252,3987,3435
0130-001,2018,3,13,19,1585,2325,3910,3987
0130-001,2018,3,13,20,1270,1880,3150,3910
0130-001,2018,3,13,21,1094,1801,2895,3150
0130-001,2018,3,13,22,1085,1197,2282,2895
0130-001,2018,3,13,23,774,834,1608,2282
0130-001,2018,3,13,24,505,472,977,1608
0130-001,2018,3,14,1,325,338,663,977
0130-001,2018,3,14,2,193,202,395,663
0130-001,2018,3,14,3,157,177,334,395
0130-001,2018,3,14,4,153,152,305,334
0130-001,2018,3,14,5,231,235,466,305
0130-001,2018,3,14,6,572,406,978,466
0130-001,2018,3,14,7,1605,877,2482,978
0130-001,2018,3,14,8,1686,1538,3224,2482
0130-001,2018,3,14,9,1697,1925,3622,3224
0130-001,2018,3,14,10,1646,1579,3225,3622
0130-001,2018,3,14,11,1708,1594,3302,3225
0130-001,2018,3,14,12,1587,1575,3162,3302
0130-001,2018,3,14,13,1437,1413,2850,3162
0130-001,2018,3,14,14,1513,1682,3195,2850
0130-001,2018,3,14,15,1114,1544,2658,3195
0130-001,2018,3,14,16,1598,1684,3282,2658
0130-001,2018,3,14,17,1485,1909,3394,3282
0130-001,2018,3,14,18,1718,2287,4005,3394
0130-001,2018,3,14,19,1640,2335,3975,4005
0130-001,2018,3,14,20,1230,2038,3268,3975
0130-001,2018,3,14,21,1109,1577,2686,3268
0130-001,2018,3,14,22,1110,1182,2292,2686
0130-001,2018,3,14,23,932,809,1741,2292
0130-001,2018,3,14,24,589,540,1129,1741
0130-001,2018,3,15,1,338,369,707,1129
0130-001,2018,3,15,2,202,217,419,707
0130-001,2018,3,15,3,182,182,364,419
0130-001,2018,3,15,4,134,171,305,364
0130-001,2018,3,15,5,214,222,436,305
0130-001,2018,3,15,6,492,410,902,436
0130-001,2018,3,15,7,1432,764,2196,902
0130-001,2018,3,15,8,1632,1482,3114,2196
0130-001,2018,3,15,9,1587,1749,3336,3114
0130-001,2018,3,15,10,1672,1628,3300,3336
0130-001,2018,3,15,11,1573,1564,3137,3300
0130-001,2018,3,15,12,1531,1542,3073,3137
0130-001,2018,3,15,13,1354,1378,2732,3073
0130-001,2018,3,15,14,1654,1578,3232,2732
0130-001,2018,3,15,15,1576,1631,3207,3232
0130-001,2018,3,15,16,1678,1674,3352,3207
0130-001,2018,3,15,17,1553,1909,3462,3352
0130-001,2018,3,15,18,1604,2154,3758,3462
0130-001,2018,3,15,19,1556,2171,3727,3758
0130-001,2018,3,15,20,1141,1640,2781,3727
0130-001,2018,3,15,21,1011,1651,2662,2781
0130-001,2018,3,15,22,1056,1212,2268,2662
0130-001,2018,3,15,23,768,772,1540,2268
0130-001,2018,3,15,24,480,488,968,1540
0130-001,2018,3,16,1,339,336,675,968
0130-001,2018,3,16,2,233,243,476,675
0130-001,2018,3,16,3,165,170,335,476
0130-001,2018,3,16,4,134,186,320,335
0130-001,2018,3,16,5,223,216,439,320
0130-001,2018,3,16,6,526,405,931,439
0130-001,2018,3,16,7,1585,825,2410,931
0130-001,2018,3,16,8,1684,1560,3244,2410
0130-001,2018,3,16,9,1709,1835,3544,3244
0130-001,2018,3,16,10,1641,1590,3231,3544
0130-001,2018,3,16,11,1658,1675,3333,3231
0130-001,2018,3,16,12,1513,1683,3196,3333
0130-001,2018,3,16,13,1474,1492,2966,3196
0130-001,2018,3,16,14,1702,1658,3360,2966
0130-001,2018,3,16,15,1720,1706,3426,3360
0130-001,2018,3,16,16,1716,1775,3491,3426
0130-001,2018,3,16,17,1601,2074,3675,3491
0130-001,2018,3,16,18,1858,2289,4147,3675
0130-001,2018,3,16,19,1804,2391,4195,4147
0130-001,2018,3,16,20,1379,1986,3365,4195
0130-001,2018,3,16,21,1214,1746,2960,3365
0130-001,2018,3,16,22,1124,1248,2372,2960
0130-001,2018,3,16,23,883,867,1750,2372
0130-001,2018,3,16,24,587,600,1187,1750
0130-001,2018,3,17,1,445,440,885,1187
0130-001,2018,3,17,2,299,279,578,885
0130-001,2018,3,17,3,261,222,483,578
0130-001,2018,3,17,4,219,232,451,483
0130-001,2018,3,17,5,237,277,514,451
0130-001,2018,3,17,6,474,397,871,514
0130-001,2018,3,17,7,1058,713,1771,871
0130-001,2018,3,17,8,1353,1070,2423,1771
0130-001,2018,3,17,9,1460,1573,3033,2423
0130-001,2018,3,17,10,1646,1679,3325,3033
0130-001,2018,3,17,11,1666,1742,3408,3325
0130-001,2018,3,17,12,1634,1831,3465,3408
0130-001,2018,3,17,13,1669,1732,3401,3465
0130-001,2018,3,17,14,1678,1738,3416,3401
0130-001,2018,3,17,15,1674,1767,3441,3416
0130-001,2018,3,17,16,1358,1680,3038,3441
0130-001,2018,3,17,17,1679,1912,3591,3038
0130-001,2018,3,17,18,1752,2099,3851,3591
0130-001,2018,3,17,19,1556,1927,3483,3851
0130-001,2018,3,17,20,1388,1310,2698,3483
0130-001,2018,3,17,21,1102,1163,2265,2698
0130-001,2018,3,17,22,977,901,1878,2265
0130-001,2018,3,17,23,755,681,1436,1878
0130-001,2018,3,17,24,495,492,987,1436
0130-001,2018,3,18,1,402,339,741,987
0130-001,2018,3,18,2,301,276,577,741
0130-001,2018,3,18,3,228,222,450,577
0130-001,2018,3,18,4,190,166,356,450
0130-001,2018,3,18,5,201,166,367,356
0130-001,2018,3,18,6,307,270,577,367
0130-001,2018,3,18,7,592,461,1053,577
0130-001,2018,3,18,8,660,640,1300,1053
0130-001,2018,3,18,9,825,882,1707,1300
0130-001,2018,3,18,10,980,1088,2068,1707
0130-001,2018,3,18,11,1208,1275,2483,2068
0130-001,2018,3,18,12,1206,1405,2611,2483
0130-001,2018,3,18,13,1360,1486,2846,2611
0130-001,2018,3,18,14,1489,1511,3000,2846
0130-001,2018,3,18,15,1460,1554,3014,3000
0130-001,2018,3,18,16,1637,1601,3238,3014
0130-001,2018,3,18,17,1679,1652,3331,3238
0130-001,2018,3,18,18,1517,1628,3145,3331
0130-001,2018,3,18,19,1570,1388,2958,3145
0130-001,2018,3,18,20,1274,1183,2457,2958
0130-001,2018,3,18,21,1059,969,2028,2457
0130-001,2018,3,18,22,941,788,1729,2028
0130-001,2018,3,18,23,632,528,1160,1729
0130-001,2018,3,18,24,398,315,713,1160
0130-001,2018,3,19,1,233,210,443,713
0130-001,2018,3,19,2,135,139,274,443
0130-001,2018,3,19,3,122,116,238,274
0130-001,2018,3,19,4,131,127,258,238
0130-001,2018,3,19,5,222,203,425,258
0130-001,2018,3,19,6,505,390,895,425
0130-001,2018,3,19,7,1527,860,2387,895
0130-001,2018,3,19,8,1472,1540,3012,2387
0130-001,2018,3,19,9,1623,1840,3463,3012
0130-001,2018,3,19,10,1614,1581,3195,3463
0130-001,2018,3,19,11,1574,1479,3053,3195
0130-001,2018,3,19,12,1571,1637,3208,3053
0130-001,2018,3,19,13,1424,1384,2808,3208
0130-001,2018,3,19,14,1596,1640,3236,2808
0130-001,2018,3,19,15,1388,1625,3013,3236
0130-001,2018,3,19,16,1437,1649,3086,3013
0130-001,2018,3,19,17,1437,1871,3308,3086
0130-001,2018,3,19,18,1677,2119,3796,3308
0130-001,2018,3,19,19,1581,2269,3850,3796
0130-001,2018,3,19,20,1205,1657,2862,3850
0130-001,2018,3,19,21,1016,1574,2590,2862
0130-001,2018,3,19,22,928,1103,2031,2590
0130-001,2018,3,19,23,690,718,1408,2031
0130-001,2018,3,19,24,408,466,874,1408
0130-001,2018,3,20,1,319,313,632,874
0130-001,2018,3,20,2,183,170,353,632
0130-001,2018,3,20,3,146,171,317,353
0130-001,2018,3,20,4,129,140,269,317
0130-001,2018,3,20,5,211,237,448,269
0130-001,2018,3,20,6,546,428,974,448
0130-001,2018,3,20,7,1599,885,2484,974
0130-001,2018,3,20,8,1672,1580,3252,2484
0130-001,2018,3,20,9,1719,1893,3612,3252
0130-001,2018,3,20,10,1767,1582,3349,3612
0130-001,2018,3,20,11,1664,1571,3235,3349
0130-001,2018,3,20,12,1594,1576,3170,3235
0130-001,2018,3,20,13,1360,1364,2724,3170
0130-001,2018,3,20,14,1627,1602,3229,2724
0130-001,2018,3,20,15,1677,1728,3405,3229
0130-001,2018,3,20,16,1679,1841,3520,3405
0130-001,2018,3,20,17,1627,1940,3567,3520
0130-001,2018,3,20,18,1690,2224,3914,3567
0130-001,2018,3,20,19,1628,2288,3916,3914
0130-001,2018,3,20,20,1261,1811,3072,3916
0130-001,2018,3,20,21,1087,1693,2780,3072
0130-001,2018,3,20,22,1024,1178,2202,2780
0130-001,2018,3,20,23,775,769,1544,2202
0130-001,2018,3,20,24,517,488,1005,1544
0130-001,2018,3,21,1,323,327,650,1005
0130-001,2018,3,21,2,188,190,378,650
0130-001,2018,3,21,3,159,176,335,378
0130-001,2018,3,21,4,148,165,313,335
0130-001,2018,3,21,5,205,208,413,313
0130-001,2018,3,21,6,551,419,970,413
0130-001,2018,3,21,7,1447,805,2252,970
0130-001,2018,3,21,8,1384,1512,2896,2252
0130-001,2018,3,21,9,1517,1820,3337,2896
0130-001,2018,3,21,10,1520,1474,2994,3337
0130-001,2018,3,21,11,1589,1590,3179,2994
0130-001,2018,3,21,12,1478,1528,3006,3179
0130-001,2018,3,21,13,1403,1425,2828,3006
0130-001,2018,3,21,14,1501,1648,3149,2828
0130-001,2018,3,21,15,1522,1608,3130,3149
0130-001,2018,3,21,16,1622,1637,3259,3130
0130-001,2018,3,21,17,1501,1886,3387,3259
0130-001,2018,3,21,18,1604,2141,3745,3387
0130-001,2018,3,21,19,1530,2298,3828,3745
0130-001,2018,3,21,20,1143,1746,2889,3828
0130-001,2018,3,21,21,996,1357,2353,2889
0130-001,2018,3,21,22,1010,1086,2096,2353
0130-001,2018,3,21,23,775,717,1492,2096
0130-001,2018,3,21,24,464,444,908,1492
0130-001,2018,3,22,1,311,323,634,908
0130-001,2018,3,22,2,192,192,384,634
0130-001,2018,3,22,3,147,153,300,384
0130-001,2018,3,22,4,114,166,280,300
0130-001,2018,3,22,5,215,226,441,280
0130-001,2018,3,22,6,539,438,977,441
0130-001,2018,3,22,7,1535,824,2359,977
0130-001,2018,3,22,8,1501,1562,3063,2359
0130-001,2018,3,22,9,1618,1803,3421,3063
0130-001,2018,3,22,10,1673,1651,3324,3421
0130-001,2018,3,22,11,1648,1555,3203,3324
0130-001,2018,3,22,12,1545,1533,3078,3203
0130-001,2018,3,22,13,1382,1397,2779,3078
0130-001,2018,3,22,14,1724,1656,3380,2779
0130-001,2018,3,22,15,1718,1638,3356,3380
0130-001,2018,3,22,16,1665,1721,3386,3356
0130-001,2018,3,22,17,1656,1860,3516,3386
0130-001,2018,3,22,18,1721,2246,3967,3516
0130-001,2018,3,22,19,1613,2429,4042,3967
0130-001,2018,3,22,20,1303,1849,3152,4042
0130-001,2018,3,22,21,1174,1675,2849,3152
0130-001,2018,3,22,22,1082,1209,2291,2849
0130-001,2018,3,22,23,839,789,1628,2291
0130-001,2018,3,22,24,514,544,1058,1628
0130-001,2018,3,23,1,356,355,711,1058
0130-001,2018,3,23,2,225,225,450,711
0130-001,2018,3,23,3,168,166,334,450
0130-001,2018,3,23,4,166,186,352,334
0130-001,2018,3,23,5,235,244,479,352
0130-001,2018,3,23,6,553,407,960,479
0130-001,2018,3,23,7,1528,863,2391,960
0130-001,2018,3,23,8,1559,1529,3088,2391
0130-001,2018,3,23,9,1729,1930,3659,3088
0130-001,2018,3,23,10,1743,1674,3417,3659
0130-001,2018,3,23,11,1738,1686,3424,3417
0130-001,2018,3,23,12,1652,1648,3300,3424
0130-001,2018,3,23,13,1474,1408,2882,3300
0130-001,2018,3,23,14,1676,1672,3348,2882
0130-001,2018,3,23,15,1766,1707,3473,3348
0130-001,2018,3,23,16,1806,1730,3536,3473
0130-001,2018,3,23,17,1660,2028,3688,3536
0130-001,2018,3,23,18,1818,2315,4133,3688
0130-001,2018,3,23,19,1803,2515,4318,4133
0130-001,2018,3,23,20,1384,1894,3278,4318
0130-001,2018,3,23,21,1220,1771,2991,3278
0130-001,2018,3,23,22,1091,1206,2297,2991
0130-001,2018,3,23,23,900,898,1798,2297
0130-001,2018,3,23,24,626,570,1196,1798
0130-001,2018,3,24,1,453,469,922,1196
0130-001,2018,3,24,2,344,262,606,922
0130-001,2018,3,24,3,236,209,445,606
0130-001,2018,3,24,4,184,232,416,445
0130-001,2018,3,24,5,259,259,518,416
0130-001,2018,3,24,6,518,384,902,518
0130-001,2018,3,24,7,1046,731,1777,902
0130-001,2018,3,24,8,1373,1108,2481,1777
0130-001,2018,3,24,9,1454,1613,3067,2481
0130-001,2018,3,24,10,1572,1658,3230,3067
0130-001,2018,3,24,11,1742,1776,3518,3230
0130-001,2018,3,24,12,1657,1706,3363,3518
0130-001,2018,3,24,13,1543,1735,3278,3363
0130-001,2018,3,24,14,1692,1819,3511,3278
0130-001,2018,3,24,15,1627,1795,3422,3511
0130-001,2018,3,24,16,1696,1757,3453,3422
0130-001,2018,3,24,17,1785,1881,3666,3453
0130-001,2018,3,24,18,1788,2198,3986,3666
0130-001,2018,3,24,19,1592,1917,3509,3986
0130-001,2018,3,24,20,1364,1328,2692,3509
0130-001,2018,3,24,21,1169,1118,2287,2692
0130-001,2018,3,24,22,1031,841,1872,2287
0130-001,2018,3,24,23,870,640,1510,1872
0130-001,2018,3,24,24,518,399,917,1510
0130-001,2018,3,25,1,393,306,699,917
0130-001,2018,3,25,2,291,252,543,699
0130-001,2018,3,25,3,229,181,410,543
0130-001,2018,3,25,4,205,187,392,410
0130-001,2018,3,25,5,188,130,318,392
0130-001,2018,3,25,6,342,277,619,318
0130-001,2018,3,25,7,608,440,1048,619
0130-001,2018,3,25,8,659,581,1240,1048
0130-001,2018,3,25,9,780,858,1638,1240
0130-001,2018,3,25,10,972,1056,2028,1638
0130-001,2018,3,25,11,1331,1292,2623,2028
0130-001,2018,3,25,12,1194,1216,2410,2623
0130-001,2018,3,25,13,1298,1301,2599,2410
0130-001,2018,3,25,14,1491,1453,2944,2599
0130-001,2018,3,25,15,1592,1434,3026,2944
0130-001,2018,3,25,16,1731,1515,3246,3026
0130-001,2018,3,25,17,1555,1578,3133,3246
0130-001,2018,3,25,18,1506,1683,3189,3133
0130-001,2018,3,25,19,1593,1434,3027,3189
0130-001,2018,3,25,20,1284,1129,2413,3027
0130-001,2018,3,25,21,1137,1038,2175,2413
0130-001,2018,3,25,22,946,756,1702,2175
0130-001,2018,3,25,23,643,522,1165,1702
0130-001,2018,3,25,24,405,339,744,1165
0130-001,2018,3,26,1,281,240,521,744
0130-001,2018,3,26,2,159,146,305,521
0130-001,2018,3,26,3,124,112,236,305
0130-001,2018,3,26,4,119,128,247,236
0130-001,2018,3,26,5,240,225,465,247
0130-001,2018,3,26,6,594,424,1018,465
0130-001,2018,3,26,7,1662,911,2573,1018
0130-001,2018,3,26,8,1592,1566,3158,2573
0130-001,2018,3,26,9,1702,1780,3482,3158
0130-001,2018,3,26,10,1737,1526,3263,3482
0130-001,2018,3,26,11,1607,1522,3129,3263
0130-001,2018,3,26,12,1598,1557,3155,3129
0130-001,2018,3,26,13,1404,1394,2798,3155
0130-001,2018,3,26,14,1776,1667,3443,2798
0130-001,2018,3,26,15,1701,1615,3316,3443
0130-001,2018,3,26,16,1551,1724,3275,3316
0130-001,2018,3,26,17,1634,2045,3679,3275
0130-001,2018,3,26,18,1698,2255,3953,3679
0130-001,2018,3,26,19,1647,2367,4014,3953
0130-001,2018,3,26,20,1246,1920,3166,4014
0130-001,2018,3,26,21,1106,1654,2760,3166
0130-001,2018,3,26,22,1072,1140,2212,2760
0130-001,2018,3,26,23,739,738,1477,2212
0130-001,2018,3,26,24,452,446,898,1477
0130-001,2018,3,27,1,302,276,578,898
0130-001,2018,3,27,2,188,175,363,578
0130-001,2018,3,27,3,145,161,306,363
0130-001,2018,3,27,4,117,169,286,306
0130-001,2018,3,27,5,249,241,490,286
0130-001,2018,3,27,6,564,423,987,490
0130-001,2018,3,27,7,1620,931,2551,987
0130-001,2018,3,27,8,1628,1570,3198,2551
0130-001,2018,3,27,9,1693,1852,3545,3198
0130-001,2018,3,27,10,1769,1601,3370,3545
0130-001,2018,3,27,11,1706,1628,3334,3370
0130-001,2018,3,27,12,1593,1564,3157,3334
0130-001,2018,3,27,13,1431,1439,2870,3157
0130-001,2018,3,27,14,1621,1622,3243,2870
0130-001,2018,3,27,15,1670,1577,3247,3243
0130-001,2018,3,27,16,1649,1636,3285,3247
0130-001,2018,3,27,17,1594,1902,3496,3285
0130-001,2018,3,27,18,1730,2248,3978,3496
0130-001,2018,3,27,19,1594,2330,3924,3978
0130-001,2018,3,27,20,1251,1878,3129,3924
0130-001,2018,3,27,21,1093,1653,2746,3129
0130-001,2018,3,27,22,1101,1206,2307,2746
0130-001,2018,3,27,23,777,804,1581,2307
0130-001,2018,3,27,24,469,470,939,1581
0130-001,2018,3,28,1,343,317,660,939
0130-001,2018,3,28,2,216,200,416,660
0130-001,2018,3,28,3,142,165,307,416
0130-001,2018,3,28,4,143,176,319,307
0130-001,2018,3,28,5,230,244,474,319
0130-001,2018,3,28,6,550,452,1002,474
0130-001,2018,3,28,7,1649,861,2510,1002
0130-001,2018,3,28,8,1673,1612,3285,2510
0130-001,2018,3,28,9,1795,1864,3659,3285
0130-001,2018,3,28,10,1753,1568,3321,3659
0130-001,2018,3,28,11,1770,1623,3393,3321
0130-001,2018,3,28,12,1606,1581,3187,3393
0130-001,2018,3,28,13,1398,1442,2840,3187
0130-001,2018,3,28,14,1664,1589,3253,2840
0130-001,2018,3,28,15,1634,1657,3291,3253
0130-001,2018,3,28,16,1697,1761,3458,3291
0130-001,2018,3,28,17,1544,1907,3451,3458
0130-001,2018,3,28,18,1735,2315,4050,3451
0130-001,2018,3,28,19,1644,2408,4052,4050
0130-001,2018,3,28,20,1259,1895,3154,4052
0130-001,2018,3,28,21,1126,1478,2604,3154
0130-001,2018,3,28,22,1092,1131,2223,2604
0130-001,2018,3,28,23,835,817,1652,2223
0130-001,2018,3,28,24,539,510,1049,1652
0130-001,2018,3,29,1,386,385,771,1049
0130-001,2018,3,29,2,222,240,462,771
0130-001,2018,3,29,3,166,189,355,462
0130-001,2018,3,29,4,149,180,329,355
0130-001,2018,3,29,5,227,245,472,329
0130-001,2018,3,29,6,574,437,1011,472
0130-001,2018,3,29,7,1639,919,2558,1011
0130-001,2018,3,29,8,1663,1601,3264,2558
0130-001,2018,3,29,9,1779,1854,3633,3264
0130-001,2018,3,29,10,1736,1610,3346,3633
0130-001,2018,3,29,11,1680,1586,3266,3346
0130-001,2018,3,29,12,1626,1575,3201,3266
0130-001,2018,3,29,13,1394,1399,2793,3201
0130-001,2018,3,29,14,1669,1685,3354,2793
0130-001,2018,3,29,15,1633,1577,3210,3354
0130-001,2018,3,29,16,1664,1659,3323,3210
0130-001,2018,3,29,17,1538,1913,3451,3323
0130-001,2018,3,29,18,1736,2303,4039,3451
0130-001,2018,3,29,19,1618,2331,3949,4039
0130-001,2018,3,29,20,1273,1896,3169,3949
0130-001,2018,3,29,21,1116,1670,2786,3169
0130-001,2018,3,29,22,1022,1259,2281,2786
0130-001,2018,3,29,23,882,786,1668,2281
0130-001,2018,3,29,24,508,543,1051,1668
0130-001,2018,3,30,1,365,371,736,1051
0130-001,2018,3,30,2,235,223,458,736
0130-001,2018,3,30,3,169,175,344,458
0130-001,2018,3,30,4,167,173,340,344
0130-001,2018,3,30,5,259,262,521,340
0130-001,2018,3,30,6,552,419,971,521
0130-001,2018,3,30,7,1683,907,2590,971
0130-001,2018,3,30,8,1719,1546,3265,2590
0130-001,2018,3,30,9,1796,1831,3627,3265
0130-001,2018,3,30,10,1673,1600,3273,3627
0130-001,2018,3,30,11,1604,1604,3208,3273
0130-001,2018,3,30,12,1663,1696,3359,3208
0130-001,2018,3,30,13,1511,1526,3037,3359
0130-001,2018,3,30,14,1683,1627,3310,3037
0130-001,2018,3,30,15,1715,1720,3435,3310
0130-001,2018,3,30,16,1688,1793,3481,3435
0130-001,2018,3,30,17,1690,1937,3627,3481
0130-001,2018,3,30,18,1884,2370,4254,3627
0130-001,2018,3,30,19,1761,2491,4252,4254
0130-001,2018,3,30,20,1442,1970,3412,4252
0130-001,2018,3,30,21,1182,1719,2901,3412
0130-001,2018,3,30,22,1204,1306,2510,2901
0130-001,2018,3,30,23,876,870,1746,2510
0130-001,2018,3,30,24,566,612,1178,1746
0130-001,2018,3,31,1,493,476,969,1178
0130-001,2018,3,31,2,395,292,687,969
0130-001,2018,3,31,3,257,259,516,687
0130-001,2018,3,31,4,205,255,460,516
0130-001,2018,3,31,5,273,261,534,460
0130-001,2018,3,31,6,478,445,923,534
0130-001,2018,3,31,7,1127,811,1938,923
0130-001,2018,3,31,8,1480,1060,2540,1938
0130-001,2018,3,31,9,1696,1658,3354,2540
0130-001,2018,3,31,10,1654,1725,3379,3354
0130-001,2018,3,31,11,1729,1799,3528,3379
0130-001,2018,3,31,12,1723,1848,3571,3528
0130-001,2018,3,31,13,1627,1748,3375,3571
0130-001,2018,3,31,14,1764,1760,3524,3375
0130-001,2018,3,31,15,1709,1703,3412,3524
0130-001,2018,3,31,16,1675,1759,3434,3412
0130-001,2018,3,31,17,1756,1989,3745,3434
0130-001,2018,3,31,18,1812,2049,3861,3745
0130-001,2018,3,31,19,1625,1906,3531,3861
0130-001,2018,3,31,20,1338,1402,2740,3531
0130-001,2018,3,31,21,1122,1148,2270,2740
0130-001,2018,3,31,22,995,951,1946,2270
0130-001,2018,3,31,23,795,699,1494,1946
0130-001,2018,3,31,24,523,508,1031,1494
0130-001,2018,4,1,1,429,377,806,1031
0130-001,2018,4,1,2,290,294,584,806
0130-001,2018,4,1,3,270,188,458,584
0130-001,2018,4,1,4,190,175,365,458
0130-001,2018,4,1,5,253,198,451,365
0130-001,2018,4,1,6,314,333,647,451
0130-001,2018,4,1,7,602,417,1019,647
0130-001,2018,4,1,8,725,588,1313,1019
0130-001,2018,4,1,9,861,926,1787,1313
0130-001,2018,4,1,10,1089,1191,2280,1787
0130-001,2018,4,1,11,1167,1400,2567,2280
0130-001,2018,4,1,12,1199,1371,2570,2567
0130-001,2018,4,1,13,1231,1427,2658,2570
0130-001,2018,4,1,14,1500,1516,3016,2658
0130-001,2018,4,1,15,1512,1550,3062,3016
0130-001,2018,4,1,16,1551,1567,3118,3062
0130-001,2018,4,1,17,1596,1614,3210,3118
0130-001,2018,4,1,18,1618,1512,3130,3210
0130-001,2018,4,1,19,1628,1434,3062,3130
0130-001,2018,4,1,20,1351,1150,2501,3062
0130-001,2018,4,1,21,1154,979,2133,2501
0130-001,2018,4,1,22,1018,793,1811,2133
0130-001,2018,4,1,23,683,556,1239,1811
0130-001,2018,4,1,24,451,338,789,1239
0130-001,2018,4,2,1,258,222,480,789
0130-001,2018,4,2,2,159,139,298,480
0130-001,2018,4,2,3,123,120,243,298
0130-001,2018,4,2,4,138,134,272,243
0130-001,2018,4,2,5,235,196,431,272
0130-001,2018,4,2,6,619,437,1056,431
0130-001,2018,4,2,7,1784,933,2717,1056
0130-001,2018,4,2,8,1633,1608,3241,2717
0130-001,2018,4,2,9,1811,1797,3608,3241
0130-001,2018,4,2,10,1633,1561,3194,3608
0130-001,2018,4,2,11,1681,1661,3342,3194
0130-001,2018,4,2,12,1739,1643,3382,3342
0130-001,2018,4,2,13,1540,1398,2938,3382
0130-001,2018,4,2,14,1675,1601,3276,2938
0130-001,2018,4,2,15,1698,1570,3268,3276
0130-001,2018,4,2,16,1547,1792,3339,3268
0130-001,2018,4,2,17,1613,1940,3553,3339
0130-001,2018,4,2,18,1717,2267,3984,3553
0130-001,2018,4,2,19,1585,2349,3934,3984
0130-001,2018,4,2,20,1292,1831,3123,3934
0130-001,2018,4,2,21,1061,1720,2781,3123
0130-001,2018,4,2,22,1015,1197,2212,2781
0130-001,2018,4,2,23,721,742,1463,2212
0130-001,2018,4,2,24,495,518,1013,1463
0130-001,2018,4,3,1,323,307,630,1013
0130-001,2018,4,3,2,212,173,385,630
0130-001,2018,4,3,3,151,176,327,385
0130-001,2018,4,3,4,160,181,341,327
0130-001,2018,4,3,5,233,231,464,341
0130-001,2018,4,3,6,578,447,1025,464
0130-001,2018,4,3,7,1663,928,2591,1025
0130-001,2018,4,3,8,1609,1602,3211,2591
0130-001,2018,4,3,9,1845,1776,3621,3211
0130-001,2018,4,3,10,1744,1469,3213,3621
0130-001,2018,4,3,11,1637,1556,3193,3213
0130-001,2018,4,3,12,1664,1543,3207,3193
0130-001,2018,4,3,13,1462,1388,2850,3207
0130-001,2018,4,3,14,1633,1494,3127,2850
0130-001,2018,4,3,15,1680,1643,3323,3127
0130-001,2018,4,3,16,1631,1915,3546,3323
0130-001,2018,4,3,17,1566,1849,3415,3546
0130-001,2018,4,3,18,1631,2340,3971,3415
0130-001,2018,4,3,19,1591,2309,3900,3971
0130-001,2018,4,3,20,1243,1850,3093,3900
0130-001,2018,4,3,21,1116,1775,2891,3093
0130-001,2018,4,3,22,1041,1245,2286,2891
0130-001,2018,4,3,23,779,803,1582,2286
0130-001,2018,4,3,24,524,505,1029,1582
0130-001,2018,4,4,1,369,329,698,1029
0130-001,2018,4,4,2,208,207,415,698
0130-001,2018,4,4,3,159,160,319,415
0130-001,2018,4,4,4,122,184,306,319
0130-001,2018,4,4,5,228,224,452,306
0130-001,2018,4,4,6,498,361,859,452
0130-001,2018,4,4,7,1452,769,2221,859
0130-001,2018,4,4,8,1596,1488,3084,2221
0130-001,2018,4,4,9,1706,1856,3562,3084
0130-001,2018,4,4,10,1622,1581,3203,3562
0130-001,2018,4,4,11,1644,1525,3169,3203
0130-001,2018,4,4,12,1646,1601,3247,3169
0130-001,2018,4,4,13,1579,1415,2994,3247
0130-001,2018,4,4,14,1633,1599,3232,2994
0130-001,2018,4,4,15,1640,1538,3178,3232
0130-001,2018,4,4,16,1677,1762,3439,3178
0130-001,2018,4,4,17,1599,1866,3465,3439
0130-001,2018,4,4,18,1671,2328,3999,3465
0130-001,2018,4,4,19,1629,2366,3995,3999
0130-001,2018,4,4,20,1238,1757,2995,3995
0130-001,2018,4,4,21,1059,1491,2550,2995
0130-001,2018,4,4,22,1044,1200,2244,2550
0130-001,2018,4,4,23,774,737,1511,2244
0130-001,2018,4,4,24,509,463,972,1511
0130-001,2018,4,5,1,317,325,642,972
0130-001,2018,4,5,2,205,213,418,642
0130-001,2018,4,5,3,143,188,331,418
0130-001,2018,4,5,4,145,143,288,331
0130-001,2018,4,5,5,220,224,444,288
0130-001,2018,4,5,6,444,393,837,444
0130-001,2018,4,5,7,1408,770,2178,837
0130-001,2018,4,5,8,1568,1498,3066,2178
0130-001,2018,4,5,9,1577,1724,3301,3066
0130-001,2018,4,5,10,1527,1594,3121,3301
0130-001,2018,4,5,11,1561,1553,3114,3121
0130-001,2018,4,5,12,1552,1493,3045,3114
0130-001,2018,4,5,13,1476,1319,2795,3045
0130-001,2018,4,5,14,1573,1588,3161,2795
0130-001,2018,4,5,15,1617,1572,3189,3161
0130-001,2018,4,5,16,1566,1671,3237,3189
0130-001,2018,4,5,17,1560,1839,3399,3237
0130-001,2018,4,5,18,1632,2182,3814,3399
0130-001,2018,4,5,19,1596,2147,3743,3814
0130-001,2018,4,5,20,1195,1685,2880,3743
0130-001,2018,4,5,21,1025,1554,2579,2880
0130-001,2018,4,5,22,984,1152,2136,2579
0130-001,2018,4,5,23,781,780,1561,2136
0130-001,2018,4,5,24,498,465,963,1561
0130-001,2018,4,6,1,347,311,658,963
0130-001,2018,4,6,2,224,234,458,658
0130-001,2018,4,6,3,170,158,328,458
0130-001,2018,4,6,4,125,163,288,328
0130-001,2018,4,6,5,210,235,445,288
0130-001,2018,4,6,6,520,377,897,445
0130-001,2018,4,6,7,1488,839,2327,897
0130-001,2018,4,6,8,1561,1549,3110,2327
0130-001,2018,4,6,9,1628,1775,3403,3110
0130-001,2018,4,6,10,1694,1634,3328,3403
0130-001,2018,4,6,11,1698,1646,3344,3328
0130-001,2018,4,6,12,1699,1599,3298,3344
0130-001,2018,4,6,13,1579,1480,3059,3298
0130-001,2018,4,6,14,1662,1684,3346,3059
0130-001,2018,4,6,15,1692,1721,3413,3346
0130-001,2018,4,6,16,1733,1754,3487,3413
0130-001,2018,4,6,17,1693,1968,3661,3487
0130-001,2018,4,6,18,1781,2354,4135,3661
0130-001,2018,4,6,19,1715,2445,4160,4135
0130-001,2018,4,6,20,1438,2008,3446,4160
0130-001,2018,4,6,21,1115,1651,2766,3446
0130-001,2018,4,6,22,1104,1230,2334,2766
0130-001,2018,4,6,23,861,799,1660,2334
0130-001,2018,4,6,24,599,586,1185,1660
0130-001,2018,4,7,1,470,413,883,1185
0130-001,2018,4,7,2,304,286,590,883
0130-001,2018,4,7,3,237,215,452,590
0130-001,2018,4,7,4,185,201,386,452
0130-001,2018,4,7,5,252,239,491,386
0130-001,2018,4,7,6,455,395,850,491
0130-001,2018,4,7,7,1078,763,1841,850
0130-001,2018,4,7,8,1377,1185,2562,1841
0130-001,2018,4,7,9,1512,1702,3214,2562
0130-001,2018,4,7,10,1566,1706,3272,3214
0130-001,2018,4,7,11,1644,1722,3366,3272
0130-001,2018,4,7,12,1681,1786,3467,3366
0130-001,2018,4,7,13,1627,1781,3408,3467
0130-001,2018,4,7,14,1711,1786,3497,3408
0130-001,2018,4,7,15,1675,1746,3421,3497
0130-001,2018,4,7,16,1761,1753,3514,3421
0130-001,2018,4,7,17,1728,1867,3595,3514
0130-001,2018,4,7,18,1768,2020,3788,3595
0130-001,2018,4,7,19,1653,1905,3558,3788
0130-001,2018,4,7,20,1365,1374,2739,3558
0130-001,2018,4,7,21,1227,1083,2310,2739
0130-001,2018,4,7,22,1013,935,1948,2310
0130-001,2018,4,7,23,760,682,1442,1948
0130-001,2018,4,7,24,503,456,959,1442
0130-001,2018,4,8,1,391,332,723,959
0130-001,2018,4,8,2,259,258,517,723
0130-001,2018,4,8,3,211,187,398,517
0130-001,2018,4,8,4,206,158,364,398
0130-001,2018,4,8,5,195,173,368,364
0130-001,2018,4,8,6,312,294,606,368
0130-001,2018,4,8,7,612,482,1094,606
0130-001,2018,4,8,8,778,642,1420,1094
0130-001,2018,4,8,9,849,817,1666,1420
0130-001,2018,4,8,10,999,1066,2065,1666
0130-001,2018,4,8,11,1289,1344,2633,2065
0130-001,2018,4,8,12,1155,1239,2394,2633
0130-001,2018,4,8,13,1307,1367,2674,2394
0130-001,2018,4,8,14,1384,1440,2824,2674
0130-001,2018,4,8,15,1515,1448,2963,2824
0130-001,2018,4,8,16,1575,1538,3113,2963
0130-001,2018,4,8,17,1460,1571,3031,3113
0130-001,2018,4,8,18,1523,1606,3129,3031
0130-001,2018,4,8,19,1462,1306,2768,3129
0130-001,2018,4,8,20,1246,1078,2324,2768
0130-001,2018,4,8,21,1068,981,2049,2324
0130-001,2018,4,8,22,925,734,1659,2049
0130-001,2018,4,8,23,655,544,1199,1659
0130-001,2018,4,8,24,419,345,764,1199
0130-001,2018,4,9,1,260,231,491,764
0130-001,2018,4,9,2,156,152,308,491
0130-001,2018,4,9,3,115,125,240,308
0130-001,2018,4,9,4,113,128,241,240
0130-001,2018,4,9,5,241,223,464,241
0130-001,2018,4,9,6,594,434,1028,464
0130-001,2018,4,9,7,1751,950,2701,1028
0130-001,2018,4,9,8,1684,1663,3347,2701
0130-001,2018,4,9,9,1797,1862,3659,3347
0130-001,2018,4,9,10,1730,1566,3296,3659
0130-001,2018,4,9,11,1668,1661,3329,3296
0130-001,2018,4,9,12,1691,1572,3263,3329
0130-001,2018,4,9,13,1623,1356,2979,3263
0130-001,2018,4,9,14,1678,1723,3401,2979
0130-001,2018,4,9,15,1723,1654,3377,3401
0130-001,2018,4,9,16,1651,1783,3434,3377
0130-001,2018,4,9,17,1631,1964,3595,3434
0130-001,2018,4,9,18,1731,2296,4027,3595
0130-001,2018,4,9,19,1609,2392,4001,4027
0130-001,2018,4,9,20,1279,1834,3113,4001
0130-001,2018,4,9,21,1103,1742,2845,3113
0130-001,2018,4,9,22,1036,1306,2342,2845
0130-001,2018,4,9,23,721,757,1478,2342
0130-001,2018,4,9,24,456,447,903,1478
0130-001,2018,4,10,1,289,263,552,903
0130-001,2018,4,10,2,240,183,423,552
0130-001,2018,4,10,3,161,173,334,423
0130-001,2018,4,10,4,130,151,281,334
0130-001,2018,4,10,5,227,233,460,281
0130-001,2018,4,10,6,633,467,1100,460
0130-001,2018,4,10,7,1750,948,2698,1100
0130-001,2018,4,10,8,1559,1532,3091,2698
0130-001,2018,4,10,9,1802,1780,3582,3091
0130-001,2018,4,10,10,1801,1642,3443,3582
0130-001,2018,4,10,11,1736,1646,3382,3443
0130-001,2018,4,10,12,1735,1591,3326,3382
0130-001,2018,4,10,13,1501,1422,2923,3326
0130-001,2018,4,10,14,1715,1649,3364,2923
0130-001,2018,4,10,15,1662,1637,3299,3364
0130-001,2018,4,10,16,1659,1736,3395,3299
0130-001,2018,4,10,17,1604,1919,3523,3395
0130-001,2018,4,10,18,1724,2292,4016,3523
0130-001,2018,4,10,19,1627,2375,4002,4016
0130-001,2018,4,10,20,1319,1861,3180,4002
0130-001,2018,4,10,21,1113,1670,2783,3180
0130-001,2018,4,10,22,975,1392,2367,2783
0130-001,2018,4,10,23,789,780,1569,2367
0130-001,2018,4,10,24,456,515,971,1569
0130-001,2018,4,11,1,313,306,619,971
0130-001,2018,4,11,2,213,210,423,619
0130-001,2018,4,11,3,160,204,364,423
0130-001,2018,4,11,4,143,164,307,364
0130-001,2018,4,11,5,218,225,443,307
0130-001,2018,4,11,6,576,416,992,443
0130-001,2018,4,11,7,1644,875,2519,992
0130-001,2018,4,11,8,1703,1547,3250,2519
0130-001,2018,4,11,9,1736,1749,3485,3250
0130-001,2018,4,11,10,1753,1677,3430,3485
0130-001,2018,4,11,11,1751,1593,3344,3430
0130-001,2018,4,11,12,1675,1565,3240,3344
0130-001,2018,4,11,13,1631,1463,3094,3240
0130-001,2018,4,11,14,1735,1676,3411,3094
0130-001,2018,4,11,15,1737,1756,3493,3411
0130-001,2018,4,11,16,1741,1815,3556,3493
0130-001,2018,4,11,17,1584,1903,3487,3556
0130-001,2018,4,11,18,1766,2277,4043,3487
0130-001,2018,4,11,19,1622,2402,4024,4043
0130-001,2018,4,11,20,1317,1988,3305,4024
0130-001,2018,4,11,21,1117,1584,2701,3305
0130-001,2018,4,11,22,1082,1223,2305,2701
0130-001,2018,4,11,23,862,773,1635,2305
0130-001,2018,4,11,24,529,497,1026,1635
0130-001,2018,4,12,1,353,329,682,1026
0130-001,2018,4,12,2,239,205,444,682
0130-001,2018,4,12,3,170,200,370,444
0130-001,2018,4,12,4,154,185,339,370
0130-001,2018,4,12,5,221,261,482,339
0130-001,2018,4,12,6,638,474,1112,482
0130-001,2018,4,12,7,1719,955,2674,1112
0130-001,2018,4,12,8,1641,1578,3219,2674
0130-001,2018,4,12,9,1743,1859,3602,3219
0130-001,2018,4,12,10,1773,1627,3400,3602
0130-001,2018,4,12,11,1664,1581,3245,3400
0130-001,2018,4,12,12,1595,1514,3109,3245
0130-001,2018,4,12,13,1434,1446,2880,3109
0130-001,2018,4,12,14,1649,1689,3338,2880
0130-001,2018,4,12,15,1670,1621,3291,3338
0130-001,2018,4,12,16,1654,1771,3425,3291
0130-001,2018,4,12,17,1606,1893,3499,3425
0130-001,2018,4,12,18,1732,2363,4095,3499
0130-001,2018,4,12,19,1619,2371,3990,4095
0130-001,2018,4,12,20,1254,1923,3177,3990
0130-001,2018,4,12,21,1191,1678,2869,3177
0130-001,2018,4,12,22,1068,1284,2352,2869
0130-001,2018,4,12,23,847,834,1681,2352
0130-001,2018,4,12,24,528,510,1038,1681
0130-001,2018,4,13,1,384,318,702,1038
0130-001,2018,4,13,2,221,230,451,702
0130-001,2018,4,13,3,158,165,323,451
0130-001,2018,4,13,4,145,203,348,323
0130-001,2018,4,13,5,235,234,469,348
0130-001,2018,4,13,6,583,471,1054,469
0130-001,2018,4,13,7,1713,957,2670,1054
0130-001,2018,4,13,8,1705,1545,3250,2670
0130-001,2018,4,13,9,1772,1834,3606,3250
0130-001,2018,4,13,10,1769,1671,3440,3606
0130-001,2018,4,13,11,1658,1704,3362,3440
0130-001,2018,4,13,12,1607,1654,3261,3362
0130-001,2018,4,13,13,1557,1545,3102,3261
0130-001,2018,4,13,14,1657,1687,3344,3102
0130-001,2018,4,13,15,1740,1734,3474,3344
0130-001,2018,4,13,16,1699,1751,3450,3474
0130-001,2018,4,13,17,1638,2038,3676,3450
0130-001,2018,4,13,18,1895,2277,4172,3676
0130-001,2018,4,13,19,1788,2430,4218,4172
0130-001,2018,4,13,20,1412,2047,3459,4218
0130-001,2018,4,13,21,1226,1671,2897,3459
0130-001,2018,4,13,22,1100,1208,2308,2897
0130-001,2018,4,13,23,958,864,1822,2308
0130-001,2018,4,13,24,632,639,1271,1822
0130-001,2018,4,14,1,475,426,901,1271
0130-001,2018,4,14,2,340,332,672,901
0130-001,2018,4,14,3,236,229,465,672
0130-001,2018,4,14,4,223,214,437,465
0130-001,2018,4,14,5,219,290,509,437
0130-001,2018,4,14,6,407,374,781,509
0130-001,2018,4,14,7,889,690,1579,781
0130-001,2018,4,14,8,1136,1005,2141,1579
0130-001,2018,4,14,9,1426,1546,2972,2141
0130-001,2018,4,14,10,1443,1537,2980,2972
0130-001,2018,4,14,11,1609,1730,3339,2980
0130-001,2018,4,14,12,1588,1782,3370,3339
0130-001,2018,4,14,13,1609,1754,3363,3370
0130-001,2018,4,14,14,1655,1786,3441,3363
0130-001,2018,4,14,15,1674,1744,3418,3441
0130-001,2018,4,14,16,1778,1735,3513,3418
0130-001,2018,4,14,17,1758,1759,3517,3513
0130-001,2018,4,14,18,1672,1913,3585,3517
0130-001,2018,4,14,19,1593,1688,3281,3585
0130-001,2018,4,14,20,1208,1186,2394,3281
0130-001,2018,4,14,21,1072,1066,2138,2394
0130-001,2018,4,14,22,949,828,1777,2138
0130-001,2018,4,14,23,720,609,1329,1777
0130-001,2018,4,14,24,530,444,974,1329
0130-001,2018,4,15,1,380,334,714,974
0130-001,2018,4,15,2,290,272,562,714
0130-001,2018,4,15,3,243,207,450,562
0130-001,2018,4,15,4,168,169,337,450
0130-001,2018,4,15,5,170,161,331,337
0130-001,2018,4,15,6,324,264,588,331
0130-001,2018,4,15,7,665,511,1176,588
0130-001,2018,4,15,8,828,703,1531,1176
0130-001,2018,4,15,9,878,982,1860,1531
0130-001,2018,4,15,10,1083,1099,2182,1860
0130-001,2018,4,15,11,1252,1313,2565,2182
0130-001,2018,4,15,12,1323,1412,2735,2565
0130-001,2018,4,15,13,1367,1452,2819,2735
0130-001,2018,4,15,14,1531,1511,3042,2819
0130-001,2018,4,15,15,1576,1570,3146,3042
0130-001,2018,4,15,16,1561,1606,3167,3146
0130-001,2018,4,15,17,1628,1629,3257,3167
0130-001,2018,4,15,18,1675,1740,3415,3257
0130-001,2018,4,15,19,1603,1443,3046,3415
0130-001,2018,4,15,20,1350,1201,2551,3046
0130-001,2018,4,15,21,1219,1029,2248,2551
0130-001,2018,4,15,22,1052,828,1880,2248
0130-001,2018,4,15,23,708,574,1282,1880
0130-001,2018,4,15,24,475,366,841,1282
0130-001,2018,4,16,1,294,234,528,841
0130-001,2018,4,16,2,163,170,333,528
0130-001,2018,4,16,3,119,120,239,333
0130-001,2018,4,16,4,127,148,275,239
0130-001,2018,4,16,5,246,234,480,275
0130-001,2018,4,16,6,657,436,1093,480
0130-001,2018,4,16,7,1841,989,2830,1093
0130-001,2018,4,16,8,1702,1615,3317,2830
0130-001,2018,4,16,9,1861,1746,3607,3317
0130-001,2018,4,16,10,1803,1622,3425,3607
0130-001,2018,4,16,11,1695,1635,3330,3425
0130-001,2018,4,16,12,1609,1475,3084,3330
0130-001,2018,4,16,13,1452,1452,2904,3084
0130-001,2018,4,16,14,1694,1680,3374,2904
0130-001,2018,4,16,15,1696,1725,3421,3374
0130-001,2018,4,16,16,1704,1732,3436,3421
0130-001,2018,4,16,17,1640,1920,3560,3436
0130-001,2018,4,16,18,1744,2255,3999,3560
0130-001,2018,4,16,19,1620,2437,4057,3999
0130-001,2018,4,16,20,1256,1806,3062,4057
0130-001,2018,4,16,21,1099,1705,2804,3062
0130-001,2018,4,16,22,1024,1299,2323,2804
0130-001,2018,4,16,23,720,759,1479,2323
0130-001,2018,4,16,24,413,462,875,1479
0130-001,2018,4,17,1,287,309,596,875
0130-001,2018,4,17,2,210,194,404,596
0130-001,2018,4,17,3,145,187,332,404
0130-001,2018,4,17,4,133,169,302,332
0130-001,2018,4,17,5,216,224,440,302
0130-001,2018,4,17,6,583,433,1016,440
0130-001,2018,4,17,7,1734,910,2644,1016
0130-001,2018,4,17,8,1696,1578,3274,2644
0130-001,2018,4,17,9,1736,1814,3550,3274
0130-001,2018,4,17,10,1766,1599,3365,3550
0130-001,2018,4,17,11,1720,1562,3282,3365
0130-001,2018,4,17,12,1521,1557,3078,3282
0130-001,2018,4,17,13,1432,1438,2870,3078
0130-001,2018,4,17,14,1656,1696,3352,2870
0130-001,2018,4,17,15,1632,1639,3271,3352
0130-001,2018,4,17,16,1648,1727,3375,3271
0130-001,2018,4,17,17,1672,1919,3591,3375
0130-001,2018,4,17,18,1713,2261,3974,3591
0130-001,2018,4,17,19,1616,2383,3999,3974
0130-001,2018,4,17,20,1289,1814,3103,3999
0130-001,2018,4,17,21,1093,1703,2796,3103
0130-001,2018,4,17,22,1066,1277,2343,2796
0130-001,2018,4,17,23,775,804,1579,2343
0130-001,2018,4,17,24,508,504,1012,1579
0130-001,2018,4,18,1,348,331,679,1012
0130-001,2018,4,18,2,204,207,411,679
0130-001,2018,4,18,3,166,178,344,411
0130-001,2018,4,18,4,145,184,329,344
0130-001,2018,4,18,5,232,237,469,329
0130-001,2018,4,18,6,613,433,1046,469
0130-001,2018,4,18,7,1668,930,2598,1046
0130-001,2018,4,18,8,1661,1564,3225,2598
0130-001,2018,4,18,9,1847,1895,3742,3225
0130-001,2018,4,18,10,1808,1614,3422,3742
0130-001,2018,4,18,11,1725,1633,3358,3422
0130-001,2018,4,18,12,1542,1470,3012,3358
0130-001,2018,4,18,13,1381,1546,2927,3012
0130-001,2018,4,18,14,1762,1697,3459,2927
0130-001,2018,4,18,15,1668,1602,3270,3459
0130-001,2018,4,18,16,1751,1746,3497,3270
0130-001,2018,4,18,17,1597,1999,3596,3497
0130-001,2018,4,18,18,1736,2299,4035,3596
0130-001,2018,4,18,19,1688,2455,4143,4035
0130-001,2018,4,18,20,1321,1902,3223,4143
0130-001,2018,4,18,21,1160,1573,2733,3223
0130-001,2018,4,18,22,1095,1223,2318,2733
0130-001,2018,4,18,23,1004,819,1823,2318
0130-001,2018,4,18,24,653,514,1167,1823
0130-001,2018,4,19,1,357,332,689,1167
0130-001,2018,4,19,2,243,202,445,689
0130-001,2018,4,19,3,148,187,335,445
0130-001,2018,4,19,4,163,149,312,335
0130-001,2018,4,19,5,196,238,434,312
0130-001,2018,4,19,6,620,436,1056,434
0130-001,2018,4,19,7,1703,952,2655,1056
0130-001,2018,4,19,8,1621,1571,3192,2655
0130-001,2018,4,19,9,1811,1863,3674,3192
0130-001,2018,4,19,10,1796,1511,3307,3674
0130-001,2018,4,19,11,1582,1622,3204,3307
0130-001,2018,4,19,12,1617,1490,3107,3204
0130-001,2018,4,19,13,1452,1516,2968,3107
0130-001,2018,4,19,14,1839,1761,3600,2968
0130-001,2018,4,19,15,1751,1713,3464,3600
0130-001,2018,4,19,16,1692,1666,3358,3464
0130-001,2018,4,19,17,1664,1931,3595,3358
0130-001,2018,4,19,18,1802,2297,4099,3595
0130-001,2018,4,19,19,1674,2387,4061,4099
0130-001,2018,4,19,20,1214,1799,3013,4061
0130-001,2018,4,19,21,1084,1661,2745,3013
0130-001,2018,4,19,22,1075,1307,2382,2745
0130-001,2018,4,19,23,810,833,1643,2382
0130-001,2018,4,19,24,519,524,1043,1643
0130-001,2018,4,20,1,418,343,761,1043
0130-001,2018,4,20,2,252,228,480,761
0130-001,2018,4,20,3,177,214,391,480
0130-001,2018,4,20,4,166,184,350,391
0130-001,2018,4,20,5,235,243,478,350
0130-001,2018,4,20,6,610,443,1053,478
0130-001,2018,4,20,7,1672,927,2599,1053
0130-001,2018,4,20,8,1562,1574,3136,2599
0130-001,2018,4,20,9,1442,1746,3188,3136
0130-001,2018,4,20,10,1831,1581,3412,3188
0130-001,2018,4,20,11,1606,1620,3226,3412
0130-001,2018,4,20,12,1656,1749,3405,3226
0130-001,2018,4,20,13,1475,1497,2972,3405
0130-001,2018,4,20,14,1789,1568,3357,2972
0130-001,2018,4,20,15,1732,1672,3404,3357
0130-001,2018,4,20,16,1522,1873,3395,3404
0130-001,2018,4,20,17,1678,2121,3799,3395
0130-001,2018,4,20,18,1927,2349,4276,3799
0130-001,2018,4,20,19,1840,2497,4337,4276
0130-001,2018,4,20,20,1431,2043,3474,4337
0130-001,2018,4,20,21,1176,1657,2833,3474
0130-001,2018,4,20,22,1108,1242,2350,2833
0130-001,2018,4,20,23,926,928,1854,2350
0130-001,2018,4,20,24,646,596,1242,1854
0130-001,2018,4,21,1,465,443,908,1242
0130-001,2018,4,21,2,324,333,657,908
0130-001,2018,4,21,3,252,228,480,657
0130-001,2018,4,21,4,217,221,438,480
0130-001,2018,4,21,5,267,292,559,438
0130-001,2018,4,21,6,528,471,999,559
0130-001,2018,4,21,7,1224,817,2041,999
0130-001,2018,4,21,8,1427,1146,2573,2041
0130-001,2018,4,21,9,1609,1664,3273,2573
0130-001,2018,4,21,10,1675,1752,3427,3273
0130-001,2018,4,21,11,1638,1818,3456,3427
0130-001,2018,4,21,12,1678,1821,3499,3456
0130-001,2018,4,21,13,1619,1867,3486,3499
0130-001,2018,4,21,14,1645,1825,3470,3486
0130-001,2018,4,21,15,1710,1807,3517,3470
0130-001,2018,4,21,16,1766,1824,3590,3517
0130-001,2018,4,21,17,1743,1962,3705,3590
0130-001,2018,4,21,18,1715,2138,3853,3705
0130-001,2018,4,21,19,1694,1981,3675,3853
0130-001,2018,4,21,20,1452,1373,2825,3675
0130-001,2018,4,21,21,1127,1282,2409,2825
0130-001,2018,4,21,22,1044,1034,2078,2409
0130-001,2018,4,21,23,759,730,1489,2078
0130-001,2018,4,21,24,536,488,1024,1489
0130-001,2018,4,22,1,396,346,742,1024
0130-001,2018,4,22,2,308,302,610,742
0130-001,2018,4,22,3,256,228,484,610
0130-001,2018,4,22,4,199,156,355,484
0130-001,2018,4,22,5,219,164,383,355
0130-001,2018,4,22,6,339,291,630,383
0130-001,2018,4,22,7,720,445,1165,630
0130-001,2018,4,22,8,693,630,1323,1165
0130-001,2018,4,22,9,845,979,1824,1323
0130-001,2018,4,22,10,1004,1133,2137,1824
0130-001,2018,4,22,11,1292,1280,2572,2137
0130-001,2018,4,22,12,1112,1275,2387,2572
0130-001,2018,4,22,13,1253,1395,2648,2387
0130-001,2018,4,22,14,1324,1494,2818,2648
0130-001,2018,4,22,15,1384,1478,2862,2818
0130-001,2018,4,22,16,1509,1502,3011,2862
0130-001,2018,4,22,17,1429,1395,2824,3011
0130-001,2018,4,22,18,1444,1370,2814,2824
0130-001,2018,4,22,19,1490,1263,2753,2814
0130-001,2018,4,22,20,1238,1069,2307,2753
0130-001,2018,4,22,21,1130,946,2076,2307
0130-001,2018,4,22,22,845,778,1623,2076
0130-001,2018,4,22,23,612,499,1111,1623
0130-001,2018,4,22,24,394,336,730,1111
0130-001,2018,4,23,1,251,218,469,730
0130-001,2018,4,23,2,148,160,308,469
0130-001,2018,4,23,3,124,116,240,308
0130-001,2018,4,23,4,127,117,244,240
0130-001,2018,4,23,5,230,181,411,244
0130-001,2018,4,23,6,532,372,904,411
0130-001,2018,4,23,7,1541,877,2418,904
0130-001,2018,4,23,8,1558,1490,3048,2418
0130-001,2018,4,23,9,1225,1810,3035,3048
0130-001,2018,4,23,10,1583,1396,2979,3035
0130-001,2018,4,23,11,1548,1511,3059,2979
0130-001,2018,4,23,12,1467,1532,2999,3059
0130-001,2018,4,23,13,1354,1358,2712,2999
0130-001,2018,4,23,14,1529,1614,3143,2712
0130-001,2018,4,23,15,1534,1502,3036,3143
0130-001,2018,4,23,16,1561,1709,3270,3036
0130-001,2018,4,23,17,1512,1764,3276,3270
0130-001,2018,4,23,18,1601,2084,3685,3276
0130-001,2018,4,23,19,1578,2208,3786,3685
0130-001,2018,4,23,20,1117,1660,2777,3786
0130-001,2018,4,23,21,990,1617,2607,2777
0130-001,2018,4,23,22,973,1136,2109,2607
0130-001,2018,4,23,23,694,688,1382,2109
0130-001,2018,4,23,24,409,410,819,1382
0130-001,2018,4,24,1,257,307,564,819
0130-001,2018,4,24,2,197,196,393,564
0130-001,2018,4,24,3,144,169,313,393
0130-001,2018,4,24,4,109,143,252,313
0130-001,2018,4,24,5,222,224,446,252
0130-001,2018,4,24,6,533,381,914,446
0130-001,2018,4,24,7,1612,834,2446,914
0130-001,2018,4,24,8,1639,1543,3182,2446
0130-001,2018,4,24,9,1648,1878,3526,3182
0130-001,2018,4,24,10,1708,1639,3347,3526
0130-001,2018,4,24,11,1687,1582,3269,3347
0130-001,2018,4,24,12,1624,1600,3224,3269
0130-001,2018,4,24,13,1423,1392,2815,3224
0130-001,2018,4,24,14,1693,1708,3401,2815
0130-001,2018,4,24,15,1644,1691,3335,3401
0130-001,2018,4,24,16,1740,1798,3538,3335
0130-001,2018,4,24,17,1694,1962,3656,3538
0130-001,2018,4,24,18,1714,2227,3941,3656
0130-001,2018,4,24,19,1590,2345,3935,3941
0130-001,2018,4,24,20,1208,1766,2974,3935
0130-001,2018,4,24,21,1043,1694,2737,2974
0130-001,2018,4,24,22,1052,1266,2318,2737
0130-001,2018,4,24,23,775,770,1545,2318
0130-001,2018,4,24,24,491,512,1003,1545
0130-001,2018,4,25,1,323,347,670,1003
0130-001,2018,4,25,2,199,196,395,670
0130-001,2018,4,25,3,159,170,329,395
0130-001,2018,4,25,4,150,155,305,329
0130-001,2018,4,25,5,252,241,493,305
0130-001,2018,4,25,6,645,436,1081,493
0130-001,2018,4,25,7,1704,917,2621,1081
0130-001,2018,4,25,8,1652,1587,3239,2621
0130-001,2018,4,25,9,1715,1916,3631,3239
0130-001,2018,4,25,10,1742,1664,3406,3631
0130-001,2018,4,25,11,1639,1647,3286,3406
0130-001,2018,4,25,12,1642,1579,3221,3286
0130-001,2018,4,25,13,1445,1470,2915,3221
0130-001,2018,4,25,14,1642,1695,3337,2915
0130-001,2018,4,25,15,1745,1690,3435,3337
0130-001,2018,4,25,16,1677,1914,3591,3435
0130-001,2018,4,25,17,1649,1951,3600,3591
0130-001,2018,4,25,18,1798,2353,4151,3600
0130-001,2018,4,25,19,1720,2479,4199,4151
0130-001,2018,4,25,20,1282,1915,3197,4199
0130-001,2018,4,25,21,1160,1550,2710,3197
0130-001,2018,4,25,22,1143,1155,2298,2710
0130-001,2018,4,25,23,826,836,1662,2298
0130-001,2018,4,25,24,555,530,1085,1662
0130-001,2018,4,26,1,375,338,713,1085
0130-001,2018,4,26,2,229,239,468,713
0130-001,2018,4,26,3,192,196,388,468
0130-001,2018,4,26,4,171,166,337,388
0130-001,2018,4,26,5,244,240,484,337
0130-001,2018,4,26,6,685,471,1156,484
0130-001,2018,4,26,7,1729,915,2644,1156
0130-001,2018,4,26,8,1687,1590,3277,2644
0130-001,2018,4,26,9,1791,1866,3657,3277
0130-001,2018,4,26,10,1765,1592,3357,3657
0130-001,2018,4,26,11,1790,1617,3407,3357
0130-001,2018,4,26,12,1655,1567,3222,3407
0130-001,2018,4,26,13,1468,1425,2893,3222
0130-001,2018,4,26,14,1730,1702,3432,2893
0130-001,2018,4,26,15,1721,1754,3475,3432
0130-001,2018,4,26,16,1667,1836,3503,3475
0130-001,2018,4,26,17,1639,2021,3660,3503
0130-001,2018,4,26,18,1756,2364,4120,3660
0130-001,2018,4,26,19,1653,2420,4073,4120
0130-001,2018,4,26,20,1205,1860,3065,4073
0130-001,2018,4,26,21,1149,1716,2865,3065
0130-001,2018,4,26,22,1057,1304,2361,2865
0130-001,2018,4,26,23,852,824,1676,2361
0130-001,2018,4,26,24,519,553,1072,1676
0130-001,2018,4,27,1,379,351,730,1072
0130-001,2018,4,27,2,246,253,499,730
0130-001,2018,4,27,3,183,206,389,499
0130-001,2018,4,27,4,175,179,354,389
0130-001,2018,4,27,5,241,261,502,354
0130-001,2018,4,27,6,593,413,1006,502
0130-001,2018,4,27,7,1748,937,2685,1006
0130-001,2018,4,27,8,1630,1614,3244,2685
0130-001,2018,4,27,9,1765,1954,3719,3244
0130-001,2018,4,27,10,1641,1599,3240,3719
0130-001,2018,4,27,11,1713,1713,3426,3240
0130-001,2018,4,27,12,1563,1680,3243,3426
0130-001,2018,4,27,13,1516,1493,3009,3243
0130-001,2018,4,27,14,1721,1819,3540,3009
0130-001,2018,4,27,15,1676,1777,3453,3540
0130-001,2018,4,27,16,1760,1964,3724,3453
0130-001,2018,4,27,17,1727,2101,3828,3724
0130-001,2018,4,27,18,1776,2364,4140,3828
0130-001,2018,4,27,19,1807,2494,4301,4140
0130-001,2018,4,27,20,1448,2222,3670,4301
0130-001,2018,4,27,21,1240,1749,2989,3670
0130-001,2018,4,27,22,1061,1274,2335,2989
0130-001,2018,4,27,23,956,923,1879,2335
0130-001,2018,4,27,24,610,587,1197,1879
0130-001,2018,4,28,1,475,438,913,1197
0130-001,2018,4,28,2,341,283,624,913
0130-001,2018,4,28,3,292,254,546,624
0130-001,2018,4,28,4,223,230,453,546
0130-001,2018,4,28,5,272,289,561,453
0130-001,2018,4,28,6,610,400,1010,561
0130-001,2018,4,28,7,1234,787,2021,1010
0130-001,2018,4,28,8,1431,1135,2566,2021
0130-001,2018,4,28,9,1673,1686,3359,2566
0130-001,2018,4,28,10,1713,1803,3516,3359
0130-001,2018,4,28,11,1606,1818,3424,3516
0130-001,2018,4,28,12,1744,2106,3850,3424
0130-001,2018,4,28,13,1627,1924,3551,3850
0130-001,2018,4,28,14,1612,1923,3535,3551
0130-001,2018,4,28,15,1678,1771,3449,3535
0130-001,2018,4,28,16,1727,1840,3567,3449
0130-001,2018,4,28,17,1735,2033,3768,3567
0130-001,2018,4,28,18,1791,2116,3907,3768
0130-001,2018,4,28,19,1659,1979,3638,3907
0130-001,2018,4,28,20,1372,1432,2804,3638
0130-001,2018,4,28,21,1154,1168,2322,2804
0130-001,2018,4,28,22,1042,948,1990,2322
0130-001,2018,4,28,23,789,699,1488,1990
0130-001,2018,4,28,24,546,458,1004,1488
0130-001,2018,4,29,1,402,382,784,1004
0130-001,2018,4,29,2,289,247,536,784
0130-001,2018,4,29,3,265,228,493,536
0130-001,2018,4,29,4,228,190,418,493
0130-001,2018,4,29,5,223,174,397,418
0130-001,2018,4,29,6,397,294,691,397
0130-001,2018,4,29,7,727,473,1200,691
0130-001,2018,4,29,8,791,676,1467,1200
0130-001,2018,4,29,9,957,983,1940,1467
0130-001,2018,4,29,10,1071,1264,2335,1940
0130-001,2018,4,29,11,1237,1289,2526,2335
0130-001,2018,4,29,12,1252,1303,2555,2526
0130-001,2018,4,29,13,1341,1450,2791,2555
0130-001,2018,4,29,14,1414,1551,2965,2791
0130-001,2018,4,29,15,1505,1537,3042,2965
0130-001,2018,4,29,16,1522,1538,3060,3042
0130-001,2018,4,29,17,1541,1615,3156,3060
0130-001,2018,4,29,18,1604,1671,3275,3156
0130-001,2018,4,29,19,1658,1424,3082,3275
0130-001,2018,4,29,20,1317,1298,2615,3082
0130-001,2018,4,29,21,1216,1186,2402,2615
0130-001,2018,4,29,22,986,828,1814,2402
0130-001,2018,4,29,23,692,609,1301,1814
0130-001,2018,4,29,24,488,366,854,1301
0130-001,2018,4,30,1,292,265,557,854
0130-001,2018,4,30,2,162,175,337,557
0130-001,2018,4,30,3,139,113,252,337
0130-001,2018,4,30,4,140,119,259,252
0130-001,2018,4,30,5,216,219,435,259
0130-001,2018,4,30,6,675,391,1066,435
0130-001,2018,4,30,7,1749,929,2678,1066
0130-001,2018,4,30,8,1679,1623,3302,2678
0130-001,2018,4,30,9,1794,1891,3685,3302
0130-001,2018,4,30,10,1752,1668,3420,3685
0130-001,2018,4,30,11,1779,1638,3417,3420
0130-001,2018,4,30,12,1702,1700,3402,3417
0130-001,2018,4,30,13,1603,1527,3130,3402
0130-001,2018,4,30,14,1894,1786,3680,3130
0130-001,2018,4,30,15,1702,1861,3563,3680
0130-001,2018,4,30,16,1786,1916,3702,3563
0130-001,2018,4,30,17,1704,1998,3702,3702
0130-001,2018,4,30,18,1824,2346,4170,3702
0130-001,2018,4,30,19,1752,2419,4171,4170
0130-001,2018,4,30,20,1356,1948,3304,4171
0130-001,2018,4,30,21,1164,1735,2899,3304
0130-001,2018,4,30,22,1063,1222,2285,2899
0130-001,2018,4,30,23,737,847,1584,2285
0130-001,2018,4,30,24,561,525,1086,1584
0130-001,2018,5,1,1,409,443,852,1086
0130-001,2018,5,1,2,314,262,576,852
0130-001,2018,5,1,3,209,213,422,576
0130-001,2018,5,1,4,171,196,367,422
0130-001,2018,5,1,5,210,249,459,367
0130-001,2018,5,1,6,417,360,777,459
0130-001,2018,5,1,7,1254,604,1858,777
0130-001,2018,5,1,8,1546,1325,2871,1858
0130-001,2018,5,1,9,1674,1618,3292,2871
0130-001,2018,5,1,10,1630,1504,3134,3292
0130-001,2018,5,1,11,1674,1655,3329,3134
0130-001,2018,5,1,12,1641,1735,3376,3329
0130-001,2018,5,1,13,1677,1742,3419,3376
0130-001,2018,5,1,14,1748,1854,3602,3419
0130-001,2018,5,1,15,1693,1826,3519,3602
0130-001,2018,5,1,16,1764,1841,3605,3519
0130-001,2018,5,1,17,1581,1901,3482,3605
0130-001,2018,5,1,18,1676,2089,3765,3482
0130-001,2018,5,1,19,1533,1909,3442,3765
0130-001,2018,5,1,20,1239,1297,2536,3442
0130-001,2018,5,1,21,1018,1171,2189,2536
0130-001,2018,5,1,22,950,996,1946,2189
0130-001,2018,5,1,23,744,618,1362,1946
0130-001,2018,5,1,24,501,427,928,1362
0130-001,2018,5,2,1,294,279,573,928
0130-001,2018,5,2,2,194,183,377,573
0130-001,2018,5,2,3,167,155,322,377
0130-001,2018,5,2,4,155,161,316,322
0130-001,2018,5,2,5,218,212,430,316
0130-001,2018,5,2,6,565,377,942,430
0130-001,2018,5,2,7,1638,873,2511,942
0130-001,2018,5,2,8,1622,1548,3170,2511
0130-001,2018,5,2,9,1767,1917,3684,3170
0130-001,2018,5,2,10,1754,1574,3328,3684
0130-001,2018,5,2,11,1702,1651,3353,3328
0130-001,2018,5,2,12,1572,1651,3223,3353
0130-001,2018,5,2,13,1478,1399,2877,3223
0130-001,2018,5,2,14,1692,1636,3328,2877
0130-001,2018,5,2,15,1660,1600,3260,3328
0130-001,2018,5,2,16,1672,1760,3432,3260
0130-001,2018,5,2,17,1478,1919,3397,3432
0130-001,2018,5,2,18,1682,2292,3974,3397
0130-001,2018,5,2,19,1654,2353,4007,3974
0130-001,2018,5,2,20,1139,1691,2830,4007
0130-001,2018,5,2,21,1032,1563,2595,2830
0130-001,2018,5,2,22,995,1078,2073,2595
0130-001,2018,5,2,23,730,721,1451,2073
0130-001,2018,5,2,24,443,414,857,1451
0130-001,2018,5,3,1,320,338,658,857
0130-001,2018,5,3,2,187,199,386,658
0130-001,2018,5,3,3,159,152,311,386
0130-001,2018,5,3,4,153,143,296,311
0130-001,2018,5,3,5,235,236,471,296
0130-001,2018,5,3,6,634,453,1087,471
0130-001,2018,5,3,7,1729,919,2648,1087
0130-001,2018,5,3,8,1625,1641,3266,2648
0130-001,2018,5,3,9,1746,1907,3653,3266
0130-001,2018,5,3,10,1768,1572,3340,3653
0130-001,2018,5,3,11,1597,1574,3171,3340
0130-001,2018,5,3,12,1601,1560,3161,3171
0130-001,2018,5,3,13,1458,1482,2940,3161
0130-001,2018,5,3,14,1732,1774,3506,2940
0130-001,2018,5,3,15,1735,1719,3454,3506
0130-001,2018,5,3,16,1781,1842,3623,3454
0130-001,2018,5,3,17,1652,2019,3671,3623
0130-001,2018,5,3,18,1766,2326,4092,3671
0130-001,2018,5,3,19,1714,2396,4110,4092
0130-001,2018,5,3,20,1266,1909,3175,4110
0130-001,2018,5,3,21,1158,1768,2926,3175
0130-001,2018,5,3,22,1075,1254,2329,2926
0130-001,2018,5,3,23,798,806,1604,2329
0130-001,2018,5,3,24,502,515,1017,1604
0130-001,2018,5,4,1,359,351,710,1017
0130-001,2018,5,4,2,233,224,457,710
0130-001,2018,5,4,3,176,193,369,457
0130-001,2018,5,4,4,155,195,350,369
0130-001,2018,5,4,5,228,229,457,350
0130-001,2018,5,4,6,683,455,1138,457
0130-001,2018,5,4,7,1549,926,2475,1138
0130-001,2018,5,4,8,1619,1645,3264,2475
0130-001,2018,5,4,9,1815,1893,3708,3264
0130-001,2018,5,4,10,1868,1684,3552,3708
0130-001,2018,5,4,11,1653,1678,3331,3552
0130-001,2018,5,4,12,1659,1763,3422,3331
0130-001,2018,5,4,13,1581,1537,3118,3422
0130-001,2018,5,4,14,1729,1807,3536,3118
0130-001,2018,5,4,15,1799,1834,3633,3536
0130-001,2018,5,4,16,1782,1971,3753,3633
0130-001,2018,5,4,17,1663,2169,3832,3753
0130-001,2018,5,4,18,1996,2363,4359,3832
0130-001,2018,5,4,19,1795,2522,4317,4359
0130-001,2018,5,4,20,1529,2284,3813,4317
0130-001,2018,5,4,21,1287,2191,3478,3813
0130-001,2018,5,4,22,1262,1783,3045,3478
0130-001,2018,5,4,23,981,1153,2134,3045
0130-001,2018,5,4,24,636,830,1466,2134
0130-001,2018,5,5,1,463,509,972,1466
0130-001,2018,5,5,2,345,424,769,972
0130-001,2018,5,5,3,230,262,492,769
0130-001,2018,5,5,4,218,217,435,492
0130-001,2018,5,5,5,273,253,526,435
0130-001,2018,5,5,6,570,415,985,526
0130-001,2018,5,5,7,1094,739,1833,985
0130-001,2018,5,5,8,1196,1014,2210,1833
0130-001,2018,5,5,9,1399,1579,2978,2210
0130-001,2018,5,5,10,1604,1900,3504,2978
0130-001,2018,5,5,11,1641,2107,3748,3504
0130-001,2018,5,5,12,1552,2035,3587,3748
0130-001,2018,5,5,13,1522,2141,3663,3587
0130-001,2018,5,5,14,1462,2093,3555,3663
0130-001,2018,5,5,15,1587,1989,3576,3555
0130-001,2018,5,5,16,1598,1972,3570,3576
0130-001,2018,5,5,17,1642,2021,3663,3570
0130-001,2018,5,5,18,1598,2229,3827,3663
0130-001,2018,5,5,19,1607,2134,3741,3827
0130-001,2018,5,5,20,1286,1689,2975,3741
0130-001,2018,5,5,21,1164,1330,2494,2975
0130-001,2018,5,5,22,1000,989,1989,2494
0130-001,2018,5,5,23,693,700,1393,1989
0130-001,2018,5,5,24,496,473,969,1393
0130-001,2018,5,6,1,355,316,671,969
0130-001,2018,5,6,2,268,277,545,671
0130-001,2018,5,6,3,227,196,423,545
0130-001,2018,5,6,4,164,151,315,423
0130-001,2018,5,6,5,183,145,328,315
0130-001,2018,5,6,6,243,220,463,328
0130-001,2018,5,6,7,430,340,770,463
0130-001,2018,5,6,8,500,519,1019,770
0130-001,2018,5,6,9,671,795,1466,1019
0130-001,2018,5,6,10,964,1042,2006,1466
0130-001,2018,5,6,11,1200,1292,2492,2006
0130-001,2018,5,6,12,1346,1425,2771,2492
0130-001,2018,5,6,13,1356,1381,2737,2771
0130-001,2018,5,6,14,1474,1506,2980,2737
0130-001,2018,5,6,15,1513,1538,3051,2980
0130-001,2018,5,6,16,1604,1546,3150,3051
0130-001,2018,5,6,17,1634,1518,3152,3150
0130-001,2018,5,6,18,1679,1472,3151,3152
0130-001,2018,5,6,19,1691,1280,2971,3151
0130-001,2018,5,6,20,1450,1125,2575,2971
0130-001,2018,5,6,21,1364,995,2359,2575
0130-001,2018,5,6,22,1221,882,2103,2359
0130-001,2018,5,6,23,772,697,1469,2103
0130-001,2018,5,6,24,555,409,964,1469
0130-001,2018,5,7,1,321,268,589,964
0130-001,2018,5,7,2,258,204,462,589
0130-001,2018,5,7,3,173,158,331,462
0130-001,2018,5,7,4,142,169,311,331
0130-001,2018,5,7,5,216,192,408,311
0130-001,2018,5,7,6,539,343,882,408
0130-001,2018,5,7,7,1091,621,1712,882
0130-001,2018,5,7,8,1288,844,2132,1712
0130-001,2018,5,7,9,1114,1035,2149,2132
0130-001,2018,5,7,10,1315,1207,2522,2149
0130-001,2018,5,7,11,1463,1391,2854,2522
0130-001,2018,5,7,12,1715,1565,3280,2854
0130-001,2018,5,7,13,1523,1563,3086,3280
0130-001,2018,5,7,14,1625,1703,3328,3086
0130-001,2018,5,7,15,1689,1672,3361,3328
0130-001,2018,5,7,16,1787,1711,3498,3361
0130-001,2018,5,7,17,1632,1691,3323,3498
0130-001,2018,5,7,18,1698,2002,3700,3323
0130-001,2018,5,7,19,1770,1914,3684,3700
0130-001,2018,5,7,20,1754,1428,3182,3684
0130-001,2018,5,7,21,1449,1381,2830,3182
0130-001,2018,5,7,22,1105,1100,2205,2830
0130-001,2018,5,7,23,764,694,1458,2205
0130-001,2018,5,7,24,473,484,957,1458
0130-001,2018,5,8,1,294,296,590,957
0130-001,2018,5,8,2,182,155,337,590
0130-001,2018,5,8,3,144,145,289,337
0130-001,2018,5,8,4,128,156,284,289
0130-001,2018,5,8,5,234,221,455,284
0130-001,2018,5,8,6,686,438,1124,455
0130-001,2018,5,8,7,1797,964,2761,1124
0130-001,2018,5,8,8,1709,1661,3370,2761
0130-001,2018,5,8,9,1778,1843,3621,3370
0130-001,2018,5,8,10,1754,1607,3361,3621
0130-001,2018,5,8,11,1808,1647,3455,3361
0130-001,2018,5,8,12,1703,1579,3282,3455
0130-001,2018,5,8,13,1479,1490,2969,3282
0130-001,2018,5,8,14,1630,1616,3246,2969
0130-001,2018,5,8,15,1726,1728,3454,3246
0130-001,2018,5,8,16,1741,1788,3529,3454
0130-001,2018,5,8,17,1633,1970,3603,3529
0130-001,2018,5,8,18,1828,2342,4170,3603
0130-001,2018,5,8,19,1708,2410,4118,4170
0130-001,2018,5,8,20,1346,2047,3393,4118
0130-001,2018,5,8,21,1174,1814,2988,3393
0130-001,2018,5,8,22,1012,1308,2320,2988
0130-001,2018,5,8,23,795,821,1616,2320
0130-001,2018,5,8,24,461,471,932,1616
0130-001,2018,5,9,1,279,335,614,932
0130-001,2018,5,9,2,181,184,365,614
0130-001,2018,5,9,3,158,206,364,365
0130-001,2018,5,9,4,133,173,306,364
0130-001,2018,5,9,5,220,211,431,306
0130-001,2018,5,9,6,695,463,1158,431
0130-001,2018,5,9,7,1741,973,2714,1158
0130-001,2018,5,9,8,1673,1596,3269,2714
0130-001,2018,5,9,9,1778,1936,3714,3269
0130-001,2018,5,9,10,1749,1587,3336,3714
0130-001,2018,5,9,11,1674,1625,3299,3336
0130-001,2018,5,9,12,1580,1699,3279,3299
0130-001,2018,5,9,13,1479,1454,2933,3279
0130-001,2018,5,9,14,1710,1733,3443,2933
0130-001,2018,5,9,15,1613,1663,3276,3443
0130-001,2018,5,9,16,1773,1701,3474,3276
0130-001,2018,5,9,17,1582,1932,3514,3474
0130-001,2018,5,9,18,1800,2323,4123,3514
0130-001,2018,5,9,19,1647,2465,4112,4123
0130-001,2018,5,9,20,1292,1954,3246,4112
0130-001,2018,5,9,21,1104,1655,2759,3246
0130-001,2018,5,9,22,1140,1211,2351,2759
0130-001,2018,5,9,23,840,815,1655,2351
0130-001,2018,5,9,24,559,527,1086,1655
0130-001,2018,5,10,1,366,383,749,1086
0130-001,2018,5,10,2,215,263,478,749
0130-001,2018,5,10,3,170,189,359,478
0130-001,2018,5,10,4,162,194,356,359
0130-001,2018,5,10,5,237,236,473,356
0130-001,2018,5,10,6,685,448,1133,473
0130-001,2018,5,10,7,1757,973,2730,1133
0130-001,2018,5,10,8,1718,1615,3333,2730
0130-001,2018,5,10,9,1764,1898,3662,3333
0130-001,2018,5,10,10,1761,1714,3475,3662
0130-001,2018,5,10,11,1585,1590,3175,3475
0130-001,2018,5,10,12,1596,1566,3162,3175
0130-001,2018,5,10,13,1418,1462,2880,3162
0130-001,2018,5,10,14,1699,1654,3353,2880
0130-001,2018,5,10,15,1746,1683,3429,3353
0130-001,2018,5,10,16,1787,1777,3564,3429
0130-001,2018,5,10,17,1584,2067,3651,3564
0130-001,2018,5,10,18,1780,2328,4108,3651
0130-001,2018,5,10,19,1702,2447,4149,4108
0130-001,2018,5,10,20,1352,1918,3270,4149
0130-001,2018,5,10,21,1119,1825,2944,3270
0130-001,2018,5,10,22,1097,1337,2434,2944
0130-001,2018,5,10,23,815,837,1652,2434
0130-001,2018,5,10,24,591,534,1125,1652
0130-001,2018,5,11,1,388,361,749,1125
0130-001,2018,5,11,2,242,234,476,749
0130-001,2018,5,11,3,201,189,390,476
0130-001,2018,5,11,4,161,160,321,390
0130-001,2018,5,11,5,283,258,541,321
0130-001,2018,5,11,6,718,492,1210,541
0130-001,2018,5,11,7,1739,952,2691,1210
0130-001,2018,5,11,8,1734,1631,3365,2691
0130-001,2018,5,11,9,1742,1906,3648,3365
0130-001,2018,5,11,10,1666,1542,3208,3648
0130-001,2018,5,11,11,1666,1667,3333,3208
0130-001,2018,5,11,12,1584,1614,3198,3333
0130-001,2018,5,11,13,1526,1478,3004,3198
0130-001,2018,5,11,14,1647,1828,3475,3004
0130-001,2018,5,11,15,1722,1831,3553,3475
0130-001,2018,5,11,16,1823,1806,3629,3553
0130-001,2018,5,11,17,1746,2057,3803,3629
0130-001,2018,5,11,18,1863,2432,4295,3803
0130-001,2018,5,11,19,1755,2537,4292,4295
0130-001,2018,5,11,20,1333,2254,3587,4292
0130-001,2018,5,11,21,1166,1819,2985,3587
0130-001,2018,5,11,22,1129,1266,2395,2985
0130-001,2018,5,11,23,924,899,1823,2395
0130-001,2018,5,11,24,602,631,1233,1823
0130-001,2018,5,12,1,490,413,903,1233
0130-001,2018,5,12,2,325,304,629,903
0130-001,2018,5,12,3,275,286,561,629
0130-001,2018,5,12,4,225,232,457,561
0130-001,2018,5,12,5,275,263,538,457
0130-001,2018,5,12,6,495,402,897,538
0130-001,2018,5,12,7,1009,713,1722,897
0130-001,2018,5,12,8,1289,1063,2352,1722
0130-001,2018,5,12,9,1393,1602,2995,2352
0130-001,2018,5,12,10,1557,1732,3289,2995
0130-001,2018,5,12,11,1612,1830,3442,3289
0130-001,2018,5,12,12,1594,1780,3374,3442
0130-001,2018,5,12,13,1528,1753,3281,3374
0130-001,2018,5,12,14,1612,1747,3359,3281
0130-001,2018,5,12,15,1608,1724,3332,3359
0130-001,2018,5,12,16,1695,1669,3364,3332
0130-001,2018,5,12,17,1595,1770,3365,3364
0130-001,2018,5,12,18,1626,1944,3570,3365
0130-001,2018,5,12,19,1438,1622,3060,3570
0130-001,2018,5,12,20,1267,1158,2425,3060
0130-001,2018,5,12,21,1056,1053,2109,2425
0130-001,2018,5,12,22,936,834,1770,2109
0130-001,2018,5,12,23,724,606,1330,1770
0130-001,2018,5,12,24,458,449,907,1330
0130-001,2018,5,13,1,396,335,731,907
0130-001,2018,5,13,2,289,249,538,731
0130-001,2018,5,13,3,255,197,452,538
0130-001,2018,5,13,4,211,189,400,452
0130-001,2018,5,13,5,221,155,376,400
0130-001,2018,5,13,6,336,309,645,376
0130-001,2018,5,13,7,633,399,1032,645
0130-001,2018,5,13,8,651,606,1257,1032
0130-001,2018,5,13,9,912,917,1829,1257
0130-001,2018,5,13,10,1022,1128,2150,1829
0130-001,2018,5,13,11,1242,1280,2522,2150
0130-001,2018,5,13,12,1127,1305,2432,2522
0130-001,2018,5,13,13,1310,1327,2637,2432
0130-001,2018,5,13,14,1436,1385,2821,2637
0130-001,2018,5,13,15,1458,1433,2891,2821
0130-001,2018,5,13,16,1553,1543,3096,2891
0130-001,2018,5,13,17,1522,1469,2991,3096
0130-001,2018,5,13,18,1426,1561,2987,2991
0130-001,2018,5,13,19,1494,1413,2907,2987
0130-001,2018,5,13,20,1254,1163,2417,2907
0130-001,2018,5,13,21,1103,1068,2171,2417
0130-001,2018,5,13,22,957,896,1853,2171
0130-001,2018,5,13,23,714,659,1373,1853
0130-001,2018,5,13,24,464,404,868,1373
0130-001,2018,5,14,1,312,267,579,868
0130-001,2018,5,14,2,174,161,335,579
0130-001,2018,5,14,3,144,138,282,335
0130-001,2018,5,14,4,128,149,277,282
0130-001,2018,5,14,5,283,236,519,277
0130-001,2018,5,14,6,785,464,1249,519
0130-001,2018,5,14,7,1865,1013,2878,1249
0130-001,2018,5,14,8,1669,1649,3318,2878
0130-001,2018,5,14,9,1791,1813,3604,3318
0130-001,2018,5,14,10,1738,1601,3339,3604
0130-001,2018,5,14,11,1673,1593,3266,3339
0130-001,2018,5,14,12,1573,1621,3194,3266
0130-001,2018,5,14,13,1517,1461,2978,3194
0130-001,2018,5,14,14,1595,1606,3201,2978
0130-001,2018,5,14,15,1684,1677,3361,3201
0130-001,2018,5,14,16,1761,1832,3593,3361
0130-001,2018,5,14,17,1576,1973,3549,3593
0130-001,2018,5,14,18,1805,2320,4125,3549
0130-001,2018,5,14,19,1698,2390,4088,4125
0130-001,2018,5,14,20,1356,1920,3276,4088
0130-001,2018,5,14,21,1143,1800,2943,3276
0130-001,2018,5,14,22,1033,1297,2330,2943
0130-001,2018,5,14,23,823,733,1556,2330
0130-001,2018,5,14,24,456,510,966,1556
0130-001,2018,5,15,1,329,360,689,966
0130-001,2018,5,15,2,201,184,385,689
0130-001,2018,5,15,3,159,166,325,385
0130-001,2018,5,15,4,138,151,289,325
0130-001,2018,5,15,5,283,242,525,289
0130-001,2018,5,15,6,747,474,1221,525
0130-001,2018,5,15,7,1661,981,2642,1221
0130-001,2018,5,15,8,1686,1577,3263,2642
0130-001,2018,5,15,9,1813,1818,3631,3263
0130-001,2018,5,15,10,1792,1663,3455,3631
0130-001,2018,5,15,11,1765,1597,3362,3455
0130-001,2018,5,15,12,1663,1617,3280,3362
0130-001,2018,5,15,13,1359,1512,2871,3280
0130-001,2018,5,15,14,1669,1656,3325,2871
0130-001,2018,5,15,15,1608,1736,3344,3325
0130-001,2018,5,15,16,1605,1834,3439,3344
0130-001,2018,5,15,17,1640,1971,3611,3439
0130-001,2018,5,15,18,1760,2319,4079,3611
0130-001,2018,5,15,19,1683,2416,4099,4079
0130-001,2018,5,15,20,1368,1913,3281,4099
0130-001,2018,5,15,21,1169,1843,3012,3281
0130-001,2018,5,15,22,1111,1266,2377,3012
0130-001,2018,5,15,23,803,867,1670,2377
0130-001,2018,5,15,24,586,574,1160,1670
0130-001,2018,5,16,1,396,384,780,1160
0130-001,2018,5,16,2,234,240,474,780
0130-001,2018,5,16,3,198,200,398,474
0130-001,2018,5,16,4,157,157,314,398
0130-001,2018,5,16,5,282,242,524,314
0130-001,2018,5,16,6,597,398,995,524
0130-001,2018,5,16,7,1643,829,2472,995
0130-001,2018,5,16,8,1701,1586,3287,2472
0130-001,2018,5,16,9,1765,1919,3684,3287
0130-001,2018,5,16,10,1669,1600,3269,3684
0130-001,2018,5,16,11,1710,1586,3296,3269
0130-001,2018,5,16,12,1596,1527,3123,3296
0130-001,2018,5,16,13,1411,1401,2812,3123
0130-001,2018,5,16,14,1607,1645,3252,2812
0130-001,2018,5,16,15,1610,1623,3233,3252
0130-001,2018,5,16,16,1671,1708,3379,3233
0130-001,2018,5,16,17,1546,1947,3493,3379
0130-001,2018,5,16,18,1684,2290,3974,3493
0130-001,2018,5,16,19,1583,2397,3980,3974
0130-001,2018,5,16,20,1206,1725,2931,3980
0130-001,2018,5,16,21,1069,1479,2548,2931
0130-001,2018,5,16,22,1064,1130,2194,2548
0130-001,2018,5,16,23,824,746,1570,2194
0130-001,2018,5,16,24,506,510,1016,1570
0130-001,2018,5,17,1,385,376,761,1016
0130-001,2018,5,17,2,229,215,444,761
0130-001,2018,5,17,3,168,177,345,444
0130-001,2018,5,17,4,156,173,329,345
0130-001,2018,5,17,5,247,233,480,329
0130-001,2018,5,17,6,571,381,952,480
0130-001,2018,5,17,7,1595,896,2491,952
0130-001,2018,5,17,8,1618,1485,3103,2491
0130-001,2018,5,17,9,1683,1886,3569,3103
0130-001,2018,5,17,10,1594,1534,3128,3569
0130-001,2018,5,17,11,1619,1661,3280,3128
0130-001,2018,5,17,12,1564,1549,3113,3280
0130-001,2018,5,17,13,1410,1415,2825,3113
0130-001,2018,5,17,14,1687,1656,3343,2825
0130-001,2018,5,17,15,1674,1656,3330,3343
0130-001,2018,5,17,16,1475,1694,3169,3330
0130-001,2018,5,17,17,1616,1925,3541,3169
0130-001,2018,5,17,18,1776,2247,4023,3541
0130-001,2018,5,17,19,1596,2349,3945,4023
0130-001,2018,5,17,20,1207,1769,2976,3945
0130-001,2018,5,17,21,1088,1633,2721,2976
0130-001,2018,5,17,22,1045,1196,2241,2721
0130-001,2018,5,17,23,764,719,1483,2241
0130-001,2018,5,17,24,522,483,1005,1483
0130-001,2018,5,18,1,415,359,774,1005
0130-001,2018,5,18,2,263,226,489,774
0130-001,2018,5,18,3,164,169,333,489
0130-001,2018,5,18,4,153,175,328,333
0130-001,2018,5,18,5,283,266,549,328
0130-001,2018,5,18,6,620,437,1057,549
0130-001,2018,5,18,7,1553,855,2408,1057
0130-001,2018,5,18,8,1720,1528,3248,2408
0130-001,2018,5,18,9,1675,1932,3607,3248
0130-001,2018,5,18,10,1731,1632,3363,3607
0130-001,2018,5,18,11,1629,1702,3331,3363
0130-001,2018,5,18,12,1566,1640,3206,3331
0130-001,2018,5,18,13,1545,1498,3043,3206
0130-001,2018,5,18,14,1680,1583,3263,3043
0130-001,2018,5,18,15,1686,1543,3229,3263
0130-001,2018,5,18,16,1698,1897,3595,3229
0130-001,2018,5,18,17,1627,2078,3705,3595
0130-001,2018,5,18,18,1767,2251,4018,3705
0130-001,2018,5,18,19,1715,2330,4045,4018
0130-001,2018,5,18,20,1438,2134,3572,4045
0130-001,2018,5,18,21,1222,1730,2952,3572
0130-001,2018,5,18,22,1175,1259,2434,2952
0130-001,2018,5,18,23,862,887,1749,2434
0130-001,2018,5,18,24,584,590,1174,1749
0130-001,2018,5,19,1,434,431,865,1174
0130-001,2018,5,19,2,352,309,661,865
0130-001,2018,5,19,3,248,230,478,661
0130-001,2018,5,19,4,214,246,460,478
0130-001,2018,5,19,5,278,277,555,460
0130-001,2018,5,19,6,577,440,1017,555
0130-001,2018,5,19,7,1212,751,1963,1017
0130-001,2018,5,19,8,1419,1263,2682,1963
0130-001,2018,5,19,9,1508,1842,3350,2682
0130-001,2018,5,19,10,1637,1708,3345,3350
0130-001,2018,5,19,11,1566,1739,3305,3345
0130-001,2018,5,19,12,1568,1781,3349,3305
0130-001,2018,5,19,13,1638,1770,3408,3349
0130-001,2018,5,19,14,1653,1878,3531,3408
0130-001,2018,5,19,15,1642,1838,3480,3531
0130-001,2018,5,19,16,1689,1791,3480,3480
0130-001,2018,5,19,17,1767,1806,3573,3480
0130-001,2018,5,19,18,1695,2096,3791,3573
0130-001,2018,5,19,19,1698,2000,3698,3791
0130-001,2018,5,19,20,1375,1473,2848,3698
0130-001,2018,5,19,21,1224,1184,2408,2848
0130-001,2018,5,19,22,1089,1010,2099,2408
0130-001,2018,5,19,23,855,804,1659,2099
0130-001,2018,5,19,24,594,505,1099,1659
0130-001,2018,5,20,1,427,390,817,1099
0130-001,2018,5,20,2,322,293,615,817
0130-001,2018,5,20,3,264,227,491,615
0130-001,2018,5,20,4,195,184,379,491
0130-001,2018,5,20,5,246,184,430,379
0130-001,2018,5,20,6,409,303,712,430
0130-001,2018,5,20,7,826,512,1338,712
0130-001,2018,5,20,8,776,706,1482,1338
0130-001,2018,5,20,9,903,943,1846,1482
0130-001,2018,5,20,10,1114,1168,2282,1846
0130-001,2018,5,20,11,1315,1392,2707,2282
0130-001,2018,5,20,12,1084,1369,2453,2707
0130-001,2018,5,20,13,1402,1375,2777,2453
0130-001,2018,5,20,14,1369,1380,2749,2777
0130-001,2018,5,20,15,1218,1483,2701,2749
0130-001,2018,5,20,16,1357,1564,2921,2701
0130-001,2018,5,20,17,1443,1512,2955,2921
0130-001,2018,5,20,18,1489,1625,3114,2955
0130-001,2018,5,20,19,1442,1393,2835,3114
0130-001,2018,5,20,20,1217,1186,2403,2835
0130-001,2018,5,20,21,1169,1086,2255,2403
0130-001,2018,5,20,22,1065,902,1967,2255
0130-001,2018,5,20,23,722,648,1370,1967
0130-001,2018,5,20,24,511,434,945,1370
0130-001,2018,5,21,1,323,268,591,945
0130-001,2018,5,21,2,195,194,389,591
0130-001,2018,5,21,3,138,141,279,389
0130-001,2018,5,21,4,137,150,287,279
0130-001,2018,5,21,5,234,224,458,287
0130-001,2018,5,21,6,723,422,1145,458
0130-001,2018,5,21,7,1737,861,2598,1145
0130-001,2018,5,21,8,1684,1454,3138,2598
0130-001,2018,5,21,9,1663,1678,3341,3138
0130-001,2018,5,21,10,1592,1628,3220,3341
0130-001,2018,5,21,11,1141,1629,2770,3220
0130-001,2018,5,21,12,1569,1675,3244,2770
0130-001,2018,5,21,13,1548,1547,3095,3244
0130-001,2018,5,21,14,1697,1706,3403,3095
0130-001,2018,5,21,15,1777,1745,3522,3403
0130-001,2018,5,21,16,1738,1638,3376,3522
0130-001,2018,5,21,17,1598,1893,3491,3376
0130-001,2018,5,21,18,1870,2247,4117,3491
0130-001,2018,5,21,19,1760,2399,4159,4117
0130-001,2018,5,21,20,1303,1867,3170,4159
0130-001,2018,5,21,21,1212,1659,2871,3170
0130-001,2018,5,21,22,1061,1224,2285,2871
0130-001,2018,5,21,23,792,815,1607,2285
0130-001,2018,5,21,24,582,550,1132,1607
0130-001,2018,5,22,1,411,400,811,1132
0130-001,2018,5,22,2,296,296,592,811
0130-001,2018,5,22,3,263,252,515,592
0130-001,2018,5,22,4,203,220,423,515
0130-001,2018,5,22,5,252,279,531,423
0130-001,2018,5,22,6,623,379,1002,531
0130-001,2018,5,22,7,1249,713,1962,1002
0130-001,2018,5,22,8,1326,956,2282,1962
0130-001,2018,5,22,9,1250,1145,2395,2282
0130-001,2018,5,22,10,1332,1154,2486,2395
0130-001,2018,5,22,11,1429,1311,2740,2486
0130-001,2018,5,22,12,1477,1397,2874,2740
0130-001,2018,5,22,13,1569,1413,2982,2874
0130-001,2018,5,22,14,1495,1576,3071,2982
0130-001,2018,5,22,15,1478,1458,2936,3071
0130-001,2018,5,22,16,1523,1717,3240,2936
0130-001,2018,5,22,17,1442,1864,3306,3240
0130-001,2018,5,22,18,1590,1920,3510,3306
0130-001,2018,5,22,19,1430,1608,3038,3510
0130-001,2018,5,22,20,1204,1188,2392,3038
0130-001,2018,5,22,21,1017,1037,2054,2392
0130-001,2018,5,22,22,831,827,1658,2054
0130-001,2018,5,22,23,655,552,1207,1658
0130-001,2018,5,22,24,417,356,773,1207
0130-001,2018,5,23,1,247,244,491,773
0130-001,2018,5,23,2,164,166,330,491
0130-001,2018,5,23,3,105,127,232,330
0130-001,2018,5,23,4,130,153,283,232
0130-001,2018,5,23,5,226,213,439,283
0130-001,2018,5,23,6,675,441,1116,439
0130-001,2018,5,23,7,1717,914,2631,1116
0130-001,2018,5,23,8,1685,1649,3334,2631
0130-001,2018,5,23,9,1828,1828,3656,3334
0130-001,2018,5,23,10,1747,1554,3301,3656
0130-001,2018,5,23,11,1682,1679,3361,3301
0130-001,2018,5,23,12,1600,1568,3168,3361
0130-001,2018,5,23,13,1388,1440,2828,3168
0130-001,2018,5,23,14,1650,1632,3282,2828
0130-001,2018,5,23,15,1667,1760,3427,3282
0130-001,2018,5,23,16,1759,1793,3552,3427
0130-001,2018,5,23,17,1617,2042,3659,3552
0130-001,2018,5,23,18,1777,2272,4049,3659
0130-001,2018,5,23,19,1724,2494,4218,4049
0130-001,2018,5,23,20,1291,1892,3183,4218
0130-001,2018,5,23,21,1075,1627,2702,3183
0130-001,2018,5,23,22,1077,1213,2290,2702
0130-001,2018,5,23,23,745,804,1549,2290
0130-001,2018,5,23,24,515,498,1013,1549
0130-001,2018,5,24,1,352,338,690,1013
0130-001,2018,5,24,2,222,202,424,690
0130-001,2018,5,24,3,159,166,325,424
0130-001,2018,5,24,4,129,164,293,325
0130-001,2018,5,24,5,248,262,510,293
0130-001,2018,5,24,6,749,491,1240,510
0130-001,2018,5,24,7,1703,1004,2707,1240
0130-001,2018,5,24,8,1712,1553,3265,2707
0130-001,2018,5,24,9,1807,1918,3725,3265
0130-001,2018,5,24,10,1764,1644,3408,3725
0130-001,2018,5,24,11,1671,1623,3294,3408
0130-001,2018,5,24,12,1632,1629,3261,3294
0130-001,2018,5,24,13,1450,1433,2883,3261
0130-001,2018,5,24,14,1664,1717,3381,2883
0130-001,2018,5,24,15,1682,1743,3425,3381
0130-001,2018,5,24,16,1635,1777,3412,3425
0130-001,2018,5,24,17,1633,1829,3462,3412
0130-001,2018,5,24,18,1776,2268,4044,3462
0130-001,2018,5,24,19,1642,2368,4010,4044
0130-001,2018,5,24,20,1216,1821,3037,4010
0130-001,2018,5,24,21,1121,1771,2892,3037
0130-001,2018,5,24,22,1040,1286,2326,2892
0130-001,2018,5,24,23,792,836,1628,2326
0130-001,2018,5,24,24,566,512,1078,1628
0130-001,2018,5,25,1,365,347,712,1078
0130-001,2018,5,25,2,225,234,459,712
0130-001,2018,5,25,3,180,185,365,459
0130-001,2018,5,25,4,164,178,342,365
0130-001,2018,5,25,5,258,258,516,342
0130-001,2018,5,25,6,731,474,1205,516
0130-001,2018,5,25,7,1716,935,2651,1205
0130-001,2018,5,25,8,1687,1567,3254,2651
0130-001,2018,5,25,9,1783,1927,3710,3254
0130-001,2018,5,25,10,1737,1634,3371,3710
0130-001,2018,5,25,11,1716,1660,3376,3371
0130-001,2018,5,25,12,1631,1645,3276,3376
0130-001,2018,5,25,13,1417,1494,2911,3276
0130-001,2018,5,25,14,1600,1808,3408,2911
0130-001,2018,5,25,15,1710,1715,3425,3408
0130-001,2018,5,25,16,1677,1645,3322,3425
0130-001,2018,5,25,17,1697,2123,3820,3322
0130-001,2018,5,25,18,1900,2385,4285,3820
0130-001,2018,5,25,19,1707,2399,4106,4285
0130-001,2018,5,25,20,1379,1948,3327,4106
0130-001,2018,5,25,21,1196,1714,2910,3327
0130-001,2018,5,25,22,1180,1329,2509,2910
0130-001,2018,5,25,23,873,921,1794,2509
0130-001,2018,5,25,24,631,592,1223,1794
0130-001,2018,5,26,1,441,450,891,1223
0130-001,2018,5,26,2,335,291,626,891
0130-001,2018,5,26,3,249,248,497,626
0130-001,2018,5,26,4,204,219,423,497
0130-001,2018,5,26,5,286,307,593,423
0130-001,2018,5,26,6,648,449,1097,593
0130-001,2018,5,26,7,1194,773,1967,1097
0130-001,2018,5,26,8,1375,1113,2488,1967
0130-001,2018,5,26,9,1610,1623,3233,2488
0130-001,2018,5,26,10,1595,1734,3329,3233
0130-001,2018,5,26,11,1663,1815,3478,3329
0130-001,2018,5,26,12,1721,1896,3617,3478
0130-001,2018,5,26,13,1649,1727,3376,3617
0130-001,2018,5,26,14,1629,1837,3466,3376
0130-001,2018,5,26,15,1706,1765,3471,3466
0130-001,2018,5,26,16,1713,1779,3492,3471
0130-001,2018,5,26,17,1656,1882,3538,3492
0130-001,2018,5,26,18,1722,2156,3878,3538
0130-001,2018,5,26,19,1662,1789,3451,3878
0130-001,2018,5,26,20,1381,1447,2828,3451
0130-001,2018,5,26,21,1134,1208,2342,2828
0130-001,2018,5,26,22,1019,981,2000,2342
0130-001,2018,5,26,23,794,735,1529,2000
0130-001,2018,5,26,24,547,541,1088,1529
0130-001,2018,5,27,1,424,346,770,1088
0130-001,2018,5,27,2,314,288,602,770
0130-001,2018,5,27,3,272,205,477,602
0130-001,2018,5,27,4,166,174,340,477
0130-001,2018,5,27,5,208,177,385,340
0130-001,2018,5,27,6,436,290,726,385
0130-001,2018,5,27,7,700,478,1178,726
0130-001,2018,5,27,8,788,638,1426,1178
0130-001,2018,5,27,9,849,887,1736,1426
0130-001,2018,5,27,10,1067,1159,2226,1736
0130-001,2018,5,27,11,1215,1244,2459,2226
0130-001,2018,5,27,12,1164,1268,2432,2459
0130-001,2018,5,27,13,1282,1267,2549,2432
0130-001,2018,5,27,14,1420,1341,2761,2549
0130-001,2018,5,27,15,1428,1458,2886,2761
0130-001,2018,5,27,16,1389,1457,2846,2886
0130-001,2018,5,27,17,1482,1470,2952,2846
0130-001,2018,5,27,18,1422,1452,2874,2952
0130-001,2018,5,27,19,1442,1369,2811,2874
0130-001,2018,5,27,20,1200,1195,2395,2811
0130-001,2018,5,27,21,1032,1071,2103,2395
0130-001,2018,5,27,22,901,845,1746,2103
0130-001,2018,5,27,23,694,585,1279,1746
0130-001,2018,5,27,24,394,366,760,1279
0130-001,2018,5,28,1,292,228,520,760
0130-001,2018,5,28,2,187,161,348,520
0130-001,2018,5,28,3,153,127,280,348
0130-001,2018,5,28,4,133,161,294,280
0130-001,2018,5,28,5,265,228,493,294
0130-001,2018,5,28,6,759,444,1203,493
0130-001,2018,5,28,7,1789,955,2744,1203
0130-001,2018,5,28,8,1668,1651,3319,2744
0130-001,2018,5,28,9,1808,1846,3654,3319
0130-001,2018,5,28,10,1609,1593,3202,3654
0130-001,2018,5,28,11,1643,1542,3185,3202
0130-001,2018,5,28,12,1624,1572,3196,3185
0130-001,2018,5,28,13,1485,1509,2994,3196
0130-001,2018,5,28,14,1626,1679,3305,2994
0130-001,2018,5,28,15,1735,1692,3427,3305
0130-001,2018,5,28,16,1692,1868,3560,3427
0130-001,2018,5,28,17,1599,1944,3543,3560
0130-001,2018,5,28,18,1809,2319,4128,3543
0130-001,2018,5,28,19,1712,2484,4196,4128
0130-001,2018,5,28,20,1308,1860,3168,4196
0130-001,2018,5,28,21,1069,1786,2855,3168
0130-001,2018,5,28,22,1092,1232,2324,2855
0130-001,2018,5,28,23,742,709,1451,2324
0130-001,2018,5,28,24,477,436,913,1451
0130-001,2018,5,29,1,337,366,703,913
0130-001,2018,5,29,2,211,186,397,703
0130-001,2018,5,29,3,162,172,334,397
0130-001,2018,5,29,4,141,169,310,334
0130-001,2018,5,29,5,252,264,516,310
0130-001,2018,5,29,6,726,458,1184,516
0130-001,2018,5,29,7,1766,936,2702,1184
0130-001,2018,5,29,8,1670,1602,3272,2702
0130-001,2018,5,29,9,1855,1879,3734,3272
0130-001,2018,5,29,10,1765,1597,3362,3734
0130-001,2018,5,29,11,1657,1616,3273,3362
0130-001,2018,5,29,12,1481,1584,3065,3273
0130-001,2018,5,29,13,1480,1390,2870,3065
0130-001,2018,5,29,14,1664,1622,3286,2870
0130-001,2018,5,29,15,1582,1702,3284,3286
0130-001,2018,5,29,16,1726,1779,3505,3284
0130-001,2018,5,29,17,1623,1996,3619,3505
0130-001,2018,5,29,18,1649,2323,3972,3619
0130-001,2018,5,29,19,1626,2383,4009,3972
0130-001,2018,5,29,20,1296,1794,3090,4009
0130-001,2018,5,29,21,1157,1809,2966,3090
0130-001,2018,5,29,22,1087,1262,2349,2966
0130-001,2018,5,29,23,790,775,1565,2349
0130-001,2018,5,29,24,521,511,1032,1565
0130-001,2018,5,30,1,334,357,691,1032
0130-001,2018,5,30,2,217,180,397,691
0130-001,2018,5,30,3,172,201,373,397
0130-001,2018,5,30,4,140,177,317,373
0130-001,2018,5,30,5,242,223,465,317
0130-001,2018,5,30,6,701,432,1133,465
0130-001,2018,5,30,7,1675,855,2530,1133
0130-001,2018,5,30,8,1649,1526,3175,2530
0130-001,2018,5,30,9,1687,1946,3633,3175
0130-001,2018,5,30,10,1748,1560,3308,3633
0130-001,2018,5,30,11,1618,1596,3214,3308
0130-001,2018,5,30,12,1588,1608,3196,3214
0130-001,2018,5,30,13,1446,1447,2893,3196
0130-001,2018,5,30,14,1636,1704,3340,2893
0130-001,2018,5,30,15,1687,1742,3429,3340
0130-001,2018,5,30,16,1733,1755,3488,3429
0130-001,2018,5,30,17,1658,1973,3631,3488
0130-001,2018,5,30,18,1813,2377,4190,3631
0130-001,2018,5,30,19,1674,2345,4019,4190
0130-001,2018,5,30,20,1279,1965,3244,4019
0130-001,2018,5,30,21,1103,1561,2664,3244
0130-001,2018,5,30,22,1095,1250,2345,2664
0130-001,2018,5,30,23,896,835,1731,2345
0130-001,2018,5,30,24,586,525,1111,1731
0130-001,2018,5,31,1,366,369,735,1111
0130-001,2018,5,31,2,255,226,481,735
0130-001,2018,5,31,3,181,191,372,481
0130-001,2018,5,31,4,138,165,303,372
0130-001,2018,5,31,5,249,264,513,303
0130-001,2018,5,31,6,708,467,1175,513
0130-001,2018,5,31,7,1697,910,2607,1175
0130-001,2018,5,31,8,1663,1570,3233,2607
0130-001,2018,5,31,9,1817,1861,3678,3233
0130-001,2018,5,31,10,1693,1395,3088,3678
0130-001,2018,5,31,11,1620,1747,3367,3088
0130-001,2018,5,31,12,1618,1555,3173,3367
0130-001,2018,5,31,13,1392,1460,2852,3173
0130-001,2018,5,31,14,1701,1680,3381,2852
0130-001,2018,5,31,15,1736,1701,3437,3381
0130-001,2018,5,31,16,1666,1700,3366,3437
0130-001,2018,5,31,17,1614,2101,3715,3366
0130-001,2018,5,31,18,1813,2329,4142,3715
0130-001,2018,5,31,19,1680,2350,4030,4142
0130-001,2018,5,31,20,1323,1926,3249,4030
0130-001,2018,5,31,21,1157,1792,2949,3249
0130-001,2018,5,31,22,1062,1303,2365,2949
0130-001,2018,5,31,23,864,798,1662,2365
0130-001,2018,5,31,24,530,548,1078,1662
0130-001,2018,6,1,1,405,404,809,1078
0130-001,2018,6,1,2,243,229,472,809
0130-001,2018,6,1,3,183,203,386,472
0130-001,2018,6,1,4,169,211,380,386
0130-001,2018,6,1,5,247,263,510,380
0130-001,2018,6,1,6,756,472,1228,510
0130-001,2018,6,1,7,1787,935,2722,1228
0130-001,2018,6,1,8,1717,1578,3295,2722
0130-001,2018,6,1,9,1823,1877,3700,3295
0130-001,2018,6,1,10,1716,1626,3342,3700
0130-001,2018,6,1,11,1648,1620,3268,3342
0130-001,2018,6,1,12,1621,1581,3202,3268
0130-001,2018,6,1,13,1500,1554,3054,3202
0130-001,2018,6,1,14,1626,1691,3317,3054
0130-001,2018,6,1,15,1680,1671,3351,3317
0130-001,2018,6,1,16,1751,1817,3568,3351
0130-001,2018,6,1,17,1648,2090,3738,3568
0130-001,2018,6,1,18,1864,2417,4281,3738
0130-001,2018,6,1,19,1774,2466,4240,4281
0130-001,2018,6,1,20,1462,2128,3590,4240
0130-001,2018,6,1,21,1214,1790,3004,3590
0130-001,2018,6,1,22,1179,1309,2488,3004
0130-001,2018,6,1,23,930,844,1774,2488
0130-001,2018,6,1,24,594,620,1214,1774
0130-001,2018,6,2,1,470,439,909,1214
0130-001,2018,6,2,2,363,319,682,909
0130-001,2018,6,2,3,266,256,522,682
0130-001,2018,6,2,4,230,217,447,522
0130-001,2018,6,2,5,273,304,577,447
0130-001,2018,6,2,6,682,466,1148,577
0130-001,2018,6,2,7,1166,757,1923,1148
0130-001,2018,6,2,8,1405,1118,2523,1923
0130-001,2018,6,2,9,1574,1634,3208,2523
0130-001,2018,6,2,10,1579,1744,3323,3208
0130-001,2018,6,2,11,1718,1863,3581,3323
0130-001,2018,6,2,12,1725,1788,3513,3581
0130-001,2018,6,2,13,1579,1725,3304,3513
0130-001,2018,6,2,14,1570,1772,3342,3304
0130-001,2018,6,2,15,1616,1796,3412,3342
0130-001,2018,6,2,16,1682,1772,3454,3412
0130-001,2018,6,2,17,1777,1913,3690,3454
0130-001,2018,6,2,18,1727,2091,3818,3690
0130-001,2018,6,2,19,1676,1870,3546,3818
0130-001,2018,6,2,20,1309,1386,2695,3546
0130-001,2018,6,2,21,1153,1204,2357,2695
0130-001,2018,6,2,22,965,947,1912,2357
0130-001,2018,6,2,23,872,698,1570,1912
0130-001,2018,6,2,24,556,506,1062,1570
0130-001,2018,6,3,1,384,393,777,1062
0130-001,2018,6,3,2,284,258,542,777
0130-001,2018,6,3,3,258,215,473,542
0130-001,2018,6,3,4,190,181,371,473
0130-001,2018,6,3,5,227,170,397,371
0130-001,2018,6,3,6,443,274,717,397
0130-001,2018,6,3,7,689,445,1134,717
0130-001,2018,6,3,8,664,618,1282,1134
0130-001,2018,6,3,9,835,907,1742,1282
0130-001,2018,6,3,10,1046,1128,2174,1742
0130-001,2018,6,3,11,1167,1389,2556,2174
0130-001,2018,6,3,12,1237,1292,2529,2556
0130-001,2018,6,3,13,1294,1297,2591,2529
0130-001,2018,6,3,14,1361,1534,2895,2591
0130-001,2018,6,3,15,1457,1615,3072,2895
0130-001,2018,6,3,16,1572,1573,3145,3072
0130-001,2018,6,3,17,1514,1581,3095,3145
0130-001,2018,6,3,18,1609,1544,3153,3095
0130-001,2018,6,3,19,1556,1400,2956,3153
0130-001,2018,6,3,20,1315,1224,2539,2956
0130-001,2018,6,3,21,1212,1099,2311,2539
0130-001,2018,6,3,22,1107,911,2018,2311
0130-001,2018,6,3,23,663,613,1276,2018
0130-001,2018,6,3,24,444,399,843,1276
0130-001,2018,6,4,1,291,237,528,843
0130-001,2018,6,4,2,148,151,299,528
0130-001,2018,6,4,3,136,94,230,299
0130-001,2018,6,4,4,117,130,247,230
0130-001,2018,6,4,5,241,225,466,247
0130-001,2018,6,4,6,749,479,1228,466
0130-001,2018,6,4,7,1805,950,2755,1228
0130-001,2018,6,4,8,1719,1596,3315,2755
0130-001,2018,6,4,9,1770,1892,3662,3315
0130-001,2018,6,4,10,1691,1609,3300,3662
0130-001,2018,6,4,11,1710,1641,3351,3300
0130-001,2018,6,4,12,1647,1620,3267,3351
0130-001,2018,6,4,13,1513,1421,2934,3267
0130-001,2018,6,4,14,1609,1653,3262,2934
0130-001,2018,6,4,15,1813,1736,3549,3262
0130-001,2018,6,4,16,1656,1746,3402,3549
0130-001,2018,6,4,17,1677,2010,3687,3402
0130-001,2018,6,4,18,1679,2232,3911,3687
0130-001,2018,6,4,19,1680,2359,4039,3911
0130-001,2018,6,4,20,1187,1865,3052,4039
0130-001,2018,6,4,21,1095,1716,2811,3052
0130-001,2018,6,4,22,994,1188,2182,2811
0130-001,2018,6,4,23,710,780,1490,2182
0130-001,2018,6,4,24,461,452,913,1490
0130-001,2018,6,5,1,266,277,543,913
0130-001,2018,6,5,2,151,156,307,543
0130-001,2018,6,5,3,112,165,277,307
0130-001,2018,6,5,4,95,155,250,277
0130-001,2018,6,5,5,222,258,480,250
0130-001,2018,6,5,6,673,418,1091,480
0130-001,2018,6,5,7,1831,908,2739,1091
0130-001,2018,6,5,8,1672,1589,3261,2739
0130-001,2018,6,5,9,1872,1909,3781,3261
0130-001,2018,6,5,10,1801,1649,3450,3781
0130-001,2018,6,5,11,1713,1658,3371,3450
0130-001,2018,6,5,12,1556,1616,3172,3371
0130-001,2018,6,5,13,1493,1418,2911,3172
0130-001,2018,6,5,14,1652,1709,3361,2911
0130-001,2018,6,5,15,1717,1739,3456,3361
0130-001,2018,6,5,16,1708,1797,3505,3456
0130-001,2018,6,5,17,1691,1997,3688,3505
0130-001,2018,6,5,18,1786,2364,4150,3688
0130-001,2018,6,5,19,1745,2433,4178,4150
0130-001,2018,6,5,20,1382,2109,3491,4178
0130-001,2018,6,5,21,1237,1927,3164,3491
0130-001,2018,6,5,22,1190,1386,2576,3164
0130-001,2018,6,5,23,904,916,1820,2576
0130-001,2018,6,5,24,584,592,1176,1820
0130-001,2018,6,6,1,469,399,868,1176
0130-001,2018,6,6,2,306,328,634,868
0130-001,2018,6,6,3,254,278,532,634
0130-001,2018,6,6,4,204,190,394,532
0130-001,2018,6,6,5,293,269,562,394
0130-001,2018,6,6,6,680,432,1112,562
0130-001,2018,6,6,7,1205,752,1957,1112
0130-001,2018,6,6,8,1392,951,2343,1957
0130-001,2018,6,6,9,1348,1257,2605,2343
0130-001,2018,6,6,10,1436,1339,2775,2605
0130-001,2018,6,6,11,1446,1548,2994,2775
0130-001,2018,6,6,12,1456,1654,3110,2994
0130-001,2018,6,6,13,1373,1557,2930,3110
0130-001,2018,6,6,14,1519,1596,3115,2930
0130-001,2018,6,6,15,1505,1574,3079,3115
0130-001,2018,6,6,16,1647,1673,3320,3079
0130-001,2018,6,6,17,1707,1727,3434,3320
0130-001,2018,6,6,18,1572,2053,3625,3434
0130-001,2018,6,6,19,1482,1742,3224,3625
0130-001,2018,6,6,20,1265,1372,2637,3224
0130-001,2018,6,6,21,1079,1177,2256,2637
0130-001,2018,6,6,22,1021,922,1943,2256
0130-001,2018,6,6,23,746,638,1384,1943
0130-001,2018,6,6,24,430,391,821,1384
0130-001,2018,6,7,1,321,253,574,821
0130-001,2018,6,7,2,178,190,368,574
0130-001,2018,6,7,3,147,144,291,368
0130-001,2018,6,7,4,119,133,252,291
0130-001,2018,6,7,5,257,232,489,252
0130-001,2018,6,7,6,732,435,1167,489
0130-001,2018,6,7,7,1782,948,2730,1167
0130-001,2018,6,7,8,1709,1534,3243,2730
0130-001,2018,6,7,9,1855,1917,3772,3243
0130-001,2018,6,7,10,1613,1623,3236,3772
0130-001,2018,6,7,11,1549,1616,3165,3236
0130-001,2018,6,7,12,1547,1604,3151,3165
0130-001,2018,6,7,13,1424,1428,2852,3151
0130-001,2018,6,7,14,1600,1668,3268,2852
0130-001,2018,6,7,15,1558,1639,3197,3268
0130-001,2018,6,7,16,1658,1835,3493,3197
0130-001,2018,6,7,17,1672,1993,3665,3493
0130-001,2018,6,7,18,1798,2275,4073,3665
0130-001,2018,6,7,19,1676,2362,4038,4073
0130-001,2018,6,7,20,1337,1934,3271,4038
0130-001,2018,6,7,21,1114,1737,2851,3271
0130-001,2018,6,7,22,1020,1314,2334,2851
0130-001,2018,6,7,23,790,881,1671,2334
0130-001,2018,6,7,24,521,506,1027,1671
0130-001,2018,6,8,1,376,376,752,1027
0130-001,2018,6,8,2,226,226,452,752
0130-001,2018,6,8,3,202,180,382,452
0130-001,2018,6,8,4,139,175,314,382
0130-001,2018,6,8,5,270,278,548,314
0130-001,2018,6,8,6,766,468,1234,548
0130-001,2018,6,8,7,1667,977,2644,1234
0130-001,2018,6,8,8,1636,1533,3169,2644
0130-001,2018,6,8,9,1768,1917,3685,3169
0130-001,2018,6,8,10,1746,1644,3390,3685
0130-001,2018,6,8,11,1614,1709,3323,3390
0130-001,2018,6,8,12,1643,1690,3333,3323
0130-001,2018,6,8,13,1436,1563,2999,3333
0130-001,2018,6,8,14,1777,1735,3512,2999
0130-001,2018,6,8,15,1744,1862,3606,3512
0130-001,2018,6,8,16,1806,1855,3661,3606
0130-001,2018,6,8,17,1726,2075,3801,3661
0130-001,2018,6,8,18,1843,2370,4213,3801
0130-001,2018,6,8,19,1828,2443,4271,4213
0130-001,2018,6,8,20,1407,2241,3648,4271
0130-001,2018,6,8,21,1210,2007,3217,3648
0130-001,2018,6,8,22,1120,1280,2400,3217
0130-001,2018,6,8,23,876,881,1757,2400
0130-001,2018,6,8,24,622,597,1219,1757
0130-001,2018,6,9,1,469,457,926,1219
0130-001,2018,6,9,2,310,286,596,926
0130-001,2018,6,9,3,257,260,517,596
0130-001,2018,6,9,4,196,225,421,517
0130-001,2018,6,9,5,289,273,562,421
0130-001,2018,6,9,6,654,460,1114,562
0130-001,2018,6,9,7,1195,809,2004,1114
0130-001,2018,6,9,8,1414,1125,2539,2004
0130-001,2018,6,9,9,1596,1647,3243,2539
0130-001,2018,6,9,10,1562,1685,3247,3243
0130-001,2018,6,9,11,1580,1747,3327,3247
0130-001,2018,6,9,12,1680,1766,3446,3327
0130-001,2018,6,9,13,1622,1745,3367,3446
0130-001,2018,6,9,14,1617,1747,3364,3367
0130-001,2018,6,9,15,1590,1730,3320,3364
0130-001,2018,6,9,16,1705,1814,3519,3320
0130-001,2018,6,9,17,1748,1912,3660,3519
0130-001,2018,6,9,18,1716,2084,3800,3660
0130-001,2018,6,9,19,1701,1844,3545,3800
0130-001,2018,6,9,20,1231,1304,2535,3545
0130-001,2018,6,9,21,1070,1144,2214,2535
0130-001,2018,6,9,22,963,912,1875,2214
0130-001,2018,6,9,23,694,594,1288,1875
0130-001,2018,6,9,24,435,418,853,1288
0130-001,2018,6,10,1,402,385,787,853
0130-001,2018,6,10,2,349,268,617,787
0130-001,2018,6,10,3,172,180,352,617
0130-001,2018,6,10,4,197,157,354,352
0130-001,2018,6,10,5,196,168,364,354
0130-001,2018,6,10,6,325,249,574,364
0130-001,2018,6,10,7,488,378,866,574
0130-001,2018,6,10,8,553,444,997,866
0130-001,2018,6,10,9,775,687,1462,997
0130-001,2018,6,10,10,992,1116,2108,1462
0130-001,2018,6,10,11,1254,1305,2559,2108
0130-001,2018,6,10,12,1224,1292,2516,2559
0130-001,2018,6,10,13,1170,1304,2474,2516
0130-001,2018,6,10,14,1459,1359,2818,2474
0130-001,2018,6,10,15,1416,1416,2832,2818
0130-001,2018,6,10,16,1436,1462,2898,2832
0130-001,2018,6,10,17,1372,1582,2954,2898
0130-001,2018,6,10,18,1423,1449,2872,2954
0130-001,2018,6,10,19,1371,1310,2681,2872
0130-001,2018,6,10,20,1175,1140,2315,2681
0130-001,2018,6,10,21,1074,1020,2094,2315
0130-001,2018,6,10,22,927,844,1771,2094
0130-001,2018,6,10,23,653,635,1288,1771
0130-001,2018,6,10,24,436,371,807,1288
0130-001,2018,6,11,1,259,241,500,807
0130-001,2018,6,11,2,174,139,313,500
0130-001,2018,6,11,3,134,119,253,313
0130-001,2018,6,11,4,129,138,267,253
0130-001,2018,6,11,5,256,232,488,267
0130-001,2018,6,11,6,772,444,1216,488
0130-001,2018,6,11,7,1874,979,2853,1216
0130-001,2018,6,11,8,1703,1636,3339,2853
0130-001,2018,6,11,9,1757,1902,3659,3339
0130-001,2018,6,11,10,1762,1591,3353,3659
0130-001,2018,6,11,11,1645,1659,3304,3353
0130-001,2018,6,11,12,1587,1502,3089,3304
0130-001,2018,6,11,13,1522,1572,3094,3089
0130-001,2018,6,11,14,1680,1719,3399,3094
0130-001,2018,6,11,15,1707,1737,3444,3399
0130-001,2018,6,11,16,1735,1956,3691,3444
0130-001,2018,6,11,17,1555,1935,3490,3691
0130-001,2018,6,11,18,1660,2320,3980,3490
0130-001,2018,6,11,19,1637,2356,3993,3980
0130-001,2018,6,11,20,1281,1809,3090,3993
0130-001,2018,6,11,21,1144,1677,2821,3090
0130-001,2018,6,11,22,997,1246,2243,2821
0130-001,2018,6,11,23,715,749,1464,2243
0130-001,2018,6,11,24,460,471,931,1464
0130-001,2018,6,12,1,321,312,633,931
0130-001,2018,6,12,2,197,201,398,633
0130-001,2018,6,12,3,178,156,334,398
0130-001,2018,6,12,4,126,180,306,334
0130-001,2018,6,12,5,264,271,535,306
0130-001,2018,6,12,6,708,481,1189,535
0130-001,2018,6,12,7,1739,936,2675,1189
0130-001,2018,6,12,8,1721,1581,3302,2675
0130-001,2018,6,12,9,1815,1930,3745,3302
0130-001,2018,6,12,10,1697,1661,3358,3745
0130-001,2018,6,12,11,1649,1683,3332,3358
0130-001,2018,6,12,12,1574,1573,3147,3332
0130-001,2018,6,12,13,1436,1438,2874,3147
0130-001,2018,6,12,14,1734,1815,3549,2874
0130-001,2018,6,12,15,1681,1681,3362,3549
0130-001,2018,6,12,16,1767,1827,3594,3362
0130-001,2018,6,12,17,1640,2080,3720,3594
0130-001,2018,6,12,18,1835,2382,4217,3720
0130-001,2018,6,12,19,1733,2402,4135,4217
0130-001,2018,6,12,20,1378,2088,3466,4135
0130-001,2018,6,12,21,1219,1840,3059,3466
0130-001,2018,6,12,22,1102,1388,2490,3059
0130-001,2018,6,12,23,892,849,1741,2490
0130-001,2018,6,12,24,616,605,1221,1741
0130-001,2018,6,13,1,464,459,923,1221
0130-001,2018,6,13,2,332,316,648,923
0130-001,2018,6,13,3,275,236,511,648
0130-001,2018,6,13,4,210,223,433,511
0130-001,2018,6,13,5,338,287,625,433
0130-001,2018,6,13,6,618,392,1010,625
0130-001,2018,6,13,7,1224,711,1935,1010
0130-001,2018,6,13,8,1347,937,2284,1935
0130-001,2018,6,13,9,1381,1263,2644,2284
0130-001,2018,6,13,10,1538,1498,3036,2644
0130-001,2018,6,13,11,1402,1566,2968,3036
0130-001,2018,6,13,12,1510,1599,3109,2968
0130-001,2018,6,13,13,1408,1613,3021,3109
0130-001,2018,6,13,14,1507,1753,3260,3021
0130-001,2018,6,13,15,1557,1724,3281,3260
0130-001,2018,6,13,16,1630,1732,3362,3281
0130-001,2018,6,13,17,1596,1900,3496,3362
0130-001,2018,6,13,18,1711,2122,3833,3496
0130-001,2018,6,13,19,1468,1795,3263,3833
0130-001,2018,6,13,20,1193,1338,2531,3263
0130-001,2018,6,13,21,1136,1195,2331,2531
0130-001,2018,6,13,22,954,876,1830,2331
0130-001,2018,6,13,23,693,640,1333,1830
0130-001,2018,6,13,24,495,438,933,1333
0130-001,2018,6,14,1,335,302,637,933
0130-001,2018,6,14,2,223,191,414,637
0130-001,2018,6,14,3,168,157,325,414
0130-001,2018,6,14,4,155,170,325,325
0130-001,2018,6,14,5,254,229,483,325
0130-001,2018,6,14,6,708,437,1145,483
0130-001,2018,6,14,7,1720,945,2665,1145
0130-001,2018,6,14,8,1675,1583,3258,2665
0130-001,2018,6,14,9,1787,1897,3684,3258
0130-001,2018,6,14,10,1797,1647,3444,3684
0130-001,2018,6,14,11,1624,1615,3239,3444
0130-001,2018,6,14,12,1369,1344,2713,3239
0130-001,2018,6,14,13,1448,1506,2954,2713
0130-001,2018,6,14,14,1706,1650,3356,2954
0130-001,2018,6,14,15,1748,1457,3205,3356
0130-001,2018,6,14,16,1672,1848,3520,3205
0130-001,2018,6,14,17,1679,1887,3566,3520
0130-001,2018,6,14,18,1785,2394,4179,3566
0130-001,2018,6,14,19,1662,2499,4161,4179
0130-001,2018,6,14,20,1323,1860,3183,4161
0130-001,2018,6,14,21,1161,1823,2984,3183
0130-001,2018,6,14,22,987,1221,2208,2984
0130-001,2018,6,14,23,799,766,1565,2208
0130-001,2018,6,14,24,481,503,984,1565
0130-001,2018,6,15,1,350,366,716,984
0130-001,2018,6,15,2,210,245,455,716
0130-001,2018,6,15,3,171,162,333,455
0130-001,2018,6,15,4,160,170,330,333
0130-001,2018,6,15,5,271,259,530,330
0130-001,2018,6,15,6,733,428,1161,530
0130-001,2018,6,15,7,1691,932,2623,1161
0130-001,2018,6,15,8,1593,1508,3101,2623
0130-001,2018,6,15,9,1674,1873,3547,3101
0130-001,2018,6,15,10,1695,1651,3346,3547
0130-001,2018,6,15,11,1666,1590,3256,3346
0130-001,2018,6,15,12,1641,1742,3383,3256
0130-001,2018,6,15,13,1528,1580,3108,3383
0130-001,2018,6,15,14,1644,1711,3355,3108
0130-001,2018,6,15,15,1776,1786,3562,3355
0130-001,2018,6,15,16,1778,1835,3613,3562
0130-001,2018,6,15,17,1684,2090,3774,3613
0130-001,2018,6,15,18,1921,2356,4277,3774
0130-001,2018,6,15,19,1823,2476,4299,4277
0130-001,2018,6,15,20,1477,2196,3673,4299
0130-001,2018,6,15,21,1293,1864,3157,3673
0130-001,2018,6,15,22,1183,1303,2486,3157
0130-001,2018,6,15,23,939,901,1840,2486
0130-001,2018,6,15,24,617,620,1237,1840
0130-001,2018,6,16,1,488,436,924,1237
0130-001,2018,6,16,2,302,315,617,924
0130-001,2018,6,16,3,243,231,474,617
0130-001,2018,6,16,4,211,247,458,474
0130-001,2018,6,16,5,316,286,602,458
0130-001,2018,6,16,6,659,491,1150,602
0130-001,2018,6,16,7,1187,737,1924,1150
0130-001,2018,6,16,8,1410,1032,2442,1924
0130-001,2018,6,16,9,1543,1637,3180,2442
0130-001,2018,6,16,10,1642,1591,3233,3180
0130-001,2018,6,16,11,1694,1778,3472,3233
0130-001,2018,6,16,12,1648,1795,3443,3472
0130-001,2018,6,16,13,1614,1754,3368,3443
0130-001,2018,6,16,14,1705,1835,3540,3368
0130-001,2018,6,16,15,1674,1773,3447,3540
0130-001,2018,6,16,16,1740,1868,3608,3447
0130-001,2018,6,16,17,1773,1895,3668,3608
0130-001,2018,6,16,18,1757,2134,3891,3668
0130-001,2018,6,16,19,1676,1931,3607,3891
0130-001,2018,6,16,20,1282,1354,2636,3607
0130-001,2018,6,16,21,1150,1227,2377,2636
0130-001,2018,6,16,22,1029,913,1942,2377
0130-001,2018,6,16,23,818,698,1516,1942
0130-001,2018,6,16,24,529,520,1049,1516
0130-001,2018,6,17,1,424,377,801,1049
0130-001,2018,6,17,2,316,269,585,801
0130-001,2018,6,17,3,220,216,436,585
0130-001,2018,6,17,4,177,166,343,436
0130-001,2018,6,17,5,250,185,435,343
0130-001,2018,6,17,6,441,291,732,435
0130-001,2018,6,17,7,657,470,1127,732
0130-001,2018,6,17,8,752,632,1384,1127
0130-001,2018,6,17,9,878,882,1760,1384
0130-001,2018,6,17,10,979,1188,2167,1760
0130-001,2018,6,17,11,1146,1324,2470,2167
0130-001,2018,6,17,12,1170,1287,2457,2470
0130-001,2018,6,17,13,1300,1431,2731,2457
0130-001,2018,6,17,14,1498,1589,3087,2731
0130-001,2018,6,17,15,1534,1592,3126,3087
0130-001,2018,6,17,16,1505,1591,3096,3126
0130-001,2018,6,17,17,1540,1692,3232,3096
0130-001,2018,6,17,18,1612,1566,3178,3232
0130-001,2018,6,17,19,1719,1404,3123,3178
0130-001,2018,6,17,20,1277,1224,2501,3123
0130-001,2018,6,17,21,1213,1090,2303,2501
0130-001,2018,6,17,22,1032,839,1871,2303
0130-001,2018,6,17,23,683,603,1286,1871
0130-001,2018,6,17,24,427,352,779,1286
0130-001,2018,6,18,1,228,261,489,779
0130-001,2018,6,18,2,160,145,305,489
0130-001,2018,6,18,3,133,107,240,305
0130-001,2018,6,18,4,131,128,259,240
0130-001,2018,6,18,5,268,241,509,259
0130-001,2018,6,18,6,744,460,1204,509
0130-001,2018,6,18,7,1756,912,2668,1204
0130-001,2018,6,18,8,1650,1588,3238,2668
0130-001,2018,6,18,9,1804,1908,3712,3238
0130-001,2018,6,18,10,1773,1594,3367,3712
0130-001,2018,6,18,11,1698,1632,3330,3367
0130-001,2018,6,18,12,1606,1684,3290,3330
0130-001,2018,6,18,13,1381,1905,3286,3290
0130-001,2018,6,18,14,1667,1692,3359,3286
0130-001,2018,6,18,15,1696,1752,3448,3359
0130-001,2018,6,18,16,1712,1844,3556,3448
0130-001,2018,6,18,17,1652,2060,3712,3556
0130-001,2018,6,18,18,1820,2349,4169,3712
0130-001,2018,6,18,19,1735,2435,4170,4169
0130-001,2018,6,18,20,1318,1911,3229,4170
0130-001,2018,6,18,21,1113,1854,2967,3229
0130-001,2018,6,18,22,838,968,1806,2967
0130-001,2018,6,18,23,504,529,1033,1806
0130-001,2018,6,18,24,576,476,1052,1033
0130-001,2018,6,19,1,290,305,595,1052
0130-001,2018,6,19,2,166,197,363,595
0130-001,2018,6,19,3,140,157,297,363
0130-001,2018,6,19,4,148,159,307,297
0130-001,2018,6,19,5,265,256,521,307
0130-001,2018,6,19,6,741,431,1172,521
0130-001,2018,6,19,7,1705,922,2627,1172
0130-001,2018,6,19,8,1570,1547,3117,2627
0130-001,2018,6,19,9,1790,1829,3619,3117
0130-001,2018,6,19,10,1748,1712,3460,3619
0130-001,2018,6,19,11,1639,1584,3223,3460
0130-001,2018,6,19,12,1537,1563,3100,3223
0130-001,2018,6,19,13,1377,1408,2785,3100
0130-001,2018,6,19,14,1675,1657,3332,2785
0130-001,2018,6,19,15,1733,1662,3395,3332
0130-001,2018,6,19,16,1683,1808,3491,3395
0130-001,2018,6,19,17,1621,1944,3565,3491
0130-001,2018,6,19,18,1643,2334,3977,3565
0130-001,2018,6,19,19,1704,2365,4069,3977
0130-001,2018,6,19,20,1220,1784,3004,4069
0130-001,2018,6,19,21,1120,1719,2839,3004
0130-001,2018,6,19,22,1064,1305,2369,2839
0130-001,2018,6,19,23,756,793,1549,2369
0130-001,2018,6,19,24,457,491,948,1549
0130-001,2018,6,20,1,350,330,680,948
0130-001,2018,6,20,2,227,213,440,680
0130-001,2018,6,20,3,156,174,330,440
0130-001,2018,6,20,4,152,147,299,330
0130-001,2018,6,20,5,255,254,509,299
0130-001,2018,6,20,6,752,480,1232,509
0130-001,2018,6,20,7,1642,851,2493,1232
0130-001,2018,6,20,8,1706,1564,3270,2493
0130-001,2018,6,20,9,1761,1931,3692,3270
0130-001,2018,6,20,10,1769,1575,3344,3692
0130-001,2018,6,20,11,1667,1544,3211,3344
0130-001,2018,6,20,12,1557,1597,3154,3211
0130-001,2018,6,20,13,1422,1433,2855,3154
0130-001,2018,6,20,14,1655,1743,3398,2855
0130-001,2018,6,20,15,1708,1700,3408,3398
0130-001,2018,6,20,16,1648,1857,3505,3408
0130-001,2018,6,20,17,1656,1952,3608,3505
0130-001,2018,6,20,18,1826,2401,4227,3608
0130-001,2018,6,20,19,1703,2444,4147,4227
0130-001,2018,6,20,20,1316,1998,3314,4147
0130-001,2018,6,20,21,1070,1669,2739,3314
0130-001,2018,6,20,22,1120,1238,2358,2739
0130-001,2018,6,20,23,839,838,1677,2358
0130-001,2018,6,20,24,532,566,1098,1677
0130-001,2018,6,21,1,380,347,727,1098
0130-001,2018,6,21,2,226,249,475,727
0130-001,2018,6,21,3,182,209,391,475
0130-001,2018,6,21,4,166,202,368,391
0130-001,2018,6,21,5,268,264,532,368
0130-001,2018,6,21,6,768,448,1216,532
0130-001,2018,6,21,7,1719,922,2641,1216
0130-001,2018,6,21,8,1713,1574,3287,2641
0130-001,2018,6,21,9,1762,1934,3696,3287
0130-001,2018,6,21,10,1703,1654,3357,3696
0130-001,2018,6,21,11,1688,1615,3303,3357
0130-001,2018,6,21,12,1632,1590,3222,3303
0130-001,2018,6,21,13,1326,1458,2784,3222
0130-001,2018,6,21,14,1675,1728,3403,2784
0130-001,2018,6,21,15,1649,1729,3378,3403
0130-001,2018,6,21,16,1727,1713,3440,3378
0130-001,2018,6,21,17,1616,1921,3537,3440
0130-001,2018,6,21,18,1777,2265,4042,3537
0130-001,2018,6,21,19,1632,2448,4080,4042
0130-001,2018,6,21,20,1262,1929,3191,4080
0130-001,2018,6,21,21,1152,1806,2958,3191
0130-001,2018,6,21,22,1070,1356,2426,2958
0130-001,2018,6,21,23,835,768,1603,2426
0130-001,2018,6,21,24,549,562,1111,1603
0130-001,2018,6,22,1,395,357,752,1111
0130-001,2018,6,22,2,230,244,474,752
0130-001,2018,6,22,3,186,169,355,474
0130-001,2018,6,22,4,169,229,398,355
0130-001,2018,6,22,5,283,272,555,398
0130-001,2018,6,22,6,786,489,1275,555
0130-001,2018,6,22,7,1680,933,2613,1275
0130-001,2018,6,22,8,1694,1549,3243,2613
0130-001,2018,6,22,9,1795,1886,3681,3243
0130-001,2018,6,22,10,1636,1709,3345,3681
0130-001,2018,6,22,11,1685,1658,3343,3345
0130-001,2018,6,22,12,1636,1643,3279,3343
0130-001,2018,6,22,13,1424,1519,2943,3279
0130-001,2018,6,22,14,1723,1769,3492,2943
0130-001,2018,6,22,15,1734,1796,3530,3492
0130-001,2018,6,22,16,1716,1879,3595,3530
0130-001,2018,6,22,17,1729,2092,3821,3595
0130-001,2018,6,22,18,1934,2365,4299,3821
0130-001,2018,6,22,19,1887,2473,4360,4299
0130-001,2018,6,22,20,1403,2083,3486,4360
0130-001,2018,6,22,21,1257,1790,3047,3486
0130-001,2018,6,22,22,1097,1357,2454,3047
0130-001,2018,6,22,23,930,907,1837,2454
0130-001,2018,6,22,24,574,622,1196,1837
0130-001,2018,6,23,1,469,442,911,1196
0130-001,2018,6,23,2,304,289,593,911
0130-001,2018,6,23,3,256,252,508,593
0130-001,2018,6,23,4,183,214,397,508
0130-001,2018,6,23,5,308,297,605,397
0130-001,2018,6,23,6,689,474,1163,605
0130-001,2018,6,23,7,1240,772,2012,1163
0130-001,2018,6,23,8,1423,1051,2474,2012
0130-001,2018,6,23,9,1566,1558,3124,2474
0130-001,2018,6,23,10,1681,1648,3329,3124
0130-001,2018,6,23,11,1606,1814,3420,3329
0130-001,2018,6,23,12,1704,1855,3559,3420
0130-001,2018,6,23,13,1575,1848,3423,3559
0130-001,2018,6,23,14,1654,1882,3536,3423
0130-001,2018,6,23,15,1677,1817,3494,3536
0130-001,2018,6,23,16,1640,1781,3421,3494
0130-001,2018,6,23,17,1723,1882,3605,3421
0130-001,2018,6,23,18,1791,2049,3840,3605
0130-001,2018,6,23,19,1595,1895,3490,3840
0130-001,2018,6,23,20,1366,1470,2836,3490
0130-001,2018,6,23,21,1163,1269,2432,2836
0130-001,2018,6,23,22,1030,996,2026,2432
0130-001,2018,6,23,23,839,751,1590,2026
0130-001,2018,6,23,24,499,524,1023,1590
0130-001,2018,6,24,1,357,311,668,1023
0130-001,2018,6,24,2,214,228,442,668
0130-001,2018,6,24,3,303,278,581,442
0130-001,2018,6,24,4,177,168,345,581
0130-001,2018,6,24,5,214,180,394,345
0130-001,2018,6,24,6,454,320,774,394
0130-001,2018,6,24,7,665,461,1126,774
0130-001,2018,6,24,8,667,594,1261,1126
0130-001,2018,6,24,9,829,896,1725,1261
0130-001,2018,6,24,10,1020,1095,2115,1725
0130-001,2018,6,24,11,1197,1266,2463,2115
0130-001,2018,6,24,12,1099,1119,2218,2463
0130-001,2018,6,24,13,1246,1358,2604,2218
0130-001,2018,6,24,14,1408,1407,2815,2604
0130-001,2018,6,24,15,1341,1449,2790,2815
0130-001,2018,6,24,16,1467,1668,3135,2790
0130-001,2018,6,24,17,1442,1470,2912,3135
0130-001,2018,6,24,18,1462,1510,2972,2912
0130-001,2018,6,24,19,1462,1387,2849,2972
0130-001,2018,6,24,20,1233,1213,2446,2849
0130-001,2018,6,24,21,1156,1065,2221,2446
0130-001,2018,6,24,22,963,905,1868,2221
0130-001,2018,6,24,23,637,613,1250,1868
0130-001,2018,6,24,24,452,376,828,1250
0130-001,2018,6,25,1,282,265,547,828
0130-001,2018,6,25,2,150,150,300,547
0130-001,2018,6,25,3,146,125,271,300
0130-001,2018,6,25,4,110,139,249,271
0130-001,2018,6,25,5,257,216,473,249
0130-001,2018,6,25,6,760,434,1194,473
0130-001,2018,6,25,7,1861,965,2826,1194
0130-001,2018,6,25,8,1624,1629,3253,2826
0130-001,2018,6,25,9,1843,1914,3757,3253
0130-001,2018,6,25,10,1643,1593,3236,3757
0130-001,2018,6,25,11,1735,1634,3369,3236
0130-001,2018,6,25,12,1540,1592,3132,3369
0130-001,2018,6,25,13,1524,1470,2994,3132
0130-001,2018,6,25,14,1639,1689,3328,2994
0130-001,2018,6,25,15,1612,1697,3309,3328
0130-001,2018,6,25,16,1789,1826,3615,3309
0130-001,2018,6,25,17,1587,2014,3601,3615
0130-001,2018,6,25,18,1798,2326,4124,3601
0130-001,2018,6,25,19,1782,2404,4186,4124
0130-001,2018,6,25,20,1286,2003,3289,4186
0130-001,2018,6,25,21,1177,1795,2972,3289
0130-001,2018,6,25,22,1078,1276,2354,2972
0130-001,2018,6,25,23,730,768,1498,2354
0130-001,2018,6,25,24,468,536,1004,1498
0130-001,2018,6,26,1,328,328,656,1004
0130-001,2018,6,26,2,218,226,444,656
0130-001,2018,6,26,3,169,176,345,444
0130-001,2018,6,26,4,117,145,262,345
0130-001,2018,6,26,5,245,249,494,262
0130-001,2018,6,26,6,639,447,1086,494
0130-001,2018,6,26,7,1468,822,2290,1086
0130-001,2018,6,26,8,1616,1491,3107,2290
0130-001,2018,6,26,9,1393,1474,2867,3107
0130-001,2018,6,26,10,1325,1264,2589,2867
0130-001,2018,6,26,11,1190,1098,2288,2589
0130-001,2018,6,26,12,1168,1086,2254,2288
0130-001,2018,6,26,13,1050,1010,2060,2254
0130-001,2018,6,26,14,1107,1133,2240,2060
0130-001,2018,6,26,15,1198,1206,2404,2240
0130-001,2018,6,26,16,1352,1377,2729,2404
0130-001,2018,6,26,17,1252,1406,2658,2729
0130-001,2018,6,26,18,1301,1661,2962,2658
0130-001,2018,6,26,19,1355,1718,3073,2962
0130-001,2018,6,26,20,1045,1423,2468,3073
0130-001,2018,6,26,21,915,1382,2297,2468
0130-001,2018,6,26,22,756,979,1735,2297
0130-001,2018,6,26,23,493,569,1062,1735
0130-001,2018,6,26,24,355,409,764,1062
0130-001,2018,6,27,1,345,300,645,764
0130-001,2018,6,27,2,192,198,390,645
0130-001,2018,6,27,3,158,169,327,390
0130-001,2018,6,27,4,154,158,312,327
0130-001,2018,6,27,5,233,224,457,312
0130-001,2018,6,27,6,687,438,1125,457
0130-001,2018,6,27,7,1535,754,2289,1125
0130-001,2018,6,27,8,1758,1519,3277,2289
0130-001,2018,6,27,9,1645,1772,3417,3277
0130-001,2018,6,27,10,1660,1626,3286,3417
0130-001,2018,6,27,11,1681,1492,3173,3286
0130-001,2018,6,27,12,1604,1565,3169,3173
0130-001,2018,6,27,13,1417,1450,2867,3169
0130-001,2018,6,27,14,1612,1700,3312,2867
0130-001,2018,6,27,15,1703,1775,3478,3312
0130-001,2018,6,27,16,1758,1828,3586,3478
0130-001,2018,6,27,17,1609,1951,3560,3586
0130-001,2018,6,27,18,1780,2317,4097,3560
0130-001,2018,6,27,19,1697,2419,4116,4097
0130-001,2018,6,27,20,1272,1902,3174,4116
0130-001,2018,6,27,21,1086,1582,2668,3174
0130-001,2018,6,27,22,1149,1193,2342,2668
0130-001,2018,6,27,23,856,824,1680,2342
0130-001,2018,6,27,24,448,471,919,1680
0130-001,2018,6,28,1,267,271,538,919
0130-001,2018,6,28,2,301,266,567,538
0130-001,2018,6,28,3,183,186,369,567
0130-001,2018,6,28,4,157,167,324,369
0130-001,2018,6,28,5,262,246,508,324
0130-001,2018,6,28,6,697,440,1137,508
0130-001,2018,6,28,7,1646,865,2511,1137
0130-001,2018,6,28,8,1742,1547,3289,2511
0130-001,2018,6,28,9,1767,1922,3689,3289
0130-001,2018,6,28,10,1668,1554,3222,3689
0130-001,2018,6,28,11,1484,1531,3015,3222
0130-001,2018,6,28,12,1410,1402,2812,3015
0130-001,2018,6,28,13,1337,1294,2631,2812
0130-001,2018,6,28,14,1487,1426,2913,2631
0130-001,2018,6,28,15,1554,1540,3094,2913
0130-001,2018,6,28,16,1534,1720,3254,3094
0130-001,2018,6,28,17,1569,1870,3439,3254
0130-001,2018,6,28,18,1691,2146,3837,3439
0130-001,2018,6,28,19,1659,2256,3915,3837
0130-001,2018,6,28,20,1205,1748,2953,3915
0130-001,2018,6,28,21,1081,1588,2669,2953
0130-001,2018,6,28,22,911,1036,1947,2669
0130-001,2018,6,28,23,643,677,1320,1947
0130-001,2018,6,28,24,375,411,786,1320
0130-001,2018,6,29,1,310,321,631,786
0130-001,2018,6,29,2,166,196,362,631
0130-001,2018,6,29,3,134,142,276,362
0130-001,2018,6,29,4,106,161,267,276
0130-001,2018,6,29,5,202,217,419,267
0130-001,2018,6,29,6,568,366,934,419
0130-001,2018,6,29,7,1352,739,2091,934
0130-001,2018,6,29,8,1733,1468,3201,2091
0130-001,2018,6,29,9,1752,1893,3645,3201
0130-001,2018,6,29,10,1715,1610,3325,3645
0130-001,2018,6,29,11,1646,1688,3334,3325
0130-001,2018,6,29,12,1591,1677,3268,3334
0130-001,2018,6,29,13,1443,1606,3049,3268
0130-001,2018,6,29,14,1720,1725,3445,3049
0130-001,2018,6,29,15,1583,1756,3339,3445
0130-001,2018,6,29,16,1702,1956,3658,3339
0130-001,2018,6,29,17,1668,2106,3774,3658
0130-001,2018,6,29,18,1960,2341,4301,3774
0130-001,2018,6,29,19,1875,2398,4273,4301
0130-001,2018,6,29,20,1465,2188,3653,4273
0130-001,2018,6,29,21,1076,1525,2601,3653
0130-001,2018,6,29,22,997,1071,2068,2601
0130-001,2018,6,29,23,824,738,1562,2068
0130-001,2018,6,29,24,493,557,1050,1562
0130-001,2018,6,30,1,392,381,773,1050
0130-001,2018,6,30,2,316,282,598,773
0130-001,2018,6,30,3,226,246,472,598
0130-001,2018,6,30,4,178,213,391,472
0130-001,2018,6,30,5,232,268,500,391
0130-001,2018,6,30,6,612,436,1048,500
0130-001,2018,6,30,7,1115,720,1835,1048
0130-001,2018,6,30,8,1358,1028,2386,1835
0130-001,2018,6,30,9,1662,1461,3123,2386
0130-001,2018,6,30,10,1593,1654,3247,3123
0130-001,2018,6,30,11,1749,1849,3598,3247
0130-001,2018,6,30,12,1682,1875,3557,3598
0130-001,2018,6,30,13,1576,1866,3442,3557
0130-001,2018,6,30,14,1797,1890,3687,3442
0130-001,2018,6,30,15,1697,1828,3525,3687
0130-001,2018,6,30,16,1787,1827,3614,3525
0130-001,2018,6,30,17,1593,1976,3569,3614
0130-001,2018,6,30,18,1402,1492,2894,3569
0130-001,2018,6,30,19,1429,1474,2903,2894
0130-001,2018,6,30,20,1168,1245,2413,2903
0130-001,2018,6,30,21,1105,1137,2242,2413
0130-001,2018,6,30,22,1009,916,1925,2242
0130-001,2018,6,30,23,765,674,1439,1925
0130-001,2018,6,30,24,527,427,954,1439
0130-001,2018,7,1,1,387,352,739,954
0130-001,2018,7,1,2,296,275,571,739
0130-001,2018,7,1,3,229,200,429,571
0130-001,2018,7,1,4,120,135,255,429
0130-001,2018,7,1,5,166,156,322,255
0130-001,2018,7,1,6,224,192,416,322
0130-001,2018,7,1,7,351,295,646,416
0130-001,2018,7,1,8,396,417,813,646
0130-001,2018,7,1,9,502,613,1115,813
0130-001,2018,7,1,10,604,742,1346,1115
0130-001,2018,7,1,11,842,952,1794,1346
0130-001,2018,7,1,12,761,968,1729,1794
0130-001,2018,7,1,13,869,1171,2040,1729
0130-001,2018,7,1,14,1087,1088,2175,2040
0130-001,2018,7,1,15,1065,1137,2202,2175
0130-001,2018,7,1,16,1027,1201,2228,2202
0130-001,2018,7,1,17,1060,1063,2123,2228
0130-001,2018,7,1,18,1207,1057,2264,2123
0130-001,2018,7,1,19,1044,982,2026,2264
0130-001,2018,7,1,20,832,807,1639,2026
0130-001,2018,7,1,21,778,690,1468,1639
0130-001,2018,7,1,22,622,549,1171,1468
0130-001,2018,7,1,23,443,432,875,1171
0130-001,2018,7,1,24,261,272,533,875
0130-001,2018,7,2,1,196,184,380,533
0130-001,2018,7,2,2,101,136,237,380
0130-001,2018,7,2,3,86,101,187,237
0130-001,2018,7,2,4,87,117,204,187
0130-001,2018,7,2,5,144,149,293,204
0130-001,2018,7,2,6,419,292,711,293
0130-001,2018,7,2,7,1183,693,1876,711
0130-001,2018,7,2,8,1404,1256,2660,1876
0130-001,2018,7,2,9,1352,1524,2876,2660
0130-001,2018,7,2,10,1548,1450,2998,2876
0130-001,2018,7,2,11,1609,1554,3163,2998
0130-001,2018,7,2,12,1596,1636,3232,3163
0130-001,2018,7,2,13,1418,1451,2869,3232
0130-001,2018,7,2,14,1648,1632,3280,2869
0130-001,2018,7,2,15,1670,1718,3388,3280
0130-001,2018,7,2,16,1281,1315,2596,3388
0130-001,2018,7,2,17,1189,1376,2565,2596
0130-001,2018,7,2,18,1295,1653,2948,2565
0130-001,2018,7,2,19,1333,1733,3066,2948
0130-001,2018,7,2,20,999,1384,2383,3066
0130-001,2018,7,2,21,833,1317,2150,2383
0130-001,2018,7,2,22,701,941,1642,2150
0130-001,2018,7,2,23,506,611,1117,1642
0130-001,2018,7,2,24,325,394,719,1117
0130-001,2018,7,3,1,213,263,476,719
0130-001,2018,7,3,2,145,145,290,476
0130-001,2018,7,3,3,110,167,277,290
0130-001,2018,7,3,4,112,164,276,277
0130-001,2018,7,3,5,149,197,346,276
0130-001,2018,7,3,6,533,374,907,346
0130-001,2018,7,3,7,1597,799,2396,907
0130-001,2018,7,3,8,1768,1482,3250,2396
0130-001,2018,7,3,9,1787,1790,3577,3250
0130-001,2018,7,3,10,1673,1514,3187,3577
0130-001,2018,7,3,11,1724,1561,3285,3187
0130-001,2018,7,3,12,1667,1638,3305,3285
0130-001,2018,7,3,13,1437,1460,2897,3305
0130-001,2018,7,3,14,1714,1681,3395,2897
0130-001,2018,7,3,15,1702,1667,3369,3395
0130-001,2018,7,3,16,1673,1698,3371,3369
0130-001,2018,7,3,17,1560,1851,3411,3371
0130-001,2018,7,3,18,1737,2300,4037,3411
0130-001,2018,7,3,19,1687,2359,4046,4037
0130-001,2018,7,3,20,1309,1742,3051,4046
0130-001,2018,7,3,21,1161,1806,2967,3051
0130-001,2018,7,3,22,1019,1238,2257,2967
0130-001,2018,7,3,23,781,823,1604,2257
0130-001,2018,7,3,24,501,484,985,1604
0130-001,2018,7,4,1,325,305,630,985
0130-001,2018,7,4,2,233,213,446,630
0130-001,2018,7,4,3,171,183,354,446
0130-001,2018,7,4,4,134,160,294,354
0130-001,2018,7,4,5,252,224,476,294
0130-001,2018,7,4,6,710,455,1165,476
0130-001,2018,7,4,7,1659,893,2552,1165
0130-001,2018,7,4,8,1825,1491,3316,2552
0130-001,2018,7,4,9,1790,1842,3632,3316
0130-001,2018,7,4,10,1703,1610,3313,3632
0130-001,2018,7,4,11,1636,1585,3221,3313
0130-001,2018,7,4,12,1655,1577,3232,3221
0130-001,2018,7,4,13,1450,1550,3000,3232
0130-001,2018,7,4,14,1685,1721,3406,3000
0130-001,2018,7,4,15,1721,1747,3468,3406
0130-001,2018,7,4,16,1741,1815,3556,3468
0130-001,2018,7,4,17,1576,1967,3543,3556
0130-001,2018,7,4,18,1554,1831,3385,3543
0130-001,2018,7,4,19,1539,2000,3539,3385
0130-001,2018,7,4,20,1312,1932,3244,3539
0130-001,2018,7,4,21,1086,1519,2605,3244
0130-001,2018,7,4,22,1015,1158,2173,2605
0130-001,2018,7,4,23,725,727,1452,2173
0130-001,2018,7,4,24,388,398,786,1452
0130-001,2018,7,5,1,288,311,599,786
0130-001,2018,7,5,2,175,201,376,599
0130-001,2018,7,5,3,135,183,318,376
0130-001,2018,7,5,4,121,162,283,318
0130-001,2018,7,5,5,189,218,407,283
0130-001,2018,7,5,6,517,378,895,407
0130-001,2018,7,5,7,1261,695,1956,895
0130-001,2018,7,5,8,1772,1462,3234,1956
0130-001,2018,7,5,9,1808,1883,3691,3234
0130-001,2018,7,5,10,1674,1594,3268,3691
0130-001,2018,7,5,11,1683,1602,3285,3268
0130-001,2018,7,5,12,1539,1606,3145,3285
0130-001,2018,7,5,13,1551,1519,3070,3145
0130-001,2018,7,5,14,1528,1556,3084,3070
0130-001,2018,7,5,15,1505,1379,2884,3084
0130-001,2018,7,5,16,1573,1645,3218,2884
0130-001,2018,7,5,17,1294,1470,2764,3218
0130-001,2018,7,5,18,1753,2257,4010,2764
0130-001,2018,7,5,19,1694,2351,4045,4010
0130-001,2018,7,5,20,1253,1876,3129,4045
0130-001,2018,7,5,21,965,1398,2363,3129
0130-001,2018,7,5,22,766,909,1675,2363
0130-001,2018,7,5,23,590,678,1268,1675
0130-001,2018,7,5,24,425,456,881,1268
0130-001,2018,7,6,1,335,324,659,881
0130-001,2018,7,6,2,234,245,479,659
0130-001,2018,7,6,3,202,187,389,479
0130-001,2018,7,6,4,153,191,344,389
0130-001,2018,7,6,5,247,224,471,344
0130-001,2018,7,6,6,712,419,1131,471
0130-001,2018,7,6,7,1659,887,2546,1131
0130-001,2018,7,6,8,1815,1530,3345,2546
0130-001,2018,7,6,9,1708,1849,3557,3345
0130-001,2018,7,6,10,1791,1557,3348,3557
0130-001,2018,7,6,11,1754,1620,3374,3348
0130-001,2018,7,6,12,1761,1591,3352,3374
0130-001,2018,7,6,13,1541,1745,3286,3352
0130-001,2018,7,6,14,1704,1682,3386,3286
0130-001,2018,7,6,15,1745,1775,3520,3386
0130-001,2018,7,6,16,1777,1892,3669,3520
0130-001,2018,7,6,17,1743,2050,3793,3669
0130-001,2018,7,6,18,1864,2370,4234,3793
0130-001,2018,7,6,19,1799,2478,4277,4234
0130-001,2018,7,6,20,1468,2037,3505,4277
0130-001,2018,7,6,21,1200,1747,2947,3505
0130-001,2018,7,6,22,1187,1277,2464,2947
0130-001,2018,7,6,23,896,887,1783,2464
0130-001,2018,7,6,24,617,581,1198,1783
0130-001,2018,7,7,1,509,381,890,1198
0130-001,2018,7,7,2,360,318,678,890
0130-001,2018,7,7,3,290,231,521,678
0130-001,2018,7,7,4,200,225,425,521
0130-001,2018,7,7,5,264,255,519,425
0130-001,2018,7,7,6,642,438,1080,519
0130-001,2018,7,7,7,1143,736,1879,1080
0130-001,2018,7,7,8,1342,1030,2372,1879
0130-001,2018,7,7,9,1483,1368,2851,2372
0130-001,2018,7,7,10,1484,1614,3098,2851
0130-001,2018,7,7,11,1722,1751,3473,3098
0130-001,2018,7,7,12,1702,1735,3437,3473
0130-001,2018,7,7,13,1731,1830,3561,3437
0130-001,2018,7,7,14,1727,1848,3575,3561
0130-001,2018,7,7,15,1706,1796,3502,3575
0130-001,2018,7,7,16,1810,1779,3589,3502
0130-001,2018,7,7,17,1707,1922,3629,3589
0130-001,2018,7,7,18,1760,2044,3804,3629
0130-001,2018,7,7,19,1658,1946,3604,3804
0130-001,2018,7,7,20,1323,1395,2718,3604
0130-001,2018,7,7,21,1158,1231,2389,2718
0130-001,2018,7,7,22,1178,1061,2239,2389
0130-001,2018,7,7,23,874,756,1630,2239
0130-001,2018,7,7,24,531,543,1074,1630
0130-001,2018,7,8,1,423,369,792,1074
0130-001,2018,7,8,2,331,260,591,792
0130-001,2018,7,8,3,244,206,450,591
0130-001,2018,7,8,4,208,159,367,450
0130-001,2018,7,8,5,213,166,379,367
0130-001,2018,7,8,6,415,309,724,379
0130-001,2018,7,8,7,678,480,1158,724
0130-001,2018,7,8,8,692,595,1287,1158
0130-001,2018,7,8,9,845,849,1694,1287
0130-001,2018,7,8,10,924,1016,1940,1694
0130-001,2018,7,8,11,1147,1240,2387,1940
0130-001,2018,7,8,12,1112,1173,2285,2387
0130-001,2018,7,8,13,1252,1300,2552,2285
0130-001,2018,7,8,14,1329,1464,2793,2552
0130-001,2018,7,8,15,1411,1467,2878,2793
0130-001,2018,7,8,16,1520,1444,2964,2878
0130-001,2018,7,8,17,1554,1534,3088,2964
0130-001,2018,7,8,18,1706,1447,3153,3088
0130-001,2018,7,8,19,1535,1335,2870,3153
0130-001,2018,7,8,20,1142,1183,2325,2870
0130-001,2018,7,8,21,1161,1038,2199,2325
0130-001,2018,7,8,22,953,915,1868,2199
0130-001,2018,7,8,23,694,662,1356,1868
0130-001,2018,7,8,24,442,397,839,1356
0130-001,2018,7,9,1,272,219,491,839
0130-001,2018,7,9,2,176,157,333,491
0130-001,2018,7,9,3,153,119,272,333
0130-001,2018,7,9,4,115,140,255,272
0130-001,2018,7,9,5,245,214,459,255
0130-001,2018,7,9,6,717,389,1106,459
0130-001,2018,7,9,7,1230,706,1936,1106
0130-001,2018,7,9,8,1384,1186,2570,1936
0130-001,2018,7,9,9,1294,1394,2688,2570
0130-001,2018,7,9,10,1224,1147,2371,2688
0130-001,2018,7,9,11,1243,1225,2468,2371
0130-001,2018,7,9,12,1218,1152,2370,2468
0130-001,2018,7,9,13,1053,1121,2174,2370
0130-001,2018,7,9,14,1210,1192,2402,2174
0130-001,2018,7,9,15,1253,1293,2546,2402
0130-001,2018,7,9,16,1252,1301,2553,2546
0130-001,2018,7,9,17,1183,1468,2651,2553
0130-001,2018,7,9,18,1432,1936,3368,2651
0130-001,2018,7,9,19,1665,2150,3815,3368
0130-001,2018,7,9,20,1121,1479,2600,3815
0130-001,2018,7,9,21,759,1279,2038,2600
0130-001,2018,7,9,22,679,963,1642,2038
0130-001,2018,7,9,23,486,567,1053,1642
0130-001,2018,7,9,24,327,368,695,1053
0130-001,2018,7,10,1,258,245,503,695
0130-001,2018,7,10,2,116,180,296,503
0130-001,2018,7,10,3,122,162,284,296
0130-001,2018,7,10,4,132,177,309,284
0130-001,2018,7,10,5,213,211,424,309
0130-001,2018,7,10,6,664,452,1116,424
0130-001,2018,7,10,7,1585,852,2437,1116
0130-001,2018,7,10,8,1865,1524,3389,2437
0130-001,2018,7,10,9,1788,1833,3621,3389
0130-001,2018,7,10,10,1728,1523,3251,3621
0130-001,2018,7,10,11,1666,1552,3218,3251
0130-001,2018,7,10,12,1581,1579,3160,3218
0130-001,2018,7,10,13,1374,1391,2765,3160
0130-001,2018,7,10,14,1651,1691,3342,2765
0130-001,2018,7,10,15,1696,1667,3363,3342
0130-001,2018,7,10,16,1806,1808,3614,3363
0130-001,2018,7,10,17,1521,1995,3516,3614
0130-001,2018,7,10,18,1812,2266,4078,3516
0130-001,2018,7,10,19,1673,2313,3986,4078
0130-001,2018,7,10,20,1121,1442,2563,3986
0130-001,2018,7,10,21,861,1338,2199,2563
0130-001,2018,7,10,22,856,991,1847,2199
0130-001,2018,7,10,23,576,645,1221,1847
0130-001,2018,7,10,24,399,408,807,1221
0130-001,2018,7,11,1,264,294,558,807
0130-001,2018,7,11,2,174,204,378,558
0130-001,2018,7,11,3,140,163,303,378
0130-001,2018,7,11,4,111,182,293,303
0130-001,2018,7,11,5,186,199,385,293
0130-001,2018,7,11,6,596,385,981,385
0130-001,2018,7,11,7,1283,715,1998,981
0130-001,2018,7,11,8,1425,1268,2693,1998
0130-001,2018,7,11,9,1552,1599,3151,2693
0130-001,2018,7,11,10,1716,1531,3247,3151
0130-001,2018,7,11,11,1691,1608,3299,3247
0130-001,2018,7,11,12,1545,1632,3177,3299
0130-001,2018,7,11,13,1390,1377,2767,3177
0130-001,2018,7,11,14,1679,1737,3416,2767
0130-001,2018,7,11,15,1651,1762,3413,3416
0130-001,2018,7,11,16,1716,1749,3465,3413
0130-001,2018,7,11,17,1503,1999,3502,3465
0130-001,2018,7,11,18,1634,2115,3749,3502
0130-001,2018,7,11,19,1689,2430,4119,3749
0130-001,2018,7,11,20,1281,1857,3138,4119
0130-001,2018,7,11,21,1125,1554,2679,3138
0130-001,2018,7,11,22,1035,1141,2176,2679
0130-001,2018,7,11,23,757,695,1452,2176
0130-001,2018,7,11,24,499,450,949,1452
0130-001,2018,7,12,1,376,339,715,949
0130-001,2018,7,12,2,202,222,424,715
0130-001,2018,7,12,3,166,193,359,424
0130-001,2018,7,12,4,138,180,318,359
0130-001,2018,7,12,5,227,201,428,318
0130-001,2018,7,12,6,689,450,1139,428
0130-001,2018,7,12,7,1626,894,2520,1139
0130-001,2018,7,12,8,1747,1554,3301,2520
0130-001,2018,7,12,9,1865,1909,3774,3301
0130-001,2018,7,12,10,1738,1551,3289,3774
0130-001,2018,7,12,11,1636,1678,3314,3289
0130-001,2018,7,12,12,1615,1821,3436,3314
0130-001,2018,7,12,13,1350,1500,2850,3436
0130-001,2018,7,12,14,1730,1666,3396,2850
0130-001,2018,7,12,15,1653,1823,3476,3396
0130-001,2018,7,12,16,1681,1958,3639,3476
0130-001,2018,7,12,17,1635,1918,3553,3639
0130-001,2018,7,12,18,1769,2368,4137,3553
0130-001,2018,7,12,19,1698,2378,4076,4137
0130-001,2018,7,12,20,1315,1935,3250,4076
0130-001,2018,7,12,21,1157,1729,2886,3250
0130-001,2018,7,12,22,1143,1258,2401,2886
0130-001,2018,7,12,23,848,851,1699,2401
0130-001,2018,7,12,24,573,538,1111,1699
0130-001,2018,7,13,1,387,395,782,1111
0130-001,2018,7,13,2,267,216,483,782
0130-001,2018,7,13,3,185,175,360,483
0130-001,2018,7,13,4,146,199,345,360
0130-001,2018,7,13,5,245,243,488,345
0130-001,2018,7,13,6,697,448,1145,488
0130-001,2018,7,13,7,1663,889,2552,1145
0130-001,2018,7,13,8,1856,1583,3439,2552
0130-001,2018,7,13,9,1802,1933,3735,3439
0130-001,2018,7,13,10,1674,1607,3281,3735
0130-001,2018,7,13,11,1608,1684,3292,3281
0130-001,2018,7,13,12,1644,1595,3239,3292
0130-001,2018,7,13,13,1438,1548,2986,3239
0130-001,2018,7,13,14,1717,1806,3523,2986
0130-001,2018,7,13,15,1680,1781,3461,3523
0130-001,2018,7,13,16,1840,1953,3793,3461
0130-001,2018,7,13,17,1800,2145,3945,3793
0130-001,2018,7,13,18,1876,2359,4235,3945
0130-001,2018,7,13,19,1779,2532,4311,4235
0130-001,2018,7,13,20,1515,2086,3601,4311
0130-001,2018,7,13,21,1346,1769,3115,3601
0130-001,2018,7,13,22,1293,1292,2585,3115
0130-001,2018,7,13,23,918,860,1778,2585
0130-001,2018,7,13,24,610,635,1245,1778
0130-001,2018,7,14,1,509,455,964,1245
0130-001,2018,7,14,2,350,345,695,964
0130-001,2018,7,14,3,258,267,525,695
0130-001,2018,7,14,4,205,226,431,525
0130-001,2018,7,14,5,267,212,479,431
0130-001,2018,7,14,6,645,394,1039,479
0130-001,2018,7,14,7,1151,749,1900,1039
0130-001,2018,7,14,8,1426,1100,2526,1900
0130-001,2018,7,14,9,1774,1498,3272,2526
0130-001,2018,7,14,10,1643,1730,3373,3272
0130-001,2018,7,14,11,1692,1818,3510,3373
0130-001,2018,7,14,12,1729,1913,3642,3510
0130-001,2018,7,14,13,1519,1897,3416,3642
0130-001,2018,7,14,14,1721,1919,3640,3416
0130-001,2018,7,14,15,1605,1833,3438,3640
0130-001,2018,7,14,16,1732,1796,3528,3438
0130-001,2018,7,14,17,1702,1904,3606,3528
0130-001,2018,7,14,18,1787,2016,3803,3606
0130-001,2018,7,14,19,1616,1927,3543,3803
0130-001,2018,7,14,20,1366,1393,2759,3543
0130-001,2018,7,14,21,1264,1201,2465,2759
0130-001,2018,7,14,22,1182,976,2158,2465
0130-001,2018,7,14,23,934,721,1655,2158
0130-001,2018,7,14,24,590,507,1097,1655
0130-001,2018,7,15,1,401,357,758,1097
0130-001,2018,7,15,2,324,318,642,758
0130-001,2018,7,15,3,228,208,436,642
0130-001,2018,7,15,4,191,146,337,436
0130-001,2018,7,15,5,235,144,379,337
0130-001,2018,7,15,6,436,284,720,379
0130-001,2018,7,15,7,654,477,1131,720
0130-001,2018,7,15,8,630,632,1262,1131
0130-001,2018,7,15,9,852,895,1747,1262
0130-001,2018,7,15,10,979,1180,2159,1747
0130-001,2018,7,15,11,1194,1378,2572,2159
0130-001,2018,7,15,12,1234,1399,2633,2572
0130-001,2018,7,15,13,1292,1449,2741,2633
0130-001,2018,7,15,14,1345,1502,2847,2741
0130-001,2018,7,15,15,1357,1484,2841,2847
0130-001,2018,7,15,16,1600,1572,3172,2841
0130-001,2018,7,15,17,1559,1486,3045,3172
0130-001,2018,7,15,18,1625,1607,3232,3045
0130-001,2018,7,15,19,1670,1552,3222,3232
0130-001,2018,7,15,20,1334,1194,2528,3222
0130-001,2018,7,15,21,1164,1113,2277,2528
0130-001,2018,7,15,22,1080,926,2006,2277
0130-001,2018,7,15,23,726,617,1343,2006
0130-001,2018,7,15,24,467,419,886,1343
0130-001,2018,7,16,1,270,263,533,886
0130-001,2018,7,16,2,167,157,324,533
0130-001,2018,7,16,3,157,168,325,324
0130-001,2018,7,16,4,155,184,339,325
0130-001,2018,7,16,5,266,183,449,339
0130-001,2018,7,16,6,737,471,1208,449
0130-001,2018,7,16,7,1780,995,2775,1208
0130-001,2018,7,16,8,1785,1575,3360,2775
0130-001,2018,7,16,9,1901,1872,3773,3360
0130-001,2018,7,16,10,1693,1634,3327,3773
0130-001,2018,7,16,11,1720,1605,3325,3327
0130-001,2018,7,16,12,1555,1708,3263,3325
0130-001,2018,7,16,13,1459,1496,2955,3263
0130-001,2018,7,16,14,1649,1720,3369,2955
0130-001,2018,7,16,15,1679,1742,3421,3369
0130-001,2018,7,16,16,1699,1789,3488,3421
0130-001,2018,7,16,17,1711,1936,3647,3488
0130-001,2018,7,16,18,1787,2349,4136,3647
0130-001,2018,7,16,19,1694,2406,4100,4136
0130-001,2018,7,16,20,1359,1887,3246,4100
0130-001,2018,7,16,21,1144,1778,2922,3246
0130-001,2018,7,16,22,1069,1232,2301,2922
0130-001,2018,7,16,23,723,768,1491,2301
0130-001,2018,7,16,24,465,473,938,1491
0130-001,2018,7,17,1,326,345,671,938
0130-001,2018,7,17,2,211,220,431,671
0130-001,2018,7,17,3,159,155,314,431
0130-001,2018,7,17,4,163,201,364,314
0130-001,2018,7,17,5,257,226,483,364
0130-001,2018,7,17,6,739,466,1205,483
0130-001,2018,7,17,7,1700,971,2671,1205
0130-001,2018,7,17,8,1817,1618,3435,2671
0130-001,2018,7,17,9,1891,1906,3797,3435
0130-001,2018,7,17,10,1816,1683,3499,3797
0130-001,2018,7,17,11,1666,1693,3359,3499
0130-001,2018,7,17,12,1540,1554,3094,3359
0130-001,2018,7,17,13,1303,1419,2722,3094
0130-001,2018,7,17,14,1605,1656,3261,2722
0130-001,2018,7,17,15,1681,1686,3367,3261
0130-001,2018,7,17,16,1790,1821,3611,3367
0130-001,2018,7,17,17,1606,1983,3589,3611
0130-001,2018,7,17,18,1836,2395,4231,3589
0130-001,2018,7,17,19,1782,2428,4210,4231
0130-001,2018,7,17,20,1318,1859,3177,4210
0130-001,2018,7,17,21,1164,1818,2982,3177
0130-001,2018,7,17,22,1048,1318,2366,2982
0130-001,2018,7,17,23,808,777,1585,2366
0130-001,2018,7,17,24,499,568,1067,1585
0130-001,2018,7,18,1,359,351,710,1067
0130-001,2018,7,18,2,213,226,439,710
0130-001,2018,7,18,3,172,215,387,439
0130-001,2018,7,18,4,146,204,350,387
0130-001,2018,7,18,5,249,245,494,350
0130-001,2018,7,18,6,776,487,1263,494
0130-001,2018,7,18,7,1676,881,2557,1263
0130-001,2018,7,18,8,1741,1593,3334,2557
0130-001,2018,7,18,9,1781,1921,3702,3334
0130-001,2018,7,18,10,1748,1695,3443,3702
0130-001,2018,7,18,11,1668,1652,3320,3443
0130-001,2018,7,18,12,1585,1584,3169,3320
0130-001,2018,7,18,13,1381,1420,2801,3169
0130-001,2018,7,18,14,1567,1685,3252,2801
0130-001,2018,7,18,15,1765,1726,3491,3252
0130-001,2018,7,18,16,1690,1789,3479,3491
0130-001,2018,7,18,17,1692,2008,3700,3479
0130-001,2018,7,18,18,1763,2393,4156,3700
0130-001,2018,7,18,19,1664,2371,4035,4156
0130-001,2018,7,18,20,1283,2007,3290,4035
0130-001,2018,7,18,21,1128,1544,2672,3290
0130-001,2018,7,18,22,1073,1181,2254,2672
0130-001,2018,7,18,23,871,772,1643,2254
0130-001,2018,7,18,24,529,541,1070,1643
0130-001,2018,7,19,1,371,368,739,1070
0130-001,2018,7,19,2,227,212,439,739
0130-001,2018,7,19,3,168,165,333,439
0130-001,2018,7,19,4,164,192,356,333
0130-001,2018,7,19,5,270,242,512,356
0130-001,2018,7,19,6,805,448,1253,512
0130-001,2018,7,19,7,1674,895,2569,1253
0130-001,2018,7,19,8,1811,1557,3368,2569
0130-001,2018,7,19,9,1875,1902,3777,3368
0130-001,2018,7,19,10,1873,1673,3546,3777
0130-001,2018,7,19,11,1730,1681,3411,3546
0130-001,2018,7,19,12,1589,1722,3311,3411
0130-001,2018,7,19,13,1458,1672,3130,3311
0130-001,2018,7,19,14,1667,1760,3427,3130
0130-001,2018,7,19,15,1677,1741,3418,3427
0130-001,2018,7,19,16,1826,1792,3618,3418
0130-001,2018,7,19,17,1596,2042,3638,3618
0130-001,2018,7,19,18,1774,2246,4020,3638
0130-001,2018,7,19,19,1727,2409,4136,4020
0130-001,2018,7,19,20,1343,1925,3268,4136
0130-001,2018,7,19,21,1149,1769,2918,3268
0130-001,2018,7,19,22,1103,1302,2405,2918
0130-001,2018,7,19,23,838,828,1666,2405
0130-001,2018,7,19,24,557,493,1050,1666
0130-001,2018,7,20,1,357,365,722,1050
0130-001,2018,7,20,2,237,215,452,722
0130-001,2018,7,20,3,191,137,328,452
0130-001,2018,7,20,4,159,177,336,328
0130-001,2018,7,20,5,253,232,485,336
0130-001,2018,7,20,6,773,462,1235,485
0130-001,2018,7,20,7,1714,791,2505,1235
0130-001,2018,7,20,8,1787,1605,3392,2505
0130-001,2018,7,20,9,1884,1950,3834,3392
0130-001,2018,7,20,10,1828,1618,3446,3834
0130-001,2018,7,20,11,1745,1756,3501,3446
0130-001,2018,7,20,12,1641,1782,3423,3501
0130-001,2018,7,20,13,1579,1671,3250,3423
0130-001,2018,7,20,14,1660,1786,3446,3250
0130-001,2018,7,20,15,1786,1669,3455,3446
0130-001,2018,7,20,16,1882,1637,3519,3455
0130-001,2018,7,20,17,1745,1760,3505,3519
0130-001,2018,7,20,18,1904,2298,4202,3505
0130-001,2018,7,20,19,1803,2419,4222,4202
0130-001,2018,7,20,20,1438,2208,3646,4222
0130-001,2018,7,20,21,1306,1887,3193,3646
0130-001,2018,7,20,22,1283,1318,2601,3193
0130-001,2018,7,20,23,906,869,1775,2601
0130-001,2018,7,20,24,681,639,1320,1775
0130-001,2018,7,21,1,489,475,964,1320
0130-001,2018,7,21,2,302,309,611,964
0130-001,2018,7,21,3,245,244,489,611
0130-001,2018,7,21,4,207,255,462,489
0130-001,2018,7,21,5,319,261,580,462
0130-001,2018,7,21,6,702,458,1160,580
0130-001,2018,7,21,7,1199,762,1961,1160
0130-001,2018,7,21,8,1429,1149,2578,1961
0130-001,2018,7,21,9,1524,1518,3042,2578
0130-001,2018,7,21,10,1650,1677,3327,3042
0130-001,2018,7,21,11,1690,1819,3509,3327
0130-001,2018,7,21,12,1669,1797,3466,3509
0130-001,2018,7,21,13,1643,1770,3413,3466
0130-001,2018,7,21,14,1694,1842,3536,3413
0130-001,2018,7,21,15,1655,1770,3425,3536
0130-001,2018,7,21,16,1682,1756,3438,3425
0130-001,2018,7,21,17,1714,1981,3695,3438
0130-001,2018,7,21,18,1819,2106,3925,3695
0130-001,2018,7,21,19,1663,1907,3570,3925
0130-001,2018,7,21,20,1330,1414,2744,3570
0130-001,2018,7,21,21,1206,1231,2437,2744
0130-001,2018,7,21,22,1199,981,2180,2437
0130-001,2018,7,21,23,811,697,1508,2180
0130-001,2018,7,21,24,493,520,1013,1508
0130-001,2018,7,22,1,417,364,781,1013
0130-001,2018,7,22,2,337,287,624,781
0130-001,2018,7,22,3,232,240,472,624
0130-001,2018,7,22,4,186,162,348,472
0130-001,2018,7,22,5,223,144,367,348
0130-001,2018,7,22,6,451,275,726,367
0130-001,2018,7,22,7,652,456,1108,726
0130-001,2018,7,22,8,703,663,1366,1108
0130-001,2018,7,22,9,815,928,1743,1366
0130-001,2018,7,22,10,1016,1163,2179,1743
0130-001,2018,7,22,11,1218,1272,2490,2179
0130-001,2018,7,22,12,1151,1307,2458,2490
0130-001,2018,7,22,13,1280,1405,2685,2458
0130-001,2018,7,22,14,1401,1489,2890,2685
0130-001,2018,7,22,15,1414,1434,2848,2890
0130-001,2018,7,22,16,1458,1526,2984,2848
0130-001,2018,7,22,17,1525,1405,2930,2984
0130-001,2018,7,22,18,1503,1509,3012,2930
0130-001,2018,7,22,19,1460,1355,2815,3012
0130-001,2018,7,22,20,1157,1112,2269,2815
0130-001,2018,7,22,21,1085,1022,2107,2269
0130-001,2018,7,22,22,937,817,1754,2107
0130-001,2018,7,22,23,651,590,1241,1754
0130-001,2018,7,22,24,443,402,845,1241
0130-001,2018,7,23,1,283,281,564,845
0130-001,2018,7,23,2,172,171,343,564
0130-001,2018,7,23,3,143,138,281,343
0130-001,2018,7,23,4,129,160,289,281
0130-001,2018,7,23,5,263,214,477,289
0130-001,2018,7,23,6,757,448,1205,477
0130-001,2018,7,23,7,1772,911,2683,1205
0130-001,2018,7,23,8,1813,1518,3331,2683
0130-001,2018,7,23,9,1796,1882,3678,3331
0130-001,2018,7,23,10,1743,1580,3323,3678
0130-001,2018,7,23,11,1718,1771,3489,3323
0130-001,2018,7,23,12,1740,1698,3438,3489
0130-001,2018,7,23,13,1607,1515,3122,3438
0130-001,2018,7,23,14,1616,1749,3365,3122
0130-001,2018,7,23,15,1758,1660,3418,3365
0130-001,2018,7,23,16,1761,1857,3618,3418
0130-001,2018,7,23,17,1593,2041,3634,3618
0130-001,2018,7,23,18,1819,2297,4116,3634
0130-001,2018,7,23,19,1734,2345,4079,4116
0130-001,2018,7,23,20,1360,1983,3343,4079
0130-001,2018,7,23,21,1146,1779,2925,3343
0130-001,2018,7,23,22,1033,1203,2236,2925
0130-001,2018,7,23,23,755,725,1480,2236
0130-001,2018,7,23,24,467,464,931,1480
0130-001,2018,7,24,1,300,304,604,931
0130-001,2018,7,24,2,196,195,391,604
0130-001,2018,7,24,3,169,182,351,391
0130-001,2018,7,24,4,148,183,331,351
0130-001,2018,7,24,5,275,254,529,331
0130-001,2018,7,24,6,726,367,1093,529
0130-001,2018,7,24,7,1700,828,2528,1093
0130-001,2018,7,24,8,1739,1527,3266,2528
0130-001,2018,7,24,9,1796,1883,3679,3266
0130-001,2018,7,24,10,1719,1747,3466,3679
0130-001,2018,7,24,11,1587,1674,3261,3466
0130-001,2018,7,24,12,1570,1677,3247,3261
0130-001,2018,7,24,13,1459,1580,3039,3247
0130-001,2018,7,24,14,1618,1662,3280,3039
0130-001,2018,7,24,15,1690,1663,3353,3280
0130-001,2018,7,24,16,1710,1762,3472,3353
0130-001,2018,7,24,17,1609,1854,3463,3472
0130-001,2018,7,24,18,1741,2286,4027,3463
0130-001,2018,7,24,19,1647,2395,4042,4027
0130-001,2018,7,24,20,1375,1952,3327,4042
0130-001,2018,7,24,21,1205,1774,2979,3327
0130-001,2018,7,24,22,1046,1316,2362,2979
0130-001,2018,7,24,23,802,835,1637,2362
0130-001,2018,7,24,24,520,477,997,1637
0130-001,2018,7,25,1,348,312,660,997
0130-001,2018,7,25,2,217,218,435,660
0130-001,2018,7,25,3,167,207,374,435
0130-001,2018,7,25,4,173,195,368,374
0130-001,2018,7,25,5,287,240,527,368
0130-001,2018,7,25,6,723,418,1141,527
0130-001,2018,7,25,7,1648,902,2550,1141
0130-001,2018,7,25,8,1793,1478,3271,2550
0130-001,2018,7,25,9,1817,1864,3681,3271
0130-001,2018,7,25,10,1742,1687,3429,3681
0130-001,2018,7,25,11,1703,1713,3416,3429
0130-001,2018,7,25,12,1597,1651,3248,3416
0130-001,2018,7,25,13,1438,1535,2973,3248
0130-001,2018,7,25,14,1593,1649,3242,2973
0130-001,2018,7,25,15,1673,1748,3421,3242
0130-001,2018,7,25,16,1706,1845,3551,3421
0130-001,2018,7,25,17,1563,1885,3448,3551
0130-001,2018,7,25,18,1767,2346,4113,3448
0130-001,2018,7,25,19,1761,2459,4220,4113
0130-001,2018,7,25,20,1279,1906,3185,4220
0130-001,2018,7,25,21,1219,1644,2863,3185
0130-001,2018,7,25,22,1078,1189,2267,2863
0130-001,2018,7,25,23,832,807,1639,2267
0130-001,2018,7,25,24,558,492,1050,1639
0130-001,2018,7,26,1,359,371,730,1050
0130-001,2018,7,26,2,249,234,483,730
0130-001,2018,7,26,3,178,222,400,483
0130-001,2018,7,26,4,182,183,365,400
0130-001,2018,7,26,5,283,232,515,365
0130-001,2018,7,26,6,711,476,1187,515
0130-001,2018,7,26,7,1656,904,2560,1187
0130-001,2018,7,26,8,1844,1505,3349,2560
0130-001,2018,7,26,9,1825,1923,3748,3349
0130-001,2018,7,26,10,1716,1642,3358,3748
0130-001,2018,7,26,11,1695,1554,3249,3358
0130-001,2018,7,26,12,1570,1760,3330,3249
0130-001,2018,7,26,13,1506,1504,3010,3330
0130-001,2018,7,26,14,1678,1587,3265,3010
0130-001,2018,7,26,15,1704,1648,3352,3265
0130-001,2018,7,26,16,1661,1845,3506,3352
0130-001,2018,7,26,17,1638,2032,3670,3506
0130-001,2018,7,26,18,1860,2325,4185,3670
0130-001,2018,7,26,19,1725,2415,4140,4185
0130-001,2018,7,26,20,1351,1880,3231,4140
0130-001,2018,7,26,21,1159,1803,2962,3231
0130-001,2018,7,26,22,1105,1235,2340,2962
0130-001,2018,7,26,23,808,815,1623,2340
0130-001,2018,7,26,24,548,537,1085,1623
0130-001,2018,7,27,1,393,384,777,1085
0130-001,2018,7,27,2,232,239,471,777
0130-001,2018,7,27,3,168,186,354,471
0130-001,2018,7,27,4,189,194,383,354
0130-001,2018,7,27,5,333,272,605,383
0130-001,2018,7,27,6,736,438,1174,605
0130-001,2018,7,27,7,1695,896,2591,1174
0130-001,2018,7,27,8,1850,1510,3360,2591
0130-001,2018,7,27,9,1790,1931,3721,3360
0130-001,2018,7,27,10,1711,1709,3420,3721
0130-001,2018,7,27,11,1646,1621,3267,3420
0130-001,2018,7,27,12,1651,1716,3367,3267
0130-001,2018,7,27,13,1450,1660,3110,3367
0130-001,2018,7,27,14,1635,1800,3435,3110
0130-001,2018,7,27,15,1706,1845,3551,3435
0130-001,2018,7,27,16,1699,1867,3566,3551
0130-001,2018,7,27,17,1758,2049,3807,3566
0130-001,2018,7,27,18,1931,2413,4344,3807
0130-001,2018,7,27,19,1837,2514,4351,4344
0130-001,2018,7,27,20,1496,2225,3721,4351
0130-001,2018,7,27,21,1291,1846,3137,3721
0130-001,2018,7,27,22,1259,1270,2529,3137
0130-001,2018,7,27,23,954,880,1834,2529
0130-001,2018,7,27,24,579,549,1128,1834
0130-001,2018,7,28,1,461,414,875,1128
0130-001,2018,7,28,2,320,348,668,875
0130-001,2018,7,28,3,285,269,554,668
0130-001,2018,7,28,4,215,267,482,554
0130-001,2018,7,28,5,334,282,616,482
0130-001,2018,7,28,6,654,438,1092,616
0130-001,2018,7,28,7,1152,710,1862,1092
0130-001,2018,7,28,8,1268,1118,2386,1862
0130-001,2018,7,28,9,1535,1538,3073,2386
0130-001,2018,7,28,10,1573,1697,3270,3073
0130-001,2018,7,28,11,1628,1751,3379,3270
0130-001,2018,7,28,12,1606,1809,3415,3379
0130-001,2018,7,28,13,1603,1803,3406,3415
0130-001,2018,7,28,14,1610,1881,3491,3406
0130-001,2018,7,28,15,1594,1737,3331,3491
0130-001,2018,7,28,16,1670,1787,3457,3331
0130-001,2018,7,28,17,1704,1848,3552,3457
0130-001,2018,7,28,18,1819,1898,3717,3552
0130-001,2018,7,28,19,1566,1690,3256,3717
0130-001,2018,7,28,20,1261,1269,2530,3256
0130-001,2018,7,28,21,1151,1152,2303,2530
0130-001,2018,7,28,22,1119,930,2049,2303
0130-001,2018,7,28,23,700,664,1364,2049
0130-001,2018,7,28,24,492,445,937,1364
0130-001,2018,7,29,1,365,347,712,937
0130-001,2018,7,29,2,269,250,519,712
0130-001,2018,7,29,3,230,212,442,519
0130-001,2018,7,29,4,178,152,330,442
0130-001,2018,7,29,5,204,170,374,330
0130-001,2018,7,29,6,426,279,705,374
0130-001,2018,7,29,7,627,469,1096,705
0130-001,2018,7,29,8,707,693,1400,1096
0130-001,2018,7,29,9,845,973,1818,1400
0130-001,2018,7,29,10,1008,1134,2142,1818
0130-001,2018,7,29,11,1200,1351,2551,2142
0130-001,2018,7,29,12,1099,1273,2372,2551
0130-001,2018,7,29,13,1213,1404,2617,2372
0130-001,2018,7,29,14,1477,1461,2938,2617
0130-001,2018,7,29,15,1634,1561,3195,2938
0130-001,2018,7,29,16,1531,1518,3049,3195
0130-001,2018,7,29,17,1701,1419,3120,3049
0130-001,2018,7,29,18,1469,1398,2867,3120
0130-001,2018,7,29,19,1552,1338,2890,2867
0130-001,2018,7,29,20,1205,1105,2310,2890
0130-001,2018,7,29,21,1147,1063,2210,2310
0130-001,2018,7,29,22,985,896,1881,2210
0130-001,2018,7,29,23,683,669,1352,1881
0130-001,2018,7,29,24,450,447,897,1352
0130-001,2018,7,30,1,329,287,616,897
0130-001,2018,7,30,2,194,193,387,616
0130-001,2018,7,30,3,131,153,284,387
0130-001,2018,7,30,4,155,189,344,284
0130-001,2018,7,30,5,260,206,466,344
0130-001,2018,7,30,6,729,424,1153,466
0130-001,2018,7,30,7,1420,866,2286,1153
0130-001,2018,7,30,8,1767,1428,3195,2286
0130-001,2018,7,30,9,1799,1776,3575,3195
0130-001,2018,7,30,10,1669,1615,3284,3575
0130-001,2018,7,30,11,1704,1755,3459,3284
0130-001,2018,7,30,12,1713,1778,3491,3459
0130-001,2018,7,30,13,1452,1613,3065,3491
0130-001,2018,7,30,14,1643,1824,3467,3065
0130-001,2018,7,30,15,1747,1789,3536,3467
0130-001,2018,7,30,16,1764,1878,3642,3536
0130-001,2018,7,30,17,1686,1867,3553,3642
0130-001,2018,7,30,18,1785,2228,4013,3553
0130-001,2018,7,30,19,1756,2292,4048,4013
0130-001,2018,7,30,20,1265,1696,2961,4048
0130-001,2018,7,30,21,1138,1408,2546,2961
0130-001,2018,7,30,22,929,1050,1979,2546
0130-001,2018,7,30,23,697,692,1389,1979
0130-001,2018,7,30,24,491,442,933,1389
0130-001,2018,7,31,1,339,353,692,933
0130-001,2018,7,31,2,223,218,441,692
0130-001,2018,7,31,3,171,174,345,441
0130-001,2018,7,31,4,162,196,358,345
0130-001,2018,7,31,5,237,200,437,358
0130-001,2018,7,31,6,617,409,1026,437
0130-001,2018,7,31,7,1311,805,2116,1026
0130-001,2018,7,31,8,1740,1359,3099,2116
0130-001,2018,7,31,9,1804,1699,3503,3099
0130-001,2018,7,31,10,1646,1652,3298,3503
0130-001,2018,7,31,11,1695,1823,3518,3298
0130-001,2018,7,31,12,1584,2071,3655,3518
0130-001,2018,7,31,13,1528,1619,3147,3655
0130-001,2018,7,31,14,1604,1748,3352,3147
0130-001,2018,7,31,15,1689,1763,3452,3352
0130-001,2018,7,31,16,1749,1819,3568,3452
0130-001,2018,7,31,17,1687,1983,3670,3568
0130-001,2018,7,31,18,1798,2215,4013,3670
0130-001,2018,7,31,19,1779,2315,4094,4013
0130-001,2018,7,31,20,1366,1735,3101,4094
0130-001,2018,7,31,21,1208,1483,2691,3101
0130-001,2018,7,31,22,1099,1160,2259,2691
0130-001,2018,7,31,23,789,754,1543,2259
0130-001,2018,7,31,24,516,499,1015,1543
0130-001,2018,8,1,1,370,351,721,1015
0130-001,2018,8,1,2,196,212,408,721
0130-001,2018,8,1,3,193,187,380,408
0130-001,2018,8,1,4,210,194,404,380
0130-001,2018,8,1,5,287,220,507,404
0130-001,2018,8,1,6,629,460,1089,507
0130-001,2018,8,1,7,1295,774,2069,1089
0130-001,2018,8,1,8,1579,1299,2878,2069
0130-001,2018,8,1,9,1786,1658,3444,2878
0130-001,2018,8,1,10,1523,1634,3157,3444
0130-001,2018,8,1,11,1694,1800,3494,3157
0130-001,2018,8,1,12,1692,1713,3405,3494
0130-001,2018,8,1,13,1487,1658,3145,3405
0130-001,2018,8,1,14,1580,1821,3401,3145
0130-001,2018,8,1,15,1664,1678,3342,3401
0130-001,2018,8,1,16,1652,1771,3423,3342
0130-001,2018,8,1,17,1670,1897,3567,3423
0130-001,2018,8,1,18,1822,2160,3982,3567
0130-001,2018,8,1,19,1718,2275,3993,3982
0130-001,2018,8,1,20,1301,1591,2892,3993
0130-001,2018,8,1,21,1131,1252,2383,2892
0130-001,2018,8,1,22,1022,998,2020,2383
0130-001,2018,8,1,23,771,766,1537,2020
0130-001,2018,8,1,24,499,485,984,1537
0130-001,2018,8,2,1,381,329,710,984
0130-001,2018,8,2,2,248,203,451,710
0130-001,2018,8,2,3,164,161,325,451
0130-001,2018,8,2,4,205,199,404,325
0130-001,2018,8,2,5,282,218,500,404
0130-001,2018,8,2,6,609,367,976,500
0130-001,2018,8,2,7,1267,734,2001,976
0130-001,2018,8,2,8,1546,1249,2795,2001
0130-001,2018,8,2,9,1771,1658,3429,2795
0130-001,2018,8,2,10,1593,1539,3132,3429
0130-001,2018,8,2,11,1582,1660,3242,3132
0130-001,2018,8,2,12,1622,1726,3348,3242
0130-001,2018,8,2,13,1411,1603,3014,3348
0130-001,2018,8,2,14,1564,1686,3250,3014
0130-001,2018,8,2,15,1663,1636,3299,3250
0130-001,2018,8,2,16,1677,1715,3392,3299
0130-001,2018,8,2,17,1637,1864,3501,3392
0130-001,2018,8,2,18,1831,2082,3913,3501
0130-001,2018,8,2,19,1664,2258,3922,3913
0130-001,2018,8,2,20,1311,1512,2823,3922
0130-001,2018,8,2,21,1125,1409,2534,2823
0130-001,2018,8,2,22,969,1097,2066,2534
0130-001,2018,8,2,23,714,697,1411,2066
0130-001,2018,8,2,24,492,450,942,1411
0130-001,2018,8,3,1,393,317,710,942
0130-001,2018,8,3,2,226,235,461,710
0130-001,2018,8,3,3,224,194,418,461
0130-001,2018,8,3,4,212,201,413,418
0130-001,2018,8,3,5,267,208,475,413
0130-001,2018,8,3,6,572,432,1004,475
0130-001,2018,8,3,7,1217,716,1933,1004
0130-001,2018,8,3,8,1610,1200,2810,1933
0130-001,2018,8,3,9,1816,1681,3497,2810
0130-001,2018,8,3,10,1495,1437,2932,3497
0130-001,2018,8,3,11,1578,1622,3200,2932
0130-001,2018,8,3,12,1574,1712,3286,3200
0130-001,2018,8,3,13,1486,1631,3117,3286
0130-001,2018,8,3,14,1536,1834,3370,3117
0130-001,2018,8,3,15,1688,1789,3477,3370
0130-001,2018,8,3,16,1687,1854,3541,3477
0130-001,2018,8,3,17,1635,1801,3436,3541
0130-001,2018,8,3,18,1975,2196,4171,3436
0130-001,2018,8,3,19,1770,2230,4000,4171
0130-001,2018,8,3,20,1444,1601,3045,4000
0130-001,2018,8,3,21,1216,1462,2678,3045
0130-001,2018,8,3,22,1093,1086,2179,2678
0130-001,2018,8,3,23,806,793,1599,2179
0130-001,2018,8,3,24,560,576,1136,1599
0130-001,2018,8,4,1,436,381,817,1136
0130-001,2018,8,4,2,324,256,580,817
0130-001,2018,8,4,3,240,230,470,580
0130-001,2018,8,4,4,261,184,445,470
0130-001,2018,8,4,5,316,219,535,445
0130-001,2018,8,4,6,540,373,913,535
0130-001,2018,8,4,7,917,597,1514,913
0130-001,2018,8,4,8,1075,901,1976,1514
0130-001,2018,8,4,9,1234,1238,2472,1976
0130-001,2018,8,4,10,1355,1495,2850,2472
0130-001,2018,8,4,11,1379,1622,3001,2850
0130-001,2018,8,4,12,1498,1683,3181,3001
0130-001,2018,8,4,13,1455,1702,3157,3181
0130-001,2018,8,4,14,1466,1740,3206,3157
0130-001,2018,8,4,15,1521,1710,3231,3206
0130-001,2018,8,4,16,1615,1590,3205,3231
0130-001,2018,8,4,17,1597,1616,3213,3205
0130-001,2018,8,4,18,1640,1758,3398,3213
0130-001,2018,8,4,19,1463,1526,2989,3398
0130-001,2018,8,4,20,1353,1225,2578,2989
0130-001,2018,8,4,21,1142,1132,2274,2578
0130-001,2018,8,4,22,1057,965,2022,2274
0130-001,2018,8,4,23,717,657,1374,2022
0130-001,2018,8,4,24,494,483,977,1374
0130-001,2018,8,5,1,384,378,762,977
0130-001,2018,8,5,2,300,283,583,762
0130-001,2018,8,5,3,220,192,412,583
0130-001,2018,8,5,4,191,148,339,412
0130-001,2018,8,5,5,213,200,413,339
0130-001,2018,8,5,6,349,261,610,413
0130-001,2018,8,5,7,613,393,1006,610
0130-001,2018,8,5,8,635,548,1183,1006
0130-001,2018,8,5,9,765,792,1557,1183
0130-001,2018,8,5,10,831,1114,1945,1557
0130-001,2018,8,5,11,1097,1265,2362,1945
0130-001,2018,8,5,12,1076,1233,2309,2362
0130-001,2018,8,5,13,1238,1454,2692,2309
0130-001,2018,8,5,14,1299,1356,2655,2692
0130-001,2018,8,5,15,1332,1440,2772,2655
0130-001,2018,8,5,16,1506,1463,2969,2772
0130-001,2018,8,5,17,1500,1372,2872,2969
0130-001,2018,8,5,18,1506,1421,2927,2872
0130-001,2018,8,5,19,1478,1325,2803,2927
0130-001,2018,8,5,20,1266,1170,2436,2803
0130-001,2018,8,5,21,1144,1005,2149,2436
0130-001,2018,8,5,22,948,892,1840,2149
0130-001,2018,8,5,23,667,591,1258,1840
0130-001,2018,8,5,24,460,362,822,1258
0130-001,2018,8,6,1,310,239,549,822
0130-001,2018,8,6,2,190,187,377,549
0130-001,2018,8,6,3,150,141,291,377
0130-001,2018,8,6,4,172,175,347,291
0130-001,2018,8,6,5,279,188,467,347
0130-001,2018,8,6,6,678,403,1081,467
0130-001,2018,8,6,7,1640,827,2467,1081
0130-001,2018,8,6,8,1624,1455,3079,2467
0130-001,2018,8,6,9,1601,1717,3318,3079
0130-001,2018,8,6,10,1833,1531,3364,3318
0130-001,2018,8,6,11,1695,1604,3299,3364
0130-001,2018,8,6,12,1570,1572,3142,3299
0130-001,2018,8,6,13,1383,1547,2930,3142
0130-001,2018,8,6,14,1609,1728,3337,2930
0130-001,2018,8,6,15,1652,1491,3143,3337
0130-001,2018,8,6,16,1676,1864,3540,3143
0130-001,2018,8,6,17,1566,1769,3335,3540
0130-001,2018,8,6,18,1740,2155,3895,3335
0130-001,2018,8,6,19,1653,2313,3966,3895
0130-001,2018,8,6,20,1214,1970,3184,3966
0130-001,2018,8,6,21,1071,1650,2721,3184
0130-001,2018,8,6,22,924,1153,2077,2721
0130-001,2018,8,6,23,694,680,1374,2077
0130-001,2018,8,6,24,479,438,917,1374
0130-001,2018,8,7,1,368,310,678,917
0130-001,2018,8,7,2,215,212,427,678
0130-001,2018,8,7,3,140,191,331,427
0130-001,2018,8,7,4,175,199,374,331
0130-001,2018,8,7,5,279,217,496,374
0130-001,2018,8,7,6,722,430,1152,496
0130-001,2018,8,7,7,1651,831,2482,1152
0130-001,2018,8,7,8,1846,1416,3262,2482
0130-001,2018,8,7,9,1789,1758,3547,3262
0130-001,2018,8,7,10,1649,1611,3260,3547
0130-001,2018,8,7,11,1588,1648,3236,3260
0130-001,2018,8,7,12,1614,1596,3210,3236
0130-001,2018,8,7,13,1244,1269,2513,3210
0130-001,2018,8,7,14,1600,1695,3295,2513
0130-001,2018,8,7,15,1569,1726,3295,3295
0130-001,2018,8,7,16,1654,1746,3400,3295
0130-001,2018,8,7,17,1589,1898,3487,3400
0130-001,2018,8,7,18,1769,2204,3973,3487
0130-001,2018,8,7,19,1637,2295,3932,3973
0130-001,2018,8,7,20,1416,1997,3413,3932
0130-001,2018,8,7,21,1107,1717,2824,3413
0130-001,2018,8,7,22,998,1240,2238,2824
0130-001,2018,8,7,23,774,784,1558,2238
0130-001,2018,8,7,24,500,474,974,1558
0130-001,2018,8,8,1,386,360,746,974
0130-001,2018,8,8,2,237,205,442,746
0130-001,2018,8,8,3,178,207,385,442
0130-001,2018,8,8,4,182,199,381,385
0130-001,2018,8,8,5,276,233,509,381
0130-001,2018,8,8,6,727,386,1113,509
0130-001,2018,8,8,7,1653,813,2466,1113
0130-001,2018,8,8,8,1814,1460,3274,2466
0130-001,2018,8,8,9,1767,1762,3529,3274
0130-001,2018,8,8,10,1642,1593,3235,3529
0130-001,2018,8,8,11,1609,1589,3198,3235
0130-001,2018,8,8,12,1565,1573,3138,3198
0130-001,2018,8,8,13,1445,1479,2924,3138
0130-001,2018,8,8,14,1618,1703,3321,2924
0130-001,2018,8,8,15,1542,1654,3196,3321
0130-001,2018,8,8,16,1700,1750,3450,3196
0130-001,2018,8,8,17,1570,1854,3424,3450
0130-001,2018,8,8,18,1750,2312,4062,3424
0130-001,2018,8,8,19,1649,2385,4034,4062
0130-001,2018,8,8,20,1352,1947,3299,4034
0130-001,2018,8,8,21,1183,1614,2797,3299
0130-001,2018,8,8,22,1093,1174,2267,2797
0130-001,2018,8,8,23,838,752,1590,2267
0130-001,2018,8,8,24,530,481,1011,1590
0130-001,2018,8,9,1,353,328,681,1011
0130-001,2018,8,9,2,265,239,504,681
0130-001,2018,8,9,3,155,200,355,504
0130-001,2018,8,9,4,176,194,370,355
0130-001,2018,8,9,5,284,240,524,370
0130-001,2018,8,9,6,692,427,1119,524
0130-001,2018,8,9,7,1748,850,2598,1119
0130-001,2018,8,9,8,1812,1389,3201,2598
0130-001,2018,8,9,9,1831,1825,3656,3201
0130-001,2018,8,9,10,1634,1645,3279,3656
0130-001,2018,8,9,11,1672,1652,3324,3279
0130-001,2018,8,9,12,1605,1644,3249,3324
0130-001,2018,8,9,13,1434,1507,2941,3249
0130-001,2018,8,9,14,1628,1625,3253,2941
0130-001,2018,8,9,15,1586,1676,3262,3253
0130-001,2018,8,9,16,1692,1768,3460,3262
0130-001,2018,8,9,17,1633,1872,3505,3460
0130-001,2018,8,9,18,1765,2261,4026,3505
0130-001,2018,8,9,19,1702,2261,3963,4026
0130-001,2018,8,9,20,1288,1900,3188,3963
0130-001,2018,8,9,21,1104,1646,2750,3188
0130-001,2018,8,9,22,1022,1127,2149,2750
0130-001,2018,8,9,23,826,761,1587,2149
0130-001,2018,8,9,24,560,490,1050,1587
0130-001,2018,8,10,1,327,347,674,1050
0130-001,2018,8,10,2,207,233,440,674
0130-001,2018,8,10,3,197,211,408,440
0130-001,2018,8,10,4,189,193,382,408
0130-001,2018,8,10,5,286,240,526,382
0130-001,2018,8,10,6,676,429,1105,526
0130-001,2018,8,10,7,1662,881,2543,1105
0130-001,2018,8,10,8,1842,1384,3226,2543
0130-001,2018,8,10,9,1812,1789,3601,3226
0130-001,2018,8,10,10,1705,1628,3333,3601
0130-001,2018,8,10,11,1626,1637,3263,3333
0130-001,2018,8,10,12,1642,1651,3293,3263
0130-001,2018,8,10,13,1471,1591,3062,3293
0130-001,2018,8,10,14,1561,1667,3228,3062
0130-001,2018,8,10,15,1859,1942,3801,3228
0130-001,2018,8,10,16,1809,1818,3627,3801
0130-001,2018,8,10,17,1658,1951,3609,3627
0130-001,2018,8,10,18,1825,2340,4165,3609
0130-001,2018,8,10,19,1818,2412,4230,4165
0130-001,2018,8,10,20,1473,2121,3594,4230
0130-001,2018,8,10,21,1272,1726,2998,3594
0130-001,2018,8,10,22,1250,1234,2484,2998
0130-001,2018,8,10,23,916,849,1765,2484
0130-001,2018,8,10,24,602,596,1198,1765
0130-001,2018,8,11,1,445,453,898,1198
0130-001,2018,8,11,2,384,335,719,898
0130-001,2018,8,11,3,280,293,573,719
0130-001,2018,8,11,4,226,277,503,573
0130-001,2018,8,11,5,294,296,590,503
0130-001,2018,8,11,6,637,410,1047,590
0130-001,2018,8,11,7,1191,790,1981,1047
0130-001,2018,8,11,8,1357,1072,2429,1981
0130-001,2018,8,11,9,1499,1411,2910,2429
0130-001,2018,8,11,10,1515,1673,3188,2910
0130-001,2018,8,11,11,1622,1717,3339,3188
0130-001,2018,8,11,12,1632,1809,3441,3339
0130-001,2018,8,11,13,1606,1773,3379,3441
0130-001,2018,8,11,14,1601,1829,3430,3379
0130-001,2018,8,11,15,1666,1805,3471,3430
0130-001,2018,8,11,16,1695,1785,3480,3471
0130-001,2018,8,11,17,1715,1914,3629,3480
0130-001,2018,8,11,18,1724,2058,3782,3629
0130-001,2018,8,11,19,1586,1858,3444,3782
0130-001,2018,8,11,20,1354,1406,2760,3444
0130-001,2018,8,11,21,1147,1148,2295,2760
0130-001,2018,8,11,22,1209,949,2158,2295
0130-001,2018,8,11,23,792,762,1554,2158
0130-001,2018,8,11,24,565,525,1090,1554
0130-001,2018,8,12,1,429,352,781,1090
0130-001,2018,8,12,2,327,282,609,781
0130-001,2018,8,12,3,243,237,480,609
0130-001,2018,8,12,4,191,174,365,480
0130-001,2018,8,12,5,237,182,419,365
0130-001,2018,8,12,6,407,275,682,419
0130-001,2018,8,12,7,658,447,1105,682
0130-001,2018,8,12,8,627,621,1248,1105
0130-001,2018,8,12,9,827,897,1724,1248
0130-001,2018,8,12,10,976,1143,2119,1724
0130-001,2018,8,12,11,1194,1200,2394,2119
0130-001,2018,8,12,12,1128,1192,2320,2394
0130-001,2018,8,12,13,1156,1313,2469,2320
0130-001,2018,8,12,14,1359,1392,2751,2469
0130-001,2018,8,12,15,1388,1352,2740,2751
0130-001,2018,8,12,16,1403,1412,2815,2740
0130-001,2018,8,12,17,1486,1353,2839,2815
0130-001,2018,8,12,18,1497,1478,2975,2839
0130-001,2018,8,12,19,1486,1334,2820,2975
0130-001,2018,8,12,20,1145,1093,2238,2820
0130-001,2018,8,12,21,1063,1031,2094,2238
0130-001,2018,8,12,22,750,661,1411,2094
0130-001,2018,8,12,23,552,554,1106,1411
0130-001,2018,8,12,24,426,380,806,1106
0130-001,2018,8,13,1,263,278,541,806
0130-001,2018,8,13,2,186,160,346,541
0130-001,2018,8,13,3,157,147,304,346
0130-001,2018,8,13,4,155,179,334,304
0130-001,2018,8,13,5,286,209,495,334
0130-001,2018,8,13,6,716,414,1130,495
0130-001,2018,8,13,7,1712,895,2607,1130
0130-001,2018,8,13,8,1875,1530,3405,2607
0130-001,2018,8,13,9,1829,1766,3595,3405
0130-001,2018,8,13,10,1672,1629,3301,3595
0130-001,2018,8,13,11,1667,1743,3410,3301
0130-001,2018,8,13,12,1664,1686,3350,3410
0130-001,2018,8,13,13,1430,1505,2935,3350
0130-001,2018,8,13,14,1690,1663,3353,2935
0130-001,2018,8,13,15,1595,1717,3312,3353
0130-001,2018,8,13,16,1668,1794,3462,3312
0130-001,2018,8,13,17,1671,1949,3620,3462
0130-001,2018,8,13,18,1742,2178,3920,3620
0130-001,2018,8,13,19,1734,2301,4035,3920
0130-001,2018,8,13,20,1240,1890,3130,4035
0130-001,2018,8,13,21,1105,1705,2810,3130
0130-001,2018,8,13,22,955,1116,2071,2810
0130-001,2018,8,13,23,774,672,1446,2071
0130-001,2018,8,13,24,453,471,924,1446
0130-001,2018,8,14,1,311,297,608,924
0130-001,2018,8,14,2,216,223,439,608
0130-001,2018,8,14,3,164,190,354,439
0130-001,2018,8,14,4,154,208,362,354
0130-001,2018,8,14,5,289,238,527,362
0130-001,2018,8,14,6,713,432,1145,527
0130-001,2018,8,14,7,1672,885,2557,1145
0130-001,2018,8,14,8,1872,1462,3334,2557
0130-001,2018,8,14,9,1859,1778,3637,3334
0130-001,2018,8,14,10,1701,1653,3354,3637
0130-001,2018,8,14,11,1660,1672,3332,3354
0130-001,2018,8,14,12,1617,1716,3333,3332
0130-001,2018,8,14,13,1466,1630,3096,3333
0130-001,2018,8,14,14,1639,1774,3413,3096
0130-001,2018,8,14,15,1711,1713,3424,3413
0130-001,2018,8,14,16,1756,1915,3671,3424
0130-001,2018,8,14,17,1780,1894,3674,3671
0130-001,2018,8,14,18,1840,2292,4132,3674
0130-001,2018,8,14,19,1834,2423,4257,4132
0130-001,2018,8,14,20,1354,1988,3342,4257
0130-001,2018,8,14,21,1202,1830,3032,3342
0130-001,2018,8,14,22,1057,1329,2386,3032
0130-001,2018,8,14,23,805,801,1606,2386
0130-001,2018,8,14,24,585,518,1103,1606
0130-001,2018,8,15,1,432,425,857,1103
0130-001,2018,8,15,2,308,276,584,857
0130-001,2018,8,15,3,246,270,516,584
0130-001,2018,8,15,4,241,267,508,516
0130-001,2018,8,15,5,299,248,547,508
0130-001,2018,8,15,6,633,376,1009,547
0130-001,2018,8,15,7,1155,683,1838,1009
0130-001,2018,8,15,8,1325,995,2320,1838
0130-001,2018,8,15,9,1266,1225,2491,2320
0130-001,2018,8,15,10,1357,1381,2738,2491
0130-001,2018,8,15,11,1335,1515,2850,2738
0130-001,2018,8,15,12,1370,1619,2989,2850
0130-001,2018,8,15,13,1347,1643,2990,2989
0130-001,2018,8,15,14,1454,1646,3100,2990
0130-001,2018,8,15,15,1519,1604,3123,3100
0130-001,2018,8,15,16,1633,1683,3316,3123
0130-001,2018,8,15,17,1503,1746,3249,3316
0130-001,2018,8,15,18,1773,2035,3808,3249
0130-001,2018,8,15,19,1610,1767,3377,3808
0130-001,2018,8,15,20,1313,1373,2686,3377
0130-001,2018,8,15,21,1167,1179,2346,2686
0130-001,2018,8,15,22,993,882,1875,2346
0130-001,2018,8,15,23,707,567,1274,1875
0130-001,2018,8,15,24,452,386,838,1274
0130-001,2018,8,16,1,287,286,573,838
0130-001,2018,8,16,2,208,183,391,573
0130-001,2018,8,16,3,148,170,318,391
0130-001,2018,8,16,4,163,185,348,318
0130-001,2018,8,16,5,283,219,502,348
0130-001,2018,8,16,6,712,382,1094,502
0130-001,2018,8,16,7,1660,744,2404,1094
0130-001,2018,8,16,8,1936,1533,3469,2404
0130-001,2018,8,16,9,1821,1891,3712,3469
0130-001,2018,8,16,10,1678,1710,3388,3712
0130-001,2018,8,16,11,1700,1635,3335,3388
0130-001,2018,8,16,12,1610,1626,3236,3335
0130-001,2018,8,16,13,1469,1477,2946,3236
0130-001,2018,8,16,14,1693,1710,3403,2946
0130-001,2018,8,16,15,1653,1725,3378,3403
0130-001,2018,8,16,16,1733,1786,3519,3378
0130-001,2018,8,16,17,1654,1948,3602,3519
0130-001,2018,8,16,18,1758,2162,3920,3602
0130-001,2018,8,16,19,1708,2242,3950,3920
0130-001,2018,8,16,20,1263,1965,3228,3950
0130-001,2018,8,16,21,1131,1693,2824,3228
0130-001,2018,8,16,22,1038,1179,2217,2824
0130-001,2018,8,16,23,709,742,1451,2217
0130-001,2018,8,16,24,495,480,975,1451
0130-001,2018,8,17,1,336,342,678,975
0130-001,2018,8,17,2,244,224,468,678
0130-001,2018,8,17,3,169,206,375,468
0130-001,2018,8,17,4,192,208,400,375
0130-001,2018,8,17,5,292,235,527,400
0130-001,2018,8,17,6,660,483,1143,527
0130-001,2018,8,17,7,1630,928,2558,1143
0130-001,2018,8,17,8,1879,1533,3412,2558
0130-001,2018,8,17,9,1921,1878,3799,3412
0130-001,2018,8,17,10,1645,1654,3299,3799
0130-001,2018,8,17,11,1634,1640,3274,3299
0130-001,2018,8,17,12,1614,1689,3303,3274
0130-001,2018,8,17,13,1483,1515,2998,3303
0130-001,2018,8,17,14,1598,1811,3409,2998
0130-001,2018,8,17,15,1748,1830,3578,3409
0130-001,2018,8,17,16,1780,1863,3643,3578
0130-001,2018,8,17,17,1773,2056,3829,3643
0130-001,2018,8,17,18,1842,2262,4104,3829
0130-001,2018,8,17,19,1802,2346,4148,4104
0130-001,2018,8,17,20,1496,2086,3582,4148
0130-001,2018,8,17,21,1205,1821,3026,3582
0130-001,2018,8,17,22,1204,1244,2448,3026
0130-001,2018,8,17,23,878,844,1722,2448
0130-001,2018,8,17,24,616,554,1170,1722
0130-001,2018,8,18,1,435,424,859,1170
0130-001,2018,8,18,2,293,284,577,859
0130-001,2018,8,18,3,244,272,516,577
0130-001,2018,8,18,4,202,232,434,516
0130-001,2018,8,18,5,281,256,537,434
0130-001,2018,8,18,6,590,437,1027,537
0130-001,2018,8,18,7,1120,729,1849,1027
0130-001,2018,8,18,8,1337,1044,2381,1849
0130-001,2018,8,18,9,1454,1436,2890,2381
0130-001,2018,8,18,10,1516,1686,3202,2890
0130-001,2018,8,18,11,1641,1794,3435,3202
0130-001,2018,8,18,12,1690,1828,3518,3435
0130-001,2018,8,18,13,1655,1777,3432,3518
0130-001,2018,8,18,14,1633,1827,3460,3432
0130-001,2018,8,18,15,1566,1753,3319,3460
0130-001,2018,8,18,16,1690,1720,3410,3319
0130-001,2018,8,18,17,1710,1775,3485,3410
0130-001,2018,8,18,18,1735,2056,3791,3485
0130-001,2018,8,18,19,1636,1815,3451,3791
0130-001,2018,8,18,20,1240,1359,2599,3451
0130-001,2018,8,18,21,1130,1174,2304,2599
0130-001,2018,8,18,22,1093,959,2052,2304
0130-001,2018,8,18,23,750,648,1398,2052
0130-001,2018,8,18,24,484,462,946,1398
0130-001,2018,8,19,1,363,393,756,946
0130-001,2018,8,19,2,338,244,582,756
0130-001,2018,8,19,3,245,189,434,582
0130-001,2018,8,19,4,203,193,396,434
0130-001,2018,8,19,5,223,189,412,396
0130-001,2018,8,19,6,358,314,672,412
0130-001,2018,8,19,7,664,486,1150,672
0130-001,2018,8,19,8,670,657,1327,1150
0130-001,2018,8,19,9,793,948,1741,1327
0130-001,2018,8,19,10,938,1120,2058,1741
0130-001,2018,8,19,11,1137,1343,2480,2058
0130-001,2018,8,19,12,1204,1357,2561,2480
0130-001,2018,8,19,13,1297,1417,2714,2561
0130-001,2018,8,19,14,1499,1447,2946,2714
0130-001,2018,8,19,15,1527,1600,3127,2946
0130-001,2018,8,19,16,1607,1502,3109,3127
0130-001,2018,8,19,17,1536,1501,3037,3109
0130-001,2018,8,19,18,1593,1570,3163,3037
0130-001,2018,8,19,19,1557,1361,2918,3163
0130-001,2018,8,19,20,1211,1237,2448,2918
0130-001,2018,8,19,21,1129,1120,2249,2448
0130-001,2018,8,19,22,926,855,1781,2249
0130-001,2018,8,19,23,673,630,1303,1781
0130-001,2018,8,19,24,412,371,783,1303
0130-001,2018,8,20,1,285,237,522,783
0130-001,2018,8,20,2,162,147,309,522
0130-001,2018,8,20,3,123,128,251,309
0130-001,2018,8,20,4,155,128,283,251
0130-001,2018,8,20,5,248,197,445,283
0130-001,2018,8,20,6,742,346,1088,445
0130-001,2018,8,20,7,1785,948,2733,1088
0130-001,2018,8,20,8,1885,1616,3501,2733
0130-001,2018,8,20,9,1894,1865,3759,3501
0130-001,2018,8,20,10,1667,1578,3245,3759
0130-001,2018,8,20,11,1711,1652,3363,3245
0130-001,2018,8,20,12,1615,1600,3215,3363
0130-001,2018,8,20,13,1463,1412,2875,3215
0130-001,2018,8,20,14,1638,1716,3354,2875
0130-001,2018,8,20,15,1728,1677,3405,3354
0130-001,2018,8,20,16,1790,1788,3578,3405
0130-001,2018,8,20,17,1695,1966,3661,3578
0130-001,2018,8,20,18,1740,2257,3997,3661
0130-001,2018,8,20,19,1711,2342,4053,3997
0130-001,2018,8,20,20,1273,1972,3245,4053
0130-001,2018,8,20,21,1116,1750,2866,3245
0130-001,2018,8,20,22,952,1192,2144,2866
0130-001,2018,8,20,23,666,710,1376,2144
0130-001,2018,8,20,24,436,418,854,1376
0130-001,2018,8,21,1,318,318,636,854
0130-001,2018,8,21,2,223,193,416,636
0130-001,2018,8,21,3,157,157,314,416
0130-001,2018,8,21,4,139,197,336,314
0130-001,2018,8,21,5,276,218,494,336
0130-001,2018,8,21,6,700,471,1171,494
0130-001,2018,8,21,7,1681,868,2549,1171
0130-001,2018,8,21,8,1855,1573,3428,2549
0130-001,2018,8,21,9,1933,1923,3856,3428
0130-001,2018,8,21,10,1561,1501,3062,3856
0130-001,2018,8,21,11,1419,1305,2724,3062
0130-001,2018,8,21,12,1622,1640,3262,2724
0130-001,2018,8,21,13,1436,1436,2872,3262
0130-001,2018,8,21,14,1654,1672,3326,2872
0130-001,2018,8,21,15,1745,1748,3493,3326
0130-001,2018,8,21,16,1423,1107,2530,3493
0130-001,2018,8,21,17,1310,1301,2611,2530
0130-001,2018,8,21,18,1356,1445,2801,2611
0130-001,2018,8,21,19,1372,1608,2980,2801
0130-001,2018,8,21,20,1085,1303,2388,2980
0130-001,2018,8,21,21,911,1171,2082,2388
0130-001,2018,8,21,22,798,889,1687,2082
0130-001,2018,8,21,23,658,586,1244,1687
0130-001,2018,8,21,24,472,388,860,1244
0130-001,2018,8,22,1,309,271,580,860
0130-001,2018,8,22,2,205,200,405,580
0130-001,2018,8,22,3,147,181,328,405
0130-001,2018,8,22,4,149,171,320,328
0130-001,2018,8,22,5,252,211,463,320
0130-001,2018,8,22,6,614,399,1013,463
0130-001,2018,8,22,7,1402,682,2084,1013
0130-001,2018,8,22,8,1606,1173,2779,2084
0130-001,2018,8,22,9,1643,1374,3017,2779
0130-001,2018,8,22,10,1433,1156,2589,3017
0130-001,2018,8,22,11,1420,1293,2713,2589
0130-001,2018,8,22,12,1593,1599,3192,2713
0130-001,2018,8,22,13,1455,1415,2870,3192
0130-001,2018,8,22,14,1628,1717,3345,2870
0130-001,2018,8,22,15,1732,1692,3424,3345
0130-001,2018,8,22,16,1827,1889,3716,3424
0130-001,2018,8,22,17,1654,1977,3631,3716
0130-001,2018,8,22,18,1761,2363,4124,3631
0130-001,2018,8,22,19,1758,2534,4292,4124
0130-001,2018,8,22,20,1342,2035,3377,4292
0130-001,2018,8,22,21,1139,1583,2722,3377
0130-001,2018,8,22,22,1139,1237,2376,2722
0130-001,2018,8,22,23,797,737,1534,2376
0130-001,2018,8,22,24,498,508,1006,1534
0130-001,2018,8,23,1,351,341,692,1006
0130-001,2018,8,23,2,250,238,488,692
0130-001,2018,8,23,3,192,197,389,488
0130-001,2018,8,23,4,163,203,366,389
0130-001,2018,8,23,5,257,252,509,366
0130-001,2018,8,23,6,543,380,923,509
0130-001,2018,8,23,7,1438,778,2216,923
0130-001,2018,8,23,8,1956,1537,3493,2216
0130-001,2018,8,23,9,1845,1884,3729,3493
0130-001,2018,8,23,10,1584,1545,3129,3729
0130-001,2018,8,23,11,1625,1556,3181,3129
0130-001,2018,8,23,12,1474,1448,2922,3181
0130-001,2018,8,23,13,1374,1431,2805,2922
0130-001,2018,8,23,14,1642,1681,3323,2805
0130-001,2018,8,23,15,1609,1639,3248,3323
0130-001,2018,8,23,16,1577,1739,3316,3248
0130-001,2018,8,23,17,1473,1879,3352,3316
0130-001,2018,8,23,18,1608,2119,3727,3352
0130-001,2018,8,23,19,1558,2212,3770,3727
0130-001,2018,8,23,20,1168,1672,2840,3770
0130-001,2018,8,23,21,789,1088,1877,2840
0130-001,2018,8,23,22,634,754,1388,1877
0130-001,2018,8,23,23,523,535,1058,1388
0130-001,2018,8,23,24,354,329,683,1058
0130-001,2018,8,24,1,254,238,492,683
0130-001,2018,8,24,2,130,137,267,492
0130-001,2018,8,24,3,95,132,227,267
0130-001,2018,8,24,4,119,153,272,227
0130-001,2018,8,24,5,157,158,315,272
0130-001,2018,8,24,6,323,261,584,315
0130-001,2018,8,24,7,1052,530,1582,584
0130-001,2018,8,24,8,1432,881,2313,1582
0130-001,2018,8,24,9,1277,1039,2316,2313
0130-001,2018,8,24,10,1210,1007,2217,2316
0130-001,2018,8,24,11,1394,1066,2460,2217
0130-001,2018,8,24,12,1497,1366,2863,2460
0130-001,2018,8,24,13,1101,891,1992,2863
0130-001,2018,8,24,14,1248,1287,2535,1992
0130-001,2018,8,24,15,1425,1556,2981,2535
0130-001,2018,8,24,16,1587,1730,3317,2981
0130-001,2018,8,24,17,1662,1976,3638,3317
0130-001,2018,8,24,18,1768,2270,4038,3638
0130-001,2018,8,24,19,1743,2379,4122,4038
0130-001,2018,8,24,20,1347,1918,3265,4122
0130-001,2018,8,24,21,1209,1553,2762,3265
0130-001,2018,8,24,22,1168,1111,2279,2762
0130-001,2018,8,24,23,825,725,1550,2279
0130-001,2018,8,24,24,549,569,1118,1550
0130-001,2018,8,25,1,447,383,830,1118
0130-001,2018,8,25,2,341,303,644,830
0130-001,2018,8,25,3,199,210,409,644
0130-001,2018,8,25,4,151,207,358,409
0130-001,2018,8,25,5,218,241,459,358
0130-001,2018,8,25,6,503,362,865,459
0130-001,2018,8,25,7,961,579,1540,865
0130-001,2018,8,25,8,1096,804,1900,1540
0130-001,2018,8,25,9,1194,1110,2304,1900
0130-001,2018,8,25,10,1376,1197,2573,2304
0130-001,2018,8,25,11,1593,1679,3272,2573
0130-001,2018,8,25,12,1654,1748,3402,3272
0130-001,2018,8,25,13,1490,1475,2965,3402
0130-001,2018,8,25,14,1501,1503,3004,2965
0130-001,2018,8,25,15,1668,1769,3437,3004
0130-001,2018,8,25,16,1455,1425,2880,3437
0130-001,2018,8,25,17,1550,1497,3047,2880
0130-001,2018,8,25,18,1567,1366,2933,3047
0130-001,2018,8,25,19,1303,1315,2618,2933
0130-001,2018,8,25,20,1199,1025,2224,2618
0130-001,2018,8,25,21,979,825,1804,2224
0130-001,2018,8,25,22,997,708,1705,1804
0130-001,2018,8,25,23,628,587,1215,1705
0130-001,2018,8,25,24,466,366,832,1215
0130-001,2018,8,26,1,296,333,629,832
0130-001,2018,8,26,2,221,219,440,629
0130-001,2018,8,26,3,184,199,383,440
0130-001,2018,8,26,4,123,177,300,383
0130-001,2018,8,26,5,164,153,317,300
0130-001,2018,8,26,6,314,241,555,317
0130-001,2018,8,26,7,462,366,828,555
0130-001,2018,8,26,8,504,467,971,828
0130-001,2018,8,26,9,650,783,1433,971
0130-001,2018,8,26,10,950,992,1942,1433
0130-001,2018,8,26,11,1242,1225,2467,1942
0130-001,2018,8,26,12,1086,1220,2306,2467
0130-001,2018,8,26,13,1005,916,1921,2306
0130-001,2018,8,26,14,1111,914,2025,1921
0130-001,2018,8,26,15,1112,1001,2113,2025
0130-001,2018,8,26,16,1175,975,2150,2113
0130-001,2018,8,26,17,1117,949,2066,2150
0130-001,2018,8,26,18,1114,899,2013,2066
0130-001,2018,8,26,19,1304,1107,2411,2013
0130-001,2018,8,26,20,1148,1105,2253,2411
0130-001,2018,8,26,21,1119,977,2096,2253
0130-001,2018,8,26,22,693,665,1358,2096
0130-001,2018,8,26,23,475,392,867,1358
0130-001,2018,8,26,24,339,324,663,867
0130-001,2018,8,27,1,237,228,465,663
0130-001,2018,8,27,2,171,143,314,465
0130-001,2018,8,27,3,123,105,228,314
0130-001,2018,8,27,4,110,168,278,228
0130-001,2018,8,27,5,187,177,364,278
0130-001,2018,8,27,6,454,302,756,364
0130-001,2018,8,27,7,1205,590,1795,756
0130-001,2018,8,27,8,1400,1001,2401,1795
0130-001,2018,8,27,9,1482,1276,2758,2401
0130-001,2018,8,27,10,1393,1037,2430,2758
0130-001,2018,8,27,11,1190,1087,2277,2430
0130-001,2018,8,27,12,1285,950,2235,2277
0130-001,2018,8,27,13,1112,963,2075,2235
0130-001,2018,8,27,14,1227,1022,2249,2075
0130-001,2018,8,27,15,1236,1080,2316,2249
0130-001,2018,8,27,16,1589,1363,2952,2316
0130-001,2018,8,27,17,1546,1911,3457,2952
0130-001,2018,8,27,18,1679,2288,3967,3457
0130-001,2018,8,27,19,1699,2367,4066,3967
0130-001,2018,8,27,20,1165,1692,2857,4066
0130-001,2018,8,27,21,942,1568,2510,2857
0130-001,2018,8,27,22,895,993,1888,2510
0130-001,2018,8,27,23,500,518,1018,1888
0130-001,2018,8,27,24,347,314,661,1018
0130-001,2018,8,28,1,244,222,466,661
0130-001,2018,8,28,2,174,182,356,466
0130-001,2018,8,28,3,121,147,268,356
0130-001,2018,8,28,4,111,164,275,268
0130-001,2018,8,28,5,152,179,331,275
0130-001,2018,8,28,6,410,278,688,331
0130-001,2018,8,28,7,1126,563,1689,688
0130-001,2018,8,28,8,1492,963,2455,1689
0130-001,2018,8,28,9,1537,1232,2769,2455
0130-001,2018,8,28,10,1311,1027,2338,2769
0130-001,2018,8,28,11,1380,1020,2400,2338
0130-001,2018,8,28,12,1261,1025,2286,2400
0130-001,2018,8,28,13,1184,951,2135,2286
0130-001,2018,8,28,14,1429,1042,2471,2135
0130-001,2018,8,28,15,1313,1067,2380,2471
0130-001,2018,8,28,16,1458,1151,2609,2380
0130-001,2018,8,28,17,1295,1372,2667,2609
0130-001,2018,8,28,18,1695,2138,3833,2667
0130-001,2018,8,28,19,1691,2340,4031,3833
0130-001,2018,8,28,20,1283,1813,3096,4031
0130-001,2018,8,28,21,1055,1691,2746,3096
0130-001,2018,8,28,22,881,1096,1977,2746
0130-001,2018,8,28,23,809,753,1562,1977
0130-001,2018,8,28,24,484,434,918,1562
0130-001,2018,8,29,1,370,313,683,918
0130-001,2018,8,29,2,219,231,450,683
0130-001,2018,8,29,3,155,170,325,450
0130-001,2018,8,29,4,166,185,351,325
0130-001,2018,8,29,5,234,229,463,351
0130-001,2018,8,29,6,619,397,1016,463
0130-001,2018,8,29,7,1594,885,2479,1016
0130-001,2018,8,29,8,1956,1510,3466,2479
0130-001,2018,8,29,9,1900,1918,3818,3466
0130-001,2018,8,29,10,1664,1561,3225,3818
0130-001,2018,8,29,11,1723,1588,3311,3225
0130-001,2018,8,29,12,1625,1633,3258,3311
0130-001,2018,8,29,13,1376,1449,2825,3258
0130-001,2018,8,29,14,1603,1737,3340,2825
0130-001,2018,8,29,15,1744,1696,3440,3340
0130-001,2018,8,29,16,1686,1843,3529,3440
0130-001,2018,8,29,17,1683,1973,3656,3529
0130-001,2018,8,29,18,1780,2398,4178,3656
0130-001,2018,8,29,19,1661,2382,4043,4178
0130-001,2018,8,29,20,1128,1742,2870,4043
0130-001,2018,8,29,21,1078,1528,2606,2870
0130-001,2018,8,29,22,955,1044,1999,2606
0130-001,2018,8,29,23,749,689,1438,1999
0130-001,2018,8,29,24,499,445,944,1438
0130-001,2018,8,30,1,373,334,707,944
0130-001,2018,8,30,2,220,198,418,707
0130-001,2018,8,30,3,184,201,385,418
0130-001,2018,8,30,4,162,191,353,385
0130-001,2018,8,30,5,179,189,368,353
0130-001,2018,8,30,6,532,318,850,368
0130-001,2018,8,30,7,1384,662,2046,850
0130-001,2018,8,30,8,1281,1007,2288,2046
0130-001,2018,8,30,9,1386,1206,2592,2288
0130-001,2018,8,30,10,1656,1163,2819,2592
0130-001,2018,8,30,11,1494,1360,2854,2819
0130-001,2018,8,30,12,1625,1767,3392,2854
0130-001,2018,8,30,13,1423,1502,2925,3392
0130-001,2018,8,30,14,1373,1210,2583,2925
0130-001,2018,8,30,15,1266,1097,2363,2583
0130-001,2018,8,30,16,1320,1074,2394,2363
0130-001,2018,8,30,17,1341,1232,2573,2394
0130-001,2018,8,30,18,1432,1317,2749,2573
0130-001,2018,8,30,19,1325,1375,2700,2749
0130-001,2018,8,30,20,993,1260,2253,2700
0130-001,2018,8,30,21,851,1106,1957,2253
0130-001,2018,8,30,22,763,726,1489,1957
0130-001,2018,8,30,23,570,518,1088,1489
0130-001,2018,8,30,24,361,384,745,1088
0130-001,2018,8,31,1,267,268,535,745
0130-001,2018,8,31,2,175,191,366,535
0130-001,2018,8,31,3,126,166,292,366
0130-001,2018,8,31,4,123,163,286,292
0130-001,2018,8,31,5,196,192,388,286
0130-001,2018,8,31,6,454,315,769,388
0130-001,2018,8,31,7,1170,626,1796,769
0130-001,2018,8,31,8,1529,985,2514,1796
0130-001,2018,8,31,9,1475,1240,2715,2514
0130-001,2018,8,31,10,1328,1015,2343,2715
0130-001,2018,8,31,11,1435,1126,2561,2343
0130-001,2018,8,31,12,1614,1481,3095,2561
0130-001,2018,8,31,13,1383,1591,2974,3095
0130-001,2018,8,31,14,1672,1839,3511,2974
0130-001,2018,8,31,15,1893,1829,3722,3511
0130-001,2018,8,31,16,1872,1851,3723,3722
0130-001,2018,8,31,17,1737,2051,3788,3723
0130-001,2018,8,31,18,1865,2280,4145,3788
0130-001,2018,8,31,19,1772,2415,4187,4145
0130-001,2018,8,31,20,1468,2043,3511,4187
0130-001,2018,8,31,21,1226,1832,3058,3511
0130-001,2018,8,31,22,1258,1247,2505,3058
0130-001,2018,8,31,23,871,858,1729,2505
0130-001,2018,8,31,24,647,637,1284,1729
0130-001,2018,9,1,1,478,453,931,1284
0130-001,2018,9,1,2,367,319,686,931
0130-001,2018,9,1,3,267,310,577,686
0130-001,2018,9,1,4,230,282,512,577
0130-001,2018,9,1,5,329,263,592,512
0130-001,2018,9,1,6,614,405,1019,592
0130-001,2018,9,1,7,1201,766,1967,1019
0130-001,2018,9,1,8,1322,1146,2468,1967
0130-001,2018,9,1,9,1504,1445,2949,2468
0130-001,2018,9,1,10,1605,1502,3107,2949
0130-001,2018,9,1,11,1674,1813,3487,3107
0130-001,2018,9,1,12,1729,1830,3559,3487
0130-001,2018,9,1,13,1691,1865,3556,3559
0130-001,2018,9,1,14,1618,1866,3484,3556
0130-001,2018,9,1,15,1619,1786,3405,3484
0130-001,2018,9,1,16,1701,1777,3478,3405
0130-001,2018,9,1,17,1745,1984,3729,3478
0130-001,2018,9,1,18,1819,2106,3925,3729
0130-001,2018,9,1,19,1601,1872,3473,3925
0130-001,2018,9,1,20,1413,1404,2817,3473
0130-001,2018,9,1,21,1164,1152,2316,2817
0130-001,2018,9,1,22,860,769,1629,2316
0130-001,2018,9,1,23,556,523,1079,1629
0130-001,2018,9,1,24,550,546,1096,1079
0130-001,2018,9,2,1,394,363,757,1096
0130-001,2018,9,2,2,295,268,563,757
0130-001,2018,9,2,3,198,189,387,563
0130-001,2018,9,2,4,195,182,377,387
0130-001,2018,9,2,5,231,188,419,377
0130-001,2018,9,2,6,423,253,676,419
0130-001,2018,9,2,7,727,478,1205,676
0130-001,2018,9,2,8,735,637,1372,1205
0130-001,2018,9,2,9,836,885,1721,1372
0130-001,2018,9,2,10,961,1100,2061,1721
0130-001,2018,9,2,11,1181,1310,2491,2061
0130-001,2018,9,2,12,1188,1360,2548,2491
0130-001,2018,9,2,13,1281,1445,2726,2548
0130-001,2018,9,2,14,1548,1573,3121,2726
0130-001,2018,9,2,15,1514,1603,3117,3121
0130-001,2018,9,2,16,1592,1610,3202,3117
0130-001,2018,9,2,17,1649,1650,3299,3202
0130-001,2018,9,2,18,1642,1703,3345,3299
0130-001,2018,9,2,19,1584,1459,3043,3345
0130-001,2018,9,2,20,1360,1285,2645,3043
0130-001,2018,9,2,21,1189,1037,2226,2645
0130-001,2018,9,2,22,950,838,1788,2226
0130-001,2018,9,2,23,673,570,1243,1788
0130-001,2018,9,2,24,451,418,869,1243
0130-001,2018,9,3,1,292,243,535,869
0130-001,2018,9,3,2,156,143,299,535
0130-001,2018,9,3,3,115,120,235,299
0130-001,2018,9,3,4,138,157,295,235
0130-001,2018,9,3,5,249,215,464,295
0130-001,2018,9,3,6,748,410,1158,464
0130-001,2018,9,3,7,1779,908,2687,1158
0130-001,2018,9,3,8,1687,1477,3164,2687
0130-001,2018,9,3,9,1547,1256,2803,3164
0130-001,2018,9,3,10,1430,1237,2667,2803
0130-001,2018,9,3,11,1505,1469,2974,2667
0130-001,2018,9,3,12,1544,1629,3173,2974
0130-001,2018,9,3,13,1466,1437,2903,3173
0130-001,2018,9,3,14,1562,1595,3157,2903
0130-001,2018,9,3,15,1620,1710,3330,3157
0130-001,2018,9,3,16,1628,1776,3404,3330
0130-001,2018,9,3,17,1617,1863,3480,3404
0130-001,2018,9,3,18,1484,1593,3077,3480
0130-001,2018,9,3,19,1298,1260,2558,3077
0130-001,2018,9,3,20,1009,1294,2303,2558
0130-001,2018,9,3,21,865,1095,1960,2303
0130-001,2018,9,3,22,758,723,1481,1960
0130-001,2018,9,3,23,504,525,1029,1481
0130-001,2018,9,3,24,303,329,632,1029
0130-001,2018,9,4,1,202,231,433,632
0130-001,2018,9,4,2,150,167,317,433
0130-001,2018,9,4,3,109,161,270,317
0130-001,2018,9,4,4,117,177,294,270
0130-001,2018,9,4,5,171,201,372,294
0130-001,2018,9,4,6,487,333,820,372
0130-001,2018,9,4,7,1304,586,1890,820
0130-001,2018,9,4,8,1592,1065,2657,1890
0130-001,2018,9,4,9,1515,1424,2939,2657
0130-001,2018,9,4,10,1685,1621,3306,2939
0130-001,2018,9,4,11,1566,1583,3149,3306
0130-001,2018,9,4,12,1502,1485,2987,3149
0130-001,2018,9,4,13,1444,1475,2919,2987
0130-001,2018,9,4,14,1646,1665,3311,2919
0130-001,2018,9,4,15,1629,1709,3338,3311
0130-001,2018,9,4,16,1577,1761,3338,3338
0130-001,2018,9,4,17,1734,2019,3753,3338
0130-001,2018,9,4,18,1837,2323,4160,3753
0130-001,2018,9,4,19,1668,2362,4030,4160
0130-001,2018,9,4,20,1399,2075,3474,4030
0130-001,2018,9,4,21,1064,1742,2806,3474
0130-001,2018,9,4,22,1059,1152,2211,2806
0130-001,2018,9,4,23,808,787,1595,2211
0130-001,2018,9,4,24,516,506,1022,1595
0130-001,2018,9,5,1,326,336,662,1022
0130-001,2018,9,5,2,209,228,437,662
0130-001,2018,9,5,3,169,167,336,437
0130-001,2018,9,5,4,154,194,348,336
0130-001,2018,9,5,5,260,246,506,348
0130-001,2018,9,5,6,705,428,1133,506
0130-001,2018,9,5,7,1733,911,2644,1133
0130-001,2018,9,5,8,1873,1598,3471,2644
0130-001,2018,9,5,9,1907,1927,3834,3471
0130-001,2018,9,5,10,1720,1611,3331,3834
0130-001,2018,9,5,11,1566,1750,3316,3331
0130-001,2018,9,5,12,1514,1930,3444,3316
0130-001,2018,9,5,13,1399,1580,2979,3444
0130-001,2018,9,5,14,1540,1680,3220,2979
0130-001,2018,9,5,15,1673,1719,3392,3220
0130-001,2018,9,5,16,1710,1751,3461,3392
0130-001,2018,9,5,17,1631,2034,3665,3461
0130-001,2018,9,5,18,1875,2407,4282,3665
0130-001,2018,9,5,19,1669,2439,4108,4282
0130-001,2018,9,5,20,1312,1982,3294,4108
0130-001,2018,9,5,21,1188,1639,2827,3294
0130-001,2018,9,5,22,1062,1225,2287,2827
0130-001,2018,9,5,23,795,764,1559,2287
0130-001,2018,9,5,24,526,531,1057,1559
0130-001,2018,9,6,1,346,355,701,1057
0130-001,2018,9,6,2,228,222,450,701
0130-001,2018,9,6,3,155,210,365,450
0130-001,2018,9,6,4,164,215,379,365
0130-001,2018,9,6,5,252,240,492,379
0130-001,2018,9,6,6,692,439,1131,492
0130-001,2018,9,6,7,1780,923,2703,1131
0130-001,2018,9,6,8,1905,1578,3483,2703
0130-001,2018,9,6,9,1964,1910,3874,3483
0130-001,2018,9,6,10,1724,1617,3341,3874
0130-001,2018,9,6,11,1623,1683,3306,3341
0130-001,2018,9,6,12,1585,1930,3515,3306
0130-001,2018,9,6,13,1344,1909,3253,3515
0130-001,2018,9,6,14,1633,1971,3604,3253
0130-001,2018,9,6,15,1612,1798,3410,3604
0130-001,2018,9,6,16,1668,1801,3469,3410
0130-001,2018,9,6,17,1707,2042,3749,3469
0130-001,2018,9,6,18,1748,2385,4133,3749
0130-001,2018,9,6,19,1697,2356,4053,4133
0130-001,2018,9,6,20,1276,2060,3336,4053
0130-001,2018,9,6,21,1080,1692,2772,3336
0130-001,2018,9,6,22,964,1060,2024,2772
0130-001,2018,9,6,23,591,567,1158,2024
0130-001,2018,9,6,24,371,401,772,1158
0130-001,2018,9,7,1,280,293,573,772
0130-001,2018,9,7,2,188,178,366,573
0130-001,2018,9,7,3,136,172,308,366
0130-001,2018,9,7,4,121,171,292,308
0130-001,2018,9,7,5,198,211,409,292
0130-001,2018,9,7,6,589,376,965,409
0130-001,2018,9,7,7,1602,889,2491,965
0130-001,2018,9,7,8,1819,1346,3165,2491
0130-001,2018,9,7,9,1650,1452,3102,3165
0130-001,2018,9,7,10,1720,1592,3312,3102
0130-001,2018,9,7,11,1558,1670,3228,3312
0130-001,2018,9,7,12,1598,1663,3261,3228
0130-001,2018,9,7,13,1492,1935,3427,3261
0130-001,2018,9,7,14,1636,1850,3486,3427
0130-001,2018,9,7,15,1612,1791,3403,3486
0130-001,2018,9,7,16,1680,1831,3511,3403
0130-001,2018,9,7,17,1774,2070,3844,3511
0130-001,2018,9,7,18,2009,2403,4412,3844
0130-001,2018,9,7,19,1841,2505,4346,4412
0130-001,2018,9,7,20,1433,2106,3539,4346
0130-001,2018,9,7,21,1187,1864,3051,3539
0130-001,2018,9,7,22,1143,1129,2272,3051
0130-001,2018,9,7,23,852,816,1668,2272
0130-001,2018,9,7,24,572,536,1108,1668
0130-001,2018,9,8,1,465,401,866,1108
0130-001,2018,9,8,2,344,276,620,866
0130-001,2018,9,8,3,222,250,472,620
0130-001,2018,9,8,4,213,264,477,472
0130-001,2018,9,8,5,283,305,588,477
0130-001,2018,9,8,6,630,458,1088,588
0130-001,2018,9,8,7,1244,825,2069,1088
0130-001,2018,9,8,8,1484,1134,2618,2069
0130-001,2018,9,8,9,1606,1733,3339,2618
0130-001,2018,9,8,10,1616,1831,3447,3339
0130-001,2018,9,8,11,1757,1946,3703,3447
0130-001,2018,9,8,12,1787,1950,3737,3703
0130-001,2018,9,8,13,1650,1898,3548,3737
0130-001,2018,9,8,14,1763,1913,3676,3548
0130-001,2018,9,8,15,1722,1839,3561,3676
0130-001,2018,9,8,16,1774,1836,3610,3561
0130-001,2018,9,8,17,1862,2022,3884,3610
0130-001,2018,9,8,18,1770,2133,3903,3884
0130-001,2018,9,8,19,1833,2107,3940,3903
0130-001,2018,9,8,20,1438,1598,3036,3940
0130-001,2018,9,8,21,1222,1235,2457,3036
0130-001,2018,9,8,22,1038,998,2036,2457
0130-001,2018,9,8,23,764,752,1516,2036
0130-001,2018,9,8,24,518,511,1029,1516
0130-001,2018,9,9,1,391,350,741,1029
0130-001,2018,9,9,2,280,252,532,741
0130-001,2018,9,9,3,242,200,442,532
0130-001,2018,9,9,4,201,184,385,442
0130-001,2018,9,9,5,217,170,387,385
0130-001,2018,9,9,6,392,290,682,387
0130-001,2018,9,9,7,747,541,1288,682
0130-001,2018,9,9,8,833,810,1643,1288
0130-001,2018,9,9,9,932,931,1863,1643
0130-001,2018,9,9,10,1094,1151,2245,1863
0130-001,2018,9,9,11,1324,1249,2573,2245
0130-001,2018,9,9,12,1262,1223,2485,2573
0130-001,2018,9,9,13,1432,1402,2834,2485
0130-001,2018,9,9,14,1539,1478,3017,2834
0130-001,2018,9,9,15,1643,1548,3191,3017
0130-001,2018,9,9,16,1766,1542,3308,3191
0130-001,2018,9,9,17,1780,1559,3339,3308
0130-001,2018,9,9,18,1709,1602,3311,3339
0130-001,2018,9,9,19,1704,1503,3207,3311
0130-001,2018,9,9,20,1597,1242,2839,3207
0130-001,2018,9,9,21,1463,1064,2527,2839
0130-001,2018,9,9,22,1089,833,1922,2527
0130-001,2018,9,9,23,701,602,1303,1922
0130-001,2018,9,9,24,429,376,805,1303
0130-001,2018,9,10,1,278,218,496,805
0130-001,2018,9,10,2,175,150,325,496
0130-001,2018,9,10,3,122,135,257,325
0130-001,2018,9,10,4,125,174,299,257
0130-001,2018,9,10,5,266,193,459,299
0130-001,2018,9,10,6,723,402,1125,459
0130-001,2018,9,10,7,1833,924,2757,1125
0130-001,2018,9,10,8,1916,1589,3505,2757
0130-001,2018,9,10,9,1975,1915,3890,3505
0130-001,2018,9,10,10,1683,1652,3335,3890
0130-001,2018,9,10,11,1623,1621,3244,3335
0130-001,2018,9,10,12,1560,1645,3205,3244
0130-001,2018,9,10,13,1471,1546,3017,3205
0130-001,2018,9,10,14,1689,1791,3480,3017
0130-001,2018,9,10,15,1566,1762,3328,3480
0130-001,2018,9,10,16,1649,1783,3432,3328
0130-001,2018,9,10,17,1733,2057,3790,3432
0130-001,2018,9,10,18,1790,2320,4110,3790
0130-001,2018,9,10,19,1752,2449,4201,4110
0130-001,2018,9,10,20,1355,2008,3363,4201
0130-001,2018,9,10,21,1083,1756,2839,3363
0130-001,2018,9,10,22,980,1233,2213,2839
0130-001,2018,9,10,23,691,800,1491,2213
0130-001,2018,9,10,24,479,449,928,1491
0130-001,2018,9,11,1,295,305,600,928
0130-001,2018,9,11,2,222,207,429,600
0130-001,2018,9,11,3,153,176,329,429
0130-001,2018,9,11,4,154,222,376,329
0130-001,2018,9,11,5,271,259,530,376
0130-001,2018,9,11,6,687,445,1132,530
0130-001,2018,9,11,7,1804,886,2690,1132
0130-001,2018,9,11,8,1891,1539,3430,2690
0130-001,2018,9,11,9,1942,1929,3871,3430
0130-001,2018,9,11,10,1840,1679,3519,3871
0130-001,2018,9,11,11,1659,1624,3283,3519
0130-001,2018,9,11,12,1589,1571,3160,3283
0130-001,2018,9,11,13,1435,1553,2988,3160
0130-001,2018,9,11,14,1664,1741,3405,2988
0130-001,2018,9,11,15,1721,1759,3480,3405
0130-001,2018,9,11,16,1576,1853,3429,3480
0130-001,2018,9,11,17,1724,2027,3751,3429
0130-001,2018,9,11,18,1737,2412,4149,3751
0130-001,2018,9,11,19,1684,2406,4090,4149
0130-001,2018,9,11,20,1352,1992,3344,4090
0130-001,2018,9,11,21,1078,1773,2851,3344
0130-001,2018,9,11,22,1007,1162,2169,2851
0130-001,2018,9,11,23,782,799,1581,2169
0130-001,2018,9,11,24,466,503,969,1581
0130-001,2018,9,12,1,319,325,644,969
0130-001,2018,9,12,2,215,197,412,644
0130-001,2018,9,12,3,182,172,354,412
0130-001,2018,9,12,4,140,211,351,354
0130-001,2018,9,12,5,278,228,506,351
0130-001,2018,9,12,6,699,453,1152,506
0130-001,2018,9,12,7,1666,921,2587,1152
0130-001,2018,9,12,8,1919,1571,3490,2587
0130-001,2018,9,12,9,1966,1915,3881,3490
0130-001,2018,9,12,10,1791,1550,3341,3881
0130-001,2018,9,12,11,1633,1684,3317,3341
0130-001,2018,9,12,12,1697,1622,3319,3317
0130-001,2018,9,12,13,1428,1454,2882,3319
0130-001,2018,9,12,14,1620,1774,3394,2882
0130-001,2018,9,12,15,1665,1951,3616,3394
0130-001,2018,9,12,16,1782,1920,3702,3616
0130-001,2018,9,12,17,1640,1971,3611,3702
0130-001,2018,9,12,18,1751,2070,3821,3611
0130-001,2018,9,12,19,1717,2380,4097,3821
0130-001,2018,9,12,20,1294,1998,3292,4097
0130-001,2018,9,12,21,1090,1552,2642,3292
0130-001,2018,9,12,22,1082,1134,2216,2642
0130-001,2018,9,12,23,828,794,1622,2216
0130-001,2018,9,12,24,646,494,1140,1622
0130-001,2018,9,13,1,366,307,673,1140
0130-001,2018,9,13,2,238,232,470,673
0130-001,2018,9,13,3,170,201,371,470
0130-001,2018,9,13,4,173,208,381,371
0130-001,2018,9,13,5,316,262,578,381
0130-001,2018,9,13,6,709,464,1173,578
0130-001,2018,9,13,7,1724,896,2620,1173
0130-001,2018,9,13,8,1909,1554,3463,2620
0130-001,2018,9,13,9,1932,1914,3846,3463
0130-001,2018,9,13,10,1769,1690,3459,3846
0130-001,2018,9,13,11,1691,1637,3328,3459
0130-001,2018,9,13,12,1657,1598,3255,3328
0130-001,2018,9,13,13,1467,1553,3020,3255
0130-001,2018,9,13,14,1750,1663,3413,3020
0130-001,2018,9,13,15,1722,1704,3426,3413
0130-001,2018,9,13,16,1690,1839,3529,3426
0130-001,2018,9,13,17,1650,2009,3659,3529
0130-001,2018,9,13,18,1746,2364,4110,3659
0130-001,2018,9,13,19,1747,2389,4136,4110
0130-001,2018,9,13,20,1399,2019,3418,4136
0130-001,2018,9,13,21,1241,1785,3026,3418
0130-001,2018,9,13,22,1131,1275,2406,3026
0130-001,2018,9,13,23,846,853,1699,2406
0130-001,2018,9,13,24,520,512,1032,1699
0130-001,2018,9,14,1,365,420,785,1032
0130-001,2018,9,14,2,233,233,466,785
0130-001,2018,9,14,3,169,193,362,466
0130-001,2018,9,14,4,164,239,403,362
0130-001,2018,9,14,5,311,240,551,403
0130-001,2018,9,14,6,681,447,1128,551
0130-001,2018,9,14,7,1705,909,2614,1128
0130-001,2018,9,14,8,1931,1554,3485,2614
0130-001,2018,9,14,9,1490,1342,2832,3485
0130-001,2018,9,14,10,1562,1231,2793,2832
0130-001,2018,9,14,11,1479,1255,2734,2793
0130-001,2018,9,14,12,1385,1245,2630,2734
0130-001,2018,9,14,13,1315,1167,2482,2630
0130-001,2018,9,14,14,1611,1336,2947,2482
0130-001,2018,9,14,15,1658,1645,3303,2947
0130-001,2018,9,14,16,1786,1964,3750,3303
0130-001,2018,9,14,17,1830,2084,3914,3750
0130-001,2018,9,14,18,1688,1772,3460,3914
0130-001,2018,9,14,19,1439,1275,2714,3460
0130-001,2018,9,14,20,1109,1327,2436,2714
0130-001,2018,9,14,21,967,1198,2165,2436
0130-001,2018,9,14,22,881,894,1775,2165
0130-001,2018,9,14,23,727,613,1340,1775
0130-001,2018,9,14,24,442,427,869,1340
0130-001,2018,9,15,1,359,352,711,869
0130-001,2018,9,15,2,227,225,452,711
0130-001,2018,9,15,3,193,223,416,452
0130-001,2018,9,15,4,144,202,346,416
0130-001,2018,9,15,5,228,228,456,346
0130-001,2018,9,15,6,447,343,790,456
0130-001,2018,9,15,7,933,559,1492,790
0130-001,2018,9,15,8,1132,771,1903,1492
0130-001,2018,9,15,9,1190,1117,2307,1903
0130-001,2018,9,15,10,1361,1154,2515,2307
0130-001,2018,9,15,11,1297,1146,2443,2515
0130-001,2018,9,15,12,1349,1194,2543,2443
0130-001,2018,9,15,13,1322,1277,2599,2543
0130-001,2018,9,15,14,1374,1258,2632,2599
0130-001,2018,9,15,15,1419,1282,2701,2632
0130-001,2018,9,15,16,1860,1843,3703,2701
0130-001,2018,9,15,17,1804,1953,3757,3703
0130-001,2018,9,15,18,1661,1879,3540,3757
0130-001,2018,9,15,19,1430,1255,2685,3540
0130-001,2018,9,15,20,1145,921,2066,2685
0130-001,2018,9,15,21,889,835,1724,2066
0130-001,2018,9,15,22,754,625,1379,1724
0130-001,2018,9,15,23,586,489,1075,1379
0130-001,2018,9,15,24,383,358,741,1075
0130-001,2018,9,16,1,314,293,607,741
0130-001,2018,9,16,2,222,238,460,607
0130-001,2018,9,16,3,188,183,371,460
0130-001,2018,9,16,4,123,138,261,371
0130-001,2018,9,16,5,173,170,343,261
0130-001,2018,9,16,6,313,260,573,343
0130-001,2018,9,16,7,627,463,1090,573
0130-001,2018,9,16,8,663,600,1263,1090
0130-001,2018,9,16,9,721,680,1401,1263
0130-001,2018,9,16,10,872,787,1659,1401
0130-001,2018,9,16,11,1004,960,1964,1659
0130-001,2018,9,16,12,963,985,1948,1964
0130-001,2018,9,16,13,1154,1066,2220,1948
0130-001,2018,9,16,14,1305,1119,2424,2220
0130-001,2018,9,16,15,1736,1685,3421,2424
0130-001,2018,9,16,16,1801,1768,3569,3421
0130-001,2018,9,16,17,1739,1687,3426,3569
0130-001,2018,9,16,18,1801,1718,3519,3426
0130-001,2018,9,16,19,1801,1575,3376,3519
0130-001,2018,9,16,20,1291,1184,2475,3376
0130-001,2018,9,16,21,1177,1091,2268,2475
0130-001,2018,9,16,22,993,805,1798,2268
0130-001,2018,9,16,23,706,567,1273,1798
0130-001,2018,9,16,24,409,345,754,1273
0130-001,2018,9,17,1,236,214,450,754
0130-001,2018,9,17,2,139,134,273,450
0130-001,2018,9,17,3,108,116,224,273
0130-001,2018,9,17,4,105,155,260,224
0130-001,2018,9,17,5,231,205,436,260
0130-001,2018,9,17,6,539,358,897,436
0130-001,2018,9,17,7,1712,869,2581,897
0130-001,2018,9,17,8,1909,1615,3524,2581
0130-001,2018,9,17,9,2003,1947,3950,3524
0130-001,2018,9,17,10,1658,1644,3302,3950
0130-001,2018,9,17,11,1520,1644,3164,3302
0130-001,2018,9,17,12,1609,1640,3249,3164
0130-001,2018,9,17,13,1486,1530,3016,3249
0130-001,2018,9,17,14,1721,1768,3489,3016
0130-001,2018,9,17,15,1842,1819,3661,3489
0130-001,2018,9,17,16,1929,1842,3771,3661
0130-001,2018,9,17,17,1781,2093,3874,3771
0130-001,2018,9,17,18,1824,2278,4102,3874
0130-001,2018,9,17,19,1767,2373,4140,4102
0130-001,2018,9,17,20,1416,2035,3451,4140
0130-001,2018,9,17,21,1120,1806,2926,3451
0130-001,2018,9,17,22,1079,1253,2332,2926
0130-001,2018,9,17,23,816,761,1577,2332
0130-001,2018,9,17,24,491,474,965,1577
0130-001,2018,9,18,1,328,334,662,965
0130-001,2018,9,18,2,226,199,425,662
0130-001,2018,9,18,3,141,159,300,425
0130-001,2018,9,18,4,155,211,366,300
0130-001,2018,9,18,5,286,267,553,366
0130-001,2018,9,18,6,729,470,1199,553
0130-001,2018,9,18,7,1784,965,2749,1199
0130-001,2018,9,18,8,1834,1584,3418,2749
0130-001,2018,9,18,9,2040,1933,3973,3418
0130-001,2018,9,18,10,1884,1697,3581,3973
0130-001,2018,9,18,11,1738,1750,3488,3581
0130-001,2018,9,18,12,1763,1753,3516,3488
0130-001,2018,9,18,13,1493,1577,3070,3516
0130-001,2018,9,18,14,1809,1830,3639,3070
0130-001,2018,9,18,15,1761,1783,3544,3639
0130-001,2018,9,18,16,1852,1950,3802,3544
0130-001,2018,9,18,17,1804,2065,3869,3802
0130-001,2018,9,18,18,1835,2314,4149,3869
0130-001,2018,9,18,19,1746,2377,4123,4149
0130-001,2018,9,18,20,1412,2019,3431,4123
0130-001,2018,9,18,21,1154,1901,3055,3431
0130-001,2018,9,18,22,1122,1248,2370,3055
0130-001,2018,9,18,23,876,806,1682,2370
0130-001,2018,9,18,24,497,490,987,1682
0130-001,2018,9,19,1,363,311,674,987
0130-001,2018,9,19,2,246,252,498,674
0130-001,2018,9,19,3,175,175,350,498
0130-001,2018,9,19,4,171,204,375,350
0130-001,2018,9,19,5,297,271,568,375
0130-001,2018,9,19,6,743,476,1219,568
0130-001,2018,9,19,7,1826,920,2746,1219
0130-001,2018,9,19,8,1906,1609,3515,2746
0130-001,2018,9,19,9,1997,1916,3913,3515
0130-001,2018,9,19,10,1893,1715,3608,3913
0130-001,2018,9,19,11,1782,1812,3594,3608
0130-001,2018,9,19,12,1630,1746,3376,3594
0130-001,2018,9,19,13,1655,1600,3255,3376
0130-001,2018,9,19,14,1867,1765,3632,3255
0130-001,2018,9,19,15,1824,1865,3689,3632
0130-001,2018,9,19,16,1939,1975,3914,3689
0130-001,2018,9,19,17,1788,2117,3905,3914
0130-001,2018,9,19,18,1832,2426,4258,3905
0130-001,2018,9,19,19,1815,2410,4225,4258
0130-001,2018,9,19,20,1397,2043,3440,4225
0130-001,2018,9,19,21,1179,1759,2938,3440
0130-001,2018,9,19,22,1159,1237,2396,2938
0130-001,2018,9,19,23,857,805,1662,2396
0130-001,2018,9,19,24,557,518,1075,1662
0130-001,2018,9,20,1,356,366,722,1075
0130-001,2018,9,20,2,247,241,488,722
0130-001,2018,9,20,3,177,196,373,488
0130-001,2018,9,20,4,183,205,388,373
0130-001,2018,9,20,5,274,242,516,388
0130-001,2018,9,20,6,642,455,1097,516
0130-001,2018,9,20,7,1602,865,2467,1097
0130-001,2018,9,20,8,1916,1538,3454,2467
0130-001,2018,9,20,9,1193,1270,2463,3454
0130-001,2018,9,20,10,1570,1214,2784,2463
0130-001,2018,9,20,11,1420,1178,2598,2784
0130-001,2018,9,20,12,1323,1192,2515,2598
0130-001,2018,9,20,13,1323,1079,2402,2515
0130-001,2018,9,20,14,1461,1207,2668,2402
0130-001,2018,9,20,15,1534,1245,2779,2668
0130-001,2018,9,20,16,1489,1283,2772,2779
0130-001,2018,9,20,17,1790,2117,3907,2772
0130-001,2018,9,20,18,1855,2316,4171,3907
0130-001,2018,9,20,19,1792,2261,4053,4171
0130-001,2018,9,20,20,1360,1926,3286,4053
0130-001,2018,9,20,21,1001,1317,2318,3286
0130-001,2018,9,20,22,950,860,1810,2318
0130-001,2018,9,20,23,650,639,1289,1810
0130-001,2018,9,20,24,381,417,798,1289
0130-001,2018,9,21,1,311,311,622,798
0130-001,2018,9,21,2,214,213,427,622
0130-001,2018,9,21,3,169,154,323,427
0130-001,2018,9,21,4,121,187,308,323
0130-001,2018,9,21,5,185,201,386,308
0130-001,2018,9,21,6,475,316,791,386
0130-001,2018,9,21,7,1143,643,1786,791
0130-001,2018,9,21,8,1517,1067,2584,1786
0130-001,2018,9,21,9,1547,1300,2847,2584
0130-001,2018,9,21,10,1381,1119,2500,2847
0130-001,2018,9,21,11,1412,1216,2628,2500
0130-001,2018,9,21,12,1392,1249,2641,2628
0130-001,2018,9,21,13,1262,1179,2441,2641
0130-001,2018,9,21,14,1494,1262,2756,2441
0130-001,2018,9,21,15,1542,1355,2897,2756
0130-001,2018,9,21,16,1501,1471,2972,2897
0130-001,2018,9,21,17,1585,1572,3157,2972
0130-001,2018,9,21,18,1723,1697,3420,3157
0130-001,2018,9,21,19,1628,2005,3633,3420
0130-001,2018,9,21,20,1472,1835,3307,3633
0130-001,2018,9,21,21,1212,1454,2666,3307
0130-001,2018,9,21,22,1136,1147,2283,2666
0130-001,2018,9,21,23,900,859,1759,2283
0130-001,2018,9,21,24,592,567,1159,1759
0130-001,2018,9,22,1,447,422,869,1159
0130-001,2018,9,22,2,338,298,636,869
0130-001,2018,9,22,3,314,266,580,636
0130-001,2018,9,22,4,257,302,559,580
0130-001,2018,9,22,5,290,315,605,559
0130-001,2018,9,22,6,461,417,878,605
0130-001,2018,9,22,7,954,682,1636,878
0130-001,2018,9,22,8,1115,1023,2138,1636
0130-001,2018,9,22,9,1297,1515,2812,2138
0130-001,2018,9,22,10,1544,1827,3371,2812
0130-001,2018,9,22,11,1597,2119,3716,3371
0130-001,2018,9,22,12,1624,2114,3738,3716
0130-001,2018,9,22,13,1649,1894,3543,3738
0130-001,2018,9,22,14,1715,1949,3664,3543
0130-001,2018,9,22,15,1684,1891,3575,3664
0130-001,2018,9,22,16,1659,1853,3512,3575
0130-001,2018,9,22,17,1601,1834,3435,3512
0130-001,2018,9,22,18,1642,1798,3440,3435
0130-001,2018,9,22,19,1487,1641,3128,3440
0130-001,2018,9,22,20,1320,1254,2574,3128
0130-001,2018,9,22,21,1041,1056,2097,2574
0130-001,2018,9,22,22,936,845,1781,2097
0130-001,2018,9,22,23,690,606,1296,1781
0130-001,2018,9,22,24,447,490,937,1296
0130-001,2018,9,23,1,352,355,707,937
0130-001,2018,9,23,2,275,265,540,707
0130-001,2018,9,23,3,221,201,422,540
0130-001,2018,9,23,4,181,181,362,422
0130-001,2018,9,23,5,218,240,458,362
0130-001,2018,9,23,6,278,314,592,458
0130-001,2018,9,23,7,452,487,939,592
0130-001,2018,9,23,8,557,743,1300,939
0130-001,2018,9,23,9,870,1087,1957,1300
0130-001,2018,9,23,10,1154,1137,2291,1957
0130-001,2018,9,23,11,1483,1315,2798,2291
0130-001,2018,9,23,12,1361,1243,2604,2798
0130-001,2018,9,23,13,1443,1242,2685,2604
0130-001,2018,9,23,14,1326,1187,2513,2685
0130-001,2018,9,23,15,1305,1136,2441,2513
0130-001,2018,9,23,16,1189,1293,2482,2441
0130-001,2018,9,23,17,1189,1231,2420,2482
0130-001,2018,9,23,18,1068,1105,2173,2420
0130-001,2018,9,23,19,930,1025,1955,2173
0130-001,2018,9,23,20,804,865,1669,1955
0130-001,2018,9,23,21,715,816,1531,1669
0130-001,2018,9,23,22,460,628,1088,1531
0130-001,2018,9,23,23,388,409,797,1088
0130-001,2018,9,23,24,315,284,599,797
0130-001,2018,9,24,1,251,218,469,599
0130-001,2018,9,24,2,165,132,297,469
0130-001,2018,9,24,3,119,95,214,297
0130-001,2018,9,24,4,121,90,211,214
0130-001,2018,9,24,5,104,76,180,211
0130-001,2018,9,24,6,179,165,344,180
0130-001,2018,9,24,7,562,414,976,344
0130-001,2018,9,24,8,1143,705,1848,976
0130-001,2018,9,24,9,945,795,1740,1848
0130-001,2018,9,24,10,858,955,1813,1740
0130-001,2018,9,24,11,1243,1462,2705,1813
0130-001,2018,9,24,12,1653,1947,3600,2705
0130-001,2018,9,24,13,1882,2064,3946,3600
0130-001,2018,9,24,14,1811,1946,3757,3946
0130-001,2018,9,24,15,1765,1958,3723,3757
0130-001,2018,9,24,16,1787,1721,3508,3723
0130-001,2018,9,24,17,1754,1478,3232,3508
0130-001,2018,9,24,18,1742,1605,3347,3232
0130-001,2018,9,24,19,1702,1524,3226,3347
0130-001,2018,9,24,20,1585,1050,2635,3226
0130-001,2018,9,24,21,1396,960,2356,2635
0130-001,2018,9,24,22,1368,792,2160,2356
0130-001,2018,9,24,23,851,534,1385,2160
0130-001,2018,9,24,24,622,357,979,1385
0130-001,2018,9,25,1,459,255,714,979
0130-001,2018,9,25,2,275,160,435,714
0130-001,2018,9,25,3,179,109,288,435
0130-001,2018,9,25,4,140,94,234,288
0130-001,2018,9,25,5,177,103,280,234
0130-001,2018,9,25,6,206,156,362,280
0130-001,2018,9,25,7,406,248,654,362
0130-001,2018,9,25,8,453,332,785,654
0130-001,2018,9,25,9,592,504,1096,785
0130-001,2018,9,25,10,774,714,1488,1096
0130-001,2018,9,25,11,955,929,1884,1488
0130-001,2018,9,25,12,1247,1184,2431,1884
0130-001,2018,9,25,13,1296,1124,2420,2431
0130-001,2018,9,25,14,1468,1271,2739,2420
0130-001,2018,9,25,15,1710,1278,2988,2739
0130-001,2018,9,25,16,1842,1369,3211,2988
0130-001,2018,9,25,17,1908,1302,3210,3211
0130-001,2018,9,25,18,1790,1264,3054,3210
0130-001,2018,9,25,19,1766,1188,2954,3054
0130-001,2018,9,25,20,1596,950,2546,2954
0130-001,2018,9,25,21,1175,941,2116,2546
0130-001,2018,9,25,22,1188,716,1904,2116
0130-001,2018,9,25,23,1053,596,1649,1904
0130-001,2018,9,25,24,832,412,1244,1649
0130-001,2018,9,26,1,628,306,934,1244
0130-001,2018,9,26,2,470,212,682,934
0130-001,2018,9,26,3,267,196,463,682
0130-001,2018,9,26,4,199,144,343,463
0130-001,2018,9,26,5,226,146,372,343
0130-001,2018,9,26,6,294,269,563,372
0130-001,2018,9,26,7,555,385,940,563
0130-001,2018,9,26,8,761,506,1267,940
0130-001,2018,9,26,9,810,727,1537,1267
0130-001,2018,9,26,10,951,867,1818,1537
0130-001,2018,9,26,11,1133,1164,2297,1818
0130-001,2018,9,26,12,1210,1289,2499,2297
0130-001,2018,9,26,13,1222,1337,2559,2499
0130-001,2018,9,26,14,1361,1527,2888,2559
0130-001,2018,9,26,15,1406,1530,2936,2888
0130-001,2018,9,26,16,1511,1527,3038,2936
0130-001,2018,9,26,17,1460,1451,2911,3038
0130-001,2018,9,26,18,1462,1499,2961,2911
0130-001,2018,9,26,19,1424,1425,2849,2961
0130-001,2018,9,26,20,1186,1151,2337,2849
0130-001,2018,9,26,21,1065,1009,2074,2337
0130-001,2018,9,26,22,924,754,1678,2074
0130-001,2018,9,26,23,621,570,1191,1678
0130-001,2018,9,26,24,415,342,757,1191
0130-001,2018,9,27,1,280,233,513,757
0130-001,2018,9,27,2,204,150,354,513
0130-001,2018,9,27,3,146,139,285,354
0130-001,2018,9,27,4,138,156,294,285
0130-001,2018,9,27,5,299,231,530,294
0130-001,2018,9,27,6,686,379,1065,530
0130-001,2018,9,27,7,1586,787,2373,1065
0130-001,2018,9,27,8,1949,1516,3465,2373
0130-001,2018,9,27,9,1812,1845,3657,3465
0130-001,2018,9,27,10,1736,1603,3339,3657
0130-001,2018,9,27,11,1600,1565,3165,3339
0130-001,2018,9,27,12,1560,1534,3094,3165
0130-001,2018,9,27,13,1438,1431,2869,3094
0130-001,2018,9,27,14,1663,1696,3359,2869
0130-001,2018,9,27,15,1711,1750,3461,3359
0130-001,2018,9,27,16,1738,1827,3565,3461
0130-001,2018,9,27,17,1707,1963,3670,3565
0130-001,2018,9,27,18,1742,2250,3992,3670
0130-001,2018,9,27,19,1727,2365,4092,3992
0130-001,2018,9,27,20,1254,1791,3045,4092
0130-001,2018,9,27,21,1008,1595,2603,3045
0130-001,2018,9,27,22,912,1076,1988,2603
0130-001,2018,9,27,23,692,713,1405,1988
0130-001,2018,9,27,24,461,411,872,1405
0130-001,2018,9,28,1,357,313,670,872
0130-001,2018,9,28,2,204,197,401,670
0130-001,2018,9,28,3,168,159,327,401
0130-001,2018,9,28,4,153,186,339,327
0130-001,2018,9,28,5,297,262,559,339
0130-001,2018,9,28,6,630,435,1065,559
0130-001,2018,9,28,7,1669,797,2466,1065
0130-001,2018,9,28,8,1973,1531,3504,2466
0130-001,2018,9,28,9,1947,1849,3796,3504
0130-001,2018,9,28,10,1658,1631,3289,3796
0130-001,2018,9,28,11,1750,1674,3424,3289
0130-001,2018,9,28,12,1635,1677,3312,3424
0130-001,2018,9,28,13,1481,1502,2983,3312
0130-001,2018,9,28,14,1701,1769,3470,2983
0130-001,2018,9,28,15,1758,1712,3470,3470
0130-001,2018,9,28,16,1822,1832,3654,3470
0130-001,2018,9,28,17,1665,2006,3671,3654
0130-001,2018,9,28,18,1765,2264,4029,3671
0130-001,2018,9,28,19,1815,2318,4133,4029
0130-001,2018,9,28,20,1315,1950,3265,4133
0130-001,2018,9,28,21,1067,1703,2770,3265
0130-001,2018,9,28,22,965,1118,2083,2770
0130-001,2018,9,28,23,755,809,1564,2083
0130-001,2018,9,28,24,583,548,1131,1564
0130-001,2018,9,29,1,461,396,857,1131
0130-001,2018,9,29,2,327,314,641,857
0130-001,2018,9,29,3,254,233,487,641
0130-001,2018,9,29,4,215,226,441,487
0130-001,2018,9,29,5,355,303,658,441
0130-001,2018,9,29,6,581,412,993,658
0130-001,2018,9,29,7,1171,706,1877,993
0130-001,2018,9,29,8,1416,1076,2492,1877
0130-001,2018,9,29,9,1499,1520,3019,2492
0130-001,2018,9,29,10,1488,1630,3118,3019
0130-001,2018,9,29,11,1436,1663,3099,3118
0130-001,2018,9,29,12,1544,1706,3250,3099
0130-001,2018,9,29,13,1564,1692,3256,3250
0130-001,2018,9,29,14,1624,1799,3423,3256
0130-001,2018,9,29,15,1661,1693,3354,3423
0130-001,2018,9,29,16,1569,1818,3387,3354
0130-001,2018,9,29,17,1658,1910,3568,3387
0130-001,2018,9,29,18,1794,2098,3892,3568
0130-001,2018,9,29,19,1630,1895,3525,3892
0130-001,2018,9,29,20,1290,1356,2646,3525
0130-001,2018,9,29,21,1030,1054,2084,2646
0130-001,2018,9,29,22,894,832,1726,2084
0130-001,2018,9,29,23,669,595,1264,1726
0130-001,2018,9,29,24,481,449,930,1264
0130-001,2018,9,30,1,376,330,706,930
0130-001,2018,9,30,2,278,248,526,706
0130-001,2018,9,30,3,234,197,431,526
0130-001,2018,9,30,4,188,168,356,431
0130-001,2018,9,30,5,228,178,406,356
0130-001,2018,9,30,6,362,295,657,406
0130-001,2018,9,30,7,680,439,1119,657
0130-001,2018,9,30,8,709,618,1327,1119
0130-001,2018,9,30,9,816,892,1708,1327
0130-001,2018,9,30,10,1019,1050,2069,1708
0130-001,2018,9,30,11,1277,1272,2549,2069
0130-001,2018,9,30,12,1096,1314,2410,2549
0130-001,2018,9,30,13,1287,1371,2658,2410
0130-001,2018,9,30,14,1451,1497,2948,2658
0130-001,2018,9,30,15,1509,1538,3047,2948
0130-001,2018,9,30,16,1555,1628,3183,3047
0130-001,2018,9,30,17,1596,1640,3236,3183
0130-001,2018,9,30,18,1517,1735,3252,3236
0130-001,2018,9,30,19,1478,1442,2920,3252
0130-001,2018,9,30,20,1249,1141,2390,2920
0130-001,2018,9,30,21,1075,998,2073,2390
0130-001,2018,9,30,22,927,704,1631,2073
0130-001,2018,9,30,23,521,480,1001,1631
0130-001,2018,9,30,24,366,343,709,1001
0130-001,2018,10,1,1,240,227,467,709
0130-001,2018,10,1,2,166,145,311,467
0130-001,2018,10,1,3,129,113,242,311
0130-001,2018,10,1,4,121,152,273,242
0130-001,2018,10,1,5,305,197,502,273
0130-001,2018,10,1,6,698,428,1126,502
0130-001,2018,10,1,7,1682,825,2507,1126
0130-001,2018,10,1,8,1860,1604,3464,2507
0130-001,2018,10,1,9,1906,1881,3787,3464
0130-001,2018,10,1,10,1717,1530,3247,3787
0130-001,2018,10,1,11,1681,1567,3248,3247
0130-001,2018,10,1,12,1473,1463,2936,3248
0130-001,2018,10,1,13,1435,1452,2887,2936
0130-001,2018,10,1,14,1568,1686,3254,2887
0130-001,2018,10,1,15,1674,1665,3339,3254
0130-001,2018,10,1,16,1663,1815,3478,3339
0130-001,2018,10,1,17,1643,1952,3595,3478
0130-001,2018,10,1,18,1725,2053,3778,3595
0130-001,2018,10,1,19,1662,2240,3902,3778
0130-001,2018,10,1,20,1224,1891,3115,3902
0130-001,2018,10,1,21,1030,1600,2630,3115
0130-001,2018,10,1,22,911,1078,1989,2630
0130-001,2018,10,1,23,675,655,1330,1989
0130-001,2018,10,1,24,420,401,821,1330
0130-001,2018,10,2,1,288,321,609,821
0130-001,2018,10,2,2,206,174,380,609
0130-001,2018,10,2,3,152,173,325,380
0130-001,2018,10,2,4,150,158,308,325
0130-001,2018,10,2,5,264,258,522,308
0130-001,2018,10,2,6,621,412,1033,522
0130-001,2018,10,2,7,1701,832,2533,1033
0130-001,2018,10,2,8,1893,1494,3387,2533
0130-001,2018,10,2,9,1907,1957,3864,3387
0130-001,2018,10,2,10,1744,1611,3355,3864
0130-001,2018,10,2,11,1648,1620,3268,3355
0130-001,2018,10,2,12,1556,1502,3058,3268
0130-001,2018,10,2,13,1425,1469,2894,3058
0130-001,2018,10,2,14,1730,1685,3415,2894
0130-001,2018,10,2,15,1773,1692,3465,3415
0130-001,2018,10,2,16,1691,1878,3569,3465
0130-001,2018,10,2,17,1656,2052,3708,3569
0130-001,2018,10,2,18,1799,2279,4078,3708
0130-001,2018,10,2,19,1736,2265,4001,4078
0130-001,2018,10,2,20,1394,2089,3483,4001
0130-001,2018,10,2,21,1068,1748,2816,3483
0130-001,2018,10,2,22,1022,1187,2209,2816
0130-001,2018,10,2,23,821,787,1608,2209
0130-001,2018,10,2,24,552,538,1090,1608
0130-001,2018,10,3,1,444,408,852,1090
0130-001,2018,10,3,2,287,273,560,852
0130-001,2018,10,3,3,227,224,451,560
0130-001,2018,10,3,4,198,207,405,451
0130-001,2018,10,3,5,270,245,515,405
0130-001,2018,10,3,6,584,349,933,515
0130-001,2018,10,3,7,1260,624,1884,933
0130-001,2018,10,3,8,1459,987,2446,1884
0130-001,2018,10,3,9,1379,1149,2528,2446
0130-001,2018,10,3,10,1401,1304,2705,2528
0130-001,2018,10,3,11,1414,1404,2818,2705
0130-001,2018,10,3,12,1477,1487,2964,2818
0130-001,2018,10,3,13,1438,1452,2890,2964
0130-001,2018,10,3,14,1475,1551,3026,2890
0130-001,2018,10,3,15,1536,1629,3165,3026
0130-001,2018,10,3,16,1552,1729,3281,3165
0130-001,2018,10,3,17,1556,1856,3412,3281
0130-001,2018,10,3,18,1600,2204,3804,3412
0130-001,2018,10,3,19,1485,1974,3459,3804
0130-001,2018,10,3,20,1234,1363,2597,3459
0130-001,2018,10,3,21,990,1078,2068,2597
0130-001,2018,10,3,22,940,818,1758,2068
0130-001,2018,10,3,23,609,567,1176,1758
0130-001,2018,10,3,24,424,370,794,1176
0130-001,2018,10,4,1,266,262,528,794
0130-001,2018,10,4,2,190,162,352,528
0130-001,2018,10,4,3,165,158,323,352
0130-001,2018,10,4,4,137,167,304,323
0130-001,2018,10,4,5,231,238,469,304
0130-001,2018,10,4,6,672,414,1086,469
0130-001,2018,10,4,7,1788,813,2601,1086
0130-001,2018,10,4,8,1966,1559,3525,2601
0130-001,2018,10,4,9,1938,1953,3891,3525
0130-001,2018,10,4,10,1831,1609,3440,3891
0130-001,2018,10,4,11,1793,1619,3412,3440
0130-001,2018,10,4,12,1648,1619,3267,3412
0130-001,2018,10,4,13,1453,1515,2968,3267
0130-001,2018,10,4,14,1839,1702,3541,2968
0130-001,2018,10,4,15,1721,1775,3496,3541
0130-001,2018,10,4,16,1717,1878,3595,3496
0130-001,2018,10,4,17,1644,2034,3678,3595
0130-001,2018,10,4,18,1748,2258,4006,3678
0130-001,2018,10,4,19,1676,2292,3968,4006
0130-001,2018,10,4,20,1308,2045,3353,3968
0130-001,2018,10,4,21,1089,1648,2737,3353
0130-001,2018,10,4,22,1010,1159,2169,2737
0130-001,2018,10,4,23,744,783,1527,2169
0130-001,2018,10,4,24,511,478,989,1527
0130-001,2018,10,5,1,383,347,730,989
0130-001,2018,10,5,2,226,235,461,730
0130-001,2018,10,5,3,172,182,354,461
0130-001,2018,10,5,4,188,182,370,354
0130-001,2018,10,5,5,239,237,476,370
0130-001,2018,10,5,6,556,367,923,476
0130-001,2018,10,5,7,1539,774,2313,923
0130-001,2018,10,5,8,1782,1495,3277,2313
0130-001,2018,10,5,9,1675,1782,3457,3277
0130-001,2018,10,5,10,1664,1629,3293,3457
0130-001,2018,10,5,11,1616,1559,3175,3293
0130-001,2018,10,5,12,1438,1629,3067,3175
0130-001,2018,10,5,13,1350,1544,2894,3067
0130-001,2018,10,5,14,1614,1643,3257,2894
0130-001,2018,10,5,15,1607,1648,3255,3257
0130-001,2018,10,5,16,1664,1728,3392,3255
0130-001,2018,10,5,17,1660,1939,3599,3392
0130-001,2018,10,5,18,1872,2049,3921,3599
0130-001,2018,10,5,19,1845,2136,3981,3921
0130-001,2018,10,5,20,1330,1902,3232,3981
0130-001,2018,10,5,21,1100,1689,2789,3232
0130-001,2018,10,5,22,999,1089,2088,2789
0130-001,2018,10,5,23,722,688,1410,2088
0130-001,2018,10,5,24,556,501,1057,1410
0130-001,2018,10,6,1,387,342,729,1057
0130-001,2018,10,6,2,265,274,539,729
0130-001,2018,10,6,3,219,197,416,539
0130-001,2018,10,6,4,171,187,358,416
0130-001,2018,10,6,5,202,212,414,358
0130-001,2018,10,6,6,360,314,674,414
0130-001,2018,10,6,7,755,494,1249,674
0130-001,2018,10,6,8,1148,893,2041,1249
0130-001,2018,10,6,9,1297,1380,2677,2041
0130-001,2018,10,6,10,1395,1450,2845,2677
0130-001,2018,10,6,11,1414,1481,2895,2845
0130-001,2018,10,6,12,1551,1281,2832,2895
0130-001,2018,10,6,13,1479,1677,3156,2832
0130-001,2018,10,6,14,1648,1683,3331,3156
0130-001,2018,10,6,15,1765,1734,3499,3331
0130-001,2018,10,6,16,1780,1765,3545,3499
0130-001,2018,10,6,17,1749,1919,3668,3545
0130-001,2018,10,6,18,1734,1898,3632,3668
0130-001,2018,10,6,19,1624,1717,3341,3632
0130-001,2018,10,6,20,1250,1219,2469,3341
0130-001,2018,10,6,21,973,932,1905,2469
0130-001,2018,10,6,22,839,780,1619,1905
0130-001,2018,10,6,23,726,556,1282,1619
0130-001,2018,10,6,24,468,448,916,1282
0130-001,2018,10,7,1,365,336,701,916
0130-001,2018,10,7,2,275,243,518,701
0130-001,2018,10,7,3,231,177,408,518
0130-001,2018,10,7,4,188,166,354,408
0130-001,2018,10,7,5,243,162,405,354
0130-001,2018,10,7,6,357,258,615,405
0130-001,2018,10,7,7,660,473,1133,615
0130-001,2018,10,7,8,724,701,1425,1133
0130-001,2018,10,7,9,992,1016,2008,1425
0130-001,2018,10,7,10,1091,1102,2193,2008
0130-001,2018,10,7,11,1414,1361,2775,2193
0130-001,2018,10,7,12,1388,1377,2765,2775
0130-001,2018,10,7,13,1436,1447,2883,2765
0130-001,2018,10,7,14,1541,1480,3021,2883
0130-001,2018,10,7,15,1606,1632,3238,3021
0130-001,2018,10,7,16,1692,1625,3317,3238
0130-001,2018,10,7,17,1691,1767,3458,3317
0130-001,2018,10,7,18,1614,1794,3408,3458
0130-001,2018,10,7,19,1506,1619,3125,3408
0130-001,2018,10,7,20,1278,1244,2522,3125
0130-001,2018,10,7,21,985,916,1901,2522
0130-001,2018,10,7,22,898,797,1695,1901
0130-001,2018,10,7,23,619,553,1172,1695
0130-001,2018,10,7,24,399,308,707,1172
0130-001,2018,10,8,1,270,252,522,707
0130-001,2018,10,8,2,160,143,303,522
0130-001,2018,10,8,3,133,121,254,303
0130-001,2018,10,8,4,137,137,274,254
0130-001,2018,10,8,5,278,224,502,274
0130-001,2018,10,8,6,659,389,1048,502
0130-001,2018,10,8,7,1702,770,2472,1048
0130-001,2018,10,8,8,1857,1427,3284,2472
0130-001,2018,10,8,9,1739,1747,3486,3284
0130-001,2018,10,8,10,1683,1564,3247,3486
0130-001,2018,10,8,11,1746,1664,3410,3247
0130-001,2018,10,8,12,1622,1608,3230,3410
0130-001,2018,10,8,13,1519,1610,3129,3230
0130-001,2018,10,8,14,1628,1781,3409,3129
0130-001,2018,10,8,15,1735,1730,3465,3409
0130-001,2018,10,8,16,1844,1912,3756,3465
0130-001,2018,10,8,17,1740,2039,3779,3756
0130-001,2018,10,8,18,1814,2208,4022,3779
0130-001,2018,10,8,19,1753,2311,4064,4022
0130-001,2018,10,8,20,1276,1975,3251,4064
0130-001,2018,10,8,21,1123,1635,2758,3251
0130-001,2018,10,8,22,993,1100,2093,2758
0130-001,2018,10,8,23,722,776,1498,2093
0130-001,2018,10,8,24,558,448,1006,1498
0130-001,2018,10,9,1,397,369,766,1006
0130-001,2018,10,9,2,279,267,546,766
0130-001,2018,10,9,3,221,209,430,546
0130-001,2018,10,9,4,208,229,437,430
0130-001,2018,10,9,5,274,244,518,437
0130-001,2018,10,9,6,608,330,938,518
0130-001,2018,10,9,7,1199,618,1817,938
0130-001,2018,10,9,8,1581,922,2503,1817
0130-001,2018,10,9,9,1274,1086,2360,2503
0130-001,2018,10,9,10,1378,1220,2598,2360
0130-001,2018,10,9,11,1446,1416,2862,2598
0130-001,2018,10,9,12,1460,1483,2943,2862
0130-001,2018,10,9,13,1400,1448,2848,2943
0130-001,2018,10,9,14,1452,1643,3095,2848
0130-001,2018,10,9,15,1513,1577,3090,3095
0130-001,2018,10,9,16,1503,1680,3183,3090
0130-001,2018,10,9,17,1484,1821,3305,3183
0130-001,2018,10,9,18,1668,1996,3664,3305
0130-001,2018,10,9,19,1437,1897,3334,3664
0130-001,2018,10,9,20,1192,1325,2517,3334
0130-001,2018,10,9,21,1002,1100,2102,2517
0130-001,2018,10,9,22,841,801,1642,2102
0130-001,2018,10,9,23,599,549,1148,1642
0130-001,2018,10,9,24,401,341,742,1148
0130-001,2018,10,10,1,260,280,540,742
0130-001,2018,10,10,2,155,142,297,540
0130-001,2018,10,10,3,126,137,263,297
0130-001,2018,10,10,4,101,120,221,263
0130-001,2018,10,10,5,190,181,371,221
0130-001,2018,10,10,6,501,303,804,371
0130-001,2018,10,10,7,1398,667,2065,804
0130-001,2018,10,10,8,1737,1482,3219,2065
0130-001,2018,10,10,9,1929,1833,3762,3219
0130-001,2018,10,10,10,1826,1566,3392,3762
0130-001,2018,10,10,11,1755,1690,3445,3392
0130-001,2018,10,10,12,1594,1622,3216,3445
0130-001,2018,10,10,13,1481,1532,3013,3216
0130-001,2018,10,10,14,1771,1744,3515,3013
0130-001,2018,10,10,15,1786,1803,3589,3515
0130-001,2018,10,10,16,1772,1904,3676,3589
0130-001,2018,10,10,17,1585,2049,3634,3676
0130-001,2018,10,10,18,1736,2283,4019,3634
0130-001,2018,10,10,19,1679,2274,3953,4019
0130-001,2018,10,10,20,1284,1958,3242,3953
0130-001,2018,10,10,21,1064,1549,2613,3242
0130-001,2018,10,10,22,1042,1093,2135,2613
0130-001,2018,10,10,23,735,734,1469,2135
0130-001,2018,10,10,24,426,449,875,1469
0130-001,2018,10,11,1,322,314,636,875
0130-001,2018,10,11,2,215,193,408,636
0130-001,2018,10,11,3,138,158,296,408
0130-001,2018,10,11,4,183,197,380,296
0130-001,2018,10,11,5,250,246,496,380
0130-001,2018,10,11,6,636,378,1014,496
0130-001,2018,10,11,7,1756,840,2596,1014
0130-001,2018,10,11,8,1872,1503,3375,2596
0130-001,2018,10,11,9,1984,1894,3878,3375
0130-001,2018,10,11,10,1817,1602,3419,3878
0130-001,2018,10,11,11,1762,1645,3407,3419
0130-001,2018,10,11,12,1668,1670,3338,3407
0130-001,2018,10,11,13,1446,1497,2943,3338
0130-001,2018,10,11,14,1729,1645,3374,2943
0130-001,2018,10,11,15,1708,1729,3437,3374
0130-001,2018,10,11,16,1736,1797,3533,3437
0130-001,2018,10,11,17,1654,2068,3722,3533
0130-001,2018,10,11,18,1700,2228,3928,3722
0130-001,2018,10,11,19,1598,2255,3853,3928
0130-001,2018,10,11,20,1262,1942,3204,3853
0130-001,2018,10,11,21,981,1707,2688,3204
0130-001,2018,10,11,22,1003,1160,2163,2688
0130-001,2018,10,11,23,784,732,1516,2163
0130-001,2018,10,11,24,467,461,928,1516
0130-001,2018,10,12,1,323,308,631,928
0130-001,2018,10,12,2,199,196,395,631
0130-001,2018,10,12,3,193,192,385,395
0130-001,2018,10,12,4,152,164,316,385
0130-001,2018,10,12,5,266,278,544,316
0130-001,2018,10,12,6,616,359,975,544
0130-001,2018,10,12,7,1691,823,2514,975
0130-001,2018,10,12,8,1907,1525,3432,2514
0130-001,2018,10,12,9,1919,1913,3832,3432
0130-001,2018,10,12,10,1781,1687,3468,3832
0130-001,2018,10,12,11,1742,1662,3404,3468
0130-001,2018,10,12,12,1688,1702,3390,3404
0130-001,2018,10,12,13,1456,1575,3031,3390
0130-001,2018,10,12,14,1708,1790,3498,3031
0130-001,2018,10,12,15,1754,1857,3611,3498
0130-001,2018,10,12,16,1866,1891,3757,3611
0130-001,2018,10,12,17,1857,2171,4028,3757
0130-001,2018,10,12,18,1852,2355,4207,4028
0130-001,2018,10,12,19,1643,2207,3850,4207
0130-001,2018,10,12,20,1349,2123,3472,3850
0130-001,2018,10,12,21,1191,1743,2934,3472
0130-001,2018,10,12,22,1017,1172,2189,2934
0130-001,2018,10,12,23,880,783,1663,2189
0130-001,2018,10,12,24,589,535,1124,1663
0130-001,2018,10,13,1,450,380,830,1124
0130-001,2018,10,13,2,279,300,579,830
0130-001,2018,10,13,3,240,210,450,579
0130-001,2018,10,13,4,205,217,422,450
0130-001,2018,10,13,5,270,283,553,422
0130-001,2018,10,13,6,586,383,969,553
0130-001,2018,10,13,7,1190,667,1857,969
0130-001,2018,10,13,8,1495,1165,2660,1857
0130-001,2018,10,13,9,1696,1746,3442,2660
0130-001,2018,10,13,10,1732,1839,3571,3442
0130-001,2018,10,13,11,1764,1856,3620,3571
0130-001,2018,10,13,12,1788,1818,3606,3620
0130-001,2018,10,13,13,1686,1821,3507,3606
0130-001,2018,10,13,14,1862,1862,3724,3507
0130-001,2018,10,13,15,1715,1800,3515,3724
0130-001,2018,10,13,16,1725,1781,3506,3515
0130-001,2018,10,13,17,1698,1985,3683,3506
0130-001,2018,10,13,18,1839,2051,3890,3683
0130-001,2018,10,13,19,1687,2042,3729,3890
0130-001,2018,10,13,20,1339,1378,2717,3729
0130-001,2018,10,13,21,1084,1136,2220,2717
0130-001,2018,10,13,22,908,803,1711,2220
0130-001,2018,10,13,23,694,678,1372,1711
0130-001,2018,10,13,24,504,454,958,1372
0130-001,2018,10,14,1,388,377,765,958
0130-001,2018,10,14,2,289,243,532,765
0130-001,2018,10,14,3,238,180,418,532
0130-001,2018,10,14,4,171,186,357,418
0130-001,2018,10,14,5,214,188,402,357
0130-001,2018,10,14,6,372,263,635,402
0130-001,2018,10,14,7,670,414,1084,635
0130-001,2018,10,14,8,724,645,1369,1084
0130-001,2018,10,14,9,870,887,1757,1369
0130-001,2018,10,14,10,1087,1067,2154,1757
0130-001,2018,10,14,11,1353,1235,2588,2154
0130-001,2018,10,14,12,1265,1318,2583,2588
0130-001,2018,10,14,13,1315,1287,2602,2583
0130-001,2018,10,14,14,1417,1404,2821,2602
0130-001,2018,10,14,15,1443,1493,2936,2821
0130-001,2018,10,14,16,1493,1657,3150,2936
0130-001,2018,10,14,17,1444,1659,3103,3150
0130-001,2018,10,14,18,1539,1661,3200,3103
0130-001,2018,10,14,19,1496,1464,2960,3200
0130-001,2018,10,14,20,1269,1152,2421,2960
0130-001,2018,10,14,21,1078,952,2030,2421
0130-001,2018,10,14,22,847,774,1621,2030
0130-001,2018,10,14,23,578,552,1130,1621
0130-001,2018,10,14,24,436,361,797,1130
0130-001,2018,10,15,1,217,235,452,797
0130-001,2018,10,15,2,178,118,296,452
0130-001,2018,10,15,3,129,122,251,296
0130-001,2018,10,15,4,142,122,264,251
0130-001,2018,10,15,5,252,256,508,264
0130-001,2018,10,15,6,715,388,1103,508
0130-001,2018,10,15,7,1815,865,2680,1103
0130-001,2018,10,15,8,1899,1537,3436,2680
0130-001,2018,10,15,9,1979,1880,3859,3436
0130-001,2018,10,15,10,1830,1623,3453,3859
0130-001,2018,10,15,11,1789,1650,3439,3453
0130-001,2018,10,15,12,1794,1573,3367,3439
0130-001,2018,10,15,13,1559,1406,2965,3367
0130-001,2018,10,15,14,1797,1845,3642,2965
0130-001,2018,10,15,15,1710,1716,3426,3642
0130-001,2018,10,15,16,1794,1846,3640,3426
0130-001,2018,10,15,17,1642,2053,3695,3640
0130-001,2018,10,15,18,1781,2295,4076,3695
0130-001,2018,10,15,19,1723,2275,3998,4076
0130-001,2018,10,15,20,1248,1906,3154,3998
0130-001,2018,10,15,21,1035,1652,2687,3154
0130-001,2018,10,15,22,962,1137,2099,2687
0130-001,2018,10,15,23,674,690,1364,2099
0130-001,2018,10,15,24,475,431,906,1364
0130-001,2018,10,16,1,297,313,610,906
0130-001,2018,10,16,2,183,174,357,610
0130-001,2018,10,16,3,137,167,304,357
0130-001,2018,10,16,4,160,170,330,304
0130-001,2018,10,16,5,268,262,530,330
0130-001,2018,10,16,6,692,419,1111,530
0130-001,2018,10,16,7,1660,793,2453,1111
0130-001,2018,10,16,8,1929,1505,3434,2453
0130-001,2018,10,16,9,1954,1861,3815,3434
0130-001,2018,10,16,10,1780,1614,3394,3815
0130-001,2018,10,16,11,1748,1637,3385,3394
0130-001,2018,10,16,12,1599,1565,3164,3385
0130-001,2018,10,16,13,1387,1432,2819,3164
0130-001,2018,10,16,14,1692,1694,3386,2819
0130-001,2018,10,16,15,1786,1728,3514,3386
0130-001,2018,10,16,16,1716,1860,3576,3514
0130-001,2018,10,16,17,1622,2032,3654,3576
0130-001,2018,10,16,18,1655,2300,3955,3654
0130-001,2018,10,16,19,1631,2287,3918,3955
0130-001,2018,10,16,20,1229,1919,3148,3918
0130-001,2018,10,16,21,1029,1595,2624,3148
0130-001,2018,10,16,22,941,1132,2073,2624
0130-001,2018,10,16,23,1044,718,1762,2073
0130-001,2018,10,16,24,570,423,993,1762
0130-001,2018,10,17,1,341,305,646,993
0130-001,2018,10,17,2,208,182,390,646
0130-001,2018,10,17,3,147,168,315,390
0130-001,2018,10,17,4,143,172,315,315
0130-001,2018,10,17,5,245,229,474,315
0130-001,2018,10,17,6,678,382,1060,474
0130-001,2018,10,17,7,1697,809,2506,1060
0130-001,2018,10,17,8,1921,1574,3495,2506
0130-001,2018,10,17,9,2009,1911,3920,3495
0130-001,2018,10,17,10,1869,1590,3459,3920
0130-001,2018,10,17,11,1759,1642,3401,3459
0130-001,2018,10,17,12,1674,1694,3368,3401
0130-001,2018,10,17,13,1619,1657,3276,3368
0130-001,2018,10,17,14,1790,1756,3546,3276
0130-001,2018,10,17,15,1768,1851,3619,3546
0130-001,2018,10,17,16,1691,1826,3517,3619
0130-001,2018,10,17,17,1760,2053,3813,3517
0130-001,2018,10,17,18,1826,2310,4136,3813
0130-001,2018,10,17,19,1753,2261,4014,4136
0130-001,2018,10,17,20,1308,1975,3283,4014
0130-001,2018,10,17,21,1052,1519,2571,3283
0130-001,2018,10,17,22,1068,1155,2223,2571
0130-001,2018,10,17,23,1031,735,1766,2223
0130-001,2018,10,17,24,744,466,1210,1766
0130-001,2018,10,18,1,420,326,746,1210
0130-001,2018,10,18,2,226,214,440,746
0130-001,2018,10,18,3,156,170,326,440
0130-001,2018,10,18,4,159,189,348,326
0130-001,2018,10,18,5,275,240,515,348
0130-001,2018,10,18,6,775,453,1228,515
0130-001,2018,10,18,7,1784,800,2584,1228
0130-001,2018,10,18,8,1909,1524,3433,2584
0130-001,2018,10,18,9,1961,1949,3910,3433
0130-001,2018,10,18,10,1749,1661,3410,3910
0130-001,2018,10,18,11,1773,1713,3486,3410
0130-001,2018,10,18,12,1678,1630,3308,3486
0130-001,2018,10,18,13,1451,1470,2921,3308
0130-001,2018,10,18,14,1763,1778,3541,2921
0130-001,2018,10,18,15,1833,1844,3677,3541
0130-001,2018,10,18,16,1722,1885,3607,3677
0130-001,2018,10,18,17,1579,2006,3585,3607
0130-001,2018,10,18,18,1779,2210,3989,3585
0130-001,2018,10,18,19,1640,2202,3842,3989
0130-001,2018,10,18,20,1351,1870,3221,3842
0130-001,2018,10,18,21,1091,1601,2692,3221
0130-001,2018,10,18,22,1020,1115,2135,2692
0130-001,2018,10,18,23,716,719,1435,2135
0130-001,2018,10,18,24,506,442,948,1435
0130-001,2018,10,19,1,365,281,646,948
0130-001,2018,10,19,2,174,206,380,646
0130-001,2018,10,19,3,168,182,350,380
0130-001,2018,10,19,4,151,169,320,350
0130-001,2018,10,19,5,245,267,512,320
0130-001,2018,10,19,6,711,406,1117,512
0130-001,2018,10,19,7,1704,800,2504,1117
0130-001,2018,10,19,8,1910,1507,3417,2504
0130-001,2018,10,19,9,1992,1868,3860,3417
0130-001,2018,10,19,10,1866,1591,3457,3860
0130-001,2018,10,19,11,1761,1753,3514,3457
0130-001,2018,10,19,12,1630,1619,3249,3514
0130-001,2018,10,19,13,1532,1710,3242,3249
0130-001,2018,10,19,14,1898,1917,3815,3242
0130-001,2018,10,19,15,1844,1871,3715,3815
0130-001,2018,10,19,16,1875,2009,3884,3715
0130-001,2018,10,19,17,1820,2143,3963,3884
0130-001,2018,10,19,18,1895,2344,4239,3963
0130-001,2018,10,19,19,1821,2206,4027,4239
0130-001,2018,10,19,20,1428,2097,3525,4027
0130-001,2018,10,19,21,1232,1664,2896,3525
0130-001,2018,10,19,22,1099,1165,2264,2896
0130-001,2018,10,19,23,861,857,1718,2264
0130-001,2018,10,19,24,580,545,1125,1718
0130-001,2018,10,20,1,440,409,849,1125
0130-001,2018,10,20,2,328,267,595,849
0130-001,2018,10,20,3,231,234,465,595
0130-001,2018,10,20,4,171,225,396,465
0130-001,2018,10,20,5,285,273,558,396
0130-001,2018,10,20,6,596,401,997,558
0130-001,2018,10,20,7,1199,689,1888,997
0130-001,2018,10,20,8,1467,1148,2615,1888
0130-001,2018,10,20,9,1738,1577,3315,2615
0130-001,2018,10,20,10,1766,1831,3597,3315
0130-001,2018,10,20,11,1780,1936,3716,3597
0130-001,2018,10,20,12,1811,2101,3912,3716
0130-001,2018,10,20,13,1710,2033,3743,3912
0130-001,2018,10,20,14,1820,1983,3803,3743
0130-001,2018,10,20,15,1819,1810,3629,3803
0130-001,2018,10,20,16,1765,1836,3601,3629
0130-001,2018,10,20,17,1829,1991,3820,3601
0130-001,2018,10,20,18,1818,2066,3884,3820
0130-001,2018,10,20,19,1636,1945,3581,3884
0130-001,2018,10,20,20,1410,1391,2801,3581
0130-001,2018,10,20,21,1155,1113,2268,2801
0130-001,2018,10,20,22,1011,889,1900,2268
0130-001,2018,10,20,23,733,624,1357,1900
0130-001,2018,10,20,24,485,452,937,1357
0130-001,2018,10,21,1,353,360,713,937
0130-001,2018,10,21,2,267,264,531,713
0130-001,2018,10,21,3,223,197,420,531
0130-001,2018,10,21,4,190,181,371,420
0130-001,2018,10,21,5,207,176,383,371
0130-001,2018,10,21,6,352,261,613,383
0130-001,2018,10,21,7,672,436,1108,613
0130-001,2018,10,21,8,753,597,1350,1108
0130-001,2018,10,21,9,899,961,1860,1350
0130-001,2018,10,21,10,1071,1166,2237,1860
0130-001,2018,10,21,11,1336,1473,2809,2237
0130-001,2018,10,21,12,1220,1383,2603,2809
0130-001,2018,10,21,13,1309,1450,2759,2603
0130-001,2018,10,21,14,1514,1554,3068,2759
0130-001,2018,10,21,15,1570,1549,3119,3068
0130-001,2018,10,21,16,1778,1585,3363,3119
0130-001,2018,10,21,17,1710,1675,3385,3363
0130-001,2018,10,21,18,1627,1751,3378,3385
0130-001,2018,10,21,19,1694,1451,3145,3378
0130-001,2018,10,21,20,1328,1264,2592,3145
0130-001,2018,10,21,21,1232,1010,2242,2592
0130-001,2018,10,21,22,952,790,1742,2242
0130-001,2018,10,21,23,765,571,1336,1742
0130-001,2018,10,21,24,408,327,735,1336
0130-001,2018,10,22,1,271,231,502,735
0130-001,2018,10,22,2,144,144,288,502
0130-001,2018,10,22,3,123,118,241,288
0130-001,2018,10,22,4,143,138,281,241
0130-001,2018,10,22,5,274,219,493,281
0130-001,2018,10,22,6,746,428,1174,493
0130-001,2018,10,22,7,1791,803,2594,1174
0130-001,2018,10,22,8,1876,1578,3454,2594
0130-001,2018,10,22,9,1952,1836,3788,3454
0130-001,2018,10,22,10,1775,1562,3337,3788
0130-001,2018,10,22,11,1682,1573,3255,3337
0130-001,2018,10,22,12,1593,1572,3165,3255
0130-001,2018,10,22,13,1430,1486,2916,3165
0130-001,2018,10,22,14,1724,1708,3432,2916
0130-001,2018,10,22,15,1734,1628,3362,3432
0130-001,2018,10,22,16,1735,1808,3543,3362
0130-001,2018,10,22,17,1658,2065,3723,3543
0130-001,2018,10,22,18,1648,2172,3820,3723
0130-001,2018,10,22,19,1843,2433,4276,3820
0130-001,2018,10,22,20,1211,1922,3133,4276
0130-001,2018,10,22,21,1006,1601,2607,3133
0130-001,2018,10,22,22,958,1095,2053,2607
0130-001,2018,10,22,23,782,656,1438,2053
0130-001,2018,10,22,24,546,397,943,1438
0130-001,2018,10,23,1,355,304,659,943
0130-001,2018,10,23,2,206,207,413,659
0130-001,2018,10,23,3,150,170,320,413
0130-001,2018,10,23,4,161,166,327,320
0130-001,2018,10,23,5,246,257,503,327
0130-001,2018,10,23,6,724,392,1116,503
0130-001,2018,10,23,7,1754,830,2584,1116
0130-001,2018,10,23,8,1926,1503,3429,2584
0130-001,2018,10,23,9,1897,1838,3735,3429
0130-001,2018,10,23,10,1795,1601,3396,3735
0130-001,2018,10,23,11,1648,1627,3275,3396
0130-001,2018,10,23,12,1577,1421,2998,3275
0130-001,2018,10,23,13,1445,1466,2911,2998
0130-001,2018,10,23,14,1621,1595,3216,2911
0130-001,2018,10,23,15,1664,1729,3393,3216
0130-001,2018,10,23,16,1591,1781,3372,3393
0130-001,2018,10,23,17,1629,1969,3598,3372
0130-001,2018,10,23,18,1700,2290,3990,3598
0130-001,2018,10,23,19,1715,2260,3975,3990
0130-001,2018,10,23,20,1188,1793,2981,3975
0130-001,2018,10,23,21,1025,1597,2622,2981
0130-001,2018,10,23,22,981,1072,2053,2622
0130-001,2018,10,23,23,852,730,1582,2053
0130-001,2018,10,23,24,580,442,1022,1582
0130-001,2018,10,24,1,297,296,593,1022
0130-001,2018,10,24,2,220,208,428,593
0130-001,2018,10,24,3,146,178,324,428
0130-001,2018,10,24,4,137,162,299,324
0130-001,2018,10,24,5,255,231,486,299
0130-001,2018,10,24,6,689,433,1122,486
0130-001,2018,10,24,7,1704,784,2488,1122
0130-001,2018,10,24,8,1866,1503,3369,2488
0130-001,2018,10,24,9,1958,1846,3804,3369
0130-001,2018,10,24,10,1818,1676,3494,3804
0130-001,2018,10,24,11,1804,1705,3509,3494
0130-001,2018,10,24,12,1589,1588,3177,3509
0130-001,2018,10,24,13,1413,1484,2897,3177
0130-001,2018,10,24,14,1703,1759,3462,2897
0130-001,2018,10,24,15,1755,1736,3491,3462
0130-001,2018,10,24,16,1696,1894,3590,3491
0130-001,2018,10,24,17,1639,2058,3697,3590
0130-001,2018,10,24,18,1771,2324,4095,3697
0130-001,2018,10,24,19,1650,2182,3832,4095
0130-001,2018,10,24,20,1250,1878,3128,3832
0130-001,2018,10,24,21,1064,1412,2476,3128
0130-001,2018,10,24,22,1007,1111,2118,2476
0130-001,2018,10,24,23,768,722,1490,2118
0130-001,2018,10,24,24,541,414,955,1490
0130-001,2018,10,25,1,328,321,649,955
0130-001,2018,10,25,2,205,196,401,649
0130-001,2018,10,25,3,148,182,330,401
0130-001,2018,10,25,4,160,177,337,330
0130-001,2018,10,25,5,302,250,552,337
0130-001,2018,10,25,6,679,420,1099,552
0130-001,2018,10,25,7,1729,789,2518,1099
0130-001,2018,10,25,8,1852,1477,3329,2518
0130-001,2018,10,25,9,1958,1898,3856,3329
0130-001,2018,10,25,10,1797,1654,3451,3856
0130-001,2018,10,25,11,1707,1672,3379,3451
0130-001,2018,10,25,12,1630,1512,3142,3379
0130-001,2018,10,25,13,1497,1533,3030,3142
0130-001,2018,10,25,14,1678,1652,3330,3030
0130-001,2018,10,25,15,1741,1755,3496,3330
0130-001,2018,10,25,16,1700,1876,3576,3496
0130-001,2018,10,25,17,1600,2115,3715,3576
0130-001,2018,10,25,18,1773,2368,4141,3715
0130-001,2018,10,25,19,1635,2310,3945,4141
0130-001,2018,10,25,20,1310,1980,3290,3945
0130-001,2018,10,25,21,1139,1526,2665,3290
0130-001,2018,10,25,22,1052,1153,2205,2665
0130-001,2018,10,25,23,880,728,1608,2205
0130-001,2018,10,25,24,616,491,1107,1608
0130-001,2018,10,26,1,388,347,735,1107
0130-001,2018,10,26,2,236,209,445,735
0130-001,2018,10,26,3,174,185,359,445
0130-001,2018,10,26,4,164,199,363,359
0130-001,2018,10,26,5,261,251,512,363
0130-001,2018,10,26,6,652,395,1047,512
0130-001,2018,10,26,7,1513,813,2326,1047
0130-001,2018,10,26,8,1927,1440,3367,2326
0130-001,2018,10,26,9,1901,1961,3862,3367
0130-001,2018,10,26,10,1697,1550,3247,3862
0130-001,2018,10,26,11,1693,1715,3408,3247
0130-001,2018,10,26,12,1625,1737,3362,3408
0130-001,2018,10,26,13,1473,1572,3045,3362
0130-001,2018,10,26,14,1682,1786,3468,3045
0130-001,2018,10,26,15,1682,1690,3372,3468
0130-001,2018,10,26,16,1721,1832,3553,3372
0130-001,2018,10,26,17,1810,2110,3920,3553
0130-001,2018,10,26,18,1824,2237,4061,3920
0130-001,2018,10,26,19,1793,2070,3863,4061
0130-001,2018,10,26,20,1352,1997,3349,3863
0130-001,2018,10,26,21,1171,1533,2704,3349
0130-001,2018,10,26,22,1068,1090,2158,2704
0130-001,2018,10,26,23,781,823,1604,2158
0130-001,2018,10,26,24,544,470,1014,1604
0130-001,2018,10,27,1,430,380,810,1014
0130-001,2018,10,27,2,288,315,603,810
0130-001,2018,10,27,3,226,219,445,603
0130-001,2018,10,27,4,207,195,402,445
0130-001,2018,10,27,5,282,253,535,402
0130-001,2018,10,27,6,572,353,925,535
0130-001,2018,10,27,7,1080,678,1758,925
0130-001,2018,10,27,8,1379,1081,2460,1758
0130-001,2018,10,27,9,1714,1627,3341,2460
0130-001,2018,10,27,10,1737,1750,3487,3341
0130-001,2018,10,27,11,1682,1935,3617,3487
0130-001,2018,10,27,12,1812,1984,3796,3617
0130-001,2018,10,27,13,1675,1976,3651,3796
0130-001,2018,10,27,14,1742,1807,3549,3651
0130-001,2018,10,27,15,1764,1671,3435,3549
0130-001,2018,10,27,16,1766,1844,3610,3435
0130-001,2018,10,27,17,1824,1919,3743,3610
0130-001,2018,10,27,18,1808,2093,3901,3743
0130-001,2018,10,27,19,1726,1822,3548,3901
0130-001,2018,10,27,20,1387,1249,2636,3548
0130-001,2018,10,27,21,1048,1058,2106,2636
0130-001,2018,10,27,22,886,883,1769,2106
0130-001,2018,10,27,23,696,719,1415,1769
0130-001,2018,10,27,24,497,475,972,1415
0130-001,2018,10,28,1,388,333,721,972
0130-001,2018,10,28,2,280,255,535,721
0130-001,2018,10,28,3,217,162,379,535
0130-001,2018,10,28,4,163,164,327,379
0130-001,2018,10,28,5,206,152,358,327
0130-001,2018,10,28,6,316,280,596,358
0130-001,2018,10,28,7,621,424,1045,596
0130-001,2018,10,28,8,728,636,1364,1045
0130-001,2018,10,28,9,870,886,1756,1364
0130-001,2018,10,28,10,975,1178,2153,1756
0130-001,2018,10,28,11,1195,1299,2494,2153
0130-001,2018,10,28,12,1221,1262,2483,2494
0130-001,2018,10,28,13,1384,1413,2797,2483
0130-001,2018,10,28,14,1510,1579,3089,2797
0130-001,2018,10,28,15,1417,1482,2899,3089
0130-001,2018,10,28,16,1558,1502,3060,2899
0130-001,2018,10,28,17,1559,1547,3106,3060
0130-001,2018,10,28,18,1689,1503,3192,3106
0130-001,2018,10,28,19,1648,1221,2869,3192
0130-001,2018,10,28,20,1304,1059,2363,2869
0130-001,2018,10,28,21,1069,893,1962,2363
0130-001,2018,10,28,22,846,677,1523,1962
0130-001,2018,10,28,23,612,507,1119,1523
0130-001,2018,10,28,24,400,349,749,1119
0130-001,2018,10,29,1,248,205,453,749
0130-001,2018,10,29,2,161,121,282,453
0130-001,2018,10,29,3,124,130,254,282
0130-001,2018,10,29,4,137,145,282,254
0130-001,2018,10,29,5,251,214,465,282
0130-001,2018,10,29,6,723,368,1091,465
0130-001,2018,10,29,7,1708,803,2511,1091
0130-001,2018,10,29,8,1847,1461,3308,2511
0130-001,2018,10,29,9,1912,1898,3810,3308
0130-001,2018,10,29,10,1773,1540,3313,3810
0130-001,2018,10,29,11,1717,1614,3331,3313
0130-001,2018,10,29,12,1606,1522,3128,3331
0130-001,2018,10,29,13,1691,1574,3265,3128
0130-001,2018,10,29,14,1914,1662,3576,3265
0130-001,2018,10,29,15,1707,1801,3508,3576
0130-001,2018,10,29,16,1780,1926,3706,3508
0130-001,2018,10,29,17,1686,2023,3709,3706
0130-001,2018,10,29,18,1794,2330,4124,3709
0130-001,2018,10,29,19,1735,2169,3904,4124
0130-001,2018,10,29,20,1194,1818,3012,3904
0130-001,2018,10,29,21,1053,1523,2576,3012
0130-001,2018,10,29,22,970,1114,2084,2576
0130-001,2018,10,29,23,721,678,1399,2084
0130-001,2018,10,29,24,404,410,814,1399
0130-001,2018,10,30,1,276,278,554,814
0130-001,2018,10,30,2,196,166,362,554
0130-001,2018,10,30,3,128,152,280,362
0130-001,2018,10,30,4,154,178,332,280
0130-001,2018,10,30,5,246,245,491,332
0130-001,2018,10,30,6,677,366,1043,491
0130-001,2018,10,30,7,1721,771,2492,1043
0130-001,2018,10,30,8,1770,1521,3291,2492
0130-001,2018,10,30,9,1892,1879,3771,3291
0130-001,2018,10,30,10,1847,1589,3436,3771
0130-001,2018,10,30,11,1626,1641,3267,3436
0130-001,2018,10,30,12,1576,1627,3203,3267
0130-001,2018,10,30,13,1462,1430,2892,3203
0130-001,2018,10,30,14,1744,1713,3457,2892
0130-001,2018,10,30,15,1667,1713,3380,3457
0130-001,2018,10,30,16,1752,1763,3515,3380
0130-001,2018,10,30,17,1682,2030,3712,3515
0130-001,2018,10,30,18,1766,2268,4034,3712
0130-001,2018,10,30,19,1666,2202,3868,4034
0130-001,2018,10,30,20,1269,1723,2992,3868
0130-001,2018,10,30,21,1043,1675,2718,2992
0130-001,2018,10,30,22,999,1142,2141,2718
0130-001,2018,10,30,23,799,728,1527,2141
0130-001,2018,10,30,24,530,444,974,1527
0130-001,2018,10,31,1,342,302,644,974
0130-001,2018,10,31,2,206,216,422,644
0130-001,2018,10,31,3,145,189,334,422
0130-001,2018,10,31,4,160,159,319,334
0130-001,2018,10,31,5,250,259,509,319
0130-001,2018,10,31,6,688,363,1051,509
0130-001,2018,10,31,7,1653,791,2444,1051
0130-001,2018,10,31,8,1872,1529,3401,2444
0130-001,2018,10,31,9,1882,1902,3784,3401
0130-001,2018,10,31,10,1723,1535,3258,3784
0130-001,2018,10,31,11,1695,1655,3350,3258
0130-001,2018,10,31,12,1582,1621,3203,3350
0130-001,2018,10,31,13,1420,1487,2907,3203
0130-001,2018,10,31,14,1687,1630,3317,2907
0130-001,2018,10,31,15,1742,1717,3459,3317
0130-001,2018,10,31,16,1713,1799,3512,3459
0130-001,2018,10,31,17,1656,2019,3675,3512
0130-001,2018,10,31,18,1700,2167,3867,3675
0130-001,2018,10,31,19,1617,2053,3670,3867
0130-001,2018,10,31,20,1273,1741,3014,3670
0130-001,2018,10,31,21,1059,1465,2524,3014
0130-001,2018,10,31,22,1008,1038,2046,2524
0130-001,2018,10,31,23,821,715,1536,2046
0130-001,2018,10,31,24,562,468,1030,1536
0130-001,2018,11,1,1,395,347,742,1030
0130-001,2018,11,1,2,230,236,466,742
0130-001,2018,11,1,3,175,180,355,466
0130-001,2018,11,1,4,151,198,349,355
0130-001,2018,11,1,5,256,274,530,349
0130-001,2018,11,1,6,676,389,1065,530
0130-001,2018,11,1,7,1636,770,2406,1065
0130-001,2018,11,1,8,1874,1481,3355,2406
0130-001,2018,11,1,9,1939,1677,3616,3355
0130-001,2018,11,1,10,1643,1677,3320,3616
0130-001,2018,11,1,11,1623,1641,3264,3320
0130-001,2018,11,1,12,1616,1590,3206,3264
0130-001,2018,11,1,13,1407,1468,2875,3206
0130-001,2018,11,1,14,1668,1654,3322,2875
0130-001,2018,11,1,15,1739,1744,3483,3322
0130-001,2018,11,1,16,1744,1781,3525,3483
0130-001,2018,11,1,17,1696,2041,3737,3525
0130-001,2018,11,1,18,1843,2341,4184,3737
0130-001,2018,11,1,19,1665,2266,3931,4184
0130-001,2018,11,1,20,1349,1787,3136,3931
0130-001,2018,11,1,21,1052,1514,2566,3136
0130-001,2018,11,1,22,1019,1163,2182,2566
0130-001,2018,11,1,23,837,704,1541,2182
0130-001,2018,11,1,24,492,470,962,1541
0130-001,2018,11,2,1,390,348,738,962
0130-001,2018,11,2,2,236,178,414,738
0130-001,2018,11,2,3,164,181,345,414
0130-001,2018,11,2,4,158,188,346,345
0130-001,2018,11,2,5,245,258,503,346
0130-001,2018,11,2,6,666,365,1031,503
0130-001,2018,11,2,7,1624,750,2374,1031
0130-001,2018,11,2,8,1882,1503,3385,2374
0130-001,2018,11,2,9,1840,1893,3733,3385
0130-001,2018,11,2,10,1688,1645,3333,3733
0130-001,2018,11,2,11,1697,1738,3435,3333
0130-001,2018,11,2,12,1584,1690,3274,3435
0130-001,2018,11,2,13,1488,1595,3083,3274
0130-001,2018,11,2,14,1714,1742,3456,3083
0130-001,2018,11,2,15,1689,1769,3458,3456
0130-001,2018,11,2,16,1882,1851,3733,3458
0130-001,2018,11,2,17,1773,2010,3783,3733
0130-001,2018,11,2,18,1893,2357,4250,3783
0130-001,2018,11,2,19,1825,2198,4023,4250
0130-001,2018,11,2,20,1473,1999,3472,4023
0130-001,2018,11,2,21,1227,1631,2858,3472
0130-001,2018,11,2,22,1036,1137,2173,2858
0130-001,2018,11,2,23,883,792,1675,2173
0130-001,2018,11,2,24,605,548,1153,1675
0130-001,2018,11,3,1,448,394,842,1153
0130-001,2018,11,3,2,322,297,619,842
0130-001,2018,11,3,3,226,244,470,619
0130-001,2018,11,3,4,221,250,471,470
0130-001,2018,11,3,5,261,259,520,471
0130-001,2018,11,3,6,556,365,921,520
0130-001,2018,11,3,7,1111,665,1776,921
0130-001,2018,11,3,8,1356,1100,2456,1776
0130-001,2018,11,3,9,1565,1538,3103,2456
0130-001,2018,11,3,10,1795,1769,3564,3103
0130-001,2018,11,3,11,1743,1932,3675,3564
0130-001,2018,11,3,12,1634,1936,3570,3675
0130-001,2018,11,3,13,1703,1985,3688,3570
0130-001,2018,11,3,14,1671,1899,3570,3688
0130-001,2018,11,3,15,1698,1846,3544,3570
0130-001,2018,11,3,16,1832,1858,3690,3544
0130-001,2018,11,3,17,1767,1970,3737,3690
0130-001,2018,11,3,18,1809,2080,3889,3737
0130-001,2018,11,3,19,1656,1820,3476,3889
0130-001,2018,11,3,20,1396,1388,2784,3476
0130-001,2018,11,3,21,1122,1114,2236,2784
0130-001,2018,11,3,22,948,868,1816,2236
0130-001,2018,11,3,23,681,629,1310,1816
0130-001,2018,11,3,24,552,484,1036,1310
0130-001,2018,11,4,1,368,375,743,1036
0130-001,2018,11,4,2,287,237,524,743
0130-001,2018,11,4,3,249,223,472,524
0130-001,2018,11,4,4,207,144,351,472
0130-001,2018,11,4,5,231,198,429,351
0130-001,2018,11,4,6,319,239,558,429
0130-001,2018,11,4,7,585,355,940,558
0130-001,2018,11,4,8,595,599,1194,940
0130-001,2018,11,4,9,843,926,1769,1194
0130-001,2018,11,4,10,1050,1164,2214,1769
0130-001,2018,11,4,11,1266,1385,2651,2214
0130-001,2018,11,4,12,1134,1322,2456,2651
0130-001,2018,11,4,13,1285,1486,2771,2456
0130-001,2018,11,4,14,1548,1514,3062,2771
0130-001,2018,11,4,15,1555,1540,3095,3062
0130-001,2018,11,4,16,1585,1619,3204,3095
0130-001,2018,11,4,17,1681,1666,3347,3204
0130-001,2018,11,4,18,1679,1696,3375,3347
0130-001,2018,11,4,19,1721,1388,3109,3375
0130-001,2018,11,4,20,1394,1161,2555,3109
0130-001,2018,11,4,21,1343,912,2255,2555
0130-001,2018,11,4,22,977,822,1799,2255
0130-001,2018,11,4,23,633,561,1194,1799
0130-001,2018,11,4,24,441,346,787,1194
0130-001,2018,11,5,1,285,220,505,787
0130-001,2018,11,5,2,172,132,304,505
0130-001,2018,11,5,3,128,117,245,304
0130-001,2018,11,5,4,131,128,259,245
0130-001,2018,11,5,5,251,218,469,259
0130-001,2018,11,5,6,691,389,1080,469
0130-001,2018,11,5,7,1770,820,2590,1080
0130-001,2018,11,5,8,1885,1593,3478,2590
0130-001,2018,11,5,9,1961,1824,3785,3478
0130-001,2018,11,5,10,1739,1612,3351,3785
0130-001,2018,11,5,11,1907,1642,3549,3351
0130-001,2018,11,5,12,1766,1616,3382,3549
0130-001,2018,11,5,13,1715,1515,3230,3382
0130-001,2018,11,5,14,1800,1730,3530,3230
0130-001,2018,11,5,15,1696,1724,3420,3530
0130-001,2018,11,5,16,1776,1790,3566,3420
0130-001,2018,11,5,17,1566,2008,3574,3566
0130-001,2018,11,5,18,1766,2271,4037,3574
0130-001,2018,11,5,19,1673,2253,3926,4037
0130-001,2018,11,5,20,1212,1828,3040,3926
0130-001,2018,11,5,21,1028,1638,2666,3040
0130-001,2018,11,5,22,971,1046,2017,2666
0130-001,2018,11,5,23,664,674,1338,2017
0130-001,2018,11,5,24,453,414,867,1338
0130-001,2018,11,6,1,305,305,610,867
0130-001,2018,11,6,2,187,176,363,610
0130-001,2018,11,6,3,155,175,330,363
0130-001,2018,11,6,4,188,185,373,330
0130-001,2018,11,6,5,250,256,506,373
0130-001,2018,11,6,6,681,380,1061,506
0130-001,2018,11,6,7,1641,765,2406,1061
0130-001,2018,11,6,8,1848,1524,3372,2406
0130-001,2018,11,6,9,1893,1867,3760,3372
0130-001,2018,11,6,10,1823,1575,3398,3760
0130-001,2018,11,6,11,1683,1622,3305,3398
0130-001,2018,11,6,12,1569,1581,3150,3305
0130-001,2018,11,6,13,1433,1395,2828,3150
0130-001,2018,11,6,14,1649,1690,3339,2828
0130-001,2018,11,6,15,1727,1688,3415,3339
0130-001,2018,11,6,16,1703,1846,3549,3415
0130-001,2018,11,6,17,1670,2069,3739,3549
0130-001,2018,11,6,18,1702,2362,4064,3739
0130-001,2018,11,6,19,1683,2218,3901,4064
0130-001,2018,11,6,20,1256,1722,2978,3901
0130-001,2018,11,6,21,1041,1692,2733,2978
0130-001,2018,11,6,22,966,1158,2124,2733
0130-001,2018,11,6,23,724,726,1450,2124
0130-001,2018,11,6,24,444,426,870,1450
0130-001,2018,11,7,1,312,308,620,870
0130-001,2018,11,7,2,206,228,434,620
0130-001,2018,11,7,3,163,162,325,434
0130-001,2018,11,7,4,141,171,312,325
0130-001,2018,11,7,5,239,240,479,312
0130-001,2018,11,7,6,653,382,1035,479
0130-001,2018,11,7,7,1652,758,2410,1035
0130-001,2018,11,7,8,1793,1449,3242,2410
0130-001,2018,11,7,9,1872,1898,3770,3242
0130-001,2018,11,7,10,1830,1603,3433,3770
0130-001,2018,11,7,11,1668,1647,3315,3433
0130-001,2018,11,7,12,1645,1650,3295,3315
0130-001,2018,11,7,13,1414,1412,2826,3295
0130-001,2018,11,7,14,1671,1719,3390,2826
0130-001,2018,11,7,15,1704,1762,3466,3390
0130-001,2018,11,7,16,1677,1842,3519,3466
0130-001,2018,11,7,17,1583,1962,3545,3519
0130-001,2018,11,7,18,1634,2279,3913,3545
0130-001,2018,11,7,19,1639,1967,3606,3913
0130-001,2018,11,7,20,1185,1846,3031,3606
0130-001,2018,11,7,21,1085,1464,2549,3031
0130-001,2018,11,7,22,1003,1030,2033,2549
0130-001,2018,11,7,23,772,711,1483,2033
0130-001,2018,11,7,24,513,496,1009,1483
0130-001,2018,11,8,1,336,351,687,1009
0130-001,2018,11,8,2,203,212,415,687
0130-001,2018,11,8,3,135,160,295,415
0130-001,2018,11,8,4,154,171,325,295
0130-001,2018,11,8,5,237,244,481,325
0130-001,2018,11,8,6,584,371,955,481
0130-001,2018,11,8,7,1433,674,2107,955
0130-001,2018,11,8,8,1785,1408,3193,2107
0130-001,2018,11,8,9,1871,1862,3733,3193
0130-001,2018,11,8,10,1745,1593,3338,3733
0130-001,2018,11,8,11,1558,1571,3129,3338
0130-001,2018,11,8,12,1511,1458,2969,3129
0130-001,2018,11,8,13,1351,1425,2776,2969
0130-001,2018,11,8,14,1583,1623,3206,2776
0130-001,2018,11,8,15,1531,1671,3202,3206
0130-001,2018,11,8,16,1615,1599,3214,3202
0130-001,2018,11,8,17,1550,1824,3374,3214
0130-001,2018,11,8,18,1593,2052,3645,3374
0130-001,2018,11,8,19,1636,2086,3722,3645
0130-001,2018,11,8,20,1121,1636,2757,3722
0130-001,2018,11,8,21,974,1502,2476,2757
0130-001,2018,11,8,22,919,1071,1990,2476
0130-001,2018,11,8,23,626,709,1335,1990
0130-001,2018,11,8,24,446,430,876,1335
0130-001,2018,11,9,1,326,313,639,876
0130-001,2018,11,9,2,214,211,425,639
0130-001,2018,11,9,3,146,181,327,425
0130-001,2018,11,9,4,146,168,314,327
0130-001,2018,11,9,5,256,229,485,314
0130-001,2018,11,9,6,651,385,1036,485
0130-001,2018,11,9,7,1578,752,2330,1036
0130-001,2018,11,9,8,1845,1463,3308,2330
0130-001,2018,11,9,9,1935,1869,3804,3308
0130-001,2018,11,9,10,1781,1643,3424,3804
0130-001,2018,11,9,11,1707,1720,3427,3424
0130-001,2018,11,9,12,1715,1699,3414,3427
0130-001,2018,11,9,13,1450,1543,2993,3414
0130-001,2018,11,9,14,1756,1834,3590,2993
0130-001,2018,11,9,15,1828,1849,3677,3590
0130-001,2018,11,9,16,1901,2010,3911,3677
0130-001,2018,11,9,17,1831,2145,3976,3911
0130-001,2018,11,9,18,1874,2271,4145,3976
0130-001,2018,11,9,19,1888,2094,3982,4145
0130-001,2018,11,9,20,1329,1897,3226,3982
0130-001,2018,11,9,21,1139,1642,2781,3226
0130-001,2018,11,9,22,1033,1180,2213,2781
0130-001,2018,11,9,23,913,804,1717,2213
0130-001,2018,11,9,24,579,521,1100,1717
0130-001,2018,11,10,1,479,436,915,1100
0130-001,2018,11,10,2,326,301,627,915
0130-001,2018,11,10,3,270,257,527,627
0130-001,2018,11,10,4,206,222,428,527
0130-001,2018,11,10,5,302,279,581,428
0130-001,2018,11,10,6,577,380,957,581
0130-001,2018,11,10,7,1112,655,1767,957
0130-001,2018,11,10,8,1354,1081,2435,1767
0130-001,2018,11,10,9,1560,1545,3105,2435
0130-001,2018,11,10,10,1738,1712,3450,3105
0130-001,2018,11,10,11,1757,1835,3592,3450
0130-001,2018,11,10,12,1750,1884,3634,3592
0130-001,2018,11,10,13,1561,1956,3517,3634
0130-001,2018,11,10,14,1644,1901,3545,3517
0130-001,2018,11,10,15,1770,1909,3679,3545
0130-001,2018,11,10,16,1790,1893,3683,3679
0130-001,2018,11,10,17,1814,2016,3830,3683
0130-001,2018,11,10,18,1728,2060,3788,3830
0130-001,2018,11,10,19,1642,1830,3472,3788
0130-001,2018,11,10,20,1383,1303,2686,3472
0130-001,2018,11,10,21,1136,1173,2309,2686
0130-001,2018,11,10,22,993,806,1799,2309
0130-001,2018,11,10,23,773,643,1416,1799
0130-001,2018,11,10,24,483,421,904,1416
0130-001,2018,11,11,1,362,304,666,904
0130-001,2018,11,11,2,307,266,573,666
0130-001,2018,11,11,3,218,213,431,573
0130-001,2018,11,11,4,201,152,353,431
0130-001,2018,11,11,5,212,179,391,353
0130-001,2018,11,11,6,340,265,605,391
0130-001,2018,11,11,7,649,393,1042,605
0130-001,2018,11,11,8,776,635,1411,1042
0130-001,2018,11,11,9,911,866,1777,1411
0130-001,2018,11,11,10,1113,1095,2208,1777
0130-001,2018,11,11,11,1344,1299,2643,2208
0130-001,2018,11,11,12,1260,1378,2638,2643
0130-001,2018,11,11,13,1384,1428,2812,2638
0130-001,2018,11,11,14,1509,1536,3045,2812
0130-001,2018,11,11,15,1529,1583,3112,3045
0130-001,2018,11,11,16,1656,1604,3260,3112
0130-001,2018,11,11,17,1648,1740,3388,3260
0130-001,2018,11,11,18,1700,1651,3351,3388
0130-001,2018,11,11,19,1656,1351,3007,3351
0130-001,2018,11,11,20,1403,1148,2551,3007
0130-001,2018,11,11,21,1272,925,2197,2551
0130-001,2018,11,11,22,911,774,1685,2197
0130-001,2018,11,11,23,619,526,1145,1685
0130-001,2018,11,11,24,452,356,808,1145
0130-001,2018,11,12,1,277,219,496,808
0130-001,2018,11,12,2,157,150,307,496
0130-001,2018,11,12,3,128,110,238,307
0130-001,2018,11,12,4,136,121,257,238
0130-001,2018,11,12,5,263,212,475,257
0130-001,2018,11,12,6,703,373,1076,475
0130-001,2018,11,12,7,1705,736,2441,1076
0130-001,2018,11,12,8,1804,1490,3294,2441
0130-001,2018,11,12,9,1971,1853,3824,3294
0130-001,2018,11,12,10,1835,1540,3375,3824
0130-001,2018,11,12,11,1699,1690,3389,3375
0130-001,2018,11,12,12,1636,1651,3287,3389
0130-001,2018,11,12,13,1486,1476,2962,3287
0130-001,2018,11,12,14,1770,1770,3540,2962
0130-001,2018,11,12,15,1710,1719,3429,3540
0130-001,2018,11,12,16,1720,1882,3602,3429
0130-001,2018,11,12,17,1705,2056,3761,3602
0130-001,2018,11,12,18,1826,2321,4147,3761
0130-001,2018,11,12,19,1635,2249,3884,4147
0130-001,2018,11,12,20,1225,1820,3045,3884
0130-001,2018,11,12,21,1008,1578,2586,3045
0130-001,2018,11,12,22,973,1063,2036,2586
0130-001,2018,11,12,23,675,673,1348,2036
0130-001,2018,11,12,24,467,424,891,1348
0130-001,2018,11,13,1,263,281,544,891
0130-001,2018,11,13,2,211,173,384,544
0130-001,2018,11,13,3,157,166,323,384
0130-001,2018,11,13,4,162,186,348,323
0130-001,2018,11,13,5,256,240,496,348
0130-001,2018,11,13,6,681,380,1061,496
0130-001,2018,11,13,7,1712,765,2477,1061
0130-001,2018,11,13,8,1767,1454,3221,2477
0130-001,2018,11,13,9,1933,1838,3771,3221
0130-001,2018,11,13,10,1788,1523,3311,3771
0130-001,2018,11,13,11,1669,1634,3303,3311
0130-001,2018,11,13,12,1614,1571,3185,3303
0130-001,2018,11,13,13,1461,1484,2945,3185
0130-001,2018,11,13,14,1658,1683,3341,2945
0130-001,2018,11,13,15,1744,1798,3542,3341
0130-001,2018,11,13,16,1771,1875,3646,3542
0130-001,2018,11,13,17,1628,2087,3715,3646
0130-001,2018,11,13,18,1774,2351,4125,3715
0130-001,2018,11,13,19,1677,2203,3880,4125
0130-001,2018,11,13,20,1229,1774,3003,3880
0130-001,2018,11,13,21,998,1633,2631,3003
0130-001,2018,11,13,22,1004,1128,2132,2631
0130-001,2018,11,13,23,752,703,1455,2132
0130-001,2018,11,13,24,475,427,902,1455
0130-001,2018,11,14,1,300,269,569,902
0130-001,2018,11,14,2,192,199,391,569
0130-001,2018,11,14,3,160,174,334,391
0130-001,2018,11,14,4,135,166,301,334
0130-001,2018,11,14,5,266,250,516,301
0130-001,2018,11,14,6,667,390,1057,516
0130-001,2018,11,14,7,1640,738,2378,1057
0130-001,2018,11,14,8,1836,1457,3293,2378
0130-001,2018,11,14,9,1994,1847,3841,3293
0130-001,2018,11,14,10,1742,1577,3319,3841
0130-001,2018,11,14,11,1618,1617,3235,3319
0130-001,2018,11,14,12,1602,1565,3167,3235
0130-001,2018,11,14,13,1493,1527,3020,3167
0130-001,2018,11,14,14,1744,1756,3500,3020
0130-001,2018,11,14,15,1720,1671,3391,3500
0130-001,2018,11,14,16,1773,1869,3642,3391
0130-001,2018,11,14,17,1650,2056,3706,3642
0130-001,2018,11,14,18,1716,2286,4002,3706
0130-001,2018,11,14,19,1743,2162,3905,4002
0130-001,2018,11,14,20,1215,1800,3015,3905
0130-001,2018,11,14,21,1034,1448,2482,3015
0130-001,2018,11,14,22,1045,1057,2102,2482
0130-001,2018,11,14,23,779,744,1523,2102
0130-001,2018,11,14,24,549,452,1001,1523
0130-001,2018,11,15,1,316,302,618,1001
0130-001,2018,11,15,2,175,215,390,618
0130-001,2018,11,15,3,169,175,344,390
0130-001,2018,11,15,4,154,186,340,344
0130-001,2018,11,15,5,257,271,528,340
0130-001,2018,11,15,6,678,388,1066,528
0130-001,2018,11,15,7,1629,817,2446,1066
0130-001,2018,11,15,8,1863,1533,3396,2446
0130-001,2018,11,15,9,1930,1790,3720,3396
0130-001,2018,11,15,10,1899,1716,3615,3720
0130-001,2018,11,15,11,1731,1647,3378,3615
0130-001,2018,11,15,12,1570,1580,3150,3378
0130-001,2018,11,15,13,1525,1481,3006,3150
0130-001,2018,11,15,14,1655,1707,3362,3006
0130-001,2018,11,15,15,1724,1845,3569,3362
0130-001,2018,11,15,16,1789,1824,3613,3569
0130-001,2018,11,15,17,1541,2017,3558,3613
0130-001,2018,11,15,18,1681,2382,4063,3558
0130-001,2018,11,15,19,1717,2234,3951,4063
0130-001,2018,11,15,20,1240,1757,2997,3951
0130-001,2018,11,15,21,1053,1562,2615,2997
0130-001,2018,11,15,22,1020,1101,2121,2615
0130-001,2018,11,15,23,761,750,1511,2121
0130-001,2018,11,15,24,513,485,998,1511
0130-001,2018,11,16,1,342,310,652,998
0130-001,2018,11,16,2,211,221,432,652
0130-001,2018,11,16,3,163,172,335,432
0130-001,2018,11,16,4,192,211,403,335
0130-001,2018,11,16,5,292,264,556,403
0130-001,2018,11,16,6,682,386,1068,556
0130-001,2018,11,16,7,1656,776,2432,1068
0130-001,2018,11,16,8,1839,1511,3350,2432
0130-001,2018,11,16,9,1939,1916,3855,3350
0130-001,2018,11,16,10,1718,1697,3415,3855
0130-001,2018,11,16,11,1805,1717,3522,3415
0130-001,2018,11,16,12,1760,1697,3457,3522
0130-001,2018,11,16,13,1538,1701,3239,3457
0130-001,2018,11,16,14,1776,1801,3577,3239
0130-001,2018,11,16,15,1844,1882,3726,3577
0130-001,2018,11,16,16,1888,1956,3844,3726
0130-001,2018,11,16,17,1873,2143,4016,3844
0130-001,2018,11,16,18,1940,2378,4318,4016
0130-001,2018,11,16,19,1786,2256,4042,4318
0130-001,2018,11,16,20,1356,1986,3342,4042
0130-001,2018,11,16,21,1091,1635,2726,3342
0130-001,2018,11,16,22,1155,1151,2306,2726
0130-001,2018,11,16,23,851,735,1586,2306
0130-001,2018,11,16,24,594,514,1108,1586
0130-001,2018,11,17,1,472,401,873,1108
0130-001,2018,11,17,2,326,269,595,873
0130-001,2018,11,17,3,231,249,480,595
0130-001,2018,11,17,4,209,224,433,480
0130-001,2018,11,17,5,265,277,542,433
0130-001,2018,11,17,6,575,372,947,542
0130-001,2018,11,17,7,1088,600,1688,947
0130-001,2018,11,17,8,1376,1036,2412,1688
0130-001,2018,11,17,9,1572,1621,3193,2412
0130-001,2018,11,17,10,1711,1790,3501,3193
0130-001,2018,11,17,11,1810,1829,3639,3501
0130-001,2018,11,17,12,1665,1984,3649,3639
0130-001,2018,11,17,13,1768,2014,3782,3649
0130-001,2018,11,17,14,1876,1929,3805,3782
0130-001,2018,11,17,15,1863,1954,3817,3805
0130-001,2018,11,17,16,1897,2001,3898,3817
0130-001,2018,11,17,17,1767,2053,3820,3898
0130-001,2018,11,17,18,1873,2099,3972,3820
0130-001,2018,11,17,19,1627,1872,3499,3972
0130-001,2018,11,17,20,1409,1250,2659,3499
0130-001,2018,11,17,21,1111,1071,2182,2659
0130-001,2018,11,17,22,876,870,1746,2182
0130-001,2018,11,17,23,713,595,1308,1746
0130-001,2018,11,17,24,488,412,900,1308
0130-001,2018,11,18,1,379,321,700,900
0130-001,2018,11,18,2,298,229,527,700
0130-001,2018,11,18,3,205,198,403,527
0130-001,2018,11,18,4,181,183,364,403
0130-001,2018,11,18,5,195,175,370,364
0130-001,2018,11,18,6,352,230,582,370
0130-001,2018,11,18,7,648,406,1054,582
0130-001,2018,11,18,8,697,631,1328,1054
0130-001,2018,11,18,9,925,876,1801,1328
0130-001,2018,11,18,10,1196,1087,2283,1801
0130-001,2018,11,18,11,1310,1272,2582,2283
0130-001,2018,11,18,12,1215,1404,2619,2582
0130-001,2018,11,18,13,1344,1315,2659,2619
0130-001,2018,11,18,14,1573,1728,3301,2659
0130-001,2018,11,18,15,1753,1757,3510,3301
0130-001,2018,11,18,16,1863,1682,3545,3510
0130-001,2018,11,18,17,1659,1760,3419,3545
0130-001,2018,11,18,18,1654,1732,3386,3419
0130-001,2018,11,18,19,1618,1354,2972,3386
0130-001,2018,11,18,20,1538,1102,2640,2972
0130-001,2018,11,18,21,1487,989,2476,2640
0130-001,2018,11,18,22,1200,784,1984,2476
0130-001,2018,11,18,23,754,516,1270,1984
0130-001,2018,11,18,24,386,356,742,1270
0130-001,2018,11,19,1,282,226,508,742
0130-001,2018,11,19,2,161,140,301,508
0130-001,2018,11,19,3,123,107,230,301
0130-001,2018,11,19,4,126,121,247,230
0130-001,2018,11,19,5,265,225,490,247
0130-001,2018,11,19,6,709,386,1095,490
0130-001,2018,11,19,7,1695,754,2449,1095
0130-001,2018,11,19,8,1893,1459,3352,2449
0130-001,2018,11,19,9,1878,1892,3770,3352
0130-001,2018,11,19,10,1750,1581,3331,3770
0130-001,2018,11,19,11,1711,1669,3380,3331
0130-001,2018,11,19,12,1583,1545,3128,3380
0130-001,2018,11,19,13,1505,1513,3018,3128
0130-001,2018,11,19,14,1827,1764,3591,3018
0130-001,2018,11,19,15,1780,1687,3467,3591
0130-001,2018,11,19,16,1905,1857,3762,3467
0130-001,2018,11,19,17,1771,2070,3841,3762
0130-001,2018,11,19,18,1775,2281,4056,3841
0130-001,2018,11,19,19,1658,2244,3902,4056
0130-001,2018,11,19,20,1189,1783,2972,3902
0130-001,2018,11,19,21,994,1560,2554,2972
0130-001,2018,11,19,22,982,1108,2090,2554
0130-001,2018,11,19,23,667,668,1335,2090
0130-001,2018,11,19,24,465,398,863,1335
0130-001,2018,11,20,1,253,282,535,863
0130-001,2018,11,20,2,189,183,372,535
0130-001,2018,11,20,3,138,167,305,372
0130-001,2018,11,20,4,127,161,288,305
0130-001,2018,11,20,5,252,229,481,288
0130-001,2018,11,20,6,684,375,1059,481
0130-001,2018,11,20,7,1686,767,2453,1059
0130-001,2018,11,20,8,1790,1441,3231,2453
0130-001,2018,11,20,9,1896,1825,3721,3231
0130-001,2018,11,20,10,1830,1613,3443,3721
0130-001,2018,11,20,11,1656,1618,3274,3443
0130-001,2018,11,20,12,1604,1531,3135,3274
0130-001,2018,11,20,13,1522,1477,2999,3135
0130-001,2018,11,20,14,1641,1680,3321,2999
0130-001,2018,11,20,15,1604,1699,3303,3321
0130-001,2018,11,20,16,1531,1831,3362,3303
0130-001,2018,11,20,17,1584,2051,3635,3362
0130-001,2018,11,20,18,1728,2342,4070,3635
0130-001,2018,11,20,19,1715,2193,3908,4070
0130-001,2018,11,20,20,1177,1771,2948,3908
0130-001,2018,11,20,21,1023,1603,2626,2948
0130-001,2018,11,20,22,1047,1101,2148,2626
0130-001,2018,11,20,23,771,730,1501,2148
0130-001,2018,11,20,24,482,451,933,1501
0130-001,2018,11,21,1,305,291,596,933
0130-001,2018,11,21,2,216,190,406,596
0130-001,2018,11,21,3,149,188,337,406
0130-001,2018,11,21,4,153,169,322,337
0130-001,2018,11,21,5,249,235,484,322
0130-001,2018,11,21,6,648,365,1013,484
0130-001,2018,11,21,7,1621,739,2360,1013
0130-001,2018,11,21,8,1761,1462,3223,2360
0130-001,2018,11,21,9,1846,1850,3696,3223
0130-001,2018,11,21,10,1773,1677,3450,3696
0130-001,2018,11,21,11,1692,1602,3294,3450
0130-001,2018,11,21,12,1638,1602,3240,3294
0130-001,2018,11,21,13,1437,1433,2870,3240
0130-001,2018,11,21,14,1636,1737,3373,2870
0130-001,2018,11,21,15,1616,1728,3344,3373
0130-001,2018,11,21,16,1738,1745,3483,3344
0130-001,2018,11,21,17,1518,1880,3398,3483
0130-001,2018,11,21,18,1773,1990,3763,3398
0130-001,2018,11,21,19,1600,1892,3492,3763
0130-001,2018,11,21,20,1131,1791,2922,3492
0130-001,2018,11,21,21,944,1358,2302,2922
0130-001,2018,11,21,22,913,977,1890,2302
0130-001,2018,11,21,23,680,659,1339,1890
0130-001,2018,11,21,24,501,430,931,1339
0130-001,2018,11,22,1,346,302,648,931
0130-001,2018,11,22,2,214,186,400,648
0130-001,2018,11,22,3,115,171,286,400
0130-001,2018,11,22,4,146,157,303,286
0130-001,2018,11,22,5,261,229,490,303
0130-001,2018,11,22,6,676,331,1007,490
0130-001,2018,11,22,7,1600,632,2232,1007
0130-001,2018,11,22,8,1710,1115,2825,2232
0130-001,2018,11,22,9,1862,1624,3486,2825
0130-001,2018,11,22,10,1826,1558,3384,3486
0130-001,2018,11,22,11,1715,1606,3321,3384
0130-001,2018,11,22,12,1580,1688,3268,3321
0130-001,2018,11,22,13,1397,1460,2857,3268
0130-001,2018,11,22,14,1753,1785,3538,2857
0130-001,2018,11,22,15,1698,1783,3481,3538
0130-001,2018,11,22,16,1802,1801,3603,3481
0130-001,2018,11,22,17,1750,2053,3803,3603
0130-001,2018,11,22,18,1733,2291,4024,3803
0130-001,2018,11,22,19,1669,2255,3924,4024
0130-001,2018,11,22,20,1234,1814,3048,3924
0130-001,2018,11,22,21,1075,1528,2603,3048
0130-001,2018,11,22,22,1013,1175,2188,2603
0130-001,2018,11,22,23,726,753,1479,2188
0130-001,2018,11,22,24,494,439,933,1479
0130-001,2018,11,23,1,309,333,642,933
0130-001,2018,11,23,2,235,210,445,642
0130-001,2018,11,23,3,172,203,375,445
0130-001,2018,11,23,4,133,167,300,375
0130-001,2018,11,23,5,270,211,481,300
0130-001,2018,11,23,6,636,308,944,481
0130-001,2018,11,23,7,1567,548,2115,944
0130-001,2018,11,23,8,1817,983,2800,2115
0130-001,2018,11,23,9,1861,1404,3265,2800
0130-001,2018,11,23,10,1807,1650,3457,3265
0130-001,2018,11,23,11,1676,1664,3340,3457
0130-001,2018,11,23,12,1706,1682,3388,3340
0130-001,2018,11,23,13,1562,1636,3198,3388
0130-001,2018,11,23,14,1878,1895,3773,3198
0130-001,2018,11,23,15,1700,1798,3498,3773
0130-001,2018,11,23,16,1801,2015,3816,3498
0130-001,2018,11,23,17,1872,2180,4052,3816
0130-001,2018,11,23,18,1917,2270,4187,4052
0130-001,2018,11,23,19,1801,2061,3862,4187
0130-001,2018,11,23,20,1341,2074,3415,3862
0130-001,2018,11,23,21,1213,1663,2876,3415
0130-001,2018,11,23,22,1063,1150,2213,2876
0130-001,2018,11,23,23,853,828,1681,2213
0130-001,2018,11,23,24,646,526,1172,1681
0130-001,2018,11,24,1,438,388,826,1172
0130-001,2018,11,24,2,353,285,638,826
0130-001,2018,11,24,3,243,237,480,638
0130-001,2018,11,24,4,205,229,434,480
0130-001,2018,11,24,5,258,291,549,434
0130-001,2018,11,24,6,493,334,827,549
0130-001,2018,11,24,7,942,596,1538,827
0130-001,2018,11,24,8,1201,1013,2214,1538
0130-001,2018,11,24,9,1493,1422,2915,2214
0130-001,2018,11,24,10,1584,1639,3223,2915
0130-001,2018,11,24,11,1694,1725,3419,3223
0130-001,2018,11,24,12,1522,1906,3428,3419
0130-001,2018,11,24,13,1623,1945,3568,3428
0130-001,2018,11,24,14,1645,2035,3680,3568
0130-001,2018,11,24,15,1736,1881,3617,3680
0130-001,2018,11,24,16,1836,1917,3753,3617
0130-001,2018,11,24,17,1846,1954,3800,3753
0130-001,2018,11,24,18,1459,1905,3364,3800
0130-001,2018,11,24,19,1851,1707,3558,3364
0130-001,2018,11,24,20,1299,1126,2425,3558
0130-001,2018,11,24,21,1097,1051,2148,2425
0130-001,2018,11,24,22,940,955,1895,2148
0130-001,2018,11,24,23,752,955,1707,1895
0130-001,2018,11,24,24,469,454,923,1707
0130-001,2018,11,25,1,411,345,756,923
0130-001,2018,11,25,2,303,259,562,756
0130-001,2018,11,25,3,253,205,458,562
0130-001,2018,11,25,4,169,164,333,458
0130-001,2018,11,25,5,202,162,364,333
0130-001,2018,11,25,6,336,237,573,364
0130-001,2018,11,25,7,598,401,999,573
0130-001,2018,11,25,8,638,537,1175,999
0130-001,2018,11,25,9,752,809,1561,1175
0130-001,2018,11,25,10,960,1009,1969,1561
0130-001,2018,11,25,11,1238,1212,2450,1969
0130-001,2018,11,25,12,1226,1249,2475,2450
0130-001,2018,11,25,13,1307,1365,2672,2475
0130-001,2018,11,25,14,1450,1494,2944,2672
0130-001,2018,11,25,15,1479,1543,3022,2944
0130-001,2018,11,25,16,1601,1612,3213,3022
0130-001,2018,11,25,17,1680,1631,3311,3213
0130-001,2018,11,25,18,1734,1596,3330,3311
0130-001,2018,11,25,19,1673,1379,3052,3330
0130-001,2018,11,25,20,1409,1082,2491,3052
0130-001,2018,11,25,21,1191,897,2088,2491
0130-001,2018,11,25,22,866,704,1570,2088
0130-001,2018,11,25,23,669,636,1305,1570
0130-001,2018,11,25,24,425,474,899,1305
0130-001,2018,11,26,1,273,247,520,899
0130-001,2018,11,26,2,147,162,309,520
0130-001,2018,11,26,3,131,123,254,309
0130-001,2018,11,26,4,129,128,257,254
0130-001,2018,11,26,5,259,206,465,257
0130-001,2018,11,26,6,700,386,1086,465
0130-001,2018,11,26,7,1733,738,2471,1086
0130-001,2018,11,26,8,1819,1448,3267,2471
0130-001,2018,11,26,9,1964,1804,3768,3267
0130-001,2018,11,26,10,1558,1505,3063,3768
0130-001,2018,11,26,11,1145,1530,2675,3063
0130-001,2018,11,26,12,1581,1562,3143,2675
0130-001,2018,11,26,13,1428,1414,2842,3143
0130-001,2018,11,26,14,1639,1670,3309,2842
0130-001,2018,11,26,15,1845,1751,3596,3309
0130-001,2018,11,26,16,1805,1827,3632,3596
0130-001,2018,11,26,17,1638,2016,3654,3632
0130-001,2018,11,26,18,1716,2273,3989,3654
0130-001,2018,11,26,19,1608,2247,3855,3989
0130-001,2018,11,26,20,1210,1746,2956,3855
0130-001,2018,11,26,21,994,1574,2568,2956
0130-001,2018,11,26,22,925,1020,1945,2568
0130-001,2018,11,26,23,692,704,1396,1945
0130-001,2018,11,26,24,456,428,884,1396
0130-001,2018,11,27,1,288,280,568,884
0130-001,2018,11,27,2,172,193,365,568
0130-001,2018,11,27,3,138,171,309,365
0130-001,2018,11,27,4,134,166,300,309
0130-001,2018,11,27,5,270,255,525,300
0130-001,2018,11,27,6,639,400,1039,525
0130-001,2018,11,27,7,1607,788,2395,1039
0130-001,2018,11,27,8,1850,1444,3294,2395
0130-001,2018,11,27,9,1924,1867,3791,3294
0130-001,2018,11,27,10,1788,1548,3336,3791
0130-001,2018,11,27,11,1639,1618,3257,3336
0130-001,2018,11,27,12,1565,1700,3265,3257
0130-001,2018,11,27,13,1433,1605,3038,3265
0130-001,2018,11,27,14,1486,1747,3233,3038
0130-001,2018,11,27,15,1749,1765,3514,3233
0130-001,2018,11,27,16,1678,1824,3502,3514
0130-001,2018,11,27,17,1687,2024,3711,3502
0130-001,2018,11,27,18,1727,2222,3949,3711
0130-001,2018,11,27,19,1605,2285,3890,3949
0130-001,2018,11,27,20,1224,1761,2985,3890
0130-001,2018,11,27,21,1026,1540,2566,2985
0130-001,2018,11,27,22,968,1090,2058,2566
0130-001,2018,11,27,23,807,755,1562,2058
0130-001,2018,11,27,24,505,422,927,1562
0130-001,2018,11,28,1,311,307,618,927
0130-001,2018,11,28,2,210,202,412,618
0130-001,2018,11,28,3,139,175,314,412
0130-001,2018,11,28,4,150,185,335,314
0130-001,2018,11,28,5,254,224,478,335
0130-001,2018,11,28,6,645,386,1031,478
0130-001,2018,11,28,7,1581,722,2303,1031
0130-001,2018,11,28,8,1813,1475,3288,2303
0130-001,2018,11,28,9,1974,1893,3867,3288
0130-001,2018,11,28,10,1647,1583,3230,3867
0130-001,2018,11,28,11,1544,1546,3090,3230
0130-001,2018,11,28,12,1583,1648,3231,3090
0130-001,2018,11,28,13,1413,1698,3111,3231
0130-001,2018,11,28,14,1642,1625,3267,3111
0130-001,2018,11,28,15,1690,1866,3556,3267
0130-001,2018,11,28,16,1698,1858,3556,3556
0130-001,2018,11,28,17,1656,2071,3727,3556
0130-001,2018,11,28,18,1728,2176,3904,3727
0130-001,2018,11,28,19,1593,2023,3616,3904
0130-001,2018,11,28,20,1259,1843,3102,3616
0130-001,2018,11,28,21,1041,1391,2432,3102
0130-001,2018,11,28,22,1013,975,1988,2432
0130-001,2018,11,28,23,789,717,1506,1988
0130-001,2018,11,28,24,520,435,955,1506
0130-001,2018,11,29,1,310,336,646,955
0130-001,2018,11,29,2,228,205,433,646
0130-001,2018,11,29,3,151,197,348,433
0130-001,2018,11,29,4,135,181,316,348
0130-001,2018,11,29,5,253,243,496,316
0130-001,2018,11,29,6,618,390,1008,496
0130-001,2018,11,29,7,1619,768,2387,1008
0130-001,2018,11,29,8,1830,1483,3313,2387
0130-001,2018,11,29,9,1936,1845,3781,3313
0130-001,2018,11,29,10,1802,1572,3374,3781
0130-001,2018,11,29,11,1618,1628,3246,3374
0130-001,2018,11,29,12,1594,1754,3348,3246
0130-001,2018,11,29,13,1406,1593,2999,3348
0130-001,2018,11,29,14,1394,1794,3188,2999
0130-001,2018,11,29,15,1757,1780,3537,3188
0130-001,2018,11,29,16,1694,1810,3504,3537
0130-001,2018,11,29,17,1533,2011,3544,3504
0130-001,2018,11,29,18,1647,2303,3950,3544
0130-001,2018,11,29,19,1613,2225,3838,3950
0130-001,2018,11,29,20,1133,1682,2815,3838
0130-001,2018,11,29,21,1001,1514,2515,2815
0130-001,2018,11,29,22,915,1028,1943,2515
0130-001,2018,11,29,23,715,748,1463,1943
0130-001,2018,11,29,24,497,444,941,1463
0130-001,2018,11,30,1,333,364,697,941
0130-001,2018,11,30,2,218,220,438,697
0130-001,2018,11,30,3,132,173,305,438
0130-001,2018,11,30,4,159,178,337,305
0130-001,2018,11,30,5,254,243,497,337
0130-001,2018,11,30,6,617,372,989,497
0130-001,2018,11,30,7,1578,705,2283,989
0130-001,2018,11,30,8,1837,1357,3194,2283
0130-001,2018,11,30,9,1824,1817,3641,3194
0130-001,2018,11,30,10,1876,1691,3567,3641
0130-001,2018,11,30,11,1699,1681,3380,3567
0130-001,2018,11,30,12,1662,1630,3292,3380
0130-001,2018,11,30,13,1399,1494,2893,3292
0130-001,2018,11,30,14,1568,1721,3289,2893
0130-001,2018,11,30,15,1826,1853,3679,3289
0130-001,2018,11,30,16,1792,1979,3771,3679
0130-001,2018,11,30,17,1705,2103,3808,3771
0130-001,2018,11,30,18,1895,2342,4237,3808
0130-001,2018,11,30,19,1700,2244,3944,4237
0130-001,2018,11,30,20,1396,2011,3407,3944
0130-001,2018,11,30,21,1094,1605,2699,3407
0130-001,2018,11,30,22,1116,1120,2236,2699
0130-001,2018,11,30,23,880,788,1668,2236
0130-001,2018,11,30,24,584,560,1144,1668
0130-001,2018,12,1,1,440,471,911,1144
0130-001,2018,12,1,2,323,272,595,911
0130-001,2018,12,1,3,242,223,465,595
0130-001,2018,12,1,4,186,194,380,465
0130-001,2018,12,1,5,281,283,564,380
0130-001,2018,12,1,6,542,345,887,564
0130-001,2018,12,1,7,1056,626,1682,887
0130-001,2018,12,1,8,1245,910,2155,1682
0130-001,2018,12,1,9,1500,1492,2992,2155
0130-001,2018,12,1,10,1623,1670,3293,2992
0130-001,2018,12,1,11,1810,1714,3524,3293
0130-001,2018,12,1,12,1691,1844,3535,3524
0130-001,2018,12,1,13,1706,1974,3680,3535
0130-001,2018,12,1,14,1727,1887,3614,3680
0130-001,2018,12,1,15,1847,1847,3694,3614
0130-001,2018,12,1,16,1726,1873,3599,3694
0130-001,2018,12,1,17,1772,2073,3845,3599
0130-001,2018,12,1,18,1746,2099,3845,3845
0130-001,2018,12,1,19,1547,1775,3322,3845
0130-001,2018,12,1,20,1283,1238,2521,3322
0130-001,2018,12,1,21,1013,977,1990,2521
0130-001,2018,12,1,22,928,847,1775,1990
0130-001,2018,12,1,23,740,585,1325,1775
0130-001,2018,12,1,24,581,451,1032,1325
0130-001,2018,12,2,1,394,367,761,1032
0130-001,2018,12,2,2,314,260,574,761
0130-001,2018,12,2,3,266,211,477,574
0130-001,2018,12,2,4,187,154,341,477
0130-001,2018,12,2,5,196,164,360,341
0130-001,2018,12,2,6,289,221,510,360
0130-001,2018,12,2,7,612,347,959,510
0130-001,2018,12,2,8,630,540,1170,959
0130-001,2018,12,2,9,846,894,1740,1170
0130-001,2018,12,2,10,1031,1107,2138,1740
0130-001,2018,12,2,11,1245,1358,2603,2138
0130-001,2018,12,2,12,1290,1401,2691,2603
0130-001,2018,12,2,13,1323,1539,2862,2691
0130-001,2018,12,2,14,1558,1633,3191,2862
0130-001,2018,12,2,15,1537,1654,3191,3191
0130-001,2018,12,2,16,1666,1615,3281,3191
0130-001,2018,12,2,17,1739,1812,3551,3281
0130-001,2018,12,2,18,1728,1664,3392,3551
0130-001,2018,12,2,19,1650,1366,3016,3392
0130-001,2018,12,2,20,1215,1053,2268,3016
0130-001,2018,12,2,21,1119,899,2018,2268
0130-001,2018,12,2,22,878,729,1607,2018
0130-001,2018,12,2,23,617,492,1109,1607
0130-001,2018,12,2,24,412,336,748,1109
0130-001,2018,12,3,1,258,210,468,748
0130-001,2018,12,3,2,164,134,298,468
0130-001,2018,12,3,3,138,111,249,298
0130-001,2018,12,3,4,124,122,246,249
0130-001,2018,12,3,5,261,207,468,246
0130-001,2018,12,3,6,565,346,911,468
0130-001,2018,12,3,7,1539,708,2247,911
0130-001,2018,12,3,8,1738,1406,3144,2247
0130-001,2018,12,3,9,1848,1827,3675,3144
0130-001,2018,12,3,10,1656,1477,3133,3675
0130-001,2018,12,3,11,1588,1517,3105,3133
0130-001,2018,12,3,12,1453,1496,2949,3105
0130-001,2018,12,3,13,1393,1344,2737,2949
0130-001,2018,12,3,14,1602,1680,3282,2737
0130-001,2018,12,3,15,1656,1674,3330,3282
0130-001,2018,12,3,16,1593,1831,3424,3330
0130-001,2018,12,3,17,1508,1899,3407,3424
0130-001,2018,12,3,18,1597,2102,3699,3407
0130-001,2018,12,3,19,1604,2152,3756,3699
0130-001,2018,12,3,20,1129,1551,2680,3756
0130-001,2018,12,3,21,964,1462,2426,2680
0130-001,2018,12,3,22,888,1043,1931,2426
0130-001,2018,12,3,23,655,664,1319,1931
0130-001,2018,12,3,24,384,443,827,1319
0130-001,2018,12,4,1,283,317,600,827
0130-001,2018,12,4,2,219,171,390,600
0130-001,2018,12,4,3,142,167,309,390
0130-001,2018,12,4,4,149,163,312,309
0130-001,2018,12,4,5,226,213,439,312
0130-001,2018,12,4,6,575,349,924,439
0130-001,2018,12,4,7,1381,703,2084,924
0130-001,2018,12,4,8,1758,1380,3138,2084
0130-001,2018,12,4,9,1897,1836,3733,3138
0130-001,2018,12,4,10,1687,1587,3274,3733
0130-001,2018,12,4,11,1709,1615,3324,3274
0130-001,2018,12,4,12,1673,1531,3204,3324
0130-001,2018,12,4,13,1438,1424,2862,3204
0130-001,2018,12,4,14,1719,1685,3404,2862
0130-001,2018,12,4,15,1689,1650,3339,3404
0130-001,2018,12,4,16,1656,1814,3470,3339
0130-001,2018,12,4,17,1618,1932,3550,3470
0130-001,2018,12,4,18,1636,2182,3818,3550
0130-001,2018,12,4,19,1593,2221,3814,3818
0130-001,2018,12,4,20,1197,1648,2845,3814
0130-001,2018,12,4,21,1028,1635,2663,2845
0130-001,2018,12,4,22,945,1019,1964,2663
0130-001,2018,12,4,23,720,723,1443,1964
0130-001,2018,12,4,24,488,439,927,1443
0130-001,2018,12,5,1,328,322,650,927
0130-001,2018,12,5,2,242,241,483,650
0130-001,2018,12,5,3,130,154,284,483
0130-001,2018,12,5,4,143,141,284,284
0130-001,2018,12,5,5,239,248,487,284
0130-001,2018,12,5,6,606,340,946,487
0130-001,2018,12,5,7,1482,687,2169,946
0130-001,2018,12,5,8,1854,1266,3120,2169
0130-001,2018,12,5,9,1880,1729,3609,3120
0130-001,2018,12,5,10,1789,1523,3312,3609
0130-001,2018,12,5,11,1670,1663,3333,3312
0130-001,2018,12,5,12,1664,1800,3464,3333
0130-001,2018,12,5,13,1410,1715,3125,3464
0130-001,2018,12,5,14,1755,1768,3523,3125
0130-001,2018,12,5,15,1666,1574,3240,3523
0130-001,2018,12,5,16,1673,1871,3544,3240
0130-001,2018,12,5,17,1602,1914,3516,3544
0130-001,2018,12,5,18,1720,2276,3996,3516
0130-001,2018,12,5,19,1625,2253,3878,3996
0130-001,2018,12,5,20,1210,1701,2911,3878
0130-001,2018,12,5,21,1022,1432,2454,2911
0130-001,2018,12,5,22,969,1085,2054,2454
0130-001,2018,12,5,23,742,713,1455,2054
0130-001,2018,12,5,24,513,481,994,1455
0130-001,2018,12,6,1,318,328,646,994
0130-001,2018,12,6,2,227,222,449,646
0130-001,2018,12,6,3,153,202,355,449
0130-001,2018,12,6,4,155,145,300,355
0130-001,2018,12,6,5,258,239,497,300
0130-001,2018,12,6,6,604,334,938,497
0130-001,2018,12,6,7,1555,760,2315,938
0130-001,2018,12,6,8,1722,1371,3093,2315
0130-001,2018,12,6,9,1832,1795,3627,3093
0130-001,2018,12,6,10,1795,1601,3396,3627
0130-001,2018,12,6,11,1724,1531,3255,3396
0130-001,2018,12,6,12,1587,1576,3163,3255
0130-001,2018,12,6,13,1387,1426,2813,3163
0130-001,2018,12,6,14,1353,1658,3011,2813
0130-001,2018,12,6,15,1607,1639,3246,3011
0130-001,2018,12,6,16,1643,1795,3438,3246
0130-001,2018,12,6,17,1579,1941,3520,3438
0130-001,2018,12,6,18,1664,2215,3879,3520
0130-001,2018,12,6,19,1583,2106,3689,3879
0130-001,2018,12,6,20,1203,1700,2903,3689
0130-001,2018,12,6,21,1005,1507,2512,2903
0130-001,2018,12,6,22,1010,1131,2141,2512
0130-001,2018,12,6,23,748,740,1488,2141
0130-001,2018,12,6,24,481,457,938,1488
0130-001,2018,12,7,1,350,333,683,938
0130-001,2018,12,7,2,208,188,396,683
0130-001,2018,12,7,3,156,165,321,396
0130-001,2018,12,7,4,146,167,313,321
0130-001,2018,12,7,5,247,223,470,313
0130-001,2018,12,7,6,606,316,922,470
0130-001,2018,12,7,7,1506,562,2068,922
0130-001,2018,12,7,8,1716,944,2660,2068
0130-001,2018,12,7,9,1762,1222,2984,2660
0130-001,2018,12,7,10,1667,1109,2776,2984
0130-001,2018,12,7,11,1448,1553,3001,2776
0130-001,2018,12,7,12,1004,1560,2564,3001
0130-001,2018,12,7,13,1342,1511,2853,2564
0130-001,2018,12,7,14,1530,1680,3210,2853
0130-001,2018,12,7,15,1594,1646,3240,3210
0130-001,2018,12,7,16,1807,1833,3640,3240
0130-001,2018,12,7,17,1729,1946,3675,3640
0130-001,2018,12,7,18,1796,2048,3844,3675
0130-001,2018,12,7,19,1747,1646,3393,3844
0130-001,2018,12,7,20,1318,1435,2753,3393
0130-001,2018,12,7,21,1074,956,2030,2753
0130-001,2018,12,7,22,1055,760,1815,2030
0130-001,2018,12,7,23,796,534,1330,1815
0130-001,2018,12,7,24,596,389,985,1330
0130-001,2018,12,8,1,439,287,726,985
0130-001,2018,12,8,2,311,192,503,726
0130-001,2018,12,8,3,218,156,374,503
0130-001,2018,12,8,4,197,128,325,374
0130-001,2018,12,8,5,245,178,423,325
0130-001,2018,12,8,6,431,222,653,423
0130-001,2018,12,8,7,886,370,1256,653
0130-001,2018,12,8,8,1175,596,1771,1256
0130-001,2018,12,8,9,1381,933,2314,1771
0130-001,2018,12,8,10,1508,1079,2587,2314
0130-001,2018,12,8,11,1630,1332,2962,2587
0130-001,2018,12,8,12,1688,1749,3437,2962
0130-001,2018,12,8,13,1651,1713,3364,3437
0130-001,2018,12,8,14,1753,1788,3541,3364
0130-001,2018,12,8,15,1720,1841,3561,3541
0130-001,2018,12,8,16,1751,1751,3502,3561
0130-001,2018,12,8,17,1762,1942,3704,3502
0130-001,2018,12,8,18,1697,1582,3279,3704
0130-001,2018,12,8,19,1646,1138,2784,3279
0130-001,2018,12,8,20,1279,780,2059,2784
0130-001,2018,12,8,21,1021,726,1747,2059
0130-001,2018,12,8,22,920,542,1462,1747
0130-001,2018,12,8,23,720,468,1188,1462
0130-001,2018,12,8,24,503,325,828,1188
0130-001,2018,12,9,1,387,260,647,828
0130-001,2018,12,9,2,298,189,487,647
0130-001,2018,12,9,3,248,162,410,487
0130-001,2018,12,9,4,178,128,306,410
0130-001,2018,12,9,5,209,101,310,306
0130-001,2018,12,9,6,254,150,404,310
0130-001,2018,12,9,7,499,234,733,404
0130-001,2018,12,9,8,564,322,886,733
0130-001,2018,12,9,9,720,516,1236,886
0130-001,2018,12,9,10,886,715,1601,1236
0130-001,2018,12,9,11,1156,939,2095,1601
0130-001,2018,12,9,12,1187,1275,2462,2095
0130-001,2018,12,9,13,1327,1306,2633,2462
0130-001,2018,12,9,14,1450,1428,2878,2633
0130-001,2018,12,9,15,1524,1495,3019,2878
0130-001,2018,12,9,16,1601,1459,3060,3019
0130-001,2018,12,9,17,1508,1568,3076,3060
0130-001,2018,12,9,18,1507,1496,3003,3076
0130-001,2018,12,9,19,1403,1018,2421,3003
0130-001,2018,12,9,20,1045,724,1769,2421
0130-001,2018,12,9,21,953,568,1521,1769
0130-001,2018,12,9,22,820,482,1302,1521
0130-001,2018,12,9,23,559,357,916,1302
0130-001,2018,12,9,24,394,214,608,916
0130-001,2018,12,10,1,238,152,390,608
0130-001,2018,12,10,2,145,85,230,390
0130-001,2018,12,10,3,125,85,210,230
0130-001,2018,12,10,4,127,88,215,210
0130-001,2018,12,10,5,245,171,416,215
0130-001,2018,12,10,6,663,233,896,416
0130-001,2018,12,10,7,1595,515,2110,896
0130-001,2018,12,10,8,1764,988,2752,2110
0130-001,2018,12,10,9,1931,1228,3159,2752
0130-001,2018,12,10,10,1632,1086,2718,3159
0130-001,2018,12,10,11,1673,1465,3138,2718
0130-001,2018,12,10,12,1562,1540,3102,3138
0130-001,2018,12,10,13,1490,1516,3006,3102
0130-001,2018,12,10,14,1696,1666,3362,3006
0130-001,2018,12,10,15,1776,1753,3529,3362
0130-001,2018,12,10,16,1774,1814,3588,3529
0130-001,2018,12,10,17,1637,1926,3563,3588
0130-001,2018,12,10,18,1707,2274,3981,3563
0130-001,2018,12,10,19,1621,2183,3804,3981
0130-001,2018,12,10,20,1273,1640,2913,3804
0130-001,2018,12,10,21,1008,1271,2279,2913
0130-001,2018,12,10,22,938,810,1748,2279
0130-001,2018,12,10,23,693,524,1217,1748
0130-001,2018,12,10,24,433,340,773,1217
0130-001,2018,12,11,1,278,225,503,773
0130-001,2018,12,11,2,193,145,338,503
0130-001,2018,12,11,3,132,124,256,338
0130-001,2018,12,11,4,141,143,284,256
0130-001,2018,12,11,5,264,221,485,284
0130-001,2018,12,11,6,601,287,888,485
0130-001,2018,12,11,7,1555,590,2145,888
0130-001,2018,12,11,8,1811,1137,2948,2145
0130-001,2018,12,11,9,1944,1470,3414,2948
0130-001,2018,12,11,10,1737,1427,3164,3414
0130-001,2018,12,11,11,1657,1313,2970,3164
0130-001,2018,12,11,12,1596,1367,2963,2970
0130-001,2018,12,11,13,1447,1711,3158,2963
0130-001,2018,12,11,14,1321,1612,2933,3158
0130-001,2018,12,11,15,1525,1727,3252,2933
0130-001,2018,12,11,16,1599,1675,3274,3252
0130-001,2018,12,11,17,1558,1860,3418,3274
0130-001,2018,12,11,18,1626,2228,3854,3418
0130-001,2018,12,11,19,1614,2233,3847,3854
0130-001,2018,12,11,20,1126,1613,2739,3847
0130-001,2018,12,11,21,1015,1488,2503,2739
0130-001,2018,12,11,22,903,1023,1926,2503
0130-001,2018,12,11,23,709,643,1352,1926
0130-001,2018,12,11,24,480,434,914,1352
0130-001,2018,12,12,1,296,273,569,914
0130-001,2018,12,12,2,210,158,368,569
0130-001,2018,12,12,3,159,146,305,368
0130-001,2018,12,12,4,146,133,279,305
0130-001,2018,12,12,5,261,217,478,279
0130-001,2018,12,12,6,589,272,861,478
0130-001,2018,12,12,7,1485,550,2035,861
0130-001,2018,12,12,8,1800,1034,2834,2035
0130-001,2018,12,12,9,1671,1332,3003,2834
0130-001,2018,12,12,10,1808,1258,3066,3003
0130-001,2018,12,12,11,1627,1695,3322,3066
0130-001,2018,12,12,12,1625,1674,3299,3322
0130-001,2018,12,12,13,1477,1608,3085,3299
0130-001,2018,12,12,14,1677,1755,3432,3085
0130-001,2018,12,12,15,1698,1780,3478,3432
0130-001,2018,12,12,16,1760,1800,3560,3478
0130-001,2018,12,12,17,1619,2003,3622,3560
0130-001,2018,12,12,18,1712,2310,4022,3622
0130-001,2018,12,12,19,1607,2105,3712,4022
0130-001,2018,12,12,20,1213,1711,2924,3712
0130-001,2018,12,12,21,1004,1258,2262,2924
0130-001,2018,12,12,22,1010,839,1849,2262
0130-001,2018,12,12,23,797,559,1356,1849
0130-001,2018,12,12,24,502,377,879,1356
0130-001,2018,12,13,1,331,249,580,879
0130-001,2018,12,13,2,229,174,403,580
0130-001,2018,12,13,3,175,164,339,403
0130-001,2018,12,13,4,144,154,298,339
0130-001,2018,12,13,5,277,218,495,298
0130-001,2018,12,13,6,615,303,918,495
0130-001,2018,12,13,7,1439,595,2034,918
0130-001,2018,12,13,8,1824,1147,2971,2034
0130-001,2018,12,13,9,1900,1489,3389,2971
0130-001,2018,12,13,10,1685,1445,3130,3389
0130-001,2018,12,13,11,1578,1514,3092,3130
0130-001,2018,12,13,12,1484,1546,3030,3092
0130-001,2018,12,13,13,1396,1403,2799,3030
0130-001,2018,12,13,14,1533,1592,3125,2799
0130-001,2018,12,13,15,1579,1595,3174,3125
0130-001,2018,12,13,16,1579,1598,3177,3174
0130-001,2018,12,13,17,1498,1813,3311,3177
0130-001,2018,12,13,18,1713,2110,3823,3311
0130-001,2018,12,13,19,1709,1983,3692,3823
0130-001,2018,12,13,20,1144,1346,2490,3692
0130-001,2018,12,13,21,975,1037,2012,2490
0130-001,2018,12,13,22,885,714,1599,2012
0130-001,2018,12,13,23,707,469,1176,1599
0130-001,2018,12,13,24,479,343,822,1176
0130-001,2018,12,14,1,318,233,551,822
0130-001,2018,12,14,2,258,138,396,551
0130-001,2018,12,14,3,181,118,299,396
0130-001,2018,12,14,4,160,145,305,299
0130-001,2018,12,14,5,248,182,430,305
0130-001,2018,12,14,6,542,223,765,430
0130-001,2018,12,14,7,1445,502,1947,765
0130-001,2018,12,14,8,1737,887,2624,1947
0130-001,2018,12,14,9,1759,1238,2997,2624
0130-001,2018,12,14,10,1679,992,2671,2997
0130-001,2018,12,14,11,1659,1316,2975,2671
0130-001,2018,12,14,12,1594,1724,3318,2975
0130-001,2018,12,14,13,1446,1598,3044,3318
0130-001,2018,12,14,14,1718,1788,3506,3044
0130-001,2018,12,14,15,1745,1780,3525,3506
0130-001,2018,12,14,16,1786,1861,3647,3525
0130-001,2018,12,14,17,1698,2030,3728,3647
0130-001,2018,12,14,18,1901,2187,4088,3728
0130-001,2018,12,14,19,1770,1939,3709,4088
0130-001,2018,12,14,20,1316,1404,2720,3709
0130-001,2018,12,14,21,1167,993,2160,2720
0130-001,2018,12,14,22,1031,723,1754,2160
0130-001,2018,12,14,23,860,496,1356,1754
0130-001,2018,12,14,24,640,383,1023,1356
0130-001,2018,12,15,1,447,280,727,1023
0130-001,2018,12,15,2,380,230,610,727
0130-001,2018,12,15,3,280,168,448,610
0130-001,2018,12,15,4,225,147,372,448
0130-001,2018,12,15,5,274,214,488,372
0130-001,2018,12,15,6,466,203,669,488
0130-001,2018,12,15,7,943,390,1333,669
0130-001,2018,12,15,8,1151,611,1762,1333
0130-001,2018,12,15,9,1340,893,2233,1762
0130-001,2018,12,15,10,1494,996,2490,2233
0130-001,2018,12,15,11,1675,1281,2956,2490
0130-001,2018,12,15,12,1730,1840,3570,2956
0130-001,2018,12,15,13,1605,1826,3431,3570
0130-001,2018,12,15,14,1720,1806,3526,3431
0130-001,2018,12,15,15,1783,1828,3611,3526
0130-001,2018,12,15,16,1803,1805,3608,3611
0130-001,2018,12,15,17,1853,1966,3819,3608
0130-001,2018,12,15,18,1616,2026,3642,3819
0130-001,2018,12,15,19,1561,1723,3284,3642
0130-001,2018,12,15,20,1276,1120,2396,3284
0130-001,2018,12,15,21,1036,825,1861,2396
0130-001,2018,12,15,22,984,612,1596,1861
0130-001,2018,12,15,23,719,433,1152,1596
0130-001,2018,12,15,24,570,321,891,1152
0130-001,2018,12,16,1,424,273,697,891
0130-001,2018,12,16,2,355,217,572,697
0130-001,2018,12,16,3,282,178,460,572
0130-001,2018,12,16,4,227,129,356,460
0130-001,2018,12,16,5,191,137,328,356
0130-001,2018,12,16,6,273,166,439,328
0130-001,2018,12,16,7,497,258,755,439
0130-001,2018,12,16,8,582,400,982,755
0130-001,2018,12,16,9,709,579,1288,982
0130-001,2018,12,16,10,911,793,1704,1288
0130-001,2018,12,16,11,1136,1290,2426,1704
0130-001,2018,12,16,12,1169,1404,2573,2426
0130-001,2018,12,16,13,1298,1514,2812,2573
0130-001,2018,12,16,14,1499,1651,3150,2812
0130-001,2018,12,16,15,1621,1617,3238,3150
0130-001,2018,12,16,16,1661,1640,3301,3238
0130-001,2018,12,16,17,1706,1594,3300,3301
0130-001,2018,12,16,18,1664,1536,3200,3300
0130-001,2018,12,16,19,1453,1178,2631,3200
0130-001,2018,12,16,20,1146,1000,2146,2631
0130-001,2018,12,16,21,1082,801,1883,2146
0130-001,2018,12,16,22,784,559,1343,1883
0130-001,2018,12,16,23,580,474,1054,1343
0130-001,2018,12,16,24,419,344,763,1054
0130-001,2018,12,17,1,255,211,466,763
0130-001,2018,12,17,2,172,149,321,466
0130-001,2018,12,17,3,119,112,231,321
0130-001,2018,12,17,4,125,140,265,231
0130-001,2018,12,17,5,256,217,473,265
0130-001,2018,12,17,6,629,335,964,473
0130-001,2018,12,17,7,1618,727,2345,964
0130-001,2018,12,17,8,1723,1312,3035,2345
0130-001,2018,12,17,9,1932,1665,3597,3035
0130-001,2018,12,17,10,1700,1542,3242,3597
0130-001,2018,12,17,11,1583,1634,3217,3242
0130-001,2018,12,17,12,1548,1722,3270,3217
0130-001,2018,12,17,13,1423,1599,3022,3270
0130-001,2018,12,17,14,1686,1700,3386,3022
0130-001,2018,12,17,15,1784,1754,3538,3386
0130-001,2018,12,17,16,1760,1847,3607,3538
0130-001,2018,12,17,17,1561,2046,3607,3607
0130-001,2018,12,17,18,1649,2312,3961,3607
0130-001,2018,12,17,19,1556,2177,3733,3961
0130-001,2018,12,17,20,1109,1642,2751,3733
0130-001,2018,12,17,21,989,1538,2527,2751
0130-001,2018,12,17,22,911,1047,1958,2527
0130-001,2018,12,17,23,707,685,1392,1958
0130-001,2018,12,17,24,430,445,875,1392
0130-001,2018,12,18,1,283,281,564,875
0130-001,2018,12,18,2,207,206,413,564
0130-001,2018,12,18,3,152,147,299,413
0130-001,2018,12,18,4,174,134,308,299
0130-001,2018,12,18,5,237,213,450,308
0130-001,2018,12,18,6,566,280,846,450
0130-001,2018,12,18,7,1586,535,2121,846
0130-001,2018,12,18,8,1760,1036,2796,2121
0130-001,2018,12,18,9,1995,1474,3469,2796
0130-001,2018,12,18,10,1722,1488,3210,3469
0130-001,2018,12,18,11,1729,1609,3338,3210
0130-001,2018,12,18,12,1564,1591,3155,3338
0130-001,2018,12,18,13,1382,1471,2853,3155
0130-001,2018,12,18,14,1740,1705,3445,2853
0130-001,2018,12,18,15,1732,1695,3427,3445
0130-001,2018,12,18,16,1724,1783,3507,3427
0130-001,2018,12,18,17,1589,1994,3583,3507
0130-001,2018,12,18,18,1721,2305,4026,3583
0130-001,2018,12,18,19,1608,2263,3871,4026
0130-001,2018,12,18,20,1134,1610,2744,3871
0130-001,2018,12,18,21,988,1533,2521,2744
0130-001,2018,12,18,22,997,1127,2124,2521
0130-001,2018,12,18,23,743,752,1495,2124
0130-001,2018,12,18,24,467,430,897,1495
0130-001,2018,12,19,1,358,331,689,897
0130-001,2018,12,19,2,205,221,426,689
0130-001,2018,12,19,3,155,178,333,426
0130-001,2018,12,19,4,167,162,329,333
0130-001,2018,12,19,5,282,257,539,329
0130-001,2018,12,19,6,625,359,984,539
0130-001,2018,12,19,7,1449,756,2205,984
0130-001,2018,12,19,8,1861,1397,3258,2205
0130-001,2018,12,19,9,1890,1808,3698,3258
0130-001,2018,12,19,10,1748,1570,3318,3698
0130-001,2018,12,19,11,1763,1632,3395,3318
0130-001,2018,12,19,12,1617,1653,3270,3395
0130-001,2018,12,19,13,1442,1504,2946,3270
0130-001,2018,12,19,14,1656,1567,3223,2946
0130-001,2018,12,19,15,1776,1807,3583,3223
0130-001,2018,12,19,16,1690,1819,3509,3583
0130-001,2018,12,19,17,1594,2062,3656,3509
0130-001,2018,12,19,18,1679,2365,4044,3656
0130-001,2018,12,19,19,1613,2262,3875,4044
0130-001,2018,12,19,20,1151,1683,2834,3875
0130-001,2018,12,19,21,959,1478,2437,2834
0130-001,2018,12,19,22,1062,1058,2120,2437
0130-001,2018,12,19,23,781,717,1498,2120
0130-001,2018,12,19,24,490,461,951,1498
0130-001,2018,12,20,1,407,358,765,951
0130-001,2018,12,20,2,241,207,448,765
0130-001,2018,12,20,3,187,184,371,448
0130-001,2018,12,20,4,166,170,336,371
0130-001,2018,12,20,5,263,261,524,336
0130-001,2018,12,20,6,608,325,933,524
0130-001,2018,12,20,7,1528,712,2240,933
0130-001,2018,12,20,8,1811,1358,3169,2240
0130-001,2018,12,20,9,1892,1837,3729,3169
0130-001,2018,12,20,10,1702,1519,3221,3729
0130-001,2018,12,20,11,1696,1699,3395,3221
0130-001,2018,12,20,12,1685,1884,3569,3395
0130-001,2018,12,20,13,1562,1820,3382,3569
0130-001,2018,12,20,14,1594,1766,3360,3382
0130-001,2018,12,20,15,1616,1756,3372,3360
0130-001,2018,12,20,16,1778,1779,3557,3372
0130-001,2018,12,20,17,1674,1998,3672,3557
0130-001,2018,12,20,18,1725,2249,3974,3672
0130-001,2018,12,20,19,1529,2092,3621,3974
0130-001,2018,12,20,20,1159,1722,2881,3621
0130-001,2018,12,20,21,1113,1503,2616,2881
0130-001,2018,12,20,22,986,1133,2119,2616
0130-001,2018,12,20,23,775,728,1503,2119
0130-001,2018,12,20,24,552,513,1065,1503
0130-001,2018,12,21,1,374,323,697,1065
0130-001,2018,12,21,2,234,220,454,697
0130-001,2018,12,21,3,195,176,371,454
0130-001,2018,12,21,4,164,146,310,371
0130-001,2018,12,21,5,247,232,479,310
0130-001,2018,12,21,6,611,297,908,479
0130-001,2018,12,21,7,1515,567,2082,908
0130-001,2018,12,21,8,1798,1153,2951,2082
0130-001,2018,12,21,9,1978,1555,3533,2951
0130-001,2018,12,21,10,1697,1546,3243,3533
0130-001,2018,12,21,11,1716,1737,3453,3243
0130-001,2018,12,21,12,1614,1699,3313,3453
0130-001,2018,12,21,13,1548,1593,3141,3313
0130-001,2018,12,21,14,1685,1769,3454,3141
0130-001,2018,12,21,15,1864,1803,3667,3454
0130-001,2018,12,21,16,1831,1964,3795,3667
0130-001,2018,12,21,17,1774,2124,3898,3795
0130-001,2018,12,21,18,1813,2336,4149,3898
0130-001,2018,12,21,19,1707,2188,3895,4149
0130-001,2018,12,21,20,1341,1825,3166,3895
0130-001,2018,12,21,21,1225,1550,2775,3166
0130-001,2018,12,21,22,1112,1201,2313,2775
0130-001,2018,12,21,23,937,863,1800,2313
0130-001,2018,12,21,24,606,551,1157,1800
0130-001,2018,12,22,1,509,402,911,1157
0130-001,2018,12,22,2,382,321,703,911
0130-001,2018,12,22,3,272,276,548,703
0130-001,2018,12,22,4,208,219,427,548
0130-001,2018,12,22,5,310,297,607,427
0130-001,2018,12,22,6,493,353,846,607
0130-001,2018,12,22,7,950,554,1504,846
0130-001,2018,12,22,8,1219,913,2132,1504
0130-001,2018,12,22,9,1426,1414,2840,2132
0130-001,2018,12,22,10,1568,1642,3210,2840
0130-001,2018,12,22,11,1622,1795,3417,3210
0130-001,2018,12,22,12,1660,1847,3507,3417
0130-001,2018,12,22,13,1681,1822,3503,3507
0130-001,2018,12,22,14,1753,1778,3531,3503
0130-001,2018,12,22,15,1838,1835,3673,3531
0130-001,2018,12,22,16,1827,1857,3684,3673
0130-001,2018,12,22,17,1742,2001,3743,3684
0130-001,2018,12,22,18,1860,2136,3996,3743
0130-001,2018,12,22,19,1663,1707,3370,3996
0130-001,2018,12,22,20,1245,1173,2418,3370
0130-001,2018,12,22,21,985,1060,2045,2418
0130-001,2018,12,22,22,932,861,1793,2045
0130-001,2018,12,22,23,824,663,1487,1793
0130-001,2018,12,22,24,556,455,1011,1487
0130-001,2018,12,23,1,432,366,798,1011
0130-001,2018,12,23,2,311,274,585,798
0130-001,2018,12,23,3,282,220,502,585
0130-001,2018,12,23,4,193,170,363,502
0130-001,2018,12,23,5,195,190,385,363
0130-001,2018,12,23,6,263,237,500,385
0130-001,2018,12,23,7,522,389,911,500
0130-001,2018,12,23,8,580,506,1086,911
0130-001,2018,12,23,9,746,734,1480,1086
0130-001,2018,12,23,10,907,1039,1946,1480
0130-001,2018,12,23,11,1176,1234,2410,1946
0130-001,2018,12,23,12,1240,1312,2552,2410
0130-001,2018,12,23,13,1288,1290,2578,2552
0130-001,2018,12,23,14,1382,1445,2827,2578
0130-001,2018,12,23,15,1445,1492,2937,2827
0130-001,2018,12,23,16,1488,1534,3022,2937
0130-001,2018,12,23,17,1525,1536,3061,3022
0130-001,2018,12,23,18,1463,1498,2961,3061
0130-001,2018,12,23,19,1347,1242,2589,2961
0130-001,2018,12,23,20,1110,941,2051,2589
0130-001,2018,12,23,21,978,835,1813,2051
0130-001,2018,12,23,22,792,682,1474,1813
0130-001,2018,12,23,23,567,482,1049,1474
0130-001,2018,12,23,24,388,316,704,1049
0130-001,2018,12,24,1,243,176,419,704
0130-001,2018,12,24,2,172,183,355,419
0130-001,2018,12,24,3,130,104,234,355
0130-001,2018,12,24,4,150,136,286,234
0130-001,2018,12,24,5,270,213,483,286
0130-001,2018,12,24,6,570,257,827,483
0130-001,2018,12,24,7,1445,615,2060,827
0130-001,2018,12,24,8,1866,1112,2978,2060
0130-001,2018,12,24,9,1707,1419,3126,2978
0130-001,2018,12,24,10,1596,1384,2980,3126
0130-001,2018,12,24,11,1658,1729,3387,2980
0130-001,2018,12,24,12,1715,1761,3476,3387
0130-001,2018,12,24,13,1621,1602,3223,3476
0130-001,2018,12,24,14,1852,1871,3723,3223
0130-001,2018,12,24,15,1912,1877,3789,3723
0130-001,2018,12,24,16,1903,1993,3896,3789
0130-001,2018,12,24,17,1814,2111,3925,3896
0130-001,2018,12,24,18,1823,2323,4146,3925
0130-001,2018,12,24,19,1814,2309,4123,4146
0130-001,2018,12,24,20,1391,1806,3197,4123
0130-001,2018,12,24,21,1101,1349,2450,3197
0130-001,2018,12,24,22,1032,930,1962,2450
0130-001,2018,12,24,23,806,619,1425,1962
0130-001,2018,12,24,24,524,412,936,1425
0130-001,2018,12,25,1,379,299,678,936
0130-001,2018,12,25,2,305,213,518,678
0130-001,2018,12,25,3,272,210,482,518
0130-001,2018,12,25,4,188,195,383,482
0130-001,2018,12,25,5,258,222,480,383
0130-001,2018,12,25,6,460,244,704,480
0130-001,2018,12,25,7,755,381,1136,704
0130-001,2018,12,25,8,937,584,1521,1136
0130-001,2018,12,25,9,847,729,1576,1521
0130-001,2018,12,25,10,1033,870,1903,1576
0130-001,2018,12,25,11,1268,1312,2580,1903
0130-001,2018,12,25,12,1141,1328,2469,2580
0130-001,2018,12,25,13,1332,1531,2863,2469
0130-001,2018,12,25,14,1484,1652,3136,2863
0130-001,2018,12,25,15,1450,1565,3015,3136
0130-001,2018,12,25,16,1609,1491,3100,3015
0130-001,2018,12,25,17,1534,1664,3198,3100
0130-001,2018,12,25,18,1501,1636,3137,3198
0130-001,2018,12,25,19,1402,1221,2623,3137
0130-001,2018,12,25,20,1043,998,2041,2623
0130-001,2018,12,25,21,1064,849,1913,2041
0130-001,2018,12,25,22,794,656,1450,1913
0130-001,2018,12,25,23,595,553,1148,1450
0130-001,2018,12,25,24,412,323,735,1148
0130-001,2018,12,26,1,269,224,493,735
0130-001,2018,12,26,2,177,151,328,493
0130-001,2018,12,26,3,133,137,270,328
0130-001,2018,12,26,4,152,149,301,270
0130-001,2018,12,26,5,277,217,494,301
0130-001,2018,12,26,6,622,318,940,494
0130-001,2018,12,26,7,1539,714,2253,940
0130-001,2018,12,26,8,1831,1340,3171,2253
0130-001,2018,12,26,9,1921,1786,3707,3171
0130-001,2018,12,26,10,1666,1467,3133,3707
0130-001,2018,12,26,11,1764,1653,3417,3133
0130-001,2018,12,26,12,1601,1616,3217,3417
0130-001,2018,12,26,13,1451,1481,2932,3217
0130-001,2018,12,26,14,1659,1789,3448,2932
0130-001,2018,12,26,15,1716,1848,3564,3448
0130-001,2018,12,26,16,1830,1844,3674,3564
0130-001,2018,12,26,17,1682,2052,3734,3674
0130-001,2018,12,26,18,1651,2357,4008,3734
0130-001,2018,12,26,19,1553,2243,3796,4008
0130-001,2018,12,26,20,1178,1603,2781,3796
0130-001,2018,12,26,21,978,1393,2371,2781
0130-001,2018,12,26,22,933,907,1840,2371
0130-001,2018,12,26,23,735,691,1426,1840
0130-001,2018,12,26,24,531,460,991,1426
0130-001,2018,12,27,1,375,308,683,991
0130-001,2018,12,27,2,252,213,465,683
0130-001,2018,12,27,3,166,187,353,465
0130-001,2018,12,27,4,167,149,316,353
0130-001,2018,12,27,5,260,218,478,316
0130-001,2018,12,27,6,554,308,862,478
0130-001,2018,12,27,7,1369,553,1922,862
0130-001,2018,12,27,8,1873,1132,3005,1922
0130-001,2018,12,27,9,1808,1489,3297,3005
0130-001,2018,12,27,10,1598,1190,2788,3297
0130-001,2018,12,27,11,1594,1423,3017,2788
0130-001,2018,12,27,12,1565,1591,3156,3017
0130-001,2018,12,27,13,1473,1398,2871,3156
0130-001,2018,12,27,14,1604,1661,3265,2871
0130-001,2018,12,27,15,1675,1724,3399,3265
0130-001,2018,12,27,16,1771,1802,3573,3399
0130-001,2018,12,27,17,1654,1856,3510,3573
0130-001,2018,12,27,18,1660,1897,3557,3510
0130-001,2018,12,27,19,1535,1603,3138,3557
0130-001,2018,12,27,20,1183,1330,2513,3138
0130-001,2018,12,27,21,1047,1113,2160,2513
0130-001,2018,12,27,22,933,816,1749,2160
0130-001,2018,12,27,23,720,656,1376,1749
0130-001,2018,12,27,24,511,421,932,1376
0130-001,2018,12,28,1,378,325,703,932
0130-001,2018,12,28,2,249,197,446,703
0130-001,2018,12,28,3,162,167,329,446
0130-001,2018,12,28,4,155,171,326,329
0130-001,2018,12,28,5,264,193,457,326
0130-001,2018,12,28,6,523,259,782,457
0130-001,2018,12,28,7,1348,552,1900,782
0130-001,2018,12,28,8,1818,1024,2842,1900
0130-001,2018,12,28,9,1817,1447,3264,2842
0130-001,2018,12,28,10,1665,1214,2879,3264
0130-001,2018,12,28,11,1599,1355,2954,2879
0130-001,2018,12,28,12,1684,1520,3204,2954
0130-001,2018,12,28,13,1497,1560,3057,3204
0130-001,2018,12,28,14,1693,1797,3490,3057
0130-001,2018,12,28,15,1748,1809,3557,3490
0130-001,2018,12,28,16,1834,1862,3696,3557
0130-001,2018,12,28,17,1729,1957,3686,3696
0130-001,2018,12,28,18,1796,1796,3592,3686
0130-001,2018,12,28,19,1651,1525,3176,3592
0130-001,2018,12,28,20,1274,1314,2588,3176
0130-001,2018,12,28,21,1044,1037,2081,2588
0130-001,2018,12,28,22,1005,815,1820,2081
0130-001,2018,12,28,23,834,599,1433,1820
0130-001,2018,12,28,24,630,464,1094,1433
0130-001,2018,12,29,1,470,314,784,1094
0130-001,2018,12,29,2,354,243,597,784
0130-001,2018,12,29,3,281,226,507,597
0130-001,2018,12,29,4,204,184,388,507
0130-001,2018,12,29,5,240,201,441,388
0130-001,2018,12,29,6,450,259,709,441
0130-001,2018,12,29,7,761,403,1164,709
0130-001,2018,12,29,8,1056,591,1647,1164
0130-001,2018,12,29,9,1233,901,2134,1647
0130-001,2018,12,29,10,1347,1140,2487,2134
0130-001,2018,12,29,11,1515,1329,2844,2487
0130-001,2018,12,29,12,1610,1636,3246,2844
0130-001,2018,12,29,13,1767,1787,3554,3246
0130-001,2018,12,29,14,1647,1891,3538,3554
0130-001,2018,12,29,15,1685,1776,3461,3538
0130-001,2018,12,29,16,1715,1738,3453,3461
0130-001,2018,12,29,17,1693,1751,3444,3453
0130-001,2018,12,29,18,1681,1705,3386,3444
0130-001,2018,12,29,19,1516,1280,2796,3386
0130-001,2018,12,29,20,1128,940,2068,2796
0130-001,2018,12,29,21,899,796,1695,2068
0130-001,2018,12,29,22,900,635,1535,1695
0130-001,2018,12,29,23,650,505,1155,1535
0130-001,2018,12,29,24,474,377,851,1155
0130-001,2018,12,30,1,411,282,693,851
0130-001,2018,12,30,2,314,223,537,693
0130-001,2018,12,30,3,227,152,379,537
0130-001,2018,12,30,4,195,126,321,379
0130-001,2018,12,30,5,205,138,343,321
0130-001,2018,12,30,6,282,159,441,343
0130-001,2018,12,30,7,444,235,679,441
0130-001,2018,12,30,8,478,368,846,679
0130-001,2018,12,30,9,634,548,1182,846
0130-001,2018,12,30,10,847,782,1629,1182
0130-001,2018,12,30,11,1103,1060,2163,1629
0130-001,2018,12,30,12,1085,1229,2314,2163
0130-001,2018,12,30,13,1213,1399,2612,2314
0130-001,2018,12,30,14,1359,1487,2846,2612
0130-001,2018,12,30,15,1443,1512,2955,2846
0130-001,2018,12,30,16,1571,1539,3110,2955
0130-001,2018,12,30,17,1586,1523,3109,3110
0130-001,2018,12,30,18,1497,1396,2893,3109
0130-001,2018,12,30,19,1467,1069,2536,2893
0130-001,2018,12,30,20,1030,812,1842,2536
0130-001,2018,12,30,21,936,671,1607,1842
0130-001,2018,12,30,22,769,506,1275,1607
0130-001,2018,12,30,23,648,398,1046,1275
0130-001,2018,12,30,24,384,286,670,1046
0130-001,2018,12,31,1,254,195,449,670
0130-001,2018,12,31,2,197,135,332,449
0130-001,2018,12,31,3,155,118,273,332
0130-001,2018,12,31,4,144,108,252,273
0130-001,2018,12,31,5,185,172,357,252
0130-001,2018,12,31,6,410,223,633,357
0130-001,2018,12,31,7,1026,401,1427,633
0130-001,2018,12,31,8,1636,827,2463,1427
0130-001,2018,12,31,9,1686,1178,2864,2463
0130-001,2018,12,31,10,1513,1130,2643,2864
0130-001,2018,12,31,11,1584,1333,2917,2643
0130-001,2018,12,31,12,1691,1657,3348,2917
0130-001,2018,12,31,13,1604,1653,3257,3348
0130-001,2018,12,31,14,1758,1794,3552,3257
0130-001,2018,12,31,15,1905,1909,3814,3552
0130-001,2018,12,31,16,1996,2103,4099,3814
0130-001,2018,12,31,17,1819,2075,3894,4099
0130-001,2018,12,31,18,1882,2137,4019,3894
0130-001,2018,12,31,19,1712,1874,3586,4019
0130-001,2018,12,31,20,1256,1149,2405,3586
0130-001,2018,12,31,21,1033,873,1906,2405
0130-001,2018,12,31,22,851,695,1546,1906
0130-001,2018,12,31,23,712,596,1308,1546
0130-001,2018,12,31,24,514,404,918,1308
