ID,Year,M,D,H,1,2,sum,sump
3404-001,2012,10,9,11,508,458,966,0
3404-001,2012,10,9,12,441,459,900,966
3404-001,2012,10,9,13,375,359,734,900
3404-001,2012,10,9,14,468,440,908,734
3404-001,2012,10,9,15,564,510,1074,908
3404-001,2012,10,9,16,530,447,977,1074
3404-001,2012,10,9,17,608,448,1056,977
3404-001,2012,10,9,18,854,472,1326,1056
3404-001,2012,10,9,19,856,418,1274,1326
3404-001,2012,10,9,20,589,322,911,1274
3404-001,2012,10,9,21,636,246,882,911
3404-001,2012,10,9,22,361,191,552,882
3404-001,2012,10,9,23,215,129,344,552
3404-001,2012,10,9,24,120,83,203,344
3404-001,2012,10,10,1,40,51,91,203
3404-001,2012,10,10,2,31,35,66,91
3404-001,2012,10,10,3,34,29,63,66
3404-001,2012,10,10,4,23,27,50,63
3404-001,2012,10,10,5,44,45,89,50
3404-001,2012,10,10,6,64,83,147,89
3404-001,2012,10,10,7,96,230,326,147
3404-001,2012,10,10,8,202,709,911,326
3404-001,2012,10,10,9,338,671,1009,911
3404-001,2012,10,10,10,389,440,829,1009
3404-001,2012,10,10,11,411,455,866,829
3404-001,2012,10,10,12,434,429,863,866
3404-001,2012,10,10,13,376,378,754,863
3404-001,2012,10,10,14,421,407,828,754
3404-001,2012,10,10,15,535,467,1002,828
3404-001,2012,10,10,16,553,456,1009,1002
3404-001,2012,10,10,17,571,432,1003,1009
3404-001,2012,10,10,18,988,463,1451,1003
3404-001,2012,10,10,19,896,435,1331,1451
3404-001,2012,10,10,20,615,321,936,1331
3404-001,2012,10,10,21,498,250,748,936
3404-001,2012,10,10,22,278,179,457,748
3404-001,2012,10,10,23,155,129,284,457
3404-001,2012,10,10,24,105,74,179,284
3404-001,2012,10,11,1,51,47,98,179
3404-001,2012,10,11,2,37,36,73,98
3404-001,2012,10,11,3,47,31,78,73
3404-001,2012,10,11,4,27,30,57,78
3404-001,2012,10,11,5,25,42,67,57
3404-001,2012,10,11,6,62,99,161,67
3404-001,2012,10,11,7,97,235,332,161
3404-001,2012,10,11,8,235,794,1029,332
3404-001,2012,10,11,9,362,676,1038,1029
3404-001,2012,10,11,10,421,465,886,1038
3404-001,2012,10,11,11,445,441,886,886
3404-001,2012,10,11,12,494,451,945,886
3404-001,2012,10,11,13,370,388,758,945
3404-001,2012,10,11,14,494,447,941,758
3404-001,2012,10,11,15,463,484,947,941
3404-001,2012,10,11,16,499,454,953,947
3404-001,2012,10,11,17,546,447,993,953
3404-001,2012,10,11,18,855,469,1324,993
3404-001,2012,10,11,19,1217,452,1669,1324
3404-001,2012,10,11,20,570,346,916,1669
3404-001,2012,10,11,21,562,262,824,916
3404-001,2012,10,11,22,388,214,602,824
3404-001,2012,10,11,23,201,130,331,602
3404-001,2012,10,11,24,116,91,207,331
3404-001,2012,10,12,1,72,66,138,207
3404-001,2012,10,12,2,34,39,73,138
3404-001,2012,10,12,3,33,34,67,73
3404-001,2012,10,12,4,49,33,82,67
3404-001,2012,10,12,5,45,49,94,82
3404-001,2012,10,12,6,70,90,160,94
3404-001,2012,10,12,7,123,292,415,160
3404-001,2012,10,12,8,239,766,1005,415
3404-001,2012,10,12,9,366,691,1057,1005
3404-001,2012,10,12,10,387,505,892,1057
3404-001,2012,10,12,11,500,486,986,892
3404-001,2012,10,12,12,517,472,989,986
3404-001,2012,10,12,13,437,408,845,989
3404-001,2012,10,12,14,525,457,982,845
3404-001,2012,10,12,15,560,515,1075,982
3404-001,2012,10,12,16,707,511,1218,1075
3404-001,2012,10,12,17,658,471,1129,1218
3404-001,2012,10,12,18,1031,513,1544,1129
3404-001,2012,10,12,19,1037,505,1542,1544
3404-001,2012,10,12,20,792,390,1182,1542
3404-001,2012,10,12,21,584,267,851,1182
3404-001,2012,10,12,22,401,199,600,851
3404-001,2012,10,12,23,267,140,407,600
3404-001,2012,10,12,24,96,107,203,407
3404-001,2012,10,13,1,66,47,113,203
3404-001,2012,10,13,2,44,36,80,113
3404-001,2012,10,13,3,42,31,73,80
3404-001,2012,10,13,4,42,25,67,73
3404-001,2012,10,13,5,30,33,63,67
3404-001,2012,10,13,6,59,80,139,63
3404-001,2012,10,13,7,102,158,260,139
3404-001,2012,10,13,8,140,344,484,260
3404-001,2012,10,13,9,298,363,661,484
3404-001,2012,10,13,10,256,292,548,661
3404-001,2012,10,13,11,307,285,592,548
3404-001,2012,10,13,12,274,281,555,592
3404-001,2012,10,13,13,340,250,590,555
3404-001,2012,10,13,14,326,296,622,590
3404-001,2012,10,13,15,323,275,598,622
3404-001,2012,10,13,16,310,261,571,598
3404-001,2012,10,13,17,448,283,731,571
3404-001,2012,10,13,18,584,335,919,731
3404-001,2012,10,13,19,378,260,638,919
3404-001,2012,10,13,20,205,188,393,638
3404-001,2012,10,13,21,160,135,295,393
3404-001,2012,10,13,22,114,108,222,295
3404-001,2012,10,13,23,54,60,114,222
3404-001,2012,10,13,24,56,55,111,114
3404-001,2012,10,14,1,26,21,47,111
3404-001,2012,10,14,2,17,16,33,47
3404-001,2012,10,14,3,19,12,31,33
3404-001,2012,10,14,4,12,10,22,31
3404-001,2012,10,14,5,9,10,19,22
3404-001,2012,10,14,6,12,24,36,19
3404-001,2012,10,14,7,39,58,97,36
3404-001,2012,10,14,8,51,103,154,97
3404-001,2012,10,14,9,87,99,186,154
3404-001,2012,10,14,10,79,103,182,186
3404-001,2012,10,14,11,106,122,228,182
3404-001,2012,10,14,12,99,113,212,228
3404-001,2012,10,14,13,102,114,216,212
3404-001,2012,10,14,14,125,112,237,216
3404-001,2012,10,14,15,157,132,289,237
3404-001,2012,10,14,16,201,135,336,289
3404-001,2012,10,14,17,213,133,346,336
3404-001,2012,10,14,18,228,144,372,346
3404-001,2012,10,14,19,184,129,313,372
3404-001,2012,10,14,20,123,95,218,313
3404-001,2012,10,14,21,79,82,161,218
3404-001,2012,10,14,22,64,74,138,161
3404-001,2012,10,14,23,34,43,77,138
3404-001,2012,10,14,24,17,32,49,77
3404-001,2012,10,15,1,51,47,98,49
3404-001,2012,10,15,2,21,31,52,98
3404-001,2012,10,15,3,12,22,34,52
3404-001,2012,10,15,4,11,23,34,34
3404-001,2012,10,15,5,29,35,64,34
3404-001,2012,10,15,6,74,98,172,64
3404-001,2012,10,15,7,126,293,419,172
3404-001,2012,10,15,8,207,853,1060,419
3404-001,2012,10,15,9,288,696,984,1060
3404-001,2012,10,15,10,372,437,809,984
3404-001,2012,10,15,11,516,477,993,809
3404-001,2012,10,15,12,476,431,907,993
3404-001,2012,10,15,13,429,398,827,907
3404-001,2012,10,15,14,520,452,972,827
3404-001,2012,10,15,15,479,475,954,972
3404-001,2012,10,15,16,507,473,980,954
3404-001,2012,10,15,17,565,455,1020,980
3404-001,2012,10,15,18,759,468,1227,1020
3404-001,2012,10,15,19,911,431,1342,1227
3404-001,2012,10,15,20,631,338,969,1342
3404-001,2012,10,15,21,630,267,897,969
3404-001,2012,10,15,22,415,211,626,897
3404-001,2012,10,15,23,196,125,321,626
3404-001,2012,10,15,24,89,69,158,321
3404-001,2012,10,16,1,66,63,129,158
3404-001,2012,10,16,2,32,32,64,129
3404-001,2012,10,16,3,36,31,67,64
3404-001,2012,10,16,4,27,28,55,67
3404-001,2012,10,16,5,34,42,76,55
3404-001,2012,10,16,6,88,105,193,76
3404-001,2012,10,16,7,85,272,357,193
3404-001,2012,10,16,8,228,773,1001,357
3404-001,2012,10,16,9,349,679,1028,1001
3404-001,2012,10,16,10,428,461,889,1028
3404-001,2012,10,16,11,470,494,964,889
3404-001,2012,10,16,12,438,433,871,964
3404-001,2012,10,16,13,442,366,808,871
3404-001,2012,10,16,14,430,441,871,808
3404-001,2012,10,16,15,492,461,953,871
3404-001,2012,10,16,16,570,482,1052,953
3404-001,2012,10,16,17,600,463,1063,1052
3404-001,2012,10,16,18,882,465,1347,1063
3404-001,2012,10,16,19,932,431,1363,1347
3404-001,2012,10,16,20,553,341,894,1363
3404-001,2012,10,16,21,583,277,860,894
3404-001,2012,10,16,22,377,219,596,860
3404-001,2012,10,16,23,191,131,322,596
3404-001,2012,10,16,24,132,75,207,322
3404-001,2012,10,17,1,67,62,129,207
3404-001,2012,10,17,2,33,37,70,129
3404-001,2012,10,17,3,36,28,64,70
3404-001,2012,10,17,4,17,24,41,64
3404-001,2012,10,17,5,47,40,87,41
3404-001,2012,10,17,6,54,83,137,87
3404-001,2012,10,17,7,96,230,326,137
3404-001,2012,10,17,8,182,697,879,326
3404-001,2012,10,17,9,344,667,1011,879
3404-001,2012,10,17,10,397,428,825,1011
3404-001,2012,10,17,11,468,440,908,825
3404-001,2012,10,17,12,481,433,914,908
3404-001,2012,10,17,13,350,382,732,914
3404-001,2012,10,17,14,391,410,801,732
3404-001,2012,10,17,15,541,486,1027,801
3404-001,2012,10,17,16,486,441,927,1027
3404-001,2012,10,17,17,550,435,985,927
3404-001,2012,10,17,18,900,495,1395,985
3404-001,2012,10,17,19,973,412,1385,1395
3404-001,2012,10,17,20,624,328,952,1385
3404-001,2012,10,17,21,600,275,875,952
3404-001,2012,10,17,22,310,171,481,875
3404-001,2012,10,17,23,168,123,291,481
3404-001,2012,10,17,24,77,71,148,291
3404-001,2012,10,18,1,53,49,102,148
3404-001,2012,10,18,2,38,37,75,102
3404-001,2012,10,18,3,40,27,67,75
3404-001,2012,10,18,4,24,27,51,67
3404-001,2012,10,18,5,28,48,76,51
3404-001,2012,10,18,6,64,103,167,76
3404-001,2012,10,18,7,114,275,389,167
3404-001,2012,10,18,8,275,930,1205,389
3404-001,2012,10,18,9,406,759,1165,1205
3404-001,2012,10,18,10,430,476,906,1165
3404-001,2012,10,18,11,467,463,930,906
3404-001,2012,10,18,12,478,437,915,930
3404-001,2012,10,18,13,370,389,759,915
3404-001,2012,10,18,14,481,436,917,759
3404-001,2012,10,18,15,457,478,935,917
3404-001,2012,10,18,16,511,465,976,935
3404-001,2012,10,18,17,532,436,968,976
3404-001,2012,10,18,18,775,425,1200,968
3404-001,2012,10,18,19,983,365,1348,1200
3404-001,2012,10,18,20,499,303,802,1348
3404-001,2012,10,18,21,460,215,675,802
3404-001,2012,10,18,22,322,178,500,675
3404-001,2012,10,18,23,178,115,293,500
3404-001,2012,10,18,24,99,78,177,293
3404-001,2012,10,19,1,63,58,121,177
3404-001,2012,10,19,2,39,45,84,121
3404-001,2012,10,19,3,29,30,59,84
3404-001,2012,10,19,4,42,28,70,59
3404-001,2012,10,19,5,38,42,80,70
3404-001,2012,10,19,6,72,93,165,80
3404-001,2012,10,19,7,130,309,439,165
3404-001,2012,10,19,8,268,860,1128,439
3404-001,2012,10,19,9,407,769,1176,1128
3404-001,2012,10,19,10,380,496,876,1176
3404-001,2012,10,19,11,483,470,953,876
3404-001,2012,10,19,12,493,451,944,953
3404-001,2012,10,19,13,411,384,795,944
3404-001,2012,10,19,14,488,425,913,795
3404-001,2012,10,19,15,520,478,998,913
3404-001,2012,10,19,16,652,471,1123,998
3404-001,2012,10,19,17,600,430,1030,1123
3404-001,2012,10,19,18,880,438,1318,1030
3404-001,2012,10,19,19,885,431,1316,1318
3404-001,2012,10,19,20,670,330,1000,1316
3404-001,2012,10,19,21,494,226,720,1000
3404-001,2012,10,19,22,335,166,501,720
3404-001,2012,10,19,23,221,116,337,501
3404-001,2012,10,19,24,82,91,173,337
3404-001,2012,10,20,1,66,47,113,173
3404-001,2012,10,20,2,45,37,82,113
3404-001,2012,10,20,3,35,26,61,82
3404-001,2012,10,20,4,38,23,61,61
3404-001,2012,10,20,5,37,41,78,61
3404-001,2012,10,20,6,60,81,141,78
3404-001,2012,10,20,7,104,162,266,141
3404-001,2012,10,20,8,160,394,554,266
3404-001,2012,10,20,9,319,389,708,554
3404-001,2012,10,20,10,274,312,586,708
3404-001,2012,10,20,11,332,309,641,586
3404-001,2012,10,20,12,291,299,590,641
3404-001,2012,10,20,13,334,246,580,590
3404-001,2012,10,20,14,323,293,616,580
3404-001,2012,10,20,15,322,274,596,616
3404-001,2012,10,20,16,321,271,592,596
3404-001,2012,10,20,17,416,263,679,592
3404-001,2012,10,20,18,518,297,815,679
3404-001,2012,10,20,19,332,229,561,815
3404-001,2012,10,20,20,198,182,380,561
3404-001,2012,10,20,21,160,135,295,380
3404-001,2012,10,20,22,110,105,215,295
3404-001,2012,10,20,23,63,70,133,215
3404-001,2012,10,20,24,52,51,103,133
3404-001,2012,10,21,1,33,27,60,103
3404-001,2012,10,21,2,19,18,37,60
3404-001,2012,10,21,3,25,16,41,37
3404-001,2012,10,21,4,17,14,31,41
3404-001,2012,10,21,5,14,16,30,31
3404-001,2012,10,21,6,20,40,60,30
3404-001,2012,10,21,7,51,77,128,60
3404-001,2012,10,21,8,73,147,220,128
3404-001,2012,10,21,9,126,144,270,220
3404-001,2012,10,21,10,115,150,265,270
3404-001,2012,10,21,11,137,159,296,265
3404-001,2012,10,21,12,153,176,329,296
3404-001,2012,10,21,13,157,176,333,329
3404-001,2012,10,21,14,188,169,357,333
3404-001,2012,10,21,15,212,179,391,357
3404-001,2012,10,21,16,265,178,443,391
3404-001,2012,10,21,17,291,182,473,443
3404-001,2012,10,21,18,303,192,495,473
3404-001,2012,10,21,19,232,163,395,495
3404-001,2012,10,21,20,166,129,295,395
3404-001,2012,10,21,21,114,119,233,295
3404-001,2012,10,21,22,97,112,209,233
3404-001,2012,10,21,23,53,67,120,209
3404-001,2012,10,21,24,32,60,92,120
3404-001,2012,10,22,1,48,44,92,92
3404-001,2012,10,22,2,21,31,52,92
3404-001,2012,10,22,3,12,23,35,52
3404-001,2012,10,22,4,9,19,28,35
3404-001,2012,10,22,5,30,37,67,28
3404-001,2012,10,22,6,75,99,174,67
3404-001,2012,10,22,7,137,318,455,174
3404-001,2012,10,22,8,242,996,1238,455
3404-001,2012,10,22,9,327,791,1118,1238
3404-001,2012,10,22,10,373,439,812,1118
3404-001,2012,10,22,11,487,450,937,812
3404-001,2012,10,22,12,459,416,875,937
3404-001,2012,10,22,13,424,393,817,875
3404-001,2012,10,22,14,469,408,877,817
3404-001,2012,10,22,15,476,473,949,877
3404-001,2012,10,22,16,481,449,930,949
3404-001,2012,10,22,17,519,418,937,930
3404-001,2012,10,22,18,692,427,1119,937
3404-001,2012,10,22,19,767,363,1130,1119
3404-001,2012,10,22,20,529,284,813,1130
3404-001,2012,10,22,21,519,220,739,813
3404-001,2012,10,22,22,346,176,522,739
3404-001,2012,10,22,23,173,111,284,522
3404-001,2012,10,22,24,88,69,157,284
3404-001,2012,10,23,1,64,61,125,157
3404-001,2012,10,23,2,33,34,67,125
3404-001,2012,10,23,3,34,29,63,67
3404-001,2012,10,23,4,26,27,53,63
3404-001,2012,10,23,5,34,42,76,53
3404-001,2012,10,23,6,79,95,174,76
3404-001,2012,10,23,7,89,286,375,174
3404-001,2012,10,23,8,265,899,1164,375
3404-001,2012,10,23,9,388,755,1143,1164
3404-001,2012,10,23,10,427,460,887,1143
3404-001,2012,10,23,11,460,483,943,887
3404-001,2012,10,23,12,431,427,858,943
3404-001,2012,10,23,13,437,362,799,858
3404-001,2012,10,23,14,424,435,859,799
3404-001,2012,10,23,15,494,463,957,859
3404-001,2012,10,23,16,568,480,1048,957
3404-001,2012,10,23,17,574,443,1017,1048
3404-001,2012,10,23,18,779,411,1190,1017
3404-001,2012,10,23,19,787,364,1151,1190
3404-001,2012,10,23,20,494,305,799,1151
3404-001,2012,10,23,21,497,236,733,799
3404-001,2012,10,23,22,315,183,498,733
3404-001,2012,10,23,23,169,116,285,498
3404-001,2012,10,23,24,112,64,176,285
3404-001,2012,10,24,1,50,64,114,176
3404-001,2012,10,24,2,38,44,82,114
3404-001,2012,10,24,3,38,33,71,82
3404-001,2012,10,24,4,27,32,59,71
3404-001,2012,10,24,5,41,42,83,59
3404-001,2012,10,24,6,78,102,180,83
3404-001,2012,10,24,7,126,303,429,180
3404-001,2012,10,24,8,289,1016,1305,429
3404-001,2012,10,24,9,441,877,1318,1305
3404-001,2012,10,24,10,400,453,853,1318
3404-001,2012,10,24,11,458,508,966,853
3404-001,2012,10,24,12,440,435,875,966
3404-001,2012,10,24,13,385,388,773,875
3404-001,2012,10,24,14,433,419,852,773
3404-001,2012,10,24,15,499,436,935,852
3404-001,2012,10,24,16,497,410,907,935
3404-001,2012,10,24,17,523,396,919,907
3404-001,2012,10,24,18,800,375,1175,919
3404-001,2012,10,24,19,673,327,1000,1175
3404-001,2012,10,24,20,465,243,708,1000
3404-001,2012,10,24,21,378,190,568,708
3404-001,2012,10,24,22,209,135,344,568
3404-001,2012,10,24,23,126,105,231,344
3404-001,2012,10,24,24,86,61,147,231
3404-001,2012,10,25,1,54,50,104,147
3404-001,2012,10,25,2,38,37,75,104
3404-001,2012,10,25,3,33,22,55,75
3404-001,2012,10,25,4,21,24,45,55
3404-001,2012,10,25,5,31,53,84,45
3404-001,2012,10,25,6,66,106,172,84
3404-001,2012,10,25,7,130,315,445,172
3404-001,2012,10,25,8,315,1065,1380,445
3404-001,2012,10,25,9,450,842,1292,1380
3404-001,2012,10,25,10,439,486,925,1292
3404-001,2012,10,25,11,488,484,972,925
3404-001,2012,10,25,12,462,422,884,972
3404-001,2012,10,25,13,370,389,759,884
3404-001,2012,10,25,14,468,424,892,759
3404-001,2012,10,25,15,451,472,923,892
3404-001,2012,10,25,16,522,475,997,923
3404-001,2012,10,25,17,517,424,941,997
3404-001,2012,10,25,18,694,381,1075,941
3404-001,2012,10,25,19,748,278,1026,1075
3404-001,2012,10,25,20,428,260,688,1026
3404-001,2012,10,25,21,358,167,525,688
3404-001,2012,10,25,22,255,141,396,525
3404-001,2012,10,25,23,154,100,254,396
3404-001,2012,10,25,24,81,64,145,254
3404-001,2012,10,26,1,53,49,102,145
3404-001,2012,10,26,2,43,50,93,102
3404-001,2012,10,26,3,24,25,49,93
3404-001,2012,10,26,4,34,23,57,49
3404-001,2012,10,26,5,31,34,65,57
3404-001,2012,10,26,6,73,95,168,65
3404-001,2012,10,26,7,137,326,463,168
3404-001,2012,10,26,8,297,954,1251,463
3404-001,2012,10,26,9,448,846,1294,1251
3404-001,2012,10,26,10,372,486,858,1294
3404-001,2012,10,26,11,466,453,919,858
3404-001,2012,10,26,12,469,429,898,919
3404-001,2012,10,26,13,384,359,743,898
3404-001,2012,10,26,14,450,392,842,743
3404-001,2012,10,26,15,479,441,920,842
3404-001,2012,10,26,16,596,431,1027,920
3404-001,2012,10,26,17,542,388,930,1027
3404-001,2012,10,26,18,729,363,1092,930
3404-001,2012,10,26,19,733,357,1090,1092
3404-001,2012,10,26,20,548,270,818,1090
3404-001,2012,10,26,21,404,185,589,818
3404-001,2012,10,26,22,268,133,401,589
3404-001,2012,10,26,23,175,92,267,401
3404-001,2012,10,26,24,67,75,142,267
3404-001,2012,10,27,1,66,47,113,142
3404-001,2012,10,27,2,46,38,84,113
3404-001,2012,10,27,3,28,21,49,84
3404-001,2012,10,27,4,33,20,53,49
3404-001,2012,10,27,5,43,48,91,53
3404-001,2012,10,27,6,60,82,142,91
3404-001,2012,10,27,7,106,165,271,142
3404-001,2012,10,27,8,180,443,623,271
3404-001,2012,10,27,9,340,415,755,623
3404-001,2012,10,27,10,291,332,623,755
3404-001,2012,10,27,11,357,332,689,623
3404-001,2012,10,27,12,308,317,625,689
3404-001,2012,10,27,13,327,241,568,625
3404-001,2012,10,27,14,319,290,609,568
3404-001,2012,10,27,15,320,273,593,609
3404-001,2012,10,27,16,332,280,612,593
3404-001,2012,10,27,17,384,243,627,612
3404-001,2012,10,27,18,451,259,710,627
3404-001,2012,10,27,19,286,197,483,710
3404-001,2012,10,27,20,191,176,367,483
3404-001,2012,10,27,21,159,135,294,367
3404-001,2012,10,27,22,106,101,207,294
3404-001,2012,10,27,23,72,80,152,207
3404-001,2012,10,27,24,47,47,94,152
3404-001,2012,10,28,1,39,32,71,94
3404-001,2012,10,28,2,21,20,41,71
3404-001,2012,10,28,3,30,19,49,41
3404-001,2012,10,28,4,21,18,39,49
3404-001,2012,10,28,5,18,21,39,39
3404-001,2012,10,28,6,27,56,83,39
3404-001,2012,10,28,7,63,96,159,83
3404-001,2012,10,28,8,94,191,285,159
3404-001,2012,10,28,9,165,188,353,285
3404-001,2012,10,28,10,150,197,347,353
3404-001,2012,10,28,11,168,195,363,347
3404-001,2012,10,28,12,207,238,445,363
3404-001,2012,10,28,13,211,237,448,445
3404-001,2012,10,28,14,251,225,476,448
3404-001,2012,10,28,15,267,225,492,476
3404-001,2012,10,28,16,329,221,550,492
3404-001,2012,10,28,17,369,231,600,550
3404-001,2012,10,28,18,377,239,616,600
3404-001,2012,10,28,19,280,197,477,616
3404-001,2012,10,28,20,209,162,371,477
3404-001,2012,10,28,21,148,155,303,371
3404-001,2012,10,28,22,129,150,279,303
3404-001,2012,10,28,23,71,90,161,279
3404-001,2012,10,28,24,46,87,133,161
3404-001,2012,10,29,1,44,41,85,133
3404-001,2012,10,29,2,20,30,50,85
3404-001,2012,10,29,3,12,23,35,50
3404-001,2012,10,29,4,7,15,22,35
3404-001,2012,10,29,5,31,38,69,22
3404-001,2012,10,29,6,75,100,175,69
3404-001,2012,10,29,7,147,343,490,175
3404-001,2012,10,29,8,276,1138,1414,490
3404-001,2012,10,29,9,365,885,1250,1414
3404-001,2012,10,29,10,374,440,814,1250
3404-001,2012,10,29,11,457,423,880,814
3404-001,2012,10,29,12,442,401,843,880
3404-001,2012,10,29,13,418,388,806,843
3404-001,2012,10,29,14,418,364,782,806
3404-001,2012,10,29,15,473,470,943,782
3404-001,2012,10,29,16,454,424,878,943
3404-001,2012,10,29,17,473,381,854,878
3404-001,2012,10,29,18,624,385,1009,854
3404-001,2012,10,29,19,623,295,918,1009
3404-001,2012,10,29,20,427,229,656,918
3404-001,2012,10,29,21,408,173,581,656
3404-001,2012,10,29,22,277,141,418,581
3404-001,2012,10,29,23,150,96,246,418
3404-001,2012,10,29,24,87,68,155,246
3404-001,2012,10,30,1,61,59,120,155
3404-001,2012,10,30,2,34,35,69,120
3404-001,2012,10,30,3,31,27,58,69
3404-001,2012,10,30,4,25,26,51,58
3404-001,2012,10,30,5,33,41,74,51
3404-001,2012,10,30,6,70,84,154,74
3404-001,2012,10,30,7,93,300,393,154
3404-001,2012,10,30,8,301,1024,1325,393
3404-001,2012,10,30,9,427,831,1258,1325
3404-001,2012,10,30,10,425,458,883,1258
3404-001,2012,10,30,11,449,472,921,883
3404-001,2012,10,30,12,424,420,844,921
3404-001,2012,10,30,13,431,357,788,844
3404-001,2012,10,30,14,418,429,847,788
3404-001,2012,10,30,15,495,464,959,847
3404-001,2012,10,30,16,565,478,1043,959
3404-001,2012,10,30,17,548,423,971,1043
3404-001,2012,10,30,18,675,356,1031,971
3404-001,2012,10,30,19,642,297,939,1031
3404-001,2012,10,30,20,434,268,702,939
3404-001,2012,10,30,21,410,195,605,702
3404-001,2012,10,30,22,253,147,400,605
3404-001,2012,10,30,23,147,101,248,400
3404-001,2012,10,30,24,91,52,143,248
3404-001,2012,10,31,1,49,46,95,143
3404-001,2012,10,31,2,33,38,71,95
3404-001,2012,10,31,3,28,22,50,71
3404-001,2012,10,31,4,21,31,52,50
3404-001,2012,10,31,5,36,31,67,52
3404-001,2012,10,31,6,57,89,146,67
3404-001,2012,10,31,7,123,296,419,146
3404-001,2012,10,31,8,270,1039,1309,419
3404-001,2012,10,31,9,417,809,1226,1309
3404-001,2012,10,31,10,412,445,857,1226
3404-001,2012,10,31,11,456,429,885,857
3404-001,2012,10,31,12,423,381,804,885
3404-001,2012,10,31,13,350,383,733,804
3404-001,2012,10,31,14,383,402,785,733
3404-001,2012,10,31,15,505,454,959,785
3404-001,2012,10,31,16,489,444,933,959
3404-001,2012,10,31,17,462,366,828,933
3404-001,2012,10,31,18,674,371,1045,828
3404-001,2012,10,31,19,699,296,995,1045
3404-001,2012,10,31,20,454,239,693,995
3404-001,2012,10,31,21,401,184,585,693
3404-001,2012,10,31,22,232,128,360,585
3404-001,2012,10,31,23,135,99,234,360
3404-001,2012,10,31,24,75,70,145,234
3404-001,2012,11,1,1,55,58,113,145
3404-001,2012,11,1,2,34,26,60,113
3404-001,2012,11,1,3,14,24,38,60
3404-001,2012,11,1,4,25,17,42,38
3404-001,2012,11,1,5,23,53,76,42
3404-001,2012,11,1,6,60,96,156,76
3404-001,2012,11,1,7,92,308,400,156
3404-001,2012,11,1,8,295,1028,1323,400
3404-001,2012,11,1,9,451,818,1269,1323
3404-001,2012,11,1,10,383,469,852,1269
3404-001,2012,11,1,11,440,414,854,852
3404-001,2012,11,1,12,427,442,869,854
3404-001,2012,11,1,13,353,344,697,869
3404-001,2012,11,1,14,438,376,814,697
3404-001,2012,11,1,15,483,454,937,814
3404-001,2012,11,1,16,474,394,868,937
3404-001,2012,11,1,17,509,380,889,868
3404-001,2012,11,1,18,649,386,1035,889
3404-001,2012,11,1,19,630,268,898,1035
3404-001,2012,11,1,20,460,232,692,898
3404-001,2012,11,1,21,366,188,554,692
3404-001,2012,11,1,22,258,129,387,554
3404-001,2012,11,1,23,157,92,249,387
3404-001,2012,11,1,24,89,61,150,249
3404-001,2012,11,2,1,50,49,99,150
3404-001,2012,11,2,2,38,39,77,99
3404-001,2012,11,2,3,28,29,57,77
3404-001,2012,11,2,4,30,32,62,57
3404-001,2012,11,2,5,33,32,65,62
3404-001,2012,11,2,6,58,87,145,65
3404-001,2012,11,2,7,134,289,423,145
3404-001,2012,11,2,8,259,1038,1297,423
3404-001,2012,11,2,9,437,816,1253,1297
3404-001,2012,11,2,10,420,473,893,1253
3404-001,2012,11,2,11,479,426,905,893
3404-001,2012,11,2,12,408,398,806,905
3404-001,2012,11,2,13,342,347,689,806
3404-001,2012,11,2,14,405,446,851,689
3404-001,2012,11,2,15,445,425,870,851
3404-001,2012,11,2,16,504,415,919,870
3404-001,2012,11,2,17,514,431,945,919
3404-001,2012,11,2,18,744,380,1124,945
3404-001,2012,11,2,19,778,333,1111,1124
3404-001,2012,11,2,20,522,272,794,1111
3404-001,2012,11,2,21,432,191,623,794
3404-001,2012,11,2,22,256,165,421,623
3404-001,2012,11,2,23,185,116,301,421
3404-001,2012,11,2,24,76,81,157,301
3404-001,2012,11,3,1,52,52,104,157
3404-001,2012,11,3,2,28,36,64,104
3404-001,2012,11,3,3,24,26,50,64
3404-001,2012,11,3,4,26,28,54,50
3404-001,2012,11,3,5,40,39,79,54
3404-001,2012,11,3,6,53,92,145,79
3404-001,2012,11,3,7,111,200,311,145
3404-001,2012,11,3,8,231,488,719,311
3404-001,2012,11,3,9,339,523,862,719
3404-001,2012,11,3,10,359,391,750,862
3404-001,2012,11,3,11,377,375,752,750
3404-001,2012,11,3,12,337,363,700,752
3404-001,2012,11,3,13,317,307,624,700
3404-001,2012,11,3,14,368,333,701,624
3404-001,2012,11,3,15,376,343,719,701
3404-001,2012,11,3,16,426,317,743,719
3404-001,2012,11,3,17,421,283,704,743
3404-001,2012,11,3,18,588,310,898,704
3404-001,2012,11,3,19,469,263,732,898
3404-001,2012,11,3,20,284,192,476,732
3404-001,2012,11,3,21,192,148,340,476
3404-001,2012,11,3,22,145,117,262,340
3404-001,2012,11,3,23,88,74,162,262
3404-001,2012,11,3,24,50,44,94,162
3404-001,2012,11,4,1,40,41,81,94
3404-001,2012,11,4,2,26,27,53,81
3404-001,2012,11,4,3,17,17,34,53
3404-001,2012,11,4,4,26,8,34,34
3404-001,2012,11,4,5,18,24,42,34
3404-001,2012,11,4,6,40,43,83,42
3404-001,2012,11,4,7,62,67,129,83
3404-001,2012,11,4,8,98,178,276,129
3404-001,2012,11,4,9,145,170,315,276
3404-001,2012,11,4,10,146,179,325,315
3404-001,2012,11,4,11,214,202,416,325
3404-001,2012,11,4,12,192,242,434,416
3404-001,2012,11,4,13,205,238,443,434
3404-001,2012,11,4,14,249,211,460,443
3404-001,2012,11,4,15,296,203,499,460
3404-001,2012,11,4,16,296,224,520,499
3404-001,2012,11,4,17,296,210,506,520
3404-001,2012,11,4,18,317,184,501,506
3404-001,2012,11,4,19,244,177,421,501
3404-001,2012,11,4,20,160,174,334,421
3404-001,2012,11,4,21,133,157,290,334
3404-001,2012,11,4,22,83,127,210,290
3404-001,2012,11,4,23,62,79,141,210
3404-001,2012,11,4,24,57,66,123,141
3404-001,2012,11,5,1,22,43,65,123
3404-001,2012,11,5,2,19,35,54,65
3404-001,2012,11,5,3,17,25,42,54
3404-001,2012,11,5,4,9,24,33,42
3404-001,2012,11,5,5,38,39,77,33
3404-001,2012,11,5,6,56,109,165,77
3404-001,2012,11,5,7,93,331,424,165
3404-001,2012,11,5,8,277,1148,1425,424
3404-001,2012,11,5,9,365,940,1305,1425
3404-001,2012,11,5,10,385,431,816,1305
3404-001,2012,11,5,11,452,445,897,816
3404-001,2012,11,5,12,414,428,842,897
3404-001,2012,11,5,13,373,335,708,842
3404-001,2012,11,5,14,387,358,745,708
3404-001,2012,11,5,15,438,409,847,745
3404-001,2012,11,5,16,515,437,952,847
3404-001,2012,11,5,17,451,386,837,952
3404-001,2012,11,5,18,640,316,956,837
3404-001,2012,11,5,19,610,260,870,956
3404-001,2012,11,5,20,442,230,672,870
3404-001,2012,11,5,21,448,178,626,672
3404-001,2012,11,5,22,277,115,392,626
3404-001,2012,11,5,23,130,91,221,392
3404-001,2012,11,5,24,54,55,109,221
3404-001,2012,11,6,1,43,41,84,109
3404-001,2012,11,6,2,35,33,68,84
3404-001,2012,11,6,3,17,23,40,68
3404-001,2012,11,6,4,21,30,51,40
3404-001,2012,11,6,5,32,40,72,51
3404-001,2012,11,6,6,55,93,148,72
3404-001,2012,11,6,7,103,257,360,148
3404-001,2012,11,6,8,268,999,1267,360
3404-001,2012,11,6,9,400,888,1288,1267
3404-001,2012,11,6,10,419,474,893,1288
3404-001,2012,11,6,11,452,454,906,893
3404-001,2012,11,6,12,439,397,836,906
3404-001,2012,11,6,13,333,355,688,836
3404-001,2012,11,6,14,383,371,754,688
3404-001,2012,11,6,15,530,415,945,754
3404-001,2012,11,6,16,503,421,924,945
3404-001,2012,11,6,17,477,352,829,924
3404-001,2012,11,6,18,631,301,932,829
3404-001,2012,11,6,19,554,281,835,932
3404-001,2012,11,6,20,394,238,632,835
3404-001,2012,11,6,21,384,166,550,632
3404-001,2012,11,6,22,261,115,376,550
3404-001,2012,11,6,23,140,93,233,376
3404-001,2012,11,6,24,93,59,152,233
3404-001,2012,11,7,1,59,57,116,152
3404-001,2012,11,7,2,30,35,65,116
3404-001,2012,11,7,3,32,26,58,65
3404-001,2012,11,7,4,15,27,42,58
3404-001,2012,11,7,5,44,31,75,42
3404-001,2012,11,7,6,58,88,146,75
3404-001,2012,11,7,7,101,289,390,146
3404-001,2012,11,7,8,272,977,1249,390
3404-001,2012,11,7,9,414,835,1249,1249
3404-001,2012,11,7,10,435,438,873,1249
3404-001,2012,11,7,11,452,457,909,873
3404-001,2012,11,7,12,393,415,808,909
3404-001,2012,11,7,13,389,351,740,808
3404-001,2012,11,7,14,418,407,825,740
3404-001,2012,11,7,15,516,472,988,825
3404-001,2012,11,7,16,492,370,862,988
3404-001,2012,11,7,17,494,442,936,862
3404-001,2012,11,7,18,707,388,1095,936
3404-001,2012,11,7,19,640,296,936,1095
3404-001,2012,11,7,20,445,254,699,936
3404-001,2012,11,7,21,395,172,567,699
3404-001,2012,11,7,22,238,131,369,567
3404-001,2012,11,7,23,154,96,250,369
3404-001,2012,11,7,24,88,61,149,250
3404-001,2012,11,8,1,54,42,96,149
3404-001,2012,11,8,2,29,34,63,96
3404-001,2012,11,8,3,32,19,51,63
3404-001,2012,11,8,4,27,35,62,51
3404-001,2012,11,8,5,40,48,88,62
3404-001,2012,11,8,6,52,86,138,88
3404-001,2012,11,8,7,106,314,420,138
3404-001,2012,11,8,8,275,1033,1308,420
3404-001,2012,11,8,9,443,914,1357,1308
3404-001,2012,11,8,10,388,478,866,1357
3404-001,2012,11,8,11,446,465,911,866
3404-001,2012,11,8,12,464,466,930,911
3404-001,2012,11,8,13,388,385,773,930
3404-001,2012,11,8,14,385,439,824,773
3404-001,2012,11,8,15,530,487,1017,824
3404-001,2012,11,8,16,525,449,974,1017
3404-001,2012,11,8,17,548,400,948,974
3404-001,2012,11,8,18,675,356,1031,948
3404-001,2012,11,8,19,658,287,945,1031
3404-001,2012,11,8,20,448,252,700,945
3404-001,2012,11,8,21,413,198,611,700
3404-001,2012,11,8,22,268,100,368,611
3404-001,2012,11,8,23,148,90,238,368
3404-001,2012,11,8,24,66,62,128,238
3404-001,2012,11,9,1,48,44,92,128
3404-001,2012,11,9,2,31,48,79,92
3404-001,2012,11,9,3,32,25,57,79
3404-001,2012,11,9,4,28,25,53,57
3404-001,2012,11,9,5,29,40,69,53
3404-001,2012,11,9,6,53,92,145,69
3404-001,2012,11,9,7,87,281,368,145
3404-001,2012,11,9,8,275,995,1270,368
3404-001,2012,11,9,9,410,857,1267,1270
3404-001,2012,11,9,10,390,468,858,1267
3404-001,2012,11,9,11,462,482,944,858
3404-001,2012,11,9,12,466,436,902,944
3404-001,2012,11,9,13,409,361,770,902
3404-001,2012,11,9,14,489,421,910,770
3404-001,2012,11,9,15,489,567,1056,910
3404-001,2012,11,9,16,565,469,1034,1056
3404-001,2012,11,9,17,565,422,987,1034
3404-001,2012,11,9,18,484,276,760,987
3404-001,2012,11,9,19,793,338,1131,760
3404-001,2012,11,9,20,525,260,785,1131
3404-001,2012,11,9,21,417,182,599,785
3404-001,2012,11,9,22,267,168,435,599
3404-001,2012,11,9,23,137,118,255,435
3404-001,2012,11,9,24,82,78,160,255
3404-001,2012,11,10,1,59,62,121,160
3404-001,2012,11,10,2,36,32,68,121
3404-001,2012,11,10,3,22,42,64,68
3404-001,2012,11,10,4,30,40,70,64
3404-001,2012,11,10,5,51,54,105,70
3404-001,2012,11,10,6,57,94,151,105
3404-001,2012,11,10,7,105,200,305,151
3404-001,2012,11,10,8,214,516,730,305
3404-001,2012,11,10,9,339,539,878,730
3404-001,2012,11,10,10,376,422,798,878
3404-001,2012,11,10,11,387,386,773,798
3404-001,2012,11,10,12,364,357,721,773
3404-001,2012,11,10,13,333,325,658,721
3404-001,2012,11,10,14,353,347,700,658
3404-001,2012,11,10,15,389,337,726,700
3404-001,2012,11,10,16,441,279,720,726
3404-001,2012,11,10,17,478,304,782,720
3404-001,2012,11,10,18,555,346,901,782
3404-001,2012,11,10,19,436,260,696,901
3404-001,2012,11,10,20,270,203,473,696
3404-001,2012,11,10,21,184,144,328,473
3404-001,2012,11,10,22,140,117,257,328
3404-001,2012,11,10,23,72,82,154,257
3404-001,2012,11,10,24,50,50,100,154
3404-001,2012,11,11,1,43,28,71,100
3404-001,2012,11,11,2,26,24,50,71
3404-001,2012,11,11,3,17,12,29,50
3404-001,2012,11,11,4,18,13,31,29
3404-001,2012,11,11,5,14,21,35,31
3404-001,2012,11,11,6,31,27,58,35
3404-001,2012,11,11,7,39,49,88,58
3404-001,2012,11,11,8,83,120,203,88
3404-001,2012,11,11,9,121,139,260,203
3404-001,2012,11,11,10,135,167,302,260
3404-001,2012,11,11,11,166,185,351,302
3404-001,2012,11,11,12,192,196,388,351
3404-001,2012,11,11,13,214,170,384,388
3404-001,2012,11,11,14,231,186,417,384
3404-001,2012,11,11,15,245,224,469,417
3404-001,2012,11,11,16,259,236,495,469
3404-001,2012,11,11,17,345,189,534,495
3404-001,2012,11,11,18,292,207,499,534
3404-001,2012,11,11,19,190,196,386,499
3404-001,2012,11,11,20,152,165,317,386
3404-001,2012,11,11,21,144,175,319,317
3404-001,2012,11,11,22,97,140,237,319
3404-001,2012,11,11,23,60,78,138,237
3404-001,2012,11,11,24,41,63,104,138
3404-001,2012,11,12,1,25,51,76,104
3404-001,2012,11,12,2,14,28,42,76
3404-001,2012,11,12,3,10,20,30,42
3404-001,2012,11,12,4,17,21,38,30
3404-001,2012,11,12,5,25,33,58,38
3404-001,2012,11,12,6,63,89,152,58
3404-001,2012,11,12,7,106,320,426,152
3404-001,2012,11,12,8,258,1140,1398,426
3404-001,2012,11,12,9,354,944,1298,1398
3404-001,2012,11,12,10,371,408,779,1298
3404-001,2012,11,12,11,441,418,859,779
3404-001,2012,11,12,12,428,388,816,859
3404-001,2012,11,12,13,342,358,700,816
3404-001,2012,11,12,14,376,416,792,700
3404-001,2012,11,12,15,469,436,905,792
3404-001,2012,11,12,16,453,394,847,905
3404-001,2012,11,12,17,465,374,839,847
3404-001,2012,11,12,18,642,339,981,839
3404-001,2012,11,12,19,533,286,819,981
3404-001,2012,11,12,20,470,223,693,819
3404-001,2012,11,12,21,396,164,560,693
3404-001,2012,11,12,22,243,125,368,560
3404-001,2012,11,12,23,149,75,224,368
3404-001,2012,11,12,24,78,66,144,224
3404-001,2012,11,13,1,41,54,95,144
3404-001,2012,11,13,2,39,34,73,95
3404-001,2012,11,13,3,39,23,62,73
3404-001,2012,11,13,4,26,25,51,62
3404-001,2012,11,13,5,31,38,69,51
3404-001,2012,11,13,6,56,79,135,69
3404-001,2012,11,13,7,102,247,349,135
3404-001,2012,11,13,8,273,971,1244,349
3404-001,2012,11,13,9,435,870,1305,1244
3404-001,2012,11,13,10,413,443,856,1305
3404-001,2012,11,13,11,442,443,885,856
3404-001,2012,11,13,12,383,428,811,885
3404-001,2012,11,13,13,351,329,680,811
3404-001,2012,11,13,14,407,422,829,680
3404-001,2012,11,13,15,490,416,906,829
3404-001,2012,11,13,16,492,417,909,906
3404-001,2012,11,13,17,500,354,854,909
3404-001,2012,11,13,18,652,339,991,854
3404-001,2012,11,13,19,581,267,848,991
3404-001,2012,11,13,20,417,222,639,848
3404-001,2012,11,13,21,413,163,576,639
3404-001,2012,11,13,22,239,132,371,576
3404-001,2012,11,13,23,163,91,254,371
3404-001,2012,11,13,24,71,56,127,254
3404-001,2012,11,14,1,42,44,86,127
3404-001,2012,11,14,2,24,33,57,86
3404-001,2012,11,14,3,33,30,63,57
3404-001,2012,11,14,4,31,20,51,63
3404-001,2012,11,14,5,42,46,88,51
3404-001,2012,11,14,6,48,89,137,88
3404-001,2012,11,14,7,106,296,402,137
3404-001,2012,11,14,8,264,984,1248,402
3404-001,2012,11,14,9,444,897,1341,1248
3404-001,2012,11,14,10,413,424,837,1341
3404-001,2012,11,14,11,447,449,896,837
3404-001,2012,11,14,12,437,416,853,896
3404-001,2012,11,14,13,371,374,745,853
3404-001,2012,11,14,14,431,417,848,745
3404-001,2012,11,14,15,456,458,914,848
3404-001,2012,11,14,16,528,410,938,914
3404-001,2012,11,14,17,519,382,901,938
3404-001,2012,11,14,18,729,369,1098,901
3404-001,2012,11,14,19,672,313,985,1098
3404-001,2012,11,14,20,419,274,693,985
3404-001,2012,11,14,21,409,185,594,693
3404-001,2012,11,14,22,240,154,394,594
3404-001,2012,11,14,23,160,80,240,394
3404-001,2012,11,14,24,84,75,159,240
3404-001,2012,11,15,1,58,68,126,159
3404-001,2012,11,15,2,39,37,76,126
3404-001,2012,11,15,3,30,21,51,76
3404-001,2012,11,15,4,27,30,57,51
3404-001,2012,11,15,5,32,30,62,57
3404-001,2012,11,15,6,70,98,168,62
3404-001,2012,11,15,7,96,267,363,168
3404-001,2012,11,15,8,270,1063,1333,363
3404-001,2012,11,15,9,467,863,1330,1333
3404-001,2012,11,15,10,420,436,856,1330
3404-001,2012,11,15,11,433,474,907,856
3404-001,2012,11,15,12,429,389,818,907
3404-001,2012,11,15,13,422,342,764,818
3404-001,2012,11,15,14,423,414,837,764
3404-001,2012,11,15,15,485,466,951,837
3404-001,2012,11,15,16,526,455,981,951
3404-001,2012,11,15,17,533,405,938,981
3404-001,2012,11,15,18,710,360,1070,938
3404-001,2012,11,15,19,614,296,910,1070
3404-001,2012,11,15,20,482,245,727,910
3404-001,2012,11,15,21,391,177,568,727
3404-001,2012,11,15,22,261,168,429,568
3404-001,2012,11,15,23,141,82,223,429
3404-001,2012,11,15,24,75,79,154,223
3404-001,2012,11,16,1,58,53,111,154
3404-001,2012,11,16,2,26,29,55,111
3404-001,2012,11,16,3,37,29,66,55
3404-001,2012,11,16,4,27,26,53,66
3404-001,2012,11,16,5,30,39,69,53
3404-001,2012,11,16,6,55,88,143,69
3404-001,2012,11,16,7,129,283,412,143
3404-001,2012,11,16,8,269,1025,1294,412
3404-001,2012,11,16,9,438,877,1315,1294
3404-001,2012,11,16,10,422,501,923,1315
3404-001,2012,11,16,11,471,469,940,923
3404-001,2012,11,16,12,470,460,930,940
3404-001,2012,11,16,13,428,379,807,930
3404-001,2012,11,16,14,461,431,892,807
3404-001,2012,11,16,15,542,444,986,892
3404-001,2012,11,16,16,511,445,956,986
3404-001,2012,11,16,17,555,462,1017,956
3404-001,2012,11,16,18,760,369,1129,1017
3404-001,2012,11,16,19,782,320,1102,1129
3404-001,2012,11,16,20,498,299,797,1102
3404-001,2012,11,16,21,405,172,577,797
3404-001,2012,11,16,22,242,133,375,577
3404-001,2012,11,16,23,149,98,247,375
3404-001,2012,11,16,24,84,64,148,247
3404-001,2012,11,17,1,63,42,105,148
3404-001,2012,11,17,2,38,34,72,105
3404-001,2012,11,17,3,21,32,53,72
3404-001,2012,11,17,4,25,22,47,53
3404-001,2012,11,17,5,35,40,75,47
3404-001,2012,11,17,6,61,67,128,75
3404-001,2012,11,17,7,97,154,251,128
3404-001,2012,11,17,8,192,452,644,251
3404-001,2012,11,17,9,320,502,822,644
3404-001,2012,11,17,10,366,368,734,822
3404-001,2012,11,17,11,348,341,689,734
3404-001,2012,11,17,12,370,331,701,689
3404-001,2012,11,17,13,313,295,608,701
3404-001,2012,11,17,14,337,293,630,608
3404-001,2012,11,17,15,350,285,635,630
3404-001,2012,11,17,16,412,302,714,635
3404-001,2012,11,17,17,448,326,774,714
3404-001,2012,11,17,18,525,326,851,774
3404-001,2012,11,17,19,376,262,638,851
3404-001,2012,11,17,20,245,214,459,638
3404-001,2012,11,17,21,183,149,332,459
3404-001,2012,11,17,22,120,124,244,332
3404-001,2012,11,17,23,99,64,163,244
3404-001,2012,11,17,24,64,55,119,163
3404-001,2012,11,18,1,42,43,85,119
3404-001,2012,11,18,2,32,36,68,85
3404-001,2012,11,18,3,17,22,39,68
3404-001,2012,11,18,4,26,18,44,39
3404-001,2012,11,18,5,24,26,50,44
3404-001,2012,11,18,6,40,33,73,50
3404-001,2012,11,18,7,67,89,156,73
3404-001,2012,11,18,8,91,199,290,156
3404-001,2012,11,18,9,135,238,373,290
3404-001,2012,11,18,10,160,166,326,373
3404-001,2012,11,18,11,189,196,385,326
3404-001,2012,11,18,12,206,228,434,385
3404-001,2012,11,18,13,201,207,408,434
3404-001,2012,11,18,14,258,250,508,408
3404-001,2012,11,18,15,288,245,533,508
3404-001,2012,11,18,16,329,220,549,533
3404-001,2012,11,18,17,392,221,613,549
3404-001,2012,11,18,18,431,208,639,613
3404-001,2012,11,18,19,306,210,516,639
3404-001,2012,11,18,20,259,166,425,516
3404-001,2012,11,18,21,191,157,348,425
3404-001,2012,11,18,22,115,162,277,348
3404-001,2012,11,18,23,59,129,188,277
3404-001,2012,11,18,24,52,87,139,188
3404-001,2012,11,19,1,38,60,98,139
3404-001,2012,11,19,2,16,25,41,98
3404-001,2012,11,19,3,23,24,47,41
3404-001,2012,11,19,4,10,24,34,47
3404-001,2012,11,19,5,30,47,77,34
3404-001,2012,11,19,6,67,102,169,77
3404-001,2012,11,19,7,119,336,455,169
3404-001,2012,11,19,8,284,1096,1380,455
3404-001,2012,11,19,9,411,1018,1429,1380
3404-001,2012,11,19,10,383,429,812,1429
3404-001,2012,11,19,11,438,442,880,812
3404-001,2012,11,19,12,408,433,841,880
3404-001,2012,11,19,13,371,360,731,841
3404-001,2012,11,19,14,436,450,886,731
3404-001,2012,11,19,15,486,484,970,886
3404-001,2012,11,19,16,524,463,987,970
3404-001,2012,11,19,17,533,409,942,987
3404-001,2012,11,19,18,699,363,1062,942
3404-001,2012,11,19,19,666,271,937,1062
3404-001,2012,11,19,20,482,255,737,937
3404-001,2012,11,19,21,428,167,595,737
3404-001,2012,11,19,22,256,131,387,595
3404-001,2012,11,19,23,169,101,270,387
3404-001,2012,11,19,24,72,70,142,270
3404-001,2012,11,20,1,49,48,97,142
3404-001,2012,11,20,2,20,29,49,97
3404-001,2012,11,20,3,25,28,53,49
3404-001,2012,11,20,4,26,31,57,53
3404-001,2012,11,20,5,31,40,71,57
3404-001,2012,11,20,6,80,95,175,71
3404-001,2012,11,20,7,97,321,418,175
3404-001,2012,11,20,8,275,1080,1355,418
3404-001,2012,11,20,9,505,862,1367,1355
3404-001,2012,11,20,10,443,482,925,1367
3404-001,2012,11,20,11,434,466,900,925
3404-001,2012,11,20,12,401,429,830,900
3404-001,2012,11,20,13,378,373,751,830
3404-001,2012,11,20,14,431,428,859,751
3404-001,2012,11,20,15,505,484,989,859
3404-001,2012,11,20,16,560,445,1005,989
3404-001,2012,11,20,17,538,422,960,1005
3404-001,2012,11,20,18,722,376,1098,960
3404-001,2012,11,20,19,658,312,970,1098
3404-001,2012,11,20,20,469,221,690,970
3404-001,2012,11,20,21,410,175,585,690
3404-001,2012,11,20,22,256,150,406,585
3404-001,2012,11,20,23,161,107,268,406
3404-001,2012,11,20,24,66,74,140,268
3404-001,2012,11,21,1,63,55,118,140
3404-001,2012,11,21,2,39,28,67,118
3404-001,2012,11,21,3,18,27,45,67
3404-001,2012,11,21,4,24,21,45,45
3404-001,2012,11,21,5,39,34,73,45
3404-001,2012,11,21,6,60,100,160,73
3404-001,2012,11,21,7,101,309,410,160
3404-001,2012,11,21,8,285,1030,1315,410
3404-001,2012,11,21,9,489,927,1416,1315
3404-001,2012,11,21,10,405,472,877,1416
3404-001,2012,11,21,11,463,470,933,877
3404-001,2012,11,21,12,399,402,801,933
3404-001,2012,11,21,13,399,348,747,801
3404-001,2012,11,21,14,448,432,880,747
3404-001,2012,11,21,15,522,485,1007,880
3404-001,2012,11,21,16,515,458,973,1007
3404-001,2012,11,21,17,599,428,1027,973
3404-001,2012,11,21,18,781,336,1117,1027
3404-001,2012,11,21,19,698,292,990,1117
3404-001,2012,11,21,20,416,249,665,990
3404-001,2012,11,21,21,425,188,613,665
3404-001,2012,11,21,22,262,129,391,613
3404-001,2012,11,21,23,144,111,255,391
3404-001,2012,11,21,24,77,87,164,255
3404-001,2012,11,22,1,56,57,113,164
3404-001,2012,11,22,2,37,35,72,113
3404-001,2012,11,22,3,27,28,55,72
3404-001,2012,11,22,4,27,27,54,55
3404-001,2012,11,22,5,43,36,79,54
3404-001,2012,11,22,6,59,93,152,79
3404-001,2012,11,22,7,99,305,404,152
3404-001,2012,11,22,8,277,1031,1308,404
3404-001,2012,11,22,9,478,907,1385,1308
3404-001,2012,11,22,10,438,466,904,1385
3404-001,2012,11,22,11,477,471,948,904
3404-001,2012,11,22,12,418,419,837,948
3404-001,2012,11,22,13,410,352,762,837
3404-001,2012,11,22,14,430,415,845,762
3404-001,2012,11,22,15,515,469,984,845
3404-001,2012,11,22,16,516,458,974,984
3404-001,2012,11,22,17,578,410,988,974
3404-001,2012,11,22,18,782,352,1134,988
3404-001,2012,11,22,19,754,323,1077,1134
3404-001,2012,11,22,20,493,272,765,1077
3404-001,2012,11,22,21,433,194,627,765
3404-001,2012,11,22,22,261,136,397,627
3404-001,2012,11,22,23,145,110,255,397
3404-001,2012,11,22,24,85,84,169,255
3404-001,2012,11,23,1,48,58,106,169
3404-001,2012,11,23,2,35,42,77,106
3404-001,2012,11,23,3,36,28,64,77
3404-001,2012,11,23,4,30,33,63,64
3404-001,2012,11,23,5,46,38,84,63
3404-001,2012,11,23,6,57,85,142,84
3404-001,2012,11,23,7,96,300,396,142
3404-001,2012,11,23,8,268,1032,1300,396
3404-001,2012,11,23,9,467,887,1354,1300
3404-001,2012,11,23,10,470,459,929,1354
3404-001,2012,11,23,11,490,472,962,929
3404-001,2012,11,23,12,437,436,873,962
3404-001,2012,11,23,13,420,356,776,873
3404-001,2012,11,23,14,411,398,809,776
3404-001,2012,11,23,15,508,452,960,809
3404-001,2012,11,23,16,517,457,974,960
3404-001,2012,11,23,17,557,392,949,974
3404-001,2012,11,23,18,783,368,1151,949
3404-001,2012,11,23,19,809,353,1162,1151
3404-001,2012,11,23,20,570,294,864,1162
3404-001,2012,11,23,21,440,199,639,864
3404-001,2012,11,23,22,259,142,401,639
3404-001,2012,11,23,23,145,109,254,401
3404-001,2012,11,23,24,93,80,173,254
3404-001,2012,11,24,1,51,39,90,173
3404-001,2012,11,24,2,39,33,72,90
3404-001,2012,11,24,3,26,36,62,72
3404-001,2012,11,24,4,26,36,62,62
3404-001,2012,11,24,5,45,38,83,62
3404-001,2012,11,24,6,61,105,166,83
3404-001,2012,11,24,7,128,192,320,166
3404-001,2012,11,24,8,217,462,679,320
3404-001,2012,11,24,9,346,499,845,679
3404-001,2012,11,24,10,337,356,693,845
3404-001,2012,11,24,11,386,386,772,693
3404-001,2012,11,24,12,389,344,733,772
3404-001,2012,11,24,13,332,283,615,733
3404-001,2012,11,24,14,330,345,675,615
3404-001,2012,11,24,15,355,324,679,675
3404-001,2012,11,24,16,432,315,747,679
3404-001,2012,11,24,17,439,316,755,747
3404-001,2012,11,24,18,587,335,922,755
3404-001,2012,11,24,19,370,290,660,922
3404-001,2012,11,24,20,275,208,483,660
3404-001,2012,11,24,21,187,174,361,483
3404-001,2012,11,24,22,126,100,226,361
3404-001,2012,11,24,23,95,73,168,226
3404-001,2012,11,24,24,72,51,123,168
3404-001,2012,11,25,1,33,39,72,123
3404-001,2012,11,25,2,23,20,43,72
3404-001,2012,11,25,3,27,25,52,43
3404-001,2012,11,25,4,17,23,40,52
3404-001,2012,11,25,5,22,23,45,40
3404-001,2012,11,25,6,46,38,84,45
3404-001,2012,11,25,7,49,112,161,84
3404-001,2012,11,25,8,107,206,313,161
3404-001,2012,11,25,9,161,193,354,313
3404-001,2012,11,25,10,171,160,331,354
3404-001,2012,11,25,11,208,197,405,331
3404-001,2012,11,25,12,251,217,468,405
3404-001,2012,11,25,13,214,209,423,468
3404-001,2012,11,25,14,236,251,487,423
3404-001,2012,11,25,15,256,250,506,487
3404-001,2012,11,25,16,329,225,554,506
3404-001,2012,11,25,17,589,210,799,554
3404-001,2012,11,25,18,595,239,834,799
3404-001,2012,11,25,19,455,240,695,834
3404-001,2012,11,25,20,410,246,656,695
3404-001,2012,11,25,21,284,256,540,656
3404-001,2012,11,25,22,181,258,439,540
3404-001,2012,11,25,23,87,122,209,439
3404-001,2012,11,25,24,90,136,226,209
3404-001,2012,11,26,1,37,74,111,226
3404-001,2012,11,26,2,24,46,70,111
3404-001,2012,11,26,3,14,17,31,70
3404-001,2012,11,26,4,14,18,32,31
3404-001,2012,11,26,5,25,35,60,32
3404-001,2012,11,26,6,50,88,138,60
3404-001,2012,11,26,7,118,311,429,138
3404-001,2012,11,26,8,267,1097,1364,429
3404-001,2012,11,26,9,377,965,1342,1364
3404-001,2012,11,26,10,409,447,856,1342
3404-001,2012,11,26,11,440,439,879,856
3404-001,2012,11,26,12,440,476,916,879
3404-001,2012,11,26,13,396,368,764,916
3404-001,2012,11,26,14,403,445,848,764
3404-001,2012,11,26,15,453,481,934,848
3404-001,2012,11,26,16,540,421,961,934
3404-001,2012,11,26,17,517,378,895,961
3404-001,2012,11,26,18,621,381,1002,895
3404-001,2012,11,26,19,564,283,847,1002
3404-001,2012,11,26,20,480,232,712,847
3404-001,2012,11,26,21,411,175,586,712
3404-001,2012,11,26,22,263,118,381,586
3404-001,2012,11,26,23,155,94,249,381
3404-001,2012,11,26,24,69,79,148,249
3404-001,2012,11,27,1,53,63,116,148
3404-001,2012,11,27,2,35,28,63,116
3404-001,2012,11,27,3,29,29,58,63
3404-001,2012,11,27,4,27,27,54,58
3404-001,2012,11,27,5,38,41,79,54
3404-001,2012,11,27,6,79,73,152,79
3404-001,2012,11,27,7,101,285,386,152
3404-001,2012,11,27,8,273,1034,1307,386
3404-001,2012,11,27,9,430,889,1319,1307
3404-001,2012,11,27,10,387,474,861,1319
3404-001,2012,11,27,11,447,507,954,861
3404-001,2012,11,27,12,435,412,847,954
3404-001,2012,11,27,13,379,370,749,847
3404-001,2012,11,27,14,411,384,795,749
3404-001,2012,11,27,15,502,503,1005,795
3404-001,2012,11,27,16,559,430,989,1005
3404-001,2012,11,27,17,506,409,915,989
3404-001,2012,11,27,18,668,382,1050,915
3404-001,2012,11,27,19,675,305,980,1050
3404-001,2012,11,27,20,481,249,730,980
3404-001,2012,11,27,21,395,175,570,730
3404-001,2012,11,27,22,266,145,411,570
3404-001,2012,11,27,23,150,117,267,411
3404-001,2012,11,27,24,85,71,156,267
3404-001,2012,11,28,1,69,60,129,156
3404-001,2012,11,28,2,31,26,57,129
3404-001,2012,11,28,3,29,28,57,57
3404-001,2012,11,28,4,26,22,48,57
3404-001,2012,11,28,5,35,28,63,48
3404-001,2012,11,28,6,60,85,145,63
3404-001,2012,11,28,7,93,286,379,145
3404-001,2012,11,28,8,309,1008,1317,379
3404-001,2012,11,28,9,449,893,1342,1317
3404-001,2012,11,28,10,420,474,894,1342
3404-001,2012,11,28,11,480,489,969,894
3404-001,2012,11,28,12,455,438,893,969
3404-001,2012,11,28,13,397,383,780,893
3404-001,2012,11,28,14,444,407,851,780
3404-001,2012,11,28,15,525,447,972,851
3404-001,2012,11,28,16,487,460,947,972
3404-001,2012,11,28,17,537,367,904,947
3404-001,2012,11,28,18,691,361,1052,904
3404-001,2012,11,28,19,609,333,942,1052
3404-001,2012,11,28,20,423,262,685,942
3404-001,2012,11,28,21,433,187,620,685
3404-001,2012,11,28,22,270,156,426,620
3404-001,2012,11,28,23,175,104,279,426
3404-001,2012,11,28,24,81,81,162,279
3404-001,2012,11,29,1,61,54,115,162
3404-001,2012,11,29,2,33,32,65,115
3404-001,2012,11,29,3,32,15,47,65
3404-001,2012,11,29,4,16,30,46,47
3404-001,2012,11,29,5,34,31,65,46
3404-001,2012,11,29,6,80,90,170,65
3404-001,2012,11,29,7,108,295,403,170
3404-001,2012,11,29,8,297,986,1283,403
3404-001,2012,11,29,9,493,890,1383,1283
3404-001,2012,11,29,10,443,522,965,1383
3404-001,2012,11,29,11,390,386,776,965
3404-001,2012,11,29,12,452,477,929,776
3404-001,2012,11,29,13,397,398,795,929
3404-001,2012,11,29,14,439,424,863,795
3404-001,2012,11,29,15,545,492,1037,863
3404-001,2012,11,29,16,521,429,950,1037
3404-001,2012,11,29,17,547,418,965,950
3404-001,2012,11,29,18,660,407,1067,965
3404-001,2012,11,29,19,635,312,947,1067
3404-001,2012,11,29,20,453,255,708,947
3404-001,2012,11,29,21,428,187,615,708
3404-001,2012,11,29,22,309,134,443,615
3404-001,2012,11,29,23,186,91,277,443
3404-001,2012,11,29,24,79,86,165,277
3404-001,2012,11,30,1,69,47,116,165
3404-001,2012,11,30,2,37,37,74,116
3404-001,2012,11,30,3,24,35,59,74
3404-001,2012,11,30,4,24,22,46,59
3404-001,2012,11,30,5,43,39,82,46
3404-001,2012,11,30,6,61,92,153,82
3404-001,2012,11,30,7,116,321,437,153
3404-001,2012,11,30,8,301,1043,1344,437
3404-001,2012,11,30,9,447,911,1358,1344
3404-001,2012,11,30,10,424,440,864,1358
3404-001,2012,11,30,11,492,508,1000,864
3404-001,2012,11,30,12,440,454,894,1000
3404-001,2012,11,30,13,408,358,766,894
3404-001,2012,11,30,14,448,436,884,766
3404-001,2012,11,30,15,537,494,1031,884
3404-001,2012,11,30,16,533,436,969,1031
3404-001,2012,11,30,17,608,434,1042,969
3404-001,2012,11,30,18,792,362,1154,1042
3404-001,2012,11,30,19,802,355,1157,1154
3404-001,2012,11,30,20,524,266,790,1157
3404-001,2012,11,30,21,391,175,566,790
3404-001,2012,11,30,22,233,128,361,566
3404-001,2012,11,30,23,161,103,264,361
3404-001,2012,11,30,24,84,92,176,264
3404-001,2012,12,1,1,61,54,115,176
3404-001,2012,12,1,2,41,39,80,115
3404-001,2012,12,1,3,34,24,58,80
3404-001,2012,12,1,4,24,24,48,58
3404-001,2012,12,1,5,40,31,71,48
3404-001,2012,12,1,6,47,81,128,71
3404-001,2012,12,1,7,126,180,306,128
3404-001,2012,12,1,8,228,499,727,306
3404-001,2012,12,1,9,318,498,816,727
3404-001,2012,12,1,10,353,406,759,816
3404-001,2012,12,1,11,370,385,755,759
3404-001,2012,12,1,12,356,380,736,755
3404-001,2012,12,1,13,351,322,673,736
3404-001,2012,12,1,14,367,360,727,673
3404-001,2012,12,1,15,369,341,710,727
3404-001,2012,12,1,16,356,335,691,710
3404-001,2012,12,1,17,421,320,741,691
3404-001,2012,12,1,18,593,292,885,741
3404-001,2012,12,1,19,348,238,586,885
3404-001,2012,12,1,20,237,178,415,586
3404-001,2012,12,1,21,197,139,336,415
3404-001,2012,12,1,22,112,108,220,336
3404-001,2012,12,1,23,102,85,187,220
3404-001,2012,12,1,24,53,52,105,187
3404-001,2012,12,2,1,36,45,81,105
3404-001,2012,12,2,2,30,34,64,81
3404-001,2012,12,2,3,24,31,55,64
3404-001,2012,12,2,4,17,10,27,55
3404-001,2012,12,2,5,21,25,46,27
3404-001,2012,12,2,6,22,37,59,46
3404-001,2012,12,2,7,54,90,144,59
3404-001,2012,12,2,8,88,201,289,144
3404-001,2012,12,2,9,168,171,339,289
3404-001,2012,12,2,10,159,184,343,339
3404-001,2012,12,2,11,176,194,370,343
3404-001,2012,12,2,12,189,224,413,370
3404-001,2012,12,2,13,238,219,457,413
3404-001,2012,12,2,14,267,205,472,457
3404-001,2012,12,2,15,300,253,553,472
3404-001,2012,12,2,16,287,218,505,553
3404-001,2012,12,2,17,311,232,543,505
3404-001,2012,12,2,18,406,215,621,543
3404-001,2012,12,2,19,296,213,509,621
3404-001,2012,12,2,20,197,182,379,509
3404-001,2012,12,2,21,159,166,325,379
3404-001,2012,12,2,22,98,141,239,325
3404-001,2012,12,2,23,66,118,184,239
3404-001,2012,12,2,24,54,76,130,184
3404-001,2012,12,3,1,44,48,92,130
3404-001,2012,12,3,2,16,32,48,92
3404-001,2012,12,3,3,22,19,41,48
3404-001,2012,12,3,4,16,31,47,41
3404-001,2012,12,3,5,28,44,72,47
3404-001,2012,12,3,6,49,86,135,72
3404-001,2012,12,3,7,113,374,487,135
3404-001,2012,12,3,8,297,1210,1507,487
3404-001,2012,12,3,9,426,1005,1431,1507
3404-001,2012,12,3,10,385,471,856,1431
3404-001,2012,12,3,11,471,418,889,856
3404-001,2012,12,3,12,445,407,852,889
3404-001,2012,12,3,13,374,377,751,852
3404-001,2012,12,3,14,433,442,875,751
3404-001,2012,12,3,15,490,443,933,875
3404-001,2012,12,3,16,462,420,882,933
3404-001,2012,12,3,17,482,408,890,882
3404-001,2012,12,3,18,611,342,953,890
3404-001,2012,12,3,19,562,273,835,953
3404-001,2012,12,3,20,464,235,699,835
3404-001,2012,12,3,21,424,171,595,699
3404-001,2012,12,3,22,247,117,364,595
3404-001,2012,12,3,23,153,87,240,364
3404-001,2012,12,3,24,83,64,147,240
3404-001,2012,12,4,1,62,49,111,147
3404-001,2012,12,4,2,27,35,62,111
3404-001,2012,12,4,3,25,40,65,62
3404-001,2012,12,4,4,22,25,47,65
3404-001,2012,12,4,5,30,46,76,47
3404-001,2012,12,4,6,58,55,113,76
3404-001,2012,12,4,7,90,244,334,113
3404-001,2012,12,4,8,241,968,1209,334
3404-001,2012,12,4,9,428,938,1366,1209
3404-001,2012,12,4,10,384,452,836,1366
3404-001,2012,12,4,11,421,468,889,836
3404-001,2012,12,4,12,412,435,847,889
3404-001,2012,12,4,13,378,386,764,847
3404-001,2012,12,4,14,428,472,900,764
3404-001,2012,12,4,15,539,492,1031,900
3404-001,2012,12,4,16,532,457,989,1031
3404-001,2012,12,4,17,556,405,961,989
3404-001,2012,12,4,18,711,373,1084,961
3404-001,2012,12,4,19,598,313,911,1084
3404-001,2012,12,4,20,523,244,767,911
3404-001,2012,12,4,21,443,174,617,767
3404-001,2012,12,4,22,274,131,405,617
3404-001,2012,12,4,23,151,85,236,405
3404-001,2012,12,4,24,67,58,125,236
3404-001,2012,12,5,1,55,49,104,125
3404-001,2012,12,5,2,54,46,100,104
3404-001,2012,12,5,3,36,27,63,100
3404-001,2012,12,5,4,30,24,54,63
3404-001,2012,12,5,5,34,40,74,54
3404-001,2012,12,5,6,63,67,130,74
3404-001,2012,12,5,7,105,273,378,130
3404-001,2012,12,5,8,283,1009,1292,378
3404-001,2012,12,5,9,467,904,1371,1292
3404-001,2012,12,5,10,406,492,898,1371
3404-001,2012,12,5,11,473,458,931,898
3404-001,2012,12,5,12,435,442,877,931
3404-001,2012,12,5,13,403,368,771,877
3404-001,2012,12,5,14,428,363,791,771
3404-001,2012,12,5,15,439,320,759,791
3404-001,2012,12,5,16,434,312,746,759
3404-001,2012,12,5,17,432,255,687,746
3404-001,2012,12,5,18,613,226,839,687
3404-001,2012,12,5,19,534,201,735,839
3404-001,2012,12,5,20,329,169,498,735
3404-001,2012,12,5,21,281,114,395,498
3404-001,2012,12,5,22,152,87,239,395
3404-001,2012,12,5,23,92,51,143,239
3404-001,2012,12,5,24,52,47,99,143
3404-001,2012,12,6,1,32,28,60,99
3404-001,2012,12,6,2,15,21,36,60
3404-001,2012,12,6,3,18,23,41,36
3404-001,2012,12,6,4,17,21,38,41
3404-001,2012,12,6,5,28,30,58,38
3404-001,2012,12,6,6,29,46,75,58
3404-001,2012,12,6,7,48,165,213,75
3404-001,2012,12,6,8,168,503,671,213
3404-001,2012,12,6,9,285,708,993,671
3404-001,2012,12,6,10,260,462,722,993
3404-001,2012,12,6,11,292,391,683,722
3404-001,2012,12,6,12,340,347,687,683
3404-001,2012,12,6,13,371,321,692,687
3404-001,2012,12,6,14,379,381,760,692
3404-001,2012,12,6,15,411,462,873,760
3404-001,2012,12,6,16,441,395,836,873
3404-001,2012,12,6,17,465,335,800,836
3404-001,2012,12,6,18,523,293,816,800
3404-001,2012,12,6,19,612,232,844,816
3404-001,2012,12,6,20,464,215,679,844
3404-001,2012,12,6,21,364,119,483,679
3404-001,2012,12,6,22,222,89,311,483
3404-001,2012,12,6,23,116,49,165,311
3404-001,2012,12,6,24,86,35,121,165
3404-001,2012,12,7,1,32,29,61,121
3404-001,2012,12,7,2,23,30,53,61
3404-001,2012,12,7,3,15,35,50,53
3404-001,2012,12,7,4,18,29,47,50
3404-001,2012,12,7,5,21,20,41,47
3404-001,2012,12,7,6,41,64,105,41
3404-001,2012,12,7,7,63,215,278,105
3404-001,2012,12,7,8,164,791,955,278
3404-001,2012,12,7,9,300,717,1017,955
3404-001,2012,12,7,10,321,369,690,1017
3404-001,2012,12,7,11,323,322,645,690
3404-001,2012,12,7,12,326,306,632,645
3404-001,2012,12,7,13,325,258,583,632
3404-001,2012,12,7,14,331,272,603,583
3404-001,2012,12,7,15,394,359,753,603
3404-001,2012,12,7,16,441,345,786,753
3404-001,2012,12,7,17,461,297,758,786
3404-001,2012,12,7,18,695,272,967,758
3404-001,2012,12,7,19,580,250,830,967
3404-001,2012,12,7,20,412,188,600,830
3404-001,2012,12,7,21,330,126,456,600
3404-001,2012,12,7,22,185,85,270,456
3404-001,2012,12,7,23,111,69,180,270
3404-001,2012,12,7,24,82,55,137,180
3404-001,2012,12,8,1,51,31,82,137
3404-001,2012,12,8,2,21,32,53,82
3404-001,2012,12,8,3,28,22,50,53
3404-001,2012,12,8,4,21,15,36,50
3404-001,2012,12,8,5,24,26,50,36
3404-001,2012,12,8,6,34,44,78,50
3404-001,2012,12,8,7,60,103,163,78
3404-001,2012,12,8,8,118,291,409,163
3404-001,2012,12,8,9,212,376,588,409
3404-001,2012,12,8,10,231,264,495,588
3404-001,2012,12,8,11,298,369,667,495
3404-001,2012,12,8,12,374,289,663,667
3404-001,2012,12,8,13,283,227,510,663
3404-001,2012,12,8,14,301,265,566,510
3404-001,2012,12,8,15,321,267,588,566
3404-001,2012,12,8,16,309,265,574,588
3404-001,2012,12,8,17,402,285,687,574
3404-001,2012,12,8,18,434,206,640,687
3404-001,2012,12,8,19,275,170,445,640
3404-001,2012,12,8,20,174,120,294,445
3404-001,2012,12,8,21,109,110,219,294
3404-001,2012,12,8,22,71,78,149,219
3404-001,2012,12,8,23,60,59,119,149
3404-001,2012,12,8,24,40,40,80,119
3404-001,2012,12,9,1,34,21,55,80
3404-001,2012,12,9,2,19,22,41,55
3404-001,2012,12,9,3,15,15,30,41
3404-001,2012,12,9,4,12,5,17,30
3404-001,2012,12,9,5,17,16,33,17
3404-001,2012,12,9,6,27,20,47,33
3404-001,2012,12,9,7,45,43,88,47
3404-001,2012,12,9,8,80,127,207,88
3404-001,2012,12,9,9,109,145,254,207
3404-001,2012,12,9,10,129,149,278,254
3404-001,2012,12,9,11,171,148,319,278
3404-001,2012,12,9,12,157,207,364,319
3404-001,2012,12,9,13,149,152,301,364
3404-001,2012,12,9,14,197,167,364,301
3404-001,2012,12,9,15,193,195,388,364
3404-001,2012,12,9,16,186,213,399,388
3404-001,2012,12,9,17,233,202,435,399
3404-001,2012,12,9,18,248,161,409,435
3404-001,2012,12,9,19,190,165,355,409
3404-001,2012,12,9,20,121,126,247,355
3404-001,2012,12,9,21,104,103,207,247
3404-001,2012,12,9,22,54,109,163,207
3404-001,2012,12,9,23,31,68,99,163
3404-001,2012,12,9,24,49,49,98,99
3404-001,2012,12,10,1,31,43,74,98
3404-001,2012,12,10,2,10,20,30,74
3404-001,2012,12,10,3,8,12,20,30
3404-001,2012,12,10,4,17,11,28,20
3404-001,2012,12,10,5,31,26,57,28
3404-001,2012,12,10,6,50,75,125,57
3404-001,2012,12,10,7,104,289,393,125
3404-001,2012,12,10,8,262,1082,1344,393
3404-001,2012,12,10,9,346,937,1283,1344
3404-001,2012,12,10,10,355,464,819,1283
3404-001,2012,12,10,11,440,419,859,819
3404-001,2012,12,10,12,419,430,849,859
3404-001,2012,12,10,13,381,398,779,849
3404-001,2012,12,10,14,400,416,816,779
3404-001,2012,12,10,15,481,518,999,816
3404-001,2012,12,10,16,505,517,1022,999
3404-001,2012,12,10,17,519,407,926,1022
3404-001,2012,12,10,18,715,331,1046,926
3404-001,2012,12,10,19,625,327,952,1046
3404-001,2012,12,10,20,516,227,743,952
3404-001,2012,12,10,21,435,156,591,743
3404-001,2012,12,10,22,245,127,372,591
3404-001,2012,12,10,23,147,93,240,372
3404-001,2012,12,10,24,82,53,135,240
3404-001,2012,12,11,1,54,47,101,135
3404-001,2012,12,11,2,25,36,61,101
3404-001,2012,12,11,3,22,21,43,61
3404-001,2012,12,11,4,25,26,51,43
3404-001,2012,12,11,5,47,41,88,51
3404-001,2012,12,11,6,55,79,134,88
3404-001,2012,12,11,7,100,279,379,134
3404-001,2012,12,11,8,303,1031,1334,379
3404-001,2012,12,11,9,455,931,1386,1334
3404-001,2012,12,11,10,440,521,961,1386
3404-001,2012,12,11,11,472,503,975,961
3404-001,2012,12,11,12,474,490,964,975
3404-001,2012,12,11,13,453,395,848,964
3404-001,2012,12,11,14,448,475,923,848
3404-001,2012,12,11,15,561,528,1089,923
3404-001,2012,12,11,16,524,469,993,1089
3404-001,2012,12,11,17,523,454,977,993
3404-001,2012,12,11,18,736,333,1069,977
3404-001,2012,12,11,19,671,300,971,1069
3404-001,2012,12,11,20,418,258,676,971
3404-001,2012,12,11,21,427,170,597,676
3404-001,2012,12,11,22,280,142,422,597
3404-001,2012,12,11,23,162,85,247,422
3404-001,2012,12,11,24,59,55,114,247
3404-001,2012,12,12,1,42,56,98,114
3404-001,2012,12,12,2,33,28,61,98
3404-001,2012,12,12,3,23,31,54,61
3404-001,2012,12,12,4,35,24,59,54
3404-001,2012,12,12,5,41,40,81,59
3404-001,2012,12,12,6,76,54,130,81
3404-001,2012,12,12,7,95,295,390,130
3404-001,2012,12,12,8,264,1000,1264,390
3404-001,2012,12,12,9,434,939,1373,1264
3404-001,2012,12,12,10,411,514,925,1373
3404-001,2012,12,12,11,445,498,943,925
3404-001,2012,12,12,12,453,497,950,943
3404-001,2012,12,12,13,431,422,853,950
3404-001,2012,12,12,14,460,406,866,853
3404-001,2012,12,12,15,511,487,998,866
3404-001,2012,12,12,16,532,481,1013,998
3404-001,2012,12,12,17,539,391,930,1013
3404-001,2012,12,12,18,809,374,1183,930
3404-001,2012,12,12,19,676,295,971,1183
3404-001,2012,12,12,20,457,246,703,971
3404-001,2012,12,12,21,390,170,560,703
3404-001,2012,12,12,22,251,135,386,560
3404-001,2012,12,12,23,168,97,265,386
3404-001,2012,12,12,24,88,70,158,265
3404-001,2012,12,13,1,40,65,105,158
3404-001,2012,12,13,2,39,28,67,105
3404-001,2012,12,13,3,29,30,59,67
3404-001,2012,12,13,4,32,17,49,59
3404-001,2012,12,13,5,30,33,63,49
3404-001,2012,12,13,6,46,68,114,63
3404-001,2012,12,13,7,92,269,361,114
3404-001,2012,12,13,8,242,1008,1250,361
3404-001,2012,12,13,9,473,989,1462,1250
3404-001,2012,12,13,10,405,475,880,1462
3404-001,2012,12,13,11,456,485,941,880
3404-001,2012,12,13,12,432,482,914,941
3404-001,2012,12,13,13,379,387,766,914
3404-001,2012,12,13,14,468,428,896,766
3404-001,2012,12,13,15,520,471,991,896
3404-001,2012,12,13,16,534,484,1018,991
3404-001,2012,12,13,17,559,438,997,1018
3404-001,2012,12,13,18,747,386,1133,997
3404-001,2012,12,13,19,676,279,955,1133
3404-001,2012,12,13,20,483,237,720,955
3404-001,2012,12,13,21,445,193,638,720
3404-001,2012,12,13,22,254,134,388,638
3404-001,2012,12,13,23,161,92,253,388
3404-001,2012,12,13,24,102,84,186,253
3404-001,2012,12,14,1,54,50,104,186
3404-001,2012,12,14,2,43,43,86,104
3404-001,2012,12,14,3,38,42,80,86
3404-001,2012,12,14,4,28,28,56,80
3404-001,2012,12,14,5,41,40,81,56
3404-001,2012,12,14,6,65,87,152,81
3404-001,2012,12,14,7,92,238,330,152
3404-001,2012,12,14,8,205,592,797,330
3404-001,2012,12,14,9,415,550,965,797
3404-001,2012,12,14,10,343,625,968,965
3404-001,2012,12,14,11,393,418,811,968
3404-001,2012,12,14,12,394,350,744,811
3404-001,2012,12,14,13,377,363,740,744
3404-001,2012,12,14,14,434,381,815,740
3404-001,2012,12,14,15,476,414,890,815
3404-001,2012,12,14,16,491,407,898,890
3404-001,2012,12,14,17,502,365,867,898
3404-001,2012,12,14,18,718,329,1047,867
3404-001,2012,12,14,19,626,314,940,1047
3404-001,2012,12,14,20,422,253,675,940
3404-001,2012,12,14,21,355,151,506,675
3404-001,2012,12,14,22,209,105,314,506
3404-001,2012,12,14,23,128,79,207,314
3404-001,2012,12,14,24,71,62,133,207
3404-001,2012,12,15,1,67,48,115,133
3404-001,2012,12,15,2,28,27,55,115
3404-001,2012,12,15,3,37,28,65,55
3404-001,2012,12,15,4,34,24,58,65
3404-001,2012,12,15,5,32,37,69,58
3404-001,2012,12,15,6,59,71,130,69
3404-001,2012,12,15,7,81,151,232,130
3404-001,2012,12,15,8,135,420,555,232
3404-001,2012,12,15,9,318,463,781,555
3404-001,2012,12,15,10,320,384,704,781
3404-001,2012,12,15,11,356,360,716,704
3404-001,2012,12,15,12,364,363,727,716
3404-001,2012,12,15,13,354,313,667,727
3404-001,2012,12,15,14,361,319,680,667
3404-001,2012,12,15,15,375,277,652,680
3404-001,2012,12,15,16,373,297,670,652
3404-001,2012,12,15,17,409,312,721,670
3404-001,2012,12,15,18,518,257,775,721
3404-001,2012,12,15,19,314,218,532,775
3404-001,2012,12,15,20,211,168,379,532
3404-001,2012,12,15,21,182,115,297,379
3404-001,2012,12,15,22,124,107,231,297
3404-001,2012,12,15,23,98,73,171,231
3404-001,2012,12,15,24,59,48,107,171
3404-001,2012,12,16,1,39,42,81,107
3404-001,2012,12,16,2,24,27,51,81
3404-001,2012,12,16,3,27,17,44,51
3404-001,2012,12,16,4,19,18,37,44
3404-001,2012,12,16,5,16,13,29,37
3404-001,2012,12,16,6,15,28,43,29
3404-001,2012,12,16,7,33,76,109,43
3404-001,2012,12,16,8,73,156,229,109
3404-001,2012,12,16,9,143,137,280,229
3404-001,2012,12,16,10,155,131,286,280
3404-001,2012,12,16,11,216,189,405,286
3404-001,2012,12,16,12,201,191,392,405
3404-001,2012,12,16,13,210,211,421,392
3404-001,2012,12,16,14,197,225,422,421
3404-001,2012,12,16,15,225,227,452,422
3404-001,2012,12,16,16,280,231,511,452
3404-001,2012,12,16,17,290,212,502,511
3404-001,2012,12,16,18,327,196,523,502
3404-001,2012,12,16,19,213,184,397,523
3404-001,2012,12,16,20,147,167,314,397
3404-001,2012,12,16,21,125,123,248,314
3404-001,2012,12,16,22,81,128,209,248
3404-001,2012,12,16,23,61,93,154,209
3404-001,2012,12,16,24,52,57,109,154
3404-001,2012,12,17,1,32,40,72,109
3404-001,2012,12,17,2,18,32,50,72
3404-001,2012,12,17,3,7,18,25,50
3404-001,2012,12,17,4,19,17,36,25
3404-001,2012,12,17,5,20,28,48,36
3404-001,2012,12,17,6,53,92,145,48
3404-001,2012,12,17,7,104,322,426,145
3404-001,2012,12,17,8,269,1096,1365,426
3404-001,2012,12,17,9,380,1020,1400,1365
3404-001,2012,12,17,10,388,460,848,1400
3404-001,2012,12,17,11,460,433,893,848
3404-001,2012,12,17,12,494,470,964,893
3404-001,2012,12,17,13,417,389,806,964
3404-001,2012,12,17,14,430,430,860,806
3404-001,2012,12,17,15,513,485,998,860
3404-001,2012,12,17,16,516,466,982,998
3404-001,2012,12,17,17,552,426,978,982
3404-001,2012,12,17,18,649,397,1046,978
3404-001,2012,12,17,19,655,288,943,1046
3404-001,2012,12,17,20,507,233,740,943
3404-001,2012,12,17,21,466,177,643,740
3404-001,2012,12,17,22,264,125,389,643
3404-001,2012,12,17,23,155,98,253,389
3404-001,2012,12,17,24,72,70,142,253
3404-001,2012,12,18,1,59,54,113,142
3404-001,2012,12,18,2,35,35,70,113
3404-001,2012,12,18,3,22,37,59,70
3404-001,2012,12,18,4,28,25,53,59
3404-001,2012,12,18,5,48,40,88,53
3404-001,2012,12,18,6,49,84,133,88
3404-001,2012,12,18,7,111,257,368,133
3404-001,2012,12,18,8,281,1040,1321,368
3404-001,2012,12,18,9,444,935,1379,1321
3404-001,2012,12,18,10,469,514,983,1379
3404-001,2012,12,18,11,500,526,1026,983
3404-001,2012,12,18,12,489,441,930,1026
3404-001,2012,12,18,13,422,408,830,930
3404-001,2012,12,18,14,429,447,876,830
3404-001,2012,12,18,15,538,489,1027,876
3404-001,2012,12,18,16,504,485,989,1027
3404-001,2012,12,18,17,560,393,953,989
3404-001,2012,12,18,18,752,399,1151,953
3404-001,2012,12,18,19,803,298,1101,1151
3404-001,2012,12,18,20,506,258,764,1101
3404-001,2012,12,18,21,467,171,638,764
3404-001,2012,12,18,22,268,157,425,638
3404-001,2012,12,18,23,156,93,249,425
3404-001,2012,12,18,24,83,64,147,249
3404-001,2012,12,19,1,65,50,115,147
3404-001,2012,12,19,2,32,34,66,115
3404-001,2012,12,19,3,33,31,64,66
3404-001,2012,12,19,4,33,29,62,64
3404-001,2012,12,19,5,32,31,63,62
3404-001,2012,12,19,6,31,84,115,63
3404-001,2012,12,19,7,84,128,212,115
3404-001,2012,12,19,8,144,400,544,212
3404-001,2012,12,19,9,283,486,769,544
3404-001,2012,12,19,10,313,431,744,769
3404-001,2012,12,19,11,338,415,753,744
3404-001,2012,12,19,12,354,354,708,753
3404-001,2012,12,19,13,336,355,691,708
3404-001,2012,12,19,14,351,356,707,691
3404-001,2012,12,19,15,391,343,734,707
3404-001,2012,12,19,16,400,342,742,734
3404-001,2012,12,19,17,432,268,700,742
3404-001,2012,12,19,18,483,233,716,700
3404-001,2012,12,19,19,370,179,549,716
3404-001,2012,12,19,20,217,165,382,549
3404-001,2012,12,19,21,187,145,332,382
3404-001,2012,12,19,22,125,117,242,332
3404-001,2012,12,19,23,95,75,170,242
3404-001,2012,12,19,24,34,72,106,170
3404-001,2012,12,20,1,36,38,74,106
3404-001,2012,12,20,2,20,38,58,74
3404-001,2012,12,20,3,19,19,38,58
3404-001,2012,12,20,4,27,21,48,38
3404-001,2012,12,20,5,26,39,65,48
3404-001,2012,12,20,6,60,80,140,65
3404-001,2012,12,20,7,97,306,403,140
3404-001,2012,12,20,8,262,1072,1334,403
3404-001,2012,12,20,9,411,997,1408,1334
3404-001,2012,12,20,10,406,436,842,1408
3404-001,2012,12,20,11,442,471,913,842
3404-001,2012,12,20,12,451,450,901,913
3404-001,2012,12,20,13,437,386,823,901
3404-001,2012,12,20,14,460,495,955,823
3404-001,2012,12,20,15,539,511,1050,955
3404-001,2012,12,20,16,570,477,1047,1050
3404-001,2012,12,20,17,534,444,978,1047
3404-001,2012,12,20,18,723,397,1120,978
3404-001,2012,12,20,19,677,289,966,1120
3404-001,2012,12,20,20,451,229,680,966
3404-001,2012,12,20,21,424,183,607,680
3404-001,2012,12,20,22,267,144,411,607
3404-001,2012,12,20,23,171,109,280,411
3404-001,2012,12,20,24,85,75,160,280
3404-001,2012,12,21,1,47,69,116,160
3404-001,2012,12,21,2,43,33,76,116
3404-001,2012,12,21,3,29,31,60,76
3404-001,2012,12,21,4,28,27,55,60
3404-001,2012,12,21,5,46,47,93,55
3404-001,2012,12,21,6,67,82,149,93
3404-001,2012,12,21,7,90,278,368,149
3404-001,2012,12,21,8,291,957,1248,368
3404-001,2012,12,21,9,442,935,1377,1248
3404-001,2012,12,21,10,470,497,967,1377
3404-001,2012,12,21,11,447,486,933,967
3404-001,2012,12,21,12,407,441,848,933
3404-001,2012,12,21,13,409,371,780,848
3404-001,2012,12,21,14,380,402,782,780
3404-001,2012,12,21,15,532,373,905,782
3404-001,2012,12,21,16,471,431,902,905
3404-001,2012,12,21,17,489,377,866,902
3404-001,2012,12,21,18,780,339,1119,866
3404-001,2012,12,21,19,742,280,1022,1119
3404-001,2012,12,21,20,469,226,695,1022
3404-001,2012,12,21,21,399,165,564,695
3404-001,2012,12,21,22,233,129,362,564
3404-001,2012,12,21,23,140,100,240,362
3404-001,2012,12,21,24,91,78,169,240
3404-001,2012,12,22,1,60,52,112,169
3404-001,2012,12,22,2,47,52,99,112
3404-001,2012,12,22,3,31,29,60,99
3404-001,2012,12,22,4,31,22,53,60
3404-001,2012,12,22,5,40,26,66,53
3404-001,2012,12,22,6,49,73,122,66
3404-001,2012,12,22,7,81,139,220,122
3404-001,2012,12,22,8,175,461,636,220
3404-001,2012,12,22,9,293,477,770,636
3404-001,2012,12,22,10,323,394,717,770
3404-001,2012,12,22,11,374,406,780,717
3404-001,2012,12,22,12,383,308,691,780
3404-001,2012,12,22,13,371,311,682,691
3404-001,2012,12,22,14,363,336,699,682
3404-001,2012,12,22,15,355,300,655,699
3404-001,2012,12,22,16,382,287,669,655
3404-001,2012,12,22,17,391,270,661,669
3404-001,2012,12,22,18,643,259,902,661
3404-001,2012,12,22,19,350,202,552,902
3404-001,2012,12,22,20,192,149,341,552
3404-001,2012,12,22,21,165,105,270,341
3404-001,2012,12,22,22,109,112,221,270
3404-001,2012,12,22,23,77,57,134,221
3404-001,2012,12,22,24,53,50,103,134
3404-001,2012,12,23,1,40,30,70,103
3404-001,2012,12,23,2,19,22,41,70
3404-001,2012,12,23,3,14,22,36,41
3404-001,2012,12,23,4,19,14,33,36
3404-001,2012,12,23,5,22,23,45,33
3404-001,2012,12,23,6,27,26,53,45
3404-001,2012,12,23,7,30,57,87,53
3404-001,2012,12,23,8,70,150,220,87
3404-001,2012,12,23,9,130,174,304,220
3404-001,2012,12,23,10,113,149,262,304
3404-001,2012,12,23,11,165,170,335,262
3404-001,2012,12,23,12,193,180,373,335
3404-001,2012,12,23,13,171,161,332,373
3404-001,2012,12,23,14,197,207,404,332
3404-001,2012,12,23,15,218,217,435,404
3404-001,2012,12,23,16,266,197,463,435
3404-001,2012,12,23,17,259,222,481,463
3404-001,2012,12,23,18,267,168,435,481
3404-001,2012,12,23,19,222,169,391,435
3404-001,2012,12,23,20,138,141,279,391
3404-001,2012,12,23,21,116,119,235,279
3404-001,2012,12,23,22,79,118,197,235
3404-001,2012,12,23,23,51,75,126,197
3404-001,2012,12,23,24,31,58,89,126
3404-001,2012,12,24,1,34,44,78,89
3404-001,2012,12,24,2,22,24,46,78
3404-001,2012,12,24,3,10,17,27,46
3404-001,2012,12,24,4,21,26,47,27
3404-001,2012,12,24,5,33,35,68,47
3404-001,2012,12,24,6,54,81,135,68
3404-001,2012,12,24,7,100,233,333,135
3404-001,2012,12,24,8,236,913,1149,333
3404-001,2012,12,24,9,363,799,1162,1149
3404-001,2012,12,24,10,347,389,736,1162
3404-001,2012,12,24,11,440,484,924,736
3404-001,2012,12,24,12,431,401,832,924
3404-001,2012,12,24,13,374,352,726,832
3404-001,2012,12,24,14,429,414,843,726
3404-001,2012,12,24,15,518,440,958,843
3404-001,2012,12,24,16,480,473,953,958
3404-001,2012,12,24,17,512,418,930,953
3404-001,2012,12,24,18,747,352,1099,930
3404-001,2012,12,24,19,696,278,974,1099
3404-001,2012,12,24,20,458,230,688,974
3404-001,2012,12,24,21,292,172,464,688
3404-001,2012,12,24,22,229,140,369,464
3404-001,2012,12,24,23,122,97,219,369
3404-001,2012,12,24,24,66,79,145,219
3404-001,2012,12,25,1,49,48,97,145
3404-001,2012,12,25,2,43,38,81,97
3404-001,2012,12,25,3,26,26,52,81
3404-001,2012,12,25,4,24,14,38,52
3404-001,2012,12,25,5,31,26,57,38
3404-001,2012,12,25,6,41,48,89,57
3404-001,2012,12,25,7,59,84,143,89
3404-001,2012,12,25,8,85,203,288,143
3404-001,2012,12,25,9,135,182,317,288
3404-001,2012,12,25,10,130,165,295,317
3404-001,2012,12,25,11,178,212,390,295
3404-001,2012,12,25,12,201,220,421,390
3404-001,2012,12,25,13,180,211,391,421
3404-001,2012,12,25,14,240,251,491,391
3404-001,2012,12,25,15,259,219,478,491
3404-001,2012,12,25,16,283,201,484,478
3404-001,2012,12,25,17,300,194,494,484
3404-001,2012,12,25,18,315,190,505,494
3404-001,2012,12,25,19,201,147,348,505
3404-001,2012,12,25,20,137,138,275,348
3404-001,2012,12,25,21,104,103,207,275
3404-001,2012,12,25,22,62,112,174,207
3404-001,2012,12,25,23,47,70,117,174
3404-001,2012,12,25,24,25,59,84,117
3404-001,2012,12,26,1,25,50,75,84
3404-001,2012,12,26,2,20,27,47,75
3404-001,2012,12,26,3,14,33,47,47
3404-001,2012,12,26,4,18,12,30,47
3404-001,2012,12,26,5,34,29,63,30
3404-001,2012,12,26,6,42,67,109,63
3404-001,2012,12,26,7,93,281,374,109
3404-001,2012,12,26,8,245,1100,1345,374
3404-001,2012,12,26,9,343,1001,1344,1345
3404-001,2012,12,26,10,385,479,864,1344
3404-001,2012,12,26,11,432,446,878,864
3404-001,2012,12,26,12,442,448,890,878
3404-001,2012,12,26,13,438,387,825,890
3404-001,2012,12,26,14,434,447,881,825
3404-001,2012,12,26,15,534,449,983,881
3404-001,2012,12,26,16,486,433,919,983
3404-001,2012,12,26,17,511,429,940,919
3404-001,2012,12,26,18,729,332,1061,940
3404-001,2012,12,26,19,727,324,1051,1061
3404-001,2012,12,26,20,477,245,722,1051
3404-001,2012,12,26,21,393,190,583,722
3404-001,2012,12,26,22,251,171,422,583
3404-001,2012,12,26,23,154,86,240,422
3404-001,2012,12,26,24,85,68,153,240
3404-001,2012,12,27,1,58,49,107,153
3404-001,2012,12,27,2,35,33,68,107
3404-001,2012,12,27,3,29,36,65,68
3404-001,2012,12,27,4,37,29,66,65
3404-001,2012,12,27,5,47,30,77,66
3404-001,2012,12,27,6,43,62,105,77
3404-001,2012,12,27,7,101,236,337,105
3404-001,2012,12,27,8,236,973,1209,337
3404-001,2012,12,27,9,437,937,1374,1209
3404-001,2012,12,27,10,454,474,928,1374
3404-001,2012,12,27,11,488,484,972,928
3404-001,2012,12,27,12,490,497,987,972
3404-001,2012,12,27,13,458,404,862,987
3404-001,2012,12,27,14,442,465,907,862
3404-001,2012,12,27,15,523,458,981,907
3404-001,2012,12,27,16,562,513,1075,981
3404-001,2012,12,27,17,562,439,1001,1075
3404-001,2012,12,27,18,752,346,1098,1001
3404-001,2012,12,27,19,678,296,974,1098
3404-001,2012,12,27,20,453,277,730,974
3404-001,2012,12,27,21,477,176,653,730
3404-001,2012,12,27,22,259,167,426,653
3404-001,2012,12,27,23,167,101,268,426
3404-001,2012,12,27,24,99,74,173,268
3404-001,2012,12,28,1,59,59,118,173
3404-001,2012,12,28,2,38,51,89,118
3404-001,2012,12,28,3,35,31,66,89
3404-001,2012,12,28,4,24,34,58,66
3404-001,2012,12,28,5,45,34,79,58
3404-001,2012,12,28,6,59,69,128,79
3404-001,2012,12,28,7,96,235,331,128
3404-001,2012,12,28,8,242,923,1165,331
3404-001,2012,12,28,9,412,832,1244,1165
3404-001,2012,12,28,10,329,415,744,1244
3404-001,2012,12,28,11,353,437,790,744
3404-001,2012,12,28,12,410,384,794,790
3404-001,2012,12,28,13,403,327,730,794
3404-001,2012,12,28,14,391,361,752,730
3404-001,2012,12,28,15,471,374,845,752
3404-001,2012,12,28,16,480,402,882,845
3404-001,2012,12,28,17,525,369,894,882
3404-001,2012,12,28,18,841,357,1198,894
3404-001,2012,12,28,19,732,294,1026,1198
3404-001,2012,12,28,20,423,246,669,1026
3404-001,2012,12,28,21,320,154,474,669
3404-001,2012,12,28,22,234,125,359,474
3404-001,2012,12,28,23,145,98,243,359
3404-001,2012,12,28,24,105,69,174,243
3404-001,2012,12,29,1,67,52,119,174
3404-001,2012,12,29,2,35,36,71,119
3404-001,2012,12,29,3,38,30,68,71
3404-001,2012,12,29,4,40,20,60,68
3404-001,2012,12,29,5,54,23,77,60
3404-001,2012,12,29,6,54,82,136,77
3404-001,2012,12,29,7,99,163,262,136
3404-001,2012,12,29,8,167,391,558,262
3404-001,2012,12,29,9,284,476,760,558
3404-001,2012,12,29,10,310,380,690,760
3404-001,2012,12,29,11,373,348,721,690
3404-001,2012,12,29,12,374,384,758,721
3404-001,2012,12,29,13,375,299,674,758
3404-001,2012,12,29,14,376,344,720,674
3404-001,2012,12,29,15,387,323,710,720
3404-001,2012,12,29,16,449,306,755,710
3404-001,2012,12,29,17,444,283,727,755
3404-001,2012,12,29,18,481,260,741,727
3404-001,2012,12,29,19,319,199,518,741
3404-001,2012,12,29,20,201,141,342,518
3404-001,2012,12,29,21,135,113,248,342
3404-001,2012,12,29,22,98,81,179,248
3404-001,2012,12,29,23,69,62,131,179
3404-001,2012,12,29,24,32,38,70,131
3404-001,2012,12,30,1,18,23,41,70
3404-001,2012,12,30,2,26,21,47,41
3404-001,2012,12,30,3,17,15,32,47
3404-001,2012,12,30,4,19,14,33,32
3404-001,2012,12,30,5,15,5,20,33
3404-001,2012,12,30,6,13,15,28,20
3404-001,2012,12,30,7,18,30,48,28
3404-001,2012,12,30,8,38,79,117,48
3404-001,2012,12,30,9,71,116,187,117
3404-001,2012,12,30,10,85,67,152,187
3404-001,2012,12,30,11,130,103,233,152
3404-001,2012,12,30,12,139,114,253,233
3404-001,2012,12,30,13,153,129,282,253
3404-001,2012,12,30,14,175,143,318,282
3404-001,2012,12,30,15,192,167,359,318
3404-001,2012,12,30,16,240,160,400,359
3404-001,2012,12,30,17,237,157,394,400
3404-001,2012,12,30,18,256,166,422,394
3404-001,2012,12,30,19,157,135,292,422
3404-001,2012,12,30,20,117,118,235,292
3404-001,2012,12,30,21,98,74,172,235
3404-001,2012,12,30,22,64,83,147,172
3404-001,2012,12,30,23,50,61,111,147
3404-001,2012,12,30,24,38,33,71,111
3404-001,2012,12,31,1,20,35,55,71
3404-001,2012,12,31,2,27,21,48,55
3404-001,2012,12,31,3,13,20,33,48
3404-001,2012,12,31,4,11,15,26,33
3404-001,2012,12,31,5,16,20,36,26
3404-001,2012,12,31,6,29,47,76,36
3404-001,2012,12,31,7,57,141,198,76
3404-001,2012,12,31,8,139,599,738,198
3404-001,2012,12,31,9,250,505,755,738
3404-001,2012,12,31,10,243,302,545,755
3404-001,2012,12,31,11,310,334,644,545
3404-001,2012,12,31,12,325,317,642,644
3404-001,2012,12,31,13,344,282,626,642
3404-001,2012,12,31,14,374,325,699,626
3404-001,2012,12,31,15,384,297,681,699
3404-001,2012,12,31,16,398,305,703,681
3404-001,2012,12,31,17,396,279,675,703
3404-001,2012,12,31,18,660,270,930,675
3404-001,2012,12,31,19,408,221,629,930
3404-001,2012,12,31,20,259,181,440,629
3404-001,2012,12,31,21,176,127,303,440
3404-001,2012,12,31,22,138,110,248,303
3404-001,2012,12,31,23,120,85,205,248
3404-001,2012,12,31,24,54,41,95,205
3404-001,2013,1,1,1,38,33,71,95
3404-001,2013,1,1,2,46,43,89,71
3404-001,2013,1,1,3,28,32,60,89
3404-001,2013,1,1,4,17,21,38,60
3404-001,2013,1,1,5,17,27,44,38
3404-001,2013,1,1,6,15,35,50,44
3404-001,2013,1,1,7,34,49,83,50
3404-001,2013,1,1,8,47,60,107,83
3404-001,2013,1,1,9,79,93,172,107
3404-001,2013,1,1,10,76,84,160,172
3404-001,2013,1,1,11,108,108,216,160
3404-001,2013,1,1,12,146,148,294,216
3404-001,2013,1,1,13,157,164,321,294
3404-001,2013,1,1,14,171,141,312,321
3404-001,2013,1,1,15,176,164,340,312
3404-001,2013,1,1,16,185,175,360,340
3404-001,2013,1,1,17,213,170,383,360
3404-001,2013,1,1,18,185,145,330,383
3404-001,2013,1,1,19,136,141,277,330
3404-001,2013,1,1,20,114,89,203,277
3404-001,2013,1,1,21,79,93,172,203
3404-001,2013,1,1,22,77,84,161,172
3404-001,2013,1,1,23,36,69,105,161
3404-001,2013,1,1,24,21,34,55,105
3404-001,2013,1,2,1,17,30,47,55
3404-001,2013,1,2,2,14,15,29,47
3404-001,2013,1,2,3,10,17,27,29
3404-001,2013,1,2,4,9,11,20,27
3404-001,2013,1,2,5,14,12,26,20
3404-001,2013,1,2,6,26,48,74,26
3404-001,2013,1,2,7,43,145,188,74
3404-001,2013,1,2,8,122,497,619,188
3404-001,2013,1,2,9,222,777,999,619
3404-001,2013,1,2,10,214,427,641,999
3404-001,2013,1,2,11,260,339,599,641
3404-001,2013,1,2,12,265,333,598,599
3404-001,2013,1,2,13,270,285,555,598
3404-001,2013,1,2,14,342,336,678,555
3404-001,2013,1,2,15,402,384,786,678
3404-001,2013,1,2,16,460,366,826,786
3404-001,2013,1,2,17,403,316,719,826
3404-001,2013,1,2,18,556,328,884,719
3404-001,2013,1,2,19,593,212,805,884
3404-001,2013,1,2,20,381,195,576,805
3404-001,2013,1,2,21,304,113,417,576
3404-001,2013,1,2,22,210,105,315,417
3404-001,2013,1,2,23,119,72,191,315
3404-001,2013,1,2,24,53,46,99,191
3404-001,2013,1,3,1,59,52,111,99
3404-001,2013,1,3,2,34,34,68,111
3404-001,2013,1,3,3,25,35,60,68
3404-001,2013,1,3,4,22,29,51,60
3404-001,2013,1,3,5,35,43,78,51
3404-001,2013,1,3,6,57,99,156,78
3404-001,2013,1,3,7,96,272,368,156
3404-001,2013,1,3,8,261,1053,1314,368
3404-001,2013,1,3,9,434,955,1389,1314
3404-001,2013,1,3,10,411,501,912,1389
3404-001,2013,1,3,11,489,483,972,912
3404-001,2013,1,3,12,478,464,942,972
3404-001,2013,1,3,13,413,382,795,942
3404-001,2013,1,3,14,454,452,906,795
3404-001,2013,1,3,15,509,506,1015,906
3404-001,2013,1,3,16,527,458,985,1015
3404-001,2013,1,3,17,521,396,917,985
3404-001,2013,1,3,18,683,335,1018,917
3404-001,2013,1,3,19,635,290,925,1018
3404-001,2013,1,3,20,472,252,724,925
3404-001,2013,1,3,21,434,160,594,724
3404-001,2013,1,3,22,260,137,397,594
3404-001,2013,1,3,23,154,105,259,397
3404-001,2013,1,3,24,87,69,156,259
3404-001,2013,1,4,1,57,55,112,156
3404-001,2013,1,4,2,36,38,74,112
3404-001,2013,1,4,3,32,30,62,74
3404-001,2013,1,4,4,23,28,51,62
3404-001,2013,1,4,5,46,49,95,51
3404-001,2013,1,4,6,63,103,166,95
3404-001,2013,1,4,7,100,284,384,166
3404-001,2013,1,4,8,259,1060,1319,384
3404-001,2013,1,4,9,419,883,1302,1319
3404-001,2013,1,4,10,423,488,911,1302
3404-001,2013,1,4,11,514,497,1011,911
3404-001,2013,1,4,12,476,467,943,1011
3404-001,2013,1,4,13,456,387,843,943
3404-001,2013,1,4,14,472,490,962,843
3404-001,2013,1,4,15,511,483,994,962
3404-001,2013,1,4,16,542,466,1008,994
3404-001,2013,1,4,17,563,391,954,1008
3404-001,2013,1,4,18,805,383,1188,954
3404-001,2013,1,4,19,768,349,1117,1188
3404-001,2013,1,4,20,520,273,793,1117
3404-001,2013,1,4,21,430,192,622,793
3404-001,2013,1,4,22,283,147,430,622
3404-001,2013,1,4,23,158,106,264,430
3404-001,2013,1,4,24,77,74,151,264
3404-001,2013,1,5,1,57,51,108,151
3404-001,2013,1,5,2,41,33,74,108
3404-001,2013,1,5,3,30,35,65,74
3404-001,2013,1,5,4,28,38,66,65
3404-001,2013,1,5,5,40,41,81,66
3404-001,2013,1,5,6,49,98,147,81
3404-001,2013,1,5,7,102,173,275,147
3404-001,2013,1,5,8,195,485,680,275
3404-001,2013,1,5,9,315,483,798,680
3404-001,2013,1,5,10,364,399,763,798
3404-001,2013,1,5,11,378,391,769,763
3404-001,2013,1,5,12,393,378,771,769
3404-001,2013,1,5,13,359,327,686,771
3404-001,2013,1,5,14,382,344,726,686
3404-001,2013,1,5,15,389,309,698,726
3404-001,2013,1,5,16,434,313,747,698
3404-001,2013,1,5,17,421,287,708,747
3404-001,2013,1,5,18,579,285,864,708
3404-001,2013,1,5,19,345,242,587,864
3404-001,2013,1,5,20,246,164,410,587
3404-001,2013,1,5,21,166,127,293,410
3404-001,2013,1,5,22,127,99,226,293
3404-001,2013,1,5,23,74,71,145,226
3404-001,2013,1,5,24,47,56,103,145
3404-001,2013,1,6,1,35,39,74,103
3404-001,2013,1,6,2,33,22,55,74
3404-001,2013,1,6,3,18,21,39,55
3404-001,2013,1,6,4,24,17,41,39
3404-001,2013,1,6,5,15,18,33,41
3404-001,2013,1,6,6,27,34,61,33
3404-001,2013,1,6,7,41,68,109,61
3404-001,2013,1,6,8,79,163,242,109
3404-001,2013,1,6,9,147,178,325,242
3404-001,2013,1,6,10,150,152,302,325
3404-001,2013,1,6,11,186,201,387,302
3404-001,2013,1,6,12,192,215,407,387
3404-001,2013,1,6,13,194,223,417,407
3404-001,2013,1,6,14,210,226,436,417
3404-001,2013,1,6,15,277,221,498,436
3404-001,2013,1,6,16,289,233,522,498
3404-001,2013,1,6,17,318,223,541,522
3404-001,2013,1,6,18,311,206,517,541
3404-001,2013,1,6,19,235,200,435,517
3404-001,2013,1,6,20,164,151,315,435
3404-001,2013,1,6,21,119,143,262,315
3404-001,2013,1,6,22,90,130,220,262
3404-001,2013,1,6,23,66,81,147,220
3404-001,2013,1,6,24,33,77,110,147
3404-001,2013,1,7,1,29,56,85,110
3404-001,2013,1,7,2,14,34,48,85
3404-001,2013,1,7,3,25,26,51,48
3404-001,2013,1,7,4,18,19,37,51
3404-001,2013,1,7,5,26,38,64,37
3404-001,2013,1,7,6,57,98,155,64
3404-001,2013,1,7,7,112,328,440,155
3404-001,2013,1,7,8,258,1144,1402,440
3404-001,2013,1,7,9,358,957,1315,1402
3404-001,2013,1,7,10,368,448,816,1315
3404-001,2013,1,7,11,416,451,867,816
3404-001,2013,1,7,12,460,416,876,867
3404-001,2013,1,7,13,384,362,746,876
3404-001,2013,1,7,14,418,429,847,746
3404-001,2013,1,7,15,522,493,1015,847
3404-001,2013,1,7,16,524,471,995,1015
3404-001,2013,1,7,17,546,405,951,995
3404-001,2013,1,7,18,628,348,976,951
3404-001,2013,1,7,19,616,289,905,976
3404-001,2013,1,7,20,470,246,716,905
3404-001,2013,1,7,21,461,171,632,716
3404-001,2013,1,7,22,307,137,444,632
3404-001,2013,1,7,23,160,86,246,444
3404-001,2013,1,7,24,80,64,144,246
3404-001,2013,1,8,1,67,43,110,144
3404-001,2013,1,8,2,35,42,77,110
3404-001,2013,1,8,3,17,27,44,77
3404-001,2013,1,8,4,34,35,69,44
3404-001,2013,1,8,5,43,33,76,69
3404-001,2013,1,8,6,52,108,160,76
3404-001,2013,1,8,7,108,308,416,160
3404-001,2013,1,8,8,285,1051,1336,416
3404-001,2013,1,8,9,436,865,1301,1336
3404-001,2013,1,8,10,393,482,875,1301
3404-001,2013,1,8,11,464,469,933,875
3404-001,2013,1,8,12,452,455,907,933
3404-001,2013,1,8,13,402,447,849,907
3404-001,2013,1,8,14,473,427,900,849
3404-001,2013,1,8,15,511,511,1022,900
3404-001,2013,1,8,16,471,417,888,1022
3404-001,2013,1,8,17,571,372,943,888
3404-001,2013,1,8,18,685,330,1015,943
3404-001,2013,1,8,19,618,305,923,1015
3404-001,2013,1,8,20,463,253,716,923
3404-001,2013,1,8,21,446,172,618,716
3404-001,2013,1,8,22,262,148,410,618
3404-001,2013,1,8,23,142,73,215,410
3404-001,2013,1,8,24,97,58,155,215
3404-001,2013,1,9,1,64,37,101,155
3404-001,2013,1,9,2,32,39,71,101
3404-001,2013,1,9,3,26,27,53,71
3404-001,2013,1,9,4,27,40,67,53
3404-001,2013,1,9,5,41,27,68,67
3404-001,2013,1,9,6,54,93,147,68
3404-001,2013,1,9,7,101,298,399,147
3404-001,2013,1,9,8,262,1010,1272,399
3404-001,2013,1,9,9,439,904,1343,1272
3404-001,2013,1,9,10,451,483,934,1343
3404-001,2013,1,9,11,460,488,948,934
3404-001,2013,1,9,12,452,491,943,948
3404-001,2013,1,9,13,381,370,751,943
3404-001,2013,1,9,14,452,460,912,751
3404-001,2013,1,9,15,540,510,1050,912
3404-001,2013,1,9,16,566,495,1061,1050
3404-001,2013,1,9,17,518,384,902,1061
3404-001,2013,1,9,18,692,338,1030,902
3404-001,2013,1,9,19,711,295,1006,1030
3404-001,2013,1,9,20,425,248,673,1006
3404-001,2013,1,9,21,386,188,574,673
3404-001,2013,1,9,22,257,157,414,574
3404-001,2013,1,9,23,148,83,231,414
3404-001,2013,1,9,24,94,77,171,231
3404-001,2013,1,10,1,66,53,119,171
3404-001,2013,1,10,2,38,34,72,119
3404-001,2013,1,10,3,20,39,59,72
3404-001,2013,1,10,4,21,30,51,59
3404-001,2013,1,10,5,39,39,78,51
3404-001,2013,1,10,6,61,109,170,78
3404-001,2013,1,10,7,104,280,384,170
3404-001,2013,1,10,8,271,1051,1322,384
3404-001,2013,1,10,9,443,949,1392,1322
3404-001,2013,1,10,10,427,510,937,1392
3404-001,2013,1,10,11,473,506,979,937
3404-001,2013,1,10,12,472,476,948,979
3404-001,2013,1,10,13,409,401,810,948
3404-001,2013,1,10,14,440,450,890,810
3404-001,2013,1,10,15,517,523,1040,890
3404-001,2013,1,10,16,527,447,974,1040
3404-001,2013,1,10,17,546,409,955,974
3404-001,2013,1,10,18,725,345,1070,955
3404-001,2013,1,10,19,626,285,911,1070
3404-001,2013,1,10,20,480,249,729,911
3404-001,2013,1,10,21,426,173,599,729
3404-001,2013,1,10,22,265,143,408,599
3404-001,2013,1,10,23,148,98,246,408
3404-001,2013,1,10,24,75,61,136,246
3404-001,2013,1,11,1,55,61,116,136
3404-001,2013,1,11,2,40,35,75,116
3404-001,2013,1,11,3,26,26,52,75
3404-001,2013,1,11,4,18,28,46,52
3404-001,2013,1,11,5,51,44,95,46
3404-001,2013,1,11,6,74,118,192,95
3404-001,2013,1,11,7,91,295,386,192
3404-001,2013,1,11,8,271,1066,1337,386
3404-001,2013,1,11,9,444,897,1341,1337
3404-001,2013,1,11,10,413,486,899,1341
3404-001,2013,1,11,11,540,511,1051,899
3404-001,2013,1,11,12,458,488,946,1051
3404-001,2013,1,11,13,441,379,820,946
3404-001,2013,1,11,14,496,486,982,820
3404-001,2013,1,11,15,540,498,1038,982
3404-001,2013,1,11,16,546,491,1037,1038
3404-001,2013,1,11,17,564,392,956,1037
3404-001,2013,1,11,18,824,391,1215,956
3404-001,2013,1,11,19,818,338,1156,1215
3404-001,2013,1,11,20,507,266,773,1156
3404-001,2013,1,11,21,410,196,606,773
3404-001,2013,1,11,22,276,143,419,606
3404-001,2013,1,11,23,156,106,262,419
3404-001,2013,1,11,24,77,76,153,262
3404-001,2013,1,12,1,54,52,106,153
3404-001,2013,1,12,2,33,40,73,106
3404-001,2013,1,12,3,30,34,64,73
3404-001,2013,1,12,4,28,41,69,64
3404-001,2013,1,12,5,41,33,74,69
3404-001,2013,1,12,6,42,88,130,74
3404-001,2013,1,12,7,101,173,274,130
3404-001,2013,1,12,8,186,474,660,274
3404-001,2013,1,12,9,318,492,810,660
3404-001,2013,1,12,10,352,385,737,810
3404-001,2013,1,12,11,357,381,738,737
3404-001,2013,1,12,12,382,345,727,738
3404-001,2013,1,12,13,352,310,662,727
3404-001,2013,1,12,14,369,323,692,662
3404-001,2013,1,12,15,400,305,705,692
3404-001,2013,1,12,16,435,304,739,705
3404-001,2013,1,12,17,433,282,715,739
3404-001,2013,1,12,18,559,278,837,715
3404-001,2013,1,12,19,344,220,564,837
3404-001,2013,1,12,20,256,137,393,564
3404-001,2013,1,12,21,143,120,263,393
3404-001,2013,1,12,22,118,110,228,263
3404-001,2013,1,12,23,66,64,130,228
3404-001,2013,1,12,24,44,57,101,130
3404-001,2013,1,13,1,29,40,69,101
3404-001,2013,1,13,2,35,19,54,69
3404-001,2013,1,13,3,19,16,35,54
3404-001,2013,1,13,4,15,18,33,35
3404-001,2013,1,13,5,16,14,30,33
3404-001,2013,1,13,6,22,26,48,30
3404-001,2013,1,13,7,37,49,86,48
3404-001,2013,1,13,8,75,132,207,86
3404-001,2013,1,13,9,133,183,316,207
3404-001,2013,1,13,10,152,147,299,316
3404-001,2013,1,13,11,190,192,382,299
3404-001,2013,1,13,12,164,199,363,382
3404-001,2013,1,13,13,181,247,428,363
3404-001,2013,1,13,14,190,189,379,428
3404-001,2013,1,13,15,291,227,518,379
3404-001,2013,1,13,16,248,214,462,518
3404-001,2013,1,13,17,311,221,532,462
3404-001,2013,1,13,18,296,212,508,532
3404-001,2013,1,13,19,224,190,414,508
3404-001,2013,1,13,20,159,139,298,414
3404-001,2013,1,13,21,107,159,266,298
3404-001,2013,1,13,22,103,116,219,266
3404-001,2013,1,13,23,63,66,129,219
3404-001,2013,1,13,24,31,66,97,129
3404-001,2013,1,14,1,23,50,73,97
3404-001,2013,1,14,2,11,29,40,73
3404-001,2013,1,14,3,17,17,34,40
3404-001,2013,1,14,4,23,17,40,34
3404-001,2013,1,14,5,23,32,55,40
3404-001,2013,1,14,6,53,104,157,55
3404-001,2013,1,14,7,120,340,460,157
3404-001,2013,1,14,8,263,1171,1434,460
3404-001,2013,1,14,9,354,1016,1370,1434
3404-001,2013,1,14,10,392,460,852,1370
3404-001,2013,1,14,11,446,483,929,852
3404-001,2013,1,14,12,474,475,949,929
3404-001,2013,1,14,13,422,388,810,949
3404-001,2013,1,14,14,485,476,961,810
3404-001,2013,1,14,15,554,537,1091,961
3404-001,2013,1,14,16,541,497,1038,1091
3404-001,2013,1,14,17,510,440,950,1038
3404-001,2013,1,14,18,693,371,1064,950
3404-001,2013,1,14,19,636,310,946,1064
3404-001,2013,1,14,20,503,242,745,946
3404-001,2013,1,14,21,455,168,623,745
3404-001,2013,1,14,22,279,132,411,623
3404-001,2013,1,14,23,135,92,227,411
3404-001,2013,1,14,24,95,62,157,227
3404-001,2013,1,15,1,67,44,111,157
3404-001,2013,1,15,2,25,38,63,111
3404-001,2013,1,15,3,21,17,38,63
3404-001,2013,1,15,4,18,28,46,38
3404-001,2013,1,15,5,28,42,70,46
3404-001,2013,1,15,6,52,100,152,70
3404-001,2013,1,15,7,92,286,378,152
3404-001,2013,1,15,8,274,1057,1331,378
3404-001,2013,1,15,9,456,843,1299,1331
3404-001,2013,1,15,10,403,543,946,1299
3404-001,2013,1,15,11,449,517,966,946
3404-001,2013,1,15,12,507,435,942,966
3404-001,2013,1,15,13,413,395,808,942
3404-001,2013,1,15,14,476,464,940,808
3404-001,2013,1,15,15,566,504,1070,940
3404-001,2013,1,15,16,529,466,995,1070
3404-001,2013,1,15,17,517,396,913,995
3404-001,2013,1,15,18,666,331,997,913
3404-001,2013,1,15,19,655,300,955,997
3404-001,2013,1,15,20,457,230,687,955
3404-001,2013,1,15,21,444,193,637,687
3404-001,2013,1,15,22,293,131,424,637
3404-001,2013,1,15,23,136,70,206,424
3404-001,2013,1,15,24,78,63,141,206
3404-001,2013,1,16,1,61,39,100,141
3404-001,2013,1,16,2,37,38,75,100
3404-001,2013,1,16,3,30,35,65,75
3404-001,2013,1,16,4,30,26,56,65
3404-001,2013,1,16,5,33,59,92,56
3404-001,2013,1,16,6,49,95,144,92
3404-001,2013,1,16,7,94,293,387,144
3404-001,2013,1,16,8,269,1014,1283,387
3404-001,2013,1,16,9,430,908,1338,1283
3404-001,2013,1,16,10,433,498,931,1338
3404-001,2013,1,16,11,466,508,974,931
3404-001,2013,1,16,12,477,428,905,974
3404-001,2013,1,16,13,404,361,765,905
3404-001,2013,1,16,14,436,401,837,765
3404-001,2013,1,16,15,526,448,974,837
3404-001,2013,1,16,16,479,442,921,974
3404-001,2013,1,16,17,514,405,919,921
3404-001,2013,1,16,18,666,325,991,919
3404-001,2013,1,16,19,659,283,942,991
3404-001,2013,1,16,20,459,240,699,942
3404-001,2013,1,16,21,386,161,547,699
3404-001,2013,1,16,22,217,116,333,547
3404-001,2013,1,16,23,153,90,243,333
3404-001,2013,1,16,24,81,54,135,243
3404-001,2013,1,17,1,52,51,103,135
3404-001,2013,1,17,2,30,33,63,103
3404-001,2013,1,17,3,29,31,60,63
3404-001,2013,1,17,4,23,27,50,60
3404-001,2013,1,17,5,31,47,78,50
3404-001,2013,1,17,6,53,89,142,78
3404-001,2013,1,17,7,87,263,350,142
3404-001,2013,1,17,8,251,1055,1306,350
3404-001,2013,1,17,9,424,960,1384,1306
3404-001,2013,1,17,10,395,492,887,1384
3404-001,2013,1,17,11,504,459,963,887
3404-001,2013,1,17,12,484,451,935,963
3404-001,2013,1,17,13,416,363,779,935
3404-001,2013,1,17,14,468,454,922,779
3404-001,2013,1,17,15,500,489,989,922
3404-001,2013,1,17,16,527,468,995,989
3404-001,2013,1,17,17,495,383,878,995
3404-001,2013,1,17,18,640,324,964,878
3404-001,2013,1,17,19,643,295,938,964
3404-001,2013,1,17,20,464,254,718,938
3404-001,2013,1,17,21,441,146,587,718
3404-001,2013,1,17,22,255,131,386,587
3404-001,2013,1,17,23,160,111,271,386
3404-001,2013,1,17,24,98,77,175,271
3404-001,2013,1,18,1,59,48,107,175
3404-001,2013,1,18,2,32,41,73,107
3404-001,2013,1,18,3,37,33,70,73
3404-001,2013,1,18,4,28,27,55,70
3404-001,2013,1,18,5,40,53,93,55
3404-001,2013,1,18,6,52,87,139,93
3404-001,2013,1,18,7,108,273,381,139
3404-001,2013,1,18,8,247,1054,1301,381
3404-001,2013,1,18,9,393,868,1261,1301
3404-001,2013,1,18,10,433,490,923,1261
3404-001,2013,1,18,11,487,482,969,923
3404-001,2013,1,18,12,494,446,940,969
3404-001,2013,1,18,13,470,395,865,940
3404-001,2013,1,18,14,448,494,942,865
3404-001,2013,1,18,15,482,468,950,942
3404-001,2013,1,18,16,537,440,977,950
3404-001,2013,1,18,17,562,390,952,977
3404-001,2013,1,18,18,786,375,1161,952
3404-001,2013,1,18,19,717,360,1077,1161
3404-001,2013,1,18,20,533,279,812,1077
3404-001,2013,1,18,21,450,187,637,812
3404-001,2013,1,18,22,290,151,441,637
3404-001,2013,1,18,23,160,105,265,441
3404-001,2013,1,18,24,77,72,149,265
3404-001,2013,1,19,1,60,49,109,149
3404-001,2013,1,19,2,49,25,74,109
3404-001,2013,1,19,3,30,36,66,74
3404-001,2013,1,19,4,27,34,61,66
3404-001,2013,1,19,5,39,48,87,61
3404-001,2013,1,19,6,56,107,163,87
3404-001,2013,1,19,7,103,173,276,163
3404-001,2013,1,19,8,204,496,700,276
3404-001,2013,1,19,9,311,474,785,700
3404-001,2013,1,19,10,376,412,788,785
3404-001,2013,1,19,11,398,401,799,788
3404-001,2013,1,19,12,404,410,814,799
3404-001,2013,1,19,13,365,344,709,814
3404-001,2013,1,19,14,394,365,759,709
3404-001,2013,1,19,15,377,312,689,759
3404-001,2013,1,19,16,432,322,754,689
3404-001,2013,1,19,17,409,292,701,754
3404-001,2013,1,19,18,598,292,890,701
3404-001,2013,1,19,19,345,263,608,890
3404-001,2013,1,19,20,235,190,425,608
3404-001,2013,1,19,21,188,134,322,425
3404-001,2013,1,19,22,135,88,223,322
3404-001,2013,1,19,23,81,77,158,223
3404-001,2013,1,19,24,49,54,103,158
3404-001,2013,1,20,1,40,38,78,103
3404-001,2013,1,20,2,31,24,55,78
3404-001,2013,1,20,3,16,25,41,55
3404-001,2013,1,20,4,32,15,47,41
3404-001,2013,1,20,5,14,22,36,47
3404-001,2013,1,20,6,31,41,72,36
3404-001,2013,1,20,7,44,87,131,72
3404-001,2013,1,20,8,82,194,276,131
3404-001,2013,1,20,9,160,173,333,276
3404-001,2013,1,20,10,147,157,304,333
3404-001,2013,1,20,11,181,209,390,304
3404-001,2013,1,20,12,220,231,451,390
3404-001,2013,1,20,13,206,199,405,451
3404-001,2013,1,20,14,229,262,491,405
3404-001,2013,1,20,15,262,215,477,491
3404-001,2013,1,20,16,330,252,582,477
3404-001,2013,1,20,17,325,225,550,582
3404-001,2013,1,20,18,326,200,526,550
3404-001,2013,1,20,19,246,210,456,526
3404-001,2013,1,20,20,168,162,330,456
3404-001,2013,1,20,21,130,126,256,330
3404-001,2013,1,20,22,76,143,219,256
3404-001,2013,1,20,23,68,95,163,219
3404-001,2013,1,20,24,35,87,122,163
3404-001,2013,1,21,1,35,63,98,122
3404-001,2013,1,21,2,17,39,56,98
3404-001,2013,1,21,3,33,36,69,56
3404-001,2013,1,21,4,13,21,34,69
3404-001,2013,1,21,5,29,45,74,34
3404-001,2013,1,21,6,61,93,154,74
3404-001,2013,1,21,7,104,317,421,154
3404-001,2013,1,21,8,253,1118,1371,421
3404-001,2013,1,21,9,361,898,1259,1371
3404-001,2013,1,21,10,345,435,780,1259
3404-001,2013,1,21,11,387,419,806,780
3404-001,2013,1,21,12,447,357,804,806
3404-001,2013,1,21,13,346,335,681,804
3404-001,2013,1,21,14,352,382,734,681
3404-001,2013,1,21,15,420,472,892,734
3404-001,2013,1,21,16,442,421,863,892
3404-001,2013,1,21,17,489,361,850,863
3404-001,2013,1,21,18,568,282,850,850
3404-001,2013,1,21,19,585,273,858,850
3404-001,2013,1,21,20,466,232,698,858
3404-001,2013,1,21,21,429,156,585,698
3404-001,2013,1,21,22,269,126,395,585
3404-001,2013,1,21,23,144,81,225,395
3404-001,2013,1,21,24,74,64,138,225
3404-001,2013,1,22,1,55,43,98,138
3404-001,2013,1,22,2,35,32,67,98
3404-001,2013,1,22,3,24,25,49,67
3404-001,2013,1,22,4,31,32,63,49
3404-001,2013,1,22,5,24,37,61,63
3404-001,2013,1,22,6,45,90,135,61
3404-001,2013,1,22,7,91,286,377,135
3404-001,2013,1,22,8,253,987,1240,377
3404-001,2013,1,22,9,445,894,1339,1240
3404-001,2013,1,22,10,409,439,848,1339
3404-001,2013,1,22,11,413,526,939,848
3404-001,2013,1,22,12,460,400,860,939
3404-001,2013,1,22,13,397,357,754,860
3404-001,2013,1,22,14,394,459,853,754
3404-001,2013,1,22,15,510,536,1046,853
3404-001,2013,1,22,16,535,474,1009,1046
3404-001,2013,1,22,17,553,360,913,1009
3404-001,2013,1,22,18,652,307,959,913
3404-001,2013,1,22,19,653,310,963,959
3404-001,2013,1,22,20,509,240,749,963
3404-001,2013,1,22,21,421,198,619,749
3404-001,2013,1,22,22,275,146,421,619
3404-001,2013,1,22,23,168,85,253,421
3404-001,2013,1,22,24,87,82,169,253
3404-001,2013,1,23,1,49,51,100,169
3404-001,2013,1,23,2,40,41,81,100
3404-001,2013,1,23,3,32,32,64,81
3404-001,2013,1,23,4,41,37,78,64
3404-001,2013,1,23,5,39,41,80,78
3404-001,2013,1,23,6,57,76,133,80
3404-001,2013,1,23,7,89,302,391,133
3404-001,2013,1,23,8,256,1056,1312,391
3404-001,2013,1,23,9,448,903,1351,1312
3404-001,2013,1,23,10,433,466,899,1351
3404-001,2013,1,23,11,463,507,970,899
3404-001,2013,1,23,12,454,459,913,970
3404-001,2013,1,23,13,413,375,788,913
3404-001,2013,1,23,14,440,456,896,788
3404-001,2013,1,23,15,516,472,988,896
3404-001,2013,1,23,16,528,470,998,988
3404-001,2013,1,23,17,547,347,894,998
3404-001,2013,1,23,18,690,361,1051,894
3404-001,2013,1,23,19,687,300,987,1051
3404-001,2013,1,23,20,436,257,693,987
3404-001,2013,1,23,21,390,187,577,693
3404-001,2013,1,23,22,237,135,372,577
3404-001,2013,1,23,23,169,95,264,372
3404-001,2013,1,23,24,80,81,161,264
3404-001,2013,1,24,1,54,48,102,161
3404-001,2013,1,24,2,34,41,75,102
3404-001,2013,1,24,3,26,39,65,75
3404-001,2013,1,24,4,34,38,72,65
3404-001,2013,1,24,5,29,33,62,72
3404-001,2013,1,24,6,60,84,144,62
3404-001,2013,1,24,7,94,303,397,144
3404-001,2013,1,24,8,270,1012,1282,397
3404-001,2013,1,24,9,461,902,1363,1282
3404-001,2013,1,24,10,425,484,909,1363
3404-001,2013,1,24,11,431,466,897,909
3404-001,2013,1,24,12,437,485,922,897
3404-001,2013,1,24,13,404,362,766,922
3404-001,2013,1,24,14,454,456,910,766
3404-001,2013,1,24,15,511,456,967,910
3404-001,2013,1,24,16,529,444,973,967
3404-001,2013,1,24,17,507,423,930,973
3404-001,2013,1,24,18,649,315,964,930
3404-001,2013,1,24,19,719,302,1021,964
3404-001,2013,1,24,20,477,246,723,1021
3404-001,2013,1,24,21,419,190,609,723
3404-001,2013,1,24,22,265,150,415,609
3404-001,2013,1,24,23,157,110,267,415
3404-001,2013,1,24,24,91,70,161,267
3404-001,2013,1,25,1,54,56,110,161
3404-001,2013,1,25,2,30,40,70,110
3404-001,2013,1,25,3,35,29,64,70
3404-001,2013,1,25,4,33,39,72,64
3404-001,2013,1,25,5,34,53,87,72
3404-001,2013,1,25,6,49,70,119,87
3404-001,2013,1,25,7,83,264,347,119
3404-001,2013,1,25,8,266,1027,1293,347
3404-001,2013,1,25,9,403,900,1303,1293
3404-001,2013,1,25,10,403,476,879,1303
3404-001,2013,1,25,11,478,509,987,879
3404-001,2013,1,25,12,498,444,942,987
3404-001,2013,1,25,13,448,397,845,942
3404-001,2013,1,25,14,445,451,896,845
3404-001,2013,1,25,15,523,517,1040,896
3404-001,2013,1,25,16,544,484,1028,1040
3404-001,2013,1,25,17,510,393,903,1028
3404-001,2013,1,25,18,807,358,1165,903
3404-001,2013,1,25,19,824,368,1192,1165
3404-001,2013,1,25,20,526,289,815,1192
3404-001,2013,1,25,21,406,185,591,815
3404-001,2013,1,25,22,299,140,439,591
3404-001,2013,1,25,23,140,106,246,439
3404-001,2013,1,25,24,83,69,152,246
3404-001,2013,1,26,1,48,41,89,152
3404-001,2013,1,26,2,52,43,95,89
3404-001,2013,1,26,3,37,37,74,95
3404-001,2013,1,26,4,36,38,74,74
3404-001,2013,1,26,5,46,44,90,74
3404-001,2013,1,26,6,61,98,159,90
3404-001,2013,1,26,7,92,174,266,159
3404-001,2013,1,26,8,196,480,676,266
3404-001,2013,1,26,9,368,476,844,676
3404-001,2013,1,26,10,325,368,693,844
3404-001,2013,1,26,11,403,381,784,693
3404-001,2013,1,26,12,391,349,740,784
3404-001,2013,1,26,13,385,331,716,740
3404-001,2013,1,26,14,385,374,759,716
3404-001,2013,1,26,15,403,351,754,759
3404-001,2013,1,26,16,431,299,730,754
3404-001,2013,1,26,17,421,284,705,730
3404-001,2013,1,26,18,537,282,819,705
3404-001,2013,1,26,19,375,244,619,819
3404-001,2013,1,26,20,240,167,407,619
3404-001,2013,1,26,21,189,142,331,407
3404-001,2013,1,26,22,114,122,236,331
3404-001,2013,1,26,23,89,75,164,236
3404-001,2013,1,26,24,47,62,109,164
3404-001,2013,1,27,1,59,44,103,109
3404-001,2013,1,27,2,30,30,60,103
3404-001,2013,1,27,3,17,14,31,60
3404-001,2013,1,27,4,19,16,35,31
3404-001,2013,1,27,5,27,20,47,35
3404-001,2013,1,27,6,32,46,78,47
3404-001,2013,1,27,7,50,86,136,78
3404-001,2013,1,27,8,86,148,234,136
3404-001,2013,1,27,9,184,194,378,234
3404-001,2013,1,27,10,172,205,377,378
3404-001,2013,1,27,11,212,239,451,377
3404-001,2013,1,27,12,200,215,415,451
3404-001,2013,1,27,13,210,205,415,415
3404-001,2013,1,27,14,219,235,454,415
3404-001,2013,1,27,15,248,226,474,454
3404-001,2013,1,27,16,281,234,515,474
3404-001,2013,1,27,17,277,244,521,515
3404-001,2013,1,27,18,254,208,462,521
3404-001,2013,1,27,19,200,203,403,462
3404-001,2013,1,27,20,161,141,302,403
3404-001,2013,1,27,21,117,123,240,302
3404-001,2013,1,27,22,106,123,229,240
3404-001,2013,1,27,23,60,102,162,229
3404-001,2013,1,27,24,52,65,117,162
3404-001,2013,1,28,1,34,40,74,117
3404-001,2013,1,28,2,25,30,55,74
3404-001,2013,1,28,3,12,18,30,55
3404-001,2013,1,28,4,18,21,39,30
3404-001,2013,1,28,5,27,32,59,39
3404-001,2013,1,28,6,51,123,174,59
3404-001,2013,1,28,7,107,331,438,174
3404-001,2013,1,28,8,279,1219,1498,438
3404-001,2013,1,28,9,395,989,1384,1498
3404-001,2013,1,28,10,419,468,887,1384
3404-001,2013,1,28,11,423,510,933,887
3404-001,2013,1,28,12,461,464,925,933
3404-001,2013,1,28,13,427,400,827,925
3404-001,2013,1,28,14,473,457,930,827
3404-001,2013,1,28,15,570,497,1067,930
3404-001,2013,1,28,16,525,494,1019,1067
3404-001,2013,1,28,17,545,435,980,1019
3404-001,2013,1,28,18,718,410,1128,980
3404-001,2013,1,28,19,682,299,981,1128
3404-001,2013,1,28,20,501,260,761,981
3404-001,2013,1,28,21,423,164,587,761
3404-001,2013,1,28,22,302,152,454,587
3404-001,2013,1,28,23,136,76,212,454
3404-001,2013,1,28,24,88,68,156,212
3404-001,2013,1,29,1,55,62,117,156
3404-001,2013,1,29,2,40,52,92,117
3404-001,2013,1,29,3,47,32,79,92
3404-001,2013,1,29,4,32,25,57,79
3404-001,2013,1,29,5,37,56,93,57
3404-001,2013,1,29,6,66,113,179,93
3404-001,2013,1,29,7,98,325,423,179
3404-001,2013,1,29,8,305,1064,1369,423
3404-001,2013,1,29,9,484,927,1411,1369
3404-001,2013,1,29,10,477,535,1012,1411
3404-001,2013,1,29,11,498,540,1038,1012
3404-001,2013,1,29,12,486,509,995,1038
3404-001,2013,1,29,13,428,432,860,995
3404-001,2013,1,29,14,454,483,937,860
3404-001,2013,1,29,15,552,468,1020,937
3404-001,2013,1,29,16,534,443,977,1020
3404-001,2013,1,29,17,565,413,978,977
3404-001,2013,1,29,18,724,348,1072,978
3404-001,2013,1,29,19,657,288,945,1072
3404-001,2013,1,29,20,496,243,739,945
3404-001,2013,1,29,21,411,188,599,739
3404-001,2013,1,29,22,313,145,458,599
3404-001,2013,1,29,23,146,113,259,458
3404-001,2013,1,29,24,97,73,170,259
3404-001,2013,1,30,1,52,55,107,170
3404-001,2013,1,30,2,39,55,94,107
3404-001,2013,1,30,3,32,33,65,94
3404-001,2013,1,30,4,40,40,80,65
3404-001,2013,1,30,5,36,48,84,80
3404-001,2013,1,30,6,55,90,145,84
3404-001,2013,1,30,7,102,319,421,145
3404-001,2013,1,30,8,285,1068,1353,421
3404-001,2013,1,30,9,476,970,1446,1353
3404-001,2013,1,30,10,470,493,963,1446
3404-001,2013,1,30,11,466,531,997,963
3404-001,2013,1,30,12,553,481,1034,997
3404-001,2013,1,30,13,429,430,859,1034
3404-001,2013,1,30,14,456,512,968,859
3404-001,2013,1,30,15,511,461,972,968
3404-001,2013,1,30,16,616,477,1093,972
3404-001,2013,1,30,17,575,439,1014,1093
3404-001,2013,1,30,18,747,392,1139,1014
3404-001,2013,1,30,19,727,313,1040,1139
3404-001,2013,1,30,20,457,249,706,1040
3404-001,2013,1,30,21,402,216,618,706
3404-001,2013,1,30,22,251,136,387,618
3404-001,2013,1,30,23,171,102,273,387
3404-001,2013,1,30,24,114,72,186,273
3404-001,2013,1,31,1,71,54,125,186
3404-001,2013,1,31,2,44,55,99,125
3404-001,2013,1,31,3,37,34,71,99
3404-001,2013,1,31,4,26,41,67,71
3404-001,2013,1,31,5,34,35,69,67
3404-001,2013,1,31,6,57,90,147,69
3404-001,2013,1,31,7,96,286,382,147
3404-001,2013,1,31,8,276,1102,1378,382
3404-001,2013,1,31,9,449,956,1405,1378
3404-001,2013,1,31,10,425,531,956,1405
3404-001,2013,1,31,11,506,510,1016,956
3404-001,2013,1,31,12,461,472,933,1016
3404-001,2013,1,31,13,409,429,838,933
3404-001,2013,1,31,14,517,457,974,838
3404-001,2013,1,31,15,569,537,1106,974
3404-001,2013,1,31,16,547,477,1024,1106
3404-001,2013,1,31,17,607,451,1058,1024
3404-001,2013,1,31,18,651,401,1052,1058
3404-001,2013,1,31,19,744,295,1039,1052
3404-001,2013,1,31,20,490,254,744,1039
3404-001,2013,1,31,21,437,208,645,744
3404-001,2013,1,31,22,287,151,438,645
3404-001,2013,1,31,23,181,110,291,438
3404-001,2013,1,31,24,93,82,175,291
3404-001,2013,2,1,1,78,65,143,175
3404-001,2013,2,1,2,40,48,88,143
3404-001,2013,2,1,3,33,27,60,88
3404-001,2013,2,1,4,24,40,64,60
3404-001,2013,2,1,5,28,46,74,64
3404-001,2013,2,1,6,60,99,159,74
3404-001,2013,2,1,7,75,268,343,159
3404-001,2013,2,1,8,239,988,1227,343
3404-001,2013,2,1,9,411,865,1276,1227
3404-001,2013,2,1,10,408,439,847,1276
3404-001,2013,2,1,11,489,436,925,847
3404-001,2013,2,1,12,420,390,810,925
3404-001,2013,2,1,13,400,370,770,810
3404-001,2013,2,1,14,454,386,840,770
3404-001,2013,2,1,15,459,440,899,840
3404-001,2013,2,1,16,523,412,935,899
3404-001,2013,2,1,17,536,415,951,935
3404-001,2013,2,1,18,737,362,1099,951
3404-001,2013,2,1,19,707,360,1067,1099
3404-001,2013,2,1,20,548,277,825,1067
3404-001,2013,2,1,21,418,165,583,825
3404-001,2013,2,1,22,243,133,376,583
3404-001,2013,2,1,23,167,92,259,376
3404-001,2013,2,1,24,102,80,182,259
3404-001,2013,2,2,1,72,55,127,182
3404-001,2013,2,2,2,45,48,93,127
3404-001,2013,2,2,3,40,24,64,93
3404-001,2013,2,2,4,38,45,83,64
3404-001,2013,2,2,5,48,51,99,83
3404-001,2013,2,2,6,62,76,138,99
3404-001,2013,2,2,7,88,152,240,138
3404-001,2013,2,2,8,204,461,665,240
3404-001,2013,2,2,9,328,561,889,665
3404-001,2013,2,2,10,352,398,750,889
3404-001,2013,2,2,11,437,370,807,750
3404-001,2013,2,2,12,403,385,788,807
3404-001,2013,2,2,13,360,353,713,788
3404-001,2013,2,2,14,378,355,733,713
3404-001,2013,2,2,15,405,350,755,733
3404-001,2013,2,2,16,421,330,751,755
3404-001,2013,2,2,17,462,288,750,751
3404-001,2013,2,2,18,553,283,836,750
3404-001,2013,2,2,19,402,267,669,836
3404-001,2013,2,2,20,236,199,435,669
3404-001,2013,2,2,21,163,145,308,435
3404-001,2013,2,2,22,152,104,256,308
3404-001,2013,2,2,23,73,70,143,256
3404-001,2013,2,2,24,56,57,113,143
3404-001,2013,2,3,1,42,39,81,113
3404-001,2013,2,3,2,28,32,60,81
3404-001,2013,2,3,3,20,14,34,60
3404-001,2013,2,3,4,13,25,38,34
3404-001,2013,2,3,5,25,19,44,38
3404-001,2013,2,3,6,35,42,77,44
3404-001,2013,2,3,7,38,67,105,77
3404-001,2013,2,3,8,82,163,245,105
3404-001,2013,2,3,9,158,211,369,245
3404-001,2013,2,3,10,147,206,353,369
3404-001,2013,2,3,11,223,207,430,353
3404-001,2013,2,3,12,210,221,431,430
3404-001,2013,2,3,13,239,217,456,431
3404-001,2013,2,3,14,245,242,487,456
3404-001,2013,2,3,15,269,273,542,487
3404-001,2013,2,3,16,292,226,518,542
3404-001,2013,2,3,17,288,237,525,518
3404-001,2013,2,3,18,291,231,522,525
3404-001,2013,2,3,19,210,208,418,522
3404-001,2013,2,3,20,179,176,355,418
3404-001,2013,2,3,21,110,154,264,355
3404-001,2013,2,3,22,95,126,221,264
3404-001,2013,2,3,23,72,116,188,221
3404-001,2013,2,3,24,34,67,101,188
3404-001,2013,2,4,1,22,34,56,101
3404-001,2013,2,4,2,21,42,63,56
3404-001,2013,2,4,3,13,31,44,63
3404-001,2013,2,4,4,15,31,46,44
3404-001,2013,2,4,5,22,27,49,46
3404-001,2013,2,4,6,39,70,109,49
3404-001,2013,2,4,7,88,223,311,109
3404-001,2013,2,4,8,188,631,819,311
3404-001,2013,2,4,9,293,675,968,819
3404-001,2013,2,4,10,300,564,864,968
3404-001,2013,2,4,11,364,388,752,864
3404-001,2013,2,4,12,406,369,775,752
3404-001,2013,2,4,13,392,403,795,775
3404-001,2013,2,4,14,402,421,823,795
3404-001,2013,2,4,15,494,458,952,823
3404-001,2013,2,4,16,509,420,929,952
3404-001,2013,2,4,17,494,430,924,929
3404-001,2013,2,4,18,616,348,964,924
3404-001,2013,2,4,19,625,278,903,964
3404-001,2013,2,4,20,490,244,734,903
3404-001,2013,2,4,21,442,204,646,734
3404-001,2013,2,4,22,277,123,400,646
3404-001,2013,2,4,23,154,94,248,400
3404-001,2013,2,4,24,113,82,195,248
3404-001,2013,2,5,1,61,51,112,195
3404-001,2013,2,5,2,38,45,83,112
3404-001,2013,2,5,3,27,33,60,83
3404-001,2013,2,5,4,31,38,69,60
3404-001,2013,2,5,5,40,52,92,69
3404-001,2013,2,5,6,66,101,167,92
3404-001,2013,2,5,7,72,287,359,167
3404-001,2013,2,5,8,281,1042,1323,359
3404-001,2013,2,5,9,427,893,1320,1323
3404-001,2013,2,5,10,458,533,991,1320
3404-001,2013,2,5,11,482,531,1013,991
3404-001,2013,2,5,12,512,499,1011,1013
3404-001,2013,2,5,13,433,426,859,1011
3404-001,2013,2,5,14,453,491,944,859
3404-001,2013,2,5,15,589,530,1119,944
3404-001,2013,2,5,16,591,512,1103,1119
3404-001,2013,2,5,17,563,447,1010,1103
3404-001,2013,2,5,18,705,397,1102,1010
3404-001,2013,2,5,19,663,305,968,1102
3404-001,2013,2,5,20,539,246,785,968
3404-001,2013,2,5,21,431,208,639,785
3404-001,2013,2,5,22,257,149,406,639
3404-001,2013,2,5,23,142,75,217,406
3404-001,2013,2,5,24,90,52,142,217
3404-001,2013,2,6,1,61,46,107,142
3404-001,2013,2,6,2,43,47,90,107
3404-001,2013,2,6,3,21,32,53,90
3404-001,2013,2,6,4,31,38,69,53
3404-001,2013,2,6,5,38,31,69,69
3404-001,2013,2,6,6,31,62,93,69
3404-001,2013,2,6,7,73,195,268,93
3404-001,2013,2,6,8,216,421,637,268
3404-001,2013,2,6,9,373,610,983,637
3404-001,2013,2,6,10,355,516,871,983
3404-001,2013,2,6,11,384,461,845,871
3404-001,2013,2,6,12,453,473,926,845
3404-001,2013,2,6,13,411,423,834,926
3404-001,2013,2,6,14,468,422,890,834
3404-001,2013,2,6,15,573,482,1055,890
3404-001,2013,2,6,16,532,479,1011,1055
3404-001,2013,2,6,17,533,417,950,1011
3404-001,2013,2,6,18,743,362,1105,950
3404-001,2013,2,6,19,694,280,974,1105
3404-001,2013,2,6,20,441,243,684,974
3404-001,2013,2,6,21,381,204,585,684
3404-001,2013,2,6,22,278,153,431,585
3404-001,2013,2,6,23,175,102,277,431
3404-001,2013,2,6,24,117,90,207,277
3404-001,2013,2,7,1,57,73,130,207
3404-001,2013,2,7,2,46,41,87,130
3404-001,2013,2,7,3,35,19,54,87
3404-001,2013,2,7,4,32,31,63,54
3404-001,2013,2,7,5,39,36,75,63
3404-001,2013,2,7,6,53,75,128,75
3404-001,2013,2,7,7,82,230,312,128
3404-001,2013,2,7,8,226,697,923,312
3404-001,2013,2,7,9,428,903,1331,923
3404-001,2013,2,7,10,427,567,994,1331
3404-001,2013,2,7,11,520,532,1052,994
3404-001,2013,2,7,12,481,445,926,1052
3404-001,2013,2,7,13,477,431,908,926
3404-001,2013,2,7,14,486,496,982,908
3404-001,2013,2,7,15,607,548,1155,982
3404-001,2013,2,7,16,645,486,1131,1155
3404-001,2013,2,7,17,607,471,1078,1131
3404-001,2013,2,7,18,708,402,1110,1078
3404-001,2013,2,7,19,781,350,1131,1110
3404-001,2013,2,7,20,560,304,864,1131
3404-001,2013,2,7,21,461,221,682,864
3404-001,2013,2,7,22,276,160,436,682
3404-001,2013,2,7,23,187,116,303,436
3404-001,2013,2,7,24,81,92,173,303
3404-001,2013,2,8,1,63,67,130,173
3404-001,2013,2,8,2,46,51,97,130
3404-001,2013,2,8,3,42,27,69,97
3404-001,2013,2,8,4,33,32,65,69
3404-001,2013,2,8,5,33,54,87,65
3404-001,2013,2,8,6,45,72,117,87
3404-001,2013,2,8,7,87,231,318,117
3404-001,2013,2,8,8,226,961,1187,318
3404-001,2013,2,8,9,380,792,1172,1187
3404-001,2013,2,8,10,400,439,839,1172
3404-001,2013,2,8,11,470,437,907,839
3404-001,2013,2,8,12,536,433,969,907
3404-001,2013,2,8,13,482,346,828,969
3404-001,2013,2,8,14,522,381,903,828
3404-001,2013,2,8,15,556,372,928,903
3404-001,2013,2,8,16,681,345,1026,928
3404-001,2013,2,8,17,586,314,900,1026
3404-001,2013,2,8,18,680,325,1005,900
3404-001,2013,2,8,19,481,262,743,1005
3404-001,2013,2,8,20,333,219,552,743
3404-001,2013,2,8,21,236,183,419,552
3404-001,2013,2,8,22,209,161,370,419
3404-001,2013,2,8,23,113,108,221,370
3404-001,2013,2,8,24,75,61,136,221
3404-001,2013,2,9,1,61,53,114,136
3404-001,2013,2,9,2,36,35,71,114
3404-001,2013,2,9,3,47,26,73,71
3404-001,2013,2,9,4,22,20,42,73
3404-001,2013,2,9,5,43,28,71,42
3404-001,2013,2,9,6,46,32,78,71
3404-001,2013,2,9,7,61,47,108,78
3404-001,2013,2,9,8,80,93,173,108
3404-001,2013,2,9,9,149,138,287,173
3404-001,2013,2,9,10,151,165,316,287
3404-001,2013,2,9,11,202,249,451,316
3404-001,2013,2,9,12,200,270,470,451
3404-001,2013,2,9,13,205,211,416,470
3404-001,2013,2,9,14,193,208,401,416
3404-001,2013,2,9,15,158,180,338,401
3404-001,2013,2,9,16,144,187,331,338
3404-001,2013,2,9,17,156,132,288,331
3404-001,2013,2,9,18,172,143,315,288
3404-001,2013,2,9,19,145,105,250,315
3404-001,2013,2,9,20,90,91,181,250
3404-001,2013,2,9,21,82,74,156,181
3404-001,2013,2,9,22,60,57,117,156
3404-001,2013,2,9,23,55,56,111,117
3404-001,2013,2,9,24,30,29,59,111
3404-001,2013,2,10,1,15,14,29,59
3404-001,2013,2,10,2,10,15,25,29
3404-001,2013,2,10,3,12,3,15,25
3404-001,2013,2,10,4,10,3,13,15
3404-001,2013,2,10,5,8,7,15,13
3404-001,2013,2,10,6,12,10,22,15
3404-001,2013,2,10,7,34,48,82,22
3404-001,2013,2,10,8,81,109,190,82
3404-001,2013,2,10,9,89,104,193,190
3404-001,2013,2,10,10,115,113,228,193
3404-001,2013,2,10,11,240,179,419,228
3404-001,2013,2,10,12,324,241,565,419
3404-001,2013,2,10,13,337,242,579,565
3404-001,2013,2,10,14,359,225,584,579
3404-001,2013,2,10,15,553,271,824,584
3404-001,2013,2,10,16,577,260,837,824
3404-001,2013,2,10,17,530,285,815,837
3404-001,2013,2,10,18,368,251,619,815
3404-001,2013,2,10,19,233,152,385,619
3404-001,2013,2,10,20,172,129,301,385
3404-001,2013,2,10,21,122,87,209,301
3404-001,2013,2,10,22,94,85,179,209
3404-001,2013,2,10,23,79,56,135,179
3404-001,2013,2,10,24,56,37,93,135
3404-001,2013,2,11,1,30,30,60,93
3404-001,2013,2,11,2,20,19,39,60
3404-001,2013,2,11,3,11,12,23,39
3404-001,2013,2,11,4,15,8,23,23
3404-001,2013,2,11,5,7,14,21,23
3404-001,2013,2,11,6,5,17,22,21
3404-001,2013,2,11,7,14,31,45,22
3404-001,2013,2,11,8,33,65,98,45
3404-001,2013,2,11,9,54,90,144,98
3404-001,2013,2,11,10,104,92,196,144
3404-001,2013,2,11,11,163,141,304,196
3404-001,2013,2,11,12,235,218,453,304
3404-001,2013,2,11,13,231,236,467,453
3404-001,2013,2,11,14,229,195,424,467
3404-001,2013,2,11,15,291,231,522,424
3404-001,2013,2,11,16,289,203,492,522
3404-001,2013,2,11,17,269,216,485,492
3404-001,2013,2,11,18,281,188,469,485
3404-001,2013,2,11,19,224,139,363,469
3404-001,2013,2,11,20,172,126,298,363
3404-001,2013,2,11,21,128,130,258,298
3404-001,2013,2,11,22,82,102,184,258
3404-001,2013,2,11,23,63,64,127,184
3404-001,2013,2,11,24,31,63,94,127
3404-001,2013,2,12,1,21,60,81,94
3404-001,2013,2,12,2,17,42,59,81
3404-001,2013,2,12,3,14,13,27,59
3404-001,2013,2,12,4,17,19,36,27
3404-001,2013,2,12,5,17,39,56,36
3404-001,2013,2,12,6,25,56,81,56
3404-001,2013,2,12,7,63,178,241,81
3404-001,2013,2,12,8,183,657,840,241
3404-001,2013,2,12,9,262,557,819,840
3404-001,2013,2,12,10,285,323,608,819
3404-001,2013,2,12,11,300,347,647,608
3404-001,2013,2,12,12,309,322,631,647
3404-001,2013,2,12,13,309,293,602,631
3404-001,2013,2,12,14,343,311,654,602
3404-001,2013,2,12,15,359,360,719,654
3404-001,2013,2,12,16,369,327,696,719
3404-001,2013,2,12,17,403,314,717,696
3404-001,2013,2,12,18,490,292,782,717
3404-001,2013,2,12,19,440,271,711,782
3404-001,2013,2,12,20,277,210,487,711
3404-001,2013,2,12,21,212,158,370,487
3404-001,2013,2,12,22,154,161,315,370
3404-001,2013,2,12,23,107,109,216,315
3404-001,2013,2,12,24,59,80,139,216
3404-001,2013,2,13,1,41,57,98,139
3404-001,2013,2,13,2,28,28,56,98
3404-001,2013,2,13,3,21,24,45,56
3404-001,2013,2,13,4,25,34,59,45
3404-001,2013,2,13,5,40,35,75,59
3404-001,2013,2,13,6,42,115,157,75
3404-001,2013,2,13,7,94,300,394,157
3404-001,2013,2,13,8,267,1083,1350,394
3404-001,2013,2,13,9,409,859,1268,1350
3404-001,2013,2,13,10,409,469,878,1268
3404-001,2013,2,13,11,463,490,953,878
3404-001,2013,2,13,12,442,450,892,953
3404-001,2013,2,13,13,384,394,778,892
3404-001,2013,2,13,14,422,479,901,778
3404-001,2013,2,13,15,499,471,970,901
3404-001,2013,2,13,16,530,441,971,970
3404-001,2013,2,13,17,530,392,922,971
3404-001,2013,2,13,18,718,348,1066,922
3404-001,2013,2,13,19,617,301,918,1066
3404-001,2013,2,13,20,414,236,650,918
3404-001,2013,2,13,21,389,174,563,650
3404-001,2013,2,13,22,246,144,390,563
3404-001,2013,2,13,23,158,101,259,390
3404-001,2013,2,13,24,80,75,155,259
3404-001,2013,2,14,1,64,73,137,155
3404-001,2013,2,14,2,48,41,89,137
3404-001,2013,2,14,3,29,39,68,89
3404-001,2013,2,14,4,31,38,69,68
3404-001,2013,2,14,5,44,57,101,69
3404-001,2013,2,14,6,63,97,160,101
3404-001,2013,2,14,7,125,330,455,160
3404-001,2013,2,14,8,269,1089,1358,455
3404-001,2013,2,14,9,470,899,1369,1358
3404-001,2013,2,14,10,474,533,1007,1369
3404-001,2013,2,14,11,530,564,1094,1007
3404-001,2013,2,14,12,523,462,985,1094
3404-001,2013,2,14,13,437,428,865,985
3404-001,2013,2,14,14,452,446,898,865
3404-001,2013,2,14,15,568,537,1105,898
3404-001,2013,2,14,16,542,468,1010,1105
3404-001,2013,2,14,17,569,459,1028,1010
3404-001,2013,2,14,18,679,374,1053,1028
3404-001,2013,2,14,19,623,305,928,1053
3404-001,2013,2,14,20,521,267,788,928
3404-001,2013,2,14,21,456,189,645,788
3404-001,2013,2,14,22,293,145,438,645
3404-001,2013,2,14,23,152,105,257,438
3404-001,2013,2,14,24,106,87,193,257
3404-001,2013,2,15,1,60,62,122,193
3404-001,2013,2,15,2,38,46,84,122
3404-001,2013,2,15,3,34,42,76,84
3404-001,2013,2,15,4,33,32,65,76
3404-001,2013,2,15,5,47,66,113,65
3404-001,2013,2,15,6,69,116,185,113
3404-001,2013,2,15,7,93,316,409,185
3404-001,2013,2,15,8,274,1090,1364,409
3404-001,2013,2,15,9,470,913,1383,1364
3404-001,2013,2,15,10,456,472,928,1383
3404-001,2013,2,15,11,505,543,1048,928
3404-001,2013,2,15,12,494,497,991,1048
3404-001,2013,2,15,13,437,388,825,991
3404-001,2013,2,15,14,445,518,963,825
3404-001,2013,2,15,15,577,496,1073,963
3404-001,2013,2,15,16,596,469,1065,1073
3404-001,2013,2,15,17,602,466,1068,1065
3404-001,2013,2,15,18,788,373,1161,1068
3404-001,2013,2,15,19,803,356,1159,1161
3404-001,2013,2,15,20,592,308,900,1159
3404-001,2013,2,15,21,441,205,646,900
3404-001,2013,2,15,22,298,175,473,646
3404-001,2013,2,15,23,182,100,282,473
3404-001,2013,2,15,24,82,90,172,282
3404-001,2013,2,16,1,57,47,104,172
3404-001,2013,2,16,2,40,55,95,104
3404-001,2013,2,16,3,39,30,69,95
3404-001,2013,2,16,4,31,38,69,69
3404-001,2013,2,16,5,43,46,89,69
3404-001,2013,2,16,6,46,105,151,89
3404-001,2013,2,16,7,104,192,296,151
3404-001,2013,2,16,8,183,549,732,296
3404-001,2013,2,16,9,373,491,864,732
3404-001,2013,2,16,10,390,374,764,864
3404-001,2013,2,16,11,410,429,839,764
3404-001,2013,2,16,12,432,343,775,839
3404-001,2013,2,16,13,384,296,680,775
3404-001,2013,2,16,14,413,332,745,680
3404-001,2013,2,16,15,397,362,759,745
3404-001,2013,2,16,16,431,308,739,759
3404-001,2013,2,16,17,397,303,700,739
3404-001,2013,2,16,18,626,318,944,700
3404-001,2013,2,16,19,377,233,610,944
3404-001,2013,2,16,20,234,176,410,610
3404-001,2013,2,16,21,174,141,315,410
3404-001,2013,2,16,22,155,114,269,315
3404-001,2013,2,16,23,81,69,150,269
3404-001,2013,2,16,24,57,64,121,150
3404-001,2013,2,17,1,38,37,75,121
3404-001,2013,2,17,2,18,23,41,75
3404-001,2013,2,17,3,14,22,36,41
3404-001,2013,2,17,4,13,20,33,36
3404-001,2013,2,17,5,22,19,41,33
3404-001,2013,2,17,6,24,29,53,41
3404-001,2013,2,17,7,48,97,145,53
3404-001,2013,2,17,8,73,177,250,145
3404-001,2013,2,17,9,156,180,336,250
3404-001,2013,2,17,10,173,195,368,336
3404-001,2013,2,17,11,204,204,408,368
3404-001,2013,2,17,12,181,223,404,408
3404-001,2013,2,17,13,211,201,412,404
3404-001,2013,2,17,14,218,227,445,412
3404-001,2013,2,17,15,250,212,462,445
3404-001,2013,2,17,16,311,265,576,462
3404-001,2013,2,17,17,337,228,565,576
3404-001,2013,2,17,18,374,190,564,565
3404-001,2013,2,17,19,222,203,425,564
3404-001,2013,2,17,20,168,156,324,425
3404-001,2013,2,17,21,115,147,262,324
3404-001,2013,2,17,22,121,141,262,262
3404-001,2013,2,17,23,65,111,176,262
3404-001,2013,2,17,24,44,72,116,176
3404-001,2013,2,18,1,40,53,93,116
3404-001,2013,2,18,2,15,36,51,93
3404-001,2013,2,18,3,19,30,49,51
3404-001,2013,2,18,4,22,23,45,49
3404-001,2013,2,18,5,34,44,78,45
3404-001,2013,2,18,6,57,101,158,78
3404-001,2013,2,18,7,128,366,494,158
3404-001,2013,2,18,8,302,1210,1512,494
3404-001,2013,2,18,9,432,987,1419,1512
3404-001,2013,2,18,10,419,471,890,1419
3404-001,2013,2,18,11,487,483,970,890
3404-001,2013,2,18,12,534,485,1019,970
3404-001,2013,2,18,13,434,422,856,1019
3404-001,2013,2,18,14,444,449,893,856
3404-001,2013,2,18,15,532,521,1053,893
3404-001,2013,2,18,16,513,449,962,1053
3404-001,2013,2,18,17,561,459,1020,962
3404-001,2013,2,18,18,657,396,1053,1020
3404-001,2013,2,18,19,626,266,892,1053
3404-001,2013,2,18,20,488,252,740,892
3404-001,2013,2,18,21,433,174,607,740
3404-001,2013,2,18,22,293,162,455,607
3404-001,2013,2,18,23,177,99,276,455
3404-001,2013,2,18,24,90,83,173,276
3404-001,2013,2,19,1,66,51,117,173
3404-001,2013,2,19,2,43,39,82,117
3404-001,2013,2,19,3,27,33,60,82
3404-001,2013,2,19,4,32,45,77,60
3404-001,2013,2,19,5,49,63,112,77
3404-001,2013,2,19,6,66,110,176,112
3404-001,2013,2,19,7,100,321,421,176
3404-001,2013,2,19,8,299,1068,1367,421
3404-001,2013,2,19,9,488,915,1403,1367
3404-001,2013,2,19,10,478,532,1010,1403
3404-001,2013,2,19,11,516,569,1085,1010
3404-001,2013,2,19,12,466,468,934,1085
3404-001,2013,2,19,13,461,394,855,934
3404-001,2013,2,19,14,474,471,945,855
3404-001,2013,2,19,15,544,505,1049,945
3404-001,2013,2,19,16,585,465,1050,1049
3404-001,2013,2,19,17,571,424,995,1050
3404-001,2013,2,19,18,637,377,1014,995
3404-001,2013,2,19,19,651,317,968,1014
3404-001,2013,2,19,20,504,274,778,968
3404-001,2013,2,19,21,477,193,670,778
3404-001,2013,2,19,22,276,139,415,670
3404-001,2013,2,19,23,158,103,261,415
3404-001,2013,2,19,24,93,69,162,261
3404-001,2013,2,20,1,56,40,96,162
3404-001,2013,2,20,2,45,51,96,96
3404-001,2013,2,20,3,34,41,75,96
3404-001,2013,2,20,4,31,48,79,75
3404-001,2013,2,20,5,38,51,89,79
3404-001,2013,2,20,6,54,86,140,89
3404-001,2013,2,20,7,99,286,385,140
3404-001,2013,2,20,8,270,1073,1343,385
3404-001,2013,2,20,9,486,888,1374,1343
3404-001,2013,2,20,10,470,517,987,1374
3404-001,2013,2,20,11,492,525,1017,987
3404-001,2013,2,20,12,488,491,979,1017
3404-001,2013,2,20,13,452,416,868,979
3404-001,2013,2,20,14,472,466,938,868
3404-001,2013,2,20,15,565,530,1095,938
3404-001,2013,2,20,16,548,460,1008,1095
3404-001,2013,2,20,17,610,471,1081,1008
3404-001,2013,2,20,18,707,368,1075,1081
3404-001,2013,2,20,19,738,331,1069,1075
3404-001,2013,2,20,20,485,281,766,1069
3404-001,2013,2,20,21,392,191,583,766
3404-001,2013,2,20,22,273,166,439,583
3404-001,2013,2,20,23,159,104,263,439
3404-001,2013,2,20,24,87,78,165,263
3404-001,2013,2,21,1,63,55,118,165
3404-001,2013,2,21,2,42,53,95,118
3404-001,2013,2,21,3,44,23,67,95
3404-001,2013,2,21,4,32,36,68,67
3404-001,2013,2,21,5,40,54,94,68
3404-001,2013,2,21,6,66,84,150,94
3404-001,2013,2,21,7,107,332,439,150
3404-001,2013,2,21,8,276,1044,1320,439
3404-001,2013,2,21,9,490,950,1440,1320
3404-001,2013,2,21,10,470,515,985,1440
3404-001,2013,2,21,11,518,549,1067,985
3404-001,2013,2,21,12,521,459,980,1067
3404-001,2013,2,21,13,417,441,858,980
3404-001,2013,2,21,14,515,443,958,858
3404-001,2013,2,21,15,539,532,1071,958
3404-001,2013,2,21,16,552,503,1055,1071
3404-001,2013,2,21,17,537,436,973,1055
3404-001,2013,2,21,18,694,396,1090,973
3404-001,2013,2,21,19,738,345,1083,1090
3404-001,2013,2,21,20,512,278,790,1083
3404-001,2013,2,21,21,465,191,656,790
3404-001,2013,2,21,22,285,154,439,656
3404-001,2013,2,21,23,189,126,315,439
3404-001,2013,2,21,24,113,74,187,315
3404-001,2013,2,22,1,75,64,139,187
3404-001,2013,2,22,2,37,45,82,139
3404-001,2013,2,22,3,30,35,65,82
3404-001,2013,2,22,4,39,30,69,65
3404-001,2013,2,22,5,52,60,112,69
3404-001,2013,2,22,6,74,101,175,112
3404-001,2013,2,22,7,75,290,365,175
3404-001,2013,2,22,8,288,860,1148,365
3404-001,2013,2,22,9,479,914,1393,1148
3404-001,2013,2,22,10,491,502,993,1393
3404-001,2013,2,22,11,461,521,982,993
3404-001,2013,2,22,12,454,435,889,982
3404-001,2013,2,22,13,417,402,819,889
3404-001,2013,2,22,14,519,452,971,819
3404-001,2013,2,22,15,549,494,1043,971
3404-001,2013,2,22,16,547,465,1012,1043
3404-001,2013,2,22,17,585,429,1014,1012
3404-001,2013,2,22,18,710,379,1089,1014
3404-001,2013,2,22,19,778,379,1157,1089
3404-001,2013,2,22,20,559,293,852,1157
3404-001,2013,2,22,21,451,202,653,852
3404-001,2013,2,22,22,302,127,429,653
3404-001,2013,2,22,23,161,130,291,429
3404-001,2013,2,22,24,88,79,167,291
3404-001,2013,2,23,1,65,67,132,167
3404-001,2013,2,23,2,46,55,101,132
3404-001,2013,2,23,3,41,30,71,101
3404-001,2013,2,23,4,32,40,72,71
3404-001,2013,2,23,5,56,54,110,72
3404-001,2013,2,23,6,52,103,155,110
3404-001,2013,2,23,7,92,192,284,155
3404-001,2013,2,23,8,196,543,739,284
3404-001,2013,2,23,9,340,482,822,739
3404-001,2013,2,23,10,381,401,782,822
3404-001,2013,2,23,11,384,396,780,782
3404-001,2013,2,23,12,448,362,810,780
3404-001,2013,2,23,13,396,330,726,810
3404-001,2013,2,23,14,417,343,760,726
3404-001,2013,2,23,15,419,345,764,760
3404-001,2013,2,23,16,421,346,767,764
3404-001,2013,2,23,17,442,307,749,767
3404-001,2013,2,23,18,552,346,898,749
3404-001,2013,2,23,19,409,281,690,898
3404-001,2013,2,23,20,252,205,457,690
3404-001,2013,2,23,21,195,147,342,457
3404-001,2013,2,23,22,130,125,255,342
3404-001,2013,2,23,23,93,90,183,255
3404-001,2013,2,23,24,54,65,119,183
3404-001,2013,2,24,1,48,38,86,119
3404-001,2013,2,24,2,38,26,64,86
3404-001,2013,2,24,3,28,9,37,64
3404-001,2013,2,24,4,23,13,36,37
3404-001,2013,2,24,5,20,14,34,36
3404-001,2013,2,24,6,27,39,66,34
3404-001,2013,2,24,7,41,73,114,66
3404-001,2013,2,24,8,99,160,259,114
3404-001,2013,2,24,9,150,196,346,259
3404-001,2013,2,24,10,178,176,354,346
3404-001,2013,2,24,11,234,233,467,354
3404-001,2013,2,24,12,222,225,447,467
3404-001,2013,2,24,13,227,249,476,447
3404-001,2013,2,24,14,220,246,466,476
3404-001,2013,2,24,15,280,263,543,466
3404-001,2013,2,24,16,330,251,581,543
3404-001,2013,2,24,17,330,251,581,581
3404-001,2013,2,24,18,351,227,578,581
3404-001,2013,2,24,19,238,214,452,578
3404-001,2013,2,24,20,189,169,358,452
3404-001,2013,2,24,21,142,125,267,358
3404-001,2013,2,24,22,115,141,256,267
3404-001,2013,2,24,23,76,99,175,256
3404-001,2013,2,24,24,43,84,127,175
3404-001,2013,2,25,1,45,57,102,127
3404-001,2013,2,25,2,22,38,60,102
3404-001,2013,2,25,3,22,29,51,60
3404-001,2013,2,25,4,15,29,44,51
3404-001,2013,2,25,5,30,42,72,44
3404-001,2013,2,25,6,56,125,181,72
3404-001,2013,2,25,7,117,382,499,181
3404-001,2013,2,25,8,303,1245,1548,499
3404-001,2013,2,25,9,435,944,1379,1548
3404-001,2013,2,25,10,458,461,919,1379
3404-001,2013,2,25,11,506,557,1063,919
3404-001,2013,2,25,12,458,442,900,1063
3404-001,2013,2,25,13,435,445,880,900
3404-001,2013,2,25,14,458,502,960,880
3404-001,2013,2,25,15,580,526,1106,960
3404-001,2013,2,25,16,579,498,1077,1106
3404-001,2013,2,25,17,593,473,1066,1077
3404-001,2013,2,25,18,717,416,1133,1066
3404-001,2013,2,25,19,693,335,1028,1133
3404-001,2013,2,25,20,488,242,730,1028
3404-001,2013,2,25,21,490,212,702,730
3404-001,2013,2,25,22,311,161,472,702
3404-001,2013,2,25,23,176,99,275,472
3404-001,2013,2,25,24,94,85,179,275
3404-001,2013,2,26,1,60,68,128,179
3404-001,2013,2,26,2,36,60,96,128
3404-001,2013,2,26,3,38,35,73,96
3404-001,2013,2,26,4,26,38,64,73
3404-001,2013,2,26,5,50,61,111,64
3404-001,2013,2,26,6,64,101,165,111
3404-001,2013,2,26,7,102,327,429,165
3404-001,2013,2,26,8,305,1083,1388,429
3404-001,2013,2,26,9,491,921,1412,1388
3404-001,2013,2,26,10,488,543,1031,1412
3404-001,2013,2,26,11,521,558,1079,1031
3404-001,2013,2,26,12,539,505,1044,1079
3404-001,2013,2,26,13,439,417,856,1044
3404-001,2013,2,26,14,449,477,926,856
3404-001,2013,2,26,15,575,481,1056,926
3404-001,2013,2,26,16,544,491,1035,1056
3404-001,2013,2,26,17,588,417,1005,1035
3404-001,2013,2,26,18,709,401,1110,1005
3404-001,2013,2,26,19,663,331,994,1110
3404-001,2013,2,26,20,516,233,749,994
3404-001,2013,2,26,21,466,223,689,749
3404-001,2013,2,26,22,321,169,490,689
3404-001,2013,2,26,23,181,91,272,490
3404-001,2013,2,26,24,92,85,177,272
3404-001,2013,2,27,1,62,59,121,177
3404-001,2013,2,27,2,39,46,85,121
3404-001,2013,2,27,3,30,30,60,85
3404-001,2013,2,27,4,27,32,59,60
3404-001,2013,2,27,5,51,61,112,59
3404-001,2013,2,27,6,66,104,170,112
3404-001,2013,2,27,7,64,328,392,170
3404-001,2013,2,27,8,326,1083,1409,392
3404-001,2013,2,27,9,523,889,1412,1409
3404-001,2013,2,27,10,508,557,1065,1412
3404-001,2013,2,27,11,503,609,1112,1065
3404-001,2013,2,27,12,511,514,1025,1112
3404-001,2013,2,27,13,432,408,840,1025
3404-001,2013,2,27,14,474,517,991,840
3404-001,2013,2,27,15,565,510,1075,991
3404-001,2013,2,27,16,544,507,1051,1075
3404-001,2013,2,27,17,606,418,1024,1051
3404-001,2013,2,27,18,775,406,1181,1024
3404-001,2013,2,27,19,708,383,1091,1181
3404-001,2013,2,27,20,510,284,794,1091
3404-001,2013,2,27,21,399,236,635,794
3404-001,2013,2,27,22,302,152,454,635
3404-001,2013,2,27,23,215,116,331,454
3404-001,2013,2,27,24,94,88,182,331
3404-001,2013,2,28,1,49,59,108,182
3404-001,2013,2,28,2,35,45,80,108
3404-001,2013,2,28,3,35,43,78,80
3404-001,2013,2,28,4,30,31,61,78
3404-001,2013,2,28,5,45,61,106,61
3404-001,2013,2,28,6,67,110,177,106
3404-001,2013,2,28,7,100,342,442,177
3404-001,2013,2,28,8,297,1084,1381,442
3404-001,2013,2,28,9,489,917,1406,1381
3404-001,2013,2,28,10,500,529,1029,1406
3404-001,2013,2,28,11,541,517,1058,1029
3404-001,2013,2,28,12,556,502,1058,1058
3404-001,2013,2,28,13,477,418,895,1058
3404-001,2013,2,28,14,480,502,982,895
3404-001,2013,2,28,15,577,538,1115,982
3404-001,2013,2,28,16,606,481,1087,1115
3404-001,2013,2,28,17,531,473,1004,1087
3404-001,2013,2,28,18,873,452,1325,1004
3404-001,2013,2,28,19,826,387,1213,1325
3404-001,2013,2,28,20,667,320,987,1213
3404-001,2013,2,28,21,479,212,691,987
3404-001,2013,2,28,22,294,190,484,691
3404-001,2013,2,28,23,184,120,304,484
3404-001,2013,2,28,24,92,82,174,304
3404-001,2013,3,1,1,87,75,162,174
3404-001,2013,3,1,2,53,53,106,162
3404-001,2013,3,1,3,38,42,80,106
3404-001,2013,3,1,4,32,42,74,80
3404-001,2013,3,1,5,41,36,77,74
3404-001,2013,3,1,6,59,106,165,77
3404-001,2013,3,1,7,90,167,257,165
3404-001,2013,3,1,8,209,484,693,257
3404-001,2013,3,1,9,296,486,782,693
3404-001,2013,3,1,10,353,399,752,782
3404-001,2013,3,1,11,358,382,740,752
3404-001,2013,3,1,12,395,376,771,740
3404-001,2013,3,1,13,380,307,687,771
3404-001,2013,3,1,14,454,325,779,687
3404-001,2013,3,1,15,466,321,787,779
3404-001,2013,3,1,16,454,330,784,787
3404-001,2013,3,1,17,565,299,864,784
3404-001,2013,3,1,18,574,285,859,864
3404-001,2013,3,1,19,421,267,688,859
3404-001,2013,3,1,20,263,215,478,688
3404-001,2013,3,1,21,208,142,350,478
3404-001,2013,3,1,22,155,124,279,350
3404-001,2013,3,1,23,88,87,175,279
3404-001,2013,3,1,24,45,62,107,175
3404-001,2013,3,2,1,42,46,88,107
3404-001,2013,3,2,2,23,39,62,88
3404-001,2013,3,2,3,29,28,57,62
3404-001,2013,3,2,4,29,36,65,57
3404-001,2013,3,2,5,44,26,70,65
3404-001,2013,3,2,6,31,84,115,70
3404-001,2013,3,2,7,75,162,237,115
3404-001,2013,3,2,8,182,379,561,237
3404-001,2013,3,2,9,280,350,630,561
3404-001,2013,3,2,10,308,288,596,630
3404-001,2013,3,2,11,334,380,714,596
3404-001,2013,3,2,12,340,322,662,714
3404-001,2013,3,2,13,328,299,627,662
3404-001,2013,3,2,14,370,330,700,627
3404-001,2013,3,2,15,407,334,741,700
3404-001,2013,3,2,16,436,340,776,741
3404-001,2013,3,2,17,430,283,713,776
3404-001,2013,3,2,18,537,310,847,713
3404-001,2013,3,2,19,388,253,641,847
3404-001,2013,3,2,20,257,185,442,641
3404-001,2013,3,2,21,166,142,308,442
3404-001,2013,3,2,22,114,121,235,308
3404-001,2013,3,2,23,83,103,186,235
3404-001,2013,3,2,24,40,48,88,186
3404-001,2013,3,3,1,41,42,83,88
3404-001,2013,3,3,2,16,25,41,83
3404-001,2013,3,3,3,22,20,42,41
3404-001,2013,3,3,4,19,14,33,42
3404-001,2013,3,3,5,21,19,40,33
3404-001,2013,3,3,6,25,28,53,40
3404-001,2013,3,3,7,57,85,142,53
3404-001,2013,3,3,8,81,174,255,142
3404-001,2013,3,3,9,147,239,386,255
3404-001,2013,3,3,10,154,173,327,386
3404-001,2013,3,3,11,214,256,470,327
3404-001,2013,3,3,12,213,244,457,470
3404-001,2013,3,3,13,239,255,494,457
3404-001,2013,3,3,14,278,293,571,494
3404-001,2013,3,3,15,330,282,612,571
3404-001,2013,3,3,16,381,262,643,612
3404-001,2013,3,3,17,376,265,641,643
3404-001,2013,3,3,18,382,234,616,641
3404-001,2013,3,3,19,261,241,502,616
3404-001,2013,3,3,20,205,191,396,502
3404-001,2013,3,3,21,135,126,261,396
3404-001,2013,3,3,22,89,142,231,261
3404-001,2013,3,3,23,68,119,187,231
3404-001,2013,3,3,24,33,81,114,187
3404-001,2013,3,4,1,31,45,76,114
3404-001,2013,3,4,2,16,28,44,76
3404-001,2013,3,4,3,8,35,43,44
3404-001,2013,3,4,4,21,39,60,43
3404-001,2013,3,4,5,28,45,73,60
3404-001,2013,3,4,6,61,120,181,73
3404-001,2013,3,4,7,126,396,522,181
3404-001,2013,3,4,8,320,1197,1517,522
3404-001,2013,3,4,9,426,972,1398,1517
3404-001,2013,3,4,10,452,522,974,1398
3404-001,2013,3,4,11,485,482,967,974
3404-001,2013,3,4,12,539,473,1012,967
3404-001,2013,3,4,13,406,422,828,1012
3404-001,2013,3,4,14,451,458,909,828
3404-001,2013,3,4,15,566,538,1104,909
3404-001,2013,3,4,16,582,491,1073,1104
3404-001,2013,3,4,17,570,488,1058,1073
3404-001,2013,3,4,18,712,380,1092,1058
3404-001,2013,3,4,19,616,343,959,1092
3404-001,2013,3,4,20,518,298,816,959
3404-001,2013,3,4,21,469,193,662,816
3404-001,2013,3,4,22,302,136,438,662
3404-001,2013,3,4,23,181,98,279,438
3404-001,2013,3,4,24,102,82,184,279
3404-001,2013,3,5,1,50,60,110,184
3404-001,2013,3,5,2,60,50,110,110
3404-001,2013,3,5,3,18,46,64,110
3404-001,2013,3,5,4,40,38,78,64
3404-001,2013,3,5,5,43,61,104,78
3404-001,2013,3,5,6,64,99,163,104
3404-001,2013,3,5,7,102,318,420,163
3404-001,2013,3,5,8,336,1111,1447,420
3404-001,2013,3,5,9,505,931,1436,1447
3404-001,2013,3,5,10,478,534,1012,1436
3404-001,2013,3,5,11,496,539,1035,1012
3404-001,2013,3,5,12,533,474,1007,1035
3404-001,2013,3,5,13,426,455,881,1007
3404-001,2013,3,5,14,501,466,967,881
3404-001,2013,3,5,15,550,534,1084,967
3404-001,2013,3,5,16,571,491,1062,1084
3404-001,2013,3,5,17,579,461,1040,1062
3404-001,2013,3,5,18,733,401,1134,1040
3404-001,2013,3,5,19,667,349,1016,1134
3404-001,2013,3,5,20,515,273,788,1016
3404-001,2013,3,5,21,469,173,642,788
3404-001,2013,3,5,22,341,165,506,642
3404-001,2013,3,5,23,178,95,273,506
3404-001,2013,3,5,24,93,75,168,273
3404-001,2013,3,6,1,61,62,123,168
3404-001,2013,3,6,2,44,35,79,123
3404-001,2013,3,6,3,24,25,49,79
3404-001,2013,3,6,4,21,38,59,49
3404-001,2013,3,6,5,40,59,99,59
3404-001,2013,3,6,6,61,90,151,99
3404-001,2013,3,6,7,89,367,456,151
3404-001,2013,3,6,8,324,1130,1454,456
3404-001,2013,3,6,9,508,976,1484,1454
3404-001,2013,3,6,10,484,546,1030,1484
3404-001,2013,3,6,11,472,538,1010,1030
3404-001,2013,3,6,12,482,462,944,1010
3404-001,2013,3,6,13,444,340,784,944
3404-001,2013,3,6,14,451,468,919,784
3404-001,2013,3,6,15,576,498,1074,919
3404-001,2013,3,6,16,555,485,1040,1074
3404-001,2013,3,6,17,583,462,1045,1040
3404-001,2013,3,6,18,846,410,1256,1045
3404-001,2013,3,6,19,747,339,1086,1256
3404-001,2013,3,6,20,498,318,816,1086
3404-001,2013,3,6,21,444,201,645,816
3404-001,2013,3,6,22,282,152,434,645
3404-001,2013,3,6,23,211,115,326,434
3404-001,2013,3,6,24,109,76,185,326
3404-001,2013,3,7,1,63,60,123,185
3404-001,2013,3,7,2,48,52,100,123
3404-001,2013,3,7,3,32,39,71,100
3404-001,2013,3,7,4,38,34,72,71
3404-001,2013,3,7,5,44,50,94,72
3404-001,2013,3,7,6,64,88,152,94
3404-001,2013,3,7,7,103,351,454,152
3404-001,2013,3,7,8,328,1008,1336,454
3404-001,2013,3,7,9,484,933,1417,1336
3404-001,2013,3,7,10,460,539,999,1417
3404-001,2013,3,7,11,559,516,1075,999
3404-001,2013,3,7,12,466,490,956,1075
3404-001,2013,3,7,13,449,434,883,956
3404-001,2013,3,7,14,482,501,983,883
3404-001,2013,3,7,15,565,510,1075,983
3404-001,2013,3,7,16,590,507,1097,1075
3404-001,2013,3,7,17,564,423,987,1097
3404-001,2013,3,7,18,690,398,1088,987
3404-001,2013,3,7,19,708,362,1070,1088
3404-001,2013,3,7,20,546,289,835,1070
3404-001,2013,3,7,21,485,165,650,835
3404-001,2013,3,7,22,290,154,444,650
3404-001,2013,3,7,23,173,117,290,444
3404-001,2013,3,7,24,86,88,174,290
3404-001,2013,3,8,1,66,51,117,174
3404-001,2013,3,8,2,55,44,99,117
3404-001,2013,3,8,3,27,30,57,99
3404-001,2013,3,8,4,35,35,70,57
3404-001,2013,3,8,5,38,55,93,70
3404-001,2013,3,8,6,66,103,169,93
3404-001,2013,3,8,7,103,371,474,169
3404-001,2013,3,8,8,353,1149,1502,474
3404-001,2013,3,8,9,530,975,1505,1502
3404-001,2013,3,8,10,489,564,1053,1505
3404-001,2013,3,8,11,544,530,1074,1053
3404-001,2013,3,8,12,517,506,1023,1074
3404-001,2013,3,8,13,474,439,913,1023
3404-001,2013,3,8,14,467,529,996,913
3404-001,2013,3,8,15,606,545,1151,996
3404-001,2013,3,8,16,597,527,1124,1151
3404-001,2013,3,8,17,583,430,1013,1124
3404-001,2013,3,8,18,897,425,1322,1013
3404-001,2013,3,8,19,826,385,1211,1322
3404-001,2013,3,8,20,626,322,948,1211
3404-001,2013,3,8,21,496,217,713,948
3404-001,2013,3,8,22,299,169,468,713
3404-001,2013,3,8,23,155,124,279,468
3404-001,2013,3,8,24,115,101,216,279
3404-001,2013,3,9,1,72,47,119,216
3404-001,2013,3,9,2,51,48,99,119
3404-001,2013,3,9,3,41,37,78,99
3404-001,2013,3,9,4,32,38,70,78
3404-001,2013,3,9,5,34,46,80,70
3404-001,2013,3,9,6,47,119,166,80
3404-001,2013,3,9,7,113,228,341,166
3404-001,2013,3,9,8,231,556,787,341
3404-001,2013,3,9,9,350,544,894,787
3404-001,2013,3,9,10,406,421,827,894
3404-001,2013,3,9,11,403,389,792,827
3404-001,2013,3,9,12,418,373,791,792
3404-001,2013,3,9,13,410,359,769,791
3404-001,2013,3,9,14,445,381,826,769
3404-001,2013,3,9,15,475,389,864,826
3404-001,2013,3,9,16,456,361,817,864
3404-001,2013,3,9,17,493,314,807,817
3404-001,2013,3,9,18,677,316,993,807
3404-001,2013,3,9,19,499,297,796,993
3404-001,2013,3,9,20,274,235,509,796
3404-001,2013,3,9,21,212,171,383,509
3404-001,2013,3,9,22,141,131,272,383
3404-001,2013,3,9,23,126,87,213,272
3404-001,2013,3,9,24,57,51,108,213
3404-001,2013,3,10,1,57,43,100,108
3404-001,2013,3,10,2,39,34,73,100
3404-001,2013,3,10,3,20,16,36,73
3404-001,2013,3,10,4,16,11,27,36
3404-001,2013,3,10,5,24,16,40,27
3404-001,2013,3,10,6,31,49,80,40
3404-001,2013,3,10,7,45,90,135,80
3404-001,2013,3,10,8,112,175,287,135
3404-001,2013,3,10,9,209,225,434,287
3404-001,2013,3,10,10,185,193,378,434
3404-001,2013,3,10,11,242,247,489,378
3404-001,2013,3,10,12,262,238,500,489
3404-001,2013,3,10,13,246,249,495,500
3404-001,2013,3,10,14,220,276,496,495
3404-001,2013,3,10,15,316,293,609,496
3404-001,2013,3,10,16,342,300,642,609
3404-001,2013,3,10,17,355,251,606,642
3404-001,2013,3,10,18,399,231,630,606
3404-001,2013,3,10,19,306,243,549,630
3404-001,2013,3,10,20,228,182,410,549
3404-001,2013,3,10,21,174,148,322,410
3404-001,2013,3,10,22,120,152,272,322
3404-001,2013,3,10,23,77,109,186,272
3404-001,2013,3,10,24,42,90,132,186
3404-001,2013,3,11,1,37,34,71,132
3404-001,2013,3,11,2,16,46,62,71
3404-001,2013,3,11,3,20,26,46,62
3404-001,2013,3,11,4,12,30,42,46
3404-001,2013,3,11,5,43,43,86,42
3404-001,2013,3,11,6,52,125,177,86
3404-001,2013,3,11,7,104,433,537,177
3404-001,2013,3,11,8,334,1303,1637,537
3404-001,2013,3,11,9,452,964,1416,1637
3404-001,2013,3,11,10,460,491,951,1416
3404-001,2013,3,11,11,509,507,1016,951
3404-001,2013,3,11,12,490,500,990,1016
3404-001,2013,3,11,13,404,444,848,990
3404-001,2013,3,11,14,437,496,933,848
3404-001,2013,3,11,15,557,552,1109,933
3404-001,2013,3,11,16,584,501,1085,1109
3404-001,2013,3,11,17,624,445,1069,1085
3404-001,2013,3,11,18,692,398,1090,1069
3404-001,2013,3,11,19,741,333,1074,1090
3404-001,2013,3,11,20,551,306,857,1074
3404-001,2013,3,11,21,477,190,667,857
3404-001,2013,3,11,22,324,149,473,667
3404-001,2013,3,11,23,150,111,261,473
3404-001,2013,3,11,24,89,77,166,261
3404-001,2013,3,12,1,58,63,121,166
3404-001,2013,3,12,2,32,33,65,121
3404-001,2013,3,12,3,33,47,80,65
3404-001,2013,3,12,4,35,44,79,80
3404-001,2013,3,12,5,37,58,95,79
3404-001,2013,3,12,6,75,124,199,95
3404-001,2013,3,12,7,87,366,453,199
3404-001,2013,3,12,8,340,1146,1486,453
3404-001,2013,3,12,9,522,940,1462,1486
3404-001,2013,3,12,10,523,583,1106,1462
3404-001,2013,3,12,11,511,528,1039,1106
3404-001,2013,3,12,12,524,501,1025,1039
3404-001,2013,3,12,13,435,409,844,1025
3404-001,2013,3,12,14,501,519,1020,844
3404-001,2013,3,12,15,628,555,1183,1020
3404-001,2013,3,12,16,658,474,1132,1183
3404-001,2013,3,12,17,610,441,1051,1132
3404-001,2013,3,12,18,707,414,1121,1051
3404-001,2013,3,12,19,752,303,1055,1121
3404-001,2013,3,12,20,521,279,800,1055
3404-001,2013,3,12,21,449,183,632,800
3404-001,2013,3,12,22,275,162,437,632
3404-001,2013,3,12,23,156,88,244,437
3404-001,2013,3,12,24,79,89,168,244
3404-001,2013,3,13,1,50,52,102,168
3404-001,2013,3,13,2,43,35,78,102
3404-001,2013,3,13,3,22,32,54,78
3404-001,2013,3,13,4,30,41,71,54
3404-001,2013,3,13,5,38,50,88,71
3404-001,2013,3,13,6,52,97,149,88
3404-001,2013,3,13,7,98,290,388,149
3404-001,2013,3,13,8,292,1016,1308,388
3404-001,2013,3,13,9,520,960,1480,1308
3404-001,2013,3,13,10,479,568,1047,1480
3404-001,2013,3,13,11,494,531,1025,1047
3404-001,2013,3,13,12,532,481,1013,1025
3404-001,2013,3,13,13,454,443,897,1013
3404-001,2013,3,13,14,467,484,951,897
3404-001,2013,3,13,15,539,520,1059,951
3404-001,2013,3,13,16,581,508,1089,1059
3404-001,2013,3,13,17,583,447,1030,1089
3404-001,2013,3,13,18,748,375,1123,1030
3404-001,2013,3,13,19,698,336,1034,1123
3404-001,2013,3,13,20,511,294,805,1034
3404-001,2013,3,13,21,431,203,634,805
3404-001,2013,3,13,22,275,175,450,634
3404-001,2013,3,13,23,186,121,307,450
3404-001,2013,3,13,24,99,74,173,307
3404-001,2013,3,14,1,62,54,116,173
3404-001,2013,3,14,2,43,54,97,116
3404-001,2013,3,14,3,32,32,64,97
3404-001,2013,3,14,4,30,44,74,64
3404-001,2013,3,14,5,38,52,90,74
3404-001,2013,3,14,6,65,109,174,90
3404-001,2013,3,14,7,110,332,442,174
3404-001,2013,3,14,8,339,1105,1444,442
3404-001,2013,3,14,9,501,921,1422,1444
3404-001,2013,3,14,10,509,559,1068,1422
3404-001,2013,3,14,11,538,551,1089,1068
3404-001,2013,3,14,12,506,512,1018,1089
3404-001,2013,3,14,13,449,416,865,1018
3404-001,2013,3,14,14,490,520,1010,865
3404-001,2013,3,14,15,569,545,1114,1010
3404-001,2013,3,14,16,624,480,1104,1114
3404-001,2013,3,14,17,566,462,1028,1104
3404-001,2013,3,14,18,772,428,1200,1028
3404-001,2013,3,14,19,773,378,1151,1200
3404-001,2013,3,14,20,591,318,909,1151
3404-001,2013,3,14,21,434,197,631,909
3404-001,2013,3,14,22,337,164,501,631
3404-001,2013,3,14,23,165,112,277,501
3404-001,2013,3,14,24,128,82,210,277
3404-001,2013,3,15,1,72,75,147,210
3404-001,2013,3,15,2,35,40,75,147
3404-001,2013,3,15,3,47,42,89,75
3404-001,2013,3,15,4,32,28,60,89
3404-001,2013,3,15,5,36,65,101,60
3404-001,2013,3,15,6,60,134,194,101
3404-001,2013,3,15,7,121,386,507,194
3404-001,2013,3,15,8,319,1199,1518,507
3404-001,2013,3,15,9,503,966,1469,1518
3404-001,2013,3,15,10,505,541,1046,1469
3404-001,2013,3,15,11,554,526,1080,1046
3404-001,2013,3,15,12,591,537,1128,1080
3404-001,2013,3,15,13,488,459,947,1128
3404-001,2013,3,15,14,523,522,1045,947
3404-001,2013,3,15,15,640,542,1182,1045
3404-001,2013,3,15,16,657,524,1181,1182
3404-001,2013,3,15,17,669,457,1126,1181
3404-001,2013,3,15,18,852,468,1320,1126
3404-001,2013,3,15,19,910,466,1376,1320
3404-001,2013,3,15,20,629,328,957,1376
3404-001,2013,3,15,21,468,197,665,957
3404-001,2013,3,15,22,305,157,462,665
3404-001,2013,3,15,23,144,126,270,462
3404-001,2013,3,15,24,109,78,187,270
3404-001,2013,3,16,1,71,61,132,187
3404-001,2013,3,16,2,42,51,93,132
3404-001,2013,3,16,3,30,36,66,93
3404-001,2013,3,16,4,39,45,84,66
3404-001,2013,3,16,5,40,42,82,84
3404-001,2013,3,16,6,63,105,168,82
3404-001,2013,3,16,7,127,209,336,168
3404-001,2013,3,16,8,239,584,823,336
3404-001,2013,3,16,9,444,587,1031,823
3404-001,2013,3,16,10,426,468,894,1031
3404-001,2013,3,16,11,449,421,870,894
3404-001,2013,3,16,12,444,441,885,870
3404-001,2013,3,16,13,384,362,746,885
3404-001,2013,3,16,14,418,371,789,746
3404-001,2013,3,16,15,452,381,833,789
3404-001,2013,3,16,16,448,357,805,833
3404-001,2013,3,16,17,558,352,910,805
3404-001,2013,3,16,18,600,338,938,910
3404-001,2013,3,16,19,473,320,793,938
3404-001,2013,3,16,20,331,222,553,793
3404-001,2013,3,16,21,196,153,349,553
3404-001,2013,3,16,22,147,127,274,349
3404-001,2013,3,16,23,116,86,202,274
3404-001,2013,3,16,24,65,54,119,202
3404-001,2013,3,17,1,48,48,96,119
3404-001,2013,3,17,2,36,24,60,96
3404-001,2013,3,17,3,24,29,53,60
3404-001,2013,3,17,4,24,21,45,53
3404-001,2013,3,17,5,21,24,45,45
3404-001,2013,3,17,6,33,44,77,45
3404-001,2013,3,17,7,38,116,154,77
3404-001,2013,3,17,8,110,200,310,154
3404-001,2013,3,17,9,174,253,427,310
3404-001,2013,3,17,10,188,203,391,427
3404-001,2013,3,17,11,221,260,481,391
3404-001,2013,3,17,12,224,262,486,481
3404-001,2013,3,17,13,232,256,488,486
3404-001,2013,3,17,14,270,282,552,488
3404-001,2013,3,17,15,294,316,610,552
3404-001,2013,3,17,16,392,281,673,610
3404-001,2013,3,17,17,425,273,698,673
3404-001,2013,3,17,18,462,250,712,698
3404-001,2013,3,17,19,327,249,576,712
3404-001,2013,3,17,20,218,190,408,576
3404-001,2013,3,17,21,139,150,289,408
3404-001,2013,3,17,22,106,130,236,289
3404-001,2013,3,17,23,65,103,168,236
3404-001,2013,3,17,24,46,83,129,168
3404-001,2013,3,18,1,38,62,100,129
3404-001,2013,3,18,2,23,32,55,100
3404-001,2013,3,18,3,20,21,41,55
3404-001,2013,3,18,4,14,27,41,41
3404-001,2013,3,18,5,27,52,79,41
3404-001,2013,3,18,6,46,102,148,79
3404-001,2013,3,18,7,125,380,505,148
3404-001,2013,3,18,8,338,1227,1565,505
3404-001,2013,3,18,9,438,1001,1439,1565
3404-001,2013,3,18,10,493,544,1037,1439
3404-001,2013,3,18,11,507,565,1072,1037
3404-001,2013,3,18,12,541,499,1040,1072
3404-001,2013,3,18,13,442,438,880,1040
3404-001,2013,3,18,14,470,498,968,880
3404-001,2013,3,18,15,586,564,1150,968
3404-001,2013,3,18,16,548,492,1040,1150
3404-001,2013,3,18,17,596,456,1052,1040
3404-001,2013,3,18,18,729,432,1161,1052
3404-001,2013,3,18,19,745,374,1119,1161
3404-001,2013,3,18,20,557,312,869,1119
3404-001,2013,3,18,21,505,199,704,869
3404-001,2013,3,18,22,341,135,476,704
3404-001,2013,3,18,23,171,102,273,476
3404-001,2013,3,18,24,122,93,215,273
3404-001,2013,3,19,1,55,69,124,215
3404-001,2013,3,19,2,37,40,77,124
3404-001,2013,3,19,3,29,32,61,77
3404-001,2013,3,19,4,29,37,66,61
3404-001,2013,3,19,5,38,68,106,66
3404-001,2013,3,19,6,74,113,187,106
3404-001,2013,3,19,7,115,365,480,187
3404-001,2013,3,19,8,334,1146,1480,480
3404-001,2013,3,19,9,514,991,1505,1480
3404-001,2013,3,19,10,501,586,1087,1505
3404-001,2013,3,19,11,545,581,1126,1087
3404-001,2013,3,19,12,512,477,989,1126
3404-001,2013,3,19,13,429,416,845,989
3404-001,2013,3,19,14,506,542,1048,845
3404-001,2013,3,19,15,608,545,1153,1048
3404-001,2013,3,19,16,607,536,1143,1153
3404-001,2013,3,19,17,602,460,1062,1143
3404-001,2013,3,19,18,703,381,1084,1062
3404-001,2013,3,19,19,733,386,1119,1084
3404-001,2013,3,19,20,576,312,888,1119
3404-001,2013,3,19,21,502,221,723,888
3404-001,2013,3,19,22,327,159,486,723
3404-001,2013,3,19,23,186,129,315,486
3404-001,2013,3,19,24,110,86,196,315
3404-001,2013,3,20,1,75,62,137,196
3404-001,2013,3,20,2,42,41,83,137
3404-001,2013,3,20,3,31,31,62,83
3404-001,2013,3,20,4,28,42,70,62
3404-001,2013,3,20,5,51,52,103,70
3404-001,2013,3,20,6,75,101,176,103
3404-001,2013,3,20,7,112,341,453,176
3404-001,2013,3,20,8,331,1037,1368,453
3404-001,2013,3,20,9,476,1032,1508,1368
3404-001,2013,3,20,10,482,563,1045,1508
3404-001,2013,3,20,11,523,562,1085,1045
3404-001,2013,3,20,12,538,477,1015,1085
3404-001,2013,3,20,13,455,409,864,1015
3404-001,2013,3,20,14,493,537,1030,864
3404-001,2013,3,20,15,562,569,1131,1030
3404-001,2013,3,20,16,600,484,1084,1131
3404-001,2013,3,20,17,558,427,985,1084
3404-001,2013,3,20,18,804,433,1237,985
3404-001,2013,3,20,19,732,332,1064,1237
3404-001,2013,3,20,20,502,328,830,1064
3404-001,2013,3,20,21,457,196,653,830
3404-001,2013,3,20,22,285,144,429,653
3404-001,2013,3,20,23,168,104,272,429
3404-001,2013,3,20,24,83,69,152,272
3404-001,2013,3,21,1,69,76,145,152
3404-001,2013,3,21,2,46,46,92,145
3404-001,2013,3,21,3,27,26,53,92
3404-001,2013,3,21,4,27,31,58,53
3404-001,2013,3,21,5,41,56,97,58
3404-001,2013,3,21,6,59,109,168,97
3404-001,2013,3,21,7,103,348,451,168
3404-001,2013,3,21,8,330,1175,1505,451
3404-001,2013,3,21,9,493,972,1465,1505
3404-001,2013,3,21,10,478,515,993,1465
3404-001,2013,3,21,11,504,528,1032,993
3404-001,2013,3,21,12,520,512,1032,1032
3404-001,2013,3,21,13,472,432,904,1032
3404-001,2013,3,21,14,440,481,921,904
3404-001,2013,3,21,15,538,514,1052,921
3404-001,2013,3,21,16,603,433,1036,1052
3404-001,2013,3,21,17,573,457,1030,1036
3404-001,2013,3,21,18,782,392,1174,1030
3404-001,2013,3,21,19,759,325,1084,1174
3404-001,2013,3,21,20,534,287,821,1084
3404-001,2013,3,21,21,510,191,701,821
3404-001,2013,3,21,22,323,197,520,701
3404-001,2013,3,21,23,180,100,280,520
3404-001,2013,3,21,24,96,79,175,280
3404-001,2013,3,22,1,65,61,126,175
3404-001,2013,3,22,2,45,36,81,126
3404-001,2013,3,22,3,46,37,83,81
3404-001,2013,3,22,4,29,37,66,83
3404-001,2013,3,22,5,43,58,101,66
3404-001,2013,3,22,6,81,113,194,101
3404-001,2013,3,22,7,111,421,532,194
3404-001,2013,3,22,8,371,1121,1492,532
3404-001,2013,3,22,9,486,937,1423,1492
3404-001,2013,3,22,10,489,561,1050,1423
3404-001,2013,3,22,11,528,555,1083,1050
3404-001,2013,3,22,12,557,500,1057,1083
3404-001,2013,3,22,13,470,447,917,1057
3404-001,2013,3,22,14,481,513,994,917
3404-001,2013,3,22,15,600,524,1124,994
3404-001,2013,3,22,16,629,520,1149,1124
3404-001,2013,3,22,17,645,435,1080,1149
3404-001,2013,3,22,18,884,433,1317,1080
3404-001,2013,3,22,19,918,415,1333,1317
3404-001,2013,3,22,20,596,331,927,1333
3404-001,2013,3,22,21,475,222,697,927
3404-001,2013,3,22,22,302,147,449,697
3404-001,2013,3,22,23,174,115,289,449
3404-001,2013,3,22,24,99,92,191,289
3404-001,2013,3,23,1,64,70,134,191
3404-001,2013,3,23,2,43,33,76,134
3404-001,2013,3,23,3,34,38,72,76
3404-001,2013,3,23,4,28,28,56,72
3404-001,2013,3,23,5,46,44,90,56
3404-001,2013,3,23,6,66,107,173,90
3404-001,2013,3,23,7,117,250,367,173
3404-001,2013,3,23,8,231,605,836,367
3404-001,2013,3,23,9,421,549,970,836
3404-001,2013,3,23,10,441,463,904,970
3404-001,2013,3,23,11,432,519,951,904
3404-001,2013,3,23,12,424,425,849,951
3404-001,2013,3,23,13,412,341,753,849
3404-001,2013,3,23,14,436,402,838,753
3404-001,2013,3,23,15,456,380,836,838
3404-001,2013,3,23,16,486,382,868,836
3404-001,2013,3,23,17,539,367,906,868
3404-001,2013,3,23,18,640,339,979,906
3404-001,2013,3,23,19,454,310,764,979
3404-001,2013,3,23,20,311,227,538,764
3404-001,2013,3,23,21,256,159,415,538
3404-001,2013,3,23,22,160,131,291,415
3404-001,2013,3,23,23,122,86,208,291
3404-001,2013,3,23,24,61,59,120,208
3404-001,2013,3,24,1,36,33,69,120
3404-001,2013,3,24,2,35,27,62,69
3404-001,2013,3,24,3,18,22,40,62
3404-001,2013,3,24,4,20,19,39,40
3404-001,2013,3,24,5,22,27,49,39
3404-001,2013,3,24,6,21,41,62,49
3404-001,2013,3,24,7,64,117,181,62
3404-001,2013,3,24,8,121,225,346,181
3404-001,2013,3,24,9,173,233,406,346
3404-001,2013,3,24,10,203,225,428,406
3404-001,2013,3,24,11,228,260,488,428
3404-001,2013,3,24,12,233,282,515,488
3404-001,2013,3,24,13,241,250,491,515
3404-001,2013,3,24,14,255,296,551,491
3404-001,2013,3,24,15,360,276,636,551
3404-001,2013,3,24,16,374,295,669,636
3404-001,2013,3,24,17,405,260,665,669
3404-001,2013,3,24,18,472,232,704,665
3404-001,2013,3,24,19,373,229,602,704
3404-001,2013,3,24,20,198,197,395,602
3404-001,2013,3,24,21,188,156,344,395
3404-001,2013,3,24,22,124,152,276,344
3404-001,2013,3,24,23,66,125,191,276
3404-001,2013,3,24,24,51,83,134,191
3404-001,2013,3,25,1,26,74,100,134
3404-001,2013,3,25,2,26,38,64,100
3404-001,2013,3,25,3,13,35,48,64
3404-001,2013,3,25,4,16,28,44,48
3404-001,2013,3,25,5,30,55,85,44
3404-001,2013,3,25,6,56,110,166,85
3404-001,2013,3,25,7,132,410,542,166
3404-001,2013,3,25,8,383,1378,1761,542
3404-001,2013,3,25,9,462,1030,1492,1761
3404-001,2013,3,25,10,464,573,1037,1492
3404-001,2013,3,25,11,499,558,1057,1037
3404-001,2013,3,25,12,540,530,1070,1057
3404-001,2013,3,25,13,447,420,867,1070
3404-001,2013,3,25,14,483,501,984,867
3404-001,2013,3,25,15,632,544,1176,984
3404-001,2013,3,25,16,595,514,1109,1176
3404-001,2013,3,25,17,600,472,1072,1109
3404-001,2013,3,25,18,774,434,1208,1072
3404-001,2013,3,25,19,747,332,1079,1208
3404-001,2013,3,25,20,563,278,841,1079
3404-001,2013,3,25,21,505,189,694,841
3404-001,2013,3,25,22,279,153,432,694
3404-001,2013,3,25,23,189,111,300,432
3404-001,2013,3,25,24,124,94,218,300
3404-001,2013,3,26,1,62,54,116,218
3404-001,2013,3,26,2,46,42,88,116
3404-001,2013,3,26,3,32,28,60,88
3404-001,2013,3,26,4,40,37,77,60
3404-001,2013,3,26,5,37,76,113,77
3404-001,2013,3,26,6,67,112,179,113
3404-001,2013,3,26,7,130,389,519,179
3404-001,2013,3,26,8,344,1185,1529,519
3404-001,2013,3,26,9,505,958,1463,1529
3404-001,2013,3,26,10,492,565,1057,1463
3404-001,2013,3,26,11,546,567,1113,1057
3404-001,2013,3,26,12,489,510,999,1113
3404-001,2013,3,26,13,432,442,874,999
3404-001,2013,3,26,14,480,518,998,874
3404-001,2013,3,26,15,602,577,1179,998
3404-001,2013,3,26,16,661,501,1162,1179
3404-001,2013,3,26,17,624,425,1049,1162
3404-001,2013,3,26,18,722,417,1139,1049
3404-001,2013,3,26,19,738,338,1076,1139
3404-001,2013,3,26,20,600,300,900,1076
3404-001,2013,3,26,21,472,213,685,900
3404-001,2013,3,26,22,322,151,473,685
3404-001,2013,3,26,23,212,123,335,473
3404-001,2013,3,26,24,93,84,177,335
3404-001,2013,3,27,1,79,65,144,177
3404-001,2013,3,27,2,37,51,88,144
3404-001,2013,3,27,3,31,37,68,88
3404-001,2013,3,27,4,37,46,83,68
3404-001,2013,3,27,5,44,56,100,83
3404-001,2013,3,27,6,81,113,194,100
3404-001,2013,3,27,7,107,386,493,194
3404-001,2013,3,27,8,333,1193,1526,493
3404-001,2013,3,27,9,526,1001,1527,1526
3404-001,2013,3,27,10,501,575,1076,1527
3404-001,2013,3,27,11,535,529,1064,1076
3404-001,2013,3,27,12,511,499,1010,1064
3404-001,2013,3,27,13,456,419,875,1010
3404-001,2013,3,27,14,488,529,1017,875
3404-001,2013,3,27,15,594,510,1104,1017
3404-001,2013,3,27,16,576,482,1058,1104
3404-001,2013,3,27,17,624,468,1092,1058
3404-001,2013,3,27,18,841,397,1238,1092
3404-001,2013,3,27,19,765,391,1156,1238
3404-001,2013,3,27,20,542,287,829,1156
3404-001,2013,3,27,21,451,213,664,829
3404-001,2013,3,27,22,288,148,436,664
3404-001,2013,3,27,23,196,114,310,436
3404-001,2013,3,27,24,95,75,170,310
3404-001,2013,3,28,1,69,78,147,170
3404-001,2013,3,28,2,38,36,74,147
3404-001,2013,3,28,3,26,35,61,74
3404-001,2013,3,28,4,28,29,57,61
3404-001,2013,3,28,5,47,71,118,57
3404-001,2013,3,28,6,63,123,186,118
3404-001,2013,3,28,7,140,396,536,186
3404-001,2013,3,28,8,338,1155,1493,536
3404-001,2013,3,28,9,520,1034,1554,1493
3404-001,2013,3,28,10,505,567,1072,1554
3404-001,2013,3,28,11,590,597,1187,1072
3404-001,2013,3,28,12,513,483,996,1187
3404-001,2013,3,28,13,496,449,945,996
3404-001,2013,3,28,14,470,525,995,945
3404-001,2013,3,28,15,592,541,1133,995
3404-001,2013,3,28,16,650,530,1180,1133
3404-001,2013,3,28,17,654,450,1104,1180
3404-001,2013,3,28,18,816,439,1255,1104
3404-001,2013,3,28,19,821,385,1206,1255
3404-001,2013,3,28,20,559,294,853,1206
3404-001,2013,3,28,21,484,201,685,853
3404-001,2013,3,28,22,286,176,462,685
3404-001,2013,3,28,23,163,118,281,462
3404-001,2013,3,28,24,111,83,194,281
3404-001,2013,3,29,1,72,72,144,194
3404-001,2013,3,29,2,46,46,92,144
3404-001,2013,3,29,3,32,41,73,92
3404-001,2013,3,29,4,22,34,56,73
3404-001,2013,3,29,5,33,63,96,56
3404-001,2013,3,29,6,63,110,173,96
3404-001,2013,3,29,7,126,394,520,173
3404-001,2013,3,29,8,338,1162,1500,520
3404-001,2013,3,29,9,534,1026,1560,1500
3404-001,2013,3,29,10,530,564,1094,1560
3404-001,2013,3,29,11,581,539,1120,1094
3404-001,2013,3,29,12,521,567,1088,1120
3404-001,2013,3,29,13,451,414,865,1088
3404-001,2013,3,29,14,491,482,973,865
3404-001,2013,3,29,15,608,543,1151,973
3404-001,2013,3,29,16,645,530,1175,1151
3404-001,2013,3,29,17,656,435,1091,1175
3404-001,2013,3,29,18,853,438,1291,1091
3404-001,2013,3,29,19,923,439,1362,1291
3404-001,2013,3,29,20,647,343,990,1362
3404-001,2013,3,29,21,472,222,694,990
3404-001,2013,3,29,22,328,156,484,694
3404-001,2013,3,29,23,160,135,295,484
3404-001,2013,3,29,24,79,89,168,295
3404-001,2013,3,30,1,81,48,129,168
3404-001,2013,3,30,2,49,57,106,129
3404-001,2013,3,30,3,33,32,65,106
3404-001,2013,3,30,4,30,34,64,65
3404-001,2013,3,30,5,51,63,114,64
3404-001,2013,3,30,6,57,119,176,114
3404-001,2013,3,30,7,127,226,353,176
3404-001,2013,3,30,8,222,554,776,353
3404-001,2013,3,30,9,365,596,961,776
3404-001,2013,3,30,10,437,473,910,961
3404-001,2013,3,30,11,457,433,890,910
3404-001,2013,3,30,12,446,404,850,890
3404-001,2013,3,30,13,406,393,799,850
3404-001,2013,3,30,14,406,379,785,799
3404-001,2013,3,30,15,462,377,839,785
3404-001,2013,3,30,16,502,354,856,839
3404-001,2013,3,30,17,526,278,804,856
3404-001,2013,3,30,18,602,310,912,804
3404-001,2013,3,30,19,436,246,682,912
3404-001,2013,3,30,20,252,228,480,682
3404-001,2013,3,30,21,228,150,378,480
3404-001,2013,3,30,22,152,141,293,378
3404-001,2013,3,30,23,95,80,175,293
3404-001,2013,3,30,24,64,50,114,175
3404-001,2013,3,31,1,46,30,76,114
3404-001,2013,3,31,2,28,23,51,76
3404-001,2013,3,31,3,18,19,37,51
3404-001,2013,3,31,4,13,21,34,37
3404-001,2013,3,31,5,24,12,36,34
3404-001,2013,3,31,6,28,44,72,36
3404-001,2013,3,31,7,51,92,143,72
3404-001,2013,3,31,8,85,181,266,143
3404-001,2013,3,31,9,162,239,401,266
3404-001,2013,3,31,10,178,207,385,401
3404-001,2013,3,31,11,248,302,550,385
3404-001,2013,3,31,12,186,298,484,550
3404-001,2013,3,31,13,251,273,524,484
3404-001,2013,3,31,14,283,317,600,524
3404-001,2013,3,31,15,349,296,645,600
3404-001,2013,3,31,16,376,318,694,645
3404-001,2013,3,31,17,464,274,738,694
3404-001,2013,3,31,18,483,256,739,738
3404-001,2013,3,31,19,383,212,595,739
3404-001,2013,3,31,20,270,197,467,595
3404-001,2013,3,31,21,218,173,391,467
3404-001,2013,3,31,22,152,182,334,391
3404-001,2013,3,31,23,80,120,200,334
3404-001,2013,3,31,24,45,71,116,200
3404-001,2013,4,1,1,41,71,112,116
3404-001,2013,4,1,2,22,40,62,112
3404-001,2013,4,1,3,21,31,52,62
3404-001,2013,4,1,4,18,43,61,52
3404-001,2013,4,1,5,29,69,98,61
3404-001,2013,4,1,6,71,144,215,98
3404-001,2013,4,1,7,142,448,590,215
3404-001,2013,4,1,8,339,1319,1658,590
3404-001,2013,4,1,9,437,1053,1490,1658
3404-001,2013,4,1,10,458,507,965,1490
3404-001,2013,4,1,11,529,515,1044,965
3404-001,2013,4,1,12,486,536,1022,1044
3404-001,2013,4,1,13,469,413,882,1022
3404-001,2013,4,1,14,541,513,1054,882
3404-001,2013,4,1,15,552,522,1074,1054
3404-001,2013,4,1,16,580,489,1069,1074
3404-001,2013,4,1,17,590,496,1086,1069
3404-001,2013,4,1,18,699,461,1160,1086
3404-001,2013,4,1,19,734,371,1105,1160
3404-001,2013,4,1,20,566,299,865,1105
3404-001,2013,4,1,21,505,186,691,865
3404-001,2013,4,1,22,329,153,482,691
3404-001,2013,4,1,23,199,108,307,482
3404-001,2013,4,1,24,94,87,181,307
3404-001,2013,4,2,1,62,41,103,181
3404-001,2013,4,2,2,44,49,93,103
3404-001,2013,4,2,3,36,35,71,93
3404-001,2013,4,2,4,25,35,60,71
3404-001,2013,4,2,5,30,68,98,60
3404-001,2013,4,2,6,62,116,178,98
3404-001,2013,4,2,7,115,364,479,178
3404-001,2013,4,2,8,340,1047,1387,479
3404-001,2013,4,2,9,462,978,1440,1387
3404-001,2013,4,2,10,509,588,1097,1440
3404-001,2013,4,2,11,480,585,1065,1097
3404-001,2013,4,2,12,543,494,1037,1065
3404-001,2013,4,2,13,444,430,874,1037
3404-001,2013,4,2,14,522,475,997,874
3404-001,2013,4,2,15,603,516,1119,997
3404-001,2013,4,2,16,600,487,1087,1119
3404-001,2013,4,2,17,601,456,1057,1087
3404-001,2013,4,2,18,690,331,1021,1057
3404-001,2013,4,2,19,692,325,1017,1021
3404-001,2013,4,2,20,526,253,779,1017
3404-001,2013,4,2,21,502,200,702,779
3404-001,2013,4,2,22,344,159,503,702
3404-001,2013,4,2,23,157,121,278,503
3404-001,2013,4,2,24,81,77,158,278
3404-001,2013,4,3,1,64,62,126,158
3404-001,2013,4,3,2,46,35,81,126
3404-001,2013,4,3,3,20,26,46,81
3404-001,2013,4,3,4,35,30,65,46
3404-001,2013,4,3,5,46,59,105,65
3404-001,2013,4,3,6,74,117,191,105
3404-001,2013,4,3,7,120,381,501,191
3404-001,2013,4,3,8,343,1197,1540,501
3404-001,2013,4,3,9,518,1021,1539,1540
3404-001,2013,4,3,10,490,504,994,1539
3404-001,2013,4,3,11,517,573,1090,994
3404-001,2013,4,3,12,518,479,997,1090
3404-001,2013,4,3,13,462,415,877,997
3404-001,2013,4,3,14,504,477,981,877
3404-001,2013,4,3,15,611,505,1116,981
3404-001,2013,4,3,16,644,499,1143,1116
3404-001,2013,4,3,17,619,470,1089,1143
3404-001,2013,4,3,18,856,445,1301,1089
3404-001,2013,4,3,19,725,326,1051,1301
3404-001,2013,4,3,20,611,294,905,1051
3404-001,2013,4,3,21,455,235,690,905
3404-001,2013,4,3,22,313,176,489,690
3404-001,2013,4,3,23,197,136,333,489
3404-001,2013,4,3,24,106,93,199,333
3404-001,2013,4,4,1,68,50,118,199
3404-001,2013,4,4,2,35,56,91,118
3404-001,2013,4,4,3,31,38,69,91
3404-001,2013,4,4,4,35,39,74,69
3404-001,2013,4,4,5,44,52,96,74
3404-001,2013,4,4,6,68,136,204,96
3404-001,2013,4,4,7,141,386,527,204
3404-001,2013,4,4,8,363,1119,1482,527
3404-001,2013,4,4,9,522,1002,1524,1482
3404-001,2013,4,4,10,522,588,1110,1524
3404-001,2013,4,4,11,494,554,1048,1110
3404-001,2013,4,4,12,512,501,1013,1048
3404-001,2013,4,4,13,459,421,880,1013
3404-001,2013,4,4,14,466,503,969,880
3404-001,2013,4,4,15,608,506,1114,969
3404-001,2013,4,4,16,605,501,1106,1114
3404-001,2013,4,4,17,628,487,1115,1106
3404-001,2013,4,4,18,754,431,1185,1115
3404-001,2013,4,4,19,793,358,1151,1185
3404-001,2013,4,4,20,567,315,882,1151
3404-001,2013,4,4,21,503,219,722,882
3404-001,2013,4,4,22,345,165,510,722
3404-001,2013,4,4,23,176,151,327,510
3404-001,2013,4,4,24,117,92,209,327
3404-001,2013,4,5,1,64,81,145,209
3404-001,2013,4,5,2,44,41,85,145
3404-001,2013,4,5,3,38,32,70,85
3404-001,2013,4,5,4,24,33,57,70
3404-001,2013,4,5,5,50,59,109,57
3404-001,2013,4,5,6,77,170,247,109
3404-001,2013,4,5,7,167,366,533,247
3404-001,2013,4,5,8,353,1116,1469,533
3404-001,2013,4,5,9,490,984,1474,1469
3404-001,2013,4,5,10,523,540,1063,1474
3404-001,2013,4,5,11,566,533,1099,1063
3404-001,2013,4,5,12,511,512,1023,1099
3404-001,2013,4,5,13,465,434,899,1023
3404-001,2013,4,5,14,503,488,991,899
3404-001,2013,4,5,15,595,473,1068,991
3404-001,2013,4,5,16,601,468,1069,1068
3404-001,2013,4,5,17,642,482,1124,1069
3404-001,2013,4,5,18,817,441,1258,1124
3404-001,2013,4,5,19,879,430,1309,1258
3404-001,2013,4,5,20,646,321,967,1309
3404-001,2013,4,5,21,436,235,671,967
3404-001,2013,4,5,22,309,190,499,671
3404-001,2013,4,5,23,197,123,320,499
3404-001,2013,4,5,24,92,87,179,320
3404-001,2013,4,6,1,78,70,148,179
3404-001,2013,4,6,2,59,59,118,148
3404-001,2013,4,6,3,36,32,68,118
3404-001,2013,4,6,4,30,29,59,68
3404-001,2013,4,6,5,61,44,105,59
3404-001,2013,4,6,6,47,86,133,105
3404-001,2013,4,6,7,77,155,232,133
3404-001,2013,4,6,8,198,426,624,232
3404-001,2013,4,6,9,302,460,762,624
3404-001,2013,4,6,10,357,372,729,762
3404-001,2013,4,6,11,410,365,775,729
3404-001,2013,4,6,12,413,344,757,775
3404-001,2013,4,6,13,374,320,694,757
3404-001,2013,4,6,14,350,308,658,694
3404-001,2013,4,6,15,395,278,673,658
3404-001,2013,4,6,16,397,267,664,673
3404-001,2013,4,6,17,393,263,656,664
3404-001,2013,4,6,18,429,271,700,656
3404-001,2013,4,6,19,333,239,572,700
3404-001,2013,4,6,20,186,169,355,572
3404-001,2013,4,6,21,154,131,285,355
3404-001,2013,4,6,22,130,101,231,285
3404-001,2013,4,6,23,70,74,144,231
3404-001,2013,4,6,24,49,49,98,144
3404-001,2013,4,7,1,42,33,75,98
3404-001,2013,4,7,2,23,26,49,75
3404-001,2013,4,7,3,15,10,25,49
3404-001,2013,4,7,4,14,17,31,25
3404-001,2013,4,7,5,14,16,30,31
3404-001,2013,4,7,6,28,21,49,30
3404-001,2013,4,7,7,43,88,131,49
3404-001,2013,4,7,8,100,184,284,131
3404-001,2013,4,7,9,133,202,335,284
3404-001,2013,4,7,10,174,195,369,335
3404-001,2013,4,7,11,224,227,451,369
3404-001,2013,4,7,12,225,280,505,451
3404-001,2013,4,7,13,237,249,486,505
3404-001,2013,4,7,14,243,251,494,486
3404-001,2013,4,7,15,306,264,570,494
3404-001,2013,4,7,16,345,270,615,570
3404-001,2013,4,7,17,339,255,594,615
3404-001,2013,4,7,18,343,235,578,594
3404-001,2013,4,7,19,305,226,531,578
3404-001,2013,4,7,20,226,193,419,531
3404-001,2013,4,7,21,184,164,348,419
3404-001,2013,4,7,22,126,165,291,348
3404-001,2013,4,7,23,81,134,215,291
3404-001,2013,4,7,24,45,95,140,215
3404-001,2013,4,8,1,37,57,94,140
3404-001,2013,4,8,2,18,44,62,94
3404-001,2013,4,8,3,12,29,41,62
3404-001,2013,4,8,4,10,29,39,41
3404-001,2013,4,8,5,29,50,79,39
3404-001,2013,4,8,6,57,129,186,79
3404-001,2013,4,8,7,121,464,585,186
3404-001,2013,4,8,8,371,1308,1679,585
3404-001,2013,4,8,9,445,1076,1521,1679
3404-001,2013,4,8,10,499,569,1068,1521
3404-001,2013,4,8,11,536,517,1053,1068
3404-001,2013,4,8,12,531,501,1032,1053
3404-001,2013,4,8,13,449,446,895,1032
3404-001,2013,4,8,14,478,505,983,895
3404-001,2013,4,8,15,605,538,1143,983
3404-001,2013,4,8,16,539,534,1073,1143
3404-001,2013,4,8,17,586,429,1015,1073
3404-001,2013,4,8,18,728,389,1117,1015
3404-001,2013,4,8,19,704,373,1077,1117
3404-001,2013,4,8,20,538,295,833,1077
3404-001,2013,4,8,21,510,205,715,833
3404-001,2013,4,8,22,326,170,496,715
3404-001,2013,4,8,23,165,103,268,496
3404-001,2013,4,8,24,100,89,189,268
3404-001,2013,4,9,1,69,55,124,189
3404-001,2013,4,9,2,37,54,91,124
3404-001,2013,4,9,3,17,28,45,91
3404-001,2013,4,9,4,39,48,87,45
3404-001,2013,4,9,5,43,63,106,87
3404-001,2013,4,9,6,72,116,188,106
3404-001,2013,4,9,7,153,391,544,188
3404-001,2013,4,9,8,341,1104,1445,544
3404-001,2013,4,9,9,517,1019,1536,1445
3404-001,2013,4,9,10,475,573,1048,1536
3404-001,2013,4,9,11,577,567,1144,1048
3404-001,2013,4,9,12,510,505,1015,1144
3404-001,2013,4,9,13,469,442,911,1015
3404-001,2013,4,9,14,501,500,1001,911
3404-001,2013,4,9,15,606,499,1105,1001
3404-001,2013,4,9,16,566,505,1071,1105
3404-001,2013,4,9,17,626,445,1071,1071
3404-001,2013,4,9,18,736,392,1128,1071
3404-001,2013,4,9,19,786,332,1118,1128
3404-001,2013,4,9,20,576,310,886,1118
3404-001,2013,4,9,21,473,224,697,886
3404-001,2013,4,9,22,332,164,496,697
3404-001,2013,4,9,23,176,126,302,496
3404-001,2013,4,9,24,108,87,195,302
3404-001,2013,4,10,1,53,47,100,195
3404-001,2013,4,10,2,33,39,72,100
3404-001,2013,4,10,3,36,34,70,72
3404-001,2013,4,10,4,30,31,61,70
3404-001,2013,4,10,5,45,67,112,61
3404-001,2013,4,10,6,79,113,192,112
3404-001,2013,4,10,7,120,361,481,192
3404-001,2013,4,10,8,345,1114,1459,481
3404-001,2013,4,10,9,526,1047,1573,1459
3404-001,2013,4,10,10,528,537,1065,1573
3404-001,2013,4,10,11,546,562,1108,1065
3404-001,2013,4,10,12,545,463,1008,1108
3404-001,2013,4,10,13,462,374,836,1008
3404-001,2013,4,10,14,484,501,985,836
3404-001,2013,4,10,15,567,515,1082,985
3404-001,2013,4,10,16,613,494,1107,1082
3404-001,2013,4,10,17,546,444,990,1107
3404-001,2013,4,10,18,777,387,1164,990
3404-001,2013,4,10,19,810,361,1171,1164
3404-001,2013,4,10,20,529,302,831,1171
3404-001,2013,4,10,21,447,224,671,831
3404-001,2013,4,10,22,332,160,492,671
3404-001,2013,4,10,23,171,121,292,492
3404-001,2013,4,10,24,96,82,178,292
3404-001,2013,4,11,1,67,64,131,178
3404-001,2013,4,11,2,54,55,109,131
3404-001,2013,4,11,3,39,39,78,109
3404-001,2013,4,11,4,28,51,79,78
3404-001,2013,4,11,5,40,71,111,79
3404-001,2013,4,11,6,76,105,181,111
3404-001,2013,4,11,7,131,415,546,181
3404-001,2013,4,11,8,372,1193,1565,546
3404-001,2013,4,11,9,511,1005,1516,1565
3404-001,2013,4,11,10,540,569,1109,1516
3404-001,2013,4,11,11,545,543,1088,1109
3404-001,2013,4,11,12,544,504,1048,1088
3404-001,2013,4,11,13,393,381,774,1048
3404-001,2013,4,11,14,470,462,932,774
3404-001,2013,4,11,15,592,555,1147,932
3404-001,2013,4,11,16,641,485,1126,1147
3404-001,2013,4,11,17,563,417,980,1126
3404-001,2013,4,11,18,759,421,1180,980
3404-001,2013,4,11,19,757,347,1104,1180
3404-001,2013,4,11,20,517,296,813,1104
3404-001,2013,4,11,21,473,198,671,813
3404-001,2013,4,11,22,304,189,493,671
3404-001,2013,4,11,23,152,113,265,493
3404-001,2013,4,11,24,92,86,178,265
3404-001,2013,4,12,1,69,60,129,178
3404-001,2013,4,12,2,56,52,108,129
3404-001,2013,4,12,3,35,37,72,108
3404-001,2013,4,12,4,30,46,76,72
3404-001,2013,4,12,5,43,66,109,76
3404-001,2013,4,12,6,78,149,227,109
3404-001,2013,4,12,7,145,433,578,227
3404-001,2013,4,12,8,399,1194,1593,578
3404-001,2013,4,12,9,537,1008,1545,1593
3404-001,2013,4,12,10,531,540,1071,1545
3404-001,2013,4,12,11,541,563,1104,1071
3404-001,2013,4,12,12,574,516,1090,1104
3404-001,2013,4,12,13,438,423,861,1090
3404-001,2013,4,12,14,510,506,1016,861
3404-001,2013,4,12,15,576,535,1111,1016
3404-001,2013,4,12,16,603,498,1101,1111
3404-001,2013,4,12,17,651,456,1107,1101
3404-001,2013,4,12,18,906,442,1348,1107
3404-001,2013,4,12,19,938,410,1348,1348
3404-001,2013,4,12,20,595,336,931,1348
3404-001,2013,4,12,21,467,242,709,931
3404-001,2013,4,12,22,353,173,526,709
3404-001,2013,4,12,23,163,124,287,526
3404-001,2013,4,12,24,102,91,193,287
3404-001,2013,4,13,1,70,73,143,193
3404-001,2013,4,13,2,45,45,90,143
3404-001,2013,4,13,3,47,33,80,90
3404-001,2013,4,13,4,38,28,66,80
3404-001,2013,4,13,5,51,60,111,66
3404-001,2013,4,13,6,69,155,224,111
3404-001,2013,4,13,7,154,292,446,224
3404-001,2013,4,13,8,259,578,837,446
3404-001,2013,4,13,9,392,598,990,837
3404-001,2013,4,13,10,443,445,888,990
3404-001,2013,4,13,11,436,447,883,888
3404-001,2013,4,13,12,436,401,837,883
3404-001,2013,4,13,13,373,401,774,837
3404-001,2013,4,13,14,441,408,849,774
3404-001,2013,4,13,15,448,355,803,849
3404-001,2013,4,13,16,440,357,797,803
3404-001,2013,4,13,17,506,369,875,797
3404-001,2013,4,13,18,615,381,996,875
3404-001,2013,4,13,19,501,313,814,996
3404-001,2013,4,13,20,322,221,543,814
3404-001,2013,4,13,21,218,167,385,543
3404-001,2013,4,13,22,170,165,335,385
3404-001,2013,4,13,23,95,93,188,335
3404-001,2013,4,13,24,59,63,122,188
3404-001,2013,4,14,1,42,52,94,122
3404-001,2013,4,14,2,27,25,52,94
3404-001,2013,4,14,3,31,20,51,52
3404-001,2013,4,14,4,21,14,35,51
3404-001,2013,4,14,5,20,17,37,35
3404-001,2013,4,14,6,29,40,69,37
3404-001,2013,4,14,7,50,82,132,69
3404-001,2013,4,14,8,107,188,295,132
3404-001,2013,4,14,9,168,196,364,295
3404-001,2013,4,14,10,174,208,382,364
3404-001,2013,4,14,11,251,247,498,382
3404-001,2013,4,14,12,211,236,447,498
3404-001,2013,4,14,13,254,279,533,447
3404-001,2013,4,14,14,237,259,496,533
3404-001,2013,4,14,15,263,255,518,496
3404-001,2013,4,14,16,313,244,557,518
3404-001,2013,4,14,17,390,265,655,557
3404-001,2013,4,14,18,348,245,593,655
3404-001,2013,4,14,19,295,223,518,593
3404-001,2013,4,14,20,238,200,438,518
3404-001,2013,4,14,21,183,191,374,438
3404-001,2013,4,14,22,124,184,308,374
3404-001,2013,4,14,23,69,103,172,308
3404-001,2013,4,14,24,44,85,129,172
3404-001,2013,4,15,1,41,66,107,129
3404-001,2013,4,15,2,15,42,57,107
3404-001,2013,4,15,3,14,28,42,57
3404-001,2013,4,15,4,16,34,50,42
3404-001,2013,4,15,5,36,59,95,50
3404-001,2013,4,15,6,76,168,244,95
3404-001,2013,4,15,7,159,467,626,244
3404-001,2013,4,15,8,376,1398,1774,626
3404-001,2013,4,15,9,461,1015,1476,1774
3404-001,2013,4,15,10,473,523,996,1476
3404-001,2013,4,15,11,519,539,1058,996
3404-001,2013,4,15,12,541,521,1062,1058
3404-001,2013,4,15,13,433,439,872,1062
3404-001,2013,4,15,14,513,529,1042,872
3404-001,2013,4,15,15,542,504,1046,1042
3404-001,2013,4,15,16,600,526,1126,1046
3404-001,2013,4,15,17,623,411,1034,1126
3404-001,2013,4,15,18,729,418,1147,1034
3404-001,2013,4,15,19,725,341,1066,1147
3404-001,2013,4,15,20,518,264,782,1066
3404-001,2013,4,15,21,496,199,695,782
3404-001,2013,4,15,22,337,156,493,695
3404-001,2013,4,15,23,183,109,292,493
3404-001,2013,4,15,24,75,84,159,292
3404-001,2013,4,16,1,58,71,129,159
3404-001,2013,4,16,2,38,34,72,129
3404-001,2013,4,16,3,30,44,74,72
3404-001,2013,4,16,4,22,37,59,74
3404-001,2013,4,16,5,41,59,100,59
3404-001,2013,4,16,6,78,122,200,100
3404-001,2013,4,16,7,139,424,563,200
3404-001,2013,4,16,8,357,1209,1566,563
3404-001,2013,4,16,9,528,986,1514,1566
3404-001,2013,4,16,10,530,603,1133,1514
3404-001,2013,4,16,11,546,545,1091,1133
3404-001,2013,4,16,12,503,542,1045,1091
3404-001,2013,4,16,13,474,457,931,1045
3404-001,2013,4,16,14,503,510,1013,931
3404-001,2013,4,16,15,586,527,1113,1013
3404-001,2013,4,16,16,628,522,1150,1113
3404-001,2013,4,16,17,620,396,1016,1150
3404-001,2013,4,16,18,752,420,1172,1016
3404-001,2013,4,16,19,733,370,1103,1172
3404-001,2013,4,16,20,537,294,831,1103
3404-001,2013,4,16,21,470,196,666,831
3404-001,2013,4,16,22,319,174,493,666
3404-001,2013,4,16,23,167,120,287,493
3404-001,2013,4,16,24,103,86,189,287
3404-001,2013,4,17,1,68,67,135,189
3404-001,2013,4,17,2,42,50,92,135
3404-001,2013,4,17,3,30,39,69,92
3404-001,2013,4,17,4,30,34,64,69
3404-001,2013,4,17,5,59,55,114,64
3404-001,2013,4,17,6,85,118,203,114
3404-001,2013,4,17,7,149,390,539,203
3404-001,2013,4,17,8,392,1159,1551,539
3404-001,2013,4,17,9,527,984,1511,1551
3404-001,2013,4,17,10,523,608,1131,1511
3404-001,2013,4,17,11,525,559,1084,1131
3404-001,2013,4,17,12,506,484,990,1084
3404-001,2013,4,17,13,456,371,827,990
3404-001,2013,4,17,14,455,330,785,827
3404-001,2013,4,17,15,557,430,987,785
3404-001,2013,4,17,16,591,479,1070,987
3404-001,2013,4,17,17,619,433,1052,1070
3404-001,2013,4,17,18,844,434,1278,1052
3404-001,2013,4,17,19,808,441,1249,1278
3404-001,2013,4,17,20,505,309,814,1249
3404-001,2013,4,17,21,465,203,668,814
3404-001,2013,4,17,22,294,160,454,668
3404-001,2013,4,17,23,168,123,291,454
3404-001,2013,4,17,24,106,64,170,291
3404-001,2013,4,18,1,66,66,132,170
3404-001,2013,4,18,2,53,31,84,132
3404-001,2013,4,18,3,32,21,53,84
3404-001,2013,4,18,4,24,44,68,53
3404-001,2013,4,18,5,48,60,108,68
3404-001,2013,4,18,6,84,138,222,108
3404-001,2013,4,18,7,146,402,548,222
3404-001,2013,4,18,8,339,1197,1536,548
3404-001,2013,4,18,9,517,938,1455,1536
3404-001,2013,4,18,10,546,547,1093,1455
3404-001,2013,4,18,11,521,559,1080,1093
3404-001,2013,4,18,12,535,510,1045,1080
3404-001,2013,4,18,13,483,397,880,1045
3404-001,2013,4,18,14,493,519,1012,880
3404-001,2013,4,18,15,587,566,1153,1012
3404-001,2013,4,18,16,631,530,1161,1153
3404-001,2013,4,18,17,637,442,1079,1161
3404-001,2013,4,18,18,761,435,1196,1079
3404-001,2013,4,18,19,762,349,1111,1196
3404-001,2013,4,18,20,536,292,828,1111
3404-001,2013,4,18,21,486,219,705,828
3404-001,2013,4,18,22,328,174,502,705
3404-001,2013,4,18,23,162,135,297,502
3404-001,2013,4,18,24,98,83,181,297
3404-001,2013,4,19,1,58,59,117,181
3404-001,2013,4,19,2,47,55,102,117
3404-001,2013,4,19,3,36,21,57,102
3404-001,2013,4,19,4,31,46,77,57
3404-001,2013,4,19,5,38,54,92,77
3404-001,2013,4,19,6,76,147,223,92
3404-001,2013,4,19,7,138,424,562,223
3404-001,2013,4,19,8,372,1124,1496,562
3404-001,2013,4,19,9,538,958,1496,1496
3404-001,2013,4,19,10,487,576,1063,1496
3404-001,2013,4,19,11,523,554,1077,1063
3404-001,2013,4,19,12,517,504,1021,1077
3404-001,2013,4,19,13,471,406,877,1021
3404-001,2013,4,19,14,479,518,997,877
3404-001,2013,4,19,15,598,548,1146,997
3404-001,2013,4,19,16,603,498,1101,1146
3404-001,2013,4,19,17,672,501,1173,1101
3404-001,2013,4,19,18,928,446,1374,1173
3404-001,2013,4,19,19,889,430,1319,1374
3404-001,2013,4,19,20,574,318,892,1319
3404-001,2013,4,19,21,490,222,712,892
3404-001,2013,4,19,22,330,161,491,712
3404-001,2013,4,19,23,183,139,322,491
3404-001,2013,4,19,24,93,95,188,322
3404-001,2013,4,20,1,76,74,150,188
3404-001,2013,4,20,2,46,39,85,150
3404-001,2013,4,20,3,38,30,68,85
3404-001,2013,4,20,4,39,37,76,68
3404-001,2013,4,20,5,41,61,102,76
3404-001,2013,4,20,6,68,111,179,102
3404-001,2013,4,20,7,123,214,337,179
3404-001,2013,4,20,8,270,521,791,337
3404-001,2013,4,20,9,384,520,904,791
3404-001,2013,4,20,10,334,402,736,904
3404-001,2013,4,20,11,391,394,785,736
3404-001,2013,4,20,12,384,399,783,785
3404-001,2013,4,20,13,323,272,595,783
3404-001,2013,4,20,14,396,341,737,595
3404-001,2013,4,20,15,377,329,706,737
3404-001,2013,4,20,16,385,314,699,706
3404-001,2013,4,20,17,458,310,768,699
3404-001,2013,4,20,18,557,332,889,768
3404-001,2013,4,20,19,325,294,619,889
3404-001,2013,4,20,20,256,218,474,619
3404-001,2013,4,20,21,188,150,338,474
3404-001,2013,4,20,22,138,102,240,338
3404-001,2013,4,20,23,92,90,182,240
3404-001,2013,4,20,24,68,51,119,182
3404-001,2013,4,21,1,41,33,74,119
3404-001,2013,4,21,2,42,31,73,74
3404-001,2013,4,21,3,13,15,28,73
3404-001,2013,4,21,4,21,15,36,28
3404-001,2013,4,21,5,22,27,49,36
3404-001,2013,4,21,6,47,46,93,49
3404-001,2013,4,21,7,77,135,212,93
3404-001,2013,4,21,8,160,211,371,212
3404-001,2013,4,21,9,238,232,470,371
3404-001,2013,4,21,10,208,257,465,470
3404-001,2013,4,21,11,236,287,523,465
3404-001,2013,4,21,12,291,305,596,523
3404-001,2013,4,21,13,241,299,540,596
3404-001,2013,4,21,14,271,280,551,540
3404-001,2013,4,21,15,316,345,661,551
3404-001,2013,4,21,16,370,275,645,661
3404-001,2013,4,21,17,399,259,658,645
3404-001,2013,4,21,18,407,222,629,658
3404-001,2013,4,21,19,377,216,593,629
3404-001,2013,4,21,20,313,186,499,593
3404-001,2013,4,21,21,211,167,378,499
3404-001,2013,4,21,22,141,187,328,378
3404-001,2013,4,21,23,110,117,227,328
3404-001,2013,4,21,24,62,99,161,227
3404-001,2013,4,22,1,27,57,84,161
3404-001,2013,4,22,2,19,29,48,84
3404-001,2013,4,22,3,13,28,41,48
3404-001,2013,4,22,4,21,29,50,41
3404-001,2013,4,22,5,48,50,98,50
3404-001,2013,4,22,6,76,163,239,98
3404-001,2013,4,22,7,169,527,696,239
3404-001,2013,4,22,8,383,1371,1754,696
3404-001,2013,4,22,9,458,1073,1531,1754
3404-001,2013,4,22,10,495,552,1047,1531
3404-001,2013,4,22,11,537,512,1049,1047
3404-001,2013,4,22,12,489,515,1004,1049
3404-001,2013,4,22,13,428,365,793,1004
3404-001,2013,4,22,14,480,517,997,793
3404-001,2013,4,22,15,563,536,1099,997
3404-001,2013,4,22,16,579,539,1118,1099
3404-001,2013,4,22,17,594,478,1072,1118
3404-001,2013,4,22,18,797,394,1191,1072
3404-001,2013,4,22,19,752,360,1112,1191
3404-001,2013,4,22,20,597,288,885,1112
3404-001,2013,4,22,21,479,211,690,885
3404-001,2013,4,22,22,320,138,458,690
3404-001,2013,4,22,23,191,116,307,458
3404-001,2013,4,22,24,97,100,197,307
3404-001,2013,4,23,1,66,55,121,197
3404-001,2013,4,23,2,35,59,94,121
3404-001,2013,4,23,3,29,30,59,94
3404-001,2013,4,23,4,33,35,68,59
3404-001,2013,4,23,5,32,64,96,68
3404-001,2013,4,23,6,85,144,229,96
3404-001,2013,4,23,7,141,450,591,229
3404-001,2013,4,23,8,342,1160,1502,591
3404-001,2013,4,23,9,576,1020,1596,1502
3404-001,2013,4,23,10,516,552,1068,1596
3404-001,2013,4,23,11,555,564,1119,1068
3404-001,2013,4,23,12,566,481,1047,1119
3404-001,2013,4,23,13,456,437,893,1047
3404-001,2013,4,23,14,520,475,995,893
3404-001,2013,4,23,15,577,485,1062,995
3404-001,2013,4,23,16,521,439,960,1062
3404-001,2013,4,23,17,531,418,949,960
3404-001,2013,4,23,18,700,375,1075,949
3404-001,2013,4,23,19,713,330,1043,1075
3404-001,2013,4,23,20,447,258,705,1043
3404-001,2013,4,23,21,467,194,661,705
3404-001,2013,4,23,22,334,136,470,661
3404-001,2013,4,23,23,142,103,245,470
3404-001,2013,4,23,24,96,86,182,245
3404-001,2013,4,24,1,68,44,112,182
3404-001,2013,4,24,2,42,44,86,112
3404-001,2013,4,24,3,30,32,62,86
3404-001,2013,4,24,4,23,32,55,62
3404-001,2013,4,24,5,38,65,103,55
3404-001,2013,4,24,6,71,127,198,103
3404-001,2013,4,24,7,126,392,518,198
3404-001,2013,4,24,8,340,1114,1454,518
3404-001,2013,4,24,9,519,1012,1531,1454
3404-001,2013,4,24,10,547,554,1101,1531
3404-001,2013,4,24,11,488,560,1048,1101
3404-001,2013,4,24,12,554,506,1060,1048
3404-001,2013,4,24,13,423,441,864,1060
3404-001,2013,4,24,14,513,498,1011,864
3404-001,2013,4,24,15,646,541,1187,1011
3404-001,2013,4,24,16,642,482,1124,1187
3404-001,2013,4,24,17,639,442,1081,1124
3404-001,2013,4,24,18,749,432,1181,1081
3404-001,2013,4,24,19,750,408,1158,1181
3404-001,2013,4,24,20,592,317,909,1158
3404-001,2013,4,24,21,510,192,702,909
3404-001,2013,4,24,22,318,171,489,702
3404-001,2013,4,24,23,166,140,306,489
3404-001,2013,4,24,24,107,91,198,306
3404-001,2013,4,25,1,61,60,121,198
3404-001,2013,4,25,2,54,42,96,121
3404-001,2013,4,25,3,26,35,61,96
3404-001,2013,4,25,4,35,37,72,61
3404-001,2013,4,25,5,50,64,114,72
3404-001,2013,4,25,6,84,148,232,114
3404-001,2013,4,25,7,152,422,574,232
3404-001,2013,4,25,8,353,1169,1522,574
3404-001,2013,4,25,9,572,995,1567,1522
3404-001,2013,4,25,10,477,547,1024,1567
3404-001,2013,4,25,11,558,528,1086,1024
3404-001,2013,4,25,12,510,440,950,1086
3404-001,2013,4,25,13,466,417,883,950
3404-001,2013,4,25,14,413,500,913,883
3404-001,2013,4,25,15,560,477,1037,913
3404-001,2013,4,25,16,600,487,1087,1037
3404-001,2013,4,25,17,605,455,1060,1087
3404-001,2013,4,25,18,736,388,1124,1060
3404-001,2013,4,25,19,751,363,1114,1124
3404-001,2013,4,25,20,499,291,790,1114
3404-001,2013,4,25,21,473,227,700,790
3404-001,2013,4,25,22,388,135,523,700
3404-001,2013,4,25,23,180,123,303,523
3404-001,2013,4,25,24,111,81,192,303
3404-001,2013,4,26,1,52,74,126,192
3404-001,2013,4,26,2,42,37,79,126
3404-001,2013,4,26,3,32,45,77,79
3404-001,2013,4,26,4,34,30,64,77
3404-001,2013,4,26,5,42,63,105,64
3404-001,2013,4,26,6,67,138,205,105
3404-001,2013,4,26,7,137,415,552,205
3404-001,2013,4,26,8,398,1138,1536,552
3404-001,2013,4,26,9,490,965,1455,1536
3404-001,2013,4,26,10,508,550,1058,1455
3404-001,2013,4,26,11,506,534,1040,1058
3404-001,2013,4,26,12,545,516,1061,1040
3404-001,2013,4,26,13,439,421,860,1061
3404-001,2013,4,26,14,496,538,1034,860
3404-001,2013,4,26,15,596,561,1157,1034
3404-001,2013,4,26,16,669,511,1180,1157
3404-001,2013,4,26,17,663,472,1135,1180
3404-001,2013,4,26,18,929,440,1369,1135
3404-001,2013,4,26,19,840,406,1246,1369
3404-001,2013,4,26,20,594,354,948,1246
3404-001,2013,4,26,21,486,268,754,948
3404-001,2013,4,26,22,336,157,493,754
3404-001,2013,4,26,23,157,142,299,493
3404-001,2013,4,26,24,115,100,215,299
3404-001,2013,4,27,1,83,65,148,215
3404-001,2013,4,27,2,62,44,106,148
3404-001,2013,4,27,3,35,38,73,106
3404-001,2013,4,27,4,36,57,93,73
3404-001,2013,4,27,5,42,56,98,93
3404-001,2013,4,27,6,90,166,256,98
3404-001,2013,4,27,7,139,281,420,256
3404-001,2013,4,27,8,300,603,903,420
3404-001,2013,4,27,9,410,573,983,903
3404-001,2013,4,27,10,409,509,918,983
3404-001,2013,4,27,11,447,419,866,918
3404-001,2013,4,27,12,435,411,846,866
3404-001,2013,4,27,13,394,398,792,846
3404-001,2013,4,27,14,401,434,835,792
3404-001,2013,4,27,15,457,403,860,835
3404-001,2013,4,27,16,437,334,771,860
3404-001,2013,4,27,17,489,335,824,771
3404-001,2013,4,27,18,602,367,969,824
3404-001,2013,4,27,19,438,258,696,969
3404-001,2013,4,27,20,307,212,519,696
3404-001,2013,4,27,21,211,162,373,519
3404-001,2013,4,27,22,158,141,299,373
3404-001,2013,4,27,23,111,95,206,299
3404-001,2013,4,27,24,69,59,128,206
3404-001,2013,4,28,1,53,39,92,128
3404-001,2013,4,28,2,42,29,71,92
3404-001,2013,4,28,3,30,22,52,71
3404-001,2013,4,28,4,12,18,30,52
3404-001,2013,4,28,5,22,31,53,30
3404-001,2013,4,28,6,46,53,99,53
3404-001,2013,4,28,7,67,145,212,99
3404-001,2013,4,28,8,143,282,425,212
3404-001,2013,4,28,9,162,265,427,425
3404-001,2013,4,28,10,252,271,523,427
3404-001,2013,4,28,11,241,305,546,523
3404-001,2013,4,28,12,218,278,496,546
3404-001,2013,4,28,13,246,249,495,496
3404-001,2013,4,28,14,252,296,548,495
3404-001,2013,4,28,15,314,319,633,548
3404-001,2013,4,28,16,391,271,662,633
3404-001,2013,4,28,17,439,243,682,662
3404-001,2013,4,28,18,463,257,720,682
3404-001,2013,4,28,19,441,244,685,720
3404-001,2013,4,28,20,297,229,526,685
3404-001,2013,4,28,21,229,184,413,526
3404-001,2013,4,28,22,177,167,344,413
3404-001,2013,4,28,23,86,109,195,344
3404-001,2013,4,28,24,54,100,154,195
3404-001,2013,4,29,1,43,67,110,154
3404-001,2013,4,29,2,23,42,65,110
3404-001,2013,4,29,3,17,24,41,65
3404-001,2013,4,29,4,36,32,68,41
3404-001,2013,4,29,5,38,50,88,68
3404-001,2013,4,29,6,76,154,230,88
3404-001,2013,4,29,7,136,423,559,230
3404-001,2013,4,29,8,343,1237,1580,559
3404-001,2013,4,29,9,442,1081,1523,1580
3404-001,2013,4,29,10,456,473,929,1523
3404-001,2013,4,29,11,488,493,981,929
3404-001,2013,4,29,12,499,494,993,981
3404-001,2013,4,29,13,444,444,888,993
3404-001,2013,4,29,14,431,463,894,888
3404-001,2013,4,29,15,555,510,1065,894
3404-001,2013,4,29,16,575,502,1077,1065
3404-001,2013,4,29,17,580,450,1030,1077
3404-001,2013,4,29,18,728,404,1132,1030
3404-001,2013,4,29,19,722,361,1083,1132
3404-001,2013,4,29,20,535,297,832,1083
3404-001,2013,4,29,21,537,221,758,832
3404-001,2013,4,29,22,347,163,510,758
3404-001,2013,4,29,23,184,136,320,510
3404-001,2013,4,29,24,107,88,195,320
3404-001,2013,4,30,1,69,54,123,195
3404-001,2013,4,30,2,47,44,91,123
3404-001,2013,4,30,3,30,32,62,91
3404-001,2013,4,30,4,34,39,73,62
3404-001,2013,4,30,5,49,72,121,73
3404-001,2013,4,30,6,75,147,222,121
3404-001,2013,4,30,7,155,465,620,222
3404-001,2013,4,30,8,384,1228,1612,620
3404-001,2013,4,30,9,530,972,1502,1612
3404-001,2013,4,30,10,531,624,1155,1502
3404-001,2013,4,30,11,558,573,1131,1155
3404-001,2013,4,30,12,555,523,1078,1131
3404-001,2013,4,30,13,452,461,913,1078
3404-001,2013,4,30,14,517,521,1038,913
3404-001,2013,4,30,15,604,584,1188,1038
3404-001,2013,4,30,16,661,491,1152,1188
3404-001,2013,4,30,17,617,500,1117,1152
3404-001,2013,4,30,18,831,444,1275,1117
3404-001,2013,4,30,19,925,393,1318,1275
3404-001,2013,4,30,20,668,344,1012,1318
3404-001,2013,4,30,21,533,236,769,1012
3404-001,2013,4,30,22,314,190,504,769
3404-001,2013,4,30,23,197,130,327,504
3404-001,2013,4,30,24,127,91,218,327
3404-001,2013,5,1,1,66,67,133,218
3404-001,2013,5,1,2,48,36,84,133
3404-001,2013,5,1,3,48,36,84,84
3404-001,2013,5,1,4,32,23,55,84
3404-001,2013,5,1,5,30,58,88,55
3404-001,2013,5,1,6,67,105,172,88
3404-001,2013,5,1,7,123,242,365,172
3404-001,2013,5,1,8,260,599,859,365
3404-001,2013,5,1,9,396,606,1002,859
3404-001,2013,5,1,10,392,417,809,1002
3404-001,2013,5,1,11,377,439,816,809
3404-001,2013,5,1,12,354,393,747,816
3404-001,2013,5,1,13,326,340,666,747
3404-001,2013,5,1,14,376,358,734,666
3404-001,2013,5,1,15,440,343,783,734
3404-001,2013,5,1,16,409,304,713,783
3404-001,2013,5,1,17,439,310,749,713
3404-001,2013,5,1,18,586,323,909,749
3404-001,2013,5,1,19,469,272,741,909
3404-001,2013,5,1,20,284,199,483,741
3404-001,2013,5,1,21,222,155,377,483
3404-001,2013,5,1,22,172,145,317,377
3404-001,2013,5,1,23,106,99,205,317
3404-001,2013,5,1,24,62,67,129,205
3404-001,2013,5,2,1,51,40,91,129
3404-001,2013,5,2,2,16,41,57,91
3404-001,2013,5,2,3,12,30,42,57
3404-001,2013,5,2,4,20,28,48,42
3404-001,2013,5,2,5,48,53,101,48
3404-001,2013,5,2,6,65,171,236,101
3404-001,2013,5,2,7,158,467,625,236
3404-001,2013,5,2,8,367,1304,1671,625
3404-001,2013,5,2,9,495,1064,1559,1671
3404-001,2013,5,2,10,577,607,1184,1559
3404-001,2013,5,2,11,573,559,1132,1184
3404-001,2013,5,2,12,488,483,971,1132
3404-001,2013,5,2,13,464,409,873,971
3404-001,2013,5,2,14,480,514,994,873
3404-001,2013,5,2,15,580,523,1103,994
3404-001,2013,5,2,16,638,520,1158,1103
3404-001,2013,5,2,17,603,453,1056,1158
3404-001,2013,5,2,18,760,440,1200,1056
3404-001,2013,5,2,19,783,380,1163,1200
3404-001,2013,5,2,20,572,319,891,1163
3404-001,2013,5,2,21,523,213,736,891
3404-001,2013,5,2,22,352,192,544,736
3404-001,2013,5,2,23,173,137,310,544
3404-001,2013,5,2,24,110,98,208,310
3404-001,2013,5,3,1,86,50,136,208
3404-001,2013,5,3,2,35,40,75,136
3404-001,2013,5,3,3,38,31,69,75
3404-001,2013,5,3,4,23,41,64,69
3404-001,2013,5,3,5,49,69,118,64
3404-001,2013,5,3,6,95,164,259,118
3404-001,2013,5,3,7,157,405,562,259
3404-001,2013,5,3,8,385,1196,1581,562
3404-001,2013,5,3,9,502,993,1495,1581
3404-001,2013,5,3,10,537,557,1094,1495
3404-001,2013,5,3,11,582,558,1140,1094
3404-001,2013,5,3,12,562,493,1055,1140
3404-001,2013,5,3,13,471,453,924,1055
3404-001,2013,5,3,14,549,538,1087,924
3404-001,2013,5,3,15,591,564,1155,1087
3404-001,2013,5,3,16,644,539,1183,1155
3404-001,2013,5,3,17,671,515,1186,1183
3404-001,2013,5,3,18,916,455,1371,1186
3404-001,2013,5,3,19,920,461,1381,1371
3404-001,2013,5,3,20,634,332,966,1381
3404-001,2013,5,3,21,504,225,729,966
3404-001,2013,5,3,22,346,181,527,729
3404-001,2013,5,3,23,174,111,285,527
3404-001,2013,5,3,24,97,90,187,285
3404-001,2013,5,4,1,61,73,134,187
3404-001,2013,5,4,2,66,47,113,134
3404-001,2013,5,4,3,34,28,62,113
3404-001,2013,5,4,4,34,41,75,62
3404-001,2013,5,4,5,42,53,95,75
3404-001,2013,5,4,6,87,130,217,95
3404-001,2013,5,4,7,134,278,412,217
3404-001,2013,5,4,8,260,559,819,412
3404-001,2013,5,4,9,419,560,979,819
3404-001,2013,5,4,10,385,454,839,979
3404-001,2013,5,4,11,425,456,881,839
3404-001,2013,5,4,12,434,433,867,881
3404-001,2013,5,4,13,382,384,766,867
3404-001,2013,5,4,14,379,372,751,766
3404-001,2013,5,4,15,443,386,829,751
3404-001,2013,5,4,16,487,384,871,829
3404-001,2013,5,4,17,484,360,844,871
3404-001,2013,5,4,18,663,358,1021,844
3404-001,2013,5,4,19,446,307,753,1021
3404-001,2013,5,4,20,345,256,601,753
3404-001,2013,5,4,21,312,167,479,601
3404-001,2013,5,4,22,198,121,319,479
3404-001,2013,5,4,23,119,96,215,319
3404-001,2013,5,4,24,87,64,151,215
3404-001,2013,5,5,1,57,49,106,151
3404-001,2013,5,5,2,32,22,54,106
3404-001,2013,5,5,3,28,30,58,54
3404-001,2013,5,5,4,22,27,49,58
3404-001,2013,5,5,5,19,35,54,49
3404-001,2013,5,5,6,43,76,119,54
3404-001,2013,5,5,7,74,145,219,119
3404-001,2013,5,5,8,107,183,290,219
3404-001,2013,5,5,9,185,202,387,290
3404-001,2013,5,5,10,198,229,427,387
3404-001,2013,5,5,11,221,319,540,427
3404-001,2013,5,5,12,227,336,563,540
3404-001,2013,5,5,13,245,277,522,563
3404-001,2013,5,5,14,269,269,538,522
3404-001,2013,5,5,15,354,320,674,538
3404-001,2013,5,5,16,357,268,625,674
3404-001,2013,5,5,17,455,275,730,625
3404-001,2013,5,5,18,608,253,861,730
3404-001,2013,5,5,19,484,246,730,861
3404-001,2013,5,5,20,366,205,571,730
3404-001,2013,5,5,21,263,178,441,571
3404-001,2013,5,5,22,196,189,385,441
3404-001,2013,5,5,23,91,143,234,385
3404-001,2013,5,5,24,60,105,165,234
3404-001,2013,5,6,1,38,78,116,165
3404-001,2013,5,6,2,21,53,74,116
3404-001,2013,5,6,3,8,25,33,74
3404-001,2013,5,6,4,22,22,44,33
3404-001,2013,5,6,5,33,72,105,44
3404-001,2013,5,6,6,79,198,277,105
3404-001,2013,5,6,7,192,508,700,277
3404-001,2013,5,6,8,412,1356,1768,700
3404-001,2013,5,6,9,493,1044,1537,1768
3404-001,2013,5,6,10,493,536,1029,1537
3404-001,2013,5,6,11,497,534,1031,1029
3404-001,2013,5,6,12,505,519,1024,1031
3404-001,2013,5,6,13,480,385,865,1024
3404-001,2013,5,6,14,496,512,1008,865
3404-001,2013,5,6,15,569,562,1131,1008
3404-001,2013,5,6,16,591,501,1092,1131
3404-001,2013,5,6,17,597,477,1074,1092
3404-001,2013,5,6,18,816,450,1266,1074
3404-001,2013,5,6,19,801,418,1219,1266
3404-001,2013,5,6,20,595,280,875,1219
3404-001,2013,5,6,21,570,247,817,875
3404-001,2013,5,6,22,353,191,544,817
3404-001,2013,5,6,23,187,138,325,544
3404-001,2013,5,6,24,115,83,198,325
3404-001,2013,5,7,1,59,59,118,198
3404-001,2013,5,7,2,46,50,96,118
3404-001,2013,5,7,3,34,31,65,96
3404-001,2013,5,7,4,38,43,81,65
3404-001,2013,5,7,5,42,91,133,81
3404-001,2013,5,7,6,85,136,221,133
3404-001,2013,5,7,7,178,431,609,221
3404-001,2013,5,7,8,403,1224,1627,609
3404-001,2013,5,7,9,526,1051,1577,1627
3404-001,2013,5,7,10,534,539,1073,1577
3404-001,2013,5,7,11,538,590,1128,1073
3404-001,2013,5,7,12,536,535,1071,1128
3404-001,2013,5,7,13,456,473,929,1071
3404-001,2013,5,7,14,533,502,1035,929
3404-001,2013,5,7,15,617,550,1167,1035
3404-001,2013,5,7,16,588,538,1126,1167
3404-001,2013,5,7,17,637,499,1136,1126
3404-001,2013,5,7,18,815,458,1273,1136
3404-001,2013,5,7,19,724,391,1115,1273
3404-001,2013,5,7,20,563,308,871,1115
3404-001,2013,5,7,21,533,253,786,871
3404-001,2013,5,7,22,380,192,572,786
3404-001,2013,5,7,23,205,126,331,572
3404-001,2013,5,7,24,109,100,209,331
3404-001,2013,5,8,1,64,70,134,209
3404-001,2013,5,8,2,43,42,85,134
3404-001,2013,5,8,3,43,28,71,85
3404-001,2013,5,8,4,45,30,75,71
3404-001,2013,5,8,5,50,61,111,75
3404-001,2013,5,8,6,86,171,257,111
3404-001,2013,5,8,7,170,409,579,257
3404-001,2013,5,8,8,364,1213,1577,579
3404-001,2013,5,8,9,554,972,1526,1577
3404-001,2013,5,8,10,515,576,1091,1526
3404-001,2013,5,8,11,572,546,1118,1091
3404-001,2013,5,8,12,531,507,1038,1118
3404-001,2013,5,8,13,443,453,896,1038
3404-001,2013,5,8,14,485,540,1025,896
3404-001,2013,5,8,15,650,519,1169,1025
3404-001,2013,5,8,16,640,494,1134,1169
3404-001,2013,5,8,17,623,496,1119,1134
3404-001,2013,5,8,18,979,468,1447,1119
3404-001,2013,5,8,19,922,419,1341,1447
3404-001,2013,5,8,20,515,350,865,1341
3404-001,2013,5,8,21,459,232,691,865
3404-001,2013,5,8,22,329,181,510,691
3404-001,2013,5,8,23,213,135,348,510
3404-001,2013,5,8,24,111,99,210,348
3404-001,2013,5,9,1,73,63,136,210
3404-001,2013,5,9,2,52,46,98,136
3404-001,2013,5,9,3,39,35,74,98
3404-001,2013,5,9,4,24,27,51,74
3404-001,2013,5,9,5,43,74,117,51
3404-001,2013,5,9,6,86,144,230,117
3404-001,2013,5,9,7,170,433,603,230
3404-001,2013,5,9,8,375,1216,1591,603
3404-001,2013,5,9,9,533,1039,1572,1591
3404-001,2013,5,9,10,536,600,1136,1572
3404-001,2013,5,9,11,541,568,1109,1136
3404-001,2013,5,9,12,558,513,1071,1109
3404-001,2013,5,9,13,477,478,955,1071
3404-001,2013,5,9,14,519,535,1054,955
3404-001,2013,5,9,15,601,504,1105,1054
3404-001,2013,5,9,16,642,531,1173,1105
3404-001,2013,5,9,17,609,469,1078,1173
3404-001,2013,5,9,18,762,434,1196,1078
3404-001,2013,5,9,19,805,342,1147,1196
3404-001,2013,5,9,20,514,304,818,1147
3404-001,2013,5,9,21,520,190,710,818
3404-001,2013,5,9,22,333,144,477,710
3404-001,2013,5,9,23,199,143,342,477
3404-001,2013,5,9,24,94,70,164,342
3404-001,2013,5,10,1,73,63,136,164
3404-001,2013,5,10,2,41,47,88,136
3404-001,2013,5,10,3,33,31,64,88
3404-001,2013,5,10,4,30,33,63,64
3404-001,2013,5,10,5,38,53,91,63
3404-001,2013,5,10,6,67,117,184,91
3404-001,2013,5,10,7,123,308,431,184
3404-001,2013,5,10,8,317,1095,1412,431
3404-001,2013,5,10,9,528,993,1521,1412
3404-001,2013,5,10,10,477,523,1000,1521
3404-001,2013,5,10,11,531,536,1067,1000
3404-001,2013,5,10,12,570,506,1076,1067
3404-001,2013,5,10,13,480,440,920,1076
3404-001,2013,5,10,14,484,466,950,920
3404-001,2013,5,10,15,585,549,1134,950
3404-001,2013,5,10,16,610,482,1092,1134
3404-001,2013,5,10,17,620,455,1075,1092
3404-001,2013,5,10,18,816,456,1272,1075
3404-001,2013,5,10,19,814,396,1210,1272
3404-001,2013,5,10,20,565,305,870,1210
3404-001,2013,5,10,21,516,236,752,870
3404-001,2013,5,10,22,312,141,453,752
3404-001,2013,5,10,23,182,121,303,453
3404-001,2013,5,10,24,121,111,232,303
3404-001,2013,5,11,1,78,69,147,232
3404-001,2013,5,11,2,54,59,113,147
3404-001,2013,5,11,3,36,40,76,113
3404-001,2013,5,11,4,33,44,77,76
3404-001,2013,5,11,5,53,69,122,77
3404-001,2013,5,11,6,74,157,231,122
3404-001,2013,5,11,7,153,284,437,231
3404-001,2013,5,11,8,275,574,849,437
3404-001,2013,5,11,9,356,603,959,849
3404-001,2013,5,11,10,426,484,910,959
3404-001,2013,5,11,11,477,461,938,910
3404-001,2013,5,11,12,460,425,885,938
3404-001,2013,5,11,13,369,350,719,885
3404-001,2013,5,11,14,375,391,766,719
3404-001,2013,5,11,15,429,375,804,766
3404-001,2013,5,11,16,478,374,852,804
3404-001,2013,5,11,17,469,316,785,852
3404-001,2013,5,11,18,658,350,1008,785
3404-001,2013,5,11,19,482,326,808,1008
3404-001,2013,5,11,20,347,247,594,808
3404-001,2013,5,11,21,233,212,445,594
3404-001,2013,5,11,22,185,153,338,445
3404-001,2013,5,11,23,115,104,219,338
3404-001,2013,5,11,24,64,50,114,219
3404-001,2013,5,12,1,52,46,98,114
3404-001,2013,5,12,2,40,36,76,98
3404-001,2013,5,12,3,17,21,38,76
3404-001,2013,5,12,4,16,19,35,38
3404-001,2013,5,12,5,20,27,47,35
3404-001,2013,5,12,6,45,74,119,47
3404-001,2013,5,12,7,93,136,229,119
3404-001,2013,5,12,8,123,216,339,229
3404-001,2013,5,12,9,182,231,413,339
3404-001,2013,5,12,10,212,229,441,413
3404-001,2013,5,12,11,247,281,528,441
3404-001,2013,5,12,12,203,280,483,528
3404-001,2013,5,12,13,217,227,444,483
3404-001,2013,5,12,14,267,297,564,444
3404-001,2013,5,12,15,329,283,612,564
3404-001,2013,5,12,16,344,270,614,612
3404-001,2013,5,12,17,425,258,683,614
3404-001,2013,5,12,18,492,246,738,683
3404-001,2013,5,12,19,362,252,614,738
3404-001,2013,5,12,20,303,215,518,614
3404-001,2013,5,12,21,198,187,385,518
3404-001,2013,5,12,22,173,186,359,385
3404-001,2013,5,12,23,88,132,220,359
3404-001,2013,5,12,24,62,83,145,220
3404-001,2013,5,13,1,49,82,131,145
3404-001,2013,5,13,2,21,54,75,131
3404-001,2013,5,13,3,12,32,44,75
3404-001,2013,5,13,4,22,40,62,44
3404-001,2013,5,13,5,40,57,97,62
3404-001,2013,5,13,6,102,189,291,97
3404-001,2013,5,13,7,167,503,670,291
3404-001,2013,5,13,8,421,1408,1829,670
3404-001,2013,5,13,9,508,1122,1630,1829
3404-001,2013,5,13,10,501,570,1071,1630
3404-001,2013,5,13,11,556,559,1115,1071
3404-001,2013,5,13,12,537,528,1065,1115
3404-001,2013,5,13,13,464,389,853,1065
3404-001,2013,5,13,14,519,521,1040,853
3404-001,2013,5,13,15,560,605,1165,1040
3404-001,2013,5,13,16,570,564,1134,1165
3404-001,2013,5,13,17,603,448,1051,1134
3404-001,2013,5,13,18,716,455,1171,1051
3404-001,2013,5,13,19,720,361,1081,1171
3404-001,2013,5,13,20,583,347,930,1081
3404-001,2013,5,13,21,305,219,524,930
3404-001,2013,5,13,22,88,193,281,524
3404-001,2013,5,13,23,221,121,342,281
3404-001,2013,5,13,24,113,91,204,342
3404-001,2013,5,14,1,58,77,135,204
3404-001,2013,5,14,2,44,60,104,135
3404-001,2013,5,14,3,34,26,60,104
3404-001,2013,5,14,4,29,53,82,60
3404-001,2013,5,14,5,48,62,110,82
3404-001,2013,5,14,6,88,150,238,110
3404-001,2013,5,14,7,169,412,581,238
3404-001,2013,5,14,8,402,1175,1577,581
3404-001,2013,5,14,9,527,1067,1594,1577
3404-001,2013,5,14,10,557,603,1160,1594
3404-001,2013,5,14,11,559,586,1145,1160
3404-001,2013,5,14,12,554,511,1065,1145
3404-001,2013,5,14,13,502,396,898,1065
3404-001,2013,5,14,14,489,530,1019,898
3404-001,2013,5,14,15,638,538,1176,1019
3404-001,2013,5,14,16,604,504,1108,1176
3404-001,2013,5,14,17,587,460,1047,1108
3404-001,2013,5,14,18,772,464,1236,1047
3404-001,2013,5,14,19,748,373,1121,1236
3404-001,2013,5,14,20,561,312,873,1121
3404-001,2013,5,14,21,518,236,754,873
3404-001,2013,5,14,22,334,189,523,754
3404-001,2013,5,14,23,180,124,304,523
3404-001,2013,5,14,24,117,97,214,304
3404-001,2013,5,15,1,76,64,140,214
3404-001,2013,5,15,2,55,51,106,140
3404-001,2013,5,15,3,38,33,71,106
3404-001,2013,5,15,4,39,40,79,71
3404-001,2013,5,15,5,45,67,112,79
3404-001,2013,5,15,6,99,150,249,112
3404-001,2013,5,15,7,148,459,607,249
3404-001,2013,5,15,8,368,1146,1514,607
3404-001,2013,5,15,9,541,1071,1612,1514
3404-001,2013,5,15,10,534,586,1120,1612
3404-001,2013,5,15,11,599,572,1171,1120
3404-001,2013,5,15,12,571,523,1094,1171
3404-001,2013,5,15,13,446,482,928,1094
3404-001,2013,5,15,14,495,519,1014,928
3404-001,2013,5,15,15,678,555,1233,1014
3404-001,2013,5,15,16,643,551,1194,1233
3404-001,2013,5,15,17,660,448,1108,1194
3404-001,2013,5,15,18,745,469,1214,1108
3404-001,2013,5,15,19,861,421,1282,1214
3404-001,2013,5,15,20,560,327,887,1282
3404-001,2013,5,15,21,503,232,735,887
3404-001,2013,5,15,22,350,181,531,735
3404-001,2013,5,15,23,240,153,393,531
3404-001,2013,5,15,24,117,86,203,393
3404-001,2013,5,16,1,74,80,154,203
3404-001,2013,5,16,2,48,49,97,154
3404-001,2013,5,16,3,30,40,70,97
3404-001,2013,5,16,4,27,40,67,70
3404-001,2013,5,16,5,52,68,120,67
3404-001,2013,5,16,6,94,137,231,120
3404-001,2013,5,16,7,171,433,604,231
3404-001,2013,5,16,8,381,1188,1569,604
3404-001,2013,5,16,9,531,1081,1612,1569
3404-001,2013,5,16,10,576,556,1132,1612
3404-001,2013,5,16,11,594,578,1172,1132
3404-001,2013,5,16,12,600,517,1117,1172
3404-001,2013,5,16,13,479,496,975,1117
3404-001,2013,5,16,14,519,517,1036,975
3404-001,2013,5,16,15,618,579,1197,1036
3404-001,2013,5,16,16,668,575,1243,1197
3404-001,2013,5,16,17,699,503,1202,1243
3404-001,2013,5,16,18,940,455,1395,1202
3404-001,2013,5,16,19,981,401,1382,1395
3404-001,2013,5,16,20,697,377,1074,1382
3404-001,2013,5,16,21,566,282,848,1074
3404-001,2013,5,16,22,384,224,608,848
3404-001,2013,5,16,23,219,170,389,608
3404-001,2013,5,16,24,119,113,232,389
3404-001,2013,5,17,1,70,88,158,232
3404-001,2013,5,17,2,54,53,107,158
3404-001,2013,5,17,3,44,40,84,107
3404-001,2013,5,17,4,25,42,67,84
3404-001,2013,5,17,5,61,56,117,67
3404-001,2013,5,17,6,73,154,227,117
3404-001,2013,5,17,7,177,284,461,227
3404-001,2013,5,17,8,277,579,856,461
3404-001,2013,5,17,9,392,563,955,856
3404-001,2013,5,17,10,404,493,897,955
3404-001,2013,5,17,11,387,501,888,897
3404-001,2013,5,17,12,401,488,889,888
3404-001,2013,5,17,13,421,384,805,889
3404-001,2013,5,17,14,411,368,779,805
3404-001,2013,5,17,15,424,422,846,779
3404-001,2013,5,17,16,373,342,715,846
3404-001,2013,5,17,17,459,375,834,715
3404-001,2013,5,17,18,531,386,917,834
3404-001,2013,5,17,19,487,299,786,917
3404-001,2013,5,17,20,348,256,604,786
3404-001,2013,5,17,21,300,179,479,604
3404-001,2013,5,17,22,211,152,363,479
3404-001,2013,5,17,23,126,114,240,363
3404-001,2013,5,17,24,74,74,148,240
3404-001,2013,5,18,1,45,54,99,148
3404-001,2013,5,18,2,36,33,69,99
3404-001,2013,5,18,3,29,41,70,69
3404-001,2013,5,18,4,41,27,68,70
3404-001,2013,5,18,5,56,45,101,68
3404-001,2013,5,18,6,70,120,190,101
3404-001,2013,5,18,7,130,223,353,190
3404-001,2013,5,18,8,215,416,631,353
3404-001,2013,5,18,9,280,415,695,631
3404-001,2013,5,18,10,346,343,689,695
3404-001,2013,5,18,11,335,366,701,689
3404-001,2013,5,18,12,319,410,729,701
3404-001,2013,5,18,13,314,351,665,729
3404-001,2013,5,18,14,347,337,684,665
3404-001,2013,5,18,15,365,333,698,684
3404-001,2013,5,18,16,419,326,745,698
3404-001,2013,5,18,17,459,322,781,745
3404-001,2013,5,18,18,505,303,808,781
3404-001,2013,5,18,19,493,296,789,808
3404-001,2013,5,18,20,334,220,554,789
3404-001,2013,5,18,21,273,134,407,554
3404-001,2013,5,18,22,202,108,310,407
3404-001,2013,5,18,23,123,83,206,310
3404-001,2013,5,18,24,60,60,120,206
3404-001,2013,5,19,1,37,49,86,120
3404-001,2013,5,19,2,34,29,63,86
3404-001,2013,5,19,3,21,19,40,63
3404-001,2013,5,19,4,9,16,25,40
3404-001,2013,5,19,5,13,13,26,25
3404-001,2013,5,19,6,31,35,66,26
3404-001,2013,5,19,7,54,84,138,66
3404-001,2013,5,19,8,75,117,192,138
3404-001,2013,5,19,9,128,171,299,192
3404-001,2013,5,19,10,189,177,366,299
3404-001,2013,5,19,11,167,216,383,366
3404-001,2013,5,19,12,232,239,471,383
3404-001,2013,5,19,13,226,224,450,471
3404-001,2013,5,19,14,239,214,453,450
3404-001,2013,5,19,15,298,251,549,453
3404-001,2013,5,19,16,319,247,566,549
3404-001,2013,5,19,17,320,236,556,566
3404-001,2013,5,19,18,334,217,551,556
3404-001,2013,5,19,19,256,224,480,551
3404-001,2013,5,19,20,209,192,401,480
3404-001,2013,5,19,21,204,192,396,401
3404-001,2013,5,19,22,118,179,297,396
3404-001,2013,5,19,23,93,104,197,297
3404-001,2013,5,19,24,54,76,130,197
3404-001,2013,5,20,1,34,64,98,130
3404-001,2013,5,20,2,18,49,67,98
3404-001,2013,5,20,3,20,28,48,67
3404-001,2013,5,20,4,15,34,49,48
3404-001,2013,5,20,5,41,60,101,49
3404-001,2013,5,20,6,63,180,243,101
3404-001,2013,5,20,7,161,477,638,243
3404-001,2013,5,20,8,381,1361,1742,638
3404-001,2013,5,20,9,485,1113,1598,1742
3404-001,2013,5,20,10,488,539,1027,1598
3404-001,2013,5,20,11,476,547,1023,1027
3404-001,2013,5,20,12,499,512,1011,1023
3404-001,2013,5,20,13,492,408,900,1011
3404-001,2013,5,20,14,475,532,1007,900
3404-001,2013,5,20,15,598,528,1126,1007
3404-001,2013,5,20,16,602,522,1124,1126
3404-001,2013,5,20,17,631,453,1084,1124
3404-001,2013,5,20,18,752,443,1195,1084
3404-001,2013,5,20,19,761,369,1130,1195
3404-001,2013,5,20,20,607,308,915,1130
3404-001,2013,5,20,21,520,242,762,915
3404-001,2013,5,20,22,355,177,532,762
3404-001,2013,5,20,23,197,124,321,532
3404-001,2013,5,20,24,96,88,184,321
3404-001,2013,5,21,1,81,60,141,184
3404-001,2013,5,21,2,61,59,120,141
3404-001,2013,5,21,3,31,30,61,120
3404-001,2013,5,21,4,41,42,83,61
3404-001,2013,5,21,5,42,84,126,83
3404-001,2013,5,21,6,85,169,254,126
3404-001,2013,5,21,7,158,409,567,254
3404-001,2013,5,21,8,385,1182,1567,567
3404-001,2013,5,21,9,557,1080,1637,1567
3404-001,2013,5,21,10,528,555,1083,1637
3404-001,2013,5,21,11,546,561,1107,1083
3404-001,2013,5,21,12,529,543,1072,1107
3404-001,2013,5,21,13,467,436,903,1072
3404-001,2013,5,21,14,548,474,1022,903
3404-001,2013,5,21,15,574,556,1130,1022
3404-001,2013,5,21,16,610,542,1152,1130
3404-001,2013,5,21,17,581,466,1047,1152
3404-001,2013,5,21,18,767,434,1201,1047
3404-001,2013,5,21,19,734,357,1091,1201
3404-001,2013,5,21,20,609,348,957,1091
3404-001,2013,5,21,21,539,199,738,957
3404-001,2013,5,21,22,369,193,562,738
3404-001,2013,5,21,23,212,114,326,562
3404-001,2013,5,21,24,133,89,222,326
3404-001,2013,5,22,1,75,60,135,222
3404-001,2013,5,22,2,39,52,91,135
3404-001,2013,5,22,3,32,44,76,91
3404-001,2013,5,22,4,19,31,50,76
3404-001,2013,5,22,5,40,82,122,50
3404-001,2013,5,22,6,98,145,243,122
3404-001,2013,5,22,7,148,428,576,243
3404-001,2013,5,22,8,384,1194,1578,576
3404-001,2013,5,22,9,539,1064,1603,1578
3404-001,2013,5,22,10,476,579,1055,1603
3404-001,2013,5,22,11,561,563,1124,1055
3404-001,2013,5,22,12,499,494,993,1124
3404-001,2013,5,22,13,430,429,859,993
3404-001,2013,5,22,14,495,508,1003,859
3404-001,2013,5,22,15,588,526,1114,1003
3404-001,2013,5,22,16,610,484,1094,1114
3404-001,2013,5,22,17,616,427,1043,1094
3404-001,2013,5,22,18,864,441,1305,1043
3404-001,2013,5,22,19,809,391,1200,1305
3404-001,2013,5,22,20,547,343,890,1200
3404-001,2013,5,22,21,509,203,712,890
3404-001,2013,5,22,22,327,177,504,712
3404-001,2013,5,22,23,189,146,335,504
3404-001,2013,5,22,24,119,93,212,335
3404-001,2013,5,23,1,56,82,138,212
3404-001,2013,5,23,2,56,49,105,138
3404-001,2013,5,23,3,33,45,78,105
3404-001,2013,5,23,4,32,33,65,78
3404-001,2013,5,23,5,37,73,110,65
3404-001,2013,5,23,6,91,135,226,110
3404-001,2013,5,23,7,148,436,584,226
3404-001,2013,5,23,8,364,1216,1580,584
3404-001,2013,5,23,9,571,1076,1647,1580
3404-001,2013,5,23,10,545,602,1147,1647
3404-001,2013,5,23,11,525,561,1086,1147
3404-001,2013,5,23,12,524,485,1009,1086
3404-001,2013,5,23,13,452,437,889,1009
3404-001,2013,5,23,14,485,499,984,889
3404-001,2013,5,23,15,591,536,1127,984
3404-001,2013,5,23,16,582,514,1096,1127
3404-001,2013,5,23,17,634,472,1106,1096
3404-001,2013,5,23,18,782,433,1215,1106
3404-001,2013,5,23,19,843,371,1214,1215
3404-001,2013,5,23,20,609,347,956,1214
3404-001,2013,5,23,21,555,234,789,956
3404-001,2013,5,23,22,341,171,512,789
3404-001,2013,5,23,23,217,123,340,512
3404-001,2013,5,23,24,131,111,242,340
3404-001,2013,5,24,1,75,79,154,242
3404-001,2013,5,24,2,55,50,105,154
3404-001,2013,5,24,3,27,43,70,105
3404-001,2013,5,24,4,39,36,75,70
3404-001,2013,5,24,5,40,73,113,75
3404-001,2013,5,24,6,95,148,243,113
3404-001,2013,5,24,7,134,428,562,243
3404-001,2013,5,24,8,392,1176,1568,562
3404-001,2013,5,24,9,534,1071,1605,1568
3404-001,2013,5,24,10,557,584,1141,1605
3404-001,2013,5,24,11,537,573,1110,1141
3404-001,2013,5,24,12,596,500,1096,1110
3404-001,2013,5,24,13,491,454,945,1096
3404-001,2013,5,24,14,544,493,1037,945
3404-001,2013,5,24,15,567,591,1158,1037
3404-001,2013,5,24,16,666,558,1224,1158
3404-001,2013,5,24,17,639,531,1170,1224
3404-001,2013,5,24,18,922,477,1399,1170
3404-001,2013,5,24,19,926,451,1377,1399
3404-001,2013,5,24,20,695,383,1078,1377
3404-001,2013,5,24,21,571,254,825,1078
3404-001,2013,5,24,22,312,210,522,825
3404-001,2013,5,24,23,187,153,340,522
3404-001,2013,5,24,24,127,99,226,340
3404-001,2013,5,25,1,100,60,160,226
3404-001,2013,5,25,2,68,50,118,160
3404-001,2013,5,25,3,49,31,80,118
3404-001,2013,5,25,4,42,43,85,80
3404-001,2013,5,25,5,43,64,107,85
3404-001,2013,5,25,6,94,141,235,107
3404-001,2013,5,25,7,191,293,484,235
3404-001,2013,5,25,8,311,605,916,484
3404-001,2013,5,25,9,454,600,1054,916
3404-001,2013,5,25,10,481,509,990,1054
3404-001,2013,5,25,11,407,508,915,990
3404-001,2013,5,25,12,437,454,891,915
3404-001,2013,5,25,13,373,409,782,891
3404-001,2013,5,25,14,406,411,817,782
3404-001,2013,5,25,15,380,338,718,817
3404-001,2013,5,25,16,443,358,801,718
3404-001,2013,5,25,17,521,367,888,801
3404-001,2013,5,25,18,610,402,1012,888
3404-001,2013,5,25,19,466,330,796,1012
3404-001,2013,5,25,20,359,204,563,796
3404-001,2013,5,25,21,254,198,452,563
3404-001,2013,5,25,22,225,154,379,452
3404-001,2013,5,25,23,111,103,214,379
3404-001,2013,5,25,24,83,66,149,214
3404-001,2013,5,26,1,73,51,124,149
3404-001,2013,5,26,2,43,33,76,124
3404-001,2013,5,26,3,26,28,54,76
3404-001,2013,5,26,4,15,18,33,54
3404-001,2013,5,26,5,33,31,64,33
3404-001,2013,5,26,6,67,83,150,64
3404-001,2013,5,26,7,73,185,258,150
3404-001,2013,5,26,8,199,253,452,258
3404-001,2013,5,26,9,200,285,485,452
3404-001,2013,5,26,10,256,254,510,485
3404-001,2013,5,26,11,259,296,555,510
3404-001,2013,5,26,12,233,287,520,555
3404-001,2013,5,26,13,258,283,541,520
3404-001,2013,5,26,14,305,274,579,541
3404-001,2013,5,26,15,334,268,602,579
3404-001,2013,5,26,16,400,260,660,602
3404-001,2013,5,26,17,341,267,608,660
3404-001,2013,5,26,18,427,273,700,608
3404-001,2013,5,26,19,374,251,625,700
3404-001,2013,5,26,20,312,219,531,625
3404-001,2013,5,26,21,224,192,416,531
3404-001,2013,5,26,22,144,174,318,416
3404-001,2013,5,26,23,83,122,205,318
3404-001,2013,5,26,24,64,84,148,205
3404-001,2013,5,27,1,38,67,105,148
3404-001,2013,5,27,2,25,50,75,105
3404-001,2013,5,27,3,22,30,52,75
3404-001,2013,5,27,4,31,37,68,52
3404-001,2013,5,27,5,39,57,96,68
3404-001,2013,5,27,6,94,144,238,96
3404-001,2013,5,27,7,162,408,570,238
3404-001,2013,5,27,8,387,1338,1725,570
3404-001,2013,5,27,9,495,1112,1607,1725
3404-001,2013,5,27,10,491,540,1031,1607
3404-001,2013,5,27,11,470,553,1023,1031
3404-001,2013,5,27,12,528,511,1039,1023
3404-001,2013,5,27,13,386,401,787,1039
3404-001,2013,5,27,14,460,459,919,787
3404-001,2013,5,27,15,551,512,1063,919
3404-001,2013,5,27,16,516,457,973,1063
3404-001,2013,5,27,17,544,412,956,973
3404-001,2013,5,27,18,673,389,1062,956
3404-001,2013,5,27,19,705,347,1052,1062
3404-001,2013,5,27,20,519,306,825,1052
3404-001,2013,5,27,21,502,223,725,825
3404-001,2013,5,27,22,304,171,475,725
3404-001,2013,5,27,23,160,98,258,475
3404-001,2013,5,27,24,123,68,191,258
3404-001,2013,5,28,1,62,58,120,191
3404-001,2013,5,28,2,40,50,90,120
3404-001,2013,5,28,3,21,24,45,90
3404-001,2013,5,28,4,34,29,63,45
3404-001,2013,5,28,5,42,56,98,63
3404-001,2013,5,28,6,75,107,182,98
3404-001,2013,5,28,7,121,315,436,182
3404-001,2013,5,28,8,347,1111,1458,436
3404-001,2013,5,28,9,513,1051,1564,1458
3404-001,2013,5,28,10,495,551,1046,1564
3404-001,2013,5,28,11,522,523,1045,1046
3404-001,2013,5,28,12,520,511,1031,1045
3404-001,2013,5,28,13,451,438,889,1031
3404-001,2013,5,28,14,468,491,959,889
3404-001,2013,5,28,15,550,522,1072,959
3404-001,2013,5,28,16,573,495,1068,1072
3404-001,2013,5,28,17,605,444,1049,1068
3404-001,2013,5,28,18,757,372,1129,1049
3404-001,2013,5,28,19,755,353,1108,1129
3404-001,2013,5,28,20,532,290,822,1108
3404-001,2013,5,28,21,518,228,746,822
3404-001,2013,5,28,22,322,162,484,746
3404-001,2013,5,28,23,195,116,311,484
3404-001,2013,5,28,24,98,92,190,311
3404-001,2013,5,29,1,52,48,100,190
3404-001,2013,5,29,2,47,44,91,100
3404-001,2013,5,29,3,37,29,66,91
3404-001,2013,5,29,4,34,30,64,66
3404-001,2013,5,29,5,44,84,128,64
3404-001,2013,5,29,6,75,126,201,128
3404-001,2013,5,29,7,166,385,551,201
3404-001,2013,5,29,8,391,1178,1569,551
3404-001,2013,5,29,9,547,1044,1591,1569
3404-001,2013,5,29,10,499,540,1039,1591
3404-001,2013,5,29,11,537,572,1109,1039
3404-001,2013,5,29,12,505,522,1027,1109
3404-001,2013,5,29,13,426,413,839,1027
3404-001,2013,5,29,14,510,504,1014,839
3404-001,2013,5,29,15,581,554,1135,1014
3404-001,2013,5,29,16,634,531,1165,1135
3404-001,2013,5,29,17,600,507,1107,1165
3404-001,2013,5,29,18,785,418,1203,1107
3404-001,2013,5,29,19,721,355,1076,1203
3404-001,2013,5,29,20,545,315,860,1076
3404-001,2013,5,29,21,482,208,690,860
3404-001,2013,5,29,22,342,178,520,690
3404-001,2013,5,29,23,188,121,309,520
3404-001,2013,5,29,24,113,111,224,309
3404-001,2013,5,30,1,67,66,133,224
3404-001,2013,5,30,2,46,62,108,133
3404-001,2013,5,30,3,24,39,63,108
3404-001,2013,5,30,4,39,35,74,63
3404-001,2013,5,30,5,64,64,128,74
3404-001,2013,5,30,6,87,146,233,128
3404-001,2013,5,30,7,144,424,568,233
3404-001,2013,5,30,8,381,1192,1573,568
3404-001,2013,5,30,9,554,1043,1597,1573
3404-001,2013,5,30,10,541,589,1130,1597
3404-001,2013,5,30,11,525,563,1088,1130
3404-001,2013,5,30,12,534,550,1084,1088
3404-001,2013,5,30,13,472,451,923,1084
3404-001,2013,5,30,14,533,505,1038,923
3404-001,2013,5,30,15,617,537,1154,1038
3404-001,2013,5,30,16,608,513,1121,1154
3404-001,2013,5,30,17,590,487,1077,1121
3404-001,2013,5,30,18,833,434,1267,1077
3404-001,2013,5,30,19,768,367,1135,1267
3404-001,2013,5,30,20,643,347,990,1135
3404-001,2013,5,30,21,555,252,807,990
3404-001,2013,5,30,22,356,198,554,807
3404-001,2013,5,30,23,226,140,366,554
3404-001,2013,5,30,24,128,96,224,366
3404-001,2013,5,31,1,83,80,163,224
3404-001,2013,5,31,2,63,54,117,163
3404-001,2013,5,31,3,41,40,81,117
3404-001,2013,5,31,4,44,40,84,81
3404-001,2013,5,31,5,60,72,132,84
3404-001,2013,5,31,6,102,165,267,132
3404-001,2013,5,31,7,149,419,568,267
3404-001,2013,5,31,8,383,1158,1541,568
3404-001,2013,5,31,9,502,1058,1560,1541
3404-001,2013,5,31,10,537,566,1103,1560
3404-001,2013,5,31,11,525,555,1080,1103
3404-001,2013,5,31,12,509,479,988,1080
3404-001,2013,5,31,13,473,410,883,988
3404-001,2013,5,31,14,463,512,975,883
3404-001,2013,5,31,15,566,530,1096,975
3404-001,2013,5,31,16,651,568,1219,1096
3404-001,2013,5,31,17,668,467,1135,1219
3404-001,2013,5,31,18,852,444,1296,1135
3404-001,2013,5,31,19,968,498,1466,1296
3404-001,2013,5,31,20,666,361,1027,1466
3404-001,2013,5,31,21,491,263,754,1027
3404-001,2013,5,31,22,357,201,558,754
3404-001,2013,5,31,23,221,156,377,558
3404-001,2013,5,31,24,140,81,221,377
3404-001,2013,6,1,1,77,69,146,221
3404-001,2013,6,1,2,60,41,101,146
3404-001,2013,6,1,3,46,41,87,101
3404-001,2013,6,1,4,28,42,70,87
3404-001,2013,6,1,5,50,73,123,70
3404-001,2013,6,1,6,112,164,276,123
3404-001,2013,6,1,7,177,285,462,276
3404-001,2013,6,1,8,281,620,901,462
3404-001,2013,6,1,9,455,581,1036,901
3404-001,2013,6,1,10,423,498,921,1036
3404-001,2013,6,1,11,434,476,910,921
3404-001,2013,6,1,12,454,440,894,910
3404-001,2013,6,1,13,355,403,758,894
3404-001,2013,6,1,14,457,403,860,758
3404-001,2013,6,1,15,453,386,839,860
3404-001,2013,6,1,16,464,379,843,839
3404-001,2013,6,1,17,474,343,817,843
3404-001,2013,6,1,18,628,363,991,817
3404-001,2013,6,1,19,510,357,867,991
3404-001,2013,6,1,20,316,245,561,867
3404-001,2013,6,1,21,250,183,433,561
3404-001,2013,6,1,22,188,144,332,433
3404-001,2013,6,1,23,124,105,229,332
3404-001,2013,6,1,24,99,76,175,229
3404-001,2013,6,2,1,71,48,119,175
3404-001,2013,6,2,2,44,39,83,119
3404-001,2013,6,2,3,43,23,66,83
3404-001,2013,6,2,4,21,24,45,66
3404-001,2013,6,2,5,34,39,73,45
3404-001,2013,6,2,6,54,80,134,73
3404-001,2013,6,2,7,93,127,220,134
3404-001,2013,6,2,8,173,255,428,220
3404-001,2013,6,2,9,221,221,442,428
3404-001,2013,6,2,10,233,259,492,442
3404-001,2013,6,2,11,254,264,518,492
3404-001,2013,6,2,12,286,310,596,518
3404-001,2013,6,2,13,275,264,539,596
3404-001,2013,6,2,14,252,273,525,539
3404-001,2013,6,2,15,324,326,650,525
3404-001,2013,6,2,16,349,306,655,650
3404-001,2013,6,2,17,374,306,680,655
3404-001,2013,6,2,18,414,242,656,680
3404-001,2013,6,2,19,388,224,612,656
3404-001,2013,6,2,20,306,240,546,612
3404-001,2013,6,2,21,254,188,442,546
3404-001,2013,6,2,22,198,169,367,442
3404-001,2013,6,2,23,116,126,242,367
3404-001,2013,6,2,24,58,101,159,242
3404-001,2013,6,3,1,47,85,132,159
3404-001,2013,6,3,2,27,46,73,132
3404-001,2013,6,3,3,15,34,49,73
3404-001,2013,6,3,4,18,36,54,49
3404-001,2013,6,3,5,50,64,114,54
3404-001,2013,6,3,6,89,193,282,114
3404-001,2013,6,3,7,158,491,649,282
3404-001,2013,6,3,8,409,1417,1826,649
3404-001,2013,6,3,9,481,1163,1644,1826
3404-001,2013,6,3,10,488,587,1075,1644
3404-001,2013,6,3,11,557,570,1127,1075
3404-001,2013,6,3,12,526,522,1048,1127
3404-001,2013,6,3,13,471,450,921,1048
3404-001,2013,6,3,14,531,493,1024,921
3404-001,2013,6,3,15,586,595,1181,1024
3404-001,2013,6,3,16,652,539,1191,1181
3404-001,2013,6,3,17,618,491,1109,1191
3404-001,2013,6,3,18,750,477,1227,1109
3404-001,2013,6,3,19,720,402,1122,1227
3404-001,2013,6,3,20,642,295,937,1122
3404-001,2013,6,3,21,554,238,792,937
3404-001,2013,6,3,22,379,190,569,792
3404-001,2013,6,3,23,231,119,350,569
3404-001,2013,6,3,24,119,82,201,350
3404-001,2013,6,4,1,84,58,142,201
3404-001,2013,6,4,2,53,54,107,142
3404-001,2013,6,4,3,25,45,70,107
3404-001,2013,6,4,4,34,45,79,70
3404-001,2013,6,4,5,41,71,112,79
3404-001,2013,6,4,6,87,165,252,112
3404-001,2013,6,4,7,173,469,642,252
3404-001,2013,6,4,8,385,1236,1621,642
3404-001,2013,6,4,9,561,1102,1663,1621
3404-001,2013,6,4,10,589,641,1230,1663
3404-001,2013,6,4,11,534,590,1124,1230
3404-001,2013,6,4,12,589,497,1086,1124
3404-001,2013,6,4,13,443,485,928,1086
3404-001,2013,6,4,14,519,494,1013,928
3404-001,2013,6,4,15,607,555,1162,1013
3404-001,2013,6,4,16,723,566,1289,1162
3404-001,2013,6,4,17,652,494,1146,1289
3404-001,2013,6,4,18,813,431,1244,1146
3404-001,2013,6,4,19,811,381,1192,1244
3404-001,2013,6,4,20,601,336,937,1192
3404-001,2013,6,4,21,602,240,842,937
3404-001,2013,6,4,22,366,186,552,842
3404-001,2013,6,4,23,226,132,358,552
3404-001,2013,6,4,24,106,105,211,358
3404-001,2013,6,5,1,84,62,146,211
3404-001,2013,6,5,2,58,61,119,146
3404-001,2013,6,5,3,34,46,80,119
3404-001,2013,6,5,4,37,41,78,80
3404-001,2013,6,5,5,41,72,113,78
3404-001,2013,6,5,6,90,142,232,113
3404-001,2013,6,5,7,143,417,560,232
3404-001,2013,6,5,8,393,1215,1608,560
3404-001,2013,6,5,9,542,1063,1605,1608
3404-001,2013,6,5,10,515,590,1105,1605
3404-001,2013,6,5,11,573,585,1158,1105
3404-001,2013,6,5,12,548,514,1062,1158
3404-001,2013,6,5,13,485,487,972,1062
3404-001,2013,6,5,14,540,546,1086,972
3404-001,2013,6,5,15,644,566,1210,1086
3404-001,2013,6,5,16,648,516,1164,1210
3404-001,2013,6,5,17,615,495,1110,1164
3404-001,2013,6,5,18,976,516,1492,1110
3404-001,2013,6,5,19,890,419,1309,1492
3404-001,2013,6,5,20,622,411,1033,1309
3404-001,2013,6,5,21,559,255,814,1033
3404-001,2013,6,5,22,390,221,611,814
3404-001,2013,6,5,23,238,137,375,611
3404-001,2013,6,5,24,121,110,231,375
3404-001,2013,6,6,1,100,63,163,231
3404-001,2013,6,6,2,67,55,122,163
3404-001,2013,6,6,3,49,43,92,122
3404-001,2013,6,6,4,39,39,78,92
3404-001,2013,6,6,5,60,61,121,78
3404-001,2013,6,6,6,85,185,270,121
3404-001,2013,6,6,7,152,296,448,270
3404-001,2013,6,6,8,256,652,908,448
3404-001,2013,6,6,9,354,684,1038,908
3404-001,2013,6,6,10,390,462,852,1038
3404-001,2013,6,6,11,375,483,858,852
3404-001,2013,6,6,12,425,409,834,858
3404-001,2013,6,6,13,378,366,744,834
3404-001,2013,6,6,14,398,417,815,744
3404-001,2013,6,6,15,402,374,776,815
3404-001,2013,6,6,16,477,332,809,776
3404-001,2013,6,6,17,486,316,802,809
3404-001,2013,6,6,18,661,322,983,802
3404-001,2013,6,6,19,491,299,790,983
3404-001,2013,6,6,20,358,237,595,790
3404-001,2013,6,6,21,341,208,549,595
3404-001,2013,6,6,22,239,179,418,549
3404-001,2013,6,6,23,147,123,270,418
3404-001,2013,6,6,24,69,81,150,270
3404-001,2013,6,7,1,56,46,102,150
3404-001,2013,6,7,2,50,37,87,102
3404-001,2013,6,7,3,35,39,74,87
3404-001,2013,6,7,4,28,41,69,74
3404-001,2013,6,7,5,43,79,122,69
3404-001,2013,6,7,6,86,153,239,122
3404-001,2013,6,7,7,154,470,624,239
3404-001,2013,6,7,8,385,1145,1530,624
3404-001,2013,6,7,9,503,1032,1535,1530
3404-001,2013,6,7,10,539,546,1085,1535
3404-001,2013,6,7,11,518,548,1066,1085
3404-001,2013,6,7,12,550,499,1049,1066
3404-001,2013,6,7,13,493,455,948,1049
3404-001,2013,6,7,14,526,540,1066,948
3404-001,2013,6,7,15,578,561,1139,1066
3404-001,2013,6,7,16,654,551,1205,1139
3404-001,2013,6,7,17,633,517,1150,1205
3404-001,2013,6,7,18,845,478,1323,1150
3404-001,2013,6,7,19,883,431,1314,1323
3404-001,2013,6,7,20,663,365,1028,1314
3404-001,2013,6,7,21,488,295,783,1028
3404-001,2013,6,7,22,364,197,561,783
3404-001,2013,6,7,23,227,152,379,561
3404-001,2013,6,7,24,123,104,227,379
3404-001,2013,6,8,1,98,64,162,227
3404-001,2013,6,8,2,67,38,105,162
3404-001,2013,6,8,3,38,45,83,105
3404-001,2013,6,8,4,25,40,65,83
3404-001,2013,6,8,5,52,58,110,65
3404-001,2013,6,8,6,104,170,274,110
3404-001,2013,6,8,7,173,306,479,274
3404-001,2013,6,8,8,257,544,801,479
3404-001,2013,6,8,9,395,631,1026,801
3404-001,2013,6,8,10,434,514,948,1026
3404-001,2013,6,8,11,477,459,936,948
3404-001,2013,6,8,12,407,470,877,936
3404-001,2013,6,8,13,407,359,766,877
3404-001,2013,6,8,14,363,398,761,766
3404-001,2013,6,8,15,423,392,815,761
3404-001,2013,6,8,16,409,312,721,815
3404-001,2013,6,8,17,455,309,764,721
3404-001,2013,6,8,18,589,375,964,764
3404-001,2013,6,8,19,516,342,858,964
3404-001,2013,6,8,20,311,258,569,858
3404-001,2013,6,8,21,234,200,434,569
3404-001,2013,6,8,22,205,145,350,434
3404-001,2013,6,8,23,126,104,230,350
3404-001,2013,6,8,24,82,79,161,230
3404-001,2013,6,9,1,65,58,123,161
3404-001,2013,6,9,2,51,29,80,123
3404-001,2013,6,9,3,36,33,69,80
3404-001,2013,6,9,4,22,30,52,69
3404-001,2013,6,9,5,30,39,69,52
3404-001,2013,6,9,6,46,90,136,69
3404-001,2013,6,9,7,81,154,235,136
3404-001,2013,6,9,8,144,241,385,235
3404-001,2013,6,9,9,200,275,475,385
3404-001,2013,6,9,10,202,263,465,475
3404-001,2013,6,9,11,231,267,498,465
3404-001,2013,6,9,12,225,251,476,498
3404-001,2013,6,9,13,256,253,509,476
3404-001,2013,6,9,14,305,251,556,509
3404-001,2013,6,9,15,298,250,548,556
3404-001,2013,6,9,16,354,278,632,548
3404-001,2013,6,9,17,353,250,603,632
3404-001,2013,6,9,18,447,228,675,603
3404-001,2013,6,9,19,388,265,653,675
3404-001,2013,6,9,20,275,213,488,653
3404-001,2013,6,9,21,244,185,429,488
3404-001,2013,6,9,22,202,184,386,429
3404-001,2013,6,9,23,118,133,251,386
3404-001,2013,6,9,24,62,104,166,251
3404-001,2013,6,10,1,37,71,108,166
3404-001,2013,6,10,2,24,47,71,108
3404-001,2013,6,10,3,20,39,59,71
3404-001,2013,6,10,4,32,44,76,59
3404-001,2013,6,10,5,48,75,123,76
3404-001,2013,6,10,6,85,174,259,123
3404-001,2013,6,10,7,190,503,693,259
3404-001,2013,6,10,8,383,1368,1751,693
3404-001,2013,6,10,9,472,1143,1615,1751
3404-001,2013,6,10,10,514,574,1088,1615
3404-001,2013,6,10,11,530,543,1073,1088
3404-001,2013,6,10,12,533,510,1043,1073
3404-001,2013,6,10,13,506,464,970,1043
3404-001,2013,6,10,14,500,514,1014,970
3404-001,2013,6,10,15,550,566,1116,1014
3404-001,2013,6,10,16,610,526,1136,1116
3404-001,2013,6,10,17,631,493,1124,1136
3404-001,2013,6,10,18,751,491,1242,1124
3404-001,2013,6,10,19,790,419,1209,1242
3404-001,2013,6,10,20,591,335,926,1209
3404-001,2013,6,10,21,609,248,857,926
3404-001,2013,6,10,22,376,186,562,857
3404-001,2013,6,10,23,212,135,347,562
3404-001,2013,6,10,24,140,102,242,347
3404-001,2013,6,11,1,90,56,146,242
3404-001,2013,6,11,2,60,51,111,146
3404-001,2013,6,11,3,35,51,86,111
3404-001,2013,6,11,4,30,44,74,86
3404-001,2013,6,11,5,63,72,135,74
3404-001,2013,6,11,6,86,164,250,135
3404-001,2013,6,11,7,187,420,607,250
3404-001,2013,6,11,8,389,1167,1556,607
3404-001,2013,6,11,9,584,1089,1673,1556
3404-001,2013,6,11,10,565,604,1169,1673
3404-001,2013,6,11,11,549,562,1111,1169
3404-001,2013,6,11,12,552,518,1070,1111
3404-001,2013,6,11,13,480,474,954,1070
3404-001,2013,6,11,14,513,508,1021,954
3404-001,2013,6,11,15,606,554,1160,1021
3404-001,2013,6,11,16,632,522,1154,1160
3404-001,2013,6,11,17,645,453,1098,1154
3404-001,2013,6,11,18,739,447,1186,1098
3404-001,2013,6,11,19,799,380,1179,1186
3404-001,2013,6,11,20,626,314,940,1179
3404-001,2013,6,11,21,493,245,738,940
3404-001,2013,6,11,22,319,158,477,738
3404-001,2013,6,11,23,217,124,341,477
3404-001,2013,6,11,24,119,66,185,341
3404-001,2013,6,12,1,85,53,138,185
3404-001,2013,6,12,2,38,43,81,138
3404-001,2013,6,12,3,34,47,81,81
3404-001,2013,6,12,4,24,32,56,81
3404-001,2013,6,12,5,48,75,123,56
3404-001,2013,6,12,6,82,124,206,123
3404-001,2013,6,12,7,135,338,473,206
3404-001,2013,6,12,8,337,1138,1475,473
3404-001,2013,6,12,9,566,1055,1621,1475
3404-001,2013,6,12,10,521,549,1070,1621
3404-001,2013,6,12,11,472,564,1036,1070
3404-001,2013,6,12,12,544,480,1024,1036
3404-001,2013,6,12,13,484,451,935,1024
3404-001,2013,6,12,14,504,481,985,935
3404-001,2013,6,12,15,568,558,1126,985
3404-001,2013,6,12,16,587,491,1078,1126
3404-001,2013,6,12,17,624,477,1101,1078
3404-001,2013,6,12,18,777,461,1238,1101
3404-001,2013,6,12,19,778,359,1137,1238
3404-001,2013,6,12,20,545,281,826,1137
3404-001,2013,6,12,21,491,238,729,826
3404-001,2013,6,12,22,349,164,513,729
3404-001,2013,6,12,23,206,138,344,513
3404-001,2013,6,12,24,117,102,219,344
3404-001,2013,6,13,1,86,63,149,219
3404-001,2013,6,13,2,59,46,105,149
3404-001,2013,6,13,3,37,43,80,105
3404-001,2013,6,13,4,32,33,65,80
3404-001,2013,6,13,5,59,67,126,65
3404-001,2013,6,13,6,102,159,261,126
3404-001,2013,6,13,7,141,464,605,261
3404-001,2013,6,13,8,377,1183,1560,605
3404-001,2013,6,13,9,571,1101,1672,1560
3404-001,2013,6,13,10,555,601,1156,1672
3404-001,2013,6,13,11,546,614,1160,1156
3404-001,2013,6,13,12,544,548,1092,1160
3404-001,2013,6,13,13,495,455,950,1092
3404-001,2013,6,13,14,516,525,1041,950
3404-001,2013,6,13,15,555,549,1104,1041
3404-001,2013,6,13,16,662,597,1259,1104
3404-001,2013,6,13,17,643,476,1119,1259
3404-001,2013,6,13,18,790,460,1250,1119
3404-001,2013,6,13,19,773,409,1182,1250
3404-001,2013,6,13,20,582,319,901,1182
3404-001,2013,6,13,21,530,247,777,901
3404-001,2013,6,13,22,360,215,575,777
3404-001,2013,6,13,23,230,158,388,575
3404-001,2013,6,13,24,141,91,232,388
3404-001,2013,6,14,1,81,74,155,232
3404-001,2013,6,14,2,53,56,109,155
3404-001,2013,6,14,3,38,39,77,109
3404-001,2013,6,14,4,40,60,100,77
3404-001,2013,6,14,5,57,86,143,100
3404-001,2013,6,14,6,113,169,282,143
3404-001,2013,6,14,7,191,473,664,282
3404-001,2013,6,14,8,397,1217,1614,664
3404-001,2013,6,14,9,535,1054,1589,1614
3404-001,2013,6,14,10,527,558,1085,1589
3404-001,2013,6,14,11,583,591,1174,1085
3404-001,2013,6,14,12,593,511,1104,1174
3404-001,2013,6,14,13,471,449,920,1104
3404-001,2013,6,14,14,569,554,1123,920
3404-001,2013,6,14,15,634,628,1262,1123
3404-001,2013,6,14,16,598,564,1162,1262
3404-001,2013,6,14,17,672,495,1167,1162
3404-001,2013,6,14,18,944,497,1441,1167
3404-001,2013,6,14,19,927,444,1371,1441
3404-001,2013,6,14,20,686,359,1045,1371
3404-001,2013,6,14,21,560,245,805,1045
3404-001,2013,6,14,22,365,203,568,805
3404-001,2013,6,14,23,212,137,349,568
3404-001,2013,6,14,24,119,119,238,349
3404-001,2013,6,15,1,69,81,150,238
3404-001,2013,6,15,2,63,59,122,150
3404-001,2013,6,15,3,40,47,87,122
3404-001,2013,6,15,4,38,49,87,87
3404-001,2013,6,15,5,67,67,134,87
3404-001,2013,6,15,6,105,189,294,134
3404-001,2013,6,15,7,188,326,514,294
3404-001,2013,6,15,8,288,630,918,514
3404-001,2013,6,15,9,430,570,1000,918
3404-001,2013,6,15,10,456,481,937,1000
3404-001,2013,6,15,11,453,453,906,937
3404-001,2013,6,15,12,411,452,863,906
3404-001,2013,6,15,13,415,351,766,863
3404-001,2013,6,15,14,434,380,814,766
3404-001,2013,6,15,15,420,403,823,814
3404-001,2013,6,15,16,474,358,832,823
3404-001,2013,6,15,17,534,359,893,832
3404-001,2013,6,15,18,625,367,992,893
3404-001,2013,6,15,19,495,305,800,992
3404-001,2013,6,15,20,349,254,603,800
3404-001,2013,6,15,21,275,193,468,603
3404-001,2013,6,15,22,169,163,332,468
3404-001,2013,6,15,23,139,104,243,332
3404-001,2013,6,15,24,92,66,158,243
3404-001,2013,6,16,1,50,61,111,158
3404-001,2013,6,16,2,39,28,67,111
3404-001,2013,6,16,3,33,34,67,67
3404-001,2013,6,16,4,31,25,56,67
3404-001,2013,6,16,5,19,41,60,56
3404-001,2013,6,16,6,52,92,144,60
3404-001,2013,6,16,7,92,153,245,144
3404-001,2013,6,16,8,146,249,395,245
3404-001,2013,6,16,9,176,266,442,395
3404-001,2013,6,16,10,194,238,432,442
3404-001,2013,6,16,11,220,241,461,432
3404-001,2013,6,16,12,217,248,465,461
3404-001,2013,6,16,13,255,199,454,465
3404-001,2013,6,16,14,285,271,556,454
3404-001,2013,6,16,15,300,223,523,556
3404-001,2013,6,16,16,367,251,618,523
3404-001,2013,6,16,17,315,279,594,618
3404-001,2013,6,16,18,419,251,670,594
3404-001,2013,6,16,19,377,229,606,670
3404-001,2013,6,16,20,318,206,524,606
3404-001,2013,6,16,21,255,212,467,524
3404-001,2013,6,16,22,180,233,413,467
3404-001,2013,6,16,23,108,149,257,413
3404-001,2013,6,16,24,80,104,184,257
3404-001,2013,6,17,1,42,57,99,184
3404-001,2013,6,17,2,24,70,94,99
3404-001,2013,6,17,3,21,36,57,94
3404-001,2013,6,17,4,29,40,69,57
3404-001,2013,6,17,5,46,77,123,69
3404-001,2013,6,17,6,111,199,310,123
3404-001,2013,6,17,7,182,534,716,310
3404-001,2013,6,17,8,406,1418,1824,716
3404-001,2013,6,17,9,498,1091,1589,1824
3404-001,2013,6,17,10,484,575,1059,1589
3404-001,2013,6,17,11,557,550,1107,1059
3404-001,2013,6,17,12,491,513,1004,1107
3404-001,2013,6,17,13,463,472,935,1004
3404-001,2013,6,17,14,494,547,1041,935
3404-001,2013,6,17,15,605,527,1132,1041
3404-001,2013,6,17,16,653,536,1189,1132
3404-001,2013,6,17,17,587,440,1027,1189
3404-001,2013,6,17,18,793,441,1234,1027
3404-001,2013,6,17,19,768,364,1132,1234
3404-001,2013,6,17,20,583,318,901,1132
3404-001,2013,6,17,21,537,246,783,901
3404-001,2013,6,17,22,357,181,538,783
3404-001,2013,6,17,23,196,118,314,538
3404-001,2013,6,17,24,102,87,189,314
3404-001,2013,6,18,1,75,58,133,189
3404-001,2013,6,18,2,54,50,104,133
3404-001,2013,6,18,3,42,37,79,104
3404-001,2013,6,18,4,37,37,74,79
3404-001,2013,6,18,5,46,63,109,74
3404-001,2013,6,18,6,63,111,174,109
3404-001,2013,6,18,7,140,360,500,174
3404-001,2013,6,18,8,357,1125,1482,500
3404-001,2013,6,18,9,517,1016,1533,1482
3404-001,2013,6,18,10,483,567,1050,1533
3404-001,2013,6,18,11,554,516,1070,1050
3404-001,2013,6,18,12,497,481,978,1070
3404-001,2013,6,18,13,453,456,909,978
3404-001,2013,6,18,14,448,469,917,909
3404-001,2013,6,18,15,558,496,1054,917
3404-001,2013,6,18,16,577,422,999,1054
3404-001,2013,6,18,17,547,441,988,999
3404-001,2013,6,18,18,728,390,1118,988
3404-001,2013,6,18,19,699,310,1009,1118
3404-001,2013,6,18,20,513,302,815,1009
3404-001,2013,6,18,21,480,208,688,815
3404-001,2013,6,18,22,316,142,458,688
3404-001,2013,6,18,23,164,105,269,458
3404-001,2013,6,18,24,86,89,175,269
3404-001,2013,6,19,1,72,64,136,175
3404-001,2013,6,19,2,38,37,75,136
3404-001,2013,6,19,3,33,27,60,75
3404-001,2013,6,19,4,34,32,66,60
3404-001,2013,6,19,5,48,68,116,66
3404-001,2013,6,19,6,91,151,242,116
3404-001,2013,6,19,7,129,417,546,242
3404-001,2013,6,19,8,378,1189,1567,546
3404-001,2013,6,19,9,525,1025,1550,1567
3404-001,2013,6,19,10,547,578,1125,1550
3404-001,2013,6,19,11,543,569,1112,1125
3404-001,2013,6,19,12,523,481,1004,1112
3404-001,2013,6,19,13,440,456,896,1004
3404-001,2013,6,19,14,514,561,1075,896
3404-001,2013,6,19,15,646,544,1190,1075
3404-001,2013,6,19,16,613,586,1199,1190
3404-001,2013,6,19,17,603,453,1056,1199
3404-001,2013,6,19,18,871,427,1298,1056
3404-001,2013,6,19,19,862,371,1233,1298
3404-001,2013,6,19,20,536,348,884,1233
3404-001,2013,6,19,21,489,232,721,884
3404-001,2013,6,19,22,371,185,556,721
3404-001,2013,6,19,23,221,144,365,556
3404-001,2013,6,19,24,112,90,202,365
3404-001,2013,6,20,1,86,59,145,202
3404-001,2013,6,20,2,49,58,107,145
3404-001,2013,6,20,3,36,41,77,107
3404-001,2013,6,20,4,28,34,62,77
3404-001,2013,6,20,5,58,98,156,62
3404-001,2013,6,20,6,103,175,278,156
3404-001,2013,6,20,7,160,434,594,278
3404-001,2013,6,20,8,401,1223,1624,594
3404-001,2013,6,20,9,547,1097,1644,1624
3404-001,2013,6,20,10,527,593,1120,1644
3404-001,2013,6,20,11,566,594,1160,1120
3404-001,2013,6,20,12,544,548,1092,1160
3404-001,2013,6,20,13,474,429,903,1092
3404-001,2013,6,20,14,543,526,1069,903
3404-001,2013,6,20,15,580,586,1166,1069
3404-001,2013,6,20,16,639,512,1151,1166
3404-001,2013,6,20,17,608,454,1062,1151
3404-001,2013,6,20,18,741,455,1196,1062
3404-001,2013,6,20,19,798,361,1159,1196
3404-001,2013,6,20,20,586,339,925,1159
3404-001,2013,6,20,21,559,225,784,925
3404-001,2013,6,20,22,369,184,553,784
3404-001,2013,6,20,23,204,155,359,553
3404-001,2013,6,20,24,117,113,230,359
3404-001,2013,6,21,1,79,77,156,230
3404-001,2013,6,21,2,46,58,104,156
3404-001,2013,6,21,3,34,49,83,104
3404-001,2013,6,21,4,46,54,100,83
3404-001,2013,6,21,5,56,79,135,100
3404-001,2013,6,21,6,111,181,292,135
3404-001,2013,6,21,7,152,447,599,292
3404-001,2013,6,21,8,391,1230,1621,599
3404-001,2013,6,21,9,569,1080,1649,1621
3404-001,2013,6,21,10,556,650,1206,1649
3404-001,2013,6,21,11,564,549,1113,1206
3404-001,2013,6,21,12,568,528,1096,1113
3404-001,2013,6,21,13,488,453,941,1096
3404-001,2013,6,21,14,532,528,1060,941
3404-001,2013,6,21,15,622,555,1177,1060
3404-001,2013,6,21,16,628,506,1134,1177
3404-001,2013,6,21,17,675,521,1196,1134
3404-001,2013,6,21,18,925,500,1425,1196
3404-001,2013,6,21,19,969,490,1459,1425
3404-001,2013,6,21,20,686,385,1071,1459
3404-001,2013,6,21,21,596,281,877,1071
3404-001,2013,6,21,22,377,178,555,877
3404-001,2013,6,21,23,218,149,367,555
3404-001,2013,6,21,24,117,106,223,367
3404-001,2013,6,22,1,87,78,165,223
3404-001,2013,6,22,2,52,65,117,165
3404-001,2013,6,22,3,54,37,91,117
3404-001,2013,6,22,4,39,49,88,91
3404-001,2013,6,22,5,55,74,129,88
3404-001,2013,6,22,6,104,186,290,129
3404-001,2013,6,22,7,174,327,501,290
3404-001,2013,6,22,8,265,647,912,501
3404-001,2013,6,22,9,423,587,1010,912
3404-001,2013,6,22,10,452,473,925,1010
3404-001,2013,6,22,11,501,471,972,925
3404-001,2013,6,22,12,425,467,892,972
3404-001,2013,6,22,13,422,404,826,892
3404-001,2013,6,22,14,433,410,843,826
3404-001,2013,6,22,15,461,417,878,843
3404-001,2013,6,22,16,494,375,869,878
3404-001,2013,6,22,17,505,359,864,869
3404-001,2013,6,22,18,669,402,1071,864
3404-001,2013,6,22,19,513,328,841,1071
3404-001,2013,6,22,20,331,237,568,841
3404-001,2013,6,22,21,269,202,471,568
3404-001,2013,6,22,22,211,154,365,471
3404-001,2013,6,22,23,134,115,249,365
3404-001,2013,6,22,24,96,63,159,249
3404-001,2013,6,23,1,83,57,140,159
3404-001,2013,6,23,2,62,34,96,140
3404-001,2013,6,23,3,40,19,59,96
3404-001,2013,6,23,4,23,22,45,59
3404-001,2013,6,23,5,29,40,69,45
3404-001,2013,6,23,6,54,93,147,69
3404-001,2013,6,23,7,94,138,232,147
3404-001,2013,6,23,8,130,265,395,232
3404-001,2013,6,23,9,200,272,472,395
3404-001,2013,6,23,10,177,225,402,472
3404-001,2013,6,23,11,239,248,487,402
3404-001,2013,6,23,12,228,256,484,487
3404-001,2013,6,23,13,256,271,527,484
3404-001,2013,6,23,14,245,257,502,527
3404-001,2013,6,23,15,320,249,569,502
3404-001,2013,6,23,16,348,264,612,569
3404-001,2013,6,23,17,396,260,656,612
3404-001,2013,6,23,18,433,257,690,656
3404-001,2013,6,23,19,390,283,673,690
3404-001,2013,6,23,20,271,202,473,673
3404-001,2013,6,23,21,251,207,458,473
3404-001,2013,6,23,22,183,176,359,458
3404-001,2013,6,23,23,113,120,233,359
3404-001,2013,6,23,24,76,101,177,233
3404-001,2013,6,24,1,47,58,105,177
3404-001,2013,6,24,2,18,37,55,105
3404-001,2013,6,24,3,18,37,55,55
3404-001,2013,6,24,4,27,27,54,55
3404-001,2013,6,24,5,53,79,132,54
3404-001,2013,6,24,6,91,202,293,132
3404-001,2013,6,24,7,190,557,747,293
3404-001,2013,6,24,8,389,1386,1775,747
3404-001,2013,6,24,9,478,1147,1625,1775
3404-001,2013,6,24,10,493,562,1055,1625
3404-001,2013,6,24,11,478,540,1018,1055
3404-001,2013,6,24,12,518,544,1062,1018
3404-001,2013,6,24,13,461,446,907,1062
3404-001,2013,6,24,14,488,531,1019,907
3404-001,2013,6,24,15,585,532,1117,1019
3404-001,2013,6,24,16,581,500,1081,1117
3404-001,2013,6,24,17,650,448,1098,1081
3404-001,2013,6,24,18,766,432,1198,1098
3404-001,2013,6,24,19,813,356,1169,1198
3404-001,2013,6,24,20,584,309,893,1169
3404-001,2013,6,24,21,532,241,773,893
3404-001,2013,6,24,22,403,169,572,773
3404-001,2013,6,24,23,245,127,372,572
3404-001,2013,6,24,24,100,84,184,372
3404-001,2013,6,25,1,85,69,154,184
3404-001,2013,6,25,2,56,64,120,154
3404-001,2013,6,25,3,34,37,71,120
3404-001,2013,6,25,4,43,43,86,71
3404-001,2013,6,25,5,51,81,132,86
3404-001,2013,6,25,6,107,215,322,132
3404-001,2013,6,25,7,165,453,618,322
3404-001,2013,6,25,8,397,1253,1650,618
3404-001,2013,6,25,9,581,1045,1626,1650
3404-001,2013,6,25,10,531,558,1089,1626
3404-001,2013,6,25,11,517,566,1083,1089
3404-001,2013,6,25,12,552,508,1060,1083
3404-001,2013,6,25,13,490,440,930,1060
3404-001,2013,6,25,14,499,520,1019,930
3404-001,2013,6,25,15,613,570,1183,1019
3404-001,2013,6,25,16,614,494,1108,1183
3404-001,2013,6,25,17,658,426,1084,1108
3404-001,2013,6,25,18,797,471,1268,1084
3404-001,2013,6,25,19,766,354,1120,1268
3404-001,2013,6,25,20,530,322,852,1120
3404-001,2013,6,25,21,537,233,770,852
3404-001,2013,6,25,22,346,188,534,770
3404-001,2013,6,25,23,206,122,328,534
3404-001,2013,6,25,24,128,97,225,328
3404-001,2013,6,26,1,71,52,123,225
3404-001,2013,6,26,2,60,56,116,123
3404-001,2013,6,26,3,30,28,58,116
3404-001,2013,6,26,4,38,39,77,58
3404-001,2013,6,26,5,48,80,128,77
3404-001,2013,6,26,6,112,149,261,128
3404-001,2013,6,26,7,157,437,594,261
3404-001,2013,6,26,8,418,1229,1647,594
3404-001,2013,6,26,9,525,1052,1577,1647
3404-001,2013,6,26,10,513,559,1072,1577
3404-001,2013,6,26,11,497,551,1048,1072
3404-001,2013,6,26,12,544,557,1101,1048
3404-001,2013,6,26,13,488,416,904,1101
3404-001,2013,6,26,14,525,532,1057,904
3404-001,2013,6,26,15,631,528,1159,1057
3404-001,2013,6,26,16,586,488,1074,1159
3404-001,2013,6,26,17,608,462,1070,1074
3404-001,2013,6,26,18,786,462,1248,1070
3404-001,2013,6,26,19,791,369,1160,1248
3404-001,2013,6,26,20,557,332,889,1160
3404-001,2013,6,26,21,535,253,788,889
3404-001,2013,6,26,22,335,197,532,788
3404-001,2013,6,26,23,237,139,376,532
3404-001,2013,6,26,24,107,111,218,376
3404-001,2013,6,27,1,82,69,151,218
3404-001,2013,6,27,2,51,56,107,151
3404-001,2013,6,27,3,44,44,88,107
3404-001,2013,6,27,4,42,41,83,88
3404-001,2013,6,27,5,46,74,120,83
3404-001,2013,6,27,6,94,196,290,120
3404-001,2013,6,27,7,162,470,632,290
3404-001,2013,6,27,8,431,1282,1713,632
3404-001,2013,6,27,9,567,1013,1580,1713
3404-001,2013,6,27,10,581,589,1170,1580
3404-001,2013,6,27,11,542,605,1147,1170
3404-001,2013,6,27,12,502,533,1035,1147
3404-001,2013,6,27,13,487,403,890,1035
3404-001,2013,6,27,14,492,524,1016,890
3404-001,2013,6,27,15,633,553,1186,1016
3404-001,2013,6,27,16,605,523,1128,1186
3404-001,2013,6,27,17,633,487,1120,1128
3404-001,2013,6,27,18,779,452,1231,1120
3404-001,2013,6,27,19,819,377,1196,1231
3404-001,2013,6,27,20,585,326,911,1196
3404-001,2013,6,27,21,539,227,766,911
3404-001,2013,6,27,22,378,184,562,766
3404-001,2013,6,27,23,191,134,325,562
3404-001,2013,6,27,24,142,85,227,325
3404-001,2013,6,28,1,84,75,159,227
3404-001,2013,6,28,2,59,45,104,159
3404-001,2013,6,28,3,47,41,88,104
3404-001,2013,6,28,4,33,41,74,88
3404-001,2013,6,28,5,59,103,162,74
3404-001,2013,6,28,6,105,194,299,162
3404-001,2013,6,28,7,173,448,621,299
3404-001,2013,6,28,8,371,1281,1652,621
3404-001,2013,6,28,9,533,1046,1579,1652
3404-001,2013,6,28,10,604,589,1193,1579
3404-001,2013,6,28,11,548,546,1094,1193
3404-001,2013,6,28,12,563,533,1096,1094
3404-001,2013,6,28,13,488,459,947,1096
3404-001,2013,6,28,14,549,478,1027,947
3404-001,2013,6,28,15,595,577,1172,1027
3404-001,2013,6,28,16,615,546,1161,1172
3404-001,2013,6,28,17,671,473,1144,1161
3404-001,2013,6,28,18,914,459,1373,1144
3404-001,2013,6,28,19,904,438,1342,1373
3404-001,2013,6,28,20,683,371,1054,1342
3404-001,2013,6,28,21,581,251,832,1054
3404-001,2013,6,28,22,394,190,584,832
3404-001,2013,6,28,23,229,182,411,584
3404-001,2013,6,28,24,123,126,249,411
3404-001,2013,6,29,1,101,78,179,249
3404-001,2013,6,29,2,52,66,118,179
3404-001,2013,6,29,3,49,53,102,118
3404-001,2013,6,29,4,49,38,87,102
3404-001,2013,6,29,5,69,88,157,87
3404-001,2013,6,29,6,97,226,323,157
3404-001,2013,6,29,7,182,309,491,323
3404-001,2013,6,29,8,287,640,927,491
3404-001,2013,6,29,9,417,629,1046,927
3404-001,2013,6,29,10,428,442,870,1046
3404-001,2013,6,29,11,440,489,929,870
3404-001,2013,6,29,12,384,434,818,929
3404-001,2013,6,29,13,394,383,777,818
3404-001,2013,6,29,14,427,405,832,777
3404-001,2013,6,29,15,445,376,821,832
3404-001,2013,6,29,16,480,390,870,821
3404-001,2013,6,29,17,485,339,824,870
3404-001,2013,6,29,18,584,342,926,824
3404-001,2013,6,29,19,458,335,793,926
3404-001,2013,6,29,20,350,254,604,793
3404-001,2013,6,29,21,287,209,496,604
3404-001,2013,6,29,22,205,159,364,496
3404-001,2013,6,29,23,158,103,261,364
3404-001,2013,6,29,24,98,74,172,261
3404-001,2013,6,30,1,67,59,126,172
3404-001,2013,6,30,2,51,31,82,126
3404-001,2013,6,30,3,37,27,64,82
3404-001,2013,6,30,4,27,24,51,64
3404-001,2013,6,30,5,24,41,65,51
3404-001,2013,6,30,6,53,93,146,65
3404-001,2013,6,30,7,93,146,239,146
3404-001,2013,6,30,8,138,257,395,239
3404-001,2013,6,30,9,188,269,457,395
3404-001,2013,6,30,10,186,232,418,457
3404-001,2013,6,30,11,230,245,475,418
3404-001,2013,6,30,12,223,252,475,475
3404-001,2013,6,30,13,256,235,491,475
3404-001,2013,6,30,14,265,264,529,491
3404-001,2013,6,30,15,310,236,546,529
3404-001,2013,6,30,16,358,258,616,546
3404-001,2013,6,30,17,356,270,626,616
3404-001,2013,6,30,18,426,254,680,626
3404-001,2013,6,30,19,384,256,640,680
3404-001,2013,6,30,20,295,204,499,640
3404-001,2013,6,30,21,253,210,463,499
3404-001,2013,6,30,22,182,205,387,463
3404-001,2013,6,30,23,111,135,246,387
3404-001,2013,6,30,24,78,103,181,246
3404-001,2013,7,1,1,46,76,122,181
3404-001,2013,7,1,2,22,65,87,122
3404-001,2013,7,1,3,31,45,76,87
3404-001,2013,7,1,4,27,34,61,76
3404-001,2013,7,1,5,54,89,143,61
3404-001,2013,7,1,6,85,215,300,143
3404-001,2013,7,1,7,197,520,717,300
3404-001,2013,7,1,8,423,1453,1876,717
3404-001,2013,7,1,9,435,1091,1526,1876
3404-001,2013,7,1,10,475,528,1003,1526
3404-001,2013,7,1,11,482,574,1056,1003
3404-001,2013,7,1,12,545,477,1022,1056
3404-001,2013,7,1,13,467,439,906,1022
3404-001,2013,7,1,14,449,486,935,906
3404-001,2013,7,1,15,571,560,1131,935
3404-001,2013,7,1,16,574,532,1106,1131
3404-001,2013,7,1,17,615,446,1061,1106
3404-001,2013,7,1,18,727,449,1176,1061
3404-001,2013,7,1,19,763,395,1158,1176
3404-001,2013,7,1,20,644,313,957,1158
3404-001,2013,7,1,21,596,236,832,957
3404-001,2013,7,1,22,353,189,542,832
3404-001,2013,7,1,23,233,131,364,542
3404-001,2013,7,1,24,106,101,207,364
3404-001,2013,7,2,1,93,77,170,207
3404-001,2013,7,2,2,35,50,85,170
3404-001,2013,7,2,3,26,35,61,85
3404-001,2013,7,2,4,38,38,76,61
3404-001,2013,7,2,5,48,80,128,76
3404-001,2013,7,2,6,71,131,202,128
3404-001,2013,7,2,7,135,362,497,202
3404-001,2013,7,2,8,364,1174,1538,497
3404-001,2013,7,2,9,533,1020,1553,1538
3404-001,2013,7,2,10,447,567,1014,1553
3404-001,2013,7,2,11,536,548,1084,1014
3404-001,2013,7,2,12,522,498,1020,1084
3404-001,2013,7,2,13,445,381,826,1020
3404-001,2013,7,2,14,432,493,925,826
3404-001,2013,7,2,15,579,522,1101,925
3404-001,2013,7,2,16,578,502,1080,1101
3404-001,2013,7,2,17,620,428,1048,1080
3404-001,2013,7,2,18,661,406,1067,1048
3404-001,2013,7,2,19,729,336,1065,1067
3404-001,2013,7,2,20,545,280,825,1065
3404-001,2013,7,2,21,516,213,729,825
3404-001,2013,7,2,22,326,151,477,729
3404-001,2013,7,2,23,194,116,310,477
3404-001,2013,7,2,24,103,76,179,310
3404-001,2013,7,3,1,68,64,132,179
3404-001,2013,7,3,2,47,48,95,132
3404-001,2013,7,3,3,38,41,79,95
3404-001,2013,7,3,4,35,28,63,79
3404-001,2013,7,3,5,51,91,142,63
3404-001,2013,7,3,6,74,136,210,142
3404-001,2013,7,3,7,117,385,502,210
3404-001,2013,7,3,8,369,1189,1558,502
3404-001,2013,7,3,9,487,1005,1492,1558
3404-001,2013,7,3,10,489,538,1027,1492
3404-001,2013,7,3,11,486,533,1019,1027
3404-001,2013,7,3,12,494,542,1036,1019
3404-001,2013,7,3,13,434,403,837,1036
3404-001,2013,7,3,14,506,478,984,837
3404-001,2013,7,3,15,560,551,1111,984
3404-001,2013,7,3,16,568,504,1072,1111
3404-001,2013,7,3,17,591,446,1037,1072
3404-001,2013,7,3,18,845,432,1277,1037
3404-001,2013,7,3,19,815,346,1161,1277
3404-001,2013,7,3,20,575,328,903,1161
3404-001,2013,7,3,21,478,260,738,903
3404-001,2013,7,3,22,332,177,509,738
3404-001,2013,7,3,23,188,112,300,509
3404-001,2013,7,3,24,100,103,203,300
3404-001,2013,7,4,1,81,66,147,203
3404-001,2013,7,4,2,51,47,98,147
3404-001,2013,7,4,3,33,34,67,98
3404-001,2013,7,4,4,30,49,79,67
3404-001,2013,7,4,5,69,87,156,79
3404-001,2013,7,4,6,87,149,236,156
3404-001,2013,7,4,7,154,419,573,236
3404-001,2013,7,4,8,353,1246,1599,573
3404-001,2013,7,4,9,509,1051,1560,1599
3404-001,2013,7,4,10,510,574,1084,1560
3404-001,2013,7,4,11,527,551,1078,1084
3404-001,2013,7,4,12,484,512,996,1078
3404-001,2013,7,4,13,455,409,864,996
3404-001,2013,7,4,14,527,476,1003,864
3404-001,2013,7,4,15,577,542,1119,1003
3404-001,2013,7,4,16,605,443,1048,1119
3404-001,2013,7,4,17,564,441,1005,1048
3404-001,2013,7,4,18,718,413,1131,1005
3404-001,2013,7,4,19,755,345,1100,1131
3404-001,2013,7,4,20,538,314,852,1100
3404-001,2013,7,4,21,585,244,829,852
3404-001,2013,7,4,22,331,175,506,829
3404-001,2013,7,4,23,189,126,315,506
3404-001,2013,7,4,24,87,97,184,315
3404-001,2013,7,5,1,84,48,132,184
3404-001,2013,7,5,2,40,45,85,132
3404-001,2013,7,5,3,39,39,78,85
3404-001,2013,7,5,4,35,28,63,78
3404-001,2013,7,5,5,45,65,110,63
3404-001,2013,7,5,6,57,115,172,110
3404-001,2013,7,5,7,124,346,470,172
3404-001,2013,7,5,8,363,1150,1513,470
3404-001,2013,7,5,9,470,1030,1500,1513
3404-001,2013,7,5,10,495,562,1057,1500
3404-001,2013,7,5,11,496,548,1044,1057
3404-001,2013,7,5,12,587,528,1115,1044
3404-001,2013,7,5,13,433,431,864,1115
3404-001,2013,7,5,14,528,516,1044,864
3404-001,2013,7,5,15,590,506,1096,1044
3404-001,2013,7,5,16,618,531,1149,1096
3404-001,2013,7,5,17,606,524,1130,1149
3404-001,2013,7,5,18,852,447,1299,1130
3404-001,2013,7,5,19,921,474,1395,1299
3404-001,2013,7,5,20,641,364,1005,1395
3404-001,2013,7,5,21,529,256,785,1005
3404-001,2013,7,5,22,347,174,521,785
3404-001,2013,7,5,23,205,120,325,521
3404-001,2013,7,5,24,99,98,197,325
3404-001,2013,7,6,1,84,78,162,197
3404-001,2013,7,6,2,58,49,107,162
3404-001,2013,7,6,3,32,51,83,107
3404-001,2013,7,6,4,34,47,81,83
3404-001,2013,7,6,5,55,62,117,81
3404-001,2013,7,6,6,81,183,264,117
3404-001,2013,7,6,7,130,314,444,264
3404-001,2013,7,6,8,279,604,883,444
3404-001,2013,7,6,9,408,568,976,883
3404-001,2013,7,6,10,449,470,919,976
3404-001,2013,7,6,11,421,448,869,919
3404-001,2013,7,6,12,400,396,796,869
3404-001,2013,7,6,13,350,354,704,796
3404-001,2013,7,6,14,421,369,790,704
3404-001,2013,7,6,15,394,396,790,790
3404-001,2013,7,6,16,461,356,817,790
3404-001,2013,7,6,17,482,305,787,817
3404-001,2013,7,6,18,588,356,944,787
3404-001,2013,7,6,19,465,328,793,944
3404-001,2013,7,6,20,328,263,591,793
3404-001,2013,7,6,21,272,202,474,591
3404-001,2013,7,6,22,231,151,382,474
3404-001,2013,7,6,23,139,108,247,382
3404-001,2013,7,6,24,94,66,160,247
3404-001,2013,7,7,1,61,61,122,160
3404-001,2013,7,7,2,43,38,81,122
3404-001,2013,7,7,3,42,20,62,81
3404-001,2013,7,7,4,30,21,51,62
3404-001,2013,7,7,5,31,32,63,51
3404-001,2013,7,7,6,43,81,124,63
3404-001,2013,7,7,7,76,135,211,124
3404-001,2013,7,7,8,115,217,332,211
3404-001,2013,7,7,9,176,204,380,332
3404-001,2013,7,7,10,190,210,400,380
3404-001,2013,7,7,11,213,238,451,400
3404-001,2013,7,7,12,216,207,423,451
3404-001,2013,7,7,13,269,215,484,423
3404-001,2013,7,7,14,270,244,514,484
3404-001,2013,7,7,15,294,248,542,514
3404-001,2013,7,7,16,332,276,608,542
3404-001,2013,7,7,17,342,232,574,608
3404-001,2013,7,7,18,364,237,601,574
3404-001,2013,7,7,19,257,255,512,601
3404-001,2013,7,7,20,228,190,418,512
3404-001,2013,7,7,21,184,185,369,418
3404-001,2013,7,7,22,125,149,274,369
3404-001,2013,7,7,23,93,125,218,274
3404-001,2013,7,7,24,56,96,152,218
3404-001,2013,7,8,1,33,70,103,152
3404-001,2013,7,8,2,16,40,56,103
3404-001,2013,7,8,3,16,23,39,56
3404-001,2013,7,8,4,25,43,68,39
3404-001,2013,7,8,5,45,75,120,68
3404-001,2013,7,8,6,88,174,262,120
3404-001,2013,7,8,7,149,449,598,262
3404-001,2013,7,8,8,391,1374,1765,598
3404-001,2013,7,8,9,455,1142,1597,1765
3404-001,2013,7,8,10,481,516,997,1597
3404-001,2013,7,8,11,501,529,1030,997
3404-001,2013,7,8,12,521,539,1060,1030
3404-001,2013,7,8,13,427,428,855,1060
3404-001,2013,7,8,14,443,484,927,855
3404-001,2013,7,8,15,544,546,1090,927
3404-001,2013,7,8,16,543,513,1056,1090
3404-001,2013,7,8,17,583,422,1005,1056
3404-001,2013,7,8,18,693,337,1030,1005
3404-001,2013,7,8,19,763,346,1109,1030
3404-001,2013,7,8,20,513,320,833,1109
3404-001,2013,7,8,21,511,199,710,833
3404-001,2013,7,8,22,333,147,480,710
3404-001,2013,7,8,23,172,106,278,480
3404-001,2013,7,8,24,96,89,185,278
3404-001,2013,7,9,1,75,58,133,185
3404-001,2013,7,9,2,49,49,98,133
3404-001,2013,7,9,3,39,42,81,98
3404-001,2013,7,9,4,44,33,77,81
3404-001,2013,7,9,5,54,80,134,77
3404-001,2013,7,9,6,106,157,263,134
3404-001,2013,7,9,7,142,393,535,263
3404-001,2013,7,9,8,369,1149,1518,535
3404-001,2013,7,9,9,581,1048,1629,1518
3404-001,2013,7,9,10,512,589,1101,1629
3404-001,2013,7,9,11,525,582,1107,1101
3404-001,2013,7,9,12,523,526,1049,1107
3404-001,2013,7,9,13,482,451,933,1049
3404-001,2013,7,9,14,482,533,1015,933
3404-001,2013,7,9,15,615,572,1187,1015
3404-001,2013,7,9,16,603,530,1133,1187
3404-001,2013,7,9,17,610,475,1085,1133
3404-001,2013,7,9,18,716,461,1177,1085
3404-001,2013,7,9,19,784,361,1145,1177
3404-001,2013,7,9,20,592,306,898,1145
3404-001,2013,7,9,21,569,227,796,898
3404-001,2013,7,9,22,378,162,540,796
3404-001,2013,7,9,23,170,142,312,540
3404-001,2013,7,9,24,121,88,209,312
3404-001,2013,7,10,1,74,62,136,209
3404-001,2013,7,10,2,56,47,103,136
3404-001,2013,7,10,3,46,54,100,103
3404-001,2013,7,10,4,32,37,69,100
3404-001,2013,7,10,5,48,81,129,69
3404-001,2013,7,10,6,89,151,240,129
3404-001,2013,7,10,7,150,412,562,240
3404-001,2013,7,10,8,353,1182,1535,562
3404-001,2013,7,10,9,568,1061,1629,1535
3404-001,2013,7,10,10,548,562,1110,1629
3404-001,2013,7,10,11,512,510,1022,1110
3404-001,2013,7,10,12,541,528,1069,1022
3404-001,2013,7,10,13,448,467,915,1069
3404-001,2013,7,10,14,485,546,1031,915
3404-001,2013,7,10,15,583,548,1131,1031
3404-001,2013,7,10,16,611,505,1116,1131
3404-001,2013,7,10,17,558,450,1008,1116
3404-001,2013,7,10,18,804,426,1230,1008
3404-001,2013,7,10,19,877,422,1299,1230
3404-001,2013,7,10,20,551,324,875,1299
3404-001,2013,7,10,21,538,267,805,875
3404-001,2013,7,10,22,334,201,535,805
3404-001,2013,7,10,23,202,146,348,535
3404-001,2013,7,10,24,120,98,218,348
3404-001,2013,7,11,1,88,65,153,218
3404-001,2013,7,11,2,64,52,116,153
3404-001,2013,7,11,3,34,46,80,116
3404-001,2013,7,11,4,32,47,79,80
3404-001,2013,7,11,5,61,85,146,79
3404-001,2013,7,11,6,92,131,223,146
3404-001,2013,7,11,7,148,417,565,223
3404-001,2013,7,11,8,356,1168,1524,565
3404-001,2013,7,11,9,512,1068,1580,1524
3404-001,2013,7,11,10,550,605,1155,1580
3404-001,2013,7,11,11,531,573,1104,1155
3404-001,2013,7,11,12,495,508,1003,1104
3404-001,2013,7,11,13,449,437,886,1003
3404-001,2013,7,11,14,481,527,1008,886
3404-001,2013,7,11,15,595,544,1139,1008
3404-001,2013,7,11,16,619,515,1134,1139
3404-001,2013,7,11,17,613,457,1070,1134
3404-001,2013,7,11,18,796,451,1247,1070
3404-001,2013,7,11,19,769,372,1141,1247
3404-001,2013,7,11,20,583,310,893,1141
3404-001,2013,7,11,21,503,224,727,893
3404-001,2013,7,11,22,329,182,511,727
3404-001,2013,7,11,23,239,121,360,511
3404-001,2013,7,11,24,103,103,206,360
3404-001,2013,7,12,1,81,67,148,206
3404-001,2013,7,12,2,49,42,91,148
3404-001,2013,7,12,3,34,42,76,91
3404-001,2013,7,12,4,56,45,101,76
3404-001,2013,7,12,5,64,80,144,101
3404-001,2013,7,12,6,83,138,221,144
3404-001,2013,7,12,7,150,412,562,221
3404-001,2013,7,12,8,406,1196,1602,562
3404-001,2013,7,12,9,551,1134,1685,1602
3404-001,2013,7,12,10,570,579,1149,1685
3404-001,2013,7,12,11,573,604,1177,1149
3404-001,2013,7,12,12,578,512,1090,1177
3404-001,2013,7,12,13,470,431,901,1090
3404-001,2013,7,12,14,538,579,1117,901
3404-001,2013,7,12,15,660,560,1220,1117
3404-001,2013,7,12,16,597,525,1122,1220
3404-001,2013,7,12,17,629,467,1096,1122
3404-001,2013,7,12,18,849,431,1280,1096
3404-001,2013,7,12,19,996,444,1440,1280
3404-001,2013,7,12,20,679,355,1034,1440
3404-001,2013,7,12,21,511,265,776,1034
3404-001,2013,7,12,22,315,163,478,776
3404-001,2013,7,12,23,191,149,340,478
3404-001,2013,7,12,24,117,103,220,340
3404-001,2013,7,13,1,59,79,138,220
3404-001,2013,7,13,2,60,48,108,138
3404-001,2013,7,13,3,50,60,110,108
3404-001,2013,7,13,4,29,38,67,110
3404-001,2013,7,13,5,52,69,121,67
3404-001,2013,7,13,6,66,150,216,121
3404-001,2013,7,13,7,129,250,379,216
3404-001,2013,7,13,8,307,575,882,379
3404-001,2013,7,13,9,428,571,999,882
3404-001,2013,7,13,10,427,455,882,999
3404-001,2013,7,13,11,437,414,851,882
3404-001,2013,7,13,12,413,429,842,851
3404-001,2013,7,13,13,405,387,792,842
3404-001,2013,7,13,14,409,392,801,792
3404-001,2013,7,13,15,416,373,789,801
3404-001,2013,7,13,16,447,340,787,789
3404-001,2013,7,13,17,521,322,843,787
3404-001,2013,7,13,18,621,315,936,843
3404-001,2013,7,13,19,443,299,742,936
3404-001,2013,7,13,20,298,213,511,742
3404-001,2013,7,13,21,226,199,425,511
3404-001,2013,7,13,22,178,127,305,425
3404-001,2013,7,13,23,110,99,209,305
3404-001,2013,7,13,24,81,65,146,209
3404-001,2013,7,14,1,59,43,102,146
3404-001,2013,7,14,2,45,42,87,102
3404-001,2013,7,14,3,24,19,43,87
3404-001,2013,7,14,4,30,21,51,43
3404-001,2013,7,14,5,36,26,62,51
3404-001,2013,7,14,6,41,58,99,62
3404-001,2013,7,14,7,64,116,180,99
3404-001,2013,7,14,8,122,164,286,180
3404-001,2013,7,14,9,204,198,402,286
3404-001,2013,7,14,10,167,208,375,402
3404-001,2013,7,14,11,212,229,441,375
3404-001,2013,7,14,12,218,210,428,441
3404-001,2013,7,14,13,194,217,411,428
3404-001,2013,7,14,14,203,189,392,411
3404-001,2013,7,14,15,239,174,413,392
3404-001,2013,7,14,16,294,216,510,413
3404-001,2013,7,14,17,283,242,525,510
3404-001,2013,7,14,18,264,188,452,525
3404-001,2013,7,14,19,232,236,468,452
3404-001,2013,7,14,20,187,175,362,468
3404-001,2013,7,14,21,151,165,316,362
3404-001,2013,7,14,22,124,150,274,316
3404-001,2013,7,14,23,79,114,193,274
3404-001,2013,7,14,24,43,81,124,193
3404-001,2013,7,15,1,49,61,110,124
3404-001,2013,7,15,2,19,43,62,110
3404-001,2013,7,15,3,18,34,52,62
3404-001,2013,7,15,4,34,24,58,52
3404-001,2013,7,15,5,42,64,106,58
3404-001,2013,7,15,6,77,134,211,106
3404-001,2013,7,15,7,152,488,640,211
3404-001,2013,7,15,8,394,1348,1742,640
3404-001,2013,7,15,9,472,1134,1606,1742
3404-001,2013,7,15,10,447,537,984,1606
3404-001,2013,7,15,11,520,569,1089,984
3404-001,2013,7,15,12,476,526,1002,1089
3404-001,2013,7,15,13,455,439,894,1002
3404-001,2013,7,15,14,538,537,1075,894
3404-001,2013,7,15,15,579,587,1166,1075
3404-001,2013,7,15,16,596,461,1057,1166
3404-001,2013,7,15,17,586,463,1049,1057
3404-001,2013,7,15,18,726,421,1147,1049
3404-001,2013,7,15,19,739,366,1105,1147
3404-001,2013,7,15,20,557,288,845,1105
3404-001,2013,7,15,21,552,233,785,845
3404-001,2013,7,15,22,351,179,530,785
3404-001,2013,7,15,23,211,125,336,530
3404-001,2013,7,15,24,124,89,213,336
3404-001,2013,7,16,1,71,70,141,213
3404-001,2013,7,16,2,49,50,99,141
3404-001,2013,7,16,3,39,27,66,99
3404-001,2013,7,16,4,42,40,82,66
3404-001,2013,7,16,5,56,65,121,82
3404-001,2013,7,16,6,84,150,234,121
3404-001,2013,7,16,7,153,434,587,234
3404-001,2013,7,16,8,377,1232,1609,587
3404-001,2013,7,16,9,522,1038,1560,1609
3404-001,2013,7,16,10,540,551,1091,1560
3404-001,2013,7,16,11,561,588,1149,1091
3404-001,2013,7,16,12,503,495,998,1149
3404-001,2013,7,16,13,473,478,951,998
3404-001,2013,7,16,14,518,464,982,951
3404-001,2013,7,16,15,585,576,1161,982
3404-001,2013,7,16,16,592,515,1107,1161
3404-001,2013,7,16,17,640,491,1131,1107
3404-001,2013,7,16,18,778,457,1235,1131
3404-001,2013,7,16,19,847,357,1204,1235
3404-001,2013,7,16,20,597,341,938,1204
3404-001,2013,7,16,21,520,213,733,938
3404-001,2013,7,16,22,358,191,549,733
3404-001,2013,7,16,23,220,118,338,549
3404-001,2013,7,16,24,99,85,184,338
3404-001,2013,7,17,1,81,53,134,184
3404-001,2013,7,17,2,42,50,92,134
3404-001,2013,7,17,3,38,39,77,92
3404-001,2013,7,17,4,31,31,62,77
3404-001,2013,7,17,5,47,57,104,62
3404-001,2013,7,17,6,78,131,209,104
3404-001,2013,7,17,7,131,310,441,209
3404-001,2013,7,17,8,323,1061,1384,441
3404-001,2013,7,17,9,433,1002,1435,1384
3404-001,2013,7,17,10,481,496,977,1435
3404-001,2013,7,17,11,467,527,994,977
3404-001,2013,7,17,12,484,494,978,994
3404-001,2013,7,17,13,463,376,839,978
3404-001,2013,7,17,14,516,475,991,839
3404-001,2013,7,17,15,519,545,1064,991
3404-001,2013,7,17,16,523,467,990,1064
3404-001,2013,7,17,17,546,414,960,990
3404-001,2013,7,17,18,752,357,1109,960
3404-001,2013,7,17,19,784,340,1124,1109
3404-001,2013,7,17,20,440,241,681,1124
3404-001,2013,7,17,21,439,216,655,681
3404-001,2013,7,17,22,329,156,485,655
3404-001,2013,7,17,23,173,126,299,485
3404-001,2013,7,17,24,100,72,172,299
3404-001,2013,7,18,1,84,69,153,172
3404-001,2013,7,18,2,30,42,72,153
3404-001,2013,7,18,3,33,34,67,72
3404-001,2013,7,18,4,29,32,61,67
3404-001,2013,7,18,5,45,59,104,61
3404-001,2013,7,18,6,63,149,212,104
3404-001,2013,7,18,7,159,392,551,212
3404-001,2013,7,18,8,361,1194,1555,551
3404-001,2013,7,18,9,505,1067,1572,1555
3404-001,2013,7,18,10,540,581,1121,1572
3404-001,2013,7,18,11,499,545,1044,1121
3404-001,2013,7,18,12,557,544,1101,1044
3404-001,2013,7,18,13,511,431,942,1101
3404-001,2013,7,18,14,525,514,1039,942
3404-001,2013,7,18,15,557,536,1093,1039
3404-001,2013,7,18,16,624,493,1117,1093
3404-001,2013,7,18,17,580,436,1016,1117
3404-001,2013,7,18,18,736,428,1164,1016
3404-001,2013,7,18,19,814,387,1201,1164
3404-001,2013,7,18,20,603,307,910,1201
3404-001,2013,7,18,21,548,229,777,910
3404-001,2013,7,18,22,374,194,568,777
3404-001,2013,7,18,23,236,145,381,568
3404-001,2013,7,18,24,102,90,192,381
3404-001,2013,7,19,1,75,74,149,192
3404-001,2013,7,19,2,47,54,101,149
3404-001,2013,7,19,3,43,41,84,101
3404-001,2013,7,19,4,35,44,79,84
3404-001,2013,7,19,5,52,62,114,79
3404-001,2013,7,19,6,89,139,228,114
3404-001,2013,7,19,7,167,442,609,228
3404-001,2013,7,19,8,397,1204,1601,609
3404-001,2013,7,19,9,564,1126,1690,1601
3404-001,2013,7,19,10,566,618,1184,1690
3404-001,2013,7,19,11,524,629,1153,1184
3404-001,2013,7,19,12,609,553,1162,1153
3404-001,2013,7,19,13,513,431,944,1162
3404-001,2013,7,19,14,505,568,1073,944
3404-001,2013,7,19,15,654,585,1239,1073
3404-001,2013,7,19,16,638,543,1181,1239
3404-001,2013,7,19,17,643,486,1129,1181
3404-001,2013,7,19,18,927,483,1410,1129
3404-001,2013,7,19,19,939,448,1387,1410
3404-001,2013,7,19,20,701,389,1090,1387
3404-001,2013,7,19,21,563,252,815,1090
3404-001,2013,7,19,22,373,197,570,815
3404-001,2013,7,19,23,234,132,366,570
3404-001,2013,7,19,24,122,113,235,366
3404-001,2013,7,20,1,81,72,153,235
3404-001,2013,7,20,2,75,51,126,153
3404-001,2013,7,20,3,33,41,74,126
3404-001,2013,7,20,4,29,47,76,74
3404-001,2013,7,20,5,51,65,116,76
3404-001,2013,7,20,6,79,175,254,116
3404-001,2013,7,20,7,153,314,467,254
3404-001,2013,7,20,8,296,639,935,467
3404-001,2013,7,20,9,434,612,1046,935
3404-001,2013,7,20,10,451,516,967,1046
3404-001,2013,7,20,11,460,540,1000,967
3404-001,2013,7,20,12,469,440,909,1000
3404-001,2013,7,20,13,375,394,769,909
3404-001,2013,7,20,14,412,392,804,769
3404-001,2013,7,20,15,446,396,842,804
3404-001,2013,7,20,16,452,347,799,842
3404-001,2013,7,20,17,472,322,794,799
3404-001,2013,7,20,18,650,356,1006,794
3404-001,2013,7,20,19,530,307,837,1006
3404-001,2013,7,20,20,292,278,570,837
3404-001,2013,7,20,21,250,251,501,570
3404-001,2013,7,20,22,195,151,346,501
3404-001,2013,7,20,23,158,109,267,346
3404-001,2013,7,20,24,82,76,158,267
3404-001,2013,7,21,1,65,46,111,158
3404-001,2013,7,21,2,46,32,78,111
3404-001,2013,7,21,3,26,26,52,78
3404-001,2013,7,21,4,22,20,42,52
3404-001,2013,7,21,5,24,29,53,42
3404-001,2013,7,21,6,43,63,106,53
3404-001,2013,7,21,7,91,149,240,106
3404-001,2013,7,21,8,136,184,320,240
3404-001,2013,7,21,9,186,251,437,320
3404-001,2013,7,21,10,233,245,478,437
3404-001,2013,7,21,11,246,281,527,478
3404-001,2013,7,21,12,221,229,450,527
3404-001,2013,7,21,13,230,289,519,450
3404-001,2013,7,21,14,258,248,506,519
3404-001,2013,7,21,15,267,212,479,506
3404-001,2013,7,21,16,328,226,554,479
3404-001,2013,7,21,17,317,281,598,554
3404-001,2013,7,21,18,408,285,693,598
3404-001,2013,7,21,19,333,233,566,693
3404-001,2013,7,21,20,265,220,485,566
3404-001,2013,7,21,21,205,218,423,485
3404-001,2013,7,21,22,134,168,302,423
3404-001,2013,7,21,23,87,139,226,302
3404-001,2013,7,21,24,55,87,142,226
3404-001,2013,7,22,1,43,48,91,142
3404-001,2013,7,22,2,28,51,79,91
3404-001,2013,7,22,3,27,25,52,79
3404-001,2013,7,22,4,27,42,69,52
3404-001,2013,7,22,5,38,77,115,69
3404-001,2013,7,22,6,69,120,189,115
3404-001,2013,7,22,7,168,409,577,189
3404-001,2013,7,22,8,371,1372,1743,577
3404-001,2013,7,22,9,446,1144,1590,1743
3404-001,2013,7,22,10,466,567,1033,1590
3404-001,2013,7,22,11,521,574,1095,1033
3404-001,2013,7,22,12,509,523,1032,1095
3404-001,2013,7,22,13,451,427,878,1032
3404-001,2013,7,22,14,498,500,998,878
3404-001,2013,7,22,15,606,564,1170,998
3404-001,2013,7,22,16,611,515,1126,1170
3404-001,2013,7,22,17,623,436,1059,1126
3404-001,2013,7,22,18,728,414,1142,1059
3404-001,2013,7,22,19,747,382,1129,1142
3404-001,2013,7,22,20,579,325,904,1129
3404-001,2013,7,22,21,583,248,831,904
3404-001,2013,7,22,22,358,186,544,831
3404-001,2013,7,22,23,197,118,315,544
3404-001,2013,7,22,24,101,98,199,315
3404-001,2013,7,23,1,81,74,155,199
3404-001,2013,7,23,2,46,48,94,155
3404-001,2013,7,23,3,35,24,59,94
3404-001,2013,7,23,4,48,37,85,59
3404-001,2013,7,23,5,54,61,115,85
3404-001,2013,7,23,6,97,129,226,115
3404-001,2013,7,23,7,159,406,565,226
3404-001,2013,7,23,8,364,1142,1506,565
3404-001,2013,7,23,9,514,1093,1607,1506
3404-001,2013,7,23,10,495,531,1026,1607
3404-001,2013,7,23,11,480,526,1006,1026
3404-001,2013,7,23,12,485,491,976,1006
3404-001,2013,7,23,13,432,380,812,976
3404-001,2013,7,23,14,483,460,943,812
3404-001,2013,7,23,15,538,478,1016,943
3404-001,2013,7,23,16,577,507,1084,1016
3404-001,2013,7,23,17,602,447,1049,1084
3404-001,2013,7,23,18,714,408,1122,1049
3404-001,2013,7,23,19,764,368,1132,1122
3404-001,2013,7,23,20,618,293,911,1132
3404-001,2013,7,23,21,521,245,766,911
3404-001,2013,7,23,22,330,200,530,766
3404-001,2013,7,23,23,209,122,331,530
3404-001,2013,7,23,24,106,95,201,331
3404-001,2013,7,24,1,67,57,124,201
3404-001,2013,7,24,2,58,49,107,124
3404-001,2013,7,24,3,34,35,69,107
3404-001,2013,7,24,4,27,22,49,69
3404-001,2013,7,24,5,38,63,101,49
3404-001,2013,7,24,6,72,114,186,101
3404-001,2013,7,24,7,121,342,463,186
3404-001,2013,7,24,8,362,1157,1519,463
3404-001,2013,7,24,9,507,1078,1585,1519
3404-001,2013,7,24,10,500,555,1055,1585
3404-001,2013,7,24,11,537,539,1076,1055
3404-001,2013,7,24,12,549,497,1046,1076
3404-001,2013,7,24,13,468,413,881,1046
3404-001,2013,7,24,14,457,503,960,881
3404-001,2013,7,24,15,568,562,1130,960
3404-001,2013,7,24,16,648,521,1169,1130
3404-001,2013,7,24,17,629,490,1119,1169
3404-001,2013,7,24,18,733,468,1201,1119
3404-001,2013,7,24,19,819,400,1219,1201
3404-001,2013,7,24,20,606,332,938,1219
3404-001,2013,7,24,21,518,232,750,938
3404-001,2013,7,24,22,311,174,485,750
3404-001,2013,7,24,23,208,123,331,485
3404-001,2013,7,24,24,127,92,219,331
3404-001,2013,7,25,1,70,64,134,219
3404-001,2013,7,25,2,58,42,100,134
3404-001,2013,7,25,3,32,34,66,100
3404-001,2013,7,25,4,38,46,84,66
3404-001,2013,7,25,5,46,74,120,84
3404-001,2013,7,25,6,89,135,224,120
3404-001,2013,7,25,7,159,427,586,224
3404-001,2013,7,25,8,383,1181,1564,586
3404-001,2013,7,25,9,523,1080,1603,1564
3404-001,2013,7,25,10,497,579,1076,1603
3404-001,2013,7,25,11,562,597,1159,1076
3404-001,2013,7,25,12,526,524,1050,1159
3404-001,2013,7,25,13,489,434,923,1050
3404-001,2013,7,25,14,547,517,1064,923
3404-001,2013,7,25,15,579,584,1163,1064
3404-001,2013,7,25,16,586,537,1123,1163
3404-001,2013,7,25,17,654,462,1116,1123
3404-001,2013,7,25,18,875,461,1336,1116
3404-001,2013,7,25,19,803,379,1182,1336
3404-001,2013,7,25,20,610,320,930,1182
3404-001,2013,7,25,21,469,261,730,930
3404-001,2013,7,25,22,326,193,519,730
3404-001,2013,7,25,23,209,153,362,519
3404-001,2013,7,25,24,118,72,190,362
3404-001,2013,7,26,1,96,67,163,190
3404-001,2013,7,26,2,62,55,117,163
3404-001,2013,7,26,3,49,39,88,117
3404-001,2013,7,26,4,31,43,74,88
3404-001,2013,7,26,5,50,91,141,74
3404-001,2013,7,26,6,88,139,227,141
3404-001,2013,7,26,7,161,412,573,227
3404-001,2013,7,26,8,362,1154,1516,573
3404-001,2013,7,26,9,491,1082,1573,1516
3404-001,2013,7,26,10,552,569,1121,1573
3404-001,2013,7,26,11,551,586,1137,1121
3404-001,2013,7,26,12,545,530,1075,1137
3404-001,2013,7,26,13,482,451,933,1075
3404-001,2013,7,26,14,496,493,989,933
3404-001,2013,7,26,15,572,566,1138,989
3404-001,2013,7,26,16,593,526,1119,1138
3404-001,2013,7,26,17,646,494,1140,1119
3404-001,2013,7,26,18,956,436,1392,1140
3404-001,2013,7,26,19,996,450,1446,1392
3404-001,2013,7,26,20,680,405,1085,1446
3404-001,2013,7,26,21,510,242,752,1085
3404-001,2013,7,26,22,337,201,538,752
3404-001,2013,7,26,23,238,147,385,538
3404-001,2013,7,26,24,113,106,219,385
3404-001,2013,7,27,1,88,73,161,219
3404-001,2013,7,27,2,58,61,119,161
3404-001,2013,7,27,3,52,48,100,119
3404-001,2013,7,27,4,40,42,82,100
3404-001,2013,7,27,5,42,66,108,82
3404-001,2013,7,27,6,92,172,264,108
3404-001,2013,7,27,7,189,315,504,264
3404-001,2013,7,27,8,272,580,852,504
3404-001,2013,7,27,9,402,621,1023,852
3404-001,2013,7,27,10,457,481,938,1023
3404-001,2013,7,27,11,483,491,974,938
3404-001,2013,7,27,12,470,434,904,974
3404-001,2013,7,27,13,349,339,688,904
3404-001,2013,7,27,14,397,383,780,688
3404-001,2013,7,27,15,410,415,825,780
3404-001,2013,7,27,16,445,359,804,825
3404-001,2013,7,27,17,491,328,819,804
3404-001,2013,7,27,18,615,344,959,819
3404-001,2013,7,27,19,502,284,786,959
3404-001,2013,7,27,20,315,219,534,786
3404-001,2013,7,27,21,251,211,462,534
3404-001,2013,7,27,22,163,129,292,462
3404-001,2013,7,27,23,126,94,220,292
3404-001,2013,7,27,24,74,56,130,220
3404-001,2013,7,28,1,59,50,109,130
3404-001,2013,7,28,2,40,25,65,109
3404-001,2013,7,28,3,29,20,49,65
3404-001,2013,7,28,4,29,25,54,49
3404-001,2013,7,28,5,24,22,46,54
3404-001,2013,7,28,6,40,40,80,46
3404-001,2013,7,28,7,64,116,180,80
3404-001,2013,7,28,8,110,214,324,180
3404-001,2013,7,28,9,158,231,389,324
3404-001,2013,7,28,10,156,202,358,389
3404-001,2013,7,28,11,199,195,394,358
3404-001,2013,7,28,12,228,220,448,394
3404-001,2013,7,28,13,239,189,428,448
3404-001,2013,7,28,14,271,227,498,428
3404-001,2013,7,28,15,292,246,538,498
3404-001,2013,7,28,16,319,263,582,538
3404-001,2013,7,28,17,326,225,551,582
3404-001,2013,7,28,18,376,223,599,551
3404-001,2013,7,28,19,307,208,515,599
3404-001,2013,7,28,20,243,214,457,515
3404-001,2013,7,28,21,176,188,364,457
3404-001,2013,7,28,22,116,143,259,364
3404-001,2013,7,28,23,86,99,185,259
3404-001,2013,7,28,24,38,79,117,185
3404-001,2013,7,29,1,36,59,95,117
3404-001,2013,7,29,2,30,28,58,95
3404-001,2013,7,29,3,10,24,34,58
3404-001,2013,7,29,4,23,40,63,34
3404-001,2013,7,29,5,24,57,81,63
3404-001,2013,7,29,6,63,134,197,81
3404-001,2013,7,29,7,155,349,504,197
3404-001,2013,7,29,8,344,964,1308,504
3404-001,2013,7,29,9,403,907,1310,1308
3404-001,2013,7,29,10,467,482,949,1310
3404-001,2013,7,29,11,437,512,949,949
3404-001,2013,7,29,12,443,455,898,949
3404-001,2013,7,29,13,405,390,795,898
3404-001,2013,7,29,14,461,430,891,795
3404-001,2013,7,29,15,447,455,902,891
3404-001,2013,7,29,16,538,428,966,902
3404-001,2013,7,29,17,472,417,889,966
3404-001,2013,7,29,18,606,398,1004,889
3404-001,2013,7,29,19,683,307,990,1004
3404-001,2013,7,29,20,442,284,726,990
3404-001,2013,7,29,21,390,200,590,726
3404-001,2013,7,29,22,314,168,482,590
3404-001,2013,7,29,23,163,94,257,482
3404-001,2013,7,29,24,93,76,169,257
3404-001,2013,7,30,1,62,76,138,169
3404-001,2013,7,30,2,38,44,82,138
3404-001,2013,7,30,3,28,25,53,82
3404-001,2013,7,30,4,41,27,68,53
3404-001,2013,7,30,5,39,66,105,68
3404-001,2013,7,30,6,82,148,230,105
3404-001,2013,7,30,7,123,335,458,230
3404-001,2013,7,30,8,347,820,1167,458
3404-001,2013,7,30,9,449,823,1272,1167
3404-001,2013,7,30,10,439,506,945,1272
3404-001,2013,7,30,11,465,465,930,945
3404-001,2013,7,30,12,471,435,906,930
3404-001,2013,7,30,13,397,387,784,906
3404-001,2013,7,30,14,422,409,831,784
3404-001,2013,7,30,15,521,449,970,831
3404-001,2013,7,30,16,569,437,1006,970
3404-001,2013,7,30,17,540,398,938,1006
3404-001,2013,7,30,18,624,357,981,938
3404-001,2013,7,30,19,734,333,1067,981
3404-001,2013,7,30,20,437,262,699,1067
3404-001,2013,7,30,21,359,191,550,699
3404-001,2013,7,30,22,283,167,450,550
3404-001,2013,7,30,23,161,126,287,450
3404-001,2013,7,30,24,76,74,150,287
3404-001,2013,7,31,1,54,64,118,150
3404-001,2013,7,31,2,25,54,79,118
3404-001,2013,7,31,3,27,33,60,79
3404-001,2013,7,31,4,22,37,59,60
3404-001,2013,7,31,5,43,50,93,59
3404-001,2013,7,31,6,75,96,171,93
3404-001,2013,7,31,7,121,228,349,171
3404-001,2013,7,31,8,291,743,1034,349
3404-001,2013,7,31,9,379,723,1102,1034
3404-001,2013,7,31,10,400,457,857,1102
3404-001,2013,7,31,11,454,519,973,857
3404-001,2013,7,31,12,441,457,898,973
3404-001,2013,7,31,13,369,380,749,898
3404-001,2013,7,31,14,459,409,868,749
3404-001,2013,7,31,15,475,416,891,868
3404-001,2013,7,31,16,478,420,898,891
3404-001,2013,7,31,17,470,401,871,898
3404-001,2013,7,31,18,585,356,941,871
3404-001,2013,7,31,19,639,303,942,941
3404-001,2013,7,31,20,426,290,716,942
3404-001,2013,7,31,21,357,213,570,716
3404-001,2013,7,31,22,273,149,422,570
3404-001,2013,7,31,23,158,112,270,422
3404-001,2013,7,31,24,81,68,149,270
3404-001,2013,8,1,1,62,77,139,149
3404-001,2013,8,1,2,28,25,53,139
3404-001,2013,8,1,3,24,22,46,53
3404-001,2013,8,1,4,31,48,79,46
3404-001,2013,8,1,5,47,64,111,79
3404-001,2013,8,1,6,68,126,194,111
3404-001,2013,8,1,7,141,328,469,194
3404-001,2013,8,1,8,323,764,1087,469
3404-001,2013,8,1,9,398,696,1094,1087
3404-001,2013,8,1,10,411,492,903,1094
3404-001,2013,8,1,11,456,501,957,903
3404-001,2013,8,1,12,382,436,818,957
3404-001,2013,8,1,13,386,353,739,818
3404-001,2013,8,1,14,379,405,784,739
3404-001,2013,8,1,15,464,408,872,784
3404-001,2013,8,1,16,453,417,870,872
3404-001,2013,8,1,17,456,377,833,870
3404-001,2013,8,1,18,543,373,916,833
3404-001,2013,8,1,19,584,339,923,916
3404-001,2013,8,1,20,369,258,627,923
3404-001,2013,8,1,21,377,195,572,627
3404-001,2013,8,1,22,242,153,395,572
3404-001,2013,8,1,23,166,102,268,395
3404-001,2013,8,1,24,88,86,174,268
3404-001,2013,8,2,1,62,40,102,174
3404-001,2013,8,2,2,44,35,79,102
3404-001,2013,8,2,3,23,33,56,79
3404-001,2013,8,2,4,26,26,52,56
3404-001,2013,8,2,5,44,49,93,52
3404-001,2013,8,2,6,76,112,188,93
3404-001,2013,8,2,7,121,215,336,188
3404-001,2013,8,2,8,244,683,927,336
3404-001,2013,8,2,9,366,674,1040,927
3404-001,2013,8,2,10,321,479,800,1040
3404-001,2013,8,2,11,407,450,857,800
3404-001,2013,8,2,12,402,420,822,857
3404-001,2013,8,2,13,383,390,773,822
3404-001,2013,8,2,14,435,412,847,773
3404-001,2013,8,2,15,449,437,886,847
3404-001,2013,8,2,16,486,348,834,886
3404-001,2013,8,2,17,474,370,844,834
3404-001,2013,8,2,18,660,365,1025,844
3404-001,2013,8,2,19,669,331,1000,1025
3404-001,2013,8,2,20,432,310,742,1000
3404-001,2013,8,2,21,335,272,607,742
3404-001,2013,8,2,22,274,157,431,607
3404-001,2013,8,2,23,177,128,305,431
3404-001,2013,8,2,24,101,88,189,305
3404-001,2013,8,3,1,62,67,129,189
3404-001,2013,8,3,2,40,48,88,129
3404-001,2013,8,3,3,33,31,64,88
3404-001,2013,8,3,4,37,28,65,64
3404-001,2013,8,3,5,43,52,95,65
3404-001,2013,8,3,6,59,111,170,95
3404-001,2013,8,3,7,116,236,352,170
3404-001,2013,8,3,8,197,411,608,352
3404-001,2013,8,3,9,311,438,749,608
3404-001,2013,8,3,10,318,412,730,749
3404-001,2013,8,3,11,371,387,758,730
3404-001,2013,8,3,12,321,364,685,758
3404-001,2013,8,3,13,299,336,635,685
3404-001,2013,8,3,14,349,360,709,635
3404-001,2013,8,3,15,361,327,688,709
3404-001,2013,8,3,16,388,348,736,688
3404-001,2013,8,3,17,380,286,666,736
3404-001,2013,8,3,18,484,266,750,666
3404-001,2013,8,3,19,417,254,671,750
3404-001,2013,8,3,20,300,233,533,671
3404-001,2013,8,3,21,245,212,457,533
3404-001,2013,8,3,22,204,134,338,457
3404-001,2013,8,3,23,156,108,264,338
3404-001,2013,8,3,24,94,79,173,264
3404-001,2013,8,4,1,93,54,147,173
3404-001,2013,8,4,2,71,33,104,147
3404-001,2013,8,4,3,54,28,82,104
3404-001,2013,8,4,4,25,11,36,82
3404-001,2013,8,4,5,30,27,57,36
3404-001,2013,8,4,6,25,62,87,57
3404-001,2013,8,4,7,64,108,172,87
3404-001,2013,8,4,8,97,242,339,172
3404-001,2013,8,4,9,173,228,401,339
3404-001,2013,8,4,10,156,212,368,401
3404-001,2013,8,4,11,250,221,471,368
3404-001,2013,8,4,12,206,212,418,471
3404-001,2013,8,4,13,280,217,497,418
3404-001,2013,8,4,14,273,204,477,497
3404-001,2013,8,4,15,254,235,489,477
3404-001,2013,8,4,16,327,215,542,489
3404-001,2013,8,4,17,365,218,583,542
3404-001,2013,8,4,18,374,218,592,583
3404-001,2013,8,4,19,310,246,556,592
3404-001,2013,8,4,20,211,192,403,556
3404-001,2013,8,4,21,189,224,413,403
3404-001,2013,8,4,22,155,196,351,413
3404-001,2013,8,4,23,104,148,252,351
3404-001,2013,8,4,24,59,89,148,252
3404-001,2013,8,5,1,39,74,113,148
3404-001,2013,8,5,2,29,47,76,113
3404-001,2013,8,5,3,21,24,45,76
3404-001,2013,8,5,4,33,17,50,45
3404-001,2013,8,5,5,51,58,109,50
3404-001,2013,8,5,6,57,140,197,109
3404-001,2013,8,5,7,174,459,633,197
3404-001,2013,8,5,8,378,1239,1617,633
3404-001,2013,8,5,9,429,999,1428,1617
3404-001,2013,8,5,10,446,545,991,1428
3404-001,2013,8,5,11,509,542,1051,991
3404-001,2013,8,5,12,504,511,1015,1051
3404-001,2013,8,5,13,446,387,833,1015
3404-001,2013,8,5,14,499,477,976,833
3404-001,2013,8,5,15,575,525,1100,976
3404-001,2013,8,5,16,564,486,1050,1100
3404-001,2013,8,5,17,545,458,1003,1050
3404-001,2013,8,5,18,679,404,1083,1003
3404-001,2013,8,5,19,767,352,1119,1083
3404-001,2013,8,5,20,557,304,861,1119
3404-001,2013,8,5,21,502,233,735,861
3404-001,2013,8,5,22,295,181,476,735
3404-001,2013,8,5,23,183,125,308,476
3404-001,2013,8,5,24,122,105,227,308
3404-001,2013,8,6,1,60,60,120,227
3404-001,2013,8,6,2,52,48,100,120
3404-001,2013,8,6,3,37,33,70,100
3404-001,2013,8,6,4,35,46,81,70
3404-001,2013,8,6,5,39,82,121,81
3404-001,2013,8,6,6,88,129,217,121
3404-001,2013,8,6,7,137,378,515,217
3404-001,2013,8,6,8,343,1109,1452,515
3404-001,2013,8,6,9,507,1013,1520,1452
3404-001,2013,8,6,10,535,551,1086,1520
3404-001,2013,8,6,11,488,546,1034,1086
3404-001,2013,8,6,12,521,532,1053,1034
3404-001,2013,8,6,13,458,441,899,1053
3404-001,2013,8,6,14,478,514,992,899
3404-001,2013,8,6,15,621,502,1123,992
3404-001,2013,8,6,16,581,451,1032,1123
3404-001,2013,8,6,17,581,396,977,1032
3404-001,2013,8,6,18,691,420,1111,977
3404-001,2013,8,6,19,758,364,1122,1111
3404-001,2013,8,6,20,602,336,938,1122
3404-001,2013,8,6,21,517,246,763,938
3404-001,2013,8,6,22,328,203,531,763
3404-001,2013,8,6,23,204,128,332,531
3404-001,2013,8,6,24,99,81,180,332
3404-001,2013,8,7,1,75,69,144,180
3404-001,2013,8,7,2,47,44,91,144
3404-001,2013,8,7,3,33,18,51,91
3404-001,2013,8,7,4,35,44,79,51
3404-001,2013,8,7,5,55,73,128,79
3404-001,2013,8,7,6,79,107,186,128
3404-001,2013,8,7,7,149,398,547,186
3404-001,2013,8,7,8,378,1080,1458,547
3404-001,2013,8,7,9,456,1031,1487,1458
3404-001,2013,8,7,10,539,555,1094,1487
3404-001,2013,8,7,11,534,600,1134,1094
3404-001,2013,8,7,12,522,518,1040,1134
3404-001,2013,8,7,13,455,453,908,1040
3404-001,2013,8,7,14,482,489,971,908
3404-001,2013,8,7,15,581,532,1113,971
3404-001,2013,8,7,16,582,457,1039,1113
3404-001,2013,8,7,17,553,475,1028,1039
3404-001,2013,8,7,18,777,466,1243,1028
3404-001,2013,8,7,19,799,421,1220,1243
3404-001,2013,8,7,20,621,334,955,1220
3404-001,2013,8,7,21,493,255,748,955
3404-001,2013,8,7,22,329,181,510,748
3404-001,2013,8,7,23,214,136,350,510
3404-001,2013,8,7,24,117,114,231,350
3404-001,2013,8,8,1,83,52,135,231
3404-001,2013,8,8,2,49,44,93,135
3404-001,2013,8,8,3,40,33,73,93
3404-001,2013,8,8,4,35,35,70,73
3404-001,2013,8,8,5,54,68,122,70
3404-001,2013,8,8,6,91,128,219,122
3404-001,2013,8,8,7,161,430,591,219
3404-001,2013,8,8,8,349,1166,1515,591
3404-001,2013,8,8,9,505,1064,1569,1515
3404-001,2013,8,8,10,497,572,1069,1569
3404-001,2013,8,8,11,547,556,1103,1069
3404-001,2013,8,8,12,505,522,1027,1103
3404-001,2013,8,8,13,450,418,868,1027
3404-001,2013,8,8,14,491,489,980,868
3404-001,2013,8,8,15,579,549,1128,980
3404-001,2013,8,8,16,605,520,1125,1128
3404-001,2013,8,8,17,571,458,1029,1125
3404-001,2013,8,8,18,728,452,1180,1029
3404-001,2013,8,8,19,889,382,1271,1180
3404-001,2013,8,8,20,637,358,995,1271
3404-001,2013,8,8,21,513,244,757,995
3404-001,2013,8,8,22,348,177,525,757
3404-001,2013,8,8,23,209,154,363,525
3404-001,2013,8,8,24,120,102,222,363
3404-001,2013,8,9,1,74,82,156,222
3404-001,2013,8,9,2,50,49,99,156
3404-001,2013,8,9,3,45,43,88,99
3404-001,2013,8,9,4,45,32,77,88
3404-001,2013,8,9,5,43,62,105,77
3404-001,2013,8,9,6,82,132,214,105
3404-001,2013,8,9,7,155,375,530,214
3404-001,2013,8,9,8,379,1112,1491,530
3404-001,2013,8,9,9,503,1039,1542,1491
3404-001,2013,8,9,10,555,598,1153,1542
3404-001,2013,8,9,11,547,543,1090,1153
3404-001,2013,8,9,12,513,536,1049,1090
3404-001,2013,8,9,13,432,441,873,1049
3404-001,2013,8,9,14,540,499,1039,873
3404-001,2013,8,9,15,644,526,1170,1039
3404-001,2013,8,9,16,597,530,1127,1170
3404-001,2013,8,9,17,644,529,1173,1127
3404-001,2013,8,9,18,876,470,1346,1173
3404-001,2013,8,9,19,953,432,1385,1346
3404-001,2013,8,9,20,691,369,1060,1385
3404-001,2013,8,9,21,528,286,814,1060
3404-001,2013,8,9,22,326,192,518,814
3404-001,2013,8,9,23,236,148,384,518
3404-001,2013,8,9,24,111,92,203,384
3404-001,2013,8,10,1,64,69,133,203
3404-001,2013,8,10,2,56,42,98,133
3404-001,2013,8,10,3,40,49,89,98
3404-001,2013,8,10,4,43,56,99,89
3404-001,2013,8,10,5,62,75,137,99
3404-001,2013,8,10,6,84,155,239,137
3404-001,2013,8,10,7,144,283,427,239
3404-001,2013,8,10,8,239,605,844,427
3404-001,2013,8,10,9,367,601,968,844
3404-001,2013,8,10,10,443,490,933,968
3404-001,2013,8,10,11,438,470,908,933
3404-001,2013,8,10,12,431,394,825,908
3404-001,2013,8,10,13,364,377,741,825
3404-001,2013,8,10,14,398,338,736,741
3404-001,2013,8,10,15,486,417,903,736
3404-001,2013,8,10,16,416,334,750,903
3404-001,2013,8,10,17,462,283,745,750
3404-001,2013,8,10,18,571,371,942,745
3404-001,2013,8,10,19,411,286,697,942
3404-001,2013,8,10,20,333,264,597,697
3404-001,2013,8,10,21,258,206,464,597
3404-001,2013,8,10,22,185,152,337,464
3404-001,2013,8,10,23,147,91,238,337
3404-001,2013,8,10,24,72,78,150,238
3404-001,2013,8,11,1,47,51,98,150
3404-001,2013,8,11,2,52,33,85,98
3404-001,2013,8,11,3,33,30,63,85
3404-001,2013,8,11,4,28,24,52,63
3404-001,2013,8,11,5,25,41,66,52
3404-001,2013,8,11,6,51,90,141,66
3404-001,2013,8,11,7,80,132,212,141
3404-001,2013,8,11,8,137,235,372,212
3404-001,2013,8,11,9,194,233,427,372
3404-001,2013,8,11,10,206,243,449,427
3404-001,2013,8,11,11,253,233,486,449
3404-001,2013,8,11,12,235,231,466,486
3404-001,2013,8,11,13,245,238,483,466
3404-001,2013,8,11,14,274,226,500,483
3404-001,2013,8,11,15,322,258,580,500
3404-001,2013,8,11,16,332,254,586,580
3404-001,2013,8,11,17,377,291,668,586
3404-001,2013,8,11,18,416,288,704,668
3404-001,2013,8,11,19,354,249,603,704
3404-001,2013,8,11,20,289,222,511,603
3404-001,2013,8,11,21,226,219,445,511
3404-001,2013,8,11,22,176,188,364,445
3404-001,2013,8,11,23,115,135,250,364
3404-001,2013,8,11,24,68,88,156,250
3404-001,2013,8,12,1,42,77,119,156
3404-001,2013,8,12,2,27,27,54,119
3404-001,2013,8,12,3,18,28,46,54
3404-001,2013,8,12,4,29,46,75,46
3404-001,2013,8,12,5,35,70,105,75
3404-001,2013,8,12,6,78,160,238,105
3404-001,2013,8,12,7,168,553,721,238
3404-001,2013,8,12,8,448,1340,1788,721
3404-001,2013,8,12,9,432,1030,1462,1788
3404-001,2013,8,12,10,496,536,1032,1462
3404-001,2013,8,12,11,520,584,1104,1032
3404-001,2013,8,12,12,488,526,1014,1104
3404-001,2013,8,12,13,451,421,872,1014
3404-001,2013,8,12,14,456,484,940,872
3404-001,2013,8,12,15,565,510,1075,940
3404-001,2013,8,12,16,600,543,1143,1075
3404-001,2013,8,12,17,608,450,1058,1143
3404-001,2013,8,12,18,779,473,1252,1058
3404-001,2013,8,12,19,771,413,1184,1252
3404-001,2013,8,12,20,610,366,976,1184
3404-001,2013,8,12,21,548,240,788,976
3404-001,2013,8,12,22,326,164,490,788
3404-001,2013,8,12,23,197,125,322,490
3404-001,2013,8,12,24,119,110,229,322
3404-001,2013,8,13,1,76,61,137,229
3404-001,2013,8,13,2,50,53,103,137
3404-001,2013,8,13,3,32,32,64,103
3404-001,2013,8,13,4,50,45,95,64
3404-001,2013,8,13,5,50,66,116,95
3404-001,2013,8,13,6,88,156,244,116
3404-001,2013,8,13,7,183,443,626,244
3404-001,2013,8,13,8,408,1253,1661,626
3404-001,2013,8,13,9,517,933,1450,1661
3404-001,2013,8,13,10,538,621,1159,1450
3404-001,2013,8,13,11,556,585,1141,1159
3404-001,2013,8,13,12,505,520,1025,1141
3404-001,2013,8,13,13,472,455,927,1025
3404-001,2013,8,13,14,532,527,1059,927
3404-001,2013,8,13,15,602,545,1147,1059
3404-001,2013,8,13,16,586,490,1076,1147
3404-001,2013,8,13,17,618,462,1080,1076
3404-001,2013,8,13,18,715,425,1140,1080
3404-001,2013,8,13,19,809,385,1194,1140
3404-001,2013,8,13,20,616,348,964,1194
3404-001,2013,8,13,21,508,249,757,964
3404-001,2013,8,13,22,315,181,496,757
3404-001,2013,8,13,23,221,132,353,496
3404-001,2013,8,13,24,102,107,209,353
3404-001,2013,8,14,1,69,64,133,209
3404-001,2013,8,14,2,53,50,103,133
3404-001,2013,8,14,3,34,46,80,103
3404-001,2013,8,14,4,46,31,77,80
3404-001,2013,8,14,5,51,80,131,77
3404-001,2013,8,14,6,81,179,260,131
3404-001,2013,8,14,7,199,481,680,260
3404-001,2013,8,14,8,400,1182,1582,680
3404-001,2013,8,14,9,543,955,1498,1582
3404-001,2013,8,14,10,621,623,1244,1498
3404-001,2013,8,14,11,569,587,1156,1244
3404-001,2013,8,14,12,559,510,1069,1156
3404-001,2013,8,14,13,489,426,915,1069
3404-001,2013,8,14,14,537,494,1031,915
3404-001,2013,8,14,15,596,562,1158,1031
3404-001,2013,8,14,16,631,519,1150,1158
3404-001,2013,8,14,17,646,542,1188,1150
3404-001,2013,8,14,18,894,462,1356,1188
3404-001,2013,8,14,19,929,464,1393,1356
3404-001,2013,8,14,20,654,375,1029,1393
3404-001,2013,8,14,21,522,253,775,1029
3404-001,2013,8,14,22,312,201,513,775
3404-001,2013,8,14,23,207,142,349,513
3404-001,2013,8,14,24,112,115,227,349
3404-001,2013,8,15,1,80,63,143,227
3404-001,2013,8,15,2,40,63,103,143
3404-001,2013,8,15,3,40,31,71,103
3404-001,2013,8,15,4,39,42,81,71
3404-001,2013,8,15,5,61,56,117,81
3404-001,2013,8,15,6,80,160,240,117
3404-001,2013,8,15,7,138,280,418,240
3404-001,2013,8,15,8,258,652,910,418
3404-001,2013,8,15,9,360,533,893,910
3404-001,2013,8,15,10,396,462,858,893
3404-001,2013,8,15,11,345,463,808,858
3404-001,2013,8,15,12,362,403,765,808
3404-001,2013,8,15,13,346,312,658,765
3404-001,2013,8,15,14,343,324,667,658
3404-001,2013,8,15,15,378,313,691,667
3404-001,2013,8,15,16,334,302,636,691
3404-001,2013,8,15,17,415,301,716,636
3404-001,2013,8,15,18,639,331,970,716
3404-001,2013,8,15,19,447,296,743,970
3404-001,2013,8,15,20,357,243,600,743
3404-001,2013,8,15,21,283,198,481,600
3404-001,2013,8,15,22,204,184,388,481
3404-001,2013,8,15,23,123,104,227,388
3404-001,2013,8,15,24,84,74,158,227
3404-001,2013,8,16,1,49,54,103,158
3404-001,2013,8,16,2,32,41,73,103
3404-001,2013,8,16,3,28,28,56,73
3404-001,2013,8,16,4,18,40,58,56
3404-001,2013,8,16,5,50,68,118,58
3404-001,2013,8,16,6,85,156,241,118
3404-001,2013,8,16,7,180,453,633,241
3404-001,2013,8,16,8,357,1149,1506,633
3404-001,2013,8,16,9,500,897,1397,1506
3404-001,2013,8,16,10,482,569,1051,1397
3404-001,2013,8,16,11,523,554,1077,1051
3404-001,2013,8,16,12,518,512,1030,1077
3404-001,2013,8,16,13,488,437,925,1030
3404-001,2013,8,16,14,522,480,1002,925
3404-001,2013,8,16,15,576,506,1082,1002
3404-001,2013,8,16,16,607,548,1155,1082
3404-001,2013,8,16,17,637,440,1077,1155
3404-001,2013,8,16,18,894,508,1402,1077
3404-001,2013,8,16,19,835,382,1217,1402
3404-001,2013,8,16,20,669,312,981,1217
3404-001,2013,8,16,21,482,240,722,981
3404-001,2013,8,16,22,323,170,493,722
3404-001,2013,8,16,23,174,134,308,493
3404-001,2013,8,16,24,103,117,220,308
3404-001,2013,8,17,1,67,58,125,220
3404-001,2013,8,17,2,60,55,115,125
3404-001,2013,8,17,3,46,45,91,115
3404-001,2013,8,17,4,42,46,88,91
3404-001,2013,8,17,5,46,65,111,88
3404-001,2013,8,17,6,79,183,262,111
3404-001,2013,8,17,7,172,307,479,262
3404-001,2013,8,17,8,290,617,907,479
3404-001,2013,8,17,9,392,551,943,907
3404-001,2013,8,17,10,415,482,897,943
3404-001,2013,8,17,11,433,461,894,897
3404-001,2013,8,17,12,423,389,812,894
3404-001,2013,8,17,13,397,364,761,812
3404-001,2013,8,17,14,437,347,784,761
3404-001,2013,8,17,15,455,382,837,784
3404-001,2013,8,17,16,416,370,786,837
3404-001,2013,8,17,17,468,347,815,786
3404-001,2013,8,17,18,639,373,1012,815
3404-001,2013,8,17,19,487,294,781,1012
3404-001,2013,8,17,20,309,265,574,781
3404-001,2013,8,17,21,235,206,441,574
3404-001,2013,8,17,22,187,138,325,441
3404-001,2013,8,17,23,109,121,230,325
3404-001,2013,8,17,24,76,77,153,230
3404-001,2013,8,18,1,71,49,120,153
3404-001,2013,8,18,2,31,34,65,120
3404-001,2013,8,18,3,32,27,59,65
3404-001,2013,8,18,4,28,21,49,59
3404-001,2013,8,18,5,38,27,65,49
3404-001,2013,8,18,6,54,85,139,65
3404-001,2013,8,18,7,73,133,206,139
3404-001,2013,8,18,8,151,195,346,206
3404-001,2013,8,18,9,205,225,430,346
3404-001,2013,8,18,10,205,223,428,430
3404-001,2013,8,18,11,258,249,507,428
3404-001,2013,8,18,12,241,240,481,507
3404-001,2013,8,18,13,245,210,455,481
3404-001,2013,8,18,14,264,234,498,455
3404-001,2013,8,18,15,278,259,537,498
3404-001,2013,8,18,16,318,273,591,537
3404-001,2013,8,18,17,373,261,634,591
3404-001,2013,8,18,18,383,267,650,634
3404-001,2013,8,18,19,323,248,571,650
3404-001,2013,8,18,20,263,228,491,571
3404-001,2013,8,18,21,185,255,440,491
3404-001,2013,8,18,22,145,189,334,440
3404-001,2013,8,18,23,109,138,247,334
3404-001,2013,8,18,24,53,74,127,247
3404-001,2013,8,19,1,46,72,118,127
3404-001,2013,8,19,2,22,42,64,118
3404-001,2013,8,19,3,19,45,64,64
3404-001,2013,8,19,4,19,31,50,64
3404-001,2013,8,19,5,54,65,119,50
3404-001,2013,8,19,6,104,162,266,119
3404-001,2013,8,19,7,205,511,716,266
3404-001,2013,8,19,8,375,1363,1738,716
3404-001,2013,8,19,9,486,1023,1509,1738
3404-001,2013,8,19,10,470,574,1044,1509
3404-001,2013,8,19,11,492,580,1072,1044
3404-001,2013,8,19,12,541,501,1042,1072
3404-001,2013,8,19,13,463,404,867,1042
3404-001,2013,8,19,14,478,528,1006,867
3404-001,2013,8,19,15,582,559,1141,1006
3404-001,2013,8,19,16,600,570,1170,1141
3404-001,2013,8,19,17,601,473,1074,1170
3404-001,2013,8,19,18,765,434,1199,1074
3404-001,2013,8,19,19,773,456,1229,1199
3404-001,2013,8,19,20,610,339,949,1229
3404-001,2013,8,19,21,572,248,820,949
3404-001,2013,8,19,22,358,167,525,820
3404-001,2013,8,19,23,189,136,325,525
3404-001,2013,8,19,24,107,92,199,325
3404-001,2013,8,20,1,88,81,169,199
3404-001,2013,8,20,2,41,57,98,169
3404-001,2013,8,20,3,40,39,79,98
3404-001,2013,8,20,4,44,45,89,79
3404-001,2013,8,20,5,58,71,129,89
3404-001,2013,8,20,6,92,153,245,129
3404-001,2013,8,20,7,165,481,646,245
3404-001,2013,8,20,8,419,1251,1670,646
3404-001,2013,8,20,9,529,1003,1532,1670
3404-001,2013,8,20,10,550,579,1129,1532
3404-001,2013,8,20,11,558,544,1102,1129
3404-001,2013,8,20,12,578,516,1094,1102
3404-001,2013,8,20,13,465,442,907,1094
3404-001,2013,8,20,14,468,519,987,907
3404-001,2013,8,20,15,597,563,1160,987
3404-001,2013,8,20,16,595,526,1121,1160
3404-001,2013,8,20,17,657,483,1140,1121
3404-001,2013,8,20,18,759,447,1206,1140
3404-001,2013,8,20,19,806,401,1207,1206
3404-001,2013,8,20,20,617,319,936,1207
3404-001,2013,8,20,21,535,240,775,936
3404-001,2013,8,20,22,329,177,506,775
3404-001,2013,8,20,23,209,139,348,506
3404-001,2013,8,20,24,102,98,200,348
3404-001,2013,8,21,1,85,68,153,200
3404-001,2013,8,21,2,57,54,111,153
3404-001,2013,8,21,3,30,44,74,111
3404-001,2013,8,21,4,48,39,87,74
3404-001,2013,8,21,5,47,76,123,87
3404-001,2013,8,21,6,86,130,216,123
3404-001,2013,8,21,7,194,473,667,216
3404-001,2013,8,21,8,409,1229,1638,667
3404-001,2013,8,21,9,554,978,1532,1638
3404-001,2013,8,21,10,537,567,1104,1532
3404-001,2013,8,21,11,622,562,1184,1104
3404-001,2013,8,21,12,544,540,1084,1184
3404-001,2013,8,21,13,454,417,871,1084
3404-001,2013,8,21,14,485,537,1022,871
3404-001,2013,8,21,15,538,563,1101,1022
3404-001,2013,8,21,16,671,507,1178,1101
3404-001,2013,8,21,17,622,457,1079,1178
3404-001,2013,8,21,18,822,460,1282,1079
3404-001,2013,8,21,19,813,418,1231,1282
3404-001,2013,8,21,20,597,332,929,1231
3404-001,2013,8,21,21,491,245,736,929
3404-001,2013,8,21,22,329,186,515,736
3404-001,2013,8,21,23,180,132,312,515
3404-001,2013,8,21,24,93,99,192,312
3404-001,2013,8,22,1,79,60,139,192
3404-001,2013,8,22,2,50,47,97,139
3404-001,2013,8,22,3,38,41,79,97
3404-001,2013,8,22,4,36,43,79,79
3404-001,2013,8,22,5,43,68,111,79
3404-001,2013,8,22,6,93,153,246,111
3404-001,2013,8,22,7,186,444,630,246
3404-001,2013,8,22,8,395,1244,1639,630
3404-001,2013,8,22,9,522,1073,1595,1639
3404-001,2013,8,22,10,532,586,1118,1595
3404-001,2013,8,22,11,559,565,1124,1118
3404-001,2013,8,22,12,544,584,1128,1124
3404-001,2013,8,22,13,460,438,898,1128
3404-001,2013,8,22,14,525,498,1023,898
3404-001,2013,8,22,15,632,528,1160,1023
3404-001,2013,8,22,16,594,515,1109,1160
3404-001,2013,8,22,17,624,474,1098,1109
3404-001,2013,8,22,18,753,432,1185,1098
3404-001,2013,8,22,19,790,383,1173,1185
3404-001,2013,8,22,20,602,348,950,1173
3404-001,2013,8,22,21,511,237,748,950
3404-001,2013,8,22,22,365,188,553,748
3404-001,2013,8,22,23,202,166,368,553
3404-001,2013,8,22,24,98,98,196,368
3404-001,2013,8,23,1,82,74,156,196
3404-001,2013,8,23,2,44,50,94,156
3404-001,2013,8,23,3,41,38,79,94
3404-001,2013,8,23,4,56,28,84,79
3404-001,2013,8,23,5,59,55,114,84
3404-001,2013,8,23,6,82,123,205,114
3404-001,2013,8,23,7,136,360,496,205
3404-001,2013,8,23,8,388,1139,1527,496
3404-001,2013,8,23,9,520,1008,1528,1527
3404-001,2013,8,23,10,489,516,1005,1528
3404-001,2013,8,23,11,510,561,1071,1005
3404-001,2013,8,23,12,536,523,1059,1071
3404-001,2013,8,23,13,488,400,888,1059
3404-001,2013,8,23,14,560,542,1102,888
3404-001,2013,8,23,15,582,568,1150,1102
3404-001,2013,8,23,16,579,533,1112,1150
3404-001,2013,8,23,17,623,477,1100,1112
3404-001,2013,8,23,18,841,437,1278,1100
3404-001,2013,8,23,19,855,387,1242,1278
3404-001,2013,8,23,20,654,361,1015,1242
3404-001,2013,8,23,21,496,268,764,1015
3404-001,2013,8,23,22,326,182,508,764
3404-001,2013,8,23,23,182,116,298,508
3404-001,2013,8,23,24,86,94,180,298
3404-001,2013,8,24,1,68,65,133,180
3404-001,2013,8,24,2,61,62,123,133
3404-001,2013,8,24,3,42,37,79,123
3404-001,2013,8,24,4,34,43,77,79
3404-001,2013,8,24,5,63,75,138,77
3404-001,2013,8,24,6,66,140,206,138
3404-001,2013,8,24,7,153,310,463,206
3404-001,2013,8,24,8,280,675,955,463
3404-001,2013,8,24,9,406,573,979,955
3404-001,2013,8,24,10,424,472,896,979
3404-001,2013,8,24,11,458,404,862,896
3404-001,2013,8,24,12,408,419,827,862
3404-001,2013,8,24,13,380,365,745,827
3404-001,2013,8,24,14,438,361,799,745
3404-001,2013,8,24,15,428,368,796,799
3404-001,2013,8,24,16,435,349,784,796
3404-001,2013,8,24,17,526,352,878,784
3404-001,2013,8,24,18,676,396,1072,878
3404-001,2013,8,24,19,436,304,740,1072
3404-001,2013,8,24,20,370,273,643,740
3404-001,2013,8,24,21,277,223,500,643
3404-001,2013,8,24,22,186,146,332,500
3404-001,2013,8,24,23,105,104,209,332
3404-001,2013,8,24,24,66,73,139,209
3404-001,2013,8,25,1,70,47,117,139
3404-001,2013,8,25,2,31,34,65,117
3404-001,2013,8,25,3,40,16,56,65
3404-001,2013,8,25,4,27,26,53,56
3404-001,2013,8,25,5,23,33,56,53
3404-001,2013,8,25,6,45,67,112,56
3404-001,2013,8,25,7,87,137,224,112
3404-001,2013,8,25,8,160,231,391,224
3404-001,2013,8,25,9,188,218,406,391
3404-001,2013,8,25,10,204,232,436,406
3404-001,2013,8,25,11,257,209,466,436
3404-001,2013,8,25,12,249,223,472,466
3404-001,2013,8,25,13,268,245,513,472
3404-001,2013,8,25,14,247,236,483,513
3404-001,2013,8,25,15,311,291,602,483
3404-001,2013,8,25,16,314,298,612,602
3404-001,2013,8,25,17,396,281,677,612
3404-001,2013,8,25,18,417,288,705,677
3404-001,2013,8,25,19,348,263,611,705
3404-001,2013,8,25,20,304,236,540,611
3404-001,2013,8,25,21,239,265,504,540
3404-001,2013,8,25,22,164,206,370,504
3404-001,2013,8,25,23,94,153,247,370
3404-001,2013,8,25,24,60,94,154,247
3404-001,2013,8,26,1,38,67,105,154
3404-001,2013,8,26,2,22,36,58,105
3404-001,2013,8,26,3,20,40,60,58
3404-001,2013,8,26,4,23,33,56,60
3404-001,2013,8,26,5,46,77,123,56
3404-001,2013,8,26,6,91,165,256,123
3404-001,2013,8,26,7,201,530,731,256
3404-001,2013,8,26,8,431,1412,1843,731
3404-001,2013,8,26,9,508,1104,1612,1843
3404-001,2013,8,26,10,537,543,1080,1612
3404-001,2013,8,26,11,553,567,1120,1080
3404-001,2013,8,26,12,577,538,1115,1120
3404-001,2013,8,26,13,452,472,924,1115
3404-001,2013,8,26,14,501,528,1029,924
3404-001,2013,8,26,15,600,602,1202,1029
3404-001,2013,8,26,16,619,572,1191,1202
3404-001,2013,8,26,17,680,480,1160,1191
3404-001,2013,8,26,18,733,440,1173,1160
3404-001,2013,8,26,19,826,424,1250,1173
3404-001,2013,8,26,20,590,303,893,1250
3404-001,2013,8,26,21,558,249,807,893
3404-001,2013,8,26,22,356,180,536,807
3404-001,2013,8,26,23,216,136,352,536
3404-001,2013,8,26,24,104,92,196,352
3404-001,2013,8,27,1,65,64,129,196
3404-001,2013,8,27,2,50,41,91,129
3404-001,2013,8,27,3,40,48,88,91
3404-001,2013,8,27,4,31,51,82,88
3404-001,2013,8,27,5,55,64,119,82
3404-001,2013,8,27,6,104,144,248,119
3404-001,2013,8,27,7,167,453,620,248
3404-001,2013,8,27,8,439,1237,1676,620
3404-001,2013,8,27,9,594,1002,1596,1676
3404-001,2013,8,27,10,572,654,1226,1596
3404-001,2013,8,27,11,563,571,1134,1226
3404-001,2013,8,27,12,519,521,1040,1134
3404-001,2013,8,27,13,453,482,935,1040
3404-001,2013,8,27,14,531,523,1054,935
3404-001,2013,8,27,15,612,577,1189,1054
3404-001,2013,8,27,16,651,535,1186,1189
3404-001,2013,8,27,17,617,445,1062,1186
3404-001,2013,8,27,18,818,435,1253,1062
3404-001,2013,8,27,19,799,439,1238,1253
3404-001,2013,8,27,20,615,338,953,1238
3404-001,2013,8,27,21,510,264,774,953
3404-001,2013,8,27,22,335,195,530,774
3404-001,2013,8,27,23,195,125,320,530
3404-001,2013,8,27,24,86,78,164,320
3404-001,2013,8,28,1,82,62,144,164
3404-001,2013,8,28,2,58,52,110,144
3404-001,2013,8,28,3,38,40,78,110
3404-001,2013,8,28,4,30,38,68,78
3404-001,2013,8,28,5,63,58,121,68
3404-001,2013,8,28,6,83,160,243,121
3404-001,2013,8,28,7,154,415,569,243
3404-001,2013,8,28,8,425,1236,1661,569
3404-001,2013,8,28,9,523,990,1513,1661
3404-001,2013,8,28,10,539,597,1136,1513
3404-001,2013,8,28,11,559,539,1098,1136
3404-001,2013,8,28,12,563,585,1148,1098
3404-001,2013,8,28,13,486,465,951,1148
3404-001,2013,8,28,14,525,549,1074,951
3404-001,2013,8,28,15,610,597,1207,1074
3404-001,2013,8,28,16,653,558,1211,1207
3404-001,2013,8,28,17,638,503,1141,1211
3404-001,2013,8,28,18,863,450,1313,1141
3404-001,2013,8,28,19,841,395,1236,1313
3404-001,2013,8,28,20,606,334,940,1236
3404-001,2013,8,28,21,535,247,782,940
3404-001,2013,8,28,22,325,201,526,782
3404-001,2013,8,28,23,211,136,347,526
3404-001,2013,8,28,24,94,95,189,347
3404-001,2013,8,29,1,69,78,147,189
3404-001,2013,8,29,2,49,58,107,147
3404-001,2013,8,29,3,36,39,75,107
3404-001,2013,8,29,4,48,44,92,75
3404-001,2013,8,29,5,51,64,115,92
3404-001,2013,8,29,6,72,113,185,115
3404-001,2013,8,29,7,156,392,548,185
3404-001,2013,8,29,8,371,1197,1568,548
3404-001,2013,8,29,9,566,1026,1592,1568
3404-001,2013,8,29,10,501,552,1053,1592
3404-001,2013,8,29,11,554,589,1143,1053
3404-001,2013,8,29,12,523,492,1015,1143
3404-001,2013,8,29,13,441,372,813,1015
3404-001,2013,8,29,14,513,457,970,813
3404-001,2013,8,29,15,476,512,988,970
3404-001,2013,8,29,16,598,471,1069,988
3404-001,2013,8,29,17,637,445,1082,1069
3404-001,2013,8,29,18,759,448,1207,1082
3404-001,2013,8,29,19,733,346,1079,1207
3404-001,2013,8,29,20,541,304,845,1079
3404-001,2013,8,29,21,484,236,720,845
3404-001,2013,8,29,22,330,190,520,720
3404-001,2013,8,29,23,185,127,312,520
3404-001,2013,8,29,24,116,108,224,312
3404-001,2013,8,30,1,78,53,131,224
3404-001,2013,8,30,2,52,47,99,131
3404-001,2013,8,30,3,40,43,83,99
3404-001,2013,8,30,4,37,46,83,83
3404-001,2013,8,30,5,51,70,121,83
3404-001,2013,8,30,6,69,157,226,121
3404-001,2013,8,30,7,149,406,555,226
3404-001,2013,8,30,8,380,1204,1584,555
3404-001,2013,8,30,9,556,995,1551,1584
3404-001,2013,8,30,10,504,595,1099,1551
3404-001,2013,8,30,11,555,554,1109,1099
3404-001,2013,8,30,12,638,525,1163,1109
3404-001,2013,8,30,13,510,397,907,1163
3404-001,2013,8,30,14,505,495,1000,907
3404-001,2013,8,30,15,622,579,1201,1000
3404-001,2013,8,30,16,587,542,1129,1201
3404-001,2013,8,30,17,658,533,1191,1129
3404-001,2013,8,30,18,917,443,1360,1191
3404-001,2013,8,30,19,909,428,1337,1360
3404-001,2013,8,30,20,705,366,1071,1337
3404-001,2013,8,30,21,531,264,795,1071
3404-001,2013,8,30,22,336,181,517,795
3404-001,2013,8,30,23,205,138,343,517
3404-001,2013,8,30,24,131,115,246,343
3404-001,2013,8,31,1,92,90,182,246
3404-001,2013,8,31,2,48,55,103,182
3404-001,2013,8,31,3,40,38,78,103
3404-001,2013,8,31,4,27,48,75,78
3404-001,2013,8,31,5,50,57,107,75
3404-001,2013,8,31,6,99,167,266,107
3404-001,2013,8,31,7,165,284,449,266
3404-001,2013,8,31,8,319,673,992,449
3404-001,2013,8,31,9,432,592,1024,992
3404-001,2013,8,31,10,467,496,963,1024
3404-001,2013,8,31,11,411,491,902,963
3404-001,2013,8,31,12,438,487,925,902
3404-001,2013,8,31,13,368,377,745,925
3404-001,2013,8,31,14,413,388,801,745
3404-001,2013,8,31,15,425,452,877,801
3404-001,2013,8,31,16,483,379,862,877
3404-001,2013,8,31,17,541,397,938,862
3404-001,2013,8,31,18,694,373,1067,938
3404-001,2013,8,31,19,507,327,834,1067
3404-001,2013,8,31,20,377,309,686,834
3404-001,2013,8,31,21,254,234,488,686
3404-001,2013,8,31,22,176,165,341,488
3404-001,2013,8,31,23,112,104,216,341
3404-001,2013,8,31,24,70,82,152,216
3404-001,2013,9,1,1,64,40,104,152
3404-001,2013,9,1,2,31,25,56,104
3404-001,2013,9,1,3,30,30,60,56
3404-001,2013,9,1,4,24,20,44,60
3404-001,2013,9,1,5,28,35,63,44
3404-001,2013,9,1,6,57,68,125,63
3404-001,2013,9,1,7,112,166,278,125
3404-001,2013,9,1,8,192,287,479,278
3404-001,2013,9,1,9,230,216,446,479
3404-001,2013,9,1,10,229,230,459,446
3404-001,2013,9,1,11,240,274,514,459
3404-001,2013,9,1,12,251,287,538,514
3404-001,2013,9,1,13,299,267,566,538
3404-001,2013,9,1,14,293,289,582,566
3404-001,2013,9,1,15,326,299,625,582
3404-001,2013,9,1,16,369,306,675,625
3404-001,2013,9,1,17,422,297,719,675
3404-001,2013,9,1,18,652,333,985,719
3404-001,2013,9,1,19,577,308,885,985
3404-001,2013,9,1,20,353,262,615,885
3404-001,2013,9,1,21,252,254,506,615
3404-001,2013,9,1,22,255,241,496,506
3404-001,2013,9,1,23,115,202,317,496
3404-001,2013,9,1,24,79,122,201,317
3404-001,2013,9,2,1,47,63,110,201
3404-001,2013,9,2,2,23,36,59,110
3404-001,2013,9,2,3,15,34,49,59
3404-001,2013,9,2,4,22,35,57,49
3404-001,2013,9,2,5,41,54,95,57
3404-001,2013,9,2,6,89,172,261,95
3404-001,2013,9,2,7,189,511,700,261
3404-001,2013,9,2,8,473,1447,1920,700
3404-001,2013,9,2,9,504,1123,1627,1920
3404-001,2013,9,2,10,498,601,1099,1627
3404-001,2013,9,2,11,553,530,1083,1099
3404-001,2013,9,2,12,536,541,1077,1083
3404-001,2013,9,2,13,474,448,922,1077
3404-001,2013,9,2,14,526,547,1073,922
3404-001,2013,9,2,15,608,582,1190,1073
3404-001,2013,9,2,16,577,530,1107,1190
3404-001,2013,9,2,17,614,507,1121,1107
3404-001,2013,9,2,18,806,469,1275,1121
3404-001,2013,9,2,19,802,382,1184,1275
3404-001,2013,9,2,20,678,335,1013,1184
3404-001,2013,9,2,21,572,230,802,1013
3404-001,2013,9,2,22,327,192,519,802
3404-001,2013,9,2,23,178,140,318,519
3404-001,2013,9,2,24,96,93,189,318
3404-001,2013,9,3,1,63,47,110,189
3404-001,2013,9,3,2,45,49,94,110
3404-001,2013,9,3,3,32,47,79,94
3404-001,2013,9,3,4,40,51,91,79
3404-001,2013,9,3,5,50,77,127,91
3404-001,2013,9,3,6,105,128,233,127
3404-001,2013,9,3,7,178,463,641,233
3404-001,2013,9,3,8,442,1335,1777,641
3404-001,2013,9,3,9,567,1070,1637,1777
3404-001,2013,9,3,10,554,644,1198,1637
3404-001,2013,9,3,11,561,618,1179,1198
3404-001,2013,9,3,12,559,524,1083,1179
3404-001,2013,9,3,13,439,449,888,1083
3404-001,2013,9,3,14,525,528,1053,888
3404-001,2013,9,3,15,608,575,1183,1053
3404-001,2013,9,3,16,610,548,1158,1183
3404-001,2013,9,3,17,632,522,1154,1158
3404-001,2013,9,3,18,848,485,1333,1154
3404-001,2013,9,3,19,810,415,1225,1333
3404-001,2013,9,3,20,658,359,1017,1225
3404-001,2013,9,3,21,541,239,780,1017
3404-001,2013,9,3,22,330,179,509,780
3404-001,2013,9,3,23,202,124,326,509
3404-001,2013,9,3,24,113,97,210,326
3404-001,2013,9,4,1,62,76,138,210
3404-001,2013,9,4,2,32,35,67,138
3404-001,2013,9,4,3,31,36,67,67
3404-001,2013,9,4,4,33,30,63,67
3404-001,2013,9,4,5,57,57,114,63
3404-001,2013,9,4,6,97,171,268,114
3404-001,2013,9,4,7,173,447,620,268
3404-001,2013,9,4,8,430,1307,1737,620
3404-001,2013,9,4,9,608,1033,1641,1737
3404-001,2013,9,4,10,530,623,1153,1641
3404-001,2013,9,4,11,551,553,1104,1153
3404-001,2013,9,4,12,590,521,1111,1104
3404-001,2013,9,4,13,482,477,959,1111
3404-001,2013,9,4,14,508,527,1035,959
3404-001,2013,9,4,15,601,563,1164,1035
3404-001,2013,9,4,16,601,528,1129,1164
3404-001,2013,9,4,17,609,514,1123,1129
3404-001,2013,9,4,18,879,489,1368,1123
3404-001,2013,9,4,19,842,423,1265,1368
3404-001,2013,9,4,20,628,359,987,1265
3404-001,2013,9,4,21,503,251,754,987
3404-001,2013,9,4,22,335,186,521,754
3404-001,2013,9,4,23,162,109,271,521
3404-001,2013,9,4,24,111,89,200,271
3404-001,2013,9,5,1,72,66,138,200
3404-001,2013,9,5,2,38,44,82,138
3404-001,2013,9,5,3,20,36,56,82
3404-001,2013,9,5,4,30,31,61,56
3404-001,2013,9,5,5,57,67,124,61
3404-001,2013,9,5,6,87,130,217,124
3404-001,2013,9,5,7,188,444,632,217
3404-001,2013,9,5,8,468,1274,1742,632
3404-001,2013,9,5,9,544,1062,1606,1742
3404-001,2013,9,5,10,545,602,1147,1606
3404-001,2013,9,5,11,508,582,1090,1147
3404-001,2013,9,5,12,570,515,1085,1090
3404-001,2013,9,5,13,470,482,952,1085
3404-001,2013,9,5,14,542,517,1059,952
3404-001,2013,9,5,15,632,617,1249,1059
3404-001,2013,9,5,16,620,563,1183,1249
3404-001,2013,9,5,17,588,468,1056,1183
3404-001,2013,9,5,18,899,473,1372,1056
3404-001,2013,9,5,19,863,413,1276,1372
3404-001,2013,9,5,20,614,346,960,1276
3404-001,2013,9,5,21,523,244,767,960
3404-001,2013,9,5,22,350,191,541,767
3404-001,2013,9,5,23,189,140,329,541
3404-001,2013,9,5,24,103,103,206,329
3404-001,2013,9,6,1,66,64,130,206
3404-001,2013,9,6,2,46,33,79,130
3404-001,2013,9,6,3,23,41,64,79
3404-001,2013,9,6,4,33,36,69,64
3404-001,2013,9,6,5,58,87,145,69
3404-001,2013,9,6,6,97,144,241,145
3404-001,2013,9,6,7,195,404,599,241
3404-001,2013,9,6,8,444,1245,1689,599
3404-001,2013,9,6,9,593,1039,1632,1689
3404-001,2013,9,6,10,584,650,1234,1632
3404-001,2013,9,6,11,582,617,1199,1234
3404-001,2013,9,6,12,576,569,1145,1199
3404-001,2013,9,6,13,542,493,1035,1145
3404-001,2013,9,6,14,588,495,1083,1035
3404-001,2013,9,6,15,658,581,1239,1083
3404-001,2013,9,6,16,634,517,1151,1239
3404-001,2013,9,6,17,691,551,1242,1151
3404-001,2013,9,6,18,883,485,1368,1242
3404-001,2013,9,6,19,968,424,1392,1368
3404-001,2013,9,6,20,752,394,1146,1392
3404-001,2013,9,6,21,495,249,744,1146
3404-001,2013,9,6,22,327,196,523,744
3404-001,2013,9,6,23,185,127,312,523
3404-001,2013,9,6,24,98,95,193,312
3404-001,2013,9,7,1,73,64,137,193
3404-001,2013,9,7,2,47,50,97,137
3404-001,2013,9,7,3,35,33,68,97
3404-001,2013,9,7,4,48,36,84,68
3404-001,2013,9,7,5,50,72,122,84
3404-001,2013,9,7,6,87,163,250,122
3404-001,2013,9,7,7,177,324,501,250
3404-001,2013,9,7,8,337,684,1021,501
3404-001,2013,9,7,9,457,607,1064,1021
3404-001,2013,9,7,10,438,536,974,1064
3404-001,2013,9,7,11,449,467,916,974
3404-001,2013,9,7,12,447,451,898,916
3404-001,2013,9,7,13,399,415,814,898
3404-001,2013,9,7,14,445,441,886,814
3404-001,2013,9,7,15,474,412,886,886
3404-001,2013,9,7,16,421,393,814,886
3404-001,2013,9,7,17,488,374,862,814
3404-001,2013,9,7,18,666,402,1068,862
3404-001,2013,9,7,19,575,360,935,1068
3404-001,2013,9,7,20,398,272,670,935
3404-001,2013,9,7,21,275,218,493,670
3404-001,2013,9,7,22,230,163,393,493
3404-001,2013,9,7,23,130,119,249,393
3404-001,2013,9,7,24,87,90,177,249
3404-001,2013,9,8,1,51,50,101,177
3404-001,2013,9,8,2,43,36,79,101
3404-001,2013,9,8,3,31,25,56,79
3404-001,2013,9,8,4,24,23,47,56
3404-001,2013,9,8,5,34,25,59,47
3404-001,2013,9,8,6,41,64,105,59
3404-001,2013,9,8,7,108,176,284,105
3404-001,2013,9,8,8,171,278,449,284
3404-001,2013,9,8,9,247,254,501,449
3404-001,2013,9,8,10,234,269,503,501
3404-001,2013,9,8,11,232,268,500,503
3404-001,2013,9,8,12,284,274,558,500
3404-001,2013,9,8,13,302,291,593,558
3404-001,2013,9,8,14,333,303,636,593
3404-001,2013,9,8,15,355,312,667,636
3404-001,2013,9,8,16,380,344,724,667
3404-001,2013,9,8,17,440,307,747,724
3404-001,2013,9,8,18,459,323,782,747
3404-001,2013,9,8,19,365,328,693,782
3404-001,2013,9,8,20,285,251,536,693
3404-001,2013,9,8,21,230,258,488,536
3404-001,2013,9,8,22,173,215,388,488
3404-001,2013,9,8,23,106,125,231,388
3404-001,2013,9,8,24,55,92,147,231
3404-001,2013,9,9,1,38,59,97,147
3404-001,2013,9,9,2,15,39,54,97
3404-001,2013,9,9,3,17,37,54,54
3404-001,2013,9,9,4,29,31,60,54
3404-001,2013,9,9,5,46,65,111,60
3404-001,2013,9,9,6,83,158,241,111
3404-001,2013,9,9,7,197,515,712,241
3404-001,2013,9,9,8,491,1527,2018,712
3404-001,2013,9,9,9,491,1175,1666,2018
3404-001,2013,9,9,10,536,593,1129,1666
3404-001,2013,9,9,11,563,604,1167,1129
3404-001,2013,9,9,12,555,587,1142,1167
3404-001,2013,9,9,13,515,493,1008,1142
3404-001,2013,9,9,14,547,552,1099,1008
3404-001,2013,9,9,15,639,624,1263,1099
3404-001,2013,9,9,16,614,601,1215,1263
3404-001,2013,9,9,17,667,537,1204,1215
3404-001,2013,9,9,18,900,509,1409,1204
3404-001,2013,9,9,19,925,414,1339,1409
3404-001,2013,9,9,20,651,312,963,1339
3404-001,2013,9,9,21,529,228,757,963
3404-001,2013,9,9,22,338,186,524,757
3404-001,2013,9,9,23,185,122,307,524
3404-001,2013,9,9,24,94,85,179,307
3404-001,2013,9,10,1,64,71,135,179
3404-001,2013,9,10,2,38,42,80,135
3404-001,2013,9,10,3,22,39,61,80
3404-001,2013,9,10,4,28,40,68,61
3404-001,2013,9,10,5,59,74,133,68
3404-001,2013,9,10,6,90,143,233,133
3404-001,2013,9,10,7,178,429,607,233
3404-001,2013,9,10,8,434,1244,1678,607
3404-001,2013,9,10,9,598,1157,1755,1678
3404-001,2013,9,10,10,573,637,1210,1755
3404-001,2013,9,10,11,586,667,1253,1210
3404-001,2013,9,10,12,571,592,1163,1253
3404-001,2013,9,10,13,520,525,1045,1163
3404-001,2013,9,10,14,564,557,1121,1045
3404-001,2013,9,10,15,639,608,1247,1121
3404-001,2013,9,10,16,605,613,1218,1247
3404-001,2013,9,10,17,685,519,1204,1218
3404-001,2013,9,10,18,929,478,1407,1204
3404-001,2013,9,10,19,869,398,1267,1407
3404-001,2013,9,10,20,637,324,961,1267
3404-001,2013,9,10,21,534,246,780,961
3404-001,2013,9,10,22,311,189,500,780
3404-001,2013,9,10,23,179,124,303,500
3404-001,2013,9,10,24,116,93,209,303
3404-001,2013,9,11,1,75,79,154,209
3404-001,2013,9,11,2,38,35,73,154
3404-001,2013,9,11,3,37,37,74,73
3404-001,2013,9,11,4,33,41,74,74
3404-001,2013,9,11,5,55,65,120,74
3404-001,2013,9,11,6,72,113,185,120
3404-001,2013,9,11,7,134,356,490,185
3404-001,2013,9,11,8,402,1199,1601,490
3404-001,2013,9,11,9,548,1086,1634,1601
3404-001,2013,9,11,10,560,559,1119,1634
3404-001,2013,9,11,11,561,579,1140,1119
3404-001,2013,9,11,12,558,576,1134,1140
3404-001,2013,9,11,13,521,469,990,1134
3404-001,2013,9,11,14,544,560,1104,990
3404-001,2013,9,11,15,696,583,1279,1104
3404-001,2013,9,11,16,653,555,1208,1279
3404-001,2013,9,11,17,646,501,1147,1208
3404-001,2013,9,11,18,873,442,1315,1147
3404-001,2013,9,11,19,851,451,1302,1315
3404-001,2013,9,11,20,604,337,941,1302
3404-001,2013,9,11,21,470,232,702,941
3404-001,2013,9,11,22,361,203,564,702
3404-001,2013,9,11,23,201,147,348,564
3404-001,2013,9,11,24,116,97,213,348
3404-001,2013,9,12,1,72,60,132,213
3404-001,2013,9,12,2,43,53,96,132
3404-001,2013,9,12,3,33,41,74,96
3404-001,2013,9,12,4,40,43,83,74
3404-001,2013,9,12,5,56,70,126,83
3404-001,2013,9,12,6,86,150,236,126
3404-001,2013,9,12,7,185,432,617,236
3404-001,2013,9,12,8,472,1252,1724,617
3404-001,2013,9,12,9,546,1063,1609,1724
3404-001,2013,9,12,10,548,670,1218,1609
3404-001,2013,9,12,11,632,589,1221,1218
3404-001,2013,9,12,12,612,579,1191,1221
3404-001,2013,9,12,13,527,511,1038,1191
3404-001,2013,9,12,14,554,590,1144,1038
3404-001,2013,9,12,15,664,680,1344,1144
3404-001,2013,9,12,16,675,650,1325,1344
3404-001,2013,9,12,17,722,571,1293,1325
3404-001,2013,9,12,18,835,485,1320,1293
3404-001,2013,9,12,19,873,423,1296,1320
3404-001,2013,9,12,20,628,325,953,1296
3404-001,2013,9,12,21,569,229,798,953
3404-001,2013,9,12,22,362,215,577,798
3404-001,2013,9,12,23,181,153,334,577
3404-001,2013,9,12,24,101,119,220,334
3404-001,2013,9,13,1,91,56,147,220
3404-001,2013,9,13,2,59,54,113,147
3404-001,2013,9,13,3,26,38,64,113
3404-001,2013,9,13,4,45,41,86,64
3404-001,2013,9,13,5,49,71,120,86
3404-001,2013,9,13,6,69,106,175,120
3404-001,2013,9,13,7,167,374,541,175
3404-001,2013,9,13,8,435,1286,1721,541
3404-001,2013,9,13,9,547,1084,1631,1721
3404-001,2013,9,13,10,570,613,1183,1631
3404-001,2013,9,13,11,631,623,1254,1183
3404-001,2013,9,13,12,601,586,1187,1254
3404-001,2013,9,13,13,539,493,1032,1187
3404-001,2013,9,13,14,583,573,1156,1032
3404-001,2013,9,13,15,712,611,1323,1156
3404-001,2013,9,13,16,661,573,1234,1323
3404-001,2013,9,13,17,680,537,1217,1234
3404-001,2013,9,13,18,947,482,1429,1217
3404-001,2013,9,13,19,1003,460,1463,1429
3404-001,2013,9,13,20,734,365,1099,1463
3404-001,2013,9,13,21,486,241,727,1099
3404-001,2013,9,13,22,354,198,552,727
3404-001,2013,9,13,23,198,156,354,552
3404-001,2013,9,13,24,125,106,231,354
3404-001,2013,9,14,1,71,75,146,231
3404-001,2013,9,14,2,64,55,119,146
3404-001,2013,9,14,3,38,44,82,119
3404-001,2013,9,14,4,37,44,81,82
3404-001,2013,9,14,5,61,46,107,81
3404-001,2013,9,14,6,65,145,210,107
3404-001,2013,9,14,7,127,240,367,210
3404-001,2013,9,14,8,289,635,924,367
3404-001,2013,9,14,9,391,609,1000,924
3404-001,2013,9,14,10,450,460,910,1000
3404-001,2013,9,14,11,486,490,976,910
3404-001,2013,9,14,12,406,425,831,976
3404-001,2013,9,14,13,473,422,895,831
3404-001,2013,9,14,14,463,434,897,895
3404-001,2013,9,14,15,447,401,848,897
3404-001,2013,9,14,16,452,385,837,848
3404-001,2013,9,14,17,489,383,872,837
3404-001,2013,9,14,18,609,405,1014,872
3404-001,2013,9,14,19,444,366,810,1014
3404-001,2013,9,14,20,339,261,600,810
3404-001,2013,9,14,21,250,204,454,600
3404-001,2013,9,14,22,186,156,342,454
3404-001,2013,9,14,23,137,78,215,342
3404-001,2013,9,14,24,81,65,146,215
3404-001,2013,9,15,1,57,61,118,146
3404-001,2013,9,15,2,45,37,82,118
3404-001,2013,9,15,3,31,30,61,82
3404-001,2013,9,15,4,23,26,49,61
3404-001,2013,9,15,5,36,40,76,49
3404-001,2013,9,15,6,37,70,107,76
3404-001,2013,9,15,7,83,204,287,107
3404-001,2013,9,15,8,182,327,509,287
3404-001,2013,9,15,9,213,267,480,509
3404-001,2013,9,15,10,246,257,503,480
3404-001,2013,9,15,11,249,316,565,503
3404-001,2013,9,15,12,303,335,638,565
3404-001,2013,9,15,13,301,323,624,638
3404-001,2013,9,15,14,279,306,585,624
3404-001,2013,9,15,15,333,308,641,585
3404-001,2013,9,15,16,386,275,661,641
3404-001,2013,9,15,17,409,296,705,661
3404-001,2013,9,15,18,440,282,722,705
3404-001,2013,9,15,19,397,318,715,722
3404-001,2013,9,15,20,317,231,548,715
3404-001,2013,9,15,21,236,170,406,548
3404-001,2013,9,15,22,156,177,333,406
3404-001,2013,9,15,23,114,133,247,333
3404-001,2013,9,15,24,60,72,132,247
3404-001,2013,9,16,1,63,67,130,132
3404-001,2013,9,16,2,23,45,68,130
3404-001,2013,9,16,3,14,30,44,68
3404-001,2013,9,16,4,23,39,62,44
3404-001,2013,9,16,5,38,77,115,62
3404-001,2013,9,16,6,83,134,217,115
3404-001,2013,9,16,7,170,433,603,217
3404-001,2013,9,16,8,422,1409,1831,603
3404-001,2013,9,16,9,498,1147,1645,1831
3404-001,2013,9,16,10,570,609,1179,1645
3404-001,2013,9,16,11,575,629,1204,1179
3404-001,2013,9,16,12,565,592,1157,1204
3404-001,2013,9,16,13,520,538,1058,1157
3404-001,2013,9,16,14,573,548,1121,1058
3404-001,2013,9,16,15,804,683,1487,1121
3404-001,2013,9,16,16,706,659,1365,1487
3404-001,2013,9,16,17,674,566,1240,1365
3404-001,2013,9,16,18,882,505,1387,1240
3404-001,2013,9,16,19,941,483,1424,1387
3404-001,2013,9,16,20,734,391,1125,1424
3404-001,2013,9,16,21,528,265,793,1125
3404-001,2013,9,16,22,385,198,583,793
3404-001,2013,9,16,23,185,159,344,583
3404-001,2013,9,16,24,97,101,198,344
3404-001,2013,9,17,1,101,68,169,198
3404-001,2013,9,17,2,49,49,98,169
3404-001,2013,9,17,3,38,30,68,98
3404-001,2013,9,17,4,37,49,86,68
3404-001,2013,9,17,5,43,69,112,86
3404-001,2013,9,17,6,78,139,217,112
3404-001,2013,9,17,7,139,372,511,217
3404-001,2013,9,17,8,406,1161,1567,511
3404-001,2013,9,17,9,528,977,1505,1567
3404-001,2013,9,17,10,524,588,1112,1505
3404-001,2013,9,17,11,586,548,1134,1112
3404-001,2013,9,17,12,552,530,1082,1134
3404-001,2013,9,17,13,496,438,934,1082
3404-001,2013,9,17,14,607,483,1090,934
3404-001,2013,9,17,15,627,431,1058,1090
3404-001,2013,9,17,16,763,449,1212,1058
3404-001,2013,9,17,17,705,456,1161,1212
3404-001,2013,9,17,18,953,398,1351,1161
3404-001,2013,9,17,19,689,386,1075,1351
3404-001,2013,9,17,20,502,317,819,1075
3404-001,2013,9,17,21,351,237,588,819
3404-001,2013,9,17,22,307,201,508,588
3404-001,2013,9,17,23,216,128,344,508
3404-001,2013,9,17,24,104,96,200,344
3404-001,2013,9,18,1,76,55,131,200
3404-001,2013,9,18,2,71,56,127,131
3404-001,2013,9,18,3,62,47,109,127
3404-001,2013,9,18,4,58,33,91,109
3404-001,2013,9,18,5,70,44,114,91
3404-001,2013,9,18,6,226,75,301,114
3404-001,2013,9,18,7,158,89,247,301
3404-001,2013,9,18,8,217,142,359,247
3404-001,2013,9,18,9,247,237,484,359
3404-001,2013,9,18,10,229,389,618,484
3404-001,2013,9,18,11,289,415,704,618
3404-001,2013,9,18,12,289,367,656,704
3404-001,2013,9,18,13,305,376,681,656
3404-001,2013,9,18,14,235,385,620,681
3404-001,2013,9,18,15,236,359,595,620
3404-001,2013,9,18,16,222,267,489,595
3404-001,2013,9,18,17,182,172,354,489
3404-001,2013,9,18,18,206,182,388,354
3404-001,2013,9,18,19,157,156,313,388
3404-001,2013,9,18,20,164,125,289,313
3404-001,2013,9,18,21,126,120,246,289
3404-001,2013,9,18,22,96,101,197,246
3404-001,2013,9,18,23,77,53,130,197
3404-001,2013,9,18,24,48,37,85,130
3404-001,2013,9,19,1,33,29,62,85
3404-001,2013,9,19,2,23,20,43,62
3404-001,2013,9,19,3,18,7,25,43
3404-001,2013,9,19,4,18,8,26,25
3404-001,2013,9,19,5,13,12,25,26
3404-001,2013,9,19,6,24,36,60,25
3404-001,2013,9,19,7,91,77,168,60
3404-001,2013,9,19,8,151,171,322,168
3404-001,2013,9,19,9,144,171,315,322
3404-001,2013,9,19,10,239,204,443,315
3404-001,2013,9,19,11,371,308,679,443
3404-001,2013,9,19,12,428,381,809,679
3404-001,2013,9,19,13,452,393,845,809
3404-001,2013,9,19,14,558,343,901,845
3404-001,2013,9,19,15,531,356,887,901
3404-001,2013,9,19,16,581,376,957,887
3404-001,2013,9,19,17,609,387,996,957
3404-001,2013,9,19,18,450,414,864,996
3404-001,2013,9,19,19,333,247,580,864
3404-001,2013,9,19,20,230,279,509,580
3404-001,2013,9,19,21,154,298,452,509
3404-001,2013,9,19,22,148,154,302,452
3404-001,2013,9,19,23,106,75,181,302
3404-001,2013,9,19,24,65,56,121,181
3404-001,2013,9,20,1,43,33,76,121
3404-001,2013,9,20,2,25,36,61,76
3404-001,2013,9,20,3,16,27,43,61
3404-001,2013,9,20,4,12,12,24,43
3404-001,2013,9,20,5,17,29,46,24
3404-001,2013,9,20,6,22,38,60,46
3404-001,2013,9,20,7,30,68,98,60
3404-001,2013,9,20,8,74,115,189,98
3404-001,2013,9,20,9,80,124,204,189
3404-001,2013,9,20,10,145,192,337,204
3404-001,2013,9,20,11,223,259,482,337
3404-001,2013,9,20,12,256,329,585,482
3404-001,2013,9,20,13,248,291,539,585
3404-001,2013,9,20,14,241,326,567,539
3404-001,2013,9,20,15,327,310,637,567
3404-001,2013,9,20,16,358,249,607,637
3404-001,2013,9,20,17,364,268,632,607
3404-001,2013,9,20,18,414,236,650,632
3404-001,2013,9,20,19,321,209,530,650
3404-001,2013,9,20,20,324,181,505,530
3404-001,2013,9,20,21,241,146,387,505
3404-001,2013,9,20,22,150,152,302,387
3404-001,2013,9,20,23,145,120,265,302
3404-001,2013,9,20,24,68,115,183,265
3404-001,2013,9,21,1,52,48,100,183
3404-001,2013,9,21,2,38,48,86,100
3404-001,2013,9,21,3,15,34,49,86
3404-001,2013,9,21,4,17,24,41,49
3404-001,2013,9,21,5,27,47,74,41
3404-001,2013,9,21,6,30,59,89,74
3404-001,2013,9,21,7,74,119,193,89
3404-001,2013,9,21,8,136,247,383,193
3404-001,2013,9,21,9,163,243,406,383
3404-001,2013,9,21,10,221,229,450,406
3404-001,2013,9,21,11,295,333,628,450
3404-001,2013,9,21,12,293,367,660,628
3404-001,2013,9,21,13,306,314,620,660
3404-001,2013,9,21,14,315,310,625,620
3404-001,2013,9,21,15,342,277,619,625
3404-001,2013,9,21,16,357,276,633,619
3404-001,2013,9,21,17,354,270,624,633
3404-001,2013,9,21,18,453,267,720,624
3404-001,2013,9,21,19,376,249,625,720
3404-001,2013,9,21,20,272,186,458,625
3404-001,2013,9,21,21,219,279,498,458
3404-001,2013,9,21,22,161,192,353,498
3404-001,2013,9,21,23,109,116,225,353
3404-001,2013,9,21,24,78,74,152,225
3404-001,2013,9,22,1,60,55,115,152
3404-001,2013,9,22,2,42,27,69,115
3404-001,2013,9,22,3,29,33,62,69
3404-001,2013,9,22,4,29,34,63,62
3404-001,2013,9,22,5,15,22,37,63
3404-001,2013,9,22,6,35,53,88,37
3404-001,2013,9,22,7,52,87,139,88
3404-001,2013,9,22,8,116,216,332,139
3404-001,2013,9,22,9,158,216,374,332
3404-001,2013,9,22,10,149,214,363,374
3404-001,2013,9,22,11,184,240,424,363
3404-001,2013,9,22,12,220,259,479,424
3404-001,2013,9,22,13,229,256,485,479
3404-001,2013,9,22,14,259,291,550,485
3404-001,2013,9,22,15,294,287,581,550
3404-001,2013,9,22,16,286,263,549,581
3404-001,2013,9,22,17,370,246,616,549
3404-001,2013,9,22,18,352,261,613,616
3404-001,2013,9,22,19,301,255,556,613
3404-001,2013,9,22,20,272,211,483,556
3404-001,2013,9,22,21,182,183,365,483
3404-001,2013,9,22,22,150,158,308,365
3404-001,2013,9,22,23,79,129,208,308
3404-001,2013,9,22,24,52,106,158,208
3404-001,2013,9,23,1,45,80,125,158
3404-001,2013,9,23,2,23,45,68,125
3404-001,2013,9,23,3,18,43,61,68
3404-001,2013,9,23,4,14,30,44,61
3404-001,2013,9,23,5,49,76,125,44
3404-001,2013,9,23,6,79,176,255,125
3404-001,2013,9,23,7,194,481,675,255
3404-001,2013,9,23,8,420,1503,1923,675
3404-001,2013,9,23,9,538,1173,1711,1923
3404-001,2013,9,23,10,481,542,1023,1711
3404-001,2013,9,23,11,564,569,1133,1023
3404-001,2013,9,23,12,508,569,1077,1133
3404-001,2013,9,23,13,473,517,990,1077
3404-001,2013,9,23,14,504,560,1064,990
3404-001,2013,9,23,15,605,583,1188,1064
3404-001,2013,9,23,16,610,563,1173,1188
3404-001,2013,9,23,17,623,486,1109,1173
3404-001,2013,9,23,18,787,496,1283,1109
3404-001,2013,9,23,19,838,398,1236,1283
3404-001,2013,9,23,20,633,317,950,1236
3404-001,2013,9,23,21,543,245,788,950
3404-001,2013,9,23,22,344,171,515,788
3404-001,2013,9,23,23,174,127,301,515
3404-001,2013,9,23,24,103,112,215,301
3404-001,2013,9,24,1,80,62,142,215
3404-001,2013,9,24,2,56,49,105,142
3404-001,2013,9,24,3,48,46,94,105
3404-001,2013,9,24,4,31,62,93,94
3404-001,2013,9,24,5,55,71,126,93
3404-001,2013,9,24,6,69,142,211,126
3404-001,2013,9,24,7,188,394,582,211
3404-001,2013,9,24,8,421,1272,1693,582
3404-001,2013,9,24,9,594,1173,1767,1693
3404-001,2013,9,24,10,585,636,1221,1767
3404-001,2013,9,24,11,580,586,1166,1221
3404-001,2013,9,24,12,570,545,1115,1166
3404-001,2013,9,24,13,509,469,978,1115
3404-001,2013,9,24,14,529,520,1049,978
3404-001,2013,9,24,15,578,562,1140,1049
3404-001,2013,9,24,16,589,565,1154,1140
3404-001,2013,9,24,17,620,443,1063,1154
3404-001,2013,9,24,18,772,456,1228,1063
3404-001,2013,9,24,19,792,352,1144,1228
3404-001,2013,9,24,20,587,326,913,1144
3404-001,2013,9,24,21,519,234,753,913
3404-001,2013,9,24,22,350,184,534,753
3404-001,2013,9,24,23,165,120,285,534
3404-001,2013,9,24,24,96,101,197,285
3404-001,2013,9,25,1,80,67,147,197
3404-001,2013,9,25,2,53,58,111,147
3404-001,2013,9,25,3,33,43,76,111
3404-001,2013,9,25,4,40,45,85,76
3404-001,2013,9,25,5,56,87,143,85
3404-001,2013,9,25,6,88,133,221,143
3404-001,2013,9,25,7,142,389,531,221
3404-001,2013,9,25,8,406,1209,1615,531
3404-001,2013,9,25,9,606,1082,1688,1615
3404-001,2013,9,25,10,580,602,1182,1688
3404-001,2013,9,25,11,567,569,1136,1182
3404-001,2013,9,25,12,579,593,1172,1136
3404-001,2013,9,25,13,480,500,980,1172
3404-001,2013,9,25,14,474,566,1040,980
3404-001,2013,9,25,15,628,589,1217,1040
3404-001,2013,9,25,16,628,560,1188,1217
3404-001,2013,9,25,17,656,484,1140,1188
3404-001,2013,9,25,18,853,504,1357,1140
3404-001,2013,9,25,19,884,417,1301,1357
3404-001,2013,9,25,20,646,346,992,1301
3404-001,2013,9,25,21,520,246,766,992
3404-001,2013,9,25,22,375,195,570,766
3404-001,2013,9,25,23,223,142,365,570
3404-001,2013,9,25,24,116,102,218,365
3404-001,2013,9,26,1,83,70,153,218
3404-001,2013,9,26,2,50,61,111,153
3404-001,2013,9,26,3,47,52,99,111
3404-001,2013,9,26,4,39,48,87,99
3404-001,2013,9,26,5,49,78,127,87
3404-001,2013,9,26,6,90,161,251,127
3404-001,2013,9,26,7,173,409,582,251
3404-001,2013,9,26,8,420,1238,1658,582
3404-001,2013,9,26,9,588,1184,1772,1658
3404-001,2013,9,26,10,578,618,1196,1772
3404-001,2013,9,26,11,565,650,1215,1196
3404-001,2013,9,26,12,537,552,1089,1215
3404-001,2013,9,26,13,515,463,978,1089
3404-001,2013,9,26,14,525,534,1059,978
3404-001,2013,9,26,15,637,606,1243,1059
3404-001,2013,9,26,16,658,599,1257,1243
3404-001,2013,9,26,17,674,539,1213,1257
3404-001,2013,9,26,18,771,509,1280,1213
3404-001,2013,9,26,19,883,451,1334,1280
3404-001,2013,9,26,20,637,310,947,1334
3404-001,2013,9,26,21,507,232,739,947
3404-001,2013,9,26,22,353,197,550,739
3404-001,2013,9,26,23,195,126,321,550
3404-001,2013,9,26,24,120,109,229,321
3404-001,2013,9,27,1,63,62,125,229
3404-001,2013,9,27,2,50,43,93,125
3404-001,2013,9,27,3,41,56,97,93
3404-001,2013,9,27,4,43,38,81,97
3404-001,2013,9,27,5,51,84,135,81
3404-001,2013,9,27,6,100,133,233,135
3404-001,2013,9,27,7,175,416,591,233
3404-001,2013,9,27,8,439,1216,1655,591
3404-001,2013,9,27,9,585,1166,1751,1655
3404-001,2013,9,27,10,561,552,1113,1751
3404-001,2013,9,27,11,558,616,1174,1113
3404-001,2013,9,27,12,532,572,1104,1174
3404-001,2013,9,27,13,460,478,938,1104
3404-001,2013,9,27,14,504,527,1031,938
3404-001,2013,9,27,15,669,579,1248,1031
3404-001,2013,9,27,16,619,625,1244,1248
3404-001,2013,9,27,17,723,503,1226,1244
3404-001,2013,9,27,18,922,524,1446,1226
3404-001,2013,9,27,19,1041,473,1514,1446
3404-001,2013,9,27,20,724,412,1136,1514
3404-001,2013,9,27,21,567,292,859,1136
3404-001,2013,9,27,22,371,176,547,859
3404-001,2013,9,27,23,195,150,345,547
3404-001,2013,9,27,24,99,105,204,345
3404-001,2013,9,28,1,75,60,135,204
3404-001,2013,9,28,2,55,57,112,135
3404-001,2013,9,28,3,50,41,91,112
3404-001,2013,9,28,4,42,51,93,91
3404-001,2013,9,28,5,42,70,112,93
3404-001,2013,9,28,6,84,148,232,112
3404-001,2013,9,28,7,146,324,470,232
3404-001,2013,9,28,8,358,682,1040,470
3404-001,2013,9,28,9,485,652,1137,1040
3404-001,2013,9,28,10,518,539,1057,1137
3404-001,2013,9,28,11,518,518,1036,1057
3404-001,2013,9,28,12,468,573,1041,1036
3404-001,2013,9,28,13,422,459,881,1041
3404-001,2013,9,28,14,479,452,931,881
3404-001,2013,9,28,15,509,502,1011,931
3404-001,2013,9,28,16,515,450,965,1011
3404-001,2013,9,28,17,604,402,1006,965
3404-001,2013,9,28,18,765,427,1192,1006
3404-001,2013,9,28,19,560,364,924,1192
3404-001,2013,9,28,20,413,255,668,924
3404-001,2013,9,28,21,265,195,460,668
3404-001,2013,9,28,22,188,138,326,460
3404-001,2013,9,28,23,109,107,216,326
3404-001,2013,9,28,24,69,53,122,216
3404-001,2013,9,29,1,55,45,100,122
3404-001,2013,9,29,2,39,35,74,100
3404-001,2013,9,29,3,34,23,57,74
3404-001,2013,9,29,4,27,28,55,57
3404-001,2013,9,29,5,32,21,53,55
3404-001,2013,9,29,6,28,56,84,53
3404-001,2013,9,29,7,57,96,153,84
3404-001,2013,9,29,8,111,210,321,153
3404-001,2013,9,29,9,172,224,396,321
3404-001,2013,9,29,10,174,184,358,396
3404-001,2013,9,29,11,242,246,488,358
3404-001,2013,9,29,12,219,229,448,488
3404-001,2013,9,29,13,246,255,501,448
3404-001,2013,9,29,14,247,245,492,501
3404-001,2013,9,29,15,316,242,558,492
3404-001,2013,9,29,16,353,262,615,558
3404-001,2013,9,29,17,330,219,549,615
3404-001,2013,9,29,18,401,246,647,549
3404-001,2013,9,29,19,328,241,569,647
3404-001,2013,9,29,20,210,207,417,569
3404-001,2013,9,29,21,165,186,351,417
3404-001,2013,9,29,22,109,136,245,351
3404-001,2013,9,29,23,59,119,178,245
3404-001,2013,9,29,24,64,103,167,178
3404-001,2013,9,30,1,42,81,123,167
3404-001,2013,9,30,2,24,47,71,123
3404-001,2013,9,30,3,22,36,58,71
3404-001,2013,9,30,4,17,36,53,58
3404-001,2013,9,30,5,49,69,118,53
3404-001,2013,9,30,6,81,160,241,118
3404-001,2013,9,30,7,181,484,665,241
3404-001,2013,9,30,8,428,1490,1918,665
3404-001,2013,9,30,9,551,1203,1754,1918
3404-001,2013,9,30,10,489,550,1039,1754
3404-001,2013,9,30,11,564,582,1146,1039
3404-001,2013,9,30,12,549,577,1126,1146
3404-001,2013,9,30,13,486,507,993,1126
3404-001,2013,9,30,14,503,567,1070,993
3404-001,2013,9,30,15,654,604,1258,1070
3404-001,2013,9,30,16,643,590,1233,1258
3404-001,2013,9,30,17,637,526,1163,1233
3404-001,2013,9,30,18,825,507,1332,1163
3404-001,2013,9,30,19,854,391,1245,1332
3404-001,2013,9,30,20,631,336,967,1245
3404-001,2013,9,30,21,543,255,798,967
3404-001,2013,9,30,22,358,172,530,798
3404-001,2013,9,30,23,176,130,306,530
3404-001,2013,9,30,24,96,104,200,306
3404-001,2013,10,1,1,83,73,156,200
3404-001,2013,10,1,2,58,50,108,156
3404-001,2013,10,1,3,49,42,91,108
3404-001,2013,10,1,4,31,47,78,91
3404-001,2013,10,1,5,51,81,132,78
3404-001,2013,10,1,6,85,135,220,132
3404-001,2013,10,1,7,163,432,595,220
3404-001,2013,10,1,8,446,1282,1728,595
3404-001,2013,10,1,9,545,1134,1679,1728
3404-001,2013,10,1,10,586,651,1237,1679
3404-001,2013,10,1,11,592,641,1233,1237
3404-001,2013,10,1,12,559,560,1119,1233
3404-001,2013,10,1,13,515,481,996,1119
3404-001,2013,10,1,14,554,466,1020,996
3404-001,2013,10,1,15,614,622,1236,1020
3404-001,2013,10,1,16,641,578,1219,1236
3404-001,2013,10,1,17,685,503,1188,1219
3404-001,2013,10,1,18,873,528,1401,1188
3404-001,2013,10,1,19,902,422,1324,1401
3404-001,2013,10,1,20,621,314,935,1324
3404-001,2013,10,1,21,511,234,745,935
3404-001,2013,10,1,22,339,197,536,745
3404-001,2013,10,1,23,191,138,329,536
3404-001,2013,10,1,24,110,74,184,329
3404-001,2013,10,2,1,72,70,142,184
3404-001,2013,10,2,2,35,48,83,142
3404-001,2013,10,2,3,39,34,73,83
3404-001,2013,10,2,4,30,51,81,73
3404-001,2013,10,2,5,53,58,111,81
3404-001,2013,10,2,6,70,128,198,111
3404-001,2013,10,2,7,145,381,526,198
3404-001,2013,10,2,8,416,1274,1690,526
3404-001,2013,10,2,9,598,1155,1753,1690
3404-001,2013,10,2,10,552,556,1108,1753
3404-001,2013,10,2,11,541,601,1142,1108
3404-001,2013,10,2,12,584,545,1129,1142
3404-001,2013,10,2,13,528,511,1039,1129
3404-001,2013,10,2,14,519,524,1043,1039
3404-001,2013,10,2,15,661,644,1305,1043
3404-001,2013,10,2,16,661,629,1290,1305
3404-001,2013,10,2,17,681,564,1245,1290
3404-001,2013,10,2,18,936,520,1456,1245
3404-001,2013,10,2,19,970,471,1441,1456
3404-001,2013,10,2,20,698,397,1095,1441
3404-001,2013,10,2,21,520,277,797,1095
3404-001,2013,10,2,22,369,203,572,797
3404-001,2013,10,2,23,160,146,306,572
3404-001,2013,10,2,24,117,90,207,306
3404-001,2013,10,3,1,88,55,143,207
3404-001,2013,10,3,2,56,67,123,143
3404-001,2013,10,3,3,39,46,85,123
3404-001,2013,10,3,4,40,42,82,85
3404-001,2013,10,3,5,43,71,114,82
3404-001,2013,10,3,6,63,148,211,114
3404-001,2013,10,3,7,136,315,451,211
3404-001,2013,10,3,8,270,771,1041,451
3404-001,2013,10,3,9,428,579,1007,1041
3404-001,2013,10,3,10,406,515,921,1007
3404-001,2013,10,3,11,430,514,944,921
3404-001,2013,10,3,12,386,481,867,944
3404-001,2013,10,3,13,375,410,785,867
3404-001,2013,10,3,14,438,451,889,785
3404-001,2013,10,3,15,513,447,960,889
3404-001,2013,10,3,16,529,394,923,960
3404-001,2013,10,3,17,582,402,984,923
3404-001,2013,10,3,18,802,353,1155,984
3404-001,2013,10,3,19,667,328,995,1155
3404-001,2013,10,3,20,421,266,687,995
3404-001,2013,10,3,21,276,184,460,687
3404-001,2013,10,3,22,190,177,367,460
3404-001,2013,10,3,23,115,105,220,367
3404-001,2013,10,3,24,70,96,166,220
3404-001,2013,10,4,1,65,60,125,166
3404-001,2013,10,4,2,41,44,85,125
3404-001,2013,10,4,3,28,38,66,85
3404-001,2013,10,4,4,32,47,79,66
3404-001,2013,10,4,5,57,61,118,79
3404-001,2013,10,4,6,69,130,199,118
3404-001,2013,10,4,7,164,425,589,199
3404-001,2013,10,4,8,415,1219,1634,589
3404-001,2013,10,4,9,546,1088,1634,1634
3404-001,2013,10,4,10,532,576,1108,1634
3404-001,2013,10,4,11,573,621,1194,1108
3404-001,2013,10,4,12,549,610,1159,1194
3404-001,2013,10,4,13,464,501,965,1159
3404-001,2013,10,4,14,578,530,1108,965
3404-001,2013,10,4,15,671,609,1280,1108
3404-001,2013,10,4,16,692,622,1314,1280
3404-001,2013,10,4,17,685,567,1252,1314
3404-001,2013,10,4,18,947,477,1424,1252
3404-001,2013,10,4,19,1017,466,1483,1424
3404-001,2013,10,4,20,714,364,1078,1483
3404-001,2013,10,4,21,517,245,762,1078
3404-001,2013,10,4,22,308,209,517,762
3404-001,2013,10,4,23,187,137,324,517
3404-001,2013,10,4,24,113,106,219,324
3404-001,2013,10,5,1,96,71,167,219
3404-001,2013,10,5,2,64,51,115,167
3404-001,2013,10,5,3,35,42,77,115
3404-001,2013,10,5,4,44,55,99,77
3404-001,2013,10,5,5,48,47,95,99
3404-001,2013,10,5,6,76,131,207,95
3404-001,2013,10,5,7,172,246,418,207
3404-001,2013,10,5,8,295,653,948,418
3404-001,2013,10,5,9,466,608,1074,948
3404-001,2013,10,5,10,456,539,995,1074
3404-001,2013,10,5,11,490,514,1004,995
3404-001,2013,10,5,12,458,516,974,1004
3404-001,2013,10,5,13,436,447,883,974
3404-001,2013,10,5,14,452,544,996,883
3404-001,2013,10,5,15,508,454,962,996
3404-001,2013,10,5,16,508,446,954,962
3404-001,2013,10,5,17,573,369,942,954
3404-001,2013,10,5,18,731,443,1174,942
3404-001,2013,10,5,19,560,353,913,1174
3404-001,2013,10,5,20,409,272,681,913
3404-001,2013,10,5,21,264,189,453,681
3404-001,2013,10,5,22,178,156,334,453
3404-001,2013,10,5,23,156,121,277,334
3404-001,2013,10,5,24,78,64,142,277
3404-001,2013,10,6,1,71,53,124,142
3404-001,2013,10,6,2,44,47,91,124
3404-001,2013,10,6,3,47,28,75,91
3404-001,2013,10,6,4,28,31,59,75
3404-001,2013,10,6,5,37,34,71,59
3404-001,2013,10,6,6,46,61,107,71
3404-001,2013,10,6,7,103,157,260,107
3404-001,2013,10,6,8,192,287,479,260
3404-001,2013,10,6,9,246,265,511,479
3404-001,2013,10,6,10,226,250,476,511
3404-001,2013,10,6,11,261,343,604,476
3404-001,2013,10,6,12,286,369,655,604
3404-001,2013,10,6,13,263,332,595,655
3404-001,2013,10,6,14,312,315,627,595
3404-001,2013,10,6,15,404,307,711,627
3404-001,2013,10,6,16,394,358,752,711
3404-001,2013,10,6,17,471,321,792,752
3404-001,2013,10,6,18,572,291,863,792
3404-001,2013,10,6,19,445,303,748,863
3404-001,2013,10,6,20,351,244,595,748
3404-001,2013,10,6,21,259,226,485,595
3404-001,2013,10,6,22,135,193,328,485
3404-001,2013,10,6,23,93,135,228,328
3404-001,2013,10,6,24,71,86,157,228
3404-001,2013,10,7,1,38,81,119,157
3404-001,2013,10,7,2,25,48,73,119
3404-001,2013,10,7,3,25,29,54,73
3404-001,2013,10,7,4,20,42,62,54
3404-001,2013,10,7,5,49,61,110,62
3404-001,2013,10,7,6,83,144,227,110
3404-001,2013,10,7,7,168,487,655,227
3404-001,2013,10,7,8,435,1477,1912,655
3404-001,2013,10,7,9,563,1233,1796,1912
3404-001,2013,10,7,10,496,557,1053,1796
3404-001,2013,10,7,11,564,594,1158,1053
3404-001,2013,10,7,12,589,585,1174,1158
3404-001,2013,10,7,13,498,497,995,1174
3404-001,2013,10,7,14,501,574,1075,995
3404-001,2013,10,7,15,703,625,1328,1075
3404-001,2013,10,7,16,676,616,1292,1328
3404-001,2013,10,7,17,650,566,1216,1292
3404-001,2013,10,7,18,862,517,1379,1216
3404-001,2013,10,7,19,870,383,1253,1379
3404-001,2013,10,7,20,628,354,982,1253
3404-001,2013,10,7,21,543,264,807,982
3404-001,2013,10,7,22,371,172,543,807
3404-001,2013,10,7,23,178,133,311,543
3404-001,2013,10,7,24,89,95,184,311
3404-001,2013,10,8,1,81,90,171,184
3404-001,2013,10,8,2,48,51,99,171
3404-001,2013,10,8,3,40,43,83,99
3404-001,2013,10,8,4,37,43,80,83
3404-001,2013,10,8,5,38,57,95,80
3404-001,2013,10,8,6,91,111,202,95
3404-001,2013,10,8,7,124,325,449,202
3404-001,2013,10,8,8,383,1133,1516,449
3404-001,2013,10,8,9,598,1151,1749,1516
3404-001,2013,10,8,10,564,584,1148,1749
3404-001,2013,10,8,11,534,621,1155,1148
3404-001,2013,10,8,12,540,559,1099,1155
3404-001,2013,10,8,13,452,468,920,1099
3404-001,2013,10,8,14,522,479,1001,920
3404-001,2013,10,8,15,651,554,1205,1001
3404-001,2013,10,8,16,568,523,1091,1205
3404-001,2013,10,8,17,654,502,1156,1091
3404-001,2013,10,8,18,842,453,1295,1156
3404-001,2013,10,8,19,898,394,1292,1295
3404-001,2013,10,8,20,636,312,948,1292
3404-001,2013,10,8,21,505,248,753,948
3404-001,2013,10,8,22,327,164,491,753
3404-001,2013,10,8,23,204,141,345,491
3404-001,2013,10,8,24,101,82,183,345
3404-001,2013,10,9,1,62,73,135,183
3404-001,2013,10,9,2,49,46,95,135
3404-001,2013,10,9,3,36,39,75,95
3404-001,2013,10,9,4,31,38,69,75
3404-001,2013,10,9,5,44,64,108,69
3404-001,2013,10,9,6,76,154,230,108
3404-001,2013,10,9,7,172,288,460,230
3404-001,2013,10,9,8,301,754,1055,460
3404-001,2013,10,9,9,403,595,998,1055
3404-001,2013,10,9,10,421,508,929,998
3404-001,2013,10,9,11,410,493,903,929
3404-001,2013,10,9,12,426,478,904,903
3404-001,2013,10,9,13,382,410,792,904
3404-001,2013,10,9,14,443,432,875,792
3404-001,2013,10,9,15,494,432,926,875
3404-001,2013,10,9,16,549,392,941,926
3404-001,2013,10,9,17,569,346,915,941
3404-001,2013,10,9,18,751,389,1140,915
3404-001,2013,10,9,19,577,322,899,1140
3404-001,2013,10,9,20,394,242,636,899
3404-001,2013,10,9,21,253,198,451,636
3404-001,2013,10,9,22,213,159,372,451
3404-001,2013,10,9,23,139,109,248,372
3404-001,2013,10,9,24,61,71,132,248
3404-001,2013,10,10,1,48,70,118,132
3404-001,2013,10,10,2,40,36,76,118
3404-001,2013,10,10,3,24,39,63,76
3404-001,2013,10,10,4,35,44,79,63
3404-001,2013,10,10,5,57,50,107,79
3404-001,2013,10,10,6,88,141,229,107
3404-001,2013,10,10,7,168,439,607,229
3404-001,2013,10,10,8,443,1439,1882,607
3404-001,2013,10,10,9,636,1131,1767,1882
3404-001,2013,10,10,10,533,629,1162,1767
3404-001,2013,10,10,11,591,554,1145,1162
3404-001,2013,10,10,12,534,579,1113,1145
3404-001,2013,10,10,13,501,505,1006,1113
3404-001,2013,10,10,14,567,582,1149,1006
3404-001,2013,10,10,15,693,653,1346,1149
3404-001,2013,10,10,16,662,610,1272,1346
3404-001,2013,10,10,17,688,553,1241,1272
3404-001,2013,10,10,18,887,495,1382,1241
3404-001,2013,10,10,19,920,454,1374,1382
3404-001,2013,10,10,20,598,340,938,1374
3404-001,2013,10,10,21,472,225,697,938
3404-001,2013,10,10,22,361,193,554,697
3404-001,2013,10,10,23,194,131,325,554
3404-001,2013,10,10,24,111,64,175,325
3404-001,2013,10,11,1,74,59,133,175
3404-001,2013,10,11,2,47,43,90,133
3404-001,2013,10,11,3,35,41,76,90
3404-001,2013,10,11,4,47,64,111,76
3404-001,2013,10,11,5,69,94,163,111
3404-001,2013,10,11,6,75,176,251,163
3404-001,2013,10,11,7,165,417,582,251
3404-001,2013,10,11,8,431,1352,1783,582
3404-001,2013,10,11,9,640,1109,1749,1783
3404-001,2013,10,11,10,588,662,1250,1749
3404-001,2013,10,11,11,631,660,1291,1250
3404-001,2013,10,11,12,625,600,1225,1291
3404-001,2013,10,11,13,530,460,990,1225
3404-001,2013,10,11,14,578,545,1123,990
3404-001,2013,10,11,15,690,597,1287,1123
3404-001,2013,10,11,16,699,596,1295,1287
3404-001,2013,10,11,17,721,559,1280,1295
3404-001,2013,10,11,18,991,534,1525,1280
3404-001,2013,10,11,19,995,452,1447,1525
3404-001,2013,10,11,20,695,375,1070,1447
3404-001,2013,10,11,21,510,253,763,1070
3404-001,2013,10,11,22,330,205,535,763
3404-001,2013,10,11,23,185,138,323,535
3404-001,2013,10,11,24,109,80,189,323
3404-001,2013,10,12,1,76,91,167,189
3404-001,2013,10,12,2,55,41,96,167
3404-001,2013,10,12,3,43,29,72,96
3404-001,2013,10,12,4,34,46,80,72
3404-001,2013,10,12,5,47,68,115,80
3404-001,2013,10,12,6,81,164,245,115
3404-001,2013,10,12,7,165,320,485,245
3404-001,2013,10,12,8,341,686,1027,485
3404-001,2013,10,12,9,495,605,1100,1027
3404-001,2013,10,12,10,433,577,1010,1100
3404-001,2013,10,12,11,498,521,1019,1010
3404-001,2013,10,12,12,498,450,948,1019
3404-001,2013,10,12,13,473,505,978,948
3404-001,2013,10,12,14,478,471,949,978
3404-001,2013,10,12,15,489,462,951,949
3404-001,2013,10,12,16,514,451,965,951
3404-001,2013,10,12,17,598,449,1047,965
3404-001,2013,10,12,18,763,461,1224,1047
3404-001,2013,10,12,19,620,373,993,1224
3404-001,2013,10,12,20,370,270,640,993
3404-001,2013,10,12,21,251,205,456,640
3404-001,2013,10,12,22,173,138,311,456
3404-001,2013,10,12,23,96,110,206,311
3404-001,2013,10,12,24,82,73,155,206
3404-001,2013,10,13,1,46,40,86,155
3404-001,2013,10,13,2,44,23,67,86
3404-001,2013,10,13,3,31,33,64,67
3404-001,2013,10,13,4,24,29,53,64
3404-001,2013,10,13,5,30,39,69,53
3404-001,2013,10,13,6,53,82,135,69
3404-001,2013,10,13,7,86,155,241,135
3404-001,2013,10,13,8,161,292,453,241
3404-001,2013,10,13,9,200,262,462,453
3404-001,2013,10,13,10,200,254,454,462
3404-001,2013,10,13,11,287,290,577,454
3404-001,2013,10,13,12,267,302,569,577
3404-001,2013,10,13,13,274,313,587,569
3404-001,2013,10,13,14,311,320,631,587
3404-001,2013,10,13,15,348,331,679,631
3404-001,2013,10,13,16,411,322,733,679
3404-001,2013,10,13,17,509,289,798,733
3404-001,2013,10,13,18,556,305,861,798
3404-001,2013,10,13,19,420,268,688,861
3404-001,2013,10,13,20,348,236,584,688
3404-001,2013,10,13,21,246,206,452,584
3404-001,2013,10,13,22,188,195,383,452
3404-001,2013,10,13,23,103,139,242,383
3404-001,2013,10,13,24,65,97,162,242
3404-001,2013,10,14,1,30,66,96,162
3404-001,2013,10,14,2,32,49,81,96
3404-001,2013,10,14,3,14,42,56,81
3404-001,2013,10,14,4,23,43,66,56
3404-001,2013,10,14,5,38,77,115,66
3404-001,2013,10,14,6,88,160,248,115
3404-001,2013,10,14,7,183,501,684,248
3404-001,2013,10,14,8,473,1518,1991,684
3404-001,2013,10,14,9,500,1146,1646,1991
3404-001,2013,10,14,10,537,601,1138,1646
3404-001,2013,10,14,11,599,653,1252,1138
3404-001,2013,10,14,12,612,621,1233,1252
3404-001,2013,10,14,13,531,490,1021,1233
3404-001,2013,10,14,14,552,627,1179,1021
3404-001,2013,10,14,15,709,641,1350,1179
3404-001,2013,10,14,16,661,638,1299,1350
3404-001,2013,10,14,17,727,562,1289,1299
3404-001,2013,10,14,18,895,501,1396,1289
3404-001,2013,10,14,19,873,414,1287,1396
3404-001,2013,10,14,20,624,303,927,1287
3404-001,2013,10,14,21,518,225,743,927
3404-001,2013,10,14,22,349,185,534,743
3404-001,2013,10,14,23,172,133,305,534
3404-001,2013,10,14,24,107,92,199,305
3404-001,2013,10,15,1,72,64,136,199
3404-001,2013,10,15,2,44,55,99,136
3404-001,2013,10,15,3,41,41,82,99
3404-001,2013,10,15,4,37,59,96,82
3404-001,2013,10,15,5,52,66,118,96
3404-001,2013,10,15,6,86,163,249,118
3404-001,2013,10,15,7,173,430,603,249
3404-001,2013,10,15,8,418,1317,1735,603
3404-001,2013,10,15,9,574,1106,1680,1735
3404-001,2013,10,15,10,548,613,1161,1680
3404-001,2013,10,15,11,615,667,1282,1161
3404-001,2013,10,15,12,562,638,1200,1282
3404-001,2013,10,15,13,544,497,1041,1200
3404-001,2013,10,15,14,596,569,1165,1041
3404-001,2013,10,15,15,664,581,1245,1165
3404-001,2013,10,15,16,693,549,1242,1245
3404-001,2013,10,15,17,702,496,1198,1242
3404-001,2013,10,15,18,810,442,1252,1198
3404-001,2013,10,15,19,800,332,1132,1252
3404-001,2013,10,15,20,526,304,830,1132
3404-001,2013,10,15,21,464,229,693,830
3404-001,2013,10,15,22,316,189,505,693
3404-001,2013,10,15,23,167,135,302,505
3404-001,2013,10,15,24,111,99,210,302
3404-001,2013,10,16,1,63,68,131,210
3404-001,2013,10,16,2,47,47,94,131
3404-001,2013,10,16,3,35,42,77,94
3404-001,2013,10,16,4,34,47,81,77
3404-001,2013,10,16,5,60,71,131,81
3404-001,2013,10,16,6,82,174,256,131
3404-001,2013,10,16,7,157,420,577,256
3404-001,2013,10,16,8,429,1349,1778,577
3404-001,2013,10,16,9,604,1110,1714,1778
3404-001,2013,10,16,10,585,668,1253,1714
3404-001,2013,10,16,11,628,644,1272,1253
3404-001,2013,10,16,12,555,590,1145,1272
3404-001,2013,10,16,13,475,473,948,1145
3404-001,2013,10,16,14,536,556,1092,948
3404-001,2013,10,16,15,700,686,1386,1092
3404-001,2013,10,16,16,655,589,1244,1386
3404-001,2013,10,16,17,707,553,1260,1244
3404-001,2013,10,16,18,950,530,1480,1260
3404-001,2013,10,16,19,884,421,1305,1480
3404-001,2013,10,16,20,613,297,910,1305
3404-001,2013,10,16,21,483,247,730,910
3404-001,2013,10,16,22,331,181,512,730
3404-001,2013,10,16,23,171,130,301,512
3404-001,2013,10,16,24,72,108,180,301
3404-001,2013,10,17,1,63,57,120,180
3404-001,2013,10,17,2,39,46,85,120
3404-001,2013,10,17,3,43,39,82,85
3404-001,2013,10,17,4,37,47,84,82
3404-001,2013,10,17,5,47,69,116,84
3404-001,2013,10,17,6,83,154,237,116
3404-001,2013,10,17,7,186,419,605,237
3404-001,2013,10,17,8,430,1292,1722,605
3404-001,2013,10,17,9,626,1146,1772,1722
3404-001,2013,10,17,10,578,636,1214,1772
3404-001,2013,10,17,11,575,636,1211,1214
3404-001,2013,10,17,12,607,558,1165,1211
3404-001,2013,10,17,13,482,461,943,1165
3404-001,2013,10,17,14,609,536,1145,943
3404-001,2013,10,17,15,660,633,1293,1145
3404-001,2013,10,17,16,701,564,1265,1293
3404-001,2013,10,17,17,736,555,1291,1265
3404-001,2013,10,17,18,881,495,1376,1291
3404-001,2013,10,17,19,845,420,1265,1376
3404-001,2013,10,17,20,575,330,905,1265
3404-001,2013,10,17,21,479,235,714,905
3404-001,2013,10,17,22,331,205,536,714
3404-001,2013,10,17,23,205,116,321,536
3404-001,2013,10,17,24,88,79,167,321
3404-001,2013,10,18,1,67,68,135,167
3404-001,2013,10,18,2,47,43,90,135
3404-001,2013,10,18,3,36,55,91,90
3404-001,2013,10,18,4,36,46,82,91
3404-001,2013,10,18,5,56,67,123,82
3404-001,2013,10,18,6,69,161,230,123
3404-001,2013,10,18,7,184,414,598,230
3404-001,2013,10,18,8,406,1289,1695,598
3404-001,2013,10,18,9,602,1129,1731,1695
3404-001,2013,10,18,10,589,641,1230,1731
3404-001,2013,10,18,11,610,657,1267,1230
3404-001,2013,10,18,12,609,597,1206,1267
3404-001,2013,10,18,13,541,523,1064,1206
3404-001,2013,10,18,14,605,603,1208,1064
3404-001,2013,10,18,15,728,624,1352,1208
3404-001,2013,10,18,16,708,631,1339,1352
3404-001,2013,10,18,17,735,571,1306,1339
3404-001,2013,10,18,18,1039,552,1591,1306
3404-001,2013,10,18,19,1070,452,1522,1591
3404-001,2013,10,18,20,681,367,1048,1522
3404-001,2013,10,18,21,496,282,778,1048
3404-001,2013,10,18,22,329,204,533,778
3404-001,2013,10,18,23,196,123,319,533
3404-001,2013,10,18,24,143,97,240,319
3404-001,2013,10,19,1,75,79,154,240
3404-001,2013,10,19,2,54,50,104,154
3404-001,2013,10,19,3,52,42,94,104
3404-001,2013,10,19,4,51,64,115,94
3404-001,2013,10,19,5,54,58,112,115
3404-001,2013,10,19,6,88,121,209,112
3404-001,2013,10,19,7,164,298,462,209
3404-001,2013,10,19,8,336,728,1064,462
3404-001,2013,10,19,9,471,680,1151,1064
3404-001,2013,10,19,10,496,527,1023,1151
3404-001,2013,10,19,11,527,535,1062,1023
3404-001,2013,10,19,12,472,530,1002,1062
3404-001,2013,10,19,13,456,469,925,1002
3404-001,2013,10,19,14,422,491,913,925
3404-001,2013,10,19,15,499,507,1006,913
3404-001,2013,10,19,16,566,454,1020,1006
3404-001,2013,10,19,17,562,416,978,1020
3404-001,2013,10,19,18,824,462,1286,978
3404-001,2013,10,19,19,579,359,938,1286
3404-001,2013,10,19,20,386,276,662,938
3404-001,2013,10,19,21,238,202,440,662
3404-001,2013,10,19,22,185,158,343,440
3404-001,2013,10,19,23,106,98,204,343
3404-001,2013,10,19,24,76,62,138,204
3404-001,2013,10,20,1,68,56,124,138
3404-001,2013,10,20,2,60,37,97,124
3404-001,2013,10,20,3,32,18,50,97
3404-001,2013,10,20,4,21,29,50,50
3404-001,2013,10,20,5,31,41,72,50
3404-001,2013,10,20,6,39,63,102,72
3404-001,2013,10,20,7,70,131,201,102
3404-001,2013,10,20,8,150,275,425,201
3404-001,2013,10,20,9,185,254,439,425
3404-001,2013,10,20,10,223,269,492,439
3404-001,2013,10,20,11,263,287,550,492
3404-001,2013,10,20,12,225,320,545,550
3404-001,2013,10,20,13,272,303,575,545
3404-001,2013,10,20,14,302,291,593,575
3404-001,2013,10,20,15,342,308,650,593
3404-001,2013,10,20,16,440,327,767,650
3404-001,2013,10,20,17,493,293,786,767
3404-001,2013,10,20,18,606,299,905,786
3404-001,2013,10,20,19,529,267,796,905
3404-001,2013,10,20,20,356,244,600,796
3404-001,2013,10,20,21,251,215,466,600
3404-001,2013,10,20,22,160,203,363,466
3404-001,2013,10,20,23,66,145,211,363
3404-001,2013,10,20,24,61,97,158,211
3404-001,2013,10,21,1,38,70,108,158
3404-001,2013,10,21,2,23,52,75,108
3404-001,2013,10,21,3,25,35,60,75
3404-001,2013,10,21,4,24,31,55,60
3404-001,2013,10,21,5,40,74,114,55
3404-001,2013,10,21,6,97,160,257,114
3404-001,2013,10,21,7,195,468,663,257
3404-001,2013,10,21,8,445,1507,1952,663
3404-001,2013,10,21,9,522,1219,1741,1952
3404-001,2013,10,21,10,521,647,1168,1741
3404-001,2013,10,21,11,528,633,1161,1168
3404-001,2013,10,21,12,552,574,1126,1161
3404-001,2013,10,21,13,510,521,1031,1126
3404-001,2013,10,21,14,552,579,1131,1031
3404-001,2013,10,21,15,665,643,1308,1131
3404-001,2013,10,21,16,711,584,1295,1308
3404-001,2013,10,21,17,673,556,1229,1295
3404-001,2013,10,21,18,861,494,1355,1229
3404-001,2013,10,21,19,828,434,1262,1355
3404-001,2013,10,21,20,637,308,945,1262
3404-001,2013,10,21,21,523,246,769,945
3404-001,2013,10,21,22,313,163,476,769
3404-001,2013,10,21,23,189,145,334,476
3404-001,2013,10,21,24,101,80,181,334
3404-001,2013,10,22,1,87,79,166,181
3404-001,2013,10,22,2,41,39,80,166
3404-001,2013,10,22,3,40,49,89,80
3404-001,2013,10,22,4,35,61,96,89
3404-001,2013,10,22,5,47,84,131,96
3404-001,2013,10,22,6,105,165,270,131
3404-001,2013,10,22,7,167,438,605,270
3404-001,2013,10,22,8,462,1332,1794,605
3404-001,2013,10,22,9,612,1104,1716,1794
3404-001,2013,10,22,10,629,670,1299,1716
3404-001,2013,10,22,11,589,668,1257,1299
3404-001,2013,10,22,12,643,562,1205,1257
3404-001,2013,10,22,13,515,508,1023,1205
3404-001,2013,10,22,14,597,611,1208,1023
3404-001,2013,10,22,15,705,675,1380,1208
3404-001,2013,10,22,16,644,621,1265,1380
3404-001,2013,10,22,17,762,520,1282,1265
3404-001,2013,10,22,18,938,504,1442,1282
3404-001,2013,10,22,19,911,438,1349,1442
3404-001,2013,10,22,20,632,332,964,1349
3404-001,2013,10,22,21,512,264,776,964
3404-001,2013,10,22,22,331,192,523,776
3404-001,2013,10,22,23,206,128,334,523
3404-001,2013,10,22,24,90,80,170,334
3404-001,2013,10,23,1,78,67,145,170
3404-001,2013,10,23,2,47,50,97,145
3404-001,2013,10,23,3,48,43,91,97
3404-001,2013,10,23,4,41,50,91,91
3404-001,2013,10,23,5,59,61,120,91
3404-001,2013,10,23,6,98,144,242,120
3404-001,2013,10,23,7,169,453,622,242
3404-001,2013,10,23,8,464,1387,1851,622
3404-001,2013,10,23,9,638,1125,1763,1851
3404-001,2013,10,23,10,625,671,1296,1763
3404-001,2013,10,23,11,629,638,1267,1296
3404-001,2013,10,23,12,592,616,1208,1267
3404-001,2013,10,23,13,519,495,1014,1208
3404-001,2013,10,23,14,584,602,1186,1014
3404-001,2013,10,23,15,657,615,1272,1186
3404-001,2013,10,23,16,722,629,1351,1272
3404-001,2013,10,23,17,694,539,1233,1351
3404-001,2013,10,23,18,860,485,1345,1233
3404-001,2013,10,23,19,955,454,1409,1345
3404-001,2013,10,23,20,628,329,957,1409
3404-001,2013,10,23,21,485,256,741,957
3404-001,2013,10,23,22,304,178,482,741
3404-001,2013,10,23,23,201,133,334,482
3404-001,2013,10,23,24,106,85,191,334
3404-001,2013,10,24,1,70,72,142,191
3404-001,2013,10,24,2,43,48,91,142
3404-001,2013,10,24,3,36,46,82,91
3404-001,2013,10,24,4,39,37,76,82
3404-001,2013,10,24,5,63,76,139,76
3404-001,2013,10,24,6,94,150,244,139
3404-001,2013,10,24,7,174,404,578,244
3404-001,2013,10,24,8,470,1331,1801,578
3404-001,2013,10,24,9,604,1153,1757,1801
3404-001,2013,10,24,10,607,686,1293,1757
3404-001,2013,10,24,11,669,676,1345,1293
3404-001,2013,10,24,12,618,580,1198,1345
3404-001,2013,10,24,13,523,511,1034,1198
3404-001,2013,10,24,14,576,556,1132,1034
3404-001,2013,10,24,15,706,634,1340,1132
3404-001,2013,10,24,16,663,610,1273,1340
3404-001,2013,10,24,17,701,558,1259,1273
3404-001,2013,10,24,18,952,486,1438,1259
3404-001,2013,10,24,19,853,385,1238,1438
3404-001,2013,10,24,20,597,332,929,1238
3404-001,2013,10,24,21,462,227,689,929
3404-001,2013,10,24,22,287,172,459,689
3404-001,2013,10,24,23,175,118,293,459
3404-001,2013,10,24,24,113,96,209,293
3404-001,2013,10,25,1,81,65,146,209
3404-001,2013,10,25,2,47,42,89,146
3404-001,2013,10,25,3,27,39,66,89
3404-001,2013,10,25,4,37,38,75,66
3404-001,2013,10,25,5,57,66,123,75
3404-001,2013,10,25,6,92,179,271,123
3404-001,2013,10,25,7,161,416,577,271
3404-001,2013,10,25,8,485,1304,1789,577
3404-001,2013,10,25,9,613,1063,1676,1789
3404-001,2013,10,25,10,597,726,1323,1676
3404-001,2013,10,25,11,667,630,1297,1323
3404-001,2013,10,25,12,627,583,1210,1297
3404-001,2013,10,25,13,513,524,1037,1210
3404-001,2013,10,25,14,608,597,1205,1037
3404-001,2013,10,25,15,725,664,1389,1205
3404-001,2013,10,25,16,755,599,1354,1389
3404-001,2013,10,25,17,769,559,1328,1354
3404-001,2013,10,25,18,1042,533,1575,1328
3404-001,2013,10,25,19,985,432,1417,1575
3404-001,2013,10,25,20,632,342,974,1417
3404-001,2013,10,25,21,475,257,732,974
3404-001,2013,10,25,22,317,198,515,732
3404-001,2013,10,25,23,170,132,302,515
3404-001,2013,10,25,24,122,93,215,302
3404-001,2013,10,26,1,81,76,157,215
3404-001,2013,10,26,2,50,50,100,157
3404-001,2013,10,26,3,30,48,78,100
3404-001,2013,10,26,4,34,43,77,78
3404-001,2013,10,26,5,55,58,113,77
3404-001,2013,10,26,6,76,146,222,113
3404-001,2013,10,26,7,177,285,462,222
3404-001,2013,10,26,8,278,694,972,462
3404-001,2013,10,26,9,453,597,1050,972
3404-001,2013,10,26,10,475,561,1036,1050
3404-001,2013,10,26,11,565,519,1084,1036
3404-001,2013,10,26,12,471,508,979,1084
3404-001,2013,10,26,13,446,455,901,979
3404-001,2013,10,26,14,455,449,904,901
3404-001,2013,10,26,15,483,470,953,904
3404-001,2013,10,26,16,515,482,997,953
3404-001,2013,10,26,17,578,449,1027,997
3404-001,2013,10,26,18,804,380,1184,1027
3404-001,2013,10,26,19,519,352,871,1184
3404-001,2013,10,26,20,305,230,535,871
3404-001,2013,10,26,21,236,196,432,535
3404-001,2013,10,26,22,179,140,319,432
3404-001,2013,10,26,23,120,107,227,319
3404-001,2013,10,26,24,75,63,138,227
3404-001,2013,10,27,1,55,37,92,138
3404-001,2013,10,27,2,34,34,68,92
3404-001,2013,10,27,3,31,27,58,68
3404-001,2013,10,27,4,21,28,49,58
3404-001,2013,10,27,5,28,27,55,49
3404-001,2013,10,27,6,39,89,128,55
3404-001,2013,10,27,7,84,135,219,128
3404-001,2013,10,27,8,132,243,375,219
3404-001,2013,10,27,9,220,243,463,375
3404-001,2013,10,27,10,223,297,520,463
3404-001,2013,10,27,11,290,287,577,520
3404-001,2013,10,27,12,272,291,563,577
3404-001,2013,10,27,13,240,321,561,563
3404-001,2013,10,27,14,288,327,615,561
3404-001,2013,10,27,15,336,325,661,615
3404-001,2013,10,27,16,485,308,793,661
3404-001,2013,10,27,17,508,292,800,793
3404-001,2013,10,27,18,555,328,883,800
3404-001,2013,10,27,19,482,264,746,883
3404-001,2013,10,27,20,374,250,624,746
3404-001,2013,10,27,21,223,214,437,624
3404-001,2013,10,27,22,171,206,377,437
3404-001,2013,10,27,23,63,177,240,377
3404-001,2013,10,27,24,53,105,158,240
3404-001,2013,10,28,1,37,69,106,158
3404-001,2013,10,28,2,19,26,45,106
3404-001,2013,10,28,3,14,31,45,45
3404-001,2013,10,28,4,21,38,59,45
3404-001,2013,10,28,5,38,65,103,59
3404-001,2013,10,28,6,85,170,255,103
3404-001,2013,10,28,7,165,487,652,255
3404-001,2013,10,28,8,433,1473,1906,652
3404-001,2013,10,28,9,505,1213,1718,1906
3404-001,2013,10,28,10,534,587,1121,1718
3404-001,2013,10,28,11,576,610,1186,1121
3404-001,2013,10,28,12,542,560,1102,1186
3404-001,2013,10,28,13,489,498,987,1102
3404-001,2013,10,28,14,588,599,1187,987
3404-001,2013,10,28,15,630,621,1251,1187
3404-001,2013,10,28,16,682,563,1245,1251
3404-001,2013,10,28,17,680,520,1200,1245
3404-001,2013,10,28,18,846,464,1310,1200
3404-001,2013,10,28,19,877,394,1271,1310
3404-001,2013,10,28,20,620,347,967,1271
3404-001,2013,10,28,21,524,223,747,967
3404-001,2013,10,28,22,320,192,512,747
3404-001,2013,10,28,23,164,124,288,512
3404-001,2013,10,28,24,106,69,175,288
3404-001,2013,10,29,1,85,66,151,175
3404-001,2013,10,29,2,39,44,83,151
3404-001,2013,10,29,3,37,48,85,83
3404-001,2013,10,29,4,37,52,89,85
3404-001,2013,10,29,5,48,81,129,89
3404-001,2013,10,29,6,102,153,255,129
3404-001,2013,10,29,7,158,401,559,255
3404-001,2013,10,29,8,436,1313,1749,559
3404-001,2013,10,29,9,595,1122,1717,1749
3404-001,2013,10,29,10,612,637,1249,1717
3404-001,2013,10,29,11,571,667,1238,1249
3404-001,2013,10,29,12,622,592,1214,1238
3404-001,2013,10,29,13,510,495,1005,1214
3404-001,2013,10,29,14,592,608,1200,1005
3404-001,2013,10,29,15,704,638,1342,1200
3404-001,2013,10,29,16,673,636,1309,1342
3404-001,2013,10,29,17,762,531,1293,1309
3404-001,2013,10,29,18,929,504,1433,1293
3404-001,2013,10,29,19,878,424,1302,1433
3404-001,2013,10,29,20,619,342,961,1302
3404-001,2013,10,29,21,508,264,772,961
3404-001,2013,10,29,22,337,187,524,772
3404-001,2013,10,29,23,195,138,333,524
3404-001,2013,10,29,24,99,79,178,333
3404-001,2013,10,30,1,83,64,147,178
3404-001,2013,10,30,2,45,32,77,147
3404-001,2013,10,30,3,45,45,90,77
3404-001,2013,10,30,4,39,43,82,90
3404-001,2013,10,30,5,44,64,108,82
3404-001,2013,10,30,6,91,136,227,108
3404-001,2013,10,30,7,177,367,544,227
3404-001,2013,10,30,8,395,1277,1672,544
3404-001,2013,10,30,9,593,1101,1694,1672
3404-001,2013,10,30,10,550,631,1181,1694
3404-001,2013,10,30,11,574,627,1201,1181
3404-001,2013,10,30,12,591,602,1193,1201
3404-001,2013,10,30,13,491,496,987,1193
3404-001,2013,10,30,14,557,562,1119,987
3404-001,2013,10,30,15,606,631,1237,1119
3404-001,2013,10,30,16,753,601,1354,1237
3404-001,2013,10,30,17,729,546,1275,1354
3404-001,2013,10,30,18,929,457,1386,1275
3404-001,2013,10,30,19,860,418,1278,1386
3404-001,2013,10,30,20,547,323,870,1278
3404-001,2013,10,30,21,474,237,711,870
3404-001,2013,10,30,22,319,175,494,711
3404-001,2013,10,30,23,163,133,296,494
3404-001,2013,10,30,24,120,87,207,296
3404-001,2013,10,31,1,72,62,134,207
3404-001,2013,10,31,2,42,45,87,134
3404-001,2013,10,31,3,28,34,62,87
3404-001,2013,10,31,4,38,32,70,62
3404-001,2013,10,31,5,56,76,132,70
3404-001,2013,10,31,6,84,134,218,132
3404-001,2013,10,31,7,174,407,581,218
3404-001,2013,10,31,8,432,1253,1685,581
3404-001,2013,10,31,9,582,1208,1790,1685
3404-001,2013,10,31,10,544,670,1214,1790
3404-001,2013,10,31,11,665,622,1287,1214
3404-001,2013,10,31,12,623,585,1208,1287
3404-001,2013,10,31,13,500,496,996,1208
3404-001,2013,10,31,14,574,581,1155,996
3404-001,2013,10,31,15,655,627,1282,1155
3404-001,2013,10,31,16,646,561,1207,1282
3404-001,2013,10,31,17,700,542,1242,1207
3404-001,2013,10,31,18,920,536,1456,1242
3404-001,2013,10,31,19,926,425,1351,1456
3404-001,2013,10,31,20,579,303,882,1351
3404-001,2013,10,31,21,499,246,745,882
3404-001,2013,10,31,22,277,197,474,745
3404-001,2013,10,31,23,176,133,309,474
3404-001,2013,10,31,24,105,76,181,309
3404-001,2013,11,1,1,87,62,149,181
3404-001,2013,11,1,2,57,51,108,149
3404-001,2013,11,1,3,48,53,101,108
3404-001,2013,11,1,4,34,39,73,101
3404-001,2013,11,1,5,43,79,122,73
3404-001,2013,11,1,6,94,161,255,122
3404-001,2013,11,1,7,150,423,573,255
3404-001,2013,11,1,8,448,1248,1696,573
3404-001,2013,11,1,9,569,1197,1766,1696
3404-001,2013,11,1,10,573,604,1177,1766
3404-001,2013,11,1,11,652,623,1275,1177
3404-001,2013,11,1,12,623,551,1174,1275
3404-001,2013,11,1,13,516,501,1017,1174
3404-001,2013,11,1,14,642,570,1212,1017
3404-001,2013,11,1,15,685,638,1323,1212
3404-001,2013,11,1,16,698,599,1297,1323
3404-001,2013,11,1,17,750,605,1355,1297
3404-001,2013,11,1,18,1055,565,1620,1355
3404-001,2013,11,1,19,1077,462,1539,1620
3404-001,2013,11,1,20,716,361,1077,1539
3404-001,2013,11,1,21,485,239,724,1077
3404-001,2013,11,1,22,300,217,517,724
3404-001,2013,11,1,23,227,152,379,517
3404-001,2013,11,1,24,107,94,201,379
3404-001,2013,11,2,1,74,67,141,201
3404-001,2013,11,2,2,63,57,120,141
3404-001,2013,11,2,3,47,36,83,120
3404-001,2013,11,2,4,41,48,89,83
3404-001,2013,11,2,5,41,75,116,89
3404-001,2013,11,2,6,65,150,215,116
3404-001,2013,11,2,7,159,261,420,215
3404-001,2013,11,2,8,290,603,893,420
3404-001,2013,11,2,9,459,594,1053,893
3404-001,2013,11,2,10,455,523,978,1053
3404-001,2013,11,2,11,537,449,986,978
3404-001,2013,11,2,12,513,495,1008,986
3404-001,2013,11,2,13,447,396,843,1008
3404-001,2013,11,2,14,488,393,881,843
3404-001,2013,11,2,15,515,417,932,881
3404-001,2013,11,2,16,489,398,887,932
3404-001,2013,11,2,17,550,426,976,887
3404-001,2013,11,2,18,629,391,1020,976
3404-001,2013,11,2,19,442,348,790,1020
3404-001,2013,11,2,20,293,259,552,790
3404-001,2013,11,2,21,222,183,405,552
3404-001,2013,11,2,22,142,139,281,405
3404-001,2013,11,2,23,93,91,184,281
3404-001,2013,11,2,24,64,45,109,184
3404-001,2013,11,3,1,39,44,83,109
3404-001,2013,11,3,2,36,33,69,83
3404-001,2013,11,3,3,23,28,51,69
3404-001,2013,11,3,4,23,22,45,51
3404-001,2013,11,3,5,25,28,53,45
3404-001,2013,11,3,6,41,65,106,53
3404-001,2013,11,3,7,67,108,175,106
3404-001,2013,11,3,8,129,225,354,175
3404-001,2013,11,3,9,186,238,424,354
3404-001,2013,11,3,10,209,265,474,424
3404-001,2013,11,3,11,275,285,560,474
3404-001,2013,11,3,12,220,307,527,560
3404-001,2013,11,3,13,273,283,556,527
3404-001,2013,11,3,14,308,332,640,556
3404-001,2013,11,3,15,369,335,704,640
3404-001,2013,11,3,16,408,334,742,704
3404-001,2013,11,3,17,452,325,777,742
3404-001,2013,11,3,18,594,334,928,777
3404-001,2013,11,3,19,428,271,699,928
3404-001,2013,11,3,20,287,252,539,699
3404-001,2013,11,3,21,208,359,567,539
3404-001,2013,11,3,22,151,283,434,567
3404-001,2013,11,3,23,95,172,267,434
3404-001,2013,11,3,24,68,112,180,267
3404-001,2013,11,4,1,44,78,122,180
3404-001,2013,11,4,2,35,36,71,122
3404-001,2013,11,4,3,19,34,53,71
3404-001,2013,11,4,4,26,35,61,53
3404-001,2013,11,4,5,52,67,119,61
3404-001,2013,11,4,6,77,158,235,119
3404-001,2013,11,4,7,173,454,627,235
3404-001,2013,11,4,8,452,1419,1871,627
3404-001,2013,11,4,9,471,1293,1764,1871
3404-001,2013,11,4,10,576,639,1215,1764
3404-001,2013,11,4,11,577,636,1213,1215
3404-001,2013,11,4,12,583,565,1148,1213
3404-001,2013,11,4,13,492,500,992,1148
3404-001,2013,11,4,14,599,581,1180,992
3404-001,2013,11,4,15,659,643,1302,1180
3404-001,2013,11,4,16,684,648,1332,1302
3404-001,2013,11,4,17,685,547,1232,1332
3404-001,2013,11,4,18,868,487,1355,1232
3404-001,2013,11,4,19,839,420,1259,1355
3404-001,2013,11,4,20,646,319,965,1259
3404-001,2013,11,4,21,550,256,806,965
3404-001,2013,11,4,22,351,203,554,806
3404-001,2013,11,4,23,173,120,293,554
3404-001,2013,11,4,24,83,84,167,293
3404-001,2013,11,5,1,82,52,134,167
3404-001,2013,11,5,2,37,49,86,134
3404-001,2013,11,5,3,34,46,80,86
3404-001,2013,11,5,4,38,43,81,80
3404-001,2013,11,5,5,49,77,126,81
3404-001,2013,11,5,6,99,140,239,126
3404-001,2013,11,5,7,149,364,513,239
3404-001,2013,11,5,8,410,1293,1703,513
3404-001,2013,11,5,9,577,1139,1716,1703
3404-001,2013,11,5,10,595,604,1199,1716
3404-001,2013,11,5,11,552,666,1218,1199
3404-001,2013,11,5,12,600,621,1221,1218
3404-001,2013,11,5,13,504,481,985,1221
3404-001,2013,11,5,14,587,605,1192,985
3404-001,2013,11,5,15,702,600,1302,1192
3404-001,2013,11,5,16,702,650,1352,1302
3404-001,2013,11,5,17,762,541,1303,1352
3404-001,2013,11,5,18,920,503,1423,1303
3404-001,2013,11,5,19,844,409,1253,1423
3404-001,2013,11,5,20,606,351,957,1253
3404-001,2013,11,5,21,503,263,766,957
3404-001,2013,11,5,22,343,182,525,766
3404-001,2013,11,5,23,183,147,330,525
3404-001,2013,11,5,24,108,77,185,330
3404-001,2013,11,6,1,59,66,125,185
3404-001,2013,11,6,2,43,49,92,125
3404-001,2013,11,6,3,36,36,72,92
3404-001,2013,11,6,4,25,38,63,72
3404-001,2013,11,6,5,51,82,133,63
3404-001,2013,11,6,6,95,130,225,133
3404-001,2013,11,6,7,155,372,527,225
3404-001,2013,11,6,8,450,1323,1773,527
3404-001,2013,11,6,9,621,1163,1784,1773
3404-001,2013,11,6,10,586,636,1222,1784
3404-001,2013,11,6,11,592,659,1251,1222
3404-001,2013,11,6,12,602,608,1210,1251
3404-001,2013,11,6,13,564,489,1053,1210
3404-001,2013,11,6,14,590,601,1191,1053
3404-001,2013,11,6,15,699,638,1337,1191
3404-001,2013,11,6,16,704,555,1259,1337
3404-001,2013,11,6,17,724,566,1290,1259
3404-001,2013,11,6,18,918,516,1434,1290
3404-001,2013,11,6,19,848,408,1256,1434
3404-001,2013,11,6,20,572,342,914,1256
3404-001,2013,11,6,21,464,265,729,914
3404-001,2013,11,6,22,295,187,482,729
3404-001,2013,11,6,23,205,130,335,482
3404-001,2013,11,6,24,100,95,195,335
3404-001,2013,11,7,1,71,64,135,195
3404-001,2013,11,7,2,38,26,64,135
3404-001,2013,11,7,3,36,37,73,64
3404-001,2013,11,7,4,38,29,67,73
3404-001,2013,11,7,5,47,74,121,67
3404-001,2013,11,7,6,79,135,214,121
3404-001,2013,11,7,7,152,359,511,214
3404-001,2013,11,7,8,426,1274,1700,511
3404-001,2013,11,7,9,611,1238,1849,1700
3404-001,2013,11,7,10,578,599,1177,1849
3404-001,2013,11,7,11,587,665,1252,1177
3404-001,2013,11,7,12,535,602,1137,1252
3404-001,2013,11,7,13,519,496,1015,1137
3404-001,2013,11,7,14,574,573,1147,1015
3404-001,2013,11,7,15,634,616,1250,1147
3404-001,2013,11,7,16,717,597,1314,1250
3404-001,2013,11,7,17,706,579,1285,1314
3404-001,2013,11,7,18,905,522,1427,1285
3404-001,2013,11,7,19,870,418,1288,1427
3404-001,2013,11,7,20,630,326,956,1288
3404-001,2013,11,7,21,512,263,775,956
3404-001,2013,11,7,22,315,210,525,775
3404-001,2013,11,7,23,191,134,325,525
3404-001,2013,11,7,24,106,76,182,325
3404-001,2013,11,8,1,82,92,174,182
3404-001,2013,11,8,2,39,47,86,174
3404-001,2013,11,8,3,43,44,87,86
3404-001,2013,11,8,4,44,43,87,87
3404-001,2013,11,8,5,48,72,120,87
3404-001,2013,11,8,6,73,151,224,120
3404-001,2013,11,8,7,178,376,554,224
3404-001,2013,11,8,8,425,1287,1712,554
3404-001,2013,11,8,9,568,1198,1766,1712
3404-001,2013,11,8,10,605,700,1305,1766
3404-001,2013,11,8,11,603,677,1280,1305
3404-001,2013,11,8,12,622,619,1241,1280
3404-001,2013,11,8,13,541,484,1025,1241
3404-001,2013,11,8,14,593,549,1142,1025
3404-001,2013,11,8,15,697,635,1332,1142
3404-001,2013,11,8,16,692,633,1325,1332
3404-001,2013,11,8,17,746,571,1317,1325
3404-001,2013,11,8,18,1057,539,1596,1317
3404-001,2013,11,8,19,1117,498,1615,1596
3404-001,2013,11,8,20,683,366,1049,1615
3404-001,2013,11,8,21,544,284,828,1049
3404-001,2013,11,8,22,329,195,524,828
3404-001,2013,11,8,23,207,163,370,524
3404-001,2013,11,8,24,144,101,245,370
3404-001,2013,11,9,1,81,78,159,245
3404-001,2013,11,9,2,78,62,140,159
3404-001,2013,11,9,3,74,47,121,140
3404-001,2013,11,9,4,36,42,78,121
3404-001,2013,11,9,5,41,77,118,78
3404-001,2013,11,9,6,74,137,211,118
3404-001,2013,11,9,7,153,255,408,211
3404-001,2013,11,9,8,348,623,971,408
3404-001,2013,11,9,9,469,592,1061,971
3404-001,2013,11,9,10,436,548,984,1061
3404-001,2013,11,9,11,454,492,946,984
3404-001,2013,11,9,12,519,435,954,946
3404-001,2013,11,9,13,460,474,934,954
3404-001,2013,11,9,14,468,478,946,934
3404-001,2013,11,9,15,459,460,919,946
3404-001,2013,11,9,16,530,379,909,919
3404-001,2013,11,9,17,592,384,976,909
3404-001,2013,11,9,18,656,371,1027,976
3404-001,2013,11,9,19,461,257,718,1027
3404-001,2013,11,9,20,345,250,595,718
3404-001,2013,11,9,21,207,187,394,595
3404-001,2013,11,9,22,143,129,272,394
3404-001,2013,11,9,23,99,102,201,272
3404-001,2013,11,9,24,67,66,133,201
3404-001,2013,11,10,1,48,50,98,133
3404-001,2013,11,10,2,32,46,78,98
3404-001,2013,11,10,3,24,13,37,78
3404-001,2013,11,10,4,11,30,41,37
3404-001,2013,11,10,5,22,16,38,41
3404-001,2013,11,10,6,26,58,84,38
3404-001,2013,11,10,7,75,72,147,84
3404-001,2013,11,10,8,145,206,351,147
3404-001,2013,11,10,9,194,249,443,351
3404-001,2013,11,10,10,224,262,486,443
3404-001,2013,11,10,11,258,272,530,486
3404-001,2013,11,10,12,257,253,510,530
3404-001,2013,11,10,13,276,253,529,510
3404-001,2013,11,10,14,315,257,572,529
3404-001,2013,11,10,15,376,332,708,572
3404-001,2013,11,10,16,400,315,715,708
3404-001,2013,11,10,17,425,290,715,715
3404-001,2013,11,10,18,622,312,934,715
3404-001,2013,11,10,19,397,255,652,934
3404-001,2013,11,10,20,327,246,573,652
3404-001,2013,11,10,21,196,217,413,573
3404-001,2013,11,10,22,127,218,345,413
3404-001,2013,11,10,23,86,228,314,345
3404-001,2013,11,10,24,52,99,151,314
3404-001,2013,11,11,1,37,70,107,151
3404-001,2013,11,11,2,25,49,74,107
3404-001,2013,11,11,3,15,42,57,74
3404-001,2013,11,11,4,15,40,55,57
3404-001,2013,11,11,5,42,64,106,55
3404-001,2013,11,11,6,83,161,244,106
3404-001,2013,11,11,7,181,481,662,244
3404-001,2013,11,11,8,456,1412,1868,662
3404-001,2013,11,11,9,506,1293,1799,1868
3404-001,2013,11,11,10,567,605,1172,1799
3404-001,2013,11,11,11,539,655,1194,1172
3404-001,2013,11,11,12,597,611,1208,1194
3404-001,2013,11,11,13,556,481,1037,1208
3404-001,2013,11,11,14,553,593,1146,1037
3404-001,2013,11,11,15,676,678,1354,1146
3404-001,2013,11,11,16,705,557,1262,1354
3404-001,2013,11,11,17,706,524,1230,1262
3404-001,2013,11,11,18,852,516,1368,1230
3404-001,2013,11,11,19,794,408,1202,1368
3404-001,2013,11,11,20,642,344,986,1202
3404-001,2013,11,11,21,490,243,733,986
3404-001,2013,11,11,22,363,194,557,733
3404-001,2013,11,11,23,179,122,301,557
3404-001,2013,11,11,24,98,106,204,301
3404-001,2013,11,12,1,70,67,137,204
3404-001,2013,11,12,2,38,49,87,137
3404-001,2013,11,12,3,46,34,80,87
3404-001,2013,11,12,4,27,33,60,80
3404-001,2013,11,12,5,39,73,112,60
3404-001,2013,11,12,6,89,133,222,112
3404-001,2013,11,12,7,156,379,535,222
3404-001,2013,11,12,8,432,1306,1738,535
3404-001,2013,11,12,9,629,1201,1830,1738
3404-001,2013,11,12,10,626,650,1276,1830
3404-001,2013,11,12,11,631,652,1283,1276
3404-001,2013,11,12,12,628,647,1275,1283
3404-001,2013,11,12,13,532,492,1024,1275
3404-001,2013,11,12,14,575,582,1157,1024
3404-001,2013,11,12,15,725,681,1406,1157
3404-001,2013,11,12,16,701,614,1315,1406
3404-001,2013,11,12,17,774,551,1325,1315
3404-001,2013,11,12,18,931,511,1442,1325
3404-001,2013,11,12,19,866,403,1269,1442
3404-001,2013,11,12,20,589,318,907,1269
3404-001,2013,11,12,21,492,237,729,907
3404-001,2013,11,12,22,314,182,496,729
3404-001,2013,11,12,23,204,126,330,496
3404-001,2013,11,12,24,110,101,211,330
3404-001,2013,11,13,1,74,73,147,211
3404-001,2013,11,13,2,44,46,90,147
3404-001,2013,11,13,3,37,42,79,90
3404-001,2013,11,13,4,40,33,73,79
3404-001,2013,11,13,5,50,65,115,73
3404-001,2013,11,13,6,95,144,239,115
3404-001,2013,11,13,7,168,374,542,239
3404-001,2013,11,13,8,407,1318,1725,542
3404-001,2013,11,13,9,565,1232,1797,1725
3404-001,2013,11,13,10,601,685,1286,1797
3404-001,2013,11,13,11,602,702,1304,1286
3404-001,2013,11,13,12,635,638,1273,1304
3404-001,2013,11,13,13,512,493,1005,1273
3404-001,2013,11,13,14,553,570,1123,1005
3404-001,2013,11,13,15,666,663,1329,1123
3404-001,2013,11,13,16,718,626,1344,1329
3404-001,2013,11,13,17,742,604,1346,1344
3404-001,2013,11,13,18,978,494,1472,1346
3404-001,2013,11,13,19,935,407,1342,1472
3404-001,2013,11,13,20,626,338,964,1342
3404-001,2013,11,13,21,492,242,734,964
3404-001,2013,11,13,22,316,172,488,734
3404-001,2013,11,13,23,174,147,321,488
3404-001,2013,11,13,24,89,82,171,321
3404-001,2013,11,14,1,92,62,154,171
3404-001,2013,11,14,2,43,41,84,154
3404-001,2013,11,14,3,44,42,86,84
3404-001,2013,11,14,4,43,40,83,86
3404-001,2013,11,14,5,51,65,116,83
3404-001,2013,11,14,6,94,149,243,116
3404-001,2013,11,14,7,173,398,571,243
3404-001,2013,11,14,8,412,1210,1622,571
3404-001,2013,11,14,9,571,1214,1785,1622
3404-001,2013,11,14,10,560,695,1255,1785
3404-001,2013,11,14,11,611,651,1262,1255
3404-001,2013,11,14,12,609,577,1186,1262
3404-001,2013,11,14,13,501,485,986,1186
3404-001,2013,11,14,14,585,577,1162,986
3404-001,2013,11,14,15,684,631,1315,1162
3404-001,2013,11,14,16,690,630,1320,1315
3404-001,2013,11,14,17,671,591,1262,1320
3404-001,2013,11,14,18,965,464,1429,1262
3404-001,2013,11,14,19,864,440,1304,1429
3404-001,2013,11,14,20,654,350,1004,1304
3404-001,2013,11,14,21,526,251,777,1004
3404-001,2013,11,14,22,369,249,618,777
3404-001,2013,11,14,23,189,139,328,618
3404-001,2013,11,14,24,101,98,199,328
3404-001,2013,11,15,1,73,75,148,199
3404-001,2013,11,15,2,62,49,111,148
3404-001,2013,11,15,3,58,45,103,111
3404-001,2013,11,15,4,41,46,87,103
3404-001,2013,11,15,5,44,73,117,87
3404-001,2013,11,15,6,93,149,242,117
3404-001,2013,11,15,7,163,393,556,242
3404-001,2013,11,15,8,424,1232,1656,556
3404-001,2013,11,15,9,605,1245,1850,1656
3404-001,2013,11,15,10,569,740,1309,1850
3404-001,2013,11,15,11,602,685,1287,1309
3404-001,2013,11,15,12,642,636,1278,1287
3404-001,2013,11,15,13,533,553,1086,1278
3404-001,2013,11,15,14,602,592,1194,1086
3404-001,2013,11,15,15,695,667,1362,1194
3404-001,2013,11,15,16,751,670,1421,1362
3404-001,2013,11,15,17,821,577,1398,1421
3404-001,2013,11,15,18,1097,570,1667,1398
3404-001,2013,11,15,19,1154,522,1676,1667
3404-001,2013,11,15,20,789,430,1219,1676
3404-001,2013,11,15,21,618,286,904,1219
3404-001,2013,11,15,22,375,190,565,904
3404-001,2013,11,15,23,205,137,342,565
3404-001,2013,11,15,24,125,114,239,342
3404-001,2013,11,16,1,79,58,137,239
3404-001,2013,11,16,2,60,44,104,137
3404-001,2013,11,16,3,57,53,110,104
3404-001,2013,11,16,4,38,44,82,110
3404-001,2013,11,16,5,45,77,122,82
3404-001,2013,11,16,6,91,130,221,122
3404-001,2013,11,16,7,171,252,423,221
3404-001,2013,11,16,8,266,639,905,423
3404-001,2013,11,16,9,464,749,1213,905
3404-001,2013,11,16,10,471,545,1016,1213
3404-001,2013,11,16,11,535,583,1118,1016
3404-001,2013,11,16,12,506,500,1006,1118
3404-001,2013,11,16,13,450,498,948,1006
3404-001,2013,11,16,14,510,500,1010,948
3404-001,2013,11,16,15,553,525,1078,1010
3404-001,2013,11,16,16,553,489,1042,1078
3404-001,2013,11,16,17,601,484,1085,1042
3404-001,2013,11,16,18,802,411,1213,1085
3404-001,2013,11,16,19,585,344,929,1213
3404-001,2013,11,16,20,377,282,659,929
3404-001,2013,11,16,21,266,215,481,659
3404-001,2013,11,16,22,190,165,355,481
3404-001,2013,11,16,23,134,107,241,355
3404-001,2013,11,16,24,73,65,138,241
3404-001,2013,11,17,1,64,49,113,138
3404-001,2013,11,17,2,37,31,68,113
3404-001,2013,11,17,3,22,25,47,68
3404-001,2013,11,17,4,19,21,40,47
3404-001,2013,11,17,5,21,22,43,40
3404-001,2013,11,17,6,29,46,75,43
3404-001,2013,11,17,7,67,109,176,75
3404-001,2013,11,17,8,146,264,410,176
3404-001,2013,11,17,9,164,276,440,410
3404-001,2013,11,17,10,242,291,533,440
3404-001,2013,11,17,11,268,314,582,533
3404-001,2013,11,17,12,260,281,541,582
3404-001,2013,11,17,13,271,283,554,541
3404-001,2013,11,17,14,390,283,673,554
3404-001,2013,11,17,15,406,284,690,673
3404-001,2013,11,17,16,392,324,716,690
3404-001,2013,11,17,17,504,330,834,716
3404-001,2013,11,17,18,779,312,1091,834
3404-001,2013,11,17,19,540,334,874,1091
3404-001,2013,11,17,20,370,412,782,874
3404-001,2013,11,17,21,239,279,518,782
3404-001,2013,11,17,22,188,198,386,518
3404-001,2013,11,17,23,95,176,271,386
3404-001,2013,11,17,24,56,127,183,271
3404-001,2013,11,18,1,35,67,102,183
3404-001,2013,11,18,2,19,53,72,102
3404-001,2013,11,18,3,18,34,52,72
3404-001,2013,11,18,4,24,41,65,52
3404-001,2013,11,18,5,41,58,99,65
3404-001,2013,11,18,6,87,159,246,99
3404-001,2013,11,18,7,177,480,657,246
3404-001,2013,11,18,8,432,1481,1913,657
3404-001,2013,11,18,9,511,1308,1819,1913
3404-001,2013,11,18,10,532,682,1214,1819
3404-001,2013,11,18,11,577,614,1191,1214
3404-001,2013,11,18,12,549,572,1121,1191
3404-001,2013,11,18,13,533,509,1042,1121
3404-001,2013,11,18,14,565,577,1142,1042
3404-001,2013,11,18,15,661,589,1250,1142
3404-001,2013,11,18,16,643,608,1251,1250
3404-001,2013,11,18,17,697,517,1214,1251
3404-001,2013,11,18,18,856,430,1286,1214
3404-001,2013,11,18,19,867,378,1245,1286
3404-001,2013,11,18,20,611,312,923,1245
3404-001,2013,11,18,21,532,250,782,923
3404-001,2013,11,18,22,343,154,497,782
3404-001,2013,11,18,23,164,134,298,497
3404-001,2013,11,18,24,74,71,145,298
3404-001,2013,11,19,1,67,83,150,145
3404-001,2013,11,19,2,48,52,100,150
3404-001,2013,11,19,3,49,45,94,100
3404-001,2013,11,19,4,51,40,91,94
3404-001,2013,11,19,5,38,65,103,91
3404-001,2013,11,19,6,92,143,235,103
3404-001,2013,11,19,7,151,391,542,235
3404-001,2013,11,19,8,374,1300,1674,542
3404-001,2013,11,19,9,619,1217,1836,1674
3404-001,2013,11,19,10,565,665,1230,1836
3404-001,2013,11,19,11,619,638,1257,1230
3404-001,2013,11,19,12,572,615,1187,1257
3404-001,2013,11,19,13,539,460,999,1187
3404-001,2013,11,19,14,566,565,1131,999
3404-001,2013,11,19,15,694,660,1354,1131
3404-001,2013,11,19,16,641,603,1244,1354
3404-001,2013,11,19,17,660,587,1247,1244
3404-001,2013,11,19,18,875,511,1386,1247
3404-001,2013,11,19,19,846,376,1222,1386
3404-001,2013,11,19,20,607,300,907,1222
3404-001,2013,11,19,21,553,243,796,907
3404-001,2013,11,19,22,334,213,547,796
3404-001,2013,11,19,23,177,132,309,547
3404-001,2013,11,19,24,100,96,196,309
3404-001,2013,11,20,1,72,65,137,196
3404-001,2013,11,20,2,57,52,109,137
3404-001,2013,11,20,3,45,37,82,109
3404-001,2013,11,20,4,39,31,70,82
3404-001,2013,11,20,5,50,62,112,70
3404-001,2013,11,20,6,79,147,226,112
3404-001,2013,11,20,7,155,391,546,226
3404-001,2013,11,20,8,424,1318,1742,546
3404-001,2013,11,20,9,564,1217,1781,1742
3404-001,2013,11,20,10,568,659,1227,1781
3404-001,2013,11,20,11,602,635,1237,1227
3404-001,2013,11,20,12,606,617,1223,1237
3404-001,2013,11,20,13,576,512,1088,1223
3404-001,2013,11,20,14,615,563,1178,1088
3404-001,2013,11,20,15,619,636,1255,1178
3404-001,2013,11,20,16,705,630,1335,1255
3404-001,2013,11,20,17,715,552,1267,1335
3404-001,2013,11,20,18,998,484,1482,1267
3404-001,2013,11,20,19,856,411,1267,1482
3404-001,2013,11,20,20,588,310,898,1267
3404-001,2013,11,20,21,502,240,742,898
3404-001,2013,11,20,22,340,175,515,742
3404-001,2013,11,20,23,196,139,335,515
3404-001,2013,11,20,24,98,97,195,335
3404-001,2013,11,21,1,68,60,128,195
3404-001,2013,11,21,2,41,46,87,128
3404-001,2013,11,21,3,36,37,73,87
3404-001,2013,11,21,4,38,40,78,73
3404-001,2013,11,21,5,52,73,125,78
3404-001,2013,11,21,6,84,144,228,125
3404-001,2013,11,21,7,180,413,593,228
3404-001,2013,11,21,8,431,1273,1704,593
3404-001,2013,11,21,9,604,1177,1781,1704
3404-001,2013,11,21,10,561,653,1214,1781
3404-001,2013,11,21,11,620,629,1249,1214
3404-001,2013,11,21,12,615,572,1187,1249
3404-001,2013,11,21,13,491,479,970,1187
3404-001,2013,11,21,14,592,559,1151,970
3404-001,2013,11,21,15,658,630,1288,1151
3404-001,2013,11,21,16,674,563,1237,1288
3404-001,2013,11,21,17,718,549,1267,1237
3404-001,2013,11,21,18,901,516,1417,1267
3404-001,2013,11,21,19,886,423,1309,1417
3404-001,2013,11,21,20,577,317,894,1309
3404-001,2013,11,21,21,489,241,730,894
3404-001,2013,11,21,22,304,201,505,730
3404-001,2013,11,21,23,191,125,316,505
3404-001,2013,11,21,24,97,78,175,316
3404-001,2013,11,22,1,77,65,142,175
3404-001,2013,11,22,2,52,47,99,142
3404-001,2013,11,22,3,42,54,96,99
3404-001,2013,11,22,4,35,43,78,96
3404-001,2013,11,22,5,50,73,123,78
3404-001,2013,11,22,6,82,161,243,123
3404-001,2013,11,22,7,167,419,586,243
3404-001,2013,11,22,8,427,1269,1696,586
3404-001,2013,11,22,9,586,1163,1749,1696
3404-001,2013,11,22,10,581,623,1204,1749
3404-001,2013,11,22,11,631,640,1271,1204
3404-001,2013,11,22,12,616,574,1190,1271
3404-001,2013,11,22,13,529,512,1041,1190
3404-001,2013,11,22,14,624,587,1211,1041
3404-001,2013,11,22,15,707,631,1338,1211
3404-001,2013,11,22,16,703,615,1318,1338
3404-001,2013,11,22,17,743,588,1331,1318
3404-001,2013,11,22,18,1047,559,1606,1331
3404-001,2013,11,22,19,1074,457,1531,1606
3404-001,2013,11,22,20,699,364,1063,1531
3404-001,2013,11,22,21,491,261,752,1063
3404-001,2013,11,22,22,315,211,526,752
3404-001,2013,11,22,23,212,138,350,526
3404-001,2013,11,22,24,125,96,221,350
3404-001,2013,11,23,1,75,73,148,221
3404-001,2013,11,23,2,59,54,113,148
3404-001,2013,11,23,3,50,39,89,113
3404-001,2013,11,23,4,46,56,102,89
3404-001,2013,11,23,5,48,67,115,102
3404-001,2013,11,23,6,77,136,213,115
3404-001,2013,11,23,7,162,280,442,213
3404-001,2013,11,23,8,313,666,979,442
3404-001,2013,11,23,9,465,637,1102,979
3404-001,2013,11,23,10,476,525,1001,1102
3404-001,2013,11,23,11,532,492,1024,1001
3404-001,2013,11,23,12,493,513,1006,1024
3404-001,2013,11,23,13,452,433,885,1006
3404-001,2013,11,23,14,455,442,897,885
3404-001,2013,11,23,15,507,462,969,897
3404-001,2013,11,23,16,528,426,954,969
3404-001,2013,11,23,17,556,421,977,954
3404-001,2013,11,23,18,727,427,1154,977
3404-001,2013,11,23,19,511,354,865,1154
3404-001,2013,11,23,20,340,268,608,865
3404-001,2013,11,23,21,230,193,423,608
3404-001,2013,11,23,22,164,149,313,423
3404-001,2013,11,23,23,100,95,195,313
3404-001,2013,11,23,24,70,54,124,195
3404-001,2013,11,24,1,54,50,104,124
3404-001,2013,11,24,2,48,35,83,104
3404-001,2013,11,24,3,28,23,51,83
3404-001,2013,11,24,4,22,26,48,51
3404-001,2013,11,24,5,28,35,63,48
3404-001,2013,11,24,6,40,64,104,63
3404-001,2013,11,24,7,69,120,189,104
3404-001,2013,11,24,8,140,250,390,189
3404-001,2013,11,24,9,186,246,432,390
3404-001,2013,11,24,10,216,267,483,432
3404-001,2013,11,24,11,269,286,555,483
3404-001,2013,11,24,12,223,314,537,555
3404-001,2013,11,24,13,273,293,566,537
3404-001,2013,11,24,14,305,312,617,566
3404-001,2013,11,24,15,356,322,678,617
3404-001,2013,11,24,16,424,331,755,678
3404-001,2013,11,24,17,473,309,782,755
3404-001,2013,11,24,18,600,317,917,782
3404-001,2013,11,24,19,479,269,748,917
3404-001,2013,11,24,20,322,248,570,748
3404-001,2013,11,24,21,230,287,517,570
3404-001,2013,11,24,22,156,243,399,517
3404-001,2013,11,24,23,81,159,240,399
3404-001,2013,11,24,24,65,105,170,240
3404-001,2013,11,25,1,41,74,115,170
3404-001,2013,11,25,2,29,44,73,115
3404-001,2013,11,25,3,22,35,57,73
3404-001,2013,11,25,4,25,33,58,57
3404-001,2013,11,25,5,46,71,117,58
3404-001,2013,11,25,6,87,159,246,117
3404-001,2013,11,25,7,184,461,645,246
3404-001,2013,11,25,8,449,1463,1912,645
3404-001,2013,11,25,9,497,1256,1753,1912
3404-001,2013,11,25,10,549,643,1192,1753
3404-001,2013,11,25,11,553,635,1188,1192
3404-001,2013,11,25,12,568,570,1138,1188
3404-001,2013,11,25,13,501,511,1012,1138
3404-001,2013,11,25,14,576,580,1156,1012
3404-001,2013,11,25,15,662,643,1305,1156
3404-001,2013,11,25,16,698,616,1314,1305
3404-001,2013,11,25,17,679,552,1231,1314
3404-001,2013,11,25,18,865,491,1356,1231
3404-001,2013,11,25,19,834,427,1261,1356
3404-001,2013,11,25,20,642,314,956,1261
3404-001,2013,11,25,21,537,251,788,956
3404-001,2013,11,25,22,332,183,515,788
3404-001,2013,11,25,23,181,133,314,515
3404-001,2013,11,25,24,92,82,174,314
3404-001,2013,11,26,1,85,66,151,174
3404-001,2013,11,26,2,39,44,83,151
3404-001,2013,11,26,3,37,48,85,83
3404-001,2013,11,26,4,37,52,89,85
3404-001,2013,11,26,5,48,81,129,89
3404-001,2013,11,26,6,102,153,255,129
3404-001,2013,11,26,7,158,401,559,255
3404-001,2013,11,26,8,436,1313,1749,559
3404-001,2013,11,26,9,595,1122,1717,1749
3404-001,2013,11,26,10,612,637,1249,1717
3404-001,2013,11,26,11,571,667,1238,1249
3404-001,2013,11,26,12,622,592,1214,1238
3404-001,2013,11,26,13,510,495,1005,1214
3404-001,2013,11,26,14,592,608,1200,1005
3404-001,2013,11,26,15,704,638,1342,1200
3404-001,2013,11,26,16,673,636,1309,1342
3404-001,2013,11,26,17,762,531,1293,1309
3404-001,2013,11,26,18,929,504,1433,1293
3404-001,2013,11,26,19,878,424,1302,1433
3404-001,2013,11,26,20,619,342,961,1302
3404-001,2013,11,26,21,508,264,772,961
3404-001,2013,11,26,22,337,187,524,772
3404-001,2013,11,26,23,195,138,333,524
3404-001,2013,11,26,24,99,79,178,333
3404-001,2013,11,27,1,69,67,136,178
3404-001,2013,11,27,2,45,50,95,136
3404-001,2013,11,27,3,42,40,82,95
3404-001,2013,11,27,4,33,44,77,82
3404-001,2013,11,27,5,55,72,127,77
3404-001,2013,11,27,6,97,137,234,127
3404-001,2013,11,27,7,162,413,575,234
3404-001,2013,11,27,8,457,1355,1812,575
3404-001,2013,11,27,9,630,1144,1774,1812
3404-001,2013,11,27,10,606,654,1260,1774
3404-001,2013,11,27,11,611,649,1260,1260
3404-001,2013,11,27,12,597,612,1209,1260
3404-001,2013,11,27,13,542,492,1034,1209
3404-001,2013,11,27,14,587,602,1189,1034
3404-001,2013,11,27,15,678,627,1305,1189
3404-001,2013,11,27,16,713,592,1305,1305
3404-001,2013,11,27,17,709,553,1262,1305
3404-001,2013,11,27,18,889,501,1390,1262
3404-001,2013,11,27,19,902,431,1333,1390
3404-001,2013,11,27,20,600,336,936,1333
3404-001,2013,11,27,21,475,261,736,936
3404-001,2013,11,27,22,300,183,483,736
3404-001,2013,11,27,23,203,132,335,483
3404-001,2013,11,27,24,103,90,193,335
3404-001,2013,11,28,1,71,68,139,193
3404-001,2013,11,28,2,41,37,78,139
3404-001,2013,11,28,3,36,42,78,78
3404-001,2013,11,28,4,39,33,72,78
3404-001,2013,11,28,5,55,75,130,72
3404-001,2013,11,28,6,87,143,230,130
3404-001,2013,11,28,7,163,382,545,230
3404-001,2013,11,28,8,448,1303,1751,545
3404-001,2013,11,28,9,608,1196,1804,1751
3404-001,2013,11,28,10,593,643,1236,1804
3404-001,2013,11,28,11,628,671,1299,1236
3404-001,2013,11,28,12,577,591,1168,1299
3404-001,2013,11,28,13,521,504,1025,1168
3404-001,2013,11,28,14,575,565,1140,1025
3404-001,2013,11,28,15,670,625,1295,1140
3404-001,2013,11,28,16,690,604,1294,1295
3404-001,2013,11,28,17,704,569,1273,1294
3404-001,2013,11,28,18,929,504,1433,1273
3404-001,2013,11,28,19,862,402,1264,1433
3404-001,2013,11,28,20,614,329,943,1264
3404-001,2013,11,28,21,487,245,732,943
3404-001,2013,11,28,22,301,191,492,732
3404-001,2013,11,28,23,183,126,309,492
3404-001,2013,11,28,24,110,86,196,309
3404-001,2013,11,29,1,82,79,161,196
3404-001,2013,11,29,2,43,45,88,161
3404-001,2013,11,29,3,35,42,77,88
3404-001,2013,11,29,4,41,41,82,77
3404-001,2013,11,29,5,53,69,122,82
3404-001,2013,11,29,6,83,165,248,122
3404-001,2013,11,29,7,170,396,566,248
3404-001,2013,11,29,8,455,1296,1751,566
3404-001,2013,11,29,9,591,1131,1722,1751
3404-001,2013,11,29,10,601,713,1314,1722
3404-001,2013,11,29,11,635,654,1289,1314
3404-001,2013,11,29,12,625,601,1226,1289
3404-001,2013,11,29,13,527,504,1031,1226
3404-001,2013,11,29,14,601,573,1174,1031
3404-001,2013,11,29,15,711,650,1361,1174
3404-001,2013,11,29,16,724,616,1340,1361
3404-001,2013,11,29,17,758,565,1323,1340
3404-001,2013,11,29,18,1050,536,1586,1323
3404-001,2013,11,29,19,1051,465,1516,1586
3404-001,2013,11,29,20,658,354,1012,1516
3404-001,2013,11,29,21,510,271,781,1012
3404-001,2013,11,29,22,323,197,520,781
3404-001,2013,11,29,23,189,148,337,520
3404-001,2013,11,29,24,133,97,230,337
3404-001,2013,11,30,1,81,77,158,230
3404-001,2013,11,30,2,64,56,120,158
3404-001,2013,11,30,3,52,48,100,120
3404-001,2013,11,30,4,35,43,78,100
3404-001,2013,11,30,5,48,68,116,78
3404-001,2013,11,30,6,75,142,217,116
3404-001,2013,11,30,7,165,270,435,217
3404-001,2013,11,30,8,313,659,972,435
3404-001,2013,11,30,9,461,595,1056,972
3404-001,2013,11,30,10,456,555,1011,1056
3404-001,2013,11,30,11,510,506,1016,1011
3404-001,2013,11,30,12,495,472,967,1016
3404-001,2013,11,30,13,453,465,918,967
3404-001,2013,11,30,14,462,464,926,918
3404-001,2013,11,30,15,471,465,936,926
3404-001,2013,11,30,16,523,431,954,936
3404-001,2013,11,30,17,585,417,1002,954
3404-001,2013,11,30,18,730,376,1106,1002
3404-001,2013,11,30,19,490,305,795,1106
3404-001,2013,11,30,20,325,240,565,795
3404-001,2013,11,30,21,222,192,414,565
3404-001,2013,11,30,22,161,135,296,414
3404-001,2013,11,30,23,110,105,215,296
3404-001,2013,11,30,24,71,65,136,215
3404-001,2013,12,1,1,49,53,102,136
3404-001,2013,12,1,2,41,30,71,102
3404-001,2013,12,1,3,27,23,50,71
3404-001,2013,12,1,4,21,25,46,50
3404-001,2013,12,1,5,33,27,60,46
3404-001,2013,12,1,6,39,48,87,60
3404-001,2013,12,1,7,62,119,181,87
3404-001,2013,12,1,8,154,241,395,181
3404-001,2013,12,1,9,193,264,457,395
3404-001,2013,12,1,10,211,234,445,457
3404-001,2013,12,1,11,277,259,536,445
3404-001,2013,12,1,12,269,275,544,536
3404-001,2013,12,1,13,268,295,563,544
3404-001,2013,12,1,14,336,347,683,563
3404-001,2013,12,1,15,341,340,681,683
3404-001,2013,12,1,16,396,281,677,681
3404-001,2013,12,1,17,480,292,772,677
3404-001,2013,12,1,18,583,285,868,772
3404-001,2013,12,1,19,356,261,617,868
3404-001,2013,12,1,20,221,249,470,617
3404-001,2013,12,1,21,171,193,364,470
3404-001,2013,12,1,22,148,183,331,364
3404-001,2013,12,1,23,64,130,194,331
3404-001,2013,12,1,24,62,97,159,194
3404-001,2013,12,2,1,30,67,97,159
3404-001,2013,12,2,2,29,51,80,97
3404-001,2013,12,2,3,26,24,50,80
3404-001,2013,12,2,4,21,45,66,50
3404-001,2013,12,2,5,33,68,101,66
3404-001,2013,12,2,6,76,150,226,101
3404-001,2013,12,2,7,187,493,680,226
3404-001,2013,12,2,8,453,1548,2001,680
3404-001,2013,12,2,9,516,1309,1825,2001
3404-001,2013,12,2,10,547,602,1149,1825
3404-001,2013,12,2,11,585,601,1186,1149
3404-001,2013,12,2,12,560,589,1149,1186
3404-001,2013,12,2,13,519,490,1009,1149
3404-001,2013,12,2,14,606,559,1165,1009
3404-001,2013,12,2,15,641,662,1303,1165
3404-001,2013,12,2,16,691,636,1327,1303
3404-001,2013,12,2,17,681,555,1236,1327
3404-001,2013,12,2,18,916,449,1365,1236
3404-001,2013,12,2,19,804,396,1200,1365
3404-001,2013,12,2,20,671,321,992,1200
3404-001,2013,12,2,21,530,267,797,992
3404-001,2013,12,2,22,320,177,497,797
3404-001,2013,12,2,23,183,142,325,497
3404-001,2013,12,2,24,115,68,183,325
3404-001,2013,12,3,1,79,52,131,183
3404-001,2013,12,3,2,57,52,109,131
3404-001,2013,12,3,3,45,37,82,109
3404-001,2013,12,3,4,40,45,85,82
3404-001,2013,12,3,5,58,82,140,85
3404-001,2013,12,3,6,72,137,209,140
3404-001,2013,12,3,7,171,424,595,209
3404-001,2013,12,3,8,429,1362,1791,595
3404-001,2013,12,3,9,587,1267,1854,1791
3404-001,2013,12,3,10,628,663,1291,1854
3404-001,2013,12,3,11,642,662,1304,1291
3404-001,2013,12,3,12,634,580,1214,1304
3404-001,2013,12,3,13,481,487,968,1214
3404-001,2013,12,3,14,621,650,1271,968
3404-001,2013,12,3,15,712,625,1337,1271
3404-001,2013,12,3,16,716,641,1357,1337
3404-001,2013,12,3,17,739,567,1306,1357
3404-001,2013,12,3,18,873,477,1350,1306
3404-001,2013,12,3,19,811,389,1200,1350
3404-001,2013,12,3,20,608,286,894,1200
3404-001,2013,12,3,21,531,256,787,894
3404-001,2013,12,3,22,323,191,514,787
3404-001,2013,12,3,23,165,124,289,514
3404-001,2013,12,3,24,112,81,193,289
3404-001,2013,12,4,1,69,62,131,193
3404-001,2013,12,4,2,68,43,111,131
3404-001,2013,12,4,3,38,38,76,111
3404-001,2013,12,4,4,42,52,94,76
3404-001,2013,12,4,5,59,75,134,94
3404-001,2013,12,4,6,73,122,195,134
3404-001,2013,12,4,7,163,408,571,195
3404-001,2013,12,4,8,411,1352,1763,571
3404-001,2013,12,4,9,614,1234,1848,1763
3404-001,2013,12,4,10,591,642,1233,1848
3404-001,2013,12,4,11,647,633,1280,1233
3404-001,2013,12,4,12,622,663,1285,1280
3404-001,2013,12,4,13,490,537,1027,1285
3404-001,2013,12,4,14,663,595,1258,1027
3404-001,2013,12,4,15,737,644,1381,1258
3404-001,2013,12,4,16,731,632,1363,1381
3404-001,2013,12,4,17,757,558,1315,1363
3404-001,2013,12,4,18,983,495,1478,1315
3404-001,2013,12,4,19,939,413,1352,1478
3404-001,2013,12,4,20,598,307,905,1352
3404-001,2013,12,4,21,470,224,694,905
3404-001,2013,12,4,22,315,217,532,694
3404-001,2013,12,4,23,194,159,353,532
3404-001,2013,12,4,24,111,103,214,353
3404-001,2013,12,5,1,66,70,136,214
3404-001,2013,12,5,2,72,36,108,136
3404-001,2013,12,5,3,54,32,86,108
3404-001,2013,12,5,4,43,42,85,86
3404-001,2013,12,5,5,47,75,122,85
3404-001,2013,12,5,6,94,151,245,122
3404-001,2013,12,5,7,192,464,656,245
3404-001,2013,12,5,8,424,1360,1784,656
3404-001,2013,12,5,9,617,1183,1800,1784
3404-001,2013,12,5,10,618,694,1312,1800
3404-001,2013,12,5,11,653,627,1280,1312
3404-001,2013,12,5,12,586,671,1257,1280
3404-001,2013,12,5,13,535,511,1046,1257
3404-001,2013,12,5,14,610,615,1225,1046
3404-001,2013,12,5,15,686,665,1351,1225
3404-001,2013,12,5,16,690,653,1343,1351
3404-001,2013,12,5,17,713,585,1298,1343
3404-001,2013,12,5,18,937,543,1480,1298
3404-001,2013,12,5,19,919,439,1358,1480
3404-001,2013,12,5,20,578,317,895,1358
3404-001,2013,12,5,21,540,240,780,895
3404-001,2013,12,5,22,331,212,543,780
3404-001,2013,12,5,23,189,127,316,543
3404-001,2013,12,5,24,118,80,198,316
3404-001,2013,12,6,1,64,62,126,198
3404-001,2013,12,6,2,54,50,104,126
3404-001,2013,12,6,3,34,37,71,104
3404-001,2013,12,6,4,38,52,90,71
3404-001,2013,12,6,5,55,78,133,90
3404-001,2013,12,6,6,92,135,227,133
3404-001,2013,12,6,7,165,407,572,227
3404-001,2013,12,6,8,461,1392,1853,572
3404-001,2013,12,6,9,599,1213,1812,1853
3404-001,2013,12,6,10,678,626,1304,1812
3404-001,2013,12,6,11,638,692,1330,1304
3404-001,2013,12,6,12,626,647,1273,1330
3404-001,2013,12,6,13,585,521,1106,1273
3404-001,2013,12,6,14,650,592,1242,1106
3404-001,2013,12,6,15,708,694,1402,1242
3404-001,2013,12,6,16,749,675,1424,1402
3404-001,2013,12,6,17,754,535,1289,1424
3404-001,2013,12,6,18,1073,542,1615,1289
3404-001,2013,12,6,19,998,444,1442,1615
3404-001,2013,12,6,20,764,375,1139,1442
3404-001,2013,12,6,21,516,254,770,1139
3404-001,2013,12,6,22,332,198,530,770
3404-001,2013,12,6,23,216,131,347,530
3404-001,2013,12,6,24,118,87,205,347
3404-001,2013,12,7,1,79,85,164,205
3404-001,2013,12,7,2,75,54,129,164
3404-001,2013,12,7,3,33,42,75,129
3404-001,2013,12,7,4,35,44,79,75
3404-001,2013,12,7,5,52,58,110,79
3404-001,2013,12,7,6,80,135,215,110
3404-001,2013,12,7,7,155,266,421,215
3404-001,2013,12,7,8,276,652,928,421
3404-001,2013,12,7,9,480,653,1133,928
3404-001,2013,12,7,10,514,514,1028,1133
3404-001,2013,12,7,11,508,532,1040,1028
3404-001,2013,12,7,12,543,492,1035,1040
3404-001,2013,12,7,13,445,439,884,1035
3404-001,2013,12,7,14,505,444,949,884
3404-001,2013,12,7,15,485,448,933,949
3404-001,2013,12,7,16,548,423,971,933
3404-001,2013,12,7,17,519,365,884,971
3404-001,2013,12,7,18,718,375,1093,884
3404-001,2013,12,7,19,437,314,751,1093
3404-001,2013,12,7,20,275,244,519,751
3404-001,2013,12,7,21,218,179,397,519
3404-001,2013,12,7,22,140,122,262,397
3404-001,2013,12,7,23,118,99,217,262
3404-001,2013,12,7,24,54,70,124,217
3404-001,2013,12,8,1,44,49,93,124
3404-001,2013,12,8,2,33,23,56,93
3404-001,2013,12,8,3,26,30,56,56
3404-001,2013,12,8,4,21,23,44,56
3404-001,2013,12,8,5,22,12,34,44
3404-001,2013,12,8,6,23,52,75,34
3404-001,2013,12,8,7,55,104,159,75
3404-001,2013,12,8,8,141,236,377,159
3404-001,2013,12,8,9,185,235,420,377
3404-001,2013,12,8,10,217,225,442,420
3404-001,2013,12,8,11,284,277,561,442
3404-001,2013,12,8,12,267,324,591,561
3404-001,2013,12,8,13,276,289,565,591
3404-001,2013,12,8,14,292,325,617,565
3404-001,2013,12,8,15,341,320,661,617
3404-001,2013,12,8,16,427,323,750,661
3404-001,2013,12,8,17,409,319,728,750
3404-001,2013,12,8,18,463,272,735,728
3404-001,2013,12,8,19,310,261,571,735
3404-001,2013,12,8,20,213,207,420,571
3404-001,2013,12,8,21,166,192,358,420
3404-001,2013,12,8,22,124,220,344,358
3404-001,2013,12,8,23,66,129,195,344
3404-001,2013,12,8,24,60,115,175,195
3404-001,2013,12,9,1,34,65,99,175
3404-001,2013,12,9,2,28,42,70,99
3404-001,2013,12,9,3,27,35,62,70
3404-001,2013,12,9,4,26,33,59,62
3404-001,2013,12,9,5,42,62,104,59
3404-001,2013,12,9,6,75,148,223,104
3404-001,2013,12,9,7,166,451,617,223
3404-001,2013,12,9,8,401,1410,1811,617
3404-001,2013,12,9,9,520,1325,1845,1811
3404-001,2013,12,9,10,481,617,1098,1845
3404-001,2013,12,9,11,555,615,1170,1098
3404-001,2013,12,9,12,534,525,1059,1170
3404-001,2013,12,9,13,515,433,948,1059
3404-001,2013,12,9,14,525,530,1055,948
3404-001,2013,12,9,15,598,589,1187,1055
3404-001,2013,12,9,16,624,572,1196,1187
3404-001,2013,12,9,17,615,482,1097,1196
3404-001,2013,12,9,18,798,439,1237,1097
3404-001,2013,12,9,19,793,372,1165,1237
3404-001,2013,12,9,20,543,320,863,1165
3404-001,2013,12,9,21,505,217,722,863
3404-001,2013,12,9,22,345,182,527,722
3404-001,2013,12,9,23,173,129,302,527
3404-001,2013,12,9,24,92,86,178,302
3404-001,2013,12,10,1,62,71,133,178
3404-001,2013,12,10,2,62,40,102,133
3404-001,2013,12,10,3,36,42,78,102
3404-001,2013,12,10,4,32,55,87,78
3404-001,2013,12,10,5,50,71,121,87
3404-001,2013,12,10,6,86,142,228,121
3404-001,2013,12,10,7,145,370,515,228
3404-001,2013,12,10,8,405,1357,1762,515
3404-001,2013,12,10,9,624,1188,1812,1762
3404-001,2013,12,10,10,605,663,1268,1812
3404-001,2013,12,10,11,648,674,1322,1268
3404-001,2013,12,10,12,574,614,1188,1322
3404-001,2013,12,10,13,554,533,1087,1188
3404-001,2013,12,10,14,619,612,1231,1087
3404-001,2013,12,10,15,705,685,1390,1231
3404-001,2013,12,10,16,711,662,1373,1390
3404-001,2013,12,10,17,730,529,1259,1373
3404-001,2013,12,10,18,909,501,1410,1259
3404-001,2013,12,10,19,848,409,1257,1410
3404-001,2013,12,10,20,583,329,912,1257
3404-001,2013,12,10,21,522,245,767,912
3404-001,2013,12,10,22,368,192,560,767
3404-001,2013,12,10,23,203,138,341,560
3404-001,2013,12,10,24,105,127,232,341
3404-001,2013,12,11,1,83,87,170,232
3404-001,2013,12,11,2,65,79,144,170
3404-001,2013,12,11,3,33,46,79,144
3404-001,2013,12,11,4,54,58,112,79
3404-001,2013,12,11,5,55,69,124,112
3404-001,2013,12,11,6,66,92,158,124
3404-001,2013,12,11,7,130,138,268,158
3404-001,2013,12,11,8,325,641,966,268
3404-001,2013,12,11,9,529,949,1478,966
3404-001,2013,12,11,10,501,705,1206,1478
3404-001,2013,12,11,11,531,612,1143,1206
3404-001,2013,12,11,12,575,531,1106,1143
3404-001,2013,12,11,13,477,466,943,1106
3404-001,2013,12,11,14,485,546,1031,943
3404-001,2013,12,11,15,616,600,1216,1031
3404-001,2013,12,11,16,671,544,1215,1216
3404-001,2013,12,11,17,650,413,1063,1215
3404-001,2013,12,11,18,880,364,1244,1063
3404-001,2013,12,11,19,698,315,1013,1244
3404-001,2013,12,11,20,525,253,778,1013
3404-001,2013,12,11,21,341,169,510,778
3404-001,2013,12,11,22,213,112,325,510
3404-001,2013,12,11,23,147,110,257,325
3404-001,2013,12,11,24,76,78,154,257
3404-001,2013,12,12,1,78,60,138,154
3404-001,2013,12,12,2,41,44,85,138
3404-001,2013,12,12,3,44,41,85,85
3404-001,2013,12,12,4,40,44,84,85
3404-001,2013,12,12,5,49,67,116,84
3404-001,2013,12,12,6,89,152,241,116
3404-001,2013,12,12,7,180,409,589,241
3404-001,2013,12,12,8,421,1251,1672,589
3404-001,2013,12,12,9,599,1180,1779,1672
3404-001,2013,12,12,10,569,666,1235,1779
3404-001,2013,12,12,11,593,644,1237,1235
3404-001,2013,12,12,12,608,568,1176,1237
3404-001,2013,12,12,13,492,473,965,1176
3404-001,2013,12,12,14,597,557,1154,965
3404-001,2013,12,12,15,672,632,1304,1154
3404-001,2013,12,12,16,696,597,1293,1304
3404-001,2013,12,12,17,704,573,1277,1293
3404-001,2013,12,12,18,923,480,1403,1277
3404-001,2013,12,12,19,855,430,1285,1403
3404-001,2013,12,12,20,615,340,955,1285
3404-001,2013,12,12,21,503,243,746,955
3404-001,2013,12,12,22,350,227,577,746
3404-001,2013,12,12,23,197,128,325,577
3404-001,2013,12,12,24,95,89,184,325
3404-001,2013,12,13,1,70,72,142,184
3404-001,2013,12,13,2,55,46,101,142
3404-001,2013,12,13,3,47,50,97,101
3404-001,2013,12,13,4,39,46,85,97
3404-001,2013,12,13,5,50,70,120,85
3404-001,2013,12,13,6,81,155,236,120
3404-001,2013,12,13,7,174,404,578,236
3404-001,2013,12,13,8,415,1261,1676,578
3404-001,2013,12,13,9,604,1187,1791,1676
3404-001,2013,12,13,10,579,691,1270,1791
3404-001,2013,12,13,11,606,671,1277,1270
3404-001,2013,12,13,12,626,617,1243,1277
3404-001,2013,12,13,13,537,538,1075,1243
3404-001,2013,12,13,14,604,598,1202,1075
3404-001,2013,12,13,15,712,646,1358,1202
3404-001,2013,12,13,16,730,651,1381,1358
3404-001,2013,12,13,17,778,574,1352,1381
3404-001,2013,12,13,18,1068,561,1629,1352
3404-001,2013,12,13,19,1112,487,1599,1629
3404-001,2013,12,13,20,735,399,1134,1599
3404-001,2013,12,13,21,557,284,841,1134
3404-001,2013,12,13,22,352,197,549,841
3404-001,2013,12,13,23,201,130,331,549
3404-001,2013,12,13,24,134,106,240,331
3404-001,2013,12,14,1,77,69,146,240
3404-001,2013,12,14,2,57,47,104,146
3404-001,2013,12,14,3,55,48,103,104
3404-001,2013,12,14,4,45,54,99,103
3404-001,2013,12,14,5,50,68,118,99
3404-001,2013,12,14,6,90,126,216,118
3404-001,2013,12,14,7,168,275,443,216
3404-001,2013,12,14,8,301,684,985,443
3404-001,2013,12,14,9,468,715,1183,985
3404-001,2013,12,14,10,484,536,1020,1183
3404-001,2013,12,14,11,531,559,1090,1020
3404-001,2013,12,14,12,489,515,1004,1090
3404-001,2013,12,14,13,453,484,937,1004
3404-001,2013,12,14,14,466,496,962,937
3404-001,2013,12,14,15,526,516,1042,962
3404-001,2013,12,14,16,560,472,1032,1042
3404-001,2013,12,14,17,582,450,1032,1032
3404-001,2013,12,14,18,813,437,1250,1032
3404-001,2013,12,14,19,582,352,934,1250
3404-001,2013,12,14,20,382,279,661,934
3404-001,2013,12,14,21,252,209,461,661
3404-001,2013,12,14,22,188,162,350,461
3404-001,2013,12,14,23,120,103,223,350
3404-001,2013,12,14,24,75,64,139,223
3404-001,2013,12,15,1,66,53,119,139
3404-001,2013,12,15,2,49,34,83,119
3404-001,2013,12,15,3,27,22,49,83
3404-001,2013,12,15,4,20,25,45,49
3404-001,2013,12,15,5,26,32,58,45
3404-001,2013,12,15,6,34,55,89,58
3404-001,2013,12,15,7,69,120,189,89
3404-001,2013,12,15,8,148,270,418,189
3404-001,2013,12,15,9,175,265,440,418
3404-001,2013,12,15,10,233,280,513,440
3404-001,2013,12,15,11,266,301,567,513
3404-001,2013,12,15,12,243,301,544,567
3404-001,2013,12,15,13,272,293,565,544
3404-001,2013,12,15,14,346,287,633,565
3404-001,2013,12,15,15,374,296,670,633
3404-001,2013,12,15,16,416,326,742,670
3404-001,2013,12,15,17,499,312,811,742
3404-001,2013,12,15,18,693,306,999,811
3404-001,2013,12,15,19,535,301,836,999
3404-001,2013,12,15,20,363,328,691,836
3404-001,2013,12,15,21,245,247,492,691
3404-001,2013,12,15,22,174,201,375,492
3404-001,2013,12,15,23,81,161,242,375
3404-001,2013,12,15,24,59,112,171,242
3404-001,2013,12,16,1,37,69,106,171
3404-001,2013,12,16,2,21,53,74,106
3404-001,2013,12,16,3,22,35,57,74
3404-001,2013,12,16,4,24,36,60,57
3404-001,2013,12,16,5,41,66,107,60
3404-001,2013,12,16,6,92,160,252,107
3404-001,2013,12,16,7,186,474,660,252
3404-001,2013,12,16,8,439,1494,1933,660
3404-001,2013,12,16,9,517,1264,1781,1933
3404-001,2013,12,16,10,527,665,1192,1781
3404-001,2013,12,16,11,553,624,1177,1192
3404-001,2013,12,16,12,551,573,1124,1177
3404-001,2013,12,16,13,522,515,1037,1124
3404-001,2013,12,16,14,559,578,1137,1037
3404-001,2013,12,16,15,663,616,1279,1137
3404-001,2013,12,16,16,677,596,1273,1279
3404-001,2013,12,16,17,685,537,1222,1273
3404-001,2013,12,16,18,859,462,1321,1222
3404-001,2013,12,16,19,848,406,1254,1321
3404-001,2013,12,16,20,624,310,934,1254
3404-001,2013,12,16,21,528,248,776,934
3404-001,2013,12,16,22,328,159,487,776
3404-001,2013,12,16,23,177,140,317,487
3404-001,2013,12,16,24,88,76,164,317
3404-001,2013,12,17,1,77,81,158,164
3404-001,2013,12,17,2,45,46,91,158
3404-001,2013,12,17,3,45,47,92,91
3404-001,2013,12,17,4,43,51,94,92
3404-001,2013,12,17,5,43,75,118,94
3404-001,2013,12,17,6,99,154,253,118
3404-001,2013,12,17,7,159,415,574,253
3404-001,2013,12,17,8,418,1316,1734,574
3404-001,2013,12,17,9,616,1161,1777,1734
3404-001,2013,12,17,10,597,668,1265,1777
3404-001,2013,12,17,11,604,653,1257,1265
3404-001,2013,12,17,12,608,589,1197,1257
3404-001,2013,12,17,13,527,484,1011,1197
3404-001,2013,12,17,14,582,588,1170,1011
3404-001,2013,12,17,15,700,668,1368,1170
3404-001,2013,12,17,16,643,612,1255,1368
3404-001,2013,12,17,17,711,554,1265,1255
3404-001,2013,12,17,18,907,508,1415,1265
3404-001,2013,12,17,19,879,407,1286,1415
3404-001,2013,12,17,20,620,316,936,1286
3404-001,2013,12,17,21,533,254,787,936
3404-001,2013,12,17,22,333,203,536,787
3404-001,2013,12,17,23,192,130,322,536
3404-001,2013,12,17,24,95,88,183,322
3404-001,2013,12,18,1,75,66,141,183
3404-001,2013,12,18,2,52,51,103,141
3404-001,2013,12,18,3,47,40,87,103
3404-001,2013,12,18,4,40,41,81,87
3404-001,2013,12,18,5,55,62,117,81
3404-001,2013,12,18,6,89,146,235,117
3404-001,2013,12,18,7,162,422,584,235
3404-001,2013,12,18,8,444,1353,1797,584
3404-001,2013,12,18,9,601,1171,1772,1797
3404-001,2013,12,18,10,597,665,1262,1772
3404-001,2013,12,18,11,616,637,1253,1262
3404-001,2013,12,18,12,599,617,1216,1253
3404-001,2013,12,18,13,548,504,1052,1216
3404-001,2013,12,18,14,600,583,1183,1052
3404-001,2013,12,18,15,638,626,1264,1183
3404-001,2013,12,18,16,714,630,1344,1264
3404-001,2013,12,18,17,705,546,1251,1344
3404-001,2013,12,18,18,929,485,1414,1251
3404-001,2013,12,18,19,906,433,1339,1414
3404-001,2013,12,18,20,608,320,928,1339
3404-001,2013,12,18,21,494,248,742,928
3404-001,2013,12,18,22,322,177,499,742
3404-001,2013,12,18,23,199,136,335,499
3404-001,2013,12,18,24,102,91,193,335
3404-001,2013,12,19,1,69,66,135,193
3404-001,2013,12,19,2,42,47,89,135
3404-001,2013,12,19,3,36,42,78,89
3404-001,2013,12,19,4,39,39,78,78
3404-001,2013,12,19,5,58,75,133,78
3404-001,2013,12,19,6,89,147,236,133
3404-001,2013,12,19,7,177,409,586,236
3404-001,2013,12,19,8,451,1302,1753,586
3404-001,2013,12,19,9,604,1165,1769,1753
3404-001,2013,12,19,10,584,670,1254,1769
3404-001,2013,12,19,11,645,653,1298,1254
3404-001,2013,12,19,12,617,576,1193,1298
3404-001,2013,12,19,13,507,495,1002,1193
3404-001,2013,12,19,14,584,558,1142,1002
3404-001,2013,12,19,15,682,632,1314,1142
3404-001,2013,12,19,16,669,587,1256,1314
3404-001,2013,12,19,17,710,554,1264,1256
3404-001,2013,12,19,18,927,501,1428,1264
3404-001,2013,12,19,19,870,404,1274,1428
3404-001,2013,12,19,20,587,325,912,1274
3404-001,2013,12,19,21,476,234,710,912
3404-001,2013,12,19,22,296,187,483,710
3404-001,2013,12,19,23,183,122,305,483
3404-001,2013,12,19,24,105,87,192,305
3404-001,2013,12,20,1,79,65,144,192
3404-001,2013,12,20,2,50,45,95,144
3404-001,2013,12,20,3,35,47,82,95
3404-001,2013,12,20,4,36,41,77,82
3404-001,2013,12,20,5,54,70,124,77
3404-001,2013,12,20,6,87,170,257,124
3404-001,2013,12,20,7,164,418,582,257
3404-001,2013,12,20,8,456,1287,1743,582
3404-001,2013,12,20,9,600,1113,1713,1743
3404-001,2013,12,20,10,589,675,1264,1713
3404-001,2013,12,20,11,649,635,1284,1264
3404-001,2013,12,20,12,622,579,1201,1284
3404-001,2013,12,20,13,521,518,1039,1201
3404-001,2013,12,20,14,616,592,1208,1039
3404-001,2013,12,20,15,716,648,1364,1208
3404-001,2013,12,20,16,729,607,1336,1364
3404-001,2013,12,20,17,756,574,1330,1336
3404-001,2013,12,20,18,1045,546,1591,1330
3404-001,2013,12,20,19,1030,445,1475,1591
3404-001,2013,12,20,20,666,353,1019,1475
3404-001,2013,12,20,21,483,259,742,1019
3404-001,2013,12,20,22,316,205,521,742
3404-001,2013,12,20,23,191,135,326,521
3404-001,2013,12,20,24,124,95,219,326
3404-001,2013,12,21,1,78,75,153,219
3404-001,2013,12,21,2,55,52,107,153
3404-001,2013,12,21,3,40,44,84,107
3404-001,2013,12,21,4,40,50,90,84
3404-001,2013,12,21,5,52,63,115,90
3404-001,2013,12,21,6,77,141,218,115
3404-001,2013,12,21,7,170,283,453,218
3404-001,2013,12,21,8,296,680,976,453
3404-001,2013,12,21,9,459,617,1076,976
3404-001,2013,12,21,10,476,543,1019,1076
3404-001,2013,12,21,11,549,506,1055,1019
3404-001,2013,12,21,12,482,511,993,1055
3404-001,2013,12,21,13,449,444,893,993
3404-001,2013,12,21,14,455,446,901,893
3404-001,2013,12,21,15,495,466,961,901
3404-001,2013,12,21,16,522,454,976,961
3404-001,2013,12,21,17,567,435,1002,976
3404-001,2013,12,21,18,766,404,1170,1002
3404-001,2013,12,21,19,515,353,868,1170
3404-001,2013,12,21,20,323,249,572,868
3404-001,2013,12,21,21,233,195,428,572
3404-001,2013,12,21,22,172,145,317,428
3404-001,2013,12,21,23,110,101,211,317
3404-001,2013,12,21,24,73,59,132,211
3404-001,2013,12,22,1,55,44,99,132
3404-001,2013,12,22,2,41,35,76,99
3404-001,2013,12,22,3,30,25,55,76
3404-001,2013,12,22,4,22,27,49,55
3404-001,2013,12,22,5,28,31,59,49
3404-001,2013,12,22,6,40,77,117,59
3404-001,2013,12,22,7,77,128,205,117
3404-001,2013,12,22,8,136,247,383,205
3404-001,2013,12,22,9,203,245,448,383
3404-001,2013,12,22,10,220,282,502,448
3404-001,2013,12,22,11,280,287,567,502
3404-001,2013,12,22,12,248,303,551,567
3404-001,2013,12,22,13,257,307,564,551
3404-001,2013,12,22,14,297,320,617,564
3404-001,2013,12,22,15,346,324,670,617
3404-001,2013,12,22,16,455,320,775,670
3404-001,2013,12,22,17,491,301,792,775
3404-001,2013,12,22,18,578,323,901,792
3404-001,2013,12,22,19,481,267,748,901
3404-001,2013,12,22,20,348,249,597,748
3404-001,2013,12,22,21,227,251,478,597
3404-001,2013,12,22,22,164,225,389,478
3404-001,2013,12,22,23,72,168,240,389
3404-001,2013,12,22,24,59,105,164,240
3404-001,2013,12,23,1,39,72,111,164
3404-001,2013,12,23,2,24,35,59,111
3404-001,2013,12,23,3,18,33,51,59
3404-001,2013,12,23,4,23,36,59,51
3404-001,2013,12,23,5,42,68,110,59
3404-001,2013,12,23,6,86,165,251,110
3404-001,2013,12,23,7,175,474,649,251
3404-001,2013,12,23,8,441,1468,1909,649
3404-001,2013,12,23,9,501,1235,1736,1909
3404-001,2013,12,23,10,542,615,1157,1736
3404-001,2013,12,23,11,565,623,1188,1157
3404-001,2013,12,23,12,555,565,1120,1188
3404-001,2013,12,23,13,495,505,1000,1120
3404-001,2013,12,23,14,582,590,1172,1000
3404-001,2013,12,23,15,646,632,1278,1172
3404-001,2013,12,23,16,690,590,1280,1278
3404-001,2013,12,23,17,680,536,1216,1280
3404-001,2013,12,23,18,856,478,1334,1216
3404-001,2013,12,23,19,856,411,1267,1334
3404-001,2013,12,23,20,631,331,962,1267
3404-001,2013,12,23,21,531,237,768,962
3404-001,2013,12,23,22,326,188,514,768
3404-001,2013,12,23,23,173,129,302,514
3404-001,2013,12,23,24,99,76,175,302
3404-001,2013,12,24,1,85,66,151,175
3404-001,2013,12,24,2,39,44,83,151
3404-001,2013,12,24,3,37,48,85,83
3404-001,2013,12,24,4,37,52,89,85
3404-001,2013,12,24,5,48,81,129,89
3404-001,2013,12,24,6,102,153,255,129
3404-001,2013,12,24,7,158,401,559,255
3404-001,2013,12,24,8,436,1313,1749,559
3404-001,2013,12,24,9,595,1122,1717,1749
3404-001,2013,12,24,10,612,637,1249,1717
3404-001,2013,12,24,11,571,667,1238,1249
3404-001,2013,12,24,12,622,592,1214,1238
3404-001,2013,12,24,13,510,495,1005,1214
3404-001,2013,12,24,14,592,608,1200,1005
3404-001,2013,12,24,15,704,638,1342,1200
3404-001,2013,12,24,16,673,636,1309,1342
3404-001,2013,12,24,17,762,531,1293,1309
3404-001,2013,12,24,18,929,504,1433,1293
3404-001,2013,12,24,19,878,424,1302,1433
3404-001,2013,12,24,20,619,342,961,1302
3404-001,2013,12,24,21,508,264,772,961
3404-001,2013,12,24,22,337,187,524,772
3404-001,2013,12,24,23,195,138,333,524
3404-001,2013,12,24,24,99,79,178,333
3404-001,2013,12,25,1,76,66,142,178
3404-001,2013,12,25,2,45,41,86,142
3404-001,2013,12,25,3,44,43,87,86
3404-001,2013,12,25,4,36,44,80,87
3404-001,2013,12,25,5,50,68,118,80
3404-001,2013,12,25,6,94,137,231,118
3404-001,2013,12,25,7,170,390,560,231
3404-001,2013,12,25,8,426,1316,1742,560
3404-001,2013,12,25,9,612,1123,1735,1742
3404-001,2013,12,25,10,578,643,1221,1735
3404-001,2013,12,25,11,593,638,1231,1221
3404-001,2013,12,25,12,594,607,1201,1231
3404-001,2013,12,25,13,517,494,1011,1201
3404-001,2013,12,25,14,572,582,1154,1011
3404-001,2013,12,25,15,642,629,1271,1154
3404-001,2013,12,25,16,733,597,1330,1271
3404-001,2013,12,25,17,719,550,1269,1330
3404-001,2013,12,25,18,909,479,1388,1269
3404-001,2013,12,25,19,881,425,1306,1388
3404-001,2013,12,25,20,574,330,904,1306
3404-001,2013,12,25,21,475,249,724,904
3404-001,2013,12,25,22,310,179,489,724
3404-001,2013,12,25,23,183,133,316,489
3404-001,2013,12,25,24,112,89,201,316
3404-001,2013,12,26,1,72,65,137,201
3404-001,2013,12,26,2,42,41,83,137
3404-001,2013,12,26,3,32,38,70,83
3404-001,2013,12,26,4,39,33,72,70
3404-001,2013,12,26,5,56,76,132,72
3404-001,2013,12,26,6,86,139,225,132
3404-001,2013,12,26,7,169,395,564,225
3404-001,2013,12,26,8,440,1278,1718,564
3404-001,2013,12,26,9,595,1202,1797,1718
3404-001,2013,12,26,10,569,657,1226,1797
3404-001,2013,12,26,11,647,647,1294,1226
3404-001,2013,12,26,12,600,588,1188,1294
3404-001,2013,12,26,13,511,500,1011,1188
3404-001,2013,12,26,14,575,573,1148,1011
3404-001,2013,12,26,15,663,626,1289,1148
3404-001,2013,12,26,16,668,583,1251,1289
3404-001,2013,12,26,17,702,556,1258,1251
3404-001,2013,12,26,18,925,520,1445,1258
3404-001,2013,12,26,19,894,414,1308,1445
3404-001,2013,12,26,20,597,316,913,1308
3404-001,2013,12,26,21,493,246,739,913
3404-001,2013,12,26,22,289,194,483,739
3404-001,2013,12,26,23,180,130,310,483
3404-001,2013,12,26,24,108,81,189,310
3404-001,2013,12,27,1,85,71,156,189
3404-001,2013,12,27,2,50,48,98,156
3404-001,2013,12,27,3,42,48,90,98
3404-001,2013,12,27,4,38,40,78,90
3404-001,2013,12,27,5,48,74,122,78
3404-001,2013,12,27,6,89,163,252,122
3404-001,2013,12,27,7,160,410,570,252
3404-001,2013,12,27,8,452,1272,1724,570
3404-001,2013,12,27,9,580,1164,1744,1724
3404-001,2013,12,27,10,587,659,1246,1744
3404-001,2013,12,27,11,644,639,1283,1246
3404-001,2013,12,27,12,624,576,1200,1283
3404-001,2013,12,27,13,522,503,1025,1200
3404-001,2013,12,27,14,622,572,1194,1025
3404-001,2013,12,27,15,698,644,1342,1194
3404-001,2013,12,27,16,711,608,1319,1342
3404-001,2013,12,27,17,754,585,1339,1319
3404-001,2013,12,27,18,1053,551,1604,1339
3404-001,2013,12,27,19,1064,464,1528,1604
3404-001,2013,12,27,20,687,358,1045,1528
3404-001,2013,12,27,21,498,255,753,1045
3404-001,2013,12,27,22,312,207,519,753
3404-001,2013,12,27,23,208,150,358,519
3404-001,2013,12,27,24,120,96,216,358
3404-001,2013,12,28,1,78,72,150,216
3404-001,2013,12,28,2,64,57,121,150
3404-001,2013,12,28,3,50,42,92,121
3404-001,2013,12,28,4,38,46,84,92
3404-001,2013,12,28,5,45,72,117,84
3404-001,2013,12,28,6,70,146,216,117
3404-001,2013,12,28,7,162,266,428,216
3404-001,2013,12,28,8,302,631,933,428
3404-001,2013,12,28,9,460,595,1055,933
3404-001,2013,12,28,10,456,539,995,1055
3404-001,2013,12,28,11,524,478,1002,995
3404-001,2013,12,28,12,504,484,988,1002
3404-001,2013,12,28,13,450,431,881,988
3404-001,2013,12,28,14,475,429,904,881
3404-001,2013,12,28,15,493,441,934,904
3404-001,2013,12,28,16,506,415,921,934
3404-001,2013,12,28,17,568,422,990,921
3404-001,2013,12,28,18,680,384,1064,990
3404-001,2013,12,28,19,466,327,793,1064
3404-001,2013,12,28,20,309,250,559,793
3404-001,2013,12,28,21,222,188,410,559
3404-001,2013,12,28,22,152,137,289,410
3404-001,2013,12,28,23,102,98,200,289
3404-001,2013,12,28,24,68,55,123,200
3404-001,2013,12,29,1,44,49,93,123
3404-001,2013,12,29,2,39,32,71,93
3404-001,2013,12,29,3,25,26,51,71
3404-001,2013,12,29,4,22,24,46,51
3404-001,2013,12,29,5,29,28,57,46
3404-001,2013,12,29,6,40,57,97,57
3404-001,2013,12,29,7,65,114,179,97
3404-001,2013,12,29,8,142,233,375,179
3404-001,2013,12,29,9,190,251,441,375
3404-001,2013,12,29,10,210,250,460,441
3404-001,2013,12,29,11,276,272,548,460
3404-001,2013,12,29,12,245,291,536,548
3404-001,2013,12,29,13,271,289,560,536
3404-001,2013,12,29,14,322,340,662,560
3404-001,2013,12,29,15,355,338,693,662
3404-001,2013,12,29,16,402,308,710,693
3404-001,2013,12,29,17,466,309,775,710
3404-001,2013,12,29,18,589,310,899,775
3404-001,2013,12,29,19,392,266,658,899
3404-001,2013,12,29,20,254,251,505,658
3404-001,2013,12,29,21,190,276,466,505
3404-001,2013,12,29,22,150,233,383,466
3404-001,2013,12,29,23,80,151,231,383
3404-001,2013,12,29,24,65,105,170,231
3404-001,2013,12,30,1,37,73,110,170
3404-001,2013,12,30,2,32,44,76,110
3404-001,2013,12,30,3,23,29,52,76
3404-001,2013,12,30,4,24,40,64,52
3404-001,2013,12,30,5,43,68,111,64
3404-001,2013,12,30,6,77,154,231,111
3404-001,2013,12,30,7,180,474,654,231
3404-001,2013,12,30,8,453,1484,1937,654
3404-001,2013,12,30,9,494,1301,1795,1937
3404-001,2013,12,30,10,562,621,1183,1795
3404-001,2013,12,30,11,581,619,1200,1183
3404-001,2013,12,30,12,572,577,1149,1200
3404-001,2013,12,30,13,506,495,1001,1149
3404-001,2013,12,30,14,603,570,1173,1001
3404-001,2013,12,30,15,650,653,1303,1173
3404-001,2013,12,30,16,688,642,1330,1303
3404-001,2013,12,30,17,683,551,1234,1330
3404-001,2013,12,30,18,892,468,1360,1234
3404-001,2013,12,30,19,822,408,1230,1360
3404-001,2013,12,30,20,659,320,979,1230
3404-001,2013,12,30,21,540,262,802,979
3404-001,2013,12,30,22,336,190,526,802
3404-001,2013,12,30,23,178,131,309,526
3404-001,2013,12,30,24,99,76,175,309
3404-001,2013,12,31,1,81,52,133,175
3404-001,2013,12,31,2,47,51,98,133
3404-001,2013,12,31,3,40,42,82,98
3404-001,2013,12,31,4,39,44,83,82
3404-001,2013,12,31,5,54,80,134,83
3404-001,2013,12,31,6,86,139,225,134
3404-001,2013,12,31,7,160,394,554,225
3404-001,2013,12,31,8,420,1328,1748,554
3404-001,2013,12,31,9,582,1203,1785,1748
3404-001,2013,12,31,10,612,634,1246,1785
3404-001,2013,12,31,11,597,664,1261,1246
3404-001,2013,12,31,12,617,601,1218,1261
3404-001,2013,12,31,13,493,484,977,1218
3404-001,2013,12,31,14,604,628,1232,977
3404-001,2013,12,31,15,707,613,1320,1232
3404-001,2013,12,31,16,709,646,1355,1320
3404-001,2013,12,31,17,751,554,1305,1355
3404-001,2013,12,31,18,897,490,1387,1305
3404-001,2013,12,31,19,828,399,1227,1387
3404-001,2013,12,31,20,607,319,926,1227
3404-001,2013,12,31,21,517,260,777,926
3404-001,2013,12,31,22,333,187,520,777
3404-001,2013,12,31,23,174,136,310,520
3404-001,2013,12,31,24,110,79,189,310
3404-001,2014,1,1,1,72,78,150,189
3404-001,2014,1,1,2,88,68,156,150
3404-001,2014,1,1,3,57,39,96,156
3404-001,2014,1,1,4,38,52,90,96
3404-001,2014,1,1,5,35,81,116,90
3404-001,2014,1,1,6,33,97,130,116
3404-001,2014,1,1,7,53,132,185,130
3404-001,2014,1,1,8,85,123,208,185
3404-001,2014,1,1,9,191,161,352,208
3404-001,2014,1,1,10,211,166,377,352
3404-001,2014,1,1,11,215,240,455,377
3404-001,2014,1,1,12,287,337,624,455
3404-001,2014,1,1,13,285,302,587,624
3404-001,2014,1,1,14,292,273,565,587
3404-001,2014,1,1,15,397,301,698,565
3404-001,2014,1,1,16,385,307,692,698
3404-001,2014,1,1,17,407,263,670,692
3404-001,2014,1,1,18,353,222,575,670
3404-001,2014,1,1,19,295,222,517,575
3404-001,2014,1,1,20,218,210,428,517
3404-001,2014,1,1,21,159,140,299,428
3404-001,2014,1,1,22,98,152,250,299
3404-001,2014,1,1,23,70,107,177,250
3404-001,2014,1,1,24,45,61,106,177
3404-001,2014,1,2,1,35,66,101,106
3404-001,2014,1,2,2,19,28,47,101
3404-001,2014,1,2,3,22,34,56,47
3404-001,2014,1,2,4,18,32,50,56
3404-001,2014,1,2,5,36,40,76,50
3404-001,2014,1,2,6,68,108,176,76
3404-001,2014,1,2,7,112,426,538,176
3404-001,2014,1,2,8,383,1288,1671,538
3404-001,2014,1,2,9,436,1029,1465,1671
3404-001,2014,1,2,10,434,518,952,1465
3404-001,2014,1,2,11,515,530,1045,952
3404-001,2014,1,2,12,506,539,1045,1045
3404-001,2014,1,2,13,453,478,931,1045
3404-001,2014,1,2,14,503,518,1021,931
3404-001,2014,1,2,15,649,560,1209,1021
3404-001,2014,1,2,16,559,514,1073,1209
3404-001,2014,1,2,17,612,460,1072,1073
3404-001,2014,1,2,18,774,424,1198,1072
3404-001,2014,1,2,19,786,340,1126,1198
3404-001,2014,1,2,20,478,294,772,1126
3404-001,2014,1,2,21,457,206,663,772
3404-001,2014,1,2,22,256,151,407,663
3404-001,2014,1,2,23,150,144,294,407
3404-001,2014,1,2,24,85,89,174,294
3404-001,2014,1,3,1,71,61,132,174
3404-001,2014,1,3,2,41,58,99,132
3404-001,2014,1,3,3,40,51,91,99
3404-001,2014,1,3,4,30,37,67,91
3404-001,2014,1,3,5,47,71,118,67
3404-001,2014,1,3,6,79,142,221,118
3404-001,2014,1,3,7,121,392,513,221
3404-001,2014,1,3,8,351,1370,1721,513
3404-001,2014,1,3,9,540,1144,1684,1721
3404-001,2014,1,3,10,564,617,1181,1684
3404-001,2014,1,3,11,678,657,1335,1181
3404-001,2014,1,3,12,624,566,1190,1335
3404-001,2014,1,3,13,521,503,1024,1190
3404-001,2014,1,3,14,573,579,1152,1024
3404-001,2014,1,3,15,691,652,1343,1152
3404-001,2014,1,3,16,684,599,1283,1343
3404-001,2014,1,3,17,699,526,1225,1283
3404-001,2014,1,3,18,954,497,1451,1225
3404-001,2014,1,3,19,962,391,1353,1451
3404-001,2014,1,3,20,642,311,953,1353
3404-001,2014,1,3,21,535,220,755,953
3404-001,2014,1,3,22,333,162,495,755
3404-001,2014,1,3,23,188,118,306,495
3404-001,2014,1,3,24,94,94,188,306
3404-001,2014,1,4,1,68,74,142,188
3404-001,2014,1,4,2,59,50,109,142
3404-001,2014,1,4,3,40,35,75,109
3404-001,2014,1,4,4,35,41,76,75
3404-001,2014,1,4,5,53,49,102,76
3404-001,2014,1,4,6,72,117,189,102
3404-001,2014,1,4,7,130,243,373,189
3404-001,2014,1,4,8,257,604,861,373
3404-001,2014,1,4,9,363,582,945,861
3404-001,2014,1,4,10,428,493,921,945
3404-001,2014,1,4,11,436,449,885,921
3404-001,2014,1,4,12,453,429,882,885
3404-001,2014,1,4,13,399,418,817,882
3404-001,2014,1,4,14,480,446,926,817
3404-001,2014,1,4,15,478,388,866,926
3404-001,2014,1,4,16,499,366,865,866
3404-001,2014,1,4,17,519,326,845,865
3404-001,2014,1,4,18,711,354,1065,845
3404-001,2014,1,4,19,414,252,666,1065
3404-001,2014,1,4,20,224,225,449,666
3404-001,2014,1,4,21,198,169,367,449
3404-001,2014,1,4,22,144,98,242,367
3404-001,2014,1,4,23,104,80,184,242
3404-001,2014,1,4,24,53,65,118,184
3404-001,2014,1,5,1,47,42,89,118
3404-001,2014,1,5,2,38,22,60,89
3404-001,2014,1,5,3,18,22,40,60
3404-001,2014,1,5,4,20,20,40,40
3404-001,2014,1,5,5,18,23,41,40
3404-001,2014,1,5,6,23,42,65,41
3404-001,2014,1,5,7,55,99,154,65
3404-001,2014,1,5,8,94,200,294,154
3404-001,2014,1,5,9,149,218,367,294
3404-001,2014,1,5,10,182,191,373,367
3404-001,2014,1,5,11,219,217,436,373
3404-001,2014,1,5,12,206,266,472,436
3404-001,2014,1,5,13,250,227,477,472
3404-001,2014,1,5,14,279,286,565,477
3404-001,2014,1,5,15,292,252,544,565
3404-001,2014,1,5,16,373,301,674,544
3404-001,2014,1,5,17,346,259,605,674
3404-001,2014,1,5,18,403,261,664,605
3404-001,2014,1,5,19,259,258,517,664
3404-001,2014,1,5,20,172,184,356,517
3404-001,2014,1,5,21,152,158,310,356
3404-001,2014,1,5,22,145,151,296,310
3404-001,2014,1,5,23,62,139,201,296
3404-001,2014,1,5,24,47,74,121,201
3404-001,2014,1,6,1,29,65,94,121
3404-001,2014,1,6,2,21,33,54,94
3404-001,2014,1,6,3,14,37,51,54
3404-001,2014,1,6,4,27,30,57,51
3404-001,2014,1,6,5,35,58,93,57
3404-001,2014,1,6,6,71,155,226,93
3404-001,2014,1,6,7,143,474,617,226
3404-001,2014,1,6,8,399,1508,1907,617
3404-001,2014,1,6,9,511,1207,1718,1907
3404-001,2014,1,6,10,480,631,1111,1718
3404-001,2014,1,6,11,559,651,1210,1111
3404-001,2014,1,6,12,560,561,1121,1210
3404-001,2014,1,6,13,504,502,1006,1121
3404-001,2014,1,6,14,591,561,1152,1006
3404-001,2014,1,6,15,699,639,1338,1152
3404-001,2014,1,6,16,639,581,1220,1338
3404-001,2014,1,6,17,701,510,1211,1220
3404-001,2014,1,6,18,862,490,1352,1211
3404-001,2014,1,6,19,834,350,1184,1352
3404-001,2014,1,6,20,579,313,892,1184
3404-001,2014,1,6,21,565,218,783,892
3404-001,2014,1,6,22,331,170,501,783
3404-001,2014,1,6,23,177,106,283,501
3404-001,2014,1,6,24,93,97,190,283
3404-001,2014,1,7,1,60,53,113,190
3404-001,2014,1,7,2,47,50,97,113
3404-001,2014,1,7,3,33,41,74,97
3404-001,2014,1,7,4,38,53,91,74
3404-001,2014,1,7,5,46,52,98,91
3404-001,2014,1,7,6,71,124,195,98
3404-001,2014,1,7,7,164,390,554,195
3404-001,2014,1,7,8,371,1318,1689,554
3404-001,2014,1,7,9,584,1213,1797,1689
3404-001,2014,1,7,10,577,635,1212,1797
3404-001,2014,1,7,11,578,612,1190,1212
3404-001,2014,1,7,12,601,599,1200,1190
3404-001,2014,1,7,13,521,486,1007,1200
3404-001,2014,1,7,14,614,607,1221,1007
3404-001,2014,1,7,15,651,664,1315,1221
3404-001,2014,1,7,16,710,576,1286,1315
3404-001,2014,1,7,17,684,561,1245,1286
3404-001,2014,1,7,18,915,475,1390,1245
3404-001,2014,1,7,19,861,368,1229,1390
3404-001,2014,1,7,20,563,354,917,1229
3404-001,2014,1,7,21,559,251,810,917
3404-001,2014,1,7,22,367,204,571,810
3404-001,2014,1,7,23,209,125,334,571
3404-001,2014,1,7,24,128,102,230,334
3404-001,2014,1,8,1,56,71,127,230
3404-001,2014,1,8,2,61,54,115,127
3404-001,2014,1,8,3,40,43,83,115
3404-001,2014,1,8,4,38,40,78,83
3404-001,2014,1,8,5,42,56,98,78
3404-001,2014,1,8,6,71,116,187,98
3404-001,2014,1,8,7,164,365,529,187
3404-001,2014,1,8,8,380,1322,1702,529
3404-001,2014,1,8,9,561,1130,1691,1702
3404-001,2014,1,8,10,535,610,1145,1691
3404-001,2014,1,8,11,563,661,1224,1145
3404-001,2014,1,8,12,582,546,1128,1224
3404-001,2014,1,8,13,499,466,965,1128
3404-001,2014,1,8,14,528,583,1111,965
3404-001,2014,1,8,15,611,612,1223,1111
3404-001,2014,1,8,16,688,553,1241,1223
3404-001,2014,1,8,17,683,507,1190,1241
3404-001,2014,1,8,18,918,477,1395,1190
3404-001,2014,1,8,19,802,370,1172,1395
3404-001,2014,1,8,20,545,280,825,1172
3404-001,2014,1,8,21,489,208,697,825
3404-001,2014,1,8,22,301,182,483,697
3404-001,2014,1,8,23,172,113,285,483
3404-001,2014,1,8,24,99,90,189,285
3404-001,2014,1,9,1,55,68,123,189
3404-001,2014,1,9,2,50,43,93,123
3404-001,2014,1,9,3,32,28,60,93
3404-001,2014,1,9,4,39,42,81,60
3404-001,2014,1,9,5,51,66,117,81
3404-001,2014,1,9,6,61,137,198,117
3404-001,2014,1,9,7,177,320,497,198
3404-001,2014,1,9,8,366,1358,1724,497
3404-001,2014,1,9,9,562,1135,1697,1724
3404-001,2014,1,9,10,555,571,1126,1697
3404-001,2014,1,9,11,575,628,1203,1126
3404-001,2014,1,9,12,589,593,1182,1203
3404-001,2014,1,9,13,486,504,990,1182
3404-001,2014,1,9,14,585,571,1156,990
3404-001,2014,1,9,15,640,616,1256,1156
3404-001,2014,1,9,16,691,592,1283,1256
3404-001,2014,1,9,17,670,527,1197,1283
3404-001,2014,1,9,18,831,442,1273,1197
3404-001,2014,1,9,19,822,398,1220,1273
3404-001,2014,1,9,20,618,288,906,1220
3404-001,2014,1,9,21,542,257,799,906
3404-001,2014,1,9,22,374,203,577,799
3404-001,2014,1,9,23,148,128,276,577
3404-001,2014,1,9,24,106,87,193,276
3404-001,2014,1,10,1,63,47,110,193
3404-001,2014,1,10,2,46,43,89,110
3404-001,2014,1,10,3,31,35,66,89
3404-001,2014,1,10,4,27,36,63,66
3404-001,2014,1,10,5,59,58,117,63
3404-001,2014,1,10,6,70,119,189,117
3404-001,2014,1,10,7,134,343,477,189
3404-001,2014,1,10,8,355,1303,1658,477
3404-001,2014,1,10,9,525,1113,1638,1658
3404-001,2014,1,10,10,519,631,1150,1638
3404-001,2014,1,10,11,595,621,1216,1150
3404-001,2014,1,10,12,616,573,1189,1216
3404-001,2014,1,10,13,544,445,989,1189
3404-001,2014,1,10,14,587,550,1137,989
3404-001,2014,1,10,15,690,637,1327,1137
3404-001,2014,1,10,16,707,573,1280,1327
3404-001,2014,1,10,17,731,550,1281,1280
3404-001,2014,1,10,18,987,498,1485,1281
3404-001,2014,1,10,19,1026,430,1456,1485
3404-001,2014,1,10,20,676,356,1032,1456
3404-001,2014,1,10,21,533,227,760,1032
3404-001,2014,1,10,22,319,168,487,760
3404-001,2014,1,10,23,194,130,324,487
3404-001,2014,1,10,24,80,92,172,324
3404-001,2014,1,11,1,72,63,135,172
3404-001,2014,1,11,2,63,43,106,135
3404-001,2014,1,11,3,45,36,81,106
3404-001,2014,1,11,4,32,39,71,81
3404-001,2014,1,11,5,46,62,108,71
3404-001,2014,1,11,6,58,132,190,108
3404-001,2014,1,11,7,123,201,324,190
3404-001,2014,1,11,8,264,644,908,324
3404-001,2014,1,11,9,401,626,1027,908
3404-001,2014,1,11,10,441,475,916,1027
3404-001,2014,1,11,11,486,499,985,916
3404-001,2014,1,11,12,492,462,954,985
3404-001,2014,1,11,13,452,401,853,954
3404-001,2014,1,11,14,475,459,934,853
3404-001,2014,1,11,15,509,396,905,934
3404-001,2014,1,11,16,527,421,948,905
3404-001,2014,1,11,17,522,366,888,948
3404-001,2014,1,11,18,697,339,1036,888
3404-001,2014,1,11,19,433,283,716,1036
3404-001,2014,1,11,20,213,188,401,716
3404-001,2014,1,11,21,183,171,354,401
3404-001,2014,1,11,22,150,124,274,354
3404-001,2014,1,11,23,96,104,200,274
3404-001,2014,1,11,24,75,57,132,200
3404-001,2014,1,12,1,42,50,92,132
3404-001,2014,1,12,2,27,23,50,92
3404-001,2014,1,12,3,27,24,51,50
3404-001,2014,1,12,4,12,23,35,51
3404-001,2014,1,12,5,21,17,38,35
3404-001,2014,1,12,6,28,41,69,38
3404-001,2014,1,12,7,47,101,148,69
3404-001,2014,1,12,8,97,194,291,148
3404-001,2014,1,12,9,171,235,406,291
3404-001,2014,1,12,10,198,222,420,406
3404-001,2014,1,12,11,219,225,444,420
3404-001,2014,1,12,12,242,245,487,444
3404-001,2014,1,12,13,263,253,516,487
3404-001,2014,1,12,14,220,250,470,516
3404-001,2014,1,12,15,321,278,599,470
3404-001,2014,1,12,16,356,308,664,599
3404-001,2014,1,12,17,334,292,626,664
3404-001,2014,1,12,18,380,301,681,626
3404-001,2014,1,12,19,243,254,497,681
3404-001,2014,1,12,20,187,182,369,497
3404-001,2014,1,12,21,155,167,322,369
3404-001,2014,1,12,22,108,145,253,322
3404-001,2014,1,12,23,64,121,185,253
3404-001,2014,1,12,24,49,97,146,185
3404-001,2014,1,13,1,39,59,98,146
3404-001,2014,1,13,2,29,42,71,98
3404-001,2014,1,13,3,21,28,49,71
3404-001,2014,1,13,4,23,39,62,49
3404-001,2014,1,13,5,34,51,85,62
3404-001,2014,1,13,6,72,165,237,85
3404-001,2014,1,13,7,130,429,559,237
3404-001,2014,1,13,8,390,1524,1914,559
3404-001,2014,1,13,9,499,1223,1722,1914
3404-001,2014,1,13,10,557,611,1168,1722
3404-001,2014,1,13,11,573,597,1170,1168
3404-001,2014,1,13,12,579,550,1129,1170
3404-001,2014,1,13,13,516,487,1003,1129
3404-001,2014,1,13,14,508,525,1033,1003
3404-001,2014,1,13,15,663,624,1287,1033
3404-001,2014,1,13,16,654,544,1198,1287
3404-001,2014,1,13,17,633,508,1141,1198
3404-001,2014,1,13,18,820,493,1313,1141
3404-001,2014,1,13,19,794,367,1161,1313
3404-001,2014,1,13,20,591,311,902,1161
3404-001,2014,1,13,21,560,218,778,902
3404-001,2014,1,13,22,342,175,517,778
3404-001,2014,1,13,23,168,121,289,517
3404-001,2014,1,13,24,101,81,182,289
3404-001,2014,1,14,1,48,61,109,182
3404-001,2014,1,14,2,49,45,94,109
3404-001,2014,1,14,3,26,30,56,94
3404-001,2014,1,14,4,36,37,73,56
3404-001,2014,1,14,5,37,57,94,73
3404-001,2014,1,14,6,70,132,202,94
3404-001,2014,1,14,7,139,336,475,202
3404-001,2014,1,14,8,367,1281,1648,475
3404-001,2014,1,14,9,538,1082,1620,1648
3404-001,2014,1,14,10,556,643,1199,1620
3404-001,2014,1,14,11,609,617,1226,1199
3404-001,2014,1,14,12,571,577,1148,1226
3404-001,2014,1,14,13,529,489,1018,1148
3404-001,2014,1,14,14,580,568,1148,1018
3404-001,2014,1,14,15,620,625,1245,1148
3404-001,2014,1,14,16,672,563,1235,1245
3404-001,2014,1,14,17,721,535,1256,1235
3404-001,2014,1,14,18,827,467,1294,1256
3404-001,2014,1,14,19,843,357,1200,1294
3404-001,2014,1,14,20,573,339,912,1200
3404-001,2014,1,14,21,560,223,783,912
3404-001,2014,1,14,22,306,174,480,783
3404-001,2014,1,14,23,169,124,293,480
3404-001,2014,1,14,24,110,77,187,293
3404-001,2014,1,15,1,57,58,115,187
3404-001,2014,1,15,2,47,46,93,115
3404-001,2014,1,15,3,27,33,60,93
3404-001,2014,1,15,4,42,44,86,60
3404-001,2014,1,15,5,35,49,84,86
3404-001,2014,1,15,6,89,125,214,84
3404-001,2014,1,15,7,123,338,461,214
3404-001,2014,1,15,8,375,1271,1646,461
3404-001,2014,1,15,9,553,1130,1683,1646
3404-001,2014,1,15,10,542,623,1165,1683
3404-001,2014,1,15,11,609,642,1251,1165
3404-001,2014,1,15,12,554,581,1135,1251
3404-001,2014,1,15,13,482,489,971,1135
3404-001,2014,1,15,14,598,562,1160,971
3404-001,2014,1,15,15,642,611,1253,1160
3404-001,2014,1,15,16,630,591,1221,1253
3404-001,2014,1,15,17,660,496,1156,1221
3404-001,2014,1,15,18,961,450,1411,1156
3404-001,2014,1,15,19,883,376,1259,1411
3404-001,2014,1,15,20,540,294,834,1259
3404-001,2014,1,15,21,462,233,695,834
3404-001,2014,1,15,22,320,198,518,695
3404-001,2014,1,15,23,172,112,284,518
3404-001,2014,1,15,24,93,87,180,284
3404-001,2014,1,16,1,67,65,132,180
3404-001,2014,1,16,2,60,44,104,132
3404-001,2014,1,16,3,40,33,73,104
3404-001,2014,1,16,4,40,36,76,73
3404-001,2014,1,16,5,37,66,103,76
3404-001,2014,1,16,6,86,115,201,103
3404-001,2014,1,16,7,136,364,500,201
3404-001,2014,1,16,8,356,1310,1666,500
3404-001,2014,1,16,9,546,1141,1687,1666
3404-001,2014,1,16,10,589,661,1250,1687
3404-001,2014,1,16,11,586,640,1226,1250
3404-001,2014,1,16,12,610,596,1206,1226
3404-001,2014,1,16,13,528,485,1013,1206
3404-001,2014,1,16,14,592,567,1159,1013
3404-001,2014,1,16,15,667,656,1323,1159
3404-001,2014,1,16,16,679,629,1308,1323
3404-001,2014,1,16,17,688,553,1241,1308
3404-001,2014,1,16,18,919,495,1414,1241
3404-001,2014,1,16,19,870,345,1215,1414
3404-001,2014,1,16,20,621,310,931,1215
3404-001,2014,1,16,21,519,248,767,931
3404-001,2014,1,16,22,325,186,511,767
3404-001,2014,1,16,23,187,117,304,511
3404-001,2014,1,16,24,117,106,223,304
3404-001,2014,1,17,1,69,60,129,223
3404-001,2014,1,17,2,53,36,89,129
3404-001,2014,1,17,3,34,35,69,89
3404-001,2014,1,17,4,29,49,78,69
3404-001,2014,1,17,5,45,53,98,78
3404-001,2014,1,17,6,89,121,210,98
3404-001,2014,1,17,7,147,334,481,210
3404-001,2014,1,17,8,358,1324,1682,481
3404-001,2014,1,17,9,513,1151,1664,1682
3404-001,2014,1,17,10,580,591,1171,1664
3404-001,2014,1,17,11,659,677,1336,1171
3404-001,2014,1,17,12,603,623,1226,1336
3404-001,2014,1,17,13,508,485,993,1226
3404-001,2014,1,17,14,621,557,1178,993
3404-001,2014,1,17,15,704,644,1348,1178
3404-001,2014,1,17,16,672,592,1264,1348
3404-001,2014,1,17,17,730,527,1257,1264
3404-001,2014,1,17,18,1016,480,1496,1257
3404-001,2014,1,17,19,1064,433,1497,1496
3404-001,2014,1,17,20,688,387,1075,1497
3404-001,2014,1,17,21,563,240,803,1075
3404-001,2014,1,17,22,302,189,491,803
3404-001,2014,1,17,23,179,131,310,491
3404-001,2014,1,17,24,119,101,220,310
3404-001,2014,1,18,1,79,62,141,220
3404-001,2014,1,18,2,63,47,110,141
3404-001,2014,1,18,3,46,47,93,110
3404-001,2014,1,18,4,37,53,90,93
3404-001,2014,1,18,5,55,43,98,90
3404-001,2014,1,18,6,65,125,190,98
3404-001,2014,1,18,7,132,239,371,190
3404-001,2014,1,18,8,278,601,879,371
3404-001,2014,1,18,9,425,585,1010,879
3404-001,2014,1,18,10,489,495,984,1010
3404-001,2014,1,18,11,465,480,945,984
3404-001,2014,1,18,12,458,471,929,945
3404-001,2014,1,18,13,457,416,873,929
3404-001,2014,1,18,14,505,444,949,873
3404-001,2014,1,18,15,546,457,1003,949
3404-001,2014,1,18,16,500,412,912,1003
3404-001,2014,1,18,17,528,363,891,912
3404-001,2014,1,18,18,661,412,1073,891
3404-001,2014,1,18,19,453,305,758,1073
3404-001,2014,1,18,20,279,218,497,758
3404-001,2014,1,18,21,198,174,372,497
3404-001,2014,1,18,22,129,118,247,372
3404-001,2014,1,18,23,85,91,176,247
3404-001,2014,1,18,24,52,65,117,176
3404-001,2014,1,19,1,49,29,78,117
3404-001,2014,1,19,2,35,32,67,78
3404-001,2014,1,19,3,19,23,42,67
3404-001,2014,1,19,4,25,19,44,42
3404-001,2014,1,19,5,30,27,57,44
3404-001,2014,1,19,6,37,39,76,57
3404-001,2014,1,19,7,45,87,132,76
3404-001,2014,1,19,8,99,220,319,132
3404-001,2014,1,19,9,157,211,368,319
3404-001,2014,1,19,10,182,206,388,368
3404-001,2014,1,19,11,232,238,470,388
3404-001,2014,1,19,12,230,308,538,470
3404-001,2014,1,19,13,282,251,533,538
3404-001,2014,1,19,14,279,300,579,533
3404-001,2014,1,19,15,323,310,633,579
3404-001,2014,1,19,16,394,285,679,633
3404-001,2014,1,19,17,371,303,674,679
3404-001,2014,1,19,18,421,319,740,674
3404-001,2014,1,19,19,297,271,568,740
3404-001,2014,1,19,20,205,198,403,568
3404-001,2014,1,19,21,166,172,338,403
3404-001,2014,1,19,22,117,195,312,338
3404-001,2014,1,19,23,92,140,232,312
3404-001,2014,1,19,24,70,101,171,232
3404-001,2014,1,20,1,33,76,109,171
3404-001,2014,1,20,2,24,59,83,109
3404-001,2014,1,20,3,11,29,40,83
3404-001,2014,1,20,4,19,27,46,40
3404-001,2014,1,20,5,35,49,84,46
3404-001,2014,1,20,6,67,97,164,84
3404-001,2014,1,20,7,113,385,498,164
3404-001,2014,1,20,8,302,1055,1357,498
3404-001,2014,1,20,9,410,1130,1540,1357
3404-001,2014,1,20,10,479,552,1031,1540
3404-001,2014,1,20,11,509,564,1073,1031
3404-001,2014,1,20,12,525,509,1034,1073
3404-001,2014,1,20,13,456,442,898,1034
3404-001,2014,1,20,14,520,520,1040,898
3404-001,2014,1,20,15,610,625,1235,1040
3404-001,2014,1,20,16,625,569,1194,1235
3404-001,2014,1,20,17,634,494,1128,1194
3404-001,2014,1,20,18,723,423,1146,1128
3404-001,2014,1,20,19,791,314,1105,1146
3404-001,2014,1,20,20,551,301,852,1105
3404-001,2014,1,20,21,463,187,650,852
3404-001,2014,1,20,22,293,152,445,650
3404-001,2014,1,20,23,150,103,253,445
3404-001,2014,1,20,24,94,69,163,253
3404-001,2014,1,21,1,49,45,94,163
3404-001,2014,1,21,2,43,43,86,94
3404-001,2014,1,21,3,30,17,47,86
3404-001,2014,1,21,4,22,28,50,47
3404-001,2014,1,21,5,39,37,76,50
3404-001,2014,1,21,6,52,97,149,76
3404-001,2014,1,21,7,118,265,383,149
3404-001,2014,1,21,8,317,986,1303,383
3404-001,2014,1,21,9,522,938,1460,1303
3404-001,2014,1,21,10,486,627,1113,1460
3404-001,2014,1,21,11,521,619,1140,1113
3404-001,2014,1,21,12,545,564,1109,1140
3404-001,2014,1,21,13,470,474,944,1109
3404-001,2014,1,21,14,596,554,1150,944
3404-001,2014,1,21,15,640,669,1309,1150
3404-001,2014,1,21,16,731,553,1284,1309
3404-001,2014,1,21,17,675,519,1194,1284
3404-001,2014,1,21,18,791,457,1248,1194
3404-001,2014,1,21,19,785,355,1140,1248
3404-001,2014,1,21,20,561,288,849,1140
3404-001,2014,1,21,21,561,231,792,849
3404-001,2014,1,21,22,315,191,506,792
3404-001,2014,1,21,23,173,117,290,506
3404-001,2014,1,21,24,86,86,172,290
3404-001,2014,1,22,1,70,46,116,172
3404-001,2014,1,22,2,64,43,107,116
3404-001,2014,1,22,3,29,33,62,107
3404-001,2014,1,22,4,29,39,68,62
3404-001,2014,1,22,5,45,41,86,68
3404-001,2014,1,22,6,61,105,166,86
3404-001,2014,1,22,7,143,326,469,166
3404-001,2014,1,22,8,357,1309,1666,469
3404-001,2014,1,22,9,567,1165,1732,1666
3404-001,2014,1,22,10,556,599,1155,1732
3404-001,2014,1,22,11,582,633,1215,1155
3404-001,2014,1,22,12,586,575,1161,1215
3404-001,2014,1,22,13,429,395,824,1161
3404-001,2014,1,22,14,575,564,1139,824
3404-001,2014,1,22,15,662,614,1276,1139
3404-001,2014,1,22,16,667,585,1252,1276
3404-001,2014,1,22,17,674,535,1209,1252
3404-001,2014,1,22,18,954,459,1413,1209
3404-001,2014,1,22,19,871,362,1233,1413
3404-001,2014,1,22,20,587,336,923,1233
3404-001,2014,1,22,21,499,221,720,923
3404-001,2014,1,22,22,325,173,498,720
3404-001,2014,1,22,23,169,122,291,498
3404-001,2014,1,22,24,91,88,179,291
3404-001,2014,1,23,1,71,50,121,179
3404-001,2014,1,23,2,42,50,92,121
3404-001,2014,1,23,3,41,39,80,92
3404-001,2014,1,23,4,38,42,80,80
3404-001,2014,1,23,5,53,58,111,80
3404-001,2014,1,23,6,81,100,181,111
3404-001,2014,1,23,7,151,375,526,181
3404-001,2014,1,23,8,365,1334,1699,526
3404-001,2014,1,23,9,509,1149,1658,1699
3404-001,2014,1,23,10,579,626,1205,1658
3404-001,2014,1,23,11,587,622,1209,1205
3404-001,2014,1,23,12,608,629,1237,1209
3404-001,2014,1,23,13,576,479,1055,1237
3404-001,2014,1,23,14,584,564,1148,1055
3404-001,2014,1,23,15,664,667,1331,1148
3404-001,2014,1,23,16,743,617,1360,1331
3404-001,2014,1,23,17,682,574,1256,1360
3404-001,2014,1,23,18,937,438,1375,1256
3404-001,2014,1,23,19,843,376,1219,1375
3404-001,2014,1,23,20,684,328,1012,1219
3404-001,2014,1,23,21,540,232,772,1012
3404-001,2014,1,23,22,359,201,560,772
3404-001,2014,1,23,23,181,112,293,560
3404-001,2014,1,23,24,84,93,177,293
3404-001,2014,1,24,1,59,67,126,177
3404-001,2014,1,24,2,71,55,126,126
3404-001,2014,1,24,3,24,49,73,126
3404-001,2014,1,24,4,32,34,66,73
3404-001,2014,1,24,5,43,66,109,66
3404-001,2014,1,24,6,79,120,199,109
3404-001,2014,1,24,7,168,394,562,199
3404-001,2014,1,24,8,361,1336,1697,562
3404-001,2014,1,24,9,597,1131,1728,1697
3404-001,2014,1,24,10,563,697,1260,1728
3404-001,2014,1,24,11,654,656,1310,1260
3404-001,2014,1,24,12,611,565,1176,1310
3404-001,2014,1,24,13,558,516,1074,1176
3404-001,2014,1,24,14,592,573,1165,1074
3404-001,2014,1,24,15,671,638,1309,1165
3404-001,2014,1,24,16,747,555,1302,1309
3404-001,2014,1,24,17,704,573,1277,1302
3404-001,2014,1,24,18,1016,544,1560,1277
3404-001,2014,1,24,19,1003,441,1444,1560
3404-001,2014,1,24,20,763,391,1154,1444
3404-001,2014,1,24,21,517,224,741,1154
3404-001,2014,1,24,22,319,181,500,741
3404-001,2014,1,24,23,198,132,330,500
3404-001,2014,1,24,24,94,101,195,330
3404-001,2014,1,25,1,62,54,116,195
3404-001,2014,1,25,2,51,40,91,116
3404-001,2014,1,25,3,42,38,80,91
3404-001,2014,1,25,4,31,47,78,80
3404-001,2014,1,25,5,47,63,110,78
3404-001,2014,1,25,6,68,122,190,110
3404-001,2014,1,25,7,129,221,350,190
3404-001,2014,1,25,8,254,633,887,350
3404-001,2014,1,25,9,433,576,1009,887
3404-001,2014,1,25,10,485,508,993,1009
3404-001,2014,1,25,11,519,473,992,993
3404-001,2014,1,25,12,486,491,977,992
3404-001,2014,1,25,13,451,417,868,977
3404-001,2014,1,25,14,492,389,881,868
3404-001,2014,1,25,15,479,417,896,881
3404-001,2014,1,25,16,497,389,886,896
3404-001,2014,1,25,17,519,337,856,886
3404-001,2014,1,25,18,669,385,1054,856
3404-001,2014,1,25,19,410,267,677,1054
3404-001,2014,1,25,20,221,251,472,677
3404-001,2014,1,25,21,182,171,353,472
3404-001,2014,1,25,22,174,139,313,353
3404-001,2014,1,25,23,92,96,188,313
3404-001,2014,1,25,24,82,58,140,188
3404-001,2014,1,26,1,47,42,89,140
3404-001,2014,1,26,2,30,36,66,89
3404-001,2014,1,26,3,20,32,52,66
3404-001,2014,1,26,4,21,24,45,52
3404-001,2014,1,26,5,26,16,42,45
3404-001,2014,1,26,6,40,54,94,42
3404-001,2014,1,26,7,49,111,160,94
3404-001,2014,1,26,8,145,242,387,160
3404-001,2014,1,26,9,206,271,477,387
3404-001,2014,1,26,10,203,227,430,477
3404-001,2014,1,26,11,259,263,522,430
3404-001,2014,1,26,12,239,228,467,522
3404-001,2014,1,26,13,313,279,592,467
3404-001,2014,1,26,14,299,290,589,592
3404-001,2014,1,26,15,300,293,593,589
3404-001,2014,1,26,16,360,302,662,593
3404-001,2014,1,26,17,387,315,702,662
3404-001,2014,1,26,18,421,263,684,702
3404-001,2014,1,26,19,283,249,532,684
3404-001,2014,1,26,20,197,150,347,532
3404-001,2014,1,26,21,141,175,316,347
3404-001,2014,1,26,22,133,153,286,316
3404-001,2014,1,26,23,80,120,200,286
3404-001,2014,1,26,24,62,86,148,200
3404-001,2014,1,27,1,40,65,105,148
3404-001,2014,1,27,2,20,38,58,105
3404-001,2014,1,27,3,21,39,60,58
3404-001,2014,1,27,4,25,27,52,60
3404-001,2014,1,27,5,32,59,91,52
3404-001,2014,1,27,6,61,130,191,91
3404-001,2014,1,27,7,152,415,567,191
3404-001,2014,1,27,8,368,1509,1877,567
3404-001,2014,1,27,9,519,1162,1681,1877
3404-001,2014,1,27,10,500,608,1108,1681
3404-001,2014,1,27,11,646,599,1245,1108
3404-001,2014,1,27,12,590,658,1248,1245
3404-001,2014,1,27,13,552,551,1103,1248
3404-001,2014,1,27,14,591,565,1156,1103
3404-001,2014,1,27,15,663,636,1299,1156
3404-001,2014,1,27,16,726,620,1346,1299
3404-001,2014,1,27,17,728,534,1262,1346
3404-001,2014,1,27,18,915,511,1426,1262
3404-001,2014,1,27,19,859,425,1284,1426
3404-001,2014,1,27,20,630,333,963,1284
3404-001,2014,1,27,21,576,223,799,963
3404-001,2014,1,27,22,358,210,568,799
3404-001,2014,1,27,23,177,133,310,568
3404-001,2014,1,27,24,110,112,222,310
3404-001,2014,1,28,1,68,60,128,222
3404-001,2014,1,28,2,54,43,97,128
3404-001,2014,1,28,3,47,39,86,97
3404-001,2014,1,28,4,32,44,76,86
3404-001,2014,1,28,5,49,61,110,76
3404-001,2014,1,28,6,73,122,195,110
3404-001,2014,1,28,7,159,357,516,195
3404-001,2014,1,28,8,386,1238,1624,516
3404-001,2014,1,28,9,584,1110,1694,1624
3404-001,2014,1,28,10,578,664,1242,1694
3404-001,2014,1,28,11,633,652,1285,1242
3404-001,2014,1,28,12,663,635,1298,1285
3404-001,2014,1,28,13,556,527,1083,1298
3404-001,2014,1,28,14,636,609,1245,1083
3404-001,2014,1,28,15,714,712,1426,1245
3404-001,2014,1,28,16,734,649,1383,1426
3404-001,2014,1,28,17,711,570,1281,1383
3404-001,2014,1,28,18,1028,532,1560,1281
3404-001,2014,1,28,19,983,401,1384,1560
3404-001,2014,1,28,20,716,330,1046,1384
3404-001,2014,1,28,21,523,236,759,1046
3404-001,2014,1,28,22,338,222,560,759
3404-001,2014,1,28,23,209,137,346,560
3404-001,2014,1,28,24,121,93,214,346
3404-001,2014,1,29,1,72,73,145,214
3404-001,2014,1,29,2,55,43,98,145
3404-001,2014,1,29,3,40,38,78,98
3404-001,2014,1,29,4,46,52,98,78
3404-001,2014,1,29,5,32,48,80,98
3404-001,2014,1,29,6,56,93,149,80
3404-001,2014,1,29,7,114,290,404,149
3404-001,2014,1,29,8,304,1223,1527,404
3404-001,2014,1,29,9,495,950,1445,1527
3404-001,2014,1,29,10,528,523,1051,1445
3404-001,2014,1,29,11,560,533,1093,1051
3404-001,2014,1,29,12,581,519,1100,1093
3404-001,2014,1,29,13,561,428,989,1100
3404-001,2014,1,29,14,629,444,1073,989
3404-001,2014,1,29,15,640,443,1083,1073
3404-001,2014,1,29,16,711,470,1181,1083
3404-001,2014,1,29,17,740,421,1161,1181
3404-001,2014,1,29,18,997,393,1390,1161
3404-001,2014,1,29,19,617,317,934,1390
3404-001,2014,1,29,20,394,275,669,934
3404-001,2014,1,29,21,309,230,539,669
3404-001,2014,1,29,22,200,166,366,539
3404-001,2014,1,29,23,110,120,230,366
3404-001,2014,1,29,24,88,68,156,230
3404-001,2014,1,30,1,61,50,111,156
3404-001,2014,1,30,2,63,36,99,111
3404-001,2014,1,30,3,35,23,58,99
3404-001,2014,1,30,4,42,21,63,58
3404-001,2014,1,30,5,63,30,93,63
3404-001,2014,1,30,6,73,70,143,93
3404-001,2014,1,30,7,96,66,162,143
3404-001,2014,1,30,8,109,145,254,162
3404-001,2014,1,30,9,157,177,334,254
3404-001,2014,1,30,10,183,248,431,334
3404-001,2014,1,30,11,244,306,550,431
3404-001,2014,1,30,12,247,302,549,550
3404-001,2014,1,30,13,249,284,533,549
3404-001,2014,1,30,14,227,272,499,533
3404-001,2014,1,30,15,178,231,409,499
3404-001,2014,1,30,16,171,236,407,409
3404-001,2014,1,30,17,178,193,371,407
3404-001,2014,1,30,18,177,148,325,371
3404-001,2014,1,30,19,144,131,275,325
3404-001,2014,1,30,20,124,92,216,275
3404-001,2014,1,30,21,101,71,172,216
3404-001,2014,1,30,22,81,60,141,172
3404-001,2014,1,30,23,43,53,96,141
3404-001,2014,1,30,24,34,36,70,96
3404-001,2014,1,31,1,24,20,44,70
3404-001,2014,1,31,2,19,17,36,44
3404-001,2014,1,31,3,6,13,19,36
3404-001,2014,1,31,4,8,10,18,19
3404-001,2014,1,31,5,9,6,15,18
3404-001,2014,1,31,6,19,15,34,15
3404-001,2014,1,31,7,62,77,139,34
3404-001,2014,1,31,8,105,166,271,139
3404-001,2014,1,31,9,127,128,255,271
3404-001,2014,1,31,10,157,135,292,255
3404-001,2014,1,31,11,319,252,571,292
3404-001,2014,1,31,12,402,364,766,571
3404-001,2014,1,31,13,448,359,807,766
3404-001,2014,1,31,14,490,390,880,807
3404-001,2014,1,31,15,604,390,994,880
3404-001,2014,1,31,16,667,489,1156,994
3404-001,2014,1,31,17,734,406,1140,1156
3404-001,2014,1,31,18,570,343,913,1140
3404-001,2014,1,31,19,392,253,645,913
3404-001,2014,1,31,20,205,202,407,645
3404-001,2014,1,31,21,193,127,320,407
3404-001,2014,1,31,22,148,83,231,320
3404-001,2014,1,31,23,78,79,157,231
3404-001,2014,1,31,24,53,62,115,157
3404-001,2014,2,1,1,39,47,86,115
3404-001,2014,2,1,2,22,22,44,86
3404-001,2014,2,1,3,19,16,35,44
3404-001,2014,2,1,4,12,23,35,35
3404-001,2014,2,1,5,12,13,25,35
3404-001,2014,2,1,6,19,21,40,25
3404-001,2014,2,1,7,27,33,60,40
3404-001,2014,2,1,8,36,80,116,60
3404-001,2014,2,1,9,73,73,146,116
3404-001,2014,2,1,10,113,108,221,146
3404-001,2014,2,1,11,180,162,342,221
3404-001,2014,2,1,12,295,234,529,342
3404-001,2014,2,1,13,235,228,463,529
3404-001,2014,2,1,14,253,248,501,463
3404-001,2014,2,1,15,272,253,525,501
3404-001,2014,2,1,16,405,240,645,525
3404-001,2014,2,1,17,362,253,615,645
3404-001,2014,2,1,18,370,235,605,615
3404-001,2014,2,1,19,317,204,521,605
3404-001,2014,2,1,20,226,215,441,521
3404-001,2014,2,1,21,132,156,288,441
3404-001,2014,2,1,22,111,148,259,288
3404-001,2014,2,1,23,78,66,144,259
3404-001,2014,2,1,24,53,65,118,144
3404-001,2014,2,2,1,30,57,87,118
3404-001,2014,2,2,2,20,34,54,87
3404-001,2014,2,2,3,15,38,53,54
3404-001,2014,2,2,4,9,20,29,53
3404-001,2014,2,2,5,13,16,29,29
3404-001,2014,2,2,6,17,32,49,29
3404-001,2014,2,2,7,18,54,72,49
3404-001,2014,2,2,8,54,129,183,72
3404-001,2014,2,2,9,117,130,247,183
3404-001,2014,2,2,10,140,139,279,247
3404-001,2014,2,2,11,157,186,343,279
3404-001,2014,2,2,12,179,212,391,343
3404-001,2014,2,2,13,226,201,427,391
3404-001,2014,2,2,14,245,274,519,427
3404-001,2014,2,2,15,270,253,523,519
3404-001,2014,2,2,16,257,271,528,523
3404-001,2014,2,2,17,318,228,546,528
3404-001,2014,2,2,18,256,223,479,546
3404-001,2014,2,2,19,196,208,404,479
3404-001,2014,2,2,20,139,183,322,404
3404-001,2014,2,2,21,117,151,268,322
3404-001,2014,2,2,22,101,154,255,268
3404-001,2014,2,2,23,52,123,175,255
3404-001,2014,2,2,24,48,97,145,175
3404-001,2014,2,3,1,22,74,96,145
3404-001,2014,2,3,2,27,53,80,96
3404-001,2014,2,3,3,16,42,58,80
3404-001,2014,2,3,4,13,38,51,58
3404-001,2014,2,3,5,30,54,84,51
3404-001,2014,2,3,6,66,152,218,84
3404-001,2014,2,3,7,107,369,476,218
3404-001,2014,2,3,8,324,1262,1586,476
3404-001,2014,2,3,9,456,954,1410,1586
3404-001,2014,2,3,10,418,473,891,1410
3404-001,2014,2,3,11,496,495,991,891
3404-001,2014,2,3,12,431,456,887,991
3404-001,2014,2,3,13,432,372,804,887
3404-001,2014,2,3,14,508,464,972,804
3404-001,2014,2,3,15,563,518,1081,972
3404-001,2014,2,3,16,563,530,1093,1081
3404-001,2014,2,3,17,497,435,932,1093
3404-001,2014,2,3,18,699,431,1130,932
3404-001,2014,2,3,19,702,326,1028,1130
3404-001,2014,2,3,20,515,274,789,1028
3404-001,2014,2,3,21,434,234,668,789
3404-001,2014,2,3,22,274,164,438,668
3404-001,2014,2,3,23,144,89,233,438
3404-001,2014,2,3,24,79,90,169,233
3404-001,2014,2,4,1,51,50,101,169
3404-001,2014,2,4,2,44,47,91,101
3404-001,2014,2,4,3,28,44,72,91
3404-001,2014,2,4,4,28,41,69,72
3404-001,2014,2,4,5,37,53,90,69
3404-001,2014,2,4,6,78,126,204,90
3404-001,2014,2,4,7,144,358,502,204
3404-001,2014,2,4,8,375,1402,1777,502
3404-001,2014,2,4,9,555,1111,1666,1777
3404-001,2014,2,4,10,536,639,1175,1666
3404-001,2014,2,4,11,575,615,1190,1175
3404-001,2014,2,4,12,567,563,1130,1190
3404-001,2014,2,4,13,473,450,923,1130
3404-001,2014,2,4,14,543,546,1089,923
3404-001,2014,2,4,15,605,610,1215,1089
3404-001,2014,2,4,16,658,575,1233,1215
3404-001,2014,2,4,17,660,491,1151,1233
3404-001,2014,2,4,18,864,451,1315,1151
3404-001,2014,2,4,19,810,380,1190,1315
3404-001,2014,2,4,20,631,329,960,1190
3404-001,2014,2,4,21,512,224,736,960
3404-001,2014,2,4,22,334,165,499,736
3404-001,2014,2,4,23,170,133,303,499
3404-001,2014,2,4,24,66,70,136,303
3404-001,2014,2,5,1,63,52,115,136
3404-001,2014,2,5,2,58,39,97,115
3404-001,2014,2,5,3,41,41,82,97
3404-001,2014,2,5,4,34,46,80,82
3404-001,2014,2,5,5,42,48,90,80
3404-001,2014,2,5,6,64,126,190,90
3404-001,2014,2,5,7,135,344,479,190
3404-001,2014,2,5,8,370,1346,1716,479
3404-001,2014,2,5,9,571,1118,1689,1716
3404-001,2014,2,5,10,505,654,1159,1689
3404-001,2014,2,5,11,552,612,1164,1159
3404-001,2014,2,5,12,559,605,1164,1164
3404-001,2014,2,5,13,488,473,961,1164
3404-001,2014,2,5,14,533,560,1093,961
3404-001,2014,2,5,15,648,628,1276,1093
3404-001,2014,2,5,16,650,563,1213,1276
3404-001,2014,2,5,17,637,503,1140,1213
3404-001,2014,2,5,18,975,499,1474,1140
3404-001,2014,2,5,19,910,387,1297,1474
3404-001,2014,2,5,20,583,329,912,1297
3404-001,2014,2,5,21,447,239,686,912
3404-001,2014,2,5,22,296,199,495,686
3404-001,2014,2,5,23,181,103,284,495
3404-001,2014,2,5,24,99,95,194,284
3404-001,2014,2,6,1,80,65,145,194
3404-001,2014,2,6,2,55,54,109,145
3404-001,2014,2,6,3,37,38,75,109
3404-001,2014,2,6,4,26,40,66,75
3404-001,2014,2,6,5,46,47,93,66
3404-001,2014,2,6,6,84,107,191,93
3404-001,2014,2,6,7,148,380,528,191
3404-001,2014,2,6,8,331,1286,1617,528
3404-001,2014,2,6,9,598,1181,1779,1617
3404-001,2014,2,6,10,573,593,1166,1779
3404-001,2014,2,6,11,605,630,1235,1166
3404-001,2014,2,6,12,566,613,1179,1235
3404-001,2014,2,6,13,495,501,996,1179
3404-001,2014,2,6,14,568,545,1113,996
3404-001,2014,2,6,15,640,621,1261,1113
3404-001,2014,2,6,16,668,595,1263,1261
3404-001,2014,2,6,17,688,557,1245,1263
3404-001,2014,2,6,18,876,473,1349,1245
3404-001,2014,2,6,19,869,357,1226,1349
3404-001,2014,2,6,20,587,306,893,1226
3404-001,2014,2,6,21,532,218,750,893
3404-001,2014,2,6,22,332,220,552,750
3404-001,2014,2,6,23,155,125,280,552
3404-001,2014,2,6,24,107,103,210,280
3404-001,2014,2,7,1,64,69,133,210
3404-001,2014,2,7,2,59,49,108,133
3404-001,2014,2,7,3,37,33,70,108
3404-001,2014,2,7,4,35,51,86,70
3404-001,2014,2,7,5,41,65,106,86
3404-001,2014,2,7,6,83,106,189,106
3404-001,2014,2,7,7,141,372,513,189
3404-001,2014,2,7,8,366,1316,1682,513
3404-001,2014,2,7,9,590,1147,1737,1682
3404-001,2014,2,7,10,545,618,1163,1737
3404-001,2014,2,7,11,620,679,1299,1163
3404-001,2014,2,7,12,590,559,1149,1299
3404-001,2014,2,7,13,525,463,988,1149
3404-001,2014,2,7,14,559,571,1130,988
3404-001,2014,2,7,15,626,659,1285,1130
3404-001,2014,2,7,16,680,585,1265,1285
3404-001,2014,2,7,17,746,542,1288,1265
3404-001,2014,2,7,18,982,443,1425,1288
3404-001,2014,2,7,19,1014,420,1434,1425
3404-001,2014,2,7,20,731,346,1077,1434
3404-001,2014,2,7,21,479,218,697,1077
3404-001,2014,2,7,22,337,175,512,697
3404-001,2014,2,7,23,201,120,321,512
3404-001,2014,2,7,24,99,106,205,321
3404-001,2014,2,8,1,62,69,131,205
3404-001,2014,2,8,2,58,63,121,131
3404-001,2014,2,8,3,43,32,75,121
3404-001,2014,2,8,4,44,43,87,75
3404-001,2014,2,8,5,42,39,81,87
3404-001,2014,2,8,6,61,100,161,81
3404-001,2014,2,8,7,129,210,339,161
3404-001,2014,2,8,8,245,604,849,339
3404-001,2014,2,8,9,367,595,962,849
3404-001,2014,2,8,10,455,432,887,962
3404-001,2014,2,8,11,442,438,880,887
3404-001,2014,2,8,12,399,416,815,880
3404-001,2014,2,8,13,403,376,779,815
3404-001,2014,2,8,14,453,413,866,779
3404-001,2014,2,8,15,420,415,835,866
3404-001,2014,2,8,16,467,303,770,835
3404-001,2014,2,8,17,510,329,839,770
3404-001,2014,2,8,18,647,295,942,839
3404-001,2014,2,8,19,375,257,632,942
3404-001,2014,2,8,20,264,215,479,632
3404-001,2014,2,8,21,169,138,307,479
3404-001,2014,2,8,22,132,123,255,307
3404-001,2014,2,8,23,68,94,162,255
3404-001,2014,2,8,24,62,55,117,162
3404-001,2014,2,9,1,40,34,74,117
3404-001,2014,2,9,2,26,22,48,74
3404-001,2014,2,9,3,21,10,31,48
3404-001,2014,2,9,4,15,13,28,31
3404-001,2014,2,9,5,28,18,46,28
3404-001,2014,2,9,6,37,33,70,46
3404-001,2014,2,9,7,37,67,104,70
3404-001,2014,2,9,8,81,165,246,104
3404-001,2014,2,9,9,154,195,349,246
3404-001,2014,2,9,10,172,192,364,349
3404-001,2014,2,9,11,225,208,433,364
3404-001,2014,2,9,12,222,202,424,433
3404-001,2014,2,9,13,250,203,453,424
3404-001,2014,2,9,14,228,251,479,453
3404-001,2014,2,9,15,265,234,499,479
3404-001,2014,2,9,16,274,285,559,499
3404-001,2014,2,9,17,328,265,593,559
3404-001,2014,2,9,18,349,236,585,593
3404-001,2014,2,9,19,234,234,468,585
3404-001,2014,2,9,20,166,180,346,468
3404-001,2014,2,9,21,123,138,261,346
3404-001,2014,2,9,22,113,147,260,261
3404-001,2014,2,9,23,66,118,184,260
3404-001,2014,2,9,24,47,86,133,184
3404-001,2014,2,10,1,30,60,90,133
3404-001,2014,2,10,2,17,37,54,90
3404-001,2014,2,10,3,19,31,50,54
3404-001,2014,2,10,4,21,22,43,50
3404-001,2014,2,10,5,29,36,65,43
3404-001,2014,2,10,6,61,123,184,65
3404-001,2014,2,10,7,136,177,313,184
3404-001,2014,2,10,8,323,448,771,313
3404-001,2014,2,10,9,421,910,1331,771
3404-001,2014,2,10,10,423,934,1357,1331
3404-001,2014,2,10,11,539,600,1139,1357
3404-001,2014,2,10,12,581,519,1100,1139
3404-001,2014,2,10,13,495,529,1024,1100
3404-001,2014,2,10,14,570,550,1120,1024
3404-001,2014,2,10,15,667,589,1256,1120
3404-001,2014,2,10,16,614,578,1192,1256
3404-001,2014,2,10,17,653,490,1143,1192
3404-001,2014,2,10,18,787,426,1213,1143
3404-001,2014,2,10,19,817,372,1189,1213
3404-001,2014,2,10,20,604,310,914,1189
3404-001,2014,2,10,21,546,214,760,914
3404-001,2014,2,10,22,336,192,528,760
3404-001,2014,2,10,23,162,117,279,528
3404-001,2014,2,10,24,108,91,199,279
3404-001,2014,2,11,1,60,69,129,199
3404-001,2014,2,11,2,44,36,80,129
3404-001,2014,2,11,3,33,40,73,80
3404-001,2014,2,11,4,30,46,76,73
3404-001,2014,2,11,5,36,44,80,76
3404-001,2014,2,11,6,69,110,179,80
3404-001,2014,2,11,7,146,350,496,179
3404-001,2014,2,11,8,366,1298,1664,496
3404-001,2014,2,11,9,543,1110,1653,1664
3404-001,2014,2,11,10,548,643,1191,1653
3404-001,2014,2,11,11,599,672,1271,1191
3404-001,2014,2,11,12,522,599,1121,1271
3404-001,2014,2,11,13,492,487,979,1121
3404-001,2014,2,11,14,600,542,1142,979
3404-001,2014,2,11,15,672,618,1290,1142
3404-001,2014,2,11,16,695,585,1280,1290
3404-001,2014,2,11,17,644,534,1178,1280
3404-001,2014,2,11,18,813,471,1284,1178
3404-001,2014,2,11,19,837,417,1254,1284
3404-001,2014,2,11,20,590,313,903,1254
3404-001,2014,2,11,21,571,220,791,903
3404-001,2014,2,11,22,342,180,522,791
3404-001,2014,2,11,23,153,118,271,522
3404-001,2014,2,11,24,115,104,219,271
3404-001,2014,2,12,1,68,66,134,219
3404-001,2014,2,12,2,52,44,96,134
3404-001,2014,2,12,3,28,29,57,96
3404-001,2014,2,12,4,39,38,77,57
3404-001,2014,2,12,5,43,37,80,77
3404-001,2014,2,12,6,81,122,203,80
3404-001,2014,2,12,7,137,375,512,203
3404-001,2014,2,12,8,381,1256,1637,512
3404-001,2014,2,12,9,601,1190,1791,1637
3404-001,2014,2,12,10,524,626,1150,1791
3404-001,2014,2,12,11,584,600,1184,1150
3404-001,2014,2,12,12,564,590,1154,1184
3404-001,2014,2,12,13,485,460,945,1154
3404-001,2014,2,12,14,533,564,1097,945
3404-001,2014,2,12,15,690,605,1295,1097
3404-001,2014,2,12,16,666,540,1206,1295
3404-001,2014,2,12,17,648,468,1116,1206
3404-001,2014,2,12,18,916,479,1395,1116
3404-001,2014,2,12,19,896,376,1272,1395
3404-001,2014,2,12,20,570,327,897,1272
3404-001,2014,2,12,21,470,261,731,897
3404-001,2014,2,12,22,359,172,531,731
3404-001,2014,2,12,23,165,137,302,531
3404-001,2014,2,12,24,89,93,182,302
3404-001,2014,2,13,1,80,74,154,182
3404-001,2014,2,13,2,47,40,87,154
3404-001,2014,2,13,3,38,36,74,87
3404-001,2014,2,13,4,38,44,82,74
3404-001,2014,2,13,5,39,50,89,82
3404-001,2014,2,13,6,69,118,187,89
3404-001,2014,2,13,7,160,351,511,187
3404-001,2014,2,13,8,357,1244,1601,511
3404-001,2014,2,13,9,566,1152,1718,1601
3404-001,2014,2,13,10,538,663,1201,1718
3404-001,2014,2,13,11,659,614,1273,1201
3404-001,2014,2,13,12,577,561,1138,1273
3404-001,2014,2,13,13,493,515,1008,1138
3404-001,2014,2,13,14,501,500,1001,1008
3404-001,2014,2,13,15,487,451,938,1001
3404-001,2014,2,13,16,869,764,1633,938
3404-001,2014,2,13,17,633,469,1102,1633
3404-001,2014,2,13,18,908,452,1360,1102
3404-001,2014,2,13,19,831,367,1198,1360
3404-001,2014,2,13,20,561,310,871,1198
3404-001,2014,2,13,21,516,245,761,871
3404-001,2014,2,13,22,327,189,516,761
3404-001,2014,2,13,23,211,138,349,516
3404-001,2014,2,13,24,102,84,186,349
3404-001,2014,2,14,1,67,65,132,186
3404-001,2014,2,14,2,54,44,98,132
3404-001,2014,2,14,3,30,35,65,98
3404-001,2014,2,14,4,36,36,72,65
3404-001,2014,2,14,5,38,53,91,72
3404-001,2014,2,14,6,82,116,198,91
3404-001,2014,2,14,7,153,382,535,198
3404-001,2014,2,14,8,362,1337,1699,535
3404-001,2014,2,14,9,578,1102,1680,1699
3404-001,2014,2,14,10,600,606,1206,1680
3404-001,2014,2,14,11,627,650,1277,1206
3404-001,2014,2,14,12,625,529,1154,1277
3404-001,2014,2,14,13,480,517,997,1154
3404-001,2014,2,14,14,603,605,1208,997
3404-001,2014,2,14,15,681,615,1296,1208
3404-001,2014,2,14,16,688,567,1255,1296
3404-001,2014,2,14,17,749,536,1285,1255
3404-001,2014,2,14,18,1030,549,1579,1285
3404-001,2014,2,14,19,1024,393,1417,1579
3404-001,2014,2,14,20,715,381,1096,1417
3404-001,2014,2,14,21,524,225,749,1096
3404-001,2014,2,14,22,318,201,519,749
3404-001,2014,2,14,23,171,151,322,519
3404-001,2014,2,14,24,106,103,209,322
3404-001,2014,2,15,1,86,59,145,209
3404-001,2014,2,15,2,65,51,116,145
3404-001,2014,2,15,3,45,28,73,116
3404-001,2014,2,15,4,38,35,73,73
3404-001,2014,2,15,5,54,57,111,73
3404-001,2014,2,15,6,66,140,206,111
3404-001,2014,2,15,7,130,258,388,206
3404-001,2014,2,15,8,253,660,913,388
3404-001,2014,2,15,9,399,562,961,913
3404-001,2014,2,15,10,442,498,940,961
3404-001,2014,2,15,11,468,446,914,940
3404-001,2014,2,15,12,466,451,917,914
3404-001,2014,2,15,13,444,409,853,917
3404-001,2014,2,15,14,462,406,868,853
3404-001,2014,2,15,15,482,387,869,868
3404-001,2014,2,15,16,506,462,968,869
3404-001,2014,2,15,17,520,353,873,968
3404-001,2014,2,15,18,738,381,1119,873
3404-001,2014,2,15,19,468,314,782,1119
3404-001,2014,2,15,20,294,248,542,782
3404-001,2014,2,15,21,182,201,383,542
3404-001,2014,2,15,22,178,140,318,383
3404-001,2014,2,15,23,98,89,187,318
3404-001,2014,2,15,24,58,63,121,187
3404-001,2014,2,16,1,49,39,88,121
3404-001,2014,2,16,2,31,27,58,88
3404-001,2014,2,16,3,31,16,47,58
3404-001,2014,2,16,4,20,14,34,47
3404-001,2014,2,16,5,21,28,49,34
3404-001,2014,2,16,6,31,45,76,49
3404-001,2014,2,16,7,55,98,153,76
3404-001,2014,2,16,8,108,211,319,153
3404-001,2014,2,16,9,182,201,383,319
3404-001,2014,2,16,10,220,202,422,383
3404-001,2014,2,16,11,233,290,523,422
3404-001,2014,2,16,12,212,288,500,523
3404-001,2014,2,16,13,251,270,521,500
3404-001,2014,2,16,14,306,321,627,521
3404-001,2014,2,16,15,342,277,619,627
3404-001,2014,2,16,16,387,304,691,619
3404-001,2014,2,16,17,415,277,692,691
3404-001,2014,2,16,18,412,294,706,692
3404-001,2014,2,16,19,301,242,543,706
3404-001,2014,2,16,20,204,209,413,543
3404-001,2014,2,16,21,133,172,305,413
3404-001,2014,2,16,22,153,200,353,305
3404-001,2014,2,16,23,76,127,203,353
3404-001,2014,2,16,24,58,91,149,203
3404-001,2014,2,17,1,33,67,100,149
3404-001,2014,2,17,2,20,31,51,100
3404-001,2014,2,17,3,25,33,58,51
3404-001,2014,2,17,4,21,32,53,58
3404-001,2014,2,17,5,42,61,103,53
3404-001,2014,2,17,6,66,146,212,103
3404-001,2014,2,17,7,170,469,639,212
3404-001,2014,2,17,8,444,1658,2102,639
3404-001,2014,2,17,9,541,1211,1752,2102
3404-001,2014,2,17,10,528,614,1142,1752
3404-001,2014,2,17,11,609,645,1254,1142
3404-001,2014,2,17,12,515,555,1070,1254
3404-001,2014,2,17,13,489,494,983,1070
3404-001,2014,2,17,14,555,550,1105,983
3404-001,2014,2,17,15,633,660,1293,1105
3404-001,2014,2,17,16,685,608,1293,1293
3404-001,2014,2,17,17,676,496,1172,1293
3404-001,2014,2,17,18,861,480,1341,1172
3404-001,2014,2,17,19,816,379,1195,1341
3404-001,2014,2,17,20,579,317,896,1195
3404-001,2014,2,17,21,528,190,718,896
3404-001,2014,2,17,22,353,179,532,718
3404-001,2014,2,17,23,153,118,271,532
3404-001,2014,2,17,24,101,93,194,271
3404-001,2014,2,18,1,56,70,126,194
3404-001,2014,2,18,2,69,53,122,126
3404-001,2014,2,18,3,29,17,46,122
3404-001,2014,2,18,4,38,40,78,46
3404-001,2014,2,18,5,50,56,106,78
3404-001,2014,2,18,6,90,135,225,106
3404-001,2014,2,18,7,142,384,526,225
3404-001,2014,2,18,8,411,1375,1786,526
3404-001,2014,2,18,9,609,1129,1738,1786
3404-001,2014,2,18,10,605,619,1224,1738
3404-001,2014,2,18,11,636,630,1266,1224
3404-001,2014,2,18,12,587,649,1236,1266
3404-001,2014,2,18,13,509,458,967,1236
3404-001,2014,2,18,14,531,575,1106,967
3404-001,2014,2,18,15,668,647,1315,1106
3404-001,2014,2,18,16,652,591,1243,1315
3404-001,2014,2,18,17,688,490,1178,1243
3404-001,2014,2,18,18,899,494,1393,1178
3404-001,2014,2,18,19,788,377,1165,1393
3404-001,2014,2,18,20,595,333,928,1165
3404-001,2014,2,18,21,500,251,751,928
3404-001,2014,2,18,22,348,201,549,751
3404-001,2014,2,18,23,178,111,289,549
3404-001,2014,2,18,24,131,86,217,289
3404-001,2014,2,19,1,65,78,143,217
3404-001,2014,2,19,2,60,46,106,143
3404-001,2014,2,19,3,37,40,77,106
3404-001,2014,2,19,4,33,36,69,77
3404-001,2014,2,19,5,56,68,124,69
3404-001,2014,2,19,6,95,112,207,124
3404-001,2014,2,19,7,146,379,525,207
3404-001,2014,2,19,8,402,1393,1795,525
3404-001,2014,2,19,9,603,1142,1745,1795
3404-001,2014,2,19,10,576,591,1167,1745
3404-001,2014,2,19,11,620,610,1230,1167
3404-001,2014,2,19,12,571,577,1148,1230
3404-001,2014,2,19,13,483,525,1008,1148
3404-001,2014,2,19,14,555,588,1143,1008
3404-001,2014,2,19,15,606,603,1209,1143
3404-001,2014,2,19,16,636,556,1192,1209
3404-001,2014,2,19,17,689,484,1173,1192
3404-001,2014,2,19,18,953,492,1445,1173
3404-001,2014,2,19,19,910,405,1315,1445
3404-001,2014,2,19,20,574,320,894,1315
3404-001,2014,2,19,21,446,217,663,894
3404-001,2014,2,19,22,338,160,498,663
3404-001,2014,2,19,23,157,150,307,498
3404-001,2014,2,19,24,92,94,186,307
3404-001,2014,2,20,1,51,48,99,186
3404-001,2014,2,20,2,56,52,108,99
3404-001,2014,2,20,3,34,32,66,108
3404-001,2014,2,20,4,48,50,98,66
3404-001,2014,2,20,5,48,39,87,98
3404-001,2014,2,20,6,76,109,185,87
3404-001,2014,2,20,7,148,392,540,185
3404-001,2014,2,20,8,417,1329,1746,540
3404-001,2014,2,20,9,653,1187,1840,1746
3404-001,2014,2,20,10,570,612,1182,1840
3404-001,2014,2,20,11,602,595,1197,1182
3404-001,2014,2,20,12,560,578,1138,1197
3404-001,2014,2,20,13,501,437,938,1138
3404-001,2014,2,20,14,595,561,1156,938
3404-001,2014,2,20,15,632,610,1242,1156
3404-001,2014,2,20,16,666,559,1225,1242
3404-001,2014,2,20,17,675,539,1214,1225
3404-001,2014,2,20,18,911,491,1402,1214
3404-001,2014,2,20,19,810,398,1208,1402
3404-001,2014,2,20,20,558,355,913,1208
3404-001,2014,2,20,21,502,210,712,913
3404-001,2014,2,20,22,320,198,518,712
3404-001,2014,2,20,23,177,118,295,518
3404-001,2014,2,20,24,101,95,196,295
3404-001,2014,2,21,1,72,52,124,196
3404-001,2014,2,21,2,66,44,110,124
3404-001,2014,2,21,3,38,32,70,110
3404-001,2014,2,21,4,32,38,70,70
3404-001,2014,2,21,5,42,66,108,70
3404-001,2014,2,21,6,80,117,197,108
3404-001,2014,2,21,7,150,389,539,197
3404-001,2014,2,21,8,406,1372,1778,539
3404-001,2014,2,21,9,610,1151,1761,1778
3404-001,2014,2,21,10,584,665,1249,1761
3404-001,2014,2,21,11,608,619,1227,1249
3404-001,2014,2,21,12,602,559,1161,1227
3404-001,2014,2,21,13,562,491,1053,1161
3404-001,2014,2,21,14,563,564,1127,1053
3404-001,2014,2,21,15,669,678,1347,1127
3404-001,2014,2,21,16,687,513,1200,1347
3404-001,2014,2,21,17,734,508,1242,1200
3404-001,2014,2,21,18,1007,521,1528,1242
3404-001,2014,2,21,19,1051,447,1498,1528
3404-001,2014,2,21,20,738,403,1141,1498
3404-001,2014,2,21,21,508,249,757,1141
3404-001,2014,2,21,22,326,188,514,757
3404-001,2014,2,21,23,172,116,288,514
3404-001,2014,2,21,24,112,118,230,288
3404-001,2014,2,22,1,66,62,128,230
3404-001,2014,2,22,2,63,45,108,128
3404-001,2014,2,22,3,48,28,76,108
3404-001,2014,2,22,4,31,41,72,76
3404-001,2014,2,22,5,46,42,88,72
3404-001,2014,2,22,6,67,124,191,88
3404-001,2014,2,22,7,129,248,377,191
3404-001,2014,2,22,8,294,664,958,377
3404-001,2014,2,22,9,425,617,1042,958
3404-001,2014,2,22,10,484,419,903,1042
3404-001,2014,2,22,11,473,462,935,903
3404-001,2014,2,22,12,486,436,922,935
3404-001,2014,2,22,13,476,373,849,922
3404-001,2014,2,22,14,445,446,891,849
3404-001,2014,2,22,15,461,444,905,891
3404-001,2014,2,22,16,477,390,867,905
3404-001,2014,2,22,17,524,359,883,867
3404-001,2014,2,22,18,706,372,1078,883
3404-001,2014,2,22,19,458,327,785,1078
3404-001,2014,2,22,20,282,210,492,785
3404-001,2014,2,22,21,213,194,407,492
3404-001,2014,2,22,22,144,157,301,407
3404-001,2014,2,22,23,108,78,186,301
3404-001,2014,2,22,24,54,62,116,186
3404-001,2014,2,23,1,53,48,101,116
3404-001,2014,2,23,2,41,29,70,101
3404-001,2014,2,23,3,27,26,53,70
3404-001,2014,2,23,4,19,15,34,53
3404-001,2014,2,23,5,20,20,40,34
3404-001,2014,2,23,6,35,45,80,40
3404-001,2014,2,23,7,46,123,169,80
3404-001,2014,2,23,8,118,215,333,169
3404-001,2014,2,23,9,160,213,373,333
3404-001,2014,2,23,10,210,210,420,373
3404-001,2014,2,23,11,240,265,505,420
3404-001,2014,2,23,12,255,258,513,505
3404-001,2014,2,23,13,265,308,573,513
3404-001,2014,2,23,14,291,325,616,573
3404-001,2014,2,23,15,335,291,626,616
3404-001,2014,2,23,16,389,316,705,626
3404-001,2014,2,23,17,408,296,704,705
3404-001,2014,2,23,18,434,279,713,704
3404-001,2014,2,23,19,331,238,569,713
3404-001,2014,2,23,20,203,225,428,569
3404-001,2014,2,23,21,161,189,350,428
3404-001,2014,2,23,22,126,183,309,350
3404-001,2014,2,23,23,75,129,204,309
3404-001,2014,2,23,24,42,87,129,204
3404-001,2014,2,24,1,37,68,105,129
3404-001,2014,2,24,2,24,41,65,105
3404-001,2014,2,24,3,29,27,56,65
3404-001,2014,2,24,4,15,29,44,56
3404-001,2014,2,24,5,22,48,70,44
3404-001,2014,2,24,6,67,151,218,70
3404-001,2014,2,24,7,183,512,695,218
3404-001,2014,2,24,8,465,1561,2026,695
3404-001,2014,2,24,9,555,1230,1785,2026
3404-001,2014,2,24,10,518,584,1102,1785
3404-001,2014,2,24,11,602,630,1232,1102
3404-001,2014,2,24,12,595,593,1188,1232
3404-001,2014,2,24,13,481,540,1021,1188
3404-001,2014,2,24,14,576,554,1130,1021
3404-001,2014,2,24,15,701,634,1335,1130
3404-001,2014,2,24,16,682,587,1269,1335
3404-001,2014,2,24,17,623,502,1125,1269
3404-001,2014,2,24,18,869,528,1397,1125
3404-001,2014,2,24,19,865,389,1254,1397
3404-001,2014,2,24,20,647,329,976,1254
3404-001,2014,2,24,21,546,235,781,976
3404-001,2014,2,24,22,367,191,558,781
3404-001,2014,2,24,23,169,123,292,558
3404-001,2014,2,24,24,114,89,203,292
3404-001,2014,2,25,1,78,59,137,203
3404-001,2014,2,25,2,58,46,104,137
3404-001,2014,2,25,3,30,37,67,104
3404-001,2014,2,25,4,31,53,84,67
3404-001,2014,2,25,5,43,60,103,84
3404-001,2014,2,25,6,77,137,214,103
3404-001,2014,2,25,7,136,404,540,214
3404-001,2014,2,25,8,410,1425,1835,540
3404-001,2014,2,25,9,575,1165,1740,1835
3404-001,2014,2,25,10,653,652,1305,1740
3404-001,2014,2,25,11,622,637,1259,1305
3404-001,2014,2,25,12,568,597,1165,1259
3404-001,2014,2,25,13,529,534,1063,1165
3404-001,2014,2,25,14,601,623,1224,1063
3404-001,2014,2,25,15,658,699,1357,1224
3404-001,2014,2,25,16,758,606,1364,1357
3404-001,2014,2,25,17,703,570,1273,1364
3404-001,2014,2,25,18,867,523,1390,1273
3404-001,2014,2,25,19,885,394,1279,1390
3404-001,2014,2,25,20,639,351,990,1279
3404-001,2014,2,25,21,624,255,879,990
3404-001,2014,2,25,22,342,188,530,879
3404-001,2014,2,25,23,183,135,318,530
3404-001,2014,2,25,24,124,107,231,318
3404-001,2014,2,26,1,63,72,135,231
3404-001,2014,2,26,2,57,56,113,135
3404-001,2014,2,26,3,52,46,98,113
3404-001,2014,2,26,4,50,47,97,98
3404-001,2014,2,26,5,62,69,131,97
3404-001,2014,2,26,6,56,144,200,131
3404-001,2014,2,26,7,149,398,547,200
3404-001,2014,2,26,8,417,1381,1798,547
3404-001,2014,2,26,9,582,1155,1737,1798
3404-001,2014,2,26,10,584,651,1235,1737
3404-001,2014,2,26,11,667,678,1345,1235
3404-001,2014,2,26,12,580,556,1136,1345
3404-001,2014,2,26,13,524,533,1057,1136
3404-001,2014,2,26,14,596,586,1182,1057
3404-001,2014,2,26,15,667,651,1318,1182
3404-001,2014,2,26,16,667,584,1251,1318
3404-001,2014,2,26,17,676,511,1187,1251
3404-001,2014,2,26,18,953,472,1425,1187
3404-001,2014,2,26,19,944,412,1356,1425
3404-001,2014,2,26,20,635,369,1004,1356
3404-001,2014,2,26,21,496,259,755,1004
3404-001,2014,2,26,22,376,185,561,755
3404-001,2014,2,26,23,189,140,329,561
3404-001,2014,2,26,24,93,88,181,329
3404-001,2014,2,27,1,75,80,155,181
3404-001,2014,2,27,2,47,45,92,155
3404-001,2014,2,27,3,55,50,105,92
3404-001,2014,2,27,4,43,38,81,105
3404-001,2014,2,27,5,46,52,98,81
3404-001,2014,2,27,6,77,139,216,98
3404-001,2014,2,27,7,170,423,593,216
3404-001,2014,2,27,8,386,1362,1748,593
3404-001,2014,2,27,9,632,1181,1813,1748
3404-001,2014,2,27,10,594,667,1261,1813
3404-001,2014,2,27,11,671,652,1323,1261
3404-001,2014,2,27,12,564,558,1122,1323
3404-001,2014,2,27,13,528,521,1049,1122
3404-001,2014,2,27,14,605,619,1224,1049
3404-001,2014,2,27,15,675,617,1292,1224
3404-001,2014,2,27,16,722,587,1309,1292
3404-001,2014,2,27,17,657,531,1188,1309
3404-001,2014,2,27,18,897,525,1422,1188
3404-001,2014,2,27,19,886,429,1315,1422
3404-001,2014,2,27,20,634,364,998,1315
3404-001,2014,2,27,21,565,261,826,998
3404-001,2014,2,27,22,345,212,557,826
3404-001,2014,2,27,23,206,142,348,557
3404-001,2014,2,27,24,131,98,229,348
3404-001,2014,2,28,1,78,58,136,229
3404-001,2014,2,28,2,53,58,111,136
3404-001,2014,2,28,3,49,43,92,111
3404-001,2014,2,28,4,37,40,77,92
3404-001,2014,2,28,5,41,72,113,77
3404-001,2014,2,28,6,80,136,216,113
3404-001,2014,2,28,7,161,407,568,216
3404-001,2014,2,28,8,415,1442,1857,568
3404-001,2014,2,28,9,633,1129,1762,1857
3404-001,2014,2,28,10,621,631,1252,1762
3404-001,2014,2,28,11,700,633,1333,1252
3404-001,2014,2,28,12,647,623,1270,1333
3404-001,2014,2,28,13,526,500,1026,1270
3404-001,2014,2,28,14,583,600,1183,1026
3404-001,2014,2,28,15,702,594,1296,1183
3404-001,2014,2,28,16,746,609,1355,1296
3404-001,2014,2,28,17,741,573,1314,1355
3404-001,2014,2,28,18,1045,511,1556,1314
3404-001,2014,2,28,19,1107,462,1569,1556
3404-001,2014,2,28,20,724,448,1172,1569
3404-001,2014,2,28,21,575,266,841,1172
3404-001,2014,2,28,22,358,196,554,841
3404-001,2014,2,28,23,201,158,359,554
3404-001,2014,2,28,24,98,89,187,359
3404-001,2014,3,1,1,61,74,135,187
3404-001,2014,3,1,2,73,61,134,135
3404-001,2014,3,1,3,45,43,88,134
3404-001,2014,3,1,4,42,39,81,88
3404-001,2014,3,1,5,48,63,111,81
3404-001,2014,3,1,6,62,136,198,111
3404-001,2014,3,1,7,136,270,406,198
3404-001,2014,3,1,8,260,574,834,406
3404-001,2014,3,1,9,384,491,875,834
3404-001,2014,3,1,10,443,443,886,875
3404-001,2014,3,1,11,417,467,884,886
3404-001,2014,3,1,12,462,486,948,884
3404-001,2014,3,1,13,429,426,855,948
3404-001,2014,3,1,14,480,404,884,855
3404-001,2014,3,1,15,455,419,874,884
3404-001,2014,3,1,16,469,378,847,874
3404-001,2014,3,1,17,525,370,895,847
3404-001,2014,3,1,18,637,378,1015,895
3404-001,2014,3,1,19,492,301,793,1015
3404-001,2014,3,1,20,282,233,515,793
3404-001,2014,3,1,21,208,193,401,515
3404-001,2014,3,1,22,163,133,296,401
3404-001,2014,3,1,23,93,97,190,296
3404-001,2014,3,1,24,69,77,146,190
3404-001,2014,3,2,1,59,44,103,146
3404-001,2014,3,2,2,32,30,62,103
3404-001,2014,3,2,3,24,28,52,62
3404-001,2014,3,2,4,16,15,31,52
3404-001,2014,3,2,5,17,18,35,31
3404-001,2014,3,2,6,39,39,78,35
3404-001,2014,3,2,7,31,116,147,78
3404-001,2014,3,2,8,126,208,334,147
3404-001,2014,3,2,9,199,210,409,334
3404-001,2014,3,2,10,177,220,397,409
3404-001,2014,3,2,11,272,278,550,397
3404-001,2014,3,2,12,267,346,613,550
3404-001,2014,3,2,13,287,310,597,613
3404-001,2014,3,2,14,323,340,663,597
3404-001,2014,3,2,15,398,306,704,663
3404-001,2014,3,2,16,449,354,803,704
3404-001,2014,3,2,17,474,298,772,803
3404-001,2014,3,2,18,498,269,767,772
3404-001,2014,3,2,19,406,262,668,767
3404-001,2014,3,2,20,254,250,504,668
3404-001,2014,3,2,21,198,242,440,504
3404-001,2014,3,2,22,140,226,366,440
3404-001,2014,3,2,23,86,165,251,366
3404-001,2014,3,2,24,67,116,183,251
3404-001,2014,3,3,1,25,54,79,183
3404-001,2014,3,3,2,21,35,56,79
3404-001,2014,3,3,3,20,39,59,56
3404-001,2014,3,3,4,20,37,57,59
3404-001,2014,3,3,5,37,66,103,57
3404-001,2014,3,3,6,78,233,311,103
3404-001,2014,3,3,7,192,535,727,311
3404-001,2014,3,3,8,463,1642,2105,727
3404-001,2014,3,3,9,537,1208,1745,2105
3404-001,2014,3,3,10,609,639,1248,1745
3404-001,2014,3,3,11,565,601,1166,1248
3404-001,2014,3,3,12,618,627,1245,1166
3404-001,2014,3,3,13,499,504,1003,1245
3404-001,2014,3,3,14,617,640,1257,1003
3404-001,2014,3,3,15,678,644,1322,1257
3404-001,2014,3,3,16,641,659,1300,1322
3404-001,2014,3,3,17,642,563,1205,1300
3404-001,2014,3,3,18,912,538,1450,1205
3404-001,2014,3,3,19,867,387,1254,1450
3404-001,2014,3,3,20,660,334,994,1254
3404-001,2014,3,3,21,592,259,851,994
3404-001,2014,3,3,22,370,192,562,851
3404-001,2014,3,3,23,188,131,319,562
3404-001,2014,3,3,24,109,96,205,319
3404-001,2014,3,4,1,70,71,141,205
3404-001,2014,3,4,2,57,44,101,141
3404-001,2014,3,4,3,41,50,91,101
3404-001,2014,3,4,4,31,40,71,91
3404-001,2014,3,4,5,48,75,123,71
3404-001,2014,3,4,6,68,144,212,123
3404-001,2014,3,4,7,169,459,628,212
3404-001,2014,3,4,8,413,1451,1864,628
3404-001,2014,3,4,9,563,1157,1720,1864
3404-001,2014,3,4,10,627,637,1264,1720
3404-001,2014,3,4,11,621,628,1249,1264
3404-001,2014,3,4,12,600,627,1227,1249
3404-001,2014,3,4,13,539,522,1061,1227
3404-001,2014,3,4,14,574,610,1184,1061
3404-001,2014,3,4,15,664,647,1311,1184
3404-001,2014,3,4,16,704,634,1338,1311
3404-001,2014,3,4,17,674,531,1205,1338
3404-001,2014,3,4,18,886,502,1388,1205
3404-001,2014,3,4,19,863,383,1246,1388
3404-001,2014,3,4,20,629,337,966,1246
3404-001,2014,3,4,21,587,242,829,966
3404-001,2014,3,4,22,354,215,569,829
3404-001,2014,3,4,23,191,121,312,569
3404-001,2014,3,4,24,118,89,207,312
3404-001,2014,3,5,1,77,65,142,207
3404-001,2014,3,5,2,59,45,104,142
3404-001,2014,3,5,3,49,38,87,104
3404-001,2014,3,5,4,33,43,76,87
3404-001,2014,3,5,5,44,65,109,76
3404-001,2014,3,5,6,84,170,254,109
3404-001,2014,3,5,7,162,412,574,254
3404-001,2014,3,5,8,412,1407,1819,574
3404-001,2014,3,5,9,606,1187,1793,1819
3404-001,2014,3,5,10,591,684,1275,1793
3404-001,2014,3,5,11,631,638,1269,1275
3404-001,2014,3,5,12,624,636,1260,1269
3404-001,2014,3,5,13,510,450,960,1260
3404-001,2014,3,5,14,568,586,1154,960
3404-001,2014,3,5,15,695,684,1379,1154
3404-001,2014,3,5,16,697,574,1271,1379
3404-001,2014,3,5,17,643,510,1153,1271
3404-001,2014,3,5,18,952,488,1440,1153
3404-001,2014,3,5,19,929,399,1328,1440
3404-001,2014,3,5,20,612,376,988,1328
3404-001,2014,3,5,21,488,221,709,988
3404-001,2014,3,5,22,382,183,565,709
3404-001,2014,3,5,23,163,126,289,565
3404-001,2014,3,5,24,111,91,202,289
3404-001,2014,3,6,1,57,58,115,202
3404-001,2014,3,6,2,57,44,101,115
3404-001,2014,3,6,3,48,41,89,101
3404-001,2014,3,6,4,35,44,79,89
3404-001,2014,3,6,5,56,64,120,79
3404-001,2014,3,6,6,85,152,237,120
3404-001,2014,3,6,7,158,431,589,237
3404-001,2014,3,6,8,421,1453,1874,589
3404-001,2014,3,6,9,634,1145,1779,1874
3404-001,2014,3,6,10,611,656,1267,1779
3404-001,2014,3,6,11,576,630,1206,1267
3404-001,2014,3,6,12,591,633,1224,1206
3404-001,2014,3,6,13,502,483,985,1224
3404-001,2014,3,6,14,596,562,1158,985
3404-001,2014,3,6,15,745,686,1431,1158
3404-001,2014,3,6,16,693,643,1336,1431
3404-001,2014,3,6,17,737,512,1249,1336
3404-001,2014,3,6,18,894,494,1388,1249
3404-001,2014,3,6,19,869,456,1325,1388
3404-001,2014,3,6,20,621,333,954,1325
3404-001,2014,3,6,21,587,234,821,954
3404-001,2014,3,6,22,328,205,533,821
3404-001,2014,3,6,23,211,140,351,533
3404-001,2014,3,6,24,118,103,221,351
3404-001,2014,3,7,1,74,73,147,221
3404-001,2014,3,7,2,47,54,101,147
3404-001,2014,3,7,3,39,33,72,101
3404-001,2014,3,7,4,50,40,90,72
3404-001,2014,3,7,5,67,74,141,90
3404-001,2014,3,7,6,71,134,205,141
3404-001,2014,3,7,7,145,415,560,205
3404-001,2014,3,7,8,413,1473,1886,560
3404-001,2014,3,7,9,604,1185,1789,1886
3404-001,2014,3,7,10,577,674,1251,1789
3404-001,2014,3,7,11,681,661,1342,1251
3404-001,2014,3,7,12,580,626,1206,1342
3404-001,2014,3,7,13,550,509,1059,1206
3404-001,2014,3,7,14,627,569,1196,1059
3404-001,2014,3,7,15,675,670,1345,1196
3404-001,2014,3,7,16,665,610,1275,1345
3404-001,2014,3,7,17,788,512,1300,1275
3404-001,2014,3,7,18,1038,474,1512,1300
3404-001,2014,3,7,19,1071,478,1549,1512
3404-001,2014,3,7,20,733,393,1126,1549
3404-001,2014,3,7,21,550,250,800,1126
3404-001,2014,3,7,22,346,178,524,800
3404-001,2014,3,7,23,178,144,322,524
3404-001,2014,3,7,24,109,114,223,322
3404-001,2014,3,8,1,71,58,129,223
3404-001,2014,3,8,2,59,52,111,129
3404-001,2014,3,8,3,44,26,70,111
3404-001,2014,3,8,4,32,36,68,70
3404-001,2014,3,8,5,51,67,118,68
3404-001,2014,3,8,6,70,157,227,118
3404-001,2014,3,8,7,158,256,414,227
3404-001,2014,3,8,8,302,693,995,414
3404-001,2014,3,8,9,417,669,1086,995
3404-001,2014,3,8,10,534,514,1048,1086
3404-001,2014,3,8,11,500,498,998,1048
3404-001,2014,3,8,12,491,459,950,998
3404-001,2014,3,8,13,416,425,841,950
3404-001,2014,3,8,14,453,468,921,841
3404-001,2014,3,8,15,486,441,927,921
3404-001,2014,3,8,16,504,382,886,927
3404-001,2014,3,8,17,557,367,924,886
3404-001,2014,3,8,18,772,381,1153,924
3404-001,2014,3,8,19,511,325,836,1153
3404-001,2014,3,8,20,271,238,509,836
3404-001,2014,3,8,21,215,196,411,509
3404-001,2014,3,8,22,172,118,290,411
3404-001,2014,3,8,23,122,94,216,290
3404-001,2014,3,8,24,62,73,135,216
3404-001,2014,3,9,1,41,60,101,135
3404-001,2014,3,9,2,43,24,67,101
3404-001,2014,3,9,3,30,30,60,67
3404-001,2014,3,9,4,28,24,52,60
3404-001,2014,3,9,5,22,14,36,52
3404-001,2014,3,9,6,23,44,67,36
3404-001,2014,3,9,7,47,109,156,67
3404-001,2014,3,9,8,106,171,277,156
3404-001,2014,3,9,9,163,194,357,277
3404-001,2014,3,9,10,204,199,403,357
3404-001,2014,3,9,11,244,247,491,403
3404-001,2014,3,9,12,231,261,492,491
3404-001,2014,3,9,13,226,270,496,492
3404-001,2014,3,9,14,259,293,552,496
3404-001,2014,3,9,15,312,288,600,552
3404-001,2014,3,9,16,375,298,673,600
3404-001,2014,3,9,17,433,253,686,673
3404-001,2014,3,9,18,369,240,609,686
3404-001,2014,3,9,19,271,259,530,609
3404-001,2014,3,9,20,202,216,418,530
3404-001,2014,3,9,21,156,202,358,418
3404-001,2014,3,9,22,125,205,330,358
3404-001,2014,3,9,23,81,158,239,330
3404-001,2014,3,9,24,54,97,151,239
3404-001,2014,3,10,1,31,68,99,151
3404-001,2014,3,10,2,18,47,65,99
3404-001,2014,3,10,3,14,32,46,65
3404-001,2014,3,10,4,23,34,57,46
3404-001,2014,3,10,5,45,60,105,57
3404-001,2014,3,10,6,73,164,237,105
3404-001,2014,3,10,7,163,547,710,237
3404-001,2014,3,10,8,449,1687,2136,710
3404-001,2014,3,10,9,533,1231,1764,2136
3404-001,2014,3,10,10,532,637,1169,1764
3404-001,2014,3,10,11,583,613,1196,1169
3404-001,2014,3,10,12,593,644,1237,1196
3404-001,2014,3,10,13,537,548,1085,1237
3404-001,2014,3,10,14,518,579,1097,1085
3404-001,2014,3,10,15,667,606,1273,1097
3404-001,2014,3,10,16,712,631,1343,1273
3404-001,2014,3,10,17,677,506,1183,1343
3404-001,2014,3,10,18,980,468,1448,1183
3404-001,2014,3,10,19,864,389,1253,1448
3404-001,2014,3,10,20,680,357,1037,1253
3404-001,2014,3,10,21,567,233,800,1037
3404-001,2014,3,10,22,349,180,529,800
3404-001,2014,3,10,23,185,159,344,529
3404-001,2014,3,10,24,111,97,208,344
3404-001,2014,3,11,1,69,65,134,208
3404-001,2014,3,11,2,43,55,98,134
3404-001,2014,3,11,3,37,47,84,98
3404-001,2014,3,11,4,39,38,77,84
3404-001,2014,3,11,5,45,70,115,77
3404-001,2014,3,11,6,82,151,233,115
3404-001,2014,3,11,7,159,445,604,233
3404-001,2014,3,11,8,428,1476,1904,604
3404-001,2014,3,11,9,640,1179,1819,1904
3404-001,2014,3,11,10,624,690,1314,1819
3404-001,2014,3,11,11,644,713,1357,1314
3404-001,2014,3,11,12,631,601,1232,1357
3404-001,2014,3,11,13,506,476,982,1232
3404-001,2014,3,11,14,545,549,1094,982
3404-001,2014,3,11,15,696,661,1357,1094
3404-001,2014,3,11,16,712,607,1319,1357
3404-001,2014,3,11,17,701,561,1262,1319
3404-001,2014,3,11,18,893,500,1393,1262
3404-001,2014,3,11,19,948,387,1335,1393
3404-001,2014,3,11,20,674,370,1044,1335
3404-001,2014,3,11,21,551,245,796,1044
3404-001,2014,3,11,22,378,166,544,796
3404-001,2014,3,11,23,199,126,325,544
3404-001,2014,3,11,24,110,101,211,325
3404-001,2014,3,12,1,75,85,160,211
3404-001,2014,3,12,2,61,56,117,160
3404-001,2014,3,12,3,40,32,72,117
3404-001,2014,3,12,4,37,48,85,72
3404-001,2014,3,12,5,41,63,104,85
3404-001,2014,3,12,6,92,131,223,104
3404-001,2014,3,12,7,153,430,583,223
3404-001,2014,3,12,8,432,1483,1915,583
3404-001,2014,3,12,9,586,1154,1740,1915
3404-001,2014,3,12,10,565,612,1177,1740
3404-001,2014,3,12,11,619,643,1262,1177
3404-001,2014,3,12,12,567,572,1139,1262
3404-001,2014,3,12,13,551,464,1015,1139
3404-001,2014,3,12,14,580,508,1088,1015
3404-001,2014,3,12,15,629,605,1234,1088
3404-001,2014,3,12,16,623,536,1159,1234
3404-001,2014,3,12,17,662,453,1115,1159
3404-001,2014,3,12,18,896,423,1319,1115
3404-001,2014,3,12,19,845,380,1225,1319
3404-001,2014,3,12,20,548,321,869,1225
3404-001,2014,3,12,21,441,214,655,869
3404-001,2014,3,12,22,298,183,481,655
3404-001,2014,3,12,23,191,116,307,481
3404-001,2014,3,12,24,110,93,203,307
3404-001,2014,3,13,1,65,63,128,203
3404-001,2014,3,13,2,44,40,84,128
3404-001,2014,3,13,3,49,33,82,84
3404-001,2014,3,13,4,34,29,63,82
3404-001,2014,3,13,5,44,53,97,63
3404-001,2014,3,13,6,67,139,206,97
3404-001,2014,3,13,7,134,401,535,206
3404-001,2014,3,13,8,386,1416,1802,535
3404-001,2014,3,13,9,613,1166,1779,1802
3404-001,2014,3,13,10,560,635,1195,1779
3404-001,2014,3,13,11,619,691,1310,1195
3404-001,2014,3,13,12,547,569,1116,1310
3404-001,2014,3,13,13,536,495,1031,1116
3404-001,2014,3,13,14,551,551,1102,1031
3404-001,2014,3,13,15,665,651,1316,1102
3404-001,2014,3,13,16,681,542,1223,1316
3404-001,2014,3,13,17,710,529,1239,1223
3404-001,2014,3,13,18,946,480,1426,1239
3404-001,2014,3,13,19,841,395,1236,1426
3404-001,2014,3,13,20,628,354,982,1236
3404-001,2014,3,13,21,546,260,806,982
3404-001,2014,3,13,22,346,196,542,806
3404-001,2014,3,13,23,186,116,302,542
3404-001,2014,3,13,24,99,111,210,302
3404-001,2014,3,14,1,63,77,140,210
3404-001,2014,3,14,2,59,41,100,140
3404-001,2014,3,14,3,36,32,68,100
3404-001,2014,3,14,4,31,40,71,68
3404-001,2014,3,14,5,44,58,102,71
3404-001,2014,3,14,6,70,148,218,102
3404-001,2014,3,14,7,144,420,564,218
3404-001,2014,3,14,8,413,1474,1887,564
3404-001,2014,3,14,9,617,1153,1770,1887
3404-001,2014,3,14,10,606,720,1326,1770
3404-001,2014,3,14,11,616,700,1316,1326
3404-001,2014,3,14,12,610,624,1234,1316
3404-001,2014,3,14,13,596,535,1131,1234
3404-001,2014,3,14,14,686,580,1266,1131
3404-001,2014,3,14,15,698,625,1323,1266
3404-001,2014,3,14,16,766,621,1387,1323
3404-001,2014,3,14,17,784,602,1386,1387
3404-001,2014,3,14,18,1136,522,1658,1386
3404-001,2014,3,14,19,1200,491,1691,1658
3404-001,2014,3,14,20,830,419,1249,1691
3404-001,2014,3,14,21,590,271,861,1249
3404-001,2014,3,14,22,397,218,615,861
3404-001,2014,3,14,23,194,145,339,615
3404-001,2014,3,14,24,124,122,246,339
3404-001,2014,3,15,1,70,62,132,246
3404-001,2014,3,15,2,47,33,80,132
3404-001,2014,3,15,3,36,31,67,80
3404-001,2014,3,15,4,37,31,68,67
3404-001,2014,3,15,5,47,52,99,68
3404-001,2014,3,15,6,69,113,182,99
3404-001,2014,3,15,7,134,258,392,182
3404-001,2014,3,15,8,286,655,941,392
3404-001,2014,3,15,9,449,648,1097,941
3404-001,2014,3,15,10,480,558,1038,1097
3404-001,2014,3,15,11,489,550,1039,1038
3404-001,2014,3,15,12,513,491,1004,1039
3404-001,2014,3,15,13,433,462,895,1004
3404-001,2014,3,15,14,454,469,923,895
3404-001,2014,3,15,15,504,413,917,923
3404-001,2014,3,15,16,541,482,1023,917
3404-001,2014,3,15,17,622,655,1277,1023
3404-001,2014,3,15,18,757,450,1207,1277
3404-001,2014,3,15,19,551,397,948,1207
3404-001,2014,3,15,20,393,291,684,948
3404-001,2014,3,15,21,292,198,490,684
3404-001,2014,3,15,22,180,126,306,490
3404-001,2014,3,15,23,134,111,245,306
3404-001,2014,3,15,24,102,68,170,245
3404-001,2014,3,16,1,120,55,175,170
3404-001,2014,3,16,2,77,27,104,175
3404-001,2014,3,16,3,31,39,70,104
3404-001,2014,3,16,4,24,17,41,70
3404-001,2014,3,16,5,21,23,44,41
3404-001,2014,3,16,6,38,67,105,44
3404-001,2014,3,16,7,60,147,207,105
3404-001,2014,3,16,8,138,250,388,207
3404-001,2014,3,16,9,185,218,403,388
3404-001,2014,3,16,10,278,257,535,403
3404-001,2014,3,16,11,287,316,603,535
3404-001,2014,3,16,12,255,344,599,603
3404-001,2014,3,16,13,270,324,594,599
3404-001,2014,3,16,14,321,364,685,594
3404-001,2014,3,16,15,396,360,756,685
3404-001,2014,3,16,16,466,322,788,756
3404-001,2014,3,16,17,465,288,753,788
3404-001,2014,3,16,18,584,309,893,753
3404-001,2014,3,16,19,420,313,733,893
3404-001,2014,3,16,20,274,225,499,733
3404-001,2014,3,16,21,184,217,401,499
3404-001,2014,3,16,22,162,193,355,401
3404-001,2014,3,16,23,101,129,230,355
3404-001,2014,3,16,24,68,94,162,230
3404-001,2014,3,17,1,32,60,92,162
3404-001,2014,3,17,2,26,44,70,92
3404-001,2014,3,17,3,18,32,50,70
3404-001,2014,3,17,4,24,30,54,50
3404-001,2014,3,17,5,36,53,89,54
3404-001,2014,3,17,6,83,203,286,89
3404-001,2014,3,17,7,197,518,715,286
3404-001,2014,3,17,8,434,1691,2125,715
3404-001,2014,3,17,9,582,1265,1847,2125
3404-001,2014,3,17,10,533,672,1205,1847
3404-001,2014,3,17,11,633,649,1282,1205
3404-001,2014,3,17,12,584,616,1200,1282
3404-001,2014,3,17,13,534,533,1067,1200
3404-001,2014,3,17,14,571,600,1171,1067
3404-001,2014,3,17,15,654,649,1303,1171
3404-001,2014,3,17,16,692,657,1349,1303
3404-001,2014,3,17,17,749,538,1287,1349
3404-001,2014,3,17,18,902,491,1393,1287
3404-001,2014,3,17,19,861,424,1285,1393
3404-001,2014,3,17,20,673,358,1031,1285
3404-001,2014,3,17,21,572,198,770,1031
3404-001,2014,3,17,22,350,176,526,770
3404-001,2014,3,17,23,190,130,320,526
3404-001,2014,3,17,24,95,96,191,320
3404-001,2014,3,18,1,81,65,146,191
3404-001,2014,3,18,2,55,37,92,146
3404-001,2014,3,18,3,30,46,76,92
3404-001,2014,3,18,4,46,48,94,76
3404-001,2014,3,18,5,54,58,112,94
3404-001,2014,3,18,6,80,121,201,112
3404-001,2014,3,18,7,158,407,565,201
3404-001,2014,3,18,8,412,1470,1882,565
3404-001,2014,3,18,9,573,1204,1777,1882
3404-001,2014,3,18,10,614,655,1269,1777
3404-001,2014,3,18,11,617,700,1317,1269
3404-001,2014,3,18,12,583,599,1182,1317
3404-001,2014,3,18,13,507,501,1008,1182
3404-001,2014,3,18,14,593,624,1217,1008
3404-001,2014,3,18,15,720,663,1383,1217
3404-001,2014,3,18,16,715,616,1331,1383
3404-001,2014,3,18,17,697,522,1219,1331
3404-001,2014,3,18,18,907,515,1422,1219
3404-001,2014,3,18,19,916,431,1347,1422
3404-001,2014,3,18,20,667,364,1031,1347
3404-001,2014,3,18,21,550,219,769,1031
3404-001,2014,3,18,22,360,220,580,769
3404-001,2014,3,18,23,172,120,292,580
3404-001,2014,3,18,24,101,99,200,292
3404-001,2014,3,19,1,98,79,177,200
3404-001,2014,3,19,2,60,51,111,177
3404-001,2014,3,19,3,54,45,99,111
3404-001,2014,3,19,4,26,34,60,99
3404-001,2014,3,19,5,49,69,118,60
3404-001,2014,3,19,6,75,151,226,118
3404-001,2014,3,19,7,163,481,644,226
3404-001,2014,3,19,8,462,1476,1938,644
3404-001,2014,3,19,9,679,1227,1906,1938
3404-001,2014,3,19,10,633,703,1336,1906
3404-001,2014,3,19,11,665,667,1332,1336
3404-001,2014,3,19,12,658,657,1315,1332
3404-001,2014,3,19,13,588,555,1143,1315
3404-001,2014,3,19,14,600,603,1203,1143
3404-001,2014,3,19,15,678,638,1316,1203
3404-001,2014,3,19,16,667,604,1271,1316
3404-001,2014,3,19,17,753,554,1307,1271
3404-001,2014,3,19,18,1086,525,1611,1307
3404-001,2014,3,19,19,930,438,1368,1611
3404-001,2014,3,19,20,603,348,951,1368
3404-001,2014,3,19,21,495,214,709,951
3404-001,2014,3,19,22,322,202,524,709
3404-001,2014,3,19,23,203,143,346,524
3404-001,2014,3,19,24,112,86,198,346
3404-001,2014,3,20,1,58,51,109,198
3404-001,2014,3,20,2,54,48,102,109
3404-001,2014,3,20,3,34,37,71,102
3404-001,2014,3,20,4,28,30,58,71
3404-001,2014,3,20,5,36,58,94,58
3404-001,2014,3,20,6,78,161,239,94
3404-001,2014,3,20,7,158,431,589,239
3404-001,2014,3,20,8,410,1439,1849,589
3404-001,2014,3,20,9,614,1208,1822,1849
3404-001,2014,3,20,10,599,640,1239,1822
3404-001,2014,3,20,11,654,646,1300,1239
3404-001,2014,3,20,12,642,622,1264,1300
3404-001,2014,3,20,13,517,512,1029,1264
3404-001,2014,3,20,14,586,561,1147,1029
3404-001,2014,3,20,15,680,671,1351,1147
3404-001,2014,3,20,16,695,633,1328,1351
3404-001,2014,3,20,17,693,499,1192,1328
3404-001,2014,3,20,18,927,453,1380,1192
3404-001,2014,3,20,19,892,438,1330,1380
3404-001,2014,3,20,20,638,377,1015,1330
3404-001,2014,3,20,21,528,235,763,1015
3404-001,2014,3,20,22,362,186,548,763
3404-001,2014,3,20,23,194,133,327,548
3404-001,2014,3,20,24,106,83,189,327
3404-001,2014,3,21,1,73,67,140,189
3404-001,2014,3,21,2,56,52,108,140
3404-001,2014,3,21,3,39,46,85,108
3404-001,2014,3,21,4,32,29,61,85
3404-001,2014,3,21,5,41,62,103,61
3404-001,2014,3,21,6,66,132,198,103
3404-001,2014,3,21,7,155,422,577,198
3404-001,2014,3,21,8,414,1480,1894,577
3404-001,2014,3,21,9,623,1180,1803,1894
3404-001,2014,3,21,10,589,642,1231,1803
3404-001,2014,3,21,11,624,670,1294,1231
3404-001,2014,3,21,12,607,569,1176,1294
3404-001,2014,3,21,13,515,463,978,1176
3404-001,2014,3,21,14,561,539,1100,978
3404-001,2014,3,21,15,682,655,1337,1100
3404-001,2014,3,21,16,742,626,1368,1337
3404-001,2014,3,21,17,713,533,1246,1368
3404-001,2014,3,21,18,1109,510,1619,1246
3404-001,2014,3,21,19,1089,442,1531,1619
3404-001,2014,3,21,20,772,387,1159,1531
3404-001,2014,3,21,21,549,252,801,1159
3404-001,2014,3,21,22,321,179,500,801
3404-001,2014,3,21,23,220,146,366,500
3404-001,2014,3,21,24,106,126,232,366
3404-001,2014,3,22,1,58,65,123,232
3404-001,2014,3,22,2,79,46,125,123
3404-001,2014,3,22,3,32,43,75,125
3404-001,2014,3,22,4,32,41,73,75
3404-001,2014,3,22,5,53,54,107,73
3404-001,2014,3,22,6,76,152,228,107
3404-001,2014,3,22,7,147,294,441,228
3404-001,2014,3,22,8,320,748,1068,441
3404-001,2014,3,22,9,476,625,1101,1068
3404-001,2014,3,22,10,503,488,991,1101
3404-001,2014,3,22,11,476,504,980,991
3404-001,2014,3,22,12,444,516,960,980
3404-001,2014,3,22,13,444,479,923,960
3404-001,2014,3,22,14,445,489,934,923
3404-001,2014,3,22,15,564,473,1037,934
3404-001,2014,3,22,16,585,452,1037,1037
3404-001,2014,3,22,17,612,431,1043,1037
3404-001,2014,3,22,18,812,445,1257,1043
3404-001,2014,3,22,19,606,393,999,1257
3404-001,2014,3,22,20,360,292,652,999
3404-001,2014,3,22,21,261,182,443,652
3404-001,2014,3,22,22,198,136,334,443
3404-001,2014,3,22,23,139,109,248,334
3404-001,2014,3,22,24,81,71,152,248
3404-001,2014,3,23,1,70,52,122,152
3404-001,2014,3,23,2,55,39,94,122
3404-001,2014,3,23,3,32,31,63,94
3404-001,2014,3,23,4,21,21,42,63
3404-001,2014,3,23,5,27,22,49,42
3404-001,2014,3,23,6,44,56,100,49
3404-001,2014,3,23,7,63,143,206,100
3404-001,2014,3,23,8,139,257,396,206
3404-001,2014,3,23,9,229,263,492,396
3404-001,2014,3,23,10,199,236,435,492
3404-001,2014,3,23,11,266,339,605,435
3404-001,2014,3,23,12,229,389,618,605
3404-001,2014,3,23,13,305,344,649,618
3404-001,2014,3,23,14,320,364,684,649
3404-001,2014,3,23,15,381,350,731,684
3404-001,2014,3,23,16,435,319,754,731
3404-001,2014,3,23,17,499,306,805,754
3404-001,2014,3,23,18,607,342,949,805
3404-001,2014,3,23,19,417,297,714,949
3404-001,2014,3,23,20,301,248,549,714
3404-001,2014,3,23,21,215,216,431,549
3404-001,2014,3,23,22,167,189,356,431
3404-001,2014,3,23,23,92,153,245,356
3404-001,2014,3,23,24,69,114,183,245
3404-001,2014,3,24,1,33,69,102,183
3404-001,2014,3,24,2,34,40,74,102
3404-001,2014,3,24,3,23,36,59,74
3404-001,2014,3,24,4,25,36,61,59
3404-001,2014,3,24,5,43,74,117,61
3404-001,2014,3,24,6,72,194,266,117
3404-001,2014,3,24,7,188,552,740,266
3404-001,2014,3,24,8,455,1698,2153,740
3404-001,2014,3,24,9,548,1240,1788,2153
3404-001,2014,3,24,10,541,615,1156,1788
3404-001,2014,3,24,11,601,634,1235,1156
3404-001,2014,3,24,12,578,567,1145,1235
3404-001,2014,3,24,13,515,488,1003,1145
3404-001,2014,3,24,14,520,567,1087,1003
3404-001,2014,3,24,15,721,643,1364,1087
3404-001,2014,3,24,16,667,573,1240,1364
3404-001,2014,3,24,17,692,535,1227,1240
3404-001,2014,3,24,18,872,481,1353,1227
3404-001,2014,3,24,19,923,426,1349,1353
3404-001,2014,3,24,20,653,343,996,1349
3404-001,2014,3,24,21,584,250,834,996
3404-001,2014,3,24,22,346,192,538,834
3404-001,2014,3,24,23,189,129,318,538
3404-001,2014,3,24,24,97,89,186,318
3404-001,2014,3,25,1,65,79,144,186
3404-001,2014,3,25,2,59,52,111,144
3404-001,2014,3,25,3,43,42,85,111
3404-001,2014,3,25,4,37,39,76,85
3404-001,2014,3,25,5,56,81,137,76
3404-001,2014,3,25,6,74,145,219,137
3404-001,2014,3,25,7,173,450,623,219
3404-001,2014,3,25,8,418,1512,1930,623
3404-001,2014,3,25,9,606,1213,1819,1930
3404-001,2014,3,25,10,606,638,1244,1819
3404-001,2014,3,25,11,593,656,1249,1244
3404-001,2014,3,25,12,598,563,1161,1249
3404-001,2014,3,25,13,486,526,1012,1161
3404-001,2014,3,25,14,574,519,1093,1012
3404-001,2014,3,25,15,684,644,1328,1093
3404-001,2014,3,25,16,671,589,1260,1328
3404-001,2014,3,25,17,721,536,1257,1260
3404-001,2014,3,25,18,956,492,1448,1257
3404-001,2014,3,25,19,936,435,1371,1448
3404-001,2014,3,25,20,647,333,980,1371
3404-001,2014,3,25,21,559,230,789,980
3404-001,2014,3,25,22,364,200,564,789
3404-001,2014,3,25,23,187,115,302,564
3404-001,2014,3,25,24,107,99,206,302
3404-001,2014,3,26,1,70,82,152,206
3404-001,2014,3,26,2,65,43,108,152
3404-001,2014,3,26,3,28,37,65,108
3404-001,2014,3,26,4,24,38,62,65
3404-001,2014,3,26,5,37,75,112,62
3404-001,2014,3,26,6,89,129,218,112
3404-001,2014,3,26,7,158,410,568,218
3404-001,2014,3,26,8,414,1404,1818,568
3404-001,2014,3,26,9,614,1192,1806,1818
3404-001,2014,3,26,10,592,669,1261,1806
3404-001,2014,3,26,11,617,675,1292,1261
3404-001,2014,3,26,12,602,614,1216,1292
3404-001,2014,3,26,13,501,534,1035,1216
3404-001,2014,3,26,14,564,585,1149,1035
3404-001,2014,3,26,15,660,620,1280,1149
3404-001,2014,3,26,16,726,599,1325,1280
3404-001,2014,3,26,17,700,520,1220,1325
3404-001,2014,3,26,18,1015,492,1507,1220
3404-001,2014,3,26,19,938,465,1403,1507
3404-001,2014,3,26,20,618,376,994,1403
3404-001,2014,3,26,21,539,243,782,994
3404-001,2014,3,26,22,349,204,553,782
3404-001,2014,3,26,23,159,141,300,553
3404-001,2014,3,26,24,134,115,249,300
3404-001,2014,3,27,1,78,65,143,249
3404-001,2014,3,27,2,60,59,119,143
3404-001,2014,3,27,3,37,44,81,119
3404-001,2014,3,27,4,35,37,72,81
3404-001,2014,3,27,5,49,65,114,72
3404-001,2014,3,27,6,93,156,249,114
3404-001,2014,3,27,7,182,471,653,249
3404-001,2014,3,27,8,427,1476,1903,653
3404-001,2014,3,27,9,660,1263,1923,1903
3404-001,2014,3,27,10,613,703,1316,1923
3404-001,2014,3,27,11,641,679,1320,1316
3404-001,2014,3,27,12,629,643,1272,1320
3404-001,2014,3,27,13,541,525,1066,1272
3404-001,2014,3,27,14,604,577,1181,1066
3404-001,2014,3,27,15,675,613,1288,1181
3404-001,2014,3,27,16,706,593,1299,1288
3404-001,2014,3,27,17,735,526,1261,1299
3404-001,2014,3,27,18,1006,516,1522,1261
3404-001,2014,3,27,19,907,418,1325,1522
3404-001,2014,3,27,20,638,424,1062,1325
3404-001,2014,3,27,21,568,211,779,1062
3404-001,2014,3,27,22,369,201,570,779
3404-001,2014,3,27,23,204,142,346,570
3404-001,2014,3,27,24,97,111,208,346
3404-001,2014,3,28,1,83,80,163,208
3404-001,2014,3,28,2,74,56,130,163
3404-001,2014,3,28,3,45,39,84,130
3404-001,2014,3,28,4,31,49,80,84
3404-001,2014,3,28,5,64,63,127,80
3404-001,2014,3,28,6,95,157,252,127
3404-001,2014,3,28,7,171,454,625,252
3404-001,2014,3,28,8,413,1496,1909,625
3404-001,2014,3,28,9,629,1164,1793,1909
3404-001,2014,3,28,10,562,680,1242,1793
3404-001,2014,3,28,11,652,629,1281,1242
3404-001,2014,3,28,12,627,645,1272,1281
3404-001,2014,3,28,13,545,505,1050,1272
3404-001,2014,3,28,14,625,570,1195,1050
3404-001,2014,3,28,15,687,658,1345,1195
3404-001,2014,3,28,16,713,603,1316,1345
3404-001,2014,3,28,17,783,520,1303,1316
3404-001,2014,3,28,18,1130,538,1668,1303
3404-001,2014,3,28,19,1163,486,1649,1668
3404-001,2014,3,28,20,809,466,1275,1649
3404-001,2014,3,28,21,559,260,819,1275
3404-001,2014,3,28,22,374,218,592,819
3404-001,2014,3,28,23,198,143,341,592
3404-001,2014,3,28,24,131,132,263,341
3404-001,2014,3,29,1,79,97,176,263
3404-001,2014,3,29,2,71,51,122,176
3404-001,2014,3,29,3,52,39,91,122
3404-001,2014,3,29,4,43,50,93,91
3404-001,2014,3,29,5,51,69,120,93
3404-001,2014,3,29,6,78,155,233,120
3404-001,2014,3,29,7,163,326,489,233
3404-001,2014,3,29,8,322,645,967,489
3404-001,2014,3,29,9,443,629,1072,967
3404-001,2014,3,29,10,453,478,931,1072
3404-001,2014,3,29,11,503,494,997,931
3404-001,2014,3,29,12,505,506,1011,997
3404-001,2014,3,29,13,444,447,891,1011
3404-001,2014,3,29,14,512,443,955,891
3404-001,2014,3,29,15,536,415,951,955
3404-001,2014,3,29,16,534,404,938,951
3404-001,2014,3,29,17,597,381,978,938
3404-001,2014,3,29,18,694,369,1063,978
3404-001,2014,3,29,19,462,335,797,1063
3404-001,2014,3,29,20,287,257,544,797
3404-001,2014,3,29,21,224,176,400,544
3404-001,2014,3,29,22,156,137,293,400
3404-001,2014,3,29,23,122,108,230,293
3404-001,2014,3,29,24,88,76,164,230
3404-001,2014,3,30,1,57,40,97,164
3404-001,2014,3,30,2,47,30,77,97
3404-001,2014,3,30,3,36,20,56,77
3404-001,2014,3,30,4,23,24,47,56
3404-001,2014,3,30,5,27,22,49,47
3404-001,2014,3,30,6,38,57,95,49
3404-001,2014,3,30,7,83,127,210,95
3404-001,2014,3,30,8,124,256,380,210
3404-001,2014,3,30,9,194,252,446,380
3404-001,2014,3,30,10,249,261,510,446
3404-001,2014,3,30,11,243,328,571,510
3404-001,2014,3,30,12,287,357,644,571
3404-001,2014,3,30,13,291,320,611,644
3404-001,2014,3,30,14,323,347,670,611
3404-001,2014,3,30,15,385,349,734,670
3404-001,2014,3,30,16,427,304,731,734
3404-001,2014,3,30,17,491,337,828,731
3404-001,2014,3,30,18,514,330,844,828
3404-001,2014,3,30,19,438,330,768,844
3404-001,2014,3,30,20,344,238,582,768
3404-001,2014,3,30,21,239,211,450,582
3404-001,2014,3,30,22,144,206,350,450
3404-001,2014,3,30,23,93,155,248,350
3404-001,2014,3,30,24,58,96,154,248
3404-001,2014,3,31,1,43,68,111,154
3404-001,2014,3,31,2,37,58,95,111
3404-001,2014,3,31,3,15,44,59,95
3404-001,2014,3,31,4,18,47,65,59
3404-001,2014,3,31,5,40,61,101,65
3404-001,2014,3,31,6,88,187,275,101
3404-001,2014,3,31,7,201,580,781,275
3404-001,2014,3,31,8,455,1659,2114,781
3404-001,2014,3,31,9,549,1315,1864,2114
3404-001,2014,3,31,10,542,655,1197,1864
3404-001,2014,3,31,11,606,626,1232,1197
3404-001,2014,3,31,12,540,612,1152,1232
3404-001,2014,3,31,13,502,482,984,1152
3404-001,2014,3,31,14,518,530,1048,984
3404-001,2014,3,31,15,626,627,1253,1048
3404-001,2014,3,31,16,654,628,1282,1253
3404-001,2014,3,31,17,676,534,1210,1282
3404-001,2014,3,31,18,939,532,1471,1210
3404-001,2014,3,31,19,906,423,1329,1471
3404-001,2014,3,31,20,649,407,1056,1329
3404-001,2014,3,31,21,620,280,900,1056
3404-001,2014,3,31,22,398,224,622,900
3404-001,2014,3,31,23,204,148,352,622
3404-001,2014,3,31,24,115,95,210,352
3404-001,2014,4,1,1,75,59,134,210
3404-001,2014,4,1,2,50,47,97,134
3404-001,2014,4,1,3,43,49,92,97
3404-001,2014,4,1,4,42,52,94,92
3404-001,2014,4,1,5,46,64,110,94
3404-001,2014,4,1,6,91,140,231,110
3404-001,2014,4,1,7,184,480,664,231
3404-001,2014,4,1,8,428,1486,1914,664
3404-001,2014,4,1,9,636,1261,1897,1914
3404-001,2014,4,1,10,592,706,1298,1897
3404-001,2014,4,1,11,632,657,1289,1298
3404-001,2014,4,1,12,597,591,1188,1289
3404-001,2014,4,1,13,527,501,1028,1188
3404-001,2014,4,1,14,595,558,1153,1028
3404-001,2014,4,1,15,652,701,1353,1153
3404-001,2014,4,1,16,710,636,1346,1353
3404-001,2014,4,1,17,710,510,1220,1346
3404-001,2014,4,1,18,912,494,1406,1220
3404-001,2014,4,1,19,943,416,1359,1406
3404-001,2014,4,1,20,709,377,1086,1359
3404-001,2014,4,1,21,578,232,810,1086
3404-001,2014,4,1,22,394,196,590,810
3404-001,2014,4,1,23,205,158,363,590
3404-001,2014,4,1,24,119,120,239,363
3404-001,2014,4,2,1,93,76,169,239
3404-001,2014,4,2,2,60,62,122,169
3404-001,2014,4,2,3,43,38,81,122
3404-001,2014,4,2,4,44,46,90,81
3404-001,2014,4,2,5,50,62,112,90
3404-001,2014,4,2,6,80,157,237,112
3404-001,2014,4,2,7,212,459,671,237
3404-001,2014,4,2,8,428,1511,1939,671
3404-001,2014,4,2,9,633,1187,1820,1939
3404-001,2014,4,2,10,606,684,1290,1820
3404-001,2014,4,2,11,664,631,1295,1290
3404-001,2014,4,2,12,599,660,1259,1295
3404-001,2014,4,2,13,537,532,1069,1259
3404-001,2014,4,2,14,523,615,1138,1069
3404-001,2014,4,2,15,666,660,1326,1138
3404-001,2014,4,2,16,698,626,1324,1326
3404-001,2014,4,2,17,687,539,1226,1324
3404-001,2014,4,2,18,1040,538,1578,1226
3404-001,2014,4,2,19,943,441,1384,1578
3404-001,2014,4,2,20,636,411,1047,1384
3404-001,2014,4,2,21,525,242,767,1047
3404-001,2014,4,2,22,369,198,567,767
3404-001,2014,4,2,23,203,132,335,567
3404-001,2014,4,2,24,119,108,227,335
3404-001,2014,4,3,1,78,73,151,227
3404-001,2014,4,3,2,59,55,114,151
3404-001,2014,4,3,3,59,63,122,114
3404-001,2014,4,3,4,30,39,69,122
3404-001,2014,4,3,5,35,82,117,69
3404-001,2014,4,3,6,88,153,241,117
3404-001,2014,4,3,7,164,473,637,241
3404-001,2014,4,3,8,411,1438,1849,637
3404-001,2014,4,3,9,614,1231,1845,1849
3404-001,2014,4,3,10,631,658,1289,1845
3404-001,2014,4,3,11,642,646,1288,1289
3404-001,2014,4,3,12,600,595,1195,1288
3404-001,2014,4,3,13,529,501,1030,1195
3404-001,2014,4,3,14,590,579,1169,1030
3404-001,2014,4,3,15,681,643,1324,1169
3404-001,2014,4,3,16,714,636,1350,1324
3404-001,2014,4,3,17,734,522,1256,1350
3404-001,2014,4,3,18,942,518,1460,1256
3404-001,2014,4,3,19,824,407,1231,1460
3404-001,2014,4,3,20,600,355,955,1231
3404-001,2014,4,3,21,574,213,787,955
3404-001,2014,4,3,22,320,226,546,787
3404-001,2014,4,3,23,175,136,311,546
3404-001,2014,4,3,24,118,97,215,311
3404-001,2014,4,4,1,75,73,148,215
3404-001,2014,4,4,2,66,45,111,148
3404-001,2014,4,4,3,43,37,80,111
3404-001,2014,4,4,4,41,54,95,80
3404-001,2014,4,4,5,36,62,98,95
3404-001,2014,4,4,6,100,157,257,98
3404-001,2014,4,4,7,174,476,650,257
3404-001,2014,4,4,8,407,1425,1832,650
3404-001,2014,4,4,9,642,1209,1851,1832
3404-001,2014,4,4,10,595,651,1246,1851
3404-001,2014,4,4,11,613,619,1232,1246
3404-001,2014,4,4,12,590,569,1159,1232
3404-001,2014,4,4,13,585,533,1118,1159
3404-001,2014,4,4,14,575,582,1157,1118
3404-001,2014,4,4,15,681,652,1333,1157
3404-001,2014,4,4,16,754,677,1431,1333
3404-001,2014,4,4,17,748,564,1312,1431
3404-001,2014,4,4,18,1104,540,1644,1312
3404-001,2014,4,4,19,1188,513,1701,1644
3404-001,2014,4,4,20,830,434,1264,1701
3404-001,2014,4,4,21,581,287,868,1264
3404-001,2014,4,4,22,356,217,573,868
3404-001,2014,4,4,23,213,141,354,573
3404-001,2014,4,4,24,131,109,240,354
3404-001,2014,4,5,1,71,66,137,240
3404-001,2014,4,5,2,69,50,119,137
3404-001,2014,4,5,3,51,37,88,119
3404-001,2014,4,5,4,41,45,86,88
3404-001,2014,4,5,5,51,64,115,86
3404-001,2014,4,5,6,107,168,275,115
3404-001,2014,4,5,7,184,309,493,275
3404-001,2014,4,5,8,257,673,930,493
3404-001,2014,4,5,9,466,629,1095,930
3404-001,2014,4,5,10,513,565,1078,1095
3404-001,2014,4,5,11,507,569,1076,1078
3404-001,2014,4,5,12,514,565,1079,1076
3404-001,2014,4,5,13,446,446,892,1079
3404-001,2014,4,5,14,500,486,986,892
3404-001,2014,4,5,15,574,463,1037,986
3404-001,2014,4,5,16,547,470,1017,1037
3404-001,2014,4,5,17,607,439,1046,1017
3404-001,2014,4,5,18,677,407,1084,1046
3404-001,2014,4,5,19,567,377,944,1084
3404-001,2014,4,5,20,318,264,582,944
3404-001,2014,4,5,21,216,183,399,582
3404-001,2014,4,5,22,198,143,341,399
3404-001,2014,4,5,23,112,112,224,341
3404-001,2014,4,5,24,57,86,143,224
3404-001,2014,4,6,1,74,47,121,143
3404-001,2014,4,6,2,32,36,68,121
3404-001,2014,4,6,3,38,21,59,68
3404-001,2014,4,6,4,25,27,52,59
3404-001,2014,4,6,5,34,24,58,52
3404-001,2014,4,6,6,36,59,95,58
3404-001,2014,4,6,7,77,127,204,95
3404-001,2014,4,6,8,147,215,362,204
3404-001,2014,4,6,9,261,236,497,362
3404-001,2014,4,6,10,284,250,534,497
3404-001,2014,4,6,11,305,350,655,534
3404-001,2014,4,6,12,250,333,583,655
3404-001,2014,4,6,13,302,384,686,583
3404-001,2014,4,6,14,326,379,705,686
3404-001,2014,4,6,15,372,330,702,705
3404-001,2014,4,6,16,422,342,764,702
3404-001,2014,4,6,17,510,308,818,764
3404-001,2014,4,6,18,752,291,1043,818
3404-001,2014,4,6,19,553,306,859,1043
3404-001,2014,4,6,20,369,275,644,859
3404-001,2014,4,6,21,261,222,483,644
3404-001,2014,4,6,22,205,241,446,483
3404-001,2014,4,6,23,99,182,281,446
3404-001,2014,4,6,24,64,127,191,281
3404-001,2014,4,7,1,39,72,111,191
3404-001,2014,4,7,2,30,51,81,111
3404-001,2014,4,7,3,19,42,61,81
3404-001,2014,4,7,4,26,40,66,61
3404-001,2014,4,7,5,42,70,112,66
3404-001,2014,4,7,6,72,216,288,112
3404-001,2014,4,7,7,182,556,738,288
3404-001,2014,4,7,8,446,1639,2085,738
3404-001,2014,4,7,9,554,1263,1817,2085
3404-001,2014,4,7,10,573,668,1241,1817
3404-001,2014,4,7,11,591,630,1221,1241
3404-001,2014,4,7,12,604,596,1200,1221
3404-001,2014,4,7,13,508,490,998,1200
3404-001,2014,4,7,14,564,591,1155,998
3404-001,2014,4,7,15,653,678,1331,1155
3404-001,2014,4,7,16,707,612,1319,1331
3404-001,2014,4,7,17,689,529,1218,1319
3404-001,2014,4,7,18,956,491,1447,1218
3404-001,2014,4,7,19,856,434,1290,1447
3404-001,2014,4,7,20,645,374,1019,1290
3404-001,2014,4,7,21,650,255,905,1019
3404-001,2014,4,7,22,386,207,593,905
3404-001,2014,4,7,23,199,132,331,593
3404-001,2014,4,7,24,111,113,224,331
3404-001,2014,4,8,1,82,66,148,224
3404-001,2014,4,8,2,53,56,109,148
3404-001,2014,4,8,3,33,40,73,109
3404-001,2014,4,8,4,37,53,90,73
3404-001,2014,4,8,5,60,77,137,90
3404-001,2014,4,8,6,90,141,231,137
3404-001,2014,4,8,7,199,474,673,231
3404-001,2014,4,8,8,445,1458,1903,673
3404-001,2014,4,8,9,579,1231,1810,1903
3404-001,2014,4,8,10,653,626,1279,1810
3404-001,2014,4,8,11,623,658,1281,1279
3404-001,2014,4,8,12,582,601,1183,1281
3404-001,2014,4,8,13,532,519,1051,1183
3404-001,2014,4,8,14,522,612,1134,1051
3404-001,2014,4,8,15,674,672,1346,1134
3404-001,2014,4,8,16,742,625,1367,1346
3404-001,2014,4,8,17,693,535,1228,1367
3404-001,2014,4,8,18,977,518,1495,1228
3404-001,2014,4,8,19,922,428,1350,1495
3404-001,2014,4,8,20,647,380,1027,1350
3404-001,2014,4,8,21,605,260,865,1027
3404-001,2014,4,8,22,347,177,524,865
3404-001,2014,4,8,23,210,168,378,524
3404-001,2014,4,8,24,128,101,229,378
3404-001,2014,4,9,1,92,84,176,229
3404-001,2014,4,9,2,44,37,81,176
3404-001,2014,4,9,3,43,46,89,81
3404-001,2014,4,9,4,32,47,79,89
3404-001,2014,4,9,5,42,70,112,79
3404-001,2014,4,9,6,92,157,249,112
3404-001,2014,4,9,7,174,464,638,249
3404-001,2014,4,9,8,419,1441,1860,638
3404-001,2014,4,9,9,608,1238,1846,1860
3404-001,2014,4,9,10,581,651,1232,1846
3404-001,2014,4,9,11,633,639,1272,1232
3404-001,2014,4,9,12,631,570,1201,1272
3404-001,2014,4,9,13,488,517,1005,1201
3404-001,2014,4,9,14,570,558,1128,1005
3404-001,2014,4,9,15,673,613,1286,1128
3404-001,2014,4,9,16,691,601,1292,1286
3404-001,2014,4,9,17,655,504,1159,1292
3404-001,2014,4,9,18,1071,479,1550,1159
3404-001,2014,4,9,19,964,452,1416,1550
3404-001,2014,4,9,20,595,376,971,1416
3404-001,2014,4,9,21,509,266,775,971
3404-001,2014,4,9,22,344,183,527,775
3404-001,2014,4,9,23,199,142,341,527
3404-001,2014,4,9,24,119,99,218,341
3404-001,2014,4,10,1,69,78,147,218
3404-001,2014,4,10,2,50,40,90,147
3404-001,2014,4,10,3,57,55,112,90
3404-001,2014,4,10,4,29,50,79,112
3404-001,2014,4,10,5,53,75,128,79
3404-001,2014,4,10,6,101,164,265,128
3404-001,2014,4,10,7,188,510,698,265
3404-001,2014,4,10,8,408,1453,1861,698
3404-001,2014,4,10,9,648,1217,1865,1861
3404-001,2014,4,10,10,610,703,1313,1865
3404-001,2014,4,10,11,677,668,1345,1313
3404-001,2014,4,10,12,610,645,1255,1345
3404-001,2014,4,10,13,529,507,1036,1255
3404-001,2014,4,10,14,581,558,1139,1036
3404-001,2014,4,10,15,688,647,1335,1139
3404-001,2014,4,10,16,677,566,1243,1335
3404-001,2014,4,10,17,696,540,1236,1243
3404-001,2014,4,10,18,992,528,1520,1236
3404-001,2014,4,10,19,913,409,1322,1520
3404-001,2014,4,10,20,732,361,1093,1322
3404-001,2014,4,10,21,531,261,792,1093
3404-001,2014,4,10,22,378,206,584,792
3404-001,2014,4,10,23,205,135,340,584
3404-001,2014,4,10,24,130,101,231,340
3404-001,2014,4,11,1,85,72,157,231
3404-001,2014,4,11,2,49,62,111,157
3404-001,2014,4,11,3,52,47,99,111
3404-001,2014,4,11,4,35,40,75,99
3404-001,2014,4,11,5,50,76,126,75
3404-001,2014,4,11,6,95,162,257,126
3404-001,2014,4,11,7,194,477,671,257
3404-001,2014,4,11,8,431,1441,1872,671
3404-001,2014,4,11,9,623,1271,1894,1872
3404-001,2014,4,11,10,597,650,1247,1894
3404-001,2014,4,11,11,641,624,1265,1247
3404-001,2014,4,11,12,576,594,1170,1265
3404-001,2014,4,11,13,575,477,1052,1170
3404-001,2014,4,11,14,571,523,1094,1052
3404-001,2014,4,11,15,676,671,1347,1094
3404-001,2014,4,11,16,675,643,1318,1347
3404-001,2014,4,11,17,735,492,1227,1318
3404-001,2014,4,11,18,1105,552,1657,1227
3404-001,2014,4,11,19,1198,551,1749,1657
3404-001,2014,4,11,20,812,423,1235,1749
3404-001,2014,4,11,21,538,256,794,1235
3404-001,2014,4,11,22,356,187,543,794
3404-001,2014,4,11,23,225,140,365,543
3404-001,2014,4,11,24,136,122,258,365
3404-001,2014,4,12,1,95,88,183,258
3404-001,2014,4,12,2,53,38,91,183
3404-001,2014,4,12,3,41,44,85,91
3404-001,2014,4,12,4,41,48,89,85
3404-001,2014,4,12,5,40,73,113,89
3404-001,2014,4,12,6,78,163,241,113
3404-001,2014,4,12,7,173,276,449,241
3404-001,2014,4,12,8,282,642,924,449
3404-001,2014,4,12,9,486,675,1161,924
3404-001,2014,4,12,10,488,523,1011,1161
3404-001,2014,4,12,11,501,527,1028,1011
3404-001,2014,4,12,12,505,490,995,1028
3404-001,2014,4,12,13,418,429,847,995
3404-001,2014,4,12,14,442,468,910,847
3404-001,2014,4,12,15,499,449,948,910
3404-001,2014,4,12,16,501,407,908,948
3404-001,2014,4,12,17,585,403,988,908
3404-001,2014,4,12,18,773,398,1171,988
3404-001,2014,4,12,19,531,361,892,1171
3404-001,2014,4,12,20,347,287,634,892
3404-001,2014,4,12,21,271,189,460,634
3404-001,2014,4,12,22,170,159,329,460
3404-001,2014,4,12,23,138,129,267,329
3404-001,2014,4,12,24,73,69,142,267
3404-001,2014,4,13,1,58,54,112,142
3404-001,2014,4,13,2,42,32,74,112
3404-001,2014,4,13,3,36,26,62,74
3404-001,2014,4,13,4,29,24,53,62
3404-001,2014,4,13,5,22,31,53,53
3404-001,2014,4,13,6,51,65,116,53
3404-001,2014,4,13,7,70,137,207,116
3404-001,2014,4,13,8,135,238,373,207
3404-001,2014,4,13,9,218,253,471,373
3404-001,2014,4,13,10,224,292,516,471
3404-001,2014,4,13,11,255,351,606,516
3404-001,2014,4,13,12,268,334,602,606
3404-001,2014,4,13,13,286,345,631,602
3404-001,2014,4,13,14,308,311,619,631
3404-001,2014,4,13,15,380,351,731,619
3404-001,2014,4,13,16,401,320,721,731
3404-001,2014,4,13,17,412,317,729,721
3404-001,2014,4,13,18,580,349,929,729
3404-001,2014,4,13,19,527,296,823,929
3404-001,2014,4,13,20,369,262,631,823
3404-001,2014,4,13,21,247,227,474,631
3404-001,2014,4,13,22,151,215,366,474
3404-001,2014,4,13,23,102,140,242,366
3404-001,2014,4,13,24,56,111,167,242
3404-001,2014,4,14,1,35,74,109,167
3404-001,2014,4,14,2,26,44,70,109
3404-001,2014,4,14,3,18,37,55,70
3404-001,2014,4,14,4,26,48,74,55
3404-001,2014,4,14,5,34,60,94,74
3404-001,2014,4,14,6,89,197,286,94
3404-001,2014,4,14,7,219,568,787,286
3404-001,2014,4,14,8,478,1725,2203,787
3404-001,2014,4,14,9,586,1339,1925,2203
3404-001,2014,4,14,10,528,642,1170,1925
3404-001,2014,4,14,11,652,646,1298,1170
3404-001,2014,4,14,12,576,578,1154,1298
3404-001,2014,4,14,13,530,533,1063,1154
3404-001,2014,4,14,14,568,617,1185,1063
3404-001,2014,4,14,15,597,646,1243,1185
3404-001,2014,4,14,16,665,566,1231,1243
3404-001,2014,4,14,17,665,590,1255,1231
3404-001,2014,4,14,18,964,557,1521,1255
3404-001,2014,4,14,19,932,436,1368,1521
3404-001,2014,4,14,20,670,388,1058,1368
3404-001,2014,4,14,21,644,261,905,1058
3404-001,2014,4,14,22,382,179,561,905
3404-001,2014,4,14,23,213,145,358,561
3404-001,2014,4,14,24,122,102,224,358
3404-001,2014,4,15,1,100,74,174,224
3404-001,2014,4,15,2,63,48,111,174
3404-001,2014,4,15,3,52,44,96,111
3404-001,2014,4,15,4,32,56,88,96
3404-001,2014,4,15,5,57,65,122,88
3404-001,2014,4,15,6,85,155,240,122
3404-001,2014,4,15,7,176,493,669,240
3404-001,2014,4,15,8,439,1498,1937,669
3404-001,2014,4,15,9,632,1258,1890,1937
3404-001,2014,4,15,10,616,702,1318,1890
3404-001,2014,4,15,11,659,651,1310,1318
3404-001,2014,4,15,12,643,615,1258,1310
3404-001,2014,4,15,13,495,513,1008,1258
3404-001,2014,4,15,14,583,577,1160,1008
3404-001,2014,4,15,15,691,635,1326,1160
3404-001,2014,4,15,16,711,595,1306,1326
3404-001,2014,4,15,17,730,569,1299,1306
3404-001,2014,4,15,18,1003,516,1519,1299
3404-001,2014,4,15,19,949,434,1383,1519
3404-001,2014,4,15,20,657,372,1029,1383
3404-001,2014,4,15,21,607,251,858,1029
3404-001,2014,4,15,22,353,208,561,858
3404-001,2014,4,15,23,188,153,341,561
3404-001,2014,4,15,24,113,103,216,341
3404-001,2014,4,16,1,100,60,160,216
3404-001,2014,4,16,2,58,56,114,160
3404-001,2014,4,16,3,51,38,89,114
3404-001,2014,4,16,4,35,50,85,89
3404-001,2014,4,16,5,50,72,122,85
3404-001,2014,4,16,6,105,142,247,122
3404-001,2014,4,16,7,177,460,637,247
3404-001,2014,4,16,8,428,1430,1858,637
3404-001,2014,4,16,9,632,1298,1930,1858
3404-001,2014,4,16,10,608,651,1259,1930
3404-001,2014,4,16,11,590,659,1249,1259
3404-001,2014,4,16,12,642,643,1285,1249
3404-001,2014,4,16,13,552,507,1059,1285
3404-001,2014,4,16,14,608,563,1171,1059
3404-001,2014,4,16,15,623,640,1263,1171
3404-001,2014,4,16,16,691,630,1321,1263
3404-001,2014,4,16,17,732,546,1278,1321
3404-001,2014,4,16,18,1043,564,1607,1278
3404-001,2014,4,16,19,992,441,1433,1607
3404-001,2014,4,16,20,628,395,1023,1433
3404-001,2014,4,16,21,529,247,776,1023
3404-001,2014,4,16,22,373,207,580,776
3404-001,2014,4,16,23,200,158,358,580
3404-001,2014,4,16,24,132,102,234,358
3404-001,2014,4,17,1,88,69,157,234
3404-001,2014,4,17,2,64,42,106,157
3404-001,2014,4,17,3,49,49,98,106
3404-001,2014,4,17,4,36,47,83,98
3404-001,2014,4,17,5,47,68,115,83
3404-001,2014,4,17,6,83,165,248,115
3404-001,2014,4,17,7,197,478,675,248
3404-001,2014,4,17,8,429,1459,1888,675
3404-001,2014,4,17,9,643,1245,1888,1888
3404-001,2014,4,17,10,574,686,1260,1888
3404-001,2014,4,17,11,667,655,1322,1260
3404-001,2014,4,17,12,624,629,1253,1322
3404-001,2014,4,17,13,507,518,1025,1253
3404-001,2014,4,17,14,605,590,1195,1025
3404-001,2014,4,17,15,711,661,1372,1195
3404-001,2014,4,17,16,661,590,1251,1372
3404-001,2014,4,17,17,726,493,1219,1251
3404-001,2014,4,17,18,960,510,1470,1219
3404-001,2014,4,17,19,907,399,1306,1470
3404-001,2014,4,17,20,634,348,982,1306
3404-001,2014,4,17,21,547,249,796,982
3404-001,2014,4,17,22,297,202,499,796
3404-001,2014,4,17,23,188,142,330,499
3404-001,2014,4,17,24,109,81,190,330
3404-001,2014,4,18,1,68,61,129,190
3404-001,2014,4,18,2,62,50,112,129
3404-001,2014,4,18,3,49,38,87,112
3404-001,2014,4,18,4,34,40,74,87
3404-001,2014,4,18,5,54,84,138,74
3404-001,2014,4,18,6,102,166,268,138
3404-001,2014,4,18,7,191,516,707,268
3404-001,2014,4,18,8,445,1508,1953,707
3404-001,2014,4,18,9,642,1184,1826,1953
3404-001,2014,4,18,10,625,635,1260,1826
3404-001,2014,4,18,11,634,650,1284,1260
3404-001,2014,4,18,12,600,643,1243,1284
3404-001,2014,4,18,13,527,498,1025,1243
3404-001,2014,4,18,14,606,597,1203,1025
3404-001,2014,4,18,15,648,612,1260,1203
3404-001,2014,4,18,16,695,625,1320,1260
3404-001,2014,4,18,17,734,562,1296,1320
3404-001,2014,4,18,18,1177,545,1722,1296
3404-001,2014,4,18,19,1099,488,1587,1722
3404-001,2014,4,18,20,792,453,1245,1587
3404-001,2014,4,18,21,581,274,855,1245
3404-001,2014,4,18,22,324,214,538,855
3404-001,2014,4,18,23,230,154,384,538
3404-001,2014,4,18,24,88,97,185,384
3404-001,2014,4,19,1,69,67,136,185
3404-001,2014,4,19,2,61,52,113,136
3404-001,2014,4,19,3,47,50,97,113
3404-001,2014,4,19,4,38,47,85,97
3404-001,2014,4,19,5,55,67,122,85
3404-001,2014,4,19,6,83,172,255,122
3404-001,2014,4,19,7,169,351,520,255
3404-001,2014,4,19,8,345,706,1051,520
3404-001,2014,4,19,9,508,636,1144,1051
3404-001,2014,4,19,10,489,530,1019,1144
3404-001,2014,4,19,11,511,542,1053,1019
3404-001,2014,4,19,12,448,513,961,1053
3404-001,2014,4,19,13,466,414,880,961
3404-001,2014,4,19,14,512,456,968,880
3404-001,2014,4,19,15,438,442,880,968
3404-001,2014,4,19,16,524,396,920,880
3404-001,2014,4,19,17,551,373,924,920
3404-001,2014,4,19,18,736,452,1188,924
3404-001,2014,4,19,19,536,383,919,1188
3404-001,2014,4,19,20,326,271,597,919
3404-001,2014,4,19,21,278,214,492,597
3404-001,2014,4,19,22,182,173,355,492
3404-001,2014,4,19,23,129,118,247,355
3404-001,2014,4,19,24,70,63,133,247
3404-001,2014,4,20,1,53,58,111,133
3404-001,2014,4,20,2,42,32,74,111
3404-001,2014,4,20,3,34,21,55,74
3404-001,2014,4,20,4,21,27,48,55
3404-001,2014,4,20,5,26,32,58,48
3404-001,2014,4,20,6,49,74,123,58
3404-001,2014,4,20,7,76,145,221,123
3404-001,2014,4,20,8,241,274,515,221
3404-001,2014,4,20,9,281,272,553,515
3404-001,2014,4,20,10,235,281,516,553
3404-001,2014,4,20,11,241,343,584,516
3404-001,2014,4,20,12,244,371,615,584
3404-001,2014,4,20,13,320,306,626,615
3404-001,2014,4,20,14,287,322,609,626
3404-001,2014,4,20,15,366,349,715,609
3404-001,2014,4,20,16,411,337,748,715
3404-001,2014,4,20,17,477,287,764,748
3404-001,2014,4,20,18,471,265,736,764
3404-001,2014,4,20,19,426,250,676,736
3404-001,2014,4,20,20,265,249,514,676
3404-001,2014,4,20,21,230,194,424,514
3404-001,2014,4,20,22,141,197,338,424
3404-001,2014,4,20,23,113,161,274,338
3404-001,2014,4,20,24,47,89,136,274
3404-001,2014,4,21,1,40,68,108,136
3404-001,2014,4,21,2,26,55,81,108
3404-001,2014,4,21,3,28,46,74,81
3404-001,2014,4,21,4,21,48,69,74
3404-001,2014,4,21,5,45,65,110,69
3404-001,2014,4,21,6,86,200,286,110
3404-001,2014,4,21,7,230,630,860,286
3404-001,2014,4,21,8,490,1723,2213,860
3404-001,2014,4,21,9,547,1221,1768,2213
3404-001,2014,4,21,10,578,701,1279,1768
3404-001,2014,4,21,11,595,691,1286,1279
3404-001,2014,4,21,12,617,599,1216,1286
3404-001,2014,4,21,13,495,533,1028,1216
3404-001,2014,4,21,14,603,607,1210,1028
3404-001,2014,4,21,15,671,650,1321,1210
3404-001,2014,4,21,16,697,638,1335,1321
3404-001,2014,4,21,17,670,566,1236,1335
3404-001,2014,4,21,18,920,534,1454,1236
3404-001,2014,4,21,19,851,426,1277,1454
3404-001,2014,4,21,20,702,369,1071,1277
3404-001,2014,4,21,21,620,251,871,1071
3404-001,2014,4,21,22,375,200,575,871
3404-001,2014,4,21,23,201,116,317,575
3404-001,2014,4,21,24,119,92,211,317
3404-001,2014,4,22,1,83,76,159,211
3404-001,2014,4,22,2,52,56,108,159
3404-001,2014,4,22,3,43,50,93,108
3404-001,2014,4,22,4,42,49,91,93
3404-001,2014,4,22,5,55,81,136,91
3404-001,2014,4,22,6,103,189,292,136
3404-001,2014,4,22,7,192,534,726,292
3404-001,2014,4,22,8,436,1658,2094,726
3404-001,2014,4,22,9,675,1135,1810,2094
3404-001,2014,4,22,10,628,690,1318,1810
3404-001,2014,4,22,11,679,635,1314,1318
3404-001,2014,4,22,12,651,614,1265,1314
3404-001,2014,4,22,13,541,539,1080,1265
3404-001,2014,4,22,14,622,596,1218,1080
3404-001,2014,4,22,15,710,639,1349,1218
3404-001,2014,4,22,16,732,630,1362,1349
3404-001,2014,4,22,17,701,518,1219,1362
3404-001,2014,4,22,18,946,542,1488,1219
3404-001,2014,4,22,19,930,428,1358,1488
3404-001,2014,4,22,20,654,371,1025,1358
3404-001,2014,4,22,21,608,270,878,1025
3404-001,2014,4,22,22,376,219,595,878
3404-001,2014,4,22,23,207,146,353,595
3404-001,2014,4,22,24,120,118,238,353
3404-001,2014,4,23,1,100,83,183,238
3404-001,2014,4,23,2,57,52,109,183
3404-001,2014,4,23,3,48,55,103,109
3404-001,2014,4,23,4,41,39,80,103
3404-001,2014,4,23,5,44,56,100,80
3404-001,2014,4,23,6,98,178,276,100
3404-001,2014,4,23,7,206,552,758,276
3404-001,2014,4,23,8,460,1535,1995,758
3404-001,2014,4,23,9,644,1139,1783,1995
3404-001,2014,4,23,10,603,702,1305,1783
3404-001,2014,4,23,11,606,665,1271,1305
3404-001,2014,4,23,12,625,615,1240,1271
3404-001,2014,4,23,13,508,494,1002,1240
3404-001,2014,4,23,14,551,584,1135,1002
3404-001,2014,4,23,15,687,681,1368,1135
3404-001,2014,4,23,16,709,584,1293,1368
3404-001,2014,4,23,17,694,545,1239,1293
3404-001,2014,4,23,18,1011,477,1488,1239
3404-001,2014,4,23,19,976,439,1415,1488
3404-001,2014,4,23,20,692,374,1066,1415
3404-001,2014,4,23,21,524,230,754,1066
3404-001,2014,4,23,22,348,219,567,754
3404-001,2014,4,23,23,189,134,323,567
3404-001,2014,4,23,24,132,91,223,323
3404-001,2014,4,24,1,71,88,159,223
3404-001,2014,4,24,2,74,49,123,159
3404-001,2014,4,24,3,43,40,83,123
3404-001,2014,4,24,4,45,51,96,83
3404-001,2014,4,24,5,49,77,126,96
3404-001,2014,4,24,6,82,211,293,126
3404-001,2014,4,24,7,212,521,733,293
3404-001,2014,4,24,8,428,1574,2002,733
3404-001,2014,4,24,9,649,1184,1833,2002
3404-001,2014,4,24,10,597,725,1322,1833
3404-001,2014,4,24,11,688,654,1342,1322
3404-001,2014,4,24,12,586,651,1237,1342
3404-001,2014,4,24,13,535,518,1053,1237
3404-001,2014,4,24,14,593,553,1146,1053
3404-001,2014,4,24,15,716,695,1411,1146
3404-001,2014,4,24,16,713,656,1369,1411
3404-001,2014,4,24,17,732,522,1254,1369
3404-001,2014,4,24,18,979,508,1487,1254
3404-001,2014,4,24,19,930,444,1374,1487
3404-001,2014,4,24,20,680,382,1062,1374
3404-001,2014,4,24,21,581,254,835,1062
3404-001,2014,4,24,22,373,192,565,835
3404-001,2014,4,24,23,216,149,365,565
3404-001,2014,4,24,24,99,113,212,365
3404-001,2014,4,25,1,85,86,171,212
3404-001,2014,4,25,2,58,48,106,171
3404-001,2014,4,25,3,52,51,103,106
3404-001,2014,4,25,4,29,49,78,103
3404-001,2014,4,25,5,46,77,123,78
3404-001,2014,4,25,6,95,159,254,123
3404-001,2014,4,25,7,220,559,779,254
3404-001,2014,4,25,8,435,1560,1995,779
3404-001,2014,4,25,9,662,1123,1785,1995
3404-001,2014,4,25,10,591,670,1261,1785
3404-001,2014,4,25,11,673,670,1343,1261
3404-001,2014,4,25,12,617,651,1268,1343
3404-001,2014,4,25,13,546,519,1065,1268
3404-001,2014,4,25,14,653,555,1208,1065
3404-001,2014,4,25,15,704,645,1349,1208
3404-001,2014,4,25,16,687,630,1317,1349
3404-001,2014,4,25,17,750,574,1324,1317
3404-001,2014,4,25,18,1153,489,1642,1324
3404-001,2014,4,25,19,1056,466,1522,1642
3404-001,2014,4,25,20,775,449,1224,1522
3404-001,2014,4,25,21,601,276,877,1224
3404-001,2014,4,25,22,351,214,565,877
3404-001,2014,4,25,23,232,152,384,565
3404-001,2014,4,25,24,123,120,243,384
3404-001,2014,4,26,1,86,89,175,243
3404-001,2014,4,26,2,89,56,145,175
3404-001,2014,4,26,3,46,53,99,145
3404-001,2014,4,26,4,36,56,92,99
3404-001,2014,4,26,5,61,82,143,92
3404-001,2014,4,26,6,104,198,302,143
3404-001,2014,4,26,7,181,370,551,302
3404-001,2014,4,26,8,333,715,1048,551
3404-001,2014,4,26,9,515,645,1160,1048
3404-001,2014,4,26,10,464,546,1010,1160
3404-001,2014,4,26,11,487,530,1017,1010
3404-001,2014,4,26,12,468,504,972,1017
3404-001,2014,4,26,13,445,392,837,972
3404-001,2014,4,26,14,525,484,1009,837
3404-001,2014,4,26,15,511,471,982,1009
3404-001,2014,4,26,16,527,434,961,982
3404-001,2014,4,26,17,575,412,987,961
3404-001,2014,4,26,18,838,387,1225,987
3404-001,2014,4,26,19,557,381,938,1225
3404-001,2014,4,26,20,319,276,595,938
3404-001,2014,4,26,21,276,216,492,595
3404-001,2014,4,26,22,177,150,327,492
3404-001,2014,4,26,23,130,124,254,327
3404-001,2014,4,26,24,76,68,144,254
3404-001,2014,4,27,1,62,61,123,144
3404-001,2014,4,27,2,50,30,80,123
3404-001,2014,4,27,3,37,20,57,80
3404-001,2014,4,27,4,40,22,62,57
3404-001,2014,4,27,5,21,24,45,62
3404-001,2014,4,27,6,48,42,90,45
3404-001,2014,4,27,7,63,114,177,90
3404-001,2014,4,27,8,131,212,343,177
3404-001,2014,4,27,9,190,201,391,343
3404-001,2014,4,27,10,209,243,452,391
3404-001,2014,4,27,11,220,266,486,452
3404-001,2014,4,27,12,271,275,546,486
3404-001,2014,4,27,13,232,286,518,546
3404-001,2014,4,27,14,319,266,585,518
3404-001,2014,4,27,15,352,252,604,585
3404-001,2014,4,27,16,370,308,678,604
3404-001,2014,4,27,17,371,261,632,678
3404-001,2014,4,27,18,408,252,660,632
3404-001,2014,4,27,19,322,244,566,660
3404-001,2014,4,27,20,212,189,401,566
3404-001,2014,4,27,21,195,190,385,401
3404-001,2014,4,27,22,136,193,329,385
3404-001,2014,4,27,23,86,128,214,329
3404-001,2014,4,27,24,63,90,153,214
3404-001,2014,4,28,1,37,69,106,153
3404-001,2014,4,28,2,25,55,80,106
3404-001,2014,4,28,3,18,41,59,80
3404-001,2014,4,28,4,23,39,62,59
3404-001,2014,4,28,5,35,50,85,62
3404-001,2014,4,28,6,91,170,261,85
3404-001,2014,4,28,7,197,522,719,261
3404-001,2014,4,28,8,435,1691,2126,719
3404-001,2014,4,28,9,521,1259,1780,2126
3404-001,2014,4,28,10,541,603,1144,1780
3404-001,2014,4,28,11,502,604,1106,1144
3404-001,2014,4,28,12,566,562,1128,1106
3404-001,2014,4,28,13,509,501,1010,1128
3404-001,2014,4,28,14,590,570,1160,1010
3404-001,2014,4,28,15,634,610,1244,1160
3404-001,2014,4,28,16,661,563,1224,1244
3404-001,2014,4,28,17,646,503,1149,1224
3404-001,2014,4,28,18,855,431,1286,1149
3404-001,2014,4,28,19,791,391,1182,1286
3404-001,2014,4,28,20,621,331,952,1182
3404-001,2014,4,28,21,588,246,834,952
3404-001,2014,4,28,22,380,196,576,834
3404-001,2014,4,28,23,178,125,303,576
3404-001,2014,4,28,24,134,82,216,303
3404-001,2014,4,29,1,80,58,138,216
3404-001,2014,4,29,2,56,46,102,138
3404-001,2014,4,29,3,40,48,88,102
3404-001,2014,4,29,4,36,51,87,88
3404-001,2014,4,29,5,40,58,98,87
3404-001,2014,4,29,6,97,160,257,98
3404-001,2014,4,29,7,173,447,620,257
3404-001,2014,4,29,8,404,1463,1867,620
3404-001,2014,4,29,9,609,1134,1743,1867
3404-001,2014,4,29,10,615,699,1314,1743
3404-001,2014,4,29,11,628,653,1281,1314
3404-001,2014,4,29,12,621,571,1192,1281
3404-001,2014,4,29,13,535,505,1040,1192
3404-001,2014,4,29,14,579,659,1238,1040
3404-001,2014,4,29,15,714,672,1386,1238
3404-001,2014,4,29,16,726,607,1333,1386
3404-001,2014,4,29,17,648,549,1197,1333
3404-001,2014,4,29,18,904,456,1360,1197
3404-001,2014,4,29,19,841,365,1206,1360
3404-001,2014,4,29,20,674,398,1072,1206
3404-001,2014,4,29,21,665,242,907,1072
3404-001,2014,4,29,22,334,181,515,907
3404-001,2014,4,29,23,176,111,287,515
3404-001,2014,4,29,24,124,112,236,287
3404-001,2014,4,30,1,64,68,132,236
3404-001,2014,4,30,2,59,54,113,132
3404-001,2014,4,30,3,52,57,109,113
3404-001,2014,4,30,4,33,58,91,109
3404-001,2014,4,30,5,61,63,124,91
3404-001,2014,4,30,6,94,209,303,124
3404-001,2014,4,30,7,217,527,744,303
3404-001,2014,4,30,8,440,1555,1995,744
3404-001,2014,4,30,9,648,1201,1849,1995
3404-001,2014,4,30,10,590,707,1297,1849
3404-001,2014,4,30,11,618,656,1274,1297
3404-001,2014,4,30,12,609,653,1262,1274
3404-001,2014,4,30,13,504,549,1053,1262
3404-001,2014,4,30,14,631,597,1228,1053
3404-001,2014,4,30,15,647,660,1307,1228
3404-001,2014,4,30,16,705,613,1318,1307
3404-001,2014,4,30,17,748,555,1303,1318
3404-001,2014,4,30,18,1173,503,1676,1303
3404-001,2014,4,30,19,1064,474,1538,1676
3404-001,2014,4,30,20,719,385,1104,1538
3404-001,2014,4,30,21,580,270,850,1104
3404-001,2014,4,30,22,357,214,571,850
3404-001,2014,4,30,23,180,146,326,571
3404-001,2014,4,30,24,107,82,189,326
3404-001,2014,5,1,1,71,66,137,189
3404-001,2014,5,1,2,85,63,148,137
3404-001,2014,5,1,3,50,36,86,148
3404-001,2014,5,1,4,55,51,106,86
3404-001,2014,5,1,5,64,54,118,106
3404-001,2014,5,1,6,104,133,237,118
3404-001,2014,5,1,7,180,360,540,237
3404-001,2014,5,1,8,322,794,1116,540
3404-001,2014,5,1,9,468,756,1224,1116
3404-001,2014,5,1,10,473,532,1005,1224
3404-001,2014,5,1,11,478,535,1013,1005
3404-001,2014,5,1,12,430,506,936,1013
3404-001,2014,5,1,13,370,400,770,936
3404-001,2014,5,1,14,419,461,880,770
3404-001,2014,5,1,15,524,466,990,880
3404-001,2014,5,1,16,468,452,920,990
3404-001,2014,5,1,17,524,362,886,920
3404-001,2014,5,1,18,733,357,1090,886
3404-001,2014,5,1,19,577,304,881,1090
3404-001,2014,5,1,20,355,259,614,881
3404-001,2014,5,1,21,306,215,521,614
3404-001,2014,5,1,22,216,157,373,521
3404-001,2014,5,1,23,106,103,209,373
3404-001,2014,5,1,24,88,80,168,209
3404-001,2014,5,2,1,45,70,115,168
3404-001,2014,5,2,2,41,53,94,115
3404-001,2014,5,2,3,32,34,66,94
3404-001,2014,5,2,4,41,45,86,66
3404-001,2014,5,2,5,43,64,107,86
3404-001,2014,5,2,6,92,207,299,107
3404-001,2014,5,2,7,197,493,690,299
3404-001,2014,5,2,8,405,1279,1684,690
3404-001,2014,5,2,9,560,1001,1561,1684
3404-001,2014,5,2,10,530,591,1121,1561
3404-001,2014,5,2,11,575,580,1155,1121
3404-001,2014,5,2,12,585,579,1164,1155
3404-001,2014,5,2,13,465,482,947,1164
3404-001,2014,5,2,14,572,553,1125,947
3404-001,2014,5,2,15,602,643,1245,1125
3404-001,2014,5,2,16,717,606,1323,1245
3404-001,2014,5,2,17,750,505,1255,1323
3404-001,2014,5,2,18,995,506,1501,1255
3404-001,2014,5,2,19,960,404,1364,1501
3404-001,2014,5,2,20,578,362,940,1364
3404-001,2014,5,2,21,442,259,701,940
3404-001,2014,5,2,22,262,174,436,701
3404-001,2014,5,2,23,175,161,336,436
3404-001,2014,5,2,24,74,97,171,336
3404-001,2014,5,3,1,62,66,128,171
3404-001,2014,5,3,2,54,47,101,128
3404-001,2014,5,3,3,27,39,66,101
3404-001,2014,5,3,4,38,50,88,66
3404-001,2014,5,3,5,55,61,116,88
3404-001,2014,5,3,6,99,174,273,116
3404-001,2014,5,3,7,187,368,555,273
3404-001,2014,5,3,8,309,670,979,555
3404-001,2014,5,3,9,464,612,1076,979
3404-001,2014,5,3,10,472,566,1038,1076
3404-001,2014,5,3,11,448,563,1011,1038
3404-001,2014,5,3,12,407,547,954,1011
3404-001,2014,5,3,13,390,435,825,954
3404-001,2014,5,3,14,462,492,954,825
3404-001,2014,5,3,15,477,519,996,954
3404-001,2014,5,3,16,509,453,962,996
3404-001,2014,5,3,17,526,422,948,962
3404-001,2014,5,3,18,730,405,1135,948
3404-001,2014,5,3,19,527,387,914,1135
3404-001,2014,5,3,20,427,366,793,914
3404-001,2014,5,3,21,273,221,494,793
3404-001,2014,5,3,22,236,184,420,494
3404-001,2014,5,3,23,134,112,246,420
3404-001,2014,5,3,24,95,73,168,246
3404-001,2014,5,4,1,49,53,102,168
3404-001,2014,5,4,2,55,35,90,102
3404-001,2014,5,4,3,23,30,53,90
3404-001,2014,5,4,4,26,15,41,53
3404-001,2014,5,4,5,54,22,76,41
3404-001,2014,5,4,6,54,73,127,76
3404-001,2014,5,4,7,71,182,253,127
3404-001,2014,5,4,8,166,266,432,253
3404-001,2014,5,4,9,214,275,489,432
3404-001,2014,5,4,10,205,330,535,489
3404-001,2014,5,4,11,253,372,625,535
3404-001,2014,5,4,12,275,386,661,625
3404-001,2014,5,4,13,298,362,660,661
3404-001,2014,5,4,14,298,345,643,660
3404-001,2014,5,4,15,326,346,672,643
3404-001,2014,5,4,16,436,338,774,672
3404-001,2014,5,4,17,474,313,787,774
3404-001,2014,5,4,18,493,281,774,787
3404-001,2014,5,4,19,434,309,743,774
3404-001,2014,5,4,20,326,227,553,743
3404-001,2014,5,4,21,228,196,424,553
3404-001,2014,5,4,22,186,134,320,424
3404-001,2014,5,4,23,168,101,269,320
3404-001,2014,5,4,24,54,84,138,269
3404-001,2014,5,5,1,43,49,92,138
3404-001,2014,5,5,2,20,35,55,92
3404-001,2014,5,5,3,18,17,35,55
3404-001,2014,5,5,4,16,28,44,35
3404-001,2014,5,5,5,40,46,86,44
3404-001,2014,5,5,6,58,132,190,86
3404-001,2014,5,5,7,134,260,394,190
3404-001,2014,5,5,8,162,385,547,394
3404-001,2014,5,5,9,215,372,587,547
3404-001,2014,5,5,10,265,394,659,587
3404-001,2014,5,5,11,316,516,832,659
3404-001,2014,5,5,12,385,515,900,832
3404-001,2014,5,5,13,321,436,757,900
3404-001,2014,5,5,14,401,375,776,757
3404-001,2014,5,5,15,461,346,807,776
3404-001,2014,5,5,16,577,315,892,807
3404-001,2014,5,5,17,749,306,1055,892
3404-001,2014,5,5,18,822,285,1107,1055
3404-001,2014,5,5,19,765,292,1057,1107
3404-001,2014,5,5,20,575,276,851,1057
3404-001,2014,5,5,21,395,227,622,851
3404-001,2014,5,5,22,323,208,531,622
3404-001,2014,5,5,23,161,133,294,531
3404-001,2014,5,5,24,216,134,350,294
3404-001,2014,5,6,1,130,140,270,350
3404-001,2014,5,6,2,109,59,168,270
3404-001,2014,5,6,3,22,54,76,168
3404-001,2014,5,6,4,35,44,79,76
3404-001,2014,5,6,5,31,47,78,79
3404-001,2014,5,6,6,69,165,234,78
3404-001,2014,5,6,7,118,254,372,234
3404-001,2014,5,6,8,218,465,683,372
3404-001,2014,5,6,9,263,431,694,683
3404-001,2014,5,6,10,286,338,624,694
3404-001,2014,5,6,11,289,408,697,624
3404-001,2014,5,6,12,333,416,749,697
3404-001,2014,5,6,13,337,326,663,749
3404-001,2014,5,6,14,453,347,800,663
3404-001,2014,5,6,15,360,378,738,800
3404-001,2014,5,6,16,471,316,787,738
3404-001,2014,5,6,17,439,323,762,787
3404-001,2014,5,6,18,585,309,894,762
3404-001,2014,5,6,19,433,316,749,894
3404-001,2014,5,6,20,280,261,541,749
3404-001,2014,5,6,21,242,198,440,541
3404-001,2014,5,6,22,158,213,371,440
3404-001,2014,5,6,23,98,138,236,371
3404-001,2014,5,6,24,57,102,159,236
3404-001,2014,5,7,1,33,84,117,159
3404-001,2014,5,7,2,22,33,55,117
3404-001,2014,5,7,3,22,32,54,55
3404-001,2014,5,7,4,20,41,61,54
3404-001,2014,5,7,5,42,59,101,61
3404-001,2014,5,7,6,87,196,283,101
3404-001,2014,5,7,7,213,600,813,283
3404-001,2014,5,7,8,445,1773,2218,813
3404-001,2014,5,7,9,586,1215,1801,2218
3404-001,2014,5,7,10,485,610,1095,1801
3404-001,2014,5,7,11,553,643,1196,1095
3404-001,2014,5,7,12,552,655,1207,1196
3404-001,2014,5,7,13,429,520,949,1207
3404-001,2014,5,7,14,504,598,1102,949
3404-001,2014,5,7,15,578,663,1241,1102
3404-001,2014,5,7,16,603,630,1233,1241
3404-001,2014,5,7,17,652,573,1225,1233
3404-001,2014,5,7,18,970,544,1514,1225
3404-001,2014,5,7,19,969,440,1409,1514
3404-001,2014,5,7,20,658,383,1041,1409
3404-001,2014,5,7,21,560,242,802,1041
3404-001,2014,5,7,22,399,207,606,802
3404-001,2014,5,7,23,233,151,384,606
3404-001,2014,5,7,24,126,109,235,384
3404-001,2014,5,8,1,83,77,160,235
3404-001,2014,5,8,2,42,35,77,160
3404-001,2014,5,8,3,36,53,89,77
3404-001,2014,5,8,4,45,51,96,89
3404-001,2014,5,8,5,53,66,119,96
3404-001,2014,5,8,6,97,154,251,119
3404-001,2014,5,8,7,175,479,654,251
3404-001,2014,5,8,8,461,1570,2031,654
3404-001,2014,5,8,9,646,1258,1904,2031
3404-001,2014,5,8,10,574,736,1310,1904
3404-001,2014,5,8,11,617,740,1357,1310
3404-001,2014,5,8,12,586,666,1252,1357
3404-001,2014,5,8,13,518,549,1067,1252
3404-001,2014,5,8,14,604,601,1205,1067
3404-001,2014,5,8,15,584,672,1256,1205
3404-001,2014,5,8,16,614,606,1220,1256
3404-001,2014,5,8,17,615,636,1251,1220
3404-001,2014,5,8,18,938,522,1460,1251
3404-001,2014,5,8,19,877,460,1337,1460
3404-001,2014,5,8,20,667,435,1102,1337
3404-001,2014,5,8,21,642,264,906,1102
3404-001,2014,5,8,22,414,214,628,906
3404-001,2014,5,8,23,235,149,384,628
3404-001,2014,5,8,24,121,104,225,384
3404-001,2014,5,9,1,96,73,169,225
3404-001,2014,5,9,2,55,57,112,169
3404-001,2014,5,9,3,41,39,80,112
3404-001,2014,5,9,4,39,47,86,80
3404-001,2014,5,9,5,44,68,112,86
3404-001,2014,5,9,6,112,200,312,112
3404-001,2014,5,9,7,222,512,734,312
3404-001,2014,5,9,8,401,1577,1978,734
3404-001,2014,5,9,9,567,1265,1832,1978
3404-001,2014,5,9,10,512,680,1192,1832
3404-001,2014,5,9,11,529,688,1217,1192
3404-001,2014,5,9,12,561,595,1156,1217
3404-001,2014,5,9,13,436,545,981,1156
3404-001,2014,5,9,14,506,569,1075,981
3404-001,2014,5,9,15,606,665,1271,1075
3404-001,2014,5,9,16,631,633,1264,1271
3404-001,2014,5,9,17,719,571,1290,1264
3404-001,2014,5,9,18,1121,532,1653,1290
3404-001,2014,5,9,19,1039,532,1571,1653
3404-001,2014,5,9,20,854,450,1304,1571
3404-001,2014,5,9,21,615,294,909,1304
3404-001,2014,5,9,22,368,207,575,909
3404-001,2014,5,9,23,213,157,370,575
3404-001,2014,5,9,24,107,114,221,370
3404-001,2014,5,10,1,80,73,153,221
3404-001,2014,5,10,2,68,51,119,153
3404-001,2014,5,10,3,41,37,78,119
3404-001,2014,5,10,4,52,51,103,78
3404-001,2014,5,10,5,45,67,112,103
3404-001,2014,5,10,6,99,197,296,112
3404-001,2014,5,10,7,181,360,541,296
3404-001,2014,5,10,8,331,773,1104,541
3404-001,2014,5,10,9,428,682,1110,1104
3404-001,2014,5,10,10,475,544,1019,1110
3404-001,2014,5,10,11,446,579,1025,1019
3404-001,2014,5,10,12,454,513,967,1025
3404-001,2014,5,10,13,388,467,855,967
3404-001,2014,5,10,14,441,486,927,855
3404-001,2014,5,10,15,487,474,961,927
3404-001,2014,5,10,16,475,395,870,961
3404-001,2014,5,10,17,547,386,933,870
3404-001,2014,5,10,18,763,434,1197,933
3404-001,2014,5,10,19,548,355,903,1197
3404-001,2014,5,10,20,355,320,675,903
3404-001,2014,5,10,21,290,208,498,675
3404-001,2014,5,10,22,212,180,392,498
3404-001,2014,5,10,23,142,113,255,392
3404-001,2014,5,10,24,80,79,159,255
3404-001,2014,5,11,1,63,61,124,159
3404-001,2014,5,11,2,41,38,79,124
3404-001,2014,5,11,3,37,21,58,79
3404-001,2014,5,11,4,19,22,41,58
3404-001,2014,5,11,5,42,28,70,41
3404-001,2014,5,11,6,50,78,128,70
3404-001,2014,5,11,7,102,189,291,128
3404-001,2014,5,11,8,162,274,436,291
3404-001,2014,5,11,9,183,262,445,436
3404-001,2014,5,11,10,191,261,452,445
3404-001,2014,5,11,11,242,300,542,452
3404-001,2014,5,11,12,239,307,546,542
3404-001,2014,5,11,13,255,276,531,546
3404-001,2014,5,11,14,287,284,571,531
3404-001,2014,5,11,15,333,274,607,571
3404-001,2014,5,11,16,402,275,677,607
3404-001,2014,5,11,17,400,282,682,677
3404-001,2014,5,11,18,467,278,745,682
3404-001,2014,5,11,19,316,266,582,745
3404-001,2014,5,11,20,236,208,444,582
3404-001,2014,5,11,21,187,195,382,444
3404-001,2014,5,11,22,128,167,295,382
3404-001,2014,5,11,23,80,138,218,295
3404-001,2014,5,11,24,50,85,135,218
3404-001,2014,5,12,1,35,81,116,135
3404-001,2014,5,12,2,28,38,66,116
3404-001,2014,5,12,3,21,26,47,66
3404-001,2014,5,12,4,19,31,50,47
3404-001,2014,5,12,5,39,61,100,50
3404-001,2014,5,12,6,88,156,244,100
3404-001,2014,5,12,7,181,541,722,244
3404-001,2014,5,12,8,444,1725,2169,722
3404-001,2014,5,12,9,570,1275,1845,2169
3404-001,2014,5,12,10,534,659,1193,1845
3404-001,2014,5,12,11,537,641,1178,1193
3404-001,2014,5,12,12,495,632,1127,1178
3404-001,2014,5,12,13,445,580,1025,1127
3404-001,2014,5,12,14,483,636,1119,1025
3404-001,2014,5,12,15,564,670,1234,1119
3404-001,2014,5,12,16,581,678,1259,1234
3404-001,2014,5,12,17,614,562,1176,1259
3404-001,2014,5,12,18,833,490,1323,1176
3404-001,2014,5,12,19,819,441,1260,1323
3404-001,2014,5,12,20,659,398,1057,1260
3404-001,2014,5,12,21,594,277,871,1057
3404-001,2014,5,12,22,373,233,606,871
3404-001,2014,5,12,23,219,154,373,606
3404-001,2014,5,12,24,144,136,280,373
3404-001,2014,5,13,1,92,72,164,280
3404-001,2014,5,13,2,66,47,113,164
3404-001,2014,5,13,3,44,47,91,113
3404-001,2014,5,13,4,51,51,102,91
3404-001,2014,5,13,5,60,57,117,102
3404-001,2014,5,13,6,99,187,286,117
3404-001,2014,5,13,7,180,563,743,286
3404-001,2014,5,13,8,460,1597,2057,743
3404-001,2014,5,13,9,633,1236,1869,2057
3404-001,2014,5,13,10,594,680,1274,1869
3404-001,2014,5,13,11,607,673,1280,1274
3404-001,2014,5,13,12,591,595,1186,1280
3404-001,2014,5,13,13,526,502,1028,1186
3404-001,2014,5,13,14,603,601,1204,1028
3404-001,2014,5,13,15,714,673,1387,1204
3404-001,2014,5,13,16,730,641,1371,1387
3404-001,2014,5,13,17,724,543,1267,1371
3404-001,2014,5,13,18,962,537,1499,1267
3404-001,2014,5,13,19,918,467,1385,1499
3404-001,2014,5,13,20,688,406,1094,1385
3404-001,2014,5,13,21,621,247,868,1094
3404-001,2014,5,13,22,418,217,635,868
3404-001,2014,5,13,23,252,130,382,635
3404-001,2014,5,13,24,144,109,253,382
3404-001,2014,5,14,1,89,68,157,253
3404-001,2014,5,14,2,64,52,116,157
3404-001,2014,5,14,3,53,44,97,116
3404-001,2014,5,14,4,33,55,88,97
3404-001,2014,5,14,5,34,78,112,88
3404-001,2014,5,14,6,116,161,277,112
3404-001,2014,5,14,7,199,550,749,277
3404-001,2014,5,14,8,459,1580,2039,749
3404-001,2014,5,14,9,671,1192,1863,2039
3404-001,2014,5,14,10,590,725,1315,1863
3404-001,2014,5,14,11,633,673,1306,1315
3404-001,2014,5,14,12,693,685,1378,1306
3404-001,2014,5,14,13,486,554,1040,1378
3404-001,2014,5,14,14,572,631,1203,1040
3404-001,2014,5,14,15,653,649,1302,1203
3404-001,2014,5,14,16,642,576,1218,1302
3404-001,2014,5,14,17,749,566,1315,1218
3404-001,2014,5,14,18,1116,530,1646,1315
3404-001,2014,5,14,19,974,444,1418,1646
3404-001,2014,5,14,20,646,362,1008,1418
3404-001,2014,5,14,21,580,257,837,1008
3404-001,2014,5,14,22,356,211,567,837
3404-001,2014,5,14,23,223,143,366,567
3404-001,2014,5,14,24,128,109,237,366
3404-001,2014,5,15,1,95,71,166,237
3404-001,2014,5,15,2,53,50,103,166
3404-001,2014,5,15,3,36,25,61,103
3404-001,2014,5,15,4,34,43,77,61
3404-001,2014,5,15,5,39,75,114,77
3404-001,2014,5,15,6,114,178,292,114
3404-001,2014,5,15,7,187,519,706,292
3404-001,2014,5,15,8,430,1514,1944,706
3404-001,2014,5,15,9,644,1201,1845,1944
3404-001,2014,5,15,10,576,640,1216,1845
3404-001,2014,5,15,11,637,680,1317,1216
3404-001,2014,5,15,12,596,638,1234,1317
3404-001,2014,5,15,13,513,480,993,1234
3404-001,2014,5,15,14,549,598,1147,993
3404-001,2014,5,15,15,681,633,1314,1147
3404-001,2014,5,15,16,659,630,1289,1314
3404-001,2014,5,15,17,713,541,1254,1289
3404-001,2014,5,15,18,975,510,1485,1254
3404-001,2014,5,15,19,911,440,1351,1485
3404-001,2014,5,15,20,703,371,1074,1351
3404-001,2014,5,15,21,579,259,838,1074
3404-001,2014,5,15,22,363,223,586,838
3404-001,2014,5,15,23,239,134,373,586
3404-001,2014,5,15,24,133,125,258,373
3404-001,2014,5,16,1,85,62,147,258
3404-001,2014,5,16,2,64,57,121,147
3404-001,2014,5,16,3,45,49,94,121
3404-001,2014,5,16,4,44,60,104,94
3404-001,2014,5,16,5,51,84,135,104
3404-001,2014,5,16,6,105,172,277,135
3404-001,2014,5,16,7,224,540,764,277
3404-001,2014,5,16,8,415,1528,1943,764
3404-001,2014,5,16,9,655,1201,1856,1943
3404-001,2014,5,16,10,619,675,1294,1856
3404-001,2014,5,16,11,738,702,1440,1294
3404-001,2014,5,16,12,580,644,1224,1440
3404-001,2014,5,16,13,567,510,1077,1224
3404-001,2014,5,16,14,579,567,1146,1077
3404-001,2014,5,16,15,679,612,1291,1146
3404-001,2014,5,16,16,741,605,1346,1291
3404-001,2014,5,16,17,712,548,1260,1346
3404-001,2014,5,16,18,1144,514,1658,1260
3404-001,2014,5,16,19,1179,521,1700,1658
3404-001,2014,5,16,20,790,443,1233,1700
3404-001,2014,5,16,21,554,306,860,1233
3404-001,2014,5,16,22,393,233,626,860
3404-001,2014,5,16,23,251,180,431,626
3404-001,2014,5,16,24,132,126,258,431
3404-001,2014,5,17,1,96,68,164,258
3404-001,2014,5,17,2,84,58,142,164
3404-001,2014,5,17,3,50,52,102,142
3404-001,2014,5,17,4,43,47,90,102
3404-001,2014,5,17,5,58,64,122,90
3404-001,2014,5,17,6,93,158,251,122
3404-001,2014,5,17,7,192,377,569,251
3404-001,2014,5,17,8,328,752,1080,569
3404-001,2014,5,17,9,467,673,1140,1080
3404-001,2014,5,17,10,510,579,1089,1140
3404-001,2014,5,17,11,502,579,1081,1089
3404-001,2014,5,17,12,465,475,940,1081
3404-001,2014,5,17,13,491,436,927,940
3404-001,2014,5,17,14,458,449,907,927
3404-001,2014,5,17,15,496,448,944,907
3404-001,2014,5,17,16,506,396,902,944
3404-001,2014,5,17,17,555,373,928,902
3404-001,2014,5,17,18,741,470,1211,928
3404-001,2014,5,17,19,578,395,973,1211
3404-001,2014,5,17,20,356,274,630,973
3404-001,2014,5,17,21,312,201,513,630
3404-001,2014,5,17,22,208,201,409,513
3404-001,2014,5,17,23,155,136,291,409
3404-001,2014,5,17,24,99,80,179,291
3404-001,2014,5,18,1,51,56,107,179
3404-001,2014,5,18,2,53,36,89,107
3404-001,2014,5,18,3,32,23,55,89
3404-001,2014,5,18,4,28,18,46,55
3404-001,2014,5,18,5,31,38,69,46
3404-001,2014,5,18,6,64,91,155,69
3404-001,2014,5,18,7,87,170,257,155
3404-001,2014,5,18,8,139,263,402,257
3404-001,2014,5,18,9,215,248,463,402
3404-001,2014,5,18,10,216,287,503,463
3404-001,2014,5,18,11,308,304,612,503
3404-001,2014,5,18,12,272,320,592,612
3404-001,2014,5,18,13,254,287,541,592
3404-001,2014,5,18,14,317,307,624,541
3404-001,2014,5,18,15,333,325,658,624
3404-001,2014,5,18,16,378,289,667,658
3404-001,2014,5,18,17,455,278,733,667
3404-001,2014,5,18,18,528,285,813,733
3404-001,2014,5,18,19,377,323,700,813
3404-001,2014,5,18,20,352,246,598,700
3404-001,2014,5,18,21,247,235,482,598
3404-001,2014,5,18,22,190,209,399,482
3404-001,2014,5,18,23,107,186,293,399
3404-001,2014,5,18,24,72,118,190,293
3404-001,2014,5,19,1,42,68,110,190
3404-001,2014,5,19,2,24,43,67,110
3404-001,2014,5,19,3,22,32,54,67
3404-001,2014,5,19,4,20,44,64,54
3404-001,2014,5,19,5,38,72,110,64
3404-001,2014,5,19,6,103,228,331,110
3404-001,2014,5,19,7,218,643,861,331
3404-001,2014,5,19,8,471,1721,2192,861
3404-001,2014,5,19,9,610,1230,1840,2192
3404-001,2014,5,19,10,614,686,1300,1840
3404-001,2014,5,19,11,605,637,1242,1300
3404-001,2014,5,19,12,589,584,1173,1242
3404-001,2014,5,19,13,513,532,1045,1173
3404-001,2014,5,19,14,569,568,1137,1045
3404-001,2014,5,19,15,675,693,1368,1137
3404-001,2014,5,19,16,706,633,1339,1368
3404-001,2014,5,19,17,733,533,1266,1339
3404-001,2014,5,19,18,965,503,1468,1266
3404-001,2014,5,19,19,915,459,1374,1468
3404-001,2014,5,19,20,677,416,1093,1374
3404-001,2014,5,19,21,612,231,843,1093
3404-001,2014,5,19,22,392,198,590,843
3404-001,2014,5,19,23,203,159,362,590
3404-001,2014,5,19,24,114,112,226,362
3404-001,2014,5,20,1,83,56,139,226
3404-001,2014,5,20,2,57,47,104,139
3404-001,2014,5,20,3,47,38,85,104
3404-001,2014,5,20,4,38,60,98,85
3404-001,2014,5,20,5,63,77,140,98
3404-001,2014,5,20,6,121,204,325,140
3404-001,2014,5,20,7,205,533,738,325
3404-001,2014,5,20,8,467,1524,1991,738
3404-001,2014,5,20,9,702,1194,1896,1991
3404-001,2014,5,20,10,635,699,1334,1896
3404-001,2014,5,20,11,625,690,1315,1334
3404-001,2014,5,20,12,630,629,1259,1315
3404-001,2014,5,20,13,549,498,1047,1259
3404-001,2014,5,20,14,518,577,1095,1047
3404-001,2014,5,20,15,674,677,1351,1095
3404-001,2014,5,20,16,673,584,1257,1351
3404-001,2014,5,20,17,731,532,1263,1257
3404-001,2014,5,20,18,984,499,1483,1263
3404-001,2014,5,20,19,910,447,1357,1483
3404-001,2014,5,20,20,663,380,1043,1357
3404-001,2014,5,20,21,631,262,893,1043
3404-001,2014,5,20,22,405,199,604,893
3404-001,2014,5,20,23,190,151,341,604
3404-001,2014,5,20,24,130,96,226,341
3404-001,2014,5,21,1,93,76,169,226
3404-001,2014,5,21,2,55,55,110,169
3404-001,2014,5,21,3,49,45,94,110
3404-001,2014,5,21,4,33,35,68,94
3404-001,2014,5,21,5,43,75,118,68
3404-001,2014,5,21,6,115,190,305,118
3404-001,2014,5,21,7,206,551,757,305
3404-001,2014,5,21,8,430,1564,1994,757
3404-001,2014,5,21,9,671,1194,1865,1994
3404-001,2014,5,21,10,571,678,1249,1865
3404-001,2014,5,21,11,621,662,1283,1249
3404-001,2014,5,21,12,708,617,1325,1283
3404-001,2014,5,21,13,541,442,983,1325
3404-001,2014,5,21,14,588,561,1149,983
3404-001,2014,5,21,15,653,596,1249,1149
3404-001,2014,5,21,16,684,599,1283,1249
3404-001,2014,5,21,17,734,504,1238,1283
3404-001,2014,5,21,18,1016,561,1577,1238
3404-001,2014,5,21,19,1000,465,1465,1577
3404-001,2014,5,21,20,621,350,971,1465
3404-001,2014,5,21,21,524,255,779,971
3404-001,2014,5,21,22,387,213,600,779
3404-001,2014,5,21,23,237,137,374,600
3404-001,2014,5,21,24,136,101,237,374
3404-001,2014,5,22,1,80,91,171,237
3404-001,2014,5,22,2,64,50,114,171
3404-001,2014,5,22,3,48,49,97,114
3404-001,2014,5,22,4,29,46,75,97
3404-001,2014,5,22,5,55,77,132,75
3404-001,2014,5,22,6,103,237,340,132
3404-001,2014,5,22,7,208,535,743,340
3404-001,2014,5,22,8,464,1496,1960,743
3404-001,2014,5,22,9,675,1234,1909,1960
3404-001,2014,5,22,10,591,689,1280,1909
3404-001,2014,5,22,11,641,638,1279,1280
3404-001,2014,5,22,12,643,623,1266,1279
3404-001,2014,5,22,13,517,494,1011,1266
3404-001,2014,5,22,14,563,595,1158,1011
3404-001,2014,5,22,15,683,669,1352,1158
3404-001,2014,5,22,16,720,588,1308,1352
3404-001,2014,5,22,17,709,580,1289,1308
3404-001,2014,5,22,18,971,538,1509,1289
3404-001,2014,5,22,19,944,431,1375,1509
3404-001,2014,5,22,20,672,365,1037,1375
3404-001,2014,5,22,21,615,270,885,1037
3404-001,2014,5,22,22,388,223,611,885
3404-001,2014,5,22,23,232,147,379,611
3404-001,2014,5,22,24,121,114,235,379
3404-001,2014,5,23,1,99,84,183,235
3404-001,2014,5,23,2,66,50,116,183
3404-001,2014,5,23,3,52,41,93,116
3404-001,2014,5,23,4,22,48,70,93
3404-001,2014,5,23,5,54,66,120,70
3404-001,2014,5,23,6,119,207,326,120
3404-001,2014,5,23,7,181,544,725,326
3404-001,2014,5,23,8,440,1480,1920,725
3404-001,2014,5,23,9,676,1273,1949,1920
3404-001,2014,5,23,10,674,640,1314,1949
3404-001,2014,5,23,11,631,672,1303,1314
3404-001,2014,5,23,12,677,612,1289,1303
3404-001,2014,5,23,13,569,523,1092,1289
3404-001,2014,5,23,14,641,561,1202,1092
3404-001,2014,5,23,15,673,656,1329,1202
3404-001,2014,5,23,16,732,659,1391,1329
3404-001,2014,5,23,17,763,590,1353,1391
3404-001,2014,5,23,18,1176,526,1702,1353
3404-001,2014,5,23,19,1155,480,1635,1702
3404-001,2014,5,23,20,788,460,1248,1635
3404-001,2014,5,23,21,611,275,886,1248
3404-001,2014,5,23,22,379,205,584,886
3404-001,2014,5,23,23,221,164,385,584
3404-001,2014,5,23,24,111,102,213,385
3404-001,2014,5,24,1,102,68,170,213
3404-001,2014,5,24,2,66,55,121,170
3404-001,2014,5,24,3,46,52,98,121
3404-001,2014,5,24,4,37,52,89,98
3404-001,2014,5,24,5,58,72,130,89
3404-001,2014,5,24,6,104,224,328,130
3404-001,2014,5,24,7,212,415,627,328
3404-001,2014,5,24,8,325,711,1036,627
3404-001,2014,5,24,9,500,677,1177,1036
3404-001,2014,5,24,10,548,589,1137,1177
3404-001,2014,5,24,11,555,544,1099,1137
3404-001,2014,5,24,12,483,546,1029,1099
3404-001,2014,5,24,13,488,447,935,1029
3404-001,2014,5,24,14,518,464,982,935
3404-001,2014,5,24,15,529,473,1002,982
3404-001,2014,5,24,16,527,389,916,1002
3404-001,2014,5,24,17,641,406,1047,916
3404-001,2014,5,24,18,792,411,1203,1047
3404-001,2014,5,24,19,534,382,916,1203
3404-001,2014,5,24,20,350,276,626,916
3404-001,2014,5,24,21,288,227,515,626
3404-001,2014,5,24,22,215,141,356,515
3404-001,2014,5,24,23,97,136,233,356
3404-001,2014,5,24,24,80,65,145,233
3404-001,2014,5,25,1,51,59,110,145
3404-001,2014,5,25,2,45,37,82,110
3404-001,2014,5,25,3,48,25,73,82
3404-001,2014,5,25,4,31,31,62,73
3404-001,2014,5,25,5,46,34,80,62
3404-001,2014,5,25,6,63,77,140,80
3404-001,2014,5,25,7,93,173,266,140
3404-001,2014,5,25,8,207,299,506,266
3404-001,2014,5,25,9,251,264,515,506
3404-001,2014,5,25,10,251,291,542,515
3404-001,2014,5,25,11,267,290,557,542
3404-001,2014,5,25,12,257,305,562,557
3404-001,2014,5,25,13,320,285,605,562
3404-001,2014,5,25,14,307,303,610,605
3404-001,2014,5,25,15,359,312,671,610
3404-001,2014,5,25,16,443,321,764,671
3404-001,2014,5,25,17,414,290,704,764
3404-001,2014,5,25,18,423,298,721,704
3404-001,2014,5,25,19,312,288,600,721
3404-001,2014,5,25,20,267,225,492,600
3404-001,2014,5,25,21,205,166,371,492
3404-001,2014,5,25,22,142,191,333,371
3404-001,2014,5,25,23,87,141,228,333
3404-001,2014,5,25,24,65,94,159,228
3404-001,2014,5,26,1,36,63,99,159
3404-001,2014,5,26,2,20,37,57,99
3404-001,2014,5,26,3,13,42,55,57
3404-001,2014,5,26,4,22,34,56,55
3404-001,2014,5,26,5,31,77,108,56
3404-001,2014,5,26,6,101,209,310,108
3404-001,2014,5,26,7,204,571,775,310
3404-001,2014,5,26,8,454,1733,2187,775
3404-001,2014,5,26,9,571,1368,1939,2187
3404-001,2014,5,26,10,584,684,1268,1939
3404-001,2014,5,26,11,622,641,1263,1268
3404-001,2014,5,26,12,639,612,1251,1263
3404-001,2014,5,26,13,506,494,1000,1251
3404-001,2014,5,26,14,560,536,1096,1000
3404-001,2014,5,26,15,663,672,1335,1096
3404-001,2014,5,26,16,708,608,1316,1335
3404-001,2014,5,26,17,662,556,1218,1316
3404-001,2014,5,26,18,935,499,1434,1218
3404-001,2014,5,26,19,907,413,1320,1434
3404-001,2014,5,26,20,659,397,1056,1320
3404-001,2014,5,26,21,641,259,900,1056
3404-001,2014,5,26,22,431,230,661,900
3404-001,2014,5,26,23,225,143,368,661
3404-001,2014,5,26,24,127,106,233,368
3404-001,2014,5,27,1,105,68,173,233
3404-001,2014,5,27,2,61,53,114,173
3404-001,2014,5,27,3,44,64,108,114
3404-001,2014,5,27,4,43,50,93,108
3404-001,2014,5,27,5,57,82,139,93
3404-001,2014,5,27,6,125,202,327,139
3404-001,2014,5,27,7,192,570,762,327
3404-001,2014,5,27,8,474,1535,2009,762
3404-001,2014,5,27,9,658,1244,1902,2009
3404-001,2014,5,27,10,638,690,1328,1902
3404-001,2014,5,27,11,633,636,1269,1328
3404-001,2014,5,27,12,604,571,1175,1269
3404-001,2014,5,27,13,504,460,964,1175
3404-001,2014,5,27,14,567,570,1137,964
3404-001,2014,5,27,15,691,667,1358,1137
3404-001,2014,5,27,16,698,621,1319,1358
3404-001,2014,5,27,17,705,534,1239,1319
3404-001,2014,5,27,18,968,494,1462,1239
3404-001,2014,5,27,19,970,472,1442,1462
3404-001,2014,5,27,20,661,403,1064,1442
3404-001,2014,5,27,21,658,249,907,1064
3404-001,2014,5,27,22,448,214,662,907
3404-001,2014,5,27,23,228,140,368,662
3404-001,2014,5,27,24,133,121,254,368
3404-001,2014,5,28,1,94,58,152,254
3404-001,2014,5,28,2,72,63,135,152
3404-001,2014,5,28,3,41,52,93,135
3404-001,2014,5,28,4,42,43,85,93
3404-001,2014,5,28,5,47,54,101,85
3404-001,2014,5,28,6,118,192,310,101
3404-001,2014,5,28,7,186,508,694,310
3404-001,2014,5,28,8,418,1585,2003,694
3404-001,2014,5,28,9,652,1287,1939,2003
3404-001,2014,5,28,10,611,683,1294,1939
3404-001,2014,5,28,11,682,632,1314,1294
3404-001,2014,5,28,12,605,617,1222,1314
3404-001,2014,5,28,13,547,538,1085,1222
3404-001,2014,5,28,14,642,560,1202,1085
3404-001,2014,5,28,15,697,657,1354,1202
3404-001,2014,5,28,16,667,616,1283,1354
3404-001,2014,5,28,17,675,496,1171,1283
3404-001,2014,5,28,18,1013,563,1576,1171
3404-001,2014,5,28,19,1051,457,1508,1576
3404-001,2014,5,28,20,673,412,1085,1508
3404-001,2014,5,28,21,611,280,891,1085
3404-001,2014,5,28,22,407,208,615,891
3404-001,2014,5,28,23,250,145,395,615
3404-001,2014,5,28,24,122,113,235,395
3404-001,2014,5,29,1,84,72,156,235
3404-001,2014,5,29,2,57,54,111,156
3404-001,2014,5,29,3,45,33,78,111
3404-001,2014,5,29,4,41,43,84,78
3404-001,2014,5,29,5,58,81,139,84
3404-001,2014,5,29,6,91,208,299,139
3404-001,2014,5,29,7,203,541,744,299
3404-001,2014,5,29,8,433,1535,1968,744
3404-001,2014,5,29,9,675,1262,1937,1968
3404-001,2014,5,29,10,641,648,1289,1937
3404-001,2014,5,29,11,628,695,1323,1289
3404-001,2014,5,29,12,665,601,1266,1323
3404-001,2014,5,29,13,529,522,1051,1266
3404-001,2014,5,29,14,593,612,1205,1051
3404-001,2014,5,29,15,708,644,1352,1205
3404-001,2014,5,29,16,695,619,1314,1352
3404-001,2014,5,29,17,777,538,1315,1314
3404-001,2014,5,29,18,998,542,1540,1315
3404-001,2014,5,29,19,1010,466,1476,1540
3404-001,2014,5,29,20,690,376,1066,1476
3404-001,2014,5,29,21,604,288,892,1066
3404-001,2014,5,29,22,441,216,657,892
3404-001,2014,5,29,23,227,167,394,657
3404-001,2014,5,29,24,126,131,257,394
3404-001,2014,5,30,1,92,87,179,257
3404-001,2014,5,30,2,67,51,118,179
3404-001,2014,5,30,3,42,40,82,118
3404-001,2014,5,30,4,26,44,70,82
3404-001,2014,5,30,5,50,67,117,70
3404-001,2014,5,30,6,123,218,341,117
3404-001,2014,5,30,7,209,523,732,341
3404-001,2014,5,30,8,450,1600,2050,732
3404-001,2014,5,30,9,657,1260,1917,2050
3404-001,2014,5,30,10,605,633,1238,1917
3404-001,2014,5,30,11,641,656,1297,1238
3404-001,2014,5,30,12,638,592,1230,1297
3404-001,2014,5,30,13,558,486,1044,1230
3404-001,2014,5,30,14,572,543,1115,1044
3404-001,2014,5,30,15,650,633,1283,1115
3404-001,2014,5,30,16,713,619,1332,1283
3404-001,2014,5,30,17,713,555,1268,1332
3404-001,2014,5,30,18,1108,547,1655,1268
3404-001,2014,5,30,19,1110,459,1569,1655
3404-001,2014,5,30,20,801,453,1254,1569
3404-001,2014,5,30,21,607,308,915,1254
3404-001,2014,5,30,22,435,209,644,915
3404-001,2014,5,30,23,224,160,384,644
3404-001,2014,5,30,24,122,118,240,384
3404-001,2014,5,31,1,123,73,196,240
3404-001,2014,5,31,2,91,66,157,196
3404-001,2014,5,31,3,51,50,101,157
3404-001,2014,5,31,4,31,56,87,101
3404-001,2014,5,31,5,54,82,136,87
3404-001,2014,5,31,6,108,201,309,136
3404-001,2014,5,31,7,183,388,571,309
3404-001,2014,5,31,8,318,767,1085,571
3404-001,2014,5,31,9,472,669,1141,1085
3404-001,2014,5,31,10,564,545,1109,1141
3404-001,2014,5,31,11,518,525,1043,1109
3404-001,2014,5,31,12,476,434,910,1043
3404-001,2014,5,31,13,485,427,912,910
3404-001,2014,5,31,14,468,418,886,912
3404-001,2014,5,31,15,508,469,977,886
3404-001,2014,5,31,16,527,393,920,977
3404-001,2014,5,31,17,575,427,1002,920
3404-001,2014,5,31,18,812,385,1197,1002
3404-001,2014,5,31,19,550,394,944,1197
3404-001,2014,5,31,20,357,316,673,944
3404-001,2014,5,31,21,297,235,532,673
3404-001,2014,5,31,22,209,187,396,532
3404-001,2014,5,31,23,149,137,286,396
3404-001,2014,5,31,24,73,80,153,286
3404-001,2014,6,1,1,62,64,126,153
3404-001,2014,6,1,2,68,34,102,126
3404-001,2014,6,1,3,39,37,76,102
3404-001,2014,6,1,4,34,28,62,76
3404-001,2014,6,1,5,34,40,74,62
3404-001,2014,6,1,6,74,104,178,74
3404-001,2014,6,1,7,96,184,280,178
3404-001,2014,6,1,8,171,275,446,280
3404-001,2014,6,1,9,223,290,513,446
3404-001,2014,6,1,10,213,264,477,513
3404-001,2014,6,1,11,273,295,568,477
3404-001,2014,6,1,12,288,290,578,568
3404-001,2014,6,1,13,265,297,562,578
3404-001,2014,6,1,14,293,286,579,562
3404-001,2014,6,1,15,342,287,629,579
3404-001,2014,6,1,16,399,277,676,629
3404-001,2014,6,1,17,406,332,738,676
3404-001,2014,6,1,18,491,340,831,738
3404-001,2014,6,1,19,371,293,664,831
3404-001,2014,6,1,20,295,230,525,664
3404-001,2014,6,1,21,218,235,453,525
3404-001,2014,6,1,22,179,200,379,453
3404-001,2014,6,1,23,111,151,262,379
3404-001,2014,6,1,24,61,99,160,262
3404-001,2014,6,2,1,38,63,101,160
3404-001,2014,6,2,2,23,49,72,101
3404-001,2014,6,2,3,19,32,51,72
3404-001,2014,6,2,4,28,35,63,51
3404-001,2014,6,2,5,42,97,139,63
3404-001,2014,6,2,6,95,218,313,139
3404-001,2014,6,2,7,226,599,825,313
3404-001,2014,6,2,8,494,1793,2287,825
3404-001,2014,6,2,9,599,1358,1957,2287
3404-001,2014,6,2,10,598,636,1234,1957
3404-001,2014,6,2,11,643,654,1297,1234
3404-001,2014,6,2,12,626,607,1233,1297
3404-001,2014,6,2,13,576,489,1065,1233
3404-001,2014,6,2,14,632,611,1243,1065
3404-001,2014,6,2,15,651,650,1301,1243
3404-001,2014,6,2,16,724,585,1309,1301
3404-001,2014,6,2,17,708,577,1285,1309
3404-001,2014,6,2,18,889,469,1358,1285
3404-001,2014,6,2,19,901,413,1314,1358
3404-001,2014,6,2,20,658,364,1022,1314
3404-001,2014,6,2,21,653,245,898,1022
3404-001,2014,6,2,22,409,204,613,898
3404-001,2014,6,2,23,227,130,357,613
3404-001,2014,6,2,24,123,84,207,357
3404-001,2014,6,3,1,87,86,173,207
3404-001,2014,6,3,2,61,57,118,173
3404-001,2014,6,3,3,45,39,84,118
3404-001,2014,6,3,4,41,55,96,84
3404-001,2014,6,3,5,38,71,109,96
3404-001,2014,6,3,6,118,160,278,109
3404-001,2014,6,3,7,159,441,600,278
3404-001,2014,6,3,8,399,1456,1855,600
3404-001,2014,6,3,9,602,1293,1895,1855
3404-001,2014,6,3,10,569,655,1224,1895
3404-001,2014,6,3,11,595,610,1205,1224
3404-001,2014,6,3,12,555,585,1140,1205
3404-001,2014,6,3,13,501,533,1034,1140
3404-001,2014,6,3,14,531,539,1070,1034
3404-001,2014,6,3,15,633,624,1257,1070
3404-001,2014,6,3,16,709,629,1338,1257
3404-001,2014,6,3,17,728,536,1264,1338
3404-001,2014,6,3,18,1012,494,1506,1264
3404-001,2014,6,3,19,1029,452,1481,1506
3404-001,2014,6,3,20,672,391,1063,1481
3404-001,2014,6,3,21,673,227,900,1063
3404-001,2014,6,3,22,410,191,601,900
3404-001,2014,6,3,23,244,131,375,601
3404-001,2014,6,3,24,109,98,207,375
3404-001,2014,6,4,1,97,87,184,207
3404-001,2014,6,4,2,66,45,111,184
3404-001,2014,6,4,3,44,55,99,111
3404-001,2014,6,4,4,40,47,87,99
3404-001,2014,6,4,5,50,86,136,87
3404-001,2014,6,4,6,95,201,296,136
3404-001,2014,6,4,7,159,327,486,296
3404-001,2014,6,4,8,316,786,1102,486
3404-001,2014,6,4,9,451,783,1234,1102
3404-001,2014,6,4,10,487,671,1158,1234
3404-001,2014,6,4,11,530,604,1134,1158
3404-001,2014,6,4,12,465,549,1014,1134
3404-001,2014,6,4,13,478,468,946,1014
3404-001,2014,6,4,14,480,461,941,946
3404-001,2014,6,4,15,557,475,1032,941
3404-001,2014,6,4,16,554,454,1008,1032
3404-001,2014,6,4,17,640,395,1035,1008
3404-001,2014,6,4,18,764,413,1177,1035
3404-001,2014,6,4,19,581,346,927,1177
3404-001,2014,6,4,20,384,271,655,927
3404-001,2014,6,4,21,370,251,621,655
3404-001,2014,6,4,22,244,170,414,621
3404-001,2014,6,4,23,170,121,291,414
3404-001,2014,6,4,24,97,93,190,291
3404-001,2014,6,5,1,68,64,132,190
3404-001,2014,6,5,2,32,31,63,132
3404-001,2014,6,5,3,31,39,70,63
3404-001,2014,6,5,4,41,40,81,70
3404-001,2014,6,5,5,50,73,123,81
3404-001,2014,6,5,6,92,201,293,123
3404-001,2014,6,5,7,214,571,785,293
3404-001,2014,6,5,8,430,1384,1814,785
3404-001,2014,6,5,9,602,1138,1740,1814
3404-001,2014,6,5,10,599,665,1264,1740
3404-001,2014,6,5,11,618,675,1293,1264
3404-001,2014,6,5,12,590,599,1189,1293
3404-001,2014,6,5,13,545,524,1069,1189
3404-001,2014,6,5,14,588,613,1201,1069
3404-001,2014,6,5,15,683,658,1341,1201
3404-001,2014,6,5,16,669,603,1272,1341
3404-001,2014,6,5,17,775,557,1332,1272
3404-001,2014,6,5,18,1040,564,1604,1332
3404-001,2014,6,5,19,1019,461,1480,1604
3404-001,2014,6,5,20,686,410,1096,1480
3404-001,2014,6,5,21,619,275,894,1096
3404-001,2014,6,5,22,422,209,631,894
3404-001,2014,6,5,23,231,168,399,631
3404-001,2014,6,5,24,142,105,247,399
3404-001,2014,6,6,1,92,68,160,247
3404-001,2014,6,6,2,56,68,124,160
3404-001,2014,6,6,3,43,53,96,124
3404-001,2014,6,6,4,46,45,91,96
3404-001,2014,6,6,5,56,72,128,91
3404-001,2014,6,6,6,101,223,324,128
3404-001,2014,6,6,7,173,394,567,324
3404-001,2014,6,6,8,294,659,953,567
3404-001,2014,6,6,9,444,643,1087,953
3404-001,2014,6,6,10,398,544,942,1087
3404-001,2014,6,6,11,418,591,1009,942
3404-001,2014,6,6,12,436,605,1041,1009
3404-001,2014,6,6,13,399,519,918,1041
3404-001,2014,6,6,14,421,438,859,918
3404-001,2014,6,6,15,505,444,949,859
3404-001,2014,6,6,16,448,417,865,949
3404-001,2014,6,6,17,526,423,949,865
3404-001,2014,6,6,18,723,405,1128,949
3404-001,2014,6,6,19,579,333,912,1128
3404-001,2014,6,6,20,408,339,747,912
3404-001,2014,6,6,21,329,227,556,747
3404-001,2014,6,6,22,237,141,378,556
3404-001,2014,6,6,23,153,116,269,378
3404-001,2014,6,6,24,99,88,187,269
3404-001,2014,6,7,1,67,63,130,187
3404-001,2014,6,7,2,52,49,101,130
3404-001,2014,6,7,3,32,27,59,101
3404-001,2014,6,7,4,31,47,78,59
3404-001,2014,6,7,5,49,73,122,78
3404-001,2014,6,7,6,75,191,266,122
3404-001,2014,6,7,7,165,314,479,266
3404-001,2014,6,7,8,227,542,769,479
3404-001,2014,6,7,9,374,502,876,769
3404-001,2014,6,7,10,381,490,871,876
3404-001,2014,6,7,11,440,488,928,871
3404-001,2014,6,7,12,446,474,920,928
3404-001,2014,6,7,13,407,370,777,920
3404-001,2014,6,7,14,419,412,831,777
3404-001,2014,6,7,15,452,383,835,831
3404-001,2014,6,7,16,466,391,857,835
3404-001,2014,6,7,17,491,357,848,857
3404-001,2014,6,7,18,656,347,1003,848
3404-001,2014,6,7,19,567,350,917,1003
3404-001,2014,6,7,20,394,298,692,917
3404-001,2014,6,7,21,289,175,464,692
3404-001,2014,6,7,22,226,147,373,464
3404-001,2014,6,7,23,161,134,295,373
3404-001,2014,6,7,24,86,83,169,295
3404-001,2014,6,8,1,72,54,126,169
3404-001,2014,6,8,2,43,32,75,126
3404-001,2014,6,8,3,22,36,58,75
3404-001,2014,6,8,4,25,21,46,58
3404-001,2014,6,8,5,30,42,72,46
3404-001,2014,6,8,6,51,87,138,72
3404-001,2014,6,8,7,87,175,262,138
3404-001,2014,6,8,8,134,237,371,262
3404-001,2014,6,8,9,190,249,439,371
3404-001,2014,6,8,10,199,231,430,439
3404-001,2014,6,8,11,231,279,510,430
3404-001,2014,6,8,12,250,300,550,510
3404-001,2014,6,8,13,289,275,564,550
3404-001,2014,6,8,14,319,286,605,564
3404-001,2014,6,8,15,334,318,652,605
3404-001,2014,6,8,16,425,296,721,652
3404-001,2014,6,8,17,435,308,743,721
3404-001,2014,6,8,18,504,269,773,743
3404-001,2014,6,8,19,383,313,696,773
3404-001,2014,6,8,20,297,250,547,696
3404-001,2014,6,8,21,227,228,455,547
3404-001,2014,6,8,22,189,217,406,455
3404-001,2014,6,8,23,93,166,259,406
3404-001,2014,6,8,24,68,99,167,259
3404-001,2014,6,9,1,65,84,149,167
3404-001,2014,6,9,2,29,36,65,149
3404-001,2014,6,9,3,24,54,78,65
3404-001,2014,6,9,4,31,36,67,78
3404-001,2014,6,9,5,49,89,138,67
3404-001,2014,6,9,6,117,252,369,138
3404-001,2014,6,9,7,181,617,798,369
3404-001,2014,6,9,8,447,1798,2245,798
3404-001,2014,6,9,9,596,1267,1863,2245
3404-001,2014,6,9,10,529,630,1159,1863
3404-001,2014,6,9,11,627,655,1282,1159
3404-001,2014,6,9,12,614,597,1211,1282
3404-001,2014,6,9,13,519,541,1060,1211
3404-001,2014,6,9,14,483,553,1036,1060
3404-001,2014,6,9,15,673,642,1315,1036
3404-001,2014,6,9,16,682,583,1265,1315
3404-001,2014,6,9,17,679,561,1240,1265
3404-001,2014,6,9,18,976,503,1479,1240
3404-001,2014,6,9,19,971,489,1460,1479
3404-001,2014,6,9,20,683,385,1068,1460
3404-001,2014,6,9,21,730,264,994,1068
3404-001,2014,6,9,22,434,227,661,994
3404-001,2014,6,9,23,262,134,396,661
3404-001,2014,6,9,24,148,96,244,396
3404-001,2014,6,10,1,100,72,172,244
3404-001,2014,6,10,2,71,47,118,172
3404-001,2014,6,10,3,43,55,98,118
3404-001,2014,6,10,4,46,55,101,98
3404-001,2014,6,10,5,53,77,130,101
3404-001,2014,6,10,6,97,223,320,130
3404-001,2014,6,10,7,187,545,732,320
3404-001,2014,6,10,8,415,1631,2046,732
3404-001,2014,6,10,9,671,1230,1901,2046
3404-001,2014,6,10,10,642,737,1379,1901
3404-001,2014,6,10,11,590,658,1248,1379
3404-001,2014,6,10,12,652,629,1281,1248
3404-001,2014,6,10,13,575,515,1090,1281
3404-001,2014,6,10,14,598,597,1195,1090
3404-001,2014,6,10,15,666,680,1346,1195
3404-001,2014,6,10,16,667,620,1287,1346
3404-001,2014,6,10,17,686,564,1250,1287
3404-001,2014,6,10,18,1045,489,1534,1250
3404-001,2014,6,10,19,967,454,1421,1534
3404-001,2014,6,10,20,699,385,1084,1421
3404-001,2014,6,10,21,664,283,947,1084
3404-001,2014,6,10,22,434,214,648,947
3404-001,2014,6,10,23,229,139,368,648
3404-001,2014,6,10,24,138,112,250,368
3404-001,2014,6,11,1,99,65,164,250
3404-001,2014,6,11,2,70,46,116,164
3404-001,2014,6,11,3,47,47,94,116
3404-001,2014,6,11,4,35,54,89,94
3404-001,2014,6,11,5,46,91,137,89
3404-001,2014,6,11,6,102,159,261,137
3404-001,2014,6,11,7,192,478,670,261
3404-001,2014,6,11,8,429,1513,1942,670
3404-001,2014,6,11,9,698,1325,2023,1942
3404-001,2014,6,11,10,594,698,1292,2023
3404-001,2014,6,11,11,655,656,1311,1292
3404-001,2014,6,11,12,649,641,1290,1311
3404-001,2014,6,11,13,563,546,1109,1290
3404-001,2014,6,11,14,538,513,1051,1109
3404-001,2014,6,11,15,688,606,1294,1051
3404-001,2014,6,11,16,727,573,1300,1294
3404-001,2014,6,11,17,720,528,1248,1300
3404-001,2014,6,11,18,1054,487,1541,1248
3404-001,2014,6,11,19,970,443,1413,1541
3404-001,2014,6,11,20,657,371,1028,1413
3404-001,2014,6,11,21,588,286,874,1028
3404-001,2014,6,11,22,376,201,577,874
3404-001,2014,6,11,23,259,141,400,577
3404-001,2014,6,11,24,133,100,233,400
3404-001,2014,6,12,1,84,60,144,233
3404-001,2014,6,12,2,68,42,110,144
3404-001,2014,6,12,3,37,44,81,110
3404-001,2014,6,12,4,56,40,96,81
3404-001,2014,6,12,5,56,80,136,96
3404-001,2014,6,12,6,122,215,337,136
3404-001,2014,6,12,7,188,583,771,337
3404-001,2014,6,12,8,453,1570,2023,771
3404-001,2014,6,12,9,624,1338,1962,2023
3404-001,2014,6,12,10,621,720,1341,1962
3404-001,2014,6,12,11,655,715,1370,1341
3404-001,2014,6,12,12,635,658,1293,1370
3404-001,2014,6,12,13,553,541,1094,1293
3404-001,2014,6,12,14,588,590,1178,1094
3404-001,2014,6,12,15,683,660,1343,1178
3404-001,2014,6,12,16,711,575,1286,1343
3404-001,2014,6,12,17,761,526,1287,1286
3404-001,2014,6,12,18,958,567,1525,1287
3404-001,2014,6,12,19,989,446,1435,1525
3404-001,2014,6,12,20,676,361,1037,1435
3404-001,2014,6,12,21,643,273,916,1037
3404-001,2014,6,12,22,404,223,627,916
3404-001,2014,6,12,23,234,157,391,627
3404-001,2014,6,12,24,136,102,238,391
3404-001,2014,6,13,1,100,78,178,238
3404-001,2014,6,13,2,68,57,125,178
3404-001,2014,6,13,3,53,55,108,125
3404-001,2014,6,13,4,38,52,90,108
3404-001,2014,6,13,5,55,73,128,90
3404-001,2014,6,13,6,120,209,329,128
3404-001,2014,6,13,7,179,517,696,329
3404-001,2014,6,13,8,471,1680,2151,696
3404-001,2014,6,13,9,640,1195,1835,2151
3404-001,2014,6,13,10,637,680,1317,1835
3404-001,2014,6,13,11,636,703,1339,1317
3404-001,2014,6,13,12,605,610,1215,1339
3404-001,2014,6,13,13,600,552,1152,1215
3404-001,2014,6,13,14,607,605,1212,1152
3404-001,2014,6,13,15,720,634,1354,1212
3404-001,2014,6,13,16,702,635,1337,1354
3404-001,2014,6,13,17,766,573,1339,1337
3404-001,2014,6,13,18,1205,522,1727,1339
3404-001,2014,6,13,19,1141,487,1628,1727
3404-001,2014,6,13,20,835,422,1257,1628
3404-001,2014,6,13,21,676,296,972,1257
3404-001,2014,6,13,22,372,218,590,972
3404-001,2014,6,13,23,199,177,376,590
3404-001,2014,6,13,24,115,113,228,376
3404-001,2014,6,14,1,102,71,173,228
3404-001,2014,6,14,2,75,52,127,173
3404-001,2014,6,14,3,55,44,99,127
3404-001,2014,6,14,4,42,40,82,99
3404-001,2014,6,14,5,49,91,140,82
3404-001,2014,6,14,6,116,225,341,140
3404-001,2014,6,14,7,182,435,617,341
3404-001,2014,6,14,8,341,723,1064,617
3404-001,2014,6,14,9,517,665,1182,1064
3404-001,2014,6,14,10,553,593,1146,1182
3404-001,2014,6,14,11,504,542,1046,1146
3404-001,2014,6,14,12,516,449,965,1046
3404-001,2014,6,14,13,434,454,888,965
3404-001,2014,6,14,14,504,424,928,888
3404-001,2014,6,14,15,503,441,944,928
3404-001,2014,6,14,16,520,424,944,944
3404-001,2014,6,14,17,588,392,980,944
3404-001,2014,6,14,18,804,423,1227,980
3404-001,2014,6,14,19,580,384,964,1227
3404-001,2014,6,14,20,385,304,689,964
3404-001,2014,6,14,21,303,249,552,689
3404-001,2014,6,14,22,220,179,399,552
3404-001,2014,6,14,23,151,139,290,399
3404-001,2014,6,14,24,99,90,189,290
3404-001,2014,6,15,1,75,48,123,189
3404-001,2014,6,15,2,66,30,96,123
3404-001,2014,6,15,3,54,22,76,96
3404-001,2014,6,15,4,33,24,57,76
3404-001,2014,6,15,5,47,51,98,57
3404-001,2014,6,15,6,57,100,157,98
3404-001,2014,6,15,7,79,167,246,157
3404-001,2014,6,15,8,191,278,469,246
3404-001,2014,6,15,9,203,291,494,469
3404-001,2014,6,15,10,251,265,516,494
3404-001,2014,6,15,11,275,290,565,516
3404-001,2014,6,15,12,240,295,535,565
3404-001,2014,6,15,13,240,255,495,535
3404-001,2014,6,15,14,291,284,575,495
3404-001,2014,6,15,15,303,285,588,575
3404-001,2014,6,15,16,425,315,740,588
3404-001,2014,6,15,17,418,302,720,740
3404-001,2014,6,15,18,502,299,801,720
3404-001,2014,6,15,19,390,265,655,801
3404-001,2014,6,15,20,286,244,530,655
3404-001,2014,6,15,21,236,232,468,530
3404-001,2014,6,15,22,205,204,409,468
3404-001,2014,6,15,23,107,145,252,409
3404-001,2014,6,15,24,63,102,165,252
3404-001,2014,6,16,1,40,91,131,165
3404-001,2014,6,16,2,28,50,78,131
3404-001,2014,6,16,3,23,45,68,78
3404-001,2014,6,16,4,28,52,80,68
3404-001,2014,6,16,5,49,79,128,80
3404-001,2014,6,16,6,109,286,395,128
3404-001,2014,6,16,7,233,701,934,395
3404-001,2014,6,16,8,475,1868,2343,934
3404-001,2014,6,16,9,591,1105,1696,2343
3404-001,2014,6,16,10,614,657,1271,1696
3404-001,2014,6,16,11,644,648,1292,1271
3404-001,2014,6,16,12,620,624,1244,1292
3404-001,2014,6,16,13,555,493,1048,1244
3404-001,2014,6,16,14,570,602,1172,1048
3404-001,2014,6,16,15,681,683,1364,1172
3404-001,2014,6,16,16,717,645,1362,1364
3404-001,2014,6,16,17,704,561,1265,1362
3404-001,2014,6,16,18,935,510,1445,1265
3404-001,2014,6,16,19,898,415,1313,1445
3404-001,2014,6,16,20,718,377,1095,1313
3404-001,2014,6,16,21,630,269,899,1095
3404-001,2014,6,16,22,385,204,589,899
3404-001,2014,6,16,23,199,132,331,589
3404-001,2014,6,16,24,145,91,236,331
3404-001,2014,6,17,1,92,85,177,236
3404-001,2014,6,17,2,56,50,106,177
3404-001,2014,6,17,3,41,54,95,106
3404-001,2014,6,17,4,32,43,75,95
3404-001,2014,6,17,5,47,95,142,75
3404-001,2014,6,17,6,132,214,346,142
3404-001,2014,6,17,7,212,577,789,346
3404-001,2014,6,17,8,454,1624,2078,789
3404-001,2014,6,17,9,644,1150,1794,2078
3404-001,2014,6,17,10,648,715,1363,1794
3404-001,2014,6,17,11,642,647,1289,1363
3404-001,2014,6,17,12,590,610,1200,1289
3404-001,2014,6,17,13,528,490,1018,1200
3404-001,2014,6,17,14,575,570,1145,1018
3404-001,2014,6,17,15,687,675,1362,1145
3404-001,2014,6,17,16,758,625,1383,1362
3404-001,2014,6,17,17,743,515,1258,1383
3404-001,2014,6,17,18,995,509,1504,1258
3404-001,2014,6,17,19,900,448,1348,1504
3404-001,2014,6,17,20,684,387,1071,1348
3404-001,2014,6,17,21,634,259,893,1071
3404-001,2014,6,17,22,433,232,665,893
3404-001,2014,6,17,23,221,148,369,665
3404-001,2014,6,17,24,146,118,264,369
3404-001,2014,6,18,1,93,86,179,264
3404-001,2014,6,18,2,63,46,109,179
3404-001,2014,6,18,3,44,45,89,109
3404-001,2014,6,18,4,48,43,91,89
3404-001,2014,6,18,5,62,93,155,91
3404-001,2014,6,18,6,125,223,348,155
3404-001,2014,6,18,7,225,749,974,348
3404-001,2014,6,18,8,449,1501,1950,974
3404-001,2014,6,18,9,565,998,1563,1950
3404-001,2014,6,18,10,649,704,1353,1563
3404-001,2014,6,18,11,709,665,1374,1353
3404-001,2014,6,18,12,589,614,1203,1374
3404-001,2014,6,18,13,479,472,951,1203
3404-001,2014,6,18,14,558,580,1138,951
3404-001,2014,6,18,15,583,654,1237,1138
3404-001,2014,6,18,16,678,559,1237,1237
3404-001,2014,6,18,17,704,543,1247,1237
3404-001,2014,6,18,18,1025,487,1512,1247
3404-001,2014,6,18,19,978,456,1434,1512
3404-001,2014,6,18,20,660,371,1031,1434
3404-001,2014,6,18,21,617,260,877,1031
3404-001,2014,6,18,22,361,176,537,877
3404-001,2014,6,18,23,215,175,390,537
3404-001,2014,6,18,24,143,94,237,390
3404-001,2014,6,19,1,98,81,179,237
3404-001,2014,6,19,2,69,56,125,179
3404-001,2014,6,19,3,40,43,83,125
3404-001,2014,6,19,4,42,37,79,83
3404-001,2014,6,19,5,66,84,150,79
3404-001,2014,6,19,6,134,210,344,150
3404-001,2014,6,19,7,198,560,758,344
3404-001,2014,6,19,8,474,1632,2106,758
3404-001,2014,6,19,9,637,1191,1828,2106
3404-001,2014,6,19,10,597,648,1245,1828
3404-001,2014,6,19,11,613,663,1276,1245
3404-001,2014,6,19,12,678,565,1243,1276
3404-001,2014,6,19,13,569,562,1131,1243
3404-001,2014,6,19,14,618,624,1242,1131
3404-001,2014,6,19,15,679,675,1354,1242
3404-001,2014,6,19,16,724,581,1305,1354
3404-001,2014,6,19,17,744,543,1287,1305
3404-001,2014,6,19,18,993,550,1543,1287
3404-001,2014,6,19,19,957,418,1375,1543
3404-001,2014,6,19,20,646,354,1000,1375
3404-001,2014,6,19,21,640,284,924,1000
3404-001,2014,6,19,22,379,190,569,924
3404-001,2014,6,19,23,227,162,389,569
3404-001,2014,6,19,24,138,108,246,389
3404-001,2014,6,20,1,76,65,141,246
3404-001,2014,6,20,2,54,41,95,141
3404-001,2014,6,20,3,42,43,85,95
3404-001,2014,6,20,4,50,60,110,85
3404-001,2014,6,20,5,49,98,147,110
3404-001,2014,6,20,6,124,201,325,147
3404-001,2014,6,20,7,177,570,747,325
3404-001,2014,6,20,8,435,1621,2056,747
3404-001,2014,6,20,9,638,1200,1838,2056
3404-001,2014,6,20,10,593,689,1282,1838
3404-001,2014,6,20,11,668,700,1368,1282
3404-001,2014,6,20,12,685,599,1284,1368
3404-001,2014,6,20,13,596,587,1183,1284
3404-001,2014,6,20,14,627,563,1190,1183
3404-001,2014,6,20,15,743,660,1403,1190
3404-001,2014,6,20,16,742,616,1358,1403
3404-001,2014,6,20,17,752,570,1322,1358
3404-001,2014,6,20,18,1225,533,1758,1322
3404-001,2014,6,20,19,1081,488,1569,1758
3404-001,2014,6,20,20,796,476,1272,1569
3404-001,2014,6,20,21,602,295,897,1272
3404-001,2014,6,20,22,377,237,614,897
3404-001,2014,6,20,23,227,170,397,614
3404-001,2014,6,20,24,98,102,200,397
3404-001,2014,6,21,1,110,69,179,200
3404-001,2014,6,21,2,61,51,112,179
3404-001,2014,6,21,3,55,48,103,112
3404-001,2014,6,21,4,30,53,83,103
3404-001,2014,6,21,5,41,73,114,83
3404-001,2014,6,21,6,98,208,306,114
3404-001,2014,6,21,7,186,393,579,306
3404-001,2014,6,21,8,331,704,1035,579
3404-001,2014,6,21,9,455,713,1168,1035
3404-001,2014,6,21,10,487,536,1023,1168
3404-001,2014,6,21,11,515,542,1057,1023
3404-001,2014,6,21,12,513,480,993,1057
3404-001,2014,6,21,13,448,433,881,993
3404-001,2014,6,21,14,498,453,951,881
3404-001,2014,6,21,15,537,469,1006,951
3404-001,2014,6,21,16,568,450,1018,1006
3404-001,2014,6,21,17,552,383,935,1018
3404-001,2014,6,21,18,792,433,1225,935
3404-001,2014,6,21,19,568,371,939,1225
3404-001,2014,6,21,20,327,277,604,939
3404-001,2014,6,21,21,282,215,497,604
3404-001,2014,6,21,22,191,170,361,497
3404-001,2014,6,21,23,129,138,267,361
3404-001,2014,6,21,24,106,111,217,267
3404-001,2014,6,22,1,76,51,127,217
3404-001,2014,6,22,2,60,40,100,127
3404-001,2014,6,22,3,28,33,61,100
3404-001,2014,6,22,4,34,34,68,61
3404-001,2014,6,22,5,49,51,100,68
3404-001,2014,6,22,6,75,128,203,100
3404-001,2014,6,22,7,106,217,323,203
3404-001,2014,6,22,8,171,274,445,323
3404-001,2014,6,22,9,240,316,556,445
3404-001,2014,6,22,10,244,277,521,556
3404-001,2014,6,22,11,239,307,546,521
3404-001,2014,6,22,12,261,326,587,546
3404-001,2014,6,22,13,273,253,526,587
3404-001,2014,6,22,14,344,317,661,526
3404-001,2014,6,22,15,358,285,643,661
3404-001,2014,6,22,16,385,348,733,643
3404-001,2014,6,22,17,441,322,763,733
3404-001,2014,6,22,18,544,335,879,763
3404-001,2014,6,22,19,425,321,746,879
3404-001,2014,6,22,20,340,269,609,746
3404-001,2014,6,22,21,270,254,524,609
3404-001,2014,6,22,22,193,202,395,524
3404-001,2014,6,22,23,98,160,258,395
3404-001,2014,6,22,24,75,105,180,258
3404-001,2014,6,23,1,48,70,118,180
3404-001,2014,6,23,2,29,70,99,118
3404-001,2014,6,23,3,19,42,61,99
3404-001,2014,6,23,4,35,51,86,61
3404-001,2014,6,23,5,54,89,143,86
3404-001,2014,6,23,6,106,276,382,143
3404-001,2014,6,23,7,224,665,889,382
3404-001,2014,6,23,8,487,1802,2289,889
3404-001,2014,6,23,9,562,1209,1771,2289
3404-001,2014,6,23,10,594,632,1226,1771
3404-001,2014,6,23,11,637,625,1262,1226
3404-001,2014,6,23,12,570,609,1179,1262
3404-001,2014,6,23,13,462,546,1008,1179
3404-001,2014,6,23,14,562,584,1146,1008
3404-001,2014,6,23,15,690,639,1329,1146
3404-001,2014,6,23,16,734,602,1336,1329
3404-001,2014,6,23,17,660,562,1222,1336
3404-001,2014,6,23,18,979,517,1496,1222
3404-001,2014,6,23,19,879,448,1327,1496
3404-001,2014,6,23,20,666,387,1053,1327
3404-001,2014,6,23,21,629,270,899,1053
3404-001,2014,6,23,22,386,205,591,899
3404-001,2014,6,23,23,257,154,411,591
3404-001,2014,6,23,24,125,86,211,411
3404-001,2014,6,24,1,102,68,170,211
3404-001,2014,6,24,2,73,52,125,170
3404-001,2014,6,24,3,39,49,88,125
3404-001,2014,6,24,4,26,56,82,88
3404-001,2014,6,24,5,60,98,158,82
3404-001,2014,6,24,6,103,230,333,158
3404-001,2014,6,24,7,195,535,730,333
3404-001,2014,6,24,8,472,1661,2133,730
3404-001,2014,6,24,9,680,1173,1853,2133
3404-001,2014,6,24,10,593,690,1283,1853
3404-001,2014,6,24,11,650,650,1300,1283
3404-001,2014,6,24,12,568,624,1192,1300
3404-001,2014,6,24,13,545,530,1075,1192
3404-001,2014,6,24,14,660,614,1274,1075
3404-001,2014,6,24,15,704,704,1408,1274
3404-001,2014,6,24,16,694,599,1293,1408
3404-001,2014,6,24,17,704,532,1236,1293
3404-001,2014,6,24,18,975,558,1533,1236
3404-001,2014,6,24,19,904,477,1381,1533
3404-001,2014,6,24,20,658,390,1048,1381
3404-001,2014,6,24,21,670,278,948,1048
3404-001,2014,6,24,22,405,189,594,948
3404-001,2014,6,24,23,199,158,357,594
3404-001,2014,6,24,24,149,97,246,357
3404-001,2014,6,25,1,76,90,166,246
3404-001,2014,6,25,2,69,64,133,166
3404-001,2014,6,25,3,44,50,94,133
3404-001,2014,6,25,4,45,45,90,94
3404-001,2014,6,25,5,61,81,142,90
3404-001,2014,6,25,6,121,205,326,142
3404-001,2014,6,25,7,219,546,765,326
3404-001,2014,6,25,8,455,1695,2150,765
3404-001,2014,6,25,9,597,1193,1790,2150
3404-001,2014,6,25,10,635,692,1327,1790
3404-001,2014,6,25,11,682,661,1343,1327
3404-001,2014,6,25,12,622,612,1234,1343
3404-001,2014,6,25,13,572,524,1096,1234
3404-001,2014,6,25,14,582,570,1152,1096
3404-001,2014,6,25,15,641,613,1254,1152
3404-001,2014,6,25,16,671,595,1266,1254
3404-001,2014,6,25,17,733,545,1278,1266
3404-001,2014,6,25,18,1048,487,1535,1278
3404-001,2014,6,25,19,998,433,1431,1535
3404-001,2014,6,25,20,676,387,1063,1431
3404-001,2014,6,25,21,582,252,834,1063
3404-001,2014,6,25,22,406,190,596,834
3404-001,2014,6,25,23,214,169,383,596
3404-001,2014,6,25,24,104,108,212,383
3404-001,2014,6,26,1,93,81,174,212
3404-001,2014,6,26,2,71,44,115,174
3404-001,2014,6,26,3,41,53,94,115
3404-001,2014,6,26,4,35,45,80,94
3404-001,2014,6,26,5,49,70,119,80
3404-001,2014,6,26,6,118,207,325,119
3404-001,2014,6,26,7,187,556,743,325
3404-001,2014,6,26,8,442,1675,2117,743
3404-001,2014,6,26,9,654,1182,1836,2117
3404-001,2014,6,26,10,609,687,1296,1836
3404-001,2014,6,26,11,649,657,1306,1296
3404-001,2014,6,26,12,674,591,1265,1306
3404-001,2014,6,26,13,509,509,1018,1265
3404-001,2014,6,26,14,576,596,1172,1018
3404-001,2014,6,26,15,679,650,1329,1172
3404-001,2014,6,26,16,724,610,1334,1329
3404-001,2014,6,26,17,738,536,1274,1334
3404-001,2014,6,26,18,1034,531,1565,1274
3404-001,2014,6,26,19,899,470,1369,1565
3404-001,2014,6,26,20,643,386,1029,1369
3404-001,2014,6,26,21,627,289,916,1029
3404-001,2014,6,26,22,409,222,631,916
3404-001,2014,6,26,23,234,160,394,631
3404-001,2014,6,26,24,117,120,237,394
3404-001,2014,6,27,1,95,85,180,237
3404-001,2014,6,27,2,79,59,138,180
3404-001,2014,6,27,3,48,50,98,138
3404-001,2014,6,27,4,57,69,126,98
3404-001,2014,6,27,5,54,89,143,126
3404-001,2014,6,27,6,133,198,331,143
3404-001,2014,6,27,7,189,563,752,331
3404-001,2014,6,27,8,486,1622,2108,752
3404-001,2014,6,27,9,696,1192,1888,2108
3404-001,2014,6,27,10,635,688,1323,1888
3404-001,2014,6,27,11,623,618,1241,1323
3404-001,2014,6,27,12,626,649,1275,1241
3404-001,2014,6,27,13,637,553,1190,1275
3404-001,2014,6,27,14,580,561,1141,1190
3404-001,2014,6,27,15,692,730,1422,1141
3404-001,2014,6,27,16,742,592,1334,1422
3404-001,2014,6,27,17,771,598,1369,1334
3404-001,2014,6,27,18,1167,523,1690,1369
3404-001,2014,6,27,19,1276,511,1787,1690
3404-001,2014,6,27,20,832,453,1285,1787
3404-001,2014,6,27,21,630,307,937,1285
3404-001,2014,6,27,22,400,240,640,937
3404-001,2014,6,27,23,244,153,397,640
3404-001,2014,6,27,24,119,112,231,397
3404-001,2014,6,28,1,89,72,161,231
3404-001,2014,6,28,2,80,70,150,161
3404-001,2014,6,28,3,47,47,94,150
3404-001,2014,6,28,4,49,66,115,94
3404-001,2014,6,28,5,47,84,131,115
3404-001,2014,6,28,6,116,215,331,131
3404-001,2014,6,28,7,181,382,563,331
3404-001,2014,6,28,8,309,718,1027,563
3404-001,2014,6,28,9,507,690,1197,1027
3404-001,2014,6,28,10,535,573,1108,1197
3404-001,2014,6,28,11,485,584,1069,1108
3404-001,2014,6,28,12,484,492,976,1069
3404-001,2014,6,28,13,432,439,871,976
3404-001,2014,6,28,14,511,498,1009,871
3404-001,2014,6,28,15,514,483,997,1009
3404-001,2014,6,28,16,593,438,1031,997
3404-001,2014,6,28,17,641,400,1041,1031
3404-001,2014,6,28,18,902,433,1335,1041
3404-001,2014,6,28,19,641,354,995,1335
3404-001,2014,6,28,20,371,290,661,995
3404-001,2014,6,28,21,285,223,508,661
3404-001,2014,6,28,22,204,183,387,508
3404-001,2014,6,28,23,165,130,295,387
3404-001,2014,6,28,24,104,87,191,295
3404-001,2014,6,29,1,75,58,133,191
3404-001,2014,6,29,2,61,46,107,133
3404-001,2014,6,29,3,42,21,63,107
3404-001,2014,6,29,4,24,42,66,63
3404-001,2014,6,29,5,29,40,69,66
3404-001,2014,6,29,6,61,103,164,69
3404-001,2014,6,29,7,89,182,271,164
3404-001,2014,6,29,8,156,299,455,271
3404-001,2014,6,29,9,230,292,522,455
3404-001,2014,6,29,10,234,263,497,522
3404-001,2014,6,29,11,252,280,532,497
3404-001,2014,6,29,12,275,289,564,532
3404-001,2014,6,29,13,285,275,560,564
3404-001,2014,6,29,14,294,285,579,560
3404-001,2014,6,29,15,353,299,652,579
3404-001,2014,6,29,16,372,317,689,652
3404-001,2014,6,29,17,426,326,752,689
3404-001,2014,6,29,18,512,274,786,752
3404-001,2014,6,29,19,375,331,706,786
3404-001,2014,6,29,20,283,257,540,706
3404-001,2014,6,29,21,262,242,504,540
3404-001,2014,6,29,22,185,187,372,504
3404-001,2014,6,29,23,114,128,242,372
3404-001,2014,6,29,24,61,97,158,242
3404-001,2014,6,30,1,34,92,126,158
3404-001,2014,6,30,2,29,45,74,126
3404-001,2014,6,30,3,18,66,84,74
3404-001,2014,6,30,4,24,52,76,84
3404-001,2014,6,30,5,42,77,119,76
3404-001,2014,6,30,6,121,266,387,119
3404-001,2014,6,30,7,213,671,884,387
3404-001,2014,6,30,8,460,1831,2291,884
3404-001,2014,6,30,9,588,1208,1796,2291
3404-001,2014,6,30,10,568,619,1187,1796
3404-001,2014,6,30,11,658,656,1314,1187
3404-001,2014,6,30,12,592,587,1179,1314
3404-001,2014,6,30,13,483,526,1009,1179
3404-001,2014,6,30,14,560,582,1142,1009
3404-001,2014,6,30,15,651,600,1251,1142
3404-001,2014,6,30,16,666,649,1315,1251
3404-001,2014,6,30,17,747,557,1304,1315
3404-001,2014,6,30,18,965,519,1484,1304
3404-001,2014,6,30,19,904,447,1351,1484
3404-001,2014,6,30,20,698,388,1086,1351
3404-001,2014,6,30,21,649,276,925,1086
3404-001,2014,6,30,22,442,218,660,925
3404-001,2014,6,30,23,214,161,375,660
3404-001,2014,6,30,24,104,102,206,375
3404-001,2014,7,1,1,77,71,148,206
3404-001,2014,7,1,2,67,57,124,148
3404-001,2014,7,1,3,37,50,87,124
3404-001,2014,7,1,4,45,59,104,87
3404-001,2014,7,1,5,64,79,143,104
3404-001,2014,7,1,6,110,225,335,143
3404-001,2014,7,1,7,183,544,727,335
3404-001,2014,7,1,8,483,1652,2135,727
3404-001,2014,7,1,9,670,1111,1781,2135
3404-001,2014,7,1,10,569,662,1231,1781
3404-001,2014,7,1,11,573,659,1232,1231
3404-001,2014,7,1,12,606,624,1230,1232
3404-001,2014,7,1,13,505,500,1005,1230
3404-001,2014,7,1,14,593,567,1160,1005
3404-001,2014,7,1,15,631,610,1241,1160
3404-001,2014,7,1,16,656,602,1258,1241
3404-001,2014,7,1,17,701,495,1196,1258
3404-001,2014,7,1,18,942,556,1498,1196
3404-001,2014,7,1,19,957,451,1408,1498
3404-001,2014,7,1,20,731,359,1090,1408
3404-001,2014,7,1,21,626,258,884,1090
3404-001,2014,7,1,22,371,210,581,884
3404-001,2014,7,1,23,238,163,401,581
3404-001,2014,7,1,24,125,108,233,401
3404-001,2014,7,2,1,85,67,152,233
3404-001,2014,7,2,2,61,51,112,152
3404-001,2014,7,2,3,42,45,87,112
3404-001,2014,7,2,4,40,51,91,87
3404-001,2014,7,2,5,51,88,139,91
3404-001,2014,7,2,6,129,208,337,139
3404-001,2014,7,2,7,202,576,778,337
3404-001,2014,7,2,8,498,1651,2149,778
3404-001,2014,7,2,9,621,1161,1782,2149
3404-001,2014,7,2,10,640,733,1373,1782
3404-001,2014,7,2,11,657,698,1355,1373
3404-001,2014,7,2,12,611,618,1229,1355
3404-001,2014,7,2,13,551,499,1050,1229
3404-001,2014,7,2,14,560,662,1222,1050
3404-001,2014,7,2,15,737,649,1386,1222
3404-001,2014,7,2,16,694,616,1310,1386
3404-001,2014,7,2,17,727,527,1254,1310
3404-001,2014,7,2,18,1125,554,1679,1254
3404-001,2014,7,2,19,974,438,1412,1679
3404-001,2014,7,2,20,677,381,1058,1412
3404-001,2014,7,2,21,561,243,804,1058
3404-001,2014,7,2,22,342,193,535,804
3404-001,2014,7,2,23,191,147,338,535
3404-001,2014,7,2,24,129,93,222,338
3404-001,2014,7,3,1,85,66,151,222
3404-001,2014,7,3,2,64,52,116,151
3404-001,2014,7,3,3,32,48,80,116
3404-001,2014,7,3,4,29,37,66,80
3404-001,2014,7,3,5,50,53,103,66
3404-001,2014,7,3,6,89,134,223,103
3404-001,2014,7,3,7,196,510,706,223
3404-001,2014,7,3,8,439,1590,2029,706
3404-001,2014,7,3,9,623,1197,1820,2029
3404-001,2014,7,3,10,585,656,1241,1820
3404-001,2014,7,3,11,622,662,1284,1241
3404-001,2014,7,3,12,598,588,1186,1284
3404-001,2014,7,3,13,519,499,1018,1186
3404-001,2014,7,3,14,562,577,1139,1018
3404-001,2014,7,3,15,635,662,1297,1139
3404-001,2014,7,3,16,730,579,1309,1297
3404-001,2014,7,3,17,652,541,1193,1309
3404-001,2014,7,3,18,948,467,1415,1193
3404-001,2014,7,3,19,889,433,1322,1415
3404-001,2014,7,3,20,646,366,1012,1322
3404-001,2014,7,3,21,611,236,847,1012
3404-001,2014,7,3,22,361,207,568,847
3404-001,2014,7,3,23,219,134,353,568
3404-001,2014,7,3,24,104,97,201,353
3404-001,2014,7,4,1,88,75,163,201
3404-001,2014,7,4,2,53,53,106,163
3404-001,2014,7,4,3,42,42,84,106
3404-001,2014,7,4,4,38,62,100,84
3404-001,2014,7,4,5,50,84,134,100
3404-001,2014,7,4,6,111,229,340,134
3404-001,2014,7,4,7,255,584,839,340
3404-001,2014,7,4,8,452,1636,2088,839
3404-001,2014,7,4,9,665,1222,1887,2088
3404-001,2014,7,4,10,605,704,1309,1887
3404-001,2014,7,4,11,682,701,1383,1309
3404-001,2014,7,4,12,711,664,1375,1383
3404-001,2014,7,4,13,592,508,1100,1375
3404-001,2014,7,4,14,609,649,1258,1100
3404-001,2014,7,4,15,732,663,1395,1258
3404-001,2014,7,4,16,755,639,1394,1395
3404-001,2014,7,4,17,811,608,1419,1394
3404-001,2014,7,4,18,1204,560,1764,1419
3404-001,2014,7,4,19,1178,511,1689,1764
3404-001,2014,7,4,20,821,495,1316,1689
3404-001,2014,7,4,21,596,329,925,1316
3404-001,2014,7,4,22,436,205,641,925
3404-001,2014,7,4,23,220,160,380,641
3404-001,2014,7,4,24,150,118,268,380
3404-001,2014,7,5,1,106,83,189,268
3404-001,2014,7,5,2,61,43,104,189
3404-001,2014,7,5,3,48,56,104,104
3404-001,2014,7,5,4,49,53,102,104
3404-001,2014,7,5,5,46,78,124,102
3404-001,2014,7,5,6,115,229,344,124
3404-001,2014,7,5,7,197,406,603,344
3404-001,2014,7,5,8,325,746,1071,603
3404-001,2014,7,5,9,519,652,1171,1071
3404-001,2014,7,5,10,532,585,1117,1171
3404-001,2014,7,5,11,515,567,1082,1117
3404-001,2014,7,5,12,529,505,1034,1082
3404-001,2014,7,5,13,501,441,942,1034
3404-001,2014,7,5,14,473,462,935,942
3404-001,2014,7,5,15,538,474,1012,935
3404-001,2014,7,5,16,560,416,976,1012
3404-001,2014,7,5,17,589,423,1012,976
3404-001,2014,7,5,18,783,419,1202,1012
3404-001,2014,7,5,19,599,358,957,1202
3404-001,2014,7,5,20,353,286,639,957
3404-001,2014,7,5,21,282,190,472,639
3404-001,2014,7,5,22,177,164,341,472
3404-001,2014,7,5,23,148,103,251,341
3404-001,2014,7,5,24,66,76,142,251
3404-001,2014,7,6,1,54,52,106,142
3404-001,2014,7,6,2,54,39,93,106
3404-001,2014,7,6,3,25,37,62,93
3404-001,2014,7,6,4,25,19,44,62
3404-001,2014,7,6,5,26,38,64,44
3404-001,2014,7,6,6,53,96,149,64
3404-001,2014,7,6,7,91,182,273,149
3404-001,2014,7,6,8,210,273,483,273
3404-001,2014,7,6,9,262,264,526,483
3404-001,2014,7,6,10,214,273,487,526
3404-001,2014,7,6,11,286,287,573,487
3404-001,2014,7,6,12,293,318,611,573
3404-001,2014,7,6,13,319,321,640,611
3404-001,2014,7,6,14,305,303,608,640
3404-001,2014,7,6,15,383,349,732,608
3404-001,2014,7,6,16,396,348,744,732
3404-001,2014,7,6,17,424,309,733,744
3404-001,2014,7,6,18,461,315,776,733
3404-001,2014,7,6,19,332,319,651,776
3404-001,2014,7,6,20,307,259,566,651
3404-001,2014,7,6,21,255,225,480,566
3404-001,2014,7,6,22,173,203,376,480
3404-001,2014,7,6,23,82,153,235,376
3404-001,2014,7,6,24,65,119,184,235
3404-001,2014,7,7,1,61,64,125,184
3404-001,2014,7,7,2,30,55,85,125
3404-001,2014,7,7,3,22,47,69,85
3404-001,2014,7,7,4,35,44,79,69
3404-001,2014,7,7,5,34,82,116,79
3404-001,2014,7,7,6,122,238,360,116
3404-001,2014,7,7,7,232,647,879,360
3404-001,2014,7,7,8,489,1882,2371,879
3404-001,2014,7,7,9,592,1242,1834,2371
3404-001,2014,7,7,10,594,636,1230,1834
3404-001,2014,7,7,11,612,697,1309,1230
3404-001,2014,7,7,12,598,578,1176,1309
3404-001,2014,7,7,13,495,536,1031,1176
3404-001,2014,7,7,14,586,625,1211,1031
3404-001,2014,7,7,15,752,663,1415,1211
3404-001,2014,7,7,16,711,645,1356,1415
3404-001,2014,7,7,17,706,601,1307,1356
3404-001,2014,7,7,18,964,505,1469,1307
3404-001,2014,7,7,19,936,467,1403,1469
3404-001,2014,7,7,20,768,405,1173,1403
3404-001,2014,7,7,21,643,251,894,1173
3404-001,2014,7,7,22,381,219,600,894
3404-001,2014,7,7,23,210,141,351,600
3404-001,2014,7,7,24,121,102,223,351
3404-001,2014,7,8,1,89,89,178,223
3404-001,2014,7,8,2,54,63,117,178
3404-001,2014,7,8,3,44,40,84,117
3404-001,2014,7,8,4,37,50,87,84
3404-001,2014,7,8,5,49,83,132,87
3404-001,2014,7,8,6,106,195,301,132
3404-001,2014,7,8,7,183,486,669,301
3404-001,2014,7,8,8,459,1637,2096,669
3404-001,2014,7,8,9,676,1185,1861,2096
3404-001,2014,7,8,10,633,675,1308,1861
3404-001,2014,7,8,11,636,690,1326,1308
3404-001,2014,7,8,12,611,652,1263,1326
3404-001,2014,7,8,13,574,538,1112,1263
3404-001,2014,7,8,14,599,632,1231,1112
3404-001,2014,7,8,15,704,666,1370,1231
3404-001,2014,7,8,16,725,659,1384,1370
3404-001,2014,7,8,17,749,590,1339,1384
3404-001,2014,7,8,18,944,493,1437,1339
3404-001,2014,7,8,19,979,434,1413,1437
3404-001,2014,7,8,20,719,365,1084,1413
3404-001,2014,7,8,21,676,262,938,1084
3404-001,2014,7,8,22,388,204,592,938
3404-001,2014,7,8,23,208,141,349,592
3404-001,2014,7,8,24,105,114,219,349
3404-001,2014,7,9,1,79,74,153,219
3404-001,2014,7,9,2,52,50,102,153
3404-001,2014,7,9,3,35,38,73,102
3404-001,2014,7,9,4,37,49,86,73
3404-001,2014,7,9,5,49,78,127,86
3404-001,2014,7,9,6,116,190,306,127
3404-001,2014,7,9,7,190,534,724,306
3404-001,2014,7,9,8,445,1663,2108,724
3404-001,2014,7,9,9,682,1152,1834,2108
3404-001,2014,7,9,10,550,644,1194,1834
3404-001,2014,7,9,11,638,622,1260,1194
3404-001,2014,7,9,12,556,648,1204,1260
3404-001,2014,7,9,13,507,460,967,1204
3404-001,2014,7,9,14,572,583,1155,967
3404-001,2014,7,9,15,667,645,1312,1155
3404-001,2014,7,9,16,685,570,1255,1312
3404-001,2014,7,9,17,721,523,1244,1255
3404-001,2014,7,9,18,1089,500,1589,1244
3404-001,2014,7,9,19,996,413,1409,1589
3404-001,2014,7,9,20,639,375,1014,1409
3404-001,2014,7,9,21,561,239,800,1014
3404-001,2014,7,9,22,324,217,541,800
3404-001,2014,7,9,23,182,142,324,541
3404-001,2014,7,9,24,98,94,192,324
3404-001,2014,7,10,1,74,69,143,192
3404-001,2014,7,10,2,68,51,119,143
3404-001,2014,7,10,3,34,48,82,119
3404-001,2014,7,10,4,39,59,98,82
3404-001,2014,7,10,5,47,54,101,98
3404-001,2014,7,10,6,98,192,290,101
3404-001,2014,7,10,7,201,531,732,290
3404-001,2014,7,10,8,458,1609,2067,732
3404-001,2014,7,10,9,616,1236,1852,2067
3404-001,2014,7,10,10,600,632,1232,1852
3404-001,2014,7,10,11,660,657,1317,1232
3404-001,2014,7,10,12,591,657,1248,1317
3404-001,2014,7,10,13,553,524,1077,1248
3404-001,2014,7,10,14,523,554,1077,1077
3404-001,2014,7,10,15,610,636,1246,1077
3404-001,2014,7,10,16,677,638,1315,1246
3404-001,2014,7,10,17,740,552,1292,1315
3404-001,2014,7,10,18,1060,588,1648,1292
3404-001,2014,7,10,19,974,456,1430,1648
3404-001,2014,7,10,20,696,383,1079,1430
3404-001,2014,7,10,21,624,286,910,1079
3404-001,2014,7,10,22,381,209,590,910
3404-001,2014,7,10,23,197,138,335,590
3404-001,2014,7,10,24,130,123,253,335
3404-001,2014,7,11,1,94,70,164,253
3404-001,2014,7,11,2,70,47,117,164
3404-001,2014,7,11,3,38,49,87,117
3404-001,2014,7,11,4,38,69,107,87
3404-001,2014,7,11,5,45,87,132,107
3404-001,2014,7,11,6,130,198,328,132
3404-001,2014,7,11,7,246,564,810,328
3404-001,2014,7,11,8,448,1590,2038,810
3404-001,2014,7,11,9,650,1195,1845,2038
3404-001,2014,7,11,10,618,706,1324,1845
3404-001,2014,7,11,11,666,688,1354,1324
3404-001,2014,7,11,12,644,638,1282,1354
3404-001,2014,7,11,13,549,552,1101,1282
3404-001,2014,7,11,14,603,630,1233,1101
3404-001,2014,7,11,15,758,655,1413,1233
3404-001,2014,7,11,16,754,648,1402,1413
3404-001,2014,7,11,17,794,597,1391,1402
3404-001,2014,7,11,18,1231,585,1816,1391
3404-001,2014,7,11,19,1247,490,1737,1816
3404-001,2014,7,11,20,845,464,1309,1737
3404-001,2014,7,11,21,644,308,952,1309
3404-001,2014,7,11,22,376,204,580,952
3404-001,2014,7,11,23,222,178,400,580
3404-001,2014,7,11,24,141,141,282,400
3404-001,2014,7,12,1,100,84,184,282
3404-001,2014,7,12,2,78,55,133,184
3404-001,2014,7,12,3,46,51,97,133
3404-001,2014,7,12,4,41,60,101,97
3404-001,2014,7,12,5,69,85,154,101
3404-001,2014,7,12,6,120,229,349,154
3404-001,2014,7,12,7,182,362,544,349
3404-001,2014,7,12,8,339,683,1022,544
3404-001,2014,7,12,9,469,649,1118,1022
3404-001,2014,7,12,10,495,502,997,1118
3404-001,2014,7,12,11,492,608,1100,997
3404-001,2014,7,12,12,524,503,1027,1100
3404-001,2014,7,12,13,469,494,963,1027
3404-001,2014,7,12,14,527,457,984,963
3404-001,2014,7,12,15,506,468,974,984
3404-001,2014,7,12,16,541,434,975,974
3404-001,2014,7,12,17,588,412,1000,975
3404-001,2014,7,12,18,768,435,1203,1000
3404-001,2014,7,12,19,549,372,921,1203
3404-001,2014,7,12,20,353,296,649,921
3404-001,2014,7,12,21,256,226,482,649
3404-001,2014,7,12,22,184,192,376,482
3404-001,2014,7,12,23,139,142,281,376
3404-001,2014,7,12,24,98,88,186,281
3404-001,2014,7,13,1,69,60,129,186
3404-001,2014,7,13,2,48,42,90,129
3404-001,2014,7,13,3,46,36,82,90
3404-001,2014,7,13,4,28,23,51,82
3404-001,2014,7,13,5,27,30,57,51
3404-001,2014,7,13,6,61,78,139,57
3404-001,2014,7,13,7,85,169,254,139
3404-001,2014,7,13,8,160,197,357,254
3404-001,2014,7,13,9,224,260,484,357
3404-001,2014,7,13,10,231,277,508,484
3404-001,2014,7,13,11,278,306,584,508
3404-001,2014,7,13,12,265,330,595,584
3404-001,2014,7,13,13,322,279,601,595
3404-001,2014,7,13,14,310,311,621,601
3404-001,2014,7,13,15,350,285,635,621
3404-001,2014,7,13,16,446,353,799,635
3404-001,2014,7,13,17,452,340,792,799
3404-001,2014,7,13,18,462,309,771,792
3404-001,2014,7,13,19,417,272,689,771
3404-001,2014,7,13,20,322,291,613,689
3404-001,2014,7,13,21,266,250,516,613
3404-001,2014,7,13,22,194,227,421,516
3404-001,2014,7,13,23,102,148,250,421
3404-001,2014,7,13,24,61,130,191,250
3404-001,2014,7,14,1,51,82,133,191
3404-001,2014,7,14,2,33,43,76,133
3404-001,2014,7,14,3,23,49,72,76
3404-001,2014,7,14,4,27,54,81,72
3404-001,2014,7,14,5,41,67,108,81
3404-001,2014,7,14,6,114,227,341,108
3404-001,2014,7,14,7,222,601,823,341
3404-001,2014,7,14,8,516,1872,2388,823
3404-001,2014,7,14,9,546,1190,1736,2388
3404-001,2014,7,14,10,547,642,1189,1736
3404-001,2014,7,14,11,581,609,1190,1189
3404-001,2014,7,14,12,603,602,1205,1190
3404-001,2014,7,14,13,489,509,998,1205
3404-001,2014,7,14,14,547,576,1123,998
3404-001,2014,7,14,15,658,626,1284,1123
3404-001,2014,7,14,16,674,616,1290,1284
3404-001,2014,7,14,17,701,569,1270,1290
3404-001,2014,7,14,18,897,470,1367,1270
3404-001,2014,7,14,19,1009,481,1490,1367
3404-001,2014,7,14,20,664,380,1044,1490
3404-001,2014,7,14,21,642,267,909,1044
3404-001,2014,7,14,22,403,220,623,909
3404-001,2014,7,14,23,210,132,342,623
3404-001,2014,7,14,24,120,94,214,342
3404-001,2014,7,15,1,90,83,173,214
3404-001,2014,7,15,2,56,58,114,173
3404-001,2014,7,15,3,33,38,71,114
3404-001,2014,7,15,4,47,57,104,71
3404-001,2014,7,15,5,67,86,153,104
3404-001,2014,7,15,6,119,210,329,153
3404-001,2014,7,15,7,214,539,753,329
3404-001,2014,7,15,8,469,1581,2050,753
3404-001,2014,7,15,9,653,1170,1823,2050
3404-001,2014,7,15,10,599,710,1309,1823
3404-001,2014,7,15,11,603,669,1272,1309
3404-001,2014,7,15,12,605,641,1246,1272
3404-001,2014,7,15,13,564,510,1074,1246
3404-001,2014,7,15,14,577,603,1180,1074
3404-001,2014,7,15,15,636,647,1283,1180
3404-001,2014,7,15,16,720,635,1355,1283
3404-001,2014,7,15,17,804,561,1365,1355
3404-001,2014,7,15,18,963,487,1450,1365
3404-001,2014,7,15,19,967,434,1401,1450
3404-001,2014,7,15,20,661,398,1059,1401
3404-001,2014,7,15,21,616,260,876,1059
3404-001,2014,7,15,22,367,194,561,876
3404-001,2014,7,15,23,258,196,454,561
3404-001,2014,7,15,24,130,129,259,454
3404-001,2014,7,16,1,77,124,201,259
3404-001,2014,7,16,2,79,57,136,201
3404-001,2014,7,16,3,37,37,74,136
3404-001,2014,7,16,4,38,72,110,74
3404-001,2014,7,16,5,38,80,118,110
3404-001,2014,7,16,6,124,192,316,118
3404-001,2014,7,16,7,200,554,754,316
3404-001,2014,7,16,8,462,1562,2024,754
3404-001,2014,7,16,9,671,1212,1883,2024
3404-001,2014,7,16,10,571,694,1265,1883
3404-001,2014,7,16,11,674,653,1327,1265
3404-001,2014,7,16,12,613,601,1214,1327
3404-001,2014,7,16,13,538,518,1056,1214
3404-001,2014,7,16,14,534,580,1114,1056
3404-001,2014,7,16,15,677,615,1292,1114
3404-001,2014,7,16,16,706,533,1239,1292
3404-001,2014,7,16,17,768,576,1344,1239
3404-001,2014,7,16,18,1057,513,1570,1344
3404-001,2014,7,16,19,1024,481,1505,1570
3404-001,2014,7,16,20,674,366,1040,1505
3404-001,2014,7,16,21,553,260,813,1040
3404-001,2014,7,16,22,343,210,553,813
3404-001,2014,7,16,23,199,140,339,553
3404-001,2014,7,16,24,123,107,230,339
3404-001,2014,7,17,1,69,77,146,230
3404-001,2014,7,17,2,59,47,106,146
3404-001,2014,7,17,3,40,46,86,106
3404-001,2014,7,17,4,41,58,99,86
3404-001,2014,7,17,5,54,86,140,99
3404-001,2014,7,17,6,124,245,369,140
3404-001,2014,7,17,7,199,477,676,369
3404-001,2014,7,17,8,470,1517,1987,676
3404-001,2014,7,17,9,613,1181,1794,1987
3404-001,2014,7,17,10,591,639,1230,1794
3404-001,2014,7,17,11,631,660,1291,1230
3404-001,2014,7,17,12,618,600,1218,1291
3404-001,2014,7,17,13,489,501,990,1218
3404-001,2014,7,17,14,551,594,1145,990
3404-001,2014,7,17,15,661,623,1284,1145
3404-001,2014,7,17,16,692,568,1260,1284
3404-001,2014,7,17,17,705,528,1233,1260
3404-001,2014,7,17,18,949,513,1462,1233
3404-001,2014,7,17,19,926,489,1415,1462
3404-001,2014,7,17,20,640,332,972,1415
3404-001,2014,7,17,21,552,263,815,972
3404-001,2014,7,17,22,367,214,581,815
3404-001,2014,7,17,23,202,135,337,581
3404-001,2014,7,17,24,109,94,203,337
3404-001,2014,7,18,1,88,65,153,203
3404-001,2014,7,18,2,59,55,114,153
3404-001,2014,7,18,3,42,44,86,114
3404-001,2014,7,18,4,41,48,89,86
3404-001,2014,7,18,5,42,66,108,89
3404-001,2014,7,18,6,95,124,219,108
3404-001,2014,7,18,7,160,399,559,219
3404-001,2014,7,18,8,423,1452,1875,559
3404-001,2014,7,18,9,621,1282,1903,1875
3404-001,2014,7,18,10,573,663,1236,1903
3404-001,2014,7,18,11,657,655,1312,1236
3404-001,2014,7,18,12,610,597,1207,1312
3404-001,2014,7,18,13,548,498,1046,1207
3404-001,2014,7,18,14,574,539,1113,1046
3404-001,2014,7,18,15,677,607,1284,1113
3404-001,2014,7,18,16,691,610,1301,1284
3404-001,2014,7,18,17,804,540,1344,1301
3404-001,2014,7,18,18,1066,579,1645,1344
3404-001,2014,7,18,19,1094,531,1625,1645
3404-001,2014,7,18,20,835,433,1268,1625
3404-001,2014,7,18,21,630,328,958,1268
3404-001,2014,7,18,22,367,232,599,958
3404-001,2014,7,18,23,224,167,391,599
3404-001,2014,7,18,24,128,111,239,391
3404-001,2014,7,19,1,92,77,169,239
3404-001,2014,7,19,2,61,58,119,169
3404-001,2014,7,19,3,46,58,104,119
3404-001,2014,7,19,4,38,72,110,104
3404-001,2014,7,19,5,49,80,129,110
3404-001,2014,7,19,6,85,185,270,129
3404-001,2014,7,19,7,164,311,475,270
3404-001,2014,7,19,8,329,668,997,475
3404-001,2014,7,19,9,465,600,1065,997
3404-001,2014,7,19,10,430,487,917,1065
3404-001,2014,7,19,11,467,486,953,917
3404-001,2014,7,19,12,473,474,947,953
3404-001,2014,7,19,13,467,458,925,947
3404-001,2014,7,19,14,468,446,914,925
3404-001,2014,7,19,15,457,424,881,914
3404-001,2014,7,19,16,478,380,858,881
3404-001,2014,7,19,17,555,393,948,858
3404-001,2014,7,19,18,755,404,1159,948
3404-001,2014,7,19,19,479,345,824,1159
3404-001,2014,7,19,20,332,275,607,824
3404-001,2014,7,19,21,267,251,518,607
3404-001,2014,7,19,22,199,165,364,518
3404-001,2014,7,19,23,137,117,254,364
3404-001,2014,7,19,24,80,79,159,254
3404-001,2014,7,20,1,56,70,126,159
3404-001,2014,7,20,2,54,45,99,126
3404-001,2014,7,20,3,29,27,56,99
3404-001,2014,7,20,4,35,23,58,56
3404-001,2014,7,20,5,27,33,60,58
3404-001,2014,7,20,6,55,92,147,60
3404-001,2014,7,20,7,67,176,243,147
3404-001,2014,7,20,8,181,247,428,243
3404-001,2014,7,20,9,266,237,503,428
3404-001,2014,7,20,10,289,253,542,503
3404-001,2014,7,20,11,338,317,655,542
3404-001,2014,7,20,12,284,291,575,655
3404-001,2014,7,20,13,278,356,634,575
3404-001,2014,7,20,14,288,320,608,634
3404-001,2014,7,20,15,330,301,631,608
3404-001,2014,7,20,16,366,294,660,631
3404-001,2014,7,20,17,426,307,733,660
3404-001,2014,7,20,18,464,311,775,733
3404-001,2014,7,20,19,369,297,666,775
3404-001,2014,7,20,20,300,274,574,666
3404-001,2014,7,20,21,266,297,563,574
3404-001,2014,7,20,22,198,225,423,563
3404-001,2014,7,20,23,108,159,267,423
3404-001,2014,7,20,24,76,117,193,267
3404-001,2014,7,21,1,32,81,113,193
3404-001,2014,7,21,2,34,41,75,113
3404-001,2014,7,21,3,16,45,61,75
3404-001,2014,7,21,4,36,54,90,61
3404-001,2014,7,21,5,31,68,99,90
3404-001,2014,7,21,6,104,241,345,99
3404-001,2014,7,21,7,236,630,866,345
3404-001,2014,7,21,8,498,1758,2256,866
3404-001,2014,7,21,9,582,1258,1840,2256
3404-001,2014,7,21,10,554,604,1158,1840
3404-001,2014,7,21,11,587,517,1104,1158
3404-001,2014,7,21,12,554,579,1133,1104
3404-001,2014,7,21,13,506,513,1019,1133
3404-001,2014,7,21,14,607,534,1141,1019
3404-001,2014,7,21,15,662,607,1269,1141
3404-001,2014,7,21,16,635,644,1279,1269
3404-001,2014,7,21,17,741,489,1230,1279
3404-001,2014,7,21,18,959,545,1504,1230
3404-001,2014,7,21,19,979,475,1454,1504
3404-001,2014,7,21,20,700,416,1116,1454
3404-001,2014,7,21,21,672,256,928,1116
3404-001,2014,7,21,22,410,208,618,928
3404-001,2014,7,21,23,189,134,323,618
3404-001,2014,7,21,24,120,110,230,323
3404-001,2014,7,22,1,73,60,133,230
3404-001,2014,7,22,2,71,44,115,133
3404-001,2014,7,22,3,42,54,96,115
3404-001,2014,7,22,4,33,65,98,96
3404-001,2014,7,22,5,58,96,154,98
3404-001,2014,7,22,6,108,193,301,154
3404-001,2014,7,22,7,188,529,717,301
3404-001,2014,7,22,8,477,1607,2084,717
3404-001,2014,7,22,9,638,1222,1860,2084
3404-001,2014,7,22,10,629,660,1289,1860
3404-001,2014,7,22,11,625,668,1293,1289
3404-001,2014,7,22,12,600,612,1212,1293
3404-001,2014,7,22,13,544,519,1063,1212
3404-001,2014,7,22,14,576,550,1126,1063
3404-001,2014,7,22,15,644,694,1338,1126
3404-001,2014,7,22,16,724,618,1342,1338
3404-001,2014,7,22,17,748,554,1302,1342
3404-001,2014,7,22,18,1005,507,1512,1302
3404-001,2014,7,22,19,1046,520,1566,1512
3404-001,2014,7,22,20,707,377,1084,1566
3404-001,2014,7,22,21,645,230,875,1084
3404-001,2014,7,22,22,364,209,573,875
3404-001,2014,7,22,23,195,115,310,573
3404-001,2014,7,22,24,99,106,205,310
3404-001,2014,7,23,1,81,89,170,205
3404-001,2014,7,23,2,56,54,110,170
3404-001,2014,7,23,3,51,39,90,110
3404-001,2014,7,23,4,54,44,98,90
3404-001,2014,7,23,5,46,70,116,98
3404-001,2014,7,23,6,100,146,246,116
3404-001,2014,7,23,7,138,416,554,246
3404-001,2014,7,23,8,376,1463,1839,554
3404-001,2014,7,23,9,593,1140,1733,1839
3404-001,2014,7,23,10,517,565,1082,1733
3404-001,2014,7,23,11,580,575,1155,1082
3404-001,2014,7,23,12,556,540,1096,1155
3404-001,2014,7,23,13,497,455,952,1096
3404-001,2014,7,23,14,571,534,1105,952
3404-001,2014,7,23,15,667,651,1318,1105
3404-001,2014,7,23,16,661,591,1252,1318
3404-001,2014,7,23,17,637,498,1135,1252
3404-001,2014,7,23,18,920,473,1393,1135
3404-001,2014,7,23,19,928,417,1345,1393
3404-001,2014,7,23,20,634,390,1024,1345
3404-001,2014,7,23,21,464,218,682,1024
3404-001,2014,7,23,22,311,166,477,682
3404-001,2014,7,23,23,189,148,337,477
3404-001,2014,7,23,24,110,104,214,337
3404-001,2014,7,24,1,79,62,141,214
3404-001,2014,7,24,2,63,44,107,141
3404-001,2014,7,24,3,53,31,84,107
3404-001,2014,7,24,4,34,48,82,84
3404-001,2014,7,24,5,40,64,104,82
3404-001,2014,7,24,6,86,170,256,104
3404-001,2014,7,24,7,167,424,591,256
3404-001,2014,7,24,8,399,1501,1900,591
3404-001,2014,7,24,9,649,1192,1841,1900
3404-001,2014,7,24,10,567,627,1194,1841
3404-001,2014,7,24,11,571,647,1218,1194
3404-001,2014,7,24,12,632,629,1261,1218
3404-001,2014,7,24,13,494,508,1002,1261
3404-001,2014,7,24,14,577,557,1134,1002
3404-001,2014,7,24,15,689,660,1349,1134
3404-001,2014,7,24,16,729,637,1366,1349
3404-001,2014,7,24,17,702,550,1252,1366
3404-001,2014,7,24,18,918,499,1417,1252
3404-001,2014,7,24,19,928,459,1387,1417
3404-001,2014,7,24,20,655,408,1063,1387
3404-001,2014,7,24,21,645,261,906,1063
3404-001,2014,7,24,22,375,235,610,906
3404-001,2014,7,24,23,195,156,351,610
3404-001,2014,7,24,24,135,86,221,351
3404-001,2014,7,25,1,102,75,177,221
3404-001,2014,7,25,2,64,51,115,177
3404-001,2014,7,25,3,44,47,91,115
3404-001,2014,7,25,4,53,46,99,91
3404-001,2014,7,25,5,52,68,120,99
3404-001,2014,7,25,6,96,171,267,120
3404-001,2014,7,25,7,155,440,595,267
3404-001,2014,7,25,8,443,1530,1973,595
3404-001,2014,7,25,9,634,1091,1725,1973
3404-001,2014,7,25,10,581,627,1208,1725
3404-001,2014,7,25,11,624,596,1220,1208
3404-001,2014,7,25,12,551,544,1095,1220
3404-001,2014,7,25,13,559,484,1043,1095
3404-001,2014,7,25,14,546,564,1110,1043
3404-001,2014,7,25,15,653,648,1301,1110
3404-001,2014,7,25,16,726,585,1311,1301
3404-001,2014,7,25,17,666,558,1224,1311
3404-001,2014,7,25,18,1020,528,1548,1224
3404-001,2014,7,25,19,1133,496,1629,1548
3404-001,2014,7,25,20,777,418,1195,1629
3404-001,2014,7,25,21,608,342,950,1195
3404-001,2014,7,25,22,364,192,556,950
3404-001,2014,7,25,23,183,163,346,556
3404-001,2014,7,25,24,112,106,218,346
3404-001,2014,7,26,1,76,67,143,218
3404-001,2014,7,26,2,64,40,104,143
3404-001,2014,7,26,3,31,52,83,104
3404-001,2014,7,26,4,34,47,81,83
3404-001,2014,7,26,5,44,70,114,81
3404-001,2014,7,26,6,89,190,279,114
3404-001,2014,7,26,7,135,306,441,279
3404-001,2014,7,26,8,269,665,934,441
3404-001,2014,7,26,9,454,598,1052,934
3404-001,2014,7,26,10,451,501,952,1052
3404-001,2014,7,26,11,519,501,1020,952
3404-001,2014,7,26,12,486,431,917,1020
3404-001,2014,7,26,13,494,425,919,917
3404-001,2014,7,26,14,462,448,910,919
3404-001,2014,7,26,15,491,448,939,910
3404-001,2014,7,26,16,483,385,868,939
3404-001,2014,7,26,17,535,367,902,868
3404-001,2014,7,26,18,703,370,1073,902
3404-001,2014,7,26,19,479,328,807,1073
3404-001,2014,7,26,20,321,276,597,807
3404-001,2014,7,26,21,281,234,515,597
3404-001,2014,7,26,22,215,139,354,515
3404-001,2014,7,26,23,122,144,266,354
3404-001,2014,7,26,24,79,84,163,266
3404-001,2014,7,27,1,63,55,118,163
3404-001,2014,7,27,2,48,38,86,118
3404-001,2014,7,27,3,28,44,72,86
3404-001,2014,7,27,4,25,28,53,72
3404-001,2014,7,27,5,32,41,73,53
3404-001,2014,7,27,6,44,86,130,73
3404-001,2014,7,27,7,78,155,233,130
3404-001,2014,7,27,8,146,280,426,233
3404-001,2014,7,27,9,205,243,448,426
3404-001,2014,7,27,10,219,249,468,448
3404-001,2014,7,27,11,225,295,520,468
3404-001,2014,7,27,12,233,273,506,520
3404-001,2014,7,27,13,281,263,544,506
3404-001,2014,7,27,14,263,234,497,544
3404-001,2014,7,27,15,317,278,595,497
3404-001,2014,7,27,16,356,299,655,595
3404-001,2014,7,27,17,408,276,684,655
3404-001,2014,7,27,18,430,293,723,684
3404-001,2014,7,27,19,393,255,648,723
3404-001,2014,7,27,20,305,266,571,648
3404-001,2014,7,27,21,274,266,540,571
3404-001,2014,7,27,22,175,199,374,540
3404-001,2014,7,27,23,101,150,251,374
3404-001,2014,7,27,24,84,104,188,251
3404-001,2014,7,28,1,47,77,124,188
3404-001,2014,7,28,2,34,42,76,124
3404-001,2014,7,28,3,23,44,67,76
3404-001,2014,7,28,4,31,47,78,67
3404-001,2014,7,28,5,46,68,114,78
3404-001,2014,7,28,6,97,234,331,114
3404-001,2014,7,28,7,229,598,827,331
3404-001,2014,7,28,8,448,1726,2174,827
3404-001,2014,7,28,9,513,1224,1737,2174
3404-001,2014,7,28,10,567,650,1217,1737
3404-001,2014,7,28,11,632,675,1307,1217
3404-001,2014,7,28,12,604,611,1215,1307
3404-001,2014,7,28,13,508,484,992,1215
3404-001,2014,7,28,14,557,577,1134,992
3404-001,2014,7,28,15,666,628,1294,1134
3404-001,2014,7,28,16,715,578,1293,1294
3404-001,2014,7,28,17,718,566,1284,1293
3404-001,2014,7,28,18,945,513,1458,1284
3404-001,2014,7,28,19,905,425,1330,1458
3404-001,2014,7,28,20,754,393,1147,1330
3404-001,2014,7,28,21,608,256,864,1147
3404-001,2014,7,28,22,420,205,625,864
3404-001,2014,7,28,23,203,166,369,625
3404-001,2014,7,28,24,110,113,223,369
3404-001,2014,7,29,1,77,80,157,223
3404-001,2014,7,29,2,54,54,108,157
3404-001,2014,7,29,3,38,58,96,108
3404-001,2014,7,29,4,40,62,102,96
3404-001,2014,7,29,5,44,78,122,102
3404-001,2014,7,29,6,104,175,279,122
3404-001,2014,7,29,7,178,501,679,279
3404-001,2014,7,29,8,443,1458,1901,679
3404-001,2014,7,29,9,608,1209,1817,1901
3404-001,2014,7,29,10,573,737,1310,1817
3404-001,2014,7,29,11,621,674,1295,1310
3404-001,2014,7,29,12,664,628,1292,1295
3404-001,2014,7,29,13,576,531,1107,1292
3404-001,2014,7,29,14,567,584,1151,1107
3404-001,2014,7,29,15,701,659,1360,1151
3404-001,2014,7,29,16,713,606,1319,1360
3404-001,2014,7,29,17,721,535,1256,1319
3404-001,2014,7,29,18,942,510,1452,1256
3404-001,2014,7,29,19,1011,433,1444,1452
3404-001,2014,7,29,20,684,364,1048,1444
3404-001,2014,7,29,21,616,248,864,1048
3404-001,2014,7,29,22,354,216,570,864
3404-001,2014,7,29,23,209,156,365,570
3404-001,2014,7,29,24,123,96,219,365
3404-001,2014,7,30,1,82,85,167,219
3404-001,2014,7,30,2,65,47,112,167
3404-001,2014,7,30,3,39,35,74,112
3404-001,2014,7,30,4,54,47,101,74
3404-001,2014,7,30,5,53,73,126,101
3404-001,2014,7,30,6,119,198,317,126
3404-001,2014,7,30,7,181,531,712,317
3404-001,2014,7,30,8,430,1375,1805,712
3404-001,2014,7,30,9,589,1054,1643,1805
3404-001,2014,7,30,10,553,643,1196,1643
3404-001,2014,7,30,11,630,673,1303,1196
3404-001,2014,7,30,12,577,616,1193,1303
3404-001,2014,7,30,13,518,482,1000,1193
3404-001,2014,7,30,14,529,594,1123,1000
3404-001,2014,7,30,15,645,604,1249,1123
3404-001,2014,7,30,16,676,549,1225,1249
3404-001,2014,7,30,17,675,526,1201,1225
3404-001,2014,7,30,18,987,516,1503,1201
3404-001,2014,7,30,19,912,481,1393,1503
3404-001,2014,7,30,20,690,369,1059,1393
3404-001,2014,7,30,21,614,243,857,1059
3404-001,2014,7,30,22,349,213,562,857
3404-001,2014,7,30,23,180,142,322,562
3404-001,2014,7,30,24,125,100,225,322
3404-001,2014,7,31,1,79,89,168,225
3404-001,2014,7,31,2,53,43,96,168
3404-001,2014,7,31,3,49,51,100,96
3404-001,2014,7,31,4,47,59,106,100
3404-001,2014,7,31,5,47,69,116,106
3404-001,2014,7,31,6,113,196,309,116
3404-001,2014,7,31,7,165,482,647,309
3404-001,2014,7,31,8,419,1381,1800,647
3404-001,2014,7,31,9,587,1039,1626,1800
3404-001,2014,7,31,10,548,602,1150,1626
3404-001,2014,7,31,11,622,612,1234,1150
3404-001,2014,7,31,12,528,592,1120,1234
3404-001,2014,7,31,13,520,503,1023,1120
3404-001,2014,7,31,14,546,534,1080,1023
3404-001,2014,7,31,15,600,565,1165,1080
3404-001,2014,7,31,16,654,588,1242,1165
3404-001,2014,7,31,17,662,502,1164,1242
3404-001,2014,7,31,18,901,475,1376,1164
3404-001,2014,7,31,19,900,447,1347,1376
3404-001,2014,7,31,20,642,370,1012,1347
3404-001,2014,7,31,21,580,248,828,1012
3404-001,2014,7,31,22,358,194,552,828
3404-001,2014,7,31,23,210,159,369,552
3404-001,2014,7,31,24,121,96,217,369
3404-001,2014,8,1,1,86,62,148,217
3404-001,2014,8,1,2,58,41,99,148
3404-001,2014,8,1,3,38,48,86,99
3404-001,2014,8,1,4,56,46,102,86
3404-001,2014,8,1,5,52,80,132,102
3404-001,2014,8,1,6,116,166,282,132
3404-001,2014,8,1,7,193,489,682,282
3404-001,2014,8,1,8,350,1330,1680,682
3404-001,2014,8,1,9,538,944,1482,1680
3404-001,2014,8,1,10,528,627,1155,1482
3404-001,2014,8,1,11,603,582,1185,1155
3404-001,2014,8,1,12,593,597,1190,1185
3404-001,2014,8,1,13,549,510,1059,1190
3404-001,2014,8,1,14,486,566,1052,1059
3404-001,2014,8,1,15,616,590,1206,1052
3404-001,2014,8,1,16,624,534,1158,1206
3404-001,2014,8,1,17,588,482,1070,1158
3404-001,2014,8,1,18,1103,508,1611,1070
3404-001,2014,8,1,19,1073,491,1564,1611
3404-001,2014,8,1,20,788,402,1190,1564
3404-001,2014,8,1,21,547,297,844,1190
3404-001,2014,8,1,22,344,205,549,844
3404-001,2014,8,1,23,193,141,334,549
3404-001,2014,8,1,24,144,113,257,334
3404-001,2014,8,2,1,66,60,126,257
3404-001,2014,8,2,2,68,51,119,126
3404-001,2014,8,2,3,49,43,92,119
3404-001,2014,8,2,4,55,55,110,92
3404-001,2014,8,2,5,54,67,121,110
3404-001,2014,8,2,6,103,154,257,121
3404-001,2014,8,2,7,164,285,449,257
3404-001,2014,8,2,8,286,548,834,449
3404-001,2014,8,2,9,373,496,869,834
3404-001,2014,8,2,10,423,486,909,869
3404-001,2014,8,2,11,430,539,969,909
3404-001,2014,8,2,12,422,449,871,969
3404-001,2014,8,2,13,409,383,792,871
3404-001,2014,8,2,14,466,434,900,792
3404-001,2014,8,2,15,433,387,820,900
3404-001,2014,8,2,16,480,361,841,820
3404-001,2014,8,2,17,521,350,871,841
3404-001,2014,8,2,18,632,330,962,871
3404-001,2014,8,2,19,510,269,779,962
3404-001,2014,8,2,20,363,237,600,779
3404-001,2014,8,2,21,290,240,530,600
3404-001,2014,8,2,22,187,151,338,530
3404-001,2014,8,2,23,112,101,213,338
3404-001,2014,8,2,24,74,57,131,213
3404-001,2014,8,3,1,49,53,102,131
3404-001,2014,8,3,2,28,26,54,102
3404-001,2014,8,3,3,23,24,47,54
3404-001,2014,8,3,4,23,25,48,47
3404-001,2014,8,3,5,22,17,39,48
3404-001,2014,8,3,6,35,44,79,39
3404-001,2014,8,3,7,55,94,149,79
3404-001,2014,8,3,8,125,215,340,149
3404-001,2014,8,3,9,169,191,360,340
3404-001,2014,8,3,10,192,188,380,360
3404-001,2014,8,3,11,233,252,485,380
3404-001,2014,8,3,12,224,261,485,485
3404-001,2014,8,3,13,269,279,548,485
3404-001,2014,8,3,14,289,254,543,548
3404-001,2014,8,3,15,339,274,613,543
3404-001,2014,8,3,16,404,231,635,613
3404-001,2014,8,3,17,388,249,637,635
3404-001,2014,8,3,18,408,230,638,637
3404-001,2014,8,3,19,300,247,547,638
3404-001,2014,8,3,20,220,248,468,547
3404-001,2014,8,3,21,199,219,418,468
3404-001,2014,8,3,22,142,155,297,418
3404-001,2014,8,3,23,76,141,217,297
3404-001,2014,8,3,24,48,100,148,217
3404-001,2014,8,4,1,37,66,103,148
3404-001,2014,8,4,2,27,38,65,103
3404-001,2014,8,4,3,14,31,45,65
3404-001,2014,8,4,4,19,30,49,45
3404-001,2014,8,4,5,34,46,80,49
3404-001,2014,8,4,6,57,169,226,80
3404-001,2014,8,4,7,146,389,535,226
3404-001,2014,8,4,8,332,1096,1428,535
3404-001,2014,8,4,9,433,813,1246,1428
3404-001,2014,8,4,10,386,486,872,1246
3404-001,2014,8,4,11,446,508,954,872
3404-001,2014,8,4,12,498,510,1008,954
3404-001,2014,8,4,13,409,422,831,1008
3404-001,2014,8,4,14,471,469,940,831
3404-001,2014,8,4,15,500,468,968,940
3404-001,2014,8,4,16,513,426,939,968
3404-001,2014,8,4,17,491,461,952,939
3404-001,2014,8,4,18,724,411,1135,952
3404-001,2014,8,4,19,681,338,1019,1135
3404-001,2014,8,4,20,437,247,684,1019
3404-001,2014,8,4,21,429,199,628,684
3404-001,2014,8,4,22,256,141,397,628
3404-001,2014,8,4,23,154,104,258,397
3404-001,2014,8,4,24,108,82,190,258
3404-001,2014,8,5,1,54,65,119,190
3404-001,2014,8,5,2,30,38,68,119
3404-001,2014,8,5,3,35,43,78,68
3404-001,2014,8,5,4,30,45,75,78
3404-001,2014,8,5,5,40,66,106,75
3404-001,2014,8,5,6,68,163,231,106
3404-001,2014,8,5,7,179,370,549,231
3404-001,2014,8,5,8,321,1004,1325,549
3404-001,2014,8,5,9,440,855,1295,1325
3404-001,2014,8,5,10,449,540,989,1295
3404-001,2014,8,5,11,467,566,1033,989
3404-001,2014,8,5,12,491,512,1003,1033
3404-001,2014,8,5,13,477,460,937,1003
3404-001,2014,8,5,14,509,463,972,937
3404-001,2014,8,5,15,522,502,1024,972
3404-001,2014,8,5,16,549,468,1017,1024
3404-001,2014,8,5,17,611,460,1071,1017
3404-001,2014,8,5,18,774,412,1186,1071
3404-001,2014,8,5,19,754,419,1173,1186
3404-001,2014,8,5,20,494,307,801,1173
3404-001,2014,8,5,21,426,196,622,801
3404-001,2014,8,5,22,305,157,462,622
3404-001,2014,8,5,23,155,160,315,462
3404-001,2014,8,5,24,105,100,205,315
3404-001,2014,8,6,1,58,72,130,205
3404-001,2014,8,6,2,34,42,76,130
3404-001,2014,8,6,3,25,38,63,76
3404-001,2014,8,6,4,34,44,78,63
3404-001,2014,8,6,5,44,70,114,78
3404-001,2014,8,6,6,82,187,269,114
3404-001,2014,8,6,7,157,357,514,269
3404-001,2014,8,6,8,373,1092,1465,514
3404-001,2014,8,6,9,505,839,1344,1465
3404-001,2014,8,6,10,436,579,1015,1344
3404-001,2014,8,6,11,491,506,997,1015
3404-001,2014,8,6,12,490,509,999,997
3404-001,2014,8,6,13,433,447,880,999
3404-001,2014,8,6,14,476,459,935,880
3404-001,2014,8,6,15,535,479,1014,935
3404-001,2014,8,6,16,591,491,1082,1014
3404-001,2014,8,6,17,573,429,1002,1082
3404-001,2014,8,6,18,780,433,1213,1002
3404-001,2014,8,6,19,739,368,1107,1213
3404-001,2014,8,6,20,479,269,748,1107
3404-001,2014,8,6,21,342,173,515,748
3404-001,2014,8,6,22,240,143,383,515
3404-001,2014,8,6,23,136,111,247,383
3404-001,2014,8,6,24,73,54,127,247
3404-001,2014,8,7,1,50,42,92,127
3404-001,2014,8,7,2,40,45,85,92
3404-001,2014,8,7,3,21,28,49,85
3404-001,2014,8,7,4,27,46,73,49
3404-001,2014,8,7,5,50,68,118,73
3404-001,2014,8,7,6,85,131,216,118
3404-001,2014,8,7,7,145,326,471,216
3404-001,2014,8,7,8,366,1119,1485,471
3404-001,2014,8,7,9,468,929,1397,1485
3404-001,2014,8,7,10,493,551,1044,1397
3404-001,2014,8,7,11,548,578,1126,1044
3404-001,2014,8,7,12,532,528,1060,1126
3404-001,2014,8,7,13,490,444,934,1060
3404-001,2014,8,7,14,487,495,982,934
3404-001,2014,8,7,15,576,564,1140,982
3404-001,2014,8,7,16,592,506,1098,1140
3404-001,2014,8,7,17,550,458,1008,1098
3404-001,2014,8,7,18,785,467,1252,1008
3404-001,2014,8,7,19,806,397,1203,1252
3404-001,2014,8,7,20,475,254,729,1203
3404-001,2014,8,7,21,430,230,660,729
3404-001,2014,8,7,22,286,162,448,660
3404-001,2014,8,7,23,165,140,305,448
3404-001,2014,8,7,24,113,99,212,305
3404-001,2014,8,8,1,60,64,124,212
3404-001,2014,8,8,2,32,41,73,124
3404-001,2014,8,8,3,27,41,68,73
3404-001,2014,8,8,4,39,52,91,68
3404-001,2014,8,8,5,44,54,98,91
3404-001,2014,8,8,6,77,131,208,98
3404-001,2014,8,8,7,165,387,552,208
3404-001,2014,8,8,8,412,1100,1512,552
3404-001,2014,8,8,9,516,973,1489,1512
3404-001,2014,8,8,10,470,583,1053,1489
3404-001,2014,8,8,11,503,591,1094,1053
3404-001,2014,8,8,12,497,569,1066,1094
3404-001,2014,8,8,13,483,440,923,1066
3404-001,2014,8,8,14,528,485,1013,923
3404-001,2014,8,8,15,594,562,1156,1013
3404-001,2014,8,8,16,623,556,1179,1156
3404-001,2014,8,8,17,660,478,1138,1179
3404-001,2014,8,8,18,904,473,1377,1138
3404-001,2014,8,8,19,936,436,1372,1377
3404-001,2014,8,8,20,611,358,969,1372
3404-001,2014,8,8,21,448,291,739,969
3404-001,2014,8,8,22,305,218,523,739
3404-001,2014,8,8,23,165,149,314,523
3404-001,2014,8,8,24,115,93,208,314
3404-001,2014,8,9,1,74,57,131,208
3404-001,2014,8,9,2,59,73,132,131
3404-001,2014,8,9,3,31,43,74,132
3404-001,2014,8,9,4,38,54,92,74
3404-001,2014,8,9,5,61,74,135,92
3404-001,2014,8,9,6,98,170,268,135
3404-001,2014,8,9,7,150,320,470,268
3404-001,2014,8,9,8,301,592,893,470
3404-001,2014,8,9,9,403,570,973,893
3404-001,2014,8,9,10,445,535,980,973
3404-001,2014,8,9,11,441,495,936,980
3404-001,2014,8,9,12,421,553,974,936
3404-001,2014,8,9,13,396,442,838,974
3404-001,2014,8,9,14,453,415,868,838
3404-001,2014,8,9,15,460,420,880,868
3404-001,2014,8,9,16,509,396,905,880
3404-001,2014,8,9,17,471,382,853,905
3404-001,2014,8,9,18,684,389,1073,853
3404-001,2014,8,9,19,548,372,920,1073
3404-001,2014,8,9,20,368,276,644,920
3404-001,2014,8,9,21,255,244,499,644
3404-001,2014,8,9,22,198,149,347,499
3404-001,2014,8,9,23,170,112,282,347
3404-001,2014,8,9,24,94,67,161,282
3404-001,2014,8,10,1,54,47,101,161
3404-001,2014,8,10,2,53,45,98,101
3404-001,2014,8,10,3,23,32,55,98
3404-001,2014,8,10,4,28,19,47,55
3404-001,2014,8,10,5,32,38,70,47
3404-001,2014,8,10,6,45,70,115,70
3404-001,2014,8,10,7,66,182,248,115
3404-001,2014,8,10,8,159,270,429,248
3404-001,2014,8,10,9,202,253,455,429
3404-001,2014,8,10,10,205,279,484,455
3404-001,2014,8,10,11,261,291,552,484
3404-001,2014,8,10,12,269,282,551,552
3404-001,2014,8,10,13,278,238,516,551
3404-001,2014,8,10,14,325,314,639,516
3404-001,2014,8,10,15,392,315,707,639
3404-001,2014,8,10,16,446,295,741,707
3404-001,2014,8,10,17,489,264,753,741
3404-001,2014,8,10,18,501,271,772,753
3404-001,2014,8,10,19,429,286,715,772
3404-001,2014,8,10,20,255,234,489,715
3404-001,2014,8,10,21,208,261,469,489
3404-001,2014,8,10,22,147,188,335,469
3404-001,2014,8,10,23,84,135,219,335
3404-001,2014,8,10,24,69,97,166,219
3404-001,2014,8,11,1,44,72,116,166
3404-001,2014,8,11,2,28,35,63,116
3404-001,2014,8,11,3,21,48,69,63
3404-001,2014,8,11,4,31,44,75,69
3404-001,2014,8,11,5,43,68,111,75
3404-001,2014,8,11,6,78,218,296,111
3404-001,2014,8,11,7,201,613,814,296
3404-001,2014,8,11,8,449,1693,2142,814
3404-001,2014,8,11,9,598,1155,1753,2142
3404-001,2014,8,11,10,546,627,1173,1753
3404-001,2014,8,11,11,596,614,1210,1173
3404-001,2014,8,11,12,623,595,1218,1210
3404-001,2014,8,11,13,529,529,1058,1218
3404-001,2014,8,11,14,570,564,1134,1058
3404-001,2014,8,11,15,642,676,1318,1134
3404-001,2014,8,11,16,766,668,1434,1318
3404-001,2014,8,11,17,759,572,1331,1434
3404-001,2014,8,11,18,886,537,1423,1331
3404-001,2014,8,11,19,858,473,1331,1423
3404-001,2014,8,11,20,723,406,1129,1331
3404-001,2014,8,11,21,652,274,926,1129
3404-001,2014,8,11,22,396,189,585,926
3404-001,2014,8,11,23,195,150,345,585
3404-001,2014,8,11,24,122,102,224,345
3404-001,2014,8,12,1,85,81,166,224
3404-001,2014,8,12,2,77,55,132,166
3404-001,2014,8,12,3,42,46,88,132
3404-001,2014,8,12,4,44,59,103,88
3404-001,2014,8,12,5,57,72,129,103
3404-001,2014,8,12,6,106,207,313,129
3404-001,2014,8,12,7,179,518,697,313
3404-001,2014,8,12,8,442,1533,1975,697
3404-001,2014,8,12,9,633,1205,1838,1975
3404-001,2014,8,12,10,707,689,1396,1838
3404-001,2014,8,12,11,612,696,1308,1396
3404-001,2014,8,12,12,611,667,1278,1308
3404-001,2014,8,12,13,557,531,1088,1278
3404-001,2014,8,12,14,594,619,1213,1088
3404-001,2014,8,12,15,705,663,1368,1213
3404-001,2014,8,12,16,765,650,1415,1368
3404-001,2014,8,12,17,808,527,1335,1415
3404-001,2014,8,12,18,969,543,1512,1335
3404-001,2014,8,12,19,934,496,1430,1512
3404-001,2014,8,12,20,768,412,1180,1430
3404-001,2014,8,12,21,614,229,843,1180
3404-001,2014,8,12,22,385,200,585,843
3404-001,2014,8,12,23,194,130,324,585
3404-001,2014,8,12,24,128,98,226,324
3404-001,2014,8,13,1,83,76,159,226
3404-001,2014,8,13,2,69,56,125,159
3404-001,2014,8,13,3,55,60,115,125
3404-001,2014,8,13,4,49,49,98,115
3404-001,2014,8,13,5,57,91,148,98
3404-001,2014,8,13,6,128,226,354,148
3404-001,2014,8,13,7,203,567,770,354
3404-001,2014,8,13,8,447,1610,2057,770
3404-001,2014,8,13,9,608,1131,1739,2057
3404-001,2014,8,13,10,672,666,1338,1739
3404-001,2014,8,13,11,686,707,1393,1338
3404-001,2014,8,13,12,615,594,1209,1393
3404-001,2014,8,13,13,545,543,1088,1209
3404-001,2014,8,13,14,634,571,1205,1088
3404-001,2014,8,13,15,621,650,1271,1205
3404-001,2014,8,13,16,743,629,1372,1271
3404-001,2014,8,13,17,772,566,1338,1372
3404-001,2014,8,13,18,1079,525,1604,1338
3404-001,2014,8,13,19,945,422,1367,1604
3404-001,2014,8,13,20,699,371,1070,1367
3404-001,2014,8,13,21,543,241,784,1070
3404-001,2014,8,13,22,316,183,499,784
3404-001,2014,8,13,23,189,155,344,499
3404-001,2014,8,13,24,140,76,216,344
3404-001,2014,8,14,1,82,66,148,216
3404-001,2014,8,14,2,73,45,118,148
3404-001,2014,8,14,3,40,51,91,118
3404-001,2014,8,14,4,50,58,108,91
3404-001,2014,8,14,5,72,67,139,108
3404-001,2014,8,14,6,93,228,321,139
3404-001,2014,8,14,7,218,532,750,321
3404-001,2014,8,14,8,462,1525,1987,750
3404-001,2014,8,14,9,630,1072,1702,1987
3404-001,2014,8,14,10,661,665,1326,1702
3404-001,2014,8,14,11,645,696,1341,1326
3404-001,2014,8,14,12,621,633,1254,1341
3404-001,2014,8,14,13,565,510,1075,1254
3404-001,2014,8,14,14,612,565,1177,1075
3404-001,2014,8,14,15,779,638,1417,1177
3404-001,2014,8,14,16,743,605,1348,1417
3404-001,2014,8,14,17,757,581,1338,1348
3404-001,2014,8,14,18,1216,513,1729,1338
3404-001,2014,8,14,19,1090,477,1567,1729
3404-001,2014,8,14,20,759,409,1168,1567
3404-001,2014,8,14,21,643,313,956,1168
3404-001,2014,8,14,22,357,224,581,956
3404-001,2014,8,14,23,222,128,350,581
3404-001,2014,8,14,24,139,108,247,350
3404-001,2014,8,15,1,82,83,165,247
3404-001,2014,8,15,2,81,56,137,165
3404-001,2014,8,15,3,50,49,99,137
3404-001,2014,8,15,4,55,58,113,99
3404-001,2014,8,15,5,64,90,154,113
3404-001,2014,8,15,6,107,189,296,154
3404-001,2014,8,15,7,165,350,515,296
3404-001,2014,8,15,8,326,745,1071,515
3404-001,2014,8,15,9,429,614,1043,1071
3404-001,2014,8,15,10,436,595,1031,1043
3404-001,2014,8,15,11,452,559,1011,1031
3404-001,2014,8,15,12,403,536,939,1011
3404-001,2014,8,15,13,447,484,931,939
3404-001,2014,8,15,14,467,497,964,931
3404-001,2014,8,15,15,444,500,944,964
3404-001,2014,8,15,16,508,544,1052,944
3404-001,2014,8,15,17,589,416,1005,1052
3404-001,2014,8,15,18,747,403,1150,1005
3404-001,2014,8,15,19,600,368,968,1150
3404-001,2014,8,15,20,440,341,781,968
3404-001,2014,8,15,21,327,237,564,781
3404-001,2014,8,15,22,210,162,372,564
3404-001,2014,8,15,23,166,115,281,372
3404-001,2014,8,15,24,77,77,154,281
3404-001,2014,8,16,1,95,67,162,154
3404-001,2014,8,16,2,61,63,124,162
3404-001,2014,8,16,3,42,44,86,124
3404-001,2014,8,16,4,46,40,86,86
3404-001,2014,8,16,5,75,66,141,86
3404-001,2014,8,16,6,98,181,279,141
3404-001,2014,8,16,7,153,369,522,279
3404-001,2014,8,16,8,262,590,852,522
3404-001,2014,8,16,9,423,505,928,852
3404-001,2014,8,16,10,389,433,822,928
3404-001,2014,8,16,11,443,498,941,822
3404-001,2014,8,16,12,418,451,869,941
3404-001,2014,8,16,13,435,420,855,869
3404-001,2014,8,16,14,486,384,870,855
3404-001,2014,8,16,15,502,466,968,870
3404-001,2014,8,16,16,499,397,896,968
3404-001,2014,8,16,17,604,393,997,896
3404-001,2014,8,16,18,926,380,1306,997
3404-001,2014,8,16,19,684,335,1019,1306
3404-001,2014,8,16,20,401,345,746,1019
3404-001,2014,8,16,21,328,253,581,746
3404-001,2014,8,16,22,208,176,384,581
3404-001,2014,8,16,23,150,123,273,384
3404-001,2014,8,16,24,98,76,174,273
3404-001,2014,8,17,1,58,60,118,174
3404-001,2014,8,17,2,62,44,106,118
3404-001,2014,8,17,3,34,39,73,106
3404-001,2014,8,17,4,31,32,63,73
3404-001,2014,8,17,5,46,34,80,63
3404-001,2014,8,17,6,56,79,135,80
3404-001,2014,8,17,7,105,172,277,135
3404-001,2014,8,17,8,182,234,416,277
3404-001,2014,8,17,9,233,221,454,416
3404-001,2014,8,17,10,245,241,486,454
3404-001,2014,8,17,11,256,292,548,486
3404-001,2014,8,17,12,318,297,615,548
3404-001,2014,8,17,13,306,289,595,615
3404-001,2014,8,17,14,290,275,565,595
3404-001,2014,8,17,15,408,250,658,565
3404-001,2014,8,17,16,388,309,697,658
3404-001,2014,8,17,17,431,248,679,697
3404-001,2014,8,17,18,407,287,694,679
3404-001,2014,8,17,19,306,279,585,694
3404-001,2014,8,17,20,251,301,552,585
3404-001,2014,8,17,21,204,278,482,552
3404-001,2014,8,17,22,129,190,319,482
3404-001,2014,8,17,23,82,136,218,319
3404-001,2014,8,17,24,63,97,160,218
3404-001,2014,8,18,1,24,75,99,160
3404-001,2014,8,18,2,35,44,79,99
3404-001,2014,8,18,3,20,45,65,79
3404-001,2014,8,18,4,21,46,67,65
3404-001,2014,8,18,5,30,69,99,67
3404-001,2014,8,18,6,73,174,247,99
3404-001,2014,8,18,7,178,576,754,247
3404-001,2014,8,18,8,458,1707,2165,754
3404-001,2014,8,18,9,585,1128,1713,2165
3404-001,2014,8,18,10,534,569,1103,1713
3404-001,2014,8,18,11,552,651,1203,1103
3404-001,2014,8,18,12,616,592,1208,1203
3404-001,2014,8,18,13,501,511,1012,1208
3404-001,2014,8,18,14,598,567,1165,1012
3404-001,2014,8,18,15,673,689,1362,1165
3404-001,2014,8,18,16,667,604,1271,1362
3404-001,2014,8,18,17,720,524,1244,1271
3404-001,2014,8,18,18,859,479,1338,1244
3404-001,2014,8,18,19,877,455,1332,1338
3404-001,2014,8,18,20,666,353,1019,1332
3404-001,2014,8,18,21,633,239,872,1019
3404-001,2014,8,18,22,350,174,524,872
3404-001,2014,8,18,23,173,123,296,524
3404-001,2014,8,18,24,119,82,201,296
3404-001,2014,8,19,1,77,81,158,201
3404-001,2014,8,19,2,64,45,109,158
3404-001,2014,8,19,3,37,43,80,109
3404-001,2014,8,19,4,43,62,105,80
3404-001,2014,8,19,5,43,75,118,105
3404-001,2014,8,19,6,83,170,253,118
3404-001,2014,8,19,7,175,490,665,253
3404-001,2014,8,19,8,407,1522,1929,665
3404-001,2014,8,19,9,623,1105,1728,1929
3404-001,2014,8,19,10,571,650,1221,1728
3404-001,2014,8,19,11,615,668,1283,1221
3404-001,2014,8,19,12,666,627,1293,1283
3404-001,2014,8,19,13,558,536,1094,1293
3404-001,2014,8,19,14,662,574,1236,1094
3404-001,2014,8,19,15,658,664,1322,1236
3404-001,2014,8,19,16,698,667,1365,1322
3404-001,2014,8,19,17,726,562,1288,1365
3404-001,2014,8,19,18,948,518,1466,1288
3404-001,2014,8,19,19,891,444,1335,1466
3404-001,2014,8,19,20,664,357,1021,1335
3404-001,2014,8,19,21,633,250,883,1021
3404-001,2014,8,19,22,366,210,576,883
3404-001,2014,8,19,23,212,131,343,576
3404-001,2014,8,19,24,130,88,218,343
3404-001,2014,8,20,1,80,76,156,218
3404-001,2014,8,20,2,63,52,115,156
3404-001,2014,8,20,3,53,53,106,115
3404-001,2014,8,20,4,43,52,95,106
3404-001,2014,8,20,5,60,77,137,95
3404-001,2014,8,20,6,89,201,290,137
3404-001,2014,8,20,7,157,499,656,290
3404-001,2014,8,20,8,440,1603,2043,656
3404-001,2014,8,20,9,644,1159,1803,2043
3404-001,2014,8,20,10,595,657,1252,1803
3404-001,2014,8,20,11,611,675,1286,1252
3404-001,2014,8,20,12,683,643,1326,1286
3404-001,2014,8,20,13,582,521,1103,1326
3404-001,2014,8,20,14,621,608,1229,1103
3404-001,2014,8,20,15,691,645,1336,1229
3404-001,2014,8,20,16,739,662,1401,1336
3404-001,2014,8,20,17,700,605,1305,1401
3404-001,2014,8,20,18,1042,574,1616,1305
3404-001,2014,8,20,19,1029,454,1483,1616
3404-001,2014,8,20,20,688,392,1080,1483
3404-001,2014,8,20,21,571,257,828,1080
3404-001,2014,8,20,22,335,183,518,828
3404-001,2014,8,20,23,198,133,331,518
3404-001,2014,8,20,24,120,90,210,331
3404-001,2014,8,21,1,78,75,153,210
3404-001,2014,8,21,2,65,42,107,153
3404-001,2014,8,21,3,46,33,79,107
3404-001,2014,8,21,4,33,55,88,79
3404-001,2014,8,21,5,33,61,94,88
3404-001,2014,8,21,6,83,133,216,94
3404-001,2014,8,21,7,131,450,581,216
3404-001,2014,8,21,8,398,1515,1913,581
3404-001,2014,8,21,9,630,1169,1799,1913
3404-001,2014,8,21,10,530,643,1173,1799
3404-001,2014,8,21,11,569,577,1146,1173
3404-001,2014,8,21,12,574,537,1111,1146
3404-001,2014,8,21,13,513,451,964,1111
3404-001,2014,8,21,14,533,530,1063,964
3404-001,2014,8,21,15,665,620,1285,1063
3404-001,2014,8,21,16,707,617,1324,1285
3404-001,2014,8,21,17,652,489,1141,1324
3404-001,2014,8,21,18,956,483,1439,1141
3404-001,2014,8,21,19,856,438,1294,1439
3404-001,2014,8,21,20,642,377,1019,1294
3404-001,2014,8,21,21,628,223,851,1019
3404-001,2014,8,21,22,344,199,543,851
3404-001,2014,8,21,23,170,132,302,543
3404-001,2014,8,21,24,126,83,209,302
3404-001,2014,8,22,1,86,89,175,209
3404-001,2014,8,22,2,70,53,123,175
3404-001,2014,8,22,3,44,53,97,123
3404-001,2014,8,22,4,35,57,92,97
3404-001,2014,8,22,5,58,75,133,92
3404-001,2014,8,22,6,97,217,314,133
3404-001,2014,8,22,7,188,511,699,314
3404-001,2014,8,22,8,436,1555,1991,699
3404-001,2014,8,22,9,628,1137,1765,1991
3404-001,2014,8,22,10,618,681,1299,1765
3404-001,2014,8,22,11,645,661,1306,1299
3404-001,2014,8,22,12,649,612,1261,1306
3404-001,2014,8,22,13,605,601,1206,1261
3404-001,2014,8,22,14,631,646,1277,1206
3404-001,2014,8,22,15,722,703,1425,1277
3404-001,2014,8,22,16,727,669,1396,1425
3404-001,2014,8,22,17,810,583,1393,1396
3404-001,2014,8,22,18,1170,610,1780,1393
3404-001,2014,8,22,19,1162,496,1658,1780
3404-001,2014,8,22,20,868,471,1339,1658
3404-001,2014,8,22,21,622,304,926,1339
3404-001,2014,8,22,22,392,214,606,926
3404-001,2014,8,22,23,200,142,342,606
3404-001,2014,8,22,24,131,101,232,342
3404-001,2014,8,23,1,96,85,181,232
3404-001,2014,8,23,2,75,62,137,181
3404-001,2014,8,23,3,50,67,117,137
3404-001,2014,8,23,4,45,62,107,117
3404-001,2014,8,23,5,69,78,147,107
3404-001,2014,8,23,6,133,242,375,147
3404-001,2014,8,23,7,195,369,564,375
3404-001,2014,8,23,8,340,784,1124,564
3404-001,2014,8,23,9,519,649,1168,1124
3404-001,2014,8,23,10,536,591,1127,1168
3404-001,2014,8,23,11,516,601,1117,1127
3404-001,2014,8,23,12,463,530,993,1117
3404-001,2014,8,23,13,502,484,986,993
3404-001,2014,8,23,14,487,498,985,986
3404-001,2014,8,23,15,546,485,1031,985
3404-001,2014,8,23,16,610,495,1105,1031
3404-001,2014,8,23,17,591,438,1029,1105
3404-001,2014,8,23,18,853,421,1274,1029
3404-001,2014,8,23,19,627,403,1030,1274
3404-001,2014,8,23,20,417,328,745,1030
3404-001,2014,8,23,21,335,243,578,745
3404-001,2014,8,23,22,206,185,391,578
3404-001,2014,8,23,23,163,124,287,391
3404-001,2014,8,23,24,96,79,175,287
3404-001,2014,8,24,1,73,55,128,175
3404-001,2014,8,24,2,55,45,100,128
3404-001,2014,8,24,3,33,32,65,100
3404-001,2014,8,24,4,33,28,61,65
3404-001,2014,8,24,5,35,39,74,61
3404-001,2014,8,24,6,76,105,181,74
3404-001,2014,8,24,7,121,189,310,181
3404-001,2014,8,24,8,221,331,552,310
3404-001,2014,8,24,9,257,300,557,552
3404-001,2014,8,24,10,248,301,549,557
3404-001,2014,8,24,11,247,275,522,549
3404-001,2014,8,24,12,293,340,633,522
3404-001,2014,8,24,13,276,328,604,633
3404-001,2014,8,24,14,375,329,704,604
3404-001,2014,8,24,15,388,355,743,704
3404-001,2014,8,24,16,534,361,895,743
3404-001,2014,8,24,17,722,317,1039,895
3404-001,2014,8,24,18,675,385,1060,1039
3404-001,2014,8,24,19,610,392,1002,1060
3404-001,2014,8,24,20,413,293,706,1002
3404-001,2014,8,24,21,296,309,605,706
3404-001,2014,8,24,22,195,318,513,605
3404-001,2014,8,24,23,116,196,312,513
3404-001,2014,8,24,24,60,133,193,312
3404-001,2014,8,25,1,39,62,101,193
3404-001,2014,8,25,2,27,54,81,101
3404-001,2014,8,25,3,19,37,56,81
3404-001,2014,8,25,4,27,39,66,56
3404-001,2014,8,25,5,38,71,109,66
3404-001,2014,8,25,6,97,207,304,109
3404-001,2014,8,25,7,204,549,753,304
3404-001,2014,8,25,8,473,1785,2258,753
3404-001,2014,8,25,9,527,1216,1743,2258
3404-001,2014,8,25,10,516,592,1108,1743
3404-001,2014,8,25,11,580,589,1169,1108
3404-001,2014,8,25,12,546,619,1165,1169
3404-001,2014,8,25,13,541,484,1025,1165
3404-001,2014,8,25,14,585,618,1203,1025
3404-001,2014,8,25,15,645,631,1276,1203
3404-001,2014,8,25,16,627,582,1209,1276
3404-001,2014,8,25,17,699,556,1255,1209
3404-001,2014,8,25,18,881,505,1386,1255
3404-001,2014,8,25,19,846,472,1318,1386
3404-001,2014,8,25,20,608,371,979,1318
3404-001,2014,8,25,21,642,243,885,979
3404-001,2014,8,25,22,386,180,566,885
3404-001,2014,8,25,23,217,150,367,566
3404-001,2014,8,25,24,132,105,237,367
3404-001,2014,8,26,1,91,82,173,237
3404-001,2014,8,26,2,57,54,111,173
3404-001,2014,8,26,3,35,58,93,111
3404-001,2014,8,26,4,53,49,102,93
3404-001,2014,8,26,5,47,83,130,102
3404-001,2014,8,26,6,116,186,302,130
3404-001,2014,8,26,7,199,513,712,302
3404-001,2014,8,26,8,461,1641,2102,712
3404-001,2014,8,26,9,678,1148,1826,2102
3404-001,2014,8,26,10,627,728,1355,1826
3404-001,2014,8,26,11,619,668,1287,1355
3404-001,2014,8,26,12,623,636,1259,1287
3404-001,2014,8,26,13,558,546,1104,1259
3404-001,2014,8,26,14,601,603,1204,1104
3404-001,2014,8,26,15,715,682,1397,1204
3404-001,2014,8,26,16,715,679,1394,1397
3404-001,2014,8,26,17,742,581,1323,1394
3404-001,2014,8,26,18,1011,570,1581,1323
3404-001,2014,8,26,19,905,485,1390,1581
3404-001,2014,8,26,20,708,415,1123,1390
3404-001,2014,8,26,21,637,259,896,1123
3404-001,2014,8,26,22,404,225,629,896
3404-001,2014,8,26,23,230,153,383,629
3404-001,2014,8,26,24,134,121,255,383
3404-001,2014,8,27,1,93,83,176,255
3404-001,2014,8,27,2,75,54,129,176
3404-001,2014,8,27,3,42,43,85,129
3404-001,2014,8,27,4,48,52,100,85
3404-001,2014,8,27,5,52,76,128,100
3404-001,2014,8,27,6,118,198,316,128
3404-001,2014,8,27,7,231,551,782,316
3404-001,2014,8,27,8,439,1612,2051,782
3404-001,2014,8,27,9,666,1210,1876,2051
3404-001,2014,8,27,10,640,707,1347,1876
3404-001,2014,8,27,11,652,654,1306,1347
3404-001,2014,8,27,12,643,616,1259,1306
3404-001,2014,8,27,13,575,555,1130,1259
3404-001,2014,8,27,14,599,613,1212,1130
3404-001,2014,8,27,15,705,687,1392,1212
3404-001,2014,8,27,16,755,599,1354,1392
3404-001,2014,8,27,17,787,572,1359,1354
3404-001,2014,8,27,18,1089,559,1648,1359
3404-001,2014,8,27,19,979,464,1443,1648
3404-001,2014,8,27,20,698,388,1086,1443
3404-001,2014,8,27,21,586,271,857,1086
3404-001,2014,8,27,22,395,220,615,857
3404-001,2014,8,27,23,227,155,382,615
3404-001,2014,8,27,24,132,124,256,382
3404-001,2014,8,28,1,87,86,173,256
3404-001,2014,8,28,2,74,44,118,173
3404-001,2014,8,28,3,35,51,86,118
3404-001,2014,8,28,4,52,48,100,86
3404-001,2014,8,28,5,59,82,141,100
3404-001,2014,8,28,6,123,197,320,141
3404-001,2014,8,28,7,203,559,762,320
3404-001,2014,8,28,8,467,1629,2096,762
3404-001,2014,8,28,9,700,1153,1853,2096
3404-001,2014,8,28,10,603,737,1340,1853
3404-001,2014,8,28,11,647,718,1365,1340
3404-001,2014,8,28,12,691,608,1299,1365
3404-001,2014,8,28,13,575,545,1120,1299
3404-001,2014,8,28,14,611,599,1210,1120
3404-001,2014,8,28,15,681,700,1381,1210
3404-001,2014,8,28,16,812,682,1494,1381
3404-001,2014,8,28,17,759,596,1355,1494
3404-001,2014,8,28,18,1016,566,1582,1355
3404-001,2014,8,28,19,961,539,1500,1582
3404-001,2014,8,28,20,741,420,1161,1500
3404-001,2014,8,28,21,676,269,945,1161
3404-001,2014,8,28,22,441,219,660,945
3404-001,2014,8,28,23,231,150,381,660
3404-001,2014,8,28,24,127,92,219,381
3404-001,2014,8,29,1,84,94,178,219
3404-001,2014,8,29,2,43,64,107,178
3404-001,2014,8,29,3,36,48,84,107
3404-001,2014,8,29,4,50,53,103,84
3404-001,2014,8,29,5,69,85,154,103
3404-001,2014,8,29,6,117,205,322,154
3404-001,2014,8,29,7,208,581,789,322
3404-001,2014,8,29,8,464,1711,2175,789
3404-001,2014,8,29,9,720,1193,1913,2175
3404-001,2014,8,29,10,613,760,1373,1913
3404-001,2014,8,29,11,651,660,1311,1373
3404-001,2014,8,29,12,640,677,1317,1311
3404-001,2014,8,29,13,619,582,1201,1317
3404-001,2014,8,29,14,657,624,1281,1201
3404-001,2014,8,29,15,721,712,1433,1281
3404-001,2014,8,29,16,768,675,1443,1433
3404-001,2014,8,29,17,757,618,1375,1443
3404-001,2014,8,29,18,1184,578,1762,1375
3404-001,2014,8,29,19,1159,501,1660,1762
3404-001,2014,8,29,20,839,457,1296,1660
3404-001,2014,8,29,21,687,310,997,1296
3404-001,2014,8,29,22,381,232,613,997
3404-001,2014,8,29,23,249,167,416,613
3404-001,2014,8,29,24,144,114,258,416
3404-001,2014,8,30,1,97,76,173,258
3404-001,2014,8,30,2,72,59,131,173
3404-001,2014,8,30,3,57,40,97,131
3404-001,2014,8,30,4,44,65,109,97
3404-001,2014,8,30,5,52,76,128,109
3404-001,2014,8,30,6,131,214,345,128
3404-001,2014,8,30,7,200,375,575,345
3404-001,2014,8,30,8,381,803,1184,575
3404-001,2014,8,30,9,495,742,1237,1184
3404-001,2014,8,30,10,481,559,1040,1237
3404-001,2014,8,30,11,472,595,1067,1040
3404-001,2014,8,30,12,518,530,1048,1067
3404-001,2014,8,30,13,536,497,1033,1048
3404-001,2014,8,30,14,502,486,988,1033
3404-001,2014,8,30,15,542,457,999,988
3404-001,2014,8,30,16,574,496,1070,999
3404-001,2014,8,30,17,656,483,1139,1070
3404-001,2014,8,30,18,916,472,1388,1139
3404-001,2014,8,30,19,633,398,1031,1388
3404-001,2014,8,30,20,411,379,790,1031
3404-001,2014,8,30,21,365,294,659,790
3404-001,2014,8,30,22,218,197,415,659
3404-001,2014,8,30,23,148,131,279,415
3404-001,2014,8,30,24,106,91,197,279
3404-001,2014,8,31,1,66,64,130,197
3404-001,2014,8,31,2,52,47,99,130
3404-001,2014,8,31,3,26,29,55,99
3404-001,2014,8,31,4,36,23,59,55
3404-001,2014,8,31,5,34,27,61,59
3404-001,2014,8,31,6,70,104,174,61
3404-001,2014,8,31,7,99,209,308,174
3404-001,2014,8,31,8,219,374,593,308
3404-001,2014,8,31,9,293,333,626,593
3404-001,2014,8,31,10,248,312,560,626
3404-001,2014,8,31,11,259,337,596,560
3404-001,2014,8,31,12,342,330,672,596
3404-001,2014,8,31,13,358,322,680,672
3404-001,2014,8,31,14,362,373,735,680
3404-001,2014,8,31,15,399,372,771,735
3404-001,2014,8,31,16,465,339,804,771
3404-001,2014,8,31,17,540,374,914,804
3404-001,2014,8,31,18,668,366,1034,914
3404-001,2014,8,31,19,460,285,745,1034
3404-001,2014,8,31,20,357,315,672,745
3404-001,2014,8,31,21,247,309,556,672
3404-001,2014,8,31,22,161,237,398,556
3404-001,2014,8,31,23,107,179,286,398
3404-001,2014,8,31,24,71,87,158,286
3404-001,2014,9,1,1,38,64,102,158
3404-001,2014,9,1,2,19,40,59,102
3404-001,2014,9,1,3,24,54,78,59
3404-001,2014,9,1,4,36,49,85,78
3404-001,2014,9,1,5,62,68,130,85
3404-001,2014,9,1,6,120,257,377,130
3404-001,2014,9,1,7,218,645,863,377
3404-001,2014,9,1,8,485,1841,2326,863
3404-001,2014,9,1,9,567,1267,1834,2326
3404-001,2014,9,1,10,576,653,1229,1834
3404-001,2014,9,1,11,663,672,1335,1229
3404-001,2014,9,1,12,642,633,1275,1335
3404-001,2014,9,1,13,547,529,1076,1275
3404-001,2014,9,1,14,616,599,1215,1076
3404-001,2014,9,1,15,685,728,1413,1215
3404-001,2014,9,1,16,704,675,1379,1413
3404-001,2014,9,1,17,740,589,1329,1379
3404-001,2014,9,1,18,974,540,1514,1329
3404-001,2014,9,1,19,986,494,1480,1514
3404-001,2014,9,1,20,805,427,1232,1480
3404-001,2014,9,1,21,709,272,981,1232
3404-001,2014,9,1,22,414,232,646,981
3404-001,2014,9,1,23,260,165,425,646
3404-001,2014,9,1,24,127,95,222,425
3404-001,2014,9,2,1,107,84,191,222
3404-001,2014,9,2,2,65,53,118,191
3404-001,2014,9,2,3,52,60,112,118
3404-001,2014,9,2,4,46,56,102,112
3404-001,2014,9,2,5,66,103,169,102
3404-001,2014,9,2,6,104,199,303,169
3404-001,2014,9,2,7,181,527,708,303
3404-001,2014,9,2,8,442,1692,2134,708
3404-001,2014,9,2,9,697,1252,1949,2134
3404-001,2014,9,2,10,648,714,1362,1949
3404-001,2014,9,2,11,668,675,1343,1362
3404-001,2014,9,2,12,681,661,1342,1343
3404-001,2014,9,2,13,582,603,1185,1342
3404-001,2014,9,2,14,691,646,1337,1185
3404-001,2014,9,2,15,729,771,1500,1337
3404-001,2014,9,2,16,817,614,1431,1500
3404-001,2014,9,2,17,833,590,1423,1431
3404-001,2014,9,2,18,1057,517,1574,1423
3404-001,2014,9,2,19,1010,502,1512,1574
3404-001,2014,9,2,20,733,395,1128,1512
3404-001,2014,9,2,21,631,286,917,1128
3404-001,2014,9,2,22,373,206,579,917
3404-001,2014,9,2,23,239,157,396,579
3404-001,2014,9,2,24,124,91,215,396
3404-001,2014,9,3,1,94,65,159,215
3404-001,2014,9,3,2,62,52,114,159
3404-001,2014,9,3,3,48,36,84,114
3404-001,2014,9,3,4,35,44,79,84
3404-001,2014,9,3,5,36,63,99,79
3404-001,2014,9,3,6,94,128,222,99
3404-001,2014,9,3,7,139,440,579,222
3404-001,2014,9,3,8,390,1615,2005,579
3404-001,2014,9,3,9,653,1211,1864,2005
3404-001,2014,9,3,10,574,610,1184,1864
3404-001,2014,9,3,11,636,676,1312,1184
3404-001,2014,9,3,12,672,611,1283,1312
3404-001,2014,9,3,13,551,491,1042,1283
3404-001,2014,9,3,14,536,614,1150,1042
3404-001,2014,9,3,15,654,683,1337,1150
3404-001,2014,9,3,16,729,611,1340,1337
3404-001,2014,9,3,17,831,562,1393,1340
3404-001,2014,9,3,18,1058,461,1519,1393
3404-001,2014,9,3,19,950,452,1402,1519
3404-001,2014,9,3,20,677,400,1077,1402
3404-001,2014,9,3,21,553,234,787,1077
3404-001,2014,9,3,22,349,203,552,787
3404-001,2014,9,3,23,197,139,336,552
3404-001,2014,9,3,24,134,99,233,336
3404-001,2014,9,4,1,84,81,165,233
3404-001,2014,9,4,2,66,57,123,165
3404-001,2014,9,4,3,49,51,100,123
3404-001,2014,9,4,4,45,48,93,100
3404-001,2014,9,4,5,68,72,140,93
3404-001,2014,9,4,6,93,178,271,140
3404-001,2014,9,4,7,173,528,701,271
3404-001,2014,9,4,8,447,1658,2105,701
3404-001,2014,9,4,9,662,1243,1905,2105
3404-001,2014,9,4,10,618,677,1295,1905
3404-001,2014,9,4,11,661,707,1368,1295
3404-001,2014,9,4,12,670,673,1343,1368
3404-001,2014,9,4,13,595,568,1163,1343
3404-001,2014,9,4,14,619,667,1286,1163
3404-001,2014,9,4,15,732,696,1428,1286
3404-001,2014,9,4,16,797,678,1475,1428
3404-001,2014,9,4,17,778,625,1403,1475
3404-001,2014,9,4,18,1058,555,1613,1403
3404-001,2014,9,4,19,1065,546,1611,1613
3404-001,2014,9,4,20,783,467,1250,1611
3404-001,2014,9,4,21,688,275,963,1250
3404-001,2014,9,4,22,394,225,619,963
3404-001,2014,9,4,23,243,151,394,619
3404-001,2014,9,4,24,132,129,261,394
3404-001,2014,9,5,1,108,68,176,261
3404-001,2014,9,5,2,66,65,131,176
3404-001,2014,9,5,3,67,44,111,131
3404-001,2014,9,5,4,36,52,88,111
3404-001,2014,9,5,5,73,70,143,88
3404-001,2014,9,5,6,93,191,284,143
3404-001,2014,9,5,7,162,502,664,284
3404-001,2014,9,5,8,445,1587,2032,664
3404-001,2014,9,5,9,682,1230,1912,2032
3404-001,2014,9,5,10,606,646,1252,1912
3404-001,2014,9,5,11,697,654,1351,1252
3404-001,2014,9,5,12,720,623,1343,1351
3404-001,2014,9,5,13,664,578,1242,1343
3404-001,2014,9,5,14,745,625,1370,1242
3404-001,2014,9,5,15,778,658,1436,1370
3404-001,2014,9,5,16,858,608,1466,1436
3404-001,2014,9,5,17,1029,529,1558,1466
3404-001,2014,9,5,18,1295,546,1841,1558
3404-001,2014,9,5,19,949,485,1434,1841
3404-001,2014,9,5,20,643,425,1068,1434
3404-001,2014,9,5,21,391,250,641,1068
3404-001,2014,9,5,22,303,194,497,641
3404-001,2014,9,5,23,200,158,358,497
3404-001,2014,9,5,24,120,107,227,358
3404-001,2014,9,6,1,83,75,158,227
3404-001,2014,9,6,2,59,54,113,158
3404-001,2014,9,6,3,62,61,123,113
3404-001,2014,9,6,4,61,52,113,123
3404-001,2014,9,6,5,58,72,130,113
3404-001,2014,9,6,6,95,152,247,130
3404-001,2014,9,6,7,144,207,351,247
3404-001,2014,9,6,8,296,390,686,351
3404-001,2014,9,6,9,379,430,809,686
3404-001,2014,9,6,10,393,373,766,809
3404-001,2014,9,6,11,381,385,766,766
3404-001,2014,9,6,12,375,372,747,766
3404-001,2014,9,6,13,347,322,669,747
3404-001,2014,9,6,14,397,348,745,669
3404-001,2014,9,6,15,375,349,724,745
3404-001,2014,9,6,16,372,324,696,724
3404-001,2014,9,6,17,398,317,715,696
3404-001,2014,9,6,18,411,315,726,715
3404-001,2014,9,6,19,320,299,619,726
3404-001,2014,9,6,20,230,216,446,619
3404-001,2014,9,6,21,214,165,379,446
3404-001,2014,9,6,22,146,121,267,379
3404-001,2014,9,6,23,120,86,206,267
3404-001,2014,9,6,24,79,56,135,206
3404-001,2014,9,7,1,58,56,114,135
3404-001,2014,9,7,2,44,36,80,114
3404-001,2014,9,7,3,40,23,63,80
3404-001,2014,9,7,4,33,14,47,63
3404-001,2014,9,7,5,31,30,61,47
3404-001,2014,9,7,6,53,39,92,61
3404-001,2014,9,7,7,74,75,149,92
3404-001,2014,9,7,8,130,175,305,149
3404-001,2014,9,7,9,175,195,370,305
3404-001,2014,9,7,10,224,244,468,370
3404-001,2014,9,7,11,210,293,503,468
3404-001,2014,9,7,12,249,276,525,503
3404-001,2014,9,7,13,239,254,493,525
3404-001,2014,9,7,14,233,249,482,493
3404-001,2014,9,7,15,205,239,444,482
3404-001,2014,9,7,16,269,237,506,444
3404-001,2014,9,7,17,232,202,434,506
3404-001,2014,9,7,18,234,221,455,434
3404-001,2014,9,7,19,175,156,331,455
3404-001,2014,9,7,20,168,148,316,331
3404-001,2014,9,7,21,137,108,245,316
3404-001,2014,9,7,22,103,83,186,245
3404-001,2014,9,7,23,88,63,151,186
3404-001,2014,9,7,24,41,46,87,151
3404-001,2014,9,8,1,27,25,52,87
3404-001,2014,9,8,2,27,18,45,52
3404-001,2014,9,8,3,16,13,29,45
3404-001,2014,9,8,4,14,8,22,29
3404-001,2014,9,8,5,18,12,30,22
3404-001,2014,9,8,6,39,34,73,30
3404-001,2014,9,8,7,102,123,225,73
3404-001,2014,9,8,8,132,220,352,225
3404-001,2014,9,8,9,153,189,342,352
3404-001,2014,9,8,10,236,198,434,342
3404-001,2014,9,8,11,419,352,771,434
3404-001,2014,9,8,12,446,433,879,771
3404-001,2014,9,8,13,542,431,973,879
3404-001,2014,9,8,14,679,388,1067,973
3404-001,2014,9,8,15,631,404,1035,1067
3404-001,2014,9,8,16,615,459,1074,1035
3404-001,2014,9,8,17,530,451,981,1074
3404-001,2014,9,8,18,495,414,909,981
3404-001,2014,9,8,19,456,345,801,909
3404-001,2014,9,8,20,340,282,622,801
3404-001,2014,9,8,21,335,352,687,622
3404-001,2014,9,8,22,218,224,442,687
3404-001,2014,9,8,23,145,118,263,442
3404-001,2014,9,8,24,81,117,198,263
3404-001,2014,9,9,1,83,42,125,198
3404-001,2014,9,9,2,44,40,84,125
3404-001,2014,9,9,3,13,27,40,84
3404-001,2014,9,9,4,14,17,31,40
3404-001,2014,9,9,5,16,26,42,31
3404-001,2014,9,9,6,25,46,71,42
3404-001,2014,9,9,7,34,77,111,71
3404-001,2014,9,9,8,78,132,210,111
3404-001,2014,9,9,9,117,137,254,210
3404-001,2014,9,9,10,186,195,381,254
3404-001,2014,9,9,11,240,267,507,381
3404-001,2014,9,9,12,253,284,537,507
3404-001,2014,9,9,13,278,327,605,537
3404-001,2014,9,9,14,355,321,676,605
3404-001,2014,9,9,15,364,295,659,676
3404-001,2014,9,9,16,417,282,699,659
3404-001,2014,9,9,17,446,306,752,699
3404-001,2014,9,9,18,525,290,815,752
3404-001,2014,9,9,19,508,248,756,815
3404-001,2014,9,9,20,434,236,670,756
3404-001,2014,9,9,21,323,209,532,670
3404-001,2014,9,9,22,178,139,317,532
3404-001,2014,9,9,23,142,142,284,317
3404-001,2014,9,9,24,79,143,222,284
3404-001,2014,9,10,1,69,121,190,222
3404-001,2014,9,10,2,56,64,120,190
3404-001,2014,9,10,3,31,50,81,120
3404-001,2014,9,10,4,21,36,57,81
3404-001,2014,9,10,5,23,58,81,57
3404-001,2014,9,10,6,49,86,135,81
3404-001,2014,9,10,7,78,191,269,135
3404-001,2014,9,10,8,207,540,747,269
3404-001,2014,9,10,9,302,454,756,747
3404-001,2014,9,10,10,315,350,665,756
3404-001,2014,9,10,11,328,388,716,665
3404-001,2014,9,10,12,319,363,682,716
3404-001,2014,9,10,13,316,361,677,682
3404-001,2014,9,10,14,346,364,710,677
3404-001,2014,9,10,15,413,357,770,710
3404-001,2014,9,10,16,414,340,754,770
3404-001,2014,9,10,17,414,349,763,754
3404-001,2014,9,10,18,530,336,866,763
3404-001,2014,9,10,19,424,311,735,866
3404-001,2014,9,10,20,357,298,655,735
3404-001,2014,9,10,21,268,232,500,655
3404-001,2014,9,10,22,164,181,345,500
3404-001,2014,9,10,23,133,157,290,345
3404-001,2014,9,10,24,65,101,166,290
3404-001,2014,9,11,1,52,61,113,166
3404-001,2014,9,11,2,36,49,85,113
3404-001,2014,9,11,3,28,57,85,85
3404-001,2014,9,11,4,25,48,73,85
3404-001,2014,9,11,5,42,77,119,73
3404-001,2014,9,11,6,75,244,319,119
3404-001,2014,9,11,7,131,536,667,319
3404-001,2014,9,11,8,423,1587,2010,667
3404-001,2014,9,11,9,581,1162,1743,2010
3404-001,2014,9,11,10,544,614,1158,1743
3404-001,2014,9,11,11,597,597,1194,1158
3404-001,2014,9,11,12,564,535,1099,1194
3404-001,2014,9,11,13,513,504,1017,1099
3404-001,2014,9,11,14,550,554,1104,1017
3404-001,2014,9,11,15,625,612,1237,1104
3404-001,2014,9,11,16,637,602,1239,1237
3404-001,2014,9,11,17,644,540,1184,1239
3404-001,2014,9,11,18,967,495,1462,1184
3404-001,2014,9,11,19,882,439,1321,1462
3404-001,2014,9,11,20,607,347,954,1321
3404-001,2014,9,11,21,525,209,734,954
3404-001,2014,9,11,22,305,216,521,734
3404-001,2014,9,11,23,185,127,312,521
3404-001,2014,9,11,24,93,79,172,312
3404-001,2014,9,12,1,77,76,153,172
3404-001,2014,9,12,2,51,56,107,153
3404-001,2014,9,12,3,43,49,92,107
3404-001,2014,9,12,4,44,55,99,92
3404-001,2014,9,12,5,68,89,157,99
3404-001,2014,9,12,6,100,220,320,157
3404-001,2014,9,12,7,209,549,758,320
3404-001,2014,9,12,8,468,1638,2106,758
3404-001,2014,9,12,9,640,1233,1873,2106
3404-001,2014,9,12,10,632,695,1327,1873
3404-001,2014,9,12,11,662,653,1315,1327
3404-001,2014,9,12,12,676,677,1353,1315
3404-001,2014,9,12,13,593,527,1120,1353
3404-001,2014,9,12,14,592,600,1192,1120
3404-001,2014,9,12,15,738,711,1449,1192
3404-001,2014,9,12,16,740,647,1387,1449
3404-001,2014,9,12,17,787,621,1408,1387
3404-001,2014,9,12,18,1127,528,1655,1408
3404-001,2014,9,12,19,1149,487,1636,1655
3404-001,2014,9,12,20,807,426,1233,1636
3404-001,2014,9,12,21,616,245,861,1233
3404-001,2014,9,12,22,376,232,608,861
3404-001,2014,9,12,23,227,148,375,608
3404-001,2014,9,12,24,148,133,281,375
3404-001,2014,9,13,1,80,61,141,281
3404-001,2014,9,13,2,79,50,129,141
3404-001,2014,9,13,3,37,59,96,129
3404-001,2014,9,13,4,48,58,106,96
3404-001,2014,9,13,5,68,94,162,106
3404-001,2014,9,13,6,120,217,337,162
3404-001,2014,9,13,7,164,374,538,337
3404-001,2014,9,13,8,386,829,1215,538
3404-001,2014,9,13,9,487,681,1168,1215
3404-001,2014,9,13,10,492,594,1086,1168
3404-001,2014,9,13,11,533,581,1114,1086
3404-001,2014,9,13,12,535,499,1034,1114
3404-001,2014,9,13,13,430,425,855,1034
3404-001,2014,9,13,14,466,494,960,855
3404-001,2014,9,13,15,516,496,1012,960
3404-001,2014,9,13,16,584,412,996,1012
3404-001,2014,9,13,17,629,434,1063,996
3404-001,2014,9,13,18,868,417,1285,1063
3404-001,2014,9,13,19,595,428,1023,1285
3404-001,2014,9,13,20,409,318,727,1023
3404-001,2014,9,13,21,272,214,486,727
3404-001,2014,9,13,22,174,134,308,486
3404-001,2014,9,13,23,138,89,227,308
3404-001,2014,9,13,24,80,89,169,227
3404-001,2014,9,14,1,47,62,109,169
3404-001,2014,9,14,2,56,49,105,109
3404-001,2014,9,14,3,29,31,60,105
3404-001,2014,9,14,4,32,24,56,60
3404-001,2014,9,14,5,30,43,73,56
3404-001,2014,9,14,6,64,91,155,73
3404-001,2014,9,14,7,108,174,282,155
3404-001,2014,9,14,8,261,276,537,282
3404-001,2014,9,14,9,263,275,538,537
3404-001,2014,9,14,10,242,308,550,538
3404-001,2014,9,14,11,323,349,672,550
3404-001,2014,9,14,12,280,384,664,672
3404-001,2014,9,14,13,281,372,653,664
3404-001,2014,9,14,14,318,367,685,653
3404-001,2014,9,14,15,353,386,739,685
3404-001,2014,9,14,16,448,327,775,739
3404-001,2014,9,14,17,530,327,857,775
3404-001,2014,9,14,18,535,396,931,857
3404-001,2014,9,14,19,469,327,796,931
3404-001,2014,9,14,20,370,221,591,796
3404-001,2014,9,14,21,243,176,419,591
3404-001,2014,9,14,22,152,183,335,419
3404-001,2014,9,14,23,83,120,203,335
3404-001,2014,9,14,24,62,88,150,203
3404-001,2014,9,15,1,41,72,113,150
3404-001,2014,9,15,2,20,53,73,113
3404-001,2014,9,15,3,26,52,78,73
3404-001,2014,9,15,4,41,53,94,78
3404-001,2014,9,15,5,45,75,120,94
3404-001,2014,9,15,6,97,195,292,120
3404-001,2014,9,15,7,203,587,790,292
3404-001,2014,9,15,8,485,1809,2294,790
3404-001,2014,9,15,9,626,1316,1942,2294
3404-001,2014,9,15,10,625,713,1338,1942
3404-001,2014,9,15,11,667,694,1361,1338
3404-001,2014,9,15,12,634,662,1296,1361
3404-001,2014,9,15,13,536,575,1111,1296
3404-001,2014,9,15,14,588,614,1202,1111
3404-001,2014,9,15,15,671,722,1393,1202
3404-001,2014,9,15,16,676,646,1322,1393
3404-001,2014,9,15,17,789,592,1381,1322
3404-001,2014,9,15,18,1010,546,1556,1381
3404-001,2014,9,15,19,977,483,1460,1556
3404-001,2014,9,15,20,735,405,1140,1460
3404-001,2014,9,15,21,681,232,913,1140
3404-001,2014,9,15,22,383,196,579,913
3404-001,2014,9,15,23,229,138,367,579
3404-001,2014,9,15,24,131,92,223,367
3404-001,2014,9,16,1,91,65,156,223
3404-001,2014,9,16,2,59,49,108,156
3404-001,2014,9,16,3,31,58,89,108
3404-001,2014,9,16,4,46,73,119,89
3404-001,2014,9,16,5,45,103,148,119
3404-001,2014,9,16,6,126,187,313,148
3404-001,2014,9,16,7,180,567,747,313
3404-001,2014,9,16,8,478,1679,2157,747
3404-001,2014,9,16,9,663,1267,1930,2157
3404-001,2014,9,16,10,637,725,1362,1930
3404-001,2014,9,16,11,724,703,1427,1362
3404-001,2014,9,16,12,665,620,1285,1427
3404-001,2014,9,16,13,527,586,1113,1285
3404-001,2014,9,16,14,617,656,1273,1113
3404-001,2014,9,16,15,776,680,1456,1273
3404-001,2014,9,16,16,762,663,1425,1456
3404-001,2014,9,16,17,748,564,1312,1425
3404-001,2014,9,16,18,1110,557,1667,1312
3404-001,2014,9,16,19,949,502,1451,1667
3404-001,2014,9,16,20,738,378,1116,1451
3404-001,2014,9,16,21,593,250,843,1116
3404-001,2014,9,16,22,395,201,596,843
3404-001,2014,9,16,23,213,161,374,596
3404-001,2014,9,16,24,127,108,235,374
3404-001,2014,9,17,1,92,65,157,235
3404-001,2014,9,17,2,56,58,114,157
3404-001,2014,9,17,3,44,58,102,114
3404-001,2014,9,17,4,63,43,106,102
3404-001,2014,9,17,5,52,76,128,106
3404-001,2014,9,17,6,127,208,335,128
3404-001,2014,9,17,7,180,504,684,335
3404-001,2014,9,17,8,504,1664,2168,684
3404-001,2014,9,17,9,688,1319,2007,2168
3404-001,2014,9,17,10,663,699,1362,2007
3404-001,2014,9,17,11,639,697,1336,1362
3404-001,2014,9,17,12,648,692,1340,1336
3404-001,2014,9,17,13,574,549,1123,1340
3404-001,2014,9,17,14,588,620,1208,1123
3404-001,2014,9,17,15,750,676,1426,1208
3404-001,2014,9,17,16,771,657,1428,1426
3404-001,2014,9,17,17,736,602,1338,1428
3404-001,2014,9,17,18,1132,544,1676,1338
3404-001,2014,9,17,19,1057,547,1604,1676
3404-001,2014,9,17,20,724,380,1104,1604
3404-001,2014,9,17,21,530,230,760,1104
3404-001,2014,9,17,22,323,198,521,760
3404-001,2014,9,17,23,230,157,387,521
3404-001,2014,9,17,24,116,89,205,387
3404-001,2014,9,18,1,95,77,172,205
3404-001,2014,9,18,2,59,59,118,172
3404-001,2014,9,18,3,43,49,92,118
3404-001,2014,9,18,4,51,48,99,92
3404-001,2014,9,18,5,48,85,133,99
3404-001,2014,9,18,6,118,211,329,133
3404-001,2014,9,18,7,196,500,696,329
3404-001,2014,9,18,8,492,1621,2113,696
3404-001,2014,9,18,9,660,1317,1977,2113
3404-001,2014,9,18,10,647,703,1350,1977
3404-001,2014,9,18,11,661,698,1359,1350
3404-001,2014,9,18,12,645,606,1251,1359
3404-001,2014,9,18,13,513,518,1031,1251
3404-001,2014,9,18,14,589,634,1223,1031
3404-001,2014,9,18,15,692,689,1381,1223
3404-001,2014,9,18,16,713,635,1348,1381
3404-001,2014,9,18,17,771,609,1380,1348
3404-001,2014,9,18,18,1083,615,1698,1380
3404-001,2014,9,18,19,1041,447,1488,1698
3404-001,2014,9,18,20,730,380,1110,1488
3404-001,2014,9,18,21,651,243,894,1110
3404-001,2014,9,18,22,398,201,599,894
3404-001,2014,9,18,23,207,139,346,599
3404-001,2014,9,18,24,114,110,224,346
3404-001,2014,9,19,1,90,82,172,224
3404-001,2014,9,19,2,56,53,109,172
3404-001,2014,9,19,3,38,56,94,109
3404-001,2014,9,19,4,44,47,91,94
3404-001,2014,9,19,5,57,78,135,91
3404-001,2014,9,19,6,106,199,305,135
3404-001,2014,9,19,7,193,492,685,305
3404-001,2014,9,19,8,498,1625,2123,685
3404-001,2014,9,19,9,632,1269,1901,2123
3404-001,2014,9,19,10,655,705,1360,1901
3404-001,2014,9,19,11,695,686,1381,1360
3404-001,2014,9,19,12,610,639,1249,1381
3404-001,2014,9,19,13,541,558,1099,1249
3404-001,2014,9,19,14,613,627,1240,1099
3404-001,2014,9,19,15,749,707,1456,1240
3404-001,2014,9,19,16,757,674,1431,1456
3404-001,2014,9,19,17,811,597,1408,1431
3404-001,2014,9,19,18,1320,583,1903,1408
3404-001,2014,9,19,19,1248,543,1791,1903
3404-001,2014,9,19,20,899,463,1362,1791
3404-001,2014,9,19,21,620,282,902,1362
3404-001,2014,9,19,22,362,213,575,902
3404-001,2014,9,19,23,224,147,371,575
3404-001,2014,9,19,24,141,112,253,371
3404-001,2014,9,20,1,111,83,194,253
3404-001,2014,9,20,2,70,55,125,194
3404-001,2014,9,20,3,46,54,100,125
3404-001,2014,9,20,4,43,43,86,100
3404-001,2014,9,20,5,66,71,137,86
3404-001,2014,9,20,6,115,185,300,137
3404-001,2014,9,20,7,177,316,493,300
3404-001,2014,9,20,8,383,761,1144,493
3404-001,2014,9,20,9,548,704,1252,1144
3404-001,2014,9,20,10,508,603,1111,1252
3404-001,2014,9,20,11,577,608,1185,1111
3404-001,2014,9,20,12,535,590,1125,1185
3404-001,2014,9,20,13,480,551,1031,1125
3404-001,2014,9,20,14,503,498,1001,1031
3404-001,2014,9,20,15,543,526,1069,1001
3404-001,2014,9,20,16,544,468,1012,1069
3404-001,2014,9,20,17,647,461,1108,1012
3404-001,2014,9,20,18,893,454,1347,1108
3404-001,2014,9,20,19,713,477,1190,1347
3404-001,2014,9,20,20,461,303,764,1190
3404-001,2014,9,20,21,325,216,541,764
3404-001,2014,9,20,22,248,166,414,541
3404-001,2014,9,20,23,145,108,253,414
3404-001,2014,9,20,24,98,90,188,253
3404-001,2014,9,21,1,57,61,118,188
3404-001,2014,9,21,2,40,26,66,118
3404-001,2014,9,21,3,27,30,57,66
3404-001,2014,9,21,4,20,26,46,57
3404-001,2014,9,21,5,33,37,70,46
3404-001,2014,9,21,6,62,85,147,70
3404-001,2014,9,21,7,81,124,205,147
3404-001,2014,9,21,8,163,277,440,205
3404-001,2014,9,21,9,227,267,494,440
3404-001,2014,9,21,10,268,298,566,494
3404-001,2014,9,21,11,323,376,699,566
3404-001,2014,9,21,12,260,407,667,699
3404-001,2014,9,21,13,307,368,675,667
3404-001,2014,9,21,14,326,362,688,675
3404-001,2014,9,21,15,405,377,782,688
3404-001,2014,9,21,16,447,326,773,782
3404-001,2014,9,21,17,498,329,827,773
3404-001,2014,9,21,18,628,339,967,827
3404-001,2014,9,21,19,600,306,906,967
3404-001,2014,9,21,20,408,238,646,906
3404-001,2014,9,21,21,332,252,584,646
3404-001,2014,9,21,22,192,213,405,584
3404-001,2014,9,21,23,98,153,251,405
3404-001,2014,9,21,24,68,107,175,251
3404-001,2014,9,22,1,41,63,104,175
3404-001,2014,9,22,2,24,46,70,104
3404-001,2014,9,22,3,24,48,72,70
3404-001,2014,9,22,4,22,40,62,72
3404-001,2014,9,22,5,50,80,130,62
3404-001,2014,9,22,6,91,243,334,130
3404-001,2014,9,22,7,223,617,840,334
3404-001,2014,9,22,8,511,1779,2290,840
3404-001,2014,9,22,9,596,1367,1963,2290
3404-001,2014,9,22,10,571,682,1253,1963
3404-001,2014,9,22,11,596,654,1250,1253
3404-001,2014,9,22,12,680,587,1267,1250
3404-001,2014,9,22,13,528,560,1088,1267
3404-001,2014,9,22,14,617,633,1250,1088
3404-001,2014,9,22,15,661,751,1412,1250
3404-001,2014,9,22,16,681,630,1311,1412
3404-001,2014,9,22,17,790,572,1362,1311
3404-001,2014,9,22,18,1055,557,1612,1362
3404-001,2014,9,22,19,962,493,1455,1612
3404-001,2014,9,22,20,698,380,1078,1455
3404-001,2014,9,22,21,684,227,911,1078
3404-001,2014,9,22,22,377,206,583,911
3404-001,2014,9,22,23,224,135,359,583
3404-001,2014,9,22,24,130,114,244,359
3404-001,2014,9,23,1,82,71,153,244
3404-001,2014,9,23,2,67,44,111,153
3404-001,2014,9,23,3,43,61,104,111
3404-001,2014,9,23,4,58,60,118,104
3404-001,2014,9,23,5,46,72,118,118
3404-001,2014,9,23,6,118,202,320,118
3404-001,2014,9,23,7,164,507,671,320
3404-001,2014,9,23,8,525,1689,2214,671
3404-001,2014,9,23,9,751,1258,2009,2214
3404-001,2014,9,23,10,667,673,1340,2009
3404-001,2014,9,23,11,681,725,1406,1340
3404-001,2014,9,23,12,632,681,1313,1406
3404-001,2014,9,23,13,551,525,1076,1313
3404-001,2014,9,23,14,604,653,1257,1076
3404-001,2014,9,23,15,734,679,1413,1257
3404-001,2014,9,23,16,779,686,1465,1413
3404-001,2014,9,23,17,773,603,1376,1465
3404-001,2014,9,23,18,1134,516,1650,1376
3404-001,2014,9,23,19,1080,520,1600,1650
3404-001,2014,9,23,20,699,398,1097,1600
3404-001,2014,9,23,21,601,270,871,1097
3404-001,2014,9,23,22,395,214,609,871
3404-001,2014,9,23,23,234,143,377,609
3404-001,2014,9,23,24,121,100,221,377
3404-001,2014,9,24,1,94,66,160,221
3404-001,2014,9,24,2,74,38,112,160
3404-001,2014,9,24,3,46,43,89,112
3404-001,2014,9,24,4,32,29,61,89
3404-001,2014,9,24,5,42,70,112,61
3404-001,2014,9,24,6,89,145,234,112
3404-001,2014,9,24,7,145,365,510,234
3404-001,2014,9,24,8,407,1481,1888,510
3404-001,2014,9,24,9,629,1192,1821,1888
3404-001,2014,9,24,10,562,640,1202,1821
3404-001,2014,9,24,11,621,569,1190,1202
3404-001,2014,9,24,12,565,559,1124,1190
3404-001,2014,9,24,13,487,501,988,1124
3404-001,2014,9,24,14,587,565,1152,988
3404-001,2014,9,24,15,617,600,1217,1152
3404-001,2014,9,24,16,669,581,1250,1217
3404-001,2014,9,24,17,684,549,1233,1250
3404-001,2014,9,24,18,1023,508,1531,1233
3404-001,2014,9,24,19,950,427,1377,1531
3404-001,2014,9,24,20,612,352,964,1377
3404-001,2014,9,24,21,559,258,817,964
3404-001,2014,9,24,22,307,191,498,817
3404-001,2014,9,24,23,203,133,336,498
3404-001,2014,9,24,24,109,104,213,336
3404-001,2014,9,25,1,71,77,148,213
3404-001,2014,9,25,2,67,57,124,148
3404-001,2014,9,25,3,46,53,99,124
3404-001,2014,9,25,4,43,53,96,99
3404-001,2014,9,25,5,55,78,133,96
3404-001,2014,9,25,6,109,206,315,133
3404-001,2014,9,25,7,183,506,689,315
3404-001,2014,9,25,8,492,1580,2072,689
3404-001,2014,9,25,9,704,1226,1930,2072
3404-001,2014,9,25,10,609,645,1254,1930
3404-001,2014,9,25,11,656,649,1305,1254
3404-001,2014,9,25,12,648,646,1294,1305
3404-001,2014,9,25,13,542,518,1060,1294
3404-001,2014,9,25,14,631,637,1268,1060
3404-001,2014,9,25,15,701,726,1427,1268
3404-001,2014,9,25,16,751,644,1395,1427
3404-001,2014,9,25,17,773,600,1373,1395
3404-001,2014,9,25,18,1119,555,1674,1373
3404-001,2014,9,25,19,1030,483,1513,1674
3404-001,2014,9,25,20,681,413,1094,1513
3404-001,2014,9,25,21,570,269,839,1094
3404-001,2014,9,25,22,371,230,601,839
3404-001,2014,9,25,23,203,148,351,601
3404-001,2014,9,25,24,133,101,234,351
3404-001,2014,9,26,1,73,77,150,234
3404-001,2014,9,26,2,65,61,126,150
3404-001,2014,9,26,3,32,48,80,126
3404-001,2014,9,26,4,46,55,101,80
3404-001,2014,9,26,5,55,76,131,101
3404-001,2014,9,26,6,80,210,290,131
3404-001,2014,9,26,7,186,488,674,290
3404-001,2014,9,26,8,471,1608,2079,674
3404-001,2014,9,26,9,697,1215,1912,2079
3404-001,2014,9,26,10,624,628,1252,1912
3404-001,2014,9,26,11,682,669,1351,1252
3404-001,2014,9,26,12,671,601,1272,1351
3404-001,2014,9,26,13,605,556,1161,1272
3404-001,2014,9,26,14,642,614,1256,1161
3404-001,2014,9,26,15,759,678,1437,1256
3404-001,2014,9,26,16,722,579,1301,1437
3404-001,2014,9,26,17,793,576,1369,1301
3404-001,2014,9,26,18,1227,605,1832,1369
3404-001,2014,9,26,19,1245,504,1749,1832
3404-001,2014,9,26,20,803,422,1225,1749
3404-001,2014,9,26,21,552,275,827,1225
3404-001,2014,9,26,22,342,189,531,827
3404-001,2014,9,26,23,198,140,338,531
3404-001,2014,9,26,24,125,88,213,338
3404-001,2014,9,27,1,88,79,167,213
3404-001,2014,9,27,2,66,49,115,167
3404-001,2014,9,27,3,47,48,95,115
3404-001,2014,9,27,4,46,53,99,95
3404-001,2014,9,27,5,52,65,117,99
3404-001,2014,9,27,6,96,200,296,117
3404-001,2014,9,27,7,144,333,477,296
3404-001,2014,9,27,8,343,752,1095,477
3404-001,2014,9,27,9,511,627,1138,1095
3404-001,2014,9,27,10,521,572,1093,1138
3404-001,2014,9,27,11,503,618,1121,1093
3404-001,2014,9,27,12,520,554,1074,1121
3404-001,2014,9,27,13,474,459,933,1074
3404-001,2014,9,27,14,517,532,1049,933
3404-001,2014,9,27,15,541,487,1028,1049
3404-001,2014,9,27,16,595,470,1065,1028
3404-001,2014,9,27,17,591,433,1024,1065
3404-001,2014,9,27,18,868,468,1336,1024
3404-001,2014,9,27,19,681,391,1072,1336
3404-001,2014,9,27,20,457,286,743,1072
3404-001,2014,9,27,21,279,209,488,743
3404-001,2014,9,27,22,198,172,370,488
3404-001,2014,9,27,23,120,114,234,370
3404-001,2014,9,27,24,70,83,153,234
3404-001,2014,9,28,1,52,56,108,153
3404-001,2014,9,28,2,52,44,96,108
3404-001,2014,9,28,3,33,32,65,96
3404-001,2014,9,28,4,37,24,61,65
3404-001,2014,9,28,5,38,34,72,61
3404-001,2014,9,28,6,47,79,126,72
3404-001,2014,9,28,7,90,164,254,126
3404-001,2014,9,28,8,181,293,474,254
3404-001,2014,9,28,9,231,293,524,474
3404-001,2014,9,28,10,228,316,544,524
3404-001,2014,9,28,11,302,384,686,544
3404-001,2014,9,28,12,282,380,662,686
3404-001,2014,9,28,13,294,329,623,662
3404-001,2014,9,28,14,331,355,686,623
3404-001,2014,9,28,15,417,330,747,686
3404-001,2014,9,28,16,415,385,800,747
3404-001,2014,9,28,17,489,326,815,800
3404-001,2014,9,28,18,624,319,943,815
3404-001,2014,9,28,19,579,335,914,943
3404-001,2014,9,28,20,415,268,683,914
3404-001,2014,9,28,21,258,242,500,683
3404-001,2014,9,28,22,169,176,345,500
3404-001,2014,9,28,23,121,153,274,345
3404-001,2014,9,28,24,45,119,164,274
3404-001,2014,9,29,1,48,66,114,164
3404-001,2014,9,29,2,24,40,64,114
3404-001,2014,9,29,3,19,41,60,64
3404-001,2014,9,29,4,30,46,76,60
3404-001,2014,9,29,5,35,63,98,76
3404-001,2014,9,29,6,108,218,326,98
3404-001,2014,9,29,7,187,535,722,326
3404-001,2014,9,29,8,418,1649,2067,722
3404-001,2014,9,29,9,543,1372,1915,2067
3404-001,2014,9,29,10,557,554,1111,1915
3404-001,2014,9,29,11,557,629,1186,1111
3404-001,2014,9,29,12,578,573,1151,1186
3404-001,2014,9,29,13,542,498,1040,1151
3404-001,2014,9,29,14,610,571,1181,1040
3404-001,2014,9,29,15,676,653,1329,1181
3404-001,2014,9,29,16,714,620,1334,1329
3404-001,2014,9,29,17,684,550,1234,1334
3404-001,2014,9,29,18,960,520,1480,1234
3404-001,2014,9,29,19,886,426,1312,1480
3404-001,2014,9,29,20,648,319,967,1312
3404-001,2014,9,29,21,635,232,867,967
3404-001,2014,9,29,22,367,171,538,867
3404-001,2014,9,29,23,196,140,336,538
3404-001,2014,9,29,24,114,88,202,336
3404-001,2014,9,30,1,88,77,165,202
3404-001,2014,9,30,2,43,57,100,165
3404-001,2014,9,30,3,32,41,73,100
3404-001,2014,9,30,4,39,45,84,73
3404-001,2014,9,30,5,45,86,131,84
3404-001,2014,9,30,6,87,204,291,131
3404-001,2014,9,30,7,177,459,636,291
3404-001,2014,9,30,8,438,1644,2082,636
3404-001,2014,9,30,9,701,1215,1916,2082
3404-001,2014,9,30,10,647,779,1426,1916
3404-001,2014,9,30,11,629,702,1331,1426
3404-001,2014,9,30,12,653,598,1251,1331
3404-001,2014,9,30,13,550,527,1077,1251
3404-001,2014,9,30,14,605,558,1163,1077
3404-001,2014,9,30,15,711,646,1357,1163
3404-001,2014,9,30,16,756,636,1392,1357
3404-001,2014,9,30,17,758,569,1327,1392
3404-001,2014,9,30,18,1030,560,1590,1327
3404-001,2014,9,30,19,1048,503,1551,1590
3404-001,2014,9,30,20,692,326,1018,1551
3404-001,2014,9,30,21,656,275,931,1018
3404-001,2014,9,30,22,324,226,550,931
3404-001,2014,9,30,23,232,157,389,550
3404-001,2014,9,30,24,126,86,212,389
3404-001,2014,10,1,1,78,76,154,212
3404-001,2014,10,1,2,51,45,96,154
3404-001,2014,10,1,3,49,45,94,96
3404-001,2014,10,1,4,47,61,108,94
3404-001,2014,10,1,5,50,84,134,108
3404-001,2014,10,1,6,106,186,292,134
3404-001,2014,10,1,7,186,471,657,292
3404-001,2014,10,1,8,445,1585,2030,657
3404-001,2014,10,1,9,657,1207,1864,2030
3404-001,2014,10,1,10,603,678,1281,1864
3404-001,2014,10,1,11,650,641,1291,1281
3404-001,2014,10,1,12,637,648,1285,1291
3404-001,2014,10,1,13,512,507,1019,1285
3404-001,2014,10,1,14,629,580,1209,1019
3404-001,2014,10,1,15,685,683,1368,1209
3404-001,2014,10,1,16,722,660,1382,1368
3404-001,2014,10,1,17,735,566,1301,1382
3404-001,2014,10,1,18,1090,514,1604,1301
3404-001,2014,10,1,19,1075,495,1570,1604
3404-001,2014,10,1,20,679,357,1036,1570
3404-001,2014,10,1,21,559,246,805,1036
3404-001,2014,10,1,22,323,218,541,805
3404-001,2014,10,1,23,207,159,366,541
3404-001,2014,10,1,24,113,98,211,366
3404-001,2014,10,2,1,83,66,149,211
3404-001,2014,10,2,2,57,54,111,149
3404-001,2014,10,2,3,50,47,97,111
3404-001,2014,10,2,4,36,51,87,97
3404-001,2014,10,2,5,46,70,116,87
3404-001,2014,10,2,6,110,186,296,116
3404-001,2014,10,2,7,172,486,658,296
3404-001,2014,10,2,8,442,1678,2120,658
3404-001,2014,10,2,9,649,1292,1941,2120
3404-001,2014,10,2,10,649,654,1303,1941
3404-001,2014,10,2,11,666,682,1348,1303
3404-001,2014,10,2,12,631,600,1231,1348
3404-001,2014,10,2,13,560,532,1092,1231
3404-001,2014,10,2,14,573,583,1156,1092
3404-001,2014,10,2,15,715,692,1407,1156
3404-001,2014,10,2,16,754,656,1410,1407
3404-001,2014,10,2,17,804,592,1396,1410
3404-001,2014,10,2,18,1210,633,1843,1396
3404-001,2014,10,2,19,1234,519,1753,1843
3404-001,2014,10,2,20,889,441,1330,1753
3404-001,2014,10,2,21,676,299,975,1330
3404-001,2014,10,2,22,348,214,562,975
3404-001,2014,10,2,23,236,148,384,562
3404-001,2014,10,2,24,150,117,267,384
3404-001,2014,10,3,1,75,73,148,267
3404-001,2014,10,3,2,55,48,103,148
3404-001,2014,10,3,3,46,37,83,103
3404-001,2014,10,3,4,36,54,90,83
3404-001,2014,10,3,5,59,74,133,90
3404-001,2014,10,3,6,100,186,286,133
3404-001,2014,10,3,7,163,347,510,286
3404-001,2014,10,3,8,333,769,1102,510
3404-001,2014,10,3,9,473,675,1148,1102
3404-001,2014,10,3,10,464,608,1072,1148
3404-001,2014,10,3,11,529,630,1159,1072
3404-001,2014,10,3,12,456,704,1160,1159
3404-001,2014,10,3,13,441,532,973,1160
3404-001,2014,10,3,14,486,536,1022,973
3404-001,2014,10,3,15,541,552,1093,1022
3404-001,2014,10,3,16,525,604,1129,1093
3404-001,2014,10,3,17,576,668,1244,1129
3404-001,2014,10,3,18,877,514,1391,1244
3404-001,2014,10,3,19,745,417,1162,1391
3404-001,2014,10,3,20,446,310,756,1162
3404-001,2014,10,3,21,338,196,534,756
3404-001,2014,10,3,22,186,148,334,534
3404-001,2014,10,3,23,135,90,225,334
3404-001,2014,10,3,24,92,67,159,225
3404-001,2014,10,4,1,63,67,130,159
3404-001,2014,10,4,2,45,39,84,130
3404-001,2014,10,4,3,29,37,66,84
3404-001,2014,10,4,4,25,38,63,66
3404-001,2014,10,4,5,52,62,114,63
3404-001,2014,10,4,6,78,155,233,114
3404-001,2014,10,4,7,140,279,419,233
3404-001,2014,10,4,8,293,585,878,419
3404-001,2014,10,4,9,386,446,832,878
3404-001,2014,10,4,10,383,506,889,832
3404-001,2014,10,4,11,434,507,941,889
3404-001,2014,10,4,12,399,505,904,941
3404-001,2014,10,4,13,370,418,788,904
3404-001,2014,10,4,14,444,447,891,788
3404-001,2014,10,4,15,449,463,912,891
3404-001,2014,10,4,16,531,411,942,912
3404-001,2014,10,4,17,593,372,965,942
3404-001,2014,10,4,18,782,426,1208,965
3404-001,2014,10,4,19,732,328,1060,1208
3404-001,2014,10,4,20,476,263,739,1060
3404-001,2014,10,4,21,345,217,562,739
3404-001,2014,10,4,22,257,161,418,562
3404-001,2014,10,4,23,140,114,254,418
3404-001,2014,10,4,24,90,73,163,254
3404-001,2014,10,5,1,56,56,112,163
3404-001,2014,10,5,2,41,30,71,112
3404-001,2014,10,5,3,23,31,54,71
3404-001,2014,10,5,4,24,37,61,54
3404-001,2014,10,5,5,25,31,56,61
3404-001,2014,10,5,6,46,72,118,56
3404-001,2014,10,5,7,77,123,200,118
3404-001,2014,10,5,8,166,259,425,200
3404-001,2014,10,5,9,231,250,481,425
3404-001,2014,10,5,10,223,277,500,481
3404-001,2014,10,5,11,293,321,614,500
3404-001,2014,10,5,12,263,367,630,614
3404-001,2014,10,5,13,324,313,637,630
3404-001,2014,10,5,14,309,334,643,637
3404-001,2014,10,5,15,417,356,773,643
3404-001,2014,10,5,16,440,358,798,773
3404-001,2014,10,5,17,507,329,836,798
3404-001,2014,10,5,18,635,347,982,836
3404-001,2014,10,5,19,559,308,867,982
3404-001,2014,10,5,20,384,297,681,867
3404-001,2014,10,5,21,228,222,450,681
3404-001,2014,10,5,22,147,212,359,450
3404-001,2014,10,5,23,107,164,271,359
3404-001,2014,10,5,24,59,123,182,271
3404-001,2014,10,6,1,40,66,106,182
3404-001,2014,10,6,2,27,54,81,106
3404-001,2014,10,6,3,25,40,65,81
3404-001,2014,10,6,4,23,47,70,65
3404-001,2014,10,6,5,50,73,123,70
3404-001,2014,10,6,6,107,216,323,123
3404-001,2014,10,6,7,234,554,788,323
3404-001,2014,10,6,8,490,1833,2323,788
3404-001,2014,10,6,9,629,1373,2002,2323
3404-001,2014,10,6,10,584,681,1265,2002
3404-001,2014,10,6,11,636,669,1305,1265
3404-001,2014,10,6,12,643,635,1278,1305
3404-001,2014,10,6,13,564,534,1098,1278
3404-001,2014,10,6,14,589,637,1226,1098
3404-001,2014,10,6,15,693,688,1381,1226
3404-001,2014,10,6,16,763,691,1454,1381
3404-001,2014,10,6,17,725,605,1330,1454
3404-001,2014,10,6,18,1038,588,1626,1330
3404-001,2014,10,6,19,995,466,1461,1626
3404-001,2014,10,6,20,742,400,1142,1461
3404-001,2014,10,6,21,663,237,900,1142
3404-001,2014,10,6,22,413,209,622,900
3404-001,2014,10,6,23,228,137,365,622
3404-001,2014,10,6,24,137,96,233,365
3404-001,2014,10,7,1,88,70,158,233
3404-001,2014,10,7,2,52,50,102,158
3404-001,2014,10,7,3,35,55,90,102
3404-001,2014,10,7,4,46,52,98,90
3404-001,2014,10,7,5,65,78,143,98
3404-001,2014,10,7,6,124,200,324,143
3404-001,2014,10,7,7,167,483,650,324
3404-001,2014,10,7,8,484,1614,2098,650
3404-001,2014,10,7,9,723,1316,2039,2098
3404-001,2014,10,7,10,656,748,1404,2039
3404-001,2014,10,7,11,696,731,1427,1404
3404-001,2014,10,7,12,711,694,1405,1427
3404-001,2014,10,7,13,562,534,1096,1405
3404-001,2014,10,7,14,591,634,1225,1096
3404-001,2014,10,7,15,745,709,1454,1225
3404-001,2014,10,7,16,745,683,1428,1454
3404-001,2014,10,7,17,814,628,1442,1428
3404-001,2014,10,7,18,1081,589,1670,1442
3404-001,2014,10,7,19,1017,466,1483,1670
3404-001,2014,10,7,20,668,382,1050,1483
3404-001,2014,10,7,21,686,229,915,1050
3404-001,2014,10,7,22,390,207,597,915
3404-001,2014,10,7,23,231,150,381,597
3404-001,2014,10,7,24,136,95,231,381
3404-001,2014,10,8,1,84,65,149,231
3404-001,2014,10,8,2,52,46,98,149
3404-001,2014,10,8,3,41,48,89,98
3404-001,2014,10,8,4,45,48,93,89
3404-001,2014,10,8,5,53,70,123,93
3404-001,2014,10,8,6,109,209,318,123
3404-001,2014,10,8,7,168,501,669,318
3404-001,2014,10,8,8,487,1633,2120,669
3404-001,2014,10,8,9,711,1305,2016,2120
3404-001,2014,10,8,10,649,732,1381,2016
3404-001,2014,10,8,11,718,725,1443,1381
3404-001,2014,10,8,12,710,680,1390,1443
3404-001,2014,10,8,13,556,486,1042,1390
3404-001,2014,10,8,14,604,624,1228,1042
3404-001,2014,10,8,15,774,740,1514,1228
3404-001,2014,10,8,16,882,756,1638,1514
3404-001,2014,10,8,17,851,611,1462,1638
3404-001,2014,10,8,18,1281,608,1889,1462
3404-001,2014,10,8,19,1239,554,1793,1889
3404-001,2014,10,8,20,828,387,1215,1793
3404-001,2014,10,8,21,573,263,836,1215
3404-001,2014,10,8,22,354,228,582,836
3404-001,2014,10,8,23,187,137,324,582
3404-001,2014,10,8,24,118,93,211,324
3404-001,2014,10,9,1,99,68,167,211
3404-001,2014,10,9,2,68,50,118,167
3404-001,2014,10,9,3,60,54,114,118
3404-001,2014,10,9,4,39,49,88,114
3404-001,2014,10,9,5,61,81,142,88
3404-001,2014,10,9,6,108,201,309,142
3404-001,2014,10,9,7,188,401,589,309
3404-001,2014,10,9,8,305,961,1266,589
3404-001,2014,10,9,9,483,781,1264,1266
3404-001,2014,10,9,10,429,606,1035,1264
3404-001,2014,10,9,11,517,635,1152,1035
3404-001,2014,10,9,12,455,596,1051,1152
3404-001,2014,10,9,13,444,466,910,1051
3404-001,2014,10,9,14,491,521,1012,910
3404-001,2014,10,9,15,520,467,987,1012
3404-001,2014,10,9,16,602,436,1038,987
3404-001,2014,10,9,17,644,383,1027,1038
3404-001,2014,10,9,18,1105,412,1517,1027
3404-001,2014,10,9,19,774,364,1138,1517
3404-001,2014,10,9,20,486,275,761,1138
3404-001,2014,10,9,21,298,210,508,761
3404-001,2014,10,9,22,203,173,376,508
3404-001,2014,10,9,23,124,130,254,376
3404-001,2014,10,9,24,79,78,157,254
3404-001,2014,10,10,1,59,62,121,157
3404-001,2014,10,10,2,46,59,105,121
3404-001,2014,10,10,3,22,50,72,105
3404-001,2014,10,10,4,42,49,91,72
3404-001,2014,10,10,5,55,79,134,91
3404-001,2014,10,10,6,93,190,283,134
3404-001,2014,10,10,7,188,541,729,283
3404-001,2014,10,10,8,464,1530,1994,729
3404-001,2014,10,10,9,595,1035,1630,1994
3404-001,2014,10,10,10,592,646,1238,1630
3404-001,2014,10,10,11,672,646,1318,1238
3404-001,2014,10,10,12,609,640,1249,1318
3404-001,2014,10,10,13,507,503,1010,1249
3404-001,2014,10,10,14,623,582,1205,1010
3404-001,2014,10,10,15,707,682,1389,1205
3404-001,2014,10,10,16,768,627,1395,1389
3404-001,2014,10,10,17,829,592,1421,1395
3404-001,2014,10,10,18,1162,551,1713,1421
3404-001,2014,10,10,19,1135,534,1669,1713
3404-001,2014,10,10,20,828,453,1281,1669
3404-001,2014,10,10,21,538,277,815,1281
3404-001,2014,10,10,22,327,181,508,815
3404-001,2014,10,10,23,207,164,371,508
3404-001,2014,10,10,24,124,108,232,371
3404-001,2014,10,11,1,82,63,145,232
3404-001,2014,10,11,2,64,61,125,145
3404-001,2014,10,11,3,42,62,104,125
3404-001,2014,10,11,4,52,43,95,104
3404-001,2014,10,11,5,55,62,117,95
3404-001,2014,10,11,6,103,173,276,117
3404-001,2014,10,11,7,174,349,523,276
3404-001,2014,10,11,8,348,752,1100,523
3404-001,2014,10,11,9,550,604,1154,1100
3404-001,2014,10,11,10,518,583,1101,1154
3404-001,2014,10,11,11,534,559,1093,1101
3404-001,2014,10,11,12,502,545,1047,1093
3404-001,2014,10,11,13,452,514,966,1047
3404-001,2014,10,11,14,483,480,963,966
3404-001,2014,10,11,15,524,523,1047,963
3404-001,2014,10,11,16,514,443,957,1047
3404-001,2014,10,11,17,574,442,1016,957
3404-001,2014,10,11,18,835,428,1263,1016
3404-001,2014,10,11,19,606,379,985,1263
3404-001,2014,10,11,20,471,323,794,985
3404-001,2014,10,11,21,288,213,501,794
3404-001,2014,10,11,22,192,137,329,501
3404-001,2014,10,11,23,117,133,250,329
3404-001,2014,10,11,24,76,87,163,250
3404-001,2014,10,12,1,58,42,100,163
3404-001,2014,10,12,2,32,36,68,100
3404-001,2014,10,12,3,29,29,58,68
3404-001,2014,10,12,4,30,18,48,58
3404-001,2014,10,12,5,31,40,71,48
3404-001,2014,10,12,6,56,92,148,71
3404-001,2014,10,12,7,95,158,253,148
3404-001,2014,10,12,8,181,308,489,253
3404-001,2014,10,12,9,242,334,576,489
3404-001,2014,10,12,10,290,337,627,576
3404-001,2014,10,12,11,306,336,642,627
3404-001,2014,10,12,12,276,352,628,642
3404-001,2014,10,12,13,303,345,648,628
3404-001,2014,10,12,14,380,378,758,648
3404-001,2014,10,12,15,428,404,832,758
3404-001,2014,10,12,16,484,378,862,832
3404-001,2014,10,12,17,528,378,906,862
3404-001,2014,10,12,18,622,340,962,906
3404-001,2014,10,12,19,502,353,855,962
3404-001,2014,10,12,20,373,268,641,855
3404-001,2014,10,12,21,243,232,475,641
3404-001,2014,10,12,22,180,226,406,475
3404-001,2014,10,12,23,110,175,285,406
3404-001,2014,10,12,24,76,129,205,285
3404-001,2014,10,13,1,42,68,110,205
3404-001,2014,10,13,2,34,46,80,110
3404-001,2014,10,13,3,33,39,72,80
3404-001,2014,10,13,4,36,38,74,72
3404-001,2014,10,13,5,65,77,142,74
3404-001,2014,10,13,6,105,243,348,142
3404-001,2014,10,13,7,215,646,861,348
3404-001,2014,10,13,8,500,1897,2397,861
3404-001,2014,10,13,9,635,1297,1932,2397
3404-001,2014,10,13,10,592,711,1303,1932
3404-001,2014,10,13,11,651,742,1393,1303
3404-001,2014,10,13,12,651,665,1316,1393
3404-001,2014,10,13,13,556,510,1066,1316
3404-001,2014,10,13,14,574,669,1243,1066
3404-001,2014,10,13,15,724,708,1432,1243
3404-001,2014,10,13,16,757,656,1413,1432
3404-001,2014,10,13,17,757,598,1355,1413
3404-001,2014,10,13,18,1012,579,1591,1355
3404-001,2014,10,13,19,1004,498,1502,1591
3404-001,2014,10,13,20,717,344,1061,1502
3404-001,2014,10,13,21,650,248,898,1061
3404-001,2014,10,13,22,324,187,511,898
3404-001,2014,10,13,23,219,136,355,511
3404-001,2014,10,13,24,119,123,242,355
3404-001,2014,10,14,1,72,87,159,242
3404-001,2014,10,14,2,48,57,105,159
3404-001,2014,10,14,3,49,45,94,105
3404-001,2014,10,14,4,32,52,84,94
3404-001,2014,10,14,5,67,76,143,84
3404-001,2014,10,14,6,118,198,316,143
3404-001,2014,10,14,7,186,568,754,316
3404-001,2014,10,14,8,493,1700,2193,754
3404-001,2014,10,14,9,645,1193,1838,2193
3404-001,2014,10,14,10,672,758,1430,1838
3404-001,2014,10,14,11,699,676,1375,1430
3404-001,2014,10,14,12,684,673,1357,1375
3404-001,2014,10,14,13,579,533,1112,1357
3404-001,2014,10,14,14,597,630,1227,1112
3404-001,2014,10,14,15,750,719,1469,1227
3404-001,2014,10,14,16,724,681,1405,1469
3404-001,2014,10,14,17,751,584,1335,1405
3404-001,2014,10,14,18,1069,558,1627,1335
3404-001,2014,10,14,19,981,448,1429,1627
3404-001,2014,10,14,20,716,366,1082,1429
3404-001,2014,10,14,21,614,218,832,1082
3404-001,2014,10,14,22,355,214,569,832
3404-001,2014,10,14,23,200,123,323,569
3404-001,2014,10,14,24,99,93,192,323
3404-001,2014,10,15,1,54,67,121,192
3404-001,2014,10,15,2,51,63,114,121
3404-001,2014,10,15,3,52,49,101,114
3404-001,2014,10,15,4,33,45,78,101
3404-001,2014,10,15,5,54,68,122,78
3404-001,2014,10,15,6,125,217,342,122
3404-001,2014,10,15,7,195,539,734,342
3404-001,2014,10,15,8,511,1663,2174,734
3404-001,2014,10,15,9,721,1248,1969,2174
3404-001,2014,10,15,10,681,750,1431,1969
3404-001,2014,10,15,11,726,740,1466,1431
3404-001,2014,10,15,12,685,662,1347,1466
3404-001,2014,10,15,13,587,534,1121,1347
3404-001,2014,10,15,14,649,590,1239,1121
3404-001,2014,10,15,15,739,735,1474,1239
3404-001,2014,10,15,16,774,665,1439,1474
3404-001,2014,10,15,17,728,635,1363,1439
3404-001,2014,10,15,18,1177,630,1807,1363
3404-001,2014,10,15,19,1136,477,1613,1807
3404-001,2014,10,15,20,636,384,1020,1613
3404-001,2014,10,15,21,526,234,760,1020
3404-001,2014,10,15,22,324,216,540,760
3404-001,2014,10,15,23,190,153,343,540
3404-001,2014,10,15,24,126,97,223,343
3404-001,2014,10,16,1,76,82,158,223
3404-001,2014,10,16,2,74,50,124,158
3404-001,2014,10,16,3,53,49,102,124
3404-001,2014,10,16,4,40,45,85,102
3404-001,2014,10,16,5,65,80,145,85
3404-001,2014,10,16,6,119,223,342,145
3404-001,2014,10,16,7,191,523,714,342
3404-001,2014,10,16,8,477,1610,2087,714
3404-001,2014,10,16,9,680,1264,1944,2087
3404-001,2014,10,16,10,647,743,1390,1944
3404-001,2014,10,16,11,623,670,1293,1390
3404-001,2014,10,16,12,671,640,1311,1293
3404-001,2014,10,16,13,591,510,1101,1311
3404-001,2014,10,16,14,587,619,1206,1101
3404-001,2014,10,16,15,758,722,1480,1206
3404-001,2014,10,16,16,761,700,1461,1480
3404-001,2014,10,16,17,762,603,1365,1461
3404-001,2014,10,16,18,1011,541,1552,1365
3404-001,2014,10,16,19,1018,458,1476,1552
3404-001,2014,10,16,20,683,364,1047,1476
3404-001,2014,10,16,21,604,246,850,1047
3404-001,2014,10,16,22,333,195,528,850
3404-001,2014,10,16,23,210,128,338,528
3404-001,2014,10,16,24,124,100,224,338
3404-001,2014,10,17,1,77,87,164,224
3404-001,2014,10,17,2,61,54,115,164
3404-001,2014,10,17,3,37,40,77,115
3404-001,2014,10,17,4,50,40,90,77
3404-001,2014,10,17,5,62,76,138,90
3404-001,2014,10,17,6,112,209,321,138
3404-001,2014,10,17,7,204,538,742,321
3404-001,2014,10,17,8,502,1673,2175,742
3404-001,2014,10,17,9,734,1229,1963,2175
3404-001,2014,10,17,10,639,695,1334,1963
3404-001,2014,10,17,11,725,747,1472,1334
3404-001,2014,10,17,12,663,627,1290,1472
3404-001,2014,10,17,13,600,540,1140,1290
3404-001,2014,10,17,14,665,664,1329,1140
3404-001,2014,10,17,15,765,753,1518,1329
3404-001,2014,10,17,16,843,689,1532,1518
3404-001,2014,10,17,17,805,624,1429,1532
3404-001,2014,10,17,18,1247,618,1865,1429
3404-001,2014,10,17,19,1276,536,1812,1865
3404-001,2014,10,17,20,907,442,1349,1812
3404-001,2014,10,17,21,613,268,881,1349
3404-001,2014,10,17,22,332,212,544,881
3404-001,2014,10,17,23,232,147,379,544
3404-001,2014,10,17,24,110,105,215,379
3404-001,2014,10,18,1,65,83,148,215
3404-001,2014,10,18,2,79,63,142,148
3404-001,2014,10,18,3,43,39,82,142
3404-001,2014,10,18,4,37,57,94,82
3404-001,2014,10,18,5,81,81,162,94
3404-001,2014,10,18,6,125,215,340,162
3404-001,2014,10,18,7,192,403,595,340
3404-001,2014,10,18,8,392,864,1256,595
3404-001,2014,10,18,9,634,688,1322,1256
3404-001,2014,10,18,10,577,621,1198,1322
3404-001,2014,10,18,11,582,623,1205,1198
3404-001,2014,10,18,12,515,590,1105,1205
3404-001,2014,10,18,13,490,488,978,1105
3404-001,2014,10,18,14,555,566,1121,978
3404-001,2014,10,18,15,504,571,1075,1121
3404-001,2014,10,18,16,607,540,1147,1075
3404-001,2014,10,18,17,754,477,1231,1147
3404-001,2014,10,18,18,982,437,1419,1231
3404-001,2014,10,18,19,692,431,1123,1419
3404-001,2014,10,18,20,396,306,702,1123
3404-001,2014,10,18,21,274,209,483,702
3404-001,2014,10,18,22,175,150,325,483
3404-001,2014,10,18,23,108,129,237,325
3404-001,2014,10,18,24,88,92,180,237
3404-001,2014,10,19,1,53,57,110,180
3404-001,2014,10,19,2,47,34,81,110
3404-001,2014,10,19,3,45,24,69,81
3404-001,2014,10,19,4,22,27,49,69
3404-001,2014,10,19,5,41,33,74,49
3404-001,2014,10,19,6,55,75,130,74
3404-001,2014,10,19,7,94,176,270,130
3404-001,2014,10,19,8,188,301,489,270
3404-001,2014,10,19,9,265,302,567,489
3404-001,2014,10,19,10,273,349,622,567
3404-001,2014,10,19,11,345,374,719,622
3404-001,2014,10,19,12,342,382,724,719
3404-001,2014,10,19,13,345,351,696,724
3404-001,2014,10,19,14,334,408,742,696
3404-001,2014,10,19,15,445,390,835,742
3404-001,2014,10,19,16,502,365,867,835
3404-001,2014,10,19,17,559,352,911,867
3404-001,2014,10,19,18,616,316,932,911
3404-001,2014,10,19,19,577,336,913,932
3404-001,2014,10,19,20,428,265,693,913
3404-001,2014,10,19,21,258,282,540,693
3404-001,2014,10,19,22,159,195,354,540
3404-001,2014,10,19,23,101,155,256,354
3404-001,2014,10,19,24,64,116,180,256
3404-001,2014,10,20,1,41,68,109,180
3404-001,2014,10,20,2,28,62,90,109
3404-001,2014,10,20,3,21,37,58,90
3404-001,2014,10,20,4,22,35,57,58
3404-001,2014,10,20,5,34,60,94,57
3404-001,2014,10,20,6,77,187,264,94
3404-001,2014,10,20,7,192,496,688,264
3404-001,2014,10,20,8,424,1649,2073,688
3404-001,2014,10,20,9,554,1337,1891,2073
3404-001,2014,10,20,10,592,627,1219,1891
3404-001,2014,10,20,11,598,595,1193,1219
3404-001,2014,10,20,12,546,585,1131,1193
3404-001,2014,10,20,13,515,520,1035,1131
3404-001,2014,10,20,14,547,545,1092,1035
3404-001,2014,10,20,15,646,601,1247,1092
3404-001,2014,10,20,16,649,562,1211,1247
3404-001,2014,10,20,17,691,555,1246,1211
3404-001,2014,10,20,18,955,512,1467,1246
3404-001,2014,10,20,19,901,398,1299,1467
3404-001,2014,10,20,20,669,319,988,1299
3404-001,2014,10,20,21,591,215,806,988
3404-001,2014,10,20,22,331,192,523,806
3404-001,2014,10,20,23,192,145,337,523
3404-001,2014,10,20,24,101,93,194,337
3404-001,2014,10,21,1,87,55,142,194
3404-001,2014,10,21,2,55,53,108,142
3404-001,2014,10,21,3,31,41,72,108
3404-001,2014,10,21,4,32,32,64,72
3404-001,2014,10,21,5,46,66,112,64
3404-001,2014,10,21,6,75,137,212,112
3404-001,2014,10,21,7,120,409,529,212
3404-001,2014,10,21,8,413,1518,1931,529
3404-001,2014,10,21,9,589,1249,1838,1931
3404-001,2014,10,21,10,577,607,1184,1838
3404-001,2014,10,21,11,602,624,1226,1184
3404-001,2014,10,21,12,579,583,1162,1226
3404-001,2014,10,21,13,505,478,983,1162
3404-001,2014,10,21,14,551,560,1111,983
3404-001,2014,10,21,15,648,596,1244,1111
3404-001,2014,10,21,16,687,567,1254,1244
3404-001,2014,10,21,17,716,530,1246,1254
3404-001,2014,10,21,18,916,490,1406,1246
3404-001,2014,10,21,19,887,418,1305,1406
3404-001,2014,10,21,20,573,285,858,1305
3404-001,2014,10,21,21,587,229,816,858
3404-001,2014,10,21,22,318,178,496,816
3404-001,2014,10,21,23,169,126,295,496
3404-001,2014,10,21,24,106,84,190,295
3404-001,2014,10,22,1,66,71,137,190
3404-001,2014,10,22,2,45,56,101,137
3404-001,2014,10,22,3,50,50,100,101
3404-001,2014,10,22,4,30,31,61,100
3404-001,2014,10,22,5,48,70,118,61
3404-001,2014,10,22,6,99,169,268,118
3404-001,2014,10,22,7,175,481,656,268
3404-001,2014,10,22,8,432,1596,2028,656
3404-001,2014,10,22,9,637,1243,1880,2028
3404-001,2014,10,22,10,612,720,1332,1880
3404-001,2014,10,22,11,662,703,1365,1332
3404-001,2014,10,22,12,687,636,1323,1365
3404-001,2014,10,22,13,524,553,1077,1323
3404-001,2014,10,22,14,609,646,1255,1077
3404-001,2014,10,22,15,702,704,1406,1255
3404-001,2014,10,22,16,767,608,1375,1406
3404-001,2014,10,22,17,806,603,1409,1375
3404-001,2014,10,22,18,1153,578,1731,1409
3404-001,2014,10,22,19,1043,494,1537,1731
3404-001,2014,10,22,20,704,349,1053,1537
3404-001,2014,10,22,21,541,219,760,1053
3404-001,2014,10,22,22,363,227,590,760
3404-001,2014,10,22,23,217,135,352,590
3404-001,2014,10,22,24,120,100,220,352
3404-001,2014,10,23,1,83,63,146,220
3404-001,2014,10,23,2,66,62,128,146
3404-001,2014,10,23,3,47,48,95,128
3404-001,2014,10,23,4,42,32,74,95
3404-001,2014,10,23,5,50,77,127,74
3404-001,2014,10,23,6,100,211,311,127
3404-001,2014,10,23,7,182,505,687,311
3404-001,2014,10,23,8,499,1609,2108,687
3404-001,2014,10,23,9,675,1307,1982,2108
3404-001,2014,10,23,10,681,708,1389,1982
3404-001,2014,10,23,11,698,692,1390,1389
3404-001,2014,10,23,12,578,628,1206,1390
3404-001,2014,10,23,13,442,413,855,1206
3404-001,2014,10,23,14,621,668,1289,855
3404-001,2014,10,23,15,803,666,1469,1289
3404-001,2014,10,23,16,715,615,1330,1469
3404-001,2014,10,23,17,798,573,1371,1330
3404-001,2014,10,23,18,1111,606,1717,1371
3404-001,2014,10,23,19,980,421,1401,1717
3404-001,2014,10,23,20,690,360,1050,1401
3404-001,2014,10,23,21,560,269,829,1050
3404-001,2014,10,23,22,323,212,535,829
3404-001,2014,10,23,23,202,141,343,535
3404-001,2014,10,23,24,120,97,217,343
3404-001,2014,10,24,1,62,74,136,217
3404-001,2014,10,24,2,54,69,123,136
3404-001,2014,10,24,3,43,49,92,123
3404-001,2014,10,24,4,47,51,98,92
3404-001,2014,10,24,5,56,79,135,98
3404-001,2014,10,24,6,105,194,299,135
3404-001,2014,10,24,7,172,500,672,299
3404-001,2014,10,24,8,462,1643,2105,672
3404-001,2014,10,24,9,694,1219,1913,2105
3404-001,2014,10,24,10,668,786,1454,1913
3404-001,2014,10,24,11,733,704,1437,1454
3404-001,2014,10,24,12,672,597,1269,1437
3404-001,2014,10,24,13,578,587,1165,1269
3404-001,2014,10,24,14,608,632,1240,1165
3404-001,2014,10,24,15,577,697,1274,1240
3404-001,2014,10,24,16,880,618,1498,1274
3404-001,2014,10,24,17,832,591,1423,1498
3404-001,2014,10,24,18,1270,568,1838,1423
3404-001,2014,10,24,19,1167,474,1641,1838
3404-001,2014,10,24,20,828,429,1257,1641
3404-001,2014,10,24,21,621,273,894,1257
3404-001,2014,10,24,22,334,219,553,894
3404-001,2014,10,24,23,176,141,317,553
3404-001,2014,10,24,24,136,100,236,317
3404-001,2014,10,25,1,91,58,149,236
3404-001,2014,10,25,2,67,50,117,149
3404-001,2014,10,25,3,47,48,95,117
3404-001,2014,10,25,4,48,44,92,95
3404-001,2014,10,25,5,59,78,137,92
3404-001,2014,10,25,6,110,194,304,137
3404-001,2014,10,25,7,180,343,523,304
3404-001,2014,10,25,8,369,721,1090,523
3404-001,2014,10,25,9,508,675,1183,1090
3404-001,2014,10,25,10,499,574,1073,1183
3404-001,2014,10,25,11,475,607,1082,1073
3404-001,2014,10,25,12,467,505,972,1082
3404-001,2014,10,25,13,475,497,972,972
3404-001,2014,10,25,14,545,508,1053,972
3404-001,2014,10,25,15,517,495,1012,1053
3404-001,2014,10,25,16,596,474,1070,1012
3404-001,2014,10,25,17,631,449,1080,1070
3404-001,2014,10,25,18,881,449,1330,1080
3404-001,2014,10,25,19,731,381,1112,1330
3404-001,2014,10,25,20,400,300,700,1112
3404-001,2014,10,25,21,240,211,451,700
3404-001,2014,10,25,22,193,169,362,451
3404-001,2014,10,25,23,136,110,246,362
3404-001,2014,10,25,24,91,68,159,246
3404-001,2014,10,26,1,44,54,98,159
3404-001,2014,10,26,2,42,37,79,98
3404-001,2014,10,26,3,39,34,73,79
3404-001,2014,10,26,4,27,35,62,73
3404-001,2014,10,26,5,24,29,53,62
3404-001,2014,10,26,6,65,94,159,53
3404-001,2014,10,26,7,99,179,278,159
3404-001,2014,10,26,8,174,292,466,278
3404-001,2014,10,26,9,226,320,546,466
3404-001,2014,10,26,10,226,285,511,546
3404-001,2014,10,26,11,287,378,665,511
3404-001,2014,10,26,12,283,335,618,665
3404-001,2014,10,26,13,334,342,676,618
3404-001,2014,10,26,14,347,394,741,676
3404-001,2014,10,26,15,392,353,745,741
3404-001,2014,10,26,16,491,361,852,745
3404-001,2014,10,26,17,538,319,857,852
3404-001,2014,10,26,18,680,356,1036,857
3404-001,2014,10,26,19,584,306,890,1036
3404-001,2014,10,26,20,368,254,622,890
3404-001,2014,10,26,21,256,263,519,622
3404-001,2014,10,26,22,146,203,349,519
3404-001,2014,10,26,23,103,157,260,349
3404-001,2014,10,26,24,61,107,168,260
3404-001,2014,10,27,1,34,57,91,168
3404-001,2014,10,27,2,19,51,70,91
3404-001,2014,10,27,3,28,49,77,70
3404-001,2014,10,27,4,26,38,64,77
3404-001,2014,10,27,5,66,65,131,64
3404-001,2014,10,27,6,116,239,355,131
3404-001,2014,10,27,7,211,588,799,355
3404-001,2014,10,27,8,505,1884,2389,799
3404-001,2014,10,27,9,611,1331,1942,2389
3404-001,2014,10,27,10,553,703,1256,1942
3404-001,2014,10,27,11,625,737,1362,1256
3404-001,2014,10,27,12,632,609,1241,1362
3404-001,2014,10,27,13,562,510,1072,1241
3404-001,2014,10,27,14,626,657,1283,1072
3404-001,2014,10,27,15,737,743,1480,1283
3404-001,2014,10,27,16,797,646,1443,1480
3404-001,2014,10,27,17,730,608,1338,1443
3404-001,2014,10,27,18,1051,584,1635,1338
3404-001,2014,10,27,19,1014,428,1442,1635
3404-001,2014,10,27,20,669,393,1062,1442
3404-001,2014,10,27,21,633,249,882,1062
3404-001,2014,10,27,22,338,206,544,882
3404-001,2014,10,27,23,200,131,331,544
3404-001,2014,10,27,24,120,101,221,331
3404-001,2014,10,28,1,86,89,175,221
3404-001,2014,10,28,2,73,62,135,175
3404-001,2014,10,28,3,38,38,76,135
3404-001,2014,10,28,4,41,41,82,76
3404-001,2014,10,28,5,84,78,162,82
3404-001,2014,10,28,6,115,224,339,162
3404-001,2014,10,28,7,175,526,701,339
3404-001,2014,10,28,8,503,1762,2265,701
3404-001,2014,10,28,9,698,1297,1995,2265
3404-001,2014,10,28,10,611,736,1347,1995
3404-001,2014,10,28,11,723,686,1409,1347
3404-001,2014,10,28,12,643,694,1337,1409
3404-001,2014,10,28,13,584,539,1123,1337
3404-001,2014,10,28,14,657,675,1332,1123
3404-001,2014,10,28,15,748,747,1495,1332
3404-001,2014,10,28,16,780,673,1453,1495
3404-001,2014,10,28,17,758,569,1327,1453
3404-001,2014,10,28,18,1149,544,1693,1327
3404-001,2014,10,28,19,1069,449,1518,1693
3404-001,2014,10,28,20,700,373,1073,1518
3404-001,2014,10,28,21,613,265,878,1073
3404-001,2014,10,28,22,349,206,555,878
3404-001,2014,10,28,23,214,138,352,555
3404-001,2014,10,28,24,105,83,188,352
3404-001,2014,10,29,1,68,73,141,188
3404-001,2014,10,29,2,74,44,118,141
3404-001,2014,10,29,3,36,39,75,118
3404-001,2014,10,29,4,43,45,88,75
3404-001,2014,10,29,5,48,80,128,88
3404-001,2014,10,29,6,107,212,319,128
3404-001,2014,10,29,7,181,532,713,319
3404-001,2014,10,29,8,480,1701,2181,713
3404-001,2014,10,29,9,679,1228,1907,2181
3404-001,2014,10,29,10,653,728,1381,1907
3404-001,2014,10,29,11,687,657,1344,1381
3404-001,2014,10,29,12,620,649,1269,1344
3404-001,2014,10,29,13,550,517,1067,1269
3404-001,2014,10,29,14,637,634,1271,1067
3404-001,2014,10,29,15,721,678,1399,1271
3404-001,2014,10,29,16,742,652,1394,1399
3404-001,2014,10,29,17,787,581,1368,1394
3404-001,2014,10,29,18,1172,576,1748,1368
3404-001,2014,10,29,19,1058,471,1529,1748
3404-001,2014,10,29,20,723,355,1078,1529
3404-001,2014,10,29,21,523,222,745,1078
3404-001,2014,10,29,22,339,180,519,745
3404-001,2014,10,29,23,220,158,378,519
3404-001,2014,10,29,24,136,86,222,378
3404-001,2014,10,30,1,95,66,161,222
3404-001,2014,10,30,2,61,53,114,161
3404-001,2014,10,30,3,46,41,87,114
3404-001,2014,10,30,4,38,48,86,87
3404-001,2014,10,30,5,59,82,141,86
3404-001,2014,10,30,6,103,208,311,141
3404-001,2014,10,30,7,182,530,712,311
3404-001,2014,10,30,8,434,1695,2129,712
3404-001,2014,10,30,9,687,1266,1953,2129
3404-001,2014,10,30,10,667,750,1417,1953
3404-001,2014,10,30,11,697,713,1410,1417
3404-001,2014,10,30,12,648,635,1283,1410
3404-001,2014,10,30,13,549,557,1106,1283
3404-001,2014,10,30,14,619,625,1244,1106
3404-001,2014,10,30,15,754,715,1469,1244
3404-001,2014,10,30,16,794,674,1468,1469
3404-001,2014,10,30,17,864,617,1481,1468
3404-001,2014,10,30,18,1165,563,1728,1481
3404-001,2014,10,30,19,1040,479,1519,1728
3404-001,2014,10,30,20,682,363,1045,1519
3404-001,2014,10,30,21,615,258,873,1045
3404-001,2014,10,30,22,343,218,561,873
3404-001,2014,10,30,23,215,147,362,561
3404-001,2014,10,30,24,129,93,222,362
3404-001,2014,10,31,1,82,68,150,222
3404-001,2014,10,31,2,74,61,135,150
3404-001,2014,10,31,3,41,45,86,135
3404-001,2014,10,31,4,32,42,74,86
3404-001,2014,10,31,5,67,70,137,74
3404-001,2014,10,31,6,118,175,293,137
3404-001,2014,10,31,7,192,463,655,293
3404-001,2014,10,31,8,418,1553,1971,655
3404-001,2014,10,31,9,662,1227,1889,1971
3404-001,2014,10,31,10,609,627,1236,1889
3404-001,2014,10,31,11,685,684,1369,1236
3404-001,2014,10,31,12,648,614,1262,1369
3404-001,2014,10,31,13,571,432,1003,1262
3404-001,2014,10,31,14,662,597,1259,1003
3404-001,2014,10,31,15,683,594,1277,1259
3404-001,2014,10,31,16,709,590,1299,1277
3404-001,2014,10,31,17,722,537,1259,1299
3404-001,2014,10,31,18,1147,526,1673,1259
3404-001,2014,10,31,19,1098,478,1576,1673
3404-001,2014,10,31,20,747,429,1176,1576
3404-001,2014,10,31,21,542,285,827,1176
3404-001,2014,10,31,22,327,189,516,827
3404-001,2014,10,31,23,194,134,328,516
3404-001,2014,10,31,24,111,72,183,328
3404-001,2014,11,1,1,93,74,167,183
3404-001,2014,11,1,2,62,51,113,167
3404-001,2014,11,1,3,53,46,99,113
3404-001,2014,11,1,4,45,46,91,99
3404-001,2014,11,1,5,53,77,130,91
3404-001,2014,11,1,6,86,164,250,130
3404-001,2014,11,1,7,156,230,386,250
3404-001,2014,11,1,8,314,646,960,386
3404-001,2014,11,1,9,519,601,1120,960
3404-001,2014,11,1,10,486,542,1028,1120
3404-001,2014,11,1,11,480,542,1022,1028
3404-001,2014,11,1,12,487,534,1021,1022
3404-001,2014,11,1,13,477,464,941,1021
3404-001,2014,11,1,14,497,444,941,941
3404-001,2014,11,1,15,501,495,996,941
3404-001,2014,11,1,16,596,415,1011,996
3404-001,2014,11,1,17,621,450,1071,1011
3404-001,2014,11,1,18,811,392,1203,1071
3404-001,2014,11,1,19,550,367,917,1203
3404-001,2014,11,1,20,370,282,652,917
3404-001,2014,11,1,21,245,205,450,652
3404-001,2014,11,1,22,164,165,329,450
3404-001,2014,11,1,23,107,116,223,329
3404-001,2014,11,1,24,93,80,173,223
3404-001,2014,11,2,1,63,53,116,173
3404-001,2014,11,2,2,49,36,85,116
3404-001,2014,11,2,3,28,26,54,85
3404-001,2014,11,2,4,22,23,45,54
3404-001,2014,11,2,5,36,32,68,45
3404-001,2014,11,2,6,54,52,106,68
3404-001,2014,11,2,7,56,100,156,106
3404-001,2014,11,2,8,140,199,339,156
3404-001,2014,11,2,9,194,227,421,339
3404-001,2014,11,2,10,240,257,497,421
3404-001,2014,11,2,11,270,310,580,497
3404-001,2014,11,2,12,306,345,651,580
3404-001,2014,11,2,13,303,299,602,651
3404-001,2014,11,2,14,338,376,714,602
3404-001,2014,11,2,15,362,323,685,714
3404-001,2014,11,2,16,420,352,772,685
3404-001,2014,11,2,17,447,336,783,772
3404-001,2014,11,2,18,477,358,835,783
3404-001,2014,11,2,19,353,274,627,835
3404-001,2014,11,2,20,270,287,557,627
3404-001,2014,11,2,21,196,223,419,557
3404-001,2014,11,2,22,124,201,325,419
3404-001,2014,11,2,23,88,156,244,325
3404-001,2014,11,2,24,51,88,139,244
3404-001,2014,11,3,1,36,71,107,139
3404-001,2014,11,3,2,25,39,64,107
3404-001,2014,11,3,3,20,44,64,64
3404-001,2014,11,3,4,28,42,70,64
3404-001,2014,11,3,5,41,69,110,70
3404-001,2014,11,3,6,117,255,372,110
3404-001,2014,11,3,7,197,582,779,372
3404-001,2014,11,3,8,474,1848,2322,779
3404-001,2014,11,3,9,604,1362,1966,2322
3404-001,2014,11,3,10,566,680,1246,1966
3404-001,2014,11,3,11,634,654,1288,1246
3404-001,2014,11,3,12,547,623,1170,1288
3404-001,2014,11,3,13,524,543,1067,1170
3404-001,2014,11,3,14,546,616,1162,1067
3404-001,2014,11,3,15,711,652,1363,1162
3404-001,2014,11,3,16,753,649,1402,1363
3404-001,2014,11,3,17,741,567,1308,1402
3404-001,2014,11,3,18,1026,566,1592,1308
3404-001,2014,11,3,19,909,460,1369,1592
3404-001,2014,11,3,20,690,353,1043,1369
3404-001,2014,11,3,21,624,230,854,1043
3404-001,2014,11,3,22,365,184,549,854
3404-001,2014,11,3,23,223,153,376,549
3404-001,2014,11,3,24,135,118,253,376
3404-001,2014,11,4,1,86,67,153,253
3404-001,2014,11,4,2,63,54,117,153
3404-001,2014,11,4,3,31,43,74,117
3404-001,2014,11,4,4,38,48,86,74
3404-001,2014,11,4,5,56,66,122,86
3404-001,2014,11,4,6,117,216,333,122
3404-001,2014,11,4,7,207,525,732,333
3404-001,2014,11,4,8,488,1660,2148,732
3404-001,2014,11,4,9,658,1290,1948,2148
3404-001,2014,11,4,10,647,705,1352,1948
3404-001,2014,11,4,11,658,752,1410,1352
3404-001,2014,11,4,12,648,648,1296,1410
3404-001,2014,11,4,13,629,528,1157,1296
3404-001,2014,11,4,14,644,635,1279,1157
3404-001,2014,11,4,15,765,751,1516,1279
3404-001,2014,11,4,16,810,645,1455,1516
3404-001,2014,11,4,17,785,582,1367,1455
3404-001,2014,11,4,18,1109,614,1723,1367
3404-001,2014,11,4,19,996,448,1444,1723
3404-001,2014,11,4,20,686,361,1047,1444
3404-001,2014,11,4,21,624,268,892,1047
3404-001,2014,11,4,22,348,211,559,892
3404-001,2014,11,4,23,210,124,334,559
3404-001,2014,11,4,24,127,85,212,334
3404-001,2014,11,5,1,79,71,150,212
3404-001,2014,11,5,2,62,49,111,150
3404-001,2014,11,5,3,44,46,90,111
3404-001,2014,11,5,4,40,54,94,90
3404-001,2014,11,5,5,62,75,137,94
3404-001,2014,11,5,6,119,171,290,137
3404-001,2014,11,5,7,186,494,680,290
3404-001,2014,11,5,8,466,1701,2167,680
3404-001,2014,11,5,9,717,1294,2011,2167
3404-001,2014,11,5,10,645,730,1375,2011
3404-001,2014,11,5,11,675,706,1381,1375
3404-001,2014,11,5,12,686,666,1352,1381
3404-001,2014,11,5,13,586,521,1107,1352
3404-001,2014,11,5,14,681,654,1335,1107
3404-001,2014,11,5,15,714,700,1414,1335
3404-001,2014,11,5,16,858,649,1507,1414
3404-001,2014,11,5,17,815,615,1430,1507
3404-001,2014,11,5,18,1220,586,1806,1430
3404-001,2014,11,5,19,1069,486,1555,1806
3404-001,2014,11,5,20,625,359,984,1555
3404-001,2014,11,5,21,548,240,788,984
3404-001,2014,11,5,22,354,194,548,788
3404-001,2014,11,5,23,199,140,339,548
3404-001,2014,11,5,24,132,93,225,339
3404-001,2014,11,6,1,86,77,163,225
3404-001,2014,11,6,2,78,46,124,163
3404-001,2014,11,6,3,44,44,88,124
3404-001,2014,11,6,4,49,46,95,88
3404-001,2014,11,6,5,64,78,142,95
3404-001,2014,11,6,6,113,201,314,142
3404-001,2014,11,6,7,200,525,725,314
3404-001,2014,11,6,8,460,1633,2093,725
3404-001,2014,11,6,9,706,1333,2039,2093
3404-001,2014,11,6,10,649,761,1410,2039
3404-001,2014,11,6,11,725,801,1526,1410
3404-001,2014,11,6,12,680,665,1345,1526
3404-001,2014,11,6,13,551,545,1096,1345
3404-001,2014,11,6,14,623,685,1308,1096
3404-001,2014,11,6,15,772,675,1447,1308
3404-001,2014,11,6,16,776,681,1457,1447
3404-001,2014,11,6,17,796,575,1371,1457
3404-001,2014,11,6,18,1133,536,1669,1371
3404-001,2014,11,6,19,1010,474,1484,1669
3404-001,2014,11,6,20,682,376,1058,1484
3404-001,2014,11,6,21,633,225,858,1058
3404-001,2014,11,6,22,366,204,570,858
3404-001,2014,11,6,23,213,157,370,570
3404-001,2014,11,6,24,124,102,226,370
3404-001,2014,11,7,1,81,76,157,226
3404-001,2014,11,7,2,76,40,116,157
3404-001,2014,11,7,3,55,52,107,116
3404-001,2014,11,7,4,43,47,90,107
3404-001,2014,11,7,5,54,86,140,90
3404-001,2014,11,7,6,127,203,330,140
3404-001,2014,11,7,7,201,515,716,330
3404-001,2014,11,7,8,480,1665,2145,716
3404-001,2014,11,7,9,728,1326,2054,2145
3404-001,2014,11,7,10,646,743,1389,2054
3404-001,2014,11,7,11,693,726,1419,1389
3404-001,2014,11,7,12,680,638,1318,1419
3404-001,2014,11,7,13,596,514,1110,1318
3404-001,2014,11,7,14,650,632,1282,1110
3404-001,2014,11,7,15,830,712,1542,1282
3404-001,2014,11,7,16,877,685,1562,1542
3404-001,2014,11,7,17,850,627,1477,1562
3404-001,2014,11,7,18,1363,603,1966,1477
3404-001,2014,11,7,19,1210,509,1719,1966
3404-001,2014,11,7,20,814,391,1205,1719
3404-001,2014,11,7,21,604,289,893,1205
3404-001,2014,11,7,22,370,207,577,893
3404-001,2014,11,7,23,198,161,359,577
3404-001,2014,11,7,24,126,104,230,359
3404-001,2014,11,8,1,91,85,176,230
3404-001,2014,11,8,2,77,48,125,176
3404-001,2014,11,8,3,45,49,94,125
3404-001,2014,11,8,4,46,36,82,94
3404-001,2014,11,8,5,85,79,164,82
3404-001,2014,11,8,6,136,208,344,164
3404-001,2014,11,8,7,168,320,488,344
3404-001,2014,11,8,8,342,675,1017,488
3404-001,2014,11,8,9,497,671,1168,1017
3404-001,2014,11,8,10,453,636,1089,1168
3404-001,2014,11,8,11,497,641,1138,1089
3404-001,2014,11,8,12,505,521,1026,1138
3404-001,2014,11,8,13,490,443,933,1026
3404-001,2014,11,8,14,523,510,1033,933
3404-001,2014,11,8,15,573,449,1022,1033
3404-001,2014,11,8,16,580,444,1024,1022
3404-001,2014,11,8,17,674,437,1111,1024
3404-001,2014,11,8,18,939,486,1425,1111
3404-001,2014,11,8,19,604,373,977,1425
3404-001,2014,11,8,20,383,279,662,977
3404-001,2014,11,8,21,252,194,446,662
3404-001,2014,11,8,22,178,155,333,446
3404-001,2014,11,8,23,118,89,207,333
3404-001,2014,11,8,24,68,50,118,207
3404-001,2014,11,9,1,51,45,96,118
3404-001,2014,11,9,2,30,30,60,96
3404-001,2014,11,9,3,29,31,60,60
3404-001,2014,11,9,4,28,19,47,60
3404-001,2014,11,9,5,31,34,65,47
3404-001,2014,11,9,6,59,89,148,65
3404-001,2014,11,9,7,92,160,252,148
3404-001,2014,11,9,8,154,267,421,252
3404-001,2014,11,9,9,290,314,604,421
3404-001,2014,11,9,10,268,326,594,604
3404-001,2014,11,9,11,288,398,686,594
3404-001,2014,11,9,12,278,360,638,686
3404-001,2014,11,9,13,307,338,645,638
3404-001,2014,11,9,14,365,343,708,645
3404-001,2014,11,9,15,428,364,792,708
3404-001,2014,11,9,16,470,432,902,792
3404-001,2014,11,9,17,591,433,1024,902
3404-001,2014,11,9,18,830,353,1183,1024
3404-001,2014,11,9,19,674,329,1003,1183
3404-001,2014,11,9,20,405,319,724,1003
3404-001,2014,11,9,21,251,248,499,724
3404-001,2014,11,9,22,166,211,377,499
3404-001,2014,11,9,23,70,180,250,377
3404-001,2014,11,9,24,55,102,157,250
3404-001,2014,11,10,1,38,64,102,157
3404-001,2014,11,10,2,22,42,64,102
3404-001,2014,11,10,3,15,36,51,64
3404-001,2014,11,10,4,27,37,64,51
3404-001,2014,11,10,5,53,78,131,64
3404-001,2014,11,10,6,96,236,332,131
3404-001,2014,11,10,7,232,625,857,332
3404-001,2014,11,10,8,508,1917,2425,857
3404-001,2014,11,10,9,623,1350,1973,2425
3404-001,2014,11,10,10,592,653,1245,1973
3404-001,2014,11,10,11,655,710,1365,1245
3404-001,2014,11,10,12,602,643,1245,1365
3404-001,2014,11,10,13,576,544,1120,1245
3404-001,2014,11,10,14,589,643,1232,1120
3404-001,2014,11,10,15,718,738,1456,1232
3404-001,2014,11,10,16,797,657,1454,1456
3404-001,2014,11,10,17,829,609,1438,1454
3404-001,2014,11,10,18,1140,561,1701,1438
3404-001,2014,11,10,19,979,463,1442,1701
3404-001,2014,11,10,20,640,337,977,1442
3404-001,2014,11,10,21,618,243,861,977
3404-001,2014,11,10,22,419,184,603,861
3404-001,2014,11,10,23,211,132,343,603
3404-001,2014,11,10,24,117,101,218,343
3404-001,2014,11,11,1,94,76,170,218
3404-001,2014,11,11,2,59,57,116,170
3404-001,2014,11,11,3,49,54,103,116
3404-001,2014,11,11,4,49,38,87,103
3404-001,2014,11,11,5,71,97,168,87
3404-001,2014,11,11,6,130,190,320,168
3404-001,2014,11,11,7,189,527,716,320
3404-001,2014,11,11,8,456,1650,2106,716
3404-001,2014,11,11,9,747,1342,2089,2106
3404-001,2014,11,11,10,687,718,1405,2089
3404-001,2014,11,11,11,714,712,1426,1405
3404-001,2014,11,11,12,681,707,1388,1426
3404-001,2014,11,11,13,612,563,1175,1388
3404-001,2014,11,11,14,664,691,1355,1175
3404-001,2014,11,11,15,766,685,1451,1355
3404-001,2014,11,11,16,789,630,1419,1451
3404-001,2014,11,11,17,773,639,1412,1419
3404-001,2014,11,11,18,1132,555,1687,1412
3404-001,2014,11,11,19,1003,453,1456,1687
3404-001,2014,11,11,20,731,374,1105,1456
3404-001,2014,11,11,21,668,239,907,1105
3404-001,2014,11,11,22,372,226,598,907
3404-001,2014,11,11,23,225,143,368,598
3404-001,2014,11,11,24,109,94,203,368
3404-001,2014,11,12,1,88,86,174,203
3404-001,2014,11,12,2,73,46,119,174
3404-001,2014,11,12,3,35,47,82,119
3404-001,2014,11,12,4,46,50,96,82
3404-001,2014,11,12,5,61,78,139,96
3404-001,2014,11,12,6,114,181,295,139
3404-001,2014,11,12,7,184,453,637,295
3404-001,2014,11,12,8,469,1637,2106,637
3404-001,2014,11,12,9,684,1296,1980,2106
3404-001,2014,11,12,10,626,715,1341,1980
3404-001,2014,11,12,11,695,727,1422,1341
3404-001,2014,11,12,12,693,669,1362,1422
3404-001,2014,11,12,13,556,535,1091,1362
3404-001,2014,11,12,14,627,654,1281,1091
3404-001,2014,11,12,15,777,691,1468,1281
3404-001,2014,11,12,16,728,660,1388,1468
3404-001,2014,11,12,17,736,586,1322,1388
3404-001,2014,11,12,18,1085,500,1585,1322
3404-001,2014,11,12,19,1007,415,1422,1585
3404-001,2014,11,12,20,648,375,1023,1422
3404-001,2014,11,12,21,506,237,743,1023
3404-001,2014,11,12,22,337,178,515,743
3404-001,2014,11,12,23,176,134,310,515
3404-001,2014,11,12,24,108,93,201,310
3404-001,2014,11,13,1,59,72,131,201
3404-001,2014,11,13,2,76,47,123,131
3404-001,2014,11,13,3,51,43,94,123
3404-001,2014,11,13,4,32,45,77,94
3404-001,2014,11,13,5,50,80,130,77
3404-001,2014,11,13,6,110,195,305,130
3404-001,2014,11,13,7,166,482,648,305
3404-001,2014,11,13,8,452,1599,2051,648
3404-001,2014,11,13,9,656,1262,1918,2051
3404-001,2014,11,13,10,656,723,1379,1918
3404-001,2014,11,13,11,688,714,1402,1379
3404-001,2014,11,13,12,681,652,1333,1402
3404-001,2014,11,13,13,555,548,1103,1333
3404-001,2014,11,13,14,624,657,1281,1103
3404-001,2014,11,13,15,749,707,1456,1281
3404-001,2014,11,13,16,842,671,1513,1456
3404-001,2014,11,13,17,770,570,1340,1513
3404-001,2014,11,13,18,1089,569,1658,1340
3404-001,2014,11,13,19,959,458,1417,1658
3404-001,2014,11,13,20,666,331,997,1417
3404-001,2014,11,13,21,601,267,868,997
3404-001,2014,11,13,22,361,225,586,868
3404-001,2014,11,13,23,208,136,344,586
3404-001,2014,11,13,24,130,88,218,344
3404-001,2014,11,14,1,55,85,140,218
3404-001,2014,11,14,2,66,42,108,140
3404-001,2014,11,14,3,37,44,81,108
3404-001,2014,11,14,4,41,42,83,81
3404-001,2014,11,14,5,57,83,140,83
3404-001,2014,11,14,6,101,197,298,140
3404-001,2014,11,14,7,197,505,702,298
3404-001,2014,11,14,8,440,1615,2055,702
3404-001,2014,11,14,9,677,1232,1909,2055
3404-001,2014,11,14,10,656,723,1379,1909
3404-001,2014,11,14,11,676,704,1380,1379
3404-001,2014,11,14,12,696,644,1340,1380
3404-001,2014,11,14,13,621,579,1200,1340
3404-001,2014,11,14,14,635,646,1281,1200
3404-001,2014,11,14,15,814,703,1517,1281
3404-001,2014,11,14,16,779,656,1435,1517
3404-001,2014,11,14,17,881,603,1484,1435
3404-001,2014,11,14,18,1330,559,1889,1484
3404-001,2014,11,14,19,1315,517,1832,1889
3404-001,2014,11,14,20,792,454,1246,1832
3404-001,2014,11,14,21,623,305,928,1246
3404-001,2014,11,14,22,351,201,552,928
3404-001,2014,11,14,23,214,154,368,552
3404-001,2014,11,14,24,130,92,222,368
3404-001,2014,11,15,1,84,70,154,222
3404-001,2014,11,15,2,84,43,127,154
3404-001,2014,11,15,3,48,56,104,127
3404-001,2014,11,15,4,49,48,97,104
3404-001,2014,11,15,5,59,65,124,97
3404-001,2014,11,15,6,91,172,263,124
3404-001,2014,11,15,7,175,339,514,263
3404-001,2014,11,15,8,353,731,1084,514
3404-001,2014,11,15,9,542,702,1244,1084
3404-001,2014,11,15,10,521,619,1140,1244
3404-001,2014,11,15,11,539,602,1141,1140
3404-001,2014,11,15,12,534,564,1098,1141
3404-001,2014,11,15,13,554,470,1024,1098
3404-001,2014,11,15,14,580,505,1085,1024
3404-001,2014,11,15,15,573,537,1110,1085
3404-001,2014,11,15,16,616,493,1109,1110
3404-001,2014,11,15,17,675,470,1145,1109
3404-001,2014,11,15,18,913,443,1356,1145
3404-001,2014,11,15,19,603,361,964,1356
3404-001,2014,11,15,20,413,305,718,964
3404-001,2014,11,15,21,237,208,445,718
3404-001,2014,11,15,22,199,172,371,445
3404-001,2014,11,15,23,116,123,239,371
3404-001,2014,11,15,24,65,85,150,239
3404-001,2014,11,16,1,55,61,116,150
3404-001,2014,11,16,2,42,32,74,116
3404-001,2014,11,16,3,36,34,70,74
3404-001,2014,11,16,4,25,28,53,70
3404-001,2014,11,16,5,36,35,71,53
3404-001,2014,11,16,6,63,77,140,71
3404-001,2014,11,16,7,64,158,222,140
3404-001,2014,11,16,8,199,263,462,222
3404-001,2014,11,16,9,247,280,527,462
3404-001,2014,11,16,10,249,302,551,527
3404-001,2014,11,16,11,305,360,665,551
3404-001,2014,11,16,12,319,319,638,665
3404-001,2014,11,16,13,341,324,665,638
3404-001,2014,11,16,14,403,341,744,665
3404-001,2014,11,16,15,431,344,775,744
3404-001,2014,11,16,16,495,380,875,775
3404-001,2014,11,16,17,638,387,1025,875
3404-001,2014,11,16,18,679,370,1049,1025
3404-001,2014,11,16,19,547,348,895,1049
3404-001,2014,11,16,20,360,325,685,895
3404-001,2014,11,16,21,226,229,455,685
3404-001,2014,11,16,22,147,246,393,455
3404-001,2014,11,16,23,87,159,246,393
3404-001,2014,11,16,24,63,98,161,246
3404-001,2014,11,17,1,27,74,101,161
3404-001,2014,11,17,2,29,39,68,101
3404-001,2014,11,17,3,10,33,43,68
3404-001,2014,11,17,4,30,41,71,43
3404-001,2014,11,17,5,51,88,139,71
3404-001,2014,11,17,6,109,225,334,139
3404-001,2014,11,17,7,206,588,794,334
3404-001,2014,11,17,8,471,1690,2161,794
3404-001,2014,11,17,9,605,1494,2099,2161
3404-001,2014,11,17,10,597,647,1244,2099
3404-001,2014,11,17,11,621,656,1277,1244
3404-001,2014,11,17,12,633,616,1249,1277
3404-001,2014,11,17,13,499,527,1026,1249
3404-001,2014,11,17,14,585,650,1235,1026
3404-001,2014,11,17,15,715,702,1417,1235
3404-001,2014,11,17,16,716,632,1348,1417
3404-001,2014,11,17,17,779,584,1363,1348
3404-001,2014,11,17,18,956,486,1442,1363
3404-001,2014,11,17,19,903,457,1360,1442
3404-001,2014,11,17,20,694,336,1030,1360
3404-001,2014,11,17,21,646,233,879,1030
3404-001,2014,11,17,22,352,195,547,879
3404-001,2014,11,17,23,227,132,359,547
3404-001,2014,11,17,24,129,86,215,359
3404-001,2014,11,18,1,70,87,157,215
3404-001,2014,11,18,2,60,66,126,157
3404-001,2014,11,18,3,37,33,70,126
3404-001,2014,11,18,4,44,53,97,70
3404-001,2014,11,18,5,65,77,142,97
3404-001,2014,11,18,6,128,199,327,142
3404-001,2014,11,18,7,157,483,640,327
3404-001,2014,11,18,8,472,1605,2077,640
3404-001,2014,11,18,9,682,1321,2003,2077
3404-001,2014,11,18,10,670,757,1427,2003
3404-001,2014,11,18,11,659,660,1319,1427
3404-001,2014,11,18,12,718,670,1388,1319
3404-001,2014,11,18,13,588,541,1129,1388
3404-001,2014,11,18,14,617,667,1284,1129
3404-001,2014,11,18,15,758,705,1463,1284
3404-001,2014,11,18,16,762,685,1447,1463
3404-001,2014,11,18,17,824,640,1464,1447
3404-001,2014,11,18,18,1150,544,1694,1464
3404-001,2014,11,18,19,1003,444,1447,1694
3404-001,2014,11,18,20,657,325,982,1447
3404-001,2014,11,18,21,611,242,853,982
3404-001,2014,11,18,22,354,217,571,853
3404-001,2014,11,18,23,188,135,323,571
3404-001,2014,11,18,24,118,108,226,323
3404-001,2014,11,19,1,70,68,138,226
3404-001,2014,11,19,2,67,57,124,138
3404-001,2014,11,19,3,49,45,94,124
3404-001,2014,11,19,4,42,47,89,94
3404-001,2014,11,19,5,54,86,140,89
3404-001,2014,11,19,6,93,200,293,140
3404-001,2014,11,19,7,199,471,670,293
3404-001,2014,11,19,8,462,1651,2113,670
3404-001,2014,11,19,9,723,1348,2071,2113
3404-001,2014,11,19,10,665,721,1386,2071
3404-001,2014,11,19,11,673,723,1396,1386
3404-001,2014,11,19,12,709,622,1331,1396
3404-001,2014,11,19,13,596,513,1109,1331
3404-001,2014,11,19,14,614,670,1284,1109
3404-001,2014,11,19,15,761,661,1422,1284
3404-001,2014,11,19,16,773,641,1414,1422
3404-001,2014,11,19,17,843,605,1448,1414
3404-001,2014,11,19,18,1206,550,1756,1448
3404-001,2014,11,19,19,1029,461,1490,1756
3404-001,2014,11,19,20,661,373,1034,1490
3404-001,2014,11,19,21,594,258,852,1034
3404-001,2014,11,19,22,348,208,556,852
3404-001,2014,11,19,23,186,132,318,556
3404-001,2014,11,19,24,128,101,229,318
3404-001,2014,11,20,1,86,79,165,229
3404-001,2014,11,20,2,56,50,106,165
3404-001,2014,11,20,3,49,41,90,106
3404-001,2014,11,20,4,33,50,83,90
3404-001,2014,11,20,5,64,75,139,83
3404-001,2014,11,20,6,121,206,327,139
3404-001,2014,11,20,7,195,473,668,327
3404-001,2014,11,20,8,467,1655,2122,668
3404-001,2014,11,20,9,755,1359,2114,2122
3404-001,2014,11,20,10,723,701,1424,2114
3404-001,2014,11,20,11,691,708,1399,1424
3404-001,2014,11,20,12,707,717,1424,1399
3404-001,2014,11,20,13,590,516,1106,1424
3404-001,2014,11,20,14,619,713,1332,1106
3404-001,2014,11,20,15,770,719,1489,1332
3404-001,2014,11,20,16,805,627,1432,1489
3404-001,2014,11,20,17,853,619,1472,1432
3404-001,2014,11,20,18,1089,586,1675,1472
3404-001,2014,11,20,19,995,433,1428,1675
3404-001,2014,11,20,20,631,358,989,1428
3404-001,2014,11,20,21,624,239,863,989
3404-001,2014,11,20,22,343,220,563,863
3404-001,2014,11,20,23,219,139,358,563
3404-001,2014,11,20,24,105,92,197,358
3404-001,2014,11,21,1,94,82,176,197
3404-001,2014,11,21,2,69,55,124,176
3404-001,2014,11,21,3,39,38,77,124
3404-001,2014,11,21,4,41,56,97,77
3404-001,2014,11,21,5,64,89,153,97
3404-001,2014,11,21,6,111,224,335,153
3404-001,2014,11,21,7,188,498,686,335
3404-001,2014,11,21,8,456,1641,2097,686
3404-001,2014,11,21,9,683,1339,2022,2097
3404-001,2014,11,21,10,726,748,1474,2022
3404-001,2014,11,21,11,756,753,1509,1474
3404-001,2014,11,21,12,745,685,1430,1509
3404-001,2014,11,21,13,686,540,1226,1430
3404-001,2014,11,21,14,650,723,1373,1226
3404-001,2014,11,21,15,800,691,1491,1373
3404-001,2014,11,21,16,887,707,1594,1491
3404-001,2014,11,21,17,899,651,1550,1594
3404-001,2014,11,21,18,1367,596,1963,1550
3404-001,2014,11,21,19,1295,536,1831,1963
3404-001,2014,11,21,20,839,446,1285,1831
3404-001,2014,11,21,21,571,335,906,1285
3404-001,2014,11,21,22,358,218,576,906
3404-001,2014,11,21,23,204,134,338,576
3404-001,2014,11,21,24,157,109,266,338
3404-001,2014,11,22,1,80,78,158,266
3404-001,2014,11,22,2,70,55,125,158
3404-001,2014,11,22,3,44,39,83,125
3404-001,2014,11,22,4,34,36,70,83
3404-001,2014,11,22,5,52,78,130,70
3404-001,2014,11,22,6,109,214,323,130
3404-001,2014,11,22,7,174,335,509,323
3404-001,2014,11,22,8,334,701,1035,509
3404-001,2014,11,22,9,573,700,1273,1035
3404-001,2014,11,22,10,514,614,1128,1273
3404-001,2014,11,22,11,540,609,1149,1128
3404-001,2014,11,22,12,513,550,1063,1149
3404-001,2014,11,22,13,509,531,1040,1063
3404-001,2014,11,22,14,599,507,1106,1040
3404-001,2014,11,22,15,560,496,1056,1106
3404-001,2014,11,22,16,630,467,1097,1056
3404-001,2014,11,22,17,705,495,1200,1097
3404-001,2014,11,22,18,838,446,1284,1200
3404-001,2014,11,22,19,509,389,898,1284
3404-001,2014,11,22,20,303,323,626,898
3404-001,2014,11,22,21,244,226,470,626
3404-001,2014,11,22,22,190,151,341,470
3404-001,2014,11,22,23,103,92,195,341
3404-001,2014,11,22,24,67,64,131,195
3404-001,2014,11,23,1,47,47,94,131
3404-001,2014,11,23,2,40,29,69,94
3404-001,2014,11,23,3,30,20,50,69
3404-001,2014,11,23,4,13,30,43,50
3404-001,2014,11,23,5,22,22,44,43
3404-001,2014,11,23,6,50,78,128,44
3404-001,2014,11,23,7,89,146,235,128
3404-001,2014,11,23,8,169,245,414,235
3404-001,2014,11,23,9,260,260,520,414
3404-001,2014,11,23,10,247,278,525,520
3404-001,2014,11,23,11,313,351,664,525
3404-001,2014,11,23,12,297,324,621,664
3404-001,2014,11,23,13,298,314,612,621
3404-001,2014,11,23,14,350,344,694,612
3404-001,2014,11,23,15,420,379,799,694
3404-001,2014,11,23,16,508,336,844,799
3404-001,2014,11,23,17,662,331,993,844
3404-001,2014,11,23,18,767,341,1108,993
3404-001,2014,11,23,19,552,306,858,1108
3404-001,2014,11,23,20,383,307,690,858
3404-001,2014,11,23,21,329,256,585,690
3404-001,2014,11,23,22,176,263,439,585
3404-001,2014,11,23,23,145,195,340,439
3404-001,2014,11,23,24,70,117,187,340
3404-001,2014,11,24,1,38,76,114,187
3404-001,2014,11,24,2,27,42,69,114
3404-001,2014,11,24,3,25,29,54,69
3404-001,2014,11,24,4,28,51,79,54
3404-001,2014,11,24,5,40,73,113,79
3404-001,2014,11,24,6,109,229,338,113
3404-001,2014,11,24,7,228,596,824,338
3404-001,2014,11,24,8,437,1786,2223,824
3404-001,2014,11,24,9,585,1366,1951,2223
3404-001,2014,11,24,10,560,655,1215,1951
3404-001,2014,11,24,11,656,673,1329,1215
3404-001,2014,11,24,12,587,596,1183,1329
3404-001,2014,11,24,13,513,549,1062,1183
3404-001,2014,11,24,14,588,594,1182,1062
3404-001,2014,11,24,15,691,637,1328,1182
3404-001,2014,11,24,16,745,608,1353,1328
3404-001,2014,11,24,17,723,591,1314,1353
3404-001,2014,11,24,18,1043,491,1534,1314
3404-001,2014,11,24,19,893,428,1321,1534
3404-001,2014,11,24,20,653,361,1014,1321
3404-001,2014,11,24,21,612,217,829,1014
3404-001,2014,11,24,22,358,192,550,829
3404-001,2014,11,24,23,213,146,359,550
3404-001,2014,11,24,24,115,78,193,359
3404-001,2014,11,25,1,70,52,122,193
3404-001,2014,11,25,2,65,55,120,122
3404-001,2014,11,25,3,45,47,92,120
3404-001,2014,11,25,4,35,42,77,92
3404-001,2014,11,25,5,66,76,142,77
3404-001,2014,11,25,6,119,201,320,142
3404-001,2014,11,25,7,167,480,647,320
3404-001,2014,11,25,8,458,1632,2090,647
3404-001,2014,11,25,9,706,1234,1940,2090
3404-001,2014,11,25,10,617,709,1326,1940
3404-001,2014,11,25,11,650,713,1363,1326
3404-001,2014,11,25,12,639,722,1361,1363
3404-001,2014,11,25,13,628,567,1195,1361
3404-001,2014,11,25,14,648,668,1316,1195
3404-001,2014,11,25,15,772,721,1493,1316
3404-001,2014,11,25,16,791,632,1423,1493
3404-001,2014,11,25,17,776,599,1375,1423
3404-001,2014,11,25,18,1079,536,1615,1375
3404-001,2014,11,25,19,920,442,1362,1615
3404-001,2014,11,25,20,692,342,1034,1362
3404-001,2014,11,25,21,602,287,889,1034
3404-001,2014,11,25,22,380,203,583,889
3404-001,2014,11,25,23,214,156,370,583
3404-001,2014,11,25,24,129,90,219,370
3404-001,2014,11,26,1,65,77,142,219
3404-001,2014,11,26,2,84,50,134,142
3404-001,2014,11,26,3,56,37,93,134
3404-001,2014,11,26,4,42,57,99,93
3404-001,2014,11,26,5,66,67,133,99
3404-001,2014,11,26,6,116,224,340,133
3404-001,2014,11,26,7,212,483,695,340
3404-001,2014,11,26,8,461,1685,2146,695
3404-001,2014,11,26,9,731,1339,2070,2146
3404-001,2014,11,26,10,657,729,1386,2070
3404-001,2014,11,26,11,678,723,1401,1386
3404-001,2014,11,26,12,686,678,1364,1401
3404-001,2014,11,26,13,591,548,1139,1364
3404-001,2014,11,26,14,670,702,1372,1139
3404-001,2014,11,26,15,762,715,1477,1372
3404-001,2014,11,26,16,788,645,1433,1477
3404-001,2014,11,26,17,824,623,1447,1433
3404-001,2014,11,26,18,1193,557,1750,1447
3404-001,2014,11,26,19,1033,462,1495,1750
3404-001,2014,11,26,20,700,364,1064,1495
3404-001,2014,11,26,21,528,241,769,1064
3404-001,2014,11,26,22,342,195,537,769
3404-001,2014,11,26,23,181,156,337,537
3404-001,2014,11,26,24,143,103,246,337
3404-001,2014,11,27,1,100,81,181,246
3404-001,2014,11,27,2,73,53,126,181
3404-001,2014,11,27,3,37,40,77,126
3404-001,2014,11,27,4,45,45,90,77
3404-001,2014,11,27,5,62,74,136,90
3404-001,2014,11,27,6,117,202,319,136
3404-001,2014,11,27,7,174,535,709,319
3404-001,2014,11,27,8,476,1686,2162,709
3404-001,2014,11,27,9,724,1371,2095,2162
3404-001,2014,11,27,10,688,754,1442,2095
3404-001,2014,11,27,11,720,756,1476,1442
3404-001,2014,11,27,12,705,667,1372,1476
3404-001,2014,11,27,13,612,533,1145,1372
3404-001,2014,11,27,14,656,719,1375,1145
3404-001,2014,11,27,15,800,756,1556,1375
3404-001,2014,11,27,16,791,615,1406,1556
3404-001,2014,11,27,17,799,599,1398,1406
3404-001,2014,11,27,18,1152,546,1698,1398
3404-001,2014,11,27,19,1049,421,1470,1698
3404-001,2014,11,27,20,705,362,1067,1470
3404-001,2014,11,27,21,619,235,854,1067
3404-001,2014,11,27,22,354,249,603,854
3404-001,2014,11,27,23,166,155,321,603
3404-001,2014,11,27,24,143,122,265,321
3404-001,2014,11,28,1,87,64,151,265
3404-001,2014,11,28,2,61,65,126,151
3404-001,2014,11,28,3,43,43,86,126
3404-001,2014,11,28,4,50,49,99,86
3404-001,2014,11,28,5,59,91,150,99
3404-001,2014,11,28,6,116,196,312,150
3404-001,2014,11,28,7,170,470,640,312
3404-001,2014,11,28,8,437,1641,2078,640
3404-001,2014,11,28,9,637,1206,1843,2078
3404-001,2014,11,28,10,633,694,1327,1843
3404-001,2014,11,28,11,687,616,1303,1327
3404-001,2014,11,28,12,648,588,1236,1303
3404-001,2014,11,28,13,580,486,1066,1236
3404-001,2014,11,28,14,653,641,1294,1066
3404-001,2014,11,28,15,656,658,1314,1294
3404-001,2014,11,28,16,702,581,1283,1314
3404-001,2014,11,28,17,802,566,1368,1283
3404-001,2014,11,28,18,1177,506,1683,1368
3404-001,2014,11,28,19,1088,491,1579,1683
3404-001,2014,11,28,20,724,370,1094,1579
3404-001,2014,11,28,21,554,259,813,1094
3404-001,2014,11,28,22,338,202,540,813
3404-001,2014,11,28,23,226,145,371,540
3404-001,2014,11,28,24,134,107,241,371
3404-001,2014,11,29,1,88,70,158,241
3404-001,2014,11,29,2,62,54,116,158
3404-001,2014,11,29,3,62,49,111,116
3404-001,2014,11,29,4,37,40,77,111
3404-001,2014,11,29,5,49,82,131,77
3404-001,2014,11,29,6,109,182,291,131
3404-001,2014,11,29,7,166,309,475,291
3404-001,2014,11,29,8,294,663,957,475
3404-001,2014,11,29,9,455,664,1119,957
3404-001,2014,11,29,10,474,594,1068,1119
3404-001,2014,11,29,11,490,573,1063,1068
3404-001,2014,11,29,12,502,530,1032,1063
3404-001,2014,11,29,13,479,505,984,1032
3404-001,2014,11,29,14,520,497,1017,984
3404-001,2014,11,29,15,548,484,1032,1017
3404-001,2014,11,29,16,597,500,1097,1032
3404-001,2014,11,29,17,700,438,1138,1097
3404-001,2014,11,29,18,878,439,1317,1138
3404-001,2014,11,29,19,591,372,963,1317
3404-001,2014,11,29,20,401,305,706,963
3404-001,2014,11,29,21,245,239,484,706
3404-001,2014,11,29,22,183,159,342,484
3404-001,2014,11,29,23,117,124,241,342
3404-001,2014,11,29,24,72,73,145,241
3404-001,2014,11,30,1,62,60,122,145
3404-001,2014,11,30,2,55,41,96,122
3404-001,2014,11,30,3,36,35,71,96
3404-001,2014,11,30,4,32,27,59,71
3404-001,2014,11,30,5,40,23,63,59
3404-001,2014,11,30,6,51,57,108,63
3404-001,2014,11,30,7,85,113,198,108
3404-001,2014,11,30,8,123,186,309,198
3404-001,2014,11,30,9,194,215,409,309
3404-001,2014,11,30,10,253,218,471,409
3404-001,2014,11,30,11,251,279,530,471
3404-001,2014,11,30,12,329,249,578,530
3404-001,2014,11,30,13,329,260,589,578
3404-001,2014,11,30,14,323,337,660,589
3404-001,2014,11,30,15,384,324,708,660
3404-001,2014,11,30,16,428,328,756,708
3404-001,2014,11,30,17,551,296,847,756
3404-001,2014,11,30,18,489,301,790,847
3404-001,2014,11,30,19,376,297,673,790
3404-001,2014,11,30,20,273,246,519,673
3404-001,2014,11,30,21,219,216,435,519
3404-001,2014,11,30,22,133,220,353,435
3404-001,2014,11,30,23,68,174,242,353
3404-001,2014,11,30,24,48,101,149,242
3404-001,2014,12,1,1,37,71,108,149
3404-001,2014,12,1,2,24,61,85,108
3404-001,2014,12,1,3,17,45,62,85
3404-001,2014,12,1,4,37,41,78,62
3404-001,2014,12,1,5,42,71,113,78
3404-001,2014,12,1,6,110,250,360,113
3404-001,2014,12,1,7,189,594,783,360
3404-001,2014,12,1,8,452,1753,2205,783
3404-001,2014,12,1,9,595,1281,1876,2205
3404-001,2014,12,1,10,504,615,1119,1876
3404-001,2014,12,1,11,561,636,1197,1119
3404-001,2014,12,1,12,551,532,1083,1197
3404-001,2014,12,1,13,522,465,987,1083
3404-001,2014,12,1,14,513,594,1107,987
3404-001,2014,12,1,15,633,612,1245,1107
3404-001,2014,12,1,16,668,554,1222,1245
3404-001,2014,12,1,17,700,518,1218,1222
3404-001,2014,12,1,18,890,463,1353,1218
3404-001,2014,12,1,19,899,358,1257,1353
3404-001,2014,12,1,20,625,356,981,1257
3404-001,2014,12,1,21,588,201,789,981
3404-001,2014,12,1,22,289,162,451,789
3404-001,2014,12,1,23,150,129,279,451
3404-001,2014,12,1,24,114,72,186,279
3404-001,2014,12,2,1,64,74,138,186
3404-001,2014,12,2,2,67,35,102,138
3404-001,2014,12,2,3,33,35,68,102
3404-001,2014,12,2,4,38,40,78,68
3404-001,2014,12,2,5,53,60,113,78
3404-001,2014,12,2,6,87,142,229,113
3404-001,2014,12,2,7,160,427,587,229
3404-001,2014,12,2,8,390,1525,1915,587
3404-001,2014,12,2,9,595,1117,1712,1915
3404-001,2014,12,2,10,514,618,1132,1712
3404-001,2014,12,2,11,570,623,1193,1132
3404-001,2014,12,2,12,602,610,1212,1193
3404-001,2014,12,2,13,591,484,1075,1212
3404-001,2014,12,2,14,588,610,1198,1075
3404-001,2014,12,2,15,715,690,1405,1198
3404-001,2014,12,2,16,731,632,1363,1405
3404-001,2014,12,2,17,779,580,1359,1363
3404-001,2014,12,2,18,1061,551,1612,1359
3404-001,2014,12,2,19,960,393,1353,1612
3404-001,2014,12,2,20,634,326,960,1353
3404-001,2014,12,2,21,584,223,807,960
3404-001,2014,12,2,22,335,304,639,807
3404-001,2014,12,2,23,158,433,591,639
3404-001,2014,12,2,24,130,37,167,591
3404-001,2014,12,3,1,18,8,26,167
3404-001,2014,12,3,2,9,13,22,26
3404-001,2014,12,3,3,48,129,177,22
3404-001,2014,12,3,4,40,50,90,177
3404-001,2014,12,3,5,32,31,63,90
3404-001,2014,12,3,6,58,96,154,63
3404-001,2014,12,3,7,190,486,676,154
3404-001,2014,12,3,8,450,1666,2116,676
3404-001,2014,12,3,9,672,1316,1988,2116
3404-001,2014,12,3,10,663,885,1548,1988
3404-001,2014,12,3,11,706,922,1628,1548
3404-001,2014,12,3,12,676,809,1485,1628
3404-001,2014,12,3,13,584,549,1133,1485
3404-001,2014,12,3,14,542,594,1136,1133
3404-001,2014,12,3,15,632,611,1243,1136
3404-001,2014,12,3,16,715,568,1283,1243
3404-001,2014,12,3,17,717,503,1220,1283
3404-001,2014,12,3,18,1011,478,1489,1220
3404-001,2014,12,3,19,803,365,1168,1489
3404-001,2014,12,3,20,557,277,834,1168
3404-001,2014,12,3,21,430,163,593,834
3404-001,2014,12,3,22,242,163,405,593
3404-001,2014,12,3,23,160,114,274,405
3404-001,2014,12,3,24,85,65,150,274
3404-001,2014,12,4,1,61,43,104,150
3404-001,2014,12,4,2,59,48,107,104
3404-001,2014,12,4,3,36,28,64,107
3404-001,2014,12,4,4,26,23,49,64
3404-001,2014,12,4,5,33,45,78,49
3404-001,2014,12,4,6,61,150,211,78
3404-001,2014,12,4,7,176,462,638,211
3404-001,2014,12,4,8,436,1567,2003,638
3404-001,2014,12,4,9,679,1299,1978,2003
3404-001,2014,12,4,10,613,838,1451,1978
3404-001,2014,12,4,11,662,706,1368,1451
3404-001,2014,12,4,12,684,631,1315,1368
3404-001,2014,12,4,13,596,587,1183,1315
3404-001,2014,12,4,14,638,752,1390,1183
3404-001,2014,12,4,15,739,706,1445,1390
3404-001,2014,12,4,16,736,616,1352,1445
3404-001,2014,12,4,17,784,589,1373,1352
3404-001,2014,12,4,18,1100,506,1606,1373
3404-001,2014,12,4,19,1008,426,1434,1606
3404-001,2014,12,4,20,672,348,1020,1434
3404-001,2014,12,4,21,580,230,810,1020
3404-001,2014,12,4,22,336,226,562,810
3404-001,2014,12,4,23,184,149,333,562
3404-001,2014,12,4,24,134,104,238,333
3404-001,2014,12,5,1,69,25,94,238
3404-001,2014,12,5,2,58,18,76,94
3404-001,2014,12,5,3,27,16,43,76
3404-001,2014,12,5,4,35,16,51,43
3404-001,2014,12,5,5,50,27,77,51
3404-001,2014,12,5,6,62,256,318,77
3404-001,2014,12,5,7,126,615,741,318
3404-001,2014,12,5,8,344,1424,1768,741
3404-001,2014,12,5,9,556,1006,1562,1768
3404-001,2014,12,5,10,535,619,1154,1562
3404-001,2014,12,5,11,600,744,1344,1154
3404-001,2014,12,5,12,649,622,1271,1344
3404-001,2014,12,5,13,606,534,1140,1271
3404-001,2014,12,5,14,669,650,1319,1140
3404-001,2014,12,5,15,739,692,1431,1319
3404-001,2014,12,5,16,766,630,1396,1431
3404-001,2014,12,5,17,846,556,1402,1396
3404-001,2014,12,5,18,1255,472,1727,1402
3404-001,2014,12,5,19,1110,444,1554,1727
3404-001,2014,12,5,20,705,354,1059,1554
3404-001,2014,12,5,21,577,230,807,1059
3404-001,2014,12,5,22,301,163,464,807
3404-001,2014,12,5,23,162,130,292,464
3404-001,2014,12,5,24,119,72,191,292
3404-001,2014,12,6,1,74,42,116,191
3404-001,2014,12,6,2,56,36,92,116
3404-001,2014,12,6,3,43,36,79,92
3404-001,2014,12,6,4,36,32,68,79
3404-001,2014,12,6,5,41,43,84,68
3404-001,2014,12,6,6,80,138,218,84
3404-001,2014,12,6,7,132,253,385,218
3404-001,2014,12,6,8,156,451,607,385
3404-001,2014,12,6,9,262,448,710,607
3404-001,2014,12,6,10,276,390,666,710
3404-001,2014,12,6,11,292,394,686,666
3404-001,2014,12,6,12,308,370,678,686
3404-001,2014,12,6,13,294,362,656,678
3404-001,2014,12,6,14,330,352,682,656
3404-001,2014,12,6,15,364,338,702,682
3404-001,2014,12,6,16,448,344,792,702
3404-001,2014,12,6,17,672,322,994,792
3404-001,2014,12,6,18,744,318,1062,994
3404-001,2014,12,6,19,494,268,762,1062
3404-001,2014,12,6,20,316,204,520,762
3404-001,2014,12,6,21,212,155,367,520
3404-001,2014,12,6,22,121,68,189,367
3404-001,2014,12,6,23,85,47,132,189
3404-001,2014,12,6,24,56,32,88,132
3404-001,2014,12,7,1,42,21,63,88
3404-001,2014,12,7,2,50,15,65,63
3404-001,2014,12,7,3,23,13,36,65
3404-001,2014,12,7,4,16,10,26,36
3404-001,2014,12,7,5,27,19,46,26
3404-001,2014,12,7,6,33,41,74,46
3404-001,2014,12,7,7,69,86,155,74
3404-001,2014,12,7,8,120,162,282,155
3404-001,2014,12,7,9,206,232,438,282
3404-001,2014,12,7,10,243,203,446,438
3404-001,2014,12,7,11,278,228,506,446
3404-001,2014,12,7,12,302,231,533,506
3404-001,2014,12,7,13,334,222,556,533
3404-001,2014,12,7,14,327,272,599,556
3404-001,2014,12,7,15,394,284,678,599
3404-001,2014,12,7,16,444,293,737,678
3404-001,2014,12,7,17,484,256,740,737
3404-001,2014,12,7,18,462,220,682,740
3404-001,2014,12,7,19,330,228,558,682
3404-001,2014,12,7,20,248,178,426,558
3404-001,2014,12,7,21,174,154,328,426
3404-001,2014,12,7,22,114,103,217,328
3404-001,2014,12,7,23,92,98,190,217
3404-001,2014,12,7,24,62,70,132,190
3404-001,2014,12,8,1,43,45,88,132
3404-001,2014,12,8,2,31,35,66,88
3404-001,2014,12,8,3,33,20,53,66
3404-001,2014,12,8,4,26,17,43,53
3404-001,2014,12,8,5,33,25,58,43
3404-001,2014,12,8,6,76,94,170,58
3404-001,2014,12,8,7,142,290,432,170
3404-001,2014,12,8,8,380,1130,1510,432
3404-001,2014,12,8,9,536,774,1310,1510
3404-001,2014,12,8,10,532,527,1059,1310
3404-001,2014,12,8,11,596,544,1140,1059
3404-001,2014,12,8,12,558,470,1028,1140
3404-001,2014,12,8,13,542,378,920,1028
3404-001,2014,12,8,14,553,475,1028,920
3404-001,2014,12,8,15,657,487,1144,1028
3404-001,2014,12,8,16,702,442,1144,1144
3404-001,2014,12,8,17,725,405,1130,1144
3404-001,2014,12,8,18,1037,360,1397,1130
3404-001,2014,12,8,19,876,292,1168,1397
3404-001,2014,12,8,20,657,278,935,1168
3404-001,2014,12,8,21,569,147,716,935
3404-001,2014,12,8,22,331,230,561,716
3404-001,2014,12,8,23,198,133,331,561
3404-001,2014,12,8,24,131,65,196,331
3404-001,2014,12,9,1,55,76,131,196
3404-001,2014,12,9,2,52,46,98,131
3404-001,2014,12,9,3,39,34,73,98
3404-001,2014,12,9,4,43,33,76,73
3404-001,2014,12,9,5,46,55,101,76
3404-001,2014,12,9,6,112,146,258,101
3404-001,2014,12,9,7,142,404,546,258
3404-001,2014,12,9,8,421,1512,1933,546
3404-001,2014,12,9,9,617,1141,1758,1933
3404-001,2014,12,9,10,610,614,1224,1758
3404-001,2014,12,9,11,670,629,1299,1224
3404-001,2014,12,9,12,650,628,1278,1299
3404-001,2014,12,9,13,576,476,1052,1278
3404-001,2014,12,9,14,635,603,1238,1052
3404-001,2014,12,9,15,678,653,1331,1238
3404-001,2014,12,9,16,775,618,1393,1331
3404-001,2014,12,9,17,764,554,1318,1393
3404-001,2014,12,9,18,1085,519,1604,1318
3404-001,2014,12,9,19,1014,402,1416,1604
3404-001,2014,12,9,20,657,314,971,1416
3404-001,2014,12,9,21,625,226,851,971
3404-001,2014,12,9,22,322,248,570,851
3404-001,2014,12,9,23,209,289,498,570
3404-001,2014,12,9,24,125,71,196,498
3404-001,2014,12,10,1,50,40,90,196
3404-001,2014,12,10,2,30,30,60,90
3404-001,2014,12,10,3,44,84,128,60
3404-001,2014,12,10,4,38,44,82,128
3404-001,2014,12,10,5,53,61,114,82
3404-001,2014,12,10,6,103,177,280,114
3404-001,2014,12,10,7,167,488,655,280
3404-001,2014,12,10,8,438,1615,2053,655
3404-001,2014,12,10,9,614,1266,1880,2053
3404-001,2014,12,10,10,669,784,1453,1880
3404-001,2014,12,10,11,734,808,1542,1453
3404-001,2014,12,10,12,667,746,1413,1542
3404-001,2014,12,10,13,577,532,1109,1413
3404-001,2014,12,10,14,682,630,1312,1109
3404-001,2014,12,10,15,739,646,1385,1312
3404-001,2014,12,10,16,752,613,1365,1385
3404-001,2014,12,10,17,769,540,1309,1365
3404-001,2014,12,10,18,1207,478,1685,1309
3404-001,2014,12,10,19,982,382,1364,1685
3404-001,2014,12,10,20,615,284,899,1364
3404-001,2014,12,10,21,507,195,702,899
3404-001,2014,12,10,22,325,166,491,702
3404-001,2014,12,10,23,189,118,307,491
3404-001,2014,12,10,24,115,69,184,307
3404-001,2014,12,11,1,78,37,115,184
3404-001,2014,12,11,2,57,17,74,115
3404-001,2014,12,11,3,36,19,55,74
3404-001,2014,12,11,4,36,20,56,55
3404-001,2014,12,11,5,51,28,79,56
3404-001,2014,12,11,6,99,104,203,79
3404-001,2014,12,11,7,177,388,565,203
3404-001,2014,12,11,8,395,1448,1843,565
3404-001,2014,12,11,9,634,1227,1861,1843
3404-001,2014,12,11,10,538,922,1460,1861
3404-001,2014,12,11,11,603,655,1258,1460
3404-001,2014,12,11,12,662,595,1257,1258
3404-001,2014,12,11,13,581,641,1222,1257
3404-001,2014,12,11,14,619,785,1404,1222
3404-001,2014,12,11,15,678,656,1334,1404
3404-001,2014,12,11,16,681,616,1297,1334
3404-001,2014,12,11,17,768,579,1347,1297
3404-001,2014,12,11,18,1049,466,1515,1347
3404-001,2014,12,11,19,968,431,1399,1515
3404-001,2014,12,11,20,639,333,972,1399
3404-001,2014,12,11,21,541,226,767,972
3404-001,2014,12,11,22,319,202,521,767
3404-001,2014,12,11,23,202,143,345,521
3404-001,2014,12,11,24,125,86,211,345
3404-001,2014,12,12,1,102,100,202,211
3404-001,2014,12,12,2,60,49,109,202
3404-001,2014,12,12,3,58,32,90,109
3404-001,2014,12,12,4,51,38,89,90
3404-001,2014,12,12,5,62,50,112,89
3404-001,2014,12,12,6,125,157,282,112
3404-001,2014,12,12,7,148,490,638,282
3404-001,2014,12,12,8,462,1653,2115,638
3404-001,2014,12,12,9,642,1253,1895,2115
3404-001,2014,12,12,10,599,674,1273,1895
3404-001,2014,12,12,11,775,749,1524,1273
3404-001,2014,12,12,12,701,655,1356,1524
3404-001,2014,12,12,13,649,583,1232,1356
3404-001,2014,12,12,14,637,659,1296,1232
3404-001,2014,12,12,15,815,725,1540,1296
3404-001,2014,12,12,16,855,679,1534,1540
3404-001,2014,12,12,17,850,546,1396,1534
3404-001,2014,12,12,18,1180,439,1619,1396
3404-001,2014,12,12,19,1350,397,1747,1619
3404-001,2014,12,12,20,693,337,1030,1747
3404-001,2014,12,12,21,478,201,679,1030
3404-001,2014,12,12,22,295,124,419,679
3404-001,2014,12,12,23,168,114,282,419
3404-001,2014,12,12,24,86,36,122,282
3404-001,2014,12,13,1,89,56,145,122
3404-001,2014,12,13,2,62,45,107,145
3404-001,2014,12,13,3,43,40,83,107
3404-001,2014,12,13,4,36,33,69,83
3404-001,2014,12,13,5,38,40,78,69
3404-001,2014,12,13,6,78,133,211,78
3404-001,2014,12,13,7,127,248,375,211
3404-001,2014,12,13,8,214,498,712,375
3404-001,2014,12,13,9,354,518,872,712
3404-001,2014,12,13,10,362,429,791,872
3404-001,2014,12,13,11,394,438,832,791
3404-001,2014,12,13,12,414,393,807,832
3404-001,2014,12,13,13,365,386,751,807
3404-001,2014,12,13,14,404,406,810,751
3404-001,2014,12,13,15,438,390,828,810
3404-001,2014,12,13,16,499,360,859,828
3404-001,2014,12,13,17,670,352,1022,859
3404-001,2014,12,13,18,759,370,1129,1022
3404-001,2014,12,13,19,466,304,770,1129
3404-001,2014,12,13,20,279,212,491,770
3404-001,2014,12,13,21,202,158,360,491
3404-001,2014,12,13,22,126,100,226,360
3404-001,2014,12,13,23,88,74,162,226
3404-001,2014,12,13,24,58,45,103,162
3404-001,2014,12,14,1,31,32,63,103
3404-001,2014,12,14,2,36,23,59,63
3404-001,2014,12,14,3,33,13,46,59
3404-001,2014,12,14,4,27,10,37,46
3404-001,2014,12,14,5,19,15,34,37
3404-001,2014,12,14,6,58,20,78,34
3404-001,2014,12,14,7,53,59,112,78
3404-001,2014,12,14,8,118,137,255,112
3404-001,2014,12,14,9,217,249,466,255
3404-001,2014,12,14,10,233,188,421,466
3404-001,2014,12,14,11,304,177,481,421
3404-001,2014,12,14,12,274,213,487,481
3404-001,2014,12,14,13,339,184,523,487
3404-001,2014,12,14,14,331,207,538,523
3404-001,2014,12,14,15,405,243,648,538
3404-001,2014,12,14,16,459,258,717,648
3404-001,2014,12,14,17,417,216,633,717
3404-001,2014,12,14,18,435,139,574,633
3404-001,2014,12,14,19,283,158,441,574
3404-001,2014,12,14,20,224,111,335,441
3404-001,2014,12,14,21,129,92,221,335
3404-001,2014,12,14,22,108,98,206,221
3404-001,2014,12,14,23,72,69,141,206
3404-001,2014,12,14,24,46,50,96,141
3404-001,2014,12,15,1,28,31,59,96
3404-001,2014,12,15,2,19,31,50,59
3404-001,2014,12,15,3,14,21,35,50
3404-001,2014,12,15,4,33,22,55,35
3404-001,2014,12,15,5,46,37,83,55
3404-001,2014,12,15,6,100,127,227,83
3404-001,2014,12,15,7,176,373,549,227
3404-001,2014,12,15,8,426,1242,1668,549
3404-001,2014,12,15,9,585,928,1513,1668
3404-001,2014,12,15,10,583,494,1077,1513
3404-001,2014,12,15,11,683,523,1206,1077
3404-001,2014,12,15,12,664,470,1134,1206
3404-001,2014,12,15,13,500,391,891,1134
3404-001,2014,12,15,14,623,472,1095,891
3404-001,2014,12,15,15,695,528,1223,1095
3404-001,2014,12,15,16,757,476,1233,1223
3404-001,2014,12,15,17,716,462,1178,1233
3404-001,2014,12,15,18,1017,410,1427,1178
3404-001,2014,12,15,19,852,330,1182,1427
3404-001,2014,12,15,20,565,291,856,1182
3404-001,2014,12,15,21,582,168,750,856
3404-001,2014,12,15,22,318,299,617,750
3404-001,2014,12,15,23,183,137,320,617
3404-001,2014,12,15,24,113,96,209,320
3404-001,2014,12,16,1,83,77,160,209
3404-001,2014,12,16,2,55,58,113,160
3404-001,2014,12,16,3,47,32,79,113
3404-001,2014,12,16,4,45,26,71,79
3404-001,2014,12,16,5,41,50,91,71
3404-001,2014,12,16,6,78,150,228,91
3404-001,2014,12,16,7,135,382,517,228
3404-001,2014,12,16,8,400,1500,1900,517
3404-001,2014,12,16,9,640,1165,1805,1900
3404-001,2014,12,16,10,583,610,1193,1805
3404-001,2014,12,16,11,588,635,1223,1193
3404-001,2014,12,16,12,594,646,1240,1223
3404-001,2014,12,16,13,518,468,986,1240
3404-001,2014,12,16,14,569,596,1165,986
3404-001,2014,12,16,15,625,616,1241,1165
3404-001,2014,12,16,16,710,604,1314,1241
3404-001,2014,12,16,17,726,527,1253,1314
3404-001,2014,12,16,18,1032,487,1519,1253
3404-001,2014,12,16,19,899,412,1311,1519
3404-001,2014,12,16,20,586,301,887,1311
3404-001,2014,12,16,21,552,229,781,887
3404-001,2014,12,16,22,305,193,498,781
3404-001,2014,12,16,23,151,145,296,498
3404-001,2014,12,16,24,117,105,222,296
3404-001,2014,12,17,1,81,72,153,222
3404-001,2014,12,17,2,51,47,98,153
3404-001,2014,12,17,3,39,40,79,98
3404-001,2014,12,17,4,37,38,75,79
3404-001,2014,12,17,5,51,62,113,75
3404-001,2014,12,17,6,88,141,229,113
3404-001,2014,12,17,7,149,442,591,229
3404-001,2014,12,17,8,380,1564,1944,591
3404-001,2014,12,17,9,656,1215,1871,1944
3404-001,2014,12,17,10,612,684,1296,1871
3404-001,2014,12,17,11,669,695,1364,1296
3404-001,2014,12,17,12,633,683,1316,1364
3404-001,2014,12,17,13,580,516,1096,1316
3404-001,2014,12,17,14,663,665,1328,1096
3404-001,2014,12,17,15,733,681,1414,1328
3404-001,2014,12,17,16,762,658,1420,1414
3404-001,2014,12,17,17,725,578,1303,1420
3404-001,2014,12,17,18,1115,477,1592,1303
3404-001,2014,12,17,19,935,399,1334,1592
3404-001,2014,12,17,20,569,290,859,1334
3404-001,2014,12,17,21,500,227,727,859
3404-001,2014,12,17,22,316,168,484,727
3404-001,2014,12,17,23,174,122,296,484
3404-001,2014,12,17,24,124,73,197,296
3404-001,2014,12,18,1,89,75,164,197
3404-001,2014,12,18,2,52,48,100,164
3404-001,2014,12,18,3,28,33,61,100
3404-001,2014,12,18,4,38,32,70,61
3404-001,2014,12,18,5,63,62,125,70
3404-001,2014,12,18,6,85,159,244,125
3404-001,2014,12,18,7,185,436,621,244
3404-001,2014,12,18,8,377,1610,1987,621
3404-001,2014,12,18,9,649,1213,1862,1987
3404-001,2014,12,18,10,572,714,1286,1862
3404-001,2014,12,18,11,671,675,1346,1286
3404-001,2014,12,18,12,684,682,1366,1346
3404-001,2014,12,18,13,586,555,1141,1366
3404-001,2014,12,18,14,676,682,1358,1141
3404-001,2014,12,18,15,760,666,1426,1358
3404-001,2014,12,18,16,780,588,1368,1426
3404-001,2014,12,18,17,739,606,1345,1368
3404-001,2014,12,18,18,1104,538,1642,1345
3404-001,2014,12,18,19,960,424,1384,1642
3404-001,2014,12,18,20,592,323,915,1384
3404-001,2014,12,18,21,600,240,840,915
3404-001,2014,12,18,22,327,188,515,840
3404-001,2014,12,18,23,193,124,317,515
3404-001,2014,12,18,24,108,84,192,317
3404-001,2014,12,19,1,81,56,137,192
3404-001,2014,12,19,2,62,54,116,137
3404-001,2014,12,19,3,41,41,82,116
3404-001,2014,12,19,4,40,34,74,82
3404-001,2014,12,19,5,71,78,149,74
3404-001,2014,12,19,6,102,172,274,149
3404-001,2014,12,19,7,150,475,625,274
3404-001,2014,12,19,8,460,1588,2048,625
3404-001,2014,12,19,9,684,1184,1868,2048
3404-001,2014,12,19,10,625,731,1356,1868
3404-001,2014,12,19,11,631,533,1164,1356
3404-001,2014,12,19,12,663,781,1444,1164
3404-001,2014,12,19,13,633,582,1215,1444
3404-001,2014,12,19,14,654,646,1300,1215
3404-001,2014,12,19,15,803,656,1459,1300
3404-001,2014,12,19,16,816,658,1474,1459
3404-001,2014,12,19,17,784,557,1341,1474
3404-001,2014,12,19,18,1258,603,1861,1341
3404-001,2014,12,19,19,1144,453,1597,1861
3404-001,2014,12,19,20,696,427,1123,1597
3404-001,2014,12,19,21,498,247,745,1123
3404-001,2014,12,19,22,349,180,529,745
3404-001,2014,12,19,23,193,130,323,529
3404-001,2014,12,19,24,106,103,209,323
3404-001,2014,12,20,1,104,70,174,209
3404-001,2014,12,20,2,67,54,121,174
3404-001,2014,12,20,3,43,43,86,121
3404-001,2014,12,20,4,35,34,69,86
3404-001,2014,12,20,5,36,38,74,69
3404-001,2014,12,20,6,76,128,204,74
3404-001,2014,12,20,7,122,243,365,204
3404-001,2014,12,20,8,273,544,817,365
3404-001,2014,12,20,9,446,588,1034,817
3404-001,2014,12,20,10,447,468,915,1034
3404-001,2014,12,20,11,496,481,977,915
3404-001,2014,12,20,12,521,416,937,977
3404-001,2014,12,20,13,436,411,847,937
3404-001,2014,12,20,14,478,461,939,847
3404-001,2014,12,20,15,511,441,952,939
3404-001,2014,12,20,16,550,376,926,952
3404-001,2014,12,20,17,667,383,1050,926
3404-001,2014,12,20,18,774,422,1196,1050
3404-001,2014,12,20,19,438,340,778,1196
3404-001,2014,12,20,20,242,221,463,778
3404-001,2014,12,20,21,191,160,351,463
3404-001,2014,12,20,22,132,132,264,351
3404-001,2014,12,20,23,91,100,191,264
3404-001,2014,12,20,24,59,58,117,191
3404-001,2014,12,21,1,46,43,89,117
3404-001,2014,12,21,2,35,35,70,89
3404-001,2014,12,21,3,31,24,55,70
3404-001,2014,12,21,4,30,15,45,55
3404-001,2014,12,21,5,30,28,58,45
3404-001,2014,12,21,6,55,48,103,58
3404-001,2014,12,21,7,57,140,197,103
3404-001,2014,12,21,8,135,232,367,197
3404-001,2014,12,21,9,227,260,487,367
3404-001,2014,12,21,10,269,267,536,487
3404-001,2014,12,21,11,280,313,593,536
3404-001,2014,12,21,12,284,319,603,593
3404-001,2014,12,21,13,294,326,620,603
3404-001,2014,12,21,14,350,356,706,620
3404-001,2014,12,21,15,396,321,717,706
3404-001,2014,12,21,16,417,346,763,717
3404-001,2014,12,21,17,381,316,697,763
3404-001,2014,12,21,18,422,312,734,697
3404-001,2014,12,21,19,258,261,519,734
3404-001,2014,12,21,20,178,220,398,519
3404-001,2014,12,21,21,134,180,314,398
3404-001,2014,12,21,22,124,155,279,314
3404-001,2014,12,21,23,62,162,224,279
3404-001,2014,12,21,24,40,88,128,224
3404-001,2014,12,22,1,36,64,100,128
3404-001,2014,12,22,2,27,45,72,100
3404-001,2014,12,22,3,19,24,43,72
3404-001,2014,12,22,4,21,31,52,43
3404-001,2014,12,22,5,32,61,93,52
3404-001,2014,12,22,6,78,168,246,93
3404-001,2014,12,22,7,141,511,652,246
3404-001,2014,12,22,8,375,1486,1861,652
3404-001,2014,12,22,9,526,1234,1760,1861
3404-001,2014,12,22,10,462,460,922,1760
3404-001,2014,12,22,11,400,502,902,922
3404-001,2014,12,22,12,400,470,870,902
3404-001,2014,12,22,13,418,404,822,870
3404-001,2014,12,22,14,510,469,979,822
3404-001,2014,12,22,15,623,569,1192,979
3404-001,2014,12,22,16,659,509,1168,1192
3404-001,2014,12,22,17,723,519,1242,1168
3404-001,2014,12,22,18,942,461,1403,1242
3404-001,2014,12,22,19,904,368,1272,1403
3404-001,2014,12,22,20,577,304,881,1272
3404-001,2014,12,22,21,569,188,757,881
3404-001,2014,12,22,22,300,168,468,757
3404-001,2014,12,22,23,152,115,267,468
3404-001,2014,12,22,24,115,70,185,267
3404-001,2014,12,23,1,64,60,124,185
3404-001,2014,12,23,2,66,53,119,124
3404-001,2014,12,23,3,33,37,70,119
3404-001,2014,12,23,4,39,37,76,70
3404-001,2014,12,23,5,57,67,124,76
3404-001,2014,12,23,6,110,159,269,124
3404-001,2014,12,23,7,142,418,560,269
3404-001,2014,12,23,8,375,1510,1885,560
3404-001,2014,12,23,9,706,1271,1977,1885
3404-001,2014,12,23,10,665,751,1416,1977
3404-001,2014,12,23,11,725,704,1429,1416
3404-001,2014,12,23,12,730,711,1441,1429
3404-001,2014,12,23,13,600,634,1234,1441
3404-001,2014,12,23,14,709,662,1371,1234
3404-001,2014,12,23,15,780,699,1479,1371
3404-001,2014,12,23,16,797,741,1538,1479
3404-001,2014,12,23,17,830,662,1492,1538
3404-001,2014,12,23,18,1126,546,1672,1492
3404-001,2014,12,23,19,1030,409,1439,1672
3404-001,2014,12,23,20,581,344,925,1439
3404-001,2014,12,23,21,529,253,782,925
3404-001,2014,12,23,22,364,197,561,782
3404-001,2014,12,23,23,196,127,323,561
3404-001,2014,12,23,24,119,98,217,323
3404-001,2014,12,24,1,85,78,163,217
3404-001,2014,12,24,2,62,50,112,163
3404-001,2014,12,24,3,43,50,93,112
3404-001,2014,12,24,4,56,38,94,93
3404-001,2014,12,24,5,51,79,130,94
3404-001,2014,12,24,6,103,187,290,130
3404-001,2014,12,24,7,186,487,673,290
3404-001,2014,12,24,8,423,1595,2018,673
3404-001,2014,12,24,9,695,1326,2021,2018
3404-001,2014,12,24,10,632,737,1369,2021
3404-001,2014,12,24,11,667,704,1371,1369
3404-001,2014,12,24,12,649,659,1308,1371
3404-001,2014,12,24,13,622,537,1159,1308
3404-001,2014,12,24,14,653,650,1303,1159
3404-001,2014,12,24,15,733,676,1409,1303
3404-001,2014,12,24,16,802,623,1425,1409
3404-001,2014,12,24,17,869,621,1490,1425
3404-001,2014,12,24,18,1552,579,2131,1490
3404-001,2014,12,24,19,1396,531,1927,2131
3404-001,2014,12,24,20,756,359,1115,1927
3404-001,2014,12,24,21,514,257,771,1115
3404-001,2014,12,24,22,268,216,484,771
3404-001,2014,12,24,23,198,127,325,484
3404-001,2014,12,24,24,123,96,219,325
3404-001,2014,12,25,1,67,62,129,219
3404-001,2014,12,25,2,65,43,108,129
3404-001,2014,12,25,3,38,30,68,108
3404-001,2014,12,25,4,47,32,79,68
3404-001,2014,12,25,5,51,57,108,79
3404-001,2014,12,25,6,81,109,190,108
3404-001,2014,12,25,7,108,218,326,190
3404-001,2014,12,25,8,234,521,755,326
3404-001,2014,12,25,9,338,459,797,755
3404-001,2014,12,25,10,388,411,799,797
3404-001,2014,12,25,11,417,430,847,799
3404-001,2014,12,25,12,365,438,803,847
3404-001,2014,12,25,13,368,415,783,803
3404-001,2014,12,25,14,457,424,881,783
3404-001,2014,12,25,15,446,481,927,881
3404-001,2014,12,25,16,496,409,905,927
3404-001,2014,12,25,17,461,318,779,905
3404-001,2014,12,25,18,602,308,910,779
3404-001,2014,12,25,19,362,218,580,910
3404-001,2014,12,25,20,232,212,444,580
3404-001,2014,12,25,21,233,169,402,444
3404-001,2014,12,25,22,153,164,317,402
3404-001,2014,12,25,23,114,96,210,317
3404-001,2014,12,25,24,69,91,160,210
3404-001,2014,12,26,1,46,67,113,160
3404-001,2014,12,26,2,45,44,89,113
3404-001,2014,12,26,3,27,39,66,89
3404-001,2014,12,26,4,34,37,71,66
3404-001,2014,12,26,5,52,60,112,71
3404-001,2014,12,26,6,85,177,262,112
3404-001,2014,12,26,7,157,473,630,262
3404-001,2014,12,26,8,441,1480,1921,630
3404-001,2014,12,26,9,570,1218,1788,1921
3404-001,2014,12,26,10,579,645,1224,1788
3404-001,2014,12,26,11,706,678,1384,1224
3404-001,2014,12,26,12,661,640,1301,1384
3404-001,2014,12,26,13,592,551,1143,1301
3404-001,2014,12,26,14,665,645,1310,1143
3404-001,2014,12,26,15,742,700,1442,1310
3404-001,2014,12,26,16,773,612,1385,1442
3404-001,2014,12,26,17,758,605,1363,1385
3404-001,2014,12,26,18,1226,545,1771,1363
3404-001,2014,12,26,19,972,470,1442,1771
3404-001,2014,12,26,20,588,318,906,1442
3404-001,2014,12,26,21,448,227,675,906
3404-001,2014,12,26,22,282,181,463,675
3404-001,2014,12,26,23,165,129,294,463
3404-001,2014,12,26,24,153,90,243,294
3404-001,2014,12,27,1,77,81,158,243
3404-001,2014,12,27,2,77,43,120,158
3404-001,2014,12,27,3,54,32,86,120
3404-001,2014,12,27,4,52,37,89,86
3404-001,2014,12,27,5,41,66,107,89
3404-001,2014,12,27,6,103,148,251,107
3404-001,2014,12,27,7,139,256,395,251
3404-001,2014,12,27,8,282,614,896,395
3404-001,2014,12,27,9,429,590,1019,896
3404-001,2014,12,27,10,492,546,1038,1019
3404-001,2014,12,27,11,519,574,1093,1038
3404-001,2014,12,27,12,556,518,1074,1093
3404-001,2014,12,27,13,470,509,979,1074
3404-001,2014,12,27,14,531,498,1029,979
3404-001,2014,12,27,15,554,456,1010,1029
3404-001,2014,12,27,16,544,426,970,1010
3404-001,2014,12,27,17,610,421,1031,970
3404-001,2014,12,27,18,724,400,1124,1031
3404-001,2014,12,27,19,438,294,732,1124
3404-001,2014,12,27,20,257,255,512,732
3404-001,2014,12,27,21,207,169,376,512
3404-001,2014,12,27,22,143,126,269,376
3404-001,2014,12,27,23,89,81,170,269
3404-001,2014,12,27,24,88,62,150,170
3404-001,2014,12,28,1,59,41,100,150
3404-001,2014,12,28,2,39,28,67,100
3404-001,2014,12,28,3,33,25,58,67
3404-001,2014,12,28,4,27,24,51,58
3404-001,2014,12,28,5,29,25,54,51
3404-001,2014,12,28,6,57,53,110,54
3404-001,2014,12,28,7,50,117,167,110
3404-001,2014,12,28,8,136,285,421,167
3404-001,2014,12,28,9,245,239,484,421
3404-001,2014,12,28,10,238,287,525,484
3404-001,2014,12,28,11,279,334,613,525
3404-001,2014,12,28,12,294,319,613,613
3404-001,2014,12,28,13,329,293,622,613
3404-001,2014,12,28,14,337,329,666,622
3404-001,2014,12,28,15,384,354,738,666
3404-001,2014,12,28,16,411,330,741,738
3404-001,2014,12,28,17,450,304,754,741
3404-001,2014,12,28,18,460,293,753,754
3404-001,2014,12,28,19,295,282,577,753
3404-001,2014,12,28,20,177,228,405,577
3404-001,2014,12,28,21,164,180,344,405
3404-001,2014,12,28,22,106,179,285,344
3404-001,2014,12,28,23,61,135,196,285
3404-001,2014,12,28,24,65,99,164,196
3404-001,2014,12,29,1,41,66,107,164
3404-001,2014,12,29,2,27,50,77,107
3404-001,2014,12,29,3,20,33,53,77
3404-001,2014,12,29,4,23,39,62,53
3404-001,2014,12,29,5,40,62,102,62
3404-001,2014,12,29,6,94,204,298,102
3404-001,2014,12,29,7,162,592,754,298
3404-001,2014,12,29,8,437,1753,2190,754
3404-001,2014,12,29,9,616,1241,1857,2190
3404-001,2014,12,29,10,659,667,1326,1857
3404-001,2014,12,29,11,619,715,1334,1326
3404-001,2014,12,29,12,729,669,1398,1334
3404-001,2014,12,29,13,572,506,1078,1398
3404-001,2014,12,29,14,610,569,1179,1078
3404-001,2014,12,29,15,706,699,1405,1179
3404-001,2014,12,29,16,729,607,1336,1405
3404-001,2014,12,29,17,757,545,1302,1336
3404-001,2014,12,29,18,1201,568,1769,1302
3404-001,2014,12,29,19,891,460,1351,1769
3404-001,2014,12,29,20,600,341,941,1351
3404-001,2014,12,29,21,567,229,796,941
3404-001,2014,12,29,22,300,198,498,796
3404-001,2014,12,29,23,184,145,329,498
3404-001,2014,12,29,24,138,88,226,329
3404-001,2014,12,30,1,88,77,165,226
3404-001,2014,12,30,2,84,75,159,165
3404-001,2014,12,30,3,48,37,85,159
3404-001,2014,12,30,4,50,45,95,85
3404-001,2014,12,30,5,59,78,137,95
3404-001,2014,12,30,6,115,160,275,137
3404-001,2014,12,30,7,139,452,591,275
3404-001,2014,12,30,8,454,1564,2018,591
3404-001,2014,12,30,9,667,1277,1944,2018
3404-001,2014,12,30,10,645,754,1399,1944
3404-001,2014,12,30,11,678,744,1422,1399
3404-001,2014,12,30,12,677,698,1375,1422
3404-001,2014,12,30,13,627,558,1185,1375
3404-001,2014,12,30,14,681,694,1375,1185
3404-001,2014,12,30,15,786,686,1472,1375
3404-001,2014,12,30,16,784,693,1477,1472
3404-001,2014,12,30,17,790,585,1375,1477
3404-001,2014,12,30,18,1179,518,1697,1375
3404-001,2014,12,30,19,1019,433,1452,1697
3404-001,2014,12,30,20,557,328,885,1452
3404-001,2014,12,30,21,559,229,788,885
3404-001,2014,12,30,22,350,218,568,788
3404-001,2014,12,30,23,216,173,389,568
3404-001,2014,12,30,24,148,129,277,389
3404-001,2014,12,31,1,108,73,181,277
3404-001,2014,12,31,2,78,73,151,181
3404-001,2014,12,31,3,59,59,118,151
3404-001,2014,12,31,4,54,45,99,118
3404-001,2014,12,31,5,70,76,146,99
3404-001,2014,12,31,6,73,119,192,146
3404-001,2014,12,31,7,109,377,486,192
3404-001,2014,12,31,8,309,1206,1515,486
3404-001,2014,12,31,9,558,1077,1635,1515
3404-001,2014,12,31,10,493,514,1007,1635
3404-001,2014,12,31,11,538,576,1114,1007
3404-001,2014,12,31,12,593,503,1096,1114
3404-001,2014,12,31,13,568,450,1018,1096
3404-001,2014,12,31,14,610,486,1096,1018
3404-001,2014,12,31,15,707,484,1191,1096
3404-001,2014,12,31,16,810,536,1346,1191
3404-001,2014,12,31,17,911,526,1437,1346
3404-001,2014,12,31,18,1201,456,1657,1437
3404-001,2014,12,31,19,799,377,1176,1657
3404-001,2014,12,31,20,508,313,821,1176
3404-001,2014,12,31,21,297,199,496,821
3404-001,2014,12,31,22,234,142,376,496
3404-001,2014,12,31,23,124,110,234,376
3404-001,2014,12,31,24,95,72,167,234
3404-001,2015,1,1,1,74,65,139,167
3404-001,2015,1,1,2,67,71,138,139
3404-001,2015,1,1,3,32,50,82,138
3404-001,2015,1,1,4,27,29,56,82
3404-001,2015,1,1,5,22,46,68,56
3404-001,2015,1,1,6,43,66,109,68
3404-001,2015,1,1,7,47,86,133,109
3404-001,2015,1,1,8,74,168,242,133
3404-001,2015,1,1,9,184,175,359,242
3404-001,2015,1,1,10,193,174,367,359
3404-001,2015,1,1,11,265,251,516,367
3404-001,2015,1,1,12,307,325,632,516
3404-001,2015,1,1,13,282,305,587,632
3404-001,2015,1,1,14,308,294,602,587
3404-001,2015,1,1,15,345,336,681,602
3404-001,2015,1,1,16,351,295,646,681
3404-001,2015,1,1,17,406,276,682,646
3404-001,2015,1,1,18,349,247,596,682
3404-001,2015,1,1,19,261,202,463,596
3404-001,2015,1,1,20,194,167,361,463
3404-001,2015,1,1,21,142,134,276,361
3404-001,2015,1,1,22,103,141,244,276
3404-001,2015,1,1,23,66,79,145,244
3404-001,2015,1,1,24,38,58,96,145
3404-001,2015,1,2,1,27,46,73,96
3404-001,2015,1,2,2,20,31,51,73
3404-001,2015,1,2,3,15,31,46,51
3404-001,2015,1,2,4,21,33,54,46
3404-001,2015,1,2,5,34,54,88,54
3404-001,2015,1,2,6,56,95,151,88
3404-001,2015,1,2,7,119,302,421,151
3404-001,2015,1,2,8,310,924,1234,421
3404-001,2015,1,2,9,401,760,1161,1234
3404-001,2015,1,2,10,400,423,823,1161
3404-001,2015,1,2,11,494,495,989,823
3404-001,2015,1,2,12,504,467,971,989
3404-001,2015,1,2,13,396,439,835,971
3404-001,2015,1,2,14,471,484,955,835
3404-001,2015,1,2,15,587,489,1076,955
3404-001,2015,1,2,16,586,451,1037,1076
3404-001,2015,1,2,17,519,423,942,1037
3404-001,2015,1,2,18,781,442,1223,942
3404-001,2015,1,2,19,698,401,1099,1223
3404-001,2015,1,2,20,373,277,650,1099
3404-001,2015,1,2,21,302,196,498,650
3404-001,2015,1,2,22,179,157,336,498
3404-001,2015,1,2,23,113,112,225,336
3404-001,2015,1,2,24,66,77,143,225
3404-001,2015,1,3,1,59,48,107,143
3404-001,2015,1,3,2,22,37,59,107
3404-001,2015,1,3,3,27,35,62,59
3404-001,2015,1,3,4,22,29,51,62
3404-001,2015,1,3,5,37,32,69,51
3404-001,2015,1,3,6,71,96,167,69
3404-001,2015,1,3,7,87,194,281,167
3404-001,2015,1,3,8,187,419,606,281
3404-001,2015,1,3,9,363,464,827,606
3404-001,2015,1,3,10,375,425,800,827
3404-001,2015,1,3,11,433,412,845,800
3404-001,2015,1,3,12,398,421,819,845
3404-001,2015,1,3,13,374,387,761,819
3404-001,2015,1,3,14,446,481,927,761
3404-001,2015,1,3,15,495,428,923,927
3404-001,2015,1,3,16,512,381,893,923
3404-001,2015,1,3,17,546,398,944,893
3404-001,2015,1,3,18,632,331,963,944
3404-001,2015,1,3,19,396,290,686,963
3404-001,2015,1,3,20,217,166,383,686
3404-001,2015,1,3,21,153,138,291,383
3404-001,2015,1,3,22,120,105,225,291
3404-001,2015,1,3,23,70,69,139,225
3404-001,2015,1,3,24,36,67,103,139
3404-001,2015,1,4,1,42,38,80,103
3404-001,2015,1,4,2,29,36,65,80
3404-001,2015,1,4,3,10,12,22,65
3404-001,2015,1,4,4,15,25,40,22
3404-001,2015,1,4,5,24,24,48,40
3404-001,2015,1,4,6,52,55,107,48
3404-001,2015,1,4,7,46,114,160,107
3404-001,2015,1,4,8,95,233,328,160
3404-001,2015,1,4,9,174,259,433,328
3404-001,2015,1,4,10,261,242,503,433
3404-001,2015,1,4,11,291,318,609,503
3404-001,2015,1,4,12,234,285,519,609
3404-001,2015,1,4,13,278,318,596,519
3404-001,2015,1,4,14,271,317,588,596
3404-001,2015,1,4,15,367,318,685,588
3404-001,2015,1,4,16,435,349,784,685
3404-001,2015,1,4,17,436,330,766,784
3404-001,2015,1,4,18,458,329,787,766
3404-001,2015,1,4,19,311,274,585,787
3404-001,2015,1,4,20,194,220,414,585
3404-001,2015,1,4,21,155,201,356,414
3404-001,2015,1,4,22,121,182,303,356
3404-001,2015,1,4,23,89,161,250,303
3404-001,2015,1,4,24,64,83,147,250
3404-001,2015,1,5,1,38,60,98,147
3404-001,2015,1,5,2,21,46,67,98
3404-001,2015,1,5,3,18,30,48,67
3404-001,2015,1,5,4,20,43,63,48
3404-001,2015,1,5,5,51,57,108,63
3404-001,2015,1,5,6,94,206,300,108
3404-001,2015,1,5,7,180,572,752,300
3404-001,2015,1,5,8,414,1833,2247,752
3404-001,2015,1,5,9,583,1336,1919,2247
3404-001,2015,1,5,10,589,655,1244,1919
3404-001,2015,1,5,11,645,678,1323,1244
3404-001,2015,1,5,12,626,649,1275,1323
3404-001,2015,1,5,13,582,507,1089,1275
3404-001,2015,1,5,14,605,643,1248,1089
3404-001,2015,1,5,15,723,727,1450,1248
3404-001,2015,1,5,16,739,616,1355,1450
3404-001,2015,1,5,17,762,566,1328,1355
3404-001,2015,1,5,18,1055,533,1588,1328
3404-001,2015,1,5,19,922,428,1350,1588
3404-001,2015,1,5,20,646,355,1001,1350
3404-001,2015,1,5,21,657,238,895,1001
3404-001,2015,1,5,22,336,195,531,895
3404-001,2015,1,5,23,185,105,290,531
3404-001,2015,1,5,24,126,98,224,290
3404-001,2015,1,6,1,87,73,160,224
3404-001,2015,1,6,2,76,40,116,160
3404-001,2015,1,6,3,43,37,80,116
3404-001,2015,1,6,4,47,35,82,80
3404-001,2015,1,6,5,57,70,127,82
3404-001,2015,1,6,6,91,173,264,127
3404-001,2015,1,6,7,144,410,554,264
3404-001,2015,1,6,8,375,1665,2040,554
3404-001,2015,1,6,9,601,1169,1770,2040
3404-001,2015,1,6,10,616,664,1280,1770
3404-001,2015,1,6,11,622,680,1302,1280
3404-001,2015,1,6,12,573,632,1205,1302
3404-001,2015,1,6,13,577,561,1138,1205
3404-001,2015,1,6,14,618,592,1210,1138
3404-001,2015,1,6,15,751,632,1383,1210
3404-001,2015,1,6,16,752,605,1357,1383
3404-001,2015,1,6,17,755,545,1300,1357
3404-001,2015,1,6,18,1045,451,1496,1300
3404-001,2015,1,6,19,881,404,1285,1496
3404-001,2015,1,6,20,648,339,987,1285
3404-001,2015,1,6,21,633,231,864,987
3404-001,2015,1,6,22,366,176,542,864
3404-001,2015,1,6,23,198,110,308,542
3404-001,2015,1,6,24,104,110,214,308
3404-001,2015,1,7,1,71,76,147,214
3404-001,2015,1,7,2,55,42,97,147
3404-001,2015,1,7,3,60,36,96,97
3404-001,2015,1,7,4,36,37,73,96
3404-001,2015,1,7,5,34,59,93,73
3404-001,2015,1,7,6,95,158,253,93
3404-001,2015,1,7,7,135,476,611,253
3404-001,2015,1,7,8,407,1647,2054,611
3404-001,2015,1,7,9,634,1256,1890,2054
3404-001,2015,1,7,10,626,704,1330,1890
3404-001,2015,1,7,11,636,674,1310,1330
3404-001,2015,1,7,12,599,632,1231,1310
3404-001,2015,1,7,13,558,548,1106,1231
3404-001,2015,1,7,14,613,662,1275,1106
3404-001,2015,1,7,15,757,676,1433,1275
3404-001,2015,1,7,16,717,615,1332,1433
3404-001,2015,1,7,17,707,515,1222,1332
3404-001,2015,1,7,18,1188,521,1709,1222
3404-001,2015,1,7,19,992,414,1406,1709
3404-001,2015,1,7,20,628,300,928,1406
3404-001,2015,1,7,21,562,194,756,928
3404-001,2015,1,7,22,292,181,473,756
3404-001,2015,1,7,23,175,108,283,473
3404-001,2015,1,7,24,122,89,211,283
3404-001,2015,1,8,1,73,54,127,211
3404-001,2015,1,8,2,56,40,96,127
3404-001,2015,1,8,3,29,33,62,96
3404-001,2015,1,8,4,43,48,91,62
3404-001,2015,1,8,5,50,70,120,91
3404-001,2015,1,8,6,96,177,273,120
3404-001,2015,1,8,7,175,492,667,273
3404-001,2015,1,8,8,404,1662,2066,667
3404-001,2015,1,8,9,679,1255,1934,2066
3404-001,2015,1,8,10,615,697,1312,1934
3404-001,2015,1,8,11,715,707,1422,1312
3404-001,2015,1,8,12,614,712,1326,1422
3404-001,2015,1,8,13,587,503,1090,1326
3404-001,2015,1,8,14,636,630,1266,1090
3404-001,2015,1,8,15,784,735,1519,1266
3404-001,2015,1,8,16,799,624,1423,1519
3404-001,2015,1,8,17,765,584,1349,1423
3404-001,2015,1,8,18,1073,543,1616,1349
3404-001,2015,1,8,19,928,393,1321,1616
3404-001,2015,1,8,20,682,326,1008,1321
3404-001,2015,1,8,21,657,225,882,1008
3404-001,2015,1,8,22,283,175,458,882
3404-001,2015,1,8,23,189,132,321,458
3404-001,2015,1,8,24,135,96,231,321
3404-001,2015,1,9,1,87,57,144,231
3404-001,2015,1,9,2,59,50,109,144
3404-001,2015,1,9,3,45,48,93,109
3404-001,2015,1,9,4,29,37,66,93
3404-001,2015,1,9,5,63,73,136,66
3404-001,2015,1,9,6,104,173,277,136
3404-001,2015,1,9,7,157,493,650,277
3404-001,2015,1,9,8,420,1717,2137,650
3404-001,2015,1,9,9,704,1286,1990,2137
3404-001,2015,1,9,10,589,735,1324,1990
3404-001,2015,1,9,11,719,663,1382,1324
3404-001,2015,1,9,12,627,670,1297,1382
3404-001,2015,1,9,13,663,606,1269,1297
3404-001,2015,1,9,14,662,621,1283,1269
3404-001,2015,1,9,15,750,678,1428,1283
3404-001,2015,1,9,16,832,654,1486,1428
3404-001,2015,1,9,17,779,567,1346,1486
3404-001,2015,1,9,18,1240,519,1759,1346
3404-001,2015,1,9,19,1226,478,1704,1759
3404-001,2015,1,9,20,784,403,1187,1704
3404-001,2015,1,9,21,544,234,778,1187
3404-001,2015,1,9,22,363,193,556,778
3404-001,2015,1,9,23,217,132,349,556
3404-001,2015,1,9,24,93,94,187,349
3404-001,2015,1,10,1,64,62,126,187
3404-001,2015,1,10,2,78,55,133,126
3404-001,2015,1,10,3,38,39,77,133
3404-001,2015,1,10,4,40,30,70,77
3404-001,2015,1,10,5,61,49,110,70
3404-001,2015,1,10,6,94,133,227,110
3404-001,2015,1,10,7,140,287,427,227
3404-001,2015,1,10,8,321,703,1024,427
3404-001,2015,1,10,9,457,595,1052,1024
3404-001,2015,1,10,10,517,587,1104,1052
3404-001,2015,1,10,11,601,567,1168,1104
3404-001,2015,1,10,12,545,561,1106,1168
3404-001,2015,1,10,13,513,488,1001,1106
3404-001,2015,1,10,14,527,535,1062,1001
3404-001,2015,1,10,15,594,498,1092,1062
3404-001,2015,1,10,16,554,479,1033,1092
3404-001,2015,1,10,17,654,428,1082,1033
3404-001,2015,1,10,18,809,417,1226,1082
3404-001,2015,1,10,19,453,299,752,1226
3404-001,2015,1,10,20,263,231,494,752
3404-001,2015,1,10,21,207,179,386,494
3404-001,2015,1,10,22,157,142,299,386
3404-001,2015,1,10,23,88,99,187,299
3404-001,2015,1,10,24,73,70,143,187
3404-001,2015,1,11,1,38,56,94,143
3404-001,2015,1,11,2,30,35,65,94
3404-001,2015,1,11,3,30,20,50,65
3404-001,2015,1,11,4,31,27,58,50
3404-001,2015,1,11,5,21,31,52,58
3404-001,2015,1,11,6,47,58,105,52
3404-001,2015,1,11,7,59,127,186,105
3404-001,2015,1,11,8,104,165,269,186
3404-001,2015,1,11,9,155,241,396,269
3404-001,2015,1,11,10,191,234,425,396
3404-001,2015,1,11,11,261,293,554,425
3404-001,2015,1,11,12,263,290,553,554
3404-001,2015,1,11,13,289,288,577,553
3404-001,2015,1,11,14,298,317,615,577
3404-001,2015,1,11,15,329,329,658,615
3404-001,2015,1,11,16,409,348,757,658
3404-001,2015,1,11,17,443,287,730,757
3404-001,2015,1,11,18,419,288,707,730
3404-001,2015,1,11,19,304,277,581,707
3404-001,2015,1,11,20,236,225,461,581
3404-001,2015,1,11,21,160,195,355,461
3404-001,2015,1,11,22,132,156,288,355
3404-001,2015,1,11,23,65,137,202,288
3404-001,2015,1,11,24,46,88,134,202
3404-001,2015,1,12,1,21,77,98,134
3404-001,2015,1,12,2,15,34,49,98
3404-001,2015,1,12,3,11,34,45,49
3404-001,2015,1,12,4,19,35,54,45
3404-001,2015,1,12,5,39,66,105,54
3404-001,2015,1,12,6,89,187,276,105
3404-001,2015,1,12,7,187,555,742,276
3404-001,2015,1,12,8,456,1869,2325,742
3404-001,2015,1,12,9,650,1304,1954,2325
3404-001,2015,1,12,10,580,670,1250,1954
3404-001,2015,1,12,11,674,709,1383,1250
3404-001,2015,1,12,12,617,698,1315,1383
3404-001,2015,1,12,13,557,512,1069,1315
3404-001,2015,1,12,14,663,620,1283,1069
3404-001,2015,1,12,15,719,730,1449,1283
3404-001,2015,1,12,16,769,664,1433,1449
3404-001,2015,1,12,17,696,587,1283,1433
3404-001,2015,1,12,18,1013,538,1551,1283
3404-001,2015,1,12,19,906,392,1298,1551
3404-001,2015,1,12,20,702,325,1027,1298
3404-001,2015,1,12,21,696,252,948,1027
3404-001,2015,1,12,22,336,179,515,948
3404-001,2015,1,12,23,188,121,309,515
3404-001,2015,1,12,24,106,85,191,309
3404-001,2015,1,13,1,71,55,126,191
3404-001,2015,1,13,2,56,49,105,126
3404-001,2015,1,13,3,35,38,73,105
3404-001,2015,1,13,4,36,37,73,73
3404-001,2015,1,13,5,46,62,108,73
3404-001,2015,1,13,6,90,167,257,108
3404-001,2015,1,13,7,163,446,609,257
3404-001,2015,1,13,8,425,1642,2067,609
3404-001,2015,1,13,9,646,1255,1901,2067
3404-001,2015,1,13,10,604,662,1266,1901
3404-001,2015,1,13,11,620,602,1222,1266
3404-001,2015,1,13,12,601,656,1257,1222
3404-001,2015,1,13,13,540,515,1055,1257
3404-001,2015,1,13,14,634,641,1275,1055
3404-001,2015,1,13,15,733,707,1440,1275
3404-001,2015,1,13,16,770,565,1335,1440
3404-001,2015,1,13,17,779,546,1325,1335
3404-001,2015,1,13,18,1004,490,1494,1325
3404-001,2015,1,13,19,930,361,1291,1494
3404-001,2015,1,13,20,655,349,1004,1291
3404-001,2015,1,13,21,668,208,876,1004
3404-001,2015,1,13,22,311,194,505,876
3404-001,2015,1,13,23,202,121,323,505
3404-001,2015,1,13,24,113,90,203,323
3404-001,2015,1,14,1,68,72,140,203
3404-001,2015,1,14,2,52,38,90,140
3404-001,2015,1,14,3,44,40,84,90
3404-001,2015,1,14,4,36,40,76,84
3404-001,2015,1,14,5,59,59,118,76
3404-001,2015,1,14,6,111,174,285,118
3404-001,2015,1,14,7,151,479,630,285
3404-001,2015,1,14,8,474,1611,2085,630
3404-001,2015,1,14,9,723,1301,2024,2085
3404-001,2015,1,14,10,642,778,1420,2024
3404-001,2015,1,14,11,714,733,1447,1420
3404-001,2015,1,14,12,656,741,1397,1447
3404-001,2015,1,14,13,564,545,1109,1397
3404-001,2015,1,14,14,631,641,1272,1109
3404-001,2015,1,14,15,764,732,1496,1272
3404-001,2015,1,14,16,757,637,1394,1496
3404-001,2015,1,14,17,771,569,1340,1394
3404-001,2015,1,14,18,1179,508,1687,1340
3404-001,2015,1,14,19,953,397,1350,1687
3404-001,2015,1,14,20,633,309,942,1350
3404-001,2015,1,14,21,565,209,774,942
3404-001,2015,1,14,22,343,178,521,774
3404-001,2015,1,14,23,187,161,348,521
3404-001,2015,1,14,24,115,106,221,348
3404-001,2015,1,15,1,67,58,125,221
3404-001,2015,1,15,2,58,53,111,125
3404-001,2015,1,15,3,37,37,74,111
3404-001,2015,1,15,4,39,40,79,74
3404-001,2015,1,15,5,67,71,138,79
3404-001,2015,1,15,6,111,187,298,138
3404-001,2015,1,15,7,165,483,648,298
3404-001,2015,1,15,8,472,1557,2029,648
3404-001,2015,1,15,9,664,1265,1929,2029
3404-001,2015,1,15,10,674,749,1423,1929
3404-001,2015,1,15,11,725,734,1459,1423
3404-001,2015,1,15,12,652,727,1379,1459
3404-001,2015,1,15,13,650,584,1234,1379
3404-001,2015,1,15,14,646,680,1326,1234
3404-001,2015,1,15,15,723,736,1459,1326
3404-001,2015,1,15,16,834,687,1521,1459
3404-001,2015,1,15,17,784,601,1385,1521
3404-001,2015,1,15,18,1099,514,1613,1385
3404-001,2015,1,15,19,914,442,1356,1613
3404-001,2015,1,15,20,662,322,984,1356
3404-001,2015,1,15,21,588,236,824,984
3404-001,2015,1,15,22,330,200,530,824
3404-001,2015,1,15,23,206,132,338,530
3404-001,2015,1,15,24,111,98,209,338
3404-001,2015,1,16,1,84,73,157,209
3404-001,2015,1,16,2,71,50,121,157
3404-001,2015,1,16,3,38,28,66,121
3404-001,2015,1,16,4,39,24,63,66
3404-001,2015,1,16,5,59,73,132,63
3404-001,2015,1,16,6,93,190,283,132
3404-001,2015,1,16,7,158,450,608,283
3404-001,2015,1,16,8,438,1580,2018,608
3404-001,2015,1,16,9,664,1264,1928,2018
3404-001,2015,1,16,10,638,714,1352,1928
3404-001,2015,1,16,11,722,687,1409,1352
3404-001,2015,1,16,12,687,659,1346,1409
3404-001,2015,1,16,13,655,540,1195,1346
3404-001,2015,1,16,14,638,627,1265,1195
3404-001,2015,1,16,15,766,704,1470,1265
3404-001,2015,1,16,16,760,595,1355,1470
3404-001,2015,1,16,17,784,546,1330,1355
3404-001,2015,1,16,18,1150,495,1645,1330
3404-001,2015,1,16,19,1151,467,1618,1645
3404-001,2015,1,16,20,732,369,1101,1618
3404-001,2015,1,16,21,571,244,815,1101
3404-001,2015,1,16,22,277,188,465,815
3404-001,2015,1,16,23,171,115,286,465
3404-001,2015,1,16,24,94,82,176,286
3404-001,2015,1,17,1,78,74,152,176
3404-001,2015,1,17,2,64,34,98,152
3404-001,2015,1,17,3,48,28,76,98
3404-001,2015,1,17,4,38,29,67,76
3404-001,2015,1,17,5,45,45,90,67
3404-001,2015,1,17,6,80,138,218,90
3404-001,2015,1,17,7,142,253,395,218
3404-001,2015,1,17,8,295,660,955,395
3404-001,2015,1,17,9,432,648,1080,955
3404-001,2015,1,17,10,522,511,1033,1080
3404-001,2015,1,17,11,497,552,1049,1033
3404-001,2015,1,17,12,483,521,1004,1049
3404-001,2015,1,17,13,495,429,924,1004
3404-001,2015,1,17,14,541,481,1022,924
3404-001,2015,1,17,15,568,467,1035,1022
3404-001,2015,1,17,16,590,454,1044,1035
3404-001,2015,1,17,17,603,397,1000,1044
3404-001,2015,1,17,18,811,394,1205,1000
3404-001,2015,1,17,19,488,322,810,1205
3404-001,2015,1,17,20,249,214,463,810
3404-001,2015,1,17,21,227,146,373,463
3404-001,2015,1,17,22,111,149,260,373
3404-001,2015,1,17,23,83,88,171,260
3404-001,2015,1,17,24,63,66,129,171
3404-001,2015,1,18,1,34,46,80,129
3404-001,2015,1,18,2,25,28,53,80
3404-001,2015,1,18,3,24,20,44,53
3404-001,2015,1,18,4,28,18,46,44
3404-001,2015,1,18,5,25,15,40,46
3404-001,2015,1,18,6,46,53,99,40
3404-001,2015,1,18,7,43,112,155,99
3404-001,2015,1,18,8,123,217,340,155
3404-001,2015,1,18,9,224,272,496,340
3404-001,2015,1,18,10,254,260,514,496
3404-001,2015,1,18,11,296,335,631,514
3404-001,2015,1,18,12,323,354,677,631
3404-001,2015,1,18,13,320,301,621,677
3404-001,2015,1,18,14,332,379,711,621
3404-001,2015,1,18,15,404,367,771,711
3404-001,2015,1,18,16,457,376,833,771
3404-001,2015,1,18,17,460,325,785,833
3404-001,2015,1,18,18,399,268,667,785
3404-001,2015,1,18,19,273,265,538,667
3404-001,2015,1,18,20,193,261,454,538
3404-001,2015,1,18,21,155,200,355,454
3404-001,2015,1,18,22,110,174,284,355
3404-001,2015,1,18,23,54,173,227,284
3404-001,2015,1,18,24,27,103,130,227
3404-001,2015,1,19,1,29,56,85,130
3404-001,2015,1,19,2,25,31,56,85
3404-001,2015,1,19,3,13,33,46,56
3404-001,2015,1,19,4,12,23,35,46
3404-001,2015,1,19,5,35,73,108,35
3404-001,2015,1,19,6,81,189,270,108
3404-001,2015,1,19,7,149,524,673,270
3404-001,2015,1,19,8,421,1715,2136,673
3404-001,2015,1,19,9,496,1187,1683,2136
3404-001,2015,1,19,10,535,608,1143,1683
3404-001,2015,1,19,11,578,643,1221,1143
3404-001,2015,1,19,12,622,624,1246,1221
3404-001,2015,1,19,13,544,498,1042,1246
3404-001,2015,1,19,14,570,572,1142,1042
3404-001,2015,1,19,15,701,661,1362,1142
3404-001,2015,1,19,16,741,588,1329,1362
3404-001,2015,1,19,17,687,567,1254,1329
3404-001,2015,1,19,18,974,524,1498,1254
3404-001,2015,1,19,19,860,453,1313,1498
3404-001,2015,1,19,20,671,321,992,1313
3404-001,2015,1,19,21,614,230,844,992
3404-001,2015,1,19,22,354,164,518,844
3404-001,2015,1,19,23,203,115,318,518
3404-001,2015,1,19,24,107,123,230,318
3404-001,2015,1,20,1,67,55,122,230
3404-001,2015,1,20,2,68,47,115,122
3404-001,2015,1,20,3,37,34,71,115
3404-001,2015,1,20,4,42,41,83,71
3404-001,2015,1,20,5,56,67,123,83
3404-001,2015,1,20,6,95,157,252,123
3404-001,2015,1,20,7,138,436,574,252
3404-001,2015,1,20,8,411,1632,2043,574
3404-001,2015,1,20,9,701,1237,1938,2043
3404-001,2015,1,20,10,618,725,1343,1938
3404-001,2015,1,20,11,635,660,1295,1343
3404-001,2015,1,20,12,610,653,1263,1295
3404-001,2015,1,20,13,571,541,1112,1263
3404-001,2015,1,20,14,605,601,1206,1112
3404-001,2015,1,20,15,737,667,1404,1206
3404-001,2015,1,20,16,758,623,1381,1404
3404-001,2015,1,20,17,800,561,1361,1381
3404-001,2015,1,20,18,1016,533,1549,1361
3404-001,2015,1,20,19,972,410,1382,1549
3404-001,2015,1,20,20,669,319,988,1382
3404-001,2015,1,20,21,641,262,903,988
3404-001,2015,1,20,22,353,201,554,903
3404-001,2015,1,20,23,167,124,291,554
3404-001,2015,1,20,24,124,90,214,291
3404-001,2015,1,21,1,70,60,130,214
3404-001,2015,1,21,2,58,57,115,130
3404-001,2015,1,21,3,43,47,90,115
3404-001,2015,1,21,4,47,42,89,90
3404-001,2015,1,21,5,66,66,132,89
3404-001,2015,1,21,6,90,160,250,132
3404-001,2015,1,21,7,175,502,677,250
3404-001,2015,1,21,8,440,1616,2056,677
3404-001,2015,1,21,9,657,1325,1982,2056
3404-001,2015,1,21,10,695,694,1389,1982
3404-001,2015,1,21,11,700,713,1413,1389
3404-001,2015,1,21,12,637,663,1300,1413
3404-001,2015,1,21,13,590,543,1133,1300
3404-001,2015,1,21,14,681,665,1346,1133
3404-001,2015,1,21,15,746,671,1417,1346
3404-001,2015,1,21,16,761,647,1408,1417
3404-001,2015,1,21,17,734,558,1292,1408
3404-001,2015,1,21,18,1145,505,1650,1292
3404-001,2015,1,21,19,952,404,1356,1650
3404-001,2015,1,21,20,633,307,940,1356
3404-001,2015,1,21,21,495,221,716,940
3404-001,2015,1,21,22,317,179,496,716
3404-001,2015,1,21,23,173,131,304,496
3404-001,2015,1,21,24,121,91,212,304
3404-001,2015,1,22,1,55,70,125,212
3404-001,2015,1,22,2,58,45,103,125
3404-001,2015,1,22,3,29,32,61,103
3404-001,2015,1,22,4,32,34,66,61
3404-001,2015,1,22,5,63,59,122,66
3404-001,2015,1,22,6,75,136,211,122
3404-001,2015,1,22,7,132,435,567,211
3404-001,2015,1,22,8,397,1489,1886,567
3404-001,2015,1,22,9,656,1202,1858,1886
3404-001,2015,1,22,10,581,614,1195,1858
3404-001,2015,1,22,11,635,656,1291,1195
3404-001,2015,1,22,12,614,622,1236,1291
3404-001,2015,1,22,13,573,548,1121,1236
3404-001,2015,1,22,14,596,647,1243,1121
3404-001,2015,1,22,15,717,667,1384,1243
3404-001,2015,1,22,16,733,553,1286,1384
3404-001,2015,1,22,17,735,522,1257,1286
3404-001,2015,1,22,18,976,502,1478,1257
3404-001,2015,1,22,19,838,398,1236,1478
3404-001,2015,1,22,20,657,318,975,1236
3404-001,2015,1,22,21,619,254,873,975
3404-001,2015,1,22,22,358,195,553,873
3404-001,2015,1,22,23,181,132,313,553
3404-001,2015,1,22,24,107,115,222,313
3404-001,2015,1,23,1,69,71,140,222
3404-001,2015,1,23,2,70,58,128,140
3404-001,2015,1,23,3,42,38,80,128
3404-001,2015,1,23,4,33,30,63,80
3404-001,2015,1,23,5,62,74,136,63
3404-001,2015,1,23,6,113,170,283,136
3404-001,2015,1,23,7,163,473,636,283
3404-001,2015,1,23,8,412,1613,2025,636
3404-001,2015,1,23,9,625,1253,1878,2025
3404-001,2015,1,23,10,705,678,1383,1878
3404-001,2015,1,23,11,686,688,1374,1383
3404-001,2015,1,23,12,649,663,1312,1374
3404-001,2015,1,23,13,576,543,1119,1312
3404-001,2015,1,23,14,691,649,1340,1119
3404-001,2015,1,23,15,733,722,1455,1340
3404-001,2015,1,23,16,820,621,1441,1455
3404-001,2015,1,23,17,808,550,1358,1441
3404-001,2015,1,23,18,1226,506,1732,1358
3404-001,2015,1,23,19,1138,497,1635,1732
3404-001,2015,1,23,20,765,393,1158,1635
3404-001,2015,1,23,21,559,255,814,1158
3404-001,2015,1,23,22,355,174,529,814
3404-001,2015,1,23,23,188,139,327,529
3404-001,2015,1,23,24,113,112,225,327
3404-001,2015,1,24,1,82,77,159,225
3404-001,2015,1,24,2,70,65,135,159
3404-001,2015,1,24,3,32,36,68,135
3404-001,2015,1,24,4,33,39,72,68
3404-001,2015,1,24,5,50,56,106,72
3404-001,2015,1,24,6,100,138,238,106
3404-001,2015,1,24,7,158,311,469,238
3404-001,2015,1,24,8,324,686,1010,469
3404-001,2015,1,24,9,491,680,1171,1010
3404-001,2015,1,24,10,501,595,1096,1171
3404-001,2015,1,24,11,554,549,1103,1096
3404-001,2015,1,24,12,536,535,1071,1103
3404-001,2015,1,24,13,499,469,968,1071
3404-001,2015,1,24,14,547,533,1080,968
3404-001,2015,1,24,15,613,508,1121,1080
3404-001,2015,1,24,16,574,467,1041,1121
3404-001,2015,1,24,17,667,428,1095,1041
3404-001,2015,1,24,18,834,416,1250,1095
3404-001,2015,1,24,19,518,320,838,1250
3404-001,2015,1,24,20,298,224,522,838
3404-001,2015,1,24,21,227,180,407,522
3404-001,2015,1,24,22,156,134,290,407
3404-001,2015,1,24,23,79,94,173,290
3404-001,2015,1,24,24,59,63,122,173
3404-001,2015,1,25,1,50,56,106,122
3404-001,2015,1,25,2,31,33,64,106
3404-001,2015,1,25,3,31,36,67,64
3404-001,2015,1,25,4,25,28,53,67
3404-001,2015,1,25,5,19,27,46,53
3404-001,2015,1,25,6,37,64,101,46
3404-001,2015,1,25,7,56,90,146,101
3404-001,2015,1,25,8,149,255,404,146
3404-001,2015,1,25,9,293,255,548,404
3404-001,2015,1,25,10,236,232,468,548
3404-001,2015,1,25,11,288,327,615,468
3404-001,2015,1,25,12,270,339,609,615
3404-001,2015,1,25,13,333,348,681,609
3404-001,2015,1,25,14,341,294,635,681
3404-001,2015,1,25,15,350,312,662,635
3404-001,2015,1,25,16,434,323,757,662
3404-001,2015,1,25,17,409,290,699,757
3404-001,2015,1,25,18,359,300,659,699
3404-001,2015,1,25,19,279,279,558,659
3404-001,2015,1,25,20,185,198,383,558
3404-001,2015,1,25,21,146,199,345,383
3404-001,2015,1,25,22,115,154,269,345
3404-001,2015,1,25,23,66,134,200,269
3404-001,2015,1,25,24,52,116,168,200
3404-001,2015,1,26,1,37,72,109,168
3404-001,2015,1,26,2,21,38,59,109
3404-001,2015,1,26,3,16,22,38,59
3404-001,2015,1,26,4,20,35,55,38
3404-001,2015,1,26,5,33,56,89,55
3404-001,2015,1,26,6,82,190,272,89
3404-001,2015,1,26,7,152,556,708,272
3404-001,2015,1,26,8,386,1704,2090,708
3404-001,2015,1,26,9,549,1207,1756,2090
3404-001,2015,1,26,10,533,619,1152,1756
3404-001,2015,1,26,11,558,598,1156,1152
3404-001,2015,1,26,12,594,586,1180,1156
3404-001,2015,1,26,13,495,505,1000,1180
3404-001,2015,1,26,14,585,563,1148,1000
3404-001,2015,1,26,15,670,660,1330,1148
3404-001,2015,1,26,16,691,578,1269,1330
3404-001,2015,1,26,17,695,560,1255,1269
3404-001,2015,1,26,18,917,520,1437,1255
3404-001,2015,1,26,19,868,416,1284,1437
3404-001,2015,1,26,20,637,322,959,1284
3404-001,2015,1,26,21,602,219,821,959
3404-001,2015,1,26,22,346,186,532,821
3404-001,2015,1,26,23,190,106,296,532
3404-001,2015,1,26,24,87,81,168,296
3404-001,2015,1,27,1,69,51,120,168
3404-001,2015,1,27,2,58,41,99,120
3404-001,2015,1,27,3,32,44,76,99
3404-001,2015,1,27,4,37,38,75,76
3404-001,2015,1,27,5,44,74,118,75
3404-001,2015,1,27,6,107,157,264,118
3404-001,2015,1,27,7,157,461,618,264
3404-001,2015,1,27,8,419,1585,2004,618
3404-001,2015,1,27,9,665,1256,1921,2004
3404-001,2015,1,27,10,623,710,1333,1921
3404-001,2015,1,27,11,677,692,1369,1333
3404-001,2015,1,27,12,644,649,1293,1369
3404-001,2015,1,27,13,504,548,1052,1293
3404-001,2015,1,27,14,668,614,1282,1052
3404-001,2015,1,27,15,783,692,1475,1282
3404-001,2015,1,27,16,732,621,1353,1475
3404-001,2015,1,27,17,789,527,1316,1353
3404-001,2015,1,27,18,1020,483,1503,1316
3404-001,2015,1,27,19,917,417,1334,1503
3404-001,2015,1,27,20,620,341,961,1334
3404-001,2015,1,27,21,662,227,889,961
3404-001,2015,1,27,22,339,206,545,889
3404-001,2015,1,27,23,183,110,293,545
3404-001,2015,1,27,24,110,113,223,293
3404-001,2015,1,28,1,62,55,117,223
3404-001,2015,1,28,2,62,57,119,117
3404-001,2015,1,28,3,43,44,87,119
3404-001,2015,1,28,4,31,49,80,87
3404-001,2015,1,28,5,44,70,114,80
3404-001,2015,1,28,6,119,170,289,114
3404-001,2015,1,28,7,158,487,645,289
3404-001,2015,1,28,8,437,1595,2032,645
3404-001,2015,1,28,9,711,1300,2011,2032
3404-001,2015,1,28,10,700,742,1442,2011
3404-001,2015,1,28,11,730,774,1504,1442
3404-001,2015,1,28,12,667,666,1333,1504
3404-001,2015,1,28,13,615,556,1171,1333
3404-001,2015,1,28,14,652,732,1384,1171
3404-001,2015,1,28,15,797,722,1519,1384
3404-001,2015,1,28,16,774,716,1490,1519
3404-001,2015,1,28,17,765,646,1411,1490
3404-001,2015,1,28,18,1110,494,1604,1411
3404-001,2015,1,28,19,981,421,1402,1604
3404-001,2015,1,28,20,648,352,1000,1402
3404-001,2015,1,28,21,578,239,817,1000
3404-001,2015,1,28,22,303,178,481,817
3404-001,2015,1,28,23,217,130,347,481
3404-001,2015,1,28,24,115,103,218,347
3404-001,2015,1,29,1,94,59,153,218
3404-001,2015,1,29,2,72,66,138,153
3404-001,2015,1,29,3,38,39,77,138
3404-001,2015,1,29,4,33,44,77,77
3404-001,2015,1,29,5,62,63,125,77
3404-001,2015,1,29,6,123,167,290,125
3404-001,2015,1,29,7,186,447,633,290
3404-001,2015,1,29,8,431,1599,2030,633
3404-001,2015,1,29,9,668,1261,1929,2030
3404-001,2015,1,29,10,659,695,1354,1929
3404-001,2015,1,29,11,755,704,1459,1354
3404-001,2015,1,29,12,683,682,1365,1459
3404-001,2015,1,29,13,616,547,1163,1365
3404-001,2015,1,29,14,648,663,1311,1163
3404-001,2015,1,29,15,710,698,1408,1311
3404-001,2015,1,29,16,758,621,1379,1408
3404-001,2015,1,29,17,754,571,1325,1379
3404-001,2015,1,29,18,1017,546,1563,1325
3404-001,2015,1,29,19,938,431,1369,1563
3404-001,2015,1,29,20,618,338,956,1369
3404-001,2015,1,29,21,654,229,883,956
3404-001,2015,1,29,22,320,205,525,883
3404-001,2015,1,29,23,188,128,316,525
3404-001,2015,1,29,24,120,95,215,316
3404-001,2015,1,30,1,67,72,139,215
3404-001,2015,1,30,2,65,47,112,139
3404-001,2015,1,30,3,49,34,83,112
3404-001,2015,1,30,4,39,33,72,83
3404-001,2015,1,30,5,69,68,137,72
3404-001,2015,1,30,6,113,180,293,137
3404-001,2015,1,30,7,167,485,652,293
3404-001,2015,1,30,8,461,1623,2084,652
3404-001,2015,1,30,9,701,1244,1945,2084
3404-001,2015,1,30,10,666,708,1374,1945
3404-001,2015,1,30,11,706,706,1412,1374
3404-001,2015,1,30,12,719,685,1404,1412
3404-001,2015,1,30,13,609,543,1152,1404
3404-001,2015,1,30,14,665,672,1337,1152
3404-001,2015,1,30,15,815,723,1538,1337
3404-001,2015,1,30,16,842,654,1496,1538
3404-001,2015,1,30,17,798,592,1390,1496
3404-001,2015,1,30,18,1213,595,1808,1390
3404-001,2015,1,30,19,1143,445,1588,1808
3404-001,2015,1,30,20,808,425,1233,1588
3404-001,2015,1,30,21,637,271,908,1233
3404-001,2015,1,30,22,353,216,569,908
3404-001,2015,1,30,23,191,120,311,569
3404-001,2015,1,30,24,136,96,232,311
3404-001,2015,1,31,1,78,74,152,232
3404-001,2015,1,31,2,62,70,132,152
3404-001,2015,1,31,3,55,37,92,132
3404-001,2015,1,31,4,46,31,77,92
3404-001,2015,1,31,5,60,44,104,77
3404-001,2015,1,31,6,91,119,210,104
3404-001,2015,1,31,7,145,279,424,210
3404-001,2015,1,31,8,322,679,1001,424
3404-001,2015,1,31,9,470,694,1164,1001
3404-001,2015,1,31,10,534,523,1057,1164
3404-001,2015,1,31,11,566,541,1107,1057
3404-001,2015,1,31,12,510,521,1031,1107
3404-001,2015,1,31,13,516,500,1016,1031
3404-001,2015,1,31,14,553,505,1058,1016
3404-001,2015,1,31,15,553,499,1052,1058
3404-001,2015,1,31,16,576,446,1022,1052
3404-001,2015,1,31,17,660,369,1029,1022
3404-001,2015,1,31,18,809,426,1235,1029
3404-001,2015,1,31,19,444,323,767,1235
3404-001,2015,1,31,20,223,238,461,767
3404-001,2015,1,31,21,203,171,374,461
3404-001,2015,1,31,22,151,146,297,374
3404-001,2015,1,31,23,94,91,185,297
3404-001,2015,1,31,24,77,50,127,185
3404-001,2015,2,1,1,53,50,103,127
3404-001,2015,2,1,2,42,46,88,103
3404-001,2015,2,1,3,23,29,52,88
3404-001,2015,2,1,4,20,31,51,52
3404-001,2015,2,1,5,23,33,56,51
3404-001,2015,2,1,6,40,50,90,56
3404-001,2015,2,1,7,59,112,171,90
3404-001,2015,2,1,8,111,244,355,171
3404-001,2015,2,1,9,237,224,461,355
3404-001,2015,2,1,10,226,263,489,461
3404-001,2015,2,1,11,277,290,567,489
3404-001,2015,2,1,12,316,308,624,567
3404-001,2015,2,1,13,290,329,619,624
3404-001,2015,2,1,14,289,346,635,619
3404-001,2015,2,1,15,373,338,711,635
3404-001,2015,2,1,16,430,369,799,711
3404-001,2015,2,1,17,452,325,777,799
3404-001,2015,2,1,18,460,301,761,777
3404-001,2015,2,1,19,320,311,631,761
3404-001,2015,2,1,20,249,247,496,631
3404-001,2015,2,1,21,186,192,378,496
3404-001,2015,2,1,22,142,191,333,378
3404-001,2015,2,1,23,75,156,231,333
3404-001,2015,2,1,24,43,87,130,231
3404-001,2015,2,2,1,34,73,107,130
3404-001,2015,2,2,2,30,44,74,107
3404-001,2015,2,2,3,18,31,49,74
3404-001,2015,2,2,4,30,28,58,49
3404-001,2015,2,2,5,43,72,115,58
3404-001,2015,2,2,6,93,212,305,115
3404-001,2015,2,2,7,179,563,742,305
3404-001,2015,2,2,8,474,1827,2301,742
3404-001,2015,2,2,9,617,1360,1977,2301
3404-001,2015,2,2,10,618,681,1299,1977
3404-001,2015,2,2,11,652,633,1285,1299
3404-001,2015,2,2,12,635,599,1234,1285
3404-001,2015,2,2,13,531,559,1090,1234
3404-001,2015,2,2,14,614,634,1248,1090
3404-001,2015,2,2,15,746,729,1475,1248
3404-001,2015,2,2,16,764,638,1402,1475
3404-001,2015,2,2,17,720,586,1306,1402
3404-001,2015,2,2,18,995,542,1537,1306
3404-001,2015,2,2,19,939,440,1379,1537
3404-001,2015,2,2,20,715,340,1055,1379
3404-001,2015,2,2,21,670,238,908,1055
3404-001,2015,2,2,22,395,201,596,908
3404-001,2015,2,2,23,216,140,356,596
3404-001,2015,2,2,24,108,89,197,356
3404-001,2015,2,3,1,73,50,123,197
3404-001,2015,2,3,2,52,49,101,123
3404-001,2015,2,3,3,44,38,82,101
3404-001,2015,2,3,4,35,42,77,82
3404-001,2015,2,3,5,56,78,134,77
3404-001,2015,2,3,6,97,183,280,134
3404-001,2015,2,3,7,181,439,620,280
3404-001,2015,2,3,8,423,1725,2148,620
3404-001,2015,2,3,9,714,1326,2040,2148
3404-001,2015,2,3,10,631,692,1323,2040
3404-001,2015,2,3,11,733,703,1436,1323
3404-001,2015,2,3,12,649,654,1303,1436
3404-001,2015,2,3,13,591,576,1167,1303
3404-001,2015,2,3,14,654,605,1259,1167
3404-001,2015,2,3,15,790,731,1521,1259
3404-001,2015,2,3,16,781,597,1378,1521
3404-001,2015,2,3,17,788,604,1392,1378
3404-001,2015,2,3,18,1072,538,1610,1392
3404-001,2015,2,3,19,935,422,1357,1610
3404-001,2015,2,3,20,669,352,1021,1357
3404-001,2015,2,3,21,655,219,874,1021
3404-001,2015,2,3,22,377,199,576,874
3404-001,2015,2,3,23,243,140,383,576
3404-001,2015,2,3,24,111,100,211,383
3404-001,2015,2,4,1,76,70,146,211
3404-001,2015,2,4,2,58,42,100,146
3404-001,2015,2,4,3,33,33,66,100
3404-001,2015,2,4,4,35,31,66,66
3404-001,2015,2,4,5,55,56,111,66
3404-001,2015,2,4,6,112,176,288,111
3404-001,2015,2,4,7,167,507,674,288
3404-001,2015,2,4,8,468,1674,2142,674
3404-001,2015,2,4,9,747,1347,2094,2142
3404-001,2015,2,4,10,686,722,1408,2094
3404-001,2015,2,4,11,717,737,1454,1408
3404-001,2015,2,4,12,665,665,1330,1454
3404-001,2015,2,4,13,597,574,1171,1330
3404-001,2015,2,4,14,676,685,1361,1171
3404-001,2015,2,4,15,805,727,1532,1361
3404-001,2015,2,4,16,798,700,1498,1532
3404-001,2015,2,4,17,821,550,1371,1498
3404-001,2015,2,4,18,1167,535,1702,1371
3404-001,2015,2,4,19,1002,439,1441,1702
3404-001,2015,2,4,20,592,346,938,1441
3404-001,2015,2,4,21,549,240,789,938
3404-001,2015,2,4,22,352,196,548,789
3404-001,2015,2,4,23,203,134,337,548
3404-001,2015,2,4,24,100,86,186,337
3404-001,2015,2,5,1,69,54,123,186
3404-001,2015,2,5,2,61,55,116,123
3404-001,2015,2,5,3,38,32,70,116
3404-001,2015,2,5,4,47,35,82,70
3404-001,2015,2,5,5,46,80,126,82
3404-001,2015,2,5,6,105,171,276,126
3404-001,2015,2,5,7,184,449,633,276
3404-001,2015,2,5,8,431,1686,2117,633
3404-001,2015,2,5,9,694,1267,1961,2117
3404-001,2015,2,5,10,665,716,1381,1961
3404-001,2015,2,5,11,704,712,1416,1381
3404-001,2015,2,5,12,640,640,1280,1416
3404-001,2015,2,5,13,612,562,1174,1280
3404-001,2015,2,5,14,615,664,1279,1174
3404-001,2015,2,5,15,784,721,1505,1279
3404-001,2015,2,5,16,773,653,1426,1505
3404-001,2015,2,5,17,798,636,1434,1426
3404-001,2015,2,5,18,1136,529,1665,1434
3404-001,2015,2,5,19,921,481,1402,1665
3404-001,2015,2,5,20,712,319,1031,1402
3404-001,2015,2,5,21,642,244,886,1031
3404-001,2015,2,5,22,354,235,589,886
3404-001,2015,2,5,23,266,142,408,589
3404-001,2015,2,5,24,128,104,232,408
3404-001,2015,2,6,1,99,62,161,232
3404-001,2015,2,6,2,62,48,110,161
3404-001,2015,2,6,3,64,52,116,110
3404-001,2015,2,6,4,41,56,97,116
3404-001,2015,2,6,5,55,75,130,97
3404-001,2015,2,6,6,95,197,292,130
3404-001,2015,2,6,7,182,515,697,292
3404-001,2015,2,6,8,491,1727,2218,697
3404-001,2015,2,6,9,711,1321,2032,2218
3404-001,2015,2,6,10,777,747,1524,2032
3404-001,2015,2,6,11,796,771,1567,1524
3404-001,2015,2,6,12,740,678,1418,1567
3404-001,2015,2,6,13,697,580,1277,1418
3404-001,2015,2,6,14,685,711,1396,1277
3404-001,2015,2,6,15,848,674,1522,1396
3404-001,2015,2,6,16,792,704,1496,1522
3404-001,2015,2,6,17,853,619,1472,1496
3404-001,2015,2,6,18,1303,603,1906,1472
3404-001,2015,2,6,19,1188,520,1708,1906
3404-001,2015,2,6,20,795,390,1185,1708
3404-001,2015,2,6,21,604,241,845,1185
3404-001,2015,2,6,22,334,194,528,845
3404-001,2015,2,6,23,233,128,361,528
3404-001,2015,2,6,24,128,107,235,361
3404-001,2015,2,7,1,95,58,153,235
3404-001,2015,2,7,2,79,40,119,153
3404-001,2015,2,7,3,39,47,86,119
3404-001,2015,2,7,4,43,37,80,86
3404-001,2015,2,7,5,58,50,108,80
3404-001,2015,2,7,6,94,143,237,108
3404-001,2015,2,7,7,151,335,486,237
3404-001,2015,2,7,8,355,774,1129,486
3404-001,2015,2,7,9,516,678,1194,1129
3404-001,2015,2,7,10,584,617,1201,1194
3404-001,2015,2,7,11,603,563,1166,1201
3404-001,2015,2,7,12,494,563,1057,1166
3404-001,2015,2,7,13,523,479,1002,1057
3404-001,2015,2,7,14,589,526,1115,1002
3404-001,2015,2,7,15,626,496,1122,1115
3404-001,2015,2,7,16,555,486,1041,1122
3404-001,2015,2,7,17,710,428,1138,1041
3404-001,2015,2,7,18,836,435,1271,1138
3404-001,2015,2,7,19,505,307,812,1271
3404-001,2015,2,7,20,292,256,548,812
3404-001,2015,2,7,21,252,168,420,548
3404-001,2015,2,7,22,175,151,326,420
3404-001,2015,2,7,23,80,110,190,326
3404-001,2015,2,7,24,82,72,154,190
3404-001,2015,2,8,1,37,56,93,154
3404-001,2015,2,8,2,52,35,87,93
3404-001,2015,2,8,3,18,13,31,87
3404-001,2015,2,8,4,20,21,41,31
3404-001,2015,2,8,5,27,27,54,41
3404-001,2015,2,8,6,39,50,89,54
3404-001,2015,2,8,7,81,118,199,89
3404-001,2015,2,8,8,122,260,382,199
3404-001,2015,2,8,9,209,270,479,382
3404-001,2015,2,8,10,254,212,466,479
3404-001,2015,2,8,11,258,298,556,466
3404-001,2015,2,8,12,263,325,588,556
3404-001,2015,2,8,13,288,269,557,588
3404-001,2015,2,8,14,302,332,634,557
3404-001,2015,2,8,15,381,306,687,634
3404-001,2015,2,8,16,363,303,666,687
3404-001,2015,2,8,17,363,316,679,666
3404-001,2015,2,8,18,434,344,778,679
3404-001,2015,2,8,19,267,281,548,778
3404-001,2015,2,8,20,210,227,437,548
3404-001,2015,2,8,21,166,187,353,437
3404-001,2015,2,8,22,133,173,306,353
3404-001,2015,2,8,23,72,150,222,306
3404-001,2015,2,8,24,65,89,154,222
3404-001,2015,2,9,1,36,43,79,154
3404-001,2015,2,9,2,20,30,50,79
3404-001,2015,2,9,3,14,41,55,50
3404-001,2015,2,9,4,22,33,55,55
3404-001,2015,2,9,5,34,48,82,55
3404-001,2015,2,9,6,87,228,315,82
3404-001,2015,2,9,7,170,598,768,315
3404-001,2015,2,9,8,489,1840,2329,768
3404-001,2015,2,9,9,615,1306,1921,2329
3404-001,2015,2,9,10,604,689,1293,1921
3404-001,2015,2,9,11,654,654,1308,1293
3404-001,2015,2,9,12,614,592,1206,1308
3404-001,2015,2,9,13,500,544,1044,1206
3404-001,2015,2,9,14,602,630,1232,1044
3404-001,2015,2,9,15,760,659,1419,1232
3404-001,2015,2,9,16,751,642,1393,1419
3404-001,2015,2,9,17,739,524,1263,1393
3404-001,2015,2,9,18,1039,506,1545,1263
3404-001,2015,2,9,19,846,417,1263,1545
3404-001,2015,2,9,20,639,366,1005,1263
3404-001,2015,2,9,21,643,200,843,1005
3404-001,2015,2,9,22,339,180,519,843
3404-001,2015,2,9,23,228,113,341,519
3404-001,2015,2,9,24,101,84,185,341
3404-001,2015,2,10,1,79,54,133,185
3404-001,2015,2,10,2,45,46,91,133
3404-001,2015,2,10,3,42,39,81,91
3404-001,2015,2,10,4,43,36,79,81
3404-001,2015,2,10,5,61,71,132,79
3404-001,2015,2,10,6,97,173,270,132
3404-001,2015,2,10,7,186,472,658,270
3404-001,2015,2,10,8,439,1650,2089,658
3404-001,2015,2,10,9,684,1278,1962,2089
3404-001,2015,2,10,10,694,684,1378,1962
3404-001,2015,2,10,11,712,687,1399,1378
3404-001,2015,2,10,12,639,656,1295,1399
3404-001,2015,2,10,13,563,559,1122,1295
3404-001,2015,2,10,14,649,645,1294,1122
3404-001,2015,2,10,15,785,718,1503,1294
3404-001,2015,2,10,16,773,640,1413,1503
3404-001,2015,2,10,17,763,612,1375,1413
3404-001,2015,2,10,18,1047,513,1560,1375
3404-001,2015,2,10,19,909,430,1339,1560
3404-001,2015,2,10,20,737,365,1102,1339
3404-001,2015,2,10,21,684,261,945,1102
3404-001,2015,2,10,22,373,205,578,945
3404-001,2015,2,10,23,228,141,369,578
3404-001,2015,2,10,24,114,85,199,369
3404-001,2015,2,11,1,68,61,129,199
3404-001,2015,2,11,2,59,65,124,129
3404-001,2015,2,11,3,45,47,92,124
3404-001,2015,2,11,4,31,44,75,92
3404-001,2015,2,11,5,58,65,123,75
3404-001,2015,2,11,6,84,188,272,123
3404-001,2015,2,11,7,175,470,645,272
3404-001,2015,2,11,8,483,1636,2119,645
3404-001,2015,2,11,9,710,1274,1984,2119
3404-001,2015,2,11,10,658,759,1417,1984
3404-001,2015,2,11,11,726,758,1484,1417
3404-001,2015,2,11,12,708,642,1350,1484
3404-001,2015,2,11,13,572,550,1122,1350
3404-001,2015,2,11,14,683,679,1362,1122
3404-001,2015,2,11,15,810,715,1525,1362
3404-001,2015,2,11,16,838,662,1500,1525
3404-001,2015,2,11,17,829,607,1436,1500
3404-001,2015,2,11,18,1186,543,1729,1436
3404-001,2015,2,11,19,1032,439,1471,1729
3404-001,2015,2,11,20,648,368,1016,1471
3404-001,2015,2,11,21,603,232,835,1016
3404-001,2015,2,11,22,337,194,531,835
3404-001,2015,2,11,23,188,142,330,531
3404-001,2015,2,11,24,131,102,233,330
3404-001,2015,2,12,1,77,85,162,233
3404-001,2015,2,12,2,63,60,123,162
3404-001,2015,2,12,3,42,34,76,123
3404-001,2015,2,12,4,36,36,72,76
3404-001,2015,2,12,5,68,77,145,72
3404-001,2015,2,12,6,116,174,290,145
3404-001,2015,2,12,7,205,489,694,290
3404-001,2015,2,12,8,442,1680,2122,694
3404-001,2015,2,12,9,729,1293,2022,2122
3404-001,2015,2,12,10,706,715,1421,2022
3404-001,2015,2,12,11,823,727,1550,1421
3404-001,2015,2,12,12,697,657,1354,1550
3404-001,2015,2,12,13,637,601,1238,1354
3404-001,2015,2,12,14,658,673,1331,1238
3404-001,2015,2,12,15,774,682,1456,1331
3404-001,2015,2,12,16,861,693,1554,1456
3404-001,2015,2,12,17,799,672,1471,1554
3404-001,2015,2,12,18,1101,564,1665,1471
3404-001,2015,2,12,19,973,473,1446,1665
3404-001,2015,2,12,20,687,401,1088,1446
3404-001,2015,2,12,21,648,231,879,1088
3404-001,2015,2,12,22,371,219,590,879
3404-001,2015,2,12,23,244,158,402,590
3404-001,2015,2,12,24,122,100,222,402
3404-001,2015,2,13,1,79,50,129,222
3404-001,2015,2,13,2,66,50,116,129
3404-001,2015,2,13,3,49,36,85,116
3404-001,2015,2,13,4,40,37,77,85
3404-001,2015,2,13,5,65,84,149,77
3404-001,2015,2,13,6,97,198,295,149
3404-001,2015,2,13,7,184,535,719,295
3404-001,2015,2,13,8,517,1690,2207,719
3404-001,2015,2,13,9,724,1237,1961,2207
3404-001,2015,2,13,10,688,752,1440,1961
3404-001,2015,2,13,11,817,759,1576,1440
3404-001,2015,2,13,12,748,660,1408,1576
3404-001,2015,2,13,13,634,633,1267,1408
3404-001,2015,2,13,14,725,736,1461,1267
3404-001,2015,2,13,15,856,734,1590,1461
3404-001,2015,2,13,16,827,760,1587,1590
3404-001,2015,2,13,17,874,636,1510,1587
3404-001,2015,2,13,18,1278,579,1857,1510
3404-001,2015,2,13,19,1215,563,1778,1857
3404-001,2015,2,13,20,806,425,1231,1778
3404-001,2015,2,13,21,672,292,964,1231
3404-001,2015,2,13,22,321,214,535,964
3404-001,2015,2,13,23,238,150,388,535
3404-001,2015,2,13,24,138,99,237,388
3404-001,2015,2,14,1,69,95,164,237
3404-001,2015,2,14,2,74,58,132,164
3404-001,2015,2,14,3,52,41,93,132
3404-001,2015,2,14,4,46,40,86,93
3404-001,2015,2,14,5,61,68,129,86
3404-001,2015,2,14,6,87,164,251,129
3404-001,2015,2,14,7,172,364,536,251
3404-001,2015,2,14,8,398,759,1157,536
3404-001,2015,2,14,9,534,757,1291,1157
3404-001,2015,2,14,10,572,611,1183,1291
3404-001,2015,2,14,11,607,626,1233,1183
3404-001,2015,2,14,12,599,554,1153,1233
3404-001,2015,2,14,13,605,536,1141,1153
3404-001,2015,2,14,14,601,557,1158,1141
3404-001,2015,2,14,15,599,530,1129,1158
3404-001,2015,2,14,16,562,510,1072,1129
3404-001,2015,2,14,17,663,408,1071,1072
3404-001,2015,2,14,18,880,447,1327,1071
3404-001,2015,2,14,19,533,348,881,1327
3404-001,2015,2,14,20,352,274,626,881
3404-001,2015,2,14,21,236,174,410,626
3404-001,2015,2,14,22,150,160,310,410
3404-001,2015,2,14,23,105,91,196,310
3404-001,2015,2,14,24,74,67,141,196
3404-001,2015,2,15,1,57,65,122,141
3404-001,2015,2,15,2,43,34,77,122
3404-001,2015,2,15,3,35,17,52,77
3404-001,2015,2,15,4,30,24,54,52
3404-001,2015,2,15,5,27,38,65,54
3404-001,2015,2,15,6,54,77,131,65
3404-001,2015,2,15,7,84,153,237,131
3404-001,2015,2,15,8,159,304,463,237
3404-001,2015,2,15,9,271,352,623,463
3404-001,2015,2,15,10,244,284,528,623
3404-001,2015,2,15,11,304,303,607,528
3404-001,2015,2,15,12,270,351,621,607
3404-001,2015,2,15,13,315,332,647,621
3404-001,2015,2,15,14,337,361,698,647
3404-001,2015,2,15,15,397,333,730,698
3404-001,2015,2,15,16,399,311,710,730
3404-001,2015,2,15,17,444,360,804,710
3404-001,2015,2,15,18,521,340,861,804
3404-001,2015,2,15,19,355,292,647,861
3404-001,2015,2,15,20,257,238,495,647
3404-001,2015,2,15,21,164,175,339,495
3404-001,2015,2,15,22,147,178,325,339
3404-001,2015,2,15,23,93,104,197,325
3404-001,2015,2,15,24,73,90,163,197
3404-001,2015,2,16,1,57,61,118,163
3404-001,2015,2,16,2,25,52,77,118
3404-001,2015,2,16,3,25,24,49,77
3404-001,2015,2,16,4,28,32,60,49
3404-001,2015,2,16,5,37,57,94,60
3404-001,2015,2,16,6,94,162,256,94
3404-001,2015,2,16,7,159,493,652,256
3404-001,2015,2,16,8,397,1753,2150,652
3404-001,2015,2,16,9,574,1221,1795,2150
3404-001,2015,2,16,10,605,624,1229,1795
3404-001,2015,2,16,11,678,646,1324,1229
3404-001,2015,2,16,12,666,629,1295,1324
3404-001,2015,2,16,13,619,582,1201,1295
3404-001,2015,2,16,14,684,673,1357,1201
3404-001,2015,2,16,15,762,694,1456,1357
3404-001,2015,2,16,16,783,642,1425,1456
3404-001,2015,2,16,17,767,606,1373,1425
3404-001,2015,2,16,18,1125,526,1651,1373
3404-001,2015,2,16,19,942,415,1357,1651
3404-001,2015,2,16,20,690,342,1032,1357
3404-001,2015,2,16,21,662,257,919,1032
3404-001,2015,2,16,22,377,206,583,919
3404-001,2015,2,16,23,214,138,352,583
3404-001,2015,2,16,24,135,108,243,352
3404-001,2015,2,17,1,82,69,151,243
3404-001,2015,2,17,2,88,63,151,151
3404-001,2015,2,17,3,47,35,82,151
3404-001,2015,2,17,4,31,41,72,82
3404-001,2015,2,17,5,53,71,124,72
3404-001,2015,2,17,6,85,155,240,124
3404-001,2015,2,17,7,152,391,543,240
3404-001,2015,2,17,8,378,1624,2002,543
3404-001,2015,2,17,9,585,1107,1692,2002
3404-001,2015,2,17,10,552,580,1132,1692
3404-001,2015,2,17,11,695,569,1264,1132
3404-001,2015,2,17,12,609,578,1187,1264
3404-001,2015,2,17,13,616,494,1110,1187
3404-001,2015,2,17,14,627,505,1132,1110
3404-001,2015,2,17,15,736,517,1253,1132
3404-001,2015,2,17,16,926,506,1432,1253
3404-001,2015,2,17,17,761,407,1168,1432
3404-001,2015,2,17,18,1229,450,1679,1168
3404-001,2015,2,17,19,724,397,1121,1679
3404-001,2015,2,17,20,436,316,752,1121
3404-001,2015,2,17,21,379,219,598,752
3404-001,2015,2,17,22,201,173,374,598
3404-001,2015,2,17,23,134,120,254,374
3404-001,2015,2,17,24,107,83,190,254
3404-001,2015,2,18,1,76,56,132,190
3404-001,2015,2,18,2,45,47,92,132
3404-001,2015,2,18,3,34,29,63,92
3404-001,2015,2,18,4,65,34,99,63
3404-001,2015,2,18,5,50,44,94,99
3404-001,2015,2,18,6,87,55,142,94
3404-001,2015,2,18,7,121,83,204,142
3404-001,2015,2,18,8,217,156,373,204
3404-001,2015,2,18,9,228,211,439,373
3404-001,2015,2,18,10,266,273,539,439
3404-001,2015,2,18,11,334,413,747,539
3404-001,2015,2,18,12,337,389,726,747
3404-001,2015,2,18,13,273,479,752,726
3404-001,2015,2,18,14,257,561,818,752
3404-001,2015,2,18,15,235,405,640,818
3404-001,2015,2,18,16,202,279,481,640
3404-001,2015,2,18,17,209,210,419,481
3404-001,2015,2,18,18,211,188,399,419
3404-001,2015,2,18,19,169,166,335,399
3404-001,2015,2,18,20,158,117,275,335
3404-001,2015,2,18,21,109,98,207,275
3404-001,2015,2,18,22,105,73,178,207
3404-001,2015,2,18,23,54,70,124,178
3404-001,2015,2,18,24,40,40,80,124
3404-001,2015,2,19,1,35,38,73,80
3404-001,2015,2,19,2,19,19,38,73
3404-001,2015,2,19,3,11,9,20,38
3404-001,2015,2,19,4,10,18,28,20
3404-001,2015,2,19,5,12,11,23,28
3404-001,2015,2,19,6,30,35,65,23
3404-001,2015,2,19,7,72,93,165,65
3404-001,2015,2,19,8,140,218,358,165
3404-001,2015,2,19,9,156,173,329,358
3404-001,2015,2,19,10,200,194,394,329
3404-001,2015,2,19,11,344,301,645,394
3404-001,2015,2,19,12,424,360,784,645
3404-001,2015,2,19,13,549,407,956,784
3404-001,2015,2,19,14,582,379,961,956
3404-001,2015,2,19,15,710,422,1132,961
3404-001,2015,2,19,16,779,417,1196,1132
3404-001,2015,2,19,17,635,331,966,1196
3404-001,2015,2,19,18,535,292,827,966
3404-001,2015,2,19,19,373,264,637,827
3404-001,2015,2,19,20,261,222,483,637
3404-001,2015,2,19,21,178,143,321,483
3404-001,2015,2,19,22,159,115,274,321
3404-001,2015,2,19,23,83,90,173,274
3404-001,2015,2,19,24,45,64,109,173
3404-001,2015,2,20,1,27,47,74,109
3404-001,2015,2,20,2,24,39,63,74
3404-001,2015,2,20,3,12,25,37,63
3404-001,2015,2,20,4,12,22,34,37
3404-001,2015,2,20,5,19,14,33,34
3404-001,2015,2,20,6,27,34,61,33
3404-001,2015,2,20,7,27,50,77,61
3404-001,2015,2,20,8,58,107,165,77
3404-001,2015,2,20,9,88,129,217,165
3404-001,2015,2,20,10,138,162,300,217
3404-001,2015,2,20,11,234,222,456,300
3404-001,2015,2,20,12,281,365,646,456
3404-001,2015,2,20,13,308,338,646,646
3404-001,2015,2,20,14,310,324,634,646
3404-001,2015,2,20,15,376,309,685,634
3404-001,2015,2,20,16,396,311,707,685
3404-001,2015,2,20,17,385,277,662,707
3404-001,2015,2,20,18,512,248,760,662
3404-001,2015,2,20,19,326,224,550,760
3404-001,2015,2,20,20,274,217,491,550
3404-001,2015,2,20,21,239,169,408,491
3404-001,2015,2,20,22,124,140,264,408
3404-001,2015,2,20,23,79,162,241,264
3404-001,2015,2,20,24,55,155,210,241
3404-001,2015,2,21,1,45,68,113,210
3404-001,2015,2,21,2,29,65,94,113
3404-001,2015,2,21,3,31,31,62,94
3404-001,2015,2,21,4,19,26,45,62
3404-001,2015,2,21,5,42,33,75,45
3404-001,2015,2,21,6,53,56,109,75
3404-001,2015,2,21,7,63,80,143,109
3404-001,2015,2,21,8,105,216,321,143
3404-001,2015,2,21,9,191,264,455,321
3404-001,2015,2,21,10,213,228,441,455
3404-001,2015,2,21,11,254,286,540,441
3404-001,2015,2,21,12,294,283,577,540
3404-001,2015,2,21,13,292,266,558,577
3404-001,2015,2,21,14,328,300,628,558
3404-001,2015,2,21,15,347,281,628,628
3404-001,2015,2,21,16,348,265,613,628
3404-001,2015,2,21,17,365,239,604,613
3404-001,2015,2,21,18,346,254,600,604
3404-001,2015,2,21,19,261,223,484,600
3404-001,2015,2,21,20,156,237,393,484
3404-001,2015,2,21,21,164,176,340,393
3404-001,2015,2,21,22,104,115,219,340
3404-001,2015,2,21,23,62,112,174,219
3404-001,2015,2,21,24,51,65,116,174
3404-001,2015,2,22,1,29,46,75,116
3404-001,2015,2,22,2,25,47,72,75
3404-001,2015,2,22,3,17,16,33,72
3404-001,2015,2,22,4,11,22,33,33
3404-001,2015,2,22,5,19,18,37,33
3404-001,2015,2,22,6,28,36,64,37
3404-001,2015,2,22,7,45,63,108,64
3404-001,2015,2,22,8,82,222,304,108
3404-001,2015,2,22,9,147,229,376,304
3404-001,2015,2,22,10,160,191,351,376
3404-001,2015,2,22,11,212,224,436,351
3404-001,2015,2,22,12,220,252,472,436
3404-001,2015,2,22,13,288,268,556,472
3404-001,2015,2,22,14,247,274,521,556
3404-001,2015,2,22,15,347,318,665,521
3404-001,2015,2,22,16,318,278,596,665
3404-001,2015,2,22,17,333,316,649,596
3404-001,2015,2,22,18,361,278,639,649
3404-001,2015,2,22,19,262,255,517,639
3404-001,2015,2,22,20,203,266,469,517
3404-001,2015,2,22,21,203,199,402,469
3404-001,2015,2,22,22,120,176,296,402
3404-001,2015,2,22,23,79,178,257,296
3404-001,2015,2,22,24,50,90,140,257
3404-001,2015,2,23,1,30,84,114,140
3404-001,2015,2,23,2,19,44,63,114
3404-001,2015,2,23,3,26,35,61,63
3404-001,2015,2,23,4,21,44,65,61
3404-001,2015,2,23,5,34,63,97,65
3404-001,2015,2,23,6,94,219,313,97
3404-001,2015,2,23,7,190,556,746,313
3404-001,2015,2,23,8,447,1898,2345,746
3404-001,2015,2,23,9,595,1218,1813,2345
3404-001,2015,2,23,10,579,591,1170,1813
3404-001,2015,2,23,11,620,610,1230,1170
3404-001,2015,2,23,12,556,573,1129,1230
3404-001,2015,2,23,13,517,495,1012,1129
3404-001,2015,2,23,14,609,613,1222,1012
3404-001,2015,2,23,15,658,641,1299,1222
3404-001,2015,2,23,16,689,608,1297,1299
3404-001,2015,2,23,17,698,537,1235,1297
3404-001,2015,2,23,18,1051,536,1587,1235
3404-001,2015,2,23,19,920,417,1337,1587
3404-001,2015,2,23,20,665,353,1018,1337
3404-001,2015,2,23,21,648,218,866,1018
3404-001,2015,2,23,22,381,194,575,866
3404-001,2015,2,23,23,226,135,361,575
3404-001,2015,2,23,24,108,96,204,361
3404-001,2015,2,24,1,66,63,129,204
3404-001,2015,2,24,2,49,63,112,129
3404-001,2015,2,24,3,40,37,77,112
3404-001,2015,2,24,4,41,42,83,77
3404-001,2015,2,24,5,64,78,142,83
3404-001,2015,2,24,6,86,199,285,142
3404-001,2015,2,24,7,196,447,643,285
3404-001,2015,2,24,8,486,1719,2205,643
3404-001,2015,2,24,9,743,1241,1984,2205
3404-001,2015,2,24,10,673,712,1385,1984
3404-001,2015,2,24,11,682,750,1432,1385
3404-001,2015,2,24,12,700,651,1351,1432
3404-001,2015,2,24,13,591,576,1167,1351
3404-001,2015,2,24,14,649,639,1288,1167
3404-001,2015,2,24,15,750,778,1528,1288
3404-001,2015,2,24,16,721,647,1368,1528
3404-001,2015,2,24,17,756,618,1374,1368
3404-001,2015,2,24,18,1123,547,1670,1374
3404-001,2015,2,24,19,948,444,1392,1670
3404-001,2015,2,24,20,662,396,1058,1392
3404-001,2015,2,24,21,684,274,958,1058
3404-001,2015,2,24,22,402,209,611,958
3404-001,2015,2,24,23,232,142,374,611
3404-001,2015,2,24,24,128,97,225,374
3404-001,2015,2,25,1,77,71,148,225
3404-001,2015,2,25,2,77,43,120,148
3404-001,2015,2,25,3,38,28,66,120
3404-001,2015,2,25,4,54,50,104,66
3404-001,2015,2,25,5,58,61,119,104
3404-001,2015,2,25,6,125,185,310,119
3404-001,2015,2,25,7,200,478,678,310
3404-001,2015,2,25,8,471,1686,2157,678
3404-001,2015,2,25,9,748,1293,2041,2157
3404-001,2015,2,25,10,685,697,1382,2041
3404-001,2015,2,25,11,720,694,1414,1382
3404-001,2015,2,25,12,667,647,1314,1414
3404-001,2015,2,25,13,594,602,1196,1314
3404-001,2015,2,25,14,621,628,1249,1196
3404-001,2015,2,25,15,783,699,1482,1249
3404-001,2015,2,25,16,783,637,1420,1482
3404-001,2015,2,25,17,818,645,1463,1420
3404-001,2015,2,25,18,1151,515,1666,1463
3404-001,2015,2,25,19,970,451,1421,1666
3404-001,2015,2,25,20,677,379,1056,1421
3404-001,2015,2,25,21,583,257,840,1056
3404-001,2015,2,25,22,370,215,585,840
3404-001,2015,2,25,23,216,150,366,585
3404-001,2015,2,25,24,120,87,207,366
3404-001,2015,2,26,1,76,62,138,207
3404-001,2015,2,26,2,63,62,125,138
3404-001,2015,2,26,3,35,37,72,125
3404-001,2015,2,26,4,51,40,91,72
3404-001,2015,2,26,5,66,68,134,91
3404-001,2015,2,26,6,108,189,297,134
3404-001,2015,2,26,7,174,466,640,297
3404-001,2015,2,26,8,442,1644,2086,640
3404-001,2015,2,26,9,717,1256,1973,2086
3404-001,2015,2,26,10,625,656,1281,1973
3404-001,2015,2,26,11,734,653,1387,1281
3404-001,2015,2,26,12,608,673,1281,1387
3404-001,2015,2,26,13,545,562,1107,1281
3404-001,2015,2,26,14,606,705,1311,1107
3404-001,2015,2,26,15,779,723,1502,1311
3404-001,2015,2,26,16,779,605,1384,1502
3404-001,2015,2,26,17,823,558,1381,1384
3404-001,2015,2,26,18,1034,579,1613,1381
3404-001,2015,2,26,19,951,434,1385,1613
3404-001,2015,2,26,20,670,349,1019,1385
3404-001,2015,2,26,21,667,244,911,1019
3404-001,2015,2,26,22,328,212,540,911
3404-001,2015,2,26,23,235,138,373,540
3404-001,2015,2,26,24,133,112,245,373
3404-001,2015,2,27,1,85,69,154,245
3404-001,2015,2,27,2,59,56,115,154
3404-001,2015,2,27,3,26,37,63,115
3404-001,2015,2,27,4,43,54,97,63
3404-001,2015,2,27,5,60,71,131,97
3404-001,2015,2,27,6,95,196,291,131
3404-001,2015,2,27,7,179,484,663,291
3404-001,2015,2,27,8,449,1687,2136,663
3404-001,2015,2,27,9,720,1191,1911,2136
3404-001,2015,2,27,10,626,662,1288,1911
3404-001,2015,2,27,11,723,654,1377,1288
3404-001,2015,2,27,12,669,657,1326,1377
3404-001,2015,2,27,13,583,515,1098,1326
3404-001,2015,2,27,14,618,614,1232,1098
3404-001,2015,2,27,15,749,746,1495,1232
3404-001,2015,2,27,16,716,602,1318,1495
3404-001,2015,2,27,17,836,539,1375,1318
3404-001,2015,2,27,18,1251,527,1778,1375
3404-001,2015,2,27,19,1091,549,1640,1778
3404-001,2015,2,27,20,766,438,1204,1640
3404-001,2015,2,27,21,607,275,882,1204
3404-001,2015,2,27,22,366,198,564,882
3404-001,2015,2,27,23,203,138,341,564
3404-001,2015,2,27,24,135,103,238,341
3404-001,2015,2,28,1,96,93,189,238
3404-001,2015,2,28,2,60,56,116,189
3404-001,2015,2,28,3,48,32,80,116
3404-001,2015,2,28,4,39,44,83,80
3404-001,2015,2,28,5,70,65,135,83
3404-001,2015,2,28,6,93,153,246,135
3404-001,2015,2,28,7,165,304,469,246
3404-001,2015,2,28,8,319,751,1070,469
3404-001,2015,2,28,9,476,692,1168,1070
3404-001,2015,2,28,10,510,588,1098,1168
3404-001,2015,2,28,11,572,520,1092,1098
3404-001,2015,2,28,12,521,497,1018,1092
3404-001,2015,2,28,13,517,442,959,1018
3404-001,2015,2,28,14,525,508,1033,959
3404-001,2015,2,28,15,548,497,1045,1033
3404-001,2015,2,28,16,595,431,1026,1045
3404-001,2015,2,28,17,627,449,1076,1026
3404-001,2015,2,28,18,873,389,1262,1076
3404-001,2015,2,28,19,600,366,966,1262
3404-001,2015,2,28,20,288,273,561,966
3404-001,2015,2,28,21,257,185,442,561
3404-001,2015,2,28,22,158,161,319,442
3404-001,2015,2,28,23,115,129,244,319
3404-001,2015,2,28,24,71,69,140,244
3404-001,2015,3,1,1,56,49,105,140
3404-001,2015,3,1,2,38,35,73,105
3404-001,2015,3,1,3,39,26,65,73
3404-001,2015,3,1,4,26,21,47,65
3404-001,2015,3,1,5,30,20,50,47
3404-001,2015,3,1,6,41,52,93,50
3404-001,2015,3,1,7,59,108,167,93
3404-001,2015,3,1,8,149,236,385,167
3404-001,2015,3,1,9,193,255,448,385
3404-001,2015,3,1,10,230,237,467,448
3404-001,2015,3,1,11,289,268,557,467
3404-001,2015,3,1,12,298,299,597,557
3404-001,2015,3,1,13,295,321,616,597
3404-001,2015,3,1,14,334,336,670,616
3404-001,2015,3,1,15,367,381,748,670
3404-001,2015,3,1,16,434,347,781,748
3404-001,2015,3,1,17,470,323,793,781
3404-001,2015,3,1,18,442,321,763,793
3404-001,2015,3,1,19,325,292,617,763
3404-001,2015,3,1,20,228,278,506,617
3404-001,2015,3,1,21,189,214,403,506
3404-001,2015,3,1,22,147,217,364,403
3404-001,2015,3,1,23,101,155,256,364
3404-001,2015,3,1,24,44,95,139,256
3404-001,2015,3,2,1,35,79,114,139
3404-001,2015,3,2,2,22,42,64,114
3404-001,2015,3,2,3,8,33,41,64
3404-001,2015,3,2,4,29,31,60,41
3404-001,2015,3,2,5,44,60,104,60
3404-001,2015,3,2,6,107,230,337,104
3404-001,2015,3,2,7,212,610,822,337
3404-001,2015,3,2,8,533,1841,2374,822
3404-001,2015,3,2,9,650,1292,1942,2374
3404-001,2015,3,2,10,646,710,1356,1942
3404-001,2015,3,2,11,671,702,1373,1356
3404-001,2015,3,2,12,645,638,1283,1373
3404-001,2015,3,2,13,555,575,1130,1283
3404-001,2015,3,2,14,650,666,1316,1130
3404-001,2015,3,2,15,737,707,1444,1316
3404-001,2015,3,2,16,746,689,1435,1444
3404-001,2015,3,2,17,753,528,1281,1435
3404-001,2015,3,2,18,1012,496,1508,1281
3404-001,2015,3,2,19,876,431,1307,1508
3404-001,2015,3,2,20,653,344,997,1307
3404-001,2015,3,2,21,677,237,914,997
3404-001,2015,3,2,22,358,184,542,914
3404-001,2015,3,2,23,209,123,332,542
3404-001,2015,3,2,24,118,99,217,332
3404-001,2015,3,3,1,63,59,122,217
3404-001,2015,3,3,2,45,36,81,122
3404-001,2015,3,3,3,33,41,74,81
3404-001,2015,3,3,4,36,47,83,74
3404-001,2015,3,3,5,38,57,95,83
3404-001,2015,3,3,6,95,189,284,95
3404-001,2015,3,3,7,193,497,690,284
3404-001,2015,3,3,8,477,1754,2231,690
3404-001,2015,3,3,9,657,1190,1847,2231
3404-001,2015,3,3,10,690,703,1393,1847
3404-001,2015,3,3,11,709,668,1377,1393
3404-001,2015,3,3,12,631,666,1297,1377
3404-001,2015,3,3,13,532,586,1118,1297
3404-001,2015,3,3,14,625,640,1265,1118
3404-001,2015,3,3,15,769,712,1481,1265
3404-001,2015,3,3,16,709,636,1345,1481
3404-001,2015,3,3,17,759,541,1300,1345
3404-001,2015,3,3,18,993,490,1483,1300
3404-001,2015,3,3,19,872,397,1269,1483
3404-001,2015,3,3,20,733,301,1034,1269
3404-001,2015,3,3,21,627,248,875,1034
3404-001,2015,3,3,22,312,195,507,875
3404-001,2015,3,3,23,191,121,312,507
3404-001,2015,3,3,24,114,84,198,312
3404-001,2015,3,4,1,69,84,153,198
3404-001,2015,3,4,2,60,41,101,153
3404-001,2015,3,4,3,41,43,84,101
3404-001,2015,3,4,4,34,36,70,84
3404-001,2015,3,4,5,50,59,109,70
3404-001,2015,3,4,6,96,183,279,109
3404-001,2015,3,4,7,210,480,690,279
3404-001,2015,3,4,8,462,1704,2166,690
3404-001,2015,3,4,9,692,1239,1931,2166
3404-001,2015,3,4,10,648,677,1325,1931
3404-001,2015,3,4,11,662,650,1312,1325
3404-001,2015,3,4,12,662,590,1252,1312
3404-001,2015,3,4,13,523,509,1032,1252
3404-001,2015,3,4,14,644,641,1285,1032
3404-001,2015,3,4,15,711,673,1384,1285
3404-001,2015,3,4,16,689,587,1276,1384
3404-001,2015,3,4,17,765,525,1290,1276
3404-001,2015,3,4,18,1167,502,1669,1290
3404-001,2015,3,4,19,976,471,1447,1669
3404-001,2015,3,4,20,636,332,968,1447
3404-001,2015,3,4,21,592,230,822,968
3404-001,2015,3,4,22,340,201,541,822
3404-001,2015,3,4,23,184,146,330,541
3404-001,2015,3,4,24,122,82,204,330
3404-001,2015,3,5,1,76,57,133,204
3404-001,2015,3,5,2,62,43,105,133
3404-001,2015,3,5,3,45,27,72,105
3404-001,2015,3,5,4,36,34,70,72
3404-001,2015,3,5,5,43,65,108,70
3404-001,2015,3,5,6,99,187,286,108
3404-001,2015,3,5,7,202,492,694,286
3404-001,2015,3,5,8,483,1668,2151,694
3404-001,2015,3,5,9,716,1269,1985,2151
3404-001,2015,3,5,10,653,739,1392,1985
3404-001,2015,3,5,11,722,721,1443,1392
3404-001,2015,3,5,12,710,688,1398,1443
3404-001,2015,3,5,13,592,558,1150,1398
3404-001,2015,3,5,14,677,666,1343,1150
3404-001,2015,3,5,15,731,711,1442,1343
3404-001,2015,3,5,16,788,627,1415,1442
3404-001,2015,3,5,17,783,530,1313,1415
3404-001,2015,3,5,18,1041,545,1586,1313
3404-001,2015,3,5,19,940,471,1411,1586
3404-001,2015,3,5,20,728,371,1099,1411
3404-001,2015,3,5,21,656,249,905,1099
3404-001,2015,3,5,22,376,186,562,905
3404-001,2015,3,5,23,199,171,370,562
3404-001,2015,3,5,24,108,111,219,370
3404-001,2015,3,6,1,89,62,151,219
3404-001,2015,3,6,2,63,46,109,151
3404-001,2015,3,6,3,40,36,76,109
3404-001,2015,3,6,4,37,51,88,76
3404-001,2015,3,6,5,72,66,138,88
3404-001,2015,3,6,6,112,208,320,138
3404-001,2015,3,6,7,183,548,731,320
3404-001,2015,3,6,8,493,1749,2242,731
3404-001,2015,3,6,9,742,1247,1989,2242
3404-001,2015,3,6,10,692,772,1464,1989
3404-001,2015,3,6,11,765,686,1451,1464
3404-001,2015,3,6,12,675,635,1310,1451
3404-001,2015,3,6,13,578,578,1156,1310
3404-001,2015,3,6,14,681,630,1311,1156
3404-001,2015,3,6,15,647,709,1356,1311
3404-001,2015,3,6,16,917,613,1530,1356
3404-001,2015,3,6,17,826,561,1387,1530
3404-001,2015,3,6,18,1289,539,1828,1387
3404-001,2015,3,6,19,1237,485,1722,1828
3404-001,2015,3,6,20,883,393,1276,1722
3404-001,2015,3,6,21,574,278,852,1276
3404-001,2015,3,6,22,356,176,532,852
3404-001,2015,3,6,23,195,155,350,532
3404-001,2015,3,6,24,139,109,248,350
3404-001,2015,3,7,1,94,72,166,248
3404-001,2015,3,7,2,73,41,114,166
3404-001,2015,3,7,3,43,41,84,114
3404-001,2015,3,7,4,59,43,102,84
3404-001,2015,3,7,5,62,58,120,102
3404-001,2015,3,7,6,101,156,257,120
3404-001,2015,3,7,7,169,334,503,257
3404-001,2015,3,7,8,347,769,1116,503
3404-001,2015,3,7,9,518,704,1222,1116
3404-001,2015,3,7,10,535,592,1127,1222
3404-001,2015,3,7,11,569,582,1151,1127
3404-001,2015,3,7,12,558,599,1157,1151
3404-001,2015,3,7,13,464,530,994,1157
3404-001,2015,3,7,14,551,486,1037,994
3404-001,2015,3,7,15,552,522,1074,1037
3404-001,2015,3,7,16,638,489,1127,1074
3404-001,2015,3,7,17,683,390,1073,1127
3404-001,2015,3,7,18,857,442,1299,1073
3404-001,2015,3,7,19,588,406,994,1299
3404-001,2015,3,7,20,369,300,669,994
3404-001,2015,3,7,21,262,177,439,669
3404-001,2015,3,7,22,182,129,311,439
3404-001,2015,3,7,23,116,82,198,311
3404-001,2015,3,7,24,69,73,142,198
3404-001,2015,3,8,1,43,46,89,142
3404-001,2015,3,8,2,32,36,68,89
3404-001,2015,3,8,3,27,22,49,68
3404-001,2015,3,8,4,28,20,48,49
3404-001,2015,3,8,5,30,23,53,48
3404-001,2015,3,8,6,42,63,105,53
3404-001,2015,3,8,7,60,164,224,105
3404-001,2015,3,8,8,168,265,433,224
3404-001,2015,3,8,9,272,270,542,433
3404-001,2015,3,8,10,247,267,514,542
3404-001,2015,3,8,11,306,333,639,514
3404-001,2015,3,8,12,300,406,706,639
3404-001,2015,3,8,13,316,361,677,706
3404-001,2015,3,8,14,338,402,740,677
3404-001,2015,3,8,15,407,398,805,740
3404-001,2015,3,8,16,452,414,866,805
3404-001,2015,3,8,17,534,376,910,866
3404-001,2015,3,8,18,617,312,929,910
3404-001,2015,3,8,19,443,301,744,929
3404-001,2015,3,8,20,261,255,516,744
3404-001,2015,3,8,21,202,215,417,516
3404-001,2015,3,8,22,132,195,327,417
3404-001,2015,3,8,23,91,160,251,327
3404-001,2015,3,8,24,54,107,161,251
3404-001,2015,3,9,1,46,60,106,161
3404-001,2015,3,9,2,24,45,69,106
3404-001,2015,3,9,3,18,29,47,69
3404-001,2015,3,9,4,19,39,58,47
3404-001,2015,3,9,5,39,65,104,58
3404-001,2015,3,9,6,118,250,368,104
3404-001,2015,3,9,7,226,630,856,368
3404-001,2015,3,9,8,482,1958,2440,856
3404-001,2015,3,9,9,691,1285,1976,2440
3404-001,2015,3,9,10,608,690,1298,1976
3404-001,2015,3,9,11,636,674,1310,1298
3404-001,2015,3,9,12,637,606,1243,1310
3404-001,2015,3,9,13,567,556,1123,1243
3404-001,2015,3,9,14,647,673,1320,1123
3404-001,2015,3,9,15,738,670,1408,1320
3404-001,2015,3,9,16,733,674,1407,1408
3404-001,2015,3,9,17,792,577,1369,1407
3404-001,2015,3,9,18,1031,533,1564,1369
3404-001,2015,3,9,19,998,435,1433,1564
3404-001,2015,3,9,20,721,366,1087,1433
3404-001,2015,3,9,21,682,230,912,1087
3404-001,2015,3,9,22,403,229,632,912
3404-001,2015,3,9,23,187,139,326,632
3404-001,2015,3,9,24,132,85,217,326
3404-001,2015,3,10,1,91,68,159,217
3404-001,2015,3,10,2,61,29,90,159
3404-001,2015,3,10,3,35,47,82,90
3404-001,2015,3,10,4,36,45,81,82
3404-001,2015,3,10,5,73,72,145,81
3404-001,2015,3,10,6,109,182,291,145
3404-001,2015,3,10,7,195,559,754,291
3404-001,2015,3,10,8,481,1746,2227,754
3404-001,2015,3,10,9,765,1244,2009,2227
3404-001,2015,3,10,10,683,720,1403,2009
3404-001,2015,3,10,11,710,694,1404,1403
3404-001,2015,3,10,12,647,673,1320,1404
3404-001,2015,3,10,13,627,537,1164,1320
3404-001,2015,3,10,14,637,687,1324,1164
3404-001,2015,3,10,15,764,683,1447,1324
3404-001,2015,3,10,16,790,680,1470,1447
3404-001,2015,3,10,17,792,578,1370,1470
3404-001,2015,3,10,18,1049,488,1537,1370
3404-001,2015,3,10,19,962,408,1370,1537
3404-001,2015,3,10,20,666,399,1065,1370
3404-001,2015,3,10,21,668,234,902,1065
3404-001,2015,3,10,22,407,202,609,902
3404-001,2015,3,10,23,224,124,348,609
3404-001,2015,3,10,24,103,117,220,348
3404-001,2015,3,11,1,65,54,119,220
3404-001,2015,3,11,2,55,39,94,119
3404-001,2015,3,11,3,34,45,79,94
3404-001,2015,3,11,4,29,45,74,79
3404-001,2015,3,11,5,50,68,118,74
3404-001,2015,3,11,6,102,177,279,118
3404-001,2015,3,11,7,197,502,699,279
3404-001,2015,3,11,8,528,1738,2266,699
3404-001,2015,3,11,9,775,1308,2083,2266
3404-001,2015,3,11,10,647,701,1348,2083
3404-001,2015,3,11,11,665,696,1361,1348
3404-001,2015,3,11,12,659,643,1302,1361
3404-001,2015,3,11,13,561,538,1099,1302
3404-001,2015,3,11,14,651,641,1292,1099
3404-001,2015,3,11,15,751,719,1470,1292
3404-001,2015,3,11,16,745,614,1359,1470
3404-001,2015,3,11,17,782,531,1313,1359
3404-001,2015,3,11,18,1118,533,1651,1313
3404-001,2015,3,11,19,989,446,1435,1651
3404-001,2015,3,11,20,702,329,1031,1435
3404-001,2015,3,11,21,571,218,789,1031
3404-001,2015,3,11,22,339,169,508,789
3404-001,2015,3,11,23,194,150,344,508
3404-001,2015,3,11,24,120,85,205,344
3404-001,2015,3,12,1,54,62,116,205
3404-001,2015,3,12,2,58,51,109,116
3404-001,2015,3,12,3,41,33,74,109
3404-001,2015,3,12,4,30,45,75,74
3404-001,2015,3,12,5,61,53,114,75
3404-001,2015,3,12,6,97,216,313,114
3404-001,2015,3,12,7,176,546,722,313
3404-001,2015,3,12,8,479,1677,2156,722
3404-001,2015,3,12,9,710,1331,2041,2156
3404-001,2015,3,12,10,625,717,1342,2041
3404-001,2015,3,12,11,667,691,1358,1342
3404-001,2015,3,12,12,648,648,1296,1358
3404-001,2015,3,12,13,592,541,1133,1296
3404-001,2015,3,12,14,653,650,1303,1133
3404-001,2015,3,12,15,769,611,1380,1303
3404-001,2015,3,12,16,753,601,1354,1380
3404-001,2015,3,12,17,824,584,1408,1354
3404-001,2015,3,12,18,1077,515,1592,1408
3404-001,2015,3,12,19,999,482,1481,1592
3404-001,2015,3,12,20,714,365,1079,1481
3404-001,2015,3,12,21,688,287,975,1079
3404-001,2015,3,12,22,334,204,538,975
3404-001,2015,3,12,23,188,133,321,538
3404-001,2015,3,12,24,121,94,215,321
3404-001,2015,3,13,1,96,77,173,215
3404-001,2015,3,13,2,59,54,113,173
3404-001,2015,3,13,3,47,45,92,113
3404-001,2015,3,13,4,40,41,81,92
3404-001,2015,3,13,5,54,56,110,81
3404-001,2015,3,13,6,89,183,272,110
3404-001,2015,3,13,7,189,476,665,272
3404-001,2015,3,13,8,479,1653,2132,665
3404-001,2015,3,13,9,703,1241,1944,2132
3404-001,2015,3,13,10,683,709,1392,1944
3404-001,2015,3,13,11,685,677,1362,1392
3404-001,2015,3,13,12,666,637,1303,1362
3404-001,2015,3,13,13,639,554,1193,1303
3404-001,2015,3,13,14,646,676,1322,1193
3404-001,2015,3,13,15,747,685,1432,1322
3404-001,2015,3,13,16,833,663,1496,1432
3404-001,2015,3,13,17,781,555,1336,1496
3404-001,2015,3,13,18,1217,538,1755,1336
3404-001,2015,3,13,19,1280,577,1857,1755
3404-001,2015,3,13,20,880,435,1315,1857
3404-001,2015,3,13,21,656,286,942,1315
3404-001,2015,3,13,22,351,210,561,942
3404-001,2015,3,13,23,187,129,316,561
3404-001,2015,3,13,24,127,98,225,316
3404-001,2015,3,14,1,84,70,154,225
3404-001,2015,3,14,2,69,54,123,154
3404-001,2015,3,14,3,46,47,93,123
3404-001,2015,3,14,4,30,34,64,93
3404-001,2015,3,14,5,63,59,122,64
3404-001,2015,3,14,6,103,169,272,122
3404-001,2015,3,14,7,180,344,524,272
3404-001,2015,3,14,8,361,752,1113,524
3404-001,2015,3,14,9,520,654,1174,1113
3404-001,2015,3,14,10,494,556,1050,1174
3404-001,2015,3,14,11,602,541,1143,1050
3404-001,2015,3,14,12,535,552,1087,1143
3404-001,2015,3,14,13,457,479,936,1087
3404-001,2015,3,14,14,497,487,984,936
3404-001,2015,3,14,15,542,511,1053,984
3404-001,2015,3,14,16,637,460,1097,1053
3404-001,2015,3,14,17,729,421,1150,1097
3404-001,2015,3,14,18,887,422,1309,1150
3404-001,2015,3,14,19,578,376,954,1309
3404-001,2015,3,14,20,313,321,634,954
3404-001,2015,3,14,21,236,220,456,634
3404-001,2015,3,14,22,183,146,329,456
3404-001,2015,3,14,23,114,108,222,329
3404-001,2015,3,14,24,73,75,148,222
3404-001,2015,3,15,1,44,58,102,148
3404-001,2015,3,15,2,38,54,92,102
3404-001,2015,3,15,3,29,20,49,92
3404-001,2015,3,15,4,22,22,44,49
3404-001,2015,3,15,5,20,32,52,44
3404-001,2015,3,15,6,49,84,133,52
3404-001,2015,3,15,7,75,161,236,133
3404-001,2015,3,15,8,148,299,447,236
3404-001,2015,3,15,9,242,261,503,447
3404-001,2015,3,15,10,207,271,478,503
3404-001,2015,3,15,11,299,347,646,478
3404-001,2015,3,15,12,282,372,654,646
3404-001,2015,3,15,13,353,354,707,654
3404-001,2015,3,15,14,364,371,735,707
3404-001,2015,3,15,15,416,346,762,735
3404-001,2015,3,15,16,460,376,836,762
3404-001,2015,3,15,17,544,377,921,836
3404-001,2015,3,15,18,629,336,965,921
3404-001,2015,3,15,19,395,331,726,965
3404-001,2015,3,15,20,295,296,591,726
3404-001,2015,3,15,21,229,229,458,591
3404-001,2015,3,15,22,149,210,359,458
3404-001,2015,3,15,23,96,164,260,359
3404-001,2015,3,15,24,51,112,163,260
3404-001,2015,3,16,1,45,61,106,163
3404-001,2015,3,16,2,25,46,71,106
3404-001,2015,3,16,3,19,36,55,71
3404-001,2015,3,16,4,20,38,58,55
3404-001,2015,3,16,5,43,66,109,58
3404-001,2015,3,16,6,103,230,333,109
3404-001,2015,3,16,7,219,678,897,333
3404-001,2015,3,16,8,506,1927,2433,897
3404-001,2015,3,16,9,657,1297,1954,2433
3404-001,2015,3,16,10,638,703,1341,1954
3404-001,2015,3,16,11,658,683,1341,1341
3404-001,2015,3,16,12,621,658,1279,1341
3404-001,2015,3,16,13,537,518,1055,1279
3404-001,2015,3,16,14,671,688,1359,1055
3404-001,2015,3,16,15,705,689,1394,1359
3404-001,2015,3,16,16,787,627,1414,1394
3404-001,2015,3,16,17,755,609,1364,1414
3404-001,2015,3,16,18,1073,542,1615,1364
3404-001,2015,3,16,19,1001,461,1462,1615
3404-001,2015,3,16,20,765,363,1128,1462
3404-001,2015,3,16,21,700,255,955,1128
3404-001,2015,3,16,22,400,209,609,955
3404-001,2015,3,16,23,216,139,355,609
3404-001,2015,3,16,24,128,92,220,355
3404-001,2015,3,17,1,72,79,151,220
3404-001,2015,3,17,2,52,49,101,151
3404-001,2015,3,17,3,35,37,72,101
3404-001,2015,3,17,4,34,37,71,72
3404-001,2015,3,17,5,59,73,132,71
3404-001,2015,3,17,6,107,206,313,132
3404-001,2015,3,17,7,228,599,827,313
3404-001,2015,3,17,8,485,1798,2283,827
3404-001,2015,3,17,9,738,1240,1978,2283
3404-001,2015,3,17,10,701,764,1465,1978
3404-001,2015,3,17,11,664,706,1370,1465
3404-001,2015,3,17,12,657,610,1267,1370
3404-001,2015,3,17,13,577,595,1172,1267
3404-001,2015,3,17,14,695,692,1387,1172
3404-001,2015,3,17,15,784,716,1500,1387
3404-001,2015,3,17,16,768,652,1420,1500
3404-001,2015,3,17,17,809,543,1352,1420
3404-001,2015,3,17,18,1081,512,1593,1352
3404-001,2015,3,17,19,1020,454,1474,1593
3404-001,2015,3,17,20,729,340,1069,1474
3404-001,2015,3,17,21,619,244,863,1069
3404-001,2015,3,17,22,362,211,573,863
3404-001,2015,3,17,23,223,141,364,573
3404-001,2015,3,17,24,129,110,239,364
3404-001,2015,3,18,1,71,65,136,239
3404-001,2015,3,18,2,63,56,119,136
3404-001,2015,3,18,3,45,48,93,119
3404-001,2015,3,18,4,39,56,95,93
3404-001,2015,3,18,5,62,68,130,95
3404-001,2015,3,18,6,112,183,295,130
3404-001,2015,3,18,7,192,505,697,295
3404-001,2015,3,18,8,442,1618,2060,697
3404-001,2015,3,18,9,688,1223,1911,2060
3404-001,2015,3,18,10,627,679,1306,1911
3404-001,2015,3,18,11,642,665,1307,1306
3404-001,2015,3,18,12,618,580,1198,1307
3404-001,2015,3,18,13,529,515,1044,1198
3404-001,2015,3,18,14,616,566,1182,1044
3404-001,2015,3,18,15,711,654,1365,1182
3404-001,2015,3,18,16,706,563,1269,1365
3404-001,2015,3,18,17,707,501,1208,1269
3404-001,2015,3,18,18,1050,477,1527,1208
3404-001,2015,3,18,19,952,427,1379,1527
3404-001,2015,3,18,20,667,303,970,1379
3404-001,2015,3,18,21,504,239,743,970
3404-001,2015,3,18,22,337,196,533,743
3404-001,2015,3,18,23,214,146,360,533
3404-001,2015,3,18,24,97,101,198,360
3404-001,2015,3,19,1,65,66,131,198
3404-001,2015,3,19,2,59,45,104,131
3404-001,2015,3,19,3,44,38,82,104
3404-001,2015,3,19,4,35,37,72,82
3404-001,2015,3,19,5,52,68,120,72
3404-001,2015,3,19,6,98,209,307,120
3404-001,2015,3,19,7,198,480,678,307
3404-001,2015,3,19,8,442,1687,2129,678
3404-001,2015,3,19,9,673,1208,1881,2129
3404-001,2015,3,19,10,667,720,1387,1881
3404-001,2015,3,19,11,674,685,1359,1387
3404-001,2015,3,19,12,640,597,1237,1359
3404-001,2015,3,19,13,544,524,1068,1237
3404-001,2015,3,19,14,649,615,1264,1068
3404-001,2015,3,19,15,757,721,1478,1264
3404-001,2015,3,19,16,718,687,1405,1478
3404-001,2015,3,19,17,812,533,1345,1405
3404-001,2015,3,19,18,1082,555,1637,1345
3404-001,2015,3,19,19,1042,442,1484,1637
3404-001,2015,3,19,20,723,394,1117,1484
3404-001,2015,3,19,21,683,265,948,1117
3404-001,2015,3,19,22,390,196,586,948
3404-001,2015,3,19,23,224,141,365,586
3404-001,2015,3,19,24,129,104,233,365
3404-001,2015,3,20,1,91,75,166,233
3404-001,2015,3,20,2,47,71,118,166
3404-001,2015,3,20,3,46,35,81,118
3404-001,2015,3,20,4,47,44,91,81
3404-001,2015,3,20,5,61,69,130,91
3404-001,2015,3,20,6,118,201,319,130
3404-001,2015,3,20,7,195,560,755,319
3404-001,2015,3,20,8,447,1715,2162,755
3404-001,2015,3,20,9,737,1282,2019,2162
3404-001,2015,3,20,10,669,732,1401,2019
3404-001,2015,3,20,11,753,709,1462,1401
3404-001,2015,3,20,12,691,679,1370,1462
3404-001,2015,3,20,13,603,521,1124,1370
3404-001,2015,3,20,14,682,674,1356,1124
3404-001,2015,3,20,15,788,708,1496,1356
3404-001,2015,3,20,16,816,573,1389,1496
3404-001,2015,3,20,17,851,604,1455,1389
3404-001,2015,3,20,18,1345,569,1914,1455
3404-001,2015,3,20,19,1226,536,1762,1914
3404-001,2015,3,20,20,884,438,1322,1762
3404-001,2015,3,20,21,618,302,920,1322
3404-001,2015,3,20,22,395,232,627,920
3404-001,2015,3,20,23,212,168,380,627
3404-001,2015,3,20,24,133,97,230,380
3404-001,2015,3,21,1,110,75,185,230
3404-001,2015,3,21,2,63,65,128,185
3404-001,2015,3,21,3,42,60,102,128
3404-001,2015,3,21,4,47,39,86,102
3404-001,2015,3,21,5,55,70,125,86
3404-001,2015,3,21,6,93,182,275,125
3404-001,2015,3,21,7,197,341,538,275
3404-001,2015,3,21,8,357,785,1142,538
3404-001,2015,3,21,9,550,713,1263,1142
3404-001,2015,3,21,10,528,584,1112,1263
3404-001,2015,3,21,11,554,605,1159,1112
3404-001,2015,3,21,12,546,580,1126,1159
3404-001,2015,3,21,13,514,463,977,1126
3404-001,2015,3,21,14,464,583,1047,977
3404-001,2015,3,21,15,581,491,1072,1047
3404-001,2015,3,21,16,611,460,1071,1072
3404-001,2015,3,21,17,703,431,1134,1071
3404-001,2015,3,21,18,999,437,1436,1134
3404-001,2015,3,21,19,635,395,1030,1436
3404-001,2015,3,21,20,421,300,721,1030
3404-001,2015,3,21,21,273,194,467,721
3404-001,2015,3,21,22,177,161,338,467
3404-001,2015,3,21,23,120,132,252,338
3404-001,2015,3,21,24,63,80,143,252
3404-001,2015,3,22,1,54,44,98,143
3404-001,2015,3,22,2,52,34,86,98
3404-001,2015,3,22,3,35,22,57,86
3404-001,2015,3,22,4,31,29,60,57
3404-001,2015,3,22,5,38,32,70,60
3404-001,2015,3,22,6,47,77,124,70
3404-001,2015,3,22,7,67,165,232,124
3404-001,2015,3,22,8,140,277,417,232
3404-001,2015,3,22,9,246,235,481,417
3404-001,2015,3,22,10,245,268,513,481
3404-001,2015,3,22,11,256,332,588,513
3404-001,2015,3,22,12,328,350,678,588
3404-001,2015,3,22,13,316,352,668,678
3404-001,2015,3,22,14,359,373,732,668
3404-001,2015,3,22,15,405,379,784,732
3404-001,2015,3,22,16,470,343,813,784
3404-001,2015,3,22,17,545,324,869,813
3404-001,2015,3,22,18,553,338,891,869
3404-001,2015,3,22,19,510,320,830,891
3404-001,2015,3,22,20,330,275,605,830
3404-001,2015,3,22,21,206,224,430,605
3404-001,2015,3,22,22,157,194,351,430
3404-001,2015,3,22,23,78,152,230,351
3404-001,2015,3,22,24,67,125,192,230
3404-001,2015,3,23,1,42,70,112,192
3404-001,2015,3,23,2,20,30,50,112
3404-001,2015,3,23,3,11,35,46,50
3404-001,2015,3,23,4,22,44,66,46
3404-001,2015,3,23,5,41,78,119,66
3404-001,2015,3,23,6,107,235,342,119
3404-001,2015,3,23,7,225,663,888,342
3404-001,2015,3,23,8,548,1926,2474,888
3404-001,2015,3,23,9,646,1305,1951,2474
3404-001,2015,3,23,10,581,719,1300,1951
3404-001,2015,3,23,11,661,645,1306,1300
3404-001,2015,3,23,12,599,545,1144,1306
3404-001,2015,3,23,13,545,540,1085,1144
3404-001,2015,3,23,14,642,700,1342,1085
3404-001,2015,3,23,15,731,767,1498,1342
3404-001,2015,3,23,16,785,614,1399,1498
3404-001,2015,3,23,17,809,563,1372,1399
3404-001,2015,3,23,18,1131,537,1668,1372
3404-001,2015,3,23,19,956,444,1400,1668
3404-001,2015,3,23,20,760,374,1134,1400
3404-001,2015,3,23,21,700,260,960,1134
3404-001,2015,3,23,22,366,209,575,960
3404-001,2015,3,23,23,189,139,328,575
3404-001,2015,3,23,24,112,98,210,328
3404-001,2015,3,24,1,91,77,168,210
3404-001,2015,3,24,2,50,58,108,168
3404-001,2015,3,24,3,30,43,73,108
3404-001,2015,3,24,4,36,45,81,73
3404-001,2015,3,24,5,63,66,129,81
3404-001,2015,3,24,6,105,211,316,129
3404-001,2015,3,24,7,206,599,805,316
3404-001,2015,3,24,8,494,1692,2186,805
3404-001,2015,3,24,9,739,1287,2026,2186
3404-001,2015,3,24,10,693,745,1438,2026
3404-001,2015,3,24,11,677,700,1377,1438
3404-001,2015,3,24,12,672,618,1290,1377
3404-001,2015,3,24,13,549,554,1103,1290
3404-001,2015,3,24,14,707,688,1395,1103
3404-001,2015,3,24,15,751,693,1444,1395
3404-001,2015,3,24,16,837,653,1490,1444
3404-001,2015,3,24,17,825,560,1385,1490
3404-001,2015,3,24,18,1142,560,1702,1385
3404-001,2015,3,24,19,982,456,1438,1702
3404-001,2015,3,24,20,741,412,1153,1438
3404-001,2015,3,24,21,657,263,920,1153
3404-001,2015,3,24,22,385,192,577,920
3404-001,2015,3,24,23,204,165,369,577
3404-001,2015,3,24,24,131,103,234,369
3404-001,2015,3,25,1,71,95,166,234
3404-001,2015,3,25,2,58,42,100,166
3404-001,2015,3,25,3,33,41,74,100
3404-001,2015,3,25,4,43,42,85,74
3404-001,2015,3,25,5,60,65,125,85
3404-001,2015,3,25,6,101,228,329,125
3404-001,2015,3,25,7,215,545,760,329
3404-001,2015,3,25,8,506,1751,2257,760
3404-001,2015,3,25,9,747,1236,1983,2257
3404-001,2015,3,25,10,679,685,1364,1983
3404-001,2015,3,25,11,677,692,1369,1364
3404-001,2015,3,25,12,649,619,1268,1369
3404-001,2015,3,25,13,519,506,1025,1268
3404-001,2015,3,25,14,630,692,1322,1025
3404-001,2015,3,25,15,802,703,1505,1322
3404-001,2015,3,25,16,784,672,1456,1505
3404-001,2015,3,25,17,810,572,1382,1456
3404-001,2015,3,25,18,1260,542,1802,1382
3404-001,2015,3,25,19,1096,497,1593,1802
3404-001,2015,3,25,20,704,375,1079,1593
3404-001,2015,3,25,21,573,278,851,1079
3404-001,2015,3,25,22,383,195,578,851
3404-001,2015,3,25,23,217,143,360,578
3404-001,2015,3,25,24,129,103,232,360
3404-001,2015,3,26,1,86,79,165,232
3404-001,2015,3,26,2,65,50,115,165
3404-001,2015,3,26,3,44,38,82,115
3404-001,2015,3,26,4,30,61,91,82
3404-001,2015,3,26,5,57,85,142,91
3404-001,2015,3,26,6,105,218,323,142
3404-001,2015,3,26,7,204,576,780,323
3404-001,2015,3,26,8,514,1691,2205,780
3404-001,2015,3,26,9,728,1301,2029,2205
3404-001,2015,3,26,10,653,748,1401,2029
3404-001,2015,3,26,11,685,692,1377,1401
3404-001,2015,3,26,12,666,647,1313,1377
3404-001,2015,3,26,13,580,513,1093,1313
3404-001,2015,3,26,14,635,647,1282,1093
3404-001,2015,3,26,15,765,667,1432,1282
3404-001,2015,3,26,16,752,653,1405,1432
3404-001,2015,3,26,17,803,628,1431,1405
3404-001,2015,3,26,18,1127,591,1718,1431
3404-001,2015,3,26,19,1067,478,1545,1718
3404-001,2015,3,26,20,703,446,1149,1545
3404-001,2015,3,26,21,665,256,921,1149
3404-001,2015,3,26,22,425,199,624,921
3404-001,2015,3,26,23,213,160,373,624
3404-001,2015,3,26,24,134,128,262,373
3404-001,2015,3,27,1,93,80,173,262
3404-001,2015,3,27,2,72,79,151,173
3404-001,2015,3,27,3,38,48,86,151
3404-001,2015,3,27,4,53,50,103,86
3404-001,2015,3,27,5,57,73,130,103
3404-001,2015,3,27,6,113,193,306,130
3404-001,2015,3,27,7,204,537,741,306
3404-001,2015,3,27,8,483,1766,2249,741
3404-001,2015,3,27,9,756,1258,2014,2249
3404-001,2015,3,27,10,702,746,1448,2014
3404-001,2015,3,27,11,743,668,1411,1448
3404-001,2015,3,27,12,687,696,1383,1411
3404-001,2015,3,27,13,606,551,1157,1383
3404-001,2015,3,27,14,675,627,1302,1157
3404-001,2015,3,27,15,827,711,1538,1302
3404-001,2015,3,27,16,849,691,1540,1538
3404-001,2015,3,27,17,806,616,1422,1540
3404-001,2015,3,27,18,1355,562,1917,1422
3404-001,2015,3,27,19,1273,548,1821,1917
3404-001,2015,3,27,20,897,466,1363,1821
3404-001,2015,3,27,21,618,268,886,1363
3404-001,2015,3,27,22,324,196,520,886
3404-001,2015,3,27,23,223,164,387,520
3404-001,2015,3,27,24,151,101,252,387
3404-001,2015,3,28,1,105,66,171,252
3404-001,2015,3,28,2,78,60,138,171
3404-001,2015,3,28,3,51,48,99,138
3404-001,2015,3,28,4,49,46,95,99
3404-001,2015,3,28,5,67,68,135,95
3404-001,2015,3,28,6,111,180,291,135
3404-001,2015,3,28,7,194,399,593,291
3404-001,2015,3,28,8,361,769,1130,593
3404-001,2015,3,28,9,516,697,1213,1130
3404-001,2015,3,28,10,502,637,1139,1213
3404-001,2015,3,28,11,587,578,1165,1139
3404-001,2015,3,28,12,585,571,1156,1165
3404-001,2015,3,28,13,542,523,1065,1156
3404-001,2015,3,28,14,521,544,1065,1065
3404-001,2015,3,28,15,524,521,1045,1065
3404-001,2015,3,28,16,629,520,1149,1045
3404-001,2015,3,28,17,677,394,1071,1149
3404-001,2015,3,28,18,1007,431,1438,1071
3404-001,2015,3,28,19,671,359,1030,1438
3404-001,2015,3,28,20,429,315,744,1030
3404-001,2015,3,28,21,304,247,551,744
3404-001,2015,3,28,22,159,162,321,551
3404-001,2015,3,28,23,139,122,261,321
3404-001,2015,3,28,24,88,91,179,261
3404-001,2015,3,29,1,52,43,95,179
3404-001,2015,3,29,2,38,27,65,95
3404-001,2015,3,29,3,35,24,59,65
3404-001,2015,3,29,4,34,21,55,59
3404-001,2015,3,29,5,34,34,68,55
3404-001,2015,3,29,6,48,88,136,68
3404-001,2015,3,29,7,86,158,244,136
3404-001,2015,3,29,8,171,247,418,244
3404-001,2015,3,29,9,218,269,487,418
3404-001,2015,3,29,10,244,296,540,487
3404-001,2015,3,29,11,302,342,644,540
3404-001,2015,3,29,12,295,310,605,644
3404-001,2015,3,29,13,317,338,655,605
3404-001,2015,3,29,14,345,372,717,655
3404-001,2015,3,29,15,389,388,777,717
3404-001,2015,3,29,16,433,356,789,777
3404-001,2015,3,29,17,515,356,871,789
3404-001,2015,3,29,18,591,330,921,871
3404-001,2015,3,29,19,462,289,751,921
3404-001,2015,3,29,20,333,265,598,751
3404-001,2015,3,29,21,243,255,498,598
3404-001,2015,3,29,22,147,202,349,498
3404-001,2015,3,29,23,107,183,290,349
3404-001,2015,3,29,24,62,108,170,290
3404-001,2015,3,30,1,44,59,103,170
3404-001,2015,3,30,2,23,57,80,103
3404-001,2015,3,30,3,21,24,45,80
3404-001,2015,3,30,4,29,49,78,45
3404-001,2015,3,30,5,64,94,158,78
3404-001,2015,3,30,6,122,243,365,158
3404-001,2015,3,30,7,226,688,914,365
3404-001,2015,3,30,8,493,1987,2480,914
3404-001,2015,3,30,9,672,1313,1985,2480
3404-001,2015,3,30,10,619,692,1311,1985
3404-001,2015,3,30,11,641,683,1324,1311
3404-001,2015,3,30,12,594,630,1224,1324
3404-001,2015,3,30,13,545,541,1086,1224
3404-001,2015,3,30,14,624,611,1235,1086
3404-001,2015,3,30,15,734,706,1440,1235
3404-001,2015,3,30,16,749,641,1390,1440
3404-001,2015,3,30,17,796,555,1351,1390
3404-001,2015,3,30,18,1098,510,1608,1351
3404-001,2015,3,30,19,988,488,1476,1608
3404-001,2015,3,30,20,749,372,1121,1476
3404-001,2015,3,30,21,705,272,977,1121
3404-001,2015,3,30,22,426,209,635,977
3404-001,2015,3,30,23,221,170,391,635
3404-001,2015,3,30,24,113,102,215,391
3404-001,2015,3,31,1,68,63,131,215
3404-001,2015,3,31,2,65,47,112,131
3404-001,2015,3,31,3,37,40,77,112
3404-001,2015,3,31,4,42,59,101,77
3404-001,2015,3,31,5,71,81,152,101
3404-001,2015,3,31,6,105,200,305,152
3404-001,2015,3,31,7,222,607,829,305
3404-001,2015,3,31,8,447,1762,2209,829
3404-001,2015,3,31,9,777,1198,1975,2209
3404-001,2015,3,31,10,677,716,1393,1975
3404-001,2015,3,31,11,706,664,1370,1393
3404-001,2015,3,31,12,626,618,1244,1370
3404-001,2015,3,31,13,564,502,1066,1244
3404-001,2015,3,31,14,725,599,1324,1066
3404-001,2015,3,31,15,704,615,1319,1324
3404-001,2015,3,31,16,740,614,1354,1319
3404-001,2015,3,31,17,771,558,1329,1354
3404-001,2015,3,31,18,1045,489,1534,1329
3404-001,2015,3,31,19,966,423,1389,1534
3404-001,2015,3,31,20,690,362,1052,1389
3404-001,2015,3,31,21,650,232,882,1052
3404-001,2015,3,31,22,349,172,521,882
3404-001,2015,3,31,23,223,151,374,521
3404-001,2015,3,31,24,118,105,223,374
3404-001,2015,4,1,1,86,87,173,223
3404-001,2015,4,1,2,63,54,117,173
3404-001,2015,4,1,3,60,37,97,117
3404-001,2015,4,1,4,46,46,92,97
3404-001,2015,4,1,5,60,74,134,92
3404-001,2015,4,1,6,84,183,267,134
3404-001,2015,4,1,7,197,556,753,267
3404-001,2015,4,1,8,452,1736,2188,753
3404-001,2015,4,1,9,726,1266,1992,2188
3404-001,2015,4,1,10,608,695,1303,1992
3404-001,2015,4,1,11,643,658,1301,1303
3404-001,2015,4,1,12,669,651,1320,1301
3404-001,2015,4,1,13,564,540,1104,1320
3404-001,2015,4,1,14,641,635,1276,1104
3404-001,2015,4,1,15,701,709,1410,1276
3404-001,2015,4,1,16,793,619,1412,1410
3404-001,2015,4,1,17,748,588,1336,1412
3404-001,2015,4,1,18,1274,534,1808,1336
3404-001,2015,4,1,19,1030,465,1495,1808
3404-001,2015,4,1,20,680,353,1033,1495
3404-001,2015,4,1,21,537,244,781,1033
3404-001,2015,4,1,22,371,214,585,781
3404-001,2015,4,1,23,190,145,335,585
3404-001,2015,4,1,24,130,105,235,335
3404-001,2015,4,2,1,90,82,172,235
3404-001,2015,4,2,2,58,64,122,172
3404-001,2015,4,2,3,31,53,84,122
3404-001,2015,4,2,4,52,51,103,84
3404-001,2015,4,2,5,70,83,153,103
3404-001,2015,4,2,6,105,207,312,153
3404-001,2015,4,2,7,226,572,798,312
3404-001,2015,4,2,8,492,1763,2255,798
3404-001,2015,4,2,9,725,1253,1978,2255
3404-001,2015,4,2,10,676,711,1387,1978
3404-001,2015,4,2,11,690,675,1365,1387
3404-001,2015,4,2,12,635,648,1283,1365
3404-001,2015,4,2,13,566,564,1130,1283
3404-001,2015,4,2,14,628,613,1241,1130
3404-001,2015,4,2,15,748,663,1411,1241
3404-001,2015,4,2,16,794,630,1424,1411
3404-001,2015,4,2,17,829,553,1382,1424
3404-001,2015,4,2,18,1149,573,1722,1382
3404-001,2015,4,2,19,962,421,1383,1722
3404-001,2015,4,2,20,697,344,1041,1383
3404-001,2015,4,2,21,705,241,946,1041
3404-001,2015,4,2,22,392,216,608,946
3404-001,2015,4,2,23,212,125,337,608
3404-001,2015,4,2,24,107,96,203,337
3404-001,2015,4,3,1,82,74,156,203
3404-001,2015,4,3,2,59,60,119,156
3404-001,2015,4,3,3,35,40,75,119
3404-001,2015,4,3,4,27,36,63,75
3404-001,2015,4,3,5,60,74,134,63
3404-001,2015,4,3,6,94,192,286,134
3404-001,2015,4,3,7,190,519,709,286
3404-001,2015,4,3,8,448,1677,2125,709
3404-001,2015,4,3,9,729,1197,1926,2125
3404-001,2015,4,3,10,648,693,1341,1926
3404-001,2015,4,3,11,677,656,1333,1341
3404-001,2015,4,3,12,665,637,1302,1333
3404-001,2015,4,3,13,588,562,1150,1302
3404-001,2015,4,3,14,633,656,1289,1150
3404-001,2015,4,3,15,739,671,1410,1289
3404-001,2015,4,3,16,842,676,1518,1410
3404-001,2015,4,3,17,831,555,1386,1518
3404-001,2015,4,3,18,1311,566,1877,1386
3404-001,2015,4,3,19,1193,523,1716,1877
3404-001,2015,4,3,20,876,498,1374,1716
3404-001,2015,4,3,21,657,259,916,1374
3404-001,2015,4,3,22,383,212,595,916
3404-001,2015,4,3,23,227,156,383,595
3404-001,2015,4,3,24,144,110,254,383
3404-001,2015,4,4,1,89,75,164,254
3404-001,2015,4,4,2,82,50,132,164
3404-001,2015,4,4,3,48,46,94,132
3404-001,2015,4,4,4,20,38,58,94
3404-001,2015,4,4,5,74,56,130,58
3404-001,2015,4,4,6,91,146,237,130
3404-001,2015,4,4,7,185,358,543,237
3404-001,2015,4,4,8,380,747,1127,543
3404-001,2015,4,4,9,599,662,1261,1127
3404-001,2015,4,4,10,605,585,1190,1261
3404-001,2015,4,4,11,574,611,1185,1190
3404-001,2015,4,4,12,508,596,1104,1185
3404-001,2015,4,4,13,490,607,1097,1104
3404-001,2015,4,4,14,475,561,1036,1097
3404-001,2015,4,4,15,518,521,1039,1036
3404-001,2015,4,4,16,619,476,1095,1039
3404-001,2015,4,4,17,799,444,1243,1095
3404-001,2015,4,4,18,907,369,1276,1243
3404-001,2015,4,4,19,573,374,947,1276
3404-001,2015,4,4,20,348,280,628,947
3404-001,2015,4,4,21,264,203,467,628
3404-001,2015,4,4,22,162,131,293,467
3404-001,2015,4,4,23,97,110,207,293
3404-001,2015,4,4,24,63,62,125,207
3404-001,2015,4,5,1,39,60,99,125
3404-001,2015,4,5,2,32,38,70,99
3404-001,2015,4,5,3,30,21,51,70
3404-001,2015,4,5,4,17,19,36,51
3404-001,2015,4,5,5,30,29,59,36
3404-001,2015,4,5,6,48,73,121,59
3404-001,2015,4,5,7,76,123,199,121
3404-001,2015,4,5,8,156,247,403,199
3404-001,2015,4,5,9,232,235,467,403
3404-001,2015,4,5,10,244,275,519,467
3404-001,2015,4,5,11,279,300,579,519
3404-001,2015,4,5,12,312,335,647,579
3404-001,2015,4,5,13,316,288,604,647
3404-001,2015,4,5,14,352,350,702,604
3404-001,2015,4,5,15,397,365,762,702
3404-001,2015,4,5,16,452,312,764,762
3404-001,2015,4,5,17,530,345,875,764
3404-001,2015,4,5,18,572,336,908,875
3404-001,2015,4,5,19,486,334,820,908
3404-001,2015,4,5,20,332,303,635,820
3404-001,2015,4,5,21,224,225,449,635
3404-001,2015,4,5,22,152,213,365,449
3404-001,2015,4,5,23,92,188,280,365
3404-001,2015,4,5,24,64,121,185,280
3404-001,2015,4,6,1,43,90,133,185
3404-001,2015,4,6,2,22,39,61,133
3404-001,2015,4,6,3,16,27,43,61
3404-001,2015,4,6,4,26,47,73,43
3404-001,2015,4,6,5,52,60,112,73
3404-001,2015,4,6,6,114,261,375,112
3404-001,2015,4,6,7,226,706,932,375
3404-001,2015,4,6,8,520,1870,2390,932
3404-001,2015,4,6,9,659,1269,1928,2390
3404-001,2015,4,6,10,600,709,1309,1928
3404-001,2015,4,6,11,651,677,1328,1309
3404-001,2015,4,6,12,596,584,1180,1328
3404-001,2015,4,6,13,545,518,1063,1180
3404-001,2015,4,6,14,633,599,1232,1063
3404-001,2015,4,6,15,732,707,1439,1232
3404-001,2015,4,6,16,767,677,1444,1439
3404-001,2015,4,6,17,802,531,1333,1444
3404-001,2015,4,6,18,1114,554,1668,1333
3404-001,2015,4,6,19,972,524,1496,1668
3404-001,2015,4,6,20,754,369,1123,1496
3404-001,2015,4,6,21,702,245,947,1123
3404-001,2015,4,6,22,396,192,588,947
3404-001,2015,4,6,23,205,127,332,588
3404-001,2015,4,6,24,112,114,226,332
3404-001,2015,4,7,1,80,59,139,226
3404-001,2015,4,7,2,58,53,111,139
3404-001,2015,4,7,3,34,44,78,111
3404-001,2015,4,7,4,39,49,88,78
3404-001,2015,4,7,5,67,67,134,88
3404-001,2015,4,7,6,105,203,308,134
3404-001,2015,4,7,7,214,605,819,308
3404-001,2015,4,7,8,470,1753,2223,819
3404-001,2015,4,7,9,758,1227,1985,2223
3404-001,2015,4,7,10,685,674,1359,1985
3404-001,2015,4,7,11,692,718,1410,1359
3404-001,2015,4,7,12,649,623,1272,1410
3404-001,2015,4,7,13,556,569,1125,1272
3404-001,2015,4,7,14,716,642,1358,1125
3404-001,2015,4,7,15,728,687,1415,1358
3404-001,2015,4,7,16,788,611,1399,1415
3404-001,2015,4,7,17,798,570,1368,1399
3404-001,2015,4,7,18,1094,513,1607,1368
3404-001,2015,4,7,19,974,470,1444,1607
3404-001,2015,4,7,20,716,398,1114,1444
3404-001,2015,4,7,21,654,239,893,1114
3404-001,2015,4,7,22,367,215,582,893
3404-001,2015,4,7,23,214,126,340,582
3404-001,2015,4,7,24,124,90,214,340
3404-001,2015,4,8,1,71,78,149,214
3404-001,2015,4,8,2,60,48,108,149
3404-001,2015,4,8,3,39,25,64,108
3404-001,2015,4,8,4,41,47,88,64
3404-001,2015,4,8,5,61,80,141,88
3404-001,2015,4,8,6,106,190,296,141
3404-001,2015,4,8,7,204,590,794,296
3404-001,2015,4,8,8,474,1688,2162,794
3404-001,2015,4,8,9,718,1316,2034,2162
3404-001,2015,4,8,10,653,703,1356,2034
3404-001,2015,4,8,11,660,679,1339,1356
3404-001,2015,4,8,12,634,623,1257,1339
3404-001,2015,4,8,13,524,566,1090,1257
3404-001,2015,4,8,14,623,662,1285,1090
3404-001,2015,4,8,15,756,670,1426,1285
3404-001,2015,4,8,16,745,620,1365,1426
3404-001,2015,4,8,17,758,530,1288,1365
3404-001,2015,4,8,18,1155,574,1729,1288
3404-001,2015,4,8,19,1024,489,1513,1729
3404-001,2015,4,8,20,686,398,1084,1513
3404-001,2015,4,8,21,538,240,778,1084
3404-001,2015,4,8,22,360,183,543,778
3404-001,2015,4,8,23,216,156,372,543
3404-001,2015,4,8,24,113,116,229,372
3404-001,2015,4,9,1,76,70,146,229
3404-001,2015,4,9,2,62,51,113,146
3404-001,2015,4,9,3,44,42,86,113
3404-001,2015,4,9,4,32,52,84,86
3404-001,2015,4,9,5,54,79,133,84
3404-001,2015,4,9,6,102,205,307,133
3404-001,2015,4,9,7,201,637,838,307
3404-001,2015,4,9,8,478,1752,2230,838
3404-001,2015,4,9,9,700,1244,1944,2230
3404-001,2015,4,9,10,660,713,1373,1944
3404-001,2015,4,9,11,680,689,1369,1373
3404-001,2015,4,9,12,653,685,1338,1369
3404-001,2015,4,9,13,562,582,1144,1338
3404-001,2015,4,9,14,642,587,1229,1144
3404-001,2015,4,9,15,761,707,1468,1229
3404-001,2015,4,9,16,735,671,1406,1468
3404-001,2015,4,9,17,808,577,1385,1406
3404-001,2015,4,9,18,1104,540,1644,1385
3404-001,2015,4,9,19,1054,516,1570,1644
3404-001,2015,4,9,20,713,418,1131,1570
3404-001,2015,4,9,21,674,260,934,1131
3404-001,2015,4,9,22,408,229,637,934
3404-001,2015,4,9,23,218,147,365,637
3404-001,2015,4,9,24,132,113,245,365
3404-001,2015,4,10,1,92,89,181,245
3404-001,2015,4,10,2,60,57,117,181
3404-001,2015,4,10,3,42,46,88,117
3404-001,2015,4,10,4,50,49,99,88
3404-001,2015,4,10,5,59,64,123,99
3404-001,2015,4,10,6,116,210,326,123
3404-001,2015,4,10,7,200,635,835,326
3404-001,2015,4,10,8,465,1735,2200,835
3404-001,2015,4,10,9,746,1184,1930,2200
3404-001,2015,4,10,10,686,726,1412,1930
3404-001,2015,4,10,11,748,714,1462,1412
3404-001,2015,4,10,12,689,631,1320,1462
3404-001,2015,4,10,13,604,556,1160,1320
3404-001,2015,4,10,14,678,618,1296,1160
3404-001,2015,4,10,15,808,750,1558,1296
3404-001,2015,4,10,16,832,662,1494,1558
3404-001,2015,4,10,17,828,585,1413,1494
3404-001,2015,4,10,18,1350,581,1931,1413
3404-001,2015,4,10,19,1250,543,1793,1931
3404-001,2015,4,10,20,890,488,1378,1793
3404-001,2015,4,10,21,618,300,918,1378
3404-001,2015,4,10,22,360,228,588,918
3404-001,2015,4,10,23,218,156,374,588
3404-001,2015,4,10,24,142,97,239,374
3404-001,2015,4,11,1,100,81,181,239
3404-001,2015,4,11,2,51,44,95,181
3404-001,2015,4,11,3,28,47,75,95
3404-001,2015,4,11,4,49,35,84,75
3404-001,2015,4,11,5,54,64,118,84
3404-001,2015,4,11,6,126,185,311,118
3404-001,2015,4,11,7,216,388,604,311
3404-001,2015,4,11,8,381,750,1131,604
3404-001,2015,4,11,9,465,694,1159,1131
3404-001,2015,4,11,10,459,581,1040,1159
3404-001,2015,4,11,11,423,582,1005,1040
3404-001,2015,4,11,12,551,557,1108,1005
3404-001,2015,4,11,13,483,464,947,1108
3404-001,2015,4,11,14,493,558,1051,947
3404-001,2015,4,11,15,551,536,1087,1051
3404-001,2015,4,11,16,719,498,1217,1087
3404-001,2015,4,11,17,684,454,1138,1217
3404-001,2015,4,11,18,734,487,1221,1138
3404-001,2015,4,11,19,749,406,1155,1221
3404-001,2015,4,11,20,444,282,726,1155
3404-001,2015,4,11,21,252,227,479,726
3404-001,2015,4,11,22,81,172,253,479
3404-001,2015,4,11,23,36,151,187,253
3404-001,2015,4,11,24,30,82,112,187
3404-001,2015,4,12,1,15,64,79,112
3404-001,2015,4,12,2,9,41,50,79
3404-001,2015,4,12,3,20,39,59,50
3404-001,2015,4,12,4,31,34,65,59
3404-001,2015,4,12,5,51,40,91,65
3404-001,2015,4,12,6,48,102,150,91
3404-001,2015,4,12,7,81,148,229,150
3404-001,2015,4,12,8,164,249,413,229
3404-001,2015,4,12,9,225,306,531,413
3404-001,2015,4,12,10,244,349,593,531
3404-001,2015,4,12,11,290,396,686,593
3404-001,2015,4,12,12,304,407,711,686
3404-001,2015,4,12,13,316,323,639,711
3404-001,2015,4,12,14,348,374,722,639
3404-001,2015,4,12,15,393,323,716,722
3404-001,2015,4,12,16,429,345,774,716
3404-001,2015,4,12,17,596,308,904,774
3404-001,2015,4,12,18,664,300,964,904
3404-001,2015,4,12,19,431,295,726,964
3404-001,2015,4,12,20,327,259,586,726
3404-001,2015,4,12,21,239,211,450,586
3404-001,2015,4,12,22,146,224,370,450
3404-001,2015,4,12,23,97,145,242,370
3404-001,2015,4,12,24,64,104,168,242
3404-001,2015,4,13,1,44,83,127,168
3404-001,2015,4,13,2,28,52,80,127
3404-001,2015,4,13,3,24,47,71,80
3404-001,2015,4,13,4,27,43,70,71
3404-001,2015,4,13,5,57,77,134,70
3404-001,2015,4,13,6,115,276,391,134
3404-001,2015,4,13,7,182,697,879,391
3404-001,2015,4,13,8,439,1979,2418,879
3404-001,2015,4,13,9,634,1272,1906,2418
3404-001,2015,4,13,10,586,713,1299,1906
3404-001,2015,4,13,11,364,694,1058,1299
3404-001,2015,4,13,12,434,680,1114,1058
3404-001,2015,4,13,13,513,564,1077,1114
3404-001,2015,4,13,14,586,680,1266,1077
3404-001,2015,4,13,15,697,698,1395,1266
3404-001,2015,4,13,16,720,607,1327,1395
3404-001,2015,4,13,17,746,556,1302,1327
3404-001,2015,4,13,18,1059,511,1570,1302
3404-001,2015,4,13,19,919,472,1391,1570
3404-001,2015,4,13,20,724,350,1074,1391
3404-001,2015,4,13,21,678,240,918,1074
3404-001,2015,4,13,22,375,208,583,918
3404-001,2015,4,13,23,200,139,339,583
3404-001,2015,4,13,24,123,94,217,339
3404-001,2015,4,14,1,65,56,121,217
3404-001,2015,4,14,2,53,61,114,121
3404-001,2015,4,14,3,42,42,84,114
3404-001,2015,4,14,4,34,40,74,84
3404-001,2015,4,14,5,54,61,115,74
3404-001,2015,4,14,6,103,175,278,115
3404-001,2015,4,14,7,154,510,664,278
3404-001,2015,4,14,8,445,1606,2051,664
3404-001,2015,4,14,9,661,1266,1927,2051
3404-001,2015,4,14,10,531,703,1234,1927
3404-001,2015,4,14,11,641,728,1369,1234
3404-001,2015,4,14,12,630,634,1264,1369
3404-001,2015,4,14,13,562,515,1077,1264
3404-001,2015,4,14,14,631,644,1275,1077
3404-001,2015,4,14,15,728,612,1340,1275
3404-001,2015,4,14,16,730,591,1321,1340
3404-001,2015,4,14,17,697,519,1216,1321
3404-001,2015,4,14,18,1001,533,1534,1216
3404-001,2015,4,14,19,934,423,1357,1534
3404-001,2015,4,14,20,749,368,1117,1357
3404-001,2015,4,14,21,680,245,925,1117
3404-001,2015,4,14,22,363,218,581,925
3404-001,2015,4,14,23,184,144,328,581
3404-001,2015,4,14,24,116,101,217,328
3404-001,2015,4,15,1,89,70,159,217
3404-001,2015,4,15,2,78,52,130,159
3404-001,2015,4,15,3,30,41,71,130
3404-001,2015,4,15,4,37,40,77,71
3404-001,2015,4,15,5,75,71,146,77
3404-001,2015,4,15,6,112,201,313,146
3404-001,2015,4,15,7,216,597,813,313
3404-001,2015,4,15,8,448,1733,2181,813
3404-001,2015,4,15,9,722,1226,1948,2181
3404-001,2015,4,15,10,648,767,1415,1948
3404-001,2015,4,15,11,691,763,1454,1415
3404-001,2015,4,15,12,661,626,1287,1454
3404-001,2015,4,15,13,569,559,1128,1287
3404-001,2015,4,15,14,679,621,1300,1128
3404-001,2015,4,15,15,739,730,1469,1300
3404-001,2015,4,15,16,765,652,1417,1469
3404-001,2015,4,15,17,756,586,1342,1417
3404-001,2015,4,15,18,1193,612,1805,1342
3404-001,2015,4,15,19,1031,491,1522,1805
3404-001,2015,4,15,20,733,347,1080,1522
3404-001,2015,4,15,21,612,250,862,1080
3404-001,2015,4,15,22,391,208,599,862
3404-001,2015,4,15,23,212,145,357,599
3404-001,2015,4,15,24,140,93,233,357
3404-001,2015,4,16,1,71,77,148,233
3404-001,2015,4,16,2,50,46,96,148
3404-001,2015,4,16,3,42,35,77,96
3404-001,2015,4,16,4,43,54,97,77
3404-001,2015,4,16,5,59,71,130,97
3404-001,2015,4,16,6,115,224,339,130
3404-001,2015,4,16,7,254,600,854,339
3404-001,2015,4,16,8,516,1714,2230,854
3404-001,2015,4,16,9,784,1277,2061,2230
3404-001,2015,4,16,10,669,789,1458,2061
3404-001,2015,4,16,11,713,717,1430,1458
3404-001,2015,4,16,12,624,604,1228,1430
3404-001,2015,4,16,13,651,558,1209,1228
3404-001,2015,4,16,14,603,619,1222,1209
3404-001,2015,4,16,15,693,585,1278,1222
3404-001,2015,4,16,16,732,613,1345,1278
3404-001,2015,4,16,17,735,526,1261,1345
3404-001,2015,4,16,18,964,512,1476,1261
3404-001,2015,4,16,19,885,412,1297,1476
3404-001,2015,4,16,20,636,362,998,1297
3404-001,2015,4,16,21,682,278,960,998
3404-001,2015,4,16,22,367,204,571,960
3404-001,2015,4,16,23,161,147,308,571
3404-001,2015,4,16,24,120,89,209,308
3404-001,2015,4,17,1,35,76,111,209
3404-001,2015,4,17,2,19,49,68,111
3404-001,2015,4,17,3,13,49,62,68
3404-001,2015,4,17,4,7,44,51,62
3404-001,2015,4,17,5,43,62,105,51
3404-001,2015,4,17,6,68,210,278,105
3404-001,2015,4,17,7,214,574,788,278
3404-001,2015,4,17,8,502,1747,2249,788
3404-001,2015,4,17,9,738,1159,1897,2249
3404-001,2015,4,17,10,667,751,1418,1897
3404-001,2015,4,17,11,712,754,1466,1418
3404-001,2015,4,17,12,677,680,1357,1466
3404-001,2015,4,17,13,596,557,1153,1357
3404-001,2015,4,17,14,656,658,1314,1153
3404-001,2015,4,17,15,743,677,1420,1314
3404-001,2015,4,17,16,753,667,1420,1420
3404-001,2015,4,17,17,825,607,1432,1420
3404-001,2015,4,17,18,1335,604,1939,1432
3404-001,2015,4,17,19,1211,579,1790,1939
3404-001,2015,4,17,20,941,439,1380,1790
3404-001,2015,4,17,21,669,303,972,1380
3404-001,2015,4,17,22,371,194,565,972
3404-001,2015,4,17,23,212,163,375,565
3404-001,2015,4,17,24,97,110,207,375
3404-001,2015,4,18,1,39,74,113,207
3404-001,2015,4,18,2,28,50,78,113
3404-001,2015,4,18,3,21,40,61,78
3404-001,2015,4,18,4,18,44,62,61
3404-001,2015,4,18,5,20,57,77,62
3404-001,2015,4,18,6,67,170,237,77
3404-001,2015,4,18,7,104,458,562,237
3404-001,2015,4,18,8,287,778,1065,562
3404-001,2015,4,18,9,512,744,1256,1065
3404-001,2015,4,18,10,544,639,1183,1256
3404-001,2015,4,18,11,580,613,1193,1183
3404-001,2015,4,18,12,492,561,1053,1193
3404-001,2015,4,18,13,512,544,1056,1053
3404-001,2015,4,18,14,483,533,1016,1056
3404-001,2015,4,18,15,586,540,1126,1016
3404-001,2015,4,18,16,655,493,1148,1126
3404-001,2015,4,18,17,723,450,1173,1148
3404-001,2015,4,18,18,1033,471,1504,1173
3404-001,2015,4,18,19,668,395,1063,1504
3404-001,2015,4,18,20,419,272,691,1063
3404-001,2015,4,18,21,278,209,487,691
3404-001,2015,4,18,22,99,153,252,487
3404-001,2015,4,18,23,117,112,229,252
3404-001,2015,4,18,24,98,80,178,229
3404-001,2015,4,19,1,41,47,88,178
3404-001,2015,4,19,2,13,38,51,88
3404-001,2015,4,19,3,20,38,58,51
3404-001,2015,4,19,4,28,22,50,58
3404-001,2015,4,19,5,37,34,71,50
3404-001,2015,4,19,6,44,71,115,71
3404-001,2015,4,19,7,91,121,212,115
3404-001,2015,4,19,8,160,225,385,212
3404-001,2015,4,19,9,228,241,469,385
3404-001,2015,4,19,10,244,225,469,469
3404-001,2015,4,19,11,284,286,570,469
3404-001,2015,4,19,12,308,319,627,570
3404-001,2015,4,19,13,316,262,578,627
3404-001,2015,4,19,14,350,317,667,578
3404-001,2015,4,19,15,395,325,720,667
3404-001,2015,4,19,16,440,310,750,720
3404-001,2015,4,19,17,563,304,867,750
3404-001,2015,4,19,18,618,290,908,867
3404-001,2015,4,19,19,458,293,751,908
3404-001,2015,4,19,20,330,237,567,751
3404-001,2015,4,19,21,232,233,465,567
3404-001,2015,4,19,22,149,180,329,465
3404-001,2015,4,19,23,94,148,242,329
3404-001,2015,4,19,24,64,100,164,242
3404-001,2015,4,20,1,44,65,109,164
3404-001,2015,4,20,2,25,47,72,109
3404-001,2015,4,20,3,20,45,65,72
3404-001,2015,4,20,4,26,37,63,65
3404-001,2015,4,20,5,54,68,122,63
3404-001,2015,4,20,6,114,209,323,122
3404-001,2015,4,20,7,204,657,861,323
3404-001,2015,4,20,8,480,1798,2278,861
3404-001,2015,4,20,9,646,1245,1891,2278
3404-001,2015,4,20,10,593,589,1182,1891
3404-001,2015,4,20,11,508,588,1096,1182
3404-001,2015,4,20,12,515,570,1085,1096
3404-001,2015,4,20,13,529,554,1083,1085
3404-001,2015,4,20,14,610,661,1271,1083
3404-001,2015,4,20,15,714,672,1386,1271
3404-001,2015,4,20,16,744,623,1367,1386
3404-001,2015,4,20,17,774,549,1323,1367
3404-001,2015,4,20,18,1086,487,1573,1323
3404-001,2015,4,20,19,946,491,1437,1573
3404-001,2015,4,20,20,739,364,1103,1437
3404-001,2015,4,20,21,690,268,958,1103
3404-001,2015,4,20,22,386,197,583,958
3404-001,2015,4,20,23,202,149,351,583
3404-001,2015,4,20,24,118,93,211,351
3404-001,2015,4,21,1,79,76,155,211
3404-001,2015,4,21,2,56,68,124,155
3404-001,2015,4,21,3,29,40,69,124
3404-001,2015,4,21,4,31,37,68,69
3404-001,2015,4,21,5,63,75,138,68
3404-001,2015,4,21,6,103,228,331,138
3404-001,2015,4,21,7,220,636,856,331
3404-001,2015,4,21,8,494,1767,2261,856
3404-001,2015,4,21,9,740,1229,1969,2261
3404-001,2015,4,21,10,690,774,1464,1969
3404-001,2015,4,21,11,692,754,1446,1464
3404-001,2015,4,21,12,652,642,1294,1446
3404-001,2015,4,21,13,577,536,1113,1294
3404-001,2015,4,21,14,657,625,1282,1113
3404-001,2015,4,21,15,728,663,1391,1282
3404-001,2015,4,21,16,759,674,1433,1391
3404-001,2015,4,21,17,748,540,1288,1433
3404-001,2015,4,21,18,1048,560,1608,1288
3404-001,2015,4,21,19,954,492,1446,1608
3404-001,2015,4,21,20,732,403,1135,1446
3404-001,2015,4,21,21,667,272,939,1135
3404-001,2015,4,21,22,365,208,573,939
3404-001,2015,4,21,23,199,126,325,573
3404-001,2015,4,21,24,120,106,226,325
3404-001,2015,4,22,1,80,89,169,226
3404-001,2015,4,22,2,69,50,119,169
3404-001,2015,4,22,3,34,34,68,119
3404-001,2015,4,22,4,39,58,97,68
3404-001,2015,4,22,5,68,79,147,97
3404-001,2015,4,22,6,109,205,314,147
3404-001,2015,4,22,7,210,628,838,314
3404-001,2015,4,22,8,461,1808,2269,838
3404-001,2015,4,22,9,720,1309,2029,2269
3404-001,2015,4,22,10,650,746,1396,2029
3404-001,2015,4,22,11,676,740,1416,1396
3404-001,2015,4,22,12,648,664,1312,1416
3404-001,2015,4,22,13,546,541,1087,1312
3404-001,2015,4,22,14,651,660,1311,1087
3404-001,2015,4,22,15,748,718,1466,1311
3404-001,2015,4,22,16,755,627,1382,1466
3404-001,2015,4,22,17,757,611,1368,1382
3404-001,2015,4,22,18,1174,584,1758,1368
3404-001,2015,4,22,19,1028,475,1503,1758
3404-001,2015,4,22,20,710,368,1078,1503
3404-001,2015,4,22,21,575,252,827,1078
3404-001,2015,4,22,22,376,180,556,827
3404-001,2015,4,22,23,214,156,370,556
3404-001,2015,4,22,24,126,110,236,370
3404-001,2015,4,23,1,74,69,143,236
3404-001,2015,4,23,2,56,59,115,143
3404-001,2015,4,23,3,43,49,92,115
3404-001,2015,4,23,4,38,32,70,92
3404-001,2015,4,23,5,56,76,132,70
3404-001,2015,4,23,6,108,215,323,132
3404-001,2015,4,23,7,228,614,842,323
3404-001,2015,4,23,8,497,1787,2284,842
3404-001,2015,4,23,9,742,1236,1978,2284
3404-001,2015,4,23,10,664,771,1435,1978
3404-001,2015,4,23,11,696,655,1351,1435
3404-001,2015,4,23,12,638,672,1310,1351
3404-001,2015,4,23,13,606,542,1148,1310
3404-001,2015,4,23,14,622,627,1249,1148
3404-001,2015,4,23,15,727,698,1425,1249
3404-001,2015,4,23,16,734,643,1377,1425
3404-001,2015,4,23,17,772,585,1357,1377
3404-001,2015,4,23,18,1034,592,1626,1357
3404-001,2015,4,23,19,970,480,1450,1626
3404-001,2015,4,23,20,674,401,1075,1450
3404-001,2015,4,23,21,678,273,951,1075
3404-001,2015,4,23,22,388,212,600,951
3404-001,2015,4,23,23,190,148,338,600
3404-001,2015,4,23,24,126,112,238,338
3404-001,2015,4,24,1,63,71,134,238
3404-001,2015,4,24,2,70,60,130,134
3404-001,2015,4,24,3,31,36,67,130
3404-001,2015,4,24,4,54,59,113,67
3404-001,2015,4,24,5,58,77,135,113
3404-001,2015,4,24,6,92,225,317,135
3404-001,2015,4,24,7,207,618,825,317
3404-001,2015,4,24,8,484,1759,2243,825
3404-001,2015,4,24,9,742,1257,1999,2243
3404-001,2015,4,24,10,676,683,1359,1999
3404-001,2015,4,24,11,730,684,1414,1359
3404-001,2015,4,24,12,683,681,1364,1414
3404-001,2015,4,24,13,600,541,1141,1364
3404-001,2015,4,24,14,667,666,1333,1141
3404-001,2015,4,24,15,776,716,1492,1333
3404-001,2015,4,24,16,792,644,1436,1492
3404-001,2015,4,24,17,826,581,1407,1436
3404-001,2015,4,24,18,1342,581,1923,1407
3404-001,2015,4,24,19,1230,552,1782,1923
3404-001,2015,4,24,20,916,545,1461,1782
3404-001,2015,4,24,21,644,313,957,1461
3404-001,2015,4,24,22,366,231,597,957
3404-001,2015,4,24,23,215,179,394,597
3404-001,2015,4,24,24,120,109,229,394
3404-001,2015,4,25,1,22,91,113,229
3404-001,2015,4,25,2,16,56,72,113
3404-001,2015,4,25,3,21,39,60,72
3404-001,2015,4,25,4,49,55,104,60
3404-001,2015,4,25,5,60,66,126,104
3404-001,2015,4,25,6,96,170,266,126
3404-001,2015,4,25,7,160,428,588,266
3404-001,2015,4,25,8,334,827,1161,588
3404-001,2015,4,25,9,488,741,1229,1161
3404-001,2015,4,25,10,502,641,1143,1229
3404-001,2015,4,25,11,502,646,1148,1143
3404-001,2015,4,25,12,522,606,1128,1148
3404-001,2015,4,25,13,498,539,1037,1128
3404-001,2015,4,25,14,488,526,1014,1037
3404-001,2015,4,25,15,568,508,1076,1014
3404-001,2015,4,25,16,687,504,1191,1076
3404-001,2015,4,25,17,704,444,1148,1191
3404-001,2015,4,25,18,884,442,1326,1148
3404-001,2015,4,25,19,708,385,1093,1326
3404-001,2015,4,25,20,432,315,747,1093
3404-001,2015,4,25,21,265,204,469,747
3404-001,2015,4,25,22,90,174,264,469
3404-001,2015,4,25,23,76,129,205,264
3404-001,2015,4,25,24,64,81,145,205
3404-001,2015,4,26,1,28,58,86,145
3404-001,2015,4,26,2,11,33,44,86
3404-001,2015,4,26,3,20,24,44,44
3404-001,2015,4,26,4,30,29,59,44
3404-001,2015,4,26,5,44,37,81,59
3404-001,2015,4,26,6,46,97,143,81
3404-001,2015,4,26,7,86,224,310,143
3404-001,2015,4,26,8,162,342,504,310
3404-001,2015,4,26,9,226,353,579,504
3404-001,2015,4,26,10,244,311,555,579
3404-001,2015,4,26,11,287,376,663,555
3404-001,2015,4,26,12,306,441,747,663
3404-001,2015,4,26,13,316,322,638,747
3404-001,2015,4,26,14,349,367,716,638
3404-001,2015,4,26,15,394,388,782,716
3404-001,2015,4,26,16,434,391,825,782
3404-001,2015,4,26,17,580,374,954,825
3404-001,2015,4,26,18,641,326,967,954
3404-001,2015,4,26,19,444,316,760,967
3404-001,2015,4,26,20,328,262,590,760
3404-001,2015,4,26,21,236,259,495,590
3404-001,2015,4,26,22,148,234,382,495
3404-001,2015,4,26,23,96,175,271,382
3404-001,2015,4,26,24,64,122,186,271
3404-001,2015,4,27,1,73,68,141,186
3404-001,2015,4,27,2,41,49,90,141
3404-001,2015,4,27,3,24,49,73,90
3404-001,2015,4,27,4,32,58,90,73
3404-001,2015,4,27,5,56,76,132,90
3404-001,2015,4,27,6,114,263,377,132
3404-001,2015,4,27,7,193,740,933,377
3404-001,2015,4,27,8,460,1993,2453,933
3404-001,2015,4,27,9,640,1309,1949,2453
3404-001,2015,4,27,10,590,734,1324,1949
3404-001,2015,4,27,11,436,725,1161,1324
3404-001,2015,4,27,12,474,679,1153,1161
3404-001,2015,4,27,13,521,556,1077,1153
3404-001,2015,4,27,14,598,626,1224,1077
3404-001,2015,4,27,15,706,734,1440,1224
3404-001,2015,4,27,16,732,714,1446,1440
3404-001,2015,4,27,17,760,593,1353,1446
3404-001,2015,4,27,18,1072,576,1648,1353
3404-001,2015,4,27,19,932,507,1439,1648
3404-001,2015,4,27,20,732,351,1083,1439
3404-001,2015,4,27,21,684,280,964,1083
3404-001,2015,4,27,22,380,196,576,964
3404-001,2015,4,27,23,201,129,330,576
3404-001,2015,4,27,24,97,109,206,330
3404-001,2015,4,28,1,36,79,115,206
3404-001,2015,4,28,2,31,56,87,115
3404-001,2015,4,28,3,34,34,68,87
3404-001,2015,4,28,4,18,39,57,68
3404-001,2015,4,28,5,58,83,141,57
3404-001,2015,4,28,6,103,227,330,141
3404-001,2015,4,28,7,187,674,861,330
3404-001,2015,4,28,8,470,1792,2262,861
3404-001,2015,4,28,9,700,1269,1969,2262
3404-001,2015,4,28,10,610,774,1384,1969
3404-001,2015,4,28,11,666,741,1407,1384
3404-001,2015,4,28,12,641,729,1370,1407
3404-001,2015,4,28,13,570,539,1109,1370
3404-001,2015,4,28,14,644,697,1341,1109
3404-001,2015,4,28,15,728,751,1479,1341
3404-001,2015,4,28,16,744,690,1434,1479
3404-001,2015,4,28,17,722,625,1347,1434
3404-001,2015,4,28,18,1024,535,1559,1347
3404-001,2015,4,28,19,944,481,1425,1559
3404-001,2015,4,28,20,740,378,1118,1425
3404-001,2015,4,28,21,674,254,928,1118
3404-001,2015,4,28,22,364,223,587,928
3404-001,2015,4,28,23,192,176,368,587
3404-001,2015,4,28,24,95,115,210,368
3404-001,2015,4,29,1,62,79,141,210
3404-001,2015,4,29,2,19,60,79,141
3404-001,2015,4,29,3,29,41,70,79
3404-001,2015,4,29,4,23,44,67,70
3404-001,2015,4,29,5,60,89,149,67
3404-001,2015,4,29,6,110,190,300,149
3404-001,2015,4,29,7,213,546,759,300
3404-001,2015,4,29,8,454,1658,2112,759
3404-001,2015,4,29,9,721,1255,1976,2112
3404-001,2015,4,29,10,649,661,1310,1976
3404-001,2015,4,29,11,684,713,1397,1310
3404-001,2015,4,29,12,654,616,1270,1397
3404-001,2015,4,29,13,558,545,1103,1270
3404-001,2015,4,29,14,665,591,1256,1103
3404-001,2015,4,29,15,744,649,1393,1256
3404-001,2015,4,29,16,760,610,1370,1393
3404-001,2015,4,29,17,756,542,1298,1370
3404-001,2015,4,29,18,1184,525,1709,1298
3404-001,2015,4,29,19,1030,464,1494,1709
3404-001,2015,4,29,20,722,340,1062,1494
3404-001,2015,4,29,21,594,244,838,1062
3404-001,2015,4,29,22,384,206,590,838
3404-001,2015,4,29,23,233,152,385,590
3404-001,2015,4,29,24,150,113,263,385
3404-001,2015,4,30,1,72,76,148,263
3404-001,2015,4,30,2,53,54,107,148
3404-001,2015,4,30,3,42,44,86,107
3404-001,2015,4,30,4,40,46,86,86
3404-001,2015,4,30,5,58,80,138,86
3404-001,2015,4,30,6,112,232,344,138
3404-001,2015,4,30,7,241,613,854,344
3404-001,2015,4,30,8,506,1802,2308,854
3404-001,2015,4,30,9,763,1197,1960,2308
3404-001,2015,4,30,10,666,706,1372,1960
3404-001,2015,4,30,11,704,793,1497,1372
3404-001,2015,4,30,12,631,679,1310,1497
3404-001,2015,4,30,13,628,512,1140,1310
3404-001,2015,4,30,14,612,634,1246,1140
3404-001,2015,4,30,15,710,682,1392,1246
3404-001,2015,4,30,16,733,662,1395,1392
3404-001,2015,4,30,17,754,597,1351,1395
3404-001,2015,4,30,18,999,642,1641,1351
3404-001,2015,4,30,19,928,555,1483,1641
3404-001,2015,4,30,20,655,449,1104,1483
3404-001,2015,4,30,21,680,311,991,1104
3404-001,2015,4,30,22,378,245,623,991
3404-001,2015,4,30,23,176,183,359,623
3404-001,2015,4,30,24,154,108,262,359
3404-001,2015,5,1,1,49,59,108,262
3404-001,2015,5,1,2,44,43,87,108
3404-001,2015,5,1,3,22,51,73,87
3404-001,2015,5,1,4,30,46,76,73
3404-001,2015,5,1,5,50,66,116,76
3404-001,2015,5,1,6,80,139,219,116
3404-001,2015,5,1,7,210,355,565,219
3404-001,2015,5,1,8,493,876,1369,565
3404-001,2015,5,1,9,740,696,1436,1369
3404-001,2015,5,1,10,672,584,1256,1436
3404-001,2015,5,1,11,721,630,1351,1256
3404-001,2015,5,1,12,680,607,1287,1351
3404-001,2015,5,1,13,598,488,1086,1287
3404-001,2015,5,1,14,662,488,1150,1086
3404-001,2015,5,1,15,760,521,1281,1150
3404-001,2015,5,1,16,772,441,1213,1281
3404-001,2015,5,1,17,826,454,1280,1213
3404-001,2015,5,1,18,1338,482,1820,1280
3404-001,2015,5,1,19,1220,405,1625,1820
3404-001,2015,5,1,20,928,363,1291,1625
3404-001,2015,5,1,21,656,230,886,1291
3404-001,2015,5,1,22,368,180,548,886
3404-001,2015,5,1,23,214,116,330,548
3404-001,2015,5,1,24,108,80,188,330
3404-001,2015,5,2,1,56,69,125,188
3404-001,2015,5,2,2,119,50,169,125
3404-001,2015,5,2,3,33,41,74,169
3404-001,2015,5,2,4,74,30,104,74
3404-001,2015,5,2,5,89,51,140,104
3404-001,2015,5,2,6,220,184,404,140
3404-001,2015,5,2,7,310,341,651,404
3404-001,2015,5,2,8,423,654,1077,651
3404-001,2015,5,2,9,683,597,1280,1077
3404-001,2015,5,2,10,818,545,1363,1280
3404-001,2015,5,2,11,874,610,1484,1363
3404-001,2015,5,2,12,732,577,1309,1484
3404-001,2015,5,2,13,757,600,1357,1309
3404-001,2015,5,2,14,599,503,1102,1357
3404-001,2015,5,2,15,712,493,1205,1102
3404-001,2015,5,2,16,864,488,1352,1205
3404-001,2015,5,2,17,902,427,1329,1352
3404-001,2015,5,2,18,1425,424,1849,1329
3404-001,2015,5,2,19,1212,374,1586,1849
3404-001,2015,5,2,20,333,258,591,1586
3404-001,2015,5,2,21,201,193,394,591
3404-001,2015,5,2,22,142,146,288,394
3404-001,2015,5,2,23,89,119,208,288
3404-001,2015,5,2,24,46,88,134,208
3404-001,2015,5,3,1,44,56,100,134
3404-001,2015,5,3,2,25,34,59,100
3404-001,2015,5,3,3,15,19,34,59
3404-001,2015,5,3,4,19,19,38,34
3404-001,2015,5,3,5,23,32,55,38
3404-001,2015,5,3,6,44,77,121,55
3404-001,2015,5,3,7,72,146,218,121
3404-001,2015,5,3,8,267,216,483,218
3404-001,2015,5,3,9,227,225,452,483
3404-001,2015,5,3,10,244,260,504,452
3404-001,2015,5,3,11,286,296,582,504
3404-001,2015,5,3,12,307,331,638,582
3404-001,2015,5,3,13,316,271,587,638
3404-001,2015,5,3,14,350,298,648,587
3404-001,2015,5,3,15,394,355,749,648
3404-001,2015,5,3,16,437,340,777,749
3404-001,2015,5,3,17,572,366,938,777
3404-001,2015,5,3,18,630,326,956,938
3404-001,2015,5,3,19,536,345,881,956
3404-001,2015,5,3,20,398,264,662,881
3404-001,2015,5,3,21,232,227,459,662
3404-001,2015,5,3,22,136,243,379,459
3404-001,2015,5,3,23,62,221,283,379
3404-001,2015,5,3,24,17,125,142,283
3404-001,2015,5,4,1,17,82,99,142
3404-001,2015,5,4,2,3,46,49,99
3404-001,2015,5,4,3,0,37,37,49
3404-001,2015,5,4,4,9,38,47,37
3404-001,2015,5,4,5,33,68,101,47
3404-001,2015,5,4,6,114,251,365,101
3404-001,2015,5,4,7,198,600,798,365
3404-001,2015,5,4,8,470,1287,1757,798
3404-001,2015,5,4,9,643,872,1515,1757
3404-001,2015,5,4,10,592,593,1185,1515
3404-001,2015,5,4,11,472,680,1152,1185
3404-001,2015,5,4,12,494,597,1091,1152
3404-001,2015,5,4,13,525,571,1096,1091
3404-001,2015,5,4,14,604,621,1225,1096
3404-001,2015,5,4,15,710,619,1329,1225
3404-001,2015,5,4,16,738,560,1298,1329
3404-001,2015,5,4,17,767,518,1285,1298
3404-001,2015,5,4,18,1079,526,1605,1285
3404-001,2015,5,4,19,978,496,1474,1605
3404-001,2015,5,4,20,609,383,992,1474
3404-001,2015,5,4,21,460,288,748,992
3404-001,2015,5,4,22,246,219,465,748
3404-001,2015,5,4,23,123,153,276,465
3404-001,2015,5,4,24,74,98,172,276
3404-001,2015,5,5,1,29,66,95,172
3404-001,2015,5,5,2,33,35,68,95
3404-001,2015,5,5,3,19,37,56,68
3404-001,2015,5,5,4,23,44,67,56
3404-001,2015,5,5,5,33,55,88,67
3404-001,2015,5,5,6,41,203,244,88
3404-001,2015,5,5,7,136,329,465,244
3404-001,2015,5,5,8,222,500,722,465
3404-001,2015,5,5,9,253,466,719,722
3404-001,2015,5,5,10,199,476,675,719
3404-001,2015,5,5,11,279,540,819,675
3404-001,2015,5,5,12,310,509,819,819
3404-001,2015,5,5,13,302,446,748,819
3404-001,2015,5,5,14,296,390,686,748
3404-001,2015,5,5,15,384,428,812,686
3404-001,2015,5,5,16,447,401,848,812
3404-001,2015,5,5,17,490,383,873,848
3404-001,2015,5,5,18,814,337,1151,873
3404-001,2015,5,5,19,507,315,822,1151
3404-001,2015,5,5,20,300,279,579,822
3404-001,2015,5,5,21,236,218,454,579
3404-001,2015,5,5,22,107,198,305,454
3404-001,2015,5,5,23,62,160,222,305
3404-001,2015,5,5,24,27,97,124,222
3404-001,2015,5,6,1,37,87,124,124
3404-001,2015,5,6,2,15,35,50,124
3404-001,2015,5,6,3,9,31,40,50
3404-001,2015,5,6,4,15,39,54,40
3404-001,2015,5,6,5,25,83,108,54
3404-001,2015,5,6,6,87,263,350,108
3404-001,2015,5,6,7,230,734,964,350
3404-001,2015,5,6,8,470,1949,2419,964
3404-001,2015,5,6,9,611,1277,1888,2419
3404-001,2015,5,6,10,591,745,1336,1888
3404-001,2015,5,6,11,671,684,1355,1336
3404-001,2015,5,6,12,609,650,1259,1355
3404-001,2015,5,6,13,556,593,1149,1259
3404-001,2015,5,6,14,556,644,1200,1149
3404-001,2015,5,6,15,753,697,1450,1200
3404-001,2015,5,6,16,833,636,1469,1450
3404-001,2015,5,6,17,722,593,1315,1469
3404-001,2015,5,6,18,1336,543,1879,1315
3404-001,2015,5,6,19,1085,530,1615,1879
3404-001,2015,5,6,20,648,388,1036,1615
3404-001,2015,5,6,21,644,256,900,1036
3404-001,2015,5,6,22,351,220,571,900
3404-001,2015,5,6,23,156,176,332,571
3404-001,2015,5,6,24,80,136,216,332
3404-001,2015,5,7,1,80,68,148,216
3404-001,2015,5,7,2,25,47,72,148
3404-001,2015,5,7,3,17,48,65,72
3404-001,2015,5,7,4,25,46,71,65
3404-001,2015,5,7,5,37,75,112,71
3404-001,2015,5,7,6,85,250,335,112
3404-001,2015,5,7,7,236,638,874,335
3404-001,2015,5,7,8,437,1805,2242,874
3404-001,2015,5,7,9,683,1282,1965,2242
3404-001,2015,5,7,10,753,702,1455,1965
3404-001,2015,5,7,11,736,726,1462,1455
3404-001,2015,5,7,12,634,601,1235,1462
3404-001,2015,5,7,13,466,532,998,1235
3404-001,2015,5,7,14,531,630,1161,998
3404-001,2015,5,7,15,728,640,1368,1161
3404-001,2015,5,7,16,806,638,1444,1368
3404-001,2015,5,7,17,743,579,1322,1444
3404-001,2015,5,7,18,1256,580,1836,1322
3404-001,2015,5,7,19,1138,468,1606,1836
3404-001,2015,5,7,20,732,426,1158,1606
3404-001,2015,5,7,21,736,303,1039,1158
3404-001,2015,5,7,22,359,227,586,1039
3404-001,2015,5,7,23,136,162,298,586
3404-001,2015,5,7,24,74,113,187,298
3404-001,2015,5,8,1,37,76,113,187
3404-001,2015,5,8,2,33,46,79,113
3404-001,2015,5,8,3,33,49,82,79
3404-001,2015,5,8,4,19,53,72,82
3404-001,2015,5,8,5,54,76,130,72
3404-001,2015,5,8,6,93,268,361,130
3404-001,2015,5,8,7,244,695,939,361
3404-001,2015,5,8,8,480,1755,2235,939
3404-001,2015,5,8,9,773,1243,2016,2235
3404-001,2015,5,8,10,591,785,1376,2016
3404-001,2015,5,8,11,763,723,1486,1376
3404-001,2015,5,8,12,763,692,1455,1486
3404-001,2015,5,8,13,570,605,1175,1455
3404-001,2015,5,8,14,652,652,1304,1175
3404-001,2015,5,8,15,816,665,1481,1304
3404-001,2015,5,8,16,952,698,1650,1481
3404-001,2015,5,8,17,911,603,1514,1650
3404-001,2015,5,8,18,1612,651,2263,1514
3404-001,2015,5,8,19,1513,656,2169,2263
3404-001,2015,5,8,20,952,510,1462,2169
3404-001,2015,5,8,21,642,290,932,1462
3404-001,2015,5,8,22,300,256,556,932
3404-001,2015,5,8,23,156,168,324,556
3404-001,2015,5,8,24,78,110,188,324
3404-001,2015,5,9,1,35,69,104,188
3404-001,2015,5,9,2,29,48,77,104
3404-001,2015,5,9,3,27,41,68,77
3404-001,2015,5,9,4,19,41,60,68
3404-001,2015,5,9,5,35,57,92,60
3404-001,2015,5,9,6,105,230,335,92
3404-001,2015,5,9,7,171,436,607,335
3404-001,2015,5,9,8,283,758,1041,607
3404-001,2015,5,9,9,474,712,1186,1041
3404-001,2015,5,9,10,451,559,1010,1186
3404-001,2015,5,9,11,456,585,1041,1010
3404-001,2015,5,9,12,523,623,1146,1041
3404-001,2015,5,9,13,445,548,993,1146
3404-001,2015,5,9,14,433,502,935,993
3404-001,2015,5,9,15,460,554,1014,935
3404-001,2015,5,9,16,490,469,959,1014
3404-001,2015,5,9,17,562,420,982,959
3404-001,2015,5,9,18,809,402,1211,982
3404-001,2015,5,9,19,536,418,954,1211
3404-001,2015,5,9,20,292,333,625,954
3404-001,2015,5,9,21,208,222,430,625
3404-001,2015,5,9,22,148,192,340,430
3404-001,2015,5,9,23,85,129,214,340
3404-001,2015,5,9,24,41,79,120,214
3404-001,2015,5,10,1,27,46,73,120
3404-001,2015,5,10,2,27,33,60,73
3404-001,2015,5,10,3,19,19,38,60
3404-001,2015,5,10,4,9,33,42,38
3404-001,2015,5,10,5,13,40,53,42
3404-001,2015,5,10,6,23,110,133,53
3404-001,2015,5,10,7,64,206,270,133
3404-001,2015,5,10,8,103,300,403,270
3404-001,2015,5,10,9,148,279,427,403
3404-001,2015,5,10,10,136,288,424,427
3404-001,2015,5,10,11,208,360,568,424
3404-001,2015,5,10,12,175,356,531,568
3404-001,2015,5,10,13,226,339,565,531
3404-001,2015,5,10,14,160,341,501,565
3404-001,2015,5,10,15,273,363,636,501
3404-001,2015,5,10,16,347,303,650,636
3404-001,2015,5,10,17,359,331,690,650
3404-001,2015,5,10,18,564,333,897,690
3404-001,2015,5,10,19,554,363,917,897
3404-001,2015,5,10,20,283,288,571,917
3404-001,2015,5,10,21,164,263,427,571
3404-001,2015,5,10,22,148,240,388,427
3404-001,2015,5,10,23,70,169,239,388
3404-001,2015,5,10,24,41,109,150,239
3404-001,2015,5,11,1,13,82,95,150
3404-001,2015,5,11,2,23,50,73,95
3404-001,2015,5,11,3,13,38,51,73
3404-001,2015,5,11,4,7,43,50,51
3404-001,2015,5,11,5,21,84,105,50
3404-001,2015,5,11,6,87,277,364,105
3404-001,2015,5,11,7,218,775,993,364
3404-001,2015,5,11,8,458,1914,2372,993
3404-001,2015,5,11,9,710,1301,2011,2372
3404-001,2015,5,11,10,511,709,1220,2011
3404-001,2015,5,11,11,626,698,1324,1220
3404-001,2015,5,11,12,564,625,1189,1324
3404-001,2015,5,11,13,492,573,1065,1189
3404-001,2015,5,11,14,495,637,1132,1065
3404-001,2015,5,11,15,679,602,1281,1132
3404-001,2015,5,11,16,677,662,1339,1281
3404-001,2015,5,11,17,718,558,1276,1339
3404-001,2015,5,11,18,1266,511,1777,1276
3404-001,2015,5,11,19,1009,507,1516,1777
3404-001,2015,5,11,20,722,348,1070,1516
3404-001,2015,5,11,21,642,247,889,1070
3404-001,2015,5,11,22,269,196,465,889
3404-001,2015,5,11,23,115,147,262,465
3404-001,2015,5,11,24,44,88,132,262
3404-001,2015,5,12,1,58,64,122,132
3404-001,2015,5,12,2,35,38,73,122
3404-001,2015,5,12,3,25,35,60,73
3404-001,2015,5,12,4,15,48,63,60
3404-001,2015,5,12,5,31,79,110,63
3404-001,2015,5,12,6,87,163,250,110
3404-001,2015,5,12,7,177,550,727,250
3404-001,2015,5,12,8,404,1732,2136,727
3404-001,2015,5,12,9,706,1170,1876,2136
3404-001,2015,5,12,10,564,692,1256,1876
3404-001,2015,5,12,11,628,639,1267,1256
3404-001,2015,5,12,12,615,615,1230,1267
3404-001,2015,5,12,13,503,579,1082,1230
3404-001,2015,5,12,14,538,627,1165,1082
3404-001,2015,5,12,15,673,642,1315,1165
3404-001,2015,5,12,16,720,571,1291,1315
3404-001,2015,5,12,17,765,563,1328,1291
3404-001,2015,5,12,18,1019,556,1575,1328
3404-001,2015,5,12,19,1044,457,1501,1575
3404-001,2015,5,12,20,646,420,1066,1501
3404-001,2015,5,12,21,540,266,806,1066
3404-001,2015,5,12,22,300,193,493,806
3404-001,2015,5,12,23,117,133,250,493
3404-001,2015,5,12,24,58,93,151,250
3404-001,2015,5,13,1,23,79,102,151
3404-001,2015,5,13,2,21,49,70,102
3404-001,2015,5,13,3,13,52,65,70
3404-001,2015,5,13,4,17,53,70,65
3404-001,2015,5,13,5,44,68,112,70
3404-001,2015,5,13,6,66,233,299,112
3404-001,2015,5,13,7,201,666,867,299
3404-001,2015,5,13,8,433,1786,2219,867
3404-001,2015,5,13,9,736,1256,1992,2219
3404-001,2015,5,13,10,591,711,1302,1992
3404-001,2015,5,13,11,628,691,1319,1302
3404-001,2015,5,13,12,697,619,1316,1319
3404-001,2015,5,13,13,599,557,1156,1316
3404-001,2015,5,13,14,638,634,1272,1156
3404-001,2015,5,13,15,747,725,1472,1272
3404-001,2015,5,13,16,777,650,1427,1472
3404-001,2015,5,13,17,763,600,1363,1427
3404-001,2015,5,13,18,1202,561,1763,1363
3404-001,2015,5,13,19,1167,504,1671,1763
3404-001,2015,5,13,20,693,386,1079,1671
3404-001,2015,5,13,21,529,246,775,1079
3404-001,2015,5,13,22,271,218,489,775
3404-001,2015,5,13,23,148,163,311,489
3404-001,2015,5,13,24,115,122,237,311
3404-001,2015,5,14,1,39,96,135,237
3404-001,2015,5,14,2,33,65,98,135
3404-001,2015,5,14,3,17,57,74,98
3404-001,2015,5,14,4,25,50,75,74
3404-001,2015,5,14,5,46,67,113,75
3404-001,2015,5,14,6,134,226,360,113
3404-001,2015,5,14,7,263,629,892,360
3404-001,2015,5,14,8,431,1742,2173,892
3404-001,2015,5,14,9,751,1250,2001,2173
3404-001,2015,5,14,10,609,705,1314,2001
3404-001,2015,5,14,11,589,745,1334,1314
3404-001,2015,5,14,12,615,597,1212,1334
3404-001,2015,5,14,13,497,526,1023,1212
3404-001,2015,5,14,14,622,632,1254,1023
3404-001,2015,5,14,15,771,690,1461,1254
3404-001,2015,5,14,16,802,642,1444,1461
3404-001,2015,5,14,17,853,571,1424,1444
3404-001,2015,5,14,18,1180,609,1789,1424
3404-001,2015,5,14,19,1103,526,1629,1789
3404-001,2015,5,14,20,759,380,1139,1629
3404-001,2015,5,14,21,702,273,975,1139
3404-001,2015,5,14,22,316,215,531,975
3404-001,2015,5,14,23,144,165,309,531
3404-001,2015,5,14,24,72,96,168,309
3404-001,2015,5,15,1,74,84,158,168
3404-001,2015,5,15,2,52,58,110,158
3404-001,2015,5,15,3,27,48,75,110
3404-001,2015,5,15,4,19,49,68,75
3404-001,2015,5,15,5,39,71,110,68
3404-001,2015,5,15,6,107,237,344,110
3404-001,2015,5,15,7,197,642,839,344
3404-001,2015,5,15,8,462,1684,2146,839
3404-001,2015,5,15,9,730,1247,1977,2146
3404-001,2015,5,15,10,599,758,1357,1977
3404-001,2015,5,15,11,794,698,1492,1357
3404-001,2015,5,15,12,638,596,1234,1492
3404-001,2015,5,15,13,618,551,1169,1234
3404-001,2015,5,15,14,613,668,1281,1169
3404-001,2015,5,15,15,700,746,1446,1281
3404-001,2015,5,15,16,868,626,1494,1446
3404-001,2015,5,15,17,890,571,1461,1494
3404-001,2015,5,15,18,1385,582,1967,1461
3404-001,2015,5,15,19,1325,584,1909,1967
3404-001,2015,5,15,20,839,457,1296,1909
3404-001,2015,5,15,21,556,281,837,1296
3404-001,2015,5,15,22,290,237,527,837
3404-001,2015,5,15,23,162,160,322,527
3404-001,2015,5,15,24,82,108,190,322
3404-001,2015,5,16,1,64,80,144,190
3404-001,2015,5,16,2,37,59,96,144
3404-001,2015,5,16,3,17,38,55,96
3404-001,2015,5,16,4,13,30,43,55
3404-001,2015,5,16,5,37,81,118,43
3404-001,2015,5,16,6,78,206,284,118
3404-001,2015,5,16,7,191,436,627,284
3404-001,2015,5,16,8,304,772,1076,627
3404-001,2015,5,16,9,507,683,1190,1076
3404-001,2015,5,16,10,499,592,1091,1190
3404-001,2015,5,16,11,472,610,1082,1091
3404-001,2015,5,16,12,478,569,1047,1082
3404-001,2015,5,16,13,470,442,912,1047
3404-001,2015,5,16,14,413,467,880,912
3404-001,2015,5,16,15,505,478,983,880
3404-001,2015,5,16,16,480,441,921,983
3404-001,2015,5,16,17,585,462,1047,921
3404-001,2015,5,16,18,881,449,1330,1047
3404-001,2015,5,16,19,445,433,878,1330
3404-001,2015,5,16,20,267,289,556,878
3404-001,2015,5,16,21,222,210,432,556
3404-001,2015,5,16,22,132,184,316,432
3404-001,2015,5,16,23,91,133,224,316
3404-001,2015,5,16,24,50,77,127,224
3404-001,2015,5,17,1,41,48,89,127
3404-001,2015,5,17,2,21,47,68,89
3404-001,2015,5,17,3,17,37,54,68
3404-001,2015,5,17,4,19,26,45,54
3404-001,2015,5,17,5,15,36,51,45
3404-001,2015,5,17,6,21,105,126,51
3404-001,2015,5,17,7,68,210,278,126
3404-001,2015,5,17,8,126,283,409,278
3404-001,2015,5,17,9,156,274,430,409
3404-001,2015,5,17,10,140,313,453,430
3404-001,2015,5,17,11,183,336,519,453
3404-001,2015,5,17,12,164,331,495,519
3404-001,2015,5,17,13,216,328,544,495
3404-001,2015,5,17,14,210,328,538,544
3404-001,2015,5,17,15,261,343,604,538
3404-001,2015,5,17,16,318,380,698,604
3404-001,2015,5,17,17,357,325,682,698
3404-001,2015,5,17,18,438,348,786,682
3404-001,2015,5,17,19,372,333,705,786
3404-001,2015,5,17,20,216,311,527,705
3404-001,2015,5,17,21,169,251,420,527
3404-001,2015,5,17,22,107,207,314,420
3404-001,2015,5,17,23,60,174,234,314
3404-001,2015,5,17,24,50,135,185,234
3404-001,2015,5,18,1,29,80,109,185
3404-001,2015,5,18,2,11,37,48,109
3404-001,2015,5,18,3,7,51,58,48
3404-001,2015,5,18,4,7,33,40,58
3404-001,2015,5,18,5,19,77,96,40
3404-001,2015,5,18,6,105,275,380,96
3404-001,2015,5,18,7,208,741,949,380
3404-001,2015,5,18,8,480,1974,2454,949
3404-001,2015,5,18,9,716,1283,1999,2454
3404-001,2015,5,18,10,607,643,1250,1999
3404-001,2015,5,18,11,638,725,1363,1250
3404-001,2015,5,18,12,671,657,1328,1363
3404-001,2015,5,18,13,521,563,1084,1328
3404-001,2015,5,18,14,697,680,1377,1084
3404-001,2015,5,18,15,738,704,1442,1377
3404-001,2015,5,18,16,695,667,1362,1442
3404-001,2015,5,18,17,755,610,1365,1362
3404-001,2015,5,18,18,1231,567,1798,1365
3404-001,2015,5,18,19,1054,530,1584,1798
3404-001,2015,5,18,20,763,387,1150,1584
3404-001,2015,5,18,21,743,277,1020,1150
3404-001,2015,5,18,22,314,231,545,1020
3404-001,2015,5,18,23,160,146,306,545
3404-001,2015,5,18,24,62,109,171,306
3404-001,2015,5,19,1,58,79,137,171
3404-001,2015,5,19,2,31,54,85,137
3404-001,2015,5,19,3,29,54,83,85
3404-001,2015,5,19,4,31,49,80,83
3404-001,2015,5,19,5,46,85,131,80
3404-001,2015,5,19,6,105,261,366,131
3404-001,2015,5,19,7,191,649,840,366
3404-001,2015,5,19,8,478,1767,2245,840
3404-001,2015,5,19,9,835,1251,2086,2245
3404-001,2015,5,19,10,613,721,1334,2086
3404-001,2015,5,19,11,802,688,1490,1334
3404-001,2015,5,19,12,595,669,1264,1490
3404-001,2015,5,19,13,548,526,1074,1264
3404-001,2015,5,19,14,533,647,1180,1074
3404-001,2015,5,19,15,751,699,1450,1180
3404-001,2015,5,19,16,888,633,1521,1450
3404-001,2015,5,19,17,773,588,1361,1521
3404-001,2015,5,19,18,1275,601,1876,1361
3404-001,2015,5,19,19,1021,488,1509,1876
3404-001,2015,5,19,20,661,372,1033,1509
3404-001,2015,5,19,21,572,258,830,1033
3404-001,2015,5,19,22,328,226,554,830
3404-001,2015,5,19,23,146,159,305,554
3404-001,2015,5,19,24,85,106,191,305
3404-001,2015,5,20,1,44,72,116,191
3404-001,2015,5,20,2,37,66,103,116
3404-001,2015,5,20,3,17,46,63,103
3404-001,2015,5,20,4,23,52,75,63
3404-001,2015,5,20,5,48,73,121,75
3404-001,2015,5,20,6,109,229,338,121
3404-001,2015,5,20,7,201,630,831,338
3404-001,2015,5,20,8,470,1754,2224,831
3404-001,2015,5,20,9,769,1260,2029,2224
3404-001,2015,5,20,10,564,707,1271,2029
3404-001,2015,5,20,11,697,683,1380,1271
3404-001,2015,5,20,12,599,623,1222,1380
3404-001,2015,5,20,13,587,587,1174,1222
3404-001,2015,5,20,14,568,634,1202,1174
3404-001,2015,5,20,15,753,677,1430,1202
3404-001,2015,5,20,16,710,636,1346,1430
3404-001,2015,5,20,17,761,569,1330,1346
3404-001,2015,5,20,18,1309,588,1897,1330
3404-001,2015,5,20,19,1093,517,1610,1897
3404-001,2015,5,20,20,665,387,1052,1610
3404-001,2015,5,20,21,507,249,756,1052
3404-001,2015,5,20,22,249,207,456,756
3404-001,2015,5,20,23,148,166,314,456
3404-001,2015,5,20,24,107,105,212,314
3404-001,2015,5,21,1,52,75,127,212
3404-001,2015,5,21,2,39,41,80,127
3404-001,2015,5,21,3,19,61,80,80
3404-001,2015,5,21,4,25,48,73,80
3404-001,2015,5,21,5,60,76,136,73
3404-001,2015,5,21,6,113,272,385,136
3404-001,2015,5,21,7,263,661,924,385
3404-001,2015,5,21,8,472,1713,2185,924
3404-001,2015,5,21,9,663,1282,1945,2185
3404-001,2015,5,21,10,661,713,1374,1945
3404-001,2015,5,21,11,640,697,1337,1374
3404-001,2015,5,21,12,570,648,1218,1337
3404-001,2015,5,21,13,611,532,1143,1218
3404-001,2015,5,21,14,632,682,1314,1143
3404-001,2015,5,21,15,777,681,1458,1314
3404-001,2015,5,21,16,855,671,1526,1458
3404-001,2015,5,21,17,771,605,1376,1526
3404-001,2015,5,21,18,1249,630,1879,1376
3404-001,2015,5,21,19,1052,516,1568,1879
3404-001,2015,5,21,20,765,392,1157,1568
3404-001,2015,5,21,21,618,268,886,1157
3404-001,2015,5,21,22,339,229,568,886
3404-001,2015,5,21,23,173,163,336,568
3404-001,2015,5,21,24,93,110,203,336
3404-001,2015,5,22,1,44,74,118,203
3404-001,2015,5,22,2,46,50,96,118
3404-001,2015,5,22,3,27,57,84,96
3404-001,2015,5,22,4,23,50,73,84
3404-001,2015,5,22,5,46,88,134,73
3404-001,2015,5,22,6,115,256,371,134
3404-001,2015,5,22,7,216,690,906,371
3404-001,2015,5,22,8,513,1725,2238,906
3404-001,2015,5,22,9,734,1209,1943,2238
3404-001,2015,5,22,10,574,629,1203,1943
3404-001,2015,5,22,11,667,793,1460,1203
3404-001,2015,5,22,12,663,640,1303,1460
3404-001,2015,5,22,13,624,562,1186,1303
3404-001,2015,5,22,14,665,663,1328,1186
3404-001,2015,5,22,15,798,696,1494,1328
3404-001,2015,5,22,16,829,726,1555,1494
3404-001,2015,5,22,17,845,639,1484,1555
3404-001,2015,5,22,18,1419,650,2069,1484
3404-001,2015,5,22,19,1399,590,1989,2069
3404-001,2015,5,22,20,866,539,1405,1989
3404-001,2015,5,22,21,640,317,957,1405
3404-001,2015,5,22,22,335,218,553,957
3404-001,2015,5,22,23,162,128,290,553
3404-001,2015,5,22,24,113,128,241,290
3404-001,2015,5,23,1,41,86,127,241
3404-001,2015,5,23,2,33,54,87,127
3404-001,2015,5,23,3,25,45,70,87
3404-001,2015,5,23,4,29,46,75,70
3404-001,2015,5,23,5,48,66,114,75
3404-001,2015,5,23,6,97,226,323,114
3404-001,2015,5,23,7,203,449,652,323
3404-001,2015,5,23,8,294,844,1138,652
3404-001,2015,5,23,9,550,715,1265,1138
3404-001,2015,5,23,10,433,674,1107,1265
3404-001,2015,5,23,11,488,675,1163,1107
3404-001,2015,5,23,12,451,647,1098,1163
3404-001,2015,5,23,13,398,603,1001,1098
3404-001,2015,5,23,14,466,676,1142,1001
3404-001,2015,5,23,15,517,592,1109,1142
3404-001,2015,5,23,16,540,583,1123,1109
3404-001,2015,5,23,17,589,636,1225,1123
3404-001,2015,5,23,18,789,540,1329,1225
3404-001,2015,5,23,19,593,454,1047,1329
3404-001,2015,5,23,20,287,348,635,1047
3404-001,2015,5,23,21,189,223,412,635
3404-001,2015,5,23,22,140,142,282,412
3404-001,2015,5,23,23,58,114,172,282
3404-001,2015,5,23,24,64,82,146,172
3404-001,2015,5,24,1,33,56,89,146
3404-001,2015,5,24,2,27,40,67,89
3404-001,2015,5,24,3,13,29,42,67
3404-001,2015,5,24,4,7,32,39,42
3404-001,2015,5,24,5,25,42,67,39
3404-001,2015,5,24,6,44,102,146,67
3404-001,2015,5,24,7,52,231,283,146
3404-001,2015,5,24,8,148,293,441,283
3404-001,2015,5,24,9,175,276,451,441
3404-001,2015,5,24,10,148,337,485,451
3404-001,2015,5,24,11,187,452,639,485
3404-001,2015,5,24,12,195,425,620,639
3404-001,2015,5,24,13,164,391,555,620
3404-001,2015,5,24,14,152,383,535,555
3404-001,2015,5,24,15,265,378,643,535
3404-001,2015,5,24,16,339,336,675,643
3404-001,2015,5,24,17,408,349,757,675
3404-001,2015,5,24,18,505,334,839,757
3404-001,2015,5,24,19,369,341,710,839
3404-001,2015,5,24,20,404,264,668,710
3404-001,2015,5,24,21,357,239,596,668
3404-001,2015,5,24,22,175,150,325,596
3404-001,2015,5,24,23,74,151,225,325
3404-001,2015,5,24,24,31,88,119,225
3404-001,2015,5,25,1,9,44,53,119
3404-001,2015,5,25,2,15,41,56,53
3404-001,2015,5,25,3,7,41,48,56
3404-001,2015,5,25,4,9,20,29,48
3404-001,2015,5,25,5,17,53,70,29
3404-001,2015,5,25,6,39,201,240,70
3404-001,2015,5,25,7,115,375,490,240
3404-001,2015,5,25,8,175,671,846,490
3404-001,2015,5,25,9,353,446,799,846
3404-001,2015,5,25,10,304,438,742,799
3404-001,2015,5,25,11,283,437,720,742
3404-001,2015,5,25,12,349,489,838,720
3404-001,2015,5,25,13,335,423,758,838
3404-001,2015,5,25,14,427,421,848,758
3404-001,2015,5,25,15,544,403,947,848
3404-001,2015,5,25,16,630,385,1015,947
3404-001,2015,5,25,17,962,373,1335,1015
3404-001,2015,5,25,18,1050,370,1420,1335
3404-001,2015,5,25,19,652,342,994,1420
3404-001,2015,5,25,20,388,313,701,994
3404-001,2015,5,25,21,244,281,525,701
3404-001,2015,5,25,22,126,251,377,525
3404-001,2015,5,25,23,78,186,264,377
3404-001,2015,5,25,24,37,120,157,264
3404-001,2015,5,26,1,25,78,103,157
3404-001,2015,5,26,2,29,51,80,103
3404-001,2015,5,26,3,7,38,45,80
3404-001,2015,5,26,4,25,40,65,45
3404-001,2015,5,26,5,35,85,120,65
3404-001,2015,5,26,6,111,301,412,120
3404-001,2015,5,26,7,242,741,983,412
3404-001,2015,5,26,8,476,1961,2437,983
3404-001,2015,5,26,9,700,1200,1900,2437
3404-001,2015,5,26,10,605,721,1326,1900
3404-001,2015,5,26,11,671,720,1391,1326
3404-001,2015,5,26,12,638,653,1291,1391
3404-001,2015,5,26,13,548,559,1107,1291
3404-001,2015,5,26,14,661,679,1340,1107
3404-001,2015,5,26,15,745,747,1492,1340
3404-001,2015,5,26,16,876,620,1496,1492
3404-001,2015,5,26,17,790,640,1430,1496
3404-001,2015,5,26,18,1249,551,1800,1430
3404-001,2015,5,26,19,1056,508,1564,1800
3404-001,2015,5,26,20,798,435,1233,1564
3404-001,2015,5,26,21,615,261,876,1233
3404-001,2015,5,26,22,339,219,558,876
3404-001,2015,5,26,23,148,147,295,558
3404-001,2015,5,26,24,68,82,150,295
3404-001,2015,5,27,1,54,74,128,150
3404-001,2015,5,27,2,48,67,115,128
3404-001,2015,5,27,3,27,44,71,115
3404-001,2015,5,27,4,37,42,79,71
3404-001,2015,5,27,5,62,85,147,79
3404-001,2015,5,27,6,117,247,364,147
3404-001,2015,5,27,7,189,644,833,364
3404-001,2015,5,27,8,497,1793,2290,833
3404-001,2015,5,27,9,714,1214,1928,2290
3404-001,2015,5,27,10,632,733,1365,1928
3404-001,2015,5,27,11,656,733,1389,1365
3404-001,2015,5,27,12,669,666,1335,1389
3404-001,2015,5,27,13,540,521,1061,1335
3404-001,2015,5,27,14,632,673,1305,1061
3404-001,2015,5,27,15,757,679,1436,1305
3404-001,2015,5,27,16,941,625,1566,1436
3404-001,2015,5,27,17,741,576,1317,1566
3404-001,2015,5,27,18,1396,624,2020,1317
3404-001,2015,5,27,19,1191,499,1690,2020
3404-001,2015,5,27,20,784,412,1196,1690
3404-001,2015,5,27,21,556,289,845,1196
3404-001,2015,5,27,22,312,203,515,845
3404-001,2015,5,27,23,177,152,329,515
3404-001,2015,5,27,24,95,95,190,329
3404-001,2015,5,28,1,72,81,153,190
3404-001,2015,5,28,2,41,53,94,153
3404-001,2015,5,28,3,27,41,68,94
3404-001,2015,5,28,4,33,40,73,68
3404-001,2015,5,28,5,58,73,131,73
3404-001,2015,5,28,6,146,258,404,131
3404-001,2015,5,28,7,263,675,938,404
3404-001,2015,5,28,8,472,1804,2276,938
3404-001,2015,5,28,9,841,1240,2081,2276
3404-001,2015,5,28,10,615,710,1325,2081
3404-001,2015,5,28,11,636,744,1380,1325
3404-001,2015,5,28,12,697,666,1363,1380
3404-001,2015,5,28,13,624,584,1208,1363
3404-001,2015,5,28,14,630,680,1310,1208
3404-001,2015,5,28,15,790,726,1516,1310
3404-001,2015,5,28,16,751,661,1412,1516
3404-001,2015,5,28,17,818,606,1424,1412
3404-001,2015,5,28,18,1312,594,1906,1424
3404-001,2015,5,28,19,939,489,1428,1906
3404-001,2015,5,28,20,796,399,1195,1428
3404-001,2015,5,28,21,634,278,912,1195
3404-001,2015,5,28,22,333,264,597,912
3404-001,2015,5,28,23,171,147,318,597
3404-001,2015,5,28,24,76,115,191,318
3404-001,2015,5,29,1,59,79,138,191
3404-001,2015,5,29,2,49,54,103,138
3404-001,2015,5,29,3,27,53,80,103
3404-001,2015,5,29,4,21,50,71,80
3404-001,2015,5,29,5,43,80,123,71
3404-001,2015,5,29,6,111,247,358,123
3404-001,2015,5,29,7,207,666,873,358
3404-001,2015,5,29,8,488,1705,2193,873
3404-001,2015,5,29,9,732,1228,1960,2193
3404-001,2015,5,29,10,587,694,1281,1960
3404-001,2015,5,29,11,731,746,1477,1281
3404-001,2015,5,29,12,651,618,1269,1477
3404-001,2015,5,29,13,621,557,1178,1269
3404-001,2015,5,29,14,639,666,1305,1178
3404-001,2015,5,29,15,749,721,1470,1305
3404-001,2015,5,29,16,849,676,1525,1470
3404-001,2015,5,29,17,868,605,1473,1525
3404-001,2015,5,29,18,1402,616,2018,1473
3404-001,2015,5,29,19,1362,587,1949,2018
3404-001,2015,5,29,20,853,498,1351,1949
3404-001,2015,5,29,21,598,299,897,1351
3404-001,2015,5,29,22,313,228,541,897
3404-001,2015,5,29,23,162,144,306,541
3404-001,2015,5,29,24,98,118,216,306
3404-001,2015,5,30,1,53,83,136,216
3404-001,2015,5,30,2,35,57,92,136
3404-001,2015,5,30,3,21,42,63,92
3404-001,2015,5,30,4,21,38,59,63
3404-001,2015,5,30,5,43,74,117,59
3404-001,2015,5,30,6,88,216,304,117
3404-001,2015,5,30,7,197,443,640,304
3404-001,2015,5,30,8,299,808,1107,640
3404-001,2015,5,30,9,529,699,1228,1107
3404-001,2015,5,30,10,466,633,1099,1228
3404-001,2015,5,30,11,480,643,1123,1099
3404-001,2015,5,30,12,465,608,1073,1123
3404-001,2015,5,30,13,434,523,957,1073
3404-001,2015,5,30,14,440,572,1012,957
3404-001,2015,5,30,15,511,535,1046,1012
3404-001,2015,5,30,16,510,512,1022,1046
3404-001,2015,5,30,17,587,549,1136,1022
3404-001,2015,5,30,18,835,495,1330,1136
3404-001,2015,5,30,19,519,444,963,1330
3404-001,2015,5,30,20,277,319,596,963
3404-001,2015,5,30,21,206,217,423,596
3404-001,2015,5,30,22,136,163,299,423
3404-001,2015,5,30,23,75,124,199,299
3404-001,2015,5,30,24,57,80,137,199
3404-001,2015,5,31,1,37,52,89,137
3404-001,2015,5,31,2,24,44,68,89
3404-001,2015,5,31,3,15,33,48,68
3404-001,2015,5,31,4,13,29,42,48
3404-001,2015,5,31,5,20,39,59,42
3404-001,2015,5,31,6,33,104,137,59
3404-001,2015,5,31,7,60,221,281,137
3404-001,2015,5,31,8,137,288,425,281
3404-001,2015,5,31,9,166,275,441,425
3404-001,2015,5,31,10,144,325,469,441
3404-001,2015,5,31,11,185,394,579,469
3404-001,2015,5,31,12,180,378,558,579
3404-001,2015,5,31,13,190,360,550,558
3404-001,2015,5,31,14,181,356,537,550
3404-001,2015,5,31,15,263,361,624,537
3404-001,2015,5,31,16,329,358,687,624
3404-001,2015,5,31,17,383,337,720,687
3404-001,2015,5,31,18,472,341,813,720
3404-001,2015,5,31,19,371,337,708,813
3404-001,2015,5,31,20,310,288,598,708
3404-001,2015,5,31,21,263,245,508,598
3404-001,2015,5,31,22,141,179,320,508
3404-001,2015,5,31,23,67,163,230,320
3404-001,2015,5,31,24,41,112,153,230
3404-001,2015,6,1,1,25,80,105,153
3404-001,2015,6,1,2,20,49,69,105
3404-001,2015,6,1,3,10,40,50,69
3404-001,2015,6,1,4,9,39,48,50
3404-001,2015,6,1,5,25,83,108,48
3404-001,2015,6,1,6,101,294,395,108
3404-001,2015,6,1,7,249,768,1017,395
3404-001,2015,6,1,8,486,1921,2407,1017
3404-001,2015,6,1,9,690,1292,1982,2407
3404-001,2015,6,1,10,590,702,1292,1982
3404-001,2015,6,1,11,618,702,1320,1292
3404-001,2015,6,1,12,597,623,1220,1320
3404-001,2015,6,1,13,500,581,1081,1220
3404-001,2015,6,1,14,521,623,1144,1081
3404-001,2015,6,1,15,742,640,1382,1144
3404-001,2015,6,1,16,717,644,1361,1382
3404-001,2015,6,1,17,770,580,1350,1361
3404-001,2015,6,1,18,1206,524,1730,1350
3404-001,2015,6,1,19,1068,479,1547,1730
3404-001,2015,6,1,20,764,377,1141,1547
3404-001,2015,6,1,21,673,255,928,1141
3404-001,2015,6,1,22,302,193,495,928
3404-001,2015,6,1,23,141,143,284,495
3404-001,2015,6,1,24,56,95,151,284
3404-001,2015,6,2,1,48,68,116,151
3404-001,2015,6,2,2,40,51,91,116
3404-001,2015,6,2,3,21,36,57,91
3404-001,2015,6,2,4,22,44,66,57
3404-001,2015,6,2,5,49,78,127,66
3404-001,2015,6,2,6,102,222,324,127
3404-001,2015,6,2,7,205,616,821,324
3404-001,2015,6,2,8,486,1725,2211,821
3404-001,2015,6,2,9,741,1199,1940,2211
3404-001,2015,6,2,10,621,709,1330,1940
3404-001,2015,6,2,11,677,652,1329,1330
3404-001,2015,6,2,12,633,641,1274,1329
3404-001,2015,6,2,13,585,557,1142,1274
3404-001,2015,6,2,14,580,626,1206,1142
3404-001,2015,6,2,15,730,635,1365,1206
3404-001,2015,6,2,16,721,643,1364,1365
3404-001,2015,6,2,17,815,579,1394,1364
3404-001,2015,6,2,18,1120,550,1670,1394
3404-001,2015,6,2,19,1042,474,1516,1670
3404-001,2015,6,2,20,758,420,1178,1516
3404-001,2015,6,2,21,668,262,930,1178
3404-001,2015,6,2,22,351,203,554,930
3404-001,2015,6,2,23,133,147,280,554
3404-001,2015,6,2,24,82,101,183,280
3404-001,2015,6,3,1,46,81,127,183
3404-001,2015,6,3,2,34,56,90,127
3404-001,2015,6,3,3,14,42,56,90
3404-001,2015,6,3,4,18,48,66,56
3404-001,2015,6,3,5,53,80,133,66
3404-001,2015,6,3,6,101,250,351,133
3404-001,2015,6,3,7,213,653,866,351
3404-001,2015,6,3,8,476,1750,2226,866
3404-001,2015,6,3,9,806,1278,2084,2226
3404-001,2015,6,3,10,659,727,1386,2084
3404-001,2015,6,3,11,614,689,1303,1386
3404-001,2015,6,3,12,657,624,1281,1303
3404-001,2015,6,3,13,567,548,1115,1281
3404-001,2015,6,3,14,596,615,1211,1115
3404-001,2015,6,3,15,724,706,1430,1211
3404-001,2015,6,3,16,803,618,1421,1430
3404-001,2015,6,3,17,836,600,1436,1421
3404-001,2015,6,3,18,1207,542,1749,1436
3404-001,2015,6,3,19,1169,508,1677,1749
3404-001,2015,6,3,20,749,405,1154,1677
3404-001,2015,6,3,21,544,254,798,1154
3404-001,2015,6,3,22,282,195,477,798
3404-001,2015,6,3,23,133,145,278,477
3404-001,2015,6,3,24,102,104,206,278
3404-001,2015,6,4,1,42,82,124,206
3404-001,2015,6,4,2,41,63,104,124
3404-001,2015,6,4,3,27,55,82,104
3404-001,2015,6,4,4,22,49,71,82
3404-001,2015,6,4,5,50,69,119,71
3404-001,2015,6,4,6,129,249,378,119
3404-001,2015,6,4,7,239,622,861,378
3404-001,2015,6,4,8,489,1756,2245,861
3404-001,2015,6,4,9,730,1253,1983,2245
3404-001,2015,6,4,10,641,706,1347,1983
3404-001,2015,6,4,11,656,710,1366,1347
3404-001,2015,6,4,12,639,618,1257,1366
3404-001,2015,6,4,13,530,519,1049,1257
3404-001,2015,6,4,14,620,635,1255,1049
3404-001,2015,6,4,15,792,681,1473,1255
3404-001,2015,6,4,16,822,640,1462,1473
3404-001,2015,6,4,17,873,559,1432,1462
3404-001,2015,6,4,18,1194,594,1788,1432
3404-001,2015,6,4,19,1151,513,1664,1788
3404-001,2015,6,4,20,807,404,1211,1664
3404-001,2015,6,4,21,695,271,966,1211
3404-001,2015,6,4,22,350,214,564,966
3404-001,2015,6,4,23,150,164,314,564
3404-001,2015,6,4,24,90,104,194,314
3404-001,2015,6,5,1,66,82,148,194
3404-001,2015,6,5,2,48,58,106,148
3404-001,2015,6,5,3,27,45,72,106
3404-001,2015,6,5,4,24,44,68,72
3404-001,2015,6,5,5,55,89,144,68
3404-001,2015,6,5,6,122,252,374,144
3404-001,2015,6,5,7,230,673,903,374
3404-001,2015,6,5,8,506,1737,2243,903
3404-001,2015,6,5,9,769,1218,1987,2243
3404-001,2015,6,5,10,684,758,1442,1987
3404-001,2015,6,5,11,725,714,1439,1442
3404-001,2015,6,5,12,654,607,1261,1439
3404-001,2015,6,5,13,636,556,1192,1261
3404-001,2015,6,5,14,603,655,1258,1192
3404-001,2015,6,5,15,700,701,1401,1258
3404-001,2015,6,5,16,883,622,1505,1401
3404-001,2015,6,5,17,867,564,1431,1505
3404-001,2015,6,5,18,1464,577,2041,1431
3404-001,2015,6,5,19,1399,586,1985,2041
3404-001,2015,6,5,20,937,482,1419,1985
3404-001,2015,6,5,21,612,300,912,1419
3404-001,2015,6,5,22,306,239,545,912
3404-001,2015,6,5,23,143,151,294,545
3404-001,2015,6,5,24,68,103,171,294
3404-001,2015,6,6,1,68,87,155,171
3404-001,2015,6,6,2,34,58,92,155
3404-001,2015,6,6,3,18,42,60,92
3404-001,2015,6,6,4,30,40,70,60
3404-001,2015,6,6,5,33,97,130,70
3404-001,2015,6,6,6,128,238,366,130
3404-001,2015,6,6,7,210,429,639,366
3404-001,2015,6,6,8,323,752,1075,639
3404-001,2015,6,6,9,559,675,1234,1075
3404-001,2015,6,6,10,517,574,1091,1234
3404-001,2015,6,6,11,522,567,1089,1091
3404-001,2015,6,6,12,531,537,1068,1089
3404-001,2015,6,6,13,439,434,873,1068
3404-001,2015,6,6,14,461,444,905,873
3404-001,2015,6,6,15,491,455,946,905
3404-001,2015,6,6,16,505,418,923,946
3404-001,2015,6,6,17,571,439,1010,923
3404-001,2015,6,6,18,777,409,1186,1010
3404-001,2015,6,6,19,389,394,783,1186
3404-001,2015,6,6,20,254,271,525,783
3404-001,2015,6,6,21,168,209,377,525
3404-001,2015,6,6,22,116,177,293,377
3404-001,2015,6,6,23,74,124,198,293
3404-001,2015,6,6,24,41,76,117,198
3404-001,2015,6,7,1,31,50,81,117
3404-001,2015,6,7,2,24,45,69,81
3404-001,2015,6,7,3,14,31,45,69
3404-001,2015,6,7,4,12,23,35,45
3404-001,2015,6,7,5,26,47,73,35
3404-001,2015,6,7,6,37,102,139,73
3404-001,2015,6,7,7,62,209,271,139
3404-001,2015,6,7,8,108,293,401,271
3404-001,2015,6,7,9,146,265,411,401
3404-001,2015,6,7,10,141,306,447,411
3404-001,2015,6,7,11,163,317,480,447
3404-001,2015,6,7,12,168,331,499,480
3404-001,2015,6,7,13,202,303,505,499
3404-001,2015,6,7,14,218,325,543,505
3404-001,2015,6,7,15,282,345,627,543
3404-001,2015,6,7,16,301,342,643,627
3404-001,2015,6,7,17,346,315,661,643
3404-001,2015,6,7,18,399,331,730,661
3404-001,2015,6,7,19,345,335,680,730
3404-001,2015,6,7,20,227,298,525,680
3404-001,2015,6,7,21,176,256,432,525
3404-001,2015,6,7,22,114,210,324,432
3404-001,2015,6,7,23,61,187,248,324
3404-001,2015,6,7,24,45,129,174,248
3404-001,2015,6,8,1,25,71,96,174
3404-001,2015,6,8,2,8,48,56,96
3404-001,2015,6,8,3,12,48,60,56
3404-001,2015,6,8,4,14,39,53,60
3404-001,2015,6,8,5,23,79,102,53
3404-001,2015,6,8,6,114,293,407,102
3404-001,2015,6,8,7,207,737,944,407
3404-001,2015,6,8,8,508,1989,2497,944
3404-001,2015,6,8,9,687,1237,1924,2497
3404-001,2015,6,8,10,618,669,1287,1924
3404-001,2015,6,8,11,610,700,1310,1287
3404-001,2015,6,8,12,652,624,1276,1310
3404-001,2015,6,8,13,539,542,1081,1276
3404-001,2015,6,8,14,624,657,1281,1081
3404-001,2015,6,8,15,706,678,1384,1281
3404-001,2015,6,8,16,713,649,1362,1384
3404-001,2015,6,8,17,783,576,1359,1362
3404-001,2015,6,8,18,1194,579,1773,1359
3404-001,2015,6,8,19,1067,494,1561,1773
3404-001,2015,6,8,20,814,391,1205,1561
3404-001,2015,6,8,21,723,266,989,1205
3404-001,2015,6,8,22,346,225,571,989
3404-001,2015,6,8,23,157,147,304,571
3404-001,2015,6,8,24,71,98,169,304
3404-001,2015,6,9,1,58,75,133,169
3404-001,2015,6,9,2,46,53,99,133
3404-001,2015,6,9,3,28,45,73,99
3404-001,2015,6,9,4,23,45,68,73
3404-001,2015,6,9,5,49,88,137,68
3404-001,2015,6,9,6,120,274,394,137
3404-001,2015,6,9,7,211,658,869,394
3404-001,2015,6,9,8,476,1740,2216,869
3404-001,2015,6,9,9,797,1259,2056,2216
3404-001,2015,6,9,10,666,714,1380,2056
3404-001,2015,6,9,11,726,682,1408,1380
3404-001,2015,6,9,12,660,663,1323,1408
3404-001,2015,6,9,13,560,541,1101,1323
3404-001,2015,6,9,14,554,643,1197,1101
3404-001,2015,6,9,15,783,693,1476,1197
3404-001,2015,6,9,16,842,607,1449,1476
3404-001,2015,6,9,17,779,585,1364,1449
3404-001,2015,6,9,18,1276,555,1831,1364
3404-001,2015,6,9,19,1066,497,1563,1831
3404-001,2015,6,9,20,752,398,1150,1563
3404-001,2015,6,9,21,594,262,856,1150
3404-001,2015,6,9,22,337,231,568,856
3404-001,2015,6,9,23,150,157,307,568
3404-001,2015,6,9,24,87,103,190,307
3404-001,2015,6,10,1,51,70,121,190
3404-001,2015,6,10,2,46,63,109,121
3404-001,2015,6,10,3,20,32,52,109
3404-001,2015,6,10,4,22,59,81,52
3404-001,2015,6,10,5,40,96,136,81
3404-001,2015,6,10,6,132,276,408,136
3404-001,2015,6,10,7,270,677,947,408
3404-001,2015,6,10,8,493,1763,2256,947
3404-001,2015,6,10,9,765,1199,1964,2256
3404-001,2015,6,10,10,622,670,1292,1964
3404-001,2015,6,10,11,594,647,1241,1292
3404-001,2015,6,10,12,635,651,1286,1241
3404-001,2015,6,10,13,631,535,1166,1286
3404-001,2015,6,10,14,568,581,1149,1166
3404-001,2015,6,10,15,743,679,1422,1149
3404-001,2015,6,10,16,681,612,1293,1422
3404-001,2015,6,10,17,909,574,1483,1293
3404-001,2015,6,10,18,1429,541,1970,1483
3404-001,2015,6,10,19,1246,445,1691,1970
3404-001,2015,6,10,20,677,426,1103,1691
3404-001,2015,6,10,21,605,266,871,1103
3404-001,2015,6,10,22,309,222,531,871
3404-001,2015,6,10,23,158,148,306,531
3404-001,2015,6,10,24,60,88,148,306
3404-001,2015,6,11,1,46,97,143,148
3404-001,2015,6,11,2,49,61,110,143
3404-001,2015,6,11,3,11,42,53,110
3404-001,2015,6,11,4,31,48,79,53
3404-001,2015,6,11,5,112,81,193,79
3404-001,2015,6,11,6,163,284,447,193
3404-001,2015,6,11,7,224,675,899,447
3404-001,2015,6,11,8,532,1746,2278,899
3404-001,2015,6,11,9,743,1215,1958,2278
3404-001,2015,6,11,10,653,669,1322,1958
3404-001,2015,6,11,11,721,659,1380,1322
3404-001,2015,6,11,12,640,636,1276,1380
3404-001,2015,6,11,13,561,506,1067,1276
3404-001,2015,6,11,14,613,594,1207,1067
3404-001,2015,6,11,15,769,652,1421,1207
3404-001,2015,6,11,16,736,683,1419,1421
3404-001,2015,6,11,17,754,560,1314,1419
3404-001,2015,6,11,18,1228,570,1798,1314
3404-001,2015,6,11,19,1226,481,1707,1798
3404-001,2015,6,11,20,769,372,1141,1707
3404-001,2015,6,11,21,716,232,948,1141
3404-001,2015,6,11,22,281,208,489,948
3404-001,2015,6,11,23,156,138,294,489
3404-001,2015,6,11,24,77,96,173,294
3404-001,2015,6,12,1,42,80,122,173
3404-001,2015,6,12,2,75,57,132,122
3404-001,2015,6,12,3,29,43,72,132
3404-001,2015,6,12,4,18,47,65,72
3404-001,2015,6,12,5,55,75,130,65
3404-001,2015,6,12,6,114,280,394,130
3404-001,2015,6,12,7,195,663,858,394
3404-001,2015,6,12,8,465,1762,2227,858
3404-001,2015,6,12,9,734,1210,1944,2227
3404-001,2015,6,12,10,627,762,1389,1944
3404-001,2015,6,12,11,703,673,1376,1389
3404-001,2015,6,12,12,646,616,1262,1376
3404-001,2015,6,12,13,618,511,1129,1262
3404-001,2015,6,12,14,618,598,1216,1129
3404-001,2015,6,12,15,760,630,1390,1216
3404-001,2015,6,12,16,751,632,1383,1390
3404-001,2015,6,12,17,754,567,1321,1383
3404-001,2015,6,12,18,1471,583,2054,1321
3404-001,2015,6,12,19,1419,521,1940,2054
3404-001,2015,6,12,20,931,470,1401,1940
3404-001,2015,6,12,21,703,317,1020,1401
3404-001,2015,6,12,22,327,249,576,1020
3404-001,2015,6,12,23,158,153,311,576
3404-001,2015,6,12,24,84,107,191,311
3404-001,2015,6,13,1,46,78,124,191
3404-001,2015,6,13,2,53,63,116,124
3404-001,2015,6,13,3,22,49,71,116
3404-001,2015,6,13,4,7,50,57,71
3404-001,2015,6,13,5,55,89,144,57
3404-001,2015,6,13,6,136,232,368,144
3404-001,2015,6,13,7,145,420,565,368
3404-001,2015,6,13,8,248,776,1024,565
3404-001,2015,6,13,9,519,632,1151,1024
3404-001,2015,6,13,10,447,550,997,1151
3404-001,2015,6,13,11,539,458,997,997
3404-001,2015,6,13,12,548,449,997,997
3404-001,2015,6,13,13,478,408,886,997
3404-001,2015,6,13,14,414,443,857,886
3404-001,2015,6,13,15,568,435,1003,857
3404-001,2015,6,13,16,500,416,916,1003
3404-001,2015,6,13,17,633,461,1094,916
3404-001,2015,6,13,18,844,394,1238,1094
3404-001,2015,6,13,19,412,389,801,1238
3404-001,2015,6,13,20,257,295,552,801
3404-001,2015,6,13,21,206,193,399,552
3404-001,2015,6,13,22,114,166,280,399
3404-001,2015,6,13,23,73,101,174,280
3404-001,2015,6,13,24,46,78,124,174
3404-001,2015,6,14,1,40,61,101,124
3404-001,2015,6,14,2,42,46,88,101
3404-001,2015,6,14,3,20,29,49,88
3404-001,2015,6,14,4,18,27,45,49
3404-001,2015,6,14,5,36,55,91,45
3404-001,2015,6,14,6,53,85,138,91
3404-001,2015,6,14,7,86,146,232,138
3404-001,2015,6,14,8,99,211,310,232
3404-001,2015,6,14,9,145,246,391,310
3404-001,2015,6,14,10,138,252,390,391
3404-001,2015,6,14,11,173,270,443,390
3404-001,2015,6,14,12,187,279,466,443
3404-001,2015,6,14,13,178,290,468,466
3404-001,2015,6,14,14,217,327,544,468
3404-001,2015,6,14,15,294,364,658,544
3404-001,2015,6,14,16,333,307,640,658
3404-001,2015,6,14,17,292,336,628,640
3404-001,2015,6,14,18,352,304,656,628
3404-001,2015,6,14,19,219,317,536,656
3404-001,2015,6,14,20,173,285,458,536
3404-001,2015,6,14,21,167,222,389,458
3404-001,2015,6,14,22,130,195,325,389
3404-001,2015,6,14,23,71,186,257,325
3404-001,2015,6,14,24,33,113,146,257
3404-001,2015,6,15,1,36,78,114,146
3404-001,2015,6,15,2,16,48,64,114
3404-001,2015,6,15,3,7,41,48,64
3404-001,2015,6,15,4,11,35,46,48
3404-001,2015,6,15,5,29,81,110,46
3404-001,2015,6,15,6,114,311,425,110
3404-001,2015,6,15,7,279,761,1040,425
3404-001,2015,6,15,8,513,1928,2441,1040
3404-001,2015,6,15,9,670,1283,1953,2441
3404-001,2015,6,15,10,668,695,1363,1953
3404-001,2015,6,15,11,609,705,1314,1363
3404-001,2015,6,15,12,629,620,1249,1314
3404-001,2015,6,15,13,508,588,1096,1249
3404-001,2015,6,15,14,546,609,1155,1096
3404-001,2015,6,15,15,804,677,1481,1155
3404-001,2015,6,15,16,756,626,1382,1481
3404-001,2015,6,15,17,821,601,1422,1382
3404-001,2015,6,15,18,1145,537,1682,1422
3404-001,2015,6,15,19,1126,451,1577,1682
3404-001,2015,6,15,20,806,405,1211,1577
3404-001,2015,6,15,21,703,262,965,1211
3404-001,2015,6,15,22,335,190,525,965
3404-001,2015,6,15,23,167,138,305,525
3404-001,2015,6,15,24,68,101,169,305
3404-001,2015,6,16,1,38,71,109,169
3404-001,2015,6,16,2,44,63,107,109
3404-001,2015,6,16,3,16,36,52,107
3404-001,2015,6,16,4,29,39,68,52
3404-001,2015,6,16,5,66,77,143,68
3404-001,2015,6,16,6,117,281,398,143
3404-001,2015,6,16,7,233,682,915,398
3404-001,2015,6,16,8,568,1717,2285,915
3404-001,2015,6,16,9,775,1227,2002,2285
3404-001,2015,6,16,10,677,726,1403,2002
3404-001,2015,6,16,11,725,665,1390,1403
3404-001,2015,6,16,12,651,666,1317,1390
3404-001,2015,6,16,13,666,534,1200,1317
3404-001,2015,6,16,14,622,624,1246,1200
3404-001,2015,6,16,15,786,628,1414,1246
3404-001,2015,6,16,16,721,714,1435,1414
3404-001,2015,6,16,17,865,595,1460,1435
3404-001,2015,6,16,18,1221,543,1764,1460
3404-001,2015,6,16,19,1040,491,1531,1764
3404-001,2015,6,16,20,870,419,1289,1531
3404-001,2015,6,16,21,795,257,1052,1289
3404-001,2015,6,16,22,401,212,613,1052
3404-001,2015,6,16,23,149,160,309,613
3404-001,2015,6,16,24,106,108,214,309
3404-001,2015,6,17,1,68,82,150,214
3404-001,2015,6,17,2,46,63,109,150
3404-001,2015,6,17,3,14,32,46,109
3404-001,2015,6,17,4,18,42,60,46
3404-001,2015,6,17,5,62,92,154,60
3404-001,2015,6,17,6,136,267,403,154
3404-001,2015,6,17,7,224,639,863,403
3404-001,2015,6,17,8,519,1714,2233,863
3404-001,2015,6,17,9,876,1299,2175,2233
3404-001,2015,6,17,10,727,743,1470,2175
3404-001,2015,6,17,11,600,687,1287,1470
3404-001,2015,6,17,12,616,629,1245,1287
3404-001,2015,6,17,13,535,538,1073,1245
3404-001,2015,6,17,14,554,595,1149,1073
3404-001,2015,6,17,15,701,687,1388,1149
3404-001,2015,6,17,16,828,585,1413,1388
3404-001,2015,6,17,17,909,599,1508,1413
3404-001,2015,6,17,18,1212,523,1735,1508
3404-001,2015,6,17,19,1170,512,1682,1735
3404-001,2015,6,17,20,804,424,1228,1682
3404-001,2015,6,17,21,559,261,820,1228
3404-001,2015,6,17,22,292,172,464,820
3404-001,2015,6,17,23,117,127,244,464
3404-001,2015,6,17,24,88,86,174,244
3404-001,2015,6,18,1,44,68,112,174
3404-001,2015,6,18,2,49,61,110,112
3404-001,2015,6,18,3,36,52,88,110
3404-001,2015,6,18,4,18,48,66,88
3404-001,2015,6,18,5,53,70,123,66
3404-001,2015,6,18,6,123,272,395,123
3404-001,2015,6,18,7,215,615,830,395
3404-001,2015,6,18,8,546,1769,2315,830
3404-001,2015,6,18,9,708,1256,1964,2315
3404-001,2015,6,18,10,673,706,1379,1964
3404-001,2015,6,18,11,723,674,1397,1379
3404-001,2015,6,18,12,662,638,1300,1397
3404-001,2015,6,18,13,563,512,1075,1300
3404-001,2015,6,18,14,618,637,1255,1075
3404-001,2015,6,18,15,813,672,1485,1255
3404-001,2015,6,18,16,841,638,1479,1485
3404-001,2015,6,18,17,892,546,1438,1479
3404-001,2015,6,18,18,1207,579,1786,1438
3404-001,2015,6,18,19,1198,500,1698,1786
3404-001,2015,6,18,20,854,428,1282,1698
3404-001,2015,6,18,21,688,269,957,1282
3404-001,2015,6,18,22,384,212,596,957
3404-001,2015,6,18,23,156,162,318,596
3404-001,2015,6,18,24,108,111,219,318
3404-001,2015,6,19,1,57,79,136,219
3404-001,2015,6,19,2,44,57,101,136
3404-001,2015,6,19,3,27,41,68,101
3404-001,2015,6,19,4,29,39,68,68
3404-001,2015,6,19,5,71,106,177,68
3404-001,2015,6,19,6,136,267,403,177
3404-001,2015,6,19,7,263,703,966,403
3404-001,2015,6,19,8,550,1789,2339,966
3404-001,2015,6,19,9,808,1188,1996,2339
3404-001,2015,6,19,10,769,757,1526,1996
3404-001,2015,6,19,11,655,730,1385,1526
3404-001,2015,6,19,12,670,617,1287,1385
3404-001,2015,6,19,13,653,561,1214,1287
3404-001,2015,6,19,14,592,642,1234,1214
3404-001,2015,6,19,15,699,656,1355,1234
3404-001,2015,6,19,16,898,617,1515,1355
3404-001,2015,6,19,17,843,557,1400,1515
3404-001,2015,6,19,18,1542,572,2114,1400
3404-001,2015,6,19,19,1472,588,2060,2114
3404-001,2015,6,19,20,1034,507,1541,2060
3404-001,2015,6,19,21,668,319,987,1541
3404-001,2015,6,19,22,322,241,563,987
3404-001,2015,6,19,23,123,141,264,563
3404-001,2015,6,19,24,53,98,151,264
3404-001,2015,6,20,1,71,93,164,151
3404-001,2015,6,20,2,31,57,88,164
3404-001,2015,6,20,3,18,45,63,88
3404-001,2015,6,20,4,46,50,96,63
3404-001,2015,6,20,5,29,112,141,96
3404-001,2015,6,20,6,178,269,447,141
3404-001,2015,6,20,7,228,422,650,447
3404-001,2015,6,20,8,342,731,1073,650
3404-001,2015,6,20,9,611,666,1277,1073
3404-001,2015,6,20,10,535,555,1090,1277
3404-001,2015,6,20,11,572,523,1095,1090
3404-001,2015,6,20,12,583,505,1088,1095
3404-001,2015,6,20,13,408,426,834,1088
3404-001,2015,6,20,14,508,421,929,834
3404-001,2015,6,20,15,476,431,907,929
3404-001,2015,6,20,16,530,394,924,907
3404-001,2015,6,20,17,557,416,973,924
3404-001,2015,6,20,18,672,368,1040,973
3404-001,2015,6,20,19,333,355,688,1040
3404-001,2015,6,20,20,241,252,493,688
3404-001,2015,6,20,21,114,208,322,493
3404-001,2015,6,20,22,99,169,268,322
3404-001,2015,6,20,23,57,115,172,268
3404-001,2015,6,20,24,31,74,105,172
3404-001,2015,6,21,1,20,51,71,105
3404-001,2015,6,21,2,27,42,69,71
3404-001,2015,6,21,3,11,25,36,69
3404-001,2015,6,21,4,5,19,24,36
3404-001,2015,6,21,5,36,57,93,24
3404-001,2015,6,21,6,53,99,152,93
3404-001,2015,6,21,7,55,207,262,152
3404-001,2015,6,21,8,90,302,392,262
3404-001,2015,6,21,9,136,255,391,392
3404-001,2015,6,21,10,141,298,439,391
3404-001,2015,6,21,11,143,298,441,439
3404-001,2015,6,21,12,171,331,502,441
3404-001,2015,6,21,13,187,277,464,502
3404-001,2015,6,21,14,226,322,548,464
3404-001,2015,6,21,15,303,346,649,548
3404-001,2015,6,21,16,283,304,587,649
3404-001,2015,6,21,17,335,304,639,587
3404-001,2015,6,21,18,360,313,673,639
3404-001,2015,6,21,19,318,337,655,673
3404-001,2015,6,21,20,237,285,522,655
3404-001,2015,6,21,21,182,260,442,522
3404-001,2015,6,21,22,121,212,333,442
3404-001,2015,6,21,23,62,200,262,333
3404-001,2015,6,21,24,40,123,163,262
3404-001,2015,6,22,1,20,62,82,163
3404-001,2015,6,22,2,5,59,64,82
3404-001,2015,6,22,3,16,45,61,64
3404-001,2015,6,22,4,20,45,65,61
3404-001,2015,6,22,5,27,81,108,65
3404-001,2015,6,22,6,123,310,433,108
3404-001,2015,6,22,7,206,733,939,433
3404-001,2015,6,22,8,535,2003,2538,939
3404-001,2015,6,22,9,657,1191,1848,2538
3404-001,2015,6,22,10,629,695,1324,1848
3404-001,2015,6,22,11,581,674,1255,1324
3404-001,2015,6,22,12,633,591,1224,1255
3404-001,2015,6,22,13,557,521,1078,1224
3404-001,2015,6,22,14,550,633,1183,1078
3404-001,2015,6,22,15,673,651,1324,1183
3404-001,2015,6,22,16,730,630,1360,1324
3404-001,2015,6,22,17,811,541,1352,1360
3404-001,2015,6,22,18,1156,590,1746,1352
3404-001,2015,6,22,19,1080,458,1538,1746
3404-001,2015,6,22,20,865,394,1259,1538
3404-001,2015,6,22,21,703,254,957,1259
3404-001,2015,6,22,22,377,218,595,957
3404-001,2015,6,22,23,154,148,302,595
3404-001,2015,6,22,24,79,87,166,302
3404-001,2015,6,23,1,57,70,127,166
3404-001,2015,6,23,2,60,51,111,127
3404-001,2015,6,23,3,27,36,63,111
3404-001,2015,6,23,4,14,41,55,63
3404-001,2015,6,23,5,51,90,141,55
3404-001,2015,6,23,6,134,286,420,141
3404-001,2015,6,23,7,230,666,896,420
3404-001,2015,6,23,8,473,1712,2185,896
3404-001,2015,6,23,9,758,1267,2025,2185
3404-001,2015,6,23,10,719,706,1425,2025
3404-001,2015,6,23,11,649,676,1325,1425
3404-001,2015,6,23,12,725,657,1382,1325
3404-001,2015,6,23,13,572,556,1128,1382
3404-001,2015,6,23,14,574,639,1213,1128
3404-001,2015,6,23,15,815,687,1502,1213
3404-001,2015,6,23,16,795,580,1375,1502
3404-001,2015,6,23,17,784,582,1366,1375
3404-001,2015,6,23,18,1276,508,1784,1366
3404-001,2015,6,23,19,1110,505,1615,1784
3404-001,2015,6,23,20,843,423,1266,1615
3404-001,2015,6,23,21,616,266,882,1266
3404-001,2015,6,23,22,346,235,581,882
3404-001,2015,6,23,23,154,155,309,581
3404-001,2015,6,23,24,88,100,188,309
3404-001,2015,6,24,1,64,59,123,188
3404-001,2015,6,24,2,53,69,122,123
3404-001,2015,6,24,3,22,44,66,122
3404-001,2015,6,24,4,29,47,76,66
3404-001,2015,6,24,5,53,98,151,76
3404-001,2015,6,24,6,130,269,399,151
3404-001,2015,6,24,7,254,654,908,399
3404-001,2015,6,24,8,467,1758,2225,908
3404-001,2015,6,24,9,780,1224,2004,2225
3404-001,2015,6,24,10,592,692,1284,2004
3404-001,2015,6,24,11,565,682,1247,1284
3404-001,2015,6,24,12,684,672,1356,1247
3404-001,2015,6,24,13,554,565,1119,1356
3404-001,2015,6,24,14,675,675,1350,1119
3404-001,2015,6,24,15,784,710,1494,1350
3404-001,2015,6,24,16,699,599,1298,1494
3404-001,2015,6,24,17,942,588,1530,1298
3404-001,2015,6,24,18,1455,535,1990,1530
3404-001,2015,6,24,19,1213,504,1717,1990
3404-001,2015,6,24,20,826,393,1219,1717
3404-001,2015,6,24,21,668,234,902,1219
3404-001,2015,6,24,22,292,212,504,902
3404-001,2015,6,24,23,158,160,318,504
3404-001,2015,6,24,24,101,105,206,318
3404-001,2015,6,25,1,53,68,121,206
3404-001,2015,6,25,2,55,53,108,121
3404-001,2015,6,25,3,29,46,75,108
3404-001,2015,6,25,4,25,41,66,75
3404-001,2015,6,25,5,42,99,141,66
3404-001,2015,6,25,6,138,252,390,141
3404-001,2015,6,25,7,217,683,900,390
3404-001,2015,6,25,8,469,1747,2216,900
3404-001,2015,6,25,9,765,1252,2017,2216
3404-001,2015,6,25,10,603,703,1306,2017
3404-001,2015,6,25,11,692,658,1350,1306
3404-001,2015,6,25,12,670,642,1312,1350
3404-001,2015,6,25,13,616,525,1141,1312
3404-001,2015,6,25,14,513,647,1160,1141
3404-001,2015,6,25,15,749,692,1441,1160
3404-001,2015,6,25,16,795,638,1433,1441
3404-001,2015,6,25,17,872,586,1458,1433
3404-001,2015,6,25,18,1262,544,1806,1458
3404-001,2015,6,25,19,1170,517,1687,1806
3404-001,2015,6,25,20,730,378,1108,1687
3404-001,2015,6,25,21,587,234,821,1108
3404-001,2015,6,25,22,265,194,459,821
3404-001,2015,6,25,23,171,162,333,459
3404-001,2015,6,25,24,106,95,201,333
3404-001,2015,6,26,1,62,75,137,201
3404-001,2015,6,26,2,27,50,77,137
3404-001,2015,6,26,3,27,29,56,77
3404-001,2015,6,26,4,16,42,58,56
3404-001,2015,6,26,5,42,77,119,58
3404-001,2015,6,26,6,64,176,240,119
3404-001,2015,6,26,7,149,476,625,240
3404-001,2015,6,26,8,434,1664,2098,625
3404-001,2015,6,26,9,721,1204,1925,2098
3404-001,2015,6,26,10,574,629,1203,1925
3404-001,2015,6,26,11,574,646,1220,1203
3404-001,2015,6,26,12,684,616,1300,1220
3404-001,2015,6,26,13,644,530,1174,1300
3404-001,2015,6,26,14,559,593,1152,1174
3404-001,2015,6,26,15,694,681,1375,1152
3404-001,2015,6,26,16,677,580,1257,1375
3404-001,2015,6,26,17,870,579,1449,1257
3404-001,2015,6,26,18,1307,582,1889,1449
3404-001,2015,6,26,19,1380,531,1911,1889
3404-001,2015,6,26,20,898,474,1372,1911
3404-001,2015,6,26,21,598,293,891,1372
3404-001,2015,6,26,22,263,228,491,891
3404-001,2015,6,26,23,143,147,290,491
3404-001,2015,6,26,24,84,107,191,290
3404-001,2015,6,27,1,57,83,140,191
3404-001,2015,6,27,2,29,53,82,140
3404-001,2015,6,27,3,14,41,55,82
3404-001,2015,6,27,4,25,53,78,55
3404-001,2015,6,27,5,33,86,119,78
3404-001,2015,6,27,6,117,234,351,119
3404-001,2015,6,27,7,204,425,629,351
3404-001,2015,6,27,8,340,758,1098,629
3404-001,2015,6,27,9,543,670,1213,1098
3404-001,2015,6,27,10,613,622,1235,1213
3404-001,2015,6,27,11,559,555,1114,1235
3404-001,2015,6,27,12,530,558,1088,1114
3404-001,2015,6,27,13,528,526,1054,1088
3404-001,2015,6,27,14,432,496,928,1054
3404-001,2015,6,27,15,522,513,1035,928
3404-001,2015,6,27,16,530,444,974,1035
3404-001,2015,6,27,17,618,388,1006,974
3404-001,2015,6,27,18,790,470,1260,1006
3404-001,2015,6,27,19,478,376,854,1260
3404-001,2015,6,27,20,254,281,535,854
3404-001,2015,6,27,21,228,262,490,535
3404-001,2015,6,27,22,169,184,353,490
3404-001,2015,6,27,23,88,113,201,353
3404-001,2015,6,27,24,53,89,142,201
3404-001,2015,6,28,1,22,66,88,142
3404-001,2015,6,28,2,25,46,71,88
3404-001,2015,6,28,3,27,44,71,71
3404-001,2015,6,28,4,27,29,56,71
3404-001,2015,6,28,5,25,54,79,56
3404-001,2015,6,28,6,82,126,208,79
3404-001,2015,6,28,7,103,194,297,208
3404-001,2015,6,28,8,101,316,417,297
3404-001,2015,6,28,9,270,300,570,417
3404-001,2015,6,28,10,279,297,576,570
3404-001,2015,6,28,11,257,332,589,576
3404-001,2015,6,28,12,311,337,648,589
3404-001,2015,6,28,13,272,323,595,648
3404-001,2015,6,28,14,292,336,628,595
3404-001,2015,6,28,15,338,406,744,628
3404-001,2015,6,28,16,414,363,777,744
3404-001,2015,6,28,17,460,343,803,777
3404-001,2015,6,28,18,479,353,832,803
3404-001,2015,6,28,19,355,354,709,832
3404-001,2015,6,28,20,226,314,540,709
3404-001,2015,6,28,21,202,268,470,540
3404-001,2015,6,28,22,132,227,359,470
3404-001,2015,6,28,23,57,190,247,359
3404-001,2015,6,28,24,51,109,160,247
3404-001,2015,6,29,1,18,75,93,160
3404-001,2015,6,29,2,25,39,64,93
3404-001,2015,6,29,3,25,34,59,64
3404-001,2015,6,29,4,9,37,46,59
3404-001,2015,6,29,5,53,90,143,46
3404-001,2015,6,29,6,117,309,426,143
3404-001,2015,6,29,7,215,784,999,426
3404-001,2015,6,29,8,543,1915,2458,999
3404-001,2015,6,29,9,749,1301,2050,2458
3404-001,2015,6,29,10,543,678,1221,2050
3404-001,2015,6,29,11,622,715,1337,1221
3404-001,2015,6,29,12,751,673,1424,1337
3404-001,2015,6,29,13,543,557,1100,1424
3404-001,2015,6,29,14,633,704,1337,1100
3404-001,2015,6,29,15,821,641,1462,1337
3404-001,2015,6,29,16,841,628,1469,1462
3404-001,2015,6,29,17,920,574,1494,1469
3404-001,2015,6,29,18,1285,580,1865,1494
3404-001,2015,6,29,19,1196,501,1697,1865
3404-001,2015,6,29,20,852,400,1252,1697
3404-001,2015,6,29,21,756,274,1030,1252
3404-001,2015,6,29,22,357,222,579,1030
3404-001,2015,6,29,23,228,151,379,579
3404-001,2015,6,29,24,77,101,178,379
3404-001,2015,6,30,1,71,68,139,178
3404-001,2015,6,30,2,57,48,105,139
3404-001,2015,6,30,3,16,41,57,105
3404-001,2015,6,30,4,36,37,73,57
3404-001,2015,6,30,5,38,96,134,73
3404-001,2015,6,30,6,103,251,354,134
3404-001,2015,6,30,7,250,587,837,354
3404-001,2015,6,30,8,513,1755,2268,837
3404-001,2015,6,30,9,843,1247,2090,2268
3404-001,2015,6,30,10,644,691,1335,2090
3404-001,2015,6,30,11,708,703,1411,1335
3404-001,2015,6,30,12,574,622,1196,1411
3404-001,2015,6,30,13,541,542,1083,1196
3404-001,2015,6,30,14,585,606,1191,1083
3404-001,2015,6,30,15,821,712,1533,1191
3404-001,2015,6,30,16,832,608,1440,1533
3404-001,2015,6,30,17,841,554,1395,1440
3404-001,2015,6,30,18,1326,544,1870,1395
3404-001,2015,6,30,19,1064,456,1520,1870
3404-001,2015,6,30,20,824,378,1202,1520
3404-001,2015,6,30,21,589,270,859,1202
3404-001,2015,6,30,22,294,189,483,859
3404-001,2015,6,30,23,189,152,341,483
3404-001,2015,6,30,24,60,100,160,341
3404-001,2015,7,1,1,47,64,111,160
3404-001,2015,7,1,2,51,58,109,111
3404-001,2015,7,1,3,18,30,48,109
3404-001,2015,7,1,4,44,52,96,48
3404-001,2015,7,1,5,60,79,139,96
3404-001,2015,7,1,6,121,268,389,139
3404-001,2015,7,1,7,244,639,883,389
3404-001,2015,7,1,8,509,1755,2264,883
3404-001,2015,7,1,9,788,1299,2087,2264
3404-001,2015,7,1,10,733,728,1461,2087
3404-001,2015,7,1,11,784,724,1508,1461
3404-001,2015,7,1,12,874,690,1564,1508
3404-001,2015,7,1,13,586,514,1100,1564
3404-001,2015,7,1,14,648,678,1326,1100
3404-001,2015,7,1,15,792,714,1506,1326
3404-001,2015,7,1,16,856,717,1573,1506
3404-001,2015,7,1,17,806,577,1383,1573
3404-001,2015,7,1,18,1420,544,1964,1383
3404-001,2015,7,1,19,1172,518,1690,1964
3404-001,2015,7,1,20,738,421,1159,1690
3404-001,2015,7,1,21,632,265,897,1159
3404-001,2015,7,1,22,325,213,538,897
3404-001,2015,7,1,23,176,176,352,538
3404-001,2015,7,1,24,77,96,173,352
3404-001,2015,7,2,1,62,70,132,173
3404-001,2015,7,2,2,29,56,85,132
3404-001,2015,7,2,3,22,44,66,85
3404-001,2015,7,2,4,20,33,53,66
3404-001,2015,7,2,5,60,76,136,53
3404-001,2015,7,2,6,117,242,359,136
3404-001,2015,7,2,7,215,667,882,359
3404-001,2015,7,2,8,531,1779,2310,882
3404-001,2015,7,2,9,795,1300,2095,2310
3404-001,2015,7,2,10,687,734,1421,2095
3404-001,2015,7,2,11,667,731,1398,1421
3404-001,2015,7,2,12,696,666,1362,1398
3404-001,2015,7,2,13,634,528,1162,1362
3404-001,2015,7,2,14,676,627,1303,1162
3404-001,2015,7,2,15,821,732,1553,1303
3404-001,2015,7,2,16,950,655,1605,1553
3404-001,2015,7,2,17,792,614,1406,1605
3404-001,2015,7,2,18,1311,530,1841,1406
3404-001,2015,7,2,19,1207,463,1670,1841
3404-001,2015,7,2,20,753,436,1189,1670
3404-001,2015,7,2,21,795,297,1092,1189
3404-001,2015,7,2,22,367,199,566,1092
3404-001,2015,7,2,23,169,155,324,566
3404-001,2015,7,2,24,95,102,197,324
3404-001,2015,7,3,1,73,67,140,197
3404-001,2015,7,3,2,38,57,95,140
3404-001,2015,7,3,3,31,38,69,95
3404-001,2015,7,3,4,9,38,47,69
3404-001,2015,7,3,5,51,88,139,47
3404-001,2015,7,3,6,115,274,389,139
3404-001,2015,7,3,7,240,617,857,389
3404-001,2015,7,3,8,560,1758,2318,857
3404-001,2015,7,3,9,863,1237,2100,2318
3404-001,2015,7,3,10,648,702,1350,2100
3404-001,2015,7,3,11,709,751,1460,1350
3404-001,2015,7,3,12,628,656,1284,1460
3404-001,2015,7,3,13,678,557,1235,1284
3404-001,2015,7,3,14,586,626,1212,1235
3404-001,2015,7,3,15,885,719,1604,1212
3404-001,2015,7,3,16,882,659,1541,1604
3404-001,2015,7,3,17,834,617,1451,1541
3404-001,2015,7,3,18,1546,599,2145,1451
3404-001,2015,7,3,19,1525,610,2135,2145
3404-001,2015,7,3,20,992,553,1545,2135
3404-001,2015,7,3,21,634,314,948,1545
3404-001,2015,7,3,22,336,234,570,948
3404-001,2015,7,3,23,147,184,331,570
3404-001,2015,7,3,24,95,96,191,331
3404-001,2015,7,4,1,77,75,152,191
3404-001,2015,7,4,2,38,63,101,152
3404-001,2015,7,4,3,29,45,74,101
3404-001,2015,7,4,4,16,40,56,74
3404-001,2015,7,4,5,38,84,122,56
3404-001,2015,7,4,6,119,211,330,122
3404-001,2015,7,4,7,185,422,607,330
3404-001,2015,7,4,8,351,769,1120,607
3404-001,2015,7,4,9,621,734,1355,1120
3404-001,2015,7,4,10,656,623,1279,1355
3404-001,2015,7,4,11,619,651,1270,1279
3404-001,2015,7,4,12,597,612,1209,1270
3404-001,2015,7,4,13,518,475,993,1209
3404-001,2015,7,4,14,584,520,1104,993
3404-001,2015,7,4,15,626,543,1169,1104
3404-001,2015,7,4,16,639,470,1109,1169
3404-001,2015,7,4,17,687,470,1157,1109
3404-001,2015,7,4,18,865,486,1351,1157
3404-001,2015,7,4,19,547,437,984,1351
3404-001,2015,7,4,20,286,313,599,984
3404-001,2015,7,4,21,259,224,483,599
3404-001,2015,7,4,22,145,183,328,483
3404-001,2015,7,4,23,95,118,213,328
3404-001,2015,7,4,24,55,81,136,213
3404-001,2015,7,5,1,27,53,80,136
3404-001,2015,7,5,2,20,38,58,80
3404-001,2015,7,5,3,27,32,59,58
3404-001,2015,7,5,4,16,28,44,59
3404-001,2015,7,5,5,31,53,84,44
3404-001,2015,7,5,6,33,118,151,84
3404-001,2015,7,5,7,77,217,294,151
3404-001,2015,7,5,8,132,280,412,294
3404-001,2015,7,5,9,233,259,492,412
3404-001,2015,7,5,10,211,288,499,492
3404-001,2015,7,5,11,189,372,561,499
3404-001,2015,7,5,12,253,383,636,561
3404-001,2015,7,5,13,226,309,535,636
3404-001,2015,7,5,14,283,379,662,535
3404-001,2015,7,5,15,382,333,715,662
3404-001,2015,7,5,16,391,386,777,715
3404-001,2015,7,5,17,354,333,687,777
3404-001,2015,7,5,18,470,359,829,687
3404-001,2015,7,5,19,356,357,713,829
3404-001,2015,7,5,20,242,268,510,713
3404-001,2015,7,5,21,196,265,461,510
3404-001,2015,7,5,22,130,207,337,461
3404-001,2015,7,5,23,97,158,255,337
3404-001,2015,7,5,24,40,122,162,255
3404-001,2015,7,6,1,16,85,101,162
3404-001,2015,7,6,2,20,48,68,101
3404-001,2015,7,6,3,14,29,43,68
3404-001,2015,7,6,4,36,46,82,43
3404-001,2015,7,6,5,44,76,120,82
3404-001,2015,7,6,6,134,300,434,120
3404-001,2015,7,6,7,202,733,935,434
3404-001,2015,7,6,8,582,1999,2581,935
3404-001,2015,7,6,9,773,1330,2103,2581
3404-001,2015,7,6,10,562,700,1262,2103
3404-001,2015,7,6,11,632,727,1359,1262
3404-001,2015,7,6,12,650,665,1315,1359
3404-001,2015,7,6,13,626,550,1176,1315
3404-001,2015,7,6,14,549,613,1162,1176
3404-001,2015,7,6,15,665,684,1349,1162
3404-001,2015,7,6,16,843,682,1525,1349
3404-001,2015,7,6,17,841,572,1413,1525
3404-001,2015,7,6,18,1207,576,1783,1413
3404-001,2015,7,6,19,1261,478,1739,1783
3404-001,2015,7,6,20,845,419,1264,1739
3404-001,2015,7,6,21,731,248,979,1264
3404-001,2015,7,6,22,424,223,647,979
3404-001,2015,7,6,23,156,131,287,647
3404-001,2015,7,6,24,79,115,194,287
3404-001,2015,7,7,1,40,71,111,194
3404-001,2015,7,7,2,36,40,76,111
3404-001,2015,7,7,3,29,48,77,76
3404-001,2015,7,7,4,31,54,85,77
3404-001,2015,7,7,5,42,77,119,85
3404-001,2015,7,7,6,143,245,388,119
3404-001,2015,7,7,7,248,658,906,388
3404-001,2015,7,7,8,481,1832,2313,906
3404-001,2015,7,7,9,825,1305,2130,2313
3404-001,2015,7,7,10,661,765,1426,2130
3404-001,2015,7,7,11,702,742,1444,1426
3404-001,2015,7,7,12,720,681,1401,1444
3404-001,2015,7,7,13,615,526,1141,1401
3404-001,2015,7,7,14,560,658,1218,1141
3404-001,2015,7,7,15,841,733,1574,1218
3404-001,2015,7,7,16,845,605,1450,1574
3404-001,2015,7,7,17,716,528,1244,1450
3404-001,2015,7,7,18,1273,517,1790,1244
3404-001,2015,7,7,19,1167,480,1647,1790
3404-001,2015,7,7,20,757,377,1134,1647
3404-001,2015,7,7,21,667,266,933,1134
3404-001,2015,7,7,22,347,214,561,933
3404-001,2015,7,7,23,139,118,257,561
3404-001,2015,7,7,24,88,84,172,257
3404-001,2015,7,8,1,44,77,121,172
3404-001,2015,7,8,2,44,53,97,121
3404-001,2015,7,8,3,25,51,76,97
3404-001,2015,7,8,4,29,42,71,76
3404-001,2015,7,8,5,40,69,109,71
3404-001,2015,7,8,6,95,230,325,109
3404-001,2015,7,8,7,187,613,800,325
3404-001,2015,7,8,8,481,1728,2209,800
3404-001,2015,7,8,9,775,1270,2045,2209
3404-001,2015,7,8,10,634,715,1349,2045
3404-001,2015,7,8,11,648,682,1330,1349
3404-001,2015,7,8,12,667,633,1300,1330
3404-001,2015,7,8,13,509,511,1020,1300
3404-001,2015,7,8,14,523,609,1132,1020
3404-001,2015,7,8,15,683,660,1343,1132
3404-001,2015,7,8,16,795,595,1390,1343
3404-001,2015,7,8,17,751,532,1283,1390
3404-001,2015,7,8,18,1292,541,1833,1283
3404-001,2015,7,8,19,1119,417,1536,1833
3404-001,2015,7,8,20,727,352,1079,1536
3404-001,2015,7,8,21,505,256,761,1079
3404-001,2015,7,8,22,277,224,501,761
3404-001,2015,7,8,23,139,138,277,501
3404-001,2015,7,8,24,71,88,159,277
3404-001,2015,7,9,1,53,70,123,159
3404-001,2015,7,9,2,27,64,91,123
3404-001,2015,7,9,3,31,29,60,91
3404-001,2015,7,9,4,25,40,65,60
3404-001,2015,7,9,5,40,64,104,65
3404-001,2015,7,9,6,82,213,295,104
3404-001,2015,7,9,7,169,642,811,295
3404-001,2015,7,9,8,481,1744,2225,811
3404-001,2015,7,9,9,904,1247,2151,2225
3404-001,2015,7,9,10,634,734,1368,2151
3404-001,2015,7,9,11,733,682,1415,1368
3404-001,2015,7,9,12,698,623,1321,1415
3404-001,2015,7,9,13,538,506,1044,1321
3404-001,2015,7,9,14,584,649,1233,1044
3404-001,2015,7,9,15,770,707,1477,1233
3404-001,2015,7,9,16,909,643,1552,1477
3404-001,2015,7,9,17,819,530,1349,1552
3404-001,2015,7,9,18,1257,541,1798,1349
3404-001,2015,7,9,19,1056,507,1563,1798
3404-001,2015,7,9,20,817,383,1200,1563
3404-001,2015,7,9,21,768,265,1033,1200
3404-001,2015,7,9,22,305,216,521,1033
3404-001,2015,7,9,23,178,137,315,521
3404-001,2015,7,9,24,64,93,157,315
3404-001,2015,7,10,1,49,80,129,157
3404-001,2015,7,10,2,66,66,132,129
3404-001,2015,7,10,3,27,41,68,132
3404-001,2015,7,10,4,27,50,77,68
3404-001,2015,7,10,5,58,61,119,77
3404-001,2015,7,10,6,147,272,419,119
3404-001,2015,7,10,7,194,654,848,419
3404-001,2015,7,10,8,452,1776,2228,848
3404-001,2015,7,10,9,895,1289,2184,2228
3404-001,2015,7,10,10,786,758,1544,2184
3404-001,2015,7,10,11,849,729,1578,1544
3404-001,2015,7,10,12,790,711,1501,1578
3404-001,2015,7,10,13,744,556,1300,1501
3404-001,2015,7,10,14,740,691,1431,1300
3404-001,2015,7,10,15,933,711,1644,1431
3404-001,2015,7,10,16,931,667,1598,1644
3404-001,2015,7,10,17,1016,606,1622,1598
3404-001,2015,7,10,18,1457,652,2109,1622
3404-001,2015,7,10,19,1471,569,2040,2109
3404-001,2015,7,10,20,1078,520,1598,2040
3404-001,2015,7,10,21,687,337,1024,1598
3404-001,2015,7,10,22,286,227,513,1024
3404-001,2015,7,10,23,191,160,351,513
3404-001,2015,7,10,24,66,111,177,351
3404-001,2015,7,11,1,53,88,141,177
3404-001,2015,7,11,2,44,69,113,141
3404-001,2015,7,11,3,31,51,82,113
3404-001,2015,7,11,4,11,58,69,82
3404-001,2015,7,11,5,49,73,122,69
3404-001,2015,7,11,6,108,215,323,122
3404-001,2015,7,11,7,152,445,597,323
3404-001,2015,7,11,8,305,755,1060,597
3404-001,2015,7,11,9,534,690,1224,1060
3404-001,2015,7,11,10,547,587,1134,1224
3404-001,2015,7,11,11,593,591,1184,1134
3404-001,2015,7,11,12,527,539,1066,1184
3404-001,2015,7,11,13,518,456,974,1066
3404-001,2015,7,11,14,459,466,925,974
3404-001,2015,7,11,15,477,481,958,925
3404-001,2015,7,11,16,549,391,940,958
3404-001,2015,7,11,17,681,440,1121,940
3404-001,2015,7,11,18,893,458,1351,1121
3404-001,2015,7,11,19,536,402,938,1351
3404-001,2015,7,11,20,264,295,559,938
3404-001,2015,7,11,21,240,244,484,559
3404-001,2015,7,11,22,108,163,271,484
3404-001,2015,7,11,23,88,143,231,271
3404-001,2015,7,11,24,53,73,126,231
3404-001,2015,7,12,1,36,69,105,126
3404-001,2015,7,12,2,36,33,69,105
3404-001,2015,7,12,3,9,27,36,69
3404-001,2015,7,12,4,14,23,37,36
3404-001,2015,7,12,5,11,35,46,37
3404-001,2015,7,12,6,18,59,77,46
3404-001,2015,7,12,7,38,135,173,77
3404-001,2015,7,12,8,115,216,331,173
3404-001,2015,7,12,9,178,219,397,331
3404-001,2015,7,12,10,97,207,304,397
3404-001,2015,7,12,11,126,258,384,304
3404-001,2015,7,12,12,187,279,466,384
3404-001,2015,7,12,13,222,280,502,466
3404-001,2015,7,12,14,220,279,499,502
3404-001,2015,7,12,15,235,289,524,499
3404-001,2015,7,12,16,255,306,561,524
3404-001,2015,7,12,17,281,279,560,561
3404-001,2015,7,12,18,288,279,567,560
3404-001,2015,7,12,19,176,268,444,567
3404-001,2015,7,12,20,126,266,392,444
3404-001,2015,7,12,21,99,245,344,392
3404-001,2015,7,12,22,58,201,259,344
3404-001,2015,7,12,23,53,133,186,259
3404-001,2015,7,12,24,22,92,114,186
3404-001,2015,7,13,1,20,65,85,114
3404-001,2015,7,13,2,9,44,53,85
3404-001,2015,7,13,3,20,27,47,53
3404-001,2015,7,13,4,18,22,40,47
3404-001,2015,7,13,5,22,53,75,40
3404-001,2015,7,13,6,62,240,302,75
3404-001,2015,7,13,7,106,674,780,302
3404-001,2015,7,13,8,492,1853,2345,780
3404-001,2015,7,13,9,674,1227,1901,2345
3404-001,2015,7,13,10,479,624,1103,1901
3404-001,2015,7,13,11,617,620,1237,1103
3404-001,2015,7,13,12,588,606,1194,1237
3404-001,2015,7,13,13,531,515,1046,1194
3404-001,2015,7,13,14,483,617,1100,1046
3404-001,2015,7,13,15,705,682,1387,1100
3404-001,2015,7,13,16,705,614,1319,1387
3404-001,2015,7,13,17,711,548,1259,1319
3404-001,2015,7,13,18,1103,541,1644,1259
3404-001,2015,7,13,19,1075,462,1537,1644
3404-001,2015,7,13,20,661,414,1075,1537
3404-001,2015,7,13,21,698,283,981,1075
3404-001,2015,7,13,22,356,198,554,981
3404-001,2015,7,13,23,185,125,310,554
3404-001,2015,7,13,24,62,91,153,310
3404-001,2015,7,14,1,51,77,128,153
3404-001,2015,7,14,2,33,53,86,128
3404-001,2015,7,14,3,7,45,52,86
3404-001,2015,7,14,4,22,40,62,52
3404-001,2015,7,14,5,33,81,114,62
3404-001,2015,7,14,6,139,240,379,114
3404-001,2015,7,14,7,222,584,806,379
3404-001,2015,7,14,8,496,1703,2199,806
3404-001,2015,7,14,9,819,1259,2078,2199
3404-001,2015,7,14,10,626,742,1368,2078
3404-001,2015,7,14,11,700,741,1441,1368
3404-001,2015,7,14,12,784,666,1450,1441
3404-001,2015,7,14,13,597,533,1130,1450
3404-001,2015,7,14,14,597,615,1212,1130
3404-001,2015,7,14,15,874,688,1562,1212
3404-001,2015,7,14,16,900,692,1592,1562
3404-001,2015,7,14,17,895,588,1483,1592
3404-001,2015,7,14,18,1303,543,1846,1483
3404-001,2015,7,14,19,1165,512,1677,1846
3404-001,2015,7,14,20,744,454,1198,1677
3404-001,2015,7,14,21,628,278,906,1198
3404-001,2015,7,14,22,384,240,624,906
3404-001,2015,7,14,23,130,180,310,624
3404-001,2015,7,14,24,69,110,179,310
3404-001,2015,7,15,1,38,72,110,179
3404-001,2015,7,15,2,31,61,92,110
3404-001,2015,7,15,3,14,35,49,92
3404-001,2015,7,15,4,22,50,72,49
3404-001,2015,7,15,5,51,56,107,72
3404-001,2015,7,15,6,106,237,343,107
3404-001,2015,7,15,7,202,639,841,343
3404-001,2015,7,15,8,461,1678,2139,841
3404-001,2015,7,15,9,801,1249,2050,2139
3404-001,2015,7,15,10,691,743,1434,2050
3404-001,2015,7,15,11,766,667,1433,1434
3404-001,2015,7,15,12,639,671,1310,1433
3404-001,2015,7,15,13,713,549,1262,1310
3404-001,2015,7,15,14,545,681,1226,1262
3404-001,2015,7,15,15,814,653,1467,1226
3404-001,2015,7,15,16,854,649,1503,1467
3404-001,2015,7,15,17,790,606,1396,1503
3404-001,2015,7,15,18,1430,569,1999,1396
3404-001,2015,7,15,19,1194,535,1729,1999
3404-001,2015,7,15,20,806,420,1226,1729
3404-001,2015,7,15,21,599,281,880,1226
3404-001,2015,7,15,22,341,225,566,880
3404-001,2015,7,15,23,132,172,304,566
3404-001,2015,7,15,24,110,108,218,304
3404-001,2015,7,16,1,71,82,153,218
3404-001,2015,7,16,2,40,62,102,153
3404-001,2015,7,16,3,33,35,68,102
3404-001,2015,7,16,4,27,43,70,68
3404-001,2015,7,16,5,49,82,131,70
3404-001,2015,7,16,6,123,241,364,131
3404-001,2015,7,16,7,207,602,809,364
3404-001,2015,7,16,8,468,1662,2130,809
3404-001,2015,7,16,9,738,1281,2019,2130
3404-001,2015,7,16,10,634,718,1352,2019
3404-001,2015,7,16,11,707,705,1412,1352
3404-001,2015,7,16,12,659,658,1317,1412
3404-001,2015,7,16,13,586,567,1153,1317
3404-001,2015,7,16,14,547,670,1217,1153
3404-001,2015,7,16,15,722,681,1403,1217
3404-001,2015,7,16,16,810,615,1425,1403
3404-001,2015,7,16,17,788,565,1353,1425
3404-001,2015,7,16,18,1333,555,1888,1353
3404-001,2015,7,16,19,1194,499,1693,1888
3404-001,2015,7,16,20,762,429,1191,1693
3404-001,2015,7,16,21,694,270,964,1191
3404-001,2015,7,16,22,393,200,593,964
3404-001,2015,7,16,23,137,149,286,593
3404-001,2015,7,16,24,99,117,216,286
3404-001,2015,7,17,1,73,89,162,216
3404-001,2015,7,17,2,51,64,115,162
3404-001,2015,7,17,3,53,36,89,115
3404-001,2015,7,17,4,25,58,83,89
3404-001,2015,7,17,5,53,79,132,83
3404-001,2015,7,17,6,123,199,322,132
3404-001,2015,7,17,7,220,549,769,322
3404-001,2015,7,17,8,498,1584,2082,769
3404-001,2015,7,17,9,762,1235,1997,2082
3404-001,2015,7,17,10,637,715,1352,1997
3404-001,2015,7,17,11,602,692,1294,1352
3404-001,2015,7,17,12,623,634,1257,1294
3404-001,2015,7,17,13,507,524,1031,1257
3404-001,2015,7,17,14,630,610,1240,1031
3404-001,2015,7,17,15,823,646,1469,1240
3404-001,2015,7,17,16,827,642,1469,1469
3404-001,2015,7,17,17,882,539,1421,1469
3404-001,2015,7,17,18,1415,563,1978,1421
3404-001,2015,7,17,19,1422,572,1994,1978
3404-001,2015,7,17,20,757,473,1230,1994
3404-001,2015,7,17,21,573,325,898,1230
3404-001,2015,7,17,22,253,220,473,898
3404-001,2015,7,17,23,119,149,268,473
3404-001,2015,7,17,24,69,89,158,268
3404-001,2015,7,18,1,47,75,122,158
3404-001,2015,7,18,2,40,54,94,122
3404-001,2015,7,18,3,55,46,101,94
3404-001,2015,7,18,4,25,42,67,101
3404-001,2015,7,18,5,53,60,113,67
3404-001,2015,7,18,6,95,185,280,113
3404-001,2015,7,18,7,198,402,600,280
3404-001,2015,7,18,8,312,704,1016,600
3404-001,2015,7,18,9,591,746,1337,1016
3404-001,2015,7,18,10,538,638,1176,1337
3404-001,2015,7,18,11,626,583,1209,1176
3404-001,2015,7,18,12,507,540,1047,1209
3404-001,2015,7,18,13,472,481,953,1047
3404-001,2015,7,18,14,441,452,893,953
3404-001,2015,7,18,15,547,458,1005,893
3404-001,2015,7,18,16,525,404,929,1005
3404-001,2015,7,18,17,599,448,1047,929
3404-001,2015,7,18,18,771,469,1240,1047
3404-001,2015,7,18,19,538,395,933,1240
3404-001,2015,7,18,20,294,285,579,933
3404-001,2015,7,18,21,178,213,391,579
3404-001,2015,7,18,22,79,156,235,391
3404-001,2015,7,18,23,71,114,185,235
3404-001,2015,7,18,24,47,78,125,185
3404-001,2015,7,19,1,36,52,88,125
3404-001,2015,7,19,2,20,47,67,88
3404-001,2015,7,19,3,18,30,48,67
3404-001,2015,7,19,4,11,30,41,48
3404-001,2015,7,19,5,11,36,47,41
3404-001,2015,7,19,6,29,80,109,47
3404-001,2015,7,19,7,62,178,240,109
3404-001,2015,7,19,8,112,237,349,240
3404-001,2015,7,19,9,207,252,459,349
3404-001,2015,7,19,10,191,246,437,459
3404-001,2015,7,19,11,237,340,577,437
3404-001,2015,7,19,12,224,343,567,577
3404-001,2015,7,19,13,220,409,629,567
3404-001,2015,7,19,14,235,402,637,629
3404-001,2015,7,19,15,251,370,621,637
3404-001,2015,7,19,16,334,356,690,621
3404-001,2015,7,19,17,398,347,745,690
3404-001,2015,7,19,18,411,326,737,745
3404-001,2015,7,19,19,290,308,598,737
3404-001,2015,7,19,20,218,282,500,598
3404-001,2015,7,19,21,176,289,465,500
3404-001,2015,7,19,22,88,227,315,465
3404-001,2015,7,19,23,64,182,246,315
3404-001,2015,7,19,24,44,118,162,246
3404-001,2015,7,20,1,29,75,104,162
3404-001,2015,7,20,2,3,38,41,104
3404-001,2015,7,20,3,5,37,42,41
3404-001,2015,7,20,4,18,35,53,42
3404-001,2015,7,20,5,33,63,96,53
3404-001,2015,7,20,6,95,292,387,96
3404-001,2015,7,20,7,211,726,937,387
3404-001,2015,7,20,8,415,1945,2360,937
3404-001,2015,7,20,9,727,1269,1996,2360
3404-001,2015,7,20,10,604,676,1280,1996
3404-001,2015,7,20,11,716,672,1388,1280
3404-001,2015,7,20,12,687,653,1340,1388
3404-001,2015,7,20,13,507,542,1049,1340
3404-001,2015,7,20,14,597,621,1218,1049
3404-001,2015,7,20,15,722,731,1453,1218
3404-001,2015,7,20,16,762,667,1429,1453
3404-001,2015,7,20,17,799,548,1347,1429
3404-001,2015,7,20,18,1146,546,1692,1347
3404-001,2015,7,20,19,1117,482,1599,1692
3404-001,2015,7,20,20,784,392,1176,1599
3404-001,2015,7,20,21,744,253,997,1176
3404-001,2015,7,20,22,365,248,613,997
3404-001,2015,7,20,23,178,162,340,613
3404-001,2015,7,20,24,130,89,219,340
3404-001,2015,7,21,1,66,62,128,219
3404-001,2015,7,21,2,47,52,99,128
3404-001,2015,7,21,3,22,44,66,99
3404-001,2015,7,21,4,31,42,73,66
3404-001,2015,7,21,5,49,66,115,73
3404-001,2015,7,21,6,90,196,286,115
3404-001,2015,7,21,7,191,518,709,286
3404-001,2015,7,21,8,417,1659,2076,709
3404-001,2015,7,21,9,740,1371,2111,2076
3404-001,2015,7,21,10,591,715,1306,2111
3404-001,2015,7,21,11,713,673,1386,1306
3404-001,2015,7,21,12,661,659,1320,1386
3404-001,2015,7,21,13,588,559,1147,1320
3404-001,2015,7,21,14,580,611,1191,1147
3404-001,2015,7,21,15,779,652,1431,1191
3404-001,2015,7,21,16,803,636,1439,1431
3404-001,2015,7,21,17,786,589,1375,1439
3404-001,2015,7,21,18,1269,559,1828,1375
3404-001,2015,7,21,19,1119,455,1574,1828
3404-001,2015,7,21,20,751,407,1158,1574
3404-001,2015,7,21,21,735,282,1017,1158
3404-001,2015,7,21,22,323,222,545,1017
3404-001,2015,7,21,23,202,130,332,545
3404-001,2015,7,21,24,88,99,187,332
3404-001,2015,7,22,1,47,71,118,187
3404-001,2015,7,22,2,51,38,89,118
3404-001,2015,7,22,3,27,39,66,89
3404-001,2015,7,22,4,25,47,72,66
3404-001,2015,7,22,5,31,75,106,72
3404-001,2015,7,22,6,117,225,342,106
3404-001,2015,7,22,7,209,581,790,342
3404-001,2015,7,22,8,468,1726,2194,790
3404-001,2015,7,22,9,720,1323,2043,2194
3404-001,2015,7,22,10,674,682,1356,2043
3404-001,2015,7,22,11,608,687,1295,1356
3404-001,2015,7,22,12,685,633,1318,1295
3404-001,2015,7,22,13,534,551,1085,1318
3404-001,2015,7,22,14,597,630,1227,1085
3404-001,2015,7,22,15,729,695,1424,1227
3404-001,2015,7,22,16,810,620,1430,1424
3404-001,2015,7,22,17,801,630,1431,1430
3404-001,2015,7,22,18,1410,569,1979,1431
3404-001,2015,7,22,19,1290,528,1818,1979
3404-001,2015,7,22,20,799,394,1193,1818
3404-001,2015,7,22,21,531,243,774,1193
3404-001,2015,7,22,22,297,206,503,774
3404-001,2015,7,22,23,200,154,354,503
3404-001,2015,7,22,24,82,120,202,354
3404-001,2015,7,23,1,42,73,115,202
3404-001,2015,7,23,2,51,66,117,115
3404-001,2015,7,23,3,22,38,60,117
3404-001,2015,7,23,4,18,40,58,60
3404-001,2015,7,23,5,47,80,127,58
3404-001,2015,7,23,6,77,233,310,127
3404-001,2015,7,23,7,205,605,810,310
3404-001,2015,7,23,8,477,1657,2134,810
3404-001,2015,7,23,9,790,1261,2051,2134
3404-001,2015,7,23,10,648,675,1323,2051
3404-001,2015,7,23,11,696,708,1404,1323
3404-001,2015,7,23,12,674,611,1285,1404
3404-001,2015,7,23,13,492,560,1052,1285
3404-001,2015,7,23,14,558,566,1124,1052
3404-001,2015,7,23,15,661,687,1348,1124
3404-001,2015,7,23,16,768,582,1350,1348
3404-001,2015,7,23,17,770,541,1311,1350
3404-001,2015,7,23,18,1228,539,1767,1311
3404-001,2015,7,23,19,999,500,1499,1767
3404-001,2015,7,23,20,707,391,1098,1499
3404-001,2015,7,23,21,593,259,852,1098
3404-001,2015,7,23,22,268,192,460,852
3404-001,2015,7,23,23,156,135,291,460
3404-001,2015,7,23,24,71,91,162,291
3404-001,2015,7,24,1,60,66,126,162
3404-001,2015,7,24,2,27,57,84,126
3404-001,2015,7,24,3,25,30,55,84
3404-001,2015,7,24,4,27,44,71,55
3404-001,2015,7,24,5,36,46,82,71
3404-001,2015,7,24,6,62,186,248,82
3404-001,2015,7,24,7,119,495,614,248
3404-001,2015,7,24,8,301,1533,1834,614
3404-001,2015,7,24,9,637,1272,1909,1834
3404-001,2015,7,24,10,492,566,1058,1909
3404-001,2015,7,24,11,573,579,1152,1058
3404-001,2015,7,24,12,582,617,1199,1152
3404-001,2015,7,24,13,498,504,1002,1199
3404-001,2015,7,24,14,549,564,1113,1002
3404-001,2015,7,24,15,619,631,1250,1113
3404-001,2015,7,24,16,852,651,1503,1250
3404-001,2015,7,24,17,759,524,1283,1503
3404-001,2015,7,24,18,1460,565,2025,1283
3404-001,2015,7,24,19,1321,498,1819,2025
3404-001,2015,7,24,20,803,454,1257,1819
3404-001,2015,7,24,21,512,310,822,1257
3404-001,2015,7,24,22,279,205,484,822
3404-001,2015,7,24,23,158,144,302,484
3404-001,2015,7,24,24,90,119,209,302
3404-001,2015,7,25,1,49,71,120,209
3404-001,2015,7,25,2,40,47,87,120
3404-001,2015,7,25,3,29,34,63,87
3404-001,2015,7,25,4,29,50,79,63
3404-001,2015,7,25,5,38,64,102,79
3404-001,2015,7,25,6,66,170,236,102
3404-001,2015,7,25,7,130,362,492,236
3404-001,2015,7,25,8,224,766,990,492
3404-001,2015,7,25,9,512,626,1138,990
3404-001,2015,7,25,10,448,526,974,1138
3404-001,2015,7,25,11,492,569,1061,974
3404-001,2015,7,25,12,470,524,994,1061
3404-001,2015,7,25,13,472,473,945,994
3404-001,2015,7,25,14,461,478,939,945
3404-001,2015,7,25,15,597,464,1061,939
3404-001,2015,7,25,16,461,404,865,1061
3404-001,2015,7,25,17,617,423,1040,865
3404-001,2015,7,25,18,804,422,1226,1040
3404-001,2015,7,25,19,419,330,749,1226
3404-001,2015,7,25,20,266,264,530,749
3404-001,2015,7,25,21,169,244,413,530
3404-001,2015,7,25,22,139,160,299,413
3404-001,2015,7,25,23,60,105,165,299
3404-001,2015,7,25,24,58,72,130,165
3404-001,2015,7,26,1,53,53,106,130
3404-001,2015,7,26,2,22,38,60,106
3404-001,2015,7,26,3,14,29,43,60
3404-001,2015,7,26,4,7,30,37,43
3404-001,2015,7,26,5,16,34,50,37
3404-001,2015,7,26,6,16,113,129,50
3404-001,2015,7,26,7,51,179,230,129
3404-001,2015,7,26,8,95,225,320,230
3404-001,2015,7,26,9,174,265,439,320
3404-001,2015,7,26,10,158,278,436,439
3404-001,2015,7,26,11,198,335,533,436
3404-001,2015,7,26,12,200,325,525,533
3404-001,2015,7,26,13,255,324,579,525
3404-001,2015,7,26,14,248,332,580,579
3404-001,2015,7,26,15,281,335,616,580
3404-001,2015,7,26,16,330,338,668,616
3404-001,2015,7,26,17,321,373,694,668
3404-001,2015,7,26,18,424,367,791,694
3404-001,2015,7,26,19,292,346,638,791
3404-001,2015,7,26,20,233,290,523,638
3404-001,2015,7,26,21,211,286,497,523
3404-001,2015,7,26,22,121,212,333,497
3404-001,2015,7,26,23,84,184,268,333
3404-001,2015,7,26,24,44,118,162,268
3404-001,2015,7,27,1,27,70,97,162
3404-001,2015,7,27,2,7,43,50,97
3404-001,2015,7,27,3,9,39,48,50
3404-001,2015,7,27,4,11,41,52,48
3404-001,2015,7,27,5,18,69,87,52
3404-001,2015,7,27,6,73,249,322,87
3404-001,2015,7,27,7,185,682,867,322
3404-001,2015,7,27,8,444,1826,2270,867
3404-001,2015,7,27,9,661,1252,1913,2270
3404-001,2015,7,27,10,604,642,1246,1913
3404-001,2015,7,27,11,637,671,1308,1246
3404-001,2015,7,27,12,652,650,1302,1308
3404-001,2015,7,27,13,536,564,1100,1302
3404-001,2015,7,27,14,643,646,1289,1100
3404-001,2015,7,27,15,812,682,1494,1289
3404-001,2015,7,27,16,812,612,1424,1494
3404-001,2015,7,27,17,867,610,1477,1424
3404-001,2015,7,27,18,1280,620,1900,1477
3404-001,2015,7,27,19,1119,499,1618,1900
3404-001,2015,7,27,20,674,389,1063,1618
3404-001,2015,7,27,21,656,249,905,1063
3404-001,2015,7,27,22,376,217,593,905
3404-001,2015,7,27,23,154,144,298,593
3404-001,2015,7,27,24,95,94,189,298
3404-001,2015,7,28,1,42,88,130,189
3404-001,2015,7,28,2,36,51,87,130
3404-001,2015,7,28,3,22,42,64,87
3404-001,2015,7,28,4,20,47,67,64
3404-001,2015,7,28,5,40,73,113,67
3404-001,2015,7,28,6,88,219,307,113
3404-001,2015,7,28,7,259,622,881,307
3404-001,2015,7,28,8,437,1662,2099,881
3404-001,2015,7,28,9,681,1309,1990,2099
3404-001,2015,7,28,10,661,729,1390,1990
3404-001,2015,7,28,11,779,714,1493,1390
3404-001,2015,7,28,12,672,665,1337,1493
3404-001,2015,7,28,13,634,576,1210,1337
3404-001,2015,7,28,14,621,627,1248,1210
3404-001,2015,7,28,15,836,712,1548,1248
3404-001,2015,7,28,16,863,654,1517,1548
3404-001,2015,7,28,17,786,650,1436,1517
3404-001,2015,7,28,18,1418,572,1990,1436
3404-001,2015,7,28,19,1271,534,1805,1990
3404-001,2015,7,28,20,806,394,1200,1805
3404-001,2015,7,28,21,707,296,1003,1200
3404-001,2015,7,28,22,349,203,552,1003
3404-001,2015,7,28,23,161,160,321,552
3404-001,2015,7,28,24,95,119,214,321
3404-001,2015,7,29,1,66,92,158,214
3404-001,2015,7,29,2,44,50,94,158
3404-001,2015,7,29,3,25,35,60,94
3404-001,2015,7,29,4,18,57,75,60
3404-001,2015,7,29,5,29,64,93,75
3404-001,2015,7,29,6,93,227,320,93
3404-001,2015,7,29,7,174,540,714,320
3404-001,2015,7,29,8,404,1523,1927,714
3404-001,2015,7,29,9,492,1201,1693,1927
3404-001,2015,7,29,10,503,632,1135,1693
3404-001,2015,7,29,11,490,577,1067,1135
3404-001,2015,7,29,12,540,594,1134,1067
3404-001,2015,7,29,13,490,561,1051,1134
3404-001,2015,7,29,14,555,646,1201,1051
3404-001,2015,7,29,15,755,634,1389,1201
3404-001,2015,7,29,16,830,680,1510,1389
3404-001,2015,7,29,17,764,578,1342,1510
3404-001,2015,7,29,18,1271,552,1823,1342
3404-001,2015,7,29,19,1161,486,1647,1823
3404-001,2015,7,29,20,650,383,1033,1647
3404-001,2015,7,29,21,575,270,845,1033
3404-001,2015,7,29,22,327,211,538,845
3404-001,2015,7,29,23,130,126,256,538
3404-001,2015,7,29,24,69,101,170,256
3404-001,2015,7,30,1,44,64,108,170
3404-001,2015,7,30,2,44,49,93,108
3404-001,2015,7,30,3,16,49,65,93
3404-001,2015,7,30,4,47,40,87,65
3404-001,2015,7,30,5,44,88,132,87
3404-001,2015,7,30,6,86,248,334,132
3404-001,2015,7,30,7,167,546,713,334
3404-001,2015,7,30,8,459,1654,2113,713
3404-001,2015,7,30,9,650,1258,1908,2113
3404-001,2015,7,30,10,580,662,1242,1908
3404-001,2015,7,30,11,650,680,1330,1242
3404-001,2015,7,30,12,595,681,1276,1330
3404-001,2015,7,30,13,512,576,1088,1276
3404-001,2015,7,30,14,630,569,1199,1088
3404-001,2015,7,30,15,674,658,1332,1199
3404-001,2015,7,30,16,733,609,1342,1332
3404-001,2015,7,30,17,786,529,1315,1342
3404-001,2015,7,30,18,1218,553,1771,1315
3404-001,2015,7,30,19,1371,521,1892,1771
3404-001,2015,7,30,20,650,437,1087,1892
3404-001,2015,7,30,21,685,298,983,1087
3404-001,2015,7,30,22,367,211,578,983
3404-001,2015,7,30,23,196,181,377,578
3404-001,2015,7,30,24,82,125,207,377
3404-001,2015,7,31,1,64,80,144,207
3404-001,2015,7,31,2,33,56,89,144
3404-001,2015,7,31,3,29,42,71,89
3404-001,2015,7,31,4,29,41,70,71
3404-001,2015,7,31,5,53,68,121,70
3404-001,2015,7,31,6,106,219,325,121
3404-001,2015,7,31,7,205,554,759,325
3404-001,2015,7,31,8,395,1580,1975,759
3404-001,2015,7,31,9,630,1175,1805,1975
3404-001,2015,7,31,10,632,670,1302,1805
3404-001,2015,7,31,11,641,700,1341,1302
3404-001,2015,7,31,12,608,584,1192,1341
3404-001,2015,7,31,13,591,523,1114,1192
3404-001,2015,7,31,14,571,605,1176,1114
3404-001,2015,7,31,15,687,642,1329,1176
3404-001,2015,7,31,16,797,634,1431,1329
3404-001,2015,7,31,17,889,542,1431,1431
3404-001,2015,7,31,18,1652,580,2232,1431
3404-001,2015,7,31,19,1486,556,2042,2232
3404-001,2015,7,31,20,922,491,1413,2042
3404-001,2015,7,31,21,575,310,885,1413
3404-001,2015,7,31,22,264,227,491,885
3404-001,2015,7,31,23,161,165,326,491
3404-001,2015,7,31,24,97,115,212,326
3404-001,2015,8,1,1,55,86,141,212
3404-001,2015,8,1,2,39,61,100,141
3404-001,2015,8,1,3,39,42,81,100
3404-001,2015,8,1,4,39,42,81,81
3404-001,2015,8,1,5,57,63,120,81
3404-001,2015,8,1,6,102,181,283,120
3404-001,2015,8,1,7,200,344,544,283
3404-001,2015,8,1,8,331,580,911,544
3404-001,2015,8,1,9,405,588,993,911
3404-001,2015,8,1,10,414,570,984,993
3404-001,2015,8,1,11,564,585,1149,984
3404-001,2015,8,1,12,464,544,1008,1149
3404-001,2015,8,1,13,423,527,950,1008
3404-001,2015,8,1,14,432,545,977,950
3404-001,2015,8,1,15,453,477,930,977
3404-001,2015,8,1,16,550,439,989,930
3404-001,2015,8,1,17,487,407,894,989
3404-001,2015,8,1,18,560,406,966,894
3404-001,2015,8,1,19,469,367,836,966
3404-001,2015,8,1,20,227,289,516,836
3404-001,2015,8,1,21,161,244,405,516
3404-001,2015,8,1,22,141,171,312,405
3404-001,2015,8,1,23,109,129,238,312
3404-001,2015,8,1,24,46,92,138,238
3404-001,2015,8,2,1,41,51,92,138
3404-001,2015,8,2,2,16,31,47,92
3404-001,2015,8,2,3,23,23,46,47
3404-001,2015,8,2,4,16,21,37,46
3404-001,2015,8,2,5,23,31,54,37
3404-001,2015,8,2,6,39,68,107,54
3404-001,2015,8,2,7,41,145,186,107
3404-001,2015,8,2,8,123,240,363,186
3404-001,2015,8,2,9,152,254,406,363
3404-001,2015,8,2,10,166,263,429,406
3404-001,2015,8,2,11,159,314,473,429
3404-001,2015,8,2,12,197,302,499,473
3404-001,2015,8,2,13,197,315,512,499
3404-001,2015,8,2,14,261,308,569,512
3404-001,2015,8,2,15,281,262,543,569
3404-001,2015,8,2,16,247,318,565,543
3404-001,2015,8,2,17,498,320,818,565
3404-001,2015,8,2,18,628,300,928,818
3404-001,2015,8,2,19,295,295,590,928
3404-001,2015,8,2,20,258,222,480,590
3404-001,2015,8,2,21,209,249,458,480
3404-001,2015,8,2,22,98,191,289,458
3404-001,2015,8,2,23,80,162,242,289
3404-001,2015,8,2,24,57,88,145,242
3404-001,2015,8,3,1,34,70,104,145
3404-001,2015,8,3,2,25,40,65,104
3404-001,2015,8,3,3,28,33,61,65
3404-001,2015,8,3,4,19,32,51,61
3404-001,2015,8,3,5,16,51,67,51
3404-001,2015,8,3,6,73,202,275,67
3404-001,2015,8,3,7,168,486,654,275
3404-001,2015,8,3,8,313,1055,1368,654
3404-001,2015,8,3,9,527,862,1389,1368
3404-001,2015,8,3,10,460,571,1031,1389
3404-001,2015,8,3,11,505,531,1036,1031
3404-001,2015,8,3,12,478,574,1052,1036
3404-001,2015,8,3,13,457,487,944,1052
3404-001,2015,8,3,14,489,555,1044,944
3404-001,2015,8,3,15,647,510,1157,1044
3404-001,2015,8,3,16,618,482,1100,1157
3404-001,2015,8,3,17,659,433,1092,1100
3404-001,2015,8,3,18,870,444,1314,1092
3404-001,2015,8,3,19,849,378,1227,1314
3404-001,2015,8,3,20,464,323,787,1227
3404-001,2015,8,3,21,365,224,589,787
3404-001,2015,8,3,22,229,183,412,589
3404-001,2015,8,3,23,84,138,222,412
3404-001,2015,8,3,24,66,87,153,222
3404-001,2015,8,4,1,32,57,89,153
3404-001,2015,8,4,2,16,30,46,89
3404-001,2015,8,4,3,7,43,50,46
3404-001,2015,8,4,4,10,36,46,50
3404-001,2015,8,4,5,39,39,78,46
3404-001,2015,8,4,6,91,172,263,78
3404-001,2015,8,4,7,138,390,528,263
3404-001,2015,8,4,8,308,931,1239,528
3404-001,2015,8,4,9,482,797,1279,1239
3404-001,2015,8,4,10,444,562,1006,1279
3404-001,2015,8,4,11,480,557,1037,1006
3404-001,2015,8,4,12,586,495,1081,1037
3404-001,2015,8,4,13,482,432,914,1081
3404-001,2015,8,4,14,417,498,915,914
3404-001,2015,8,4,15,645,493,1138,915
3404-001,2015,8,4,16,677,493,1170,1138
3404-001,2015,8,4,17,652,444,1096,1170
3404-001,2015,8,4,18,901,459,1360,1096
3404-001,2015,8,4,19,978,418,1396,1360
3404-001,2015,8,4,20,514,340,854,1396
3404-001,2015,8,4,21,408,263,671,854
3404-001,2015,8,4,22,211,194,405,671
3404-001,2015,8,4,23,89,151,240,405
3404-001,2015,8,4,24,93,104,197,240
3404-001,2015,8,5,1,30,65,95,197
3404-001,2015,8,5,2,12,40,52,95
3404-001,2015,8,5,3,14,25,39,52
3404-001,2015,8,5,4,14,28,42,39
3404-001,2015,8,5,5,23,43,66,42
3404-001,2015,8,5,6,71,165,236,66
3404-001,2015,8,5,7,188,400,588,236
3404-001,2015,8,5,8,351,942,1293,588
3404-001,2015,8,5,9,548,841,1389,1293
3404-001,2015,8,5,10,500,592,1092,1389
3404-001,2015,8,5,11,475,573,1048,1092
3404-001,2015,8,5,12,500,529,1029,1048
3404-001,2015,8,5,13,491,399,890,1029
3404-001,2015,8,5,14,480,497,977,890
3404-001,2015,8,5,15,568,524,1092,977
3404-001,2015,8,5,16,487,483,970,1092
3404-001,2015,8,5,17,636,467,1103,970
3404-001,2015,8,5,18,928,467,1395,1103
3404-001,2015,8,5,19,851,460,1311,1395
3404-001,2015,8,5,20,446,316,762,1311
3404-001,2015,8,5,21,304,228,532,762
3404-001,2015,8,5,22,240,172,412,532
3404-001,2015,8,5,23,114,129,243,412
3404-001,2015,8,5,24,86,98,184,243
3404-001,2015,8,6,1,46,60,106,184
3404-001,2015,8,6,2,16,52,68,106
3404-001,2015,8,6,3,28,36,64,68
3404-001,2015,8,6,4,25,48,73,64
3404-001,2015,8,6,5,37,42,79,73
3404-001,2015,8,6,6,59,175,234,79
3404-001,2015,8,6,7,159,473,632,234
3404-001,2015,8,6,8,374,1168,1542,632
3404-001,2015,8,6,9,570,991,1561,1542
3404-001,2015,8,6,10,546,631,1177,1561
3404-001,2015,8,6,11,742,602,1344,1177
3404-001,2015,8,6,12,600,577,1177,1344
3404-001,2015,8,6,13,550,476,1026,1177
3404-001,2015,8,6,14,523,575,1098,1026
3404-001,2015,8,6,15,756,575,1331,1098
3404-001,2015,8,6,16,593,548,1141,1331
3404-001,2015,8,6,17,609,515,1124,1141
3404-001,2015,8,6,18,1027,545,1572,1124
3404-001,2015,8,6,19,1058,430,1488,1572
3404-001,2015,8,6,20,561,320,881,1488
3404-001,2015,8,6,21,496,249,745,881
3404-001,2015,8,6,22,263,211,474,745
3404-001,2015,8,6,23,157,124,281,474
3404-001,2015,8,6,24,86,87,173,281
3404-001,2015,8,7,1,34,71,105,173
3404-001,2015,8,7,2,37,50,87,105
3404-001,2015,8,7,3,14,36,50,87
3404-001,2015,8,7,4,28,39,67,50
3404-001,2015,8,7,5,53,58,111,67
3404-001,2015,8,7,6,73,182,255,111
3404-001,2015,8,7,7,211,424,635,255
3404-001,2015,8,7,8,389,1161,1550,635
3404-001,2015,8,7,9,631,1025,1656,1550
3404-001,2015,8,7,10,566,634,1200,1656
3404-001,2015,8,7,11,622,657,1279,1200
3404-001,2015,8,7,12,589,585,1174,1279
3404-001,2015,8,7,13,577,495,1072,1174
3404-001,2015,8,7,14,575,552,1127,1072
3404-001,2015,8,7,15,656,548,1204,1127
3404-001,2015,8,7,16,720,556,1276,1204
3404-001,2015,8,7,17,745,519,1264,1276
3404-001,2015,8,7,18,1208,592,1800,1264
3404-001,2015,8,7,19,1239,523,1762,1800
3404-001,2015,8,7,20,695,372,1067,1762
3404-001,2015,8,7,21,444,323,767,1067
3404-001,2015,8,7,22,249,220,469,767
3404-001,2015,8,7,23,111,130,241,469
3404-001,2015,8,7,24,66,87,153,241
3404-001,2015,8,8,1,21,70,91,153
3404-001,2015,8,8,2,21,45,66,91
3404-001,2015,8,8,3,28,55,83,66
3404-001,2015,8,8,4,25,31,56,83
3404-001,2015,8,8,5,48,62,110,56
3404-001,2015,8,8,6,53,163,216,110
3404-001,2015,8,8,7,175,335,510,216
3404-001,2015,8,8,8,261,619,880,510
3404-001,2015,8,8,9,421,633,1054,880
3404-001,2015,8,8,10,435,536,971,1054
3404-001,2015,8,8,11,469,547,1016,971
3404-001,2015,8,8,12,503,501,1004,1016
3404-001,2015,8,8,13,408,462,870,1004
3404-001,2015,8,8,14,374,403,777,870
3404-001,2015,8,8,15,435,406,841,777
3404-001,2015,8,8,16,403,380,783,841
3404-001,2015,8,8,17,498,362,860,783
3404-001,2015,8,8,18,648,358,1006,860
3404-001,2015,8,8,19,358,333,691,1006
3404-001,2015,8,8,20,197,238,435,691
3404-001,2015,8,8,21,168,272,440,435
3404-001,2015,8,8,22,152,156,308,440
3404-001,2015,8,8,23,62,119,181,308
3404-001,2015,8,8,24,41,106,147,181
3404-001,2015,8,9,1,37,45,82,147
3404-001,2015,8,9,2,21,34,55,82
3404-001,2015,8,9,3,16,25,41,55
3404-001,2015,8,9,4,10,30,40,41
3404-001,2015,8,9,5,3,29,32,40
3404-001,2015,8,9,6,43,86,129,32
3404-001,2015,8,9,7,59,209,268,129
3404-001,2015,8,9,8,107,305,412,268
3404-001,2015,8,9,9,200,301,501,412
3404-001,2015,8,9,10,175,246,421,501
3404-001,2015,8,9,11,202,306,508,421
3404-001,2015,8,9,12,265,335,600,508
3404-001,2015,8,9,13,254,276,530,600
3404-001,2015,8,9,14,261,367,628,530
3404-001,2015,8,9,15,310,304,614,628
3404-001,2015,8,9,16,378,351,729,614
3404-001,2015,8,9,17,401,327,728,729
3404-001,2015,8,9,18,367,340,707,728
3404-001,2015,8,9,19,319,320,639,707
3404-001,2015,8,9,20,233,288,521,639
3404-001,2015,8,9,21,195,305,500,521
3404-001,2015,8,9,22,125,203,328,500
3404-001,2015,8,9,23,62,143,205,328
3404-001,2015,8,9,24,32,99,131,205
3404-001,2015,8,10,1,43,70,113,131
3404-001,2015,8,10,2,10,32,42,113
3404-001,2015,8,10,3,12,38,50,42
3404-001,2015,8,10,4,12,32,44,50
3404-001,2015,8,10,5,21,59,80,44
3404-001,2015,8,10,6,82,261,343,80
3404-001,2015,8,10,7,195,657,852,343
3404-001,2015,8,10,8,478,1842,2320,852
3404-001,2015,8,10,9,726,1348,2074,2320
3404-001,2015,8,10,10,539,701,1240,2074
3404-001,2015,8,10,11,589,693,1282,1240
3404-001,2015,8,10,12,543,653,1196,1282
3404-001,2015,8,10,13,629,602,1231,1196
3404-001,2015,8,10,14,527,613,1140,1231
3404-001,2015,8,10,15,747,698,1445,1140
3404-001,2015,8,10,16,758,619,1377,1445
3404-001,2015,8,10,17,842,579,1421,1377
3404-001,2015,8,10,18,1203,586,1789,1421
3404-001,2015,8,10,19,1215,471,1686,1789
3404-001,2015,8,10,20,837,438,1275,1686
3404-001,2015,8,10,21,828,296,1124,1275
3404-001,2015,8,10,22,313,213,526,1124
3404-001,2015,8,10,23,145,137,282,526
3404-001,2015,8,10,24,109,109,218,282
3404-001,2015,8,11,1,82,70,152,218
3404-001,2015,8,11,2,43,64,107,152
3404-001,2015,8,11,3,43,43,86,107
3404-001,2015,8,11,4,39,39,78,86
3404-001,2015,8,11,5,62,55,117,78
3404-001,2015,8,11,6,95,231,326,117
3404-001,2015,8,11,7,200,575,775,326
3404-001,2015,8,11,8,525,1715,2240,775
3404-001,2015,8,11,9,745,1289,2034,2240
3404-001,2015,8,11,10,668,661,1329,2034
3404-001,2015,8,11,11,756,719,1475,1329
3404-001,2015,8,11,12,681,683,1364,1475
3404-001,2015,8,11,13,561,565,1126,1364
3404-001,2015,8,11,14,684,704,1388,1126
3404-001,2015,8,11,15,828,753,1581,1388
3404-001,2015,8,11,16,912,685,1597,1581
3404-001,2015,8,11,17,937,598,1535,1597
3404-001,2015,8,11,18,1258,560,1818,1535
3404-001,2015,8,11,19,1217,531,1748,1818
3404-001,2015,8,11,20,833,397,1230,1748
3404-001,2015,8,11,21,754,285,1039,1230
3404-001,2015,8,11,22,356,208,564,1039
3404-001,2015,8,11,23,168,156,324,564
3404-001,2015,8,11,24,91,108,199,324
3404-001,2015,8,12,1,75,59,134,199
3404-001,2015,8,12,2,43,53,96,134
3404-001,2015,8,12,3,37,42,79,96
3404-001,2015,8,12,4,25,56,81,79
3404-001,2015,8,12,5,46,57,103,81
3404-001,2015,8,12,6,114,205,319,103
3404-001,2015,8,12,7,184,567,751,319
3404-001,2015,8,12,8,471,1690,2161,751
3404-001,2015,8,12,9,806,1271,2077,2161
3404-001,2015,8,12,10,638,670,1308,2077
3404-001,2015,8,12,11,650,692,1342,1308
3404-001,2015,8,12,12,665,668,1333,1342
3404-001,2015,8,12,13,726,537,1263,1333
3404-001,2015,8,12,14,557,641,1198,1263
3404-001,2015,8,12,15,765,671,1436,1198
3404-001,2015,8,12,16,767,692,1459,1436
3404-001,2015,8,12,17,898,580,1478,1459
3404-001,2015,8,12,18,1409,552,1961,1478
3404-001,2015,8,12,19,1296,542,1838,1961
3404-001,2015,8,12,20,824,423,1247,1838
3404-001,2015,8,12,21,645,260,905,1247
3404-001,2015,8,12,22,308,222,530,905
3404-001,2015,8,12,23,186,151,337,530
3404-001,2015,8,12,24,105,109,214,337
3404-001,2015,8,13,1,50,71,121,214
3404-001,2015,8,13,2,37,55,92,121
3404-001,2015,8,13,3,34,44,78,92
3404-001,2015,8,13,4,53,47,100,78
3404-001,2015,8,13,5,55,69,124,100
3404-001,2015,8,13,6,116,207,323,124
3404-001,2015,8,13,7,231,587,818,323
3404-001,2015,8,13,8,482,1707,2189,818
3404-001,2015,8,13,9,769,1382,2151,2189
3404-001,2015,8,13,10,684,689,1373,2151
3404-001,2015,8,13,11,790,767,1557,1373
3404-001,2015,8,13,12,758,668,1426,1557
3404-001,2015,8,13,13,570,551,1121,1426
3404-001,2015,8,13,14,679,659,1338,1121
3404-001,2015,8,13,15,808,733,1541,1338
3404-001,2015,8,13,16,883,703,1586,1541
3404-001,2015,8,13,17,1014,614,1628,1586
3404-001,2015,8,13,18,1430,627,2057,1628
3404-001,2015,8,13,19,1524,597,2121,2057
3404-001,2015,8,13,20,959,494,1453,2121
3404-001,2015,8,13,21,774,319,1093,1453
3404-001,2015,8,13,22,369,233,602,1093
3404-001,2015,8,13,23,161,171,332,602
3404-001,2015,8,13,24,95,111,206,332
3404-001,2015,8,14,1,53,87,140,206
3404-001,2015,8,14,2,46,75,121,140
3404-001,2015,8,14,3,34,38,72,121
3404-001,2015,8,14,4,25,51,76,72
3404-001,2015,8,14,5,28,59,87,76
3404-001,2015,8,14,6,95,185,280,87
3404-001,2015,8,14,7,231,459,690,280
3404-001,2015,8,14,8,374,1108,1482,690
3404-001,2015,8,14,9,668,1001,1669,1482
3404-001,2015,8,14,10,611,724,1335,1669
3404-001,2015,8,14,11,706,697,1403,1335
3404-001,2015,8,14,12,720,730,1450,1403
3404-001,2015,8,14,13,579,601,1180,1450
3404-001,2015,8,14,14,584,600,1184,1180
3404-001,2015,8,14,15,711,568,1279,1184
3404-001,2015,8,14,16,681,575,1256,1279
3404-001,2015,8,14,17,731,506,1237,1256
3404-001,2015,8,14,18,1204,508,1712,1237
3404-001,2015,8,14,19,935,453,1388,1712
3404-001,2015,8,14,20,559,369,928,1388
3404-001,2015,8,14,21,367,295,662,928
3404-001,2015,8,14,22,197,225,422,662
3404-001,2015,8,14,23,148,132,280,422
3404-001,2015,8,14,24,71,106,177,280
3404-001,2015,8,15,1,34,79,113,177
3404-001,2015,8,15,2,30,35,65,113
3404-001,2015,8,15,3,23,41,64,65
3404-001,2015,8,15,4,25,41,66,64
3404-001,2015,8,15,5,21,72,93,66
3404-001,2015,8,15,6,57,192,249,93
3404-001,2015,8,15,7,152,317,469,249
3404-001,2015,8,15,8,261,589,850,469
3404-001,2015,8,15,9,389,546,935,850
3404-001,2015,8,15,10,351,540,891,935
3404-001,2015,8,15,11,389,550,939,891
3404-001,2015,8,15,12,353,521,874,939
3404-001,2015,8,15,13,347,411,758,874
3404-001,2015,8,15,14,374,400,774,758
3404-001,2015,8,15,15,487,397,884,774
3404-001,2015,8,15,16,446,393,839,884
3404-001,2015,8,15,17,573,356,929,839
3404-001,2015,8,15,18,700,386,1086,929
3404-001,2015,8,15,19,618,340,958,1086
3404-001,2015,8,15,20,306,274,580,958
3404-001,2015,8,15,21,227,231,458,580
3404-001,2015,8,15,22,98,155,253,458
3404-001,2015,8,15,23,93,121,214,253
3404-001,2015,8,15,24,53,97,150,214
3404-001,2015,8,16,1,28,52,80,150
3404-001,2015,8,16,2,25,38,63,80
3404-001,2015,8,16,3,12,26,38,63
3404-001,2015,8,16,4,23,32,55,38
3404-001,2015,8,16,5,12,48,60,55
3404-001,2015,8,16,6,19,97,116,60
3404-001,2015,8,16,7,55,187,242,116
3404-001,2015,8,16,8,114,230,344,242
3404-001,2015,8,16,9,172,261,433,344
3404-001,2015,8,16,10,148,253,401,433
3404-001,2015,8,16,11,204,285,489,401
3404-001,2015,8,16,12,301,322,623,489
3404-001,2015,8,16,13,254,286,540,623
3404-001,2015,8,16,14,222,305,527,540
3404-001,2015,8,16,15,258,342,600,527
3404-001,2015,8,16,16,324,336,660,600
3404-001,2015,8,16,17,380,360,740,660
3404-001,2015,8,16,18,437,310,747,740
3404-001,2015,8,16,19,299,294,593,747
3404-001,2015,8,16,20,179,264,443,593
3404-001,2015,8,16,21,148,299,447,443
3404-001,2015,8,16,22,80,220,300,447
3404-001,2015,8,16,23,53,164,217,300
3404-001,2015,8,16,24,25,122,147,217
3404-001,2015,8,17,1,19,68,87,147
3404-001,2015,8,17,2,12,40,52,87
3404-001,2015,8,17,3,19,27,46,52
3404-001,2015,8,17,4,16,34,50,46
3404-001,2015,8,17,5,32,83,115,50
3404-001,2015,8,17,6,73,274,347,115
3404-001,2015,8,17,7,186,751,937,347
3404-001,2015,8,17,8,484,1911,2395,937
3404-001,2015,8,17,9,695,1179,1874,2395
3404-001,2015,8,17,10,561,673,1234,1874
3404-001,2015,8,17,11,613,678,1291,1234
3404-001,2015,8,17,12,668,660,1328,1291
3404-001,2015,8,17,13,643,580,1223,1328
3404-001,2015,8,17,14,570,671,1241,1223
3404-001,2015,8,17,15,880,666,1546,1241
3404-001,2015,8,17,16,812,654,1466,1546
3404-001,2015,8,17,17,876,602,1478,1466
3404-001,2015,8,17,18,1233,580,1813,1478
3404-001,2015,8,17,19,1161,498,1659,1813
3404-001,2015,8,17,20,846,409,1255,1659
3404-001,2015,8,17,21,763,284,1047,1255
3404-001,2015,8,17,22,310,195,505,1047
3404-001,2015,8,17,23,188,135,323,505
3404-001,2015,8,17,24,84,101,185,323
3404-001,2015,8,18,1,82,64,146,185
3404-001,2015,8,18,2,37,34,71,146
3404-001,2015,8,18,3,21,39,60,71
3404-001,2015,8,18,4,30,44,74,60
3404-001,2015,8,18,5,55,78,133,74
3404-001,2015,8,18,6,150,237,387,133
3404-001,2015,8,18,7,218,671,889,387
3404-001,2015,8,18,8,496,1810,2306,889
3404-001,2015,8,18,9,792,1258,2050,2306
3404-001,2015,8,18,10,765,778,1543,2050
3404-001,2015,8,18,11,751,761,1512,1543
3404-001,2015,8,18,12,851,731,1582,1512
3404-001,2015,8,18,13,656,594,1250,1582
3404-001,2015,8,18,14,720,662,1382,1250
3404-001,2015,8,18,15,860,751,1611,1382
3404-001,2015,8,18,16,932,664,1596,1611
3404-001,2015,8,18,17,880,616,1496,1596
3404-001,2015,8,18,18,1505,604,2109,1496
3404-001,2015,8,18,19,1276,530,1806,2109
3404-001,2015,8,18,20,826,436,1262,1806
3404-001,2015,8,18,21,742,274,1016,1262
3404-001,2015,8,18,22,410,216,626,1016
3404-001,2015,8,18,23,200,162,362,626
3404-001,2015,8,18,24,107,128,235,362
3404-001,2015,8,19,1,53,68,121,235
3404-001,2015,8,19,2,48,50,98,121
3404-001,2015,8,19,3,23,39,62,98
3404-001,2015,8,19,4,23,57,80,62
3404-001,2015,8,19,5,48,76,124,80
3404-001,2015,8,19,6,125,226,351,124
3404-001,2015,8,19,7,256,626,882,351
3404-001,2015,8,19,8,530,1830,2360,882
3404-001,2015,8,19,9,853,1263,2116,2360
3404-001,2015,8,19,10,763,782,1545,2116
3404-001,2015,8,19,11,776,730,1506,1545
3404-001,2015,8,19,12,758,668,1426,1506
3404-001,2015,8,19,13,708,613,1321,1426
3404-001,2015,8,19,14,738,662,1400,1321
3404-001,2015,8,19,15,923,723,1646,1400
3404-001,2015,8,19,16,880,694,1574,1646
3404-001,2015,8,19,17,996,613,1609,1574
3404-001,2015,8,19,18,1602,613,2215,1609
3404-001,2015,8,19,19,1335,502,1837,2215
3404-001,2015,8,19,20,790,435,1225,1837
3404-001,2015,8,19,21,609,264,873,1225
3404-001,2015,8,19,22,326,194,520,873
3404-001,2015,8,19,23,150,161,311,520
3404-001,2015,8,19,24,62,95,157,311
3404-001,2015,8,20,1,43,72,115,157
3404-001,2015,8,20,2,28,37,65,115
3404-001,2015,8,20,3,25,42,67,65
3404-001,2015,8,20,4,19,46,65,67
3404-001,2015,8,20,5,34,57,91,65
3404-001,2015,8,20,6,129,232,361,91
3404-001,2015,8,20,7,279,647,926,361
3404-001,2015,8,20,8,460,1699,2159,926
3404-001,2015,8,20,9,772,1401,2173,2159
3404-001,2015,8,20,10,697,800,1497,2173
3404-001,2015,8,20,11,788,694,1482,1497
3404-001,2015,8,20,12,634,686,1320,1482
3404-001,2015,8,20,13,548,591,1139,1320
3404-001,2015,8,20,14,724,696,1420,1139
3404-001,2015,8,20,15,919,749,1668,1420
3404-001,2015,8,20,16,876,687,1563,1668
3404-001,2015,8,20,17,1068,637,1705,1563
3404-001,2015,8,20,18,1288,562,1850,1705
3404-001,2015,8,20,19,1190,486,1676,1850
3404-001,2015,8,20,20,742,349,1091,1676
3404-001,2015,8,20,21,720,265,985,1091
3404-001,2015,8,20,22,324,196,520,985
3404-001,2015,8,20,23,157,155,312,520
3404-001,2015,8,20,24,77,100,177,312
3404-001,2015,8,21,1,59,62,121,177
3404-001,2015,8,21,2,34,48,82,121
3404-001,2015,8,21,3,16,33,49,82
3404-001,2015,8,21,4,14,40,54,49
3404-001,2015,8,21,5,48,52,100,54
3404-001,2015,8,21,6,93,180,273,100
3404-001,2015,8,21,7,166,510,676,273
3404-001,2015,8,21,8,464,1652,2116,676
3404-001,2015,8,21,9,778,1226,2004,2116
3404-001,2015,8,21,10,609,751,1360,2004
3404-001,2015,8,21,11,693,683,1376,1360
3404-001,2015,8,21,12,724,683,1407,1376
3404-001,2015,8,21,13,582,564,1146,1407
3404-001,2015,8,21,14,672,628,1300,1146
3404-001,2015,8,21,15,611,724,1335,1300
3404-001,2015,8,21,16,826,653,1479,1335
3404-001,2015,8,21,17,878,562,1440,1479
3404-001,2015,8,21,18,1520,546,2066,1440
3404-001,2015,8,21,19,1367,540,1907,2066
3404-001,2015,8,21,20,851,478,1329,1907
3404-001,2015,8,21,21,668,364,1032,1329
3404-001,2015,8,21,22,285,218,503,1032
3404-001,2015,8,21,23,150,173,323,503
3404-001,2015,8,21,24,71,103,174,323
3404-001,2015,8,22,1,41,66,107,174
3404-001,2015,8,22,2,66,51,117,107
3404-001,2015,8,22,3,32,42,74,117
3404-001,2015,8,22,4,25,62,87,74
3404-001,2015,8,22,5,59,76,135,87
3404-001,2015,8,22,6,100,197,297,135
3404-001,2015,8,22,7,157,427,584,297
3404-001,2015,8,22,8,310,839,1149,584
3404-001,2015,8,22,9,530,656,1186,1149
3404-001,2015,8,22,10,564,603,1167,1186
3404-001,2015,8,22,11,448,627,1075,1167
3404-001,2015,8,22,12,416,551,967,1075
3404-001,2015,8,22,13,498,472,970,967
3404-001,2015,8,22,14,478,502,980,970
3404-001,2015,8,22,15,550,448,998,980
3404-001,2015,8,22,16,512,444,956,998
3404-001,2015,8,22,17,622,459,1081,956
3404-001,2015,8,22,18,873,444,1317,1081
3404-001,2015,8,22,19,539,334,873,1317
3404-001,2015,8,22,20,313,287,600,873
3404-001,2015,8,22,21,204,261,465,600
3404-001,2015,8,22,22,138,163,301,465
3404-001,2015,8,22,23,93,136,229,301
3404-001,2015,8,22,24,30,76,106,229
3404-001,2015,8,23,1,28,60,88,106
3404-001,2015,8,23,2,25,37,62,88
3404-001,2015,8,23,3,12,29,41,62
3404-001,2015,8,23,4,14,26,40,41
3404-001,2015,8,23,5,23,30,53,40
3404-001,2015,8,23,6,32,91,123,53
3404-001,2015,8,23,7,66,255,321,123
3404-001,2015,8,23,8,138,282,420,321
3404-001,2015,8,23,9,222,275,497,420
3404-001,2015,8,23,10,145,287,432,497
3404-001,2015,8,23,11,175,325,500,432
3404-001,2015,8,23,12,211,352,563,500
3404-001,2015,8,23,13,204,353,557,563
3404-001,2015,8,23,14,222,370,592,557
3404-001,2015,8,23,15,236,395,631,592
3404-001,2015,8,23,16,337,349,686,631
3404-001,2015,8,23,17,451,351,802,686
3404-001,2015,8,23,18,484,376,860,802
3404-001,2015,8,23,19,374,295,669,860
3404-001,2015,8,23,20,285,285,570,669
3404-001,2015,8,23,21,213,306,519,570
3404-001,2015,8,23,22,132,197,329,519
3404-001,2015,8,23,23,73,166,239,329
3404-001,2015,8,23,24,50,105,155,239
3404-001,2015,8,24,1,43,71,114,155
3404-001,2015,8,24,2,7,36,43,114
3404-001,2015,8,24,3,28,38,66,43
3404-001,2015,8,24,4,14,26,40,66
3404-001,2015,8,24,5,25,62,87,40
3404-001,2015,8,24,6,71,284,355,87
3404-001,2015,8,24,7,213,761,974,355
3404-001,2015,8,24,8,561,1945,2506,974
3404-001,2015,8,24,9,772,1351,2123,2506
3404-001,2015,8,24,10,550,696,1246,2123
3404-001,2015,8,24,11,792,678,1470,1246
3404-001,2015,8,24,12,697,657,1354,1470
3404-001,2015,8,24,13,548,617,1165,1354
3404-001,2015,8,24,14,641,688,1329,1165
3404-001,2015,8,24,15,858,742,1600,1329
3404-001,2015,8,24,16,894,640,1534,1600
3404-001,2015,8,24,17,860,609,1469,1534
3404-001,2015,8,24,18,1342,602,1944,1469
3404-001,2015,8,24,19,1281,542,1823,1944
3404-001,2015,8,24,20,869,403,1272,1823
3404-001,2015,8,24,21,810,316,1126,1272
3404-001,2015,8,24,22,349,210,559,1126
3404-001,2015,8,24,23,154,136,290,559
3404-001,2015,8,24,24,91,102,193,290
3404-001,2015,8,25,1,57,70,127,193
3404-001,2015,8,25,2,37,51,88,127
3404-001,2015,8,25,3,25,52,77,88
3404-001,2015,8,25,4,12,43,55,77
3404-001,2015,8,25,5,41,57,98,55
3404-001,2015,8,25,6,82,160,242,98
3404-001,2015,8,25,7,159,535,694,242
3404-001,2015,8,25,8,430,1658,2088,694
3404-001,2015,8,25,9,636,1195,1831,2088
3404-001,2015,8,25,10,518,684,1202,1831
3404-001,2015,8,25,11,516,618,1134,1202
3404-001,2015,8,25,12,584,594,1178,1134
3404-001,2015,8,25,13,480,558,1038,1178
3404-001,2015,8,25,14,527,560,1087,1038
3404-001,2015,8,25,15,613,626,1239,1087
3404-001,2015,8,25,16,654,603,1257,1239
3404-001,2015,8,25,17,695,552,1247,1257
3404-001,2015,8,25,18,1040,552,1592,1247
3404-001,2015,8,25,19,1023,455,1478,1592
3404-001,2015,8,25,20,717,384,1101,1478
3404-001,2015,8,25,21,674,268,942,1101
3404-001,2015,8,25,22,272,206,478,942
3404-001,2015,8,25,23,152,153,305,478
3404-001,2015,8,25,24,93,84,177,305
3404-001,2015,8,26,1,59,56,115,177
3404-001,2015,8,26,2,30,38,68,115
3404-001,2015,8,26,3,7,49,56,68
3404-001,2015,8,26,4,34,48,82,56
3404-001,2015,8,26,5,43,67,110,82
3404-001,2015,8,26,6,111,213,324,110
3404-001,2015,8,26,7,231,622,853,324
3404-001,2015,8,26,8,552,1807,2359,853
3404-001,2015,8,26,9,797,1321,2118,2359
3404-001,2015,8,26,10,659,761,1420,2118
3404-001,2015,8,26,11,702,695,1397,1420
3404-001,2015,8,26,12,582,698,1280,1397
3404-001,2015,8,26,13,643,599,1242,1280
3404-001,2015,8,26,14,722,632,1354,1242
3404-001,2015,8,26,15,742,698,1440,1354
3404-001,2015,8,26,16,742,659,1401,1440
3404-001,2015,8,26,17,781,612,1393,1401
3404-001,2015,8,26,18,1460,568,2028,1393
3404-001,2015,8,26,19,1262,524,1786,2028
3404-001,2015,8,26,20,704,391,1095,1786
3404-001,2015,8,26,21,622,283,905,1095
3404-001,2015,8,26,22,304,213,517,905
3404-001,2015,8,26,23,181,167,348,517
3404-001,2015,8,26,24,118,121,239,348
3404-001,2015,8,27,1,48,75,123,239
3404-001,2015,8,27,2,37,63,100,123
3404-001,2015,8,27,3,34,47,81,100
3404-001,2015,8,27,4,21,48,69,81
3404-001,2015,8,27,5,55,69,124,69
3404-001,2015,8,27,6,134,214,348,124
3404-001,2015,8,27,7,258,655,913,348
3404-001,2015,8,27,8,484,1780,2264,913
3404-001,2015,8,27,9,747,1389,2136,2264
3404-001,2015,8,27,10,731,786,1517,2136
3404-001,2015,8,27,11,722,709,1431,1517
3404-001,2015,8,27,12,849,668,1517,1431
3404-001,2015,8,27,13,688,540,1228,1517
3404-001,2015,8,27,14,704,665,1369,1228
3404-001,2015,8,27,15,860,744,1604,1369
3404-001,2015,8,27,16,846,673,1519,1604
3404-001,2015,8,27,17,846,605,1451,1519
3404-001,2015,8,27,18,1389,601,1990,1451
3404-001,2015,8,27,19,1265,530,1795,1990
3404-001,2015,8,27,20,855,446,1301,1795
3404-001,2015,8,27,21,690,303,993,1301
3404-001,2015,8,27,22,457,217,674,993
3404-001,2015,8,27,23,200,169,369,674
3404-001,2015,8,27,24,118,98,216,369
3404-001,2015,8,28,1,68,80,148,216
3404-001,2015,8,28,2,64,62,126,148
3404-001,2015,8,28,3,34,40,74,126
3404-001,2015,8,28,4,48,46,94,74
3404-001,2015,8,28,5,14,68,82,94
3404-001,2015,8,28,6,89,233,322,82
3404-001,2015,8,28,7,220,603,823,322
3404-001,2015,8,28,8,546,1773,2319,823
3404-001,2015,8,28,9,801,1344,2145,2319
3404-001,2015,8,28,10,665,772,1437,2145
3404-001,2015,8,28,11,745,732,1477,1437
3404-001,2015,8,28,12,715,705,1420,1477
3404-001,2015,8,28,13,688,556,1244,1420
3404-001,2015,8,28,14,654,689,1343,1244
3404-001,2015,8,28,15,871,698,1569,1343
3404-001,2015,8,28,16,860,651,1511,1569
3404-001,2015,8,28,17,984,648,1632,1511
3404-001,2015,8,28,18,1726,670,2396,1632
3404-001,2015,8,28,19,1685,588,2273,2396
3404-001,2015,8,28,20,975,521,1496,2273
3404-001,2015,8,28,21,751,330,1081,1496
3404-001,2015,8,28,22,371,219,590,1081
3404-001,2015,8,28,23,181,161,342,590
3404-001,2015,8,28,24,102,120,222,342
3404-001,2015,8,29,1,82,74,156,222
3404-001,2015,8,29,2,37,58,95,156
3404-001,2015,8,29,3,19,45,64,95
3404-001,2015,8,29,4,30,48,78,64
3404-001,2015,8,29,5,50,63,113,78
3404-001,2015,8,29,6,84,214,298,113
3404-001,2015,8,29,7,238,395,633,298
3404-001,2015,8,29,8,310,869,1179,633
3404-001,2015,8,29,9,548,756,1304,1179
3404-001,2015,8,29,10,489,632,1121,1304
3404-001,2015,8,29,11,507,642,1149,1121
3404-001,2015,8,29,12,480,548,1028,1149
3404-001,2015,8,29,13,446,533,979,1028
3404-001,2015,8,29,14,498,535,1033,979
3404-001,2015,8,29,15,469,533,1002,1033
3404-001,2015,8,29,16,579,455,1034,1002
3404-001,2015,8,29,17,749,465,1214,1034
3404-001,2015,8,29,18,993,505,1498,1214
3404-001,2015,8,29,19,686,452,1138,1498
3404-001,2015,8,29,20,333,351,684,1138
3404-001,2015,8,29,21,281,278,559,684
3404-001,2015,8,29,22,170,182,352,559
3404-001,2015,8,29,23,95,139,234,352
3404-001,2015,8,29,24,46,90,136,234
3404-001,2015,8,30,1,39,66,105,136
3404-001,2015,8,30,2,25,37,62,105
3404-001,2015,8,30,3,19,36,55,62
3404-001,2015,8,30,4,19,22,41,55
3404-001,2015,8,30,5,12,49,61,41
3404-001,2015,8,30,6,55,85,140,61
3404-001,2015,8,30,7,55,247,302,140
3404-001,2015,8,30,8,134,273,407,302
3404-001,2015,8,30,9,177,305,482,407
3404-001,2015,8,30,10,145,314,459,482
3404-001,2015,8,30,11,231,361,592,459
3404-001,2015,8,30,12,209,358,567,592
3404-001,2015,8,30,13,227,365,592,567
3404-001,2015,8,30,14,299,374,673,592
3404-001,2015,8,30,15,331,360,691,673
3404-001,2015,8,30,16,376,366,742,691
3404-001,2015,8,30,17,428,346,774,742
3404-001,2015,8,30,18,632,334,966,774
3404-001,2015,8,30,19,530,327,857,966
3404-001,2015,8,30,20,295,314,609,857
3404-001,2015,8,30,21,233,323,556,609
3404-001,2015,8,30,22,98,249,347,556
3404-001,2015,8,30,23,62,151,213,347
3404-001,2015,8,30,24,39,117,156,213
3404-001,2015,8,31,1,23,86,109,156
3404-001,2015,8,31,2,10,42,52,109
3404-001,2015,8,31,3,12,41,53,52
3404-001,2015,8,31,4,23,43,66,53
3404-001,2015,8,31,5,41,61,102,66
3404-001,2015,8,31,6,123,275,398,102
3404-001,2015,8,31,7,200,721,921,398
3404-001,2015,8,31,8,568,1958,2526,921
3404-001,2015,8,31,9,699,1421,2120,2526
3404-001,2015,8,31,10,573,678,1251,2120
3404-001,2015,8,31,11,663,689,1352,1251
3404-001,2015,8,31,12,622,637,1259,1352
3404-001,2015,8,31,13,699,583,1282,1259
3404-001,2015,8,31,14,638,684,1322,1282
3404-001,2015,8,31,15,869,695,1564,1322
3404-001,2015,8,31,16,887,617,1504,1564
3404-001,2015,8,31,17,910,655,1565,1504
3404-001,2015,8,31,18,1354,569,1923,1565
3404-001,2015,8,31,19,1244,552,1796,1923
3404-001,2015,8,31,20,828,397,1225,1796
3404-001,2015,8,31,21,756,291,1047,1225
3404-001,2015,8,31,22,333,221,554,1047
3404-001,2015,8,31,23,227,157,384,554
3404-001,2015,8,31,24,80,101,181,384
3404-001,2015,9,1,1,52,68,120,181
3404-001,2015,9,1,2,29,51,80,120
3404-001,2015,9,1,3,31,36,67,80
3404-001,2015,9,1,4,33,51,84,67
3404-001,2015,9,1,5,50,74,124,84
3404-001,2015,9,1,6,117,222,339,124
3404-001,2015,9,1,7,199,631,830,339
3404-001,2015,9,1,8,460,1794,2254,830
3404-001,2015,9,1,9,806,1321,2127,2254
3404-001,2015,9,1,10,750,826,1576,2127
3404-001,2015,9,1,11,722,691,1413,1576
3404-001,2015,9,1,12,735,668,1403,1413
3404-001,2015,9,1,13,609,547,1156,1403
3404-001,2015,9,1,14,596,707,1303,1156
3404-001,2015,9,1,15,862,755,1617,1303
3404-001,2015,9,1,16,860,697,1557,1617
3404-001,2015,9,1,17,873,601,1474,1557
3404-001,2015,9,1,18,1312,577,1889,1474
3404-001,2015,9,1,19,1233,518,1751,1889
3404-001,2015,9,1,20,719,395,1114,1751
3404-001,2015,9,1,21,760,309,1069,1114
3404-001,2015,9,1,22,385,237,622,1069
3404-001,2015,9,1,23,149,154,303,622
3404-001,2015,9,1,24,74,107,181,303
3404-001,2015,9,2,1,48,86,134,181
3404-001,2015,9,2,2,39,45,84,134
3404-001,2015,9,2,3,29,37,66,84
3404-001,2015,9,2,4,20,43,63,66
3404-001,2015,9,2,5,65,61,126,63
3404-001,2015,9,2,6,111,230,341,126
3404-001,2015,9,2,7,199,632,831,341
3404-001,2015,9,2,8,413,1797,2210,831
3404-001,2015,9,2,9,793,1406,2199,2210
3404-001,2015,9,2,10,696,722,1418,2199
3404-001,2015,9,2,11,726,744,1470,1418
3404-001,2015,9,2,12,728,669,1397,1470
3404-001,2015,9,2,13,642,588,1230,1397
3404-001,2015,9,2,14,622,731,1353,1230
3404-001,2015,9,2,15,827,726,1553,1353
3404-001,2015,9,2,16,864,662,1526,1553
3404-001,2015,9,2,17,896,593,1489,1526
3404-001,2015,9,2,18,1455,548,2003,1489
3404-001,2015,9,2,19,1350,501,1851,2003
3404-001,2015,9,2,20,776,416,1192,1851
3404-001,2015,9,2,21,683,265,948,1192
3404-001,2015,9,2,22,344,210,554,948
3404-001,2015,9,2,23,126,139,265,554
3404-001,2015,9,2,24,91,92,183,265
3404-001,2015,9,3,1,35,64,99,183
3404-001,2015,9,3,2,46,51,97,99
3404-001,2015,9,3,3,22,44,66,97
3404-001,2015,9,3,4,22,39,61,66
3404-001,2015,9,3,5,52,57,109,61
3404-001,2015,9,3,6,102,207,309,109
3404-001,2015,9,3,7,188,605,793,309
3404-001,2015,9,3,8,519,1812,2331,793
3404-001,2015,9,3,9,711,1347,2058,2331
3404-001,2015,9,3,10,715,731,1446,2058
3404-001,2015,9,3,11,683,723,1406,1446
3404-001,2015,9,3,12,607,665,1272,1406
3404-001,2015,9,3,13,532,593,1125,1272
3404-001,2015,9,3,14,655,687,1342,1125
3404-001,2015,9,3,15,830,710,1540,1342
3404-001,2015,9,3,16,840,643,1483,1540
3404-001,2015,9,3,17,892,613,1505,1483
3404-001,2015,9,3,18,1363,597,1960,1505
3404-001,2015,9,3,19,1315,524,1839,1960
3404-001,2015,9,3,20,752,403,1155,1839
3404-001,2015,9,3,21,657,292,949,1155
3404-001,2015,9,3,22,342,229,571,949
3404-001,2015,9,3,23,208,177,385,571
3404-001,2015,9,3,24,67,95,162,385
3404-001,2015,9,4,1,63,62,125,162
3404-001,2015,9,4,2,37,51,88,125
3404-001,2015,9,4,3,31,38,69,88
3404-001,2015,9,4,4,35,57,92,69
3404-001,2015,9,4,5,35,80,115,92
3404-001,2015,9,4,6,115,232,347,115
3404-001,2015,9,4,7,223,596,819,347
3404-001,2015,9,4,8,501,1783,2284,819
3404-001,2015,9,4,9,745,1290,2035,2284
3404-001,2015,9,4,10,642,751,1393,2035
3404-001,2015,9,4,11,754,768,1522,1393
3404-001,2015,9,4,12,760,666,1426,1522
3404-001,2015,9,4,13,657,624,1281,1426
3404-001,2015,9,4,14,637,632,1269,1281
3404-001,2015,9,4,15,823,718,1541,1269
3404-001,2015,9,4,16,933,696,1629,1541
3404-001,2015,9,4,17,1151,654,1805,1629
3404-001,2015,9,4,18,1654,646,2300,1805
3404-001,2015,9,4,19,1663,598,2261,2300
3404-001,2015,9,4,20,972,480,1452,2261
3404-001,2015,9,4,21,685,371,1056,1452
3404-001,2015,9,4,22,326,234,560,1056
3404-001,2015,9,4,23,195,180,375,560
3404-001,2015,9,4,24,83,102,185,375
3404-001,2015,9,5,1,37,89,126,185
3404-001,2015,9,5,2,48,57,105,126
3404-001,2015,9,5,3,22,52,74,105
3404-001,2015,9,5,4,20,58,78,74
3404-001,2015,9,5,5,46,67,113,78
3404-001,2015,9,5,6,111,196,307,113
3404-001,2015,9,5,7,169,395,564,307
3404-001,2015,9,5,8,361,813,1174,564
3404-001,2015,9,5,9,607,735,1342,1174
3404-001,2015,9,5,10,486,612,1098,1342
3404-001,2015,9,5,11,484,608,1092,1098
3404-001,2015,9,5,12,529,562,1091,1092
3404-001,2015,9,5,13,417,487,904,1091
3404-001,2015,9,5,14,521,484,1005,904
3404-001,2015,9,5,15,506,489,995,1005
3404-001,2015,9,5,16,624,489,1113,995
3404-001,2015,9,5,17,512,433,945,1113
3404-001,2015,9,5,18,802,392,1194,945
3404-001,2015,9,5,19,581,381,962,1194
3404-001,2015,9,5,20,288,316,604,962
3404-001,2015,9,5,21,201,220,421,604
3404-001,2015,9,5,22,100,168,268,421
3404-001,2015,9,5,23,78,112,190,268
3404-001,2015,9,5,24,39,80,119,190
3404-001,2015,9,6,1,22,73,95,119
3404-001,2015,9,6,2,24,45,69,95
3404-001,2015,9,6,3,3,35,38,69
3404-001,2015,9,6,4,20,32,52,38
3404-001,2015,9,6,5,20,40,60,52
3404-001,2015,9,6,6,46,96,142,60
3404-001,2015,9,6,7,44,217,261,142
3404-001,2015,9,6,8,143,338,481,261
3404-001,2015,9,6,9,203,285,488,481
3404-001,2015,9,6,10,137,334,471,488
3404-001,2015,9,6,11,219,391,610,471
3404-001,2015,9,6,12,210,399,609,610
3404-001,2015,9,6,13,236,365,601,609
3404-001,2015,9,6,14,247,418,665,601
3404-001,2015,9,6,15,363,414,777,665
3404-001,2015,9,6,16,393,387,780,777
3404-001,2015,9,6,17,655,385,1040,780
3404-001,2015,9,6,18,755,377,1132,1040
3404-001,2015,9,6,19,577,350,927,1132
3404-001,2015,9,6,20,337,323,660,927
3404-001,2015,9,6,21,173,241,414,660
3404-001,2015,9,6,22,124,258,382,414
3404-001,2015,9,6,23,74,169,243,382
3404-001,2015,9,6,24,35,108,143,243
3404-001,2015,9,7,1,35,64,99,143
3404-001,2015,9,7,2,13,40,53,99
3404-001,2015,9,7,3,16,31,47,53
3404-001,2015,9,7,4,16,43,59,47
3404-001,2015,9,7,5,31,81,112,59
3404-001,2015,9,7,6,115,279,394,112
3404-001,2015,9,7,7,232,720,952,394
3404-001,2015,9,7,8,532,1946,2478,952
3404-001,2015,9,7,9,650,1410,2060,2478
3404-001,2015,9,7,10,525,725,1250,2060
3404-001,2015,9,7,11,588,735,1323,1250
3404-001,2015,9,7,12,732,683,1415,1323
3404-001,2015,9,7,13,579,592,1171,1415
3404-001,2015,9,7,14,588,733,1321,1171
3404-001,2015,9,7,15,750,794,1544,1321
3404-001,2015,9,7,16,834,669,1503,1544
3404-001,2015,9,7,17,840,678,1518,1503
3404-001,2015,9,7,18,1455,614,2069,1518
3404-001,2015,9,7,19,1108,519,1627,2069
3404-001,2015,9,7,20,834,438,1272,1627
3404-001,2015,9,7,21,750,266,1016,1272
3404-001,2015,9,7,22,383,228,611,1016
3404-001,2015,9,7,23,188,158,346,611
3404-001,2015,9,7,24,78,101,179,346
3404-001,2015,9,8,1,48,70,118,179
3404-001,2015,9,8,2,42,59,101,118
3404-001,2015,9,8,3,24,38,62,101
3404-001,2015,9,8,4,42,50,92,62
3404-001,2015,9,8,5,54,73,127,92
3404-001,2015,9,8,6,130,237,367,127
3404-001,2015,9,8,7,260,634,894,367
3404-001,2015,9,8,8,568,1799,2367,894
3404-001,2015,9,8,9,799,1334,2133,2367
3404-001,2015,9,8,10,670,791,1461,2133
3404-001,2015,9,8,11,674,792,1466,1461
3404-001,2015,9,8,12,674,682,1356,1466
3404-001,2015,9,8,13,564,566,1130,1356
3404-001,2015,9,8,14,719,670,1389,1130
3404-001,2015,9,8,15,763,767,1530,1389
3404-001,2015,9,8,16,823,707,1530,1530
3404-001,2015,9,8,17,959,629,1588,1530
3404-001,2015,9,8,18,1294,616,1910,1588
3404-001,2015,9,8,19,1255,500,1755,1910
3404-001,2015,9,8,20,685,446,1131,1755
3404-001,2015,9,8,21,732,311,1043,1131
3404-001,2015,9,8,22,331,193,524,1043
3404-001,2015,9,8,23,165,162,327,524
3404-001,2015,9,8,24,78,117,195,327
3404-001,2015,9,9,1,37,69,106,195
3404-001,2015,9,9,2,20,62,82,106
3404-001,2015,9,9,3,22,48,70,82
3404-001,2015,9,9,4,39,39,78,70
3404-001,2015,9,9,5,39,73,112,78
3404-001,2015,9,9,6,154,242,396,112
3404-001,2015,9,9,7,227,618,845,396
3404-001,2015,9,9,8,523,1792,2315,845
3404-001,2015,9,9,9,765,1323,2088,2315
3404-001,2015,9,9,10,685,782,1467,2088
3404-001,2015,9,9,11,629,728,1357,1467
3404-001,2015,9,9,12,674,709,1383,1357
3404-001,2015,9,9,13,603,537,1140,1383
3404-001,2015,9,9,14,588,687,1275,1140
3404-001,2015,9,9,15,868,715,1583,1275
3404-001,2015,9,9,16,847,706,1553,1583
3404-001,2015,9,9,17,840,616,1456,1553
3404-001,2015,9,9,18,1631,619,2250,1456
3404-001,2015,9,9,19,1361,571,1932,2250
3404-001,2015,9,9,20,739,459,1198,1932
3404-001,2015,9,9,21,618,255,873,1198
3404-001,2015,9,9,22,285,235,520,873
3404-001,2015,9,9,23,169,135,304,520
3404-001,2015,9,9,24,98,95,193,304
3404-001,2015,9,10,1,48,71,119,193
3404-001,2015,9,10,2,29,53,82,119
3404-001,2015,9,10,3,26,43,69,82
3404-001,2015,9,10,4,24,46,70,69
3404-001,2015,9,10,5,37,74,111,70
3404-001,2015,9,10,6,100,207,307,111
3404-001,2015,9,10,7,262,675,937,307
3404-001,2015,9,10,8,463,1799,2262,937
3404-001,2015,9,10,9,875,1376,2251,2262
3404-001,2015,9,10,10,691,719,1410,2251
3404-001,2015,9,10,11,709,738,1447,1410
3404-001,2015,9,10,12,808,687,1495,1447
3404-001,2015,9,10,13,557,588,1145,1495
3404-001,2015,9,10,14,668,660,1328,1145
3404-001,2015,9,10,15,743,739,1482,1328
3404-001,2015,9,10,16,946,711,1657,1482
3404-001,2015,9,10,17,855,676,1531,1657
3404-001,2015,9,10,18,1519,643,2162,1531
3404-001,2015,9,10,19,1341,559,1900,2162
3404-001,2015,9,10,20,845,419,1264,1900
3404-001,2015,9,10,21,717,297,1014,1264
3404-001,2015,9,10,22,301,250,551,1014
3404-001,2015,9,10,23,145,151,296,551
3404-001,2015,9,10,24,121,106,227,296
3404-001,2015,9,11,1,54,85,139,227
3404-001,2015,9,11,2,33,58,91,139
3404-001,2015,9,11,3,18,42,60,91
3404-001,2015,9,11,4,39,55,94,60
3404-001,2015,9,11,5,48,76,124,94
3404-001,2015,9,11,6,171,248,419,124
3404-001,2015,9,11,7,232,672,904,419
3404-001,2015,9,11,8,562,1811,2373,904
3404-001,2015,9,11,9,784,1305,2089,2373
3404-001,2015,9,11,10,618,753,1371,2089
3404-001,2015,9,11,11,694,727,1421,1371
3404-001,2015,9,11,12,830,699,1529,1421
3404-001,2015,9,11,13,627,602,1229,1529
3404-001,2015,9,11,14,722,692,1414,1229
3404-001,2015,9,11,15,840,706,1546,1414
3404-001,2015,9,11,16,959,712,1671,1546
3404-001,2015,9,11,17,903,578,1481,1671
3404-001,2015,9,11,18,1904,649,2553,1481
3404-001,2015,9,11,19,1596,586,2182,2553
3404-001,2015,9,11,20,916,535,1451,2182
3404-001,2015,9,11,21,583,340,923,1451
3404-001,2015,9,11,22,279,216,495,923
3404-001,2015,9,11,23,169,148,317,495
3404-001,2015,9,11,24,70,113,183,317
3404-001,2015,9,12,1,42,84,126,183
3404-001,2015,9,12,2,26,50,76,126
3404-001,2015,9,12,3,20,44,64,76
3404-001,2015,9,12,4,24,43,67,64
3404-001,2015,9,12,5,46,65,111,67
3404-001,2015,9,12,6,121,173,294,111
3404-001,2015,9,12,7,188,430,618,294
3404-001,2015,9,12,8,298,866,1164,618
3404-001,2015,9,12,9,547,742,1289,1164
3404-001,2015,9,12,10,486,618,1104,1289
3404-001,2015,9,12,11,538,604,1142,1104
3404-001,2015,9,12,12,486,607,1093,1142
3404-001,2015,9,12,13,456,529,985,1093
3404-001,2015,9,12,14,521,566,1087,985
3404-001,2015,9,12,15,566,559,1125,1087
3404-001,2015,9,12,16,646,512,1158,1125
3404-001,2015,9,12,17,737,489,1226,1158
3404-001,2015,9,12,18,1126,467,1593,1226
3404-001,2015,9,12,19,851,437,1288,1593
3404-001,2015,9,12,20,463,360,823,1288
3404-001,2015,9,12,21,223,253,476,823
3404-001,2015,9,12,22,111,176,287,476
3404-001,2015,9,12,23,98,122,220,287
3404-001,2015,9,12,24,46,90,136,220
3404-001,2015,9,13,1,42,66,108,136
3404-001,2015,9,13,2,26,38,64,108
3404-001,2015,9,13,3,13,34,47,64
3404-001,2015,9,13,4,16,33,49,47
3404-001,2015,9,13,5,33,38,71,49
3404-001,2015,9,13,6,39,100,139,71
3404-001,2015,9,13,7,89,227,316,139
3404-001,2015,9,13,8,184,355,539,316
3404-001,2015,9,13,9,253,346,599,539
3404-001,2015,9,13,10,188,372,560,599
3404-001,2015,9,13,11,240,350,590,560
3404-001,2015,9,13,12,184,385,569,590
3404-001,2015,9,13,13,305,443,748,569
3404-001,2015,9,13,14,294,395,689,748
3404-001,2015,9,13,15,359,418,777,689
3404-001,2015,9,13,16,836,389,1225,777
3404-001,2015,9,13,17,1167,391,1558,1225
3404-001,2015,9,13,18,1080,445,1525,1558
3404-001,2015,9,13,19,741,412,1153,1525
3404-001,2015,9,13,20,469,317,786,1153
3404-001,2015,9,13,21,439,310,749,786
3404-001,2015,9,13,22,193,287,480,749
3404-001,2015,9,13,23,61,172,233,480
3404-001,2015,9,13,24,31,130,161,233
3404-001,2015,9,14,1,24,87,111,161
3404-001,2015,9,14,2,22,36,58,111
3404-001,2015,9,14,3,13,49,62,58
3404-001,2015,9,14,4,9,35,44,62
3404-001,2015,9,14,5,39,67,106,44
3404-001,2015,9,14,6,76,286,362,106
3404-001,2015,9,14,7,221,727,948,362
3404-001,2015,9,14,8,540,2017,2557,948
3404-001,2015,9,14,9,763,1454,2217,2557
3404-001,2015,9,14,10,553,705,1258,2217
3404-001,2015,9,14,11,700,729,1429,1258
3404-001,2015,9,14,12,756,724,1480,1429
3404-001,2015,9,14,13,652,589,1241,1480
3404-001,2015,9,14,14,694,729,1423,1241
3404-001,2015,9,14,15,786,756,1542,1423
3404-001,2015,9,14,16,812,644,1456,1542
3404-001,2015,9,14,17,836,641,1477,1456
3404-001,2015,9,14,18,1515,647,2162,1477
3404-001,2015,9,14,19,1304,564,1868,2162
3404-001,2015,9,14,20,834,415,1249,1868
3404-001,2015,9,14,21,711,251,962,1249
3404-001,2015,9,14,22,314,250,564,962
3404-001,2015,9,14,23,137,142,279,564
3404-001,2015,9,14,24,83,96,179,279
3404-001,2015,9,15,1,57,68,125,179
3404-001,2015,9,15,2,39,63,102,125
3404-001,2015,9,15,3,22,39,61,102
3404-001,2015,9,15,4,37,56,93,61
3404-001,2015,9,15,5,67,72,139,93
3404-001,2015,9,15,6,104,240,344,139
3404-001,2015,9,15,7,201,649,850,344
3404-001,2015,9,15,8,514,1847,2361,850
3404-001,2015,9,15,9,883,1360,2243,2361
3404-001,2015,9,15,10,691,790,1481,2243
3404-001,2015,9,15,11,754,764,1518,1481
3404-001,2015,9,15,12,700,665,1365,1518
3404-001,2015,9,15,13,605,612,1217,1365
3404-001,2015,9,15,14,711,664,1375,1217
3404-001,2015,9,15,15,849,769,1618,1375
3404-001,2015,9,15,16,931,716,1647,1618
3404-001,2015,9,15,17,970,597,1567,1647
3404-001,2015,9,15,18,1528,641,2169,1567
3404-001,2015,9,15,19,1138,536,1674,2169
3404-001,2015,9,15,20,782,423,1205,1674
3404-001,2015,9,15,21,709,304,1013,1205
3404-001,2015,9,15,22,365,239,604,1013
3404-001,2015,9,15,23,121,147,268,604
3404-001,2015,9,15,24,98,93,191,268
3404-001,2015,9,16,1,54,63,117,191
3404-001,2015,9,16,2,33,47,80,117
3404-001,2015,9,16,3,33,36,69,80
3404-001,2015,9,16,4,31,40,71,69
3404-001,2015,9,16,5,91,74,165,71
3404-001,2015,9,16,6,111,228,339,165
3404-001,2015,9,16,7,262,613,875,339
3404-001,2015,9,16,8,521,1895,2416,875
3404-001,2015,9,16,9,866,1374,2240,2416
3404-001,2015,9,16,10,644,738,1382,2240
3404-001,2015,9,16,11,726,722,1448,1382
3404-001,2015,9,16,12,776,690,1466,1448
3404-001,2015,9,16,13,562,642,1204,1466
3404-001,2015,9,16,14,722,664,1386,1204
3404-001,2015,9,16,15,840,772,1612,1386
3404-001,2015,9,16,16,821,684,1505,1612
3404-001,2015,9,16,17,840,624,1464,1505
3404-001,2015,9,16,18,1533,646,2179,1464
3404-001,2015,9,16,19,1294,548,1842,2179
3404-001,2015,9,16,20,784,418,1202,1842
3404-001,2015,9,16,21,629,284,913,1202
3404-001,2015,9,16,22,350,231,581,913
3404-001,2015,9,16,23,141,149,290,581
3404-001,2015,9,16,24,54,118,172,290
3404-001,2015,9,17,1,70,76,146,172
3404-001,2015,9,17,2,37,44,81,146
3404-001,2015,9,17,3,29,40,69,81
3404-001,2015,9,17,4,29,48,77,69
3404-001,2015,9,17,5,42,74,116,77
3404-001,2015,9,17,6,128,207,335,116
3404-001,2015,9,17,7,247,649,896,335
3404-001,2015,9,17,8,471,1824,2295,896
3404-001,2015,9,17,9,806,1346,2152,2295
3404-001,2015,9,17,10,624,760,1384,2152
3404-001,2015,9,17,11,804,745,1549,1384
3404-001,2015,9,17,12,681,721,1402,1549
3404-001,2015,9,17,13,506,604,1110,1402
3404-001,2015,9,17,14,700,627,1327,1110
3404-001,2015,9,17,15,879,766,1645,1327
3404-001,2015,9,17,16,927,751,1678,1645
3404-001,2015,9,17,17,981,604,1585,1678
3404-001,2015,9,17,18,1496,668,2164,1585
3404-001,2015,9,17,19,1244,509,1753,2164
3404-001,2015,9,17,20,782,456,1238,1753
3404-001,2015,9,17,21,791,320,1111,1238
3404-001,2015,9,17,22,370,257,627,1111
3404-001,2015,9,17,23,149,181,330,627
3404-001,2015,9,17,24,76,88,164,330
3404-001,2015,9,18,1,52,84,136,164
3404-001,2015,9,18,2,33,64,97,136
3404-001,2015,9,18,3,31,49,80,97
3404-001,2015,9,18,4,24,52,76,80
3404-001,2015,9,18,5,46,67,113,76
3404-001,2015,9,18,6,137,240,377,113
3404-001,2015,9,18,7,247,603,850,377
3404-001,2015,9,18,8,473,1789,2262,850
3404-001,2015,9,18,9,851,1359,2210,2262
3404-001,2015,9,18,10,778,761,1539,2210
3404-001,2015,9,18,11,741,777,1518,1539
3404-001,2015,9,18,12,797,771,1568,1518
3404-001,2015,9,18,13,642,600,1242,1568
3404-001,2015,9,18,14,709,676,1385,1242
3404-001,2015,9,18,15,866,766,1632,1385
3404-001,2015,9,18,16,994,744,1738,1632
3404-001,2015,9,18,17,957,660,1617,1738
3404-001,2015,9,18,18,1657,650,2307,1617
3404-001,2015,9,18,19,1525,585,2110,2307
3404-001,2015,9,18,20,953,538,1491,2110
3404-001,2015,9,18,21,732,315,1047,1491
3404-001,2015,9,18,22,342,236,578,1047
3404-001,2015,9,18,23,132,151,283,578
3404-001,2015,9,18,24,98,100,198,283
3404-001,2015,9,19,1,46,74,120,198
3404-001,2015,9,19,2,18,61,79,120
3404-001,2015,9,19,3,16,57,73,79
3404-001,2015,9,19,4,22,42,64,73
3404-001,2015,9,19,5,50,73,123,64
3404-001,2015,9,19,6,98,195,293,123
3404-001,2015,9,19,7,193,434,627,293
3404-001,2015,9,19,8,378,905,1283,627
3404-001,2015,9,19,9,698,774,1472,1283
3404-001,2015,9,19,10,564,680,1244,1472
3404-001,2015,9,19,11,484,611,1095,1244
3404-001,2015,9,19,12,536,641,1177,1095
3404-001,2015,9,19,13,430,532,962,1177
3404-001,2015,9,19,14,547,541,1088,962
3404-001,2015,9,19,15,614,530,1144,1088
3404-001,2015,9,19,16,609,552,1161,1144
3404-001,2015,9,19,17,758,476,1234,1161
3404-001,2015,9,19,18,1051,518,1569,1234
3404-001,2015,9,19,19,689,442,1131,1569
3404-001,2015,9,19,20,363,335,698,1131
3404-001,2015,9,19,21,249,213,462,698
3404-001,2015,9,19,22,115,179,294,462
3404-001,2015,9,19,23,102,131,233,294
3404-001,2015,9,19,24,57,80,137,233
3404-001,2015,9,20,1,31,66,97,137
3404-001,2015,9,20,2,13,46,59,97
3404-001,2015,9,20,3,26,39,65,59
3404-001,2015,9,20,4,13,34,47,65
3404-001,2015,9,20,5,26,50,76,47
3404-001,2015,9,20,6,50,116,166,76
3404-001,2015,9,20,7,57,249,306,166
3404-001,2015,9,20,8,188,367,555,306
3404-001,2015,9,20,9,232,352,584,555
3404-001,2015,9,20,10,190,360,550,584
3404-001,2015,9,20,11,242,392,634,550
3404-001,2015,9,20,12,244,409,653,634
3404-001,2015,9,20,13,277,376,653,653
3404-001,2015,9,20,14,264,378,642,653
3404-001,2015,9,20,15,387,389,776,642
3404-001,2015,9,20,16,419,400,819,776
3404-001,2015,9,20,17,525,379,904,819
3404-001,2015,9,20,18,601,419,1020,904
3404-001,2015,9,20,19,447,354,801,1020
3404-001,2015,9,20,20,242,271,513,801
3404-001,2015,9,20,21,160,230,390,513
3404-001,2015,9,20,22,128,210,338,390
3404-001,2015,9,20,23,80,183,263,338
3404-001,2015,9,20,24,33,88,121,263
3404-001,2015,9,21,1,26,77,103,121
3404-001,2015,9,21,2,11,41,52,103
3404-001,2015,9,21,3,13,30,43,52
3404-001,2015,9,21,4,24,27,51,43
3404-001,2015,9,21,5,42,83,125,51
3404-001,2015,9,21,6,70,245,315,125
3404-001,2015,9,21,7,212,678,890,315
3404-001,2015,9,21,8,497,1934,2431,890
3404-001,2015,9,21,9,719,1493,2212,2431
3404-001,2015,9,21,10,581,744,1325,2212
3404-001,2015,9,21,11,756,699,1455,1325
3404-001,2015,9,21,12,741,716,1457,1455
3404-001,2015,9,21,13,592,645,1237,1457
3404-001,2015,9,21,14,728,737,1465,1237
3404-001,2015,9,21,15,760,769,1529,1465
3404-001,2015,9,21,16,883,767,1650,1529
3404-001,2015,9,21,17,1056,644,1700,1650
3404-001,2015,9,21,18,1470,644,2114,1700
3404-001,2015,9,21,19,1324,592,1916,2114
3404-001,2015,9,21,20,909,402,1311,1916
3404-001,2015,9,21,21,711,325,1036,1311
3404-001,2015,9,21,22,335,254,589,1036
3404-001,2015,9,21,23,197,160,357,589
3404-001,2015,9,21,24,78,114,192,357
3404-001,2015,9,22,1,50,74,124,192
3404-001,2015,9,22,2,72,70,142,124
3404-001,2015,9,22,3,35,39,74,142
3404-001,2015,9,22,4,20,56,76,74
3404-001,2015,9,22,5,59,63,122,76
3404-001,2015,9,22,6,132,230,362,122
3404-001,2015,9,22,7,225,617,842,362
3404-001,2015,9,22,8,512,1843,2355,842
3404-001,2015,9,22,9,894,1372,2266,2355
3404-001,2015,9,22,10,750,791,1541,2266
3404-001,2015,9,22,11,788,772,1560,1541
3404-001,2015,9,22,12,871,752,1623,1560
3404-001,2015,9,22,13,674,638,1312,1623
3404-001,2015,9,22,14,687,766,1453,1312
3404-001,2015,9,22,15,922,805,1727,1453
3404-001,2015,9,22,16,937,739,1676,1727
3404-001,2015,9,22,17,935,639,1574,1676
3404-001,2015,9,22,18,1454,662,2116,1574
3404-001,2015,9,22,19,1317,593,1910,2116
3404-001,2015,9,22,20,821,479,1300,1910
3404-001,2015,9,22,21,817,308,1125,1300
3404-001,2015,9,22,22,380,248,628,1125
3404-001,2015,9,22,23,182,150,332,628
3404-001,2015,9,22,24,128,109,237,332
3404-001,2015,9,23,1,70,88,158,237
3404-001,2015,9,23,2,44,78,122,158
3404-001,2015,9,23,3,26,39,65,122
3404-001,2015,9,23,4,29,55,84,65
3404-001,2015,9,23,5,52,73,125,84
3404-001,2015,9,23,6,139,221,360,125
3404-001,2015,9,23,7,236,581,817,360
3404-001,2015,9,23,8,499,1841,2340,817
3404-001,2015,9,23,9,840,1444,2284,2340
3404-001,2015,9,23,10,678,789,1467,2284
3404-001,2015,9,23,11,788,788,1576,1467
3404-001,2015,9,23,12,702,764,1466,1576
3404-001,2015,9,23,13,681,622,1303,1466
3404-001,2015,9,23,14,681,757,1438,1303
3404-001,2015,9,23,15,994,746,1740,1438
3404-001,2015,9,23,16,983,758,1741,1740
3404-001,2015,9,23,17,1093,751,1844,1741
3404-001,2015,9,23,18,1587,645,2232,1844
3404-001,2015,9,23,19,1466,514,1980,2232
3404-001,2015,9,23,20,808,432,1240,1980
3404-001,2015,9,23,21,663,266,929,1240
3404-001,2015,9,23,22,303,223,526,929
3404-001,2015,9,23,23,238,155,393,526
3404-001,2015,9,23,24,113,131,244,393
3404-001,2015,9,24,1,78,94,172,244
3404-001,2015,9,24,2,42,72,114,172
3404-001,2015,9,24,3,31,47,78,114
3404-001,2015,9,24,4,22,40,62,78
3404-001,2015,9,24,5,57,79,136,62
3404-001,2015,9,24,6,147,220,367,136
3404-001,2015,9,24,7,206,581,787,367
3404-001,2015,9,24,8,536,1726,2262,787
3404-001,2015,9,24,9,840,1433,2273,2262
3404-001,2015,9,24,10,713,760,1473,2273
3404-001,2015,9,24,11,819,830,1649,1473
3404-001,2015,9,24,12,765,730,1495,1649
3404-001,2015,9,24,13,685,623,1308,1495
3404-001,2015,9,24,14,646,665,1311,1308
3404-001,2015,9,24,15,955,749,1704,1311
3404-001,2015,9,24,16,1024,728,1752,1704
3404-001,2015,9,24,17,1015,580,1595,1752
3404-001,2015,9,24,18,1493,594,2087,1595
3404-001,2015,9,24,19,1391,596,1987,2087
3404-001,2015,9,24,20,953,486,1439,1987
3404-001,2015,9,24,21,711,308,1019,1439
3404-001,2015,9,24,22,361,249,610,1019
3404-001,2015,9,24,23,171,167,338,610
3404-001,2015,9,24,24,111,133,244,338
3404-001,2015,9,25,1,46,94,140,244
3404-001,2015,9,25,2,65,53,118,140
3404-001,2015,9,25,3,29,66,95,118
3404-001,2015,9,25,4,33,50,83,95
3404-001,2015,9,25,5,33,83,116,83
3404-001,2015,9,25,6,100,193,293,116
3404-001,2015,9,25,7,184,522,706,293
3404-001,2015,9,25,8,499,1698,2197,706
3404-001,2015,9,25,9,842,1368,2210,2197
3404-001,2015,9,25,10,663,724,1387,2210
3404-001,2015,9,25,11,726,759,1485,1387
3404-001,2015,9,25,12,769,622,1391,1485
3404-001,2015,9,25,13,689,547,1236,1391
3404-001,2015,9,25,14,715,558,1273,1236
3404-001,2015,9,25,15,836,597,1433,1273
3404-001,2015,9,25,16,1125,592,1717,1433
3404-001,2015,9,25,17,968,543,1511,1717
3404-001,2015,9,25,18,1248,581,1829,1511
3404-001,2015,9,25,19,750,583,1333,1829
3404-001,2015,9,25,20,389,395,784,1333
3404-001,2015,9,25,21,240,320,560,784
3404-001,2015,9,25,22,201,260,461,560
3404-001,2015,9,25,23,95,224,319,461
3404-001,2015,9,25,24,48,106,154,319
3404-001,2015,9,26,1,29,70,99,154
3404-001,2015,9,26,2,48,56,104,99
3404-001,2015,9,26,3,18,37,55,104
3404-001,2015,9,26,4,29,47,76,55
3404-001,2015,9,26,5,31,38,69,76
3404-001,2015,9,26,6,57,89,146,69
3404-001,2015,9,26,7,152,143,295,146
3404-001,2015,9,26,8,117,224,341,295
3404-001,2015,9,26,9,130,380,510,341
3404-001,2015,9,26,10,132,648,780,510
3404-001,2015,9,26,11,184,763,947,780
3404-001,2015,9,26,12,192,625,817,947
3404-001,2015,9,26,13,158,742,900,817
3404-001,2015,9,26,14,162,735,897,900
3404-001,2015,9,26,15,145,462,607,897
3404-001,2015,9,26,16,169,293,462,607
3404-001,2015,9,26,17,165,251,416,462
3404-001,2015,9,26,18,180,250,430,416
3404-001,2015,9,26,19,143,183,326,430
3404-001,2015,9,26,20,106,153,259,326
3404-001,2015,9,26,21,52,101,153,259
3404-001,2015,9,26,22,63,92,155,153
3404-001,2015,9,26,23,33,57,90,155
3404-001,2015,9,26,24,16,46,62,90
3404-001,2015,9,27,1,13,37,50,62
3404-001,2015,9,27,2,7,18,25,50
3404-001,2015,9,27,3,11,15,26,25
3404-001,2015,9,27,4,5,13,18,26
3404-001,2015,9,27,5,9,12,21,18
3404-001,2015,9,27,6,13,34,47,21
3404-001,2015,9,27,7,42,126,168,47
3404-001,2015,9,27,8,87,214,301,168
3404-001,2015,9,27,9,78,201,279,301
3404-001,2015,9,27,10,115,256,371,279
3404-001,2015,9,27,11,257,379,636,371
3404-001,2015,9,27,12,437,506,943,636
3404-001,2015,9,27,13,832,444,1276,943
3404-001,2015,9,27,14,916,496,1412,1276
3404-001,2015,9,27,15,983,587,1570,1412
3404-001,2015,9,27,16,1008,543,1551,1570
3404-001,2015,9,27,17,633,439,1072,1551
3404-001,2015,9,27,18,724,437,1161,1072
3404-001,2015,9,27,19,672,342,1014,1161
3404-001,2015,9,27,20,447,255,702,1014
3404-001,2015,9,27,21,441,182,623,702
3404-001,2015,9,27,22,244,149,393,623
3404-001,2015,9,27,23,108,86,194,393
3404-001,2015,9,27,24,31,65,96,194
3404-001,2015,9,28,1,37,44,81,96
3404-001,2015,9,28,2,18,33,51,81
3404-001,2015,9,28,3,9,21,30,51
3404-001,2015,9,28,4,13,16,29,30
3404-001,2015,9,28,5,9,37,46,29
3404-001,2015,9,28,6,16,49,65,46
3404-001,2015,9,28,7,26,100,126,65
3404-001,2015,9,28,8,50,143,193,126
3404-001,2015,9,28,9,100,184,284,193
3404-001,2015,9,28,10,115,240,355,284
3404-001,2015,9,28,11,184,318,502,355
3404-001,2015,9,28,12,212,404,616,502
3404-001,2015,9,28,13,339,399,738,616
3404-001,2015,9,28,14,609,370,979,738
3404-001,2015,9,28,15,488,356,844,979
3404-001,2015,9,28,16,501,358,859,844
3404-001,2015,9,28,17,918,320,1238,859
3404-001,2015,9,28,18,607,317,924,1238
3404-001,2015,9,28,19,709,253,962,924
3404-001,2015,9,28,20,756,259,1015,962
3404-001,2015,9,28,21,348,187,535,1015
3404-001,2015,9,28,22,201,154,355,535
3404-001,2015,9,28,23,296,112,408,355
3404-001,2015,9,28,24,67,70,137,408
3404-001,2015,9,29,1,46,62,108,137
3404-001,2015,9,29,2,11,37,48,108
3404-001,2015,9,29,3,16,38,54,48
3404-001,2015,9,29,4,5,18,23,54
3404-001,2015,9,29,5,16,42,58,23
3404-001,2015,9,29,6,24,44,68,58
3404-001,2015,9,29,7,31,146,177,68
3404-001,2015,9,29,8,113,310,423,177
3404-001,2015,9,29,9,203,339,542,423
3404-001,2015,9,29,10,197,316,513,542
3404-001,2015,9,29,11,260,396,656,513
3404-001,2015,9,29,12,288,417,705,656
3404-001,2015,9,29,13,281,371,652,705
3404-001,2015,9,29,14,288,349,637,652
3404-001,2015,9,29,15,350,377,727,637
3404-001,2015,9,29,16,396,357,753,727
3404-001,2015,9,29,17,396,340,736,753
3404-001,2015,9,29,18,543,345,888,736
3404-001,2015,9,29,19,365,300,665,888
3404-001,2015,9,29,20,260,277,537,665
3404-001,2015,9,29,21,212,229,441,537
3404-001,2015,9,29,22,139,199,338,441
3404-001,2015,9,29,23,46,145,191,338
3404-001,2015,9,29,24,33,123,156,191
3404-001,2015,9,30,1,24,88,112,156
3404-001,2015,9,30,2,20,42,62,112
3404-001,2015,9,30,3,13,36,49,62
3404-001,2015,9,30,4,20,36,56,49
3404-001,2015,9,30,5,29,67,96,56
3404-001,2015,9,30,6,39,170,209,96
3404-001,2015,9,30,7,128,514,642,209
3404-001,2015,9,30,8,391,1580,1971,642
3404-001,2015,9,30,9,611,1180,1791,1971
3404-001,2015,9,30,10,504,650,1154,1791
3404-001,2015,9,30,11,605,645,1250,1154
3404-001,2015,9,30,12,668,630,1298,1250
3404-001,2015,9,30,13,445,512,957,1298
3404-001,2015,9,30,14,527,620,1147,957
3404-001,2015,9,30,15,665,619,1284,1147
3404-001,2015,9,30,16,726,570,1296,1284
3404-001,2015,9,30,17,689,522,1211,1296
3404-001,2015,9,30,18,1196,572,1768,1211
3404-001,2015,9,30,19,994,480,1474,1768
3404-001,2015,9,30,20,575,357,932,1474
3404-001,2015,9,30,21,514,270,784,932
3404-001,2015,9,30,22,262,173,435,784
3404-001,2015,9,30,23,119,146,265,435
3404-001,2015,9,30,24,72,108,180,265
3404-001,2015,10,1,1,26,82,108,180
3404-001,2015,10,1,2,31,52,83,108
3404-001,2015,10,1,3,16,34,50,83
3404-001,2015,10,1,4,33,37,70,50
3404-001,2015,10,1,5,26,63,89,70
3404-001,2015,10,1,6,81,165,246,89
3404-001,2015,10,1,7,158,498,656,246
3404-001,2015,10,1,8,360,1355,1715,656
3404-001,2015,10,1,9,687,1014,1701,1715
3404-001,2015,10,1,10,513,670,1183,1701
3404-001,2015,10,1,11,645,710,1355,1183
3404-001,2015,10,1,12,650,621,1271,1355
3404-001,2015,10,1,13,459,517,976,1271
3404-001,2015,10,1,14,494,609,1103,976
3404-001,2015,10,1,15,803,616,1419,1103
3404-001,2015,10,1,16,760,620,1380,1419
3404-001,2015,10,1,17,760,526,1286,1380
3404-001,2015,10,1,18,1087,531,1618,1286
3404-001,2015,10,1,19,1085,463,1548,1618
3404-001,2015,10,1,20,706,318,1024,1548
3404-001,2015,10,1,21,591,253,844,1024
3404-001,2015,10,1,22,288,178,466,844
3404-001,2015,10,1,23,152,138,290,466
3404-001,2015,10,1,24,74,86,160,290
3404-001,2015,10,2,1,44,70,114,160
3404-001,2015,10,2,2,44,67,111,114
3404-001,2015,10,2,3,20,40,60,111
3404-001,2015,10,2,4,24,47,71,60
3404-001,2015,10,2,5,50,77,127,71
3404-001,2015,10,2,6,115,204,319,127
3404-001,2015,10,2,7,180,558,738,319
3404-001,2015,10,2,8,468,1761,2229,738
3404-001,2015,10,2,9,786,1406,2192,2229
3404-001,2015,10,2,10,689,748,1437,2192
3404-001,2015,10,2,11,764,754,1518,1437
3404-001,2015,10,2,12,784,703,1487,1518
3404-001,2015,10,2,13,663,604,1267,1487
3404-001,2015,10,2,14,702,633,1335,1267
3404-001,2015,10,2,15,795,739,1534,1335
3404-001,2015,10,2,16,1044,752,1796,1534
3404-001,2015,10,2,17,1009,661,1670,1796
3404-001,2015,10,2,18,1413,662,2075,1670
3404-001,2015,10,2,19,1418,602,2020,2075
3404-001,2015,10,2,20,840,482,1322,2020
3404-001,2015,10,2,21,700,313,1013,1322
3404-001,2015,10,2,22,282,209,491,1013
3404-001,2015,10,2,23,176,146,322,491
3404-001,2015,10,2,24,94,97,191,322
3404-001,2015,10,3,1,42,80,122,191
3404-001,2015,10,3,2,31,57,88,122
3404-001,2015,10,3,3,22,45,67,88
3404-001,2015,10,3,4,18,39,57,67
3404-001,2015,10,3,5,42,69,111,57
3404-001,2015,10,3,6,81,164,245,111
3404-001,2015,10,3,7,182,368,550,245
3404-001,2015,10,3,8,327,811,1138,550
3404-001,2015,10,3,9,580,743,1323,1138
3404-001,2015,10,3,10,451,611,1062,1323
3404-001,2015,10,3,11,559,654,1213,1062
3404-001,2015,10,3,12,542,592,1134,1213
3404-001,2015,10,3,13,448,562,1010,1134
3404-001,2015,10,3,14,459,592,1051,1010
3404-001,2015,10,3,15,656,556,1212,1051
3404-001,2015,10,3,16,548,497,1045,1212
3404-001,2015,10,3,17,604,407,1011,1045
3404-001,2015,10,3,18,1013,471,1484,1011
3404-001,2015,10,3,19,656,418,1074,1484
3404-001,2015,10,3,20,332,296,628,1074
3404-001,2015,10,3,21,217,210,427,628
3404-001,2015,10,3,22,111,190,301,427
3404-001,2015,10,3,23,83,120,203,301
3404-001,2015,10,3,24,42,70,112,203
3404-001,2015,10,4,1,31,65,96,112
3404-001,2015,10,4,2,18,41,59,96
3404-001,2015,10,4,3,18,32,50,59
3404-001,2015,10,4,4,9,27,36,50
3404-001,2015,10,4,5,20,38,58,36
3404-001,2015,10,4,6,39,98,137,58
3404-001,2015,10,4,7,74,223,297,137
3404-001,2015,10,4,8,189,326,515,297
3404-001,2015,10,4,9,273,340,613,515
3404-001,2015,10,4,10,208,325,533,613
3404-001,2015,10,4,11,256,419,675,533
3404-001,2015,10,4,12,262,428,690,675
3404-001,2015,10,4,13,262,403,665,690
3404-001,2015,10,4,14,241,404,645,665
3404-001,2015,10,4,15,353,433,786,645
3404-001,2015,10,4,16,435,410,845,786
3404-001,2015,10,4,17,477,397,874,845
3404-001,2015,10,4,18,657,420,1077,874
3404-001,2015,10,4,19,427,359,786,1077
3404-001,2015,10,4,20,254,273,527,786
3404-001,2015,10,4,21,156,241,397,527
3404-001,2015,10,4,22,115,206,321,397
3404-001,2015,10,4,23,74,140,214,321
3404-001,2015,10,4,24,39,97,136,214
3404-001,2015,10,5,1,9,46,55,136
3404-001,2015,10,5,2,7,44,51,55
3404-001,2015,10,5,3,20,31,51,51
3404-001,2015,10,5,4,33,37,70,51
3404-001,2015,10,5,5,42,58,100,70
3404-001,2015,10,5,6,124,235,359,100
3404-001,2015,10,5,7,184,654,838,359
3404-001,2015,10,5,8,522,1921,2443,838
3404-001,2015,10,5,9,790,1446,2236,2443
3404-001,2015,10,5,10,576,732,1308,2236
3404-001,2015,10,5,11,717,733,1450,1308
3404-001,2015,10,5,12,715,754,1469,1450
3404-001,2015,10,5,13,609,630,1239,1469
3404-001,2015,10,5,14,548,686,1234,1239
3404-001,2015,10,5,15,857,796,1653,1234
3404-001,2015,10,5,16,866,719,1585,1653
3404-001,2015,10,5,17,907,607,1514,1585
3404-001,2015,10,5,18,1343,641,1984,1514
3404-001,2015,10,5,19,1221,526,1747,1984
3404-001,2015,10,5,20,749,397,1146,1747
3404-001,2015,10,5,21,697,282,979,1146
3404-001,2015,10,5,22,410,210,620,979
3404-001,2015,10,5,23,158,148,306,620
3404-001,2015,10,5,24,78,107,185,306
3404-001,2015,10,6,1,65,68,133,185
3404-001,2015,10,6,2,76,52,128,133
3404-001,2015,10,6,3,35,38,73,128
3404-001,2015,10,6,4,29,52,81,73
3404-001,2015,10,6,5,52,63,115,81
3404-001,2015,10,6,6,126,216,342,115
3404-001,2015,10,6,7,195,585,780,342
3404-001,2015,10,6,8,494,1805,2299,780
3404-001,2015,10,6,9,912,1474,2386,2299
3404-001,2015,10,6,10,751,772,1523,2386
3404-001,2015,10,6,11,775,797,1572,1523
3404-001,2015,10,6,12,890,755,1645,1572
3404-001,2015,10,6,13,708,650,1358,1645
3404-001,2015,10,6,14,728,755,1483,1358
3404-001,2015,10,6,15,957,723,1680,1483
3404-001,2015,10,6,16,909,790,1699,1680
3404-001,2015,10,6,17,951,642,1593,1699
3404-001,2015,10,6,18,1495,687,2182,1593
3404-001,2015,10,6,19,1349,537,1886,2182
3404-001,2015,10,6,20,674,388,1062,1886
3404-001,2015,10,6,21,712,298,1010,1062
3404-001,2015,10,6,22,371,191,562,1010
3404-001,2015,10,6,23,195,166,361,562
3404-001,2015,10,6,24,68,117,185,361
3404-001,2015,10,7,1,33,75,108,185
3404-001,2015,10,7,2,39,51,90,108
3404-001,2015,10,7,3,31,42,73,90
3404-001,2015,10,7,4,48,44,92,73
3404-001,2015,10,7,5,55,54,109,92
3404-001,2015,10,7,6,124,204,328,109
3404-001,2015,10,7,7,226,581,807,328
3404-001,2015,10,7,8,524,1668,2192,807
3404-001,2015,10,7,9,918,1375,2293,2192
3404-001,2015,10,7,10,764,817,1581,2293
3404-001,2015,10,7,11,717,769,1486,1581
3404-001,2015,10,7,12,747,754,1501,1486
3404-001,2015,10,7,13,645,599,1244,1501
3404-001,2015,10,7,14,702,750,1452,1244
3404-001,2015,10,7,15,948,785,1733,1452
3404-001,2015,10,7,16,948,772,1720,1733
3404-001,2015,10,7,17,1087,634,1721,1720
3404-001,2015,10,7,18,1566,644,2210,1721
3404-001,2015,10,7,19,1399,568,1967,2210
3404-001,2015,10,7,20,780,432,1212,1967
3404-001,2015,10,7,21,576,250,826,1212
3404-001,2015,10,7,22,368,180,548,826
3404-001,2015,10,7,23,152,154,306,548
3404-001,2015,10,7,24,100,100,200,306
3404-001,2015,10,8,1,48,69,117,200
3404-001,2015,10,8,2,42,54,96,117
3404-001,2015,10,8,3,24,49,73,96
3404-001,2015,10,8,4,42,45,87,73
3404-001,2015,10,8,5,61,71,132,87
3404-001,2015,10,8,6,87,212,299,132
3404-001,2015,10,8,7,197,586,783,299
3404-001,2015,10,8,8,529,1800,2329,783
3404-001,2015,10,8,9,873,1493,2366,2329
3404-001,2015,10,8,10,749,804,1553,2366
3404-001,2015,10,8,11,745,766,1511,1553
3404-001,2015,10,8,12,812,746,1558,1511
3404-001,2015,10,8,13,611,651,1262,1558
3404-001,2015,10,8,14,736,731,1467,1262
3404-001,2015,10,8,15,914,802,1716,1467
3404-001,2015,10,8,16,987,806,1793,1716
3404-001,2015,10,8,17,1098,709,1807,1793
3404-001,2015,10,8,18,1666,726,2392,1807
3404-001,2015,10,8,19,1556,607,2163,2392
3404-001,2015,10,8,20,922,493,1415,2163
3404-001,2015,10,8,21,704,330,1034,1415
3404-001,2015,10,8,22,384,226,610,1034
3404-001,2015,10,8,23,171,163,334,610
3404-001,2015,10,8,24,74,116,190,334
3404-001,2015,10,9,1,48,88,136,190
3404-001,2015,10,9,2,42,61,103,136
3404-001,2015,10,9,3,18,53,71,103
3404-001,2015,10,9,4,7,35,42,71
3404-001,2015,10,9,5,37,81,118,42
3404-001,2015,10,9,6,91,182,273,118
3404-001,2015,10,9,7,148,461,609,273
3404-001,2015,10,9,8,407,938,1345,609
3404-001,2015,10,9,9,518,815,1333,1345
3404-001,2015,10,9,10,548,714,1262,1333
3404-001,2015,10,9,11,516,759,1275,1262
3404-001,2015,10,9,12,557,737,1294,1275
3404-001,2015,10,9,13,442,665,1107,1294
3404-001,2015,10,9,14,500,651,1151,1107
3404-001,2015,10,9,15,544,810,1354,1151
3404-001,2015,10,9,16,661,782,1443,1354
3404-001,2015,10,9,17,812,568,1380,1443
3404-001,2015,10,9,18,1047,539,1586,1380
3404-001,2015,10,9,19,786,467,1253,1586
3404-001,2015,10,9,20,479,318,797,1253
3404-001,2015,10,9,21,299,221,520,797
3404-001,2015,10,9,22,161,171,332,520
3404-001,2015,10,9,23,111,130,241,332
3404-001,2015,10,9,24,61,85,146,241
3404-001,2015,10,10,1,22,62,84,146
3404-001,2015,10,10,2,13,43,56,84
3404-001,2015,10,10,3,20,33,53,56
3404-001,2015,10,10,4,20,36,56,53
3404-001,2015,10,10,5,18,38,56,56
3404-001,2015,10,10,6,52,146,198,56
3404-001,2015,10,10,7,98,300,398,198
3404-001,2015,10,10,8,260,547,807,398
3404-001,2015,10,10,9,494,608,1102,807
3404-001,2015,10,10,10,442,465,907,1102
3404-001,2015,10,10,11,542,523,1065,907
3404-001,2015,10,10,12,422,491,913,1065
3404-001,2015,10,10,13,431,470,901,913
3404-001,2015,10,10,14,474,452,926,901
3404-001,2015,10,10,15,468,448,916,926
3404-001,2015,10,10,16,550,364,914,916
3404-001,2015,10,10,17,477,373,850,914
3404-001,2015,10,10,18,763,377,1140,850
3404-001,2015,10,10,19,539,347,886,1140
3404-001,2015,10,10,20,299,254,553,886
3404-001,2015,10,10,21,163,188,351,553
3404-001,2015,10,10,22,115,144,259,351
3404-001,2015,10,10,23,35,116,151,259
3404-001,2015,10,10,24,26,65,91,151
3404-001,2015,10,11,1,24,47,71,91
3404-001,2015,10,11,2,20,32,52,71
3404-001,2015,10,11,3,26,25,51,52
3404-001,2015,10,11,4,13,35,48,51
3404-001,2015,10,11,5,16,37,53,48
3404-001,2015,10,11,6,18,84,102,53
3404-001,2015,10,11,7,44,181,225,102
3404-001,2015,10,11,8,113,244,357,225
3404-001,2015,10,11,9,197,278,475,357
3404-001,2015,10,11,10,161,286,447,475
3404-001,2015,10,11,11,230,379,609,447
3404-001,2015,10,11,12,247,349,596,609
3404-001,2015,10,11,13,249,355,604,596
3404-001,2015,10,11,14,243,360,603,604
3404-001,2015,10,11,15,342,316,658,603
3404-001,2015,10,11,16,334,336,670,658
3404-001,2015,10,11,17,390,385,775,670
3404-001,2015,10,11,18,432,329,761,775
3404-001,2015,10,11,19,314,308,622,761
3404-001,2015,10,11,20,167,287,454,622
3404-001,2015,10,11,21,111,252,363,454
3404-001,2015,10,11,22,70,181,251,363
3404-001,2015,10,11,23,52,167,219,251
3404-001,2015,10,11,24,24,91,115,219
3404-001,2015,10,12,1,11,67,78,115
3404-001,2015,10,12,2,11,36,47,78
3404-001,2015,10,12,3,20,40,60,47
3404-001,2015,10,12,4,5,37,42,60
3404-001,2015,10,12,5,29,66,95,42
3404-001,2015,10,12,6,85,233,318,95
3404-001,2015,10,12,7,150,627,777,318
3404-001,2015,10,12,8,511,1877,2388,777
3404-001,2015,10,12,9,648,1533,2181,2388
3404-001,2015,10,12,10,635,720,1355,2181
3404-001,2015,10,12,11,684,733,1417,1355
3404-001,2015,10,12,12,747,655,1402,1417
3404-001,2015,10,12,13,652,615,1267,1402
3404-001,2015,10,12,14,667,660,1327,1267
3404-001,2015,10,12,15,676,800,1476,1327
3404-001,2015,10,12,16,708,687,1395,1476
3404-001,2015,10,12,17,901,669,1570,1395
3404-001,2015,10,12,18,1394,653,2047,1570
3404-001,2015,10,12,19,1310,515,1825,2047
3404-001,2015,10,12,20,797,434,1231,1825
3404-001,2015,10,12,21,697,281,978,1231
3404-001,2015,10,12,22,347,221,568,978
3404-001,2015,10,12,23,161,147,308,568
3404-001,2015,10,12,24,65,93,158,308
3404-001,2015,10,13,1,50,79,129,158
3404-001,2015,10,13,2,61,55,116,129
3404-001,2015,10,13,3,42,50,92,116
3404-001,2015,10,13,4,39,39,78,92
3404-001,2015,10,13,5,44,58,102,78
3404-001,2015,10,13,6,126,210,336,102
3404-001,2015,10,13,7,191,580,771,336
3404-001,2015,10,13,8,479,1748,2227,771
3404-001,2015,10,13,9,812,1472,2284,2227
3404-001,2015,10,13,10,648,818,1466,2284
3404-001,2015,10,13,11,749,723,1472,1466
3404-001,2015,10,13,12,786,741,1527,1472
3404-001,2015,10,13,13,730,635,1365,1527
3404-001,2015,10,13,14,708,741,1449,1365
3404-001,2015,10,13,15,825,725,1550,1449
3404-001,2015,10,13,16,940,724,1664,1550
3404-001,2015,10,13,17,1083,622,1705,1664
3404-001,2015,10,13,18,1444,655,2099,1705
3404-001,2015,10,13,19,1169,533,1702,2099
3404-001,2015,10,13,20,808,416,1224,1702
3404-001,2015,10,13,21,637,252,889,1224
3404-001,2015,10,13,22,355,199,554,889
3404-001,2015,10,13,23,141,144,285,554
3404-001,2015,10,13,24,57,81,138,285
3404-001,2015,10,14,1,42,72,114,138
3404-001,2015,10,14,2,44,56,100,114
3404-001,2015,10,14,3,61,27,88,100
3404-001,2015,10,14,4,37,52,89,88
3404-001,2015,10,14,5,61,68,129,89
3404-001,2015,10,14,6,122,212,334,129
3404-001,2015,10,14,7,217,599,816,334
3404-001,2015,10,14,8,589,1839,2428,816
3404-001,2015,10,14,9,747,1319,2066,2428
3404-001,2015,10,14,10,793,756,1549,2066
3404-001,2015,10,14,11,725,766,1491,1549
3404-001,2015,10,14,12,786,740,1526,1491
3404-001,2015,10,14,13,715,562,1277,1526
3404-001,2015,10,14,14,613,697,1310,1277
3404-001,2015,10,14,15,851,763,1614,1310
3404-001,2015,10,14,16,840,749,1589,1614
3404-001,2015,10,14,17,1093,666,1759,1589
3404-001,2015,10,14,18,1698,618,2316,1759
3404-001,2015,10,14,19,1340,544,1884,2316
3404-001,2015,10,14,20,700,413,1113,1884
3404-001,2015,10,14,21,561,299,860,1113
3404-001,2015,10,14,22,340,190,530,860
3404-001,2015,10,14,23,145,144,289,530
3404-001,2015,10,14,24,96,92,188,289
3404-001,2015,10,15,1,61,75,136,188
3404-001,2015,10,15,2,57,43,100,136
3404-001,2015,10,15,3,24,43,67,100
3404-001,2015,10,15,4,35,45,80,67
3404-001,2015,10,15,5,52,88,140,80
3404-001,2015,10,15,6,128,254,382,140
3404-001,2015,10,15,7,226,610,836,382
3404-001,2015,10,15,8,464,1869,2333,836
3404-001,2015,10,15,9,840,1276,2116,2333
3404-001,2015,10,15,10,635,766,1401,2116
3404-001,2015,10,15,11,769,756,1525,1401
3404-001,2015,10,15,12,840,729,1569,1525
3404-001,2015,10,15,13,691,608,1299,1569
3404-001,2015,10,15,14,728,701,1429,1299
3404-001,2015,10,15,15,799,746,1545,1429
3404-001,2015,10,15,16,961,693,1654,1545
3404-001,2015,10,15,17,983,617,1600,1654
3404-001,2015,10,15,18,1541,663,2204,1600
3404-001,2015,10,15,19,1221,572,1793,2204
3404-001,2015,10,15,20,767,429,1196,1793
3404-001,2015,10,15,21,639,291,930,1196
3404-001,2015,10,15,22,308,221,529,930
3404-001,2015,10,15,23,135,139,274,529
3404-001,2015,10,15,24,70,87,157,274
3404-001,2015,10,16,1,55,76,131,157
3404-001,2015,10,16,2,52,50,102,131
3404-001,2015,10,16,3,35,43,78,102
3404-001,2015,10,16,4,22,44,66,78
3404-001,2015,10,16,5,35,74,109,66
3404-001,2015,10,16,6,126,247,373,109
3404-001,2015,10,16,7,208,626,834,373
3404-001,2015,10,16,8,555,1818,2373,834
3404-001,2015,10,16,9,782,1236,2018,2373
3404-001,2015,10,16,10,723,778,1501,2018
3404-001,2015,10,16,11,790,800,1590,1501
3404-001,2015,10,16,12,788,684,1472,1590
3404-001,2015,10,16,13,645,645,1290,1472
3404-001,2015,10,16,14,583,694,1277,1290
3404-001,2015,10,16,15,907,793,1700,1277
3404-001,2015,10,16,16,970,689,1659,1700
3404-001,2015,10,16,17,1225,648,1873,1659
3404-001,2015,10,16,18,1689,689,2378,1873
3404-001,2015,10,16,19,1515,614,2129,2378
3404-001,2015,10,16,20,916,473,1389,2129
3404-001,2015,10,16,21,555,310,865,1389
3404-001,2015,10,16,22,265,236,501,865
3404-001,2015,10,16,23,128,140,268,501
3404-001,2015,10,16,24,76,104,180,268
3404-001,2015,10,17,1,37,84,121,180
3404-001,2015,10,17,2,24,45,69,121
3404-001,2015,10,17,3,44,47,91,69
3404-001,2015,10,17,4,31,43,74,91
3404-001,2015,10,17,5,33,64,97,74
3404-001,2015,10,17,6,83,168,251,97
3404-001,2015,10,17,7,141,427,568,251
3404-001,2015,10,17,8,290,824,1114,568
3404-001,2015,10,17,9,550,740,1290,1114
3404-001,2015,10,17,10,524,638,1162,1290
3404-001,2015,10,17,11,520,650,1170,1162
3404-001,2015,10,17,12,570,580,1150,1170
3404-001,2015,10,17,13,533,560,1093,1150
3404-001,2015,10,17,14,507,612,1119,1093
3404-001,2015,10,17,15,507,602,1109,1119
3404-001,2015,10,17,16,682,561,1243,1109
3404-001,2015,10,17,17,767,473,1240,1243
3404-001,2015,10,17,18,1155,542,1697,1240
3404-001,2015,10,17,19,700,435,1135,1697
3404-001,2015,10,17,20,338,327,665,1135
3404-001,2015,10,17,21,223,256,479,665
3404-001,2015,10,17,22,120,186,306,479
3404-001,2015,10,17,23,65,115,180,306
3404-001,2015,10,17,24,44,73,117,180
3404-001,2015,10,18,1,31,51,82,117
3404-001,2015,10,18,2,33,38,71,82
3404-001,2015,10,18,3,13,28,41,71
3404-001,2015,10,18,4,3,26,29,41
3404-001,2015,10,18,5,7,50,57,29
3404-001,2015,10,18,6,24,93,117,57
3404-001,2015,10,18,7,83,197,280,117
3404-001,2015,10,18,8,161,369,530,280
3404-001,2015,10,18,9,252,334,586,530
3404-001,2015,10,18,10,226,353,579,586
3404-001,2015,10,18,11,286,426,712,579
3404-001,2015,10,18,12,221,423,644,712
3404-001,2015,10,18,13,258,363,621,644
3404-001,2015,10,18,14,254,384,638,621
3404-001,2015,10,18,15,418,391,809,638
3404-001,2015,10,18,16,414,420,834,809
3404-001,2015,10,18,17,537,345,882,834
3404-001,2015,10,18,18,641,412,1053,882
3404-001,2015,10,18,19,636,349,985,1053
3404-001,2015,10,18,20,319,298,617,985
3404-001,2015,10,18,21,204,255,459,617
3404-001,2015,10,18,22,122,205,327,459
3404-001,2015,10,18,23,57,193,250,327
3404-001,2015,10,18,24,33,117,150,250
3404-001,2015,10,19,1,26,67,93,150
3404-001,2015,10,19,2,0,46,46,93
3404-001,2015,10,19,3,7,31,38,46
3404-001,2015,10,19,4,20,42,62,38
3404-001,2015,10,19,5,18,78,96,62
3404-001,2015,10,19,6,94,250,344,96
3404-001,2015,10,19,7,193,677,870,344
3404-001,2015,10,19,8,589,1947,2536,870
3404-001,2015,10,19,9,682,1370,2052,2536
3404-001,2015,10,19,10,617,690,1307,2052
3404-001,2015,10,19,11,708,772,1480,1307
3404-001,2015,10,19,12,715,706,1421,1480
3404-001,2015,10,19,13,611,603,1214,1421
3404-001,2015,10,19,14,622,703,1325,1214
3404-001,2015,10,19,15,782,737,1519,1325
3404-001,2015,10,19,16,851,713,1564,1519
3404-001,2015,10,19,17,985,628,1613,1564
3404-001,2015,10,19,18,1383,644,2027,1613
3404-001,2015,10,19,19,1210,529,1739,2027
3404-001,2015,10,19,20,769,400,1169,1739
3404-001,2015,10,19,21,719,246,965,1169
3404-001,2015,10,19,22,381,210,591,965
3404-001,2015,10,19,23,137,144,281,591
3404-001,2015,10,19,24,63,89,152,281
3404-001,2015,10,20,1,59,66,125,152
3404-001,2015,10,20,2,33,46,79,125
3404-001,2015,10,20,3,16,41,57,79
3404-001,2015,10,20,4,29,48,77,57
3404-001,2015,10,20,5,44,62,106,77
3404-001,2015,10,20,6,107,222,329,106
3404-001,2015,10,20,7,213,609,822,329
3404-001,2015,10,20,8,544,1717,2261,822
3404-001,2015,10,20,9,708,1374,2082,2261
3404-001,2015,10,20,10,710,812,1522,2082
3404-001,2015,10,20,11,769,766,1535,1522
3404-001,2015,10,20,12,747,678,1425,1535
3404-001,2015,10,20,13,570,631,1201,1425
3404-001,2015,10,20,14,689,678,1367,1201
3404-001,2015,10,20,15,797,750,1547,1367
3404-001,2015,10,20,16,938,697,1635,1547
3404-001,2015,10,20,17,948,642,1590,1635
3404-001,2015,10,20,18,1381,627,2008,1590
3404-001,2015,10,20,19,1323,488,1811,2008
3404-001,2015,10,20,20,719,421,1140,1811
3404-001,2015,10,20,21,680,262,942,1140
3404-001,2015,10,20,22,319,202,521,942
3404-001,2015,10,20,23,195,130,325,521
3404-001,2015,10,20,24,74,94,168,325
3404-001,2015,10,21,1,42,65,107,168
3404-001,2015,10,21,2,35,60,95,107
3404-001,2015,10,21,3,24,41,65,95
3404-001,2015,10,21,4,29,43,72,65
3404-001,2015,10,21,5,35,73,108,72
3404-001,2015,10,21,6,113,234,347,108
3404-001,2015,10,21,7,189,581,770,347
3404-001,2015,10,21,8,533,1785,2318,770
3404-001,2015,10,21,9,803,1339,2142,2318
3404-001,2015,10,21,10,689,764,1453,2142
3404-001,2015,10,21,11,728,776,1504,1453
3404-001,2015,10,21,12,903,697,1600,1504
3404-001,2015,10,21,13,615,616,1231,1600
3404-001,2015,10,21,14,691,663,1354,1231
3404-001,2015,10,21,15,849,696,1545,1354
3404-001,2015,10,21,16,842,711,1553,1545
3404-001,2015,10,21,17,959,630,1589,1553
3404-001,2015,10,21,18,1619,627,2246,1589
3404-001,2015,10,21,19,1392,478,1870,2246
3404-001,2015,10,21,20,743,404,1147,1870
3404-001,2015,10,21,21,529,254,783,1147
3404-001,2015,10,21,22,256,208,464,783
3404-001,2015,10,21,23,154,160,314,464
3404-001,2015,10,21,24,94,111,205,314
3404-001,2015,10,22,1,44,82,126,205
3404-001,2015,10,22,2,31,48,79,126
3404-001,2015,10,22,3,18,34,52,79
3404-001,2015,10,22,4,33,42,75,52
3404-001,2015,10,22,5,24,73,97,75
3404-001,2015,10,22,6,115,206,321,97
3404-001,2015,10,22,7,141,561,702,321
3404-001,2015,10,22,8,464,1707,2171,702
3404-001,2015,10,22,9,758,1407,2165,2171
3404-001,2015,10,22,10,658,789,1447,2165
3404-001,2015,10,22,11,654,728,1382,1447
3404-001,2015,10,22,12,775,662,1437,1382
3404-001,2015,10,22,13,567,593,1160,1437
3404-001,2015,10,22,14,674,665,1339,1160
3404-001,2015,10,22,15,873,722,1595,1339
3404-001,2015,10,22,16,883,723,1606,1595
3404-001,2015,10,22,17,968,634,1602,1606
3404-001,2015,10,22,18,1479,617,2096,1602
3404-001,2015,10,22,19,1269,531,1800,2096
3404-001,2015,10,22,20,816,436,1252,1800
3404-001,2015,10,22,21,585,278,863,1252
3404-001,2015,10,22,22,306,179,485,863
3404-001,2015,10,22,23,117,132,249,485
3404-001,2015,10,22,24,70,108,178,249
3404-001,2015,10,23,1,57,72,129,178
3404-001,2015,10,23,2,31,63,94,129
3404-001,2015,10,23,3,20,37,57,94
3404-001,2015,10,23,4,20,50,70,57
3404-001,2015,10,23,5,39,78,117,70
3404-001,2015,10,23,6,141,241,382,117
3404-001,2015,10,23,7,210,603,813,382
3404-001,2015,10,23,8,509,1818,2327,813
3404-001,2015,10,23,9,793,1294,2087,2327
3404-001,2015,10,23,10,838,757,1595,2087
3404-001,2015,10,23,11,769,773,1542,1595
3404-001,2015,10,23,12,795,717,1512,1542
3404-001,2015,10,23,13,658,620,1278,1512
3404-001,2015,10,23,14,689,715,1404,1278
3404-001,2015,10,23,15,957,749,1706,1404
3404-001,2015,10,23,16,903,753,1656,1706
3404-001,2015,10,23,17,1156,641,1797,1656
3404-001,2015,10,23,18,1669,678,2347,1797
3404-001,2015,10,23,19,1667,637,2304,2347
3404-001,2015,10,23,20,834,470,1304,2304
3404-001,2015,10,23,21,570,316,886,1304
3404-001,2015,10,23,22,267,196,463,886
3404-001,2015,10,23,23,156,155,311,463
3404-001,2015,10,23,24,91,94,185,311
3404-001,2015,10,24,1,61,88,149,185
3404-001,2015,10,24,2,39,57,96,149
3404-001,2015,10,24,3,22,42,64,96
3404-001,2015,10,24,4,20,52,72,64
3404-001,2015,10,24,5,26,79,105,72
3404-001,2015,10,24,6,120,184,304,105
3404-001,2015,10,24,7,154,425,579,304
3404-001,2015,10,24,8,284,716,1000,579
3404-001,2015,10,24,9,570,652,1222,1000
3404-001,2015,10,24,10,513,629,1142,1222
3404-001,2015,10,24,11,544,625,1169,1142
3404-001,2015,10,24,12,583,631,1214,1169
3404-001,2015,10,24,13,531,566,1097,1214
3404-001,2015,10,24,14,453,581,1034,1097
3404-001,2015,10,24,15,589,583,1172,1034
3404-001,2015,10,24,16,656,560,1216,1172
3404-001,2015,10,24,17,775,524,1299,1216
3404-001,2015,10,24,18,1001,520,1521,1299
3404-001,2015,10,24,19,583,476,1059,1521
3404-001,2015,10,24,20,312,302,614,1059
3404-001,2015,10,24,21,223,246,469,614
3404-001,2015,10,24,22,158,145,303,469
3404-001,2015,10,24,23,78,140,218,303
3404-001,2015,10,24,24,37,88,125,218
3404-001,2015,10,25,1,18,58,76,125
3404-001,2015,10,25,2,16,37,53,76
3404-001,2015,10,25,3,18,26,44,53
3404-001,2015,10,25,4,33,32,65,44
3404-001,2015,10,25,5,26,61,87,65
3404-001,2015,10,25,6,33,103,136,87
3404-001,2015,10,25,7,68,195,263,136
3404-001,2015,10,25,8,107,307,414,263
3404-001,2015,10,25,9,187,348,535,414
3404-001,2015,10,25,10,217,331,548,535
3404-001,2015,10,25,11,299,411,710,548
3404-001,2015,10,25,12,234,402,636,710
3404-001,2015,10,25,13,265,397,662,636
3404-001,2015,10,25,14,288,414,702,662
3404-001,2015,10,25,15,349,388,737,702
3404-001,2015,10,25,16,440,405,845,737
3404-001,2015,10,25,17,684,389,1073,845
3404-001,2015,10,25,18,868,361,1229,1073
3404-001,2015,10,25,19,613,313,926,1229
3404-001,2015,10,25,20,377,313,690,926
3404-001,2015,10,25,21,167,263,430,690
3404-001,2015,10,25,22,98,237,335,430
3404-001,2015,10,25,23,50,146,196,335
3404-001,2015,10,25,24,22,125,147,196
3404-001,2015,10,26,1,16,65,81,147
3404-001,2015,10,26,2,16,36,52,81
3404-001,2015,10,26,3,9,35,44,52
3404-001,2015,10,26,4,13,45,58,44
3404-001,2015,10,26,5,35,75,110,58
3404-001,2015,10,26,6,78,263,341,110
3404-001,2015,10,26,7,169,721,890,341
3404-001,2015,10,26,8,546,1930,2476,890
3404-001,2015,10,26,9,661,1378,2039,2476
3404-001,2015,10,26,10,609,708,1317,2039
3404-001,2015,10,26,11,684,703,1387,1317
3404-001,2015,10,26,12,695,692,1387,1387
3404-001,2015,10,26,13,583,554,1137,1387
3404-001,2015,10,26,14,641,701,1342,1137
3404-001,2015,10,26,15,780,744,1524,1342
3404-001,2015,10,26,16,823,687,1510,1524
3404-001,2015,10,26,17,948,652,1600,1510
3404-001,2015,10,26,18,1490,595,2085,1600
3404-001,2015,10,26,19,1282,490,1772,2085
3404-001,2015,10,26,20,758,373,1131,1772
3404-001,2015,10,26,21,693,298,991,1131
3404-001,2015,10,26,22,267,204,471,991
3404-001,2015,10,26,23,156,131,287,471
3404-001,2015,10,26,24,57,87,144,287
3404-001,2015,10,27,1,26,75,101,144
3404-001,2015,10,27,2,50,39,89,101
3404-001,2015,10,27,3,24,40,64,89
3404-001,2015,10,27,4,39,39,78,64
3404-001,2015,10,27,5,22,53,75,78
3404-001,2015,10,27,6,78,177,255,75
3404-001,2015,10,27,7,143,476,619,255
3404-001,2015,10,27,8,410,1680,2090,619
3404-001,2015,10,27,9,654,1268,1922,2090
3404-001,2015,10,27,10,546,699,1245,1922
3404-001,2015,10,27,11,663,741,1404,1245
3404-001,2015,10,27,12,658,683,1341,1404
3404-001,2015,10,27,13,555,573,1128,1341
3404-001,2015,10,27,14,676,681,1357,1128
3404-001,2015,10,27,15,706,741,1447,1357
3404-001,2015,10,27,16,756,660,1416,1447
3404-001,2015,10,27,17,875,590,1465,1416
3404-001,2015,10,27,18,1208,556,1764,1465
3404-001,2015,10,27,19,1067,489,1556,1764
3404-001,2015,10,27,20,732,392,1124,1556
3404-001,2015,10,27,21,604,290,894,1124
3404-001,2015,10,27,22,247,187,434,894
3404-001,2015,10,27,23,150,134,284,434
3404-001,2015,10,27,24,74,98,172,284
3404-001,2015,10,28,1,48,85,133,172
3404-001,2015,10,28,2,48,43,91,133
3404-001,2015,10,28,3,20,42,62,91
3404-001,2015,10,28,4,29,45,74,62
3404-001,2015,10,28,5,46,71,117,74
3404-001,2015,10,28,6,111,214,325,117
3404-001,2015,10,28,7,171,622,793,325
3404-001,2015,10,28,8,557,1835,2392,793
3404-001,2015,10,28,9,866,1392,2258,2392
3404-001,2015,10,28,10,769,784,1553,2258
3404-001,2015,10,28,11,829,770,1599,1553
3404-001,2015,10,28,12,786,736,1522,1599
3404-001,2015,10,28,13,596,593,1189,1522
3404-001,2015,10,28,14,721,674,1395,1189
3404-001,2015,10,28,15,847,726,1573,1395
3404-001,2015,10,28,16,899,675,1574,1573
3404-001,2015,10,28,17,989,610,1599,1574
3404-001,2015,10,28,18,1580,632,2212,1599
3404-001,2015,10,28,19,1264,494,1758,2212
3404-001,2015,10,28,20,669,391,1060,1758
3404-001,2015,10,28,21,518,282,800,1060
3404-001,2015,10,28,22,232,197,429,800
3404-001,2015,10,28,23,156,147,303,429
3404-001,2015,10,28,24,91,93,184,303
3404-001,2015,10,29,1,31,71,102,184
3404-001,2015,10,29,2,37,50,87,102
3404-001,2015,10,29,3,39,36,75,87
3404-001,2015,10,29,4,57,35,92,75
3404-001,2015,10,29,5,57,74,131,92
3404-001,2015,10,29,6,126,202,328,131
3404-001,2015,10,29,7,184,607,791,328
3404-001,2015,10,29,8,526,1849,2375,791
3404-001,2015,10,29,9,758,1336,2094,2375
3404-001,2015,10,29,10,654,769,1423,2094
3404-001,2015,10,29,11,769,753,1522,1423
3404-001,2015,10,29,12,689,674,1363,1522
3404-001,2015,10,29,13,671,569,1240,1363
3404-001,2015,10,29,14,622,638,1260,1240
3404-001,2015,10,29,15,888,773,1661,1260
3404-001,2015,10,29,16,886,679,1565,1661
3404-001,2015,10,29,17,1109,608,1717,1565
3404-001,2015,10,29,18,1586,630,2216,1717
3404-001,2015,10,29,19,1279,579,1858,2216
3404-001,2015,10,29,20,715,396,1111,1858
3404-001,2015,10,29,21,574,281,855,1111
3404-001,2015,10,29,22,293,214,507,855
3404-001,2015,10,29,23,148,162,310,507
3404-001,2015,10,29,24,122,72,194,310
3404-001,2015,10,30,1,44,69,113,194
3404-001,2015,10,30,2,39,40,79,113
3404-001,2015,10,30,3,29,37,66,79
3404-001,2015,10,30,4,22,52,74,66
3404-001,2015,10,30,5,50,68,118,74
3404-001,2015,10,30,6,109,202,311,118
3404-001,2015,10,30,7,189,609,798,311
3404-001,2015,10,30,8,496,1807,2303,798
3404-001,2015,10,30,9,810,1327,2137,2303
3404-001,2015,10,30,10,626,781,1407,2137
3404-001,2015,10,30,11,734,770,1504,1407
3404-001,2015,10,30,12,767,681,1448,1504
3404-001,2015,10,30,13,652,607,1259,1448
3404-001,2015,10,30,14,702,663,1365,1259
3404-001,2015,10,30,15,931,720,1651,1365
3404-001,2015,10,30,16,1007,654,1661,1651
3404-001,2015,10,30,17,1182,598,1780,1661
3404-001,2015,10,30,18,1732,627,2359,1780
3404-001,2015,10,30,19,1561,581,2142,2359
3404-001,2015,10,30,20,907,479,1386,2142
3404-001,2015,10,30,21,544,327,871,1386
3404-001,2015,10,30,22,258,196,454,871
3404-001,2015,10,30,23,141,142,283,454
3404-001,2015,10,30,24,61,97,158,283
3404-001,2015,10,31,1,37,71,108,158
3404-001,2015,10,31,2,37,40,77,108
3404-001,2015,10,31,3,22,47,69,77
3404-001,2015,10,31,4,46,41,87,69
3404-001,2015,10,31,5,48,60,108,87
3404-001,2015,10,31,6,124,158,282,108
3404-001,2015,10,31,7,122,411,533,282
3404-001,2015,10,31,8,303,761,1064,533
3404-001,2015,10,31,9,565,655,1220,1064
3404-001,2015,10,31,10,609,616,1225,1220
3404-001,2015,10,31,11,505,647,1152,1225
3404-001,2015,10,31,12,513,582,1095,1152
3404-001,2015,10,31,13,477,567,1044,1095
3404-001,2015,10,31,14,598,558,1156,1044
3404-001,2015,10,31,15,576,625,1201,1156
3404-001,2015,10,31,16,639,548,1187,1201
3404-001,2015,10,31,17,751,492,1243,1187
3404-001,2015,10,31,18,1026,494,1520,1243
3404-001,2015,10,31,19,719,377,1096,1520
3404-001,2015,10,31,20,338,308,646,1096
3404-001,2015,10,31,21,197,216,413,646
3404-001,2015,10,31,22,98,166,264,413
3404-001,2015,10,31,23,57,133,190,264
3404-001,2015,10,31,24,37,59,96,190
3404-001,2015,11,1,1,31,62,93,96
3404-001,2015,11,1,2,16,33,49,93
3404-001,2015,11,1,3,29,29,58,49
3404-001,2015,11,1,4,18,34,52,58
3404-001,2015,11,1,5,14,45,59,52
3404-001,2015,11,1,6,42,84,126,59
3404-001,2015,11,1,7,71,183,254,126
3404-001,2015,11,1,8,121,276,397,254
3404-001,2015,11,1,9,196,324,520,397
3404-001,2015,11,1,10,220,319,539,520
3404-001,2015,11,1,11,281,364,645,539
3404-001,2015,11,1,12,257,360,617,645
3404-001,2015,11,1,13,218,384,602,617
3404-001,2015,11,1,14,277,386,663,602
3404-001,2015,11,1,15,393,388,781,663
3404-001,2015,11,1,16,463,418,881,781
3404-001,2015,11,1,17,581,359,940,881
3404-001,2015,11,1,18,776,413,1189,940
3404-001,2015,11,1,19,485,358,843,1189
3404-001,2015,11,1,20,285,302,587,843
3404-001,2015,11,1,21,171,249,420,587
3404-001,2015,11,1,22,93,218,311,420
3404-001,2015,11,1,23,62,169,231,311
3404-001,2015,11,1,24,25,113,138,231
3404-001,2015,11,2,1,18,59,77,138
3404-001,2015,11,2,2,18,46,64,77
3404-001,2015,11,2,3,7,33,40,64
3404-001,2015,11,2,4,29,34,63,40
3404-001,2015,11,2,5,25,82,107,63
3404-001,2015,11,2,6,117,238,355,107
3404-001,2015,11,2,7,182,678,860,355
3404-001,2015,11,2,8,472,2015,2487,860
3404-001,2015,11,2,9,833,1435,2268,2487
3404-001,2015,11,2,10,737,764,1501,2268
3404-001,2015,11,2,11,755,720,1475,1501
3404-001,2015,11,2,12,844,674,1518,1475
3404-001,2015,11,2,13,647,656,1303,1518
3404-001,2015,11,2,14,704,732,1436,1303
3404-001,2015,11,2,15,871,761,1632,1436
3404-001,2015,11,2,16,796,682,1478,1632
3404-001,2015,11,2,17,917,664,1581,1478
3404-001,2015,11,2,18,1486,642,2128,1581
3404-001,2015,11,2,19,1191,513,1704,2128
3404-001,2015,11,2,20,741,406,1147,1704
3404-001,2015,11,2,21,689,270,959,1147
3404-001,2015,11,2,22,290,227,517,959
3404-001,2015,11,2,23,163,142,305,517
3404-001,2015,11,2,24,90,94,184,305
3404-001,2015,11,3,1,53,76,129,184
3404-001,2015,11,3,2,22,41,63,129
3404-001,2015,11,3,3,36,43,79,63
3404-001,2015,11,3,4,25,48,73,79
3404-001,2015,11,3,5,47,59,106,73
3404-001,2015,11,3,6,136,216,352,106
3404-001,2015,11,3,7,187,564,751,352
3404-001,2015,11,3,8,494,1795,2289,751
3404-001,2015,11,3,9,790,1337,2127,2289
3404-001,2015,11,3,10,750,768,1518,2127
3404-001,2015,11,3,11,728,774,1502,1518
3404-001,2015,11,3,12,794,703,1497,1502
3404-001,2015,11,3,13,673,526,1199,1497
3404-001,2015,11,3,14,652,682,1334,1199
3404-001,2015,11,3,15,869,768,1637,1334
3404-001,2015,11,3,16,926,685,1611,1637
3404-001,2015,11,3,17,1015,620,1635,1611
3404-001,2015,11,3,18,1468,664,2132,1635
3404-001,2015,11,3,19,1318,490,1808,2132
3404-001,2015,11,3,20,709,420,1129,1808
3404-001,2015,11,3,21,634,281,915,1129
3404-001,2015,11,3,22,334,217,551,915
3404-001,2015,11,3,23,165,140,305,551
3404-001,2015,11,3,24,86,99,185,305
3404-001,2015,11,4,1,51,72,123,185
3404-001,2015,11,4,2,27,47,74,123
3404-001,2015,11,4,3,22,35,57,74
3404-001,2015,11,4,4,25,43,68,57
3404-001,2015,11,4,5,42,68,110,68
3404-001,2015,11,4,6,114,198,312,110
3404-001,2015,11,4,7,180,576,756,312
3404-001,2015,11,4,8,551,1747,2298,756
3404-001,2015,11,4,9,792,1433,2225,2298
3404-001,2015,11,4,10,748,738,1486,2225
3404-001,2015,11,4,11,726,746,1472,1486
3404-001,2015,11,4,12,616,672,1288,1472
3404-001,2015,11,4,13,603,580,1183,1288
3404-001,2015,11,4,14,584,659,1243,1183
3404-001,2015,11,4,15,763,745,1508,1243
3404-001,2015,11,4,16,875,656,1531,1508
3404-001,2015,11,4,17,956,567,1523,1531
3404-001,2015,11,4,18,1641,601,2242,1523
3404-001,2015,11,4,19,1364,522,1886,2242
3404-001,2015,11,4,20,820,397,1217,1886
3404-001,2015,11,4,21,614,262,876,1217
3404-001,2015,11,4,22,270,198,468,876
3404-001,2015,11,4,23,147,149,296,468
3404-001,2015,11,4,24,93,96,189,296
3404-001,2015,11,5,1,53,69,122,189
3404-001,2015,11,5,2,38,51,89,122
3404-001,2015,11,5,3,20,43,63,89
3404-001,2015,11,5,4,38,46,84,63
3404-001,2015,11,5,5,66,72,138,84
3404-001,2015,11,5,6,125,238,363,138
3404-001,2015,11,5,7,163,584,747,363
3404-001,2015,11,5,8,557,1834,2391,747
3404-001,2015,11,5,9,862,1405,2267,2391
3404-001,2015,11,5,10,873,787,1660,2267
3404-001,2015,11,5,11,831,733,1564,1660
3404-001,2015,11,5,12,728,750,1478,1564
3404-001,2015,11,5,13,603,608,1211,1478
3404-001,2015,11,5,14,722,703,1425,1211
3404-001,2015,11,5,15,904,718,1622,1425
3404-001,2015,11,5,16,950,681,1631,1622
3404-001,2015,11,5,17,1040,637,1677,1631
3404-001,2015,11,5,18,1580,678,2258,1677
3404-001,2015,11,5,19,1309,534,1843,2258
3404-001,2015,11,5,20,829,417,1246,1843
3404-001,2015,11,5,21,667,244,911,1246
3404-001,2015,11,5,22,305,227,532,911
3404-001,2015,11,5,23,176,144,320,532
3404-001,2015,11,5,24,88,101,189,320
3404-001,2015,11,6,1,53,73,126,189
3404-001,2015,11,6,2,44,58,102,126
3404-001,2015,11,6,3,31,29,60,102
3404-001,2015,11,6,4,29,54,83,60
3404-001,2015,11,6,5,22,67,89,83
3404-001,2015,11,6,6,125,210,335,89
3404-001,2015,11,6,7,196,640,836,335
3404-001,2015,11,6,8,555,1763,2318,836
3404-001,2015,11,6,9,790,1293,2083,2318
3404-001,2015,11,6,10,676,776,1452,2083
3404-001,2015,11,6,11,822,852,1674,1452
3404-001,2015,11,6,12,792,732,1524,1674
3404-001,2015,11,6,13,700,634,1334,1524
3404-001,2015,11,6,14,755,745,1500,1334
3404-001,2015,11,6,15,1009,732,1741,1500
3404-001,2015,11,6,16,928,689,1617,1741
3404-001,2015,11,6,17,1081,620,1701,1617
3404-001,2015,11,6,18,1770,605,2375,1701
3404-001,2015,11,6,19,1691,556,2247,2375
3404-001,2015,11,6,20,956,468,1424,2247
3404-001,2015,11,6,21,678,314,992,1424
3404-001,2015,11,6,22,277,197,474,992
3404-001,2015,11,6,23,141,146,287,474
3404-001,2015,11,6,24,55,90,145,287
3404-001,2015,11,7,1,42,69,111,145
3404-001,2015,11,7,2,40,37,77,111
3404-001,2015,11,7,3,33,45,78,77
3404-001,2015,11,7,4,25,40,65,78
3404-001,2015,11,7,5,36,44,80,65
3404-001,2015,11,7,6,55,106,161,80
3404-001,2015,11,7,7,95,238,333,161
3404-001,2015,11,7,8,253,625,878,333
3404-001,2015,11,7,9,461,609,1070,878
3404-001,2015,11,7,10,402,524,926,1070
3404-001,2015,11,7,11,456,566,1022,926
3404-001,2015,11,7,12,410,529,939,1022
3404-001,2015,11,7,13,428,502,930,939
3404-001,2015,11,7,14,413,432,845,930
3404-001,2015,11,7,15,437,507,944,845
3404-001,2015,11,7,16,485,495,980,944
3404-001,2015,11,7,17,540,406,946,980
3404-001,2015,11,7,18,587,440,1027,946
3404-001,2015,11,7,19,393,346,739,1027
3404-001,2015,11,7,20,185,277,462,739
3404-001,2015,11,7,21,147,175,322,462
3404-001,2015,11,7,22,84,136,220,322
3404-001,2015,11,7,23,73,116,189,220
3404-001,2015,11,7,24,31,82,113,189
3404-001,2015,11,8,1,27,50,77,113
3404-001,2015,11,8,2,18,46,64,77
3404-001,2015,11,8,3,22,23,45,64
3404-001,2015,11,8,4,14,27,41,45
3404-001,2015,11,8,5,14,14,28,41
3404-001,2015,11,8,6,29,41,70,28
3404-001,2015,11,8,7,25,113,138,70
3404-001,2015,11,8,8,90,183,273,138
3404-001,2015,11,8,9,174,209,383,273
3404-001,2015,11,8,10,150,250,400,383
3404-001,2015,11,8,11,161,311,472,400
3404-001,2015,11,8,12,169,327,496,472
3404-001,2015,11,8,13,211,348,559,496
3404-001,2015,11,8,14,235,363,598,559
3404-001,2015,11,8,15,277,329,606,598
3404-001,2015,11,8,16,349,356,705,606
3404-001,2015,11,8,17,380,311,691,705
3404-001,2015,11,8,18,353,305,658,691
3404-001,2015,11,8,19,211,289,500,658
3404-001,2015,11,8,20,119,223,342,500
3404-001,2015,11,8,21,114,239,353,342
3404-001,2015,11,8,22,60,185,245,353
3404-001,2015,11,8,23,42,151,193,245
3404-001,2015,11,8,24,22,107,129,193
3404-001,2015,11,9,1,27,61,88,129
3404-001,2015,11,9,2,9,40,49,88
3404-001,2015,11,9,3,11,29,40,49
3404-001,2015,11,9,4,20,36,56,40
3404-001,2015,11,9,5,22,61,83,56
3404-001,2015,11,9,6,57,234,291,83
3404-001,2015,11,9,7,112,613,725,291
3404-001,2015,11,9,8,450,1927,2377,725
3404-001,2015,11,9,9,750,1396,2146,2377
3404-001,2015,11,9,10,546,663,1209,2146
3404-001,2015,11,9,11,733,691,1424,1209
3404-001,2015,11,9,12,654,698,1352,1424
3404-001,2015,11,9,13,553,576,1129,1352
3404-001,2015,11,9,14,590,647,1237,1129
3404-001,2015,11,9,15,831,721,1552,1237
3404-001,2015,11,9,16,801,659,1460,1552
3404-001,2015,11,9,17,934,595,1529,1460
3404-001,2015,11,9,18,1330,665,1995,1529
3404-001,2015,11,9,19,1107,477,1584,1995
3404-001,2015,11,9,20,724,379,1103,1584
3404-001,2015,11,9,21,641,284,925,1103
3404-001,2015,11,9,22,312,223,535,925
3404-001,2015,11,9,23,125,140,265,535
3404-001,2015,11,9,24,79,107,186,265
3404-001,2015,11,10,1,77,46,123,186
3404-001,2015,11,10,2,42,49,91,123
3404-001,2015,11,10,3,36,49,85,91
3404-001,2015,11,10,4,20,44,64,85
3404-001,2015,11,10,5,68,69,137,64
3404-001,2015,11,10,6,79,211,290,137
3404-001,2015,11,10,7,150,564,714,290
3404-001,2015,11,10,8,483,1814,2297,714
3404-001,2015,11,10,9,888,1357,2245,2297
3404-001,2015,11,10,10,660,786,1446,2245
3404-001,2015,11,10,11,750,825,1575,1446
3404-001,2015,11,10,12,741,724,1465,1575
3404-001,2015,11,10,13,660,597,1257,1465
3404-001,2015,11,10,14,687,716,1403,1257
3404-001,2015,11,10,15,906,695,1601,1403
3404-001,2015,11,10,16,985,698,1683,1601
3404-001,2015,11,10,17,985,630,1615,1683
3404-001,2015,11,10,18,1530,588,2118,1615
3404-001,2015,11,10,19,1210,516,1726,2118
3404-001,2015,11,10,20,737,399,1136,1726
3404-001,2015,11,10,21,656,275,931,1136
3404-001,2015,11,10,22,362,221,583,931
3404-001,2015,11,10,23,161,161,322,583
3404-001,2015,11,10,24,73,94,167,322
3404-001,2015,11,11,1,40,57,97,167
3404-001,2015,11,11,2,44,51,95,97
3404-001,2015,11,11,3,20,42,62,95
3404-001,2015,11,11,4,16,52,68,62
3404-001,2015,11,11,5,49,68,117,68
3404-001,2015,11,11,6,84,186,270,117
3404-001,2015,11,11,7,220,550,770,270
3404-001,2015,11,11,8,507,1752,2259,770
3404-001,2015,11,11,9,886,1389,2275,2259
3404-001,2015,11,11,10,667,752,1419,2275
3404-001,2015,11,11,11,783,739,1522,1419
3404-001,2015,11,11,12,695,708,1403,1522
3404-001,2015,11,11,13,599,604,1203,1403
3404-001,2015,11,11,14,645,694,1339,1203
3404-001,2015,11,11,15,809,727,1536,1339
3404-001,2015,11,11,16,869,697,1566,1536
3404-001,2015,11,11,17,956,630,1586,1566
3404-001,2015,11,11,18,1698,623,2321,1586
3404-001,2015,11,11,19,1360,526,1886,2321
3404-001,2015,11,11,20,700,385,1085,1886
3404-001,2015,11,11,21,570,259,829,1085
3404-001,2015,11,11,22,371,230,601,829
3404-001,2015,11,11,23,185,133,318,601
3404-001,2015,11,11,24,79,118,197,318
3404-001,2015,11,12,1,60,72,132,197
3404-001,2015,11,12,2,25,62,87,132
3404-001,2015,11,12,3,38,35,73,87
3404-001,2015,11,12,4,36,36,72,73
3404-001,2015,11,12,5,51,56,107,72
3404-001,2015,11,12,6,119,189,308,107
3404-001,2015,11,12,7,161,567,728,308
3404-001,2015,11,12,8,507,1821,2328,728
3404-001,2015,11,12,9,763,1364,2127,2328
3404-001,2015,11,12,10,671,747,1418,2127
3404-001,2015,11,12,11,779,649,1428,1418
3404-001,2015,11,12,12,748,728,1476,1428
3404-001,2015,11,12,13,634,558,1192,1476
3404-001,2015,11,12,14,621,714,1335,1192
3404-001,2015,11,12,15,829,716,1545,1335
3404-001,2015,11,12,16,936,731,1667,1545
3404-001,2015,11,12,17,934,602,1536,1667
3404-001,2015,11,12,18,1437,631,2068,1536
3404-001,2015,11,12,19,1175,563,1738,2068
3404-001,2015,11,12,20,779,422,1201,1738
3404-001,2015,11,12,21,623,285,908,1201
3404-001,2015,11,12,22,316,214,530,908
3404-001,2015,11,12,23,154,141,295,530
3404-001,2015,11,12,24,66,93,159,295
3404-001,2015,11,13,1,60,70,130,159
3404-001,2015,11,13,2,31,48,79,130
3404-001,2015,11,13,3,29,36,65,79
3404-001,2015,11,13,4,20,50,70,65
3404-001,2015,11,13,5,53,63,116,70
3404-001,2015,11,13,6,117,217,334,116
3404-001,2015,11,13,7,178,558,736,334
3404-001,2015,11,13,8,441,1660,2101,736
3404-001,2015,11,13,9,862,1420,2282,2101
3404-001,2015,11,13,10,605,769,1374,2282
3404-001,2015,11,13,11,709,729,1438,1374
3404-001,2015,11,13,12,713,623,1336,1438
3404-001,2015,11,13,13,595,571,1166,1336
3404-001,2015,11,13,14,621,602,1223,1166
3404-001,2015,11,13,15,702,632,1334,1223
3404-001,2015,11,13,16,735,585,1320,1334
3404-001,2015,11,13,17,774,526,1300,1320
3404-001,2015,11,13,18,1474,615,2089,1300
3404-001,2015,11,13,19,1316,544,1860,2089
3404-001,2015,11,13,20,792,452,1244,1860
3404-001,2015,11,13,21,511,269,780,1244
3404-001,2015,11,13,22,244,188,432,780
3404-001,2015,11,13,23,132,134,266,432
3404-001,2015,11,13,24,68,127,195,266
3404-001,2015,11,14,1,51,76,127,195
3404-001,2015,11,14,2,40,51,91,127
3404-001,2015,11,14,3,38,43,81,91
3404-001,2015,11,14,4,16,25,41,81
3404-001,2015,11,14,5,22,57,79,41
3404-001,2015,11,14,6,51,115,166,79
3404-001,2015,11,14,7,47,259,306,166
3404-001,2015,11,14,8,246,607,853,306
3404-001,2015,11,14,9,483,660,1143,853
3404-001,2015,11,14,10,437,522,959,1143
3404-001,2015,11,14,11,553,578,1131,959
3404-001,2015,11,14,12,559,537,1096,1131
3404-001,2015,11,14,13,450,534,984,1096
3404-001,2015,11,14,14,424,502,926,984
3404-001,2015,11,14,15,557,527,1084,926
3404-001,2015,11,14,16,623,487,1110,1084
3404-001,2015,11,14,17,660,480,1140,1110
3404-001,2015,11,14,18,772,470,1242,1140
3404-001,2015,11,14,19,483,413,896,1242
3404-001,2015,11,14,20,207,255,462,896
3404-001,2015,11,14,21,150,191,341,462
3404-001,2015,11,14,22,101,158,259,341
3404-001,2015,11,14,23,40,114,154,259
3404-001,2015,11,14,24,33,75,108,154
3404-001,2015,11,15,1,33,53,86,108
3404-001,2015,11,15,2,27,43,70,86
3404-001,2015,11,15,3,14,29,43,70
3404-001,2015,11,15,4,9,32,41,43
3404-001,2015,11,15,5,16,47,63,41
3404-001,2015,11,15,6,36,87,123,63
3404-001,2015,11,15,7,51,191,242,123
3404-001,2015,11,15,8,117,252,369,242
3404-001,2015,11,15,9,161,312,473,369
3404-001,2015,11,15,10,235,328,563,473
3404-001,2015,11,15,11,239,382,621,563
3404-001,2015,11,15,12,259,349,608,621
3404-001,2015,11,15,13,301,359,660,608
3404-001,2015,11,15,14,285,410,695,660
3404-001,2015,11,15,15,369,402,771,695
3404-001,2015,11,15,16,472,423,895,771
3404-001,2015,11,15,17,974,433,1407,895
3404-001,2015,11,15,18,990,403,1393,1407
3404-001,2015,11,15,19,792,353,1145,1393
3404-001,2015,11,15,20,719,299,1018,1145
3404-001,2015,11,15,21,250,239,489,1018
3404-001,2015,11,15,22,128,256,384,489
3404-001,2015,11,15,23,75,184,259,384
3404-001,2015,11,15,24,33,125,158,259
3404-001,2015,11,16,1,8,66,74,158
3404-001,2015,11,16,2,6,36,42,74
3404-001,2015,11,16,3,4,37,41,42
3404-001,2015,11,16,4,5,38,43,41
3404-001,2015,11,16,5,12,56,68,43
3404-001,2015,11,16,6,44,228,272,68
3404-001,2015,11,16,7,92,639,731,272
3404-001,2015,11,16,8,230,1911,2141,731
3404-001,2015,11,16,9,343,1508,1851,2141
3404-001,2015,11,16,10,414,766,1180,1851
3404-001,2015,11,16,11,714,659,1373,1180
3404-001,2015,11,16,12,686,652,1338,1373
3404-001,2015,11,16,13,603,570,1173,1338
3404-001,2015,11,16,14,625,668,1293,1173
3404-001,2015,11,16,15,800,717,1517,1293
3404-001,2015,11,16,16,829,653,1482,1517
3404-001,2015,11,16,17,844,623,1467,1482
3404-001,2015,11,16,18,1168,558,1726,1467
3404-001,2015,11,16,19,1045,471,1516,1726
3404-001,2015,11,16,20,741,403,1144,1516
3404-001,2015,11,16,21,678,247,925,1144
3404-001,2015,11,16,22,366,194,560,925
3404-001,2015,11,16,23,193,131,324,560
3404-001,2015,11,16,24,119,87,206,324
3404-001,2015,11,17,1,81,66,147,206
3404-001,2015,11,17,2,57,44,101,147
3404-001,2015,11,17,3,37,42,79,101
3404-001,2015,11,17,4,33,32,65,79
3404-001,2015,11,17,5,57,62,119,65
3404-001,2015,11,17,6,135,160,295,119
3404-001,2015,11,17,7,191,509,700,295
3404-001,2015,11,17,8,489,1707,2196,700
3404-001,2015,11,17,9,750,1374,2124,2196
3404-001,2015,11,17,10,696,785,1481,2124
3404-001,2015,11,17,11,687,697,1384,1481
3404-001,2015,11,17,12,716,699,1415,1384
3404-001,2015,11,17,13,576,622,1198,1415
3404-001,2015,11,17,14,630,684,1314,1198
3404-001,2015,11,17,15,792,731,1523,1314
3404-001,2015,11,17,16,810,632,1442,1523
3404-001,2015,11,17,17,865,618,1483,1442
3404-001,2015,11,17,18,1167,611,1778,1483
3404-001,2015,11,17,19,1074,497,1571,1778
3404-001,2015,11,17,20,748,415,1163,1571
3404-001,2015,11,17,21,728,264,992,1163
3404-001,2015,11,17,22,401,206,607,992
3404-001,2015,11,17,23,243,169,412,607
3404-001,2015,11,17,24,133,121,254,412
3404-001,2015,11,18,1,82,68,150,254
3404-001,2015,11,18,2,62,57,119,150
3404-001,2015,11,18,3,56,41,97,119
3404-001,2015,11,18,4,46,30,76,97
3404-001,2015,11,18,5,63,72,135,76
3404-001,2015,11,18,6,134,171,305,135
3404-001,2015,11,18,7,194,535,729,305
3404-001,2015,11,18,8,460,1697,2157,729
3404-001,2015,11,18,9,785,1366,2151,2157
3404-001,2015,11,18,10,632,739,1371,2151
3404-001,2015,11,18,11,710,706,1416,1371
3404-001,2015,11,18,12,761,689,1450,1416
3404-001,2015,11,18,13,622,600,1222,1450
3404-001,2015,11,18,14,673,689,1362,1222
3404-001,2015,11,18,15,749,714,1463,1362
3404-001,2015,11,18,16,819,617,1436,1463
3404-001,2015,11,18,17,883,558,1441,1436
3404-001,2015,11,18,18,1260,566,1826,1441
3404-001,2015,11,18,19,1094,509,1603,1826
3404-001,2015,11,18,20,678,357,1035,1603
3404-001,2015,11,18,21,572,243,815,1035
3404-001,2015,11,18,22,356,186,542,815
3404-001,2015,11,18,23,201,133,334,542
3404-001,2015,11,18,24,128,92,220,334
3404-001,2015,11,19,1,90,82,172,220
3404-001,2015,11,19,2,63,59,122,172
3404-001,2015,11,19,3,41,48,89,122
3404-001,2015,11,19,4,42,37,79,89
3404-001,2015,11,19,5,62,66,128,79
3404-001,2015,11,19,6,119,176,295,128
3404-001,2015,11,19,7,193,553,746,295
3404-001,2015,11,19,8,493,1671,2164,746
3404-001,2015,11,19,9,778,1403,2181,2164
3404-001,2015,11,19,10,660,744,1404,2181
3404-001,2015,11,19,11,721,825,1546,1404
3404-001,2015,11,19,12,705,735,1440,1546
3404-001,2015,11,19,13,601,566,1167,1440
3404-001,2015,11,19,14,683,665,1348,1167
3404-001,2015,11,19,15,787,718,1505,1348
3404-001,2015,11,19,16,813,620,1433,1505
3404-001,2015,11,19,17,852,615,1467,1433
3404-001,2015,11,19,18,1267,643,1910,1467
3404-001,2015,11,19,19,1006,495,1501,1910
3404-001,2015,11,19,20,730,404,1134,1501
3404-001,2015,11,19,21,670,264,934,1134
3404-001,2015,11,19,22,350,242,592,934
3404-001,2015,11,19,23,215,149,364,592
3404-001,2015,11,19,24,165,99,264,364
3404-001,2015,11,20,1,99,70,169,264
3404-001,2015,11,20,2,67,47,114,169
3404-001,2015,11,20,3,52,47,99,114
3404-001,2015,11,20,4,45,36,81,99
3404-001,2015,11,20,5,57,84,141,81
3404-001,2015,11,20,6,117,174,291,141
3404-001,2015,11,20,7,225,522,747,291
3404-001,2015,11,20,8,495,1733,2228,747
3404-001,2015,11,20,9,765,1393,2158,2228
3404-001,2015,11,20,10,656,767,1423,2158
3404-001,2015,11,20,11,770,740,1510,1423
3404-001,2015,11,20,12,649,720,1369,1510
3404-001,2015,11,20,13,631,593,1224,1369
3404-001,2015,11,20,14,660,625,1285,1224
3404-001,2015,11,20,15,819,705,1524,1285
3404-001,2015,11,20,16,897,684,1581,1524
3404-001,2015,11,20,17,1003,677,1680,1581
3404-001,2015,11,20,18,1536,675,2211,1680
3404-001,2015,11,20,19,1402,583,1985,2211
3404-001,2015,11,20,20,847,487,1334,1985
3404-001,2015,11,20,21,651,323,974,1334
3404-001,2015,11,20,22,401,221,622,974
3404-001,2015,11,20,23,200,172,372,622
3404-001,2015,11,20,24,132,115,247,372
3404-001,2015,11,21,1,102,89,191,247
3404-001,2015,11,21,2,67,65,132,191
3404-001,2015,11,21,3,59,35,94,132
3404-001,2015,11,21,4,34,43,77,94
3404-001,2015,11,21,5,54,52,106,77
3404-001,2015,11,21,6,111,143,254,106
3404-001,2015,11,21,7,192,385,577,254
3404-001,2015,11,21,8,382,709,1091,577
3404-001,2015,11,21,9,569,761,1330,1091
3404-001,2015,11,21,10,528,618,1146,1330
3404-001,2015,11,21,11,552,671,1223,1146
3404-001,2015,11,21,12,571,590,1161,1223
3404-001,2015,11,21,13,533,555,1088,1161
3404-001,2015,11,21,14,463,605,1068,1088
3404-001,2015,11,21,15,645,577,1222,1068
3404-001,2015,11,21,16,654,589,1243,1222
3404-001,2015,11,21,17,742,521,1263,1243
3404-001,2015,11,21,18,1123,542,1665,1263
3404-001,2015,11,21,19,870,462,1332,1665
3404-001,2015,11,21,20,431,353,784,1332
3404-001,2015,11,21,21,299,219,518,784
3404-001,2015,11,21,22,177,186,363,518
3404-001,2015,11,21,23,120,107,227,363
3404-001,2015,11,21,24,94,95,189,227
3404-001,2015,11,22,1,49,42,91,189
3404-001,2015,11,22,2,42,36,78,91
3404-001,2015,11,22,3,30,35,65,78
3404-001,2015,11,22,4,31,30,61,65
3404-001,2015,11,22,5,30,42,72,61
3404-001,2015,11,22,6,67,91,158,72
3404-001,2015,11,22,7,90,198,288,158
3404-001,2015,11,22,8,155,294,449,288
3404-001,2015,11,22,9,249,326,575,449
3404-001,2015,11,22,10,260,308,568,575
3404-001,2015,11,22,11,286,342,628,568
3404-001,2015,11,22,12,322,349,671,628
3404-001,2015,11,22,13,329,405,734,671
3404-001,2015,11,22,14,405,376,781,734
3404-001,2015,11,22,15,650,419,1069,781
3404-001,2015,11,22,16,859,373,1232,1069
3404-001,2015,11,22,17,996,352,1348,1232
3404-001,2015,11,22,18,948,397,1345,1348
3404-001,2015,11,22,19,830,315,1145,1345
3404-001,2015,11,22,20,611,330,941,1145
3404-001,2015,11,22,21,507,247,754,941
3404-001,2015,11,22,22,343,223,566,754
3404-001,2015,11,22,23,178,197,375,566
3404-001,2015,11,22,24,79,150,229,375
3404-001,2015,11,23,1,54,81,135,229
3404-001,2015,11,23,2,40,51,91,135
3404-001,2015,11,23,3,27,34,61,91
3404-001,2015,11,23,4,35,29,64,61
3404-001,2015,11,23,5,54,63,117,64
3404-001,2015,11,23,6,94,183,277,117
3404-001,2015,11,23,7,178,536,714,277
3404-001,2015,11,23,8,469,1759,2228,714
3404-001,2015,11,23,9,706,1473,2179,2228
3404-001,2015,11,23,10,679,672,1351,2179
3404-001,2015,11,23,11,646,770,1416,1351
3404-001,2015,11,23,12,677,693,1370,1416
3404-001,2015,11,23,13,600,607,1207,1370
3404-001,2015,11,23,14,600,682,1282,1207
3404-001,2015,11,23,15,752,688,1440,1282
3404-001,2015,11,23,16,751,692,1443,1440
3404-001,2015,11,23,17,896,612,1508,1443
3404-001,2015,11,23,18,1184,597,1781,1508
3404-001,2015,11,23,19,1013,486,1499,1781
3404-001,2015,11,23,20,730,404,1134,1499
3404-001,2015,11,23,21,706,252,958,1134
3404-001,2015,11,23,22,384,204,588,958
3404-001,2015,11,23,23,224,152,376,588
3404-001,2015,11,23,24,120,110,230,376
3404-001,2015,11,24,1,76,59,135,230
3404-001,2015,11,24,2,53,45,98,135
3404-001,2015,11,24,3,45,40,85,98
3404-001,2015,11,24,4,43,47,90,85
3404-001,2015,11,24,5,50,88,138,90
3404-001,2015,11,24,6,129,200,329,138
3404-001,2015,11,24,7,227,519,746,329
3404-001,2015,11,24,8,530,1781,2311,746
3404-001,2015,11,24,9,750,1429,2179,2311
3404-001,2015,11,24,10,704,765,1469,2179
3404-001,2015,11,24,11,788,769,1557,1469
3404-001,2015,11,24,12,711,750,1461,1557
3404-001,2015,11,24,13,577,635,1212,1461
3404-001,2015,11,24,14,723,673,1396,1212
3404-001,2015,11,24,15,817,700,1517,1396
3404-001,2015,11,24,16,796,702,1498,1517
3404-001,2015,11,24,17,879,590,1469,1498
3404-001,2015,11,24,18,1274,640,1914,1469
3404-001,2015,11,24,19,1162,534,1696,1914
3404-001,2015,11,24,20,738,392,1130,1696
3404-001,2015,11,24,21,670,251,921,1130
3404-001,2015,11,24,22,388,209,597,921
3404-001,2015,11,24,23,222,155,377,597
3404-001,2015,11,24,24,106,103,209,377
3404-001,2015,11,25,1,74,68,142,209
3404-001,2015,11,25,2,65,39,104,142
3404-001,2015,11,25,3,36,45,81,104
3404-001,2015,11,25,4,43,32,75,81
3404-001,2015,11,25,5,52,62,114,75
3404-001,2015,11,25,6,103,148,251,114
3404-001,2015,11,25,7,171,457,628,251
3404-001,2015,11,25,8,501,1590,2091,628
3404-001,2015,11,25,9,754,1372,2126,2091
3404-001,2015,11,25,10,608,691,1299,2126
3404-001,2015,11,25,11,662,671,1333,1299
3404-001,2015,11,25,12,668,708,1376,1333
3404-001,2015,11,25,13,627,520,1147,1376
3404-001,2015,11,25,14,635,670,1305,1147
3404-001,2015,11,25,15,827,702,1529,1305
3404-001,2015,11,25,16,814,662,1476,1529
3404-001,2015,11,25,17,872,593,1465,1476
3404-001,2015,11,25,18,1230,586,1816,1465
3404-001,2015,11,25,19,1113,475,1588,1816
3404-001,2015,11,25,20,685,367,1052,1588
3404-001,2015,11,25,21,616,259,875,1052
3404-001,2015,11,25,22,332,208,540,875
3404-001,2015,11,25,23,174,143,317,540
3404-001,2015,11,25,24,108,103,211,317
3404-001,2015,11,26,1,87,66,153,211
3404-001,2015,11,26,2,48,58,106,153
3404-001,2015,11,26,3,30,35,65,106
3404-001,2015,11,26,4,39,40,79,65
3404-001,2015,11,26,5,46,68,114,79
3404-001,2015,11,26,6,81,67,148,114
3404-001,2015,11,26,7,75,132,207,148
3404-001,2015,11,26,8,258,451,709,207
3404-001,2015,11,26,9,403,1140,1543,709
3404-001,2015,11,26,10,555,1006,1561,1543
3404-001,2015,11,26,11,470,693,1163,1561
3404-001,2015,11,26,12,555,549,1104,1163
3404-001,2015,11,26,13,513,435,948,1104
3404-001,2015,11,26,14,528,503,1031,948
3404-001,2015,11,26,15,708,592,1300,1031
3404-001,2015,11,26,16,720,562,1282,1300
3404-001,2015,11,26,17,726,506,1232,1282
3404-001,2015,11,26,18,1042,462,1504,1232
3404-001,2015,11,26,19,897,387,1284,1504
3404-001,2015,11,26,20,556,282,838,1284
3404-001,2015,11,26,21,492,202,694,838
3404-001,2015,11,26,22,277,61,338,694
3404-001,2015,11,26,23,139,52,191,338
3404-001,2015,11,26,24,72,20,92,191
3404-001,2015,11,27,1,77,46,123,92
3404-001,2015,11,27,2,55,33,88,123
3404-001,2015,11,27,3,26,27,53,88
3404-001,2015,11,27,4,39,28,67,53
3404-001,2015,11,27,5,44,27,71,67
3404-001,2015,11,27,6,76,113,189,71
3404-001,2015,11,27,7,118,403,521,189
3404-001,2015,11,27,8,400,1521,1921,521
3404-001,2015,11,27,9,589,1185,1774,1921
3404-001,2015,11,27,10,626,672,1298,1774
3404-001,2015,11,27,11,665,655,1320,1298
3404-001,2015,11,27,12,672,596,1268,1320
3404-001,2015,11,27,13,612,523,1135,1268
3404-001,2015,11,27,14,697,502,1199,1135
3404-001,2015,11,27,15,834,624,1458,1199
3404-001,2015,11,27,16,818,627,1445,1458
3404-001,2015,11,27,17,870,589,1459,1445
3404-001,2015,11,27,18,1284,485,1769,1459
3404-001,2015,11,27,19,1311,499,1810,1769
3404-001,2015,11,27,20,800,433,1233,1810
3404-001,2015,11,27,21,551,280,831,1233
3404-001,2015,11,27,22,340,141,481,831
3404-001,2015,11,27,23,163,125,288,481
3404-001,2015,11,27,24,115,86,201,288
3404-001,2015,11,28,1,70,56,126,201
3404-001,2015,11,28,2,60,32,92,126
3404-001,2015,11,28,3,40,28,68,92
3404-001,2015,11,28,4,52,51,103,68
3404-001,2015,11,28,5,68,42,110,103
3404-001,2015,11,28,6,72,120,192,110
3404-001,2015,11,28,7,149,277,426,192
3404-001,2015,11,28,8,313,653,966,426
3404-001,2015,11,28,9,490,622,1112,966
3404-001,2015,11,28,10,512,610,1122,1112
3404-001,2015,11,28,11,549,556,1105,1122
3404-001,2015,11,28,12,519,565,1084,1105
3404-001,2015,11,28,13,494,539,1033,1084
3404-001,2015,11,28,14,479,474,953,1033
3404-001,2015,11,28,15,551,554,1105,953
3404-001,2015,11,28,16,641,542,1183,1105
3404-001,2015,11,28,17,644,492,1136,1183
3404-001,2015,11,28,18,863,549,1412,1136
3404-001,2015,11,28,19,570,343,913,1412
3404-001,2015,11,28,20,316,249,565,913
3404-001,2015,11,28,21,261,172,433,565
3404-001,2015,11,28,22,156,138,294,433
3404-001,2015,11,28,23,102,94,196,294
3404-001,2015,11,28,24,98,60,158,196
3404-001,2015,11,29,1,68,47,115,158
3404-001,2015,11,29,2,33,47,80,115
3404-001,2015,11,29,3,25,32,57,80
3404-001,2015,11,29,4,38,25,63,57
3404-001,2015,11,29,5,27,32,59,63
3404-001,2015,11,29,6,54,70,124,59
3404-001,2015,11,29,7,85,146,231,124
3404-001,2015,11,29,8,157,188,345,231
3404-001,2015,11,29,9,206,226,432,345
3404-001,2015,11,29,10,242,228,470,432
3404-001,2015,11,29,11,280,263,543,470
3404-001,2015,11,29,12,311,315,626,543
3404-001,2015,11,29,13,344,323,667,626
3404-001,2015,11,29,14,365,364,729,667
3404-001,2015,11,29,15,463,367,830,729
3404-001,2015,11,29,16,650,372,1022,830
3404-001,2015,11,29,17,781,299,1080,1022
3404-001,2015,11,29,18,908,304,1212,1080
3404-001,2015,11,29,19,587,268,855,1212
3404-001,2015,11,29,20,407,245,652,855
3404-001,2015,11,29,21,295,252,547,652
3404-001,2015,11,29,22,177,205,382,547
3404-001,2015,11,29,23,107,186,293,382
3404-001,2015,11,29,24,67,99,166,293
3404-001,2015,11,30,1,48,87,135,166
3404-001,2015,11,30,2,30,42,72,135
3404-001,2015,11,30,3,18,21,39,72
3404-001,2015,11,30,4,31,28,59,39
3404-001,2015,11,30,5,39,56,95,59
3404-001,2015,11,30,6,106,206,312,95
3404-001,2015,11,30,7,197,588,785,312
3404-001,2015,11,30,8,495,1835,2330,785
3404-001,2015,11,30,9,665,1490,2155,2330
3404-001,2015,11,30,10,604,719,1323,2155
3404-001,2015,11,30,11,656,714,1370,1323
3404-001,2015,11,30,12,647,672,1319,1370
3404-001,2015,11,30,13,574,588,1162,1319
3404-001,2015,11,30,14,609,675,1284,1162
3404-001,2015,11,30,15,782,702,1484,1284
3404-001,2015,11,30,16,823,672,1495,1484
3404-001,2015,11,30,17,906,618,1524,1495
3404-001,2015,11,30,18,1172,578,1750,1524
3404-001,2015,11,30,19,1011,478,1489,1750
3404-001,2015,11,30,20,577,404,981,1489
3404-001,2015,11,30,21,630,527,1157,981
3404-001,2015,11,30,22,375,348,723,1157
3404-001,2015,11,30,23,238,245,483,723
3404-001,2015,11,30,24,128,160,288,483
3404-001,2015,12,1,1,91,57,148,288
3404-001,2015,12,1,2,45,53,98,148
3404-001,2015,12,1,3,43,47,90,98
3404-001,2015,12,1,4,31,43,74,90
3404-001,2015,12,1,5,61,55,116,74
3404-001,2015,12,1,6,100,187,287,116
3404-001,2015,12,1,7,217,498,715,287
3404-001,2015,12,1,8,533,1652,2185,715
3404-001,2015,12,1,9,769,1408,2177,2185
3404-001,2015,12,1,10,699,799,1498,2177
3404-001,2015,12,1,11,765,703,1468,1498
3404-001,2015,12,1,12,706,717,1423,1468
3404-001,2015,12,1,13,628,604,1232,1423
3404-001,2015,12,1,14,691,684,1375,1232
3404-001,2015,12,1,15,764,727,1491,1375
3404-001,2015,12,1,16,878,708,1586,1491
3404-001,2015,12,1,17,904,619,1523,1586
3404-001,2015,12,1,18,1232,645,1877,1523
3404-001,2015,12,1,19,1032,545,1577,1877
3404-001,2015,12,1,20,748,423,1171,1577
3404-001,2015,12,1,21,649,283,932,1171
3404-001,2015,12,1,22,356,215,571,932
3404-001,2015,12,1,23,229,132,361,571
3404-001,2015,12,1,24,110,98,208,361
3404-001,2015,12,2,1,82,77,159,208
3404-001,2015,12,2,2,67,55,122,159
3404-001,2015,12,2,3,40,46,86,122
3404-001,2015,12,2,4,38,44,82,86
3404-001,2015,12,2,5,65,65,130,82
3404-001,2015,12,2,6,106,173,279,130
3404-001,2015,12,2,7,191,453,644,279
3404-001,2015,12,2,8,499,1694,2193,644
3404-001,2015,12,2,9,707,1317,2024,2193
3404-001,2015,12,2,10,635,529,1164,2024
3404-001,2015,12,2,11,684,635,1319,1164
3404-001,2015,12,2,12,631,633,1264,1319
3404-001,2015,12,2,13,569,569,1138,1264
3404-001,2015,12,2,14,633,586,1219,1138
3404-001,2015,12,2,15,716,658,1374,1219
3404-001,2015,12,2,16,759,653,1412,1374
3404-001,2015,12,2,17,740,578,1318,1412
3404-001,2015,12,2,18,1181,557,1738,1318
3404-001,2015,12,2,19,1001,421,1422,1738
3404-001,2015,12,2,20,683,343,1026,1422
3404-001,2015,12,2,21,565,268,833,1026
3404-001,2015,12,2,22,349,203,552,833
3404-001,2015,12,2,23,185,124,309,552
3404-001,2015,12,2,24,126,116,242,309
3404-001,2015,12,3,1,72,63,135,242
3404-001,2015,12,3,2,68,59,127,135
3404-001,2015,12,3,3,42,42,84,127
3404-001,2015,12,3,4,51,36,87,84
3404-001,2015,12,3,5,46,39,85,87
3404-001,2015,12,3,6,84,110,194,85
3404-001,2015,12,3,7,141,266,407,194
3404-001,2015,12,3,8,399,1033,1432,407
3404-001,2015,12,3,9,658,1031,1689,1432
3404-001,2015,12,3,10,560,589,1149,1689
3404-001,2015,12,3,11,579,656,1235,1149
3404-001,2015,12,3,12,588,608,1196,1235
3404-001,2015,12,3,13,537,489,1026,1196
3404-001,2015,12,3,14,573,594,1167,1026
3404-001,2015,12,3,15,677,522,1199,1167
3404-001,2015,12,3,16,699,540,1239,1199
3404-001,2015,12,3,17,547,348,895,1239
3404-001,2015,12,3,18,714,386,1100,895
3404-001,2015,12,3,19,1036,304,1340,1100
3404-001,2015,12,3,20,531,262,793,1340
3404-001,2015,12,3,21,464,276,740,793
3404-001,2015,12,3,22,266,173,439,740
3404-001,2015,12,3,23,175,101,276,439
3404-001,2015,12,3,24,89,85,174,276
3404-001,2015,12,4,1,69,40,109,174
3404-001,2015,12,4,2,47,48,95,109
3404-001,2015,12,4,3,48,36,84,95
3404-001,2015,12,4,4,37,50,87,84
3404-001,2015,12,4,5,55,58,113,87
3404-001,2015,12,4,6,69,152,221,113
3404-001,2015,12,4,7,152,393,545,221
3404-001,2015,12,4,8,368,1211,1579,545
3404-001,2015,12,4,9,550,684,1234,1579
3404-001,2015,12,4,10,568,393,961,1234
3404-001,2015,12,4,11,635,427,1062,961
3404-001,2015,12,4,12,686,382,1068,1062
3404-001,2015,12,4,13,670,410,1080,1068
3404-001,2015,12,4,14,654,403,1057,1080
3404-001,2015,12,4,15,778,400,1178,1057
3404-001,2015,12,4,16,913,387,1300,1178
3404-001,2015,12,4,17,984,356,1340,1300
3404-001,2015,12,4,18,1284,337,1621,1340
3404-001,2015,12,4,19,1247,378,1625,1621
3404-001,2015,12,4,20,840,281,1121,1625
3404-001,2015,12,4,21,647,154,801,1121
3404-001,2015,12,4,22,374,119,493,801
3404-001,2015,12,4,23,203,75,278,493
3404-001,2015,12,4,24,115,58,173,278
3404-001,2015,12,5,1,95,41,136,173
3404-001,2015,12,5,2,75,30,105,136
3404-001,2015,12,5,3,45,36,81,105
3404-001,2015,12,5,4,42,37,79,81
3404-001,2015,12,5,5,67,47,114,79
3404-001,2015,12,5,6,107,86,193,114
3404-001,2015,12,5,7,157,201,358,193
3404-001,2015,12,5,8,302,378,680,358
3404-001,2015,12,5,9,550,382,932,680
3404-001,2015,12,5,10,502,348,850,932
3404-001,2015,12,5,11,491,403,894,850
3404-001,2015,12,5,12,566,413,979,894
3404-001,2015,12,5,13,581,474,1055,979
3404-001,2015,12,5,14,623,442,1065,1055
3404-001,2015,12,5,15,578,346,924,1065
3404-001,2015,12,5,16,628,320,948,924
3404-001,2015,12,5,17,703,334,1037,948
3404-001,2015,12,5,18,977,325,1302,1037
3404-001,2015,12,5,19,645,337,982,1302
3404-001,2015,12,5,20,328,318,646,982
3404-001,2015,12,5,21,239,216,455,646
3404-001,2015,12,5,22,160,158,318,455
3404-001,2015,12,5,23,102,109,211,318
3404-001,2015,12,5,24,83,78,161,211
3404-001,2015,12,6,1,52,44,96,161
3404-001,2015,12,6,2,55,40,95,96
3404-001,2015,12,6,3,43,40,83,95
3404-001,2015,12,6,4,23,36,59,83
3404-001,2015,12,6,5,30,20,50,59
3404-001,2015,12,6,6,43,78,121,50
3404-001,2015,12,6,7,81,170,251,121
3404-001,2015,12,6,8,168,244,412,251
3404-001,2015,12,6,9,270,269,539,412
3404-001,2015,12,6,10,232,252,484,539
3404-001,2015,12,6,11,305,305,610,484
3404-001,2015,12,6,12,332,363,695,610
3404-001,2015,12,6,13,351,340,691,695
3404-001,2015,12,6,14,338,414,752,691
3404-001,2015,12,6,15,435,417,852,752
3404-001,2015,12,6,16,510,368,878,852
3404-001,2015,12,6,17,641,389,1030,878
3404-001,2015,12,6,18,802,384,1186,1030
3404-001,2015,12,6,19,501,321,822,1186
3404-001,2015,12,6,20,334,301,635,822
3404-001,2015,12,6,21,208,248,456,635
3404-001,2015,12,6,22,191,256,447,456
3404-001,2015,12,6,23,107,151,258,447
3404-001,2015,12,6,24,74,106,180,258
3404-001,2015,12,7,1,49,99,148,180
3404-001,2015,12,7,2,33,64,97,148
3404-001,2015,12,7,3,38,45,83,97
3404-001,2015,12,7,4,36,58,94,83
3404-001,2015,12,7,5,61,107,168,94
3404-001,2015,12,7,6,117,234,351,168
3404-001,2015,12,7,7,213,655,868,351
3404-001,2015,12,7,8,522,1795,2317,868
3404-001,2015,12,7,9,677,1549,2226,2317
3404-001,2015,12,7,10,628,774,1402,2226
3404-001,2015,12,7,11,675,734,1409,1402
3404-001,2015,12,7,12,739,740,1479,1409
3404-001,2015,12,7,13,675,650,1325,1479
3404-001,2015,12,7,14,627,752,1379,1325
3404-001,2015,12,7,15,754,753,1507,1379
3404-001,2015,12,7,16,794,706,1500,1507
3404-001,2015,12,7,17,876,729,1605,1500
3404-001,2015,12,7,18,1287,622,1909,1605
3404-001,2015,12,7,19,1153,489,1642,1909
3404-001,2015,12,7,20,762,422,1184,1642
3404-001,2015,12,7,21,722,274,996,1184
3404-001,2015,12,7,22,349,217,566,996
3404-001,2015,12,7,23,229,150,379,566
3404-001,2015,12,7,24,135,108,243,379
3404-001,2015,12,8,1,83,82,165,243
3404-001,2015,12,8,2,50,60,110,165
3404-001,2015,12,8,3,37,39,76,110
3404-001,2015,12,8,4,50,69,119,76
3404-001,2015,12,8,5,76,120,196,119
3404-001,2015,12,8,6,134,228,362,196
3404-001,2015,12,8,7,257,574,831,362
3404-001,2015,12,8,8,474,1747,2221,831
3404-001,2015,12,8,9,765,1423,2188,2221
3404-001,2015,12,8,10,697,867,1564,2188
3404-001,2015,12,8,11,772,856,1628,1564
3404-001,2015,12,8,12,699,782,1481,1628
3404-001,2015,12,8,13,600,644,1244,1481
3404-001,2015,12,8,14,679,734,1413,1244
3404-001,2015,12,8,15,816,758,1574,1413
3404-001,2015,12,8,16,819,738,1557,1574
3404-001,2015,12,8,17,999,609,1608,1557
3404-001,2015,12,8,18,1295,606,1901,1608
3404-001,2015,12,8,19,1188,493,1681,1901
3404-001,2015,12,8,20,783,396,1179,1681
3404-001,2015,12,8,21,723,289,1012,1179
3404-001,2015,12,8,22,373,206,579,1012
3404-001,2015,12,8,23,220,160,380,579
3404-001,2015,12,8,24,127,104,231,380
3404-001,2015,12,9,1,71,85,156,231
3404-001,2015,12,9,2,54,66,120,156
3404-001,2015,12,9,3,57,55,112,120
3404-001,2015,12,9,4,39,90,129,112
3404-001,2015,12,9,5,80,100,180,129
3404-001,2015,12,9,6,139,244,383,180
3404-001,2015,12,9,7,248,625,873,383
3404-001,2015,12,9,8,510,1783,2293,873
3404-001,2015,12,9,9,774,1405,2179,2293
3404-001,2015,12,9,10,709,881,1590,2179
3404-001,2015,12,9,11,767,838,1605,1590
3404-001,2015,12,9,12,688,750,1438,1605
3404-001,2015,12,9,13,643,652,1295,1438
3404-001,2015,12,9,14,710,725,1435,1295
3404-001,2015,12,9,15,834,791,1625,1435
3404-001,2015,12,9,16,925,727,1652,1625
3404-001,2015,12,9,17,893,679,1572,1652
3404-001,2015,12,9,18,1516,619,2135,1572
3404-001,2015,12,9,19,1179,526,1705,2135
3404-001,2015,12,9,20,754,370,1124,1705
3404-001,2015,12,9,21,656,311,967,1124
3404-001,2015,12,9,22,341,208,549,967
3404-001,2015,12,9,23,201,163,364,549
3404-001,2015,12,9,24,136,109,245,364
3404-001,2015,12,10,1,92,90,182,245
3404-001,2015,12,10,2,59,58,117,182
3404-001,2015,12,10,3,44,62,106,117
3404-001,2015,12,10,4,67,79,146,106
3404-001,2015,12,10,5,84,100,184,146
3404-001,2015,12,10,6,118,247,365,184
3404-001,2015,12,10,7,245,590,835,365
3404-001,2015,12,10,8,485,1815,2300,835
3404-001,2015,12,10,9,783,1336,2119,2300
3404-001,2015,12,10,10,692,800,1492,2119
3404-001,2015,12,10,11,746,754,1500,1492
3404-001,2015,12,10,12,674,660,1334,1500
3404-001,2015,12,10,13,654,572,1226,1334
3404-001,2015,12,10,14,706,654,1360,1226
3404-001,2015,12,10,15,796,639,1435,1360
3404-001,2015,12,10,16,902,688,1590,1435
3404-001,2015,12,10,17,841,628,1469,1590
3404-001,2015,12,10,18,1222,599,1821,1469
3404-001,2015,12,10,19,1044,486,1530,1821
3404-001,2015,12,10,20,697,368,1065,1530
3404-001,2015,12,10,21,656,269,925,1065
3404-001,2015,12,10,22,323,184,507,925
3404-001,2015,12,10,23,201,155,356,507
3404-001,2015,12,10,24,128,145,273,356
3404-001,2015,12,11,1,90,89,179,273
3404-001,2015,12,11,2,87,59,146,179
3404-001,2015,12,11,3,45,64,109,146
3404-001,2015,12,11,4,49,66,115,109
3404-001,2015,12,11,5,85,77,162,115
3404-001,2015,12,11,6,139,227,366,162
3404-001,2015,12,11,7,232,600,832,366
3404-001,2015,12,11,8,536,1761,2297,832
3404-001,2015,12,11,9,767,1316,2083,2297
3404-001,2015,12,11,10,747,856,1603,2083
3404-001,2015,12,11,11,742,803,1545,1603
3404-001,2015,12,11,12,806,749,1555,1545
3404-001,2015,12,11,13,723,667,1390,1555
3404-001,2015,12,11,14,725,734,1459,1390
3404-001,2015,12,11,15,773,848,1621,1459
3404-001,2015,12,11,16,939,764,1703,1621
3404-001,2015,12,11,17,1034,651,1685,1703
3404-001,2015,12,11,18,1604,648,2252,1685
3404-001,2015,12,11,19,1449,592,2041,2252
3404-001,2015,12,11,20,899,449,1348,2041
3404-001,2015,12,11,21,658,324,982,1348
3404-001,2015,12,11,22,369,239,608,982
3404-001,2015,12,11,23,204,189,393,608
3404-001,2015,12,11,24,129,127,256,393
3404-001,2015,12,12,1,92,80,172,256
3404-001,2015,12,12,2,64,53,117,172
3404-001,2015,12,12,3,57,64,121,117
3404-001,2015,12,12,4,65,56,121,121
3404-001,2015,12,12,5,63,84,147,121
3404-001,2015,12,12,6,122,182,304,147
3404-001,2015,12,12,7,242,377,619,304
3404-001,2015,12,12,8,357,770,1127,619
3404-001,2015,12,12,9,563,691,1254,1127
3404-001,2015,12,12,10,545,583,1128,1254
3404-001,2015,12,12,11,575,637,1212,1128
3404-001,2015,12,12,12,569,525,1094,1212
3404-001,2015,12,12,13,575,568,1143,1094
3404-001,2015,12,12,14,575,561,1136,1143
3404-001,2015,12,12,15,623,544,1167,1136
3404-001,2015,12,12,16,675,554,1229,1167
3404-001,2015,12,12,17,744,499,1243,1229
3404-001,2015,12,12,18,1079,487,1566,1243
3404-001,2015,12,12,19,704,415,1119,1566
3404-001,2015,12,12,20,371,324,695,1119
3404-001,2015,12,12,21,234,259,493,695
3404-001,2015,12,12,22,162,178,340,493
3404-001,2015,12,12,23,123,124,247,340
3404-001,2015,12,12,24,92,95,187,247
3404-001,2015,12,13,1,73,90,163,187
3404-001,2015,12,13,2,62,47,109,163
3404-001,2015,12,13,3,47,47,94,109
3404-001,2015,12,13,4,35,38,73,94
3404-001,2015,12,13,5,40,46,86,73
3404-001,2015,12,13,6,64,86,150,86
3404-001,2015,12,13,7,90,184,274,150
3404-001,2015,12,13,8,189,270,459,274
3404-001,2015,12,13,9,245,288,533,459
3404-001,2015,12,13,10,271,295,566,533
3404-001,2015,12,13,11,341,345,686,566
3404-001,2015,12,13,12,354,345,699,686
3404-001,2015,12,13,13,349,399,748,699
3404-001,2015,12,13,14,375,442,817,748
3404-001,2015,12,13,15,463,438,901,817
3404-001,2015,12,13,16,467,450,917,901
3404-001,2015,12,13,17,596,391,987,917
3404-001,2015,12,13,18,694,366,1060,987
3404-001,2015,12,13,19,383,365,748,1060
3404-001,2015,12,13,20,288,303,591,748
3404-001,2015,12,13,21,204,241,445,591
3404-001,2015,12,13,22,158,235,393,445
3404-001,2015,12,13,23,98,165,263,393
3404-001,2015,12,13,24,66,111,177,263
3404-001,2015,12,14,1,43,64,107,177
3404-001,2015,12,14,2,32,51,83,107
3404-001,2015,12,14,3,31,43,74,83
3404-001,2015,12,14,4,39,54,93,74
3404-001,2015,12,14,5,56,97,153,93
3404-001,2015,12,14,6,121,270,391,153
3404-001,2015,12,14,7,256,709,965,391
3404-001,2015,12,14,8,531,1922,2453,965
3404-001,2015,12,14,9,702,1470,2172,2453
3404-001,2015,12,14,10,649,764,1413,2172
3404-001,2015,12,14,11,710,776,1486,1413
3404-001,2015,12,14,12,715,668,1383,1486
3404-001,2015,12,14,13,602,648,1250,1383
3404-001,2015,12,14,14,593,663,1256,1250
3404-001,2015,12,14,15,718,691,1409,1256
3404-001,2015,12,14,16,797,650,1447,1409
3404-001,2015,12,14,17,842,614,1456,1447
3404-001,2015,12,14,18,1200,553,1753,1456
3404-001,2015,12,14,19,1046,428,1474,1753
3404-001,2015,12,14,20,677,363,1040,1474
3404-001,2015,12,14,21,627,253,880,1040
3404-001,2015,12,14,22,370,195,565,880
3404-001,2015,12,14,23,225,149,374,565
3404-001,2015,12,14,24,130,94,224,374
3404-001,2015,12,15,1,79,76,155,224
3404-001,2015,12,15,2,51,68,119,155
3404-001,2015,12,15,3,51,66,117,119
3404-001,2015,12,15,4,50,81,131,117
3404-001,2015,12,15,5,82,84,166,131
3404-001,2015,12,15,6,122,220,342,166
3404-001,2015,12,15,7,232,576,808,342
3404-001,2015,12,15,8,528,1760,2288,808
3404-001,2015,12,15,9,795,1384,2179,2288
3404-001,2015,12,15,10,698,833,1531,2179
3404-001,2015,12,15,11,734,850,1584,1531
3404-001,2015,12,15,12,706,736,1442,1584
3404-001,2015,12,15,13,641,664,1305,1442
3404-001,2015,12,15,14,709,751,1460,1305
3404-001,2015,12,15,15,772,746,1518,1460
3404-001,2015,12,15,16,878,741,1619,1518
3404-001,2015,12,15,17,873,642,1515,1619
3404-001,2015,12,15,18,1288,652,1940,1515
3404-001,2015,12,15,19,1145,480,1625,1940
3404-001,2015,12,15,20,699,373,1072,1625
3404-001,2015,12,15,21,639,258,897,1072
3404-001,2015,12,15,22,414,223,637,897
3404-001,2015,12,15,23,204,156,360,637
3404-001,2015,12,15,24,129,131,260,360
3404-001,2015,12,16,1,111,92,203,260
3404-001,2015,12,16,2,70,60,130,203
3404-001,2015,12,16,3,43,66,109,130
3404-001,2015,12,16,4,62,66,128,109
3404-001,2015,12,16,5,65,85,150,128
3404-001,2015,12,16,6,119,214,333,150
3404-001,2015,12,16,7,234,405,639,333
3404-001,2015,12,16,8,492,1162,1654,639
3404-001,2015,12,16,9,786,860,1646,1654
3404-001,2015,12,16,10,650,465,1115,1646
3404-001,2015,12,16,11,726,478,1204,1115
3404-001,2015,12,16,12,696,829,1525,1204
3404-001,2015,12,16,13,620,967,1587,1525
3404-001,2015,12,16,14,679,665,1344,1587
3404-001,2015,12,16,15,784,684,1468,1344
3404-001,2015,12,16,16,824,647,1471,1468
3404-001,2015,12,16,17,870,597,1467,1471
3404-001,2015,12,16,18,1395,622,2017,1467
3404-001,2015,12,16,19,1085,512,1597,2017
3404-001,2015,12,16,20,612,373,985,1597
3404-001,2015,12,16,21,500,253,753,985
3404-001,2015,12,16,22,320,179,499,753
3404-001,2015,12,16,23,199,139,338,499
3404-001,2015,12,16,24,105,116,221,338
3404-001,2015,12,17,1,96,87,183,221
3404-001,2015,12,17,2,56,55,111,183
3404-001,2015,12,17,3,45,63,108,111
3404-001,2015,12,17,4,39,66,105,108
3404-001,2015,12,17,5,65,90,155,105
3404-001,2015,12,17,6,124,200,324,155
3404-001,2015,12,17,7,230,541,771,324
3404-001,2015,12,17,8,542,1810,2352,771
3404-001,2015,12,17,9,777,1322,2099,2352
3404-001,2015,12,17,10,663,818,1481,2099
3404-001,2015,12,17,11,736,801,1537,1481
3404-001,2015,12,17,12,744,713,1457,1537
3404-001,2015,12,17,13,675,655,1330,1457
3404-001,2015,12,17,14,669,714,1383,1330
3404-001,2015,12,17,15,760,756,1516,1383
3404-001,2015,12,17,16,864,701,1565,1516
3404-001,2015,12,17,17,938,641,1579,1565
3404-001,2015,12,17,18,1336,672,2008,1579
3404-001,2015,12,17,19,1085,518,1603,2008
3404-001,2015,12,17,20,708,391,1099,1603
3404-001,2015,12,17,21,649,261,910,1099
3404-001,2015,12,17,22,361,211,572,910
3404-001,2015,12,17,23,204,130,334,572
3404-001,2015,12,17,24,136,124,260,334
3404-001,2015,12,18,1,109,94,203,260
3404-001,2015,12,18,2,63,47,110,203
3404-001,2015,12,18,3,55,73,128,110
3404-001,2015,12,18,4,54,67,121,128
3404-001,2015,12,18,5,55,92,147,121
3404-001,2015,12,18,6,133,220,353,147
3404-001,2015,12,18,7,222,577,799,353
3404-001,2015,12,18,8,522,1742,2264,799
3404-001,2015,12,18,9,751,1388,2139,2264
3404-001,2015,12,18,10,633,782,1415,2139
3404-001,2015,12,18,11,758,815,1573,1415
3404-001,2015,12,18,12,755,730,1485,1573
3404-001,2015,12,18,13,711,672,1383,1485
3404-001,2015,12,18,14,686,642,1328,1383
3404-001,2015,12,18,15,846,738,1584,1328
3404-001,2015,12,18,16,898,739,1637,1584
3404-001,2015,12,18,17,1038,594,1632,1637
3404-001,2015,12,18,18,1558,619,2177,1632
3404-001,2015,12,18,19,1324,573,1897,2177
3404-001,2015,12,18,20,761,407,1168,1897
3404-001,2015,12,18,21,593,294,887,1168
3404-001,2015,12,18,22,347,213,560,887
3404-001,2015,12,18,23,218,157,375,560
3404-001,2015,12,18,24,109,115,224,375
3404-001,2015,12,19,1,101,88,189,224
3404-001,2015,12,19,2,60,56,116,189
3404-001,2015,12,19,3,44,42,86,116
3404-001,2015,12,19,4,50,39,89,86
3404-001,2015,12,19,5,49,64,113,89
3404-001,2015,12,19,6,84,137,221,113
3404-001,2015,12,19,7,162,333,495,221
3404-001,2015,12,19,8,291,684,975,495
3404-001,2015,12,19,9,480,654,1134,975
3404-001,2015,12,19,10,513,530,1043,1134
3404-001,2015,12,19,11,527,560,1087,1043
3404-001,2015,12,19,12,552,545,1097,1087
3404-001,2015,12,19,13,507,459,966,1097
3404-001,2015,12,19,14,493,520,1013,966
3404-001,2015,12,19,15,569,490,1059,1013
3404-001,2015,12,19,16,617,471,1088,1059
3404-001,2015,12,19,17,688,435,1123,1088
3404-001,2015,12,19,18,844,432,1276,1123
3404-001,2015,12,19,19,509,369,878,1276
3404-001,2015,12,19,20,292,289,581,878
3404-001,2015,12,19,21,212,171,383,581
3404-001,2015,12,19,22,151,137,288,383
3404-001,2015,12,19,23,99,107,206,288
3404-001,2015,12,19,24,85,101,186,206
3404-001,2015,12,20,1,66,51,117,186
3404-001,2015,12,20,2,51,29,80,117
3404-001,2015,12,20,3,39,24,63,80
3404-001,2015,12,20,4,33,25,58,63
3404-001,2015,12,20,5,30,37,67,58
3404-001,2015,12,20,6,50,49,99,67
3404-001,2015,12,20,7,74,151,225,99
3404-001,2015,12,20,8,148,259,407,225
3404-001,2015,12,20,9,210,219,429,407
3404-001,2015,12,20,10,235,258,493,429
3404-001,2015,12,20,11,306,324,630,493
3404-001,2015,12,20,12,311,319,630,630
3404-001,2015,12,20,13,295,344,639,630
3404-001,2015,12,20,14,303,349,652,639
3404-001,2015,12,20,15,375,355,730,652
3404-001,2015,12,20,16,442,346,788,730
3404-001,2015,12,20,17,473,325,798,788
3404-001,2015,12,20,18,515,383,898,798
3404-001,2015,12,20,19,320,310,630,898
3404-001,2015,12,20,20,256,275,531,630
3404-001,2015,12,20,21,203,219,422,531
3404-001,2015,12,20,22,141,193,334,422
3404-001,2015,12,20,23,100,157,257,334
3404-001,2015,12,20,24,80,112,192,257
3404-001,2015,12,21,1,52,74,126,192
3404-001,2015,12,21,2,39,34,73,126
3404-001,2015,12,21,3,39,42,81,73
3404-001,2015,12,21,4,27,41,68,81
3404-001,2015,12,21,5,40,53,93,68
3404-001,2015,12,21,6,101,219,320,93
3404-001,2015,12,21,7,206,610,816,320
3404-001,2015,12,21,8,473,1666,2139,816
3404-001,2015,12,21,9,701,1244,1945,2139
3404-001,2015,12,21,10,557,712,1269,1945
3404-001,2015,12,21,11,677,635,1312,1269
3404-001,2015,12,21,12,614,646,1260,1312
3404-001,2015,12,21,13,614,606,1220,1260
3404-001,2015,12,21,14,657,694,1351,1220
3404-001,2015,12,21,15,773,684,1457,1351
3404-001,2015,12,21,16,778,602,1380,1457
3404-001,2015,12,21,17,821,579,1400,1380
3404-001,2015,12,21,18,1170,538,1708,1400
3404-001,2015,12,21,19,1019,438,1457,1708
3404-001,2015,12,21,20,670,380,1050,1457
3404-001,2015,12,21,21,597,255,852,1050
3404-001,2015,12,21,22,370,191,561,852
3404-001,2015,12,21,23,194,120,314,561
3404-001,2015,12,21,24,123,104,227,314
3404-001,2015,12,22,1,72,62,134,227
3404-001,2015,12,22,2,58,52,110,134
3404-001,2015,12,22,3,39,43,82,110
3404-001,2015,12,22,4,36,57,93,82
3404-001,2015,12,22,5,59,75,134,93
3404-001,2015,12,22,6,117,192,309,134
3404-001,2015,12,22,7,212,540,752,309
3404-001,2015,12,22,8,470,1712,2182,752
3404-001,2015,12,22,9,766,1333,2099,2182
3404-001,2015,12,22,10,700,763,1463,2099
3404-001,2015,12,22,11,712,758,1470,1463
3404-001,2015,12,22,12,685,716,1401,1470
3404-001,2015,12,22,13,608,597,1205,1401
3404-001,2015,12,22,14,711,657,1368,1205
3404-001,2015,12,22,15,817,753,1570,1368
3404-001,2015,12,22,16,844,658,1502,1570
3404-001,2015,12,22,17,913,648,1561,1502
3404-001,2015,12,22,18,1212,623,1835,1561
3404-001,2015,12,22,19,1042,501,1543,1835
3404-001,2015,12,22,20,655,326,981,1543
3404-001,2015,12,22,21,591,244,835,981
3404-001,2015,12,22,22,377,209,586,835
3404-001,2015,12,22,23,194,139,333,586
3404-001,2015,12,22,24,108,108,216,333
3404-001,2015,12,23,1,92,86,178,216
3404-001,2015,12,23,2,62,52,114,178
3404-001,2015,12,23,3,34,59,93,114
3404-001,2015,12,23,4,42,42,84,93
3404-001,2015,12,23,5,68,78,146,84
3404-001,2015,12,23,6,99,178,277,146
3404-001,2015,12,23,7,182,505,687,277
3404-001,2015,12,23,8,478,1698,2176,687
3404-001,2015,12,23,9,751,1314,2065,2176
3404-001,2015,12,23,10,664,727,1391,2065
3404-001,2015,12,23,11,693,744,1437,1391
3404-001,2015,12,23,12,660,691,1351,1437
3404-001,2015,12,23,13,589,572,1161,1351
3404-001,2015,12,23,14,691,662,1353,1161
3404-001,2015,12,23,15,783,721,1504,1353
3404-001,2015,12,23,16,839,654,1493,1504
3404-001,2015,12,23,17,791,604,1395,1493
3404-001,2015,12,23,18,1332,603,1935,1395
3404-001,2015,12,23,19,1100,484,1584,1935
3404-001,2015,12,23,20,669,354,1023,1584
3404-001,2015,12,23,21,497,247,744,1023
3404-001,2015,12,23,22,334,197,531,744
3404-001,2015,12,23,23,201,144,345,531
3404-001,2015,12,23,24,136,105,241,345
3404-001,2015,12,24,1,91,98,189,241
3404-001,2015,12,24,2,70,65,135,189
3404-001,2015,12,24,3,64,42,106,135
3404-001,2015,12,24,4,52,45,97,106
3404-001,2015,12,24,5,62,54,116,97
3404-001,2015,12,24,6,102,172,274,116
3404-001,2015,12,24,7,190,531,721,274
3404-001,2015,12,24,8,454,1638,2092,721
3404-001,2015,12,24,9,717,1305,2022,2092
3404-001,2015,12,24,10,643,725,1368,2022
3404-001,2015,12,24,11,669,745,1414,1368
3404-001,2015,12,24,12,672,693,1365,1414
3404-001,2015,12,24,13,646,535,1181,1365
3404-001,2015,12,24,14,740,682,1422,1181
3404-001,2015,12,24,15,826,720,1546,1422
3404-001,2015,12,24,16,881,686,1567,1546
3404-001,2015,12,24,17,888,639,1527,1567
3404-001,2015,12,24,18,1608,624,2232,1527
3404-001,2015,12,24,19,1380,587,1967,2232
3404-001,2015,12,24,20,862,429,1291,1967
3404-001,2015,12,24,21,459,265,724,1291
3404-001,2015,12,24,22,310,203,513,724
3404-001,2015,12,24,23,191,146,337,513
3404-001,2015,12,24,24,112,93,205,337
3404-001,2015,12,25,1,86,74,160,205
3404-001,2015,12,25,2,58,58,116,160
3404-001,2015,12,25,3,43,30,73,116
3404-001,2015,12,25,4,36,44,80,73
3404-001,2015,12,25,5,53,56,109,80
3404-001,2015,12,25,6,57,122,179,109
3404-001,2015,12,25,7,159,234,393,179
3404-001,2015,12,25,8,252,477,729,393
3404-001,2015,12,25,9,337,416,753,729
3404-001,2015,12,25,10,339,342,681,753
3404-001,2015,12,25,11,391,411,802,681
3404-001,2015,12,25,12,407,414,821,802
3404-001,2015,12,25,13,380,457,837,821
3404-001,2015,12,25,14,396,457,853,837
3404-001,2015,12,25,15,463,459,922,853
3404-001,2015,12,25,16,480,419,899,922
3404-001,2015,12,25,17,579,369,948,899
3404-001,2015,12,25,18,682,344,1026,948
3404-001,2015,12,25,19,424,293,717,1026
3404-001,2015,12,25,20,251,208,459,717
3404-001,2015,12,25,21,208,161,369,459
3404-001,2015,12,25,22,128,127,255,369
3404-001,2015,12,25,23,94,94,188,255
3404-001,2015,12,25,24,59,73,132,188
3404-001,2015,12,26,1,48,58,106,132
3404-001,2015,12,26,2,37,36,73,106
3404-001,2015,12,26,3,37,24,61,73
3404-001,2015,12,26,4,15,23,38,61
3404-001,2015,12,26,5,38,39,77,38
3404-001,2015,12,26,6,61,104,165,77
3404-001,2015,12,26,7,116,208,324,165
3404-001,2015,12,26,8,221,461,682,324
3404-001,2015,12,26,9,322,417,739,682
3404-001,2015,12,26,10,358,394,752,739
3404-001,2015,12,26,11,390,411,801,752
3404-001,2015,12,26,12,391,415,806,801
3404-001,2015,12,26,13,369,441,810,806
3404-001,2015,12,26,14,423,445,868,810
3404-001,2015,12,26,15,523,402,925,868
3404-001,2015,12,26,16,536,436,972,925
3404-001,2015,12,26,17,651,397,1048,972
3404-001,2015,12,26,18,658,395,1053,1048
3404-001,2015,12,26,19,405,295,700,1053
3404-001,2015,12,26,20,252,225,477,700
3404-001,2015,12,26,21,173,172,345,477
3404-001,2015,12,26,22,112,112,224,345
3404-001,2015,12,26,23,86,105,191,224
3404-001,2015,12,26,24,65,75,140,191
3404-001,2015,12,27,1,56,58,114,140
3404-001,2015,12,27,2,31,30,61,114
3404-001,2015,12,27,3,29,30,59,61
3404-001,2015,12,27,4,32,17,49,59
3404-001,2015,12,27,5,28,23,51,49
3404-001,2015,12,27,6,36,55,91,51
3404-001,2015,12,27,7,46,104,150,91
3404-001,2015,12,27,8,100,239,339,150
3404-001,2015,12,27,9,172,216,388,339
3404-001,2015,12,27,10,208,233,441,388
3404-001,2015,12,27,11,239,282,521,441
3404-001,2015,12,27,12,259,320,579,521
3404-001,2015,12,27,13,307,316,623,579
3404-001,2015,12,27,14,295,309,604,623
3404-001,2015,12,27,15,408,333,741,604
3404-001,2015,12,27,16,425,351,776,741
3404-001,2015,12,27,17,461,295,756,776
3404-001,2015,12,27,18,497,315,812,756
3404-001,2015,12,27,19,289,291,580,812
3404-001,2015,12,27,20,208,266,474,580
3404-001,2015,12,27,21,183,228,411,474
3404-001,2015,12,27,22,126,196,322,411
3404-001,2015,12,27,23,89,145,234,322
3404-001,2015,12,27,24,74,90,164,234
3404-001,2015,12,28,1,38,65,103,164
3404-001,2015,12,28,2,30,36,66,103
3404-001,2015,12,28,3,15,40,55,66
3404-001,2015,12,28,4,25,25,50,55
3404-001,2015,12,28,5,43,68,111,50
3404-001,2015,12,28,6,86,208,294,111
3404-001,2015,12,28,7,221,596,817,294
3404-001,2015,12,28,8,436,1811,2247,817
3404-001,2015,12,28,9,678,1391,2069,2247
3404-001,2015,12,28,10,595,625,1220,2069
3404-001,2015,12,28,11,670,704,1374,1220
3404-001,2015,12,28,12,602,707,1309,1374
3404-001,2015,12,28,13,607,575,1182,1309
3404-001,2015,12,28,14,603,670,1273,1182
3404-001,2015,12,28,15,755,707,1462,1273
3404-001,2015,12,28,16,789,622,1411,1462
3404-001,2015,12,28,17,846,648,1494,1411
3404-001,2015,12,28,18,1186,566,1752,1494
3404-001,2015,12,28,19,973,506,1479,1752
3404-001,2015,12,28,20,734,321,1055,1479
3404-001,2015,12,28,21,623,248,871,1055
3404-001,2015,12,28,22,337,203,540,871
3404-001,2015,12,28,23,191,148,339,540
3404-001,2015,12,28,24,109,95,204,339
3404-001,2015,12,29,1,78,83,161,204
3404-001,2015,12,29,2,54,51,105,161
3404-001,2015,12,29,3,32,48,80,105
3404-001,2015,12,29,4,40,36,76,80
3404-001,2015,12,29,5,68,77,145,76
3404-001,2015,12,29,6,102,167,269,145
3404-001,2015,12,29,7,190,507,697,269
3404-001,2015,12,29,8,442,1638,2080,697
3404-001,2015,12,29,9,744,1342,2086,2080
3404-001,2015,12,29,10,661,698,1359,2086
3404-001,2015,12,29,11,706,725,1431,1359
3404-001,2015,12,29,12,670,660,1330,1431
3404-001,2015,12,29,13,617,581,1198,1330
3404-001,2015,12,29,14,650,666,1316,1198
3404-001,2015,12,29,15,819,729,1548,1316
3404-001,2015,12,29,16,809,638,1447,1548
3404-001,2015,12,29,17,845,581,1426,1447
3404-001,2015,12,29,18,1193,602,1795,1426
3404-001,2015,12,29,19,964,499,1463,1795
3404-001,2015,12,29,20,695,360,1055,1463
3404-001,2015,12,29,21,598,254,852,1055
3404-001,2015,12,29,22,347,194,541,852
3404-001,2015,12,29,23,190,140,330,541
3404-001,2015,12,29,24,132,123,255,330
3404-001,2015,12,30,1,91,75,166,255
3404-001,2015,12,30,2,57,53,110,166
3404-001,2015,12,30,3,35,42,77,110
3404-001,2015,12,30,4,33,39,72,77
3404-001,2015,12,30,5,67,77,144,72
3404-001,2015,12,30,6,113,156,269,144
3404-001,2015,12,30,7,215,468,683,269
3404-001,2015,12,30,8,446,1656,2102,683
3404-001,2015,12,30,9,729,1213,1942,2102
3404-001,2015,12,30,10,678,740,1418,1942
3404-001,2015,12,30,11,700,712,1412,1418
3404-001,2015,12,30,12,629,679,1308,1412
3404-001,2015,12,30,13,566,569,1135,1308
3404-001,2015,12,30,14,647,657,1304,1135
3404-001,2015,12,30,15,808,658,1466,1304
3404-001,2015,12,30,16,805,680,1485,1466
3404-001,2015,12,30,17,794,620,1414,1485
3404-001,2015,12,30,18,1315,598,1913,1414
3404-001,2015,12,30,19,1052,491,1543,1913
3404-001,2015,12,30,20,582,364,946,1543
3404-001,2015,12,30,21,494,238,732,946
3404-001,2015,12,30,22,359,188,547,732
3404-001,2015,12,30,23,205,134,339,547
3404-001,2015,12,30,24,134,91,225,339
3404-001,2015,12,31,1,108,53,161,225
3404-001,2015,12,31,2,59,35,94,161
3404-001,2015,12,31,3,40,17,57,94
3404-001,2015,12,31,4,50,25,75,57
3404-001,2015,12,31,5,58,29,87,75
3404-001,2015,12,31,6,84,96,180,87
3404-001,2015,12,31,7,158,689,847,180
3404-001,2015,12,31,8,377,1546,1923,847
3404-001,2015,12,31,9,606,1138,1744,1923
3404-001,2015,12,31,10,576,537,1113,1744
3404-001,2015,12,31,11,649,624,1273,1113
3404-001,2015,12,31,12,686,549,1235,1273
3404-001,2015,12,31,13,687,512,1199,1235
3404-001,2015,12,31,14,676,591,1267,1199
3404-001,2015,12,31,15,784,572,1356,1267
3404-001,2015,12,31,16,935,596,1531,1356
3404-001,2015,12,31,17,976,578,1554,1531
3404-001,2015,12,31,18,1286,557,1843,1554
3404-001,2015,12,31,19,905,474,1379,1843
3404-001,2015,12,31,20,526,354,880,1379
3404-001,2015,12,31,21,351,281,632,880
3404-001,2015,12,31,22,204,225,429,632
3404-001,2015,12,31,23,170,160,330,429
3404-001,2015,12,31,24,88,102,190,330
3404-001,2016,1,1,1,89,85,174,190
3404-001,2016,1,1,2,85,67,152,174
3404-001,2016,1,1,3,49,46,95,152
3404-001,2016,1,1,4,33,41,74,95
3404-001,2016,1,1,5,31,59,90,74
3404-001,2016,1,1,6,66,121,187,90
3404-001,2016,1,1,7,68,164,232,187
3404-001,2016,1,1,8,96,184,280,232
3404-001,2016,1,1,9,231,201,432,280
3404-001,2016,1,1,10,296,212,508,432
3404-001,2016,1,1,11,314,297,611,508
3404-001,2016,1,1,12,345,432,777,611
3404-001,2016,1,1,13,287,473,760,777
3404-001,2016,1,1,14,325,390,715,760
3404-001,2016,1,1,15,363,395,758,715
3404-001,2016,1,1,16,485,377,862,758
3404-001,2016,1,1,17,477,322,799,862
3404-001,2016,1,1,18,465,256,721,799
3404-001,2016,1,1,19,361,217,578,721
3404-001,2016,1,1,20,243,189,432,578
3404-001,2016,1,1,21,217,130,347,432
3404-001,2016,1,1,22,130,104,234,347
3404-001,2016,1,1,23,79,74,153,234
3404-001,2016,1,1,24,51,70,121,153
3404-001,2016,1,2,1,40,37,77,121
3404-001,2016,1,2,2,25,34,59,77
3404-001,2016,1,2,3,24,25,49,59
3404-001,2016,1,2,4,20,18,38,49
3404-001,2016,1,2,5,30,29,59,38
3404-001,2016,1,2,6,48,52,100,59
3404-001,2016,1,2,7,74,145,219,100
3404-001,2016,1,2,8,164,299,463,219
3404-001,2016,1,2,9,249,300,549,463
3404-001,2016,1,2,10,290,307,597,549
3404-001,2016,1,2,11,339,388,727,597
3404-001,2016,1,2,12,372,418,790,727
3404-001,2016,1,2,13,362,435,797,790
3404-001,2016,1,2,14,369,409,778,797
3404-001,2016,1,2,15,437,390,827,778
3404-001,2016,1,2,16,471,382,853,827
3404-001,2016,1,2,17,518,369,887,853
3404-001,2016,1,2,18,703,355,1058,887
3404-001,2016,1,2,19,459,308,767,1058
3404-001,2016,1,2,20,263,222,485,767
3404-001,2016,1,2,21,217,188,405,485
3404-001,2016,1,2,22,150,118,268,405
3404-001,2016,1,2,23,95,99,194,268
3404-001,2016,1,2,24,44,77,121,194
3404-001,2016,1,3,1,51,53,104,121
3404-001,2016,1,3,2,30,36,66,104
3404-001,2016,1,3,3,19,32,51,66
3404-001,2016,1,3,4,28,12,40,51
3404-001,2016,1,3,5,25,24,49,40
3404-001,2016,1,3,6,33,41,74,49
3404-001,2016,1,3,7,47,121,168,74
3404-001,2016,1,3,8,91,215,306,168
3404-001,2016,1,3,9,176,221,397,306
3404-001,2016,1,3,10,205,224,429,397
3404-001,2016,1,3,11,228,257,485,429
3404-001,2016,1,3,12,263,306,569,485
3404-001,2016,1,3,13,296,292,588,569
3404-001,2016,1,3,14,355,358,713,588
3404-001,2016,1,3,15,385,339,724,713
3404-001,2016,1,3,16,427,376,803,724
3404-001,2016,1,3,17,470,343,813,803
3404-001,2016,1,3,18,445,321,766,813
3404-001,2016,1,3,19,314,284,598,766
3404-001,2016,1,3,20,219,251,470,598
3404-001,2016,1,3,21,178,205,383,470
3404-001,2016,1,3,22,134,206,340,383
3404-001,2016,1,3,23,98,165,263,340
3404-001,2016,1,3,24,59,112,171,263
3404-001,2016,1,4,1,33,69,102,171
3404-001,2016,1,4,2,31,56,87,102
3404-001,2016,1,4,3,23,32,55,87
3404-001,2016,1,4,4,14,32,46,55
3404-001,2016,1,4,5,42,61,103,46
3404-001,2016,1,4,6,101,218,319,103
3404-001,2016,1,4,7,209,597,806,319
3404-001,2016,1,4,8,455,1915,2370,806
3404-001,2016,1,4,9,628,1280,1908,2370
3404-001,2016,1,4,10,578,653,1231,1908
3404-001,2016,1,4,11,633,643,1276,1231
3404-001,2016,1,4,12,659,668,1327,1276
3404-001,2016,1,4,13,559,553,1112,1327
3404-001,2016,1,4,14,616,647,1263,1112
3404-001,2016,1,4,15,728,731,1459,1263
3404-001,2016,1,4,16,746,651,1397,1459
3404-001,2016,1,4,17,747,592,1339,1397
3404-001,2016,1,4,18,1102,502,1604,1339
3404-001,2016,1,4,19,951,431,1382,1604
3404-001,2016,1,4,20,729,358,1087,1382
3404-001,2016,1,4,21,648,239,887,1087
3404-001,2016,1,4,22,350,159,509,887
3404-001,2016,1,4,23,175,128,303,509
3404-001,2016,1,4,24,120,91,211,303
3404-001,2016,1,5,1,70,77,147,211
3404-001,2016,1,5,2,54,43,97,147
3404-001,2016,1,5,3,32,55,87,97
3404-001,2016,1,5,4,44,50,94,87
3404-001,2016,1,5,5,48,66,114,94
3404-001,2016,1,5,6,114,175,289,114
3404-001,2016,1,5,7,191,520,711,289
3404-001,2016,1,5,8,440,1783,2223,711
3404-001,2016,1,5,9,721,1299,2020,2223
3404-001,2016,1,5,10,687,731,1418,2020
3404-001,2016,1,5,11,675,756,1431,1418
3404-001,2016,1,5,12,686,648,1334,1431
3404-001,2016,1,5,13,603,564,1167,1334
3404-001,2016,1,5,14,629,663,1292,1167
3404-001,2016,1,5,15,775,749,1524,1292
3404-001,2016,1,5,16,792,636,1428,1524
3404-001,2016,1,5,17,821,577,1398,1428
3404-001,2016,1,5,18,1093,546,1639,1398
3404-001,2016,1,5,19,992,429,1421,1639
3404-001,2016,1,5,20,722,360,1082,1421
3404-001,2016,1,5,21,677,259,936,1082
3404-001,2016,1,5,22,400,192,592,936
3404-001,2016,1,5,23,212,131,343,592
3404-001,2016,1,5,24,98,79,177,343
3404-001,2016,1,6,1,72,77,149,177
3404-001,2016,1,6,2,54,61,115,149
3404-001,2016,1,6,3,40,41,81,115
3404-001,2016,1,6,4,49,53,102,81
3404-001,2016,1,6,5,44,58,102,102
3404-001,2016,1,6,6,108,161,269,102
3404-001,2016,1,6,7,212,512,724,269
3404-001,2016,1,6,8,485,1732,2217,724
3404-001,2016,1,6,9,743,1329,2072,2217
3404-001,2016,1,6,10,678,751,1429,2072
3404-001,2016,1,6,11,686,728,1414,1429
3404-001,2016,1,6,12,669,708,1377,1414
3404-001,2016,1,6,13,640,557,1197,1377
3404-001,2016,1,6,14,648,684,1332,1197
3404-001,2016,1,6,15,782,731,1513,1332
3404-001,2016,1,6,16,805,649,1454,1513
3404-001,2016,1,6,17,812,567,1379,1454
3404-001,2016,1,6,18,1275,593,1868,1379
3404-001,2016,1,6,19,1030,498,1528,1868
3404-001,2016,1,6,20,732,374,1106,1528
3404-001,2016,1,6,21,536,228,764,1106
3404-001,2016,1,6,22,306,179,485,764
3404-001,2016,1,6,23,190,124,314,485
3404-001,2016,1,6,24,97,77,174,314
3404-001,2016,1,7,1,70,69,139,174
3404-001,2016,1,7,2,56,48,104,139
3404-001,2016,1,7,3,31,37,68,104
3404-001,2016,1,7,4,35,36,71,68
3404-001,2016,1,7,5,38,54,92,71
3404-001,2016,1,7,6,118,181,299,92
3404-001,2016,1,7,7,181,493,674,299
3404-001,2016,1,7,8,426,1706,2132,674
3404-001,2016,1,7,9,680,1293,1973,2132
3404-001,2016,1,7,10,653,687,1340,1973
3404-001,2016,1,7,11,721,693,1414,1340
3404-001,2016,1,7,12,603,660,1263,1414
3404-001,2016,1,7,13,573,564,1137,1263
3404-001,2016,1,7,14,657,679,1336,1137
3404-001,2016,1,7,15,770,683,1453,1336
3404-001,2016,1,7,16,789,664,1453,1453
3404-001,2016,1,7,17,797,567,1364,1453
3404-001,2016,1,7,18,1080,543,1623,1364
3404-001,2016,1,7,19,1002,479,1481,1623
3404-001,2016,1,7,20,715,387,1102,1481
3404-001,2016,1,7,21,677,267,944,1102
3404-001,2016,1,7,22,394,200,594,944
3404-001,2016,1,7,23,197,135,332,594
3404-001,2016,1,7,24,101,97,198,332
3404-001,2016,1,8,1,84,72,156,198
3404-001,2016,1,8,2,66,57,123,156
3404-001,2016,1,8,3,37,40,77,123
3404-001,2016,1,8,4,45,35,80,77
3404-001,2016,1,8,5,56,66,122,80
3404-001,2016,1,8,6,105,166,271,122
3404-001,2016,1,8,7,194,512,706,271
3404-001,2016,1,8,8,435,1700,2135,706
3404-001,2016,1,8,9,701,1292,1993,2135
3404-001,2016,1,8,10,668,753,1421,1993
3404-001,2016,1,8,11,741,729,1470,1421
3404-001,2016,1,8,12,725,713,1438,1470
3404-001,2016,1,8,13,603,613,1216,1438
3404-001,2016,1,8,14,640,697,1337,1216
3404-001,2016,1,8,15,899,687,1586,1337
3404-001,2016,1,8,16,859,647,1506,1586
3404-001,2016,1,8,17,875,624,1499,1506
3404-001,2016,1,8,18,1315,606,1921,1499
3404-001,2016,1,8,19,1173,537,1710,1921
3404-001,2016,1,8,20,784,428,1212,1710
3404-001,2016,1,8,21,614,263,877,1212
3404-001,2016,1,8,22,363,185,548,877
3404-001,2016,1,8,23,206,152,358,548
3404-001,2016,1,8,24,113,94,207,358
3404-001,2016,1,9,1,93,67,160,207
3404-001,2016,1,9,2,65,65,130,160
3404-001,2016,1,9,3,48,38,86,130
3404-001,2016,1,9,4,60,34,94,86
3404-001,2016,1,9,5,36,44,80,94
3404-001,2016,1,9,6,78,124,202,80
3404-001,2016,1,9,7,134,276,410,202
3404-001,2016,1,9,8,295,695,990,410
3404-001,2016,1,9,9,459,636,1095,990
3404-001,2016,1,9,10,499,524,1023,1095
3404-001,2016,1,9,11,497,547,1044,1023
3404-001,2016,1,9,12,505,497,1002,1044
3404-001,2016,1,9,13,505,443,948,1002
3404-001,2016,1,9,14,502,469,971,948
3404-001,2016,1,9,15,560,433,993,971
3404-001,2016,1,9,16,591,458,1049,993
3404-001,2016,1,9,17,692,459,1151,1049
3404-001,2016,1,9,18,814,396,1210,1151
3404-001,2016,1,9,19,499,340,839,1210
3404-001,2016,1,9,20,293,241,534,839
3404-001,2016,1,9,21,201,188,389,534
3404-001,2016,1,9,22,146,138,284,389
3404-001,2016,1,9,23,89,101,190,284
3404-001,2016,1,9,24,85,81,166,190
3404-001,2016,1,10,1,56,61,117,166
3404-001,2016,1,10,2,31,37,68,117
3404-001,2016,1,10,3,32,30,62,68
3404-001,2016,1,10,4,21,25,46,62
3404-001,2016,1,10,5,25,28,53,46
3404-001,2016,1,10,6,41,39,80,53
3404-001,2016,1,10,7,61,114,175,80
3404-001,2016,1,10,8,113,193,306,175
3404-001,2016,1,10,9,200,198,398,306
3404-001,2016,1,10,10,198,211,409,398
3404-001,2016,1,10,11,251,283,534,409
3404-001,2016,1,10,12,245,337,582,534
3404-001,2016,1,10,13,304,305,609,582
3404-001,2016,1,10,14,310,357,667,609
3404-001,2016,1,10,15,387,342,729,667
3404-001,2016,1,10,16,408,359,767,729
3404-001,2016,1,10,17,456,311,767,767
3404-001,2016,1,10,18,479,324,803,767
3404-001,2016,1,10,19,334,286,620,803
3404-001,2016,1,10,20,215,220,435,620
3404-001,2016,1,10,21,189,193,382,435
3404-001,2016,1,10,22,139,181,320,382
3404-001,2016,1,10,23,92,142,234,320
3404-001,2016,1,10,24,64,101,165,234
3404-001,2016,1,11,1,54,69,123,165
3404-001,2016,1,11,2,22,36,58,123
3404-001,2016,1,11,3,24,23,47,58
3404-001,2016,1,11,4,18,28,46,47
3404-001,2016,1,11,5,30,41,71,46
3404-001,2016,1,11,6,89,177,266,71
3404-001,2016,1,11,7,183,605,788,266
3404-001,2016,1,11,8,496,1864,2360,788
3404-001,2016,1,11,9,653,1308,1961,2360
3404-001,2016,1,11,10,622,665,1287,1961
3404-001,2016,1,11,11,644,689,1333,1287
3404-001,2016,1,11,12,583,630,1213,1333
3404-001,2016,1,11,13,552,558,1110,1213
3404-001,2016,1,11,14,613,676,1289,1110
3404-001,2016,1,11,15,730,707,1437,1289
3404-001,2016,1,11,16,819,665,1484,1437
3404-001,2016,1,11,17,735,608,1343,1484
3404-001,2016,1,11,18,1111,556,1667,1343
3404-001,2016,1,11,19,997,501,1498,1667
3404-001,2016,1,11,20,704,372,1076,1498
3404-001,2016,1,11,21,685,244,929,1076
3404-001,2016,1,11,22,402,176,578,929
3404-001,2016,1,11,23,198,130,328,578
3404-001,2016,1,11,24,110,83,193,328
3404-001,2016,1,12,1,72,60,132,193
3404-001,2016,1,12,2,44,51,95,132
3404-001,2016,1,12,3,32,41,73,95
3404-001,2016,1,12,4,43,37,80,73
3404-001,2016,1,12,5,64,56,120,80
3404-001,2016,1,12,6,109,156,265,120
3404-001,2016,1,12,7,180,489,669,265
3404-001,2016,1,12,8,451,1696,2147,669
3404-001,2016,1,12,9,719,1394,2113,2147
3404-001,2016,1,12,10,675,752,1427,2113
3404-001,2016,1,12,11,696,742,1438,1427
3404-001,2016,1,12,12,642,626,1268,1438
3404-001,2016,1,12,13,628,585,1213,1268
3404-001,2016,1,12,14,600,693,1293,1213
3404-001,2016,1,12,15,756,731,1487,1293
3404-001,2016,1,12,16,819,658,1477,1487
3404-001,2016,1,12,17,828,579,1407,1477
3404-001,2016,1,12,18,1232,551,1783,1407
3404-001,2016,1,12,19,977,445,1422,1783
3404-001,2016,1,12,20,711,381,1092,1422
3404-001,2016,1,12,21,667,279,946,1092
3404-001,2016,1,12,22,365,201,566,946
3404-001,2016,1,12,23,217,149,366,566
3404-001,2016,1,12,24,109,108,217,366
3404-001,2016,1,13,1,80,77,157,217
3404-001,2016,1,13,2,64,63,127,157
3404-001,2016,1,13,3,49,25,74,127
3404-001,2016,1,13,4,35,43,78,74
3404-001,2016,1,13,5,45,48,93,78
3404-001,2016,1,13,6,84,153,237,93
3404-001,2016,1,13,7,155,435,590,237
3404-001,2016,1,13,8,413,1397,1810,590
3404-001,2016,1,13,9,658,1305,1963,1810
3404-001,2016,1,13,10,565,656,1221,1963
3404-001,2016,1,13,11,632,737,1369,1221
3404-001,2016,1,13,12,667,635,1302,1369
3404-001,2016,1,13,13,554,535,1089,1302
3404-001,2016,1,13,14,645,628,1273,1089
3404-001,2016,1,13,15,796,704,1500,1273
3404-001,2016,1,13,16,815,625,1440,1500
3404-001,2016,1,13,17,735,588,1323,1440
3404-001,2016,1,13,18,1231,545,1776,1323
3404-001,2016,1,13,19,1100,433,1533,1776
3404-001,2016,1,13,20,576,436,1012,1533
3404-001,2016,1,13,21,518,487,1005,1012
3404-001,2016,1,13,22,324,164,488,1005
3404-001,2016,1,13,23,138,43,181,488
3404-001,2016,1,13,24,100,31,131,181
3404-001,2016,1,14,1,65,21,86,131
3404-001,2016,1,14,2,49,14,63,86
3404-001,2016,1,14,3,40,8,48,63
3404-001,2016,1,14,4,41,11,52,48
3404-001,2016,1,14,5,49,77,126,52
3404-001,2016,1,14,6,77,135,212,126
3404-001,2016,1,14,7,169,464,633,212
3404-001,2016,1,14,8,403,1468,1871,633
3404-001,2016,1,14,9,670,1294,1964,1871
3404-001,2016,1,14,10,610,722,1332,1964
3404-001,2016,1,14,11,686,681,1367,1332
3404-001,2016,1,14,12,654,604,1258,1367
3404-001,2016,1,14,13,572,538,1110,1258
3404-001,2016,1,14,14,623,635,1258,1110
3404-001,2016,1,14,15,806,628,1434,1258
3404-001,2016,1,14,16,839,630,1469,1434
3404-001,2016,1,14,17,820,572,1392,1469
3404-001,2016,1,14,18,1103,550,1653,1392
3404-001,2016,1,14,19,1001,476,1477,1653
3404-001,2016,1,14,20,691,370,1061,1477
3404-001,2016,1,14,21,663,274,937,1061
3404-001,2016,1,14,22,314,436,750,937
3404-001,2016,1,14,23,203,135,338,750
3404-001,2016,1,14,24,118,105,223,338
3404-001,2016,1,15,1,82,71,153,223
3404-001,2016,1,15,2,64,65,129,153
3404-001,2016,1,15,3,34,37,71,129
3404-001,2016,1,15,4,39,34,73,71
3404-001,2016,1,15,5,53,67,120,73
3404-001,2016,1,15,6,104,126,230,120
3404-001,2016,1,15,7,172,468,640,230
3404-001,2016,1,15,8,475,1633,2108,640
3404-001,2016,1,15,9,702,1315,2017,2108
3404-001,2016,1,15,10,712,705,1417,2017
3404-001,2016,1,15,11,726,733,1459,1417
3404-001,2016,1,15,12,688,689,1377,1459
3404-001,2016,1,15,13,622,580,1202,1377
3404-001,2016,1,15,14,644,675,1319,1202
3404-001,2016,1,15,15,833,742,1575,1319
3404-001,2016,1,15,16,875,649,1524,1575
3404-001,2016,1,15,17,868,649,1517,1524
3404-001,2016,1,15,18,1371,595,1966,1517
3404-001,2016,1,15,19,1238,532,1770,1966
3404-001,2016,1,15,20,748,491,1239,1770
3404-001,2016,1,15,21,629,284,913,1239
3404-001,2016,1,15,22,314,193,507,913
3404-001,2016,1,15,23,182,146,328,507
3404-001,2016,1,15,24,124,112,236,328
3404-001,2016,1,16,1,96,75,171,236
3404-001,2016,1,16,2,50,43,93,171
3404-001,2016,1,16,3,50,41,91,93
3404-001,2016,1,16,4,43,49,92,91
3404-001,2016,1,16,5,53,40,93,92
3404-001,2016,1,16,6,88,105,193,93
3404-001,2016,1,16,7,159,297,456,193
3404-001,2016,1,16,8,322,641,963,456
3404-001,2016,1,16,9,461,630,1091,963
3404-001,2016,1,16,10,482,507,989,1091
3404-001,2016,1,16,11,504,490,994,989
3404-001,2016,1,16,12,487,509,996,994
3404-001,2016,1,16,13,467,488,955,996
3404-001,2016,1,16,14,452,482,934,955
3404-001,2016,1,16,15,532,474,1006,934
3404-001,2016,1,16,16,600,476,1076,1006
3404-001,2016,1,16,17,696,414,1110,1076
3404-001,2016,1,16,18,873,453,1326,1110
3404-001,2016,1,16,19,488,363,851,1326
3404-001,2016,1,16,20,309,276,585,851
3404-001,2016,1,16,21,238,192,430,585
3404-001,2016,1,16,22,142,139,281,430
3404-001,2016,1,16,23,96,136,232,281
3404-001,2016,1,16,24,75,69,144,232
3404-001,2016,1,17,1,46,63,109,144
3404-001,2016,1,17,2,52,33,85,109
3404-001,2016,1,17,3,34,28,62,85
3404-001,2016,1,17,4,24,20,44,62
3404-001,2016,1,17,5,33,28,61,44
3404-001,2016,1,17,6,42,42,84,61
3404-001,2016,1,17,7,58,139,197,84
3404-001,2016,1,17,8,132,211,343,197
3404-001,2016,1,17,9,197,222,419,343
3404-001,2016,1,17,10,241,200,441,419
3404-001,2016,1,17,11,255,282,537,441
3404-001,2016,1,17,12,247,308,555,537
3404-001,2016,1,17,13,296,320,616,555
3404-001,2016,1,17,14,326,354,680,616
3404-001,2016,1,17,15,358,343,701,680
3404-001,2016,1,17,16,411,345,756,701
3404-001,2016,1,17,17,480,320,800,756
3404-001,2016,1,17,18,450,317,767,800
3404-001,2016,1,17,19,309,291,600,767
3404-001,2016,1,17,20,214,226,440,600
3404-001,2016,1,17,21,194,225,419,440
3404-001,2016,1,17,22,147,193,340,419
3404-001,2016,1,17,23,87,145,232,340
3404-001,2016,1,17,24,56,123,179,232
3404-001,2016,1,18,1,35,57,92,179
3404-001,2016,1,18,2,23,45,68,92
3404-001,2016,1,18,3,27,35,62,68
3404-001,2016,1,18,4,27,51,78,62
3404-001,2016,1,18,5,34,22,56,78
3404-001,2016,1,18,6,95,94,189,56
3404-001,2016,1,18,7,199,328,527,189
3404-001,2016,1,18,8,452,1169,1621,527
3404-001,2016,1,18,9,633,812,1445,1621
3404-001,2016,1,18,10,610,659,1269,1445
3404-001,2016,1,18,11,630,666,1296,1269
3404-001,2016,1,18,12,601,649,1250,1296
3404-001,2016,1,18,13,564,556,1120,1250
3404-001,2016,1,18,14,591,662,1253,1120
3404-001,2016,1,18,15,699,719,1418,1253
3404-001,2016,1,18,16,732,655,1387,1418
3404-001,2016,1,18,17,747,542,1289,1387
3404-001,2016,1,18,18,1025,497,1522,1289
3404-001,2016,1,18,19,994,427,1421,1522
3404-001,2016,1,18,20,667,355,1022,1421
3404-001,2016,1,18,21,561,213,774,1022
3404-001,2016,1,18,22,312,151,463,774
3404-001,2016,1,18,23,166,129,295,463
3404-001,2016,1,18,24,81,80,161,295
3404-001,2016,1,19,1,74,65,139,161
3404-001,2016,1,19,2,51,42,93,139
3404-001,2016,1,19,3,36,34,70,93
3404-001,2016,1,19,4,44,43,87,70
3404-001,2016,1,19,5,37,46,83,87
3404-001,2016,1,19,6,68,102,170,83
3404-001,2016,1,19,7,119,404,523,170
3404-001,2016,1,19,8,351,1398,1749,523
3404-001,2016,1,19,9,584,1155,1739,1749
3404-001,2016,1,19,10,528,637,1165,1739
3404-001,2016,1,19,11,578,653,1231,1165
3404-001,2016,1,19,12,607,620,1227,1231
3404-001,2016,1,19,13,539,566,1105,1227
3404-001,2016,1,19,14,588,618,1206,1105
3404-001,2016,1,19,15,696,597,1293,1206
3404-001,2016,1,19,16,738,635,1373,1293
3404-001,2016,1,19,17,683,555,1238,1373
3404-001,2016,1,19,18,987,488,1475,1238
3404-001,2016,1,19,19,902,430,1332,1475
3404-001,2016,1,19,20,623,373,996,1332
3404-001,2016,1,19,21,619,232,851,996
3404-001,2016,1,19,22,352,173,525,851
3404-001,2016,1,19,23,199,120,319,525
3404-001,2016,1,19,24,108,102,210,319
3404-001,2016,1,20,1,78,63,141,210
3404-001,2016,1,20,2,50,33,83,141
3404-001,2016,1,20,3,46,34,80,83
3404-001,2016,1,20,4,30,34,64,80
3404-001,2016,1,20,5,40,48,88,64
3404-001,2016,1,20,6,86,119,205,88
3404-001,2016,1,20,7,149,408,557,205
3404-001,2016,1,20,8,388,1585,1973,557
3404-001,2016,1,20,9,669,1214,1883,1973
3404-001,2016,1,20,10,585,659,1244,1883
3404-001,2016,1,20,11,688,667,1355,1244
3404-001,2016,1,20,12,622,672,1294,1355
3404-001,2016,1,20,13,579,548,1127,1294
3404-001,2016,1,20,14,574,622,1196,1127
3404-001,2016,1,20,15,800,719,1519,1196
3404-001,2016,1,20,16,788,666,1454,1519
3404-001,2016,1,20,17,719,569,1288,1454
3404-001,2016,1,20,18,1235,523,1758,1288
3404-001,2016,1,20,19,1053,447,1500,1758
3404-001,2016,1,20,20,641,365,1006,1500
3404-001,2016,1,20,21,537,254,791,1006
3404-001,2016,1,20,22,314,168,482,791
3404-001,2016,1,20,23,183,122,305,482
3404-001,2016,1,20,24,117,105,222,305
3404-001,2016,1,21,1,72,61,133,222
3404-001,2016,1,21,2,53,46,99,133
3404-001,2016,1,21,3,47,39,86,99
3404-001,2016,1,21,4,39,34,73,86
3404-001,2016,1,21,5,53,61,114,73
3404-001,2016,1,21,6,98,129,227,114
3404-001,2016,1,21,7,148,436,584,227
3404-001,2016,1,21,8,433,1612,2045,584
3404-001,2016,1,21,9,684,1328,2012,2045
3404-001,2016,1,21,10,625,681,1306,2012
3404-001,2016,1,21,11,666,712,1378,1306
3404-001,2016,1,21,12,632,664,1296,1378
3404-001,2016,1,21,13,599,567,1166,1296
3404-001,2016,1,21,14,647,681,1328,1166
3404-001,2016,1,21,15,722,671,1393,1328
3404-001,2016,1,21,16,749,651,1400,1393
3404-001,2016,1,21,17,868,587,1455,1400
3404-001,2016,1,21,18,1067,604,1671,1455
3404-001,2016,1,21,19,1049,464,1513,1671
3404-001,2016,1,21,20,700,389,1089,1513
3404-001,2016,1,21,21,623,282,905,1089
3404-001,2016,1,21,22,312,198,510,905
3404-001,2016,1,21,23,249,148,397,510
3404-001,2016,1,21,24,143,114,257,397
3404-001,2016,1,22,1,85,73,158,257
3404-001,2016,1,22,2,59,51,110,158
3404-001,2016,1,22,3,39,42,81,110
3404-001,2016,1,22,4,30,36,66,81
3404-001,2016,1,22,5,56,57,113,66
3404-001,2016,1,22,6,89,141,230,113
3404-001,2016,1,22,7,160,454,614,230
3404-001,2016,1,22,8,433,1616,2049,614
3404-001,2016,1,22,9,725,1334,2059,2049
3404-001,2016,1,22,10,675,721,1396,2059
3404-001,2016,1,22,11,676,709,1385,1396
3404-001,2016,1,22,12,686,654,1340,1385
3404-001,2016,1,22,13,604,637,1241,1340
3404-001,2016,1,22,14,716,637,1353,1241
3404-001,2016,1,22,15,760,758,1518,1353
3404-001,2016,1,22,16,847,690,1537,1518
3404-001,2016,1,22,17,840,595,1435,1537
3404-001,2016,1,22,18,1290,596,1886,1435
3404-001,2016,1,22,19,1232,541,1773,1886
3404-001,2016,1,22,20,760,425,1185,1773
3404-001,2016,1,22,21,665,261,926,1185
3404-001,2016,1,22,22,365,211,576,926
3404-001,2016,1,22,23,188,143,331,576
3404-001,2016,1,22,24,126,114,240,331
3404-001,2016,1,23,1,74,74,148,240
3404-001,2016,1,23,2,67,46,113,148
3404-001,2016,1,23,3,47,43,90,113
3404-001,2016,1,23,4,46,34,80,90
3404-001,2016,1,23,5,53,48,101,80
3404-001,2016,1,23,6,81,92,173,101
3404-001,2016,1,23,7,133,260,393,173
3404-001,2016,1,23,8,290,635,925,393
3404-001,2016,1,23,9,434,618,1052,925
3404-001,2016,1,23,10,464,499,963,1052
3404-001,2016,1,23,11,516,540,1056,963
3404-001,2016,1,23,12,485,493,978,1056
3404-001,2016,1,23,13,484,450,934,978
3404-001,2016,1,23,14,459,458,917,934
3404-001,2016,1,23,15,574,459,1033,917
3404-001,2016,1,23,16,535,438,973,1033
3404-001,2016,1,23,17,596,374,970,973
3404-001,2016,1,23,18,723,409,1132,970
3404-001,2016,1,23,19,513,290,803,1132
3404-001,2016,1,23,20,247,232,479,803
3404-001,2016,1,23,21,182,150,332,479
3404-001,2016,1,23,22,109,95,204,332
3404-001,2016,1,23,23,79,89,168,204
3404-001,2016,1,23,24,53,51,104,168
3404-001,2016,1,24,1,33,41,74,104
3404-001,2016,1,24,2,38,21,59,74
3404-001,2016,1,24,3,21,16,37,59
3404-001,2016,1,24,4,23,21,44,37
3404-001,2016,1,24,5,10,15,25,44
3404-001,2016,1,24,6,20,24,44,25
3404-001,2016,1,24,7,35,55,90,44
3404-001,2016,1,24,8,78,202,280,90
3404-001,2016,1,24,9,167,210,377,280
3404-001,2016,1,24,10,150,206,356,377
3404-001,2016,1,24,11,170,282,452,356
3404-001,2016,1,24,12,187,322,509,452
3404-001,2016,1,24,13,230,312,542,509
3404-001,2016,1,24,14,249,356,605,542
3404-001,2016,1,24,15,275,342,617,605
3404-001,2016,1,24,16,318,352,670,617
3404-001,2016,1,24,17,312,316,628,670
3404-001,2016,1,24,18,355,320,675,628
3404-001,2016,1,24,19,220,228,448,675
3404-001,2016,1,24,20,152,202,354,448
3404-001,2016,1,24,21,118,162,280,354
3404-001,2016,1,24,22,101,131,232,280
3404-001,2016,1,24,23,59,115,174,232
3404-001,2016,1,24,24,47,73,120,174
3404-001,2016,1,25,1,30,59,89,120
3404-001,2016,1,25,2,17,37,54,89
3404-001,2016,1,25,3,11,16,27,54
3404-001,2016,1,25,4,15,33,48,27
3404-001,2016,1,25,5,34,42,76,48
3404-001,2016,1,25,6,64,129,193,76
3404-001,2016,1,25,7,124,480,604,193
3404-001,2016,1,25,8,372,1542,1914,604
3404-001,2016,1,25,9,552,1280,1832,1914
3404-001,2016,1,25,10,480,587,1067,1832
3404-001,2016,1,25,11,593,596,1189,1067
3404-001,2016,1,25,12,577,620,1197,1189
3404-001,2016,1,25,13,588,534,1122,1197
3404-001,2016,1,25,14,566,627,1193,1122
3404-001,2016,1,25,15,692,713,1405,1193
3404-001,2016,1,25,16,673,660,1333,1405
3404-001,2016,1,25,17,765,575,1340,1333
3404-001,2016,1,25,18,1055,526,1581,1340
3404-001,2016,1,25,19,963,464,1427,1581
3404-001,2016,1,25,20,741,364,1105,1427
3404-001,2016,1,25,21,659,228,887,1105
3404-001,2016,1,25,22,358,164,522,887
3404-001,2016,1,25,23,190,130,320,522
3404-001,2016,1,25,24,100,82,182,320
3404-001,2016,1,26,1,66,77,143,182
3404-001,2016,1,26,2,61,52,113,143
3404-001,2016,1,26,3,26,43,69,113
3404-001,2016,1,26,4,37,50,87,69
3404-001,2016,1,26,5,49,62,111,87
3404-001,2016,1,26,6,94,145,239,111
3404-001,2016,1,26,7,133,411,544,239
3404-001,2016,1,26,8,421,1036,1457,544
3404-001,2016,1,26,9,683,838,1521,1457
3404-001,2016,1,26,10,614,694,1308,1521
3404-001,2016,1,26,11,639,698,1337,1308
3404-001,2016,1,26,12,624,623,1247,1337
3404-001,2016,1,26,13,619,576,1195,1247
3404-001,2016,1,26,14,654,656,1310,1195
3404-001,2016,1,26,15,756,664,1420,1310
3404-001,2016,1,26,16,801,646,1447,1420
3404-001,2016,1,26,17,813,567,1380,1447
3404-001,2016,1,26,18,1032,520,1552,1380
3404-001,2016,1,26,19,999,438,1437,1552
3404-001,2016,1,26,20,698,377,1075,1437
3404-001,2016,1,26,21,661,256,917,1075
3404-001,2016,1,26,22,408,187,595,917
3404-001,2016,1,26,23,184,134,318,595
3404-001,2016,1,26,24,121,105,226,318
3404-001,2016,1,27,1,79,27,106,226
3404-001,2016,1,27,2,52,31,83,106
3404-001,2016,1,27,3,34,30,64,83
3404-001,2016,1,27,4,52,49,101,64
3404-001,2016,1,27,5,53,60,113,101
3404-001,2016,1,27,6,107,156,263,113
3404-001,2016,1,27,7,201,468,669,263
3404-001,2016,1,27,8,454,1674,2128,669
3404-001,2016,1,27,9,726,1323,2049,2128
3404-001,2016,1,27,10,671,704,1375,2049
3404-001,2016,1,27,11,659,702,1361,1375
3404-001,2016,1,27,12,686,654,1340,1361
3404-001,2016,1,27,13,645,542,1187,1340
3404-001,2016,1,27,14,675,625,1300,1187
3404-001,2016,1,27,15,826,712,1538,1300
3404-001,2016,1,27,16,823,646,1469,1538
3404-001,2016,1,27,17,811,578,1389,1469
3404-001,2016,1,27,18,1278,534,1812,1389
3404-001,2016,1,27,19,1108,440,1548,1812
3404-001,2016,1,27,20,720,400,1120,1548
3404-001,2016,1,27,21,555,370,925,1120
3404-001,2016,1,27,22,370,166,536,925
3404-001,2016,1,27,23,214,82,296,536
3404-001,2016,1,27,24,122,68,190,296
3404-001,2016,1,28,1,94,38,132,190
3404-001,2016,1,28,2,57,26,83,132
3404-001,2016,1,28,3,51,24,75,83
3404-001,2016,1,28,4,53,51,104,75
3404-001,2016,1,28,5,63,72,135,104
3404-001,2016,1,28,6,105,160,265,135
3404-001,2016,1,28,7,199,480,679,265
3404-001,2016,1,28,8,496,1702,2198,679
3404-001,2016,1,28,9,761,1352,2113,2198
3404-001,2016,1,28,10,692,723,1415,2113
3404-001,2016,1,28,11,730,652,1382,1415
3404-001,2016,1,28,12,714,634,1348,1382
3404-001,2016,1,28,13,634,552,1186,1348
3404-001,2016,1,28,14,660,658,1318,1186
3404-001,2016,1,28,15,776,650,1426,1318
3404-001,2016,1,28,16,887,640,1527,1426
3404-001,2016,1,28,17,851,580,1431,1527
3404-001,2016,1,28,18,1125,577,1702,1431
3404-001,2016,1,28,19,1044,470,1514,1702
3404-001,2016,1,28,20,709,380,1089,1514
3404-001,2016,1,28,21,743,278,1021,1089
3404-001,2016,1,28,22,385,317,702,1021
3404-001,2016,1,28,23,212,142,354,702
3404-001,2016,1,28,24,113,110,223,354
3404-001,2016,1,29,1,76,40,116,223
3404-001,2016,1,29,2,71,25,96,116
3404-001,2016,1,29,3,43,19,62,96
3404-001,2016,1,29,4,52,11,63,62
3404-001,2016,1,29,5,65,23,88,63
3404-001,2016,1,29,6,100,77,177,88
3404-001,2016,1,29,7,163,278,441,177
3404-001,2016,1,29,8,463,1624,2087,441
3404-001,2016,1,29,9,732,1324,2056,2087
3404-001,2016,1,29,10,664,713,1377,2056
3404-001,2016,1,29,11,730,721,1451,1377
3404-001,2016,1,29,12,677,672,1349,1451
3404-001,2016,1,29,13,634,608,1242,1349
3404-001,2016,1,29,14,703,656,1359,1242
3404-001,2016,1,29,15,788,750,1538,1359
3404-001,2016,1,29,16,846,670,1516,1538
3404-001,2016,1,29,17,895,622,1517,1516
3404-001,2016,1,29,18,1314,596,1910,1517
3404-001,2016,1,29,19,1135,536,1671,1910
3404-001,2016,1,29,20,760,458,1218,1671
3404-001,2016,1,29,21,651,272,923,1218
3404-001,2016,1,29,22,379,202,581,923
3404-001,2016,1,29,23,224,144,368,581
3404-001,2016,1,29,24,127,113,240,368
3404-001,2016,1,30,1,100,40,140,240
3404-001,2016,1,30,2,67,38,105,140
3404-001,2016,1,30,3,45,29,74,105
3404-001,2016,1,30,4,44,16,60,74
3404-001,2016,1,30,5,55,34,89,60
3404-001,2016,1,30,6,65,98,163,89
3404-001,2016,1,30,7,127,278,405,163
3404-001,2016,1,30,8,317,638,955,405
3404-001,2016,1,30,9,481,624,1105,955
3404-001,2016,1,30,10,496,503,999,1105
3404-001,2016,1,30,11,539,515,1054,999
3404-001,2016,1,30,12,547,501,1048,1054
3404-001,2016,1,30,13,502,469,971,1048
3404-001,2016,1,30,14,557,470,1027,971
3404-001,2016,1,30,15,592,466,1058,1027
3404-001,2016,1,30,16,567,457,1024,1058
3404-001,2016,1,30,17,642,394,1036,1024
3404-001,2016,1,30,18,913,431,1344,1036
3404-001,2016,1,30,19,546,326,872,1344
3404-001,2016,1,30,20,322,254,576,872
3404-001,2016,1,30,21,235,171,406,576
3404-001,2016,1,30,22,160,117,277,406
3404-001,2016,1,30,23,104,112,216,277
3404-001,2016,1,30,24,80,80,160,216
3404-001,2016,1,31,1,44,52,96,160
3404-001,2016,1,31,2,43,27,70,96
3404-001,2016,1,31,3,33,20,53,70
3404-001,2016,1,31,4,23,29,52,53
3404-001,2016,1,31,5,29,34,63,52
3404-001,2016,1,31,6,53,50,103,63
3404-001,2016,1,31,7,61,126,187,103
3404-001,2016,1,31,8,141,210,351,187
3404-001,2016,1,31,9,209,216,425,351
3404-001,2016,1,31,10,242,203,445,425
3404-001,2016,1,31,11,278,282,560,445
3404-001,2016,1,31,12,302,315,617,560
3404-001,2016,1,31,13,334,316,650,617
3404-001,2016,1,31,14,326,355,681,650
3404-001,2016,1,31,15,407,342,749,681
3404-001,2016,1,31,16,429,348,777,749
3404-001,2016,1,31,17,472,318,790,777
3404-001,2016,1,31,18,475,318,793,790
3404-001,2016,1,31,19,347,260,607,793
3404-001,2016,1,31,20,221,214,435,607
3404-001,2016,1,31,21,206,194,400,435
3404-001,2016,1,31,22,139,162,301,400
3404-001,2016,1,31,23,100,130,230,301
3404-001,2016,1,31,24,48,98,146,230
3404-001,2016,2,1,1,42,61,103,146
3404-001,2016,2,1,2,26,49,75,103
3404-001,2016,2,1,3,39,26,65,75
3404-001,2016,2,1,4,20,30,50,65
3404-001,2016,2,1,5,48,65,113,50
3404-001,2016,2,1,6,98,175,273,113
3404-001,2016,2,1,7,205,561,766,273
3404-001,2016,2,1,8,504,1832,2336,766
3404-001,2016,2,1,9,665,1467,2132,2336
3404-001,2016,2,1,10,623,683,1306,2132
3404-001,2016,2,1,11,717,734,1451,1306
3404-001,2016,2,1,12,685,716,1401,1451
3404-001,2016,2,1,13,583,545,1128,1401
3404-001,2016,2,1,14,707,644,1351,1128
3404-001,2016,2,1,15,763,716,1479,1351
3404-001,2016,2,1,16,805,658,1463,1479
3404-001,2016,2,1,17,798,558,1356,1463
3404-001,2016,2,1,18,1108,512,1620,1356
3404-001,2016,2,1,19,967,446,1413,1620
3404-001,2016,2,1,20,786,360,1146,1413
3404-001,2016,2,1,21,708,220,928,1146
3404-001,2016,2,1,22,380,158,538,928
3404-001,2016,2,1,23,235,130,365,538
3404-001,2016,2,1,24,118,105,223,365
3404-001,2016,2,2,1,98,82,180,223
3404-001,2016,2,2,2,54,40,94,180
3404-001,2016,2,2,3,50,38,88,94
3404-001,2016,2,2,4,32,54,86,88
3404-001,2016,2,2,5,75,61,136,86
3404-001,2016,2,2,6,87,165,252,136
3404-001,2016,2,2,7,180,476,656,252
3404-001,2016,2,2,8,478,1680,2158,656
3404-001,2016,2,2,9,737,1408,2145,2158
3404-001,2016,2,2,10,691,765,1456,2145
3404-001,2016,2,2,11,733,761,1494,1456
3404-001,2016,2,2,12,695,684,1379,1494
3404-001,2016,2,2,13,620,663,1283,1379
3404-001,2016,2,2,14,689,637,1326,1283
3404-001,2016,2,2,15,884,630,1514,1326
3404-001,2016,2,2,16,865,640,1505,1514
3404-001,2016,2,2,17,856,561,1417,1505
3404-001,2016,2,2,18,1236,504,1740,1417
3404-001,2016,2,2,19,1113,434,1547,1740
3404-001,2016,2,2,20,729,375,1104,1547
3404-001,2016,2,2,21,679,244,923,1104
3404-001,2016,2,2,22,423,180,603,923
3404-001,2016,2,2,23,250,127,377,603
3404-001,2016,2,2,24,135,105,240,377
3404-001,2016,2,3,1,93,87,180,240
3404-001,2016,2,3,2,60,70,130,180
3404-001,2016,2,3,3,45,38,83,130
3404-001,2016,2,3,4,40,56,96,83
3404-001,2016,2,3,5,57,68,125,96
3404-001,2016,2,3,6,117,143,260,125
3404-001,2016,2,3,7,186,459,645,260
3404-001,2016,2,3,8,501,1847,2348,645
3404-001,2016,2,3,9,752,1281,2033,2348
3404-001,2016,2,3,10,732,703,1435,2033
3404-001,2016,2,3,11,696,794,1490,1435
3404-001,2016,2,3,12,670,688,1358,1490
3404-001,2016,2,3,13,641,630,1271,1358
3404-001,2016,2,3,14,655,624,1279,1271
3404-001,2016,2,3,15,886,716,1602,1279
3404-001,2016,2,3,16,831,656,1487,1602
3404-001,2016,2,3,17,929,574,1503,1487
3404-001,2016,2,3,18,1439,609,2048,1503
3404-001,2016,2,3,19,1168,553,1721,2048
3404-001,2016,2,3,20,719,406,1125,1721
3404-001,2016,2,3,21,592,281,873,1125
3404-001,2016,2,3,22,362,203,565,873
3404-001,2016,2,3,23,222,163,385,565
3404-001,2016,2,3,24,132,101,233,385
3404-001,2016,2,4,1,99,91,190,233
3404-001,2016,2,4,2,56,53,109,190
3404-001,2016,2,4,3,45,54,99,109
3404-001,2016,2,4,4,44,46,90,99
3404-001,2016,2,4,5,50,69,119,90
3404-001,2016,2,4,6,103,175,278,119
3404-001,2016,2,4,7,177,553,730,278
3404-001,2016,2,4,8,473,1753,2226,730
3404-001,2016,2,4,9,760,1350,2110,2226
3404-001,2016,2,4,10,769,811,1580,2110
3404-001,2016,2,4,11,770,781,1551,1580
3404-001,2016,2,4,12,752,711,1463,1551
3404-001,2016,2,4,13,612,903,1515,1463
3404-001,2016,2,4,14,697,754,1451,1515
3404-001,2016,2,4,15,875,705,1580,1451
3404-001,2016,2,4,16,928,750,1678,1580
3404-001,2016,2,4,17,943,799,1742,1678
3404-001,2016,2,4,18,1170,626,1796,1742
3404-001,2016,2,4,19,1091,528,1619,1796
3404-001,2016,2,4,20,758,414,1172,1619
3404-001,2016,2,4,21,740,303,1043,1172
3404-001,2016,2,4,22,418,225,643,1043
3404-001,2016,2,4,23,224,143,367,643
3404-001,2016,2,4,24,161,103,264,367
3404-001,2016,2,5,1,104,95,199,264
3404-001,2016,2,5,2,72,65,137,199
3404-001,2016,2,5,3,63,56,119,137
3404-001,2016,2,5,4,47,49,96,119
3404-001,2016,2,5,5,61,68,129,96
3404-001,2016,2,5,6,109,156,265,129
3404-001,2016,2,5,7,172,501,673,265
3404-001,2016,2,5,8,500,1760,2260,673
3404-001,2016,2,5,9,747,1292,2039,2260
3404-001,2016,2,5,10,698,757,1455,2039
3404-001,2016,2,5,11,772,752,1524,1455
3404-001,2016,2,5,12,756,648,1404,1524
3404-001,2016,2,5,13,692,584,1276,1404
3404-001,2016,2,5,14,758,682,1440,1276
3404-001,2016,2,5,15,904,777,1681,1440
3404-001,2016,2,5,16,979,769,1748,1681
3404-001,2016,2,5,17,1094,592,1686,1748
3404-001,2016,2,5,18,1307,623,1930,1686
3404-001,2016,2,5,19,916,508,1424,1930
3404-001,2016,2,5,20,547,419,966,1424
3404-001,2016,2,5,21,419,251,670,966
3404-001,2016,2,5,22,279,182,461,670
3404-001,2016,2,5,23,173,148,321,461
3404-001,2016,2,5,24,136,95,231,321
3404-001,2016,2,6,1,97,66,163,231
3404-001,2016,2,6,2,88,46,134,163
3404-001,2016,2,6,3,58,41,99,134
3404-001,2016,2,6,4,51,43,94,99
3404-001,2016,2,6,5,66,33,99,94
3404-001,2016,2,6,6,106,76,182,99
3404-001,2016,2,6,7,105,175,280,182
3404-001,2016,2,6,8,223,453,676,280
3404-001,2016,2,6,9,322,443,765,676
3404-001,2016,2,6,10,374,383,757,765
3404-001,2016,2,6,11,379,406,785,757
3404-001,2016,2,6,12,390,435,825,785
3404-001,2016,2,6,13,397,351,748,825
3404-001,2016,2,6,14,397,363,760,748
3404-001,2016,2,6,15,407,712,1119,760
3404-001,2016,2,6,16,413,584,997,1119
3404-001,2016,2,6,17,388,319,707,997
3404-001,2016,2,6,18,407,316,723,707
3404-001,2016,2,6,19,274,253,527,723
3404-001,2016,2,6,20,206,224,430,527
3404-001,2016,2,6,21,147,154,301,430
3404-001,2016,2,6,22,107,123,230,301
3404-001,2016,2,6,23,91,87,178,230
3404-001,2016,2,6,24,56,58,114,178
3404-001,2016,2,7,1,50,52,102,114
3404-001,2016,2,7,2,42,25,67,102
3404-001,2016,2,7,3,26,28,54,67
3404-001,2016,2,7,4,46,12,58,54
3404-001,2016,2,7,5,34,16,50,58
3404-001,2016,2,7,6,40,33,73,50
3404-001,2016,2,7,7,47,73,120,73
3404-001,2016,2,7,8,104,119,223,120
3404-001,2016,2,7,9,146,208,354,223
3404-001,2016,2,7,10,190,238,428,354
3404-001,2016,2,7,11,204,334,538,428
3404-001,2016,2,7,12,232,334,566,538
3404-001,2016,2,7,13,226,299,525,566
3404-001,2016,2,7,14,240,269,509,525
3404-001,2016,2,7,15,267,272,539,509
3404-001,2016,2,7,16,230,273,503,539
3404-001,2016,2,7,17,225,236,461,503
3404-001,2016,2,7,18,227,193,420,461
3404-001,2016,2,7,19,155,144,299,420
3404-001,2016,2,7,20,146,144,290,299
3404-001,2016,2,7,21,131,96,227,290
3404-001,2016,2,7,22,102,83,185,227
3404-001,2016,2,7,23,44,61,105,185
3404-001,2016,2,7,24,41,46,87,105
3404-001,2016,2,8,1,33,36,69,87
3404-001,2016,2,8,2,20,18,38,69
3404-001,2016,2,8,3,17,13,30,38
3404-001,2016,2,8,4,20,9,29,30
3404-001,2016,2,8,5,18,5,23,29
3404-001,2016,2,8,6,26,27,53,23
3404-001,2016,2,8,7,62,116,178,53
3404-001,2016,2,8,8,130,183,313,178
3404-001,2016,2,8,9,154,175,329,313
3404-001,2016,2,8,10,193,178,371,329
3404-001,2016,2,8,11,364,287,651,371
3404-001,2016,2,8,12,498,438,936,651
3404-001,2016,2,8,13,951,441,1392,936
3404-001,2016,2,8,14,896,432,1328,1392
3404-001,2016,2,8,15,945,441,1386,1328
3404-001,2016,2,8,16,858,464,1322,1386
3404-001,2016,2,8,17,685,430,1115,1322
3404-001,2016,2,8,18,643,374,1017,1115
3404-001,2016,2,8,19,375,332,707,1017
3404-001,2016,2,8,20,441,233,674,707
3404-001,2016,2,8,21,323,168,491,674
3404-001,2016,2,8,22,470,185,655,491
3404-001,2016,2,8,23,149,104,253,655
3404-001,2016,2,8,24,134,66,200,253
3404-001,2016,2,9,1,43,57,100,200
3404-001,2016,2,9,2,28,47,75,100
3404-001,2016,2,9,3,18,26,44,75
3404-001,2016,2,9,4,17,25,42,44
3404-001,2016,2,9,5,19,20,39,42
3404-001,2016,2,9,6,21,27,48,39
3404-001,2016,2,9,7,36,60,96,48
3404-001,2016,2,9,8,61,112,173,96
3404-001,2016,2,9,9,118,119,237,173
3404-001,2016,2,9,10,156,156,312,237
3404-001,2016,2,9,11,249,234,483,312
3404-001,2016,2,9,12,323,320,643,483
3404-001,2016,2,9,13,643,331,974,643
3404-001,2016,2,9,14,599,311,910,974
3404-001,2016,2,9,15,818,292,1110,910
3404-001,2016,2,9,16,693,275,968,1110
3404-001,2016,2,9,17,716,288,1004,968
3404-001,2016,2,9,18,608,274,882,1004
3404-001,2016,2,9,19,452,232,684,882
3404-001,2016,2,9,20,368,222,590,684
3404-001,2016,2,9,21,371,173,544,590
3404-001,2016,2,9,22,240,143,383,544
3404-001,2016,2,9,23,208,116,324,383
3404-001,2016,2,9,24,81,76,157,324
3404-001,2016,2,10,1,45,52,97,157
3404-001,2016,2,10,2,25,37,62,97
3404-001,2016,2,10,3,28,35,63,62
3404-001,2016,2,10,4,26,27,53,63
3404-001,2016,2,10,5,21,25,46,53
3404-001,2016,2,10,6,39,55,94,46
3404-001,2016,2,10,7,70,137,207,94
3404-001,2016,2,10,8,139,353,492,207
3404-001,2016,2,10,9,206,329,535,492
3404-001,2016,2,10,10,227,225,452,535
3404-001,2016,2,10,11,257,326,583,452
3404-001,2016,2,10,12,337,377,714,583
3404-001,2016,2,10,13,360,364,724,714
3404-001,2016,2,10,14,356,394,750,724
3404-001,2016,2,10,15,404,376,780,750
3404-001,2016,2,10,16,426,374,800,780
3404-001,2016,2,10,17,428,353,781,800
3404-001,2016,2,10,18,483,329,812,781
3404-001,2016,2,10,19,394,277,671,812
3404-001,2016,2,10,20,237,236,473,671
3404-001,2016,2,10,21,202,202,404,473
3404-001,2016,2,10,22,143,188,331,404
3404-001,2016,2,10,23,102,149,251,331
3404-001,2016,2,10,24,51,107,158,251
3404-001,2016,2,11,1,53,77,130,158
3404-001,2016,2,11,2,45,52,97,130
3404-001,2016,2,11,3,34,26,60,97
3404-001,2016,2,11,4,26,39,65,60
3404-001,2016,2,11,5,30,62,92,65
3404-001,2016,2,11,6,102,156,258,92
3404-001,2016,2,11,7,179,501,680,258
3404-001,2016,2,11,8,439,1603,2042,680
3404-001,2016,2,11,9,601,1186,1787,2042
3404-001,2016,2,11,10,564,650,1214,1787
3404-001,2016,2,11,11,623,637,1260,1214
3404-001,2016,2,11,12,635,597,1232,1260
3404-001,2016,2,11,13,544,549,1093,1232
3404-001,2016,2,11,14,594,604,1198,1093
3404-001,2016,2,11,15,713,640,1353,1198
3404-001,2016,2,11,16,729,636,1365,1353
3404-001,2016,2,11,17,701,573,1274,1365
3404-001,2016,2,11,18,1046,523,1569,1274
3404-001,2016,2,11,19,865,440,1305,1569
3404-001,2016,2,11,20,629,351,980,1305
3404-001,2016,2,11,21,601,219,820,980
3404-001,2016,2,11,22,290,160,450,820
3404-001,2016,2,11,23,166,128,294,450
3404-001,2016,2,11,24,106,74,180,294
3404-001,2016,2,12,1,70,43,113,180
3404-001,2016,2,12,2,44,29,73,113
3404-001,2016,2,12,3,37,33,70,73
3404-001,2016,2,12,4,39,37,76,70
3404-001,2016,2,12,5,52,38,90,76
3404-001,2016,2,12,6,95,84,179,90
3404-001,2016,2,12,7,141,262,403,179
3404-001,2016,2,12,8,449,1084,1533,403
3404-001,2016,2,12,9,696,794,1490,1533
3404-001,2016,2,12,10,613,735,1348,1490
3404-001,2016,2,12,11,700,736,1436,1348
3404-001,2016,2,12,12,624,660,1284,1436
3404-001,2016,2,12,13,595,596,1191,1284
3404-001,2016,2,12,14,600,669,1269,1191
3404-001,2016,2,12,15,701,764,1465,1269
3404-001,2016,2,12,16,782,720,1502,1465
3404-001,2016,2,12,17,732,607,1339,1502
3404-001,2016,2,12,18,1117,610,1727,1339
3404-001,2016,2,12,19,1108,522,1630,1727
3404-001,2016,2,12,20,730,438,1168,1630
3404-001,2016,2,12,21,571,262,833,1168
3404-001,2016,2,12,22,339,192,531,833
3404-001,2016,2,12,23,160,146,306,531
3404-001,2016,2,12,24,107,104,211,306
3404-001,2016,2,13,1,77,53,130,211
3404-001,2016,2,13,2,57,58,115,130
3404-001,2016,2,13,3,45,34,79,115
3404-001,2016,2,13,4,39,44,83,79
3404-001,2016,2,13,5,48,44,92,83
3404-001,2016,2,13,6,76,99,175,92
3404-001,2016,2,13,7,130,246,376,175
3404-001,2016,2,13,8,300,648,948,376
3404-001,2016,2,13,9,440,621,1061,948
3404-001,2016,2,13,10,480,536,1016,1061
3404-001,2016,2,13,11,518,493,1011,1016
3404-001,2016,2,13,12,463,477,940,1011
3404-001,2016,2,13,13,505,411,916,940
3404-001,2016,2,13,14,471,460,931,916
3404-001,2016,2,13,15,568,444,1012,931
3404-001,2016,2,13,16,519,393,912,1012
3404-001,2016,2,13,17,615,379,994,912
3404-001,2016,2,13,18,777,425,1202,994
3404-001,2016,2,13,19,420,338,758,1202
3404-001,2016,2,13,20,285,232,517,758
3404-001,2016,2,13,21,205,144,349,517
3404-001,2016,2,13,22,132,141,273,349
3404-001,2016,2,13,23,73,99,172,273
3404-001,2016,2,13,24,67,58,125,172
3404-001,2016,2,14,1,51,57,108,125
3404-001,2016,2,14,2,36,37,73,108
3404-001,2016,2,14,3,30,28,58,73
3404-001,2016,2,14,4,19,28,47,58
3404-001,2016,2,14,5,24,22,46,47
3404-001,2016,2,14,6,45,62,107,46
3404-001,2016,2,14,7,70,114,184,107
3404-001,2016,2,14,8,105,219,324,184
3404-001,2016,2,14,9,188,179,367,324
3404-001,2016,2,14,10,155,188,343,367
3404-001,2016,2,14,11,241,231,472,343
3404-001,2016,2,14,12,263,258,521,472
3404-001,2016,2,14,13,278,276,554,521
3404-001,2016,2,14,14,298,309,607,554
3404-001,2016,2,14,15,322,302,624,607
3404-001,2016,2,14,16,356,319,675,624
3404-001,2016,2,14,17,387,290,677,675
3404-001,2016,2,14,18,371,317,688,677
3404-001,2016,2,14,19,265,283,548,688
3404-001,2016,2,14,20,210,227,437,548
3404-001,2016,2,14,21,157,174,331,437
3404-001,2016,2,14,22,118,158,276,331
3404-001,2016,2,14,23,68,118,186,276
3404-001,2016,2,14,24,47,93,140,186
3404-001,2016,2,15,1,47,60,107,140
3404-001,2016,2,15,2,29,46,75,107
3404-001,2016,2,15,3,28,39,67,75
3404-001,2016,2,15,4,24,25,49,67
3404-001,2016,2,15,5,41,52,93,49
3404-001,2016,2,15,6,99,162,261,93
3404-001,2016,2,15,7,172,572,744,261
3404-001,2016,2,15,8,488,1872,2360,744
3404-001,2016,2,15,9,678,1297,1975,2360
3404-001,2016,2,15,10,627,715,1342,1975
3404-001,2016,2,15,11,677,653,1330,1342
3404-001,2016,2,15,12,652,635,1287,1330
3404-001,2016,2,15,13,600,594,1194,1287
3404-001,2016,2,15,14,620,678,1298,1194
3404-001,2016,2,15,15,834,744,1578,1298
3404-001,2016,2,15,16,835,627,1462,1578
3404-001,2016,2,15,17,807,615,1422,1462
3404-001,2016,2,15,18,1017,568,1585,1422
3404-001,2016,2,15,19,962,469,1431,1585
3404-001,2016,2,15,20,739,419,1158,1431
3404-001,2016,2,15,21,699,222,921,1158
3404-001,2016,2,15,22,426,188,614,921
3404-001,2016,2,15,23,191,133,324,614
3404-001,2016,2,15,24,107,108,215,324
3404-001,2016,2,16,1,74,60,134,215
3404-001,2016,2,16,2,63,64,127,134
3404-001,2016,2,16,3,40,38,78,127
3404-001,2016,2,16,4,33,40,73,78
3404-001,2016,2,16,5,48,51,99,73
3404-001,2016,2,16,6,95,162,257,99
3404-001,2016,2,16,7,189,480,669,257
3404-001,2016,2,16,8,459,1665,2124,669
3404-001,2016,2,16,9,709,1305,2014,2124
3404-001,2016,2,16,10,665,780,1445,2014
3404-001,2016,2,16,11,634,723,1357,1445
3404-001,2016,2,16,12,656,605,1261,1357
3404-001,2016,2,16,13,581,546,1127,1261
3404-001,2016,2,16,14,654,690,1344,1127
3404-001,2016,2,16,15,757,659,1416,1344
3404-001,2016,2,16,16,802,598,1400,1416
3404-001,2016,2,16,17,774,577,1351,1400
3404-001,2016,2,16,18,1122,573,1695,1351
3404-001,2016,2,16,19,976,469,1445,1695
3404-001,2016,2,16,20,691,380,1071,1445
3404-001,2016,2,16,21,641,264,905,1071
3404-001,2016,2,16,22,416,175,591,905
3404-001,2016,2,16,23,188,115,303,591
3404-001,2016,2,16,24,140,109,249,303
3404-001,2016,2,17,1,86,68,154,249
3404-001,2016,2,17,2,68,50,118,154
3404-001,2016,2,17,3,35,39,74,118
3404-001,2016,2,17,4,51,42,93,74
3404-001,2016,2,17,5,60,73,133,93
3404-001,2016,2,17,6,107,164,271,133
3404-001,2016,2,17,7,181,467,648,271
3404-001,2016,2,17,8,497,1836,2333,648
3404-001,2016,2,17,9,728,1306,2034,2333
3404-001,2016,2,17,10,691,692,1383,2034
3404-001,2016,2,17,11,710,723,1433,1383
3404-001,2016,2,17,12,708,694,1402,1433
3404-001,2016,2,17,13,566,582,1148,1402
3404-001,2016,2,17,14,672,679,1351,1148
3404-001,2016,2,17,15,758,733,1491,1351
3404-001,2016,2,17,16,817,672,1489,1491
3404-001,2016,2,17,17,813,603,1416,1489
3404-001,2016,2,17,18,1324,581,1905,1416
3404-001,2016,2,17,19,1092,495,1587,1905
3404-001,2016,2,17,20,670,396,1066,1587
3404-001,2016,2,17,21,566,283,849,1066
3404-001,2016,2,17,22,394,196,590,849
3404-001,2016,2,17,23,189,141,330,590
3404-001,2016,2,17,24,109,109,218,330
3404-001,2016,2,18,1,85,68,153,218
3404-001,2016,2,18,2,62,53,115,153
3404-001,2016,2,18,3,49,47,96,115
3404-001,2016,2,18,4,42,44,86,96
3404-001,2016,2,18,5,66,41,107,86
3404-001,2016,2,18,6,101,175,276,107
3404-001,2016,2,18,7,195,500,695,276
3404-001,2016,2,18,8,488,1734,2222,695
3404-001,2016,2,18,9,725,1375,2100,2222
3404-001,2016,2,18,10,741,723,1464,2100
3404-001,2016,2,18,11,675,717,1392,1464
3404-001,2016,2,18,12,714,690,1404,1392
3404-001,2016,2,18,13,591,543,1134,1404
3404-001,2016,2,18,14,650,711,1361,1134
3404-001,2016,2,18,15,771,713,1484,1361
3404-001,2016,2,18,16,851,720,1571,1484
3404-001,2016,2,18,17,822,649,1471,1571
3404-001,2016,2,18,18,1203,626,1829,1471
3404-001,2016,2,18,19,1018,524,1542,1829
3404-001,2016,2,18,20,742,397,1139,1542
3404-001,2016,2,18,21,687,275,962,1139
3404-001,2016,2,18,22,380,233,613,962
3404-001,2016,2,18,23,195,161,356,613
3404-001,2016,2,18,24,148,93,241,356
3404-001,2016,2,19,1,86,100,186,241
3404-001,2016,2,19,2,61,61,122,186
3404-001,2016,2,19,3,39,37,76,122
3404-001,2016,2,19,4,52,33,85,76
3404-001,2016,2,19,5,58,56,114,85
3404-001,2016,2,19,6,103,150,253,114
3404-001,2016,2,19,7,183,528,711,253
3404-001,2016,2,19,8,482,1728,2210,711
3404-001,2016,2,19,9,720,1240,1960,2210
3404-001,2016,2,19,10,681,742,1423,1960
3404-001,2016,2,19,11,686,675,1361,1423
3404-001,2016,2,19,12,662,618,1280,1361
3404-001,2016,2,19,13,602,586,1188,1280
3404-001,2016,2,19,14,683,635,1318,1188
3404-001,2016,2,19,15,776,684,1460,1318
3404-001,2016,2,19,16,809,644,1453,1460
3404-001,2016,2,19,17,841,587,1428,1453
3404-001,2016,2,19,18,1336,571,1907,1428
3404-001,2016,2,19,19,1194,517,1711,1907
3404-001,2016,2,19,20,799,445,1244,1711
3404-001,2016,2,19,21,638,309,947,1244
3404-001,2016,2,19,22,351,168,519,947
3404-001,2016,2,19,23,213,148,361,519
3404-001,2016,2,19,24,124,118,242,361
3404-001,2016,2,20,1,106,78,184,242
3404-001,2016,2,20,2,65,47,112,184
3404-001,2016,2,20,3,50,38,88,112
3404-001,2016,2,20,4,43,38,81,88
3404-001,2016,2,20,5,64,64,128,81
3404-001,2016,2,20,6,104,104,208,128
3404-001,2016,2,20,7,144,300,444,208
3404-001,2016,2,20,8,358,745,1103,444
3404-001,2016,2,20,9,485,661,1146,1103
3404-001,2016,2,20,10,482,577,1059,1146
3404-001,2016,2,20,11,489,521,1010,1059
3404-001,2016,2,20,12,472,496,968,1010
3404-001,2016,2,20,13,537,509,1046,968
3404-001,2016,2,20,14,515,521,1036,1046
3404-001,2016,2,20,15,559,458,1017,1036
3404-001,2016,2,20,16,631,534,1165,1017
3404-001,2016,2,20,17,711,442,1153,1165
3404-001,2016,2,20,18,897,475,1372,1153
3404-001,2016,2,20,19,543,420,963,1372
3404-001,2016,2,20,20,329,278,607,963
3404-001,2016,2,20,21,238,191,429,607
3404-001,2016,2,20,22,138,142,280,429
3404-001,2016,2,20,23,99,90,189,280
3404-001,2016,2,20,24,107,94,201,189
3404-001,2016,2,21,1,56,42,98,201
3404-001,2016,2,21,2,49,29,78,98
3404-001,2016,2,21,3,33,22,55,78
3404-001,2016,2,21,4,30,18,48,55
3404-001,2016,2,21,5,34,23,57,48
3404-001,2016,2,21,6,44,61,105,57
3404-001,2016,2,21,7,52,113,165,105
3404-001,2016,2,21,8,120,251,371,165
3404-001,2016,2,21,9,204,263,467,371
3404-001,2016,2,21,10,262,244,506,467
3404-001,2016,2,21,11,279,294,573,506
3404-001,2016,2,21,12,307,316,623,573
3404-001,2016,2,21,13,333,320,653,623
3404-001,2016,2,21,14,344,352,696,653
3404-001,2016,2,21,15,354,345,699,696
3404-001,2016,2,21,16,440,358,798,699
3404-001,2016,2,21,17,447,365,812,798
3404-001,2016,2,21,18,535,360,895,812
3404-001,2016,2,21,19,367,309,676,895
3404-001,2016,2,21,20,257,265,522,676
3404-001,2016,2,21,21,195,218,413,522
3404-001,2016,2,21,22,137,189,326,413
3404-001,2016,2,21,23,90,123,213,326
3404-001,2016,2,21,24,63,97,160,213
3404-001,2016,2,22,1,57,70,127,160
3404-001,2016,2,22,2,30,57,87,127
3404-001,2016,2,22,3,24,25,49,87
3404-001,2016,2,22,4,27,30,57,49
3404-001,2016,2,22,5,43,62,105,57
3404-001,2016,2,22,6,114,213,327,105
3404-001,2016,2,22,7,209,598,807,327
3404-001,2016,2,22,8,498,1940,2438,807
3404-001,2016,2,22,9,661,1413,2074,2438
3404-001,2016,2,22,10,649,713,1362,2074
3404-001,2016,2,22,11,706,659,1365,1362
3404-001,2016,2,22,12,613,672,1285,1365
3404-001,2016,2,22,13,581,590,1171,1285
3404-001,2016,2,22,14,742,656,1398,1171
3404-001,2016,2,22,15,725,734,1459,1398
3404-001,2016,2,22,16,838,734,1572,1459
3404-001,2016,2,22,17,847,641,1488,1572
3404-001,2016,2,22,18,1182,569,1751,1488
3404-001,2016,2,22,19,997,480,1477,1751
3404-001,2016,2,22,20,718,382,1100,1477
3404-001,2016,2,22,21,665,266,931,1100
3404-001,2016,2,22,22,415,186,601,931
3404-001,2016,2,22,23,213,131,344,601
3404-001,2016,2,22,24,116,89,205,344
3404-001,2016,2,23,1,75,82,157,205
3404-001,2016,2,23,2,65,56,121,157
3404-001,2016,2,23,3,42,42,84,121
3404-001,2016,2,23,4,45,26,71,84
3404-001,2016,2,23,5,61,71,132,71
3404-001,2016,2,23,6,105,161,266,132
3404-001,2016,2,23,7,175,503,678,266
3404-001,2016,2,23,8,525,1737,2262,678
3404-001,2016,2,23,9,773,1323,2096,2262
3404-001,2016,2,23,10,672,771,1443,2096
3404-001,2016,2,23,11,761,724,1485,1443
3404-001,2016,2,23,12,630,701,1331,1485
3404-001,2016,2,23,13,675,613,1288,1331
3404-001,2016,2,23,14,648,681,1329,1288
3404-001,2016,2,23,15,851,748,1599,1329
3404-001,2016,2,23,16,873,711,1584,1599
3404-001,2016,2,23,17,852,653,1505,1584
3404-001,2016,2,23,18,1170,596,1766,1505
3404-001,2016,2,23,19,983,507,1490,1766
3404-001,2016,2,23,20,757,392,1149,1490
3404-001,2016,2,23,21,713,247,960,1149
3404-001,2016,2,23,22,376,181,557,960
3404-001,2016,2,23,23,172,161,333,557
3404-001,2016,2,23,24,125,114,239,333
3404-001,2016,2,24,1,76,72,148,239
3404-001,2016,2,24,2,70,61,131,148
3404-001,2016,2,24,3,41,49,90,131
3404-001,2016,2,24,4,45,36,81,90
3404-001,2016,2,24,5,49,63,112,81
3404-001,2016,2,24,6,119,167,286,112
3404-001,2016,2,24,7,176,528,704,286
3404-001,2016,2,24,8,508,1748,2256,704
3404-001,2016,2,24,9,751,1312,2063,2256
3404-001,2016,2,24,10,704,696,1400,2063
3404-001,2016,2,24,11,688,751,1439,1400
3404-001,2016,2,24,12,682,694,1376,1439
3404-001,2016,2,24,13,602,638,1240,1376
3404-001,2016,2,24,14,710,673,1383,1240
3404-001,2016,2,24,15,886,714,1600,1383
3404-001,2016,2,24,16,796,691,1487,1600
3404-001,2016,2,24,17,822,614,1436,1487
3404-001,2016,2,24,18,1310,584,1894,1436
3404-001,2016,2,24,19,1051,517,1568,1894
3404-001,2016,2,24,20,700,384,1084,1568
3404-001,2016,2,24,21,550,252,802,1084
3404-001,2016,2,24,22,353,233,586,802
3404-001,2016,2,24,23,191,117,308,586
3404-001,2016,2,24,24,147,107,254,308
3404-001,2016,2,25,1,87,67,154,254
3404-001,2016,2,25,2,64,46,110,154
3404-001,2016,2,25,3,51,33,84,110
3404-001,2016,2,25,4,35,30,65,84
3404-001,2016,2,25,5,65,58,123,65
3404-001,2016,2,25,6,119,172,291,123
3404-001,2016,2,25,7,215,496,711,291
3404-001,2016,2,25,8,497,1741,2238,711
3404-001,2016,2,25,9,741,1315,2056,2238
3404-001,2016,2,25,10,687,772,1459,2056
3404-001,2016,2,25,11,725,704,1429,1459
3404-001,2016,2,25,12,675,635,1310,1429
3404-001,2016,2,25,13,613,546,1159,1310
3404-001,2016,2,25,14,658,667,1325,1159
3404-001,2016,2,25,15,780,810,1590,1325
3404-001,2016,2,25,16,851,653,1504,1590
3404-001,2016,2,25,17,845,626,1471,1504
3404-001,2016,2,25,18,1176,605,1781,1471
3404-001,2016,2,25,19,1108,530,1638,1781
3404-001,2016,2,25,20,744,384,1128,1638
3404-001,2016,2,25,21,647,251,898,1128
3404-001,2016,2,25,22,382,217,599,898
3404-001,2016,2,25,23,214,168,382,599
3404-001,2016,2,25,24,138,114,252,382
3404-001,2016,2,26,1,81,63,144,252
3404-001,2016,2,26,2,69,41,110,144
3404-001,2016,2,26,3,45,41,86,110
3404-001,2016,2,26,4,45,41,86,86
3404-001,2016,2,26,5,61,49,110,86
3404-001,2016,2,26,6,105,145,250,110
3404-001,2016,2,26,7,204,514,718,250
3404-001,2016,2,26,8,487,1695,2182,718
3404-001,2016,2,26,9,810,1290,2100,2182
3404-001,2016,2,26,10,694,787,1481,2100
3404-001,2016,2,26,11,755,705,1460,1481
3404-001,2016,2,26,12,729,671,1400,1460
3404-001,2016,2,26,13,630,597,1227,1400
3404-001,2016,2,26,14,693,677,1370,1227
3404-001,2016,2,26,15,855,738,1593,1370
3404-001,2016,2,26,16,833,649,1482,1593
3404-001,2016,2,26,17,875,658,1533,1482
3404-001,2016,2,26,18,1377,642,2019,1533
3404-001,2016,2,26,19,1277,547,1824,2019
3404-001,2016,2,26,20,797,493,1290,1824
3404-001,2016,2,26,21,670,282,952,1290
3404-001,2016,2,26,22,346,123,469,952
3404-001,2016,2,26,23,188,80,268,469
3404-001,2016,2,26,24,136,62,198,268
3404-001,2016,2,27,1,91,245,336,198
3404-001,2016,2,27,2,86,69,155,336
3404-001,2016,2,27,3,40,35,75,155
3404-001,2016,2,27,4,47,30,77,75
3404-001,2016,2,27,5,40,55,95,77
3404-001,2016,2,27,6,93,125,218,95
3404-001,2016,2,27,7,171,290,461,218
3404-001,2016,2,27,8,346,670,1016,461
3404-001,2016,2,27,9,509,619,1128,1016
3404-001,2016,2,27,10,529,552,1081,1128
3404-001,2016,2,27,11,545,539,1084,1081
3404-001,2016,2,27,12,532,528,1060,1084
3404-001,2016,2,27,13,507,509,1016,1060
3404-001,2016,2,27,14,499,558,1057,1016
3404-001,2016,2,27,15,548,440,988,1057
3404-001,2016,2,27,16,585,462,1047,988
3404-001,2016,2,27,17,664,440,1104,1047
3404-001,2016,2,27,18,891,448,1339,1104
3404-001,2016,2,27,19,563,401,964,1339
3404-001,2016,2,27,20,340,291,631,964
3404-001,2016,2,27,21,253,212,465,631
3404-001,2016,2,27,22,166,144,310,465
3404-001,2016,2,27,23,119,114,233,310
3404-001,2016,2,27,24,78,81,159,233
3404-001,2016,2,28,1,68,52,120,159
3404-001,2016,2,28,2,40,40,80,120
3404-001,2016,2,28,3,32,28,60,80
3404-001,2016,2,28,4,28,26,54,60
3404-001,2016,2,28,5,30,27,57,54
3404-001,2016,2,28,6,42,63,105,57
3404-001,2016,2,28,7,60,114,174,105
3404-001,2016,2,28,8,130,238,368,174
3404-001,2016,2,28,9,197,241,438,368
3404-001,2016,2,28,10,234,241,475,438
3404-001,2016,2,28,11,256,338,594,475
3404-001,2016,2,28,12,298,330,628,594
3404-001,2016,2,28,13,365,344,709,628
3404-001,2016,2,28,14,386,316,702,709
3404-001,2016,2,28,15,374,275,649,702
3404-001,2016,2,28,16,409,255,664,649
3404-001,2016,2,28,17,352,205,557,664
3404-001,2016,2,28,18,410,201,611,557
3404-001,2016,2,28,19,308,259,567,611
3404-001,2016,2,28,20,179,246,425,567
3404-001,2016,2,28,21,146,196,342,425
3404-001,2016,2,28,22,88,174,262,342
3404-001,2016,2,28,23,71,120,191,262
3404-001,2016,2,28,24,39,95,134,191
3404-001,2016,2,29,1,53,74,127,134
3404-001,2016,2,29,2,30,52,82,127
3404-001,2016,2,29,3,23,34,57,82
3404-001,2016,2,29,4,29,36,65,57
3404-001,2016,2,29,5,52,69,121,65
3404-001,2016,2,29,6,118,226,344,121
3404-001,2016,2,29,7,216,607,823,344
3404-001,2016,2,29,8,514,1928,2442,823
3404-001,2016,2,29,9,694,1395,2089,2442
3404-001,2016,2,29,10,651,715,1366,2089
3404-001,2016,2,29,11,716,683,1399,1366
3404-001,2016,2,29,12,658,680,1338,1399
3404-001,2016,2,29,13,558,610,1168,1338
3404-001,2016,2,29,14,674,678,1352,1168
3404-001,2016,2,29,15,785,723,1508,1352
3404-001,2016,2,29,16,831,713,1544,1508
3404-001,2016,2,29,17,846,632,1478,1544
3404-001,2016,2,29,18,1137,583,1720,1478
3404-001,2016,2,29,19,1023,464,1487,1720
3404-001,2016,2,29,20,723,391,1114,1487
3404-001,2016,2,29,21,691,261,952,1114
3404-001,2016,2,29,22,419,210,629,952
3404-001,2016,2,29,23,216,132,348,629
3404-001,2016,2,29,24,119,94,213,348
3404-001,2016,3,1,1,76,185,261,213
3404-001,2016,3,1,2,52,51,103,261
3404-001,2016,3,1,3,35,34,69,103
3404-001,2016,3,1,4,30,26,56,69
3404-001,2016,3,1,5,44,42,86,56
3404-001,2016,3,1,6,63,109,172,86
3404-001,2016,3,1,7,110,259,369,172
3404-001,2016,3,1,8,220,636,856,369
3404-001,2016,3,1,9,373,530,903,856
3404-001,2016,3,1,10,386,451,837,903
3404-001,2016,3,1,11,421,456,877,837
3404-001,2016,3,1,12,481,653,1134,877
3404-001,2016,3,1,13,438,580,1018,1134
3404-001,2016,3,1,14,455,686,1141,1018
3404-001,2016,3,1,15,495,704,1199,1141
3404-001,2016,3,1,16,553,654,1207,1199
3404-001,2016,3,1,17,591,615,1206,1207
3404-001,2016,3,1,18,757,584,1341,1206
3404-001,2016,3,1,19,507,488,995,1341
3404-001,2016,3,1,20,314,308,622,995
3404-001,2016,3,1,21,245,241,486,622
3404-001,2016,3,1,22,168,194,362,486
3404-001,2016,3,1,23,124,133,257,362
3404-001,2016,3,1,24,52,93,145,257
3404-001,2016,3,2,1,45,54,99,145
3404-001,2016,3,2,2,26,41,67,99
3404-001,2016,3,2,3,24,36,60,67
3404-001,2016,3,2,4,29,36,65,60
3404-001,2016,3,2,5,49,59,108,65
3404-001,2016,3,2,6,100,189,289,108
3404-001,2016,3,2,7,193,540,733,289
3404-001,2016,3,2,8,531,1854,2385,733
3404-001,2016,3,2,9,722,1363,2085,2385
3404-001,2016,3,2,10,661,751,1412,2085
3404-001,2016,3,2,11,688,766,1454,1412
3404-001,2016,3,2,12,693,650,1343,1454
3404-001,2016,3,2,13,591,582,1173,1343
3404-001,2016,3,2,14,683,690,1373,1173
3404-001,2016,3,2,15,781,731,1512,1373
3404-001,2016,3,2,16,794,665,1459,1512
3404-001,2016,3,2,17,835,613,1448,1459
3404-001,2016,3,2,18,1278,586,1864,1448
3404-001,2016,3,2,19,1099,462,1561,1864
3404-001,2016,3,2,20,745,392,1137,1561
3404-001,2016,3,2,21,557,301,858,1137
3404-001,2016,3,2,22,412,204,616,858
3404-001,2016,3,2,23,205,144,349,616
3404-001,2016,3,2,24,126,91,217,349
3404-001,2016,3,3,1,81,75,156,217
3404-001,2016,3,3,2,65,49,114,156
3404-001,2016,3,3,3,41,43,84,114
3404-001,2016,3,3,4,43,37,80,84
3404-001,2016,3,3,5,62,64,126,80
3404-001,2016,3,3,6,124,181,305,126
3404-001,2016,3,3,7,233,524,757,305
3404-001,2016,3,3,8,496,1806,2302,757
3404-001,2016,3,3,9,755,1346,2101,2302
3404-001,2016,3,3,10,694,717,1411,2101
3404-001,2016,3,3,11,719,787,1506,1411
3404-001,2016,3,3,12,688,700,1388,1506
3404-001,2016,3,3,13,588,641,1229,1388
3404-001,2016,3,3,14,681,691,1372,1229
3404-001,2016,3,3,15,757,731,1488,1372
3404-001,2016,3,3,16,840,663,1503,1488
3404-001,2016,3,3,17,860,664,1524,1503
3404-001,2016,3,3,18,1148,664,1812,1524
3404-001,2016,3,3,19,1161,489,1650,1812
3404-001,2016,3,3,20,763,416,1179,1650
3404-001,2016,3,3,21,675,292,967,1179
3404-001,2016,3,3,22,411,233,644,967
3404-001,2016,3,3,23,207,166,373,644
3404-001,2016,3,3,24,124,96,220,373
3404-001,2016,3,4,1,72,72,144,220
3404-001,2016,3,4,2,60,43,103,144
3404-001,2016,3,4,3,52,39,91,103
3404-001,2016,3,4,4,39,54,93,91
3404-001,2016,3,4,5,63,60,123,93
3404-001,2016,3,4,6,114,177,291,123
3404-001,2016,3,4,7,178,511,689,291
3404-001,2016,3,4,8,507,1763,2270,689
3404-001,2016,3,4,9,760,1353,2113,2270
3404-001,2016,3,4,10,732,750,1482,2113
3404-001,2016,3,4,11,753,756,1509,1482
3404-001,2016,3,4,12,694,674,1368,1509
3404-001,2016,3,4,13,639,665,1304,1368
3404-001,2016,3,4,14,691,723,1414,1304
3404-001,2016,3,4,15,853,678,1531,1414
3404-001,2016,3,4,16,812,706,1518,1531
3404-001,2016,3,4,17,885,609,1494,1518
3404-001,2016,3,4,18,1464,629,2093,1494
3404-001,2016,3,4,19,1297,559,1856,2093
3404-001,2016,3,4,20,861,483,1344,1856
3404-001,2016,3,4,21,632,313,945,1344
3404-001,2016,3,4,22,343,203,546,945
3404-001,2016,3,4,23,199,126,325,546
3404-001,2016,3,4,24,126,49,175,325
3404-001,2016,3,5,1,86,59,145,175
3404-001,2016,3,5,2,68,45,113,145
3404-001,2016,3,5,3,48,36,84,113
3404-001,2016,3,5,4,48,33,81,84
3404-001,2016,3,5,5,58,42,100,81
3404-001,2016,3,5,6,86,99,185,100
3404-001,2016,3,5,7,113,261,374,185
3404-001,2016,3,5,8,282,627,909,374
3404-001,2016,3,5,9,509,608,1117,909
3404-001,2016,3,5,10,521,472,993,1117
3404-001,2016,3,5,11,515,480,995,993
3404-001,2016,3,5,12,506,537,1043,995
3404-001,2016,3,5,13,503,457,960,1043
3404-001,2016,3,5,14,472,523,995,960
3404-001,2016,3,5,15,515,471,986,995
3404-001,2016,3,5,16,594,465,1059,986
3404-001,2016,3,5,17,623,404,1027,1059
3404-001,2016,3,5,18,766,371,1137,1027
3404-001,2016,3,5,19,432,340,772,1137
3404-001,2016,3,5,20,268,282,550,772
3404-001,2016,3,5,21,212,188,400,550
3404-001,2016,3,5,22,141,115,256,400
3404-001,2016,3,5,23,100,107,207,256
3404-001,2016,3,5,24,48,66,114,207
3404-001,2016,3,6,1,44,39,83,114
3404-001,2016,3,6,2,37,40,77,83
3404-001,2016,3,6,3,44,25,69,77
3404-001,2016,3,6,4,32,20,52,69
3404-001,2016,3,6,5,23,33,56,52
3404-001,2016,3,6,6,50,50,100,56
3404-001,2016,3,6,7,74,132,206,100
3404-001,2016,3,6,8,170,205,375,206
3404-001,2016,3,6,9,275,249,524,375
3404-001,2016,3,6,10,240,266,506,524
3404-001,2016,3,6,11,254,331,585,506
3404-001,2016,3,6,12,382,392,774,585
3404-001,2016,3,6,13,351,373,724,774
3404-001,2016,3,6,14,345,367,712,724
3404-001,2016,3,6,15,398,452,850,712
3404-001,2016,3,6,16,481,532,1013,850
3404-001,2016,3,6,17,500,382,882,1013
3404-001,2016,3,6,18,547,397,944,882
3404-001,2016,3,6,19,398,337,735,944
3404-001,2016,3,6,20,272,240,512,735
3404-001,2016,3,6,21,207,203,410,512
3404-001,2016,3,6,22,177,178,355,410
3404-001,2016,3,6,23,104,149,253,355
3404-001,2016,3,6,24,55,105,160,253
3404-001,2016,3,7,1,48,77,125,160
3404-001,2016,3,7,2,29,46,75,125
3404-001,2016,3,7,3,21,42,63,75
3404-001,2016,3,7,4,30,41,71,63
3404-001,2016,3,7,5,60,76,136,71
3404-001,2016,3,7,6,122,238,360,136
3404-001,2016,3,7,7,223,615,838,360
3404-001,2016,3,7,8,530,1915,2445,838
3404-001,2016,3,7,9,727,1376,2103,2445
3404-001,2016,3,7,10,652,716,1368,2103
3404-001,2016,3,7,11,726,707,1433,1368
3404-001,2016,3,7,12,702,688,1390,1433
3404-001,2016,3,7,13,535,629,1164,1390
3404-001,2016,3,7,14,605,700,1305,1164
3404-001,2016,3,7,15,845,711,1556,1305
3404-001,2016,3,7,16,824,692,1516,1556
3404-001,2016,3,7,17,845,623,1468,1516
3404-001,2016,3,7,18,1091,597,1688,1468
3404-001,2016,3,7,19,1048,447,1495,1688
3404-001,2016,3,7,20,728,400,1128,1495
3404-001,2016,3,7,21,716,255,971,1128
3404-001,2016,3,7,22,423,233,656,971
3404-001,2016,3,7,23,219,132,351,656
3404-001,2016,3,7,24,121,98,219,351
3404-001,2016,3,8,1,63,74,137,219
3404-001,2016,3,8,2,71,47,118,137
3404-001,2016,3,8,3,41,51,92,118
3404-001,2016,3,8,4,49,72,121,92
3404-001,2016,3,8,5,57,68,125,121
3404-001,2016,3,8,6,141,184,325,125
3404-001,2016,3,8,7,202,527,729,325
3404-001,2016,3,8,8,527,1788,2315,729
3404-001,2016,3,8,9,779,1295,2074,2315
3404-001,2016,3,8,10,722,850,1572,2074
3404-001,2016,3,8,11,767,778,1545,1572
3404-001,2016,3,8,12,687,720,1407,1545
3404-001,2016,3,8,13,607,664,1271,1407
3404-001,2016,3,8,14,656,699,1355,1271
3404-001,2016,3,8,15,788,760,1548,1355
3404-001,2016,3,8,16,907,706,1613,1548
3404-001,2016,3,8,17,844,648,1492,1613
3404-001,2016,3,8,18,1230,572,1802,1492
3404-001,2016,3,8,19,1077,478,1555,1802
3404-001,2016,3,8,20,699,367,1066,1555
3404-001,2016,3,8,21,676,280,956,1066
3404-001,2016,3,8,22,424,209,633,956
3404-001,2016,3,8,23,238,166,404,633
3404-001,2016,3,8,24,129,87,216,404
3404-001,2016,3,9,1,85,72,157,216
3404-001,2016,3,9,2,72,45,117,157
3404-001,2016,3,9,3,44,33,77,117
3404-001,2016,3,9,4,45,38,83,77
3404-001,2016,3,9,5,62,81,143,83
3404-001,2016,3,9,6,113,174,287,143
3404-001,2016,3,9,7,219,501,720,287
3404-001,2016,3,9,8,538,1726,2264,720
3404-001,2016,3,9,9,776,1323,2099,2264
3404-001,2016,3,9,10,668,759,1427,2099
3404-001,2016,3,9,11,729,749,1478,1427
3404-001,2016,3,9,12,681,700,1381,1478
3404-001,2016,3,9,13,590,584,1174,1381
3404-001,2016,3,9,14,725,730,1455,1174
3404-001,2016,3,9,15,777,701,1478,1455
3404-001,2016,3,9,16,818,668,1486,1478
3404-001,2016,3,9,17,857,616,1473,1486
3404-001,2016,3,9,18,1345,576,1921,1473
3404-001,2016,3,9,19,1160,506,1666,1921
3404-001,2016,3,9,20,663,416,1079,1666
3404-001,2016,3,9,21,555,267,822,1079
3404-001,2016,3,9,22,363,205,568,822
3404-001,2016,3,9,23,216,142,358,568
3404-001,2016,3,9,24,113,103,216,358
3404-001,2016,3,10,1,73,77,150,216
3404-001,2016,3,10,2,68,47,115,150
3404-001,2016,3,10,3,53,55,108,115
3404-001,2016,3,10,4,39,39,78,108
3404-001,2016,3,10,5,58,64,122,78
3404-001,2016,3,10,6,118,181,299,122
3404-001,2016,3,10,7,226,490,716,299
3404-001,2016,3,10,8,536,1834,2370,716
3404-001,2016,3,10,9,798,1344,2142,2370
3404-001,2016,3,10,10,733,801,1534,2142
3404-001,2016,3,10,11,760,744,1504,1534
3404-001,2016,3,10,12,724,712,1436,1504
3404-001,2016,3,10,13,578,587,1165,1436
3404-001,2016,3,10,14,674,681,1355,1165
3404-001,2016,3,10,15,802,675,1477,1355
3404-001,2016,3,10,16,809,656,1465,1477
3404-001,2016,3,10,17,790,656,1446,1465
3404-001,2016,3,10,18,1149,569,1718,1446
3404-001,2016,3,10,19,1075,539,1614,1718
3404-001,2016,3,10,20,722,395,1117,1614
3404-001,2016,3,10,21,715,268,983,1117
3404-001,2016,3,10,22,366,206,572,983
3404-001,2016,3,10,23,221,165,386,572
3404-001,2016,3,10,24,115,102,217,386
3404-001,2016,3,11,1,75,84,159,217
3404-001,2016,3,11,2,71,56,127,159
3404-001,2016,3,11,3,52,37,89,127
3404-001,2016,3,11,4,54,37,91,89
3404-001,2016,3,11,5,60,60,120,91
3404-001,2016,3,11,6,118,188,306,120
3404-001,2016,3,11,7,202,505,707,306
3404-001,2016,3,11,8,529,1755,2284,707
3404-001,2016,3,11,9,737,1348,2085,2284
3404-001,2016,3,11,10,710,806,1516,2085
3404-001,2016,3,11,11,720,728,1448,1516
3404-001,2016,3,11,12,684,684,1368,1448
3404-001,2016,3,11,13,639,625,1264,1368
3404-001,2016,3,11,14,656,668,1324,1264
3404-001,2016,3,11,15,812,741,1553,1324
3404-001,2016,3,11,16,843,710,1553,1553
3404-001,2016,3,11,17,895,642,1537,1553
3404-001,2016,3,11,18,1422,616,2038,1537
3404-001,2016,3,11,19,1332,612,1944,2038
3404-001,2016,3,11,20,896,469,1365,1944
3404-001,2016,3,11,21,730,302,1032,1365
3404-001,2016,3,11,22,375,215,590,1032
3404-001,2016,3,11,23,215,186,401,590
3404-001,2016,3,11,24,132,101,233,401
3404-001,2016,3,12,1,100,86,186,233
3404-001,2016,3,12,2,69,53,122,186
3404-001,2016,3,12,3,46,43,89,122
3404-001,2016,3,12,4,34,33,67,89
3404-001,2016,3,12,5,58,69,127,67
3404-001,2016,3,12,6,108,141,249,127
3404-001,2016,3,12,7,160,328,488,249
3404-001,2016,3,12,8,381,751,1132,488
3404-001,2016,3,12,9,550,700,1250,1132
3404-001,2016,3,12,10,547,571,1118,1250
3404-001,2016,3,12,11,571,610,1181,1118
3404-001,2016,3,12,12,508,599,1107,1181
3404-001,2016,3,12,13,535,526,1061,1107
3404-001,2016,3,12,14,525,534,1059,1061
3404-001,2016,3,12,15,621,522,1143,1059
3404-001,2016,3,12,16,654,489,1143,1143
3404-001,2016,3,12,17,711,445,1156,1143
3404-001,2016,3,12,18,913,484,1397,1156
3404-001,2016,3,12,19,613,409,1022,1397
3404-001,2016,3,12,20,357,297,654,1022
3404-001,2016,3,12,21,290,234,524,654
3404-001,2016,3,12,22,156,140,296,524
3404-001,2016,3,12,23,101,148,249,296
3404-001,2016,3,12,24,76,68,144,249
3404-001,2016,3,13,1,48,57,105,144
3404-001,2016,3,13,2,51,50,101,105
3404-001,2016,3,13,3,37,28,65,101
3404-001,2016,3,13,4,24,15,39,65
3404-001,2016,3,13,5,29,35,64,39
3404-001,2016,3,13,6,60,75,135,64
3404-001,2016,3,13,7,82,140,222,135
3404-001,2016,3,13,8,159,241,400,222
3404-001,2016,3,13,9,239,288,527,400
3404-001,2016,3,13,10,264,273,537,527
3404-001,2016,3,13,11,315,340,655,537
3404-001,2016,3,13,12,293,371,664,655
3404-001,2016,3,13,13,358,357,715,664
3404-001,2016,3,13,14,376,400,776,715
3404-001,2016,3,13,15,435,420,855,776
3404-001,2016,3,13,16,475,375,850,855
3404-001,2016,3,13,17,524,361,885,850
3404-001,2016,3,13,18,599,340,939,885
3404-001,2016,3,13,19,401,359,760,939
3404-001,2016,3,13,20,299,283,582,760
3404-001,2016,3,13,21,250,239,489,582
3404-001,2016,3,13,22,170,204,374,489
3404-001,2016,3,13,23,106,157,263,374
3404-001,2016,3,13,24,51,126,177,263
3404-001,2016,3,14,1,46,73,119,177
3404-001,2016,3,14,2,37,38,75,119
3404-001,2016,3,14,3,31,34,65,75
3404-001,2016,3,14,4,23,37,60,65
3404-001,2016,3,14,5,39,50,89,60
3404-001,2016,3,14,6,145,210,355,89
3404-001,2016,3,14,7,202,620,822,355
3404-001,2016,3,14,8,498,1828,2326,822
3404-001,2016,3,14,9,729,1423,2152,2326
3404-001,2016,3,14,10,661,664,1325,2152
3404-001,2016,3,14,11,703,692,1395,1325
3404-001,2016,3,14,12,665,665,1330,1395
3404-001,2016,3,14,13,635,629,1264,1330
3404-001,2016,3,14,14,685,716,1401,1264
3404-001,2016,3,14,15,746,689,1435,1401
3404-001,2016,3,14,16,831,676,1507,1435
3404-001,2016,3,14,17,819,631,1450,1507
3404-001,2016,3,14,18,1206,581,1787,1450
3404-001,2016,3,14,19,1104,532,1636,1787
3404-001,2016,3,14,20,771,399,1170,1636
3404-001,2016,3,14,21,663,266,929,1170
3404-001,2016,3,14,22,421,206,627,929
3404-001,2016,3,14,23,218,137,355,627
3404-001,2016,3,14,24,105,115,220,355
3404-001,2016,3,15,1,82,80,162,220
3404-001,2016,3,15,2,61,55,116,162
3404-001,2016,3,15,3,48,51,99,116
3404-001,2016,3,15,4,43,46,89,99
3404-001,2016,3,15,5,65,69,134,89
3404-001,2016,3,15,6,119,190,309,134
3404-001,2016,3,15,7,207,529,736,309
3404-001,2016,3,15,8,557,1810,2367,736
3404-001,2016,3,15,9,774,1350,2124,2367
3404-001,2016,3,15,10,706,792,1498,2124
3404-001,2016,3,15,11,750,713,1463,1498
3404-001,2016,3,15,12,709,675,1384,1463
3404-001,2016,3,15,13,598,615,1213,1384
3404-001,2016,3,15,14,694,668,1362,1213
3404-001,2016,3,15,15,793,723,1516,1362
3404-001,2016,3,15,16,854,637,1491,1516
3404-001,2016,3,15,17,822,607,1429,1491
3404-001,2016,3,15,18,1218,586,1804,1429
3404-001,2016,3,15,19,1092,504,1596,1804
3404-001,2016,3,15,20,792,454,1246,1596
3404-001,2016,3,15,21,685,312,997,1246
3404-001,2016,3,15,22,401,207,608,997
3404-001,2016,3,15,23,254,164,418,608
3404-001,2016,3,15,24,116,119,235,418
3404-001,2016,3,16,1,81,75,156,235
3404-001,2016,3,16,2,55,74,129,156
3404-001,2016,3,16,3,48,56,104,129
3404-001,2016,3,16,4,44,41,85,104
3404-001,2016,3,16,5,74,67,141,85
3404-001,2016,3,16,6,112,189,301,141
3404-001,2016,3,16,7,218,522,740,301
3404-001,2016,3,16,8,544,1748,2292,740
3404-001,2016,3,16,9,812,1300,2112,2292
3404-001,2016,3,16,10,783,741,1524,2112
3404-001,2016,3,16,11,761,732,1493,1524
3404-001,2016,3,16,12,732,707,1439,1493
3404-001,2016,3,16,13,651,611,1262,1439
3404-001,2016,3,16,14,714,719,1433,1262
3404-001,2016,3,16,15,772,776,1548,1433
3404-001,2016,3,16,16,854,685,1539,1548
3404-001,2016,3,16,17,903,640,1543,1539
3404-001,2016,3,16,18,1436,580,2016,1543
3404-001,2016,3,16,19,1166,540,1706,2016
3404-001,2016,3,16,20,768,429,1197,1706
3404-001,2016,3,16,21,612,268,880,1197
3404-001,2016,3,16,22,342,217,559,880
3404-001,2016,3,16,23,186,159,345,559
3404-001,2016,3,16,24,140,97,237,345
3404-001,2016,3,17,1,84,83,167,237
3404-001,2016,3,17,2,59,42,101,167
3404-001,2016,3,17,3,44,35,79,101
3404-001,2016,3,17,4,40,47,87,79
3404-001,2016,3,17,5,72,67,139,87
3404-001,2016,3,17,6,105,194,299,139
3404-001,2016,3,17,7,203,544,747,299
3404-001,2016,3,17,8,516,1706,2222,747
3404-001,2016,3,17,9,839,1246,2085,2222
3404-001,2016,3,17,10,692,738,1430,2085
3404-001,2016,3,17,11,771,752,1523,1430
3404-001,2016,3,17,12,714,628,1342,1523
3404-001,2016,3,17,13,642,567,1209,1342
3404-001,2016,3,17,14,706,778,1484,1209
3404-001,2016,3,17,15,847,763,1610,1484
3404-001,2016,3,17,16,879,728,1607,1610
3404-001,2016,3,17,17,907,662,1569,1607
3404-001,2016,3,17,18,1197,590,1787,1569
3404-001,2016,3,17,19,1050,504,1554,1787
3404-001,2016,3,17,20,792,392,1184,1554
3404-001,2016,3,17,21,673,280,953,1184
3404-001,2016,3,17,22,413,223,636,953
3404-001,2016,3,17,23,224,155,379,636
3404-001,2016,3,17,24,131,91,222,379
3404-001,2016,3,18,1,72,106,178,222
3404-001,2016,3,18,2,80,52,132,178
3404-001,2016,3,18,3,32,31,63,132
3404-001,2016,3,18,4,38,57,95,63
3404-001,2016,3,18,5,65,68,133,95
3404-001,2016,3,18,6,99,186,285,133
3404-001,2016,3,18,7,211,505,716,285
3404-001,2016,3,18,8,492,1613,2105,716
3404-001,2016,3,18,9,768,1297,2065,2105
3404-001,2016,3,18,10,727,691,1418,2065
3404-001,2016,3,18,11,741,666,1407,1418
3404-001,2016,3,18,12,773,635,1408,1407
3404-001,2016,3,18,13,593,576,1169,1408
3404-001,2016,3,18,14,689,697,1386,1169
3404-001,2016,3,18,15,873,727,1600,1386
3404-001,2016,3,18,16,819,711,1530,1600
3404-001,2016,3,18,17,871,592,1463,1530
3404-001,2016,3,18,18,1417,617,2034,1463
3404-001,2016,3,18,19,1399,576,1975,2034
3404-001,2016,3,18,20,843,501,1344,1975
3404-001,2016,3,18,21,675,301,976,1344
3404-001,2016,3,18,22,400,231,631,976
3404-001,2016,3,18,23,227,141,368,631
3404-001,2016,3,18,24,117,97,214,368
3404-001,2016,3,19,1,72,71,143,214
3404-001,2016,3,19,2,73,55,128,143
3404-001,2016,3,19,3,49,51,100,128
3404-001,2016,3,19,4,50,50,100,100
3404-001,2016,3,19,5,60,57,117,100
3404-001,2016,3,19,6,101,153,254,117
3404-001,2016,3,19,7,187,341,528,254
3404-001,2016,3,19,8,334,786,1120,528
3404-001,2016,3,19,9,586,728,1314,1120
3404-001,2016,3,19,10,529,620,1149,1314
3404-001,2016,3,19,11,546,599,1145,1149
3404-001,2016,3,19,12,520,595,1115,1145
3404-001,2016,3,19,13,518,561,1079,1115
3404-001,2016,3,19,14,538,590,1128,1079
3404-001,2016,3,19,15,614,586,1200,1128
3404-001,2016,3,19,16,633,518,1151,1200
3404-001,2016,3,19,17,696,461,1157,1151
3404-001,2016,3,19,18,998,479,1477,1157
3404-001,2016,3,19,19,723,435,1158,1477
3404-001,2016,3,19,20,463,298,761,1158
3404-001,2016,3,19,21,321,223,544,761
3404-001,2016,3,19,22,195,157,352,544
3404-001,2016,3,19,23,135,119,254,352
3404-001,2016,3,19,24,95,88,183,254
3404-001,2016,3,20,1,59,73,132,183
3404-001,2016,3,20,2,35,30,65,132
3404-001,2016,3,20,3,34,51,85,65
3404-001,2016,3,20,4,26,24,50,85
3404-001,2016,3,20,5,41,21,62,50
3404-001,2016,3,20,6,50,59,109,62
3404-001,2016,3,20,7,93,160,253,109
3404-001,2016,3,20,8,186,235,421,253
3404-001,2016,3,20,9,235,248,483,421
3404-001,2016,3,20,10,260,282,542,483
3404-001,2016,3,20,11,280,382,662,542
3404-001,2016,3,20,12,296,412,708,662
3404-001,2016,3,20,13,331,392,723,708
3404-001,2016,3,20,14,362,409,771,723
3404-001,2016,3,20,15,442,450,892,771
3404-001,2016,3,20,16,562,408,970,892
3404-001,2016,3,20,17,643,406,1049,970
3404-001,2016,3,20,18,677,379,1056,1049
3404-001,2016,3,20,19,530,346,876,1056
3404-001,2016,3,20,20,367,249,616,876
3404-001,2016,3,20,21,240,256,496,616
3404-001,2016,3,20,22,176,204,380,496
3404-001,2016,3,20,23,110,148,258,380
3404-001,2016,3,20,24,56,115,171,258
3404-001,2016,3,21,1,39,61,100,171
3404-001,2016,3,21,2,29,56,85,100
3404-001,2016,3,21,3,29,35,64,85
3404-001,2016,3,21,4,25,31,56,64
3404-001,2016,3,21,5,51,67,118,56
3404-001,2016,3,21,6,109,195,304,118
3404-001,2016,3,21,7,234,629,863,304
3404-001,2016,3,21,8,539,1755,2294,863
3404-001,2016,3,21,9,682,1393,2075,2294
3404-001,2016,3,21,10,647,763,1410,2075
3404-001,2016,3,21,11,743,724,1467,1410
3404-001,2016,3,21,12,729,650,1379,1467
3404-001,2016,3,21,13,612,613,1225,1379
3404-001,2016,3,21,14,700,754,1454,1225
3404-001,2016,3,21,15,790,702,1492,1454
3404-001,2016,3,21,16,794,672,1466,1492
3404-001,2016,3,21,17,830,639,1469,1466
3404-001,2016,3,21,18,1240,585,1825,1469
3404-001,2016,3,21,19,1120,534,1654,1825
3404-001,2016,3,21,20,722,398,1120,1654
3404-001,2016,3,21,21,738,258,996,1120
3404-001,2016,3,21,22,410,198,608,996
3404-001,2016,3,21,23,240,164,404,608
3404-001,2016,3,21,24,126,92,218,404
3404-001,2016,3,22,1,95,80,175,218
3404-001,2016,3,22,2,63,60,123,175
3404-001,2016,3,22,3,39,48,87,123
3404-001,2016,3,22,4,50,30,80,87
3404-001,2016,3,22,5,72,74,146,80
3404-001,2016,3,22,6,123,211,334,146
3404-001,2016,3,22,7,221,593,814,334
3404-001,2016,3,22,8,587,1736,2323,814
3404-001,2016,3,22,9,807,1453,2260,2323
3404-001,2016,3,22,10,738,754,1492,2260
3404-001,2016,3,22,11,772,730,1502,1492
3404-001,2016,3,22,12,749,682,1431,1502
3404-001,2016,3,22,13,610,591,1201,1431
3404-001,2016,3,22,14,744,730,1474,1201
3404-001,2016,3,22,15,817,729,1546,1474
3404-001,2016,3,22,16,816,644,1460,1546
3404-001,2016,3,22,17,869,611,1480,1460
3404-001,2016,3,22,18,1308,570,1878,1480
3404-001,2016,3,22,19,1061,442,1503,1878
3404-001,2016,3,22,20,790,379,1169,1503
3404-001,2016,3,22,21,687,314,1001,1169
3404-001,2016,3,22,22,359,226,585,1001
3404-001,2016,3,22,23,231,146,377,585
3404-001,2016,3,22,24,103,137,240,377
3404-001,2016,3,23,1,80,72,152,240
3404-001,2016,3,23,2,67,61,128,152
3404-001,2016,3,23,3,47,34,81,128
3404-001,2016,3,23,4,52,55,107,81
3404-001,2016,3,23,5,58,77,135,107
3404-001,2016,3,23,6,126,210,336,135
3404-001,2016,3,23,7,260,584,844,336
3404-001,2016,3,23,8,564,1851,2415,844
3404-001,2016,3,23,9,821,1275,2096,2415
3404-001,2016,3,23,10,772,795,1567,2096
3404-001,2016,3,23,11,756,713,1469,1567
3404-001,2016,3,23,12,673,637,1310,1469
3404-001,2016,3,23,13,658,576,1234,1310
3404-001,2016,3,23,14,702,636,1338,1234
3404-001,2016,3,23,15,796,692,1488,1338
3404-001,2016,3,23,16,893,646,1539,1488
3404-001,2016,3,23,17,938,548,1486,1539
3404-001,2016,3,23,18,1378,581,1959,1486
3404-001,2016,3,23,19,1209,521,1730,1959
3404-001,2016,3,23,20,731,398,1129,1730
3404-001,2016,3,23,21,557,272,829,1129
3404-001,2016,3,23,22,360,187,547,829
3404-001,2016,3,23,23,208,136,344,547
3404-001,2016,3,23,24,109,118,227,344
3404-001,2016,3,24,1,101,89,190,227
3404-001,2016,3,24,2,68,64,132,190
3404-001,2016,3,24,3,44,50,94,132
3404-001,2016,3,24,4,46,44,90,94
3404-001,2016,3,24,5,80,76,156,90
3404-001,2016,3,24,6,131,216,347,156
3404-001,2016,3,24,7,236,576,812,347
3404-001,2016,3,24,8,595,1780,2375,812
3404-001,2016,3,24,9,831,1165,1996,2375
3404-001,2016,3,24,10,762,722,1484,1996
3404-001,2016,3,24,11,781,774,1555,1484
3404-001,2016,3,24,12,714,683,1397,1555
3404-001,2016,3,24,13,675,554,1229,1397
3404-001,2016,3,24,14,678,638,1316,1229
3404-001,2016,3,24,15,833,728,1561,1316
3404-001,2016,3,24,16,881,651,1532,1561
3404-001,2016,3,24,17,924,625,1549,1532
3404-001,2016,3,24,18,1244,512,1756,1549
3404-001,2016,3,24,19,1052,482,1534,1756
3404-001,2016,3,24,20,761,360,1121,1534
3404-001,2016,3,24,21,699,270,969,1121
3404-001,2016,3,24,22,393,213,606,969
3404-001,2016,3,24,23,219,137,356,606
3404-001,2016,3,24,24,121,95,216,356
3404-001,2016,3,25,1,93,91,184,216
3404-001,2016,3,25,2,91,41,132,184
3404-001,2016,3,25,3,43,62,105,132
3404-001,2016,3,25,4,57,39,96,105
3404-001,2016,3,25,5,69,77,146,96
3404-001,2016,3,25,6,140,195,335,146
3404-001,2016,3,25,7,246,591,837,335
3404-001,2016,3,25,8,561,1786,2347,837
3404-001,2016,3,25,9,825,1134,1959,2347
3404-001,2016,3,25,10,720,761,1481,1959
3404-001,2016,3,25,11,760,702,1462,1481
3404-001,2016,3,25,12,749,643,1392,1462
3404-001,2016,3,25,13,675,611,1286,1392
3404-001,2016,3,25,14,754,662,1416,1286
3404-001,2016,3,25,15,867,727,1594,1416
3404-001,2016,3,25,16,921,627,1548,1594
3404-001,2016,3,25,17,994,598,1592,1548
3404-001,2016,3,25,18,1395,585,1980,1592
3404-001,2016,3,25,19,1372,566,1938,1980
3404-001,2016,3,25,20,869,441,1310,1938
3404-001,2016,3,25,21,659,263,922,1310
3404-001,2016,3,25,22,363,208,571,922
3404-001,2016,3,25,23,205,158,363,571
3404-001,2016,3,25,24,115,107,222,363
3404-001,2016,3,26,1,82,62,144,222
3404-001,2016,3,26,2,86,54,140,144
3404-001,2016,3,26,3,44,43,87,140
3404-001,2016,3,26,4,48,42,90,87
3404-001,2016,3,26,5,67,49,116,90
3404-001,2016,3,26,6,116,160,276,116
3404-001,2016,3,26,7,182,372,554,276
3404-001,2016,3,26,8,403,769,1172,554
3404-001,2016,3,26,9,584,575,1159,1172
3404-001,2016,3,26,10,532,598,1130,1159
3404-001,2016,3,26,11,575,611,1186,1130
3404-001,2016,3,26,12,527,522,1049,1186
3404-001,2016,3,26,13,509,486,995,1049
3404-001,2016,3,26,14,550,523,1073,995
3404-001,2016,3,26,15,585,500,1085,1073
3404-001,2016,3,26,16,673,460,1133,1085
3404-001,2016,3,26,17,741,402,1143,1133
3404-001,2016,3,26,18,1016,421,1437,1143
3404-001,2016,3,26,19,613,361,974,1437
3404-001,2016,3,26,20,381,260,641,974
3404-001,2016,3,26,21,286,188,474,641
3404-001,2016,3,26,22,193,159,352,474
3404-001,2016,3,26,23,110,90,200,352
3404-001,2016,3,26,24,93,74,167,200
3404-001,2016,3,27,1,68,72,140,167
3404-001,2016,3,27,2,31,26,57,140
3404-001,2016,3,27,3,23,32,55,57
3404-001,2016,3,27,4,40,29,69,55
3404-001,2016,3,27,5,23,27,50,69
3404-001,2016,3,27,6,72,67,139,50
3404-001,2016,3,27,7,92,177,269,139
3404-001,2016,3,27,8,171,250,421,269
3404-001,2016,3,27,9,248,268,516,421
3404-001,2016,3,27,10,306,299,605,516
3404-001,2016,3,27,11,315,368,683,605
3404-001,2016,3,27,12,331,385,716,683
3404-001,2016,3,27,13,340,369,709,716
3404-001,2016,3,27,14,374,412,786,709
3404-001,2016,3,27,15,487,397,884,786
3404-001,2016,3,27,16,561,388,949,884
3404-001,2016,3,27,17,659,345,1004,949
3404-001,2016,3,27,18,684,323,1007,1004
3404-001,2016,3,27,19,548,289,837,1007
3404-001,2016,3,27,20,364,245,609,837
3404-001,2016,3,27,21,270,206,476,609
3404-001,2016,3,27,22,187,212,399,476
3404-001,2016,3,27,23,88,162,250,399
3404-001,2016,3,27,24,59,107,166,250
3404-001,2016,3,28,1,45,50,95,166
3404-001,2016,3,28,2,14,35,49,95
3404-001,2016,3,28,3,27,39,66,49
3404-001,2016,3,28,4,27,39,66,66
3404-001,2016,3,28,5,50,69,119,66
3404-001,2016,3,28,6,123,219,342,119
3404-001,2016,3,28,7,259,657,916,342
3404-001,2016,3,28,8,554,1806,2360,916
3404-001,2016,3,28,9,745,1217,1962,2360
3404-001,2016,3,28,10,682,713,1395,1962
3404-001,2016,3,28,11,734,695,1429,1395
3404-001,2016,3,28,12,663,602,1265,1429
3404-001,2016,3,28,13,647,578,1225,1265
3404-001,2016,3,28,14,671,594,1265,1225
3404-001,2016,3,28,15,801,701,1502,1265
3404-001,2016,3,28,16,841,590,1431,1502
3404-001,2016,3,28,17,887,609,1496,1431
3404-001,2016,3,28,18,1193,506,1699,1496
3404-001,2016,3,28,19,1116,454,1570,1699
3404-001,2016,3,28,20,819,369,1188,1570
3404-001,2016,3,28,21,738,246,984,1188
3404-001,2016,3,28,22,392,198,590,984
3404-001,2016,3,28,23,229,185,414,590
3404-001,2016,3,28,24,124,100,224,414
3404-001,2016,3,29,1,74,101,175,224
3404-001,2016,3,29,2,57,66,123,175
3404-001,2016,3,29,3,39,59,98,123
3404-001,2016,3,29,4,54,65,119,98
3404-001,2016,3,29,5,71,107,178,119
3404-001,2016,3,29,6,137,220,357,178
3404-001,2016,3,29,7,227,616,843,357
3404-001,2016,3,29,8,524,1663,2187,843
3404-001,2016,3,29,9,827,1139,1966,2187
3404-001,2016,3,29,10,748,711,1459,1966
3404-001,2016,3,29,11,723,679,1402,1459
3404-001,2016,3,29,12,689,582,1271,1402
3404-001,2016,3,29,13,625,550,1175,1271
3404-001,2016,3,29,14,711,631,1342,1175
3404-001,2016,3,29,15,804,635,1439,1342
3404-001,2016,3,29,16,837,610,1447,1439
3404-001,2016,3,29,17,928,555,1483,1447
3404-001,2016,3,29,18,1216,509,1725,1483
3404-001,2016,3,29,19,1097,426,1523,1725
3404-001,2016,3,29,20,745,405,1150,1523
3404-001,2016,3,29,21,695,235,930,1150
3404-001,2016,3,29,22,416,208,624,930
3404-001,2016,3,29,23,232,139,371,624
3404-001,2016,3,29,24,127,125,252,371
3404-001,2016,3,30,1,72,79,151,252
3404-001,2016,3,30,2,77,90,167,151
3404-001,2016,3,30,3,46,98,144,167
3404-001,2016,3,30,4,41,64,105,144
3404-001,2016,3,30,5,63,96,159,105
3404-001,2016,3,30,6,132,210,342,159
3404-001,2016,3,30,7,193,576,769,342
3404-001,2016,3,30,8,504,1642,2146,769
3404-001,2016,3,30,9,748,1140,1888,2146
3404-001,2016,3,30,10,711,689,1400,1888
3404-001,2016,3,30,11,746,630,1376,1400
3404-001,2016,3,30,12,688,610,1298,1376
3404-001,2016,3,30,13,665,534,1199,1298
3404-001,2016,3,30,14,709,616,1325,1199
3404-001,2016,3,30,15,836,592,1428,1325
3404-001,2016,3,30,16,817,608,1425,1428
3404-001,2016,3,30,17,931,521,1452,1425
3404-001,2016,3,30,18,1348,540,1888,1452
3404-001,2016,3,30,19,1199,480,1679,1888
3404-001,2016,3,30,20,779,365,1144,1679
3404-001,2016,3,30,21,581,243,824,1144
3404-001,2016,3,30,22,380,207,587,824
3404-001,2016,3,30,23,207,179,386,587
3404-001,2016,3,30,24,123,127,250,386
3404-001,2016,3,31,1,86,72,158,250
3404-001,2016,3,31,2,58,48,106,158
3404-001,2016,3,31,3,44,43,87,106
3404-001,2016,3,31,4,55,43,98,87
3404-001,2016,3,31,5,72,67,139,98
3404-001,2016,3,31,6,134,199,333,139
3404-001,2016,3,31,7,224,607,831,333
3404-001,2016,3,31,8,527,1741,2268,831
3404-001,2016,3,31,9,806,1146,1952,2268
3404-001,2016,3,31,10,680,682,1362,1952
3404-001,2016,3,31,11,713,637,1350,1362
3404-001,2016,3,31,12,697,604,1301,1350
3404-001,2016,3,31,13,648,497,1145,1301
3404-001,2016,3,31,14,725,648,1373,1145
3404-001,2016,3,31,15,867,717,1584,1373
3404-001,2016,3,31,16,873,593,1466,1584
3404-001,2016,3,31,17,900,506,1406,1466
3404-001,2016,3,31,18,1173,560,1733,1406
3404-001,2016,3,31,19,1166,488,1654,1733
3404-001,2016,3,31,20,816,412,1228,1654
3404-001,2016,3,31,21,671,277,948,1228
3404-001,2016,3,31,22,433,194,627,948
3404-001,2016,3,31,23,210,171,381,627
3404-001,2016,3,31,24,113,104,217,381
3404-001,2016,4,1,1,87,79,166,217
3404-001,2016,4,1,2,77,55,132,166
3404-001,2016,4,1,3,50,61,111,132
3404-001,2016,4,1,4,44,65,109,111
3404-001,2016,4,1,5,69,87,156,109
3404-001,2016,4,1,6,119,182,301,156
3404-001,2016,4,1,7,237,566,803,301
3404-001,2016,4,1,8,542,1661,2203,803
3404-001,2016,4,1,9,773,1153,1926,2203
3404-001,2016,4,1,10,736,673,1409,1926
3404-001,2016,4,1,11,759,631,1390,1409
3404-001,2016,4,1,12,725,623,1348,1390
3404-001,2016,4,1,13,646,569,1215,1348
3404-001,2016,4,1,14,735,628,1363,1215
3404-001,2016,4,1,15,865,682,1547,1363
3404-001,2016,4,1,16,884,647,1531,1547
3404-001,2016,4,1,17,962,602,1564,1531
3404-001,2016,4,1,18,1472,551,2023,1564
3404-001,2016,4,1,19,1359,545,1904,2023
3404-001,2016,4,1,20,921,485,1406,1904
3404-001,2016,4,1,21,694,295,989,1406
3404-001,2016,4,1,22,387,277,664,989
3404-001,2016,4,1,23,246,191,437,664
3404-001,2016,4,1,24,154,136,290,437
3404-001,2016,4,2,1,74,102,176,290
3404-001,2016,4,2,2,71,106,177,176
3404-001,2016,4,2,3,40,113,153,177
3404-001,2016,4,2,4,50,36,86,153
3404-001,2016,4,2,5,74,62,136,86
3404-001,2016,4,2,6,88,172,260,136
3404-001,2016,4,2,7,168,371,539,260
3404-001,2016,4,2,8,430,775,1205,539
3404-001,2016,4,2,9,624,646,1270,1205
3404-001,2016,4,2,10,623,597,1220,1270
3404-001,2016,4,2,11,617,638,1255,1220
3404-001,2016,4,2,12,519,658,1177,1255
3404-001,2016,4,2,13,542,586,1128,1177
3404-001,2016,4,2,14,544,589,1133,1128
3404-001,2016,4,2,15,571,586,1157,1133
3404-001,2016,4,2,16,629,503,1132,1157
3404-001,2016,4,2,17,736,469,1205,1132
3404-001,2016,4,2,18,1078,463,1541,1205
3404-001,2016,4,2,19,763,387,1150,1541
3404-001,2016,4,2,20,452,292,744,1150
3404-001,2016,4,2,21,332,208,540,744
3404-001,2016,4,2,22,225,169,394,540
3404-001,2016,4,2,23,113,100,213,394
3404-001,2016,4,2,24,79,95,174,213
3404-001,2016,4,3,1,56,48,104,174
3404-001,2016,4,3,2,39,48,87,104
3404-001,2016,4,3,3,45,34,79,87
3404-001,2016,4,3,4,28,35,63,79
3404-001,2016,4,3,5,29,28,57,63
3404-001,2016,4,3,6,58,71,129,57
3404-001,2016,4,3,7,88,178,266,129
3404-001,2016,4,3,8,142,267,409,266
3404-001,2016,4,3,9,241,285,526,409
3404-001,2016,4,3,10,287,341,628,526
3404-001,2016,4,3,11,318,369,687,628
3404-001,2016,4,3,12,334,409,743,687
3404-001,2016,4,3,13,365,340,705,743
3404-001,2016,4,3,14,425,328,753,705
3404-001,2016,4,3,15,543,362,905,753
3404-001,2016,4,3,16,661,306,967,905
3404-001,2016,4,3,17,809,309,1118,967
3404-001,2016,4,3,18,836,279,1115,1118
3404-001,2016,4,3,19,649,294,943,1115
3404-001,2016,4,3,20,416,247,663,943
3404-001,2016,4,3,21,256,217,473,663
3404-001,2016,4,3,22,161,193,354,473
3404-001,2016,4,3,23,107,157,264,354
3404-001,2016,4,3,24,53,116,169,264
3404-001,2016,4,4,1,46,81,127,169
3404-001,2016,4,4,2,30,64,94,127
3404-001,2016,4,4,3,20,37,57,94
3404-001,2016,4,4,4,32,45,77,57
3404-001,2016,4,4,5,46,77,123,77
3404-001,2016,4,4,6,122,239,361,123
3404-001,2016,4,4,7,274,714,988,361
3404-001,2016,4,4,8,592,1779,2371,988
3404-001,2016,4,4,9,720,1123,1843,2371
3404-001,2016,4,4,10,675,684,1359,1843
3404-001,2016,4,4,11,700,662,1362,1359
3404-001,2016,4,4,12,633,624,1257,1362
3404-001,2016,4,4,13,636,534,1170,1257
3404-001,2016,4,4,14,684,608,1292,1170
3404-001,2016,4,4,15,823,711,1534,1292
3404-001,2016,4,4,16,907,664,1571,1534
3404-001,2016,4,4,17,822,614,1436,1571
3404-001,2016,4,4,18,1228,536,1764,1436
3404-001,2016,4,4,19,1125,481,1606,1764
3404-001,2016,4,4,20,788,365,1153,1606
3404-001,2016,4,4,21,704,265,969,1153
3404-001,2016,4,4,22,413,181,594,969
3404-001,2016,4,4,23,202,125,327,594
3404-001,2016,4,4,24,139,100,239,327
3404-001,2016,4,5,1,85,94,179,239
3404-001,2016,4,5,2,77,77,154,179
3404-001,2016,4,5,3,43,59,102,154
3404-001,2016,4,5,4,46,68,114,102
3404-001,2016,4,5,5,76,86,162,114
3404-001,2016,4,5,6,146,181,327,162
3404-001,2016,4,5,7,262,595,857,327
3404-001,2016,4,5,8,537,1638,2175,857
3404-001,2016,4,5,9,796,1117,1913,2175
3404-001,2016,4,5,10,760,761,1521,1913
3404-001,2016,4,5,11,730,675,1405,1521
3404-001,2016,4,5,12,738,628,1366,1405
3404-001,2016,4,5,13,651,565,1216,1366
3404-001,2016,4,5,14,747,660,1407,1216
3404-001,2016,4,5,15,888,703,1591,1407
3404-001,2016,4,5,16,887,617,1504,1591
3404-001,2016,4,5,17,852,598,1450,1504
3404-001,2016,4,5,18,1176,548,1724,1450
3404-001,2016,4,5,19,1094,434,1528,1724
3404-001,2016,4,5,20,748,387,1135,1528
3404-001,2016,4,5,21,688,247,935,1135
3404-001,2016,4,5,22,389,193,582,935
3404-001,2016,4,5,23,229,153,382,582
3404-001,2016,4,5,24,127,110,237,382
3404-001,2016,4,6,1,76,70,146,237
3404-001,2016,4,6,2,53,67,120,146
3404-001,2016,4,6,3,34,41,75,120
3404-001,2016,4,6,4,36,53,89,75
3404-001,2016,4,6,5,76,90,166,89
3404-001,2016,4,6,6,122,209,331,166
3404-001,2016,4,6,7,253,619,872,331
3404-001,2016,4,6,8,543,1731,2274,872
3404-001,2016,4,6,9,802,1162,1964,2274
3404-001,2016,4,6,10,750,669,1419,1964
3404-001,2016,4,6,11,769,685,1454,1419
3404-001,2016,4,6,12,717,606,1323,1454
3404-001,2016,4,6,13,625,562,1187,1323
3404-001,2016,4,6,14,703,639,1342,1187
3404-001,2016,4,6,15,855,704,1559,1342
3404-001,2016,4,6,16,862,643,1505,1559
3404-001,2016,4,6,17,922,511,1433,1505
3404-001,2016,4,6,18,1339,584,1923,1433
3404-001,2016,4,6,19,1219,497,1716,1923
3404-001,2016,4,6,20,771,381,1152,1716
3404-001,2016,4,6,21,585,298,883,1152
3404-001,2016,4,6,22,378,100,478,883
3404-001,2016,4,6,23,193,86,279,478
3404-001,2016,4,6,24,116,127,243,279
3404-001,2016,4,7,1,92,103,195,243
3404-001,2016,4,7,2,77,41,118,195
3404-001,2016,4,7,3,30,40,70,118
3404-001,2016,4,7,4,48,59,107,70
3404-001,2016,4,7,5,70,77,147,107
3404-001,2016,4,7,6,100,181,281,147
3404-001,2016,4,7,7,206,472,678,281
3404-001,2016,4,7,8,502,1750,2252,678
3404-001,2016,4,7,9,798,1221,2019,2252
3404-001,2016,4,7,10,695,721,1416,2019
3404-001,2016,4,7,11,676,711,1387,1416
3404-001,2016,4,7,12,667,690,1357,1387
3404-001,2016,4,7,13,621,586,1207,1357
3404-001,2016,4,7,14,747,685,1432,1207
3404-001,2016,4,7,15,738,772,1510,1432
3404-001,2016,4,7,16,810,709,1519,1510
3404-001,2016,4,7,17,817,598,1415,1519
3404-001,2016,4,7,18,1091,601,1692,1415
3404-001,2016,4,7,19,1088,555,1643,1692
3404-001,2016,4,7,20,739,444,1183,1643
3404-001,2016,4,7,21,683,260,943,1183
3404-001,2016,4,7,22,447,231,678,943
3404-001,2016,4,7,23,224,141,365,678
3404-001,2016,4,7,24,121,81,202,365
3404-001,2016,4,8,1,75,80,155,202
3404-001,2016,4,8,2,58,50,108,155
3404-001,2016,4,8,3,40,47,87,108
3404-001,2016,4,8,4,49,46,95,87
3404-001,2016,4,8,5,65,86,151,95
3404-001,2016,4,8,6,118,234,352,151
3404-001,2016,4,8,7,238,652,890,352
3404-001,2016,4,8,8,561,1839,2400,890
3404-001,2016,4,8,9,789,1332,2121,2400
3404-001,2016,4,8,10,744,822,1566,2121
3404-001,2016,4,8,11,764,746,1510,1566
3404-001,2016,4,8,12,746,721,1467,1510
3404-001,2016,4,8,13,673,638,1311,1467
3404-001,2016,4,8,14,729,751,1480,1311
3404-001,2016,4,8,15,848,788,1636,1480
3404-001,2016,4,8,16,1007,711,1718,1636
3404-001,2016,4,8,17,956,637,1593,1718
3404-001,2016,4,8,18,1450,712,2162,1593
3404-001,2016,4,8,19,1420,566,1986,2162
3404-001,2016,4,8,20,903,508,1411,1986
3404-001,2016,4,8,21,713,317,1030,1411
3404-001,2016,4,8,22,379,213,592,1030
3404-001,2016,4,8,23,217,170,387,592
3404-001,2016,4,8,24,142,108,250,387
3404-001,2016,4,9,1,102,92,194,250
3404-001,2016,4,9,2,96,70,166,194
3404-001,2016,4,9,3,46,52,98,166
3404-001,2016,4,9,4,56,44,100,98
3404-001,2016,4,9,5,66,63,129,100
3404-001,2016,4,9,6,127,178,305,129
3404-001,2016,4,9,7,217,389,606,305
3404-001,2016,4,9,8,369,776,1145,606
3404-001,2016,4,9,9,528,696,1224,1145
3404-001,2016,4,9,10,525,624,1149,1224
3404-001,2016,4,9,11,549,633,1182,1149
3404-001,2016,4,9,12,508,637,1145,1182
3404-001,2016,4,9,13,499,573,1072,1145
3404-001,2016,4,9,14,524,563,1087,1072
3404-001,2016,4,9,15,553,538,1091,1087
3404-001,2016,4,9,16,631,521,1152,1091
3404-001,2016,4,9,17,735,448,1183,1152
3404-001,2016,4,9,18,1027,435,1462,1183
3404-001,2016,4,9,19,724,436,1160,1462
3404-001,2016,4,9,20,426,305,731,1160
3404-001,2016,4,9,21,304,248,552,731
3404-001,2016,4,9,22,230,172,402,552
3404-001,2016,4,9,23,127,131,258,402
3404-001,2016,4,9,24,106,98,204,258
3404-001,2016,4,10,1,70,73,143,204
3404-001,2016,4,10,2,46,48,94,143
3404-001,2016,4,10,3,35,29,64,94
3404-001,2016,4,10,4,34,20,54,64
3404-001,2016,4,10,5,33,32,65,54
3404-001,2016,4,10,6,63,73,136,65
3404-001,2016,4,10,7,114,204,318,136
3404-001,2016,4,10,8,182,296,478,318
3404-001,2016,4,10,9,253,308,561,478
3404-001,2016,4,10,10,270,356,626,561
3404-001,2016,4,10,11,298,437,735,626
3404-001,2016,4,10,12,328,402,730,735
3404-001,2016,4,10,13,348,402,750,730
3404-001,2016,4,10,14,395,386,781,750
3404-001,2016,4,10,15,517,396,913,781
3404-001,2016,4,10,16,580,372,952,913
3404-001,2016,4,10,17,765,379,1144,952
3404-001,2016,4,10,18,1025,427,1452,1144
3404-001,2016,4,10,19,634,329,963,1452
3404-001,2016,4,10,20,384,280,664,963
3404-001,2016,4,10,21,284,284,568,664
3404-001,2016,4,10,22,197,224,421,568
3404-001,2016,4,10,23,106,159,265,421
3404-001,2016,4,10,24,68,104,172,265
3404-001,2016,4,11,1,54,58,112,172
3404-001,2016,4,11,2,24,49,73,112
3404-001,2016,4,11,3,21,49,70,73
3404-001,2016,4,11,4,23,37,60,70
3404-001,2016,4,11,5,48,65,113,60
3404-001,2016,4,11,6,134,259,393,113
3404-001,2016,4,11,7,277,762,1039,393
3404-001,2016,4,11,8,587,1837,2424,1039
3404-001,2016,4,11,9,724,1350,2074,2424
3404-001,2016,4,11,10,742,744,1486,2074
3404-001,2016,4,11,11,777,730,1507,1486
3404-001,2016,4,11,12,738,675,1413,1507
3404-001,2016,4,11,13,631,671,1302,1413
3404-001,2016,4,11,14,699,709,1408,1302
3404-001,2016,4,11,15,854,726,1580,1408
3404-001,2016,4,11,16,836,702,1538,1580
3404-001,2016,4,11,17,881,581,1462,1538
3404-001,2016,4,11,18,1185,586,1771,1462
3404-001,2016,4,11,19,1085,486,1571,1771
3404-001,2016,4,11,20,818,399,1217,1571
3404-001,2016,4,11,21,711,307,1018,1217
3404-001,2016,4,11,22,432,202,634,1018
3404-001,2016,4,11,23,261,150,411,634
3404-001,2016,4,11,24,144,126,270,411
3404-001,2016,4,12,1,108,72,180,270
3404-001,2016,4,12,2,71,46,117,180
3404-001,2016,4,12,3,44,62,106,117
3404-001,2016,4,12,4,43,61,104,106
3404-001,2016,4,12,5,74,67,141,104
3404-001,2016,4,12,6,137,244,381,141
3404-001,2016,4,12,7,267,636,903,381
3404-001,2016,4,12,8,585,1810,2395,903
3404-001,2016,4,12,9,790,1315,2105,2395
3404-001,2016,4,12,10,748,801,1549,2105
3404-001,2016,4,12,11,812,747,1559,1549
3404-001,2016,4,12,12,771,693,1464,1559
3404-001,2016,4,12,13,689,636,1325,1464
3404-001,2016,4,12,14,711,724,1435,1325
3404-001,2016,4,12,15,826,752,1578,1435
3404-001,2016,4,12,16,944,653,1597,1578
3404-001,2016,4,12,17,960,595,1555,1597
3404-001,2016,4,12,18,1340,604,1944,1555
3404-001,2016,4,12,19,1272,562,1834,1944
3404-001,2016,4,12,20,923,533,1456,1834
3404-001,2016,4,12,21,737,308,1045,1456
3404-001,2016,4,12,22,472,241,713,1045
3404-001,2016,4,12,23,250,173,423,713
3404-001,2016,4,12,24,122,115,237,423
3404-001,2016,4,13,1,116,149,265,237
3404-001,2016,4,13,2,71,73,144,265
3404-001,2016,4,13,3,55,82,137,144
3404-001,2016,4,13,4,44,72,116,137
3404-001,2016,4,13,5,58,122,180,116
3404-001,2016,4,13,6,108,217,325,180
3404-001,2016,4,13,7,164,483,647,325
3404-001,2016,4,13,8,310,964,1274,647
3404-001,2016,4,13,9,479,753,1232,1274
3404-001,2016,4,13,10,456,596,1052,1232
3404-001,2016,4,13,11,500,566,1066,1052
3404-001,2016,4,13,12,484,576,1060,1066
3404-001,2016,4,13,13,526,528,1054,1060
3404-001,2016,4,13,14,547,527,1074,1054
3404-001,2016,4,13,15,603,559,1162,1074
3404-001,2016,4,13,16,619,501,1120,1162
3404-001,2016,4,13,17,691,444,1135,1120
3404-001,2016,4,13,18,850,425,1275,1135
3404-001,2016,4,13,19,625,327,952,1275
3404-001,2016,4,13,20,467,246,713,952
3404-001,2016,4,13,21,332,214,546,713
3404-001,2016,4,13,22,234,192,426,546
3404-001,2016,4,13,23,137,136,273,426
3404-001,2016,4,13,24,92,95,187,273
3404-001,2016,4,14,1,68,72,140,187
3404-001,2016,4,14,2,41,55,96,140
3404-001,2016,4,14,3,20,28,48,96
3404-001,2016,4,14,4,40,24,64,48
3404-001,2016,4,14,5,64,56,120,64
3404-001,2016,4,14,6,132,234,366,120
3404-001,2016,4,14,7,254,767,1021,366
3404-001,2016,4,14,8,595,2188,2783,1021
3404-001,2016,4,14,9,778,1583,2361,2783
3404-001,2016,4,14,10,716,769,1485,2361
3404-001,2016,4,14,11,765,738,1503,1485
3404-001,2016,4,14,12,740,757,1497,1503
3404-001,2016,4,14,13,668,596,1264,1497
3404-001,2016,4,14,14,685,701,1386,1264
3404-001,2016,4,14,15,817,850,1667,1386
3404-001,2016,4,14,16,896,823,1719,1667
3404-001,2016,4,14,17,938,699,1637,1719
3404-001,2016,4,14,18,1201,584,1785,1637
3404-001,2016,4,14,19,1186,491,1677,1785
3404-001,2016,4,14,20,834,434,1268,1677
3404-001,2016,4,14,21,715,258,973,1268
3404-001,2016,4,14,22,439,192,631,973
3404-001,2016,4,14,23,237,124,361,631
3404-001,2016,4,14,24,147,110,257,361
3404-001,2016,4,15,1,101,63,164,257
3404-001,2016,4,15,2,71,50,121,164
3404-001,2016,4,15,3,44,17,61,121
3404-001,2016,4,15,4,33,34,67,61
3404-001,2016,4,15,5,71,46,117,67
3404-001,2016,4,15,6,116,188,304,117
3404-001,2016,4,15,7,244,696,940,304
3404-001,2016,4,15,8,558,2208,2766,940
3404-001,2016,4,15,9,809,1540,2349,2766
3404-001,2016,4,15,10,750,857,1607,2349
3404-001,2016,4,15,11,808,857,1665,1607
3404-001,2016,4,15,12,743,782,1525,1665
3404-001,2016,4,15,13,681,750,1431,1525
3404-001,2016,4,15,14,715,760,1475,1431
3404-001,2016,4,15,15,930,921,1851,1475
3404-001,2016,4,15,16,918,863,1781,1851
3404-001,2016,4,15,17,984,769,1753,1781
3404-001,2016,4,15,18,1489,665,2154,1753
3404-001,2016,4,15,19,1382,689,2071,2154
3404-001,2016,4,15,20,945,505,1450,2071
3404-001,2016,4,15,21,757,324,1081,1450
3404-001,2016,4,15,22,443,192,635,1081
3404-001,2016,4,15,23,273,168,441,635
3404-001,2016,4,15,24,126,105,231,441
3404-001,2016,4,16,1,119,90,209,231
3404-001,2016,4,16,2,72,46,118,209
3404-001,2016,4,16,3,47,44,91,118
3404-001,2016,4,16,4,48,55,103,91
3404-001,2016,4,16,5,75,72,147,103
3404-001,2016,4,16,6,104,158,262,147
3404-001,2016,4,16,7,217,396,613,262
3404-001,2016,4,16,8,409,948,1357,613
3404-001,2016,4,16,9,612,703,1315,1357
3404-001,2016,4,16,10,539,718,1257,1315
3404-001,2016,4,16,11,586,735,1321,1257
3404-001,2016,4,16,12,536,706,1242,1321
3404-001,2016,4,16,13,543,632,1175,1242
3404-001,2016,4,16,14,566,508,1074,1175
3404-001,2016,4,16,15,576,511,1087,1074
3404-001,2016,4,16,16,688,495,1183,1087
3404-001,2016,4,16,17,794,432,1226,1183
3404-001,2016,4,16,18,861,395,1256,1226
3404-001,2016,4,16,19,593,308,901,1256
3404-001,2016,4,16,20,311,286,597,901
3404-001,2016,4,16,21,243,178,421,597
3404-001,2016,4,16,22,169,141,310,421
3404-001,2016,4,16,23,121,99,220,310
3404-001,2016,4,16,24,62,58,120,220
3404-001,2016,4,17,1,63,66,129,120
3404-001,2016,4,17,2,41,28,69,129
3404-001,2016,4,17,3,33,17,50,69
3404-001,2016,4,17,4,17,12,29,50
3404-001,2016,4,17,5,28,22,50,29
3404-001,2016,4,17,6,55,58,113,50
3404-001,2016,4,17,7,75,127,202,113
3404-001,2016,4,17,8,244,204,448,202
3404-001,2016,4,17,9,248,231,479,448
3404-001,2016,4,17,10,256,215,471,479
3404-001,2016,4,17,11,326,308,634,471
3404-001,2016,4,17,12,321,368,689,634
3404-001,2016,4,17,13,334,381,715,689
3404-001,2016,4,17,14,330,336,666,715
3404-001,2016,4,17,15,422,354,776,666
3404-001,2016,4,17,16,465,368,833,776
3404-001,2016,4,17,17,524,336,860,833
3404-001,2016,4,17,18,562,336,898,860
3404-001,2016,4,17,19,435,312,747,898
3404-001,2016,4,17,20,308,276,584,747
3404-001,2016,4,17,21,239,212,451,584
3404-001,2016,4,17,22,180,202,382,451
3404-001,2016,4,17,23,106,170,276,382
3404-001,2016,4,17,24,74,129,203,276
3404-001,2016,4,18,1,38,70,108,203
3404-001,2016,4,18,2,23,53,76,108
3404-001,2016,4,18,3,23,33,56,76
3404-001,2016,4,18,4,29,44,73,56
3404-001,2016,4,18,5,71,68,139,73
3404-001,2016,4,18,6,123,249,372,139
3404-001,2016,4,18,7,269,863,1132,372
3404-001,2016,4,18,8,598,2406,3004,1132
3404-001,2016,4,18,9,728,1481,2209,3004
3404-001,2016,4,18,10,742,818,1560,2209
3404-001,2016,4,18,11,696,867,1563,1560
3404-001,2016,4,18,12,702,796,1498,1563
3404-001,2016,4,18,13,648,659,1307,1498
3404-001,2016,4,18,14,693,740,1433,1307
3404-001,2016,4,18,15,881,857,1738,1433
3404-001,2016,4,18,16,863,845,1708,1738
3404-001,2016,4,18,17,973,642,1615,1708
3404-001,2016,4,18,18,1172,583,1755,1615
3404-001,2016,4,18,19,1154,554,1708,1755
3404-001,2016,4,18,20,823,381,1204,1708
3404-001,2016,4,18,21,698,222,920,1204
3404-001,2016,4,18,22,413,187,600,920
3404-001,2016,4,18,23,205,131,336,600
3404-001,2016,4,18,24,106,60,166,336
3404-001,2016,4,19,1,75,72,147,166
3404-001,2016,4,19,2,64,28,92,147
3404-001,2016,4,19,3,33,33,66,92
3404-001,2016,4,19,4,45,28,73,66
3404-001,2016,4,19,5,57,51,108,73
3404-001,2016,4,19,6,116,200,316,108
3404-001,2016,4,19,7,238,728,966,316
3404-001,2016,4,19,8,571,2219,2790,966
3404-001,2016,4,19,9,828,1444,2272,2790
3404-001,2016,4,19,10,747,836,1583,2272
3404-001,2016,4,19,11,795,841,1636,1583
3404-001,2016,4,19,12,704,848,1552,1636
3404-001,2016,4,19,13,609,796,1405,1552
3404-001,2016,4,19,14,697,818,1515,1405
3404-001,2016,4,19,15,856,850,1706,1515
3404-001,2016,4,19,16,885,860,1745,1706
3404-001,2016,4,19,17,908,735,1643,1745
3404-001,2016,4,19,18,1230,637,1867,1643
3404-001,2016,4,19,19,1140,484,1624,1867
3404-001,2016,4,19,20,791,380,1171,1624
3404-001,2016,4,19,21,752,263,1015,1171
3404-001,2016,4,19,22,426,207,633,1015
3404-001,2016,4,19,23,255,139,394,633
3404-001,2016,4,19,24,140,107,247,394
3404-001,2016,4,20,1,112,66,178,247
3404-001,2016,4,20,2,67,46,113,178
3404-001,2016,4,20,3,46,36,82,113
3404-001,2016,4,20,4,49,29,78,82
3404-001,2016,4,20,5,65,60,125,78
3404-001,2016,4,20,6,136,224,360,125
3404-001,2016,4,20,7,246,660,906,360
3404-001,2016,4,20,8,555,2212,2767,906
3404-001,2016,4,20,9,814,1577,2391,2767
3404-001,2016,4,20,10,726,803,1529,2391
3404-001,2016,4,20,11,743,840,1583,1529
3404-001,2016,4,20,12,763,814,1577,1583
3404-001,2016,4,20,13,657,645,1302,1577
3404-001,2016,4,20,14,737,797,1534,1302
3404-001,2016,4,20,15,854,728,1582,1534
3404-001,2016,4,20,16,842,676,1518,1582
3404-001,2016,4,20,17,944,564,1508,1518
3404-001,2016,4,20,18,1359,581,1940,1508
3404-001,2016,4,20,19,1093,459,1552,1940
3404-001,2016,4,20,20,741,371,1112,1552
3404-001,2016,4,20,21,600,248,848,1112
3404-001,2016,4,20,22,367,188,555,848
3404-001,2016,4,20,23,221,151,372,555
3404-001,2016,4,20,24,119,126,245,372
3404-001,2016,4,21,1,112,63,175,245
3404-001,2016,4,21,2,64,51,115,175
3404-001,2016,4,21,3,55,31,86,115
3404-001,2016,4,21,4,39,28,67,86
3404-001,2016,4,21,5,55,46,101,67
3404-001,2016,4,21,6,103,160,263,101
3404-001,2016,4,21,7,181,594,775,263
3404-001,2016,4,21,8,487,2072,2559,775
3404-001,2016,4,21,9,799,1369,2168,2559
3404-001,2016,4,21,10,654,716,1370,2168
3404-001,2016,4,21,11,667,640,1307,1370
3404-001,2016,4,21,12,730,632,1362,1307
3404-001,2016,4,21,13,618,540,1158,1362
3404-001,2016,4,21,14,681,611,1292,1158
3404-001,2016,4,21,15,790,777,1567,1292
3404-001,2016,4,21,16,824,676,1500,1567
3404-001,2016,4,21,17,884,637,1521,1500
3404-001,2016,4,21,18,1122,542,1664,1521
3404-001,2016,4,21,19,1041,462,1503,1664
3404-001,2016,4,21,20,807,403,1210,1503
3404-001,2016,4,21,21,698,258,956,1210
3404-001,2016,4,21,22,431,193,624,956
3404-001,2016,4,21,23,226,126,352,624
3404-001,2016,4,21,24,126,112,238,352
3404-001,2016,4,22,1,94,60,154,238
3404-001,2016,4,22,2,66,39,105,154
3404-001,2016,4,22,3,38,44,82,105
3404-001,2016,4,22,4,43,39,82,82
3404-001,2016,4,22,5,65,56,121,82
3404-001,2016,4,22,6,122,187,309,121
3404-001,2016,4,22,7,252,730,982,309
3404-001,2016,4,22,8,568,2150,2718,982
3404-001,2016,4,22,9,816,1569,2385,2718
3404-001,2016,4,22,10,768,902,1670,2385
3404-001,2016,4,22,11,773,858,1631,1670
3404-001,2016,4,22,12,772,753,1525,1631
3404-001,2016,4,22,13,672,716,1388,1525
3404-001,2016,4,22,14,703,765,1468,1388
3404-001,2016,4,22,15,884,962,1846,1468
3404-001,2016,4,22,16,963,865,1828,1846
3404-001,2016,4,22,17,1003,745,1748,1828
3404-001,2016,4,22,18,1503,662,2165,1748
3404-001,2016,4,22,19,1431,635,2066,2165
3404-001,2016,4,22,20,903,562,1465,2066
3404-001,2016,4,22,21,719,288,1007,1465
3404-001,2016,4,22,22,387,231,618,1007
3404-001,2016,4,22,23,210,154,364,618
3404-001,2016,4,22,24,138,99,237,364
3404-001,2016,4,23,1,121,61,182,237
3404-001,2016,4,23,2,69,53,122,182
3404-001,2016,4,23,3,40,36,76,122
3404-001,2016,4,23,4,41,43,84,76
3404-001,2016,4,23,5,51,60,111,84
3404-001,2016,4,23,6,115,197,312,111
3404-001,2016,4,23,7,209,420,629,312
3404-001,2016,4,23,8,398,856,1254,629
3404-001,2016,4,23,9,586,813,1399,1254
3404-001,2016,4,23,10,547,665,1212,1399
3404-001,2016,4,23,11,588,681,1269,1212
3404-001,2016,4,23,12,491,709,1200,1269
3404-001,2016,4,23,13,506,649,1155,1200
3404-001,2016,4,23,14,505,643,1148,1155
3404-001,2016,4,23,15,581,645,1226,1148
3404-001,2016,4,23,16,649,610,1259,1226
3404-001,2016,4,23,17,744,550,1294,1259
3404-001,2016,4,23,18,1000,520,1520,1294
3404-001,2016,4,23,19,797,412,1209,1520
3404-001,2016,4,23,20,463,337,800,1209
3404-001,2016,4,23,21,305,254,559,800
3404-001,2016,4,23,22,202,219,421,559
3404-001,2016,4,23,23,134,121,255,421
3404-001,2016,4,23,24,106,92,198,255
3404-001,2016,4,24,1,70,55,125,198
3404-001,2016,4,24,2,54,43,97,125
3404-001,2016,4,24,3,50,39,89,97
3404-001,2016,4,24,4,24,44,68,89
3404-001,2016,4,24,5,39,39,78,68
3404-001,2016,4,24,6,80,77,157,78
3404-001,2016,4,24,7,101,183,284,157
3404-001,2016,4,24,8,182,292,474,284
3404-001,2016,4,24,9,240,305,545,474
3404-001,2016,4,24,10,271,373,644,545
3404-001,2016,4,24,11,316,437,753,644
3404-001,2016,4,24,12,326,358,684,753
3404-001,2016,4,24,13,338,435,773,684
3404-001,2016,4,24,14,427,371,798,773
3404-001,2016,4,24,15,450,415,865,798
3404-001,2016,4,24,16,617,396,1013,865
3404-001,2016,4,24,17,951,364,1315,1013
3404-001,2016,4,24,18,953,336,1289,1315
3404-001,2016,4,24,19,913,308,1221,1289
3404-001,2016,4,24,20,598,305,903,1221
3404-001,2016,4,24,21,323,266,589,903
3404-001,2016,4,24,22,248,253,501,589
3404-001,2016,4,24,23,120,168,288,501
3404-001,2016,4,24,24,71,136,207,288
3404-001,2016,4,25,1,58,93,151,207
3404-001,2016,4,25,2,37,72,109,151
3404-001,2016,4,25,3,28,70,98,109
3404-001,2016,4,25,4,31,36,67,98
3404-001,2016,4,25,5,56,54,110,67
3404-001,2016,4,25,6,133,166,299,110
3404-001,2016,4,25,7,275,554,829,299
3404-001,2016,4,25,8,565,1450,2015,829
3404-001,2016,4,25,9,750,970,1720,2015
3404-001,2016,4,25,10,687,781,1468,1720
3404-001,2016,4,25,11,744,798,1542,1468
3404-001,2016,4,25,12,655,736,1391,1542
3404-001,2016,4,25,13,600,665,1265,1391
3404-001,2016,4,25,14,706,724,1430,1265
3404-001,2016,4,25,15,822,792,1614,1430
3404-001,2016,4,25,16,830,774,1604,1614
3404-001,2016,4,25,17,921,612,1533,1604
3404-001,2016,4,25,18,1188,584,1772,1533
3404-001,2016,4,25,19,1123,520,1643,1772
3404-001,2016,4,25,20,819,390,1209,1643
3404-001,2016,4,25,21,820,264,1084,1209
3404-001,2016,4,25,22,409,194,603,1084
3404-001,2016,4,25,23,247,140,387,603
3404-001,2016,4,25,24,153,93,246,387
3404-001,2016,4,26,1,103,54,157,246
3404-001,2016,4,26,2,72,72,144,157
3404-001,2016,4,26,3,51,70,121,144
3404-001,2016,4,26,4,42,71,113,121
3404-001,2016,4,26,5,75,171,246,113
3404-001,2016,4,26,6,160,239,399,246
3404-001,2016,4,26,7,243,670,913,399
3404-001,2016,4,26,8,546,1795,2341,913
3404-001,2016,4,26,9,796,1338,2134,2341
3404-001,2016,4,26,10,770,769,1539,2134
3404-001,2016,4,26,11,784,804,1588,1539
3404-001,2016,4,26,12,746,691,1437,1588
3404-001,2016,4,26,13,660,597,1257,1437
3404-001,2016,4,26,14,698,682,1380,1257
3404-001,2016,4,26,15,846,732,1578,1380
3404-001,2016,4,26,16,838,681,1519,1578
3404-001,2016,4,26,17,937,625,1562,1519
3404-001,2016,4,26,18,1285,579,1864,1562
3404-001,2016,4,26,19,1171,482,1653,1864
3404-001,2016,4,26,20,843,408,1251,1653
3404-001,2016,4,26,21,748,276,1024,1251
3404-001,2016,4,26,22,440,242,682,1024
3404-001,2016,4,26,23,191,155,346,682
3404-001,2016,4,26,24,146,120,266,346
3404-001,2016,4,27,1,93,86,179,266
3404-001,2016,4,27,2,75,60,135,179
3404-001,2016,4,27,3,49,52,101,135
3404-001,2016,4,27,4,44,52,96,101
3404-001,2016,4,27,5,73,55,128,96
3404-001,2016,4,27,6,152,191,343,128
3404-001,2016,4,27,7,268,626,894,343
3404-001,2016,4,27,8,551,1640,2191,894
3404-001,2016,4,27,9,795,1328,2123,2191
3404-001,2016,4,27,10,725,763,1488,2123
3404-001,2016,4,27,11,793,713,1506,1488
3404-001,2016,4,27,12,706,681,1387,1506
3404-001,2016,4,27,13,714,563,1277,1387
3404-001,2016,4,27,14,791,679,1470,1277
3404-001,2016,4,27,15,855,681,1536,1470
3404-001,2016,4,27,16,882,646,1528,1536
3404-001,2016,4,27,17,895,572,1467,1528
3404-001,2016,4,27,18,1386,552,1938,1467
3404-001,2016,4,27,19,1184,527,1711,1938
3404-001,2016,4,27,20,708,428,1136,1711
3404-001,2016,4,27,21,609,280,889,1136
3404-001,2016,4,27,22,365,214,579,889
3404-001,2016,4,27,23,232,185,417,579
3404-001,2016,4,27,24,137,122,259,417
3404-001,2016,4,28,1,95,64,159,259
3404-001,2016,4,28,2,75,50,125,159
3404-001,2016,4,28,3,59,43,102,125
3404-001,2016,4,28,4,55,36,91,102
3404-001,2016,4,28,5,68,72,140,91
3404-001,2016,4,28,6,152,211,363,140
3404-001,2016,4,28,7,251,649,900,363
3404-001,2016,4,28,8,508,1875,2383,900
3404-001,2016,4,28,9,828,1398,2226,2383
3404-001,2016,4,28,10,766,773,1539,2226
3404-001,2016,4,28,11,740,709,1449,1539
3404-001,2016,4,28,12,731,716,1447,1449
3404-001,2016,4,28,13,668,624,1292,1447
3404-001,2016,4,28,14,696,709,1405,1292
3404-001,2016,4,28,15,875,713,1588,1405
3404-001,2016,4,28,16,905,717,1622,1588
3404-001,2016,4,28,17,900,654,1554,1622
3404-001,2016,4,28,18,1251,638,1889,1554
3404-001,2016,4,28,19,1034,563,1597,1889
3404-001,2016,4,28,20,791,450,1241,1597
3404-001,2016,4,28,21,760,314,1074,1241
3404-001,2016,4,28,22,454,259,713,1074
3404-001,2016,4,28,23,256,164,420,713
3404-001,2016,4,28,24,148,130,278,420
3404-001,2016,4,29,1,122,96,218,278
3404-001,2016,4,29,2,77,53,130,218
3404-001,2016,4,29,3,69,52,121,130
3404-001,2016,4,29,4,43,42,85,121
3404-001,2016,4,29,5,71,78,149,85
3404-001,2016,4,29,6,147,235,382,149
3404-001,2016,4,29,7,236,647,883,382
3404-001,2016,4,29,8,588,1834,2422,883
3404-001,2016,4,29,9,783,1331,2114,2422
3404-001,2016,4,29,10,781,759,1540,2114
3404-001,2016,4,29,11,729,793,1522,1540
3404-001,2016,4,29,12,712,672,1384,1522
3404-001,2016,4,29,13,623,647,1270,1384
3404-001,2016,4,29,14,638,678,1316,1270
3404-001,2016,4,29,15,869,672,1541,1316
3404-001,2016,4,29,16,871,693,1564,1541
3404-001,2016,4,29,17,988,700,1688,1564
3404-001,2016,4,29,18,1454,670,2124,1688
3404-001,2016,4,29,19,1364,683,2047,2124
3404-001,2016,4,29,20,906,542,1448,2047
3404-001,2016,4,29,21,722,365,1087,1448
3404-001,2016,4,29,22,410,246,656,1087
3404-001,2016,4,29,23,255,189,444,656
3404-001,2016,4,29,24,124,98,222,444
3404-001,2016,4,30,1,135,96,231,222
3404-001,2016,4,30,2,76,72,148,231
3404-001,2016,4,30,3,55,61,116,148
3404-001,2016,4,30,4,50,41,91,116
3404-001,2016,4,30,5,64,62,126,91
3404-001,2016,4,30,6,121,202,323,126
3404-001,2016,4,30,7,211,404,615,323
3404-001,2016,4,30,8,398,732,1130,615
3404-001,2016,4,30,9,634,678,1312,1130
3404-001,2016,4,30,10,590,629,1219,1312
3404-001,2016,4,30,11,594,674,1268,1219
3404-001,2016,4,30,12,569,653,1222,1268
3404-001,2016,4,30,13,578,483,1061,1222
3404-001,2016,4,30,14,588,591,1179,1061
3404-001,2016,4,30,15,567,573,1140,1179
3404-001,2016,4,30,16,657,498,1155,1140
3404-001,2016,4,30,17,732,459,1191,1155
3404-001,2016,4,30,18,966,453,1419,1191
3404-001,2016,4,30,19,720,367,1087,1419
3404-001,2016,4,30,20,422,301,723,1087
3404-001,2016,4,30,21,304,256,560,723
3404-001,2016,4,30,22,209,189,398,560
3404-001,2016,4,30,23,152,133,285,398
3404-001,2016,4,30,24,68,87,155,285
3404-001,2016,5,1,1,50,110,160,155
3404-001,2016,5,1,2,52,49,101,160
3404-001,2016,5,1,3,52,76,128,101
3404-001,2016,5,1,4,39,39,78,128
3404-001,2016,5,1,5,33,74,107,78
3404-001,2016,5,1,6,58,104,162,107
3404-001,2016,5,1,7,104,155,259,162
3404-001,2016,5,1,8,180,248,428,259
3404-001,2016,5,1,9,251,268,519,428
3404-001,2016,5,1,10,285,294,579,519
3404-001,2016,5,1,11,310,372,682,579
3404-001,2016,5,1,12,322,363,685,682
3404-001,2016,5,1,13,371,408,779,685
3404-001,2016,5,1,14,409,354,763,779
3404-001,2016,5,1,15,478,384,862,763
3404-001,2016,5,1,16,521,382,903,862
3404-001,2016,5,1,17,586,350,936,903
3404-001,2016,5,1,18,764,336,1100,936
3404-001,2016,5,1,19,592,310,902,1100
3404-001,2016,5,1,20,423,290,713,902
3404-001,2016,5,1,21,314,239,553,713
3404-001,2016,5,1,22,238,228,466,553
3404-001,2016,5,1,23,119,237,356,466
3404-001,2016,5,1,24,75,129,204,356
3404-001,2016,5,2,1,65,84,149,204
3404-001,2016,5,2,2,31,69,100,149
3404-001,2016,5,2,3,20,33,53,100
3404-001,2016,5,2,4,30,61,91,53
3404-001,2016,5,2,5,50,88,138,91
3404-001,2016,5,2,6,142,252,394,138
3404-001,2016,5,2,7,255,677,932,394
3404-001,2016,5,2,8,554,1583,2137,932
3404-001,2016,5,2,9,727,1221,1948,2137
3404-001,2016,5,2,10,712,656,1368,1948
3404-001,2016,5,2,11,687,703,1390,1368
3404-001,2016,5,2,12,699,632,1331,1390
3404-001,2016,5,2,13,604,560,1164,1331
3404-001,2016,5,2,14,667,658,1325,1164
3404-001,2016,5,2,15,789,678,1467,1325
3404-001,2016,5,2,16,874,586,1460,1467
3404-001,2016,5,2,17,895,553,1448,1460
3404-001,2016,5,2,18,1108,555,1663,1448
3404-001,2016,5,2,19,1017,540,1557,1663
3404-001,2016,5,2,20,624,366,990,1557
3404-001,2016,5,2,21,634,273,907,990
3404-001,2016,5,2,22,361,191,552,907
3404-001,2016,5,2,23,194,147,341,552
3404-001,2016,5,2,24,125,111,236,341
3404-001,2016,5,3,1,59,66,125,236
3404-001,2016,5,3,2,59,52,111,125
3404-001,2016,5,3,3,47,67,114,111
3404-001,2016,5,3,4,39,52,91,114
3404-001,2016,5,3,5,65,70,135,91
3404-001,2016,5,3,6,100,176,276,135
3404-001,2016,5,3,7,193,567,760,276
3404-001,2016,5,3,8,504,1628,2132,760
3404-001,2016,5,3,9,698,1227,1925,2132
3404-001,2016,5,3,10,636,649,1285,1925
3404-001,2016,5,3,11,665,627,1292,1285
3404-001,2016,5,3,12,653,649,1302,1292
3404-001,2016,5,3,13,579,563,1142,1302
3404-001,2016,5,3,14,659,750,1409,1142
3404-001,2016,5,3,15,734,681,1415,1409
3404-001,2016,5,3,16,769,670,1439,1415
3404-001,2016,5,3,17,861,586,1447,1439
3404-001,2016,5,3,18,1032,548,1580,1447
3404-001,2016,5,3,19,963,502,1465,1580
3404-001,2016,5,3,20,718,359,1077,1465
3404-001,2016,5,3,21,680,313,993,1077
3404-001,2016,5,3,22,392,247,639,993
3404-001,2016,5,3,23,241,153,394,639
3404-001,2016,5,3,24,138,88,226,394
3404-001,2016,5,4,1,116,73,189,226
3404-001,2016,5,4,2,66,62,128,189
3404-001,2016,5,4,3,55,51,106,128
3404-001,2016,5,4,4,55,49,104,106
3404-001,2016,5,4,5,58,98,156,104
3404-001,2016,5,4,6,120,237,357,156
3404-001,2016,5,4,7,281,667,948,357
3404-001,2016,5,4,8,580,1783,2363,948
3404-001,2016,5,4,9,789,1369,2158,2363
3404-001,2016,5,4,10,796,754,1550,2158
3404-001,2016,5,4,11,803,780,1583,1550
3404-001,2016,5,4,12,795,723,1518,1583
3404-001,2016,5,4,13,700,637,1337,1518
3404-001,2016,5,4,14,766,761,1527,1337
3404-001,2016,5,4,15,833,779,1612,1527
3404-001,2016,5,4,16,947,764,1711,1612
3404-001,2016,5,4,17,978,687,1665,1711
3404-001,2016,5,4,18,1483,703,2186,1665
3404-001,2016,5,4,19,1409,664,2073,2186
3404-001,2016,5,4,20,950,580,1530,2073
3404-001,2016,5,4,21,752,383,1135,1530
3404-001,2016,5,4,22,457,290,747,1135
3404-001,2016,5,4,23,253,193,446,747
3404-001,2016,5,4,24,167,133,300,446
3404-001,2016,5,5,1,118,120,238,300
3404-001,2016,5,5,2,83,88,171,238
3404-001,2016,5,5,3,57,87,144,171
3404-001,2016,5,5,4,60,53,113,144
3404-001,2016,5,5,5,80,87,167,113
3404-001,2016,5,5,6,126,212,338,167
3404-001,2016,5,5,7,212,398,610,338
3404-001,2016,5,5,8,354,702,1056,610
3404-001,2016,5,5,9,483,593,1076,1056
3404-001,2016,5,5,10,447,642,1089,1076
3404-001,2016,5,5,11,431,870,1301,1089
3404-001,2016,5,5,12,469,912,1381,1301
3404-001,2016,5,5,13,398,791,1189,1381
3404-001,2016,5,5,14,444,864,1308,1189
3404-001,2016,5,5,15,514,815,1329,1308
3404-001,2016,5,5,16,547,720,1267,1329
3404-001,2016,5,5,17,592,456,1048,1267
3404-001,2016,5,5,18,924,456,1380,1048
3404-001,2016,5,5,19,686,370,1056,1380
3404-001,2016,5,5,20,452,292,744,1056
3404-001,2016,5,5,21,363,203,566,744
3404-001,2016,5,5,22,274,165,439,566
3404-001,2016,5,5,23,142,124,266,439
3404-001,2016,5,5,24,101,81,182,266
3404-001,2016,5,6,1,76,64,140,182
3404-001,2016,5,6,2,39,30,69,140
3404-001,2016,5,6,3,36,42,78,69
3404-001,2016,5,6,4,44,76,120,78
3404-001,2016,5,6,5,57,63,120,120
3404-001,2016,5,6,6,89,183,272,120
3404-001,2016,5,6,7,197,410,607,272
3404-001,2016,5,6,8,356,876,1232,607
3404-001,2016,5,6,9,493,686,1179,1232
3404-001,2016,5,6,10,557,554,1111,1179
3404-001,2016,5,6,11,572,606,1178,1111
3404-001,2016,5,6,12,519,597,1116,1178
3404-001,2016,5,6,13,550,565,1115,1116
3404-001,2016,5,6,14,623,595,1218,1115
3404-001,2016,5,6,15,626,585,1211,1218
3404-001,2016,5,6,16,720,572,1292,1211
3404-001,2016,5,6,17,826,488,1314,1292
3404-001,2016,5,6,18,1133,497,1630,1314
3404-001,2016,5,6,19,997,407,1404,1630
3404-001,2016,5,6,20,531,351,882,1404
3404-001,2016,5,6,21,420,232,652,882
3404-001,2016,5,6,22,304,182,486,652
3404-001,2016,5,6,23,158,141,299,486
3404-001,2016,5,6,24,117,99,216,299
3404-001,2016,5,7,1,72,72,144,216
3404-001,2016,5,7,2,51,57,108,144
3404-001,2016,5,7,3,42,40,82,108
3404-001,2016,5,7,4,35,30,65,82
3404-001,2016,5,7,5,71,70,141,65
3404-001,2016,5,7,6,109,169,278,141
3404-001,2016,5,7,7,212,351,563,278
3404-001,2016,5,7,8,353,552,905,563
3404-001,2016,5,7,9,483,506,989,905
3404-001,2016,5,7,10,431,591,1022,989
3404-001,2016,5,7,11,526,608,1134,1022
3404-001,2016,5,7,12,518,564,1082,1134
3404-001,2016,5,7,13,555,556,1111,1082
3404-001,2016,5,7,14,530,568,1098,1111
3404-001,2016,5,7,15,566,478,1044,1098
3404-001,2016,5,7,16,652,454,1106,1044
3404-001,2016,5,7,17,925,425,1350,1106
3404-001,2016,5,7,18,1244,395,1639,1350
3404-001,2016,5,7,19,1058,339,1397,1639
3404-001,2016,5,7,20,689,283,972,1397
3404-001,2016,5,7,21,502,266,768,972
3404-001,2016,5,7,22,332,192,524,768
3404-001,2016,5,7,23,164,204,368,524
3404-001,2016,5,7,24,100,63,163,368
3404-001,2016,5,8,1,87,69,156,163
3404-001,2016,5,8,2,52,31,83,156
3404-001,2016,5,8,3,38,18,56,83
3404-001,2016,5,8,4,19,29,48,56
3404-001,2016,5,8,5,43,17,60,48
3404-001,2016,5,8,6,56,65,121,60
3404-001,2016,5,8,7,108,134,242,121
3404-001,2016,5,8,8,203,252,455,242
3404-001,2016,5,8,9,275,309,584,455
3404-001,2016,5,8,10,272,314,586,584
3404-001,2016,5,8,11,385,357,742,586
3404-001,2016,5,8,12,384,425,809,742
3404-001,2016,5,8,13,542,403,945,809
3404-001,2016,5,8,14,603,351,954,945
3404-001,2016,5,8,15,693,409,1102,954
3404-001,2016,5,8,16,841,406,1247,1102
3404-001,2016,5,8,17,987,389,1376,1247
3404-001,2016,5,8,18,1028,377,1405,1376
3404-001,2016,5,8,19,836,391,1227,1405
3404-001,2016,5,8,20,423,354,777,1227
3404-001,2016,5,8,21,348,317,665,777
3404-001,2016,5,8,22,258,287,545,665
3404-001,2016,5,8,23,154,137,291,545
3404-001,2016,5,8,24,103,159,262,291
3404-001,2016,5,9,1,51,95,146,262
3404-001,2016,5,9,2,48,51,99,146
3404-001,2016,5,9,3,16,43,59,99
3404-001,2016,5,9,4,27,36,63,59
3404-001,2016,5,9,5,51,81,132,63
3404-001,2016,5,9,6,126,308,434,132
3404-001,2016,5,9,7,309,779,1088,434
3404-001,2016,5,9,8,584,1864,2448,1088
3404-001,2016,5,9,9,742,1382,2124,2448
3404-001,2016,5,9,10,712,693,1405,2124
3404-001,2016,5,9,11,732,666,1398,1405
3404-001,2016,5,9,12,727,694,1421,1398
3404-001,2016,5,9,13,622,629,1251,1421
3404-001,2016,5,9,14,728,642,1370,1251
3404-001,2016,5,9,15,806,713,1519,1370
3404-001,2016,5,9,16,835,700,1535,1519
3404-001,2016,5,9,17,879,645,1524,1535
3404-001,2016,5,9,18,1213,598,1811,1524
3404-001,2016,5,9,19,1135,636,1771,1811
3404-001,2016,5,9,20,858,467,1325,1771
3404-001,2016,5,9,21,780,259,1039,1325
3404-001,2016,5,9,22,484,154,638,1039
3404-001,2016,5,9,23,282,156,438,638
3404-001,2016,5,9,24,150,99,249,438
3404-001,2016,5,10,1,107,91,198,249
3404-001,2016,5,10,2,62,62,124,198
3404-001,2016,5,10,3,52,64,116,124
3404-001,2016,5,10,4,40,41,81,116
3404-001,2016,5,10,5,59,79,138,81
3404-001,2016,5,10,6,129,189,318,138
3404-001,2016,5,10,7,253,603,856,318
3404-001,2016,5,10,8,562,1757,2319,856
3404-001,2016,5,10,9,784,1401,2185,2319
3404-001,2016,5,10,10,642,814,1456,2185
3404-001,2016,5,10,11,718,721,1439,1456
3404-001,2016,5,10,12,756,659,1415,1439
3404-001,2016,5,10,13,667,604,1271,1415
3404-001,2016,5,10,14,725,685,1410,1271
3404-001,2016,5,10,15,757,763,1520,1410
3404-001,2016,5,10,16,835,705,1540,1520
3404-001,2016,5,10,17,865,678,1543,1540
3404-001,2016,5,10,18,1181,609,1790,1543
3404-001,2016,5,10,19,1020,561,1581,1790
3404-001,2016,5,10,20,721,434,1155,1581
3404-001,2016,5,10,21,711,302,1013,1155
3404-001,2016,5,10,22,446,251,697,1013
3404-001,2016,5,10,23,226,204,430,697
3404-001,2016,5,10,24,145,143,288,430
3404-001,2016,5,11,1,101,80,181,288
3404-001,2016,5,11,2,67,28,95,181
3404-001,2016,5,11,3,57,18,75,95
3404-001,2016,5,11,4,43,101,144,75
3404-001,2016,5,11,5,69,100,169,144
3404-001,2016,5,11,6,127,254,381,169
3404-001,2016,5,11,7,299,705,1004,381
3404-001,2016,5,11,8,582,1820,2402,1004
3404-001,2016,5,11,9,845,1344,2189,2402
3404-001,2016,5,11,10,683,803,1486,2189
3404-001,2016,5,11,11,770,818,1588,1486
3404-001,2016,5,11,12,741,789,1530,1588
3404-001,2016,5,11,13,649,654,1303,1530
3404-001,2016,5,11,14,731,671,1402,1303
3404-001,2016,5,11,15,854,800,1654,1402
3404-001,2016,5,11,16,869,737,1606,1654
3404-001,2016,5,11,17,969,722,1691,1606
3404-001,2016,5,11,18,1335,656,1991,1691
3404-001,2016,5,11,19,1214,581,1795,1991
3404-001,2016,5,11,20,740,472,1212,1795
3404-001,2016,5,11,21,651,295,946,1212
3404-001,2016,5,11,22,391,282,673,946
3404-001,2016,5,11,23,254,207,461,673
3404-001,2016,5,11,24,149,151,300,461
3404-001,2016,5,12,1,114,87,201,300
3404-001,2016,5,12,2,59,73,132,201
3404-001,2016,5,12,3,59,53,112,132
3404-001,2016,5,12,4,55,57,112,112
3404-001,2016,5,12,5,76,85,161,112
3404-001,2016,5,12,6,140,243,383,161
3404-001,2016,5,12,7,294,631,925,383
3404-001,2016,5,12,8,543,1749,2292,925
3404-001,2016,5,12,9,882,1334,2216,2292
3404-001,2016,5,12,10,688,766,1454,2216
3404-001,2016,5,12,11,694,737,1431,1454
3404-001,2016,5,12,12,742,633,1375,1431
3404-001,2016,5,12,13,687,635,1322,1375
3404-001,2016,5,12,14,714,685,1399,1322
3404-001,2016,5,12,15,803,712,1515,1399
3404-001,2016,5,12,16,866,606,1472,1515
3404-001,2016,5,12,17,880,616,1496,1472
3404-001,2016,5,12,18,1238,566,1804,1496
3404-001,2016,5,12,19,1172,563,1735,1804
3404-001,2016,5,12,20,829,441,1270,1735
3404-001,2016,5,12,21,812,295,1107,1270
3404-001,2016,5,12,22,449,258,707,1107
3404-001,2016,5,12,23,246,205,451,707
3404-001,2016,5,12,24,142,115,257,451
3404-001,2016,5,13,1,110,183,293,257
3404-001,2016,5,13,2,86,140,226,293
3404-001,2016,5,13,3,51,196,247,226
3404-001,2016,5,13,4,59,78,137,247
3404-001,2016,5,13,5,81,49,130,137
3404-001,2016,5,13,6,136,223,359,130
3404-001,2016,5,13,7,258,883,1141,359
3404-001,2016,5,13,8,567,1789,2356,1141
3404-001,2016,5,13,9,845,1290,2135,2356
3404-001,2016,5,13,10,728,694,1422,2135
3404-001,2016,5,13,11,775,627,1402,1422
3404-001,2016,5,13,12,759,658,1417,1402
3404-001,2016,5,13,13,676,628,1304,1417
3404-001,2016,5,13,14,767,612,1379,1304
3404-001,2016,5,13,15,848,701,1549,1379
3404-001,2016,5,13,16,1027,719,1746,1549
3404-001,2016,5,13,17,1004,603,1607,1746
3404-001,2016,5,13,18,1407,531,1938,1607
3404-001,2016,5,13,19,1468,531,1999,1938
3404-001,2016,5,13,20,904,434,1338,1999
3404-001,2016,5,13,21,689,263,952,1338
3404-001,2016,5,13,22,432,193,625,952
3404-001,2016,5,13,23,275,153,428,625
3404-001,2016,5,13,24,164,82,246,428
3404-001,2016,5,14,1,120,59,179,246
3404-001,2016,5,14,2,86,31,117,179
3404-001,2016,5,14,3,65,38,103,117
3404-001,2016,5,14,4,59,54,113,103
3404-001,2016,5,14,5,77,57,134,113
3404-001,2016,5,14,6,127,142,269,134
3404-001,2016,5,14,7,242,334,576,269
3404-001,2016,5,14,8,378,639,1017,576
3404-001,2016,5,14,9,522,588,1110,1017
3404-001,2016,5,14,10,516,607,1123,1110
3404-001,2016,5,14,11,534,612,1146,1123
3404-001,2016,5,14,12,482,571,1053,1146
3404-001,2016,5,14,13,457,504,961,1053
3404-001,2016,5,14,14,489,480,969,961
3404-001,2016,5,14,15,522,454,976,969
3404-001,2016,5,14,16,588,418,1006,976
3404-001,2016,5,14,17,698,393,1091,1006
3404-001,2016,5,14,18,1012,405,1417,1091
3404-001,2016,5,14,19,722,311,1033,1417
3404-001,2016,5,14,20,464,240,704,1033
3404-001,2016,5,14,21,338,156,494,704
3404-001,2016,5,14,22,263,130,393,494
3404-001,2016,5,14,23,172,150,322,393
3404-001,2016,5,14,24,124,165,289,322
3404-001,2016,5,15,1,63,97,160,289
3404-001,2016,5,15,2,58,50,108,160
3404-001,2016,5,15,3,39,37,76,108
3404-001,2016,5,15,4,29,57,86,76
3404-001,2016,5,15,5,33,33,66,86
3404-001,2016,5,15,6,71,102,173,66
3404-001,2016,5,15,7,112,268,380,173
3404-001,2016,5,15,8,182,250,432,380
3404-001,2016,5,15,9,252,288,540,432
3404-001,2016,5,15,10,295,304,599,540
3404-001,2016,5,15,11,312,364,676,599
3404-001,2016,5,15,12,392,394,786,676
3404-001,2016,5,15,13,380,406,786,786
3404-001,2016,5,15,14,401,352,753,786
3404-001,2016,5,15,15,548,396,944,753
3404-001,2016,5,15,16,601,394,995,944
3404-001,2016,5,15,17,746,370,1116,995
3404-001,2016,5,15,18,790,356,1146,1116
3404-001,2016,5,15,19,567,350,917,1146
3404-001,2016,5,15,20,359,322,681,917
3404-001,2016,5,15,21,199,278,477,681
3404-001,2016,5,15,22,155,258,413,477
3404-001,2016,5,15,23,97,187,284,413
3404-001,2016,5,15,24,79,144,223,284
3404-001,2016,5,16,1,57,139,196,223
3404-001,2016,5,16,2,40,87,127,196
3404-001,2016,5,16,3,30,76,106,127
3404-001,2016,5,16,4,30,76,106,106
3404-001,2016,5,16,5,67,69,136,106
3404-001,2016,5,16,6,128,281,409,136
3404-001,2016,5,16,7,263,794,1057,409
3404-001,2016,5,16,8,591,1564,2155,1057
3404-001,2016,5,16,9,765,1410,2175,2155
3404-001,2016,5,16,10,695,767,1462,2175
3404-001,2016,5,16,11,722,699,1421,1462
3404-001,2016,5,16,12,712,681,1393,1421
3404-001,2016,5,16,13,631,696,1327,1393
3404-001,2016,5,16,14,710,745,1455,1327
3404-001,2016,5,16,15,808,808,1616,1455
3404-001,2016,5,16,16,854,787,1641,1616
3404-001,2016,5,16,17,872,697,1569,1641
3404-001,2016,5,16,18,1161,613,1774,1569
3404-001,2016,5,16,19,1036,606,1642,1774
3404-001,2016,5,16,20,794,527,1321,1642
3404-001,2016,5,16,21,763,360,1123,1321
3404-001,2016,5,16,22,451,254,705,1123
3404-001,2016,5,16,23,242,198,440,705
3404-001,2016,5,16,24,142,132,274,440
3404-001,2016,5,17,1,100,100,200,274
3404-001,2016,5,17,2,59,115,174,200
3404-001,2016,5,17,3,39,80,119,174
3404-001,2016,5,17,4,45,94,139,119
3404-001,2016,5,17,5,54,82,136,139
3404-001,2016,5,17,6,173,278,451,136
3404-001,2016,5,17,7,258,659,917,451
3404-001,2016,5,17,8,624,1806,2430,917
3404-001,2016,5,17,9,812,1323,2135,2430
3404-001,2016,5,17,10,775,768,1543,2135
3404-001,2016,5,17,11,783,755,1538,1543
3404-001,2016,5,17,12,684,779,1463,1538
3404-001,2016,5,17,13,641,644,1285,1463
3404-001,2016,5,17,14,711,702,1413,1285
3404-001,2016,5,17,15,848,827,1675,1413
3404-001,2016,5,17,16,879,714,1593,1675
3404-001,2016,5,17,17,947,636,1583,1593
3404-001,2016,5,17,18,1265,682,1947,1583
3404-001,2016,5,17,19,1092,583,1675,1947
3404-001,2016,5,17,20,792,497,1289,1675
3404-001,2016,5,17,21,811,367,1178,1289
3404-001,2016,5,17,22,466,313,779,1178
3404-001,2016,5,17,23,288,239,527,779
3404-001,2016,5,17,24,137,179,316,527
3404-001,2016,5,18,1,109,111,220,316
3404-001,2016,5,18,2,62,57,119,220
3404-001,2016,5,18,3,44,78,122,119
3404-001,2016,5,18,4,32,54,86,122
3404-001,2016,5,18,5,60,123,183,86
3404-001,2016,5,18,6,143,286,429,183
3404-001,2016,5,18,7,281,713,994,429
3404-001,2016,5,18,8,584,1642,2226,994
3404-001,2016,5,18,9,874,1387,2261,2226
3404-001,2016,5,18,10,733,926,1659,2261
3404-001,2016,5,18,11,781,747,1528,1659
3404-001,2016,5,18,12,655,697,1352,1528
3404-001,2016,5,18,13,646,606,1252,1352
3404-001,2016,5,18,14,690,728,1418,1252
3404-001,2016,5,18,15,849,831,1680,1418
3404-001,2016,5,18,16,856,692,1548,1680
3404-001,2016,5,18,17,853,721,1574,1548
3404-001,2016,5,18,18,1333,661,1994,1574
3404-001,2016,5,18,19,1227,654,1881,1994
3404-001,2016,5,18,20,822,543,1365,1881
3404-001,2016,5,18,21,694,311,1005,1365
3404-001,2016,5,18,22,417,199,616,1005
3404-001,2016,5,18,23,224,202,426,616
3404-001,2016,5,18,24,177,175,352,426
3404-001,2016,5,19,1,92,187,279,352
3404-001,2016,5,19,2,72,71,143,279
3404-001,2016,5,19,3,49,76,125,143
3404-001,2016,5,19,4,47,40,87,125
3404-001,2016,5,19,5,68,93,161,87
3404-001,2016,5,19,6,143,309,452,161
3404-001,2016,5,19,7,295,799,1094,452
3404-001,2016,5,19,8,583,2014,2597,1094
3404-001,2016,5,19,9,859,1594,2453,2597
3404-001,2016,5,19,10,719,756,1475,2453
3404-001,2016,5,19,11,783,711,1494,1475
3404-001,2016,5,19,12,765,530,1295,1494
3404-001,2016,5,19,13,616,542,1158,1295
3404-001,2016,5,19,14,773,554,1327,1158
3404-001,2016,5,19,15,865,594,1459,1327
3404-001,2016,5,19,16,901,604,1505,1459
3404-001,2016,5,19,17,917,577,1494,1505
3404-001,2016,5,19,18,1198,564,1762,1494
3404-001,2016,5,19,19,1142,718,1860,1762
3404-001,2016,5,19,20,828,402,1230,1860
3404-001,2016,5,19,21,738,308,1046,1230
3404-001,2016,5,19,22,470,181,651,1046
3404-001,2016,5,19,23,271,159,430,651
3404-001,2016,5,19,24,171,96,267,430
3404-001,2016,5,20,1,106,89,195,267
3404-001,2016,5,20,2,61,119,180,195
3404-001,2016,5,20,3,56,62,118,180
3404-001,2016,5,20,4,65,28,93,118
3404-001,2016,5,20,5,76,112,188,93
3404-001,2016,5,20,6,157,276,433,188
3404-001,2016,5,20,7,282,722,1004,433
3404-001,2016,5,20,8,581,1965,2546,1004
3404-001,2016,5,20,9,870,1621,2491,2546
3404-001,2016,5,20,10,707,958,1665,2491
3404-001,2016,5,20,11,778,819,1597,1665
3404-001,2016,5,20,12,790,588,1378,1597
3404-001,2016,5,20,13,679,567,1246,1378
3404-001,2016,5,20,14,714,605,1319,1246
3404-001,2016,5,20,15,920,639,1559,1319
3404-001,2016,5,20,16,986,579,1565,1559
3404-001,2016,5,20,17,970,573,1543,1565
3404-001,2016,5,20,18,1508,618,2126,1543
3404-001,2016,5,20,19,1335,861,2196,2126
3404-001,2016,5,20,20,920,466,1386,2196
3404-001,2016,5,20,21,788,275,1063,1386
3404-001,2016,5,20,22,419,213,632,1063
3404-001,2016,5,20,23,249,152,401,632
3404-001,2016,5,20,24,126,124,250,401
3404-001,2016,5,21,1,112,64,176,250
3404-001,2016,5,21,2,84,64,148,176
3404-001,2016,5,21,3,60,22,82,148
3404-001,2016,5,21,4,53,39,92,82
3404-001,2016,5,21,5,71,60,131,92
3404-001,2016,5,21,6,137,168,305,131
3404-001,2016,5,21,7,274,509,783,305
3404-001,2016,5,21,8,443,960,1403,783
3404-001,2016,5,21,9,605,943,1548,1403
3404-001,2016,5,21,10,556,717,1273,1548
3404-001,2016,5,21,11,608,727,1335,1273
3404-001,2016,5,21,12,541,609,1150,1335
3404-001,2016,5,21,13,488,609,1097,1150
3404-001,2016,5,21,14,499,469,968,1097
3404-001,2016,5,21,15,579,494,1073,968
3404-001,2016,5,21,16,623,436,1059,1073
3404-001,2016,5,21,17,691,409,1100,1059
3404-001,2016,5,21,18,1011,400,1411,1100
3404-001,2016,5,21,19,705,325,1030,1411
3404-001,2016,5,21,20,422,262,684,1030
3404-001,2016,5,21,21,348,211,559,684
3404-001,2016,5,21,22,222,161,383,559
3404-001,2016,5,21,23,170,213,383,383
3404-001,2016,5,21,24,140,87,227,383
3404-001,2016,5,22,1,110,70,180,227
3404-001,2016,5,22,2,60,38,98,180
3404-001,2016,5,22,3,41,24,65,98
3404-001,2016,5,22,4,31,32,63,65
3404-001,2016,5,22,5,37,39,76,63
3404-001,2016,5,22,6,80,73,153,76
3404-001,2016,5,22,7,135,174,309,153
3404-001,2016,5,22,8,212,245,457,309
3404-001,2016,5,22,9,267,268,535,457
3404-001,2016,5,22,10,278,298,576,535
3404-001,2016,5,22,11,320,355,675,576
3404-001,2016,5,22,12,366,557,923,675
3404-001,2016,5,22,13,380,542,922,923
3404-001,2016,5,22,14,391,515,906,922
3404-001,2016,5,22,15,435,493,928,906
3404-001,2016,5,22,16,568,414,982,928
3404-001,2016,5,22,17,646,357,1003,982
3404-001,2016,5,22,18,661,307,968,1003
3404-001,2016,5,22,19,590,370,960,968
3404-001,2016,5,22,20,417,239,656,960
3404-001,2016,5,22,21,340,188,528,656
3404-001,2016,5,22,22,204,208,412,528
3404-001,2016,5,22,23,170,195,365,412
3404-001,2016,5,22,24,85,98,183,365
3404-001,2016,5,23,1,66,98,164,183
3404-001,2016,5,23,2,47,34,81,164
3404-001,2016,5,23,3,33,43,76,81
3404-001,2016,5,23,4,46,65,111,76
3404-001,2016,5,23,5,53,112,165,111
3404-001,2016,5,23,6,160,278,438,165
3404-001,2016,5,23,7,290,873,1163,438
3404-001,2016,5,23,8,621,2182,2803,1163
3404-001,2016,5,23,9,751,1529,2280,2803
3404-001,2016,5,23,10,701,881,1582,2280
3404-001,2016,5,23,11,694,821,1515,1582
3404-001,2016,5,23,12,737,753,1490,1515
3404-001,2016,5,23,13,584,710,1294,1490
3404-001,2016,5,23,14,740,842,1582,1294
3404-001,2016,5,23,15,859,826,1685,1582
3404-001,2016,5,23,16,893,826,1719,1685
3404-001,2016,5,23,17,916,765,1681,1719
3404-001,2016,5,23,18,1248,646,1894,1681
3404-001,2016,5,23,19,1137,528,1665,1894
3404-001,2016,5,23,20,853,517,1370,1665
3404-001,2016,5,23,21,769,322,1091,1370
3404-001,2016,5,23,22,455,209,664,1091
3404-001,2016,5,23,23,247,105,352,664
3404-001,2016,5,23,24,126,76,202,352
3404-001,2016,5,24,1,80,60,140,202
3404-001,2016,5,24,2,53,63,116,140
3404-001,2016,5,24,3,65,53,118,116
3404-001,2016,5,24,4,45,57,102,118
3404-001,2016,5,24,5,65,39,104,102
3404-001,2016,5,24,6,118,175,293,104
3404-001,2016,5,24,7,219,587,806,293
3404-001,2016,5,24,8,497,1873,2370,806
3404-001,2016,5,24,9,745,1544,2289,2370
3404-001,2016,5,24,10,657,789,1446,2289
3404-001,2016,5,24,11,621,616,1237,1446
3404-001,2016,5,24,12,719,538,1257,1237
3404-001,2016,5,24,13,651,571,1222,1257
3404-001,2016,5,24,14,626,600,1226,1222
3404-001,2016,5,24,15,750,708,1458,1226
3404-001,2016,5,24,16,782,839,1621,1458
3404-001,2016,5,24,17,802,740,1542,1621
3404-001,2016,5,24,18,1154,778,1932,1542
3404-001,2016,5,24,19,1072,718,1790,1932
3404-001,2016,5,24,20,847,520,1367,1790
3404-001,2016,5,24,21,742,377,1119,1367
3404-001,2016,5,24,22,427,377,804,1119
3404-001,2016,5,24,23,237,323,560,804
3404-001,2016,5,24,24,142,149,291,560
3404-001,2016,5,25,1,107,132,239,291
3404-001,2016,5,25,2,58,115,173,239
3404-001,2016,5,25,3,39,106,145,173
3404-001,2016,5,25,4,47,49,96,145
3404-001,2016,5,25,5,66,95,161,96
3404-001,2016,5,25,6,179,312,491,161
3404-001,2016,5,25,7,277,823,1100,491
3404-001,2016,5,25,8,564,2023,2587,1100
3404-001,2016,5,25,9,851,1670,2521,2587
3404-001,2016,5,25,10,814,693,1507,2521
3404-001,2016,5,25,11,742,747,1489,1507
3404-001,2016,5,25,12,741,921,1662,1489
3404-001,2016,5,25,13,658,705,1363,1662
3404-001,2016,5,25,14,712,836,1548,1363
3404-001,2016,5,25,15,842,615,1457,1548
3404-001,2016,5,25,16,817,626,1443,1457
3404-001,2016,5,25,17,874,569,1443,1443
3404-001,2016,5,25,18,1343,479,1822,1443
3404-001,2016,5,25,19,1270,706,1976,1822
3404-001,2016,5,25,20,802,563,1365,1976
3404-001,2016,5,25,21,642,242,884,1365
3404-001,2016,5,25,22,390,181,571,884
3404-001,2016,5,25,23,213,159,372,571
3404-001,2016,5,25,24,118,105,223,372
3404-001,2016,5,26,1,114,98,212,223
3404-001,2016,5,26,2,60,83,143,212
3404-001,2016,5,26,3,47,32,79,143
3404-001,2016,5,26,4,64,56,120,79
3404-001,2016,5,26,5,69,81,150,120
3404-001,2016,5,26,6,163,206,369,150
3404-001,2016,5,26,7,275,710,985,369
3404-001,2016,5,26,8,582,1939,2521,985
3404-001,2016,5,26,9,846,1481,2327,2521
3404-001,2016,5,26,10,753,944,1697,2327
3404-001,2016,5,26,11,762,789,1551,1697
3404-001,2016,5,26,12,733,842,1575,1551
3404-001,2016,5,26,13,651,700,1351,1575
3404-001,2016,5,26,14,730,603,1333,1351
3404-001,2016,5,26,15,834,827,1661,1333
3404-001,2016,5,26,16,898,866,1764,1661
3404-001,2016,5,26,17,891,789,1680,1764
3404-001,2016,5,26,18,1241,846,2087,1680
3404-001,2016,5,26,19,1138,479,1617,2087
3404-001,2016,5,26,20,844,577,1421,1617
3404-001,2016,5,26,21,702,360,1062,1421
3404-001,2016,5,26,22,470,249,719,1062
3404-001,2016,5,26,23,260,179,439,719
3404-001,2016,5,26,24,166,93,259,439
3404-001,2016,5,27,1,109,77,186,259
3404-001,2016,5,27,2,54,43,97,186
3404-001,2016,5,27,3,49,49,98,97
3404-001,2016,5,27,4,51,39,90,98
3404-001,2016,5,27,5,75,83,158,90
3404-001,2016,5,27,6,144,224,368,158
3404-001,2016,5,27,7,285,602,887,368
3404-001,2016,5,27,8,568,1644,2212,887
3404-001,2016,5,27,9,839,1382,2221,2212
3404-001,2016,5,27,10,733,760,1493,2221
3404-001,2016,5,27,11,781,863,1644,1493
3404-001,2016,5,27,12,769,846,1615,1644
3404-001,2016,5,27,13,686,710,1396,1615
3404-001,2016,5,27,14,773,866,1639,1396
3404-001,2016,5,27,15,786,925,1711,1639
3404-001,2016,5,27,16,874,870,1744,1711
3404-001,2016,5,27,17,1020,731,1751,1744
3404-001,2016,5,27,18,1447,636,2083,1751
3404-001,2016,5,27,19,1448,740,2188,2083
3404-001,2016,5,27,20,902,652,1554,2188
3404-001,2016,5,27,21,729,402,1131,1554
3404-001,2016,5,27,22,418,304,722,1131
3404-001,2016,5,27,23,235,155,390,722
3404-001,2016,5,27,24,163,115,278,390
3404-001,2016,5,28,1,125,67,192,278
3404-001,2016,5,28,2,75,58,133,192
3404-001,2016,5,28,3,60,25,85,133
3404-001,2016,5,28,4,46,75,121,85
3404-001,2016,5,28,5,65,60,125,121
3404-001,2016,5,28,6,129,132,261,125
3404-001,2016,5,28,7,282,267,549,261
3404-001,2016,5,28,8,439,727,1166,549
3404-001,2016,5,28,9,557,550,1107,1166
3404-001,2016,5,28,10,572,540,1112,1107
3404-001,2016,5,28,11,560,598,1158,1112
3404-001,2016,5,28,12,576,564,1140,1158
3404-001,2016,5,28,13,533,496,1029,1140
3404-001,2016,5,28,14,538,476,1014,1029
3404-001,2016,5,28,15,555,611,1166,1014
3404-001,2016,5,28,16,577,539,1116,1166
3404-001,2016,5,28,17,671,499,1170,1116
3404-001,2016,5,28,18,990,507,1497,1170
3404-001,2016,5,28,19,728,492,1220,1497
3404-001,2016,5,28,20,420,301,721,1220
3404-001,2016,5,28,21,375,200,575,721
3404-001,2016,5,28,22,273,209,482,575
3404-001,2016,5,28,23,155,139,294,482
3404-001,2016,5,28,24,103,65,168,294
3404-001,2016,5,29,1,82,56,138,168
3404-001,2016,5,29,2,49,43,92,138
3404-001,2016,5,29,3,35,33,68,92
3404-001,2016,5,29,4,40,29,69,68
3404-001,2016,5,29,5,42,32,74,69
3404-001,2016,5,29,6,77,85,162,74
3404-001,2016,5,29,7,128,217,345,162
3404-001,2016,5,29,8,205,296,501,345
3404-001,2016,5,29,9,266,310,576,501
3404-001,2016,5,29,10,267,348,615,576
3404-001,2016,5,29,11,302,356,658,615
3404-001,2016,5,29,12,322,402,724,658
3404-001,2016,5,29,13,301,452,753,724
3404-001,2016,5,29,14,344,434,778,753
3404-001,2016,5,29,15,455,444,899,778
3404-001,2016,5,29,16,539,404,943,899
3404-001,2016,5,29,17,592,364,956,943
3404-001,2016,5,29,18,663,332,995,956
3404-001,2016,5,29,19,571,360,931,995
3404-001,2016,5,29,20,357,280,637,931
3404-001,2016,5,29,21,326,233,559,637
3404-001,2016,5,29,22,245,233,478,559
3404-001,2016,5,29,23,146,191,337,478
3404-001,2016,5,29,24,91,121,212,337
3404-001,2016,5,30,1,52,95,147,212
3404-001,2016,5,30,2,35,37,72,147
3404-001,2016,5,30,3,27,35,62,72
3404-001,2016,5,30,4,35,33,68,62
3404-001,2016,5,30,5,58,61,119,68
3404-001,2016,5,30,6,133,210,343,119
3404-001,2016,5,30,7,303,708,1011,343
3404-001,2016,5,30,8,607,1936,2543,1011
3404-001,2016,5,30,9,754,1526,2280,2543
3404-001,2016,5,30,10,687,880,1567,2280
3404-001,2016,5,30,11,725,691,1416,1567
3404-001,2016,5,30,12,701,664,1365,1416
3404-001,2016,5,30,13,672,674,1346,1365
3404-001,2016,5,30,14,673,746,1419,1346
3404-001,2016,5,30,15,812,742,1554,1419
3404-001,2016,5,30,16,908,797,1705,1554
3404-001,2016,5,30,17,886,867,1753,1705
3404-001,2016,5,30,18,1190,545,1735,1753
3404-001,2016,5,30,19,1123,608,1731,1735
3404-001,2016,5,30,20,884,533,1417,1731
3404-001,2016,5,30,21,795,271,1066,1417
3404-001,2016,5,30,22,491,238,729,1066
3404-001,2016,5,30,23,224,135,359,729
3404-001,2016,5,30,24,130,85,215,359
3404-001,2016,5,31,1,98,83,181,215
3404-001,2016,5,31,2,78,40,118,181
3404-001,2016,5,31,3,58,33,91,118
3404-001,2016,5,31,4,62,36,98,91
3404-001,2016,5,31,5,77,58,135,98
3404-001,2016,5,31,6,132,197,329,135
3404-001,2016,5,31,7,286,576,862,329
3404-001,2016,5,31,8,554,1749,2303,862
3404-001,2016,5,31,9,873,1302,2175,2303
3404-001,2016,5,31,10,679,807,1486,2175
3404-001,2016,5,31,11,722,882,1604,1486
3404-001,2016,5,31,12,752,797,1549,1604
3404-001,2016,5,31,13,653,761,1414,1549
3404-001,2016,5,31,14,718,847,1565,1414
3404-001,2016,5,31,15,843,862,1705,1565
3404-001,2016,5,31,16,864,841,1705,1705
3404-001,2016,5,31,17,901,766,1667,1705
3404-001,2016,5,31,18,1289,846,2135,1667
3404-001,2016,5,31,19,1170,651,1821,2135
3404-001,2016,5,31,20,807,444,1251,1821
3404-001,2016,5,31,21,724,264,988,1251
3404-001,2016,5,31,22,482,172,654,988
3404-001,2016,5,31,23,258,124,382,654
3404-001,2016,5,31,24,141,68,209,382
3404-001,2016,6,1,1,81,75,156,209
3404-001,2016,6,1,2,69,44,113,156
3404-001,2016,6,1,3,44,43,87,113
3404-001,2016,6,1,4,44,27,71,87
3404-001,2016,6,1,5,74,46,120,71
3404-001,2016,6,1,6,139,183,322,120
3404-001,2016,6,1,7,276,616,892,322
3404-001,2016,6,1,8,583,1904,2487,892
3404-001,2016,6,1,9,842,1557,2399,2487
3404-001,2016,6,1,10,749,873,1622,2399
3404-001,2016,6,1,11,710,901,1611,1622
3404-001,2016,6,1,12,731,949,1680,1611
3404-001,2016,6,1,13,641,590,1231,1680
3404-001,2016,6,1,14,640,787,1427,1231
3404-001,2016,6,1,15,841,939,1780,1427
3404-001,2016,6,1,16,882,916,1798,1780
3404-001,2016,6,1,17,906,847,1753,1798
3404-001,2016,6,1,18,1407,678,2085,1753
3404-001,2016,6,1,19,1278,755,2033,2085
3404-001,2016,6,1,20,854,448,1302,2033
3404-001,2016,6,1,21,625,274,899,1302
3404-001,2016,6,1,22,416,175,591,899
3404-001,2016,6,1,23,234,164,398,591
3404-001,2016,6,1,24,166,101,267,398
3404-001,2016,6,2,1,95,63,158,267
3404-001,2016,6,2,2,70,74,144,158
3404-001,2016,6,2,3,54,30,84,144
3404-001,2016,6,2,4,41,24,65,84
3404-001,2016,6,2,5,71,60,131,65
3404-001,2016,6,2,6,166,236,402,131
3404-001,2016,6,2,7,265,614,879,402
3404-001,2016,6,2,8,592,1778,2370,879
3404-001,2016,6,2,9,807,1491,2298,2370
3404-001,2016,6,2,10,752,836,1588,2298
3404-001,2016,6,2,11,743,969,1712,1588
3404-001,2016,6,2,12,716,919,1635,1712
3404-001,2016,6,2,13,661,684,1345,1635
3404-001,2016,6,2,14,723,899,1622,1345
3404-001,2016,6,2,15,809,908,1717,1622
3404-001,2016,6,2,16,956,813,1769,1717
3404-001,2016,6,2,17,876,634,1510,1769
3404-001,2016,6,2,18,1294,667,1961,1510
3404-001,2016,6,2,19,1214,558,1772,1961
3404-001,2016,6,2,20,812,500,1312,1772
3404-001,2016,6,2,21,789,326,1115,1312
3404-001,2016,6,2,22,462,324,786,1115
3404-001,2016,6,2,23,312,177,489,786
3404-001,2016,6,2,24,159,153,312,489
3404-001,2016,6,3,1,117,96,213,312
3404-001,2016,6,3,2,68,88,156,213
3404-001,2016,6,3,3,43,58,101,156
3404-001,2016,6,3,4,44,34,78,101
3404-001,2016,6,3,5,72,142,214,78
3404-001,2016,6,3,6,145,294,439,214
3404-001,2016,6,3,7,290,621,911,439
3404-001,2016,6,3,8,584,1778,2362,911
3404-001,2016,6,3,9,804,1371,2175,2362
3404-001,2016,6,3,10,727,901,1628,2175
3404-001,2016,6,3,11,783,905,1688,1628
3404-001,2016,6,3,12,783,925,1708,1688
3404-001,2016,6,3,13,682,751,1433,1708
3404-001,2016,6,3,14,750,908,1658,1433
3404-001,2016,6,3,15,859,859,1718,1658
3404-001,2016,6,3,16,907,919,1826,1718
3404-001,2016,6,3,17,991,890,1881,1826
3404-001,2016,6,3,18,1499,811,2310,1881
3404-001,2016,6,3,19,1499,705,2204,2310
3404-001,2016,6,3,20,1012,641,1653,2204
3404-001,2016,6,3,21,816,437,1253,1653
3404-001,2016,6,3,22,442,222,664,1253
3404-001,2016,6,3,23,232,204,436,664
3404-001,2016,6,3,24,146,95,241,436
3404-001,2016,6,4,1,115,111,226,241
3404-001,2016,6,4,2,79,105,184,226
3404-001,2016,6,4,3,54,77,131,184
3404-001,2016,6,4,4,46,143,189,131
3404-001,2016,6,4,5,82,266,348,189
3404-001,2016,6,4,6,141,215,356,348
3404-001,2016,6,4,7,273,516,789,356
3404-001,2016,6,4,8,430,902,1332,789
3404-001,2016,6,4,9,610,836,1446,1332
3404-001,2016,6,4,10,588,788,1376,1446
3404-001,2016,6,4,11,601,826,1427,1376
3404-001,2016,6,4,12,550,974,1524,1427
3404-001,2016,6,4,13,503,922,1425,1524
3404-001,2016,6,4,14,589,873,1462,1425
3404-001,2016,6,4,15,565,808,1373,1462
3404-001,2016,6,4,16,586,969,1555,1373
3404-001,2016,6,4,17,669,980,1649,1555
3404-001,2016,6,4,18,972,835,1807,1649
3404-001,2016,6,4,19,704,530,1234,1807
3404-001,2016,6,4,20,426,626,1052,1234
3404-001,2016,6,4,21,311,430,741,1052
3404-001,2016,6,4,22,242,225,467,741
3404-001,2016,6,4,23,145,140,285,467
3404-001,2016,6,4,24,124,81,205,285
3404-001,2016,6,5,1,91,58,149,205
3404-001,2016,6,5,2,51,65,116,149
3404-001,2016,6,5,3,43,29,72,116
3404-001,2016,6,5,4,43,48,91,72
3404-001,2016,6,5,5,37,56,93,91
3404-001,2016,6,5,6,81,96,177,93
3404-001,2016,6,5,7,142,231,373,177
3404-001,2016,6,5,8,205,266,471,373
3404-001,2016,6,5,9,293,280,573,471
3404-001,2016,6,5,10,288,352,640,573
3404-001,2016,6,5,11,329,574,903,640
3404-001,2016,6,5,12,327,506,833,903
3404-001,2016,6,5,13,340,418,758,833
3404-001,2016,6,5,14,379,407,786,758
3404-001,2016,6,5,15,505,473,978,786
3404-001,2016,6,5,16,518,332,850,978
3404-001,2016,6,5,17,556,294,850,850
3404-001,2016,6,5,18,832,300,1132,850
3404-001,2016,6,5,19,646,287,933,1132
3404-001,2016,6,5,20,606,240,846,933
3404-001,2016,6,5,21,458,212,670,846
3404-001,2016,6,5,22,285,153,438,670
3404-001,2016,6,5,23,207,119,326,438
3404-001,2016,6,5,24,127,94,221,326
3404-001,2016,6,6,1,93,60,153,221
3404-001,2016,6,6,2,66,37,103,153
3404-001,2016,6,6,3,41,82,123,103
3404-001,2016,6,6,4,26,30,56,123
3404-001,2016,6,6,5,50,64,114,56
3404-001,2016,6,6,6,124,221,345,114
3404-001,2016,6,6,7,197,446,643,345
3404-001,2016,6,6,8,304,601,905,643
3404-001,2016,6,6,9,390,511,901,905
3404-001,2016,6,6,10,391,431,822,901
3404-001,2016,6,6,11,410,479,889,822
3404-001,2016,6,6,12,443,458,901,889
3404-001,2016,6,6,13,475,389,864,901
3404-001,2016,6,6,14,567,496,1063,864
3404-001,2016,6,6,15,697,581,1278,1063
3404-001,2016,6,6,16,915,492,1407,1278
3404-001,2016,6,6,17,1104,504,1608,1407
3404-001,2016,6,6,18,1506,377,1883,1608
3404-001,2016,6,6,19,936,358,1294,1883
3404-001,2016,6,6,20,601,355,956,1294
3404-001,2016,6,6,21,403,380,783,956
3404-001,2016,6,6,22,250,243,493,783
3404-001,2016,6,6,23,157,142,299,493
3404-001,2016,6,6,24,102,95,197,299
3404-001,2016,6,7,1,46,74,120,197
3404-001,2016,6,7,2,44,47,91,120
3404-001,2016,6,7,3,27,33,60,91
3404-001,2016,6,7,4,37,34,71,60
3404-001,2016,6,7,5,67,63,130,71
3404-001,2016,6,7,6,162,263,425,130
3404-001,2016,6,7,7,296,737,1033,425
3404-001,2016,6,7,8,581,2194,2775,1033
3404-001,2016,6,7,9,789,1446,2235,2775
3404-001,2016,6,7,10,715,1035,1750,2235
3404-001,2016,6,7,11,744,737,1481,1750
3404-001,2016,6,7,12,728,662,1390,1481
3404-001,2016,6,7,13,602,561,1163,1390
3404-001,2016,6,7,14,696,696,1392,1163
3404-001,2016,6,7,15,830,768,1598,1392
3404-001,2016,6,7,16,881,763,1644,1598
3404-001,2016,6,7,17,901,651,1552,1644
3404-001,2016,6,7,18,1242,524,1766,1552
3404-001,2016,6,7,19,1124,463,1587,1766
3404-001,2016,6,7,20,802,582,1384,1587
3404-001,2016,6,7,21,787,490,1277,1384
3404-001,2016,6,7,22,447,372,819,1277
3404-001,2016,6,7,23,214,226,440,819
3404-001,2016,6,7,24,139,88,227,440
3404-001,2016,6,8,1,103,57,160,227
3404-001,2016,6,8,2,60,60,120,160
3404-001,2016,6,8,3,56,70,126,120
3404-001,2016,6,8,4,51,70,121,126
3404-001,2016,6,8,5,77,109,186,121
3404-001,2016,6,8,6,172,305,477,186
3404-001,2016,6,8,7,282,727,1009,477
3404-001,2016,6,8,8,584,2232,2816,1009
3404-001,2016,6,8,9,854,1237,2091,2816
3404-001,2016,6,8,10,716,654,1370,2091
3404-001,2016,6,8,11,784,990,1774,1370
3404-001,2016,6,8,12,740,942,1682,1774
3404-001,2016,6,8,13,630,827,1457,1682
3404-001,2016,6,8,14,694,877,1571,1457
3404-001,2016,6,8,15,785,875,1660,1571
3404-001,2016,6,8,16,871,689,1560,1660
3404-001,2016,6,8,17,887,645,1532,1560
3404-001,2016,6,8,18,1360,823,2183,1532
3404-001,2016,6,8,19,1279,796,2075,2183
3404-001,2016,6,8,20,800,681,1481,2075
3404-001,2016,6,8,21,674,466,1140,1481
3404-001,2016,6,8,22,426,324,750,1140
3404-001,2016,6,8,23,287,346,633,750
3404-001,2016,6,8,24,153,181,334,633
3404-001,2016,6,9,1,82,119,201,334
3404-001,2016,6,9,2,64,89,153,201
3404-001,2016,6,9,3,53,68,121,153
3404-001,2016,6,9,4,50,108,158,121
3404-001,2016,6,9,5,84,88,172,158
3404-001,2016,6,9,6,164,252,416,172
3404-001,2016,6,9,7,309,813,1122,416
3404-001,2016,6,9,8,589,2218,2807,1122
3404-001,2016,6,9,9,838,1798,2636,2807
3404-001,2016,6,9,10,675,925,1600,2636
3404-001,2016,6,9,11,754,726,1480,1600
3404-001,2016,6,9,12,696,674,1370,1480
3404-001,2016,6,9,13,636,571,1207,1370
3404-001,2016,6,9,14,716,665,1381,1207
3404-001,2016,6,9,15,826,880,1706,1381
3404-001,2016,6,9,16,904,928,1832,1706
3404-001,2016,6,9,17,928,836,1764,1832
3404-001,2016,6,9,18,1196,775,1971,1764
3404-001,2016,6,9,19,1161,579,1740,1971
3404-001,2016,6,9,20,858,627,1485,1740
3404-001,2016,6,9,21,756,521,1277,1485
3404-001,2016,6,9,22,444,221,665,1277
3404-001,2016,6,9,23,248,180,428,665
3404-001,2016,6,9,24,155,142,297,428
3404-001,2016,6,10,1,95,130,225,297
3404-001,2016,6,10,2,67,96,163,225
3404-001,2016,6,10,3,59,63,122,163
3404-001,2016,6,10,4,54,75,129,122
3404-001,2016,6,10,5,73,99,172,129
3404-001,2016,6,10,6,177,269,446,172
3404-001,2016,6,10,7,277,708,985,446
3404-001,2016,6,10,8,596,2228,2824,985
3404-001,2016,6,10,9,869,1591,2460,2824
3404-001,2016,6,10,10,738,1090,1828,2460
3404-001,2016,6,10,11,770,993,1763,1828
3404-001,2016,6,10,12,795,899,1694,1763
3404-001,2016,6,10,13,657,792,1449,1694
3404-001,2016,6,10,14,742,716,1458,1449
3404-001,2016,6,10,15,805,839,1644,1458
3404-001,2016,6,10,16,923,850,1773,1644
3404-001,2016,6,10,17,1033,734,1767,1773
3404-001,2016,6,10,18,1467,665,2132,1767
3404-001,2016,6,10,19,1447,581,2028,2132
3404-001,2016,6,10,20,941,446,1387,2028
3404-001,2016,6,10,21,751,302,1053,1387
3404-001,2016,6,10,22,412,192,604,1053
3404-001,2016,6,10,23,254,147,401,604
3404-001,2016,6,10,24,160,88,248,401
3404-001,2016,6,11,1,107,94,201,248
3404-001,2016,6,11,2,84,43,127,201
3404-001,2016,6,11,3,55,53,108,127
3404-001,2016,6,11,4,44,47,91,108
3404-001,2016,6,11,5,81,64,145,91
3404-001,2016,6,11,6,158,188,346,145
3404-001,2016,6,11,7,255,360,615,346
3404-001,2016,6,11,8,437,720,1157,615
3404-001,2016,6,11,9,634,597,1231,1157
3404-001,2016,6,11,10,530,607,1137,1231
3404-001,2016,6,11,11,571,757,1328,1137
3404-001,2016,6,11,12,541,737,1278,1328
3404-001,2016,6,11,13,534,655,1189,1278
3404-001,2016,6,11,14,550,706,1256,1189
3404-001,2016,6,11,15,581,679,1260,1256
3404-001,2016,6,11,16,643,671,1314,1260
3404-001,2016,6,11,17,729,490,1219,1314
3404-001,2016,6,11,18,1058,641,1699,1219
3404-001,2016,6,11,19,679,554,1233,1699
3404-001,2016,6,11,20,404,322,726,1233
3404-001,2016,6,11,21,350,183,533,726
3404-001,2016,6,11,22,255,195,450,533
3404-001,2016,6,11,23,162,120,282,450
3404-001,2016,6,11,24,131,102,233,282
3404-001,2016,6,12,1,95,56,151,233
3404-001,2016,6,12,2,49,36,85,151
3404-001,2016,6,12,3,37,50,87,85
3404-001,2016,6,12,4,20,34,54,87
3404-001,2016,6,12,5,50,43,93,54
3404-001,2016,6,12,6,69,57,126,93
3404-001,2016,6,12,7,114,171,285,126
3404-001,2016,6,12,8,154,188,342,285
3404-001,2016,6,12,9,267,238,505,342
3404-001,2016,6,12,10,279,253,532,505
3404-001,2016,6,12,11,325,336,661,532
3404-001,2016,6,12,12,317,343,660,661
3404-001,2016,6,12,13,323,314,637,660
3404-001,2016,6,12,14,365,373,738,637
3404-001,2016,6,12,15,430,486,916,738
3404-001,2016,6,12,16,520,391,911,916
3404-001,2016,6,12,17,494,486,980,911
3404-001,2016,6,12,18,618,372,990,980
3404-001,2016,6,12,19,462,324,786,990
3404-001,2016,6,12,20,354,334,688,786
3404-001,2016,6,12,21,314,171,485,688
3404-001,2016,6,12,22,207,193,400,485
3404-001,2016,6,12,23,127,155,282,400
3404-001,2016,6,12,24,68,108,176,282
3404-001,2016,6,13,1,40,77,117,176
3404-001,2016,6,13,2,30,56,86,117
3404-001,2016,6,13,3,31,34,65,86
3404-001,2016,6,13,4,30,24,54,65
3404-001,2016,6,13,5,76,63,139,54
3404-001,2016,6,13,6,162,262,424,139
3404-001,2016,6,13,7,318,739,1057,424
3404-001,2016,6,13,8,606,1994,2600,1057
3404-001,2016,6,13,9,725,1310,2035,2600
3404-001,2016,6,13,10,660,708,1368,2035
3404-001,2016,6,13,11,717,712,1429,1368
3404-001,2016,6,13,12,691,736,1427,1429
3404-001,2016,6,13,13,626,805,1431,1427
3404-001,2016,6,13,14,684,978,1662,1431
3404-001,2016,6,13,15,790,1048,1838,1662
3404-001,2016,6,13,16,862,1067,1929,1838
3404-001,2016,6,13,17,890,998,1888,1929
3404-001,2016,6,13,18,1199,630,1829,1888
3404-001,2016,6,13,19,1127,458,1585,1829
3404-001,2016,6,13,20,832,370,1202,1585
3404-001,2016,6,13,21,850,250,1100,1202
3404-001,2016,6,13,22,472,173,645,1100
3404-001,2016,6,13,23,272,132,404,645
3404-001,2016,6,13,24,146,67,213,404
3404-001,2016,6,14,1,82,98,180,213
3404-001,2016,6,14,2,66,71,137,180
3404-001,2016,6,14,3,47,46,93,137
3404-001,2016,6,14,4,56,41,97,93
3404-001,2016,6,14,5,89,50,139,97
3404-001,2016,6,14,6,164,246,410,139
3404-001,2016,6,14,7,319,650,969,410
3404-001,2016,6,14,8,585,1843,2428,969
3404-001,2016,6,14,9,828,1283,2111,2428
3404-001,2016,6,14,10,789,796,1585,2111
3404-001,2016,6,14,11,746,938,1684,1585
3404-001,2016,6,14,12,754,877,1631,1684
3404-001,2016,6,14,13,676,939,1615,1631
3404-001,2016,6,14,14,733,986,1719,1615
3404-001,2016,6,14,15,838,911,1749,1719
3404-001,2016,6,14,16,882,973,1855,1749
3404-001,2016,6,14,17,909,894,1803,1855
3404-001,2016,6,14,18,1294,679,1973,1803
3404-001,2016,6,14,19,1206,494,1700,1973
3404-001,2016,6,14,20,881,620,1501,1700
3404-001,2016,6,14,21,757,428,1185,1501
3404-001,2016,6,14,22,415,363,778,1185
3404-001,2016,6,14,23,263,250,513,778
3404-001,2016,6,14,24,148,133,281,513
3404-001,2016,6,15,1,97,111,208,281
3404-001,2016,6,15,2,59,88,147,208
3404-001,2016,6,15,3,49,58,107,147
3404-001,2016,6,15,4,54,51,105,107
3404-001,2016,6,15,5,99,140,239,105
3404-001,2016,6,15,6,174,277,451,239
3404-001,2016,6,15,7,295,640,935,451
3404-001,2016,6,15,8,615,1748,2363,935
3404-001,2016,6,15,9,877,1443,2320,2363
3404-001,2016,6,15,10,746,808,1554,2320
3404-001,2016,6,15,11,801,743,1544,1554
3404-001,2016,6,15,12,752,892,1644,1544
3404-001,2016,6,15,13,637,761,1398,1644
3404-001,2016,6,15,14,739,898,1637,1398
3404-001,2016,6,15,15,850,727,1577,1637
3404-001,2016,6,15,16,831,575,1406,1577
3404-001,2016,6,15,17,918,782,1700,1406
3404-001,2016,6,15,18,1330,667,1997,1700
3404-001,2016,6,15,19,1171,703,1874,1997
3404-001,2016,6,15,20,716,537,1253,1874
3404-001,2016,6,15,21,613,366,979,1253
3404-001,2016,6,15,22,382,391,773,979
3404-001,2016,6,15,23,250,246,496,773
3404-001,2016,6,15,24,156,223,379,496
3404-001,2016,6,16,1,84,92,176,379
3404-001,2016,6,16,2,66,82,148,176
3404-001,2016,6,16,3,51,49,100,148
3404-001,2016,6,16,4,51,112,163,100
3404-001,2016,6,16,5,79,183,262,163
3404-001,2016,6,16,6,166,468,634,262
3404-001,2016,6,16,7,304,774,1078,634
3404-001,2016,6,16,8,573,2155,2728,1078
3404-001,2016,6,16,9,830,1280,2110,2728
3404-001,2016,6,16,10,762,1120,1882,2110
3404-001,2016,6,16,11,755,994,1749,1882
3404-001,2016,6,16,12,749,918,1667,1749
3404-001,2016,6,16,13,674,811,1485,1667
3404-001,2016,6,16,14,707,926,1633,1485
3404-001,2016,6,16,15,815,1014,1829,1633
3404-001,2016,6,16,16,856,936,1792,1829
3404-001,2016,6,16,17,921,760,1681,1792
3404-001,2016,6,16,18,1286,589,1875,1681
3404-001,2016,6,16,19,1159,771,1930,1875
3404-001,2016,6,16,20,888,724,1612,1930
3404-001,2016,6,16,21,809,497,1306,1612
3404-001,2016,6,16,22,458,235,693,1306
3404-001,2016,6,16,23,269,157,426,693
3404-001,2016,6,16,24,137,109,246,426
3404-001,2016,6,17,1,113,82,195,246
3404-001,2016,6,17,2,69,47,116,195
3404-001,2016,6,17,3,41,41,82,116
3404-001,2016,6,17,4,69,29,98,82
3404-001,2016,6,17,5,76,63,139,98
3404-001,2016,6,17,6,185,231,416,139
3404-001,2016,6,17,7,326,661,987,416
3404-001,2016,6,17,8,589,1787,2376,987
3404-001,2016,6,17,9,801,1304,2105,2376
3404-001,2016,6,17,10,797,928,1725,2105
3404-001,2016,6,17,11,807,1083,1890,1725
3404-001,2016,6,17,12,765,812,1577,1890
3404-001,2016,6,17,13,771,733,1504,1577
3404-001,2016,6,17,14,799,750,1549,1504
3404-001,2016,6,17,15,938,857,1795,1549
3404-001,2016,6,17,16,945,757,1702,1795
3404-001,2016,6,17,17,965,636,1601,1702
3404-001,2016,6,17,18,1507,727,2234,1601
3404-001,2016,6,17,19,1426,609,2035,2234
3404-001,2016,6,17,20,976,518,1494,2035
3404-001,2016,6,17,21,804,334,1138,1494
3404-001,2016,6,17,22,448,207,655,1138
3404-001,2016,6,17,23,279,180,459,655
3404-001,2016,6,17,24,145,125,270,459
3404-001,2016,6,18,1,125,72,197,270
3404-001,2016,6,18,2,74,57,131,197
3404-001,2016,6,18,3,61,32,93,131
3404-001,2016,6,18,4,68,60,128,93
3404-001,2016,6,18,5,78,64,142,128
3404-001,2016,6,18,6,167,184,351,142
3404-001,2016,6,18,7,260,408,668,351
3404-001,2016,6,18,8,462,740,1202,668
3404-001,2016,6,18,9,678,706,1384,1202
3404-001,2016,6,18,10,605,722,1327,1384
3404-001,2016,6,18,11,577,717,1294,1327
3404-001,2016,6,18,12,582,586,1168,1294
3404-001,2016,6,18,13,505,620,1125,1168
3404-001,2016,6,18,14,589,583,1172,1125
3404-001,2016,6,18,15,615,547,1162,1172
3404-001,2016,6,18,16,650,492,1142,1162
3404-001,2016,6,18,17,690,477,1167,1142
3404-001,2016,6,18,18,978,421,1399,1167
3404-001,2016,6,18,19,715,435,1150,1399
3404-001,2016,6,18,20,423,279,702,1150
3404-001,2016,6,18,21,370,218,588,702
3404-001,2016,6,18,22,270,190,460,588
3404-001,2016,6,18,23,157,140,297,460
3404-001,2016,6,18,24,107,80,187,297
3404-001,2016,6,19,1,74,57,131,187
3404-001,2016,6,19,2,49,41,90,131
3404-001,2016,6,19,3,50,33,83,90
3404-001,2016,6,19,4,26,24,50,83
3404-001,2016,6,19,5,46,39,85,50
3404-001,2016,6,19,6,89,80,169,85
3404-001,2016,6,19,7,113,201,314,169
3404-001,2016,6,19,8,200,300,500,314
3404-001,2016,6,19,9,284,257,541,500
3404-001,2016,6,19,10,270,259,529,541
3404-001,2016,6,19,11,326,310,636,529
3404-001,2016,6,19,12,345,298,643,636
3404-001,2016,6,19,13,363,283,646,643
3404-001,2016,6,19,14,439,281,720,646
3404-001,2016,6,19,15,469,276,745,720
3404-001,2016,6,19,16,589,280,869,745
3404-001,2016,6,19,17,598,277,875,869
3404-001,2016,6,19,18,734,304,1038,875
3404-001,2016,6,19,19,550,319,869,1038
3404-001,2016,6,19,20,412,315,727,869
3404-001,2016,6,19,21,349,259,608,727
3404-001,2016,6,19,22,259,223,482,608
3404-001,2016,6,19,23,147,195,342,482
3404-001,2016,6,19,24,94,222,316,342
3404-001,2016,6,20,1,50,68,118,316
3404-001,2016,6,20,2,32,46,78,118
3404-001,2016,6,20,3,23,58,81,78
3404-001,2016,6,20,4,46,27,73,81
3404-001,2016,6,20,5,56,81,137,73
3404-001,2016,6,20,6,164,267,431,137
3404-001,2016,6,20,7,300,757,1057,431
3404-001,2016,6,20,8,617,1916,2533,1057
3404-001,2016,6,20,9,759,1290,2049,2533
3404-001,2016,6,20,10,732,652,1384,2049
3404-001,2016,6,20,11,754,664,1418,1384
3404-001,2016,6,20,12,745,734,1479,1418
3404-001,2016,6,20,13,588,599,1187,1479
3404-001,2016,6,20,14,682,737,1419,1187
3404-001,2016,6,20,15,812,814,1626,1419
3404-001,2016,6,20,16,877,676,1553,1626
3404-001,2016,6,20,17,888,599,1487,1553
3404-001,2016,6,20,18,1242,607,1849,1487
3404-001,2016,6,20,19,1208,573,1781,1849
3404-001,2016,6,20,20,889,376,1265,1781
3404-001,2016,6,20,21,805,362,1167,1265
3404-001,2016,6,20,22,512,339,851,1167
3404-001,2016,6,20,23,257,341,598,851
3404-001,2016,6,20,24,174,270,444,598
3404-001,2016,6,21,1,92,156,248,444
3404-001,2016,6,21,2,65,71,136,248
3404-001,2016,6,21,3,42,139,181,136
3404-001,2016,6,21,4,58,81,139,181
3404-001,2016,6,21,5,61,209,270,139
3404-001,2016,6,21,6,179,446,625,270
3404-001,2016,6,21,7,294,791,1085,625
3404-001,2016,6,21,8,588,1821,2409,1085
3404-001,2016,6,21,9,838,1299,2137,2409
3404-001,2016,6,21,10,756,754,1510,2137
3404-001,2016,6,21,11,782,692,1474,1510
3404-001,2016,6,21,12,806,652,1458,1474
3404-001,2016,6,21,13,645,839,1484,1458
3404-001,2016,6,21,14,731,813,1544,1484
3404-001,2016,6,21,15,819,791,1610,1544
3404-001,2016,6,21,16,890,826,1716,1610
3404-001,2016,6,21,17,940,698,1638,1716
3404-001,2016,6,21,18,1208,638,1846,1638
3404-001,2016,6,21,19,1140,679,1819,1846
3404-001,2016,6,21,20,861,494,1355,1819
3404-001,2016,6,21,21,779,517,1296,1355
3404-001,2016,6,21,22,449,369,818,1296
3404-001,2016,6,21,23,261,205,466,818
3404-001,2016,6,21,24,135,153,288,466
3404-001,2016,6,22,1,92,129,221,288
3404-001,2016,6,22,2,69,188,257,221
3404-001,2016,6,22,3,55,41,96,257
3404-001,2016,6,22,4,63,43,106,96
3404-001,2016,6,22,5,70,95,165,106
3404-001,2016,6,22,6,161,231,392,165
3404-001,2016,6,22,7,305,719,1024,392
3404-001,2016,6,22,8,584,1924,2508,1024
3404-001,2016,6,22,9,841,1453,2294,2508
3404-001,2016,6,22,10,731,952,1683,2294
3404-001,2016,6,22,11,753,939,1692,1683
3404-001,2016,6,22,12,708,825,1533,1692
3404-001,2016,6,22,13,628,645,1273,1533
3404-001,2016,6,22,14,681,696,1377,1273
3404-001,2016,6,22,15,812,789,1601,1377
3404-001,2016,6,22,16,867,593,1460,1601
3404-001,2016,6,22,17,936,619,1555,1460
3404-001,2016,6,22,18,1356,733,2089,1555
3404-001,2016,6,22,19,1192,648,1840,2089
3404-001,2016,6,22,20,759,472,1231,1840
3404-001,2016,6,22,21,590,380,970,1231
3404-001,2016,6,22,22,372,293,665,970
3404-001,2016,6,22,23,215,160,375,665
3404-001,2016,6,22,24,148,132,280,375
3404-001,2016,6,23,1,103,78,181,280
3404-001,2016,6,23,2,60,57,117,181
3404-001,2016,6,23,3,53,41,94,117
3404-001,2016,6,23,4,56,50,106,94
3404-001,2016,6,23,5,79,63,142,106
3404-001,2016,6,23,6,156,233,389,142
3404-001,2016,6,23,7,294,684,978,389
3404-001,2016,6,23,8,575,1862,2437,978
3404-001,2016,6,23,9,872,1581,2453,2437
3404-001,2016,6,23,10,741,976,1717,2453
3404-001,2016,6,23,11,755,912,1667,1717
3404-001,2016,6,23,12,743,888,1631,1667
3404-001,2016,6,23,13,682,825,1507,1631
3404-001,2016,6,23,14,712,902,1614,1507
3404-001,2016,6,23,15,845,969,1814,1614
3404-001,2016,6,23,16,905,840,1745,1814
3404-001,2016,6,23,17,962,940,1902,1745
3404-001,2016,6,23,18,1323,706,2029,1902
3404-001,2016,6,23,19,1212,675,1887,2029
3404-001,2016,6,23,20,901,547,1448,1887
3404-001,2016,6,23,21,781,317,1098,1448
3404-001,2016,6,23,22,432,294,726,1098
3404-001,2016,6,23,23,274,246,520,726
3404-001,2016,6,23,24,142,91,233,520
3404-001,2016,6,24,1,100,54,154,233
3404-001,2016,6,24,2,59,50,109,154
3404-001,2016,6,24,3,45,43,88,109
3404-001,2016,6,24,4,49,30,79,88
3404-001,2016,6,24,5,72,51,123,79
3404-001,2016,6,24,6,155,164,319,123
3404-001,2016,6,24,7,265,528,793,319
3404-001,2016,6,24,8,548,1636,2184,793
3404-001,2016,6,24,9,783,1550,2333,2184
3404-001,2016,6,24,10,678,737,1415,2333
3404-001,2016,6,24,11,730,743,1473,1415
3404-001,2016,6,24,12,707,688,1395,1473
3404-001,2016,6,24,13,636,739,1375,1395
3404-001,2016,6,24,14,664,823,1487,1375
3404-001,2016,6,24,15,805,693,1498,1487
3404-001,2016,6,24,16,871,733,1604,1498
3404-001,2016,6,24,17,890,593,1483,1604
3404-001,2016,6,24,18,1412,623,2035,1483
3404-001,2016,6,24,19,1368,761,2129,2035
3404-001,2016,6,24,20,935,579,1514,2129
3404-001,2016,6,24,21,705,365,1070,1514
3404-001,2016,6,24,22,414,238,652,1070
3404-001,2016,6,24,23,261,184,445,652
3404-001,2016,6,24,24,155,151,306,445
3404-001,2016,6,25,1,118,88,206,306
3404-001,2016,6,25,2,70,71,141,206
3404-001,2016,6,25,3,51,37,88,141
3404-001,2016,6,25,4,61,46,107,88
3404-001,2016,6,25,5,81,63,144,107
3404-001,2016,6,25,6,150,209,359,144
3404-001,2016,6,25,7,265,417,682,359
3404-001,2016,6,25,8,375,790,1165,682
3404-001,2016,6,25,9,618,708,1326,1165
3404-001,2016,6,25,10,598,684,1282,1326
3404-001,2016,6,25,11,584,654,1238,1282
3404-001,2016,6,25,12,549,761,1310,1238
3404-001,2016,6,25,13,542,576,1118,1310
3404-001,2016,6,25,14,566,667,1233,1118
3404-001,2016,6,25,15,609,702,1311,1233
3404-001,2016,6,25,16,664,612,1276,1311
3404-001,2016,6,25,17,736,487,1223,1276
3404-001,2016,6,25,18,906,564,1470,1223
3404-001,2016,6,25,19,705,417,1122,1470
3404-001,2016,6,25,20,458,281,739,1122
3404-001,2016,6,25,21,375,190,565,739
3404-001,2016,6,25,22,269,184,453,565
3404-001,2016,6,25,23,180,128,308,453
3404-001,2016,6,25,24,115,92,207,308
3404-001,2016,6,26,1,75,54,129,207
3404-001,2016,6,26,2,63,40,103,129
3404-001,2016,6,26,3,56,44,100,103
3404-001,2016,6,26,4,35,36,71,100
3404-001,2016,6,26,5,45,32,77,71
3404-001,2016,6,26,6,75,94,169,77
3404-001,2016,6,26,7,132,180,312,169
3404-001,2016,6,26,8,286,183,469,312
3404-001,2016,6,26,9,362,274,636,469
3404-001,2016,6,26,10,340,231,571,636
3404-001,2016,6,26,11,358,403,761,571
3404-001,2016,6,26,12,374,394,768,761
3404-001,2016,6,26,13,358,360,718,768
3404-001,2016,6,26,14,427,346,773,718
3404-001,2016,6,26,15,479,360,839,773
3404-001,2016,6,26,16,600,377,977,839
3404-001,2016,6,26,17,612,332,944,977
3404-001,2016,6,26,18,674,311,985,944
3404-001,2016,6,26,19,583,326,909,985
3404-001,2016,6,26,20,402,276,678,909
3404-001,2016,6,26,21,330,238,568,678
3404-001,2016,6,26,22,262,188,450,568
3404-001,2016,6,26,23,171,167,338,450
3404-001,2016,6,26,24,83,142,225,338
3404-001,2016,6,27,1,67,71,138,225
3404-001,2016,6,27,2,37,47,84,138
3404-001,2016,6,27,3,35,23,58,84
3404-001,2016,6,27,4,31,36,67,58
3404-001,2016,6,27,5,60,74,134,67
3404-001,2016,6,27,6,143,259,402,134
3404-001,2016,6,27,7,333,741,1074,402
3404-001,2016,6,27,8,605,2078,2683,1074
3404-001,2016,6,27,9,720,1232,1952,2683
3404-001,2016,6,27,10,715,710,1425,1952
3404-001,2016,6,27,11,792,616,1408,1425
3404-001,2016,6,27,12,734,664,1398,1408
3404-001,2016,6,27,13,630,620,1250,1398
3404-001,2016,6,27,14,665,657,1322,1250
3404-001,2016,6,27,15,879,705,1584,1322
3404-001,2016,6,27,16,830,722,1552,1584
3404-001,2016,6,27,17,931,654,1585,1552
3404-001,2016,6,27,18,1266,559,1825,1585
3404-001,2016,6,27,19,1129,479,1608,1825
3404-001,2016,6,27,20,834,342,1176,1608
3404-001,2016,6,27,21,837,225,1062,1176
3404-001,2016,6,27,22,501,160,661,1062
3404-001,2016,6,27,23,248,113,361,661
3404-001,2016,6,27,24,124,101,225,361
3404-001,2016,6,28,1,98,70,168,225
3404-001,2016,6,28,2,62,48,110,168
3404-001,2016,6,28,3,51,53,104,110
3404-001,2016,6,28,4,65,33,98,104
3404-001,2016,6,28,5,74,60,134,98
3404-001,2016,6,28,6,170,240,410,134
3404-001,2016,6,28,7,293,645,938,410
3404-001,2016,6,28,8,600,1798,2398,938
3404-001,2016,6,28,9,849,1303,2152,2398
3404-001,2016,6,28,10,737,737,1474,2152
3404-001,2016,6,28,11,810,700,1510,1474
3404-001,2016,6,28,12,754,708,1462,1510
3404-001,2016,6,28,13,634,662,1296,1462
3404-001,2016,6,28,14,768,720,1488,1296
3404-001,2016,6,28,15,859,799,1658,1488
3404-001,2016,6,28,16,855,693,1548,1658
3404-001,2016,6,28,17,916,650,1566,1548
3404-001,2016,6,28,18,1279,583,1862,1566
3404-001,2016,6,28,19,1202,483,1685,1862
3404-001,2016,6,28,20,813,345,1158,1685
3404-001,2016,6,28,21,818,247,1065,1158
3404-001,2016,6,28,22,462,191,653,1065
3404-001,2016,6,28,23,264,128,392,653
3404-001,2016,6,28,24,122,91,213,392
3404-001,2016,6,29,1,94,68,162,213
3404-001,2016,6,29,2,71,48,119,162
3404-001,2016,6,29,3,47,46,93,119
3404-001,2016,6,29,4,54,27,81,93
3404-001,2016,6,29,5,63,71,134,81
3404-001,2016,6,29,6,167,204,371,134
3404-001,2016,6,29,7,288,640,928,371
3404-001,2016,6,29,8,566,1802,2368,928
3404-001,2016,6,29,9,838,1316,2154,2368
3404-001,2016,6,29,10,742,723,1465,2154
3404-001,2016,6,29,11,739,658,1397,1465
3404-001,2016,6,29,12,765,654,1419,1397
3404-001,2016,6,29,13,649,650,1299,1419
3404-001,2016,6,29,14,728,767,1495,1299
3404-001,2016,6,29,15,846,676,1522,1495
3404-001,2016,6,29,16,918,544,1462,1522
3404-001,2016,6,29,17,939,573,1512,1462
3404-001,2016,6,29,18,1457,603,2060,1512
3404-001,2016,6,29,19,1338,475,1813,2060
3404-001,2016,6,29,20,807,341,1148,1813
3404-001,2016,6,29,21,621,195,816,1148
3404-001,2016,6,29,22,436,180,616,816
3404-001,2016,6,29,23,245,139,384,616
3404-001,2016,6,29,24,139,89,228,384
3404-001,2016,6,30,1,102,78,180,228
3404-001,2016,6,30,2,61,54,115,180
3404-001,2016,6,30,3,50,29,79,115
3404-001,2016,6,30,4,61,32,93,79
3404-001,2016,6,30,5,81,50,131,93
3404-001,2016,6,30,6,159,190,349,131
3404-001,2016,6,30,7,264,623,887,349
3404-001,2016,6,30,8,594,1834,2428,887
3404-001,2016,6,30,9,804,1252,2056,2428
3404-001,2016,6,30,10,704,739,1443,2056
3404-001,2016,6,30,11,741,613,1354,1443
3404-001,2016,6,30,12,722,542,1264,1354
3404-001,2016,6,30,13,636,506,1142,1264
3404-001,2016,6,30,14,692,602,1294,1142
3404-001,2016,6,30,15,777,669,1446,1294
3404-001,2016,6,30,16,809,568,1377,1446
3404-001,2016,6,30,17,953,537,1490,1377
3404-001,2016,6,30,18,1335,596,1931,1490
3404-001,2016,6,30,19,1178,468,1646,1931
3404-001,2016,6,30,20,846,317,1163,1646
3404-001,2016,6,30,21,824,247,1071,1163
3404-001,2016,6,30,22,436,166,602,1071
3404-001,2016,6,30,23,268,136,404,602
3404-001,2016,6,30,24,117,92,209,404
3404-001,2016,7,1,1,95,90,185,209
3404-001,2016,7,1,2,72,58,130,185
3404-001,2016,7,1,3,55,40,95,130
3404-001,2016,7,1,4,57,43,100,95
3404-001,2016,7,1,5,79,82,161,100
3404-001,2016,7,1,6,151,270,421,161
3404-001,2016,7,1,7,276,710,986,421
3404-001,2016,7,1,8,549,2149,2698,986
3404-001,2016,7,1,9,833,1447,2280,2698
3404-001,2016,7,1,10,744,841,1585,2280
3404-001,2016,7,1,11,785,815,1600,1585
3404-001,2016,7,1,12,744,622,1366,1600
3404-001,2016,7,1,13,679,603,1282,1366
3404-001,2016,7,1,14,752,854,1606,1282
3404-001,2016,7,1,15,864,936,1800,1606
3404-001,2016,7,1,16,903,844,1747,1800
3404-001,2016,7,1,17,925,790,1715,1747
3404-001,2016,7,1,18,1400,904,2304,1715
3404-001,2016,7,1,19,1383,858,2241,2304
3404-001,2016,7,1,20,820,647,1467,2241
3404-001,2016,7,1,21,698,386,1084,1467
3404-001,2016,7,1,22,405,269,674,1084
3404-001,2016,7,1,23,216,169,385,674
3404-001,2016,7,1,24,111,87,198,385
3404-001,2016,7,2,1,108,72,180,198
3404-001,2016,7,2,2,86,55,141,180
3404-001,2016,7,2,3,38,36,74,141
3404-001,2016,7,2,4,52,45,97,74
3404-001,2016,7,2,5,54,46,100,97
3404-001,2016,7,2,6,111,143,254,100
3404-001,2016,7,2,7,178,315,493,254
3404-001,2016,7,2,8,371,708,1079,493
3404-001,2016,7,2,9,523,622,1145,1079
3404-001,2016,7,2,10,520,493,1013,1145
3404-001,2016,7,2,11,512,545,1057,1013
3404-001,2016,7,2,12,559,583,1142,1057
3404-001,2016,7,2,13,502,588,1090,1142
3404-001,2016,7,2,14,497,457,954,1090
3404-001,2016,7,2,15,553,540,1093,954
3404-001,2016,7,2,16,652,442,1094,1093
3404-001,2016,7,2,17,651,449,1100,1094
3404-001,2016,7,2,18,897,510,1407,1100
3404-001,2016,7,2,19,595,396,991,1407
3404-001,2016,7,2,20,364,338,702,991
3404-001,2016,7,2,21,320,223,543,702
3404-001,2016,7,2,22,226,192,418,543
3404-001,2016,7,2,23,141,145,286,418
3404-001,2016,7,2,24,117,106,223,286
3404-001,2016,7,3,1,75,62,137,223
3404-001,2016,7,3,2,59,40,99,137
3404-001,2016,7,3,3,36,43,79,99
3404-001,2016,7,3,4,33,23,56,79
3404-001,2016,7,3,5,30,33,63,56
3404-001,2016,7,3,6,62,84,146,63
3404-001,2016,7,3,7,109,187,296,146
3404-001,2016,7,3,8,184,272,456,296
3404-001,2016,7,3,9,247,245,492,456
3404-001,2016,7,3,10,294,231,525,492
3404-001,2016,7,3,11,345,301,646,525
3404-001,2016,7,3,12,320,349,669,646
3404-001,2016,7,3,13,345,318,663,669
3404-001,2016,7,3,14,362,326,688,663
3404-001,2016,7,3,15,491,342,833,688
3404-001,2016,7,3,16,544,357,901,833
3404-001,2016,7,3,17,531,345,876,901
3404-001,2016,7,3,18,482,368,850,876
3404-001,2016,7,3,19,372,326,698,850
3404-001,2016,7,3,20,284,270,554,698
3404-001,2016,7,3,21,286,248,534,554
3404-001,2016,7,3,22,193,226,419,534
3404-001,2016,7,3,23,155,163,318,419
3404-001,2016,7,3,24,89,130,219,318
3404-001,2016,7,4,1,49,62,111,219
3404-001,2016,7,4,2,42,51,93,111
3404-001,2016,7,4,3,33,33,66,93
3404-001,2016,7,4,4,25,26,51,66
3404-001,2016,7,4,5,48,63,111,51
3404-001,2016,7,4,6,124,213,337,111
3404-001,2016,7,4,7,225,642,867,337
3404-001,2016,7,4,8,543,2162,2705,867
3404-001,2016,7,4,9,701,1571,2272,2705
3404-001,2016,7,4,10,616,600,1216,2272
3404-001,2016,7,4,11,676,620,1296,1216
3404-001,2016,7,4,12,652,508,1160,1296
3404-001,2016,7,4,13,617,464,1081,1160
3404-001,2016,7,4,14,599,613,1212,1081
3404-001,2016,7,4,15,697,605,1302,1212
3404-001,2016,7,4,16,746,629,1375,1302
3404-001,2016,7,4,17,792,520,1312,1375
3404-001,2016,7,4,18,1027,508,1535,1312
3404-001,2016,7,4,19,1061,479,1540,1535
3404-001,2016,7,4,20,781,377,1158,1540
3404-001,2016,7,4,21,742,250,992,1158
3404-001,2016,7,4,22,418,174,592,992
3404-001,2016,7,4,23,235,111,346,592
3404-001,2016,7,4,24,130,72,202,346
3404-001,2016,7,5,1,106,70,176,202
3404-001,2016,7,5,2,61,36,97,176
3404-001,2016,7,5,3,43,45,88,97
3404-001,2016,7,5,4,44,40,84,88
3404-001,2016,7,5,5,51,48,99,84
3404-001,2016,7,5,6,122,196,318,99
3404-001,2016,7,5,7,221,600,821,318
3404-001,2016,7,5,8,549,2089,2638,821
3404-001,2016,7,5,9,758,1486,2244,2638
3404-001,2016,7,5,10,692,630,1322,2244
3404-001,2016,7,5,11,681,639,1320,1322
3404-001,2016,7,5,12,699,625,1324,1320
3404-001,2016,7,5,13,629,544,1173,1324
3404-001,2016,7,5,14,658,703,1361,1173
3404-001,2016,7,5,15,821,787,1608,1361
3404-001,2016,7,5,16,812,668,1480,1608
3404-001,2016,7,5,17,829,652,1481,1480
3404-001,2016,7,5,18,1113,554,1667,1481
3404-001,2016,7,5,19,1078,520,1598,1667
3404-001,2016,7,5,20,818,372,1190,1598
3404-001,2016,7,5,21,714,321,1035,1190
3404-001,2016,7,5,22,456,230,686,1035
3404-001,2016,7,5,23,246,147,393,686
3404-001,2016,7,5,24,136,102,238,393
3404-001,2016,7,6,1,104,67,171,238
3404-001,2016,7,6,2,55,58,113,171
3404-001,2016,7,6,3,42,43,85,113
3404-001,2016,7,6,4,47,29,76,85
3404-001,2016,7,6,5,67,43,110,76
3404-001,2016,7,6,6,131,143,274,110
3404-001,2016,7,6,7,207,529,736,274
3404-001,2016,7,6,8,505,1995,2500,736
3404-001,2016,7,6,9,776,1527,2303,2500
3404-001,2016,7,6,10,699,829,1528,2303
3404-001,2016,7,6,11,671,834,1505,1528
3404-001,2016,7,6,12,683,731,1414,1505
3404-001,2016,7,6,13,686,615,1301,1414
3404-001,2016,7,6,14,704,770,1474,1301
3404-001,2016,7,6,15,827,844,1671,1474
3404-001,2016,7,6,16,802,746,1548,1671
3404-001,2016,7,6,17,829,625,1454,1548
3404-001,2016,7,6,18,1332,585,1917,1454
3404-001,2016,7,6,19,1192,515,1707,1917
3404-001,2016,7,6,20,782,408,1190,1707
3404-001,2016,7,6,21,631,259,890,1190
3404-001,2016,7,6,22,421,250,671,890
3404-001,2016,7,6,23,242,140,382,671
3404-001,2016,7,6,24,160,109,269,382
3404-001,2016,7,7,1,108,75,183,269
3404-001,2016,7,7,2,66,58,124,183
3404-001,2016,7,7,3,51,57,108,124
3404-001,2016,7,7,4,43,38,81,108
3404-001,2016,7,7,5,98,82,180,81
3404-001,2016,7,7,6,153,204,357,180
3404-001,2016,7,7,7,250,695,945,357
3404-001,2016,7,7,8,558,2040,2598,945
3404-001,2016,7,7,9,787,1554,2341,2598
3404-001,2016,7,7,10,736,766,1502,2341
3404-001,2016,7,7,11,768,739,1507,1502
3404-001,2016,7,7,12,748,770,1518,1507
3404-001,2016,7,7,13,649,712,1361,1518
3404-001,2016,7,7,14,706,814,1520,1361
3404-001,2016,7,7,15,863,848,1711,1520
3404-001,2016,7,7,16,889,798,1687,1711
3404-001,2016,7,7,17,885,734,1619,1687
3404-001,2016,7,7,18,1190,651,1841,1619
3404-001,2016,7,7,19,1140,527,1667,1841
3404-001,2016,7,7,20,821,369,1190,1667
3404-001,2016,7,7,21,777,286,1063,1190
3404-001,2016,7,7,22,470,184,654,1063
3404-001,2016,7,7,23,264,206,470,654
3404-001,2016,7,7,24,160,128,288,470
3404-001,2016,7,8,1,110,111,221,288
3404-001,2016,7,8,2,62,60,122,221
3404-001,2016,7,8,3,47,48,95,122
3404-001,2016,7,8,4,44,53,97,95
3404-001,2016,7,8,5,68,72,140,97
3404-001,2016,7,8,6,156,228,384,140
3404-001,2016,7,8,7,275,741,1016,384
3404-001,2016,7,8,8,612,2122,2734,1016
3404-001,2016,7,8,9,835,1625,2460,2734
3404-001,2016,7,8,10,731,904,1635,2460
3404-001,2016,7,8,11,772,873,1645,1635
3404-001,2016,7,8,12,768,807,1575,1645
3404-001,2016,7,8,13,679,598,1277,1575
3404-001,2016,7,8,14,713,778,1491,1277
3404-001,2016,7,8,15,839,748,1587,1491
3404-001,2016,7,8,16,844,793,1637,1587
3404-001,2016,7,8,17,944,746,1690,1637
3404-001,2016,7,8,18,1474,683,2157,1690
3404-001,2016,7,8,19,1378,627,2005,2157
3404-001,2016,7,8,20,963,505,1468,2005
3404-001,2016,7,8,21,764,333,1097,1468
3404-001,2016,7,8,22,438,262,700,1097
3404-001,2016,7,8,23,244,199,443,700
3404-001,2016,7,8,24,143,133,276,443
3404-001,2016,7,9,1,112,79,191,276
3404-001,2016,7,9,2,68,58,126,191
3404-001,2016,7,9,3,68,46,114,126
3404-001,2016,7,9,4,55,48,103,114
3404-001,2016,7,9,5,97,67,164,103
3404-001,2016,7,9,6,135,194,329,164
3404-001,2016,7,9,7,223,466,689,329
3404-001,2016,7,9,8,388,827,1215,689
3404-001,2016,7,9,9,602,756,1358,1215
3404-001,2016,7,9,10,572,702,1274,1358
3404-001,2016,7,9,11,592,776,1368,1274
3404-001,2016,7,9,12,579,744,1323,1368
3404-001,2016,7,9,13,560,641,1201,1323
3404-001,2016,7,9,14,551,529,1080,1201
3404-001,2016,7,9,15,570,557,1127,1080
3404-001,2016,7,9,16,638,542,1180,1127
3404-001,2016,7,9,17,692,471,1163,1180
3404-001,2016,7,9,18,966,486,1452,1163
3404-001,2016,7,9,19,654,442,1096,1452
3404-001,2016,7,9,20,431,355,786,1096
3404-001,2016,7,9,21,325,226,551,786
3404-001,2016,7,9,22,230,228,458,551
3404-001,2016,7,9,23,173,162,335,458
3404-001,2016,7,9,24,117,87,204,335
3404-001,2016,7,10,1,91,70,161,204
3404-001,2016,7,10,2,53,48,101,161
3404-001,2016,7,10,3,51,36,87,101
3404-001,2016,7,10,4,49,31,80,87
3404-001,2016,7,10,5,44,23,67,80
3404-001,2016,7,10,6,81,77,158,67
3404-001,2016,7,10,7,137,214,351,158
3404-001,2016,7,10,8,206,225,431,351
3404-001,2016,7,10,9,296,277,573,431
3404-001,2016,7,10,10,350,272,622,573
3404-001,2016,7,10,11,391,355,746,622
3404-001,2016,7,10,12,317,332,649,746
3404-001,2016,7,10,13,329,419,748,649
3404-001,2016,7,10,14,359,340,699,748
3404-001,2016,7,10,15,492,343,835,699
3404-001,2016,7,10,16,510,355,865,835
3404-001,2016,7,10,17,597,338,935,865
3404-001,2016,7,10,18,722,367,1089,935
3404-001,2016,7,10,19,515,349,864,1089
3404-001,2016,7,10,20,375,287,662,864
3404-001,2016,7,10,21,290,248,538,662
3404-001,2016,7,10,22,205,216,421,538
3404-001,2016,7,10,23,159,177,336,421
3404-001,2016,7,10,24,77,131,208,336
3404-001,2016,7,11,1,53,82,135,208
3404-001,2016,7,11,2,34,60,94,135
3404-001,2016,7,11,3,24,34,58,94
3404-001,2016,7,11,4,33,45,78,58
3404-001,2016,7,11,5,64,65,129,78
3404-001,2016,7,11,6,152,240,392,129
3404-001,2016,7,11,7,272,895,1167,392
3404-001,2016,7,11,8,584,2302,2886,1167
3404-001,2016,7,11,9,758,1590,2348,2886
3404-001,2016,7,11,10,695,781,1476,2348
3404-001,2016,7,11,11,706,756,1462,1476
3404-001,2016,7,11,12,741,817,1558,1462
3404-001,2016,7,11,13,625,719,1344,1558
3404-001,2016,7,11,14,675,741,1416,1344
3404-001,2016,7,11,15,807,861,1668,1416
3404-001,2016,7,11,16,890,768,1658,1668
3404-001,2016,7,11,17,861,663,1524,1658
3404-001,2016,7,11,18,1261,590,1851,1524
3404-001,2016,7,11,19,1172,515,1687,1851
3404-001,2016,7,11,20,879,357,1236,1687
3404-001,2016,7,11,21,791,287,1078,1236
3404-001,2016,7,11,22,472,235,707,1078
3404-001,2016,7,11,23,250,140,390,707
3404-001,2016,7,11,24,124,114,238,390
3404-001,2016,7,12,1,99,101,200,238
3404-001,2016,7,12,2,62,96,158,200
3404-001,2016,7,12,3,55,68,123,158
3404-001,2016,7,12,4,49,80,129,123
3404-001,2016,7,12,5,64,34,98,129
3404-001,2016,7,12,6,123,206,329,98
3404-001,2016,7,12,7,230,579,809,329
3404-001,2016,7,12,8,596,2106,2702,809
3404-001,2016,7,12,9,752,1549,2301,2702
3404-001,2016,7,12,10,743,771,1514,2301
3404-001,2016,7,12,11,733,722,1455,1514
3404-001,2016,7,12,12,697,790,1487,1455
3404-001,2016,7,12,13,585,712,1297,1487
3404-001,2016,7,12,14,705,725,1430,1297
3404-001,2016,7,12,15,807,765,1572,1430
3404-001,2016,7,12,16,854,729,1583,1572
3404-001,2016,7,12,17,845,658,1503,1583
3404-001,2016,7,12,18,1175,569,1744,1503
3404-001,2016,7,12,19,1122,512,1634,1744
3404-001,2016,7,12,20,765,374,1139,1634
3404-001,2016,7,12,21,726,303,1029,1139
3404-001,2016,7,12,22,450,192,642,1029
3404-001,2016,7,12,23,277,148,425,642
3404-001,2016,7,12,24,144,109,253,425
3404-001,2016,7,13,1,95,92,187,253
3404-001,2016,7,13,2,70,43,113,187
3404-001,2016,7,13,3,59,55,114,113
3404-001,2016,7,13,4,45,31,76,114
3404-001,2016,7,13,5,64,77,141,76
3404-001,2016,7,13,6,165,231,396,141
3404-001,2016,7,13,7,272,719,991,396
3404-001,2016,7,13,8,554,2144,2698,991
3404-001,2016,7,13,9,812,1532,2344,2698
3404-001,2016,7,13,10,748,860,1608,2344
3404-001,2016,7,13,11,755,851,1606,1608
3404-001,2016,7,13,12,755,759,1514,1606
3404-001,2016,7,13,13,668,666,1334,1514
3404-001,2016,7,13,14,723,812,1535,1334
3404-001,2016,7,13,15,882,856,1738,1535
3404-001,2016,7,13,16,891,804,1695,1738
3404-001,2016,7,13,17,928,734,1662,1695
3404-001,2016,7,13,18,1399,676,2075,1662
3404-001,2016,7,13,19,1222,634,1856,2075
3404-001,2016,7,13,20,810,478,1288,1856
3404-001,2016,7,13,21,708,308,1016,1288
3404-001,2016,7,13,22,464,243,707,1016
3404-001,2016,7,13,23,262,119,381,707
3404-001,2016,7,13,24,148,111,259,381
3404-001,2016,7,14,1,103,84,187,259
3404-001,2016,7,14,2,62,58,120,187
3404-001,2016,7,14,3,48,45,93,120
3404-001,2016,7,14,4,56,48,104,93
3404-001,2016,7,14,5,83,67,150,104
3404-001,2016,7,14,6,158,242,400,150
3404-001,2016,7,14,7,304,727,1031,400
3404-001,2016,7,14,8,594,2170,2764,1031
3404-001,2016,7,14,9,756,1547,2303,2764
3404-001,2016,7,14,10,748,871,1619,2303
3404-001,2016,7,14,11,790,853,1643,1619
3404-001,2016,7,14,12,738,805,1543,1643
3404-001,2016,7,14,13,676,748,1424,1543
3404-001,2016,7,14,14,724,890,1614,1424
3404-001,2016,7,14,15,815,941,1756,1614
3404-001,2016,7,14,16,932,763,1695,1756
3404-001,2016,7,14,17,897,562,1459,1695
3404-001,2016,7,14,18,1241,664,1905,1459
3404-001,2016,7,14,19,1177,639,1816,1905
3404-001,2016,7,14,20,824,450,1274,1816
3404-001,2016,7,14,21,793,321,1114,1274
3404-001,2016,7,14,22,462,197,659,1114
3404-001,2016,7,14,23,282,143,425,659
3404-001,2016,7,14,24,120,131,251,425
3404-001,2016,7,15,1,114,75,189,251
3404-001,2016,7,15,2,69,50,119,189
3404-001,2016,7,15,3,45,51,96,119
3404-001,2016,7,15,4,55,36,91,96
3404-001,2016,7,15,5,70,74,144,91
3404-001,2016,7,15,6,159,240,399,144
3404-001,2016,7,15,7,258,780,1038,399
3404-001,2016,7,15,8,590,2112,2702,1038
3404-001,2016,7,15,9,800,1530,2330,2702
3404-001,2016,7,15,10,768,802,1570,2330
3404-001,2016,7,15,11,798,883,1681,1570
3404-001,2016,7,15,12,777,870,1647,1681
3404-001,2016,7,15,13,675,725,1400,1647
3404-001,2016,7,15,14,788,829,1617,1400
3404-001,2016,7,15,15,890,931,1821,1617
3404-001,2016,7,15,16,970,773,1743,1821
3404-001,2016,7,15,17,955,646,1601,1743
3404-001,2016,7,15,18,1435,659,2094,1601
3404-001,2016,7,15,19,1472,675,2147,2094
3404-001,2016,7,15,20,960,540,1500,2147
3404-001,2016,7,15,21,727,379,1106,1500
3404-001,2016,7,15,22,443,230,673,1106
3404-001,2016,7,15,23,258,140,398,673
3404-001,2016,7,15,24,126,145,271,398
3404-001,2016,7,16,1,117,84,201,271
3404-001,2016,7,16,2,68,70,138,201
3404-001,2016,7,16,3,62,48,110,138
3404-001,2016,7,16,4,54,48,102,110
3404-001,2016,7,16,5,50,53,103,102
3404-001,2016,7,16,6,108,138,246,103
3404-001,2016,7,16,7,179,265,444,246
3404-001,2016,7,16,8,397,734,1131,444
3404-001,2016,7,16,9,520,612,1132,1131
3404-001,2016,7,16,10,484,505,989,1132
3404-001,2016,7,16,11,530,552,1082,989
3404-001,2016,7,16,12,541,534,1075,1082
3404-001,2016,7,16,13,557,510,1067,1075
3404-001,2016,7,16,14,522,484,1006,1067
3404-001,2016,7,16,15,524,433,957,1006
3404-001,2016,7,16,16,540,495,1035,957
3404-001,2016,7,16,17,611,388,999,1035
3404-001,2016,7,16,18,821,427,1248,999
3404-001,2016,7,16,19,481,377,858,1248
3404-001,2016,7,16,20,340,270,610,858
3404-001,2016,7,16,21,291,228,519,610
3404-001,2016,7,16,22,198,175,373,519
3404-001,2016,7,16,23,147,118,265,373
3404-001,2016,7,16,24,92,89,181,265
3404-001,2016,7,17,1,79,72,151,181
3404-001,2016,7,17,2,37,43,80,151
3404-001,2016,7,17,3,29,28,57,80
3404-001,2016,7,17,4,30,40,70,57
3404-001,2016,7,17,5,41,26,67,70
3404-001,2016,7,17,6,63,77,140,67
3404-001,2016,7,17,7,103,189,292,140
3404-001,2016,7,17,8,176,247,423,292
3404-001,2016,7,17,9,287,274,561,423
3404-001,2016,7,17,10,265,270,535,561
3404-001,2016,7,17,11,312,350,662,535
3404-001,2016,7,17,12,321,328,649,662
3404-001,2016,7,17,13,353,355,708,649
3404-001,2016,7,17,14,344,357,701,708
3404-001,2016,7,17,15,441,356,797,701
3404-001,2016,7,17,16,485,342,827,797
3404-001,2016,7,17,17,561,333,894,827
3404-001,2016,7,17,18,615,359,974,894
3404-001,2016,7,17,19,445,311,756,974
3404-001,2016,7,17,20,364,287,651,756
3404-001,2016,7,17,21,279,252,531,651
3404-001,2016,7,17,22,219,250,469,531
3404-001,2016,7,17,23,159,196,355,469
3404-001,2016,7,17,24,90,145,235,355
3404-001,2016,7,18,1,53,58,111,235
3404-001,2016,7,18,2,31,45,76,111
3404-001,2016,7,18,3,27,31,58,76
3404-001,2016,7,18,4,40,53,93,58
3404-001,2016,7,18,5,50,57,107,93
3404-001,2016,7,18,6,157,269,426,107
3404-001,2016,7,18,7,306,844,1150,426
3404-001,2016,7,18,8,603,2296,2899,1150
3404-001,2016,7,18,9,717,1568,2285,2899
3404-001,2016,7,18,10,711,807,1518,2285
3404-001,2016,7,18,11,745,819,1564,1518
3404-001,2016,7,18,12,703,870,1573,1564
3404-001,2016,7,18,13,622,693,1315,1573
3404-001,2016,7,18,14,686,839,1525,1315
3404-001,2016,7,18,15,844,941,1785,1525
3404-001,2016,7,18,16,818,878,1696,1785
3404-001,2016,7,18,17,873,697,1570,1696
3404-001,2016,7,18,18,1269,651,1920,1570
3404-001,2016,7,18,19,1125,618,1743,1920
3404-001,2016,7,18,20,909,413,1322,1743
3404-001,2016,7,18,21,776,296,1072,1322
3404-001,2016,7,18,22,443,160,603,1072
3404-001,2016,7,18,23,261,177,438,603
3404-001,2016,7,18,24,145,107,252,438
3404-001,2016,7,19,1,101,55,156,252
3404-001,2016,7,19,2,65,53,118,156
3404-001,2016,7,19,3,49,46,95,118
3404-001,2016,7,19,4,71,62,133,95
3404-001,2016,7,19,5,86,74,160,133
3404-001,2016,7,19,6,172,248,420,160
3404-001,2016,7,19,7,223,792,1015,420
3404-001,2016,7,19,8,576,2202,2778,1015
3404-001,2016,7,19,9,811,1581,2392,2778
3404-001,2016,7,19,10,752,951,1703,2392
3404-001,2016,7,19,11,720,933,1653,1703
3404-001,2016,7,19,12,759,907,1666,1653
3404-001,2016,7,19,13,654,754,1408,1666
3404-001,2016,7,19,14,709,804,1513,1408
3404-001,2016,7,19,15,840,742,1582,1513
3404-001,2016,7,19,16,904,812,1716,1582
3404-001,2016,7,19,17,926,783,1709,1716
3404-001,2016,7,19,18,1361,766,2127,1709
3404-001,2016,7,19,19,1179,576,1755,2127
3404-001,2016,7,19,20,838,427,1265,1755
3404-001,2016,7,19,21,784,286,1070,1265
3404-001,2016,7,19,22,439,240,679,1070
3404-001,2016,7,19,23,260,167,427,679
3404-001,2016,7,19,24,144,116,260,427
3404-001,2016,7,20,1,104,63,167,260
3404-001,2016,7,20,2,67,48,115,167
3404-001,2016,7,20,3,45,40,85,115
3404-001,2016,7,20,4,57,51,108,85
3404-001,2016,7,20,5,81,72,153,108
3404-001,2016,7,20,6,156,216,372,153
3404-001,2016,7,20,7,291,815,1106,372
3404-001,2016,7,20,8,578,2102,2680,1106
3404-001,2016,7,20,9,801,1557,2358,2680
3404-001,2016,7,20,10,790,927,1717,2358
3404-001,2016,7,20,11,723,899,1622,1717
3404-001,2016,7,20,12,809,877,1686,1622
3404-001,2016,7,20,13,666,748,1414,1686
3404-001,2016,7,20,14,698,737,1435,1414
3404-001,2016,7,20,15,853,897,1750,1435
3404-001,2016,7,20,16,872,878,1750,1750
3404-001,2016,7,20,17,926,724,1650,1750
3404-001,2016,7,20,18,1407,658,2065,1650
3404-001,2016,7,20,19,1285,618,1903,2065
3404-001,2016,7,20,20,777,472,1249,1903
3404-001,2016,7,20,21,643,282,925,1249
3404-001,2016,7,20,22,478,223,701,925
3404-001,2016,7,20,23,242,130,372,701
3404-001,2016,7,20,24,149,80,229,372
3404-001,2016,7,21,1,121,101,222,229
3404-001,2016,7,21,2,69,34,103,222
3404-001,2016,7,21,3,56,29,85,103
3404-001,2016,7,21,4,52,40,92,85
3404-001,2016,7,21,5,69,75,144,92
3404-001,2016,7,21,6,157,216,373,144
3404-001,2016,7,21,7,290,798,1088,373
3404-001,2016,7,21,8,562,2122,2684,1088
3404-001,2016,7,21,9,823,1535,2358,2684
3404-001,2016,7,21,10,718,887,1605,2358
3404-001,2016,7,21,11,759,814,1573,1605
3404-001,2016,7,21,12,737,912,1649,1573
3404-001,2016,7,21,13,652,744,1396,1649
3404-001,2016,7,21,14,716,870,1586,1396
3404-001,2016,7,21,15,893,990,1883,1586
3404-001,2016,7,21,16,888,758,1646,1883
3404-001,2016,7,21,17,919,780,1699,1646
3404-001,2016,7,21,18,1268,683,1951,1699
3404-001,2016,7,21,19,1190,641,1831,1951
3404-001,2016,7,21,20,888,433,1321,1831
3404-001,2016,7,21,21,761,343,1104,1321
3404-001,2016,7,21,22,484,236,720,1104
3404-001,2016,7,21,23,279,189,468,720
3404-001,2016,7,21,24,135,113,248,468
3404-001,2016,7,22,1,93,82,175,248
3404-001,2016,7,22,2,82,62,144,175
3404-001,2016,7,22,3,46,38,84,144
3404-001,2016,7,22,4,56,45,101,84
3404-001,2016,7,22,5,72,62,134,101
3404-001,2016,7,22,6,150,245,395,134
3404-001,2016,7,22,7,301,703,1004,395
3404-001,2016,7,22,8,592,2141,2733,1004
3404-001,2016,7,22,9,779,1569,2348,2733
3404-001,2016,7,22,10,746,871,1617,2348
3404-001,2016,7,22,11,799,868,1667,1617
3404-001,2016,7,22,12,809,871,1680,1667
3404-001,2016,7,22,13,679,663,1342,1680
3404-001,2016,7,22,14,758,773,1531,1342
3404-001,2016,7,22,15,834,809,1643,1531
3404-001,2016,7,22,16,934,887,1821,1643
3404-001,2016,7,22,17,923,787,1710,1821
3404-001,2016,7,22,18,1346,756,2102,1710
3404-001,2016,7,22,19,1444,727,2171,2102
3404-001,2016,7,22,20,896,551,1447,2171
3404-001,2016,7,22,21,722,359,1081,1447
3404-001,2016,7,22,22,418,236,654,1081
3404-001,2016,7,22,23,258,158,416,654
3404-001,2016,7,22,24,167,155,322,416
3404-001,2016,7,23,1,132,96,228,322
3404-001,2016,7,23,2,81,50,131,228
3404-001,2016,7,23,3,58,38,96,131
3404-001,2016,7,23,4,60,53,113,96
3404-001,2016,7,23,5,70,67,137,113
3404-001,2016,7,23,6,143,196,339,137
3404-001,2016,7,23,7,232,430,662,339
3404-001,2016,7,23,8,386,793,1179,662
3404-001,2016,7,23,9,558,838,1396,1179
3404-001,2016,7,23,10,597,736,1333,1396
3404-001,2016,7,23,11,621,698,1319,1333
3404-001,2016,7,23,12,586,675,1261,1319
3404-001,2016,7,23,13,554,588,1142,1261
3404-001,2016,7,23,14,588,654,1242,1142
3404-001,2016,7,23,15,518,520,1038,1242
3404-001,2016,7,23,16,604,505,1109,1038
3404-001,2016,7,23,17,732,491,1223,1109
3404-001,2016,7,23,18,916,472,1388,1223
3404-001,2016,7,23,19,671,396,1067,1388
3404-001,2016,7,23,20,415,333,748,1067
3404-001,2016,7,23,21,302,250,552,748
3404-001,2016,7,23,22,240,191,431,552
3404-001,2016,7,23,23,175,140,315,431
3404-001,2016,7,23,24,109,80,189,315
3404-001,2016,7,24,1,77,67,144,189
3404-001,2016,7,24,2,63,50,113,144
3404-001,2016,7,24,3,56,43,99,113
3404-001,2016,7,24,4,32,33,65,99
3404-001,2016,7,24,5,43,45,88,65
3404-001,2016,7,24,6,68,87,155,88
3404-001,2016,7,24,7,116,253,369,155
3404-001,2016,7,24,8,186,262,448,369
3404-001,2016,7,24,9,273,272,545,448
3404-001,2016,7,24,10,283,264,547,545
3404-001,2016,7,24,11,354,363,717,547
3404-001,2016,7,24,12,323,335,658,717
3404-001,2016,7,24,13,359,309,668,658
3404-001,2016,7,24,14,358,318,676,668
3404-001,2016,7,24,15,399,321,720,676
3404-001,2016,7,24,16,487,316,803,720
3404-001,2016,7,24,17,604,342,946,803
3404-001,2016,7,24,18,630,355,985,946
3404-001,2016,7,24,19,509,321,830,985
3404-001,2016,7,24,20,321,321,642,830
3404-001,2016,7,24,21,293,269,562,642
3404-001,2016,7,24,22,208,216,424,562
3404-001,2016,7,24,23,179,153,332,424
3404-001,2016,7,24,24,102,118,220,332
3404-001,2016,7,25,1,48,87,135,220
3404-001,2016,7,25,2,32,46,78,135
3404-001,2016,7,25,3,31,55,86,78
3404-001,2016,7,25,4,33,43,76,86
3404-001,2016,7,25,5,53,72,125,76
3404-001,2016,7,25,6,146,250,396,125
3404-001,2016,7,25,7,283,916,1199,396
3404-001,2016,7,25,8,624,2315,2939,1199
3404-001,2016,7,25,9,715,1613,2328,2939
3404-001,2016,7,25,10,712,793,1505,2328
3404-001,2016,7,25,11,758,817,1575,1505
3404-001,2016,7,25,12,757,797,1554,1575
3404-001,2016,7,25,13,669,652,1321,1554
3404-001,2016,7,25,14,681,781,1462,1321
3404-001,2016,7,25,15,813,849,1662,1462
3404-001,2016,7,25,16,841,793,1634,1662
3404-001,2016,7,25,17,875,690,1565,1634
3404-001,2016,7,25,18,1216,552,1768,1565
3404-001,2016,7,25,19,1134,537,1671,1768
3404-001,2016,7,25,20,858,454,1312,1671
3404-001,2016,7,25,21,825,330,1155,1312
3404-001,2016,7,25,22,490,192,682,1155
3404-001,2016,7,25,23,249,162,411,682
3404-001,2016,7,25,24,132,77,209,411
3404-001,2016,7,26,1,86,79,165,209
3404-001,2016,7,26,2,74,60,134,165
3404-001,2016,7,26,3,40,45,85,134
3404-001,2016,7,26,4,59,57,116,85
3404-001,2016,7,26,5,66,63,129,116
3404-001,2016,7,26,6,166,260,426,129
3404-001,2016,7,26,7,315,807,1122,426
3404-001,2016,7,26,8,583,2069,2652,1122
3404-001,2016,7,26,9,827,1605,2432,2652
3404-001,2016,7,26,10,778,832,1610,2432
3404-001,2016,7,26,11,736,919,1655,1610
3404-001,2016,7,26,12,790,894,1684,1655
3404-001,2016,7,26,13,693,848,1541,1684
3404-001,2016,7,26,14,729,765,1494,1541
3404-001,2016,7,26,15,809,871,1680,1494
3404-001,2016,7,26,16,932,844,1776,1680
3404-001,2016,7,26,17,917,714,1631,1776
3404-001,2016,7,26,18,1222,630,1852,1631
3404-001,2016,7,26,19,1209,562,1771,1852
3404-001,2016,7,26,20,855,359,1214,1771
3404-001,2016,7,26,21,760,315,1075,1214
3404-001,2016,7,26,22,486,240,726,1075
3404-001,2016,7,26,23,273,165,438,726
3404-001,2016,7,26,24,153,119,272,438
3404-001,2016,7,27,1,102,77,179,272
3404-001,2016,7,27,2,67,38,105,179
3404-001,2016,7,27,3,58,41,99,105
3404-001,2016,7,27,4,63,45,108,99
3404-001,2016,7,27,5,66,60,126,108
3404-001,2016,7,27,6,153,211,364,126
3404-001,2016,7,27,7,291,751,1042,364
3404-001,2016,7,27,8,554,2134,2688,1042
3404-001,2016,7,27,9,811,1449,2260,2688
3404-001,2016,7,27,10,719,882,1601,2260
3404-001,2016,7,27,11,787,829,1616,1601
3404-001,2016,7,27,12,726,703,1429,1616
3404-001,2016,7,27,13,611,639,1250,1429
3404-001,2016,7,27,14,729,629,1358,1250
3404-001,2016,7,27,15,840,714,1554,1358
3404-001,2016,7,27,16,831,681,1512,1554
3404-001,2016,7,27,17,861,666,1527,1512
3404-001,2016,7,27,18,1419,632,2051,1527
3404-001,2016,7,27,19,1260,561,1821,2051
3404-001,2016,7,27,20,835,394,1229,1821
3404-001,2016,7,27,21,600,253,853,1229
3404-001,2016,7,27,22,408,194,602,853
3404-001,2016,7,27,23,250,150,400,602
3404-001,2016,7,27,24,129,118,247,400
3404-001,2016,7,28,1,101,80,181,247
3404-001,2016,7,28,2,72,58,130,181
3404-001,2016,7,28,3,46,50,96,130
3404-001,2016,7,28,4,58,38,96,96
3404-001,2016,7,28,5,74,96,170,96
3404-001,2016,7,28,6,151,235,386,170
3404-001,2016,7,28,7,242,715,957,386
3404-001,2016,7,28,8,559,2078,2637,957
3404-001,2016,7,28,9,751,1615,2366,2637
3404-001,2016,7,28,10,709,943,1652,2366
3404-001,2016,7,28,11,756,904,1660,1652
3404-001,2016,7,28,12,708,822,1530,1660
3404-001,2016,7,28,13,684,817,1501,1530
3404-001,2016,7,28,14,672,761,1433,1501
3404-001,2016,7,28,15,828,887,1715,1433
3404-001,2016,7,28,16,831,819,1650,1715
3404-001,2016,7,28,17,908,775,1683,1650
3404-001,2016,7,28,18,1305,675,1980,1683
3404-001,2016,7,28,19,1160,547,1707,1980
3404-001,2016,7,28,20,843,416,1259,1707
3404-001,2016,7,28,21,748,318,1066,1259
3404-001,2016,7,28,22,467,218,685,1066
3404-001,2016,7,28,23,248,199,447,685
3404-001,2016,7,28,24,141,102,243,447
3404-001,2016,7,29,1,98,89,187,243
3404-001,2016,7,29,2,70,51,121,187
3404-001,2016,7,29,3,46,43,89,121
3404-001,2016,7,29,4,44,43,87,89
3404-001,2016,7,29,5,75,72,147,87
3404-001,2016,7,29,6,140,226,366,147
3404-001,2016,7,29,7,247,744,991,366
3404-001,2016,7,29,8,555,1955,2510,991
3404-001,2016,7,29,9,782,1371,2153,2510
3404-001,2016,7,29,10,722,656,1378,2153
3404-001,2016,7,29,11,678,598,1276,1378
3404-001,2016,7,29,12,647,551,1198,1276
3404-001,2016,7,29,13,669,551,1220,1198
3404-001,2016,7,29,14,705,675,1380,1220
3404-001,2016,7,29,15,761,608,1369,1380
3404-001,2016,7,29,16,832,675,1507,1369
3404-001,2016,7,29,17,854,598,1452,1507
3404-001,2016,7,29,18,1487,603,2090,1452
3404-001,2016,7,29,19,1334,562,1896,2090
3404-001,2016,7,29,20,850,474,1324,1896
3404-001,2016,7,29,21,614,308,922,1324
3404-001,2016,7,29,22,348,270,618,922
3404-001,2016,7,29,23,236,131,367,618
3404-001,2016,7,29,24,142,104,246,367
3404-001,2016,7,30,1,125,87,212,246
3404-001,2016,7,30,2,60,63,123,212
3404-001,2016,7,30,3,56,45,101,123
3404-001,2016,7,30,4,56,45,101,101
3404-001,2016,7,30,5,80,58,138,101
3404-001,2016,7,30,6,147,140,287,138
3404-001,2016,7,30,7,222,388,610,287
3404-001,2016,7,30,8,344,669,1013,610
3404-001,2016,7,30,9,473,732,1205,1013
3404-001,2016,7,30,10,564,690,1254,1205
3404-001,2016,7,30,11,645,744,1389,1254
3404-001,2016,7,30,12,497,651,1148,1389
3404-001,2016,7,30,13,489,717,1206,1148
3404-001,2016,7,30,14,528,676,1204,1206
3404-001,2016,7,30,15,560,658,1218,1204
3404-001,2016,7,30,16,549,493,1042,1218
3404-001,2016,7,30,17,589,466,1055,1042
3404-001,2016,7,30,18,756,472,1228,1055
3404-001,2016,7,30,19,611,384,995,1228
3404-001,2016,7,30,20,430,311,741,995
3404-001,2016,7,30,21,314,203,517,741
3404-001,2016,7,30,22,235,189,424,517
3404-001,2016,7,30,23,177,153,330,424
3404-001,2016,7,30,24,115,87,202,330
3404-001,2016,7,31,1,73,65,138,202
3404-001,2016,7,31,2,72,62,134,138
3404-001,2016,7,31,3,34,26,60,134
3404-001,2016,7,31,4,36,46,82,60
3404-001,2016,7,31,5,43,50,93,82
3404-001,2016,7,31,6,86,80,166,93
3404-001,2016,7,31,7,102,203,305,166
3404-001,2016,7,31,8,181,242,423,305
3404-001,2016,7,31,9,258,298,556,423
3404-001,2016,7,31,10,301,299,600,556
3404-001,2016,7,31,11,380,354,734,600
3404-001,2016,7,31,12,305,346,651,734
3404-001,2016,7,31,13,358,294,652,651
3404-001,2016,7,31,14,369,309,678,652
3404-001,2016,7,31,15,404,281,685,678
3404-001,2016,7,31,16,482,321,803,685
3404-001,2016,7,31,17,552,309,861,803
3404-001,2016,7,31,18,701,343,1044,861
3404-001,2016,7,31,19,519,333,852,1044
3404-001,2016,7,31,20,359,277,636,852
3404-001,2016,7,31,21,296,218,514,636
3404-001,2016,7,31,22,219,192,411,514
3404-001,2016,7,31,23,137,169,306,411
3404-001,2016,7,31,24,85,94,179,306
3404-001,2016,8,1,1,63,76,139,179
3404-001,2016,8,1,2,45,43,88,139
3404-001,2016,8,1,3,23,38,61,88
3404-001,2016,8,1,4,30,22,52,61
3404-001,2016,8,1,5,46,44,90,52
3404-001,2016,8,1,6,138,123,261,90
3404-001,2016,8,1,7,245,485,730,261
3404-001,2016,8,1,8,440,1126,1566,730
3404-001,2016,8,1,9,561,926,1487,1566
3404-001,2016,8,1,10,524,538,1062,1487
3404-001,2016,8,1,11,551,563,1114,1062
3404-001,2016,8,1,12,573,670,1243,1114
3404-001,2016,8,1,13,511,629,1140,1243
3404-001,2016,8,1,14,588,553,1141,1140
3404-001,2016,8,1,15,673,582,1255,1141
3404-001,2016,8,1,16,593,496,1089,1255
3404-001,2016,8,1,17,677,472,1149,1089
3404-001,2016,8,1,18,1002,420,1422,1149
3404-001,2016,8,1,19,883,434,1317,1422
3404-001,2016,8,1,20,546,311,857,1317
3404-001,2016,8,1,21,456,213,669,857
3404-001,2016,8,1,22,307,164,471,669
3404-001,2016,8,1,23,199,116,315,471
3404-001,2016,8,1,24,122,87,209,315
3404-001,2016,8,2,1,83,69,152,209
3404-001,2016,8,2,2,46,46,92,152
3404-001,2016,8,2,3,41,43,84,92
3404-001,2016,8,2,4,38,29,67,84
3404-001,2016,8,2,5,54,35,89,67
3404-001,2016,8,2,6,114,137,251,89
3404-001,2016,8,2,7,226,469,695,251
3404-001,2016,8,2,8,377,1022,1399,695
3404-001,2016,8,2,9,549,919,1468,1399
3404-001,2016,8,2,10,580,569,1149,1468
3404-001,2016,8,2,11,558,611,1169,1149
3404-001,2016,8,2,12,582,599,1181,1169
3404-001,2016,8,2,13,486,523,1009,1181
3404-001,2016,8,2,14,551,534,1085,1009
3404-001,2016,8,2,15,716,510,1226,1085
3404-001,2016,8,2,16,709,547,1256,1226
3404-001,2016,8,2,17,713,453,1166,1256
3404-001,2016,8,2,18,1133,461,1594,1166
3404-001,2016,8,2,19,1008,379,1387,1594
3404-001,2016,8,2,20,585,305,890,1387
3404-001,2016,8,2,21,433,229,662,890
3404-001,2016,8,2,22,303,163,466,662
3404-001,2016,8,2,23,183,102,285,466
3404-001,2016,8,2,24,124,91,215,285
3404-001,2016,8,3,1,59,69,128,215
3404-001,2016,8,3,2,52,32,84,128
3404-001,2016,8,3,3,45,32,77,84
3404-001,2016,8,3,4,46,31,77,77
3404-001,2016,8,3,5,73,58,131,77
3404-001,2016,8,3,6,121,135,256,131
3404-001,2016,8,3,7,223,420,643,256
3404-001,2016,8,3,8,417,987,1404,643
3404-001,2016,8,3,9,540,860,1400,1404
3404-001,2016,8,3,10,577,602,1179,1400
3404-001,2016,8,3,11,570,614,1184,1179
3404-001,2016,8,3,12,612,669,1281,1184
3404-001,2016,8,3,13,505,457,962,1281
3404-001,2016,8,3,14,570,547,1117,962
3404-001,2016,8,3,15,618,553,1171,1117
3404-001,2016,8,3,16,672,481,1153,1171
3404-001,2016,8,3,17,739,450,1189,1153
3404-001,2016,8,3,18,956,453,1409,1189
3404-001,2016,8,3,19,921,467,1388,1409
3404-001,2016,8,3,20,605,294,899,1388
3404-001,2016,8,3,21,426,207,633,899
3404-001,2016,8,3,22,293,187,480,633
3404-001,2016,8,3,23,155,114,269,480
3404-001,2016,8,3,24,118,82,200,269
3404-001,2016,8,4,1,72,67,139,200
3404-001,2016,8,4,2,71,49,120,139
3404-001,2016,8,4,3,46,40,86,120
3404-001,2016,8,4,4,56,29,85,86
3404-001,2016,8,4,5,58,64,122,85
3404-001,2016,8,4,6,110,173,283,122
3404-001,2016,8,4,7,238,585,823,283
3404-001,2016,8,4,8,441,1205,1646,823
3404-001,2016,8,4,9,668,969,1637,1646
3404-001,2016,8,4,10,581,656,1237,1637
3404-001,2016,8,4,11,577,740,1317,1237
3404-001,2016,8,4,12,633,681,1314,1317
3404-001,2016,8,4,13,543,503,1046,1314
3404-001,2016,8,4,14,602,603,1205,1046
3404-001,2016,8,4,15,681,605,1286,1205
3404-001,2016,8,4,16,660,573,1233,1286
3404-001,2016,8,4,17,720,540,1260,1233
3404-001,2016,8,4,18,1098,528,1626,1260
3404-001,2016,8,4,19,953,452,1405,1626
3404-001,2016,8,4,20,627,357,984,1405
3404-001,2016,8,4,21,528,200,728,984
3404-001,2016,8,4,22,311,149,460,728
3404-001,2016,8,4,23,182,100,282,460
3404-001,2016,8,4,24,140,84,224,282
3404-001,2016,8,5,1,78,58,136,224
3404-001,2016,8,5,2,55,35,90,136
3404-001,2016,8,5,3,53,37,90,90
3404-001,2016,8,5,4,44,29,73,90
3404-001,2016,8,5,5,62,54,116,73
3404-001,2016,8,5,6,126,140,266,116
3404-001,2016,8,5,7,261,523,784,266
3404-001,2016,8,5,8,482,1244,1726,784
3404-001,2016,8,5,9,690,1069,1759,1726
3404-001,2016,8,5,10,601,655,1256,1759
3404-001,2016,8,5,11,615,737,1352,1256
3404-001,2016,8,5,12,643,602,1245,1352
3404-001,2016,8,5,13,547,537,1084,1245
3404-001,2016,8,5,14,618,572,1190,1084
3404-001,2016,8,5,15,686,628,1314,1190
3404-001,2016,8,5,16,721,525,1246,1314
3404-001,2016,8,5,17,750,510,1260,1246
3404-001,2016,8,5,18,1198,523,1721,1260
3404-001,2016,8,5,19,1121,558,1679,1721
3404-001,2016,8,5,20,649,353,1002,1679
3404-001,2016,8,5,21,471,284,755,1002
3404-001,2016,8,5,22,297,185,482,755
3404-001,2016,8,5,23,222,107,329,482
3404-001,2016,8,5,24,111,90,201,329
3404-001,2016,8,6,1,88,84,172,201
3404-001,2016,8,6,2,63,37,100,172
3404-001,2016,8,6,3,58,32,90,100
3404-001,2016,8,6,4,51,32,83,90
3404-001,2016,8,6,5,49,57,106,83
3404-001,2016,8,6,6,97,134,231,106
3404-001,2016,8,6,7,203,367,570,231
3404-001,2016,8,6,8,376,581,957,570
3404-001,2016,8,6,9,442,599,1041,957
3404-001,2016,8,6,10,487,500,987,1041
3404-001,2016,8,6,11,517,517,1034,987
3404-001,2016,8,6,12,497,558,1055,1034
3404-001,2016,8,6,13,512,449,961,1055
3404-001,2016,8,6,14,511,391,902,961
3404-001,2016,8,6,15,536,414,950,902
3404-001,2016,8,6,16,579,423,1002,950
3404-001,2016,8,6,17,664,423,1087,1002
3404-001,2016,8,6,18,789,411,1200,1087
3404-001,2016,8,6,19,581,344,925,1200
3404-001,2016,8,6,20,386,269,655,925
3404-001,2016,8,6,21,317,193,510,655
3404-001,2016,8,6,22,231,188,419,510
3404-001,2016,8,6,23,133,102,235,419
3404-001,2016,8,6,24,109,73,182,235
3404-001,2016,8,7,1,76,60,136,182
3404-001,2016,8,7,2,45,37,82,136
3404-001,2016,8,7,3,25,28,53,82
3404-001,2016,8,7,4,25,41,66,53
3404-001,2016,8,7,5,37,38,75,66
3404-001,2016,8,7,6,71,73,144,75
3404-001,2016,8,7,7,112,157,269,144
3404-001,2016,8,7,8,171,208,379,269
3404-001,2016,8,7,9,262,249,511,379
3404-001,2016,8,7,10,277,257,534,511
3404-001,2016,8,7,11,306,291,597,534
3404-001,2016,8,7,12,345,326,671,597
3404-001,2016,8,7,13,348,250,598,671
3404-001,2016,8,7,14,383,299,682,598
3404-001,2016,8,7,15,469,293,762,682
3404-001,2016,8,7,16,424,318,742,762
3404-001,2016,8,7,17,513,261,774,742
3404-001,2016,8,7,18,534,329,863,774
3404-001,2016,8,7,19,426,313,739,863
3404-001,2016,8,7,20,310,270,580,739
3404-001,2016,8,7,21,308,204,512,580
3404-001,2016,8,7,22,227,197,424,512
3404-001,2016,8,7,23,147,141,288,424
3404-001,2016,8,7,24,91,110,201,288
3404-001,2016,8,8,1,34,73,107,201
3404-001,2016,8,8,2,49,40,89,107
3404-001,2016,8,8,3,32,29,61,89
3404-001,2016,8,8,4,32,40,72,61
3404-001,2016,8,8,5,76,57,133,72
3404-001,2016,8,8,6,132,250,382,133
3404-001,2016,8,8,7,284,867,1151,382
3404-001,2016,8,8,8,595,2123,2718,1151
3404-001,2016,8,8,9,708,1273,1981,2718
3404-001,2016,8,8,10,661,728,1389,1981
3404-001,2016,8,8,11,742,749,1491,1389
3404-001,2016,8,8,12,679,743,1422,1491
3404-001,2016,8,8,13,639,626,1265,1422
3404-001,2016,8,8,14,664,667,1331,1265
3404-001,2016,8,8,15,738,703,1441,1331
3404-001,2016,8,8,16,903,800,1703,1441
3404-001,2016,8,8,17,860,705,1565,1703
3404-001,2016,8,8,18,1202,582,1784,1565
3404-001,2016,8,8,19,1120,510,1630,1784
3404-001,2016,8,8,20,793,396,1189,1630
3404-001,2016,8,8,21,789,257,1046,1189
3404-001,2016,8,8,22,433,155,588,1046
3404-001,2016,8,8,23,210,111,321,588
3404-001,2016,8,8,24,125,131,256,321
3404-001,2016,8,9,1,82,66,148,256
3404-001,2016,8,9,2,86,40,126,148
3404-001,2016,8,9,3,40,35,75,126
3404-001,2016,8,9,4,54,41,95,75
3404-001,2016,8,9,5,74,72,146,95
3404-001,2016,8,9,6,149,243,392,146
3404-001,2016,8,9,7,289,670,959,392
3404-001,2016,8,9,8,620,1974,2594,959
3404-001,2016,8,9,9,820,1231,2051,2594
3404-001,2016,8,9,10,786,755,1541,2051
3404-001,2016,8,9,11,781,814,1595,1541
3404-001,2016,8,9,12,807,781,1588,1595
3404-001,2016,8,9,13,658,666,1324,1588
3404-001,2016,8,9,14,714,708,1422,1324
3404-001,2016,8,9,15,853,708,1561,1422
3404-001,2016,8,9,16,866,710,1576,1561
3404-001,2016,8,9,17,900,616,1516,1576
3404-001,2016,8,9,18,1244,579,1823,1516
3404-001,2016,8,9,19,1144,432,1576,1823
3404-001,2016,8,9,20,820,367,1187,1576
3404-001,2016,8,9,21,810,284,1094,1187
3404-001,2016,8,9,22,401,169,570,1094
3404-001,2016,8,9,23,225,107,332,570
3404-001,2016,8,9,24,117,99,216,332
3404-001,2016,8,10,1,107,69,176,216
3404-001,2016,8,10,2,57,49,106,176
3404-001,2016,8,10,3,63,35,98,106
3404-001,2016,8,10,4,49,35,84,98
3404-001,2016,8,10,5,80,50,130,84
3404-001,2016,8,10,6,135,219,354,130
3404-001,2016,8,10,7,269,679,948,354
3404-001,2016,8,10,8,606,1881,2487,948
3404-001,2016,8,10,9,795,1241,2036,2487
3404-001,2016,8,10,10,738,767,1505,2036
3404-001,2016,8,10,11,768,840,1608,1505
3404-001,2016,8,10,12,739,799,1538,1608
3404-001,2016,8,10,13,646,687,1333,1538
3404-001,2016,8,10,14,718,772,1490,1333
3404-001,2016,8,10,15,779,817,1596,1490
3404-001,2016,8,10,16,844,770,1614,1596
3404-001,2016,8,10,17,955,610,1565,1614
3404-001,2016,8,10,18,1338,579,1917,1565
3404-001,2016,8,10,19,1232,502,1734,1917
3404-001,2016,8,10,20,867,410,1277,1734
3404-001,2016,8,10,21,690,273,963,1277
3404-001,2016,8,10,22,403,170,573,963
3404-001,2016,8,10,23,220,123,343,573
3404-001,2016,8,10,24,123,78,201,343
3404-001,2016,8,11,1,94,76,170,201
3404-001,2016,8,11,2,64,41,105,170
3404-001,2016,8,11,3,46,40,86,105
3404-001,2016,8,11,4,56,26,82,86
3404-001,2016,8,11,5,76,55,131,82
3404-001,2016,8,11,6,127,238,365,131
3404-001,2016,8,11,7,299,682,981,365
3404-001,2016,8,11,8,581,1934,2515,981
3404-001,2016,8,11,9,811,1328,2139,2515
3404-001,2016,8,11,10,745,705,1450,2139
3404-001,2016,8,11,11,745,849,1594,1450
3404-001,2016,8,11,12,778,740,1518,1594
3404-001,2016,8,11,13,696,631,1327,1518
3404-001,2016,8,11,14,740,682,1422,1327
3404-001,2016,8,11,15,796,802,1598,1422
3404-001,2016,8,11,16,877,711,1588,1598
3404-001,2016,8,11,17,911,679,1590,1588
3404-001,2016,8,11,18,1245,611,1856,1590
3404-001,2016,8,11,19,1221,485,1706,1856
3404-001,2016,8,11,20,847,384,1231,1706
3404-001,2016,8,11,21,734,246,980,1231
3404-001,2016,8,11,22,416,185,601,980
3404-001,2016,8,11,23,233,138,371,601
3404-001,2016,8,11,24,117,111,228,371
3404-001,2016,8,12,1,95,58,153,228
3404-001,2016,8,12,2,62,70,132,153
3404-001,2016,8,12,3,52,38,90,132
3404-001,2016,8,12,4,60,38,98,90
3404-001,2016,8,12,5,71,75,146,98
3404-001,2016,8,12,6,126,208,334,146
3404-001,2016,8,12,7,277,667,944,334
3404-001,2016,8,12,8,610,1921,2531,944
3404-001,2016,8,12,9,801,1234,2035,2531
3404-001,2016,8,12,10,772,720,1492,2035
3404-001,2016,8,12,11,826,850,1676,1492
3404-001,2016,8,12,12,787,646,1433,1676
3404-001,2016,8,12,13,650,616,1266,1433
3404-001,2016,8,12,14,726,719,1445,1266
3404-001,2016,8,12,15,857,813,1670,1445
3404-001,2016,8,12,16,922,803,1725,1670
3404-001,2016,8,12,17,699,641,1340,1725
3404-001,2016,8,12,18,879,666,1545,1340
3404-001,2016,8,12,19,751,584,1335,1545
3404-001,2016,8,12,20,456,538,994,1335
3404-001,2016,8,12,21,373,331,704,994
3404-001,2016,8,12,22,162,231,393,704
3404-001,2016,8,12,23,87,160,247,393
3404-001,2016,8,12,24,44,96,140,247
3404-001,2016,8,13,1,61,87,148,140
3404-001,2016,8,13,2,61,57,118,148
3404-001,2016,8,13,3,27,37,64,118
3404-001,2016,8,13,4,43,31,74,64
3404-001,2016,8,13,5,39,64,103,74
3404-001,2016,8,13,6,125,197,322,103
3404-001,2016,8,13,7,211,360,571,322
3404-001,2016,8,13,8,377,700,1077,571
3404-001,2016,8,13,9,489,669,1158,1077
3404-001,2016,8,13,10,473,641,1114,1158
3404-001,2016,8,13,11,499,688,1187,1114
3404-001,2016,8,13,12,455,795,1250,1187
3404-001,2016,8,13,13,397,763,1160,1250
3404-001,2016,8,13,14,445,696,1141,1160
3404-001,2016,8,13,15,563,766,1329,1141
3404-001,2016,8,13,16,551,526,1077,1329
3404-001,2016,8,13,17,563,508,1071,1077
3404-001,2016,8,13,18,775,567,1342,1071
3404-001,2016,8,13,19,511,457,968,1342
3404-001,2016,8,13,20,297,343,640,968
3404-001,2016,8,13,21,211,220,431,640
3404-001,2016,8,13,22,129,181,310,431
3404-001,2016,8,13,23,75,141,216,310
3404-001,2016,8,13,24,41,75,116,216
3404-001,2016,8,14,1,41,66,107,116
3404-001,2016,8,14,2,31,29,60,107
3404-001,2016,8,14,3,17,29,46,60
3404-001,2016,8,14,4,19,28,47,46
3404-001,2016,8,14,5,21,40,61,47
3404-001,2016,8,14,6,33,81,114,61
3404-001,2016,8,14,7,63,175,238,114
3404-001,2016,8,14,8,85,213,298,238
3404-001,2016,8,14,9,181,254,435,298
3404-001,2016,8,14,10,189,319,508,435
3404-001,2016,8,14,11,215,357,572,508
3404-001,2016,8,14,12,207,322,529,572
3404-001,2016,8,14,13,189,322,511,529
3404-001,2016,8,14,14,177,316,493,511
3404-001,2016,8,14,15,263,304,567,493
3404-001,2016,8,14,16,289,261,550,567
3404-001,2016,8,14,17,375,297,672,550
3404-001,2016,8,14,18,394,340,734,672
3404-001,2016,8,14,19,311,282,593,734
3404-001,2016,8,14,20,249,275,524,593
3404-001,2016,8,14,21,201,200,401,524
3404-001,2016,8,14,22,147,190,337,401
3404-001,2016,8,14,23,83,126,209,337
3404-001,2016,8,14,24,37,90,127,209
3404-001,2016,8,15,1,23,79,102,127
3404-001,2016,8,15,2,33,58,91,102
3404-001,2016,8,15,3,17,43,60,91
3404-001,2016,8,15,4,25,40,65,60
3404-001,2016,8,15,5,23,49,72,65
3404-001,2016,8,15,6,57,166,223,72
3404-001,2016,8,15,7,169,352,521,223
3404-001,2016,8,15,8,237,582,819,521
3404-001,2016,8,15,9,285,494,779,819
3404-001,2016,8,15,10,353,405,758,779
3404-001,2016,8,15,11,365,452,817,758
3404-001,2016,8,15,12,443,461,904,817
3404-001,2016,8,15,13,419,397,816,904
3404-001,2016,8,15,14,443,372,815,816
3404-001,2016,8,15,15,631,408,1039,815
3404-001,2016,8,15,16,559,405,964,1039
3404-001,2016,8,15,17,679,353,1032,964
3404-001,2016,8,15,18,978,355,1333,1032
3404-001,2016,8,15,19,597,329,926,1333
3404-001,2016,8,15,20,341,288,629,926
3404-001,2016,8,15,21,225,263,488,629
3404-001,2016,8,15,22,151,193,344,488
3404-001,2016,8,15,23,79,140,219,344
3404-001,2016,8,15,24,67,120,187,219
3404-001,2016,8,16,1,27,66,93,187
3404-001,2016,8,16,2,17,60,77,93
3404-001,2016,8,16,3,29,31,60,77
3404-001,2016,8,16,4,27,40,67,60
3404-001,2016,8,16,5,35,66,101,67
3404-001,2016,8,16,6,123,243,366,101
3404-001,2016,8,16,7,283,706,989,366
3404-001,2016,8,16,8,581,2107,2688,989
3404-001,2016,8,16,9,695,1276,1971,2688
3404-001,2016,8,16,10,631,750,1381,1971
3404-001,2016,8,16,11,687,806,1493,1381
3404-001,2016,8,16,12,653,772,1425,1493
3404-001,2016,8,16,13,647,666,1313,1425
3404-001,2016,8,16,14,553,702,1255,1313
3404-001,2016,8,16,15,790,787,1577,1255
3404-001,2016,8,16,16,723,784,1507,1577
3404-001,2016,8,16,17,894,703,1597,1507
3404-001,2016,8,16,18,1318,676,1994,1597
3404-001,2016,8,16,19,1156,444,1600,1994
3404-001,2016,8,16,20,659,384,1043,1600
3404-001,2016,8,16,21,735,249,984,1043
3404-001,2016,8,16,22,433,170,603,984
3404-001,2016,8,16,23,167,122,289,603
3404-001,2016,8,16,24,77,107,184,289
3404-001,2016,8,17,1,61,67,128,184
3404-001,2016,8,17,2,51,49,100,128
3404-001,2016,8,17,3,31,38,69,100
3404-001,2016,8,17,4,41,47,88,69
3404-001,2016,8,17,5,61,70,131,88
3404-001,2016,8,17,6,111,250,361,131
3404-001,2016,8,17,7,249,649,898,361
3404-001,2016,8,17,8,489,2056,2545,898
3404-001,2016,8,17,9,806,1262,2068,2545
3404-001,2016,8,17,10,733,710,1443,2068
3404-001,2016,8,17,11,745,735,1480,1443
3404-001,2016,8,17,12,836,829,1665,1480
3404-001,2016,8,17,13,671,669,1340,1665
3404-001,2016,8,17,14,735,784,1519,1340
3404-001,2016,8,17,15,948,756,1704,1519
3404-001,2016,8,17,16,872,793,1665,1704
3404-001,2016,8,17,17,860,579,1439,1665
3404-001,2016,8,17,18,1541,531,2072,1439
3404-001,2016,8,17,19,1438,429,1867,2072
3404-001,2016,8,17,20,820,405,1225,1867
3404-001,2016,8,17,21,615,266,881,1225
3404-001,2016,8,17,22,353,187,540,881
3404-001,2016,8,17,23,133,131,264,540
3404-001,2016,8,17,24,91,126,217,264
3404-001,2016,8,18,1,43,85,128,217
3404-001,2016,8,18,2,17,43,60,128
3404-001,2016,8,18,3,27,34,61,60
3404-001,2016,8,18,4,39,46,85,61
3404-001,2016,8,18,5,53,60,113,85
3404-001,2016,8,18,6,133,238,371,113
3404-001,2016,8,18,7,259,722,981,371
3404-001,2016,8,18,8,529,1979,2508,981
3404-001,2016,8,18,9,772,1305,2077,2508
3404-001,2016,8,18,10,697,750,1447,2077
3404-001,2016,8,18,11,735,758,1493,1447
3404-001,2016,8,18,12,796,753,1549,1493
3404-001,2016,8,18,13,641,725,1366,1549
3404-001,2016,8,18,14,737,756,1493,1366
3404-001,2016,8,18,15,842,891,1733,1493
3404-001,2016,8,18,16,854,697,1551,1733
3404-001,2016,8,18,17,890,564,1454,1551
3404-001,2016,8,18,18,1377,575,1952,1454
3404-001,2016,8,18,19,1230,493,1723,1952
3404-001,2016,8,18,20,840,370,1210,1723
3404-001,2016,8,18,21,767,278,1045,1210
3404-001,2016,8,18,22,405,216,621,1045
3404-001,2016,8,18,23,133,110,243,621
3404-001,2016,8,18,24,77,108,185,243
3404-001,2016,8,19,1,45,87,132,185
3404-001,2016,8,19,2,37,46,83,132
3404-001,2016,8,19,3,33,43,76,83
3404-001,2016,8,19,4,41,41,82,76
3404-001,2016,8,19,5,45,90,135,82
3404-001,2016,8,19,6,135,254,389,135
3404-001,2016,8,19,7,265,626,891,389
3404-001,2016,8,19,8,519,2033,2552,891
3404-001,2016,8,19,9,786,1362,2148,2552
3404-001,2016,8,19,10,751,755,1506,2148
3404-001,2016,8,19,11,769,767,1536,1506
3404-001,2016,8,19,12,840,781,1621,1536
3404-001,2016,8,19,13,671,673,1344,1621
3404-001,2016,8,19,14,661,756,1417,1344
3404-001,2016,8,19,15,838,873,1711,1417
3404-001,2016,8,19,16,904,747,1651,1711
3404-001,2016,8,19,17,942,611,1553,1651
3404-001,2016,8,19,18,1591,587,2178,1553
3404-001,2016,8,19,19,1593,543,2136,2178
3404-001,2016,8,19,20,842,452,1294,2136
3404-001,2016,8,19,21,723,302,1025,1294
3404-001,2016,8,19,22,385,197,582,1025
3404-001,2016,8,19,23,133,146,279,582
3404-001,2016,8,19,24,81,93,174,279
3404-001,2016,8,20,1,69,61,130,174
3404-001,2016,8,20,2,45,37,82,130
3404-001,2016,8,20,3,25,46,71,82
3404-001,2016,8,20,4,31,35,66,71
3404-001,2016,8,20,5,47,44,91,66
3404-001,2016,8,20,6,91,202,293,91
3404-001,2016,8,20,7,175,478,653,293
3404-001,2016,8,20,8,313,855,1168,653
3404-001,2016,8,20,9,549,590,1139,1168
3404-001,2016,8,20,10,535,878,1413,1139
3404-001,2016,8,20,11,525,917,1442,1413
3404-001,2016,8,20,12,509,882,1391,1442
3404-001,2016,8,20,13,435,766,1201,1391
3404-001,2016,8,20,14,463,716,1179,1201
3404-001,2016,8,20,15,503,763,1266,1179
3404-001,2016,8,20,16,601,684,1285,1266
3404-001,2016,8,20,17,637,573,1210,1285
3404-001,2016,8,20,18,911,419,1330,1210
3404-001,2016,8,20,19,523,402,925,1330
3404-001,2016,8,20,20,273,305,578,925
3404-001,2016,8,20,21,177,217,394,578
3404-001,2016,8,20,22,145,163,308,394
3404-001,2016,8,20,23,97,140,237,308
3404-001,2016,8,20,24,65,81,146,237
3404-001,2016,8,21,1,33,55,88,146
3404-001,2016,8,21,2,25,50,75,88
3404-001,2016,8,21,3,29,31,60,75
3404-001,2016,8,21,4,23,29,52,60
3404-001,2016,8,21,5,23,58,81,52
3404-001,2016,8,21,6,37,78,115,81
3404-001,2016,8,21,7,115,175,290,115
3404-001,2016,8,21,8,115,241,356,290
3404-001,2016,8,21,9,169,263,432,356
3404-001,2016,8,21,10,181,273,454,432
3404-001,2016,8,21,11,179,307,486,454
3404-001,2016,8,21,12,177,325,502,486
3404-001,2016,8,21,13,251,326,577,502
3404-001,2016,8,21,14,235,314,549,577
3404-001,2016,8,21,15,313,333,646,549
3404-001,2016,8,21,16,401,344,745,646
3404-001,2016,8,21,17,373,294,667,745
3404-001,2016,8,21,18,432,343,775,667
3404-001,2016,8,21,19,323,329,652,775
3404-001,2016,8,21,20,187,267,454,652
3404-001,2016,8,21,21,177,263,440,454
3404-001,2016,8,21,22,133,213,346,440
3404-001,2016,8,21,23,49,167,216,346
3404-001,2016,8,21,24,39,99,138,216
3404-001,2016,8,22,1,19,60,79,138
3404-001,2016,8,22,2,17,40,57,79
3404-001,2016,8,22,3,23,47,70,57
3404-001,2016,8,22,4,17,40,57,70
3404-001,2016,8,22,5,37,64,101,57
3404-001,2016,8,22,6,115,252,367,101
3404-001,2016,8,22,7,271,796,1067,367
3404-001,2016,8,22,8,575,2097,2672,1067
3404-001,2016,8,22,9,661,1406,2067,2672
3404-001,2016,8,22,10,583,697,1280,2067
3404-001,2016,8,22,11,697,705,1402,1280
3404-001,2016,8,22,12,641,734,1375,1402
3404-001,2016,8,22,13,515,679,1194,1375
3404-001,2016,8,22,14,613,746,1359,1194
3404-001,2016,8,22,15,693,753,1446,1359
3404-001,2016,8,22,16,812,766,1578,1446
3404-001,2016,8,22,17,888,614,1502,1578
3404-001,2016,8,22,18,1221,544,1765,1502
3404-001,2016,8,22,19,1192,473,1665,1765
3404-001,2016,8,22,20,840,390,1230,1665
3404-001,2016,8,22,21,840,258,1098,1230
3404-001,2016,8,22,22,353,191,544,1098
3404-001,2016,8,22,23,181,108,289,544
3404-001,2016,8,22,24,69,72,141,289
3404-001,2016,8,23,1,59,60,119,141
3404-001,2016,8,23,2,37,55,92,119
3404-001,2016,8,23,3,35,44,79,92
3404-001,2016,8,23,4,23,25,48,79
3404-001,2016,8,23,5,63,46,109,48
3404-001,2016,8,23,6,131,252,383,109
3404-001,2016,8,23,7,295,737,1032,383
3404-001,2016,8,23,8,623,2017,2640,1032
3404-001,2016,8,23,9,872,1314,2186,2640
3404-001,2016,8,23,10,671,743,1414,2186
3404-001,2016,8,23,11,619,725,1344,1414
3404-001,2016,8,23,12,639,653,1292,1344
3404-001,2016,8,23,13,613,647,1260,1292
3404-001,2016,8,23,14,591,734,1325,1260
3404-001,2016,8,23,15,806,775,1581,1325
3404-001,2016,8,23,16,944,710,1654,1581
3404-001,2016,8,23,17,984,584,1568,1654
3404-001,2016,8,23,18,1264,600,1864,1568
3404-001,2016,8,23,19,1268,450,1718,1864
3404-001,2016,8,23,20,761,360,1121,1718
3404-001,2016,8,23,21,804,238,1042,1121
3404-001,2016,8,23,22,347,173,520,1042
3404-001,2016,8,23,23,175,123,298,520
3404-001,2016,8,23,24,99,110,209,298
3404-001,2016,8,24,1,65,67,132,209
3404-001,2016,8,24,2,31,41,72,132
3404-001,2016,8,24,3,49,49,98,72
3404-001,2016,8,24,4,35,35,70,98
3404-001,2016,8,24,5,45,46,91,70
3404-001,2016,8,24,6,115,238,353,91
3404-001,2016,8,24,7,267,688,955,353
3404-001,2016,8,24,8,575,2000,2575,955
3404-001,2016,8,24,9,834,1397,2231,2575
3404-001,2016,8,24,10,645,681,1326,2231
3404-001,2016,8,24,11,778,672,1450,1326
3404-001,2016,8,24,12,772,728,1500,1450
3404-001,2016,8,24,13,585,681,1266,1500
3404-001,2016,8,24,14,617,760,1377,1266
3404-001,2016,8,24,15,778,822,1600,1377
3404-001,2016,8,24,16,900,720,1620,1600
3404-001,2016,8,24,17,930,602,1532,1620
3404-001,2016,8,24,18,1474,535,2009,1532
3404-001,2016,8,24,19,1292,490,1782,2009
3404-001,2016,8,24,20,767,397,1164,1782
3404-001,2016,8,24,21,607,235,842,1164
3404-001,2016,8,24,22,307,179,486,842
3404-001,2016,8,24,23,155,122,277,486
3404-001,2016,8,24,24,69,90,159,277
3404-001,2016,8,25,1,53,70,123,159
3404-001,2016,8,25,2,47,57,104,123
3404-001,2016,8,25,3,23,44,67,104
3404-001,2016,8,25,4,39,46,85,67
3404-001,2016,8,25,5,51,78,129,85
3404-001,2016,8,25,6,121,238,359,129
3404-001,2016,8,25,7,241,681,922,359
3404-001,2016,8,25,8,559,1937,2496,922
3404-001,2016,8,25,9,890,1353,2243,2496
3404-001,2016,8,25,10,745,760,1505,2243
3404-001,2016,8,25,11,631,760,1391,1505
3404-001,2016,8,25,12,757,752,1509,1391
3404-001,2016,8,25,13,541,663,1204,1509
3404-001,2016,8,25,14,725,744,1469,1204
3404-001,2016,8,25,15,808,810,1618,1469
3404-001,2016,8,25,16,914,755,1669,1618
3404-001,2016,8,25,17,894,616,1510,1669
3404-001,2016,8,25,18,1310,555,1865,1510
3404-001,2016,8,25,19,1328,494,1822,1865
3404-001,2016,8,25,20,820,379,1199,1822
3404-001,2016,8,25,21,721,246,967,1199
3404-001,2016,8,25,22,341,179,520,967
3404-001,2016,8,25,23,167,154,321,520
3404-001,2016,8,25,24,95,100,195,321
3404-001,2016,8,26,1,39,55,94,195
3404-001,2016,8,26,2,53,49,102,94
3404-001,2016,8,26,3,31,52,83,102
3404-001,2016,8,26,4,25,31,56,83
3404-001,2016,8,26,5,63,46,109,56
3404-001,2016,8,26,6,133,191,324,109
3404-001,2016,8,26,7,241,570,811,324
3404-001,2016,8,26,8,499,1669,2168,811
3404-001,2016,8,26,9,804,1326,2130,2168
3404-001,2016,8,26,10,619,669,1288,2130
3404-001,2016,8,26,11,667,684,1351,1288
3404-001,2016,8,26,12,689,646,1335,1351
3404-001,2016,8,26,13,607,522,1129,1335
3404-001,2016,8,26,14,647,520,1167,1129
3404-001,2016,8,26,15,800,602,1402,1167
3404-001,2016,8,26,16,932,613,1545,1402
3404-001,2016,8,26,17,944,605,1549,1545
3404-001,2016,8,26,18,1514,514,2028,1549
3404-001,2016,8,26,19,1454,561,2015,2028
3404-001,2016,8,26,20,834,394,1228,2015
3404-001,2016,8,26,21,627,249,876,1228
3404-001,2016,8,26,22,333,217,550,876
3404-001,2016,8,26,23,195,120,315,550
3404-001,2016,8,26,24,85,94,179,315
3404-001,2016,8,27,1,63,54,117,179
3404-001,2016,8,27,2,43,67,110,117
3404-001,2016,8,27,3,47,43,90,110
3404-001,2016,8,27,4,29,47,76,90
3404-001,2016,8,27,5,47,49,96,76
3404-001,2016,8,27,6,95,204,299,96
3404-001,2016,8,27,7,189,476,665,299
3404-001,2016,8,27,8,387,722,1109,665
3404-001,2016,8,27,9,477,681,1158,1109
3404-001,2016,8,27,10,469,614,1083,1158
3404-001,2016,8,27,11,501,622,1123,1083
3404-001,2016,8,27,12,517,666,1183,1123
3404-001,2016,8,27,13,657,596,1253,1183
3404-001,2016,8,27,14,431,572,1003,1253
3404-001,2016,8,27,15,577,617,1194,1003
3404-001,2016,8,27,16,555,550,1105,1194
3404-001,2016,8,27,17,597,496,1093,1105
3404-001,2016,8,27,18,1015,494,1509,1093
3404-001,2016,8,27,19,820,416,1236,1509
3404-001,2016,8,27,20,333,352,685,1236
3404-001,2016,8,27,21,253,231,484,685
3404-001,2016,8,27,22,101,219,320,484
3404-001,2016,8,27,23,79,123,202,320
3404-001,2016,8,27,24,43,76,119,202
3404-001,2016,8,28,1,39,58,97,119
3404-001,2016,8,28,2,29,26,55,97
3404-001,2016,8,28,3,19,40,59,55
3404-001,2016,8,28,4,25,31,56,59
3404-001,2016,8,28,5,31,26,57,56
3404-001,2016,8,28,6,49,82,131,57
3404-001,2016,8,28,7,91,185,276,131
3404-001,2016,8,28,8,179,316,495,276
3404-001,2016,8,28,9,205,263,468,495
3404-001,2016,8,28,10,149,261,410,468
3404-001,2016,8,28,11,259,334,593,410
3404-001,2016,8,28,12,295,364,659,593
3404-001,2016,8,28,13,263,376,639,659
3404-001,2016,8,28,14,277,355,632,639
3404-001,2016,8,28,15,515,381,896,632
3404-001,2016,8,28,16,998,378,1376,896
3404-001,2016,8,28,17,976,317,1293,1376
3404-001,2016,8,28,18,1025,325,1350,1293
3404-001,2016,8,28,19,697,358,1055,1350
3404-001,2016,8,28,20,623,285,908,1055
3404-001,2016,8,28,21,489,244,733,908
3404-001,2016,8,28,22,595,214,809,733
3404-001,2016,8,28,23,113,188,301,809
3404-001,2016,8,28,24,29,135,164,301
3404-001,2016,8,29,1,33,82,115,164
3404-001,2016,8,29,2,17,37,54,115
3404-001,2016,8,29,3,9,23,32,54
3404-001,2016,8,29,4,25,37,62,32
3404-001,2016,8,29,5,45,61,106,62
3404-001,2016,8,29,6,145,252,397,106
3404-001,2016,8,29,7,253,814,1067,397
3404-001,2016,8,29,8,563,2087,2650,1067
3404-001,2016,8,29,9,745,959,1704,2650
3404-001,2016,8,29,10,669,706,1375,1704
3404-001,2016,8,29,11,810,803,1613,1375
3404-001,2016,8,29,12,693,734,1427,1613
3404-001,2016,8,29,13,603,685,1288,1427
3404-001,2016,8,29,14,719,750,1469,1288
3404-001,2016,8,29,15,878,796,1674,1469
3404-001,2016,8,29,16,912,663,1575,1674
3404-001,2016,8,29,17,856,664,1520,1575
3404-001,2016,8,29,18,1146,558,1704,1520
3404-001,2016,8,29,19,1309,460,1769,1704
3404-001,2016,8,29,20,808,378,1186,1769
3404-001,2016,8,29,21,677,223,900,1186
3404-001,2016,8,29,22,379,210,589,900
3404-001,2016,8,29,23,167,137,304,589
3404-001,2016,8,29,24,89,93,182,304
3404-001,2016,8,30,1,69,82,151,182
3404-001,2016,8,30,2,47,44,91,151
3404-001,2016,8,30,3,29,35,64,91
3404-001,2016,8,30,4,31,35,66,64
3404-001,2016,8,30,5,53,75,128,66
3404-001,2016,8,30,6,147,234,381,128
3404-001,2016,8,30,7,297,699,996,381
3404-001,2016,8,30,8,593,1856,2449,996
3404-001,2016,8,30,9,808,1335,2143,2449
3404-001,2016,8,30,10,669,755,1424,2143
3404-001,2016,8,30,11,607,699,1306,1424
3404-001,2016,8,30,12,643,756,1399,1306
3404-001,2016,8,30,13,639,525,1164,1399
3404-001,2016,8,30,14,675,572,1247,1164
3404-001,2016,8,30,15,749,644,1393,1247
3404-001,2016,8,30,16,854,623,1477,1393
3404-001,2016,8,30,17,1056,549,1605,1477
3404-001,2016,8,30,18,1307,553,1860,1605
3404-001,2016,8,30,19,1260,432,1692,1860
3404-001,2016,8,30,20,749,355,1104,1692
3404-001,2016,8,30,21,687,238,925,1104
3404-001,2016,8,30,22,367,188,555,925
3404-001,2016,8,30,23,167,122,289,555
3404-001,2016,8,30,24,79,100,179,289
3404-001,2016,8,31,1,53,64,117,179
3404-001,2016,8,31,2,35,38,73,117
3404-001,2016,8,31,3,27,49,76,73
3404-001,2016,8,31,4,25,32,57,76
3404-001,2016,8,31,5,51,60,111,57
3404-001,2016,8,31,6,125,155,280,111
3404-001,2016,8,31,7,207,507,714,280
3404-001,2016,8,31,8,491,1698,2189,714
3404-001,2016,8,31,9,802,1299,2101,2189
3404-001,2016,8,31,10,555,660,1215,2101
3404-001,2016,8,31,11,617,632,1249,1215
3404-001,2016,8,31,12,605,507,1112,1249
3404-001,2016,8,31,13,467,502,969,1112
3404-001,2016,8,31,14,541,472,1013,969
3404-001,2016,8,31,15,719,514,1233,1013
3404-001,2016,8,31,16,679,507,1186,1233
3404-001,2016,8,31,17,753,503,1256,1186
3404-001,2016,8,31,18,1464,487,1951,1256
3404-001,2016,8,31,19,1216,469,1685,1951
3404-001,2016,8,31,20,763,379,1142,1685
3404-001,2016,8,31,21,581,199,780,1142
3404-001,2016,8,31,22,363,158,521,780
3404-001,2016,8,31,23,179,132,311,521
3404-001,2016,8,31,24,79,81,160,311
3404-001,2016,9,1,1,49,76,125,160
3404-001,2016,9,1,2,23,48,71,125
3404-001,2016,9,1,3,29,43,72,71
3404-001,2016,9,1,4,27,45,72,72
3404-001,2016,9,1,5,53,49,102,72
3404-001,2016,9,1,6,91,199,290,102
3404-001,2016,9,1,7,245,687,932,290
3404-001,2016,9,1,8,501,1960,2461,932
3404-001,2016,9,1,9,874,1372,2246,2461
3404-001,2016,9,1,10,633,772,1405,2246
3404-001,2016,9,1,11,767,855,1622,1405
3404-001,2016,9,1,12,669,778,1447,1622
3404-001,2016,9,1,13,669,747,1416,1447
3404-001,2016,9,1,14,633,762,1395,1416
3404-001,2016,9,1,15,1168,817,1985,1395
3404-001,2016,9,1,16,1389,839,2228,1985
3404-001,2016,9,1,17,1200,625,1825,2228
3404-001,2016,9,1,18,1226,586,1812,1825
3404-001,2016,9,1,19,1236,542,1778,1812
3404-001,2016,9,1,20,834,452,1286,1778
3404-001,2016,9,1,21,699,260,959,1286
3404-001,2016,9,1,22,381,161,542,959
3404-001,2016,9,1,23,195,144,339,542
3404-001,2016,9,1,24,65,114,179,339
3404-001,2016,9,2,1,63,84,147,179
3404-001,2016,9,2,2,39,46,85,147
3404-001,2016,9,2,3,31,41,72,85
3404-001,2016,9,2,4,31,40,71,72
3404-001,2016,9,2,5,37,48,85,71
3404-001,2016,9,2,6,95,218,313,85
3404-001,2016,9,2,7,215,643,858,313
3404-001,2016,9,2,8,497,1980,2477,858
3404-001,2016,9,2,9,806,1359,2165,2477
3404-001,2016,9,2,10,653,797,1450,2165
3404-001,2016,9,2,11,872,876,1748,1450
3404-001,2016,9,2,12,842,844,1686,1748
3404-001,2016,9,2,13,709,654,1363,1686
3404-001,2016,9,2,14,713,786,1499,1363
3404-001,2016,9,2,15,898,766,1664,1499
3404-001,2016,9,2,16,1052,762,1814,1664
3404-001,2016,9,2,17,1194,627,1821,1814
3404-001,2016,9,2,18,1593,666,2259,1821
3404-001,2016,9,2,19,1306,660,1966,2259
3404-001,2016,9,2,20,850,437,1287,1966
3404-001,2016,9,2,21,721,306,1027,1287
3404-001,2016,9,2,22,413,240,653,1027
3404-001,2016,9,2,23,201,131,332,653
3404-001,2016,9,2,24,93,106,199,332
3404-001,2016,9,3,1,77,70,147,199
3404-001,2016,9,3,2,31,63,94,147
3404-001,2016,9,3,3,11,40,51,94
3404-001,2016,9,3,4,33,40,73,51
3404-001,2016,9,3,5,51,52,103,73
3404-001,2016,9,3,6,99,155,254,103
3404-001,2016,9,3,7,249,426,675,254
3404-001,2016,9,3,8,319,922,1241,675
3404-001,2016,9,3,9,675,784,1459,1241
3404-001,2016,9,3,10,541,644,1185,1459
3404-001,2016,9,3,11,537,718,1255,1185
3404-001,2016,9,3,12,535,712,1247,1255
3404-001,2016,9,3,13,487,772,1259,1247
3404-001,2016,9,3,14,545,712,1257,1259
3404-001,2016,9,3,15,631,658,1289,1257
3404-001,2016,9,3,16,677,618,1295,1289
3404-001,2016,9,3,17,776,515,1291,1295
3404-001,2016,9,3,18,1589,556,2145,1291
3404-001,2016,9,3,19,858,451,1309,2145
3404-001,2016,9,3,20,381,295,676,1309
3404-001,2016,9,3,21,261,257,518,676
3404-001,2016,9,3,22,131,196,327,518
3404-001,2016,9,3,23,85,115,200,327
3404-001,2016,9,3,24,41,97,138,200
3404-001,2016,9,4,1,35,54,89,138
3404-001,2016,9,4,2,29,23,52,89
3404-001,2016,9,4,3,21,38,59,52
3404-001,2016,9,4,4,11,32,43,59
3404-001,2016,9,4,5,25,40,65,43
3404-001,2016,9,4,6,45,98,143,65
3404-001,2016,9,4,7,81,216,297,143
3404-001,2016,9,4,8,213,298,511,297
3404-001,2016,9,4,9,215,318,533,511
3404-001,2016,9,4,10,239,290,529,533
3404-001,2016,9,4,11,263,317,580,529
3404-001,2016,9,4,12,267,350,617,580
3404-001,2016,9,4,13,289,380,669,617
3404-001,2016,9,4,14,311,407,718,669
3404-001,2016,9,4,15,573,419,992,718
3404-001,2016,9,4,16,822,385,1207,992
3404-001,2016,9,4,17,1094,361,1455,1207
3404-001,2016,9,4,18,1038,355,1393,1455
3404-001,2016,9,4,19,523,374,897,1393
3404-001,2016,9,4,20,279,312,591,897
3404-001,2016,9,4,21,217,273,490,591
3404-001,2016,9,4,22,135,205,340,490
3404-001,2016,9,4,23,57,161,218,340
3404-001,2016,9,4,24,57,131,188,218
3404-001,2016,9,5,1,45,82,127,188
3404-001,2016,9,5,2,17,51,68,127
3404-001,2016,9,5,3,17,34,51,68
3404-001,2016,9,5,4,13,43,56,51
3404-001,2016,9,5,5,33,65,98,56
3404-001,2016,9,5,6,123,244,367,98
3404-001,2016,9,5,7,261,879,1140,367
3404-001,2016,9,5,8,637,2238,2875,1140
3404-001,2016,9,5,9,798,1447,2245,2875
3404-001,2016,9,5,10,639,695,1334,2245
3404-001,2016,9,5,11,757,726,1483,1334
3404-001,2016,9,5,12,757,754,1511,1483
3404-001,2016,9,5,13,651,766,1417,1511
3404-001,2016,9,5,14,701,775,1476,1417
3404-001,2016,9,5,15,888,819,1707,1476
3404-001,2016,9,5,16,854,795,1649,1707
3404-001,2016,9,5,17,920,726,1646,1649
3404-001,2016,9,5,18,1403,619,2022,1646
3404-001,2016,9,5,19,1262,529,1791,2022
3404-001,2016,9,5,20,790,451,1241,1791
3404-001,2016,9,5,21,772,270,1042,1241
3404-001,2016,9,5,22,455,197,652,1042
3404-001,2016,9,5,23,173,150,323,652
3404-001,2016,9,5,24,101,78,179,323
3404-001,2016,9,6,1,43,63,106,179
3404-001,2016,9,6,2,45,51,96,106
3404-001,2016,9,6,3,25,29,54,96
3404-001,2016,9,6,4,43,48,91,54
3404-001,2016,9,6,5,61,59,120,91
3404-001,2016,9,6,6,139,232,371,120
3404-001,2016,9,6,7,291,703,994,371
3404-001,2016,9,6,8,625,1975,2600,994
3404-001,2016,9,6,9,830,1538,2368,2600
3404-001,2016,9,6,10,739,786,1525,2368
3404-001,2016,9,6,11,822,762,1584,1525
3404-001,2016,9,6,12,896,742,1638,1584
3404-001,2016,9,6,13,617,692,1309,1638
3404-001,2016,9,6,14,699,704,1403,1309
3404-001,2016,9,6,15,858,706,1564,1403
3404-001,2016,9,6,16,1536,712,2248,1564
3404-001,2016,9,6,17,1967,654,2621,2248
3404-001,2016,9,6,18,2104,594,2698,2621
3404-001,2016,9,6,19,1226,586,1812,2698
3404-001,2016,9,6,20,822,414,1236,1812
3404-001,2016,9,6,21,790,301,1091,1236
3404-001,2016,9,6,22,377,205,582,1091
3404-001,2016,9,6,23,203,150,353,582
3404-001,2016,9,6,24,91,93,184,353
3404-001,2016,9,7,1,49,76,125,184
3404-001,2016,9,7,2,37,54,91,125
3404-001,2016,9,7,3,29,46,75,91
3404-001,2016,9,7,4,43,37,80,75
3404-001,2016,9,7,5,53,67,120,80
3404-001,2016,9,7,6,127,204,331,120
3404-001,2016,9,7,7,253,688,941,331
3404-001,2016,9,7,8,605,1970,2575,941
3404-001,2016,9,7,9,874,1398,2272,2575
3404-001,2016,9,7,10,721,720,1441,2272
3404-001,2016,9,7,11,786,751,1537,1441
3404-001,2016,9,7,12,735,714,1449,1537
3404-001,2016,9,7,13,643,651,1294,1449
3404-001,2016,9,7,14,649,833,1482,1294
3404-001,2016,9,7,15,866,917,1783,1482
3404-001,2016,9,7,16,942,827,1769,1783
3404-001,2016,9,7,17,976,627,1603,1769
3404-001,2016,9,7,18,1688,591,2279,1603
3404-001,2016,9,7,19,1458,545,2003,2279
3404-001,2016,9,7,20,826,402,1228,2003
3404-001,2016,9,7,21,623,235,858,1228
3404-001,2016,9,7,22,367,243,610,858
3404-001,2016,9,7,23,193,150,343,610
3404-001,2016,9,7,24,117,108,225,343
3404-001,2016,9,8,1,79,79,158,225
3404-001,2016,9,8,2,41,51,92,158
3404-001,2016,9,8,3,41,40,81,92
3404-001,2016,9,8,4,35,35,70,81
3404-001,2016,9,8,5,45,71,116,70
3404-001,2016,9,8,6,155,213,368,116
3404-001,2016,9,8,7,245,681,926,368
3404-001,2016,9,8,8,685,2041,2726,926
3404-001,2016,9,8,9,922,1502,2424,2726
3404-001,2016,9,8,10,838,888,1726,2424
3404-001,2016,9,8,11,830,869,1699,1726
3404-001,2016,9,8,12,796,822,1618,1699
3404-001,2016,9,8,13,707,740,1447,1618
3404-001,2016,9,8,14,605,810,1415,1447
3404-001,2016,9,8,15,890,710,1600,1415
3404-001,2016,9,8,16,1040,699,1739,1600
3404-001,2016,9,8,17,1018,714,1732,1739
3404-001,2016,9,8,18,1521,657,2178,1732
3404-001,2016,9,8,19,1412,545,1957,2178
3404-001,2016,9,8,20,906,413,1319,1957
3404-001,2016,9,8,21,745,273,1018,1319
3404-001,2016,9,8,22,425,240,665,1018
3404-001,2016,9,8,23,215,185,400,665
3404-001,2016,9,8,24,115,125,240,400
3404-001,2016,9,9,1,51,84,135,240
3404-001,2016,9,9,2,47,48,95,135
3404-001,2016,9,9,3,35,57,92,95
3404-001,2016,9,9,4,25,49,74,92
3404-001,2016,9,9,5,51,70,121,74
3404-001,2016,9,9,6,157,232,389,121
3404-001,2016,9,9,7,269,723,992,389
3404-001,2016,9,9,8,498,2043,2541,992
3404-001,2016,9,9,9,805,1468,2273,2541
3404-001,2016,9,9,10,636,863,1499,2273
3404-001,2016,9,9,11,770,792,1562,1499
3404-001,2016,9,9,12,766,863,1629,1562
3404-001,2016,9,9,13,699,750,1449,1629
3404-001,2016,9,9,14,769,827,1596,1449
3404-001,2016,9,9,15,1052,945,1997,1596
3404-001,2016,9,9,16,1138,907,2045,1997
3404-001,2016,9,9,17,1108,816,1924,2045
3404-001,2016,9,9,18,1713,679,2392,1924
3404-001,2016,9,9,19,1601,651,2252,2392
3404-001,2016,9,9,20,944,537,1481,2252
3404-001,2016,9,9,21,727,355,1082,1481
3404-001,2016,9,9,22,471,298,769,1082
3404-001,2016,9,9,23,209,180,389,769
3404-001,2016,9,9,24,113,125,238,389
3404-001,2016,9,10,1,81,79,160,238
3404-001,2016,9,10,2,51,54,105,160
3404-001,2016,9,10,3,31,38,69,105
3404-001,2016,9,10,4,49,40,89,69
3404-001,2016,9,10,5,49,67,116,89
3404-001,2016,9,10,6,99,193,292,116
3404-001,2016,9,10,7,237,509,746,292
3404-001,2016,9,10,8,425,992,1417,746
3404-001,2016,9,10,9,697,817,1514,1417
3404-001,2016,9,10,10,589,671,1260,1514
3404-001,2016,9,10,11,623,671,1294,1260
3404-001,2016,9,10,12,615,616,1231,1294
3404-001,2016,9,10,13,565,551,1116,1231
3404-001,2016,9,10,14,595,578,1173,1116
3404-001,2016,9,10,15,685,534,1219,1173
3404-001,2016,9,10,16,703,621,1324,1219
3404-001,2016,9,10,17,741,452,1193,1324
3404-001,2016,9,10,18,1109,482,1591,1193
3404-001,2016,9,10,19,657,457,1114,1591
3404-001,2016,9,10,20,311,331,642,1114
3404-001,2016,9,10,21,295,218,513,642
3404-001,2016,9,10,22,165,194,359,513
3404-001,2016,9,10,23,105,119,224,359
3404-001,2016,9,10,24,57,82,139,224
3404-001,2016,9,11,1,35,73,108,139
3404-001,2016,9,11,2,25,46,71,108
3404-001,2016,9,11,3,15,41,56,71
3404-001,2016,9,11,4,25,45,70,56
3404-001,2016,9,11,5,19,30,49,70
3404-001,2016,9,11,6,47,93,140,49
3404-001,2016,9,11,7,93,237,330,140
3404-001,2016,9,11,8,151,426,577,330
3404-001,2016,9,11,9,249,323,572,577
3404-001,2016,9,11,10,251,265,516,572
3404-001,2016,9,11,11,231,312,543,516
3404-001,2016,9,11,12,237,377,614,543
3404-001,2016,9,11,13,267,396,663,614
3404-001,2016,9,11,14,255,377,632,663
3404-001,2016,9,11,15,289,358,647,632
3404-001,2016,9,11,16,405,366,771,647
3404-001,2016,9,11,17,425,364,789,771
3404-001,2016,9,11,18,639,315,954,789
3404-001,2016,9,11,19,309,300,609,954
3404-001,2016,9,11,20,283,285,568,609
3404-001,2016,9,11,21,241,202,443,568
3404-001,2016,9,11,22,135,171,306,443
3404-001,2016,9,11,23,69,128,197,306
3404-001,2016,9,11,24,35,90,125,197
3404-001,2016,9,12,1,15,71,86,125
3404-001,2016,9,12,2,35,56,91,86
3404-001,2016,9,12,3,9,41,50,91
3404-001,2016,9,12,4,9,43,52,50
3404-001,2016,9,12,5,33,60,93,52
3404-001,2016,9,12,6,103,260,363,93
3404-001,2016,9,12,7,285,717,1002,363
3404-001,2016,9,12,8,541,2178,2719,1002
3404-001,2016,9,12,9,834,1455,2289,2719
3404-001,2016,9,12,10,679,791,1470,2289
3404-001,2016,9,12,11,715,759,1474,1470
3404-001,2016,9,12,12,794,871,1665,1474
3404-001,2016,9,12,13,677,750,1427,1665
3404-001,2016,9,12,14,757,849,1606,1427
3404-001,2016,9,12,15,950,924,1874,1606
3404-001,2016,9,12,16,910,858,1768,1874
3404-001,2016,9,12,17,1136,740,1876,1768
3404-001,2016,9,12,18,1466,643,2109,1876
3404-001,2016,9,12,19,1424,592,2016,2109
3404-001,2016,9,12,20,830,421,1251,2016
3404-001,2016,9,12,21,709,285,994,1251
3404-001,2016,9,12,22,381,222,603,994
3404-001,2016,9,12,23,197,175,372,603
3404-001,2016,9,12,24,105,101,206,372
3404-001,2016,9,13,1,79,79,158,206
3404-001,2016,9,13,2,39,62,101,158
3404-001,2016,9,13,3,31,43,74,101
3404-001,2016,9,13,4,35,40,75,74
3404-001,2016,9,13,5,43,59,102,75
3404-001,2016,9,13,6,113,202,315,102
3404-001,2016,9,13,7,235,479,714,315
3404-001,2016,9,13,8,505,1795,2300,714
3404-001,2016,9,13,9,703,1255,1958,2300
3404-001,2016,9,13,10,661,673,1334,1958
3404-001,2016,9,13,11,679,743,1422,1334
3404-001,2016,9,13,12,697,718,1415,1422
3404-001,2016,9,13,13,743,607,1350,1415
3404-001,2016,9,13,14,757,622,1379,1350
3404-001,2016,9,13,15,800,717,1517,1379
3404-001,2016,9,13,16,1016,690,1706,1517
3404-001,2016,9,13,17,974,764,1738,1706
3404-001,2016,9,13,18,1166,643,1809,1738
3404-001,2016,9,13,19,892,614,1506,1809
3404-001,2016,9,13,20,459,550,1009,1506
3404-001,2016,9,13,21,271,397,668,1009
3404-001,2016,9,13,22,177,364,541,668
3404-001,2016,9,13,23,89,216,305,541
3404-001,2016,9,13,24,57,108,165,305
3404-001,2016,9,14,1,47,104,151,165
3404-001,2016,9,14,2,37,76,113,151
3404-001,2016,9,14,3,31,49,80,113
3404-001,2016,9,14,4,27,60,87,80
3404-001,2016,9,14,5,31,76,107,87
3404-001,2016,9,14,6,89,95,184,107
3404-001,2016,9,14,7,143,156,299,184
3404-001,2016,9,14,8,113,459,572,299
3404-001,2016,9,14,9,209,594,803,572
3404-001,2016,9,14,10,203,913,1116,803
3404-001,2016,9,14,11,243,891,1134,1116
3404-001,2016,9,14,12,201,974,1175,1134
3404-001,2016,9,14,13,209,718,927,1175
3404-001,2016,9,14,14,163,849,1012,927
3404-001,2016,9,14,15,205,619,824,1012
3404-001,2016,9,14,16,119,501,620,824
3404-001,2016,9,14,17,177,353,530,620
3404-001,2016,9,14,18,175,227,402,530
3404-001,2016,9,14,19,161,219,380,402
3404-001,2016,9,14,20,101,163,264,380
3404-001,2016,9,14,21,71,134,205,264
3404-001,2016,9,14,22,65,90,155,205
3404-001,2016,9,14,23,23,63,86,155
3404-001,2016,9,14,24,25,56,81,86
3404-001,2016,9,15,1,17,32,49,81
3404-001,2016,9,15,2,13,26,39,49
3404-001,2016,9,15,3,7,15,22,39
3404-001,2016,9,15,4,7,15,22,22
3404-001,2016,9,15,5,11,16,27,22
3404-001,2016,9,15,6,21,38,59,27
3404-001,2016,9,15,7,55,103,158,59
3404-001,2016,9,15,8,99,235,334,158
3404-001,2016,9,15,9,95,150,245,334
3404-001,2016,9,15,10,129,240,369,245
3404-001,2016,9,15,11,257,374,631,369
3404-001,2016,9,15,12,347,493,840,631
3404-001,2016,9,15,13,838,551,1389,840
3404-001,2016,9,15,14,946,596,1542,1389
3404-001,2016,9,15,15,790,775,1565,1542
3404-001,2016,9,15,16,553,823,1376,1565
3404-001,2016,9,15,17,617,569,1186,1376
3404-001,2016,9,15,18,703,715,1418,1186
3404-001,2016,9,15,19,563,520,1083,1418
3404-001,2016,9,15,20,387,268,655,1083
3404-001,2016,9,15,21,377,199,576,655
3404-001,2016,9,15,22,223,123,346,576
3404-001,2016,9,15,23,101,95,196,346
3404-001,2016,9,15,24,67,62,129,196
3404-001,2016,9,16,1,15,48,63,129
3404-001,2016,9,16,2,25,41,66,63
3404-001,2016,9,16,3,5,29,34,66
3404-001,2016,9,16,4,3,23,26,34
3404-001,2016,9,16,5,15,27,42,26
3404-001,2016,9,16,6,23,48,71,42
3404-001,2016,9,16,7,27,73,100,71
3404-001,2016,9,16,8,47,103,150,100
3404-001,2016,9,16,9,81,172,253,150
3404-001,2016,9,16,10,121,205,326,253
3404-001,2016,9,16,11,197,333,530,326
3404-001,2016,9,16,12,301,331,632,530
3404-001,2016,9,16,13,477,352,829,632
3404-001,2016,9,16,14,411,287,698,829
3404-001,2016,9,16,15,677,307,984,698
3404-001,2016,9,16,16,581,298,879,984
3404-001,2016,9,16,17,858,246,1104,879
3404-001,2016,9,16,18,843,284,1127,1104
3404-001,2016,9,16,19,537,219,756,1127
3404-001,2016,9,16,20,838,178,1016,756
3404-001,2016,9,16,21,603,188,791,1016
3404-001,2016,9,16,22,427,125,552,791
3404-001,2016,9,16,23,241,89,330,552
3404-001,2016,9,16,24,413,93,506,330
3404-001,2016,9,17,1,37,65,102,506
3404-001,2016,9,17,2,81,49,130,102
3404-001,2016,9,17,3,15,45,60,130
3404-001,2016,9,17,4,9,37,46,60
3404-001,2016,9,17,5,21,35,56,46
3404-001,2016,9,17,6,23,51,74,56
3404-001,2016,9,17,7,21,84,105,74
3404-001,2016,9,17,8,75,182,257,105
3404-001,2016,9,17,9,217,226,443,257
3404-001,2016,9,17,10,173,216,389,443
3404-001,2016,9,17,11,295,211,506,389
3404-001,2016,9,17,12,449,237,686,506
3404-001,2016,9,17,13,581,295,876,686
3404-001,2016,9,17,14,447,293,740,876
3404-001,2016,9,17,15,715,300,1015,740
3404-001,2016,9,17,16,593,307,900,1015
3404-001,2016,9,17,17,713,251,964,900
3404-001,2016,9,17,18,347,270,617,964
3404-001,2016,9,17,19,407,263,670,617
3404-001,2016,9,17,20,197,196,393,670
3404-001,2016,9,17,21,157,163,320,393
3404-001,2016,9,17,22,111,172,283,320
3404-001,2016,9,17,23,59,97,156,283
3404-001,2016,9,17,24,41,71,112,156
3404-001,2016,9,18,1,41,56,97,112
3404-001,2016,9,18,2,33,26,59,97
3404-001,2016,9,18,3,19,27,46,59
3404-001,2016,9,18,4,7,27,34,46
3404-001,2016,9,18,5,25,32,57,34
3404-001,2016,9,18,6,15,59,74,57
3404-001,2016,9,18,7,23,134,157,74
3404-001,2016,9,18,8,81,222,303,157
3404-001,2016,9,18,9,183,243,426,303
3404-001,2016,9,18,10,125,254,379,426
3404-001,2016,9,18,11,165,276,441,379
3404-001,2016,9,18,12,181,322,503,441
3404-001,2016,9,18,13,155,326,481,503
3404-001,2016,9,18,14,233,301,534,481
3404-001,2016,9,18,15,303,370,673,534
3404-001,2016,9,18,16,309,362,671,673
3404-001,2016,9,18,17,357,320,677,671
3404-001,2016,9,18,18,387,290,677,677
3404-001,2016,9,18,19,307,303,610,677
3404-001,2016,9,18,20,159,252,411,610
3404-001,2016,9,18,21,149,213,362,411
3404-001,2016,9,18,22,87,218,305,362
3404-001,2016,9,18,23,39,178,217,305
3404-001,2016,9,18,24,31,125,156,217
3404-001,2016,9,19,1,21,84,105,156
3404-001,2016,9,19,2,19,49,68,105
3404-001,2016,9,19,3,17,41,58,68
3404-001,2016,9,19,4,5,37,42,58
3404-001,2016,9,19,5,25,54,79,42
3404-001,2016,9,19,6,117,233,350,79
3404-001,2016,9,19,7,213,817,1030,350
3404-001,2016,9,19,8,495,2209,2704,1030
3404-001,2016,9,19,9,691,1535,2226,2704
3404-001,2016,9,19,10,661,736,1397,2226
3404-001,2016,9,19,11,613,734,1347,1397
3404-001,2016,9,19,12,653,791,1444,1347
3404-001,2016,9,19,13,537,662,1199,1444
3404-001,2016,9,19,14,501,707,1208,1199
3404-001,2016,9,19,15,663,748,1411,1208
3404-001,2016,9,19,16,830,635,1465,1411
3404-001,2016,9,19,17,749,572,1321,1465
3404-001,2016,9,19,18,1297,515,1812,1321
3404-001,2016,9,19,19,1254,496,1750,1812
3404-001,2016,9,19,20,794,405,1199,1750
3404-001,2016,9,19,21,647,267,914,1199
3404-001,2016,9,19,22,387,211,598,914
3404-001,2016,9,19,23,155,141,296,598
3404-001,2016,9,19,24,83,101,184,296
3404-001,2016,9,20,1,39,82,121,184
3404-001,2016,9,20,2,35,65,100,121
3404-001,2016,9,20,3,25,41,66,100
3404-001,2016,9,20,4,29,41,70,66
3404-001,2016,9,20,5,43,78,121,70
3404-001,2016,9,20,6,145,219,364,121
3404-001,2016,9,20,7,263,636,899,364
3404-001,2016,9,20,8,579,2098,2677,899
3404-001,2016,9,20,9,800,1649,2449,2677
3404-001,2016,9,20,10,669,762,1431,2449
3404-001,2016,9,20,11,717,778,1495,1431
3404-001,2016,9,20,12,816,750,1566,1495
3404-001,2016,9,20,13,553,764,1317,1566
3404-001,2016,9,20,14,711,855,1566,1317
3404-001,2016,9,20,15,946,950,1896,1566
3404-001,2016,9,20,16,898,789,1687,1896
3404-001,2016,9,20,17,950,630,1580,1687
3404-001,2016,9,20,18,1288,633,1921,1580
3404-001,2016,9,20,19,1192,547,1739,1921
3404-001,2016,9,20,20,856,403,1259,1739
3404-001,2016,9,20,21,850,256,1106,1259
3404-001,2016,9,20,22,433,215,648,1106
3404-001,2016,9,20,23,193,123,316,648
3404-001,2016,9,20,24,73,104,177,316
3404-001,2016,9,21,1,49,67,116,177
3404-001,2016,9,21,2,47,57,104,116
3404-001,2016,9,21,3,35,46,81,104
3404-001,2016,9,21,4,23,49,72,81
3404-001,2016,9,21,5,47,49,96,72
3404-001,2016,9,21,6,105,213,318,96
3404-001,2016,9,21,7,231,641,872,318
3404-001,2016,9,21,8,537,2111,2648,872
3404-001,2016,9,21,9,749,1543,2292,2648
3404-001,2016,9,21,10,663,748,1411,2292
3404-001,2016,9,21,11,701,769,1470,1411
3404-001,2016,9,21,12,836,707,1543,1470
3404-001,2016,9,21,13,625,599,1224,1543
3404-001,2016,9,21,14,639,806,1445,1224
3404-001,2016,9,21,15,898,773,1671,1445
3404-001,2016,9,21,16,818,703,1521,1671
3404-001,2016,9,21,17,1002,660,1662,1521
3404-001,2016,9,21,18,1468,646,2114,1662
3404-001,2016,9,21,19,1513,572,2085,2114
3404-001,2016,9,21,20,753,407,1160,2085
3404-001,2016,9,21,21,619,241,860,1160
3404-001,2016,9,21,22,335,199,534,860
3404-001,2016,9,21,23,177,141,318,534
3404-001,2016,9,21,24,83,109,192,318
3404-001,2016,9,22,1,59,60,119,192
3404-001,2016,9,22,2,55,45,100,119
3404-001,2016,9,22,3,19,49,68,100
3404-001,2016,9,22,4,25,52,77,68
3404-001,2016,9,22,5,51,63,114,77
3404-001,2016,9,22,6,123,197,320,114
3404-001,2016,9,22,7,259,684,943,320
3404-001,2016,9,22,8,511,2182,2693,943
3404-001,2016,9,22,9,820,1575,2395,2693
3404-001,2016,9,22,10,864,813,1677,2395
3404-001,2016,9,22,11,856,788,1644,1677
3404-001,2016,9,22,12,838,754,1592,1644
3404-001,2016,9,22,13,631,747,1378,1592
3404-001,2016,9,22,14,665,851,1516,1378
3404-001,2016,9,22,15,886,817,1703,1516
3404-001,2016,9,22,16,952,803,1755,1703
3404-001,2016,9,22,17,1046,635,1681,1755
3404-001,2016,9,22,18,1366,611,1977,1681
3404-001,2016,9,22,19,1352,518,1870,1977
3404-001,2016,9,22,20,836,410,1246,1870
3404-001,2016,9,22,21,709,296,1005,1246
3404-001,2016,9,22,22,353,241,594,1005
3404-001,2016,9,22,23,193,136,329,594
3404-001,2016,9,22,24,89,119,208,329
3404-001,2016,9,23,1,53,87,140,208
3404-001,2016,9,23,2,27,67,94,140
3404-001,2016,9,23,3,49,45,94,94
3404-001,2016,9,23,4,39,73,112,94
3404-001,2016,9,23,5,27,67,94,112
3404-001,2016,9,23,6,117,249,366,94
3404-001,2016,9,23,7,201,710,911,366
3404-001,2016,9,23,8,579,2176,2755,911
3404-001,2016,9,23,9,888,1408,2296,2755
3404-001,2016,9,23,10,723,841,1564,2296
3404-001,2016,9,23,11,790,742,1532,1564
3404-001,2016,9,23,12,719,817,1536,1532
3404-001,2016,9,23,13,798,756,1554,1536
3404-001,2016,9,23,14,679,849,1528,1554
3404-001,2016,9,23,15,1000,967,1967,1528
3404-001,2016,9,23,16,932,869,1801,1967
3404-001,2016,9,23,17,1052,731,1783,1801
3404-001,2016,9,23,18,1632,652,2284,1783
3404-001,2016,9,23,19,1543,619,2162,2284
3404-001,2016,9,23,20,970,528,1498,2162
3404-001,2016,9,23,21,683,334,1017,1498
3404-001,2016,9,23,22,327,230,557,1017
3404-001,2016,9,23,23,157,139,296,557
3404-001,2016,9,23,24,79,115,194,296
3404-001,2016,9,24,1,79,84,163,194
3404-001,2016,9,24,2,43,52,95,163
3404-001,2016,9,24,3,39,60,99,95
3404-001,2016,9,24,4,29,48,77,99
3404-001,2016,9,24,5,55,59,114,77
3404-001,2016,9,24,6,105,164,269,114
3404-001,2016,9,24,7,191,426,617,269
3404-001,2016,9,24,8,345,876,1221,617
3404-001,2016,9,24,9,535,797,1332,1221
3404-001,2016,9,24,10,519,655,1174,1332
3404-001,2016,9,24,11,539,665,1204,1174
3404-001,2016,9,24,12,561,739,1300,1204
3404-001,2016,9,24,13,453,644,1097,1300
3404-001,2016,9,24,14,543,638,1181,1097
3404-001,2016,9,24,15,625,665,1290,1181
3404-001,2016,9,24,16,731,596,1327,1290
3404-001,2016,9,24,17,709,518,1227,1327
3404-001,2016,9,24,18,1098,501,1599,1227
3404-001,2016,9,24,19,719,419,1138,1599
3404-001,2016,9,24,20,373,322,695,1138
3404-001,2016,9,24,21,233,233,466,695
3404-001,2016,9,24,22,139,221,360,466
3404-001,2016,9,24,23,85,120,205,360
3404-001,2016,9,24,24,51,106,157,205
3404-001,2016,9,25,1,31,62,93,157
3404-001,2016,9,25,2,25,45,70,93
3404-001,2016,9,25,3,33,51,84,70
3404-001,2016,9,25,4,21,24,45,84
3404-001,2016,9,25,5,31,40,71,45
3404-001,2016,9,25,6,39,67,106,71
3404-001,2016,9,25,7,89,211,300,106
3404-001,2016,9,25,8,137,279,416,300
3404-001,2016,9,25,9,207,337,544,416
3404-001,2016,9,25,10,187,285,472,544
3404-001,2016,9,25,11,251,312,563,472
3404-001,2016,9,25,12,207,383,590,563
3404-001,2016,9,25,13,259,356,615,590
3404-001,2016,9,25,14,267,405,672,615
3404-001,2016,9,25,15,375,419,794,672
3404-001,2016,9,25,16,415,377,792,794
3404-001,2016,9,25,17,571,359,930,792
3404-001,2016,9,25,18,696,372,1068,930
3404-001,2016,9,25,19,513,322,835,1068
3404-001,2016,9,25,20,293,268,561,835
3404-001,2016,9,25,21,249,260,509,561
3404-001,2016,9,25,22,143,210,353,509
3404-001,2016,9,25,23,63,171,234,353
3404-001,2016,9,25,24,41,123,164,234
3404-001,2016,9,26,1,27,76,103,164
3404-001,2016,9,26,2,29,67,96,103
3404-001,2016,9,26,3,23,35,58,96
3404-001,2016,9,26,4,31,45,76,58
3404-001,2016,9,26,5,31,71,102,76
3404-001,2016,9,26,6,89,205,294,102
3404-001,2016,9,26,7,227,772,999,294
3404-001,2016,9,26,8,569,2256,2825,999
3404-001,2016,9,26,9,759,1660,2419,2825
3404-001,2016,9,26,10,657,786,1443,2419
3404-001,2016,9,26,11,695,677,1372,1443
3404-001,2016,9,26,12,721,600,1321,1372
3404-001,2016,9,26,13,581,577,1158,1321
3404-001,2016,9,26,14,601,679,1280,1158
3404-001,2016,9,26,15,810,698,1508,1280
3404-001,2016,9,26,16,892,726,1618,1508
3404-001,2016,9,26,17,940,575,1515,1618
3404-001,2016,9,26,18,1453,548,2001,1515
3404-001,2016,9,26,19,1358,537,1895,2001
3404-001,2016,9,26,20,884,374,1258,1895
3404-001,2016,9,26,21,769,274,1043,1258
3404-001,2016,9,26,22,375,226,601,1043
3404-001,2016,9,26,23,207,133,340,601
3404-001,2016,9,26,24,93,97,190,340
3404-001,2016,9,27,1,55,57,112,190
3404-001,2016,9,27,2,43,57,100,112
3404-001,2016,9,27,3,27,57,84,100
3404-001,2016,9,27,4,39,51,90,84
3404-001,2016,9,27,5,53,46,99,90
3404-001,2016,9,27,6,129,207,336,99
3404-001,2016,9,27,7,227,544,771,336
3404-001,2016,9,27,8,487,2016,2503,771
3404-001,2016,9,27,9,864,1581,2445,2503
3404-001,2016,9,27,10,763,808,1571,2445
3404-001,2016,9,27,11,757,740,1497,1571
3404-001,2016,9,27,12,697,633,1330,1497
3404-001,2016,9,27,13,547,611,1158,1330
3404-001,2016,9,27,14,607,619,1226,1158
3404-001,2016,9,27,15,753,687,1440,1226
3404-001,2016,9,27,16,826,597,1423,1440
3404-001,2016,9,27,17,846,635,1481,1423
3404-001,2016,9,27,18,1174,567,1741,1481
3404-001,2016,9,27,19,1152,440,1592,1741
3404-001,2016,9,27,20,786,370,1156,1592
3404-001,2016,9,27,21,703,251,954,1156
3404-001,2016,9,27,22,335,196,531,954
3404-001,2016,9,27,23,137,125,262,531
3404-001,2016,9,27,24,101,108,209,262
3404-001,2016,9,28,1,69,60,129,209
3404-001,2016,9,28,2,49,57,106,129
3404-001,2016,9,28,3,37,49,86,106
3404-001,2016,9,28,4,39,34,73,86
3404-001,2016,9,28,5,39,45,84,73
3404-001,2016,9,28,6,115,216,331,84
3404-001,2016,9,28,7,235,710,945,331
3404-001,2016,9,28,8,553,1946,2499,945
3404-001,2016,9,28,9,834,1556,2390,2499
3404-001,2016,9,28,10,665,688,1353,2390
3404-001,2016,9,28,11,735,725,1460,1353
3404-001,2016,9,28,12,699,681,1380,1460
3404-001,2016,9,28,13,573,564,1137,1380
3404-001,2016,9,28,14,591,714,1305,1137
3404-001,2016,9,28,15,790,690,1480,1305
3404-001,2016,9,28,16,808,660,1468,1480
3404-001,2016,9,28,17,932,627,1559,1468
3404-001,2016,9,28,18,1433,616,2049,1559
3404-001,2016,9,28,19,1382,481,1863,2049
3404-001,2016,9,28,20,852,369,1221,1863
3404-001,2016,9,28,21,623,254,877,1221
3404-001,2016,9,28,22,327,202,529,877
3404-001,2016,9,28,23,181,158,339,529
3404-001,2016,9,28,24,107,108,215,339
3404-001,2016,9,29,1,67,68,135,215
3404-001,2016,9,29,2,65,54,119,135
3404-001,2016,9,29,3,35,56,91,119
3404-001,2016,9,29,4,25,57,82,91
3404-001,2016,9,29,5,55,49,104,82
3404-001,2016,9,29,6,91,191,282,104
3404-001,2016,9,29,7,241,647,888,282
3404-001,2016,9,29,8,531,2039,2570,888
3404-001,2016,9,29,9,902,1622,2524,2570
3404-001,2016,9,29,10,761,816,1577,2524
3404-001,2016,9,29,11,802,836,1638,1577
3404-001,2016,9,29,12,866,740,1606,1638
3404-001,2016,9,29,13,681,584,1265,1606
3404-001,2016,9,29,14,687,698,1385,1265
3404-001,2016,9,29,15,964,753,1717,1385
3404-001,2016,9,29,16,870,688,1558,1717
3404-001,2016,9,29,17,942,679,1621,1558
3404-001,2016,9,29,18,1336,647,1983,1621
3404-001,2016,9,29,19,1264,550,1814,1983
3404-001,2016,9,29,20,848,345,1193,1814
3404-001,2016,9,29,21,675,276,951,1193
3404-001,2016,9,29,22,445,260,705,951
3404-001,2016,9,29,23,209,150,359,705
3404-001,2016,9,29,24,93,95,188,359
3404-001,2016,9,30,1,71,59,130,188
3404-001,2016,9,30,2,53,46,99,130
3404-001,2016,9,30,3,37,57,94,99
3404-001,2016,9,30,4,43,43,86,94
3404-001,2016,9,30,5,41,54,95,86
3404-001,2016,9,30,6,135,216,351,95
3404-001,2016,9,30,7,247,652,899,351
3404-001,2016,9,30,8,545,1982,2527,899
3404-001,2016,9,30,9,810,1554,2364,2527
3404-001,2016,9,30,10,701,795,1496,2364
3404-001,2016,9,30,11,713,676,1389,1496
3404-001,2016,9,30,12,755,714,1469,1389
3404-001,2016,9,30,13,641,580,1221,1469
3404-001,2016,9,30,14,709,668,1377,1221
3404-001,2016,9,30,15,986,676,1662,1377
3404-001,2016,9,30,16,998,693,1691,1662
3404-001,2016,9,30,17,1012,682,1694,1691
3404-001,2016,9,30,18,1672,669,2341,1694
3404-001,2016,9,30,19,1621,641,2262,2341
3404-001,2016,9,30,20,994,481,1475,2262
3404-001,2016,9,30,21,649,300,949,1475
3404-001,2016,9,30,22,309,243,552,949
3404-001,2016,9,30,23,213,144,357,552
3404-001,2016,9,30,24,71,109,180,357
3404-001,2016,10,1,1,49,85,134,180
3404-001,2016,10,1,2,43,52,95,134
3404-001,2016,10,1,3,21,46,67,95
3404-001,2016,10,1,4,23,33,56,67
3404-001,2016,10,1,5,51,51,102,56
3404-001,2016,10,1,6,101,116,217,102
3404-001,2016,10,1,7,136,325,461,217
3404-001,2016,10,1,8,298,673,971,461
3404-001,2016,10,1,9,481,670,1151,971
3404-001,2016,10,1,10,451,557,1008,1151
3404-001,2016,10,1,11,473,585,1058,1008
3404-001,2016,10,1,12,462,670,1132,1058
3404-001,2016,10,1,13,488,597,1085,1132
3404-001,2016,10,1,14,426,641,1067,1085
3404-001,2016,10,1,15,421,644,1065,1067
3404-001,2016,10,1,16,468,556,1024,1065
3404-001,2016,10,1,17,536,614,1150,1024
3404-001,2016,10,1,18,786,464,1250,1150
3404-001,2016,10,1,19,666,408,1074,1250
3404-001,2016,10,1,20,372,303,675,1074
3404-001,2016,10,1,21,178,170,348,675
3404-001,2016,10,1,22,142,144,286,348
3404-001,2016,10,1,23,71,104,175,286
3404-001,2016,10,1,24,51,58,109,175
3404-001,2016,10,2,1,29,42,71,109
3404-001,2016,10,2,2,21,31,52,71
3404-001,2016,10,2,3,10,12,22,52
3404-001,2016,10,2,4,12,18,30,22
3404-001,2016,10,2,5,15,18,33,30
3404-001,2016,10,2,6,27,42,69,33
3404-001,2016,10,2,7,43,112,155,69
3404-001,2016,10,2,8,84,189,273,155
3404-001,2016,10,2,9,126,192,318,273
3404-001,2016,10,2,10,130,214,344,318
3404-001,2016,10,2,11,158,273,431,344
3404-001,2016,10,2,12,158,334,492,431
3404-001,2016,10,2,13,224,287,511,492
3404-001,2016,10,2,14,180,315,495,511
3404-001,2016,10,2,15,249,320,569,495
3404-001,2016,10,2,16,278,274,552,569
3404-001,2016,10,2,17,311,266,577,552
3404-001,2016,10,2,18,359,268,627,577
3404-001,2016,10,2,19,367,225,592,627
3404-001,2016,10,2,20,237,173,410,592
3404-001,2016,10,2,21,103,166,269,410
3404-001,2016,10,2,22,71,114,185,269
3404-001,2016,10,2,23,51,107,158,185
3404-001,2016,10,2,24,37,56,93,158
3404-001,2016,10,3,1,15,51,66,93
3404-001,2016,10,3,2,29,23,52,66
3404-001,2016,10,3,3,8,29,37,52
3404-001,2016,10,3,4,8,24,32,37
3404-001,2016,10,3,5,18,21,39,32
3404-001,2016,10,3,6,49,114,163,39
3404-001,2016,10,3,7,67,215,282,163
3404-001,2016,10,3,8,167,467,634,282
3404-001,2016,10,3,9,226,418,644,634
3404-001,2016,10,3,10,252,330,582,644
3404-001,2016,10,3,11,281,360,641,582
3404-001,2016,10,3,12,304,452,756,641
3404-001,2016,10,3,13,289,366,655,756
3404-001,2016,10,3,14,298,450,748,655
3404-001,2016,10,3,15,380,411,791,748
3404-001,2016,10,3,16,484,384,868,791
3404-001,2016,10,3,17,567,334,901,868
3404-001,2016,10,3,18,860,317,1177,901
3404-001,2016,10,3,19,553,330,883,1177
3404-001,2016,10,3,20,256,241,497,883
3404-001,2016,10,3,21,202,222,424,497
3404-001,2016,10,3,22,128,149,277,424
3404-001,2016,10,3,23,68,134,202,277
3404-001,2016,10,3,24,27,80,107,202
3404-001,2016,10,4,1,13,67,80,107
3404-001,2016,10,4,2,12,34,46,80
3404-001,2016,10,4,3,8,26,34,46
3404-001,2016,10,4,4,12,22,34,34
3404-001,2016,10,4,5,45,33,78,34
3404-001,2016,10,4,6,62,176,238,78
3404-001,2016,10,4,7,180,620,800,238
3404-001,2016,10,4,8,482,1732,2214,800
3404-001,2016,10,4,9,602,1275,1877,2214
3404-001,2016,10,4,10,536,601,1137,1877
3404-001,2016,10,4,11,600,641,1241,1137
3404-001,2016,10,4,12,534,650,1184,1241
3404-001,2016,10,4,13,506,587,1093,1184
3404-001,2016,10,4,14,525,615,1140,1093
3404-001,2016,10,4,15,770,738,1508,1140
3404-001,2016,10,4,16,750,669,1419,1508
3404-001,2016,10,4,17,868,531,1399,1419
3404-001,2016,10,4,18,1093,502,1595,1399
3404-001,2016,10,4,19,921,404,1325,1595
3404-001,2016,10,4,20,646,297,943,1325
3404-001,2016,10,4,21,561,227,788,943
3404-001,2016,10,4,22,279,154,433,788
3404-001,2016,10,4,23,158,107,265,433
3404-001,2016,10,4,24,78,60,138,265
3404-001,2016,10,5,1,65,58,123,138
3404-001,2016,10,5,2,32,42,74,123
3404-001,2016,10,5,3,35,34,69,74
3404-001,2016,10,5,4,32,31,63,69
3404-001,2016,10,5,5,29,51,80,63
3404-001,2016,10,5,6,79,144,223,80
3404-001,2016,10,5,7,196,472,668,223
3404-001,2016,10,5,8,405,1553,1958,668
3404-001,2016,10,5,9,641,1203,1844,1958
3404-001,2016,10,5,10,471,587,1058,1844
3404-001,2016,10,5,11,575,601,1176,1058
3404-001,2016,10,5,12,501,577,1078,1176
3404-001,2016,10,5,13,459,501,960,1078
3404-001,2016,10,5,14,526,560,1086,960
3404-001,2016,10,5,15,688,552,1240,1086
3404-001,2016,10,5,16,715,566,1281,1240
3404-001,2016,10,5,17,692,444,1136,1281
3404-001,2016,10,5,18,1184,504,1688,1136
3404-001,2016,10,5,19,970,391,1361,1688
3404-001,2016,10,5,20,693,288,981,1361
3404-001,2016,10,5,21,441,195,636,981
3404-001,2016,10,5,22,279,154,433,636
3404-001,2016,10,5,23,150,99,249,433
3404-001,2016,10,5,24,60,90,150,249
3404-001,2016,10,6,1,45,72,117,150
3404-001,2016,10,6,2,29,44,73,117
3404-001,2016,10,6,3,23,38,61,73
3404-001,2016,10,6,4,27,32,59,61
3404-001,2016,10,6,5,59,39,98,59
3404-001,2016,10,6,6,76,174,250,98
3404-001,2016,10,6,7,218,564,782,250
3404-001,2016,10,6,8,487,1723,2210,782
3404-001,2016,10,6,9,799,1144,1943,2210
3404-001,2016,10,6,10,537,711,1248,1943
3404-001,2016,10,6,11,629,669,1298,1248
3404-001,2016,10,6,12,581,625,1206,1298
3404-001,2016,10,6,13,441,584,1025,1206
3404-001,2016,10,6,14,531,674,1205,1025
3404-001,2016,10,6,15,737,680,1417,1205
3404-001,2016,10,6,16,728,625,1353,1417
3404-001,2016,10,6,17,777,548,1325,1353
3404-001,2016,10,6,18,1167,517,1684,1325
3404-001,2016,10,6,19,1038,429,1467,1684
3404-001,2016,10,6,20,663,316,979,1467
3404-001,2016,10,6,21,588,203,791,979
3404-001,2016,10,6,22,274,153,427,791
3404-001,2016,10,6,23,147,135,282,427
3404-001,2016,10,6,24,78,88,166,282
3404-001,2016,10,7,1,63,57,120,166
3404-001,2016,10,7,2,26,42,68,120
3404-001,2016,10,7,3,27,34,61,68
3404-001,2016,10,7,4,35,26,61,61
3404-001,2016,10,7,5,27,63,90,61
3404-001,2016,10,7,6,93,223,316,90
3404-001,2016,10,7,7,215,609,824,316
3404-001,2016,10,7,8,506,1734,2240,824
3404-001,2016,10,7,9,767,1167,1934,2240
3404-001,2016,10,7,10,547,699,1246,1934
3404-001,2016,10,7,11,636,707,1343,1246
3404-001,2016,10,7,12,651,553,1204,1343
3404-001,2016,10,7,13,536,530,1066,1204
3404-001,2016,10,7,14,555,672,1227,1066
3404-001,2016,10,7,15,729,685,1414,1227
3404-001,2016,10,7,16,827,624,1451,1414
3404-001,2016,10,7,17,954,571,1525,1451
3404-001,2016,10,7,18,1331,594,1925,1525
3404-001,2016,10,7,19,1326,481,1807,1925
3404-001,2016,10,7,20,799,371,1170,1807
3404-001,2016,10,7,21,566,256,822,1170
3404-001,2016,10,7,22,210,197,407,822
3404-001,2016,10,7,23,172,110,282,407
3404-001,2016,10,7,24,76,90,166,282
3404-001,2016,10,8,1,57,50,107,166
3404-001,2016,10,8,2,40,60,100,107
3404-001,2016,10,8,3,52,36,88,100
3404-001,2016,10,8,4,30,58,88,88
3404-001,2016,10,8,5,32,47,79,88
3404-001,2016,10,8,6,71,129,200,79
3404-001,2016,10,8,7,111,271,382,200
3404-001,2016,10,8,8,241,581,822,382
3404-001,2016,10,8,9,452,608,1060,822
3404-001,2016,10,8,10,435,466,901,1060
3404-001,2016,10,8,11,433,517,950,901
3404-001,2016,10,8,12,446,494,940,950
3404-001,2016,10,8,13,358,532,890,940
3404-001,2016,10,8,14,386,556,942,890
3404-001,2016,10,8,15,416,523,939,942
3404-001,2016,10,8,16,534,458,992,939
3404-001,2016,10,8,17,614,409,1023,992
3404-001,2016,10,8,18,973,448,1421,1023
3404-001,2016,10,8,19,681,342,1023,1421
3404-001,2016,10,8,20,265,257,522,1023
3404-001,2016,10,8,21,194,209,403,522
3404-001,2016,10,8,22,131,131,262,403
3404-001,2016,10,8,23,59,102,161,262
3404-001,2016,10,8,24,38,68,106,161
3404-001,2016,10,9,1,26,37,63,106
3404-001,2016,10,9,2,18,46,64,63
3404-001,2016,10,9,3,12,26,38,64
3404-001,2016,10,9,4,19,24,43,38
3404-001,2016,10,9,5,15,31,46,43
3404-001,2016,10,9,6,26,62,88,46
3404-001,2016,10,9,7,63,199,262,88
3404-001,2016,10,9,8,125,266,391,262
3404-001,2016,10,9,9,194,244,438,391
3404-001,2016,10,9,10,208,273,481,438
3404-001,2016,10,9,11,270,341,611,481
3404-001,2016,10,9,12,238,380,618,611
3404-001,2016,10,9,13,183,336,519,618
3404-001,2016,10,9,14,246,313,559,519
3404-001,2016,10,9,15,364,373,737,559
3404-001,2016,10,9,16,424,360,784,737
3404-001,2016,10,9,17,470,313,783,784
3404-001,2016,10,9,18,688,303,991,783
3404-001,2016,10,9,19,665,290,955,991
3404-001,2016,10,9,20,410,228,638,955
3404-001,2016,10,9,21,188,193,381,638
3404-001,2016,10,9,22,104,137,241,381
3404-001,2016,10,9,23,43,121,164,241
3404-001,2016,10,9,24,27,76,103,164
3404-001,2016,10,10,1,16,46,62,103
3404-001,2016,10,10,2,10,42,52,62
3404-001,2016,10,10,3,7,31,38,52
3404-001,2016,10,10,4,13,28,41,38
3404-001,2016,10,10,5,35,47,82,41
3404-001,2016,10,10,6,78,181,259,82
3404-001,2016,10,10,7,243,702,945,259
3404-001,2016,10,10,8,529,1869,2398,945
3404-001,2016,10,10,9,657,1216,1873,2398
3404-001,2016,10,10,10,570,635,1205,1873
3404-001,2016,10,10,11,636,610,1246,1205
3404-001,2016,10,10,12,603,623,1226,1246
3404-001,2016,10,10,13,551,553,1104,1226
3404-001,2016,10,10,14,652,621,1273,1104
3404-001,2016,10,10,15,704,615,1319,1273
3404-001,2016,10,10,16,725,618,1343,1319
3404-001,2016,10,10,17,794,522,1316,1343
3404-001,2016,10,10,18,1180,478,1658,1316
3404-001,2016,10,10,19,1019,434,1453,1658
3404-001,2016,10,10,20,591,287,878,1453
3404-001,2016,10,10,21,555,210,765,878
3404-001,2016,10,10,22,267,139,406,765
3404-001,2016,10,10,23,147,96,243,406
3404-001,2016,10,10,24,68,62,130,243
3404-001,2016,10,11,1,43,53,96,130
3404-001,2016,10,11,2,32,39,71,96
3404-001,2016,10,11,3,52,36,88,71
3404-001,2016,10,11,4,32,43,75,88
3404-001,2016,10,11,5,43,55,98,75
3404-001,2016,10,11,6,79,141,220,98
3404-001,2016,10,11,7,216,584,800,220
3404-001,2016,10,11,8,542,1709,2251,800
3404-001,2016,10,11,9,629,1143,1772,2251
3404-001,2016,10,11,10,611,674,1285,1772
3404-001,2016,10,11,11,577,611,1188,1285
3404-001,2016,10,11,12,553,590,1143,1188
3404-001,2016,10,11,13,520,463,983,1143
3404-001,2016,10,11,14,586,540,1126,983
3404-001,2016,10,11,15,729,584,1313,1126
3404-001,2016,10,11,16,740,548,1288,1313
3404-001,2016,10,11,17,792,547,1339,1288
3404-001,2016,10,11,18,1165,483,1648,1339
3404-001,2016,10,11,19,1072,383,1455,1648
3404-001,2016,10,11,20,633,285,918,1455
3404-001,2016,10,11,21,555,229,784,918
3404-001,2016,10,11,22,256,165,421,784
3404-001,2016,10,11,23,167,112,279,421
3404-001,2016,10,11,24,63,83,146,279
3404-001,2016,10,12,1,40,51,91,146
3404-001,2016,10,12,2,30,27,57,91
3404-001,2016,10,12,3,34,41,75,57
3404-001,2016,10,12,4,26,36,62,75
3404-001,2016,10,12,5,45,50,95,62
3404-001,2016,10,12,6,120,166,286,95
3404-001,2016,10,12,7,221,596,817,286
3404-001,2016,10,12,8,438,1644,2082,817
3404-001,2016,10,12,9,703,1145,1848,2082
3404-001,2016,10,12,10,592,652,1244,1848
3404-001,2016,10,12,11,632,615,1247,1244
3404-001,2016,10,12,12,528,525,1053,1247
3404-001,2016,10,12,13,474,487,961,1053
3404-001,2016,10,12,14,586,591,1177,961
3404-001,2016,10,12,15,725,616,1341,1177
3404-001,2016,10,12,16,665,545,1210,1341
3404-001,2016,10,12,17,743,471,1214,1210
3404-001,2016,10,12,18,1270,497,1767,1214
3404-001,2016,10,12,19,1017,419,1436,1767
3404-001,2016,10,12,20,660,278,938,1436
3404-001,2016,10,12,21,446,224,670,938
3404-001,2016,10,12,22,257,143,400,670
3404-001,2016,10,12,23,148,102,250,400
3404-001,2016,10,12,24,57,82,139,250
3404-001,2016,10,13,1,57,67,124,139
3404-001,2016,10,13,2,41,48,89,124
3404-001,2016,10,13,3,21,33,54,89
3404-001,2016,10,13,4,18,41,59,54
3404-001,2016,10,13,5,29,46,75,59
3404-001,2016,10,13,6,122,168,290,75
3404-001,2016,10,13,7,199,497,696,290
3404-001,2016,10,13,8,474,1676,2150,696
3404-001,2016,10,13,9,695,1197,1892,2150
3404-001,2016,10,13,10,599,645,1244,1892
3404-001,2016,10,13,11,618,581,1199,1244
3404-001,2016,10,13,12,602,591,1193,1199
3404-001,2016,10,13,13,531,493,1024,1193
3404-001,2016,10,13,14,531,608,1139,1024
3404-001,2016,10,13,15,726,633,1359,1139
3404-001,2016,10,13,16,783,570,1353,1359
3404-001,2016,10,13,17,761,531,1292,1353
3404-001,2016,10,13,18,1242,491,1733,1292
3404-001,2016,10,13,19,1050,366,1416,1733
3404-001,2016,10,13,20,605,327,932,1416
3404-001,2016,10,13,21,490,222,712,932
3404-001,2016,10,13,22,318,183,501,712
3404-001,2016,10,13,23,141,112,253,501
3404-001,2016,10,13,24,81,70,151,253
3404-001,2016,10,14,1,40,70,110,151
3404-001,2016,10,14,2,32,34,66,110
3404-001,2016,10,14,3,18,41,59,66
3404-001,2016,10,14,4,35,52,87,59
3404-001,2016,10,14,5,49,47,96,87
3404-001,2016,10,14,6,115,168,283,96
3404-001,2016,10,14,7,238,565,803,283
3404-001,2016,10,14,8,474,1740,2214,803
3404-001,2016,10,14,9,662,1176,1838,2214
3404-001,2016,10,14,10,602,684,1286,1838
3404-001,2016,10,14,11,640,633,1273,1286
3404-001,2016,10,14,12,646,630,1276,1273
3404-001,2016,10,14,13,586,540,1126,1276
3404-001,2016,10,14,14,633,597,1230,1126
3404-001,2016,10,14,15,770,659,1429,1230
3404-001,2016,10,14,16,901,615,1516,1429
3404-001,2016,10,14,17,969,520,1489,1516
3404-001,2016,10,14,18,1357,550,1907,1489
3404-001,2016,10,14,19,1230,474,1704,1907
3404-001,2016,10,14,20,748,391,1139,1704
3404-001,2016,10,14,21,531,234,765,1139
3404-001,2016,10,14,22,248,153,401,765
3404-001,2016,10,14,23,171,106,277,401
3404-001,2016,10,14,24,76,102,178,277
3404-001,2016,10,15,1,43,63,106,178
3404-001,2016,10,15,2,43,36,79,106
3404-001,2016,10,15,3,23,47,70,79
3404-001,2016,10,15,4,19,37,56,70
3404-001,2016,10,15,5,49,55,104,56
3404-001,2016,10,15,6,67,131,198,104
3404-001,2016,10,15,7,171,342,513,198
3404-001,2016,10,15,8,307,687,994,513
3404-001,2016,10,15,9,514,655,1169,994
3404-001,2016,10,15,10,422,643,1065,1169
3404-001,2016,10,15,11,473,561,1034,1065
3404-001,2016,10,15,12,536,582,1118,1034
3404-001,2016,10,15,13,438,621,1059,1118
3404-001,2016,10,15,14,454,581,1035,1059
3404-001,2016,10,15,15,506,574,1080,1035
3404-001,2016,10,15,16,548,498,1046,1080
3404-001,2016,10,15,17,743,478,1221,1046
3404-001,2016,10,15,18,997,458,1455,1221
3404-001,2016,10,15,19,721,398,1119,1455
3404-001,2016,10,15,20,389,287,676,1119
3404-001,2016,10,15,21,186,209,395,676
3404-001,2016,10,15,22,141,135,276,395
3404-001,2016,10,15,23,74,92,166,276
3404-001,2016,10,15,24,57,48,105,166
3404-001,2016,10,16,1,26,48,74,105
3404-001,2016,10,16,2,13,43,56,74
3404-001,2016,10,16,3,15,33,48,56
3404-001,2016,10,16,4,5,21,26,48
3404-001,2016,10,16,5,4,31,35,26
3404-001,2016,10,16,6,37,65,102,35
3404-001,2016,10,16,7,45,121,166,102
3404-001,2016,10,16,8,82,204,286,166
3404-001,2016,10,16,9,159,241,400,286
3404-001,2016,10,16,10,144,237,381,400
3404-001,2016,10,16,11,194,311,505,381
3404-001,2016,10,16,12,224,307,531,505
3404-001,2016,10,16,13,240,291,531,531
3404-001,2016,10,16,14,263,296,559,531
3404-001,2016,10,16,15,375,257,632,559
3404-001,2016,10,16,16,410,295,705,632
3404-001,2016,10,16,17,674,290,964,705
3404-001,2016,10,16,18,756,274,1030,964
3404-001,2016,10,16,19,522,213,735,1030
3404-001,2016,10,16,20,405,236,641,735
3404-001,2016,10,16,21,152,204,356,641
3404-001,2016,10,16,22,84,181,265,356
3404-001,2016,10,16,23,49,125,174,265
3404-001,2016,10,16,24,30,80,110,174
3404-001,2016,10,17,1,15,55,70,110
3404-001,2016,10,17,2,29,37,66,70
3404-001,2016,10,17,3,8,32,40,66
3404-001,2016,10,17,4,10,32,42,40
3404-001,2016,10,17,5,26,52,78,42
3404-001,2016,10,17,6,81,190,271,78
3404-001,2016,10,17,7,182,624,806,271
3404-001,2016,10,17,8,463,1833,2296,806
3404-001,2016,10,17,9,566,1238,1804,2296
3404-001,2016,10,17,10,484,596,1080,1804
3404-001,2016,10,17,11,529,579,1108,1080
3404-001,2016,10,17,12,597,547,1144,1108
3404-001,2016,10,17,13,433,476,909,1144
3404-001,2016,10,17,14,517,582,1099,909
3404-001,2016,10,17,15,644,566,1210,1099
3404-001,2016,10,17,16,707,557,1264,1210
3404-001,2016,10,17,17,729,518,1247,1264
3404-001,2016,10,17,18,1088,460,1548,1247
3404-001,2016,10,17,19,929,423,1352,1548
3404-001,2016,10,17,20,651,306,957,1352
3404-001,2016,10,17,21,594,215,809,957
3404-001,2016,10,17,22,279,125,404,809
3404-001,2016,10,17,23,134,101,235,404
3404-001,2016,10,17,24,68,76,144,235
3404-001,2016,10,18,1,62,65,127,144
3404-001,2016,10,18,2,35,39,74,127
3404-001,2016,10,18,3,24,36,60,74
3404-001,2016,10,18,4,15,50,65,60
3404-001,2016,10,18,5,35,46,81,65
3404-001,2016,10,18,6,89,183,272,81
3404-001,2016,10,18,7,185,525,710,272
3404-001,2016,10,18,8,496,1694,2190,710
3404-001,2016,10,18,9,715,1325,2040,2190
3404-001,2016,10,18,10,539,624,1163,2040
3404-001,2016,10,18,11,641,581,1222,1163
3404-001,2016,10,18,12,580,556,1136,1222
3404-001,2016,10,18,13,514,511,1025,1136
3404-001,2016,10,18,14,548,625,1173,1025
3404-001,2016,10,18,15,794,644,1438,1173
3404-001,2016,10,18,16,753,553,1306,1438
3404-001,2016,10,18,17,827,508,1335,1306
3404-001,2016,10,18,18,1148,496,1644,1335
3404-001,2016,10,18,19,1054,448,1502,1644
3404-001,2016,10,18,20,640,340,980,1502
3404-001,2016,10,18,21,556,222,778,980
3404-001,2016,10,18,22,328,173,501,778
3404-001,2016,10,18,23,159,122,281,501
3404-001,2016,10,18,24,82,82,164,281
3404-001,2016,10,19,1,51,60,111,164
3404-001,2016,10,19,2,27,33,60,111
3404-001,2016,10,19,3,26,53,79,60
3404-001,2016,10,19,4,21,46,67,79
3404-001,2016,10,19,5,38,43,81,67
3404-001,2016,10,19,6,106,169,275,81
3404-001,2016,10,19,7,204,521,725,275
3404-001,2016,10,19,8,444,1714,2158,725
3404-001,2016,10,19,9,704,1178,1882,2158
3404-001,2016,10,19,10,603,644,1247,1882
3404-001,2016,10,19,11,625,633,1258,1247
3404-001,2016,10,19,12,545,615,1160,1258
3404-001,2016,10,19,13,512,565,1077,1160
3404-001,2016,10,19,14,610,719,1329,1077
3404-001,2016,10,19,15,688,692,1380,1329
3404-001,2016,10,19,16,841,591,1432,1380
3404-001,2016,10,19,17,915,488,1403,1432
3404-001,2016,10,19,18,1382,494,1876,1403
3404-001,2016,10,19,19,1180,422,1602,1876
3404-001,2016,10,19,20,654,315,969,1602
3404-001,2016,10,19,21,490,233,723,969
3404-001,2016,10,19,22,268,220,488,723
3404-001,2016,10,19,23,164,115,279,488
3404-001,2016,10,19,24,89,76,165,279
3404-001,2016,10,20,1,46,63,109,165
3404-001,2016,10,20,2,29,37,66,109
3404-001,2016,10,20,3,21,28,49,66
3404-001,2016,10,20,4,19,39,58,49
3404-001,2016,10,20,5,52,43,95,58
3404-001,2016,10,20,6,84,155,239,95
3404-001,2016,10,20,7,183,449,632,239
3404-001,2016,10,20,8,426,1662,2088,632
3404-001,2016,10,20,9,668,1275,1943,2088
3404-001,2016,10,20,10,523,649,1172,1943
3404-001,2016,10,20,11,608,604,1212,1172
3404-001,2016,10,20,12,578,574,1152,1212
3404-001,2016,10,20,13,533,532,1065,1152
3404-001,2016,10,20,14,525,611,1136,1065
3404-001,2016,10,20,15,712,619,1331,1136
3404-001,2016,10,20,16,783,512,1295,1331
3404-001,2016,10,20,17,830,516,1346,1295
3404-001,2016,10,20,18,1255,511,1766,1346
3404-001,2016,10,20,19,972,413,1385,1766
3404-001,2016,10,20,20,584,310,894,1385
3404-001,2016,10,20,21,611,246,857,894
3404-001,2016,10,20,22,268,164,432,857
3404-001,2016,10,20,23,134,122,256,432
3404-001,2016,10,20,24,84,80,164,256
3404-001,2016,10,21,1,35,78,113,164
3404-001,2016,10,21,2,49,63,112,113
3404-001,2016,10,21,3,26,29,55,112
3404-001,2016,10,21,4,23,43,66,55
3404-001,2016,10,21,5,27,51,78,66
3404-001,2016,10,21,6,89,199,288,78
3404-001,2016,10,21,7,191,548,739,288
3404-001,2016,10,21,8,440,1642,2082,739
3404-001,2016,10,21,9,685,1210,1895,2082
3404-001,2016,10,21,10,577,657,1234,1895
3404-001,2016,10,21,11,600,618,1218,1234
3404-001,2016,10,21,12,718,595,1313,1218
3404-001,2016,10,21,13,567,564,1131,1313
3404-001,2016,10,21,14,588,587,1175,1131
3404-001,2016,10,21,15,692,638,1330,1175
3404-001,2016,10,21,16,821,592,1413,1330
3404-001,2016,10,21,17,811,542,1353,1413
3404-001,2016,10,21,18,1397,547,1944,1353
3404-001,2016,10,21,19,1211,518,1729,1944
3404-001,2016,10,21,20,688,432,1120,1729
3404-001,2016,10,21,21,523,266,789,1120
3404-001,2016,10,21,22,263,179,442,789
3404-001,2016,10,21,23,123,115,238,442
3404-001,2016,10,21,24,84,87,171,238
3404-001,2016,10,22,1,54,63,117,171
3404-001,2016,10,22,2,40,38,78,117
3404-001,2016,10,22,3,26,34,60,78
3404-001,2016,10,22,4,29,41,70,60
3404-001,2016,10,22,5,41,47,88,70
3404-001,2016,10,22,6,89,181,270,88
3404-001,2016,10,22,7,153,349,502,270
3404-001,2016,10,22,8,271,697,968,502
3404-001,2016,10,22,9,484,662,1146,968
3404-001,2016,10,22,10,427,606,1033,1146
3404-001,2016,10,22,11,473,625,1098,1033
3404-001,2016,10,22,12,517,628,1145,1098
3404-001,2016,10,22,13,383,576,959,1145
3404-001,2016,10,22,14,389,543,932,959
3404-001,2016,10,22,15,476,566,1042,932
3404-001,2016,10,22,16,495,464,959,1042
3404-001,2016,10,22,17,572,487,1059,959
3404-001,2016,10,22,18,993,425,1418,1059
3404-001,2016,10,22,19,739,327,1066,1418
3404-001,2016,10,22,20,374,238,612,1066
3404-001,2016,10,22,21,197,189,386,612
3404-001,2016,10,22,22,137,124,261,386
3404-001,2016,10,22,23,82,90,172,261
3404-001,2016,10,22,24,41,71,112,172
3404-001,2016,10,23,1,27,44,71,112
3404-001,2016,10,23,2,12,31,43,71
3404-001,2016,10,23,3,10,31,41,43
3404-001,2016,10,23,4,2,22,24,41
3404-001,2016,10,23,5,15,28,43,24
3404-001,2016,10,23,6,32,77,109,43
3404-001,2016,10,23,7,60,181,241,109
3404-001,2016,10,23,8,81,236,317,241
3404-001,2016,10,23,9,174,273,447,317
3404-001,2016,10,23,10,156,277,433,447
3404-001,2016,10,23,11,224,280,504,433
3404-001,2016,10,23,12,221,316,537,504
3404-001,2016,10,23,13,292,319,611,537
3404-001,2016,10,23,14,227,266,493,611
3404-001,2016,10,23,15,345,306,651,493
3404-001,2016,10,23,16,492,297,789,651
3404-001,2016,10,23,17,666,257,923,789
3404-001,2016,10,23,18,744,274,1018,923
3404-001,2016,10,23,19,533,239,772,1018
3404-001,2016,10,23,20,408,210,618,772
3404-001,2016,10,23,21,438,210,648,618
3404-001,2016,10,23,22,148,180,328,648
3404-001,2016,10,23,23,38,135,173,328
3404-001,2016,10,23,24,32,92,124,173
3404-001,2016,10,24,1,16,67,83,124
3404-001,2016,10,24,2,10,39,49,83
3404-001,2016,10,24,3,13,37,50,49
3404-001,2016,10,24,4,21,33,54,50
3404-001,2016,10,24,5,38,55,93,54
3404-001,2016,10,24,6,73,183,256,93
3404-001,2016,10,24,7,194,614,808,256
3404-001,2016,10,24,8,443,1775,2218,808
3404-001,2016,10,24,9,548,1300,1848,2218
3404-001,2016,10,24,10,558,560,1118,1848
3404-001,2016,10,24,11,584,575,1159,1118
3404-001,2016,10,24,12,547,579,1126,1159
3404-001,2016,10,24,13,506,540,1046,1126
3404-001,2016,10,24,14,534,600,1134,1046
3404-001,2016,10,24,15,710,683,1393,1134
3404-001,2016,10,24,16,731,608,1339,1393
3404-001,2016,10,24,17,822,460,1282,1339
3404-001,2016,10,24,18,1196,452,1648,1282
3404-001,2016,10,24,19,1101,391,1492,1648
3404-001,2016,10,24,20,687,288,975,1492
3404-001,2016,10,24,21,518,214,732,975
3404-001,2016,10,24,22,287,165,452,732
3404-001,2016,10,24,23,189,135,324,452
3404-001,2016,10,24,24,73,68,141,324
3404-001,2016,10,25,1,57,57,114,141
3404-001,2016,10,25,2,40,39,79,114
3404-001,2016,10,25,3,18,43,61,79
3404-001,2016,10,25,4,26,33,59,61
3404-001,2016,10,25,5,27,37,64,59
3404-001,2016,10,25,6,81,135,216,64
3404-001,2016,10,25,7,158,400,558,216
3404-001,2016,10,25,8,333,1489,1822,558
3404-001,2016,10,25,9,614,1125,1739,1822
3404-001,2016,10,25,10,457,606,1063,1739
3404-001,2016,10,25,11,474,580,1054,1063
3404-001,2016,10,25,12,477,502,979,1054
3404-001,2016,10,25,13,470,474,944,979
3404-001,2016,10,25,14,569,488,1057,944
3404-001,2016,10,25,15,671,603,1274,1057
3404-001,2016,10,25,16,662,545,1207,1274
3404-001,2016,10,25,17,698,472,1170,1207
3404-001,2016,10,25,18,1007,435,1442,1170
3404-001,2016,10,25,19,983,371,1354,1442
3404-001,2016,10,25,20,603,272,875,1354
3404-001,2016,10,25,21,558,241,799,875
3404-001,2016,10,25,22,336,171,507,799
3404-001,2016,10,25,23,147,110,257,507
3404-001,2016,10,25,24,78,80,158,257
3404-001,2016,10,26,1,48,60,108,158
3404-001,2016,10,26,2,40,39,79,108
3404-001,2016,10,26,3,21,34,55,79
3404-001,2016,10,26,4,29,33,62,55
3404-001,2016,10,26,5,32,47,79,62
3404-001,2016,10,26,6,86,150,236,79
3404-001,2016,10,26,7,171,472,643,236
3404-001,2016,10,26,8,381,1588,1969,643
3404-001,2016,10,26,9,592,1324,1916,1969
3404-001,2016,10,26,10,551,633,1184,1916
3404-001,2016,10,26,11,566,574,1140,1184
3404-001,2016,10,26,12,602,518,1120,1140
3404-001,2016,10,26,13,454,507,961,1120
3404-001,2016,10,26,14,545,564,1109,961
3404-001,2016,10,26,15,668,603,1271,1109
3404-001,2016,10,26,16,747,504,1251,1271
3404-001,2016,10,26,17,743,474,1217,1251
3404-001,2016,10,26,18,1253,489,1742,1217
3404-001,2016,10,26,19,1168,427,1595,1742
3404-001,2016,10,26,20,636,285,921,1595
3404-001,2016,10,26,21,493,199,692,921
3404-001,2016,10,26,22,267,174,441,692
3404-001,2016,10,26,23,150,94,244,441
3404-001,2016,10,26,24,67,63,130,244
3404-001,2016,10,27,1,32,53,85,130
3404-001,2016,10,27,2,41,36,77,85
3404-001,2016,10,27,3,21,42,63,77
3404-001,2016,10,27,4,24,33,57,63
3404-001,2016,10,27,5,40,42,82,57
3404-001,2016,10,27,6,76,166,242,82
3404-001,2016,10,27,7,153,542,695,242
3404-001,2016,10,27,8,449,1692,2141,695
3404-001,2016,10,27,9,685,1261,1946,2141
3404-001,2016,10,27,10,611,625,1236,1946
3404-001,2016,10,27,11,633,633,1266,1236
3404-001,2016,10,27,12,555,556,1111,1266
3404-001,2016,10,27,13,511,458,969,1111
3404-001,2016,10,27,14,572,648,1220,969
3404-001,2016,10,27,15,676,641,1317,1220
3404-001,2016,10,27,16,761,594,1355,1317
3404-001,2016,10,27,17,734,542,1276,1355
3404-001,2016,10,27,18,1134,489,1623,1276
3404-001,2016,10,27,19,1110,418,1528,1623
3404-001,2016,10,27,20,636,340,976,1528
3404-001,2016,10,27,21,540,220,760,976
3404-001,2016,10,27,22,276,141,417,760
3404-001,2016,10,27,23,159,101,260,417
3404-001,2016,10,27,24,95,101,196,260
3404-001,2016,10,28,1,40,68,108,196
3404-001,2016,10,28,2,49,37,86,108
3404-001,2016,10,28,3,38,38,76,86
3404-001,2016,10,28,4,21,42,63,76
3404-001,2016,10,28,5,51,55,106,63
3404-001,2016,10,28,6,82,146,228,106
3404-001,2016,10,28,7,178,468,646,228
3404-001,2016,10,28,8,380,1526,1906,646
3404-001,2016,10,28,9,651,1266,1917,1906
3404-001,2016,10,28,10,534,649,1183,1917
3404-001,2016,10,28,11,599,594,1193,1183
3404-001,2016,10,28,12,542,533,1075,1193
3404-001,2016,10,28,13,512,462,974,1075
3404-001,2016,10,28,14,570,564,1134,974
3404-001,2016,10,28,15,684,517,1201,1134
3404-001,2016,10,28,16,731,590,1321,1201
3404-001,2016,10,28,17,828,484,1312,1321
3404-001,2016,10,28,18,1217,525,1742,1312
3404-001,2016,10,28,19,1187,449,1636,1742
3404-001,2016,10,28,20,654,364,1018,1636
3404-001,2016,10,28,21,533,238,771,1018
3404-001,2016,10,28,22,303,164,467,771
3404-001,2016,10,28,23,112,114,226,467
3404-001,2016,10,28,24,76,80,156,226
3404-001,2016,10,29,1,37,70,107,156
3404-001,2016,10,29,2,34,42,76,107
3404-001,2016,10,29,3,26,26,52,76
3404-001,2016,10,29,4,27,19,46,52
3404-001,2016,10,29,5,40,33,73,46
3404-001,2016,10,29,6,76,107,183,73
3404-001,2016,10,29,7,119,300,419,183
3404-001,2016,10,29,8,284,646,930,419
3404-001,2016,10,29,9,496,655,1151,930
3404-001,2016,10,29,10,419,540,959,1151
3404-001,2016,10,29,11,427,591,1018,959
3404-001,2016,10,29,12,443,550,993,1018
3404-001,2016,10,29,13,405,538,943,993
3404-001,2016,10,29,14,381,521,902,943
3404-001,2016,10,29,15,509,520,1029,902
3404-001,2016,10,29,16,465,460,925,1029
3404-001,2016,10,29,17,566,433,999,925
3404-001,2016,10,29,18,844,453,1297,999
3404-001,2016,10,29,19,662,400,1062,1297
3404-001,2016,10,29,20,262,259,521,1062
3404-001,2016,10,29,21,153,161,314,521
3404-001,2016,10,29,22,87,122,209,314
3404-001,2016,10,29,23,46,83,129,209
3404-001,2016,10,29,24,46,76,122,129
3404-001,2016,10,30,1,21,46,67,122
3404-001,2016,10,30,2,26,34,60,67
3404-001,2016,10,30,3,21,41,62,60
3404-001,2016,10,30,4,21,26,47,62
3404-001,2016,10,30,5,13,42,55,47
3404-001,2016,10,30,6,37,63,100,55
3404-001,2016,10,30,7,34,150,184,100
3404-001,2016,10,30,8,93,233,326,184
3404-001,2016,10,30,9,136,215,351,326
3404-001,2016,10,30,10,142,207,349,351
3404-001,2016,10,30,11,175,292,467,349
3404-001,2016,10,30,12,177,286,463,467
3404-001,2016,10,30,13,215,290,505,463
3404-001,2016,10,30,14,218,326,544,505
3404-001,2016,10,30,15,312,291,603,544
3404-001,2016,10,30,16,414,280,694,603
3404-001,2016,10,30,17,584,280,864,694
3404-001,2016,10,30,18,852,326,1178,864
3404-001,2016,10,30,19,646,273,919,1178
3404-001,2016,10,30,20,426,281,707,919
3404-001,2016,10,30,21,183,269,452,707
3404-001,2016,10,30,22,112,180,292,452
3404-001,2016,10,30,23,59,141,200,292
3404-001,2016,10,30,24,24,112,136,200
3404-001,2016,10,31,1,13,66,79,136
3404-001,2016,10,31,2,18,53,71,79
3404-001,2016,10,31,3,19,34,53,71
3404-001,2016,10,31,4,10,34,44,53
3404-001,2016,10,31,5,24,53,77,44
3404-001,2016,10,31,6,89,185,274,77
3404-001,2016,10,31,7,207,587,794,274
3404-001,2016,10,31,8,389,1800,2189,794
3404-001,2016,10,31,9,594,1329,1923,2189
3404-001,2016,10,31,10,542,654,1196,1923
3404-001,2016,10,31,11,518,547,1065,1196
3404-001,2016,10,31,12,592,586,1178,1065
3404-001,2016,10,31,13,451,489,940,1178
3404-001,2016,10,31,14,518,565,1083,940
3404-001,2016,10,31,15,671,566,1237,1083
3404-001,2016,10,31,16,754,557,1311,1237
3404-001,2016,10,31,17,824,550,1374,1311
3404-001,2016,10,31,18,1083,491,1574,1374
3404-001,2016,10,31,19,965,379,1344,1574
3404-001,2016,10,31,20,603,301,904,1344
3404-001,2016,10,31,21,559,212,771,904
3404-001,2016,10,31,22,306,141,447,771
3404-001,2016,10,31,23,147,106,253,447
3404-001,2016,10,31,24,71,65,136,253
3404-001,2016,11,1,1,60,54,114,136
3404-001,2016,11,1,2,23,48,71,114
3404-001,2016,11,1,3,21,34,55,71
3404-001,2016,11,1,4,26,42,68,55
3404-001,2016,11,1,5,54,42,96,68
3404-001,2016,11,1,6,89,154,243,96
3404-001,2016,11,1,7,169,489,658,243
3404-001,2016,11,1,8,460,1696,2156,658
3404-001,2016,11,1,9,630,1191,1821,2156
3404-001,2016,11,1,10,506,621,1127,1821
3404-001,2016,11,1,11,509,547,1056,1127
3404-001,2016,11,1,12,561,562,1123,1056
3404-001,2016,11,1,13,496,423,919,1123
3404-001,2016,11,1,14,555,585,1140,919
3404-001,2016,11,1,15,698,571,1269,1140
3404-001,2016,11,1,16,715,557,1272,1269
3404-001,2016,11,1,17,825,504,1329,1272
3404-001,2016,11,1,18,1054,451,1505,1329
3404-001,2016,11,1,19,983,401,1384,1505
3404-001,2016,11,1,20,677,290,967,1384
3404-001,2016,11,1,21,553,214,767,967
3404-001,2016,11,1,22,285,135,420,767
3404-001,2016,11,1,23,156,124,280,420
3404-001,2016,11,1,24,62,84,146,280
3404-001,2016,11,2,1,49,54,103,146
3404-001,2016,11,2,2,49,41,90,103
3404-001,2016,11,2,3,32,44,76,90
3404-001,2016,11,2,4,32,36,68,76
3404-001,2016,11,2,5,38,53,91,68
3404-001,2016,11,2,6,89,166,255,91
3404-001,2016,11,2,7,166,529,695,255
3404-001,2016,11,2,8,410,1688,2098,695
3404-001,2016,11,2,9,712,1245,1957,2098
3404-001,2016,11,2,10,540,649,1189,1957
3404-001,2016,11,2,11,490,574,1064,1189
3404-001,2016,11,2,12,564,500,1064,1064
3404-001,2016,11,2,13,495,440,935,1064
3404-001,2016,11,2,14,531,523,1054,935
3404-001,2016,11,2,15,679,617,1296,1054
3404-001,2016,11,2,16,825,607,1432,1296
3404-001,2016,11,2,17,764,592,1356,1432
3404-001,2016,11,2,18,1216,489,1705,1356
3404-001,2016,11,2,19,1142,423,1565,1705
3404-001,2016,11,2,20,561,302,863,1565
3404-001,2016,11,2,21,498,203,701,863
3404-001,2016,11,2,22,260,165,425,701
3404-001,2016,11,2,23,141,96,237,425
3404-001,2016,11,2,24,82,79,161,237
3404-001,2016,11,3,1,41,62,103,161
3404-001,2016,11,3,2,30,40,70,103
3404-001,2016,11,3,3,16,40,56,70
3404-001,2016,11,3,4,27,34,61,56
3404-001,2016,11,3,5,51,53,104,61
3404-001,2016,11,3,6,92,158,250,104
3404-001,2016,11,3,7,164,473,637,250
3404-001,2016,11,3,8,405,1710,2115,637
3404-001,2016,11,3,9,658,1346,2004,2115
3404-001,2016,11,3,10,605,585,1190,2004
3404-001,2016,11,3,11,600,631,1231,1190
3404-001,2016,11,3,12,583,569,1152,1231
3404-001,2016,11,3,13,498,541,1039,1152
3404-001,2016,11,3,14,616,588,1204,1039
3404-001,2016,11,3,15,671,623,1294,1204
3404-001,2016,11,3,16,797,701,1498,1294
3404-001,2016,11,3,17,827,519,1346,1498
3404-001,2016,11,3,18,1307,518,1825,1346
3404-001,2016,11,3,19,1065,444,1509,1825
3404-001,2016,11,3,20,610,353,963,1509
3404-001,2016,11,3,21,550,236,786,963
3404-001,2016,11,3,22,298,196,494,786
3404-001,2016,11,3,23,177,128,305,494
3404-001,2016,11,3,24,76,101,177,305
3404-001,2016,11,4,1,60,59,119,177
3404-001,2016,11,4,2,37,44,81,119
3404-001,2016,11,4,3,27,40,67,81
3404-001,2016,11,4,4,19,45,64,67
3404-001,2016,11,4,5,43,48,91,64
3404-001,2016,11,4,6,108,167,275,91
3404-001,2016,11,4,7,163,496,659,275
3404-001,2016,11,4,8,402,1652,2054,659
3404-001,2016,11,4,9,759,1259,2018,2054
3404-001,2016,11,4,10,591,568,1159,2018
3404-001,2016,11,4,11,603,650,1253,1159
3404-001,2016,11,4,12,618,548,1166,1253
3404-001,2016,11,4,13,517,509,1026,1166
3404-001,2016,11,4,14,592,571,1163,1026
3404-001,2016,11,4,15,725,625,1350,1163
3404-001,2016,11,4,16,920,579,1499,1350
3404-001,2016,11,4,17,869,585,1454,1499
3404-001,2016,11,4,18,1319,556,1875,1454
3404-001,2016,11,4,19,1233,479,1712,1875
3404-001,2016,11,4,20,792,423,1215,1712
3404-001,2016,11,4,21,556,255,811,1215
3404-001,2016,11,4,22,296,210,506,811
3404-001,2016,11,4,23,159,115,274,506
3404-001,2016,11,4,24,114,105,219,274
3404-001,2016,11,5,1,52,63,115,219
3404-001,2016,11,5,2,43,56,99,115
3404-001,2016,11,5,3,26,37,63,99
3404-001,2016,11,5,4,24,44,68,63
3404-001,2016,11,5,5,38,42,80,68
3404-001,2016,11,5,6,81,142,223,80
3404-001,2016,11,5,7,171,290,461,223
3404-001,2016,11,5,8,290,687,977,461
3404-001,2016,11,5,9,501,683,1184,977
3404-001,2016,11,5,10,459,643,1102,1184
3404-001,2016,11,5,11,531,641,1172,1102
3404-001,2016,11,5,12,518,611,1129,1172
3404-001,2016,11,5,13,410,515,925,1129
3404-001,2016,11,5,14,388,518,906,925
3404-001,2016,11,5,15,509,574,1083,906
3404-001,2016,11,5,16,555,494,1049,1083
3404-001,2016,11,5,17,573,442,1015,1049
3404-001,2016,11,5,18,875,447,1322,1015
3404-001,2016,11,5,19,770,363,1133,1322
3404-001,2016,11,5,20,344,284,628,1133
3404-001,2016,11,5,21,172,191,363,628
3404-001,2016,11,5,22,117,139,256,363
3404-001,2016,11,5,23,60,88,148,256
3404-001,2016,11,5,24,52,64,116,148
3404-001,2016,11,6,1,23,46,69,116
3404-001,2016,11,6,2,23,34,57,69
3404-001,2016,11,6,3,29,23,52,57
3404-001,2016,11,6,4,10,28,38,52
3404-001,2016,11,6,5,19,22,41,38
3404-001,2016,11,6,6,18,59,77,41
3404-001,2016,11,6,7,35,148,183,77
3404-001,2016,11,6,8,106,223,329,183
3404-001,2016,11,6,9,240,294,534,329
3404-001,2016,11,6,10,210,279,489,534
3404-001,2016,11,6,11,227,295,522,489
3404-001,2016,11,6,12,237,339,576,522
3404-001,2016,11,6,13,229,290,519,576
3404-001,2016,11,6,14,241,339,580,519
3404-001,2016,11,6,15,342,360,702,580
3404-001,2016,11,6,16,463,330,793,702
3404-001,2016,11,6,17,714,307,1021,793
3404-001,2016,11,6,18,833,304,1137,1021
3404-001,2016,11,6,19,858,252,1110,1137
3404-001,2016,11,6,20,344,254,598,1110
3404-001,2016,11,6,21,317,177,494,598
3404-001,2016,11,6,22,204,181,385,494
3404-001,2016,11,6,23,67,170,237,385
3404-001,2016,11,6,24,21,95,116,237
3404-001,2016,11,7,1,12,53,65,116
3404-001,2016,11,7,2,19,40,59,65
3404-001,2016,11,7,3,15,27,42,59
3404-001,2016,11,7,4,13,25,38,42
3404-001,2016,11,7,5,49,44,93,38
3404-001,2016,11,7,6,67,182,249,93
3404-001,2016,11,7,7,243,569,812,249
3404-001,2016,11,7,8,466,1905,2371,812
3404-001,2016,11,7,9,652,1380,2032,2371
3404-001,2016,11,7,10,542,658,1200,2032
3404-001,2016,11,7,11,580,623,1203,1200
3404-001,2016,11,7,12,600,580,1180,1203
3404-001,2016,11,7,13,460,521,981,1180
3404-001,2016,11,7,14,573,594,1167,981
3404-001,2016,11,7,15,767,607,1374,1167
3404-001,2016,11,7,16,729,631,1360,1374
3404-001,2016,11,7,17,788,527,1315,1360
3404-001,2016,11,7,18,1069,473,1542,1315
3404-001,2016,11,7,19,1016,382,1398,1542
3404-001,2016,11,7,20,654,308,962,1398
3404-001,2016,11,7,21,529,196,725,962
3404-001,2016,11,7,22,307,182,489,725
3404-001,2016,11,7,23,131,91,222,489
3404-001,2016,11,7,24,73,60,133,222
3404-001,2016,11,8,1,43,34,77,133
3404-001,2016,11,8,2,38,53,91,77
3404-001,2016,11,8,3,29,35,64,91
3404-001,2016,11,8,4,32,30,62,64
3404-001,2016,11,8,5,43,49,92,62
3404-001,2016,11,8,6,71,137,208,92
3404-001,2016,11,8,7,226,470,696,208
3404-001,2016,11,8,8,427,1737,2164,696
3404-001,2016,11,8,9,803,1367,2170,2164
3404-001,2016,11,8,10,603,637,1240,2170
3404-001,2016,11,8,11,665,685,1350,1240
3404-001,2016,11,8,12,633,538,1171,1350
3404-001,2016,11,8,13,492,519,1011,1171
3404-001,2016,11,8,14,523,500,1023,1011
3404-001,2016,11,8,15,714,606,1320,1023
3404-001,2016,11,8,16,762,499,1261,1320
3404-001,2016,11,8,17,869,518,1387,1261
3404-001,2016,11,8,18,1131,504,1635,1387
3404-001,2016,11,8,19,1033,415,1448,1635
3404-001,2016,11,8,20,676,281,957,1448
3404-001,2016,11,8,21,544,237,781,957
3404-001,2016,11,8,22,289,177,466,781
3404-001,2016,11,8,23,112,124,236,466
3404-001,2016,11,8,24,95,79,174,236
3404-001,2016,11,9,1,49,63,112,174
3404-001,2016,11,9,2,21,37,58,112
3404-001,2016,11,9,3,37,31,68,58
3404-001,2016,11,9,4,21,36,57,68
3404-001,2016,11,9,5,30,48,78,57
3404-001,2016,11,9,6,90,147,237,78
3404-001,2016,11,9,7,189,496,685,237
3404-001,2016,11,9,8,413,1680,2093,685
3404-001,2016,11,9,9,729,1337,2066,2093
3404-001,2016,11,9,10,551,690,1241,2066
3404-001,2016,11,9,11,792,571,1363,1241
3404-001,2016,11,9,12,575,551,1126,1363
3404-001,2016,11,9,13,441,545,986,1126
3404-001,2016,11,9,14,501,500,1001,986
3404-001,2016,11,9,15,663,551,1214,1001
3404-001,2016,11,9,16,725,538,1263,1214
3404-001,2016,11,9,17,868,575,1443,1263
3404-001,2016,11,9,18,1291,542,1833,1443
3404-001,2016,11,9,19,1129,416,1545,1833
3404-001,2016,11,9,20,703,317,1020,1545
3404-001,2016,11,9,21,504,213,717,1020
3404-001,2016,11,9,22,262,171,433,717
3404-001,2016,11,9,23,141,142,283,433
3404-001,2016,11,9,24,62,98,160,283
3404-001,2016,11,10,1,35,53,88,160
3404-001,2016,11,10,2,32,31,63,88
3404-001,2016,11,10,3,51,32,83,63
3404-001,2016,11,10,4,38,36,74,83
3404-001,2016,11,10,5,34,55,89,74
3404-001,2016,11,10,6,93,157,250,89
3404-001,2016,11,10,7,216,472,688,250
3404-001,2016,11,10,8,411,1718,2129,688
3404-001,2016,11,10,9,723,1278,2001,2129
3404-001,2016,11,10,10,589,662,1251,2001
3404-001,2016,11,10,11,660,617,1277,1251
3404-001,2016,11,10,12,572,559,1131,1277
3404-001,2016,11,10,13,476,503,979,1131
3404-001,2016,11,10,14,544,526,1070,979
3404-001,2016,11,10,15,665,597,1262,1070
3404-001,2016,11,10,16,844,592,1436,1262
3404-001,2016,11,10,17,841,504,1345,1436
3404-001,2016,11,10,18,1050,465,1515,1345
3404-001,2016,11,10,19,994,428,1422,1515
3404-001,2016,11,10,20,572,322,894,1422
3404-001,2016,11,10,21,529,217,746,894
3404-001,2016,11,10,22,334,177,511,746
3404-001,2016,11,10,23,156,126,282,511
3404-001,2016,11,10,24,87,93,180,282
3404-001,2016,11,11,1,52,64,116,180
3404-001,2016,11,11,2,41,50,91,116
3404-001,2016,11,11,3,35,36,71,91
3404-001,2016,11,11,4,23,36,59,71
3404-001,2016,11,11,5,45,51,96,59
3404-001,2016,11,11,6,78,145,223,96
3404-001,2016,11,11,7,164,454,618,223
3404-001,2016,11,11,8,413,1510,1923,618
3404-001,2016,11,11,9,748,1295,2043,1923
3404-001,2016,11,11,10,514,679,1193,2043
3404-001,2016,11,11,11,649,598,1247,1193
3404-001,2016,11,11,12,652,622,1274,1247
3404-001,2016,11,11,13,570,562,1132,1274
3404-001,2016,11,11,14,570,565,1135,1132
3404-001,2016,11,11,15,817,564,1381,1135
3404-001,2016,11,11,16,902,649,1551,1381
3404-001,2016,11,11,17,901,512,1413,1551
3404-001,2016,11,11,18,1267,527,1794,1413
3404-001,2016,11,11,19,1271,459,1730,1794
3404-001,2016,11,11,20,758,404,1162,1730
3404-001,2016,11,11,21,503,289,792,1162
3404-001,2016,11,11,22,306,195,501,792
3404-001,2016,11,11,23,142,114,256,501
3404-001,2016,11,11,24,76,107,183,256
3404-001,2016,11,12,1,57,69,126,183
3404-001,2016,11,12,2,35,40,75,126
3404-001,2016,11,12,3,30,41,71,75
3404-001,2016,11,12,4,40,46,86,71
3404-001,2016,11,12,5,29,44,73,86
3404-001,2016,11,12,6,52,139,191,73
3404-001,2016,11,12,7,136,265,401,191
3404-001,2016,11,12,8,257,588,845,401
3404-001,2016,11,12,9,514,620,1134,845
3404-001,2016,11,12,10,429,562,991,1134
3404-001,2016,11,12,11,403,589,992,991
3404-001,2016,11,12,12,389,647,1036,992
3404-001,2016,11,12,13,386,592,978,1036
3404-001,2016,11,12,14,416,529,945,978
3404-001,2016,11,12,15,462,564,1026,945
3404-001,2016,11,12,16,492,523,1015,1026
3404-001,2016,11,12,17,636,420,1056,1015
3404-001,2016,11,12,18,965,456,1421,1056
3404-001,2016,11,12,19,852,393,1245,1421
3404-001,2016,11,12,20,287,335,622,1245
3404-001,2016,11,12,21,182,203,385,622
3404-001,2016,11,12,22,123,173,296,385
3404-001,2016,11,12,23,59,95,154,296
3404-001,2016,11,12,24,32,72,104,154
3404-001,2016,11,13,1,34,59,93,104
3404-001,2016,11,13,2,10,25,35,93
3404-001,2016,11,13,3,13,39,52,35
3404-001,2016,11,13,4,26,26,52,52
3404-001,2016,11,13,5,7,41,48,52
3404-001,2016,11,13,6,37,91,128,48
3404-001,2016,11,13,7,41,187,228,128
3404-001,2016,11,13,8,108,251,359,228
3404-001,2016,11,13,9,163,320,483,359
3404-001,2016,11,13,10,188,334,522,483
3404-001,2016,11,13,11,218,410,628,522
3404-001,2016,11,13,12,202,416,618,628
3404-001,2016,11,13,13,194,322,516,618
3404-001,2016,11,13,14,259,344,603,516
3404-001,2016,11,13,15,333,369,702,603
3404-001,2016,11,13,16,547,408,955,702
3404-001,2016,11,13,17,830,396,1226,955
3404-001,2016,11,13,18,1000,390,1390,1226
3404-001,2016,11,13,19,575,364,939,1390
3404-001,2016,11,13,20,512,378,890,939
3404-001,2016,11,13,21,274,224,498,890
3404-001,2016,11,13,22,156,176,332,498
3404-001,2016,11,13,23,73,204,277,332
3404-001,2016,11,13,24,34,111,145,277
3404-001,2016,11,14,1,32,44,76,145
3404-001,2016,11,14,2,18,29,47,76
3404-001,2016,11,14,3,16,31,47,47
3404-001,2016,11,14,4,24,18,42,47
3404-001,2016,11,14,5,19,51,70,42
3404-001,2016,11,14,6,70,146,216,70
3404-001,2016,11,14,7,196,489,685,216
3404-001,2016,11,14,8,454,1551,2005,685
3404-001,2016,11,14,9,638,1264,1902,2005
3404-001,2016,11,14,10,509,662,1171,1902
3404-001,2016,11,14,11,613,528,1141,1171
3404-001,2016,11,14,12,594,587,1181,1141
3404-001,2016,11,14,13,484,516,1000,1181
3404-001,2016,11,14,14,507,587,1094,1000
3404-001,2016,11,14,15,635,681,1316,1094
3404-001,2016,11,14,16,773,745,1518,1316
3404-001,2016,11,14,17,822,598,1420,1518
3404-001,2016,11,14,18,1109,434,1543,1420
3404-001,2016,11,14,19,929,355,1284,1543
3404-001,2016,11,14,20,625,301,926,1284
3404-001,2016,11,14,21,619,195,814,926
3404-001,2016,11,14,22,311,144,455,814
3404-001,2016,11,14,23,148,92,240,455
3404-001,2016,11,14,24,82,74,156,240
3404-001,2016,11,15,1,57,50,107,156
3404-001,2016,11,15,2,34,46,80,107
3404-001,2016,11,15,3,34,30,64,80
3404-001,2016,11,15,4,26,24,50,64
3404-001,2016,11,15,5,30,55,85,50
3404-001,2016,11,15,6,92,137,229,85
3404-001,2016,11,15,7,199,431,630,229
3404-001,2016,11,15,8,389,1335,1724,630
3404-001,2016,11,15,9,641,1126,1767,1724
3404-001,2016,11,15,10,544,541,1085,1767
3404-001,2016,11,15,11,564,561,1125,1085
3404-001,2016,11,15,12,649,502,1151,1125
3404-001,2016,11,15,13,515,436,951,1151
3404-001,2016,11,15,14,531,488,1019,951
3404-001,2016,11,15,15,668,548,1216,1019
3404-001,2016,11,15,16,788,533,1321,1216
3404-001,2016,11,15,17,789,508,1297,1321
3404-001,2016,11,15,18,1191,415,1606,1297
3404-001,2016,11,15,19,969,335,1304,1606
3404-001,2016,11,15,20,629,264,893,1304
3404-001,2016,11,15,21,589,240,829,893
3404-001,2016,11,15,22,293,149,442,829
3404-001,2016,11,15,23,183,106,289,442
3404-001,2016,11,15,24,81,53,134,289
3404-001,2016,11,16,1,56,62,118,134
3404-001,2016,11,16,2,37,38,75,118
3404-001,2016,11,16,3,45,47,92,75
3404-001,2016,11,16,4,32,39,71,92
3404-001,2016,11,16,5,37,47,84,71
3404-001,2016,11,16,6,81,158,239,84
3404-001,2016,11,16,7,188,427,615,239
3404-001,2016,11,16,8,385,1368,1753,615
3404-001,2016,11,16,9,687,1093,1780,1753
3404-001,2016,11,16,10,589,844,1433,1780
3404-001,2016,11,16,11,592,867,1459,1433
3404-001,2016,11,16,12,621,779,1400,1459
3404-001,2016,11,16,13,507,407,914,1400
3404-001,2016,11,16,14,506,488,994,914
3404-001,2016,11,16,15,687,466,1153,994
3404-001,2016,11,16,16,795,453,1248,1153
3404-001,2016,11,16,17,803,434,1237,1248
3404-001,2016,11,16,18,1325,423,1748,1237
3404-001,2016,11,16,19,1180,367,1547,1748
3404-001,2016,11,16,20,599,264,863,1547
3404-001,2016,11,16,21,481,176,657,863
3404-001,2016,11,16,22,284,147,431,657
3404-001,2016,11,16,23,153,107,260,431
3404-001,2016,11,16,24,65,68,133,260
3404-001,2016,11,17,1,54,55,109,133
3404-001,2016,11,17,2,32,37,69,109
3404-001,2016,11,17,3,24,36,60,69
3404-001,2016,11,17,4,21,32,53,60
3404-001,2016,11,17,5,45,34,79,53
3404-001,2016,11,17,6,73,134,207,79
3404-001,2016,11,17,7,189,422,611,207
3404-001,2016,11,17,8,443,1404,1847,611
3404-001,2016,11,17,9,706,1130,1836,1847
3404-001,2016,11,17,10,553,587,1140,1836
3404-001,2016,11,17,11,662,532,1194,1140
3404-001,2016,11,17,12,570,467,1037,1194
3404-001,2016,11,17,13,520,435,955,1037
3404-001,2016,11,17,14,592,459,1051,955
3404-001,2016,11,17,15,685,544,1229,1051
3404-001,2016,11,17,16,794,549,1343,1229
3404-001,2016,11,17,17,805,433,1238,1343
3404-001,2016,11,17,18,1210,505,1715,1238
3404-001,2016,11,17,19,1161,419,1580,1715
3404-001,2016,11,17,20,657,315,972,1580
3404-001,2016,11,17,21,561,247,808,972
3404-001,2016,11,17,22,344,165,509,808
3404-001,2016,11,17,23,152,133,285,509
3404-001,2016,11,17,24,93,90,183,285
3404-001,2016,11,18,1,57,57,114,183
3404-001,2016,11,18,2,46,45,91,114
3404-001,2016,11,18,3,43,48,91,91
3404-001,2016,11,18,4,27,39,66,91
3404-001,2016,11,18,5,46,45,91,66
3404-001,2016,11,18,6,79,177,256,91
3404-001,2016,11,18,7,189,502,691,256
3404-001,2016,11,18,8,465,1571,2036,691
3404-001,2016,11,18,9,780,1263,2043,2036
3404-001,2016,11,18,10,636,686,1322,2043
3404-001,2016,11,18,11,638,689,1327,1322
3404-001,2016,11,18,12,710,601,1311,1327
3404-001,2016,11,18,13,589,533,1122,1311
3404-001,2016,11,18,14,594,553,1147,1122
3404-001,2016,11,18,15,671,647,1318,1147
3404-001,2016,11,18,16,873,462,1335,1318
3404-001,2016,11,18,17,984,326,1310,1335
3404-001,2016,11,18,18,1318,397,1715,1310
3404-001,2016,11,18,19,1355,352,1707,1715
3404-001,2016,11,18,20,671,343,1014,1707
3404-001,2016,11,18,21,588,246,834,1014
3404-001,2016,11,18,22,274,141,415,834
3404-001,2016,11,18,23,174,84,258,415
3404-001,2016,11,18,24,76,50,126,258
3404-001,2016,11,19,1,48,42,90,126
3404-001,2016,11,19,2,37,30,67,90
3404-001,2016,11,19,3,34,27,61,67
3404-001,2016,11,19,4,23,20,43,61
3404-001,2016,11,19,5,27,26,53,43
3404-001,2016,11,19,6,76,69,145,53
3404-001,2016,11,19,7,131,181,312,145
3404-001,2016,11,19,8,237,461,698,312
3404-001,2016,11,19,9,383,473,856,698
3404-001,2016,11,19,10,414,367,781,856
3404-001,2016,11,19,11,414,433,847,781
3404-001,2016,11,19,12,411,465,876,847
3404-001,2016,11,19,13,413,525,938,876
3404-001,2016,11,19,14,358,447,805,938
3404-001,2016,11,19,15,411,502,913,805
3404-001,2016,11,19,16,477,411,888,913
3404-001,2016,11,19,17,636,423,1059,888
3404-001,2016,11,19,18,781,433,1214,1059
3404-001,2016,11,19,19,636,343,979,1214
3404-001,2016,11,19,20,270,226,496,979
3404-001,2016,11,19,21,210,175,385,496
3404-001,2016,11,19,22,112,134,246,385
3404-001,2016,11,19,23,59,95,154,246
3404-001,2016,11,19,24,56,70,126,154
3404-001,2016,11,20,1,23,27,50,126
3404-001,2016,11,20,2,26,20,46,50
3404-001,2016,11,20,3,12,20,32,46
3404-001,2016,11,20,4,10,16,26,32
3404-001,2016,11,20,5,15,15,30,26
3404-001,2016,11,20,6,30,48,78,30
3404-001,2016,11,20,7,38,126,164,78
3404-001,2016,11,20,8,98,237,335,164
3404-001,2016,11,20,9,155,214,369,335
3404-001,2016,11,20,10,166,203,369,369
3404-001,2016,11,20,11,166,231,397,369
3404-001,2016,11,20,12,196,238,434,397
3404-001,2016,11,20,13,235,197,432,434
3404-001,2016,11,20,14,251,273,524,432
3404-001,2016,11,20,15,336,280,616,524
3404-001,2016,11,20,16,414,318,732,616
3404-001,2016,11,20,17,566,285,851,732
3404-001,2016,11,20,18,688,339,1027,851
3404-001,2016,11,20,19,619,314,933,1027
3404-001,2016,11,20,20,285,273,558,933
3404-001,2016,11,20,21,171,241,412,558
3404-001,2016,11,20,22,106,200,306,412
3404-001,2016,11,20,23,67,124,191,306
3404-001,2016,11,20,24,59,90,149,191
3404-001,2016,11,21,1,27,96,123,149
3404-001,2016,11,21,2,19,49,68,123
3404-001,2016,11,21,3,18,31,49,68
3404-001,2016,11,21,4,19,35,54,49
3404-001,2016,11,21,5,30,60,90,54
3404-001,2016,11,21,6,62,206,268,90
3404-001,2016,11,21,7,186,636,822,268
3404-001,2016,11,21,8,426,1802,2228,822
3404-001,2016,11,21,9,676,1422,2098,2228
3404-001,2016,11,21,10,501,711,1212,2098
3404-001,2016,11,21,11,558,693,1251,1212
3404-001,2016,11,21,12,514,551,1065,1251
3404-001,2016,11,21,13,525,500,1025,1065
3404-001,2016,11,21,14,534,555,1089,1025
3404-001,2016,11,21,15,663,589,1252,1089
3404-001,2016,11,21,16,660,682,1342,1252
3404-001,2016,11,21,17,732,521,1253,1342
3404-001,2016,11,21,18,1115,546,1661,1253
3404-001,2016,11,21,19,1009,429,1438,1661
3404-001,2016,11,21,20,561,309,870,1438
3404-001,2016,11,21,21,556,255,811,870
3404-001,2016,11,21,22,248,171,419,811
3404-001,2016,11,21,23,125,111,236,419
3404-001,2016,11,21,24,63,81,144,236
3404-001,2016,11,22,1,70,62,132,144
3404-001,2016,11,22,2,30,31,61,132
3404-001,2016,11,22,3,21,36,57,61
3404-001,2016,11,22,4,34,36,70,57
3404-001,2016,11,22,5,59,54,113,70
3404-001,2016,11,22,6,74,159,233,113
3404-001,2016,11,22,7,178,458,636,233
3404-001,2016,11,22,8,402,1422,1824,636
3404-001,2016,11,22,9,720,1198,1918,1824
3404-001,2016,11,22,10,528,597,1125,1918
3404-001,2016,11,22,11,594,579,1173,1125
3404-001,2016,11,22,12,578,496,1074,1173
3404-001,2016,11,22,13,477,428,905,1074
3404-001,2016,11,22,14,457,546,1003,905
3404-001,2016,11,22,15,706,554,1260,1003
3404-001,2016,11,22,16,685,578,1263,1260
3404-001,2016,11,22,17,817,552,1369,1263
3404-001,2016,11,22,18,1033,521,1554,1369
3404-001,2016,11,22,19,880,393,1273,1554
3404-001,2016,11,22,20,551,320,871,1273
3404-001,2016,11,22,21,641,238,879,871
3404-001,2016,11,22,22,285,178,463,879
3404-001,2016,11,22,23,152,124,276,463
3404-001,2016,11,22,24,82,77,159,276
3404-001,2016,11,23,1,48,49,97,159
3404-001,2016,11,23,2,43,48,91,97
3404-001,2016,11,23,3,29,53,82,91
3404-001,2016,11,23,4,30,34,64,82
3404-001,2016,11,23,5,35,46,81,64
3404-001,2016,11,23,6,101,180,281,81
3404-001,2016,11,23,7,177,472,649,281
3404-001,2016,11,23,8,374,1576,1950,649
3404-001,2016,11,23,9,709,1277,1986,1950
3404-001,2016,11,23,10,558,662,1220,1986
3404-001,2016,11,23,11,600,596,1196,1220
3404-001,2016,11,23,12,584,559,1143,1196
3404-001,2016,11,23,13,499,466,965,1143
3404-001,2016,11,23,14,531,524,1055,965
3404-001,2016,11,23,15,657,587,1244,1055
3404-001,2016,11,23,16,780,554,1334,1244
3404-001,2016,11,23,17,784,489,1273,1334
3404-001,2016,11,23,18,1273,471,1744,1273
3404-001,2016,11,23,19,951,421,1372,1744
3404-001,2016,11,23,20,559,320,879,1372
3404-001,2016,11,23,21,452,264,716,879
3404-001,2016,11,23,22,235,212,447,716
3404-001,2016,11,23,23,126,105,231,447
3404-001,2016,11,23,24,82,84,166,231
3404-001,2016,11,24,1,60,55,115,166
3404-001,2016,11,24,2,56,36,92,115
3404-001,2016,11,24,3,21,41,62,92
3404-001,2016,11,24,4,18,37,55,62
3404-001,2016,11,24,5,43,32,75,55
3404-001,2016,11,24,6,86,147,233,75
3404-001,2016,11,24,7,188,463,651,233
3404-001,2016,11,24,8,386,1539,1925,651
3404-001,2016,11,24,9,725,1203,1928,1925
3404-001,2016,11,24,10,596,688,1284,1928
3404-001,2016,11,24,11,636,550,1186,1284
3404-001,2016,11,24,12,597,546,1143,1186
3404-001,2016,11,24,13,498,462,960,1143
3404-001,2016,11,24,14,499,523,1022,960
3404-001,2016,11,24,15,636,550,1186,1022
3404-001,2016,11,24,16,671,510,1181,1186
3404-001,2016,11,24,17,745,489,1234,1181
3404-001,2016,11,24,18,1065,501,1566,1234
3404-001,2016,11,24,19,1003,423,1426,1566
3404-001,2016,11,24,20,537,313,850,1426
3404-001,2016,11,24,21,544,251,795,850
3404-001,2016,11,24,22,289,194,483,795
3404-001,2016,11,24,23,178,133,311,483
3404-001,2016,11,24,24,78,82,160,311
3404-001,2016,11,25,1,65,59,124,160
3404-001,2016,11,25,2,26,37,63,124
3404-001,2016,11,25,3,34,39,73,63
3404-001,2016,11,25,4,27,44,71,73
3404-001,2016,11,25,5,27,44,71,71
3404-001,2016,11,25,6,84,170,254,71
3404-001,2016,11,25,7,169,503,672,254
3404-001,2016,11,25,8,386,1496,1882,672
3404-001,2016,11,25,9,712,1225,1937,1882
3404-001,2016,11,25,10,578,625,1203,1937
3404-001,2016,11,25,11,622,616,1238,1203
3404-001,2016,11,25,12,607,541,1148,1238
3404-001,2016,11,25,13,520,477,997,1148
3404-001,2016,11,25,14,577,487,1064,997
3404-001,2016,11,25,15,720,607,1327,1064
3404-001,2016,11,25,16,1237,565,1802,1327
3404-001,2016,11,25,17,891,562,1453,1802
3404-001,2016,11,25,18,1217,565,1782,1453
3404-001,2016,11,25,19,1168,578,1746,1782
3404-001,2016,11,25,20,720,437,1157,1746
3404-001,2016,11,25,21,559,358,917,1157
3404-001,2016,11,25,22,328,199,527,917
3404-001,2016,11,25,23,144,130,274,527
3404-001,2016,11,25,24,87,87,174,274
3404-001,2016,11,26,1,34,64,98,174
3404-001,2016,11,26,2,45,49,94,98
3404-001,2016,11,26,3,30,40,70,94
3404-001,2016,11,26,4,32,51,83,70
3404-001,2016,11,26,5,38,54,92,83
3404-001,2016,11,26,6,68,139,207,92
3404-001,2016,11,26,7,155,306,461,207
3404-001,2016,11,26,8,279,672,951,461
3404-001,2016,11,26,9,457,688,1145,951
3404-001,2016,11,26,10,396,540,936,1145
3404-001,2016,11,26,11,435,574,1009,936
3404-001,2016,11,26,12,495,551,1046,1009
3404-001,2016,11,26,13,421,501,922,1046
3404-001,2016,11,26,14,405,457,862,922
3404-001,2016,11,26,15,525,419,944,862
3404-001,2016,11,26,16,522,402,924,944
3404-001,2016,11,26,17,567,383,950,924
3404-001,2016,11,26,18,689,457,1146,950
3404-001,2016,11,26,19,534,298,832,1146
3404-001,2016,11,26,20,237,232,469,832
3404-001,2016,11,26,21,153,124,277,469
3404-001,2016,11,26,22,90,111,201,277
3404-001,2016,11,26,23,57,84,141,201
3404-001,2016,11,26,24,32,64,96,141
3404-001,2016,11,27,1,24,63,87,96
3404-001,2016,11,27,2,27,32,59,87
3404-001,2016,11,27,3,5,28,33,59
3404-001,2016,11,27,4,10,16,26,33
3404-001,2016,11,27,5,7,18,25,26
3404-001,2016,11,27,6,19,46,65,25
3404-001,2016,11,27,7,27,153,180,65
3404-001,2016,11,27,8,52,205,257,180
3404-001,2016,11,27,9,171,233,404,257
3404-001,2016,11,27,10,136,200,336,404
3404-001,2016,11,27,11,171,260,431,336
3404-001,2016,11,27,12,199,281,480,431
3404-001,2016,11,27,13,211,295,506,480
3404-001,2016,11,27,14,205,320,525,506
3404-001,2016,11,27,15,325,312,637,525
3404-001,2016,11,27,16,440,284,724,637
3404-001,2016,11,27,17,466,287,753,724
3404-001,2016,11,27,18,515,298,813,753
3404-001,2016,11,27,19,385,240,625,813
3404-001,2016,11,27,20,178,182,360,625
3404-001,2016,11,27,21,134,189,323,360
3404-001,2016,11,27,22,97,208,305,323
3404-001,2016,11,27,23,68,137,205,305
3404-001,2016,11,27,24,30,93,123,205
3404-001,2016,11,28,1,24,60,84,123
3404-001,2016,11,28,2,34,39,73,84
3404-001,2016,11,28,3,27,32,59,73
3404-001,2016,11,28,4,21,32,53,59
3404-001,2016,11,28,5,32,56,88,53
3404-001,2016,11,28,6,56,151,207,88
3404-001,2016,11,28,7,175,420,595,207
3404-001,2016,11,28,8,408,1425,1833,595
3404-001,2016,11,28,9,649,1193,1842,1833
3404-001,2016,11,28,10,518,640,1158,1842
3404-001,2016,11,28,11,564,556,1120,1158
3404-001,2016,11,28,12,586,485,1071,1120
3404-001,2016,11,28,13,476,471,947,1071
3404-001,2016,11,28,14,517,536,1053,947
3404-001,2016,11,28,15,633,611,1244,1053
3404-001,2016,11,28,16,684,576,1260,1244
3404-001,2016,11,28,17,773,505,1278,1260
3404-001,2016,11,28,18,1103,561,1664,1278
3404-001,2016,11,28,19,876,440,1316,1664
3404-001,2016,11,28,20,577,321,898,1316
3404-001,2016,11,28,21,550,233,783,898
3404-001,2016,11,28,22,289,170,459,783
3404-001,2016,11,28,23,136,91,227,459
3404-001,2016,11,28,24,81,78,159,227
3404-001,2016,11,29,1,56,42,98,159
3404-001,2016,11,29,2,56,37,93,98
3404-001,2016,11,29,3,40,34,74,93
3404-001,2016,11,29,4,23,26,49,74
3404-001,2016,11,29,5,38,59,97,49
3404-001,2016,11,29,6,81,138,219,97
3404-001,2016,11,29,7,193,462,655,219
3404-001,2016,11,29,8,481,1575,2056,655
3404-001,2016,11,29,9,698,1297,1995,2056
3404-001,2016,11,29,10,594,649,1243,1995
3404-001,2016,11,29,11,567,636,1203,1243
3404-001,2016,11,29,12,608,528,1136,1203
3404-001,2016,11,29,13,511,461,972,1136
3404-001,2016,11,29,14,396,531,927,972
3404-001,2016,11,29,15,674,514,1188,927
3404-001,2016,11,29,16,695,561,1256,1188
3404-001,2016,11,29,17,747,504,1251,1256
3404-001,2016,11,29,18,1091,583,1674,1251
3404-001,2016,11,29,19,943,376,1319,1674
3404-001,2016,11,29,20,652,309,961,1319
3404-001,2016,11,29,21,564,245,809,961
3404-001,2016,11,29,22,369,201,570,809
3404-001,2016,11,29,23,171,105,276,570
3404-001,2016,11,29,24,86,74,160,276
3404-001,2016,11,30,1,41,55,96,160
3404-001,2016,11,30,2,35,44,79,96
3404-001,2016,11,30,3,18,35,53,79
3404-001,2016,11,30,4,32,44,76,53
3404-001,2016,11,30,5,43,44,87,76
3404-001,2016,11,30,6,70,171,241,87
3404-001,2016,11,30,7,227,504,731,241
3404-001,2016,11,30,8,451,1614,2065,731
3404-001,2016,11,30,9,652,1163,1815,2065
3404-001,2016,11,30,10,536,617,1153,1815
3404-001,2016,11,30,11,619,585,1204,1153
3404-001,2016,11,30,12,668,578,1246,1204
3404-001,2016,11,30,13,446,476,922,1246
3404-001,2016,11,30,14,495,548,1043,922
3404-001,2016,11,30,15,660,546,1206,1043
3404-001,2016,11,30,16,619,508,1127,1206
3404-001,2016,11,30,17,663,481,1144,1127
3404-001,2016,11,30,18,1195,514,1709,1144
3404-001,2016,11,30,19,909,343,1252,1709
3404-001,2016,11,30,20,564,316,880,1252
3404-001,2016,11,30,21,421,223,644,880
3404-001,2016,11,30,22,246,172,418,644
3404-001,2016,11,30,23,114,125,239,418
3404-001,2016,11,30,24,67,67,134,239
3404-001,2016,12,1,1,52,66,118,134
3404-001,2016,12,1,2,34,38,72,118
3404-001,2016,12,1,3,29,35,64,72
3404-001,2016,12,1,4,25,41,66,64
3404-001,2016,12,1,5,40,26,66,66
3404-001,2016,12,1,6,107,137,244,66
3404-001,2016,12,1,7,213,418,631,244
3404-001,2016,12,1,8,459,1543,2002,631
3404-001,2016,12,1,9,690,1172,1862,2002
3404-001,2016,12,1,10,582,598,1180,1862
3404-001,2016,12,1,11,555,548,1103,1180
3404-001,2016,12,1,12,562,504,1066,1103
3404-001,2016,12,1,13,477,450,927,1066
3404-001,2016,12,1,14,578,424,1002,927
3404-001,2016,12,1,15,700,532,1232,1002
3404-001,2016,12,1,16,643,540,1183,1232
3404-001,2016,12,1,17,758,518,1276,1183
3404-001,2016,12,1,18,1166,539,1705,1276
3404-001,2016,12,1,19,920,368,1288,1705
3404-001,2016,12,1,20,595,291,886,1288
3404-001,2016,12,1,21,582,224,806,886
3404-001,2016,12,1,22,273,181,454,806
3404-001,2016,12,1,23,173,109,282,454
3404-001,2016,12,1,24,85,70,155,282
3404-001,2016,12,2,1,59,67,126,155
3404-001,2016,12,2,2,45,41,86,126
3404-001,2016,12,2,3,19,46,65,86
3404-001,2016,12,2,4,25,35,60,65
3404-001,2016,12,2,5,34,38,72,60
3404-001,2016,12,2,6,77,159,236,72
3404-001,2016,12,2,7,180,474,654,236
3404-001,2016,12,2,8,474,1657,2131,654
3404-001,2016,12,2,9,758,1141,1899,2131
3404-001,2016,12,2,10,567,547,1114,1899
3404-001,2016,12,2,11,583,524,1107,1114
3404-001,2016,12,2,12,587,500,1087,1107
3404-001,2016,12,2,13,525,432,957,1087
3404-001,2016,12,2,14,577,446,1023,957
3404-001,2016,12,2,15,583,537,1120,1023
3404-001,2016,12,2,16,841,566,1407,1120
3404-001,2016,12,2,17,884,476,1360,1407
3404-001,2016,12,2,18,1381,559,1940,1360
3404-001,2016,12,2,19,1281,461,1742,1940
3404-001,2016,12,2,20,666,439,1105,1742
3404-001,2016,12,2,21,504,234,738,1105
3404-001,2016,12,2,22,281,183,464,738
3404-001,2016,12,2,23,147,132,279,464
3404-001,2016,12,2,24,82,72,154,279
3404-001,2016,12,3,1,55,64,119,154
3404-001,2016,12,3,2,25,37,62,119
3404-001,2016,12,3,3,27,31,58,62
3404-001,2016,12,3,4,29,30,59,58
3404-001,2016,12,3,5,39,50,89,59
3404-001,2016,12,3,6,62,110,172,89
3404-001,2016,12,3,7,145,330,475,172
3404-001,2016,12,3,8,304,684,988,475
3404-001,2016,12,3,9,558,639,1197,988
3404-001,2016,12,3,10,472,521,993,1197
3404-001,2016,12,3,11,434,518,952,993
3404-001,2016,12,3,12,447,458,905,952
3404-001,2016,12,3,13,414,455,869,905
3404-001,2016,12,3,14,392,448,840,869
3404-001,2016,12,3,15,475,452,927,840
3404-001,2016,12,3,16,580,462,1042,927
3404-001,2016,12,3,17,698,405,1103,1042
3404-001,2016,12,3,18,952,465,1417,1103
3404-001,2016,12,3,19,439,355,794,1417
3404-001,2016,12,3,20,231,217,448,794
3404-001,2016,12,3,21,200,173,373,448
3404-001,2016,12,3,22,110,103,213,373
3404-001,2016,12,3,23,64,94,158,213
3404-001,2016,12,3,24,29,51,80,158
3404-001,2016,12,4,1,39,52,91,80
3404-001,2016,12,4,2,20,42,62,91
3404-001,2016,12,4,3,15,36,51,62
3404-001,2016,12,4,4,14,16,30,51
3404-001,2016,12,4,5,15,28,43,30
3404-001,2016,12,4,6,22,61,83,43
3404-001,2016,12,4,7,50,129,179,83
3404-001,2016,12,4,8,115,212,327,179
3404-001,2016,12,4,9,196,277,473,327
3404-001,2016,12,4,10,152,241,393,473
3404-001,2016,12,4,11,236,288,524,393
3404-001,2016,12,4,12,198,320,518,524
3404-001,2016,12,4,13,230,275,505,518
3404-001,2016,12,4,14,230,340,570,505
3404-001,2016,12,4,15,301,313,614,570
3404-001,2016,12,4,16,424,339,763,614
3404-001,2016,12,4,17,414,275,689,763
3404-001,2016,12,4,18,545,263,808,689
3404-001,2016,12,4,19,269,248,517,808
3404-001,2016,12,4,20,188,197,385,517
3404-001,2016,12,4,21,125,199,324,385
3404-001,2016,12,4,22,90,149,239,324
3404-001,2016,12,4,23,55,129,184,239
3404-001,2016,12,4,24,24,84,108,184
3404-001,2016,12,5,1,17,50,67,108
3404-001,2016,12,5,2,20,32,52,67
3404-001,2016,12,5,3,22,40,62,52
3404-001,2016,12,5,4,17,27,44,62
3404-001,2016,12,5,5,47,53,100,44
3404-001,2016,12,5,6,59,159,218,100
3404-001,2016,12,5,7,196,582,778,218
3404-001,2016,12,5,8,462,1305,1767,778
3404-001,2016,12,5,9,721,1151,1872,1767
3404-001,2016,12,5,10,613,603,1216,1872
3404-001,2016,12,5,11,492,582,1074,1216
3404-001,2016,12,5,12,515,544,1059,1074
3404-001,2016,12,5,13,480,511,991,1059
3404-001,2016,12,5,14,567,569,1136,991
3404-001,2016,12,5,15,686,537,1223,1136
3404-001,2016,12,5,16,811,581,1392,1223
3404-001,2016,12,5,17,768,503,1271,1392
3404-001,2016,12,5,18,908,456,1364,1271
3404-001,2016,12,5,19,872,386,1258,1364
3404-001,2016,12,5,20,512,289,801,1258
3404-001,2016,12,5,21,557,229,786,801
3404-001,2016,12,5,22,286,170,456,786
3404-001,2016,12,5,23,158,112,270,456
3404-001,2016,12,5,24,65,65,130,270
3404-001,2016,12,6,1,35,62,97,130
3404-001,2016,12,6,2,20,32,52,97
3404-001,2016,12,6,3,22,28,50,52
3404-001,2016,12,6,4,25,30,55,50
3404-001,2016,12,6,5,40,41,81,55
3404-001,2016,12,6,6,95,147,242,81
3404-001,2016,12,6,7,228,504,732,242
3404-001,2016,12,6,8,529,1625,2154,732
3404-001,2016,12,6,9,700,1140,1840,2154
3404-001,2016,12,6,10,568,606,1174,1840
3404-001,2016,12,6,11,618,520,1138,1174
3404-001,2016,12,6,12,658,568,1226,1138
3404-001,2016,12,6,13,474,381,855,1226
3404-001,2016,12,6,14,505,477,982,855
3404-001,2016,12,6,15,693,528,1221,982
3404-001,2016,12,6,16,636,527,1163,1221
3404-001,2016,12,6,17,731,470,1201,1163
3404-001,2016,12,6,18,1051,487,1538,1201
3404-001,2016,12,6,19,924,376,1300,1538
3404-001,2016,12,6,20,578,304,882,1300
3404-001,2016,12,6,21,535,230,765,882
3404-001,2016,12,6,22,260,190,450,765
3404-001,2016,12,6,23,173,110,283,450
3404-001,2016,12,6,24,64,69,133,283
3404-001,2016,12,7,1,69,65,134,133
3404-001,2016,12,7,2,27,41,68,134
3404-001,2016,12,7,3,17,38,55,68
3404-001,2016,12,7,4,40,35,75,55
3404-001,2016,12,7,5,29,31,60,75
3404-001,2016,12,7,6,74,141,215,60
3404-001,2016,12,7,7,205,470,675,215
3404-001,2016,12,7,8,497,1497,1994,675
3404-001,2016,12,7,9,733,1259,1992,1994
3404-001,2016,12,7,10,633,646,1279,1992
3404-001,2016,12,7,11,641,615,1256,1279
3404-001,2016,12,7,12,595,545,1140,1256
3404-001,2016,12,7,13,495,462,957,1140
3404-001,2016,12,7,14,598,561,1159,957
3404-001,2016,12,7,15,680,527,1207,1159
3404-001,2016,12,7,16,734,514,1248,1207
3404-001,2016,12,7,17,766,516,1282,1248
3404-001,2016,12,7,18,1252,462,1714,1282
3404-001,2016,12,7,19,975,410,1385,1714
3404-001,2016,12,7,20,543,326,869,1385
3404-001,2016,12,7,21,460,202,662,869
3404-001,2016,12,7,22,250,175,425,662
3404-001,2016,12,7,23,137,99,236,425
3404-001,2016,12,7,24,69,91,160,236
3404-001,2016,12,8,1,32,64,96,160
3404-001,2016,12,8,2,35,36,71,96
3404-001,2016,12,8,3,19,42,61,71
3404-001,2016,12,8,4,29,23,52,61
3404-001,2016,12,8,5,27,43,70,52
3404-001,2016,12,8,6,75,127,202,70
3404-001,2016,12,8,7,200,496,696,202
3404-001,2016,12,8,8,462,1542,2004,696
3404-001,2016,12,8,9,758,1191,1949,2004
3404-001,2016,12,8,10,607,603,1210,1949
3404-001,2016,12,8,11,633,586,1219,1210
3404-001,2016,12,8,12,759,465,1224,1219
3404-001,2016,12,8,13,533,463,996,1224
3404-001,2016,12,8,14,510,577,1087,996
3404-001,2016,12,8,15,695,524,1219,1087
3404-001,2016,12,8,16,824,648,1472,1219
3404-001,2016,12,8,17,796,528,1324,1472
3404-001,2016,12,8,18,1165,490,1655,1324
3404-001,2016,12,8,19,902,379,1281,1655
3404-001,2016,12,8,20,543,292,835,1281
3404-001,2016,12,8,21,558,220,778,835
3404-001,2016,12,8,22,294,158,452,778
3404-001,2016,12,8,23,123,99,222,452
3404-001,2016,12,8,24,77,56,133,222
3404-001,2016,12,9,1,44,37,81,133
3404-001,2016,12,9,2,62,28,90,81
3404-001,2016,12,9,3,25,24,49,90
3404-001,2016,12,9,4,20,18,38,49
3404-001,2016,12,9,5,34,31,65,38
3404-001,2016,12,9,6,60,132,192,65
3404-001,2016,12,9,7,218,407,625,192
3404-001,2016,12,9,8,460,1400,1860,625
3404-001,2016,12,9,9,631,1090,1721,1860
3404-001,2016,12,9,10,542,562,1104,1721
3404-001,2016,12,9,11,628,509,1137,1104
3404-001,2016,12,9,12,605,554,1159,1137
3404-001,2016,12,9,13,460,503,963,1159
3404-001,2016,12,9,14,533,490,1023,963
3404-001,2016,12,9,15,724,587,1311,1023
3404-001,2016,12,9,16,728,495,1223,1311
3404-001,2016,12,9,17,881,533,1414,1223
3404-001,2016,12,9,18,1150,567,1717,1414
3404-001,2016,12,9,19,1131,503,1634,1717
3404-001,2016,12,9,20,603,398,1001,1634
3404-001,2016,12,9,21,442,245,687,1001
3404-001,2016,12,9,22,256,162,418,687
3404-001,2016,12,9,23,148,120,268,418
3404-001,2016,12,9,24,59,82,141,268
3404-001,2016,12,10,1,77,53,130,141
3404-001,2016,12,10,2,37,32,69,130
3404-001,2016,12,10,3,20,26,46,69
3404-001,2016,12,10,4,19,27,46,46
3404-001,2016,12,10,5,34,55,89,46
3404-001,2016,12,10,6,84,94,178,89
3404-001,2016,12,10,7,140,265,405,178
3404-001,2016,12,10,8,269,565,834,405
3404-001,2016,12,10,9,445,558,1003,834
3404-001,2016,12,10,10,416,474,890,1003
3404-001,2016,12,10,11,452,475,927,890
3404-001,2016,12,10,12,452,450,902,927
3404-001,2016,12,10,13,394,399,793,902
3404-001,2016,12,10,14,362,461,823,793
3404-001,2016,12,10,15,529,400,929,823
3404-001,2016,12,10,16,520,417,937,929
3404-001,2016,12,10,17,621,412,1033,937
3404-001,2016,12,10,18,908,433,1341,1033
3404-001,2016,12,10,19,336,270,606,1341
3404-001,2016,12,10,20,234,224,458,606
3404-001,2016,12,10,21,176,148,324,458
3404-001,2016,12,10,22,100,107,207,324
3404-001,2016,12,10,23,60,89,149,207
3404-001,2016,12,10,24,30,58,88,149
3404-001,2016,12,11,1,34,41,75,88
3404-001,2016,12,11,2,27,42,69,75
3404-001,2016,12,11,3,15,23,38,69
3404-001,2016,12,11,4,5,22,27,38
3404-001,2016,12,11,5,14,42,56,27
3404-001,2016,12,11,6,34,42,76,56
3404-001,2016,12,11,7,54,100,154,76
3404-001,2016,12,11,8,84,190,274,154
3404-001,2016,12,11,9,147,254,401,274
3404-001,2016,12,11,10,160,200,360,401
3404-001,2016,12,11,11,188,283,471,360
3404-001,2016,12,11,12,177,304,481,471
3404-001,2016,12,11,13,243,273,516,481
3404-001,2016,12,11,14,223,306,529,516
3404-001,2016,12,11,15,283,296,579,529
3404-001,2016,12,11,16,329,296,625,579
3404-001,2016,12,11,17,393,254,647,625
3404-001,2016,12,11,18,399,278,677,647
3404-001,2016,12,11,19,266,228,494,677
3404-001,2016,12,11,20,155,211,366,494
3404-001,2016,12,11,21,118,195,313,366
3404-001,2016,12,11,22,85,180,265,313
3404-001,2016,12,11,23,65,125,190,265
3404-001,2016,12,11,24,37,66,103,190
3404-001,2016,12,12,1,35,60,95,103
3404-001,2016,12,12,2,14,28,42,95
3404-001,2016,12,12,3,4,41,45,42
3404-001,2016,12,12,4,14,30,44,45
3404-001,2016,12,12,5,22,36,58,44
3404-001,2016,12,12,6,72,171,243,58
3404-001,2016,12,12,7,188,523,711,243
3404-001,2016,12,12,8,460,1660,2120,711
3404-001,2016,12,12,9,617,1198,1815,2120
3404-001,2016,12,12,10,437,537,974,1815
3404-001,2016,12,12,11,550,532,1082,974
3404-001,2016,12,12,12,520,500,1020,1082
3404-001,2016,12,12,13,499,445,944,1020
3404-001,2016,12,12,14,537,506,1043,944
3404-001,2016,12,12,15,714,606,1320,1043
3404-001,2016,12,12,16,729,554,1283,1320
3404-001,2016,12,12,17,729,557,1286,1283
3404-001,2016,12,12,18,1027,421,1448,1286
3404-001,2016,12,12,19,856,390,1246,1448
3404-001,2016,12,12,20,558,277,835,1246
3404-001,2016,12,12,21,578,249,827,835
3404-001,2016,12,12,22,346,181,527,827
3404-001,2016,12,12,23,153,98,251,527
3404-001,2016,12,12,24,74,69,143,251
3404-001,2016,12,13,1,50,55,105,143
3404-001,2016,12,13,2,30,36,66,105
3404-001,2016,12,13,3,12,24,36,66
3404-001,2016,12,13,4,15,38,53,36
3404-001,2016,12,13,5,37,53,90,53
3404-001,2016,12,13,6,75,142,217,90
3404-001,2016,12,13,7,177,427,604,217
3404-001,2016,12,13,8,464,1577,2041,604
3404-001,2016,12,13,9,768,1223,1991,2041
3404-001,2016,12,13,10,547,607,1154,1991
3404-001,2016,12,13,11,552,554,1106,1154
3404-001,2016,12,13,12,568,563,1131,1106
3404-001,2016,12,13,13,482,470,952,1131
3404-001,2016,12,13,14,598,485,1083,952
3404-001,2016,12,13,15,603,515,1118,1083
3404-001,2016,12,13,16,680,518,1198,1118
3404-001,2016,12,13,17,709,452,1161,1198
3404-001,2016,12,13,18,1062,509,1571,1161
3404-001,2016,12,13,19,856,354,1210,1571
3404-001,2016,12,13,20,573,289,862,1210
3404-001,2016,12,13,21,553,230,783,862
3404-001,2016,12,13,22,293,148,441,783
3404-001,2016,12,13,23,157,109,266,441
3404-001,2016,12,13,24,70,65,135,266
3404-001,2016,12,14,1,49,45,94,135
3404-001,2016,12,14,2,29,50,79,94
3404-001,2016,12,14,3,29,30,59,79
3404-001,2016,12,14,4,15,21,36,59
3404-001,2016,12,14,5,27,31,58,36
3404-001,2016,12,14,6,89,133,222,58
3404-001,2016,12,14,7,203,399,602,222
3404-001,2016,12,14,8,460,1525,1985,602
3404-001,2016,12,14,9,685,1158,1843,1985
3404-001,2016,12,14,10,517,617,1134,1843
3404-001,2016,12,14,11,540,532,1072,1134
3404-001,2016,12,14,12,532,588,1120,1072
3404-001,2016,12,14,13,474,426,900,1120
3404-001,2016,12,14,14,509,540,1049,900
3404-001,2016,12,14,15,648,542,1190,1049
3404-001,2016,12,14,16,691,496,1187,1190
3404-001,2016,12,14,17,759,470,1229,1187
3404-001,2016,12,14,18,1168,475,1643,1229
3404-001,2016,12,14,19,907,369,1276,1643
3404-001,2016,12,14,20,457,293,750,1276
3404-001,2016,12,14,21,454,240,694,750
3404-001,2016,12,14,22,266,176,442,694
3404-001,2016,12,14,23,163,86,249,442
3404-001,2016,12,14,24,87,70,157,249
3404-001,2016,12,15,1,42,62,104,157
3404-001,2016,12,15,2,32,37,69,104
3404-001,2016,12,15,3,15,30,45,69
3404-001,2016,12,15,4,32,35,67,45
3404-001,2016,12,15,5,19,38,57,67
3404-001,2016,12,15,6,74,108,182,57
3404-001,2016,12,15,7,165,424,589,182
3404-001,2016,12,15,8,474,1547,2021,589
3404-001,2016,12,15,9,753,1203,1956,2021
3404-001,2016,12,15,10,565,610,1175,1956
3404-001,2016,12,15,11,570,529,1099,1175
3404-001,2016,12,15,12,590,481,1071,1099
3404-001,2016,12,15,13,524,466,990,1071
3404-001,2016,12,15,14,578,558,1136,990
3404-001,2016,12,15,15,656,590,1246,1136
3404-001,2016,12,15,16,714,561,1275,1246
3404-001,2016,12,15,17,806,485,1291,1275
3404-001,2016,12,15,18,1075,506,1581,1291
3404-001,2016,12,15,19,905,379,1284,1581
3404-001,2016,12,15,20,558,317,875,1284
3404-001,2016,12,15,21,538,240,778,875
3404-001,2016,12,15,22,308,181,489,778
3404-001,2016,12,15,23,143,94,237,489
3404-001,2016,12,15,24,74,64,138,237
3404-001,2016,12,16,1,45,69,114,138
3404-001,2016,12,16,2,27,43,70,114
3404-001,2016,12,16,3,24,38,62,70
3404-001,2016,12,16,4,15,31,46,62
3404-001,2016,12,16,5,35,26,61,46
3404-001,2016,12,16,6,72,115,187,61
3404-001,2016,12,16,7,173,431,604,187
3404-001,2016,12,16,8,389,1518,1907,604
3404-001,2016,12,16,9,631,1087,1718,1907
3404-001,2016,12,16,10,625,592,1217,1718
3404-001,2016,12,16,11,643,540,1183,1217
3404-001,2016,12,16,12,575,558,1133,1183
3404-001,2016,12,16,13,527,496,1023,1133
3404-001,2016,12,16,14,445,499,944,1023
3404-001,2016,12,16,15,759,497,1256,944
3404-001,2016,12,16,16,701,499,1200,1256
3404-001,2016,12,16,17,764,547,1311,1200
3404-001,2016,12,16,18,1187,494,1681,1311
3404-001,2016,12,16,19,1075,496,1571,1681
3404-001,2016,12,16,20,613,328,941,1571
3404-001,2016,12,16,21,462,236,698,941
3404-001,2016,12,16,22,284,163,447,698
3404-001,2016,12,16,23,117,123,240,447
3404-001,2016,12,16,24,85,80,165,240
3404-001,2016,12,17,1,47,61,108,165
3404-001,2016,12,17,2,50,53,103,108
3404-001,2016,12,17,3,27,35,62,103
3404-001,2016,12,17,4,22,30,52,62
3404-001,2016,12,17,5,44,43,87,52
3404-001,2016,12,17,6,59,98,157,87
3404-001,2016,12,17,7,117,253,370,157
3404-001,2016,12,17,8,269,582,851,370
3404-001,2016,12,17,9,449,595,1044,851
3404-001,2016,12,17,10,470,445,915,1044
3404-001,2016,12,17,11,479,525,1004,915
3404-001,2016,12,17,12,432,528,960,1004
3404-001,2016,12,17,13,422,556,978,960
3404-001,2016,12,17,14,450,510,960,978
3404-001,2016,12,17,15,543,492,1035,960
3404-001,2016,12,17,16,612,521,1133,1035
3404-001,2016,12,17,17,641,394,1035,1133
3404-001,2016,12,17,18,780,486,1266,1035
3404-001,2016,12,17,19,457,312,769,1266
3404-001,2016,12,17,20,185,230,415,769
3404-001,2016,12,17,21,167,125,292,415
3404-001,2016,12,17,22,118,134,252,292
3404-001,2016,12,17,23,70,94,164,252
3404-001,2016,12,17,24,49,67,116,164
3404-001,2016,12,18,1,29,52,81,116
3404-001,2016,12,18,2,17,36,53,81
3404-001,2016,12,18,3,19,21,40,53
3404-001,2016,12,18,4,10,28,38,40
3404-001,2016,12,18,5,14,19,33,38
3404-001,2016,12,18,6,15,56,71,33
3404-001,2016,12,18,7,67,146,213,71
3404-001,2016,12,18,8,125,220,345,213
3404-001,2016,12,18,9,235,293,528,345
3404-001,2016,12,18,10,208,270,478,528
3404-001,2016,12,18,11,274,289,563,478
3404-001,2016,12,18,12,309,332,641,563
3404-001,2016,12,18,13,221,323,544,641
3404-001,2016,12,18,14,284,339,623,544
3404-001,2016,12,18,15,367,345,712,623
3404-001,2016,12,18,16,394,346,740,712
3404-001,2016,12,18,17,386,301,687,740
3404-001,2016,12,18,18,439,337,776,687
3404-001,2016,12,18,19,203,254,457,776
3404-001,2016,12,18,20,193,199,392,457
3404-001,2016,12,18,21,103,185,288,392
3404-001,2016,12,18,22,87,149,236,288
3404-001,2016,12,18,23,67,113,180,236
3404-001,2016,12,18,24,30,99,129,180
3404-001,2016,12,19,1,19,66,85,129
3404-001,2016,12,19,2,15,28,43,85
3404-001,2016,12,19,3,29,18,47,43
3404-001,2016,12,19,4,12,22,34,47
3404-001,2016,12,19,5,22,27,49,34
3404-001,2016,12,19,6,55,112,167,49
3404-001,2016,12,19,7,160,413,573,167
3404-001,2016,12,19,8,394,1480,1874,573
3404-001,2016,12,19,9,675,1181,1856,1874
3404-001,2016,12,19,10,492,471,963,1856
3404-001,2016,12,19,11,510,514,1024,963
3404-001,2016,12,19,12,613,468,1081,1024
3404-001,2016,12,19,13,417,436,853,1081
3404-001,2016,12,19,14,460,513,973,853
3404-001,2016,12,19,15,698,508,1206,973
3404-001,2016,12,19,16,628,492,1120,1206
3404-001,2016,12,19,17,705,442,1147,1120
3404-001,2016,12,19,18,983,450,1433,1147
3404-001,2016,12,19,19,895,381,1276,1433
3404-001,2016,12,19,20,490,301,791,1276
3404-001,2016,12,19,21,553,211,764,791
3404-001,2016,12,19,22,309,159,468,764
3404-001,2016,12,19,23,160,106,266,468
3404-001,2016,12,19,24,74,65,139,266
3404-001,2016,12,20,1,45,45,90,139
3404-001,2016,12,20,2,47,22,69,90
3404-001,2016,12,20,3,30,22,52,69
3404-001,2016,12,20,4,20,22,42,52
3404-001,2016,12,20,5,35,22,57,42
3404-001,2016,12,20,6,59,98,157,57
3404-001,2016,12,20,7,191,413,604,157
3404-001,2016,12,20,8,424,1388,1812,604
3404-001,2016,12,20,9,663,1132,1795,1812
3404-001,2016,12,20,10,502,549,1051,1795
3404-001,2016,12,20,11,504,535,1039,1051
3404-001,2016,12,20,12,517,529,1046,1039
3404-001,2016,12,20,13,465,417,882,1046
3404-001,2016,12,20,14,529,527,1056,882
3404-001,2016,12,20,15,646,566,1212,1056
3404-001,2016,12,20,16,733,513,1246,1212
3404-001,2016,12,20,17,731,529,1260,1246
3404-001,2016,12,20,18,1049,495,1544,1260
3404-001,2016,12,20,19,957,416,1373,1544
3404-001,2016,12,20,20,563,316,879,1373
3404-001,2016,12,20,21,575,217,792,879
3404-001,2016,12,20,22,279,156,435,792
3404-001,2016,12,20,23,152,120,272,435
3404-001,2016,12,20,24,69,81,150,272
3404-001,2016,12,21,1,59,50,109,150
3404-001,2016,12,21,2,35,40,75,109
3404-001,2016,12,21,3,25,37,62,75
3404-001,2016,12,21,4,27,36,63,62
3404-001,2016,12,21,5,25,31,56,63
3404-001,2016,12,21,6,72,137,209,56
3404-001,2016,12,21,7,188,405,593,209
3404-001,2016,12,21,8,419,1523,1942,593
3404-001,2016,12,21,9,764,1167,1931,1942
3404-001,2016,12,21,10,575,622,1197,1931
3404-001,2016,12,21,11,636,603,1239,1197
3404-001,2016,12,21,12,558,482,1040,1239
3404-001,2016,12,21,13,447,445,892,1040
3404-001,2016,12,21,14,552,515,1067,892
3404-001,2016,12,21,15,653,544,1197,1067
3404-001,2016,12,21,16,768,500,1268,1197
3404-001,2016,12,21,17,721,468,1189,1268
3404-001,2016,12,21,18,1072,394,1466,1189
3404-001,2016,12,21,19,905,385,1290,1466
3404-001,2016,12,21,20,499,288,787,1290
3404-001,2016,12,21,21,399,175,574,787
3404-001,2016,12,21,22,230,156,386,574
3404-001,2016,12,21,23,112,85,197,386
3404-001,2016,12,21,24,64,55,119,197
3404-001,2016,12,22,1,45,48,93,119
3404-001,2016,12,22,2,32,24,56,93
3404-001,2016,12,22,3,19,24,43,56
3404-001,2016,12,22,4,10,23,33,43
3404-001,2016,12,22,5,19,18,37,33
3404-001,2016,12,22,6,52,89,141,37
3404-001,2016,12,22,7,150,322,472,141
3404-001,2016,12,22,8,386,1333,1719,472
3404-001,2016,12,22,9,696,1070,1766,1719
3404-001,2016,12,22,10,522,534,1056,1766
3404-001,2016,12,22,11,482,538,1020,1056
3404-001,2016,12,22,12,497,510,1007,1020
3404-001,2016,12,22,13,416,404,820,1007
3404-001,2016,12,22,14,469,424,893,820
3404-001,2016,12,22,15,557,461,1018,893
3404-001,2016,12,22,16,578,410,988,1018
3404-001,2016,12,22,17,578,419,997,988
3404-001,2016,12,22,18,945,395,1340,997
3404-001,2016,12,22,19,842,328,1170,1340
3404-001,2016,12,22,20,469,268,737,1170
3404-001,2016,12,22,21,472,197,669,737
3404-001,2016,12,22,22,240,152,392,669
3404-001,2016,12,22,23,110,115,225,392
3404-001,2016,12,22,24,65,79,144,225
3404-001,2016,12,23,1,57,62,119,144
3404-001,2016,12,23,2,32,37,69,119
3404-001,2016,12,23,3,25,26,51,69
3404-001,2016,12,23,4,22,30,52,51
3404-001,2016,12,23,5,27,38,65,52
3404-001,2016,12,23,6,54,91,145,65
3404-001,2016,12,23,7,138,291,429,145
3404-001,2016,12,23,8,324,1279,1603,429
3404-001,2016,12,23,9,568,1023,1591,1603
3404-001,2016,12,23,10,318,330,648,1591
3404-001,2016,12,23,11,351,489,840,648
3404-001,2016,12,23,12,422,412,834,840
3404-001,2016,12,23,13,470,383,853,834
3404-001,2016,12,23,14,530,386,916,853
3404-001,2016,12,23,15,542,399,941,916
3404-001,2016,12,23,16,648,413,1061,941
3404-001,2016,12,23,17,648,413,1061,1061
3404-001,2016,12,23,18,977,414,1391,1061
3404-001,2016,12,23,19,947,390,1337,1391
3404-001,2016,12,23,20,497,297,794,1337
3404-001,2016,12,23,21,416,206,622,794
3404-001,2016,12,23,22,236,134,370,622
3404-001,2016,12,23,23,82,90,172,370
3404-001,2016,12,23,24,54,72,126,172
3404-001,2016,12,24,1,55,70,125,126
3404-001,2016,12,24,2,45,48,93,125
3404-001,2016,12,24,3,34,30,64,93
3404-001,2016,12,24,4,15,28,43,64
3404-001,2016,12,24,5,24,27,51,43
3404-001,2016,12,24,6,54,62,116,51
3404-001,2016,12,24,7,87,205,292,116
3404-001,2016,12,24,8,281,398,679,292
3404-001,2016,12,24,9,426,416,842,679
3404-001,2016,12,24,10,338,315,653,842
3404-001,2016,12,24,11,424,393,817,653
3404-001,2016,12,24,12,429,422,851,817
3404-001,2016,12,24,13,364,318,682,851
3404-001,2016,12,24,14,406,335,741,682
3404-001,2016,12,24,15,409,357,766,741
3404-001,2016,12,24,16,417,349,766,766
3404-001,2016,12,24,17,457,366,823,766
3404-001,2016,12,24,18,595,365,960,823
3404-001,2016,12,24,19,357,250,607,960
3404-001,2016,12,24,20,177,188,365,607
3404-001,2016,12,24,21,140,129,269,365
3404-001,2016,12,24,22,82,122,204,269
3404-001,2016,12,24,23,42,66,108,204
3404-001,2016,12,24,24,47,75,122,108
3404-001,2016,12,25,1,34,48,82,122
3404-001,2016,12,25,2,20,42,62,82
3404-001,2016,12,25,3,10,28,38,62
3404-001,2016,12,25,4,4,28,32,38
3404-001,2016,12,25,5,10,22,32,32
3404-001,2016,12,25,6,19,36,55,32
3404-001,2016,12,25,7,39,98,137,55
3404-001,2016,12,25,8,85,157,242,137
3404-001,2016,12,25,9,170,154,324,242
3404-001,2016,12,25,10,148,149,297,324
3404-001,2016,12,25,11,181,226,407,297
3404-001,2016,12,25,12,208,270,478,407
3404-001,2016,12,25,13,181,246,427,478
3404-001,2016,12,25,14,250,332,582,427
3404-001,2016,12,25,15,321,310,631,582
3404-001,2016,12,25,16,366,333,699,631
3404-001,2016,12,25,17,395,279,674,699
3404-001,2016,12,25,18,384,248,632,674
3404-001,2016,12,25,19,223,226,449,632
3404-001,2016,12,25,20,133,187,320,449
3404-001,2016,12,25,21,120,164,284,320
3404-001,2016,12,25,22,62,164,226,284
3404-001,2016,12,25,23,54,120,174,226
3404-001,2016,12,25,24,35,76,111,174
3404-001,2016,12,26,1,20,51,71,111
3404-001,2016,12,26,2,20,23,43,71
3404-001,2016,12,26,3,4,23,27,43
3404-001,2016,12,26,4,12,17,29,27
3404-001,2016,12,26,5,35,32,67,29
3404-001,2016,12,26,6,77,114,191,67
3404-001,2016,12,26,7,183,434,617,191
3404-001,2016,12,26,8,479,1544,2023,617
3404-001,2016,12,26,9,701,1124,1825,2023
3404-001,2016,12,26,10,560,553,1113,1825
3404-001,2016,12,26,11,552,513,1065,1113
3404-001,2016,12,26,12,603,443,1046,1065
3404-001,2016,12,26,13,524,403,927,1046
3404-001,2016,12,26,14,525,566,1091,927
3404-001,2016,12,26,15,497,474,971,1091
3404-001,2016,12,26,16,631,457,1088,971
3404-001,2016,12,26,17,648,450,1098,1088
3404-001,2016,12,26,18,956,380,1336,1098
3404-001,2016,12,26,19,786,373,1159,1336
3404-001,2016,12,26,20,441,277,718,1159
3404-001,2016,12,26,21,467,193,660,718
3404-001,2016,12,26,22,273,157,430,660
3404-001,2016,12,26,23,155,90,245,430
3404-001,2016,12,26,24,80,61,141,245
3404-001,2016,12,27,1,69,56,125,141
3404-001,2016,12,27,2,39,45,84,125
3404-001,2016,12,27,3,22,26,48,84
3404-001,2016,12,27,4,22,24,46,48
3404-001,2016,12,27,5,24,36,60,46
3404-001,2016,12,27,6,75,113,188,60
3404-001,2016,12,27,7,143,383,526,188
3404-001,2016,12,27,8,409,1454,1863,526
3404-001,2016,12,27,9,660,1121,1781,1863
3404-001,2016,12,27,10,457,574,1031,1781
3404-001,2016,12,27,11,482,497,979,1031
3404-001,2016,12,27,12,507,442,949,979
3404-001,2016,12,27,13,427,452,879,949
3404-001,2016,12,27,14,487,468,955,879
3404-001,2016,12,27,15,572,439,1011,955
3404-001,2016,12,27,16,605,441,1046,1011
3404-001,2016,12,27,17,648,410,1058,1046
3404-001,2016,12,27,18,981,433,1414,1058
3404-001,2016,12,27,19,834,370,1204,1414
3404-001,2016,12,27,20,492,269,761,1204
3404-001,2016,12,27,21,557,199,756,761
3404-001,2016,12,27,22,278,129,407,756
3404-001,2016,12,27,23,132,123,255,407
3404-001,2016,12,27,24,72,62,134,255
3404-001,2016,12,28,1,37,56,93,134
3404-001,2016,12,28,2,34,33,67,93
3404-001,2016,12,28,3,17,26,43,67
3404-001,2016,12,28,4,22,32,54,43
3404-001,2016,12,28,5,42,37,79,54
3404-001,2016,12,28,6,47,108,155,79
3404-001,2016,12,28,7,160,346,506,155
3404-001,2016,12,28,8,439,1480,1919,506
3404-001,2016,12,28,9,673,1128,1801,1919
3404-001,2016,12,28,10,573,539,1112,1801
3404-001,2016,12,28,11,595,592,1187,1112
3404-001,2016,12,28,12,578,436,1014,1187
3404-001,2016,12,28,13,505,407,912,1014
3404-001,2016,12,28,14,557,442,999,912
3404-001,2016,12,28,15,681,492,1173,999
3404-001,2016,12,28,16,764,442,1206,1173
3404-001,2016,12,28,17,783,427,1210,1206
3404-001,2016,12,28,18,1197,465,1662,1210
3404-001,2016,12,28,19,942,379,1321,1662
3404-001,2016,12,28,20,533,272,805,1321
3404-001,2016,12,28,21,437,199,636,805
3404-001,2016,12,28,22,225,147,372,636
3404-001,2016,12,28,23,137,110,247,372
3404-001,2016,12,28,24,82,70,152,247
3404-001,2016,12,29,1,54,50,104,152
3404-001,2016,12,29,2,34,45,79,104
3404-001,2016,12,29,3,20,40,60,79
3404-001,2016,12,29,4,15,24,39,60
3404-001,2016,12,29,5,27,26,53,39
3404-001,2016,12,29,6,20,81,101,53
3404-001,2016,12,29,7,74,321,395,101
3404-001,2016,12,29,8,291,1222,1513,395
3404-001,2016,12,29,9,553,1107,1660,1513
3404-001,2016,12,29,10,409,538,947,1660
3404-001,2016,12,29,11,553,455,1008,947
3404-001,2016,12,29,12,427,359,786,1008
3404-001,2016,12,29,13,477,334,811,786
3404-001,2016,12,29,14,555,388,943,811
3404-001,2016,12,29,15,620,485,1105,943
3404-001,2016,12,29,16,729,484,1213,1105
3404-001,2016,12,29,17,724,475,1199,1213
3404-001,2016,12,29,18,972,456,1428,1199
3404-001,2016,12,29,19,872,326,1198,1428
3404-001,2016,12,29,20,519,296,815,1198
3404-001,2016,12,29,21,533,193,726,815
3404-001,2016,12,29,22,256,162,418,726
3404-001,2016,12,29,23,142,112,254,418
3404-001,2016,12,29,24,49,70,119,254
3404-001,2016,12,30,1,57,66,123,119
3404-001,2016,12,30,2,35,47,82,123
3404-001,2016,12,30,3,14,27,41,82
3404-001,2016,12,30,4,22,21,43,41
3404-001,2016,12,30,5,30,27,57,43
3404-001,2016,12,30,6,59,89,148,57
3404-001,2016,12,30,7,138,342,480,148
3404-001,2016,12,30,8,359,1259,1618,480
3404-001,2016,12,30,9,650,1002,1652,1618
3404-001,2016,12,30,10,469,447,916,1652
3404-001,2016,12,30,11,570,462,1032,916
3404-001,2016,12,30,12,582,480,1062,1032
3404-001,2016,12,30,13,563,352,915,1062
3404-001,2016,12,30,14,520,439,959,915
3404-001,2016,12,30,15,724,437,1161,959
3404-001,2016,12,30,16,804,494,1298,1161
3404-001,2016,12,30,17,942,519,1461,1298
3404-001,2016,12,30,18,1160,467,1627,1461
3404-001,2016,12,30,19,949,438,1387,1627
3404-001,2016,12,30,20,514,289,803,1387
3404-001,2016,12,30,21,362,190,552,803
3404-001,2016,12,30,22,233,147,380,552
3404-001,2016,12,30,23,108,103,211,380
3404-001,2016,12,30,24,77,65,142,211
3404-001,2016,12,31,1,30,77,107,142
3404-001,2016,12,31,2,20,35,55,107
3404-001,2016,12,31,3,19,32,51,55
3404-001,2016,12,31,4,19,23,42,51
3404-001,2016,12,31,5,24,23,47,42
3404-001,2016,12,31,6,45,56,101,47
3404-001,2016,12,31,7,85,139,224,101
3404-001,2016,12,31,8,178,337,515,224
3404-001,2016,12,31,9,318,403,721,515
3404-001,2016,12,31,10,372,322,694,721
3404-001,2016,12,31,11,401,345,746,694
3404-001,2016,12,31,12,364,405,769,746
3404-001,2016,12,31,13,419,413,832,769
3404-001,2016,12,31,14,389,383,772,832
3404-001,2016,12,31,15,469,455,924,772
3404-001,2016,12,31,16,494,370,864,924
3404-001,2016,12,31,17,447,381,828,864
3404-001,2016,12,31,18,499,315,814,828
3404-001,2016,12,31,19,289,248,537,814
3404-001,2016,12,31,20,168,200,368,537
3404-001,2016,12,31,21,127,119,246,368
3404-001,2016,12,31,22,113,129,242,246
3404-001,2016,12,31,23,47,81,128,242
3404-001,2016,12,31,24,39,46,85,128
3404-001,2017,1,1,1,82,75,157,85
3404-001,2017,1,1,2,76,69,145,157
3404-001,2017,1,1,3,41,48,89,145
3404-001,2017,1,1,4,30,35,65,89
3404-001,2017,1,1,5,27,53,80,65
3404-001,2017,1,1,6,55,94,149,80
3404-001,2017,1,1,7,58,125,183,149
3404-001,2017,1,1,8,85,176,261,183
3404-001,2017,1,1,9,208,188,396,261
3404-001,2017,1,1,10,245,193,438,396
3404-001,2017,1,1,11,290,274,564,438
3404-001,2017,1,1,12,326,379,705,564
3404-001,2017,1,1,13,285,389,674,705
3404-001,2017,1,1,14,317,342,659,674
3404-001,2017,1,1,15,354,366,720,659
3404-001,2017,1,1,16,418,336,754,720
3404-001,2017,1,1,17,442,299,741,754
3404-001,2017,1,1,18,407,252,659,741
3404-001,2017,1,1,19,311,210,521,659
3404-001,2017,1,1,20,219,178,397,521
3404-001,2017,1,1,21,180,132,312,397
3404-001,2017,1,1,22,117,123,240,312
3404-001,2017,1,1,23,73,77,150,240
3404-001,2017,1,1,24,45,64,109,150
3404-001,2017,1,2,1,36,65,101,109
3404-001,2017,1,2,2,26,51,77,101
3404-001,2017,1,2,3,21,31,52,77
3404-001,2017,1,2,4,17,38,55,52
3404-001,2017,1,2,5,47,59,106,55
3404-001,2017,1,2,6,98,212,310,106
3404-001,2017,1,2,7,195,585,780,310
3404-001,2017,1,2,8,435,1874,2309,780
3404-001,2017,1,2,9,606,1308,1914,2309
3404-001,2017,1,2,10,584,654,1238,1914
3404-001,2017,1,2,11,639,661,1300,1238
3404-001,2017,1,2,12,643,659,1302,1300
3404-001,2017,1,2,13,571,530,1101,1302
3404-001,2017,1,2,14,611,645,1256,1101
3404-001,2017,1,2,15,726,729,1455,1256
3404-001,2017,1,2,16,743,634,1377,1455
3404-001,2017,1,2,17,755,579,1334,1377
3404-001,2017,1,2,18,1079,518,1597,1334
3404-001,2017,1,2,19,937,430,1367,1597
3404-001,2017,1,2,20,688,357,1045,1367
3404-001,2017,1,2,21,653,239,892,1045
3404-001,2017,1,2,22,343,177,520,892
3404-001,2017,1,2,23,180,117,297,520
3404-001,2017,1,2,24,123,95,218,297
3404-001,2017,1,3,1,79,75,154,218
3404-001,2017,1,3,2,65,42,107,154
3404-001,2017,1,3,3,38,46,84,107
3404-001,2017,1,3,4,46,43,89,84
3404-001,2017,1,3,5,53,68,121,89
3404-001,2017,1,3,6,103,174,277,121
3404-001,2017,1,3,7,168,465,633,277
3404-001,2017,1,3,8,408,1724,2132,633
3404-001,2017,1,3,9,661,1234,1895,2132
3404-001,2017,1,3,10,652,698,1350,1895
3404-001,2017,1,3,11,649,718,1367,1350
3404-001,2017,1,3,12,630,640,1270,1367
3404-001,2017,1,3,13,590,563,1153,1270
3404-001,2017,1,3,14,624,628,1252,1153
3404-001,2017,1,3,15,763,691,1454,1252
3404-001,2017,1,3,16,772,621,1393,1454
3404-001,2017,1,3,17,788,561,1349,1393
3404-001,2017,1,3,18,1069,499,1568,1349
3404-001,2017,1,3,19,937,417,1354,1568
3404-001,2017,1,3,20,685,350,1035,1354
3404-001,2017,1,3,21,655,245,900,1035
3404-001,2017,1,3,22,383,184,567,900
3404-001,2017,1,3,23,205,121,326,567
3404-001,2017,1,3,24,101,95,196,326
3404-001,2017,1,4,1,72,77,149,196
3404-001,2017,1,4,2,55,52,107,149
3404-001,2017,1,4,3,50,39,89,107
3404-001,2017,1,4,4,43,45,88,89
3404-001,2017,1,4,5,39,59,98,88
3404-001,2017,1,4,6,102,160,262,98
3404-001,2017,1,4,7,174,494,668,262
3404-001,2017,1,4,8,446,1690,2136,668
3404-001,2017,1,4,9,689,1293,1982,2136
3404-001,2017,1,4,10,652,728,1380,1982
3404-001,2017,1,4,11,661,701,1362,1380
3404-001,2017,1,4,12,634,670,1304,1362
3404-001,2017,1,4,13,599,553,1152,1304
3404-001,2017,1,4,14,631,673,1304,1152
3404-001,2017,1,4,15,770,704,1474,1304
3404-001,2017,1,4,16,761,632,1393,1474
3404-001,2017,1,4,17,760,541,1301,1393
3404-001,2017,1,4,18,1232,557,1789,1301
3404-001,2017,1,4,19,1011,456,1467,1789
3404-001,2017,1,4,20,680,337,1017,1467
3404-001,2017,1,4,21,549,211,760,1017
3404-001,2017,1,4,22,299,180,479,760
3404-001,2017,1,4,23,183,116,299,479
3404-001,2017,1,4,24,110,83,193,299
3404-001,2017,1,5,1,72,62,134,193
3404-001,2017,1,5,2,56,44,100,134
3404-001,2017,1,5,3,30,35,65,100
3404-001,2017,1,5,4,39,42,81,65
3404-001,2017,1,5,5,44,62,106,81
3404-001,2017,1,5,6,107,179,286,106
3404-001,2017,1,5,7,178,493,671,286
3404-001,2017,1,5,8,415,1684,2099,671
3404-001,2017,1,5,9,680,1274,1954,2099
3404-001,2017,1,5,10,634,692,1326,1954
3404-001,2017,1,5,11,718,700,1418,1326
3404-001,2017,1,5,12,609,686,1295,1418
3404-001,2017,1,5,13,580,534,1114,1295
3404-001,2017,1,5,14,647,655,1302,1114
3404-001,2017,1,5,15,777,709,1486,1302
3404-001,2017,1,5,16,794,644,1438,1486
3404-001,2017,1,5,17,781,576,1357,1438
3404-001,2017,1,5,18,1077,543,1620,1357
3404-001,2017,1,5,19,965,436,1401,1620
3404-001,2017,1,5,20,699,357,1056,1401
3404-001,2017,1,5,21,667,246,913,1056
3404-001,2017,1,5,22,339,188,527,913
3404-001,2017,1,5,23,193,134,327,527
3404-001,2017,1,5,24,118,97,215,327
3404-001,2017,1,6,1,86,65,151,215
3404-001,2017,1,6,2,63,54,117,151
3404-001,2017,1,6,3,41,44,85,117
3404-001,2017,1,6,4,37,36,73,85
3404-001,2017,1,6,5,60,70,130,73
3404-001,2017,1,6,6,105,170,275,130
3404-001,2017,1,6,7,176,503,679,275
3404-001,2017,1,6,8,428,1709,2137,679
3404-001,2017,1,6,9,703,1289,1992,2137
3404-001,2017,1,6,10,629,744,1373,1992
3404-001,2017,1,6,11,730,696,1426,1373
3404-001,2017,1,6,12,676,692,1368,1426
3404-001,2017,1,6,13,633,610,1243,1368
3404-001,2017,1,6,14,651,659,1310,1243
3404-001,2017,1,6,15,825,683,1508,1310
3404-001,2017,1,6,16,846,651,1497,1508
3404-001,2017,1,6,17,827,596,1423,1497
3404-001,2017,1,6,18,1278,563,1841,1423
3404-001,2017,1,6,19,1200,508,1708,1841
3404-001,2017,1,6,20,784,416,1200,1708
3404-001,2017,1,6,21,579,249,828,1200
3404-001,2017,1,6,22,363,189,552,828
3404-001,2017,1,6,23,212,142,354,552
3404-001,2017,1,6,24,103,94,197,354
3404-001,2017,1,7,1,79,65,144,197
3404-001,2017,1,7,2,72,60,132,144
3404-001,2017,1,7,3,43,39,82,132
3404-001,2017,1,7,4,50,32,82,82
3404-001,2017,1,7,5,49,47,96,82
3404-001,2017,1,7,6,86,129,215,96
3404-001,2017,1,7,7,137,282,419,215
3404-001,2017,1,7,8,308,699,1007,419
3404-001,2017,1,7,9,458,616,1074,1007
3404-001,2017,1,7,10,508,556,1064,1074
3404-001,2017,1,7,11,549,557,1106,1064
3404-001,2017,1,7,12,525,529,1054,1106
3404-001,2017,1,7,13,509,466,975,1054
3404-001,2017,1,7,14,515,502,1017,975
3404-001,2017,1,7,15,577,466,1043,1017
3404-001,2017,1,7,16,573,469,1042,1043
3404-001,2017,1,7,17,673,444,1117,1042
3404-001,2017,1,7,18,812,407,1219,1117
3404-001,2017,1,7,19,476,320,796,1219
3404-001,2017,1,7,20,278,236,514,796
3404-001,2017,1,7,21,204,184,388,514
3404-001,2017,1,7,22,152,140,292,388
3404-001,2017,1,7,23,89,100,189,292
3404-001,2017,1,7,24,79,76,155,189
3404-001,2017,1,8,1,47,59,106,155
3404-001,2017,1,8,2,31,36,67,106
3404-001,2017,1,8,3,31,25,56,67
3404-001,2017,1,8,4,26,26,52,56
3404-001,2017,1,8,5,23,30,53,52
3404-001,2017,1,8,6,44,49,93,53
3404-001,2017,1,8,7,60,121,181,93
3404-001,2017,1,8,8,109,179,288,181
3404-001,2017,1,8,9,178,220,398,288
3404-001,2017,1,8,10,195,223,418,398
3404-001,2017,1,8,11,256,288,544,418
3404-001,2017,1,8,12,254,314,568,544
3404-001,2017,1,8,13,297,297,594,568
3404-001,2017,1,8,14,304,337,641,594
3404-001,2017,1,8,15,358,336,694,641
3404-001,2017,1,8,16,409,354,763,694
3404-001,2017,1,8,17,450,299,749,763
3404-001,2017,1,8,18,449,306,755,749
3404-001,2017,1,8,19,319,282,601,755
3404-001,2017,1,8,20,226,223,449,601
3404-001,2017,1,8,21,175,194,369,449
3404-001,2017,1,8,22,136,169,305,369
3404-001,2017,1,8,23,79,140,219,305
3404-001,2017,1,8,24,55,95,150,219
3404-001,2017,1,9,1,36,80,116,150
3404-001,2017,1,9,2,19,44,63,116
3404-001,2017,1,9,3,22,55,77,63
3404-001,2017,1,9,4,28,46,74,77
3404-001,2017,1,9,5,56,70,126,74
3404-001,2017,1,9,6,90,216,306,126
3404-001,2017,1,9,7,214,637,851,306
3404-001,2017,1,9,8,487,1856,2343,851
3404-001,2017,1,9,9,641,1377,2018,2343
3404-001,2017,1,9,10,703,833,1536,2018
3404-001,2017,1,9,11,744,750,1494,1536
3404-001,2017,1,9,12,769,774,1543,1494
3404-001,2017,1,9,13,677,683,1360,1543
3404-001,2017,1,9,14,738,768,1506,1360
3404-001,2017,1,9,15,862,833,1695,1506
3404-001,2017,1,9,16,909,782,1691,1695
3404-001,2017,1,9,17,976,697,1673,1691
3404-001,2017,1,9,18,1149,656,1805,1673
3404-001,2017,1,9,19,998,480,1478,1805
3404-001,2017,1,9,20,723,417,1140,1478
3404-001,2017,1,9,21,674,296,970,1140
3404-001,2017,1,9,22,412,210,622,970
3404-001,2017,1,9,23,216,157,373,622
3404-001,2017,1,9,24,139,90,229,373
3404-001,2017,1,10,1,86,97,183,229
3404-001,2017,1,10,2,70,68,138,183
3404-001,2017,1,10,3,53,50,103,138
3404-001,2017,1,10,4,47,68,115,103
3404-001,2017,1,10,5,72,92,164,115
3404-001,2017,1,10,6,131,224,355,164
3404-001,2017,1,10,7,277,619,896,355
3404-001,2017,1,10,8,581,1709,2290,896
3404-001,2017,1,10,9,861,1279,2140,2290
3404-001,2017,1,10,10,761,904,1665,2140
3404-001,2017,1,10,11,774,863,1637,1665
3404-001,2017,1,10,12,794,746,1540,1637
3404-001,2017,1,10,13,648,647,1295,1540
3404-001,2017,1,10,14,637,779,1416,1295
3404-001,2017,1,10,15,861,805,1666,1416
3404-001,2017,1,10,16,912,810,1722,1666
3404-001,2017,1,10,17,897,706,1603,1722
3404-001,2017,1,10,18,1153,575,1728,1603
3404-001,2017,1,10,19,1005,490,1495,1728
3404-001,2017,1,10,20,679,422,1101,1495
3404-001,2017,1,10,21,656,270,926,1101
3404-001,2017,1,10,22,377,254,631,926
3404-001,2017,1,10,23,211,109,320,631
3404-001,2017,1,10,24,133,110,243,320
3404-001,2017,1,11,1,110,88,198,243
3404-001,2017,1,11,2,62,66,128,198
3404-001,2017,1,11,3,42,48,90,128
3404-001,2017,1,11,4,45,78,123,90
3404-001,2017,1,11,5,70,99,169,123
3404-001,2017,1,11,6,137,203,340,169
3404-001,2017,1,11,7,282,578,860,340
3404-001,2017,1,11,8,574,1661,2235,860
3404-001,2017,1,11,9,902,1391,2293,2235
3404-001,2017,1,11,10,751,902,1653,2293
3404-001,2017,1,11,11,860,877,1737,1653
3404-001,2017,1,11,12,872,815,1687,1737
3404-001,2017,1,11,13,689,688,1377,1687
3404-001,2017,1,11,14,773,822,1595,1377
3404-001,2017,1,11,15,932,885,1817,1595
3404-001,2017,1,11,16,965,830,1795,1817
3404-001,2017,1,11,17,957,734,1691,1795
3404-001,2017,1,11,18,1292,638,1930,1691
3404-001,2017,1,11,19,1091,525,1616,1930
3404-001,2017,1,11,20,675,443,1118,1616
3404-001,2017,1,11,21,538,314,852,1118
3404-001,2017,1,11,22,369,240,609,852
3404-001,2017,1,11,23,209,127,336,609
3404-001,2017,1,11,24,141,88,229,336
3404-001,2017,1,12,1,102,74,176,229
3404-001,2017,1,12,2,54,63,117,176
3404-001,2017,1,12,3,43,61,104,117
3404-001,2017,1,12,4,60,61,121,104
3404-001,2017,1,12,5,54,59,113,121
3404-001,2017,1,12,6,109,209,318,113
3404-001,2017,1,12,7,210,540,750,318
3404-001,2017,1,12,8,469,1623,2092,750
3404-001,2017,1,12,9,758,1418,2176,2092
3404-001,2017,1,12,10,682,735,1417,2176
3404-001,2017,1,12,11,782,828,1610,1417
3404-001,2017,1,12,12,739,822,1561,1610
3404-001,2017,1,12,13,676,657,1333,1561
3404-001,2017,1,12,14,686,759,1445,1333
3404-001,2017,1,12,15,740,815,1555,1445
3404-001,2017,1,12,16,820,817,1637,1555
3404-001,2017,1,12,17,853,685,1538,1637
3404-001,2017,1,12,18,1147,616,1763,1538
3404-001,2017,1,12,19,1027,482,1509,1763
3404-001,2017,1,12,20,645,449,1094,1509
3404-001,2017,1,12,21,641,280,921,1094
3404-001,2017,1,12,22,416,218,634,921
3404-001,2017,1,12,23,226,151,377,634
3404-001,2017,1,12,24,133,90,223,377
3404-001,2017,1,13,1,73,92,165,223
3404-001,2017,1,13,2,90,50,140,165
3404-001,2017,1,13,3,36,41,77,140
3404-001,2017,1,13,4,63,60,123,77
3404-001,2017,1,13,5,72,67,139,123
3404-001,2017,1,13,6,117,249,366,139
3404-001,2017,1,13,7,254,593,847,366
3404-001,2017,1,13,8,549,1628,2177,847
3404-001,2017,1,13,9,884,1364,2248,2177
3404-001,2017,1,13,10,756,870,1626,2248
3404-001,2017,1,13,11,907,890,1797,1626
3404-001,2017,1,13,12,839,777,1616,1797
3404-001,2017,1,13,13,675,690,1365,1616
3404-001,2017,1,13,14,801,752,1553,1365
3404-001,2017,1,13,15,957,845,1802,1553
3404-001,2017,1,13,16,914,797,1711,1802
3404-001,2017,1,13,17,983,752,1735,1711
3404-001,2017,1,13,18,1309,677,1986,1735
3404-001,2017,1,13,19,1125,564,1689,1986
3404-001,2017,1,13,20,757,485,1242,1689
3404-001,2017,1,13,21,587,307,894,1242
3404-001,2017,1,13,22,341,221,562,894
3404-001,2017,1,13,23,200,152,352,562
3404-001,2017,1,13,24,120,90,210,352
3404-001,2017,1,14,1,98,98,196,210
3404-001,2017,1,14,2,75,60,135,196
3404-001,2017,1,14,3,50,46,96,135
3404-001,2017,1,14,4,50,49,99,96
3404-001,2017,1,14,5,61,76,137,99
3404-001,2017,1,14,6,94,170,264,137
3404-001,2017,1,14,7,149,335,484,264
3404-001,2017,1,14,8,361,690,1051,484
3404-001,2017,1,14,9,592,759,1351,1051
3404-001,2017,1,14,10,559,603,1162,1351
3404-001,2017,1,14,11,623,612,1235,1162
3404-001,2017,1,14,12,590,599,1189,1235
3404-001,2017,1,14,13,489,546,1035,1189
3404-001,2017,1,14,14,553,525,1078,1035
3404-001,2017,1,14,15,621,520,1141,1078
3404-001,2017,1,14,16,600,514,1114,1141
3404-001,2017,1,14,17,679,459,1138,1114
3404-001,2017,1,14,18,869,485,1354,1138
3404-001,2017,1,14,19,496,384,880,1354
3404-001,2017,1,14,20,267,273,540,880
3404-001,2017,1,14,21,235,190,425,540
3404-001,2017,1,14,22,161,138,299,425
3404-001,2017,1,14,23,100,100,200,299
3404-001,2017,1,14,24,91,68,159,200
3404-001,2017,1,15,1,59,55,114,159
3404-001,2017,1,15,2,31,37,68,114
3404-001,2017,1,15,3,27,20,47,68
3404-001,2017,1,15,4,15,22,37,47
3404-001,2017,1,15,5,27,21,48,37
3404-001,2017,1,15,6,45,51,96,48
3404-001,2017,1,15,7,69,123,192,96
3404-001,2017,1,15,8,127,201,328,192
3404-001,2017,1,15,9,205,255,460,328
3404-001,2017,1,15,10,232,225,457,460
3404-001,2017,1,15,11,285,305,590,457
3404-001,2017,1,15,12,307,370,677,590
3404-001,2017,1,15,13,272,347,619,677
3404-001,2017,1,15,14,333,367,700,619
3404-001,2017,1,15,15,378,365,743,700
3404-001,2017,1,15,16,412,385,797,743
3404-001,2017,1,15,17,452,343,795,797
3404-001,2017,1,15,18,478,352,830,795
3404-001,2017,1,15,19,323,301,624,830
3404-001,2017,1,15,20,252,234,486,624
3404-001,2017,1,15,21,189,227,416,486
3404-001,2017,1,15,22,136,170,306,416
3404-001,2017,1,15,23,97,126,223,306
3404-001,2017,1,15,24,63,101,164,223
3404-001,2017,1,16,1,41,61,102,164
3404-001,2017,1,16,2,30,46,76,102
3404-001,2017,1,16,3,27,35,62,76
3404-001,2017,1,16,4,30,43,73,62
3404-001,2017,1,16,5,57,83,140,73
3404-001,2017,1,16,6,95,206,301,140
3404-001,2017,1,16,7,259,609,868,301
3404-001,2017,1,16,8,618,1771,2389,868
3404-001,2017,1,16,9,739,1441,2180,2389
3404-001,2017,1,16,10,783,761,1544,2180
3404-001,2017,1,16,11,794,897,1691,1544
3404-001,2017,1,16,12,804,831,1635,1691
3404-001,2017,1,16,13,661,692,1353,1635
3404-001,2017,1,16,14,825,854,1679,1353
3404-001,2017,1,16,15,929,863,1792,1679
3404-001,2017,1,16,16,966,860,1826,1792
3404-001,2017,1,16,17,919,742,1661,1826
3404-001,2017,1,16,18,1176,713,1889,1661
3404-001,2017,1,16,19,1061,511,1572,1889
3404-001,2017,1,16,20,723,434,1157,1572
3404-001,2017,1,16,21,696,304,1000,1157
3404-001,2017,1,16,22,393,213,606,1000
3404-001,2017,1,16,23,194,119,313,606
3404-001,2017,1,16,24,123,91,214,313
3404-001,2017,1,17,1,80,92,172,214
3404-001,2017,1,17,2,54,73,127,172
3404-001,2017,1,17,3,52,50,102,127
3404-001,2017,1,17,4,57,46,103,102
3404-001,2017,1,17,5,91,86,177,103
3404-001,2017,1,17,6,111,199,310,177
3404-001,2017,1,17,7,277,554,831,310
3404-001,2017,1,17,8,580,1737,2317,831
3404-001,2017,1,17,9,792,1354,2146,2317
3404-001,2017,1,17,10,809,813,1622,2146
3404-001,2017,1,17,11,771,920,1691,1622
3404-001,2017,1,17,12,864,899,1763,1691
3404-001,2017,1,17,13,717,729,1446,1763
3404-001,2017,1,17,14,819,840,1659,1446
3404-001,2017,1,17,15,915,887,1802,1659
3404-001,2017,1,17,16,1007,862,1869,1802
3404-001,2017,1,17,17,914,734,1648,1869
3404-001,2017,1,17,18,1128,648,1776,1648
3404-001,2017,1,17,19,1033,504,1537,1776
3404-001,2017,1,17,20,783,439,1222,1537
3404-001,2017,1,17,21,706,307,1013,1222
3404-001,2017,1,17,22,382,208,590,1013
3404-001,2017,1,17,23,223,149,372,590
3404-001,2017,1,17,24,133,111,244,372
3404-001,2017,1,18,1,90,69,159,244
3404-001,2017,1,18,2,53,64,117,159
3404-001,2017,1,18,3,52,73,125,117
3404-001,2017,1,18,4,62,45,107,125
3404-001,2017,1,18,5,71,90,161,107
3404-001,2017,1,18,6,131,223,354,161
3404-001,2017,1,18,7,247,627,874,354
3404-001,2017,1,18,8,582,1747,2329,874
3404-001,2017,1,18,9,883,1399,2282,2329
3404-001,2017,1,18,10,740,926,1666,2282
3404-001,2017,1,18,11,838,968,1806,1666
3404-001,2017,1,18,12,859,840,1699,1806
3404-001,2017,1,18,13,643,788,1431,1699
3404-001,2017,1,18,14,868,802,1670,1431
3404-001,2017,1,18,15,938,895,1833,1670
3404-001,2017,1,18,16,915,864,1779,1833
3404-001,2017,1,18,17,909,749,1658,1779
3404-001,2017,1,18,18,1290,683,1973,1658
3404-001,2017,1,18,19,1088,542,1630,1973
3404-001,2017,1,18,20,630,435,1065,1630
3404-001,2017,1,18,21,513,286,799,1065
3404-001,2017,1,18,22,322,239,561,799
3404-001,2017,1,18,23,221,157,378,561
3404-001,2017,1,18,24,127,113,240,378
3404-001,2017,1,19,1,70,69,139,240
3404-001,2017,1,19,2,60,70,130,139
3404-001,2017,1,19,3,35,43,78,130
3404-001,2017,1,19,4,50,64,114,78
3404-001,2017,1,19,5,53,83,136,114
3404-001,2017,1,19,6,111,210,321,136
3404-001,2017,1,19,7,242,599,841,321
3404-001,2017,1,19,8,523,1566,2089,841
3404-001,2017,1,19,9,836,1335,2171,2089
3404-001,2017,1,19,10,731,895,1626,2171
3404-001,2017,1,19,11,846,879,1725,1626
3404-001,2017,1,19,12,869,795,1664,1725
3404-001,2017,1,19,13,773,757,1530,1664
3404-001,2017,1,19,14,782,872,1654,1530
3404-001,2017,1,19,15,884,881,1765,1654
3404-001,2017,1,19,16,1009,862,1871,1765
3404-001,2017,1,19,17,991,774,1765,1871
3404-001,2017,1,19,18,1228,750,1978,1765
3404-001,2017,1,19,19,1083,600,1683,1978
3404-001,2017,1,19,20,786,454,1240,1683
3404-001,2017,1,19,21,717,340,1057,1240
3404-001,2017,1,19,22,399,256,655,1057
3404-001,2017,1,19,23,262,177,439,655
3404-001,2017,1,19,24,156,138,294,439
3404-001,2017,1,20,1,99,115,214,294
3404-001,2017,1,20,2,69,69,138,214
3404-001,2017,1,20,3,29,64,93,138
3404-001,2017,1,20,4,31,81,112,93
3404-001,2017,1,20,5,30,86,116,112
3404-001,2017,1,20,6,49,171,220,116
3404-001,2017,1,20,7,116,450,566,220
3404-001,2017,1,20,8,242,1128,1370,566
3404-001,2017,1,20,9,311,1102,1413,1370
3404-001,2017,1,20,10,201,733,934,1413
3404-001,2017,1,20,11,452,691,1143,934
3404-001,2017,1,20,12,610,676,1286,1143
3404-001,2017,1,20,13,513,612,1125,1286
3404-001,2017,1,20,14,471,720,1191,1125
3404-001,2017,1,20,15,790,783,1573,1191
3404-001,2017,1,20,16,896,737,1633,1573
3404-001,2017,1,20,17,822,668,1490,1633
3404-001,2017,1,20,18,1091,638,1729,1490
3404-001,2017,1,20,19,1073,544,1617,1729
3404-001,2017,1,20,20,654,415,1069,1617
3404-001,2017,1,20,21,521,216,737,1069
3404-001,2017,1,20,22,295,212,507,737
3404-001,2017,1,20,23,186,130,316,507
3404-001,2017,1,20,24,107,95,202,316
3404-001,2017,1,21,1,134,68,202,202
3404-001,2017,1,21,2,69,59,128,202
3404-001,2017,1,21,3,44,50,94,128
3404-001,2017,1,21,4,46,42,88,94
3404-001,2017,1,21,5,72,62,134,88
3404-001,2017,1,21,6,88,130,218,134
3404-001,2017,1,21,7,175,322,497,218
3404-001,2017,1,21,8,356,669,1025,497
3404-001,2017,1,21,9,548,753,1301,1025
3404-001,2017,1,21,10,618,684,1302,1301
3404-001,2017,1,21,11,645,627,1272,1302
3404-001,2017,1,21,12,642,637,1279,1272
3404-001,2017,1,21,13,532,570,1102,1279
3404-001,2017,1,21,14,642,638,1280,1102
3404-001,2017,1,21,15,708,621,1329,1280
3404-001,2017,1,21,16,720,544,1264,1329
3404-001,2017,1,21,17,692,540,1232,1264
3404-001,2017,1,21,18,846,433,1279,1232
3404-001,2017,1,21,19,442,380,822,1279
3404-001,2017,1,21,20,274,270,544,822
3404-001,2017,1,21,21,211,179,390,544
3404-001,2017,1,21,22,62,130,192,390
3404-001,2017,1,21,23,36,79,115,192
3404-001,2017,1,21,24,40,52,92,115
3404-001,2017,1,22,1,25,38,63,92
3404-001,2017,1,22,2,12,27,39,63
3404-001,2017,1,22,3,7,27,34,39
3404-001,2017,1,22,4,10,19,29,34
3404-001,2017,1,22,5,7,15,22,29
3404-001,2017,1,22,6,10,40,50,22
3404-001,2017,1,22,7,14,110,124,50
3404-001,2017,1,22,8,55,190,245,124
3404-001,2017,1,22,9,112,240,352,245
3404-001,2017,1,22,10,116,230,346,352
3404-001,2017,1,22,11,75,223,298,346
3404-001,2017,1,22,12,73,260,333,298
3404-001,2017,1,22,13,86,301,387,333
3404-001,2017,1,22,14,109,327,436,387
3404-001,2017,1,22,15,278,334,612,436
3404-001,2017,1,22,16,353,318,671,612
3404-001,2017,1,22,17,373,288,661,671
3404-001,2017,1,22,18,407,298,705,661
3404-001,2017,1,22,19,265,272,537,705
3404-001,2017,1,22,20,202,206,408,537
3404-001,2017,1,22,21,171,178,349,408
3404-001,2017,1,22,22,118,146,264,349
3404-001,2017,1,22,23,86,130,216,264
3404-001,2017,1,22,24,51,93,144,216
3404-001,2017,1,23,1,32,70,102,144
3404-001,2017,1,23,2,34,60,94,102
3404-001,2017,1,23,3,19,24,43,94
3404-001,2017,1,23,4,33,43,76,43
3404-001,2017,1,23,5,50,76,126,76
3404-001,2017,1,23,6,92,203,295,126
3404-001,2017,1,23,7,252,618,870,295
3404-001,2017,1,23,8,541,1738,2279,870
3404-001,2017,1,23,9,791,1391,2182,2279
3404-001,2017,1,23,10,768,890,1658,2182
3404-001,2017,1,23,11,856,821,1677,1658
3404-001,2017,1,23,12,832,840,1672,1677
3404-001,2017,1,23,13,733,776,1509,1672
3404-001,2017,1,23,14,841,839,1680,1509
3404-001,2017,1,23,15,886,944,1830,1680
3404-001,2017,1,23,16,1049,899,1948,1830
3404-001,2017,1,23,17,942,800,1742,1948
3404-001,2017,1,23,18,1230,706,1936,1742
3404-001,2017,1,23,19,1020,526,1546,1936
3404-001,2017,1,23,20,677,433,1110,1546
3404-001,2017,1,23,21,680,308,988,1110
3404-001,2017,1,23,22,424,198,622,988
3404-001,2017,1,23,23,221,147,368,622
3404-001,2017,1,23,24,116,97,213,368
3404-001,2017,1,24,1,105,84,189,213
3404-001,2017,1,24,2,66,63,129,189
3404-001,2017,1,24,3,42,50,92,129
3404-001,2017,1,24,4,57,88,145,92
3404-001,2017,1,24,5,69,90,159,145
3404-001,2017,1,24,6,127,199,326,159
3404-001,2017,1,24,7,238,540,778,326
3404-001,2017,1,24,8,580,1635,2215,778
3404-001,2017,1,24,9,843,1423,2266,2215
3404-001,2017,1,24,10,766,882,1648,2266
3404-001,2017,1,24,11,875,893,1768,1648
3404-001,2017,1,24,12,834,849,1683,1768
3404-001,2017,1,24,13,754,742,1496,1683
3404-001,2017,1,24,14,842,791,1633,1496
3404-001,2017,1,24,15,925,934,1859,1633
3404-001,2017,1,24,16,1017,877,1894,1859
3404-001,2017,1,24,17,957,806,1763,1894
3404-001,2017,1,24,18,1262,750,2012,1763
3404-001,2017,1,24,19,1041,577,1618,2012
3404-001,2017,1,24,20,716,487,1203,1618
3404-001,2017,1,24,21,697,302,999,1203
3404-001,2017,1,24,22,427,247,674,999
3404-001,2017,1,24,23,245,181,426,674
3404-001,2017,1,24,24,145,107,252,426
3404-001,2017,1,25,1,109,92,201,252
3404-001,2017,1,25,2,81,74,155,201
3404-001,2017,1,25,3,66,56,122,155
3404-001,2017,1,25,4,43,63,106,122
3404-001,2017,1,25,5,83,82,165,106
3404-001,2017,1,25,6,117,180,297,165
3404-001,2017,1,25,7,246,547,793,297
3404-001,2017,1,25,8,566,1638,2204,793
3404-001,2017,1,25,9,851,1343,2194,2204
3404-001,2017,1,25,10,853,891,1744,2194
3404-001,2017,1,25,11,867,858,1725,1744
3404-001,2017,1,25,12,859,860,1719,1725
3404-001,2017,1,25,13,721,737,1458,1719
3404-001,2017,1,25,14,819,799,1618,1458
3404-001,2017,1,25,15,1047,937,1984,1618
3404-001,2017,1,25,16,1069,821,1890,1984
3404-001,2017,1,25,17,1029,810,1839,1890
3404-001,2017,1,25,18,1342,701,2043,1839
3404-001,2017,1,25,19,1194,632,1826,2043
3404-001,2017,1,25,20,813,449,1262,1826
3404-001,2017,1,25,21,681,305,986,1262
3404-001,2017,1,25,22,392,291,683,986
3404-001,2017,1,25,23,222,179,401,683
3404-001,2017,1,25,24,170,109,279,401
3404-001,2017,1,26,1,96,73,169,279
3404-001,2017,1,26,2,88,77,165,169
3404-001,2017,1,26,3,50,65,115,165
3404-001,2017,1,26,4,58,46,104,115
3404-001,2017,1,26,5,66,81,147,104
3404-001,2017,1,26,6,113,187,300,147
3404-001,2017,1,26,7,199,465,664,300
3404-001,2017,1,26,8,504,1536,2040,664
3404-001,2017,1,26,9,852,1286,2138,2040
3404-001,2017,1,26,10,735,770,1505,2138
3404-001,2017,1,26,11,762,839,1601,1505
3404-001,2017,1,26,12,758,763,1521,1601
3404-001,2017,1,26,13,733,667,1400,1521
3404-001,2017,1,26,14,750,789,1539,1400
3404-001,2017,1,26,15,837,748,1585,1539
3404-001,2017,1,26,16,1044,722,1766,1585
3404-001,2017,1,26,17,998,751,1749,1766
3404-001,2017,1,26,18,1174,759,1933,1749
3404-001,2017,1,26,19,746,629,1375,1933
3404-001,2017,1,26,20,457,521,978,1375
3404-001,2017,1,26,21,311,318,629,978
3404-001,2017,1,26,22,229,283,512,629
3404-001,2017,1,26,23,146,214,360,512
3404-001,2017,1,26,24,96,133,229,360
3404-001,2017,1,27,1,86,72,158,229
3404-001,2017,1,27,2,46,61,107,158
3404-001,2017,1,27,3,23,56,79,107
3404-001,2017,1,27,4,10,55,65,79
3404-001,2017,1,27,5,46,46,92,65
3404-001,2017,1,27,6,74,71,145,92
3404-001,2017,1,27,7,101,91,192,145
3404-001,2017,1,27,8,178,225,403,192
3404-001,2017,1,27,9,209,264,473,403
3404-001,2017,1,27,10,219,331,550,473
3404-001,2017,1,27,11,273,431,704,550
3404-001,2017,1,27,12,321,469,790,704
3404-001,2017,1,27,13,338,441,779,790
3404-001,2017,1,27,14,276,350,626,779
3404-001,2017,1,27,15,256,324,580,626
3404-001,2017,1,27,16,301,306,607,580
3404-001,2017,1,27,17,262,287,549,607
3404-001,2017,1,27,18,246,249,495,549
3404-001,2017,1,27,19,186,193,379,495
3404-001,2017,1,27,20,173,159,332,379
3404-001,2017,1,27,21,150,116,266,332
3404-001,2017,1,27,22,77,73,150,266
3404-001,2017,1,27,23,50,64,114,150
3404-001,2017,1,27,24,47,40,87,114
3404-001,2017,1,28,1,36,21,57,87
3404-001,2017,1,28,2,19,12,31,57
3404-001,2017,1,28,3,10,9,19,31
3404-001,2017,1,28,4,15,18,33,19
3404-001,2017,1,28,5,22,13,35,33
3404-001,2017,1,28,6,45,25,70,35
3404-001,2017,1,28,7,88,100,188,70
3404-001,2017,1,28,8,134,191,325,188
3404-001,2017,1,28,9,163,161,324,325
3404-001,2017,1,28,10,203,176,379,324
3404-001,2017,1,28,11,333,306,639,379
3404-001,2017,1,28,12,526,517,1043,639
3404-001,2017,1,28,13,600,504,1104,1043
3404-001,2017,1,28,14,899,451,1350,1104
3404-001,2017,1,28,15,704,455,1159,1350
3404-001,2017,1,28,16,590,493,1083,1159
3404-001,2017,1,28,17,983,499,1482,1083
3404-001,2017,1,28,18,515,418,933,1482
3404-001,2017,1,28,19,563,268,831,933
3404-001,2017,1,28,20,245,184,429,831
3404-001,2017,1,28,21,182,187,369,429
3404-001,2017,1,28,22,154,133,287,369
3404-001,2017,1,28,23,96,100,196,287
3404-001,2017,1,28,24,67,54,121,196
3404-001,2017,1,29,1,36,44,80,121
3404-001,2017,1,29,2,24,28,52,80
3404-001,2017,1,29,3,13,26,39,52
3404-001,2017,1,29,4,15,19,34,39
3404-001,2017,1,29,5,14,19,33,34
3404-001,2017,1,29,6,23,29,52,33
3404-001,2017,1,29,7,22,42,64,52
3404-001,2017,1,29,8,56,94,150,64
3404-001,2017,1,29,9,120,129,249,150
3404-001,2017,1,29,10,122,168,290,249
3404-001,2017,1,29,11,242,230,472,290
3404-001,2017,1,29,12,299,316,615,472
3404-001,2017,1,29,13,328,330,658,615
3404-001,2017,1,29,14,359,286,645,658
3404-001,2017,1,29,15,391,295,686,645
3404-001,2017,1,29,16,376,299,675,686
3404-001,2017,1,29,17,459,295,754,675
3404-001,2017,1,29,18,465,271,736,754
3404-001,2017,1,29,19,235,255,490,736
3404-001,2017,1,29,20,166,172,338,490
3404-001,2017,1,29,21,133,168,301,338
3404-001,2017,1,29,22,84,107,191,301
3404-001,2017,1,29,23,56,83,139,191
3404-001,2017,1,29,24,44,69,113,139
3404-001,2017,1,30,1,38,34,72,113
3404-001,2017,1,30,2,23,32,55,72
3404-001,2017,1,30,3,20,27,47,55
3404-001,2017,1,30,4,16,17,33,47
3404-001,2017,1,30,5,20,34,54,33
3404-001,2017,1,30,6,29,34,63,54
3404-001,2017,1,30,7,35,81,116,63
3404-001,2017,1,30,8,62,234,296,116
3404-001,2017,1,30,9,109,232,341,296
3404-001,2017,1,30,10,156,199,355,341
3404-001,2017,1,30,11,205,253,458,355
3404-001,2017,1,30,12,234,241,475,458
3404-001,2017,1,30,13,168,337,505,475
3404-001,2017,1,30,14,353,343,696,505
3404-001,2017,1,30,15,419,326,745,696
3404-001,2017,1,30,16,401,347,748,745
3404-001,2017,1,30,17,388,334,722,748
3404-001,2017,1,30,18,408,324,732,722
3404-001,2017,1,30,19,327,255,582,732
3404-001,2017,1,30,20,202,210,412,582
3404-001,2017,1,30,21,161,187,348,412
3404-001,2017,1,30,22,133,161,294,348
3404-001,2017,1,30,23,73,135,208,294
3404-001,2017,1,30,24,63,91,154,208
3404-001,2017,1,31,1,40,71,111,154
3404-001,2017,1,31,2,31,45,76,111
3404-001,2017,1,31,3,27,32,59,76
3404-001,2017,1,31,4,33,35,68,59
3404-001,2017,1,31,5,40,55,95,68
3404-001,2017,1,31,6,77,132,209,95
3404-001,2017,1,31,7,159,403,562,209
3404-001,2017,1,31,8,438,1390,1828,562
3404-001,2017,1,31,9,573,1049,1622,1828
3404-001,2017,1,31,10,518,639,1157,1622
3404-001,2017,1,31,11,640,607,1247,1157
3404-001,2017,1,31,12,588,639,1227,1247
3404-001,2017,1,31,13,562,568,1130,1227
3404-001,2017,1,31,14,576,670,1246,1130
3404-001,2017,1,31,15,667,684,1351,1246
3404-001,2017,1,31,16,744,661,1405,1351
3404-001,2017,1,31,17,747,596,1343,1405
3404-001,2017,1,31,18,995,578,1573,1343
3404-001,2017,1,31,19,849,474,1323,1573
3404-001,2017,1,31,20,568,367,935,1323
3404-001,2017,1,31,21,472,254,726,935
3404-001,2017,1,31,22,302,220,522,726
3404-001,2017,1,31,23,195,142,337,522
3404-001,2017,1,31,24,119,99,218,337
3404-001,2017,2,1,1,57,94,151,218
3404-001,2017,2,1,2,61,53,114,151
3404-001,2017,2,1,3,52,57,109,114
3404-001,2017,2,1,4,54,45,99,109
3404-001,2017,2,1,5,80,88,168,99
3404-001,2017,2,1,6,103,222,325,168
3404-001,2017,2,1,7,220,575,795,325
3404-001,2017,2,1,8,525,1707,2232,795
3404-001,2017,2,1,9,808,1310,2118,2232
3404-001,2017,2,1,10,753,847,1600,2118
3404-001,2017,2,1,11,775,749,1524,1600
3404-001,2017,2,1,12,731,769,1500,1524
3404-001,2017,2,1,13,660,700,1360,1500
3404-001,2017,2,1,14,746,755,1501,1360
3404-001,2017,2,1,15,816,865,1681,1501
3404-001,2017,2,1,16,815,729,1544,1681
3404-001,2017,2,1,17,839,705,1544,1544
3404-001,2017,2,1,18,1249,620,1869,1544
3404-001,2017,2,1,19,1065,509,1574,1869
3404-001,2017,2,1,20,697,408,1105,1574
3404-001,2017,2,1,21,546,258,804,1105
3404-001,2017,2,1,22,360,210,570,804
3404-001,2017,2,1,23,217,132,349,570
3404-001,2017,2,1,24,137,119,256,349
3404-001,2017,2,2,1,99,108,207,256
3404-001,2017,2,2,2,69,64,133,207
3404-001,2017,2,2,3,50,49,99,133
3404-001,2017,2,2,4,54,53,107,99
3404-001,2017,2,2,5,84,68,152,107
3404-001,2017,2,2,6,126,185,311,152
3404-001,2017,2,2,7,267,609,876,311
3404-001,2017,2,2,8,578,1734,2312,876
3404-001,2017,2,2,9,812,1332,2144,2312
3404-001,2017,2,2,10,822,832,1654,2144
3404-001,2017,2,2,11,810,845,1655,1654
3404-001,2017,2,2,12,723,835,1558,1655
3404-001,2017,2,2,13,668,724,1392,1558
3404-001,2017,2,2,14,710,854,1564,1392
3404-001,2017,2,2,15,804,795,1599,1564
3404-001,2017,2,2,16,851,791,1642,1599
3404-001,2017,2,2,17,905,736,1641,1642
3404-001,2017,2,2,18,1116,664,1780,1641
3404-001,2017,2,2,19,1032,499,1531,1780
3404-001,2017,2,2,20,746,415,1161,1531
3404-001,2017,2,2,21,659,282,941,1161
3404-001,2017,2,2,22,365,200,565,941
3404-001,2017,2,2,23,209,123,332,565
3404-001,2017,2,2,24,123,81,204,332
3404-001,2017,2,3,1,110,75,185,204
3404-001,2017,2,3,2,56,54,110,185
3404-001,2017,2,3,3,40,61,101,110
3404-001,2017,2,3,4,55,44,99,101
3404-001,2017,2,3,5,67,68,135,99
3404-001,2017,2,3,6,117,231,348,135
3404-001,2017,2,3,7,258,595,853,348
3404-001,2017,2,3,8,574,1710,2284,853
3404-001,2017,2,3,9,784,1454,2238,2284
3404-001,2017,2,3,10,816,818,1634,2238
3404-001,2017,2,3,11,785,912,1697,1634
3404-001,2017,2,3,12,802,771,1573,1697
3404-001,2017,2,3,13,648,696,1344,1573
3404-001,2017,2,3,14,714,877,1591,1344
3404-001,2017,2,3,15,932,837,1769,1591
3404-001,2017,2,3,16,958,813,1771,1769
3404-001,2017,2,3,17,922,698,1620,1771
3404-001,2017,2,3,18,1315,680,1995,1620
3404-001,2017,2,3,19,1270,619,1889,1995
3404-001,2017,2,3,20,791,460,1251,1889
3404-001,2017,2,3,21,661,298,959,1251
3404-001,2017,2,3,22,399,247,646,959
3404-001,2017,2,3,23,199,158,357,646
3404-001,2017,2,3,24,124,108,232,357
3404-001,2017,2,4,1,114,81,195,232
3404-001,2017,2,4,2,63,57,120,195
3404-001,2017,2,4,3,63,58,121,120
3404-001,2017,2,4,4,62,49,111,121
3404-001,2017,2,4,5,64,77,141,111
3404-001,2017,2,4,6,94,159,253,141
3404-001,2017,2,4,7,182,350,532,253
3404-001,2017,2,4,8,397,830,1227,532
3404-001,2017,2,4,9,576,910,1486,1227
3404-001,2017,2,4,10,644,720,1364,1486
3404-001,2017,2,4,11,608,634,1242,1364
3404-001,2017,2,4,12,597,655,1252,1242
3404-001,2017,2,4,13,584,551,1135,1252
3404-001,2017,2,4,14,630,604,1234,1135
3404-001,2017,2,4,15,617,580,1197,1234
3404-001,2017,2,4,16,637,559,1196,1197
3404-001,2017,2,4,17,720,464,1184,1196
3404-001,2017,2,4,18,894,528,1422,1184
3404-001,2017,2,4,19,564,413,977,1422
3404-001,2017,2,4,20,301,254,555,977
3404-001,2017,2,4,21,239,199,438,555
3404-001,2017,2,4,22,170,156,326,438
3404-001,2017,2,4,23,90,114,204,326
3404-001,2017,2,4,24,94,69,163,204
3404-001,2017,2,5,1,50,40,90,163
3404-001,2017,2,5,2,36,39,75,90
3404-001,2017,2,5,3,38,27,65,75
3404-001,2017,2,5,4,22,35,57,65
3404-001,2017,2,5,5,31,35,66,57
3404-001,2017,2,5,6,45,48,93,66
3404-001,2017,2,5,7,73,138,211,93
3404-001,2017,2,5,8,140,233,373,211
3404-001,2017,2,5,9,228,307,535,373
3404-001,2017,2,5,10,236,289,525,535
3404-001,2017,2,5,11,280,343,623,525
3404-001,2017,2,5,12,280,359,639,623
3404-001,2017,2,5,13,262,387,649,639
3404-001,2017,2,5,14,187,336,523,649
3404-001,2017,2,5,15,288,320,608,523
3404-001,2017,2,5,16,361,305,666,608
3404-001,2017,2,5,17,378,313,691,666
3404-001,2017,2,5,18,401,334,735,691
3404-001,2017,2,5,19,261,295,556,735
3404-001,2017,2,5,20,178,229,407,556
3404-001,2017,2,5,21,153,194,347,407
3404-001,2017,2,5,22,101,144,245,347
3404-001,2017,2,5,23,75,106,181,245
3404-001,2017,2,5,24,48,96,144,181
3404-001,2017,2,6,1,38,60,98,144
3404-001,2017,2,6,2,31,53,84,98
3404-001,2017,2,6,3,17,46,63,84
3404-001,2017,2,6,4,39,31,70,63
3404-001,2017,2,6,5,52,55,107,70
3404-001,2017,2,6,6,87,222,309,107
3404-001,2017,2,6,7,239,629,868,309
3404-001,2017,2,6,8,599,1802,2401,868
3404-001,2017,2,6,9,821,1440,2261,2401
3404-001,2017,2,6,10,781,854,1635,2261
3404-001,2017,2,6,11,826,886,1712,1635
3404-001,2017,2,6,12,762,832,1594,1712
3404-001,2017,2,6,13,655,675,1330,1594
3404-001,2017,2,6,14,795,813,1608,1330
3404-001,2017,2,6,15,872,899,1771,1608
3404-001,2017,2,6,16,972,831,1803,1771
3404-001,2017,2,6,17,917,750,1667,1803
3404-001,2017,2,6,18,1167,663,1830,1667
3404-001,2017,2,6,19,1004,557,1561,1830
3404-001,2017,2,6,20,760,405,1165,1561
3404-001,2017,2,6,21,675,297,972,1165
3404-001,2017,2,6,22,424,220,644,972
3404-001,2017,2,6,23,200,148,348,644
3404-001,2017,2,6,24,130,102,232,348
3404-001,2017,2,7,1,95,97,192,232
3404-001,2017,2,7,2,65,45,110,192
3404-001,2017,2,7,3,46,73,119,110
3404-001,2017,2,7,4,44,49,93,119
3404-001,2017,2,7,5,76,99,175,93
3404-001,2017,2,7,6,108,219,327,175
3404-001,2017,2,7,7,252,563,815,327
3404-001,2017,2,7,8,615,1824,2439,815
3404-001,2017,2,7,9,869,1369,2238,2439
3404-001,2017,2,7,10,857,886,1743,2238
3404-001,2017,2,7,11,847,943,1790,1743
3404-001,2017,2,7,12,806,741,1547,1790
3404-001,2017,2,7,13,694,702,1396,1547
3404-001,2017,2,7,14,766,801,1567,1396
3404-001,2017,2,7,15,874,872,1746,1567
3404-001,2017,2,7,16,953,841,1794,1746
3404-001,2017,2,7,17,875,732,1607,1794
3404-001,2017,2,7,18,1181,608,1789,1607
3404-001,2017,2,7,19,1041,581,1622,1789
3404-001,2017,2,7,20,711,429,1140,1622
3404-001,2017,2,7,21,696,281,977,1140
3404-001,2017,2,7,22,378,251,629,977
3404-001,2017,2,7,23,212,166,378,629
3404-001,2017,2,7,24,116,101,217,378
3404-001,2017,2,8,1,107,81,188,217
3404-001,2017,2,8,2,70,46,116,188
3404-001,2017,2,8,3,51,47,98,116
3404-001,2017,2,8,4,66,60,126,98
3404-001,2017,2,8,5,85,85,170,126
3404-001,2017,2,8,6,120,223,343,170
3404-001,2017,2,8,7,273,618,891,343
3404-001,2017,2,8,8,585,1712,2297,891
3404-001,2017,2,8,9,852,1311,2163,2297
3404-001,2017,2,8,10,861,911,1772,2163
3404-001,2017,2,8,11,825,931,1756,1772
3404-001,2017,2,8,12,808,794,1602,1756
3404-001,2017,2,8,13,653,732,1385,1602
3404-001,2017,2,8,14,820,798,1618,1385
3404-001,2017,2,8,15,871,855,1726,1618
3404-001,2017,2,8,16,894,813,1707,1726
3404-001,2017,2,8,17,928,745,1673,1707
3404-001,2017,2,8,18,1336,690,2026,1673
3404-001,2017,2,8,19,1049,507,1556,2026
3404-001,2017,2,8,20,628,456,1084,1556
3404-001,2017,2,8,21,581,286,867,1084
3404-001,2017,2,8,22,324,182,506,867
3404-001,2017,2,8,23,223,139,362,506
3404-001,2017,2,8,24,127,106,233,362
3404-001,2017,2,9,1,91,102,193,233
3404-001,2017,2,9,2,67,53,120,193
3404-001,2017,2,9,3,44,30,74,120
3404-001,2017,2,9,4,44,46,90,74
3404-001,2017,2,9,5,80,90,170,90
3404-001,2017,2,9,6,126,215,341,170
3404-001,2017,2,9,7,237,614,851,341
3404-001,2017,2,9,8,609,1736,2345,851
3404-001,2017,2,9,9,830,1300,2130,2345
3404-001,2017,2,9,10,852,849,1701,2130
3404-001,2017,2,9,11,884,795,1679,1701
3404-001,2017,2,9,12,786,820,1606,1679
3404-001,2017,2,9,13,630,755,1385,1606
3404-001,2017,2,9,14,773,754,1527,1385
3404-001,2017,2,9,15,824,805,1629,1527
3404-001,2017,2,9,16,892,803,1695,1629
3404-001,2017,2,9,17,900,651,1551,1695
3404-001,2017,2,9,18,1147,650,1797,1551
3404-001,2017,2,9,19,986,545,1531,1797
3404-001,2017,2,9,20,631,423,1054,1531
3404-001,2017,2,9,21,660,298,958,1054
3404-001,2017,2,9,22,387,210,597,958
3404-001,2017,2,9,23,204,127,331,597
3404-001,2017,2,9,24,139,105,244,331
3404-001,2017,2,10,1,101,89,190,244
3404-001,2017,2,10,2,69,68,137,190
3404-001,2017,2,10,3,44,65,109,137
3404-001,2017,2,10,4,56,69,125,109
3404-001,2017,2,10,5,71,82,153,125
3404-001,2017,2,10,6,113,204,317,153
3404-001,2017,2,10,7,260,557,817,317
3404-001,2017,2,10,8,586,1637,2223,817
3404-001,2017,2,10,9,880,1387,2267,2223
3404-001,2017,2,10,10,775,902,1677,2267
3404-001,2017,2,10,11,894,912,1806,1677
3404-001,2017,2,10,12,779,763,1542,1806
3404-001,2017,2,10,13,706,712,1418,1542
3404-001,2017,2,10,14,787,716,1503,1418
3404-001,2017,2,10,15,902,828,1730,1503
3404-001,2017,2,10,16,874,780,1654,1730
3404-001,2017,2,10,17,961,751,1712,1654
3404-001,2017,2,10,18,1302,687,1989,1712
3404-001,2017,2,10,19,1204,569,1773,1989
3404-001,2017,2,10,20,712,490,1202,1773
3404-001,2017,2,10,21,599,330,929,1202
3404-001,2017,2,10,22,357,218,575,929
3404-001,2017,2,10,23,231,144,375,575
3404-001,2017,2,10,24,145,110,255,375
3404-001,2017,2,11,1,98,81,179,255
3404-001,2017,2,11,2,85,50,135,179
3404-001,2017,2,11,3,61,53,114,135
3404-001,2017,2,11,4,47,42,89,114
3404-001,2017,2,11,5,93,63,156,89
3404-001,2017,2,11,6,79,122,201,156
3404-001,2017,2,11,7,149,329,478,201
3404-001,2017,2,11,8,364,683,1047,478
3404-001,2017,2,11,9,583,719,1302,1047
3404-001,2017,2,11,10,552,626,1178,1302
3404-001,2017,2,11,11,600,586,1186,1178
3404-001,2017,2,11,12,575,597,1172,1186
3404-001,2017,2,11,13,490,567,1057,1172
3404-001,2017,2,11,14,528,539,1067,1057
3404-001,2017,2,11,15,575,533,1108,1067
3404-001,2017,2,11,16,592,454,1046,1108
3404-001,2017,2,11,17,635,466,1101,1046
3404-001,2017,2,11,18,831,476,1307,1101
3404-001,2017,2,11,19,533,407,940,1307
3404-001,2017,2,11,20,278,287,565,940
3404-001,2017,2,11,21,253,202,455,565
3404-001,2017,2,11,22,173,164,337,455
3404-001,2017,2,11,23,152,127,279,337
3404-001,2017,2,11,24,79,76,155,279
3404-001,2017,2,12,1,66,69,135,155
3404-001,2017,2,12,2,44,41,85,135
3404-001,2017,2,12,3,31,23,54,85
3404-001,2017,2,12,4,22,31,53,54
3404-001,2017,2,12,5,40,35,75,53
3404-001,2017,2,12,6,38,42,80,75
3404-001,2017,2,12,7,80,153,233,80
3404-001,2017,2,12,8,162,248,410,233
3404-001,2017,2,12,9,261,327,588,410
3404-001,2017,2,12,10,229,303,532,588
3404-001,2017,2,12,11,301,340,641,532
3404-001,2017,2,12,12,270,372,642,641
3404-001,2017,2,12,13,287,374,661,642
3404-001,2017,2,12,14,366,436,802,661
3404-001,2017,2,12,15,407,405,812,802
3404-001,2017,2,12,16,481,423,904,812
3404-001,2017,2,12,17,536,451,987,904
3404-001,2017,2,12,18,520,369,889,987
3404-001,2017,2,12,19,374,342,716,889
3404-001,2017,2,12,20,250,230,480,716
3404-001,2017,2,12,21,193,234,427,480
3404-001,2017,2,12,22,165,212,377,427
3404-001,2017,2,12,23,100,130,230,377
3404-001,2017,2,12,24,69,99,168,230
3404-001,2017,2,13,1,29,74,103,168
3404-001,2017,2,13,2,34,45,79,103
3404-001,2017,2,13,3,23,49,72,79
3404-001,2017,2,13,4,31,40,71,72
3404-001,2017,2,13,5,41,71,112,71
3404-001,2017,2,13,6,127,230,357,112
3404-001,2017,2,13,7,266,620,886,357
3404-001,2017,2,13,8,596,1855,2451,886
3404-001,2017,2,13,9,777,1424,2201,2451
3404-001,2017,2,13,10,807,812,1619,2201
3404-001,2017,2,13,11,793,868,1661,1619
3404-001,2017,2,13,12,827,783,1610,1661
3404-001,2017,2,13,13,646,757,1403,1610
3404-001,2017,2,13,14,729,784,1513,1403
3404-001,2017,2,13,15,910,916,1826,1513
3404-001,2017,2,13,16,857,775,1632,1826
3404-001,2017,2,13,17,947,720,1667,1632
3404-001,2017,2,13,18,1212,655,1867,1667
3404-001,2017,2,13,19,951,519,1470,1867
3404-001,2017,2,13,20,571,389,960,1470
3404-001,2017,2,13,21,609,281,890,960
3404-001,2017,2,13,22,389,213,602,890
3404-001,2017,2,13,23,209,155,364,602
3404-001,2017,2,13,24,107,98,205,364
3404-001,2017,2,14,1,105,59,164,205
3404-001,2017,2,14,2,61,44,105,164
3404-001,2017,2,14,3,51,75,126,105
3404-001,2017,2,14,4,64,49,113,126
3404-001,2017,2,14,5,73,86,159,113
3404-001,2017,2,14,6,127,208,335,159
3404-001,2017,2,14,7,262,600,862,335
3404-001,2017,2,14,8,594,1727,2321,862
3404-001,2017,2,14,9,896,1383,2279,2321
3404-001,2017,2,14,10,821,953,1774,2279
3404-001,2017,2,14,11,846,915,1761,1774
3404-001,2017,2,14,12,871,840,1711,1761
3404-001,2017,2,14,13,699,819,1518,1711
3404-001,2017,2,14,14,773,856,1629,1518
3404-001,2017,2,14,15,888,907,1795,1629
3404-001,2017,2,14,16,947,883,1830,1795
3404-001,2017,2,14,17,1029,794,1823,1830
3404-001,2017,2,14,18,1198,656,1854,1823
3404-001,2017,2,14,19,1055,590,1645,1854
3404-001,2017,2,14,20,745,439,1184,1645
3404-001,2017,2,14,21,720,301,1021,1184
3404-001,2017,2,14,22,406,230,636,1021
3404-001,2017,2,14,23,237,163,400,636
3404-001,2017,2,14,24,135,90,225,400
3404-001,2017,2,15,1,85,77,162,225
3404-001,2017,2,15,2,57,73,130,162
3404-001,2017,2,15,3,49,49,98,130
3404-001,2017,2,15,4,63,61,124,98
3404-001,2017,2,15,5,84,84,168,124
3404-001,2017,2,15,6,114,232,346,168
3404-001,2017,2,15,7,275,567,842,346
3404-001,2017,2,15,8,536,1795,2331,842
3404-001,2017,2,15,9,891,1429,2320,2331
3404-001,2017,2,15,10,895,935,1830,2320
3404-001,2017,2,15,11,914,938,1852,1830
3404-001,2017,2,15,12,827,879,1706,1852
3404-001,2017,2,15,13,647,801,1448,1706
3404-001,2017,2,15,14,780,894,1674,1448
3404-001,2017,2,15,15,901,926,1827,1674
3404-001,2017,2,15,16,961,814,1775,1827
3404-001,2017,2,15,17,932,722,1654,1775
3404-001,2017,2,15,18,1247,696,1943,1654
3404-001,2017,2,15,19,1115,569,1684,1943
3404-001,2017,2,15,20,682,393,1075,1684
3404-001,2017,2,15,21,550,302,852,1075
3404-001,2017,2,15,22,367,224,591,852
3404-001,2017,2,15,23,203,139,342,591
3404-001,2017,2,15,24,167,116,283,342
3404-001,2017,2,16,1,116,87,203,283
3404-001,2017,2,16,2,79,62,141,203
3404-001,2017,2,16,3,55,68,123,141
3404-001,2017,2,16,4,51,40,91,123
3404-001,2017,2,16,5,72,81,153,91
3404-001,2017,2,16,6,113,208,321,153
3404-001,2017,2,16,7,269,571,840,321
3404-001,2017,2,16,8,582,1791,2373,840
3404-001,2017,2,16,9,863,1355,2218,2373
3404-001,2017,2,16,10,833,873,1706,2218
3404-001,2017,2,16,11,822,851,1673,1706
3404-001,2017,2,16,12,804,913,1717,1673
3404-001,2017,2,16,13,619,820,1439,1717
3404-001,2017,2,16,14,766,867,1633,1439
3404-001,2017,2,16,15,908,907,1815,1633
3404-001,2017,2,16,16,921,900,1821,1815
3404-001,2017,2,16,17,928,780,1708,1821
3404-001,2017,2,16,18,1197,673,1870,1708
3404-001,2017,2,16,19,1061,550,1611,1870
3404-001,2017,2,16,20,707,425,1132,1611
3404-001,2017,2,16,21,701,329,1030,1132
3404-001,2017,2,16,22,376,241,617,1030
3404-001,2017,2,16,23,226,137,363,617
3404-001,2017,2,16,24,155,124,279,363
3404-001,2017,2,17,1,110,75,185,279
3404-001,2017,2,17,2,66,45,111,185
3404-001,2017,2,17,3,50,38,88,111
3404-001,2017,2,17,4,44,48,92,88
3404-001,2017,2,17,5,61,76,137,92
3404-001,2017,2,17,6,124,219,343,137
3404-001,2017,2,17,7,284,574,858,343
3404-001,2017,2,17,8,589,1781,2370,858
3404-001,2017,2,17,9,983,1337,2320,2370
3404-001,2017,2,17,10,869,882,1751,2320
3404-001,2017,2,17,11,866,853,1719,1751
3404-001,2017,2,17,12,850,799,1649,1719
3404-001,2017,2,17,13,726,785,1511,1649
3404-001,2017,2,17,14,732,821,1553,1511
3404-001,2017,2,17,15,880,952,1832,1553
3404-001,2017,2,17,16,973,818,1791,1832
3404-001,2017,2,17,17,929,769,1698,1791
3404-001,2017,2,17,18,1314,714,2028,1698
3404-001,2017,2,17,19,1259,640,1899,2028
3404-001,2017,2,17,20,847,490,1337,1899
3404-001,2017,2,17,21,586,329,915,1337
3404-001,2017,2,17,22,401,222,623,915
3404-001,2017,2,17,23,218,184,402,623
3404-001,2017,2,17,24,114,98,212,402
3404-001,2017,2,18,1,103,69,172,212
3404-001,2017,2,18,2,84,57,141,172
3404-001,2017,2,18,3,54,47,101,141
3404-001,2017,2,18,4,59,47,106,101
3404-001,2017,2,18,5,85,64,149,106
3404-001,2017,2,18,6,108,155,263,149
3404-001,2017,2,18,7,166,401,567,263
3404-001,2017,2,18,8,404,776,1180,567
3404-001,2017,2,18,9,655,848,1503,1180
3404-001,2017,2,18,10,732,715,1447,1503
3404-001,2017,2,18,11,699,749,1448,1447
3404-001,2017,2,18,12,626,698,1324,1448
3404-001,2017,2,18,13,582,661,1243,1324
3404-001,2017,2,18,14,625,636,1261,1243
3404-001,2017,2,18,15,630,643,1273,1261
3404-001,2017,2,18,16,629,610,1239,1273
3404-001,2017,2,18,17,729,529,1258,1239
3404-001,2017,2,18,18,973,510,1483,1258
3404-001,2017,2,18,19,534,438,972,1483
3404-001,2017,2,18,20,295,272,567,972
3404-001,2017,2,18,21,268,189,457,567
3404-001,2017,2,18,22,178,144,322,457
3404-001,2017,2,18,23,106,121,227,322
3404-001,2017,2,18,24,76,90,166,227
3404-001,2017,2,19,1,49,53,102,166
3404-001,2017,2,19,2,44,41,85,102
3404-001,2017,2,19,3,40,37,77,85
3404-001,2017,2,19,4,25,30,55,77
3404-001,2017,2,19,5,27,28,55,55
3404-001,2017,2,19,6,45,49,94,55
3404-001,2017,2,19,7,69,175,244,94
3404-001,2017,2,19,8,129,285,414,244
3404-001,2017,2,19,9,229,313,542,414
3404-001,2017,2,19,10,247,323,570,542
3404-001,2017,2,19,11,277,381,658,570
3404-001,2017,2,19,12,324,403,727,658
3404-001,2017,2,19,13,318,407,725,727
3404-001,2017,2,19,14,370,375,745,725
3404-001,2017,2,19,15,470,413,883,745
3404-001,2017,2,19,16,540,437,977,883
3404-001,2017,2,19,17,563,353,916,977
3404-001,2017,2,19,18,524,356,880,916
3404-001,2017,2,19,19,334,290,624,880
3404-001,2017,2,19,20,206,235,441,624
3404-001,2017,2,19,21,158,183,341,441
3404-001,2017,2,19,22,126,175,301,341
3404-001,2017,2,19,23,83,143,226,301
3404-001,2017,2,19,24,84,116,200,226
3404-001,2017,2,20,1,44,65,109,200
3404-001,2017,2,20,2,36,57,93,109
3404-001,2017,2,20,3,18,56,74,93
3404-001,2017,2,20,4,42,44,86,74
3404-001,2017,2,20,5,50,86,136,86
3404-001,2017,2,20,6,112,212,324,136
3404-001,2017,2,20,7,277,633,910,324
3404-001,2017,2,20,8,615,1915,2530,910
3404-001,2017,2,20,9,819,1326,2145,2530
3404-001,2017,2,20,10,791,807,1598,2145
3404-001,2017,2,20,11,816,874,1690,1598
3404-001,2017,2,20,12,801,740,1541,1690
3404-001,2017,2,20,13,686,706,1392,1541
3404-001,2017,2,20,14,760,802,1562,1392
3404-001,2017,2,20,15,946,891,1837,1562
3404-001,2017,2,20,16,929,821,1750,1837
3404-001,2017,2,20,17,952,688,1640,1750
3404-001,2017,2,20,18,1137,685,1822,1640
3404-001,2017,2,20,19,1044,599,1643,1822
3404-001,2017,2,20,20,754,428,1182,1643
3404-001,2017,2,20,21,711,282,993,1182
3404-001,2017,2,20,22,424,209,633,993
3404-001,2017,2,20,23,201,138,339,633
3404-001,2017,2,20,24,138,110,248,339
3404-001,2017,2,21,1,96,83,179,248
3404-001,2017,2,21,2,67,58,125,179
3404-001,2017,2,21,3,49,38,87,125
3404-001,2017,2,21,4,47,65,112,87
3404-001,2017,2,21,5,59,95,154,112
3404-001,2017,2,21,6,127,200,327,154
3404-001,2017,2,21,7,280,619,899,327
3404-001,2017,2,21,8,613,1829,2442,899
3404-001,2017,2,21,9,919,1322,2241,2442
3404-001,2017,2,21,10,874,941,1815,2241
3404-001,2017,2,21,11,873,906,1779,1815
3404-001,2017,2,21,12,843,865,1708,1779
3404-001,2017,2,21,13,669,781,1450,1708
3404-001,2017,2,21,14,829,1010,1839,1450
3404-001,2017,2,21,15,928,966,1894,1839
3404-001,2017,2,21,16,957,893,1850,1894
3404-001,2017,2,21,17,916,757,1673,1850
3404-001,2017,2,21,18,1225,703,1928,1673
3404-001,2017,2,21,19,1055,575,1630,1928
3404-001,2017,2,21,20,695,424,1119,1630
3404-001,2017,2,21,21,674,296,970,1119
3404-001,2017,2,21,22,423,218,641,970
3404-001,2017,2,21,23,212,158,370,641
3404-001,2017,2,21,24,120,103,223,370
3404-001,2017,2,22,1,81,79,160,223
3404-001,2017,2,22,2,78,73,151,160
3404-001,2017,2,22,3,59,57,116,151
3404-001,2017,2,22,4,61,57,118,116
3404-001,2017,2,22,5,62,95,157,118
3404-001,2017,2,22,6,139,209,348,157
3404-001,2017,2,22,7,262,569,831,348
3404-001,2017,2,22,8,573,1761,2334,831
3404-001,2017,2,22,9,858,1362,2220,2334
3404-001,2017,2,22,10,772,853,1625,2220
3404-001,2017,2,22,11,684,785,1469,1625
3404-001,2017,2,22,12,690,730,1420,1469
3404-001,2017,2,22,13,716,666,1382,1420
3404-001,2017,2,22,14,680,645,1325,1382
3404-001,2017,2,22,15,823,644,1467,1325
3404-001,2017,2,22,16,839,721,1560,1467
3404-001,2017,2,22,17,757,629,1386,1560
3404-001,2017,2,22,18,1155,592,1747,1386
3404-001,2017,2,22,19,994,452,1446,1747
3404-001,2017,2,22,20,629,390,1019,1446
3404-001,2017,2,22,21,547,284,831,1019
3404-001,2017,2,22,22,330,197,527,831
3404-001,2017,2,22,23,193,137,330,527
3404-001,2017,2,22,24,119,93,212,330
3404-001,2017,2,23,1,102,79,181,212
3404-001,2017,2,23,2,77,61,138,181
3404-001,2017,2,23,3,39,53,92,138
3404-001,2017,2,23,4,44,37,81,92
3404-001,2017,2,23,5,64,85,149,81
3404-001,2017,2,23,6,127,199,326,149
3404-001,2017,2,23,7,265,570,835,326
3404-001,2017,2,23,8,540,1775,2315,835
3404-001,2017,2,23,9,860,1336,2196,2315
3404-001,2017,2,23,10,801,922,1723,2196
3404-001,2017,2,23,11,892,899,1791,1723
3404-001,2017,2,23,12,840,894,1734,1791
3404-001,2017,2,23,13,734,822,1556,1734
3404-001,2017,2,23,14,766,894,1660,1556
3404-001,2017,2,23,15,881,989,1870,1660
3404-001,2017,2,23,16,923,812,1735,1870
3404-001,2017,2,23,17,913,700,1613,1735
3404-001,2017,2,23,18,1119,686,1805,1613
3404-001,2017,2,23,19,1066,585,1651,1805
3404-001,2017,2,23,20,696,410,1106,1651
3404-001,2017,2,23,21,650,305,955,1106
3404-001,2017,2,23,22,409,241,650,955
3404-001,2017,2,23,23,218,135,353,650
3404-001,2017,2,23,24,143,101,244,353
3404-001,2017,2,24,1,85,90,175,244
3404-001,2017,2,24,2,85,77,162,175
3404-001,2017,2,24,3,40,57,97,162
3404-001,2017,2,24,4,61,51,112,97
3404-001,2017,2,24,5,89,74,163,112
3404-001,2017,2,24,6,142,221,363,163
3404-001,2017,2,24,7,290,641,931,363
3404-001,2017,2,24,8,614,1748,2362,931
3404-001,2017,2,24,9,836,1324,2160,2362
3404-001,2017,2,24,10,857,874,1731,2160
3404-001,2017,2,24,11,923,891,1814,1731
3404-001,2017,2,24,12,816,866,1682,1814
3404-001,2017,2,24,13,740,808,1548,1682
3404-001,2017,2,24,14,828,988,1816,1548
3404-001,2017,2,24,15,916,1013,1929,1816
3404-001,2017,2,24,16,982,874,1856,1929
3404-001,2017,2,24,17,978,819,1797,1856
3404-001,2017,2,24,18,1416,726,2142,1797
3404-001,2017,2,24,19,1297,659,1956,2142
3404-001,2017,2,24,20,751,497,1248,1956
3404-001,2017,2,24,21,670,356,1026,1248
3404-001,2017,2,24,22,346,229,575,1026
3404-001,2017,2,24,23,235,158,393,575
3404-001,2017,2,24,24,134,102,236,393
3404-001,2017,2,25,1,117,94,211,236
3404-001,2017,2,25,2,67,65,132,211
3404-001,2017,2,25,3,62,51,113,132
3404-001,2017,2,25,4,57,66,123,113
3404-001,2017,2,25,5,69,57,126,123
3404-001,2017,2,25,6,100,175,275,126
3404-001,2017,2,25,7,180,411,591,275
3404-001,2017,2,25,8,359,760,1119,591
3404-001,2017,2,25,9,615,821,1436,1119
3404-001,2017,2,25,10,670,705,1375,1436
3404-001,2017,2,25,11,663,713,1376,1375
3404-001,2017,2,25,12,609,747,1356,1376
3404-001,2017,2,25,13,556,703,1259,1356
3404-001,2017,2,25,14,550,675,1225,1259
3404-001,2017,2,25,15,578,651,1229,1225
3404-001,2017,2,25,16,677,616,1293,1229
3404-001,2017,2,25,17,798,550,1348,1293
3404-001,2017,2,25,18,1053,524,1577,1348
3404-001,2017,2,25,19,673,463,1136,1577
3404-001,2017,2,25,20,343,339,682,1136
3404-001,2017,2,25,21,266,238,504,682
3404-001,2017,2,25,22,210,170,380,504
3404-001,2017,2,25,23,133,124,257,380
3404-001,2017,2,25,24,99,73,172,257
3404-001,2017,2,26,1,67,45,112,172
3404-001,2017,2,26,2,53,49,102,112
3404-001,2017,2,26,3,29,30,59,102
3404-001,2017,2,26,4,24,23,47,59
3404-001,2017,2,26,5,37,31,68,47
3404-001,2017,2,26,6,48,53,101,68
3404-001,2017,2,26,7,80,174,254,101
3404-001,2017,2,26,8,141,284,425,254
3404-001,2017,2,26,9,230,375,605,425
3404-001,2017,2,26,10,275,326,601,605
3404-001,2017,2,26,11,302,388,690,601
3404-001,2017,2,26,12,275,445,720,690
3404-001,2017,2,26,13,329,435,764,720
3404-001,2017,2,26,14,344,444,788,764
3404-001,2017,2,26,15,437,476,913,788
3404-001,2017,2,26,16,529,426,955,913
3404-001,2017,2,26,17,567,397,964,955
3404-001,2017,2,26,18,719,357,1076,964
3404-001,2017,2,26,19,432,351,783,1076
3404-001,2017,2,26,20,306,307,613,783
3404-001,2017,2,26,21,222,298,520,613
3404-001,2017,2,26,22,185,232,417,520
3404-001,2017,2,26,23,99,153,252,417
3404-001,2017,2,26,24,102,134,236,252
3404-001,2017,2,27,1,44,70,114,236
3404-001,2017,2,27,2,25,77,102,114
3404-001,2017,2,27,3,26,43,69,102
3404-001,2017,2,27,4,33,66,99,69
3404-001,2017,2,27,5,74,98,172,99
3404-001,2017,2,27,6,142,212,354,172
3404-001,2017,2,27,7,296,781,1077,354
3404-001,2017,2,27,8,622,1906,2528,1077
3404-001,2017,2,27,9,839,1458,2297,2528
3404-001,2017,2,27,10,923,936,1859,2297
3404-001,2017,2,27,11,881,942,1823,1859
3404-001,2017,2,27,12,901,989,1890,1823
3404-001,2017,2,27,13,678,874,1552,1890
3404-001,2017,2,27,14,786,960,1746,1552
3404-001,2017,2,27,15,999,995,1994,1746
3404-001,2017,2,27,16,1001,955,1956,1994
3404-001,2017,2,27,17,997,908,1905,1956
3404-001,2017,2,27,18,1260,758,2018,1905
3404-001,2017,2,27,19,1066,563,1629,2018
3404-001,2017,2,27,20,750,456,1206,1629
3404-001,2017,2,27,21,710,322,1032,1206
3404-001,2017,2,27,22,441,233,674,1032
3404-001,2017,2,27,23,244,140,384,674
3404-001,2017,2,27,24,155,106,261,384
3404-001,2017,2,28,1,106,94,200,261
3404-001,2017,2,28,2,70,66,136,200
3404-001,2017,2,28,3,41,72,113,136
3404-001,2017,2,28,4,58,65,123,113
3404-001,2017,2,28,5,95,125,220,123
3404-001,2017,2,28,6,122,242,364,220
3404-001,2017,2,28,7,314,655,969,364
3404-001,2017,2,28,8,584,1897,2481,969
3404-001,2017,2,28,9,874,1418,2292,2481
3404-001,2017,2,28,10,858,990,1848,2292
3404-001,2017,2,28,11,900,899,1799,1848
3404-001,2017,2,28,12,834,897,1731,1799
3404-001,2017,2,28,13,706,829,1535,1731
3404-001,2017,2,28,14,795,857,1652,1535
3404-001,2017,2,28,15,888,975,1863,1652
3404-001,2017,2,28,16,964,953,1917,1863
3404-001,2017,2,28,17,1017,795,1812,1917
3404-001,2017,2,28,18,1370,776,2146,1812
3404-001,2017,2,28,19,1271,664,1935,2146
3404-001,2017,2,28,20,829,475,1304,1935
3404-001,2017,2,28,21,724,346,1070,1304
3404-001,2017,2,28,22,411,273,684,1070
3404-001,2017,2,28,23,233,160,393,684
3404-001,2017,2,28,24,146,84,230,393
3404-001,2017,3,1,1,117,67,184,230
3404-001,2017,3,1,2,72,51,123,184
3404-001,2017,3,1,3,45,48,93,123
3404-001,2017,3,1,4,55,38,93,93
3404-001,2017,3,1,5,58,68,126,93
3404-001,2017,3,1,6,92,137,229,126
3404-001,2017,3,1,7,214,414,628,229
3404-001,2017,3,1,8,379,815,1194,628
3404-001,2017,3,1,9,565,708,1273,1194
3404-001,2017,3,1,10,519,549,1068,1273
3404-001,2017,3,1,11,608,586,1194,1068
3404-001,2017,3,1,12,541,541,1082,1194
3404-001,2017,3,1,13,534,498,1032,1082
3404-001,2017,3,1,14,568,540,1108,1032
3404-001,2017,3,1,15,614,554,1168,1108
3404-001,2017,3,1,16,671,478,1149,1168
3404-001,2017,3,1,17,811,467,1278,1149
3404-001,2017,3,1,18,955,449,1404,1278
3404-001,2017,3,1,19,604,363,967,1404
3404-001,2017,3,1,20,358,318,676,967
3404-001,2017,3,1,21,308,220,528,676
3404-001,2017,3,1,22,170,90,260,528
3404-001,2017,3,1,23,107,70,177,260
3404-001,2017,3,1,24,83,36,119,177
3404-001,2017,3,2,1,67,32,99,119
3404-001,2017,3,2,2,28,23,51,99
3404-001,2017,3,2,3,41,16,57,51
3404-001,2017,3,2,4,42,16,58,57
3404-001,2017,3,2,5,60,15,75,58
3404-001,2017,3,2,6,101,79,180,75
3404-001,2017,3,2,7,288,309,597,180
3404-001,2017,3,2,8,613,1456,2069,597
3404-001,2017,3,2,9,833,1235,2068,2069
3404-001,2017,3,2,10,808,675,1483,2068
3404-001,2017,3,2,11,859,772,1631,1483
3404-001,2017,3,2,12,802,729,1531,1631
3404-001,2017,3,2,13,687,638,1325,1531
3404-001,2017,3,2,14,723,723,1446,1325
3404-001,2017,3,2,15,851,787,1638,1446
3404-001,2017,3,2,16,880,763,1643,1638
3404-001,2017,3,2,17,848,696,1544,1643
3404-001,2017,3,2,18,1168,619,1787,1544
3404-001,2017,3,2,19,1050,561,1611,1787
3404-001,2017,3,2,20,727,401,1128,1611
3404-001,2017,3,2,21,684,306,990,1128
3404-001,2017,3,2,22,436,210,646,990
3404-001,2017,3,2,23,203,145,348,646
3404-001,2017,3,2,24,134,92,226,348
3404-001,2017,3,3,1,111,94,205,226
3404-001,2017,3,3,2,73,59,132,205
3404-001,2017,3,3,3,38,40,78,132
3404-001,2017,3,3,4,64,56,120,78
3404-001,2017,3,3,5,67,66,133,120
3404-001,2017,3,3,6,142,202,344,133
3404-001,2017,3,3,7,253,640,893,344
3404-001,2017,3,3,8,563,1617,2180,893
3404-001,2017,3,3,9,839,1293,2132,2180
3404-001,2017,3,3,10,868,818,1686,2132
3404-001,2017,3,3,11,833,732,1565,1686
3404-001,2017,3,3,12,748,728,1476,1565
3404-001,2017,3,3,13,660,576,1236,1476
3404-001,2017,3,3,14,718,750,1468,1236
3404-001,2017,3,3,15,897,808,1705,1468
3404-001,2017,3,3,16,865,774,1639,1705
3404-001,2017,3,3,17,958,773,1731,1639
3404-001,2017,3,3,18,1325,708,2033,1731
3404-001,2017,3,3,19,1305,591,1896,2033
3404-001,2017,3,3,20,856,497,1353,1896
3404-001,2017,3,3,21,648,330,978,1353
3404-001,2017,3,3,22,436,220,656,978
3404-001,2017,3,3,23,244,174,418,656
3404-001,2017,3,3,24,164,116,280,418
3404-001,2017,3,4,1,110,75,185,280
3404-001,2017,3,4,2,64,56,120,185
3404-001,2017,3,4,3,54,66,120,120
3404-001,2017,3,4,4,44,54,98,120
3404-001,2017,3,4,5,93,79,172,98
3404-001,2017,3,4,6,100,150,250,172
3404-001,2017,3,4,7,218,376,594,250
3404-001,2017,3,4,8,409,793,1202,594
3404-001,2017,3,4,9,652,785,1437,1202
3404-001,2017,3,4,10,614,639,1253,1437
3404-001,2017,3,4,11,631,640,1271,1253
3404-001,2017,3,4,12,555,640,1195,1271
3404-001,2017,3,4,13,534,591,1125,1195
3404-001,2017,3,4,14,542,559,1101,1125
3404-001,2017,3,4,15,576,557,1133,1101
3404-001,2017,3,4,16,670,523,1193,1133
3404-001,2017,3,4,17,778,506,1284,1193
3404-001,2017,3,4,18,946,463,1409,1284
3404-001,2017,3,4,19,677,384,1061,1409
3404-001,2017,3,4,20,350,260,610,1061
3404-001,2017,3,4,21,277,198,475,610
3404-001,2017,3,4,22,190,155,345,475
3404-001,2017,3,4,23,102,104,206,345
3404-001,2017,3,4,24,92,71,163,206
3404-001,2017,3,5,1,69,37,106,163
3404-001,2017,3,5,2,58,33,91,106
3404-001,2017,3,5,3,32,29,61,91
3404-001,2017,3,5,4,28,20,48,61
3404-001,2017,3,5,5,31,23,54,48
3404-001,2017,3,5,6,24,51,75,54
3404-001,2017,3,5,7,74,162,236,75
3404-001,2017,3,5,8,162,230,392,236
3404-001,2017,3,5,9,293,300,593,392
3404-001,2017,3,5,10,304,309,613,593
3404-001,2017,3,5,11,308,365,673,613
3404-001,2017,3,5,12,332,411,743,673
3404-001,2017,3,5,13,377,399,776,743
3404-001,2017,3,5,14,332,374,706,776
3404-001,2017,3,5,15,396,433,829,706
3404-001,2017,3,5,16,517,434,951,829
3404-001,2017,3,5,17,593,379,972,951
3404-001,2017,3,5,18,684,375,1059,972
3404-001,2017,3,5,19,423,350,773,1059
3404-001,2017,3,5,20,291,250,541,773
3404-001,2017,3,5,21,269,210,479,541
3404-001,2017,3,5,22,170,169,339,479
3404-001,2017,3,5,23,108,151,259,339
3404-001,2017,3,5,24,87,102,189,259
3404-001,2017,3,6,1,46,31,77,189
3404-001,2017,3,6,2,32,60,92,77
3404-001,2017,3,6,3,19,64,83,92
3404-001,2017,3,6,4,38,43,81,83
3404-001,2017,3,6,5,66,86,152,81
3404-001,2017,3,6,6,134,214,348,152
3404-001,2017,3,6,7,309,663,972,348
3404-001,2017,3,6,8,681,1722,2403,972
3404-001,2017,3,6,9,850,1322,2172,2403
3404-001,2017,3,6,10,761,805,1566,2172
3404-001,2017,3,6,11,818,758,1576,1566
3404-001,2017,3,6,12,809,811,1620,1576
3404-001,2017,3,6,13,631,672,1303,1620
3404-001,2017,3,6,14,698,681,1379,1303
3404-001,2017,3,6,15,876,772,1648,1379
3404-001,2017,3,6,16,940,837,1777,1648
3404-001,2017,3,6,17,886,677,1563,1777
3404-001,2017,3,6,18,1232,639,1871,1563
3404-001,2017,3,6,19,1016,541,1557,1871
3404-001,2017,3,6,20,698,389,1087,1557
3404-001,2017,3,6,21,653,326,979,1087
3404-001,2017,3,6,22,437,204,641,979
3404-001,2017,3,6,23,227,137,364,641
3404-001,2017,3,6,24,114,105,219,364
3404-001,2017,3,7,1,70,92,162,219
3404-001,2017,3,7,2,59,50,109,162
3404-001,2017,3,7,3,50,35,85,109
3404-001,2017,3,7,4,37,64,101,85
3404-001,2017,3,7,5,85,72,157,101
3404-001,2017,3,7,6,156,218,374,157
3404-001,2017,3,7,7,320,586,906,374
3404-001,2017,3,7,8,666,1647,2313,906
3404-001,2017,3,7,9,894,1376,2270,2313
3404-001,2017,3,7,10,865,868,1733,2270
3404-001,2017,3,7,11,881,812,1693,1733
3404-001,2017,3,7,12,891,722,1613,1693
3404-001,2017,3,7,13,671,646,1317,1613
3404-001,2017,3,7,14,731,712,1443,1317
3404-001,2017,3,7,15,920,777,1697,1443
3404-001,2017,3,7,16,881,749,1630,1697
3404-001,2017,3,7,17,892,659,1551,1630
3404-001,2017,3,7,18,1133,641,1774,1551
3404-001,2017,3,7,19,1006,555,1561,1774
3404-001,2017,3,7,20,687,401,1088,1561
3404-001,2017,3,7,21,677,299,976,1088
3404-001,2017,3,7,22,429,257,686,976
3404-001,2017,3,7,23,239,153,392,686
3404-001,2017,3,7,24,132,113,245,392
3404-001,2017,3,8,1,101,84,185,245
3404-001,2017,3,8,2,69,56,125,185
3404-001,2017,3,8,3,49,49,98,125
3404-001,2017,3,8,4,48,58,106,98
3404-001,2017,3,8,5,64,75,139,106
3404-001,2017,3,8,6,140,199,339,139
3404-001,2017,3,8,7,302,598,900,339
3404-001,2017,3,8,8,658,1622,2280,900
3404-001,2017,3,8,9,906,1320,2226,2280
3404-001,2017,3,8,10,873,802,1675,2226
3404-001,2017,3,8,11,809,827,1636,1675
3404-001,2017,3,8,12,779,708,1487,1636
3404-001,2017,3,8,13,706,638,1344,1487
3404-001,2017,3,8,14,709,740,1449,1344
3404-001,2017,3,8,15,868,848,1716,1449
3404-001,2017,3,8,16,882,762,1644,1716
3404-001,2017,3,8,17,883,653,1536,1644
3404-001,2017,3,8,18,1349,603,1952,1536
3404-001,2017,3,8,19,1074,528,1602,1952
3404-001,2017,3,8,20,666,404,1070,1602
3404-001,2017,3,8,21,602,318,920,1070
3404-001,2017,3,8,22,354,239,593,920
3404-001,2017,3,8,23,209,144,353,593
3404-001,2017,3,8,24,145,99,244,353
3404-001,2017,3,9,1,103,81,184,244
3404-001,2017,3,9,2,66,61,127,184
3404-001,2017,3,9,3,72,49,121,127
3404-001,2017,3,9,4,59,60,119,121
3404-001,2017,3,9,5,76,87,163,119
3404-001,2017,3,9,6,119,199,318,163
3404-001,2017,3,9,7,285,595,880,318
3404-001,2017,3,9,8,665,1659,2324,880
3404-001,2017,3,9,9,954,1220,2174,2324
3404-001,2017,3,9,10,848,800,1648,2174
3404-001,2017,3,9,11,811,760,1571,1648
3404-001,2017,3,9,12,724,687,1411,1571
3404-001,2017,3,9,13,697,618,1315,1411
3404-001,2017,3,9,14,707,651,1358,1315
3404-001,2017,3,9,15,823,761,1584,1358
3404-001,2017,3,9,16,972,728,1700,1584
3404-001,2017,3,9,17,872,737,1609,1700
3404-001,2017,3,9,18,1173,689,1862,1609
3404-001,2017,3,9,19,1064,544,1608,1862
3404-001,2017,3,9,20,736,452,1188,1608
3404-001,2017,3,9,21,658,323,981,1188
3404-001,2017,3,9,22,408,258,666,981
3404-001,2017,3,9,23,223,131,354,666
3404-001,2017,3,9,24,126,96,222,354
3404-001,2017,3,10,1,114,76,190,222
3404-001,2017,3,10,2,54,69,123,190
3404-001,2017,3,10,3,39,49,88,123
3404-001,2017,3,10,4,66,63,129,88
3404-001,2017,3,10,5,79,73,152,129
3404-001,2017,3,10,6,126,221,347,152
3404-001,2017,3,10,7,293,618,911,347
3404-001,2017,3,10,8,612,1679,2291,911
3404-001,2017,3,10,9,897,1234,2131,2291
3404-001,2017,3,10,10,918,791,1709,2131
3404-001,2017,3,10,11,830,852,1682,1709
3404-001,2017,3,10,12,716,669,1385,1682
3404-001,2017,3,10,13,643,666,1309,1385
3404-001,2017,3,10,14,735,738,1473,1309
3404-001,2017,3,10,15,888,822,1710,1473
3404-001,2017,3,10,16,943,786,1729,1710
3404-001,2017,3,10,17,939,747,1686,1729
3404-001,2017,3,10,18,1305,720,2025,1686
3404-001,2017,3,10,19,1342,664,2006,2025
3404-001,2017,3,10,20,821,553,1374,2006
3404-001,2017,3,10,21,702,298,1000,1374
3404-001,2017,3,10,22,376,281,657,1000
3404-001,2017,3,10,23,193,141,334,657
3404-001,2017,3,10,24,125,119,244,334
3404-001,2017,3,11,1,116,90,206,244
3404-001,2017,3,11,2,76,76,152,206
3404-001,2017,3,11,3,54,51,105,152
3404-001,2017,3,11,4,49,59,108,105
3404-001,2017,3,11,5,73,59,132,108
3404-001,2017,3,11,6,120,156,276,132
3404-001,2017,3,11,7,224,418,642,276
3404-001,2017,3,11,8,378,792,1170,642
3404-001,2017,3,11,9,619,752,1371,1170
3404-001,2017,3,11,10,578,615,1193,1371
3404-001,2017,3,11,11,625,649,1274,1193
3404-001,2017,3,11,12,573,636,1209,1274
3404-001,2017,3,11,13,503,548,1051,1209
3404-001,2017,3,11,14,545,601,1146,1051
3404-001,2017,3,11,15,609,542,1151,1146
3404-001,2017,3,11,16,619,550,1169,1151
3404-001,2017,3,11,17,743,561,1304,1169
3404-001,2017,3,11,18,1043,547,1590,1304
3404-001,2017,3,11,19,652,445,1097,1590
3404-001,2017,3,11,20,386,315,701,1097
3404-001,2017,3,11,21,281,217,498,701
3404-001,2017,3,11,22,210,152,362,498
3404-001,2017,3,11,23,139,134,273,362
3404-001,2017,3,11,24,113,75,188,273
3404-001,2017,3,12,1,70,56,126,188
3404-001,2017,3,12,2,60,38,98,126
3404-001,2017,3,12,3,48,29,77,98
3404-001,2017,3,12,4,25,31,56,77
3404-001,2017,3,12,5,33,32,65,56
3404-001,2017,3,12,6,45,73,118,65
3404-001,2017,3,12,7,97,191,288,118
3404-001,2017,3,12,8,193,275,468,288
3404-001,2017,3,12,9,270,314,584,468
3404-001,2017,3,12,10,283,288,571,584
3404-001,2017,3,12,11,293,365,658,571
3404-001,2017,3,12,12,332,436,768,658
3404-001,2017,3,12,13,310,427,737,768
3404-001,2017,3,12,14,389,438,827,737
3404-001,2017,3,12,15,480,390,870,827
3404-001,2017,3,12,16,602,423,1025,870
3404-001,2017,3,12,17,623,438,1061,1025
3404-001,2017,3,12,18,701,398,1099,1061
3404-001,2017,3,12,19,465,317,782,1099
3404-001,2017,3,12,20,300,290,590,782
3404-001,2017,3,12,21,241,257,498,590
3404-001,2017,3,12,22,188,208,396,498
3404-001,2017,3,12,23,130,150,280,396
3404-001,2017,3,12,24,85,117,202,280
3404-001,2017,3,13,1,45,64,109,202
3404-001,2017,3,13,2,29,42,71,109
3404-001,2017,3,13,3,30,43,73,71
3404-001,2017,3,13,4,60,42,102,73
3404-001,2017,3,13,5,78,67,145,102
3404-001,2017,3,13,6,140,232,372,145
3404-001,2017,3,13,7,274,703,977,372
3404-001,2017,3,13,8,736,1854,2590,977
3404-001,2017,3,13,9,823,1283,2106,2590
3404-001,2017,3,13,10,800,787,1587,2106
3404-001,2017,3,13,11,796,771,1567,1587
3404-001,2017,3,13,12,788,774,1562,1567
3404-001,2017,3,13,13,716,619,1335,1562
3404-001,2017,3,13,14,682,708,1390,1335
3404-001,2017,3,13,15,886,765,1651,1390
3404-001,2017,3,13,16,873,773,1646,1651
3404-001,2017,3,13,17,940,707,1647,1646
3404-001,2017,3,13,18,1195,680,1875,1647
3404-001,2017,3,13,19,1152,571,1723,1875
3404-001,2017,3,13,20,779,462,1241,1723
3404-001,2017,3,13,21,756,308,1064,1241
3404-001,2017,3,13,22,375,227,602,1064
3404-001,2017,3,13,23,226,158,384,602
3404-001,2017,3,13,24,122,106,228,384
3404-001,2017,3,14,1,104,88,192,228
3404-001,2017,3,14,2,63,70,133,192
3404-001,2017,3,14,3,44,52,96,133
3404-001,2017,3,14,4,62,70,132,96
3404-001,2017,3,14,5,79,116,195,132
3404-001,2017,3,14,6,138,243,381,195
3404-001,2017,3,14,7,350,642,992,381
3404-001,2017,3,14,8,689,1763,2452,992
3404-001,2017,3,14,9,885,1209,2094,2452
3404-001,2017,3,14,10,855,873,1728,2094
3404-001,2017,3,14,11,890,780,1670,1728
3404-001,2017,3,14,12,814,723,1537,1670
3404-001,2017,3,14,13,742,682,1424,1537
3404-001,2017,3,14,14,761,723,1484,1424
3404-001,2017,3,14,15,918,799,1717,1484
3404-001,2017,3,14,16,916,765,1681,1717
3404-001,2017,3,14,17,940,719,1659,1681
3404-001,2017,3,14,18,1189,663,1852,1659
3404-001,2017,3,14,19,1046,601,1647,1852
3404-001,2017,3,14,20,799,414,1213,1647
3404-001,2017,3,14,21,649,314,963,1213
3404-001,2017,3,14,22,414,274,688,963
3404-001,2017,3,14,23,232,167,399,688
3404-001,2017,3,14,24,114,99,213,399
3404-001,2017,3,15,1,109,80,189,213
3404-001,2017,3,15,2,72,55,127,189
3404-001,2017,3,15,3,54,45,99,127
3404-001,2017,3,15,4,50,66,116,99
3404-001,2017,3,15,5,102,100,202,116
3404-001,2017,3,15,6,136,219,355,202
3404-001,2017,3,15,7,314,650,964,355
3404-001,2017,3,15,8,665,1777,2442,964
3404-001,2017,3,15,9,947,1335,2282,2442
3404-001,2017,3,15,10,836,827,1663,2282
3404-001,2017,3,15,11,890,811,1701,1663
3404-001,2017,3,15,12,892,751,1643,1701
3404-001,2017,3,15,13,629,734,1363,1643
3404-001,2017,3,15,14,753,705,1458,1363
3404-001,2017,3,15,15,836,835,1671,1458
3404-001,2017,3,15,16,861,782,1643,1671
3404-001,2017,3,15,17,906,712,1618,1643
3404-001,2017,3,15,18,1394,652,2046,1618
3404-001,2017,3,15,19,1166,584,1750,2046
3404-001,2017,3,15,20,751,455,1206,1750
3404-001,2017,3,15,21,559,315,874,1206
3404-001,2017,3,15,22,398,241,639,874
3404-001,2017,3,15,23,213,159,372,639
3404-001,2017,3,15,24,154,116,270,372
3404-001,2017,3,16,1,107,87,194,270
3404-001,2017,3,16,2,84,49,133,194
3404-001,2017,3,16,3,52,57,109,133
3404-001,2017,3,16,4,39,57,96,109
3404-001,2017,3,16,5,65,77,142,96
3404-001,2017,3,16,6,146,228,374,142
3404-001,2017,3,16,7,320,688,1008,374
3404-001,2017,3,16,8,656,1786,2442,1008
3404-001,2017,3,16,9,968,1339,2307,2442
3404-001,2017,3,16,10,894,850,1744,2307
3404-001,2017,3,16,11,804,848,1652,1744
3404-001,2017,3,16,12,853,791,1644,1652
3404-001,2017,3,16,13,662,687,1349,1644
3404-001,2017,3,16,14,733,760,1493,1349
3404-001,2017,3,16,15,898,766,1664,1493
3404-001,2017,3,16,16,815,757,1572,1664
3404-001,2017,3,16,17,953,681,1634,1572
3404-001,2017,3,16,18,1180,713,1893,1634
3404-001,2017,3,16,19,1178,618,1796,1893
3404-001,2017,3,16,20,797,404,1201,1796
3404-001,2017,3,16,21,679,343,1022,1201
3404-001,2017,3,16,22,408,271,679,1022
3404-001,2017,3,16,23,231,160,391,679
3404-001,2017,3,16,24,140,105,245,391
3404-001,2017,3,17,1,114,91,205,245
3404-001,2017,3,17,2,64,67,131,205
3404-001,2017,3,17,3,51,54,105,131
3404-001,2017,3,17,4,56,46,102,105
3404-001,2017,3,17,5,79,102,181,102
3404-001,2017,3,17,6,139,255,394,181
3404-001,2017,3,17,7,350,648,998,394
3404-001,2017,3,17,8,652,1768,2420,998
3404-001,2017,3,17,9,995,1385,2380,2420
3404-001,2017,3,17,10,864,821,1685,2380
3404-001,2017,3,17,11,871,786,1657,1685
3404-001,2017,3,17,12,880,702,1582,1657
3404-001,2017,3,17,13,697,711,1408,1582
3404-001,2017,3,17,14,803,726,1529,1408
3404-001,2017,3,17,15,923,803,1726,1529
3404-001,2017,3,17,16,976,813,1789,1726
3404-001,2017,3,17,17,1028,734,1762,1789
3404-001,2017,3,17,18,1439,785,2224,1762
3404-001,2017,3,17,19,1308,675,1983,2224
3404-001,2017,3,17,20,872,543,1415,1983
3404-001,2017,3,17,21,698,331,1029,1415
3404-001,2017,3,17,22,370,290,660,1029
3404-001,2017,3,17,23,248,161,409,660
3404-001,2017,3,17,24,153,108,261,409
3404-001,2017,3,18,1,130,76,206,261
3404-001,2017,3,18,2,77,81,158,206
3404-001,2017,3,18,3,58,46,104,158
3404-001,2017,3,18,4,62,57,119,104
3404-001,2017,3,18,5,81,76,157,119
3404-001,2017,3,18,6,118,189,307,157
3404-001,2017,3,18,7,223,446,669,307
3404-001,2017,3,18,8,450,805,1255,669
3404-001,2017,3,18,9,703,805,1508,1255
3404-001,2017,3,18,10,589,689,1278,1508
3404-001,2017,3,18,11,678,648,1326,1278
3404-001,2017,3,18,12,610,665,1275,1326
3404-001,2017,3,18,13,507,606,1113,1275
3404-001,2017,3,18,14,548,645,1193,1113
3404-001,2017,3,18,15,572,577,1149,1193
3404-001,2017,3,18,16,701,585,1286,1149
3404-001,2017,3,18,17,804,522,1326,1286
3404-001,2017,3,18,18,1061,577,1638,1326
3404-001,2017,3,18,19,731,437,1168,1638
3404-001,2017,3,18,20,424,304,728,1168
3404-001,2017,3,18,21,324,249,573,728
3404-001,2017,3,18,22,185,176,361,573
3404-001,2017,3,18,23,137,114,251,361
3404-001,2017,3,18,24,99,107,206,251
3404-001,2017,3,19,1,70,46,116,206
3404-001,2017,3,19,2,44,44,88,116
3404-001,2017,3,19,3,38,18,56,88
3404-001,2017,3,19,4,36,17,53,56
3404-001,2017,3,19,5,28,33,61,53
3404-001,2017,3,19,6,54,71,125,61
3404-001,2017,3,19,7,98,178,276,125
3404-001,2017,3,19,8,192,285,477,276
3404-001,2017,3,19,9,297,325,622,477
3404-001,2017,3,19,10,293,283,576,622
3404-001,2017,3,19,11,310,442,752,576
3404-001,2017,3,19,12,311,436,747,752
3404-001,2017,3,19,13,346,381,727,747
3404-001,2017,3,19,14,360,417,777,727
3404-001,2017,3,19,15,458,391,849,777
3404-001,2017,3,19,16,512,401,913,849
3404-001,2017,3,19,17,633,400,1033,913
3404-001,2017,3,19,18,669,384,1053,1033
3404-001,2017,3,19,19,557,413,970,1053
3404-001,2017,3,19,20,355,278,633,970
3404-001,2017,3,19,21,288,265,553,633
3404-001,2017,3,19,22,215,220,435,553
3404-001,2017,3,19,23,126,173,299,435
3404-001,2017,3,19,24,79,115,194,299
3404-001,2017,3,20,1,50,77,127,194
3404-001,2017,3,20,2,38,52,90,127
3404-001,2017,3,20,3,22,49,71,90
3404-001,2017,3,20,4,35,60,95,71
3404-001,2017,3,20,5,46,88,134,95
3404-001,2017,3,20,6,154,221,375,134
3404-001,2017,3,20,7,361,698,1059,375
3404-001,2017,3,20,8,722,1897,2619,1059
3404-001,2017,3,20,9,894,1358,2252,2619
3404-001,2017,3,20,10,843,877,1720,2252
3404-001,2017,3,20,11,908,783,1691,1720
3404-001,2017,3,20,12,858,774,1632,1691
3404-001,2017,3,20,13,698,694,1392,1632
3404-001,2017,3,20,14,774,811,1585,1392
3404-001,2017,3,20,15,940,839,1779,1585
3404-001,2017,3,20,16,925,737,1662,1779
3404-001,2017,3,20,17,936,711,1647,1662
3404-001,2017,3,20,18,1173,685,1858,1647
3404-001,2017,3,20,19,1071,604,1675,1858
3404-001,2017,3,20,20,760,439,1199,1675
3404-001,2017,3,20,21,727,335,1062,1199
3404-001,2017,3,20,22,405,238,643,1062
3404-001,2017,3,20,23,225,145,370,643
3404-001,2017,3,20,24,136,95,231,370
3404-001,2017,3,21,1,94,78,172,231
3404-001,2017,3,21,2,69,74,143,172
3404-001,2017,3,21,3,36,57,93,143
3404-001,2017,3,21,4,45,59,104,93
3404-001,2017,3,21,5,90,98,188,104
3404-001,2017,3,21,6,163,252,415,188
3404-001,2017,3,21,7,333,667,1000,415
3404-001,2017,3,21,8,712,1771,2483,1000
3404-001,2017,3,21,9,1008,1301,2309,2483
3404-001,2017,3,21,10,850,904,1754,2309
3404-001,2017,3,21,11,847,771,1618,1754
3404-001,2017,3,21,12,823,753,1576,1618
3404-001,2017,3,21,13,692,653,1345,1576
3404-001,2017,3,21,14,740,719,1459,1345
3404-001,2017,3,21,15,898,769,1667,1459
3404-001,2017,3,21,16,958,773,1731,1667
3404-001,2017,3,21,17,920,771,1691,1731
3404-001,2017,3,21,18,1196,703,1899,1691
3404-001,2017,3,21,19,1066,588,1654,1899
3404-001,2017,3,21,20,802,387,1189,1654
3404-001,2017,3,21,21,665,324,989,1189
3404-001,2017,3,21,22,388,263,651,989
3404-001,2017,3,21,23,258,159,417,651
3404-001,2017,3,21,24,128,87,215,417
3404-001,2017,3,22,1,99,72,171,215
3404-001,2017,3,22,2,58,75,133,171
3404-001,2017,3,22,3,44,48,92,133
3404-001,2017,3,22,4,59,73,132,92
3404-001,2017,3,22,5,83,90,173,132
3404-001,2017,3,22,6,139,234,373,173
3404-001,2017,3,22,7,324,624,948,373
3404-001,2017,3,22,8,735,1795,2530,948
3404-001,2017,3,22,9,1050,1247,2297,2530
3404-001,2017,3,22,10,879,850,1729,2297
3404-001,2017,3,22,11,849,768,1617,1729
3404-001,2017,3,22,12,780,742,1522,1617
3404-001,2017,3,22,13,671,669,1340,1522
3404-001,2017,3,22,14,763,673,1436,1340
3404-001,2017,3,22,15,861,696,1557,1436
3404-001,2017,3,22,16,877,770,1647,1557
3404-001,2017,3,22,17,928,779,1707,1647
3404-001,2017,3,22,18,1393,724,2117,1707
3404-001,2017,3,22,19,1223,563,1786,2117
3404-001,2017,3,22,20,722,407,1129,1786
3404-001,2017,3,22,21,563,279,842,1129
3404-001,2017,3,22,22,396,227,623,842
3404-001,2017,3,22,23,199,172,371,623
3404-001,2017,3,22,24,122,99,221,371
3404-001,2017,3,23,1,81,75,156,221
3404-001,2017,3,23,2,78,77,155,156
3404-001,2017,3,23,3,60,66,126,155
3404-001,2017,3,23,4,37,65,102,126
3404-001,2017,3,23,5,90,95,185,102
3404-001,2017,3,23,6,134,249,383,185
3404-001,2017,3,23,7,322,688,1010,383
3404-001,2017,3,23,8,690,1746,2436,1010
3404-001,2017,3,23,9,1027,1248,2275,2436
3404-001,2017,3,23,10,855,891,1746,2275
3404-001,2017,3,23,11,859,851,1710,1746
3404-001,2017,3,23,12,800,773,1573,1710
3404-001,2017,3,23,13,703,634,1337,1573
3404-001,2017,3,23,14,777,732,1509,1337
3404-001,2017,3,23,15,843,737,1580,1509
3404-001,2017,3,23,16,899,796,1695,1580
3404-001,2017,3,23,17,913,733,1646,1695
3404-001,2017,3,23,18,1231,711,1942,1646
3404-001,2017,3,23,19,1053,585,1638,1942
3404-001,2017,3,23,20,781,453,1234,1638
3404-001,2017,3,23,21,711,337,1048,1234
3404-001,2017,3,23,22,405,243,648,1048
3404-001,2017,3,23,23,231,190,421,648
3404-001,2017,3,23,24,156,128,284,421
3404-001,2017,3,24,1,101,107,208,284
3404-001,2017,3,24,2,71,54,125,208
3404-001,2017,3,24,3,66,47,113,125
3404-001,2017,3,24,4,66,53,119,113
3404-001,2017,3,24,5,66,96,162,119
3404-001,2017,3,24,6,148,253,401,162
3404-001,2017,3,24,7,314,649,963,401
3404-001,2017,3,24,8,717,1736,2453,963
3404-001,2017,3,24,9,1006,1263,2269,2453
3404-001,2017,3,24,10,849,913,1762,2269
3404-001,2017,3,24,11,875,855,1730,1762
3404-001,2017,3,24,12,787,802,1589,1730
3404-001,2017,3,24,13,676,690,1366,1589
3404-001,2017,3,24,14,786,709,1495,1366
3404-001,2017,3,24,15,907,795,1702,1495
3404-001,2017,3,24,16,943,725,1668,1702
3404-001,2017,3,24,17,954,697,1651,1668
3404-001,2017,3,24,18,1368,759,2127,1651
3404-001,2017,3,24,19,1389,651,2040,2127
3404-001,2017,3,24,20,826,510,1336,2040
3404-001,2017,3,24,21,650,346,996,1336
3404-001,2017,3,24,22,391,274,665,996
3404-001,2017,3,24,23,203,180,383,665
3404-001,2017,3,24,24,140,108,248,383
3404-001,2017,3,25,1,93,69,162,248
3404-001,2017,3,25,2,90,71,161,162
3404-001,2017,3,25,3,61,49,110,161
3404-001,2017,3,25,4,36,60,96,110
3404-001,2017,3,25,5,102,77,179,96
3404-001,2017,3,25,6,120,199,319,179
3404-001,2017,3,25,7,234,408,642,319
3404-001,2017,3,25,8,442,783,1225,642
3404-001,2017,3,25,9,693,785,1478,1225
3404-001,2017,3,25,10,602,658,1260,1478
3404-001,2017,3,25,11,632,699,1331,1260
3404-001,2017,3,25,12,623,693,1316,1331
3404-001,2017,3,25,13,564,591,1155,1316
3404-001,2017,3,25,14,548,576,1124,1155
3404-001,2017,3,25,15,633,560,1193,1124
3404-001,2017,3,25,16,673,538,1211,1193
3404-001,2017,3,25,17,723,464,1187,1211
3404-001,2017,3,25,18,1013,517,1530,1187
3404-001,2017,3,25,19,659,436,1095,1530
3404-001,2017,3,25,20,359,302,661,1095
3404-001,2017,3,25,21,284,210,494,661
3404-001,2017,3,25,22,160,172,332,494
3404-001,2017,3,25,23,152,135,287,332
3404-001,2017,3,25,24,97,71,168,287
3404-001,2017,3,26,1,69,78,147,168
3404-001,2017,3,26,2,63,44,107,147
3404-001,2017,3,26,3,27,28,55,107
3404-001,2017,3,26,4,31,31,62,55
3404-001,2017,3,26,5,31,38,69,62
3404-001,2017,3,26,6,50,87,137,69
3404-001,2017,3,26,7,104,190,294,137
3404-001,2017,3,26,8,197,313,510,294
3404-001,2017,3,26,9,318,331,649,510
3404-001,2017,3,26,10,294,319,613,649
3404-001,2017,3,26,11,326,410,736,613
3404-001,2017,3,26,12,354,404,758,736
3404-001,2017,3,26,13,328,382,710,758
3404-001,2017,3,26,14,394,364,758,710
3404-001,2017,3,26,15,506,375,881,758
3404-001,2017,3,26,16,570,390,960,881
3404-001,2017,3,26,17,611,354,965,960
3404-001,2017,3,26,18,671,358,1029,965
3404-001,2017,3,26,19,447,343,790,1029
3404-001,2017,3,26,20,317,272,589,790
3404-001,2017,3,26,21,278,253,531,589
3404-001,2017,3,26,22,183,211,394,531
3404-001,2017,3,26,23,110,147,257,394
3404-001,2017,3,26,24,88,104,192,257
3404-001,2017,3,27,1,45,72,117,192
3404-001,2017,3,27,2,25,59,84,117
3404-001,2017,3,27,3,32,46,78,84
3404-001,2017,3,27,4,41,56,97,78
3404-001,2017,3,27,5,71,64,135,97
3404-001,2017,3,27,6,130,224,354,135
3404-001,2017,3,27,7,331,668,999,354
3404-001,2017,3,27,8,762,1885,2647,999
3404-001,2017,3,27,9,944,1262,2206,2647
3404-001,2017,3,27,10,772,814,1586,2206
3404-001,2017,3,27,11,792,759,1551,1586
3404-001,2017,3,27,12,782,701,1483,1551
3404-001,2017,3,27,13,660,661,1321,1483
3404-001,2017,3,27,14,684,728,1412,1321
3404-001,2017,3,27,15,899,744,1643,1412
3404-001,2017,3,27,16,928,712,1640,1643
3404-001,2017,3,27,17,871,745,1616,1640
3404-001,2017,3,27,18,1233,700,1933,1616
3404-001,2017,3,27,19,1095,545,1640,1933
3404-001,2017,3,27,20,794,496,1290,1640
3404-001,2017,3,27,21,680,301,981,1290
3404-001,2017,3,27,22,396,247,643,981
3404-001,2017,3,27,23,256,161,417,643
3404-001,2017,3,27,24,113,111,224,417
3404-001,2017,3,28,1,89,81,170,224
3404-001,2017,3,28,2,68,52,120,170
3404-001,2017,3,28,3,41,61,102,120
3404-001,2017,3,28,4,56,74,130,102
3404-001,2017,3,28,5,81,126,207,130
3404-001,2017,3,28,6,148,248,396,207
3404-001,2017,3,28,7,343,657,1000,396
3404-001,2017,3,28,8,681,1766,2447,1000
3404-001,2017,3,28,9,947,1332,2279,2447
3404-001,2017,3,28,10,912,855,1767,2279
3404-001,2017,3,28,11,870,810,1680,1767
3404-001,2017,3,28,12,784,773,1557,1680
3404-001,2017,3,28,13,690,663,1353,1557
3404-001,2017,3,28,14,773,719,1492,1353
3404-001,2017,3,28,15,890,783,1673,1492
3404-001,2017,3,28,16,922,802,1724,1673
3404-001,2017,3,28,17,961,733,1694,1724
3404-001,2017,3,28,18,1219,690,1909,1694
3404-001,2017,3,28,19,1142,598,1740,1909
3404-001,2017,3,28,20,705,465,1170,1740
3404-001,2017,3,28,21,691,320,1011,1170
3404-001,2017,3,28,22,392,259,651,1011
3404-001,2017,3,28,23,221,159,380,651
3404-001,2017,3,28,24,133,104,237,380
3404-001,2017,3,29,1,112,71,183,237
3404-001,2017,3,29,2,63,59,122,183
3404-001,2017,3,29,3,59,65,124,122
3404-001,2017,3,29,4,39,76,115,124
3404-001,2017,3,29,5,64,81,145,115
3404-001,2017,3,29,6,152,227,379,145
3404-001,2017,3,29,7,337,649,986,379
3404-001,2017,3,29,8,677,1768,2445,986
3404-001,2017,3,29,9,969,1342,2311,2445
3404-001,2017,3,29,10,867,906,1773,2311
3404-001,2017,3,29,11,867,782,1649,1773
3404-001,2017,3,29,12,869,769,1638,1649
3404-001,2017,3,29,13,680,609,1289,1638
3404-001,2017,3,29,14,824,739,1563,1289
3404-001,2017,3,29,15,861,787,1648,1563
3404-001,2017,3,29,16,907,700,1607,1648
3404-001,2017,3,29,17,929,709,1638,1607
3404-001,2017,3,29,18,1310,672,1982,1638
3404-001,2017,3,29,19,1175,610,1785,1982
3404-001,2017,3,29,20,686,486,1172,1785
3404-001,2017,3,29,21,596,321,917,1172
3404-001,2017,3,29,22,317,244,561,917
3404-001,2017,3,29,23,235,188,423,561
3404-001,2017,3,29,24,171,112,283,423
3404-001,2017,3,30,1,102,111,213,283
3404-001,2017,3,30,2,97,49,146,213
3404-001,2017,3,30,3,66,71,137,146
3404-001,2017,3,30,4,57,79,136,137
3404-001,2017,3,30,5,79,96,175,136
3404-001,2017,3,30,6,142,247,389,175
3404-001,2017,3,30,7,347,668,1015,389
3404-001,2017,3,30,8,704,1794,2498,1015
3404-001,2017,3,30,9,970,1327,2297,2498
3404-001,2017,3,30,10,861,856,1717,2297
3404-001,2017,3,30,11,844,787,1631,1717
3404-001,2017,3,30,12,816,779,1595,1631
3404-001,2017,3,30,13,652,687,1339,1595
3404-001,2017,3,30,14,734,658,1392,1339
3404-001,2017,3,30,15,857,777,1634,1392
3404-001,2017,3,30,16,930,730,1660,1634
3404-001,2017,3,30,17,925,705,1630,1660
3404-001,2017,3,30,18,1168,709,1877,1630
3404-001,2017,3,30,19,1096,594,1690,1877
3404-001,2017,3,30,20,734,459,1193,1690
3404-001,2017,3,30,21,671,309,980,1193
3404-001,2017,3,30,22,422,262,684,980
3404-001,2017,3,30,23,237,156,393,684
3404-001,2017,3,30,24,165,110,275,393
3404-001,2017,3,31,1,132,70,202,275
3404-001,2017,3,31,2,67,61,128,202
3404-001,2017,3,31,3,52,58,110,128
3404-001,2017,3,31,4,65,56,121,110
3404-001,2017,3,31,5,74,93,167,121
3404-001,2017,3,31,6,117,250,367,167
3404-001,2017,3,31,7,328,622,950,367
3404-001,2017,3,31,8,628,1695,2323,950
3404-001,2017,3,31,9,955,1272,2227,2323
3404-001,2017,3,31,10,864,823,1687,2227
3404-001,2017,3,31,11,849,807,1656,1687
3404-001,2017,3,31,12,772,734,1506,1656
3404-001,2017,3,31,13,697,637,1334,1506
3404-001,2017,3,31,14,779,497,1276,1334
3404-001,2017,3,31,15,886,357,1243,1276
3404-001,2017,3,31,16,938,356,1294,1243
3404-001,2017,3,31,17,900,342,1242,1294
3404-001,2017,3,31,18,1290,374,1664,1242
3404-001,2017,3,31,19,1292,313,1605,1664
3404-001,2017,3,31,20,844,281,1125,1605
3404-001,2017,3,31,21,645,178,823,1125
3404-001,2017,3,31,22,384,144,528,823
3404-001,2017,3,31,23,260,96,356,528
3404-001,2017,3,31,24,151,65,216,356
3404-001,2017,4,1,1,110,78,188,216
3404-001,2017,4,1,2,66,58,124,188
3404-001,2017,4,1,3,56,38,94,124
3404-001,2017,4,1,4,60,26,86,94
3404-001,2017,4,1,5,63,24,87,86
3404-001,2017,4,1,6,123,139,262,87
3404-001,2017,4,1,7,235,348,583,262
3404-001,2017,4,1,8,421,843,1264,583
3404-001,2017,4,1,9,611,831,1442,1264
3404-001,2017,4,1,10,578,676,1254,1442
3404-001,2017,4,1,11,597,734,1331,1254
3404-001,2017,4,1,12,624,678,1302,1331
3404-001,2017,4,1,13,539,546,1085,1302
3404-001,2017,4,1,14,557,628,1185,1085
3404-001,2017,4,1,15,609,624,1233,1185
3404-001,2017,4,1,16,679,532,1211,1233
3404-001,2017,4,1,17,767,512,1279,1211
3404-001,2017,4,1,18,1090,519,1609,1279
3404-001,2017,4,1,19,701,474,1175,1609
3404-001,2017,4,1,20,393,334,727,1175
3404-001,2017,4,1,21,304,269,573,727
3404-001,2017,4,1,22,200,170,370,573
3404-001,2017,4,1,23,129,128,257,370
3404-001,2017,4,1,24,103,98,201,257
3404-001,2017,4,2,1,71,56,127,201
3404-001,2017,4,2,2,51,37,88,127
3404-001,2017,4,2,3,31,37,68,88
3404-001,2017,4,2,4,34,28,62,68
3404-001,2017,4,2,5,47,28,75,62
3404-001,2017,4,2,6,46,74,120,75
3404-001,2017,4,2,7,105,193,298,120
3404-001,2017,4,2,8,198,271,469,298
3404-001,2017,4,2,9,317,305,622,469
3404-001,2017,4,2,10,310,291,601,622
3404-001,2017,4,2,11,308,406,714,601
3404-001,2017,4,2,12,374,500,874,714
3404-001,2017,4,2,13,333,429,762,874
3404-001,2017,4,2,14,392,447,839,762
3404-001,2017,4,2,15,476,465,941,839
3404-001,2017,4,2,16,520,415,935,941
3404-001,2017,4,2,17,649,426,1075,935
3404-001,2017,4,2,18,757,384,1141,1075
3404-001,2017,4,2,19,642,411,1053,1141
3404-001,2017,4,2,20,448,361,809,1053
3404-001,2017,4,2,21,301,337,638,809
3404-001,2017,4,2,22,218,271,489,638
3404-001,2017,4,2,23,135,208,343,489
3404-001,2017,4,2,24,108,134,242,343
3404-001,2017,4,3,1,69,74,143,242
3404-001,2017,4,3,2,29,46,75,143
3404-001,2017,4,3,3,34,37,71,75
3404-001,2017,4,3,4,33,28,61,71
3404-001,2017,4,3,5,76,47,123,61
3404-001,2017,4,3,6,114,199,313,123
3404-001,2017,4,3,7,335,772,1107,313
3404-001,2017,4,3,8,744,2485,3229,1107
3404-001,2017,4,3,9,837,1593,2430,3229
3404-001,2017,4,3,10,780,664,1444,2430
3404-001,2017,4,3,11,786,638,1424,1444
3404-001,2017,4,3,12,780,620,1400,1424
3404-001,2017,4,3,13,664,593,1257,1400
3404-001,2017,4,3,14,734,554,1288,1257
3404-001,2017,4,3,15,821,723,1544,1288
3404-001,2017,4,3,16,904,667,1571,1544
3404-001,2017,4,3,17,901,628,1529,1571
3404-001,2017,4,3,18,1167,743,1910,1529
3404-001,2017,4,3,19,1067,574,1641,1910
3404-001,2017,4,3,20,807,404,1211,1641
3404-001,2017,4,3,21,787,373,1160,1211
3404-001,2017,4,3,22,403,233,636,1160
3404-001,2017,4,3,23,246,150,396,636
3404-001,2017,4,3,24,152,100,252,396
3404-001,2017,4,4,1,96,62,158,252
3404-001,2017,4,4,2,62,31,93,158
3404-001,2017,4,4,3,38,26,64,93
3404-001,2017,4,4,4,63,29,92,64
3404-001,2017,4,4,5,76,33,109,92
3404-001,2017,4,4,6,125,202,327,109
3404-001,2017,4,4,7,313,628,941,327
3404-001,2017,4,4,8,698,2289,2987,941
3404-001,2017,4,4,9,937,1469,2406,2987
3404-001,2017,4,4,10,863,703,1566,2406
3404-001,2017,4,4,11,875,673,1548,1566
3404-001,2017,4,4,12,740,633,1373,1548
3404-001,2017,4,4,13,716,537,1253,1373
3404-001,2017,4,4,14,738,673,1411,1253
3404-001,2017,4,4,15,902,714,1616,1411
3404-001,2017,4,4,16,874,741,1615,1616
3404-001,2017,4,4,17,964,617,1581,1615
3404-001,2017,4,4,18,1182,656,1838,1581
3404-001,2017,4,4,19,1173,624,1797,1838
3404-001,2017,4,4,20,746,455,1201,1797
3404-001,2017,4,4,21,680,336,1016,1201
3404-001,2017,4,4,22,450,238,688,1016
3404-001,2017,4,4,23,236,127,363,688
3404-001,2017,4,4,24,183,105,288,363
3404-001,2017,4,5,1,110,47,157,288
3404-001,2017,4,5,2,67,28,95,157
3404-001,2017,4,5,3,45,24,69,95
3404-001,2017,4,5,4,72,22,94,69
3404-001,2017,4,5,5,89,44,133,94
3404-001,2017,4,5,6,132,159,291,133
3404-001,2017,4,5,7,333,586,919,291
3404-001,2017,4,5,8,711,2161,2872,919
3404-001,2017,4,5,9,1022,1471,2493,2872
3404-001,2017,4,5,10,913,745,1658,2493
3404-001,2017,4,5,11,875,728,1603,1658
3404-001,2017,4,5,12,820,624,1444,1603
3404-001,2017,4,5,13,670,588,1258,1444
3404-001,2017,4,5,14,840,638,1478,1258
3404-001,2017,4,5,15,843,804,1647,1478
3404-001,2017,4,5,16,870,676,1546,1647
3404-001,2017,4,5,17,810,610,1420,1546
3404-001,2017,4,5,18,1255,637,1892,1420
3404-001,2017,4,5,19,1127,543,1670,1892
3404-001,2017,4,5,20,631,375,1006,1670
3404-001,2017,4,5,21,554,318,872,1006
3404-001,2017,4,5,22,324,231,555,872
3404-001,2017,4,5,23,222,166,388,555
3404-001,2017,4,5,24,148,109,257,388
3404-001,2017,4,6,1,135,55,190,257
3404-001,2017,4,6,2,48,38,86,190
3404-001,2017,4,6,3,35,33,68,86
3404-001,2017,4,6,4,73,24,97,68
3404-001,2017,4,6,5,67,31,98,97
3404-001,2017,4,6,6,107,146,253,98
3404-001,2017,4,6,7,275,575,850,253
3404-001,2017,4,6,8,667,2136,2803,850
3404-001,2017,4,6,9,954,1509,2463,2803
3404-001,2017,4,6,10,827,777,1604,2463
3404-001,2017,4,6,11,793,745,1538,1604
3404-001,2017,4,6,12,859,696,1555,1538
3404-001,2017,4,6,13,676,568,1244,1555
3404-001,2017,4,6,14,729,691,1420,1244
3404-001,2017,4,6,15,889,662,1551,1420
3404-001,2017,4,6,16,915,696,1611,1551
3404-001,2017,4,6,17,911,656,1567,1611
3404-001,2017,4,6,18,1161,653,1814,1567
3404-001,2017,4,6,19,1065,577,1642,1814
3404-001,2017,4,6,20,732,503,1235,1642
3404-001,2017,4,6,21,695,346,1041,1235
3404-001,2017,4,6,22,396,253,649,1041
3404-001,2017,4,6,23,220,136,356,649
3404-001,2017,4,6,24,155,82,237,356
3404-001,2017,4,7,1,85,55,140,237
3404-001,2017,4,7,2,69,49,118,140
3404-001,2017,4,7,3,64,42,106,118
3404-001,2017,4,7,4,59,38,97,106
3404-001,2017,4,7,5,81,51,132,97
3404-001,2017,4,7,6,153,152,305,132
3404-001,2017,4,7,7,369,683,1052,305
3404-001,2017,4,7,8,688,2150,2838,1052
3404-001,2017,4,7,9,933,1530,2463,2838
3404-001,2017,4,7,10,855,725,1580,2463
3404-001,2017,4,7,11,874,804,1678,1580
3404-001,2017,4,7,12,820,691,1511,1678
3404-001,2017,4,7,13,652,561,1213,1511
3404-001,2017,4,7,14,824,683,1507,1213
3404-001,2017,4,7,15,931,795,1726,1507
3404-001,2017,4,7,16,970,707,1677,1726
3404-001,2017,4,7,17,1000,658,1658,1677
3404-001,2017,4,7,18,1402,781,2183,1658
3404-001,2017,4,7,19,1371,743,2114,2183
3404-001,2017,4,7,20,893,602,1495,2114
3404-001,2017,4,7,21,715,354,1069,1495
3404-001,2017,4,7,22,430,285,715,1069
3404-001,2017,4,7,23,276,193,469,715
3404-001,2017,4,7,24,148,114,262,469
3404-001,2017,4,8,1,120,76,196,262
3404-001,2017,4,8,2,83,60,143,196
3404-001,2017,4,8,3,70,53,123,143
3404-001,2017,4,8,4,49,24,73,123
3404-001,2017,4,8,5,92,49,141,73
3404-001,2017,4,8,6,139,154,293,141
3404-001,2017,4,8,7,257,437,694,293
3404-001,2017,4,8,8,452,847,1299,694
3404-001,2017,4,8,9,688,837,1525,1299
3404-001,2017,4,8,10,619,737,1356,1525
3404-001,2017,4,8,11,628,752,1380,1356
3404-001,2017,4,8,12,642,786,1428,1380
3404-001,2017,4,8,13,495,584,1079,1428
3404-001,2017,4,8,14,654,583,1237,1079
3404-001,2017,4,8,15,673,620,1293,1237
3404-001,2017,4,8,16,724,608,1332,1293
3404-001,2017,4,8,17,789,608,1397,1332
3404-001,2017,4,8,18,1089,613,1702,1397
3404-001,2017,4,8,19,782,491,1273,1702
3404-001,2017,4,8,20,427,370,797,1273
3404-001,2017,4,8,21,363,283,646,797
3404-001,2017,4,8,22,198,190,388,646
3404-001,2017,4,8,23,144,152,296,388
3404-001,2017,4,8,24,99,94,193,296
3404-001,2017,4,9,1,86,87,173,193
3404-001,2017,4,9,2,66,40,106,173
3404-001,2017,4,9,3,32,40,72,106
3404-001,2017,4,9,4,41,33,74,72
3404-001,2017,4,9,5,42,26,68,74
3404-001,2017,4,9,6,53,71,124,68
3404-001,2017,4,9,7,112,222,334,124
3404-001,2017,4,9,8,210,282,492,334
3404-001,2017,4,9,9,307,327,634,492
3404-001,2017,4,9,10,333,303,636,634
3404-001,2017,4,9,11,326,440,766,636
3404-001,2017,4,9,12,343,459,802,766
3404-001,2017,4,9,13,396,429,825,802
3404-001,2017,4,9,14,442,451,893,825
3404-001,2017,4,9,15,515,438,953,893
3404-001,2017,4,9,16,563,413,976,953
3404-001,2017,4,9,17,617,429,1046,976
3404-001,2017,4,9,18,673,424,1097,1046
3404-001,2017,4,9,19,522,379,901,1097
3404-001,2017,4,9,20,366,341,707,901
3404-001,2017,4,9,21,312,328,640,707
3404-001,2017,4,9,22,196,253,449,640
3404-001,2017,4,9,23,130,264,394,449
3404-001,2017,4,9,24,104,116,220,394
3404-001,2017,4,10,1,47,74,121,220
3404-001,2017,4,10,2,34,55,89,121
3404-001,2017,4,10,3,17,29,46,89
3404-001,2017,4,10,4,33,26,59,46
3404-001,2017,4,10,5,70,58,128,59
3404-001,2017,4,10,6,144,201,345,128
3404-001,2017,4,10,7,357,835,1192,345
3404-001,2017,4,10,8,734,2378,3112,1192
3404-001,2017,4,10,9,871,1624,2495,3112
3404-001,2017,4,10,10,832,763,1595,2495
3404-001,2017,4,10,11,775,736,1511,1595
3404-001,2017,4,10,12,810,694,1504,1511
3404-001,2017,4,10,13,734,635,1369,1504
3404-001,2017,4,10,14,770,707,1477,1369
3404-001,2017,4,10,15,933,736,1669,1477
3404-001,2017,4,10,16,882,732,1614,1669
3404-001,2017,4,10,17,935,629,1564,1614
3404-001,2017,4,10,18,1213,703,1916,1564
3404-001,2017,4,10,19,1065,572,1637,1916
3404-001,2017,4,10,20,787,471,1258,1637
3404-001,2017,4,10,21,683,327,1010,1258
3404-001,2017,4,10,22,455,264,719,1010
3404-001,2017,4,10,23,248,159,407,719
3404-001,2017,4,10,24,134,121,255,407
3404-001,2017,4,11,1,110,73,183,255
3404-001,2017,4,11,2,75,35,110,183
3404-001,2017,4,11,3,37,29,66,110
3404-001,2017,4,11,4,62,19,81,66
3404-001,2017,4,11,5,83,47,130,81
3404-001,2017,4,11,6,143,145,288,130
3404-001,2017,4,11,7,336,635,971,288
3404-001,2017,4,11,8,658,2085,2743,971
3404-001,2017,4,11,9,970,1554,2524,2743
3404-001,2017,4,11,10,831,765,1596,2524
3404-001,2017,4,11,11,850,784,1634,1596
3404-001,2017,4,11,12,814,669,1483,1634
3404-001,2017,4,11,13,683,604,1287,1483
3404-001,2017,4,11,14,743,610,1353,1287
3404-001,2017,4,11,15,880,725,1605,1353
3404-001,2017,4,11,16,968,714,1682,1605
3404-001,2017,4,11,17,864,689,1553,1682
3404-001,2017,4,11,18,1157,653,1810,1553
3404-001,2017,4,11,19,1110,574,1684,1810
3404-001,2017,4,11,20,784,537,1321,1684
3404-001,2017,4,11,21,653,305,958,1321
3404-001,2017,4,11,22,389,283,672,958
3404-001,2017,4,11,23,253,155,408,672
3404-001,2017,4,11,24,163,112,275,408
3404-001,2017,4,12,1,125,76,201,275
3404-001,2017,4,12,2,65,49,114,201
3404-001,2017,4,12,3,58,37,95,114
3404-001,2017,4,12,4,51,28,79,95
3404-001,2017,4,12,5,69,38,107,79
3404-001,2017,4,12,6,143,182,325,107
3404-001,2017,4,12,7,383,653,1036,325
3404-001,2017,4,12,8,704,2247,2951,1036
3404-001,2017,4,12,9,1015,1597,2612,2951
3404-001,2017,4,12,10,875,694,1569,2612
3404-001,2017,4,12,11,846,792,1638,1569
3404-001,2017,4,12,12,793,658,1451,1638
3404-001,2017,4,12,13,705,561,1266,1451
3404-001,2017,4,12,14,725,678,1403,1266
3404-001,2017,4,12,15,903,705,1608,1403
3404-001,2017,4,12,16,922,793,1715,1608
3404-001,2017,4,12,17,936,664,1600,1715
3404-001,2017,4,12,18,1457,725,2182,1600
3404-001,2017,4,12,19,1191,601,1792,2182
3404-001,2017,4,12,20,750,440,1190,1792
3404-001,2017,4,12,21,607,348,955,1190
3404-001,2017,4,12,22,376,267,643,955
3404-001,2017,4,12,23,215,148,363,643
3404-001,2017,4,12,24,175,110,285,363
3404-001,2017,4,13,1,117,74,191,285
3404-001,2017,4,13,2,72,49,121,191
3404-001,2017,4,13,3,37,38,75,121
3404-001,2017,4,13,4,63,40,103,75
3404-001,2017,4,13,5,96,53,149,103
3404-001,2017,4,13,6,152,175,327,149
3404-001,2017,4,13,7,359,633,992,327
3404-001,2017,4,13,8,739,2159,2898,992
3404-001,2017,4,13,9,912,1676,2588,2898
3404-001,2017,4,13,10,855,730,1585,2588
3404-001,2017,4,13,11,813,741,1554,1585
3404-001,2017,4,13,12,743,673,1416,1554
3404-001,2017,4,13,13,778,572,1350,1416
3404-001,2017,4,13,14,760,680,1440,1350
3404-001,2017,4,13,15,926,781,1707,1440
3404-001,2017,4,13,16,957,692,1649,1707
3404-001,2017,4,13,17,980,647,1627,1649
3404-001,2017,4,13,18,1237,746,1983,1627
3404-001,2017,4,13,19,1205,660,1865,1983
3404-001,2017,4,13,20,810,422,1232,1865
3404-001,2017,4,13,21,703,361,1064,1232
3404-001,2017,4,13,22,433,283,716,1064
3404-001,2017,4,13,23,257,184,441,716
3404-001,2017,4,13,24,144,110,254,441
3404-001,2017,4,14,1,109,73,182,254
3404-001,2017,4,14,2,74,46,120,182
3404-001,2017,4,14,3,40,38,78,120
3404-001,2017,4,14,4,56,35,91,78
3404-001,2017,4,14,5,86,53,139,91
3404-001,2017,4,14,6,143,164,307,139
3404-001,2017,4,14,7,377,700,1077,307
3404-001,2017,4,14,8,703,2065,2768,1077
3404-001,2017,4,14,9,903,1631,2534,2768
3404-001,2017,4,14,10,823,775,1598,2534
3404-001,2017,4,14,11,837,804,1641,1598
3404-001,2017,4,14,12,855,718,1573,1641
3404-001,2017,4,14,13,770,523,1293,1573
3404-001,2017,4,14,14,808,664,1472,1293
3404-001,2017,4,14,15,927,689,1616,1472
3404-001,2017,4,14,16,923,678,1601,1616
3404-001,2017,4,14,17,907,662,1569,1601
3404-001,2017,4,14,18,1400,792,2192,1569
3404-001,2017,4,14,19,1312,728,2040,2192
3404-001,2017,4,14,20,841,548,1389,2040
3404-001,2017,4,14,21,713,377,1090,1389
3404-001,2017,4,14,22,378,264,642,1090
3404-001,2017,4,14,23,218,168,386,642
3404-001,2017,4,14,24,123,119,242,386
3404-001,2017,4,15,1,124,92,216,242
3404-001,2017,4,15,2,84,55,139,216
3404-001,2017,4,15,3,54,58,112,139
3404-001,2017,4,15,4,65,44,109,112
3404-001,2017,4,15,5,84,71,155,109
3404-001,2017,4,15,6,151,150,301,155
3404-001,2017,4,15,7,270,417,687,301
3404-001,2017,4,15,8,445,869,1314,687
3404-001,2017,4,15,9,651,826,1477,1314
3404-001,2017,4,15,10,623,692,1315,1477
3404-001,2017,4,15,11,586,754,1340,1315
3404-001,2017,4,15,12,571,710,1281,1340
3404-001,2017,4,15,13,525,644,1169,1281
3404-001,2017,4,15,14,488,622,1110,1169
3404-001,2017,4,15,15,589,694,1283,1110
3404-001,2017,4,15,16,653,633,1286,1283
3404-001,2017,4,15,17,769,604,1373,1286
3404-001,2017,4,15,18,1132,537,1669,1373
3404-001,2017,4,15,19,734,494,1228,1669
3404-001,2017,4,15,20,431,343,774,1228
3404-001,2017,4,15,21,345,287,632,774
3404-001,2017,4,15,22,219,219,438,632
3404-001,2017,4,15,23,135,136,271,438
3404-001,2017,4,15,24,110,91,201,271
3404-001,2017,4,16,1,72,51,123,201
3404-001,2017,4,16,2,50,47,97,123
3404-001,2017,4,16,3,36,47,83,97
3404-001,2017,4,16,4,37,31,68,83
3404-001,2017,4,16,5,37,46,83,68
3404-001,2017,4,16,6,69,92,161,83
3404-001,2017,4,16,7,116,197,313,161
3404-001,2017,4,16,8,276,310,586,313
3404-001,2017,4,16,9,365,337,702,586
3404-001,2017,4,16,10,303,334,637,702
3404-001,2017,4,16,11,330,532,862,637
3404-001,2017,4,16,12,404,530,934,862
3404-001,2017,4,16,13,357,507,864,934
3404-001,2017,4,16,14,392,447,839,864
3404-001,2017,4,16,15,470,489,959,839
3404-001,2017,4,16,16,555,510,1065,959
3404-001,2017,4,16,17,567,478,1045,1065
3404-001,2017,4,16,18,675,428,1103,1045
3404-001,2017,4,16,19,620,392,1012,1103
3404-001,2017,4,16,20,492,359,851,1012
3404-001,2017,4,16,21,325,283,608,851
3404-001,2017,4,16,22,201,271,472,608
3404-001,2017,4,16,23,130,175,305,472
3404-001,2017,4,16,24,110,152,262,305
3404-001,2017,4,17,1,66,71,137,262
3404-001,2017,4,17,2,49,53,102,137
3404-001,2017,4,17,3,25,44,69,102
3404-001,2017,4,17,4,45,31,76,69
3404-001,2017,4,17,5,61,38,99,76
3404-001,2017,4,17,6,131,172,303,99
3404-001,2017,4,17,7,322,801,1123,303
3404-001,2017,4,17,8,714,2457,3171,1123
3404-001,2017,4,17,9,897,1532,2429,3171
3404-001,2017,4,17,10,847,746,1593,2429
3404-001,2017,4,17,11,814,683,1497,1593
3404-001,2017,4,17,12,804,682,1486,1497
3404-001,2017,4,17,13,667,548,1215,1486
3404-001,2017,4,17,14,708,608,1316,1215
3404-001,2017,4,17,15,835,718,1553,1316
3404-001,2017,4,17,16,910,676,1586,1553
3404-001,2017,4,17,17,850,642,1492,1586
3404-001,2017,4,17,18,1061,635,1696,1492
3404-001,2017,4,17,19,1083,548,1631,1696
3404-001,2017,4,17,20,769,474,1243,1631
3404-001,2017,4,17,21,671,319,990,1243
3404-001,2017,4,17,22,392,206,598,990
3404-001,2017,4,17,23,219,154,373,598
3404-001,2017,4,17,24,135,82,217,373
3404-001,2017,4,18,1,117,76,193,217
3404-001,2017,4,18,2,69,53,122,193
3404-001,2017,4,18,3,39,40,79,122
3404-001,2017,4,18,4,64,20,84,79
3404-001,2017,4,18,5,88,28,116,84
3404-001,2017,4,18,6,165,182,347,116
3404-001,2017,4,18,7,340,682,1022,347
3404-001,2017,4,18,8,751,2200,2951,1022
3404-001,2017,4,18,9,982,1501,2483,2951
3404-001,2017,4,18,10,893,784,1677,2483
3404-001,2017,4,18,11,872,802,1674,1677
3404-001,2017,4,18,12,873,727,1600,1674
3404-001,2017,4,18,13,729,676,1405,1600
3404-001,2017,4,18,14,790,635,1425,1405
3404-001,2017,4,18,15,1034,730,1764,1425
3404-001,2017,4,18,16,967,647,1614,1764
3404-001,2017,4,18,17,933,682,1615,1614
3404-001,2017,4,18,18,1153,638,1791,1615
3404-001,2017,4,18,19,1023,584,1607,1791
3404-001,2017,4,18,20,701,453,1154,1607
3404-001,2017,4,18,21,703,339,1042,1154
3404-001,2017,4,18,22,424,237,661,1042
3404-001,2017,4,18,23,217,141,358,661
3404-001,2017,4,18,24,154,91,245,358
3404-001,2017,4,19,1,112,56,168,245
3404-001,2017,4,19,2,76,37,113,168
3404-001,2017,4,19,3,43,46,89,113
3404-001,2017,4,19,4,47,26,73,89
3404-001,2017,4,19,5,83,42,125,73
3404-001,2017,4,19,6,163,192,355,125
3404-001,2017,4,19,7,343,673,1016,355
3404-001,2017,4,19,8,760,2292,3052,1016
3404-001,2017,4,19,9,945,1489,2434,3052
3404-001,2017,4,19,10,826,775,1601,2434
3404-001,2017,4,19,11,865,777,1642,1601
3404-001,2017,4,19,12,827,671,1498,1642
3404-001,2017,4,19,13,686,574,1260,1498
3404-001,2017,4,19,14,753,647,1400,1260
3404-001,2017,4,19,15,950,746,1696,1400
3404-001,2017,4,19,16,883,737,1620,1696
3404-001,2017,4,19,17,891,606,1497,1620
3404-001,2017,4,19,18,1390,714,2104,1497
3404-001,2017,4,19,19,1168,707,1875,2104
3404-001,2017,4,19,20,760,507,1267,1875
3404-001,2017,4,19,21,645,318,963,1267
3404-001,2017,4,19,22,378,253,631,963
3404-001,2017,4,19,23,210,164,374,631
3404-001,2017,4,19,24,150,123,273,374
3404-001,2017,4,20,1,97,65,162,273
3404-001,2017,4,20,2,69,44,113,162
3404-001,2017,4,20,3,72,29,101,113
3404-001,2017,4,20,4,47,35,82,101
3404-001,2017,4,20,5,93,56,149,82
3404-001,2017,4,20,6,146,190,336,149
3404-001,2017,4,20,7,342,646,988,336
3404-001,2017,4,20,8,711,2191,2902,988
3404-001,2017,4,20,9,1023,1482,2505,2902
3404-001,2017,4,20,10,870,799,1669,2505
3404-001,2017,4,20,11,870,741,1611,1669
3404-001,2017,4,20,12,855,683,1538,1611
3404-001,2017,4,20,13,693,555,1248,1538
3404-001,2017,4,20,14,776,707,1483,1248
3404-001,2017,4,20,15,900,701,1601,1483
3404-001,2017,4,20,16,962,710,1672,1601
3404-001,2017,4,20,17,980,664,1644,1672
3404-001,2017,4,20,18,1221,667,1888,1644
3404-001,2017,4,20,19,1123,584,1707,1888
3404-001,2017,4,20,20,778,469,1247,1707
3404-001,2017,4,20,21,712,368,1080,1247
3404-001,2017,4,20,22,412,264,676,1080
3404-001,2017,4,20,23,251,168,419,676
3404-001,2017,4,20,24,149,109,258,419
3404-001,2017,4,21,1,128,65,193,258
3404-001,2017,4,21,2,73,47,120,193
3404-001,2017,4,21,3,42,49,91,120
3404-001,2017,4,21,4,62,31,93,91
3404-001,2017,4,21,5,94,46,140,93
3404-001,2017,4,21,6,150,199,349,140
3404-001,2017,4,21,7,369,694,1063,349
3404-001,2017,4,21,8,763,2189,2952,1063
3404-001,2017,4,21,9,949,1593,2542,2952
3404-001,2017,4,21,10,869,793,1662,2542
3404-001,2017,4,21,11,840,819,1659,1662
3404-001,2017,4,21,12,803,651,1454,1659
3404-001,2017,4,21,13,715,570,1285,1454
3404-001,2017,4,21,14,810,637,1447,1285
3404-001,2017,4,21,15,940,797,1737,1447
3404-001,2017,4,21,16,978,786,1764,1737
3404-001,2017,4,21,17,1051,682,1733,1764
3404-001,2017,4,21,18,1536,819,2355,1733
3404-001,2017,4,21,19,1438,849,2287,2355
3404-001,2017,4,21,20,1057,665,1722,2287
3404-001,2017,4,21,21,811,393,1204,1722
3404-001,2017,4,21,22,401,312,713,1204
3404-001,2017,4,21,23,255,168,423,713
3404-001,2017,4,21,24,134,80,214,423
3404-001,2017,4,22,1,106,80,186,214
3404-001,2017,4,22,2,73,44,117,186
3404-001,2017,4,22,3,47,42,89,117
3404-001,2017,4,22,4,56,35,91,89
3404-001,2017,4,22,5,76,56,132,91
3404-001,2017,4,22,6,153,170,323,132
3404-001,2017,4,22,7,293,473,766,323
3404-001,2017,4,22,8,500,907,1407,766
3404-001,2017,4,22,9,672,906,1578,1407
3404-001,2017,4,22,10,648,692,1340,1578
3404-001,2017,4,22,11,580,759,1339,1340
3404-001,2017,4,22,12,546,730,1276,1339
3404-001,2017,4,22,13,585,655,1240,1276
3404-001,2017,4,22,14,606,617,1223,1240
3404-001,2017,4,22,15,635,635,1270,1223
3404-001,2017,4,22,16,644,606,1250,1270
3404-001,2017,4,22,17,835,610,1445,1250
3404-001,2017,4,22,18,1108,655,1763,1445
3404-001,2017,4,22,19,746,487,1233,1763
3404-001,2017,4,22,20,504,390,894,1233
3404-001,2017,4,22,21,345,280,625,894
3404-001,2017,4,22,22,225,217,442,625
3404-001,2017,4,22,23,147,128,275,442
3404-001,2017,4,22,24,107,109,216,275
3404-001,2017,4,23,1,83,71,154,216
3404-001,2017,4,23,2,49,55,104,154
3404-001,2017,4,23,3,37,37,74,104
3404-001,2017,4,23,4,42,42,84,74
3404-001,2017,4,23,5,45,42,87,84
3404-001,2017,4,23,6,59,89,148,87
3404-001,2017,4,23,7,125,231,356,148
3404-001,2017,4,23,8,218,321,539,356
3404-001,2017,4,23,9,292,323,615,539
3404-001,2017,4,23,10,322,316,638,615
3404-001,2017,4,23,11,299,534,833,638
3404-001,2017,4,23,12,350,498,848,833
3404-001,2017,4,23,13,346,503,849,848
3404-001,2017,4,23,14,410,469,879,849
3404-001,2017,4,23,15,498,505,1003,879
3404-001,2017,4,23,16,602,455,1057,1003
3404-001,2017,4,23,17,659,469,1128,1057
3404-001,2017,4,23,18,743,413,1156,1128
3404-001,2017,4,23,19,652,411,1063,1156
3404-001,2017,4,23,20,438,370,808,1063
3404-001,2017,4,23,21,316,355,671,808
3404-001,2017,4,23,22,212,294,506,671
3404-001,2017,4,23,23,151,182,333,506
3404-001,2017,4,23,24,105,123,228,333
3404-001,2017,4,24,1,63,64,127,228
3404-001,2017,4,24,2,31,47,78,127
3404-001,2017,4,24,3,32,37,69,78
3404-001,2017,4,24,4,44,28,72,69
3404-001,2017,4,24,5,63,56,119,72
3404-001,2017,4,24,6,138,226,364,119
3404-001,2017,4,24,7,379,894,1273,364
3404-001,2017,4,24,8,753,2402,3155,1273
3404-001,2017,4,24,9,882,1559,2441,3155
3404-001,2017,4,24,10,834,795,1629,2441
3404-001,2017,4,24,11,823,707,1530,1629
3404-001,2017,4,24,12,830,642,1472,1530
3404-001,2017,4,24,13,687,541,1228,1472
3404-001,2017,4,24,14,740,669,1409,1228
3404-001,2017,4,24,15,889,774,1663,1409
3404-001,2017,4,24,16,883,704,1587,1663
3404-001,2017,4,24,17,874,636,1510,1587
3404-001,2017,4,24,18,1184,669,1853,1510
3404-001,2017,4,24,19,1213,560,1773,1853
3404-001,2017,4,24,20,820,472,1292,1773
3404-001,2017,4,24,21,742,323,1065,1292
3404-001,2017,4,24,22,414,235,649,1065
3404-001,2017,4,24,23,219,156,375,649
3404-001,2017,4,24,24,150,102,252,375
3404-001,2017,4,25,1,28,38,66,252
3404-001,2017,4,25,2,15,16,31,66
3404-001,2017,4,25,3,6,27,33,31
3404-001,2017,4,25,4,4,9,13,33
3404-001,2017,4,25,5,10,24,34,13
3404-001,2017,4,25,6,154,164,318,34
3404-001,2017,4,25,7,338,658,996,318
3404-001,2017,4,25,8,704,2142,2846,996
3404-001,2017,4,25,9,976,1528,2504,2846
3404-001,2017,4,25,10,862,774,1636,2504
3404-001,2017,4,25,11,861,793,1654,1636
3404-001,2017,4,25,12,844,698,1542,1654
3404-001,2017,4,25,13,706,640,1346,1542
3404-001,2017,4,25,14,766,622,1388,1346
3404-001,2017,4,25,15,957,728,1685,1388
3404-001,2017,4,25,16,968,680,1648,1685
3404-001,2017,4,25,17,898,686,1584,1648
3404-001,2017,4,25,18,1155,646,1801,1584
3404-001,2017,4,25,19,1066,579,1645,1801
3404-001,2017,4,25,20,742,495,1237,1645
3404-001,2017,4,25,21,678,322,1000,1237
3404-001,2017,4,25,22,406,260,666,1000
3404-001,2017,4,25,23,235,148,383,666
3404-001,2017,4,25,24,158,102,260,383
3404-001,2017,4,26,1,116,72,188,260
3404-001,2017,4,26,2,60,67,127,188
3404-001,2017,4,26,3,31,33,64,127
3404-001,2017,4,26,4,50,55,105,64
3404-001,2017,4,26,5,73,95,168,105
3404-001,2017,4,26,6,143,224,367,168
3404-001,2017,4,26,7,319,700,1019,367
3404-001,2017,4,26,8,706,1878,2584,1019
3404-001,2017,4,26,9,981,1394,2375,2584
3404-001,2017,4,26,10,889,875,1764,2375
3404-001,2017,4,26,11,804,833,1637,1764
3404-001,2017,4,26,12,797,790,1587,1637
3404-001,2017,4,26,13,675,623,1298,1587
3404-001,2017,4,26,14,766,795,1561,1298
3404-001,2017,4,26,15,918,791,1709,1561
3404-001,2017,4,26,16,904,778,1682,1709
3404-001,2017,4,26,17,955,747,1702,1682
3404-001,2017,4,26,18,1507,777,2284,1702
3404-001,2017,4,26,19,1288,639,1927,2284
3404-001,2017,4,26,20,789,495,1284,1927
3404-001,2017,4,26,21,634,339,973,1284
3404-001,2017,4,26,22,390,268,658,973
3404-001,2017,4,26,23,222,139,361,658
3404-001,2017,4,26,24,152,131,283,361
3404-001,2017,4,27,1,99,83,182,283
3404-001,2017,4,27,2,68,62,130,182
3404-001,2017,4,27,3,51,36,87,130
3404-001,2017,4,27,4,46,49,95,87
3404-001,2017,4,27,5,83,95,178,95
3404-001,2017,4,27,6,139,252,391,178
3404-001,2017,4,27,7,327,733,1060,391
3404-001,2017,4,27,8,757,1878,2635,1060
3404-001,2017,4,27,9,937,1372,2309,2635
3404-001,2017,4,27,10,870,892,1762,2309
3404-001,2017,4,27,11,825,847,1672,1762
3404-001,2017,4,27,12,827,761,1588,1672
3404-001,2017,4,27,13,803,670,1473,1588
3404-001,2017,4,27,14,809,760,1569,1473
3404-001,2017,4,27,15,861,819,1680,1569
3404-001,2017,4,27,16,951,799,1750,1680
3404-001,2017,4,27,17,930,757,1687,1750
3404-001,2017,4,27,18,1329,871,2200,1687
3404-001,2017,4,27,19,1229,607,1836,2200
3404-001,2017,4,27,20,867,542,1409,1836
3404-001,2017,4,27,21,811,402,1213,1409
3404-001,2017,4,27,22,427,313,740,1213
3404-001,2017,4,27,23,275,167,442,740
3404-001,2017,4,27,24,157,124,281,442
3404-001,2017,4,28,1,98,96,194,281
3404-001,2017,4,28,2,79,57,136,194
3404-001,2017,4,28,3,51,42,93,136
3404-001,2017,4,28,4,57,51,108,93
3404-001,2017,4,28,5,76,90,166,108
3404-001,2017,4,28,6,151,264,415,166
3404-001,2017,4,28,7,323,765,1088,415
3404-001,2017,4,28,8,725,1848,2573,1088
3404-001,2017,4,28,9,995,1359,2354,2573
3404-001,2017,4,28,10,838,836,1674,2354
3404-001,2017,4,28,11,873,851,1724,1674
3404-001,2017,4,28,12,807,767,1574,1724
3404-001,2017,4,28,13,733,657,1390,1574
3404-001,2017,4,28,14,829,767,1596,1390
3404-001,2017,4,28,15,906,798,1704,1596
3404-001,2017,4,28,16,962,818,1780,1704
3404-001,2017,4,28,17,1062,790,1852,1780
3404-001,2017,4,28,18,1566,837,2403,1852
3404-001,2017,4,28,19,1557,732,2289,2403
3404-001,2017,4,28,20,1052,656,1708,2289
3404-001,2017,4,28,21,838,407,1245,1708
3404-001,2017,4,28,22,450,313,763,1245
3404-001,2017,4,28,23,303,209,512,763
3404-001,2017,4,28,24,150,124,274,512
3404-001,2017,4,29,1,114,77,191,274
3404-001,2017,4,29,2,78,56,134,191
3404-001,2017,4,29,3,60,61,121,134
3404-001,2017,4,29,4,77,66,143,121
3404-001,2017,4,29,5,97,79,176,143
3404-001,2017,4,29,6,113,226,339,176
3404-001,2017,4,29,7,289,524,813,339
3404-001,2017,4,29,8,488,894,1382,813
3404-001,2017,4,29,9,716,885,1601,1382
3404-001,2017,4,29,10,631,792,1423,1601
3404-001,2017,4,29,11,636,780,1416,1423
3404-001,2017,4,29,12,569,751,1320,1416
3404-001,2017,4,29,13,593,670,1263,1320
3404-001,2017,4,29,14,574,644,1218,1263
3404-001,2017,4,29,15,687,584,1271,1218
3404-001,2017,4,29,16,709,649,1358,1271
3404-001,2017,4,29,17,814,635,1449,1358
3404-001,2017,4,29,18,1153,690,1843,1449
3404-001,2017,4,29,19,842,538,1380,1843
3404-001,2017,4,29,20,519,406,925,1380
3404-001,2017,4,29,21,391,269,660,925
3404-001,2017,4,29,22,257,209,466,660
3404-001,2017,4,29,23,167,163,330,466
3404-001,2017,4,29,24,123,84,207,330
3404-001,2017,4,30,1,80,77,157,207
3404-001,2017,4,30,2,61,32,93,157
3404-001,2017,4,30,3,46,36,82,93
3404-001,2017,4,30,4,39,33,72,82
3404-001,2017,4,30,5,48,46,94,72
3404-001,2017,4,30,6,62,125,187,94
3404-001,2017,4,30,7,131,254,385,187
3404-001,2017,4,30,8,257,377,634,385
3404-001,2017,4,30,9,324,425,749,634
3404-001,2017,4,30,10,334,459,793,749
3404-001,2017,4,30,11,386,536,922,793
3404-001,2017,4,30,12,362,513,875,922
3404-001,2017,4,30,13,388,472,860,875
3404-001,2017,4,30,14,474,471,945,860
3404-001,2017,4,30,15,520,461,981,945
3404-001,2017,4,30,16,588,455,1043,981
3404-001,2017,4,30,17,673,404,1077,1043
3404-001,2017,4,30,18,812,391,1203,1077
3404-001,2017,4,30,19,618,409,1027,1203
3404-001,2017,4,30,20,512,320,832,1027
3404-001,2017,4,30,21,412,284,696,832
3404-001,2017,4,30,22,277,236,513,696
3404-001,2017,4,30,23,183,159,342,513
3404-001,2017,4,30,24,100,118,218,342
3404-001,2017,5,1,1,58,82,140,218
3404-001,2017,5,1,2,51,39,90,140
3404-001,2017,5,1,3,26,35,61,90
3404-001,2017,5,1,4,39,38,77,61
3404-001,2017,5,1,5,54,56,110,77
3404-001,2017,5,1,6,107,142,249,110
3404-001,2017,5,1,7,209,390,599,249
3404-001,2017,5,1,8,468,999,1467,599
3404-001,2017,5,1,9,651,870,1521,1467
3404-001,2017,5,1,10,577,620,1197,1521
3404-001,2017,5,1,11,591,646,1237,1197
3404-001,2017,5,1,12,541,658,1199,1237
3404-001,2017,5,1,13,508,516,1024,1199
3404-001,2017,5,1,14,563,560,1123,1024
3404-001,2017,5,1,15,677,550,1227,1123
3404-001,2017,5,1,16,681,594,1275,1227
3404-001,2017,5,1,17,766,530,1296,1275
3404-001,2017,5,1,18,989,544,1533,1296
3404-001,2017,5,1,19,798,534,1332,1533
3404-001,2017,5,1,20,479,435,914,1332
3404-001,2017,5,1,21,457,328,785,914
3404-001,2017,5,1,22,258,249,507,785
3404-001,2017,5,1,23,142,178,320,507
3404-001,2017,5,1,24,97,131,228,320
3404-001,2017,5,2,1,61,76,137,228
3404-001,2017,5,2,2,48,57,105,137
3404-001,2017,5,2,3,39,39,78,105
3404-001,2017,5,2,4,40,41,81,78
3404-001,2017,5,2,5,59,77,136,81
3404-001,2017,5,2,6,150,262,412,136
3404-001,2017,5,2,7,345,702,1047,412
3404-001,2017,5,2,8,687,1759,2446,1047
3404-001,2017,5,2,9,855,1233,2088,2446
3404-001,2017,5,2,10,778,805,1583,2088
3404-001,2017,5,2,11,799,792,1591,1583
3404-001,2017,5,2,12,763,773,1536,1591
3404-001,2017,5,2,13,641,697,1338,1536
3404-001,2017,5,2,14,784,792,1576,1338
3404-001,2017,5,2,15,889,827,1716,1576
3404-001,2017,5,2,16,969,842,1811,1716
3404-001,2017,5,2,17,990,760,1750,1811
3404-001,2017,5,2,18,1402,803,2205,1750
3404-001,2017,5,2,19,1306,704,2010,2205
3404-001,2017,5,2,20,887,629,1516,2010
3404-001,2017,5,2,21,761,388,1149,1516
3404-001,2017,5,2,22,387,293,680,1149
3404-001,2017,5,2,23,187,184,371,680
3404-001,2017,5,2,24,133,112,245,371
3404-001,2017,5,3,1,113,69,182,245
3404-001,2017,5,3,2,56,57,113,182
3404-001,2017,5,3,3,47,51,98,113
3404-001,2017,5,3,4,57,39,96,98
3404-001,2017,5,3,5,75,75,150,96
3404-001,2017,5,3,6,120,220,340,150
3404-001,2017,5,3,7,263,551,814,340
3404-001,2017,5,3,8,454,1012,1466,814
3404-001,2017,5,3,9,623,834,1457,1466
3404-001,2017,5,3,10,584,718,1302,1457
3404-001,2017,5,3,11,579,831,1410,1302
3404-001,2017,5,3,12,549,743,1292,1410
3404-001,2017,5,3,13,501,646,1147,1292
3404-001,2017,5,3,14,573,637,1210,1147
3404-001,2017,5,3,15,622,661,1283,1210
3404-001,2017,5,3,16,701,579,1280,1283
3404-001,2017,5,3,17,698,574,1272,1280
3404-001,2017,5,3,18,1122,589,1711,1272
3404-001,2017,5,3,19,780,470,1250,1711
3404-001,2017,5,3,20,565,411,976,1250
3404-001,2017,5,3,21,433,273,706,976
3404-001,2017,5,3,22,313,240,553,706
3404-001,2017,5,3,23,188,151,339,553
3404-001,2017,5,3,24,122,102,224,339
3404-001,2017,5,4,1,63,86,149,224
3404-001,2017,5,4,2,63,55,118,149
3404-001,2017,5,4,3,32,41,73,118
3404-001,2017,5,4,4,41,48,89,73
3404-001,2017,5,4,5,67,65,132,89
3404-001,2017,5,4,6,111,209,320,132
3404-001,2017,5,4,7,297,575,872,320
3404-001,2017,5,4,8,550,1324,1874,872
3404-001,2017,5,4,9,786,1020,1806,1874
3404-001,2017,5,4,10,663,726,1389,1806
3404-001,2017,5,4,11,739,798,1537,1389
3404-001,2017,5,4,12,651,729,1380,1537
3404-001,2017,5,4,13,636,687,1323,1380
3404-001,2017,5,4,14,698,731,1429,1323
3404-001,2017,5,4,15,822,750,1572,1429
3404-001,2017,5,4,16,865,749,1614,1572
3404-001,2017,5,4,17,918,667,1585,1614
3404-001,2017,5,4,18,1278,706,1984,1585
3404-001,2017,5,4,19,1338,649,1987,1984
3404-001,2017,5,4,20,878,490,1368,1987
3404-001,2017,5,4,21,622,338,960,1368
3404-001,2017,5,4,22,352,267,619,960
3404-001,2017,5,4,23,210,182,392,619
3404-001,2017,5,4,24,137,114,251,392
3404-001,2017,5,5,1,81,66,147,251
3404-001,2017,5,5,2,68,55,123,147
3404-001,2017,5,5,3,53,43,96,123
3404-001,2017,5,5,4,41,32,73,96
3404-001,2017,5,5,5,72,82,154,73
3404-001,2017,5,5,6,115,152,267,154
3404-001,2017,5,5,7,229,469,698,267
3404-001,2017,5,5,8,359,616,975,698
3404-001,2017,5,5,9,447,662,1109,975
3404-001,2017,5,5,10,493,650,1143,1109
3404-001,2017,5,5,11,526,735,1261,1143
3404-001,2017,5,5,12,464,911,1375,1261
3404-001,2017,5,5,13,416,927,1343,1375
3404-001,2017,5,5,14,429,740,1169,1343
3404-001,2017,5,5,15,579,600,1179,1169
3404-001,2017,5,5,16,644,519,1163,1179
3404-001,2017,5,5,17,696,498,1194,1163
3404-001,2017,5,5,18,933,474,1407,1194
3404-001,2017,5,5,19,700,417,1117,1407
3404-001,2017,5,5,20,477,324,801,1117
3404-001,2017,5,5,21,392,243,635,801
3404-001,2017,5,5,22,306,206,512,635
3404-001,2017,5,5,23,177,137,314,512
3404-001,2017,5,5,24,89,72,161,314
3404-001,2017,5,6,1,63,66,129,161
3404-001,2017,5,6,2,41,43,84,129
3404-001,2017,5,6,3,31,35,66,84
3404-001,2017,5,6,4,29,32,61,66
3404-001,2017,5,6,5,57,59,116,61
3404-001,2017,5,6,6,91,172,263,116
3404-001,2017,5,6,7,185,402,587,263
3404-001,2017,5,6,8,273,559,832,587
3404-001,2017,5,6,9,437,530,967,832
3404-001,2017,5,6,10,397,528,925,967
3404-001,2017,5,6,11,485,601,1086,925
3404-001,2017,5,6,12,539,633,1172,1086
3404-001,2017,5,6,13,497,501,998,1172
3404-001,2017,5,6,14,511,506,1017,998
3404-001,2017,5,6,15,603,492,1095,1017
3404-001,2017,5,6,16,685,454,1139,1095
3404-001,2017,5,6,17,783,440,1223,1139
3404-001,2017,5,6,18,1197,453,1650,1223
3404-001,2017,5,6,19,774,425,1199,1650
3404-001,2017,5,6,20,513,297,810,1199
3404-001,2017,5,6,21,405,335,740,810
3404-001,2017,5,6,22,280,230,510,740
3404-001,2017,5,6,23,193,138,331,510
3404-001,2017,5,6,24,104,92,196,331
3404-001,2017,5,7,1,80,75,155,196
3404-001,2017,5,7,2,49,34,83,155
3404-001,2017,5,7,3,28,41,69,83
3404-001,2017,5,7,4,27,28,55,69
3404-001,2017,5,7,5,43,41,84,55
3404-001,2017,5,7,6,61,93,154,84
3404-001,2017,5,7,7,114,253,367,154
3404-001,2017,5,7,8,209,305,514,367
3404-001,2017,5,7,9,275,318,593,514
3404-001,2017,5,7,10,323,358,681,593
3404-001,2017,5,7,11,409,372,781,681
3404-001,2017,5,7,12,407,488,895,781
3404-001,2017,5,7,13,466,398,864,895
3404-001,2017,5,7,14,463,399,862,864
3404-001,2017,5,7,15,576,422,998,862
3404-001,2017,5,7,16,640,417,1057,998
3404-001,2017,5,7,17,757,436,1193,1057
3404-001,2017,5,7,18,770,400,1170,1193
3404-001,2017,5,7,19,554,394,948,1170
3404-001,2017,5,7,20,461,379,840,948
3404-001,2017,5,7,21,368,317,685,840
3404-001,2017,5,7,22,278,293,571,685
3404-001,2017,5,7,23,183,189,372,571
3404-001,2017,5,7,24,86,137,223,372
3404-001,2017,5,8,1,56,85,141,223
3404-001,2017,5,8,2,44,60,104,141
3404-001,2017,5,8,3,22,28,50,104
3404-001,2017,5,8,4,39,59,98,50
3404-001,2017,5,8,5,61,97,158,98
3404-001,2017,5,8,6,129,253,382,158
3404-001,2017,5,8,7,356,748,1104,382
3404-001,2017,5,8,8,755,1898,2653,1104
3404-001,2017,5,8,9,884,1294,2178,2653
3404-001,2017,5,8,10,751,782,1533,2178
3404-001,2017,5,8,11,770,777,1547,1533
3404-001,2017,5,8,12,739,692,1431,1547
3404-001,2017,5,8,13,664,676,1340,1431
3404-001,2017,5,8,14,793,754,1547,1340
3404-001,2017,5,8,15,835,842,1677,1547
3404-001,2017,5,8,16,923,768,1691,1677
3404-001,2017,5,8,17,922,778,1700,1691
3404-001,2017,5,8,18,1366,757,2123,1700
3404-001,2017,5,8,19,1361,728,2089,2123
3404-001,2017,5,8,20,899,616,1515,2089
3404-001,2017,5,8,21,743,401,1144,1515
3404-001,2017,5,8,22,442,278,720,1144
3404-001,2017,5,8,23,278,186,464,720
3404-001,2017,5,8,24,167,105,272,464
3404-001,2017,5,9,1,103,88,191,272
3404-001,2017,5,9,2,63,52,115,191
3404-001,2017,5,9,3,38,37,75,115
3404-001,2017,5,9,4,45,54,99,75
3404-001,2017,5,9,5,72,61,133,99
3404-001,2017,5,9,6,122,170,292,133
3404-001,2017,5,9,7,264,422,686,292
3404-001,2017,5,9,8,459,882,1341,686
3404-001,2017,5,9,9,620,893,1513,1341
3404-001,2017,5,9,10,607,777,1384,1513
3404-001,2017,5,9,11,629,698,1327,1384
3404-001,2017,5,9,12,621,640,1261,1327
3404-001,2017,5,9,13,552,625,1177,1261
3404-001,2017,5,9,14,686,602,1288,1177
3404-001,2017,5,9,15,702,601,1303,1288
3404-001,2017,5,9,16,717,593,1310,1303
3404-001,2017,5,9,17,814,568,1382,1310
3404-001,2017,5,9,18,931,523,1454,1382
3404-001,2017,5,9,19,708,426,1134,1454
3404-001,2017,5,9,20,385,391,776,1134
3404-001,2017,5,9,21,405,259,664,776
3404-001,2017,5,9,22,214,220,434,664
3404-001,2017,5,9,23,158,135,293,434
3404-001,2017,5,9,24,97,89,186,293
3404-001,2017,5,10,1,64,58,122,186
3404-001,2017,5,10,2,49,45,94,122
3404-001,2017,5,10,3,31,40,71,94
3404-001,2017,5,10,4,43,53,96,71
3404-001,2017,5,10,5,59,95,154,96
3404-001,2017,5,10,6,133,206,339,154
3404-001,2017,5,10,7,294,658,952,339
3404-001,2017,5,10,8,713,1852,2565,952
3404-001,2017,5,10,9,917,1423,2340,2565
3404-001,2017,5,10,10,810,831,1641,2340
3404-001,2017,5,10,11,807,860,1667,1641
3404-001,2017,5,10,12,769,775,1544,1667
3404-001,2017,5,10,13,677,629,1306,1544
3404-001,2017,5,10,14,769,719,1488,1306
3404-001,2017,5,10,15,847,837,1684,1488
3404-001,2017,5,10,16,871,811,1682,1684
3404-001,2017,5,10,17,855,714,1569,1682
3404-001,2017,5,10,18,1317,711,2028,1569
3404-001,2017,5,10,19,1138,618,1756,2028
3404-001,2017,5,10,20,794,514,1308,1756
3404-001,2017,5,10,21,742,387,1129,1308
3404-001,2017,5,10,22,440,262,702,1129
3404-001,2017,5,10,23,250,155,405,702
3404-001,2017,5,10,24,150,107,257,405
3404-001,2017,5,11,1,94,66,160,257
3404-001,2017,5,11,2,63,53,116,160
3404-001,2017,5,11,3,54,44,98,116
3404-001,2017,5,11,4,44,47,91,98
3404-001,2017,5,11,5,77,82,159,91
3404-001,2017,5,11,6,120,260,380,159
3404-001,2017,5,11,7,318,644,962,380
3404-001,2017,5,11,8,716,1832,2548,962
3404-001,2017,5,11,9,1008,1484,2492,2548
3404-001,2017,5,11,10,875,826,1701,2492
3404-001,2017,5,11,11,819,852,1671,1701
3404-001,2017,5,11,12,835,768,1603,1671
3404-001,2017,5,11,13,577,552,1129,1603
3404-001,2017,5,11,14,762,803,1565,1129
3404-001,2017,5,11,15,928,801,1729,1565
3404-001,2017,5,11,16,910,759,1669,1729
3404-001,2017,5,11,17,957,748,1705,1669
3404-001,2017,5,11,18,1336,756,2092,1705
3404-001,2017,5,11,19,1174,682,1856,2092
3404-001,2017,5,11,20,851,497,1348,1856
3404-001,2017,5,11,21,792,409,1201,1348
3404-001,2017,5,11,22,445,298,743,1201
3404-001,2017,5,11,23,297,199,496,743
3404-001,2017,5,11,24,145,97,242,496
3404-001,2017,5,12,1,127,69,196,242
3404-001,2017,5,12,2,72,62,134,196
3404-001,2017,5,12,3,37,46,83,134
3404-001,2017,5,12,4,50,70,120,83
3404-001,2017,5,12,5,72,86,158,120
3404-001,2017,5,12,6,135,245,380,158
3404-001,2017,5,12,7,321,765,1086,380
3404-001,2017,5,12,8,779,1912,2691,1086
3404-001,2017,5,12,9,1018,1411,2429,2691
3404-001,2017,5,12,10,850,902,1752,2429
3404-001,2017,5,12,11,880,847,1727,1752
3404-001,2017,5,12,12,798,792,1590,1727
3404-001,2017,5,12,13,710,697,1407,1590
3404-001,2017,5,12,14,750,787,1537,1407
3404-001,2017,5,12,15,931,858,1789,1537
3404-001,2017,5,12,16,897,840,1737,1789
3404-001,2017,5,12,17,974,787,1761,1737
3404-001,2017,5,12,18,1546,786,2332,1761
3404-001,2017,5,12,19,1515,781,2296,2332
3404-001,2017,5,12,20,1003,616,1619,2296
3404-001,2017,5,12,21,753,427,1180,1619
3404-001,2017,5,12,22,423,291,714,1180
3404-001,2017,5,12,23,265,166,431,714
3404-001,2017,5,12,24,173,127,300,431
3404-001,2017,5,13,1,125,101,226,300
3404-001,2017,5,13,2,96,54,150,226
3404-001,2017,5,13,3,36,62,98,150
3404-001,2017,5,13,4,55,56,111,98
3404-001,2017,5,13,5,89,93,182,111
3404-001,2017,5,13,6,132,222,354,182
3404-001,2017,5,13,7,249,530,779,354
3404-001,2017,5,13,8,448,938,1386,779
3404-001,2017,5,13,9,705,908,1613,1386
3404-001,2017,5,13,10,677,727,1404,1613
3404-001,2017,5,13,11,630,780,1410,1404
3404-001,2017,5,13,12,582,688,1270,1410
3404-001,2017,5,13,13,559,578,1137,1270
3404-001,2017,5,13,14,629,588,1217,1137
3404-001,2017,5,13,15,691,615,1306,1217
3404-001,2017,5,13,16,818,559,1377,1306
3404-001,2017,5,13,17,917,563,1480,1377
3404-001,2017,5,13,18,1052,554,1606,1480
3404-001,2017,5,13,19,650,498,1148,1606
3404-001,2017,5,13,20,389,346,735,1148
3404-001,2017,5,13,21,313,270,583,735
3404-001,2017,5,13,22,217,211,428,583
3404-001,2017,5,13,23,147,152,299,428
3404-001,2017,5,13,24,115,100,215,299
3404-001,2017,5,14,1,78,56,134,215
3404-001,2017,5,14,2,59,46,105,134
3404-001,2017,5,14,3,44,29,73,105
3404-001,2017,5,14,4,44,33,77,73
3404-001,2017,5,14,5,46,53,99,77
3404-001,2017,5,14,6,73,133,206,99
3404-001,2017,5,14,7,144,243,387,206
3404-001,2017,5,14,8,235,333,568,387
3404-001,2017,5,14,9,292,385,677,568
3404-001,2017,5,14,10,325,387,712,677
3404-001,2017,5,14,11,385,384,769,712
3404-001,2017,5,14,12,341,470,811,769
3404-001,2017,5,14,13,423,430,853,811
3404-001,2017,5,14,14,419,430,849,853
3404-001,2017,5,14,15,518,455,973,849
3404-001,2017,5,14,16,593,442,1035,973
3404-001,2017,5,14,17,689,429,1118,1035
3404-001,2017,5,14,18,765,435,1200,1118
3404-001,2017,5,14,19,524,378,902,1200
3404-001,2017,5,14,20,361,348,709,902
3404-001,2017,5,14,21,342,297,639,709
3404-001,2017,5,14,22,256,263,519,639
3404-001,2017,5,14,23,167,211,378,519
3404-001,2017,5,14,24,113,120,233,378
3404-001,2017,5,15,1,65,82,147,233
3404-001,2017,5,15,2,44,37,81,147
3404-001,2017,5,15,3,24,36,60,81
3404-001,2017,5,15,4,22,37,59,60
3404-001,2017,5,15,5,68,84,152,59
3404-001,2017,5,15,6,149,265,414,152
3404-001,2017,5,15,7,373,785,1158,414
3404-001,2017,5,15,8,744,2070,2814,1158
3404-001,2017,5,15,9,975,1425,2400,2814
3404-001,2017,5,15,10,727,800,1527,2400
3404-001,2017,5,15,11,775,774,1549,1527
3404-001,2017,5,15,12,793,749,1542,1549
3404-001,2017,5,15,13,648,672,1320,1542
3404-001,2017,5,15,14,793,724,1517,1320
3404-001,2017,5,15,15,853,825,1678,1517
3404-001,2017,5,15,16,888,725,1613,1678
3404-001,2017,5,15,17,912,716,1628,1613
3404-001,2017,5,15,18,1255,741,1996,1628
3404-001,2017,5,15,19,1154,629,1783,1996
3404-001,2017,5,15,20,826,516,1342,1783
3404-001,2017,5,15,21,810,380,1190,1342
3404-001,2017,5,15,22,463,298,761,1190
3404-001,2017,5,15,23,280,171,451,761
3404-001,2017,5,15,24,161,111,272,451
3404-001,2017,5,16,1,98,70,168,272
3404-001,2017,5,16,2,61,57,118,168
3404-001,2017,5,16,3,37,42,79,118
3404-001,2017,5,16,4,46,49,95,79
3404-001,2017,5,16,5,75,81,156,95
3404-001,2017,5,16,6,151,245,396,156
3404-001,2017,5,16,7,331,733,1064,396
3404-001,2017,5,16,8,721,1874,2595,1064
3404-001,2017,5,16,9,1018,1418,2436,2595
3404-001,2017,5,16,10,827,855,1682,2436
3404-001,2017,5,16,11,809,832,1641,1682
3404-001,2017,5,16,12,842,760,1602,1641
3404-001,2017,5,16,13,687,678,1365,1602
3404-001,2017,5,16,14,791,764,1555,1365
3404-001,2017,5,16,15,866,850,1716,1555
3404-001,2017,5,16,16,917,793,1710,1716
3404-001,2017,5,16,17,934,757,1691,1710
3404-001,2017,5,16,18,1288,777,2065,1691
3404-001,2017,5,16,19,1236,632,1868,2065
3404-001,2017,5,16,20,775,539,1314,1868
3404-001,2017,5,16,21,816,393,1209,1314
3404-001,2017,5,16,22,428,277,705,1209
3404-001,2017,5,16,23,260,174,434,705
3404-001,2017,5,16,24,147,102,249,434
3404-001,2017,5,17,1,99,77,176,249
3404-001,2017,5,17,2,43,60,103,176
3404-001,2017,5,17,3,42,45,87,103
3404-001,2017,5,17,4,60,45,105,87
3404-001,2017,5,17,5,76,80,156,105
3404-001,2017,5,17,6,137,268,405,156
3404-001,2017,5,17,7,309,750,1059,405
3404-001,2017,5,17,8,753,1923,2676,1059
3404-001,2017,5,17,9,974,1429,2403,2676
3404-001,2017,5,17,10,835,880,1715,2403
3404-001,2017,5,17,11,804,839,1643,1715
3404-001,2017,5,17,12,775,740,1515,1643
3404-001,2017,5,17,13,646,659,1305,1515
3404-001,2017,5,17,14,802,813,1615,1305
3404-001,2017,5,17,15,873,830,1703,1615
3404-001,2017,5,17,16,894,752,1646,1703
3404-001,2017,5,17,17,940,771,1711,1646
3404-001,2017,5,17,18,1515,745,2260,1711
3404-001,2017,5,17,19,1351,664,2015,2260
3404-001,2017,5,17,20,824,507,1331,2015
3404-001,2017,5,17,21,690,359,1049,1331
3404-001,2017,5,17,22,404,255,659,1049
3404-001,2017,5,17,23,265,183,448,659
3404-001,2017,5,17,24,151,127,278,448
3404-001,2017,5,18,1,93,74,167,278
3404-001,2017,5,18,2,68,64,132,167
3404-001,2017,5,18,3,48,40,88,132
3404-001,2017,5,18,4,48,48,96,88
3404-001,2017,5,18,5,71,88,159,96
3404-001,2017,5,18,6,148,253,401,159
3404-001,2017,5,18,7,358,727,1085,401
3404-001,2017,5,18,8,761,1897,2658,1085
3404-001,2017,5,18,9,1035,1418,2453,2658
3404-001,2017,5,18,10,882,875,1757,2453
3404-001,2017,5,18,11,815,841,1656,1757
3404-001,2017,5,18,12,841,758,1599,1656
3404-001,2017,5,18,13,707,752,1459,1599
3404-001,2017,5,18,14,785,812,1597,1459
3404-001,2017,5,18,15,917,814,1731,1597
3404-001,2017,5,18,16,900,843,1743,1731
3404-001,2017,5,18,17,903,774,1677,1743
3404-001,2017,5,18,18,1330,779,2109,1677
3404-001,2017,5,18,19,1224,660,1884,2109
3404-001,2017,5,18,20,804,509,1313,1884
3404-001,2017,5,18,21,837,379,1216,1313
3404-001,2017,5,18,22,443,277,720,1216
3404-001,2017,5,18,23,265,202,467,720
3404-001,2017,5,18,24,145,113,258,467
3404-001,2017,5,19,1,105,74,179,258
3404-001,2017,5,19,2,69,53,122,179
3404-001,2017,5,19,3,43,44,87,122
3404-001,2017,5,19,4,48,58,106,87
3404-001,2017,5,19,5,68,77,145,106
3404-001,2017,5,19,6,145,249,394,145
3404-001,2017,5,19,7,355,720,1075,394
3404-001,2017,5,19,8,746,1867,2613,1075
3404-001,2017,5,19,9,967,1374,2341,2613
3404-001,2017,5,19,10,847,878,1725,2341
3404-001,2017,5,19,11,865,893,1758,1725
3404-001,2017,5,19,12,771,802,1573,1758
3404-001,2017,5,19,13,782,639,1421,1573
3404-001,2017,5,19,14,795,735,1530,1421
3404-001,2017,5,19,15,908,849,1757,1530
3404-001,2017,5,19,16,979,844,1823,1757
3404-001,2017,5,19,17,1013,742,1755,1823
3404-001,2017,5,19,18,1519,803,2322,1755
3404-001,2017,5,19,19,1515,770,2285,2322
3404-001,2017,5,19,20,920,604,1524,2285
3404-001,2017,5,19,21,793,482,1275,1524
3404-001,2017,5,19,22,444,304,748,1275
3404-001,2017,5,19,23,300,196,496,748
3404-001,2017,5,19,24,166,155,321,496
3404-001,2017,5,20,1,146,102,248,321
3404-001,2017,5,20,2,64,64,128,248
3404-001,2017,5,20,3,55,48,103,128
3404-001,2017,5,20,4,62,65,127,103
3404-001,2017,5,20,5,98,87,185,127
3404-001,2017,5,20,6,128,260,388,185
3404-001,2017,5,20,7,284,556,840,388
3404-001,2017,5,20,8,491,867,1358,840
3404-001,2017,5,20,9,711,839,1550,1358
3404-001,2017,5,20,10,684,713,1397,1550
3404-001,2017,5,20,11,642,747,1389,1397
3404-001,2017,5,20,12,591,692,1283,1389
3404-001,2017,5,20,13,575,621,1196,1283
3404-001,2017,5,20,14,583,597,1180,1196
3404-001,2017,5,20,15,615,581,1196,1180
3404-001,2017,5,20,16,744,599,1343,1196
3404-001,2017,5,20,17,818,572,1390,1343
3404-001,2017,5,20,18,1105,618,1723,1390
3404-001,2017,5,20,19,686,533,1219,1723
3404-001,2017,5,20,20,470,416,886,1219
3404-001,2017,5,20,21,382,282,664,886
3404-001,2017,5,20,22,290,239,529,664
3404-001,2017,5,20,23,173,150,323,529
3404-001,2017,5,20,24,120,100,220,323
3404-001,2017,5,21,1,87,75,162,220
3404-001,2017,5,21,2,75,42,117,162
3404-001,2017,5,21,3,44,45,89,117
3404-001,2017,5,21,4,24,43,67,89
3404-001,2017,5,21,5,52,53,105,67
3404-001,2017,5,21,6,98,116,214,105
3404-001,2017,5,21,7,161,243,404,214
3404-001,2017,5,21,8,268,380,648,404
3404-001,2017,5,21,9,341,399,740,648
3404-001,2017,5,21,10,348,393,741,740
3404-001,2017,5,21,11,390,460,850,741
3404-001,2017,5,21,12,415,456,871,850
3404-001,2017,5,21,13,416,422,838,871
3404-001,2017,5,21,14,470,468,938,838
3404-001,2017,5,21,15,543,443,986,938
3404-001,2017,5,21,16,607,442,1049,986
3404-001,2017,5,21,17,683,417,1100,1049
3404-001,2017,5,21,18,735,481,1216,1100
3404-001,2017,5,21,19,537,423,960,1216
3404-001,2017,5,21,20,418,381,799,960
3404-001,2017,5,21,21,332,333,665,799
3404-001,2017,5,21,22,291,284,575,665
3404-001,2017,5,21,23,185,220,405,575
3404-001,2017,5,21,24,106,131,237,405
3404-001,2017,5,22,1,51,83,134,237
3404-001,2017,5,22,2,47,45,92,134
3404-001,2017,5,22,3,30,37,67,92
3404-001,2017,5,22,4,37,48,85,67
3404-001,2017,5,22,5,65,88,153,85
3404-001,2017,5,22,6,159,268,427,153
3404-001,2017,5,22,7,386,779,1165,427
3404-001,2017,5,22,8,775,2068,2843,1165
3404-001,2017,5,22,9,937,1493,2430,2843
3404-001,2017,5,22,10,796,772,1568,2430
3404-001,2017,5,22,11,742,796,1538,1568
3404-001,2017,5,22,12,771,748,1519,1538
3404-001,2017,5,22,13,659,639,1298,1519
3404-001,2017,5,22,14,753,714,1467,1298
3404-001,2017,5,22,15,850,850,1700,1467
3404-001,2017,5,22,16,874,784,1658,1700
3404-001,2017,5,22,17,908,747,1655,1658
3404-001,2017,5,22,18,1223,727,1950,1655
3404-001,2017,5,22,19,1247,633,1880,1950
3404-001,2017,5,22,20,855,542,1397,1880
3404-001,2017,5,22,21,840,391,1231,1397
3404-001,2017,5,22,22,463,315,778,1231
3404-001,2017,5,22,23,249,168,417,778
3404-001,2017,5,22,24,163,130,293,417
3404-001,2017,5,23,1,126,82,208,293
3404-001,2017,5,23,2,84,62,146,208
3404-001,2017,5,23,3,40,47,87,146
3404-001,2017,5,23,4,44,54,98,87
3404-001,2017,5,23,5,73,80,153,98
3404-001,2017,5,23,6,150,249,399,153
3404-001,2017,5,23,7,360,724,1084,399
3404-001,2017,5,23,8,763,1828,2591,1084
3404-001,2017,5,23,9,1004,1448,2452,2591
3404-001,2017,5,23,10,938,874,1812,2452
3404-001,2017,5,23,11,793,846,1639,1812
3404-001,2017,5,23,12,787,773,1560,1639
3404-001,2017,5,23,13,660,673,1333,1560
3404-001,2017,5,23,14,813,817,1630,1333
3404-001,2017,5,23,15,797,774,1571,1630
3404-001,2017,5,23,16,858,786,1644,1571
3404-001,2017,5,23,17,922,727,1649,1644
3404-001,2017,5,23,18,1317,682,1999,1649
3404-001,2017,5,23,19,1264,617,1881,1999
3404-001,2017,5,23,20,797,500,1297,1881
3404-001,2017,5,23,21,731,395,1126,1297
3404-001,2017,5,23,22,385,261,646,1126
3404-001,2017,5,23,23,263,179,442,646
3404-001,2017,5,23,24,163,111,274,442
3404-001,2017,5,24,1,100,64,164,274
3404-001,2017,5,24,2,72,65,137,164
3404-001,2017,5,24,3,32,39,71,137
3404-001,2017,5,24,4,31,51,82,71
3404-001,2017,5,24,5,79,82,161,82
3404-001,2017,5,24,6,138,237,375,161
3404-001,2017,5,24,7,335,668,1003,375
3404-001,2017,5,24,8,714,1884,2598,1003
3404-001,2017,5,24,9,989,1465,2454,2598
3404-001,2017,5,24,10,787,836,1623,2454
3404-001,2017,5,24,11,803,857,1660,1623
3404-001,2017,5,24,12,780,751,1531,1660
3404-001,2017,5,24,13,685,626,1311,1531
3404-001,2017,5,24,14,721,735,1456,1311
3404-001,2017,5,24,15,834,767,1601,1456
3404-001,2017,5,24,16,991,790,1781,1601
3404-001,2017,5,24,17,926,754,1680,1781
3404-001,2017,5,24,18,1452,775,2227,1680
3404-001,2017,5,24,19,1259,632,1891,2227
3404-001,2017,5,24,20,818,511,1329,1891
3404-001,2017,5,24,21,676,351,1027,1329
3404-001,2017,5,24,22,399,297,696,1027
3404-001,2017,5,24,23,273,173,446,696
3404-001,2017,5,24,24,152,132,284,446
3404-001,2017,5,25,1,94,85,179,284
3404-001,2017,5,25,2,78,50,128,179
3404-001,2017,5,25,3,37,42,79,128
3404-001,2017,5,25,4,43,44,87,79
3404-001,2017,5,25,5,75,88,163,87
3404-001,2017,5,25,6,155,282,437,163
3404-001,2017,5,25,7,371,722,1093,437
3404-001,2017,5,25,8,728,1813,2541,1093
3404-001,2017,5,25,9,1036,1440,2476,2541
3404-001,2017,5,25,10,886,870,1756,2476
3404-001,2017,5,25,11,823,829,1652,1756
3404-001,2017,5,25,12,786,798,1584,1652
3404-001,2017,5,25,13,750,654,1404,1584
3404-001,2017,5,25,14,768,813,1581,1404
3404-001,2017,5,25,15,890,825,1715,1581
3404-001,2017,5,25,16,914,825,1739,1715
3404-001,2017,5,25,17,937,755,1692,1739
3404-001,2017,5,25,18,1373,731,2104,1692
3404-001,2017,5,25,19,1223,644,1867,2104
3404-001,2017,5,25,20,871,534,1405,1867
3404-001,2017,5,25,21,579,409,988,1405
3404-001,2017,5,25,22,523,295,818,988
3404-001,2017,5,25,23,276,201,477,818
3404-001,2017,5,25,24,179,117,296,477
3404-001,2017,5,26,1,111,99,210,296
3404-001,2017,5,26,2,70,43,113,210
3404-001,2017,5,26,3,46,42,88,113
3404-001,2017,5,26,4,47,50,97,88
3404-001,2017,5,26,5,66,75,141,97
3404-001,2017,5,26,6,161,249,410,141
3404-001,2017,5,26,7,384,733,1117,410
3404-001,2017,5,26,8,704,1847,2551,1117
3404-001,2017,5,26,9,1036,1428,2464,2551
3404-001,2017,5,26,10,841,831,1672,2464
3404-001,2017,5,26,11,878,900,1778,1672
3404-001,2017,5,26,12,845,787,1632,1778
3404-001,2017,5,26,13,723,710,1433,1632
3404-001,2017,5,26,14,821,773,1594,1433
3404-001,2017,5,26,15,918,858,1776,1594
3404-001,2017,5,26,16,973,803,1776,1776
3404-001,2017,5,26,17,983,844,1827,1776
3404-001,2017,5,26,18,1569,782,2351,1827
3404-001,2017,5,26,19,1554,781,2335,2351
3404-001,2017,5,26,20,957,649,1606,2335
3404-001,2017,5,26,21,763,400,1163,1606
3404-001,2017,5,26,22,445,309,754,1163
3404-001,2017,5,26,23,268,199,467,754
3404-001,2017,5,26,24,153,130,283,467
3404-001,2017,5,27,1,123,81,204,283
3404-001,2017,5,27,2,81,55,136,204
3404-001,2017,5,27,3,59,43,102,136
3404-001,2017,5,27,4,53,42,95,102
3404-001,2017,5,27,5,97,76,173,95
3404-001,2017,5,27,6,163,249,412,173
3404-001,2017,5,27,7,302,522,824,412
3404-001,2017,5,27,8,466,843,1309,824
3404-001,2017,5,27,9,717,874,1591,1309
3404-001,2017,5,27,10,661,810,1471,1591
3404-001,2017,5,27,11,625,821,1446,1471
3404-001,2017,5,27,12,637,702,1339,1446
3404-001,2017,5,27,13,659,595,1254,1339
3404-001,2017,5,27,14,608,648,1256,1254
3404-001,2017,5,27,15,662,615,1277,1256
3404-001,2017,5,27,16,757,607,1364,1277
3404-001,2017,5,27,17,764,598,1362,1364
3404-001,2017,5,27,18,1147,670,1817,1362
3404-001,2017,5,27,19,854,590,1444,1817
3404-001,2017,5,27,20,489,441,930,1444
3404-001,2017,5,27,21,379,282,661,930
3404-001,2017,5,27,22,251,219,470,661
3404-001,2017,5,27,23,187,151,338,470
3404-001,2017,5,27,24,124,115,239,338
3404-001,2017,5,28,1,91,81,172,239
3404-001,2017,5,28,2,81,47,128,172
3404-001,2017,5,28,3,63,25,88,128
3404-001,2017,5,28,4,44,34,78,88
3404-001,2017,5,28,5,53,56,109,78
3404-001,2017,5,28,6,95,122,217,109
3404-001,2017,5,28,7,132,250,382,217
3404-001,2017,5,28,8,239,348,587,382
3404-001,2017,5,28,9,362,434,796,587
3404-001,2017,5,28,10,353,429,782,796
3404-001,2017,5,28,11,391,501,892,782
3404-001,2017,5,28,12,410,470,880,892
3404-001,2017,5,28,13,445,446,891,880
3404-001,2017,5,28,14,482,451,933,891
3404-001,2017,5,28,15,607,468,1075,933
3404-001,2017,5,28,16,705,464,1169,1075
3404-001,2017,5,28,17,694,444,1138,1169
3404-001,2017,5,28,18,738,404,1142,1138
3404-001,2017,5,28,19,652,415,1067,1142
3404-001,2017,5,28,20,446,365,811,1067
3404-001,2017,5,28,21,340,339,679,811
3404-001,2017,5,28,22,243,264,507,679
3404-001,2017,5,28,23,160,219,379,507
3404-001,2017,5,28,24,100,139,239,379
3404-001,2017,5,29,1,59,71,130,239
3404-001,2017,5,29,2,35,45,80,130
3404-001,2017,5,29,3,29,33,62,80
3404-001,2017,5,29,4,28,38,66,62
3404-001,2017,5,29,5,65,85,150,66
3404-001,2017,5,29,6,175,291,466,150
3404-001,2017,5,29,7,377,820,1197,466
3404-001,2017,5,29,8,764,2001,2765,1197
3404-001,2017,5,29,9,928,1457,2385,2765
3404-001,2017,5,29,10,849,788,1637,2385
3404-001,2017,5,29,11,854,815,1669,1637
3404-001,2017,5,29,12,789,820,1609,1669
3404-001,2017,5,29,13,701,688,1389,1609
3404-001,2017,5,29,14,718,758,1476,1389
3404-001,2017,5,29,15,856,839,1695,1476
3404-001,2017,5,29,16,937,774,1711,1695
3404-001,2017,5,29,17,869,736,1605,1711
3404-001,2017,5,29,18,1299,745,2044,1605
3404-001,2017,5,29,19,1236,647,1883,2044
3404-001,2017,5,29,20,847,498,1345,1883
3404-001,2017,5,29,21,785,384,1169,1345
3404-001,2017,5,29,22,471,292,763,1169
3404-001,2017,5,29,23,228,168,396,763
3404-001,2017,5,29,24,168,119,287,396
3404-001,2017,5,30,1,85,65,150,287
3404-001,2017,5,30,2,68,44,112,150
3404-001,2017,5,30,3,31,46,77,112
3404-001,2017,5,30,4,53,46,99,77
3404-001,2017,5,30,5,71,96,167,99
3404-001,2017,5,30,6,153,266,419,167
3404-001,2017,5,30,7,390,733,1123,419
3404-001,2017,5,30,8,764,1849,2613,1123
3404-001,2017,5,30,9,955,1408,2363,2613
3404-001,2017,5,30,10,787,861,1648,2363
3404-001,2017,5,30,11,789,844,1633,1648
3404-001,2017,5,30,12,732,692,1424,1633
3404-001,2017,5,30,13,698,659,1357,1424
3404-001,2017,5,30,14,754,746,1500,1357
3404-001,2017,5,30,15,863,889,1752,1500
3404-001,2017,5,30,16,947,804,1751,1752
3404-001,2017,5,30,17,945,718,1663,1751
3404-001,2017,5,30,18,1215,745,1960,1663
3404-001,2017,5,30,19,1271,646,1917,1960
3404-001,2017,5,30,20,853,534,1387,1917
3404-001,2017,5,30,21,747,369,1116,1387
3404-001,2017,5,30,22,429,285,714,1116
3404-001,2017,5,30,23,274,197,471,714
3404-001,2017,5,30,24,148,114,262,471
3404-001,2017,5,31,1,113,85,198,262
3404-001,2017,5,31,2,58,52,110,198
3404-001,2017,5,31,3,38,46,84,110
3404-001,2017,5,31,4,49,55,104,84
3404-001,2017,5,31,5,66,75,141,104
3404-001,2017,5,31,6,166,264,430,141
3404-001,2017,5,31,7,317,708,1025,430
3404-001,2017,5,31,8,718,1832,2550,1025
3404-001,2017,5,31,9,777,1389,2166,2550
3404-001,2017,5,31,10,714,768,1482,2166
3404-001,2017,5,31,11,710,826,1536,1482
3404-001,2017,5,31,12,690,752,1442,1536
3404-001,2017,5,31,13,604,652,1256,1442
3404-001,2017,5,31,14,730,695,1425,1256
3404-001,2017,5,31,15,848,811,1659,1425
3404-001,2017,5,31,16,859,759,1618,1659
3404-001,2017,5,31,17,890,742,1632,1618
3404-001,2017,5,31,18,1408,678,2086,1632
3404-001,2017,5,31,19,1206,668,1874,2086
3404-001,2017,5,31,20,768,476,1244,1874
3404-001,2017,5,31,21,665,381,1046,1244
3404-001,2017,5,31,22,421,279,700,1046
3404-001,2017,5,31,23,250,187,437,700
3404-001,2017,5,31,24,149,138,287,437
3404-001,2017,6,1,1,100,78,178,287
3404-001,2017,6,1,2,61,46,107,178
3404-001,2017,6,1,3,51,52,103,107
3404-001,2017,6,1,4,45,49,94,103
3404-001,2017,6,1,5,73,81,154,94
3404-001,2017,6,1,6,169,269,438,154
3404-001,2017,6,1,7,358,664,1022,438
3404-001,2017,6,1,8,765,1653,2418,1022
3404-001,2017,6,1,9,924,1444,2368,2418
3404-001,2017,6,1,10,898,794,1692,2368
3404-001,2017,6,1,11,773,811,1584,1692
3404-001,2017,6,1,12,729,734,1463,1584
3404-001,2017,6,1,13,632,635,1267,1463
3404-001,2017,6,1,14,718,706,1424,1267
3404-001,2017,6,1,15,810,845,1655,1424
3404-001,2017,6,1,16,875,782,1657,1655
3404-001,2017,6,1,17,917,704,1621,1657
3404-001,2017,6,1,18,1334,725,2059,1621
3404-001,2017,6,1,19,1242,619,1861,2059
3404-001,2017,6,1,20,867,532,1399,1861
3404-001,2017,6,1,21,796,367,1163,1399
3404-001,2017,6,1,22,422,273,695,1163
3404-001,2017,6,1,23,228,182,410,695
3404-001,2017,6,1,24,171,136,307,410
3404-001,2017,6,2,1,94,91,185,307
3404-001,2017,6,2,2,66,56,122,185
3404-001,2017,6,2,3,59,54,113,122
3404-001,2017,6,2,4,50,35,85,113
3404-001,2017,6,2,5,76,87,163,85
3404-001,2017,6,2,6,154,268,422,163
3404-001,2017,6,2,7,370,715,1085,422
3404-001,2017,6,2,8,752,1765,2517,1085
3404-001,2017,6,2,9,981,1385,2366,2517
3404-001,2017,6,2,10,817,813,1630,2366
3404-001,2017,6,2,11,826,855,1681,1630
3404-001,2017,6,2,12,822,790,1612,1681
3404-001,2017,6,2,13,732,653,1385,1612
3404-001,2017,6,2,14,739,775,1514,1385
3404-001,2017,6,2,15,807,831,1638,1514
3404-001,2017,6,2,16,974,833,1807,1638
3404-001,2017,6,2,17,1005,795,1800,1807
3404-001,2017,6,2,18,1538,831,2369,1800
3404-001,2017,6,2,19,1544,794,2338,2369
3404-001,2017,6,2,20,1004,623,1627,2338
3404-001,2017,6,2,21,751,417,1168,1627
3404-001,2017,6,2,22,478,350,828,1168
3404-001,2017,6,2,23,255,202,457,828
3404-001,2017,6,2,24,163,116,279,457
3404-001,2017,6,3,1,136,93,229,279
3404-001,2017,6,3,2,84,67,151,229
3404-001,2017,6,3,3,51,55,106,151
3404-001,2017,6,3,4,63,56,119,106
3404-001,2017,6,3,5,71,70,141,119
3404-001,2017,6,3,6,145,245,390,141
3404-001,2017,6,3,7,291,488,779,390
3404-001,2017,6,3,8,501,789,1290,779
3404-001,2017,6,3,9,690,863,1553,1290
3404-001,2017,6,3,10,657,753,1410,1553
3404-001,2017,6,3,11,655,820,1475,1410
3404-001,2017,6,3,12,638,691,1329,1475
3404-001,2017,6,3,13,589,612,1201,1329
3404-001,2017,6,3,14,619,660,1279,1201
3404-001,2017,6,3,15,656,649,1305,1279
3404-001,2017,6,3,16,722,569,1291,1305
3404-001,2017,6,3,17,795,627,1422,1291
3404-001,2017,6,3,18,1087,603,1690,1422
3404-001,2017,6,3,19,628,533,1161,1690
3404-001,2017,6,3,20,428,420,848,1161
3404-001,2017,6,3,21,403,284,687,848
3404-001,2017,6,3,22,245,262,507,687
3404-001,2017,6,3,23,182,172,354,507
3404-001,2017,6,3,24,125,95,220,354
3404-001,2017,6,4,1,81,71,152,220
3404-001,2017,6,4,2,83,54,137,152
3404-001,2017,6,4,3,33,36,69,137
3404-001,2017,6,4,4,43,46,89,69
3404-001,2017,6,4,5,42,48,90,89
3404-001,2017,6,4,6,71,136,207,90
3404-001,2017,6,4,7,142,235,377,207
3404-001,2017,6,4,8,232,314,546,377
3404-001,2017,6,4,9,328,354,682,546
3404-001,2017,6,4,10,345,365,710,682
3404-001,2017,6,4,11,383,453,836,710
3404-001,2017,6,4,12,351,466,817,836
3404-001,2017,6,4,13,411,425,836,817
3404-001,2017,6,4,14,415,464,879,836
3404-001,2017,6,4,15,511,367,878,879
3404-001,2017,6,4,16,634,459,1093,878
3404-001,2017,6,4,17,626,418,1044,1093
3404-001,2017,6,4,18,693,458,1151,1044
3404-001,2017,6,4,19,608,416,1024,1151
3404-001,2017,6,4,20,434,368,802,1024
3404-001,2017,6,4,21,373,338,711,802
3404-001,2017,6,4,22,315,275,590,711
3404-001,2017,6,4,23,199,171,370,590
3404-001,2017,6,4,24,112,137,249,370
3404-001,2017,6,5,1,61,77,138,249
3404-001,2017,6,5,2,26,45,71,138
3404-001,2017,6,5,3,35,44,79,71
3404-001,2017,6,5,4,44,39,83,79
3404-001,2017,6,5,5,76,81,157,83
3404-001,2017,6,5,6,139,284,423,157
3404-001,2017,6,5,7,360,828,1188,423
3404-001,2017,6,5,8,720,1825,2545,1188
3404-001,2017,6,5,9,884,1288,2172,2545
3404-001,2017,6,5,10,827,792,1619,2172
3404-001,2017,6,5,11,787,847,1634,1619
3404-001,2017,6,5,12,774,763,1537,1634
3404-001,2017,6,5,13,668,690,1358,1537
3404-001,2017,6,5,14,749,760,1509,1358
3404-001,2017,6,5,15,868,799,1667,1509
3404-001,2017,6,5,16,850,814,1664,1667
3404-001,2017,6,5,17,905,723,1628,1664
3404-001,2017,6,5,18,1299,727,2026,1628
3404-001,2017,6,5,19,1201,687,1888,2026
3404-001,2017,6,5,20,898,549,1447,1888
3404-001,2017,6,5,21,695,378,1073,1447
3404-001,2017,6,5,22,431,286,717,1073
3404-001,2017,6,5,23,275,165,440,717
3404-001,2017,6,5,24,135,130,265,440
3404-001,2017,6,6,1,106,88,194,265
3404-001,2017,6,6,2,67,55,122,194
3404-001,2017,6,6,3,58,47,105,122
3404-001,2017,6,6,4,51,36,87,105
3404-001,2017,6,6,5,74,80,154,87
3404-001,2017,6,6,6,122,234,356,154
3404-001,2017,6,6,7,264,527,791,356
3404-001,2017,6,6,8,402,880,1282,791
3404-001,2017,6,6,9,560,732,1292,1282
3404-001,2017,6,6,10,489,613,1102,1292
3404-001,2017,6,6,11,515,634,1149,1102
3404-001,2017,6,6,12,517,596,1113,1149
3404-001,2017,6,6,13,538,499,1037,1113
3404-001,2017,6,6,14,552,477,1029,1037
3404-001,2017,6,6,15,637,520,1157,1029
3404-001,2017,6,6,16,663,500,1163,1157
3404-001,2017,6,6,17,746,472,1218,1163
3404-001,2017,6,6,18,1020,481,1501,1218
3404-001,2017,6,6,19,663,413,1076,1501
3404-001,2017,6,6,20,421,316,737,1076
3404-001,2017,6,6,21,373,276,649,737
3404-001,2017,6,6,22,204,193,397,649
3404-001,2017,6,6,23,137,138,275,397
3404-001,2017,6,6,24,97,105,202,275
3404-001,2017,6,7,1,59,64,123,202
3404-001,2017,6,7,2,36,36,72,123
3404-001,2017,6,7,3,22,28,50,72
3404-001,2017,6,7,4,25,42,67,50
3404-001,2017,6,7,5,55,61,116,67
3404-001,2017,6,7,6,114,214,328,116
3404-001,2017,6,7,7,315,704,1019,328
3404-001,2017,6,7,8,720,1819,2539,1019
3404-001,2017,6,7,9,973,1450,2423,2539
3404-001,2017,6,7,10,769,815,1584,2423
3404-001,2017,6,7,11,815,758,1573,1584
3404-001,2017,6,7,12,767,728,1495,1573
3404-001,2017,6,7,13,642,644,1286,1495
3404-001,2017,6,7,14,728,767,1495,1286
3404-001,2017,6,7,15,898,763,1661,1495
3404-001,2017,6,7,16,900,769,1669,1661
3404-001,2017,6,7,17,847,631,1478,1669
3404-001,2017,6,7,18,1315,637,1952,1478
3404-001,2017,6,7,19,1150,585,1735,1952
3404-001,2017,6,7,20,739,473,1212,1735
3404-001,2017,6,7,21,626,319,945,1212
3404-001,2017,6,7,22,390,256,646,945
3404-001,2017,6,7,23,227,143,370,646
3404-001,2017,6,7,24,140,102,242,370
3404-001,2017,6,8,1,92,77,169,242
3404-001,2017,6,8,2,57,46,103,169
3404-001,2017,6,8,3,37,35,72,103
3404-001,2017,6,8,4,52,58,110,72
3404-001,2017,6,8,5,72,81,153,110
3404-001,2017,6,8,6,145,259,404,153
3404-001,2017,6,8,7,336,722,1058,404
3404-001,2017,6,8,8,730,1857,2587,1058
3404-001,2017,6,8,9,958,1431,2389,2587
3404-001,2017,6,8,10,807,837,1644,2389
3404-001,2017,6,8,11,809,813,1622,1644
3404-001,2017,6,8,12,751,752,1503,1622
3404-001,2017,6,8,13,693,638,1331,1503
3404-001,2017,6,8,14,760,736,1496,1331
3404-001,2017,6,8,15,813,792,1605,1496
3404-001,2017,6,8,16,919,788,1707,1605
3404-001,2017,6,8,17,947,783,1730,1707
3404-001,2017,6,8,18,1267,774,2041,1730
3404-001,2017,6,8,19,1236,644,1880,2041
3404-001,2017,6,8,20,822,494,1316,1880
3404-001,2017,6,8,21,729,403,1132,1316
3404-001,2017,6,8,22,490,291,781,1132
3404-001,2017,6,8,23,258,173,431,781
3404-001,2017,6,8,24,146,110,256,431
3404-001,2017,6,9,1,87,87,174,256
3404-001,2017,6,9,2,65,65,130,174
3404-001,2017,6,9,3,36,45,81,130
3404-001,2017,6,9,4,57,48,105,81
3404-001,2017,6,9,5,80,82,162,105
3404-001,2017,6,9,6,155,267,422,162
3404-001,2017,6,9,7,338,742,1080,422
3404-001,2017,6,9,8,721,1862,2583,1080
3404-001,2017,6,9,9,950,1394,2344,2583
3404-001,2017,6,9,10,829,827,1656,2344
3404-001,2017,6,9,11,841,886,1727,1656
3404-001,2017,6,9,12,810,781,1591,1727
3404-001,2017,6,9,13,687,593,1280,1591
3404-001,2017,6,9,14,759,705,1464,1280
3404-001,2017,6,9,15,917,746,1663,1464
3404-001,2017,6,9,16,950,808,1758,1663
3404-001,2017,6,9,17,979,735,1714,1758
3404-001,2017,6,9,18,1572,875,2447,1714
3404-001,2017,6,9,19,1525,756,2281,2447
3404-001,2017,6,9,20,980,601,1581,2281
3404-001,2017,6,9,21,729,432,1161,1581
3404-001,2017,6,9,22,434,314,748,1161
3404-001,2017,6,9,23,256,198,454,748
3404-001,2017,6,9,24,145,132,277,454
3404-001,2017,6,10,1,147,86,233,277
3404-001,2017,6,10,2,91,63,154,233
3404-001,2017,6,10,3,46,46,92,154
3404-001,2017,6,10,4,54,64,118,92
3404-001,2017,6,10,5,96,88,184,118
3404-001,2017,6,10,6,138,218,356,184
3404-001,2017,6,10,7,309,496,805,356
3404-001,2017,6,10,8,477,820,1297,805
3404-001,2017,6,10,9,741,853,1594,1297
3404-001,2017,6,10,10,638,702,1340,1594
3404-001,2017,6,10,11,661,752,1413,1340
3404-001,2017,6,10,12,606,660,1266,1413
3404-001,2017,6,10,13,626,627,1253,1266
3404-001,2017,6,10,14,558,587,1145,1253
3404-001,2017,6,10,15,617,549,1166,1145
3404-001,2017,6,10,16,714,587,1301,1166
3404-001,2017,6,10,17,848,569,1417,1301
3404-001,2017,6,10,18,1032,603,1635,1417
3404-001,2017,6,10,19,771,521,1292,1635
3404-001,2017,6,10,20,437,418,855,1292
3404-001,2017,6,10,21,373,288,661,855
3404-001,2017,6,10,22,256,226,482,661
3404-001,2017,6,10,23,156,140,296,482
3404-001,2017,6,10,24,132,116,248,296
3404-001,2017,6,11,1,105,93,198,248
3404-001,2017,6,11,2,79,67,146,198
3404-001,2017,6,11,3,45,31,76,146
3404-001,2017,6,11,4,39,34,73,76
3404-001,2017,6,11,5,53,62,115,73
3404-001,2017,6,11,6,81,130,211,115
3404-001,2017,6,11,7,131,222,353,211
3404-001,2017,6,11,8,201,322,523,353
3404-001,2017,6,11,9,326,364,690,523
3404-001,2017,6,11,10,321,378,699,690
3404-001,2017,6,11,11,334,423,757,699
3404-001,2017,6,11,12,366,434,800,757
3404-001,2017,6,11,13,401,425,826,800
3404-001,2017,6,11,14,463,451,914,826
3404-001,2017,6,11,15,546,449,995,914
3404-001,2017,6,11,16,591,418,1009,995
3404-001,2017,6,11,17,607,425,1032,1009
3404-001,2017,6,11,18,722,417,1139,1032
3404-001,2017,6,11,19,601,446,1047,1139
3404-001,2017,6,11,20,453,370,823,1047
3404-001,2017,6,11,21,344,321,665,823
3404-001,2017,6,11,22,290,265,555,665
3404-001,2017,6,11,23,179,257,436,555
3404-001,2017,6,11,24,104,131,235,436
3404-001,2017,6,12,1,57,96,153,235
3404-001,2017,6,12,2,28,60,88,153
3404-001,2017,6,12,3,39,43,82,88
3404-001,2017,6,12,4,36,46,82,82
3404-001,2017,6,12,5,85,90,175,82
3404-001,2017,6,12,6,149,296,445,175
3404-001,2017,6,12,7,382,761,1143,445
3404-001,2017,6,12,8,773,2046,2819,1143
3404-001,2017,6,12,9,906,1398,2304,2819
3404-001,2017,6,12,10,827,829,1656,2304
3404-001,2017,6,12,11,774,854,1628,1656
3404-001,2017,6,12,12,781,713,1494,1628
3404-001,2017,6,12,13,671,666,1337,1494
3404-001,2017,6,12,14,824,759,1583,1337
3404-001,2017,6,12,15,836,844,1680,1583
3404-001,2017,6,12,16,905,787,1692,1680
3404-001,2017,6,12,17,926,768,1694,1692
3404-001,2017,6,12,18,1323,769,2092,1694
3404-001,2017,6,12,19,1206,660,1866,2092
3404-001,2017,6,12,20,808,500,1308,1866
3404-001,2017,6,12,21,748,373,1121,1308
3404-001,2017,6,12,22,403,279,682,1121
3404-001,2017,6,12,23,228,174,402,682
3404-001,2017,6,12,24,138,109,247,402
3404-001,2017,6,13,1,114,75,189,247
3404-001,2017,6,13,2,66,56,122,189
3404-001,2017,6,13,3,40,47,87,122
3404-001,2017,6,13,4,46,39,85,87
3404-001,2017,6,13,5,76,95,171,85
3404-001,2017,6,13,6,145,288,433,171
3404-001,2017,6,13,7,331,743,1074,433
3404-001,2017,6,13,8,742,1884,2626,1074
3404-001,2017,6,13,9,983,1385,2368,2626
3404-001,2017,6,13,10,825,879,1704,2368
3404-001,2017,6,13,11,786,807,1593,1704
3404-001,2017,6,13,12,749,743,1492,1593
3404-001,2017,6,13,13,670,647,1317,1492
3404-001,2017,6,13,14,766,760,1526,1317
3404-001,2017,6,13,15,854,809,1663,1526
3404-001,2017,6,13,16,909,825,1734,1663
3404-001,2017,6,13,17,925,686,1611,1734
3404-001,2017,6,13,18,1324,723,2047,1611
3404-001,2017,6,13,19,1221,661,1882,2047
3404-001,2017,6,13,20,835,543,1378,1882
3404-001,2017,6,13,21,771,390,1161,1378
3404-001,2017,6,13,22,479,293,772,1161
3404-001,2017,6,13,23,261,200,461,772
3404-001,2017,6,13,24,174,102,276,461
3404-001,2017,6,14,1,102,80,182,276
3404-001,2017,6,14,2,60,58,118,182
3404-001,2017,6,14,3,43,46,89,118
3404-001,2017,6,14,4,49,44,93,89
3404-001,2017,6,14,5,83,101,184,93
3404-001,2017,6,14,6,145,277,422,184
3404-001,2017,6,14,7,351,734,1085,422
3404-001,2017,6,14,8,717,1953,2670,1085
3404-001,2017,6,14,9,1024,1453,2477,2670
3404-001,2017,6,14,10,864,873,1737,2477
3404-001,2017,6,14,11,849,849,1698,1737
3404-001,2017,6,14,12,809,773,1582,1698
3404-001,2017,6,14,13,635,697,1332,1582
3404-001,2017,6,14,14,782,756,1538,1332
3404-001,2017,6,14,15,936,770,1706,1538
3404-001,2017,6,14,16,894,766,1660,1706
3404-001,2017,6,14,17,959,746,1705,1660
3404-001,2017,6,14,18,1518,708,2226,1705
3404-001,2017,6,14,19,1346,672,2018,2226
3404-001,2017,6,14,20,735,558,1293,2018
3404-001,2017,6,14,21,627,378,1005,1293
3404-001,2017,6,14,22,424,293,717,1005
3404-001,2017,6,14,23,235,195,430,717
3404-001,2017,6,14,24,146,118,264,430
3404-001,2017,6,15,1,98,87,185,264
3404-001,2017,6,15,2,67,51,118,185
3404-001,2017,6,15,3,40,38,78,118
3404-001,2017,6,15,4,55,50,105,78
3404-001,2017,6,15,5,87,109,196,105
3404-001,2017,6,15,6,172,283,455,196
3404-001,2017,6,15,7,341,734,1075,455
3404-001,2017,6,15,8,721,1854,2575,1075
3404-001,2017,6,15,9,1007,1405,2412,2575
3404-001,2017,6,15,10,793,802,1595,2412
3404-001,2017,6,15,11,829,786,1615,1595
3404-001,2017,6,15,12,728,811,1539,1615
3404-001,2017,6,15,13,662,656,1318,1539
3404-001,2017,6,15,14,732,764,1496,1318
3404-001,2017,6,15,15,870,819,1689,1496
3404-001,2017,6,15,16,930,806,1736,1689
3404-001,2017,6,15,17,955,745,1700,1736
3404-001,2017,6,15,18,1307,730,2037,1700
3404-001,2017,6,15,19,1270,689,1959,2037
3404-001,2017,6,15,20,854,524,1378,1959
3404-001,2017,6,15,21,758,389,1147,1378
3404-001,2017,6,15,22,470,269,739,1147
3404-001,2017,6,15,23,290,210,500,739
3404-001,2017,6,15,24,174,141,315,500
3404-001,2017,6,16,1,120,89,209,315
3404-001,2017,6,16,2,57,60,117,209
3404-001,2017,6,16,3,48,51,99,117
3404-001,2017,6,16,4,51,32,83,99
3404-001,2017,6,16,5,85,108,193,83
3404-001,2017,6,16,6,159,284,443,193
3404-001,2017,6,16,7,314,768,1082,443
3404-001,2017,6,16,8,715,1861,2576,1082
3404-001,2017,6,16,9,1003,1442,2445,2576
3404-001,2017,6,16,10,861,817,1678,2445
3404-001,2017,6,16,11,827,828,1655,1678
3404-001,2017,6,16,12,764,784,1548,1655
3404-001,2017,6,16,13,746,639,1385,1548
3404-001,2017,6,16,14,808,733,1541,1385
3404-001,2017,6,16,15,900,782,1682,1541
3404-001,2017,6,16,16,957,768,1725,1682
3404-001,2017,6,16,17,1057,828,1885,1725
3404-001,2017,6,16,18,1595,847,2442,1885
3404-001,2017,6,16,19,1588,792,2380,2442
3404-001,2017,6,16,20,935,623,1558,2380
3404-001,2017,6,16,21,832,451,1283,1558
3404-001,2017,6,16,22,474,327,801,1283
3404-001,2017,6,16,23,266,231,497,801
3404-001,2017,6,16,24,157,133,290,497
3404-001,2017,6,17,1,126,98,224,290
3404-001,2017,6,17,2,82,70,152,224
3404-001,2017,6,17,3,54,50,104,152
3404-001,2017,6,17,4,50,53,103,104
3404-001,2017,6,17,5,107,112,219,103
3404-001,2017,6,17,6,149,251,400,219
3404-001,2017,6,17,7,264,504,768,400
3404-001,2017,6,17,8,463,789,1252,768
3404-001,2017,6,17,9,696,866,1562,1252
3404-001,2017,6,17,10,652,772,1424,1562
3404-001,2017,6,17,11,613,778,1391,1424
3404-001,2017,6,17,12,616,755,1371,1391
3404-001,2017,6,17,13,587,631,1218,1371
3404-001,2017,6,17,14,644,620,1264,1218
3404-001,2017,6,17,15,651,675,1326,1264
3404-001,2017,6,17,16,720,677,1397,1326
3404-001,2017,6,17,17,851,589,1440,1397
3404-001,2017,6,17,18,1101,650,1751,1440
3404-001,2017,6,17,19,826,552,1378,1751
3404-001,2017,6,17,20,501,441,942,1378
3404-001,2017,6,17,21,361,308,669,942
3404-001,2017,6,17,22,279,239,518,669
3404-001,2017,6,17,23,204,179,383,518
3404-001,2017,6,17,24,138,107,245,383
3404-001,2017,6,18,1,94,67,161,245
3404-001,2017,6,18,2,65,68,133,161
3404-001,2017,6,18,3,32,35,67,133
3404-001,2017,6,18,4,45,30,75,67
3404-001,2017,6,18,5,53,64,117,75
3404-001,2017,6,18,6,100,131,231,117
3404-001,2017,6,18,7,137,254,391,231
3404-001,2017,6,18,8,241,282,523,391
3404-001,2017,6,18,9,324,345,669,523
3404-001,2017,6,18,10,317,371,688,669
3404-001,2017,6,18,11,393,405,798,688
3404-001,2017,6,18,12,385,463,848,798
3404-001,2017,6,18,13,404,450,854,848
3404-001,2017,6,18,14,494,540,1034,854
3404-001,2017,6,18,15,508,551,1059,1034
3404-001,2017,6,18,16,591,536,1127,1059
3404-001,2017,6,18,17,659,486,1145,1127
3404-001,2017,6,18,18,674,497,1171,1145
3404-001,2017,6,18,19,502,451,953,1171
3404-001,2017,6,18,20,456,373,829,953
3404-001,2017,6,18,21,388,348,736,829
3404-001,2017,6,18,22,267,291,558,736
3404-001,2017,6,18,23,177,198,375,558
3404-001,2017,6,18,24,108,144,252,375
3404-001,2017,6,19,1,76,81,157,252
3404-001,2017,6,19,2,41,45,86,157
3404-001,2017,6,19,3,27,47,74,86
3404-001,2017,6,19,4,30,37,67,74
3404-001,2017,6,19,5,74,99,173,67
3404-001,2017,6,19,6,154,306,460,173
3404-001,2017,6,19,7,373,792,1165,460
3404-001,2017,6,19,8,730,2056,2786,1165
3404-001,2017,6,19,9,922,1394,2316,2786
3404-001,2017,6,19,10,827,810,1637,2316
3404-001,2017,6,19,11,756,790,1546,1637
3404-001,2017,6,19,12,757,721,1478,1546
3404-001,2017,6,19,13,634,640,1274,1478
3404-001,2017,6,19,14,743,752,1495,1274
3404-001,2017,6,19,15,925,822,1747,1495
3404-001,2017,6,19,16,920,842,1762,1747
3404-001,2017,6,19,17,972,703,1675,1762
3404-001,2017,6,19,18,1250,780,2030,1675
3404-001,2017,6,19,19,1270,680,1950,2030
3404-001,2017,6,19,20,889,558,1447,1950
3404-001,2017,6,19,21,839,395,1234,1447
3404-001,2017,6,19,22,449,285,734,1234
3404-001,2017,6,19,23,245,170,415,734
3404-001,2017,6,19,24,170,106,276,415
3404-001,2017,6,20,1,116,91,207,276
3404-001,2017,6,20,2,70,63,133,207
3404-001,2017,6,20,3,46,35,81,133
3404-001,2017,6,20,4,62,43,105,81
3404-001,2017,6,20,5,82,97,179,105
3404-001,2017,6,20,6,153,278,431,179
3404-001,2017,6,20,7,345,775,1120,431
3404-001,2017,6,20,8,727,1902,2629,1120
3404-001,2017,6,20,9,996,1381,2377,2629
3404-001,2017,6,20,10,792,921,1713,2377
3404-001,2017,6,20,11,844,799,1643,1713
3404-001,2017,6,20,12,767,779,1546,1643
3404-001,2017,6,20,13,712,665,1377,1546
3404-001,2017,6,20,14,814,749,1563,1377
3404-001,2017,6,20,15,874,795,1669,1563
3404-001,2017,6,20,16,839,732,1571,1669
3404-001,2017,6,20,17,884,760,1644,1571
3404-001,2017,6,20,18,1256,697,1953,1644
3404-001,2017,6,20,19,1270,655,1925,1953
3404-001,2017,6,20,20,823,535,1358,1925
3404-001,2017,6,20,21,830,395,1225,1358
3404-001,2017,6,20,22,416,264,680,1225
3404-001,2017,6,20,23,264,186,450,680
3404-001,2017,6,20,24,158,108,266,450
3404-001,2017,6,21,1,112,84,196,266
3404-001,2017,6,21,2,64,51,115,196
3404-001,2017,6,21,3,52,47,99,115
3404-001,2017,6,21,4,51,56,107,99
3404-001,2017,6,21,5,78,99,177,107
3404-001,2017,6,21,6,152,295,447,177
3404-001,2017,6,21,7,384,729,1113,447
3404-001,2017,6,21,8,746,1882,2628,1113
3404-001,2017,6,21,9,1018,1461,2479,2628
3404-001,2017,6,21,10,841,838,1679,2479
3404-001,2017,6,21,11,821,847,1668,1679
3404-001,2017,6,21,12,783,777,1560,1668
3404-001,2017,6,21,13,732,718,1450,1560
3404-001,2017,6,21,14,798,735,1533,1450
3404-001,2017,6,21,15,849,802,1651,1533
3404-001,2017,6,21,16,891,774,1665,1651
3404-001,2017,6,21,17,965,761,1726,1665
3404-001,2017,6,21,18,1517,806,2323,1726
3404-001,2017,6,21,19,1396,678,2074,2323
3404-001,2017,6,21,20,820,550,1370,2074
3404-001,2017,6,21,21,684,381,1065,1370
3404-001,2017,6,21,22,426,307,733,1065
3404-001,2017,6,21,23,248,195,443,733
3404-001,2017,6,21,24,147,120,267,443
3404-001,2017,6,22,1,121,87,208,267
3404-001,2017,6,22,2,62,49,111,208
3404-001,2017,6,22,3,42,43,85,111
3404-001,2017,6,22,4,65,55,120,85
3404-001,2017,6,22,5,77,123,200,120
3404-001,2017,6,22,6,156,280,436,200
3404-001,2017,6,22,7,352,743,1095,436
3404-001,2017,6,22,8,715,1835,2550,1095
3404-001,2017,6,22,9,1004,1386,2390,2550
3404-001,2017,6,22,10,805,855,1660,2390
3404-001,2017,6,22,11,794,811,1605,1660
3404-001,2017,6,22,12,759,746,1505,1605
3404-001,2017,6,22,13,681,641,1322,1505
3404-001,2017,6,22,14,741,697,1438,1322
3404-001,2017,6,22,15,875,748,1623,1438
3404-001,2017,6,22,16,888,760,1648,1623
3404-001,2017,6,22,17,966,711,1677,1648
3404-001,2017,6,22,18,1274,778,2052,1677
3404-001,2017,6,22,19,1279,689,1968,2052
3404-001,2017,6,22,20,818,521,1339,1968
3404-001,2017,6,22,21,795,398,1193,1339
3404-001,2017,6,22,22,465,308,773,1193
3404-001,2017,6,22,23,278,177,455,773
3404-001,2017,6,22,24,178,121,299,455
3404-001,2017,6,23,1,105,85,190,299
3404-001,2017,6,23,2,63,51,114,190
3404-001,2017,6,23,3,40,32,72,114
3404-001,2017,6,23,4,52,44,96,72
3404-001,2017,6,23,5,81,125,206,96
3404-001,2017,6,23,6,144,248,392,206
3404-001,2017,6,23,7,363,755,1118,392
3404-001,2017,6,23,8,743,1818,2561,1118
3404-001,2017,6,23,9,934,1390,2324,2561
3404-001,2017,6,23,10,813,819,1632,2324
3404-001,2017,6,23,11,825,819,1644,1632
3404-001,2017,6,23,12,751,751,1502,1644
3404-001,2017,6,23,13,694,705,1399,1502
3404-001,2017,6,23,14,838,748,1586,1399
3404-001,2017,6,23,15,916,807,1723,1586
3404-001,2017,6,23,16,961,766,1727,1723
3404-001,2017,6,23,17,1001,761,1762,1727
3404-001,2017,6,23,18,1568,840,2408,1762
3404-001,2017,6,23,19,1515,781,2296,2408
3404-001,2017,6,23,20,911,663,1574,2296
3404-001,2017,6,23,21,799,453,1252,1574
3404-001,2017,6,23,22,445,320,765,1252
3404-001,2017,6,23,23,280,190,470,765
3404-001,2017,6,23,24,178,119,297,470
3404-001,2017,6,24,1,132,97,229,297
3404-001,2017,6,24,2,71,54,125,229
3404-001,2017,6,24,3,54,75,129,125
3404-001,2017,6,24,4,62,53,115,129
3404-001,2017,6,24,5,96,115,211,115
3404-001,2017,6,24,6,144,232,376,211
3404-001,2017,6,24,7,267,495,762,376
3404-001,2017,6,24,8,489,833,1322,762
3404-001,2017,6,24,9,657,796,1453,1322
3404-001,2017,6,24,10,594,691,1285,1453
3404-001,2017,6,24,11,606,644,1250,1285
3404-001,2017,6,24,12,611,662,1273,1250
3404-001,2017,6,24,13,577,606,1183,1273
3404-001,2017,6,24,14,554,603,1157,1183
3404-001,2017,6,24,15,665,559,1224,1157
3404-001,2017,6,24,16,781,569,1350,1224
3404-001,2017,6,24,17,811,510,1321,1350
3404-001,2017,6,24,18,1114,556,1670,1321
3404-001,2017,6,24,19,717,468,1185,1670
3404-001,2017,6,24,20,386,413,799,1185
3404-001,2017,6,24,21,305,271,576,799
3404-001,2017,6,24,22,232,207,439,576
3404-001,2017,6,24,23,136,158,294,439
3404-001,2017,6,24,24,110,109,219,294
3404-001,2017,6,25,1,100,52,152,219
3404-001,2017,6,25,2,65,38,103,152
3404-001,2017,6,25,3,48,35,83,103
3404-001,2017,6,25,4,37,44,81,83
3404-001,2017,6,25,5,56,58,114,81
3404-001,2017,6,25,6,72,104,176,114
3404-001,2017,6,25,7,149,223,372,176
3404-001,2017,6,25,8,236,310,546,372
3404-001,2017,6,25,9,335,313,648,546
3404-001,2017,6,25,10,310,365,675,648
3404-001,2017,6,25,11,308,397,705,675
3404-001,2017,6,25,12,354,423,777,705
3404-001,2017,6,25,13,387,409,796,777
3404-001,2017,6,25,14,438,389,827,796
3404-001,2017,6,25,15,473,432,905,827
3404-001,2017,6,25,16,564,448,1012,905
3404-001,2017,6,25,17,618,439,1057,1012
3404-001,2017,6,25,18,708,429,1137,1057
3404-001,2017,6,25,19,526,426,952,1137
3404-001,2017,6,25,20,408,342,750,952
3404-001,2017,6,25,21,322,303,625,750
3404-001,2017,6,25,22,243,262,505,625
3404-001,2017,6,25,23,151,209,360,505
3404-001,2017,6,25,24,100,140,240,360
3404-001,2017,6,26,1,63,77,140,240
3404-001,2017,6,26,2,40,50,90,140
3404-001,2017,6,26,3,29,37,66,90
3404-001,2017,6,26,4,31,40,71,66
3404-001,2017,6,26,5,76,99,175,71
3404-001,2017,6,26,6,157,282,439,175
3404-001,2017,6,26,7,401,811,1212,439
3404-001,2017,6,26,8,757,2071,2828,1212
3404-001,2017,6,26,9,961,1388,2349,2828
3404-001,2017,6,26,10,758,787,1545,2349
3404-001,2017,6,26,11,791,772,1563,1545
3404-001,2017,6,26,12,787,750,1537,1563
3404-001,2017,6,26,13,679,669,1348,1537
3404-001,2017,6,26,14,752,705,1457,1348
3404-001,2017,6,26,15,805,810,1615,1457
3404-001,2017,6,26,16,882,719,1601,1615
3404-001,2017,6,26,17,911,664,1575,1601
3404-001,2017,6,26,18,1179,729,1908,1575
3404-001,2017,6,26,19,1119,637,1756,1908
3404-001,2017,6,26,20,804,515,1319,1756
3404-001,2017,6,26,21,757,394,1151,1319
3404-001,2017,6,26,22,447,262,709,1151
3404-001,2017,6,26,23,238,177,415,709
3404-001,2017,6,26,24,135,115,250,415
3404-001,2017,6,27,1,105,74,179,250
3404-001,2017,6,27,2,53,56,109,179
3404-001,2017,6,27,3,36,52,88,109
3404-001,2017,6,27,4,55,43,98,88
3404-001,2017,6,27,5,82,85,167,98
3404-001,2017,6,27,6,156,279,435,167
3404-001,2017,6,27,7,337,704,1041,435
3404-001,2017,6,27,8,770,1883,2653,1041
3404-001,2017,6,27,9,942,1385,2327,2653
3404-001,2017,6,27,10,801,894,1695,2327
3404-001,2017,6,27,11,821,807,1628,1695
3404-001,2017,6,27,12,773,721,1494,1628
3404-001,2017,6,27,13,674,674,1348,1494
3404-001,2017,6,27,14,737,740,1477,1348
3404-001,2017,6,27,15,878,779,1657,1477
3404-001,2017,6,27,16,928,745,1673,1657
3404-001,2017,6,27,17,958,694,1652,1673
3404-001,2017,6,27,18,1232,751,1983,1652
3404-001,2017,6,27,19,1255,662,1917,1983
3404-001,2017,6,27,20,817,509,1326,1917
3404-001,2017,6,27,21,779,378,1157,1326
3404-001,2017,6,27,22,442,269,711,1157
3404-001,2017,6,27,23,275,135,410,711
3404-001,2017,6,27,24,145,127,272,410
3404-001,2017,6,28,1,95,79,174,272
3404-001,2017,6,28,2,64,50,114,174
3404-001,2017,6,28,3,42,48,90,114
3404-001,2017,6,28,4,63,52,115,90
3404-001,2017,6,28,5,78,89,167,115
3404-001,2017,6,28,6,159,278,437,167
3404-001,2017,6,28,7,360,712,1072,437
3404-001,2017,6,28,8,698,1951,2649,1072
3404-001,2017,6,28,9,1003,1436,2439,2649
3404-001,2017,6,28,10,894,851,1745,2439
3404-001,2017,6,28,11,797,812,1609,1745
3404-001,2017,6,28,12,828,859,1687,1609
3404-001,2017,6,28,13,662,716,1378,1687
3404-001,2017,6,28,14,780,790,1570,1378
3404-001,2017,6,28,15,901,811,1712,1570
3404-001,2017,6,28,16,896,830,1726,1712
3404-001,2017,6,28,17,917,747,1664,1726
3404-001,2017,6,28,18,1485,769,2254,1664
3404-001,2017,6,28,19,1413,718,2131,2254
3404-001,2017,6,28,20,762,537,1299,2131
3404-001,2017,6,28,21,670,350,1020,1299
3404-001,2017,6,28,22,434,277,711,1020
3404-001,2017,6,28,23,242,190,432,711
3404-001,2017,6,28,24,161,98,259,432
3404-001,2017,6,29,1,105,97,202,259
3404-001,2017,6,29,2,81,58,139,202
3404-001,2017,6,29,3,49,56,105,139
3404-001,2017,6,29,4,55,47,102,105
3404-001,2017,6,29,5,101,94,195,102
3404-001,2017,6,29,6,141,282,423,195
3404-001,2017,6,29,7,356,696,1052,423
3404-001,2017,6,29,8,770,1855,2625,1052
3404-001,2017,6,29,9,967,1340,2307,2625
3404-001,2017,6,29,10,817,788,1605,2307
3404-001,2017,6,29,11,732,806,1538,1605
3404-001,2017,6,29,12,777,765,1542,1538
3404-001,2017,6,29,13,684,629,1313,1542
3404-001,2017,6,29,14,756,743,1499,1313
3404-001,2017,6,29,15,849,771,1620,1499
3404-001,2017,6,29,16,866,794,1660,1620
3404-001,2017,6,29,17,897,734,1631,1660
3404-001,2017,6,29,18,1356,758,2114,1631
3404-001,2017,6,29,19,1256,710,1966,2114
3404-001,2017,6,29,20,823,548,1371,1966
3404-001,2017,6,29,21,717,396,1113,1371
3404-001,2017,6,29,22,469,292,761,1113
3404-001,2017,6,29,23,255,186,441,761
3404-001,2017,6,29,24,177,131,308,441
3404-001,2017,6,30,1,128,90,218,308
3404-001,2017,6,30,2,57,52,109,218
3404-001,2017,6,30,3,59,42,101,109
3404-001,2017,6,30,4,55,48,103,101
3404-001,2017,6,30,5,100,121,221,103
3404-001,2017,6,30,6,148,281,429,221
3404-001,2017,6,30,7,363,769,1132,429
3404-001,2017,6,30,8,750,1793,2543,1132
3404-001,2017,6,30,9,972,1381,2353,2543
3404-001,2017,6,30,10,786,721,1507,2353
3404-001,2017,6,30,11,771,735,1506,1507
3404-001,2017,6,30,12,756,779,1535,1506
3404-001,2017,6,30,13,656,637,1293,1535
3404-001,2017,6,30,14,776,701,1477,1293
3404-001,2017,6,30,15,908,806,1714,1477
3404-001,2017,6,30,16,973,754,1727,1714
3404-001,2017,6,30,17,983,715,1698,1727
3404-001,2017,6,30,18,1739,812,2551,1698
3404-001,2017,6,30,19,1771,817,2588,2551
3404-001,2017,6,30,20,933,634,1567,2588
3404-001,2017,6,30,21,686,434,1120,1567
3404-001,2017,6,30,22,427,320,747,1120
3404-001,2017,6,30,23,275,201,476,747
3404-001,2017,6,30,24,193,117,310,476
3404-001,2017,7,1,1,133,107,240,310
3404-001,2017,7,1,2,83,57,140,240
3404-001,2017,7,1,3,51,49,100,140
3404-001,2017,7,1,4,77,61,138,100
3404-001,2017,7,1,5,82,98,180,138
3404-001,2017,7,1,6,152,241,393,180
3404-001,2017,7,1,7,243,490,733,393
3404-001,2017,7,1,8,532,842,1374,733
3404-001,2017,7,1,9,661,836,1497,1374
3404-001,2017,7,1,10,610,671,1281,1497
3404-001,2017,7,1,11,601,661,1262,1281
3404-001,2017,7,1,12,581,633,1214,1262
3404-001,2017,7,1,13,565,575,1140,1214
3404-001,2017,7,1,14,601,643,1244,1140
3404-001,2017,7,1,15,634,579,1213,1244
3404-001,2017,7,1,16,801,569,1370,1213
3404-001,2017,7,1,17,887,531,1418,1370
3404-001,2017,7,1,18,1047,579,1626,1418
3404-001,2017,7,1,19,785,499,1284,1626
3404-001,2017,7,1,20,394,357,751,1284
3404-001,2017,7,1,21,282,268,550,751
3404-001,2017,7,1,22,199,243,442,550
3404-001,2017,7,1,23,146,136,282,442
3404-001,2017,7,1,24,97,87,184,282
3404-001,2017,7,2,1,63,59,122,184
3404-001,2017,7,2,2,55,38,93,122
3404-001,2017,7,2,3,45,27,72,93
3404-001,2017,7,2,4,30,34,64,72
3404-001,2017,7,2,5,31,47,78,64
3404-001,2017,7,2,6,58,72,130,78
3404-001,2017,7,2,7,117,172,289,130
3404-001,2017,7,2,8,202,245,447,289
3404-001,2017,7,2,9,259,289,548,447
3404-001,2017,7,2,10,270,309,579,548
3404-001,2017,7,2,11,339,357,696,579
3404-001,2017,7,2,12,380,410,790,696
3404-001,2017,7,2,13,452,399,851,790
3404-001,2017,7,2,14,430,395,825,851
3404-001,2017,7,2,15,504,419,923,825
3404-001,2017,7,2,16,536,462,998,923
3404-001,2017,7,2,17,501,412,913,998
3404-001,2017,7,2,18,540,378,918,913
3404-001,2017,7,2,19,415,343,758,918
3404-001,2017,7,2,20,355,391,746,758
3404-001,2017,7,2,21,288,302,590,746
3404-001,2017,7,2,22,202,231,433,590
3404-001,2017,7,2,23,131,161,292,433
3404-001,2017,7,2,24,76,129,205,292
3404-001,2017,7,3,1,60,88,148,205
3404-001,2017,7,3,2,38,34,72,148
3404-001,2017,7,3,3,26,41,67,72
3404-001,2017,7,3,4,45,30,75,67
3404-001,2017,7,3,5,52,71,123,75
3404-001,2017,7,3,6,131,246,377,123
3404-001,2017,7,3,7,307,701,1008,377
3404-001,2017,7,3,8,735,1863,2598,1008
3404-001,2017,7,3,9,928,1417,2345,2598
3404-001,2017,7,3,10,747,747,1494,2345
3404-001,2017,7,3,11,685,770,1455,1494
3404-001,2017,7,3,12,746,731,1477,1455
3404-001,2017,7,3,13,658,637,1295,1477
3404-001,2017,7,3,14,703,745,1448,1295
3404-001,2017,7,3,15,816,778,1594,1448
3404-001,2017,7,3,16,826,761,1587,1594
3404-001,2017,7,3,17,815,681,1496,1587
3404-001,2017,7,3,18,1175,650,1825,1496
3404-001,2017,7,3,19,1163,585,1748,1825
3404-001,2017,7,3,20,773,518,1291,1748
3404-001,2017,7,3,21,763,347,1110,1291
3404-001,2017,7,3,22,444,255,699,1110
3404-001,2017,7,3,23,242,180,422,699
3404-001,2017,7,3,24,151,93,244,422
3404-001,2017,7,4,1,100,75,175,244
3404-001,2017,7,4,2,68,57,125,175
3404-001,2017,7,4,3,43,41,84,125
3404-001,2017,7,4,4,48,38,86,84
3404-001,2017,7,4,5,53,77,130,86
3404-001,2017,7,4,6,119,193,312,130
3404-001,2017,7,4,7,256,586,842,312
3404-001,2017,7,4,8,721,1777,2498,842
3404-001,2017,7,4,9,890,1324,2214,2498
3404-001,2017,7,4,10,788,816,1604,2214
3404-001,2017,7,4,11,770,862,1632,1604
3404-001,2017,7,4,12,702,758,1460,1632
3404-001,2017,7,4,13,652,614,1266,1460
3404-001,2017,7,4,14,722,718,1440,1266
3404-001,2017,7,4,15,861,776,1637,1440
3404-001,2017,7,4,16,881,763,1644,1637
3404-001,2017,7,4,17,837,674,1511,1644
3404-001,2017,7,4,18,1158,740,1898,1511
3404-001,2017,7,4,19,1168,669,1837,1898
3404-001,2017,7,4,20,867,531,1398,1837
3404-001,2017,7,4,21,714,386,1100,1398
3404-001,2017,7,4,22,471,257,728,1100
3404-001,2017,7,4,23,270,174,444,728
3404-001,2017,7,4,24,134,113,247,444
3404-001,2017,7,5,1,116,86,202,247
3404-001,2017,7,5,2,69,43,112,202
3404-001,2017,7,5,3,48,34,82,112
3404-001,2017,7,5,4,57,54,111,82
3404-001,2017,7,5,5,63,93,156,111
3404-001,2017,7,5,6,164,278,442,156
3404-001,2017,7,5,7,367,723,1090,442
3404-001,2017,7,5,8,745,1863,2608,1090
3404-001,2017,7,5,9,931,1415,2346,2608
3404-001,2017,7,5,10,737,773,1510,2346
3404-001,2017,7,5,11,771,771,1542,1510
3404-001,2017,7,5,12,716,763,1479,1542
3404-001,2017,7,5,13,687,666,1353,1479
3404-001,2017,7,5,14,785,745,1530,1353
3404-001,2017,7,5,15,858,787,1645,1530
3404-001,2017,7,5,16,846,801,1647,1645
3404-001,2017,7,5,17,855,676,1531,1647
3404-001,2017,7,5,18,1383,740,2123,1531
3404-001,2017,7,5,19,1344,667,2011,2123
3404-001,2017,7,5,20,788,526,1314,2011
3404-001,2017,7,5,21,631,362,993,1314
3404-001,2017,7,5,22,414,271,685,993
3404-001,2017,7,5,23,236,175,411,685
3404-001,2017,7,5,24,147,105,252,411
3404-001,2017,7,6,1,117,98,215,252
3404-001,2017,7,6,2,74,61,135,215
3404-001,2017,7,6,3,54,42,96,135
3404-001,2017,7,6,4,51,59,110,96
3404-001,2017,7,6,5,76,102,178,110
3404-001,2017,7,6,6,146,282,428,178
3404-001,2017,7,6,7,347,725,1072,428
3404-001,2017,7,6,8,759,1866,2625,1072
3404-001,2017,7,6,9,957,1411,2368,2625
3404-001,2017,7,6,10,806,815,1621,2368
3404-001,2017,7,6,11,778,823,1601,1621
3404-001,2017,7,6,12,750,709,1459,1601
3404-001,2017,7,6,13,680,675,1355,1459
3404-001,2017,7,6,14,757,755,1512,1355
3404-001,2017,7,6,15,859,853,1712,1512
3404-001,2017,7,6,16,909,807,1716,1712
3404-001,2017,7,6,17,884,726,1610,1716
3404-001,2017,7,6,18,1279,731,2010,1610
3404-001,2017,7,6,19,1307,652,1959,2010
3404-001,2017,7,6,20,806,518,1324,1959
3404-001,2017,7,6,21,735,371,1106,1324
3404-001,2017,7,6,22,417,294,711,1106
3404-001,2017,7,6,23,253,181,434,711
3404-001,2017,7,6,24,129,101,230,434
3404-001,2017,7,7,1,91,101,192,230
3404-001,2017,7,7,2,64,50,114,192
3404-001,2017,7,7,3,56,42,98,114
3404-001,2017,7,7,4,63,43,106,98
3404-001,2017,7,7,5,67,90,157,106
3404-001,2017,7,7,6,136,249,385,157
3404-001,2017,7,7,7,312,711,1023,385
3404-001,2017,7,7,8,709,1856,2565,1023
3404-001,2017,7,7,9,940,1311,2251,2565
3404-001,2017,7,7,10,777,779,1556,2251
3404-001,2017,7,7,11,772,759,1531,1556
3404-001,2017,7,7,12,784,756,1540,1531
3404-001,2017,7,7,13,666,629,1295,1540
3404-001,2017,7,7,14,774,742,1516,1295
3404-001,2017,7,7,15,900,816,1716,1516
3404-001,2017,7,7,16,996,762,1758,1716
3404-001,2017,7,7,17,891,727,1618,1758
3404-001,2017,7,7,18,1506,790,2296,1618
3404-001,2017,7,7,19,1531,721,2252,2296
3404-001,2017,7,7,20,917,624,1541,2252
3404-001,2017,7,7,21,715,356,1071,1541
3404-001,2017,7,7,22,364,277,641,1071
3404-001,2017,7,7,23,219,186,405,641
3404-001,2017,7,7,24,126,107,233,405
3404-001,2017,7,8,1,109,95,204,233
3404-001,2017,7,8,2,84,72,156,204
3404-001,2017,7,8,3,58,42,100,156
3404-001,2017,7,8,4,38,49,87,100
3404-001,2017,7,8,5,76,65,141,87
3404-001,2017,7,8,6,111,171,282,141
3404-001,2017,7,8,7,198,391,589,282
3404-001,2017,7,8,8,415,727,1142,589
3404-001,2017,7,8,9,709,695,1404,1142
3404-001,2017,7,8,10,570,617,1187,1404
3404-001,2017,7,8,11,588,644,1232,1187
3404-001,2017,7,8,12,574,610,1184,1232
3404-001,2017,7,8,13,551,522,1073,1184
3404-001,2017,7,8,14,555,508,1063,1073
3404-001,2017,7,8,15,601,500,1101,1063
3404-001,2017,7,8,16,649,506,1155,1101
3404-001,2017,7,8,17,654,490,1144,1155
3404-001,2017,7,8,18,927,548,1475,1144
3404-001,2017,7,8,19,620,453,1073,1475
3404-001,2017,7,8,20,393,367,760,1073
3404-001,2017,7,8,21,328,265,593,760
3404-001,2017,7,8,22,244,223,467,593
3404-001,2017,7,8,23,165,148,313,467
3404-001,2017,7,8,24,106,113,219,313
3404-001,2017,7,9,1,86,64,150,219
3404-001,2017,7,9,2,74,46,120,150
3404-001,2017,7,9,3,38,46,84,120
3404-001,2017,7,9,4,39,42,81,84
3404-001,2017,7,9,5,44,46,90,81
3404-001,2017,7,9,6,67,96,163,90
3404-001,2017,7,9,7,95,197,292,163
3404-001,2017,7,9,8,203,240,443,292
3404-001,2017,7,9,9,250,333,583,443
3404-001,2017,7,9,10,299,320,619,583
3404-001,2017,7,9,11,325,416,741,619
3404-001,2017,7,9,12,366,398,764,741
3404-001,2017,7,9,13,413,415,828,764
3404-001,2017,7,9,14,421,435,856,828
3404-001,2017,7,9,15,524,461,985,856
3404-001,2017,7,9,16,527,396,923,985
3404-001,2017,7,9,17,617,462,1079,923
3404-001,2017,7,9,18,609,399,1008,1079
3404-001,2017,7,9,19,492,381,873,1008
3404-001,2017,7,9,20,362,379,741,873
3404-001,2017,7,9,21,285,282,567,741
3404-001,2017,7,9,22,266,284,550,567
3404-001,2017,7,9,23,163,208,371,550
3404-001,2017,7,9,24,90,136,226,371
3404-001,2017,7,10,1,60,91,151,226
3404-001,2017,7,10,2,34,46,80,151
3404-001,2017,7,10,3,17,30,47,80
3404-001,2017,7,10,4,32,38,70,47
3404-001,2017,7,10,5,75,79,154,70
3404-001,2017,7,10,6,138,276,414,154
3404-001,2017,7,10,7,339,729,1068,414
3404-001,2017,7,10,8,725,1935,2660,1068
3404-001,2017,7,10,9,882,1376,2258,2660
3404-001,2017,7,10,10,681,693,1374,2258
3404-001,2017,7,10,11,698,688,1386,1374
3404-001,2017,7,10,12,716,663,1379,1386
3404-001,2017,7,10,13,606,615,1221,1379
3404-001,2017,7,10,14,662,647,1309,1221
3404-001,2017,7,10,15,820,785,1605,1309
3404-001,2017,7,10,16,820,722,1542,1605
3404-001,2017,7,10,17,823,618,1441,1542
3404-001,2017,7,10,18,1126,680,1806,1441
3404-001,2017,7,10,19,1132,633,1765,1806
3404-001,2017,7,10,20,752,461,1213,1765
3404-001,2017,7,10,21,706,324,1030,1213
3404-001,2017,7,10,22,392,250,642,1030
3404-001,2017,7,10,23,262,141,403,642
3404-001,2017,7,10,24,119,94,213,403
3404-001,2017,7,11,1,91,66,157,213
3404-001,2017,7,11,2,58,42,100,157
3404-001,2017,7,11,3,43,55,98,100
3404-001,2017,7,11,4,60,50,110,98
3404-001,2017,7,11,5,66,73,139,110
3404-001,2017,7,11,6,131,228,359,139
3404-001,2017,7,11,7,308,684,992,359
3404-001,2017,7,11,8,743,1810,2553,992
3404-001,2017,7,11,9,933,1371,2304,2553
3404-001,2017,7,11,10,790,823,1613,2304
3404-001,2017,7,11,11,695,795,1490,1613
3404-001,2017,7,11,12,805,733,1538,1490
3404-001,2017,7,11,13,650,667,1317,1538
3404-001,2017,7,11,14,801,742,1543,1317
3404-001,2017,7,11,15,900,843,1743,1543
3404-001,2017,7,11,16,905,759,1664,1743
3404-001,2017,7,11,17,835,680,1515,1664
3404-001,2017,7,11,18,1206,720,1926,1515
3404-001,2017,7,11,19,1333,621,1954,1926
3404-001,2017,7,11,20,820,559,1379,1954
3404-001,2017,7,11,21,713,327,1040,1379
3404-001,2017,7,11,22,378,276,654,1040
3404-001,2017,7,11,23,271,163,434,654
3404-001,2017,7,11,24,153,111,264,434
3404-001,2017,7,12,1,106,86,192,264
3404-001,2017,7,12,2,77,53,130,192
3404-001,2017,7,12,3,52,46,98,130
3404-001,2017,7,12,4,42,51,93,98
3404-001,2017,7,12,5,76,87,163,93
3404-001,2017,7,12,6,146,258,404,163
3404-001,2017,7,12,7,295,689,984,404
3404-001,2017,7,12,8,762,1914,2676,984
3404-001,2017,7,12,9,963,1377,2340,2676
3404-001,2017,7,12,10,813,851,1664,2340
3404-001,2017,7,12,11,776,861,1637,1664
3404-001,2017,7,12,12,799,748,1547,1637
3404-001,2017,7,12,13,660,658,1318,1547
3404-001,2017,7,12,14,752,746,1498,1318
3404-001,2017,7,12,15,851,794,1645,1498
3404-001,2017,7,12,16,931,781,1712,1645
3404-001,2017,7,12,17,871,721,1592,1712
3404-001,2017,7,12,18,1502,816,2318,1592
3404-001,2017,7,12,19,1322,692,2014,2318
3404-001,2017,7,12,20,819,533,1352,2014
3404-001,2017,7,12,21,691,359,1050,1352
3404-001,2017,7,12,22,396,311,707,1050
3404-001,2017,7,12,23,239,167,406,707
3404-001,2017,7,12,24,164,117,281,406
3404-001,2017,7,13,1,114,85,199,281
3404-001,2017,7,13,2,68,49,117,199
3404-001,2017,7,13,3,62,48,110,117
3404-001,2017,7,13,4,49,36,85,110
3404-001,2017,7,13,5,85,93,178,85
3404-001,2017,7,13,6,156,287,443,178
3404-001,2017,7,13,7,356,702,1058,443
3404-001,2017,7,13,8,772,1880,2652,1058
3404-001,2017,7,13,9,969,1359,2328,2652
3404-001,2017,7,13,10,839,823,1662,2328
3404-001,2017,7,13,11,755,840,1595,1662
3404-001,2017,7,13,12,833,767,1600,1595
3404-001,2017,7,13,13,654,643,1297,1600
3404-001,2017,7,13,14,718,782,1500,1297
3404-001,2017,7,13,15,804,780,1584,1500
3404-001,2017,7,13,16,913,779,1692,1584
3404-001,2017,7,13,17,924,675,1599,1692
3404-001,2017,7,13,18,1296,749,2045,1599
3404-001,2017,7,13,19,1245,702,1947,2045
3404-001,2017,7,13,20,775,532,1307,1947
3404-001,2017,7,13,21,790,373,1163,1307
3404-001,2017,7,13,22,438,305,743,1163
3404-001,2017,7,13,23,278,206,484,743
3404-001,2017,7,13,24,177,124,301,484
3404-001,2017,7,14,1,93,98,191,301
3404-001,2017,7,14,2,78,55,133,191
3404-001,2017,7,14,3,49,41,90,133
3404-001,2017,7,14,4,50,42,92,90
3404-001,2017,7,14,5,87,96,183,92
3404-001,2017,7,14,6,172,267,439,183
3404-001,2017,7,14,7,344,743,1087,439
3404-001,2017,7,14,8,817,1895,2712,1087
3404-001,2017,7,14,9,954,1378,2332,2712
3404-001,2017,7,14,10,777,839,1616,2332
3404-001,2017,7,14,11,830,844,1674,1616
3404-001,2017,7,14,12,753,782,1535,1674
3404-001,2017,7,14,13,714,643,1357,1535
3404-001,2017,7,14,14,789,702,1491,1357
3404-001,2017,7,14,15,846,799,1645,1491
3404-001,2017,7,14,16,972,822,1794,1645
3404-001,2017,7,14,17,984,784,1768,1794
3404-001,2017,7,14,18,1560,826,2386,1768
3404-001,2017,7,14,19,1562,788,2350,2386
3404-001,2017,7,14,20,940,662,1602,2350
3404-001,2017,7,14,21,760,398,1158,1602
3404-001,2017,7,14,22,446,319,765,1158
3404-001,2017,7,14,23,233,194,427,765
3404-001,2017,7,14,24,160,130,290,427
3404-001,2017,7,15,1,116,80,196,290
3404-001,2017,7,15,2,84,69,153,196
3404-001,2017,7,15,3,56,58,114,153
3404-001,2017,7,15,4,43,55,98,114
3404-001,2017,7,15,5,71,89,160,98
3404-001,2017,7,15,6,124,177,301,160
3404-001,2017,7,15,7,231,439,670,301
3404-001,2017,7,15,8,505,798,1303,670
3404-001,2017,7,15,9,726,757,1483,1303
3404-001,2017,7,15,10,586,706,1292,1483
3404-001,2017,7,15,11,602,674,1276,1292
3404-001,2017,7,15,12,659,639,1298,1276
3404-001,2017,7,15,13,582,574,1156,1298
3404-001,2017,7,15,14,579,576,1155,1156
3404-001,2017,7,15,15,643,515,1158,1155
3404-001,2017,7,15,16,718,573,1291,1158
3404-001,2017,7,15,17,713,535,1248,1291
3404-001,2017,7,15,18,915,555,1470,1248
3404-001,2017,7,15,19,624,441,1065,1470
3404-001,2017,7,15,20,376,357,733,1065
3404-001,2017,7,15,21,344,270,614,733
3404-001,2017,7,15,22,213,235,448,614
3404-001,2017,7,15,23,142,139,281,448
3404-001,2017,7,15,24,121,119,240,281
3404-001,2017,7,16,1,94,63,157,240
3404-001,2017,7,16,2,59,63,122,157
3404-001,2017,7,16,3,33,28,61,122
3404-001,2017,7,16,4,33,38,71,61
3404-001,2017,7,16,5,42,39,81,71
3404-001,2017,7,16,6,48,53,101,81
3404-001,2017,7,16,7,113,130,243,101
3404-001,2017,7,16,8,184,238,422,243
3404-001,2017,7,16,9,304,279,583,422
3404-001,2017,7,16,10,274,281,555,583
3404-001,2017,7,16,11,332,295,627,555
3404-001,2017,7,16,12,333,353,686,627
3404-001,2017,7,16,13,376,323,699,686
3404-001,2017,7,16,14,369,377,746,699
3404-001,2017,7,16,15,443,430,873,746
3404-001,2017,7,16,16,495,396,891,873
3404-001,2017,7,16,17,543,415,958,891
3404-001,2017,7,16,18,490,380,870,958
3404-001,2017,7,16,19,384,335,719,870
3404-001,2017,7,16,20,287,344,631,719
3404-001,2017,7,16,21,268,270,538,631
3404-001,2017,7,16,22,201,277,478,538
3404-001,2017,7,16,23,142,178,320,478
3404-001,2017,7,16,24,94,121,215,320
3404-001,2017,7,17,1,68,81,149,215
3404-001,2017,7,17,2,37,46,83,149
3404-001,2017,7,17,3,27,41,68,83
3404-001,2017,7,17,4,39,35,74,68
3404-001,2017,7,17,5,60,81,141,74
3404-001,2017,7,17,6,147,252,399,141
3404-001,2017,7,17,7,350,749,1099,399
3404-001,2017,7,17,8,767,1993,2760,1099
3404-001,2017,7,17,9,932,1399,2331,2760
3404-001,2017,7,17,10,807,810,1617,2331
3404-001,2017,7,17,11,750,735,1485,1617
3404-001,2017,7,17,12,713,768,1481,1485
3404-001,2017,7,17,13,609,609,1218,1481
3404-001,2017,7,17,14,689,726,1415,1218
3404-001,2017,7,17,15,838,783,1621,1415
3404-001,2017,7,17,16,834,743,1577,1621
3404-001,2017,7,17,17,886,661,1547,1577
3404-001,2017,7,17,18,1167,726,1893,1547
3404-001,2017,7,17,19,1178,682,1860,1893
3404-001,2017,7,17,20,778,514,1292,1860
3404-001,2017,7,17,21,763,341,1104,1292
3404-001,2017,7,17,22,423,238,661,1104
3404-001,2017,7,17,23,257,153,410,661
3404-001,2017,7,17,24,111,97,208,410
3404-001,2017,7,18,1,102,67,169,208
3404-001,2017,7,18,2,53,43,96,169
3404-001,2017,7,18,3,39,49,88,96
3404-001,2017,7,18,4,49,49,98,88
3404-001,2017,7,18,5,75,76,151,98
3404-001,2017,7,18,6,137,248,385,151
3404-001,2017,7,18,7,288,676,964,385
3404-001,2017,7,18,8,706,1846,2552,964
3404-001,2017,7,18,9,946,1365,2311,2552
3404-001,2017,7,18,10,783,777,1560,2311
3404-001,2017,7,18,11,760,827,1587,1560
3404-001,2017,7,18,12,775,709,1484,1587
3404-001,2017,7,18,13,632,650,1282,1484
3404-001,2017,7,18,14,751,759,1510,1282
3404-001,2017,7,18,15,887,809,1696,1510
3404-001,2017,7,18,16,898,802,1700,1696
3404-001,2017,7,18,17,895,749,1644,1700
3404-001,2017,7,18,18,1229,769,1998,1644
3404-001,2017,7,18,19,1231,686,1917,1998
3404-001,2017,7,18,20,861,525,1386,1917
3404-001,2017,7,18,21,769,371,1140,1386
3404-001,2017,7,18,22,457,288,745,1140
3404-001,2017,7,18,23,283,189,472,745
3404-001,2017,7,18,24,135,135,270,472
3404-001,2017,7,19,1,101,61,162,270
3404-001,2017,7,19,2,67,55,122,162
3404-001,2017,7,19,3,41,57,98,122
3404-001,2017,7,19,4,56,49,105,98
3404-001,2017,7,19,5,80,82,162,105
3404-001,2017,7,19,6,177,258,435,162
3404-001,2017,7,19,7,342,686,1028,435
3404-001,2017,7,19,8,774,1902,2676,1028
3404-001,2017,7,19,9,1014,1420,2434,2676
3404-001,2017,7,19,10,829,816,1645,2434
3404-001,2017,7,19,11,785,840,1625,1645
3404-001,2017,7,19,12,788,792,1580,1625
3404-001,2017,7,19,13,703,649,1352,1580
3404-001,2017,7,19,14,752,727,1479,1352
3404-001,2017,7,19,15,857,813,1670,1479
3404-001,2017,7,19,16,912,745,1657,1670
3404-001,2017,7,19,17,873,723,1596,1657
3404-001,2017,7,19,18,1481,834,2315,1596
3404-001,2017,7,19,19,1354,717,2071,2315
3404-001,2017,7,19,20,777,535,1312,2071
3404-001,2017,7,19,21,655,350,1005,1312
3404-001,2017,7,19,22,395,281,676,1005
3404-001,2017,7,19,23,244,174,418,676
3404-001,2017,7,19,24,126,141,267,418
3404-001,2017,7,20,1,103,88,191,267
3404-001,2017,7,20,2,58,59,117,191
3404-001,2017,7,20,3,45,36,81,117
3404-001,2017,7,20,4,46,43,89,81
3404-001,2017,7,20,5,85,83,168,89
3404-001,2017,7,20,6,149,301,450,168
3404-001,2017,7,20,7,371,723,1094,450
3404-001,2017,7,20,8,772,1887,2659,1094
3404-001,2017,7,20,9,1000,1428,2428,2659
3404-001,2017,7,20,10,899,850,1749,2428
3404-001,2017,7,20,11,804,885,1689,1749
3404-001,2017,7,20,12,833,759,1592,1689
3404-001,2017,7,20,13,633,623,1256,1592
3404-001,2017,7,20,14,786,811,1597,1256
3404-001,2017,7,20,15,834,766,1600,1597
3404-001,2017,7,20,16,952,780,1732,1600
3404-001,2017,7,20,17,894,744,1638,1732
3404-001,2017,7,20,18,1290,746,2036,1638
3404-001,2017,7,20,19,1261,700,1961,2036
3404-001,2017,7,20,20,886,523,1409,1961
3404-001,2017,7,20,21,764,359,1123,1409
3404-001,2017,7,20,22,426,282,708,1123
3404-001,2017,7,20,23,255,205,460,708
3404-001,2017,7,20,24,168,111,279,460
3404-001,2017,7,21,1,106,82,188,279
3404-001,2017,7,21,2,74,51,125,188
3404-001,2017,7,21,3,55,55,110,125
3404-001,2017,7,21,4,51,45,96,110
3404-001,2017,7,21,5,80,87,167,96
3404-001,2017,7,21,6,170,274,444,167
3404-001,2017,7,21,7,364,698,1062,444
3404-001,2017,7,21,8,739,1876,2615,1062
3404-001,2017,7,21,9,1016,1369,2385,2615
3404-001,2017,7,21,10,804,919,1723,2385
3404-001,2017,7,21,11,827,860,1687,1723
3404-001,2017,7,21,12,815,757,1572,1687
3404-001,2017,7,21,13,725,694,1419,1572
3404-001,2017,7,21,14,805,804,1609,1419
3404-001,2017,7,21,15,953,784,1737,1609
3404-001,2017,7,21,16,903,840,1743,1737
3404-001,2017,7,21,17,996,837,1833,1743
3404-001,2017,7,21,18,1528,830,2358,1833
3404-001,2017,7,21,19,1562,767,2329,2358
3404-001,2017,7,21,20,981,625,1606,2329
3404-001,2017,7,21,21,726,433,1159,1606
3404-001,2017,7,21,22,458,326,784,1159
3404-001,2017,7,21,23,276,224,500,784
3404-001,2017,7,21,24,133,117,250,500
3404-001,2017,7,22,1,106,86,192,250
3404-001,2017,7,22,2,70,72,142,192
3404-001,2017,7,22,3,61,55,116,142
3404-001,2017,7,22,4,62,63,125,116
3404-001,2017,7,22,5,82,83,165,125
3404-001,2017,7,22,6,161,239,400,165
3404-001,2017,7,22,7,270,497,767,400
3404-001,2017,7,22,8,441,904,1345,767
3404-001,2017,7,22,9,688,830,1518,1345
3404-001,2017,7,22,10,649,705,1354,1518
3404-001,2017,7,22,11,640,705,1345,1354
3404-001,2017,7,22,12,598,687,1285,1345
3404-001,2017,7,22,13,648,626,1274,1285
3404-001,2017,7,22,14,664,588,1252,1274
3404-001,2017,7,22,15,682,547,1229,1252
3404-001,2017,7,22,16,737,525,1262,1229
3404-001,2017,7,22,17,780,579,1359,1262
3404-001,2017,7,22,18,1074,562,1636,1359
3404-001,2017,7,22,19,718,531,1249,1636
3404-001,2017,7,22,20,417,439,856,1249
3404-001,2017,7,22,21,353,317,670,856
3404-001,2017,7,22,22,270,254,524,670
3404-001,2017,7,22,23,198,175,373,524
3404-001,2017,7,22,24,110,104,214,373
3404-001,2017,7,23,1,106,71,177,214
3404-001,2017,7,23,2,64,47,111,177
3404-001,2017,7,23,3,34,29,63,111
3404-001,2017,7,23,4,38,44,82,63
3404-001,2017,7,23,5,38,56,94,82
3404-001,2017,7,23,6,78,123,201,94
3404-001,2017,7,23,7,131,234,365,201
3404-001,2017,7,23,8,235,307,542,365
3404-001,2017,7,23,9,329,324,653,542
3404-001,2017,7,23,10,293,292,585,653
3404-001,2017,7,23,11,343,356,699,585
3404-001,2017,7,23,12,375,381,756,699
3404-001,2017,7,23,13,385,369,754,756
3404-001,2017,7,23,14,409,413,822,754
3404-001,2017,7,23,15,481,431,912,822
3404-001,2017,7,23,16,523,395,918,912
3404-001,2017,7,23,17,573,440,1013,918
3404-001,2017,7,23,18,593,439,1032,1013
3404-001,2017,7,23,19,471,367,838,1032
3404-001,2017,7,23,20,371,360,731,838
3404-001,2017,7,23,21,278,298,576,731
3404-001,2017,7,23,22,215,229,444,576
3404-001,2017,7,23,23,137,182,319,444
3404-001,2017,7,23,24,94,121,215,319
3404-001,2017,7,24,1,143,62,205,215
3404-001,2017,7,24,2,104,37,141,205
3404-001,2017,7,24,3,55,39,94,141
3404-001,2017,7,24,4,74,32,106,94
3404-001,2017,7,24,5,146,91,237,106
3404-001,2017,7,24,6,142,292,434,237
3404-001,2017,7,24,7,344,841,1185,434
3404-001,2017,7,24,8,746,2090,2836,1185
3404-001,2017,7,24,9,907,1427,2334,2836
3404-001,2017,7,24,10,744,840,1584,2334
3404-001,2017,7,24,11,724,766,1490,1584
3404-001,2017,7,24,12,714,779,1493,1490
3404-001,2017,7,24,13,608,646,1254,1493
3404-001,2017,7,24,14,676,726,1402,1254
3404-001,2017,7,24,15,829,777,1606,1402
3404-001,2017,7,24,16,827,747,1574,1606
3404-001,2017,7,24,17,854,709,1563,1574
3404-001,2017,7,24,18,1146,629,1775,1563
3404-001,2017,7,24,19,1155,624,1779,1775
3404-001,2017,7,24,20,765,486,1251,1779
3404-001,2017,7,24,21,734,358,1092,1251
3404-001,2017,7,24,22,408,255,663,1092
3404-001,2017,7,24,23,183,156,339,663
3404-001,2017,7,24,24,72,97,169,339
3404-001,2017,7,25,1,50,67,117,169
3404-001,2017,7,25,2,45,39,84,117
3404-001,2017,7,25,3,10,51,61,84
3404-001,2017,7,25,4,20,33,53,61
3404-001,2017,7,25,5,20,76,96,53
3404-001,2017,7,25,6,67,251,318,96
3404-001,2017,7,25,7,257,617,874,318
3404-001,2017,7,25,8,757,1860,2617,874
3404-001,2017,7,25,9,932,1377,2309,2617
3404-001,2017,7,25,10,725,845,1570,2309
3404-001,2017,7,25,11,690,882,1572,1570
3404-001,2017,7,25,12,611,781,1392,1572
3404-001,2017,7,25,13,513,690,1203,1392
3404-001,2017,7,25,14,641,750,1391,1203
3404-001,2017,7,25,15,712,811,1523,1391
3404-001,2017,7,25,16,742,775,1517,1523
3404-001,2017,7,25,17,865,714,1579,1517
3404-001,2017,7,25,18,1403,753,2156,1579
3404-001,2017,7,25,19,1397,686,2083,2156
3404-001,2017,7,25,20,843,551,1394,2083
3404-001,2017,7,25,21,741,349,1090,1394
3404-001,2017,7,25,22,400,294,694,1090
3404-001,2017,7,25,23,200,194,394,694
3404-001,2017,7,25,24,121,119,240,394
3404-001,2017,7,26,1,74,105,179,240
3404-001,2017,7,26,2,47,59,106,179
3404-001,2017,7,26,3,20,44,64,106
3404-001,2017,7,26,4,15,51,66,64
3404-001,2017,7,26,5,18,78,96,66
3404-001,2017,7,26,6,97,286,383,96
3404-001,2017,7,26,7,244,757,1001,383
3404-001,2017,7,26,8,757,1855,2612,1001
3404-001,2017,7,26,9,929,1378,2307,2612
3404-001,2017,7,26,10,739,823,1562,2307
3404-001,2017,7,26,11,651,819,1470,1562
3404-001,2017,7,26,12,624,789,1413,1470
3404-001,2017,7,26,13,471,688,1159,1413
3404-001,2017,7,26,14,614,762,1376,1159
3404-001,2017,7,26,15,663,827,1490,1376
3404-001,2017,7,26,16,863,765,1628,1490
3404-001,2017,7,26,17,882,738,1620,1628
3404-001,2017,7,26,18,1690,780,2470,1620
3404-001,2017,7,26,19,1656,728,2384,2470
3404-001,2017,7,26,20,836,527,1363,2384
3404-001,2017,7,26,21,735,399,1134,1363
3404-001,2017,7,26,22,348,296,644,1134
3404-001,2017,7,26,23,170,185,355,644
3404-001,2017,7,26,24,79,134,213,355
3404-001,2017,7,27,1,65,73,138,213
3404-001,2017,7,27,2,52,52,104,138
3404-001,2017,7,27,3,23,55,78,104
3404-001,2017,7,27,4,13,43,56,78
3404-001,2017,7,27,5,40,82,122,56
3404-001,2017,7,27,6,106,272,378,122
3404-001,2017,7,27,7,279,713,992,378
3404-001,2017,7,27,8,712,1871,2583,992
3404-001,2017,7,27,9,996,1397,2393,2583
3404-001,2017,7,27,10,673,867,1540,2393
3404-001,2017,7,27,11,641,820,1461,1540
3404-001,2017,7,27,12,695,813,1508,1461
3404-001,2017,7,27,13,542,705,1247,1508
3404-001,2017,7,27,14,626,765,1391,1247
3404-001,2017,7,27,15,804,848,1652,1391
3404-001,2017,7,27,16,678,863,1541,1652
3404-001,2017,7,27,17,801,729,1530,1541
3404-001,2017,7,27,18,1532,776,2308,1530
3404-001,2017,7,27,19,1456,684,2140,2308
3404-001,2017,7,27,20,794,556,1350,2140
3404-001,2017,7,27,21,730,387,1117,1350
3404-001,2017,7,27,22,358,307,665,1117
3404-001,2017,7,27,23,232,176,408,665
3404-001,2017,7,27,24,104,122,226,408
3404-001,2017,7,28,1,67,84,151,226
3404-001,2017,7,28,2,33,64,97,151
3404-001,2017,7,28,3,18,56,74,97
3404-001,2017,7,28,4,13,52,65,74
3404-001,2017,7,28,5,37,89,126,65
3404-001,2017,7,28,6,82,238,320,126
3404-001,2017,7,28,7,222,665,887,320
3404-001,2017,7,28,8,722,1766,2488,887
3404-001,2017,7,28,9,900,1395,2295,2488
3404-001,2017,7,28,10,634,801,1435,2295
3404-001,2017,7,28,11,675,833,1508,1435
3404-001,2017,7,28,12,693,726,1419,1508
3404-001,2017,7,28,13,547,694,1241,1419
3404-001,2017,7,28,14,668,685,1353,1241
3404-001,2017,7,28,15,769,764,1533,1353
3404-001,2017,7,28,16,875,811,1686,1533
3404-001,2017,7,28,17,978,699,1677,1686
3404-001,2017,7,28,18,1614,784,2398,1677
3404-001,2017,7,28,19,1637,715,2352,2398
3404-001,2017,7,28,20,924,552,1476,2352
3404-001,2017,7,28,21,572,380,952,1476
3404-001,2017,7,28,22,276,304,580,952
3404-001,2017,7,28,23,170,176,346,580
3404-001,2017,7,28,24,111,126,237,346
3404-001,2017,7,29,1,60,95,155,237
3404-001,2017,7,29,2,42,72,114,155
3404-001,2017,7,29,3,23,61,84,114
3404-001,2017,7,29,4,18,52,70,84
3404-001,2017,7,29,5,25,73,98,70
3404-001,2017,7,29,6,74,194,268,98
3404-001,2017,7,29,7,148,381,529,268
3404-001,2017,7,29,8,350,796,1146,529
3404-001,2017,7,29,9,565,700,1265,1146
3404-001,2017,7,29,10,422,724,1146,1265
3404-001,2017,7,29,11,525,769,1294,1146
3404-001,2017,7,29,12,606,732,1338,1294
3404-001,2017,7,29,13,550,636,1186,1338
3404-001,2017,7,29,14,476,605,1081,1186
3404-001,2017,7,29,15,533,614,1147,1081
3404-001,2017,7,29,16,565,575,1140,1147
3404-001,2017,7,29,17,712,515,1227,1140
3404-001,2017,7,29,18,840,534,1374,1227
3404-001,2017,7,29,19,540,496,1036,1374
3404-001,2017,7,29,20,281,346,627,1036
3404-001,2017,7,29,21,257,286,543,627
3404-001,2017,7,29,22,198,243,441,543
3404-001,2017,7,29,23,94,153,247,441
3404-001,2017,7,29,24,69,94,163,247
3404-001,2017,7,30,1,57,55,112,163
3404-001,2017,7,30,2,28,58,86,112
3404-001,2017,7,30,3,13,40,53,86
3404-001,2017,7,30,4,23,44,67,53
3404-001,2017,7,30,5,18,55,73,67
3404-001,2017,7,30,6,45,118,163,73
3404-001,2017,7,30,7,55,242,297,163
3404-001,2017,7,30,8,146,361,507,297
3404-001,2017,7,30,9,202,361,563,507
3404-001,2017,7,30,10,227,352,579,563
3404-001,2017,7,30,11,267,438,705,579
3404-001,2017,7,30,12,232,428,660,705
3404-001,2017,7,30,13,289,406,695,660
3404-001,2017,7,30,14,296,418,714,695
3404-001,2017,7,30,15,316,409,725,714
3404-001,2017,7,30,16,358,383,741,725
3404-001,2017,7,30,17,528,431,959,741
3404-001,2017,7,30,18,545,422,967,959
3404-001,2017,7,30,19,424,390,814,967
3404-001,2017,7,30,20,301,367,668,814
3404-001,2017,7,30,21,301,294,595,668
3404-001,2017,7,30,22,173,268,441,595
3404-001,2017,7,30,23,114,190,304,441
3404-001,2017,7,30,24,79,130,209,304
3404-001,2017,7,31,1,35,93,128,209
3404-001,2017,7,31,2,23,49,72,128
3404-001,2017,7,31,3,8,43,51,72
3404-001,2017,7,31,4,13,40,53,51
3404-001,2017,7,31,5,37,68,105,53
3404-001,2017,7,31,6,37,207,244,105
3404-001,2017,7,31,7,193,523,716,244
3404-001,2017,7,31,8,535,1313,1848,716
3404-001,2017,7,31,9,653,1004,1657,1848
3404-001,2017,7,31,10,409,585,994,1657
3404-001,2017,7,31,11,323,546,869,994
3404-001,2017,7,31,12,427,547,974,869
3404-001,2017,7,31,13,419,540,959,974
3404-001,2017,7,31,14,486,594,1080,959
3404-001,2017,7,31,15,520,622,1142,1080
3404-001,2017,7,31,16,545,551,1096,1142
3404-001,2017,7,31,17,528,504,1032,1096
3404-001,2017,7,31,18,885,488,1373,1032
3404-001,2017,7,31,19,858,484,1342,1373
3404-001,2017,7,31,20,476,412,888,1342
3404-001,2017,7,31,21,390,277,667,888
3404-001,2017,7,31,22,210,196,406,667
3404-001,2017,7,31,23,116,115,231,406
3404-001,2017,7,31,24,57,76,133,231
3404-001,2017,8,1,1,71,63,134,133
3404-001,2017,8,1,2,46,46,92,134
3404-001,2017,8,1,3,16,36,52,92
3404-001,2017,8,1,4,7,42,49,52
3404-001,2017,8,1,5,43,40,83,49
3404-001,2017,8,1,6,71,137,208,83
3404-001,2017,8,1,7,212,445,657,208
3404-001,2017,8,1,8,493,1150,1643,657
3404-001,2017,8,1,9,787,959,1746,1643
3404-001,2017,8,1,10,560,632,1192,1746
3404-001,2017,8,1,11,508,674,1182,1192
3404-001,2017,8,1,12,582,630,1212,1182
3404-001,2017,8,1,13,548,601,1149,1212
3404-001,2017,8,1,14,517,665,1182,1149
3404-001,2017,8,1,15,670,666,1336,1182
3404-001,2017,8,1,16,756,654,1410,1336
3404-001,2017,8,1,17,790,584,1374,1410
3404-001,2017,8,1,18,1188,651,1839,1374
3404-001,2017,8,1,19,1166,665,1831,1839
3404-001,2017,8,1,20,680,433,1113,1831
3404-001,2017,8,1,21,618,330,948,1113
3404-001,2017,8,1,22,343,253,596,948
3404-001,2017,8,1,23,144,161,305,596
3404-001,2017,8,1,24,120,100,220,305
3404-001,2017,8,2,1,92,77,169,220
3404-001,2017,8,2,2,28,61,89,169
3404-001,2017,8,2,3,25,41,66,89
3404-001,2017,8,2,4,19,37,56,66
3404-001,2017,8,2,5,31,76,107,56
3404-001,2017,8,2,6,89,199,288,107
3404-001,2017,8,2,7,261,512,773,288
3404-001,2017,8,2,8,588,1134,1722,773
3404-001,2017,8,2,9,799,930,1729,1722
3404-001,2017,8,2,10,591,615,1206,1729
3404-001,2017,8,2,11,643,730,1373,1206
3404-001,2017,8,2,12,573,657,1230,1373
3404-001,2017,8,2,13,557,588,1145,1230
3404-001,2017,8,2,14,594,624,1218,1145
3404-001,2017,8,2,15,670,628,1298,1218
3404-001,2017,8,2,16,726,553,1279,1298
3404-001,2017,8,2,17,765,572,1337,1279
3404-001,2017,8,2,18,1303,599,1902,1337
3404-001,2017,8,2,19,1313,643,1956,1902
3404-001,2017,8,2,20,677,428,1105,1956
3404-001,2017,8,2,21,508,302,810,1105
3404-001,2017,8,2,22,319,291,610,810
3404-001,2017,8,2,23,175,199,374,610
3404-001,2017,8,2,24,95,103,198,374
3404-001,2017,8,3,1,59,84,143,198
3404-001,2017,8,3,2,37,52,89,143
3404-001,2017,8,3,3,31,44,75,89
3404-001,2017,8,3,4,19,43,62,75
3404-001,2017,8,3,5,22,66,88,62
3404-001,2017,8,3,6,117,235,352,88
3404-001,2017,8,3,7,212,544,756,352
3404-001,2017,8,3,8,634,1243,1877,756
3404-001,2017,8,3,9,967,985,1952,1877
3404-001,2017,8,3,10,612,740,1352,1952
3404-001,2017,8,3,11,609,672,1281,1352
3404-001,2017,8,3,12,692,706,1398,1281
3404-001,2017,8,3,13,524,602,1126,1398
3404-001,2017,8,3,14,667,678,1345,1126
3404-001,2017,8,3,15,808,620,1428,1345
3404-001,2017,8,3,16,738,608,1346,1428
3404-001,2017,8,3,17,753,591,1344,1346
3404-001,2017,8,3,18,1476,647,2123,1344
3404-001,2017,8,3,19,1301,590,1891,2123
3404-001,2017,8,3,20,701,434,1135,1891
3404-001,2017,8,3,21,621,294,915,1135
3404-001,2017,8,3,22,358,242,600,915
3404-001,2017,8,3,23,153,180,333,600
3404-001,2017,8,3,24,83,79,162,333
3404-001,2017,8,4,1,46,67,113,162
3404-001,2017,8,4,2,43,58,101,113
3404-001,2017,8,4,3,22,42,64,101
3404-001,2017,8,4,4,7,42,49,64
3404-001,2017,8,4,5,31,69,100,49
3404-001,2017,8,4,6,86,222,308,100
3404-001,2017,8,4,7,254,515,769,308
3404-001,2017,8,4,8,618,1307,1925,769
3404-001,2017,8,4,9,869,1053,1922,1925
3404-001,2017,8,4,10,631,698,1329,1922
3404-001,2017,8,4,11,661,725,1386,1329
3404-001,2017,8,4,12,609,707,1316,1386
3404-001,2017,8,4,13,643,586,1229,1316
3404-001,2017,8,4,14,713,638,1351,1229
3404-001,2017,8,4,15,796,678,1474,1351
3404-001,2017,8,4,16,833,678,1511,1474
3404-001,2017,8,4,17,970,667,1637,1511
3404-001,2017,8,4,18,1747,657,2404,1637
3404-001,2017,8,4,19,1741,663,2404,2404
3404-001,2017,8,4,20,814,546,1360,2404
3404-001,2017,8,4,21,514,359,873,1360
3404-001,2017,8,4,22,352,285,637,873
3404-001,2017,8,4,23,163,161,324,637
3404-001,2017,8,4,24,77,102,179,324
3404-001,2017,8,5,1,59,94,153,179
3404-001,2017,8,5,2,43,48,91,153
3404-001,2017,8,5,3,31,59,90,91
3404-001,2017,8,5,4,37,39,76,90
3404-001,2017,8,5,5,43,73,116,76
3404-001,2017,8,5,6,95,196,291,116
3404-001,2017,8,5,7,193,420,613,291
3404-001,2017,8,5,8,337,648,985,613
3404-001,2017,8,5,9,585,702,1287,985
3404-001,2017,8,5,10,548,700,1248,1287
3404-001,2017,8,5,11,615,636,1251,1248
3404-001,2017,8,5,12,542,612,1154,1251
3404-001,2017,8,5,13,527,563,1090,1154
3404-001,2017,8,5,14,536,512,1048,1090
3404-001,2017,8,5,15,640,528,1168,1048
3404-001,2017,8,5,16,729,523,1252,1168
3404-001,2017,8,5,17,735,458,1193,1252
3404-001,2017,8,5,18,1072,507,1579,1193
3404-001,2017,8,5,19,667,532,1199,1579
3404-001,2017,8,5,20,438,415,853,1199
3404-001,2017,8,5,21,334,280,614,853
3404-001,2017,8,5,22,193,275,468,614
3404-001,2017,8,5,23,138,154,292,468
3404-001,2017,8,5,24,95,103,198,292
3404-001,2017,8,6,1,49,83,132,198
3404-001,2017,8,6,2,43,49,92,132
3404-001,2017,8,6,3,25,34,59,92
3404-001,2017,8,6,4,28,30,58,59
3404-001,2017,8,6,5,43,46,89,58
3404-001,2017,8,6,6,86,107,193,89
3404-001,2017,8,6,7,108,195,303,193
3404-001,2017,8,6,8,144,316,460,303
3404-001,2017,8,6,9,221,333,554,460
3404-001,2017,8,6,10,273,318,591,554
3404-001,2017,8,6,11,309,350,659,591
3404-001,2017,8,6,12,309,407,716,659
3404-001,2017,8,6,13,386,394,780,716
3404-001,2017,8,6,14,407,381,788,780
3404-001,2017,8,6,15,502,386,888,788
3404-001,2017,8,6,16,502,411,913,888
3404-001,2017,8,6,17,528,396,924,913
3404-001,2017,8,6,18,536,427,963,924
3404-001,2017,8,6,19,465,430,895,963
3404-001,2017,8,6,20,276,367,643,895
3404-001,2017,8,6,21,276,286,562,643
3404-001,2017,8,6,22,209,265,474,562
3404-001,2017,8,6,23,111,224,335,474
3404-001,2017,8,6,24,71,146,217,335
3404-001,2017,8,7,1,28,80,108,217
3404-001,2017,8,7,2,13,48,61,108
3404-001,2017,8,7,3,13,48,61,61
3404-001,2017,8,7,4,13,57,70,61
3404-001,2017,8,7,5,43,80,123,70
3404-001,2017,8,7,6,126,280,406,123
3404-001,2017,8,7,7,389,760,1149,406
3404-001,2017,8,7,8,940,1969,2909,1149
3404-001,2017,8,7,9,979,1313,2292,2909
3404-001,2017,8,7,10,784,774,1558,2292
3404-001,2017,8,7,11,722,749,1471,1558
3404-001,2017,8,7,12,741,787,1528,1471
3404-001,2017,8,7,13,573,638,1211,1528
3404-001,2017,8,7,14,646,724,1370,1211
3404-001,2017,8,7,15,921,761,1682,1370
3404-001,2017,8,7,16,958,769,1727,1682
3404-001,2017,8,7,17,992,697,1689,1727
3404-001,2017,8,7,18,1591,752,2343,1689
3404-001,2017,8,7,19,1551,625,2176,2343
3404-001,2017,8,7,20,976,545,1521,2176
3404-001,2017,8,7,21,909,413,1322,1521
3404-001,2017,8,7,22,447,262,709,1322
3404-001,2017,8,7,23,242,187,429,709
3404-001,2017,8,7,24,108,110,218,429
3404-001,2017,8,8,1,68,85,153,218
3404-001,2017,8,8,2,56,55,111,153
3404-001,2017,8,8,3,28,34,62,111
3404-001,2017,8,8,4,13,59,72,62
3404-001,2017,8,8,5,59,84,143,72
3404-001,2017,8,8,6,117,255,372,143
3404-001,2017,8,8,7,297,682,979,372
3404-001,2017,8,8,8,866,1845,2711,979
3404-001,2017,8,8,9,1221,1357,2578,2711
3404-001,2017,8,8,10,839,848,1687,2578
3404-001,2017,8,8,11,836,839,1675,1687
3404-001,2017,8,8,12,741,749,1490,1675
3404-001,2017,8,8,13,680,764,1444,1490
3404-001,2017,8,8,14,784,796,1580,1444
3404-001,2017,8,8,15,921,797,1718,1580
3404-001,2017,8,8,16,1001,790,1791,1718
3404-001,2017,8,8,17,1010,827,1837,1791
3404-001,2017,8,8,18,1898,739,2637,1837
3404-001,2017,8,8,19,1763,642,2405,2637
3404-001,2017,8,8,20,1004,498,1502,2405
3404-001,2017,8,8,21,952,404,1356,1502
3404-001,2017,8,8,22,447,279,726,1356
3404-001,2017,8,8,23,199,175,374,726
3404-001,2017,8,8,24,98,106,204,374
3404-001,2017,8,9,1,56,79,135,204
3404-001,2017,8,9,2,31,63,94,135
3404-001,2017,8,9,3,13,40,53,94
3404-001,2017,8,9,4,16,43,59,53
3404-001,2017,8,9,5,37,93,130,59
3404-001,2017,8,9,6,65,256,321,130
3404-001,2017,8,9,7,264,645,909,321
3404-001,2017,8,9,8,891,1829,2720,909
3404-001,2017,8,9,9,1230,1321,2551,2720
3404-001,2017,8,9,10,811,875,1686,2551
3404-001,2017,8,9,11,774,850,1624,1686
3404-001,2017,8,9,12,793,784,1577,1624
3404-001,2017,8,9,13,716,653,1369,1577
3404-001,2017,8,9,14,747,756,1503,1369
3404-001,2017,8,9,15,930,850,1780,1503
3404-001,2017,8,9,16,906,850,1756,1780
3404-001,2017,8,9,17,1093,746,1839,1756
3404-001,2017,8,9,18,2099,736,2835,1839
3404-001,2017,8,9,19,1827,657,2484,2835
3404-001,2017,8,9,20,1031,513,1544,2484
3404-001,2017,8,9,21,753,339,1092,1544
3404-001,2017,8,9,22,410,273,683,1092
3404-001,2017,8,9,23,175,173,348,683
3404-001,2017,8,9,24,111,100,211,348
3404-001,2017,8,10,1,25,78,103,211
3404-001,2017,8,10,2,13,49,62,103
3404-001,2017,8,10,3,8,47,55,62
3404-001,2017,8,10,4,9,50,59,55
3404-001,2017,8,10,5,31,75,106,59
3404-001,2017,8,10,6,112,255,367,106
3404-001,2017,8,10,7,246,638,884,367
3404-001,2017,8,10,8,673,1739,2412,884
3404-001,2017,8,10,9,982,1328,2310,2412
3404-001,2017,8,10,10,642,849,1491,2310
3404-001,2017,8,10,11,625,798,1423,1491
3404-001,2017,8,10,12,694,774,1468,1423
3404-001,2017,8,10,13,533,654,1187,1468
3404-001,2017,8,10,14,646,684,1330,1187
3404-001,2017,8,10,15,892,796,1688,1330
3404-001,2017,8,10,16,880,772,1652,1688
3404-001,2017,8,10,17,898,657,1555,1652
3404-001,2017,8,10,18,1279,709,1988,1555
3404-001,2017,8,10,19,1240,662,1902,1988
3404-001,2017,8,10,20,814,574,1388,1902
3404-001,2017,8,10,21,764,346,1110,1388
3404-001,2017,8,10,22,417,244,661,1110
3404-001,2017,8,10,23,220,153,373,661
3404-001,2017,8,10,24,140,111,251,373
3404-001,2017,8,11,1,101,87,188,251
3404-001,2017,8,11,2,70,57,127,188
3404-001,2017,8,11,3,46,58,104,127
3404-001,2017,8,11,4,56,52,108,104
3404-001,2017,8,11,5,71,73,144,108
3404-001,2017,8,11,6,146,259,405,144
3404-001,2017,8,11,7,320,728,1048,405
3404-001,2017,8,11,8,757,1785,2542,1048
3404-001,2017,8,11,9,917,1341,2258,2542
3404-001,2017,8,11,10,856,815,1671,2258
3404-001,2017,8,11,11,833,893,1726,1671
3404-001,2017,8,11,12,785,724,1509,1726
3404-001,2017,8,11,13,730,717,1447,1509
3404-001,2017,8,11,14,780,809,1589,1447
3404-001,2017,8,11,15,929,806,1735,1589
3404-001,2017,8,11,16,887,768,1655,1735
3404-001,2017,8,11,17,893,719,1612,1655
3404-001,2017,8,11,18,1027,817,1844,1612
3404-001,2017,8,11,19,994,734,1728,1844
3404-001,2017,8,11,20,886,614,1500,1728
3404-001,2017,8,11,21,734,435,1169,1500
3404-001,2017,8,11,22,345,320,665,1169
3404-001,2017,8,11,23,262,193,455,665
3404-001,2017,8,11,24,145,117,262,455
3404-001,2017,8,12,1,115,88,203,262
3404-001,2017,8,12,2,56,64,120,203
3404-001,2017,8,12,3,54,66,120,120
3404-001,2017,8,12,4,66,45,111,120
3404-001,2017,8,12,5,75,78,153,111
3404-001,2017,8,12,6,138,193,331,153
3404-001,2017,8,12,7,292,496,788,331
3404-001,2017,8,12,8,504,857,1361,788
3404-001,2017,8,12,9,713,778,1491,1361
3404-001,2017,8,12,10,651,742,1393,1491
3404-001,2017,8,12,11,659,747,1406,1393
3404-001,2017,8,12,12,683,717,1400,1406
3404-001,2017,8,12,13,551,642,1193,1400
3404-001,2017,8,12,14,615,655,1270,1193
3404-001,2017,8,12,15,644,673,1317,1270
3404-001,2017,8,12,16,686,590,1276,1317
3404-001,2017,8,12,17,692,578,1270,1276
3404-001,2017,8,12,18,1032,649,1681,1270
3404-001,2017,8,12,19,679,510,1189,1681
3404-001,2017,8,12,20,448,410,858,1189
3404-001,2017,8,12,21,338,281,619,858
3404-001,2017,8,12,22,270,245,515,619
3404-001,2017,8,12,23,152,138,290,515
3404-001,2017,8,12,24,124,97,221,290
3404-001,2017,8,13,1,89,91,180,221
3404-001,2017,8,13,2,69,41,110,180
3404-001,2017,8,13,3,39,60,99,110
3404-001,2017,8,13,4,39,35,74,99
3404-001,2017,8,13,5,59,48,107,74
3404-001,2017,8,13,6,95,109,204,107
3404-001,2017,8,13,7,123,225,348,204
3404-001,2017,8,13,8,249,355,604,348
3404-001,2017,8,13,9,322,360,682,604
3404-001,2017,8,13,10,331,389,720,682
3404-001,2017,8,13,11,389,437,826,720
3404-001,2017,8,13,12,369,453,822,826
3404-001,2017,8,13,13,365,406,771,822
3404-001,2017,8,13,14,421,481,902,771
3404-001,2017,8,13,15,514,452,966,902
3404-001,2017,8,13,16,623,445,1068,966
3404-001,2017,8,13,17,593,455,1048,1068
3404-001,2017,8,13,18,664,472,1136,1048
3404-001,2017,8,13,19,592,405,997,1136
3404-001,2017,8,13,20,456,379,835,997
3404-001,2017,8,13,21,316,325,641,835
3404-001,2017,8,13,22,243,241,484,641
3404-001,2017,8,13,23,128,171,299,484
3404-001,2017,8,13,24,113,129,242,299
3404-001,2017,8,14,1,65,79,144,242
3404-001,2017,8,14,2,36,59,95,144
3404-001,2017,8,14,3,27,29,56,95
3404-001,2017,8,14,4,35,41,76,56
3404-001,2017,8,14,5,70,74,144,76
3404-001,2017,8,14,6,132,239,371,144
3404-001,2017,8,14,7,353,614,967,371
3404-001,2017,8,14,8,648,1778,2426,967
3404-001,2017,8,14,9,755,1137,1892,2426
3404-001,2017,8,14,10,711,733,1444,1892
3404-001,2017,8,14,11,750,784,1534,1444
3404-001,2017,8,14,12,686,688,1374,1534
3404-001,2017,8,14,13,659,615,1274,1374
3404-001,2017,8,14,14,753,682,1435,1274
3404-001,2017,8,14,15,754,692,1446,1435
3404-001,2017,8,14,16,828,759,1587,1446
3404-001,2017,8,14,17,894,774,1668,1587
3404-001,2017,8,14,18,1181,708,1889,1668
3404-001,2017,8,14,19,1305,669,1974,1889
3404-001,2017,8,14,20,795,533,1328,1974
3404-001,2017,8,14,21,642,349,991,1328
3404-001,2017,8,14,22,366,254,620,991
3404-001,2017,8,14,23,191,175,366,620
3404-001,2017,8,14,24,125,104,229,366
3404-001,2017,8,15,1,103,70,173,229
3404-001,2017,8,15,2,61,65,126,173
3404-001,2017,8,15,3,48,54,102,126
3404-001,2017,8,15,4,57,35,92,102
3404-001,2017,8,15,5,56,54,110,92
3404-001,2017,8,15,6,75,144,219,110
3404-001,2017,8,15,7,188,362,550,219
3404-001,2017,8,15,8,373,752,1125,550
3404-001,2017,8,15,9,494,645,1139,1125
3404-001,2017,8,15,10,445,535,980,1139
3404-001,2017,8,15,11,526,547,1073,980
3404-001,2017,8,15,12,517,561,1078,1073
3404-001,2017,8,15,13,497,487,984,1078
3404-001,2017,8,15,14,533,531,1064,984
3404-001,2017,8,15,15,589,490,1079,1064
3404-001,2017,8,15,16,657,462,1119,1079
3404-001,2017,8,15,17,633,433,1066,1119
3404-001,2017,8,15,18,824,469,1293,1066
3404-001,2017,8,15,19,571,461,1032,1293
3404-001,2017,8,15,20,357,360,717,1032
3404-001,2017,8,15,21,329,274,603,717
3404-001,2017,8,15,22,195,207,402,603
3404-001,2017,8,15,23,138,140,278,402
3404-001,2017,8,15,24,79,92,171,278
3404-001,2017,8,16,1,66,78,144,171
3404-001,2017,8,16,2,54,59,113,144
3404-001,2017,8,16,3,41,37,78,113
3404-001,2017,8,16,4,33,40,73,78
3404-001,2017,8,16,5,76,56,132,73
3404-001,2017,8,16,6,133,220,353,132
3404-001,2017,8,16,7,328,674,1002,353
3404-001,2017,8,16,8,730,1999,2729,1002
3404-001,2017,8,16,9,870,1337,2207,2729
3404-001,2017,8,16,10,811,818,1629,2207
3404-001,2017,8,16,11,779,800,1579,1629
3404-001,2017,8,16,12,816,781,1597,1579
3404-001,2017,8,16,13,724,704,1428,1597
3404-001,2017,8,16,14,785,812,1597,1428
3404-001,2017,8,16,15,898,828,1726,1597
3404-001,2017,8,16,16,861,770,1631,1726
3404-001,2017,8,16,17,928,735,1663,1631
3404-001,2017,8,16,18,1406,769,2175,1663
3404-001,2017,8,16,19,1234,647,1881,2175
3404-001,2017,8,16,20,863,520,1383,1881
3404-001,2017,8,16,21,607,344,951,1383
3404-001,2017,8,16,22,383,259,642,951
3404-001,2017,8,16,23,215,168,383,642
3404-001,2017,8,16,24,133,102,235,383
3404-001,2017,8,17,1,104,101,205,235
3404-001,2017,8,17,2,66,61,127,205
3404-001,2017,8,17,3,43,55,98,127
3404-001,2017,8,17,4,68,43,111,98
3404-001,2017,8,17,5,76,91,167,111
3404-001,2017,8,17,6,132,237,369,167
3404-001,2017,8,17,7,326,684,1010,369
3404-001,2017,8,17,8,733,1873,2606,1010
3404-001,2017,8,17,9,958,1430,2388,2606
3404-001,2017,8,17,10,787,867,1654,2388
3404-001,2017,8,17,11,828,830,1658,1654
3404-001,2017,8,17,12,836,723,1559,1658
3404-001,2017,8,17,13,653,639,1292,1559
3404-001,2017,8,17,14,784,741,1525,1292
3404-001,2017,8,17,15,854,826,1680,1525
3404-001,2017,8,17,16,912,812,1724,1680
3404-001,2017,8,17,17,877,729,1606,1724
3404-001,2017,8,17,18,1263,745,2008,1606
3404-001,2017,8,17,19,1276,707,1983,2008
3404-001,2017,8,17,20,832,543,1375,1983
3404-001,2017,8,17,21,765,353,1118,1375
3404-001,2017,8,17,22,457,278,735,1118
3404-001,2017,8,17,23,242,169,411,735
3404-001,2017,8,17,24,159,117,276,411
3404-001,2017,8,18,1,112,94,206,276
3404-001,2017,8,18,2,54,57,111,206
3404-001,2017,8,18,3,40,35,75,111
3404-001,2017,8,18,4,50,41,91,75
3404-001,2017,8,18,5,78,106,184,91
3404-001,2017,8,18,6,152,253,405,184
3404-001,2017,8,18,7,329,712,1041,405
3404-001,2017,8,18,8,747,1850,2597,1041
3404-001,2017,8,18,9,945,1366,2311,2597
3404-001,2017,8,18,10,812,843,1655,2311
3404-001,2017,8,18,11,834,814,1648,1655
3404-001,2017,8,18,12,747,765,1512,1648
3404-001,2017,8,18,13,714,656,1370,1512
3404-001,2017,8,18,14,847,730,1577,1370
3404-001,2017,8,18,15,866,749,1615,1577
3404-001,2017,8,18,16,913,823,1736,1615
3404-001,2017,8,18,17,955,781,1736,1736
3404-001,2017,8,18,18,1577,805,2382,1736
3404-001,2017,8,18,19,1553,789,2342,2382
3404-001,2017,8,18,20,938,578,1516,2342
3404-001,2017,8,18,21,753,445,1198,1516
3404-001,2017,8,18,22,419,300,719,1198
3404-001,2017,8,18,23,230,184,414,719
3404-001,2017,8,18,24,147,118,265,414
3404-001,2017,8,19,1,99,83,182,265
3404-001,2017,8,19,2,77,67,144,182
3404-001,2017,8,19,3,51,53,104,144
3404-001,2017,8,19,4,63,56,119,104
3404-001,2017,8,19,5,90,67,157,119
3404-001,2017,8,19,6,122,228,350,157
3404-001,2017,8,19,7,283,518,801,350
3404-001,2017,8,19,8,467,867,1334,801
3404-001,2017,8,19,9,673,842,1515,1334
3404-001,2017,8,19,10,690,696,1386,1515
3404-001,2017,8,19,11,661,688,1349,1386
3404-001,2017,8,19,12,649,703,1352,1349
3404-001,2017,8,19,13,644,640,1284,1352
3404-001,2017,8,19,14,637,643,1280,1284
3404-001,2017,8,19,15,720,583,1303,1280
3404-001,2017,8,19,16,769,609,1378,1303
3404-001,2017,8,19,17,820,567,1387,1378
3404-001,2017,8,19,18,1071,583,1654,1387
3404-001,2017,8,19,19,732,533,1265,1654
3404-001,2017,8,19,20,482,398,880,1265
3404-001,2017,8,19,21,326,256,582,880
3404-001,2017,8,19,22,232,219,451,582
3404-001,2017,8,19,23,146,147,293,451
3404-001,2017,8,19,24,104,103,207,293
3404-001,2017,8,20,1,79,69,148,207
3404-001,2017,8,20,2,71,52,123,148
3404-001,2017,8,20,3,38,38,76,123
3404-001,2017,8,20,4,44,47,91,76
3404-001,2017,8,20,5,44,42,86,91
3404-001,2017,8,20,6,71,72,143,86
3404-001,2017,8,20,7,93,140,233,143
3404-001,2017,8,20,8,190,239,429,233
3404-001,2017,8,20,9,280,322,602,429
3404-001,2017,8,20,10,256,255,511,602
3404-001,2017,8,20,11,368,331,699,511
3404-001,2017,8,20,12,369,381,750,699
3404-001,2017,8,20,13,403,374,777,750
3404-001,2017,8,20,14,405,448,853,777
3404-001,2017,8,20,15,512,439,951,853
3404-001,2017,8,20,16,581,432,1013,951
3404-001,2017,8,20,17,516,406,922,1013
3404-001,2017,8,20,18,612,396,1008,922
3404-001,2017,8,20,19,444,414,858,1008
3404-001,2017,8,20,20,346,343,689,858
3404-001,2017,8,20,21,271,301,572,689
3404-001,2017,8,20,22,173,246,419,572
3404-001,2017,8,20,23,124,205,329,419
3404-001,2017,8,20,24,88,121,209,329
3404-001,2017,8,21,1,52,79,131,209
3404-001,2017,8,21,2,30,43,73,131
3404-001,2017,8,21,3,33,39,72,73
3404-001,2017,8,21,4,39,41,80,72
3404-001,2017,8,21,5,67,89,156,80
3404-001,2017,8,21,6,140,213,353,156
3404-001,2017,8,21,7,348,728,1076,353
3404-001,2017,8,21,8,771,2028,2799,1076
3404-001,2017,8,21,9,849,1407,2256,2799
3404-001,2017,8,21,10,699,792,1491,2256
3404-001,2017,8,21,11,770,786,1556,1491
3404-001,2017,8,21,12,706,716,1422,1556
3404-001,2017,8,21,13,645,610,1255,1422
3404-001,2017,8,21,14,719,719,1438,1255
3404-001,2017,8,21,15,863,794,1657,1438
3404-001,2017,8,21,16,934,739,1673,1657
3404-001,2017,8,21,17,831,706,1537,1673
3404-001,2017,8,21,18,1130,694,1824,1537
3404-001,2017,8,21,19,1190,657,1847,1824
3404-001,2017,8,21,20,789,535,1324,1847
3404-001,2017,8,21,21,801,339,1140,1324
3404-001,2017,8,21,22,404,260,664,1140
3404-001,2017,8,21,23,222,159,381,664
3404-001,2017,8,21,24,140,87,227,381
3404-001,2017,8,22,1,87,80,167,227
3404-001,2017,8,22,2,61,49,110,167
3404-001,2017,8,22,3,42,36,78,110
3404-001,2017,8,22,4,57,47,104,78
3404-001,2017,8,22,5,71,92,163,104
3404-001,2017,8,22,6,132,244,376,163
3404-001,2017,8,22,7,357,690,1047,376
3404-001,2017,8,22,8,757,1890,2647,1047
3404-001,2017,8,22,9,953,1431,2384,2647
3404-001,2017,8,22,10,816,870,1686,2384
3404-001,2017,8,22,11,794,807,1601,1686
3404-001,2017,8,22,12,815,782,1597,1601
3404-001,2017,8,22,13,685,661,1346,1597
3404-001,2017,8,22,14,812,800,1612,1346
3404-001,2017,8,22,15,831,800,1631,1612
3404-001,2017,8,22,16,952,727,1679,1631
3404-001,2017,8,22,17,939,741,1680,1679
3404-001,2017,8,22,18,1259,778,2037,1680
3404-001,2017,8,22,19,1281,708,1989,2037
3404-001,2017,8,22,20,864,558,1422,1989
3404-001,2017,8,22,21,770,384,1154,1422
3404-001,2017,8,22,22,427,295,722,1154
3404-001,2017,8,22,23,260,176,436,722
3404-001,2017,8,22,24,127,113,240,436
3404-001,2017,8,23,1,83,70,153,240
3404-001,2017,8,23,2,66,48,114,153
3404-001,2017,8,23,3,48,46,94,114
3404-001,2017,8,23,4,41,55,96,94
3404-001,2017,8,23,5,67,81,148,96
3404-001,2017,8,23,6,137,216,353,148
3404-001,2017,8,23,7,311,642,953,353
3404-001,2017,8,23,8,715,1763,2478,953
3404-001,2017,8,23,9,946,1423,2369,2478
3404-001,2017,8,23,10,792,828,1620,2369
3404-001,2017,8,23,11,775,879,1654,1620
3404-001,2017,8,23,12,765,701,1466,1654
3404-001,2017,8,23,13,675,639,1314,1466
3404-001,2017,8,23,14,770,718,1488,1314
3404-001,2017,8,23,15,876,785,1661,1488
3404-001,2017,8,23,16,913,769,1682,1661
3404-001,2017,8,23,17,939,697,1636,1682
3404-001,2017,8,23,18,1452,786,2238,1636
3404-001,2017,8,23,19,1243,709,1952,2238
3404-001,2017,8,23,20,857,514,1371,1952
3404-001,2017,8,23,21,633,332,965,1371
3404-001,2017,8,23,22,365,275,640,965
3404-001,2017,8,23,23,242,156,398,640
3404-001,2017,8,23,24,123,118,241,398
3404-001,2017,8,24,1,101,81,182,241
3404-001,2017,8,24,2,64,58,122,182
3404-001,2017,8,24,3,32,43,75,122
3404-001,2017,8,24,4,59,58,117,75
3404-001,2017,8,24,5,72,89,161,117
3404-001,2017,8,24,6,123,218,341,161
3404-001,2017,8,24,7,287,660,947,341
3404-001,2017,8,24,8,746,1835,2581,947
3404-001,2017,8,24,9,967,1362,2329,2581
3404-001,2017,8,24,10,774,844,1618,2329
3404-001,2017,8,24,11,853,839,1692,1618
3404-001,2017,8,24,12,767,734,1501,1692
3404-001,2017,8,24,13,662,623,1285,1501
3404-001,2017,8,24,14,770,706,1476,1285
3404-001,2017,8,24,15,827,753,1580,1476
3404-001,2017,8,24,16,859,770,1629,1580
3404-001,2017,8,24,17,924,664,1588,1629
3404-001,2017,8,24,18,1306,675,1981,1588
3404-001,2017,8,24,19,1202,680,1882,1981
3404-001,2017,8,24,20,791,490,1281,1882
3404-001,2017,8,24,21,693,320,1013,1281
3404-001,2017,8,24,22,374,258,632,1013
3404-001,2017,8,24,23,214,171,385,632
3404-001,2017,8,24,24,141,109,250,385
3404-001,2017,8,25,1,87,67,154,250
3404-001,2017,8,25,2,69,61,130,154
3404-001,2017,8,25,3,32,36,68,130
3404-001,2017,8,25,4,46,55,101,68
3404-001,2017,8,25,5,72,77,149,101
3404-001,2017,8,25,6,138,238,376,149
3404-001,2017,8,25,7,318,731,1049,376
3404-001,2017,8,25,8,772,1898,2670,1049
3404-001,2017,8,25,9,947,1345,2292,2670
3404-001,2017,8,25,10,810,851,1661,2292
3404-001,2017,8,25,11,841,822,1663,1661
3404-001,2017,8,25,12,798,768,1566,1663
3404-001,2017,8,25,13,696,642,1338,1566
3404-001,2017,8,25,14,809,744,1553,1338
3404-001,2017,8,25,15,855,838,1693,1553
3404-001,2017,8,25,16,924,780,1704,1693
3404-001,2017,8,25,17,1000,790,1790,1704
3404-001,2017,8,25,18,1587,789,2376,1790
3404-001,2017,8,25,19,1610,814,2424,2376
3404-001,2017,8,25,20,1018,666,1684,2424
3404-001,2017,8,25,21,770,470,1240,1684
3404-001,2017,8,25,22,408,324,732,1240
3404-001,2017,8,25,23,269,210,479,732
3404-001,2017,8,25,24,143,111,254,479
3404-001,2017,8,26,1,95,92,187,254
3404-001,2017,8,26,2,88,60,148,187
3404-001,2017,8,26,3,53,58,111,148
3404-001,2017,8,26,4,55,52,107,111
3404-001,2017,8,26,5,88,91,179,107
3404-001,2017,8,26,6,153,223,376,179
3404-001,2017,8,26,7,317,515,832,376
3404-001,2017,8,26,8,477,903,1380,832
3404-001,2017,8,26,9,725,817,1542,1380
3404-001,2017,8,26,10,659,772,1431,1542
3404-001,2017,8,26,11,709,767,1476,1431
3404-001,2017,8,26,12,687,672,1359,1476
3404-001,2017,8,26,13,718,653,1371,1359
3404-001,2017,8,26,14,629,675,1304,1371
3404-001,2017,8,26,15,683,680,1363,1304
3404-001,2017,8,26,16,812,642,1454,1363
3404-001,2017,8,26,17,829,651,1480,1454
3404-001,2017,8,26,18,1132,721,1853,1480
3404-001,2017,8,26,19,927,591,1518,1853
3404-001,2017,8,26,20,695,415,1110,1518
3404-001,2017,8,26,21,497,320,817,1110
3404-001,2017,8,26,22,254,232,486,817
3404-001,2017,8,26,23,184,169,353,486
3404-001,2017,8,26,24,126,103,229,353
3404-001,2017,8,27,1,90,99,189,229
3404-001,2017,8,27,2,54,56,110,189
3404-001,2017,8,27,3,39,38,77,110
3404-001,2017,8,27,4,38,38,76,77
3404-001,2017,8,27,5,53,65,118,76
3404-001,2017,8,27,6,94,109,203,118
3404-001,2017,8,27,7,138,274,412,203
3404-001,2017,8,27,8,228,319,547,412
3404-001,2017,8,27,9,325,368,693,547
3404-001,2017,8,27,10,313,367,680,693
3404-001,2017,8,27,11,400,463,863,680
3404-001,2017,8,27,12,347,481,828,863
3404-001,2017,8,27,13,438,453,891,828
3404-001,2017,8,27,14,486,474,960,891
3404-001,2017,8,27,15,604,503,1107,960
3404-001,2017,8,27,16,871,447,1318,1107
3404-001,2017,8,27,17,957,501,1458,1318
3404-001,2017,8,27,18,1246,436,1682,1458
3404-001,2017,8,27,19,934,408,1342,1682
3404-001,2017,8,27,20,979,405,1384,1342
3404-001,2017,8,27,21,880,306,1186,1384
3404-001,2017,8,27,22,374,327,701,1186
3404-001,2017,8,27,23,128,231,359,701
3404-001,2017,8,27,24,113,144,257,359
3404-001,2017,8,28,1,54,88,142,257
3404-001,2017,8,28,2,46,42,88,142
3404-001,2017,8,28,3,28,44,72,88
3404-001,2017,8,28,4,33,46,79,72
3404-001,2017,8,28,5,61,94,155,79
3404-001,2017,8,28,6,142,259,401,155
3404-001,2017,8,28,7,354,854,1208,401
3404-001,2017,8,28,8,774,2192,2966,1208
3404-001,2017,8,28,9,907,1620,2527,2966
3404-001,2017,8,28,10,778,863,1641,2527
3404-001,2017,8,28,11,799,878,1677,1641
3404-001,2017,8,28,12,789,821,1610,1677
3404-001,2017,8,28,13,729,671,1400,1610
3404-001,2017,8,28,14,800,770,1570,1400
3404-001,2017,8,28,15,883,843,1726,1570
3404-001,2017,8,28,16,897,815,1712,1726
3404-001,2017,8,28,17,999,668,1667,1712
3404-001,2017,8,28,18,1424,704,2128,1667
3404-001,2017,8,28,19,1265,588,1853,2128
3404-001,2017,8,28,20,840,476,1316,1853
3404-001,2017,8,28,21,710,303,1013,1316
3404-001,2017,8,28,22,346,225,571,1013
3404-001,2017,8,28,23,198,135,333,571
3404-001,2017,8,28,24,96,95,191,333
3404-001,2017,8,29,1,81,73,154,191
3404-001,2017,8,29,2,51,59,110,154
3404-001,2017,8,29,3,52,32,84,110
3404-001,2017,8,29,4,52,45,97,84
3404-001,2017,8,29,5,68,79,147,97
3404-001,2017,8,29,6,120,239,359,147
3404-001,2017,8,29,7,330,738,1068,359
3404-001,2017,8,29,8,692,1939,2631,1068
3404-001,2017,8,29,9,941,1539,2480,2631
3404-001,2017,8,29,10,805,827,1632,2480
3404-001,2017,8,29,11,757,753,1510,1632
3404-001,2017,8,29,12,740,743,1483,1510
3404-001,2017,8,29,13,620,630,1250,1483
3404-001,2017,8,29,14,773,747,1520,1250
3404-001,2017,8,29,15,821,781,1602,1520
3404-001,2017,8,29,16,885,772,1657,1602
3404-001,2017,8,29,17,913,701,1614,1657
3404-001,2017,8,29,18,1423,753,2176,1614
3404-001,2017,8,29,19,1317,680,1997,2176
3404-001,2017,8,29,20,898,492,1390,1997
3404-001,2017,8,29,21,788,362,1150,1390
3404-001,2017,8,29,22,387,250,637,1150
3404-001,2017,8,29,23,215,170,385,637
3404-001,2017,8,29,24,145,104,249,385
3404-001,2017,8,30,1,101,62,163,249
3404-001,2017,8,30,2,59,60,119,163
3404-001,2017,8,30,3,37,39,76,119
3404-001,2017,8,30,4,59,49,108,76
3404-001,2017,8,30,5,89,72,161,108
3404-001,2017,8,30,6,138,257,395,161
3404-001,2017,8,30,7,334,720,1054,395
3404-001,2017,8,30,8,740,2027,2767,1054
3404-001,2017,8,30,9,1009,1584,2593,2767
3404-001,2017,8,30,10,820,838,1658,2593
3404-001,2017,8,30,11,773,850,1623,1658
3404-001,2017,8,30,12,716,810,1526,1623
3404-001,2017,8,30,13,642,691,1333,1526
3404-001,2017,8,30,14,791,735,1526,1333
3404-001,2017,8,30,15,876,782,1658,1526
3404-001,2017,8,30,16,939,761,1700,1658
3404-001,2017,8,30,17,920,722,1642,1700
3404-001,2017,8,30,18,1652,794,2446,1642
3404-001,2017,8,30,19,1479,670,2149,2446
3404-001,2017,8,30,20,871,499,1370,2149
3404-001,2017,8,30,21,619,373,992,1370
3404-001,2017,8,30,22,365,254,619,992
3404-001,2017,8,30,23,239,190,429,619
3404-001,2017,8,30,24,133,107,240,429
3404-001,2017,8,31,1,99,77,176,240
3404-001,2017,8,31,2,58,59,117,176
3404-001,2017,8,31,3,46,46,92,117
3404-001,2017,8,31,4,52,50,102,92
3404-001,2017,8,31,5,92,92,184,102
3404-001,2017,8,31,6,136,223,359,184
3404-001,2017,8,31,7,319,750,1069,359
3404-001,2017,8,31,8,750,2059,2809,1069
3404-001,2017,8,31,9,986,1536,2522,2809
3404-001,2017,8,31,10,798,826,1624,2522
3404-001,2017,8,31,11,732,868,1600,1624
3404-001,2017,8,31,12,720,761,1481,1600
3404-001,2017,8,31,13,639,645,1284,1481
3404-001,2017,8,31,14,772,667,1439,1284
3404-001,2017,8,31,15,801,847,1648,1439
3404-001,2017,8,31,16,939,814,1753,1648
3404-001,2017,8,31,17,996,739,1735,1753
3404-001,2017,8,31,18,1558,722,2280,1735
3404-001,2017,8,31,19,1289,731,2020,2280
3404-001,2017,8,31,20,879,512,1391,2020
3404-001,2017,8,31,21,786,378,1164,1391
3404-001,2017,8,31,22,375,273,648,1164
3404-001,2017,8,31,23,215,177,392,648
3404-001,2017,8,31,24,154,141,295,392
3404-001,2017,9,1,1,91,78,169,295
3404-001,2017,9,1,2,56,58,114,169
3404-001,2017,9,1,3,43,54,97,114
3404-001,2017,9,1,4,55,56,111,97
3404-001,2017,9,1,5,83,73,156,111
3404-001,2017,9,1,6,180,241,421,156
3404-001,2017,9,1,7,349,788,1137,421
3404-001,2017,9,1,8,742,1976,2718,1137
3404-001,2017,9,1,9,905,1511,2416,2718
3404-001,2017,9,1,10,749,803,1552,2416
3404-001,2017,9,1,11,830,778,1608,1552
3404-001,2017,9,1,12,781,770,1551,1608
3404-001,2017,9,1,13,737,649,1386,1551
3404-001,2017,9,1,14,796,765,1561,1386
3404-001,2017,9,1,15,888,848,1736,1561
3404-001,2017,9,1,16,969,812,1781,1736
3404-001,2017,9,1,17,1062,787,1849,1781
3404-001,2017,9,1,18,1877,767,2644,1849
3404-001,2017,9,1,19,1810,801,2611,2644
3404-001,2017,9,1,20,1156,629,1785,2611
3404-001,2017,9,1,21,791,426,1217,1785
3404-001,2017,9,1,22,406,300,706,1217
3404-001,2017,9,1,23,223,182,405,706
3404-001,2017,9,1,24,152,116,268,405
3404-001,2017,9,2,1,117,76,193,268
3404-001,2017,9,2,2,71,63,134,193
3404-001,2017,9,2,3,37,50,87,134
3404-001,2017,9,2,4,55,49,104,87
3404-001,2017,9,2,5,99,66,165,104
3404-001,2017,9,2,6,136,213,349,165
3404-001,2017,9,2,7,268,522,790,349
3404-001,2017,9,2,8,486,972,1458,790
3404-001,2017,9,2,9,694,876,1570,1458
3404-001,2017,9,2,10,599,717,1316,1570
3404-001,2017,9,2,11,675,776,1451,1316
3404-001,2017,9,2,12,661,761,1422,1451
3404-001,2017,9,2,13,626,708,1334,1422
3404-001,2017,9,2,14,669,745,1414,1334
3404-001,2017,9,2,15,692,725,1417,1414
3404-001,2017,9,2,16,820,694,1514,1417
3404-001,2017,9,2,17,939,595,1534,1514
3404-001,2017,9,2,18,1410,711,2121,1534
3404-001,2017,9,2,19,952,626,1578,2121
3404-001,2017,9,2,20,559,473,1032,1578
3404-001,2017,9,2,21,391,313,704,1032
3404-001,2017,9,2,22,243,202,445,704
3404-001,2017,9,2,23,155,161,316,445
3404-001,2017,9,2,24,138,115,253,316
3404-001,2017,9,3,1,91,61,152,253
3404-001,2017,9,3,2,58,57,115,152
3404-001,2017,9,3,3,48,44,92,115
3404-001,2017,9,3,4,50,47,97,92
3404-001,2017,9,3,5,50,54,104,97
3404-001,2017,9,3,6,66,116,182,104
3404-001,2017,9,3,7,126,266,392,182
3404-001,2017,9,3,8,248,353,601,392
3404-001,2017,9,3,9,309,345,654,601
3404-001,2017,9,3,10,351,368,719,654
3404-001,2017,9,3,11,403,450,853,719
3404-001,2017,9,3,12,365,503,868,853
3404-001,2017,9,3,13,422,470,892,868
3404-001,2017,9,3,14,544,459,1003,892
3404-001,2017,9,3,15,588,490,1078,1003
3404-001,2017,9,3,16,759,455,1214,1078
3404-001,2017,9,3,17,949,443,1392,1214
3404-001,2017,9,3,18,1191,472,1663,1392
3404-001,2017,9,3,19,1090,428,1518,1663
3404-001,2017,9,3,20,846,360,1206,1518
3404-001,2017,9,3,21,521,358,879,1206
3404-001,2017,9,3,22,297,272,569,879
3404-001,2017,9,3,23,147,177,324,569
3404-001,2017,9,3,24,97,148,245,324
3404-001,2017,9,4,1,53,99,152,245
3404-001,2017,9,4,2,32,45,77,152
3404-001,2017,9,4,3,24,39,63,77
3404-001,2017,9,4,4,39,41,80,63
3404-001,2017,9,4,5,81,74,155,80
3404-001,2017,9,4,6,137,291,428,155
3404-001,2017,9,4,7,379,802,1181,428
3404-001,2017,9,4,8,740,2217,2957,1181
3404-001,2017,9,4,9,888,1625,2513,2957
3404-001,2017,9,4,10,736,783,1519,2513
3404-001,2017,9,4,11,761,748,1509,1519
3404-001,2017,9,4,12,759,781,1540,1509
3404-001,2017,9,4,13,599,646,1245,1540
3404-001,2017,9,4,14,726,760,1486,1245
3404-001,2017,9,4,15,841,819,1660,1486
3404-001,2017,9,4,16,894,831,1725,1660
3404-001,2017,9,4,17,957,711,1668,1725
3404-001,2017,9,4,18,1429,824,2253,1668
3404-001,2017,9,4,19,1393,691,2084,2253
3404-001,2017,9,4,20,857,554,1411,2084
3404-001,2017,9,4,21,800,375,1175,1411
3404-001,2017,9,4,22,445,248,693,1175
3404-001,2017,9,4,23,247,147,394,693
3404-001,2017,9,4,24,124,106,230,394
3404-001,2017,9,5,1,85,94,179,230
3404-001,2017,9,5,2,41,51,92,179
3404-001,2017,9,5,3,49,34,83,92
3404-001,2017,9,5,4,52,55,107,83
3404-001,2017,9,5,5,75,78,153,107
3404-001,2017,9,5,6,130,233,363,153
3404-001,2017,9,5,7,347,762,1109,363
3404-001,2017,9,5,8,746,2061,2807,1109
3404-001,2017,9,5,9,1011,1535,2546,2807
3404-001,2017,9,5,10,844,856,1700,2546
3404-001,2017,9,5,11,812,783,1595,1700
3404-001,2017,9,5,12,802,779,1581,1595
3404-001,2017,9,5,13,679,700,1379,1581
3404-001,2017,9,5,14,684,710,1394,1379
3404-001,2017,9,5,15,915,793,1708,1394
3404-001,2017,9,5,16,903,728,1631,1708
3404-001,2017,9,5,17,1014,763,1777,1631
3404-001,2017,9,5,18,1443,742,2185,1777
3404-001,2017,9,5,19,1339,636,1975,2185
3404-001,2017,9,5,20,829,517,1346,1975
3404-001,2017,9,5,21,756,355,1111,1346
3404-001,2017,9,5,22,413,265,678,1111
3404-001,2017,9,5,23,232,164,396,678
3404-001,2017,9,5,24,132,114,246,396
3404-001,2017,9,6,1,109,80,189,246
3404-001,2017,9,6,2,60,62,122,189
3404-001,2017,9,6,3,44,48,92,122
3404-001,2017,9,6,4,54,39,93,92
3404-001,2017,9,6,5,67,73,140,93
3404-001,2017,9,6,6,128,198,326,140
3404-001,2017,9,6,7,317,709,1026,326
3404-001,2017,9,6,8,757,2038,2795,1026
3404-001,2017,9,6,9,918,1516,2434,2795
3404-001,2017,9,6,10,782,800,1582,2434
3404-001,2017,9,6,11,717,758,1475,1582
3404-001,2017,9,6,12,733,766,1499,1475
3404-001,2017,9,6,13,642,676,1318,1499
3404-001,2017,9,6,14,710,735,1445,1318
3404-001,2017,9,6,15,790,845,1635,1445
3404-001,2017,9,6,16,944,734,1678,1635
3404-001,2017,9,6,17,943,703,1646,1678
3404-001,2017,9,6,18,1640,734,2374,1646
3404-001,2017,9,6,19,1373,658,2031,2374
3404-001,2017,9,6,20,813,484,1297,2031
3404-001,2017,9,6,21,589,336,925,1297
3404-001,2017,9,6,22,412,251,663,925
3404-001,2017,9,6,23,229,154,383,663
3404-001,2017,9,6,24,112,101,213,383
3404-001,2017,9,7,1,105,96,201,213
3404-001,2017,9,7,2,62,55,117,201
3404-001,2017,9,7,3,40,42,82,117
3404-001,2017,9,7,4,48,53,101,82
3404-001,2017,9,7,5,72,60,132,101
3404-001,2017,9,7,6,155,229,384,132
3404-001,2017,9,7,7,343,730,1073,384
3404-001,2017,9,7,8,777,2040,2817,1073
3404-001,2017,9,7,9,955,1580,2535,2817
3404-001,2017,9,7,10,808,873,1681,2535
3404-001,2017,9,7,11,795,864,1659,1681
3404-001,2017,9,7,12,784,850,1634,1659
3404-001,2017,9,7,13,661,751,1412,1634
3404-001,2017,9,7,14,828,806,1634,1412
3404-001,2017,9,7,15,895,901,1796,1634
3404-001,2017,9,7,16,1012,854,1866,1796
3404-001,2017,9,7,17,992,753,1745,1866
3404-001,2017,9,7,18,1530,740,2270,1745
3404-001,2017,9,7,19,1319,668,1987,2270
3404-001,2017,9,7,20,864,547,1411,1987
3404-001,2017,9,7,21,742,403,1145,1411
3404-001,2017,9,7,22,454,309,763,1145
3404-001,2017,9,7,23,211,185,396,763
3404-001,2017,9,7,24,133,124,257,396
3404-001,2017,9,8,1,97,86,183,257
3404-001,2017,9,8,2,68,54,122,183
3404-001,2017,9,8,3,53,45,98,122
3404-001,2017,9,8,4,57,62,119,98
3404-001,2017,9,8,5,82,78,160,119
3404-001,2017,9,8,6,155,244,399,160
3404-001,2017,9,8,7,358,757,1115,399
3404-001,2017,9,8,8,792,2119,2911,1115
3404-001,2017,9,8,9,918,1519,2437,2911
3404-001,2017,9,8,10,797,861,1658,2437
3404-001,2017,9,8,11,813,828,1641,1658
3404-001,2017,9,8,12,752,794,1546,1641
3404-001,2017,9,8,13,678,749,1427,1546
3404-001,2017,9,8,14,827,820,1647,1427
3404-001,2017,9,8,15,981,807,1788,1647
3404-001,2017,9,8,16,1038,775,1813,1788
3404-001,2017,9,8,17,1077,759,1836,1813
3404-001,2017,9,8,18,1868,868,2736,1836
3404-001,2017,9,8,19,1720,868,2588,2736
3404-001,2017,9,8,20,1141,656,1797,2588
3404-001,2017,9,8,21,781,408,1189,1797
3404-001,2017,9,8,22,447,307,754,1189
3404-001,2017,9,8,23,258,179,437,754
3404-001,2017,9,8,24,153,118,271,437
3404-001,2017,9,9,1,104,97,201,271
3404-001,2017,9,9,2,88,61,149,201
3404-001,2017,9,9,3,56,62,118,149
3404-001,2017,9,9,4,59,54,113,118
3404-001,2017,9,9,5,78,90,168,113
3404-001,2017,9,9,6,170,202,372,168
3404-001,2017,9,9,7,324,497,821,372
3404-001,2017,9,9,8,584,950,1534,821
3404-001,2017,9,9,9,711,906,1617,1534
3404-001,2017,9,9,10,619,796,1415,1617
3404-001,2017,9,9,11,664,827,1491,1415
3404-001,2017,9,9,12,690,890,1580,1491
3404-001,2017,9,9,13,650,961,1611,1580
3404-001,2017,9,9,14,616,897,1513,1611
3404-001,2017,9,9,15,672,821,1493,1513
3404-001,2017,9,9,16,766,669,1435,1493
3404-001,2017,9,9,17,918,650,1568,1435
3404-001,2017,9,9,18,1230,680,1910,1568
3404-001,2017,9,9,19,934,648,1582,1910
3404-001,2017,9,9,20,539,474,1013,1582
3404-001,2017,9,9,21,361,317,678,1013
3404-001,2017,9,9,22,232,225,457,678
3404-001,2017,9,9,23,179,153,332,457
3404-001,2017,9,9,24,128,119,247,332
3404-001,2017,9,10,1,93,76,169,247
3404-001,2017,9,10,2,63,51,114,169
3404-001,2017,9,10,3,52,47,99,114
3404-001,2017,9,10,4,31,37,68,99
3404-001,2017,9,10,5,48,50,98,68
3404-001,2017,9,10,6,84,119,203,98
3404-001,2017,9,10,7,145,249,394,203
3404-001,2017,9,10,8,298,401,699,394
3404-001,2017,9,10,9,343,391,734,699
3404-001,2017,9,10,10,352,371,723,734
3404-001,2017,9,10,11,406,475,881,723
3404-001,2017,9,10,12,470,485,955,881
3404-001,2017,9,10,13,443,476,919,955
3404-001,2017,9,10,14,492,551,1043,919
3404-001,2017,9,10,15,574,581,1155,1043
3404-001,2017,9,10,16,693,557,1250,1155
3404-001,2017,9,10,17,780,508,1288,1250
3404-001,2017,9,10,18,958,524,1482,1288
3404-001,2017,9,10,19,760,464,1224,1482
3404-001,2017,9,10,20,538,368,906,1224
3404-001,2017,9,10,21,369,310,679,906
3404-001,2017,9,10,22,230,267,497,679
3404-001,2017,9,10,23,132,201,333,497
3404-001,2017,9,10,24,86,138,224,333
3404-001,2017,9,11,1,57,81,138,224
3404-001,2017,9,11,2,29,42,71,138
3404-001,2017,9,11,3,35,48,83,71
3404-001,2017,9,11,4,32,42,74,83
3404-001,2017,9,11,5,61,63,124,74
3404-001,2017,9,11,6,142,203,345,124
3404-001,2017,9,11,7,316,685,1001,345
3404-001,2017,9,11,8,777,2052,2829,1001
3404-001,2017,9,11,9,883,1598,2481,2829
3404-001,2017,9,11,10,749,820,1569,2481
3404-001,2017,9,11,11,751,775,1526,1569
3404-001,2017,9,11,12,711,695,1406,1526
3404-001,2017,9,11,13,660,709,1369,1406
3404-001,2017,9,11,14,717,759,1476,1369
3404-001,2017,9,11,15,887,817,1704,1476
3404-001,2017,9,11,16,911,772,1683,1704
3404-001,2017,9,11,17,860,718,1578,1683
3404-001,2017,9,11,18,1296,713,2009,1578
3404-001,2017,9,11,19,1306,682,1988,2009
3404-001,2017,9,11,20,785,529,1314,1988
3404-001,2017,9,11,21,756,341,1097,1314
3404-001,2017,9,11,22,455,287,742,1097
3404-001,2017,9,11,23,234,178,412,742
3404-001,2017,9,11,24,113,104,217,412
3404-001,2017,9,12,1,106,95,201,217
3404-001,2017,9,12,2,68,56,124,201
3404-001,2017,9,12,3,55,53,108,124
3404-001,2017,9,12,4,61,52,113,108
3404-001,2017,9,12,5,82,87,169,113
3404-001,2017,9,12,6,173,238,411,169
3404-001,2017,9,12,7,353,763,1116,411
3404-001,2017,9,12,8,817,2050,2867,1116
3404-001,2017,9,12,9,971,1433,2404,2867
3404-001,2017,9,12,10,830,853,1683,2404
3404-001,2017,9,12,11,851,833,1684,1683
3404-001,2017,9,12,12,827,810,1637,1684
3404-001,2017,9,12,13,702,706,1408,1637
3404-001,2017,9,12,14,851,795,1646,1408
3404-001,2017,9,12,15,919,832,1751,1646
3404-001,2017,9,12,16,949,835,1784,1751
3404-001,2017,9,12,17,933,760,1693,1784
3404-001,2017,9,12,18,1483,807,2290,1693
3404-001,2017,9,12,19,1286,731,2017,2290
3404-001,2017,9,12,20,872,555,1427,2017
3404-001,2017,9,12,21,820,392,1212,1427
3404-001,2017,9,12,22,454,341,795,1212
3404-001,2017,9,12,23,256,181,437,795
3404-001,2017,9,12,24,135,108,243,437
3404-001,2017,9,13,1,128,89,217,243
3404-001,2017,9,13,2,69,60,129,217
3404-001,2017,9,13,3,55,52,107,129
3404-001,2017,9,13,4,47,53,100,107
3404-001,2017,9,13,5,73,79,152,100
3404-001,2017,9,13,6,166,236,402,152
3404-001,2017,9,13,7,370,785,1155,402
3404-001,2017,9,13,8,792,2052,2844,1155
3404-001,2017,9,13,9,1076,1445,2521,2844
3404-001,2017,9,13,10,872,868,1740,2521
3404-001,2017,9,13,11,825,840,1665,1740
3404-001,2017,9,13,12,798,832,1630,1665
3404-001,2017,9,13,13,660,656,1316,1630
3404-001,2017,9,13,14,787,746,1533,1316
3404-001,2017,9,13,15,935,890,1825,1533
3404-001,2017,9,13,16,973,845,1818,1825
3404-001,2017,9,13,17,978,738,1716,1818
3404-001,2017,9,13,18,1670,781,2451,1716
3404-001,2017,9,13,19,1436,758,2194,2451
3404-001,2017,9,13,20,802,583,1385,2194
3404-001,2017,9,13,21,658,364,1022,1385
3404-001,2017,9,13,22,407,284,691,1022
3404-001,2017,9,13,23,257,173,430,691
3404-001,2017,9,13,24,149,119,268,430
3404-001,2017,9,14,1,119,94,213,268
3404-001,2017,9,14,2,59,50,109,213
3404-001,2017,9,14,3,49,55,104,109
3404-001,2017,9,14,4,64,58,122,104
3404-001,2017,9,14,5,94,85,179,122
3404-001,2017,9,14,6,177,254,431,179
3404-001,2017,9,14,7,338,780,1118,431
3404-001,2017,9,14,8,791,1974,2765,1118
3404-001,2017,9,14,9,1065,1472,2537,2765
3404-001,2017,9,14,10,938,896,1834,2537
3404-001,2017,9,14,11,841,843,1684,1834
3404-001,2017,9,14,12,897,786,1683,1684
3404-001,2017,9,14,13,739,673,1412,1683
3404-001,2017,9,14,14,833,796,1629,1412
3404-001,2017,9,14,15,998,823,1821,1629
3404-001,2017,9,14,16,964,881,1845,1821
3404-001,2017,9,14,17,1036,813,1849,1845
3404-001,2017,9,14,18,1473,848,2321,1849
3404-001,2017,9,14,19,1424,771,2195,2321
3404-001,2017,9,14,20,809,533,1342,2195
3404-001,2017,9,14,21,818,372,1190,1342
3404-001,2017,9,14,22,446,323,769,1190
3404-001,2017,9,14,23,239,212,451,769
3404-001,2017,9,14,24,156,116,272,451
3404-001,2017,9,15,1,107,70,177,272
3404-001,2017,9,15,2,56,61,117,177
3404-001,2017,9,15,3,47,49,96,117
3404-001,2017,9,15,4,51,58,109,96
3404-001,2017,9,15,5,76,91,167,109
3404-001,2017,9,15,6,177,251,428,167
3404-001,2017,9,15,7,381,744,1125,428
3404-001,2017,9,15,8,816,2031,2847,1125
3404-001,2017,9,15,9,1052,1545,2597,2847
3404-001,2017,9,15,10,914,923,1837,2597
3404-001,2017,9,15,11,948,876,1824,1837
3404-001,2017,9,15,12,956,871,1827,1824
3404-001,2017,9,15,13,785,740,1525,1827
3404-001,2017,9,15,14,861,843,1704,1525
3404-001,2017,9,15,15,1004,1068,2072,1704
3404-001,2017,9,15,16,1020,1078,2098,2072
3404-001,2017,9,15,17,1199,864,2063,2098
3404-001,2017,9,15,18,1814,919,2733,2063
3404-001,2017,9,15,19,1748,847,2595,2733
3404-001,2017,9,15,20,1020,679,1699,2595
3404-001,2017,9,15,21,819,466,1285,1699
3404-001,2017,9,15,22,467,344,811,1285
3404-001,2017,9,15,23,269,189,458,811
3404-001,2017,9,15,24,167,139,306,458
3404-001,2017,9,16,1,127,92,219,306
3404-001,2017,9,16,2,79,67,146,219
3404-001,2017,9,16,3,76,65,141,146
3404-001,2017,9,16,4,64,59,123,141
3404-001,2017,9,16,5,107,94,201,123
3404-001,2017,9,16,6,159,235,394,201
3404-001,2017,9,16,7,312,509,821,394
3404-001,2017,9,16,8,552,983,1535,821
3404-001,2017,9,16,9,824,937,1761,1535
3404-001,2017,9,16,10,709,852,1561,1761
3404-001,2017,9,16,11,780,802,1582,1561
3404-001,2017,9,16,12,695,816,1511,1582
3404-001,2017,9,16,13,672,735,1407,1511
3404-001,2017,9,16,14,757,799,1556,1407
3404-001,2017,9,16,15,752,726,1478,1556
3404-001,2017,9,16,16,892,742,1634,1478
3404-001,2017,9,16,17,939,655,1594,1634
3404-001,2017,9,16,18,1214,731,1945,1594
3404-001,2017,9,16,19,950,671,1621,1945
3404-001,2017,9,16,20,598,495,1093,1621
3404-001,2017,9,16,21,394,303,697,1093
3404-001,2017,9,16,22,290,266,556,697
3404-001,2017,9,16,23,163,164,327,556
3404-001,2017,9,16,24,143,122,265,327
3404-001,2017,9,17,1,92,79,171,265
3404-001,2017,9,17,2,68,50,118,171
3404-001,2017,9,17,3,49,38,87,118
3404-001,2017,9,17,4,44,41,85,87
3404-001,2017,9,17,5,61,53,114,85
3404-001,2017,9,17,6,108,127,235,114
3404-001,2017,9,17,7,175,278,453,235
3404-001,2017,9,17,8,317,455,772,453
3404-001,2017,9,17,9,437,428,865,772
3404-001,2017,9,17,10,382,436,818,865
3404-001,2017,9,17,11,462,486,948,818
3404-001,2017,9,17,12,425,528,953,948
3404-001,2017,9,17,13,531,480,1011,953
3404-001,2017,9,17,14,490,503,993,1011
3404-001,2017,9,17,15,614,604,1218,993
3404-001,2017,9,17,16,692,577,1269,1218
3404-001,2017,9,17,17,818,510,1328,1269
3404-001,2017,9,17,18,1056,520,1576,1328
3404-001,2017,9,17,19,873,504,1377,1576
3404-001,2017,9,17,20,618,462,1080,1377
3404-001,2017,9,17,21,533,388,921,1080
3404-001,2017,9,17,22,309,337,646,921
3404-001,2017,9,17,23,158,210,368,646
3404-001,2017,9,17,24,102,129,231,368
3404-001,2017,9,18,1,64,94,158,231
3404-001,2017,9,18,2,35,62,97,158
3404-001,2017,9,18,3,39,47,86,97
3404-001,2017,9,18,4,46,51,97,86
3404-001,2017,9,18,5,86,88,174,97
3404-001,2017,9,18,6,166,267,433,174
3404-001,2017,9,18,7,390,767,1157,433
3404-001,2017,9,18,8,894,2209,3103,1157
3404-001,2017,9,18,9,1011,1552,2563,3103
3404-001,2017,9,18,10,825,850,1675,2563
3404-001,2017,9,18,11,901,845,1746,1675
3404-001,2017,9,18,12,819,857,1676,1746
3404-001,2017,9,18,13,701,732,1433,1676
3404-001,2017,9,18,14,824,867,1691,1433
3404-001,2017,9,18,15,928,894,1822,1691
3404-001,2017,9,18,16,987,886,1873,1822
3404-001,2017,9,18,17,1006,792,1798,1873
3404-001,2017,9,18,18,1383,799,2182,1798
3404-001,2017,9,18,19,1308,713,2021,2182
3404-001,2017,9,18,20,864,575,1439,2021
3404-001,2017,9,18,21,792,394,1186,1439
3404-001,2017,9,18,22,436,304,740,1186
3404-001,2017,9,18,23,257,162,419,740
3404-001,2017,9,18,24,125,110,235,419
3404-001,2017,9,19,1,86,67,153,235
3404-001,2017,9,19,2,70,50,120,153
3404-001,2017,9,19,3,53,48,101,120
3404-001,2017,9,19,4,63,66,129,101
3404-001,2017,9,19,5,82,100,182,129
3404-001,2017,9,19,6,183,237,420,182
3404-001,2017,9,19,7,363,710,1073,420
3404-001,2017,9,19,8,828,2095,2923,1073
3404-001,2017,9,19,9,1069,1519,2588,2923
3404-001,2017,9,19,10,933,860,1793,2588
3404-001,2017,9,19,11,957,858,1815,1793
3404-001,2017,9,19,12,879,808,1687,1815
3404-001,2017,9,19,13,695,712,1407,1687
3404-001,2017,9,19,14,850,837,1687,1407
3404-001,2017,9,19,15,914,852,1766,1687
3404-001,2017,9,19,16,959,890,1849,1766
3404-001,2017,9,19,17,1001,773,1774,1849
3404-001,2017,9,19,18,1491,817,2308,1774
3404-001,2017,9,19,19,1282,702,1984,2308
3404-001,2017,9,19,20,847,545,1392,1984
3404-001,2017,9,19,21,810,453,1263,1392
3404-001,2017,9,19,22,428,298,726,1263
3404-001,2017,9,19,23,241,190,431,726
3404-001,2017,9,19,24,148,117,265,431
3404-001,2017,9,20,1,108,95,203,265
3404-001,2017,9,20,2,55,50,105,203
3404-001,2017,9,20,3,51,42,93,105
3404-001,2017,9,20,4,58,57,115,93
3404-001,2017,9,20,5,85,99,184,115
3404-001,2017,9,20,6,164,288,452,184
3404-001,2017,9,20,7,417,743,1160,452
3404-001,2017,9,20,8,832,2056,2888,1160
3404-001,2017,9,20,9,1108,1546,2654,2888
3404-001,2017,9,20,10,879,890,1769,2654
3404-001,2017,9,20,11,928,937,1865,1769
3404-001,2017,9,20,12,864,890,1754,1865
3404-001,2017,9,20,13,766,753,1519,1754
3404-001,2017,9,20,14,873,856,1729,1519
3404-001,2017,9,20,15,1010,941,1951,1729
3404-001,2017,9,20,16,993,917,1910,1951
3404-001,2017,9,20,17,1029,821,1850,1910
3404-001,2017,9,20,18,1662,857,2519,1850
3404-001,2017,9,20,19,1399,695,2094,2519
3404-001,2017,9,20,20,907,560,1467,2094
3404-001,2017,9,20,21,656,374,1030,1467
3404-001,2017,9,20,22,415,317,732,1030
3404-001,2017,9,20,23,226,170,396,732
3404-001,2017,9,20,24,164,122,286,396
3404-001,2017,9,21,1,0,0,0,286
3404-001,2017,9,21,2,0,0,0,0
3404-001,2017,9,21,3,0,0,0,0
3404-001,2017,9,21,4,50,59,109,0
3404-001,2017,9,21,5,0,0,0,109
3404-001,2017,9,21,6,158,227,385,0
3404-001,2017,9,21,7,388,782,1170,385
3404-001,2017,9,21,8,853,2036,2889,1170
3404-001,2017,9,21,9,1067,1526,2593,2889
3404-001,2017,9,21,10,973,890,1863,2593
3404-001,2017,9,21,11,882,881,1763,1863
3404-001,2017,9,21,12,948,817,1765,1763
3404-001,2017,9,21,13,768,710,1478,1765
3404-001,2017,9,21,14,833,854,1687,1478
3404-001,2017,9,21,15,939,854,1793,1687
3404-001,2017,9,21,16,1034,910,1944,1793
3404-001,2017,9,21,17,1051,905,1956,1944
3404-001,2017,9,21,18,1468,805,2273,1956
3404-001,2017,9,21,19,1353,730,2083,2273
3404-001,2017,9,21,20,836,585,1421,2083
3404-001,2017,9,21,21,760,421,1181,1421
3404-001,2017,9,21,22,473,303,776,1181
3404-001,2017,9,21,23,259,194,453,776
3404-001,2017,9,21,24,149,124,273,453
3404-001,2017,9,22,1,106,103,209,273
3404-001,2017,9,22,2,58,67,125,209
3404-001,2017,9,22,3,49,54,103,125
3404-001,2017,9,22,4,52,60,112,103
3404-001,2017,9,22,5,101,95,196,112
3404-001,2017,9,22,6,183,291,474,196
3404-001,2017,9,22,7,385,756,1141,474
3404-001,2017,9,22,8,855,1991,2846,1141
3404-001,2017,9,22,9,1101,1525,2626,2846
3404-001,2017,9,22,10,939,945,1884,2626
3404-001,2017,9,22,11,958,925,1883,1884
3404-001,2017,9,22,12,874,838,1712,1883
3404-001,2017,9,22,13,780,735,1515,1712
3404-001,2017,9,22,14,928,854,1782,1515
3404-001,2017,9,22,15,972,937,1909,1782
3404-001,2017,9,22,16,1049,842,1891,1909
3404-001,2017,9,22,17,1081,850,1931,1891
3404-001,2017,9,22,18,1743,905,2648,1931
3404-001,2017,9,22,19,1676,859,2535,2648
3404-001,2017,9,22,20,1048,633,1681,2535
3404-001,2017,9,22,21,795,500,1295,1681
3404-001,2017,9,22,22,455,335,790,1295
3404-001,2017,9,22,23,246,212,458,790
3404-001,2017,9,22,24,171,136,307,458
3404-001,2017,9,23,1,114,94,208,307
3404-001,2017,9,23,2,88,68,156,208
3404-001,2017,9,23,3,61,55,116,156
3404-001,2017,9,23,4,55,61,116,116
3404-001,2017,9,23,5,103,95,198,116
3404-001,2017,9,23,6,183,232,415,198
3404-001,2017,9,23,7,321,553,874,415
3404-001,2017,9,23,8,620,1020,1640,874
3404-001,2017,9,23,9,869,987,1856,1640
3404-001,2017,9,23,10,707,778,1485,1856
3404-001,2017,9,23,11,760,847,1607,1485
3404-001,2017,9,23,12,740,754,1494,1607
3404-001,2017,9,23,13,724,704,1428,1494
3404-001,2017,9,23,14,671,696,1367,1428
3404-001,2017,9,23,15,693,738,1431,1367
3404-001,2017,9,23,16,817,687,1504,1431
3404-001,2017,9,23,17,985,616,1601,1504
3404-001,2017,9,23,18,1393,765,2158,1601
3404-001,2017,9,23,19,985,674,1659,2158
3404-001,2017,9,23,20,574,569,1143,1659
3404-001,2017,9,23,21,402,341,743,1143
3404-001,2017,9,23,22,273,233,506,743
3404-001,2017,9,23,23,163,180,343,506
3404-001,2017,9,23,24,142,114,256,343
3404-001,2017,9,24,1,93,80,173,256
3404-001,2017,9,24,2,64,53,117,173
3404-001,2017,9,24,3,54,35,89,117
3404-001,2017,9,24,4,44,53,97,89
3404-001,2017,9,24,5,61,63,124,97
3404-001,2017,9,24,6,109,128,237,124
3404-001,2017,9,24,7,194,265,459,237
3404-001,2017,9,24,8,288,509,797,459
3404-001,2017,9,24,9,408,455,863,797
3404-001,2017,9,24,10,428,403,831,863
3404-001,2017,9,24,11,479,492,971,831
3404-001,2017,9,24,12,429,491,920,971
3404-001,2017,9,24,13,447,504,951,920
3404-001,2017,9,24,14,488,561,1049,951
3404-001,2017,9,24,15,637,587,1224,1049
3404-001,2017,9,24,16,703,559,1262,1224
3404-001,2017,9,24,17,795,509,1304,1262
3404-001,2017,9,24,18,980,571,1551,1304
3404-001,2017,9,24,19,703,489,1192,1551
3404-001,2017,9,24,20,440,372,812,1192
3404-001,2017,9,24,21,355,333,688,812
3404-001,2017,9,24,22,251,281,532,688
3404-001,2017,9,24,23,147,190,337,532
3404-001,2017,9,24,24,108,142,250,337
3404-001,2017,9,25,1,52,73,125,250
3404-001,2017,9,25,2,43,38,81,125
3404-001,2017,9,25,3,39,43,82,81
3404-001,2017,9,25,4,41,38,79,82
3404-001,2017,9,25,5,83,96,179,79
3404-001,2017,9,25,6,191,283,474,179
3404-001,2017,9,25,7,399,840,1239,474
3404-001,2017,9,25,8,895,2165,3060,1239
3404-001,2017,9,25,9,1050,1602,2652,3060
3404-001,2017,9,25,10,883,929,1812,2652
3404-001,2017,9,25,11,880,906,1786,1812
3404-001,2017,9,25,12,915,874,1789,1786
3404-001,2017,9,25,13,832,753,1585,1789
3404-001,2017,9,25,14,872,854,1726,1585
3404-001,2017,9,25,15,956,896,1852,1726
3404-001,2017,9,25,16,971,986,1957,1852
3404-001,2017,9,25,17,1041,995,2036,1957
3404-001,2017,9,25,18,1566,840,2406,2036
3404-001,2017,9,25,19,1374,754,2128,2406
3404-001,2017,9,25,20,871,586,1457,2128
3404-001,2017,9,25,21,778,430,1208,1457
3404-001,2017,9,25,22,497,338,835,1208
3404-001,2017,9,25,23,242,178,420,835
3404-001,2017,9,25,24,164,109,273,420
3404-001,2017,9,26,1,95,82,177,273
3404-001,2017,9,26,2,75,55,130,177
3404-001,2017,9,26,3,39,37,76,130
3404-001,2017,9,26,4,64,51,115,76
3404-001,2017,9,26,5,95,92,187,115
3404-001,2017,9,26,6,156,242,398,187
3404-001,2017,9,26,7,402,779,1181,398
3404-001,2017,9,26,8,825,2067,2892,1181
3404-001,2017,9,26,9,1098,1476,2574,2892
3404-001,2017,9,26,10,932,888,1820,2574
3404-001,2017,9,26,11,960,878,1838,1820
3404-001,2017,9,26,12,889,835,1724,1838
3404-001,2017,9,26,13,786,736,1522,1724
3404-001,2017,9,26,14,884,860,1744,1522
3404-001,2017,9,26,15,1092,942,2034,1744
3404-001,2017,9,26,16,1063,886,1949,2034
3404-001,2017,9,26,17,1022,836,1858,1949
3404-001,2017,9,26,18,1503,849,2352,1858
3404-001,2017,9,26,19,1451,738,2189,2352
3404-001,2017,9,26,20,914,571,1485,2189
3404-001,2017,9,26,21,819,422,1241,1485
3404-001,2017,9,26,22,467,322,789,1241
3404-001,2017,9,26,23,271,186,457,789
3404-001,2017,9,26,24,157,146,303,457
3404-001,2017,9,27,1,124,88,212,303
3404-001,2017,9,27,2,62,62,124,212
3404-001,2017,9,27,3,45,51,96,124
3404-001,2017,9,27,4,57,53,110,96
3404-001,2017,9,27,5,83,95,178,110
3404-001,2017,9,27,6,137,218,355,178
3404-001,2017,9,27,7,376,665,1041,355
3404-001,2017,9,27,8,777,1990,2767,1041
3404-001,2017,9,27,9,1036,1459,2495,2767
3404-001,2017,9,27,10,894,878,1772,2495
3404-001,2017,9,27,11,950,911,1861,1772
3404-001,2017,9,27,12,840,835,1675,1861
3404-001,2017,9,27,13,743,690,1433,1675
3404-001,2017,9,27,14,857,855,1712,1433
3404-001,2017,9,27,15,960,895,1855,1712
3404-001,2017,9,27,16,1023,861,1884,1855
3404-001,2017,9,27,17,995,879,1874,1884
3404-001,2017,9,27,18,1657,820,2477,1874
3404-001,2017,9,27,19,1448,724,2172,2477
3404-001,2017,9,27,20,841,584,1425,2172
3404-001,2017,9,27,21,660,396,1056,1425
3404-001,2017,9,27,22,410,338,748,1056
3404-001,2017,9,27,23,249,175,424,748
3404-001,2017,9,27,24,182,132,314,424
3404-001,2017,9,28,1,128,95,223,314
3404-001,2017,9,28,2,75,52,127,223
3404-001,2017,9,28,3,44,35,79,127
3404-001,2017,9,28,4,59,51,110,79
3404-001,2017,9,28,5,87,109,196,110
3404-001,2017,9,28,6,154,248,402,196
3404-001,2017,9,28,7,391,739,1130,402
3404-001,2017,9,28,8,812,2042,2854,1130
3404-001,2017,9,28,9,1104,1493,2597,2854
3404-001,2017,9,28,10,903,921,1824,2597
3404-001,2017,9,28,11,897,917,1814,1824
3404-001,2017,9,28,12,864,819,1683,1814
3404-001,2017,9,28,13,817,770,1587,1683
3404-001,2017,9,28,14,937,747,1684,1587
3404-001,2017,9,28,15,990,909,1899,1684
3404-001,2017,9,28,16,1042,914,1956,1899
3404-001,2017,9,28,17,1004,891,1895,1956
3404-001,2017,9,28,18,1489,902,2391,1895
3404-001,2017,9,28,19,1442,731,2173,2391
3404-001,2017,9,28,20,925,593,1518,2173
3404-001,2017,9,28,21,825,416,1241,1518
3404-001,2017,9,28,22,481,331,812,1241
3404-001,2017,9,28,23,263,210,473,812
3404-001,2017,9,28,24,163,138,301,473
3404-001,2017,9,29,1,129,102,231,301
3404-001,2017,9,29,2,68,80,148,231
3404-001,2017,9,29,3,44,59,103,148
3404-001,2017,9,29,4,56,73,129,103
3404-001,2017,9,29,5,71,111,182,129
3404-001,2017,9,29,6,166,242,408,182
3404-001,2017,9,29,7,360,802,1162,408
3404-001,2017,9,29,8,818,2069,2887,1162
3404-001,2017,9,29,9,1050,1507,2557,2887
3404-001,2017,9,29,10,873,914,1787,2557
3404-001,2017,9,29,11,909,865,1774,1787
3404-001,2017,9,29,12,973,794,1767,1774
3404-001,2017,9,29,13,798,759,1557,1767
3404-001,2017,9,29,14,905,810,1715,1557
3404-001,2017,9,29,15,993,984,1977,1715
3404-001,2017,9,29,16,1132,946,2078,1977
3404-001,2017,9,29,17,1143,876,2019,2078
3404-001,2017,9,29,18,1834,927,2761,2019
3404-001,2017,9,29,19,1652,841,2493,2761
3404-001,2017,9,29,20,1001,653,1654,2493
3404-001,2017,9,29,21,712,413,1125,1654
3404-001,2017,9,29,22,397,336,733,1125
3404-001,2017,9,29,23,280,194,474,733
3404-001,2017,9,29,24,161,118,279,474
3404-001,2017,9,30,1,125,112,237,279
3404-001,2017,9,30,2,67,77,144,237
3404-001,2017,9,30,3,63,77,140,144
3404-001,2017,9,30,4,63,66,129,140
3404-001,2017,9,30,5,118,100,218,129
3404-001,2017,9,30,6,175,202,377,218
3404-001,2017,9,30,7,283,499,782,377
3404-001,2017,9,30,8,508,1024,1532,782
3404-001,2017,9,30,9,741,889,1630,1532
3404-001,2017,9,30,10,732,715,1447,1630
3404-001,2017,9,30,11,778,789,1567,1447
3404-001,2017,9,30,12,731,805,1536,1567
3404-001,2017,9,30,13,683,688,1371,1536
3404-001,2017,9,30,14,688,706,1394,1371
3404-001,2017,9,30,15,738,682,1420,1394
3404-001,2017,9,30,16,847,661,1508,1420
3404-001,2017,9,30,17,900,620,1520,1508
3404-001,2017,9,30,18,1124,650,1774,1520
3404-001,2017,9,30,19,763,593,1356,1774
3404-001,2017,9,30,20,446,392,838,1356
3404-001,2017,9,30,21,355,261,616,838
3404-001,2017,9,30,22,238,203,441,616
3404-001,2017,9,30,23,153,144,297,441
3404-001,2017,9,30,24,120,100,220,297
3404-001,2017,10,1,1,71,65,136,220
3404-001,2017,10,1,2,58,46,104,136
3404-001,2017,10,1,3,54,38,92,104
3404-001,2017,10,1,4,54,54,108,92
3404-001,2017,10,1,5,47,51,98,108
3404-001,2017,10,1,6,95,129,224,98
3404-001,2017,10,1,7,188,282,470,224
3404-001,2017,10,1,8,314,530,844,470
3404-001,2017,10,1,9,414,479,893,844
3404-001,2017,10,1,10,441,382,823,893
3404-001,2017,10,1,11,452,434,886,823
3404-001,2017,10,1,12,478,498,976,886
3404-001,2017,10,1,13,511,434,945,976
3404-001,2017,10,1,14,498,499,997,945
3404-001,2017,10,1,15,580,448,1028,997
3404-001,2017,10,1,16,525,459,984,1028
3404-001,2017,10,1,17,557,433,990,984
3404-001,2017,10,1,18,638,437,1075,990
3404-001,2017,10,1,19,472,373,845,1075
3404-001,2017,10,1,20,293,305,598,845
3404-001,2017,10,1,21,242,208,450,598
3404-001,2017,10,1,22,157,161,318,450
3404-001,2017,10,1,23,107,116,223,318
3404-001,2017,10,1,24,78,61,139,223
3404-001,2017,10,2,1,59,64,123,139
3404-001,2017,10,2,2,37,41,78,123
3404-001,2017,10,2,3,41,33,74,78
3404-001,2017,10,2,4,31,35,66,74
3404-001,2017,10,2,5,56,69,125,66
3404-001,2017,10,2,6,86,137,223,125
3404-001,2017,10,2,7,167,337,504,223
3404-001,2017,10,2,8,367,759,1126,504
3404-001,2017,10,2,9,510,686,1196,1126
3404-001,2017,10,2,10,552,601,1153,1196
3404-001,2017,10,2,11,571,603,1174,1153
3404-001,2017,10,2,12,629,608,1237,1174
3404-001,2017,10,2,13,585,636,1221,1237
3404-001,2017,10,2,14,620,606,1226,1221
3404-001,2017,10,2,15,641,624,1265,1226
3404-001,2017,10,2,16,700,622,1322,1265
3404-001,2017,10,2,17,708,648,1356,1322
3404-001,2017,10,2,18,799,617,1416,1356
3404-001,2017,10,2,19,596,518,1114,1416
3404-001,2017,10,2,20,354,378,732,1114
3404-001,2017,10,2,21,307,274,581,732
3404-001,2017,10,2,22,187,179,366,581
3404-001,2017,10,2,23,118,155,273,366
3404-001,2017,10,2,24,101,103,204,273
3404-001,2017,10,3,1,69,76,145,204
3404-001,2017,10,3,2,50,46,96,145
3404-001,2017,10,3,3,46,33,79,96
3404-001,2017,10,3,4,47,32,79,79
3404-001,2017,10,3,5,80,42,122,79
3404-001,2017,10,3,6,84,89,173,122
3404-001,2017,10,3,7,139,144,283,173
3404-001,2017,10,3,8,205,286,491,283
3404-001,2017,10,3,9,251,350,601,491
3404-001,2017,10,3,10,316,443,759,601
3404-001,2017,10,3,11,372,631,1003,759
3404-001,2017,10,3,12,345,715,1060,1003
3404-001,2017,10,3,13,317,900,1217,1060
3404-001,2017,10,3,14,306,621,927,1217
3404-001,2017,10,3,15,327,479,806,927
3404-001,2017,10,3,16,361,421,782,806
3404-001,2017,10,3,17,383,384,767,782
3404-001,2017,10,3,18,380,317,697,767
3404-001,2017,10,3,19,297,275,572,697
3404-001,2017,10,3,20,211,177,388,572
3404-001,2017,10,3,21,159,192,351,388
3404-001,2017,10,3,22,109,123,232,351
3404-001,2017,10,3,23,89,70,159,232
3404-001,2017,10,3,24,60,59,119,159
3404-001,2017,10,4,1,49,39,88,119
3404-001,2017,10,4,2,23,34,57,88
3404-001,2017,10,4,3,22,22,44,57
3404-001,2017,10,4,4,13,20,33,44
3404-001,2017,10,4,5,29,18,47,33
3404-001,2017,10,4,6,67,50,117,47
3404-001,2017,10,4,7,136,148,284,117
3404-001,2017,10,4,8,219,283,502,284
3404-001,2017,10,4,9,233,250,483,502
3404-001,2017,10,4,10,277,331,608,483
3404-001,2017,10,4,11,450,591,1041,608
3404-001,2017,10,4,12,658,698,1356,1041
3404-001,2017,10,4,13,716,702,1418,1356
3404-001,2017,10,4,14,904,816,1720,1418
3404-001,2017,10,4,15,832,801,1633,1720
3404-001,2017,10,4,16,933,752,1685,1633
3404-001,2017,10,4,17,722,662,1384,1685
3404-001,2017,10,4,18,737,609,1346,1384
3404-001,2017,10,4,19,531,678,1209,1346
3404-001,2017,10,4,20,458,490,948,1209
3404-001,2017,10,4,21,351,259,610,948
3404-001,2017,10,4,22,256,233,489,610
3404-001,2017,10,4,23,151,142,293,489
3404-001,2017,10,4,24,103,118,221,293
3404-001,2017,10,5,1,65,72,137,221
3404-001,2017,10,5,2,49,47,96,137
3404-001,2017,10,5,3,20,36,56,96
3404-001,2017,10,5,4,24,36,60,56
3404-001,2017,10,5,5,38,44,82,60
3404-001,2017,10,5,6,50,57,107,82
3404-001,2017,10,5,7,77,123,200,107
3404-001,2017,10,5,8,144,207,351,200
3404-001,2017,10,5,9,209,279,488,351
3404-001,2017,10,5,10,282,430,712,488
3404-001,2017,10,5,11,411,614,1025,712
3404-001,2017,10,5,12,444,658,1102,1025
3404-001,2017,10,5,13,452,635,1087,1102
3404-001,2017,10,5,14,448,557,1005,1087
3404-001,2017,10,5,15,554,474,1028,1005
3404-001,2017,10,5,16,634,433,1067,1028
3404-001,2017,10,5,17,638,467,1105,1067
3404-001,2017,10,5,18,814,386,1200,1105
3404-001,2017,10,5,19,502,393,895,1200
3404-001,2017,10,5,20,547,319,866,895
3404-001,2017,10,5,21,392,318,710,866
3404-001,2017,10,5,22,449,236,685,710
3404-001,2017,10,5,23,470,192,662,685
3404-001,2017,10,5,24,399,115,514,662
3404-001,2017,10,6,1,126,163,289,514
3404-001,2017,10,6,2,67,74,141,289
3404-001,2017,10,6,3,44,60,104,141
3404-001,2017,10,6,4,36,41,77,104
3404-001,2017,10,6,5,48,32,80,77
3404-001,2017,10,6,6,55,75,130,80
3404-001,2017,10,6,7,92,150,242,130
3404-001,2017,10,6,8,209,362,571,242
3404-001,2017,10,6,9,288,294,582,571
3404-001,2017,10,6,10,326,400,726,582
3404-001,2017,10,6,11,439,505,944,726
3404-001,2017,10,6,12,486,558,1044,944
3404-001,2017,10,6,13,415,551,966,1044
3404-001,2017,10,6,14,483,498,981,966
3404-001,2017,10,6,15,520,484,1004,981
3404-001,2017,10,6,16,590,440,1030,1004
3404-001,2017,10,6,17,656,460,1116,1030
3404-001,2017,10,6,18,638,418,1056,1116
3404-001,2017,10,6,19,605,405,1010,1056
3404-001,2017,10,6,20,506,303,809,1010
3404-001,2017,10,6,21,392,257,649,809
3404-001,2017,10,6,22,327,174,501,649
3404-001,2017,10,6,23,333,149,482,501
3404-001,2017,10,6,24,112,161,273,482
3404-001,2017,10,7,1,77,69,146,273
3404-001,2017,10,7,2,61,47,108,146
3404-001,2017,10,7,3,38,49,87,108
3404-001,2017,10,7,4,32,41,73,87
3404-001,2017,10,7,5,64,57,121,73
3404-001,2017,10,7,6,67,107,174,121
3404-001,2017,10,7,7,123,284,407,174
3404-001,2017,10,7,8,274,507,781,407
3404-001,2017,10,7,9,390,472,862,781
3404-001,2017,10,7,10,383,466,849,862
3404-001,2017,10,7,11,418,580,998,849
3404-001,2017,10,7,12,483,643,1126,998
3404-001,2017,10,7,13,545,573,1118,1126
3404-001,2017,10,7,14,535,538,1073,1118
3404-001,2017,10,7,15,612,541,1153,1073
3404-001,2017,10,7,16,680,488,1168,1153
3404-001,2017,10,7,17,739,470,1209,1168
3404-001,2017,10,7,18,867,527,1394,1209
3404-001,2017,10,7,19,622,435,1057,1394
3404-001,2017,10,7,20,467,338,805,1057
3404-001,2017,10,7,21,339,240,579,805
3404-001,2017,10,7,22,266,183,449,579
3404-001,2017,10,7,23,143,121,264,449
3404-001,2017,10,7,24,101,107,208,264
3404-001,2017,10,8,1,97,77,174,208
3404-001,2017,10,8,2,48,50,98,174
3404-001,2017,10,8,3,41,38,79,98
3404-001,2017,10,8,4,35,37,72,79
3404-001,2017,10,8,5,62,38,100,72
3404-001,2017,10,8,6,51,97,148,100
3404-001,2017,10,8,7,130,244,374,148
3404-001,2017,10,8,8,220,388,608,374
3404-001,2017,10,8,9,285,365,650,608
3404-001,2017,10,8,10,291,366,657,650
3404-001,2017,10,8,11,355,457,812,657
3404-001,2017,10,8,12,410,513,923,812
3404-001,2017,10,8,13,470,452,922,923
3404-001,2017,10,8,14,486,502,988,922
3404-001,2017,10,8,15,519,540,1059,988
3404-001,2017,10,8,16,649,461,1110,1059
3404-001,2017,10,8,17,714,472,1186,1110
3404-001,2017,10,8,18,786,450,1236,1186
3404-001,2017,10,8,19,652,464,1116,1236
3404-001,2017,10,8,20,458,335,793,1116
3404-001,2017,10,8,21,348,261,609,793
3404-001,2017,10,8,22,212,236,448,609
3404-001,2017,10,8,23,168,180,348,448
3404-001,2017,10,8,24,97,118,215,348
3404-001,2017,10,9,1,53,83,136,215
3404-001,2017,10,9,2,47,50,97,136
3404-001,2017,10,9,3,29,40,69,97
3404-001,2017,10,9,4,46,39,85,69
3404-001,2017,10,9,5,69,60,129,85
3404-001,2017,10,9,6,114,158,272,129
3404-001,2017,10,9,7,239,473,712,272
3404-001,2017,10,9,8,431,959,1390,712
3404-001,2017,10,9,9,518,707,1225,1390
3404-001,2017,10,9,10,450,556,1006,1225
3404-001,2017,10,9,11,520,596,1116,1006
3404-001,2017,10,9,12,520,576,1096,1116
3404-001,2017,10,9,13,524,507,1031,1096
3404-001,2017,10,9,14,562,581,1143,1031
3404-001,2017,10,9,15,592,618,1210,1143
3404-001,2017,10,9,16,660,611,1271,1210
3404-001,2017,10,9,17,780,552,1332,1271
3404-001,2017,10,9,18,1059,546,1605,1332
3404-001,2017,10,9,19,797,506,1303,1605
3404-001,2017,10,9,20,444,412,856,1303
3404-001,2017,10,9,21,376,338,714,856
3404-001,2017,10,9,22,217,208,425,714
3404-001,2017,10,9,23,147,163,310,425
3404-001,2017,10,9,24,103,81,184,310
3404-001,2017,10,10,1,72,85,157,184
3404-001,2017,10,10,2,25,45,70,157
3404-001,2017,10,10,3,30,40,70,70
3404-001,2017,10,10,4,47,41,88,70
3404-001,2017,10,10,5,72,78,150,88
3404-001,2017,10,10,6,163,240,403,150
3404-001,2017,10,10,7,341,780,1121,403
3404-001,2017,10,10,8,800,2132,2932,1121
3404-001,2017,10,10,9,1014,1548,2562,2932
3404-001,2017,10,10,10,836,834,1670,2562
3404-001,2017,10,10,11,813,800,1613,1670
3404-001,2017,10,10,12,789,777,1566,1613
3404-001,2017,10,10,13,716,655,1371,1566
3404-001,2017,10,10,14,744,804,1548,1371
3404-001,2017,10,10,15,937,872,1809,1548
3404-001,2017,10,10,16,964,830,1794,1809
3404-001,2017,10,10,17,912,803,1715,1794
3404-001,2017,10,10,18,1391,771,2162,1715
3404-001,2017,10,10,19,1418,712,2130,2162
3404-001,2017,10,10,20,815,474,1289,2130
3404-001,2017,10,10,21,746,358,1104,1289
3404-001,2017,10,10,22,363,273,636,1104
3404-001,2017,10,10,23,237,169,406,636
3404-001,2017,10,10,24,123,129,252,406
3404-001,2017,10,11,1,93,85,178,252
3404-001,2017,10,11,2,78,51,129,178
3404-001,2017,10,11,3,47,33,80,129
3404-001,2017,10,11,4,50,57,107,80
3404-001,2017,10,11,5,86,90,176,107
3404-001,2017,10,11,6,121,208,329,176
3404-001,2017,10,11,7,325,627,952,329
3404-001,2017,10,11,8,710,1854,2564,952
3404-001,2017,10,11,9,1059,1530,2589,2564
3404-001,2017,10,11,10,841,882,1723,2589
3404-001,2017,10,11,11,814,838,1652,1723
3404-001,2017,10,11,12,802,794,1596,1652
3404-001,2017,10,11,13,690,638,1328,1596
3404-001,2017,10,11,14,778,730,1508,1328
3404-001,2017,10,11,15,895,862,1757,1508
3404-001,2017,10,11,16,914,859,1773,1757
3404-001,2017,10,11,17,902,768,1670,1773
3404-001,2017,10,11,18,1506,704,2210,1670
3404-001,2017,10,11,19,1288,637,1925,2210
3404-001,2017,10,11,20,797,530,1327,1925
3404-001,2017,10,11,21,637,356,993,1327
3404-001,2017,10,11,22,366,280,646,993
3404-001,2017,10,11,23,213,162,375,646
3404-001,2017,10,11,24,167,124,291,375
3404-001,2017,10,12,1,101,87,188,291
3404-001,2017,10,12,2,51,61,112,188
3404-001,2017,10,12,3,39,42,81,112
3404-001,2017,10,12,4,52,59,111,81
3404-001,2017,10,12,5,79,82,161,111
3404-001,2017,10,12,6,181,224,405,161
3404-001,2017,10,12,7,343,681,1024,405
3404-001,2017,10,12,8,777,1987,2764,1024
3404-001,2017,10,12,9,1082,1432,2514,2764
3404-001,2017,10,12,10,900,895,1795,2514
3404-001,2017,10,12,11,827,884,1711,1795
3404-001,2017,10,12,12,834,772,1606,1711
3404-001,2017,10,12,13,726,684,1410,1606
3404-001,2017,10,12,14,825,774,1599,1410
3404-001,2017,10,12,15,888,911,1799,1599
3404-001,2017,10,12,16,908,839,1747,1799
3404-001,2017,10,12,17,955,798,1753,1747
3404-001,2017,10,12,18,1400,800,2200,1753
3404-001,2017,10,12,19,1257,715,1972,2200
3404-001,2017,10,12,20,844,513,1357,1972
3404-001,2017,10,12,21,793,404,1197,1357
3404-001,2017,10,12,22,428,281,709,1197
3404-001,2017,10,12,23,242,173,415,709
3404-001,2017,10,12,24,146,104,250,415
3404-001,2017,10,13,1,107,77,184,250
3404-001,2017,10,13,2,71,64,135,184
3404-001,2017,10,13,3,59,47,106,135
3404-001,2017,10,13,4,49,59,108,106
3404-001,2017,10,13,5,68,98,166,108
3404-001,2017,10,13,6,182,195,377,166
3404-001,2017,10,13,7,369,690,1059,377
3404-001,2017,10,13,8,796,2033,2829,1059
3404-001,2017,10,13,9,1035,1519,2554,2829
3404-001,2017,10,13,10,920,917,1837,2554
3404-001,2017,10,13,11,879,870,1749,1837
3404-001,2017,10,13,12,932,862,1794,1749
3404-001,2017,10,13,13,810,740,1550,1794
3404-001,2017,10,13,14,857,847,1704,1550
3404-001,2017,10,13,15,921,913,1834,1704
3404-001,2017,10,13,16,980,924,1904,1834
3404-001,2017,10,13,17,1066,901,1967,1904
3404-001,2017,10,13,18,1689,824,2513,1967
3404-001,2017,10,13,19,1663,829,2492,2513
3404-001,2017,10,13,20,1021,624,1645,2492
3404-001,2017,10,13,21,762,445,1207,1645
3404-001,2017,10,13,22,409,289,698,1207
3404-001,2017,10,13,23,231,175,406,698
3404-001,2017,10,13,24,129,131,260,406
3404-001,2017,10,14,1,133,89,222,260
3404-001,2017,10,14,2,57,59,116,222
3404-001,2017,10,14,3,56,53,109,116
3404-001,2017,10,14,4,61,63,124,109
3404-001,2017,10,14,5,85,71,156,124
3404-001,2017,10,14,6,135,198,333,156
3404-001,2017,10,14,7,270,508,778,333
3404-001,2017,10,14,8,610,903,1513,778
3404-001,2017,10,14,9,925,904,1829,1513
3404-001,2017,10,14,10,679,723,1402,1829
3404-001,2017,10,14,11,705,815,1520,1402
3404-001,2017,10,14,12,688,728,1416,1520
3404-001,2017,10,14,13,658,613,1271,1416
3404-001,2017,10,14,14,710,652,1362,1271
3404-001,2017,10,14,15,756,729,1485,1362
3404-001,2017,10,14,16,865,646,1511,1485
3404-001,2017,10,14,17,895,622,1517,1511
3404-001,2017,10,14,18,1250,764,2014,1517
3404-001,2017,10,14,19,833,675,1508,2014
3404-001,2017,10,14,20,438,395,833,1508
3404-001,2017,10,14,21,347,273,620,833
3404-001,2017,10,14,22,220,216,436,620
3404-001,2017,10,14,23,160,152,312,436
3404-001,2017,10,14,24,115,97,212,312
3404-001,2017,10,15,1,84,83,167,212
3404-001,2017,10,15,2,73,52,125,167
3404-001,2017,10,15,3,36,41,77,125
3404-001,2017,10,15,4,34,44,78,77
3404-001,2017,10,15,5,50,56,106,78
3404-001,2017,10,15,6,85,103,188,106
3404-001,2017,10,15,7,158,240,398,188
3404-001,2017,10,15,8,240,359,599,398
3404-001,2017,10,15,9,328,402,730,599
3404-001,2017,10,15,10,335,406,741,730
3404-001,2017,10,15,11,419,439,858,741
3404-001,2017,10,15,12,416,462,878,858
3404-001,2017,10,15,13,454,472,926,878
3404-001,2017,10,15,14,466,501,967,926
3404-001,2017,10,15,15,575,478,1053,967
3404-001,2017,10,15,16,636,532,1168,1053
3404-001,2017,10,15,17,726,509,1235,1168
3404-001,2017,10,15,18,825,545,1370,1235
3404-001,2017,10,15,19,625,465,1090,1370
3404-001,2017,10,15,20,470,325,795,1090
3404-001,2017,10,15,21,293,297,590,795
3404-001,2017,10,15,22,206,287,493,590
3404-001,2017,10,15,23,128,193,321,493
3404-001,2017,10,15,24,113,101,214,321
3404-001,2017,10,16,1,51,78,129,214
3404-001,2017,10,16,2,39,51,90,129
3404-001,2017,10,16,3,31,36,67,90
3404-001,2017,10,16,4,40,43,83,67
3404-001,2017,10,16,5,72,83,155,83
3404-001,2017,10,16,6,157,249,406,155
3404-001,2017,10,16,7,405,762,1167,406
3404-001,2017,10,16,8,832,2239,3071,1167
3404-001,2017,10,16,9,1037,1554,2591,3071
3404-001,2017,10,16,10,846,898,1744,2591
3404-001,2017,10,16,11,870,863,1733,1744
3404-001,2017,10,16,12,837,778,1615,1733
3404-001,2017,10,16,13,823,742,1565,1615
3404-001,2017,10,16,14,770,809,1579,1565
3404-001,2017,10,16,15,989,834,1823,1579
3404-001,2017,10,16,16,930,884,1814,1823
3404-001,2017,10,16,17,1021,842,1863,1814
3404-001,2017,10,16,18,1388,821,2209,1863
3404-001,2017,10,16,19,1361,709,2070,2209
3404-001,2017,10,16,20,851,544,1395,2070
3404-001,2017,10,16,21,806,342,1148,1395
3404-001,2017,10,16,22,440,273,713,1148
3404-001,2017,10,16,23,264,199,463,713
3404-001,2017,10,16,24,138,106,244,463
3404-001,2017,10,17,1,107,83,190,244
3404-001,2017,10,17,2,62,44,106,190
3404-001,2017,10,17,3,42,49,91,106
3404-001,2017,10,17,4,59,51,110,91
3404-001,2017,10,17,5,78,89,167,110
3404-001,2017,10,17,6,154,227,381,167
3404-001,2017,10,17,7,361,667,1028,381
3404-001,2017,10,17,8,779,2057,2836,1028
3404-001,2017,10,17,9,1067,1584,2651,2836
3404-001,2017,10,17,10,893,907,1800,2651
3404-001,2017,10,17,11,891,851,1742,1800
3404-001,2017,10,17,12,863,825,1688,1742
3404-001,2017,10,17,13,751,752,1503,1688
3404-001,2017,10,17,14,788,732,1520,1503
3404-001,2017,10,17,15,970,892,1862,1520
3404-001,2017,10,17,16,995,902,1897,1862
3404-001,2017,10,17,17,1101,841,1942,1897
3404-001,2017,10,17,18,1537,813,2350,1942
3404-001,2017,10,17,19,1428,725,2153,2350
3404-001,2017,10,17,20,763,518,1281,2153
3404-001,2017,10,17,21,784,389,1173,1281
3404-001,2017,10,17,22,437,317,754,1173
3404-001,2017,10,17,23,247,189,436,754
3404-001,2017,10,17,24,163,104,267,436
3404-001,2017,10,18,1,100,86,186,267
3404-001,2017,10,18,2,73,48,121,186
3404-001,2017,10,18,3,51,44,95,121
3404-001,2017,10,18,4,45,54,99,95
3404-001,2017,10,18,5,88,84,172,99
3404-001,2017,10,18,6,131,257,388,172
3404-001,2017,10,18,7,314,661,975,388
3404-001,2017,10,18,8,793,1985,2778,975
3404-001,2017,10,18,9,1127,1531,2658,2778
3404-001,2017,10,18,10,916,908,1824,2658
3404-001,2017,10,18,11,869,888,1757,1824
3404-001,2017,10,18,12,829,829,1658,1757
3404-001,2017,10,18,13,793,689,1482,1658
3404-001,2017,10,18,14,791,824,1615,1482
3404-001,2017,10,18,15,970,885,1855,1615
3404-001,2017,10,18,16,1001,935,1936,1855
3404-001,2017,10,18,17,1021,788,1809,1936
3404-001,2017,10,18,18,1728,815,2543,1809
3404-001,2017,10,18,19,1477,714,2191,2543
3404-001,2017,10,18,20,784,464,1248,2191
3404-001,2017,10,18,21,590,352,942,1248
3404-001,2017,10,18,22,371,262,633,942
3404-001,2017,10,18,23,192,171,363,633
3404-001,2017,10,18,24,158,102,260,363
3404-001,2017,10,19,1,105,72,177,260
3404-001,2017,10,19,2,60,47,107,177
3404-001,2017,10,19,3,29,50,79,107
3404-001,2017,10,19,4,51,56,107,79
3404-001,2017,10,19,5,82,90,172,107
3404-001,2017,10,19,6,152,238,390,172
3404-001,2017,10,19,7,338,670,1008,390
3404-001,2017,10,19,8,784,2022,2806,1008
3404-001,2017,10,19,9,1126,1558,2684,2806
3404-001,2017,10,19,10,871,870,1741,2684
3404-001,2017,10,19,11,875,883,1758,1741
3404-001,2017,10,19,12,803,795,1598,1758
3404-001,2017,10,19,13,771,693,1464,1598
3404-001,2017,10,19,14,822,782,1604,1464
3404-001,2017,10,19,15,942,935,1877,1604
3404-001,2017,10,19,16,933,851,1784,1877
3404-001,2017,10,19,17,1003,825,1828,1784
3404-001,2017,10,19,18,1475,786,2261,1828
3404-001,2017,10,19,19,1348,708,2056,2261
3404-001,2017,10,19,20,786,525,1311,2056
3404-001,2017,10,19,21,745,412,1157,1311
3404-001,2017,10,19,22,422,283,705,1157
3404-001,2017,10,19,23,240,168,408,705
3404-001,2017,10,19,24,135,112,247,408
3404-001,2017,10,20,1,127,77,204,247
3404-001,2017,10,20,2,76,66,142,204
3404-001,2017,10,20,3,40,53,93,142
3404-001,2017,10,20,4,46,43,89,93
3404-001,2017,10,20,5,88,78,166,89
3404-001,2017,10,20,6,173,263,436,166
3404-001,2017,10,20,7,352,716,1068,436
3404-001,2017,10,20,8,840,2028,2868,1068
3404-001,2017,10,20,9,1135,1568,2703,2868
3404-001,2017,10,20,10,889,886,1775,2703
3404-001,2017,10,20,11,926,909,1835,1775
3404-001,2017,10,20,12,857,808,1665,1835
3404-001,2017,10,20,13,771,783,1554,1665
3404-001,2017,10,20,14,926,854,1780,1554
3404-001,2017,10,20,15,998,854,1852,1780
3404-001,2017,10,20,16,1005,907,1912,1852
3404-001,2017,10,20,17,1055,868,1923,1912
3404-001,2017,10,20,18,1788,883,2671,1923
3404-001,2017,10,20,19,1683,837,2520,2671
3404-001,2017,10,20,20,958,660,1618,2520
3404-001,2017,10,20,21,757,417,1174,1618
3404-001,2017,10,20,22,410,316,726,1174
3404-001,2017,10,20,23,259,181,440,726
3404-001,2017,10,20,24,150,135,285,440
3404-001,2017,10,21,1,136,80,216,285
3404-001,2017,10,21,2,75,71,146,216
3404-001,2017,10,21,3,61,55,116,146
3404-001,2017,10,21,4,53,61,114,116
3404-001,2017,10,21,5,83,78,161,114
3404-001,2017,10,21,6,149,220,369,161
3404-001,2017,10,21,7,295,490,785,369
3404-001,2017,10,21,8,491,941,1432,785
3404-001,2017,10,21,9,820,932,1752,1432
3404-001,2017,10,21,10,657,803,1460,1752
3404-001,2017,10,21,11,730,811,1541,1460
3404-001,2017,10,21,12,663,762,1425,1541
3404-001,2017,10,21,13,660,689,1349,1425
3404-001,2017,10,21,14,591,720,1311,1349
3404-001,2017,10,21,15,717,702,1419,1311
3404-001,2017,10,21,16,897,657,1554,1419
3404-001,2017,10,21,17,927,640,1567,1554
3404-001,2017,10,21,18,1227,755,1982,1567
3404-001,2017,10,21,19,924,557,1481,1982
3404-001,2017,10,21,20,510,465,975,1481
3404-001,2017,10,21,21,343,303,646,975
3404-001,2017,10,21,22,258,206,464,646
3404-001,2017,10,21,23,155,162,317,464
3404-001,2017,10,21,24,106,123,229,317
3404-001,2017,10,22,1,89,76,165,229
3404-001,2017,10,22,2,55,42,97,165
3404-001,2017,10,22,3,46,40,86,97
3404-001,2017,10,22,4,40,30,70,86
3404-001,2017,10,22,5,56,44,100,70
3404-001,2017,10,22,6,74,94,168,100
3404-001,2017,10,22,7,141,222,363,168
3404-001,2017,10,22,8,254,410,664,363
3404-001,2017,10,22,9,358,423,781,664
3404-001,2017,10,22,10,340,422,762,781
3404-001,2017,10,22,11,434,456,890,762
3404-001,2017,10,22,12,392,535,927,890
3404-001,2017,10,22,13,430,464,894,927
3404-001,2017,10,22,14,540,526,1066,894
3404-001,2017,10,22,15,600,504,1104,1066
3404-001,2017,10,22,16,737,545,1282,1104
3404-001,2017,10,22,17,755,512,1267,1282
3404-001,2017,10,22,18,807,498,1305,1267
3404-001,2017,10,22,19,718,515,1233,1305
3404-001,2017,10,22,20,474,375,849,1233
3404-001,2017,10,22,21,324,303,627,849
3404-001,2017,10,22,22,226,281,507,627
3404-001,2017,10,22,23,134,211,345,507
3404-001,2017,10,22,24,105,120,225,345
3404-001,2017,10,23,1,62,74,136,225
3404-001,2017,10,23,2,32,51,83,136
3404-001,2017,10,23,3,26,42,68,83
3404-001,2017,10,23,4,42,42,84,68
3404-001,2017,10,23,5,69,76,145,84
3404-001,2017,10,23,6,184,293,477,145
3404-001,2017,10,23,7,386,775,1161,477
3404-001,2017,10,23,8,839,2166,3005,1161
3404-001,2017,10,23,9,1041,1594,2635,3005
3404-001,2017,10,23,10,839,849,1688,2635
3404-001,2017,10,23,11,849,899,1748,1688
3404-001,2017,10,23,12,833,765,1598,1748
3404-001,2017,10,23,13,703,771,1474,1598
3404-001,2017,10,23,14,805,791,1596,1474
3404-001,2017,10,23,15,964,895,1859,1596
3404-001,2017,10,23,16,930,892,1822,1859
3404-001,2017,10,23,17,981,750,1731,1822
3404-001,2017,10,23,18,1445,805,2250,1731
3404-001,2017,10,23,19,1288,701,1989,2250
3404-001,2017,10,23,20,830,550,1380,1989
3404-001,2017,10,23,21,732,407,1139,1380
3404-001,2017,10,23,22,415,276,691,1139
3404-001,2017,10,23,23,266,167,433,691
3404-001,2017,10,23,24,154,109,263,433
3404-001,2017,10,24,1,109,70,179,263
3404-001,2017,10,24,2,65,64,129,179
3404-001,2017,10,24,3,52,57,109,129
3404-001,2017,10,24,4,59,52,111,109
3404-001,2017,10,24,5,92,86,178,111
3404-001,2017,10,24,6,159,231,390,178
3404-001,2017,10,24,7,331,661,992,390
3404-001,2017,10,24,8,822,2030,2852,992
3404-001,2017,10,24,9,1076,1496,2572,2852
3404-001,2017,10,24,10,863,864,1727,2572
3404-001,2017,10,24,11,826,880,1706,1727
3404-001,2017,10,24,12,874,825,1699,1706
3404-001,2017,10,24,13,727,679,1406,1699
3404-001,2017,10,24,14,851,837,1688,1406
3404-001,2017,10,24,15,984,816,1800,1688
3404-001,2017,10,24,16,1002,889,1891,1800
3404-001,2017,10,24,17,924,788,1712,1891
3404-001,2017,10,24,18,1377,786,2163,1712
3404-001,2017,10,24,19,1369,682,2051,2163
3404-001,2017,10,24,20,767,507,1274,2051
3404-001,2017,10,24,21,715,373,1088,1274
3404-001,2017,10,24,22,411,278,689,1088
3404-001,2017,10,24,23,263,181,444,689
3404-001,2017,10,24,24,140,98,238,444
3404-001,2017,10,25,1,94,64,158,238
3404-001,2017,10,25,2,65,53,118,158
3404-001,2017,10,25,3,41,44,85,118
3404-001,2017,10,25,4,49,50,99,85
3404-001,2017,10,25,5,91,97,188,99
3404-001,2017,10,25,6,148,249,397,188
3404-001,2017,10,25,7,355,686,1041,397
3404-001,2017,10,25,8,781,2005,2786,1041
3404-001,2017,10,25,9,1060,1516,2576,2786
3404-001,2017,10,25,10,805,895,1700,2576
3404-001,2017,10,25,11,903,825,1728,1700
3404-001,2017,10,25,12,830,795,1625,1728
3404-001,2017,10,25,13,707,688,1395,1625
3404-001,2017,10,25,14,836,774,1610,1395
3404-001,2017,10,25,15,1020,880,1900,1610
3404-001,2017,10,25,16,937,868,1805,1900
3404-001,2017,10,25,17,981,774,1755,1805
3404-001,2017,10,25,18,1672,828,2500,1755
3404-001,2017,10,25,19,1384,714,2098,2500
3404-001,2017,10,25,20,782,518,1300,2098
3404-001,2017,10,25,21,566,375,941,1300
3404-001,2017,10,25,22,387,286,673,941
3404-001,2017,10,25,23,241,196,437,673
3404-001,2017,10,25,24,150,104,254,437
3404-001,2017,10,26,1,96,78,174,254
3404-001,2017,10,26,2,67,44,111,174
3404-001,2017,10,26,3,52,43,95,111
3404-001,2017,10,26,4,51,43,94,95
3404-001,2017,10,26,5,92,88,180,94
3404-001,2017,10,26,6,161,255,416,180
3404-001,2017,10,26,7,350,713,1063,416
3404-001,2017,10,26,8,775,2002,2777,1063
3404-001,2017,10,26,9,1113,1507,2620,2777
3404-001,2017,10,26,10,832,857,1689,2620
3404-001,2017,10,26,11,831,861,1692,1689
3404-001,2017,10,26,12,829,856,1685,1692
3404-001,2017,10,26,13,728,669,1397,1685
3404-001,2017,10,26,14,836,744,1580,1397
3404-001,2017,10,26,15,943,849,1792,1580
3404-001,2017,10,26,16,983,828,1811,1792
3404-001,2017,10,26,17,1037,833,1870,1811
3404-001,2017,10,26,18,1478,852,2330,1870
3404-001,2017,10,26,19,1404,711,2115,2330
3404-001,2017,10,26,20,881,526,1407,2115
3404-001,2017,10,26,21,673,403,1076,1407
3404-001,2017,10,26,22,415,289,704,1076
3404-001,2017,10,26,23,224,188,412,704
3404-001,2017,10,26,24,181,130,311,412
3404-001,2017,10,27,1,113,82,195,311
3404-001,2017,10,27,2,78,57,135,195
3404-001,2017,10,27,3,51,42,93,135
3404-001,2017,10,27,4,48,60,108,93
3404-001,2017,10,27,5,80,84,164,108
3404-001,2017,10,27,6,152,239,391,164
3404-001,2017,10,27,7,337,700,1037,391
3404-001,2017,10,27,8,827,1971,2798,1037
3404-001,2017,10,27,9,1058,1493,2551,2798
3404-001,2017,10,27,10,870,888,1758,2551
3404-001,2017,10,27,11,843,851,1694,1758
3404-001,2017,10,27,12,884,854,1738,1694
3404-001,2017,10,27,13,734,689,1423,1738
3404-001,2017,10,27,14,866,812,1678,1423
3404-001,2017,10,27,15,966,882,1848,1678
3404-001,2017,10,27,16,1045,845,1890,1848
3404-001,2017,10,27,17,1159,859,2018,1890
3404-001,2017,10,27,18,1663,865,2528,2018
3404-001,2017,10,27,19,1654,846,2500,2528
3404-001,2017,10,27,20,1077,639,1716,2500
3404-001,2017,10,27,21,681,419,1100,1716
3404-001,2017,10,27,22,439,296,735,1100
3404-001,2017,10,27,23,272,211,483,735
3404-001,2017,10,27,24,142,136,278,483
3404-001,2017,10,28,1,105,82,187,278
3404-001,2017,10,28,2,77,54,131,187
3404-001,2017,10,28,3,54,50,104,131
3404-001,2017,10,28,4,57,59,116,104
3404-001,2017,10,28,5,106,75,181,116
3404-001,2017,10,28,6,149,199,348,181
3404-001,2017,10,28,7,285,472,757,348
3404-001,2017,10,28,8,599,901,1500,757
3404-001,2017,10,28,9,822,879,1701,1500
3404-001,2017,10,28,10,732,862,1594,1701
3404-001,2017,10,28,11,642,894,1536,1594
3404-001,2017,10,28,12,717,890,1607,1536
3404-001,2017,10,28,13,666,817,1483,1607
3404-001,2017,10,28,14,669,736,1405,1483
3404-001,2017,10,28,15,717,686,1403,1405
3404-001,2017,10,28,16,846,671,1517,1403
3404-001,2017,10,28,17,1003,641,1644,1517
3404-001,2017,10,28,18,1327,808,2135,1644
3404-001,2017,10,28,19,955,649,1604,2135
3404-001,2017,10,28,20,541,465,1006,1604
3404-001,2017,10,28,21,356,338,694,1006
3404-001,2017,10,28,22,233,201,434,694
3404-001,2017,10,28,23,155,152,307,434
3404-001,2017,10,28,24,121,105,226,307
3404-001,2017,10,29,1,88,79,167,226
3404-001,2017,10,29,2,62,48,110,167
3404-001,2017,10,29,3,40,34,74,110
3404-001,2017,10,29,4,38,29,67,74
3404-001,2017,10,29,5,56,32,88,67
3404-001,2017,10,29,6,71,77,148,88
3404-001,2017,10,29,7,151,210,361,148
3404-001,2017,10,29,8,253,379,632,361
3404-001,2017,10,29,9,348,374,722,632
3404-001,2017,10,29,10,363,405,768,722
3404-001,2017,10,29,11,410,442,852,768
3404-001,2017,10,29,12,426,539,965,852
3404-001,2017,10,29,13,442,473,915,965
3404-001,2017,10,29,14,514,549,1063,915
3404-001,2017,10,29,15,639,471,1110,1063
3404-001,2017,10,29,16,697,456,1153,1110
3404-001,2017,10,29,17,771,539,1310,1153
3404-001,2017,10,29,18,919,545,1464,1310
3404-001,2017,10,29,19,619,442,1061,1464
3404-001,2017,10,29,20,400,384,784,1061
3404-001,2017,10,29,21,341,327,668,784
3404-001,2017,10,29,22,210,266,476,668
3404-001,2017,10,29,23,126,203,329,476
3404-001,2017,10,29,24,89,111,200,329
3404-001,2017,10,30,1,58,87,145,200
3404-001,2017,10,30,2,32,47,79,145
3404-001,2017,10,30,3,25,39,64,79
3404-001,2017,10,30,4,37,42,79,64
3404-001,2017,10,30,5,74,80,154,79
3404-001,2017,10,30,6,164,280,444,154
3404-001,2017,10,30,7,338,782,1120,444
3404-001,2017,10,30,8,855,2197,3052,1120
3404-001,2017,10,30,9,1041,1546,2587,3052
3404-001,2017,10,30,10,819,809,1628,2587
3404-001,2017,10,30,11,818,864,1682,1628
3404-001,2017,10,30,12,757,779,1536,1682
3404-001,2017,10,30,13,777,727,1504,1536
3404-001,2017,10,30,14,824,841,1665,1504
3404-001,2017,10,30,15,915,934,1849,1665
3404-001,2017,10,30,16,986,896,1882,1849
3404-001,2017,10,30,17,1038,801,1839,1882
3404-001,2017,10,30,18,1363,828,2191,1839
3404-001,2017,10,30,19,1262,729,1991,2191
3404-001,2017,10,30,20,834,508,1342,1991
3404-001,2017,10,30,21,761,391,1152,1342
3404-001,2017,10,30,22,416,269,685,1152
3404-001,2017,10,30,23,227,136,363,685
3404-001,2017,10,30,24,147,104,251,363
3404-001,2017,10,31,1,94,83,177,251
3404-001,2017,10,31,2,58,55,113,177
3404-001,2017,10,31,3,39,52,91,113
3404-001,2017,10,31,4,46,49,95,91
3404-001,2017,10,31,5,83,82,165,95
3404-001,2017,10,31,6,145,247,392,165
3404-001,2017,10,31,7,345,683,1028,392
3404-001,2017,10,31,8,836,2073,2909,1028
3404-001,2017,10,31,9,1119,1505,2624,2909
3404-001,2017,10,31,10,902,841,1743,2624
3404-001,2017,10,31,11,823,838,1661,1743
3404-001,2017,10,31,12,792,807,1599,1661
3404-001,2017,10,31,13,722,660,1382,1599
3404-001,2017,10,31,14,853,836,1689,1382
3404-001,2017,10,31,15,962,850,1812,1689
3404-001,2017,10,31,16,960,771,1731,1812
3404-001,2017,10,31,17,973,776,1749,1731
3404-001,2017,10,31,18,1466,826,2292,1749
3404-001,2017,10,31,19,1376,691,2067,2292
3404-001,2017,10,31,20,829,492,1321,2067
3404-001,2017,10,31,21,751,378,1129,1321
3404-001,2017,10,31,22,440,277,717,1129
3404-001,2017,10,31,23,222,163,385,717
3404-001,2017,10,31,24,147,108,255,385
3404-001,2017,11,1,1,103,61,164,255
3404-001,2017,11,1,2,76,51,127,164
3404-001,2017,11,1,3,35,52,87,127
3404-001,2017,11,1,4,61,57,118,87
3404-001,2017,11,1,5,88,81,169,118
3404-001,2017,11,1,6,151,234,385,169
3404-001,2017,11,1,7,327,689,1016,385
3404-001,2017,11,1,8,810,2038,2848,1016
3404-001,2017,11,1,9,1082,1558,2640,2848
3404-001,2017,11,1,10,831,800,1631,2640
3404-001,2017,11,1,11,780,875,1655,1631
3404-001,2017,11,1,12,716,733,1449,1655
3404-001,2017,11,1,13,685,695,1380,1449
3404-001,2017,11,1,14,814,799,1613,1380
3404-001,2017,11,1,15,995,882,1877,1613
3404-001,2017,11,1,16,969,902,1871,1877
3404-001,2017,11,1,17,1001,781,1782,1871
3404-001,2017,11,1,18,1700,822,2522,1782
3404-001,2017,11,1,19,1403,676,2079,2522
3404-001,2017,11,1,20,773,511,1284,2079
3404-001,2017,11,1,21,615,361,976,1284
3404-001,2017,11,1,22,370,261,631,976
3404-001,2017,11,1,23,220,182,402,631
3404-001,2017,11,1,24,142,115,257,402
3404-001,2017,11,2,1,102,82,184,257
3404-001,2017,11,2,2,61,55,116,184
3404-001,2017,11,2,3,50,46,96,116
3404-001,2017,11,2,4,48,53,101,96
3404-001,2017,11,2,5,89,93,182,101
3404-001,2017,11,2,6,145,228,373,182
3404-001,2017,11,2,7,353,655,1008,373
3404-001,2017,11,2,8,769,2014,2783,1008
3404-001,2017,11,2,9,1040,1441,2481,2783
3404-001,2017,11,2,10,872,851,1723,2481
3404-001,2017,11,2,11,866,868,1734,1723
3404-001,2017,11,2,12,752,805,1557,1734
3404-001,2017,11,2,13,707,711,1418,1557
3404-001,2017,11,2,14,798,806,1604,1418
3404-001,2017,11,2,15,953,906,1859,1604
3404-001,2017,11,2,16,970,828,1798,1859
3404-001,2017,11,2,17,946,794,1740,1798
3404-001,2017,11,2,18,1549,782,2331,1740
3404-001,2017,11,2,19,1309,684,1993,2331
3404-001,2017,11,2,20,794,493,1287,1993
3404-001,2017,11,2,21,699,370,1069,1287
3404-001,2017,11,2,22,389,271,660,1069
3404-001,2017,11,2,23,216,177,393,660
3404-001,2017,11,2,24,143,89,232,393
3404-001,2017,11,3,1,100,72,172,232
3404-001,2017,11,3,2,54,44,98,172
3404-001,2017,11,3,3,42,50,92,98
3404-001,2017,11,3,4,49,41,90,92
3404-001,2017,11,3,5,74,79,153,90
3404-001,2017,11,3,6,124,242,366,153
3404-001,2017,11,3,7,328,660,988,366
3404-001,2017,11,3,8,794,1931,2725,988
3404-001,2017,11,3,9,994,1517,2511,2725
3404-001,2017,11,3,10,828,822,1650,2511
3404-001,2017,11,3,11,809,798,1607,1650
3404-001,2017,11,3,12,833,747,1580,1607
3404-001,2017,11,3,13,728,654,1382,1580
3404-001,2017,11,3,14,788,751,1539,1382
3404-001,2017,11,3,15,945,835,1780,1539
3404-001,2017,11,3,16,1023,830,1853,1780
3404-001,2017,11,3,17,1067,768,1835,1853
3404-001,2017,11,3,18,1711,836,2547,1835
3404-001,2017,11,3,19,1585,849,2434,2547
3404-001,2017,11,3,20,950,580,1530,2434
3404-001,2017,11,3,21,720,401,1121,1530
3404-001,2017,11,3,22,428,272,700,1121
3404-001,2017,11,3,23,228,201,429,700
3404-001,2017,11,3,24,141,98,239,429
3404-001,2017,11,4,1,116,98,214,239
3404-001,2017,11,4,2,70,53,123,214
3404-001,2017,11,4,3,61,44,105,123
3404-001,2017,11,4,4,52,57,109,105
3404-001,2017,11,4,5,89,75,164,109
3404-001,2017,11,4,6,121,190,311,164
3404-001,2017,11,4,7,268,388,656,311
3404-001,2017,11,4,8,513,831,1344,656
3404-001,2017,11,4,9,725,831,1556,1344
3404-001,2017,11,4,10,677,759,1436,1556
3404-001,2017,11,4,11,689,813,1502,1436
3404-001,2017,11,4,12,641,725,1366,1502
3404-001,2017,11,4,13,658,707,1365,1366
3404-001,2017,11,4,14,661,633,1294,1365
3404-001,2017,11,4,15,669,709,1378,1294
3404-001,2017,11,4,16,803,672,1475,1378
3404-001,2017,11,4,17,1016,641,1657,1475
3404-001,2017,11,4,18,1245,668,1913,1657
3404-001,2017,11,4,19,841,590,1431,1913
3404-001,2017,11,4,20,453,403,856,1431
3404-001,2017,11,4,21,305,319,624,856
3404-001,2017,11,4,22,245,232,477,624
3404-001,2017,11,4,23,148,161,309,477
3404-001,2017,11,4,24,101,85,186,309
3404-001,2017,11,5,1,69,74,143,186
3404-001,2017,11,5,2,65,53,118,143
3404-001,2017,11,5,3,33,36,69,118
3404-001,2017,11,5,4,33,32,65,69
3404-001,2017,11,5,5,53,44,97,65
3404-001,2017,11,5,6,65,84,149,97
3404-001,2017,11,5,7,129,213,342,149
3404-001,2017,11,5,8,210,292,502,342
3404-001,2017,11,5,9,328,356,684,502
3404-001,2017,11,5,10,336,381,717,684
3404-001,2017,11,5,11,420,439,859,717
3404-001,2017,11,5,12,380,442,822,859
3404-001,2017,11,5,13,419,451,870,822
3404-001,2017,11,5,14,461,464,925,870
3404-001,2017,11,5,15,607,483,1090,925
3404-001,2017,11,5,16,704,492,1196,1090
3404-001,2017,11,5,17,774,557,1331,1196
3404-001,2017,11,5,18,934,606,1540,1331
3404-001,2017,11,5,19,656,477,1133,1540
3404-001,2017,11,5,20,497,382,879,1133
3404-001,2017,11,5,21,332,334,666,879
3404-001,2017,11,5,22,265,280,545,666
3404-001,2017,11,5,23,153,221,374,545
3404-001,2017,11,5,24,103,144,247,374
3404-001,2017,11,6,1,64,87,151,247
3404-001,2017,11,6,2,34,45,79,151
3404-001,2017,11,6,3,38,48,86,79
3404-001,2017,11,6,4,33,34,67,86
3404-001,2017,11,6,5,95,87,182,67
3404-001,2017,11,6,6,166,231,397,182
3404-001,2017,11,6,7,361,736,1097,397
3404-001,2017,11,6,8,791,2125,2916,1097
3404-001,2017,11,6,9,999,1653,2652,2916
3404-001,2017,11,6,10,795,819,1614,2652
3404-001,2017,11,6,11,812,833,1645,1614
3404-001,2017,11,6,12,745,789,1534,1645
3404-001,2017,11,6,13,737,702,1439,1534
3404-001,2017,11,6,14,785,804,1589,1439
3404-001,2017,11,6,15,964,891,1855,1589
3404-001,2017,11,6,16,991,895,1886,1855
3404-001,2017,11,6,17,992,739,1731,1886
3404-001,2017,11,6,18,1419,821,2240,1731
3404-001,2017,11,6,19,1302,754,2056,2240
3404-001,2017,11,6,20,826,545,1371,2056
3404-001,2017,11,6,21,739,386,1125,1371
3404-001,2017,11,6,22,388,242,630,1125
3404-001,2017,11,6,23,240,192,432,630
3404-001,2017,11,6,24,153,122,275,432
3404-001,2017,11,7,1,110,89,199,275
3404-001,2017,11,7,2,67,58,125,199
3404-001,2017,11,7,3,51,34,85,125
3404-001,2017,11,7,4,46,53,99,85
3404-001,2017,11,7,5,96,89,185,99
3404-001,2017,11,7,6,147,243,390,185
3404-001,2017,11,7,7,312,696,1008,390
3404-001,2017,11,7,8,788,2025,2813,1008
3404-001,2017,11,7,9,1100,1517,2617,2813
3404-001,2017,11,7,10,850,864,1714,2617
3404-001,2017,11,7,11,884,906,1790,1714
3404-001,2017,11,7,12,831,854,1685,1790
3404-001,2017,11,7,13,720,669,1389,1685
3404-001,2017,11,7,14,840,818,1658,1389
3404-001,2017,11,7,15,964,913,1877,1658
3404-001,2017,11,7,16,950,821,1771,1877
3404-001,2017,11,7,17,1020,777,1797,1771
3404-001,2017,11,7,18,1526,808,2334,1797
3404-001,2017,11,7,19,1327,666,1993,2334
3404-001,2017,11,7,20,820,573,1393,1993
3404-001,2017,11,7,21,769,364,1133,1393
3404-001,2017,11,7,22,410,242,652,1133
3404-001,2017,11,7,23,244,166,410,652
3404-001,2017,11,7,24,136,115,251,410
3404-001,2017,11,8,1,107,72,179,251
3404-001,2017,11,8,2,76,52,128,179
3404-001,2017,11,8,3,57,41,98,128
3404-001,2017,11,8,4,54,39,93,98
3404-001,2017,11,8,5,97,86,183,93
3404-001,2017,11,8,6,137,222,359,183
3404-001,2017,11,8,7,337,686,1023,359
3404-001,2017,11,8,8,798,1997,2795,1023
3404-001,2017,11,8,9,1080,1470,2550,2795
3404-001,2017,11,8,10,789,885,1674,2550
3404-001,2017,11,8,11,839,809,1648,1674
3404-001,2017,11,8,12,794,771,1565,1648
3404-001,2017,11,8,13,721,691,1412,1565
3404-001,2017,11,8,14,791,764,1555,1412
3404-001,2017,11,8,15,915,893,1808,1555
3404-001,2017,11,8,16,915,803,1718,1808
3404-001,2017,11,8,17,980,775,1755,1718
3404-001,2017,11,8,18,1688,843,2531,1755
3404-001,2017,11,8,19,1442,765,2207,2531
3404-001,2017,11,8,20,773,534,1307,2207
3404-001,2017,11,8,21,636,376,1012,1307
3404-001,2017,11,8,22,377,302,679,1012
3404-001,2017,11,8,23,227,175,402,679
3404-001,2017,11,8,24,150,107,257,402
3404-001,2017,11,9,1,109,86,195,257
3404-001,2017,11,9,2,75,46,121,195
3404-001,2017,11,9,3,43,39,82,121
3404-001,2017,11,9,4,62,49,111,82
3404-001,2017,11,9,5,69,75,144,111
3404-001,2017,11,9,6,145,227,372,144
3404-001,2017,11,9,7,332,660,992,372
3404-001,2017,11,9,8,779,2012,2791,992
3404-001,2017,11,9,9,1106,1570,2676,2791
3404-001,2017,11,9,10,888,887,1775,2676
3404-001,2017,11,9,11,806,903,1709,1775
3404-001,2017,11,9,12,840,838,1678,1709
3404-001,2017,11,9,13,674,741,1415,1678
3404-001,2017,11,9,14,814,797,1611,1415
3404-001,2017,11,9,15,901,876,1777,1611
3404-001,2017,11,9,16,920,825,1745,1777
3404-001,2017,11,9,17,989,796,1785,1745
3404-001,2017,11,9,18,1567,779,2346,1785
3404-001,2017,11,9,19,1349,711,2060,2346
3404-001,2017,11,9,20,809,531,1340,2060
3404-001,2017,11,9,21,707,409,1116,1340
3404-001,2017,11,9,22,431,289,720,1116
3404-001,2017,11,9,23,227,182,409,720
3404-001,2017,11,9,24,140,106,246,409
3404-001,2017,11,10,1,110,76,186,246
3404-001,2017,11,10,2,63,57,120,186
3404-001,2017,11,10,3,49,39,88,120
3404-001,2017,11,10,4,42,44,86,88
3404-001,2017,11,10,5,72,79,151,86
3404-001,2017,11,10,6,148,211,359,151
3404-001,2017,11,10,7,373,651,1024,359
3404-001,2017,11,10,8,783,1943,2726,1024
3404-001,2017,11,10,9,1064,1508,2572,2726
3404-001,2017,11,10,10,867,915,1782,2572
3404-001,2017,11,10,11,911,885,1796,1782
3404-001,2017,11,10,12,852,839,1691,1796
3404-001,2017,11,10,13,739,778,1517,1691
3404-001,2017,11,10,14,863,793,1656,1517
3404-001,2017,11,10,15,988,875,1863,1656
3404-001,2017,11,10,16,978,842,1820,1863
3404-001,2017,11,10,17,1032,789,1821,1820
3404-001,2017,11,10,18,1696,845,2541,1821
3404-001,2017,11,10,19,1595,810,2405,2541
3404-001,2017,11,10,20,961,641,1602,2405
3404-001,2017,11,10,21,677,413,1090,1602
3404-001,2017,11,10,22,370,261,631,1090
3404-001,2017,11,10,23,230,169,399,631
3404-001,2017,11,10,24,159,123,282,399
3404-001,2017,11,11,1,102,79,181,282
3404-001,2017,11,11,2,72,64,136,181
3404-001,2017,11,11,3,54,52,106,136
3404-001,2017,11,11,4,45,49,94,106
3404-001,2017,11,11,5,99,58,157,94
3404-001,2017,11,11,6,133,189,322,157
3404-001,2017,11,11,7,264,401,665,322
3404-001,2017,11,11,8,484,835,1319,665
3404-001,2017,11,11,9,703,882,1585,1319
3404-001,2017,11,11,10,703,710,1413,1585
3404-001,2017,11,11,11,653,812,1465,1413
3404-001,2017,11,11,12,617,771,1388,1465
3404-001,2017,11,11,13,644,665,1309,1388
3404-001,2017,11,11,14,607,664,1271,1309
3404-001,2017,11,11,15,676,740,1416,1271
3404-001,2017,11,11,16,812,640,1452,1416
3404-001,2017,11,11,17,853,685,1538,1452
3404-001,2017,11,11,18,1176,645,1821,1538
3404-001,2017,11,11,19,794,594,1388,1821
3404-001,2017,11,11,20,442,425,867,1388
3404-001,2017,11,11,21,276,308,584,867
3404-001,2017,11,11,22,209,224,433,584
3404-001,2017,11,11,23,139,146,285,433
3404-001,2017,11,11,24,112,87,199,285
3404-001,2017,11,12,1,63,71,134,199
3404-001,2017,11,12,2,54,63,117,134
3404-001,2017,11,12,3,32,34,66,117
3404-001,2017,11,12,4,36,43,79,66
3404-001,2017,11,12,5,41,43,84,79
3404-001,2017,11,12,6,79,94,173,84
3404-001,2017,11,12,7,108,189,297,173
3404-001,2017,11,12,8,195,322,517,297
3404-001,2017,11,12,9,321,360,681,517
3404-001,2017,11,12,10,331,394,725,681
3404-001,2017,11,12,11,362,454,816,725
3404-001,2017,11,12,12,403,455,858,816
3404-001,2017,11,12,13,409,415,824,858
3404-001,2017,11,12,14,490,513,1003,824
3404-001,2017,11,12,15,576,498,1074,1003
3404-001,2017,11,12,16,714,553,1267,1074
3404-001,2017,11,12,17,778,577,1355,1267
3404-001,2017,11,12,18,897,504,1401,1355
3404-001,2017,11,12,19,701,539,1240,1401
3404-001,2017,11,12,20,481,468,949,1240
3404-001,2017,11,12,21,322,397,719,949
3404-001,2017,11,12,22,237,310,547,719
3404-001,2017,11,12,23,166,201,367,547
3404-001,2017,11,12,24,85,123,208,367
3404-001,2017,11,13,1,39,93,132,208
3404-001,2017,11,13,2,43,55,98,132
3404-001,2017,11,13,3,27,35,62,98
3404-001,2017,11,13,4,38,44,82,62
3404-001,2017,11,13,5,75,84,159,82
3404-001,2017,11,13,6,162,268,430,159
3404-001,2017,11,13,7,372,742,1114,430
3404-001,2017,11,13,8,821,2111,2932,1114
3404-001,2017,11,13,9,1007,1605,2612,2932
3404-001,2017,11,13,10,811,838,1649,2612
3404-001,2017,11,13,11,845,844,1689,1649
3404-001,2017,11,13,12,783,732,1515,1689
3404-001,2017,11,13,13,699,698,1397,1515
3404-001,2017,11,13,14,803,832,1635,1397
3404-001,2017,11,13,15,908,832,1740,1635
3404-001,2017,11,13,16,919,873,1792,1740
3404-001,2017,11,13,17,986,763,1749,1792
3404-001,2017,11,13,18,1233,759,1992,1749
3404-001,2017,11,13,19,1295,747,2042,1992
3404-001,2017,11,13,20,772,517,1289,2042
3404-001,2017,11,13,21,732,343,1075,1289
3404-001,2017,11,13,22,381,269,650,1075
3404-001,2017,11,13,23,243,178,421,650
3404-001,2017,11,13,24,148,127,275,421
3404-001,2017,11,14,1,91,74,165,275
3404-001,2017,11,14,2,56,47,103,165
3404-001,2017,11,14,3,39,43,82,103
3404-001,2017,11,14,4,65,47,112,82
3404-001,2017,11,14,5,84,98,182,112
3404-001,2017,11,14,6,127,219,346,182
3404-001,2017,11,14,7,347,643,990,346
3404-001,2017,11,14,8,813,2016,2829,990
3404-001,2017,11,14,9,1058,1504,2562,2829
3404-001,2017,11,14,10,895,906,1801,2562
3404-001,2017,11,14,11,853,846,1699,1801
3404-001,2017,11,14,12,819,826,1645,1699
3404-001,2017,11,14,13,758,719,1477,1645
3404-001,2017,11,14,14,848,829,1677,1477
3404-001,2017,11,14,15,927,900,1827,1677
3404-001,2017,11,14,16,961,876,1837,1827
3404-001,2017,11,14,17,1011,797,1808,1837
3404-001,2017,11,14,18,1431,777,2208,1808
3404-001,2017,11,14,19,1276,680,1956,2208
3404-001,2017,11,14,20,824,527,1351,1956
3404-001,2017,11,14,21,753,379,1132,1351
3404-001,2017,11,14,22,408,276,684,1132
3404-001,2017,11,14,23,242,166,408,684
3404-001,2017,11,14,24,157,77,234,408
3404-001,2017,11,15,1,88,70,158,234
3404-001,2017,11,15,2,65,48,113,158
3404-001,2017,11,15,3,39,39,78,113
3404-001,2017,11,15,4,38,49,87,78
3404-001,2017,11,15,5,92,96,188,87
3404-001,2017,11,15,6,118,215,333,188
3404-001,2017,11,15,7,358,664,1022,333
3404-001,2017,11,15,8,786,1953,2739,1022
3404-001,2017,11,15,9,1107,1586,2693,2739
3404-001,2017,11,15,10,865,907,1772,2693
3404-001,2017,11,15,11,926,867,1793,1772
3404-001,2017,11,15,12,864,821,1685,1793
3404-001,2017,11,15,13,736,754,1490,1685
3404-001,2017,11,15,14,790,806,1596,1490
3404-001,2017,11,15,15,912,896,1808,1596
3404-001,2017,11,15,16,951,845,1796,1808
3404-001,2017,11,15,17,1013,783,1796,1796
3404-001,2017,11,15,18,1692,806,2498,1796
3404-001,2017,11,15,19,1382,726,2108,2498
3404-001,2017,11,15,20,757,526,1283,2108
3404-001,2017,11,15,21,585,382,967,1283
3404-001,2017,11,15,22,381,272,653,967
3404-001,2017,11,15,23,212,155,367,653
3404-001,2017,11,15,24,155,129,284,367
3404-001,2017,11,16,1,94,92,186,284
3404-001,2017,11,16,2,44,45,89,186
3404-001,2017,11,16,3,51,51,102,89
3404-001,2017,11,16,4,57,43,100,102
3404-001,2017,11,16,5,80,86,166,100
3404-001,2017,11,16,6,134,205,339,166
3404-001,2017,11,16,7,324,626,950,339
3404-001,2017,11,16,8,783,1928,2711,950
3404-001,2017,11,16,9,1081,1523,2604,2711
3404-001,2017,11,16,10,872,861,1733,2604
3404-001,2017,11,16,11,836,844,1680,1733
3404-001,2017,11,16,12,780,759,1539,1680
3404-001,2017,11,16,13,724,691,1415,1539
3404-001,2017,11,16,14,846,819,1665,1415
3404-001,2017,11,16,15,948,888,1836,1665
3404-001,2017,11,16,16,1020,815,1835,1836
3404-001,2017,11,16,17,1014,829,1843,1835
3404-001,2017,11,16,18,1455,793,2248,1843
3404-001,2017,11,16,19,1359,729,2088,2248
3404-001,2017,11,16,20,832,551,1383,2088
3404-001,2017,11,16,21,696,421,1117,1383
3404-001,2017,11,16,22,412,274,686,1117
3404-001,2017,11,16,23,217,176,393,686
3404-001,2017,11,16,24,149,108,257,393
3404-001,2017,11,17,1,120,91,211,257
3404-001,2017,11,17,2,54,58,112,211
3404-001,2017,11,17,3,49,49,98,112
3404-001,2017,11,17,4,44,47,91,98
3404-001,2017,11,17,5,78,78,156,91
3404-001,2017,11,17,6,115,223,338,156
3404-001,2017,11,17,7,339,604,943,338
3404-001,2017,11,17,8,746,1892,2638,943
3404-001,2017,11,17,9,1019,1505,2524,2638
3404-001,2017,11,17,10,839,872,1711,2524
3404-001,2017,11,17,11,873,858,1731,1711
3404-001,2017,11,17,12,807,860,1667,1731
3404-001,2017,11,17,13,769,735,1504,1667
3404-001,2017,11,17,14,860,785,1645,1504
3404-001,2017,11,17,15,993,882,1875,1645
3404-001,2017,11,17,16,1020,879,1899,1875
3404-001,2017,11,17,17,1107,830,1937,1899
3404-001,2017,11,17,18,1704,792,2496,1937
3404-001,2017,11,17,19,1620,813,2433,2496
3404-001,2017,11,17,20,955,592,1547,2433
3404-001,2017,11,17,21,708,444,1152,1547
3404-001,2017,11,17,22,419,267,686,1152
3404-001,2017,11,17,23,219,183,402,686
3404-001,2017,11,17,24,166,107,273,402
3404-001,2017,11,18,1,104,92,196,273
3404-001,2017,11,18,2,74,56,130,196
3404-001,2017,11,18,3,44,34,78,130
3404-001,2017,11,18,4,43,45,88,78
3404-001,2017,11,18,5,74,62,136,88
3404-001,2017,11,18,6,118,170,288,136
3404-001,2017,11,18,7,267,365,632,288
3404-001,2017,11,18,8,478,801,1279,632
3404-001,2017,11,18,9,712,823,1535,1279
3404-001,2017,11,18,10,637,717,1354,1535
3404-001,2017,11,18,11,707,741,1448,1354
3404-001,2017,11,18,12,658,739,1397,1448
3404-001,2017,11,18,13,633,663,1296,1397
3404-001,2017,11,18,14,694,637,1331,1296
3404-001,2017,11,18,15,772,698,1470,1331
3404-001,2017,11,18,16,779,694,1473,1470
3404-001,2017,11,18,17,881,681,1562,1473
3404-001,2017,11,18,18,1168,683,1851,1562
3404-001,2017,11,18,19,788,588,1376,1851
3404-001,2017,11,18,20,416,408,824,1376
3404-001,2017,11,18,21,287,281,568,824
3404-001,2017,11,18,22,214,189,403,568
3404-001,2017,11,18,23,119,140,259,403
3404-001,2017,11,18,24,79,88,167,259
3404-001,2017,11,19,1,88,61,149,167
3404-001,2017,11,19,2,63,37,100,149
3404-001,2017,11,19,3,36,41,77,100
3404-001,2017,11,19,4,34,33,67,77
3404-001,2017,11,19,5,42,33,75,67
3404-001,2017,11,19,6,63,71,134,75
3404-001,2017,11,19,7,117,163,280,134
3404-001,2017,11,19,8,218,319,537,280
3404-001,2017,11,19,9,348,350,698,537
3404-001,2017,11,19,10,320,375,695,698
3404-001,2017,11,19,11,395,398,793,695
3404-001,2017,11,19,12,398,454,852,793
3404-001,2017,11,19,13,456,456,912,852
3404-001,2017,11,19,14,529,489,1018,912
3404-001,2017,11,19,15,602,525,1127,1018
3404-001,2017,11,19,16,776,532,1308,1127
3404-001,2017,11,19,17,898,531,1429,1308
3404-001,2017,11,19,18,900,525,1425,1429
3404-001,2017,11,19,19,605,440,1045,1425
3404-001,2017,11,19,20,463,397,860,1045
3404-001,2017,11,19,21,306,326,632,860
3404-001,2017,11,19,22,191,280,471,632
3404-001,2017,11,19,23,137,200,337,471
3404-001,2017,11,19,24,86,132,218,337
3404-001,2017,11,20,1,44,75,119,218
3404-001,2017,11,20,2,41,46,87,119
3404-001,2017,11,20,3,30,29,59,87
3404-001,2017,11,20,4,43,30,73,59
3404-001,2017,11,20,5,72,56,128,73
3404-001,2017,11,20,6,129,255,384,128
3404-001,2017,11,20,7,337,700,1037,384
3404-001,2017,11,20,8,796,2082,2878,1037
3404-001,2017,11,20,9,976,1525,2501,2878
3404-001,2017,11,20,10,772,766,1538,2501
3404-001,2017,11,20,11,812,813,1625,1538
3404-001,2017,11,20,12,719,817,1536,1625
3404-001,2017,11,20,13,662,685,1347,1536
3404-001,2017,11,20,14,796,821,1617,1347
3404-001,2017,11,20,15,999,878,1877,1617
3404-001,2017,11,20,16,951,812,1763,1877
3404-001,2017,11,20,17,991,764,1755,1763
3404-001,2017,11,20,18,1407,775,2182,1755
3404-001,2017,11,20,19,1245,683,1928,2182
3404-001,2017,11,20,20,796,501,1297,1928
3404-001,2017,11,20,21,770,392,1162,1297
3404-001,2017,11,20,22,371,251,622,1162
3404-001,2017,11,20,23,208,174,382,622
3404-001,2017,11,20,24,117,90,207,382
3404-001,2017,11,21,1,91,55,146,207
3404-001,2017,11,21,2,70,60,130,146
3404-001,2017,11,21,3,50,43,93,130
3404-001,2017,11,21,4,36,43,79,93
3404-001,2017,11,21,5,81,63,144,79
3404-001,2017,11,21,6,126,200,326,144
3404-001,2017,11,21,7,311,598,909,326
3404-001,2017,11,21,8,724,1883,2607,909
3404-001,2017,11,21,9,1074,1580,2654,2607
3404-001,2017,11,21,10,853,906,1759,2654
3404-001,2017,11,21,11,845,902,1747,1759
3404-001,2017,11,21,12,824,861,1685,1747
3404-001,2017,11,21,13,720,735,1455,1685
3404-001,2017,11,21,14,807,772,1579,1455
3404-001,2017,11,21,15,910,900,1810,1579
3404-001,2017,11,21,16,980,859,1839,1810
3404-001,2017,11,21,17,951,791,1742,1839
3404-001,2017,11,21,18,1482,876,2358,1742
3404-001,2017,11,21,19,1311,712,2023,2358
3404-001,2017,11,21,20,802,493,1295,2023
3404-001,2017,11,21,21,719,378,1097,1295
3404-001,2017,11,21,22,410,264,674,1097
3404-001,2017,11,21,23,211,161,372,674
3404-001,2017,11,21,24,132,117,249,372
3404-001,2017,11,22,1,99,86,185,249
3404-001,2017,11,22,2,55,52,107,185
3404-001,2017,11,22,3,50,55,105,107
3404-001,2017,11,22,4,47,45,92,105
3404-001,2017,11,22,5,71,76,147,92
3404-001,2017,11,22,6,156,196,352,147
3404-001,2017,11,22,7,350,606,956,352
3404-001,2017,11,22,8,742,1886,2628,956
3404-001,2017,11,22,9,1069,1584,2653,2628
3404-001,2017,11,22,10,839,816,1655,2653
3404-001,2017,11,22,11,833,831,1664,1655
3404-001,2017,11,22,12,824,806,1630,1664
3404-001,2017,11,22,13,728,647,1375,1630
3404-001,2017,11,22,14,801,766,1567,1375
3404-001,2017,11,22,15,909,880,1789,1567
3404-001,2017,11,22,16,927,928,1855,1789
3404-001,2017,11,22,17,954,753,1707,1855
3404-001,2017,11,22,18,1558,801,2359,1707
3404-001,2017,11,22,19,1380,667,2047,2359
3404-001,2017,11,22,20,735,554,1289,2047
3404-001,2017,11,22,21,617,367,984,1289
3404-001,2017,11,22,22,384,228,612,984
3404-001,2017,11,22,23,207,163,370,612
3404-001,2017,11,22,24,132,108,240,370
3404-001,2017,11,23,1,90,87,177,240
3404-001,2017,11,23,2,51,52,103,177
3404-001,2017,11,23,3,56,29,85,103
3404-001,2017,11,23,4,48,61,109,85
3404-001,2017,11,23,5,60,72,132,109
3404-001,2017,11,23,6,140,188,328,132
3404-001,2017,11,23,7,317,612,929,328
3404-001,2017,11,23,8,716,1882,2598,929
3404-001,2017,11,23,9,1049,1527,2576,2598
3404-001,2017,11,23,10,852,911,1763,2576
3404-001,2017,11,23,11,770,762,1532,1763
3404-001,2017,11,23,12,801,733,1534,1532
3404-001,2017,11,23,13,699,699,1398,1534
3404-001,2017,11,23,14,775,812,1587,1398
3404-001,2017,11,23,15,936,849,1785,1587
3404-001,2017,11,23,16,862,822,1684,1785
3404-001,2017,11,23,17,926,782,1708,1684
3404-001,2017,11,23,18,1368,750,2118,1708
3404-001,2017,11,23,19,1228,671,1899,2118
3404-001,2017,11,23,20,746,549,1295,1899
3404-001,2017,11,23,21,712,378,1090,1295
3404-001,2017,11,23,22,415,244,659,1090
3404-001,2017,11,23,23,234,170,404,659
3404-001,2017,11,23,24,156,63,219,404
3404-001,2017,11,24,1,91,74,165,219
3404-001,2017,11,24,2,51,39,90,165
3404-001,2017,11,24,3,45,48,93,90
3404-001,2017,11,24,4,44,47,91,93
3404-001,2017,11,24,5,63,52,115,91
3404-001,2017,11,24,6,123,175,298,115
3404-001,2017,11,24,7,259,491,750,298
3404-001,2017,11,24,8,654,1474,2128,750
3404-001,2017,11,24,9,902,1412,2314,2128
3404-001,2017,11,24,10,742,769,1511,2314
3404-001,2017,11,24,11,737,808,1545,1511
3404-001,2017,11,24,12,749,718,1467,1545
3404-001,2017,11,24,13,677,653,1330,1467
3404-001,2017,11,24,14,760,748,1508,1330
3404-001,2017,11,24,15,903,827,1730,1508
3404-001,2017,11,24,16,867,815,1682,1730
3404-001,2017,11,24,17,940,741,1681,1682
3404-001,2017,11,24,18,1582,821,2403,1681
3404-001,2017,11,24,19,1424,764,2188,2403
3404-001,2017,11,24,20,828,564,1392,2188
3404-001,2017,11,24,21,656,378,1034,1392
3404-001,2017,11,24,22,413,221,634,1034
3404-001,2017,11,24,23,213,158,371,634
3404-001,2017,11,24,24,128,105,233,371
3404-001,2017,11,25,1,110,95,205,233
3404-001,2017,11,25,2,58,50,108,205
3404-001,2017,11,25,3,42,48,90,108
3404-001,2017,11,25,4,49,55,104,90
3404-001,2017,11,25,5,75,58,133,104
3404-001,2017,11,25,6,126,118,244,133
3404-001,2017,11,25,7,212,380,592,244
3404-001,2017,11,25,8,440,731,1171,592
3404-001,2017,11,25,9,647,801,1448,1171
3404-001,2017,11,25,10,668,741,1409,1448
3404-001,2017,11,25,11,711,731,1442,1409
3404-001,2017,11,25,12,591,680,1271,1442
3404-001,2017,11,25,13,621,654,1275,1271
3404-001,2017,11,25,14,686,643,1329,1275
3404-001,2017,11,25,15,762,658,1420,1329
3404-001,2017,11,25,16,761,650,1411,1420
3404-001,2017,11,25,17,811,589,1400,1411
3404-001,2017,11,25,18,1194,617,1811,1400
3404-001,2017,11,25,19,773,469,1242,1811
3404-001,2017,11,25,20,373,388,761,1242
3404-001,2017,11,25,21,296,283,579,761
3404-001,2017,11,25,22,193,176,369,579
3404-001,2017,11,25,23,106,178,284,369
3404-001,2017,11,25,24,95,91,186,284
3404-001,2017,11,26,1,63,68,131,186
3404-001,2017,11,26,2,49,47,96,131
3404-001,2017,11,26,3,30,42,72,96
3404-001,2017,11,26,4,27,27,54,72
3404-001,2017,11,26,5,43,39,82,54
3404-001,2017,11,26,6,37,77,114,82
3404-001,2017,11,26,7,93,162,255,114
3404-001,2017,11,26,8,229,253,482,255
3404-001,2017,11,26,9,273,320,593,482
3404-001,2017,11,26,10,309,313,622,593
3404-001,2017,11,26,11,346,394,740,622
3404-001,2017,11,26,12,443,399,842,740
3404-001,2017,11,26,13,431,418,849,842
3404-001,2017,11,26,14,498,463,961,849
3404-001,2017,11,26,15,581,524,1105,961
3404-001,2017,11,26,16,712,514,1226,1105
3404-001,2017,11,26,17,707,481,1188,1226
3404-001,2017,11,26,18,942,474,1416,1188
3404-001,2017,11,26,19,755,445,1200,1416
3404-001,2017,11,26,20,493,334,827,1200
3404-001,2017,11,26,21,356,289,645,827
3404-001,2017,11,26,22,241,279,520,645
3404-001,2017,11,26,23,134,224,358,520
3404-001,2017,11,26,24,97,130,227,358
3404-001,2017,11,27,1,44,84,128,227
3404-001,2017,11,27,2,37,37,74,128
3404-001,2017,11,27,3,24,32,56,74
3404-001,2017,11,27,4,25,34,59,56
3404-001,2017,11,27,5,59,64,123,59
3404-001,2017,11,27,6,134,236,370,123
3404-001,2017,11,27,7,328,674,1002,370
3404-001,2017,11,27,8,752,2026,2778,1002
3404-001,2017,11,27,9,957,1613,2570,2778
3404-001,2017,11,27,10,800,850,1650,2570
3404-001,2017,11,27,11,886,794,1680,1650
3404-001,2017,11,27,12,822,895,1717,1680
3404-001,2017,11,27,13,707,694,1401,1717
3404-001,2017,11,27,14,759,823,1582,1401
3404-001,2017,11,27,15,941,871,1812,1582
3404-001,2017,11,27,16,984,846,1830,1812
3404-001,2017,11,27,17,1028,812,1840,1830
3404-001,2017,11,27,18,1460,830,2290,1840
3404-001,2017,11,27,19,1270,698,1968,2290
3404-001,2017,11,27,20,802,486,1288,1968
3404-001,2017,11,27,21,723,372,1095,1288
3404-001,2017,11,27,22,464,240,704,1095
3404-001,2017,11,27,23,237,148,385,704
3404-001,2017,11,27,24,132,112,244,385
3404-001,2017,11,28,1,80,74,154,244
3404-001,2017,11,28,2,54,49,103,154
3404-001,2017,11,28,3,50,39,89,103
3404-001,2017,11,28,4,59,47,106,89
3404-001,2017,11,28,5,75,93,168,106
3404-001,2017,11,28,6,134,194,328,168
3404-001,2017,11,28,7,287,614,901,328
3404-001,2017,11,28,8,817,1903,2720,901
3404-001,2017,11,28,9,1077,1556,2633,2720
3404-001,2017,11,28,10,824,913,1737,2633
3404-001,2017,11,28,11,922,842,1764,1737
3404-001,2017,11,28,12,804,872,1676,1764
3404-001,2017,11,28,13,717,698,1415,1676
3404-001,2017,11,28,14,829,808,1637,1415
3404-001,2017,11,28,15,951,922,1873,1637
3404-001,2017,11,28,16,927,879,1806,1873
3404-001,2017,11,28,17,1086,798,1884,1806
3404-001,2017,11,28,18,1444,759,2203,1884
3404-001,2017,11,28,19,1267,730,1997,2203
3404-001,2017,11,28,20,725,515,1240,1997
3404-001,2017,11,28,21,689,346,1035,1240
3404-001,2017,11,28,22,433,254,687,1035
3404-001,2017,11,28,23,238,138,376,687
3404-001,2017,11,28,24,150,128,278,376
3404-001,2017,11,29,1,108,90,198,278
3404-001,2017,11,29,2,60,64,124,198
3404-001,2017,11,29,3,43,54,97,124
3404-001,2017,11,29,4,49,54,103,97
3404-001,2017,11,29,5,73,76,149,103
3404-001,2017,11,29,6,145,225,370,149
3404-001,2017,11,29,7,331,640,971,370
3404-001,2017,11,29,8,768,1964,2732,971
3404-001,2017,11,29,9,1015,1534,2549,2732
3404-001,2017,11,29,10,798,888,1686,2549
3404-001,2017,11,29,11,849,856,1705,1686
3404-001,2017,11,29,12,799,817,1616,1705
3404-001,2017,11,29,13,678,682,1360,1616
3404-001,2017,11,29,14,803,792,1595,1360
3404-001,2017,11,29,15,844,791,1635,1595
3404-001,2017,11,29,16,929,783,1712,1635
3404-001,2017,11,29,17,1019,716,1735,1712
3404-001,2017,11,29,18,1689,821,2510,1735
3404-001,2017,11,29,19,1320,681,2001,2510
3404-001,2017,11,29,20,731,483,1214,2001
3404-001,2017,11,29,21,537,337,874,1214
3404-001,2017,11,29,22,374,234,608,874
3404-001,2017,11,29,23,205,180,385,608
3404-001,2017,11,29,24,125,119,244,385
3404-001,2017,11,30,1,84,81,165,244
3404-001,2017,11,30,2,62,53,115,165
3404-001,2017,11,30,3,55,46,101,115
3404-001,2017,11,30,4,57,53,110,101
3404-001,2017,11,30,5,74,64,138,110
3404-001,2017,11,30,6,129,223,352,138
3404-001,2017,11,30,7,330,650,980,352
3404-001,2017,11,30,8,775,1970,2745,980
3404-001,2017,11,30,9,997,1550,2547,2745
3404-001,2017,11,30,10,799,905,1704,2547
3404-001,2017,11,30,11,816,792,1608,1704
3404-001,2017,11,30,12,790,750,1540,1608
3404-001,2017,11,30,13,703,695,1398,1540
3404-001,2017,11,30,14,814,783,1597,1398
3404-001,2017,11,30,15,881,805,1686,1597
3404-001,2017,11,30,16,905,842,1747,1686
3404-001,2017,11,30,17,1007,780,1787,1747
3404-001,2017,11,30,18,1508,809,2317,1787
3404-001,2017,11,30,19,1289,655,1944,2317
3404-001,2017,11,30,20,800,505,1305,1944
3404-001,2017,11,30,21,670,360,1030,1305
3404-001,2017,11,30,22,426,238,664,1030
3404-001,2017,11,30,23,218,189,407,664
3404-001,2017,11,30,24,126,106,232,407
3404-001,2017,12,1,1,94,75,169,232
3404-001,2017,12,1,2,49,47,96,169
3404-001,2017,12,1,3,40,53,93,96
3404-001,2017,12,1,4,52,54,106,93
3404-001,2017,12,1,5,67,77,144,106
3404-001,2017,12,1,6,112,198,310,144
3404-001,2017,12,1,7,336,652,988,310
3404-001,2017,12,1,8,743,1909,2652,988
3404-001,2017,12,1,9,1011,1479,2490,2652
3404-001,2017,12,1,10,787,848,1635,2490
3404-001,2017,12,1,11,819,833,1652,1635
3404-001,2017,12,1,12,849,842,1691,1652
3404-001,2017,12,1,13,748,727,1475,1691
3404-001,2017,12,1,14,781,780,1561,1475
3404-001,2017,12,1,15,898,846,1744,1561
3404-001,2017,12,1,16,968,867,1835,1744
3404-001,2017,12,1,17,1122,875,1997,1835
3404-001,2017,12,1,18,1709,813,2522,1997
3404-001,2017,12,1,19,1570,777,2347,2522
3404-001,2017,12,1,20,940,615,1555,2347
3404-001,2017,12,1,21,649,386,1035,1555
3404-001,2017,12,1,22,398,266,664,1035
3404-001,2017,12,1,23,210,178,388,664
3404-001,2017,12,1,24,114,114,228,388
3404-001,2017,12,2,1,101,73,174,228
3404-001,2017,12,2,2,66,57,123,174
3404-001,2017,12,2,3,34,32,66,123
3404-001,2017,12,2,4,43,42,85,66
3404-001,2017,12,2,5,73,64,137,85
3404-001,2017,12,2,6,116,159,275,137
3404-001,2017,12,2,7,252,388,640,275
3404-001,2017,12,2,8,449,754,1203,640
3404-001,2017,12,2,9,637,785,1422,1203
3404-001,2017,12,2,10,639,714,1353,1422
3404-001,2017,12,2,11,660,762,1422,1353
3404-001,2017,12,2,12,613,697,1310,1422
3404-001,2017,12,2,13,596,684,1280,1310
3404-001,2017,12,2,14,641,674,1315,1280
3404-001,2017,12,2,15,689,626,1315,1315
3404-001,2017,12,2,16,776,650,1426,1315
3404-001,2017,12,2,17,843,635,1478,1426
3404-001,2017,12,2,18,1121,619,1740,1478
3404-001,2017,12,2,19,748,472,1220,1740
3404-001,2017,12,2,20,390,337,727,1220
3404-001,2017,12,2,21,278,252,530,727
3404-001,2017,12,2,22,204,197,401,530
3404-001,2017,12,2,23,132,135,267,401
3404-001,2017,12,2,24,103,84,187,267
3404-001,2017,12,3,1,80,73,153,187
3404-001,2017,12,3,2,51,48,99,153
3404-001,2017,12,3,3,34,20,54,99
3404-001,2017,12,3,4,30,42,72,54
3404-001,2017,12,3,5,44,27,71,72
3404-001,2017,12,3,6,57,70,127,71
3404-001,2017,12,3,7,109,151,260,127
3404-001,2017,12,3,8,189,271,460,260
3404-001,2017,12,3,9,295,323,618,460
3404-001,2017,12,3,10,337,346,683,618
3404-001,2017,12,3,11,403,401,804,683
3404-001,2017,12,3,12,365,411,776,804
3404-001,2017,12,3,13,433,443,876,776
3404-001,2017,12,3,14,497,410,907,876
3404-001,2017,12,3,15,586,449,1035,907
3404-001,2017,12,3,16,607,477,1084,1035
3404-001,2017,12,3,17,674,444,1118,1084
3404-001,2017,12,3,18,676,450,1126,1118
3404-001,2017,12,3,19,477,416,893,1126
3404-001,2017,12,3,20,318,305,623,893
3404-001,2017,12,3,21,262,288,550,623
3404-001,2017,12,3,22,183,227,410,550
3404-001,2017,12,3,23,134,196,330,410
3404-001,2017,12,3,24,89,126,215,330
3404-001,2017,12,4,1,58,81,139,215
3404-001,2017,12,4,2,33,46,79,139
3404-001,2017,12,4,3,34,41,75,79
3404-001,2017,12,4,4,36,43,79,75
3404-001,2017,12,4,5,71,70,141,79
3404-001,2017,12,4,6,134,243,377,141
3404-001,2017,12,4,7,350,688,1038,377
3404-001,2017,12,4,8,794,2018,2812,1038
3404-001,2017,12,4,9,961,1665,2626,2812
3404-001,2017,12,4,10,837,851,1688,2626
3404-001,2017,12,4,11,848,838,1686,1688
3404-001,2017,12,4,12,731,768,1499,1686
3404-001,2017,12,4,13,676,686,1362,1499
3404-001,2017,12,4,14,780,714,1494,1362
3404-001,2017,12,4,15,894,844,1738,1494
3404-001,2017,12,4,16,994,807,1801,1738
3404-001,2017,12,4,17,997,783,1780,1801
3404-001,2017,12,4,18,1356,744,2100,1780
3404-001,2017,12,4,19,1202,669,1871,2100
3404-001,2017,12,4,20,808,481,1289,1871
3404-001,2017,12,4,21,746,382,1128,1289
3404-001,2017,12,4,22,445,250,695,1128
3404-001,2017,12,4,23,183,159,342,695
3404-001,2017,12,4,24,128,101,229,342
3404-001,2017,12,5,1,91,75,166,229
3404-001,2017,12,5,2,61,36,97,166
3404-001,2017,12,5,3,44,38,82,97
3404-001,2017,12,5,4,52,35,87,82
3404-001,2017,12,5,5,69,81,150,87
3404-001,2017,12,5,6,136,192,328,150
3404-001,2017,12,5,7,311,641,952,328
3404-001,2017,12,5,8,696,1908,2604,952
3404-001,2017,12,5,9,1076,1425,2501,2604
3404-001,2017,12,5,10,857,891,1748,2501
3404-001,2017,12,5,11,814,885,1699,1748
3404-001,2017,12,5,12,845,786,1631,1699
3404-001,2017,12,5,13,709,638,1347,1631
3404-001,2017,12,5,14,789,797,1586,1347
3404-001,2017,12,5,15,944,842,1786,1586
3404-001,2017,12,5,16,950,842,1792,1786
3404-001,2017,12,5,17,963,797,1760,1792
3404-001,2017,12,5,18,1399,756,2155,1760
3404-001,2017,12,5,19,1193,656,1849,2155
3404-001,2017,12,5,20,762,474,1236,1849
3404-001,2017,12,5,21,680,336,1016,1236
3404-001,2017,12,5,22,393,248,641,1016
3404-001,2017,12,5,23,241,182,423,641
3404-001,2017,12,5,24,135,113,248,423
3404-001,2017,12,6,1,101,83,184,248
3404-001,2017,12,6,2,68,53,121,184
3404-001,2017,12,6,3,34,30,64,121
3404-001,2017,12,6,4,30,54,84,64
3404-001,2017,12,6,5,50,44,94,84
3404-001,2017,12,6,6,79,140,219,94
3404-001,2017,12,6,7,241,623,864,219
3404-001,2017,12,6,8,377,1925,2302,864
3404-001,2017,12,6,9,676,1559,2235,2302
3404-001,2017,12,6,10,680,852,1532,2235
3404-001,2017,12,6,11,751,844,1595,1532
3404-001,2017,12,6,12,783,812,1595,1595
3404-001,2017,12,6,13,623,664,1287,1595
3404-001,2017,12,6,14,785,779,1564,1287
3404-001,2017,12,6,15,847,836,1683,1564
3404-001,2017,12,6,16,931,856,1787,1683
3404-001,2017,12,6,17,877,732,1609,1787
3404-001,2017,12,6,18,1495,823,2318,1609
3404-001,2017,12,6,19,1324,686,2010,2318
3404-001,2017,12,6,20,751,530,1281,2010
3404-001,2017,12,6,21,545,364,909,1281
3404-001,2017,12,6,22,350,231,581,909
3404-001,2017,12,6,23,145,124,269,581
3404-001,2017,12,6,24,97,57,154,269
3404-001,2017,12,7,1,79,37,116,154
3404-001,2017,12,7,2,62,36,98,116
3404-001,2017,12,7,3,44,26,70,98
3404-001,2017,12,7,4,47,46,93,70
3404-001,2017,12,7,5,67,58,125,93
3404-001,2017,12,7,6,109,201,310,125
3404-001,2017,12,7,7,272,562,834,310
3404-001,2017,12,7,8,714,1834,2548,834
3404-001,2017,12,7,9,956,1518,2474,2548
3404-001,2017,12,7,10,781,797,1578,2474
3404-001,2017,12,7,11,820,885,1705,1578
3404-001,2017,12,7,12,812,837,1649,1705
3404-001,2017,12,7,13,642,714,1356,1649
3404-001,2017,12,7,14,839,831,1670,1356
3404-001,2017,12,7,15,884,889,1773,1670
3404-001,2017,12,7,16,911,875,1786,1773
3404-001,2017,12,7,17,973,751,1724,1786
3404-001,2017,12,7,18,1389,776,2165,1724
3404-001,2017,12,7,19,1320,658,1978,2165
3404-001,2017,12,7,20,744,480,1224,1978
3404-001,2017,12,7,21,703,324,1027,1224
3404-001,2017,12,7,22,365,258,623,1027
3404-001,2017,12,7,23,203,151,354,623
3404-001,2017,12,7,24,137,95,232,354
3404-001,2017,12,8,1,101,70,171,232
3404-001,2017,12,8,2,56,52,108,171
3404-001,2017,12,8,3,59,31,90,108
3404-001,2017,12,8,4,47,58,105,90
3404-001,2017,12,8,5,84,74,158,105
3404-001,2017,12,8,6,117,209,326,158
3404-001,2017,12,8,7,301,607,908,326
3404-001,2017,12,8,8,717,1923,2640,908
3404-001,2017,12,8,9,959,1528,2487,2640
3404-001,2017,12,8,10,893,849,1742,2487
3404-001,2017,12,8,11,802,888,1690,1742
3404-001,2017,12,8,12,791,789,1580,1690
3404-001,2017,12,8,13,739,700,1439,1580
3404-001,2017,12,8,14,804,844,1648,1439
3404-001,2017,12,8,15,961,887,1848,1648
3404-001,2017,12,8,16,973,877,1850,1848
3404-001,2017,12,8,17,1037,805,1842,1850
3404-001,2017,12,8,18,1743,783,2526,1842
3404-001,2017,12,8,19,1557,779,2336,2526
3404-001,2017,12,8,20,830,540,1370,2336
3404-001,2017,12,8,21,648,375,1023,1370
3404-001,2017,12,8,22,375,248,623,1023
3404-001,2017,12,8,23,208,171,379,623
3404-001,2017,12,8,24,118,108,226,379
3404-001,2017,12,9,1,85,96,181,226
3404-001,2017,12,9,2,53,56,109,181
3404-001,2017,12,9,3,41,37,78,109
3404-001,2017,12,9,4,37,49,86,78
3404-001,2017,12,9,5,93,59,152,86
3404-001,2017,12,9,6,139,117,256,152
3404-001,2017,12,9,7,191,375,566,256
3404-001,2017,12,9,8,380,755,1135,566
3404-001,2017,12,9,9,628,826,1454,1135
3404-001,2017,12,9,10,573,634,1207,1454
3404-001,2017,12,9,11,661,695,1356,1207
3404-001,2017,12,9,12,613,668,1281,1356
3404-001,2017,12,9,13,601,609,1210,1281
3404-001,2017,12,9,14,593,578,1171,1210
3404-001,2017,12,9,15,660,595,1255,1171
3404-001,2017,12,9,16,744,584,1328,1255
3404-001,2017,12,9,17,832,552,1384,1328
3404-001,2017,12,9,18,1079,652,1731,1384
3404-001,2017,12,9,19,667,460,1127,1731
3404-001,2017,12,9,20,329,330,659,1127
3404-001,2017,12,9,21,221,236,457,659
3404-001,2017,12,9,22,197,186,383,457
3404-001,2017,12,9,23,109,154,263,383
3404-001,2017,12,9,24,107,92,199,263
3404-001,2017,12,10,1,70,83,153,199
3404-001,2017,12,10,2,55,41,96,153
3404-001,2017,12,10,3,54,41,95,96
3404-001,2017,12,10,4,34,36,70,95
3404-001,2017,12,10,5,41,41,82,70
3404-001,2017,12,10,6,47,48,95,82
3404-001,2017,12,10,7,84,136,220,95
3404-001,2017,12,10,8,176,233,409,220
3404-001,2017,12,10,9,287,291,578,409
3404-001,2017,12,10,10,289,299,588,578
3404-001,2017,12,10,11,341,402,743,588
3404-001,2017,12,10,12,379,366,745,743
3404-001,2017,12,10,13,385,369,754,745
3404-001,2017,12,10,14,399,467,866,754
3404-001,2017,12,10,15,465,439,904,866
3404-001,2017,12,10,16,586,452,1038,904
3404-001,2017,12,10,17,545,442,987,1038
3404-001,2017,12,10,18,531,409,940,987
3404-001,2017,12,10,19,379,366,745,940
3404-001,2017,12,10,20,290,323,613,745
3404-001,2017,12,10,21,229,257,486,613
3404-001,2017,12,10,22,190,203,393,486
3404-001,2017,12,10,23,121,178,299,393
3404-001,2017,12,10,24,65,111,176,299
3404-001,2017,12,11,1,48,72,120,176
3404-001,2017,12,11,2,33,44,77,120
3404-001,2017,12,11,3,31,43,74,77
3404-001,2017,12,11,4,32,29,61,74
3404-001,2017,12,11,5,55,63,118,61
3404-001,2017,12,11,6,119,222,341,118
3404-001,2017,12,11,7,311,690,1001,341
3404-001,2017,12,11,8,757,1969,2726,1001
3404-001,2017,12,11,9,922,1518,2440,2726
3404-001,2017,12,11,10,783,921,1704,2440
3404-001,2017,12,11,11,837,847,1684,1704
3404-001,2017,12,11,12,760,727,1487,1684
3404-001,2017,12,11,13,684,623,1307,1487
3404-001,2017,12,11,14,777,816,1593,1307
3404-001,2017,12,11,15,857,839,1696,1593
3404-001,2017,12,11,16,896,790,1686,1696
3404-001,2017,12,11,17,897,752,1649,1686
3404-001,2017,12,11,18,1412,737,2149,1649
3404-001,2017,12,11,19,1153,608,1761,2149
3404-001,2017,12,11,20,746,475,1221,1761
3404-001,2017,12,11,21,655,300,955,1221
3404-001,2017,12,11,22,367,191,558,955
3404-001,2017,12,11,23,200,134,334,558
3404-001,2017,12,11,24,114,109,223,334
3404-001,2017,12,12,1,77,75,152,223
3404-001,2017,12,12,2,54,57,111,152
3404-001,2017,12,12,3,33,33,66,111
3404-001,2017,12,12,4,34,54,88,66
3404-001,2017,12,12,5,63,59,122,88
3404-001,2017,12,12,6,100,172,272,122
3404-001,2017,12,12,7,266,563,829,272
3404-001,2017,12,12,8,686,1816,2502,829
3404-001,2017,12,12,9,1022,1492,2514,2502
3404-001,2017,12,12,10,766,776,1542,2514
3404-001,2017,12,12,11,802,818,1620,1542
3404-001,2017,12,12,12,766,806,1572,1620
3404-001,2017,12,12,13,684,700,1384,1572
3404-001,2017,12,12,14,729,756,1485,1384
3404-001,2017,12,12,15,969,791,1760,1485
3404-001,2017,12,12,16,889,810,1699,1760
3404-001,2017,12,12,17,897,768,1665,1699
3404-001,2017,12,12,18,1300,776,2076,1665
3404-001,2017,12,12,19,1252,570,1822,2076
3404-001,2017,12,12,20,720,452,1172,1822
3404-001,2017,12,12,21,688,331,1019,1172
3404-001,2017,12,12,22,392,247,639,1019
3404-001,2017,12,12,23,195,156,351,639
3404-001,2017,12,12,24,107,81,188,351
3404-001,2017,12,13,1,104,86,190,188
3404-001,2017,12,13,2,64,58,122,190
3404-001,2017,12,13,3,38,42,80,122
3404-001,2017,12,13,4,40,54,94,80
3404-001,2017,12,13,5,62,60,122,94
3404-001,2017,12,13,6,112,182,294,122
3404-001,2017,12,13,7,255,550,805,294
3404-001,2017,12,13,8,691,1874,2565,805
3404-001,2017,12,13,9,982,1478,2460,2565
3404-001,2017,12,13,10,812,790,1602,2460
3404-001,2017,12,13,11,809,750,1559,1602
3404-001,2017,12,13,12,798,771,1569,1559
3404-001,2017,12,13,13,708,669,1377,1569
3404-001,2017,12,13,14,768,772,1540,1377
3404-001,2017,12,13,15,915,825,1740,1540
3404-001,2017,12,13,16,871,793,1664,1740
3404-001,2017,12,13,17,1002,711,1713,1664
3404-001,2017,12,13,18,1595,812,2407,1713
3404-001,2017,12,13,19,1268,689,1957,2407
3404-001,2017,12,13,20,719,477,1196,1957
3404-001,2017,12,13,21,550,324,874,1196
3404-001,2017,12,13,22,384,232,616,874
3404-001,2017,12,13,23,197,158,355,616
3404-001,2017,12,13,24,147,99,246,355
3404-001,2017,12,14,1,96,70,166,246
3404-001,2017,12,14,2,57,46,103,166
3404-001,2017,12,14,3,46,36,82,103
3404-001,2017,12,14,4,38,48,86,82
3404-001,2017,12,14,5,68,58,126,86
3404-001,2017,12,14,6,92,189,281,126
3404-001,2017,12,14,7,283,607,890,281
3404-001,2017,12,14,8,702,1875,2577,890
3404-001,2017,12,14,9,977,1462,2439,2577
3404-001,2017,12,14,10,807,885,1692,2439
3404-001,2017,12,14,11,845,847,1692,1692
3404-001,2017,12,14,12,820,707,1527,1692
3404-001,2017,12,14,13,720,689,1409,1527
3404-001,2017,12,14,14,804,736,1540,1409
3404-001,2017,12,14,15,873,848,1721,1540
3404-001,2017,12,14,16,932,755,1687,1721
3404-001,2017,12,14,17,949,814,1763,1687
3404-001,2017,12,14,18,1452,760,2212,1763
3404-001,2017,12,14,19,1230,647,1877,2212
3404-001,2017,12,14,20,687,466,1153,1877
3404-001,2017,12,14,21,682,336,1018,1153
3404-001,2017,12,14,22,401,229,630,1018
3404-001,2017,12,14,23,217,159,376,630
3404-001,2017,12,14,24,118,107,225,376
3404-001,2017,12,15,1,101,69,170,225
3404-001,2017,12,15,2,58,56,114,170
3404-001,2017,12,15,3,47,49,96,114
3404-001,2017,12,15,4,37,47,84,96
3404-001,2017,12,15,5,74,72,146,84
3404-001,2017,12,15,6,128,203,331,146
3404-001,2017,12,15,7,290,588,878,331
3404-001,2017,12,15,8,718,1867,2585,878
3404-001,2017,12,15,9,969,1476,2445,2585
3404-001,2017,12,15,10,798,886,1684,2445
3404-001,2017,12,15,11,855,866,1721,1684
3404-001,2017,12,15,12,822,771,1593,1721
3404-001,2017,12,15,13,732,694,1426,1593
3404-001,2017,12,15,14,870,760,1630,1426
3404-001,2017,12,15,15,963,867,1830,1630
3404-001,2017,12,15,16,957,869,1826,1830
3404-001,2017,12,15,17,1086,798,1884,1826
3404-001,2017,12,15,18,1765,818,2583,1884
3404-001,2017,12,15,19,1562,735,2297,2583
3404-001,2017,12,15,20,810,571,1381,2297
3404-001,2017,12,15,21,673,355,1028,1381
3404-001,2017,12,15,22,395,252,647,1028
3404-001,2017,12,15,23,207,186,393,647
3404-001,2017,12,15,24,137,122,259,393
3404-001,2017,12,16,1,88,80,168,259
3404-001,2017,12,16,2,51,59,110,168
3404-001,2017,12,16,3,56,47,103,110
3404-001,2017,12,16,4,47,44,91,103
3404-001,2017,12,16,5,64,50,114,91
3404-001,2017,12,16,6,85,117,202,114
3404-001,2017,12,16,7,191,301,492,202
3404-001,2017,12,16,8,413,690,1103,492
3404-001,2017,12,16,9,590,734,1324,1103
3404-001,2017,12,16,10,596,603,1199,1324
3404-001,2017,12,16,11,627,627,1254,1199
3404-001,2017,12,16,12,633,631,1264,1254
3404-001,2017,12,16,13,598,567,1165,1264
3404-001,2017,12,16,14,549,549,1098,1165
3404-001,2017,12,16,15,677,587,1264,1098
3404-001,2017,12,16,16,707,589,1296,1264
3404-001,2017,12,16,17,761,592,1353,1296
3404-001,2017,12,16,18,1000,591,1591,1353
3404-001,2017,12,16,19,589,472,1061,1591
3404-001,2017,12,16,20,349,328,677,1061
3404-001,2017,12,16,21,258,231,489,677
3404-001,2017,12,16,22,211,201,412,489
3404-001,2017,12,16,23,108,138,246,412
3404-001,2017,12,16,24,96,102,198,246
3404-001,2017,12,17,1,67,64,131,198
3404-001,2017,12,17,2,51,38,89,131
3404-001,2017,12,17,3,40,35,75,89
3404-001,2017,12,17,4,30,43,73,75
3404-001,2017,12,17,5,46,32,78,73
3404-001,2017,12,17,6,47,51,98,78
3404-001,2017,12,17,7,72,129,201,98
3404-001,2017,12,17,8,170,250,420,201
3404-001,2017,12,17,9,300,268,568,420
3404-001,2017,12,17,10,290,265,555,568
3404-001,2017,12,17,11,351,351,702,555
3404-001,2017,12,17,12,362,398,760,702
3404-001,2017,12,17,13,397,403,800,760
3404-001,2017,12,17,14,410,440,850,800
3404-001,2017,12,17,15,527,459,986,850
3404-001,2017,12,17,16,548,445,993,986
3404-001,2017,12,17,17,601,476,1077,993
3404-001,2017,12,17,18,534,428,962,1077
3404-001,2017,12,17,19,344,386,730,962
3404-001,2017,12,17,20,272,317,589,730
3404-001,2017,12,17,21,259,270,529,589
3404-001,2017,12,17,22,174,222,396,529
3404-001,2017,12,17,23,117,187,304,396
3404-001,2017,12,17,24,85,137,222,304
3404-001,2017,12,18,1,54,78,132,222
3404-001,2017,12,18,2,33,54,87,132
3404-001,2017,12,18,3,26,25,51,87
3404-001,2017,12,18,4,32,39,71,51
3404-001,2017,12,18,5,70,68,138,71
3404-001,2017,12,18,6,125,209,334,138
3404-001,2017,12,18,7,275,629,904,334
3404-001,2017,12,18,8,656,1959,2615,904
3404-001,2017,12,18,9,979,1452,2431,2615
3404-001,2017,12,18,10,720,833,1553,2431
3404-001,2017,12,18,11,751,791,1542,1553
3404-001,2017,12,18,12,782,729,1511,1542
3404-001,2017,12,18,13,625,601,1226,1511
3404-001,2017,12,18,14,804,794,1598,1226
3404-001,2017,12,18,15,879,802,1681,1598
3404-001,2017,12,18,16,883,786,1669,1681
3404-001,2017,12,18,17,891,799,1690,1669
3404-001,2017,12,18,18,1323,728,2051,1690
3404-001,2017,12,18,19,1178,606,1784,2051
3404-001,2017,12,18,20,748,476,1224,1784
3404-001,2017,12,18,21,707,323,1030,1224
3404-001,2017,12,18,22,407,240,647,1030
3404-001,2017,12,18,23,231,153,384,647
3404-001,2017,12,18,24,156,101,257,384
3404-001,2017,12,19,1,79,78,157,257
3404-001,2017,12,19,2,41,57,98,157
3404-001,2017,12,19,3,46,38,84,98
3404-001,2017,12,19,4,46,43,89,84
3404-001,2017,12,19,5,67,71,138,89
3404-001,2017,12,19,6,107,174,281,138
3404-001,2017,12,19,7,297,526,823,281
3404-001,2017,12,19,8,694,1785,2479,823
3404-001,2017,12,19,9,964,1516,2480,2479
3404-001,2017,12,19,10,839,820,1659,2480
3404-001,2017,12,19,11,786,810,1596,1659
3404-001,2017,12,19,12,763,752,1515,1596
3404-001,2017,12,19,13,645,698,1343,1515
3404-001,2017,12,19,14,848,780,1628,1343
3404-001,2017,12,19,15,925,811,1736,1628
3404-001,2017,12,19,16,891,804,1695,1736
3404-001,2017,12,19,17,1004,793,1797,1695
3404-001,2017,12,19,18,1322,723,2045,1797
3404-001,2017,12,19,19,1221,667,1888,2045
3404-001,2017,12,19,20,751,443,1194,1888
3404-001,2017,12,19,21,740,328,1068,1194
3404-001,2017,12,19,22,415,249,664,1068
3404-001,2017,12,19,23,215,151,366,664
3404-001,2017,12,19,24,133,122,255,366
3404-001,2017,12,20,1,91,89,180,255
3404-001,2017,12,20,2,62,53,115,180
3404-001,2017,12,20,3,41,44,85,115
3404-001,2017,12,20,4,50,41,91,85
3404-001,2017,12,20,5,59,78,137,91
3404-001,2017,12,20,6,122,185,307,137
3404-001,2017,12,20,7,304,584,888,307
3404-001,2017,12,20,8,643,1865,2508,888
3404-001,2017,12,20,9,1000,1492,2492,2508
3404-001,2017,12,20,10,844,864,1708,2492
3404-001,2017,12,20,11,854,854,1708,1708
3404-001,2017,12,20,12,810,803,1613,1708
3404-001,2017,12,20,13,703,644,1347,1613
3404-001,2017,12,20,14,770,777,1547,1347
3404-001,2017,12,20,15,948,834,1782,1547
3404-001,2017,12,20,16,888,770,1658,1782
3404-001,2017,12,20,17,978,772,1750,1658
3404-001,2017,12,20,18,1563,748,2311,1750
3404-001,2017,12,20,19,1276,588,1864,2311
3404-001,2017,12,20,20,659,451,1110,1864
3404-001,2017,12,20,21,530,328,858,1110
3404-001,2017,12,20,22,303,221,524,858
3404-001,2017,12,20,23,170,146,316,524
3404-001,2017,12,20,24,110,110,220,316
3404-001,2017,12,21,1,110,67,177,220
3404-001,2017,12,21,2,54,51,105,177
3404-001,2017,12,21,3,39,36,75,105
3404-001,2017,12,21,4,41,41,82,75
3404-001,2017,12,21,5,61,56,117,82
3404-001,2017,12,21,6,94,162,256,117
3404-001,2017,12,21,7,256,563,819,256
3404-001,2017,12,21,8,612,1747,2359,819
3404-001,2017,12,21,9,888,1366,2254,2359
3404-001,2017,12,21,10,745,729,1474,2254
3404-001,2017,12,21,11,745,790,1535,1474
3404-001,2017,12,21,12,766,757,1523,1535
3404-001,2017,12,21,13,683,626,1309,1523
3404-001,2017,12,21,14,754,761,1515,1309
3404-001,2017,12,21,15,896,816,1712,1515
3404-001,2017,12,21,16,938,762,1700,1712
3404-001,2017,12,21,17,965,730,1695,1700
3404-001,2017,12,21,18,1450,741,2191,1695
3404-001,2017,12,21,19,1215,639,1854,2191
3404-001,2017,12,21,20,711,443,1154,1854
3404-001,2017,12,21,21,647,329,976,1154
3404-001,2017,12,21,22,409,247,656,976
3404-001,2017,12,21,23,229,145,374,656
3404-001,2017,12,21,24,164,109,273,374
3404-001,2017,12,22,1,98,90,188,273
3404-001,2017,12,22,2,63,48,111,188
3404-001,2017,12,22,3,45,44,89,111
3404-001,2017,12,22,4,56,37,93,89
3404-001,2017,12,22,5,64,68,132,93
3404-001,2017,12,22,6,130,196,326,132
3404-001,2017,12,22,7,275,562,837,326
3404-001,2017,12,22,8,690,1770,2460,837
3404-001,2017,12,22,9,954,1423,2377,2460
3404-001,2017,12,22,10,818,876,1694,2377
3404-001,2017,12,22,11,866,837,1703,1694
3404-001,2017,12,22,12,802,760,1562,1703
3404-001,2017,12,22,13,760,679,1439,1562
3404-001,2017,12,22,14,876,803,1679,1439
3404-001,2017,12,22,15,924,901,1825,1679
3404-001,2017,12,22,16,988,821,1809,1825
3404-001,2017,12,22,17,1105,817,1922,1809
3404-001,2017,12,22,18,1808,877,2685,1922
3404-001,2017,12,22,19,1528,740,2268,2685
3404-001,2017,12,22,20,804,555,1359,2268
3404-001,2017,12,22,21,644,339,983,1359
3404-001,2017,12,22,22,366,285,651,983
3404-001,2017,12,22,23,199,188,387,651
3404-001,2017,12,22,24,163,125,288,387
3404-001,2017,12,23,1,116,95,211,288
3404-001,2017,12,23,2,78,73,151,211
3404-001,2017,12,23,3,65,43,108,151
3404-001,2017,12,23,4,63,45,108,108
3404-001,2017,12,23,5,72,66,138,108
3404-001,2017,12,23,6,114,162,276,138
3404-001,2017,12,23,7,205,359,564,276
3404-001,2017,12,23,8,426,678,1104,564
3404-001,2017,12,23,9,579,714,1293,1104
3404-001,2017,12,23,10,603,588,1191,1293
3404-001,2017,12,23,11,606,618,1224,1191
3404-001,2017,12,23,12,610,699,1309,1224
3404-001,2017,12,23,13,607,592,1199,1309
3404-001,2017,12,23,14,574,606,1180,1199
3404-001,2017,12,23,15,686,627,1313,1180
3404-001,2017,12,23,16,705,632,1337,1313
3404-001,2017,12,23,17,793,540,1333,1337
3404-001,2017,12,23,18,1013,588,1601,1333
3404-001,2017,12,23,19,626,509,1135,1601
3404-001,2017,12,23,20,342,337,679,1135
3404-001,2017,12,23,21,247,250,497,679
3404-001,2017,12,23,22,206,191,397,497
3404-001,2017,12,23,23,123,136,259,397
3404-001,2017,12,23,24,119,81,200,259
3404-001,2017,12,24,1,94,72,166,200
3404-001,2017,12,24,2,51,52,103,166
3404-001,2017,12,24,3,44,29,73,103
3404-001,2017,12,24,4,26,28,54,73
3404-001,2017,12,24,5,38,22,60,54
3404-001,2017,12,24,6,55,49,104,60
3404-001,2017,12,24,7,87,113,200,104
3404-001,2017,12,24,8,142,183,325,200
3404-001,2017,12,24,9,244,234,478,325
3404-001,2017,12,24,10,258,265,523,478
3404-001,2017,12,24,11,300,300,600,523
3404-001,2017,12,24,12,379,333,712,600
3404-001,2017,12,24,13,319,376,695,712
3404-001,2017,12,24,14,388,388,776,695
3404-001,2017,12,24,15,425,405,830,776
3404-001,2017,12,24,16,515,401,916,830
3404-001,2017,12,24,17,454,356,810,916
3404-001,2017,12,24,18,422,343,765,810
3404-001,2017,12,24,19,341,293,634,765
3404-001,2017,12,24,20,209,256,465,634
3404-001,2017,12,24,21,174,164,338,465
3404-001,2017,12,24,22,151,155,306,338
3404-001,2017,12,24,23,118,119,237,306
3404-001,2017,12,24,24,70,89,159,237
3404-001,2017,12,25,1,51,60,111,159
3404-001,2017,12,25,2,39,46,85,111
3404-001,2017,12,25,3,21,29,50,85
3404-001,2017,12,25,4,31,19,50,50
3404-001,2017,12,25,5,40,33,73,50
3404-001,2017,12,25,6,61,93,154,73
3404-001,2017,12,25,7,110,214,324,154
3404-001,2017,12,25,8,218,373,591,324
3404-001,2017,12,25,9,234,304,538,591
3404-001,2017,12,25,10,300,334,634,538
3404-001,2017,12,25,11,377,388,765,634
3404-001,2017,12,25,12,394,416,810,765
3404-001,2017,12,25,13,412,445,857,810
3404-001,2017,12,25,14,501,506,1007,857
3404-001,2017,12,25,15,594,565,1159,1007
3404-001,2017,12,25,16,515,469,984,1159
3404-001,2017,12,25,17,568,446,1014,984
3404-001,2017,12,25,18,736,465,1201,1014
3404-001,2017,12,25,19,422,352,774,1201
3404-001,2017,12,25,20,278,320,598,774
3404-001,2017,12,25,21,245,282,527,598
3404-001,2017,12,25,22,193,251,444,527
3404-001,2017,12,25,23,105,195,300,444
3404-001,2017,12,25,24,78,134,212,300
3404-001,2017,12,26,1,70,85,155,212
3404-001,2017,12,26,2,33,56,89,155
3404-001,2017,12,26,3,32,33,65,89
3404-001,2017,12,26,4,35,39,74,65
3404-001,2017,12,26,5,55,63,118,74
3404-001,2017,12,26,6,107,187,294,118
3404-001,2017,12,26,7,253,643,896,294
3404-001,2017,12,26,8,696,1922,2618,896
3404-001,2017,12,26,9,854,1469,2323,2618
3404-001,2017,12,26,10,719,808,1527,2323
3404-001,2017,12,26,11,803,809,1612,1527
3404-001,2017,12,26,12,750,731,1481,1612
3404-001,2017,12,26,13,717,686,1403,1481
3404-001,2017,12,26,14,810,753,1563,1403
3404-001,2017,12,26,15,880,812,1692,1563
3404-001,2017,12,26,16,884,759,1643,1692
3404-001,2017,12,26,17,855,739,1594,1643
3404-001,2017,12,26,18,1344,720,2064,1594
3404-001,2017,12,26,19,1224,618,1842,2064
3404-001,2017,12,26,20,698,477,1175,1842
3404-001,2017,12,26,21,676,306,982,1175
3404-001,2017,12,26,22,409,208,617,982
3404-001,2017,12,26,23,250,144,394,617
3404-001,2017,12,26,24,137,96,233,394
3404-001,2017,12,27,1,106,85,191,233
3404-001,2017,12,27,2,55,46,101,191
3404-001,2017,12,27,3,47,50,97,101
3404-001,2017,12,27,4,41,35,76,97
3404-001,2017,12,27,5,83,66,149,76
3404-001,2017,12,27,6,112,169,281,149
3404-001,2017,12,27,7,250,520,770,281
3404-001,2017,12,27,8,676,1909,2585,770
3404-001,2017,12,27,9,941,1451,2392,2585
3404-001,2017,12,27,10,723,789,1512,2392
3404-001,2017,12,27,11,784,818,1602,1512
3404-001,2017,12,27,12,806,704,1510,1602
3404-001,2017,12,27,13,642,638,1280,1510
3404-001,2017,12,27,14,765,786,1551,1280
3404-001,2017,12,27,15,804,814,1618,1551
3404-001,2017,12,27,16,920,853,1773,1618
3404-001,2017,12,27,17,910,699,1609,1773
3404-001,2017,12,27,18,1524,683,2207,1609
3404-001,2017,12,27,19,1223,636,1859,2207
3404-001,2017,12,27,20,700,423,1123,1859
3404-001,2017,12,27,21,585,322,907,1123
3404-001,2017,12,27,22,396,242,638,907
3404-001,2017,12,27,23,208,151,359,638
3404-001,2017,12,27,24,119,121,240,359
3404-001,2017,12,28,1,90,62,152,240
3404-001,2017,12,28,2,56,56,112,152
3404-001,2017,12,28,3,41,40,81,112
3404-001,2017,12,28,4,53,41,94,81
3404-001,2017,12,28,5,63,76,139,94
3404-001,2017,12,28,6,126,175,301,139
3404-001,2017,12,28,7,282,579,861,301
3404-001,2017,12,28,8,660,1853,2513,861
3404-001,2017,12,28,9,916,1412,2328,2513
3404-001,2017,12,28,10,714,822,1536,2328
3404-001,2017,12,28,11,785,800,1585,1536
3404-001,2017,12,28,12,826,810,1636,1585
3404-001,2017,12,28,13,690,651,1341,1636
3404-001,2017,12,28,14,812,784,1596,1341
3404-001,2017,12,28,15,925,782,1707,1596
3404-001,2017,12,28,16,904,812,1716,1707
3404-001,2017,12,28,17,989,806,1795,1716
3404-001,2017,12,28,18,1418,717,2135,1795
3404-001,2017,12,28,19,1206,574,1780,2135
3404-001,2017,12,28,20,670,444,1114,1780
3404-001,2017,12,28,21,616,313,929,1114
3404-001,2017,12,28,22,436,231,667,929
3404-001,2017,12,28,23,225,159,384,667
3404-001,2017,12,28,24,128,101,229,384
3404-001,2017,12,29,1,108,91,199,229
3404-001,2017,12,29,2,68,53,121,199
3404-001,2017,12,29,3,55,59,114,121
3404-001,2017,12,29,4,49,53,102,114
3404-001,2017,12,29,5,60,71,131,102
3404-001,2017,12,29,6,114,150,264,131
3404-001,2017,12,29,7,247,526,773,264
3404-001,2017,12,29,8,625,1679,2304,773
3404-001,2017,12,29,9,860,1262,2122,2304
3404-001,2017,12,29,10,758,785,1543,2122
3404-001,2017,12,29,11,760,823,1583,1543
3404-001,2017,12,29,12,729,772,1501,1583
3404-001,2017,12,29,13,718,671,1389,1501
3404-001,2017,12,29,14,808,697,1505,1389
3404-001,2017,12,29,15,959,796,1755,1505
3404-001,2017,12,29,16,1031,746,1777,1755
3404-001,2017,12,29,17,1158,716,1874,1777
3404-001,2017,12,29,18,1603,716,2319,1874
3404-001,2017,12,29,19,1241,620,1861,2319
3404-001,2017,12,29,20,610,442,1052,1861
3404-001,2017,12,29,21,430,325,755,1052
3404-001,2017,12,29,22,317,228,545,755
3404-001,2017,12,29,23,199,151,350,545
3404-001,2017,12,29,24,115,90,205,350
3404-001,2017,12,30,1,90,91,181,205
3404-001,2017,12,30,2,71,53,124,181
3404-001,2017,12,30,3,57,48,105,124
3404-001,2017,12,30,4,49,46,95,105
3404-001,2017,12,30,5,71,50,121,95
3404-001,2017,12,30,6,110,120,230,121
3404-001,2017,12,30,7,171,262,433,230
3404-001,2017,12,30,8,322,559,881,433
3404-001,2017,12,30,9,446,589,1035,881
3404-001,2017,12,30,10,500,521,1021,1035
3404-001,2017,12,30,11,550,535,1085,1021
3404-001,2017,12,30,12,566,577,1143,1085
3404-001,2017,12,30,13,512,591,1103,1143
3404-001,2017,12,30,14,592,559,1151,1103
3404-001,2017,12,30,15,630,607,1237,1151
3404-001,2017,12,30,16,697,558,1255,1237
3404-001,2017,12,30,17,736,577,1313,1255
3404-001,2017,12,30,18,771,591,1362,1313
3404-001,2017,12,30,19,518,429,947,1362
3404-001,2017,12,30,20,300,282,582,947
3404-001,2017,12,30,21,278,208,486,582
3404-001,2017,12,30,22,185,149,334,486
3404-001,2017,12,30,23,93,125,218,334
3404-001,2017,12,30,24,78,57,135,218
3404-001,2017,12,31,1,67,54,121,135
3404-001,2017,12,31,2,40,35,75,121
3404-001,2017,12,31,3,43,40,83,75
3404-001,2017,12,31,4,22,39,61,83
3404-001,2017,12,31,5,27,16,43,61
3404-001,2017,12,31,6,43,30,73,43
3404-001,2017,12,31,7,56,94,150,73
3404-001,2017,12,31,8,138,187,325,150
3404-001,2017,12,31,9,186,168,354,325
3404-001,2017,12,31,10,219,251,470,354
3404-001,2017,12,31,11,338,336,674,470
3404-001,2017,12,31,12,349,419,768,674
3404-001,2017,12,31,13,349,449,798,768
3404-001,2017,12,31,14,363,465,828,798
3404-001,2017,12,31,15,495,508,1003,828
3404-001,2017,12,31,16,511,498,1009,1003
3404-001,2017,12,31,17,511,466,977,1009
3404-001,2017,12,31,18,573,426,999,977
3404-001,2017,12,31,19,439,326,765,999
3404-001,2017,12,31,20,290,250,540,765
3404-001,2017,12,31,21,187,184,371,540
3404-001,2017,12,31,22,172,162,334,371
3404-001,2017,12,31,23,132,116,248,334
3404-001,2017,12,31,24,87,93,180,248
3404-001,2018,1,1,1,72,75,147,180
3404-001,2018,1,1,2,70,57,127,147
3404-001,2018,1,1,3,36,56,92,127
3404-001,2018,1,1,4,34,44,78,92
3404-001,2018,1,1,5,29,86,115,78
3404-001,2018,1,1,6,42,135,177,115
3404-001,2018,1,1,7,68,168,236,177
3404-001,2018,1,1,8,117,187,304,236
3404-001,2018,1,1,9,208,154,362,304
3404-001,2018,1,1,10,274,238,512,362
3404-001,2018,1,1,11,325,311,636,512
3404-001,2018,1,1,12,408,476,884,636
3404-001,2018,1,1,13,466,437,903,884
3404-001,2018,1,1,14,448,473,921,903
3404-001,2018,1,1,15,537,515,1052,921
3404-001,2018,1,1,16,557,429,986,1052
3404-001,2018,1,1,17,564,432,996,986
3404-001,2018,1,1,18,613,365,978,996
3404-001,2018,1,1,19,442,312,754,978
3404-001,2018,1,1,20,344,329,673,754
3404-001,2018,1,1,21,258,281,539,673
3404-001,2018,1,1,22,185,229,414,539
3404-001,2018,1,1,23,104,194,298,414
3404-001,2018,1,1,24,71,144,215,298
3404-001,2018,1,2,1,37,66,103,215
3404-001,2018,1,2,2,28,55,83,103
3404-001,2018,1,2,3,29,32,61,83
3404-001,2018,1,2,4,26,50,76,61
3404-001,2018,1,2,5,64,57,121,76
3404-001,2018,1,2,6,95,167,262,121
3404-001,2018,1,2,7,264,539,803,262
3404-001,2018,1,2,8,665,1792,2457,803
3404-001,2018,1,2,9,772,1219,1991,2457
3404-001,2018,1,2,10,600,678,1278,1991
3404-001,2018,1,2,11,672,659,1331,1278
3404-001,2018,1,2,12,664,687,1351,1331
3404-001,2018,1,2,13,599,585,1184,1351
3404-001,2018,1,2,14,665,638,1303,1184
3404-001,2018,1,2,15,748,727,1475,1303
3404-001,2018,1,2,16,805,663,1468,1475
3404-001,2018,1,2,17,735,617,1352,1468
3404-001,2018,1,2,18,1177,657,1834,1352
3404-001,2018,1,2,19,1070,600,1670,1834
3404-001,2018,1,2,20,681,422,1103,1670
3404-001,2018,1,2,21,583,291,874,1103
3404-001,2018,1,2,22,282,176,458,874
3404-001,2018,1,2,23,153,143,296,458
3404-001,2018,1,2,24,104,103,207,296
3404-001,2018,1,3,1,76,72,148,207
3404-001,2018,1,3,2,41,53,94,148
3404-001,2018,1,3,3,43,32,75,94
3404-001,2018,1,3,4,38,46,84,75
3404-001,2018,1,3,5,60,77,137,84
3404-001,2018,1,3,6,131,183,314,137
3404-001,2018,1,3,7,257,614,871,314
3404-001,2018,1,3,8,625,1975,2600,871
3404-001,2018,1,3,9,915,1373,2288,2600
3404-001,2018,1,3,10,682,778,1460,2288
3404-001,2018,1,3,11,724,754,1478,1460
3404-001,2018,1,3,12,753,711,1464,1478
3404-001,2018,1,3,13,657,664,1321,1464
3404-001,2018,1,3,14,764,759,1523,1321
3404-001,2018,1,3,15,816,811,1627,1523
3404-001,2018,1,3,16,874,707,1581,1627
3404-001,2018,1,3,17,837,688,1525,1581
3404-001,2018,1,3,18,1461,685,2146,1525
3404-001,2018,1,3,19,1225,577,1802,2146
3404-001,2018,1,3,20,747,438,1185,1802
3404-001,2018,1,3,21,578,291,869,1185
3404-001,2018,1,3,22,388,234,622,869
3404-001,2018,1,3,23,229,145,374,622
3404-001,2018,1,3,24,137,104,241,374
3404-001,2018,1,4,1,79,70,149,241
3404-001,2018,1,4,2,37,53,90,149
3404-001,2018,1,4,3,37,46,83,90
3404-001,2018,1,4,4,37,43,80,83
3404-001,2018,1,4,5,61,66,127,80
3404-001,2018,1,4,6,124,202,326,127
3404-001,2018,1,4,7,272,581,853,326
3404-001,2018,1,4,8,651,1920,2571,853
3404-001,2018,1,4,9,903,1375,2278,2571
3404-001,2018,1,4,10,757,738,1495,2278
3404-001,2018,1,4,11,758,805,1563,1495
3404-001,2018,1,4,12,791,746,1537,1563
3404-001,2018,1,4,13,641,684,1325,1537
3404-001,2018,1,4,14,802,777,1579,1325
3404-001,2018,1,4,15,886,832,1718,1579
3404-001,2018,1,4,16,894,765,1659,1718
3404-001,2018,1,4,17,881,708,1589,1659
3404-001,2018,1,4,18,1319,706,2025,1589
3404-001,2018,1,4,19,1248,599,1847,2025
3404-001,2018,1,4,20,753,398,1151,1847
3404-001,2018,1,4,21,691,349,1040,1151
3404-001,2018,1,4,22,380,197,577,1040
3404-001,2018,1,4,23,191,162,353,577
3404-001,2018,1,4,24,143,93,236,353
3404-001,2018,1,5,1,88,85,173,236
3404-001,2018,1,5,2,48,50,98,173
3404-001,2018,1,5,3,39,38,77,98
3404-001,2018,1,5,4,28,41,69,77
3404-001,2018,1,5,5,47,64,111,69
3404-001,2018,1,5,6,100,199,299,111
3404-001,2018,1,5,7,265,587,852,299
3404-001,2018,1,5,8,648,1873,2521,852
3404-001,2018,1,5,9,938,1410,2348,2521
3404-001,2018,1,5,10,717,849,1566,2348
3404-001,2018,1,5,11,763,824,1587,1566
3404-001,2018,1,5,12,832,797,1629,1587
3404-001,2018,1,5,13,674,703,1377,1629
3404-001,2018,1,5,14,755,725,1480,1377
3404-001,2018,1,5,15,915,844,1759,1480
3404-001,2018,1,5,16,916,788,1704,1759
3404-001,2018,1,5,17,868,780,1648,1704
3404-001,2018,1,5,18,1534,765,2299,1648
3404-001,2018,1,5,19,1552,681,2233,2299
3404-001,2018,1,5,20,821,499,1320,2233
3404-001,2018,1,5,21,639,320,959,1320
3404-001,2018,1,5,22,358,256,614,959
3404-001,2018,1,5,23,192,165,357,614
3404-001,2018,1,5,24,138,106,244,357
3404-001,2018,1,6,1,93,74,167,244
3404-001,2018,1,6,2,26,56,82,167
3404-001,2018,1,6,3,75,35,110,82
3404-001,2018,1,6,4,68,61,129,110
3404-001,2018,1,6,5,42,58,100,129
3404-001,2018,1,6,6,69,113,182,100
3404-001,2018,1,6,7,114,326,440,182
3404-001,2018,1,6,8,258,711,969,440
3404-001,2018,1,6,9,333,673,1006,969
3404-001,2018,1,6,10,427,593,1020,1006
3404-001,2018,1,6,11,607,608,1215,1020
3404-001,2018,1,6,12,556,571,1127,1215
3404-001,2018,1,6,13,438,560,998,1127
3404-001,2018,1,6,14,535,527,1062,998
3404-001,2018,1,6,15,576,531,1107,1062
3404-001,2018,1,6,16,529,522,1051,1107
3404-001,2018,1,6,17,631,526,1157,1051
3404-001,2018,1,6,18,789,523,1312,1157
3404-001,2018,1,6,19,522,403,925,1312
3404-001,2018,1,6,20,244,317,561,925
3404-001,2018,1,6,21,244,231,475,561
3404-001,2018,1,6,22,171,186,357,475
3404-001,2018,1,6,23,128,116,244,357
3404-001,2018,1,6,24,77,82,159,244
3404-001,2018,1,7,1,41,53,94,159
3404-001,2018,1,7,2,45,42,87,94
3404-001,2018,1,7,3,48,45,93,87
3404-001,2018,1,7,4,13,35,48,93
3404-001,2018,1,7,5,10,30,40,48
3404-001,2018,1,7,6,14,49,63,40
3404-001,2018,1,7,7,15,107,122,63
3404-001,2018,1,7,8,109,200,309,122
3404-001,2018,1,7,9,130,242,372,309
3404-001,2018,1,7,10,115,245,360,372
3404-001,2018,1,7,11,245,336,581,360
3404-001,2018,1,7,12,349,373,722,581
3404-001,2018,1,7,13,392,391,783,722
3404-001,2018,1,7,14,326,410,736,783
3404-001,2018,1,7,15,350,411,761,736
3404-001,2018,1,7,16,427,417,844,761
3404-001,2018,1,7,17,358,417,775,844
3404-001,2018,1,7,18,440,419,859,775
3404-001,2018,1,7,19,288,380,668,859
3404-001,2018,1,7,20,259,280,539,668
3404-001,2018,1,7,21,210,247,457,539
3404-001,2018,1,7,22,158,216,374,457
3404-001,2018,1,7,23,103,159,262,374
3404-001,2018,1,7,24,75,105,180,262
3404-001,2018,1,8,1,113,69,182,180
3404-001,2018,1,8,2,35,44,79,182
3404-001,2018,1,8,3,106,30,136,79
3404-001,2018,1,8,4,77,37,114,136
3404-001,2018,1,8,5,118,63,181,114
3404-001,2018,1,8,6,285,206,491,181
3404-001,2018,1,8,7,234,630,864,491
3404-001,2018,1,8,8,556,2050,2606,864
3404-001,2018,1,8,9,836,1415,2251,2606
3404-001,2018,1,8,10,690,750,1440,2251
3404-001,2018,1,8,11,627,771,1398,1440
3404-001,2018,1,8,12,549,697,1246,1398
3404-001,2018,1,8,13,494,625,1119,1246
3404-001,2018,1,8,14,561,718,1279,1119
3404-001,2018,1,8,15,638,778,1416,1279
3404-001,2018,1,8,16,645,762,1407,1416
3404-001,2018,1,8,17,686,702,1388,1407
3404-001,2018,1,8,18,988,701,1689,1388
3404-001,2018,1,8,19,993,599,1592,1689
3404-001,2018,1,8,20,650,421,1071,1592
3404-001,2018,1,8,21,699,280,979,1071
3404-001,2018,1,8,22,354,160,514,979
3404-001,2018,1,8,23,186,123,309,514
3404-001,2018,1,8,24,127,77,204,309
3404-001,2018,1,9,1,81,45,126,204
3404-001,2018,1,9,2,43,29,72,126
3404-001,2018,1,9,3,33,43,76,72
3404-001,2018,1,9,4,40,38,78,76
3404-001,2018,1,9,5,56,64,120,78
3404-001,2018,1,9,6,92,105,197,120
3404-001,2018,1,9,7,108,209,317,197
3404-001,2018,1,9,8,294,569,863,317
3404-001,2018,1,9,9,577,535,1112,863
3404-001,2018,1,9,10,573,325,898,1112
3404-001,2018,1,9,11,716,372,1088,898
3404-001,2018,1,9,12,748,323,1071,1088
3404-001,2018,1,9,13,606,318,924,1071
3404-001,2018,1,9,14,696,360,1056,924
3404-001,2018,1,9,15,810,360,1170,1056
3404-001,2018,1,9,16,751,342,1093,1170
3404-001,2018,1,9,17,828,309,1137,1093
3404-001,2018,1,9,18,888,592,1480,1137
3404-001,2018,1,9,19,1109,501,1610,1480
3404-001,2018,1,9,20,627,434,1061,1610
3404-001,2018,1,9,21,422,271,693,1061
3404-001,2018,1,9,22,278,187,465,693
3404-001,2018,1,9,23,115,111,226,465
3404-001,2018,1,9,24,69,67,136,226
3404-001,2018,1,10,1,40,32,72,136
3404-001,2018,1,10,2,22,12,34,72
3404-001,2018,1,10,3,12,25,37,34
3404-001,2018,1,10,4,25,23,48,37
3404-001,2018,1,10,5,31,33,64,48
3404-001,2018,1,10,6,58,98,156,64
3404-001,2018,1,10,7,68,299,367,156
3404-001,2018,1,10,8,164,1292,1456,367
3404-001,2018,1,10,9,261,1307,1568,1456
3404-001,2018,1,10,10,270,383,653,1568
3404-001,2018,1,10,11,546,334,880,653
3404-001,2018,1,10,12,626,345,971,880
3404-001,2018,1,10,13,601,311,912,971
3404-001,2018,1,10,14,696,323,1019,912
3404-001,2018,1,10,15,776,374,1150,1019
3404-001,2018,1,10,16,727,344,1071,1150
3404-001,2018,1,10,17,768,339,1107,1071
3404-001,2018,1,10,18,1313,295,1608,1107
3404-001,2018,1,10,19,1089,233,1322,1608
3404-001,2018,1,10,20,501,204,705,1322
3404-001,2018,1,10,21,244,181,425,705
3404-001,2018,1,10,22,114,181,295,425
3404-001,2018,1,10,23,66,127,193,295
3404-001,2018,1,10,24,29,98,127,193
3404-001,2018,1,11,1,27,67,94,127
3404-001,2018,1,11,2,15,38,53,94
3404-001,2018,1,11,3,12,44,56,53
3404-001,2018,1,11,4,16,31,47,56
3404-001,2018,1,11,5,29,56,85,47
3404-001,2018,1,11,6,40,163,203,85
3404-001,2018,1,11,7,101,467,568,203
3404-001,2018,1,11,8,264,1775,2039,568
3404-001,2018,1,11,9,402,1300,1702,2039
3404-001,2018,1,11,10,326,780,1106,1702
3404-001,2018,1,11,11,533,716,1249,1106
3404-001,2018,1,11,12,711,715,1426,1249
3404-001,2018,1,11,13,649,633,1282,1426
3404-001,2018,1,11,14,690,711,1401,1282
3404-001,2018,1,11,15,824,722,1546,1401
3404-001,2018,1,11,16,799,708,1507,1546
3404-001,2018,1,11,17,848,666,1514,1507
3404-001,2018,1,11,18,1125,684,1809,1514
3404-001,2018,1,11,19,826,584,1410,1809
3404-001,2018,1,11,20,451,455,906,1410
3404-001,2018,1,11,21,320,302,622,906
3404-001,2018,1,11,22,164,200,364,622
3404-001,2018,1,11,23,92,131,223,364
3404-001,2018,1,11,24,64,109,173,223
3404-001,2018,1,12,1,38,76,114,173
3404-001,2018,1,12,2,26,52,78,114
3404-001,2018,1,12,3,20,27,47,78
3404-001,2018,1,12,4,19,47,66,47
3404-001,2018,1,12,5,42,59,101,66
3404-001,2018,1,12,6,60,149,209,101
3404-001,2018,1,12,7,150,476,626,209
3404-001,2018,1,12,8,353,1474,1827,626
3404-001,2018,1,12,9,486,1368,1854,1827
3404-001,2018,1,12,10,397,758,1155,1854
3404-001,2018,1,12,11,538,726,1264,1155
3404-001,2018,1,12,12,649,700,1349,1264
3404-001,2018,1,12,13,705,629,1334,1349
3404-001,2018,1,12,14,739,673,1412,1334
3404-001,2018,1,12,15,812,783,1595,1412
3404-001,2018,1,12,16,884,787,1671,1595
3404-001,2018,1,12,17,902,673,1575,1671
3404-001,2018,1,12,18,1399,782,2181,1575
3404-001,2018,1,12,19,1237,694,1931,2181
3404-001,2018,1,12,20,666,539,1205,1931
3404-001,2018,1,12,21,473,372,845,1205
3404-001,2018,1,12,22,289,264,553,845
3404-001,2018,1,12,23,160,111,271,553
3404-001,2018,1,12,24,128,102,230,271
3404-001,2018,1,13,1,79,56,135,230
3404-001,2018,1,13,2,53,55,108,135
3404-001,2018,1,13,3,36,43,79,108
3404-001,2018,1,13,4,29,37,66,79
3404-001,2018,1,13,5,53,45,98,66
3404-001,2018,1,13,6,87,98,185,98
3404-001,2018,1,13,7,90,165,255,185
3404-001,2018,1,13,8,226,250,476,255
3404-001,2018,1,13,9,376,289,665,476
3404-001,2018,1,13,10,411,247,658,665
3404-001,2018,1,13,11,485,238,723,658
3404-001,2018,1,13,12,536,246,782,723
3404-001,2018,1,13,13,461,232,693,782
3404-001,2018,1,13,14,487,229,716,693
3404-001,2018,1,13,15,475,250,725,716
3404-001,2018,1,13,16,563,254,817,725
3404-001,2018,1,13,17,546,222,768,817
3404-001,2018,1,13,18,669,231,900,768
3404-001,2018,1,13,19,476,174,650,900
3404-001,2018,1,13,20,257,136,393,650
3404-001,2018,1,13,21,217,107,324,393
3404-001,2018,1,13,22,140,78,218,324
3404-001,2018,1,13,23,91,40,131,218
3404-001,2018,1,13,24,67,42,109,131
3404-001,2018,1,14,1,46,109,155,109
3404-001,2018,1,14,2,45,54,99,155
3404-001,2018,1,14,3,21,22,43,99
3404-001,2018,1,14,4,22,30,52,43
3404-001,2018,1,14,5,27,25,52,52
3404-001,2018,1,14,6,34,46,80,52
3404-001,2018,1,14,7,40,100,140,80
3404-001,2018,1,14,8,124,194,318,140
3404-001,2018,1,14,9,180,201,381,318
3404-001,2018,1,14,10,195,275,470,381
3404-001,2018,1,14,11,276,299,575,470
3404-001,2018,1,14,12,277,367,644,575
3404-001,2018,1,14,13,237,300,537,644
3404-001,2018,1,14,14,177,166,343,537
3404-001,2018,1,14,15,264,214,478,343
3404-001,2018,1,14,16,409,196,605,478
3404-001,2018,1,14,17,439,452,891,605
3404-001,2018,1,14,18,442,432,874,891
3404-001,2018,1,14,19,323,348,671,874
3404-001,2018,1,14,20,213,293,506,671
3404-001,2018,1,14,21,180,252,432,506
3404-001,2018,1,14,22,158,215,373,432
3404-001,2018,1,14,23,115,167,282,373
3404-001,2018,1,14,24,63,114,177,282
3404-001,2018,1,15,1,35,68,103,177
3404-001,2018,1,15,2,34,39,73,103
3404-001,2018,1,15,3,31,32,63,73
3404-001,2018,1,15,4,24,35,59,63
3404-001,2018,1,15,5,75,79,154,59
3404-001,2018,1,15,6,136,211,347,154
3404-001,2018,1,15,7,264,637,901,347
3404-001,2018,1,15,8,678,1568,2246,901
3404-001,2018,1,15,9,863,896,1759,2246
3404-001,2018,1,15,10,717,432,1149,1759
3404-001,2018,1,15,11,766,425,1191,1149
3404-001,2018,1,15,12,680,490,1170,1191
3404-001,2018,1,15,13,544,500,1044,1170
3404-001,2018,1,15,14,577,641,1218,1044
3404-001,2018,1,15,15,742,763,1505,1218
3404-001,2018,1,15,16,898,809,1707,1505
3404-001,2018,1,15,17,826,738,1564,1707
3404-001,2018,1,15,18,1177,801,1978,1564
3404-001,2018,1,15,19,1134,639,1773,1978
3404-001,2018,1,15,20,724,449,1173,1773
3404-001,2018,1,15,21,630,346,976,1173
3404-001,2018,1,15,22,355,215,570,976
3404-001,2018,1,15,23,184,140,324,570
3404-001,2018,1,15,24,125,85,210,324
3404-001,2018,1,16,1,83,78,161,210
3404-001,2018,1,16,2,40,44,84,161
3404-001,2018,1,16,3,37,43,80,84
3404-001,2018,1,16,4,51,51,102,80
3404-001,2018,1,16,5,73,76,149,102
3404-001,2018,1,16,6,145,204,349,149
3404-001,2018,1,16,7,276,593,869,349
3404-001,2018,1,16,8,660,1785,2445,869
3404-001,2018,1,16,9,838,1341,2179,2445
3404-001,2018,1,16,10,749,798,1547,2179
3404-001,2018,1,16,11,784,783,1567,1547
3404-001,2018,1,16,12,757,769,1526,1567
3404-001,2018,1,16,13,704,643,1347,1526
3404-001,2018,1,16,14,734,765,1499,1347
3404-001,2018,1,16,15,839,867,1706,1499
3404-001,2018,1,16,16,855,757,1612,1706
3404-001,2018,1,16,17,893,702,1595,1612
3404-001,2018,1,16,18,1183,671,1854,1595
3404-001,2018,1,16,19,1114,579,1693,1854
3404-001,2018,1,16,20,671,435,1106,1693
3404-001,2018,1,16,21,605,340,945,1106
3404-001,2018,1,16,22,337,225,562,945
3404-001,2018,1,16,23,209,125,334,562
3404-001,2018,1,16,24,125,111,236,334
3404-001,2018,1,17,1,82,57,139,236
3404-001,2018,1,17,2,42,53,95,139
3404-001,2018,1,17,3,55,44,99,95
3404-001,2018,1,17,4,45,30,75,99
3404-001,2018,1,17,5,63,86,149,75
3404-001,2018,1,17,6,143,170,313,149
3404-001,2018,1,17,7,271,541,812,313
3404-001,2018,1,17,8,635,1834,2469,812
3404-001,2018,1,17,9,834,1415,2249,2469
3404-001,2018,1,17,10,737,803,1540,2249
3404-001,2018,1,17,11,785,813,1598,1540
3404-001,2018,1,17,12,767,736,1503,1598
3404-001,2018,1,17,13,691,619,1310,1503
3404-001,2018,1,17,14,671,750,1421,1310
3404-001,2018,1,17,15,835,863,1698,1421
3404-001,2018,1,17,16,844,754,1598,1698
3404-001,2018,1,17,17,847,657,1504,1598
3404-001,2018,1,17,18,1409,719,2128,1504
3404-001,2018,1,17,19,1175,636,1811,2128
3404-001,2018,1,17,20,633,491,1124,1811
3404-001,2018,1,17,21,512,306,818,1124
3404-001,2018,1,17,22,305,229,534,818
3404-001,2018,1,17,23,194,139,333,534
3404-001,2018,1,17,24,129,119,248,333
3404-001,2018,1,18,1,81,59,140,248
3404-001,2018,1,18,2,62,47,109,140
3404-001,2018,1,18,3,44,47,91,109
3404-001,2018,1,18,4,45,40,85,91
3404-001,2018,1,18,5,68,64,132,85
3404-001,2018,1,18,6,130,185,315,132
3404-001,2018,1,18,7,281,556,837,315
3404-001,2018,1,18,8,640,1844,2484,837
3404-001,2018,1,18,9,911,1391,2302,2484
3404-001,2018,1,18,10,793,799,1592,2302
3404-001,2018,1,18,11,786,804,1590,1592
3404-001,2018,1,18,12,765,734,1499,1590
3404-001,2018,1,18,13,720,645,1365,1499
3404-001,2018,1,18,14,661,737,1398,1365
3404-001,2018,1,18,15,872,846,1718,1398
3404-001,2018,1,18,16,861,758,1619,1718
3404-001,2018,1,18,17,821,657,1478,1619
3404-001,2018,1,18,18,1274,721,1995,1478
3404-001,2018,1,18,19,1145,617,1762,1995
3404-001,2018,1,18,20,680,428,1108,1762
3404-001,2018,1,18,21,613,309,922,1108
3404-001,2018,1,18,22,322,242,564,922
3404-001,2018,1,18,23,196,151,347,564
3404-001,2018,1,18,24,132,96,228,347
3404-001,2018,1,19,1,83,76,159,228
3404-001,2018,1,19,2,55,42,97,159
3404-001,2018,1,19,3,58,46,104,97
3404-001,2018,1,19,4,41,47,88,104
3404-001,2018,1,19,5,70,60,130,88
3404-001,2018,1,19,6,138,182,320,130
3404-001,2018,1,19,7,283,566,849,320
3404-001,2018,1,19,8,657,1874,2531,849
3404-001,2018,1,19,9,921,1448,2369,2531
3404-001,2018,1,19,10,834,785,1619,2369
3404-001,2018,1,19,11,860,798,1658,1619
3404-001,2018,1,19,12,836,740,1576,1658
3404-001,2018,1,19,13,705,682,1387,1576
3404-001,2018,1,19,14,693,770,1463,1387
3404-001,2018,1,19,15,895,801,1696,1463
3404-001,2018,1,19,16,900,782,1682,1696
3404-001,2018,1,19,17,940,758,1698,1682
3404-001,2018,1,19,18,1483,770,2253,1698
3404-001,2018,1,19,19,1476,790,2266,2253
3404-001,2018,1,19,20,810,566,1376,2266
3404-001,2018,1,19,21,551,377,928,1376
3404-001,2018,1,19,22,335,247,582,928
3404-001,2018,1,19,23,200,175,375,582
3404-001,2018,1,19,24,132,112,244,375
3404-001,2018,1,20,1,86,82,168,244
3404-001,2018,1,20,2,78,65,143,168
3404-001,2018,1,20,3,53,35,88,143
3404-001,2018,1,20,4,53,33,86,88
3404-001,2018,1,20,5,62,50,112,86
3404-001,2018,1,20,6,93,138,231,112
3404-001,2018,1,20,7,163,314,477,231
3404-001,2018,1,20,8,356,718,1074,477
3404-001,2018,1,20,9,555,683,1238,1074
3404-001,2018,1,20,10,576,618,1194,1238
3404-001,2018,1,20,11,571,664,1235,1194
3404-001,2018,1,20,12,628,634,1262,1235
3404-001,2018,1,20,13,567,547,1114,1262
3404-001,2018,1,20,14,517,548,1065,1114
3404-001,2018,1,20,15,557,574,1131,1065
3404-001,2018,1,20,16,629,537,1166,1131
3404-001,2018,1,20,17,716,572,1288,1166
3404-001,2018,1,20,18,832,604,1436,1288
3404-001,2018,1,20,19,511,439,950,1436
3404-001,2018,1,20,20,312,323,635,950
3404-001,2018,1,20,21,246,246,492,635
3404-001,2018,1,20,22,153,168,321,492
3404-001,2018,1,20,23,115,111,226,321
3404-001,2018,1,20,24,77,88,165,226
3404-001,2018,1,21,1,68,61,129,165
3404-001,2018,1,21,2,43,41,84,129
3404-001,2018,1,21,3,36,32,68,84
3404-001,2018,1,21,4,24,28,52,68
3404-001,2018,1,21,5,37,20,57,52
3404-001,2018,1,21,6,42,46,88,57
3404-001,2018,1,21,7,62,121,183,88
3404-001,2018,1,21,8,137,235,372,183
3404-001,2018,1,21,9,191,220,411,372
3404-001,2018,1,21,10,221,233,454,411
3404-001,2018,1,21,11,290,313,603,454
3404-001,2018,1,21,12,338,357,695,603
3404-001,2018,1,21,13,342,346,688,695
3404-001,2018,1,21,14,362,405,767,688
3404-001,2018,1,21,15,417,417,834,767
3404-001,2018,1,21,16,485,423,908,834
3404-001,2018,1,21,17,527,420,947,908
3404-001,2018,1,21,18,478,445,923,947
3404-001,2018,1,21,19,309,359,668,923
3404-001,2018,1,21,20,240,332,572,668
3404-001,2018,1,21,21,210,240,450,572
3404-001,2018,1,21,22,161,247,408,450
3404-001,2018,1,21,23,121,169,290,408
3404-001,2018,1,21,24,73,117,190,290
3404-001,2018,1,22,1,58,78,136,190
3404-001,2018,1,22,2,34,44,78,136
3404-001,2018,1,22,3,28,43,71,78
3404-001,2018,1,22,4,43,41,84,71
3404-001,2018,1,22,5,59,60,119,84
3404-001,2018,1,22,6,149,198,347,119
3404-001,2018,1,22,7,293,652,945,347
3404-001,2018,1,22,8,675,2109,2784,945
3404-001,2018,1,22,9,885,1417,2302,2784
3404-001,2018,1,22,10,788,811,1599,2302
3404-001,2018,1,22,11,788,756,1544,1599
3404-001,2018,1,22,12,844,728,1572,1544
3404-001,2018,1,22,13,674,635,1309,1572
3404-001,2018,1,22,14,797,783,1580,1309
3404-001,2018,1,22,15,896,807,1703,1580
3404-001,2018,1,22,16,983,749,1732,1703
3404-001,2018,1,22,17,887,712,1599,1732
3404-001,2018,1,22,18,1224,616,1840,1599
3404-001,2018,1,22,19,1108,591,1699,1840
3404-001,2018,1,22,20,673,439,1112,1699
3404-001,2018,1,22,21,627,335,962,1112
3404-001,2018,1,22,22,328,224,552,962
3404-001,2018,1,22,23,160,110,270,552
3404-001,2018,1,22,24,110,119,229,270
3404-001,2018,1,23,1,78,64,142,229
3404-001,2018,1,23,2,68,51,119,142
3404-001,2018,1,23,3,24,44,68,119
3404-001,2018,1,23,4,25,41,66,68
3404-001,2018,1,23,5,22,62,84,66
3404-001,2018,1,23,6,48,152,200,84
3404-001,2018,1,23,7,106,543,649,200
3404-001,2018,1,23,8,321,1869,2190,649
3404-001,2018,1,23,9,484,1331,1815,2190
3404-001,2018,1,23,10,523,790,1313,1815
3404-001,2018,1,23,11,768,741,1509,1313
3404-001,2018,1,23,12,770,711,1481,1509
3404-001,2018,1,23,13,644,589,1233,1481
3404-001,2018,1,23,14,729,727,1456,1233
3404-001,2018,1,23,15,806,766,1572,1456
3404-001,2018,1,23,16,895,803,1698,1572
3404-001,2018,1,23,17,818,695,1513,1698
3404-001,2018,1,23,18,1181,670,1851,1513
3404-001,2018,1,23,19,1072,620,1692,1851
3404-001,2018,1,23,20,620,454,1074,1692
3404-001,2018,1,23,21,561,317,878,1074
3404-001,2018,1,23,22,307,212,519,878
3404-001,2018,1,23,23,194,147,341,519
3404-001,2018,1,23,24,98,85,183,341
3404-001,2018,1,24,1,81,56,137,183
3404-001,2018,1,24,2,55,43,98,137
3404-001,2018,1,24,3,47,45,92,98
3404-001,2018,1,24,4,45,37,82,92
3404-001,2018,1,24,5,52,52,104,82
3404-001,2018,1,24,6,141,164,305,104
3404-001,2018,1,24,7,202,493,695,305
3404-001,2018,1,24,8,549,1805,2354,695
3404-001,2018,1,24,9,789,1363,2152,2354
3404-001,2018,1,24,10,657,794,1451,2152
3404-001,2018,1,24,11,783,739,1522,1451
3404-001,2018,1,24,12,723,707,1430,1522
3404-001,2018,1,24,13,670,624,1294,1430
3404-001,2018,1,24,14,692,731,1423,1294
3404-001,2018,1,24,15,841,766,1607,1423
3404-001,2018,1,24,16,825,693,1518,1607
3404-001,2018,1,24,17,840,664,1504,1518
3404-001,2018,1,24,18,1292,678,1970,1504
3404-001,2018,1,24,19,1122,678,1800,1970
3404-001,2018,1,24,20,638,479,1117,1800
3404-001,2018,1,24,21,501,314,815,1117
3404-001,2018,1,24,22,300,203,503,815
3404-001,2018,1,24,23,167,139,306,503
3404-001,2018,1,24,24,100,83,183,306
3404-001,2018,1,25,1,61,67,128,183
3404-001,2018,1,25,2,52,45,97,128
3404-001,2018,1,25,3,39,37,76,97
3404-001,2018,1,25,4,50,38,88,76
3404-001,2018,1,25,5,70,60,130,88
3404-001,2018,1,25,6,106,161,267,130
3404-001,2018,1,25,7,237,509,746,267
3404-001,2018,1,25,8,582,1782,2364,746
3404-001,2018,1,25,9,777,1336,2113,2364
3404-001,2018,1,25,10,728,794,1522,2113
3404-001,2018,1,25,11,741,761,1502,1522
3404-001,2018,1,25,12,714,745,1459,1502
3404-001,2018,1,25,13,673,593,1266,1459
3404-001,2018,1,25,14,737,755,1492,1266
3404-001,2018,1,25,15,857,775,1632,1492
3404-001,2018,1,25,16,834,744,1578,1632
3404-001,2018,1,25,17,844,650,1494,1578
3404-001,2018,1,25,18,1189,712,1901,1494
3404-001,2018,1,25,19,1084,610,1694,1901
3404-001,2018,1,25,20,687,429,1116,1694
3404-001,2018,1,25,21,539,285,824,1116
3404-001,2018,1,25,22,360,250,610,824
3404-001,2018,1,25,23,174,133,307,610
3404-001,2018,1,25,24,128,100,228,307
3404-001,2018,1,26,1,85,68,153,228
3404-001,2018,1,26,2,44,41,85,153
3404-001,2018,1,26,3,37,39,76,85
3404-001,2018,1,26,4,42,36,78,76
3404-001,2018,1,26,5,62,65,127,78
3404-001,2018,1,26,6,136,178,314,127
3404-001,2018,1,26,7,209,492,701,314
3404-001,2018,1,26,8,597,1804,2401,701
3404-001,2018,1,26,9,814,1325,2139,2401
3404-001,2018,1,26,10,658,750,1408,2139
3404-001,2018,1,26,11,764,741,1505,1408
3404-001,2018,1,26,12,776,716,1492,1505
3404-001,2018,1,26,13,664,592,1256,1492
3404-001,2018,1,26,14,726,691,1417,1256
3404-001,2018,1,26,15,829,802,1631,1417
3404-001,2018,1,26,16,844,812,1656,1631
3404-001,2018,1,26,17,926,726,1652,1656
3404-001,2018,1,26,18,1383,754,2137,1652
3404-001,2018,1,26,19,1366,715,2081,2137
3404-001,2018,1,26,20,750,541,1291,2081
3404-001,2018,1,26,21,551,390,941,1291
3404-001,2018,1,26,22,317,247,564,941
3404-001,2018,1,26,23,208,129,337,564
3404-001,2018,1,26,24,119,97,216,337
3404-001,2018,1,27,1,89,64,153,216
3404-001,2018,1,27,2,66,55,121,153
3404-001,2018,1,27,3,40,41,81,121
3404-001,2018,1,27,4,28,35,63,81
3404-001,2018,1,27,5,71,49,120,63
3404-001,2018,1,27,6,94,99,193,120
3404-001,2018,1,27,7,161,207,368,193
3404-001,2018,1,27,8,336,627,963,368
3404-001,2018,1,27,9,478,650,1128,963
3404-001,2018,1,27,10,515,543,1058,1128
3404-001,2018,1,27,11,541,566,1107,1058
3404-001,2018,1,27,12,613,544,1157,1107
3404-001,2018,1,27,13,580,579,1159,1157
3404-001,2018,1,27,14,546,521,1067,1159
3404-001,2018,1,27,15,540,530,1070,1067
3404-001,2018,1,27,16,628,521,1149,1070
3404-001,2018,1,27,17,562,542,1104,1149
3404-001,2018,1,27,18,748,511,1259,1104
3404-001,2018,1,27,19,450,415,865,1259
3404-001,2018,1,27,20,272,300,572,865
3404-001,2018,1,27,21,207,220,427,572
3404-001,2018,1,27,22,158,149,307,427
3404-001,2018,1,27,23,105,114,219,307
3404-001,2018,1,27,24,78,87,165,219
3404-001,2018,1,28,1,71,60,131,165
3404-001,2018,1,28,2,36,37,73,131
3404-001,2018,1,28,3,35,34,69,73
3404-001,2018,1,28,4,31,28,59,69
3404-001,2018,1,28,5,39,30,69,59
3404-001,2018,1,28,6,34,42,76,69
3404-001,2018,1,28,7,49,103,152,76
3404-001,2018,1,28,8,150,203,353,152
3404-001,2018,1,28,9,196,251,447,353
3404-001,2018,1,28,10,198,283,481,447
3404-001,2018,1,28,11,328,304,632,481
3404-001,2018,1,28,12,333,366,699,632
3404-001,2018,1,28,13,268,414,682,699
3404-001,2018,1,28,14,248,418,666,682
3404-001,2018,1,28,15,342,428,770,666
3404-001,2018,1,28,16,404,444,848,770
3404-001,2018,1,28,17,500,435,935,848
3404-001,2018,1,28,18,438,451,889,935
3404-001,2018,1,28,19,321,362,683,889
3404-001,2018,1,28,20,245,274,519,683
3404-001,2018,1,28,21,161,241,402,519
3404-001,2018,1,28,22,158,248,406,402
3404-001,2018,1,28,23,96,190,286,406
3404-001,2018,1,28,24,51,101,152,286
3404-001,2018,1,29,1,39,64,103,152
3404-001,2018,1,29,2,22,44,66,103
3404-001,2018,1,29,3,24,38,62,66
3404-001,2018,1,29,4,34,29,63,62
3404-001,2018,1,29,5,52,59,111,63
3404-001,2018,1,29,6,127,194,321,111
3404-001,2018,1,29,7,261,602,863,321
3404-001,2018,1,29,8,664,2044,2708,863
3404-001,2018,1,29,9,838,1390,2228,2708
3404-001,2018,1,29,10,672,823,1495,2228
3404-001,2018,1,29,11,740,791,1531,1495
3404-001,2018,1,29,12,766,705,1471,1531
3404-001,2018,1,29,13,646,631,1277,1471
3404-001,2018,1,29,14,662,707,1369,1277
3404-001,2018,1,29,15,847,839,1686,1369
3404-001,2018,1,29,16,885,766,1651,1686
3404-001,2018,1,29,17,872,689,1561,1651
3404-001,2018,1,29,18,1183,725,1908,1561
3404-001,2018,1,29,19,1102,620,1722,1908
3404-001,2018,1,29,20,718,453,1171,1722
3404-001,2018,1,29,21,640,334,974,1171
3404-001,2018,1,29,22,350,226,576,974
3404-001,2018,1,29,23,209,149,358,576
3404-001,2018,1,29,24,107,92,199,358
3404-001,2018,1,30,1,98,77,175,199
3404-001,2018,1,30,2,67,45,112,175
3404-001,2018,1,30,3,54,59,113,112
3404-001,2018,1,30,4,35,40,75,113
3404-001,2018,1,30,5,65,68,133,75
3404-001,2018,1,30,6,142,181,323,133
3404-001,2018,1,30,7,288,546,834,323
3404-001,2018,1,30,8,687,1904,2591,834
3404-001,2018,1,30,9,820,1364,2184,2591
3404-001,2018,1,30,10,716,821,1537,2184
3404-001,2018,1,30,11,764,836,1600,1537
3404-001,2018,1,30,12,748,763,1511,1600
3404-001,2018,1,30,13,629,625,1254,1511
3404-001,2018,1,30,14,717,766,1483,1254
3404-001,2018,1,30,15,813,775,1588,1483
3404-001,2018,1,30,16,846,753,1599,1588
3404-001,2018,1,30,17,854,733,1587,1599
3404-001,2018,1,30,18,1182,696,1878,1587
3404-001,2018,1,30,19,1096,596,1692,1878
3404-001,2018,1,30,20,746,496,1242,1692
3404-001,2018,1,30,21,609,284,893,1242
3404-001,2018,1,30,22,383,223,606,893
3404-001,2018,1,30,23,186,131,317,606
3404-001,2018,1,30,24,107,85,192,317
3404-001,2018,1,31,1,81,78,159,192
3404-001,2018,1,31,2,70,53,123,159
3404-001,2018,1,31,3,64,39,103,123
3404-001,2018,1,31,4,40,44,84,103
3404-001,2018,1,31,5,68,62,130,84
3404-001,2018,1,31,6,153,156,309,130
3404-001,2018,1,31,7,271,541,812,309
3404-001,2018,1,31,8,624,1924,2548,812
3404-001,2018,1,31,9,882,1387,2269,2548
3404-001,2018,1,31,10,760,773,1533,2269
3404-001,2018,1,31,11,875,845,1720,1533
3404-001,2018,1,31,12,748,817,1565,1720
3404-001,2018,1,31,13,685,635,1320,1565
3404-001,2018,1,31,14,735,777,1512,1320
3404-001,2018,1,31,15,875,843,1718,1512
3404-001,2018,1,31,16,855,790,1645,1718
3404-001,2018,1,31,17,813,673,1486,1645
3404-001,2018,1,31,18,1386,720,2106,1486
3404-001,2018,1,31,19,1211,631,1842,2106
3404-001,2018,1,31,20,692,453,1145,1842
3404-001,2018,1,31,21,508,333,841,1145
3404-001,2018,1,31,22,352,238,590,841
3404-001,2018,1,31,23,211,153,364,590
3404-001,2018,1,31,24,156,112,268,364
3404-001,2018,2,1,1,92,78,170,268
3404-001,2018,2,1,2,53,57,110,170
3404-001,2018,2,1,3,45,46,91,110
3404-001,2018,2,1,4,46,47,93,91
3404-001,2018,2,1,5,66,63,129,93
3404-001,2018,2,1,6,137,179,316,129
3404-001,2018,2,1,7,262,557,819,316
3404-001,2018,2,1,8,592,1885,2477,819
3404-001,2018,2,1,9,866,1339,2205,2477
3404-001,2018,2,1,10,786,763,1549,2205
3404-001,2018,2,1,11,820,766,1586,1549
3404-001,2018,2,1,12,761,692,1453,1586
3404-001,2018,2,1,13,631,644,1275,1453
3404-001,2018,2,1,14,653,790,1443,1275
3404-001,2018,2,1,15,837,781,1618,1443
3404-001,2018,2,1,16,832,718,1550,1618
3404-001,2018,2,1,17,846,726,1572,1550
3404-001,2018,2,1,18,1228,677,1905,1572
3404-001,2018,2,1,19,1134,676,1810,1905
3404-001,2018,2,1,20,835,491,1326,1810
3404-001,2018,2,1,21,625,353,978,1326
3404-001,2018,2,1,22,366,250,616,978
3404-001,2018,2,1,23,216,181,397,616
3404-001,2018,2,1,24,147,103,250,397
3404-001,2018,2,2,1,102,83,185,250
3404-001,2018,2,2,2,55,43,98,185
3404-001,2018,2,2,3,51,39,90,98
3404-001,2018,2,2,4,37,49,86,90
3404-001,2018,2,2,5,66,53,119,86
3404-001,2018,2,2,6,123,208,331,119
3404-001,2018,2,2,7,262,574,836,331
3404-001,2018,2,2,8,637,1906,2543,836
3404-001,2018,2,2,9,914,1379,2293,2543
3404-001,2018,2,2,10,774,791,1565,2293
3404-001,2018,2,2,11,836,791,1627,1565
3404-001,2018,2,2,12,859,718,1577,1627
3404-001,2018,2,2,13,657,683,1340,1577
3404-001,2018,2,2,14,692,749,1441,1340
3404-001,2018,2,2,15,845,788,1633,1441
3404-001,2018,2,2,16,923,735,1658,1633
3404-001,2018,2,2,17,932,759,1691,1658
3404-001,2018,2,2,18,1535,855,2390,1691
3404-001,2018,2,2,19,1437,757,2194,2390
3404-001,2018,2,2,20,856,584,1440,2194
3404-001,2018,2,2,21,622,386,1008,1440
3404-001,2018,2,2,22,342,265,607,1008
3404-001,2018,2,2,23,196,163,359,607
3404-001,2018,2,2,24,124,95,219,359
3404-001,2018,2,3,1,93,80,173,219
3404-001,2018,2,3,2,65,54,119,173
3404-001,2018,2,3,3,51,54,105,119
3404-001,2018,2,3,4,52,48,100,105
3404-001,2018,2,3,5,70,46,116,100
3404-001,2018,2,3,6,90,123,213,116
3404-001,2018,2,3,7,173,295,468,213
3404-001,2018,2,3,8,375,714,1089,468
3404-001,2018,2,3,9,561,664,1225,1089
3404-001,2018,2,3,10,609,633,1242,1225
3404-001,2018,2,3,11,629,632,1261,1242
3404-001,2018,2,3,12,623,608,1231,1261
3404-001,2018,2,3,13,550,544,1094,1231
3404-001,2018,2,3,14,553,540,1093,1094
3404-001,2018,2,3,15,601,555,1156,1093
3404-001,2018,2,3,16,654,509,1163,1156
3404-001,2018,2,3,17,650,526,1176,1163
3404-001,2018,2,3,18,764,537,1301,1176
3404-001,2018,2,3,19,510,465,975,1301
3404-001,2018,2,3,20,312,312,624,975
3404-001,2018,2,3,21,257,216,473,624
3404-001,2018,2,3,22,152,161,313,473
3404-001,2018,2,3,23,107,133,240,313
3404-001,2018,2,3,24,81,82,163,240
3404-001,2018,2,4,1,79,72,151,163
3404-001,2018,2,4,2,34,39,73,151
3404-001,2018,2,4,3,25,30,55,73
3404-001,2018,2,4,4,24,20,44,55
3404-001,2018,2,4,5,39,28,67,44
3404-001,2018,2,4,6,43,40,83,67
3404-001,2018,2,4,7,52,116,168,83
3404-001,2018,2,4,8,115,205,320,168
3404-001,2018,2,4,9,226,251,477,320
3404-001,2018,2,4,10,236,250,486,477
3404-001,2018,2,4,11,316,332,648,486
3404-001,2018,2,4,12,317,350,667,648
3404-001,2018,2,4,13,325,349,674,667
3404-001,2018,2,4,14,314,391,705,674
3404-001,2018,2,4,15,408,420,828,705
3404-001,2018,2,4,16,408,452,860,828
3404-001,2018,2,4,17,457,417,874,860
3404-001,2018,2,4,18,443,414,857,874
3404-001,2018,2,4,19,324,353,677,857
3404-001,2018,2,4,20,243,291,534,677
3404-001,2018,2,4,21,227,248,475,534
3404-001,2018,2,4,22,138,217,355,475
3404-001,2018,2,4,23,122,161,283,355
3404-001,2018,2,4,24,70,114,184,283
3404-001,2018,2,5,1,38,67,105,184
3404-001,2018,2,5,2,32,41,73,105
3404-001,2018,2,5,3,30,30,60,73
3404-001,2018,2,5,4,31,43,74,60
3404-001,2018,2,5,5,54,59,113,74
3404-001,2018,2,5,6,116,175,291,113
3404-001,2018,2,5,7,319,648,967,291
3404-001,2018,2,5,8,645,2035,2680,967
3404-001,2018,2,5,9,858,1465,2323,2680
3404-001,2018,2,5,10,770,757,1527,2323
3404-001,2018,2,5,11,799,777,1576,1527
3404-001,2018,2,5,12,780,716,1496,1576
3404-001,2018,2,5,13,632,682,1314,1496
3404-001,2018,2,5,14,695,747,1442,1314
3404-001,2018,2,5,15,913,780,1693,1442
3404-001,2018,2,5,16,958,738,1696,1693
3404-001,2018,2,5,17,917,682,1599,1696
3404-001,2018,2,5,18,1191,727,1918,1599
3404-001,2018,2,5,19,1055,631,1686,1918
3404-001,2018,2,5,20,765,468,1233,1686
3404-001,2018,2,5,21,637,319,956,1233
3404-001,2018,2,5,22,336,239,575,956
3404-001,2018,2,5,23,224,162,386,575
3404-001,2018,2,5,24,132,89,221,386
3404-001,2018,2,6,1,91,56,147,221
3404-001,2018,2,6,2,72,41,113,147
3404-001,2018,2,6,3,37,37,74,113
3404-001,2018,2,6,4,63,51,114,74
3404-001,2018,2,6,5,70,58,128,114
3404-001,2018,2,6,6,139,185,324,128
3404-001,2018,2,6,7,300,553,853,324
3404-001,2018,2,6,8,671,1878,2549,853
3404-001,2018,2,6,9,866,1367,2233,2549
3404-001,2018,2,6,10,879,808,1687,2233
3404-001,2018,2,6,11,1006,766,1772,1687
3404-001,2018,2,6,12,779,753,1532,1772
3404-001,2018,2,6,13,668,677,1345,1532
3404-001,2018,2,6,14,799,811,1610,1345
3404-001,2018,2,6,15,835,926,1761,1610
3404-001,2018,2,6,16,840,802,1642,1761
3404-001,2018,2,6,17,943,721,1664,1642
3404-001,2018,2,6,18,1210,709,1919,1664
3404-001,2018,2,6,19,1072,647,1719,1919
3404-001,2018,2,6,20,762,480,1242,1719
3404-001,2018,2,6,21,620,333,953,1242
3404-001,2018,2,6,22,404,254,658,953
3404-001,2018,2,6,23,235,187,422,658
3404-001,2018,2,6,24,104,104,208,422
3404-001,2018,2,7,1,88,85,173,208
3404-001,2018,2,7,2,68,51,119,173
3404-001,2018,2,7,3,56,32,88,119
3404-001,2018,2,7,4,63,47,110,88
3404-001,2018,2,7,5,55,68,123,110
3404-001,2018,2,7,6,138,156,294,123
3404-001,2018,2,7,7,265,506,771,294
3404-001,2018,2,7,8,655,1854,2509,771
3404-001,2018,2,7,9,930,1413,2343,2509
3404-001,2018,2,7,10,771,831,1602,2343
3404-001,2018,2,7,11,831,784,1615,1602
3404-001,2018,2,7,12,754,735,1489,1615
3404-001,2018,2,7,13,712,712,1424,1489
3404-001,2018,2,7,14,789,754,1543,1424
3404-001,2018,2,7,15,862,864,1726,1543
3404-001,2018,2,7,16,975,773,1748,1726
3404-001,2018,2,7,17,896,785,1681,1748
3404-001,2018,2,7,18,1413,797,2210,1681
3404-001,2018,2,7,19,1254,718,1972,2210
3404-001,2018,2,7,20,691,462,1153,1972
3404-001,2018,2,7,21,537,359,896,1153
3404-001,2018,2,7,22,337,235,572,896
3404-001,2018,2,7,23,196,170,366,572
3404-001,2018,2,7,24,130,120,250,366
3404-001,2018,2,8,1,85,87,172,250
3404-001,2018,2,8,2,70,69,139,172
3404-001,2018,2,8,3,54,51,105,139
3404-001,2018,2,8,4,61,51,112,105
3404-001,2018,2,8,5,77,64,141,112
3404-001,2018,2,8,6,153,162,315,141
3404-001,2018,2,8,7,285,547,832,315
3404-001,2018,2,8,8,651,1890,2541,832
3404-001,2018,2,8,9,885,1366,2251,2541
3404-001,2018,2,8,10,818,807,1625,2251
3404-001,2018,2,8,11,875,815,1690,1625
3404-001,2018,2,8,12,778,764,1542,1690
3404-001,2018,2,8,13,640,690,1330,1542
3404-001,2018,2,8,14,748,756,1504,1330
3404-001,2018,2,8,15,775,902,1677,1504
3404-001,2018,2,8,16,836,811,1647,1677
3404-001,2018,2,8,17,867,760,1627,1647
3404-001,2018,2,8,18,1225,734,1959,1627
3404-001,2018,2,8,19,1165,652,1817,1959
3404-001,2018,2,8,20,760,507,1267,1817
3404-001,2018,2,8,21,677,371,1048,1267
3404-001,2018,2,8,22,368,249,617,1048
3404-001,2018,2,8,23,223,183,406,617
3404-001,2018,2,8,24,119,104,223,406
3404-001,2018,2,9,1,90,79,169,223
3404-001,2018,2,9,2,55,48,103,169
3404-001,2018,2,9,3,45,39,84,103
3404-001,2018,2,9,4,46,38,84,84
3404-001,2018,2,9,5,76,66,142,84
3404-001,2018,2,9,6,130,184,314,142
3404-001,2018,2,9,7,287,543,830,314
3404-001,2018,2,9,8,701,1849,2550,830
3404-001,2018,2,9,9,962,1471,2433,2550
3404-001,2018,2,9,10,832,784,1616,2433
3404-001,2018,2,9,11,819,845,1664,1616
3404-001,2018,2,9,12,869,789,1658,1664
3404-001,2018,2,9,13,713,693,1406,1658
3404-001,2018,2,9,14,646,779,1425,1406
3404-001,2018,2,9,15,748,864,1612,1425
3404-001,2018,2,9,16,768,789,1557,1612
3404-001,2018,2,9,17,921,834,1755,1557
3404-001,2018,2,9,18,1422,875,2297,1755
3404-001,2018,2,9,19,1347,751,2098,2297
3404-001,2018,2,9,20,834,595,1429,2098
3404-001,2018,2,9,21,691,384,1075,1429
3404-001,2018,2,9,22,350,276,626,1075
3404-001,2018,2,9,23,210,173,383,626
3404-001,2018,2,9,24,145,109,254,383
3404-001,2018,2,10,1,98,86,184,254
3404-001,2018,2,10,2,73,57,130,184
3404-001,2018,2,10,3,66,46,112,130
3404-001,2018,2,10,4,70,58,128,112
3404-001,2018,2,10,5,70,71,141,128
3404-001,2018,2,10,6,135,137,272,141
3404-001,2018,2,10,7,211,335,546,272
3404-001,2018,2,10,8,397,748,1145,546
3404-001,2018,2,10,9,569,725,1294,1145
3404-001,2018,2,10,10,631,590,1221,1294
3404-001,2018,2,10,11,628,603,1231,1221
3404-001,2018,2,10,12,617,601,1218,1231
3404-001,2018,2,10,13,572,545,1117,1218
3404-001,2018,2,10,14,498,550,1048,1117
3404-001,2018,2,10,15,551,571,1122,1048
3404-001,2018,2,10,16,661,559,1220,1122
3404-001,2018,2,10,17,687,521,1208,1220
3404-001,2018,2,10,18,954,606,1560,1208
3404-001,2018,2,10,19,562,524,1086,1560
3404-001,2018,2,10,20,326,331,657,1086
3404-001,2018,2,10,21,246,231,477,657
3404-001,2018,2,10,22,152,191,343,477
3404-001,2018,2,10,23,121,137,258,343
3404-001,2018,2,10,24,87,115,202,258
3404-001,2018,2,11,1,66,74,140,202
3404-001,2018,2,11,2,47,41,88,140
3404-001,2018,2,11,3,32,30,62,88
3404-001,2018,2,11,4,22,27,49,62
3404-001,2018,2,11,5,28,37,65,49
3404-001,2018,2,11,6,44,48,92,65
3404-001,2018,2,11,7,82,137,219,92
3404-001,2018,2,11,8,199,278,477,219
3404-001,2018,2,11,9,262,264,526,477
3404-001,2018,2,11,10,282,308,590,526
3404-001,2018,2,11,11,386,319,705,590
3404-001,2018,2,11,12,371,362,733,705
3404-001,2018,2,11,13,320,390,710,733
3404-001,2018,2,11,14,360,395,755,710
3404-001,2018,2,11,15,384,401,785,755
3404-001,2018,2,11,16,460,444,904,785
3404-001,2018,2,11,17,484,391,875,904
3404-001,2018,2,11,18,407,399,806,875
3404-001,2018,2,11,19,293,338,631,806
3404-001,2018,2,11,20,205,241,446,631
3404-001,2018,2,11,21,168,207,375,446
3404-001,2018,2,11,22,128,180,308,375
3404-001,2018,2,11,23,81,130,211,308
3404-001,2018,2,11,24,40,101,141,211
3404-001,2018,2,12,1,36,55,91,141
3404-001,2018,2,12,2,20,58,78,91
3404-001,2018,2,12,3,12,27,39,78
3404-001,2018,2,12,4,9,41,50,39
3404-001,2018,2,12,5,19,49,68,50
3404-001,2018,2,12,6,52,150,202,68
3404-001,2018,2,12,7,113,516,629,202
3404-001,2018,2,12,8,285,1417,1702,629
3404-001,2018,2,12,9,453,1331,1784,1702
3404-001,2018,2,12,10,606,813,1419,1784
3404-001,2018,2,12,11,767,778,1545,1419
3404-001,2018,2,12,12,840,829,1669,1545
3404-001,2018,2,12,13,726,693,1419,1669
3404-001,2018,2,12,14,757,775,1532,1419
3404-001,2018,2,12,15,883,860,1743,1532
3404-001,2018,2,12,16,916,831,1747,1743
3404-001,2018,2,12,17,886,801,1687,1747
3404-001,2018,2,12,18,1125,694,1819,1687
3404-001,2018,2,12,19,1095,685,1780,1819
3404-001,2018,2,12,20,737,489,1226,1780
3404-001,2018,2,12,21,634,321,955,1226
3404-001,2018,2,12,22,345,249,594,955
3404-001,2018,2,12,23,215,132,347,594
3404-001,2018,2,12,24,126,103,229,347
3404-001,2018,2,13,1,82,63,145,229
3404-001,2018,2,13,2,49,51,100,145
3404-001,2018,2,13,3,39,64,103,100
3404-001,2018,2,13,4,47,36,83,103
3404-001,2018,2,13,5,52,54,106,83
3404-001,2018,2,13,6,104,177,281,106
3404-001,2018,2,13,7,216,530,746,281
3404-001,2018,2,13,8,528,1515,2043,746
3404-001,2018,2,13,9,827,1329,2156,2043
3404-001,2018,2,13,10,732,882,1614,2156
3404-001,2018,2,13,11,815,936,1751,1614
3404-001,2018,2,13,12,791,808,1599,1751
3404-001,2018,2,13,13,723,697,1420,1599
3404-001,2018,2,13,14,704,823,1527,1420
3404-001,2018,2,13,15,840,908,1748,1527
3404-001,2018,2,13,16,945,891,1836,1748
3404-001,2018,2,13,17,870,811,1681,1836
3404-001,2018,2,13,18,1226,795,2021,1681
3404-001,2018,2,13,19,1195,685,1880,2021
3404-001,2018,2,13,20,768,510,1278,1880
3404-001,2018,2,13,21,595,374,969,1278
3404-001,2018,2,13,22,348,304,652,969
3404-001,2018,2,13,23,188,180,368,652
3404-001,2018,2,13,24,146,119,265,368
3404-001,2018,2,14,1,126,102,228,265
3404-001,2018,2,14,2,67,79,146,228
3404-001,2018,2,14,3,35,55,90,146
3404-001,2018,2,14,4,55,47,102,90
3404-001,2018,2,14,5,59,58,117,102
3404-001,2018,2,14,6,114,177,291,117
3404-001,2018,2,14,7,265,468,733,291
3404-001,2018,2,14,8,607,1646,2253,733
3404-001,2018,2,14,9,857,1235,2092,2253
3404-001,2018,2,14,10,765,756,1521,2092
3404-001,2018,2,14,11,737,787,1524,1521
3404-001,2018,2,14,12,707,725,1432,1524
3404-001,2018,2,14,13,668,750,1418,1432
3404-001,2018,2,14,14,695,752,1447,1418
3404-001,2018,2,14,15,790,751,1541,1447
3404-001,2018,2,14,16,954,753,1707,1541
3404-001,2018,2,14,17,916,834,1750,1707
3404-001,2018,2,14,18,1147,802,1949,1750
3404-001,2018,2,14,19,790,643,1433,1949
3404-001,2018,2,14,20,389,486,875,1433
3404-001,2018,2,14,21,298,319,617,875
3404-001,2018,2,14,22,189,260,449,617
3404-001,2018,2,14,23,144,167,311,449
3404-001,2018,2,14,24,119,101,220,311
3404-001,2018,2,15,1,85,87,172,220
3404-001,2018,2,15,2,77,70,147,172
3404-001,2018,2,15,3,59,71,130,147
3404-001,2018,2,15,4,59,41,100,130
3404-001,2018,2,15,5,84,61,145,100
3404-001,2018,2,15,6,104,92,196,145
3404-001,2018,2,15,7,130,137,267,196
3404-001,2018,2,15,8,152,219,371,267
3404-001,2018,2,15,9,240,319,559,371
3404-001,2018,2,15,10,276,739,1015,559
3404-001,2018,2,15,11,334,529,863,1015
3404-001,2018,2,15,12,291,514,805,863
3404-001,2018,2,15,13,229,565,794,805
3404-001,2018,2,15,14,223,403,626,794
3404-001,2018,2,15,15,243,395,638,626
3404-001,2018,2,15,16,307,351,658,638
3404-001,2018,2,15,17,305,318,623,658
3404-001,2018,2,15,18,261,277,538,623
3404-001,2018,2,15,19,231,220,451,538
3404-001,2018,2,15,20,163,151,314,451
3404-001,2018,2,15,21,119,124,243,314
3404-001,2018,2,15,22,98,106,204,243
3404-001,2018,2,15,23,71,76,147,204
3404-001,2018,2,15,24,51,66,117,147
3404-001,2018,2,16,1,32,33,65,117
3404-001,2018,2,16,2,18,26,44,65
3404-001,2018,2,16,3,25,21,46,44
3404-001,2018,2,16,4,18,17,35,46
3404-001,2018,2,16,5,29,18,47,35
3404-001,2018,2,16,6,41,40,81,47
3404-001,2018,2,16,7,97,124,221,81
3404-001,2018,2,16,8,193,237,430,221
3404-001,2018,2,16,9,185,243,428,430
3404-001,2018,2,16,10,207,252,459,428
3404-001,2018,2,16,11,368,512,880,459
3404-001,2018,2,16,12,502,676,1178,880
3404-001,2018,2,16,13,460,802,1262,1178
3404-001,2018,2,16,14,673,667,1340,1262
3404-001,2018,2,16,15,695,648,1343,1340
3404-001,2018,2,16,16,672,643,1315,1343
3404-001,2018,2,16,17,773,587,1360,1315
3404-001,2018,2,16,18,558,506,1064,1360
3404-001,2018,2,16,19,540,333,873,1064
3404-001,2018,2,16,20,273,370,643,873
3404-001,2018,2,16,21,359,237,596,643
3404-001,2018,2,16,22,176,161,337,596
3404-001,2018,2,16,23,112,115,227,337
3404-001,2018,2,16,24,85,107,192,227
3404-001,2018,2,17,1,59,52,111,192
3404-001,2018,2,17,2,22,49,71,111
3404-001,2018,2,17,3,16,28,44,71
3404-001,2018,2,17,4,13,21,34,44
3404-001,2018,2,17,5,22,26,48,34
3404-001,2018,2,17,6,18,38,56,48
3404-001,2018,2,17,7,37,66,103,56
3404-001,2018,2,17,8,70,120,190,103
3404-001,2018,2,17,9,141,148,289,190
3404-001,2018,2,17,10,217,222,439,289
3404-001,2018,2,17,11,278,322,600,439
3404-001,2018,2,17,12,344,369,713,600
3404-001,2018,2,17,13,342,368,710,713
3404-001,2018,2,17,14,340,412,752,710
3404-001,2018,2,17,15,367,434,801,752
3404-001,2018,2,17,16,572,362,934,801
3404-001,2018,2,17,17,505,351,856,934
3404-001,2018,2,17,18,506,370,876,856
3404-001,2018,2,17,19,493,309,802,876
3404-001,2018,2,17,20,250,237,487,802
3404-001,2018,2,17,21,274,259,533,487
3404-001,2018,2,17,22,158,201,359,533
3404-001,2018,2,17,23,80,149,229,359
3404-001,2018,2,17,24,67,86,153,229
3404-001,2018,2,18,1,47,80,127,153
3404-001,2018,2,18,2,26,53,79,127
3404-001,2018,2,18,3,25,50,75,79
3404-001,2018,2,18,4,11,28,39,75
3404-001,2018,2,18,5,32,30,62,39
3404-001,2018,2,18,6,29,40,69,62
3404-001,2018,2,18,7,40,84,124,69
3404-001,2018,2,18,8,104,177,281,124
3404-001,2018,2,18,9,149,194,343,281
3404-001,2018,2,18,10,229,219,448,343
3404-001,2018,2,18,11,260,303,563,448
3404-001,2018,2,18,12,279,341,620,563
3404-001,2018,2,18,13,285,396,681,620
3404-001,2018,2,18,14,336,395,731,681
3404-001,2018,2,18,15,319,387,706,731
3404-001,2018,2,18,16,369,402,771,706
3404-001,2018,2,18,17,368,363,731,771
3404-001,2018,2,18,18,375,353,728,731
3404-001,2018,2,18,19,237,313,550,728
3404-001,2018,2,18,20,214,274,488,550
3404-001,2018,2,18,21,187,234,421,488
3404-001,2018,2,18,22,147,200,347,421
3404-001,2018,2,18,23,97,148,245,347
3404-001,2018,2,18,24,58,133,191,245
3404-001,2018,2,19,1,60,85,145,191
3404-001,2018,2,19,2,38,56,94,145
3404-001,2018,2,19,3,32,24,56,94
3404-001,2018,2,19,4,18,30,48,56
3404-001,2018,2,19,5,47,51,98,48
3404-001,2018,2,19,6,94,150,244,98
3404-001,2018,2,19,7,238,561,799,244
3404-001,2018,2,19,8,634,1789,2423,799
3404-001,2018,2,19,9,763,1211,1974,2423
3404-001,2018,2,19,10,690,707,1397,1974
3404-001,2018,2,19,11,711,701,1412,1397
3404-001,2018,2,19,12,676,660,1336,1412
3404-001,2018,2,19,13,556,635,1191,1336
3404-001,2018,2,19,14,616,695,1311,1191
3404-001,2018,2,19,15,758,771,1529,1311
3404-001,2018,2,19,16,794,682,1476,1529
3404-001,2018,2,19,17,730,646,1376,1476
3404-001,2018,2,19,18,1052,684,1736,1376
3404-001,2018,2,19,19,972,613,1585,1736
3404-001,2018,2,19,20,603,458,1061,1585
3404-001,2018,2,19,21,492,336,828,1061
3404-001,2018,2,19,22,293,206,499,828
3404-001,2018,2,19,23,169,177,346,499
3404-001,2018,2,19,24,90,90,180,346
3404-001,2018,2,20,1,60,67,127,180
3404-001,2018,2,20,2,40,45,85,127
3404-001,2018,2,20,3,52,43,95,85
3404-001,2018,2,20,4,47,34,81,95
3404-001,2018,2,20,5,67,62,129,81
3404-001,2018,2,20,6,130,190,320,129
3404-001,2018,2,20,7,277,579,856,320
3404-001,2018,2,20,8,699,1952,2651,856
3404-001,2018,2,20,9,872,1363,2235,2651
3404-001,2018,2,20,10,822,829,1651,2235
3404-001,2018,2,20,11,821,812,1633,1651
3404-001,2018,2,20,12,795,767,1562,1633
3404-001,2018,2,20,13,645,656,1301,1562
3404-001,2018,2,20,14,722,747,1469,1301
3404-001,2018,2,20,15,869,838,1707,1469
3404-001,2018,2,20,16,861,767,1628,1707
3404-001,2018,2,20,17,864,745,1609,1628
3404-001,2018,2,20,18,1189,733,1922,1609
3404-001,2018,2,20,19,1111,639,1750,1922
3404-001,2018,2,20,20,719,477,1196,1750
3404-001,2018,2,20,21,588,325,913,1196
3404-001,2018,2,20,22,330,243,573,913
3404-001,2018,2,20,23,184,159,343,573
3404-001,2018,2,20,24,148,105,253,343
3404-001,2018,2,21,1,105,68,173,253
3404-001,2018,2,21,2,60,50,110,173
3404-001,2018,2,21,3,33,40,73,110
3404-001,2018,2,21,4,47,54,101,73
3404-001,2018,2,21,5,92,65,157,101
3404-001,2018,2,21,6,132,167,299,157
3404-001,2018,2,21,7,313,598,911,299
3404-001,2018,2,21,8,727,1951,2678,911
3404-001,2018,2,21,9,963,1413,2376,2678
3404-001,2018,2,21,10,873,843,1716,2376
3404-001,2018,2,21,11,833,821,1654,1716
3404-001,2018,2,21,12,774,768,1542,1654
3404-001,2018,2,21,13,637,670,1307,1542
3404-001,2018,2,21,14,686,719,1405,1307
3404-001,2018,2,21,15,850,840,1690,1405
3404-001,2018,2,21,16,852,779,1631,1690
3404-001,2018,2,21,17,824,714,1538,1631
3404-001,2018,2,21,18,1396,742,2138,1538
3404-001,2018,2,21,19,1203,622,1825,2138
3404-001,2018,2,21,20,723,484,1207,1825
3404-001,2018,2,21,21,528,336,864,1207
3404-001,2018,2,21,22,337,234,571,864
3404-001,2018,2,21,23,170,155,325,571
3404-001,2018,2,21,24,142,105,247,325
3404-001,2018,2,22,1,87,71,158,247
3404-001,2018,2,22,2,51,46,97,158
3404-001,2018,2,22,3,59,57,116,97
3404-001,2018,2,22,4,42,38,80,116
3404-001,2018,2,22,5,78,65,143,80
3404-001,2018,2,22,6,133,186,319,143
3404-001,2018,2,22,7,303,595,898,319
3404-001,2018,2,22,8,682,1900,2582,898
3404-001,2018,2,22,9,981,1447,2428,2582
3404-001,2018,2,22,10,824,882,1706,2428
3404-001,2018,2,22,11,877,785,1662,1706
3404-001,2018,2,22,12,778,722,1500,1662
3404-001,2018,2,22,13,698,672,1370,1500
3404-001,2018,2,22,14,743,761,1504,1370
3404-001,2018,2,22,15,848,791,1639,1504
3404-001,2018,2,22,16,817,745,1562,1639
3404-001,2018,2,22,17,878,811,1689,1562
3404-001,2018,2,22,18,1248,723,1971,1689
3404-001,2018,2,22,19,1171,635,1806,1971
3404-001,2018,2,22,20,765,479,1244,1806
3404-001,2018,2,22,21,640,360,1000,1244
3404-001,2018,2,22,22,327,240,567,1000
3404-001,2018,2,22,23,209,162,371,567
3404-001,2018,2,22,24,125,112,237,371
3404-001,2018,2,23,1,94,91,185,237
3404-001,2018,2,23,2,77,50,127,185
3404-001,2018,2,23,3,42,21,63,127
3404-001,2018,2,23,4,36,27,63,63
3404-001,2018,2,23,5,66,39,105,63
3404-001,2018,2,23,6,130,95,225,105
3404-001,2018,2,23,7,267,255,522,225
3404-001,2018,2,23,8,579,644,1223,522
3404-001,2018,2,23,9,780,512,1292,1223
3404-001,2018,2,23,10,655,377,1032,1292
3404-001,2018,2,23,11,689,377,1066,1032
3404-001,2018,2,23,12,660,362,1022,1066
3404-001,2018,2,23,13,546,333,879,1022
3404-001,2018,2,23,14,604,393,997,879
3404-001,2018,2,23,15,673,395,1068,997
3404-001,2018,2,23,16,679,407,1086,1068
3404-001,2018,2,23,17,662,368,1030,1086
3404-001,2018,2,23,18,974,361,1335,1030
3404-001,2018,2,23,19,916,324,1240,1335
3404-001,2018,2,23,20,591,248,839,1240
3404-001,2018,2,23,21,457,166,623,839
3404-001,2018,2,23,22,285,106,391,623
3404-001,2018,2,23,23,145,82,227,391
3404-001,2018,2,23,24,131,66,197,227
3404-001,2018,2,24,1,79,41,120,197
3404-001,2018,2,24,2,72,26,98,120
3404-001,2018,2,24,3,48,22,70,98
3404-001,2018,2,24,4,40,24,64,70
3404-001,2018,2,24,5,75,29,104,64
3404-001,2018,2,24,6,127,82,209,104
3404-001,2018,2,24,7,195,171,366,209
3404-001,2018,2,24,8,351,349,700,366
3404-001,2018,2,24,9,497,331,828,700
3404-001,2018,2,24,10,528,309,837,828
3404-001,2018,2,24,11,521,325,846,837
3404-001,2018,2,24,12,486,301,787,846
3404-001,2018,2,24,13,411,495,906,787
3404-001,2018,2,24,14,359,580,939,906
3404-001,2018,2,24,15,372,523,895,939
3404-001,2018,2,24,16,459,574,1033,895
3404-001,2018,2,24,17,558,530,1088,1033
3404-001,2018,2,24,18,734,586,1320,1088
3404-001,2018,2,24,19,429,461,890,1320
3404-001,2018,2,24,20,284,375,659,890
3404-001,2018,2,24,21,217,239,456,659
3404-001,2018,2,24,22,150,199,349,456
3404-001,2018,2,24,23,97,118,215,349
3404-001,2018,2,24,24,65,73,138,215
3404-001,2018,2,25,1,64,75,139,138
3404-001,2018,2,25,2,34,38,72,139
3404-001,2018,2,25,3,31,41,72,72
3404-001,2018,2,25,4,25,31,56,72
3404-001,2018,2,25,5,32,26,58,56
3404-001,2018,2,25,6,49,63,112,58
3404-001,2018,2,25,7,71,131,202,112
3404-001,2018,2,25,8,176,297,473,202
3404-001,2018,2,25,9,265,257,522,473
3404-001,2018,2,25,10,259,292,551,522
3404-001,2018,2,25,11,293,307,600,551
3404-001,2018,2,25,12,271,384,655,600
3404-001,2018,2,25,13,275,415,690,655
3404-001,2018,2,25,14,280,500,780,690
3404-001,2018,2,25,15,322,478,800,780
3404-001,2018,2,25,16,366,463,829,800
3404-001,2018,2,25,17,442,416,858,829
3404-001,2018,2,25,18,473,467,940,858
3404-001,2018,2,25,19,351,407,758,940
3404-001,2018,2,25,20,235,334,569,758
3404-001,2018,2,25,21,219,209,428,569
3404-001,2018,2,25,22,158,233,391,428
3404-001,2018,2,25,23,126,195,321,391
3404-001,2018,2,25,24,76,108,184,321
3404-001,2018,2,26,1,48,79,127,184
3404-001,2018,2,26,2,39,57,96,127
3404-001,2018,2,26,3,35,29,64,96
3404-001,2018,2,26,4,27,37,64,64
3404-001,2018,2,26,5,78,62,140,64
3404-001,2018,2,26,6,127,216,343,140
3404-001,2018,2,26,7,324,643,967,343
3404-001,2018,2,26,8,689,2114,2803,967
3404-001,2018,2,26,9,836,1495,2331,2803
3404-001,2018,2,26,10,853,772,1625,2331
3404-001,2018,2,26,11,857,871,1728,1625
3404-001,2018,2,26,12,718,777,1495,1728
3404-001,2018,2,26,13,644,668,1312,1495
3404-001,2018,2,26,14,617,820,1437,1312
3404-001,2018,2,26,15,879,868,1747,1437
3404-001,2018,2,26,16,793,808,1601,1747
3404-001,2018,2,26,17,844,775,1619,1601
3404-001,2018,2,26,18,1182,715,1897,1619
3404-001,2018,2,26,19,1107,667,1774,1897
3404-001,2018,2,26,20,748,498,1246,1774
3404-001,2018,2,26,21,692,374,1066,1246
3404-001,2018,2,26,22,354,255,609,1066
3404-001,2018,2,26,23,196,149,345,609
3404-001,2018,2,26,24,135,92,227,345
3404-001,2018,2,27,1,95,79,174,227
3404-001,2018,2,27,2,73,45,118,174
3404-001,2018,2,27,3,54,41,95,118
3404-001,2018,2,27,4,66,58,124,95
3404-001,2018,2,27,5,71,67,138,124
3404-001,2018,2,27,6,145,217,362,138
3404-001,2018,2,27,7,318,589,907,362
3404-001,2018,2,27,8,714,2035,2749,907
3404-001,2018,2,27,9,995,1412,2407,2749
3404-001,2018,2,27,10,816,833,1649,2407
3404-001,2018,2,27,11,924,862,1786,1649
3404-001,2018,2,27,12,767,829,1596,1786
3404-001,2018,2,27,13,765,695,1460,1596
3404-001,2018,2,27,14,807,769,1576,1460
3404-001,2018,2,27,15,919,866,1785,1576
3404-001,2018,2,27,16,938,818,1756,1785
3404-001,2018,2,27,17,867,749,1616,1756
3404-001,2018,2,27,18,1219,767,1986,1616
3404-001,2018,2,27,19,1137,679,1816,1986
3404-001,2018,2,27,20,753,531,1284,1816
3404-001,2018,2,27,21,606,350,956,1284
3404-001,2018,2,27,22,379,242,621,956
3404-001,2018,2,27,23,216,162,378,621
3404-001,2018,2,27,24,142,117,259,378
3404-001,2018,2,28,1,91,84,175,259
3404-001,2018,2,28,2,70,48,118,175
3404-001,2018,2,28,3,56,40,96,118
3404-001,2018,2,28,4,50,43,93,96
3404-001,2018,2,28,5,80,66,146,93
3404-001,2018,2,28,6,161,191,352,146
3404-001,2018,2,28,7,322,530,852,352
3404-001,2018,2,28,8,674,1937,2611,852
3404-001,2018,2,28,9,1003,1445,2448,2611
3404-001,2018,2,28,10,869,821,1690,2448
3404-001,2018,2,28,11,913,821,1734,1690
3404-001,2018,2,28,12,820,791,1611,1734
3404-001,2018,2,28,13,724,714,1438,1611
3404-001,2018,2,28,14,774,816,1590,1438
3404-001,2018,2,28,15,777,442,1219,1590
3404-001,2018,2,28,16,733,645,1378,1219
3404-001,2018,2,28,17,712,697,1409,1378
3404-001,2018,2,28,18,1270,749,2019,1409
3404-001,2018,2,28,19,1171,757,1928,2019
3404-001,2018,2,28,20,677,576,1253,1928
3404-001,2018,2,28,21,472,335,807,1253
3404-001,2018,2,28,22,286,235,521,807
3404-001,2018,2,28,23,167,154,321,521
3404-001,2018,2,28,24,103,98,201,321
3404-001,2018,3,1,1,99,127,226,201
3404-001,2018,3,1,2,50,69,119,226
3404-001,2018,3,1,3,54,85,139,119
3404-001,2018,3,1,4,45,76,121,139
3404-001,2018,3,1,5,74,140,214,121
3404-001,2018,3,1,6,87,123,210,214
3404-001,2018,3,1,7,164,282,446,210
3404-001,2018,3,1,8,384,730,1114,446
3404-001,2018,3,1,9,516,621,1137,1114
3404-001,2018,3,1,10,511,503,1014,1137
3404-001,2018,3,1,11,514,595,1109,1014
3404-001,2018,3,1,12,559,568,1127,1109
3404-001,2018,3,1,13,439,523,962,1127
3404-001,2018,3,1,14,421,501,922,962
3404-001,2018,3,1,15,484,507,991,922
3404-001,2018,3,1,16,516,519,1035,991
3404-001,2018,3,1,17,565,503,1068,1035
3404-001,2018,3,1,18,714,550,1264,1068
3404-001,2018,3,1,19,502,474,976,1264
3404-001,2018,3,1,20,322,383,705,976
3404-001,2018,3,1,21,302,252,554,705
3404-001,2018,3,1,22,164,175,339,554
3404-001,2018,3,1,23,118,145,263,339
3404-001,2018,3,1,24,64,78,142,263
3404-001,2018,3,2,1,39,70,109,142
3404-001,2018,3,2,2,31,42,73,109
3404-001,2018,3,2,3,39,29,68,73
3404-001,2018,3,2,4,39,41,80,68
3404-001,2018,3,2,5,59,70,129,80
3404-001,2018,3,2,6,96,179,275,129
3404-001,2018,3,2,7,215,554,769,275
3404-001,2018,3,2,8,480,1720,2200,769
3404-001,2018,3,2,9,794,1254,2048,2200
3404-001,2018,3,2,10,769,752,1521,2048
3404-001,2018,3,2,11,775,785,1560,1521
3404-001,2018,3,2,12,667,744,1411,1560
3404-001,2018,3,2,13,579,676,1255,1411
3404-001,2018,3,2,14,610,723,1333,1255
3404-001,2018,3,2,15,719,832,1551,1333
3404-001,2018,3,2,16,780,786,1566,1551
3404-001,2018,3,2,17,886,716,1602,1566
3404-001,2018,3,2,18,1175,726,1901,1602
3404-001,2018,3,2,19,1199,746,1945,1901
3404-001,2018,3,2,20,729,535,1264,1945
3404-001,2018,3,2,21,553,395,948,1264
3404-001,2018,3,2,22,324,289,613,948
3404-001,2018,3,2,23,172,154,326,613
3404-001,2018,3,2,24,107,109,216,326
3404-001,2018,3,3,1,84,82,166,216
3404-001,2018,3,3,2,69,46,115,166
3404-001,2018,3,3,3,45,33,78,115
3404-001,2018,3,3,4,48,38,86,78
3404-001,2018,3,3,5,69,50,119,86
3404-001,2018,3,3,6,128,118,246,119
3404-001,2018,3,3,7,220,486,706,246
3404-001,2018,3,3,8,428,733,1161,706
3404-001,2018,3,3,9,593,726,1319,1161
3404-001,2018,3,3,10,591,610,1201,1319
3404-001,2018,3,3,11,591,638,1229,1201
3404-001,2018,3,3,12,524,657,1181,1229
3404-001,2018,3,3,13,478,575,1053,1181
3404-001,2018,3,3,14,428,589,1017,1053
3404-001,2018,3,3,15,487,673,1160,1017
3404-001,2018,3,3,16,526,576,1102,1160
3404-001,2018,3,3,17,560,528,1088,1102
3404-001,2018,3,3,18,769,598,1367,1088
3404-001,2018,3,3,19,529,498,1027,1367
3404-001,2018,3,3,20,323,324,647,1027
3404-001,2018,3,3,21,266,238,504,647
3404-001,2018,3,3,22,192,184,376,504
3404-001,2018,3,3,23,104,130,234,376
3404-001,2018,3,3,24,94,113,207,234
3404-001,2018,3,4,1,52,76,128,207
3404-001,2018,3,4,2,35,42,77,128
3404-001,2018,3,4,3,35,28,63,77
3404-001,2018,3,4,4,22,19,41,63
3404-001,2018,3,4,5,39,34,73,41
3404-001,2018,3,4,6,42,53,95,73
3404-001,2018,3,4,7,75,136,211,95
3404-001,2018,3,4,8,216,251,467,211
3404-001,2018,3,4,9,292,285,577,467
3404-001,2018,3,4,10,260,261,521,577
3404-001,2018,3,4,11,253,405,658,521
3404-001,2018,3,4,12,279,468,747,658
3404-001,2018,3,4,13,288,442,730,747
3404-001,2018,3,4,14,295,513,808,730
3404-001,2018,3,4,15,376,518,894,808
3404-001,2018,3,4,16,431,505,936,894
3404-001,2018,3,4,17,465,516,981,936
3404-001,2018,3,4,18,494,456,950,981
3404-001,2018,3,4,19,352,397,749,950
3404-001,2018,3,4,20,296,371,667,749
3404-001,2018,3,4,21,191,286,477,667
3404-001,2018,3,4,22,131,254,385,477
3404-001,2018,3,4,23,113,195,308,385
3404-001,2018,3,4,24,69,106,175,308
3404-001,2018,3,5,1,44,61,105,175
3404-001,2018,3,5,2,46,48,94,105
3404-001,2018,3,5,3,21,26,47,94
3404-001,2018,3,5,4,29,30,59,47
3404-001,2018,3,5,5,60,65,125,59
3404-001,2018,3,5,6,141,267,408,125
3404-001,2018,3,5,7,280,635,915,408
3404-001,2018,3,5,8,650,1978,2628,915
3404-001,2018,3,5,9,812,1520,2332,2628
3404-001,2018,3,5,10,710,760,1470,2332
3404-001,2018,3,5,11,788,763,1551,1470
3404-001,2018,3,5,12,708,721,1429,1551
3404-001,2018,3,5,13,653,654,1307,1429
3404-001,2018,3,5,14,695,699,1394,1307
3404-001,2018,3,5,15,788,820,1608,1394
3404-001,2018,3,5,16,805,770,1575,1608
3404-001,2018,3,5,17,863,707,1570,1575
3404-001,2018,3,5,18,1111,699,1810,1570
3404-001,2018,3,5,19,1034,661,1695,1810
3404-001,2018,3,5,20,760,472,1232,1695
3404-001,2018,3,5,21,680,391,1071,1232
3404-001,2018,3,5,22,358,301,659,1071
3404-001,2018,3,5,23,233,183,416,659
3404-001,2018,3,5,24,141,82,223,416
3404-001,2018,3,6,1,80,89,169,223
3404-001,2018,3,6,2,54,63,117,169
3404-001,2018,3,6,3,62,92,154,117
3404-001,2018,3,6,4,59,46,105,154
3404-001,2018,3,6,5,59,98,157,105
3404-001,2018,3,6,6,129,325,454,157
3404-001,2018,3,6,7,303,639,942,454
3404-001,2018,3,6,8,723,1983,2706,942
3404-001,2018,3,6,9,927,1504,2431,2706
3404-001,2018,3,6,10,864,816,1680,2431
3404-001,2018,3,6,11,787,805,1592,1680
3404-001,2018,3,6,12,770,784,1554,1592
3404-001,2018,3,6,13,633,684,1317,1554
3404-001,2018,3,6,14,707,718,1425,1317
3404-001,2018,3,6,15,815,828,1643,1425
3404-001,2018,3,6,16,870,764,1634,1643
3404-001,2018,3,6,17,909,737,1646,1634
3404-001,2018,3,6,18,1289,737,2026,1646
3404-001,2018,3,6,19,1187,644,1831,2026
3404-001,2018,3,6,20,746,527,1273,1831
3404-001,2018,3,6,21,622,400,1022,1273
3404-001,2018,3,6,22,378,234,612,1022
3404-001,2018,3,6,23,204,178,382,612
3404-001,2018,3,6,24,136,94,230,382
3404-001,2018,3,7,1,111,80,191,230
3404-001,2018,3,7,2,60,142,202,191
3404-001,2018,3,7,3,54,160,214,202
3404-001,2018,3,7,4,54,128,182,214
3404-001,2018,3,7,5,82,243,325,182
3404-001,2018,3,7,6,154,356,510,325
3404-001,2018,3,7,7,325,639,964,510
3404-001,2018,3,7,8,740,1561,2301,964
3404-001,2018,3,7,9,1037,1374,2411,2301
3404-001,2018,3,7,10,821,897,1718,2411
3404-001,2018,3,7,11,867,882,1749,1718
3404-001,2018,3,7,12,824,811,1635,1749
3404-001,2018,3,7,13,705,676,1381,1635
3404-001,2018,3,7,14,783,795,1578,1381
3404-001,2018,3,7,15,947,843,1790,1578
3404-001,2018,3,7,16,971,919,1890,1790
3404-001,2018,3,7,17,974,727,1701,1890
3404-001,2018,3,7,18,1386,751,2137,1701
3404-001,2018,3,7,19,1240,713,1953,2137
3404-001,2018,3,7,20,666,517,1183,1953
3404-001,2018,3,7,21,534,316,850,1183
3404-001,2018,3,7,22,313,250,563,850
3404-001,2018,3,7,23,207,297,504,563
3404-001,2018,3,7,24,131,240,371,504
3404-001,2018,3,8,1,111,183,294,371
3404-001,2018,3,8,2,48,92,140,294
3404-001,2018,3,8,3,49,113,162,140
3404-001,2018,3,8,4,48,115,163,162
3404-001,2018,3,8,5,69,215,284,163
3404-001,2018,3,8,6,129,290,419,284
3404-001,2018,3,8,7,227,516,743,419
3404-001,2018,3,8,8,653,1739,2392,743
3404-001,2018,3,8,9,900,1416,2316,2392
3404-001,2018,3,8,10,744,782,1526,2316
3404-001,2018,3,8,11,732,744,1476,1526
3404-001,2018,3,8,12,718,673,1391,1476
3404-001,2018,3,8,13,597,711,1308,1391
3404-001,2018,3,8,14,731,727,1458,1308
3404-001,2018,3,8,15,786,729,1515,1458
3404-001,2018,3,8,16,858,739,1597,1515
3404-001,2018,3,8,17,806,733,1539,1597
3404-001,2018,3,8,18,1079,717,1796,1539
3404-001,2018,3,8,19,1065,655,1720,1796
3404-001,2018,3,8,20,704,532,1236,1720
3404-001,2018,3,8,21,641,379,1020,1236
3404-001,2018,3,8,22,369,324,693,1020
3404-001,2018,3,8,23,213,208,421,693
3404-001,2018,3,8,24,126,117,243,421
3404-001,2018,3,9,1,81,169,250,243
3404-001,2018,3,9,2,48,139,187,250
3404-001,2018,3,9,3,46,167,213,187
3404-001,2018,3,9,4,42,114,156,213
3404-001,2018,3,9,5,78,173,251,156
3404-001,2018,3,9,6,148,261,409,251
3404-001,2018,3,9,7,334,648,982,409
3404-001,2018,3,9,8,731,1917,2648,982
3404-001,2018,3,9,9,993,1392,2385,2648
3404-001,2018,3,9,10,814,918,1732,2385
3404-001,2018,3,9,11,833,826,1659,1732
3404-001,2018,3,9,12,793,778,1571,1659
3404-001,2018,3,9,13,722,683,1405,1571
3404-001,2018,3,9,14,743,739,1482,1405
3404-001,2018,3,9,15,867,872,1739,1482
3404-001,2018,3,9,16,900,839,1739,1739
3404-001,2018,3,9,17,858,742,1600,1739
3404-001,2018,3,9,18,1450,832,2282,1600
3404-001,2018,3,9,19,1426,760,2186,2282
3404-001,2018,3,9,20,871,540,1411,2186
3404-001,2018,3,9,21,624,383,1007,1411
3404-001,2018,3,9,22,351,320,671,1007
3404-001,2018,3,9,23,188,222,410,671
3404-001,2018,3,9,24,133,167,300,410
3404-001,2018,3,10,1,116,126,242,300
3404-001,2018,3,10,2,70,97,167,242
3404-001,2018,3,10,3,57,99,156,167
3404-001,2018,3,10,4,42,70,112,156
3404-001,2018,3,10,5,92,51,143,112
3404-001,2018,3,10,6,137,141,278,143
3404-001,2018,3,10,7,229,371,600,278
3404-001,2018,3,10,8,467,802,1269,600
3404-001,2018,3,10,9,695,771,1466,1269
3404-001,2018,3,10,10,604,664,1268,1466
3404-001,2018,3,10,11,645,656,1301,1268
3404-001,2018,3,10,12,619,652,1271,1301
3404-001,2018,3,10,13,513,599,1112,1271
3404-001,2018,3,10,14,518,625,1143,1112
3404-001,2018,3,10,15,529,614,1143,1143
3404-001,2018,3,10,16,556,637,1193,1143
3404-001,2018,3,10,17,671,605,1276,1193
3404-001,2018,3,10,18,896,621,1517,1276
3404-001,2018,3,10,19,634,493,1127,1517
3404-001,2018,3,10,20,379,377,756,1127
3404-001,2018,3,10,21,242,228,470,756
3404-001,2018,3,10,22,204,214,418,470
3404-001,2018,3,10,23,108,135,243,418
3404-001,2018,3,10,24,95,97,192,243
3404-001,2018,3,11,1,68,77,145,192
3404-001,2018,3,11,2,57,46,103,145
3404-001,2018,3,11,3,41,35,76,103
3404-001,2018,3,11,4,27,38,65,76
3404-001,2018,3,11,5,42,26,68,65
3404-001,2018,3,11,6,51,76,127,68
3404-001,2018,3,11,7,101,183,284,127
3404-001,2018,3,11,8,176,238,414,284
3404-001,2018,3,11,9,239,276,515,414
3404-001,2018,3,11,10,226,304,530,515
3404-001,2018,3,11,11,287,398,685,530
3404-001,2018,3,11,12,267,489,756,685
3404-001,2018,3,11,13,300,444,744,756
3404-001,2018,3,11,14,289,480,769,744
3404-001,2018,3,11,15,367,470,837,769
3404-001,2018,3,11,16,426,468,894,837
3404-001,2018,3,11,17,544,462,1006,894
3404-001,2018,3,11,18,629,475,1104,1006
3404-001,2018,3,11,19,439,397,836,1104
3404-001,2018,3,11,20,306,369,675,836
3404-001,2018,3,11,21,260,295,555,675
3404-001,2018,3,11,22,172,296,468,555
3404-001,2018,3,11,23,111,194,305,468
3404-001,2018,3,11,24,82,113,195,305
3404-001,2018,3,12,1,49,65,114,195
3404-001,2018,3,12,2,32,37,69,114
3404-001,2018,3,12,3,29,29,58,69
3404-001,2018,3,12,4,29,44,73,58
3404-001,2018,3,12,5,59,67,126,73
3404-001,2018,3,12,6,170,215,385,126
3404-001,2018,3,12,7,360,718,1078,385
3404-001,2018,3,12,8,747,2154,2901,1078
3404-001,2018,3,12,9,1025,1616,2641,2901
3404-001,2018,3,12,10,895,827,1722,2641
3404-001,2018,3,12,11,859,813,1672,1722
3404-001,2018,3,12,12,755,864,1619,1672
3404-001,2018,3,12,13,668,701,1369,1619
3404-001,2018,3,12,14,721,809,1530,1369
3404-001,2018,3,12,15,907,879,1786,1530
3404-001,2018,3,12,16,881,797,1678,1786
3404-001,2018,3,12,17,898,751,1649,1678
3404-001,2018,3,12,18,1284,789,2073,1649
3404-001,2018,3,12,19,1166,735,1901,2073
3404-001,2018,3,12,20,722,501,1223,1901
3404-001,2018,3,12,21,667,401,1068,1223
3404-001,2018,3,12,22,363,243,606,1068
3404-001,2018,3,12,23,218,164,382,606
3404-001,2018,3,12,24,111,116,227,382
3404-001,2018,3,13,1,83,77,160,227
3404-001,2018,3,13,2,74,52,126,160
3404-001,2018,3,13,3,47,43,90,126
3404-001,2018,3,13,4,66,50,116,90
3404-001,2018,3,13,5,112,83,195,116
3404-001,2018,3,13,6,179,237,416,195
3404-001,2018,3,13,7,331,645,976,416
3404-001,2018,3,13,8,760,2074,2834,976
3404-001,2018,3,13,9,1081,1513,2594,2834
3404-001,2018,3,13,10,881,904,1785,2594
3404-001,2018,3,13,11,830,900,1730,1785
3404-001,2018,3,13,12,813,791,1604,1730
3404-001,2018,3,13,13,667,683,1350,1604
3404-001,2018,3,13,14,733,845,1578,1350
3404-001,2018,3,13,15,888,856,1744,1578
3404-001,2018,3,13,16,892,797,1689,1744
3404-001,2018,3,13,17,888,782,1670,1689
3404-001,2018,3,13,18,1240,798,2038,1670
3404-001,2018,3,13,19,1198,702,1900,2038
3404-001,2018,3,13,20,752,508,1260,1900
3404-001,2018,3,13,21,595,383,978,1260
3404-001,2018,3,13,22,340,260,600,978
3404-001,2018,3,13,23,242,189,431,600
3404-001,2018,3,13,24,109,117,226,431
3404-001,2018,3,14,1,102,72,174,226
3404-001,2018,3,14,2,72,51,123,174
3404-001,2018,3,14,3,51,41,92,123
3404-001,2018,3,14,4,69,50,119,92
3404-001,2018,3,14,5,87,78,165,119
3404-001,2018,3,14,6,182,226,408,165
3404-001,2018,3,14,7,332,653,985,408
3404-001,2018,3,14,8,808,2022,2830,985
3404-001,2018,3,14,9,1033,1512,2545,2830
3404-001,2018,3,14,10,846,884,1730,2545
3404-001,2018,3,14,11,817,889,1706,1730
3404-001,2018,3,14,12,839,799,1638,1706
3404-001,2018,3,14,13,730,714,1444,1638
3404-001,2018,3,14,14,779,768,1547,1444
3404-001,2018,3,14,15,889,801,1690,1547
3404-001,2018,3,14,16,815,750,1565,1690
3404-001,2018,3,14,17,877,771,1648,1565
3404-001,2018,3,14,18,1410,796,2206,1648
3404-001,2018,3,14,19,1265,739,2004,2206
3404-001,2018,3,14,20,779,514,1293,2004
3404-001,2018,3,14,21,509,361,870,1293
3404-001,2018,3,14,22,306,279,585,870
3404-001,2018,3,14,23,209,199,408,585
3404-001,2018,3,14,24,123,128,251,408
3404-001,2018,3,15,1,96,93,189,251
3404-001,2018,3,15,2,78,54,132,189
3404-001,2018,3,15,3,60,43,103,132
3404-001,2018,3,15,4,42,43,85,103
3404-001,2018,3,15,5,72,92,164,85
3404-001,2018,3,15,6,134,163,297,164
3404-001,2018,3,15,7,286,563,849,297
3404-001,2018,3,15,8,648,1880,2528,849
3404-001,2018,3,15,9,935,1465,2400,2528
3404-001,2018,3,15,10,821,750,1571,2400
3404-001,2018,3,15,11,713,833,1546,1571
3404-001,2018,3,15,12,742,702,1444,1546
3404-001,2018,3,15,13,691,661,1352,1444
3404-001,2018,3,15,14,734,788,1522,1352
3404-001,2018,3,15,15,827,794,1621,1522
3404-001,2018,3,15,16,912,723,1635,1621
3404-001,2018,3,15,17,812,694,1506,1635
3404-001,2018,3,15,18,1186,700,1886,1506
3404-001,2018,3,15,19,1033,650,1683,1886
3404-001,2018,3,15,20,654,477,1131,1683
3404-001,2018,3,15,21,617,375,992,1131
3404-001,2018,3,15,22,326,252,578,992
3404-001,2018,3,15,23,201,154,355,578
3404-001,2018,3,15,24,148,123,271,355
3404-001,2018,3,16,1,66,82,148,271
3404-001,2018,3,16,2,60,52,112,148
3404-001,2018,3,16,3,49,31,80,112
3404-001,2018,3,16,4,49,46,95,80
3404-001,2018,3,16,5,99,76,175,95
3404-001,2018,3,16,6,196,172,368,175
3404-001,2018,3,16,7,312,630,942,368
3404-001,2018,3,16,8,723,1896,2619,942
3404-001,2018,3,16,9,982,1460,2442,2619
3404-001,2018,3,16,10,840,867,1707,2442
3404-001,2018,3,16,11,784,803,1587,1707
3404-001,2018,3,16,12,778,804,1582,1587
3404-001,2018,3,16,13,727,627,1354,1582
3404-001,2018,3,16,14,737,765,1502,1354
3404-001,2018,3,16,15,849,886,1735,1502
3404-001,2018,3,16,16,898,794,1692,1735
3404-001,2018,3,16,17,919,774,1693,1692
3404-001,2018,3,16,18,1423,845,2268,1693
3404-001,2018,3,16,19,1439,799,2238,2268
3404-001,2018,3,16,20,889,649,1538,2238
3404-001,2018,3,16,21,599,452,1051,1538
3404-001,2018,3,16,22,387,288,675,1051
3404-001,2018,3,16,23,236,188,424,675
3404-001,2018,3,16,24,124,136,260,424
3404-001,2018,3,17,1,103,105,208,260
3404-001,2018,3,17,2,68,63,131,208
3404-001,2018,3,17,3,53,49,102,131
3404-001,2018,3,17,4,45,44,89,102
3404-001,2018,3,17,5,84,72,156,89
3404-001,2018,3,17,6,132,147,279,156
3404-001,2018,3,17,7,252,399,651,279
3404-001,2018,3,17,8,488,828,1316,651
3404-001,2018,3,17,9,689,843,1532,1316
3404-001,2018,3,17,10,662,736,1398,1532
3404-001,2018,3,17,11,672,717,1389,1398
3404-001,2018,3,17,12,711,765,1476,1389
3404-001,2018,3,17,13,585,725,1310,1476
3404-001,2018,3,17,14,559,654,1213,1310
3404-001,2018,3,17,15,608,670,1278,1213
3404-001,2018,3,17,16,637,622,1259,1278
3404-001,2018,3,17,17,684,584,1268,1259
3404-001,2018,3,17,18,1027,651,1678,1268
3404-001,2018,3,17,19,667,529,1196,1678
3404-001,2018,3,17,20,401,375,776,1196
3404-001,2018,3,17,21,265,268,533,776
3404-001,2018,3,17,22,171,181,352,533
3404-001,2018,3,17,23,141,148,289,352
3404-001,2018,3,17,24,96,94,190,289
3404-001,2018,3,18,1,81,67,148,190
3404-001,2018,3,18,2,57,45,102,148
3404-001,2018,3,18,3,36,42,78,102
3404-001,2018,3,18,4,35,48,83,78
3404-001,2018,3,18,5,44,40,84,83
3404-001,2018,3,18,6,52,79,131,84
3404-001,2018,3,18,7,101,168,269,131
3404-001,2018,3,18,8,186,277,463,269
3404-001,2018,3,18,9,290,320,610,463
3404-001,2018,3,18,10,326,359,685,610
3404-001,2018,3,18,11,355,417,772,685
3404-001,2018,3,18,12,372,506,878,772
3404-001,2018,3,18,13,355,438,793,878
3404-001,2018,3,18,14,391,444,835,793
3404-001,2018,3,18,15,478,485,963,835
3404-001,2018,3,18,16,517,461,978,963
3404-001,2018,3,18,17,559,460,1019,978
3404-001,2018,3,18,18,563,481,1044,1019
3404-001,2018,3,18,19,436,437,873,1044
3404-001,2018,3,18,20,299,342,641,873
3404-001,2018,3,18,21,245,295,540,641
3404-001,2018,3,18,22,170,215,385,540
3404-001,2018,3,18,23,94,194,288,385
3404-001,2018,3,18,24,62,120,182,288
3404-001,2018,3,19,1,45,76,121,182
3404-001,2018,3,19,2,44,45,89,121
3404-001,2018,3,19,3,36,33,69,89
3404-001,2018,3,19,4,31,39,70,69
3404-001,2018,3,19,5,62,72,134,70
3404-001,2018,3,19,6,132,211,343,134
3404-001,2018,3,19,7,305,637,942,343
3404-001,2018,3,19,8,695,1976,2671,942
3404-001,2018,3,19,9,913,1650,2563,2671
3404-001,2018,3,19,10,736,795,1531,2563
3404-001,2018,3,19,11,785,748,1533,1531
3404-001,2018,3,19,12,719,725,1444,1533
3404-001,2018,3,19,13,686,707,1393,1444
3404-001,2018,3,19,14,716,737,1453,1393
3404-001,2018,3,19,15,844,743,1587,1453
3404-001,2018,3,19,16,803,807,1610,1587
3404-001,2018,3,19,17,838,692,1530,1610
3404-001,2018,3,19,18,1194,726,1920,1530
3404-001,2018,3,19,19,1107,671,1778,1920
3404-001,2018,3,19,20,695,478,1173,1778
3404-001,2018,3,19,21,608,364,972,1173
3404-001,2018,3,19,22,353,220,573,972
3404-001,2018,3,19,23,226,162,388,573
3404-001,2018,3,19,24,111,91,202,388
3404-001,2018,3,20,1,75,73,148,202
3404-001,2018,3,20,2,54,51,105,148
3404-001,2018,3,20,3,44,42,86,105
3404-001,2018,3,20,4,48,65,113,86
3404-001,2018,3,20,5,81,67,148,113
3404-001,2018,3,20,6,194,209,403,148
3404-001,2018,3,20,7,323,655,978,403
3404-001,2018,3,20,8,799,1973,2772,978
3404-001,2018,3,20,9,989,1540,2529,2772
3404-001,2018,3,20,10,834,861,1695,2529
3404-001,2018,3,20,11,864,900,1764,1695
3404-001,2018,3,20,12,746,809,1555,1764
3404-001,2018,3,20,13,659,744,1403,1555
3404-001,2018,3,20,14,758,781,1539,1403
3404-001,2018,3,20,15,962,844,1806,1539
3404-001,2018,3,20,16,970,803,1773,1806
3404-001,2018,3,20,17,922,778,1700,1773
3404-001,2018,3,20,18,1262,775,2037,1700
3404-001,2018,3,20,19,1131,627,1758,2037
3404-001,2018,3,20,20,738,523,1261,1758
3404-001,2018,3,20,21,660,369,1029,1261
3404-001,2018,3,20,22,347,239,586,1029
3404-001,2018,3,20,23,184,157,341,586
3404-001,2018,3,20,24,123,117,240,341
3404-001,2018,3,21,1,81,66,147,240
3404-001,2018,3,21,2,75,55,130,147
3404-001,2018,3,21,3,45,38,83,130
3404-001,2018,3,21,4,47,53,100,83
3404-001,2018,3,21,5,83,65,148,100
3404-001,2018,3,21,6,188,219,407,148
3404-001,2018,3,21,7,307,641,948,407
3404-001,2018,3,21,8,780,1892,2672,948
3404-001,2018,3,21,9,1044,1511,2555,2672
3404-001,2018,3,21,10,827,836,1663,2555
3404-001,2018,3,21,11,781,801,1582,1663
3404-001,2018,3,21,12,820,761,1581,1582
3404-001,2018,3,21,13,694,646,1340,1581
3404-001,2018,3,21,14,692,715,1407,1340
3404-001,2018,3,21,15,802,764,1566,1407
3404-001,2018,3,21,16,849,789,1638,1566
3404-001,2018,3,21,17,876,645,1521,1638
3404-001,2018,3,21,18,1267,751,2018,1521
3404-001,2018,3,21,19,1185,655,1840,2018
3404-001,2018,3,21,20,580,455,1035,1840
3404-001,2018,3,21,21,492,296,788,1035
3404-001,2018,3,21,22,305,227,532,788
3404-001,2018,3,21,23,166,159,325,532
3404-001,2018,3,21,24,107,96,203,325
3404-001,2018,3,22,1,64,74,138,203
3404-001,2018,3,22,2,56,57,113,138
3404-001,2018,3,22,3,33,27,60,113
3404-001,2018,3,22,4,48,44,92,60
3404-001,2018,3,22,5,66,73,139,92
3404-001,2018,3,22,6,164,206,370,139
3404-001,2018,3,22,7,279,612,891,370
3404-001,2018,3,22,8,720,1876,2596,891
3404-001,2018,3,22,9,1007,1514,2521,2596
3404-001,2018,3,22,10,751,882,1633,2521
3404-001,2018,3,22,11,802,811,1613,1633
3404-001,2018,3,22,12,761,722,1483,1613
3404-001,2018,3,22,13,680,648,1328,1483
3404-001,2018,3,22,14,719,757,1476,1328
3404-001,2018,3,22,15,835,824,1659,1476
3404-001,2018,3,22,16,907,769,1676,1659
3404-001,2018,3,22,17,852,688,1540,1676
3404-001,2018,3,22,18,1263,758,2021,1540
3404-001,2018,3,22,19,1219,651,1870,2021
3404-001,2018,3,22,20,715,530,1245,1870
3404-001,2018,3,22,21,667,357,1024,1245
3404-001,2018,3,22,22,340,258,598,1024
3404-001,2018,3,22,23,234,174,408,598
3404-001,2018,3,22,24,124,123,247,408
3404-001,2018,3,23,1,96,72,168,247
3404-001,2018,3,23,2,59,48,107,168
3404-001,2018,3,23,3,48,35,83,107
3404-001,2018,3,23,4,53,54,107,83
3404-001,2018,3,23,5,72,63,135,107
3404-001,2018,3,23,6,172,178,350,135
3404-001,2018,3,23,7,313,638,951,350
3404-001,2018,3,23,8,749,1932,2681,951
3404-001,2018,3,23,9,995,1534,2529,2681
3404-001,2018,3,23,10,871,876,1747,2529
3404-001,2018,3,23,11,820,853,1673,1747
3404-001,2018,3,23,12,758,790,1548,1673
3404-001,2018,3,23,13,660,722,1382,1548
3404-001,2018,3,23,14,733,750,1483,1382
3404-001,2018,3,23,15,880,843,1723,1483
3404-001,2018,3,23,16,862,800,1662,1723
3404-001,2018,3,23,17,918,778,1696,1662
3404-001,2018,3,23,18,1552,827,2379,1696
3404-001,2018,3,23,19,1470,803,2273,2379
3404-001,2018,3,23,20,813,589,1402,2273
3404-001,2018,3,23,21,601,416,1017,1402
3404-001,2018,3,23,22,352,298,650,1017
3404-001,2018,3,23,23,225,173,398,650
3404-001,2018,3,23,24,123,137,260,398
3404-001,2018,3,24,1,86,85,171,260
3404-001,2018,3,24,2,60,66,126,171
3404-001,2018,3,24,3,49,42,91,126
3404-001,2018,3,24,4,42,40,82,91
3404-001,2018,3,24,5,74,62,136,82
3404-001,2018,3,24,6,130,149,279,136
3404-001,2018,3,24,7,238,395,633,279
3404-001,2018,3,24,8,483,803,1286,633
3404-001,2018,3,24,9,634,744,1378,1286
3404-001,2018,3,24,10,648,676,1324,1378
3404-001,2018,3,24,11,604,711,1315,1324
3404-001,2018,3,24,12,576,753,1329,1315
3404-001,2018,3,24,13,526,609,1135,1329
3404-001,2018,3,24,14,486,614,1100,1135
3404-001,2018,3,24,15,618,596,1214,1100
3404-001,2018,3,24,16,594,584,1178,1214
3404-001,2018,3,24,17,661,552,1213,1178
3404-001,2018,3,24,18,917,636,1553,1213
3404-001,2018,3,24,19,562,561,1123,1553
3404-001,2018,3,24,20,347,395,742,1123
3404-001,2018,3,24,21,294,262,556,742
3404-001,2018,3,24,22,180,225,405,556
3404-001,2018,3,24,23,125,171,296,405
3404-001,2018,3,24,24,98,91,189,296
3404-001,2018,3,25,1,58,68,126,189
3404-001,2018,3,25,2,41,51,92,126
3404-001,2018,3,25,3,41,37,78,92
3404-001,2018,3,25,4,29,39,68,78
3404-001,2018,3,25,5,36,32,68,68
3404-001,2018,3,25,6,51,93,144,68
3404-001,2018,3,25,7,126,163,289,144
3404-001,2018,3,25,8,194,316,510,289
3404-001,2018,3,25,9,241,303,544,510
3404-001,2018,3,25,10,245,296,541,544
3404-001,2018,3,25,11,309,467,776,541
3404-001,2018,3,25,12,310,505,815,776
3404-001,2018,3,25,13,313,464,777,815
3404-001,2018,3,25,14,315,497,812,777
3404-001,2018,3,25,15,428,547,975,812
3404-001,2018,3,25,16,460,515,975,975
3404-001,2018,3,25,17,566,469,1035,975
3404-001,2018,3,25,18,639,411,1050,1035
3404-001,2018,3,25,19,449,438,887,1050
3404-001,2018,3,25,20,324,336,660,887
3404-001,2018,3,25,21,309,335,644,660
3404-001,2018,3,25,22,206,271,477,644
3404-001,2018,3,25,23,108,192,300,477
3404-001,2018,3,25,24,66,116,182,300
3404-001,2018,3,26,1,38,72,110,182
3404-001,2018,3,26,2,38,43,81,110
3404-001,2018,3,26,3,25,35,60,81
3404-001,2018,3,26,4,38,37,75,60
3404-001,2018,3,26,5,72,55,127,75
3404-001,2018,3,26,6,166,227,393,127
3404-001,2018,3,26,7,352,734,1086,393
3404-001,2018,3,26,8,682,2025,2707,1086
3404-001,2018,3,26,9,912,1575,2487,2707
3404-001,2018,3,26,10,805,818,1623,2487
3404-001,2018,3,26,11,793,810,1603,1623
3404-001,2018,3,26,12,770,761,1531,1603
3404-001,2018,3,26,13,667,640,1307,1531
3404-001,2018,3,26,14,707,757,1464,1307
3404-001,2018,3,26,15,866,840,1706,1464
3404-001,2018,3,26,16,859,745,1604,1706
3404-001,2018,3,26,17,854,760,1614,1604
3404-001,2018,3,26,18,1239,744,1983,1614
3404-001,2018,3,26,19,1152,726,1878,1983
3404-001,2018,3,26,20,722,522,1244,1878
3404-001,2018,3,26,21,610,391,1001,1244
3404-001,2018,3,26,22,322,272,594,1001
3404-001,2018,3,26,23,216,155,371,594
3404-001,2018,3,26,24,136,155,291,371
3404-001,2018,3,27,1,82,135,217,291
3404-001,2018,3,27,2,49,41,90,217
3404-001,2018,3,27,3,35,152,187,90
3404-001,2018,3,27,4,57,158,215,187
3404-001,2018,3,27,5,79,205,284,215
3404-001,2018,3,27,6,157,204,361,284
3404-001,2018,3,27,7,367,677,1044,361
3404-001,2018,3,27,8,761,1996,2757,1044
3404-001,2018,3,27,9,961,1543,2504,2757
3404-001,2018,3,27,10,847,867,1714,2504
3404-001,2018,3,27,11,736,903,1639,1714
3404-001,2018,3,27,12,716,830,1546,1639
3404-001,2018,3,27,13,701,698,1399,1546
3404-001,2018,3,27,14,758,763,1521,1399
3404-001,2018,3,27,15,776,861,1637,1521
3404-001,2018,3,27,16,878,836,1714,1637
3404-001,2018,3,27,17,883,774,1657,1714
3404-001,2018,3,27,18,1141,798,1939,1657
3404-001,2018,3,27,19,1108,682,1790,1939
3404-001,2018,3,27,20,690,644,1334,1790
3404-001,2018,3,27,21,646,405,1051,1334
3404-001,2018,3,27,22,350,268,618,1051
3404-001,2018,3,27,23,210,231,441,618
3404-001,2018,3,27,24,126,184,310,441
3404-001,2018,3,28,1,94,101,195,310
3404-001,2018,3,28,2,62,118,180,195
3404-001,2018,3,28,3,63,42,105,180
3404-001,2018,3,28,4,40,67,107,105
3404-001,2018,3,28,5,91,151,242,107
3404-001,2018,3,28,6,156,190,346,242
3404-001,2018,3,28,7,348,622,970,346
3404-001,2018,3,28,8,755,1858,2613,970
3404-001,2018,3,28,9,952,1406,2358,2613
3404-001,2018,3,28,10,737,869,1606,2358
3404-001,2018,3,28,11,728,862,1590,1606
3404-001,2018,3,28,12,735,792,1527,1590
3404-001,2018,3,28,13,636,704,1340,1527
3404-001,2018,3,28,14,740,765,1505,1340
3404-001,2018,3,28,15,829,790,1619,1505
3404-001,2018,3,28,16,908,787,1695,1619
3404-001,2018,3,28,17,902,708,1610,1695
3404-001,2018,3,28,18,1358,843,2201,1610
3404-001,2018,3,28,19,1231,745,1976,2201
3404-001,2018,3,28,20,680,538,1218,1976
3404-001,2018,3,28,21,531,373,904,1218
3404-001,2018,3,28,22,304,277,581,904
3404-001,2018,3,28,23,206,203,409,581
3404-001,2018,3,28,24,120,195,315,409
3404-001,2018,3,29,1,106,280,386,315
3404-001,2018,3,29,2,55,113,168,386
3404-001,2018,3,29,3,45,64,109,168
3404-001,2018,3,29,4,42,82,124,109
3404-001,2018,3,29,5,113,74,187,124
3404-001,2018,3,29,6,177,209,386,187
3404-001,2018,3,29,7,349,658,1007,386
3404-001,2018,3,29,8,722,1915,2637,1007
3404-001,2018,3,29,9,940,1507,2447,2637
3404-001,2018,3,29,10,783,821,1604,2447
3404-001,2018,3,29,11,756,886,1642,1604
3404-001,2018,3,29,12,711,843,1554,1642
3404-001,2018,3,29,13,606,641,1247,1554
3404-001,2018,3,29,14,685,811,1496,1247
3404-001,2018,3,29,15,876,860,1736,1496
3404-001,2018,3,29,16,841,846,1687,1736
3404-001,2018,3,29,17,815,747,1562,1687
3404-001,2018,3,29,18,1148,771,1919,1562
3404-001,2018,3,29,19,1151,673,1824,1919
3404-001,2018,3,29,20,692,544,1236,1824
3404-001,2018,3,29,21,618,434,1052,1236
3404-001,2018,3,29,22,321,349,670,1052
3404-001,2018,3,29,23,233,181,414,670
3404-001,2018,3,29,24,121,145,266,414
3404-001,2018,3,30,1,104,106,210,266
3404-001,2018,3,30,2,72,69,141,210
3404-001,2018,3,30,3,41,46,87,141
3404-001,2018,3,30,4,69,49,118,87
3404-001,2018,3,30,5,93,92,185,118
3404-001,2018,3,30,6,159,206,365,185
3404-001,2018,3,30,7,348,680,1028,365
3404-001,2018,3,30,8,742,1831,2573,1028
3404-001,2018,3,30,9,974,1464,2438,2573
3404-001,2018,3,30,10,779,866,1645,2438
3404-001,2018,3,30,11,843,833,1676,1645
3404-001,2018,3,30,12,780,772,1552,1676
3404-001,2018,3,30,13,629,710,1339,1552
3404-001,2018,3,30,14,743,731,1474,1339
3404-001,2018,3,30,15,871,782,1653,1474
3404-001,2018,3,30,16,815,768,1583,1653
3404-001,2018,3,30,17,926,710,1636,1583
3404-001,2018,3,30,18,1378,751,2129,1636
3404-001,2018,3,30,19,1333,869,2202,2129
3404-001,2018,3,30,20,782,641,1423,2202
3404-001,2018,3,30,21,608,449,1057,1423
3404-001,2018,3,30,22,364,302,666,1057
3404-001,2018,3,30,23,184,214,398,666
3404-001,2018,3,30,24,141,136,277,398
3404-001,2018,3,31,1,107,126,233,277
3404-001,2018,3,31,2,58,114,172,233
3404-001,2018,3,31,3,60,121,181,172
3404-001,2018,3,31,4,67,139,206,181
3404-001,2018,3,31,5,78,72,150,206
3404-001,2018,3,31,6,179,231,410,150
3404-001,2018,3,31,7,279,419,698,410
3404-001,2018,3,31,8,473,698,1171,698
3404-001,2018,3,31,9,660,746,1406,1171
3404-001,2018,3,31,10,604,653,1257,1406
3404-001,2018,3,31,11,604,858,1462,1257
3404-001,2018,3,31,12,501,774,1275,1462
3404-001,2018,3,31,13,457,626,1083,1275
3404-001,2018,3,31,14,476,606,1082,1083
3404-001,2018,3,31,15,558,609,1167,1082
3404-001,2018,3,31,16,579,608,1187,1167
3404-001,2018,3,31,17,641,516,1157,1187
3404-001,2018,3,31,18,823,647,1470,1157
3404-001,2018,3,31,19,602,614,1216,1470
3404-001,2018,3,31,20,392,395,787,1216
3404-001,2018,3,31,21,265,308,573,787
3404-001,2018,3,31,22,175,212,387,573
3404-001,2018,3,31,23,131,184,315,387
3404-001,2018,3,31,24,89,112,201,315
3404-001,2018,4,1,1,79,82,161,201
3404-001,2018,4,1,2,54,48,102,161
3404-001,2018,4,1,3,42,40,82,102
3404-001,2018,4,1,4,36,44,80,82
3404-001,2018,4,1,5,49,36,85,80
3404-001,2018,4,1,6,61,86,147,85
3404-001,2018,4,1,7,109,166,275,147
3404-001,2018,4,1,8,197,296,493,275
3404-001,2018,4,1,9,263,312,575,493
3404-001,2018,4,1,10,263,328,591,575
3404-001,2018,4,1,11,306,442,748,591
3404-001,2018,4,1,12,316,506,822,748
3404-001,2018,4,1,13,338,451,789,822
3404-001,2018,4,1,14,377,467,844,789
3404-001,2018,4,1,15,433,457,890,844
3404-001,2018,4,1,16,521,434,955,890
3404-001,2018,4,1,17,542,477,1019,955
3404-001,2018,4,1,18,549,494,1043,1019
3404-001,2018,4,1,19,474,478,952,1043
3404-001,2018,4,1,20,310,291,601,952
3404-001,2018,4,1,21,257,355,612,601
3404-001,2018,4,1,22,156,230,386,612
3404-001,2018,4,1,23,110,194,304,386
3404-001,2018,4,1,24,55,124,179,304
3404-001,2018,4,2,1,42,133,175,179
3404-001,2018,4,2,2,32,44,76,175
3404-001,2018,4,2,3,32,24,56,76
3404-001,2018,4,2,4,27,128,155,56
3404-001,2018,4,2,5,77,128,205,155
3404-001,2018,4,2,6,183,217,400,205
3404-001,2018,4,2,7,323,639,962,400
3404-001,2018,4,2,8,710,1768,2478,962
3404-001,2018,4,2,9,844,1226,2070,2478
3404-001,2018,4,2,10,719,753,1472,2070
3404-001,2018,4,2,11,765,838,1603,1472
3404-001,2018,4,2,12,779,796,1575,1603
3404-001,2018,4,2,13,672,652,1324,1575
3404-001,2018,4,2,14,711,760,1471,1324
3404-001,2018,4,2,15,838,777,1615,1471
3404-001,2018,4,2,16,858,720,1578,1615
3404-001,2018,4,2,17,822,630,1452,1578
3404-001,2018,4,2,18,1125,717,1842,1452
3404-001,2018,4,2,19,1057,689,1746,1842
3404-001,2018,4,2,20,760,521,1281,1746
3404-001,2018,4,2,21,596,382,978,1281
3404-001,2018,4,2,22,350,278,628,978
3404-001,2018,4,2,23,197,210,407,628
3404-001,2018,4,2,24,138,195,333,407
3404-001,2018,4,3,1,77,180,257,333
3404-001,2018,4,3,2,76,144,220,257
3404-001,2018,4,3,3,48,121,169,220
3404-001,2018,4,3,4,49,77,126,169
3404-001,2018,4,3,5,94,68,162,126
3404-001,2018,4,3,6,160,206,366,162
3404-001,2018,4,3,7,332,577,909,366
3404-001,2018,4,3,8,769,1867,2636,909
3404-001,2018,4,3,9,977,1448,2425,2636
3404-001,2018,4,3,10,814,840,1654,2425
3404-001,2018,4,3,11,813,830,1643,1654
3404-001,2018,4,3,12,764,781,1545,1643
3404-001,2018,4,3,13,667,603,1270,1545
3404-001,2018,4,3,14,755,672,1427,1270
3404-001,2018,4,3,15,837,784,1621,1427
3404-001,2018,4,3,16,863,825,1688,1621
3404-001,2018,4,3,17,844,698,1542,1688
3404-001,2018,4,3,18,1194,764,1958,1542
3404-001,2018,4,3,19,1048,652,1700,1958
3404-001,2018,4,3,20,701,540,1241,1700
3404-001,2018,4,3,21,653,355,1008,1241
3404-001,2018,4,3,22,339,308,647,1008
3404-001,2018,4,3,23,213,155,368,647
3404-001,2018,4,3,24,111,161,272,368
3404-001,2018,4,4,1,90,77,167,272
3404-001,2018,4,4,2,55,45,100,167
3404-001,2018,4,4,3,33,69,102,100
3404-001,2018,4,4,4,50,57,107,102
3404-001,2018,4,4,5,85,67,152,107
3404-001,2018,4,4,6,106,174,280,152
3404-001,2018,4,4,7,292,548,840,280
3404-001,2018,4,4,8,675,1899,2574,840
3404-001,2018,4,4,9,871,1498,2369,2574
3404-001,2018,4,4,10,748,807,1555,2369
3404-001,2018,4,4,11,819,783,1602,1555
3404-001,2018,4,4,12,747,799,1546,1602
3404-001,2018,4,4,13,595,668,1263,1546
3404-001,2018,4,4,14,637,700,1337,1263
3404-001,2018,4,4,15,784,799,1583,1337
3404-001,2018,4,4,16,861,804,1665,1583
3404-001,2018,4,4,17,806,722,1528,1665
3404-001,2018,4,4,18,1249,727,1976,1528
3404-001,2018,4,4,19,1161,680,1841,1976
3404-001,2018,4,4,20,648,491,1139,1841
3404-001,2018,4,4,21,528,336,864,1139
3404-001,2018,4,4,22,305,234,539,864
3404-001,2018,4,4,23,174,197,371,539
3404-001,2018,4,4,24,108,90,198,371
3404-001,2018,4,5,1,103,61,164,198
3404-001,2018,4,5,2,63,46,109,164
3404-001,2018,4,5,3,40,44,84,109
3404-001,2018,4,5,4,48,41,89,84
3404-001,2018,4,5,5,56,68,124,89
3404-001,2018,4,5,6,132,210,342,124
3404-001,2018,4,5,7,280,508,788,342
3404-001,2018,4,5,8,579,1820,2399,788
3404-001,2018,4,5,9,794,1497,2291,2399
3404-001,2018,4,5,10,712,765,1477,2291
3404-001,2018,4,5,11,761,761,1522,1477
3404-001,2018,4,5,12,691,749,1440,1522
3404-001,2018,4,5,13,633,651,1284,1440
3404-001,2018,4,5,14,651,714,1365,1284
3404-001,2018,4,5,15,785,762,1547,1365
3404-001,2018,4,5,16,789,703,1492,1547
3404-001,2018,4,5,17,791,709,1500,1492
3404-001,2018,4,5,18,1003,734,1737,1500
3404-001,2018,4,5,19,993,617,1610,1737
3404-001,2018,4,5,20,640,458,1098,1610
3404-001,2018,4,5,21,531,365,896,1098
3404-001,2018,4,5,22,288,243,531,896
3404-001,2018,4,5,23,138,182,320,531
3404-001,2018,4,5,24,108,135,243,320
3404-001,2018,4,6,1,90,82,172,243
3404-001,2018,4,6,2,49,58,107,172
3404-001,2018,4,6,3,31,40,71,107
3404-001,2018,4,6,4,39,52,91,71
3404-001,2018,4,6,5,72,70,142,91
3404-001,2018,4,6,6,152,182,334,142
3404-001,2018,4,6,7,256,627,883,334
3404-001,2018,4,6,8,673,1850,2523,883
3404-001,2018,4,6,9,894,1464,2358,2523
3404-001,2018,4,6,10,838,806,1644,2358
3404-001,2018,4,6,11,856,846,1702,1644
3404-001,2018,4,6,12,727,795,1522,1702
3404-001,2018,4,6,13,703,748,1451,1522
3404-001,2018,4,6,14,671,796,1467,1451
3404-001,2018,4,6,15,855,828,1683,1467
3404-001,2018,4,6,16,874,806,1680,1683
3404-001,2018,4,6,17,883,757,1640,1680
3404-001,2018,4,6,18,1463,856,2319,1640
3404-001,2018,4,6,19,1426,865,2291,2319
3404-001,2018,4,6,20,823,655,1478,2291
3404-001,2018,4,6,21,583,447,1030,1478
3404-001,2018,4,6,22,349,286,635,1030
3404-001,2018,4,6,23,179,208,387,635
3404-001,2018,4,6,24,126,130,256,387
3404-001,2018,4,7,1,93,99,192,256
3404-001,2018,4,7,2,74,56,130,192
3404-001,2018,4,7,3,44,95,139,130
3404-001,2018,4,7,4,57,46,103,139
3404-001,2018,4,7,5,88,71,159,103
3404-001,2018,4,7,6,137,194,331,159
3404-001,2018,4,7,7,218,387,605,331
3404-001,2018,4,7,8,434,738,1172,605
3404-001,2018,4,7,9,640,774,1414,1172
3404-001,2018,4,7,10,577,662,1239,1414
3404-001,2018,4,7,11,591,760,1351,1239
3404-001,2018,4,7,12,538,709,1247,1351
3404-001,2018,4,7,13,533,662,1195,1247
3404-001,2018,4,7,14,494,627,1121,1195
3404-001,2018,4,7,15,570,663,1233,1121
3404-001,2018,4,7,16,585,604,1189,1233
3404-001,2018,4,7,17,587,521,1108,1189
3404-001,2018,4,7,18,822,593,1415,1108
3404-001,2018,4,7,19,557,520,1077,1415
3404-001,2018,4,7,20,317,402,719,1077
3404-001,2018,4,7,21,266,310,576,719
3404-001,2018,4,7,22,177,199,376,576
3404-001,2018,4,7,23,124,168,292,376
3404-001,2018,4,7,24,73,104,177,292
3404-001,2018,4,8,1,53,60,113,177
3404-001,2018,4,8,2,47,54,101,113
3404-001,2018,4,8,3,21,37,58,101
3404-001,2018,4,8,4,36,26,62,58
3404-001,2018,4,8,5,41,34,75,62
3404-001,2018,4,8,6,47,82,129,75
3404-001,2018,4,8,7,102,174,276,129
3404-001,2018,4,8,8,179,289,468,276
3404-001,2018,4,8,9,260,296,556,468
3404-001,2018,4,8,10,256,342,598,556
3404-001,2018,4,8,11,280,393,673,598
3404-001,2018,4,8,12,274,475,749,673
3404-001,2018,4,8,13,333,453,786,749
3404-001,2018,4,8,14,347,465,812,786
3404-001,2018,4,8,15,417,468,885,812
3404-001,2018,4,8,16,523,463,986,885
3404-001,2018,4,8,17,545,508,1053,986
3404-001,2018,4,8,18,574,567,1141,1053
3404-001,2018,4,8,19,437,421,858,1141
3404-001,2018,4,8,20,347,383,730,858
3404-001,2018,4,8,21,265,322,587,730
3404-001,2018,4,8,22,162,240,402,587
3404-001,2018,4,8,23,110,211,321,402
3404-001,2018,4,8,24,81,96,177,321
3404-001,2018,4,9,1,50,67,117,177
3404-001,2018,4,9,2,25,51,76,117
3404-001,2018,4,9,3,26,36,62,76
3404-001,2018,4,9,4,46,32,78,62
3404-001,2018,4,9,5,83,123,206,78
3404-001,2018,4,9,6,142,348,490,206
3404-001,2018,4,9,7,397,780,1177,490
3404-001,2018,4,9,8,776,2004,2780,1177
3404-001,2018,4,9,9,915,1517,2432,2780
3404-001,2018,4,9,10,807,791,1598,2432
3404-001,2018,4,9,11,795,817,1612,1598
3404-001,2018,4,9,12,778,817,1595,1612
3404-001,2018,4,9,13,607,701,1308,1595
3404-001,2018,4,9,14,669,793,1462,1308
3404-001,2018,4,9,15,937,797,1734,1462
3404-001,2018,4,9,16,799,775,1574,1734
3404-001,2018,4,9,17,816,725,1541,1574
3404-001,2018,4,9,18,1130,844,1974,1541
3404-001,2018,4,9,19,1179,695,1874,1974
3404-001,2018,4,9,20,725,556,1281,1874
3404-001,2018,4,9,21,617,388,1005,1281
3404-001,2018,4,9,22,352,255,607,1005
3404-001,2018,4,9,23,191,184,375,607
3404-001,2018,4,9,24,103,95,198,375
3404-001,2018,4,10,1,90,96,186,198
3404-001,2018,4,10,2,56,53,109,186
3404-001,2018,4,10,3,45,27,72,109
3404-001,2018,4,10,4,47,50,97,72
3404-001,2018,4,10,5,66,70,136,97
3404-001,2018,4,10,6,179,240,419,136
3404-001,2018,4,10,7,358,698,1056,419
3404-001,2018,4,10,8,788,1949,2737,1056
3404-001,2018,4,10,9,917,1465,2382,2737
3404-001,2018,4,10,10,800,940,1740,2382
3404-001,2018,4,10,11,817,870,1687,1740
3404-001,2018,4,10,12,781,768,1549,1687
3404-001,2018,4,10,13,640,624,1264,1549
3404-001,2018,4,10,14,747,724,1471,1264
3404-001,2018,4,10,15,891,828,1719,1471
3404-001,2018,4,10,16,811,763,1574,1719
3404-001,2018,4,10,17,842,715,1557,1574
3404-001,2018,4,10,18,1149,769,1918,1557
3404-001,2018,4,10,19,1110,756,1866,1918
3404-001,2018,4,10,20,652,575,1227,1866
3404-001,2018,4,10,21,583,387,970,1227
3404-001,2018,4,10,22,330,290,620,970
3404-001,2018,4,10,23,185,207,392,620
3404-001,2018,4,10,24,100,140,240,392
3404-001,2018,4,11,1,76,102,178,240
3404-001,2018,4,11,2,54,120,174,178
3404-001,2018,4,11,3,58,134,192,174
3404-001,2018,4,11,4,34,75,109,192
3404-001,2018,4,11,5,69,126,195,109
3404-001,2018,4,11,6,188,246,434,195
3404-001,2018,4,11,7,338,657,995,434
3404-001,2018,4,11,8,748,1825,2573,995
3404-001,2018,4,11,9,869,1445,2314,2573
3404-001,2018,4,11,10,732,798,1530,2314
3404-001,2018,4,11,11,793,813,1606,1530
3404-001,2018,4,11,12,756,761,1517,1606
3404-001,2018,4,11,13,616,686,1302,1517
3404-001,2018,4,11,14,688,732,1420,1302
3404-001,2018,4,11,15,806,794,1600,1420
3404-001,2018,4,11,16,884,796,1680,1600
3404-001,2018,4,11,17,854,715,1569,1680
3404-001,2018,4,11,18,1291,745,2036,1569
3404-001,2018,4,11,19,1151,661,1812,2036
3404-001,2018,4,11,20,681,511,1192,1812
3404-001,2018,4,11,21,552,371,923,1192
3404-001,2018,4,11,22,320,283,603,923
3404-001,2018,4,11,23,184,203,387,603
3404-001,2018,4,11,24,107,141,248,387
3404-001,2018,4,12,1,102,80,182,248
3404-001,2018,4,12,2,66,76,142,182
3404-001,2018,4,12,3,50,53,103,142
3404-001,2018,4,12,4,65,77,142,103
3404-001,2018,4,12,5,95,111,206,142
3404-001,2018,4,12,6,180,252,432,206
3404-001,2018,4,12,7,382,666,1048,432
3404-001,2018,4,12,8,751,1872,2623,1048
3404-001,2018,4,12,9,980,1383,2363,2623
3404-001,2018,4,12,10,778,892,1670,2363
3404-001,2018,4,12,11,763,837,1600,1670
3404-001,2018,4,12,12,828,769,1597,1600
3404-001,2018,4,12,13,535,629,1164,1597
3404-001,2018,4,12,14,746,799,1545,1164
3404-001,2018,4,12,15,869,847,1716,1545
3404-001,2018,4,12,16,848,843,1691,1716
3404-001,2018,4,12,17,837,828,1665,1691
3404-001,2018,4,12,18,1196,852,2048,1665
3404-001,2018,4,12,19,1158,733,1891,2048
3404-001,2018,4,12,20,734,618,1352,1891
3404-001,2018,4,12,21,597,506,1103,1352
3404-001,2018,4,12,22,333,327,660,1103
3404-001,2018,4,12,23,220,263,483,660
3404-001,2018,4,12,24,163,151,314,483
3404-001,2018,4,13,1,103,96,199,314
3404-001,2018,4,13,2,76,84,160,199
3404-001,2018,4,13,3,40,43,83,160
3404-001,2018,4,13,4,47,60,107,83
3404-001,2018,4,13,5,79,127,206,107
3404-001,2018,4,13,6,170,247,417,206
3404-001,2018,4,13,7,397,711,1108,417
3404-001,2018,4,13,8,798,1994,2792,1108
3404-001,2018,4,13,9,898,1491,2389,2792
3404-001,2018,4,13,10,841,869,1710,2389
3404-001,2018,4,13,11,859,848,1707,1710
3404-001,2018,4,13,12,837,803,1640,1707
3404-001,2018,4,13,13,664,727,1391,1640
3404-001,2018,4,13,14,719,822,1541,1391
3404-001,2018,4,13,15,890,959,1849,1541
3404-001,2018,4,13,16,838,849,1687,1849
3404-001,2018,4,13,17,923,887,1810,1687
3404-001,2018,4,13,18,1378,888,2266,1810
3404-001,2018,4,13,19,1308,889,2197,2266
3404-001,2018,4,13,20,803,696,1499,2197
3404-001,2018,4,13,21,610,500,1110,1499
3404-001,2018,4,13,22,302,325,627,1110
3404-001,2018,4,13,23,199,190,389,627
3404-001,2018,4,13,24,130,141,271,389
3404-001,2018,4,14,1,84,199,283,271
3404-001,2018,4,14,2,73,106,179,283
3404-001,2018,4,14,3,43,80,123,179
3404-001,2018,4,14,4,63,59,122,123
3404-001,2018,4,14,5,80,81,161,122
3404-001,2018,4,14,6,101,185,286,161
3404-001,2018,4,14,7,196,343,539,286
3404-001,2018,4,14,8,387,701,1088,539
3404-001,2018,4,14,9,534,716,1250,1088
3404-001,2018,4,14,10,552,720,1272,1250
3404-001,2018,4,14,11,544,802,1346,1272
3404-001,2018,4,14,12,505,723,1228,1346
3404-001,2018,4,14,13,505,620,1125,1228
3404-001,2018,4,14,14,490,586,1076,1125
3404-001,2018,4,14,15,544,615,1159,1076
3404-001,2018,4,14,16,501,602,1103,1159
3404-001,2018,4,14,17,551,545,1096,1103
3404-001,2018,4,14,18,668,665,1333,1096
3404-001,2018,4,14,19,443,526,969,1333
3404-001,2018,4,14,20,262,371,633,969
3404-001,2018,4,14,21,244,262,506,633
3404-001,2018,4,14,22,153,183,336,506
3404-001,2018,4,14,23,97,141,238,336
3404-001,2018,4,14,24,64,85,149,238
3404-001,2018,4,15,1,60,68,128,149
3404-001,2018,4,15,2,34,33,67,128
3404-001,2018,4,15,3,25,38,63,67
3404-001,2018,4,15,4,32,35,67,63
3404-001,2018,4,15,5,37,35,72,67
3404-001,2018,4,15,6,79,84,163,72
3404-001,2018,4,15,7,120,170,290,163
3404-001,2018,4,15,8,218,292,510,290
3404-001,2018,4,15,9,273,304,577,510
3404-001,2018,4,15,10,236,335,571,577
3404-001,2018,4,15,11,270,418,688,571
3404-001,2018,4,15,12,299,490,789,688
3404-001,2018,4,15,13,317,452,769,789
3404-001,2018,4,15,14,354,466,820,769
3404-001,2018,4,15,15,417,462,879,820
3404-001,2018,4,15,16,455,450,905,879
3404-001,2018,4,15,17,485,504,989,905
3404-001,2018,4,15,18,556,502,1058,989
3404-001,2018,4,15,19,408,450,858,1058
3404-001,2018,4,15,20,340,337,677,858
3404-001,2018,4,15,21,264,338,602,677
3404-001,2018,4,15,22,178,235,413,602
3404-001,2018,4,15,23,105,202,307,413
3404-001,2018,4,15,24,62,110,172,307
3404-001,2018,4,16,1,50,88,138,172
3404-001,2018,4,16,2,33,145,178,138
3404-001,2018,4,16,3,30,118,148,178
3404-001,2018,4,16,4,45,42,87,148
3404-001,2018,4,16,5,93,98,191,87
3404-001,2018,4,16,6,176,247,423,191
3404-001,2018,4,16,7,366,819,1185,423
3404-001,2018,4,16,8,778,2218,2996,1185
3404-001,2018,4,16,9,940,1652,2592,2996
3404-001,2018,4,16,10,790,904,1694,2592
3404-001,2018,4,16,11,816,877,1693,1694
3404-001,2018,4,16,12,811,807,1618,1693
3404-001,2018,4,16,13,654,702,1356,1618
3404-001,2018,4,16,14,745,819,1564,1356
3404-001,2018,4,16,15,911,855,1766,1564
3404-001,2018,4,16,16,916,838,1754,1766
3404-001,2018,4,16,17,849,813,1662,1754
3404-001,2018,4,16,18,1132,872,2004,1662
3404-001,2018,4,16,19,1093,752,1845,2004
3404-001,2018,4,16,20,740,672,1412,1845
3404-001,2018,4,16,21,657,418,1075,1412
3404-001,2018,4,16,22,349,295,644,1075
3404-001,2018,4,16,23,197,162,359,644
3404-001,2018,4,16,24,110,113,223,359
3404-001,2018,4,17,1,75,86,161,223
3404-001,2018,4,17,2,66,70,136,161
3404-001,2018,4,17,3,39,74,113,136
3404-001,2018,4,17,4,35,64,99,113
3404-001,2018,4,17,5,103,96,199,99
3404-001,2018,4,17,6,168,234,402,199
3404-001,2018,4,17,7,376,719,1095,402
3404-001,2018,4,17,8,752,1755,2507,1095
3404-001,2018,4,17,9,915,1408,2323,2507
3404-001,2018,4,17,10,816,908,1724,2323
3404-001,2018,4,17,11,775,910,1685,1724
3404-001,2018,4,17,12,721,790,1511,1685
3404-001,2018,4,17,13,724,775,1499,1511
3404-001,2018,4,17,14,695,948,1643,1499
3404-001,2018,4,17,15,977,860,1837,1643
3404-001,2018,4,17,16,919,833,1752,1837
3404-001,2018,4,17,17,915,780,1695,1752
3404-001,2018,4,17,18,1224,898,2122,1695
3404-001,2018,4,17,19,1176,889,2065,2122
3404-001,2018,4,17,20,782,561,1343,2065
3404-001,2018,4,17,21,690,413,1103,1343
3404-001,2018,4,17,22,433,287,720,1103
3404-001,2018,4,17,23,229,181,410,720
3404-001,2018,4,17,24,146,150,296,410
3404-001,2018,4,18,1,94,90,184,296
3404-001,2018,4,18,2,62,82,144,184
3404-001,2018,4,18,3,53,102,155,144
3404-001,2018,4,18,4,80,66,146,155
3404-001,2018,4,18,5,91,96,187,146
3404-001,2018,4,18,6,194,210,404,187
3404-001,2018,4,18,7,419,563,982,404
3404-001,2018,4,18,8,773,1670,2443,982
3404-001,2018,4,18,9,1029,1186,2215,2443
3404-001,2018,4,18,10,892,897,1789,2215
3404-001,2018,4,18,11,903,936,1839,1789
3404-001,2018,4,18,12,801,864,1665,1839
3404-001,2018,4,18,13,705,831,1536,1665
3404-001,2018,4,18,14,817,953,1770,1536
3404-001,2018,4,18,15,975,899,1874,1770
3404-001,2018,4,18,16,948,855,1803,1874
3404-001,2018,4,18,17,957,795,1752,1803
3404-001,2018,4,18,18,1518,823,2341,1752
3404-001,2018,4,18,19,1297,719,2016,2341
3404-001,2018,4,18,20,789,530,1319,2016
3404-001,2018,4,18,21,536,355,891,1319
3404-001,2018,4,18,22,345,252,597,891
3404-001,2018,4,18,23,220,200,420,597
3404-001,2018,4,18,24,139,144,283,420
3404-001,2018,4,19,1,93,94,187,283
3404-001,2018,4,19,2,70,67,137,187
3404-001,2018,4,19,3,57,69,126,137
3404-001,2018,4,19,4,44,72,116,126
3404-001,2018,4,19,5,95,69,164,116
3404-001,2018,4,19,6,197,242,439,164
3404-001,2018,4,19,7,434,704,1138,439
3404-001,2018,4,19,8,785,1968,2753,1138
3404-001,2018,4,19,9,944,1458,2402,2753
3404-001,2018,4,19,10,830,929,1759,2402
3404-001,2018,4,19,11,900,936,1836,1759
3404-001,2018,4,19,12,864,810,1674,1836
3404-001,2018,4,19,13,731,788,1519,1674
3404-001,2018,4,19,14,808,862,1670,1519
3404-001,2018,4,19,15,954,891,1845,1670
3404-001,2018,4,19,16,957,907,1864,1845
3404-001,2018,4,19,17,906,817,1723,1864
3404-001,2018,4,19,18,1260,767,2027,1723
3404-001,2018,4,19,19,1222,746,1968,2027
3404-001,2018,4,19,20,778,543,1321,1968
3404-001,2018,4,19,21,714,441,1155,1321
3404-001,2018,4,19,22,348,316,664,1155
3404-001,2018,4,19,23,236,188,424,664
3404-001,2018,4,19,24,130,117,247,424
3404-001,2018,4,20,1,72,103,175,247
3404-001,2018,4,20,2,77,75,152,175
3404-001,2018,4,20,3,68,67,135,152
3404-001,2018,4,20,4,53,65,118,135
3404-001,2018,4,20,5,88,70,158,118
3404-001,2018,4,20,6,197,240,437,158
3404-001,2018,4,20,7,438,667,1105,437
3404-001,2018,4,20,8,810,1939,2749,1105
3404-001,2018,4,20,9,1013,1505,2518,2749
3404-001,2018,4,20,10,816,906,1722,2518
3404-001,2018,4,20,11,894,991,1885,1722
3404-001,2018,4,20,12,859,905,1764,1885
3404-001,2018,4,20,13,743,796,1539,1764
3404-001,2018,4,20,14,859,816,1675,1539
3404-001,2018,4,20,15,963,911,1874,1675
3404-001,2018,4,20,16,1000,915,1915,1874
3404-001,2018,4,20,17,1069,894,1963,1915
3404-001,2018,4,20,18,1639,970,2609,1963
3404-001,2018,4,20,19,1487,906,2393,2609
3404-001,2018,4,20,20,916,705,1621,2393
3404-001,2018,4,20,21,648,622,1270,1621
3404-001,2018,4,20,22,422,562,984,1270
3404-001,2018,4,20,23,236,142,378,984
3404-001,2018,4,20,24,143,57,200,378
3404-001,2018,4,21,1,109,100,209,200
3404-001,2018,4,21,2,74,107,181,209
3404-001,2018,4,21,3,60,28,88,181
3404-001,2018,4,21,4,50,104,154,88
3404-001,2018,4,21,5,81,54,135,154
3404-001,2018,4,21,6,180,448,628,135
3404-001,2018,4,21,7,296,761,1057,628
3404-001,2018,4,21,8,528,951,1479,1057
3404-001,2018,4,21,9,679,776,1455,1479
3404-001,2018,4,21,10,623,832,1455,1455
3404-001,2018,4,21,11,608,844,1452,1455
3404-001,2018,4,21,12,629,755,1384,1452
3404-001,2018,4,21,13,571,678,1249,1384
3404-001,2018,4,21,14,612,631,1243,1249
3404-001,2018,4,21,15,689,688,1377,1243
3404-001,2018,4,21,16,740,666,1406,1377
3404-001,2018,4,21,17,765,533,1298,1406
3404-001,2018,4,21,18,1083,629,1712,1298
3404-001,2018,4,21,19,824,523,1347,1712
3404-001,2018,4,21,20,508,386,894,1347
3404-001,2018,4,21,21,309,286,595,894
3404-001,2018,4,21,22,220,191,411,595
3404-001,2018,4,21,23,145,154,299,411
3404-001,2018,4,21,24,121,94,215,299
3404-001,2018,4,22,1,77,64,141,215
3404-001,2018,4,22,2,49,44,93,141
3404-001,2018,4,22,3,46,38,84,93
3404-001,2018,4,22,4,23,30,53,84
3404-001,2018,4,22,5,33,34,67,53
3404-001,2018,4,22,6,78,83,161,67
3404-001,2018,4,22,7,145,172,317,161
3404-001,2018,4,22,8,209,290,499,317
3404-001,2018,4,22,9,319,300,619,499
3404-001,2018,4,22,10,345,338,683,619
3404-001,2018,4,22,11,364,406,770,683
3404-001,2018,4,22,12,402,482,884,770
3404-001,2018,4,22,13,414,452,866,884
3404-001,2018,4,22,14,457,466,923,866
3404-001,2018,4,22,15,478,465,943,923
3404-001,2018,4,22,16,545,456,1001,943
3404-001,2018,4,22,17,508,506,1014,1001
3404-001,2018,4,22,18,565,534,1099,1014
3404-001,2018,4,22,19,447,436,883,1099
3404-001,2018,4,22,20,320,360,680,883
3404-001,2018,4,22,21,249,330,579,680
3404-001,2018,4,22,22,169,238,407,579
3404-001,2018,4,22,23,106,206,312,407
3404-001,2018,4,22,24,90,103,193,312
3404-001,2018,4,23,1,42,78,120,193
3404-001,2018,4,23,2,45,98,143,120
3404-001,2018,4,23,3,16,77,93,143
3404-001,2018,4,23,4,30,37,67,93
3404-001,2018,4,23,5,66,110,176,67
3404-001,2018,4,23,6,123,298,421,176
3404-001,2018,4,23,7,305,800,1105,421
3404-001,2018,4,23,8,682,2111,2793,1105
3404-001,2018,4,23,9,945,1584,2529,2793
3404-001,2018,4,23,10,683,719,1402,2529
3404-001,2018,4,23,11,748,717,1465,1402
3404-001,2018,4,23,12,708,799,1507,1465
3404-001,2018,4,23,13,612,632,1244,1507
3404-001,2018,4,23,14,674,717,1391,1244
3404-001,2018,4,23,15,783,762,1545,1391
3404-001,2018,4,23,16,809,758,1567,1545
3404-001,2018,4,23,17,774,687,1461,1567
3404-001,2018,4,23,18,1123,722,1845,1461
3404-001,2018,4,23,19,1027,696,1723,1845
3404-001,2018,4,23,20,698,694,1392,1723
3404-001,2018,4,23,21,591,487,1078,1392
3404-001,2018,4,23,22,355,332,687,1078
3404-001,2018,4,23,23,194,423,617,687
3404-001,2018,4,23,24,120,217,337,617
3404-001,2018,4,24,1,88,91,179,337
3404-001,2018,4,24,2,79,62,141,179
3404-001,2018,4,24,3,43,50,93,141
3404-001,2018,4,24,4,48,57,105,93
3404-001,2018,4,24,5,65,83,148,105
3404-001,2018,4,24,6,152,237,389,148
3404-001,2018,4,24,7,323,708,1031,389
3404-001,2018,4,24,8,664,1852,2516,1031
3404-001,2018,4,24,9,981,1436,2417,2516
3404-001,2018,4,24,10,838,924,1762,2417
3404-001,2018,4,24,11,870,845,1715,1762
3404-001,2018,4,24,12,797,808,1605,1715
3404-001,2018,4,24,13,739,733,1472,1605
3404-001,2018,4,24,14,765,863,1628,1472
3404-001,2018,4,24,15,839,895,1734,1628
3404-001,2018,4,24,16,971,860,1831,1734
3404-001,2018,4,24,17,877,793,1670,1831
3404-001,2018,4,24,18,1232,832,2064,1670
3404-001,2018,4,24,19,1152,732,1884,2064
3404-001,2018,4,24,20,739,615,1354,1884
3404-001,2018,4,24,21,698,483,1181,1354
3404-001,2018,4,24,22,389,352,741,1181
3404-001,2018,4,24,23,203,203,406,741
3404-001,2018,4,24,24,153,131,284,406
3404-001,2018,4,25,1,90,81,171,284
3404-001,2018,4,25,2,75,101,176,171
3404-001,2018,4,25,3,53,118,171,176
3404-001,2018,4,25,4,57,70,127,171
3404-001,2018,4,25,5,91,111,202,127
3404-001,2018,4,25,6,176,228,404,202
3404-001,2018,4,25,7,393,610,1003,404
3404-001,2018,4,25,8,764,1748,2512,1003
3404-001,2018,4,25,9,965,1316,2281,2512
3404-001,2018,4,25,10,805,848,1653,2281
3404-001,2018,4,25,11,850,874,1724,1653
3404-001,2018,4,25,12,804,725,1529,1724
3404-001,2018,4,25,13,757,642,1399,1529
3404-001,2018,4,25,14,742,863,1605,1399
3404-001,2018,4,25,15,943,685,1628,1605
3404-001,2018,4,25,16,997,918,1915,1628
3404-001,2018,4,25,17,945,758,1703,1915
3404-001,2018,4,25,18,1476,869,2345,1703
3404-001,2018,4,25,19,1274,789,2063,2345
3404-001,2018,4,25,20,814,546,1360,2063
3404-001,2018,4,25,21,545,342,887,1360
3404-001,2018,4,25,22,321,268,589,887
3404-001,2018,4,25,23,224,202,426,589
3404-001,2018,4,25,24,122,142,264,426
3404-001,2018,4,26,1,123,87,210,264
3404-001,2018,4,26,2,80,72,152,210
3404-001,2018,4,26,3,61,61,122,152
3404-001,2018,4,26,4,67,74,141,122
3404-001,2018,4,26,5,98,90,188,141
3404-001,2018,4,26,6,187,247,434,188
3404-001,2018,4,26,7,428,685,1113,434
3404-001,2018,4,26,8,771,1920,2691,1113
3404-001,2018,4,26,9,990,1420,2410,2691
3404-001,2018,4,26,10,781,910,1691,2410
3404-001,2018,4,26,11,867,886,1753,1691
3404-001,2018,4,26,12,856,790,1646,1753
3404-001,2018,4,26,13,701,744,1445,1646
3404-001,2018,4,26,14,830,834,1664,1445
3404-001,2018,4,26,15,951,892,1843,1664
3404-001,2018,4,26,16,1022,833,1855,1843
3404-001,2018,4,26,17,990,879,1869,1855
3404-001,2018,4,26,18,1403,862,2265,1869
3404-001,2018,4,26,19,1280,756,2036,2265
3404-001,2018,4,26,20,828,521,1349,2036
3404-001,2018,4,26,21,688,355,1043,1349
3404-001,2018,4,26,22,398,471,869,1043
3404-001,2018,4,26,23,241,130,371,869
3404-001,2018,4,26,24,157,162,319,371
3404-001,2018,4,27,1,108,56,164,319
3404-001,2018,4,27,2,85,48,133,164
3404-001,2018,4,27,3,68,26,94,133
3404-001,2018,4,27,4,41,39,80,94
3404-001,2018,4,27,5,88,67,155,80
3404-001,2018,4,27,6,206,489,695,155
3404-001,2018,4,27,7,415,869,1284,695
3404-001,2018,4,27,8,826,1183,2009,1284
3404-001,2018,4,27,9,927,1227,2154,2009
3404-001,2018,4,27,10,900,925,1825,2154
3404-001,2018,4,27,11,897,892,1789,1825
3404-001,2018,4,27,12,863,897,1760,1789
3404-001,2018,4,27,13,734,813,1547,1760
3404-001,2018,4,27,14,791,777,1568,1547
3404-001,2018,4,27,15,995,918,1913,1568
3404-001,2018,4,27,16,1093,781,1874,1913
3404-001,2018,4,27,17,963,802,1765,1874
3404-001,2018,4,27,18,1625,956,2581,1765
3404-001,2018,4,27,19,1502,1048,2550,2581
3404-001,2018,4,27,20,960,877,1837,2550
3404-001,2018,4,27,21,677,484,1161,1837
3404-001,2018,4,27,22,361,367,728,1161
3404-001,2018,4,27,23,279,166,445,728
3404-001,2018,4,27,24,151,99,250,445
3404-001,2018,4,28,1,121,150,271,250
3404-001,2018,4,28,2,74,106,180,271
3404-001,2018,4,28,3,56,54,110,180
3404-001,2018,4,28,4,58,82,140,110
3404-001,2018,4,28,5,112,68,180,140
3404-001,2018,4,28,6,169,316,485,180
3404-001,2018,4,28,7,326,552,878,485
3404-001,2018,4,28,8,498,826,1324,878
3404-001,2018,4,28,9,690,746,1436,1324
3404-001,2018,4,28,10,631,776,1407,1436
3404-001,2018,4,28,11,648,823,1471,1407
3404-001,2018,4,28,12,674,739,1413,1471
3404-001,2018,4,28,13,655,649,1304,1413
3404-001,2018,4,28,14,620,608,1228,1304
3404-001,2018,4,28,15,709,652,1361,1228
3404-001,2018,4,28,16,741,634,1375,1361
3404-001,2018,4,28,17,784,539,1323,1375
3404-001,2018,4,28,18,971,647,1618,1323
3404-001,2018,4,28,19,700,524,1224,1618
3404-001,2018,4,28,20,458,378,836,1224
3404-001,2018,4,28,21,341,274,615,836
3404-001,2018,4,28,22,205,187,392,615
3404-001,2018,4,28,23,120,148,268,392
3404-001,2018,4,28,24,114,90,204,268
3404-001,2018,4,29,1,86,66,152,204
3404-001,2018,4,29,2,43,38,81,152
3404-001,2018,4,29,3,42,38,80,81
3404-001,2018,4,29,4,40,32,72,80
3404-001,2018,4,29,5,42,34,76,72
3404-001,2018,4,29,6,74,84,158,76
3404-001,2018,4,29,7,150,171,321,158
3404-001,2018,4,29,8,229,291,520,321
3404-001,2018,4,29,9,257,302,559,520
3404-001,2018,4,29,10,286,336,622,559
3404-001,2018,4,29,11,344,412,756,622
3404-001,2018,4,29,12,384,486,870,756
3404-001,2018,4,29,13,402,452,854,870
3404-001,2018,4,29,14,440,466,906,854
3404-001,2018,4,29,15,520,464,984,906
3404-001,2018,4,29,16,569,453,1022,984
3404-001,2018,4,29,17,654,505,1159,1022
3404-001,2018,4,29,18,736,518,1254,1159
3404-001,2018,4,29,19,575,443,1018,1254
3404-001,2018,4,29,20,481,348,829,1018
3404-001,2018,4,29,21,402,334,736,829
3404-001,2018,4,29,22,244,236,480,736
3404-001,2018,4,29,23,163,204,367,480
3404-001,2018,4,29,24,92,106,198,367
3404-001,2018,4,30,1,47,83,130,198
3404-001,2018,4,30,2,51,122,173,130
3404-001,2018,4,30,3,34,98,132,173
3404-001,2018,4,30,4,37,40,77,132
3404-001,2018,4,30,5,100,104,204,77
3404-001,2018,4,30,6,191,272,463,204
3404-001,2018,4,30,7,402,810,1212,463
3404-001,2018,4,30,8,785,2164,2949,1212
3404-001,2018,4,30,9,935,1618,2553,2949
3404-001,2018,4,30,10,824,812,1636,2553
3404-001,2018,4,30,11,787,797,1584,1636
3404-001,2018,4,30,12,773,803,1576,1584
3404-001,2018,4,30,13,811,667,1478,1576
3404-001,2018,4,30,14,843,768,1611,1478
3404-001,2018,4,30,15,899,808,1707,1611
3404-001,2018,4,30,16,977,798,1775,1707
3404-001,2018,4,30,17,1070,750,1820,1775
3404-001,2018,4,30,18,1280,797,2077,1820
3404-001,2018,4,30,19,1333,724,2057,2077
3404-001,2018,4,30,20,842,683,1525,2057
3404-001,2018,4,30,21,668,452,1120,1525
3404-001,2018,4,30,22,362,314,676,1120
3404-001,2018,4,30,23,204,292,496,676
3404-001,2018,4,30,24,154,165,319,496
3404-001,2018,5,1,1,114,64,178,319
3404-001,2018,5,1,2,65,60,125,178
3404-001,2018,5,1,3,51,73,124,125
3404-001,2018,5,1,4,47,55,102,124
3404-001,2018,5,1,5,72,73,145,102
3404-001,2018,5,1,6,127,196,323,145
3404-001,2018,5,1,7,232,443,675,323
3404-001,2018,5,1,8,540,954,1494,675
3404-001,2018,5,1,9,720,841,1561,1494
3404-001,2018,5,1,10,653,702,1355,1561
3404-001,2018,5,1,11,597,779,1376,1355
3404-001,2018,5,1,12,664,716,1380,1376
3404-001,2018,5,1,13,611,540,1151,1380
3404-001,2018,5,1,14,587,591,1178,1151
3404-001,2018,5,1,15,708,611,1319,1178
3404-001,2018,5,1,16,713,556,1269,1319
3404-001,2018,5,1,17,701,542,1243,1269
3404-001,2018,5,1,18,869,533,1402,1243
3404-001,2018,5,1,19,605,433,1038,1402
3404-001,2018,5,1,20,413,416,829,1038
3404-001,2018,5,1,21,328,280,608,829
3404-001,2018,5,1,22,195,223,418,608
3404-001,2018,5,1,23,142,167,309,418
3404-001,2018,5,1,24,94,139,233,309
3404-001,2018,5,2,1,90,92,182,233
3404-001,2018,5,2,2,34,64,98,182
3404-001,2018,5,2,3,42,41,83,98
3404-001,2018,5,2,4,44,59,103,83
3404-001,2018,5,2,5,81,93,174,103
3404-001,2018,5,2,6,163,245,408,174
3404-001,2018,5,2,7,338,764,1102,408
3404-001,2018,5,2,8,744,1904,2648,1102
3404-001,2018,5,2,9,1010,1497,2507,2648
3404-001,2018,5,2,10,866,943,1809,2507
3404-001,2018,5,2,11,852,882,1734,1809
3404-001,2018,5,2,12,790,838,1628,1734
3404-001,2018,5,2,13,699,661,1360,1628
3404-001,2018,5,2,14,771,854,1625,1360
3404-001,2018,5,2,15,897,908,1805,1625
3404-001,2018,5,2,16,947,839,1786,1805
3404-001,2018,5,2,17,923,810,1733,1786
3404-001,2018,5,2,18,1376,729,2105,1733
3404-001,2018,5,2,19,1293,653,1946,2105
3404-001,2018,5,2,20,667,456,1123,1946
3404-001,2018,5,2,21,567,328,895,1123
3404-001,2018,5,2,22,355,225,580,895
3404-001,2018,5,2,23,199,146,345,580
3404-001,2018,5,2,24,118,123,241,345
3404-001,2018,5,3,1,66,63,129,241
3404-001,2018,5,3,2,54,55,109,129
3404-001,2018,5,3,3,59,74,133,109
3404-001,2018,5,3,4,61,60,121,133
3404-001,2018,5,3,5,101,97,198,121
3404-001,2018,5,3,6,205,305,510,198
3404-001,2018,5,3,7,424,821,1245,510
3404-001,2018,5,3,8,861,1782,2643,1245
3404-001,2018,5,3,9,1049,1447,2496,2643
3404-001,2018,5,3,10,865,991,1856,2496
3404-001,2018,5,3,11,861,925,1786,1856
3404-001,2018,5,3,12,872,839,1711,1786
3404-001,2018,5,3,13,738,806,1544,1711
3404-001,2018,5,3,14,870,861,1731,1544
3404-001,2018,5,3,15,1059,974,2033,1731
3404-001,2018,5,3,16,987,950,1937,2033
3404-001,2018,5,3,17,997,807,1804,1937
3404-001,2018,5,3,18,1267,863,2130,1804
3404-001,2018,5,3,19,1281,735,2016,2130
3404-001,2018,5,3,20,806,535,1341,2016
3404-001,2018,5,3,21,717,367,1084,1341
3404-001,2018,5,3,22,429,279,708,1084
3404-001,2018,5,3,23,233,176,409,708
3404-001,2018,5,3,24,157,152,309,409
3404-001,2018,5,4,1,105,83,188,309
3404-001,2018,5,4,2,89,80,169,188
3404-001,2018,5,4,3,62,50,112,169
3404-001,2018,5,4,4,47,92,139,112
3404-001,2018,5,4,5,112,105,217,139
3404-001,2018,5,4,6,203,307,510,217
3404-001,2018,5,4,7,473,805,1278,510
3404-001,2018,5,4,8,784,1852,2636,1278
3404-001,2018,5,4,9,1032,1510,2542,2636
3404-001,2018,5,4,10,894,1009,1903,2542
3404-001,2018,5,4,11,851,998,1849,1903
3404-001,2018,5,4,12,906,905,1811,1849
3404-001,2018,5,4,13,837,866,1703,1811
3404-001,2018,5,4,14,879,869,1748,1703
3404-001,2018,5,4,15,1123,969,2092,1748
3404-001,2018,5,4,16,1089,904,1993,2092
3404-001,2018,5,4,17,1161,961,2122,1993
3404-001,2018,5,4,18,1691,927,2618,2122
3404-001,2018,5,4,19,1638,949,2587,2618
3404-001,2018,5,4,20,1158,761,1919,2587
3404-001,2018,5,4,21,883,489,1372,1919
3404-001,2018,5,4,22,465,365,830,1372
3404-001,2018,5,4,23,272,236,508,830
3404-001,2018,5,4,24,161,163,324,508
3404-001,2018,5,5,1,139,97,236,324
3404-001,2018,5,5,2,66,62,128,236
3404-001,2018,5,5,3,63,56,119,128
3404-001,2018,5,5,4,56,58,114,119
3404-001,2018,5,5,5,98,65,163,114
3404-001,2018,5,5,6,148,247,395,163
3404-001,2018,5,5,7,323,452,775,395
3404-001,2018,5,5,8,395,741,1136,775
3404-001,2018,5,5,9,541,719,1260,1136
3404-001,2018,5,5,10,576,888,1464,1260
3404-001,2018,5,5,11,603,968,1571,1464
3404-001,2018,5,5,12,567,1071,1638,1571
3404-001,2018,5,5,13,473,946,1419,1638
3404-001,2018,5,5,14,496,867,1363,1419
3404-001,2018,5,5,15,503,836,1339,1363
3404-001,2018,5,5,16,609,840,1449,1339
3404-001,2018,5,5,17,637,630,1267,1449
3404-001,2018,5,5,18,792,743,1535,1267
3404-001,2018,5,5,19,498,533,1031,1535
3404-001,2018,5,5,20,389,397,786,1031
3404-001,2018,5,5,21,335,256,591,786
3404-001,2018,5,5,22,231,204,435,591
3404-001,2018,5,5,23,139,147,286,435
3404-001,2018,5,5,24,112,106,218,286
3404-001,2018,5,6,1,66,51,117,218
3404-001,2018,5,6,2,52,39,91,117
3404-001,2018,5,6,3,31,31,62,91
3404-001,2018,5,6,4,21,29,50,62
3404-001,2018,5,6,5,33,32,65,50
3404-001,2018,5,6,6,39,52,91,65
3404-001,2018,5,6,7,84,110,194,91
3404-001,2018,5,6,8,153,223,376,194
3404-001,2018,5,6,9,225,237,462,376
3404-001,2018,5,6,10,243,316,559,462
3404-001,2018,5,6,11,377,388,765,559
3404-001,2018,5,6,12,407,427,834,765
3404-001,2018,5,6,13,412,392,804,834
3404-001,2018,5,6,14,405,437,842,804
3404-001,2018,5,6,15,543,387,930,842
3404-001,2018,5,6,16,546,408,954,930
3404-001,2018,5,6,17,563,371,934,954
3404-001,2018,5,6,18,572,387,959,934
3404-001,2018,5,6,19,444,340,784,959
3404-001,2018,5,6,20,335,346,681,784
3404-001,2018,5,6,21,295,266,561,681
3404-001,2018,5,6,22,215,242,457,561
3404-001,2018,5,6,23,167,175,342,457
3404-001,2018,5,6,24,96,129,225,342
3404-001,2018,5,7,1,61,84,145,225
3404-001,2018,5,7,2,39,56,95,145
3404-001,2018,5,7,3,33,29,62,95
3404-001,2018,5,7,4,45,36,81,62
3404-001,2018,5,7,5,73,60,133,81
3404-001,2018,5,7,6,130,219,349,133
3404-001,2018,5,7,7,238,464,702,349
3404-001,2018,5,7,8,424,840,1264,702
3404-001,2018,5,7,9,522,659,1181,1264
3404-001,2018,5,7,10,543,608,1151,1181
3404-001,2018,5,7,11,644,707,1351,1151
3404-001,2018,5,7,12,664,672,1336,1351
3404-001,2018,5,7,13,582,570,1152,1336
3404-001,2018,5,7,14,638,625,1263,1152
3404-001,2018,5,7,15,769,614,1383,1263
3404-001,2018,5,7,16,822,568,1390,1383
3404-001,2018,5,7,17,920,561,1481,1390
3404-001,2018,5,7,18,1245,616,1861,1481
3404-001,2018,5,7,19,848,565,1413,1861
3404-001,2018,5,7,20,677,481,1158,1413
3404-001,2018,5,7,21,474,422,896,1158
3404-001,2018,5,7,22,296,314,610,896
3404-001,2018,5,7,23,183,239,422,610
3404-001,2018,5,7,24,122,139,261,422
3404-001,2018,5,8,1,61,107,168,261
3404-001,2018,5,8,2,39,49,88,168
3404-001,2018,5,8,3,52,33,85,88
3404-001,2018,5,8,4,53,81,134,85
3404-001,2018,5,8,5,102,87,189,134
3404-001,2018,5,8,6,187,294,481,189
3404-001,2018,5,8,7,397,808,1205,481
3404-001,2018,5,8,8,749,1930,2679,1205
3404-001,2018,5,8,9,1011,1513,2524,2679
3404-001,2018,5,8,10,849,883,1732,2524
3404-001,2018,5,8,11,884,977,1861,1732
3404-001,2018,5,8,12,883,930,1813,1861
3404-001,2018,5,8,13,844,801,1645,1813
3404-001,2018,5,8,14,857,955,1812,1645
3404-001,2018,5,8,15,1011,940,1951,1812
3404-001,2018,5,8,16,968,904,1872,1951
3404-001,2018,5,8,17,1044,837,1881,1872
3404-001,2018,5,8,18,1393,856,2249,1881
3404-001,2018,5,8,19,1295,728,2023,2249
3404-001,2018,5,8,20,794,523,1317,2023
3404-001,2018,5,8,21,729,369,1098,1317
3404-001,2018,5,8,22,424,287,711,1098
3404-001,2018,5,8,23,252,197,449,711
3404-001,2018,5,8,24,155,122,277,449
3404-001,2018,5,9,1,106,103,209,277
3404-001,2018,5,9,2,65,95,160,209
3404-001,2018,5,9,3,49,55,104,160
3404-001,2018,5,9,4,60,61,121,104
3404-001,2018,5,9,5,95,104,199,121
3404-001,2018,5,9,6,168,321,489,199
3404-001,2018,5,9,7,456,822,1278,489
3404-001,2018,5,9,8,764,1992,2756,1278
3404-001,2018,5,9,9,1060,1507,2567,2756
3404-001,2018,5,9,10,802,1037,1839,2567
3404-001,2018,5,9,11,812,1013,1825,1839
3404-001,2018,5,9,12,913,889,1802,1825
3404-001,2018,5,9,13,712,767,1479,1802
3404-001,2018,5,9,14,875,811,1686,1479
3404-001,2018,5,9,15,992,846,1838,1686
3404-001,2018,5,9,16,1048,882,1930,1838
3404-001,2018,5,9,17,1120,771,1891,1930
3404-001,2018,5,9,18,1549,815,2364,1891
3404-001,2018,5,9,19,1373,738,2111,2364
3404-001,2018,5,9,20,793,499,1292,2111
3404-001,2018,5,9,21,667,342,1009,1292
3404-001,2018,5,9,22,409,258,667,1009
3404-001,2018,5,9,23,251,202,453,667
3404-001,2018,5,9,24,131,129,260,453
3404-001,2018,5,10,1,106,120,226,260
3404-001,2018,5,10,2,90,71,161,226
3404-001,2018,5,10,3,69,59,128,161
3404-001,2018,5,10,4,55,49,104,128
3404-001,2018,5,10,5,96,112,208,104
3404-001,2018,5,10,6,217,282,499,208
3404-001,2018,5,10,7,456,818,1274,499
3404-001,2018,5,10,8,800,1818,2618,1274
3404-001,2018,5,10,9,1037,1471,2508,2618
3404-001,2018,5,10,10,879,915,1794,2508
3404-001,2018,5,10,11,887,958,1845,1794
3404-001,2018,5,10,12,851,885,1736,1845
3404-001,2018,5,10,13,797,741,1538,1736
3404-001,2018,5,10,14,869,770,1639,1538
3404-001,2018,5,10,15,985,919,1904,1639
3404-001,2018,5,10,16,942,824,1766,1904
3404-001,2018,5,10,17,989,785,1774,1766
3404-001,2018,5,10,18,1373,745,2118,1774
3404-001,2018,5,10,19,1254,689,1943,2118
3404-001,2018,5,10,20,794,446,1240,1943
3404-001,2018,5,10,21,664,346,1010,1240
3404-001,2018,5,10,22,445,255,700,1010
3404-001,2018,5,10,23,256,198,454,700
3404-001,2018,5,10,24,161,159,320,454
3404-001,2018,5,11,1,96,101,197,320
3404-001,2018,5,11,2,95,55,150,197
3404-001,2018,5,11,3,75,57,132,150
3404-001,2018,5,11,4,44,83,127,132
3404-001,2018,5,11,5,118,107,225,127
3404-001,2018,5,11,6,226,271,497,225
3404-001,2018,5,11,7,448,702,1150,497
3404-001,2018,5,11,8,797,1813,2610,1150
3404-001,2018,5,11,9,1024,1512,2536,2610
3404-001,2018,5,11,10,876,991,1867,2536
3404-001,2018,5,11,11,881,979,1860,1867
3404-001,2018,5,11,12,931,877,1808,1860
3404-001,2018,5,11,13,847,790,1637,1808
3404-001,2018,5,11,14,896,844,1740,1637
3404-001,2018,5,11,15,1022,917,1939,1740
3404-001,2018,5,11,16,1012,879,1891,1939
3404-001,2018,5,11,17,1045,767,1812,1891
3404-001,2018,5,11,18,1664,807,2471,1812
3404-001,2018,5,11,19,1637,850,2487,2471
3404-001,2018,5,11,20,900,657,1557,2487
3404-001,2018,5,11,21,667,364,1031,1557
3404-001,2018,5,11,22,377,277,654,1031
3404-001,2018,5,11,23,243,199,442,654
3404-001,2018,5,11,24,171,139,310,442
3404-001,2018,5,12,1,101,85,186,310
3404-001,2018,5,12,2,94,63,157,186
3404-001,2018,5,12,3,72,70,142,157
3404-001,2018,5,12,4,64,48,112,142
3404-001,2018,5,12,5,99,81,180,112
3404-001,2018,5,12,6,141,199,340,180
3404-001,2018,5,12,7,231,422,653,340
3404-001,2018,5,12,8,404,725,1129,653
3404-001,2018,5,12,9,700,680,1380,1129
3404-001,2018,5,12,10,649,690,1339,1380
3404-001,2018,5,12,11,604,697,1301,1339
3404-001,2018,5,12,12,563,642,1205,1301
3404-001,2018,5,12,13,563,569,1132,1205
3404-001,2018,5,12,14,537,529,1066,1132
3404-001,2018,5,12,15,514,497,1011,1066
3404-001,2018,5,12,16,529,513,1042,1011
3404-001,2018,5,12,17,608,533,1141,1042
3404-001,2018,5,12,18,737,482,1219,1141
3404-001,2018,5,12,19,430,401,831,1219
3404-001,2018,5,12,20,284,346,630,831
3404-001,2018,5,12,21,217,247,464,630
3404-001,2018,5,12,22,158,177,335,464
3404-001,2018,5,12,23,105,118,223,335
3404-001,2018,5,12,24,71,78,149,223
3404-001,2018,5,13,1,47,64,111,149
3404-001,2018,5,13,2,44,56,100,111
3404-001,2018,5,13,3,32,41,73,100
3404-001,2018,5,13,4,28,34,62,73
3404-001,2018,5,13,5,41,42,83,62
3404-001,2018,5,13,6,54,100,154,83
3404-001,2018,5,13,7,111,204,315,154
3404-001,2018,5,13,8,211,275,486,315
3404-001,2018,5,13,9,284,271,555,486
3404-001,2018,5,13,10,284,338,622,555
3404-001,2018,5,13,11,362,431,793,622
3404-001,2018,5,13,12,403,417,820,793
3404-001,2018,5,13,13,376,402,778,820
3404-001,2018,5,13,14,396,435,831,778
3404-001,2018,5,13,15,488,421,909,831
3404-001,2018,5,13,16,522,455,977,909
3404-001,2018,5,13,17,563,457,1020,977
3404-001,2018,5,13,18,583,430,1013,1020
3404-001,2018,5,13,19,497,389,886,1013
3404-001,2018,5,13,20,342,337,679,886
3404-001,2018,5,13,21,320,310,630,679
3404-001,2018,5,13,22,199,258,457,630
3404-001,2018,5,13,23,140,197,337,457
3404-001,2018,5,13,24,96,155,251,337
3404-001,2018,5,14,1,52,88,140,251
3404-001,2018,5,14,2,36,43,79,140
3404-001,2018,5,14,3,32,43,75,79
3404-001,2018,5,14,4,53,34,87,75
3404-001,2018,5,14,5,105,109,214,87
3404-001,2018,5,14,6,187,345,532,214
3404-001,2018,5,14,7,420,873,1293,532
3404-001,2018,5,14,8,805,2025,2830,1293
3404-001,2018,5,14,9,940,1531,2471,2830
3404-001,2018,5,14,10,851,845,1696,2471
3404-001,2018,5,14,11,849,884,1733,1696
3404-001,2018,5,14,12,775,854,1629,1733
3404-001,2018,5,14,13,696,718,1414,1629
3404-001,2018,5,14,14,779,766,1545,1414
3404-001,2018,5,14,15,956,778,1734,1545
3404-001,2018,5,14,16,962,778,1740,1734
3404-001,2018,5,14,17,1022,749,1771,1740
3404-001,2018,5,14,18,1383,791,2174,1771
3404-001,2018,5,14,19,1287,767,2054,2174
3404-001,2018,5,14,20,790,512,1302,2054
3404-001,2018,5,14,21,750,358,1108,1302
3404-001,2018,5,14,22,410,239,649,1108
3404-001,2018,5,14,23,225,192,417,649
3404-001,2018,5,14,24,151,115,266,417
3404-001,2018,5,15,1,109,87,196,266
3404-001,2018,5,15,2,62,72,134,196
3404-001,2018,5,15,3,42,58,100,134
3404-001,2018,5,15,4,46,69,115,100
3404-001,2018,5,15,5,116,149,265,115
3404-001,2018,5,15,6,240,321,561,265
3404-001,2018,5,15,7,452,782,1234,561
3404-001,2018,5,15,8,806,1856,2662,1234
3404-001,2018,5,15,9,1022,1564,2586,2662
3404-001,2018,5,15,10,903,995,1898,2586
3404-001,2018,5,15,11,910,1019,1929,1898
3404-001,2018,5,15,12,899,839,1738,1929
3404-001,2018,5,15,13,863,733,1596,1738
3404-001,2018,5,15,14,883,861,1744,1596
3404-001,2018,5,15,15,1066,863,1929,1744
3404-001,2018,5,15,16,1040,871,1911,1929
3404-001,2018,5,15,17,1023,722,1745,1911
3404-001,2018,5,15,18,1383,740,2123,1745
3404-001,2018,5,15,19,1300,668,1968,2123
3404-001,2018,5,15,20,832,532,1364,1968
3404-001,2018,5,15,21,725,401,1126,1364
3404-001,2018,5,15,22,393,289,682,1126
3404-001,2018,5,15,23,245,198,443,682
3404-001,2018,5,15,24,129,139,268,443
3404-001,2018,5,16,1,117,102,219,268
3404-001,2018,5,16,2,59,67,126,219
3404-001,2018,5,16,3,54,63,117,126
3404-001,2018,5,16,4,34,75,109,117
3404-001,2018,5,16,5,95,123,218,109
3404-001,2018,5,16,6,150,190,340,218
3404-001,2018,5,16,7,341,674,1015,340
3404-001,2018,5,16,8,790,1787,2577,1015
3404-001,2018,5,16,9,1000,1448,2448,2577
3404-001,2018,5,16,10,917,883,1800,2448
3404-001,2018,5,16,11,842,837,1679,1800
3404-001,2018,5,16,12,754,792,1546,1679
3404-001,2018,5,16,13,699,652,1351,1546
3404-001,2018,5,16,14,689,796,1485,1351
3404-001,2018,5,16,15,853,779,1632,1485
3404-001,2018,5,16,16,865,788,1653,1632
3404-001,2018,5,16,17,865,714,1579,1653
3404-001,2018,5,16,18,1454,744,2198,1579
3404-001,2018,5,16,19,1146,621,1767,2198
3404-001,2018,5,16,20,683,469,1152,1767
3404-001,2018,5,16,21,504,275,779,1152
3404-001,2018,5,16,22,316,243,559,779
3404-001,2018,5,16,23,214,174,388,559
3404-001,2018,5,16,24,115,101,216,388
3404-001,2018,5,17,1,101,83,184,216
3404-001,2018,5,17,2,62,51,113,184
3404-001,2018,5,17,3,51,48,99,113
3404-001,2018,5,17,4,45,66,111,99
3404-001,2018,5,17,5,67,95,162,111
3404-001,2018,5,17,6,141,262,403,162
3404-001,2018,5,17,7,297,675,972,403
3404-001,2018,5,17,8,705,1754,2459,972
3404-001,2018,5,17,9,914,1422,2336,2459
3404-001,2018,5,17,10,825,804,1629,2336
3404-001,2018,5,17,11,774,860,1634,1629
3404-001,2018,5,17,12,796,787,1583,1634
3404-001,2018,5,17,13,703,703,1406,1583
3404-001,2018,5,17,14,793,842,1635,1406
3404-001,2018,5,17,15,872,869,1741,1635
3404-001,2018,5,17,16,876,838,1714,1741
3404-001,2018,5,17,17,832,753,1585,1714
3404-001,2018,5,17,18,1168,732,1900,1585
3404-001,2018,5,17,19,1166,596,1762,1900
3404-001,2018,5,17,20,701,465,1166,1762
3404-001,2018,5,17,21,635,336,971,1166
3404-001,2018,5,17,22,367,296,663,971
3404-001,2018,5,17,23,202,178,380,663
3404-001,2018,5,17,24,128,102,230,380
3404-001,2018,5,18,1,86,99,185,230
3404-001,2018,5,18,2,66,65,131,185
3404-001,2018,5,18,3,42,48,90,131
3404-001,2018,5,18,4,47,71,118,90
3404-001,2018,5,18,5,80,94,174,118
3404-001,2018,5,18,6,169,286,455,174
3404-001,2018,5,18,7,357,756,1113,455
3404-001,2018,5,18,8,729,1771,2500,1113
3404-001,2018,5,18,9,955,1448,2403,2500
3404-001,2018,5,18,10,821,896,1717,2403
3404-001,2018,5,18,11,853,839,1692,1717
3404-001,2018,5,18,12,830,874,1704,1692
3404-001,2018,5,18,13,726,750,1476,1704
3404-001,2018,5,18,14,763,867,1630,1476
3404-001,2018,5,18,15,856,912,1768,1630
3404-001,2018,5,18,16,955,844,1799,1768
3404-001,2018,5,18,17,979,826,1805,1799
3404-001,2018,5,18,18,1474,848,2322,1805
3404-001,2018,5,18,19,1400,812,2212,2322
3404-001,2018,5,18,20,874,606,1480,2212
3404-001,2018,5,18,21,671,423,1094,1480
3404-001,2018,5,18,22,347,283,630,1094
3404-001,2018,5,18,23,239,207,446,630
3404-001,2018,5,18,24,138,159,297,446
3404-001,2018,5,19,1,109,83,192,297
3404-001,2018,5,19,2,73,79,152,192
3404-001,2018,5,19,3,84,62,146,152
3404-001,2018,5,19,4,53,59,112,146
3404-001,2018,5,19,5,83,86,169,112
3404-001,2018,5,19,6,174,243,417,169
3404-001,2018,5,19,7,284,526,810,417
3404-001,2018,5,19,8,503,806,1309,810
3404-001,2018,5,19,9,638,861,1499,1309
3404-001,2018,5,19,10,640,837,1477,1499
3404-001,2018,5,19,11,672,888,1560,1477
3404-001,2018,5,19,12,643,778,1421,1560
3404-001,2018,5,19,13,608,732,1340,1421
3404-001,2018,5,19,14,599,695,1294,1340
3404-001,2018,5,19,15,660,719,1379,1294
3404-001,2018,5,19,16,674,657,1331,1379
3404-001,2018,5,19,17,721,619,1340,1331
3404-001,2018,5,19,18,916,621,1537,1340
3404-001,2018,5,19,19,675,541,1216,1537
3404-001,2018,5,19,20,458,414,872,1216
3404-001,2018,5,19,21,309,280,589,872
3404-001,2018,5,19,22,285,236,521,589
3404-001,2018,5,19,23,166,148,314,521
3404-001,2018,5,19,24,117,114,231,314
3404-001,2018,5,20,1,86,81,167,231
3404-001,2018,5,20,2,62,55,117,167
3404-001,2018,5,20,3,32,28,60,117
3404-001,2018,5,20,4,36,42,78,60
3404-001,2018,5,20,5,51,39,90,78
3404-001,2018,5,20,6,84,113,197,90
3404-001,2018,5,20,7,143,275,418,197
3404-001,2018,5,20,8,257,284,541,418
3404-001,2018,5,20,9,296,321,617,541
3404-001,2018,5,20,10,287,350,637,617
3404-001,2018,5,20,11,401,454,855,637
3404-001,2018,5,20,12,348,493,841,855
3404-001,2018,5,20,13,407,427,834,841
3404-001,2018,5,20,14,422,456,878,834
3404-001,2018,5,20,15,551,426,977,878
3404-001,2018,5,20,16,559,439,998,977
3404-001,2018,5,20,17,587,385,972,998
3404-001,2018,5,20,18,645,468,1113,972
3404-001,2018,5,20,19,494,403,897,1113
3404-001,2018,5,20,20,488,339,827,897
3404-001,2018,5,20,21,355,279,634,827
3404-001,2018,5,20,22,284,258,542,634
3404-001,2018,5,20,23,179,182,361,542
3404-001,2018,5,20,24,104,129,233,361
3404-001,2018,5,21,1,75,92,167,233
3404-001,2018,5,21,2,46,51,97,167
3404-001,2018,5,21,3,41,44,85,97
3404-001,2018,5,21,4,41,59,100,85
3404-001,2018,5,21,5,90,95,185,100
3404-001,2018,5,21,6,196,322,518,185
3404-001,2018,5,21,7,415,757,1172,518
3404-001,2018,5,21,8,689,1689,2378,1172
3404-001,2018,5,21,9,881,1281,2162,2378
3404-001,2018,5,21,10,844,909,1753,2162
3404-001,2018,5,21,11,728,848,1576,1753
3404-001,2018,5,21,12,849,864,1713,1576
3404-001,2018,5,21,13,715,752,1467,1713
3404-001,2018,5,21,14,765,760,1525,1467
3404-001,2018,5,21,15,930,887,1817,1525
3404-001,2018,5,21,16,988,777,1765,1817
3404-001,2018,5,21,17,952,696,1648,1765
3404-001,2018,5,21,18,1297,815,2112,1648
3404-001,2018,5,21,19,1265,757,2022,2112
3404-001,2018,5,21,20,799,504,1303,2022
3404-001,2018,5,21,21,664,368,1032,1303
3404-001,2018,5,21,22,348,281,629,1032
3404-001,2018,5,21,23,216,166,382,629
3404-001,2018,5,21,24,130,123,253,382
3404-001,2018,5,22,1,107,97,204,253
3404-001,2018,5,22,2,75,80,155,204
3404-001,2018,5,22,3,68,46,114,155
3404-001,2018,5,22,4,73,64,137,114
3404-001,2018,5,22,5,70,76,146,137
3404-001,2018,5,22,6,155,251,406,146
3404-001,2018,5,22,7,265,507,772,406
3404-001,2018,5,22,8,425,823,1248,772
3404-001,2018,5,22,9,546,748,1294,1248
3404-001,2018,5,22,10,559,685,1244,1294
3404-001,2018,5,22,11,546,700,1246,1244
3404-001,2018,5,22,12,541,646,1187,1246
3404-001,2018,5,22,13,508,558,1066,1187
3404-001,2018,5,22,14,561,508,1069,1066
3404-001,2018,5,22,15,636,533,1169,1069
3404-001,2018,5,22,16,717,509,1226,1169
3404-001,2018,5,22,17,758,492,1250,1226
3404-001,2018,5,22,18,918,532,1450,1250
3404-001,2018,5,22,19,685,431,1116,1450
3404-001,2018,5,22,20,372,327,699,1116
3404-001,2018,5,22,21,340,255,595,699
3404-001,2018,5,22,22,198,209,407,595
3404-001,2018,5,22,23,123,153,276,407
3404-001,2018,5,22,24,64,121,185,276
3404-001,2018,5,23,1,44,89,133,185
3404-001,2018,5,23,2,45,51,96,133
3404-001,2018,5,23,3,52,59,111,96
3404-001,2018,5,23,4,47,68,115,111
3404-001,2018,5,23,5,95,114,209,115
3404-001,2018,5,23,6,159,256,415,209
3404-001,2018,5,23,7,398,748,1146,415
3404-001,2018,5,23,8,777,1890,2667,1146
3404-001,2018,5,23,9,949,1568,2517,2667
3404-001,2018,5,23,10,857,927,1784,2517
3404-001,2018,5,23,11,836,993,1829,1784
3404-001,2018,5,23,12,861,917,1778,1829
3404-001,2018,5,23,13,761,743,1504,1778
3404-001,2018,5,23,14,841,823,1664,1504
3404-001,2018,5,23,15,990,963,1953,1664
3404-001,2018,5,23,16,1021,859,1880,1953
3404-001,2018,5,23,17,1019,776,1795,1880
3404-001,2018,5,23,18,1489,831,2320,1795
3404-001,2018,5,23,19,1314,750,2064,2320
3404-001,2018,5,23,20,806,565,1371,2064
3404-001,2018,5,23,21,649,373,1022,1371
3404-001,2018,5,23,22,440,220,660,1022
3404-001,2018,5,23,23,235,181,416,660
3404-001,2018,5,23,24,147,135,282,416
3404-001,2018,5,24,1,110,100,210,282
3404-001,2018,5,24,2,57,69,126,210
3404-001,2018,5,24,3,65,60,125,126
3404-001,2018,5,24,4,57,60,117,125
3404-001,2018,5,24,5,82,129,211,117
3404-001,2018,5,24,6,234,312,546,211
3404-001,2018,5,24,7,466,787,1253,546
3404-001,2018,5,24,8,772,1868,2640,1253
3404-001,2018,5,24,9,1048,1491,2539,2640
3404-001,2018,5,24,10,853,936,1789,2539
3404-001,2018,5,24,11,865,986,1851,1789
3404-001,2018,5,24,12,906,894,1800,1851
3404-001,2018,5,24,13,802,720,1522,1800
3404-001,2018,5,24,14,842,829,1671,1522
3404-001,2018,5,24,15,992,889,1881,1671
3404-001,2018,5,24,16,1008,797,1805,1881
3404-001,2018,5,24,17,1003,732,1735,1805
3404-001,2018,5,24,18,1449,751,2200,1735
3404-001,2018,5,24,19,1291,695,1986,2200
3404-001,2018,5,24,20,809,485,1294,1986
3404-001,2018,5,24,21,724,396,1120,1294
3404-001,2018,5,24,22,427,258,685,1120
3404-001,2018,5,24,23,234,195,429,685
3404-001,2018,5,24,24,140,143,283,429
3404-001,2018,5,25,1,114,102,216,283
3404-001,2018,5,25,2,77,89,166,216
3404-001,2018,5,25,3,52,78,130,166
3404-001,2018,5,25,4,55,78,133,130
3404-001,2018,5,25,5,86,109,195,133
3404-001,2018,5,25,6,252,298,550,195
3404-001,2018,5,25,7,412,823,1235,550
3404-001,2018,5,25,8,847,1869,2716,1235
3404-001,2018,5,25,9,996,1460,2456,2716
3404-001,2018,5,25,10,832,945,1777,2456
3404-001,2018,5,25,11,980,959,1939,1777
3404-001,2018,5,25,12,885,844,1729,1939
3404-001,2018,5,25,13,798,712,1510,1729
3404-001,2018,5,25,14,827,734,1561,1510
3404-001,2018,5,25,15,983,823,1806,1561
3404-001,2018,5,25,16,967,841,1808,1806
3404-001,2018,5,25,17,1037,753,1790,1808
3404-001,2018,5,25,18,1705,805,2510,1790
3404-001,2018,5,25,19,1511,836,2347,2510
3404-001,2018,5,25,20,964,584,1548,2347
3404-001,2018,5,25,21,657,360,1017,1548
3404-001,2018,5,25,22,385,293,678,1017
3404-001,2018,5,25,23,232,198,430,678
3404-001,2018,5,25,24,149,116,265,430
3404-001,2018,5,26,1,106,91,197,265
3404-001,2018,5,26,2,73,77,150,197
3404-001,2018,5,26,3,71,60,131,150
3404-001,2018,5,26,4,54,61,115,131
3404-001,2018,5,26,5,105,123,228,115
3404-001,2018,5,26,6,189,265,454,228
3404-001,2018,5,26,7,348,521,869,454
3404-001,2018,5,26,8,513,825,1338,869
3404-001,2018,5,26,9,701,783,1484,1338
3404-001,2018,5,26,10,689,839,1528,1484
3404-001,2018,5,26,11,701,793,1494,1528
3404-001,2018,5,26,12,652,758,1410,1494
3404-001,2018,5,26,13,612,665,1277,1410
3404-001,2018,5,26,14,584,668,1252,1277
3404-001,2018,5,26,15,724,657,1381,1252
3404-001,2018,5,26,16,709,582,1291,1381
3404-001,2018,5,26,17,765,555,1320,1291
3404-001,2018,5,26,18,882,565,1447,1320
3404-001,2018,5,26,19,648,477,1125,1447
3404-001,2018,5,26,20,369,358,727,1125
3404-001,2018,5,26,21,316,252,568,727
3404-001,2018,5,26,22,232,198,430,568
3404-001,2018,5,26,23,163,133,296,430
3404-001,2018,5,26,24,132,111,243,296
3404-001,2018,5,27,1,80,74,154,243
3404-001,2018,5,27,2,57,62,119,154
3404-001,2018,5,27,3,33,32,65,119
3404-001,2018,5,27,4,35,43,78,65
3404-001,2018,5,27,5,47,36,83,78
3404-001,2018,5,27,6,70,134,204,83
3404-001,2018,5,27,7,117,232,349,204
3404-001,2018,5,27,8,243,273,516,349
3404-001,2018,5,27,9,286,303,589,516
3404-001,2018,5,27,10,290,314,604,589
3404-001,2018,5,27,11,387,427,814,604
3404-001,2018,5,27,12,361,404,765,814
3404-001,2018,5,27,13,368,390,758,765
3404-001,2018,5,27,14,397,402,799,758
3404-001,2018,5,27,15,500,412,912,799
3404-001,2018,5,27,16,601,416,1017,912
3404-001,2018,5,27,17,633,431,1064,1017
3404-001,2018,5,27,18,679,421,1100,1064
3404-001,2018,5,27,19,456,444,900,1100
3404-001,2018,5,27,20,385,364,749,900
3404-001,2018,5,27,21,269,286,555,749
3404-001,2018,5,27,22,208,233,441,555
3404-001,2018,5,27,23,159,187,346,441
3404-001,2018,5,27,24,100,113,213,346
3404-001,2018,5,28,1,55,84,139,213
3404-001,2018,5,28,2,35,60,95,139
3404-001,2018,5,28,3,52,58,110,95
3404-001,2018,5,28,4,39,42,81,110
3404-001,2018,5,28,5,81,88,169,81
3404-001,2018,5,28,6,205,314,519,169
3404-001,2018,5,28,7,441,889,1330,519
3404-001,2018,5,28,8,826,2041,2867,1330
3404-001,2018,5,28,9,948,1517,2465,2867
3404-001,2018,5,28,10,891,909,1800,2465
3404-001,2018,5,28,11,939,1000,1939,1800
3404-001,2018,5,28,12,879,851,1730,1939
3404-001,2018,5,28,13,753,731,1484,1730
3404-001,2018,5,28,14,823,781,1604,1484
3404-001,2018,5,28,15,983,869,1852,1604
3404-001,2018,5,28,16,978,821,1799,1852
3404-001,2018,5,28,17,976,739,1715,1799
3404-001,2018,5,28,18,1381,790,2171,1715
3404-001,2018,5,28,19,1280,657,1937,2171
3404-001,2018,5,28,20,862,521,1383,1937
3404-001,2018,5,28,21,695,354,1049,1383
3404-001,2018,5,28,22,368,265,633,1049
3404-001,2018,5,28,23,240,134,374,633
3404-001,2018,5,28,24,153,121,274,374
3404-001,2018,5,29,1,99,78,177,274
3404-001,2018,5,29,2,62,78,140,177
3404-001,2018,5,29,3,52,59,111,140
3404-001,2018,5,29,4,61,64,125,111
3404-001,2018,5,29,5,106,129,235,125
3404-001,2018,5,29,6,205,292,497,235
3404-001,2018,5,29,7,422,879,1301,497
3404-001,2018,5,29,8,848,1864,2712,1301
3404-001,2018,5,29,9,1025,1521,2546,2712
3404-001,2018,5,29,10,899,899,1798,2546
3404-001,2018,5,29,11,876,890,1766,1798
3404-001,2018,5,29,12,891,854,1745,1766
3404-001,2018,5,29,13,793,727,1520,1745
3404-001,2018,5,29,14,812,859,1671,1520
3404-001,2018,5,29,15,958,895,1853,1671
3404-001,2018,5,29,16,1021,802,1823,1853
3404-001,2018,5,29,17,1055,785,1840,1823
3404-001,2018,5,29,18,1434,764,2198,1840
3404-001,2018,5,29,19,1247,694,1941,2198
3404-001,2018,5,29,20,775,455,1230,1941
3404-001,2018,5,29,21,678,366,1044,1230
3404-001,2018,5,29,22,369,244,613,1044
3404-001,2018,5,29,23,218,180,398,613
3404-001,2018,5,29,24,137,122,259,398
3404-001,2018,5,30,1,107,90,197,259
3404-001,2018,5,30,2,61,70,131,197
3404-001,2018,5,30,3,44,62,106,131
3404-001,2018,5,30,4,59,48,107,106
3404-001,2018,5,30,5,81,111,192,107
3404-001,2018,5,30,6,189,299,488,192
3404-001,2018,5,30,7,398,824,1222,488
3404-001,2018,5,30,8,869,1776,2645,1222
3404-001,2018,5,30,9,1024,1540,2564,2645
3404-001,2018,5,30,10,880,947,1827,2564
3404-001,2018,5,30,11,903,867,1770,1827
3404-001,2018,5,30,12,839,871,1710,1770
3404-001,2018,5,30,13,757,695,1452,1710
3404-001,2018,5,30,14,821,830,1651,1452
3404-001,2018,5,30,15,997,921,1918,1651
3404-001,2018,5,30,16,1004,791,1795,1918
3404-001,2018,5,30,17,976,765,1741,1795
3404-001,2018,5,30,18,1535,716,2251,1741
3404-001,2018,5,30,19,1314,700,2014,2251
3404-001,2018,5,30,20,753,537,1290,2014
3404-001,2018,5,30,21,587,326,913,1290
3404-001,2018,5,30,22,328,233,561,913
3404-001,2018,5,30,23,222,226,448,561
3404-001,2018,5,30,24,144,136,280,448
3404-001,2018,5,31,1,89,94,183,280
3404-001,2018,5,31,2,60,81,141,183
3404-001,2018,5,31,3,58,49,107,141
3404-001,2018,5,31,4,58,59,117,107
3404-001,2018,5,31,5,99,129,228,117
3404-001,2018,5,31,6,205,334,539,228
3404-001,2018,5,31,7,427,803,1230,539
3404-001,2018,5,31,8,764,1920,2684,1230
3404-001,2018,5,31,9,983,1527,2510,2684
3404-001,2018,5,31,10,863,962,1825,2510
3404-001,2018,5,31,11,933,969,1902,1825
3404-001,2018,5,31,12,862,875,1737,1902
3404-001,2018,5,31,13,711,755,1466,1737
3404-001,2018,5,31,14,791,750,1541,1466
3404-001,2018,5,31,15,964,852,1816,1541
3404-001,2018,5,31,16,995,836,1831,1816
3404-001,2018,5,31,17,1048,726,1774,1831
3404-001,2018,5,31,18,1397,713,2110,1774
3404-001,2018,5,31,19,1250,629,1879,2110
3404-001,2018,5,31,20,823,501,1324,1879
3404-001,2018,5,31,21,706,330,1036,1324
3404-001,2018,5,31,22,425,261,686,1036
3404-001,2018,5,31,23,233,168,401,686
3404-001,2018,5,31,24,165,127,292,401
3404-001,2018,6,1,1,103,91,194,292
3404-001,2018,6,1,2,57,65,122,194
3404-001,2018,6,1,3,50,53,103,122
3404-001,2018,6,1,4,71,64,135,103
3404-001,2018,6,1,5,84,94,178,135
3404-001,2018,6,1,6,195,291,486,178
3404-001,2018,6,1,7,407,835,1242,486
3404-001,2018,6,1,8,799,1862,2661,1242
3404-001,2018,6,1,9,1004,1472,2476,2661
3404-001,2018,6,1,10,855,931,1786,2476
3404-001,2018,6,1,11,926,951,1877,1786
3404-001,2018,6,1,12,855,877,1732,1877
3404-001,2018,6,1,13,839,732,1571,1732
3404-001,2018,6,1,14,880,825,1705,1571
3404-001,2018,6,1,15,976,860,1836,1705
3404-001,2018,6,1,16,1000,901,1901,1836
3404-001,2018,6,1,17,1146,801,1947,1901
3404-001,2018,6,1,18,1746,794,2540,1947
3404-001,2018,6,1,19,1609,797,2406,2540
3404-001,2018,6,1,20,975,590,1565,2406
3404-001,2018,6,1,21,689,377,1066,1565
3404-001,2018,6,1,22,376,256,632,1066
3404-001,2018,6,1,23,257,184,441,632
3404-001,2018,6,1,24,154,106,260,441
3404-001,2018,6,2,1,125,65,190,260
3404-001,2018,6,2,2,73,70,143,190
3404-001,2018,6,2,3,43,61,104,143
3404-001,2018,6,2,4,61,58,119,104
3404-001,2018,6,2,5,93,101,194,119
3404-001,2018,6,2,6,183,256,439,194
3404-001,2018,6,2,7,322,547,869,439
3404-001,2018,6,2,8,507,834,1341,869
3404-001,2018,6,2,9,689,780,1469,1341
3404-001,2018,6,2,10,657,774,1431,1469
3404-001,2018,6,2,11,672,849,1521,1431
3404-001,2018,6,2,12,725,704,1429,1521
3404-001,2018,6,2,13,597,693,1290,1429
3404-001,2018,6,2,14,612,656,1268,1290
3404-001,2018,6,2,15,652,689,1341,1268
3404-001,2018,6,2,16,729,654,1383,1341
3404-001,2018,6,2,17,807,536,1343,1383
3404-001,2018,6,2,18,939,567,1506,1343
3404-001,2018,6,2,19,616,553,1169,1506
3404-001,2018,6,2,20,374,365,739,1169
3404-001,2018,6,2,21,311,275,586,739
3404-001,2018,6,2,22,250,190,440,586
3404-001,2018,6,2,23,152,142,294,440
3404-001,2018,6,2,24,118,107,225,294
3404-001,2018,6,3,1,96,76,172,225
3404-001,2018,6,3,2,58,45,103,172
3404-001,2018,6,3,3,41,35,76,103
3404-001,2018,6,3,4,39,48,87,76
3404-001,2018,6,3,5,47,34,81,87
3404-001,2018,6,3,6,64,118,182,81
3404-001,2018,6,3,7,160,243,403,182
3404-001,2018,6,3,8,211,298,509,403
3404-001,2018,6,3,9,294,276,570,509
3404-001,2018,6,3,10,306,330,636,570
3404-001,2018,6,3,11,354,430,784,636
3404-001,2018,6,3,12,392,441,833,784
3404-001,2018,6,3,13,378,370,748,833
3404-001,2018,6,3,14,465,418,883,748
3404-001,2018,6,3,15,532,436,968,883
3404-001,2018,6,3,16,606,450,1056,968
3404-001,2018,6,3,17,625,404,1029,1056
3404-001,2018,6,3,18,618,419,1037,1029
3404-001,2018,6,3,19,508,406,914,1037
3404-001,2018,6,3,20,374,322,696,914
3404-001,2018,6,3,21,338,317,655,696
3404-001,2018,6,3,22,266,245,511,655
3404-001,2018,6,3,23,153,214,367,511
3404-001,2018,6,3,24,95,134,229,367
3404-001,2018,6,4,1,42,88,130,229
3404-001,2018,6,4,2,47,52,99,130
3404-001,2018,6,4,3,34,49,83,99
3404-001,2018,6,4,4,40,57,97,83
3404-001,2018,6,4,5,108,83,191,97
3404-001,2018,6,4,6,222,332,554,191
3404-001,2018,6,4,7,469,869,1338,554
3404-001,2018,6,4,8,899,2023,2922,1338
3404-001,2018,6,4,9,994,1559,2553,2922
3404-001,2018,6,4,10,931,957,1888,2553
3404-001,2018,6,4,11,910,908,1818,1888
3404-001,2018,6,4,12,874,881,1755,1818
3404-001,2018,6,4,13,779,737,1516,1755
3404-001,2018,6,4,14,831,849,1680,1516
3404-001,2018,6,4,15,1034,937,1971,1680
3404-001,2018,6,4,16,998,861,1859,1971
3404-001,2018,6,4,17,1025,730,1755,1859
3404-001,2018,6,4,18,1422,723,2145,1755
3404-001,2018,6,4,19,1306,664,1970,2145
3404-001,2018,6,4,20,834,508,1342,1970
3404-001,2018,6,4,21,756,304,1060,1342
3404-001,2018,6,4,22,397,244,641,1060
3404-001,2018,6,4,23,224,164,388,641
3404-001,2018,6,4,24,126,112,238,388
3404-001,2018,6,5,1,103,64,167,238
3404-001,2018,6,5,2,66,76,142,167
3404-001,2018,6,5,3,46,63,109,142
3404-001,2018,6,5,4,52,56,108,109
3404-001,2018,6,5,5,99,109,208,108
3404-001,2018,6,5,6,255,353,608,208
3404-001,2018,6,5,7,411,807,1218,608
3404-001,2018,6,5,8,841,1890,2731,1218
3404-001,2018,6,5,9,1105,1562,2667,2731
3404-001,2018,6,5,10,900,965,1865,2667
3404-001,2018,6,5,11,893,956,1849,1865
3404-001,2018,6,5,12,917,882,1799,1849
3404-001,2018,6,5,13,745,795,1540,1799
3404-001,2018,6,5,14,925,939,1864,1540
3404-001,2018,6,5,15,1081,940,2021,1864
3404-001,2018,6,5,16,1043,917,1960,2021
3404-001,2018,6,5,17,1119,885,2004,1960
3404-001,2018,6,5,18,1562,839,2401,2004
3404-001,2018,6,5,19,1433,696,2129,2401
3404-001,2018,6,5,20,944,570,1514,2129
3404-001,2018,6,5,21,725,412,1137,1514
3404-001,2018,6,5,22,412,278,690,1137
3404-001,2018,6,5,23,271,196,467,690
3404-001,2018,6,5,24,134,124,258,467
3404-001,2018,6,6,1,115,96,211,258
3404-001,2018,6,6,2,70,74,144,211
3404-001,2018,6,6,3,62,46,108,144
3404-001,2018,6,6,4,62,68,130,108
3404-001,2018,6,6,5,90,105,195,130
3404-001,2018,6,6,6,180,274,454,195
3404-001,2018,6,6,7,366,524,890,454
3404-001,2018,6,6,8,474,837,1311,890
3404-001,2018,6,6,9,570,763,1333,1311
3404-001,2018,6,6,10,571,646,1217,1333
3404-001,2018,6,6,11,596,699,1295,1217
3404-001,2018,6,6,12,663,616,1279,1295
3404-001,2018,6,6,13,540,564,1104,1279
3404-001,2018,6,6,14,499,518,1017,1104
3404-001,2018,6,6,15,750,518,1268,1017
3404-001,2018,6,6,16,718,586,1304,1268
3404-001,2018,6,6,17,727,546,1273,1304
3404-001,2018,6,6,18,968,533,1501,1273
3404-001,2018,6,6,19,631,398,1029,1501
3404-001,2018,6,6,20,448,357,805,1029
3404-001,2018,6,6,21,368,246,614,805
3404-001,2018,6,6,22,242,192,434,614
3404-001,2018,6,6,23,145,145,290,434
3404-001,2018,6,6,24,87,91,178,290
3404-001,2018,6,7,1,75,67,142,178
3404-001,2018,6,7,2,51,76,127,142
3404-001,2018,6,7,3,36,36,72,127
3404-001,2018,6,7,4,39,45,84,72
3404-001,2018,6,7,5,90,125,215,84
3404-001,2018,6,7,6,198,277,475,215
3404-001,2018,6,7,7,388,779,1167,475
3404-001,2018,6,7,8,789,1935,2724,1167
3404-001,2018,6,7,9,1035,1599,2634,2724
3404-001,2018,6,7,10,934,873,1807,2634
3404-001,2018,6,7,11,962,838,1800,1807
3404-001,2018,6,7,12,936,831,1767,1800
3404-001,2018,6,7,13,757,696,1453,1767
3404-001,2018,6,7,14,890,835,1725,1453
3404-001,2018,6,7,15,1004,927,1931,1725
3404-001,2018,6,7,16,1057,847,1904,1931
3404-001,2018,6,7,17,1001,819,1820,1904
3404-001,2018,6,7,18,1584,734,2318,1820
3404-001,2018,6,7,19,1361,668,2029,2318
3404-001,2018,6,7,20,912,488,1400,2029
3404-001,2018,6,7,21,731,355,1086,1400
3404-001,2018,6,7,22,436,267,703,1086
3404-001,2018,6,7,23,248,170,418,703
3404-001,2018,6,7,24,160,108,268,418
3404-001,2018,6,8,1,95,82,177,268
3404-001,2018,6,8,2,68,61,129,177
3404-001,2018,6,8,3,40,68,108,129
3404-001,2018,6,8,4,56,59,115,108
3404-001,2018,6,8,5,91,113,204,115
3404-001,2018,6,8,6,215,274,489,204
3404-001,2018,6,8,7,444,801,1245,489
3404-001,2018,6,8,8,876,1854,2730,1245
3404-001,2018,6,8,9,1070,1593,2663,2730
3404-001,2018,6,8,10,891,921,1812,2663
3404-001,2018,6,8,11,956,909,1865,1812
3404-001,2018,6,8,12,911,905,1816,1865
3404-001,2018,6,8,13,889,762,1651,1816
3404-001,2018,6,8,14,883,823,1706,1651
3404-001,2018,6,8,15,1047,906,1953,1706
3404-001,2018,6,8,16,1074,913,1987,1953
3404-001,2018,6,8,17,1077,846,1923,1987
3404-001,2018,6,8,18,1741,784,2525,1923
3404-001,2018,6,8,19,1514,784,2298,2525
3404-001,2018,6,8,20,988,593,1581,2298
3404-001,2018,6,8,21,724,358,1082,1581
3404-001,2018,6,8,22,425,296,721,1082
3404-001,2018,6,8,23,225,192,417,721
3404-001,2018,6,8,24,154,123,277,417
3404-001,2018,6,9,1,138,86,224,277
3404-001,2018,6,9,2,70,68,138,224
3404-001,2018,6,9,3,55,55,110,138
3404-001,2018,6,9,4,51,69,120,110
3404-001,2018,6,9,5,87,108,195,120
3404-001,2018,6,9,6,190,245,435,195
3404-001,2018,6,9,7,322,499,821,435
3404-001,2018,6,9,8,551,785,1336,821
3404-001,2018,6,9,9,685,705,1390,1336
3404-001,2018,6,9,10,673,737,1410,1390
3404-001,2018,6,9,11,693,807,1500,1410
3404-001,2018,6,9,12,676,769,1445,1500
3404-001,2018,6,9,13,606,608,1214,1445
3404-001,2018,6,9,14,586,649,1235,1214
3404-001,2018,6,9,15,656,591,1247,1235
3404-001,2018,6,9,16,722,531,1253,1247
3404-001,2018,6,9,17,730,515,1245,1253
3404-001,2018,6,9,18,964,544,1508,1245
3404-001,2018,6,9,19,640,498,1138,1508
3404-001,2018,6,9,20,433,320,753,1138
3404-001,2018,6,9,21,309,238,547,753
3404-001,2018,6,9,22,205,200,405,547
3404-001,2018,6,9,23,127,156,283,405
3404-001,2018,6,9,24,96,83,179,283
3404-001,2018,6,10,1,78,66,144,179
3404-001,2018,6,10,2,61,56,117,144
3404-001,2018,6,10,3,28,36,64,117
3404-001,2018,6,10,4,34,59,93,64
3404-001,2018,6,10,5,34,52,86,93
3404-001,2018,6,10,6,84,101,185,86
3404-001,2018,6,10,7,135,188,323,185
3404-001,2018,6,10,8,186,254,440,323
3404-001,2018,6,10,9,281,276,557,440
3404-001,2018,6,10,10,299,276,575,557
3404-001,2018,6,10,11,326,356,682,575
3404-001,2018,6,10,12,345,403,748,682
3404-001,2018,6,10,13,374,421,795,748
3404-001,2018,6,10,14,407,422,829,795
3404-001,2018,6,10,15,491,420,911,829
3404-001,2018,6,10,16,559,412,971,911
3404-001,2018,6,10,17,681,419,1100,971
3404-001,2018,6,10,18,595,402,997,1100
3404-001,2018,6,10,19,503,404,907,997
3404-001,2018,6,10,20,382,312,694,907
3404-001,2018,6,10,21,301,302,603,694
3404-001,2018,6,10,22,245,247,492,603
3404-001,2018,6,10,23,151,216,367,492
3404-001,2018,6,10,24,94,123,217,367
3404-001,2018,6,11,1,55,89,144,217
3404-001,2018,6,11,2,43,64,107,144
3404-001,2018,6,11,3,29,48,77,107
3404-001,2018,6,11,4,48,44,92,77
3404-001,2018,6,11,5,92,154,246,92
3404-001,2018,6,11,6,243,374,617,246
3404-001,2018,6,11,7,430,876,1306,617
3404-001,2018,6,11,8,843,2067,2910,1306
3404-001,2018,6,11,9,1015,1466,2481,2910
3404-001,2018,6,11,10,878,921,1799,2481
3404-001,2018,6,11,11,891,909,1800,1799
3404-001,2018,6,11,12,847,825,1672,1800
3404-001,2018,6,11,13,807,722,1529,1672
3404-001,2018,6,11,14,780,802,1582,1529
3404-001,2018,6,11,15,928,805,1733,1582
3404-001,2018,6,11,16,993,870,1863,1733
3404-001,2018,6,11,17,1079,772,1851,1863
3404-001,2018,6,11,18,1442,771,2213,1851
3404-001,2018,6,11,19,1218,658,1876,2213
3404-001,2018,6,11,20,859,475,1334,1876
3404-001,2018,6,11,21,748,331,1079,1334
3404-001,2018,6,11,22,416,253,669,1079
3404-001,2018,6,11,23,195,155,350,669
3404-001,2018,6,11,24,134,108,242,350
3404-001,2018,6,12,1,92,74,166,242
3404-001,2018,6,12,2,52,79,131,166
3404-001,2018,6,12,3,52,68,120,131
3404-001,2018,6,12,4,58,53,111,120
3404-001,2018,6,12,5,96,135,231,111
3404-001,2018,6,12,6,224,326,550,231
3404-001,2018,6,12,7,440,797,1237,550
3404-001,2018,6,12,8,814,1899,2713,1237
3404-001,2018,6,12,9,1068,1436,2504,2713
3404-001,2018,6,12,10,888,1016,1904,2504
3404-001,2018,6,12,11,895,1027,1922,1904
3404-001,2018,6,12,12,836,818,1654,1922
3404-001,2018,6,12,13,799,767,1566,1654
3404-001,2018,6,12,14,859,882,1741,1566
3404-001,2018,6,12,15,958,916,1874,1741
3404-001,2018,6,12,16,1055,863,1918,1874
3404-001,2018,6,12,17,1037,875,1912,1918
3404-001,2018,6,12,18,1557,863,2420,1912
3404-001,2018,6,12,19,1467,738,2205,2420
3404-001,2018,6,12,20,887,561,1448,2205
3404-001,2018,6,12,21,741,362,1103,1448
3404-001,2018,6,12,22,433,264,697,1103
3404-001,2018,6,12,23,257,180,437,697
3404-001,2018,6,12,24,167,112,279,437
3404-001,2018,6,13,1,118,95,213,279
3404-001,2018,6,13,2,81,72,153,213
3404-001,2018,6,13,3,51,53,104,153
3404-001,2018,6,13,4,57,60,117,104
3404-001,2018,6,13,5,85,104,189,117
3404-001,2018,6,13,6,178,240,418,189
3404-001,2018,6,13,7,301,491,792,418
3404-001,2018,6,13,8,529,885,1414,792
3404-001,2018,6,13,9,599,888,1487,1414
3404-001,2018,6,13,10,634,773,1407,1487
3404-001,2018,6,13,11,620,675,1295,1407
3404-001,2018,6,13,12,678,632,1310,1295
3404-001,2018,6,13,13,604,580,1184,1310
3404-001,2018,6,13,14,669,580,1249,1184
3404-001,2018,6,13,15,647,580,1227,1249
3404-001,2018,6,13,16,760,527,1287,1227
3404-001,2018,6,13,17,810,543,1353,1287
3404-001,2018,6,13,18,929,522,1451,1353
3404-001,2018,6,13,19,642,406,1048,1451
3404-001,2018,6,13,20,432,340,772,1048
3404-001,2018,6,13,21,401,246,647,772
3404-001,2018,6,13,22,236,222,458,647
3404-001,2018,6,13,23,170,152,322,458
3404-001,2018,6,13,24,112,100,212,322
3404-001,2018,6,14,1,59,84,143,212
3404-001,2018,6,14,2,42,58,100,143
3404-001,2018,6,14,3,43,36,79,100
3404-001,2018,6,14,4,46,44,90,79
3404-001,2018,6,14,5,91,106,197,90
3404-001,2018,6,14,6,212,328,540,197
3404-001,2018,6,14,7,445,765,1210,540
3404-001,2018,6,14,8,839,1893,2732,1210
3404-001,2018,6,14,9,1007,1519,2526,2732
3404-001,2018,6,14,10,930,903,1833,2526
3404-001,2018,6,14,11,936,867,1803,1833
3404-001,2018,6,14,12,976,808,1784,1803
3404-001,2018,6,14,13,822,717,1539,1784
3404-001,2018,6,14,14,882,878,1760,1539
3404-001,2018,6,14,15,1004,861,1865,1760
3404-001,2018,6,14,16,951,853,1804,1865
3404-001,2018,6,14,17,1023,821,1844,1804
3404-001,2018,6,14,18,1417,722,2139,1844
3404-001,2018,6,14,19,1321,718,2039,2139
3404-001,2018,6,14,20,825,492,1317,2039
3404-001,2018,6,14,21,747,325,1072,1317
3404-001,2018,6,14,22,405,257,662,1072
3404-001,2018,6,14,23,236,164,400,662
3404-001,2018,6,14,24,172,119,291,400
3404-001,2018,6,15,1,91,71,162,291
3404-001,2018,6,15,2,64,57,121,162
3404-001,2018,6,15,3,58,56,114,121
3404-001,2018,6,15,4,55,65,120,114
3404-001,2018,6,15,5,96,113,209,120
3404-001,2018,6,15,6,230,318,548,209
3404-001,2018,6,15,7,461,816,1277,548
3404-001,2018,6,15,8,843,1813,2656,1277
3404-001,2018,6,15,9,1072,1500,2572,2656
3404-001,2018,6,15,10,895,1025,1920,2572
3404-001,2018,6,15,11,948,984,1932,1920
3404-001,2018,6,15,12,917,857,1774,1932
3404-001,2018,6,15,13,782,744,1526,1774
3404-001,2018,6,15,14,880,863,1743,1526
3404-001,2018,6,15,15,1000,840,1840,1743
3404-001,2018,6,15,16,983,876,1859,1840
3404-001,2018,6,15,17,1167,746,1913,1859
3404-001,2018,6,15,18,1686,833,2519,1913
3404-001,2018,6,15,19,1623,825,2448,2519
3404-001,2018,6,15,20,1017,619,1636,2448
3404-001,2018,6,15,21,725,442,1167,1636
3404-001,2018,6,15,22,424,288,712,1167
3404-001,2018,6,15,23,256,212,468,712
3404-001,2018,6,15,24,155,134,289,468
3404-001,2018,6,16,1,93,108,201,289
3404-001,2018,6,16,2,90,76,166,201
3404-001,2018,6,16,3,77,55,132,166
3404-001,2018,6,16,4,67,52,119,132
3404-001,2018,6,16,5,100,98,198,119
3404-001,2018,6,16,6,188,276,464,198
3404-001,2018,6,16,7,324,488,812,464
3404-001,2018,6,16,8,501,716,1217,812
3404-001,2018,6,16,9,633,806,1439,1217
3404-001,2018,6,16,10,643,771,1414,1439
3404-001,2018,6,16,11,668,820,1488,1414
3404-001,2018,6,16,12,668,758,1426,1488
3404-001,2018,6,16,13,635,616,1251,1426
3404-001,2018,6,16,14,592,712,1304,1251
3404-001,2018,6,16,15,598,538,1136,1304
3404-001,2018,6,16,16,712,662,1374,1136
3404-001,2018,6,16,17,738,575,1313,1374
3404-001,2018,6,16,18,949,574,1523,1313
3404-001,2018,6,16,19,615,485,1100,1523
3404-001,2018,6,16,20,419,379,798,1100
3404-001,2018,6,16,21,290,256,546,798
3404-001,2018,6,16,22,243,188,431,546
3404-001,2018,6,16,23,157,154,311,431
3404-001,2018,6,16,24,110,104,214,311
3404-001,2018,6,17,1,64,74,138,214
3404-001,2018,6,17,2,66,53,119,138
3404-001,2018,6,17,3,60,34,94,119
3404-001,2018,6,17,4,50,34,84,94
3404-001,2018,6,17,5,55,60,115,84
3404-001,2018,6,17,6,81,127,208,115
3404-001,2018,6,17,7,145,215,360,208
3404-001,2018,6,17,8,239,273,512,360
3404-001,2018,6,17,9,306,283,589,512
3404-001,2018,6,17,10,294,336,630,589
3404-001,2018,6,17,11,350,352,702,630
3404-001,2018,6,17,12,335,384,719,702
3404-001,2018,6,17,13,336,384,720,719
3404-001,2018,6,17,14,480,410,890,720
3404-001,2018,6,17,15,523,376,899,890
3404-001,2018,6,17,16,586,417,1003,899
3404-001,2018,6,17,17,633,422,1055,1003
3404-001,2018,6,17,18,658,441,1099,1055
3404-001,2018,6,17,19,548,384,932,1099
3404-001,2018,6,17,20,403,326,729,932
3404-001,2018,6,17,21,322,271,593,729
3404-001,2018,6,17,22,195,264,459,593
3404-001,2018,6,17,23,138,196,334,459
3404-001,2018,6,17,24,100,127,227,334
3404-001,2018,6,18,1,62,86,148,227
3404-001,2018,6,18,2,43,58,101,148
3404-001,2018,6,18,3,23,34,57,101
3404-001,2018,6,18,4,51,49,100,57
3404-001,2018,6,18,5,89,78,167,100
3404-001,2018,6,18,6,221,293,514,167
3404-001,2018,6,18,7,424,807,1231,514
3404-001,2018,6,18,8,851,1945,2796,1231
3404-001,2018,6,18,9,1018,1488,2506,2796
3404-001,2018,6,18,10,891,843,1734,2506
3404-001,2018,6,18,11,899,901,1800,1734
3404-001,2018,6,18,12,848,887,1735,1800
3404-001,2018,6,18,13,735,849,1584,1735
3404-001,2018,6,18,14,934,828,1762,1584
3404-001,2018,6,18,15,946,933,1879,1762
3404-001,2018,6,18,16,1004,893,1897,1879
3404-001,2018,6,18,17,1050,813,1863,1897
3404-001,2018,6,18,18,1412,753,2165,1863
3404-001,2018,6,18,19,1307,671,1978,2165
3404-001,2018,6,18,20,940,489,1429,1978
3404-001,2018,6,18,21,751,316,1067,1429
3404-001,2018,6,18,22,318,206,524,1067
3404-001,2018,6,18,23,133,120,253,524
3404-001,2018,6,18,24,134,124,258,253
3404-001,2018,6,19,1,91,94,185,258
3404-001,2018,6,19,2,55,56,111,185
3404-001,2018,6,19,3,40,42,82,111
3404-001,2018,6,19,4,50,56,106,82
3404-001,2018,6,19,5,89,94,183,106
3404-001,2018,6,19,6,208,292,500,183
3404-001,2018,6,19,7,458,741,1199,500
3404-001,2018,6,19,8,781,1822,2603,1199
3404-001,2018,6,19,9,1071,1473,2544,2603
3404-001,2018,6,19,10,864,864,1728,2544
3404-001,2018,6,19,11,939,882,1821,1728
3404-001,2018,6,19,12,865,757,1622,1821
3404-001,2018,6,19,13,760,698,1458,1622
3404-001,2018,6,19,14,821,717,1538,1458
3404-001,2018,6,19,15,987,853,1840,1538
3404-001,2018,6,19,16,974,819,1793,1840
3404-001,2018,6,19,17,962,671,1633,1793
3404-001,2018,6,19,18,1370,805,2175,1633
3404-001,2018,6,19,19,1276,692,1968,2175
3404-001,2018,6,19,20,806,528,1334,1968
3404-001,2018,6,19,21,675,310,985,1334
3404-001,2018,6,19,22,404,261,665,985
3404-001,2018,6,19,23,227,193,420,665
3404-001,2018,6,19,24,139,92,231,420
3404-001,2018,6,20,1,112,86,198,231
3404-001,2018,6,20,2,82,64,146,198
3404-001,2018,6,20,3,57,44,101,146
3404-001,2018,6,20,4,74,56,130,101
3404-001,2018,6,20,5,91,104,195,130
3404-001,2018,6,20,6,224,284,508,195
3404-001,2018,6,20,7,450,811,1261,508
3404-001,2018,6,20,8,814,1838,2652,1261
3404-001,2018,6,20,9,1014,1459,2473,2652
3404-001,2018,6,20,10,899,878,1777,2473
3404-001,2018,6,20,11,930,855,1785,1777
3404-001,2018,6,20,12,866,861,1727,1785
3404-001,2018,6,20,13,789,739,1528,1727
3404-001,2018,6,20,14,901,823,1724,1528
3404-001,2018,6,20,15,959,867,1826,1724
3404-001,2018,6,20,16,1046,813,1859,1826
3404-001,2018,6,20,17,1011,865,1876,1859
3404-001,2018,6,20,18,1562,798,2360,1876
3404-001,2018,6,20,19,1421,726,2147,2360
3404-001,2018,6,20,20,786,503,1289,2147
3404-001,2018,6,20,21,592,370,962,1289
3404-001,2018,6,20,22,363,267,630,962
3404-001,2018,6,20,23,241,186,427,630
3404-001,2018,6,20,24,129,141,270,427
3404-001,2018,6,21,1,100,88,188,270
3404-001,2018,6,21,2,87,81,168,188
3404-001,2018,6,21,3,56,55,111,168
3404-001,2018,6,21,4,64,44,108,111
3404-001,2018,6,21,5,122,126,248,108
3404-001,2018,6,21,6,221,308,529,248
3404-001,2018,6,21,7,409,776,1185,529
3404-001,2018,6,21,8,883,1871,2754,1185
3404-001,2018,6,21,9,1076,1510,2586,2754
3404-001,2018,6,21,10,920,905,1825,2586
3404-001,2018,6,21,11,987,971,1958,1825
3404-001,2018,6,21,12,897,863,1760,1958
3404-001,2018,6,21,13,825,797,1622,1760
3404-001,2018,6,21,14,890,850,1740,1622
3404-001,2018,6,21,15,1018,899,1917,1740
3404-001,2018,6,21,16,958,884,1842,1917
3404-001,2018,6,21,17,1022,849,1871,1842
3404-001,2018,6,21,18,1413,750,2163,1871
3404-001,2018,6,21,19,1287,681,1968,2163
3404-001,2018,6,21,20,818,502,1320,1968
3404-001,2018,6,21,21,774,347,1121,1320
3404-001,2018,6,21,22,415,272,687,1121
3404-001,2018,6,21,23,267,200,467,687
3404-001,2018,6,21,24,154,139,293,467
3404-001,2018,6,22,1,117,105,222,293
3404-001,2018,6,22,2,90,59,149,222
3404-001,2018,6,22,3,56,64,120,149
3404-001,2018,6,22,4,75,56,131,120
3404-001,2018,6,22,5,86,104,190,131
3404-001,2018,6,22,6,238,338,576,190
3404-001,2018,6,22,7,448,841,1289,576
3404-001,2018,6,22,8,846,1385,2231,1289
3404-001,2018,6,22,9,1036,1291,2327,2231
3404-001,2018,6,22,10,912,973,1885,2327
3404-001,2018,6,22,11,1008,865,1873,1885
3404-001,2018,6,22,12,884,842,1726,1873
3404-001,2018,6,22,13,845,703,1548,1726
3404-001,2018,6,22,14,848,825,1673,1548
3404-001,2018,6,22,15,1004,854,1858,1673
3404-001,2018,6,22,16,1054,838,1892,1858
3404-001,2018,6,22,17,1055,779,1834,1892
3404-001,2018,6,22,18,1726,877,2603,1834
3404-001,2018,6,22,19,1553,862,2415,2603
3404-001,2018,6,22,20,963,654,1617,2415
3404-001,2018,6,22,21,723,383,1106,1617
3404-001,2018,6,22,22,423,296,719,1106
3404-001,2018,6,22,23,253,171,424,719
3404-001,2018,6,22,24,137,115,252,424
3404-001,2018,6,23,1,126,100,226,252
3404-001,2018,6,23,2,67,73,140,226
3404-001,2018,6,23,3,61,59,120,140
3404-001,2018,6,23,4,58,75,133,120
3404-001,2018,6,23,5,103,124,227,133
3404-001,2018,6,23,6,169,253,422,227
3404-001,2018,6,23,7,337,506,843,422
3404-001,2018,6,23,8,556,769,1325,843
3404-001,2018,6,23,9,686,798,1484,1325
3404-001,2018,6,23,10,744,767,1511,1484
3404-001,2018,6,23,11,771,750,1521,1511
3404-001,2018,6,23,12,700,704,1404,1521
3404-001,2018,6,23,13,650,626,1276,1404
3404-001,2018,6,23,14,631,629,1260,1276
3404-001,2018,6,23,15,634,645,1279,1260
3404-001,2018,6,23,16,647,609,1256,1279
3404-001,2018,6,23,17,740,612,1352,1256
3404-001,2018,6,23,18,892,581,1473,1352
3404-001,2018,6,23,19,631,468,1099,1473
3404-001,2018,6,23,20,426,352,778,1099
3404-001,2018,6,23,21,377,264,641,778
3404-001,2018,6,23,22,245,189,434,641
3404-001,2018,6,23,23,157,146,303,434
3404-001,2018,6,23,24,103,100,203,303
3404-001,2018,6,24,1,78,51,129,203
3404-001,2018,6,24,2,55,29,84,129
3404-001,2018,6,24,3,49,43,92,84
3404-001,2018,6,24,4,40,36,76,92
3404-001,2018,6,24,5,60,64,124,76
3404-001,2018,6,24,6,74,110,184,124
3404-001,2018,6,24,7,136,199,335,184
3404-001,2018,6,24,8,212,252,464,335
3404-001,2018,6,24,9,309,254,563,464
3404-001,2018,6,24,10,299,337,636,563
3404-001,2018,6,24,11,344,401,745,636
3404-001,2018,6,24,12,377,370,747,745
3404-001,2018,6,24,13,415,382,797,747
3404-001,2018,6,24,14,447,404,851,797
3404-001,2018,6,24,15,498,424,922,851
3404-001,2018,6,24,16,640,480,1120,922
3404-001,2018,6,24,17,605,427,1032,1120
3404-001,2018,6,24,18,666,398,1064,1032
3404-001,2018,6,24,19,515,404,919,1064
3404-001,2018,6,24,20,390,316,706,919
3404-001,2018,6,24,21,340,291,631,706
3404-001,2018,6,24,22,257,270,527,631
3404-001,2018,6,24,23,149,195,344,527
3404-001,2018,6,24,24,115,119,234,344
3404-001,2018,6,25,1,60,89,149,234
3404-001,2018,6,25,2,40,58,98,149
3404-001,2018,6,25,3,22,65,87,98
3404-001,2018,6,25,4,39,44,83,87
3404-001,2018,6,25,5,103,108,211,83
3404-001,2018,6,25,6,223,337,560,211
3404-001,2018,6,25,7,451,871,1322,560
3404-001,2018,6,25,8,899,1963,2862,1322
3404-001,2018,6,25,9,976,1446,2422,2862
3404-001,2018,6,25,10,912,812,1724,2422
3404-001,2018,6,25,11,952,755,1707,1724
3404-001,2018,6,25,12,956,709,1665,1707
3404-001,2018,6,25,13,803,653,1456,1665
3404-001,2018,6,25,14,857,843,1700,1456
3404-001,2018,6,25,15,1015,844,1859,1700
3404-001,2018,6,25,16,1016,861,1877,1859
3404-001,2018,6,25,17,1024,746,1770,1877
3404-001,2018,6,25,18,1379,772,2151,1770
3404-001,2018,6,25,19,1300,657,1957,2151
3404-001,2018,6,25,20,853,449,1302,1957
3404-001,2018,6,25,21,764,328,1092,1302
3404-001,2018,6,25,22,418,235,653,1092
3404-001,2018,6,25,23,222,178,400,653
3404-001,2018,6,25,24,150,114,264,400
3404-001,2018,6,26,1,95,60,155,264
3404-001,2018,6,26,2,80,79,159,155
3404-001,2018,6,26,3,51,40,91,159
3404-001,2018,6,26,4,55,68,123,91
3404-001,2018,6,26,5,87,80,167,123
3404-001,2018,6,26,6,228,237,465,167
3404-001,2018,6,26,7,353,679,1032,465
3404-001,2018,6,26,8,800,1774,2574,1032
3404-001,2018,6,26,9,969,1403,2372,2574
3404-001,2018,6,26,10,789,789,1578,2372
3404-001,2018,6,26,11,753,729,1482,1578
3404-001,2018,6,26,12,735,687,1422,1482
3404-001,2018,6,26,13,690,629,1319,1422
3404-001,2018,6,26,14,711,631,1342,1319
3404-001,2018,6,26,15,924,725,1649,1342
3404-001,2018,6,26,16,901,756,1657,1649
3404-001,2018,6,26,17,824,657,1481,1657
3404-001,2018,6,26,18,1192,706,1898,1481
3404-001,2018,6,26,19,1185,600,1785,1898
3404-001,2018,6,26,20,716,475,1191,1785
3404-001,2018,6,26,21,618,267,885,1191
3404-001,2018,6,26,22,353,216,569,885
3404-001,2018,6,26,23,166,134,300,569
3404-001,2018,6,26,24,123,96,219,300
3404-001,2018,6,27,1,107,64,171,219
3404-001,2018,6,27,2,56,59,115,171
3404-001,2018,6,27,3,29,49,78,115
3404-001,2018,6,27,4,44,47,91,78
3404-001,2018,6,27,5,90,99,189,91
3404-001,2018,6,27,6,178,260,438,189
3404-001,2018,6,27,7,378,677,1055,438
3404-001,2018,6,27,8,793,1811,2604,1055
3404-001,2018,6,27,9,963,1408,2371,2604
3404-001,2018,6,27,10,865,950,1815,2371
3404-001,2018,6,27,11,868,851,1719,1815
3404-001,2018,6,27,12,918,816,1734,1719
3404-001,2018,6,27,13,788,754,1542,1734
3404-001,2018,6,27,14,833,805,1638,1542
3404-001,2018,6,27,15,968,879,1847,1638
3404-001,2018,6,27,16,982,832,1814,1847
3404-001,2018,6,27,17,1041,749,1790,1814
3404-001,2018,6,27,18,1595,811,2406,1790
3404-001,2018,6,27,19,1400,717,2117,2406
3404-001,2018,6,27,20,756,442,1198,2117
3404-001,2018,6,27,21,632,292,924,1198
3404-001,2018,6,27,22,354,234,588,924
3404-001,2018,6,27,23,211,182,393,588
3404-001,2018,6,27,24,134,139,273,393
3404-001,2018,6,28,1,92,59,151,273
3404-001,2018,6,28,2,67,86,153,151
3404-001,2018,6,28,3,46,51,97,153
3404-001,2018,6,28,4,49,56,105,97
3404-001,2018,6,28,5,94,108,202,105
3404-001,2018,6,28,6,205,256,461,202
3404-001,2018,6,28,7,421,678,1099,461
3404-001,2018,6,28,8,857,1822,2679,1099
3404-001,2018,6,28,9,1027,1372,2399,2679
3404-001,2018,6,28,10,913,820,1733,2399
3404-001,2018,6,28,11,882,847,1729,1733
3404-001,2018,6,28,12,925,793,1718,1729
3404-001,2018,6,28,13,768,705,1473,1718
3404-001,2018,6,28,14,795,724,1519,1473
3404-001,2018,6,28,15,991,841,1832,1519
3404-001,2018,6,28,16,999,755,1754,1832
3404-001,2018,6,28,17,955,725,1680,1754
3404-001,2018,6,28,18,1392,737,2129,1680
3404-001,2018,6,28,19,1290,692,1982,2129
3404-001,2018,6,28,20,781,464,1245,1982
3404-001,2018,6,28,21,717,291,1008,1245
3404-001,2018,6,28,22,354,234,588,1008
3404-001,2018,6,28,23,194,179,373,588
3404-001,2018,6,28,24,132,106,238,373
3404-001,2018,6,29,1,108,69,177,238
3404-001,2018,6,29,2,73,60,133,177
3404-001,2018,6,29,3,71,43,114,133
3404-001,2018,6,29,4,50,56,106,114
3404-001,2018,6,29,5,84,104,188,106
3404-001,2018,6,29,6,200,316,516,188
3404-001,2018,6,29,7,408,694,1102,516
3404-001,2018,6,29,8,829,1745,2574,1102
3404-001,2018,6,29,9,1033,1428,2461,2574
3404-001,2018,6,29,10,850,875,1725,2461
3404-001,2018,6,29,11,989,826,1815,1725
3404-001,2018,6,29,12,887,798,1685,1815
3404-001,2018,6,29,13,817,717,1534,1685
3404-001,2018,6,29,14,831,832,1663,1534
3404-001,2018,6,29,15,994,837,1831,1663
3404-001,2018,6,29,16,1063,857,1920,1831
3404-001,2018,6,29,17,1077,828,1905,1920
3404-001,2018,6,29,18,1732,831,2563,1905
3404-001,2018,6,29,19,1433,845,2278,2563
3404-001,2018,6,29,20,987,595,1582,2278
3404-001,2018,6,29,21,809,387,1196,1582
3404-001,2018,6,29,22,417,306,723,1196
3404-001,2018,6,29,23,258,206,464,723
3404-001,2018,6,29,24,158,114,272,464
3404-001,2018,6,30,1,128,80,208,272
3404-001,2018,6,30,2,89,75,164,208
3404-001,2018,6,30,3,60,34,94,164
3404-001,2018,6,30,4,58,56,114,94
3404-001,2018,6,30,5,97,70,167,114
3404-001,2018,6,30,6,163,227,390,167
3404-001,2018,6,30,7,293,394,687,390
3404-001,2018,6,30,8,524,668,1192,687
3404-001,2018,6,30,9,642,712,1354,1192
3404-001,2018,6,30,10,693,564,1257,1354
3404-001,2018,6,30,11,681,643,1324,1257
3404-001,2018,6,30,12,694,623,1317,1324
3404-001,2018,6,30,13,631,560,1191,1317
3404-001,2018,6,30,14,608,552,1160,1191
3404-001,2018,6,30,15,642,512,1154,1160
3404-001,2018,6,30,16,701,517,1218,1154
3404-001,2018,6,30,17,698,485,1183,1218
3404-001,2018,6,30,18,806,554,1360,1183
3404-001,2018,6,30,19,492,419,911,1360
3404-001,2018,6,30,20,355,304,659,911
3404-001,2018,6,30,21,305,261,566,659
3404-001,2018,6,30,22,191,187,378,566
3404-001,2018,6,30,23,130,163,293,378
3404-001,2018,6,30,24,103,90,193,293
3404-001,2018,7,1,1,66,67,133,193
3404-001,2018,7,1,2,61,50,111,133
3404-001,2018,7,1,3,47,36,83,111
3404-001,2018,7,1,4,25,32,57,83
3404-001,2018,7,1,5,45,42,87,57
3404-001,2018,7,1,6,45,56,101,87
3404-001,2018,7,1,7,92,101,193,101
3404-001,2018,7,1,8,147,193,340,193
3404-001,2018,7,1,9,202,197,399,340
3404-001,2018,7,1,10,210,219,429,399
3404-001,2018,7,1,11,315,313,628,429
3404-001,2018,7,1,12,287,294,581,628
3404-001,2018,7,1,13,353,330,683,581
3404-001,2018,7,1,14,356,313,669,683
3404-001,2018,7,1,15,452,332,784,669
3404-001,2018,7,1,16,459,367,826,784
3404-001,2018,7,1,17,400,309,709,826
3404-001,2018,7,1,18,389,342,731,709
3404-001,2018,7,1,19,275,343,618,731
3404-001,2018,7,1,20,247,284,531,618
3404-001,2018,7,1,21,190,243,433,531
3404-001,2018,7,1,22,149,192,341,433
3404-001,2018,7,1,23,101,149,250,341
3404-001,2018,7,1,24,72,98,170,250
3404-001,2018,7,2,1,45,72,117,170
3404-001,2018,7,2,2,29,64,93,117
3404-001,2018,7,2,3,30,28,58,93
3404-001,2018,7,2,4,30,45,75,58
3404-001,2018,7,2,5,66,57,123,75
3404-001,2018,7,2,6,133,251,384,123
3404-001,2018,7,2,7,355,662,1017,384
3404-001,2018,7,2,8,767,1884,2651,1017
3404-001,2018,7,2,9,927,1371,2298,2651
3404-001,2018,7,2,10,835,794,1629,2298
3404-001,2018,7,2,11,831,823,1654,1629
3404-001,2018,7,2,12,851,784,1635,1654
3404-001,2018,7,2,13,771,647,1418,1635
3404-001,2018,7,2,14,792,754,1546,1418
3404-001,2018,7,2,15,801,784,1585,1546
3404-001,2018,7,2,16,853,702,1555,1585
3404-001,2018,7,2,17,944,672,1616,1555
3404-001,2018,7,2,18,1279,693,1972,1616
3404-001,2018,7,2,19,1209,614,1823,1972
3404-001,2018,7,2,20,775,445,1220,1823
3404-001,2018,7,2,21,647,271,918,1220
3404-001,2018,7,2,22,342,218,560,918
3404-001,2018,7,2,23,228,140,368,560
3404-001,2018,7,2,24,141,106,247,368
3404-001,2018,7,3,1,102,81,183,247
3404-001,2018,7,3,2,50,64,114,183
3404-001,2018,7,3,3,37,39,76,114
3404-001,2018,7,3,4,45,73,118,76
3404-001,2018,7,3,5,80,103,183,118
3404-001,2018,7,3,6,203,253,456,183
3404-001,2018,7,3,7,393,719,1112,456
3404-001,2018,7,3,8,779,1839,2618,1112
3404-001,2018,7,3,9,972,1371,2343,2618
3404-001,2018,7,3,10,833,841,1674,2343
3404-001,2018,7,3,11,791,928,1719,1674
3404-001,2018,7,3,12,881,773,1654,1719
3404-001,2018,7,3,13,820,720,1540,1654
3404-001,2018,7,3,14,788,795,1583,1540
3404-001,2018,7,3,15,890,915,1805,1583
3404-001,2018,7,3,16,894,865,1759,1805
3404-001,2018,7,3,17,958,695,1653,1759
3404-001,2018,7,3,18,1174,713,1887,1653
3404-001,2018,7,3,19,1201,640,1841,1887
3404-001,2018,7,3,20,863,469,1332,1841
3404-001,2018,7,3,21,849,327,1176,1332
3404-001,2018,7,3,22,413,263,676,1176
3404-001,2018,7,3,23,271,164,435,676
3404-001,2018,7,3,24,142,117,259,435
3404-001,2018,7,4,1,106,58,164,259
3404-001,2018,7,4,2,53,47,100,164
3404-001,2018,7,4,3,41,38,79,100
3404-001,2018,7,4,4,55,62,117,79
3404-001,2018,7,4,5,89,81,170,117
3404-001,2018,7,4,6,179,244,423,170
3404-001,2018,7,4,7,434,682,1116,423
3404-001,2018,7,4,8,834,1767,2601,1116
3404-001,2018,7,4,9,1051,1373,2424,2601
3404-001,2018,7,4,10,886,928,1814,2424
3404-001,2018,7,4,11,875,840,1715,1814
3404-001,2018,7,4,12,883,789,1672,1715
3404-001,2018,7,4,13,837,718,1555,1672
3404-001,2018,7,4,14,818,817,1635,1555
3404-001,2018,7,4,15,919,883,1802,1635
3404-001,2018,7,4,16,949,796,1745,1802
3404-001,2018,7,4,17,1001,732,1733,1745
3404-001,2018,7,4,18,1539,685,2224,1733
3404-001,2018,7,4,19,1388,656,2044,2224
3404-001,2018,7,4,20,814,492,1306,2044
3404-001,2018,7,4,21,583,284,867,1306
3404-001,2018,7,4,22,394,230,624,867
3404-001,2018,7,4,23,232,141,373,624
3404-001,2018,7,4,24,102,111,213,373
3404-001,2018,7,5,1,106,66,172,213
3404-001,2018,7,5,2,89,62,151,172
3404-001,2018,7,5,3,57,58,115,151
3404-001,2018,7,5,4,55,67,122,115
3404-001,2018,7,5,5,98,66,164,122
3404-001,2018,7,5,6,203,256,459,164
3404-001,2018,7,5,7,451,654,1105,459
3404-001,2018,7,5,8,868,1767,2635,1105
3404-001,2018,7,5,9,1054,1355,2409,2635
3404-001,2018,7,5,10,839,856,1695,2409
3404-001,2018,7,5,11,882,811,1693,1695
3404-001,2018,7,5,12,856,730,1586,1693
3404-001,2018,7,5,13,686,699,1385,1586
3404-001,2018,7,5,14,817,730,1547,1385
3404-001,2018,7,5,15,938,866,1804,1547
3404-001,2018,7,5,16,979,828,1807,1804
3404-001,2018,7,5,17,996,645,1641,1807
3404-001,2018,7,5,18,1343,688,2031,1641
3404-001,2018,7,5,19,1351,619,1970,2031
3404-001,2018,7,5,20,816,442,1258,1970
3404-001,2018,7,5,21,737,299,1036,1258
3404-001,2018,7,5,22,377,226,603,1036
3404-001,2018,7,5,23,249,132,381,603
3404-001,2018,7,5,24,159,110,269,381
3404-001,2018,7,6,1,98,82,180,269
3404-001,2018,7,6,2,81,53,134,180
3404-001,2018,7,6,3,45,67,112,134
3404-001,2018,7,6,4,67,58,125,112
3404-001,2018,7,6,5,67,90,157,125
3404-001,2018,7,6,6,231,273,504,157
3404-001,2018,7,6,7,417,733,1150,504
3404-001,2018,7,6,8,835,1820,2655,1150
3404-001,2018,7,6,9,1013,1422,2435,2655
3404-001,2018,7,6,10,823,847,1670,2435
3404-001,2018,7,6,11,941,820,1761,1670
3404-001,2018,7,6,12,936,772,1708,1761
3404-001,2018,7,6,13,838,621,1459,1708
3404-001,2018,7,6,14,839,842,1681,1459
3404-001,2018,7,6,15,900,775,1675,1681
3404-001,2018,7,6,16,1002,734,1736,1675
3404-001,2018,7,6,17,1059,674,1733,1736
3404-001,2018,7,6,18,1733,818,2551,1733
3404-001,2018,7,6,19,1508,759,2267,2551
3404-001,2018,7,6,20,998,527,1525,2267
3404-001,2018,7,6,21,719,354,1073,1525
3404-001,2018,7,6,22,376,269,645,1073
3404-001,2018,7,6,23,243,165,408,645
3404-001,2018,7,6,24,150,117,267,408
3404-001,2018,7,7,1,92,78,170,267
3404-001,2018,7,7,2,76,70,146,170
3404-001,2018,7,7,3,53,37,90,146
3404-001,2018,7,7,4,46,62,108,90
3404-001,2018,7,7,5,99,89,188,108
3404-001,2018,7,7,6,177,245,422,188
3404-001,2018,7,7,7,318,464,782,422
3404-001,2018,7,7,8,465,732,1197,782
3404-001,2018,7,7,9,661,692,1353,1197
3404-001,2018,7,7,10,673,728,1401,1353
3404-001,2018,7,7,11,668,750,1418,1401
3404-001,2018,7,7,12,703,759,1462,1418
3404-001,2018,7,7,13,727,625,1352,1462
3404-001,2018,7,7,14,661,689,1350,1352
3404-001,2018,7,7,15,705,633,1338,1350
3404-001,2018,7,7,16,697,614,1311,1338
3404-001,2018,7,7,17,692,524,1216,1311
3404-001,2018,7,7,18,951,556,1507,1216
3404-001,2018,7,7,19,616,457,1073,1507
3404-001,2018,7,7,20,399,371,770,1073
3404-001,2018,7,7,21,311,258,569,770
3404-001,2018,7,7,22,239,260,499,569
3404-001,2018,7,7,23,172,138,310,499
3404-001,2018,7,7,24,132,98,230,310
3404-001,2018,7,8,1,70,76,146,230
3404-001,2018,7,8,2,56,49,105,146
3404-001,2018,7,8,3,51,57,108,105
3404-001,2018,7,8,4,36,37,73,108
3404-001,2018,7,8,5,54,39,93,73
3404-001,2018,7,8,6,84,102,186,93
3404-001,2018,7,8,7,167,202,369,186
3404-001,2018,7,8,8,197,222,419,369
3404-001,2018,7,8,9,258,273,531,419
3404-001,2018,7,8,10,342,281,623,531
3404-001,2018,7,8,11,345,367,712,623
3404-001,2018,7,8,12,362,381,743,712
3404-001,2018,7,8,13,415,372,787,743
3404-001,2018,7,8,14,417,405,822,787
3404-001,2018,7,8,15,484,427,911,822
3404-001,2018,7,8,16,544,400,944,911
3404-001,2018,7,8,17,620,399,1019,944
3404-001,2018,7,8,18,723,415,1138,1019
3404-001,2018,7,8,19,503,436,939,1138
3404-001,2018,7,8,20,402,344,746,939
3404-001,2018,7,8,21,325,301,626,746
3404-001,2018,7,8,22,257,258,515,626
3404-001,2018,7,8,23,153,195,348,515
3404-001,2018,7,8,24,105,131,236,348
3404-001,2018,7,9,1,58,68,126,236
3404-001,2018,7,9,2,32,50,82,126
3404-001,2018,7,9,3,29,41,70,82
3404-001,2018,7,9,4,33,31,64,70
3404-001,2018,7,9,5,94,75,169,64
3404-001,2018,7,9,6,180,220,400,169
3404-001,2018,7,9,7,421,752,1173,400
3404-001,2018,7,9,8,801,1875,2676,1173
3404-001,2018,7,9,9,1012,1448,2460,2676
3404-001,2018,7,9,10,831,752,1583,2460
3404-001,2018,7,9,11,787,743,1530,1583
3404-001,2018,7,9,12,806,699,1505,1530
3404-001,2018,7,9,13,722,612,1334,1505
3404-001,2018,7,9,14,717,688,1405,1334
3404-001,2018,7,9,15,896,792,1688,1405
3404-001,2018,7,9,16,819,715,1534,1688
3404-001,2018,7,9,17,886,629,1515,1534
3404-001,2018,7,9,18,1287,657,1944,1515
3404-001,2018,7,9,19,1146,644,1790,1944
3404-001,2018,7,9,20,717,411,1128,1790
3404-001,2018,7,9,21,625,268,893,1128
3404-001,2018,7,9,22,324,216,540,893
3404-001,2018,7,9,23,200,142,342,540
3404-001,2018,7,9,24,129,91,220,342
3404-001,2018,7,10,1,78,71,149,220
3404-001,2018,7,10,2,58,50,108,149
3404-001,2018,7,10,3,41,45,86,108
3404-001,2018,7,10,4,47,56,103,86
3404-001,2018,7,10,5,76,89,165,103
3404-001,2018,7,10,6,184,257,441,165
3404-001,2018,7,10,7,421,718,1139,441
3404-001,2018,7,10,8,817,1837,2654,1139
3404-001,2018,7,10,9,1096,1393,2489,2654
3404-001,2018,7,10,10,870,882,1752,2489
3404-001,2018,7,10,11,889,868,1757,1752
3404-001,2018,7,10,12,846,768,1614,1757
3404-001,2018,7,10,13,750,667,1417,1614
3404-001,2018,7,10,14,808,756,1564,1417
3404-001,2018,7,10,15,1046,782,1828,1564
3404-001,2018,7,10,16,1063,785,1848,1828
3404-001,2018,7,10,17,974,622,1596,1848
3404-001,2018,7,10,18,1322,712,2034,1596
3404-001,2018,7,10,19,1265,637,1902,2034
3404-001,2018,7,10,20,755,442,1197,1902
3404-001,2018,7,10,21,735,328,1063,1197
3404-001,2018,7,10,22,402,240,642,1063
3404-001,2018,7,10,23,222,167,389,642
3404-001,2018,7,10,24,150,99,249,389
3404-001,2018,7,11,1,97,85,182,249
3404-001,2018,7,11,2,68,58,126,182
3404-001,2018,7,11,3,45,45,90,126
3404-001,2018,7,11,4,52,70,122,90
3404-001,2018,7,11,5,102,86,188,122
3404-001,2018,7,11,6,247,271,518,188
3404-001,2018,7,11,7,408,672,1080,518
3404-001,2018,7,11,8,853,1765,2618,1080
3404-001,2018,7,11,9,1060,1360,2420,2618
3404-001,2018,7,11,10,801,839,1640,2420
3404-001,2018,7,11,11,928,878,1806,1640
3404-001,2018,7,11,12,901,860,1761,1806
3404-001,2018,7,11,13,813,690,1503,1761
3404-001,2018,7,11,14,884,781,1665,1503
3404-001,2018,7,11,15,1003,804,1807,1665
3404-001,2018,7,11,16,966,814,1780,1807
3404-001,2018,7,11,17,1021,740,1761,1780
3404-001,2018,7,11,18,1579,724,2303,1761
3404-001,2018,7,11,19,1320,724,2044,2303
3404-001,2018,7,11,20,763,476,1239,2044
3404-001,2018,7,11,21,608,288,896,1239
3404-001,2018,7,11,22,356,263,619,896
3404-001,2018,7,11,23,211,179,390,619
3404-001,2018,7,11,24,158,115,273,390
3404-001,2018,7,12,1,103,93,196,273
3404-001,2018,7,12,2,86,61,147,196
3404-001,2018,7,12,3,51,41,92,147
3404-001,2018,7,12,4,53,74,127,92
3404-001,2018,7,12,5,84,78,162,127
3404-001,2018,7,12,6,238,288,526,162
3404-001,2018,7,12,7,469,725,1194,526
3404-001,2018,7,12,8,861,1793,2654,1194
3404-001,2018,7,12,9,1006,1461,2467,2654
3404-001,2018,7,12,10,883,920,1803,2467
3404-001,2018,7,12,11,1033,798,1831,1803
3404-001,2018,7,12,12,918,810,1728,1831
3404-001,2018,7,12,13,810,644,1454,1728
3404-001,2018,7,12,14,875,781,1656,1454
3404-001,2018,7,12,15,989,917,1906,1656
3404-001,2018,7,12,16,978,845,1823,1906
3404-001,2018,7,12,17,1007,757,1764,1823
3404-001,2018,7,12,18,1411,741,2152,1764
3404-001,2018,7,12,19,1310,649,1959,2152
3404-001,2018,7,12,20,793,484,1277,1959
3404-001,2018,7,12,21,732,365,1097,1277
3404-001,2018,7,12,22,424,253,677,1097
3404-001,2018,7,12,23,227,170,397,677
3404-001,2018,7,12,24,179,121,300,397
3404-001,2018,7,13,1,104,70,174,300
3404-001,2018,7,13,2,73,65,138,174
3404-001,2018,7,13,3,58,58,116,138
3404-001,2018,7,13,4,73,74,147,116
3404-001,2018,7,13,5,110,119,229,147
3404-001,2018,7,13,6,260,258,518,229
3404-001,2018,7,13,7,429,725,1154,518
3404-001,2018,7,13,8,855,1773,2628,1154
3404-001,2018,7,13,9,1064,1358,2422,2628
3404-001,2018,7,13,10,959,953,1912,2422
3404-001,2018,7,13,11,1002,862,1864,1912
3404-001,2018,7,13,12,906,819,1725,1864
3404-001,2018,7,13,13,841,750,1591,1725
3404-001,2018,7,13,14,922,754,1676,1591
3404-001,2018,7,13,15,982,914,1896,1676
3404-001,2018,7,13,16,1073,858,1931,1896
3404-001,2018,7,13,17,1003,863,1866,1931
3404-001,2018,7,13,18,1694,858,2552,1866
3404-001,2018,7,13,19,1718,791,2509,2552
3404-001,2018,7,13,20,1022,587,1609,2509
3404-001,2018,7,13,21,750,373,1123,1609
3404-001,2018,7,13,22,374,280,654,1123
3404-001,2018,7,13,23,245,170,415,654
3404-001,2018,7,13,24,175,111,286,415
3404-001,2018,7,14,1,111,83,194,286
3404-001,2018,7,14,2,88,54,142,194
3404-001,2018,7,14,3,61,40,101,142
3404-001,2018,7,14,4,51,56,107,101
3404-001,2018,7,14,5,74,82,156,107
3404-001,2018,7,14,6,178,224,402,156
3404-001,2018,7,14,7,324,394,718,402
3404-001,2018,7,14,8,530,686,1216,718
3404-001,2018,7,14,9,718,768,1486,1216
3404-001,2018,7,14,10,720,757,1477,1486
3404-001,2018,7,14,11,635,757,1392,1477
3404-001,2018,7,14,12,721,732,1453,1392
3404-001,2018,7,14,13,646,608,1254,1453
3404-001,2018,7,14,14,646,636,1282,1254
3404-001,2018,7,14,15,635,611,1246,1282
3404-001,2018,7,14,16,717,621,1338,1246
3404-001,2018,7,14,17,715,563,1278,1338
3404-001,2018,7,14,18,852,535,1387,1278
3404-001,2018,7,14,19,587,482,1069,1387
3404-001,2018,7,14,20,396,342,738,1069
3404-001,2018,7,14,21,322,300,622,738
3404-001,2018,7,14,22,246,213,459,622
3404-001,2018,7,14,23,161,160,321,459
3404-001,2018,7,14,24,116,100,216,321
3404-001,2018,7,15,1,98,69,167,216
3404-001,2018,7,15,2,75,51,126,167
3404-001,2018,7,15,3,50,44,94,126
3404-001,2018,7,15,4,32,37,69,94
3404-001,2018,7,15,5,45,37,82,69
3404-001,2018,7,15,6,83,101,184,82
3404-001,2018,7,15,7,154,180,334,184
3404-001,2018,7,15,8,225,234,459,334
3404-001,2018,7,15,9,320,236,556,459
3404-001,2018,7,15,10,319,303,622,556
3404-001,2018,7,15,11,347,323,670,622
3404-001,2018,7,15,12,411,352,763,670
3404-001,2018,7,15,13,398,355,753,763
3404-001,2018,7,15,14,430,413,843,753
3404-001,2018,7,15,15,482,388,870,843
3404-001,2018,7,15,16,525,416,941,870
3404-001,2018,7,15,17,570,405,975,941
3404-001,2018,7,15,18,547,432,979,975
3404-001,2018,7,15,19,450,403,853,979
3404-001,2018,7,15,20,322,325,647,853
3404-001,2018,7,15,21,312,276,588,647
3404-001,2018,7,15,22,237,229,466,588
3404-001,2018,7,15,23,166,197,363,466
3404-001,2018,7,15,24,104,132,236,363
3404-001,2018,7,16,1,54,73,127,236
3404-001,2018,7,16,2,45,53,98,127
3404-001,2018,7,16,3,42,36,78,98
3404-001,2018,7,16,4,52,63,115,78
3404-001,2018,7,16,5,69,64,133,115
3404-001,2018,7,16,6,233,229,462,133
3404-001,2018,7,16,7,458,726,1184,462
3404-001,2018,7,16,8,838,1746,2584,1184
3404-001,2018,7,16,9,1008,1364,2372,2584
3404-001,2018,7,16,10,880,753,1633,2372
3404-001,2018,7,16,11,912,877,1789,1633
3404-001,2018,7,16,12,937,848,1785,1789
3404-001,2018,7,16,13,750,714,1464,1785
3404-001,2018,7,16,14,759,783,1542,1464
3404-001,2018,7,16,15,1014,859,1873,1542
3404-001,2018,7,16,16,856,892,1748,1873
3404-001,2018,7,16,17,999,727,1726,1748
3404-001,2018,7,16,18,1442,814,2256,1726
3404-001,2018,7,16,19,1272,628,1900,2256
3404-001,2018,7,16,20,848,504,1352,1900
3404-001,2018,7,16,21,733,319,1052,1352
3404-001,2018,7,16,22,406,233,639,1052
3404-001,2018,7,16,23,221,144,365,639
3404-001,2018,7,16,24,167,61,228,365
3404-001,2018,7,17,1,87,69,156,228
3404-001,2018,7,17,2,77,46,123,156
3404-001,2018,7,17,3,76,38,114,123
3404-001,2018,7,17,4,75,35,110,114
3404-001,2018,7,17,5,86,90,176,110
3404-001,2018,7,17,6,251,226,477,176
3404-001,2018,7,17,7,443,625,1068,477
3404-001,2018,7,17,8,867,1680,2547,1068
3404-001,2018,7,17,9,1080,1307,2387,2547
3404-001,2018,7,17,10,911,963,1874,2387
3404-001,2018,7,17,11,839,895,1734,1874
3404-001,2018,7,17,12,860,777,1637,1734
3404-001,2018,7,17,13,780,724,1504,1637
3404-001,2018,7,17,14,884,784,1668,1504
3404-001,2018,7,17,15,971,862,1833,1668
3404-001,2018,7,17,16,928,852,1780,1833
3404-001,2018,7,17,17,983,792,1775,1780
3404-001,2018,7,17,18,1342,725,2067,1775
3404-001,2018,7,17,19,1352,658,2010,2067
3404-001,2018,7,17,20,818,476,1294,2010
3404-001,2018,7,17,21,720,297,1017,1294
3404-001,2018,7,17,22,414,216,630,1017
3404-001,2018,7,17,23,233,159,392,630
3404-001,2018,7,17,24,163,115,278,392
3404-001,2018,7,18,1,87,77,164,278
3404-001,2018,7,18,2,63,41,104,164
3404-001,2018,7,18,3,52,21,73,104
3404-001,2018,7,18,4,68,56,124,73
3404-001,2018,7,18,5,106,68,174,124
3404-001,2018,7,18,6,234,286,520,174
3404-001,2018,7,18,7,484,683,1167,520
3404-001,2018,7,18,8,861,1820,2681,1167
3404-001,2018,7,18,9,1096,1440,2536,2681
3404-001,2018,7,18,10,923,896,1819,2536
3404-001,2018,7,18,11,848,996,1844,1819
3404-001,2018,7,18,12,832,795,1627,1844
3404-001,2018,7,18,13,715,696,1411,1627
3404-001,2018,7,18,14,828,751,1579,1411
3404-001,2018,7,18,15,998,829,1827,1579
3404-001,2018,7,18,16,1010,801,1811,1827
3404-001,2018,7,18,17,941,733,1674,1811
3404-001,2018,7,18,18,1545,796,2341,1674
3404-001,2018,7,18,19,1402,678,2080,2341
3404-001,2018,7,18,20,780,463,1243,2080
3404-001,2018,7,18,21,593,290,883,1243
3404-001,2018,7,18,22,417,210,627,883
3404-001,2018,7,18,23,245,161,406,627
3404-001,2018,7,18,24,145,98,243,406
3404-001,2018,7,19,1,108,75,183,243
3404-001,2018,7,19,2,71,52,123,183
3404-001,2018,7,19,3,61,44,105,123
3404-001,2018,7,19,4,65,54,119,105
3404-001,2018,7,19,5,90,74,164,119
3404-001,2018,7,19,6,222,260,482,164
3404-001,2018,7,19,7,458,626,1084,482
3404-001,2018,7,19,8,905,1803,2708,1084
3404-001,2018,7,19,9,1097,1395,2492,2708
3404-001,2018,7,19,10,982,960,1942,2492
3404-001,2018,7,19,11,904,926,1830,1942
3404-001,2018,7,19,12,853,868,1721,1830
3404-001,2018,7,19,13,761,823,1584,1721
3404-001,2018,7,19,14,812,841,1653,1584
3404-001,2018,7,19,15,1085,896,1981,1653
3404-001,2018,7,19,16,998,828,1826,1981
3404-001,2018,7,19,17,991,772,1763,1826
3404-001,2018,7,19,18,1452,849,2301,1763
3404-001,2018,7,19,19,1287,784,2071,2301
3404-001,2018,7,19,20,818,535,1353,2071
3404-001,2018,7,19,21,770,325,1095,1353
3404-001,2018,7,19,22,404,261,665,1095
3404-001,2018,7,19,23,218,217,435,665
3404-001,2018,7,19,24,150,143,293,435
3404-001,2018,7,20,1,113,89,202,293
3404-001,2018,7,20,2,71,83,154,202
3404-001,2018,7,20,3,43,50,93,154
3404-001,2018,7,20,4,58,77,135,93
3404-001,2018,7,20,5,102,87,189,135
3404-001,2018,7,20,6,236,337,573,189
3404-001,2018,7,20,7,427,776,1203,573
3404-001,2018,7,20,8,905,1878,2783,1203
3404-001,2018,7,20,9,1187,1396,2583,2783
3404-001,2018,7,20,10,928,1033,1961,2583
3404-001,2018,7,20,11,969,928,1897,1961
3404-001,2018,7,20,12,944,769,1713,1897
3404-001,2018,7,20,13,911,722,1633,1713
3404-001,2018,7,20,14,856,821,1677,1633
3404-001,2018,7,20,15,1033,928,1961,1677
3404-001,2018,7,20,16,1024,871,1895,1961
3404-001,2018,7,20,17,1075,879,1954,1895
3404-001,2018,7,20,18,1770,903,2673,1954
3404-001,2018,7,20,19,1576,880,2456,2673
3404-001,2018,7,20,20,909,689,1598,2456
3404-001,2018,7,20,21,721,384,1105,1598
3404-001,2018,7,20,22,438,305,743,1105
3404-001,2018,7,20,23,250,222,472,743
3404-001,2018,7,20,24,171,167,338,472
3404-001,2018,7,21,1,129,87,216,338
3404-001,2018,7,21,2,91,66,157,216
3404-001,2018,7,21,3,57,68,125,157
3404-001,2018,7,21,4,62,61,123,125
3404-001,2018,7,21,5,96,109,205,123
3404-001,2018,7,21,6,187,263,450,205
3404-001,2018,7,21,7,327,501,828,450
3404-001,2018,7,21,8,555,771,1326,828
3404-001,2018,7,21,9,760,773,1533,1326
3404-001,2018,7,21,10,721,769,1490,1533
3404-001,2018,7,21,11,743,753,1496,1490
3404-001,2018,7,21,12,749,654,1403,1496
3404-001,2018,7,21,13,646,605,1251,1403
3404-001,2018,7,21,14,583,565,1148,1251
3404-001,2018,7,21,15,682,597,1279,1148
3404-001,2018,7,21,16,659,507,1166,1279
3404-001,2018,7,21,17,694,529,1223,1166
3404-001,2018,7,21,18,788,603,1391,1223
3404-001,2018,7,21,19,608,467,1075,1391
3404-001,2018,7,21,20,397,397,794,1075
3404-001,2018,7,21,21,333,295,628,794
3404-001,2018,7,21,22,253,206,459,628
3404-001,2018,7,21,23,158,154,312,459
3404-001,2018,7,21,24,131,99,230,312
3404-001,2018,7,22,1,93,77,170,230
3404-001,2018,7,22,2,71,62,133,170
3404-001,2018,7,22,3,54,42,96,133
3404-001,2018,7,22,4,55,38,93,96
3404-001,2018,7,22,5,61,47,108,93
3404-001,2018,7,22,6,93,98,191,108
3404-001,2018,7,22,7,131,229,360,191
3404-001,2018,7,22,8,227,230,457,360
3404-001,2018,7,22,9,332,282,614,457
3404-001,2018,7,22,10,331,337,668,614
3404-001,2018,7,22,11,384,373,757,668
3404-001,2018,7,22,12,413,385,798,757
3404-001,2018,7,22,13,383,407,790,798
3404-001,2018,7,22,14,412,404,816,790
3404-001,2018,7,22,15,506,405,911,816
3404-001,2018,7,22,16,540,416,956,911
3404-001,2018,7,22,17,545,442,987,956
3404-001,2018,7,22,18,545,397,942,987
3404-001,2018,7,22,19,451,401,852,942
3404-001,2018,7,22,20,327,351,678,852
3404-001,2018,7,22,21,329,296,625,678
3404-001,2018,7,22,22,234,257,491,625
3404-001,2018,7,22,23,130,189,319,491
3404-001,2018,7,22,24,122,100,222,319
3404-001,2018,7,23,1,59,92,151,222
3404-001,2018,7,23,2,39,69,108,151
3404-001,2018,7,23,3,37,37,74,108
3404-001,2018,7,23,4,51,55,106,74
3404-001,2018,7,23,5,98,105,203,106
3404-001,2018,7,23,6,251,335,586,203
3404-001,2018,7,23,7,492,885,1377,586
3404-001,2018,7,23,8,939,1961,2900,1377
3404-001,2018,7,23,9,1055,1491,2546,2900
3404-001,2018,7,23,10,898,841,1739,2546
3404-001,2018,7,23,11,981,868,1849,1739
3404-001,2018,7,23,12,949,827,1776,1849
3404-001,2018,7,23,13,859,749,1608,1776
3404-001,2018,7,23,14,951,792,1743,1608
3404-001,2018,7,23,15,1038,942,1980,1743
3404-001,2018,7,23,16,1062,921,1983,1980
3404-001,2018,7,23,17,993,791,1784,1983
3404-001,2018,7,23,18,1418,837,2255,1784
3404-001,2018,7,23,19,1310,747,2057,2255
3404-001,2018,7,23,20,871,501,1372,2057
3404-001,2018,7,23,21,773,391,1164,1372
3404-001,2018,7,23,22,400,246,646,1164
3404-001,2018,7,23,23,226,165,391,646
3404-001,2018,7,23,24,122,108,230,391
3404-001,2018,7,24,1,89,87,176,230
3404-001,2018,7,24,2,61,56,117,176
3404-001,2018,7,24,3,61,54,115,117
3404-001,2018,7,24,4,71,105,176,115
3404-001,2018,7,24,5,81,128,209,176
3404-001,2018,7,24,6,225,322,547,209
3404-001,2018,7,24,7,447,768,1215,547
3404-001,2018,7,24,8,939,1922,2861,1215
3404-001,2018,7,24,9,1130,1413,2543,2861
3404-001,2018,7,24,10,984,918,1902,2543
3404-001,2018,7,24,11,962,899,1861,1902
3404-001,2018,7,24,12,1016,824,1840,1861
3404-001,2018,7,24,13,840,736,1576,1840
3404-001,2018,7,24,14,878,880,1758,1576
3404-001,2018,7,24,15,1095,852,1947,1758
3404-001,2018,7,24,16,1016,875,1891,1947
3404-001,2018,7,24,17,978,770,1748,1891
3404-001,2018,7,24,18,1401,815,2216,1748
3404-001,2018,7,24,19,1315,742,2057,2216
3404-001,2018,7,24,20,823,507,1330,2057
3404-001,2018,7,24,21,769,355,1124,1330
3404-001,2018,7,24,22,417,271,688,1124
3404-001,2018,7,24,23,207,153,360,688
3404-001,2018,7,24,24,149,131,280,360
3404-001,2018,7,25,1,105,73,178,280
3404-001,2018,7,25,2,51,48,99,178
3404-001,2018,7,25,3,51,44,95,99
3404-001,2018,7,25,4,64,53,117,95
3404-001,2018,7,25,5,96,117,213,117
3404-001,2018,7,25,6,257,309,566,213
3404-001,2018,7,25,7,446,751,1197,566
3404-001,2018,7,25,8,959,1828,2787,1197
3404-001,2018,7,25,9,1101,1346,2447,2787
3404-001,2018,7,25,10,950,1007,1957,2447
3404-001,2018,7,25,11,1024,899,1923,1957
3404-001,2018,7,25,12,861,888,1749,1923
3404-001,2018,7,25,13,867,716,1583,1749
3404-001,2018,7,25,14,838,790,1628,1583
3404-001,2018,7,25,15,1019,861,1880,1628
3404-001,2018,7,25,16,933,829,1762,1880
3404-001,2018,7,25,17,1019,769,1788,1762
3404-001,2018,7,25,18,1541,837,2378,1788
3404-001,2018,7,25,19,1324,775,2099,2378
3404-001,2018,7,25,20,763,509,1272,2099
3404-001,2018,7,25,21,598,335,933,1272
3404-001,2018,7,25,22,424,243,667,933
3404-001,2018,7,25,23,237,144,381,667
3404-001,2018,7,25,24,171,132,303,381
3404-001,2018,7,26,1,113,78,191,303
3404-001,2018,7,26,2,61,56,117,191
3404-001,2018,7,26,3,47,70,117,117
3404-001,2018,7,26,4,70,58,128,117
3404-001,2018,7,26,5,95,130,225,128
3404-001,2018,7,26,6,240,321,561,225
3404-001,2018,7,26,7,473,721,1194,561
3404-001,2018,7,26,8,949,1783,2732,1194
3404-001,2018,7,26,9,1067,1452,2519,2732
3404-001,2018,7,26,10,965,890,1855,2519
3404-001,2018,7,26,11,977,974,1951,1855
3404-001,2018,7,26,12,905,813,1718,1951
3404-001,2018,7,26,13,838,761,1599,1718
3404-001,2018,7,26,14,926,827,1753,1599
3404-001,2018,7,26,15,1044,837,1881,1753
3404-001,2018,7,26,16,995,884,1879,1881
3404-001,2018,7,26,17,1065,810,1875,1879
3404-001,2018,7,26,18,1462,764,2226,1875
3404-001,2018,7,26,19,1326,741,2067,2226
3404-001,2018,7,26,20,833,576,1409,2067
3404-001,2018,7,26,21,737,371,1108,1409
3404-001,2018,7,26,22,390,257,647,1108
3404-001,2018,7,26,23,242,173,415,647
3404-001,2018,7,26,24,155,116,271,415
3404-001,2018,7,27,1,113,90,203,271
3404-001,2018,7,27,2,75,60,135,203
3404-001,2018,7,27,3,54,62,116,135
3404-001,2018,7,27,4,51,68,119,116
3404-001,2018,7,27,5,124,111,235,119
3404-001,2018,7,27,6,232,341,573,235
3404-001,2018,7,27,7,431,823,1254,573
3404-001,2018,7,27,8,905,1836,2741,1254
3404-001,2018,7,27,9,1115,1371,2486,2741
3404-001,2018,7,27,10,979,879,1858,2486
3404-001,2018,7,27,11,966,912,1878,1858
3404-001,2018,7,27,12,1017,879,1896,1878
3404-001,2018,7,27,13,919,762,1681,1896
3404-001,2018,7,27,14,956,792,1748,1681
3404-001,2018,7,27,15,1065,869,1934,1748
3404-001,2018,7,27,16,1108,875,1983,1934
3404-001,2018,7,27,17,1085,853,1938,1983
3404-001,2018,7,27,18,1722,872,2594,1938
3404-001,2018,7,27,19,1543,904,2447,2594
3404-001,2018,7,27,20,884,618,1502,2447
3404-001,2018,7,27,21,675,412,1087,1502
3404-001,2018,7,27,22,410,301,711,1087
3404-001,2018,7,27,23,262,214,476,711
3404-001,2018,7,27,24,163,122,285,476
3404-001,2018,7,28,1,137,20,157,285
3404-001,2018,7,28,2,79,71,150,157
3404-001,2018,7,28,3,66,58,124,150
3404-001,2018,7,28,4,64,76,140,124
3404-001,2018,7,28,5,104,100,204,140
3404-001,2018,7,28,6,201,266,467,204
3404-001,2018,7,28,7,341,449,790,467
3404-001,2018,7,28,8,509,754,1263,790
3404-001,2018,7,28,9,665,733,1398,1263
3404-001,2018,7,28,10,705,730,1435,1398
3404-001,2018,7,28,11,724,775,1499,1435
3404-001,2018,7,28,12,677,789,1466,1499
3404-001,2018,7,28,13,644,695,1339,1466
3404-001,2018,7,28,14,642,611,1253,1339
3404-001,2018,7,28,15,638,569,1207,1253
3404-001,2018,7,28,16,706,555,1261,1207
3404-001,2018,7,28,17,704,506,1210,1261
3404-001,2018,7,28,18,758,519,1277,1210
3404-001,2018,7,28,19,532,465,997,1277
3404-001,2018,7,28,20,349,336,685,997
3404-001,2018,7,28,21,319,265,584,685
3404-001,2018,7,28,22,215,218,433,584
3404-001,2018,7,28,23,150,142,292,433
3404-001,2018,7,28,24,116,93,209,292
3404-001,2018,7,29,1,92,62,154,209
3404-001,2018,7,29,2,53,33,86,154
3404-001,2018,7,29,3,44,37,81,86
3404-001,2018,7,29,4,41,25,66,81
3404-001,2018,7,29,5,46,47,93,66
3404-001,2018,7,29,6,80,105,185,93
3404-001,2018,7,29,7,143,208,351,185
3404-001,2018,7,29,8,222,266,488,351
3404-001,2018,7,29,9,328,284,612,488
3404-001,2018,7,29,10,338,276,614,612
3404-001,2018,7,29,11,382,367,749,614
3404-001,2018,7,29,12,393,336,729,749
3404-001,2018,7,29,13,396,358,754,729
3404-001,2018,7,29,14,403,371,774,754
3404-001,2018,7,29,15,474,388,862,774
3404-001,2018,7,29,16,538,411,949,862
3404-001,2018,7,29,17,495,443,938,949
3404-001,2018,7,29,18,551,436,987,938
3404-001,2018,7,29,19,400,446,846,987
3404-001,2018,7,29,20,323,345,668,846
3404-001,2018,7,29,21,287,282,569,668
3404-001,2018,7,29,22,219,247,466,569
3404-001,2018,7,29,23,181,151,332,466
3404-001,2018,7,29,24,123,126,249,332
3404-001,2018,7,30,1,60,75,135,249
3404-001,2018,7,30,2,54,31,85,135
3404-001,2018,7,30,3,38,46,84,85
3404-001,2018,7,30,4,46,54,100,84
3404-001,2018,7,30,5,92,75,167,100
3404-001,2018,7,30,6,216,235,451,167
3404-001,2018,7,30,7,459,646,1105,451
3404-001,2018,7,30,8,801,1379,2180,1105
3404-001,2018,7,30,9,898,1069,1967,2180
3404-001,2018,7,30,10,749,769,1518,1967
3404-001,2018,7,30,11,856,790,1646,1518
3404-001,2018,7,30,12,783,738,1521,1646
3404-001,2018,7,30,13,755,663,1418,1521
3404-001,2018,7,30,14,779,683,1462,1418
3404-001,2018,7,30,15,870,708,1578,1462
3404-001,2018,7,30,16,822,790,1612,1578
3404-001,2018,7,30,17,922,687,1609,1612
3404-001,2018,7,30,18,1197,736,1933,1609
3404-001,2018,7,30,19,1031,646,1677,1933
3404-001,2018,7,30,20,624,499,1123,1677
3404-001,2018,7,30,21,492,309,801,1123
3404-001,2018,7,30,22,307,223,530,801
3404-001,2018,7,30,23,197,127,324,530
3404-001,2018,7,30,24,126,99,225,324
3404-001,2018,7,31,1,91,60,151,225
3404-001,2018,7,31,2,61,53,114,151
3404-001,2018,7,31,3,53,60,113,114
3404-001,2018,7,31,4,57,58,115,113
3404-001,2018,7,31,5,75,98,173,115
3404-001,2018,7,31,6,198,213,411,173
3404-001,2018,7,31,7,361,537,898,411
3404-001,2018,7,31,8,640,1254,1894,898
3404-001,2018,7,31,9,891,1028,1919,1894
3404-001,2018,7,31,10,783,771,1554,1919
3404-001,2018,7,31,11,777,722,1499,1554
3404-001,2018,7,31,12,716,708,1424,1499
3404-001,2018,7,31,13,707,655,1362,1424
3404-001,2018,7,31,14,713,743,1456,1362
3404-001,2018,7,31,15,823,717,1540,1456
3404-001,2018,7,31,16,851,702,1553,1540
3404-001,2018,7,31,17,881,648,1529,1553
3404-001,2018,7,31,18,1208,694,1902,1529
3404-001,2018,7,31,19,996,687,1683,1902
3404-001,2018,7,31,20,671,462,1133,1683
3404-001,2018,7,31,21,476,372,848,1133
3404-001,2018,7,31,22,312,220,532,848
3404-001,2018,7,31,23,179,161,340,532
3404-001,2018,7,31,24,131,107,238,340
3404-001,2018,8,1,1,90,79,169,238
3404-001,2018,8,1,2,57,64,121,169
3404-001,2018,8,1,3,29,35,64,121
3404-001,2018,8,1,4,57,51,108,64
3404-001,2018,8,1,5,82,87,169,108
3404-001,2018,8,1,6,154,199,353,169
3404-001,2018,8,1,7,344,508,852,353
3404-001,2018,8,1,8,625,1044,1669,852
3404-001,2018,8,1,9,788,949,1737,1669
3404-001,2018,8,1,10,723,679,1402,1737
3404-001,2018,8,1,11,746,689,1435,1402
3404-001,2018,8,1,12,681,753,1434,1435
3404-001,2018,8,1,13,676,651,1327,1434
3404-001,2018,8,1,14,696,708,1404,1327
3404-001,2018,8,1,15,677,724,1401,1404
3404-001,2018,8,1,16,711,686,1397,1401
3404-001,2018,8,1,17,708,668,1376,1397
3404-001,2018,8,1,18,952,634,1586,1376
3404-001,2018,8,1,19,853,578,1431,1586
3404-001,2018,8,1,20,507,424,931,1431
3404-001,2018,8,1,21,380,282,662,931
3404-001,2018,8,1,22,265,203,468,662
3404-001,2018,8,1,23,163,148,311,468
3404-001,2018,8,1,24,113,96,209,311
3404-001,2018,8,2,1,94,63,157,209
3404-001,2018,8,2,2,53,53,106,157
3404-001,2018,8,2,3,29,41,70,106
3404-001,2018,8,2,4,41,51,92,70
3404-001,2018,8,2,5,65,82,147,92
3404-001,2018,8,2,6,187,170,357,147
3404-001,2018,8,2,7,317,444,761,357
3404-001,2018,8,2,8,617,1127,1744,761
3404-001,2018,8,2,9,797,903,1700,1744
3404-001,2018,8,2,10,762,730,1492,1700
3404-001,2018,8,2,11,743,760,1503,1492
3404-001,2018,8,2,12,667,738,1405,1503
3404-001,2018,8,2,13,696,627,1323,1405
3404-001,2018,8,2,14,653,660,1313,1323
3404-001,2018,8,2,15,736,637,1373,1313
3404-001,2018,8,2,16,702,651,1353,1373
3404-001,2018,8,2,17,652,596,1248,1353
3404-001,2018,8,2,18,927,603,1530,1248
3404-001,2018,8,2,19,730,583,1313,1530
3404-001,2018,8,2,20,511,401,912,1313
3404-001,2018,8,2,21,421,282,703,912
3404-001,2018,8,2,22,278,221,499,703
3404-001,2018,8,2,23,181,133,314,499
3404-001,2018,8,2,24,113,108,221,314
3404-001,2018,8,3,1,73,66,139,221
3404-001,2018,8,3,2,55,55,110,139
3404-001,2018,8,3,3,39,42,81,110
3404-001,2018,8,3,4,57,63,120,81
3404-001,2018,8,3,5,70,81,151,120
3404-001,2018,8,3,6,145,229,374,151
3404-001,2018,8,3,7,377,471,848,374
3404-001,2018,8,3,8,616,994,1610,848
3404-001,2018,8,3,9,784,940,1724,1610
3404-001,2018,8,3,10,655,710,1365,1724
3404-001,2018,8,3,11,687,661,1348,1365
3404-001,2018,8,3,12,668,617,1285,1348
3404-001,2018,8,3,13,616,587,1203,1285
3404-001,2018,8,3,14,689,622,1311,1203
3404-001,2018,8,3,15,717,646,1363,1311
3404-001,2018,8,3,16,692,653,1345,1363
3404-001,2018,8,3,17,745,593,1338,1345
3404-001,2018,8,3,18,1149,640,1789,1338
3404-001,2018,8,3,19,972,632,1604,1789
3404-001,2018,8,3,20,571,529,1100,1604
3404-001,2018,8,3,21,494,325,819,1100
3404-001,2018,8,3,22,272,255,527,819
3404-001,2018,8,3,23,156,168,324,527
3404-001,2018,8,3,24,118,103,221,324
3404-001,2018,8,4,1,91,63,154,221
3404-001,2018,8,4,2,45,44,89,154
3404-001,2018,8,4,3,51,29,80,89
3404-001,2018,8,4,4,29,53,82,80
3404-001,2018,8,4,5,79,98,177,82
3404-001,2018,8,4,6,124,192,316,177
3404-001,2018,8,4,7,261,310,571,316
3404-001,2018,8,4,8,394,508,902,571
3404-001,2018,8,4,9,539,552,1091,902
3404-001,2018,8,4,10,508,588,1096,1091
3404-001,2018,8,4,11,528,594,1122,1096
3404-001,2018,8,4,12,542,636,1178,1122
3404-001,2018,8,4,13,514,590,1104,1178
3404-001,2018,8,4,14,514,513,1027,1104
3404-001,2018,8,4,15,551,530,1081,1027
3404-001,2018,8,4,16,553,457,1010,1081
3404-001,2018,8,4,17,574,466,1040,1010
3404-001,2018,8,4,18,688,442,1130,1040
3404-001,2018,8,4,19,488,405,893,1130
3404-001,2018,8,4,20,317,329,646,893
3404-001,2018,8,4,21,277,265,542,646
3404-001,2018,8,4,22,186,225,411,542
3404-001,2018,8,4,23,142,148,290,411
3404-001,2018,8,4,24,115,94,209,290
3404-001,2018,8,5,1,65,57,122,209
3404-001,2018,8,5,2,40,54,94,122
3404-001,2018,8,5,3,33,39,72,94
3404-001,2018,8,5,4,28,31,59,72
3404-001,2018,8,5,5,51,48,99,59
3404-001,2018,8,5,6,83,91,174,99
3404-001,2018,8,5,7,129,183,312,174
3404-001,2018,8,5,8,206,252,458,312
3404-001,2018,8,5,9,266,291,557,458
3404-001,2018,8,5,10,270,278,548,557
3404-001,2018,8,5,11,346,362,708,548
3404-001,2018,8,5,12,370,376,746,708
3404-001,2018,8,5,13,381,326,707,746
3404-001,2018,8,5,14,436,368,804,707
3404-001,2018,8,5,15,535,381,916,804
3404-001,2018,8,5,16,532,411,943,916
3404-001,2018,8,5,17,502,405,907,943
3404-001,2018,8,5,18,536,424,960,907
3404-001,2018,8,5,19,360,384,744,960
3404-001,2018,8,5,20,309,337,646,744
3404-001,2018,8,5,21,311,325,636,646
3404-001,2018,8,5,22,206,250,456,636
3404-001,2018,8,5,23,158,183,341,456
3404-001,2018,8,5,24,104,148,252,341
3404-001,2018,8,6,1,62,86,148,252
3404-001,2018,8,6,2,38,75,113,148
3404-001,2018,8,6,3,44,47,91,113
3404-001,2018,8,6,4,35,40,75,91
3404-001,2018,8,6,5,83,121,204,75
3404-001,2018,8,6,6,189,266,455,204
3404-001,2018,8,6,7,393,733,1126,455
3404-001,2018,8,6,8,869,1856,2725,1126
3404-001,2018,8,6,9,949,1320,2269,2725
3404-001,2018,8,6,10,764,851,1615,2269
3404-001,2018,8,6,11,829,800,1629,1615
3404-001,2018,8,6,12,787,776,1563,1629
3404-001,2018,8,6,13,720,709,1429,1563
3404-001,2018,8,6,14,765,822,1587,1429
3404-001,2018,8,6,15,875,843,1718,1587
3404-001,2018,8,6,16,913,799,1712,1718
3404-001,2018,8,6,17,811,675,1486,1712
3404-001,2018,8,6,18,1211,749,1960,1486
3404-001,2018,8,6,19,1143,659,1802,1960
3404-001,2018,8,6,20,760,497,1257,1802
3404-001,2018,8,6,21,649,341,990,1257
3404-001,2018,8,6,22,349,228,577,990
3404-001,2018,8,6,23,160,166,326,577
3404-001,2018,8,6,24,128,110,238,326
3404-001,2018,8,7,1,93,94,187,238
3404-001,2018,8,7,2,62,58,120,187
3404-001,2018,8,7,3,60,47,107,120
3404-001,2018,8,7,4,59,70,129,107
3404-001,2018,8,7,5,92,106,198,129
3404-001,2018,8,7,6,221,263,484,198
3404-001,2018,8,7,7,403,729,1132,484
3404-001,2018,8,7,8,870,1867,2737,1132
3404-001,2018,8,7,9,979,1414,2393,2737
3404-001,2018,8,7,10,927,883,1810,2393
3404-001,2018,8,7,11,867,892,1759,1810
3404-001,2018,8,7,12,870,819,1689,1759
3404-001,2018,8,7,13,726,656,1382,1689
3404-001,2018,8,7,14,837,819,1656,1382
3404-001,2018,8,7,15,969,900,1869,1656
3404-001,2018,8,7,16,932,873,1805,1869
3404-001,2018,8,7,17,933,753,1686,1805
3404-001,2018,8,7,18,1304,798,2102,1686
3404-001,2018,8,7,19,1183,682,1865,2102
3404-001,2018,8,7,20,799,502,1301,1865
3404-001,2018,8,7,21,656,357,1013,1301
3404-001,2018,8,7,22,338,254,592,1013
3404-001,2018,8,7,23,211,176,387,592
3404-001,2018,8,7,24,129,107,236,387
3404-001,2018,8,8,1,99,92,191,236
3404-001,2018,8,8,2,59,54,113,191
3404-001,2018,8,8,3,58,47,105,113
3404-001,2018,8,8,4,66,55,121,105
3404-001,2018,8,8,5,79,101,180,121
3404-001,2018,8,8,6,229,298,527,180
3404-001,2018,8,8,7,442,728,1170,527
3404-001,2018,8,8,8,877,1801,2678,1170
3404-001,2018,8,8,9,972,1331,2303,2678
3404-001,2018,8,8,10,855,855,1710,2303
3404-001,2018,8,8,11,912,897,1809,1710
3404-001,2018,8,8,12,861,822,1683,1809
3404-001,2018,8,8,13,709,742,1451,1683
3404-001,2018,8,8,14,778,797,1575,1451
3404-001,2018,8,8,15,946,905,1851,1575
3404-001,2018,8,8,16,953,784,1737,1851
3404-001,2018,8,8,17,964,718,1682,1737
3404-001,2018,8,8,18,1434,827,2261,1682
3404-001,2018,8,8,19,1237,740,1977,2261
3404-001,2018,8,8,20,750,473,1223,1977
3404-001,2018,8,8,21,572,362,934,1223
3404-001,2018,8,8,22,329,241,570,934
3404-001,2018,8,8,23,211,193,404,570
3404-001,2018,8,8,24,135,106,241,404
3404-001,2018,8,9,1,111,81,192,241
3404-001,2018,8,9,2,64,73,137,192
3404-001,2018,8,9,3,56,43,99,137
3404-001,2018,8,9,4,63,51,114,99
3404-001,2018,8,9,5,101,106,207,114
3404-001,2018,8,9,6,225,287,512,207
3404-001,2018,8,9,7,391,714,1105,512
3404-001,2018,8,9,8,838,1835,2673,1105
3404-001,2018,8,9,9,992,1353,2345,2673
3404-001,2018,8,9,10,899,916,1815,2345
3404-001,2018,8,9,11,911,843,1754,1815
3404-001,2018,8,9,12,797,827,1624,1754
3404-001,2018,8,9,13,730,730,1460,1624
3404-001,2018,8,9,14,784,771,1555,1460
3404-001,2018,8,9,15,949,863,1812,1555
3404-001,2018,8,9,16,880,855,1735,1812
3404-001,2018,8,9,17,885,798,1683,1735
3404-001,2018,8,9,18,1307,719,2026,1683
3404-001,2018,8,9,19,1180,682,1862,2026
3404-001,2018,8,9,20,780,494,1274,1862
3404-001,2018,8,9,21,628,338,966,1274
3404-001,2018,8,9,22,344,261,605,966
3404-001,2018,8,9,23,216,165,381,605
3404-001,2018,8,9,24,137,132,269,381
3404-001,2018,8,10,1,71,80,151,269
3404-001,2018,8,10,2,72,58,130,151
3404-001,2018,8,10,3,50,70,120,130
3404-001,2018,8,10,4,61,66,127,120
3404-001,2018,8,10,5,110,88,198,127
3404-001,2018,8,10,6,219,297,516,198
3404-001,2018,8,10,7,406,717,1123,516
3404-001,2018,8,10,8,823,1748,2571,1123
3404-001,2018,8,10,9,1028,1370,2398,2571
3404-001,2018,8,10,10,883,903,1786,2398
3404-001,2018,8,10,11,893,905,1798,1786
3404-001,2018,8,10,12,890,853,1743,1798
3404-001,2018,8,10,13,727,806,1533,1743
3404-001,2018,8,10,14,835,793,1628,1533
3404-001,2018,8,10,15,1031,950,1981,1628
3404-001,2018,8,10,16,931,842,1773,1981
3404-001,2018,8,10,17,1019,816,1835,1773
3404-001,2018,8,10,18,1493,807,2300,1835
3404-001,2018,8,10,19,1396,812,2208,2300
3404-001,2018,8,10,20,875,578,1453,2208
3404-001,2018,8,10,21,682,416,1098,1453
3404-001,2018,8,10,22,356,301,657,1098
3404-001,2018,8,10,23,236,205,441,657
3404-001,2018,8,10,24,152,138,290,441
3404-001,2018,8,11,1,109,77,186,290
3404-001,2018,8,11,2,74,59,133,186
3404-001,2018,8,11,3,55,64,119,133
3404-001,2018,8,11,4,66,58,124,119
3404-001,2018,8,11,5,91,74,165,124
3404-001,2018,8,11,6,166,239,405,165
3404-001,2018,8,11,7,314,452,766,405
3404-001,2018,8,11,8,531,755,1286,766
3404-001,2018,8,11,9,651,672,1323,1286
3404-001,2018,8,11,10,638,681,1319,1323
3404-001,2018,8,11,11,650,779,1429,1319
3404-001,2018,8,11,12,641,665,1306,1429
3404-001,2018,8,11,13,663,618,1281,1306
3404-001,2018,8,11,14,586,576,1162,1281
3404-001,2018,8,11,15,600,581,1181,1162
3404-001,2018,8,11,16,630,541,1171,1181
3404-001,2018,8,11,17,650,521,1171,1171
3404-001,2018,8,11,18,782,530,1312,1171
3404-001,2018,8,11,19,556,478,1034,1312
3404-001,2018,8,11,20,358,367,725,1034
3404-001,2018,8,11,21,320,285,605,725
3404-001,2018,8,11,22,206,219,425,605
3404-001,2018,8,11,23,172,148,320,425
3404-001,2018,8,11,24,118,122,240,320
3404-001,2018,8,12,1,79,73,152,240
3404-001,2018,8,12,2,68,40,108,152
3404-001,2018,8,12,3,42,35,77,108
3404-001,2018,8,12,4,41,38,79,77
3404-001,2018,8,12,5,51,52,103,79
3404-001,2018,8,12,6,78,102,180,103
3404-001,2018,8,12,7,144,178,322,180
3404-001,2018,8,12,8,240,242,482,322
3404-001,2018,8,12,9,311,285,596,482
3404-001,2018,8,12,10,285,298,583,596
3404-001,2018,8,12,11,307,353,660,583
3404-001,2018,8,12,12,371,313,684,660
3404-001,2018,8,12,13,375,341,716,684
3404-001,2018,8,12,14,426,383,809,716
3404-001,2018,8,12,15,454,392,846,809
3404-001,2018,8,12,16,494,421,915,846
3404-001,2018,8,12,17,476,454,930,915
3404-001,2018,8,12,18,476,455,931,930
3404-001,2018,8,12,19,400,373,773,931
3404-001,2018,8,12,20,308,339,647,773
3404-001,2018,8,12,21,281,305,586,647
3404-001,2018,8,12,22,227,247,474,586
3404-001,2018,8,12,23,150,170,320,474
3404-001,2018,8,12,24,103,123,226,320
3404-001,2018,8,13,1,59,82,141,226
3404-001,2018,8,13,2,33,51,84,141
3404-001,2018,8,13,3,27,34,61,84
3404-001,2018,8,13,4,41,49,90,61
3404-001,2018,8,13,5,100,70,170,90
3404-001,2018,8,13,6,196,253,449,170
3404-001,2018,8,13,7,414,798,1212,449
3404-001,2018,8,13,8,843,1954,2797,1212
3404-001,2018,8,13,9,954,1327,2281,2797
3404-001,2018,8,13,10,855,866,1721,2281
3404-001,2018,8,13,11,961,833,1794,1721
3404-001,2018,8,13,12,857,847,1704,1794
3404-001,2018,8,13,13,760,759,1519,1704
3404-001,2018,8,13,14,767,834,1601,1519
3404-001,2018,8,13,15,924,839,1763,1601
3404-001,2018,8,13,16,909,924,1833,1763
3404-001,2018,8,13,17,947,729,1676,1833
3404-001,2018,8,13,18,1196,768,1964,1676
3404-001,2018,8,13,19,1166,701,1867,1964
3404-001,2018,8,13,20,795,504,1299,1867
3404-001,2018,8,13,21,688,312,1000,1299
3404-001,2018,8,13,22,376,247,623,1000
3404-001,2018,8,13,23,173,168,341,623
3404-001,2018,8,13,24,132,108,240,341
3404-001,2018,8,14,1,85,81,166,240
3404-001,2018,8,14,2,76,74,150,166
3404-001,2018,8,14,3,58,57,115,150
3404-001,2018,8,14,4,59,75,134,115
3404-001,2018,8,14,5,100,131,231,134
3404-001,2018,8,14,6,206,324,530,231
3404-001,2018,8,14,7,423,775,1198,530
3404-001,2018,8,14,8,828,1779,2607,1198
3404-001,2018,8,14,9,981,1324,2305,2607
3404-001,2018,8,14,10,849,883,1732,2305
3404-001,2018,8,14,11,937,950,1887,1732
3404-001,2018,8,14,12,861,957,1818,1887
3404-001,2018,8,14,13,817,777,1594,1818
3404-001,2018,8,14,14,809,827,1636,1594
3404-001,2018,8,14,15,982,915,1897,1636
3404-001,2018,8,14,16,1075,943,2018,1897
3404-001,2018,8,14,17,1017,857,1874,2018
3404-001,2018,8,14,18,1372,849,2221,1874
3404-001,2018,8,14,19,1394,767,2161,2221
3404-001,2018,8,14,20,856,600,1456,2161
3404-001,2018,8,14,21,677,375,1052,1456
3404-001,2018,8,14,22,372,258,630,1052
3404-001,2018,8,14,23,209,188,397,630
3404-001,2018,8,14,24,139,110,249,397
3404-001,2018,8,15,1,103,78,181,249
3404-001,2018,8,15,2,67,67,134,181
3404-001,2018,8,15,3,49,65,114,134
3404-001,2018,8,15,4,57,52,109,114
3404-001,2018,8,15,5,102,78,180,109
3404-001,2018,8,15,6,156,256,412,180
3404-001,2018,8,15,7,300,447,747,412
3404-001,2018,8,15,8,512,783,1295,747
3404-001,2018,8,15,9,569,752,1321,1295
3404-001,2018,8,15,10,597,615,1212,1321
3404-001,2018,8,15,11,639,600,1239,1212
3404-001,2018,8,15,12,589,551,1140,1239
3404-001,2018,8,15,13,536,534,1070,1140
3404-001,2018,8,15,14,516,488,1004,1070
3404-001,2018,8,15,15,577,528,1105,1004
3404-001,2018,8,15,16,605,518,1123,1105
3404-001,2018,8,15,17,623,416,1039,1123
3404-001,2018,8,15,18,855,483,1338,1039
3404-001,2018,8,15,19,528,484,1012,1338
3404-001,2018,8,15,20,416,411,827,1012
3404-001,2018,8,15,21,343,292,635,827
3404-001,2018,8,15,22,209,234,443,635
3404-001,2018,8,15,23,155,160,315,443
3404-001,2018,8,15,24,97,94,191,315
3404-001,2018,8,16,1,66,54,120,191
3404-001,2018,8,16,2,51,62,113,120
3404-001,2018,8,16,3,39,33,72,113
3404-001,2018,8,16,4,48,52,100,72
3404-001,2018,8,16,5,67,107,174,100
3404-001,2018,8,16,6,194,309,503,174
3404-001,2018,8,16,7,389,736,1125,503
3404-001,2018,8,16,8,793,1817,2610,1125
3404-001,2018,8,16,9,1048,1388,2436,2610
3404-001,2018,8,16,10,873,841,1714,2436
3404-001,2018,8,16,11,913,879,1792,1714
3404-001,2018,8,16,12,893,793,1686,1792
3404-001,2018,8,16,13,784,728,1512,1686
3404-001,2018,8,16,14,846,865,1711,1512
3404-001,2018,8,16,15,912,891,1803,1711
3404-001,2018,8,16,16,979,842,1821,1803
3404-001,2018,8,16,17,864,868,1732,1821
3404-001,2018,8,16,18,1344,805,2149,1732
3404-001,2018,8,16,19,1221,717,1938,2149
3404-001,2018,8,16,20,767,520,1287,1938
3404-001,2018,8,16,21,660,348,1008,1287
3404-001,2018,8,16,22,373,242,615,1008
3404-001,2018,8,16,23,213,168,381,615
3404-001,2018,8,16,24,140,115,255,381
3404-001,2018,8,17,1,117,86,203,255
3404-001,2018,8,17,2,62,59,121,203
3404-001,2018,8,17,3,65,56,121,121
3404-001,2018,8,17,4,67,64,131,121
3404-001,2018,8,17,5,99,110,209,131
3404-001,2018,8,17,6,208,297,505,209
3404-001,2018,8,17,7,369,749,1118,505
3404-001,2018,8,17,8,855,1720,2575,1118
3404-001,2018,8,17,9,1063,1424,2487,2575
3404-001,2018,8,17,10,918,943,1861,2487
3404-001,2018,8,17,11,982,878,1860,1861
3404-001,2018,8,17,12,922,868,1790,1860
3404-001,2018,8,17,13,695,792,1487,1790
3404-001,2018,8,17,14,849,808,1657,1487
3404-001,2018,8,17,15,943,911,1854,1657
3404-001,2018,8,17,16,1028,916,1944,1854
3404-001,2018,8,17,17,1052,866,1918,1944
3404-001,2018,8,17,18,1605,875,2480,1918
3404-001,2018,8,17,19,1479,830,2309,2480
3404-001,2018,8,17,20,968,650,1618,2309
3404-001,2018,8,17,21,697,421,1118,1618
3404-001,2018,8,17,22,339,272,611,1118
3404-001,2018,8,17,23,205,185,390,611
3404-001,2018,8,17,24,146,115,261,390
3404-001,2018,8,18,1,133,86,219,261
3404-001,2018,8,18,2,87,64,151,219
3404-001,2018,8,18,3,67,59,126,151
3404-001,2018,8,18,4,71,45,116,126
3404-001,2018,8,18,5,96,94,190,116
3404-001,2018,8,18,6,159,249,408,190
3404-001,2018,8,18,7,334,406,740,408
3404-001,2018,8,18,8,493,751,1244,740
3404-001,2018,8,18,9,626,725,1351,1244
3404-001,2018,8,18,10,716,674,1390,1351
3404-001,2018,8,18,11,762,653,1415,1390
3404-001,2018,8,18,12,697,708,1405,1415
3404-001,2018,8,18,13,629,609,1238,1405
3404-001,2018,8,18,14,549,593,1142,1238
3404-001,2018,8,18,15,606,590,1196,1142
3404-001,2018,8,18,16,667,568,1235,1196
3404-001,2018,8,18,17,635,566,1201,1235
3404-001,2018,8,18,18,787,572,1359,1201
3404-001,2018,8,18,19,578,485,1063,1359
3404-001,2018,8,18,20,341,428,769,1063
3404-001,2018,8,18,21,295,289,584,769
3404-001,2018,8,18,22,232,202,434,584
3404-001,2018,8,18,23,141,134,275,434
3404-001,2018,8,18,24,125,106,231,275
3404-001,2018,8,19,1,78,88,166,231
3404-001,2018,8,19,2,58,67,125,166
3404-001,2018,8,19,3,39,45,84,125
3404-001,2018,8,19,4,31,40,71,84
3404-001,2018,8,19,5,39,51,90,71
3404-001,2018,8,19,6,64,98,162,90
3404-001,2018,8,19,7,145,183,328,162
3404-001,2018,8,19,8,225,248,473,328
3404-001,2018,8,19,9,305,268,573,473
3404-001,2018,8,19,10,288,298,586,573
3404-001,2018,8,19,11,367,391,758,586
3404-001,2018,8,19,12,389,381,770,758
3404-001,2018,8,19,13,347,395,742,770
3404-001,2018,8,19,14,400,412,812,742
3404-001,2018,8,19,15,564,400,964,812
3404-001,2018,8,19,16,564,430,994,964
3404-001,2018,8,19,17,576,443,1019,994
3404-001,2018,8,19,18,516,408,924,1019
3404-001,2018,8,19,19,427,410,837,924
3404-001,2018,8,19,20,356,341,697,837
3404-001,2018,8,19,21,325,306,631,697
3404-001,2018,8,19,22,198,262,460,631
3404-001,2018,8,19,23,136,196,332,460
3404-001,2018,8,19,24,96,117,213,332
3404-001,2018,8,20,1,52,76,128,213
3404-001,2018,8,20,2,39,43,82,128
3404-001,2018,8,20,3,34,27,61,82
3404-001,2018,8,20,4,38,45,83,61
3404-001,2018,8,20,5,88,101,189,83
3404-001,2018,8,20,6,202,258,460,189
3404-001,2018,8,20,7,462,808,1270,460
3404-001,2018,8,20,8,837,1972,2809,1270
3404-001,2018,8,20,9,978,1376,2354,2809
3404-001,2018,8,20,10,864,882,1746,2354
3404-001,2018,8,20,11,909,856,1765,1746
3404-001,2018,8,20,12,831,882,1713,1765
3404-001,2018,8,20,13,750,771,1521,1713
3404-001,2018,8,20,14,822,864,1686,1521
3404-001,2018,8,20,15,990,921,1911,1686
3404-001,2018,8,20,16,955,871,1826,1911
3404-001,2018,8,20,17,985,732,1717,1826
3404-001,2018,8,20,18,1387,808,2195,1717
3404-001,2018,8,20,19,1236,701,1937,2195
3404-001,2018,8,20,20,778,514,1292,1937
3404-001,2018,8,20,21,672,343,1015,1292
3404-001,2018,8,20,22,375,234,609,1015
3404-001,2018,8,20,23,190,174,364,609
3404-001,2018,8,20,24,139,104,243,364
3404-001,2018,8,21,1,89,76,165,243
3404-001,2018,8,21,2,46,70,116,165
3404-001,2018,8,21,3,43,59,102,116
3404-001,2018,8,21,4,68,51,119,102
3404-001,2018,8,21,5,101,131,232,119
3404-001,2018,8,21,6,241,261,502,232
3404-001,2018,8,21,7,372,747,1119,502
3404-001,2018,8,21,8,855,1825,2680,1119
3404-001,2018,8,21,9,1034,1450,2484,2680
3404-001,2018,8,21,10,885,939,1824,2484
3404-001,2018,8,21,11,917,860,1777,1824
3404-001,2018,8,21,12,884,794,1678,1777
3404-001,2018,8,21,13,735,712,1447,1678
3404-001,2018,8,21,14,814,846,1660,1447
3404-001,2018,8,21,15,926,887,1813,1660
3404-001,2018,8,21,16,985,813,1798,1813
3404-001,2018,8,21,17,907,804,1711,1798
3404-001,2018,8,21,18,1326,782,2108,1711
3404-001,2018,8,21,19,1178,674,1852,2108
3404-001,2018,8,21,20,783,501,1284,1852
3404-001,2018,8,21,21,669,352,1021,1284
3404-001,2018,8,21,22,395,244,639,1021
3404-001,2018,8,21,23,212,198,410,639
3404-001,2018,8,21,24,144,155,299,410
3404-001,2018,8,22,1,88,66,154,299
3404-001,2018,8,22,2,69,55,124,154
3404-001,2018,8,22,3,74,43,117,124
3404-001,2018,8,22,4,53,62,115,117
3404-001,2018,8,22,5,91,116,207,115
3404-001,2018,8,22,6,205,279,484,207
3404-001,2018,8,22,7,401,774,1175,484
3404-001,2018,8,22,8,857,1832,2689,1175
3404-001,2018,8,22,9,1084,1392,2476,2689
3404-001,2018,8,22,10,824,1007,1831,2476
3404-001,2018,8,22,11,917,978,1895,1831
3404-001,2018,8,22,12,867,858,1725,1895
3404-001,2018,8,22,13,779,751,1530,1725
3404-001,2018,8,22,14,818,821,1639,1530
3404-001,2018,8,22,15,957,944,1901,1639
3404-001,2018,8,22,16,966,908,1874,1901
3404-001,2018,8,22,17,996,831,1827,1874
3404-001,2018,8,22,18,1463,820,2283,1827
3404-001,2018,8,22,19,1247,768,2015,2283
3404-001,2018,8,22,20,794,522,1316,2015
3404-001,2018,8,22,21,610,336,946,1316
3404-001,2018,8,22,22,376,289,665,946
3404-001,2018,8,22,23,203,184,387,665
3404-001,2018,8,22,24,169,120,289,387
3404-001,2018,8,23,1,85,87,172,289
3404-001,2018,8,23,2,56,80,136,172
3404-001,2018,8,23,3,60,59,119,136
3404-001,2018,8,23,4,47,47,94,119
3404-001,2018,8,23,5,76,102,178,94
3404-001,2018,8,23,6,176,205,381,178
3404-001,2018,8,23,7,330,607,937,381
3404-001,2018,8,23,8,780,1730,2510,937
3404-001,2018,8,23,9,958,1310,2268,2510
3404-001,2018,8,23,10,844,811,1655,2268
3404-001,2018,8,23,11,777,827,1604,1655
3404-001,2018,8,23,12,764,723,1487,1604
3404-001,2018,8,23,13,620,670,1290,1487
3404-001,2018,8,23,14,756,727,1483,1290
3404-001,2018,8,23,15,873,801,1674,1483
3404-001,2018,8,23,16,816,673,1489,1674
3404-001,2018,8,23,17,703,675,1378,1489
3404-001,2018,8,23,18,1245,641,1886,1378
3404-001,2018,8,23,19,1078,594,1672,1886
3404-001,2018,8,23,20,646,435,1081,1672
3404-001,2018,8,23,21,528,279,807,1081
3404-001,2018,8,23,22,230,175,405,807
3404-001,2018,8,23,23,120,117,237,405
3404-001,2018,8,23,24,94,80,174,237
3404-001,2018,8,24,1,71,60,131,174
3404-001,2018,8,24,2,59,52,111,131
3404-001,2018,8,24,3,40,43,83,111
3404-001,2018,8,24,4,53,42,95,83
3404-001,2018,8,24,5,42,65,107,95
3404-001,2018,8,24,6,111,155,266,107
3404-001,2018,8,24,7,251,484,735,266
3404-001,2018,8,24,8,643,1491,2134,735
3404-001,2018,8,24,9,865,1111,1976,2134
3404-001,2018,8,24,10,664,694,1358,1976
3404-001,2018,8,24,11,737,720,1457,1358
3404-001,2018,8,24,12,670,704,1374,1457
3404-001,2018,8,24,13,607,587,1194,1374
3404-001,2018,8,24,14,674,712,1386,1194
3404-001,2018,8,24,15,806,731,1537,1386
3404-001,2018,8,24,16,823,755,1578,1537
3404-001,2018,8,24,17,879,677,1556,1578
3404-001,2018,8,24,18,1440,734,2174,1556
3404-001,2018,8,24,19,1277,734,2011,2174
3404-001,2018,8,24,20,757,528,1285,2011
3404-001,2018,8,24,21,614,333,947,1285
3404-001,2018,8,24,22,298,272,570,947
3404-001,2018,8,24,23,206,181,387,570
3404-001,2018,8,24,24,145,120,265,387
3404-001,2018,8,25,1,123,92,215,265
3404-001,2018,8,25,2,69,73,142,215
3404-001,2018,8,25,3,53,63,116,142
3404-001,2018,8,25,4,52,41,93,116
3404-001,2018,8,25,5,106,86,192,93
3404-001,2018,8,25,6,172,220,392,192
3404-001,2018,8,25,7,286,395,681,392
3404-001,2018,8,25,8,531,766,1297,681
3404-001,2018,8,25,9,664,688,1352,1297
3404-001,2018,8,25,10,711,713,1424,1352
3404-001,2018,8,25,11,676,728,1404,1424
3404-001,2018,8,25,12,638,676,1314,1404
3404-001,2018,8,25,13,584,626,1210,1314
3404-001,2018,8,25,14,615,580,1195,1210
3404-001,2018,8,25,15,610,595,1205,1195
3404-001,2018,8,25,16,663,577,1240,1205
3404-001,2018,8,25,17,687,547,1234,1240
3404-001,2018,8,25,18,787,534,1321,1234
3404-001,2018,8,25,19,561,460,1021,1321
3404-001,2018,8,25,20,345,333,678,1021
3404-001,2018,8,25,21,306,244,550,678
3404-001,2018,8,25,22,221,203,424,550
3404-001,2018,8,25,23,127,126,253,424
3404-001,2018,8,25,24,96,86,182,253
3404-001,2018,8,26,1,89,54,143,182
3404-001,2018,8,26,2,44,43,87,143
3404-001,2018,8,26,3,43,43,86,87
3404-001,2018,8,26,4,34,41,75,86
3404-001,2018,8,26,5,49,27,76,75
3404-001,2018,8,26,6,62,80,142,76
3404-001,2018,8,26,7,145,188,333,142
3404-001,2018,8,26,8,223,208,431,333
3404-001,2018,8,26,9,250,255,505,431
3404-001,2018,8,26,10,277,289,566,505
3404-001,2018,8,26,11,396,345,741,566
3404-001,2018,8,26,12,390,339,729,741
3404-001,2018,8,26,13,390,324,714,729
3404-001,2018,8,26,14,420,403,823,714
3404-001,2018,8,26,15,452,374,826,823
3404-001,2018,8,26,16,560,368,928,826
3404-001,2018,8,26,17,541,403,944,928
3404-001,2018,8,26,18,533,421,954,944
3404-001,2018,8,26,19,391,399,790,954
3404-001,2018,8,26,20,323,305,628,790
3404-001,2018,8,26,21,265,275,540,628
3404-001,2018,8,26,22,170,229,399,540
3404-001,2018,8,26,23,126,169,295,399
3404-001,2018,8,26,24,84,125,209,295
3404-001,2018,8,27,1,55,65,120,209
3404-001,2018,8,27,2,32,54,86,120
3404-001,2018,8,27,3,30,56,86,86
3404-001,2018,8,27,4,37,34,71,86
3404-001,2018,8,27,5,81,74,155,71
3404-001,2018,8,27,6,175,206,381,155
3404-001,2018,8,27,7,332,589,921,381
3404-001,2018,8,27,8,770,1675,2445,921
3404-001,2018,8,27,9,930,1491,2421,2445
3404-001,2018,8,27,10,776,800,1576,2421
3404-001,2018,8,27,11,839,820,1659,1576
3404-001,2018,8,27,12,801,700,1501,1659
3404-001,2018,8,27,13,726,671,1397,1501
3404-001,2018,8,27,14,719,749,1468,1397
3404-001,2018,8,27,15,862,803,1665,1468
3404-001,2018,8,27,16,878,735,1613,1665
3404-001,2018,8,27,17,849,696,1545,1613
3404-001,2018,8,27,18,1264,765,2029,1545
3404-001,2018,8,27,19,1143,642,1785,2029
3404-001,2018,8,27,20,678,411,1089,1785
3404-001,2018,8,27,21,585,300,885,1089
3404-001,2018,8,27,22,314,215,529,885
3404-001,2018,8,27,23,190,144,334,529
3404-001,2018,8,27,24,125,67,192,334
3404-001,2018,8,28,1,102,82,184,192
3404-001,2018,8,28,2,66,67,133,184
3404-001,2018,8,28,3,47,48,95,133
3404-001,2018,8,28,4,63,65,128,95
3404-001,2018,8,28,5,85,86,171,128
3404-001,2018,8,28,6,154,224,378,171
3404-001,2018,8,28,7,332,582,914,378
3404-001,2018,8,28,8,775,1717,2492,914
3404-001,2018,8,28,9,981,1395,2376,2492
3404-001,2018,8,28,10,766,913,1679,2376
3404-001,2018,8,28,11,805,826,1631,1679
3404-001,2018,8,28,12,770,779,1549,1631
3404-001,2018,8,28,13,680,673,1353,1549
3404-001,2018,8,28,14,814,760,1574,1353
3404-001,2018,8,28,15,866,803,1669,1574
3404-001,2018,8,28,16,914,958,1872,1669
3404-001,2018,8,28,17,870,762,1632,1872
3404-001,2018,8,28,18,1208,695,1903,1632
3404-001,2018,8,28,19,1162,632,1794,1903
3404-001,2018,8,28,20,741,472,1213,1794
3404-001,2018,8,28,21,645,309,954,1213
3404-001,2018,8,28,22,317,221,538,954
3404-001,2018,8,28,23,204,184,388,538
3404-001,2018,8,28,24,144,91,235,388
3404-001,2018,8,29,1,88,94,182,235
3404-001,2018,8,29,2,75,76,151,182
3404-001,2018,8,29,3,50,65,115,151
3404-001,2018,8,29,4,57,43,100,115
3404-001,2018,8,29,5,98,109,207,100
3404-001,2018,8,29,6,169,250,419,207
3404-001,2018,8,29,7,388,648,1036,419
3404-001,2018,8,29,8,787,1810,2597,1036
3404-001,2018,8,29,9,984,1394,2378,2597
3404-001,2018,8,29,10,782,931,1713,2378
3404-001,2018,8,29,11,920,893,1813,1713
3404-001,2018,8,29,12,864,873,1737,1813
3404-001,2018,8,29,13,785,708,1493,1737
3404-001,2018,8,29,14,755,770,1525,1493
3404-001,2018,8,29,15,948,985,1933,1525
3404-001,2018,8,29,16,916,883,1799,1933
3404-001,2018,8,29,17,914,730,1644,1799
3404-001,2018,8,29,18,1587,807,2394,1644
3404-001,2018,8,29,19,1258,685,1943,2394
3404-001,2018,8,29,20,666,431,1097,1943
3404-001,2018,8,29,21,551,304,855,1097
3404-001,2018,8,29,22,295,210,505,855
3404-001,2018,8,29,23,199,158,357,505
3404-001,2018,8,29,24,125,107,232,357
3404-001,2018,8,30,1,102,78,180,232
3404-001,2018,8,30,2,46,43,89,180
3404-001,2018,8,30,3,36,39,75,89
3404-001,2018,8,30,4,59,65,124,75
3404-001,2018,8,30,5,80,98,178,124
3404-001,2018,8,30,6,181,230,411,178
3404-001,2018,8,30,7,366,705,1071,411
3404-001,2018,8,30,8,767,1750,2517,1071
3404-001,2018,8,30,9,1020,1384,2404,2517
3404-001,2018,8,30,10,852,943,1795,2404
3404-001,2018,8,30,11,821,849,1670,1795
3404-001,2018,8,30,12,867,878,1745,1670
3404-001,2018,8,30,13,670,719,1389,1745
3404-001,2018,8,30,14,827,771,1598,1389
3404-001,2018,8,30,15,867,869,1736,1598
3404-001,2018,8,30,16,843,794,1637,1736
3404-001,2018,8,30,17,939,749,1688,1637
3404-001,2018,8,30,18,1180,846,2026,1688
3404-001,2018,8,30,19,1222,684,1906,2026
3404-001,2018,8,30,20,727,474,1201,1906
3404-001,2018,8,30,21,625,305,930,1201
3404-001,2018,8,30,22,297,220,517,930
3404-001,2018,8,30,23,157,145,302,517
3404-001,2018,8,30,24,134,88,222,302
3404-001,2018,8,31,1,103,81,184,222
3404-001,2018,8,31,2,73,49,122,184
3404-001,2018,8,31,3,56,55,111,122
3404-001,2018,8,31,4,61,51,112,111
3404-001,2018,8,31,5,80,109,189,112
3404-001,2018,8,31,6,194,237,431,189
3404-001,2018,8,31,7,362,628,990,431
3404-001,2018,8,31,8,759,1775,2534,990
3404-001,2018,8,31,9,972,1423,2395,2534
3404-001,2018,8,31,10,743,948,1691,2395
3404-001,2018,8,31,11,839,856,1695,1691
3404-001,2018,8,31,12,909,799,1708,1695
3404-001,2018,8,31,13,749,665,1414,1708
3404-001,2018,8,31,14,805,842,1647,1414
3404-001,2018,8,31,15,906,904,1810,1647
3404-001,2018,8,31,16,999,850,1849,1810
3404-001,2018,8,31,17,1028,847,1875,1849
3404-001,2018,8,31,18,1548,862,2410,1875
3404-001,2018,8,31,19,1518,862,2380,2410
3404-001,2018,8,31,20,916,649,1565,2380
3404-001,2018,8,31,21,635,415,1050,1565
3404-001,2018,8,31,22,354,326,680,1050
3404-001,2018,8,31,23,237,193,430,680
3404-001,2018,8,31,24,161,123,284,430
3404-001,2018,9,1,1,132,85,217,284
3404-001,2018,9,1,2,72,53,125,217
3404-001,2018,9,1,3,56,65,121,125
3404-001,2018,9,1,4,74,59,133,121
3404-001,2018,9,1,5,80,92,172,133
3404-001,2018,9,1,6,174,214,388,172
3404-001,2018,9,1,7,344,489,833,388
3404-001,2018,9,1,8,543,740,1283,833
3404-001,2018,9,1,9,719,737,1456,1283
3404-001,2018,9,1,10,720,749,1469,1456
3404-001,2018,9,1,11,677,760,1437,1469
3404-001,2018,9,1,12,760,746,1506,1437
3404-001,2018,9,1,13,651,645,1296,1506
3404-001,2018,9,1,14,686,585,1271,1296
3404-001,2018,9,1,15,643,606,1249,1271
3404-001,2018,9,1,16,700,628,1328,1249
3404-001,2018,9,1,17,703,612,1315,1328
3404-001,2018,9,1,18,845,544,1389,1315
3404-001,2018,9,1,19,628,532,1160,1389
3404-001,2018,9,1,20,452,365,817,1160
3404-001,2018,9,1,21,289,260,549,817
3404-001,2018,9,1,22,186,173,359,549
3404-001,2018,9,1,23,97,109,206,359
3404-001,2018,9,1,24,120,92,212,206
3404-001,2018,9,2,1,96,68,164,212
3404-001,2018,9,2,2,56,41,97,164
3404-001,2018,9,2,3,37,37,74,97
3404-001,2018,9,2,4,43,27,70,74
3404-001,2018,9,2,5,65,64,129,70
3404-001,2018,9,2,6,70,102,172,129
3404-001,2018,9,2,7,164,188,352,172
3404-001,2018,9,2,8,264,309,573,352
3404-001,2018,9,2,9,286,295,581,573
3404-001,2018,9,2,10,349,319,668,581
3404-001,2018,9,2,11,385,376,761,668
3404-001,2018,9,2,12,451,424,875,761
3404-001,2018,9,2,13,412,406,818,875
3404-001,2018,9,2,14,491,447,938,818
3404-001,2018,9,2,15,566,446,1012,938
3404-001,2018,9,2,16,617,478,1095,1012
3404-001,2018,9,2,17,632,491,1123,1095
3404-001,2018,9,2,18,705,465,1170,1123
3404-001,2018,9,2,19,590,421,1011,1170
3404-001,2018,9,2,20,435,346,781,1011
3404-001,2018,9,2,21,370,294,664,781
3404-001,2018,9,2,22,270,262,532,664
3404-001,2018,9,2,23,134,193,327,532
3404-001,2018,9,2,24,99,131,230,327
3404-001,2018,9,3,1,51,81,132,230
3404-001,2018,9,3,2,41,48,89,132
3404-001,2018,9,3,3,40,46,86,89
3404-001,2018,9,3,4,43,47,90,86
3404-001,2018,9,3,5,84,89,173,90
3404-001,2018,9,3,6,199,264,463,173
3404-001,2018,9,3,7,402,755,1157,463
3404-001,2018,9,3,8,938,1904,2842,1157
3404-001,2018,9,3,9,1044,1440,2484,2842
3404-001,2018,9,3,10,870,835,1705,2484
3404-001,2018,9,3,11,861,849,1710,1705
3404-001,2018,9,3,12,826,793,1619,1710
3404-001,2018,9,3,13,757,652,1409,1619
3404-001,2018,9,3,14,865,785,1650,1409
3404-001,2018,9,3,15,921,945,1866,1650
3404-001,2018,9,3,16,916,851,1767,1866
3404-001,2018,9,3,17,1008,751,1759,1767
3404-001,2018,9,3,18,1356,809,2165,1759
3404-001,2018,9,3,19,1237,659,1896,2165
3404-001,2018,9,3,20,818,473,1291,1896
3404-001,2018,9,3,21,634,328,962,1291
3404-001,2018,9,3,22,321,248,569,962
3404-001,2018,9,3,23,177,129,306,569
3404-001,2018,9,3,24,140,81,221,306
3404-001,2018,9,4,1,75,60,135,221
3404-001,2018,9,4,2,48,52,100,135
3404-001,2018,9,4,3,39,49,88,100
3404-001,2018,9,4,4,62,54,116,88
3404-001,2018,9,4,5,60,103,163,116
3404-001,2018,9,4,6,176,265,441,163
3404-001,2018,9,4,7,418,668,1086,441
3404-001,2018,9,4,8,903,1794,2697,1086
3404-001,2018,9,4,9,1098,1427,2525,2697
3404-001,2018,9,4,10,939,883,1822,2525
3404-001,2018,9,4,11,901,893,1794,1822
3404-001,2018,9,4,12,842,808,1650,1794
3404-001,2018,9,4,13,792,694,1486,1650
3404-001,2018,9,4,14,882,794,1676,1486
3404-001,2018,9,4,15,926,940,1866,1676
3404-001,2018,9,4,16,1004,889,1893,1866
3404-001,2018,9,4,17,1043,789,1832,1893
3404-001,2018,9,4,18,1384,843,2227,1832
3404-001,2018,9,4,19,1379,728,2107,2227
3404-001,2018,9,4,20,835,532,1367,2107
3404-001,2018,9,4,21,658,346,1004,1367
3404-001,2018,9,4,22,385,238,623,1004
3404-001,2018,9,4,23,217,190,407,623
3404-001,2018,9,4,24,156,106,262,407
3404-001,2018,9,5,1,119,80,199,262
3404-001,2018,9,5,2,70,61,131,199
3404-001,2018,9,5,3,38,43,81,131
3404-001,2018,9,5,4,76,61,137,81
3404-001,2018,9,5,5,99,102,201,137
3404-001,2018,9,5,6,169,286,455,201
3404-001,2018,9,5,7,427,734,1161,455
3404-001,2018,9,5,8,863,1872,2735,1161
3404-001,2018,9,5,9,1150,1438,2588,2735
3404-001,2018,9,5,10,969,886,1855,2588
3404-001,2018,9,5,11,926,908,1834,1855
3404-001,2018,9,5,12,849,851,1700,1834
3404-001,2018,9,5,13,758,744,1502,1700
3404-001,2018,9,5,14,883,855,1738,1502
3404-001,2018,9,5,15,1056,916,1972,1738
3404-001,2018,9,5,16,1050,848,1898,1972
3404-001,2018,9,5,17,955,780,1735,1898
3404-001,2018,9,5,18,1643,864,2507,1735
3404-001,2018,9,5,19,1372,744,2116,2507
3404-001,2018,9,5,20,840,513,1353,2116
3404-001,2018,9,5,21,580,320,900,1353
3404-001,2018,9,5,22,309,239,548,900
3404-001,2018,9,5,23,207,185,392,548
3404-001,2018,9,5,24,184,126,310,392
3404-001,2018,9,6,1,117,100,217,310
3404-001,2018,9,6,2,64,86,150,217
3404-001,2018,9,6,3,53,56,109,150
3404-001,2018,9,6,4,49,61,110,109
3404-001,2018,9,6,5,106,103,209,110
3404-001,2018,9,6,6,199,265,464,209
3404-001,2018,9,6,7,423,767,1190,464
3404-001,2018,9,6,8,962,1857,2819,1190
3404-001,2018,9,6,9,1102,1418,2520,2819
3404-001,2018,9,6,10,983,937,1920,2520
3404-001,2018,9,6,11,1003,960,1963,1920
3404-001,2018,9,6,12,915,904,1819,1963
3404-001,2018,9,6,13,770,812,1582,1819
3404-001,2018,9,6,14,939,825,1764,1582
3404-001,2018,9,6,15,1074,935,2009,1764
3404-001,2018,9,6,16,1011,944,1955,2009
3404-001,2018,9,6,17,1110,878,1988,1955
3404-001,2018,9,6,18,1466,907,2373,1988
3404-001,2018,9,6,19,1235,761,1996,2373
3404-001,2018,9,6,20,859,479,1338,1996
3404-001,2018,9,6,21,701,340,1041,1338
3404-001,2018,9,6,22,374,260,634,1041
3404-001,2018,9,6,23,178,165,343,634
3404-001,2018,9,6,24,146,96,242,343
3404-001,2018,9,7,1,111,69,180,242
3404-001,2018,9,7,2,56,65,121,180
3404-001,2018,9,7,3,72,55,127,121
3404-001,2018,9,7,4,64,57,121,127
3404-001,2018,9,7,5,92,98,190,121
3404-001,2018,9,7,6,169,268,437,190
3404-001,2018,9,7,7,407,686,1093,437
3404-001,2018,9,7,8,884,1808,2692,1093
3404-001,2018,9,7,9,1110,1409,2519,2692
3404-001,2018,9,7,10,965,946,1911,2519
3404-001,2018,9,7,11,1058,908,1966,1911
3404-001,2018,9,7,12,967,875,1842,1966
3404-001,2018,9,7,13,892,849,1741,1842
3404-001,2018,9,7,14,941,818,1759,1741
3404-001,2018,9,7,15,1132,896,2028,1759
3404-001,2018,9,7,16,1000,938,1938,2028
3404-001,2018,9,7,17,1103,845,1948,1938
3404-001,2018,9,7,18,1697,934,2631,1948
3404-001,2018,9,7,19,1533,876,2409,2631
3404-001,2018,9,7,20,1021,676,1697,2409
3404-001,2018,9,7,21,682,440,1122,1697
3404-001,2018,9,7,22,401,283,684,1122
3404-001,2018,9,7,23,262,185,447,684
3404-001,2018,9,7,24,184,118,302,447
3404-001,2018,9,8,1,120,81,201,302
3404-001,2018,9,8,2,79,75,154,201
3404-001,2018,9,8,3,68,56,124,154
3404-001,2018,9,8,4,70,59,129,124
3404-001,2018,9,8,5,125,87,212,129
3404-001,2018,9,8,6,213,262,475,212
3404-001,2018,9,8,7,339,511,850,475
3404-001,2018,9,8,8,571,857,1428,850
3404-001,2018,9,8,9,749,807,1556,1428
3404-001,2018,9,8,10,757,807,1564,1556
3404-001,2018,9,8,11,727,855,1582,1564
3404-001,2018,9,8,12,629,1043,1672,1582
3404-001,2018,9,8,13,636,737,1373,1672
3404-001,2018,9,8,14,660,733,1393,1373
3404-001,2018,9,8,15,738,708,1446,1393
3404-001,2018,9,8,16,828,703,1531,1446
3404-001,2018,9,8,17,833,634,1467,1531
3404-001,2018,9,8,18,1108,587,1695,1467
3404-001,2018,9,8,19,827,630,1457,1695
3404-001,2018,9,8,20,562,441,1003,1457
3404-001,2018,9,8,21,374,325,699,1003
3404-001,2018,9,8,22,248,223,471,699
3404-001,2018,9,8,23,156,144,300,471
3404-001,2018,9,8,24,127,91,218,300
3404-001,2018,9,9,1,92,78,170,218
3404-001,2018,9,9,2,51,43,94,170
3404-001,2018,9,9,3,37,34,71,94
3404-001,2018,9,9,4,38,50,88,71
3404-001,2018,9,9,5,56,34,90,88
3404-001,2018,9,9,6,80,103,183,90
3404-001,2018,9,9,7,216,225,441,183
3404-001,2018,9,9,8,303,336,639,441
3404-001,2018,9,9,9,374,363,737,639
3404-001,2018,9,9,10,331,388,719,737
3404-001,2018,9,9,11,413,421,834,719
3404-001,2018,9,9,12,412,412,824,834
3404-001,2018,9,9,13,441,431,872,824
3404-001,2018,9,9,14,459,513,972,872
3404-001,2018,9,9,15,567,488,1055,972
3404-001,2018,9,9,16,740,497,1237,1055
3404-001,2018,9,9,17,809,509,1318,1237
3404-001,2018,9,9,18,934,501,1435,1318
3404-001,2018,9,9,19,798,476,1274,1435
3404-001,2018,9,9,20,615,418,1033,1274
3404-001,2018,9,9,21,516,336,852,1033
3404-001,2018,9,9,22,277,241,518,852
3404-001,2018,9,9,23,173,210,383,518
3404-001,2018,9,9,24,96,148,244,383
3404-001,2018,9,10,1,55,95,150,244
3404-001,2018,9,10,2,34,49,83,150
3404-001,2018,9,10,3,27,49,76,83
3404-001,2018,9,10,4,44,49,93,76
3404-001,2018,9,10,5,89,92,181,93
3404-001,2018,9,10,6,207,268,475,181
3404-001,2018,9,10,7,492,796,1288,475
3404-001,2018,9,10,8,954,1929,2883,1288
3404-001,2018,9,10,9,1134,1508,2642,2883
3404-001,2018,9,10,10,977,934,1911,2642
3404-001,2018,9,10,11,933,940,1873,1911
3404-001,2018,9,10,12,991,831,1822,1873
3404-001,2018,9,10,13,827,775,1602,1822
3404-001,2018,9,10,14,962,830,1792,1602
3404-001,2018,9,10,15,971,954,1925,1792
3404-001,2018,9,10,16,1014,882,1896,1925
3404-001,2018,9,10,17,1018,910,1928,1896
3404-001,2018,9,10,18,1490,883,2373,1928
3404-001,2018,9,10,19,1346,769,2115,2373
3404-001,2018,9,10,20,867,542,1409,2115
3404-001,2018,9,10,21,735,366,1101,1409
3404-001,2018,9,10,22,401,259,660,1101
3404-001,2018,9,10,23,201,171,372,660
3404-001,2018,9,10,24,143,103,246,372
3404-001,2018,9,11,1,98,100,198,246
3404-001,2018,9,11,2,86,64,150,198
3404-001,2018,9,11,3,48,46,94,150
3404-001,2018,9,11,4,74,48,122,94
3404-001,2018,9,11,5,92,105,197,122
3404-001,2018,9,11,6,208,292,500,197
3404-001,2018,9,11,7,420,711,1131,500
3404-001,2018,9,11,8,938,1510,2448,1131
3404-001,2018,9,11,9,1167,1176,2343,2448
3404-001,2018,9,11,10,1028,948,1976,2343
3404-001,2018,9,11,11,1008,985,1993,1976
3404-001,2018,9,11,12,971,890,1861,1993
3404-001,2018,9,11,13,900,804,1704,1861
3404-001,2018,9,11,14,978,839,1817,1704
3404-001,2018,9,11,15,1169,1015,2184,1817
3404-001,2018,9,11,16,1171,929,2100,2184
3404-001,2018,9,11,17,1045,849,1894,2100
3404-001,2018,9,11,18,1495,886,2381,1894
3404-001,2018,9,11,19,1357,728,2085,2381
3404-001,2018,9,11,20,864,494,1358,2085
3404-001,2018,9,11,21,698,333,1031,1358
3404-001,2018,9,11,22,423,257,680,1031
3404-001,2018,9,11,23,231,178,409,680
3404-001,2018,9,11,24,129,113,242,409
3404-001,2018,9,12,1,130,94,224,242
3404-001,2018,9,12,2,68,67,135,224
3404-001,2018,9,12,3,58,71,129,135
3404-001,2018,9,12,4,57,52,109,129
3404-001,2018,9,12,5,111,109,220,109
3404-001,2018,9,12,6,214,278,492,220
3404-001,2018,9,12,7,441,737,1178,492
3404-001,2018,9,12,8,935,1811,2746,1178
3404-001,2018,9,12,9,1195,1483,2678,2746
3404-001,2018,9,12,10,1026,1029,2055,2678
3404-001,2018,9,12,11,1076,929,2005,2055
3404-001,2018,9,12,12,952,881,1833,2005
3404-001,2018,9,12,13,849,740,1589,1833
3404-001,2018,9,12,14,985,873,1858,1589
3404-001,2018,9,12,15,1077,942,2019,1858
3404-001,2018,9,12,16,1006,961,1967,2019
3404-001,2018,9,12,17,1111,803,1914,1967
3404-001,2018,9,12,18,1654,882,2536,1914
3404-001,2018,9,12,19,1469,786,2255,2536
3404-001,2018,9,12,20,820,541,1361,2255
3404-001,2018,9,12,21,607,304,911,1361
3404-001,2018,9,12,22,374,263,637,911
3404-001,2018,9,12,23,219,178,397,637
3404-001,2018,9,12,24,150,126,276,397
3404-001,2018,9,13,1,117,102,219,276
3404-001,2018,9,13,2,73,58,131,219
3404-001,2018,9,13,3,50,49,99,131
3404-001,2018,9,13,4,76,53,129,99
3404-001,2018,9,13,5,94,120,214,129
3404-001,2018,9,13,6,213,275,488,214
3404-001,2018,9,13,7,439,705,1144,488
3404-001,2018,9,13,8,951,1878,2829,1144
3404-001,2018,9,13,9,1144,1499,2643,2829
3404-001,2018,9,13,10,1020,929,1949,2643
3404-001,2018,9,13,11,1046,969,2015,1949
3404-001,2018,9,13,12,1077,910,1987,2015
3404-001,2018,9,13,13,1018,753,1771,1987
3404-001,2018,9,13,14,1042,809,1851,1771
3404-001,2018,9,13,15,1206,950,2156,1851
3404-001,2018,9,13,16,1123,926,2049,2156
3404-001,2018,9,13,17,1094,927,2021,2049
3404-001,2018,9,13,18,1509,847,2356,2021
3404-001,2018,9,13,19,1311,816,2127,2356
3404-001,2018,9,13,20,918,580,1498,2127
3404-001,2018,9,13,21,760,397,1157,1498
3404-001,2018,9,13,22,392,288,680,1157
3404-001,2018,9,13,23,238,212,450,680
3404-001,2018,9,13,24,155,116,271,450
3404-001,2018,9,14,1,114,90,204,271
3404-001,2018,9,14,2,73,63,136,204
3404-001,2018,9,14,3,42,79,121,136
3404-001,2018,9,14,4,74,76,150,121
3404-001,2018,9,14,5,92,104,196,150
3404-001,2018,9,14,6,199,281,480,196
3404-001,2018,9,14,7,444,774,1218,480
3404-001,2018,9,14,8,968,1848,2816,1218
3404-001,2018,9,14,9,1204,1489,2693,2816
3404-001,2018,9,14,10,1000,963,1963,2693
3404-001,2018,9,14,11,1063,966,2029,1963
3404-001,2018,9,14,12,977,879,1856,2029
3404-001,2018,9,14,13,843,709,1552,1856
3404-001,2018,9,14,14,856,873,1729,1552
3404-001,2018,9,14,15,1167,923,2090,1729
3404-001,2018,9,14,16,1081,956,2037,2090
3404-001,2018,9,14,17,1098,892,1990,2037
3404-001,2018,9,14,18,1684,890,2574,1990
3404-001,2018,9,14,19,1529,869,2398,2574
3404-001,2018,9,14,20,909,666,1575,2398
3404-001,2018,9,14,21,739,386,1125,1575
3404-001,2018,9,14,22,383,290,673,1125
3404-001,2018,9,14,23,195,197,392,673
3404-001,2018,9,14,24,149,126,275,392
3404-001,2018,9,15,1,120,92,212,275
3404-001,2018,9,15,2,84,68,152,212
3404-001,2018,9,15,3,70,69,139,152
3404-001,2018,9,15,4,62,73,135,139
3404-001,2018,9,15,5,88,104,192,135
3404-001,2018,9,15,6,188,212,400,192
3404-001,2018,9,15,7,292,472,764,400
3404-001,2018,9,15,8,595,796,1391,764
3404-001,2018,9,15,9,813,798,1611,1391
3404-001,2018,9,15,10,709,757,1466,1611
3404-001,2018,9,15,11,721,818,1539,1466
3404-001,2018,9,15,12,743,769,1512,1539
3404-001,2018,9,15,13,691,714,1405,1512
3404-001,2018,9,15,14,659,688,1347,1405
3404-001,2018,9,15,15,645,642,1287,1347
3404-001,2018,9,15,16,692,648,1340,1287
3404-001,2018,9,15,17,881,544,1425,1340
3404-001,2018,9,15,18,1057,575,1632,1425
3404-001,2018,9,15,19,747,540,1287,1632
3404-001,2018,9,15,20,414,389,803,1287
3404-001,2018,9,15,21,353,243,596,803
3404-001,2018,9,15,22,227,177,404,596
3404-001,2018,9,15,23,142,123,265,404
3404-001,2018,9,15,24,104,86,190,265
3404-001,2018,9,16,1,85,66,151,190
3404-001,2018,9,16,2,56,51,107,151
3404-001,2018,9,16,3,29,35,64,107
3404-001,2018,9,16,4,45,43,88,64
3404-001,2018,9,16,5,54,56,110,88
3404-001,2018,9,16,6,94,100,194,110
3404-001,2018,9,16,7,153,197,350,194
3404-001,2018,9,16,8,319,327,646,350
3404-001,2018,9,16,9,361,346,707,646
3404-001,2018,9,16,10,344,320,664,707
3404-001,2018,9,16,11,384,422,806,664
3404-001,2018,9,16,12,434,426,860,806
3404-001,2018,9,16,13,491,410,901,860
3404-001,2018,9,16,14,528,455,983,901
3404-001,2018,9,16,15,638,477,1115,983
3404-001,2018,9,16,16,650,486,1136,1115
3404-001,2018,9,16,17,666,469,1135,1136
3404-001,2018,9,16,18,791,494,1285,1135
3404-001,2018,9,16,19,523,459,982,1285
3404-001,2018,9,16,20,409,374,783,982
3404-001,2018,9,16,21,343,299,642,783
3404-001,2018,9,16,22,211,226,437,642
3404-001,2018,9,16,23,156,184,340,437
3404-001,2018,9,16,24,98,108,206,340
3404-001,2018,9,17,1,63,78,141,206
3404-001,2018,9,17,2,25,52,77,141
3404-001,2018,9,17,3,38,41,79,77
3404-001,2018,9,17,4,61,61,122,79
3404-001,2018,9,17,5,128,82,210,122
3404-001,2018,9,17,6,208,268,476,210
3404-001,2018,9,17,7,457,770,1227,476
3404-001,2018,9,17,8,951,1941,2892,1227
3404-001,2018,9,17,9,1098,1616,2714,2892
3404-001,2018,9,17,10,902,934,1836,2714
3404-001,2018,9,17,11,958,848,1806,1836
3404-001,2018,9,17,12,860,855,1715,1806
3404-001,2018,9,17,13,809,786,1595,1715
3404-001,2018,9,17,14,900,849,1749,1595
3404-001,2018,9,17,15,1011,954,1965,1749
3404-001,2018,9,17,16,1057,960,2017,1965
3404-001,2018,9,17,17,1155,899,2054,2017
3404-001,2018,9,17,18,1405,871,2276,2054
3404-001,2018,9,17,19,1374,732,2106,2276
3404-001,2018,9,17,20,869,569,1438,2106
3404-001,2018,9,17,21,742,356,1098,1438
3404-001,2018,9,17,22,452,295,747,1098
3404-001,2018,9,17,23,224,161,385,747
3404-001,2018,9,17,24,174,112,286,385
3404-001,2018,9,18,1,115,80,195,286
3404-001,2018,9,18,2,71,78,149,195
3404-001,2018,9,18,3,76,67,143,149
3404-001,2018,9,18,4,71,75,146,143
3404-001,2018,9,18,5,115,109,224,146
3404-001,2018,9,18,6,203,291,494,224
3404-001,2018,9,18,7,431,686,1117,494
3404-001,2018,9,18,8,983,1968,2951,1117
3404-001,2018,9,18,9,1122,1572,2694,2951
3404-001,2018,9,18,10,1073,975,2048,2694
3404-001,2018,9,18,11,1055,956,2011,2048
3404-001,2018,9,18,12,920,879,1799,2011
3404-001,2018,9,18,13,836,803,1639,1799
3404-001,2018,9,18,14,974,870,1844,1639
3404-001,2018,9,18,15,1109,1058,2167,1844
3404-001,2018,9,18,16,1062,1007,2069,2167
3404-001,2018,9,18,17,1073,942,2015,2069
3404-001,2018,9,18,18,1540,886,2426,2015
3404-001,2018,9,18,19,1382,754,2136,2426
3404-001,2018,9,18,20,896,563,1459,2136
3404-001,2018,9,18,21,788,358,1146,1459
3404-001,2018,9,18,22,418,279,697,1146
3404-001,2018,9,18,23,239,170,409,697
3404-001,2018,9,18,24,158,133,291,409
3404-001,2018,9,19,1,104,94,198,291
3404-001,2018,9,19,2,80,95,175,198
3404-001,2018,9,19,3,70,65,135,175
3404-001,2018,9,19,4,84,69,153,135
3404-001,2018,9,19,5,87,126,213,153
3404-001,2018,9,19,6,201,292,493,213
3404-001,2018,9,19,7,464,734,1198,493
3404-001,2018,9,19,8,1019,1954,2973,1198
3404-001,2018,9,19,9,1118,1531,2649,2973
3404-001,2018,9,19,10,1061,1008,2069,2649
3404-001,2018,9,19,11,1166,1013,2179,2069
3404-001,2018,9,19,12,1142,995,2137,2179
3404-001,2018,9,19,13,936,839,1775,2137
3404-001,2018,9,19,14,933,850,1783,1775
3404-001,2018,9,19,15,1129,986,2115,1783
3404-001,2018,9,19,16,1038,974,2012,2115
3404-001,2018,9,19,17,1186,850,2036,2012
3404-001,2018,9,19,18,1753,910,2663,2036
3404-001,2018,9,19,19,1495,817,2312,2663
3404-001,2018,9,19,20,856,561,1417,2312
3404-001,2018,9,19,21,653,360,1013,1417
3404-001,2018,9,19,22,413,308,721,1013
3404-001,2018,9,19,23,251,195,446,721
3404-001,2018,9,19,24,216,146,362,446
3404-001,2018,9,20,1,116,119,235,362
3404-001,2018,9,20,2,78,92,170,235
3404-001,2018,9,20,3,68,39,107,170
3404-001,2018,9,20,4,66,72,138,107
3404-001,2018,9,20,5,104,136,240,138
3404-001,2018,9,20,6,191,283,474,240
3404-001,2018,9,20,7,411,633,1044,474
3404-001,2018,9,20,8,951,1721,2672,1044
3404-001,2018,9,20,9,1160,1560,2720,2672
3404-001,2018,9,20,10,982,988,1970,2720
3404-001,2018,9,20,11,963,953,1916,1970
3404-001,2018,9,20,12,980,885,1865,1916
3404-001,2018,9,20,13,913,767,1680,1865
3404-001,2018,9,20,14,974,888,1862,1680
3404-001,2018,9,20,15,1040,946,1986,1862
3404-001,2018,9,20,16,1099,968,2067,1986
3404-001,2018,9,20,17,1104,907,2011,2067
3404-001,2018,9,20,18,1541,853,2394,2011
3404-001,2018,9,20,19,1345,797,2142,2394
3404-001,2018,9,20,20,818,482,1300,2142
3404-001,2018,9,20,21,689,364,1053,1300
3404-001,2018,9,20,22,397,265,662,1053
3404-001,2018,9,20,23,244,170,414,662
3404-001,2018,9,20,24,148,118,266,414
3404-001,2018,9,21,1,121,100,221,266
3404-001,2018,9,21,2,82,92,174,221
3404-001,2018,9,21,3,62,62,124,174
3404-001,2018,9,21,4,67,59,126,124
3404-001,2018,9,21,5,107,88,195,126
3404-001,2018,9,21,6,153,246,399,195
3404-001,2018,9,21,7,372,593,965,399
3404-001,2018,9,21,8,875,1671,2546,965
3404-001,2018,9,21,9,1023,1438,2461,2546
3404-001,2018,9,21,10,872,900,1772,2461
3404-001,2018,9,21,11,963,932,1895,1772
3404-001,2018,9,21,12,954,793,1747,1895
3404-001,2018,9,21,13,928,777,1705,1747
3404-001,2018,9,21,14,1001,807,1808,1705
3404-001,2018,9,21,15,1083,837,1920,1808
3404-001,2018,9,21,16,1266,958,2224,1920
3404-001,2018,9,21,17,1304,901,2205,2224
3404-001,2018,9,21,18,1618,898,2516,2205
3404-001,2018,9,21,19,1110,790,1900,2516
3404-001,2018,9,21,20,684,553,1237,1900
3404-001,2018,9,21,21,567,347,914,1237
3404-001,2018,9,21,22,299,248,547,914
3404-001,2018,9,21,23,211,179,390,547
3404-001,2018,9,21,24,140,109,249,390
3404-001,2018,9,22,1,126,98,224,249
3404-001,2018,9,22,2,95,67,162,224
3404-001,2018,9,22,3,54,58,112,162
3404-001,2018,9,22,4,73,73,146,112
3404-001,2018,9,22,5,122,77,199,146
3404-001,2018,9,22,6,160,180,340,199
3404-001,2018,9,22,7,275,387,662,340
3404-001,2018,9,22,8,551,623,1174,662
3404-001,2018,9,22,9,633,632,1265,1174
3404-001,2018,9,22,10,612,608,1220,1265
3404-001,2018,9,22,11,586,624,1210,1220
3404-001,2018,9,22,12,536,531,1067,1210
3404-001,2018,9,22,13,581,564,1145,1067
3404-001,2018,9,22,14,557,567,1124,1145
3404-001,2018,9,22,15,573,540,1113,1124
3404-001,2018,9,22,16,608,525,1133,1113
3404-001,2018,9,22,17,575,485,1060,1133
3404-001,2018,9,22,18,591,447,1038,1060
3404-001,2018,9,22,19,455,382,837,1038
3404-001,2018,9,22,20,310,315,625,837
3404-001,2018,9,22,21,275,221,496,625
3404-001,2018,9,22,22,203,150,353,496
3404-001,2018,9,22,23,131,97,228,353
3404-001,2018,9,22,24,91,79,170,228
3404-001,2018,9,23,1,90,57,147,170
3404-001,2018,9,23,2,48,42,90,147
3404-001,2018,9,23,3,60,39,99,90
3404-001,2018,9,23,4,41,41,82,99
3404-001,2018,9,23,5,68,33,101,82
3404-001,2018,9,23,6,92,92,184,101
3404-001,2018,9,23,7,117,152,269,184
3404-001,2018,9,23,8,196,227,423,269
3404-001,2018,9,23,9,271,310,581,423
3404-001,2018,9,23,10,273,382,655,581
3404-001,2018,9,23,11,315,447,762,655
3404-001,2018,9,23,12,330,431,761,762
3404-001,2018,9,23,13,359,395,754,761
3404-001,2018,9,23,14,345,412,757,754
3404-001,2018,9,23,15,344,373,717,757
3404-001,2018,9,23,16,356,348,704,717
3404-001,2018,9,23,17,367,321,688,704
3404-001,2018,9,23,18,339,302,641,688
3404-001,2018,9,23,19,272,222,494,641
3404-001,2018,9,23,20,220,206,426,494
3404-001,2018,9,23,21,204,150,354,426
3404-001,2018,9,23,22,129,109,238,354
3404-001,2018,9,23,23,75,66,141,238
3404-001,2018,9,23,24,66,54,120,141
3404-001,2018,9,24,1,38,37,75,120
3404-001,2018,9,24,2,33,26,59,75
3404-001,2018,9,24,3,27,12,39,59
3404-001,2018,9,24,4,21,21,42,39
3404-001,2018,9,24,5,41,20,61,42
3404-001,2018,9,24,6,50,51,101,61
3404-001,2018,9,24,7,129,141,270,101
3404-001,2018,9,24,8,212,251,463,270
3404-001,2018,9,24,9,246,248,494,463
3404-001,2018,9,24,10,295,327,622,494
3404-001,2018,9,24,11,480,594,1074,622
3404-001,2018,9,24,12,695,725,1420,1074
3404-001,2018,9,24,13,874,662,1536,1420
3404-001,2018,9,24,14,1035,672,1707,1536
3404-001,2018,9,24,15,849,709,1558,1707
3404-001,2018,9,24,16,876,713,1589,1558
3404-001,2018,9,24,17,755,625,1380,1589
3404-001,2018,9,24,18,640,609,1249,1380
3404-001,2018,9,24,19,589,478,1067,1249
3404-001,2018,9,24,20,731,377,1108,1067
3404-001,2018,9,24,21,626,242,868,1108
3404-001,2018,9,24,22,368,190,558,868
3404-001,2018,9,24,23,280,145,425,558
3404-001,2018,9,24,24,96,81,177,425
3404-001,2018,9,25,1,71,68,139,177
3404-001,2018,9,25,2,36,60,96,139
3404-001,2018,9,25,3,30,54,84,96
3404-001,2018,9,25,4,20,40,60,84
3404-001,2018,9,25,5,44,28,72,60
3404-001,2018,9,25,6,34,63,97,72
3404-001,2018,9,25,7,80,115,195,97
3404-001,2018,9,25,8,166,173,339,195
3404-001,2018,9,25,9,190,198,388,339
3404-001,2018,9,25,10,265,272,537,388
3404-001,2018,9,25,11,343,395,738,537
3404-001,2018,9,25,12,421,439,860,738
3404-001,2018,9,25,13,446,418,864,860
3404-001,2018,9,25,14,429,380,809,864
3404-001,2018,9,25,15,543,404,947,809
3404-001,2018,9,25,16,572,394,966,947
3404-001,2018,9,25,17,638,420,1058,966
3404-001,2018,9,25,18,696,462,1158,1058
3404-001,2018,9,25,19,683,370,1053,1158
3404-001,2018,9,25,20,677,292,969,1053
3404-001,2018,9,25,21,461,247,708,969
3404-001,2018,9,25,22,441,204,645,708
3404-001,2018,9,25,23,244,124,368,645
3404-001,2018,9,25,24,138,119,257,368
3404-001,2018,9,26,1,76,81,157,257
3404-001,2018,9,26,2,54,64,118,157
3404-001,2018,9,26,3,53,60,113,118
3404-001,2018,9,26,4,42,41,83,113
3404-001,2018,9,26,5,42,51,93,83
3404-001,2018,9,26,6,60,117,177,93
3404-001,2018,9,26,7,120,200,320,177
3404-001,2018,9,26,8,280,354,634,320
3404-001,2018,9,26,9,362,371,733,634
3404-001,2018,9,26,10,408,370,778,733
3404-001,2018,9,26,11,443,440,883,778
3404-001,2018,9,26,12,478,439,917,883
3404-001,2018,9,26,13,482,451,933,917
3404-001,2018,9,26,14,537,455,992,933
3404-001,2018,9,26,15,591,517,1108,992
3404-001,2018,9,26,16,665,479,1144,1108
3404-001,2018,9,26,17,594,443,1037,1144
3404-001,2018,9,26,18,665,424,1089,1037
3404-001,2018,9,26,19,476,414,890,1089
3404-001,2018,9,26,20,374,325,699,890
3404-001,2018,9,26,21,309,271,580,699
3404-001,2018,9,26,22,244,220,464,580
3404-001,2018,9,26,23,130,161,291,464
3404-001,2018,9,26,24,83,98,181,291
3404-001,2018,9,27,1,64,89,153,181
3404-001,2018,9,27,2,38,52,90,153
3404-001,2018,9,27,3,36,43,79,90
3404-001,2018,9,27,4,60,58,118,79
3404-001,2018,9,27,5,76,75,151,118
3404-001,2018,9,27,6,166,262,428,151
3404-001,2018,9,27,7,391,661,1052,428
3404-001,2018,9,27,8,839,1731,2570,1052
3404-001,2018,9,27,9,1044,1350,2394,2570
3404-001,2018,9,27,10,984,850,1834,2394
3404-001,2018,9,27,11,994,849,1843,1834
3404-001,2018,9,27,12,918,788,1706,1843
3404-001,2018,9,27,13,800,676,1476,1706
3404-001,2018,9,27,14,788,753,1541,1476
3404-001,2018,9,27,15,926,926,1852,1541
3404-001,2018,9,27,16,838,864,1702,1852
3404-001,2018,9,27,17,950,798,1748,1702
3404-001,2018,9,27,18,1331,790,2121,1748
3404-001,2018,9,27,19,1227,656,1883,2121
3404-001,2018,9,27,20,761,461,1222,1883
3404-001,2018,9,27,21,623,312,935,1222
3404-001,2018,9,27,22,334,225,559,935
3404-001,2018,9,27,23,193,163,356,559
3404-001,2018,9,27,24,109,120,229,356
3404-001,2018,9,28,1,77,96,173,229
3404-001,2018,9,28,2,76,63,139,173
3404-001,2018,9,28,3,45,53,98,139
3404-001,2018,9,28,4,44,66,110,98
3404-001,2018,9,28,5,108,108,216,110
3404-001,2018,9,28,6,197,279,476,216
3404-001,2018,9,28,7,348,768,1116,476
3404-001,2018,9,28,8,881,1811,2692,1116
3404-001,2018,9,28,9,1073,1419,2492,2692
3404-001,2018,9,28,10,970,984,1954,2492
3404-001,2018,9,28,11,1030,848,1878,1954
3404-001,2018,9,28,12,1048,851,1899,1878
3404-001,2018,9,28,13,877,770,1647,1899
3404-001,2018,9,28,14,934,866,1800,1647
3404-001,2018,9,28,15,1093,906,1999,1800
3404-001,2018,9,28,16,1102,880,1982,1999
3404-001,2018,9,28,17,1117,827,1944,1982
3404-001,2018,9,28,18,1617,855,2472,1944
3404-001,2018,9,28,19,1456,838,2294,2472
3404-001,2018,9,28,20,906,554,1460,2294
3404-001,2018,9,28,21,703,331,1034,1460
3404-001,2018,9,28,22,328,270,598,1034
3404-001,2018,9,28,23,217,168,385,598
3404-001,2018,9,28,24,147,118,265,385
3404-001,2018,9,29,1,117,78,195,265
3404-001,2018,9,29,2,80,65,145,195
3404-001,2018,9,29,3,58,63,121,145
3404-001,2018,9,29,4,64,68,132,121
3404-001,2018,9,29,5,100,117,217,132
3404-001,2018,9,29,6,175,263,438,217
3404-001,2018,9,29,7,319,457,776,438
3404-001,2018,9,29,8,562,886,1448,776
3404-001,2018,9,29,9,792,815,1607,1448
3404-001,2018,9,29,10,720,760,1480,1607
3404-001,2018,9,29,11,729,695,1424,1480
3404-001,2018,9,29,12,692,761,1453,1424
3404-001,2018,9,29,13,658,663,1321,1453
3404-001,2018,9,29,14,661,662,1323,1321
3404-001,2018,9,29,15,754,615,1369,1323
3404-001,2018,9,29,16,695,604,1299,1369
3404-001,2018,9,29,17,767,584,1351,1299
3404-001,2018,9,29,18,993,672,1665,1351
3404-001,2018,9,29,19,743,533,1276,1665
3404-001,2018,9,29,20,430,411,841,1276
3404-001,2018,9,29,21,312,253,565,841
3404-001,2018,9,29,22,236,176,412,565
3404-001,2018,9,29,23,157,143,300,412
3404-001,2018,9,29,24,100,84,184,300
3404-001,2018,9,30,1,70,59,129,184
3404-001,2018,9,30,2,47,43,90,129
3404-001,2018,9,30,3,34,38,72,90
3404-001,2018,9,30,4,42,26,68,72
3404-001,2018,9,30,5,57,53,110,68
3404-001,2018,9,30,6,73,120,193,110
3404-001,2018,9,30,7,129,226,355,193
3404-001,2018,9,30,8,258,326,584,355
3404-001,2018,9,30,9,300,324,624,584
3404-001,2018,9,30,10,362,329,691,624
3404-001,2018,9,30,11,414,436,850,691
3404-001,2018,9,30,12,392,432,824,850
3404-001,2018,9,30,13,412,441,853,824
3404-001,2018,9,30,14,490,429,919,853
3404-001,2018,9,30,15,495,423,918,919
3404-001,2018,9,30,16,637,462,1099,918
3404-001,2018,9,30,17,657,472,1129,1099
3404-001,2018,9,30,18,687,464,1151,1129
3404-001,2018,9,30,19,601,409,1010,1151
3404-001,2018,9,30,20,366,328,694,1010
3404-001,2018,9,30,21,285,285,570,694
3404-001,2018,9,30,22,209,199,408,570
3404-001,2018,9,30,23,136,150,286,408
3404-001,2018,9,30,24,87,117,204,286
3404-001,2018,10,1,1,59,79,138,204
3404-001,2018,10,1,2,51,72,123,138
3404-001,2018,10,1,3,22,54,76,123
3404-001,2018,10,1,4,55,45,100,76
3404-001,2018,10,1,5,82,96,178,100
3404-001,2018,10,1,6,206,310,516,178
3404-001,2018,10,1,7,420,673,1093,516
3404-001,2018,10,1,8,949,1957,2906,1093
3404-001,2018,10,1,9,1090,1653,2743,2906
3404-001,2018,10,1,10,1023,938,1961,2743
3404-001,2018,10,1,11,1017,886,1903,1961
3404-001,2018,10,1,12,875,835,1710,1903
3404-001,2018,10,1,13,820,756,1576,1710
3404-001,2018,10,1,14,904,790,1694,1576
3404-001,2018,10,1,15,970,922,1892,1694
3404-001,2018,10,1,16,955,851,1806,1892
3404-001,2018,10,1,17,1058,798,1856,1806
3404-001,2018,10,1,18,1433,739,2172,1856
3404-001,2018,10,1,19,1330,696,2026,2172
3404-001,2018,10,1,20,883,475,1358,2026
3404-001,2018,10,1,21,680,317,997,1358
3404-001,2018,10,1,22,342,253,595,997
3404-001,2018,10,1,23,221,151,372,595
3404-001,2018,10,1,24,136,125,261,372
3404-001,2018,10,2,1,94,79,173,261
3404-001,2018,10,2,2,61,73,134,173
3404-001,2018,10,2,3,53,53,106,134
3404-001,2018,10,2,4,59,59,118,106
3404-001,2018,10,2,5,91,97,188,118
3404-001,2018,10,2,6,178,270,448,188
3404-001,2018,10,2,7,408,706,1114,448
3404-001,2018,10,2,8,922,1982,2904,1114
3404-001,2018,10,2,9,1177,1531,2708,2904
3404-001,2018,10,2,10,1080,1012,2092,2708
3404-001,2018,10,2,11,1067,924,1991,2092
3404-001,2018,10,2,12,975,854,1829,1991
3404-001,2018,10,2,13,872,825,1697,1829
3404-001,2018,10,2,14,914,937,1851,1697
3404-001,2018,10,2,15,1034,1065,2099,1851
3404-001,2018,10,2,16,1226,1001,2227,2099
3404-001,2018,10,2,17,1167,935,2102,2227
3404-001,2018,10,2,18,1682,988,2670,2102
3404-001,2018,10,2,19,1655,824,2479,2670
3404-001,2018,10,2,20,1022,608,1630,2479
3404-001,2018,10,2,21,767,352,1119,1630
3404-001,2018,10,2,22,351,269,620,1119
3404-001,2018,10,2,23,206,162,368,620
3404-001,2018,10,2,24,137,116,253,368
3404-001,2018,10,3,1,112,80,192,253
3404-001,2018,10,3,2,66,72,138,192
3404-001,2018,10,3,3,43,57,100,138
3404-001,2018,10,3,4,66,48,114,100
3404-001,2018,10,3,5,95,99,194,114
3404-001,2018,10,3,6,143,231,374,194
3404-001,2018,10,3,7,311,487,798,374
3404-001,2018,10,3,8,523,963,1486,798
3404-001,2018,10,3,9,729,813,1542,1486
3404-001,2018,10,3,10,665,743,1408,1542
3404-001,2018,10,3,11,693,738,1431,1408
3404-001,2018,10,3,12,731,688,1419,1431
3404-001,2018,10,3,13,606,548,1154,1419
3404-001,2018,10,3,14,629,545,1174,1154
3404-001,2018,10,3,15,701,589,1290,1174
3404-001,2018,10,3,16,801,610,1411,1290
3404-001,2018,10,3,17,876,558,1434,1411
3404-001,2018,10,3,18,1088,597,1685,1434
3404-001,2018,10,3,19,799,501,1300,1685
3404-001,2018,10,3,20,562,387,949,1300
3404-001,2018,10,3,21,409,262,671,949
3404-001,2018,10,3,22,219,200,419,671
3404-001,2018,10,3,23,148,150,298,419
3404-001,2018,10,3,24,111,105,216,298
3404-001,2018,10,4,1,74,76,150,216
3404-001,2018,10,4,2,44,52,96,150
3404-001,2018,10,4,3,41,43,84,96
3404-001,2018,10,4,4,70,62,132,84
3404-001,2018,10,4,5,90,91,181,132
3404-001,2018,10,4,6,209,287,496,181
3404-001,2018,10,4,7,391,750,1141,496
3404-001,2018,10,4,8,969,2007,2976,1141
3404-001,2018,10,4,9,1202,1566,2768,2976
3404-001,2018,10,4,10,1097,922,2019,2768
3404-001,2018,10,4,11,1049,963,2012,2019
3404-001,2018,10,4,12,1006,886,1892,2012
3404-001,2018,10,4,13,849,811,1660,1892
3404-001,2018,10,4,14,953,850,1803,1660
3404-001,2018,10,4,15,1068,1097,2165,1803
3404-001,2018,10,4,16,1068,969,2037,2165
3404-001,2018,10,4,17,1116,911,2027,2037
3404-001,2018,10,4,18,1510,918,2428,2027
3404-001,2018,10,4,19,1444,820,2264,2428
3404-001,2018,10,4,20,940,572,1512,2264
3404-001,2018,10,4,21,698,393,1091,1512
3404-001,2018,10,4,22,394,276,670,1091
3404-001,2018,10,4,23,252,190,442,670
3404-001,2018,10,4,24,187,128,315,442
3404-001,2018,10,5,1,108,116,224,315
3404-001,2018,10,5,2,85,77,162,224
3404-001,2018,10,5,3,43,52,95,162
3404-001,2018,10,5,4,69,98,167,95
3404-001,2018,10,5,5,125,101,226,167
3404-001,2018,10,5,6,213,246,459,226
3404-001,2018,10,5,7,372,631,1003,459
3404-001,2018,10,5,8,829,1780,2609,1003
3404-001,2018,10,5,9,1085,1489,2574,2609
3404-001,2018,10,5,10,838,863,1701,2574
3404-001,2018,10,5,11,865,851,1716,1701
3404-001,2018,10,5,12,946,739,1685,1716
3404-001,2018,10,5,13,815,711,1526,1685
3404-001,2018,10,5,14,887,803,1690,1526
3404-001,2018,10,5,15,917,872,1789,1690
3404-001,2018,10,5,16,1047,799,1846,1789
3404-001,2018,10,5,17,1012,804,1816,1846
3404-001,2018,10,5,18,1579,798,2377,1816
3404-001,2018,10,5,19,1490,815,2305,2377
3404-001,2018,10,5,20,853,627,1480,2305
3404-001,2018,10,5,21,671,368,1039,1480
3404-001,2018,10,5,22,313,246,559,1039
3404-001,2018,10,5,23,184,143,327,559
3404-001,2018,10,5,24,126,97,223,327
3404-001,2018,10,6,1,95,80,175,223
3404-001,2018,10,6,2,63,51,114,175
3404-001,2018,10,6,3,46,64,110,114
3404-001,2018,10,6,4,47,45,92,110
3404-001,2018,10,6,5,62,66,128,92
3404-001,2018,10,6,6,107,158,265,128
3404-001,2018,10,6,7,219,254,473,265
3404-001,2018,10,6,8,430,602,1032,473
3404-001,2018,10,6,9,654,578,1232,1032
3404-001,2018,10,6,10,656,555,1211,1232
3404-001,2018,10,6,11,605,609,1214,1211
3404-001,2018,10,6,12,632,553,1185,1214
3404-001,2018,10,6,13,567,563,1130,1185
3404-001,2018,10,6,14,586,607,1193,1130
3404-001,2018,10,6,15,586,592,1178,1193
3404-001,2018,10,6,16,612,560,1172,1178
3404-001,2018,10,6,17,642,556,1198,1172
3404-001,2018,10,6,18,817,515,1332,1198
3404-001,2018,10,6,19,472,446,918,1332
3404-001,2018,10,6,20,331,305,636,918
3404-001,2018,10,6,21,246,212,458,636
3404-001,2018,10,6,22,166,150,316,458
3404-001,2018,10,6,23,121,125,246,316
3404-001,2018,10,6,24,96,92,188,246
3404-001,2018,10,7,1,78,74,152,188
3404-001,2018,10,7,2,44,40,84,152
3404-001,2018,10,7,3,34,39,73,84
3404-001,2018,10,7,4,41,36,77,73
3404-001,2018,10,7,5,43,40,83,77
3404-001,2018,10,7,6,80,102,182,83
3404-001,2018,10,7,7,120,194,314,182
3404-001,2018,10,7,8,276,293,569,314
3404-001,2018,10,7,9,385,297,682,569
3404-001,2018,10,7,10,351,335,686,682
3404-001,2018,10,7,11,418,418,836,686
3404-001,2018,10,7,12,404,434,838,836
3404-001,2018,10,7,13,418,443,861,838
3404-001,2018,10,7,14,429,501,930,861
3404-001,2018,10,7,15,537,470,1007,930
3404-001,2018,10,7,16,627,470,1097,1007
3404-001,2018,10,7,17,617,483,1100,1097
3404-001,2018,10,7,18,685,477,1162,1100
3404-001,2018,10,7,19,522,448,970,1162
3404-001,2018,10,7,20,383,356,739,970
3404-001,2018,10,7,21,295,291,586,739
3404-001,2018,10,7,22,192,228,420,586
3404-001,2018,10,7,23,121,162,283,420
3404-001,2018,10,7,24,82,102,184,283
3404-001,2018,10,8,1,58,61,119,184
3404-001,2018,10,8,2,32,48,80,119
3404-001,2018,10,8,3,48,33,81,80
3404-001,2018,10,8,4,44,58,102,81
3404-001,2018,10,8,5,83,113,196,102
3404-001,2018,10,8,6,212,277,489,196
3404-001,2018,10,8,7,449,725,1174,489
3404-001,2018,10,8,8,895,1826,2721,1174
3404-001,2018,10,8,9,1069,1364,2433,2721
3404-001,2018,10,8,10,937,935,1872,2433
3404-001,2018,10,8,11,958,941,1899,1872
3404-001,2018,10,8,12,1006,897,1903,1899
3404-001,2018,10,8,13,931,815,1746,1903
3404-001,2018,10,8,14,879,867,1746,1746
3404-001,2018,10,8,15,1059,879,1938,1746
3404-001,2018,10,8,16,1036,959,1995,1938
3404-001,2018,10,8,17,1066,911,1977,1995
3404-001,2018,10,8,18,1506,904,2410,1977
3404-001,2018,10,8,19,1410,845,2255,2410
3404-001,2018,10,8,20,917,602,1519,2255
3404-001,2018,10,8,21,690,370,1060,1519
3404-001,2018,10,8,22,357,296,653,1060
3404-001,2018,10,8,23,188,172,360,653
3404-001,2018,10,8,24,126,128,254,360
3404-001,2018,10,9,1,122,83,205,254
3404-001,2018,10,9,2,79,51,130,205
3404-001,2018,10,9,3,43,47,90,130
3404-001,2018,10,9,4,66,67,133,90
3404-001,2018,10,9,5,87,105,192,133
3404-001,2018,10,9,6,163,275,438,192
3404-001,2018,10,9,7,315,492,807,438
3404-001,2018,10,9,8,518,963,1481,807
3404-001,2018,10,9,9,630,787,1417,1481
3404-001,2018,10,9,10,590,675,1265,1417
3404-001,2018,10,9,11,654,677,1331,1265
3404-001,2018,10,9,12,598,629,1227,1331
3404-001,2018,10,9,13,630,616,1246,1227
3404-001,2018,10,9,14,731,587,1318,1246
3404-001,2018,10,9,15,711,612,1323,1318
3404-001,2018,10,9,16,835,607,1442,1323
3404-001,2018,10,9,17,847,521,1368,1442
3404-001,2018,10,9,18,1163,613,1776,1368
3404-001,2018,10,9,19,797,503,1300,1776
3404-001,2018,10,9,20,477,421,898,1300
3404-001,2018,10,9,21,397,272,669,898
3404-001,2018,10,9,22,178,216,394,669
3404-001,2018,10,9,23,110,144,254,394
3404-001,2018,10,9,24,99,92,191,254
3404-001,2018,10,10,1,62,75,137,191
3404-001,2018,10,10,2,51,45,96,137
3404-001,2018,10,10,3,40,46,86,96
3404-001,2018,10,10,4,45,61,106,86
3404-001,2018,10,10,5,106,83,189,106
3404-001,2018,10,10,6,218,298,516,189
3404-001,2018,10,10,7,428,717,1145,516
3404-001,2018,10,10,8,893,1961,2854,1145
3404-001,2018,10,10,9,1127,1500,2627,2854
3404-001,2018,10,10,10,1017,1024,2041,2627
3404-001,2018,10,10,11,1000,1106,2106,2041
3404-001,2018,10,10,12,964,1032,1996,2106
3404-001,2018,10,10,13,862,864,1726,1996
3404-001,2018,10,10,14,984,929,1913,1726
3404-001,2018,10,10,15,1141,988,2129,1913
3404-001,2018,10,10,16,1096,1001,2097,2129
3404-001,2018,10,10,17,1096,957,2053,2097
3404-001,2018,10,10,18,1687,892,2579,2053
3404-001,2018,10,10,19,1396,798,2194,2579
3404-001,2018,10,10,20,837,564,1401,2194
3404-001,2018,10,10,21,572,374,946,1401
3404-001,2018,10,10,22,347,215,562,946
3404-001,2018,10,10,23,205,195,400,562
3404-001,2018,10,10,24,148,101,249,400
3404-001,2018,10,11,1,95,102,197,249
3404-001,2018,10,11,2,74,80,154,197
3404-001,2018,10,11,3,53,52,105,154
3404-001,2018,10,11,4,68,66,134,105
3404-001,2018,10,11,5,86,140,226,134
3404-001,2018,10,11,6,237,312,549,226
3404-001,2018,10,11,7,441,736,1177,549
3404-001,2018,10,11,8,919,1989,2908,1177
3404-001,2018,10,11,9,1162,1550,2712,2908
3404-001,2018,10,11,10,1030,1084,2114,2712
3404-001,2018,10,11,11,1063,1108,2171,2114
3404-001,2018,10,11,12,1124,990,2114,2171
3404-001,2018,10,11,13,884,935,1819,2114
3404-001,2018,10,11,14,951,969,1920,1819
3404-001,2018,10,11,15,1165,1074,2239,1920
3404-001,2018,10,11,16,1125,1017,2142,2239
3404-001,2018,10,11,17,1127,1003,2130,2142
3404-001,2018,10,11,18,1509,953,2462,2130
3404-001,2018,10,11,19,1307,791,2098,2462
3404-001,2018,10,11,20,903,527,1430,2098
3404-001,2018,10,11,21,677,350,1027,1430
3404-001,2018,10,11,22,363,288,651,1027
3404-001,2018,10,11,23,190,188,378,651
3404-001,2018,10,11,24,144,128,272,378
3404-001,2018,10,12,1,95,103,198,272
3404-001,2018,10,12,2,58,54,112,198
3404-001,2018,10,12,3,47,63,110,112
3404-001,2018,10,12,4,63,90,153,110
3404-001,2018,10,12,5,92,104,196,153
3404-001,2018,10,12,6,201,292,493,196
3404-001,2018,10,12,7,428,748,1176,493
3404-001,2018,10,12,8,885,1912,2797,1176
3404-001,2018,10,12,9,1187,1608,2795,2797
3404-001,2018,10,12,10,1033,1115,2148,2795
3404-001,2018,10,12,11,1204,1075,2279,2148
3404-001,2018,10,12,12,1024,984,2008,2279
3404-001,2018,10,12,13,923,915,1838,2008
3404-001,2018,10,12,14,1027,971,1998,1838
3404-001,2018,10,12,15,1224,1158,2382,1998
3404-001,2018,10,12,16,1172,1074,2246,2382
3404-001,2018,10,12,17,1196,1003,2199,2246
3404-001,2018,10,12,18,1801,1039,2840,2199
3404-001,2018,10,12,19,1642,929,2571,2840
3404-001,2018,10,12,20,953,717,1670,2571
3404-001,2018,10,12,21,689,398,1087,1670
3404-001,2018,10,12,22,340,292,632,1087
3404-001,2018,10,12,23,205,195,400,632
3404-001,2018,10,12,24,150,124,274,400
3404-001,2018,10,13,1,116,93,209,274
3404-001,2018,10,13,2,72,79,151,209
3404-001,2018,10,13,3,58,79,137,151
3404-001,2018,10,13,4,71,59,130,137
3404-001,2018,10,13,5,99,112,211,130
3404-001,2018,10,13,6,177,281,458,211
3404-001,2018,10,13,7,329,506,835,458
3404-001,2018,10,13,8,657,860,1517,835
3404-001,2018,10,13,9,949,897,1846,1517
3404-001,2018,10,13,10,804,1015,1819,1846
3404-001,2018,10,13,11,736,987,1723,1819
3404-001,2018,10,13,12,721,903,1624,1723
3404-001,2018,10,13,13,714,847,1561,1624
3404-001,2018,10,13,14,730,797,1527,1561
3404-001,2018,10,13,15,752,902,1654,1527
3404-001,2018,10,13,16,793,815,1608,1654
3404-001,2018,10,13,17,904,713,1617,1608
3404-001,2018,10,13,18,1030,673,1703,1617
3404-001,2018,10,13,19,782,537,1319,1703
3404-001,2018,10,13,20,465,458,923,1319
3404-001,2018,10,13,21,288,254,542,923
3404-001,2018,10,13,22,215,189,404,542
3404-001,2018,10,13,23,131,133,264,404
3404-001,2018,10,13,24,115,100,215,264
3404-001,2018,10,14,1,68,85,153,215
3404-001,2018,10,14,2,53,44,97,153
3404-001,2018,10,14,3,28,39,67,97
3404-001,2018,10,14,4,32,41,73,67
3404-001,2018,10,14,5,62,54,116,73
3404-001,2018,10,14,6,58,125,183,116
3404-001,2018,10,14,7,121,236,357,183
3404-001,2018,10,14,8,232,290,522,357
3404-001,2018,10,14,9,304,323,627,522
3404-001,2018,10,14,10,341,356,697,627
3404-001,2018,10,14,11,430,462,892,697
3404-001,2018,10,14,12,396,494,890,892
3404-001,2018,10,14,13,409,469,878,890
3404-001,2018,10,14,14,443,518,961,878
3404-001,2018,10,14,15,547,529,1076,961
3404-001,2018,10,14,16,684,569,1253,1076
3404-001,2018,10,14,17,761,529,1290,1253
3404-001,2018,10,14,18,793,482,1275,1290
3404-001,2018,10,14,19,705,472,1177,1275
3404-001,2018,10,14,20,473,394,867,1177
3404-001,2018,10,14,21,356,319,675,867
3404-001,2018,10,14,22,225,224,449,675
3404-001,2018,10,14,23,141,197,338,449
3404-001,2018,10,14,24,77,125,202,338
3404-001,2018,10,15,1,56,73,129,202
3404-001,2018,10,15,2,32,42,74,129
3404-001,2018,10,15,3,44,70,114,74
3404-001,2018,10,15,4,49,54,103,114
3404-001,2018,10,15,5,90,150,240,103
3404-001,2018,10,15,6,215,312,527,240
3404-001,2018,10,15,7,442,808,1250,527
3404-001,2018,10,15,8,928,2102,3030,1250
3404-001,2018,10,15,9,1106,1644,2750,3030
3404-001,2018,10,15,10,1022,1109,2131,2750
3404-001,2018,10,15,11,1063,1045,2108,2131
3404-001,2018,10,15,12,1052,988,2040,2108
3404-001,2018,10,15,13,994,869,1863,2040
3404-001,2018,10,15,14,940,1050,1990,1863
3404-001,2018,10,15,15,1033,1025,2058,1990
3404-001,2018,10,15,16,1088,1023,2111,2058
3404-001,2018,10,15,17,1111,924,2035,2111
3404-001,2018,10,15,18,1501,879,2380,2035
3404-001,2018,10,15,19,1405,787,2192,2380
3404-001,2018,10,15,20,773,549,1322,2192
3404-001,2018,10,15,21,701,388,1089,1322
3404-001,2018,10,15,22,373,269,642,1089
3404-001,2018,10,15,23,197,180,377,642
3404-001,2018,10,15,24,134,104,238,377
3404-001,2018,10,16,1,83,107,190,238
3404-001,2018,10,16,2,52,84,136,190
3404-001,2018,10,16,3,39,75,114,136
3404-001,2018,10,16,4,55,59,114,114
3404-001,2018,10,16,5,86,122,208,114
3404-001,2018,10,16,6,196,291,487,208
3404-001,2018,10,16,7,376,677,1053,487
3404-001,2018,10,16,8,925,1891,2816,1053
3404-001,2018,10,16,9,1073,1650,2723,2816
3404-001,2018,10,16,10,940,1056,1996,2723
3404-001,2018,10,16,11,1021,1023,2044,1996
3404-001,2018,10,16,12,1027,923,1950,2044
3404-001,2018,10,16,13,956,820,1776,1950
3404-001,2018,10,16,14,973,903,1876,1776
3404-001,2018,10,16,15,1101,1055,2156,1876
3404-001,2018,10,16,16,1173,1045,2218,2156
3404-001,2018,10,16,17,1134,939,2073,2218
3404-001,2018,10,16,18,1514,914,2428,2073
3404-001,2018,10,16,19,1351,787,2138,2428
3404-001,2018,10,16,20,864,480,1344,2138
3404-001,2018,10,16,21,649,345,994,1344
3404-001,2018,10,16,22,343,277,620,994
3404-001,2018,10,16,23,220,172,392,620
3404-001,2018,10,16,24,151,144,295,392
3404-001,2018,10,17,1,125,113,238,295
3404-001,2018,10,17,2,61,87,148,238
3404-001,2018,10,17,3,58,66,124,148
3404-001,2018,10,17,4,58,74,132,124
3404-001,2018,10,17,5,82,117,199,132
3404-001,2018,10,17,6,199,326,525,199
3404-001,2018,10,17,7,422,801,1223,525
3404-001,2018,10,17,8,927,1885,2812,1223
3404-001,2018,10,17,9,1118,1621,2739,2812
3404-001,2018,10,17,10,1008,1117,2125,2739
3404-001,2018,10,17,11,1058,1069,2127,2125
3404-001,2018,10,17,12,1003,901,1904,2127
3404-001,2018,10,17,13,916,883,1799,1904
3404-001,2018,10,17,14,965,1006,1971,1799
3404-001,2018,10,17,15,1143,985,2128,1971
3404-001,2018,10,17,16,1107,1073,2180,2128
3404-001,2018,10,17,17,1186,981,2167,2180
3404-001,2018,10,17,18,1764,963,2727,2167
3404-001,2018,10,17,19,1484,803,2287,2727
3404-001,2018,10,17,20,810,529,1339,2287
3404-001,2018,10,17,21,616,309,925,1339
3404-001,2018,10,17,22,377,255,632,925
3404-001,2018,10,17,23,202,215,417,632
3404-001,2018,10,17,24,143,115,258,417
3404-001,2018,10,18,1,89,131,220,258
3404-001,2018,10,18,2,76,76,152,220
3404-001,2018,10,18,3,63,49,112,152
3404-001,2018,10,18,4,58,70,128,112
3404-001,2018,10,18,5,90,134,224,128
3404-001,2018,10,18,6,208,321,529,224
3404-001,2018,10,18,7,379,769,1148,529
3404-001,2018,10,18,8,924,1893,2817,1148
3404-001,2018,10,18,9,1137,1666,2803,2817
3404-001,2018,10,18,10,979,1086,2065,2803
3404-001,2018,10,18,11,1078,1079,2157,2065
3404-001,2018,10,18,12,1145,925,2070,2157
3404-001,2018,10,18,13,1014,852,1866,2070
3404-001,2018,10,18,14,1040,917,1957,1866
3404-001,2018,10,18,15,1113,1007,2120,1957
3404-001,2018,10,18,16,1125,981,2106,2120
3404-001,2018,10,18,17,1095,944,2039,2106
3404-001,2018,10,18,18,1605,1033,2638,2039
3404-001,2018,10,18,19,1426,730,2156,2638
3404-001,2018,10,18,20,880,526,1406,2156
3404-001,2018,10,18,21,693,332,1025,1406
3404-001,2018,10,18,22,327,240,567,1025
3404-001,2018,10,18,23,188,169,357,567
3404-001,2018,10,18,24,132,118,250,357
3404-001,2018,10,19,1,109,89,198,250
3404-001,2018,10,19,2,75,72,147,198
3404-001,2018,10,19,3,89,66,155,147
3404-001,2018,10,19,4,48,81,129,155
3404-001,2018,10,19,5,84,138,222,129
3404-001,2018,10,19,6,195,365,560,222
3404-001,2018,10,19,7,419,790,1209,560
3404-001,2018,10,19,8,895,1915,2810,1209
3404-001,2018,10,19,9,1108,1661,2769,2810
3404-001,2018,10,19,10,1009,1075,2084,2769
3404-001,2018,10,19,11,1171,1126,2297,2084
3404-001,2018,10,19,12,1171,966,2137,2297
3404-001,2018,10,19,13,1066,922,1988,2137
3404-001,2018,10,19,14,1006,972,1978,1988
3404-001,2018,10,19,15,1223,1145,2368,1978
3404-001,2018,10,19,16,1282,1096,2378,2368
3404-001,2018,10,19,17,1295,945,2240,2378
3404-001,2018,10,19,18,1802,987,2789,2240
3404-001,2018,10,19,19,1600,891,2491,2789
3404-001,2018,10,19,20,1012,640,1652,2491
3404-001,2018,10,19,21,688,462,1150,1652
3404-001,2018,10,19,22,344,274,618,1150
3404-001,2018,10,19,23,205,166,371,618
3404-001,2018,10,19,24,138,136,274,371
3404-001,2018,10,20,1,111,101,212,274
3404-001,2018,10,20,2,65,74,139,212
3404-001,2018,10,20,3,67,71,138,139
3404-001,2018,10,20,4,56,87,143,138
3404-001,2018,10,20,5,80,114,194,143
3404-001,2018,10,20,6,172,236,408,194
3404-001,2018,10,20,7,283,475,758,408
3404-001,2018,10,20,8,652,806,1458,758
3404-001,2018,10,20,9,769,854,1623,1458
3404-001,2018,10,20,10,745,880,1625,1623
3404-001,2018,10,20,11,788,982,1770,1625
3404-001,2018,10,20,12,730,914,1644,1770
3404-001,2018,10,20,13,739,777,1516,1644
3404-001,2018,10,20,14,618,774,1392,1516
3404-001,2018,10,20,15,699,712,1411,1392
3404-001,2018,10,20,16,835,696,1531,1411
3404-001,2018,10,20,17,851,671,1522,1531
3404-001,2018,10,20,18,1064,683,1747,1522
3404-001,2018,10,20,19,754,564,1318,1747
3404-001,2018,10,20,20,466,416,882,1318
3404-001,2018,10,20,21,347,299,646,882
3404-001,2018,10,20,22,221,201,422,646
3404-001,2018,10,20,23,125,115,240,422
3404-001,2018,10,20,24,117,92,209,240
3404-001,2018,10,21,1,76,81,157,209
3404-001,2018,10,21,2,58,49,107,157
3404-001,2018,10,21,3,33,39,72,107
3404-001,2018,10,21,4,32,51,83,72
3404-001,2018,10,21,5,47,74,121,83
3404-001,2018,10,21,6,78,111,189,121
3404-001,2018,10,21,7,133,208,341,189
3404-001,2018,10,21,8,244,318,562,341
3404-001,2018,10,21,9,356,350,706,562
3404-001,2018,10,21,10,357,420,777,706
3404-001,2018,10,21,11,396,485,881,777
3404-001,2018,10,21,12,419,490,909,881
3404-001,2018,10,21,13,432,441,873,909
3404-001,2018,10,21,14,513,522,1035,873
3404-001,2018,10,21,15,586,493,1079,1035
3404-001,2018,10,21,16,708,568,1276,1079
3404-001,2018,10,21,17,719,476,1195,1276
3404-001,2018,10,21,18,780,485,1265,1195
3404-001,2018,10,21,19,738,385,1123,1265
3404-001,2018,10,21,20,493,345,838,1123
3404-001,2018,10,21,21,370,306,676,838
3404-001,2018,10,21,22,208,316,524,676
3404-001,2018,10,21,23,134,305,439,524
3404-001,2018,10,21,24,94,144,238,439
3404-001,2018,10,22,1,53,86,139,238
3404-001,2018,10,22,2,26,65,91,139
3404-001,2018,10,22,3,36,42,78,91
3404-001,2018,10,22,4,40,58,98,78
3404-001,2018,10,22,5,99,131,230,98
3404-001,2018,10,22,6,173,369,542,230
3404-001,2018,10,22,7,442,865,1307,542
3404-001,2018,10,22,8,942,2088,3030,1307
3404-001,2018,10,22,9,1044,1635,2679,3030
3404-001,2018,10,22,10,935,1054,1989,2679
3404-001,2018,10,22,11,990,993,1983,1989
3404-001,2018,10,22,12,980,977,1957,1983
3404-001,2018,10,22,13,977,830,1807,1957
3404-001,2018,10,22,14,952,957,1909,1807
3404-001,2018,10,22,15,1193,974,2167,1909
3404-001,2018,10,22,16,1198,1004,2202,2167
3404-001,2018,10,22,17,1088,918,2006,2202
3404-001,2018,10,22,18,1504,892,2396,2006
3404-001,2018,10,22,19,1301,720,2021,2396
3404-001,2018,10,22,20,785,508,1293,2021
3404-001,2018,10,22,21,696,379,1075,1293
3404-001,2018,10,22,22,321,222,543,1075
3404-001,2018,10,22,23,217,172,389,543
3404-001,2018,10,22,24,138,105,243,389
3404-001,2018,10,23,1,99,131,230,243
3404-001,2018,10,23,2,63,86,149,230
3404-001,2018,10,23,3,80,60,140,149
3404-001,2018,10,23,4,61,72,133,140
3404-001,2018,10,23,5,109,95,204,133
3404-001,2018,10,23,6,214,333,547,204
3404-001,2018,10,23,7,394,741,1135,547
3404-001,2018,10,23,8,940,2050,2990,1135
3404-001,2018,10,23,9,1085,1673,2758,2990
3404-001,2018,10,23,10,1027,1111,2138,2758
3404-001,2018,10,23,11,1104,1041,2145,2138
3404-001,2018,10,23,12,1008,953,1961,2145
3404-001,2018,10,23,13,871,879,1750,1961
3404-001,2018,10,23,14,926,977,1903,1750
3404-001,2018,10,23,15,1046,1052,2098,1903
3404-001,2018,10,23,16,1070,950,2020,2098
3404-001,2018,10,23,17,981,909,1890,2020
3404-001,2018,10,23,18,1536,869,2405,1890
3404-001,2018,10,23,19,1346,690,2036,2405
3404-001,2018,10,23,20,786,496,1282,2036
3404-001,2018,10,23,21,666,312,978,1282
3404-001,2018,10,23,22,345,246,591,978
3404-001,2018,10,23,23,184,184,368,591
3404-001,2018,10,23,24,133,129,262,368
3404-001,2018,10,24,1,109,95,204,262
3404-001,2018,10,24,2,51,82,133,204
3404-001,2018,10,24,3,51,45,96,133
3404-001,2018,10,24,4,58,79,137,96
3404-001,2018,10,24,5,102,114,216,137
3404-001,2018,10,24,6,214,284,498,216
3404-001,2018,10,24,7,446,728,1174,498
3404-001,2018,10,24,8,914,1886,2800,1174
3404-001,2018,10,24,9,1152,1620,2772,2800
3404-001,2018,10,24,10,1115,995,2110,2772
3404-001,2018,10,24,11,1145,1026,2171,2110
3404-001,2018,10,24,12,976,998,1974,2171
3404-001,2018,10,24,13,907,847,1754,1974
3404-001,2018,10,24,14,933,970,1903,1754
3404-001,2018,10,24,15,1115,1082,2197,1903
3404-001,2018,10,24,16,1080,960,2040,2197
3404-001,2018,10,24,17,1089,935,2024,2040
3404-001,2018,10,24,18,1710,861,2571,2024
3404-001,2018,10,24,19,1452,740,2192,2571
3404-001,2018,10,24,20,775,498,1273,2192
3404-001,2018,10,24,21,587,330,917,1273
3404-001,2018,10,24,22,349,230,579,917
3404-001,2018,10,24,23,178,159,337,579
3404-001,2018,10,24,24,116,103,219,337
3404-001,2018,10,25,1,95,103,198,219
3404-001,2018,10,25,2,81,63,144,198
3404-001,2018,10,25,3,50,55,105,144
3404-001,2018,10,25,4,70,52,122,105
3404-001,2018,10,25,5,118,114,232,122
3404-001,2018,10,25,6,189,295,484,232
3404-001,2018,10,25,7,397,717,1114,484
3404-001,2018,10,25,8,832,1900,2732,1114
3404-001,2018,10,25,9,1111,1529,2640,2732
3404-001,2018,10,25,10,1029,1056,2085,2640
3404-001,2018,10,25,11,1100,1023,2123,2085
3404-001,2018,10,25,12,1069,892,1961,2123
3404-001,2018,10,25,13,1029,889,1918,1961
3404-001,2018,10,25,14,1043,946,1989,1918
3404-001,2018,10,25,15,1123,1080,2203,1989
3404-001,2018,10,25,16,1127,1027,2154,2203
3404-001,2018,10,25,17,1220,914,2134,2154
3404-001,2018,10,25,18,1609,922,2531,2134
3404-001,2018,10,25,19,1530,710,2240,2531
3404-001,2018,10,25,20,798,533,1331,2240
3404-001,2018,10,25,21,655,341,996,1331
3404-001,2018,10,25,22,378,256,634,996
3404-001,2018,10,25,23,201,204,405,634
3404-001,2018,10,25,24,156,145,301,405
3404-001,2018,10,26,1,130,100,230,301
3404-001,2018,10,26,2,78,69,147,230
3404-001,2018,10,26,3,53,54,107,147
3404-001,2018,10,26,4,68,75,143,107
3404-001,2018,10,26,5,98,83,181,143
3404-001,2018,10,26,6,191,310,501,181
3404-001,2018,10,26,7,389,689,1078,501
3404-001,2018,10,26,8,824,1857,2681,1078
3404-001,2018,10,26,9,1053,1600,2653,2681
3404-001,2018,10,26,10,982,1043,2025,2653
3404-001,2018,10,26,11,997,1033,2030,2025
3404-001,2018,10,26,12,944,902,1846,2030
3404-001,2018,10,26,13,812,751,1563,1846
3404-001,2018,10,26,14,893,872,1765,1563
3404-001,2018,10,26,15,1002,977,1979,1765
3404-001,2018,10,26,16,1071,950,2021,1979
3404-001,2018,10,26,17,1082,855,1937,2021
3404-001,2018,10,26,18,1666,860,2526,1937
3404-001,2018,10,26,19,1523,810,2333,2526
3404-001,2018,10,26,20,866,571,1437,2333
3404-001,2018,10,26,21,701,354,1055,1437
3404-001,2018,10,26,22,323,234,557,1055
3404-001,2018,10,26,23,164,163,327,557
3404-001,2018,10,26,24,109,111,220,327
3404-001,2018,10,27,1,107,97,204,220
3404-001,2018,10,27,2,87,73,160,204
3404-001,2018,10,27,3,56,54,110,160
3404-001,2018,10,27,4,56,43,99,110
3404-001,2018,10,27,5,86,105,191,99
3404-001,2018,10,27,6,159,214,373,191
3404-001,2018,10,27,7,312,448,760,373
3404-001,2018,10,27,8,505,760,1265,760
3404-001,2018,10,27,9,711,820,1531,1265
3404-001,2018,10,27,10,751,896,1647,1531
3404-001,2018,10,27,11,742,899,1641,1647
3404-001,2018,10,27,12,737,815,1552,1641
3404-001,2018,10,27,13,695,787,1482,1552
3404-001,2018,10,27,14,654,741,1395,1482
3404-001,2018,10,27,15,679,758,1437,1395
3404-001,2018,10,27,16,743,675,1418,1437
3404-001,2018,10,27,17,730,617,1347,1418
3404-001,2018,10,27,18,914,649,1563,1347
3404-001,2018,10,27,19,711,516,1227,1563
3404-001,2018,10,27,20,375,385,760,1227
3404-001,2018,10,27,21,289,243,532,760
3404-001,2018,10,27,22,206,203,409,532
3404-001,2018,10,27,23,114,118,232,409
3404-001,2018,10,27,24,103,95,198,232
3404-001,2018,10,28,1,59,75,134,198
3404-001,2018,10,28,2,51,45,96,134
3404-001,2018,10,28,3,44,43,87,96
3404-001,2018,10,28,4,30,35,65,87
3404-001,2018,10,28,5,43,30,73,65
3404-001,2018,10,28,6,68,101,169,73
3404-001,2018,10,28,7,101,177,278,169
3404-001,2018,10,28,8,215,271,486,278
3404-001,2018,10,28,9,248,225,473,486
3404-001,2018,10,28,10,338,245,583,473
3404-001,2018,10,28,11,359,293,652,583
3404-001,2018,10,28,12,423,302,725,652
3404-001,2018,10,28,13,440,320,760,725
3404-001,2018,10,28,14,496,345,841,760
3404-001,2018,10,28,15,575,324,899,841
3404-001,2018,10,28,16,607,304,911,899
3404-001,2018,10,28,17,597,487,1084,911
3404-001,2018,10,28,18,639,444,1083,1084
3404-001,2018,10,28,19,462,385,847,1083
3404-001,2018,10,28,20,311,343,654,847
3404-001,2018,10,28,21,281,282,563,654
3404-001,2018,10,28,22,193,244,437,563
3404-001,2018,10,28,23,133,190,323,437
3404-001,2018,10,28,24,73,121,194,323
3404-001,2018,10,29,1,50,85,135,194
3404-001,2018,10,29,2,21,54,75,135
3404-001,2018,10,29,3,28,45,73,75
3404-001,2018,10,29,4,37,45,82,73
3404-001,2018,10,29,5,95,104,199,82
3404-001,2018,10,29,6,219,325,544,199
3404-001,2018,10,29,7,366,757,1123,544
3404-001,2018,10,29,8,886,1991,2877,1123
3404-001,2018,10,29,9,1087,1498,2585,2877
3404-001,2018,10,29,10,1008,993,2001,2585
3404-001,2018,10,29,11,1003,1053,2056,2001
3404-001,2018,10,29,12,989,865,1854,2056
3404-001,2018,10,29,13,904,749,1653,1854
3404-001,2018,10,29,14,948,890,1838,1653
3404-001,2018,10,29,15,1085,1073,2158,1838
3404-001,2018,10,29,16,1070,997,2067,2158
3404-001,2018,10,29,17,1053,866,1919,2067
3404-001,2018,10,29,18,1621,853,2474,1919
3404-001,2018,10,29,19,1317,723,2040,2474
3404-001,2018,10,29,20,793,575,1368,2040
3404-001,2018,10,29,21,653,309,962,1368
3404-001,2018,10,29,22,356,239,595,962
3404-001,2018,10,29,23,200,177,377,595
3404-001,2018,10,29,24,117,106,223,377
3404-001,2018,10,30,1,85,93,178,223
3404-001,2018,10,30,2,45,74,119,178
3404-001,2018,10,30,3,46,77,123,119
3404-001,2018,10,30,4,71,64,135,123
3404-001,2018,10,30,5,80,95,175,135
3404-001,2018,10,30,6,200,309,509,175
3404-001,2018,10,30,7,398,764,1162,509
3404-001,2018,10,30,8,945,1958,2903,1162
3404-001,2018,10,30,9,1240,1572,2812,2903
3404-001,2018,10,30,10,1178,1024,2202,2812
3404-001,2018,10,30,11,1123,1074,2197,2202
3404-001,2018,10,30,12,1011,879,1890,2197
3404-001,2018,10,30,13,1002,825,1827,1890
3404-001,2018,10,30,14,978,948,1926,1827
3404-001,2018,10,30,15,1197,1025,2222,1926
3404-001,2018,10,30,16,1220,964,2184,2222
3404-001,2018,10,30,17,1135,955,2090,2184
3404-001,2018,10,30,18,1583,881,2464,2090
3404-001,2018,10,30,19,1304,730,2034,2464
3404-001,2018,10,30,20,804,524,1328,2034
3404-001,2018,10,30,21,658,328,986,1328
3404-001,2018,10,30,22,389,232,621,986
3404-001,2018,10,30,23,209,175,384,621
3404-001,2018,10,30,24,120,119,239,384
3404-001,2018,10,31,1,96,86,182,239
3404-001,2018,10,31,2,59,75,134,182
3404-001,2018,10,31,3,38,51,89,134
3404-001,2018,10,31,4,82,76,158,89
3404-001,2018,10,31,5,116,118,234,158
3404-001,2018,10,31,6,206,347,553,234
3404-001,2018,10,31,7,414,712,1126,553
3404-001,2018,10,31,8,949,1861,2810,1126
3404-001,2018,10,31,9,1180,1565,2745,2810
3404-001,2018,10,31,10,1145,955,2100,2745
3404-001,2018,10,31,11,1104,1026,2130,2100
3404-001,2018,10,31,12,1044,925,1969,2130
3404-001,2018,10,31,13,895,811,1706,1969
3404-001,2018,10,31,14,1030,926,1956,1706
3404-001,2018,10,31,15,1084,1041,2125,1956
3404-001,2018,10,31,16,1152,979,2131,2125
3404-001,2018,10,31,17,1093,870,1963,2131
3404-001,2018,10,31,18,1757,916,2673,1963
3404-001,2018,10,31,19,1394,774,2168,2673
3404-001,2018,10,31,20,787,533,1320,2168
3404-001,2018,10,31,21,569,257,826,1320
3404-001,2018,10,31,22,349,228,577,826
3404-001,2018,10,31,23,197,191,388,577
3404-001,2018,10,31,24,146,111,257,388
3404-001,2018,11,1,1,111,72,183,257
3404-001,2018,11,1,2,68,73,141,183
3404-001,2018,11,1,3,41,76,117,141
3404-001,2018,11,1,4,64,63,127,117
3404-001,2018,11,1,5,106,120,226,127
3404-001,2018,11,1,6,229,295,524,226
3404-001,2018,11,1,7,381,691,1072,524
3404-001,2018,11,1,8,924,1917,2841,1072
3404-001,2018,11,1,9,1099,1572,2671,2841
3404-001,2018,11,1,10,1085,1006,2091,2671
3404-001,2018,11,1,11,1144,1067,2211,2091
3404-001,2018,11,1,12,1101,987,2088,2211
3404-001,2018,11,1,13,962,824,1786,2088
3404-001,2018,11,1,14,1031,911,1942,1786
3404-001,2018,11,1,15,1119,1023,2142,1942
3404-001,2018,11,1,16,1142,1013,2155,2142
3404-001,2018,11,1,17,1201,844,2045,2155
3404-001,2018,11,1,18,1579,890,2469,2045
3404-001,2018,11,1,19,1422,756,2178,2469
3404-001,2018,11,1,20,818,535,1353,2178
3404-001,2018,11,1,21,605,345,950,1353
3404-001,2018,11,1,22,355,262,617,950
3404-001,2018,11,1,23,200,179,379,617
3404-001,2018,11,1,24,136,123,259,379
3404-001,2018,11,2,1,121,112,233,259
3404-001,2018,11,2,2,63,62,125,233
3404-001,2018,11,2,3,59,69,128,125
3404-001,2018,11,2,4,78,63,141,128
3404-001,2018,11,2,5,93,115,208,141
3404-001,2018,11,2,6,204,301,505,208
3404-001,2018,11,2,7,390,724,1114,505
3404-001,2018,11,2,8,847,1889,2736,1114
3404-001,2018,11,2,9,1153,1552,2705,2736
3404-001,2018,11,2,10,1054,958,2012,2705
3404-001,2018,11,2,11,1014,956,1970,2012
3404-001,2018,11,2,12,1087,947,2034,1970
3404-001,2018,11,2,13,919,824,1743,2034
3404-001,2018,11,2,14,1026,960,1986,1743
3404-001,2018,11,2,15,1080,1000,2080,1986
3404-001,2018,11,2,16,1151,1022,2173,2080
3404-001,2018,11,2,17,1221,940,2161,2173
3404-001,2018,11,2,18,1831,936,2767,2161
3404-001,2018,11,2,19,1699,957,2656,2767
3404-001,2018,11,2,20,1038,831,1869,2656
3404-001,2018,11,2,21,656,406,1062,1869
3404-001,2018,11,2,22,324,240,564,1062
3404-001,2018,11,2,23,209,174,383,564
3404-001,2018,11,2,24,133,127,260,383
3404-001,2018,11,3,1,106,79,185,260
3404-001,2018,11,3,2,72,83,155,185
3404-001,2018,11,3,3,55,67,122,155
3404-001,2018,11,3,4,58,73,131,122
3404-001,2018,11,3,5,106,111,217,131
3404-001,2018,11,3,6,172,259,431,217
3404-001,2018,11,3,7,296,437,733,431
3404-001,2018,11,3,8,575,754,1329,733
3404-001,2018,11,3,9,707,804,1511,1329
3404-001,2018,11,3,10,727,894,1621,1511
3404-001,2018,11,3,11,761,960,1721,1621
3404-001,2018,11,3,12,701,924,1625,1721
3404-001,2018,11,3,13,672,838,1510,1625
3404-001,2018,11,3,14,661,785,1446,1510
3404-001,2018,11,3,15,770,803,1573,1446
3404-001,2018,11,3,16,768,740,1508,1573
3404-001,2018,11,3,17,809,723,1532,1508
3404-001,2018,11,3,18,1047,639,1686,1532
3404-001,2018,11,3,19,798,582,1380,1686
3404-001,2018,11,3,20,439,419,858,1380
3404-001,2018,11,3,21,273,241,514,858
3404-001,2018,11,3,22,190,183,373,514
3404-001,2018,11,3,23,117,116,233,373
3404-001,2018,11,3,24,99,80,179,233
3404-001,2018,11,4,1,70,64,134,179
3404-001,2018,11,4,2,45,42,87,134
3404-001,2018,11,4,3,47,39,86,87
3404-001,2018,11,4,4,33,44,77,86
3404-001,2018,11,4,5,56,49,105,77
3404-001,2018,11,4,6,60,103,163,105
3404-001,2018,11,4,7,105,170,275,163
3404-001,2018,11,4,8,202,261,463,275
3404-001,2018,11,4,9,302,335,637,463
3404-001,2018,11,4,10,344,343,687,637
3404-001,2018,11,4,11,469,455,924,687
3404-001,2018,11,4,12,399,438,837,924
3404-001,2018,11,4,13,443,439,882,837
3404-001,2018,11,4,14,507,470,977,882
3404-001,2018,11,4,15,585,460,1045,977
3404-001,2018,11,4,16,727,476,1203,1045
3404-001,2018,11,4,17,796,533,1329,1203
3404-001,2018,11,4,18,834,488,1322,1329
3404-001,2018,11,4,19,764,468,1232,1322
3404-001,2018,11,4,20,512,381,893,1232
3404-001,2018,11,4,21,310,329,639,893
3404-001,2018,11,4,22,252,285,537,639
3404-001,2018,11,4,23,136,195,331,537
3404-001,2018,11,4,24,92,120,212,331
3404-001,2018,11,5,1,55,74,129,212
3404-001,2018,11,5,2,26,45,71,129
3404-001,2018,11,5,3,38,48,86,71
3404-001,2018,11,5,4,54,59,113,86
3404-001,2018,11,5,5,112,128,240,113
3404-001,2018,11,5,6,197,295,492,240
3404-001,2018,11,5,7,425,743,1168,492
3404-001,2018,11,5,8,907,1973,2880,1168
3404-001,2018,11,5,9,1033,1618,2651,2880
3404-001,2018,11,5,10,898,971,1869,2651
3404-001,2018,11,5,11,1000,968,1968,1869
3404-001,2018,11,5,12,992,904,1896,1968
3404-001,2018,11,5,13,859,724,1583,1896
3404-001,2018,11,5,14,901,958,1859,1583
3404-001,2018,11,5,15,1090,1065,2155,1859
3404-001,2018,11,5,16,1152,983,2135,2155
3404-001,2018,11,5,17,1155,839,1994,2135
3404-001,2018,11,5,18,1559,911,2470,1994
3404-001,2018,11,5,19,1309,740,2049,2470
3404-001,2018,11,5,20,795,500,1295,2049
3404-001,2018,11,5,21,678,313,991,1295
3404-001,2018,11,5,22,333,246,579,991
3404-001,2018,11,5,23,189,182,371,579
3404-001,2018,11,5,24,135,94,229,371
3404-001,2018,11,6,1,85,126,211,229
3404-001,2018,11,6,2,79,87,166,211
3404-001,2018,11,6,3,49,54,103,166
3404-001,2018,11,6,4,61,110,171,103
3404-001,2018,11,6,5,80,157,237,171
3404-001,2018,11,6,6,204,295,499,237
3404-001,2018,11,6,7,398,751,1149,499
3404-001,2018,11,6,8,890,1979,2869,1149
3404-001,2018,11,6,9,1073,1610,2683,2869
3404-001,2018,11,6,10,1018,1005,2023,2683
3404-001,2018,11,6,11,1040,1054,2094,2023
3404-001,2018,11,6,12,1022,956,1978,2094
3404-001,2018,11,6,13,1027,878,1905,1978
3404-001,2018,11,6,14,1001,1042,2043,1905
3404-001,2018,11,6,15,1142,1124,2266,2043
3404-001,2018,11,6,16,1098,1043,2141,2266
3404-001,2018,11,6,17,1174,891,2065,2141
3404-001,2018,11,6,18,1582,891,2473,2065
3404-001,2018,11,6,19,1422,764,2186,2473
3404-001,2018,11,6,20,792,498,1290,2186
3404-001,2018,11,6,21,682,377,1059,1290
3404-001,2018,11,6,22,363,203,566,1059
3404-001,2018,11,6,23,187,170,357,566
3404-001,2018,11,6,24,139,94,233,357
3404-001,2018,11,7,1,123,99,222,233
3404-001,2018,11,7,2,66,62,128,222
3404-001,2018,11,7,3,62,70,132,128
3404-001,2018,11,7,4,60,81,141,132
3404-001,2018,11,7,5,109,88,197,141
3404-001,2018,11,7,6,207,292,499,197
3404-001,2018,11,7,7,377,729,1106,499
3404-001,2018,11,7,8,811,1875,2686,1106
3404-001,2018,11,7,9,1014,1621,2635,2686
3404-001,2018,11,7,10,964,1053,2017,2635
3404-001,2018,11,7,11,950,1047,1997,2017
3404-001,2018,11,7,12,992,936,1928,1997
3404-001,2018,11,7,13,844,796,1640,1928
3404-001,2018,11,7,14,965,962,1927,1640
3404-001,2018,11,7,15,1051,977,2028,1927
3404-001,2018,11,7,16,914,970,1884,2028
3404-001,2018,11,7,17,949,902,1851,1884
3404-001,2018,11,7,18,1470,888,2358,1851
3404-001,2018,11,7,19,1297,757,2054,2358
3404-001,2018,11,7,20,694,516,1210,2054
3404-001,2018,11,7,21,488,294,782,1210
3404-001,2018,11,7,22,331,229,560,782
3404-001,2018,11,7,23,176,175,351,560
3404-001,2018,11,7,24,116,48,164,351
3404-001,2018,11,8,1,76,78,154,164
3404-001,2018,11,8,2,55,45,100,154
3404-001,2018,11,8,3,42,50,92,100
3404-001,2018,11,8,4,51,38,89,92
3404-001,2018,11,8,5,79,91,170,89
3404-001,2018,11,8,6,165,197,362,170
3404-001,2018,11,8,7,315,562,877,362
3404-001,2018,11,8,8,732,1691,2423,877
3404-001,2018,11,8,9,1034,1619,2653,2423
3404-001,2018,11,8,10,877,836,1713,2653
3404-001,2018,11,8,11,847,810,1657,1713
3404-001,2018,11,8,12,813,631,1444,1657
3404-001,2018,11,8,13,695,644,1339,1444
3404-001,2018,11,8,14,795,715,1510,1339
3404-001,2018,11,8,15,961,737,1698,1510
3404-001,2018,11,8,16,938,713,1651,1698
3404-001,2018,11,8,17,903,696,1599,1651
3404-001,2018,11,8,18,1298,752,2050,1599
3404-001,2018,11,8,19,1201,588,1789,2050
3404-001,2018,11,8,20,728,389,1117,1789
3404-001,2018,11,8,21,657,269,926,1117
3404-001,2018,11,8,22,359,160,519,926
3404-001,2018,11,8,23,152,124,276,519
3404-001,2018,11,8,24,106,93,199,276
3404-001,2018,11,9,1,79,74,153,199
3404-001,2018,11,9,2,55,31,86,153
3404-001,2018,11,9,3,55,36,91,86
3404-001,2018,11,9,4,49,52,101,91
3404-001,2018,11,9,5,52,66,118,101
3404-001,2018,11,9,6,166,204,370,118
3404-001,2018,11,9,7,284,607,891,370
3404-001,2018,11,9,8,699,1917,2616,891
3404-001,2018,11,9,9,952,1567,2519,2616
3404-001,2018,11,9,10,930,881,1811,2519
3404-001,2018,11,9,11,879,860,1739,1811
3404-001,2018,11,9,12,889,817,1706,1739
3404-001,2018,11,9,13,828,715,1543,1706
3404-001,2018,11,9,14,898,786,1684,1543
3404-001,2018,11,9,15,1054,903,1957,1684
3404-001,2018,11,9,16,1071,855,1926,1957
3404-001,2018,11,9,17,1121,793,1914,1926
3404-001,2018,11,9,18,1559,959,2518,1914
3404-001,2018,11,9,19,1406,901,2307,2518
3404-001,2018,11,9,20,826,591,1417,2307
3404-001,2018,11,9,21,545,357,902,1417
3404-001,2018,11,9,22,327,215,542,902
3404-001,2018,11,9,23,177,144,321,542
3404-001,2018,11,9,24,116,105,221,321
3404-001,2018,11,10,1,90,67,157,221
3404-001,2018,11,10,2,65,66,131,157
3404-001,2018,11,10,3,41,59,100,131
3404-001,2018,11,10,4,56,55,111,100
3404-001,2018,11,10,5,70,71,141,111
3404-001,2018,11,10,6,126,187,313,141
3404-001,2018,11,10,7,231,355,586,313
3404-001,2018,11,10,8,414,649,1063,586
3404-001,2018,11,10,9,657,692,1349,1063
3404-001,2018,11,10,10,738,691,1429,1349
3404-001,2018,11,10,11,714,757,1471,1429
3404-001,2018,11,10,12,746,687,1433,1471
3404-001,2018,11,10,13,685,590,1275,1433
3404-001,2018,11,10,14,614,593,1207,1275
3404-001,2018,11,10,15,720,615,1335,1207
3404-001,2018,11,10,16,744,638,1382,1335
3404-001,2018,11,10,17,818,649,1467,1382
3404-001,2018,11,10,18,955,590,1545,1467
3404-001,2018,11,10,19,633,454,1087,1545
3404-001,2018,11,10,20,372,369,741,1087
3404-001,2018,11,10,21,244,268,512,741
3404-001,2018,11,10,22,191,172,363,512
3404-001,2018,11,10,23,128,117,245,363
3404-001,2018,11,10,24,103,79,182,245
3404-001,2018,11,11,1,57,55,112,182
3404-001,2018,11,11,2,39,36,75,112
3404-001,2018,11,11,3,34,42,76,75
3404-001,2018,11,11,4,29,24,53,76
3404-001,2018,11,11,5,39,52,91,53
3404-001,2018,11,11,6,50,83,133,91
3404-001,2018,11,11,7,76,179,255,133
3404-001,2018,11,11,8,217,218,435,255
3404-001,2018,11,11,9,236,280,516,435
3404-001,2018,11,11,10,293,286,579,516
3404-001,2018,11,11,11,389,352,741,579
3404-001,2018,11,11,12,430,403,833,741
3404-001,2018,11,11,13,388,381,769,833
3404-001,2018,11,11,14,462,413,875,769
3404-001,2018,11,11,15,528,497,1025,875
3404-001,2018,11,11,16,655,465,1120,1025
3404-001,2018,11,11,17,687,502,1189,1120
3404-001,2018,11,11,18,744,458,1202,1189
3404-001,2018,11,11,19,599,485,1084,1202
3404-001,2018,11,11,20,351,338,689,1084
3404-001,2018,11,11,21,261,280,541,689
3404-001,2018,11,11,22,172,269,441,541
3404-001,2018,11,11,23,121,153,274,441
3404-001,2018,11,11,24,74,105,179,274
3404-001,2018,11,12,1,44,76,120,179
3404-001,2018,11,12,2,30,30,60,120
3404-001,2018,11,12,3,18,45,63,60
3404-001,2018,11,12,4,29,43,72,63
3404-001,2018,11,12,5,65,66,131,72
3404-001,2018,11,12,6,137,269,406,131
3404-001,2018,11,12,7,323,661,984,406
3404-001,2018,11,12,8,736,2093,2829,984
3404-001,2018,11,12,9,836,1636,2472,2829
3404-001,2018,11,12,10,871,819,1690,2472
3404-001,2018,11,12,11,1004,776,1780,1690
3404-001,2018,11,12,12,927,733,1660,1780
3404-001,2018,11,12,13,865,745,1610,1660
3404-001,2018,11,12,14,928,749,1677,1610
3404-001,2018,11,12,15,996,879,1875,1677
3404-001,2018,11,12,16,1078,805,1883,1875
3404-001,2018,11,12,17,970,793,1763,1883
3404-001,2018,11,12,18,1359,836,2195,1763
3404-001,2018,11,12,19,1192,740,1932,2195
3404-001,2018,11,12,20,663,453,1116,1932
3404-001,2018,11,12,21,606,264,870,1116
3404-001,2018,11,12,22,301,209,510,870
3404-001,2018,11,12,23,155,112,267,510
3404-001,2018,11,12,24,110,98,208,267
3404-001,2018,11,13,1,73,72,145,208
3404-001,2018,11,13,2,54,48,102,145
3404-001,2018,11,13,3,31,31,62,102
3404-001,2018,11,13,4,55,36,91,62
3404-001,2018,11,13,5,97,69,166,91
3404-001,2018,11,13,6,128,254,382,166
3404-001,2018,11,13,7,305,603,908,382
3404-001,2018,11,13,8,763,2064,2827,908
3404-001,2018,11,13,9,863,1615,2478,2827
3404-001,2018,11,13,10,834,927,1761,2478
3404-001,2018,11,13,11,1002,804,1806,1761
3404-001,2018,11,13,12,925,775,1700,1806
3404-001,2018,11,13,13,819,703,1522,1700
3404-001,2018,11,13,14,965,742,1707,1522
3404-001,2018,11,13,15,1186,798,1984,1707
3404-001,2018,11,13,16,1113,775,1888,1984
3404-001,2018,11,13,17,1082,786,1868,1888
3404-001,2018,11,13,18,1395,809,2204,1868
3404-001,2018,11,13,19,1120,694,1814,2204
3404-001,2018,11,13,20,637,468,1105,1814
3404-001,2018,11,13,21,571,264,835,1105
3404-001,2018,11,13,22,316,206,522,835
3404-001,2018,11,13,23,149,161,310,522
3404-001,2018,11,13,24,153,71,224,310
3404-001,2018,11,14,1,77,50,127,224
3404-001,2018,11,14,2,44,42,86,127
3404-001,2018,11,14,3,44,38,82,86
3404-001,2018,11,14,4,51,35,86,82
3404-001,2018,11,14,5,80,83,163,86
3404-001,2018,11,14,6,168,185,353,163
3404-001,2018,11,14,7,316,612,928,353
3404-001,2018,11,14,8,656,1969,2625,928
3404-001,2018,11,14,9,935,1629,2564,2625
3404-001,2018,11,14,10,838,843,1681,2564
3404-001,2018,11,14,11,1004,908,1912,1681
3404-001,2018,11,14,12,981,816,1797,1912
3404-001,2018,11,14,13,908,653,1561,1797
3404-001,2018,11,14,14,925,829,1754,1561
3404-001,2018,11,14,15,1089,898,1987,1754
3404-001,2018,11,14,16,1097,961,2058,1987
3404-001,2018,11,14,17,1076,826,1902,2058
3404-001,2018,11,14,18,1650,795,2445,1902
3404-001,2018,11,14,19,1258,711,1969,2445
3404-001,2018,11,14,20,616,444,1060,1969
3404-001,2018,11,14,21,515,261,776,1060
3404-001,2018,11,14,22,279,203,482,776
3404-001,2018,11,14,23,178,158,336,482
3404-001,2018,11,14,24,150,93,243,336
3404-001,2018,11,15,1,75,74,149,243
3404-001,2018,11,15,2,69,52,121,149
3404-001,2018,11,15,3,46,50,96,121
3404-001,2018,11,15,4,62,72,134,96
3404-001,2018,11,15,5,65,57,122,134
3404-001,2018,11,15,6,143,216,359,122
3404-001,2018,11,15,7,306,603,909,359
3404-001,2018,11,15,8,739,1966,2705,909
3404-001,2018,11,15,9,887,1622,2509,2705
3404-001,2018,11,15,10,866,879,1745,2509
3404-001,2018,11,15,11,988,853,1841,1745
3404-001,2018,11,15,12,930,826,1756,1841
3404-001,2018,11,15,13,881,682,1563,1756
3404-001,2018,11,15,14,941,757,1698,1563
3404-001,2018,11,15,15,1080,848,1928,1698
3404-001,2018,11,15,16,1100,889,1989,1928
3404-001,2018,11,15,17,1139,785,1924,1989
3404-001,2018,11,15,18,1488,833,2321,1924
3404-001,2018,11,15,19,1172,742,1914,2321
3404-001,2018,11,15,20,695,465,1160,1914
3404-001,2018,11,15,21,557,285,842,1160
3404-001,2018,11,15,22,307,206,513,842
3404-001,2018,11,15,23,174,108,282,513
3404-001,2018,11,15,24,90,88,178,282
3404-001,2018,11,16,1,88,64,152,178
3404-001,2018,11,16,2,65,36,101,152
3404-001,2018,11,16,3,54,45,99,101
3404-001,2018,11,16,4,52,52,104,99
3404-001,2018,11,16,5,74,91,165,104
3404-001,2018,11,16,6,149,239,388,165
3404-001,2018,11,16,7,289,656,945,388
3404-001,2018,11,16,8,706,1987,2693,945
3404-001,2018,11,16,9,852,1694,2546,2693
3404-001,2018,11,16,10,865,927,1792,2546
3404-001,2018,11,16,11,866,961,1827,1792
3404-001,2018,11,16,12,1018,785,1803,1827
3404-001,2018,11,16,13,923,739,1662,1803
3404-001,2018,11,16,14,904,776,1680,1662
3404-001,2018,11,16,15,1077,970,2047,1680
3404-001,2018,11,16,16,1172,903,2075,2047
3404-001,2018,11,16,17,1105,822,1927,2075
3404-001,2018,11,16,18,1816,910,2726,1927
3404-001,2018,11,16,19,1473,956,2429,2726
3404-001,2018,11,16,20,924,602,1526,2429
3404-001,2018,11,16,21,585,377,962,1526
3404-001,2018,11,16,22,300,245,545,962
3404-001,2018,11,16,23,165,149,314,545
3404-001,2018,11,16,24,112,126,238,314
3404-001,2018,11,17,1,80,55,135,238
3404-001,2018,11,17,2,58,60,118,135
3404-001,2018,11,17,3,53,76,129,118
3404-001,2018,11,17,4,49,60,109,129
3404-001,2018,11,17,5,73,62,135,109
3404-001,2018,11,17,6,115,161,276,135
3404-001,2018,11,17,7,255,399,654,276
3404-001,2018,11,17,8,433,728,1161,654
3404-001,2018,11,17,9,637,677,1314,1161
3404-001,2018,11,17,10,612,718,1330,1314
3404-001,2018,11,17,11,734,790,1524,1330
3404-001,2018,11,17,12,668,682,1350,1524
3404-001,2018,11,17,13,638,658,1296,1350
3404-001,2018,11,17,14,727,677,1404,1296
3404-001,2018,11,17,15,751,742,1493,1404
3404-001,2018,11,17,16,702,629,1331,1493
3404-001,2018,11,17,17,760,634,1394,1331
3404-001,2018,11,17,18,920,667,1587,1394
3404-001,2018,11,17,19,601,519,1120,1587
3404-001,2018,11,17,20,342,388,730,1120
3404-001,2018,11,17,21,271,247,518,730
3404-001,2018,11,17,22,169,184,353,518
3404-001,2018,11,17,23,115,139,254,353
3404-001,2018,11,17,24,86,76,162,254
3404-001,2018,11,18,1,62,59,121,162
3404-001,2018,11,18,2,43,42,85,121
3404-001,2018,11,18,3,34,31,65,85
3404-001,2018,11,18,4,33,36,69,65
3404-001,2018,11,18,5,37,40,77,69
3404-001,2018,11,18,6,69,71,140,77
3404-001,2018,11,18,7,96,141,237,140
3404-001,2018,11,18,8,203,245,448,237
3404-001,2018,11,18,9,284,269,553,448
3404-001,2018,11,18,10,257,269,526,553
3404-001,2018,11,18,11,373,336,709,526
3404-001,2018,11,18,12,391,350,741,709
3404-001,2018,11,18,13,423,350,773,741
3404-001,2018,11,18,14,501,413,914,773
3404-001,2018,11,18,15,568,427,995,914
3404-001,2018,11,18,16,685,507,1192,995
3404-001,2018,11,18,17,734,511,1245,1192
3404-001,2018,11,18,18,781,470,1251,1245
3404-001,2018,11,18,19,575,451,1026,1251
3404-001,2018,11,18,20,489,352,841,1026
3404-001,2018,11,18,21,335,286,621,841
3404-001,2018,11,18,22,181,232,413,621
3404-001,2018,11,18,23,108,225,333,413
3404-001,2018,11,18,24,64,137,201,333
3404-001,2018,11,19,1,41,67,108,201
3404-001,2018,11,19,2,36,45,81,108
3404-001,2018,11,19,3,26,42,68,81
3404-001,2018,11,19,4,23,57,80,68
3404-001,2018,11,19,5,63,91,154,80
3404-001,2018,11,19,6,167,244,411,154
3404-001,2018,11,19,7,327,723,1050,411
3404-001,2018,11,19,8,724,2221,2945,1050
3404-001,2018,11,19,9,851,1687,2538,2945
3404-001,2018,11,19,10,813,727,1540,2538
3404-001,2018,11,19,11,947,792,1739,1540
3404-001,2018,11,19,12,887,716,1603,1739
3404-001,2018,11,19,13,812,668,1480,1603
3404-001,2018,11,19,14,913,795,1708,1480
3404-001,2018,11,19,15,1161,860,2021,1708
3404-001,2018,11,19,16,1071,828,1899,2021
3404-001,2018,11,19,17,1014,841,1855,1899
3404-001,2018,11,19,18,1382,810,2192,1855
3404-001,2018,11,19,19,1072,680,1752,2192
3404-001,2018,11,19,20,647,461,1108,1752
3404-001,2018,11,19,21,538,264,802,1108
3404-001,2018,11,19,22,274,182,456,802
3404-001,2018,11,19,23,128,129,257,456
3404-001,2018,11,19,24,79,86,165,257
3404-001,2018,11,20,1,68,54,122,165
3404-001,2018,11,20,2,54,43,97,122
3404-001,2018,11,20,3,37,28,65,97
3404-001,2018,11,20,4,40,59,99,65
3404-001,2018,11,20,5,69,66,135,99
3404-001,2018,11,20,6,135,232,367,135
3404-001,2018,11,20,7,292,584,876,367
3404-001,2018,11,20,8,752,2098,2850,876
3404-001,2018,11,20,9,924,1591,2515,2850
3404-001,2018,11,20,10,751,840,1591,2515
3404-001,2018,11,20,11,923,804,1727,1591
3404-001,2018,11,20,12,911,764,1675,1727
3404-001,2018,11,20,13,795,692,1487,1675
3404-001,2018,11,20,14,926,822,1748,1487
3404-001,2018,11,20,15,1093,901,1994,1748
3404-001,2018,11,20,16,1008,798,1806,1994
3404-001,2018,11,20,17,913,802,1715,1806
3404-001,2018,11,20,18,1312,862,2174,1715
3404-001,2018,11,20,19,1171,655,1826,2174
3404-001,2018,11,20,20,646,406,1052,1826
3404-001,2018,11,20,21,555,281,836,1052
3404-001,2018,11,20,22,293,201,494,836
3404-001,2018,11,20,23,167,108,275,494
3404-001,2018,11,20,24,114,96,210,275
3404-001,2018,11,21,1,70,69,139,210
3404-001,2018,11,21,2,46,45,91,139
3404-001,2018,11,21,3,50,33,83,91
3404-001,2018,11,21,4,43,40,83,83
3404-001,2018,11,21,5,65,69,134,83
3404-001,2018,11,21,6,157,221,378,134
3404-001,2018,11,21,7,257,598,855,378
3404-001,2018,11,21,8,837,1881,2718,855
3404-001,2018,11,21,9,867,1686,2553,2718
3404-001,2018,11,21,10,664,809,1473,2553
3404-001,2018,11,21,11,563,858,1421,1473
3404-001,2018,11,21,12,780,727,1507,1421
3404-001,2018,11,21,13,779,680,1459,1507
3404-001,2018,11,21,14,743,720,1463,1459
3404-001,2018,11,21,15,797,869,1666,1463
3404-001,2018,11,21,16,852,785,1637,1666
3404-001,2018,11,21,17,976,749,1725,1637
3404-001,2018,11,21,18,1515,829,2344,1725
3404-001,2018,11,21,19,1053,679,1732,2344
3404-001,2018,11,21,20,533,394,927,1732
3404-001,2018,11,21,21,375,245,620,927
3404-001,2018,11,21,22,259,161,420,620
3404-001,2018,11,21,23,141,136,277,420
3404-001,2018,11,21,24,85,84,169,277
3404-001,2018,11,22,1,54,55,109,169
3404-001,2018,11,22,2,38,36,74,109
3404-001,2018,11,22,3,28,31,59,74
3404-001,2018,11,22,4,34,43,77,59
3404-001,2018,11,22,5,67,55,122,77
3404-001,2018,11,22,6,93,199,292,122
3404-001,2018,11,22,7,232,572,804,292
3404-001,2018,11,22,8,598,1993,2591,804
3404-001,2018,11,22,9,745,1525,2270,2591
3404-001,2018,11,22,10,816,857,1673,2270
3404-001,2018,11,22,11,1026,775,1801,1673
3404-001,2018,11,22,12,1002,680,1682,1801
3404-001,2018,11,22,13,822,682,1504,1682
3404-001,2018,11,22,14,745,536,1281,1504
3404-001,2018,11,22,15,1171,836,2007,1281
3404-001,2018,11,22,16,868,795,1663,2007
3404-001,2018,11,22,17,771,838,1609,1663
3404-001,2018,11,22,18,1206,795,2001,1609
3404-001,2018,11,22,19,1085,634,1719,2001
3404-001,2018,11,22,20,634,482,1116,1719
3404-001,2018,11,22,21,530,261,791,1116
3404-001,2018,11,22,22,306,221,527,791
3404-001,2018,11,22,23,163,149,312,527
3404-001,2018,11,22,24,114,81,195,312
3404-001,2018,11,23,1,76,64,140,195
3404-001,2018,11,23,2,65,30,95,140
3404-001,2018,11,23,3,41,54,95,95
3404-001,2018,11,23,4,38,38,76,95
3404-001,2018,11,23,5,72,71,143,76
3404-001,2018,11,23,6,140,165,305,143
3404-001,2018,11,23,7,269,542,811,305
3404-001,2018,11,23,8,614,1916,2530,811
3404-001,2018,11,23,9,789,1531,2320,2530
3404-001,2018,11,23,10,693,865,1558,2320
3404-001,2018,11,23,11,996,814,1810,1558
3404-001,2018,11,23,12,964,778,1742,1810
3404-001,2018,11,23,13,877,706,1583,1742
3404-001,2018,11,23,14,1058,802,1860,1583
3404-001,2018,11,23,15,1030,841,1871,1860
3404-001,2018,11,23,16,1018,836,1854,1871
3404-001,2018,11,23,17,939,894,1833,1854
3404-001,2018,11,23,18,1585,896,2481,1833
3404-001,2018,11,23,19,1400,971,2371,2481
3404-001,2018,11,23,20,690,550,1240,2371
3404-001,2018,11,23,21,555,357,912,1240
3404-001,2018,11,23,22,300,262,562,912
3404-001,2018,11,23,23,171,182,353,562
3404-001,2018,11,23,24,108,127,235,353
3404-001,2018,11,24,1,86,69,155,235
3404-001,2018,11,24,2,69,66,135,155
3404-001,2018,11,24,3,45,48,93,135
3404-001,2018,11,24,4,59,48,107,93
3404-001,2018,11,24,5,55,60,115,107
3404-001,2018,11,24,6,103,146,249,115
3404-001,2018,11,24,7,163,290,453,249
3404-001,2018,11,24,8,388,615,1003,453
3404-001,2018,11,24,9,682,622,1304,1003
3404-001,2018,11,24,10,650,624,1274,1304
3404-001,2018,11,24,11,673,615,1288,1274
3404-001,2018,11,24,12,568,588,1156,1288
3404-001,2018,11,24,13,600,605,1205,1156
3404-001,2018,11,24,14,559,600,1159,1205
3404-001,2018,11,24,15,649,626,1275,1159
3404-001,2018,11,24,16,635,618,1253,1275
3404-001,2018,11,24,17,609,581,1190,1253
3404-001,2018,11,24,18,730,590,1320,1190
3404-001,2018,11,24,19,485,466,951,1320
3404-001,2018,11,24,20,303,370,673,951
3404-001,2018,11,24,21,237,225,462,673
3404-001,2018,11,24,22,158,206,364,462
3404-001,2018,11,24,23,111,144,255,364
3404-001,2018,11,24,24,101,98,199,255
3404-001,2018,11,25,1,49,55,104,199
3404-001,2018,11,25,2,44,45,89,104
3404-001,2018,11,25,3,18,43,61,89
3404-001,2018,11,25,4,28,38,66,61
3404-001,2018,11,25,5,42,38,80,66
3404-001,2018,11,25,6,59,79,138,80
3404-001,2018,11,25,7,92,156,248,138
3404-001,2018,11,25,8,149,218,367,248
3404-001,2018,11,25,9,228,254,482,367
3404-001,2018,11,25,10,278,273,551,482
3404-001,2018,11,25,11,341,304,645,551
3404-001,2018,11,25,12,389,367,756,645
3404-001,2018,11,25,13,402,396,798,756
3404-001,2018,11,25,14,502,415,917,798
3404-001,2018,11,25,15,600,408,1008,917
3404-001,2018,11,25,16,657,461,1118,1008
3404-001,2018,11,25,17,764,410,1174,1118
3404-001,2018,11,25,18,845,474,1319,1174
3404-001,2018,11,25,19,653,396,1049,1319
3404-001,2018,11,25,20,429,338,767,1049
3404-001,2018,11,25,21,277,240,517,767
3404-001,2018,11,25,22,184,216,400,517
3404-001,2018,11,25,23,114,189,303,400
3404-001,2018,11,25,24,99,100,199,303
3404-001,2018,11,26,1,48,64,112,199
3404-001,2018,11,26,2,30,36,66,112
3404-001,2018,11,26,3,19,21,40,66
3404-001,2018,11,26,4,24,43,67,40
3404-001,2018,11,26,5,50,76,126,67
3404-001,2018,11,26,6,129,225,354,126
3404-001,2018,11,26,7,281,649,930,354
3404-001,2018,11,26,8,715,2133,2848,930
3404-001,2018,11,26,9,790,1643,2433,2848
3404-001,2018,11,26,10,788,756,1544,2433
3404-001,2018,11,26,11,949,737,1686,1544
3404-001,2018,11,26,12,962,727,1689,1686
3404-001,2018,11,26,13,829,670,1499,1689
3404-001,2018,11,26,14,937,689,1626,1499
3404-001,2018,11,26,15,1069,882,1951,1626
3404-001,2018,11,26,16,1089,802,1891,1951
3404-001,2018,11,26,17,993,778,1771,1891
3404-001,2018,11,26,18,1364,821,2185,1771
3404-001,2018,11,26,19,1131,675,1806,2185
3404-001,2018,11,26,20,654,449,1103,1806
3404-001,2018,11,26,21,547,274,821,1103
3404-001,2018,11,26,22,284,208,492,821
3404-001,2018,11,26,23,155,120,275,492
3404-001,2018,11,26,24,91,91,182,275
3404-001,2018,11,27,1,67,69,136,182
3404-001,2018,11,27,2,66,43,109,136
3404-001,2018,11,27,3,50,59,109,109
3404-001,2018,11,27,4,67,36,103,109
3404-001,2018,11,27,5,54,71,125,103
3404-001,2018,11,27,6,153,191,344,125
3404-001,2018,11,27,7,292,629,921,344
3404-001,2018,11,27,8,720,1996,2716,921
3404-001,2018,11,27,9,835,1632,2467,2716
3404-001,2018,11,27,10,728,869,1597,2467
3404-001,2018,11,27,11,896,889,1785,1597
3404-001,2018,11,27,12,934,697,1631,1785
3404-001,2018,11,27,13,767,583,1350,1631
3404-001,2018,11,27,14,920,744,1664,1350
3404-001,2018,11,27,15,1122,828,1950,1664
3404-001,2018,11,27,16,1044,793,1837,1950
3404-001,2018,11,27,17,997,751,1748,1837
3404-001,2018,11,27,18,1453,822,2275,1748
3404-001,2018,11,27,19,1252,598,1850,2275
3404-001,2018,11,27,20,704,483,1187,1850
3404-001,2018,11,27,21,578,312,890,1187
3404-001,2018,11,27,22,262,177,439,890
3404-001,2018,11,27,23,171,153,324,439
3404-001,2018,11,27,24,119,100,219,324
3404-001,2018,11,28,1,88,45,133,219
3404-001,2018,11,28,2,45,64,109,133
3404-001,2018,11,28,3,51,38,89,109
3404-001,2018,11,28,4,56,45,101,89
3404-001,2018,11,28,5,61,91,152,101
3404-001,2018,11,28,6,133,180,313,152
3404-001,2018,11,28,7,272,586,858,313
3404-001,2018,11,28,8,706,1950,2656,858
3404-001,2018,11,28,9,921,1598,2519,2656
3404-001,2018,11,28,10,738,822,1560,2519
3404-001,2018,11,28,11,804,833,1637,1560
3404-001,2018,11,28,12,873,742,1615,1637
3404-001,2018,11,28,13,802,668,1470,1615
3404-001,2018,11,28,14,955,802,1757,1470
3404-001,2018,11,28,15,1124,908,2032,1757
3404-001,2018,11,28,16,1105,775,1880,2032
3404-001,2018,11,28,17,873,735,1608,1880
3404-001,2018,11,28,18,1470,802,2272,1608
3404-001,2018,11,28,19,1154,603,1757,2272
3404-001,2018,11,28,20,608,410,1018,1757
3404-001,2018,11,28,21,469,292,761,1018
3404-001,2018,11,28,22,244,192,436,761
3404-001,2018,11,28,23,175,143,318,436
3404-001,2018,11,28,24,97,120,217,318
3404-001,2018,11,29,1,67,74,141,217
3404-001,2018,11,29,2,61,33,94,141
3404-001,2018,11,29,3,42,40,82,94
3404-001,2018,11,29,4,50,43,93,82
3404-001,2018,11,29,5,88,69,157,93
3404-001,2018,11,29,6,153,228,381,157
3404-001,2018,11,29,7,328,571,899,381
3404-001,2018,11,29,8,702,1927,2629,899
3404-001,2018,11,29,9,862,1608,2470,2629
3404-001,2018,11,29,10,795,786,1581,2470
3404-001,2018,11,29,11,847,812,1659,1581
3404-001,2018,11,29,12,724,697,1421,1659
3404-001,2018,11,29,13,656,619,1275,1421
3404-001,2018,11,29,14,787,697,1484,1275
3404-001,2018,11,29,15,944,843,1787,1484
3404-001,2018,11,29,16,891,795,1686,1787
3404-001,2018,11,29,17,850,822,1672,1686
3404-001,2018,11,29,18,1425,831,2256,1672
3404-001,2018,11,29,19,1161,646,1807,2256
3404-001,2018,11,29,20,639,399,1038,1807
3404-001,2018,11,29,21,538,249,787,1038
3404-001,2018,11,29,22,280,173,453,787
3404-001,2018,11,29,23,173,139,312,453
3404-001,2018,11,29,24,107,134,241,312
3404-001,2018,11,30,1,70,78,148,241
3404-001,2018,11,30,2,56,47,103,148
3404-001,2018,11,30,3,50,35,85,103
3404-001,2018,11,30,4,31,54,85,85
3404-001,2018,11,30,5,55,67,122,85
3404-001,2018,11,30,6,161,165,326,122
3404-001,2018,11,30,7,312,574,886,326
3404-001,2018,11,30,8,711,1924,2635,886
3404-001,2018,11,30,9,940,1483,2423,2635
3404-001,2018,11,30,10,791,804,1595,2423
3404-001,2018,11,30,11,957,841,1798,1595
3404-001,2018,11,30,12,970,709,1679,1798
3404-001,2018,11,30,13,790,617,1407,1679
3404-001,2018,11,30,14,848,706,1554,1407
3404-001,2018,11,30,15,1113,845,1958,1554
3404-001,2018,11,30,16,1017,747,1764,1958
3404-001,2018,11,30,17,1000,816,1816,1764
3404-001,2018,11,30,18,1787,970,2757,1816
3404-001,2018,11,30,19,1512,853,2365,2757
3404-001,2018,11,30,20,827,550,1377,2365
3404-001,2018,11,30,21,559,343,902,1377
3404-001,2018,11,30,22,317,232,549,902
3404-001,2018,11,30,23,200,151,351,549
3404-001,2018,11,30,24,121,98,219,351
3404-001,2018,12,1,1,99,89,188,219
3404-001,2018,12,1,2,62,50,112,188
3404-001,2018,12,1,3,50,64,114,112
3404-001,2018,12,1,4,48,45,93,114
3404-001,2018,12,1,5,78,79,157,93
3404-001,2018,12,1,6,129,206,335,157
3404-001,2018,12,1,7,234,399,633,335
3404-001,2018,12,1,8,441,742,1183,633
3404-001,2018,12,1,9,626,775,1401,1183
3404-001,2018,12,1,10,653,725,1378,1401
3404-001,2018,12,1,11,660,832,1492,1378
3404-001,2018,12,1,12,644,826,1470,1492
3404-001,2018,12,1,13,667,748,1415,1470
3404-001,2018,12,1,14,645,708,1353,1415
3404-001,2018,12,1,15,676,698,1374,1353
3404-001,2018,12,1,16,761,734,1495,1374
3404-001,2018,12,1,17,748,614,1362,1495
3404-001,2018,12,1,18,892,687,1579,1362
3404-001,2018,12,1,19,614,579,1193,1579
3404-001,2018,12,1,20,324,336,660,1193
3404-001,2018,12,1,21,250,219,469,660
3404-001,2018,12,1,22,171,202,373,469
3404-001,2018,12,1,23,109,148,257,373
3404-001,2018,12,1,24,90,104,194,257
3404-001,2018,12,2,1,53,69,122,194
3404-001,2018,12,2,2,54,54,108,122
3404-001,2018,12,2,3,35,48,83,108
3404-001,2018,12,2,4,37,39,76,83
3404-001,2018,12,2,5,52,58,110,76
3404-001,2018,12,2,6,47,87,134,110
3404-001,2018,12,2,7,95,161,256,134
3404-001,2018,12,2,8,247,232,479,256
3404-001,2018,12,2,9,275,275,550,479
3404-001,2018,12,2,10,317,292,609,550
3404-001,2018,12,2,11,450,397,847,609
3404-001,2018,12,2,12,435,482,917,847
3404-001,2018,12,2,13,441,455,896,917
3404-001,2018,12,2,14,485,462,947,896
3404-001,2018,12,2,15,574,512,1086,947
3404-001,2018,12,2,16,678,503,1181,1086
3404-001,2018,12,2,17,714,506,1220,1181
3404-001,2018,12,2,18,704,499,1203,1220
3404-001,2018,12,2,19,501,420,921,1203
3404-001,2018,12,2,20,321,386,707,921
3404-001,2018,12,2,21,268,267,535,707
3404-001,2018,12,2,22,184,218,402,535
3404-001,2018,12,2,23,122,180,302,402
3404-001,2018,12,2,24,71,104,175,302
3404-001,2018,12,3,1,35,74,109,175
3404-001,2018,12,3,2,70,58,128,109
3404-001,2018,12,3,3,39,58,97,128
3404-001,2018,12,3,4,37,46,83,97
3404-001,2018,12,3,5,60,79,139,83
3404-001,2018,12,3,6,144,209,353,139
3404-001,2018,12,3,7,335,636,971,353
3404-001,2018,12,3,8,760,2031,2791,971
3404-001,2018,12,3,9,957,1765,2722,2791
3404-001,2018,12,3,10,847,890,1737,2722
3404-001,2018,12,3,11,908,804,1712,1737
3404-001,2018,12,3,12,856,775,1631,1712
3404-001,2018,12,3,13,752,634,1386,1631
3404-001,2018,12,3,14,884,713,1597,1386
3404-001,2018,12,3,15,1002,828,1830,1597
3404-001,2018,12,3,16,994,804,1798,1830
3404-001,2018,12,3,17,977,634,1611,1798
3404-001,2018,12,3,18,1383,680,2063,1611
3404-001,2018,12,3,19,1204,653,1857,2063
3404-001,2018,12,3,20,666,445,1111,1857
3404-001,2018,12,3,21,671,276,947,1111
3404-001,2018,12,3,22,297,225,522,947
3404-001,2018,12,3,23,171,161,332,522
3404-001,2018,12,3,24,119,107,226,332
3404-001,2018,12,4,1,101,81,182,226
3404-001,2018,12,4,2,70,52,122,182
3404-001,2018,12,4,3,39,46,85,122
3404-001,2018,12,4,4,46,72,118,85
3404-001,2018,12,4,5,71,68,139,118
3404-001,2018,12,4,6,172,232,404,139
3404-001,2018,12,4,7,321,602,923,404
3404-001,2018,12,4,8,803,1816,2619,923
3404-001,2018,12,4,9,1023,1685,2708,2619
3404-001,2018,12,4,10,896,932,1828,2708
3404-001,2018,12,4,11,873,835,1708,1828
3404-001,2018,12,4,12,744,777,1521,1708
3404-001,2018,12,4,13,757,675,1432,1521
3404-001,2018,12,4,14,895,804,1699,1432
3404-001,2018,12,4,15,981,824,1805,1699
3404-001,2018,12,4,16,894,818,1712,1805
3404-001,2018,12,4,17,856,700,1556,1712
3404-001,2018,12,4,18,1268,751,2019,1556
3404-001,2018,12,4,19,1152,693,1845,2019
3404-001,2018,12,4,20,684,461,1145,1845
3404-001,2018,12,4,21,654,312,966,1145
3404-001,2018,12,4,22,272,223,495,966
3404-001,2018,12,4,23,173,134,307,495
3404-001,2018,12,4,24,111,97,208,307
3404-001,2018,12,5,1,95,56,151,208
3404-001,2018,12,5,2,77,32,109,151
3404-001,2018,12,5,3,57,44,101,109
3404-001,2018,12,5,4,45,41,86,101
3404-001,2018,12,5,5,67,81,148,86
3404-001,2018,12,5,6,126,223,349,148
3404-001,2018,12,5,7,293,580,873,349
3404-001,2018,12,5,8,722,2047,2769,873
3404-001,2018,12,5,9,1026,1647,2673,2769
3404-001,2018,12,5,10,874,904,1778,2673
3404-001,2018,12,5,11,1012,835,1847,1778
3404-001,2018,12,5,12,957,747,1704,1847
3404-001,2018,12,5,13,898,741,1639,1704
3404-001,2018,12,5,14,930,855,1785,1639
3404-001,2018,12,5,15,1078,935,2013,1785
3404-001,2018,12,5,16,1075,846,1921,2013
3404-001,2018,12,5,17,921,779,1700,1921
3404-001,2018,12,5,18,1458,818,2276,1700
3404-001,2018,12,5,19,1167,687,1854,2276
3404-001,2018,12,5,20,634,481,1115,1854
3404-001,2018,12,5,21,503,270,773,1115
3404-001,2018,12,5,22,293,216,509,773
3404-001,2018,12,5,23,162,163,325,509
3404-001,2018,12,5,24,122,119,241,325
3404-001,2018,12,6,1,86,87,173,241
3404-001,2018,12,6,2,62,50,112,173
3404-001,2018,12,6,3,54,59,113,112
3404-001,2018,12,6,4,52,48,100,113
3404-001,2018,12,6,5,61,90,151,100
3404-001,2018,12,6,6,160,207,367,151
3404-001,2018,12,6,7,353,594,947,367
3404-001,2018,12,6,8,794,1932,2726,947
3404-001,2018,12,6,9,957,1760,2717,2726
3404-001,2018,12,6,10,796,904,1700,2717
3404-001,2018,12,6,11,796,870,1666,1700
3404-001,2018,12,6,12,942,757,1699,1666
3404-001,2018,12,6,13,864,695,1559,1699
3404-001,2018,12,6,14,975,725,1700,1559
3404-001,2018,12,6,15,1078,851,1929,1700
3404-001,2018,12,6,16,939,874,1813,1929
3404-001,2018,12,6,17,834,862,1696,1813
3404-001,2018,12,6,18,1405,862,2267,1696
3404-001,2018,12,6,19,1103,653,1756,2267
3404-001,2018,12,6,20,625,443,1068,1756
3404-001,2018,12,6,21,613,285,898,1068
3404-001,2018,12,6,22,315,190,505,898
3404-001,2018,12,6,23,177,161,338,505
3404-001,2018,12,6,24,124,99,223,338
3404-001,2018,12,7,1,78,87,165,223
3404-001,2018,12,7,2,43,58,101,165
3404-001,2018,12,7,3,38,43,81,101
3404-001,2018,12,7,4,47,48,95,81
3404-001,2018,12,7,5,62,63,125,95
3404-001,2018,12,7,6,100,131,231,125
3404-001,2018,12,7,7,183,578,761,231
3404-001,2018,12,7,8,633,1876,2509,761
3404-001,2018,12,7,9,803,1543,2346,2509
3404-001,2018,12,7,10,634,785,1419,2346
3404-001,2018,12,7,11,753,757,1510,1419
3404-001,2018,12,7,12,676,678,1354,1510
3404-001,2018,12,7,13,713,590,1303,1354
3404-001,2018,12,7,14,757,757,1514,1303
3404-001,2018,12,7,15,773,826,1599,1514
3404-001,2018,12,7,16,787,870,1657,1599
3404-001,2018,12,7,17,959,807,1766,1657
3404-001,2018,12,7,18,1653,886,2539,1766
3404-001,2018,12,7,19,1311,793,2104,2539
3404-001,2018,12,7,20,710,614,1324,2104
3404-001,2018,12,7,21,509,272,781,1324
3404-001,2018,12,7,22,250,210,460,781
3404-001,2018,12,7,23,157,134,291,460
3404-001,2018,12,7,24,104,105,209,291
3404-001,2018,12,8,1,70,52,122,209
3404-001,2018,12,8,2,53,52,105,122
3404-001,2018,12,8,3,35,37,72,105
3404-001,2018,12,8,4,34,52,86,72
3404-001,2018,12,8,5,45,33,78,86
3404-001,2018,12,8,6,85,112,197,78
3404-001,2018,12,8,7,140,282,422,197
3404-001,2018,12,8,8,311,616,927,422
3404-001,2018,12,8,9,498,554,1052,927
3404-001,2018,12,8,10,461,562,1023,1052
3404-001,2018,12,8,11,492,585,1077,1023
3404-001,2018,12,8,12,556,619,1175,1077
3404-001,2018,12,8,13,534,528,1062,1175
3404-001,2018,12,8,14,572,543,1115,1062
3404-001,2018,12,8,15,552,562,1114,1115
3404-001,2018,12,8,16,569,625,1194,1114
3404-001,2018,12,8,17,642,562,1204,1194
3404-001,2018,12,8,18,757,606,1363,1204
3404-001,2018,12,8,19,422,424,846,1363
3404-001,2018,12,8,20,261,322,583,846
3404-001,2018,12,8,21,214,198,412,583
3404-001,2018,12,8,22,128,188,316,412
3404-001,2018,12,8,23,106,115,221,316
3404-001,2018,12,8,24,60,102,162,221
3404-001,2018,12,9,1,47,92,139,162
3404-001,2018,12,9,2,41,50,91,139
3404-001,2018,12,9,3,28,35,63,91
3404-001,2018,12,9,4,32,25,57,63
3404-001,2018,12,9,5,29,43,72,57
3404-001,2018,12,9,6,30,46,76,72
3404-001,2018,12,9,7,72,104,176,76
3404-001,2018,12,9,8,151,190,341,176
3404-001,2018,12,9,9,227,192,419,341
3404-001,2018,12,9,10,222,219,441,419
3404-001,2018,12,9,11,289,313,602,441
3404-001,2018,12,9,12,315,399,714,602
3404-001,2018,12,9,13,409,390,799,714
3404-001,2018,12,9,14,387,405,792,799
3404-001,2018,12,9,15,501,384,885,792
3404-001,2018,12,9,16,513,487,1000,885
3404-001,2018,12,9,17,528,430,958,1000
3404-001,2018,12,9,18,495,414,909,958
3404-001,2018,12,9,19,339,405,744,909
3404-001,2018,12,9,20,208,290,498,744
3404-001,2018,12,9,21,176,267,443,498
3404-001,2018,12,9,22,133,219,352,443
3404-001,2018,12,9,23,65,171,236,352
3404-001,2018,12,9,24,62,108,170,236
3404-001,2018,12,10,1,39,74,113,170
3404-001,2018,12,10,2,25,37,62,113
3404-001,2018,12,10,3,19,18,37,62
3404-001,2018,12,10,4,25,33,58,37
3404-001,2018,12,10,5,52,60,112,58
3404-001,2018,12,10,6,104,172,276,112
3404-001,2018,12,10,7,304,638,942,276
3404-001,2018,12,10,8,718,2031,2749,942
3404-001,2018,12,10,9,899,1563,2462,2749
3404-001,2018,12,10,10,747,742,1489,2462
3404-001,2018,12,10,11,747,781,1528,1489
3404-001,2018,12,10,12,722,663,1385,1528
3404-001,2018,12,10,13,756,670,1426,1385
3404-001,2018,12,10,14,888,771,1659,1426
3404-001,2018,12,10,15,1080,829,1909,1659
3404-001,2018,12,10,16,1022,760,1782,1909
3404-001,2018,12,10,17,954,722,1676,1782
3404-001,2018,12,10,18,1363,808,2171,1676
3404-001,2018,12,10,19,1172,651,1823,2171
3404-001,2018,12,10,20,742,425,1167,1823
3404-001,2018,12,10,21,551,301,852,1167
3404-001,2018,12,10,22,258,212,470,852
3404-001,2018,12,10,23,164,126,290,470
3404-001,2018,12,10,24,116,79,195,290
3404-001,2018,12,11,1,69,54,123,195
3404-001,2018,12,11,2,38,42,80,123
3404-001,2018,12,11,3,44,37,81,80
3404-001,2018,12,11,4,36,44,80,81
3404-001,2018,12,11,5,68,58,126,80
3404-001,2018,12,11,6,131,142,273,126
3404-001,2018,12,11,7,278,555,833,273
3404-001,2018,12,11,8,683,1849,2532,833
3404-001,2018,12,11,9,873,1504,2377,2532
3404-001,2018,12,11,10,676,767,1443,2377
3404-001,2018,12,11,11,779,746,1525,1443
3404-001,2018,12,11,12,696,682,1378,1525
3404-001,2018,12,11,13,716,669,1385,1378
3404-001,2018,12,11,14,843,802,1645,1385
3404-001,2018,12,11,15,926,840,1766,1645
3404-001,2018,12,11,16,996,836,1832,1766
3404-001,2018,12,11,17,921,666,1587,1832
3404-001,2018,12,11,18,1317,797,2114,1587
3404-001,2018,12,11,19,1144,663,1807,2114
3404-001,2018,12,11,20,692,419,1111,1807
3404-001,2018,12,11,21,632,265,897,1111
3404-001,2018,12,11,22,337,185,522,897
3404-001,2018,12,11,23,190,133,323,522
3404-001,2018,12,11,24,130,88,218,323
3404-001,2018,12,12,1,96,62,158,218
3404-001,2018,12,12,2,40,50,90,158
3404-001,2018,12,12,3,31,43,74,90
3404-001,2018,12,12,4,40,39,79,74
3404-001,2018,12,12,5,61,45,106,79
3404-001,2018,12,12,6,101,135,236,106
3404-001,2018,12,12,7,262,572,834,236
3404-001,2018,12,12,8,654,1953,2607,834
3404-001,2018,12,12,9,948,1677,2625,2607
3404-001,2018,12,12,10,806,823,1629,2625
3404-001,2018,12,12,11,916,897,1813,1629
3404-001,2018,12,12,12,928,823,1751,1813
3404-001,2018,12,12,13,815,708,1523,1751
3404-001,2018,12,12,14,995,780,1775,1523
3404-001,2018,12,12,15,1127,966,2093,1775
3404-001,2018,12,12,16,1115,849,1964,2093
3404-001,2018,12,12,17,1098,901,1999,1964
3404-001,2018,12,12,18,1619,953,2572,1999
3404-001,2018,12,12,19,1245,821,2066,2572
3404-001,2018,12,12,20,750,485,1235,2066
3404-001,2018,12,12,21,523,290,813,1235
3404-001,2018,12,12,22,313,192,505,813
3404-001,2018,12,12,23,148,133,281,505
3404-001,2018,12,12,24,106,94,200,281
3404-001,2018,12,13,1,78,85,163,200
3404-001,2018,12,13,2,47,60,107,163
3404-001,2018,12,13,3,40,42,82,107
3404-001,2018,12,13,4,63,42,105,82
3404-001,2018,12,13,5,81,58,139,105
3404-001,2018,12,13,6,142,177,319,139
3404-001,2018,12,13,7,255,679,934,319
3404-001,2018,12,13,8,662,2277,2939,934
3404-001,2018,12,13,9,949,1877,2826,2939
3404-001,2018,12,13,10,759,975,1734,2826
3404-001,2018,12,13,11,838,1036,1874,1734
3404-001,2018,12,13,12,889,898,1787,1874
3404-001,2018,12,13,13,907,683,1590,1787
3404-001,2018,12,13,14,1005,829,1834,1590
3404-001,2018,12,13,15,1038,949,1987,1834
3404-001,2018,12,13,16,1097,1019,2116,1987
3404-001,2018,12,13,17,1129,820,1949,2116
3404-001,2018,12,13,18,1786,854,2640,1949
3404-001,2018,12,13,19,1595,709,2304,2640
3404-001,2018,12,13,20,884,447,1331,2304
3404-001,2018,12,13,21,737,349,1086,1331
3404-001,2018,12,13,22,291,191,482,1086
3404-001,2018,12,13,23,164,131,295,482
3404-001,2018,12,13,24,110,119,229,295
3404-001,2018,12,14,1,78,67,145,229
3404-001,2018,12,14,2,37,53,90,145
3404-001,2018,12,14,3,52,62,114,90
3404-001,2018,12,14,4,42,42,84,114
3404-001,2018,12,14,5,40,54,94,84
3404-001,2018,12,14,6,125,189,314,94
3404-001,2018,12,14,7,296,610,906,314
3404-001,2018,12,14,8,726,2277,3003,906
3404-001,2018,12,14,9,1036,1883,2919,3003
3404-001,2018,12,14,10,888,975,1863,2919
3404-001,2018,12,14,11,988,920,1908,1863
3404-001,2018,12,14,12,931,862,1793,1908
3404-001,2018,12,14,13,840,866,1706,1793
3404-001,2018,12,14,14,943,977,1920,1706
3404-001,2018,12,14,15,1085,1056,2141,1920
3404-001,2018,12,14,16,1197,1097,2294,2141
3404-001,2018,12,14,17,1398,965,2363,2294
3404-001,2018,12,14,18,2375,1101,3476,2363
3404-001,2018,12,14,19,1942,986,2928,3476
3404-001,2018,12,14,20,1018,638,1656,2928
3404-001,2018,12,14,21,583,386,969,1656
3404-001,2018,12,14,22,269,269,538,969
3404-001,2018,12,14,23,164,185,349,538
3404-001,2018,12,14,24,106,125,231,349
3404-001,2018,12,15,1,74,71,145,231
3404-001,2018,12,15,2,67,58,125,145
3404-001,2018,12,15,3,44,60,104,125
3404-001,2018,12,15,4,53,33,86,104
3404-001,2018,12,15,5,60,66,126,86
3404-001,2018,12,15,6,97,106,203,126
3404-001,2018,12,15,7,191,284,475,203
3404-001,2018,12,15,8,392,558,950,475
3404-001,2018,12,15,9,604,591,1195,950
3404-001,2018,12,15,10,611,549,1160,1195
3404-001,2018,12,15,11,655,619,1274,1160
3404-001,2018,12,15,12,730,648,1378,1274
3404-001,2018,12,15,13,641,698,1339,1378
3404-001,2018,12,15,14,655,641,1296,1339
3404-001,2018,12,15,15,662,641,1303,1296
3404-001,2018,12,15,16,757,696,1453,1303
3404-001,2018,12,15,17,884,616,1500,1453
3404-001,2018,12,15,18,1084,619,1703,1500
3404-001,2018,12,15,19,685,480,1165,1703
3404-001,2018,12,15,20,392,357,749,1165
3404-001,2018,12,15,21,312,202,514,749
3404-001,2018,12,15,22,174,175,349,514
3404-001,2018,12,15,23,103,121,224,349
3404-001,2018,12,15,24,83,91,174,224
3404-001,2018,12,16,1,55,71,126,174
3404-001,2018,12,16,2,33,43,76,126
3404-001,2018,12,16,3,31,52,83,76
3404-001,2018,12,16,4,30,58,88,83
3404-001,2018,12,16,5,37,45,82,88
3404-001,2018,12,16,6,38,75,113,82
3404-001,2018,12,16,7,86,127,213,113
3404-001,2018,12,16,8,164,190,354,213
3404-001,2018,12,16,9,239,255,494,354
3404-001,2018,12,16,10,267,242,509,494
3404-001,2018,12,16,11,319,328,647,509
3404-001,2018,12,16,12,356,384,740,647
3404-001,2018,12,16,13,383,378,761,740
3404-001,2018,12,16,14,436,401,837,761
3404-001,2018,12,16,15,452,434,886,837
3404-001,2018,12,16,16,545,470,1015,886
3404-001,2018,12,16,17,535,451,986,1015
3404-001,2018,12,16,18,548,430,978,986
3404-001,2018,12,16,19,329,372,701,978
3404-001,2018,12,16,20,280,288,568,701
3404-001,2018,12,16,21,243,230,473,568
3404-001,2018,12,16,22,186,221,407,473
3404-001,2018,12,16,23,125,150,275,407
3404-001,2018,12,16,24,89,127,216,275
3404-001,2018,12,17,1,51,81,132,216
3404-001,2018,12,17,2,39,68,107,132
3404-001,2018,12,17,3,75,56,131,107
3404-001,2018,12,17,4,69,56,125,131
3404-001,2018,12,17,5,120,88,208,125
3404-001,2018,12,17,6,250,235,485,208
3404-001,2018,12,17,7,429,816,1245,485
3404-001,2018,12,17,8,866,1934,2800,1245
3404-001,2018,12,17,9,1110,1941,3051,2800
3404-001,2018,12,17,10,1012,1036,2048,3051
3404-001,2018,12,17,11,924,1013,1937,2048
3404-001,2018,12,17,12,888,814,1702,1937
3404-001,2018,12,17,13,839,828,1667,1702
3404-001,2018,12,17,14,884,1030,1914,1667
3404-001,2018,12,17,15,1115,974,2089,1914
3404-001,2018,12,17,16,1075,981,2056,2089
3404-001,2018,12,17,17,1178,916,2094,2056
3404-001,2018,12,17,18,1552,920,2472,2094
3404-001,2018,12,17,19,1444,712,2156,2472
3404-001,2018,12,17,20,866,509,1375,2156
3404-001,2018,12,17,21,731,330,1061,1375
3404-001,2018,12,17,22,415,252,667,1061
3404-001,2018,12,17,23,250,200,450,667
3404-001,2018,12,17,24,136,136,272,450
3404-001,2018,12,18,1,114,78,192,272
3404-001,2018,12,18,2,89,64,153,192
3404-001,2018,12,18,3,51,83,134,153
3404-001,2018,12,18,4,78,69,147,134
3404-001,2018,12,18,5,126,66,192,147
3404-001,2018,12,18,6,199,200,399,192
3404-001,2018,12,18,7,440,708,1148,399
3404-001,2018,12,18,8,930,2243,3173,1148
3404-001,2018,12,18,9,1297,2102,3399,3173
3404-001,2018,12,18,10,1142,889,2031,3399
3404-001,2018,12,18,11,1031,999,2030,2031
3404-001,2018,12,18,12,852,962,1814,2030
3404-001,2018,12,18,13,852,840,1692,1814
3404-001,2018,12,18,14,896,929,1825,1692
3404-001,2018,12,18,15,1002,995,1997,1825
3404-001,2018,12,18,16,1051,983,2034,1997
3404-001,2018,12,18,17,1191,921,2112,2034
3404-001,2018,12,18,18,1599,917,2516,2112
3404-001,2018,12,18,19,1434,881,2315,2516
3404-001,2018,12,18,20,817,525,1342,2315
3404-001,2018,12,18,21,781,306,1087,1342
3404-001,2018,12,18,22,418,249,667,1087
3404-001,2018,12,18,23,259,191,450,667
3404-001,2018,12,18,24,171,123,294,450
3404-001,2018,12,19,1,115,92,207,294
3404-001,2018,12,19,2,81,78,159,207
3404-001,2018,12,19,3,79,69,148,159
3404-001,2018,12,19,4,84,69,153,148
3404-001,2018,12,19,5,112,104,216,153
3404-001,2018,12,19,6,224,269,493,216
3404-001,2018,12,19,7,497,773,1270,493
3404-001,2018,12,19,8,1064,2318,3382,1270
3404-001,2018,12,19,9,1305,1955,3260,3382
3404-001,2018,12,19,10,1004,1070,2074,3260
3404-001,2018,12,19,11,1026,962,1988,2074
3404-001,2018,12,19,12,921,972,1893,1988
3404-001,2018,12,19,13,800,891,1691,1893
3404-001,2018,12,19,14,866,978,1844,1691
3404-001,2018,12,19,15,1121,950,2071,1844
3404-001,2018,12,19,16,1071,1046,2117,2071
3404-001,2018,12,19,17,1138,1001,2139,2117
3404-001,2018,12,19,18,1807,1017,2824,2139
3404-001,2018,12,19,19,1405,842,2247,2824
3404-001,2018,12,19,20,819,553,1372,2247
3404-001,2018,12,19,21,620,334,954,1372
3404-001,2018,12,19,22,407,288,695,954
3404-001,2018,12,19,23,227,207,434,695
3404-001,2018,12,19,24,158,108,266,434
3404-001,2018,12,20,1,147,86,233,266
3404-001,2018,12,20,2,77,72,149,233
3404-001,2018,12,20,3,55,50,105,149
3404-001,2018,12,20,4,89,75,164,105
3404-001,2018,12,20,5,106,100,206,164
3404-001,2018,12,20,6,219,249,468,206
3404-001,2018,12,20,7,515,678,1193,468
3404-001,2018,12,20,8,1048,2248,3296,1193
3404-001,2018,12,20,9,1306,1944,3250,3296
3404-001,2018,12,20,10,1060,1049,2109,3250
3404-001,2018,12,20,11,1023,1015,2038,2109
3404-001,2018,12,20,12,988,1005,1993,2038
3404-001,2018,12,20,13,808,859,1667,1993
3404-001,2018,12,20,14,862,927,1789,1667
3404-001,2018,12,20,15,1100,964,2064,1789
3404-001,2018,12,20,16,1071,959,2030,2064
3404-001,2018,12,20,17,1094,938,2032,2030
3404-001,2018,12,20,18,1493,929,2422,2032
3404-001,2018,12,20,19,1281,750,2031,2422
3404-001,2018,12,20,20,777,495,1272,2031
3404-001,2018,12,20,21,715,372,1087,1272
3404-001,2018,12,20,22,386,249,635,1087
3404-001,2018,12,20,23,209,202,411,635
3404-001,2018,12,20,24,195,116,311,411
3404-001,2018,12,21,1,143,89,232,311
3404-001,2018,12,21,2,87,58,145,232
3404-001,2018,12,21,3,80,49,129,145
3404-001,2018,12,21,4,73,49,122,129
3404-001,2018,12,21,5,99,56,155,122
3404-001,2018,12,21,6,178,173,351,155
3404-001,2018,12,21,7,384,656,1040,351
3404-001,2018,12,21,8,819,2071,2890,1040
3404-001,2018,12,21,9,1212,1761,2973,2890
3404-001,2018,12,21,10,1055,998,2053,2973
3404-001,2018,12,21,11,1151,1023,2174,2053
3404-001,2018,12,21,12,948,927,1875,2174
3404-001,2018,12,21,13,872,796,1668,1875
3404-001,2018,12,21,14,906,918,1824,1668
3404-001,2018,12,21,15,1100,1052,2152,1824
3404-001,2018,12,21,16,1152,1056,2208,2152
3404-001,2018,12,21,17,1245,950,2195,2208
3404-001,2018,12,21,18,1912,1049,2961,2195
3404-001,2018,12,21,19,1492,1011,2503,2961
3404-001,2018,12,21,20,788,613,1401,2503
3404-001,2018,12,21,21,578,413,991,1401
3404-001,2018,12,21,22,390,242,632,991
3404-001,2018,12,21,23,240,269,509,632
3404-001,2018,12,21,24,147,147,294,509
3404-001,2018,12,22,1,102,98,200,294
3404-001,2018,12,22,2,85,75,160,200
3404-001,2018,12,22,3,82,73,155,160
3404-001,2018,12,22,4,77,71,148,155
3404-001,2018,12,22,5,82,68,150,148
3404-001,2018,12,22,6,143,186,329,150
3404-001,2018,12,22,7,329,414,743,329
3404-001,2018,12,22,8,521,715,1236,743
3404-001,2018,12,22,9,732,736,1468,1236
3404-001,2018,12,22,10,702,702,1404,1468
3404-001,2018,12,22,11,753,743,1496,1404
3404-001,2018,12,22,12,722,750,1472,1496
3404-001,2018,12,22,13,664,683,1347,1472
3404-001,2018,12,22,14,603,702,1305,1347
3404-001,2018,12,22,15,662,715,1377,1305
3404-001,2018,12,22,16,760,656,1416,1377
3404-001,2018,12,22,17,785,627,1412,1416
3404-001,2018,12,22,18,926,725,1651,1412
3404-001,2018,12,22,19,518,549,1067,1651
3404-001,2018,12,22,20,336,342,678,1067
3404-001,2018,12,22,21,255,227,482,678
3404-001,2018,12,22,22,186,181,367,482
3404-001,2018,12,22,23,122,137,259,367
3404-001,2018,12,22,24,95,112,207,259
3404-001,2018,12,23,1,62,69,131,207
3404-001,2018,12,23,2,54,58,112,131
3404-001,2018,12,23,3,43,29,72,112
3404-001,2018,12,23,4,38,18,56,72
3404-001,2018,12,23,5,42,33,75,56
3404-001,2018,12,23,6,41,66,107,75
3404-001,2018,12,23,7,103,160,263,107
3404-001,2018,12,23,8,204,209,413,263
3404-001,2018,12,23,9,282,242,524,413
3404-001,2018,12,23,10,323,257,580,524
3404-001,2018,12,23,11,383,342,725,580
3404-001,2018,12,23,12,369,409,778,725
3404-001,2018,12,23,13,394,397,791,778
3404-001,2018,12,23,14,403,409,812,791
3404-001,2018,12,23,15,573,401,974,812
3404-001,2018,12,23,16,520,528,1048,974
3404-001,2018,12,23,17,504,508,1012,1048
3404-001,2018,12,23,18,550,432,982,1012
3404-001,2018,12,23,19,384,351,735,982
3404-001,2018,12,23,20,278,267,545,735
3404-001,2018,12,23,21,228,229,457,545
3404-001,2018,12,23,22,199,190,389,457
3404-001,2018,12,23,23,116,158,274,389
3404-001,2018,12,23,24,88,83,171,274
3404-001,2018,12,24,1,44,60,104,171
3404-001,2018,12,24,2,40,48,88,104
3404-001,2018,12,24,3,52,25,77,88
3404-001,2018,12,24,4,20,33,53,77
3404-001,2018,12,24,5,89,50,139,53
3404-001,2018,12,24,6,158,163,321,139
3404-001,2018,12,24,7,295,551,846,321
3404-001,2018,12,24,8,621,1720,2341,846
3404-001,2018,12,24,9,710,1286,1996,2341
3404-001,2018,12,24,10,729,675,1404,1996
3404-001,2018,12,24,11,935,756,1691,1404
3404-001,2018,12,24,12,904,752,1656,1691
3404-001,2018,12,24,13,783,803,1586,1656
3404-001,2018,12,24,14,819,727,1546,1586
3404-001,2018,12,24,15,1001,872,1873,1546
3404-001,2018,12,24,16,951,805,1756,1873
3404-001,2018,12,24,17,1037,775,1812,1756
3404-001,2018,12,24,18,1591,865,2456,1812
3404-001,2018,12,24,19,1382,832,2214,2456
3404-001,2018,12,24,20,795,526,1321,2214
3404-001,2018,12,24,21,614,315,929,1321
3404-001,2018,12,24,22,310,183,493,929
3404-001,2018,12,24,23,173,138,311,493
3404-001,2018,12,24,24,88,85,173,311
3404-001,2018,12,25,1,67,75,142,173
3404-001,2018,12,25,2,41,43,84,142
3404-001,2018,12,25,3,35,41,76,84
3404-001,2018,12,25,4,33,46,79,76
3404-001,2018,12,25,5,43,45,88,79
3404-001,2018,12,25,6,72,85,157,88
3404-001,2018,12,25,7,126,236,362,157
3404-001,2018,12,25,8,251,391,642,362
3404-001,2018,12,25,9,313,351,664,642
3404-001,2018,12,25,10,355,317,672,664
3404-001,2018,12,25,11,431,397,828,672
3404-001,2018,12,25,12,391,416,807,828
3404-001,2018,12,25,13,449,474,923,807
3404-001,2018,12,25,14,499,485,984,923
3404-001,2018,12,25,15,565,476,1041,984
3404-001,2018,12,25,16,632,445,1077,1041
3404-001,2018,12,25,17,595,460,1055,1077
3404-001,2018,12,25,18,745,476,1221,1055
3404-001,2018,12,25,19,521,344,865,1221
3404-001,2018,12,25,20,361,288,649,865
3404-001,2018,12,25,21,333,211,544,649
3404-001,2018,12,25,22,215,192,407,544
3404-001,2018,12,25,23,171,175,346,407
3404-001,2018,12,25,24,90,112,202,346
3404-001,2018,12,26,1,46,66,112,202
3404-001,2018,12,26,2,23,45,68,112
3404-001,2018,12,26,3,5,46,51,68
3404-001,2018,12,26,4,7,50,57,51
3404-001,2018,12,26,5,10,85,95,57
3404-001,2018,12,26,6,32,261,293,95
3404-001,2018,12,26,7,294,746,1040,293
3404-001,2018,12,26,8,1016,2183,3199,1040
3404-001,2018,12,26,9,1349,1798,3147,3199
3404-001,2018,12,26,10,1037,922,1959,3147
3404-001,2018,12,26,11,1107,848,1955,1959
3404-001,2018,12,26,12,1010,844,1854,1955
3404-001,2018,12,26,13,856,694,1550,1854
3404-001,2018,12,26,14,928,815,1743,1550
3404-001,2018,12,26,15,1249,940,2189,1743
3404-001,2018,12,26,16,1155,924,2079,2189
3404-001,2018,12,26,17,1122,834,1956,2079
3404-001,2018,12,26,18,1719,821,2540,1956
3404-001,2018,12,26,19,1407,773,2180,2540
3404-001,2018,12,26,20,827,464,1291,2180
3404-001,2018,12,26,21,679,267,946,1291
3404-001,2018,12,26,22,384,207,591,946
3404-001,2018,12,26,23,250,152,402,591
3404-001,2018,12,26,24,188,73,261,402
3404-001,2018,12,27,1,136,58,194,261
3404-001,2018,12,27,2,75,43,118,194
3404-001,2018,12,27,3,60,43,103,118
3404-001,2018,12,27,4,51,56,107,103
3404-001,2018,12,27,5,55,58,113,107
3404-001,2018,12,27,6,107,142,249,113
3404-001,2018,12,27,7,244,505,749,249
3404-001,2018,12,27,8,619,2101,2720,749
3404-001,2018,12,27,9,835,1532,2367,2720
3404-001,2018,12,27,10,771,740,1511,2367
3404-001,2018,12,27,11,739,773,1512,1511
3404-001,2018,12,27,12,804,710,1514,1512
3404-001,2018,12,27,13,827,641,1468,1514
3404-001,2018,12,27,14,879,807,1686,1468
3404-001,2018,12,27,15,1079,876,1955,1686
3404-001,2018,12,27,16,995,857,1852,1955
3404-001,2018,12,27,17,1104,744,1848,1852
3404-001,2018,12,27,18,1431,802,2233,1848
3404-001,2018,12,27,19,955,667,1622,2233
3404-001,2018,12,27,20,602,401,1003,1622
3404-001,2018,12,27,21,528,292,820,1003
3404-001,2018,12,27,22,290,194,484,820
3404-001,2018,12,27,23,183,150,333,484
3404-001,2018,12,27,24,124,108,232,333
3404-001,2018,12,28,1,88,71,159,232
3404-001,2018,12,28,2,56,58,114,159
3404-001,2018,12,28,3,53,45,98,114
3404-001,2018,12,28,4,60,33,93,98
3404-001,2018,12,28,5,59,54,113,93
3404-001,2018,12,28,6,115,144,259,113
3404-001,2018,12,28,7,268,539,807,259
3404-001,2018,12,28,8,671,1931,2602,807
3404-001,2018,12,28,9,850,1516,2366,2602
3404-001,2018,12,28,10,717,733,1450,2366
3404-001,2018,12,28,11,767,756,1523,1450
3404-001,2018,12,28,12,703,675,1378,1523
3404-001,2018,12,28,13,726,508,1234,1378
3404-001,2018,12,28,14,876,719,1595,1234
3404-001,2018,12,28,15,936,750,1686,1595
3404-001,2018,12,28,16,899,779,1678,1686
3404-001,2018,12,28,17,991,754,1745,1678
3404-001,2018,12,28,18,1342,782,2124,1745
3404-001,2018,12,28,19,1202,815,2017,2124
3404-001,2018,12,28,20,600,474,1074,2017
3404-001,2018,12,28,21,467,269,736,1074
3404-001,2018,12,28,22,293,183,476,736
3404-001,2018,12,28,23,153,144,297,476
3404-001,2018,12,28,24,119,110,229,297
3404-001,2018,12,29,1,100,85,185,229
3404-001,2018,12,29,2,69,54,123,185
3404-001,2018,12,29,3,56,45,101,123
3404-001,2018,12,29,4,47,43,90,101
3404-001,2018,12,29,5,58,33,91,90
3404-001,2018,12,29,6,103,92,195,91
3404-001,2018,12,29,7,198,261,459,195
3404-001,2018,12,29,8,363,512,875,459
3404-001,2018,12,29,9,489,493,982,875
3404-001,2018,12,29,10,476,455,931,982
3404-001,2018,12,29,11,545,501,1046,931
3404-001,2018,12,29,12,492,497,989,1046
3404-001,2018,12,29,13,562,556,1118,989
3404-001,2018,12,29,14,530,564,1094,1118
3404-001,2018,12,29,15,627,561,1188,1094
3404-001,2018,12,29,16,551,551,1102,1188
3404-001,2018,12,29,17,588,574,1162,1102
3404-001,2018,12,29,18,670,489,1159,1162
3404-001,2018,12,29,19,370,401,771,1159
3404-001,2018,12,29,20,234,271,505,771
3404-001,2018,12,29,21,186,206,392,505
3404-001,2018,12,29,22,132,158,290,392
3404-001,2018,12,29,23,101,133,234,290
3404-001,2018,12,29,24,83,62,145,234
3404-001,2018,12,30,1,58,62,120,145
3404-001,2018,12,30,2,48,50,98,120
3404-001,2018,12,30,3,29,39,68,98
3404-001,2018,12,30,4,30,31,61,68
3404-001,2018,12,30,5,33,39,72,61
3404-001,2018,12,30,6,39,41,80,72
3404-001,2018,12,30,7,60,119,179,80
3404-001,2018,12,30,8,125,138,263,179
3404-001,2018,12,30,9,223,165,388,263
3404-001,2018,12,30,10,239,223,462,388
3404-001,2018,12,30,11,312,309,621,462
3404-001,2018,12,30,12,317,321,638,621
3404-001,2018,12,30,13,338,397,735,638
3404-001,2018,12,30,14,391,405,796,735
3404-001,2018,12,30,15,450,374,824,796
3404-001,2018,12,30,16,541,382,923,824
3404-001,2018,12,30,17,811,431,1242,923
3404-001,2018,12,30,18,510,380,890,1242
3404-001,2018,12,30,19,289,345,634,890
3404-001,2018,12,30,20,243,275,518,634
3404-001,2018,12,30,21,174,165,339,518
3404-001,2018,12,30,22,134,133,267,339
3404-001,2018,12,30,23,91,135,226,267
3404-001,2018,12,30,24,57,96,153,226
3404-001,2018,12,31,1,36,43,79,153
3404-001,2018,12,31,2,32,41,73,79
3404-001,2018,12,31,3,32,39,71,73
3404-001,2018,12,31,4,22,35,57,71
3404-001,2018,12,31,5,47,39,86,57
3404-001,2018,12,31,6,88,102,190,86
3404-001,2018,12,31,7,177,359,536,190
3404-001,2018,12,31,8,442,1113,1555,536
3404-001,2018,12,31,9,525,832,1357,1555
3404-001,2018,12,31,10,515,526,1041,1357
3404-001,2018,12,31,11,588,602,1190,1041
3404-001,2018,12,31,12,683,568,1251,1190
3404-001,2018,12,31,13,628,551,1179,1251
3404-001,2018,12,31,14,685,704,1389,1179
3404-001,2018,12,31,15,766,886,1652,1389
3404-001,2018,12,31,16,754,788,1542,1652
3404-001,2018,12,31,17,826,819,1645,1542
3404-001,2018,12,31,18,961,708,1669,1645
3404-001,2018,12,31,19,702,595,1297,1669
3404-001,2018,12,31,20,387,368,755,1297
3404-001,2018,12,31,21,305,253,558,755
3404-001,2018,12,31,22,204,213,417,558
3404-001,2018,12,31,23,136,148,284,417
3404-001,2018,12,31,24,93,87,180,284
